time,subj_course_id,sec_code,sec_id,prof,available,waitlist,total,enrolled_ct
1668083386432,COGS 205,A00,101395,Chiba; Andrea,19,0,20,1
1668083386863,COGS 210B,001,101404,Greene; Deanna Jacquelyn,9998,0,9999,1
1668083386863,COGS 210B,002,101417,Xia; Haijun,9999,0,9999,0
1668083386863,COGS 210B,003,101422,Nitz; Douglas A.,9999,0,9999,0
1668083386863,COGS 210B,004,101423,Hollan; James D.,9998,0,9999,1
1668083386863,COGS 210B,005,101424,Deak; Gedeon O.,9998,0,9999,1
1668083386863,COGS 210B,006,101425,Rossano; Federico,9999,0,9999,0
1668083387295,COGS 211B,A00,101427,Coulson; Seana M,9996,0,9999,3
1668083387722,COGS 220,A00,101428,Hollan; James D.,0,0,25,25
1668083388153,COGS 229,A00,101429,Dow; Steven P,18,0,25,7
1668083388582,COGS 230,A00,101430,Klemmer; Scott R,13,0,17,4
1668083389008,COGS 234,A00,101431,Xia; Haijun,3,0,25,22
1668083389440,COGS 260,A00,101432,Kiyonaga; Anastasia,19,0,25,6
1668083389440,COGS 260,B00,101433,Kirsh; David Joel,16,0,25,9
1668083389868,CSE 202,A00,102371,Impagliazzo; Russell,0,0,0,0
1668083390294,CSE 203B,A01,102373,Cheng; Chung Kuan,0,0,0,0
1668083390719,CSE 208,A00,102374,Micciancio; Daniele,0,0,0,0
1668083391147,CSE 209A,A00,112895,Impagliazzo; Russell,0,0,15,15
1668083391575,CSE 209B,A00,108005,Bellare; Mihir,0,0,0,0
1668083392003,CSE 210,A00,113163,Coblenz; Michael J,0,0,0,0
1668083392432,CSE 219,A00,106111,Dow; Steven P,0,0,20,20
1668083392860,CSE 221,A00,102376,Voelker; Geoffrey M.,0,0,0,0
1668083393288,CSE 224,A01,102378,Porter; George M,0,0,0,0
1668083393719,CSE 229A,A00,102379,Savage; Stefan,0,0,0,0
1668083394148,CSE 229C,A00,102380,Munyaka; Imani N. S.,0,0,0,0
1668083394578,CSE 232B,A00,102382,Deutsch; Alin Bernard,0,0,0,0
1668083395005,CSE 234,A01,112904,Kumar; Arun Kumar,0,0,0,0
1668083395443,CSE 237A,A00,102383,Rosing; Tajana Simunic,0,0,0,0
1668083395872,CSE 239A,A00,102384,Deutsch; Alin Bernard,0,0,0,0
1668083396308,CSE 239B,A00,102385,Polikarpova; Nadezhda,0,0,0,0
1668083396740,CSE 240A,A00,102386,Pannuto; Patrick William,0,0,0,0
1668083397170,CSE 240B,A00,102387,Zhao; Jishen,0,0,0,0
1668083397600,CSE 241A,A00,106406,Kang; Mingu,0,0,0,0
1668083398028,CSE 249B,A00,102388,Kahng; Andrew Byun,0,0,8,8
1668083398483,CSE 251B,A01,102392,Cottrell; Garrison W,0,0,0,0
1668083398483,CSE 251B,A02,102393,Cottrell; Garrison W,0,0,0,0
1668083398912,CSE 252B,A00,102394,Ochoa; Benjamin Lawrence,0,0,0,0
1668083399341,CSE 257,A01,102396,Gao; Sicun,0,0,0,0
1668083399768,CSE 272,A00,102397,Li; Tzumao,0,0,0,0
1668083400197,CSE 274,A00,111323,Chern; Albert Ren-Haur,0,0,0,0
1668083400625,CSE 282,A00,102398,Pevzner; Pavel Arkadjevich,0,0,0,0
1668083401053,CSE 284,A00,114175,Gymrek; Melissa Ann,0,0,0,0
1668083401483,CSE 290,A00,102399,Chandraker; Manmohan Krishna,0,0,0,0
1668083401483,CSE 290,B00,102400,Vaccaro; Kristen Marie,0,0,25,25
1668083401483,CSE 290,C00,102414,Pannuto; Patrick William,0,0,25,25
1668083401483,CSE 290,D00,102427,Pevzner; Pavel Arkadjevich,0,0,0,0
1668083401483,CSE 290,E00,102429,Zhao; Jishen,0,0,0,0
1668083401483,CSE 290,F00,102436,Tullsen; Dean Michael,0,0,0,0
1668083401483,CSE 290,G00,102440,Christensen; Henrik I,0,0,20,20
1668083401925,CSE 291,A00,102443,Su; Hao,0,0,0,0
1668083401925,CSE 291,B00,102448,Polikarpova; Nadezhda,0,0,0,0
1668083401925,CSE 291,C00,102453,Vaccaro; Kristen Marie,0,0,0,0
1668083401925,CSE 291,D00,111343,Savage; Stefan,0,0,0,0
1668083401925,CSE 291,E00,116474,Claffy; Kimberly Claire,0,0,0,0
1668083401925,CSE 291,F00,116479,Pasquale; Joseph,0,0,0,0
1668083402374,CSE 293,001,119111,Bafna; Vineet,9999,0,9999,0
1668083402374,CSE 293,002,119118,Bellare; Mihir,9999,0,9999,0
1668083402374,CSE 293,003,119122,Berg-Kirkpatrick; Taylor D,9999,0,9999,0
1668083402374,CSE 293,004,119135,Christensen; Henrik I,9999,0,9999,0
1668083402374,CSE 293,005,119142,Cottrell; Garrison W,9999,0,9999,0
1668083402374,CSE 293,006,119146,Deutsch; Alin Bernard,9999,0,9999,0
1668083402374,CSE 293,007,119159,Esmaeilzadeh; Hadi,9999,0,9999,0
1668083402374,CSE 293,008,119166,Freund; Yoav,9999,0,9999,0
1668083402374,CSE 293,009,119170,Griswold; William G.,9999,0,9999,0
1668083402374,CSE 293,010,119183,Gymrek; Melissa Ann,9999,0,9999,0
1668083402374,CSE 293,011,119190,Heninger; Nadia A,9999,0,9999,0
1668083402374,CSE 293,012,119230,Impagliazzo; Russell,9999,0,9999,0
1668083402374,CSE 293,013,119232,Jhala; Ranjit,9999,0,9999,0
1668083402374,CSE 293,014,119233,Kahng; Andrew Byun,9999,0,9999,0
1668083402374,CSE 293,015,119298,Kane; Daniel Mertz,9999,0,9999,0
1668083402374,CSE 293,016,119299,Kriegman; David J,9999,0,9999,0
1668083402374,CSE 293,017,119300,Kumar; Arun Kumar,9999,0,9999,0
1668083402374,CSE 293,018,119301,Lerner; Sorin,9999,0,9999,0
1668083402374,CSE 293,019,119302,Lovett; Shachar,9999,0,9999,0
1668083402374,CSE 293,020,119303,McAuley; Julian John,9999,0,9999,0
1668083402374,CSE 293,021,119304,Micciancio; Daniele,9999,0,9999,0
1668083402374,CSE 293,022,119367,Orailoglu; Alex,9999,0,9999,0
1668083402374,CSE 293,023,119382,Paturi; Ramamohan,9999,0,9999,0
1668083402374,CSE 293,024,119404,Polikarpova; Nadezhda,9999,0,9999,0
1668083402374,CSE 293,025,119406,Politz; Joseph Gibbs,9999,0,9999,0
1668083402374,CSE 293,026,119411,Porter; George M,9999,0,9999,0
1668083402374,CSE 293,027,119414,Porter; Leonard Emerson,9999,0,9999,0
1668083402374,CSE 293,028,119416,Ramamoorthi; Ravi,9999,0,9999,0
1668083402374,CSE 293,029,119417,Sahoo; Debashis,9999,0,9999,0
1668083402374,CSE 293,030,119420,Saul; Lawrence,9999,0,9999,0
1668083402374,CSE 293,031,119421,Savage; Stefan,9999,0,9999,0
1668083402374,CSE 293,032,119425,Schulze; Jurgen P.,9999,0,9999,0
1668083402374,CSE 293,033,119426,Snoeren; Alex C.,9999,0,9999,0
1668083402374,CSE 293,034,119428,Shang; Jingbo,9999,0,9999,0
1668083402374,CSE 293,035,119430,Stefan; Deian,9999,0,9999,0
1668083402374,CSE 293,036,119431,Su; Hao,9999,0,9999,0
1668083402374,CSE 293,037,119433,Swanson; Steven James,9999,0,9999,0
1668083402374,CSE 293,038,119435,Tullsen; Dean Michael,9999,0,9999,0
1668083402374,CSE 293,039,119483,Voelker; Geoffrey M.,9999,0,9999,0
1668083402374,CSE 293,040,119537,Zhao; Jishen,9999,0,9999,0
1668083402374,CSE 293,041,119538,Zhou; Yuan-Yuan,9999,0,9999,0
1668083402374,CSE 293,042,119539,Gao; Sicun,9999,0,9999,0
1668083402374,CSE 293,043,119540,Weibel; Nadir,9999,0,9999,0
1668083402374,CSE 293,044,119541,Gupta; Rajesh K.,9999,0,9999,0
1668083402374,CSE 293,045,126410,Vaccaro; Kristen Marie,9999,0,9999,0
1668083402374,CSE 293,046,126411,Klemke; Richard,9999,0,9999,0
1668083402806,CSE 294,A00,102459,Voelker; Geoffrey M.,0,0,0,0
1668083402806,CSE 294,B00,111322,Orailoglu; Alex,0,0,0,0
1668083403238,DSE 201,A00,096914,Deutsch; Alin Bernard,30,0,30,0
1668083403666,DSE 210,A00,096915,Dasgupta; Sanjoy,30,0,30,0
1668083404095,DSE 260A,A00,096916,Altintas De Callaf; Ilkay,30,0,30,0
1668083404558,ECE 200,001,103586,Antipa; Nicholas A,9999,0,9999,0
1668083404558,ECE 200,002,103587,Atanasov; Nikolay A.,9999,0,9999,0
1668083404558,ECE 200,003,103588,Bharadia; Dinesh,9999,0,9999,0
1668083404558,ECE 200,004,103589,Cheng; Chung Kuan,9999,0,9999,0
1668083404558,ECE 200,005,103590,Cosman; Pamela C.,9999,0,9999,0
1668083404558,ECE 200,006,103591,Dayeh; Shadi Ahmad,9999,0,9999,0
1668083404558,ECE 200,007,103592,Fainman; Yeshaiahu,9999,0,9999,0
1668083404558,ECE 200,008,103593,Ford; Joseph Earl,9999,0,9999,0
1668083404558,ECE 200,009,103594,Franceschetti; Massimo,9999,0,9999,0
1668083404558,ECE 200,010,103595,Fullerton; Eric E,9999,0,9999,0
1668083404558,ECE 200,011,103596,Galton; Ian A,9999,0,9999,0
1668083404558,ECE 200,012,103597,Gilja; Vikash,9999,0,9999,0
1668083404558,ECE 200,013,103598,Hall; Drew A.,9999,0,9999,0
1668083404558,ECE 200,014,103599,Hsueh; Tzu-Chien,9999,0,9999,0
1668083404558,ECE 200,015,103600,Javidi; Tara,9999,0,9999,0
1668083404558,ECE 200,016,103601,Kahng; Andrew Byun,9999,0,9999,0
1668083404558,ECE 200,017,103602,Kim; Young-Han,9999,0,9999,0
1668083404558,ECE 200,018,103603,Koushanfar; Farinaz,9999,0,9999,0
1668083404558,ECE 200,019,103604,Kuzum; Duygu,9999,0,9999,0
1668083404558,ECE 200,020,103605,Le; Hanh-Phuc,9999,0,9999,0
1668083404558,ECE 200,021,103606,Lin; Bill,9999,0,9999,0
1668083404558,ECE 200,022,103607,Liu; Zhaowei,9998,0,9999,1
1668083404558,ECE 200,023,103608,Lo; Yu-Hwa,9999,0,9999,0
1668083404558,ECE 200,024,103609,Lomakin; Vitaliy,9999,0,9999,0
1668083404558,ECE 200,025,103610,Mercier; Patrick Philip,9999,0,9999,0
1668083404558,ECE 200,026,103611,Meyer; Florian,9999,0,9999,0
1668083404558,ECE 200,027,103612,Milstein; Laurence B.,9999,0,9999,0
1668083404558,ECE 200,028,103613,Mir Arabbaygi; Siavash,9999,0,9999,0
1668083404558,ECE 200,029,103614,Mookherjea; Shayan,9999,0,9999,0
1668083404558,ECE 200,030,103615,Morris; Karcher William,9999,0,9999,0
1668083404558,ECE 200,031,103616,Ng; Tse Nga,9999,0,9999,0
1668083404558,ECE 200,032,103617,Nguyen; Truong Quang,9999,0,9999,0
1668083404558,ECE 200,033,103618,Nomura; Kenji,9999,0,9999,0
1668083404558,ECE 200,034,103619,Orlitsky; Alon,9999,0,9999,0
1668083404558,ECE 200,035,103620,Pal; Piya,9999,0,9999,0
1668083404558,ECE 200,036,103621,Papen; George C.,9999,0,9999,0
1668083404558,ECE 200,037,103622,Radic; Stojan,9999,0,9999,0
1668083404558,ECE 200,038,103623,Rao; Bhaskar D.,9999,0,9999,0
1668083404558,ECE 200,039,103624,Rao; Ramesh R,9999,0,9999,0
1668083404558,ECE 200,040,103625,Rebeiz; Gabriel,9999,0,9999,0
1668083404558,ECE 200,041,103626,Sanford; John R,9999,0,9999,0
1668083404558,ECE 200,042,103627,Siegel; Paul H.,9999,0,9999,0
1668083404558,ECE 200,043,103628,Sievenpiper; Daniel F.,9999,0,9999,0
1668083404558,ECE 200,044,103629,Sworder; David D.,9999,0,9999,0
1668083404558,ECE 200,045,103630,Taur; Yuan,9999,0,9999,0
1668083404558,ECE 200,046,103631,Touri; Behrouz,9999,0,9999,0
1668083404558,ECE 200,047,103632,Trivedi; Mohan M.,9999,0,9999,0
1668083404558,ECE 200,048,103633,Vasconcelos; Nuno,9999,0,9999,0
1668083404558,ECE 200,049,103634,Wang; Xiaolong,9999,0,9999,0
1668083404558,ECE 200,050,103635,Xie; Pengtao,9999,0,9999,0
1668083404558,ECE 200,051,103636,Yip; Michael,9999,0,9999,0
1668083404558,ECE 200,052,103637,Zeger; Kenneth A.,999,0,999,0
1668083404558,ECE 200,053,103638,Zhang; Xinyu,9999,0,9999,0
1668083404558,ECE 200,054,103639,Turakhia; Yatish Girish,9999,0,9999,0
1668083404558,ECE 200,055,103640,Kang; Mingu,9999,0,9999,0
1668083404558,ECE 200,056,103641,Shi; Yuanyuan,9999,0,9999,0
1668083404558,ECE 200,057,103642,Wang; Edward Jay,9999,0,9999,0
1668083404558,ECE 200,058,103643,Zheng; Yang,9999,0,9999,0
1668083404982,ECE 202,A00,103644,Kuzum; Duygu,0,0,0,0
1668083405407,ECE 212BN,A00,103646,Ng; Tse Nga,0,0,0,0
1668083405914,ECE 221,A00,111493,Staff,0,0,0,0
1668083406342,ECE 222B,A00,103647,Lomakin; Vitaliy,0,0,0,0
1668083406768,ECE 230B,A00,103648,Taur; Yuan,0,0,0,0
1668083407195,ECE 238B,A00,103649,Garay; Javier,0,0,0,0
1668083407625,ECE 240B,A00,112900,Fainman; Yeshaiahu,0,0,0,0
1668083408054,ECE 247A,A00,103650,Jokerst; Jesse Vincent,0,0,0,0
1668083408483,ECE 247B,A00,103651,Wang; Joseph,0,0,0,0
1668083408911,ECE 250,A00,103652,Siegel; Paul H.,0,0,0,0
1668083409337,ECE 251A,A00,103654,Rao; Bhaskar D.,0,0,0,0
1668083409765,ECE 257B,A00,103655,Bharadia; Dinesh,0,0,0,0
1668083410195,ECE 258A,A00,103656,Milstein; Laurence B.,0,0,0,0
1668083410621,ECE 260B,A00,103658,Kang; Mingu,0,0,0,0
1668083411049,ECE 264A,A00,103659,Galton; Ian A,0,0,0,0
1668083411479,ECE 265A,A00,103661,Gudem; Prasad S.S.,0,0,0,0
1668083411904,ECE 265D,A00,103662,Gudem; Prasad S.S.,0,0,0,0
1668083412329,ECE 268,A00,103663,Koushanfar; Farinaz,0,0,0,0
1668083412762,ECE 269,A01,103665,Pal; Piya,0,0,0,0
1668083413193,ECE 271B,A00,103666,Vasconcelos; Manuela,0,0,0,0
1668083413624,ECE 276A,A00,103667,Atanasov; Nikolay A.,0,0,0,0
1668083414050,ECE 277,A00,103668,An; Cheolhong,0,0,0,0
1668083414492,ECE 279,A00,117947,Hall; Drew A.,0,0,0,0
1668083415349,ECE 283,A00,103670,Hsueh; Tzu-Chien,0,0,0,0
1668083415779,ECE 284,A00,103671,Turakhia; Yatish Girish,0,0,0,0
1668083416205,ECE 285,A00,103672,Zheng; Yang,0,0,0,0
1668083416205,ECE 285,B00,103673,Sworder; David D.,0,0,0,0
1668083416634,ECE 287,A00,103676,Javidi; Tara,0,0,0,0
1668083417073,MATH 200B,A00,098023,Salehi Golsefidy; Alireza,13,0,15,2
1668083417504,MATH 202B,A00,098024,Rhoades; Brendon Patrick,9,0,15,6
1668083417932,MATH 203B,A00,098025,Oprea; Dragos N.,10,0,15,5
1668083418362,MATH 204B,A00,098026,Sorensen; Claus M,13,0,15,2
1668083418789,MATH 208,A00,098027,Izadi; Elham,7,0,10,3
1668083419215,MATH 209,A00,098028,Pollack; Aaron,10,0,10,0
1668083419645,MATH 211A,A00,112919,Rogalski; Daniel,9,0,10,1
1668083420071,MATH 211B,A00,112920,Seward; Brandon M.,9,0,10,1
1668083420501,MATH 218,A00,098029,Li; Bo,10,0,10,0
1668083420927,MATH 220B,A00,098030,Novak; Jonathan I,12,0,15,3
1668083421362,MATH 221A,A00,098031,Ebenfelt; Peter F,13,0,15,2
1668083421790,MATH 231B,A00,098032,Zlatos; Andrej,12,0,15,3
1668083422226,MATH 240B,A00,098033,Ni; Lei,9,0,15,6
1668083422663,MATH 243,A00,098034,Jekel; David Andrew,10,0,10,0
1668083423095,MATH 245A,A00,098035,Nie; Jiawang,0,0,15,16
1668083423523,MATH 248,A00,098036,Bejenaru; Ioan,10,0,10,0
1668083423950,MATH 250B,A00,098037,Spolaor; Luca,14,0,15,1
1668083424378,MATH 258,A00,098038,Ni; Lei,10,0,10,0
1668083424805,MATH 264B,A00,098041,Rhoades; Brendon Patrick,10,0,15,5
1668083425241,MATH 268,A00,098042,Buss; Samuel R,10,0,10,0
1668083425667,MATH 269,A00,098043,Rhoades; Brendon Patrick,10,0,10,0
1668083426091,MATH 270B,A00,098044,Li; Bo,11,0,15,4
1668083426523,MATH 272B,A00,098045,Holst; Michael J,13,0,15,2
1668083426950,MATH 273A,A00,098046,Tian; Xiaochuan,10,0,15,5
1668083427378,MATH 275,A01,098048,Tian; Xiaochuan,6,0,10,4
1668083427806,MATH 278A,A00,098049,Holst; Michael J,8,0,10,2
1668083428237,MATH 278B,A00,098050,Cloninger; Alexander,10,0,10,0
1668083428663,MATH 278C,A00,098051,Nie; Jiawang,7,0,10,3
1668083429093,MATH 280B,A00,098052,Zheng; Tianyi,10,0,15,5
1668083429517,MATH 281B,A00,098053,Bradic; Jelena,3,0,15,12
1668083429945,MATH 282B,A00,098054,Arias-Castro; Ery,0,0,15,15
1668083430372,MATH 285,A00,098055,Fitzsimmons; Patrick J,0,0,15,17
1668083430803,MATH 287B,A00,098056,Arias-Castro; Ery,3,0,15,12
1668083431231,MATH 288,A00,098057,Agarwal; Pooja,9,0,10,1
1668083431231,MATH 288,B00,098058,Zhang; Danna,8,0,10,2
1668083431231,MATH 288,C00,098059,Williams; Ruth J,10,0,10,0
1668083431663,MATH 290B,A00,098060,Roberts; Justin Deritter,13,0,15,2
1668083432091,MATH 292,A00,098061,Belmont; Eva Kinoshita,10,0,10,0
1668083432519,MATH 295,A00,098062,Suk; Andrew Hoon,48,0,50,2
1668083432945,MATH 296,A00,098063,Novak; Jonathan I,20,0,20,0
1668083433374,MATH 297,001,098064,Gamst; Anthony Collins,9997,0,9999,2
1668083936373,COGS 205,A00,101395,Chiba; Andrea,19,0,20,1
1668083936802,COGS 210B,001,101404,Greene; Deanna Jacquelyn,9998,0,9999,1
1668083936802,COGS 210B,002,101417,Xia; Haijun,9999,0,9999,0
1668083936802,COGS 210B,003,101422,Nitz; Douglas A.,9999,0,9999,0
1668083936802,COGS 210B,004,101423,Hollan; James D.,9998,0,9999,1
1668083936802,COGS 210B,005,101424,Deak; Gedeon O.,9998,0,9999,1
1668083936802,COGS 210B,006,101425,Rossano; Federico,9999,0,9999,0
1668083937228,COGS 211B,A00,101427,Coulson; Seana M,9996,0,9999,3
1668083937652,COGS 220,A00,101428,Hollan; James D.,0,0,25,25
1668083938094,COGS 229,A00,101429,Dow; Steven P,18,0,25,7
1668083938518,COGS 230,A00,101430,Klemmer; Scott R,13,0,17,4
1668083938942,COGS 234,A00,101431,Xia; Haijun,3,0,25,22
1668083939383,COGS 260,A00,101432,Kiyonaga; Anastasia,19,0,25,6
1668083939383,COGS 260,B00,101433,Kirsh; David Joel,16,0,25,9
1668083939811,CSE 202,A00,102371,Impagliazzo; Russell,0,0,0,0
1668083940242,CSE 203B,A01,102373,Cheng; Chung Kuan,0,0,0,0
1668083940668,CSE 208,A00,102374,Micciancio; Daniele,0,0,0,0
1668083941094,CSE 209A,A00,112895,Impagliazzo; Russell,0,0,15,15
1668083941526,CSE 209B,A00,108005,Bellare; Mihir,0,0,0,0
1668083941958,CSE 210,A00,113163,Coblenz; Michael J,0,0,0,0
1668083942392,CSE 219,A00,106111,Dow; Steven P,0,0,20,20
1668083942831,CSE 221,A00,102376,Voelker; Geoffrey M.,0,0,0,0
1668083943262,CSE 224,A01,102378,Porter; George M,0,0,0,0
1668083943693,CSE 229A,A00,102379,Savage; Stefan,0,0,0,0
1668083944119,CSE 229C,A00,102380,Munyaka; Imani N. S.,0,0,0,0
1668083944546,CSE 232B,A00,102382,Deutsch; Alin Bernard,0,0,0,0
1668083944980,CSE 234,A01,112904,Kumar; Arun Kumar,0,0,0,0
1668083945409,CSE 237A,A00,102383,Rosing; Tajana Simunic,0,0,0,0
1668083945835,CSE 239A,A00,102384,Deutsch; Alin Bernard,0,0,0,0
1668083946260,CSE 239B,A00,102385,Polikarpova; Nadezhda,0,0,0,0
1668083946685,CSE 240A,A00,102386,Pannuto; Patrick William,0,0,0,0
1668083947111,CSE 240B,A00,102387,Zhao; Jishen,0,0,0,0
1668083947537,CSE 241A,A00,106406,Kang; Mingu,0,0,0,0
1668083947966,CSE 249B,A00,102388,Kahng; Andrew Byun,0,0,8,8
1668083948398,CSE 251B,A01,102392,Cottrell; Garrison W,0,0,0,0
1668083948398,CSE 251B,A02,102393,Cottrell; Garrison W,0,0,0,0
1668083948825,CSE 252B,A00,102394,Ochoa; Benjamin Lawrence,0,0,0,0
1668083949255,CSE 257,A01,102396,Gao; Sicun,0,0,0,0
1668083949682,CSE 272,A00,102397,Li; Tzumao,0,0,0,0
1668083950109,CSE 274,A00,111323,Chern; Albert Ren-Haur,0,0,0,0
1668083950538,CSE 282,A00,102398,Pevzner; Pavel Arkadjevich,0,0,0,0
1668083950972,CSE 284,A00,114175,Gymrek; Melissa Ann,0,0,0,0
1668083951400,CSE 290,A00,102399,Chandraker; Manmohan Krishna,0,0,0,0
1668083951400,CSE 290,B00,102400,Vaccaro; Kristen Marie,0,0,25,25
1668083951400,CSE 290,C00,102414,Pannuto; Patrick William,0,0,25,25
1668083951400,CSE 290,D00,102427,Pevzner; Pavel Arkadjevich,0,0,0,0
1668083951400,CSE 290,E00,102429,Zhao; Jishen,0,0,0,0
1668083951400,CSE 290,F00,102436,Tullsen; Dean Michael,0,0,0,0
1668083951400,CSE 290,G00,102440,Christensen; Henrik I,0,0,20,20
1668083951830,CSE 291,A00,102443,Su; Hao,0,0,0,0
1668083951830,CSE 291,B00,102448,Polikarpova; Nadezhda,0,0,0,0
1668083951830,CSE 291,C00,102453,Vaccaro; Kristen Marie,0,0,0,0
1668083951830,CSE 291,D00,111343,Savage; Stefan,0,0,0,0
1668083951830,CSE 291,E00,116474,Claffy; Kimberly Claire,0,0,0,0
1668083951830,CSE 291,F00,116479,Pasquale; Joseph,0,0,0,0
1668083952282,CSE 293,001,119111,Bafna; Vineet,9999,0,9999,0
1668083952282,CSE 293,002,119118,Bellare; Mihir,9999,0,9999,0
1668083952282,CSE 293,003,119122,Berg-Kirkpatrick; Taylor D,9999,0,9999,0
1668083952282,CSE 293,004,119135,Christensen; Henrik I,9999,0,9999,0
1668083952282,CSE 293,005,119142,Cottrell; Garrison W,9999,0,9999,0
1668083952282,CSE 293,006,119146,Deutsch; Alin Bernard,9999,0,9999,0
1668083952282,CSE 293,007,119159,Esmaeilzadeh; Hadi,9999,0,9999,0
1668083952282,CSE 293,008,119166,Freund; Yoav,9999,0,9999,0
1668083952282,CSE 293,009,119170,Griswold; William G.,9999,0,9999,0
1668083952282,CSE 293,010,119183,Gymrek; Melissa Ann,9999,0,9999,0
1668083952282,CSE 293,011,119190,Heninger; Nadia A,9999,0,9999,0
1668083952282,CSE 293,012,119230,Impagliazzo; Russell,9999,0,9999,0
1668083952282,CSE 293,013,119232,Jhala; Ranjit,9999,0,9999,0
1668083952282,CSE 293,014,119233,Kahng; Andrew Byun,9999,0,9999,0
1668083952282,CSE 293,015,119298,Kane; Daniel Mertz,9999,0,9999,0
1668083952282,CSE 293,016,119299,Kriegman; David J,9999,0,9999,0
1668083952282,CSE 293,017,119300,Kumar; Arun Kumar,9999,0,9999,0
1668083952282,CSE 293,018,119301,Lerner; Sorin,9999,0,9999,0
1668083952282,CSE 293,019,119302,Lovett; Shachar,9999,0,9999,0
1668083952282,CSE 293,020,119303,McAuley; Julian John,9999,0,9999,0
1668083952282,CSE 293,021,119304,Micciancio; Daniele,9999,0,9999,0
1668083952282,CSE 293,022,119367,Orailoglu; Alex,9999,0,9999,0
1668083952282,CSE 293,023,119382,Paturi; Ramamohan,9999,0,9999,0
1668083952282,CSE 293,024,119404,Polikarpova; Nadezhda,9999,0,9999,0
1668083952282,CSE 293,025,119406,Politz; Joseph Gibbs,9999,0,9999,0
1668083952282,CSE 293,026,119411,Porter; George M,9999,0,9999,0
1668083952282,CSE 293,027,119414,Porter; Leonard Emerson,9999,0,9999,0
1668083952282,CSE 293,028,119416,Ramamoorthi; Ravi,9999,0,9999,0
1668083952282,CSE 293,029,119417,Sahoo; Debashis,9999,0,9999,0
1668083952282,CSE 293,030,119420,Saul; Lawrence,9999,0,9999,0
1668083952282,CSE 293,031,119421,Savage; Stefan,9999,0,9999,0
1668083952282,CSE 293,032,119425,Schulze; Jurgen P.,9999,0,9999,0
1668083952282,CSE 293,033,119426,Snoeren; Alex C.,9999,0,9999,0
1668083952282,CSE 293,034,119428,Shang; Jingbo,9999,0,9999,0
1668083952282,CSE 293,035,119430,Stefan; Deian,9999,0,9999,0
1668083952282,CSE 293,036,119431,Su; Hao,9999,0,9999,0
1668083952282,CSE 293,037,119433,Swanson; Steven James,9999,0,9999,0
1668083952282,CSE 293,038,119435,Tullsen; Dean Michael,9999,0,9999,0
1668083952282,CSE 293,039,119483,Voelker; Geoffrey M.,9999,0,9999,0
1668083952282,CSE 293,040,119537,Zhao; Jishen,9999,0,9999,0
1668083952282,CSE 293,041,119538,Zhou; Yuan-Yuan,9999,0,9999,0
1668083952282,CSE 293,042,119539,Gao; Sicun,9999,0,9999,0
1668083952282,CSE 293,043,119540,Weibel; Nadir,9999,0,9999,0
1668083952282,CSE 293,044,119541,Gupta; Rajesh K.,9999,0,9999,0
1668083952282,CSE 293,045,126410,Vaccaro; Kristen Marie,9999,0,9999,0
1668083952282,CSE 293,046,126411,Klemke; Richard,9999,0,9999,0
1668083952714,CSE 294,A00,102459,Voelker; Geoffrey M.,0,0,0,0
1668083952714,CSE 294,B00,111322,Orailoglu; Alex,0,0,0,0
1668083953144,DSE 201,A00,096914,Deutsch; Alin Bernard,30,0,30,0
1668083953570,DSE 210,A00,096915,Dasgupta; Sanjoy,30,0,30,0
1668083953996,DSE 260A,A00,096916,Altintas De Callaf; Ilkay,30,0,30,0
1668083954465,ECE 200,001,103586,Antipa; Nicholas A,9999,0,9999,0
1668083954465,ECE 200,002,103587,Atanasov; Nikolay A.,9999,0,9999,0
1668083954465,ECE 200,003,103588,Bharadia; Dinesh,9999,0,9999,0
1668083954465,ECE 200,004,103589,Cheng; Chung Kuan,9999,0,9999,0
1668083954465,ECE 200,005,103590,Cosman; Pamela C.,9999,0,9999,0
1668083954465,ECE 200,006,103591,Dayeh; Shadi Ahmad,9999,0,9999,0
1668083954465,ECE 200,007,103592,Fainman; Yeshaiahu,9999,0,9999,0
1668083954465,ECE 200,008,103593,Ford; Joseph Earl,9999,0,9999,0
1668083954465,ECE 200,009,103594,Franceschetti; Massimo,9999,0,9999,0
1668083954465,ECE 200,010,103595,Fullerton; Eric E,9999,0,9999,0
1668083954465,ECE 200,011,103596,Galton; Ian A,9999,0,9999,0
1668083954465,ECE 200,012,103597,Gilja; Vikash,9999,0,9999,0
1668083954465,ECE 200,013,103598,Hall; Drew A.,9999,0,9999,0
1668083954465,ECE 200,014,103599,Hsueh; Tzu-Chien,9999,0,9999,0
1668083954465,ECE 200,015,103600,Javidi; Tara,9999,0,9999,0
1668083954465,ECE 200,016,103601,Kahng; Andrew Byun,9999,0,9999,0
1668083954465,ECE 200,017,103602,Kim; Young-Han,9999,0,9999,0
1668083954465,ECE 200,018,103603,Koushanfar; Farinaz,9999,0,9999,0
1668083954465,ECE 200,019,103604,Kuzum; Duygu,9999,0,9999,0
1668083954465,ECE 200,020,103605,Le; Hanh-Phuc,9999,0,9999,0
1668083954465,ECE 200,021,103606,Lin; Bill,9999,0,9999,0
1668083954465,ECE 200,022,103607,Liu; Zhaowei,9998,0,9999,1
1668083954465,ECE 200,023,103608,Lo; Yu-Hwa,9999,0,9999,0
1668083954465,ECE 200,024,103609,Lomakin; Vitaliy,9999,0,9999,0
1668083954465,ECE 200,025,103610,Mercier; Patrick Philip,9999,0,9999,0
1668083954465,ECE 200,026,103611,Meyer; Florian,9999,0,9999,0
1668083954465,ECE 200,027,103612,Milstein; Laurence B.,9999,0,9999,0
1668083954465,ECE 200,028,103613,Mir Arabbaygi; Siavash,9999,0,9999,0
1668083954465,ECE 200,029,103614,Mookherjea; Shayan,9999,0,9999,0
1668083954465,ECE 200,030,103615,Morris; Karcher William,9999,0,9999,0
1668083954465,ECE 200,031,103616,Ng; Tse Nga,9999,0,9999,0
1668083954465,ECE 200,032,103617,Nguyen; Truong Quang,9999,0,9999,0
1668083954465,ECE 200,033,103618,Nomura; Kenji,9999,0,9999,0
1668083954465,ECE 200,034,103619,Orlitsky; Alon,9999,0,9999,0
1668083954465,ECE 200,035,103620,Pal; Piya,9999,0,9999,0
1668083954465,ECE 200,036,103621,Papen; George C.,9999,0,9999,0
1668083954465,ECE 200,037,103622,Radic; Stojan,9999,0,9999,0
1668083954465,ECE 200,038,103623,Rao; Bhaskar D.,9999,0,9999,0
1668083954465,ECE 200,039,103624,Rao; Ramesh R,9999,0,9999,0
1668083954465,ECE 200,040,103625,Rebeiz; Gabriel,9999,0,9999,0
1668083954465,ECE 200,041,103626,Sanford; John R,9999,0,9999,0
1668083954465,ECE 200,042,103627,Siegel; Paul H.,9999,0,9999,0
1668083954465,ECE 200,043,103628,Sievenpiper; Daniel F.,9999,0,9999,0
1668083954465,ECE 200,044,103629,Sworder; David D.,9999,0,9999,0
1668083954465,ECE 200,045,103630,Taur; Yuan,9999,0,9999,0
1668083954465,ECE 200,046,103631,Touri; Behrouz,9999,0,9999,0
1668083954465,ECE 200,047,103632,Trivedi; Mohan M.,9999,0,9999,0
1668083954465,ECE 200,048,103633,Vasconcelos; Nuno,9999,0,9999,0
1668083954465,ECE 200,049,103634,Wang; Xiaolong,9999,0,9999,0
1668083954465,ECE 200,050,103635,Xie; Pengtao,9999,0,9999,0
1668083954465,ECE 200,051,103636,Yip; Michael,9999,0,9999,0
1668083954465,ECE 200,052,103637,Zeger; Kenneth A.,999,0,999,0
1668083954465,ECE 200,053,103638,Zhang; Xinyu,9999,0,9999,0
1668083954465,ECE 200,054,103639,Turakhia; Yatish Girish,9999,0,9999,0
1668083954465,ECE 200,055,103640,Kang; Mingu,9999,0,9999,0
1668083954465,ECE 200,056,103641,Shi; Yuanyuan,9999,0,9999,0
1668083954465,ECE 200,057,103642,Wang; Edward Jay,9999,0,9999,0
1668083954465,ECE 200,058,103643,Zheng; Yang,9999,0,9999,0
1668083954894,ECE 202,A00,103644,Kuzum; Duygu,0,0,0,0
1668083955322,ECE 212BN,A00,103646,Ng; Tse Nga,0,0,0,0
1668083955746,ECE 221,A00,111493,Staff,0,0,0,0
1668083956173,ECE 222B,A00,103647,Lomakin; Vitaliy,0,0,0,0
1668083956600,ECE 230B,A00,103648,Taur; Yuan,0,0,0,0
1668083957032,ECE 238B,A00,103649,Garay; Javier,0,0,0,0
1668083957458,ECE 240B,A00,112900,Fainman; Yeshaiahu,0,0,0,0
1668083957885,ECE 247A,A00,103650,Jokerst; Jesse Vincent,0,0,0,0
1668083958314,ECE 247B,A00,103651,Wang; Joseph,0,0,0,0
1668083958745,ECE 250,A00,103652,Siegel; Paul H.,0,0,0,0
1668083959179,ECE 251A,A00,103654,Rao; Bhaskar D.,0,0,0,0
1668083959606,ECE 257B,A00,103655,Bharadia; Dinesh,0,0,0,0
1668083960031,ECE 258A,A00,103656,Milstein; Laurence B.,0,0,0,0
1668083960456,ECE 260B,A00,103658,Kang; Mingu,0,0,0,0
1668083960885,ECE 264A,A00,103659,Galton; Ian A,0,0,0,0
1668083961324,ECE 265A,A00,103661,Gudem; Prasad S.S.,0,0,0,0
1668083961748,ECE 265D,A00,103662,Gudem; Prasad S.S.,0,0,0,0
1668083962174,ECE 268,A00,103663,Koushanfar; Farinaz,0,0,0,0
1668083962600,ECE 269,A01,103665,Pal; Piya,0,0,0,0
1668083963028,ECE 271B,A00,103666,Vasconcelos; Manuela,0,0,0,0
1668083963455,ECE 276A,A00,103667,Atanasov; Nikolay A.,0,0,0,0
1668083963888,ECE 277,A00,103668,An; Cheolhong,0,0,0,0
1668083964316,ECE 279,A00,117947,Hall; Drew A.,0,0,0,0
1668083965174,ECE 283,A00,103670,Hsueh; Tzu-Chien,0,0,0,0
1668083965600,ECE 284,A00,103671,Turakhia; Yatish Girish,0,0,0,0
1668083966035,ECE 285,A00,103672,Zheng; Yang,0,0,0,0
1668083966035,ECE 285,B00,103673,Sworder; David D.,0,0,0,0
1668083966464,ECE 287,A00,103676,Javidi; Tara,0,0,0,0
1668083966891,MATH 200B,A00,098023,Salehi Golsefidy; Alireza,13,0,15,2
1668083967324,MATH 202B,A00,098024,Rhoades; Brendon Patrick,9,0,15,6
1668083967749,MATH 203B,A00,098025,Oprea; Dragos N.,10,0,15,5
1668083968178,MATH 204B,A00,098026,Sorensen; Claus M,13,0,15,2
1668083968607,MATH 208,A00,098027,Izadi; Elham,7,0,10,3
1668083969034,MATH 209,A00,098028,Pollack; Aaron,10,0,10,0
1668083969460,MATH 211A,A00,112919,Rogalski; Daniel,9,0,10,1
1668083969886,MATH 211B,A00,112920,Seward; Brandon M.,9,0,10,1
1668083970330,MATH 218,A00,098029,Li; Bo,10,0,10,0
1668083970761,MATH 220B,A00,098030,Novak; Jonathan I,12,0,15,3
1668083971191,MATH 221A,A00,098031,Ebenfelt; Peter F,13,0,15,2
1668083971617,MATH 231B,A00,098032,Zlatos; Andrej,12,0,15,3
1668083972046,MATH 240B,A00,098033,Ni; Lei,9,0,15,6
1668083972548,MATH 243,A00,098034,Jekel; David Andrew,10,0,10,0
1668083972973,MATH 245A,A00,098035,Nie; Jiawang,0,0,15,16
1668083973403,MATH 248,A00,098036,Bejenaru; Ioan,10,0,10,0
1668083973835,MATH 250B,A00,098037,Spolaor; Luca,14,0,15,1
1668083974260,MATH 258,A00,098038,Ni; Lei,10,0,10,0
1668083974685,MATH 264B,A00,098041,Rhoades; Brendon Patrick,10,0,15,5
1668083975119,MATH 268,A00,098042,Buss; Samuel R,10,0,10,0
1668083975556,MATH 269,A00,098043,Rhoades; Brendon Patrick,10,0,10,0
1668083975982,MATH 270B,A00,098044,Li; Bo,11,0,15,4
1668083976415,MATH 272B,A00,098045,Holst; Michael J,13,0,15,2
1668083976840,MATH 273A,A00,098046,Tian; Xiaochuan,10,0,15,5
1668083977265,MATH 275,A01,098048,Tian; Xiaochuan,6,0,10,4
1668083977692,MATH 278A,A00,098049,Holst; Michael J,8,0,10,2
1668083978117,MATH 278B,A00,098050,Cloninger; Alexander,10,0,10,0
1668083978547,MATH 278C,A00,098051,Nie; Jiawang,7,0,10,3
1668083978975,MATH 280B,A00,098052,Zheng; Tianyi,10,0,15,5
1668083979403,MATH 281B,A00,098053,Bradic; Jelena,3,0,15,12
1668083979828,MATH 282B,A00,098054,Arias-Castro; Ery,0,0,15,15
1668083980256,MATH 285,A00,098055,Fitzsimmons; Patrick J,0,0,15,17
1668083980681,MATH 287B,A00,098056,Arias-Castro; Ery,3,0,15,12
1668083981108,MATH 288,A00,098057,Agarwal; Pooja,9,0,10,1
1668083981108,MATH 288,B00,098058,Zhang; Danna,8,0,10,2
1668083981108,MATH 288,C00,098059,Williams; Ruth J,10,0,10,0
1668083981539,MATH 290B,A00,098060,Roberts; Justin Deritter,13,0,15,2
1668083981966,MATH 292,A00,098061,Belmont; Eva Kinoshita,10,0,10,0
1668083982406,MATH 295,A00,098062,Suk; Andrew Hoon,48,0,50,2
1668083982831,MATH 296,A00,098063,Novak; Jonathan I,20,0,20,0
1668083983259,MATH 297,001,098064,Gamst; Anthony Collins,9997,0,9999,2
1668084488647,COGS 205,A00,101395,Chiba; Andrea,19,0,20,1
1668084489076,COGS 210B,001,101404,Greene; Deanna Jacquelyn,9998,0,9999,1
1668084489076,COGS 210B,002,101417,Xia; Haijun,9999,0,9999,0
1668084489076,COGS 210B,003,101422,Nitz; Douglas A.,9999,0,9999,0
1668084489076,COGS 210B,004,101423,Hollan; James D.,9998,0,9999,1
1668084489076,COGS 210B,005,101424,Deak; Gedeon O.,9998,0,9999,1
1668084489076,COGS 210B,006,101425,Rossano; Federico,9999,0,9999,0
1668084489507,COGS 211B,A00,101427,Coulson; Seana M,9996,0,9999,3
1668084489931,COGS 220,A00,101428,Hollan; James D.,0,0,25,25
1668084490357,COGS 229,A00,101429,Dow; Steven P,18,0,25,7
1668084490782,COGS 230,A00,101430,Klemmer; Scott R,13,0,17,4
1668084491207,COGS 234,A00,101431,Xia; Haijun,3,0,25,22
1668084491633,COGS 260,A00,101432,Kiyonaga; Anastasia,19,0,25,6
1668084491633,COGS 260,B00,101433,Kirsh; David Joel,16,0,25,9
1668084492066,CSE 202,A00,102371,Impagliazzo; Russell,0,0,0,0
1668084492498,CSE 203B,A01,102373,Cheng; Chung Kuan,0,0,0,0
1668084492925,CSE 208,A00,102374,Micciancio; Daniele,0,0,0,0
1668084493351,CSE 209A,A00,112895,Impagliazzo; Russell,0,0,15,15
1668084493779,CSE 209B,A00,108005,Bellare; Mihir,0,0,0,0
1668084494207,CSE 210,A00,113163,Coblenz; Michael J,0,0,0,0
1668084494633,CSE 219,A00,106111,Dow; Steven P,0,0,20,20
1668084495064,CSE 221,A00,102376,Voelker; Geoffrey M.,0,0,0,0
1668084495491,CSE 224,A01,102378,Porter; George M,0,0,0,0
1668084495915,CSE 229A,A00,102379,Savage; Stefan,0,0,0,0
1668084496342,CSE 229C,A00,102380,Munyaka; Imani N. S.,0,0,0,0
1668084496769,CSE 232B,A00,102382,Deutsch; Alin Bernard,0,0,0,0
1668084497199,CSE 234,A01,112904,Kumar; Arun Kumar,0,0,0,0
1668084497625,CSE 237A,A00,102383,Rosing; Tajana Simunic,0,0,0,0
1668084498126,CSE 239A,A00,102384,Deutsch; Alin Bernard,0,0,0,0
1668084498551,CSE 239B,A00,102385,Polikarpova; Nadezhda,0,0,0,0
1668084498981,CSE 240A,A00,102386,Pannuto; Patrick William,0,0,0,0
1668084499407,CSE 240B,A00,102387,Zhao; Jishen,0,0,0,0
1668084499833,CSE 241A,A00,106406,Kang; Mingu,0,0,0,0
1668084500258,CSE 249B,A00,102388,Kahng; Andrew Byun,0,0,8,8
1668084500685,CSE 251B,A01,102392,Cottrell; Garrison W,0,0,0,0
1668084500685,CSE 251B,A02,102393,Cottrell; Garrison W,0,0,0,0
1668084501114,CSE 252B,A00,102394,Ochoa; Benjamin Lawrence,0,0,0,0
1668084501539,CSE 257,A01,102396,Gao; Sicun,0,0,0,0
1668084501966,CSE 272,A00,102397,Li; Tzumao,0,0,0,0
1668084502392,CSE 274,A00,111323,Chern; Albert Ren-Haur,0,0,0,0
1668084502820,CSE 282,A00,102398,Pevzner; Pavel Arkadjevich,0,0,0,0
1668084503245,CSE 284,A00,114175,Gymrek; Melissa Ann,0,0,0,0
1668084503671,CSE 290,A00,102399,Chandraker; Manmohan Krishna,0,0,0,0
1668084503671,CSE 290,B00,102400,Vaccaro; Kristen Marie,0,0,25,25
1668084503671,CSE 290,C00,102414,Pannuto; Patrick William,0,0,25,25
1668084503671,CSE 290,D00,102427,Pevzner; Pavel Arkadjevich,0,0,0,0
1668084503671,CSE 290,E00,102429,Zhao; Jishen,0,0,0,0
1668084503671,CSE 290,F00,102436,Tullsen; Dean Michael,0,0,0,0
1668084503671,CSE 290,G00,102440,Christensen; Henrik I,0,0,20,20
1668084504102,CSE 291,A00,102443,Su; Hao,0,0,0,0
1668084504102,CSE 291,B00,102448,Polikarpova; Nadezhda,0,0,0,0
1668084504102,CSE 291,C00,102453,Vaccaro; Kristen Marie,0,0,0,0
1668084504102,CSE 291,D00,111343,Savage; Stefan,0,0,0,0
1668084504102,CSE 291,E00,116474,Claffy; Kimberly Claire,0,0,0,0
1668084504102,CSE 291,F00,116479,Pasquale; Joseph,0,0,0,0
1668084504545,CSE 293,001,119111,Bafna; Vineet,9999,0,9999,0
1668084504545,CSE 293,002,119118,Bellare; Mihir,9999,0,9999,0
1668084504545,CSE 293,003,119122,Berg-Kirkpatrick; Taylor D,9999,0,9999,0
1668084504545,CSE 293,004,119135,Christensen; Henrik I,9999,0,9999,0
1668084504545,CSE 293,005,119142,Cottrell; Garrison W,9999,0,9999,0
1668084504545,CSE 293,006,119146,Deutsch; Alin Bernard,9999,0,9999,0
1668084504545,CSE 293,007,119159,Esmaeilzadeh; Hadi,9999,0,9999,0
1668084504545,CSE 293,008,119166,Freund; Yoav,9999,0,9999,0
1668084504545,CSE 293,009,119170,Griswold; William G.,9999,0,9999,0
1668084504545,CSE 293,010,119183,Gymrek; Melissa Ann,9999,0,9999,0
1668084504545,CSE 293,011,119190,Heninger; Nadia A,9999,0,9999,0
1668084504545,CSE 293,012,119230,Impagliazzo; Russell,9999,0,9999,0
1668084504545,CSE 293,013,119232,Jhala; Ranjit,9999,0,9999,0
1668084504545,CSE 293,014,119233,Kahng; Andrew Byun,9999,0,9999,0
1668084504545,CSE 293,015,119298,Kane; Daniel Mertz,9999,0,9999,0
1668084504545,CSE 293,016,119299,Kriegman; David J,9999,0,9999,0
1668084504545,CSE 293,017,119300,Kumar; Arun Kumar,9999,0,9999,0
1668084504545,CSE 293,018,119301,Lerner; Sorin,9999,0,9999,0
1668084504545,CSE 293,019,119302,Lovett; Shachar,9999,0,9999,0
1668084504545,CSE 293,020,119303,McAuley; Julian John,9999,0,9999,0
1668084504545,CSE 293,021,119304,Micciancio; Daniele,9999,0,9999,0
1668084504545,CSE 293,022,119367,Orailoglu; Alex,9999,0,9999,0
1668084504545,CSE 293,023,119382,Paturi; Ramamohan,9999,0,9999,0
1668084504545,CSE 293,024,119404,Polikarpova; Nadezhda,9999,0,9999,0
1668084504545,CSE 293,025,119406,Politz; Joseph Gibbs,9999,0,9999,0
1668084504545,CSE 293,026,119411,Porter; George M,9999,0,9999,0
1668084504545,CSE 293,027,119414,Porter; Leonard Emerson,9999,0,9999,0
1668084504545,CSE 293,028,119416,Ramamoorthi; Ravi,9999,0,9999,0
1668084504545,CSE 293,029,119417,Sahoo; Debashis,9999,0,9999,0
1668084504545,CSE 293,030,119420,Saul; Lawrence,9999,0,9999,0
1668084504545,CSE 293,031,119421,Savage; Stefan,9999,0,9999,0
1668084504545,CSE 293,032,119425,Schulze; Jurgen P.,9999,0,9999,0
1668084504545,CSE 293,033,119426,Snoeren; Alex C.,9999,0,9999,0
1668084504545,CSE 293,034,119428,Shang; Jingbo,9999,0,9999,0
1668084504545,CSE 293,035,119430,Stefan; Deian,9999,0,9999,0
1668084504545,CSE 293,036,119431,Su; Hao,9999,0,9999,0
1668084504545,CSE 293,037,119433,Swanson; Steven James,9999,0,9999,0
1668084504545,CSE 293,038,119435,Tullsen; Dean Michael,9999,0,9999,0
1668084504545,CSE 293,039,119483,Voelker; Geoffrey M.,9999,0,9999,0
1668084504545,CSE 293,040,119537,Zhao; Jishen,9999,0,9999,0
1668084504545,CSE 293,041,119538,Zhou; Yuan-Yuan,9999,0,9999,0
1668084504545,CSE 293,042,119539,Gao; Sicun,9999,0,9999,0
1668084504545,CSE 293,043,119540,Weibel; Nadir,9999,0,9999,0
1668084504545,CSE 293,044,119541,Gupta; Rajesh K.,9999,0,9999,0
1668084504545,CSE 293,045,126410,Vaccaro; Kristen Marie,9999,0,9999,0
1668084504545,CSE 293,046,126411,Klemke; Richard,9999,0,9999,0
1668084504970,CSE 294,A00,102459,Voelker; Geoffrey M.,0,0,0,0
1668084504970,CSE 294,B00,111322,Orailoglu; Alex,0,0,0,0
1668084505398,DSE 201,A00,096914,Deutsch; Alin Bernard,30,0,30,0
1668084505824,DSE 210,A00,096915,Dasgupta; Sanjoy,30,0,30,0
1668084506249,DSE 260A,A00,096916,Altintas De Callaf; Ilkay,30,0,30,0
1668084506701,ECE 200,001,103586,Antipa; Nicholas A,9999,0,9999,0
1668084506701,ECE 200,002,103587,Atanasov; Nikolay A.,9999,0,9999,0
1668084506701,ECE 200,003,103588,Bharadia; Dinesh,9999,0,9999,0
1668084506701,ECE 200,004,103589,Cheng; Chung Kuan,9999,0,9999,0
1668084506701,ECE 200,005,103590,Cosman; Pamela C.,9999,0,9999,0
1668084506701,ECE 200,006,103591,Dayeh; Shadi Ahmad,9999,0,9999,0
1668084506701,ECE 200,007,103592,Fainman; Yeshaiahu,9999,0,9999,0
1668084506701,ECE 200,008,103593,Ford; Joseph Earl,9999,0,9999,0
1668084506701,ECE 200,009,103594,Franceschetti; Massimo,9999,0,9999,0
1668084506701,ECE 200,010,103595,Fullerton; Eric E,9999,0,9999,0
1668084506701,ECE 200,011,103596,Galton; Ian A,9999,0,9999,0
1668084506701,ECE 200,012,103597,Gilja; Vikash,9999,0,9999,0
1668084506701,ECE 200,013,103598,Hall; Drew A.,9999,0,9999,0
1668084506701,ECE 200,014,103599,Hsueh; Tzu-Chien,9999,0,9999,0
1668084506701,ECE 200,015,103600,Javidi; Tara,9999,0,9999,0
1668084506701,ECE 200,016,103601,Kahng; Andrew Byun,9999,0,9999,0
1668084506701,ECE 200,017,103602,Kim; Young-Han,9999,0,9999,0
1668084506701,ECE 200,018,103603,Koushanfar; Farinaz,9999,0,9999,0
1668084506701,ECE 200,019,103604,Kuzum; Duygu,9999,0,9999,0
1668084506701,ECE 200,020,103605,Le; Hanh-Phuc,9999,0,9999,0
1668084506701,ECE 200,021,103606,Lin; Bill,9999,0,9999,0
1668084506701,ECE 200,022,103607,Liu; Zhaowei,9998,0,9999,1
1668084506701,ECE 200,023,103608,Lo; Yu-Hwa,9999,0,9999,0
1668084506701,ECE 200,024,103609,Lomakin; Vitaliy,9999,0,9999,0
1668084506701,ECE 200,025,103610,Mercier; Patrick Philip,9999,0,9999,0
1668084506701,ECE 200,026,103611,Meyer; Florian,9999,0,9999,0
1668084506701,ECE 200,027,103612,Milstein; Laurence B.,9999,0,9999,0
1668084506701,ECE 200,028,103613,Mir Arabbaygi; Siavash,9999,0,9999,0
1668084506701,ECE 200,029,103614,Mookherjea; Shayan,9999,0,9999,0
1668084506701,ECE 200,030,103615,Morris; Karcher William,9999,0,9999,0
1668084506701,ECE 200,031,103616,Ng; Tse Nga,9999,0,9999,0
1668084506701,ECE 200,032,103617,Nguyen; Truong Quang,9999,0,9999,0
1668084506701,ECE 200,033,103618,Nomura; Kenji,9999,0,9999,0
1668084506701,ECE 200,034,103619,Orlitsky; Alon,9999,0,9999,0
1668084506701,ECE 200,035,103620,Pal; Piya,9999,0,9999,0
1668084506701,ECE 200,036,103621,Papen; George C.,9999,0,9999,0
1668084506701,ECE 200,037,103622,Radic; Stojan,9999,0,9999,0
1668084506701,ECE 200,038,103623,Rao; Bhaskar D.,9999,0,9999,0
1668084506701,ECE 200,039,103624,Rao; Ramesh R,9999,0,9999,0
1668084506701,ECE 200,040,103625,Rebeiz; Gabriel,9999,0,9999,0
1668084506701,ECE 200,041,103626,Sanford; John R,9999,0,9999,0
1668084506701,ECE 200,042,103627,Siegel; Paul H.,9999,0,9999,0
1668084506701,ECE 200,043,103628,Sievenpiper; Daniel F.,9999,0,9999,0
1668084506701,ECE 200,044,103629,Sworder; David D.,9999,0,9999,0
1668084506701,ECE 200,045,103630,Taur; Yuan,9999,0,9999,0
1668084506701,ECE 200,046,103631,Touri; Behrouz,9999,0,9999,0
1668084506701,ECE 200,047,103632,Trivedi; Mohan M.,9999,0,9999,0
1668084506701,ECE 200,048,103633,Vasconcelos; Nuno,9999,0,9999,0
1668084506701,ECE 200,049,103634,Wang; Xiaolong,9999,0,9999,0
1668084506701,ECE 200,050,103635,Xie; Pengtao,9999,0,9999,0
1668084506701,ECE 200,051,103636,Yip; Michael,9999,0,9999,0
1668084506701,ECE 200,052,103637,Zeger; Kenneth A.,999,0,999,0
1668084506701,ECE 200,053,103638,Zhang; Xinyu,9999,0,9999,0
1668084506701,ECE 200,054,103639,Turakhia; Yatish Girish,9999,0,9999,0
1668084506701,ECE 200,055,103640,Kang; Mingu,9999,0,9999,0
1668084506701,ECE 200,056,103641,Shi; Yuanyuan,9999,0,9999,0
1668084506701,ECE 200,057,103642,Wang; Edward Jay,9999,0,9999,0
1668084506701,ECE 200,058,103643,Zheng; Yang,9999,0,9999,0
1668084507125,ECE 202,A00,103644,Kuzum; Duygu,0,0,0,0
1668084507554,ECE 212BN,A00,103646,Ng; Tse Nga,0,0,0,0
1668084507993,ECE 221,A00,111493,Staff,0,0,0,0
1668084508417,ECE 222B,A00,103647,Lomakin; Vitaliy,0,0,0,0
1668084508842,ECE 230B,A00,103648,Taur; Yuan,0,0,0,0
1668084509272,ECE 238B,A00,103649,Garay; Javier,0,0,0,0
1668084509703,ECE 240B,A00,112900,Fainman; Yeshaiahu,0,0,0,0
1668084510133,ECE 247A,A00,103650,Jokerst; Jesse Vincent,0,0,0,0
1668084510559,ECE 247B,A00,103651,Wang; Joseph,0,0,0,0
1668084510998,ECE 250,A00,103652,Siegel; Paul H.,0,0,0,0
1668084511423,ECE 251A,A00,103654,Rao; Bhaskar D.,0,0,0,0
1668084511848,ECE 257B,A00,103655,Bharadia; Dinesh,0,0,0,0
1668084512273,ECE 258A,A00,103656,Milstein; Laurence B.,0,0,0,0
1668084512702,ECE 260B,A00,103658,Kang; Mingu,0,0,0,0
1668084513127,ECE 264A,A00,103659,Galton; Ian A,0,0,0,0
1668084513556,ECE 265A,A00,103661,Gudem; Prasad S.S.,0,0,0,0
1668084513981,ECE 265D,A00,103662,Gudem; Prasad S.S.,0,0,0,0
1668084514405,ECE 268,A00,103663,Koushanfar; Farinaz,0,0,0,0
1668084514838,ECE 269,A01,103665,Pal; Piya,0,0,0,0
1668084515265,ECE 271B,A00,103666,Vasconcelos; Manuela,0,0,0,0
1668084515692,ECE 276A,A00,103667,Atanasov; Nikolay A.,0,0,0,0
1668084516119,ECE 277,A00,103668,An; Cheolhong,0,0,0,0
1668084516548,ECE 279,A00,117947,Hall; Drew A.,0,0,0,0
1668084517401,ECE 283,A00,103670,Hsueh; Tzu-Chien,0,0,0,0
1668084517826,ECE 284,A00,103671,Turakhia; Yatish Girish,0,0,0,0
1668084518255,ECE 285,A00,103672,Zheng; Yang,0,0,0,0
1668084518255,ECE 285,B00,103673,Sworder; David D.,0,0,0,0
1668084518682,ECE 287,A00,103676,Javidi; Tara,0,0,0,0
1668084519128,MATH 200B,A00,098023,Salehi Golsefidy; Alireza,13,0,15,2
1668084519554,MATH 202B,A00,098024,Rhoades; Brendon Patrick,9,0,15,6
1668084519993,MATH 203B,A00,098025,Oprea; Dragos N.,10,0,15,5
1668084520418,MATH 204B,A00,098026,Sorensen; Claus M,13,0,15,2
1668084520841,MATH 208,A00,098027,Izadi; Elham,7,0,10,3
1668084521265,MATH 209,A00,098028,Pollack; Aaron,10,0,10,0
1668084521691,MATH 211A,A00,112919,Rogalski; Daniel,9,0,10,1
1668084522114,MATH 211B,A00,112920,Seward; Brandon M.,9,0,10,1
1668084522543,MATH 218,A00,098029,Li; Bo,10,0,10,0
1668084522970,MATH 220B,A00,098030,Novak; Jonathan I,12,0,15,3
1668084523397,MATH 221A,A00,098031,Ebenfelt; Peter F,13,0,15,2
1668084523823,MATH 231B,A00,098032,Zlatos; Andrej,12,0,15,3
1668084524250,MATH 240B,A00,098033,Ni; Lei,9,0,15,6
1668084524679,MATH 243,A00,098034,Jekel; David Andrew,10,0,10,0
1668084525107,MATH 245A,A00,098035,Nie; Jiawang,0,0,15,16
1668084525532,MATH 248,A00,098036,Bejenaru; Ioan,10,0,10,0
1668084525958,MATH 250B,A00,098037,Spolaor; Luca,14,0,15,1
1668084526385,MATH 258,A00,098038,Ni; Lei,10,0,10,0
1668084526810,MATH 264B,A00,098041,Rhoades; Brendon Patrick,10,0,15,5
1668084527237,MATH 268,A00,098042,Buss; Samuel R,10,0,10,0
1668084527665,MATH 269,A00,098043,Rhoades; Brendon Patrick,10,0,10,0
1668084528093,MATH 270B,A00,098044,Li; Bo,11,0,15,4
1668084528528,MATH 272B,A00,098045,Holst; Michael J,13,0,15,2
1668084528953,MATH 273A,A00,098046,Tian; Xiaochuan,10,0,15,5
1668084529385,MATH 275,A01,098048,Tian; Xiaochuan,6,0,10,4
1668084529811,MATH 278A,A00,098049,Holst; Michael J,8,0,10,2
1668084530237,MATH 278B,A00,098050,Cloninger; Alexander,10,0,10,0
1668084530663,MATH 278C,A00,098051,Nie; Jiawang,7,0,10,3
1668084531093,MATH 280B,A00,098052,Zheng; Tianyi,10,0,15,5
1668084531521,MATH 281B,A00,098053,Bradic; Jelena,3,0,15,12
1668084531946,MATH 282B,A00,098054,Arias-Castro; Ery,0,0,15,15
1668084532372,MATH 285,A00,098055,Fitzsimmons; Patrick J,0,0,15,17
1668084532798,MATH 287B,A00,098056,Arias-Castro; Ery,3,0,15,12
1668084533225,MATH 288,A00,098057,Agarwal; Pooja,9,0,10,1
1668084533225,MATH 288,B00,098058,Zhang; Danna,8,0,10,2
1668084533225,MATH 288,C00,098059,Williams; Ruth J,10,0,10,0
1668084533649,MATH 290B,A00,098060,Roberts; Justin Deritter,13,0,15,2
1668084534078,MATH 292,A00,098061,Belmont; Eva Kinoshita,10,0,10,0
1668084534504,MATH 295,A00,098062,Suk; Andrew Hoon,48,0,50,2
1668084534929,MATH 296,A00,098063,Novak; Jonathan I,20,0,20,0
1668084535355,MATH 297,001,098064,Gamst; Anthony Collins,9997,0,9999,2
1668085037204,COGS 205,A00,101395,Chiba; Andrea,19,0,20,1
1668085037638,COGS 210B,001,101404,Greene; Deanna Jacquelyn,9998,0,9999,1
1668085037638,COGS 210B,002,101417,Xia; Haijun,9999,0,9999,0
1668085037638,COGS 210B,003,101422,Nitz; Douglas A.,9999,0,9999,0
1668085037638,COGS 210B,004,101423,Hollan; James D.,9998,0,9999,1
1668085037638,COGS 210B,005,101424,Deak; Gedeon O.,9998,0,9999,1
1668085037638,COGS 210B,006,101425,Rossano; Federico,9999,0,9999,0
1668085038074,COGS 211B,A00,101427,Coulson; Seana M,9996,0,9999,3
1668085038497,COGS 220,A00,101428,Hollan; James D.,0,0,25,25
1668085038926,COGS 229,A00,101429,Dow; Steven P,18,0,25,7
1668085039350,COGS 230,A00,101430,Klemmer; Scott R,13,0,17,4
1668085039773,COGS 234,A00,101431,Xia; Haijun,3,0,25,22
1668085040210,COGS 260,A00,101432,Kiyonaga; Anastasia,19,0,25,6
1668085040210,COGS 260,B00,101433,Kirsh; David Joel,16,0,25,9
1668085040635,CSE 202,A00,102371,Impagliazzo; Russell,0,0,0,0
1668085041066,CSE 203B,A01,102373,Cheng; Chung Kuan,0,0,0,0
1668085041492,CSE 208,A00,102374,Micciancio; Daniele,0,0,0,0
1668085041917,CSE 209A,A00,112895,Impagliazzo; Russell,0,0,15,15
1668085042344,CSE 209B,A00,108005,Bellare; Mihir,0,0,0,0
1668085042774,CSE 210,A00,113163,Coblenz; Michael J,0,0,0,0
1668085043201,CSE 219,A00,106111,Dow; Steven P,0,0,20,20
1668085043625,CSE 221,A00,102376,Voelker; Geoffrey M.,0,0,0,0
1668085044055,CSE 224,A01,102378,Porter; George M,0,0,0,0
1668085044478,CSE 229A,A00,102379,Savage; Stefan,0,0,0,0
1668085044903,CSE 229C,A00,102380,Munyaka; Imani N. S.,0,0,0,0
1668085045330,CSE 232B,A00,102382,Deutsch; Alin Bernard,0,0,0,0
1668085045756,CSE 234,A01,112904,Kumar; Arun Kumar,0,0,0,0
1668085046190,CSE 237A,A00,102383,Rosing; Tajana Simunic,0,0,0,0
1668085046614,CSE 239A,A00,102384,Deutsch; Alin Bernard,0,0,0,0
1668085047038,CSE 239B,A00,102385,Polikarpova; Nadezhda,0,0,0,0
1668085047461,CSE 240A,A00,102386,Pannuto; Patrick William,0,0,0,0
1668085047888,CSE 240B,A00,102387,Zhao; Jishen,0,0,0,0
1668085048315,CSE 241A,A00,106406,Kang; Mingu,0,0,0,0
1668085048740,CSE 249B,A00,102388,Kahng; Andrew Byun,0,0,8,8
1668085049172,CSE 251B,A01,102392,Cottrell; Garrison W,0,0,0,0
1668085049172,CSE 251B,A02,102393,Cottrell; Garrison W,0,0,0,0
1668085049608,CSE 252B,A00,102394,Ochoa; Benjamin Lawrence,0,0,0,0
1668085050035,CSE 257,A01,102396,Gao; Sicun,0,0,0,0
1668085050476,CSE 272,A00,102397,Li; Tzumao,0,0,0,0
1668085050900,CSE 274,A00,111323,Chern; Albert Ren-Haur,0,0,0,0
1668085051329,CSE 282,A00,102398,Pevzner; Pavel Arkadjevich,0,0,0,0
1668085051763,CSE 284,A00,114175,Gymrek; Melissa Ann,0,0,0,0
1668085052193,CSE 290,A00,102399,Chandraker; Manmohan Krishna,0,0,0,0
1668085052193,CSE 290,B00,102400,Vaccaro; Kristen Marie,0,0,25,25
1668085052193,CSE 290,C00,102414,Pannuto; Patrick William,0,0,25,25
1668085052193,CSE 290,D00,102427,Pevzner; Pavel Arkadjevich,0,0,0,0
1668085052193,CSE 290,E00,102429,Zhao; Jishen,0,0,0,0
1668085052193,CSE 290,F00,102436,Tullsen; Dean Michael,0,0,0,0
1668085052193,CSE 290,G00,102440,Christensen; Henrik I,0,0,20,20
1668085052621,CSE 291,A00,102443,Su; Hao,0,0,0,0
1668085052621,CSE 291,B00,102448,Polikarpova; Nadezhda,0,0,0,0
1668085052621,CSE 291,C00,102453,Vaccaro; Kristen Marie,0,0,0,0
1668085052621,CSE 291,D00,111343,Savage; Stefan,0,0,0,0
1668085052621,CSE 291,E00,116474,Claffy; Kimberly Claire,0,0,0,0
1668085052621,CSE 291,F00,116479,Pasquale; Joseph,0,0,0,0
1668085053073,CSE 293,001,119111,Bafna; Vineet,9999,0,9999,0
1668085053073,CSE 293,002,119118,Bellare; Mihir,9999,0,9999,0
1668085053073,CSE 293,003,119122,Berg-Kirkpatrick; Taylor D,9999,0,9999,0
1668085053073,CSE 293,004,119135,Christensen; Henrik I,9999,0,9999,0
1668085053073,CSE 293,005,119142,Cottrell; Garrison W,9999,0,9999,0
1668085053073,CSE 293,006,119146,Deutsch; Alin Bernard,9999,0,9999,0
1668085053073,CSE 293,007,119159,Esmaeilzadeh; Hadi,9999,0,9999,0
1668085053073,CSE 293,008,119166,Freund; Yoav,9999,0,9999,0
1668085053073,CSE 293,009,119170,Griswold; William G.,9999,0,9999,0
1668085053073,CSE 293,010,119183,Gymrek; Melissa Ann,9999,0,9999,0
1668085053073,CSE 293,011,119190,Heninger; Nadia A,9999,0,9999,0
1668085053073,CSE 293,012,119230,Impagliazzo; Russell,9999,0,9999,0
1668085053073,CSE 293,013,119232,Jhala; Ranjit,9999,0,9999,0
1668085053073,CSE 293,014,119233,Kahng; Andrew Byun,9999,0,9999,0
1668085053073,CSE 293,015,119298,Kane; Daniel Mertz,9999,0,9999,0
1668085053073,CSE 293,016,119299,Kriegman; David J,9999,0,9999,0
1668085053073,CSE 293,017,119300,Kumar; Arun Kumar,9999,0,9999,0
1668085053073,CSE 293,018,119301,Lerner; Sorin,9999,0,9999,0
1668085053073,CSE 293,019,119302,Lovett; Shachar,9999,0,9999,0
1668085053073,CSE 293,020,119303,McAuley; Julian John,9999,0,9999,0
1668085053073,CSE 293,021,119304,Micciancio; Daniele,9999,0,9999,0
1668085053073,CSE 293,022,119367,Orailoglu; Alex,9999,0,9999,0
1668085053073,CSE 293,023,119382,Paturi; Ramamohan,9999,0,9999,0
1668085053073,CSE 293,024,119404,Polikarpova; Nadezhda,9999,0,9999,0
1668085053073,CSE 293,025,119406,Politz; Joseph Gibbs,9999,0,9999,0
1668085053073,CSE 293,026,119411,Porter; George M,9999,0,9999,0
1668085053073,CSE 293,027,119414,Porter; Leonard Emerson,9999,0,9999,0
1668085053073,CSE 293,028,119416,Ramamoorthi; Ravi,9999,0,9999,0
1668085053073,CSE 293,029,119417,Sahoo; Debashis,9999,0,9999,0
1668085053073,CSE 293,030,119420,Saul; Lawrence,9999,0,9999,0
1668085053073,CSE 293,031,119421,Savage; Stefan,9999,0,9999,0
1668085053073,CSE 293,032,119425,Schulze; Jurgen P.,9999,0,9999,0
1668085053073,CSE 293,033,119426,Snoeren; Alex C.,9999,0,9999,0
1668085053073,CSE 293,034,119428,Shang; Jingbo,9999,0,9999,0
1668085053073,CSE 293,035,119430,Stefan; Deian,9999,0,9999,0
1668085053073,CSE 293,036,119431,Su; Hao,9999,0,9999,0
1668085053073,CSE 293,037,119433,Swanson; Steven James,9999,0,9999,0
1668085053073,CSE 293,038,119435,Tullsen; Dean Michael,9999,0,9999,0
1668085053073,CSE 293,039,119483,Voelker; Geoffrey M.,9999,0,9999,0
1668085053073,CSE 293,040,119537,Zhao; Jishen,9999,0,9999,0
1668085053073,CSE 293,041,119538,Zhou; Yuan-Yuan,9999,0,9999,0
1668085053073,CSE 293,042,119539,Gao; Sicun,9999,0,9999,0
1668085053073,CSE 293,043,119540,Weibel; Nadir,9999,0,9999,0
1668085053073,CSE 293,044,119541,Gupta; Rajesh K.,9999,0,9999,0
1668085053073,CSE 293,045,126410,Vaccaro; Kristen Marie,9999,0,9999,0
1668085053073,CSE 293,046,126411,Klemke; Richard,9999,0,9999,0
1668085053498,CSE 294,A00,102459,Voelker; Geoffrey M.,0,0,0,0
1668085053498,CSE 294,B00,111322,Orailoglu; Alex,0,0,0,0
1668085053923,DSE 201,A00,096914,Deutsch; Alin Bernard,30,0,30,0
1668085054348,DSE 210,A00,096915,Dasgupta; Sanjoy,30,0,30,0
1668085054775,DSE 260A,A00,096916,Altintas De Callaf; Ilkay,30,0,30,0
1668085055232,ECE 200,001,103586,Antipa; Nicholas A,9999,0,9999,0
1668085055232,ECE 200,002,103587,Atanasov; Nikolay A.,9999,0,9999,0
1668085055232,ECE 200,003,103588,Bharadia; Dinesh,9999,0,9999,0
1668085055232,ECE 200,004,103589,Cheng; Chung Kuan,9999,0,9999,0
1668085055232,ECE 200,005,103590,Cosman; Pamela C.,9999,0,9999,0
1668085055232,ECE 200,006,103591,Dayeh; Shadi Ahmad,9999,0,9999,0
1668085055232,ECE 200,007,103592,Fainman; Yeshaiahu,9999,0,9999,0
1668085055232,ECE 200,008,103593,Ford; Joseph Earl,9999,0,9999,0
1668085055232,ECE 200,009,103594,Franceschetti; Massimo,9999,0,9999,0
1668085055232,ECE 200,010,103595,Fullerton; Eric E,9999,0,9999,0
1668085055232,ECE 200,011,103596,Galton; Ian A,9999,0,9999,0
1668085055232,ECE 200,012,103597,Gilja; Vikash,9999,0,9999,0
1668085055232,ECE 200,013,103598,Hall; Drew A.,9999,0,9999,0
1668085055232,ECE 200,014,103599,Hsueh; Tzu-Chien,9999,0,9999,0
1668085055232,ECE 200,015,103600,Javidi; Tara,9999,0,9999,0
1668085055232,ECE 200,016,103601,Kahng; Andrew Byun,9999,0,9999,0
1668085055232,ECE 200,017,103602,Kim; Young-Han,9999,0,9999,0
1668085055232,ECE 200,018,103603,Koushanfar; Farinaz,9999,0,9999,0
1668085055232,ECE 200,019,103604,Kuzum; Duygu,9999,0,9999,0
1668085055232,ECE 200,020,103605,Le; Hanh-Phuc,9999,0,9999,0
1668085055232,ECE 200,021,103606,Lin; Bill,9999,0,9999,0
1668085055232,ECE 200,022,103607,Liu; Zhaowei,9998,0,9999,1
1668085055232,ECE 200,023,103608,Lo; Yu-Hwa,9999,0,9999,0
1668085055232,ECE 200,024,103609,Lomakin; Vitaliy,9999,0,9999,0
1668085055232,ECE 200,025,103610,Mercier; Patrick Philip,9999,0,9999,0
1668085055232,ECE 200,026,103611,Meyer; Florian,9999,0,9999,0
1668085055232,ECE 200,027,103612,Milstein; Laurence B.,9999,0,9999,0
1668085055232,ECE 200,028,103613,Mir Arabbaygi; Siavash,9999,0,9999,0
1668085055232,ECE 200,029,103614,Mookherjea; Shayan,9999,0,9999,0
1668085055232,ECE 200,030,103615,Morris; Karcher William,9999,0,9999,0
1668085055232,ECE 200,031,103616,Ng; Tse Nga,9999,0,9999,0
1668085055232,ECE 200,032,103617,Nguyen; Truong Quang,9999,0,9999,0
1668085055232,ECE 200,033,103618,Nomura; Kenji,9999,0,9999,0
1668085055232,ECE 200,034,103619,Orlitsky; Alon,9999,0,9999,0
1668085055232,ECE 200,035,103620,Pal; Piya,9999,0,9999,0
1668085055232,ECE 200,036,103621,Papen; George C.,9999,0,9999,0
1668085055232,ECE 200,037,103622,Radic; Stojan,9999,0,9999,0
1668085055232,ECE 200,038,103623,Rao; Bhaskar D.,9999,0,9999,0
1668085055232,ECE 200,039,103624,Rao; Ramesh R,9999,0,9999,0
1668085055232,ECE 200,040,103625,Rebeiz; Gabriel,9999,0,9999,0
1668085055232,ECE 200,041,103626,Sanford; John R,9999,0,9999,0
1668085055232,ECE 200,042,103627,Siegel; Paul H.,9999,0,9999,0
1668085055232,ECE 200,043,103628,Sievenpiper; Daniel F.,9999,0,9999,0
1668085055232,ECE 200,044,103629,Sworder; David D.,9999,0,9999,0
1668085055232,ECE 200,045,103630,Taur; Yuan,9999,0,9999,0
1668085055232,ECE 200,046,103631,Touri; Behrouz,9999,0,9999,0
1668085055232,ECE 200,047,103632,Trivedi; Mohan M.,9999,0,9999,0
1668085055232,ECE 200,048,103633,Vasconcelos; Nuno,9999,0,9999,0
1668085055232,ECE 200,049,103634,Wang; Xiaolong,9999,0,9999,0
1668085055232,ECE 200,050,103635,Xie; Pengtao,9999,0,9999,0
1668085055232,ECE 200,051,103636,Yip; Michael,9999,0,9999,0
1668085055232,ECE 200,052,103637,Zeger; Kenneth A.,999,0,999,0
1668085055232,ECE 200,053,103638,Zhang; Xinyu,9999,0,9999,0
1668085055232,ECE 200,054,103639,Turakhia; Yatish Girish,9999,0,9999,0
1668085055232,ECE 200,055,103640,Kang; Mingu,9999,0,9999,0
1668085055232,ECE 200,056,103641,Shi; Yuanyuan,9999,0,9999,0
1668085055232,ECE 200,057,103642,Wang; Edward Jay,9999,0,9999,0
1668085055232,ECE 200,058,103643,Zheng; Yang,9999,0,9999,0
1668085055662,ECE 202,A00,103644,Kuzum; Duygu,0,0,0,0
1668085056093,ECE 212BN,A00,103646,Ng; Tse Nga,0,0,0,0
1668085056517,ECE 221,A00,111493,Staff,0,0,0,0
1668085056946,ECE 222B,A00,103647,Lomakin; Vitaliy,0,0,0,0
1668085057370,ECE 230B,A00,103648,Taur; Yuan,0,0,0,0
1668085057796,ECE 238B,A00,103649,Garay; Javier,0,0,0,0
1668085058220,ECE 240B,A00,112900,Fainman; Yeshaiahu,0,0,0,0
1668085058648,ECE 247A,A00,103650,Jokerst; Jesse Vincent,0,0,0,0
1668085059077,ECE 247B,A00,103651,Wang; Joseph,0,0,0,0
1668085059506,ECE 250,A00,103652,Siegel; Paul H.,0,0,0,0
1668085059934,ECE 251A,A00,103654,Rao; Bhaskar D.,0,0,0,0
1668085060363,ECE 257B,A00,103655,Bharadia; Dinesh,0,0,0,0
1668085060788,ECE 258A,A00,103656,Milstein; Laurence B.,0,0,0,0
1668085061212,ECE 260B,A00,103658,Kang; Mingu,0,0,0,0
1668085061636,ECE 264A,A00,103659,Galton; Ian A,0,0,0,0
1668085062061,ECE 265A,A00,103661,Gudem; Prasad S.S.,0,0,0,0
1668085062484,ECE 265D,A00,103662,Gudem; Prasad S.S.,0,0,0,0
1668085062908,ECE 268,A00,103663,Koushanfar; Farinaz,0,0,0,0
1668085063428,ECE 269,A01,103665,Pal; Piya,0,0,0,0
1668085063855,ECE 271B,A00,103666,Vasconcelos; Manuela,0,0,0,0
1668085064286,ECE 276A,A00,103667,Atanasov; Nikolay A.,0,0,0,0
1668085064710,ECE 277,A00,103668,An; Cheolhong,0,0,0,0
1668085065140,ECE 279,A00,117947,Hall; Drew A.,0,0,0,0
1668085065996,ECE 283,A00,103670,Hsueh; Tzu-Chien,0,0,0,0
1668085066422,ECE 284,A00,103671,Turakhia; Yatish Girish,0,0,0,0
1668085066849,ECE 285,A00,103672,Zheng; Yang,0,0,0,0
1668085066849,ECE 285,B00,103673,Sworder; David D.,0,0,0,0
1668085067281,ECE 287,A00,103676,Javidi; Tara,0,0,0,0
1668085067707,MATH 200B,A00,098023,Salehi Golsefidy; Alireza,13,0,15,2
1668085068130,MATH 202B,A00,098024,Rhoades; Brendon Patrick,9,0,15,6
1668085068562,MATH 203B,A00,098025,Oprea; Dragos N.,10,0,15,5
1668085068996,MATH 204B,A00,098026,Sorensen; Claus M,13,0,15,2
1668085069421,MATH 208,A00,098027,Izadi; Elham,7,0,10,3
1668085069846,MATH 209,A00,098028,Pollack; Aaron,10,0,10,0
1668085070272,MATH 211A,A00,112919,Rogalski; Daniel,9,0,10,1
1668085070697,MATH 211B,A00,112920,Seward; Brandon M.,9,0,10,1
1668085071126,MATH 218,A00,098029,Li; Bo,10,0,10,0
1668085071554,MATH 220B,A00,098030,Novak; Jonathan I,12,0,15,3
1668085071978,MATH 221A,A00,098031,Ebenfelt; Peter F,13,0,15,2
1668085072415,MATH 231B,A00,098032,Zlatos; Andrej,12,0,15,3
1668085072840,MATH 240B,A00,098033,Ni; Lei,9,0,15,6
1668085073265,MATH 243,A00,098034,Jekel; David Andrew,10,0,10,0
1668085073688,MATH 245A,A00,098035,Nie; Jiawang,0,0,15,16
1668085074114,MATH 248,A00,098036,Bejenaru; Ioan,10,0,10,0
1668085074539,MATH 250B,A00,098037,Spolaor; Luca,14,0,15,1
1668085074964,MATH 258,A00,098038,Ni; Lei,10,0,10,0
1668085075388,MATH 264B,A00,098041,Rhoades; Brendon Patrick,10,0,15,5
1668085075818,MATH 268,A00,098042,Buss; Samuel R,10,0,10,0
1668085076242,MATH 269,A00,098043,Rhoades; Brendon Patrick,10,0,10,0
1668085076667,MATH 270B,A00,098044,Li; Bo,11,0,15,4
1668085077091,MATH 272B,A00,098045,Holst; Michael J,13,0,15,2
1668085077521,MATH 273A,A00,098046,Tian; Xiaochuan,10,0,15,5
1668085077947,MATH 275,A01,098048,Tian; Xiaochuan,6,0,10,4
1668085078371,MATH 278A,A00,098049,Holst; Michael J,8,0,10,2
1668085078800,MATH 278B,A00,098050,Cloninger; Alexander,10,0,10,0
1668085079227,MATH 278C,A00,098051,Nie; Jiawang,7,0,10,3
1668085079654,MATH 280B,A00,098052,Zheng; Tianyi,10,0,15,5
1668085080092,MATH 281B,A00,098053,Bradic; Jelena,3,0,15,12
1668085080523,MATH 282B,A00,098054,Arias-Castro; Ery,0,0,15,15
1668085080950,MATH 285,A00,098055,Fitzsimmons; Patrick J,0,0,15,17
1668085081379,MATH 287B,A00,098056,Arias-Castro; Ery,3,0,15,12
1668085081810,MATH 288,A00,098057,Agarwal; Pooja,9,0,10,1
1668085081810,MATH 288,B00,098058,Zhang; Danna,8,0,10,2
1668085081810,MATH 288,C00,098059,Williams; Ruth J,10,0,10,0
1668085082236,MATH 290B,A00,098060,Roberts; Justin Deritter,13,0,15,2
1668085082662,MATH 292,A00,098061,Belmont; Eva Kinoshita,10,0,10,0
1668085083090,MATH 295,A00,098062,Suk; Andrew Hoon,48,0,50,2
1668085083515,MATH 296,A00,098063,Novak; Jonathan I,20,0,20,0
1668085083940,MATH 297,001,098064,Gamst; Anthony Collins,9997,0,9999,2
1668085586065,COGS 205,A00,101395,Chiba; Andrea,19,0,20,1
1668085586488,COGS 210B,001,101404,Greene; Deanna Jacquelyn,9998,0,9999,1
1668085586488,COGS 210B,002,101417,Xia; Haijun,9999,0,9999,0
1668085586488,COGS 210B,003,101422,Nitz; Douglas A.,9999,0,9999,0
1668085586488,COGS 210B,004,101423,Hollan; James D.,9998,0,9999,1
1668085586488,COGS 210B,005,101424,Deak; Gedeon O.,9998,0,9999,1
1668085586488,COGS 210B,006,101425,Rossano; Federico,9999,0,9999,0
1668085586913,COGS 211B,A00,101427,Coulson; Seana M,9996,0,9999,3
1668085587339,COGS 220,A00,101428,Hollan; James D.,0,0,25,25
1668085587762,COGS 229,A00,101429,Dow; Steven P,18,0,25,7
1668085588189,COGS 230,A00,101430,Klemmer; Scott R,13,0,17,4
1668085588612,COGS 234,A00,101431,Xia; Haijun,3,0,25,22
1668085589040,COGS 260,A00,101432,Kiyonaga; Anastasia,19,0,25,6
1668085589040,COGS 260,B00,101433,Kirsh; David Joel,16,0,25,9
1668085589466,CSE 202,A00,102371,Impagliazzo; Russell,0,0,0,0
1668085589893,CSE 203B,A01,102373,Cheng; Chung Kuan,0,0,0,0
1668085590327,CSE 208,A00,102374,Micciancio; Daniele,0,0,0,0
1668085590749,CSE 209A,A00,112895,Impagliazzo; Russell,0,0,15,15
1668085591171,CSE 209B,A00,108005,Bellare; Mihir,0,0,0,0
1668085591594,CSE 210,A00,113163,Coblenz; Michael J,0,0,0,0
1668085592018,CSE 219,A00,106111,Dow; Steven P,0,0,20,20
1668085592445,CSE 221,A00,102376,Voelker; Geoffrey M.,0,0,0,0
1668085592875,CSE 224,A01,102378,Porter; George M,0,0,0,0
1668085593297,CSE 229A,A00,102379,Savage; Stefan,0,0,0,0
1668085593728,CSE 229C,A00,102380,Munyaka; Imani N. S.,0,0,0,0
1668085594153,CSE 232B,A00,102382,Deutsch; Alin Bernard,0,0,0,0
1668085594583,CSE 234,A01,112904,Kumar; Arun Kumar,0,0,0,0
1668085595017,CSE 237A,A00,102383,Rosing; Tajana Simunic,0,0,0,0
1668085595451,CSE 239A,A00,102384,Deutsch; Alin Bernard,0,0,0,0
1668085595872,CSE 239B,A00,102385,Polikarpova; Nadezhda,0,0,0,0
1668085596299,CSE 240A,A00,102386,Pannuto; Patrick William,0,0,0,0
1668085596726,CSE 240B,A00,102387,Zhao; Jishen,0,0,0,0
1668085597149,CSE 241A,A00,106406,Kang; Mingu,0,0,0,0
1668085597589,CSE 249B,A00,102388,Kahng; Andrew Byun,0,0,8,8
1668085598018,CSE 251B,A01,102392,Cottrell; Garrison W,0,0,0,0
1668085598018,CSE 251B,A02,102393,Cottrell; Garrison W,0,0,0,0
1668085598445,CSE 252B,A00,102394,Ochoa; Benjamin Lawrence,0,0,0,0
1668085598869,CSE 257,A01,102396,Gao; Sicun,0,0,0,0
1668085599301,CSE 272,A00,102397,Li; Tzumao,0,0,0,0
1668085599724,CSE 274,A00,111323,Chern; Albert Ren-Haur,0,0,0,0
1668085600148,CSE 282,A00,102398,Pevzner; Pavel Arkadjevich,0,0,0,0
1668085600577,CSE 284,A00,114175,Gymrek; Melissa Ann,0,0,0,0
1668085601005,CSE 290,A00,102399,Chandraker; Manmohan Krishna,0,0,0,0
1668085601005,CSE 290,B00,102400,Vaccaro; Kristen Marie,0,0,25,25
1668085601005,CSE 290,C00,102414,Pannuto; Patrick William,0,0,25,25
1668085601005,CSE 290,D00,102427,Pevzner; Pavel Arkadjevich,0,0,0,0
1668085601005,CSE 290,E00,102429,Zhao; Jishen,0,0,0,0
1668085601005,CSE 290,F00,102436,Tullsen; Dean Michael,0,0,0,0
1668085601005,CSE 290,G00,102440,Christensen; Henrik I,0,0,20,20
1668085601433,CSE 291,A00,102443,Su; Hao,0,0,0,0
1668085601433,CSE 291,B00,102448,Polikarpova; Nadezhda,0,0,0,0
1668085601433,CSE 291,C00,102453,Vaccaro; Kristen Marie,0,0,0,0
1668085601433,CSE 291,D00,111343,Savage; Stefan,0,0,0,0
1668085601433,CSE 291,E00,116474,Claffy; Kimberly Claire,0,0,0,0
1668085601433,CSE 291,F00,116479,Pasquale; Joseph,0,0,0,0
1668085601865,CSE 293,001,119111,Bafna; Vineet,9999,0,9999,0
1668085601865,CSE 293,002,119118,Bellare; Mihir,9999,0,9999,0
1668085601865,CSE 293,003,119122,Berg-Kirkpatrick; Taylor D,9999,0,9999,0
1668085601865,CSE 293,004,119135,Christensen; Henrik I,9999,0,9999,0
1668085601865,CSE 293,005,119142,Cottrell; Garrison W,9999,0,9999,0
1668085601865,CSE 293,006,119146,Deutsch; Alin Bernard,9999,0,9999,0
1668085601865,CSE 293,007,119159,Esmaeilzadeh; Hadi,9999,0,9999,0
1668085601865,CSE 293,008,119166,Freund; Yoav,9999,0,9999,0
1668085601865,CSE 293,009,119170,Griswold; William G.,9999,0,9999,0
1668085601865,CSE 293,010,119183,Gymrek; Melissa Ann,9999,0,9999,0
1668085601865,CSE 293,011,119190,Heninger; Nadia A,9999,0,9999,0
1668085601865,CSE 293,012,119230,Impagliazzo; Russell,9999,0,9999,0
1668085601865,CSE 293,013,119232,Jhala; Ranjit,9999,0,9999,0
1668085601865,CSE 293,014,119233,Kahng; Andrew Byun,9999,0,9999,0
1668085601865,CSE 293,015,119298,Kane; Daniel Mertz,9999,0,9999,0
1668085601865,CSE 293,016,119299,Kriegman; David J,9999,0,9999,0
1668085601865,CSE 293,017,119300,Kumar; Arun Kumar,9999,0,9999,0
1668085601865,CSE 293,018,119301,Lerner; Sorin,9999,0,9999,0
1668085601865,CSE 293,019,119302,Lovett; Shachar,9999,0,9999,0
1668085601865,CSE 293,020,119303,McAuley; Julian John,9999,0,9999,0
1668085601865,CSE 293,021,119304,Micciancio; Daniele,9999,0,9999,0
1668085601865,CSE 293,022,119367,Orailoglu; Alex,9999,0,9999,0
1668085601865,CSE 293,023,119382,Paturi; Ramamohan,9999,0,9999,0
1668085601865,CSE 293,024,119404,Polikarpova; Nadezhda,9999,0,9999,0
1668085601865,CSE 293,025,119406,Politz; Joseph Gibbs,9999,0,9999,0
1668085601865,CSE 293,026,119411,Porter; George M,9999,0,9999,0
1668085601865,CSE 293,027,119414,Porter; Leonard Emerson,9999,0,9999,0
1668085601865,CSE 293,028,119416,Ramamoorthi; Ravi,9999,0,9999,0
1668085601865,CSE 293,029,119417,Sahoo; Debashis,9999,0,9999,0
1668085601865,CSE 293,030,119420,Saul; Lawrence,9999,0,9999,0
1668085601865,CSE 293,031,119421,Savage; Stefan,9999,0,9999,0
1668085601865,CSE 293,032,119425,Schulze; Jurgen P.,9999,0,9999,0
1668085601865,CSE 293,033,119426,Snoeren; Alex C.,9999,0,9999,0
1668085601865,CSE 293,034,119428,Shang; Jingbo,9999,0,9999,0
1668085601865,CSE 293,035,119430,Stefan; Deian,9999,0,9999,0
1668085601865,CSE 293,036,119431,Su; Hao,9999,0,9999,0
1668085601865,CSE 293,037,119433,Swanson; Steven James,9999,0,9999,0
1668085601865,CSE 293,038,119435,Tullsen; Dean Michael,9999,0,9999,0
1668085601865,CSE 293,039,119483,Voelker; Geoffrey M.,9999,0,9999,0
1668085601865,CSE 293,040,119537,Zhao; Jishen,9999,0,9999,0
1668085601865,CSE 293,041,119538,Zhou; Yuan-Yuan,9999,0,9999,0
1668085601865,CSE 293,042,119539,Gao; Sicun,9999,0,9999,0
1668085601865,CSE 293,043,119540,Weibel; Nadir,9999,0,9999,0
1668085601865,CSE 293,044,119541,Gupta; Rajesh K.,9999,0,9999,0
1668085601865,CSE 293,045,126410,Vaccaro; Kristen Marie,9999,0,9999,0
1668085601865,CSE 293,046,126411,Klemke; Richard,9999,0,9999,0
1668085602289,CSE 294,A00,102459,Voelker; Geoffrey M.,0,0,0,0
1668085602289,CSE 294,B00,111322,Orailoglu; Alex,0,0,0,0
1668085602728,DSE 201,A00,096914,Deutsch; Alin Bernard,30,0,30,0
1668085603169,DSE 210,A00,096915,Dasgupta; Sanjoy,30,0,30,0
1668085603597,DSE 260A,A00,096916,Altintas De Callaf; Ilkay,30,0,30,0
1668085604035,ECE 200,001,103586,Antipa; Nicholas A,9999,0,9999,0
1668085604035,ECE 200,002,103587,Atanasov; Nikolay A.,9999,0,9999,0
1668085604035,ECE 200,003,103588,Bharadia; Dinesh,9999,0,9999,0
1668085604035,ECE 200,004,103589,Cheng; Chung Kuan,9999,0,9999,0
1668085604035,ECE 200,005,103590,Cosman; Pamela C.,9999,0,9999,0
1668085604035,ECE 200,006,103591,Dayeh; Shadi Ahmad,9999,0,9999,0
1668085604035,ECE 200,007,103592,Fainman; Yeshaiahu,9999,0,9999,0
1668085604035,ECE 200,008,103593,Ford; Joseph Earl,9999,0,9999,0
1668085604035,ECE 200,009,103594,Franceschetti; Massimo,9999,0,9999,0
1668085604035,ECE 200,010,103595,Fullerton; Eric E,9999,0,9999,0
1668085604035,ECE 200,011,103596,Galton; Ian A,9999,0,9999,0
1668085604035,ECE 200,012,103597,Gilja; Vikash,9999,0,9999,0
1668085604035,ECE 200,013,103598,Hall; Drew A.,9999,0,9999,0
1668085604035,ECE 200,014,103599,Hsueh; Tzu-Chien,9999,0,9999,0
1668085604035,ECE 200,015,103600,Javidi; Tara,9999,0,9999,0
1668085604035,ECE 200,016,103601,Kahng; Andrew Byun,9999,0,9999,0
1668085604035,ECE 200,017,103602,Kim; Young-Han,9999,0,9999,0
1668085604035,ECE 200,018,103603,Koushanfar; Farinaz,9999,0,9999,0
1668085604035,ECE 200,019,103604,Kuzum; Duygu,9999,0,9999,0
1668085604035,ECE 200,020,103605,Le; Hanh-Phuc,9999,0,9999,0
1668085604035,ECE 200,021,103606,Lin; Bill,9999,0,9999,0
1668085604035,ECE 200,022,103607,Liu; Zhaowei,9998,0,9999,1
1668085604035,ECE 200,023,103608,Lo; Yu-Hwa,9999,0,9999,0
1668085604035,ECE 200,024,103609,Lomakin; Vitaliy,9999,0,9999,0
1668085604035,ECE 200,025,103610,Mercier; Patrick Philip,9999,0,9999,0
1668085604035,ECE 200,026,103611,Meyer; Florian,9999,0,9999,0
1668085604035,ECE 200,027,103612,Milstein; Laurence B.,9999,0,9999,0
1668085604035,ECE 200,028,103613,Mir Arabbaygi; Siavash,9999,0,9999,0
1668085604035,ECE 200,029,103614,Mookherjea; Shayan,9999,0,9999,0
1668085604035,ECE 200,030,103615,Morris; Karcher William,9999,0,9999,0
1668085604035,ECE 200,031,103616,Ng; Tse Nga,9999,0,9999,0
1668085604035,ECE 200,032,103617,Nguyen; Truong Quang,9999,0,9999,0
1668085604035,ECE 200,033,103618,Nomura; Kenji,9999,0,9999,0
1668085604035,ECE 200,034,103619,Orlitsky; Alon,9999,0,9999,0
1668085604035,ECE 200,035,103620,Pal; Piya,9999,0,9999,0
1668085604035,ECE 200,036,103621,Papen; George C.,9999,0,9999,0
1668085604035,ECE 200,037,103622,Radic; Stojan,9999,0,9999,0
1668085604035,ECE 200,038,103623,Rao; Bhaskar D.,9999,0,9999,0
1668085604035,ECE 200,039,103624,Rao; Ramesh R,9999,0,9999,0
1668085604035,ECE 200,040,103625,Rebeiz; Gabriel,9999,0,9999,0
1668085604035,ECE 200,041,103626,Sanford; John R,9999,0,9999,0
1668085604035,ECE 200,042,103627,Siegel; Paul H.,9999,0,9999,0
1668085604035,ECE 200,043,103628,Sievenpiper; Daniel F.,9999,0,9999,0
1668085604035,ECE 200,044,103629,Sworder; David D.,9999,0,9999,0
1668085604035,ECE 200,045,103630,Taur; Yuan,9999,0,9999,0
1668085604035,ECE 200,046,103631,Touri; Behrouz,9999,0,9999,0
1668085604035,ECE 200,047,103632,Trivedi; Mohan M.,9999,0,9999,0
1668085604035,ECE 200,048,103633,Vasconcelos; Nuno,9999,0,9999,0
1668085604035,ECE 200,049,103634,Wang; Xiaolong,9999,0,9999,0
1668085604035,ECE 200,050,103635,Xie; Pengtao,9999,0,9999,0
1668085604035,ECE 200,051,103636,Yip; Michael,9999,0,9999,0
1668085604035,ECE 200,052,103637,Zeger; Kenneth A.,999,0,999,0
1668085604035,ECE 200,053,103638,Zhang; Xinyu,9999,0,9999,0
1668085604035,ECE 200,054,103639,Turakhia; Yatish Girish,9999,0,9999,0
1668085604035,ECE 200,055,103640,Kang; Mingu,9999,0,9999,0
1668085604035,ECE 200,056,103641,Shi; Yuanyuan,9999,0,9999,0
1668085604035,ECE 200,057,103642,Wang; Edward Jay,9999,0,9999,0
1668085604035,ECE 200,058,103643,Zheng; Yang,9999,0,9999,0
1668085604458,ECE 202,A00,103644,Kuzum; Duygu,0,0,0,0
1668085604883,ECE 212BN,A00,103646,Ng; Tse Nga,0,0,0,0
1668085605306,ECE 221,A00,111493,Staff,0,0,0,0
1668085605729,ECE 222B,A00,103647,Lomakin; Vitaliy,0,0,0,0
1668085606158,ECE 230B,A00,103648,Taur; Yuan,0,0,0,0
1668085606592,ECE 238B,A00,103649,Garay; Javier,0,0,0,0
1668085607018,ECE 240B,A00,112900,Fainman; Yeshaiahu,0,0,0,0
1668085607446,ECE 247A,A00,103650,Jokerst; Jesse Vincent,0,0,0,0
1668085607869,ECE 247B,A00,103651,Wang; Joseph,0,0,0,0
1668085608300,ECE 250,A00,103652,Siegel; Paul H.,0,0,0,0
1668085608726,ECE 251A,A00,103654,Rao; Bhaskar D.,0,0,0,0
1668085609151,ECE 257B,A00,103655,Bharadia; Dinesh,0,0,0,0
1668085609576,ECE 258A,A00,103656,Milstein; Laurence B.,0,0,0,0
1668085609999,ECE 260B,A00,103658,Kang; Mingu,0,0,0,0
1668085610430,ECE 264A,A00,103659,Galton; Ian A,0,0,0,0
1668085610863,ECE 265A,A00,103661,Gudem; Prasad S.S.,0,0,0,0
1668085611289,ECE 265D,A00,103662,Gudem; Prasad S.S.,0,0,0,0
1668085611713,ECE 268,A00,103663,Koushanfar; Farinaz,0,0,0,0
1668085612140,ECE 269,A01,103665,Pal; Piya,0,0,0,0
1668085612574,ECE 271B,A00,103666,Vasconcelos; Manuela,0,0,0,0
1668085613005,ECE 276A,A00,103667,Atanasov; Nikolay A.,0,0,0,0
1668085613428,ECE 277,A00,103668,An; Cheolhong,0,0,0,0
1668085613860,ECE 279,A00,117947,Hall; Drew A.,0,0,0,0
1668085614715,ECE 283,A00,103670,Hsueh; Tzu-Chien,0,0,0,0
1668085615146,ECE 284,A00,103671,Turakhia; Yatish Girish,0,0,0,0
1668085615571,ECE 285,A00,103672,Zheng; Yang,0,0,0,0
1668085615571,ECE 285,B00,103673,Sworder; David D.,0,0,0,0
1668085615994,ECE 287,A00,103676,Javidi; Tara,0,0,0,0
1668085616418,MATH 200B,A00,098023,Salehi Golsefidy; Alireza,13,0,15,2
1668085616843,MATH 202B,A00,098024,Rhoades; Brendon Patrick,9,0,15,6
1668085617269,MATH 203B,A00,098025,Oprea; Dragos N.,10,0,15,5
1668085617691,MATH 204B,A00,098026,Sorensen; Claus M,13,0,15,2
1668085618117,MATH 208,A00,098027,Izadi; Elham,7,0,10,3
1668085618542,MATH 209,A00,098028,Pollack; Aaron,10,0,10,0
1668085618966,MATH 211A,A00,112919,Rogalski; Daniel,9,0,10,1
1668085619389,MATH 211B,A00,112920,Seward; Brandon M.,9,0,10,1
1668085619812,MATH 218,A00,098029,Li; Bo,10,0,10,0
1668085620237,MATH 220B,A00,098030,Novak; Jonathan I,12,0,15,3
1668085620664,MATH 221A,A00,098031,Ebenfelt; Peter F,13,0,15,2
1668085621091,MATH 231B,A00,098032,Zlatos; Andrej,12,0,15,3
1668085621515,MATH 240B,A00,098033,Ni; Lei,9,0,15,6
1668085621939,MATH 243,A00,098034,Jekel; David Andrew,10,0,10,0
1668085622362,MATH 245A,A00,098035,Nie; Jiawang,0,0,15,16
1668085622789,MATH 248,A00,098036,Bejenaru; Ioan,10,0,10,0
1668085623213,MATH 250B,A00,098037,Spolaor; Luca,14,0,15,1
1668085623637,MATH 258,A00,098038,Ni; Lei,10,0,10,0
1668085624061,MATH 264B,A00,098041,Rhoades; Brendon Patrick,10,0,15,5
1668085624489,MATH 268,A00,098042,Buss; Samuel R,10,0,10,0
1668085624917,MATH 269,A00,098043,Rhoades; Brendon Patrick,10,0,10,0
1668085625352,MATH 270B,A00,098044,Li; Bo,11,0,15,4
1668085625779,MATH 272B,A00,098045,Holst; Michael J,13,0,15,2
1668085626208,MATH 273A,A00,098046,Tian; Xiaochuan,10,0,15,5
1668085626630,MATH 275,A01,098048,Tian; Xiaochuan,6,0,10,4
1668085627057,MATH 278A,A00,098049,Holst; Michael J,8,0,10,2
1668085627493,MATH 278B,A00,098050,Cloninger; Alexander,10,0,10,0
1668085627919,MATH 278C,A00,098051,Nie; Jiawang,7,0,10,3
1668085628349,MATH 280B,A00,098052,Zheng; Tianyi,10,0,15,5
1668085628867,MATH 281B,A00,098053,Bradic; Jelena,3,0,15,12
1668085629299,MATH 282B,A00,098054,Arias-Castro; Ery,0,0,15,15
1668085629723,MATH 285,A00,098055,Fitzsimmons; Patrick J,0,0,15,17
1668085630155,MATH 287B,A00,098056,Arias-Castro; Ery,3,0,15,12
1668085630581,MATH 288,A00,098057,Agarwal; Pooja,9,0,10,1
1668085630581,MATH 288,B00,098058,Zhang; Danna,8,0,10,2
1668085630581,MATH 288,C00,098059,Williams; Ruth J,10,0,10,0
1668085631005,MATH 290B,A00,098060,Roberts; Justin Deritter,13,0,15,2
1668085631430,MATH 292,A00,098061,Belmont; Eva Kinoshita,10,0,10,0
1668085631857,MATH 295,A00,098062,Suk; Andrew Hoon,48,0,50,2
1668085632284,MATH 296,A00,098063,Novak; Jonathan I,20,0,20,0
1668085632709,MATH 297,001,098064,Gamst; Anthony Collins,9997,0,9999,2
1668086133697,COGS 205,A00,101395,Chiba; Andrea,19,0,20,1
1668086134124,COGS 210B,001,101404,Greene; Deanna Jacquelyn,9998,0,9999,1
1668086134124,COGS 210B,002,101417,Xia; Haijun,9999,0,9999,0
1668086134124,COGS 210B,003,101422,Nitz; Douglas A.,9999,0,9999,0
1668086134124,COGS 210B,004,101423,Hollan; James D.,9998,0,9999,1
1668086134124,COGS 210B,005,101424,Deak; Gedeon O.,9998,0,9999,1
1668086134124,COGS 210B,006,101425,Rossano; Federico,9999,0,9999,0
1668086134547,COGS 211B,A00,101427,Coulson; Seana M,9996,0,9999,3
1668086134972,COGS 220,A00,101428,Hollan; James D.,0,0,25,25
1668086135406,COGS 229,A00,101429,Dow; Steven P,18,0,25,7
1668086135834,COGS 230,A00,101430,Klemmer; Scott R,13,0,17,4
1668086136261,COGS 234,A00,101431,Xia; Haijun,3,0,25,22
1668086136783,COGS 260,A00,101432,Kiyonaga; Anastasia,19,0,25,6
1668086136783,COGS 260,B00,101433,Kirsh; David Joel,16,0,25,9
1668086137217,CSE 202,A00,102371,Impagliazzo; Russell,0,0,0,0
1668086137649,CSE 203B,A01,102373,Cheng; Chung Kuan,0,0,0,0
1668086138073,CSE 208,A00,102374,Micciancio; Daniele,0,0,0,0
1668086138502,CSE 209A,A00,112895,Impagliazzo; Russell,0,0,15,15
1668086138928,CSE 209B,A00,108005,Bellare; Mihir,0,0,0,0
1668086139362,CSE 210,A00,113163,Coblenz; Michael J,0,0,0,0
1668086139791,CSE 219,A00,106111,Dow; Steven P,0,0,20,20
1668086140214,CSE 221,A00,102376,Voelker; Geoffrey M.,0,0,0,0
1668086140654,CSE 224,A01,102378,Porter; George M,0,0,0,0
1668086141081,CSE 229A,A00,102379,Savage; Stefan,0,0,0,0
1668086141507,CSE 229C,A00,102380,Munyaka; Imani N. S.,0,0,0,0
1668086141932,CSE 232B,A00,102382,Deutsch; Alin Bernard,0,0,0,0
1668086142359,CSE 234,A01,112904,Kumar; Arun Kumar,0,0,0,0
1668086142785,CSE 237A,A00,102383,Rosing; Tajana Simunic,0,0,0,0
1668086143221,CSE 239A,A00,102384,Deutsch; Alin Bernard,0,0,0,0
1668086143648,CSE 239B,A00,102385,Polikarpova; Nadezhda,0,0,0,0
1668086144076,CSE 240A,A00,102386,Pannuto; Patrick William,0,0,0,0
1668086144506,CSE 240B,A00,102387,Zhao; Jishen,0,0,0,0
1668086144939,CSE 241A,A00,106406,Kang; Mingu,0,0,0,0
1668086145363,CSE 249B,A00,102388,Kahng; Andrew Byun,0,0,8,8
1668086145788,CSE 251B,A01,102392,Cottrell; Garrison W,0,0,0,0
1668086145788,CSE 251B,A02,102393,Cottrell; Garrison W,0,0,0,0
1668086146214,CSE 252B,A00,102394,Ochoa; Benjamin Lawrence,0,0,0,0
1668086146639,CSE 257,A01,102396,Gao; Sicun,0,0,0,0
1668086147071,CSE 272,A00,102397,Li; Tzumao,0,0,0,0
1668086147497,CSE 274,A00,111323,Chern; Albert Ren-Haur,0,0,0,0
1668086147923,CSE 282,A00,102398,Pevzner; Pavel Arkadjevich,0,0,0,0
1668086148348,CSE 284,A00,114175,Gymrek; Melissa Ann,0,0,0,0
1668086148785,CSE 290,A00,102399,Chandraker; Manmohan Krishna,0,0,0,0
1668086148785,CSE 290,B00,102400,Vaccaro; Kristen Marie,0,0,25,25
1668086148785,CSE 290,C00,102414,Pannuto; Patrick William,0,0,25,25
1668086148785,CSE 290,D00,102427,Pevzner; Pavel Arkadjevich,0,0,0,0
1668086148785,CSE 290,E00,102429,Zhao; Jishen,0,0,0,0
1668086148785,CSE 290,F00,102436,Tullsen; Dean Michael,0,0,0,0
1668086148785,CSE 290,G00,102440,Christensen; Henrik I,0,0,20,20
1668086149226,CSE 291,A00,102443,Su; Hao,0,0,0,0
1668086149226,CSE 291,B00,102448,Polikarpova; Nadezhda,0,0,0,0
1668086149226,CSE 291,C00,102453,Vaccaro; Kristen Marie,0,0,0,0
1668086149226,CSE 291,D00,111343,Savage; Stefan,0,0,0,0
1668086149226,CSE 291,E00,116474,Claffy; Kimberly Claire,0,0,0,0
1668086149226,CSE 291,F00,116479,Pasquale; Joseph,0,0,0,0
1668086149697,CSE 293,001,119111,Bafna; Vineet,9999,0,9999,0
1668086149697,CSE 293,002,119118,Bellare; Mihir,9999,0,9999,0
1668086149697,CSE 293,003,119122,Berg-Kirkpatrick; Taylor D,9999,0,9999,0
1668086149697,CSE 293,004,119135,Christensen; Henrik I,9999,0,9999,0
1668086149697,CSE 293,005,119142,Cottrell; Garrison W,9999,0,9999,0
1668086149697,CSE 293,006,119146,Deutsch; Alin Bernard,9999,0,9999,0
1668086149697,CSE 293,007,119159,Esmaeilzadeh; Hadi,9999,0,9999,0
1668086149697,CSE 293,008,119166,Freund; Yoav,9999,0,9999,0
1668086149697,CSE 293,009,119170,Griswold; William G.,9999,0,9999,0
1668086149697,CSE 293,010,119183,Gymrek; Melissa Ann,9999,0,9999,0
1668086149697,CSE 293,011,119190,Heninger; Nadia A,9999,0,9999,0
1668086149697,CSE 293,012,119230,Impagliazzo; Russell,9999,0,9999,0
1668086149697,CSE 293,013,119232,Jhala; Ranjit,9999,0,9999,0
1668086149697,CSE 293,014,119233,Kahng; Andrew Byun,9999,0,9999,0
1668086149697,CSE 293,015,119298,Kane; Daniel Mertz,9999,0,9999,0
1668086149697,CSE 293,016,119299,Kriegman; David J,9999,0,9999,0
1668086149697,CSE 293,017,119300,Kumar; Arun Kumar,9999,0,9999,0
1668086149697,CSE 293,018,119301,Lerner; Sorin,9999,0,9999,0
1668086149697,CSE 293,019,119302,Lovett; Shachar,9999,0,9999,0
1668086149697,CSE 293,020,119303,McAuley; Julian John,9999,0,9999,0
1668086149697,CSE 293,021,119304,Micciancio; Daniele,9999,0,9999,0
1668086149697,CSE 293,022,119367,Orailoglu; Alex,9999,0,9999,0
1668086149697,CSE 293,023,119382,Paturi; Ramamohan,9999,0,9999,0
1668086149697,CSE 293,024,119404,Polikarpova; Nadezhda,9999,0,9999,0
1668086149697,CSE 293,025,119406,Politz; Joseph Gibbs,9999,0,9999,0
1668086149697,CSE 293,026,119411,Porter; George M,9999,0,9999,0
1668086149697,CSE 293,027,119414,Porter; Leonard Emerson,9999,0,9999,0
1668086149697,CSE 293,028,119416,Ramamoorthi; Ravi,9999,0,9999,0
1668086149697,CSE 293,029,119417,Sahoo; Debashis,9999,0,9999,0
1668086149697,CSE 293,030,119420,Saul; Lawrence,9999,0,9999,0
1668086149697,CSE 293,031,119421,Savage; Stefan,9999,0,9999,0
1668086149697,CSE 293,032,119425,Schulze; Jurgen P.,9999,0,9999,0
1668086149697,CSE 293,033,119426,Snoeren; Alex C.,9999,0,9999,0
1668086149697,CSE 293,034,119428,Shang; Jingbo,9999,0,9999,0
1668086149697,CSE 293,035,119430,Stefan; Deian,9999,0,9999,0
1668086149697,CSE 293,036,119431,Su; Hao,9999,0,9999,0
1668086149697,CSE 293,037,119433,Swanson; Steven James,9999,0,9999,0
1668086149697,CSE 293,038,119435,Tullsen; Dean Michael,9999,0,9999,0
1668086149697,CSE 293,039,119483,Voelker; Geoffrey M.,9999,0,9999,0
1668086149697,CSE 293,040,119537,Zhao; Jishen,9999,0,9999,0
1668086149697,CSE 293,041,119538,Zhou; Yuan-Yuan,9999,0,9999,0
1668086149697,CSE 293,042,119539,Gao; Sicun,9999,0,9999,0
1668086149697,CSE 293,043,119540,Weibel; Nadir,9999,0,9999,0
1668086149697,CSE 293,044,119541,Gupta; Rajesh K.,9999,0,9999,0
1668086149697,CSE 293,045,126410,Vaccaro; Kristen Marie,9999,0,9999,0
1668086149697,CSE 293,046,126411,Klemke; Richard,9999,0,9999,0
1668086150200,CSE 294,A00,102459,Voelker; Geoffrey M.,0,0,0,0
1668086150200,CSE 294,B00,111322,Orailoglu; Alex,0,0,0,0
1668086150627,DSE 201,A00,096914,Deutsch; Alin Bernard,30,0,30,0
1668086151051,DSE 210,A00,096915,Dasgupta; Sanjoy,30,0,30,0
1668086151475,DSE 260A,A00,096916,Altintas De Callaf; Ilkay,30,0,30,0
1668086151982,ECE 200,001,103586,Antipa; Nicholas A,9999,0,9999,0
1668086151982,ECE 200,002,103587,Atanasov; Nikolay A.,9999,0,9999,0
1668086151982,ECE 200,003,103588,Bharadia; Dinesh,9999,0,9999,0
1668086151982,ECE 200,004,103589,Cheng; Chung Kuan,9999,0,9999,0
1668086151982,ECE 200,005,103590,Cosman; Pamela C.,9999,0,9999,0
1668086151982,ECE 200,006,103591,Dayeh; Shadi Ahmad,9999,0,9999,0
1668086151982,ECE 200,007,103592,Fainman; Yeshaiahu,9999,0,9999,0
1668086151982,ECE 200,008,103593,Ford; Joseph Earl,9999,0,9999,0
1668086151982,ECE 200,009,103594,Franceschetti; Massimo,9999,0,9999,0
1668086151982,ECE 200,010,103595,Fullerton; Eric E,9999,0,9999,0
1668086151982,ECE 200,011,103596,Galton; Ian A,9999,0,9999,0
1668086151982,ECE 200,012,103597,Gilja; Vikash,9999,0,9999,0
1668086151982,ECE 200,013,103598,Hall; Drew A.,9999,0,9999,0
1668086151982,ECE 200,014,103599,Hsueh; Tzu-Chien,9999,0,9999,0
1668086151982,ECE 200,015,103600,Javidi; Tara,9999,0,9999,0
1668086151982,ECE 200,016,103601,Kahng; Andrew Byun,9999,0,9999,0
1668086151982,ECE 200,017,103602,Kim; Young-Han,9999,0,9999,0
1668086151982,ECE 200,018,103603,Koushanfar; Farinaz,9999,0,9999,0
1668086151982,ECE 200,019,103604,Kuzum; Duygu,9999,0,9999,0
1668086151982,ECE 200,020,103605,Le; Hanh-Phuc,9999,0,9999,0
1668086151982,ECE 200,021,103606,Lin; Bill,9999,0,9999,0
1668086151982,ECE 200,022,103607,Liu; Zhaowei,9998,0,9999,1
1668086151982,ECE 200,023,103608,Lo; Yu-Hwa,9999,0,9999,0
1668086151982,ECE 200,024,103609,Lomakin; Vitaliy,9999,0,9999,0
1668086151982,ECE 200,025,103610,Mercier; Patrick Philip,9999,0,9999,0
1668086151982,ECE 200,026,103611,Meyer; Florian,9999,0,9999,0
1668086151982,ECE 200,027,103612,Milstein; Laurence B.,9999,0,9999,0
1668086151982,ECE 200,028,103613,Mir Arabbaygi; Siavash,9999,0,9999,0
1668086151982,ECE 200,029,103614,Mookherjea; Shayan,9999,0,9999,0
1668086151982,ECE 200,030,103615,Morris; Karcher William,9999,0,9999,0
1668086151982,ECE 200,031,103616,Ng; Tse Nga,9999,0,9999,0
1668086151982,ECE 200,032,103617,Nguyen; Truong Quang,9999,0,9999,0
1668086151982,ECE 200,033,103618,Nomura; Kenji,9999,0,9999,0
1668086151982,ECE 200,034,103619,Orlitsky; Alon,9999,0,9999,0
1668086151982,ECE 200,035,103620,Pal; Piya,9999,0,9999,0
1668086151982,ECE 200,036,103621,Papen; George C.,9999,0,9999,0
1668086151982,ECE 200,037,103622,Radic; Stojan,9999,0,9999,0
1668086151982,ECE 200,038,103623,Rao; Bhaskar D.,9999,0,9999,0
1668086151982,ECE 200,039,103624,Rao; Ramesh R,9999,0,9999,0
1668086151982,ECE 200,040,103625,Rebeiz; Gabriel,9999,0,9999,0
1668086151982,ECE 200,041,103626,Sanford; John R,9999,0,9999,0
1668086151982,ECE 200,042,103627,Siegel; Paul H.,9999,0,9999,0
1668086151982,ECE 200,043,103628,Sievenpiper; Daniel F.,9999,0,9999,0
1668086151982,ECE 200,044,103629,Sworder; David D.,9999,0,9999,0
1668086151982,ECE 200,045,103630,Taur; Yuan,9999,0,9999,0
1668086151982,ECE 200,046,103631,Touri; Behrouz,9999,0,9999,0
1668086151982,ECE 200,047,103632,Trivedi; Mohan M.,9999,0,9999,0
1668086151982,ECE 200,048,103633,Vasconcelos; Nuno,9999,0,9999,0
1668086151982,ECE 200,049,103634,Wang; Xiaolong,9999,0,9999,0
1668086151982,ECE 200,050,103635,Xie; Pengtao,9999,0,9999,0
1668086151982,ECE 200,051,103636,Yip; Michael,9999,0,9999,0
1668086151982,ECE 200,052,103637,Zeger; Kenneth A.,999,0,999,0
1668086151982,ECE 200,053,103638,Zhang; Xinyu,9999,0,9999,0
1668086151982,ECE 200,054,103639,Turakhia; Yatish Girish,9999,0,9999,0
1668086151982,ECE 200,055,103640,Kang; Mingu,9999,0,9999,0
1668086151982,ECE 200,056,103641,Shi; Yuanyuan,9999,0,9999,0
1668086151982,ECE 200,057,103642,Wang; Edward Jay,9999,0,9999,0
1668086151982,ECE 200,058,103643,Zheng; Yang,9999,0,9999,0
1668086152408,ECE 202,A00,103644,Kuzum; Duygu,0,0,0,0
1668086152836,ECE 212BN,A00,103646,Ng; Tse Nga,0,0,0,0
1668086153265,ECE 221,A00,111493,Staff,0,0,0,0
1668086153688,ECE 222B,A00,103647,Lomakin; Vitaliy,0,0,0,0
1668086154113,ECE 230B,A00,103648,Taur; Yuan,0,0,0,0
1668086154539,ECE 238B,A00,103649,Garay; Javier,0,0,0,0
1668086154965,ECE 240B,A00,112900,Fainman; Yeshaiahu,0,0,0,0
1668086155397,ECE 247A,A00,103650,Jokerst; Jesse Vincent,0,0,0,0
1668086155828,ECE 247B,A00,103651,Wang; Joseph,0,0,0,0
1668086156255,ECE 250,A00,103652,Siegel; Paul H.,0,0,0,0
1668086156683,ECE 251A,A00,103654,Rao; Bhaskar D.,0,0,0,0
1668086157107,ECE 257B,A00,103655,Bharadia; Dinesh,0,0,0,0
1668086157535,ECE 258A,A00,103656,Milstein; Laurence B.,0,0,0,0
1668086157963,ECE 260B,A00,103658,Kang; Mingu,0,0,0,0
1668086158389,ECE 264A,A00,103659,Galton; Ian A,0,0,0,0
1668086158816,ECE 265A,A00,103661,Gudem; Prasad S.S.,0,0,0,0
1668086159243,ECE 265D,A00,103662,Gudem; Prasad S.S.,0,0,0,0
1668086159670,ECE 268,A00,103663,Koushanfar; Farinaz,0,0,0,0
1668086160093,ECE 269,A01,103665,Pal; Piya,0,0,0,0
1668086160517,ECE 271B,A00,103666,Vasconcelos; Manuela,0,0,0,0
1668086160946,ECE 276A,A00,103667,Atanasov; Nikolay A.,0,0,0,0
1668086161378,ECE 277,A00,103668,An; Cheolhong,0,0,0,0
1668086161808,ECE 279,A00,117947,Hall; Drew A.,0,0,0,0
1668086162684,ECE 283,A00,103670,Hsueh; Tzu-Chien,0,0,0,0
1668086163113,ECE 284,A00,103671,Turakhia; Yatish Girish,0,0,0,0
1668086163538,ECE 285,A00,103672,Zheng; Yang,0,0,0,0
1668086163538,ECE 285,B00,103673,Sworder; David D.,0,0,0,0
1668086163963,ECE 287,A00,103676,Javidi; Tara,0,0,0,0
1668086164390,MATH 200B,A00,098023,Salehi Golsefidy; Alireza,13,0,15,2
1668086164827,MATH 202B,A00,098024,Rhoades; Brendon Patrick,9,0,15,6
1668086165254,MATH 203B,A00,098025,Oprea; Dragos N.,10,0,15,5
1668086165679,MATH 204B,A00,098026,Sorensen; Claus M,13,0,15,2
1668086166111,MATH 208,A00,098027,Izadi; Elham,7,0,10,3
1668086166543,MATH 209,A00,098028,Pollack; Aaron,10,0,10,0
1668086166970,MATH 211A,A00,112919,Rogalski; Daniel,9,0,10,1
1668086167397,MATH 211B,A00,112920,Seward; Brandon M.,9,0,10,1
1668086167826,MATH 218,A00,098029,Li; Bo,10,0,10,0
1668086168251,MATH 220B,A00,098030,Novak; Jonathan I,12,0,15,3
1668086168675,MATH 221A,A00,098031,Ebenfelt; Peter F,13,0,15,2
1668086169099,MATH 231B,A00,098032,Zlatos; Andrej,12,0,15,3
1668086169531,MATH 240B,A00,098033,Ni; Lei,9,0,15,6
1668086169956,MATH 243,A00,098034,Jekel; David Andrew,10,0,10,0
1668086170385,MATH 245A,A00,098035,Nie; Jiawang,0,0,15,16
1668086170815,MATH 248,A00,098036,Bejenaru; Ioan,10,0,10,0
1668086171240,MATH 250B,A00,098037,Spolaor; Luca,14,0,15,1
1668086171669,MATH 258,A00,098038,Ni; Lei,10,0,10,0
1668086172093,MATH 264B,A00,098041,Rhoades; Brendon Patrick,10,0,15,5
1668086172523,MATH 268,A00,098042,Buss; Samuel R,10,0,10,0
1668086172947,MATH 269,A00,098043,Rhoades; Brendon Patrick,10,0,10,0
1668086173370,MATH 270B,A00,098044,Li; Bo,11,0,15,4
1668086173796,MATH 272B,A00,098045,Holst; Michael J,13,0,15,2
1668086174234,MATH 273A,A00,098046,Tian; Xiaochuan,10,0,15,5
1668086174710,MATH 275,A01,098048,Tian; Xiaochuan,6,0,10,4
1668086175146,MATH 278A,A00,098049,Holst; Michael J,8,0,10,2
1668086175568,MATH 278B,A00,098050,Cloninger; Alexander,10,0,10,0
1668086175994,MATH 278C,A00,098051,Nie; Jiawang,7,0,10,3
1668086176418,MATH 280B,A00,098052,Zheng; Tianyi,10,0,15,5
1668086176849,MATH 281B,A00,098053,Bradic; Jelena,3,0,15,12
1668086177280,MATH 282B,A00,098054,Arias-Castro; Ery,0,0,15,15
1668086177709,MATH 285,A00,098055,Fitzsimmons; Patrick J,0,0,15,17
1668086178149,MATH 287B,A00,098056,Arias-Castro; Ery,3,0,15,12
1668086178573,MATH 288,A00,098057,Agarwal; Pooja,9,0,10,1
1668086178573,MATH 288,B00,098058,Zhang; Danna,8,0,10,2
1668086178573,MATH 288,C00,098059,Williams; Ruth J,10,0,10,0
1668086179004,MATH 290B,A00,098060,Roberts; Justin Deritter,13,0,15,2
1668086179459,MATH 292,A00,098061,Belmont; Eva Kinoshita,10,0,10,0
1668086179883,MATH 295,A00,098062,Suk; Andrew Hoon,48,0,50,2
1668086180317,MATH 296,A00,098063,Novak; Jonathan I,20,0,20,0
1668086180745,MATH 297,001,098064,Gamst; Anthony Collins,9997,0,9999,2
1668086682683,COGS 205,A00,101395,Chiba; Andrea,19,0,20,1
1668086683116,COGS 210B,001,101404,Greene; Deanna Jacquelyn,9998,0,9999,1
1668086683116,COGS 210B,002,101417,Xia; Haijun,9999,0,9999,0
1668086683116,COGS 210B,003,101422,Nitz; Douglas A.,9999,0,9999,0
1668086683116,COGS 210B,004,101423,Hollan; James D.,9998,0,9999,1
1668086683116,COGS 210B,005,101424,Deak; Gedeon O.,9998,0,9999,1
1668086683116,COGS 210B,006,101425,Rossano; Federico,9999,0,9999,0
1668086683539,COGS 211B,A00,101427,Coulson; Seana M,9996,0,9999,3
1668086683966,COGS 220,A00,101428,Hollan; James D.,0,0,25,25
1668086684393,COGS 229,A00,101429,Dow; Steven P,18,0,25,7
1668086684822,COGS 230,A00,101430,Klemmer; Scott R,13,0,17,4
1668086685247,COGS 234,A00,101431,Xia; Haijun,3,0,25,22
1668086685676,COGS 260,A00,101432,Kiyonaga; Anastasia,19,0,25,6
1668086685676,COGS 260,B00,101433,Kirsh; David Joel,16,0,25,9
1668086686105,CSE 202,A00,102371,Impagliazzo; Russell,0,0,0,0
1668086686530,CSE 203B,A01,102373,Cheng; Chung Kuan,0,0,0,0
1668086686955,CSE 208,A00,102374,Micciancio; Daniele,0,0,0,0
1668086687383,CSE 209A,A00,112895,Impagliazzo; Russell,0,0,15,15
1668086687812,CSE 209B,A00,108005,Bellare; Mihir,0,0,0,0
1668086688240,CSE 210,A00,113163,Coblenz; Michael J,0,0,0,0
1668086688667,CSE 219,A00,106111,Dow; Steven P,0,0,20,20
1668086689093,CSE 221,A00,102376,Voelker; Geoffrey M.,0,0,0,0
1668086689517,CSE 224,A01,102378,Porter; George M,0,0,0,0
1668086689945,CSE 229A,A00,102379,Savage; Stefan,0,0,0,0
1668086690371,CSE 229C,A00,102380,Munyaka; Imani N. S.,0,0,0,0
1668086690798,CSE 232B,A00,102382,Deutsch; Alin Bernard,0,0,0,0
1668086691234,CSE 234,A01,112904,Kumar; Arun Kumar,0,0,0,0
1668086691664,CSE 237A,A00,102383,Rosing; Tajana Simunic,0,0,0,0
1668086692092,CSE 239A,A00,102384,Deutsch; Alin Bernard,0,0,0,0
1668086692516,CSE 239B,A00,102385,Polikarpova; Nadezhda,0,0,0,0
1668086692940,CSE 240A,A00,102386,Pannuto; Patrick William,0,0,0,0
1668086693369,CSE 240B,A00,102387,Zhao; Jishen,0,0,0,0
1668086693796,CSE 241A,A00,106406,Kang; Mingu,0,0,0,0
1668086694225,CSE 249B,A00,102388,Kahng; Andrew Byun,0,0,8,8
1668086694657,CSE 251B,A01,102392,Cottrell; Garrison W,0,0,0,0
1668086694657,CSE 251B,A02,102393,Cottrell; Garrison W,0,0,0,0
1668086695086,CSE 252B,A00,102394,Ochoa; Benjamin Lawrence,0,0,0,0
1668086695511,CSE 257,A01,102396,Gao; Sicun,0,0,0,0
1668086695936,CSE 272,A00,102397,Li; Tzumao,0,0,0,0
1668086696365,CSE 274,A00,111323,Chern; Albert Ren-Haur,0,0,0,0
1668086696787,CSE 282,A00,102398,Pevzner; Pavel Arkadjevich,0,0,0,0
1668086697216,CSE 284,A00,114175,Gymrek; Melissa Ann,0,0,0,0
1668086697646,CSE 290,A00,102399,Chandraker; Manmohan Krishna,0,0,0,0
1668086697646,CSE 290,B00,102400,Vaccaro; Kristen Marie,0,0,25,25
1668086697646,CSE 290,C00,102414,Pannuto; Patrick William,0,0,25,25
1668086697646,CSE 290,D00,102427,Pevzner; Pavel Arkadjevich,0,0,0,0
1668086697646,CSE 290,E00,102429,Zhao; Jishen,0,0,0,0
1668086697646,CSE 290,F00,102436,Tullsen; Dean Michael,0,0,0,0
1668086697646,CSE 290,G00,102440,Christensen; Henrik I,0,0,20,20
1668086698078,CSE 291,A00,102443,Su; Hao,0,0,0,0
1668086698078,CSE 291,B00,102448,Polikarpova; Nadezhda,0,0,0,0
1668086698078,CSE 291,C00,102453,Vaccaro; Kristen Marie,0,0,0,0
1668086698078,CSE 291,D00,111343,Savage; Stefan,0,0,0,0
1668086698078,CSE 291,E00,116474,Claffy; Kimberly Claire,0,0,0,0
1668086698078,CSE 291,F00,116479,Pasquale; Joseph,0,0,0,0
1668086698516,CSE 293,001,119111,Bafna; Vineet,9999,0,9999,0
1668086698516,CSE 293,002,119118,Bellare; Mihir,9999,0,9999,0
1668086698516,CSE 293,003,119122,Berg-Kirkpatrick; Taylor D,9999,0,9999,0
1668086698516,CSE 293,004,119135,Christensen; Henrik I,9999,0,9999,0
1668086698516,CSE 293,005,119142,Cottrell; Garrison W,9999,0,9999,0
1668086698516,CSE 293,006,119146,Deutsch; Alin Bernard,9999,0,9999,0
1668086698516,CSE 293,007,119159,Esmaeilzadeh; Hadi,9999,0,9999,0
1668086698516,CSE 293,008,119166,Freund; Yoav,9999,0,9999,0
1668086698516,CSE 293,009,119170,Griswold; William G.,9999,0,9999,0
1668086698516,CSE 293,010,119183,Gymrek; Melissa Ann,9999,0,9999,0
1668086698516,CSE 293,011,119190,Heninger; Nadia A,9999,0,9999,0
1668086698516,CSE 293,012,119230,Impagliazzo; Russell,9999,0,9999,0
1668086698516,CSE 293,013,119232,Jhala; Ranjit,9999,0,9999,0
1668086698516,CSE 293,014,119233,Kahng; Andrew Byun,9999,0,9999,0
1668086698516,CSE 293,015,119298,Kane; Daniel Mertz,9999,0,9999,0
1668086698516,CSE 293,016,119299,Kriegman; David J,9999,0,9999,0
1668086698516,CSE 293,017,119300,Kumar; Arun Kumar,9999,0,9999,0
1668086698516,CSE 293,018,119301,Lerner; Sorin,9999,0,9999,0
1668086698516,CSE 293,019,119302,Lovett; Shachar,9999,0,9999,0
1668086698516,CSE 293,020,119303,McAuley; Julian John,9999,0,9999,0
1668086698516,CSE 293,021,119304,Micciancio; Daniele,9999,0,9999,0
1668086698516,CSE 293,022,119367,Orailoglu; Alex,9999,0,9999,0
1668086698516,CSE 293,023,119382,Paturi; Ramamohan,9999,0,9999,0
1668086698516,CSE 293,024,119404,Polikarpova; Nadezhda,9999,0,9999,0
1668086698516,CSE 293,025,119406,Politz; Joseph Gibbs,9999,0,9999,0
1668086698516,CSE 293,026,119411,Porter; George M,9999,0,9999,0
1668086698516,CSE 293,027,119414,Porter; Leonard Emerson,9999,0,9999,0
1668086698516,CSE 293,028,119416,Ramamoorthi; Ravi,9999,0,9999,0
1668086698516,CSE 293,029,119417,Sahoo; Debashis,9999,0,9999,0
1668086698516,CSE 293,030,119420,Saul; Lawrence,9999,0,9999,0
1668086698516,CSE 293,031,119421,Savage; Stefan,9999,0,9999,0
1668086698516,CSE 293,032,119425,Schulze; Jurgen P.,9999,0,9999,0
1668086698516,CSE 293,033,119426,Snoeren; Alex C.,9999,0,9999,0
1668086698516,CSE 293,034,119428,Shang; Jingbo,9999,0,9999,0
1668086698516,CSE 293,035,119430,Stefan; Deian,9999,0,9999,0
1668086698516,CSE 293,036,119431,Su; Hao,9999,0,9999,0
1668086698516,CSE 293,037,119433,Swanson; Steven James,9999,0,9999,0
1668086698516,CSE 293,038,119435,Tullsen; Dean Michael,9999,0,9999,0
1668086698516,CSE 293,039,119483,Voelker; Geoffrey M.,9999,0,9999,0
1668086698516,CSE 293,040,119537,Zhao; Jishen,9999,0,9999,0
1668086698516,CSE 293,041,119538,Zhou; Yuan-Yuan,9999,0,9999,0
1668086698516,CSE 293,042,119539,Gao; Sicun,9999,0,9999,0
1668086698516,CSE 293,043,119540,Weibel; Nadir,9999,0,9999,0
1668086698516,CSE 293,044,119541,Gupta; Rajesh K.,9999,0,9999,0
1668086698516,CSE 293,045,126410,Vaccaro; Kristen Marie,9999,0,9999,0
1668086698516,CSE 293,046,126411,Klemke; Richard,9999,0,9999,0
1668086698945,CSE 294,A00,102459,Voelker; Geoffrey M.,0,0,0,0
1668086698945,CSE 294,B00,111322,Orailoglu; Alex,0,0,0,0
1668086699370,DSE 201,A00,096914,Deutsch; Alin Bernard,30,0,30,0
1668086699802,DSE 210,A00,096915,Dasgupta; Sanjoy,30,0,30,0
1668086700227,DSE 260A,A00,096916,Altintas De Callaf; Ilkay,30,0,30,0
1668086700673,ECE 200,001,103586,Antipa; Nicholas A,9999,0,9999,0
1668086700673,ECE 200,002,103587,Atanasov; Nikolay A.,9999,0,9999,0
1668086700673,ECE 200,003,103588,Bharadia; Dinesh,9999,0,9999,0
1668086700673,ECE 200,004,103589,Cheng; Chung Kuan,9999,0,9999,0
1668086700673,ECE 200,005,103590,Cosman; Pamela C.,9999,0,9999,0
1668086700673,ECE 200,006,103591,Dayeh; Shadi Ahmad,9999,0,9999,0
1668086700673,ECE 200,007,103592,Fainman; Yeshaiahu,9999,0,9999,0
1668086700673,ECE 200,008,103593,Ford; Joseph Earl,9999,0,9999,0
1668086700673,ECE 200,009,103594,Franceschetti; Massimo,9999,0,9999,0
1668086700673,ECE 200,010,103595,Fullerton; Eric E,9999,0,9999,0
1668086700673,ECE 200,011,103596,Galton; Ian A,9999,0,9999,0
1668086700673,ECE 200,012,103597,Gilja; Vikash,9999,0,9999,0
1668086700673,ECE 200,013,103598,Hall; Drew A.,9999,0,9999,0
1668086700673,ECE 200,014,103599,Hsueh; Tzu-Chien,9999,0,9999,0
1668086700673,ECE 200,015,103600,Javidi; Tara,9999,0,9999,0
1668086700673,ECE 200,016,103601,Kahng; Andrew Byun,9999,0,9999,0
1668086700673,ECE 200,017,103602,Kim; Young-Han,9999,0,9999,0
1668086700673,ECE 200,018,103603,Koushanfar; Farinaz,9999,0,9999,0
1668086700673,ECE 200,019,103604,Kuzum; Duygu,9999,0,9999,0
1668086700673,ECE 200,020,103605,Le; Hanh-Phuc,9999,0,9999,0
1668086700673,ECE 200,021,103606,Lin; Bill,9999,0,9999,0
1668086700673,ECE 200,022,103607,Liu; Zhaowei,9998,0,9999,1
1668086700673,ECE 200,023,103608,Lo; Yu-Hwa,9999,0,9999,0
1668086700673,ECE 200,024,103609,Lomakin; Vitaliy,9999,0,9999,0
1668086700673,ECE 200,025,103610,Mercier; Patrick Philip,9999,0,9999,0
1668086700673,ECE 200,026,103611,Meyer; Florian,9999,0,9999,0
1668086700673,ECE 200,027,103612,Milstein; Laurence B.,9999,0,9999,0
1668086700673,ECE 200,028,103613,Mir Arabbaygi; Siavash,9999,0,9999,0
1668086700673,ECE 200,029,103614,Mookherjea; Shayan,9999,0,9999,0
1668086700673,ECE 200,030,103615,Morris; Karcher William,9999,0,9999,0
1668086700673,ECE 200,031,103616,Ng; Tse Nga,9999,0,9999,0
1668086700673,ECE 200,032,103617,Nguyen; Truong Quang,9999,0,9999,0
1668086700673,ECE 200,033,103618,Nomura; Kenji,9999,0,9999,0
1668086700673,ECE 200,034,103619,Orlitsky; Alon,9999,0,9999,0
1668086700673,ECE 200,035,103620,Pal; Piya,9999,0,9999,0
1668086700673,ECE 200,036,103621,Papen; George C.,9999,0,9999,0
1668086700673,ECE 200,037,103622,Radic; Stojan,9999,0,9999,0
1668086700673,ECE 200,038,103623,Rao; Bhaskar D.,9999,0,9999,0
1668086700673,ECE 200,039,103624,Rao; Ramesh R,9999,0,9999,0
1668086700673,ECE 200,040,103625,Rebeiz; Gabriel,9999,0,9999,0
1668086700673,ECE 200,041,103626,Sanford; John R,9999,0,9999,0
1668086700673,ECE 200,042,103627,Siegel; Paul H.,9999,0,9999,0
1668086700673,ECE 200,043,103628,Sievenpiper; Daniel F.,9999,0,9999,0
1668086700673,ECE 200,044,103629,Sworder; David D.,9999,0,9999,0
1668086700673,ECE 200,045,103630,Taur; Yuan,9999,0,9999,0
1668086700673,ECE 200,046,103631,Touri; Behrouz,9999,0,9999,0
1668086700673,ECE 200,047,103632,Trivedi; Mohan M.,9999,0,9999,0
1668086700673,ECE 200,048,103633,Vasconcelos; Nuno,9999,0,9999,0
1668086700673,ECE 200,049,103634,Wang; Xiaolong,9999,0,9999,0
1668086700673,ECE 200,050,103635,Xie; Pengtao,9999,0,9999,0
1668086700673,ECE 200,051,103636,Yip; Michael,9999,0,9999,0
1668086700673,ECE 200,052,103637,Zeger; Kenneth A.,999,0,999,0
1668086700673,ECE 200,053,103638,Zhang; Xinyu,9999,0,9999,0
1668086700673,ECE 200,054,103639,Turakhia; Yatish Girish,9999,0,9999,0
1668086700673,ECE 200,055,103640,Kang; Mingu,9999,0,9999,0
1668086700673,ECE 200,056,103641,Shi; Yuanyuan,9999,0,9999,0
1668086700673,ECE 200,057,103642,Wang; Edward Jay,9999,0,9999,0
1668086700673,ECE 200,058,103643,Zheng; Yang,9999,0,9999,0
1668086701114,ECE 202,A00,103644,Kuzum; Duygu,0,0,0,0
1668086701540,ECE 212BN,A00,103646,Ng; Tse Nga,0,0,0,0
1668086701964,ECE 221,A00,111493,Staff,0,0,0,0
1668086702393,ECE 222B,A00,103647,Lomakin; Vitaliy,0,0,0,0
1668086702817,ECE 230B,A00,103648,Taur; Yuan,0,0,0,0
1668086703252,ECE 238B,A00,103649,Garay; Javier,0,0,0,0
1668086703692,ECE 240B,A00,112900,Fainman; Yeshaiahu,0,0,0,0
1668086704124,ECE 247A,A00,103650,Jokerst; Jesse Vincent,0,0,0,0
1668086704552,ECE 247B,A00,103651,Wang; Joseph,0,0,0,0
1668086704986,ECE 250,A00,103652,Siegel; Paul H.,0,0,0,0
1668086705412,ECE 251A,A00,103654,Rao; Bhaskar D.,0,0,0,0
1668086705837,ECE 257B,A00,103655,Bharadia; Dinesh,0,0,0,0
1668086706265,ECE 258A,A00,103656,Milstein; Laurence B.,0,0,0,0
1668086706689,ECE 260B,A00,103658,Kang; Mingu,0,0,0,0
1668086707119,ECE 264A,A00,103659,Galton; Ian A,0,0,0,0
1668086707551,ECE 265A,A00,103661,Gudem; Prasad S.S.,0,0,0,0
1668086707978,ECE 265D,A00,103662,Gudem; Prasad S.S.,0,0,0,0
1668086708403,ECE 268,A00,103663,Koushanfar; Farinaz,0,0,0,0
1668086708837,ECE 269,A01,103665,Pal; Piya,0,0,0,0
1668086709267,ECE 271B,A00,103666,Vasconcelos; Manuela,0,0,0,0
1668086709693,ECE 276A,A00,103667,Atanasov; Nikolay A.,0,0,0,0
1668086710117,ECE 277,A00,103668,An; Cheolhong,0,0,0,0
1668086710553,ECE 279,A00,117947,Hall; Drew A.,0,0,0,0
1668086711404,ECE 283,A00,103670,Hsueh; Tzu-Chien,0,0,0,0
1668086711832,ECE 284,A00,103671,Turakhia; Yatish Girish,0,0,0,0
1668086712259,ECE 285,A00,103672,Zheng; Yang,0,0,0,0
1668086712259,ECE 285,B00,103673,Sworder; David D.,0,0,0,0
1668086712684,ECE 287,A00,103676,Javidi; Tara,0,0,0,0
1668086713110,MATH 200B,A00,098023,Salehi Golsefidy; Alireza,13,0,15,2
1668086713542,MATH 202B,A00,098024,Rhoades; Brendon Patrick,9,0,15,6
1668086713970,MATH 203B,A00,098025,Oprea; Dragos N.,10,0,15,5
1668086714398,MATH 204B,A00,098026,Sorensen; Claus M,13,0,15,2
1668086714825,MATH 208,A00,098027,Izadi; Elham,7,0,10,3
1668086715252,MATH 209,A00,098028,Pollack; Aaron,10,0,10,0
1668086715790,MATH 211A,A00,112919,Rogalski; Daniel,9,0,10,1
1668086716213,MATH 211B,A00,112920,Seward; Brandon M.,9,0,10,1
1668086716637,MATH 218,A00,098029,Li; Bo,10,0,10,0
1668086717063,MATH 220B,A00,098030,Novak; Jonathan I,12,0,15,3
1668086717496,MATH 221A,A00,098031,Ebenfelt; Peter F,13,0,15,2
1668086717922,MATH 231B,A00,098032,Zlatos; Andrej,12,0,15,3
1668086718347,MATH 240B,A00,098033,Ni; Lei,9,0,15,6
1668086718771,MATH 243,A00,098034,Jekel; David Andrew,10,0,10,0
1668086719200,MATH 245A,A00,098035,Nie; Jiawang,0,0,15,16
1668086719624,MATH 248,A00,098036,Bejenaru; Ioan,10,0,10,0
1668086720050,MATH 250B,A00,098037,Spolaor; Luca,14,0,15,1
1668086720476,MATH 258,A00,098038,Ni; Lei,10,0,10,0
1668086720901,MATH 264B,A00,098041,Rhoades; Brendon Patrick,10,0,15,5
1668086721330,MATH 268,A00,098042,Buss; Samuel R,10,0,10,0
1668086721757,MATH 269,A00,098043,Rhoades; Brendon Patrick,10,0,10,0
1668086722185,MATH 270B,A00,098044,Li; Bo,11,0,15,4
1668086722611,MATH 272B,A00,098045,Holst; Michael J,13,0,15,2
1668086723037,MATH 273A,A00,098046,Tian; Xiaochuan,10,0,15,5
1668086723463,MATH 275,A01,098048,Tian; Xiaochuan,6,0,10,4
1668086723889,MATH 278A,A00,098049,Holst; Michael J,8,0,10,2
1668086724319,MATH 278B,A00,098050,Cloninger; Alexander,10,0,10,0
1668086724746,MATH 278C,A00,098051,Nie; Jiawang,7,0,10,3
1668086725173,MATH 280B,A00,098052,Zheng; Tianyi,10,0,15,5
1668086725600,MATH 281B,A00,098053,Bradic; Jelena,3,0,15,12
1668086726032,MATH 282B,A00,098054,Arias-Castro; Ery,0,0,15,15
1668086726457,MATH 285,A00,098055,Fitzsimmons; Patrick J,0,0,15,17
1668086726885,MATH 287B,A00,098056,Arias-Castro; Ery,3,0,15,12
1668086727313,MATH 288,A00,098057,Agarwal; Pooja,9,0,10,1
1668086727313,MATH 288,B00,098058,Zhang; Danna,8,0,10,2
1668086727313,MATH 288,C00,098059,Williams; Ruth J,10,0,10,0
1668086727739,MATH 290B,A00,098060,Roberts; Justin Deritter,13,0,15,2
1668086728165,MATH 292,A00,098061,Belmont; Eva Kinoshita,10,0,10,0
1668086728588,MATH 295,A00,098062,Suk; Andrew Hoon,48,0,50,2
1668086729012,MATH 296,A00,098063,Novak; Jonathan I,20,0,20,0
1668086729436,MATH 297,001,098064,Gamst; Anthony Collins,9997,0,9999,2
1668087230918,COGS 205,A00,101395,Chiba; Andrea,19,0,20,1
1668087231360,COGS 210B,001,101404,Greene; Deanna Jacquelyn,9998,0,9999,1
1668087231360,COGS 210B,002,101417,Xia; Haijun,9999,0,9999,0
1668087231360,COGS 210B,003,101422,Nitz; Douglas A.,9999,0,9999,0
1668087231360,COGS 210B,004,101423,Hollan; James D.,9998,0,9999,1
1668087231360,COGS 210B,005,101424,Deak; Gedeon O.,9998,0,9999,1
1668087231360,COGS 210B,006,101425,Rossano; Federico,9999,0,9999,0
1668087231785,COGS 211B,A00,101427,Coulson; Seana M,9996,0,9999,3
1668087232212,COGS 220,A00,101428,Hollan; James D.,0,0,25,25
1668087232640,COGS 229,A00,101429,Dow; Steven P,18,0,25,7
1668087233069,COGS 230,A00,101430,Klemmer; Scott R,13,0,17,4
1668087233496,COGS 234,A00,101431,Xia; Haijun,3,0,25,22
1668087233927,COGS 260,A00,101432,Kiyonaga; Anastasia,19,0,25,6
1668087233927,COGS 260,B00,101433,Kirsh; David Joel,16,0,25,9
1668087234363,CSE 202,A00,102371,Impagliazzo; Russell,0,0,0,0
1668087234789,CSE 203B,A01,102373,Cheng; Chung Kuan,0,0,0,0
1668087235214,CSE 208,A00,102374,Micciancio; Daniele,0,0,0,0
1668087235639,CSE 209A,A00,112895,Impagliazzo; Russell,0,0,15,15
1668087236063,CSE 209B,A00,108005,Bellare; Mihir,0,0,0,0
1668087236488,CSE 210,A00,113163,Coblenz; Michael J,0,0,0,0
1668087236916,CSE 219,A00,106111,Dow; Steven P,0,0,20,20
1668087237446,CSE 221,A00,102376,Voelker; Geoffrey M.,0,0,0,0
1668087237872,CSE 224,A01,102378,Porter; George M,0,0,0,0
1668087238307,CSE 229A,A00,102379,Savage; Stefan,0,0,0,0
1668087238731,CSE 229C,A00,102380,Munyaka; Imani N. S.,0,0,0,0
1668087239158,CSE 232B,A00,102382,Deutsch; Alin Bernard,0,0,0,0
1668087239586,CSE 234,A01,112904,Kumar; Arun Kumar,0,0,0,0
1668087240020,CSE 237A,A00,102383,Rosing; Tajana Simunic,0,0,0,0
1668087240445,CSE 239A,A00,102384,Deutsch; Alin Bernard,0,0,0,0
1668087240875,CSE 239B,A00,102385,Polikarpova; Nadezhda,0,0,0,0
1668087241304,CSE 240A,A00,102386,Pannuto; Patrick William,0,0,0,0
1668087241727,CSE 240B,A00,102387,Zhao; Jishen,0,0,0,0
1668087242168,CSE 241A,A00,106406,Kang; Mingu,0,0,0,0
1668087242599,CSE 249B,A00,102388,Kahng; Andrew Byun,0,0,8,8
1668087243037,CSE 251B,A01,102392,Cottrell; Garrison W,0,0,0,0
1668087243037,CSE 251B,A02,102393,Cottrell; Garrison W,0,0,0,0
1668087243472,CSE 252B,A00,102394,Ochoa; Benjamin Lawrence,0,0,0,0
1668087243896,CSE 257,A01,102396,Gao; Sicun,0,0,0,0
1668087244331,CSE 272,A00,102397,Li; Tzumao,0,0,0,0
1668087244760,CSE 274,A00,111323,Chern; Albert Ren-Haur,0,0,0,0
1668087245187,CSE 282,A00,102398,Pevzner; Pavel Arkadjevich,0,0,0,0
1668087245610,CSE 284,A00,114175,Gymrek; Melissa Ann,0,0,0,0
1668087246063,CSE 290,A00,102399,Chandraker; Manmohan Krishna,0,0,0,0
1668087246063,CSE 290,B00,102400,Vaccaro; Kristen Marie,0,0,25,25
1668087246063,CSE 290,C00,102414,Pannuto; Patrick William,0,0,25,25
1668087246063,CSE 290,D00,102427,Pevzner; Pavel Arkadjevich,0,0,0,0
1668087246063,CSE 290,E00,102429,Zhao; Jishen,0,0,0,0
1668087246063,CSE 290,F00,102436,Tullsen; Dean Michael,0,0,0,0
1668087246063,CSE 290,G00,102440,Christensen; Henrik I,0,0,20,20
1668087246500,CSE 291,A00,102443,Su; Hao,0,0,0,0
1668087246500,CSE 291,B00,102448,Polikarpova; Nadezhda,0,0,0,0
1668087246500,CSE 291,C00,102453,Vaccaro; Kristen Marie,0,0,0,0
1668087246500,CSE 291,D00,111343,Savage; Stefan,0,0,0,0
1668087246500,CSE 291,E00,116474,Claffy; Kimberly Claire,0,0,0,0
1668087246500,CSE 291,F00,116479,Pasquale; Joseph,0,0,0,0
1668087246961,CSE 293,001,119111,Bafna; Vineet,9999,0,9999,0
1668087246961,CSE 293,002,119118,Bellare; Mihir,9999,0,9999,0
1668087246961,CSE 293,003,119122,Berg-Kirkpatrick; Taylor D,9999,0,9999,0
1668087246961,CSE 293,004,119135,Christensen; Henrik I,9999,0,9999,0
1668087246961,CSE 293,005,119142,Cottrell; Garrison W,9999,0,9999,0
1668087246961,CSE 293,006,119146,Deutsch; Alin Bernard,9999,0,9999,0
1668087246961,CSE 293,007,119159,Esmaeilzadeh; Hadi,9999,0,9999,0
1668087246961,CSE 293,008,119166,Freund; Yoav,9999,0,9999,0
1668087246961,CSE 293,009,119170,Griswold; William G.,9999,0,9999,0
1668087246961,CSE 293,010,119183,Gymrek; Melissa Ann,9999,0,9999,0
1668087246961,CSE 293,011,119190,Heninger; Nadia A,9999,0,9999,0
1668087246961,CSE 293,012,119230,Impagliazzo; Russell,9999,0,9999,0
1668087246961,CSE 293,013,119232,Jhala; Ranjit,9999,0,9999,0
1668087246961,CSE 293,014,119233,Kahng; Andrew Byun,9999,0,9999,0
1668087246961,CSE 293,015,119298,Kane; Daniel Mertz,9999,0,9999,0
1668087246961,CSE 293,016,119299,Kriegman; David J,9999,0,9999,0
1668087246961,CSE 293,017,119300,Kumar; Arun Kumar,9999,0,9999,0
1668087246961,CSE 293,018,119301,Lerner; Sorin,9999,0,9999,0
1668087246961,CSE 293,019,119302,Lovett; Shachar,9999,0,9999,0
1668087246961,CSE 293,020,119303,McAuley; Julian John,9999,0,9999,0
1668087246961,CSE 293,021,119304,Micciancio; Daniele,9999,0,9999,0
1668087246961,CSE 293,022,119367,Orailoglu; Alex,9999,0,9999,0
1668087246961,CSE 293,023,119382,Paturi; Ramamohan,9999,0,9999,0
1668087246961,CSE 293,024,119404,Polikarpova; Nadezhda,9999,0,9999,0
1668087246961,CSE 293,025,119406,Politz; Joseph Gibbs,9999,0,9999,0
1668087246961,CSE 293,026,119411,Porter; George M,9999,0,9999,0
1668087246961,CSE 293,027,119414,Porter; Leonard Emerson,9999,0,9999,0
1668087246961,CSE 293,028,119416,Ramamoorthi; Ravi,9999,0,9999,0
1668087246961,CSE 293,029,119417,Sahoo; Debashis,9999,0,9999,0
1668087246961,CSE 293,030,119420,Saul; Lawrence,9999,0,9999,0
1668087246961,CSE 293,031,119421,Savage; Stefan,9999,0,9999,0
1668087246961,CSE 293,032,119425,Schulze; Jurgen P.,9999,0,9999,0
1668087246961,CSE 293,033,119426,Snoeren; Alex C.,9999,0,9999,0
1668087246961,CSE 293,034,119428,Shang; Jingbo,9999,0,9999,0
1668087246961,CSE 293,035,119430,Stefan; Deian,9999,0,9999,0
1668087246961,CSE 293,036,119431,Su; Hao,9999,0,9999,0
1668087246961,CSE 293,037,119433,Swanson; Steven James,9999,0,9999,0
1668087246961,CSE 293,038,119435,Tullsen; Dean Michael,9999,0,9999,0
1668087246961,CSE 293,039,119483,Voelker; Geoffrey M.,9999,0,9999,0
1668087246961,CSE 293,040,119537,Zhao; Jishen,9999,0,9999,0
1668087246961,CSE 293,041,119538,Zhou; Yuan-Yuan,9999,0,9999,0
1668087246961,CSE 293,042,119539,Gao; Sicun,9999,0,9999,0
1668087246961,CSE 293,043,119540,Weibel; Nadir,9999,0,9999,0
1668087246961,CSE 293,044,119541,Gupta; Rajesh K.,9999,0,9999,0
1668087246961,CSE 293,045,126410,Vaccaro; Kristen Marie,9999,0,9999,0
1668087246961,CSE 293,046,126411,Klemke; Richard,9999,0,9999,0
1668087247389,CSE 294,A00,102459,Voelker; Geoffrey M.,0,0,0,0
1668087247389,CSE 294,B00,111322,Orailoglu; Alex,0,0,0,0
1668087247816,DSE 201,A00,096914,Deutsch; Alin Bernard,30,0,30,0
1668087248249,DSE 210,A00,096915,Dasgupta; Sanjoy,30,0,30,0
1668087248678,DSE 260A,A00,096916,Altintas De Callaf; Ilkay,30,0,30,0
1668087249121,ECE 200,001,103586,Antipa; Nicholas A,9999,0,9999,0
1668087249121,ECE 200,002,103587,Atanasov; Nikolay A.,9999,0,9999,0
1668087249121,ECE 200,003,103588,Bharadia; Dinesh,9999,0,9999,0
1668087249121,ECE 200,004,103589,Cheng; Chung Kuan,9999,0,9999,0
1668087249121,ECE 200,005,103590,Cosman; Pamela C.,9999,0,9999,0
1668087249121,ECE 200,006,103591,Dayeh; Shadi Ahmad,9999,0,9999,0
1668087249121,ECE 200,007,103592,Fainman; Yeshaiahu,9999,0,9999,0
1668087249121,ECE 200,008,103593,Ford; Joseph Earl,9999,0,9999,0
1668087249121,ECE 200,009,103594,Franceschetti; Massimo,9999,0,9999,0
1668087249121,ECE 200,010,103595,Fullerton; Eric E,9999,0,9999,0
1668087249121,ECE 200,011,103596,Galton; Ian A,9999,0,9999,0
1668087249121,ECE 200,012,103597,Gilja; Vikash,9999,0,9999,0
1668087249121,ECE 200,013,103598,Hall; Drew A.,9999,0,9999,0
1668087249121,ECE 200,014,103599,Hsueh; Tzu-Chien,9999,0,9999,0
1668087249121,ECE 200,015,103600,Javidi; Tara,9999,0,9999,0
1668087249121,ECE 200,016,103601,Kahng; Andrew Byun,9999,0,9999,0
1668087249121,ECE 200,017,103602,Kim; Young-Han,9999,0,9999,0
1668087249121,ECE 200,018,103603,Koushanfar; Farinaz,9999,0,9999,0
1668087249121,ECE 200,019,103604,Kuzum; Duygu,9999,0,9999,0
1668087249121,ECE 200,020,103605,Le; Hanh-Phuc,9999,0,9999,0
1668087249121,ECE 200,021,103606,Lin; Bill,9999,0,9999,0
1668087249121,ECE 200,022,103607,Liu; Zhaowei,9998,0,9999,1
1668087249121,ECE 200,023,103608,Lo; Yu-Hwa,9999,0,9999,0
1668087249121,ECE 200,024,103609,Lomakin; Vitaliy,9999,0,9999,0
1668087249121,ECE 200,025,103610,Mercier; Patrick Philip,9999,0,9999,0
1668087249121,ECE 200,026,103611,Meyer; Florian,9999,0,9999,0
1668087249121,ECE 200,027,103612,Milstein; Laurence B.,9999,0,9999,0
1668087249121,ECE 200,028,103613,Mir Arabbaygi; Siavash,9999,0,9999,0
1668087249121,ECE 200,029,103614,Mookherjea; Shayan,9999,0,9999,0
1668087249121,ECE 200,030,103615,Morris; Karcher William,9999,0,9999,0
1668087249121,ECE 200,031,103616,Ng; Tse Nga,9999,0,9999,0
1668087249121,ECE 200,032,103617,Nguyen; Truong Quang,9999,0,9999,0
1668087249121,ECE 200,033,103618,Nomura; Kenji,9999,0,9999,0
1668087249121,ECE 200,034,103619,Orlitsky; Alon,9999,0,9999,0
1668087249121,ECE 200,035,103620,Pal; Piya,9999,0,9999,0
1668087249121,ECE 200,036,103621,Papen; George C.,9999,0,9999,0
1668087249121,ECE 200,037,103622,Radic; Stojan,9999,0,9999,0
1668087249121,ECE 200,038,103623,Rao; Bhaskar D.,9999,0,9999,0
1668087249121,ECE 200,039,103624,Rao; Ramesh R,9999,0,9999,0
1668087249121,ECE 200,040,103625,Rebeiz; Gabriel,9999,0,9999,0
1668087249121,ECE 200,041,103626,Sanford; John R,9999,0,9999,0
1668087249121,ECE 200,042,103627,Siegel; Paul H.,9999,0,9999,0
1668087249121,ECE 200,043,103628,Sievenpiper; Daniel F.,9999,0,9999,0
1668087249121,ECE 200,044,103629,Sworder; David D.,9999,0,9999,0
1668087249121,ECE 200,045,103630,Taur; Yuan,9999,0,9999,0
1668087249121,ECE 200,046,103631,Touri; Behrouz,9999,0,9999,0
1668087249121,ECE 200,047,103632,Trivedi; Mohan M.,9999,0,9999,0
1668087249121,ECE 200,048,103633,Vasconcelos; Nuno,9999,0,9999,0
1668087249121,ECE 200,049,103634,Wang; Xiaolong,9999,0,9999,0
1668087249121,ECE 200,050,103635,Xie; Pengtao,9999,0,9999,0
1668087249121,ECE 200,051,103636,Yip; Michael,9999,0,9999,0
1668087249121,ECE 200,052,103637,Zeger; Kenneth A.,999,0,999,0
1668087249121,ECE 200,053,103638,Zhang; Xinyu,9999,0,9999,0
1668087249121,ECE 200,054,103639,Turakhia; Yatish Girish,9999,0,9999,0
1668087249121,ECE 200,055,103640,Kang; Mingu,9999,0,9999,0
1668087249121,ECE 200,056,103641,Shi; Yuanyuan,9999,0,9999,0
1668087249121,ECE 200,057,103642,Wang; Edward Jay,9999,0,9999,0
1668087249121,ECE 200,058,103643,Zheng; Yang,9999,0,9999,0
1668087249545,ECE 202,A00,103644,Kuzum; Duygu,0,0,0,0
1668087249975,ECE 212BN,A00,103646,Ng; Tse Nga,0,0,0,0
1668087250412,ECE 221,A00,111493,Staff,0,0,0,0
1668087250835,ECE 222B,A00,103647,Lomakin; Vitaliy,0,0,0,0
1668087251264,ECE 230B,A00,103648,Taur; Yuan,0,0,0,0
1668087251692,ECE 238B,A00,103649,Garay; Javier,0,0,0,0
1668087252124,ECE 240B,A00,112900,Fainman; Yeshaiahu,0,0,0,0
1668087252547,ECE 247A,A00,103650,Jokerst; Jesse Vincent,0,0,0,0
1668087252974,ECE 247B,A00,103651,Wang; Joseph,0,0,0,0
1668087253409,ECE 250,A00,103652,Siegel; Paul H.,0,0,0,0
1668087253835,ECE 251A,A00,103654,Rao; Bhaskar D.,0,0,0,0
1668087254263,ECE 257B,A00,103655,Bharadia; Dinesh,0,0,0,0
1668087254689,ECE 258A,A00,103656,Milstein; Laurence B.,0,0,0,0
1668087255119,ECE 260B,A00,103658,Kang; Mingu,0,0,0,0
1668087255543,ECE 264A,A00,103659,Galton; Ian A,0,0,0,0
1668087255969,ECE 265A,A00,103661,Gudem; Prasad S.S.,0,0,0,0
1668087256404,ECE 265D,A00,103662,Gudem; Prasad S.S.,0,0,0,0
1668087256828,ECE 268,A00,103663,Koushanfar; Farinaz,0,0,0,0
1668087257255,ECE 269,A01,103665,Pal; Piya,0,0,0,0
1668087257680,ECE 271B,A00,103666,Vasconcelos; Manuela,0,0,0,0
1668087258103,ECE 276A,A00,103667,Atanasov; Nikolay A.,0,0,0,0
1668087258527,ECE 277,A00,103668,An; Cheolhong,0,0,0,0
1668087258960,ECE 279,A00,117947,Hall; Drew A.,0,0,0,0
1668087259811,ECE 283,A00,103670,Hsueh; Tzu-Chien,0,0,0,0
1668087260237,ECE 284,A00,103671,Turakhia; Yatish Girish,0,0,0,0
1668087260666,ECE 285,A00,103672,Zheng; Yang,0,0,0,0
1668087260666,ECE 285,B00,103673,Sworder; David D.,0,0,0,0
1668087261091,ECE 287,A00,103676,Javidi; Tara,0,0,0,0
1668087261526,MATH 200B,A00,098023,Salehi Golsefidy; Alireza,13,0,15,2
1668087261957,MATH 202B,A00,098024,Rhoades; Brendon Patrick,9,0,15,6
1668087262386,MATH 203B,A00,098025,Oprea; Dragos N.,10,0,15,5
1668087262810,MATH 204B,A00,098026,Sorensen; Claus M,13,0,15,2
1668087263239,MATH 208,A00,098027,Izadi; Elham,7,0,10,3
1668087263665,MATH 209,A00,098028,Pollack; Aaron,10,0,10,0
1668087264095,MATH 211A,A00,112919,Rogalski; Daniel,9,0,10,1
1668087264518,MATH 211B,A00,112920,Seward; Brandon M.,9,0,10,1
1668087264943,MATH 218,A00,098029,Li; Bo,10,0,10,0
1668087265367,MATH 220B,A00,098030,Novak; Jonathan I,12,0,15,3
1668087265798,MATH 221A,A00,098031,Ebenfelt; Peter F,13,0,15,2
1668087266221,MATH 231B,A00,098032,Zlatos; Andrej,12,0,15,3
1668087266647,MATH 240B,A00,098033,Ni; Lei,9,0,15,6
1668087267071,MATH 243,A00,098034,Jekel; David Andrew,10,0,10,0
1668087267495,MATH 245A,A00,098035,Nie; Jiawang,0,0,15,16
1668087267920,MATH 248,A00,098036,Bejenaru; Ioan,10,0,10,0
1668087268349,MATH 250B,A00,098037,Spolaor; Luca,14,0,15,1
1668087268773,MATH 258,A00,098038,Ni; Lei,10,0,10,0
1668087269204,MATH 264B,A00,098041,Rhoades; Brendon Patrick,10,0,15,5
1668087269629,MATH 268,A00,098042,Buss; Samuel R,10,0,10,0
1668087270057,MATH 269,A00,098043,Rhoades; Brendon Patrick,10,0,10,0
1668087270493,MATH 270B,A00,098044,Li; Bo,11,0,15,4
1668087270917,MATH 272B,A00,098045,Holst; Michael J,13,0,15,2
1668087271343,MATH 273A,A00,098046,Tian; Xiaochuan,10,0,15,5
1668087271772,MATH 275,A01,098048,Tian; Xiaochuan,6,0,10,4
1668087272197,MATH 278A,A00,098049,Holst; Michael J,8,0,10,2
1668087272622,MATH 278B,A00,098050,Cloninger; Alexander,10,0,10,0
1668087273046,MATH 278C,A00,098051,Nie; Jiawang,7,0,10,3
1668087273474,MATH 280B,A00,098052,Zheng; Tianyi,10,0,15,5
1668087273901,MATH 281B,A00,098053,Bradic; Jelena,3,0,15,12
1668087274328,MATH 282B,A00,098054,Arias-Castro; Ery,0,0,15,15
1668087274754,MATH 285,A00,098055,Fitzsimmons; Patrick J,0,0,15,17
1668087275181,MATH 287B,A00,098056,Arias-Castro; Ery,3,0,15,12
1668087275605,MATH 288,A00,098057,Agarwal; Pooja,9,0,10,1
1668087275605,MATH 288,B00,098058,Zhang; Danna,8,0,10,2
1668087275605,MATH 288,C00,098059,Williams; Ruth J,10,0,10,0
1668087276034,MATH 290B,A00,098060,Roberts; Justin Deritter,13,0,15,2
1668087276463,MATH 292,A00,098061,Belmont; Eva Kinoshita,10,0,10,0
1668087276886,MATH 295,A00,098062,Suk; Andrew Hoon,48,0,50,2
1668087277315,MATH 296,A00,098063,Novak; Jonathan I,20,0,20,0
1668087277750,MATH 297,001,098064,Gamst; Anthony Collins,9997,0,9999,2
1668087779247,COGS 205,A00,101395,Chiba; Andrea,19,0,20,1
1668087779681,COGS 210B,001,101404,Greene; Deanna Jacquelyn,9998,0,9999,1
1668087779681,COGS 210B,002,101417,Xia; Haijun,9999,0,9999,0
1668087779681,COGS 210B,003,101422,Nitz; Douglas A.,9999,0,9999,0
1668087779681,COGS 210B,004,101423,Hollan; James D.,9998,0,9999,1
1668087779681,COGS 210B,005,101424,Deak; Gedeon O.,9998,0,9999,1
1668087779681,COGS 210B,006,101425,Rossano; Federico,9999,0,9999,0
1668087780109,COGS 211B,A00,101427,Coulson; Seana M,9996,0,9999,3
1668087780534,COGS 220,A00,101428,Hollan; James D.,0,0,25,25
1668087780961,COGS 229,A00,101429,Dow; Steven P,18,0,25,7
1668087781396,COGS 230,A00,101430,Klemmer; Scott R,13,0,17,4
1668087781819,COGS 234,A00,101431,Xia; Haijun,3,0,25,22
1668087782250,COGS 260,A00,101432,Kiyonaga; Anastasia,19,0,25,6
1668087782250,COGS 260,B00,101433,Kirsh; David Joel,16,0,25,9
1668087782681,CSE 202,A00,102371,Impagliazzo; Russell,0,0,0,0
1668087783106,CSE 203B,A01,102373,Cheng; Chung Kuan,0,0,0,0
1668087783531,CSE 208,A00,102374,Micciancio; Daniele,0,0,0,0
1668087783955,CSE 209A,A00,112895,Impagliazzo; Russell,0,0,15,15
1668087784386,CSE 209B,A00,108005,Bellare; Mihir,0,0,0,0
1668087784811,CSE 210,A00,113163,Coblenz; Michael J,0,0,0,0
1668087785241,CSE 219,A00,106111,Dow; Steven P,0,0,20,20
1668087785670,CSE 221,A00,102376,Voelker; Geoffrey M.,0,0,0,0
1668087786096,CSE 224,A01,102378,Porter; George M,0,0,0,0
1668087786520,CSE 229A,A00,102379,Savage; Stefan,0,0,0,0
1668087786950,CSE 229C,A00,102380,Munyaka; Imani N. S.,0,0,0,0
1668087787380,CSE 232B,A00,102382,Deutsch; Alin Bernard,0,0,0,0
1668087787803,CSE 234,A01,112904,Kumar; Arun Kumar,0,0,0,0
1668087788233,CSE 237A,A00,102383,Rosing; Tajana Simunic,0,0,0,0
1668087788665,CSE 239A,A00,102384,Deutsch; Alin Bernard,0,0,0,0
1668087789092,CSE 239B,A00,102385,Polikarpova; Nadezhda,0,0,0,0
1668087789517,CSE 240A,A00,102386,Pannuto; Patrick William,0,0,0,0
1668087789945,CSE 240B,A00,102387,Zhao; Jishen,0,0,0,0
1668087790382,CSE 241A,A00,106406,Kang; Mingu,0,0,0,0
1668087790811,CSE 249B,A00,102388,Kahng; Andrew Byun,0,0,8,8
1668087791238,CSE 251B,A01,102392,Cottrell; Garrison W,0,0,0,0
1668087791238,CSE 251B,A02,102393,Cottrell; Garrison W,0,0,0,0
1668087791662,CSE 252B,A00,102394,Ochoa; Benjamin Lawrence,0,0,0,0
1668087792086,CSE 257,A01,102396,Gao; Sicun,0,0,0,0
1668087792510,CSE 272,A00,102397,Li; Tzumao,0,0,0,0
1668087792935,CSE 274,A00,111323,Chern; Albert Ren-Haur,0,0,0,0
1668087793362,CSE 282,A00,102398,Pevzner; Pavel Arkadjevich,0,0,0,0
1668087793788,CSE 284,A00,114175,Gymrek; Melissa Ann,0,0,0,0
1668087794221,CSE 290,A00,102399,Chandraker; Manmohan Krishna,0,0,0,0
1668087794221,CSE 290,B00,102400,Vaccaro; Kristen Marie,0,0,25,25
1668087794221,CSE 290,C00,102414,Pannuto; Patrick William,0,0,25,25
1668087794221,CSE 290,D00,102427,Pevzner; Pavel Arkadjevich,0,0,0,0
1668087794221,CSE 290,E00,102429,Zhao; Jishen,0,0,0,0
1668087794221,CSE 290,F00,102436,Tullsen; Dean Michael,0,0,0,0
1668087794221,CSE 290,G00,102440,Christensen; Henrik I,0,0,20,20
1668087794649,CSE 291,A00,102443,Su; Hao,0,0,0,0
1668087794649,CSE 291,B00,102448,Polikarpova; Nadezhda,0,0,0,0
1668087794649,CSE 291,C00,102453,Vaccaro; Kristen Marie,0,0,0,0
1668087794649,CSE 291,D00,111343,Savage; Stefan,0,0,0,0
1668087794649,CSE 291,E00,116474,Claffy; Kimberly Claire,0,0,0,0
1668087794649,CSE 291,F00,116479,Pasquale; Joseph,0,0,0,0
1668087795115,CSE 293,001,119111,Bafna; Vineet,9999,0,9999,0
1668087795115,CSE 293,002,119118,Bellare; Mihir,9999,0,9999,0
1668087795115,CSE 293,003,119122,Berg-Kirkpatrick; Taylor D,9999,0,9999,0
1668087795115,CSE 293,004,119135,Christensen; Henrik I,9999,0,9999,0
1668087795115,CSE 293,005,119142,Cottrell; Garrison W,9999,0,9999,0
1668087795115,CSE 293,006,119146,Deutsch; Alin Bernard,9999,0,9999,0
1668087795115,CSE 293,007,119159,Esmaeilzadeh; Hadi,9999,0,9999,0
1668087795115,CSE 293,008,119166,Freund; Yoav,9999,0,9999,0
1668087795115,CSE 293,009,119170,Griswold; William G.,9999,0,9999,0
1668087795115,CSE 293,010,119183,Gymrek; Melissa Ann,9999,0,9999,0
1668087795115,CSE 293,011,119190,Heninger; Nadia A,9999,0,9999,0
1668087795115,CSE 293,012,119230,Impagliazzo; Russell,9999,0,9999,0
1668087795115,CSE 293,013,119232,Jhala; Ranjit,9999,0,9999,0
1668087795115,CSE 293,014,119233,Kahng; Andrew Byun,9999,0,9999,0
1668087795115,CSE 293,015,119298,Kane; Daniel Mertz,9999,0,9999,0
1668087795115,CSE 293,016,119299,Kriegman; David J,9999,0,9999,0
1668087795115,CSE 293,017,119300,Kumar; Arun Kumar,9999,0,9999,0
1668087795115,CSE 293,018,119301,Lerner; Sorin,9999,0,9999,0
1668087795115,CSE 293,019,119302,Lovett; Shachar,9999,0,9999,0
1668087795115,CSE 293,020,119303,McAuley; Julian John,9999,0,9999,0
1668087795115,CSE 293,021,119304,Micciancio; Daniele,9999,0,9999,0
1668087795115,CSE 293,022,119367,Orailoglu; Alex,9999,0,9999,0
1668087795115,CSE 293,023,119382,Paturi; Ramamohan,9999,0,9999,0
1668087795115,CSE 293,024,119404,Polikarpova; Nadezhda,9999,0,9999,0
1668087795115,CSE 293,025,119406,Politz; Joseph Gibbs,9999,0,9999,0
1668087795115,CSE 293,026,119411,Porter; George M,9999,0,9999,0
1668087795115,CSE 293,027,119414,Porter; Leonard Emerson,9999,0,9999,0
1668087795115,CSE 293,028,119416,Ramamoorthi; Ravi,9999,0,9999,0
1668087795115,CSE 293,029,119417,Sahoo; Debashis,9999,0,9999,0
1668087795115,CSE 293,030,119420,Saul; Lawrence,9999,0,9999,0
1668087795115,CSE 293,031,119421,Savage; Stefan,9999,0,9999,0
1668087795115,CSE 293,032,119425,Schulze; Jurgen P.,9999,0,9999,0
1668087795115,CSE 293,033,119426,Snoeren; Alex C.,9999,0,9999,0
1668087795115,CSE 293,034,119428,Shang; Jingbo,9999,0,9999,0
1668087795115,CSE 293,035,119430,Stefan; Deian,9999,0,9999,0
1668087795115,CSE 293,036,119431,Su; Hao,9999,0,9999,0
1668087795115,CSE 293,037,119433,Swanson; Steven James,9999,0,9999,0
1668087795115,CSE 293,038,119435,Tullsen; Dean Michael,9999,0,9999,0
1668087795115,CSE 293,039,119483,Voelker; Geoffrey M.,9999,0,9999,0
1668087795115,CSE 293,040,119537,Zhao; Jishen,9999,0,9999,0
1668087795115,CSE 293,041,119538,Zhou; Yuan-Yuan,9999,0,9999,0
1668087795115,CSE 293,042,119539,Gao; Sicun,9999,0,9999,0
1668087795115,CSE 293,043,119540,Weibel; Nadir,9999,0,9999,0
1668087795115,CSE 293,044,119541,Gupta; Rajesh K.,9999,0,9999,0
1668087795115,CSE 293,045,126410,Vaccaro; Kristen Marie,9999,0,9999,0
1668087795115,CSE 293,046,126411,Klemke; Richard,9999,0,9999,0
1668087795542,CSE 294,A00,102459,Voelker; Geoffrey M.,0,0,0,0
1668087795542,CSE 294,B00,111322,Orailoglu; Alex,0,0,0,0
1668087795969,DSE 201,A00,096914,Deutsch; Alin Bernard,30,0,30,0
1668087796399,DSE 210,A00,096915,Dasgupta; Sanjoy,30,0,30,0
1668087796830,DSE 260A,A00,096916,Altintas De Callaf; Ilkay,30,0,30,0
1668087797316,ECE 200,001,103586,Antipa; Nicholas A,9999,0,9999,0
1668087797316,ECE 200,002,103587,Atanasov; Nikolay A.,9999,0,9999,0
1668087797316,ECE 200,003,103588,Bharadia; Dinesh,9999,0,9999,0
1668087797316,ECE 200,004,103589,Cheng; Chung Kuan,9999,0,9999,0
1668087797316,ECE 200,005,103590,Cosman; Pamela C.,9999,0,9999,0
1668087797316,ECE 200,006,103591,Dayeh; Shadi Ahmad,9999,0,9999,0
1668087797316,ECE 200,007,103592,Fainman; Yeshaiahu,9999,0,9999,0
1668087797316,ECE 200,008,103593,Ford; Joseph Earl,9999,0,9999,0
1668087797316,ECE 200,009,103594,Franceschetti; Massimo,9999,0,9999,0
1668087797316,ECE 200,010,103595,Fullerton; Eric E,9999,0,9999,0
1668087797316,ECE 200,011,103596,Galton; Ian A,9999,0,9999,0
1668087797316,ECE 200,012,103597,Gilja; Vikash,9999,0,9999,0
1668087797316,ECE 200,013,103598,Hall; Drew A.,9999,0,9999,0
1668087797316,ECE 200,014,103599,Hsueh; Tzu-Chien,9999,0,9999,0
1668087797316,ECE 200,015,103600,Javidi; Tara,9999,0,9999,0
1668087797316,ECE 200,016,103601,Kahng; Andrew Byun,9999,0,9999,0
1668087797316,ECE 200,017,103602,Kim; Young-Han,9999,0,9999,0
1668087797316,ECE 200,018,103603,Koushanfar; Farinaz,9999,0,9999,0
1668087797316,ECE 200,019,103604,Kuzum; Duygu,9999,0,9999,0
1668087797316,ECE 200,020,103605,Le; Hanh-Phuc,9999,0,9999,0
1668087797316,ECE 200,021,103606,Lin; Bill,9999,0,9999,0
1668087797316,ECE 200,022,103607,Liu; Zhaowei,9998,0,9999,1
1668087797316,ECE 200,023,103608,Lo; Yu-Hwa,9999,0,9999,0
1668087797316,ECE 200,024,103609,Lomakin; Vitaliy,9999,0,9999,0
1668087797316,ECE 200,025,103610,Mercier; Patrick Philip,9999,0,9999,0
1668087797316,ECE 200,026,103611,Meyer; Florian,9999,0,9999,0
1668087797316,ECE 200,027,103612,Milstein; Laurence B.,9999,0,9999,0
1668087797316,ECE 200,028,103613,Mir Arabbaygi; Siavash,9999,0,9999,0
1668087797316,ECE 200,029,103614,Mookherjea; Shayan,9999,0,9999,0
1668087797316,ECE 200,030,103615,Morris; Karcher William,9999,0,9999,0
1668087797316,ECE 200,031,103616,Ng; Tse Nga,9999,0,9999,0
1668087797316,ECE 200,032,103617,Nguyen; Truong Quang,9999,0,9999,0
1668087797316,ECE 200,033,103618,Nomura; Kenji,9999,0,9999,0
1668087797316,ECE 200,034,103619,Orlitsky; Alon,9999,0,9999,0
1668087797316,ECE 200,035,103620,Pal; Piya,9999,0,9999,0
1668087797316,ECE 200,036,103621,Papen; George C.,9999,0,9999,0
1668087797316,ECE 200,037,103622,Radic; Stojan,9999,0,9999,0
1668087797316,ECE 200,038,103623,Rao; Bhaskar D.,9999,0,9999,0
1668087797316,ECE 200,039,103624,Rao; Ramesh R,9999,0,9999,0
1668087797316,ECE 200,040,103625,Rebeiz; Gabriel,9999,0,9999,0
1668087797316,ECE 200,041,103626,Sanford; John R,9999,0,9999,0
1668087797316,ECE 200,042,103627,Siegel; Paul H.,9999,0,9999,0
1668087797316,ECE 200,043,103628,Sievenpiper; Daniel F.,9999,0,9999,0
1668087797316,ECE 200,044,103629,Sworder; David D.,9999,0,9999,0
1668087797316,ECE 200,045,103630,Taur; Yuan,9999,0,9999,0
1668087797316,ECE 200,046,103631,Touri; Behrouz,9999,0,9999,0
1668087797316,ECE 200,047,103632,Trivedi; Mohan M.,9999,0,9999,0
1668087797316,ECE 200,048,103633,Vasconcelos; Nuno,9999,0,9999,0
1668087797316,ECE 200,049,103634,Wang; Xiaolong,9999,0,9999,0
1668087797316,ECE 200,050,103635,Xie; Pengtao,9999,0,9999,0
1668087797316,ECE 200,051,103636,Yip; Michael,9999,0,9999,0
1668087797316,ECE 200,052,103637,Zeger; Kenneth A.,999,0,999,0
1668087797316,ECE 200,053,103638,Zhang; Xinyu,9999,0,9999,0
1668087797316,ECE 200,054,103639,Turakhia; Yatish Girish,9999,0,9999,0
1668087797316,ECE 200,055,103640,Kang; Mingu,9999,0,9999,0
1668087797316,ECE 200,056,103641,Shi; Yuanyuan,9999,0,9999,0
1668087797316,ECE 200,057,103642,Wang; Edward Jay,9999,0,9999,0
1668087797316,ECE 200,058,103643,Zheng; Yang,9999,0,9999,0
1668087797747,ECE 202,A00,103644,Kuzum; Duygu,0,0,0,0
1668087798174,ECE 212BN,A00,103646,Ng; Tse Nga,0,0,0,0
1668087798603,ECE 221,A00,111493,Staff,0,0,0,0
1668087799035,ECE 222B,A00,103647,Lomakin; Vitaliy,0,0,0,0
1668087799460,ECE 230B,A00,103648,Taur; Yuan,0,0,0,0
1668087799890,ECE 238B,A00,103649,Garay; Javier,0,0,0,0
1668087800313,ECE 240B,A00,112900,Fainman; Yeshaiahu,0,0,0,0
1668087800739,ECE 247A,A00,103650,Jokerst; Jesse Vincent,0,0,0,0
1668087801175,ECE 247B,A00,103651,Wang; Joseph,0,0,0,0
1668087801605,ECE 250,A00,103652,Siegel; Paul H.,0,0,0,0
1668087802028,ECE 251A,A00,103654,Rao; Bhaskar D.,0,0,0,0
1668087802526,ECE 257B,A00,103655,Bharadia; Dinesh,0,0,0,0
1668087802952,ECE 258A,A00,103656,Milstein; Laurence B.,0,0,0,0
1668087803378,ECE 260B,A00,103658,Kang; Mingu,0,0,0,0
1668087803802,ECE 264A,A00,103659,Galton; Ian A,0,0,0,0
1668087804230,ECE 265A,A00,103661,Gudem; Prasad S.S.,0,0,0,0
1668087804654,ECE 265D,A00,103662,Gudem; Prasad S.S.,0,0,0,0
1668087805079,ECE 268,A00,103663,Koushanfar; Farinaz,0,0,0,0
1668087805507,ECE 269,A01,103665,Pal; Piya,0,0,0,0
1668087805933,ECE 271B,A00,103666,Vasconcelos; Manuela,0,0,0,0
1668087806372,ECE 276A,A00,103667,Atanasov; Nikolay A.,0,0,0,0
1668087806796,ECE 277,A00,103668,An; Cheolhong,0,0,0,0
1668087807221,ECE 279,A00,117947,Hall; Drew A.,0,0,0,0
1668087808076,ECE 283,A00,103670,Hsueh; Tzu-Chien,0,0,0,0
1668087808507,ECE 284,A00,103671,Turakhia; Yatish Girish,0,0,0,0
1668087808937,ECE 285,A00,103672,Zheng; Yang,0,0,0,0
1668087808937,ECE 285,B00,103673,Sworder; David D.,0,0,0,0
1668087809361,ECE 287,A00,103676,Javidi; Tara,0,0,0,0
1668087809789,MATH 200B,A00,098023,Salehi Golsefidy; Alireza,13,0,15,2
1668087810218,MATH 202B,A00,098024,Rhoades; Brendon Patrick,9,0,15,6
1668087810645,MATH 203B,A00,098025,Oprea; Dragos N.,10,0,15,5
1668087811074,MATH 204B,A00,098026,Sorensen; Claus M,13,0,15,2
1668087811500,MATH 208,A00,098027,Izadi; Elham,7,0,10,3
1668087811924,MATH 209,A00,098028,Pollack; Aaron,10,0,10,0
1668087812356,MATH 211A,A00,112919,Rogalski; Daniel,9,0,10,1
1668087812786,MATH 211B,A00,112920,Seward; Brandon M.,9,0,10,1
1668087813213,MATH 218,A00,098029,Li; Bo,10,0,10,0
1668087813638,MATH 220B,A00,098030,Novak; Jonathan I,12,0,15,3
1668087814071,MATH 221A,A00,098031,Ebenfelt; Peter F,13,0,15,2
1668087814497,MATH 231B,A00,098032,Zlatos; Andrej,12,0,15,3
1668087814927,MATH 240B,A00,098033,Ni; Lei,9,0,15,6
1668087815353,MATH 243,A00,098034,Jekel; David Andrew,10,0,10,0
1668087815782,MATH 245A,A00,098035,Nie; Jiawang,0,0,15,16
1668087816206,MATH 248,A00,098036,Bejenaru; Ioan,10,0,10,0
1668087816657,MATH 250B,A00,098037,Spolaor; Luca,14,0,15,1
1668087817087,MATH 258,A00,098038,Ni; Lei,10,0,10,0
1668087817515,MATH 264B,A00,098041,Rhoades; Brendon Patrick,10,0,15,5
1668087817939,MATH 268,A00,098042,Buss; Samuel R,10,0,10,0
1668087818365,MATH 269,A00,098043,Rhoades; Brendon Patrick,10,0,10,0
1668087818791,MATH 270B,A00,098044,Li; Bo,11,0,15,4
1668087819216,MATH 272B,A00,098045,Holst; Michael J,13,0,15,2
1668087819645,MATH 273A,A00,098046,Tian; Xiaochuan,10,0,15,5
1668087820075,MATH 275,A01,098048,Tian; Xiaochuan,6,0,10,4
1668087820503,MATH 278A,A00,098049,Holst; Michael J,8,0,10,2
1668087820931,MATH 278B,A00,098050,Cloninger; Alexander,10,0,10,0
1668087821356,MATH 278C,A00,098051,Nie; Jiawang,7,0,10,3
1668087821783,MATH 280B,A00,098052,Zheng; Tianyi,10,0,15,5
1668087822206,MATH 281B,A00,098053,Bradic; Jelena,3,0,15,12
1668087822629,MATH 282B,A00,098054,Arias-Castro; Ery,0,0,15,15
1668087823054,MATH 285,A00,098055,Fitzsimmons; Patrick J,0,0,15,17
1668087823480,MATH 287B,A00,098056,Arias-Castro; Ery,3,0,15,12
1668087823907,MATH 288,A00,098057,Agarwal; Pooja,9,0,10,1
1668087823907,MATH 288,B00,098058,Zhang; Danna,8,0,10,2
1668087823907,MATH 288,C00,098059,Williams; Ruth J,10,0,10,0
1668087824332,MATH 290B,A00,098060,Roberts; Justin Deritter,13,0,15,2
1668087824756,MATH 292,A00,098061,Belmont; Eva Kinoshita,10,0,10,0
1668087825178,MATH 295,A00,098062,Suk; Andrew Hoon,48,0,50,2
1668087825602,MATH 296,A00,098063,Novak; Jonathan I,20,0,20,0
1668087826030,MATH 297,001,098064,Gamst; Anthony Collins,9997,0,9999,2
1668088326956,COGS 205,A00,101395,Chiba; Andrea,19,0,20,1
1668088327383,COGS 210B,001,101404,Greene; Deanna Jacquelyn,9998,0,9999,1
1668088327383,COGS 210B,002,101417,Xia; Haijun,9999,0,9999,0
1668088327383,COGS 210B,003,101422,Nitz; Douglas A.,9999,0,9999,0
1668088327383,COGS 210B,004,101423,Hollan; James D.,9998,0,9999,1
1668088327383,COGS 210B,005,101424,Deak; Gedeon O.,9998,0,9999,1
1668088327383,COGS 210B,006,101425,Rossano; Federico,9999,0,9999,0
1668088327809,COGS 211B,A00,101427,Coulson; Seana M,9996,0,9999,3
1668088328244,COGS 220,A00,101428,Hollan; James D.,0,0,25,25
1668088328670,COGS 229,A00,101429,Dow; Steven P,18,0,25,7
1668088329096,COGS 230,A00,101430,Klemmer; Scott R,13,0,17,4
1668088329521,COGS 234,A00,101431,Xia; Haijun,3,0,25,22
1668088329947,COGS 260,A00,101432,Kiyonaga; Anastasia,19,0,25,6
1668088329947,COGS 260,B00,101433,Kirsh; David Joel,16,0,25,9
1668088330371,CSE 202,A00,102371,Impagliazzo; Russell,0,0,0,0
1668088330796,CSE 203B,A01,102373,Cheng; Chung Kuan,0,0,0,0
1668088331225,CSE 208,A00,102374,Micciancio; Daniele,0,0,0,0
1668088331651,CSE 209A,A00,112895,Impagliazzo; Russell,0,0,15,15
1668088332078,CSE 209B,A00,108005,Bellare; Mihir,0,0,0,0
1668088332503,CSE 210,A00,113163,Coblenz; Michael J,0,0,0,0
1668088332933,CSE 219,A00,106111,Dow; Steven P,0,0,20,20
1668088333358,CSE 221,A00,102376,Voelker; Geoffrey M.,0,0,0,0
1668088333782,CSE 224,A01,102378,Porter; George M,0,0,0,0
1668088334207,CSE 229A,A00,102379,Savage; Stefan,0,0,0,0
1668088334632,CSE 229C,A00,102380,Munyaka; Imani N. S.,0,0,0,0
1668088335057,CSE 232B,A00,102382,Deutsch; Alin Bernard,0,0,0,0
1668088335484,CSE 234,A01,112904,Kumar; Arun Kumar,0,0,0,0
1668088335915,CSE 237A,A00,102383,Rosing; Tajana Simunic,0,0,0,0
1668088336338,CSE 239A,A00,102384,Deutsch; Alin Bernard,0,0,0,0
1668088336784,CSE 239B,A00,102385,Polikarpova; Nadezhda,0,0,0,0
1668088337210,CSE 240A,A00,102386,Pannuto; Patrick William,0,0,0,0
1668088337634,CSE 240B,A00,102387,Zhao; Jishen,0,0,0,0
1668088338058,CSE 241A,A00,106406,Kang; Mingu,0,0,0,0
1668088338487,CSE 249B,A00,102388,Kahng; Andrew Byun,0,0,8,8
1668088338914,CSE 251B,A01,102392,Cottrell; Garrison W,0,0,0,0
1668088338914,CSE 251B,A02,102393,Cottrell; Garrison W,0,0,0,0
1668088339339,CSE 252B,A00,102394,Ochoa; Benjamin Lawrence,0,0,0,0
1668088339764,CSE 257,A01,102396,Gao; Sicun,0,0,0,0
1668088340187,CSE 272,A00,102397,Li; Tzumao,0,0,0,0
1668088340610,CSE 274,A00,111323,Chern; Albert Ren-Haur,0,0,0,0
1668088341033,CSE 282,A00,102398,Pevzner; Pavel Arkadjevich,0,0,0,0
1668088341464,CSE 284,A00,114175,Gymrek; Melissa Ann,0,0,0,0
1668088341893,CSE 290,A00,102399,Chandraker; Manmohan Krishna,0,0,0,0
1668088341893,CSE 290,B00,102400,Vaccaro; Kristen Marie,0,0,25,25
1668088341893,CSE 290,C00,102414,Pannuto; Patrick William,0,0,25,25
1668088341893,CSE 290,D00,102427,Pevzner; Pavel Arkadjevich,0,0,0,0
1668088341893,CSE 290,E00,102429,Zhao; Jishen,0,0,0,0
1668088341893,CSE 290,F00,102436,Tullsen; Dean Michael,0,0,0,0
1668088341893,CSE 290,G00,102440,Christensen; Henrik I,0,0,20,20
1668088342320,CSE 291,A00,102443,Su; Hao,0,0,0,0
1668088342320,CSE 291,B00,102448,Polikarpova; Nadezhda,0,0,0,0
1668088342320,CSE 291,C00,102453,Vaccaro; Kristen Marie,0,0,0,0
1668088342320,CSE 291,D00,111343,Savage; Stefan,0,0,0,0
1668088342320,CSE 291,E00,116474,Claffy; Kimberly Claire,0,0,0,0
1668088342320,CSE 291,F00,116479,Pasquale; Joseph,0,0,0,0
1668088342753,CSE 293,001,119111,Bafna; Vineet,9999,0,9999,0
1668088342753,CSE 293,002,119118,Bellare; Mihir,9999,0,9999,0
1668088342753,CSE 293,003,119122,Berg-Kirkpatrick; Taylor D,9999,0,9999,0
1668088342753,CSE 293,004,119135,Christensen; Henrik I,9999,0,9999,0
1668088342753,CSE 293,005,119142,Cottrell; Garrison W,9999,0,9999,0
1668088342753,CSE 293,006,119146,Deutsch; Alin Bernard,9999,0,9999,0
1668088342753,CSE 293,007,119159,Esmaeilzadeh; Hadi,9999,0,9999,0
1668088342753,CSE 293,008,119166,Freund; Yoav,9999,0,9999,0
1668088342753,CSE 293,009,119170,Griswold; William G.,9999,0,9999,0
1668088342753,CSE 293,010,119183,Gymrek; Melissa Ann,9999,0,9999,0
1668088342753,CSE 293,011,119190,Heninger; Nadia A,9999,0,9999,0
1668088342753,CSE 293,012,119230,Impagliazzo; Russell,9999,0,9999,0
1668088342753,CSE 293,013,119232,Jhala; Ranjit,9999,0,9999,0
1668088342753,CSE 293,014,119233,Kahng; Andrew Byun,9999,0,9999,0
1668088342753,CSE 293,015,119298,Kane; Daniel Mertz,9999,0,9999,0
1668088342753,CSE 293,016,119299,Kriegman; David J,9999,0,9999,0
1668088342753,CSE 293,017,119300,Kumar; Arun Kumar,9999,0,9999,0
1668088342753,CSE 293,018,119301,Lerner; Sorin,9999,0,9999,0
1668088342753,CSE 293,019,119302,Lovett; Shachar,9999,0,9999,0
1668088342753,CSE 293,020,119303,McAuley; Julian John,9999,0,9999,0
1668088342753,CSE 293,021,119304,Micciancio; Daniele,9999,0,9999,0
1668088342753,CSE 293,022,119367,Orailoglu; Alex,9999,0,9999,0
1668088342753,CSE 293,023,119382,Paturi; Ramamohan,9999,0,9999,0
1668088342753,CSE 293,024,119404,Polikarpova; Nadezhda,9999,0,9999,0
1668088342753,CSE 293,025,119406,Politz; Joseph Gibbs,9999,0,9999,0
1668088342753,CSE 293,026,119411,Porter; George M,9999,0,9999,0
1668088342753,CSE 293,027,119414,Porter; Leonard Emerson,9999,0,9999,0
1668088342753,CSE 293,028,119416,Ramamoorthi; Ravi,9999,0,9999,0
1668088342753,CSE 293,029,119417,Sahoo; Debashis,9999,0,9999,0
1668088342753,CSE 293,030,119420,Saul; Lawrence,9999,0,9999,0
1668088342753,CSE 293,031,119421,Savage; Stefan,9999,0,9999,0
1668088342753,CSE 293,032,119425,Schulze; Jurgen P.,9999,0,9999,0
1668088342753,CSE 293,033,119426,Snoeren; Alex C.,9999,0,9999,0
1668088342753,CSE 293,034,119428,Shang; Jingbo,9999,0,9999,0
1668088342753,CSE 293,035,119430,Stefan; Deian,9999,0,9999,0
1668088342753,CSE 293,036,119431,Su; Hao,9999,0,9999,0
1668088342753,CSE 293,037,119433,Swanson; Steven James,9999,0,9999,0
1668088342753,CSE 293,038,119435,Tullsen; Dean Michael,9999,0,9999,0
1668088342753,CSE 293,039,119483,Voelker; Geoffrey M.,9999,0,9999,0
1668088342753,CSE 293,040,119537,Zhao; Jishen,9999,0,9999,0
1668088342753,CSE 293,041,119538,Zhou; Yuan-Yuan,9999,0,9999,0
1668088342753,CSE 293,042,119539,Gao; Sicun,9999,0,9999,0
1668088342753,CSE 293,043,119540,Weibel; Nadir,9999,0,9999,0
1668088342753,CSE 293,044,119541,Gupta; Rajesh K.,9999,0,9999,0
1668088342753,CSE 293,045,126410,Vaccaro; Kristen Marie,9999,0,9999,0
1668088342753,CSE 293,046,126411,Klemke; Richard,9999,0,9999,0
1668088343180,CSE 294,A00,102459,Voelker; Geoffrey M.,0,0,0,0
1668088343180,CSE 294,B00,111322,Orailoglu; Alex,0,0,0,0
1668088343608,DSE 201,A00,096914,Deutsch; Alin Bernard,30,0,30,0
1668088344036,DSE 210,A00,096915,Dasgupta; Sanjoy,30,0,30,0
1668088344458,DSE 260A,A00,096916,Altintas De Callaf; Ilkay,30,0,30,0
1668088344904,ECE 200,001,103586,Antipa; Nicholas A,9999,0,9999,0
1668088344904,ECE 200,002,103587,Atanasov; Nikolay A.,9999,0,9999,0
1668088344904,ECE 200,003,103588,Bharadia; Dinesh,9999,0,9999,0
1668088344904,ECE 200,004,103589,Cheng; Chung Kuan,9999,0,9999,0
1668088344904,ECE 200,005,103590,Cosman; Pamela C.,9999,0,9999,0
1668088344904,ECE 200,006,103591,Dayeh; Shadi Ahmad,9999,0,9999,0
1668088344904,ECE 200,007,103592,Fainman; Yeshaiahu,9999,0,9999,0
1668088344904,ECE 200,008,103593,Ford; Joseph Earl,9999,0,9999,0
1668088344904,ECE 200,009,103594,Franceschetti; Massimo,9999,0,9999,0
1668088344904,ECE 200,010,103595,Fullerton; Eric E,9999,0,9999,0
1668088344904,ECE 200,011,103596,Galton; Ian A,9999,0,9999,0
1668088344904,ECE 200,012,103597,Gilja; Vikash,9999,0,9999,0
1668088344904,ECE 200,013,103598,Hall; Drew A.,9999,0,9999,0
1668088344904,ECE 200,014,103599,Hsueh; Tzu-Chien,9999,0,9999,0
1668088344904,ECE 200,015,103600,Javidi; Tara,9999,0,9999,0
1668088344904,ECE 200,016,103601,Kahng; Andrew Byun,9999,0,9999,0
1668088344904,ECE 200,017,103602,Kim; Young-Han,9999,0,9999,0
1668088344904,ECE 200,018,103603,Koushanfar; Farinaz,9999,0,9999,0
1668088344904,ECE 200,019,103604,Kuzum; Duygu,9999,0,9999,0
1668088344904,ECE 200,020,103605,Le; Hanh-Phuc,9999,0,9999,0
1668088344904,ECE 200,021,103606,Lin; Bill,9999,0,9999,0
1668088344904,ECE 200,022,103607,Liu; Zhaowei,9998,0,9999,1
1668088344904,ECE 200,023,103608,Lo; Yu-Hwa,9999,0,9999,0
1668088344904,ECE 200,024,103609,Lomakin; Vitaliy,9999,0,9999,0
1668088344904,ECE 200,025,103610,Mercier; Patrick Philip,9999,0,9999,0
1668088344904,ECE 200,026,103611,Meyer; Florian,9999,0,9999,0
1668088344904,ECE 200,027,103612,Milstein; Laurence B.,9999,0,9999,0
1668088344904,ECE 200,028,103613,Mir Arabbaygi; Siavash,9999,0,9999,0
1668088344904,ECE 200,029,103614,Mookherjea; Shayan,9999,0,9999,0
1668088344904,ECE 200,030,103615,Morris; Karcher William,9999,0,9999,0
1668088344904,ECE 200,031,103616,Ng; Tse Nga,9999,0,9999,0
1668088344904,ECE 200,032,103617,Nguyen; Truong Quang,9999,0,9999,0
1668088344904,ECE 200,033,103618,Nomura; Kenji,9999,0,9999,0
1668088344904,ECE 200,034,103619,Orlitsky; Alon,9999,0,9999,0
1668088344904,ECE 200,035,103620,Pal; Piya,9999,0,9999,0
1668088344904,ECE 200,036,103621,Papen; George C.,9999,0,9999,0
1668088344904,ECE 200,037,103622,Radic; Stojan,9999,0,9999,0
1668088344904,ECE 200,038,103623,Rao; Bhaskar D.,9999,0,9999,0
1668088344904,ECE 200,039,103624,Rao; Ramesh R,9999,0,9999,0
1668088344904,ECE 200,040,103625,Rebeiz; Gabriel,9999,0,9999,0
1668088344904,ECE 200,041,103626,Sanford; John R,9999,0,9999,0
1668088344904,ECE 200,042,103627,Siegel; Paul H.,9999,0,9999,0
1668088344904,ECE 200,043,103628,Sievenpiper; Daniel F.,9999,0,9999,0
1668088344904,ECE 200,044,103629,Sworder; David D.,9999,0,9999,0
1668088344904,ECE 200,045,103630,Taur; Yuan,9999,0,9999,0
1668088344904,ECE 200,046,103631,Touri; Behrouz,9999,0,9999,0
1668088344904,ECE 200,047,103632,Trivedi; Mohan M.,9999,0,9999,0
1668088344904,ECE 200,048,103633,Vasconcelos; Nuno,9999,0,9999,0
1668088344904,ECE 200,049,103634,Wang; Xiaolong,9999,0,9999,0
1668088344904,ECE 200,050,103635,Xie; Pengtao,9999,0,9999,0
1668088344904,ECE 200,051,103636,Yip; Michael,9999,0,9999,0
1668088344904,ECE 200,052,103637,Zeger; Kenneth A.,999,0,999,0
1668088344904,ECE 200,053,103638,Zhang; Xinyu,9999,0,9999,0
1668088344904,ECE 200,054,103639,Turakhia; Yatish Girish,9999,0,9999,0
1668088344904,ECE 200,055,103640,Kang; Mingu,9999,0,9999,0
1668088344904,ECE 200,056,103641,Shi; Yuanyuan,9999,0,9999,0
1668088344904,ECE 200,057,103642,Wang; Edward Jay,9999,0,9999,0
1668088344904,ECE 200,058,103643,Zheng; Yang,9999,0,9999,0
1668088345328,ECE 202,A00,103644,Kuzum; Duygu,0,0,0,0
1668088345757,ECE 212BN,A00,103646,Ng; Tse Nga,0,0,0,0
1668088346180,ECE 221,A00,111493,Staff,0,0,0,0
1668088346607,ECE 222B,A00,103647,Lomakin; Vitaliy,0,0,0,0
1668088347031,ECE 230B,A00,103648,Taur; Yuan,0,0,0,0
1668088347456,ECE 238B,A00,103649,Garay; Javier,0,0,0,0
1668088347883,ECE 240B,A00,112900,Fainman; Yeshaiahu,0,0,0,0
1668088348310,ECE 247A,A00,103650,Jokerst; Jesse Vincent,0,0,0,0
1668088348733,ECE 247B,A00,103651,Wang; Joseph,0,0,0,0
1668088349156,ECE 250,A00,103652,Siegel; Paul H.,0,0,0,0
1668088349584,ECE 251A,A00,103654,Rao; Bhaskar D.,0,0,0,0
1668088350009,ECE 257B,A00,103655,Bharadia; Dinesh,0,0,0,0
1668088350433,ECE 258A,A00,103656,Milstein; Laurence B.,0,0,0,0
1668088350862,ECE 260B,A00,103658,Kang; Mingu,0,0,0,0
1668088351294,ECE 264A,A00,103659,Galton; Ian A,0,0,0,0
1668088351725,ECE 265A,A00,103661,Gudem; Prasad S.S.,0,0,0,0
1668088352164,ECE 265D,A00,103662,Gudem; Prasad S.S.,0,0,0,0
1668088352586,ECE 268,A00,103663,Koushanfar; Farinaz,0,0,0,0
1668088353010,ECE 269,A01,103665,Pal; Piya,0,0,0,0
1668088353447,ECE 271B,A00,103666,Vasconcelos; Manuela,0,0,0,0
1668088353883,ECE 276A,A00,103667,Atanasov; Nikolay A.,0,0,0,0
1668088354321,ECE 277,A00,103668,An; Cheolhong,0,0,0,0
1668088354747,ECE 279,A00,117947,Hall; Drew A.,0,0,0,0
1668088355595,ECE 283,A00,103670,Hsueh; Tzu-Chien,0,0,0,0
1668088356018,ECE 284,A00,103671,Turakhia; Yatish Girish,0,0,0,0
1668088356441,ECE 285,A00,103672,Zheng; Yang,0,0,0,0
1668088356441,ECE 285,B00,103673,Sworder; David D.,0,0,0,0
1668088356867,ECE 287,A00,103676,Javidi; Tara,0,0,0,0
1668088357290,MATH 200B,A00,098023,Salehi Golsefidy; Alireza,13,0,15,2
1668088357716,MATH 202B,A00,098024,Rhoades; Brendon Patrick,9,0,15,6
1668088358150,MATH 203B,A00,098025,Oprea; Dragos N.,10,0,15,5
1668088358577,MATH 204B,A00,098026,Sorensen; Claus M,13,0,15,2
1668088359003,MATH 208,A00,098027,Izadi; Elham,7,0,10,3
1668088359428,MATH 209,A00,098028,Pollack; Aaron,10,0,10,0
1668088359851,MATH 211A,A00,112919,Rogalski; Daniel,9,0,10,1
1668088360276,MATH 211B,A00,112920,Seward; Brandon M.,9,0,10,1
1668088360701,MATH 218,A00,098029,Li; Bo,10,0,10,0
1668088361124,MATH 220B,A00,098030,Novak; Jonathan I,12,0,15,3
1668088361551,MATH 221A,A00,098031,Ebenfelt; Peter F,13,0,15,2
1668088361990,MATH 231B,A00,098032,Zlatos; Andrej,12,0,15,3
1668088362415,MATH 240B,A00,098033,Ni; Lei,9,0,15,6
1668088362841,MATH 243,A00,098034,Jekel; David Andrew,10,0,10,0
1668088363280,MATH 245A,A00,098035,Nie; Jiawang,0,0,15,16
1668088363703,MATH 248,A00,098036,Bejenaru; Ioan,10,0,10,0
1668088364132,MATH 250B,A00,098037,Spolaor; Luca,14,0,15,1
1668088364557,MATH 258,A00,098038,Ni; Lei,10,0,10,0
1668088364983,MATH 264B,A00,098041,Rhoades; Brendon Patrick,10,0,15,5
1668088365409,MATH 268,A00,098042,Buss; Samuel R,10,0,10,0
1668088365837,MATH 269,A00,098043,Rhoades; Brendon Patrick,10,0,10,0
1668088366262,MATH 270B,A00,098044,Li; Bo,11,0,15,4
1668088366782,MATH 272B,A00,098045,Holst; Michael J,13,0,15,2
1668088367209,MATH 273A,A00,098046,Tian; Xiaochuan,10,0,15,5
1668088367635,MATH 275,A01,098048,Tian; Xiaochuan,6,0,10,4
1668088368059,MATH 278A,A00,098049,Holst; Michael J,8,0,10,2
1668088368494,MATH 278B,A00,098050,Cloninger; Alexander,10,0,10,0
1668088368931,MATH 278C,A00,098051,Nie; Jiawang,7,0,10,3
1668088369360,MATH 280B,A00,098052,Zheng; Tianyi,10,0,15,5
1668088369783,MATH 281B,A00,098053,Bradic; Jelena,3,0,15,12
1668088370208,MATH 282B,A00,098054,Arias-Castro; Ery,0,0,15,15
1668088370653,MATH 285,A00,098055,Fitzsimmons; Patrick J,0,0,15,17
1668088371083,MATH 287B,A00,098056,Arias-Castro; Ery,3,0,15,12
1668088371514,MATH 288,A00,098057,Agarwal; Pooja,9,0,10,1
1668088371514,MATH 288,B00,098058,Zhang; Danna,8,0,10,2
1668088371514,MATH 288,C00,098059,Williams; Ruth J,10,0,10,0
1668088371950,MATH 290B,A00,098060,Roberts; Justin Deritter,13,0,15,2
1668088372375,MATH 292,A00,098061,Belmont; Eva Kinoshita,10,0,10,0
1668088372812,MATH 295,A00,098062,Suk; Andrew Hoon,48,0,50,2
1668088373235,MATH 296,A00,098063,Novak; Jonathan I,20,0,20,0
1668088373662,MATH 297,001,098064,Gamst; Anthony Collins,9997,0,9999,2
1668088875046,COGS 205,A00,101395,Chiba; Andrea,19,0,20,1
1668088875469,COGS 210B,001,101404,Greene; Deanna Jacquelyn,9998,0,9999,1
1668088875469,COGS 210B,002,101417,Xia; Haijun,9999,0,9999,0
1668088875469,COGS 210B,003,101422,Nitz; Douglas A.,9999,0,9999,0
1668088875469,COGS 210B,004,101423,Hollan; James D.,9998,0,9999,1
1668088875469,COGS 210B,005,101424,Deak; Gedeon O.,9998,0,9999,1
1668088875469,COGS 210B,006,101425,Rossano; Federico,9999,0,9999,0
1668088875904,COGS 211B,A00,101427,Coulson; Seana M,9996,0,9999,3
1668088876330,COGS 220,A00,101428,Hollan; James D.,0,0,25,25
1668088876754,COGS 229,A00,101429,Dow; Steven P,18,0,25,7
1668088877184,COGS 230,A00,101430,Klemmer; Scott R,13,0,17,4
1668088877610,COGS 234,A00,101431,Xia; Haijun,3,0,25,22
1668088878043,COGS 260,A00,101432,Kiyonaga; Anastasia,19,0,25,6
1668088878043,COGS 260,B00,101433,Kirsh; David Joel,16,0,25,9
1668088878476,CSE 202,A00,102371,Impagliazzo; Russell,0,0,0,0
1668088878912,CSE 203B,A01,102373,Cheng; Chung Kuan,0,0,0,0
1668088879347,CSE 208,A00,102374,Micciancio; Daniele,0,0,0,0
1668088879780,CSE 209A,A00,112895,Impagliazzo; Russell,0,0,15,15
1668088880218,CSE 209B,A00,108005,Bellare; Mihir,0,0,0,0
1668088880681,CSE 210,A00,113163,Coblenz; Michael J,0,0,0,0
1668088881117,CSE 219,A00,106111,Dow; Steven P,0,0,20,20
1668088881541,CSE 221,A00,102376,Voelker; Geoffrey M.,0,0,0,0
1668088881967,CSE 224,A01,102378,Porter; George M,0,0,0,0
1668088882393,CSE 229A,A00,102379,Savage; Stefan,0,0,0,0
1668088882823,CSE 229C,A00,102380,Munyaka; Imani N. S.,0,0,0,0
1668088883249,CSE 232B,A00,102382,Deutsch; Alin Bernard,0,0,0,0
1668088883677,CSE 234,A01,112904,Kumar; Arun Kumar,0,0,0,0
1668088884103,CSE 237A,A00,102383,Rosing; Tajana Simunic,0,0,0,0
1668088884525,CSE 239A,A00,102384,Deutsch; Alin Bernard,0,0,0,0
1668088884952,CSE 239B,A00,102385,Polikarpova; Nadezhda,0,0,0,0
1668088885374,CSE 240A,A00,102386,Pannuto; Patrick William,0,0,0,0
1668088885798,CSE 240B,A00,102387,Zhao; Jishen,0,0,0,0
1668088886226,CSE 241A,A00,106406,Kang; Mingu,0,0,0,0
1668088886650,CSE 249B,A00,102388,Kahng; Andrew Byun,0,0,8,8
1668088887090,CSE 251B,A01,102392,Cottrell; Garrison W,0,0,0,0
1668088887090,CSE 251B,A02,102393,Cottrell; Garrison W,0,0,0,0
1668088887525,CSE 252B,A00,102394,Ochoa; Benjamin Lawrence,0,0,0,0
1668088887957,CSE 257,A01,102396,Gao; Sicun,0,0,0,0
1668088888488,CSE 272,A00,102397,Li; Tzumao,0,0,0,0
1668088888913,CSE 274,A00,111323,Chern; Albert Ren-Haur,0,0,0,0
1668088889338,CSE 282,A00,102398,Pevzner; Pavel Arkadjevich,0,0,0,0
1668088889762,CSE 284,A00,114175,Gymrek; Melissa Ann,0,0,0,0
1668088890186,CSE 290,A00,102399,Chandraker; Manmohan Krishna,0,0,0,0
1668088890186,CSE 290,B00,102400,Vaccaro; Kristen Marie,0,0,25,25
1668088890186,CSE 290,C00,102414,Pannuto; Patrick William,0,0,25,25
1668088890186,CSE 290,D00,102427,Pevzner; Pavel Arkadjevich,0,0,0,0
1668088890186,CSE 290,E00,102429,Zhao; Jishen,0,0,0,0
1668088890186,CSE 290,F00,102436,Tullsen; Dean Michael,0,0,0,0
1668088890186,CSE 290,G00,102440,Christensen; Henrik I,0,0,20,20
1668088890617,CSE 291,A00,102443,Su; Hao,0,0,0,0
1668088890617,CSE 291,B00,102448,Polikarpova; Nadezhda,0,0,0,0
1668088890617,CSE 291,C00,102453,Vaccaro; Kristen Marie,0,0,0,0
1668088890617,CSE 291,D00,111343,Savage; Stefan,0,0,0,0
1668088890617,CSE 291,E00,116474,Claffy; Kimberly Claire,0,0,0,0
1668088890617,CSE 291,F00,116479,Pasquale; Joseph,0,0,0,0
1668088891060,CSE 293,001,119111,Bafna; Vineet,9999,0,9999,0
1668088891060,CSE 293,002,119118,Bellare; Mihir,9999,0,9999,0
1668088891060,CSE 293,003,119122,Berg-Kirkpatrick; Taylor D,9999,0,9999,0
1668088891060,CSE 293,004,119135,Christensen; Henrik I,9999,0,9999,0
1668088891060,CSE 293,005,119142,Cottrell; Garrison W,9999,0,9999,0
1668088891060,CSE 293,006,119146,Deutsch; Alin Bernard,9999,0,9999,0
1668088891060,CSE 293,007,119159,Esmaeilzadeh; Hadi,9999,0,9999,0
1668088891060,CSE 293,008,119166,Freund; Yoav,9999,0,9999,0
1668088891060,CSE 293,009,119170,Griswold; William G.,9999,0,9999,0
1668088891060,CSE 293,010,119183,Gymrek; Melissa Ann,9999,0,9999,0
1668088891060,CSE 293,011,119190,Heninger; Nadia A,9999,0,9999,0
1668088891060,CSE 293,012,119230,Impagliazzo; Russell,9999,0,9999,0
1668088891060,CSE 293,013,119232,Jhala; Ranjit,9999,0,9999,0
1668088891060,CSE 293,014,119233,Kahng; Andrew Byun,9999,0,9999,0
1668088891060,CSE 293,015,119298,Kane; Daniel Mertz,9999,0,9999,0
1668088891060,CSE 293,016,119299,Kriegman; David J,9999,0,9999,0
1668088891060,CSE 293,017,119300,Kumar; Arun Kumar,9999,0,9999,0
1668088891060,CSE 293,018,119301,Lerner; Sorin,9999,0,9999,0
1668088891060,CSE 293,019,119302,Lovett; Shachar,9999,0,9999,0
1668088891060,CSE 293,020,119303,McAuley; Julian John,9999,0,9999,0
1668088891060,CSE 293,021,119304,Micciancio; Daniele,9999,0,9999,0
1668088891060,CSE 293,022,119367,Orailoglu; Alex,9999,0,9999,0
1668088891060,CSE 293,023,119382,Paturi; Ramamohan,9999,0,9999,0
1668088891060,CSE 293,024,119404,Polikarpova; Nadezhda,9999,0,9999,0
1668088891060,CSE 293,025,119406,Politz; Joseph Gibbs,9999,0,9999,0
1668088891060,CSE 293,026,119411,Porter; George M,9999,0,9999,0
1668088891060,CSE 293,027,119414,Porter; Leonard Emerson,9999,0,9999,0
1668088891060,CSE 293,028,119416,Ramamoorthi; Ravi,9999,0,9999,0
1668088891060,CSE 293,029,119417,Sahoo; Debashis,9999,0,9999,0
1668088891060,CSE 293,030,119420,Saul; Lawrence,9999,0,9999,0
1668088891060,CSE 293,031,119421,Savage; Stefan,9999,0,9999,0
1668088891060,CSE 293,032,119425,Schulze; Jurgen P.,9999,0,9999,0
1668088891060,CSE 293,033,119426,Snoeren; Alex C.,9999,0,9999,0
1668088891060,CSE 293,034,119428,Shang; Jingbo,9999,0,9999,0
1668088891060,CSE 293,035,119430,Stefan; Deian,9999,0,9999,0
1668088891060,CSE 293,036,119431,Su; Hao,9999,0,9999,0
1668088891060,CSE 293,037,119433,Swanson; Steven James,9999,0,9999,0
1668088891060,CSE 293,038,119435,Tullsen; Dean Michael,9999,0,9999,0
1668088891060,CSE 293,039,119483,Voelker; Geoffrey M.,9999,0,9999,0
1668088891060,CSE 293,040,119537,Zhao; Jishen,9999,0,9999,0
1668088891060,CSE 293,041,119538,Zhou; Yuan-Yuan,9999,0,9999,0
1668088891060,CSE 293,042,119539,Gao; Sicun,9999,0,9999,0
1668088891060,CSE 293,043,119540,Weibel; Nadir,9999,0,9999,0
1668088891060,CSE 293,044,119541,Gupta; Rajesh K.,9999,0,9999,0
1668088891060,CSE 293,045,126410,Vaccaro; Kristen Marie,9999,0,9999,0
1668088891060,CSE 293,046,126411,Klemke; Richard,9999,0,9999,0
1668088891487,CSE 294,A00,102459,Voelker; Geoffrey M.,0,0,0,0
1668088891487,CSE 294,B00,111322,Orailoglu; Alex,0,0,0,0
1668088891911,DSE 201,A00,096914,Deutsch; Alin Bernard,30,0,30,0
1668088892347,DSE 210,A00,096915,Dasgupta; Sanjoy,30,0,30,0
1668088892779,DSE 260A,A00,096916,Altintas De Callaf; Ilkay,30,0,30,0
1668088893244,ECE 200,001,103586,Antipa; Nicholas A,9999,0,9999,0
1668088893244,ECE 200,002,103587,Atanasov; Nikolay A.,9999,0,9999,0
1668088893244,ECE 200,003,103588,Bharadia; Dinesh,9999,0,9999,0
1668088893244,ECE 200,004,103589,Cheng; Chung Kuan,9999,0,9999,0
1668088893244,ECE 200,005,103590,Cosman; Pamela C.,9999,0,9999,0
1668088893244,ECE 200,006,103591,Dayeh; Shadi Ahmad,9999,0,9999,0
1668088893244,ECE 200,007,103592,Fainman; Yeshaiahu,9999,0,9999,0
1668088893244,ECE 200,008,103593,Ford; Joseph Earl,9999,0,9999,0
1668088893244,ECE 200,009,103594,Franceschetti; Massimo,9999,0,9999,0
1668088893244,ECE 200,010,103595,Fullerton; Eric E,9999,0,9999,0
1668088893244,ECE 200,011,103596,Galton; Ian A,9999,0,9999,0
1668088893244,ECE 200,012,103597,Gilja; Vikash,9999,0,9999,0
1668088893244,ECE 200,013,103598,Hall; Drew A.,9999,0,9999,0
1668088893244,ECE 200,014,103599,Hsueh; Tzu-Chien,9999,0,9999,0
1668088893244,ECE 200,015,103600,Javidi; Tara,9999,0,9999,0
1668088893244,ECE 200,016,103601,Kahng; Andrew Byun,9999,0,9999,0
1668088893244,ECE 200,017,103602,Kim; Young-Han,9999,0,9999,0
1668088893244,ECE 200,018,103603,Koushanfar; Farinaz,9999,0,9999,0
1668088893244,ECE 200,019,103604,Kuzum; Duygu,9999,0,9999,0
1668088893244,ECE 200,020,103605,Le; Hanh-Phuc,9999,0,9999,0
1668088893244,ECE 200,021,103606,Lin; Bill,9999,0,9999,0
1668088893244,ECE 200,022,103607,Liu; Zhaowei,9998,0,9999,1
1668088893244,ECE 200,023,103608,Lo; Yu-Hwa,9999,0,9999,0
1668088893244,ECE 200,024,103609,Lomakin; Vitaliy,9999,0,9999,0
1668088893244,ECE 200,025,103610,Mercier; Patrick Philip,9999,0,9999,0
1668088893244,ECE 200,026,103611,Meyer; Florian,9999,0,9999,0
1668088893244,ECE 200,027,103612,Milstein; Laurence B.,9999,0,9999,0
1668088893244,ECE 200,028,103613,Mir Arabbaygi; Siavash,9999,0,9999,0
1668088893244,ECE 200,029,103614,Mookherjea; Shayan,9999,0,9999,0
1668088893244,ECE 200,030,103615,Morris; Karcher William,9999,0,9999,0
1668088893244,ECE 200,031,103616,Ng; Tse Nga,9999,0,9999,0
1668088893244,ECE 200,032,103617,Nguyen; Truong Quang,9999,0,9999,0
1668088893244,ECE 200,033,103618,Nomura; Kenji,9999,0,9999,0
1668088893244,ECE 200,034,103619,Orlitsky; Alon,9999,0,9999,0
1668088893244,ECE 200,035,103620,Pal; Piya,9999,0,9999,0
1668088893244,ECE 200,036,103621,Papen; George C.,9999,0,9999,0
1668088893244,ECE 200,037,103622,Radic; Stojan,9999,0,9999,0
1668088893244,ECE 200,038,103623,Rao; Bhaskar D.,9999,0,9999,0
1668088893244,ECE 200,039,103624,Rao; Ramesh R,9999,0,9999,0
1668088893244,ECE 200,040,103625,Rebeiz; Gabriel,9999,0,9999,0
1668088893244,ECE 200,041,103626,Sanford; John R,9999,0,9999,0
1668088893244,ECE 200,042,103627,Siegel; Paul H.,9999,0,9999,0
1668088893244,ECE 200,043,103628,Sievenpiper; Daniel F.,9999,0,9999,0
1668088893244,ECE 200,044,103629,Sworder; David D.,9999,0,9999,0
1668088893244,ECE 200,045,103630,Taur; Yuan,9999,0,9999,0
1668088893244,ECE 200,046,103631,Touri; Behrouz,9999,0,9999,0
1668088893244,ECE 200,047,103632,Trivedi; Mohan M.,9999,0,9999,0
1668088893244,ECE 200,048,103633,Vasconcelos; Nuno,9999,0,9999,0
1668088893244,ECE 200,049,103634,Wang; Xiaolong,9999,0,9999,0
1668088893244,ECE 200,050,103635,Xie; Pengtao,9999,0,9999,0
1668088893244,ECE 200,051,103636,Yip; Michael,9999,0,9999,0
1668088893244,ECE 200,052,103637,Zeger; Kenneth A.,999,0,999,0
1668088893244,ECE 200,053,103638,Zhang; Xinyu,9999,0,9999,0
1668088893244,ECE 200,054,103639,Turakhia; Yatish Girish,9999,0,9999,0
1668088893244,ECE 200,055,103640,Kang; Mingu,9999,0,9999,0
1668088893244,ECE 200,056,103641,Shi; Yuanyuan,9999,0,9999,0
1668088893244,ECE 200,057,103642,Wang; Edward Jay,9999,0,9999,0
1668088893244,ECE 200,058,103643,Zheng; Yang,9999,0,9999,0
1668088893686,ECE 202,A00,103644,Kuzum; Duygu,0,0,0,0
1668088894129,ECE 212BN,A00,103646,Ng; Tse Nga,0,0,0,0
1668088894568,ECE 221,A00,111493,Staff,0,0,0,0
1668088894991,ECE 222B,A00,103647,Lomakin; Vitaliy,0,0,0,0
1668088895427,ECE 230B,A00,103648,Taur; Yuan,0,0,0,0
1668088895853,ECE 238B,A00,103649,Garay; Javier,0,0,0,0
1668088896279,ECE 240B,A00,112900,Fainman; Yeshaiahu,0,0,0,0
1668088896707,ECE 247A,A00,103650,Jokerst; Jesse Vincent,0,0,0,0
1668088897135,ECE 247B,A00,103651,Wang; Joseph,0,0,0,0
1668088897561,ECE 250,A00,103652,Siegel; Paul H.,0,0,0,0
1668088897993,ECE 251A,A00,103654,Rao; Bhaskar D.,0,0,0,0
1668088898416,ECE 257B,A00,103655,Bharadia; Dinesh,0,0,0,0
1668088898840,ECE 258A,A00,103656,Milstein; Laurence B.,0,0,0,0
1668088899268,ECE 260B,A00,103658,Kang; Mingu,0,0,0,0
1668088899697,ECE 264A,A00,103659,Galton; Ian A,0,0,0,0
1668088900140,ECE 265A,A00,103661,Gudem; Prasad S.S.,0,0,0,0
1668088900581,ECE 265D,A00,103662,Gudem; Prasad S.S.,0,0,0,0
1668088901015,ECE 268,A00,103663,Koushanfar; Farinaz,0,0,0,0
1668088901443,ECE 269,A01,103665,Pal; Piya,0,0,0,0
1668088901867,ECE 271B,A00,103666,Vasconcelos; Manuela,0,0,0,0
1668088902291,ECE 276A,A00,103667,Atanasov; Nikolay A.,0,0,0,0
1668088902717,ECE 277,A00,103668,An; Cheolhong,0,0,0,0
1668088903141,ECE 279,A00,117947,Hall; Drew A.,0,0,0,0
1668088903994,ECE 283,A00,103670,Hsueh; Tzu-Chien,0,0,0,0
1668088904419,ECE 284,A00,103671,Turakhia; Yatish Girish,0,0,0,0
1668088904844,ECE 285,A00,103672,Zheng; Yang,0,0,0,0
1668088904844,ECE 285,B00,103673,Sworder; David D.,0,0,0,0
1668088905274,ECE 287,A00,103676,Javidi; Tara,0,0,0,0
1668088905702,MATH 200B,A00,098023,Salehi Golsefidy; Alireza,13,0,15,2
1668088906126,MATH 202B,A00,098024,Rhoades; Brendon Patrick,9,0,15,6
1668088906558,MATH 203B,A00,098025,Oprea; Dragos N.,10,0,15,5
1668088906981,MATH 204B,A00,098026,Sorensen; Claus M,13,0,15,2
1668088907406,MATH 208,A00,098027,Izadi; Elham,7,0,10,3
1668088907830,MATH 209,A00,098028,Pollack; Aaron,10,0,10,0
1668088908259,MATH 211A,A00,112919,Rogalski; Daniel,9,0,10,1
1668088908685,MATH 211B,A00,112920,Seward; Brandon M.,9,0,10,1
1668088909108,MATH 218,A00,098029,Li; Bo,10,0,10,0
1668088909539,MATH 220B,A00,098030,Novak; Jonathan I,12,0,15,3
1668088909964,MATH 221A,A00,098031,Ebenfelt; Peter F,13,0,15,2
1668088910389,MATH 231B,A00,098032,Zlatos; Andrej,12,0,15,3
1668088910839,MATH 240B,A00,098033,Ni; Lei,9,0,15,6
1668088911271,MATH 243,A00,098034,Jekel; David Andrew,10,0,10,0
1668088911697,MATH 245A,A00,098035,Nie; Jiawang,0,0,15,16
1668088912123,MATH 248,A00,098036,Bejenaru; Ioan,10,0,10,0
1668088912559,MATH 250B,A00,098037,Spolaor; Luca,14,0,15,1
1668088912982,MATH 258,A00,098038,Ni; Lei,10,0,10,0
1668088913411,MATH 264B,A00,098041,Rhoades; Brendon Patrick,10,0,15,5
1668088913836,MATH 268,A00,098042,Buss; Samuel R,10,0,10,0
1668088914269,MATH 269,A00,098043,Rhoades; Brendon Patrick,10,0,10,0
1668088914693,MATH 270B,A00,098044,Li; Bo,11,0,15,4
1668088915122,MATH 272B,A00,098045,Holst; Michael J,13,0,15,2
1668088915552,MATH 273A,A00,098046,Tian; Xiaochuan,10,0,15,5
1668088915976,MATH 275,A01,098048,Tian; Xiaochuan,6,0,10,4
1668088916401,MATH 278A,A00,098049,Holst; Michael J,8,0,10,2
1668088916828,MATH 278B,A00,098050,Cloninger; Alexander,10,0,10,0
1668088917280,MATH 278C,A00,098051,Nie; Jiawang,7,0,10,3
1668088917712,MATH 280B,A00,098052,Zheng; Tianyi,10,0,15,5
1668088918136,MATH 281B,A00,098053,Bradic; Jelena,3,0,15,12
1668088918562,MATH 282B,A00,098054,Arias-Castro; Ery,0,0,15,15
1668088918988,MATH 285,A00,098055,Fitzsimmons; Patrick J,0,0,15,17
1668088919414,MATH 287B,A00,098056,Arias-Castro; Ery,3,0,15,12
1668088919841,MATH 288,A00,098057,Agarwal; Pooja,9,0,10,1
1668088919841,MATH 288,B00,098058,Zhang; Danna,8,0,10,2
1668088919841,MATH 288,C00,098059,Williams; Ruth J,10,0,10,0
1668088920272,MATH 290B,A00,098060,Roberts; Justin Deritter,13,0,15,2
1668088920702,MATH 292,A00,098061,Belmont; Eva Kinoshita,10,0,10,0
1668088921127,MATH 295,A00,098062,Suk; Andrew Hoon,48,0,50,2
1668088921553,MATH 296,A00,098063,Novak; Jonathan I,20,0,20,0
1668088921991,MATH 297,001,098064,Gamst; Anthony Collins,9997,0,9999,2
1668089423912,COGS 205,A00,101395,Chiba; Andrea,19,0,20,1
1668089424349,COGS 210B,001,101404,Greene; Deanna Jacquelyn,9998,0,9999,1
1668089424349,COGS 210B,002,101417,Xia; Haijun,9999,0,9999,0
1668089424349,COGS 210B,003,101422,Nitz; Douglas A.,9999,0,9999,0
1668089424349,COGS 210B,004,101423,Hollan; James D.,9998,0,9999,1
1668089424349,COGS 210B,005,101424,Deak; Gedeon O.,9998,0,9999,1
1668089424349,COGS 210B,006,101425,Rossano; Federico,9999,0,9999,0
1668089424773,COGS 211B,A00,101427,Coulson; Seana M,9996,0,9999,3
1668089425205,COGS 220,A00,101428,Hollan; James D.,0,0,25,25
1668089425627,COGS 229,A00,101429,Dow; Steven P,18,0,25,7
1668089426051,COGS 230,A00,101430,Klemmer; Scott R,13,0,17,4
1668089426476,COGS 234,A00,101431,Xia; Haijun,3,0,25,22
1668089426899,COGS 260,A00,101432,Kiyonaga; Anastasia,19,0,25,6
1668089426899,COGS 260,B00,101433,Kirsh; David Joel,16,0,25,9
1668089427340,CSE 202,A00,102371,Impagliazzo; Russell,0,0,0,0
1668089427762,CSE 203B,A01,102373,Cheng; Chung Kuan,0,0,0,0
1668089428195,CSE 208,A00,102374,Micciancio; Daniele,0,0,0,0
1668089428647,CSE 209A,A00,112895,Impagliazzo; Russell,0,0,15,15
1668089429085,CSE 209B,A00,108005,Bellare; Mihir,0,0,0,0
1668089429513,CSE 210,A00,113163,Coblenz; Michael J,0,0,0,0
1668089429937,CSE 219,A00,106111,Dow; Steven P,0,0,20,20
1668089430359,CSE 221,A00,102376,Voelker; Geoffrey M.,0,0,0,0
1668089430783,CSE 224,A01,102378,Porter; George M,0,0,0,0
1668089431210,CSE 229A,A00,102379,Savage; Stefan,0,0,0,0
1668089431634,CSE 229C,A00,102380,Munyaka; Imani N. S.,0,0,0,0
1668089432059,CSE 232B,A00,102382,Deutsch; Alin Bernard,0,0,0,0
1668089432485,CSE 234,A01,112904,Kumar; Arun Kumar,0,0,0,0
1668089432912,CSE 237A,A00,102383,Rosing; Tajana Simunic,0,0,0,0
1668089433335,CSE 239A,A00,102384,Deutsch; Alin Bernard,0,0,0,0
1668089433760,CSE 239B,A00,102385,Polikarpova; Nadezhda,0,0,0,0
1668089434187,CSE 240A,A00,102386,Pannuto; Patrick William,0,0,0,0
1668089434614,CSE 240B,A00,102387,Zhao; Jishen,0,0,0,0
1668089435039,CSE 241A,A00,106406,Kang; Mingu,0,0,0,0
1668089435466,CSE 249B,A00,102388,Kahng; Andrew Byun,0,0,8,8
1668089435891,CSE 251B,A01,102392,Cottrell; Garrison W,0,0,0,0
1668089435891,CSE 251B,A02,102393,Cottrell; Garrison W,0,0,0,0
1668089436323,CSE 252B,A00,102394,Ochoa; Benjamin Lawrence,0,0,0,0
1668089436766,CSE 257,A01,102396,Gao; Sicun,0,0,0,0
1668089437189,CSE 272,A00,102397,Li; Tzumao,0,0,0,0
1668089437610,CSE 274,A00,111323,Chern; Albert Ren-Haur,0,0,0,0
1668089438045,CSE 282,A00,102398,Pevzner; Pavel Arkadjevich,0,0,0,0
1668089438479,CSE 284,A00,114175,Gymrek; Melissa Ann,0,0,0,0
1668089438906,CSE 290,A00,102399,Chandraker; Manmohan Krishna,0,0,0,0
1668089438906,CSE 290,B00,102400,Vaccaro; Kristen Marie,0,0,25,25
1668089438906,CSE 290,C00,102414,Pannuto; Patrick William,0,0,25,25
1668089438906,CSE 290,D00,102427,Pevzner; Pavel Arkadjevich,0,0,0,0
1668089438906,CSE 290,E00,102429,Zhao; Jishen,0,0,0,0
1668089438906,CSE 290,F00,102436,Tullsen; Dean Michael,0,0,0,0
1668089438906,CSE 290,G00,102440,Christensen; Henrik I,0,0,20,20
1668089439338,CSE 291,A00,102443,Su; Hao,0,0,0,0
1668089439338,CSE 291,B00,102448,Polikarpova; Nadezhda,0,0,0,0
1668089439338,CSE 291,C00,102453,Vaccaro; Kristen Marie,0,0,0,0
1668089439338,CSE 291,D00,111343,Savage; Stefan,0,0,0,0
1668089439338,CSE 291,E00,116474,Claffy; Kimberly Claire,0,0,0,0
1668089439338,CSE 291,F00,116479,Pasquale; Joseph,0,0,0,0
1668089439791,CSE 293,001,119111,Bafna; Vineet,9999,0,9999,0
1668089439791,CSE 293,002,119118,Bellare; Mihir,9999,0,9999,0
1668089439791,CSE 293,003,119122,Berg-Kirkpatrick; Taylor D,9999,0,9999,0
1668089439791,CSE 293,004,119135,Christensen; Henrik I,9999,0,9999,0
1668089439791,CSE 293,005,119142,Cottrell; Garrison W,9999,0,9999,0
1668089439791,CSE 293,006,119146,Deutsch; Alin Bernard,9999,0,9999,0
1668089439791,CSE 293,007,119159,Esmaeilzadeh; Hadi,9999,0,9999,0
1668089439791,CSE 293,008,119166,Freund; Yoav,9999,0,9999,0
1668089439791,CSE 293,009,119170,Griswold; William G.,9999,0,9999,0
1668089439791,CSE 293,010,119183,Gymrek; Melissa Ann,9999,0,9999,0
1668089439791,CSE 293,011,119190,Heninger; Nadia A,9999,0,9999,0
1668089439791,CSE 293,012,119230,Impagliazzo; Russell,9999,0,9999,0
1668089439791,CSE 293,013,119232,Jhala; Ranjit,9999,0,9999,0
1668089439791,CSE 293,014,119233,Kahng; Andrew Byun,9999,0,9999,0
1668089439791,CSE 293,015,119298,Kane; Daniel Mertz,9999,0,9999,0
1668089439791,CSE 293,016,119299,Kriegman; David J,9999,0,9999,0
1668089439791,CSE 293,017,119300,Kumar; Arun Kumar,9999,0,9999,0
1668089439791,CSE 293,018,119301,Lerner; Sorin,9999,0,9999,0
1668089439791,CSE 293,019,119302,Lovett; Shachar,9999,0,9999,0
1668089439791,CSE 293,020,119303,McAuley; Julian John,9999,0,9999,0
1668089439791,CSE 293,021,119304,Micciancio; Daniele,9999,0,9999,0
1668089439791,CSE 293,022,119367,Orailoglu; Alex,9999,0,9999,0
1668089439791,CSE 293,023,119382,Paturi; Ramamohan,9999,0,9999,0
1668089439791,CSE 293,024,119404,Polikarpova; Nadezhda,9999,0,9999,0
1668089439791,CSE 293,025,119406,Politz; Joseph Gibbs,9999,0,9999,0
1668089439791,CSE 293,026,119411,Porter; George M,9999,0,9999,0
1668089439791,CSE 293,027,119414,Porter; Leonard Emerson,9999,0,9999,0
1668089439791,CSE 293,028,119416,Ramamoorthi; Ravi,9999,0,9999,0
1668089439791,CSE 293,029,119417,Sahoo; Debashis,9999,0,9999,0
1668089439791,CSE 293,030,119420,Saul; Lawrence,9999,0,9999,0
1668089439791,CSE 293,031,119421,Savage; Stefan,9999,0,9999,0
1668089439791,CSE 293,032,119425,Schulze; Jurgen P.,9999,0,9999,0
1668089439791,CSE 293,033,119426,Snoeren; Alex C.,9999,0,9999,0
1668089439791,CSE 293,034,119428,Shang; Jingbo,9999,0,9999,0
1668089439791,CSE 293,035,119430,Stefan; Deian,9999,0,9999,0
1668089439791,CSE 293,036,119431,Su; Hao,9999,0,9999,0
1668089439791,CSE 293,037,119433,Swanson; Steven James,9999,0,9999,0
1668089439791,CSE 293,038,119435,Tullsen; Dean Michael,9999,0,9999,0
1668089439791,CSE 293,039,119483,Voelker; Geoffrey M.,9999,0,9999,0
1668089439791,CSE 293,040,119537,Zhao; Jishen,9999,0,9999,0
1668089439791,CSE 293,041,119538,Zhou; Yuan-Yuan,9999,0,9999,0
1668089439791,CSE 293,042,119539,Gao; Sicun,9999,0,9999,0
1668089439791,CSE 293,043,119540,Weibel; Nadir,9999,0,9999,0
1668089439791,CSE 293,044,119541,Gupta; Rajesh K.,9999,0,9999,0
1668089439791,CSE 293,045,126410,Vaccaro; Kristen Marie,9999,0,9999,0
1668089439791,CSE 293,046,126411,Klemke; Richard,9999,0,9999,0
1668089440216,CSE 294,A00,102459,Voelker; Geoffrey M.,0,0,0,0
1668089440216,CSE 294,B00,111322,Orailoglu; Alex,0,0,0,0
1668089440654,DSE 201,A00,096914,Deutsch; Alin Bernard,30,0,30,0
1668089441084,DSE 210,A00,096915,Dasgupta; Sanjoy,30,0,30,0
1668089441511,DSE 260A,A00,096916,Altintas De Callaf; Ilkay,30,0,30,0
1668089441969,ECE 200,001,103586,Antipa; Nicholas A,9999,0,9999,0
1668089441969,ECE 200,002,103587,Atanasov; Nikolay A.,9999,0,9999,0
1668089441969,ECE 200,003,103588,Bharadia; Dinesh,9999,0,9999,0
1668089441969,ECE 200,004,103589,Cheng; Chung Kuan,9999,0,9999,0
1668089441969,ECE 200,005,103590,Cosman; Pamela C.,9999,0,9999,0
1668089441969,ECE 200,006,103591,Dayeh; Shadi Ahmad,9999,0,9999,0
1668089441969,ECE 200,007,103592,Fainman; Yeshaiahu,9999,0,9999,0
1668089441969,ECE 200,008,103593,Ford; Joseph Earl,9999,0,9999,0
1668089441969,ECE 200,009,103594,Franceschetti; Massimo,9999,0,9999,0
1668089441969,ECE 200,010,103595,Fullerton; Eric E,9999,0,9999,0
1668089441969,ECE 200,011,103596,Galton; Ian A,9999,0,9999,0
1668089441969,ECE 200,012,103597,Gilja; Vikash,9999,0,9999,0
1668089441969,ECE 200,013,103598,Hall; Drew A.,9999,0,9999,0
1668089441969,ECE 200,014,103599,Hsueh; Tzu-Chien,9999,0,9999,0
1668089441969,ECE 200,015,103600,Javidi; Tara,9999,0,9999,0
1668089441969,ECE 200,016,103601,Kahng; Andrew Byun,9999,0,9999,0
1668089441969,ECE 200,017,103602,Kim; Young-Han,9999,0,9999,0
1668089441969,ECE 200,018,103603,Koushanfar; Farinaz,9999,0,9999,0
1668089441969,ECE 200,019,103604,Kuzum; Duygu,9999,0,9999,0
1668089441969,ECE 200,020,103605,Le; Hanh-Phuc,9999,0,9999,0
1668089441969,ECE 200,021,103606,Lin; Bill,9999,0,9999,0
1668089441969,ECE 200,022,103607,Liu; Zhaowei,9998,0,9999,1
1668089441969,ECE 200,023,103608,Lo; Yu-Hwa,9999,0,9999,0
1668089441969,ECE 200,024,103609,Lomakin; Vitaliy,9999,0,9999,0
1668089441969,ECE 200,025,103610,Mercier; Patrick Philip,9999,0,9999,0
1668089441969,ECE 200,026,103611,Meyer; Florian,9999,0,9999,0
1668089441969,ECE 200,027,103612,Milstein; Laurence B.,9999,0,9999,0
1668089441969,ECE 200,028,103613,Mir Arabbaygi; Siavash,9999,0,9999,0
1668089441969,ECE 200,029,103614,Mookherjea; Shayan,9999,0,9999,0
1668089441969,ECE 200,030,103615,Morris; Karcher William,9999,0,9999,0
1668089441969,ECE 200,031,103616,Ng; Tse Nga,9999,0,9999,0
1668089441969,ECE 200,032,103617,Nguyen; Truong Quang,9999,0,9999,0
1668089441969,ECE 200,033,103618,Nomura; Kenji,9999,0,9999,0
1668089441969,ECE 200,034,103619,Orlitsky; Alon,9999,0,9999,0
1668089441969,ECE 200,035,103620,Pal; Piya,9999,0,9999,0
1668089441969,ECE 200,036,103621,Papen; George C.,9999,0,9999,0
1668089441969,ECE 200,037,103622,Radic; Stojan,9999,0,9999,0
1668089441969,ECE 200,038,103623,Rao; Bhaskar D.,9999,0,9999,0
1668089441969,ECE 200,039,103624,Rao; Ramesh R,9999,0,9999,0
1668089441969,ECE 200,040,103625,Rebeiz; Gabriel,9999,0,9999,0
1668089441969,ECE 200,041,103626,Sanford; John R,9999,0,9999,0
1668089441969,ECE 200,042,103627,Siegel; Paul H.,9999,0,9999,0
1668089441969,ECE 200,043,103628,Sievenpiper; Daniel F.,9999,0,9999,0
1668089441969,ECE 200,044,103629,Sworder; David D.,9999,0,9999,0
1668089441969,ECE 200,045,103630,Taur; Yuan,9999,0,9999,0
1668089441969,ECE 200,046,103631,Touri; Behrouz,9999,0,9999,0
1668089441969,ECE 200,047,103632,Trivedi; Mohan M.,9999,0,9999,0
1668089441969,ECE 200,048,103633,Vasconcelos; Nuno,9999,0,9999,0
1668089441969,ECE 200,049,103634,Wang; Xiaolong,9999,0,9999,0
1668089441969,ECE 200,050,103635,Xie; Pengtao,9999,0,9999,0
1668089441969,ECE 200,051,103636,Yip; Michael,9999,0,9999,0
1668089441969,ECE 200,052,103637,Zeger; Kenneth A.,999,0,999,0
1668089441969,ECE 200,053,103638,Zhang; Xinyu,9999,0,9999,0
1668089441969,ECE 200,054,103639,Turakhia; Yatish Girish,9999,0,9999,0
1668089441969,ECE 200,055,103640,Kang; Mingu,9999,0,9999,0
1668089441969,ECE 200,056,103641,Shi; Yuanyuan,9999,0,9999,0
1668089441969,ECE 200,057,103642,Wang; Edward Jay,9999,0,9999,0
1668089441969,ECE 200,058,103643,Zheng; Yang,9999,0,9999,0
1668089442404,ECE 202,A00,103644,Kuzum; Duygu,0,0,0,0
1668089442835,ECE 212BN,A00,103646,Ng; Tse Nga,0,0,0,0
1668089443263,ECE 221,A00,111493,Staff,0,0,0,0
1668089443699,ECE 222B,A00,103647,Lomakin; Vitaliy,0,0,0,0
1668089444127,ECE 230B,A00,103648,Taur; Yuan,0,0,0,0
1668089444557,ECE 238B,A00,103649,Garay; Javier,0,0,0,0
1668089444989,ECE 240B,A00,112900,Fainman; Yeshaiahu,0,0,0,0
1668089445426,ECE 247A,A00,103650,Jokerst; Jesse Vincent,0,0,0,0
1668089445870,ECE 247B,A00,103651,Wang; Joseph,0,0,0,0
1668089446301,ECE 250,A00,103652,Siegel; Paul H.,0,0,0,0
1668089446728,ECE 251A,A00,103654,Rao; Bhaskar D.,0,0,0,0
1668089447150,ECE 257B,A00,103655,Bharadia; Dinesh,0,0,0,0
1668089447573,ECE 258A,A00,103656,Milstein; Laurence B.,0,0,0,0
1668089447997,ECE 260B,A00,103658,Kang; Mingu,0,0,0,0
1668089448425,ECE 264A,A00,103659,Galton; Ian A,0,0,0,0
1668089448850,ECE 265A,A00,103661,Gudem; Prasad S.S.,0,0,0,0
1668089449277,ECE 265D,A00,103662,Gudem; Prasad S.S.,0,0,0,0
1668089449705,ECE 268,A00,103663,Koushanfar; Farinaz,0,0,0,0
1668089450133,ECE 269,A01,103665,Pal; Piya,0,0,0,0
1668089450558,ECE 271B,A00,103666,Vasconcelos; Manuela,0,0,0,0
1668089450985,ECE 276A,A00,103667,Atanasov; Nikolay A.,0,0,0,0
1668089451417,ECE 277,A00,103668,An; Cheolhong,0,0,0,0
1668089451840,ECE 279,A00,117947,Hall; Drew A.,0,0,0,0
1668089452693,ECE 283,A00,103670,Hsueh; Tzu-Chien,0,0,0,0
1668089453120,ECE 284,A00,103671,Turakhia; Yatish Girish,0,0,0,0
1668089453547,ECE 285,A00,103672,Zheng; Yang,0,0,0,0
1668089453547,ECE 285,B00,103673,Sworder; David D.,0,0,0,0
1668089454051,ECE 287,A00,103676,Javidi; Tara,0,0,0,0
1668089454476,MATH 200B,A00,098023,Salehi Golsefidy; Alireza,13,0,15,2
1668089454898,MATH 202B,A00,098024,Rhoades; Brendon Patrick,9,0,15,6
1668089455323,MATH 203B,A00,098025,Oprea; Dragos N.,10,0,15,5
1668089455749,MATH 204B,A00,098026,Sorensen; Claus M,13,0,15,2
1668089456187,MATH 208,A00,098027,Izadi; Elham,7,0,10,3
1668089456622,MATH 209,A00,098028,Pollack; Aaron,10,0,10,0
1668089457047,MATH 211A,A00,112919,Rogalski; Daniel,9,0,10,1
1668089457470,MATH 211B,A00,112920,Seward; Brandon M.,9,0,10,1
1668089457895,MATH 218,A00,098029,Li; Bo,10,0,10,0
1668089458319,MATH 220B,A00,098030,Novak; Jonathan I,12,0,15,3
1668089458746,MATH 221A,A00,098031,Ebenfelt; Peter F,13,0,15,2
1668089459173,MATH 231B,A00,098032,Zlatos; Andrej,12,0,15,3
1668089459597,MATH 240B,A00,098033,Ni; Lei,9,0,15,6
1668089460021,MATH 243,A00,098034,Jekel; David Andrew,10,0,10,0
1668089460449,MATH 245A,A00,098035,Nie; Jiawang,0,0,15,16
1668089460875,MATH 248,A00,098036,Bejenaru; Ioan,10,0,10,0
1668089461301,MATH 250B,A00,098037,Spolaor; Luca,14,0,15,1
1668089461726,MATH 258,A00,098038,Ni; Lei,10,0,10,0
1668089462151,MATH 264B,A00,098041,Rhoades; Brendon Patrick,10,0,15,5
1668089462579,MATH 268,A00,098042,Buss; Samuel R,10,0,10,0
1668089463006,MATH 269,A00,098043,Rhoades; Brendon Patrick,10,0,10,0
1668089463429,MATH 270B,A00,098044,Li; Bo,11,0,15,4
1668089463855,MATH 272B,A00,098045,Holst; Michael J,13,0,15,2
1668089464287,MATH 273A,A00,098046,Tian; Xiaochuan,10,0,15,5
1668089464722,MATH 275,A01,098048,Tian; Xiaochuan,6,0,10,4
1668089465159,MATH 278A,A00,098049,Holst; Michael J,8,0,10,2
1668089465586,MATH 278B,A00,098050,Cloninger; Alexander,10,0,10,0
1668089466009,MATH 278C,A00,098051,Nie; Jiawang,7,0,10,3
1668089466439,MATH 280B,A00,098052,Zheng; Tianyi,10,0,15,5
1668089466872,MATH 281B,A00,098053,Bradic; Jelena,3,0,15,12
1668089467308,MATH 282B,A00,098054,Arias-Castro; Ery,0,0,15,15
1668089467737,MATH 285,A00,098055,Fitzsimmons; Patrick J,0,0,15,17
1668089468159,MATH 287B,A00,098056,Arias-Castro; Ery,3,0,15,12
1668089468583,MATH 288,A00,098057,Agarwal; Pooja,9,0,10,1
1668089468583,MATH 288,B00,098058,Zhang; Danna,8,0,10,2
1668089468583,MATH 288,C00,098059,Williams; Ruth J,10,0,10,0
1668089469010,MATH 290B,A00,098060,Roberts; Justin Deritter,13,0,15,2
1668089469436,MATH 292,A00,098061,Belmont; Eva Kinoshita,10,0,10,0
1668089469859,MATH 295,A00,098062,Suk; Andrew Hoon,48,0,50,2
1668089470282,MATH 296,A00,098063,Novak; Jonathan I,20,0,20,0
1668089470705,MATH 297,001,098064,Gamst; Anthony Collins,9997,0,9999,2
1668089972895,COGS 205,A00,101395,Chiba; Andrea,19,0,20,1
1668089973322,COGS 210B,001,101404,Greene; Deanna Jacquelyn,9998,0,9999,1
1668089973322,COGS 210B,002,101417,Xia; Haijun,9999,0,9999,0
1668089973322,COGS 210B,003,101422,Nitz; Douglas A.,9999,0,9999,0
1668089973322,COGS 210B,004,101423,Hollan; James D.,9998,0,9999,1
1668089973322,COGS 210B,005,101424,Deak; Gedeon O.,9998,0,9999,1
1668089973322,COGS 210B,006,101425,Rossano; Federico,9999,0,9999,0
1668089973746,COGS 211B,A00,101427,Coulson; Seana M,9996,0,9999,3
1668089974172,COGS 220,A00,101428,Hollan; James D.,0,0,25,25
1668089974610,COGS 229,A00,101429,Dow; Steven P,18,0,25,7
1668089975047,COGS 230,A00,101430,Klemmer; Scott R,13,0,17,4
1668089975482,COGS 234,A00,101431,Xia; Haijun,3,0,25,22
1668089975911,COGS 260,A00,101432,Kiyonaga; Anastasia,19,0,25,6
1668089975911,COGS 260,B00,101433,Kirsh; David Joel,16,0,25,9
1668089976414,CSE 202,A00,102371,Impagliazzo; Russell,0,0,0,0
1668089976840,CSE 203B,A01,102373,Cheng; Chung Kuan,0,0,0,0
1668089977265,CSE 208,A00,102374,Micciancio; Daniele,0,0,0,0
1668089977691,CSE 209A,A00,112895,Impagliazzo; Russell,0,0,15,15
1668089978121,CSE 209B,A00,108005,Bellare; Mihir,0,0,0,0
1668089978551,CSE 210,A00,113163,Coblenz; Michael J,0,0,0,0
1668089978975,CSE 219,A00,106111,Dow; Steven P,0,0,20,20
1668089979412,CSE 221,A00,102376,Voelker; Geoffrey M.,0,0,0,0
1668089979852,CSE 224,A01,102378,Porter; George M,0,0,0,0
1668089980277,CSE 229A,A00,102379,Savage; Stefan,0,0,0,0
1668089980704,CSE 229C,A00,102380,Munyaka; Imani N. S.,0,0,0,0
1668089981127,CSE 232B,A00,102382,Deutsch; Alin Bernard,0,0,0,0
1668089981559,CSE 234,A01,112904,Kumar; Arun Kumar,0,0,0,0
1668089981987,CSE 237A,A00,102383,Rosing; Tajana Simunic,0,0,0,0
1668089982423,CSE 239A,A00,102384,Deutsch; Alin Bernard,0,0,0,0
1668089982852,CSE 239B,A00,102385,Polikarpova; Nadezhda,0,0,0,0
1668089983275,CSE 240A,A00,102386,Pannuto; Patrick William,0,0,0,0
1668089983697,CSE 240B,A00,102387,Zhao; Jishen,0,0,0,0
1668089984120,CSE 241A,A00,106406,Kang; Mingu,0,0,0,0
1668089984542,CSE 249B,A00,102388,Kahng; Andrew Byun,0,0,8,8
1668089984971,CSE 251B,A01,102392,Cottrell; Garrison W,0,0,0,0
1668089984971,CSE 251B,A02,102393,Cottrell; Garrison W,0,0,0,0
1668089985418,CSE 252B,A00,102394,Ochoa; Benjamin Lawrence,0,0,0,0
1668089985854,CSE 257,A01,102396,Gao; Sicun,0,0,0,0
1668089986288,CSE 272,A00,102397,Li; Tzumao,0,0,0,0
1668089986721,CSE 274,A00,111323,Chern; Albert Ren-Haur,0,0,0,0
1668089987156,CSE 282,A00,102398,Pevzner; Pavel Arkadjevich,0,0,0,0
1668089987626,CSE 284,A00,114175,Gymrek; Melissa Ann,0,0,0,0
1668089988051,CSE 290,A00,102399,Chandraker; Manmohan Krishna,0,0,0,0
1668089988051,CSE 290,B00,102400,Vaccaro; Kristen Marie,0,0,25,25
1668089988051,CSE 290,C00,102414,Pannuto; Patrick William,0,0,25,25
1668089988051,CSE 290,D00,102427,Pevzner; Pavel Arkadjevich,0,0,0,0
1668089988051,CSE 290,E00,102429,Zhao; Jishen,0,0,0,0
1668089988051,CSE 290,F00,102436,Tullsen; Dean Michael,0,0,0,0
1668089988051,CSE 290,G00,102440,Christensen; Henrik I,0,0,20,20
1668089988485,CSE 291,A00,102443,Su; Hao,0,0,0,0
1668089988485,CSE 291,B00,102448,Polikarpova; Nadezhda,0,0,0,0
1668089988485,CSE 291,C00,102453,Vaccaro; Kristen Marie,0,0,0,0
1668089988485,CSE 291,D00,111343,Savage; Stefan,0,0,0,0
1668089988485,CSE 291,E00,116474,Claffy; Kimberly Claire,0,0,0,0
1668089988485,CSE 291,F00,116479,Pasquale; Joseph,0,0,0,0
1668089988946,CSE 293,001,119111,Bafna; Vineet,9999,0,9999,0
1668089988946,CSE 293,002,119118,Bellare; Mihir,9999,0,9999,0
1668089988946,CSE 293,003,119122,Berg-Kirkpatrick; Taylor D,9999,0,9999,0
1668089988946,CSE 293,004,119135,Christensen; Henrik I,9999,0,9999,0
1668089988946,CSE 293,005,119142,Cottrell; Garrison W,9999,0,9999,0
1668089988946,CSE 293,006,119146,Deutsch; Alin Bernard,9999,0,9999,0
1668089988946,CSE 293,007,119159,Esmaeilzadeh; Hadi,9999,0,9999,0
1668089988946,CSE 293,008,119166,Freund; Yoav,9999,0,9999,0
1668089988946,CSE 293,009,119170,Griswold; William G.,9999,0,9999,0
1668089988946,CSE 293,010,119183,Gymrek; Melissa Ann,9999,0,9999,0
1668089988946,CSE 293,011,119190,Heninger; Nadia A,9999,0,9999,0
1668089988946,CSE 293,012,119230,Impagliazzo; Russell,9999,0,9999,0
1668089988946,CSE 293,013,119232,Jhala; Ranjit,9999,0,9999,0
1668089988946,CSE 293,014,119233,Kahng; Andrew Byun,9999,0,9999,0
1668089988946,CSE 293,015,119298,Kane; Daniel Mertz,9999,0,9999,0
1668089988946,CSE 293,016,119299,Kriegman; David J,9999,0,9999,0
1668089988946,CSE 293,017,119300,Kumar; Arun Kumar,9999,0,9999,0
1668089988946,CSE 293,018,119301,Lerner; Sorin,9999,0,9999,0
1668089988946,CSE 293,019,119302,Lovett; Shachar,9999,0,9999,0
1668089988946,CSE 293,020,119303,McAuley; Julian John,9999,0,9999,0
1668089988946,CSE 293,021,119304,Micciancio; Daniele,9999,0,9999,0
1668089988946,CSE 293,022,119367,Orailoglu; Alex,9999,0,9999,0
1668089988946,CSE 293,023,119382,Paturi; Ramamohan,9999,0,9999,0
1668089988946,CSE 293,024,119404,Polikarpova; Nadezhda,9999,0,9999,0
1668089988946,CSE 293,025,119406,Politz; Joseph Gibbs,9999,0,9999,0
1668089988946,CSE 293,026,119411,Porter; George M,9999,0,9999,0
1668089988946,CSE 293,027,119414,Porter; Leonard Emerson,9999,0,9999,0
1668089988946,CSE 293,028,119416,Ramamoorthi; Ravi,9999,0,9999,0
1668089988946,CSE 293,029,119417,Sahoo; Debashis,9999,0,9999,0
1668089988946,CSE 293,030,119420,Saul; Lawrence,9999,0,9999,0
1668089988946,CSE 293,031,119421,Savage; Stefan,9999,0,9999,0
1668089988946,CSE 293,032,119425,Schulze; Jurgen P.,9999,0,9999,0
1668089988946,CSE 293,033,119426,Snoeren; Alex C.,9999,0,9999,0
1668089988946,CSE 293,034,119428,Shang; Jingbo,9999,0,9999,0
1668089988946,CSE 293,035,119430,Stefan; Deian,9999,0,9999,0
1668089988946,CSE 293,036,119431,Su; Hao,9999,0,9999,0
1668089988946,CSE 293,037,119433,Swanson; Steven James,9999,0,9999,0
1668089988946,CSE 293,038,119435,Tullsen; Dean Michael,9999,0,9999,0
1668089988946,CSE 293,039,119483,Voelker; Geoffrey M.,9999,0,9999,0
1668089988946,CSE 293,040,119537,Zhao; Jishen,9999,0,9999,0
1668089988946,CSE 293,041,119538,Zhou; Yuan-Yuan,9999,0,9999,0
1668089988946,CSE 293,042,119539,Gao; Sicun,9999,0,9999,0
1668089988946,CSE 293,043,119540,Weibel; Nadir,9999,0,9999,0
1668089988946,CSE 293,044,119541,Gupta; Rajesh K.,9999,0,9999,0
1668089988946,CSE 293,045,126410,Vaccaro; Kristen Marie,9999,0,9999,0
1668089988946,CSE 293,046,126411,Klemke; Richard,9999,0,9999,0
1668089989370,CSE 294,A00,102459,Voelker; Geoffrey M.,0,0,0,0
1668089989370,CSE 294,B00,111322,Orailoglu; Alex,0,0,0,0
1668089989794,DSE 201,A00,096914,Deutsch; Alin Bernard,30,0,30,0
1668089990220,DSE 210,A00,096915,Dasgupta; Sanjoy,30,0,30,0
1668089990652,DSE 260A,A00,096916,Altintas De Callaf; Ilkay,30,0,30,0
1668089991083,ECE 200,001,103586,Antipa; Nicholas A,9999,0,9999,0
1668089991083,ECE 200,002,103587,Atanasov; Nikolay A.,9999,0,9999,0
1668089991083,ECE 200,003,103588,Bharadia; Dinesh,9999,0,9999,0
1668089991083,ECE 200,004,103589,Cheng; Chung Kuan,9999,0,9999,0
1668089991083,ECE 200,005,103590,Cosman; Pamela C.,9999,0,9999,0
1668089991083,ECE 200,006,103591,Dayeh; Shadi Ahmad,9999,0,9999,0
1668089991083,ECE 200,007,103592,Fainman; Yeshaiahu,9999,0,9999,0
1668089991083,ECE 200,008,103593,Ford; Joseph Earl,9999,0,9999,0
1668089991083,ECE 200,009,103594,Franceschetti; Massimo,9999,0,9999,0
1668089991083,ECE 200,010,103595,Fullerton; Eric E,9999,0,9999,0
1668089991083,ECE 200,011,103596,Galton; Ian A,9999,0,9999,0
1668089991083,ECE 200,012,103597,Gilja; Vikash,9999,0,9999,0
1668089991083,ECE 200,013,103598,Hall; Drew A.,9999,0,9999,0
1668089991083,ECE 200,014,103599,Hsueh; Tzu-Chien,9999,0,9999,0
1668089991083,ECE 200,015,103600,Javidi; Tara,9999,0,9999,0
1668089991083,ECE 200,016,103601,Kahng; Andrew Byun,9999,0,9999,0
1668089991083,ECE 200,017,103602,Kim; Young-Han,9999,0,9999,0
1668089991083,ECE 200,018,103603,Koushanfar; Farinaz,9999,0,9999,0
1668089991083,ECE 200,019,103604,Kuzum; Duygu,9999,0,9999,0
1668089991083,ECE 200,020,103605,Le; Hanh-Phuc,9999,0,9999,0
1668089991083,ECE 200,021,103606,Lin; Bill,9999,0,9999,0
1668089991083,ECE 200,022,103607,Liu; Zhaowei,9998,0,9999,1
1668089991083,ECE 200,023,103608,Lo; Yu-Hwa,9999,0,9999,0
1668089991083,ECE 200,024,103609,Lomakin; Vitaliy,9999,0,9999,0
1668089991083,ECE 200,025,103610,Mercier; Patrick Philip,9999,0,9999,0
1668089991083,ECE 200,026,103611,Meyer; Florian,9999,0,9999,0
1668089991083,ECE 200,027,103612,Milstein; Laurence B.,9999,0,9999,0
1668089991083,ECE 200,028,103613,Mir Arabbaygi; Siavash,9999,0,9999,0
1668089991083,ECE 200,029,103614,Mookherjea; Shayan,9999,0,9999,0
1668089991083,ECE 200,030,103615,Morris; Karcher William,9999,0,9999,0
1668089991083,ECE 200,031,103616,Ng; Tse Nga,9999,0,9999,0
1668089991083,ECE 200,032,103617,Nguyen; Truong Quang,9999,0,9999,0
1668089991083,ECE 200,033,103618,Nomura; Kenji,9999,0,9999,0
1668089991083,ECE 200,034,103619,Orlitsky; Alon,9999,0,9999,0
1668089991083,ECE 200,035,103620,Pal; Piya,9999,0,9999,0
1668089991083,ECE 200,036,103621,Papen; George C.,9999,0,9999,0
1668089991083,ECE 200,037,103622,Radic; Stojan,9999,0,9999,0
1668089991083,ECE 200,038,103623,Rao; Bhaskar D.,9999,0,9999,0
1668089991083,ECE 200,039,103624,Rao; Ramesh R,9999,0,9999,0
1668089991083,ECE 200,040,103625,Rebeiz; Gabriel,9999,0,9999,0
1668089991083,ECE 200,041,103626,Sanford; John R,9999,0,9999,0
1668089991083,ECE 200,042,103627,Siegel; Paul H.,9999,0,9999,0
1668089991083,ECE 200,043,103628,Sievenpiper; Daniel F.,9999,0,9999,0
1668089991083,ECE 200,044,103629,Sworder; David D.,9999,0,9999,0
1668089991083,ECE 200,045,103630,Taur; Yuan,9999,0,9999,0
1668089991083,ECE 200,046,103631,Touri; Behrouz,9999,0,9999,0
1668089991083,ECE 200,047,103632,Trivedi; Mohan M.,9999,0,9999,0
1668089991083,ECE 200,048,103633,Vasconcelos; Nuno,9999,0,9999,0
1668089991083,ECE 200,049,103634,Wang; Xiaolong,9999,0,9999,0
1668089991083,ECE 200,050,103635,Xie; Pengtao,9999,0,9999,0
1668089991083,ECE 200,051,103636,Yip; Michael,9999,0,9999,0
1668089991083,ECE 200,052,103637,Zeger; Kenneth A.,999,0,999,0
1668089991083,ECE 200,053,103638,Zhang; Xinyu,9999,0,9999,0
1668089991083,ECE 200,054,103639,Turakhia; Yatish Girish,9999,0,9999,0
1668089991083,ECE 200,055,103640,Kang; Mingu,9999,0,9999,0
1668089991083,ECE 200,056,103641,Shi; Yuanyuan,9999,0,9999,0
1668089991083,ECE 200,057,103642,Wang; Edward Jay,9999,0,9999,0
1668089991083,ECE 200,058,103643,Zheng; Yang,9999,0,9999,0
1668089991510,ECE 202,A00,103644,Kuzum; Duygu,0,0,0,0
1668089991935,ECE 212BN,A00,103646,Ng; Tse Nga,0,0,0,0
1668089992359,ECE 221,A00,111493,Staff,0,0,0,0
1668089992795,ECE 222B,A00,103647,Lomakin; Vitaliy,0,0,0,0
1668089993225,ECE 230B,A00,103648,Taur; Yuan,0,0,0,0
1668089993656,ECE 238B,A00,103649,Garay; Javier,0,0,0,0
1668089994088,ECE 240B,A00,112900,Fainman; Yeshaiahu,0,0,0,0
1668089994510,ECE 247A,A00,103650,Jokerst; Jesse Vincent,0,0,0,0
1668089994934,ECE 247B,A00,103651,Wang; Joseph,0,0,0,0
1668089995362,ECE 250,A00,103652,Siegel; Paul H.,0,0,0,0
1668089995791,ECE 251A,A00,103654,Rao; Bhaskar D.,0,0,0,0
1668089996230,ECE 257B,A00,103655,Bharadia; Dinesh,0,0,0,0
1668089996663,ECE 258A,A00,103656,Milstein; Laurence B.,0,0,0,0
1668089997089,ECE 260B,A00,103658,Kang; Mingu,0,0,0,0
1668089997514,ECE 264A,A00,103659,Galton; Ian A,0,0,0,0
1668089997956,ECE 265A,A00,103661,Gudem; Prasad S.S.,0,0,0,0
1668089998383,ECE 265D,A00,103662,Gudem; Prasad S.S.,0,0,0,0
1668089998809,ECE 268,A00,103663,Koushanfar; Farinaz,0,0,0,0
1668089999246,ECE 269,A01,103665,Pal; Piya,0,0,0,0
1668089999670,ECE 271B,A00,103666,Vasconcelos; Manuela,0,0,0,0
1668090000094,ECE 276A,A00,103667,Atanasov; Nikolay A.,0,0,0,0
1668090000518,ECE 277,A00,103668,An; Cheolhong,0,0,0,0
1668090000950,ECE 279,A00,117947,Hall; Drew A.,0,0,0,0
1668090001828,ECE 283,A00,103670,Hsueh; Tzu-Chien,0,0,0,0
1668090002252,ECE 284,A00,103671,Turakhia; Yatish Girish,0,0,0,0
1668090002695,ECE 285,A00,103672,Zheng; Yang,0,0,0,0
1668090002695,ECE 285,B00,103673,Sworder; David D.,0,0,0,0
1668090003118,ECE 287,A00,103676,Javidi; Tara,0,0,0,0
1668090003545,MATH 200B,A00,098023,Salehi Golsefidy; Alireza,13,0,15,2
1668090003970,MATH 202B,A00,098024,Rhoades; Brendon Patrick,9,0,15,6
1668090004396,MATH 203B,A00,098025,Oprea; Dragos N.,10,0,15,5
1668090004823,MATH 204B,A00,098026,Sorensen; Claus M,13,0,15,2
1668090005251,MATH 208,A00,098027,Izadi; Elham,7,0,10,3
1668090005678,MATH 209,A00,098028,Pollack; Aaron,10,0,10,0
1668090006102,MATH 211A,A00,112919,Rogalski; Daniel,9,0,10,1
1668090006528,MATH 211B,A00,112920,Seward; Brandon M.,9,0,10,1
1668090006950,MATH 218,A00,098029,Li; Bo,10,0,10,0
1668090007381,MATH 220B,A00,098030,Novak; Jonathan I,12,0,15,3
1668090007803,MATH 221A,A00,098031,Ebenfelt; Peter F,13,0,15,2
1668090008227,MATH 231B,A00,098032,Zlatos; Andrej,12,0,15,3
1668090008653,MATH 240B,A00,098033,Ni; Lei,9,0,15,6
1668090009077,MATH 243,A00,098034,Jekel; David Andrew,10,0,10,0
1668090009507,MATH 245A,A00,098035,Nie; Jiawang,0,0,15,16
1668090009946,MATH 248,A00,098036,Bejenaru; Ioan,10,0,10,0
1668090010386,MATH 250B,A00,098037,Spolaor; Luca,14,0,15,1
1668090010815,MATH 258,A00,098038,Ni; Lei,10,0,10,0
1668090011243,MATH 264B,A00,098041,Rhoades; Brendon Patrick,10,0,15,5
1668090011678,MATH 268,A00,098042,Buss; Samuel R,10,0,10,0
1668090012105,MATH 269,A00,098043,Rhoades; Brendon Patrick,10,0,10,0
1668090012530,MATH 270B,A00,098044,Li; Bo,11,0,15,4
1668090012954,MATH 272B,A00,098045,Holst; Michael J,13,0,15,2
1668090013380,MATH 273A,A00,098046,Tian; Xiaochuan,10,0,15,5
1668090013813,MATH 275,A01,098048,Tian; Xiaochuan,6,0,10,4
1668090014239,MATH 278A,A00,098049,Holst; Michael J,8,0,10,2
1668090014662,MATH 278B,A00,098050,Cloninger; Alexander,10,0,10,0
1668090015088,MATH 278C,A00,098051,Nie; Jiawang,7,0,10,3
1668090015514,MATH 280B,A00,098052,Zheng; Tianyi,10,0,15,5
1668090015939,MATH 281B,A00,098053,Bradic; Jelena,3,0,15,12
1668090016365,MATH 282B,A00,098054,Arias-Castro; Ery,0,0,15,15
1668090016803,MATH 285,A00,098055,Fitzsimmons; Patrick J,0,0,15,17
1668090017230,MATH 287B,A00,098056,Arias-Castro; Ery,3,0,15,12
1668090017658,MATH 288,A00,098057,Agarwal; Pooja,9,0,10,1
1668090017658,MATH 288,B00,098058,Zhang; Danna,8,0,10,2
1668090017658,MATH 288,C00,098059,Williams; Ruth J,10,0,10,0
1668090018083,MATH 290B,A00,098060,Roberts; Justin Deritter,13,0,15,2
1668090018513,MATH 292,A00,098061,Belmont; Eva Kinoshita,10,0,10,0
1668090018950,MATH 295,A00,098062,Suk; Andrew Hoon,48,0,50,2
1668090019375,MATH 296,A00,098063,Novak; Jonathan I,20,0,20,0
1668090019913,MATH 297,001,098064,Gamst; Anthony Collins,9997,0,9999,2
1668090520763,COGS 205,A00,101395,Chiba; Andrea,19,0,20,1
1668090521188,COGS 210B,001,101404,Greene; Deanna Jacquelyn,9998,0,9999,1
1668090521188,COGS 210B,002,101417,Xia; Haijun,9999,0,9999,0
1668090521188,COGS 210B,003,101422,Nitz; Douglas A.,9999,0,9999,0
1668090521188,COGS 210B,004,101423,Hollan; James D.,9998,0,9999,1
1668090521188,COGS 210B,005,101424,Deak; Gedeon O.,9998,0,9999,1
1668090521188,COGS 210B,006,101425,Rossano; Federico,9999,0,9999,0
1668090521613,COGS 211B,A00,101427,Coulson; Seana M,9996,0,9999,3
1668090522038,COGS 220,A00,101428,Hollan; James D.,0,0,25,25
1668090522472,COGS 229,A00,101429,Dow; Steven P,18,0,25,7
1668090522896,COGS 230,A00,101430,Klemmer; Scott R,13,0,17,4
1668090523320,COGS 234,A00,101431,Xia; Haijun,3,0,25,22
1668090523745,COGS 260,A00,101432,Kiyonaga; Anastasia,19,0,25,6
1668090523745,COGS 260,B00,101433,Kirsh; David Joel,16,0,25,9
1668090524167,CSE 202,A00,102371,Impagliazzo; Russell,0,0,0,0
1668090524607,CSE 203B,A01,102373,Cheng; Chung Kuan,0,0,0,0
1668090525032,CSE 208,A00,102374,Micciancio; Daniele,0,0,0,0
1668090525453,CSE 209A,A00,112895,Impagliazzo; Russell,0,0,15,15
1668090525881,CSE 209B,A00,108005,Bellare; Mihir,0,0,0,0
1668090526307,CSE 210,A00,113163,Coblenz; Michael J,0,0,0,0
1668090526730,CSE 219,A00,106111,Dow; Steven P,0,0,20,20
1668090527157,CSE 221,A00,102376,Voelker; Geoffrey M.,0,0,0,0
1668090527580,CSE 224,A01,102378,Porter; George M,0,0,0,0
1668090528005,CSE 229A,A00,102379,Savage; Stefan,0,0,0,0
1668090528430,CSE 229C,A00,102380,Munyaka; Imani N. S.,0,0,0,0
1668090528855,CSE 232B,A00,102382,Deutsch; Alin Bernard,0,0,0,0
1668090529277,CSE 234,A01,112904,Kumar; Arun Kumar,0,0,0,0
1668090529703,CSE 237A,A00,102383,Rosing; Tajana Simunic,0,0,0,0
1668090530128,CSE 239A,A00,102384,Deutsch; Alin Bernard,0,0,0,0
1668090530551,CSE 239B,A00,102385,Polikarpova; Nadezhda,0,0,0,0
1668090530979,CSE 240A,A00,102386,Pannuto; Patrick William,0,0,0,0
1668090531403,CSE 240B,A00,102387,Zhao; Jishen,0,0,0,0
1668090531832,CSE 241A,A00,106406,Kang; Mingu,0,0,0,0
1668090532257,CSE 249B,A00,102388,Kahng; Andrew Byun,0,0,8,8
1668090532680,CSE 251B,A01,102392,Cottrell; Garrison W,0,0,0,0
1668090532680,CSE 251B,A02,102393,Cottrell; Garrison W,0,0,0,0
1668090533107,CSE 252B,A00,102394,Ochoa; Benjamin Lawrence,0,0,0,0
1668090533532,CSE 257,A01,102396,Gao; Sicun,0,0,0,0
1668090533955,CSE 272,A00,102397,Li; Tzumao,0,0,0,0
1668090534378,CSE 274,A00,111323,Chern; Albert Ren-Haur,0,0,0,0
1668090534818,CSE 282,A00,102398,Pevzner; Pavel Arkadjevich,0,0,0,0
1668090535245,CSE 284,A00,114175,Gymrek; Melissa Ann,0,0,0,0
1668090535679,CSE 290,A00,102399,Chandraker; Manmohan Krishna,0,0,0,0
1668090535679,CSE 290,B00,102400,Vaccaro; Kristen Marie,0,0,25,25
1668090535679,CSE 290,C00,102414,Pannuto; Patrick William,0,0,25,25
1668090535679,CSE 290,D00,102427,Pevzner; Pavel Arkadjevich,0,0,0,0
1668090535679,CSE 290,E00,102429,Zhao; Jishen,0,0,0,0
1668090535679,CSE 290,F00,102436,Tullsen; Dean Michael,0,0,0,0
1668090535679,CSE 290,G00,102440,Christensen; Henrik I,0,0,20,20
1668090536101,CSE 291,A00,102443,Su; Hao,0,0,0,0
1668090536101,CSE 291,B00,102448,Polikarpova; Nadezhda,0,0,0,0
1668090536101,CSE 291,C00,102453,Vaccaro; Kristen Marie,0,0,0,0
1668090536101,CSE 291,D00,111343,Savage; Stefan,0,0,0,0
1668090536101,CSE 291,E00,116474,Claffy; Kimberly Claire,0,0,0,0
1668090536101,CSE 291,F00,116479,Pasquale; Joseph,0,0,0,0
1668090536529,CSE 293,001,119111,Bafna; Vineet,9999,0,9999,0
1668090536529,CSE 293,002,119118,Bellare; Mihir,9999,0,9999,0
1668090536529,CSE 293,003,119122,Berg-Kirkpatrick; Taylor D,9999,0,9999,0
1668090536529,CSE 293,004,119135,Christensen; Henrik I,9999,0,9999,0
1668090536529,CSE 293,005,119142,Cottrell; Garrison W,9999,0,9999,0
1668090536529,CSE 293,006,119146,Deutsch; Alin Bernard,9999,0,9999,0
1668090536529,CSE 293,007,119159,Esmaeilzadeh; Hadi,9999,0,9999,0
1668090536529,CSE 293,008,119166,Freund; Yoav,9999,0,9999,0
1668090536529,CSE 293,009,119170,Griswold; William G.,9999,0,9999,0
1668090536529,CSE 293,010,119183,Gymrek; Melissa Ann,9999,0,9999,0
1668090536529,CSE 293,011,119190,Heninger; Nadia A,9999,0,9999,0
1668090536529,CSE 293,012,119230,Impagliazzo; Russell,9999,0,9999,0
1668090536529,CSE 293,013,119232,Jhala; Ranjit,9999,0,9999,0
1668090536529,CSE 293,014,119233,Kahng; Andrew Byun,9999,0,9999,0
1668090536529,CSE 293,015,119298,Kane; Daniel Mertz,9999,0,9999,0
1668090536529,CSE 293,016,119299,Kriegman; David J,9999,0,9999,0
1668090536529,CSE 293,017,119300,Kumar; Arun Kumar,9999,0,9999,0
1668090536529,CSE 293,018,119301,Lerner; Sorin,9999,0,9999,0
1668090536529,CSE 293,019,119302,Lovett; Shachar,9999,0,9999,0
1668090536529,CSE 293,020,119303,McAuley; Julian John,9999,0,9999,0
1668090536529,CSE 293,021,119304,Micciancio; Daniele,9999,0,9999,0
1668090536529,CSE 293,022,119367,Orailoglu; Alex,9999,0,9999,0
1668090536529,CSE 293,023,119382,Paturi; Ramamohan,9999,0,9999,0
1668090536529,CSE 293,024,119404,Polikarpova; Nadezhda,9999,0,9999,0
1668090536529,CSE 293,025,119406,Politz; Joseph Gibbs,9999,0,9999,0
1668090536529,CSE 293,026,119411,Porter; George M,9999,0,9999,0
1668090536529,CSE 293,027,119414,Porter; Leonard Emerson,9999,0,9999,0
1668090536529,CSE 293,028,119416,Ramamoorthi; Ravi,9999,0,9999,0
1668090536529,CSE 293,029,119417,Sahoo; Debashis,9999,0,9999,0
1668090536529,CSE 293,030,119420,Saul; Lawrence,9999,0,9999,0
1668090536529,CSE 293,031,119421,Savage; Stefan,9999,0,9999,0
1668090536529,CSE 293,032,119425,Schulze; Jurgen P.,9999,0,9999,0
1668090536529,CSE 293,033,119426,Snoeren; Alex C.,9999,0,9999,0
1668090536529,CSE 293,034,119428,Shang; Jingbo,9999,0,9999,0
1668090536529,CSE 293,035,119430,Stefan; Deian,9999,0,9999,0
1668090536529,CSE 293,036,119431,Su; Hao,9999,0,9999,0
1668090536529,CSE 293,037,119433,Swanson; Steven James,9999,0,9999,0
1668090536529,CSE 293,038,119435,Tullsen; Dean Michael,9999,0,9999,0
1668090536529,CSE 293,039,119483,Voelker; Geoffrey M.,9999,0,9999,0
1668090536529,CSE 293,040,119537,Zhao; Jishen,9999,0,9999,0
1668090536529,CSE 293,041,119538,Zhou; Yuan-Yuan,9999,0,9999,0
1668090536529,CSE 293,042,119539,Gao; Sicun,9999,0,9999,0
1668090536529,CSE 293,043,119540,Weibel; Nadir,9999,0,9999,0
1668090536529,CSE 293,044,119541,Gupta; Rajesh K.,9999,0,9999,0
1668090536529,CSE 293,045,126410,Vaccaro; Kristen Marie,9999,0,9999,0
1668090536529,CSE 293,046,126411,Klemke; Richard,9999,0,9999,0
1668090536952,CSE 294,A00,102459,Voelker; Geoffrey M.,0,0,0,0
1668090536952,CSE 294,B00,111322,Orailoglu; Alex,0,0,0,0
1668090537377,DSE 201,A00,096914,Deutsch; Alin Bernard,30,0,30,0
1668090537798,DSE 210,A00,096915,Dasgupta; Sanjoy,30,0,30,0
1668090538224,DSE 260A,A00,096916,Altintas De Callaf; Ilkay,30,0,30,0
1668090538660,ECE 200,001,103586,Antipa; Nicholas A,9999,0,9999,0
1668090538660,ECE 200,002,103587,Atanasov; Nikolay A.,9999,0,9999,0
1668090538660,ECE 200,003,103588,Bharadia; Dinesh,9999,0,9999,0
1668090538660,ECE 200,004,103589,Cheng; Chung Kuan,9999,0,9999,0
1668090538660,ECE 200,005,103590,Cosman; Pamela C.,9999,0,9999,0
1668090538660,ECE 200,006,103591,Dayeh; Shadi Ahmad,9999,0,9999,0
1668090538660,ECE 200,007,103592,Fainman; Yeshaiahu,9999,0,9999,0
1668090538660,ECE 200,008,103593,Ford; Joseph Earl,9999,0,9999,0
1668090538660,ECE 200,009,103594,Franceschetti; Massimo,9999,0,9999,0
1668090538660,ECE 200,010,103595,Fullerton; Eric E,9999,0,9999,0
1668090538660,ECE 200,011,103596,Galton; Ian A,9999,0,9999,0
1668090538660,ECE 200,012,103597,Gilja; Vikash,9999,0,9999,0
1668090538660,ECE 200,013,103598,Hall; Drew A.,9999,0,9999,0
1668090538660,ECE 200,014,103599,Hsueh; Tzu-Chien,9999,0,9999,0
1668090538660,ECE 200,015,103600,Javidi; Tara,9999,0,9999,0
1668090538660,ECE 200,016,103601,Kahng; Andrew Byun,9999,0,9999,0
1668090538660,ECE 200,017,103602,Kim; Young-Han,9999,0,9999,0
1668090538660,ECE 200,018,103603,Koushanfar; Farinaz,9999,0,9999,0
1668090538660,ECE 200,019,103604,Kuzum; Duygu,9999,0,9999,0
1668090538660,ECE 200,020,103605,Le; Hanh-Phuc,9999,0,9999,0
1668090538660,ECE 200,021,103606,Lin; Bill,9999,0,9999,0
1668090538660,ECE 200,022,103607,Liu; Zhaowei,9998,0,9999,1
1668090538660,ECE 200,023,103608,Lo; Yu-Hwa,9999,0,9999,0
1668090538660,ECE 200,024,103609,Lomakin; Vitaliy,9999,0,9999,0
1668090538660,ECE 200,025,103610,Mercier; Patrick Philip,9999,0,9999,0
1668090538660,ECE 200,026,103611,Meyer; Florian,9999,0,9999,0
1668090538660,ECE 200,027,103612,Milstein; Laurence B.,9999,0,9999,0
1668090538660,ECE 200,028,103613,Mir Arabbaygi; Siavash,9999,0,9999,0
1668090538660,ECE 200,029,103614,Mookherjea; Shayan,9999,0,9999,0
1668090538660,ECE 200,030,103615,Morris; Karcher William,9999,0,9999,0
1668090538660,ECE 200,031,103616,Ng; Tse Nga,9999,0,9999,0
1668090538660,ECE 200,032,103617,Nguyen; Truong Quang,9999,0,9999,0
1668090538660,ECE 200,033,103618,Nomura; Kenji,9999,0,9999,0
1668090538660,ECE 200,034,103619,Orlitsky; Alon,9999,0,9999,0
1668090538660,ECE 200,035,103620,Pal; Piya,9999,0,9999,0
1668090538660,ECE 200,036,103621,Papen; George C.,9999,0,9999,0
1668090538660,ECE 200,037,103622,Radic; Stojan,9999,0,9999,0
1668090538660,ECE 200,038,103623,Rao; Bhaskar D.,9999,0,9999,0
1668090538660,ECE 200,039,103624,Rao; Ramesh R,9999,0,9999,0
1668090538660,ECE 200,040,103625,Rebeiz; Gabriel,9999,0,9999,0
1668090538660,ECE 200,041,103626,Sanford; John R,9999,0,9999,0
1668090538660,ECE 200,042,103627,Siegel; Paul H.,9999,0,9999,0
1668090538660,ECE 200,043,103628,Sievenpiper; Daniel F.,9999,0,9999,0
1668090538660,ECE 200,044,103629,Sworder; David D.,9999,0,9999,0
1668090538660,ECE 200,045,103630,Taur; Yuan,9999,0,9999,0
1668090538660,ECE 200,046,103631,Touri; Behrouz,9999,0,9999,0
1668090538660,ECE 200,047,103632,Trivedi; Mohan M.,9999,0,9999,0
1668090538660,ECE 200,048,103633,Vasconcelos; Nuno,9999,0,9999,0
1668090538660,ECE 200,049,103634,Wang; Xiaolong,9999,0,9999,0
1668090538660,ECE 200,050,103635,Xie; Pengtao,9999,0,9999,0
1668090538660,ECE 200,051,103636,Yip; Michael,9999,0,9999,0
1668090538660,ECE 200,052,103637,Zeger; Kenneth A.,999,0,999,0
1668090538660,ECE 200,053,103638,Zhang; Xinyu,9999,0,9999,0
1668090538660,ECE 200,054,103639,Turakhia; Yatish Girish,9999,0,9999,0
1668090538660,ECE 200,055,103640,Kang; Mingu,9999,0,9999,0
1668090538660,ECE 200,056,103641,Shi; Yuanyuan,9999,0,9999,0
1668090538660,ECE 200,057,103642,Wang; Edward Jay,9999,0,9999,0
1668090538660,ECE 200,058,103643,Zheng; Yang,9999,0,9999,0
1668090539084,ECE 202,A00,103644,Kuzum; Duygu,0,0,0,0
1668090539511,ECE 212BN,A00,103646,Ng; Tse Nga,0,0,0,0
1668090539936,ECE 221,A00,111493,Staff,0,0,0,0
1668090540361,ECE 222B,A00,103647,Lomakin; Vitaliy,0,0,0,0
1668090540888,ECE 230B,A00,103648,Taur; Yuan,0,0,0,0
1668090541311,ECE 238B,A00,103649,Garay; Javier,0,0,0,0
1668090541737,ECE 240B,A00,112900,Fainman; Yeshaiahu,0,0,0,0
1668090542160,ECE 247A,A00,103650,Jokerst; Jesse Vincent,0,0,0,0
1668090542585,ECE 247B,A00,103651,Wang; Joseph,0,0,0,0
1668090543014,ECE 250,A00,103652,Siegel; Paul H.,0,0,0,0
1668090543438,ECE 251A,A00,103654,Rao; Bhaskar D.,0,0,0,0
1668090543863,ECE 257B,A00,103655,Bharadia; Dinesh,0,0,0,0
1668090544288,ECE 258A,A00,103656,Milstein; Laurence B.,0,0,0,0
1668090544712,ECE 260B,A00,103658,Kang; Mingu,0,0,0,0
1668090545138,ECE 264A,A00,103659,Galton; Ian A,0,0,0,0
1668090545561,ECE 265A,A00,103661,Gudem; Prasad S.S.,0,0,0,0
1668090545987,ECE 265D,A00,103662,Gudem; Prasad S.S.,0,0,0,0
1668090546411,ECE 268,A00,103663,Koushanfar; Farinaz,0,0,0,0
1668090546833,ECE 269,A01,103665,Pal; Piya,0,0,0,0
1668090547260,ECE 271B,A00,103666,Vasconcelos; Manuela,0,0,0,0
1668090547686,ECE 276A,A00,103667,Atanasov; Nikolay A.,0,0,0,0
1668090548110,ECE 277,A00,103668,An; Cheolhong,0,0,0,0
1668090548534,ECE 279,A00,117947,Hall; Drew A.,0,0,0,0
1668090549383,ECE 283,A00,103670,Hsueh; Tzu-Chien,0,0,0,0
1668090549808,ECE 284,A00,103671,Turakhia; Yatish Girish,0,0,0,0
1668090550241,ECE 285,A00,103672,Zheng; Yang,0,0,0,0
1668090550241,ECE 285,B00,103673,Sworder; David D.,0,0,0,0
1668090550667,ECE 287,A00,103676,Javidi; Tara,0,0,0,0
1668090551094,MATH 200B,A00,098023,Salehi Golsefidy; Alireza,13,0,15,2
1668090551518,MATH 202B,A00,098024,Rhoades; Brendon Patrick,9,0,15,6
1668090551959,MATH 203B,A00,098025,Oprea; Dragos N.,10,0,15,5
1668090552382,MATH 204B,A00,098026,Sorensen; Claus M,13,0,15,2
1668090552807,MATH 208,A00,098027,Izadi; Elham,7,0,10,3
1668090553234,MATH 209,A00,098028,Pollack; Aaron,10,0,10,0
1668090553657,MATH 211A,A00,112919,Rogalski; Daniel,9,0,10,1
1668090554082,MATH 211B,A00,112920,Seward; Brandon M.,9,0,10,1
1668090554507,MATH 218,A00,098029,Li; Bo,10,0,10,0
1668090554936,MATH 220B,A00,098030,Novak; Jonathan I,12,0,15,3
1668090555360,MATH 221A,A00,098031,Ebenfelt; Peter F,13,0,15,2
1668090555788,MATH 231B,A00,098032,Zlatos; Andrej,12,0,15,3
1668090556210,MATH 240B,A00,098033,Ni; Lei,9,0,15,6
1668090556648,MATH 243,A00,098034,Jekel; David Andrew,10,0,10,0
1668090557076,MATH 245A,A00,098035,Nie; Jiawang,0,0,15,16
1668090557512,MATH 248,A00,098036,Bejenaru; Ioan,10,0,10,0
1668090557938,MATH 250B,A00,098037,Spolaor; Luca,14,0,15,1
1668090558360,MATH 258,A00,098038,Ni; Lei,10,0,10,0
1668090558784,MATH 264B,A00,098041,Rhoades; Brendon Patrick,10,0,15,5
1668090559208,MATH 268,A00,098042,Buss; Samuel R,10,0,10,0
1668090559633,MATH 269,A00,098043,Rhoades; Brendon Patrick,10,0,10,0
1668090560060,MATH 270B,A00,098044,Li; Bo,11,0,15,4
1668090560494,MATH 272B,A00,098045,Holst; Michael J,13,0,15,2
1668090560922,MATH 273A,A00,098046,Tian; Xiaochuan,10,0,15,5
1668090561345,MATH 275,A01,098048,Tian; Xiaochuan,6,0,10,4
1668090561766,MATH 278A,A00,098049,Holst; Michael J,8,0,10,2
1668090562195,MATH 278B,A00,098050,Cloninger; Alexander,10,0,10,0
1668090562621,MATH 278C,A00,098051,Nie; Jiawang,7,0,10,3
1668090563043,MATH 280B,A00,098052,Zheng; Tianyi,10,0,15,5
1668090563466,MATH 281B,A00,098053,Bradic; Jelena,3,0,15,12
1668090563890,MATH 282B,A00,098054,Arias-Castro; Ery,0,0,15,15
1668090564316,MATH 285,A00,098055,Fitzsimmons; Patrick J,0,0,15,17
1668090564741,MATH 287B,A00,098056,Arias-Castro; Ery,3,0,15,12
1668090565167,MATH 288,A00,098057,Agarwal; Pooja,9,0,10,1
1668090565167,MATH 288,B00,098058,Zhang; Danna,8,0,10,2
1668090565167,MATH 288,C00,098059,Williams; Ruth J,10,0,10,0
1668090565592,MATH 290B,A00,098060,Roberts; Justin Deritter,13,0,15,2
1668090566017,MATH 292,A00,098061,Belmont; Eva Kinoshita,10,0,10,0
1668090566450,MATH 295,A00,098062,Suk; Andrew Hoon,48,0,50,2
1668090566876,MATH 296,A00,098063,Novak; Jonathan I,20,0,20,0
1668090567307,MATH 297,001,098064,Gamst; Anthony Collins,9997,0,9999,2
1668091067106,COGS 205,A00,101395,Chiba; Andrea,19,0,20,1
1668091067530,COGS 210B,001,101404,Greene; Deanna Jacquelyn,9998,0,9999,1
1668091067530,COGS 210B,002,101417,Xia; Haijun,9999,0,9999,0
1668091067530,COGS 210B,003,101422,Nitz; Douglas A.,9999,0,9999,0
1668091067530,COGS 210B,004,101423,Hollan; James D.,9998,0,9999,1
1668091067530,COGS 210B,005,101424,Deak; Gedeon O.,9998,0,9999,1
1668091067530,COGS 210B,006,101425,Rossano; Federico,9999,0,9999,0
1668091067951,COGS 211B,A00,101427,Coulson; Seana M,9996,0,9999,3
1668091068375,COGS 220,A00,101428,Hollan; James D.,0,0,25,25
1668091068798,COGS 229,A00,101429,Dow; Steven P,18,0,25,7
1668091069223,COGS 230,A00,101430,Klemmer; Scott R,13,0,17,4
1668091069649,COGS 234,A00,101431,Xia; Haijun,3,0,25,22
1668091070074,COGS 260,A00,101432,Kiyonaga; Anastasia,19,0,25,6
1668091070074,COGS 260,B00,101433,Kirsh; David Joel,16,0,25,9
1668091070496,CSE 202,A00,102371,Impagliazzo; Russell,0,0,0,0
1668091070919,CSE 203B,A01,102373,Cheng; Chung Kuan,0,0,0,0
1668091071343,CSE 208,A00,102374,Micciancio; Daniele,0,0,0,0
1668091071765,CSE 209A,A00,112895,Impagliazzo; Russell,0,0,15,15
1668091072189,CSE 209B,A00,108005,Bellare; Mihir,0,0,0,0
1668091072612,CSE 210,A00,113163,Coblenz; Michael J,0,0,0,0
1668091073034,CSE 219,A00,106111,Dow; Steven P,0,0,20,20
1668091073461,CSE 221,A00,102376,Voelker; Geoffrey M.,0,0,0,0
1668091073885,CSE 224,A01,102378,Porter; George M,0,0,0,0
1668091074309,CSE 229A,A00,102379,Savage; Stefan,0,0,0,0
1668091074732,CSE 229C,A00,102380,Munyaka; Imani N. S.,0,0,0,0
1668091075159,CSE 232B,A00,102382,Deutsch; Alin Bernard,0,0,0,0
1668091075584,CSE 234,A01,112904,Kumar; Arun Kumar,0,0,0,0
1668091076020,CSE 237A,A00,102383,Rosing; Tajana Simunic,0,0,0,0
1668091076453,CSE 239A,A00,102384,Deutsch; Alin Bernard,0,0,0,0
1668091076877,CSE 239B,A00,102385,Polikarpova; Nadezhda,0,0,0,0
1668091077302,CSE 240A,A00,102386,Pannuto; Patrick William,0,0,0,0
1668091077734,CSE 240B,A00,102387,Zhao; Jishen,0,0,0,0
1668091078158,CSE 241A,A00,106406,Kang; Mingu,0,0,0,0
1668091078580,CSE 249B,A00,102388,Kahng; Andrew Byun,0,0,8,8
1668091079004,CSE 251B,A01,102392,Cottrell; Garrison W,0,0,0,0
1668091079004,CSE 251B,A02,102393,Cottrell; Garrison W,0,0,0,0
1668091079430,CSE 252B,A00,102394,Ochoa; Benjamin Lawrence,0,0,0,0
1668091079869,CSE 257,A01,102396,Gao; Sicun,0,0,0,0
1668091080292,CSE 272,A00,102397,Li; Tzumao,0,0,0,0
1668091080721,CSE 274,A00,111323,Chern; Albert Ren-Haur,0,0,0,0
1668091081144,CSE 282,A00,102398,Pevzner; Pavel Arkadjevich,0,0,0,0
1668091081586,CSE 284,A00,114175,Gymrek; Melissa Ann,0,0,0,0
1668091082012,CSE 290,A00,102399,Chandraker; Manmohan Krishna,0,0,0,0
1668091082012,CSE 290,B00,102400,Vaccaro; Kristen Marie,0,0,25,25
1668091082012,CSE 290,C00,102414,Pannuto; Patrick William,0,0,25,25
1668091082012,CSE 290,D00,102427,Pevzner; Pavel Arkadjevich,0,0,0,0
1668091082012,CSE 290,E00,102429,Zhao; Jishen,0,0,0,0
1668091082012,CSE 290,F00,102436,Tullsen; Dean Michael,0,0,0,0
1668091082012,CSE 290,G00,102440,Christensen; Henrik I,0,0,20,20
1668091082448,CSE 291,A00,102443,Su; Hao,0,0,0,0
1668091082448,CSE 291,B00,102448,Polikarpova; Nadezhda,0,0,0,0
1668091082448,CSE 291,C00,102453,Vaccaro; Kristen Marie,0,0,0,0
1668091082448,CSE 291,D00,111343,Savage; Stefan,0,0,0,0
1668091082448,CSE 291,E00,116474,Claffy; Kimberly Claire,0,0,0,0
1668091082448,CSE 291,F00,116479,Pasquale; Joseph,0,0,0,0
1668091082907,CSE 293,001,119111,Bafna; Vineet,9999,0,9999,0
1668091082907,CSE 293,002,119118,Bellare; Mihir,9999,0,9999,0
1668091082907,CSE 293,003,119122,Berg-Kirkpatrick; Taylor D,9999,0,9999,0
1668091082907,CSE 293,004,119135,Christensen; Henrik I,9999,0,9999,0
1668091082907,CSE 293,005,119142,Cottrell; Garrison W,9999,0,9999,0
1668091082907,CSE 293,006,119146,Deutsch; Alin Bernard,9999,0,9999,0
1668091082907,CSE 293,007,119159,Esmaeilzadeh; Hadi,9999,0,9999,0
1668091082907,CSE 293,008,119166,Freund; Yoav,9999,0,9999,0
1668091082907,CSE 293,009,119170,Griswold; William G.,9999,0,9999,0
1668091082907,CSE 293,010,119183,Gymrek; Melissa Ann,9999,0,9999,0
1668091082907,CSE 293,011,119190,Heninger; Nadia A,9999,0,9999,0
1668091082907,CSE 293,012,119230,Impagliazzo; Russell,9999,0,9999,0
1668091082907,CSE 293,013,119232,Jhala; Ranjit,9999,0,9999,0
1668091082907,CSE 293,014,119233,Kahng; Andrew Byun,9999,0,9999,0
1668091082907,CSE 293,015,119298,Kane; Daniel Mertz,9999,0,9999,0
1668091082907,CSE 293,016,119299,Kriegman; David J,9999,0,9999,0
1668091082907,CSE 293,017,119300,Kumar; Arun Kumar,9999,0,9999,0
1668091082907,CSE 293,018,119301,Lerner; Sorin,9999,0,9999,0
1668091082907,CSE 293,019,119302,Lovett; Shachar,9999,0,9999,0
1668091082907,CSE 293,020,119303,McAuley; Julian John,9999,0,9999,0
1668091082907,CSE 293,021,119304,Micciancio; Daniele,9999,0,9999,0
1668091082907,CSE 293,022,119367,Orailoglu; Alex,9999,0,9999,0
1668091082907,CSE 293,023,119382,Paturi; Ramamohan,9999,0,9999,0
1668091082907,CSE 293,024,119404,Polikarpova; Nadezhda,9999,0,9999,0
1668091082907,CSE 293,025,119406,Politz; Joseph Gibbs,9999,0,9999,0
1668091082907,CSE 293,026,119411,Porter; George M,9999,0,9999,0
1668091082907,CSE 293,027,119414,Porter; Leonard Emerson,9999,0,9999,0
1668091082907,CSE 293,028,119416,Ramamoorthi; Ravi,9999,0,9999,0
1668091082907,CSE 293,029,119417,Sahoo; Debashis,9999,0,9999,0
1668091082907,CSE 293,030,119420,Saul; Lawrence,9999,0,9999,0
1668091082907,CSE 293,031,119421,Savage; Stefan,9999,0,9999,0
1668091082907,CSE 293,032,119425,Schulze; Jurgen P.,9999,0,9999,0
1668091082907,CSE 293,033,119426,Snoeren; Alex C.,9999,0,9999,0
1668091082907,CSE 293,034,119428,Shang; Jingbo,9999,0,9999,0
1668091082907,CSE 293,035,119430,Stefan; Deian,9999,0,9999,0
1668091082907,CSE 293,036,119431,Su; Hao,9999,0,9999,0
1668091082907,CSE 293,037,119433,Swanson; Steven James,9999,0,9999,0
1668091082907,CSE 293,038,119435,Tullsen; Dean Michael,9999,0,9999,0
1668091082907,CSE 293,039,119483,Voelker; Geoffrey M.,9999,0,9999,0
1668091082907,CSE 293,040,119537,Zhao; Jishen,9999,0,9999,0
1668091082907,CSE 293,041,119538,Zhou; Yuan-Yuan,9999,0,9999,0
1668091082907,CSE 293,042,119539,Gao; Sicun,9999,0,9999,0
1668091082907,CSE 293,043,119540,Weibel; Nadir,9999,0,9999,0
1668091082907,CSE 293,044,119541,Gupta; Rajesh K.,9999,0,9999,0
1668091082907,CSE 293,045,126410,Vaccaro; Kristen Marie,9999,0,9999,0
1668091082907,CSE 293,046,126411,Klemke; Richard,9999,0,9999,0
1668091083336,CSE 294,A00,102459,Voelker; Geoffrey M.,0,0,0,0
1668091083336,CSE 294,B00,111322,Orailoglu; Alex,0,0,0,0
1668091083761,DSE 201,A00,096914,Deutsch; Alin Bernard,30,0,30,0
1668091084182,DSE 210,A00,096915,Dasgupta; Sanjoy,30,0,30,0
1668091084606,DSE 260A,A00,096916,Altintas De Callaf; Ilkay,30,0,30,0
1668091085033,ECE 200,001,103586,Antipa; Nicholas A,9999,0,9999,0
1668091085033,ECE 200,002,103587,Atanasov; Nikolay A.,9999,0,9999,0
1668091085033,ECE 200,003,103588,Bharadia; Dinesh,9999,0,9999,0
1668091085033,ECE 200,004,103589,Cheng; Chung Kuan,9999,0,9999,0
1668091085033,ECE 200,005,103590,Cosman; Pamela C.,9999,0,9999,0
1668091085033,ECE 200,006,103591,Dayeh; Shadi Ahmad,9999,0,9999,0
1668091085033,ECE 200,007,103592,Fainman; Yeshaiahu,9999,0,9999,0
1668091085033,ECE 200,008,103593,Ford; Joseph Earl,9999,0,9999,0
1668091085033,ECE 200,009,103594,Franceschetti; Massimo,9999,0,9999,0
1668091085033,ECE 200,010,103595,Fullerton; Eric E,9999,0,9999,0
1668091085033,ECE 200,011,103596,Galton; Ian A,9999,0,9999,0
1668091085033,ECE 200,012,103597,Gilja; Vikash,9999,0,9999,0
1668091085033,ECE 200,013,103598,Hall; Drew A.,9999,0,9999,0
1668091085033,ECE 200,014,103599,Hsueh; Tzu-Chien,9999,0,9999,0
1668091085033,ECE 200,015,103600,Javidi; Tara,9999,0,9999,0
1668091085033,ECE 200,016,103601,Kahng; Andrew Byun,9999,0,9999,0
1668091085033,ECE 200,017,103602,Kim; Young-Han,9999,0,9999,0
1668091085033,ECE 200,018,103603,Koushanfar; Farinaz,9999,0,9999,0
1668091085033,ECE 200,019,103604,Kuzum; Duygu,9999,0,9999,0
1668091085033,ECE 200,020,103605,Le; Hanh-Phuc,9999,0,9999,0
1668091085033,ECE 200,021,103606,Lin; Bill,9999,0,9999,0
1668091085033,ECE 200,022,103607,Liu; Zhaowei,9998,0,9999,1
1668091085033,ECE 200,023,103608,Lo; Yu-Hwa,9999,0,9999,0
1668091085033,ECE 200,024,103609,Lomakin; Vitaliy,9999,0,9999,0
1668091085033,ECE 200,025,103610,Mercier; Patrick Philip,9999,0,9999,0
1668091085033,ECE 200,026,103611,Meyer; Florian,9999,0,9999,0
1668091085033,ECE 200,027,103612,Milstein; Laurence B.,9999,0,9999,0
1668091085033,ECE 200,028,103613,Mir Arabbaygi; Siavash,9999,0,9999,0
1668091085033,ECE 200,029,103614,Mookherjea; Shayan,9999,0,9999,0
1668091085033,ECE 200,030,103615,Morris; Karcher William,9999,0,9999,0
1668091085033,ECE 200,031,103616,Ng; Tse Nga,9999,0,9999,0
1668091085033,ECE 200,032,103617,Nguyen; Truong Quang,9999,0,9999,0
1668091085033,ECE 200,033,103618,Nomura; Kenji,9999,0,9999,0
1668091085033,ECE 200,034,103619,Orlitsky; Alon,9999,0,9999,0
1668091085033,ECE 200,035,103620,Pal; Piya,9999,0,9999,0
1668091085033,ECE 200,036,103621,Papen; George C.,9999,0,9999,0
1668091085033,ECE 200,037,103622,Radic; Stojan,9999,0,9999,0
1668091085033,ECE 200,038,103623,Rao; Bhaskar D.,9999,0,9999,0
1668091085033,ECE 200,039,103624,Rao; Ramesh R,9999,0,9999,0
1668091085033,ECE 200,040,103625,Rebeiz; Gabriel,9999,0,9999,0
1668091085033,ECE 200,041,103626,Sanford; John R,9999,0,9999,0
1668091085033,ECE 200,042,103627,Siegel; Paul H.,9999,0,9999,0
1668091085033,ECE 200,043,103628,Sievenpiper; Daniel F.,9999,0,9999,0
1668091085033,ECE 200,044,103629,Sworder; David D.,9999,0,9999,0
1668091085033,ECE 200,045,103630,Taur; Yuan,9999,0,9999,0
1668091085033,ECE 200,046,103631,Touri; Behrouz,9999,0,9999,0
1668091085033,ECE 200,047,103632,Trivedi; Mohan M.,9999,0,9999,0
1668091085033,ECE 200,048,103633,Vasconcelos; Nuno,9999,0,9999,0
1668091085033,ECE 200,049,103634,Wang; Xiaolong,9999,0,9999,0
1668091085033,ECE 200,050,103635,Xie; Pengtao,9999,0,9999,0
1668091085033,ECE 200,051,103636,Yip; Michael,9999,0,9999,0
1668091085033,ECE 200,052,103637,Zeger; Kenneth A.,999,0,999,0
1668091085033,ECE 200,053,103638,Zhang; Xinyu,9999,0,9999,0
1668091085033,ECE 200,054,103639,Turakhia; Yatish Girish,9999,0,9999,0
1668091085033,ECE 200,055,103640,Kang; Mingu,9999,0,9999,0
1668091085033,ECE 200,056,103641,Shi; Yuanyuan,9999,0,9999,0
1668091085033,ECE 200,057,103642,Wang; Edward Jay,9999,0,9999,0
1668091085033,ECE 200,058,103643,Zheng; Yang,9999,0,9999,0
1668091085455,ECE 202,A00,103644,Kuzum; Duygu,0,0,0,0
1668091085883,ECE 212BN,A00,103646,Ng; Tse Nga,0,0,0,0
1668091086307,ECE 221,A00,111493,Staff,0,0,0,0
1668091086732,ECE 222B,A00,103647,Lomakin; Vitaliy,0,0,0,0
1668091087158,ECE 230B,A00,103648,Taur; Yuan,0,0,0,0
1668091087586,ECE 238B,A00,103649,Garay; Javier,0,0,0,0
1668091088017,ECE 240B,A00,112900,Fainman; Yeshaiahu,0,0,0,0
1668091088439,ECE 247A,A00,103650,Jokerst; Jesse Vincent,0,0,0,0
1668091088865,ECE 247B,A00,103651,Wang; Joseph,0,0,0,0
1668091089289,ECE 250,A00,103652,Siegel; Paul H.,0,0,0,0
1668091089713,ECE 251A,A00,103654,Rao; Bhaskar D.,0,0,0,0
1668091090135,ECE 257B,A00,103655,Bharadia; Dinesh,0,0,0,0
1668091090562,ECE 258A,A00,103656,Milstein; Laurence B.,0,0,0,0
1668091090994,ECE 260B,A00,103658,Kang; Mingu,0,0,0,0
1668091091426,ECE 264A,A00,103659,Galton; Ian A,0,0,0,0
1668091091847,ECE 265A,A00,103661,Gudem; Prasad S.S.,0,0,0,0
1668091092271,ECE 265D,A00,103662,Gudem; Prasad S.S.,0,0,0,0
1668091092696,ECE 268,A00,103663,Koushanfar; Farinaz,0,0,0,0
1668091093119,ECE 269,A01,103665,Pal; Piya,0,0,0,0
1668091093544,ECE 271B,A00,103666,Vasconcelos; Manuela,0,0,0,0
1668091093967,ECE 276A,A00,103667,Atanasov; Nikolay A.,0,0,0,0
1668091094392,ECE 277,A00,103668,An; Cheolhong,0,0,0,0
1668091094816,ECE 279,A00,117947,Hall; Drew A.,0,0,0,0
1668091095664,ECE 283,A00,103670,Hsueh; Tzu-Chien,0,0,0,0
1668091096090,ECE 284,A00,103671,Turakhia; Yatish Girish,0,0,0,0
1668091096516,ECE 285,A00,103672,Zheng; Yang,0,0,0,0
1668091096516,ECE 285,B00,103673,Sworder; David D.,0,0,0,0
1668091096939,ECE 287,A00,103676,Javidi; Tara,0,0,0,0
1668091097362,MATH 200B,A00,098023,Salehi Golsefidy; Alireza,13,0,15,2
1668091097787,MATH 202B,A00,098024,Rhoades; Brendon Patrick,9,0,15,6
1668091098209,MATH 203B,A00,098025,Oprea; Dragos N.,10,0,15,5
1668091098633,MATH 204B,A00,098026,Sorensen; Claus M,13,0,15,2
1668091099055,MATH 208,A00,098027,Izadi; Elham,7,0,10,3
1668091099479,MATH 209,A00,098028,Pollack; Aaron,10,0,10,0
1668091099901,MATH 211A,A00,112919,Rogalski; Daniel,9,0,10,1
1668091100323,MATH 211B,A00,112920,Seward; Brandon M.,9,0,10,1
1668091100746,MATH 218,A00,098029,Li; Bo,10,0,10,0
1668091101168,MATH 220B,A00,098030,Novak; Jonathan I,12,0,15,3
1668091101592,MATH 221A,A00,098031,Ebenfelt; Peter F,13,0,15,2
1668091102019,MATH 231B,A00,098032,Zlatos; Andrej,12,0,15,3
1668091102446,MATH 240B,A00,098033,Ni; Lei,9,0,15,6
1668091102869,MATH 243,A00,098034,Jekel; David Andrew,10,0,10,0
1668091103294,MATH 245A,A00,098035,Nie; Jiawang,0,0,15,16
1668091103803,MATH 248,A00,098036,Bejenaru; Ioan,10,0,10,0
1668091104227,MATH 250B,A00,098037,Spolaor; Luca,14,0,15,1
1668091104663,MATH 258,A00,098038,Ni; Lei,10,0,10,0
1668091105090,MATH 264B,A00,098041,Rhoades; Brendon Patrick,10,0,15,5
1668091105512,MATH 268,A00,098042,Buss; Samuel R,10,0,10,0
1668091105936,MATH 269,A00,098043,Rhoades; Brendon Patrick,10,0,10,0
1668091106365,MATH 270B,A00,098044,Li; Bo,11,0,15,4
1668091106793,MATH 272B,A00,098045,Holst; Michael J,13,0,15,2
1668091107216,MATH 273A,A00,098046,Tian; Xiaochuan,10,0,15,5
1668091107638,MATH 275,A01,098048,Tian; Xiaochuan,6,0,10,4
1668091108063,MATH 278A,A00,098049,Holst; Michael J,8,0,10,2
1668091108485,MATH 278B,A00,098050,Cloninger; Alexander,10,0,10,0
1668091108911,MATH 278C,A00,098051,Nie; Jiawang,7,0,10,3
1668091109353,MATH 280B,A00,098052,Zheng; Tianyi,10,0,15,5
1668091109781,MATH 281B,A00,098053,Bradic; Jelena,3,0,15,12
1668091110204,MATH 282B,A00,098054,Arias-Castro; Ery,0,0,15,15
1668091110631,MATH 285,A00,098055,Fitzsimmons; Patrick J,0,0,15,17
1668091111054,MATH 287B,A00,098056,Arias-Castro; Ery,3,0,15,12
1668091111478,MATH 288,A00,098057,Agarwal; Pooja,9,0,10,1
1668091111478,MATH 288,B00,098058,Zhang; Danna,8,0,10,2
1668091111478,MATH 288,C00,098059,Williams; Ruth J,10,0,10,0
1668091111902,MATH 290B,A00,098060,Roberts; Justin Deritter,13,0,15,2
1668091112325,MATH 292,A00,098061,Belmont; Eva Kinoshita,10,0,10,0
1668091112748,MATH 295,A00,098062,Suk; Andrew Hoon,48,0,50,2
1668091113176,MATH 296,A00,098063,Novak; Jonathan I,20,0,20,0
1668091113614,MATH 297,001,098064,Gamst; Anthony Collins,9997,0,9999,2
1668091613981,COGS 205,A00,101395,Chiba; Andrea,19,0,20,1
1668091614406,COGS 210B,001,101404,Greene; Deanna Jacquelyn,9998,0,9999,1
1668091614406,COGS 210B,002,101417,Xia; Haijun,9999,0,9999,0
1668091614406,COGS 210B,003,101422,Nitz; Douglas A.,9999,0,9999,0
1668091614406,COGS 210B,004,101423,Hollan; James D.,9998,0,9999,1
1668091614406,COGS 210B,005,101424,Deak; Gedeon O.,9998,0,9999,1
1668091614406,COGS 210B,006,101425,Rossano; Federico,9999,0,9999,0
1668091614832,COGS 211B,A00,101427,Coulson; Seana M,9996,0,9999,3
1668091615267,COGS 220,A00,101428,Hollan; James D.,0,0,25,25
1668091615702,COGS 229,A00,101429,Dow; Steven P,18,0,25,7
1668091616133,COGS 230,A00,101430,Klemmer; Scott R,13,0,17,4
1668091616563,COGS 234,A00,101431,Xia; Haijun,3,0,25,22
1668091616990,COGS 260,A00,101432,Kiyonaga; Anastasia,19,0,25,6
1668091616990,COGS 260,B00,101433,Kirsh; David Joel,16,0,25,9
1668091617414,CSE 202,A00,102371,Impagliazzo; Russell,0,0,0,0
1668091617854,CSE 203B,A01,102373,Cheng; Chung Kuan,0,0,0,0
1668091618278,CSE 208,A00,102374,Micciancio; Daniele,0,0,0,0
1668091618701,CSE 209A,A00,112895,Impagliazzo; Russell,0,0,15,15
1668091619132,CSE 209B,A00,108005,Bellare; Mihir,0,0,0,0
1668091619557,CSE 210,A00,113163,Coblenz; Michael J,0,0,0,0
1668091619986,CSE 219,A00,106111,Dow; Steven P,0,0,20,20
1668091620417,CSE 221,A00,102376,Voelker; Geoffrey M.,0,0,0,0
1668091620847,CSE 224,A01,102378,Porter; George M,0,0,0,0
1668091621272,CSE 229A,A00,102379,Savage; Stefan,0,0,0,0
1668091621696,CSE 229C,A00,102380,Munyaka; Imani N. S.,0,0,0,0
1668091622120,CSE 232B,A00,102382,Deutsch; Alin Bernard,0,0,0,0
1668091622547,CSE 234,A01,112904,Kumar; Arun Kumar,0,0,0,0
1668091622970,CSE 237A,A00,102383,Rosing; Tajana Simunic,0,0,0,0
1668091623399,CSE 239A,A00,102384,Deutsch; Alin Bernard,0,0,0,0
1668091623822,CSE 239B,A00,102385,Polikarpova; Nadezhda,0,0,0,0
1668091624321,CSE 240A,A00,102386,Pannuto; Patrick William,0,0,0,0
1668091624747,CSE 240B,A00,102387,Zhao; Jishen,0,0,0,0
1668091625169,CSE 241A,A00,106406,Kang; Mingu,0,0,0,0
1668091625591,CSE 249B,A00,102388,Kahng; Andrew Byun,0,0,8,8
1668091626019,CSE 251B,A01,102392,Cottrell; Garrison W,0,0,0,0
1668091626019,CSE 251B,A02,102393,Cottrell; Garrison W,0,0,0,0
1668091626456,CSE 252B,A00,102394,Ochoa; Benjamin Lawrence,0,0,0,0
1668091626880,CSE 257,A01,102396,Gao; Sicun,0,0,0,0
1668091627309,CSE 272,A00,102397,Li; Tzumao,0,0,0,0
1668091627738,CSE 274,A00,111323,Chern; Albert Ren-Haur,0,0,0,0
1668091628169,CSE 282,A00,102398,Pevzner; Pavel Arkadjevich,0,0,0,0
1668091628597,CSE 284,A00,114175,Gymrek; Melissa Ann,0,0,0,0
1668091629020,CSE 290,A00,102399,Chandraker; Manmohan Krishna,0,0,0,0
1668091629020,CSE 290,B00,102400,Vaccaro; Kristen Marie,0,0,25,25
1668091629020,CSE 290,C00,102414,Pannuto; Patrick William,0,0,25,25
1668091629020,CSE 290,D00,102427,Pevzner; Pavel Arkadjevich,0,0,0,0
1668091629020,CSE 290,E00,102429,Zhao; Jishen,0,0,0,0
1668091629020,CSE 290,F00,102436,Tullsen; Dean Michael,0,0,0,0
1668091629020,CSE 290,G00,102440,Christensen; Henrik I,0,0,20,20
1668091629450,CSE 291,A00,102443,Su; Hao,0,0,0,0
1668091629450,CSE 291,B00,102448,Polikarpova; Nadezhda,0,0,0,0
1668091629450,CSE 291,C00,102453,Vaccaro; Kristen Marie,0,0,0,0
1668091629450,CSE 291,D00,111343,Savage; Stefan,0,0,0,0
1668091629450,CSE 291,E00,116474,Claffy; Kimberly Claire,0,0,0,0
1668091629450,CSE 291,F00,116479,Pasquale; Joseph,0,0,0,0
1668091629882,CSE 293,001,119111,Bafna; Vineet,9999,0,9999,0
1668091629882,CSE 293,002,119118,Bellare; Mihir,9999,0,9999,0
1668091629882,CSE 293,003,119122,Berg-Kirkpatrick; Taylor D,9999,0,9999,0
1668091629882,CSE 293,004,119135,Christensen; Henrik I,9999,0,9999,0
1668091629882,CSE 293,005,119142,Cottrell; Garrison W,9999,0,9999,0
1668091629882,CSE 293,006,119146,Deutsch; Alin Bernard,9999,0,9999,0
1668091629882,CSE 293,007,119159,Esmaeilzadeh; Hadi,9999,0,9999,0
1668091629882,CSE 293,008,119166,Freund; Yoav,9999,0,9999,0
1668091629882,CSE 293,009,119170,Griswold; William G.,9999,0,9999,0
1668091629882,CSE 293,010,119183,Gymrek; Melissa Ann,9999,0,9999,0
1668091629882,CSE 293,011,119190,Heninger; Nadia A,9999,0,9999,0
1668091629882,CSE 293,012,119230,Impagliazzo; Russell,9999,0,9999,0
1668091629882,CSE 293,013,119232,Jhala; Ranjit,9999,0,9999,0
1668091629882,CSE 293,014,119233,Kahng; Andrew Byun,9999,0,9999,0
1668091629882,CSE 293,015,119298,Kane; Daniel Mertz,9999,0,9999,0
1668091629882,CSE 293,016,119299,Kriegman; David J,9999,0,9999,0
1668091629882,CSE 293,017,119300,Kumar; Arun Kumar,9999,0,9999,0
1668091629882,CSE 293,018,119301,Lerner; Sorin,9999,0,9999,0
1668091629882,CSE 293,019,119302,Lovett; Shachar,9999,0,9999,0
1668091629882,CSE 293,020,119303,McAuley; Julian John,9999,0,9999,0
1668091629882,CSE 293,021,119304,Micciancio; Daniele,9999,0,9999,0
1668091629882,CSE 293,022,119367,Orailoglu; Alex,9999,0,9999,0
1668091629882,CSE 293,023,119382,Paturi; Ramamohan,9999,0,9999,0
1668091629882,CSE 293,024,119404,Polikarpova; Nadezhda,9999,0,9999,0
1668091629882,CSE 293,025,119406,Politz; Joseph Gibbs,9999,0,9999,0
1668091629882,CSE 293,026,119411,Porter; George M,9999,0,9999,0
1668091629882,CSE 293,027,119414,Porter; Leonard Emerson,9999,0,9999,0
1668091629882,CSE 293,028,119416,Ramamoorthi; Ravi,9999,0,9999,0
1668091629882,CSE 293,029,119417,Sahoo; Debashis,9999,0,9999,0
1668091629882,CSE 293,030,119420,Saul; Lawrence,9999,0,9999,0
1668091629882,CSE 293,031,119421,Savage; Stefan,9999,0,9999,0
1668091629882,CSE 293,032,119425,Schulze; Jurgen P.,9999,0,9999,0
1668091629882,CSE 293,033,119426,Snoeren; Alex C.,9999,0,9999,0
1668091629882,CSE 293,034,119428,Shang; Jingbo,9999,0,9999,0
1668091629882,CSE 293,035,119430,Stefan; Deian,9999,0,9999,0
1668091629882,CSE 293,036,119431,Su; Hao,9999,0,9999,0
1668091629882,CSE 293,037,119433,Swanson; Steven James,9999,0,9999,0
1668091629882,CSE 293,038,119435,Tullsen; Dean Michael,9999,0,9999,0
1668091629882,CSE 293,039,119483,Voelker; Geoffrey M.,9999,0,9999,0
1668091629882,CSE 293,040,119537,Zhao; Jishen,9999,0,9999,0
1668091629882,CSE 293,041,119538,Zhou; Yuan-Yuan,9999,0,9999,0
1668091629882,CSE 293,042,119539,Gao; Sicun,9999,0,9999,0
1668091629882,CSE 293,043,119540,Weibel; Nadir,9999,0,9999,0
1668091629882,CSE 293,044,119541,Gupta; Rajesh K.,9999,0,9999,0
1668091629882,CSE 293,045,126410,Vaccaro; Kristen Marie,9999,0,9999,0
1668091629882,CSE 293,046,126411,Klemke; Richard,9999,0,9999,0
1668091630306,CSE 294,A00,102459,Voelker; Geoffrey M.,0,0,0,0
1668091630306,CSE 294,B00,111322,Orailoglu; Alex,0,0,0,0
1668091630728,DSE 201,A00,096914,Deutsch; Alin Bernard,30,0,30,0
1668091631153,DSE 210,A00,096915,Dasgupta; Sanjoy,30,0,30,0
1668091631580,DSE 260A,A00,096916,Altintas De Callaf; Ilkay,30,0,30,0
1668091632010,ECE 200,001,103586,Antipa; Nicholas A,9999,0,9999,0
1668091632010,ECE 200,002,103587,Atanasov; Nikolay A.,9999,0,9999,0
1668091632010,ECE 200,003,103588,Bharadia; Dinesh,9999,0,9999,0
1668091632010,ECE 200,004,103589,Cheng; Chung Kuan,9999,0,9999,0
1668091632010,ECE 200,005,103590,Cosman; Pamela C.,9999,0,9999,0
1668091632010,ECE 200,006,103591,Dayeh; Shadi Ahmad,9999,0,9999,0
1668091632010,ECE 200,007,103592,Fainman; Yeshaiahu,9999,0,9999,0
1668091632010,ECE 200,008,103593,Ford; Joseph Earl,9999,0,9999,0
1668091632010,ECE 200,009,103594,Franceschetti; Massimo,9999,0,9999,0
1668091632010,ECE 200,010,103595,Fullerton; Eric E,9999,0,9999,0
1668091632010,ECE 200,011,103596,Galton; Ian A,9999,0,9999,0
1668091632010,ECE 200,012,103597,Gilja; Vikash,9999,0,9999,0
1668091632010,ECE 200,013,103598,Hall; Drew A.,9999,0,9999,0
1668091632010,ECE 200,014,103599,Hsueh; Tzu-Chien,9999,0,9999,0
1668091632010,ECE 200,015,103600,Javidi; Tara,9999,0,9999,0
1668091632010,ECE 200,016,103601,Kahng; Andrew Byun,9999,0,9999,0
1668091632010,ECE 200,017,103602,Kim; Young-Han,9999,0,9999,0
1668091632010,ECE 200,018,103603,Koushanfar; Farinaz,9999,0,9999,0
1668091632010,ECE 200,019,103604,Kuzum; Duygu,9999,0,9999,0
1668091632010,ECE 200,020,103605,Le; Hanh-Phuc,9999,0,9999,0
1668091632010,ECE 200,021,103606,Lin; Bill,9999,0,9999,0
1668091632010,ECE 200,022,103607,Liu; Zhaowei,9998,0,9999,1
1668091632010,ECE 200,023,103608,Lo; Yu-Hwa,9999,0,9999,0
1668091632010,ECE 200,024,103609,Lomakin; Vitaliy,9999,0,9999,0
1668091632010,ECE 200,025,103610,Mercier; Patrick Philip,9999,0,9999,0
1668091632010,ECE 200,026,103611,Meyer; Florian,9999,0,9999,0
1668091632010,ECE 200,027,103612,Milstein; Laurence B.,9999,0,9999,0
1668091632010,ECE 200,028,103613,Mir Arabbaygi; Siavash,9999,0,9999,0
1668091632010,ECE 200,029,103614,Mookherjea; Shayan,9999,0,9999,0
1668091632010,ECE 200,030,103615,Morris; Karcher William,9999,0,9999,0
1668091632010,ECE 200,031,103616,Ng; Tse Nga,9999,0,9999,0
1668091632010,ECE 200,032,103617,Nguyen; Truong Quang,9999,0,9999,0
1668091632010,ECE 200,033,103618,Nomura; Kenji,9999,0,9999,0
1668091632010,ECE 200,034,103619,Orlitsky; Alon,9999,0,9999,0
1668091632010,ECE 200,035,103620,Pal; Piya,9999,0,9999,0
1668091632010,ECE 200,036,103621,Papen; George C.,9999,0,9999,0
1668091632010,ECE 200,037,103622,Radic; Stojan,9999,0,9999,0
1668091632010,ECE 200,038,103623,Rao; Bhaskar D.,9999,0,9999,0
1668091632010,ECE 200,039,103624,Rao; Ramesh R,9999,0,9999,0
1668091632010,ECE 200,040,103625,Rebeiz; Gabriel,9999,0,9999,0
1668091632010,ECE 200,041,103626,Sanford; John R,9999,0,9999,0
1668091632010,ECE 200,042,103627,Siegel; Paul H.,9999,0,9999,0
1668091632010,ECE 200,043,103628,Sievenpiper; Daniel F.,9999,0,9999,0
1668091632010,ECE 200,044,103629,Sworder; David D.,9999,0,9999,0
1668091632010,ECE 200,045,103630,Taur; Yuan,9999,0,9999,0
1668091632010,ECE 200,046,103631,Touri; Behrouz,9999,0,9999,0
1668091632010,ECE 200,047,103632,Trivedi; Mohan M.,9999,0,9999,0
1668091632010,ECE 200,048,103633,Vasconcelos; Nuno,9999,0,9999,0
1668091632010,ECE 200,049,103634,Wang; Xiaolong,9999,0,9999,0
1668091632010,ECE 200,050,103635,Xie; Pengtao,9999,0,9999,0
1668091632010,ECE 200,051,103636,Yip; Michael,9999,0,9999,0
1668091632010,ECE 200,052,103637,Zeger; Kenneth A.,999,0,999,0
1668091632010,ECE 200,053,103638,Zhang; Xinyu,9999,0,9999,0
1668091632010,ECE 200,054,103639,Turakhia; Yatish Girish,9999,0,9999,0
1668091632010,ECE 200,055,103640,Kang; Mingu,9999,0,9999,0
1668091632010,ECE 200,056,103641,Shi; Yuanyuan,9999,0,9999,0
1668091632010,ECE 200,057,103642,Wang; Edward Jay,9999,0,9999,0
1668091632010,ECE 200,058,103643,Zheng; Yang,9999,0,9999,0
1668091632438,ECE 202,A00,103644,Kuzum; Duygu,0,0,0,0
1668091632861,ECE 212BN,A00,103646,Ng; Tse Nga,0,0,0,0
1668091633283,ECE 221,A00,111493,Staff,0,0,0,0
1668091633710,ECE 222B,A00,103647,Lomakin; Vitaliy,0,0,0,0
1668091634146,ECE 230B,A00,103648,Taur; Yuan,0,0,0,0
1668091634580,ECE 238B,A00,103649,Garay; Javier,0,0,0,0
1668091635017,ECE 240B,A00,112900,Fainman; Yeshaiahu,0,0,0,0
1668091635443,ECE 247A,A00,103650,Jokerst; Jesse Vincent,0,0,0,0
1668091635865,ECE 247B,A00,103651,Wang; Joseph,0,0,0,0
1668091636289,ECE 250,A00,103652,Siegel; Paul H.,0,0,0,0
1668091636722,ECE 251A,A00,103654,Rao; Bhaskar D.,0,0,0,0
1668091637145,ECE 257B,A00,103655,Bharadia; Dinesh,0,0,0,0
1668091637567,ECE 258A,A00,103656,Milstein; Laurence B.,0,0,0,0
1668091637994,ECE 260B,A00,103658,Kang; Mingu,0,0,0,0
1668091638419,ECE 264A,A00,103659,Galton; Ian A,0,0,0,0
1668091638842,ECE 265A,A00,103661,Gudem; Prasad S.S.,0,0,0,0
1668091639265,ECE 265D,A00,103662,Gudem; Prasad S.S.,0,0,0,0
1668091639688,ECE 268,A00,103663,Koushanfar; Farinaz,0,0,0,0
1668091640114,ECE 269,A01,103665,Pal; Piya,0,0,0,0
1668091640539,ECE 271B,A00,103666,Vasconcelos; Manuela,0,0,0,0
1668091640962,ECE 276A,A00,103667,Atanasov; Nikolay A.,0,0,0,0
1668091641393,ECE 277,A00,103668,An; Cheolhong,0,0,0,0
1668091641819,ECE 279,A00,117947,Hall; Drew A.,0,0,0,0
1668091642673,ECE 283,A00,103670,Hsueh; Tzu-Chien,0,0,0,0
1668091643098,ECE 284,A00,103671,Turakhia; Yatish Girish,0,0,0,0
1668091643520,ECE 285,A00,103672,Zheng; Yang,0,0,0,0
1668091643520,ECE 285,B00,103673,Sworder; David D.,0,0,0,0
1668091643942,ECE 287,A00,103676,Javidi; Tara,0,0,0,0
1668091644368,MATH 200B,A00,098023,Salehi Golsefidy; Alireza,13,0,15,2
1668091644792,MATH 202B,A00,098024,Rhoades; Brendon Patrick,9,0,15,6
1668091645220,MATH 203B,A00,098025,Oprea; Dragos N.,10,0,15,5
1668091645646,MATH 204B,A00,098026,Sorensen; Claus M,13,0,15,2
1668091646072,MATH 208,A00,098027,Izadi; Elham,7,0,10,3
1668091646494,MATH 209,A00,098028,Pollack; Aaron,10,0,10,0
1668091646919,MATH 211A,A00,112919,Rogalski; Daniel,9,0,10,1
1668091647343,MATH 211B,A00,112920,Seward; Brandon M.,9,0,10,1
1668091647769,MATH 218,A00,098029,Li; Bo,10,0,10,0
1668091648192,MATH 220B,A00,098030,Novak; Jonathan I,12,0,15,3
1668091648615,MATH 221A,A00,098031,Ebenfelt; Peter F,13,0,15,2
1668091649038,MATH 231B,A00,098032,Zlatos; Andrej,12,0,15,3
1668091649465,MATH 240B,A00,098033,Ni; Lei,9,0,15,6
1668091649889,MATH 243,A00,098034,Jekel; David Andrew,10,0,10,0
1668091650313,MATH 245A,A00,098035,Nie; Jiawang,0,0,15,16
1668091650739,MATH 248,A00,098036,Bejenaru; Ioan,10,0,10,0
1668091651161,MATH 250B,A00,098037,Spolaor; Luca,14,0,15,1
1668091651586,MATH 258,A00,098038,Ni; Lei,10,0,10,0
1668091652010,MATH 264B,A00,098041,Rhoades; Brendon Patrick,10,0,15,5
1668091652434,MATH 268,A00,098042,Buss; Samuel R,10,0,10,0
1668091652866,MATH 269,A00,098043,Rhoades; Brendon Patrick,10,0,10,0
1668091653290,MATH 270B,A00,098044,Li; Bo,11,0,15,4
1668091653726,MATH 272B,A00,098045,Holst; Michael J,13,0,15,2
1668091654165,MATH 273A,A00,098046,Tian; Xiaochuan,10,0,15,5
1668091654588,MATH 275,A01,098048,Tian; Xiaochuan,6,0,10,4
1668091655011,MATH 278A,A00,098049,Holst; Michael J,8,0,10,2
1668091655433,MATH 278B,A00,098050,Cloninger; Alexander,10,0,10,0
1668091655860,MATH 278C,A00,098051,Nie; Jiawang,7,0,10,3
1668091656281,MATH 280B,A00,098052,Zheng; Tianyi,10,0,15,5
1668091656708,MATH 281B,A00,098053,Bradic; Jelena,3,0,15,12
1668091657136,MATH 282B,A00,098054,Arias-Castro; Ery,0,0,15,15
1668091657563,MATH 285,A00,098055,Fitzsimmons; Patrick J,0,0,15,17
1668091657985,MATH 287B,A00,098056,Arias-Castro; Ery,3,0,15,12
1668091658411,MATH 288,A00,098057,Agarwal; Pooja,9,0,10,1
1668091658411,MATH 288,B00,098058,Zhang; Danna,8,0,10,2
1668091658411,MATH 288,C00,098059,Williams; Ruth J,10,0,10,0
1668091658834,MATH 290B,A00,098060,Roberts; Justin Deritter,13,0,15,2
1668091659266,MATH 292,A00,098061,Belmont; Eva Kinoshita,10,0,10,0
1668091659689,MATH 295,A00,098062,Suk; Andrew Hoon,48,0,50,2
1668091660113,MATH 296,A00,098063,Novak; Jonathan I,20,0,20,0
1668091660534,MATH 297,001,098064,Gamst; Anthony Collins,9997,0,9999,2
1668092160734,COGS 205,A00,101395,Chiba; Andrea,19,0,20,1
1668092161160,COGS 210B,001,101404,Greene; Deanna Jacquelyn,9998,0,9999,1
1668092161160,COGS 210B,002,101417,Xia; Haijun,9999,0,9999,0
1668092161160,COGS 210B,003,101422,Nitz; Douglas A.,9999,0,9999,0
1668092161160,COGS 210B,004,101423,Hollan; James D.,9998,0,9999,1
1668092161160,COGS 210B,005,101424,Deak; Gedeon O.,9998,0,9999,1
1668092161160,COGS 210B,006,101425,Rossano; Federico,9999,0,9999,0
1668092161586,COGS 211B,A00,101427,Coulson; Seana M,9996,0,9999,3
1668092162013,COGS 220,A00,101428,Hollan; James D.,0,0,25,25
1668092162450,COGS 229,A00,101429,Dow; Steven P,18,0,25,7
1668092162875,COGS 230,A00,101430,Klemmer; Scott R,13,0,17,4
1668092163302,COGS 234,A00,101431,Xia; Haijun,3,0,25,22
1668092163729,COGS 260,A00,101432,Kiyonaga; Anastasia,19,0,25,6
1668092163729,COGS 260,B00,101433,Kirsh; David Joel,16,0,25,9
1668092164155,CSE 202,A00,102371,Impagliazzo; Russell,0,0,0,0
1668092164582,CSE 203B,A01,102373,Cheng; Chung Kuan,0,0,0,0
1668092165009,CSE 208,A00,102374,Micciancio; Daniele,0,0,0,0
1668092165435,CSE 209A,A00,112895,Impagliazzo; Russell,0,0,15,15
1668092165857,CSE 209B,A00,108005,Bellare; Mihir,0,0,0,0
1668092166280,CSE 210,A00,113163,Coblenz; Michael J,0,0,0,0
1668092166707,CSE 219,A00,106111,Dow; Steven P,0,0,20,20
1668092167133,CSE 221,A00,102376,Voelker; Geoffrey M.,0,0,0,0
1668092167559,CSE 224,A01,102378,Porter; George M,0,0,0,0
1668092167982,CSE 229A,A00,102379,Savage; Stefan,0,0,0,0
1668092168404,CSE 229C,A00,102380,Munyaka; Imani N. S.,0,0,0,0
1668092168848,CSE 232B,A00,102382,Deutsch; Alin Bernard,0,0,0,0
1668092169274,CSE 234,A01,112904,Kumar; Arun Kumar,0,0,0,0
1668092169707,CSE 237A,A00,102383,Rosing; Tajana Simunic,0,0,0,0
1668092170144,CSE 239A,A00,102384,Deutsch; Alin Bernard,0,0,0,0
1668092170570,CSE 239B,A00,102385,Polikarpova; Nadezhda,0,0,0,0
1668092170993,CSE 240A,A00,102386,Pannuto; Patrick William,0,0,0,0
1668092171419,CSE 240B,A00,102387,Zhao; Jishen,0,0,0,0
1668092171846,CSE 241A,A00,106406,Kang; Mingu,0,0,0,0
1668092172269,CSE 249B,A00,102388,Kahng; Andrew Byun,0,0,8,8
1668092172692,CSE 251B,A01,102392,Cottrell; Garrison W,0,0,0,0
1668092172692,CSE 251B,A02,102393,Cottrell; Garrison W,0,0,0,0
1668092173118,CSE 252B,A00,102394,Ochoa; Benjamin Lawrence,0,0,0,0
1668092173543,CSE 257,A01,102396,Gao; Sicun,0,0,0,0
1668092173977,CSE 272,A00,102397,Li; Tzumao,0,0,0,0
1668092174399,CSE 274,A00,111323,Chern; Albert Ren-Haur,0,0,0,0
1668092174826,CSE 282,A00,102398,Pevzner; Pavel Arkadjevich,0,0,0,0
1668092175249,CSE 284,A00,114175,Gymrek; Melissa Ann,0,0,0,0
1668092175672,CSE 290,A00,102399,Chandraker; Manmohan Krishna,0,0,0,0
1668092175672,CSE 290,B00,102400,Vaccaro; Kristen Marie,0,0,25,25
1668092175672,CSE 290,C00,102414,Pannuto; Patrick William,0,0,25,25
1668092175672,CSE 290,D00,102427,Pevzner; Pavel Arkadjevich,0,0,0,0
1668092175672,CSE 290,E00,102429,Zhao; Jishen,0,0,0,0
1668092175672,CSE 290,F00,102436,Tullsen; Dean Michael,0,0,0,0
1668092175672,CSE 290,G00,102440,Christensen; Henrik I,0,0,20,20
1668092176098,CSE 291,A00,102443,Su; Hao,0,0,0,0
1668092176098,CSE 291,B00,102448,Polikarpova; Nadezhda,0,0,0,0
1668092176098,CSE 291,C00,102453,Vaccaro; Kristen Marie,0,0,0,0
1668092176098,CSE 291,D00,111343,Savage; Stefan,0,0,0,0
1668092176098,CSE 291,E00,116474,Claffy; Kimberly Claire,0,0,0,0
1668092176098,CSE 291,F00,116479,Pasquale; Joseph,0,0,0,0
1668092176536,CSE 293,001,119111,Bafna; Vineet,9999,0,9999,0
1668092176536,CSE 293,002,119118,Bellare; Mihir,9999,0,9999,0
1668092176536,CSE 293,003,119122,Berg-Kirkpatrick; Taylor D,9999,0,9999,0
1668092176536,CSE 293,004,119135,Christensen; Henrik I,9999,0,9999,0
1668092176536,CSE 293,005,119142,Cottrell; Garrison W,9999,0,9999,0
1668092176536,CSE 293,006,119146,Deutsch; Alin Bernard,9999,0,9999,0
1668092176536,CSE 293,007,119159,Esmaeilzadeh; Hadi,9999,0,9999,0
1668092176536,CSE 293,008,119166,Freund; Yoav,9999,0,9999,0
1668092176536,CSE 293,009,119170,Griswold; William G.,9999,0,9999,0
1668092176536,CSE 293,010,119183,Gymrek; Melissa Ann,9999,0,9999,0
1668092176536,CSE 293,011,119190,Heninger; Nadia A,9999,0,9999,0
1668092176536,CSE 293,012,119230,Impagliazzo; Russell,9999,0,9999,0
1668092176536,CSE 293,013,119232,Jhala; Ranjit,9999,0,9999,0
1668092176536,CSE 293,014,119233,Kahng; Andrew Byun,9999,0,9999,0
1668092176536,CSE 293,015,119298,Kane; Daniel Mertz,9999,0,9999,0
1668092176536,CSE 293,016,119299,Kriegman; David J,9999,0,9999,0
1668092176536,CSE 293,017,119300,Kumar; Arun Kumar,9999,0,9999,0
1668092176536,CSE 293,018,119301,Lerner; Sorin,9999,0,9999,0
1668092176536,CSE 293,019,119302,Lovett; Shachar,9999,0,9999,0
1668092176536,CSE 293,020,119303,McAuley; Julian John,9999,0,9999,0
1668092176536,CSE 293,021,119304,Micciancio; Daniele,9999,0,9999,0
1668092176536,CSE 293,022,119367,Orailoglu; Alex,9999,0,9999,0
1668092176536,CSE 293,023,119382,Paturi; Ramamohan,9999,0,9999,0
1668092176536,CSE 293,024,119404,Polikarpova; Nadezhda,9999,0,9999,0
1668092176536,CSE 293,025,119406,Politz; Joseph Gibbs,9999,0,9999,0
1668092176536,CSE 293,026,119411,Porter; George M,9999,0,9999,0
1668092176536,CSE 293,027,119414,Porter; Leonard Emerson,9999,0,9999,0
1668092176536,CSE 293,028,119416,Ramamoorthi; Ravi,9999,0,9999,0
1668092176536,CSE 293,029,119417,Sahoo; Debashis,9999,0,9999,0
1668092176536,CSE 293,030,119420,Saul; Lawrence,9999,0,9999,0
1668092176536,CSE 293,031,119421,Savage; Stefan,9999,0,9999,0
1668092176536,CSE 293,032,119425,Schulze; Jurgen P.,9999,0,9999,0
1668092176536,CSE 293,033,119426,Snoeren; Alex C.,9999,0,9999,0
1668092176536,CSE 293,034,119428,Shang; Jingbo,9999,0,9999,0
1668092176536,CSE 293,035,119430,Stefan; Deian,9999,0,9999,0
1668092176536,CSE 293,036,119431,Su; Hao,9999,0,9999,0
1668092176536,CSE 293,037,119433,Swanson; Steven James,9999,0,9999,0
1668092176536,CSE 293,038,119435,Tullsen; Dean Michael,9999,0,9999,0
1668092176536,CSE 293,039,119483,Voelker; Geoffrey M.,9999,0,9999,0
1668092176536,CSE 293,040,119537,Zhao; Jishen,9999,0,9999,0
1668092176536,CSE 293,041,119538,Zhou; Yuan-Yuan,9999,0,9999,0
1668092176536,CSE 293,042,119539,Gao; Sicun,9999,0,9999,0
1668092176536,CSE 293,043,119540,Weibel; Nadir,9999,0,9999,0
1668092176536,CSE 293,044,119541,Gupta; Rajesh K.,9999,0,9999,0
1668092176536,CSE 293,045,126410,Vaccaro; Kristen Marie,9999,0,9999,0
1668092176536,CSE 293,046,126411,Klemke; Richard,9999,0,9999,0
1668092176959,CSE 294,A00,102459,Voelker; Geoffrey M.,0,0,0,0
1668092176959,CSE 294,B00,111322,Orailoglu; Alex,0,0,0,0
1668092177384,DSE 201,A00,096914,Deutsch; Alin Bernard,30,0,30,0
1668092177811,DSE 210,A00,096915,Dasgupta; Sanjoy,30,0,30,0
1668092178251,DSE 260A,A00,096916,Altintas De Callaf; Ilkay,30,0,30,0
1668092178682,ECE 200,001,103586,Antipa; Nicholas A,9999,0,9999,0
1668092178682,ECE 200,002,103587,Atanasov; Nikolay A.,9999,0,9999,0
1668092178682,ECE 200,003,103588,Bharadia; Dinesh,9999,0,9999,0
1668092178682,ECE 200,004,103589,Cheng; Chung Kuan,9999,0,9999,0
1668092178682,ECE 200,005,103590,Cosman; Pamela C.,9999,0,9999,0
1668092178682,ECE 200,006,103591,Dayeh; Shadi Ahmad,9999,0,9999,0
1668092178682,ECE 200,007,103592,Fainman; Yeshaiahu,9999,0,9999,0
1668092178682,ECE 200,008,103593,Ford; Joseph Earl,9999,0,9999,0
1668092178682,ECE 200,009,103594,Franceschetti; Massimo,9999,0,9999,0
1668092178682,ECE 200,010,103595,Fullerton; Eric E,9999,0,9999,0
1668092178682,ECE 200,011,103596,Galton; Ian A,9999,0,9999,0
1668092178682,ECE 200,012,103597,Gilja; Vikash,9999,0,9999,0
1668092178682,ECE 200,013,103598,Hall; Drew A.,9999,0,9999,0
1668092178682,ECE 200,014,103599,Hsueh; Tzu-Chien,9999,0,9999,0
1668092178682,ECE 200,015,103600,Javidi; Tara,9999,0,9999,0
1668092178682,ECE 200,016,103601,Kahng; Andrew Byun,9999,0,9999,0
1668092178682,ECE 200,017,103602,Kim; Young-Han,9999,0,9999,0
1668092178682,ECE 200,018,103603,Koushanfar; Farinaz,9999,0,9999,0
1668092178682,ECE 200,019,103604,Kuzum; Duygu,9999,0,9999,0
1668092178682,ECE 200,020,103605,Le; Hanh-Phuc,9999,0,9999,0
1668092178682,ECE 200,021,103606,Lin; Bill,9999,0,9999,0
1668092178682,ECE 200,022,103607,Liu; Zhaowei,9998,0,9999,1
1668092178682,ECE 200,023,103608,Lo; Yu-Hwa,9999,0,9999,0
1668092178682,ECE 200,024,103609,Lomakin; Vitaliy,9999,0,9999,0
1668092178682,ECE 200,025,103610,Mercier; Patrick Philip,9999,0,9999,0
1668092178682,ECE 200,026,103611,Meyer; Florian,9999,0,9999,0
1668092178682,ECE 200,027,103612,Milstein; Laurence B.,9999,0,9999,0
1668092178682,ECE 200,028,103613,Mir Arabbaygi; Siavash,9999,0,9999,0
1668092178682,ECE 200,029,103614,Mookherjea; Shayan,9999,0,9999,0
1668092178682,ECE 200,030,103615,Morris; Karcher William,9999,0,9999,0
1668092178682,ECE 200,031,103616,Ng; Tse Nga,9999,0,9999,0
1668092178682,ECE 200,032,103617,Nguyen; Truong Quang,9999,0,9999,0
1668092178682,ECE 200,033,103618,Nomura; Kenji,9999,0,9999,0
1668092178682,ECE 200,034,103619,Orlitsky; Alon,9999,0,9999,0
1668092178682,ECE 200,035,103620,Pal; Piya,9999,0,9999,0
1668092178682,ECE 200,036,103621,Papen; George C.,9999,0,9999,0
1668092178682,ECE 200,037,103622,Radic; Stojan,9999,0,9999,0
1668092178682,ECE 200,038,103623,Rao; Bhaskar D.,9999,0,9999,0
1668092178682,ECE 200,039,103624,Rao; Ramesh R,9999,0,9999,0
1668092178682,ECE 200,040,103625,Rebeiz; Gabriel,9999,0,9999,0
1668092178682,ECE 200,041,103626,Sanford; John R,9999,0,9999,0
1668092178682,ECE 200,042,103627,Siegel; Paul H.,9999,0,9999,0
1668092178682,ECE 200,043,103628,Sievenpiper; Daniel F.,9999,0,9999,0
1668092178682,ECE 200,044,103629,Sworder; David D.,9999,0,9999,0
1668092178682,ECE 200,045,103630,Taur; Yuan,9999,0,9999,0
1668092178682,ECE 200,046,103631,Touri; Behrouz,9999,0,9999,0
1668092178682,ECE 200,047,103632,Trivedi; Mohan M.,9999,0,9999,0
1668092178682,ECE 200,048,103633,Vasconcelos; Nuno,9999,0,9999,0
1668092178682,ECE 200,049,103634,Wang; Xiaolong,9999,0,9999,0
1668092178682,ECE 200,050,103635,Xie; Pengtao,9999,0,9999,0
1668092178682,ECE 200,051,103636,Yip; Michael,9999,0,9999,0
1668092178682,ECE 200,052,103637,Zeger; Kenneth A.,999,0,999,0
1668092178682,ECE 200,053,103638,Zhang; Xinyu,9999,0,9999,0
1668092178682,ECE 200,054,103639,Turakhia; Yatish Girish,9999,0,9999,0
1668092178682,ECE 200,055,103640,Kang; Mingu,9999,0,9999,0
1668092178682,ECE 200,056,103641,Shi; Yuanyuan,9999,0,9999,0
1668092178682,ECE 200,057,103642,Wang; Edward Jay,9999,0,9999,0
1668092178682,ECE 200,058,103643,Zheng; Yang,9999,0,9999,0
1668092179107,ECE 202,A00,103644,Kuzum; Duygu,0,0,0,0
1668092179533,ECE 212BN,A00,103646,Ng; Tse Nga,0,0,0,0
1668092179957,ECE 221,A00,111493,Staff,0,0,0,0
1668092180382,ECE 222B,A00,103647,Lomakin; Vitaliy,0,0,0,0
1668092180811,ECE 230B,A00,103648,Taur; Yuan,0,0,0,0
1668092181246,ECE 238B,A00,103649,Garay; Javier,0,0,0,0
1668092181669,ECE 240B,A00,112900,Fainman; Yeshaiahu,0,0,0,0
1668092182094,ECE 247A,A00,103650,Jokerst; Jesse Vincent,0,0,0,0
1668092182519,ECE 247B,A00,103651,Wang; Joseph,0,0,0,0
1668092182950,ECE 250,A00,103652,Siegel; Paul H.,0,0,0,0
1668092183379,ECE 251A,A00,103654,Rao; Bhaskar D.,0,0,0,0
1668092183809,ECE 257B,A00,103655,Bharadia; Dinesh,0,0,0,0
1668092184238,ECE 258A,A00,103656,Milstein; Laurence B.,0,0,0,0
1668092184674,ECE 260B,A00,103658,Kang; Mingu,0,0,0,0
1668092185111,ECE 264A,A00,103659,Galton; Ian A,0,0,0,0
1668092185537,ECE 265A,A00,103661,Gudem; Prasad S.S.,0,0,0,0
1668092185961,ECE 265D,A00,103662,Gudem; Prasad S.S.,0,0,0,0
1668092186385,ECE 268,A00,103663,Koushanfar; Farinaz,0,0,0,0
1668092186809,ECE 269,A01,103665,Pal; Piya,0,0,0,0
1668092187232,ECE 271B,A00,103666,Vasconcelos; Manuela,0,0,0,0
1668092187747,ECE 276A,A00,103667,Atanasov; Nikolay A.,0,0,0,0
1668092188178,ECE 277,A00,103668,An; Cheolhong,0,0,0,0
1668092188604,ECE 279,A00,117947,Hall; Drew A.,0,0,0,0
1668092189453,ECE 283,A00,103670,Hsueh; Tzu-Chien,0,0,0,0
1668092189883,ECE 284,A00,103671,Turakhia; Yatish Girish,0,0,0,0
1668092190311,ECE 285,A00,103672,Zheng; Yang,0,0,0,0
1668092190311,ECE 285,B00,103673,Sworder; David D.,0,0,0,0
1668092190735,ECE 287,A00,103676,Javidi; Tara,0,0,0,0
1668092191158,MATH 200B,A00,098023,Salehi Golsefidy; Alireza,13,0,15,2
1668092191582,MATH 202B,A00,098024,Rhoades; Brendon Patrick,9,0,15,6
1668092192013,MATH 203B,A00,098025,Oprea; Dragos N.,10,0,15,5
1668092192435,MATH 204B,A00,098026,Sorensen; Claus M,13,0,15,2
1668092192866,MATH 208,A00,098027,Izadi; Elham,7,0,10,3
1668092193288,MATH 209,A00,098028,Pollack; Aaron,10,0,10,0
1668092193714,MATH 211A,A00,112919,Rogalski; Daniel,9,0,10,1
1668092194138,MATH 211B,A00,112920,Seward; Brandon M.,9,0,10,1
1668092194573,MATH 218,A00,098029,Li; Bo,10,0,10,0
1668092195000,MATH 220B,A00,098030,Novak; Jonathan I,12,0,15,3
1668092195426,MATH 221A,A00,098031,Ebenfelt; Peter F,13,0,15,2
1668092195850,MATH 231B,A00,098032,Zlatos; Andrej,12,0,15,3
1668092196275,MATH 240B,A00,098033,Ni; Lei,9,0,15,6
1668092196699,MATH 243,A00,098034,Jekel; David Andrew,10,0,10,0
1668092197122,MATH 245A,A00,098035,Nie; Jiawang,0,0,15,16
1668092197546,MATH 248,A00,098036,Bejenaru; Ioan,10,0,10,0
1668092197972,MATH 250B,A00,098037,Spolaor; Luca,14,0,15,1
1668092198400,MATH 258,A00,098038,Ni; Lei,10,0,10,0
1668092198831,MATH 264B,A00,098041,Rhoades; Brendon Patrick,10,0,15,5
1668092199266,MATH 268,A00,098042,Buss; Samuel R,10,0,10,0
1668092199693,MATH 269,A00,098043,Rhoades; Brendon Patrick,10,0,10,0
1668092200117,MATH 270B,A00,098044,Li; Bo,11,0,15,4
1668092200540,MATH 272B,A00,098045,Holst; Michael J,13,0,15,2
1668092200963,MATH 273A,A00,098046,Tian; Xiaochuan,10,0,15,5
1668092201388,MATH 275,A01,098048,Tian; Xiaochuan,6,0,10,4
1668092201813,MATH 278A,A00,098049,Holst; Michael J,8,0,10,2
1668092202239,MATH 278B,A00,098050,Cloninger; Alexander,10,0,10,0
1668092202662,MATH 278C,A00,098051,Nie; Jiawang,7,0,10,3
1668092203086,MATH 280B,A00,098052,Zheng; Tianyi,10,0,15,5
1668092203518,MATH 281B,A00,098053,Bradic; Jelena,3,0,15,12
1668092203949,MATH 282B,A00,098054,Arias-Castro; Ery,0,0,15,15
1668092204371,MATH 285,A00,098055,Fitzsimmons; Patrick J,0,0,15,17
1668092204794,MATH 287B,A00,098056,Arias-Castro; Ery,3,0,15,12
1668092205230,MATH 288,A00,098057,Agarwal; Pooja,9,0,10,1
1668092205230,MATH 288,B00,098058,Zhang; Danna,8,0,10,2
1668092205230,MATH 288,C00,098059,Williams; Ruth J,10,0,10,0
1668092205657,MATH 290B,A00,098060,Roberts; Justin Deritter,13,0,15,2
1668092206083,MATH 292,A00,098061,Belmont; Eva Kinoshita,10,0,10,0
1668092206510,MATH 295,A00,098062,Suk; Andrew Hoon,48,0,50,2
1668092206931,MATH 296,A00,098063,Novak; Jonathan I,20,0,20,0
1668092207359,MATH 297,001,098064,Gamst; Anthony Collins,9997,0,9999,2
1668092714680,COGS 205,A00,101395,Chiba; Andrea,19,0,20,1
1668092715198,COGS 210B,001,101404,Greene; Deanna Jacquelyn,9998,0,9999,1
1668092715198,COGS 210B,002,101417,Xia; Haijun,9999,0,9999,0
1668092715198,COGS 210B,003,101422,Nitz; Douglas A.,9999,0,9999,0
1668092715198,COGS 210B,004,101423,Hollan; James D.,9998,0,9999,1
1668092715198,COGS 210B,005,101424,Deak; Gedeon O.,9998,0,9999,1
1668092715198,COGS 210B,006,101425,Rossano; Federico,9999,0,9999,0
1668092715630,COGS 211B,A00,101427,Coulson; Seana M,9996,0,9999,3
1668092716055,COGS 220,A00,101428,Hollan; James D.,0,0,25,25
1668092716491,COGS 229,A00,101429,Dow; Steven P,18,0,25,7
1668092716913,COGS 230,A00,101430,Klemmer; Scott R,13,0,17,4
1668092717340,COGS 234,A00,101431,Xia; Haijun,3,0,25,22
1668092717794,COGS 260,A00,101432,Kiyonaga; Anastasia,19,0,25,6
1668092717794,COGS 260,B00,101433,Kirsh; David Joel,16,0,25,9
1668092718223,CSE 202,A00,102371,Impagliazzo; Russell,0,0,0,0
1668092718644,CSE 203B,A01,102373,Cheng; Chung Kuan,0,0,0,0
1668092719072,CSE 208,A00,102374,Micciancio; Daniele,0,0,0,0
1668092719500,CSE 209A,A00,112895,Impagliazzo; Russell,0,0,15,15
1668092719941,CSE 209B,A00,108005,Bellare; Mihir,0,0,0,0
1668092720364,CSE 210,A00,113163,Coblenz; Michael J,0,0,0,0
1668092720801,CSE 219,A00,106111,Dow; Steven P,0,0,20,20
1668092721230,CSE 221,A00,102376,Voelker; Geoffrey M.,0,0,0,0
1668092721656,CSE 224,A01,102378,Porter; George M,0,0,0,0
1668092722081,CSE 229A,A00,102379,Savage; Stefan,0,0,0,0
1668092722507,CSE 229C,A00,102380,Munyaka; Imani N. S.,0,0,0,0
1668092722945,CSE 232B,A00,102382,Deutsch; Alin Bernard,0,0,0,0
1668092723370,CSE 234,A01,112904,Kumar; Arun Kumar,0,0,0,0
1668092723801,CSE 237A,A00,102383,Rosing; Tajana Simunic,0,0,0,0
1668092724230,CSE 239A,A00,102384,Deutsch; Alin Bernard,0,0,0,0
1668092724652,CSE 239B,A00,102385,Polikarpova; Nadezhda,0,0,0,0
1668092725080,CSE 240A,A00,102386,Pannuto; Patrick William,0,0,0,0
1668092725516,CSE 240B,A00,102387,Zhao; Jishen,0,0,0,0
1668092725938,CSE 241A,A00,106406,Kang; Mingu,0,0,0,0
1668092726365,CSE 249B,A00,102388,Kahng; Andrew Byun,0,0,8,8
1668092726793,CSE 251B,A01,102392,Cottrell; Garrison W,0,0,0,0
1668092726793,CSE 251B,A02,102393,Cottrell; Garrison W,0,0,0,0
1668092727231,CSE 252B,A00,102394,Ochoa; Benjamin Lawrence,0,0,0,0
1668092727656,CSE 257,A01,102396,Gao; Sicun,0,0,0,0
1668092728079,CSE 272,A00,102397,Li; Tzumao,0,0,0,0
1668092728503,CSE 274,A00,111323,Chern; Albert Ren-Haur,0,0,0,0
1668092728925,CSE 282,A00,102398,Pevzner; Pavel Arkadjevich,0,0,0,0
1668092729350,CSE 284,A00,114175,Gymrek; Melissa Ann,0,0,0,0
1668092729778,CSE 290,A00,102399,Chandraker; Manmohan Krishna,0,0,0,0
1668092729778,CSE 290,B00,102400,Vaccaro; Kristen Marie,0,0,25,25
1668092729778,CSE 290,C00,102414,Pannuto; Patrick William,0,0,25,25
1668092729778,CSE 290,D00,102427,Pevzner; Pavel Arkadjevich,0,0,0,0
1668092729778,CSE 290,E00,102429,Zhao; Jishen,0,0,0,0
1668092729778,CSE 290,F00,102436,Tullsen; Dean Michael,0,0,0,0
1668092729778,CSE 290,G00,102440,Christensen; Henrik I,0,0,20,20
1668092730207,CSE 291,A00,102443,Su; Hao,0,0,0,0
1668092730207,CSE 291,B00,102448,Polikarpova; Nadezhda,0,0,0,0
1668092730207,CSE 291,C00,102453,Vaccaro; Kristen Marie,0,0,0,0
1668092730207,CSE 291,D00,111343,Savage; Stefan,0,0,0,0
1668092730207,CSE 291,E00,116474,Claffy; Kimberly Claire,0,0,0,0
1668092730207,CSE 291,F00,116479,Pasquale; Joseph,0,0,0,0
1668092730639,CSE 293,001,119111,Bafna; Vineet,9999,0,9999,0
1668092730639,CSE 293,002,119118,Bellare; Mihir,9999,0,9999,0
1668092730639,CSE 293,003,119122,Berg-Kirkpatrick; Taylor D,9999,0,9999,0
1668092730639,CSE 293,004,119135,Christensen; Henrik I,9999,0,9999,0
1668092730639,CSE 293,005,119142,Cottrell; Garrison W,9999,0,9999,0
1668092730639,CSE 293,006,119146,Deutsch; Alin Bernard,9999,0,9999,0
1668092730639,CSE 293,007,119159,Esmaeilzadeh; Hadi,9999,0,9999,0
1668092730639,CSE 293,008,119166,Freund; Yoav,9999,0,9999,0
1668092730639,CSE 293,009,119170,Griswold; William G.,9999,0,9999,0
1668092730639,CSE 293,010,119183,Gymrek; Melissa Ann,9999,0,9999,0
1668092730639,CSE 293,011,119190,Heninger; Nadia A,9999,0,9999,0
1668092730639,CSE 293,012,119230,Impagliazzo; Russell,9999,0,9999,0
1668092730639,CSE 293,013,119232,Jhala; Ranjit,9999,0,9999,0
1668092730639,CSE 293,014,119233,Kahng; Andrew Byun,9999,0,9999,0
1668092730639,CSE 293,015,119298,Kane; Daniel Mertz,9999,0,9999,0
1668092730639,CSE 293,016,119299,Kriegman; David J,9999,0,9999,0
1668092730639,CSE 293,017,119300,Kumar; Arun Kumar,9999,0,9999,0
1668092730639,CSE 293,018,119301,Lerner; Sorin,9999,0,9999,0
1668092730639,CSE 293,019,119302,Lovett; Shachar,9999,0,9999,0
1668092730639,CSE 293,020,119303,McAuley; Julian John,9999,0,9999,0
1668092730639,CSE 293,021,119304,Micciancio; Daniele,9999,0,9999,0
1668092730639,CSE 293,022,119367,Orailoglu; Alex,9999,0,9999,0
1668092730639,CSE 293,023,119382,Paturi; Ramamohan,9999,0,9999,0
1668092730639,CSE 293,024,119404,Polikarpova; Nadezhda,9999,0,9999,0
1668092730639,CSE 293,025,119406,Politz; Joseph Gibbs,9999,0,9999,0
1668092730639,CSE 293,026,119411,Porter; George M,9999,0,9999,0
1668092730639,CSE 293,027,119414,Porter; Leonard Emerson,9999,0,9999,0
1668092730639,CSE 293,028,119416,Ramamoorthi; Ravi,9999,0,9999,0
1668092730639,CSE 293,029,119417,Sahoo; Debashis,9999,0,9999,0
1668092730639,CSE 293,030,119420,Saul; Lawrence,9999,0,9999,0
1668092730639,CSE 293,031,119421,Savage; Stefan,9999,0,9999,0
1668092730639,CSE 293,032,119425,Schulze; Jurgen P.,9999,0,9999,0
1668092730639,CSE 293,033,119426,Snoeren; Alex C.,9999,0,9999,0
1668092730639,CSE 293,034,119428,Shang; Jingbo,9999,0,9999,0
1668092730639,CSE 293,035,119430,Stefan; Deian,9999,0,9999,0
1668092730639,CSE 293,036,119431,Su; Hao,9999,0,9999,0
1668092730639,CSE 293,037,119433,Swanson; Steven James,9999,0,9999,0
1668092730639,CSE 293,038,119435,Tullsen; Dean Michael,9999,0,9999,0
1668092730639,CSE 293,039,119483,Voelker; Geoffrey M.,9999,0,9999,0
1668092730639,CSE 293,040,119537,Zhao; Jishen,9999,0,9999,0
1668092730639,CSE 293,041,119538,Zhou; Yuan-Yuan,9999,0,9999,0
1668092730639,CSE 293,042,119539,Gao; Sicun,9999,0,9999,0
1668092730639,CSE 293,043,119540,Weibel; Nadir,9999,0,9999,0
1668092730639,CSE 293,044,119541,Gupta; Rajesh K.,9999,0,9999,0
1668092730639,CSE 293,045,126410,Vaccaro; Kristen Marie,9999,0,9999,0
1668092730639,CSE 293,046,126411,Klemke; Richard,9999,0,9999,0
1668092731065,CSE 294,A00,102459,Voelker; Geoffrey M.,0,0,0,0
1668092731065,CSE 294,B00,111322,Orailoglu; Alex,0,0,0,0
1668092731491,DSE 201,A00,096914,Deutsch; Alin Bernard,30,0,30,0
1668092731917,DSE 210,A00,096915,Dasgupta; Sanjoy,30,0,30,0
1668092732339,DSE 260A,A00,096916,Altintas De Callaf; Ilkay,30,0,30,0
1668092732812,ECE 200,001,103586,Antipa; Nicholas A,9999,0,9999,0
1668092732812,ECE 200,002,103587,Atanasov; Nikolay A.,9999,0,9999,0
1668092732812,ECE 200,003,103588,Bharadia; Dinesh,9999,0,9999,0
1668092732812,ECE 200,004,103589,Cheng; Chung Kuan,9999,0,9999,0
1668092732812,ECE 200,005,103590,Cosman; Pamela C.,9999,0,9999,0
1668092732812,ECE 200,006,103591,Dayeh; Shadi Ahmad,9999,0,9999,0
1668092732812,ECE 200,007,103592,Fainman; Yeshaiahu,9999,0,9999,0
1668092732812,ECE 200,008,103593,Ford; Joseph Earl,9999,0,9999,0
1668092732812,ECE 200,009,103594,Franceschetti; Massimo,9999,0,9999,0
1668092732812,ECE 200,010,103595,Fullerton; Eric E,9999,0,9999,0
1668092732812,ECE 200,011,103596,Galton; Ian A,9999,0,9999,0
1668092732812,ECE 200,012,103597,Gilja; Vikash,9999,0,9999,0
1668092732812,ECE 200,013,103598,Hall; Drew A.,9999,0,9999,0
1668092732812,ECE 200,014,103599,Hsueh; Tzu-Chien,9999,0,9999,0
1668092732812,ECE 200,015,103600,Javidi; Tara,9999,0,9999,0
1668092732812,ECE 200,016,103601,Kahng; Andrew Byun,9999,0,9999,0
1668092732812,ECE 200,017,103602,Kim; Young-Han,9999,0,9999,0
1668092732812,ECE 200,018,103603,Koushanfar; Farinaz,9999,0,9999,0
1668092732812,ECE 200,019,103604,Kuzum; Duygu,9999,0,9999,0
1668092732812,ECE 200,020,103605,Le; Hanh-Phuc,9999,0,9999,0
1668092732812,ECE 200,021,103606,Lin; Bill,9999,0,9999,0
1668092732812,ECE 200,022,103607,Liu; Zhaowei,9998,0,9999,1
1668092732812,ECE 200,023,103608,Lo; Yu-Hwa,9999,0,9999,0
1668092732812,ECE 200,024,103609,Lomakin; Vitaliy,9999,0,9999,0
1668092732812,ECE 200,025,103610,Mercier; Patrick Philip,9999,0,9999,0
1668092732812,ECE 200,026,103611,Meyer; Florian,9999,0,9999,0
1668092732812,ECE 200,027,103612,Milstein; Laurence B.,9999,0,9999,0
1668092732812,ECE 200,028,103613,Mir Arabbaygi; Siavash,9999,0,9999,0
1668092732812,ECE 200,029,103614,Mookherjea; Shayan,9999,0,9999,0
1668092732812,ECE 200,030,103615,Morris; Karcher William,9999,0,9999,0
1668092732812,ECE 200,031,103616,Ng; Tse Nga,9999,0,9999,0
1668092732812,ECE 200,032,103617,Nguyen; Truong Quang,9999,0,9999,0
1668092732812,ECE 200,033,103618,Nomura; Kenji,9999,0,9999,0
1668092732812,ECE 200,034,103619,Orlitsky; Alon,9999,0,9999,0
1668092732812,ECE 200,035,103620,Pal; Piya,9999,0,9999,0
1668092732812,ECE 200,036,103621,Papen; George C.,9999,0,9999,0
1668092732812,ECE 200,037,103622,Radic; Stojan,9999,0,9999,0
1668092732812,ECE 200,038,103623,Rao; Bhaskar D.,9999,0,9999,0
1668092732812,ECE 200,039,103624,Rao; Ramesh R,9999,0,9999,0
1668092732812,ECE 200,040,103625,Rebeiz; Gabriel,9999,0,9999,0
1668092732812,ECE 200,041,103626,Sanford; John R,9999,0,9999,0
1668092732812,ECE 200,042,103627,Siegel; Paul H.,9999,0,9999,0
1668092732812,ECE 200,043,103628,Sievenpiper; Daniel F.,9999,0,9999,0
1668092732812,ECE 200,044,103629,Sworder; David D.,9999,0,9999,0
1668092732812,ECE 200,045,103630,Taur; Yuan,9999,0,9999,0
1668092732812,ECE 200,046,103631,Touri; Behrouz,9999,0,9999,0
1668092732812,ECE 200,047,103632,Trivedi; Mohan M.,9999,0,9999,0
1668092732812,ECE 200,048,103633,Vasconcelos; Nuno,9999,0,9999,0
1668092732812,ECE 200,049,103634,Wang; Xiaolong,9999,0,9999,0
1668092732812,ECE 200,050,103635,Xie; Pengtao,9999,0,9999,0
1668092732812,ECE 200,051,103636,Yip; Michael,9999,0,9999,0
1668092732812,ECE 200,052,103637,Zeger; Kenneth A.,999,0,999,0
1668092732812,ECE 200,053,103638,Zhang; Xinyu,9999,0,9999,0
1668092732812,ECE 200,054,103639,Turakhia; Yatish Girish,9999,0,9999,0
1668092732812,ECE 200,055,103640,Kang; Mingu,9999,0,9999,0
1668092732812,ECE 200,056,103641,Shi; Yuanyuan,9999,0,9999,0
1668092732812,ECE 200,057,103642,Wang; Edward Jay,9999,0,9999,0
1668092732812,ECE 200,058,103643,Zheng; Yang,9999,0,9999,0
1668092733237,ECE 202,A00,103644,Kuzum; Duygu,0,0,0,0
1668092733674,ECE 212BN,A00,103646,Ng; Tse Nga,0,0,0,0
1668092734102,ECE 221,A00,111493,Staff,0,0,0,0
1668092734530,ECE 222B,A00,103647,Lomakin; Vitaliy,0,0,0,0
1668092734956,ECE 230B,A00,103648,Taur; Yuan,0,0,0,0
1668092735384,ECE 238B,A00,103649,Garay; Javier,0,0,0,0
1668092735808,ECE 240B,A00,112900,Fainman; Yeshaiahu,0,0,0,0
1668092736238,ECE 247A,A00,103650,Jokerst; Jesse Vincent,0,0,0,0
1668092736675,ECE 247B,A00,103651,Wang; Joseph,0,0,0,0
1668092737099,ECE 250,A00,103652,Siegel; Paul H.,0,0,0,0
1668092737525,ECE 251A,A00,103654,Rao; Bhaskar D.,0,0,0,0
1668092737950,ECE 257B,A00,103655,Bharadia; Dinesh,0,0,0,0
1668092738383,ECE 258A,A00,103656,Milstein; Laurence B.,0,0,0,0
1668092738808,ECE 260B,A00,103658,Kang; Mingu,0,0,0,0
1668092739245,ECE 264A,A00,103659,Galton; Ian A,0,0,0,0
1668092739670,ECE 265A,A00,103661,Gudem; Prasad S.S.,0,0,0,0
1668092740093,ECE 265D,A00,103662,Gudem; Prasad S.S.,0,0,0,0
1668092740522,ECE 268,A00,103663,Koushanfar; Farinaz,0,0,0,0
1668092740954,ECE 269,A01,103665,Pal; Piya,0,0,0,0
1668092741381,ECE 271B,A00,103666,Vasconcelos; Manuela,0,0,0,0
1668092741826,ECE 276A,A00,103667,Atanasov; Nikolay A.,0,0,0,0
1668092742252,ECE 277,A00,103668,An; Cheolhong,0,0,0,0
1668092742680,ECE 279,A00,117947,Hall; Drew A.,0,0,0,0
1668092743528,ECE 283,A00,103670,Hsueh; Tzu-Chien,0,0,0,0
1668092743956,ECE 284,A00,103671,Turakhia; Yatish Girish,0,0,0,0
1668092744397,ECE 285,A00,103672,Zheng; Yang,0,0,0,0
1668092744397,ECE 285,B00,103673,Sworder; David D.,0,0,0,0
1668092744820,ECE 287,A00,103676,Javidi; Tara,0,0,0,0
1668092745258,MATH 200B,A00,098023,Salehi Golsefidy; Alireza,13,0,15,2
1668092745680,MATH 202B,A00,098024,Rhoades; Brendon Patrick,9,0,15,6
1668092746104,MATH 203B,A00,098025,Oprea; Dragos N.,10,0,15,5
1668092746530,MATH 204B,A00,098026,Sorensen; Claus M,13,0,15,2
1668092746956,MATH 208,A00,098027,Izadi; Elham,7,0,10,3
1668092747381,MATH 209,A00,098028,Pollack; Aaron,10,0,10,0
1668092747819,MATH 211A,A00,112919,Rogalski; Daniel,9,0,10,1
1668092748243,MATH 211B,A00,112920,Seward; Brandon M.,9,0,10,1
1668092748675,MATH 218,A00,098029,Li; Bo,10,0,10,0
1668092749102,MATH 220B,A00,098030,Novak; Jonathan I,12,0,15,3
1668092749525,MATH 221A,A00,098031,Ebenfelt; Peter F,13,0,15,2
1668092749951,MATH 231B,A00,098032,Zlatos; Andrej,12,0,15,3
1668092750378,MATH 240B,A00,098033,Ni; Lei,9,0,15,6
1668092750804,MATH 243,A00,098034,Jekel; David Andrew,10,0,10,0
1668092751235,MATH 245A,A00,098035,Nie; Jiawang,0,0,15,16
1668092751665,MATH 248,A00,098036,Bejenaru; Ioan,10,0,10,0
1668092752096,MATH 250B,A00,098037,Spolaor; Luca,14,0,15,1
1668092752527,MATH 258,A00,098038,Ni; Lei,10,0,10,0
1668092752967,MATH 264B,A00,098041,Rhoades; Brendon Patrick,10,0,15,5
1668092753396,MATH 268,A00,098042,Buss; Samuel R,10,0,10,0
1668092753824,MATH 269,A00,098043,Rhoades; Brendon Patrick,10,0,10,0
1668092754248,MATH 270B,A00,098044,Li; Bo,11,0,15,4
1668092754682,MATH 272B,A00,098045,Holst; Michael J,13,0,15,2
1668092755110,MATH 273A,A00,098046,Tian; Xiaochuan,10,0,15,5
1668092755544,MATH 275,A01,098048,Tian; Xiaochuan,6,0,10,4
1668092755978,MATH 278A,A00,098049,Holst; Michael J,8,0,10,2
1668092756417,MATH 278B,A00,098050,Cloninger; Alexander,10,0,10,0
1668092756843,MATH 278C,A00,098051,Nie; Jiawang,7,0,10,3
1668092757270,MATH 280B,A00,098052,Zheng; Tianyi,10,0,15,5
1668092757695,MATH 281B,A00,098053,Bradic; Jelena,3,0,15,12
1668092758126,MATH 282B,A00,098054,Arias-Castro; Ery,0,0,15,15
1668092758625,MATH 285,A00,098055,Fitzsimmons; Patrick J,0,0,15,17
1668092759053,MATH 287B,A00,098056,Arias-Castro; Ery,3,0,15,12
1668092759482,MATH 288,A00,098057,Agarwal; Pooja,9,0,10,1
1668092759482,MATH 288,B00,098058,Zhang; Danna,8,0,10,2
1668092759482,MATH 288,C00,098059,Williams; Ruth J,10,0,10,0
1668092759910,MATH 290B,A00,098060,Roberts; Justin Deritter,13,0,15,2
1668092760333,MATH 292,A00,098061,Belmont; Eva Kinoshita,10,0,10,0
1668092760759,MATH 295,A00,098062,Suk; Andrew Hoon,48,0,50,2
1668092761183,MATH 296,A00,098063,Novak; Jonathan I,20,0,20,0
1668092761608,MATH 297,001,098064,Gamst; Anthony Collins,9997,0,9999,2
1668093263093,COGS 205,A00,101395,Chiba; Andrea,19,0,20,1
1668093263519,COGS 210B,001,101404,Greene; Deanna Jacquelyn,9998,0,9999,1
1668093263519,COGS 210B,002,101417,Xia; Haijun,9999,0,9999,0
1668093263519,COGS 210B,003,101422,Nitz; Douglas A.,9999,0,9999,0
1668093263519,COGS 210B,004,101423,Hollan; James D.,9998,0,9999,1
1668093263519,COGS 210B,005,101424,Deak; Gedeon O.,9998,0,9999,1
1668093263519,COGS 210B,006,101425,Rossano; Federico,9999,0,9999,0
1668093263956,COGS 211B,A00,101427,Coulson; Seana M,9996,0,9999,3
1668093264379,COGS 220,A00,101428,Hollan; James D.,0,0,25,25
1668093264807,COGS 229,A00,101429,Dow; Steven P,18,0,25,7
1668093265241,COGS 230,A00,101430,Klemmer; Scott R,13,0,17,4
1668093265668,COGS 234,A00,101431,Xia; Haijun,3,0,25,22
1668093266092,COGS 260,A00,101432,Kiyonaga; Anastasia,19,0,25,6
1668093266092,COGS 260,B00,101433,Kirsh; David Joel,16,0,25,9
1668093266516,CSE 202,A00,102371,Impagliazzo; Russell,0,0,0,0
1668093266941,CSE 203B,A01,102373,Cheng; Chung Kuan,0,0,0,0
1668093267375,CSE 208,A00,102374,Micciancio; Daniele,0,0,0,0
1668093267800,CSE 209A,A00,112895,Impagliazzo; Russell,0,0,15,15
1668093268224,CSE 209B,A00,108005,Bellare; Mihir,0,0,0,0
1668093268652,CSE 210,A00,113163,Coblenz; Michael J,0,0,0,0
1668093269083,CSE 219,A00,106111,Dow; Steven P,0,0,20,20
1668093269509,CSE 221,A00,102376,Voelker; Geoffrey M.,0,0,0,0
1668093269936,CSE 224,A01,102378,Porter; George M,0,0,0,0
1668093270367,CSE 229A,A00,102379,Savage; Stefan,0,0,0,0
1668093270792,CSE 229C,A00,102380,Munyaka; Imani N. S.,0,0,0,0
1668093271223,CSE 232B,A00,102382,Deutsch; Alin Bernard,0,0,0,0
1668093271647,CSE 234,A01,112904,Kumar; Arun Kumar,0,0,0,0
1668093272076,CSE 237A,A00,102383,Rosing; Tajana Simunic,0,0,0,0
1668093272498,CSE 239A,A00,102384,Deutsch; Alin Bernard,0,0,0,0
1668093272922,CSE 239B,A00,102385,Polikarpova; Nadezhda,0,0,0,0
1668093273348,CSE 240A,A00,102386,Pannuto; Patrick William,0,0,0,0
1668093273773,CSE 240B,A00,102387,Zhao; Jishen,0,0,0,0
1668093274209,CSE 241A,A00,106406,Kang; Mingu,0,0,0,0
1668093274633,CSE 249B,A00,102388,Kahng; Andrew Byun,0,0,8,8
1668093275061,CSE 251B,A01,102392,Cottrell; Garrison W,0,0,0,0
1668093275061,CSE 251B,A02,102393,Cottrell; Garrison W,0,0,0,0
1668093275485,CSE 252B,A00,102394,Ochoa; Benjamin Lawrence,0,0,0,0
1668093275923,CSE 257,A01,102396,Gao; Sicun,0,0,0,0
1668093276349,CSE 272,A00,102397,Li; Tzumao,0,0,0,0
1668093276774,CSE 274,A00,111323,Chern; Albert Ren-Haur,0,0,0,0
1668093277198,CSE 282,A00,102398,Pevzner; Pavel Arkadjevich,0,0,0,0
1668093277636,CSE 284,A00,114175,Gymrek; Melissa Ann,0,0,0,0
1668093278063,CSE 290,A00,102399,Chandraker; Manmohan Krishna,0,0,0,0
1668093278063,CSE 290,B00,102400,Vaccaro; Kristen Marie,0,0,25,25
1668093278063,CSE 290,C00,102414,Pannuto; Patrick William,0,0,25,25
1668093278063,CSE 290,D00,102427,Pevzner; Pavel Arkadjevich,0,0,0,0
1668093278063,CSE 290,E00,102429,Zhao; Jishen,0,0,0,0
1668093278063,CSE 290,F00,102436,Tullsen; Dean Michael,0,0,0,0
1668093278063,CSE 290,G00,102440,Christensen; Henrik I,0,0,20,20
1668093278488,CSE 291,A00,102443,Su; Hao,0,0,0,0
1668093278488,CSE 291,B00,102448,Polikarpova; Nadezhda,0,0,0,0
1668093278488,CSE 291,C00,102453,Vaccaro; Kristen Marie,0,0,0,0
1668093278488,CSE 291,D00,111343,Savage; Stefan,0,0,0,0
1668093278488,CSE 291,E00,116474,Claffy; Kimberly Claire,0,0,0,0
1668093278488,CSE 291,F00,116479,Pasquale; Joseph,0,0,0,0
1668093278917,CSE 293,001,119111,Bafna; Vineet,9999,0,9999,0
1668093278917,CSE 293,002,119118,Bellare; Mihir,9999,0,9999,0
1668093278917,CSE 293,003,119122,Berg-Kirkpatrick; Taylor D,9999,0,9999,0
1668093278917,CSE 293,004,119135,Christensen; Henrik I,9999,0,9999,0
1668093278917,CSE 293,005,119142,Cottrell; Garrison W,9999,0,9999,0
1668093278917,CSE 293,006,119146,Deutsch; Alin Bernard,9999,0,9999,0
1668093278917,CSE 293,007,119159,Esmaeilzadeh; Hadi,9999,0,9999,0
1668093278917,CSE 293,008,119166,Freund; Yoav,9999,0,9999,0
1668093278917,CSE 293,009,119170,Griswold; William G.,9999,0,9999,0
1668093278917,CSE 293,010,119183,Gymrek; Melissa Ann,9999,0,9999,0
1668093278917,CSE 293,011,119190,Heninger; Nadia A,9999,0,9999,0
1668093278917,CSE 293,012,119230,Impagliazzo; Russell,9999,0,9999,0
1668093278917,CSE 293,013,119232,Jhala; Ranjit,9999,0,9999,0
1668093278917,CSE 293,014,119233,Kahng; Andrew Byun,9999,0,9999,0
1668093278917,CSE 293,015,119298,Kane; Daniel Mertz,9999,0,9999,0
1668093278917,CSE 293,016,119299,Kriegman; David J,9999,0,9999,0
1668093278917,CSE 293,017,119300,Kumar; Arun Kumar,9999,0,9999,0
1668093278917,CSE 293,018,119301,Lerner; Sorin,9999,0,9999,0
1668093278917,CSE 293,019,119302,Lovett; Shachar,9999,0,9999,0
1668093278917,CSE 293,020,119303,McAuley; Julian John,9999,0,9999,0
1668093278917,CSE 293,021,119304,Micciancio; Daniele,9999,0,9999,0
1668093278917,CSE 293,022,119367,Orailoglu; Alex,9999,0,9999,0
1668093278917,CSE 293,023,119382,Paturi; Ramamohan,9999,0,9999,0
1668093278917,CSE 293,024,119404,Polikarpova; Nadezhda,9999,0,9999,0
1668093278917,CSE 293,025,119406,Politz; Joseph Gibbs,9999,0,9999,0
1668093278917,CSE 293,026,119411,Porter; George M,9999,0,9999,0
1668093278917,CSE 293,027,119414,Porter; Leonard Emerson,9999,0,9999,0
1668093278917,CSE 293,028,119416,Ramamoorthi; Ravi,9999,0,9999,0
1668093278917,CSE 293,029,119417,Sahoo; Debashis,9999,0,9999,0
1668093278917,CSE 293,030,119420,Saul; Lawrence,9999,0,9999,0
1668093278917,CSE 293,031,119421,Savage; Stefan,9999,0,9999,0
1668093278917,CSE 293,032,119425,Schulze; Jurgen P.,9999,0,9999,0
1668093278917,CSE 293,033,119426,Snoeren; Alex C.,9999,0,9999,0
1668093278917,CSE 293,034,119428,Shang; Jingbo,9999,0,9999,0
1668093278917,CSE 293,035,119430,Stefan; Deian,9999,0,9999,0
1668093278917,CSE 293,036,119431,Su; Hao,9999,0,9999,0
1668093278917,CSE 293,037,119433,Swanson; Steven James,9999,0,9999,0
1668093278917,CSE 293,038,119435,Tullsen; Dean Michael,9999,0,9999,0
1668093278917,CSE 293,039,119483,Voelker; Geoffrey M.,9999,0,9999,0
1668093278917,CSE 293,040,119537,Zhao; Jishen,9999,0,9999,0
1668093278917,CSE 293,041,119538,Zhou; Yuan-Yuan,9999,0,9999,0
1668093278917,CSE 293,042,119539,Gao; Sicun,9999,0,9999,0
1668093278917,CSE 293,043,119540,Weibel; Nadir,9999,0,9999,0
1668093278917,CSE 293,044,119541,Gupta; Rajesh K.,9999,0,9999,0
1668093278917,CSE 293,045,126410,Vaccaro; Kristen Marie,9999,0,9999,0
1668093278917,CSE 293,046,126411,Klemke; Richard,9999,0,9999,0
1668093279349,CSE 294,A00,102459,Voelker; Geoffrey M.,0,0,0,0
1668093279349,CSE 294,B00,111322,Orailoglu; Alex,0,0,0,0
1668093279771,DSE 201,A00,096914,Deutsch; Alin Bernard,30,0,30,0
1668093280301,DSE 210,A00,096915,Dasgupta; Sanjoy,30,0,30,0
1668093280730,DSE 260A,A00,096916,Altintas De Callaf; Ilkay,30,0,30,0
1668093281184,ECE 200,001,103586,Antipa; Nicholas A,9999,0,9999,0
1668093281184,ECE 200,002,103587,Atanasov; Nikolay A.,9999,0,9999,0
1668093281184,ECE 200,003,103588,Bharadia; Dinesh,9999,0,9999,0
1668093281184,ECE 200,004,103589,Cheng; Chung Kuan,9999,0,9999,0
1668093281184,ECE 200,005,103590,Cosman; Pamela C.,9999,0,9999,0
1668093281184,ECE 200,006,103591,Dayeh; Shadi Ahmad,9999,0,9999,0
1668093281184,ECE 200,007,103592,Fainman; Yeshaiahu,9999,0,9999,0
1668093281184,ECE 200,008,103593,Ford; Joseph Earl,9999,0,9999,0
1668093281184,ECE 200,009,103594,Franceschetti; Massimo,9999,0,9999,0
1668093281184,ECE 200,010,103595,Fullerton; Eric E,9999,0,9999,0
1668093281184,ECE 200,011,103596,Galton; Ian A,9999,0,9999,0
1668093281184,ECE 200,012,103597,Gilja; Vikash,9999,0,9999,0
1668093281184,ECE 200,013,103598,Hall; Drew A.,9999,0,9999,0
1668093281184,ECE 200,014,103599,Hsueh; Tzu-Chien,9999,0,9999,0
1668093281184,ECE 200,015,103600,Javidi; Tara,9999,0,9999,0
1668093281184,ECE 200,016,103601,Kahng; Andrew Byun,9999,0,9999,0
1668093281184,ECE 200,017,103602,Kim; Young-Han,9999,0,9999,0
1668093281184,ECE 200,018,103603,Koushanfar; Farinaz,9999,0,9999,0
1668093281184,ECE 200,019,103604,Kuzum; Duygu,9999,0,9999,0
1668093281184,ECE 200,020,103605,Le; Hanh-Phuc,9999,0,9999,0
1668093281184,ECE 200,021,103606,Lin; Bill,9999,0,9999,0
1668093281184,ECE 200,022,103607,Liu; Zhaowei,9998,0,9999,1
1668093281184,ECE 200,023,103608,Lo; Yu-Hwa,9999,0,9999,0
1668093281184,ECE 200,024,103609,Lomakin; Vitaliy,9999,0,9999,0
1668093281184,ECE 200,025,103610,Mercier; Patrick Philip,9999,0,9999,0
1668093281184,ECE 200,026,103611,Meyer; Florian,9999,0,9999,0
1668093281184,ECE 200,027,103612,Milstein; Laurence B.,9999,0,9999,0
1668093281184,ECE 200,028,103613,Mir Arabbaygi; Siavash,9999,0,9999,0
1668093281184,ECE 200,029,103614,Mookherjea; Shayan,9999,0,9999,0
1668093281184,ECE 200,030,103615,Morris; Karcher William,9999,0,9999,0
1668093281184,ECE 200,031,103616,Ng; Tse Nga,9999,0,9999,0
1668093281184,ECE 200,032,103617,Nguyen; Truong Quang,9999,0,9999,0
1668093281184,ECE 200,033,103618,Nomura; Kenji,9999,0,9999,0
1668093281184,ECE 200,034,103619,Orlitsky; Alon,9999,0,9999,0
1668093281184,ECE 200,035,103620,Pal; Piya,9999,0,9999,0
1668093281184,ECE 200,036,103621,Papen; George C.,9999,0,9999,0
1668093281184,ECE 200,037,103622,Radic; Stojan,9999,0,9999,0
1668093281184,ECE 200,038,103623,Rao; Bhaskar D.,9999,0,9999,0
1668093281184,ECE 200,039,103624,Rao; Ramesh R,9999,0,9999,0
1668093281184,ECE 200,040,103625,Rebeiz; Gabriel,9999,0,9999,0
1668093281184,ECE 200,041,103626,Sanford; John R,9999,0,9999,0
1668093281184,ECE 200,042,103627,Siegel; Paul H.,9999,0,9999,0
1668093281184,ECE 200,043,103628,Sievenpiper; Daniel F.,9999,0,9999,0
1668093281184,ECE 200,044,103629,Sworder; David D.,9999,0,9999,0
1668093281184,ECE 200,045,103630,Taur; Yuan,9999,0,9999,0
1668093281184,ECE 200,046,103631,Touri; Behrouz,9999,0,9999,0
1668093281184,ECE 200,047,103632,Trivedi; Mohan M.,9999,0,9999,0
1668093281184,ECE 200,048,103633,Vasconcelos; Nuno,9999,0,9999,0
1668093281184,ECE 200,049,103634,Wang; Xiaolong,9999,0,9999,0
1668093281184,ECE 200,050,103635,Xie; Pengtao,9999,0,9999,0
1668093281184,ECE 200,051,103636,Yip; Michael,9999,0,9999,0
1668093281184,ECE 200,052,103637,Zeger; Kenneth A.,999,0,999,0
1668093281184,ECE 200,053,103638,Zhang; Xinyu,9999,0,9999,0
1668093281184,ECE 200,054,103639,Turakhia; Yatish Girish,9999,0,9999,0
1668093281184,ECE 200,055,103640,Kang; Mingu,9999,0,9999,0
1668093281184,ECE 200,056,103641,Shi; Yuanyuan,9999,0,9999,0
1668093281184,ECE 200,057,103642,Wang; Edward Jay,9999,0,9999,0
1668093281184,ECE 200,058,103643,Zheng; Yang,9999,0,9999,0
1668093281610,ECE 202,A00,103644,Kuzum; Duygu,0,0,0,0
1668093282033,ECE 212BN,A00,103646,Ng; Tse Nga,0,0,0,0
1668093282454,ECE 221,A00,111493,Staff,0,0,0,0
1668093282878,ECE 222B,A00,103647,Lomakin; Vitaliy,0,0,0,0
1668093283311,ECE 230B,A00,103648,Taur; Yuan,0,0,0,0
1668093283741,ECE 238B,A00,103649,Garay; Javier,0,0,0,0
1668093284171,ECE 240B,A00,112900,Fainman; Yeshaiahu,0,0,0,0
1668093284598,ECE 247A,A00,103650,Jokerst; Jesse Vincent,0,0,0,0
1668093285029,ECE 247B,A00,103651,Wang; Joseph,0,0,0,0
1668093285454,ECE 250,A00,103652,Siegel; Paul H.,0,0,0,0
1668093285891,ECE 251A,A00,103654,Rao; Bhaskar D.,0,0,0,0
1668093286318,ECE 257B,A00,103655,Bharadia; Dinesh,0,0,0,0
1668093286747,ECE 258A,A00,103656,Milstein; Laurence B.,0,0,0,0
1668093287174,ECE 260B,A00,103658,Kang; Mingu,0,0,0,0
1668093287597,ECE 264A,A00,103659,Galton; Ian A,0,0,0,0
1668093288021,ECE 265A,A00,103661,Gudem; Prasad S.S.,0,0,0,0
1668093288454,ECE 265D,A00,103662,Gudem; Prasad S.S.,0,0,0,0
1668093288879,ECE 268,A00,103663,Koushanfar; Farinaz,0,0,0,0
1668093289308,ECE 269,A01,103665,Pal; Piya,0,0,0,0
1668093289734,ECE 271B,A00,103666,Vasconcelos; Manuela,0,0,0,0
1668093290159,ECE 276A,A00,103667,Atanasov; Nikolay A.,0,0,0,0
1668093290587,ECE 277,A00,103668,An; Cheolhong,0,0,0,0
1668093291016,ECE 279,A00,117947,Hall; Drew A.,0,0,0,0
1668093291879,ECE 283,A00,103670,Hsueh; Tzu-Chien,0,0,0,0
1668093292313,ECE 284,A00,103671,Turakhia; Yatish Girish,0,0,0,0
1668093292741,ECE 285,A00,103672,Zheng; Yang,0,0,0,0
1668093292741,ECE 285,B00,103673,Sworder; David D.,0,0,0,0
1668093293187,ECE 287,A00,103676,Javidi; Tara,0,0,0,0
1668093293613,MATH 200B,A00,098023,Salehi Golsefidy; Alireza,13,0,15,2
1668093294043,MATH 202B,A00,098024,Rhoades; Brendon Patrick,9,0,15,6
1668093294469,MATH 203B,A00,098025,Oprea; Dragos N.,10,0,15,5
1668093294893,MATH 204B,A00,098026,Sorensen; Claus M,13,0,15,2
1668093295315,MATH 208,A00,098027,Izadi; Elham,7,0,10,3
1668093295737,MATH 209,A00,098028,Pollack; Aaron,10,0,10,0
1668093296163,MATH 211A,A00,112919,Rogalski; Daniel,9,0,10,1
1668093296586,MATH 211B,A00,112920,Seward; Brandon M.,9,0,10,1
1668093297010,MATH 218,A00,098029,Li; Bo,10,0,10,0
1668093297442,MATH 220B,A00,098030,Novak; Jonathan I,12,0,15,3
1668093297866,MATH 221A,A00,098031,Ebenfelt; Peter F,13,0,15,2
1668093298295,MATH 231B,A00,098032,Zlatos; Andrej,12,0,15,3
1668093298719,MATH 240B,A00,098033,Ni; Lei,9,0,15,6
1668093299144,MATH 243,A00,098034,Jekel; David Andrew,10,0,10,0
1668093299567,MATH 245A,A00,098035,Nie; Jiawang,0,0,15,16
1668093299995,MATH 248,A00,098036,Bejenaru; Ioan,10,0,10,0
1668093300421,MATH 250B,A00,098037,Spolaor; Luca,14,0,15,1
1668093300845,MATH 258,A00,098038,Ni; Lei,10,0,10,0
1668093301273,MATH 264B,A00,098041,Rhoades; Brendon Patrick,10,0,15,5
1668093301705,MATH 268,A00,098042,Buss; Samuel R,10,0,10,0
1668093302137,MATH 269,A00,098043,Rhoades; Brendon Patrick,10,0,10,0
1668093302561,MATH 270B,A00,098044,Li; Bo,11,0,15,4
1668093302988,MATH 272B,A00,098045,Holst; Michael J,13,0,15,2
1668093303411,MATH 273A,A00,098046,Tian; Xiaochuan,10,0,15,5
1668093303836,MATH 275,A01,098048,Tian; Xiaochuan,6,0,10,4
1668093304271,MATH 278A,A00,098049,Holst; Michael J,8,0,10,2
1668093304704,MATH 278B,A00,098050,Cloninger; Alexander,10,0,10,0
1668093305125,MATH 278C,A00,098051,Nie; Jiawang,7,0,10,3
1668093305549,MATH 280B,A00,098052,Zheng; Tianyi,10,0,15,5
1668093305975,MATH 281B,A00,098053,Bradic; Jelena,3,0,15,12
1668093306401,MATH 282B,A00,098054,Arias-Castro; Ery,0,0,15,15
1668093306841,MATH 285,A00,098055,Fitzsimmons; Patrick J,0,0,15,17
1668093307267,MATH 287B,A00,098056,Arias-Castro; Ery,3,0,15,12
1668093307699,MATH 288,A00,098057,Agarwal; Pooja,9,0,10,1
1668093307699,MATH 288,B00,098058,Zhang; Danna,8,0,10,2
1668093307699,MATH 288,C00,098059,Williams; Ruth J,10,0,10,0
1668093308130,MATH 290B,A00,098060,Roberts; Justin Deritter,13,0,15,2
1668093308568,MATH 292,A00,098061,Belmont; Eva Kinoshita,10,0,10,0
1668093308995,MATH 295,A00,098062,Suk; Andrew Hoon,48,0,50,2
1668093309428,MATH 296,A00,098063,Novak; Jonathan I,20,0,20,0
1668093309860,MATH 297,001,098064,Gamst; Anthony Collins,9997,0,9999,2
1668093812349,COGS 205,A00,101395,Chiba; Andrea,19,0,20,1
1668093812776,COGS 210B,001,101404,Greene; Deanna Jacquelyn,9998,0,9999,1
1668093812776,COGS 210B,002,101417,Xia; Haijun,9999,0,9999,0
1668093812776,COGS 210B,003,101422,Nitz; Douglas A.,9999,0,9999,0
1668093812776,COGS 210B,004,101423,Hollan; James D.,9998,0,9999,1
1668093812776,COGS 210B,005,101424,Deak; Gedeon O.,9998,0,9999,1
1668093812776,COGS 210B,006,101425,Rossano; Federico,9999,0,9999,0
1668093813201,COGS 211B,A00,101427,Coulson; Seana M,9996,0,9999,3
1668093813630,COGS 220,A00,101428,Hollan; James D.,0,0,25,25
1668093814052,COGS 229,A00,101429,Dow; Steven P,18,0,25,7
1668093814489,COGS 230,A00,101430,Klemmer; Scott R,13,0,17,4
1668093814912,COGS 234,A00,101431,Xia; Haijun,3,0,25,22
1668093815349,COGS 260,A00,101432,Kiyonaga; Anastasia,19,0,25,6
1668093815349,COGS 260,B00,101433,Kirsh; David Joel,16,0,25,9
1668093815771,CSE 202,A00,102371,Impagliazzo; Russell,0,0,0,0
1668093816192,CSE 203B,A01,102373,Cheng; Chung Kuan,0,0,0,0
1668093816630,CSE 208,A00,102374,Micciancio; Daniele,0,0,0,0
1668093817055,CSE 209A,A00,112895,Impagliazzo; Russell,0,0,15,15
1668093817482,CSE 209B,A00,108005,Bellare; Mihir,0,0,0,0
1668093817911,CSE 210,A00,113163,Coblenz; Michael J,0,0,0,0
1668093818337,CSE 219,A00,106111,Dow; Steven P,0,0,20,20
1668093818768,CSE 221,A00,102376,Voelker; Geoffrey M.,0,0,0,0
1668093819191,CSE 224,A01,102378,Porter; George M,0,0,0,0
1668093819617,CSE 229A,A00,102379,Savage; Stefan,0,0,0,0
1668093820040,CSE 229C,A00,102380,Munyaka; Imani N. S.,0,0,0,0
1668093820463,CSE 232B,A00,102382,Deutsch; Alin Bernard,0,0,0,0
1668093820886,CSE 234,A01,112904,Kumar; Arun Kumar,0,0,0,0
1668093821308,CSE 237A,A00,102383,Rosing; Tajana Simunic,0,0,0,0
1668093821731,CSE 239A,A00,102384,Deutsch; Alin Bernard,0,0,0,0
1668093822168,CSE 239B,A00,102385,Polikarpova; Nadezhda,0,0,0,0
1668093822591,CSE 240A,A00,102386,Pannuto; Patrick William,0,0,0,0
1668093823016,CSE 240B,A00,102387,Zhao; Jishen,0,0,0,0
1668093823443,CSE 241A,A00,106406,Kang; Mingu,0,0,0,0
1668093823882,CSE 249B,A00,102388,Kahng; Andrew Byun,0,0,8,8
1668093824308,CSE 251B,A01,102392,Cottrell; Garrison W,0,0,0,0
1668093824308,CSE 251B,A02,102393,Cottrell; Garrison W,0,0,0,0
1668093824733,CSE 252B,A00,102394,Ochoa; Benjamin Lawrence,0,0,0,0
1668093825166,CSE 257,A01,102396,Gao; Sicun,0,0,0,0
1668093825593,CSE 272,A00,102397,Li; Tzumao,0,0,0,0
1668093826016,CSE 274,A00,111323,Chern; Albert Ren-Haur,0,0,0,0
1668093826442,CSE 282,A00,102398,Pevzner; Pavel Arkadjevich,0,0,0,0
1668093826877,CSE 284,A00,114175,Gymrek; Melissa Ann,0,0,0,0
1668093827300,CSE 290,A00,102399,Chandraker; Manmohan Krishna,0,0,0,0
1668093827300,CSE 290,B00,102400,Vaccaro; Kristen Marie,0,0,25,25
1668093827300,CSE 290,C00,102414,Pannuto; Patrick William,0,0,25,25
1668093827300,CSE 290,D00,102427,Pevzner; Pavel Arkadjevich,0,0,0,0
1668093827300,CSE 290,E00,102429,Zhao; Jishen,0,0,0,0
1668093827300,CSE 290,F00,102436,Tullsen; Dean Michael,0,0,0,0
1668093827300,CSE 290,G00,102440,Christensen; Henrik I,0,0,20,20
1668093827725,CSE 291,A00,102443,Su; Hao,0,0,0,0
1668093827725,CSE 291,B00,102448,Polikarpova; Nadezhda,0,0,0,0
1668093827725,CSE 291,C00,102453,Vaccaro; Kristen Marie,0,0,0,0
1668093827725,CSE 291,D00,111343,Savage; Stefan,0,0,0,0
1668093827725,CSE 291,E00,116474,Claffy; Kimberly Claire,0,0,0,0
1668093827725,CSE 291,F00,116479,Pasquale; Joseph,0,0,0,0
1668093828151,CSE 293,001,119111,Bafna; Vineet,9999,0,9999,0
1668093828151,CSE 293,002,119118,Bellare; Mihir,9999,0,9999,0
1668093828151,CSE 293,003,119122,Berg-Kirkpatrick; Taylor D,9999,0,9999,0
1668093828151,CSE 293,004,119135,Christensen; Henrik I,9999,0,9999,0
1668093828151,CSE 293,005,119142,Cottrell; Garrison W,9999,0,9999,0
1668093828151,CSE 293,006,119146,Deutsch; Alin Bernard,9999,0,9999,0
1668093828151,CSE 293,007,119159,Esmaeilzadeh; Hadi,9999,0,9999,0
1668093828151,CSE 293,008,119166,Freund; Yoav,9999,0,9999,0
1668093828151,CSE 293,009,119170,Griswold; William G.,9999,0,9999,0
1668093828151,CSE 293,010,119183,Gymrek; Melissa Ann,9999,0,9999,0
1668093828151,CSE 293,011,119190,Heninger; Nadia A,9999,0,9999,0
1668093828151,CSE 293,012,119230,Impagliazzo; Russell,9999,0,9999,0
1668093828151,CSE 293,013,119232,Jhala; Ranjit,9999,0,9999,0
1668093828151,CSE 293,014,119233,Kahng; Andrew Byun,9999,0,9999,0
1668093828151,CSE 293,015,119298,Kane; Daniel Mertz,9999,0,9999,0
1668093828151,CSE 293,016,119299,Kriegman; David J,9999,0,9999,0
1668093828151,CSE 293,017,119300,Kumar; Arun Kumar,9999,0,9999,0
1668093828151,CSE 293,018,119301,Lerner; Sorin,9999,0,9999,0
1668093828151,CSE 293,019,119302,Lovett; Shachar,9999,0,9999,0
1668093828151,CSE 293,020,119303,McAuley; Julian John,9999,0,9999,0
1668093828151,CSE 293,021,119304,Micciancio; Daniele,9999,0,9999,0
1668093828151,CSE 293,022,119367,Orailoglu; Alex,9999,0,9999,0
1668093828151,CSE 293,023,119382,Paturi; Ramamohan,9999,0,9999,0
1668093828151,CSE 293,024,119404,Polikarpova; Nadezhda,9999,0,9999,0
1668093828151,CSE 293,025,119406,Politz; Joseph Gibbs,9999,0,9999,0
1668093828151,CSE 293,026,119411,Porter; George M,9999,0,9999,0
1668093828151,CSE 293,027,119414,Porter; Leonard Emerson,9999,0,9999,0
1668093828151,CSE 293,028,119416,Ramamoorthi; Ravi,9999,0,9999,0
1668093828151,CSE 293,029,119417,Sahoo; Debashis,9999,0,9999,0
1668093828151,CSE 293,030,119420,Saul; Lawrence,9999,0,9999,0
1668093828151,CSE 293,031,119421,Savage; Stefan,9999,0,9999,0
1668093828151,CSE 293,032,119425,Schulze; Jurgen P.,9999,0,9999,0
1668093828151,CSE 293,033,119426,Snoeren; Alex C.,9999,0,9999,0
1668093828151,CSE 293,034,119428,Shang; Jingbo,9999,0,9999,0
1668093828151,CSE 293,035,119430,Stefan; Deian,9999,0,9999,0
1668093828151,CSE 293,036,119431,Su; Hao,9999,0,9999,0
1668093828151,CSE 293,037,119433,Swanson; Steven James,9999,0,9999,0
1668093828151,CSE 293,038,119435,Tullsen; Dean Michael,9999,0,9999,0
1668093828151,CSE 293,039,119483,Voelker; Geoffrey M.,9999,0,9999,0
1668093828151,CSE 293,040,119537,Zhao; Jishen,9999,0,9999,0
1668093828151,CSE 293,041,119538,Zhou; Yuan-Yuan,9999,0,9999,0
1668093828151,CSE 293,042,119539,Gao; Sicun,9999,0,9999,0
1668093828151,CSE 293,043,119540,Weibel; Nadir,9999,0,9999,0
1668093828151,CSE 293,044,119541,Gupta; Rajesh K.,9999,0,9999,0
1668093828151,CSE 293,045,126410,Vaccaro; Kristen Marie,9999,0,9999,0
1668093828151,CSE 293,046,126411,Klemke; Richard,9999,0,9999,0
1668093828581,CSE 294,A00,102459,Voelker; Geoffrey M.,0,0,0,0
1668093828581,CSE 294,B00,111322,Orailoglu; Alex,0,0,0,0
1668093829005,DSE 201,A00,096914,Deutsch; Alin Bernard,30,0,30,0
1668093829429,DSE 210,A00,096915,Dasgupta; Sanjoy,30,0,30,0
1668093829852,DSE 260A,A00,096916,Altintas De Callaf; Ilkay,30,0,30,0
1668093830279,ECE 200,001,103586,Antipa; Nicholas A,9999,0,9999,0
1668093830279,ECE 200,002,103587,Atanasov; Nikolay A.,9999,0,9999,0
1668093830279,ECE 200,003,103588,Bharadia; Dinesh,9999,0,9999,0
1668093830279,ECE 200,004,103589,Cheng; Chung Kuan,9999,0,9999,0
1668093830279,ECE 200,005,103590,Cosman; Pamela C.,9999,0,9999,0
1668093830279,ECE 200,006,103591,Dayeh; Shadi Ahmad,9999,0,9999,0
1668093830279,ECE 200,007,103592,Fainman; Yeshaiahu,9999,0,9999,0
1668093830279,ECE 200,008,103593,Ford; Joseph Earl,9999,0,9999,0
1668093830279,ECE 200,009,103594,Franceschetti; Massimo,9999,0,9999,0
1668093830279,ECE 200,010,103595,Fullerton; Eric E,9999,0,9999,0
1668093830279,ECE 200,011,103596,Galton; Ian A,9999,0,9999,0
1668093830279,ECE 200,012,103597,Gilja; Vikash,9999,0,9999,0
1668093830279,ECE 200,013,103598,Hall; Drew A.,9999,0,9999,0
1668093830279,ECE 200,014,103599,Hsueh; Tzu-Chien,9999,0,9999,0
1668093830279,ECE 200,015,103600,Javidi; Tara,9999,0,9999,0
1668093830279,ECE 200,016,103601,Kahng; Andrew Byun,9999,0,9999,0
1668093830279,ECE 200,017,103602,Kim; Young-Han,9999,0,9999,0
1668093830279,ECE 200,018,103603,Koushanfar; Farinaz,9999,0,9999,0
1668093830279,ECE 200,019,103604,Kuzum; Duygu,9999,0,9999,0
1668093830279,ECE 200,020,103605,Le; Hanh-Phuc,9999,0,9999,0
1668093830279,ECE 200,021,103606,Lin; Bill,9999,0,9999,0
1668093830279,ECE 200,022,103607,Liu; Zhaowei,9998,0,9999,1
1668093830279,ECE 200,023,103608,Lo; Yu-Hwa,9999,0,9999,0
1668093830279,ECE 200,024,103609,Lomakin; Vitaliy,9999,0,9999,0
1668093830279,ECE 200,025,103610,Mercier; Patrick Philip,9999,0,9999,0
1668093830279,ECE 200,026,103611,Meyer; Florian,9999,0,9999,0
1668093830279,ECE 200,027,103612,Milstein; Laurence B.,9999,0,9999,0
1668093830279,ECE 200,028,103613,Mir Arabbaygi; Siavash,9999,0,9999,0
1668093830279,ECE 200,029,103614,Mookherjea; Shayan,9999,0,9999,0
1668093830279,ECE 200,030,103615,Morris; Karcher William,9999,0,9999,0
1668093830279,ECE 200,031,103616,Ng; Tse Nga,9999,0,9999,0
1668093830279,ECE 200,032,103617,Nguyen; Truong Quang,9999,0,9999,0
1668093830279,ECE 200,033,103618,Nomura; Kenji,9999,0,9999,0
1668093830279,ECE 200,034,103619,Orlitsky; Alon,9999,0,9999,0
1668093830279,ECE 200,035,103620,Pal; Piya,9999,0,9999,0
1668093830279,ECE 200,036,103621,Papen; George C.,9999,0,9999,0
1668093830279,ECE 200,037,103622,Radic; Stojan,9999,0,9999,0
1668093830279,ECE 200,038,103623,Rao; Bhaskar D.,9999,0,9999,0
1668093830279,ECE 200,039,103624,Rao; Ramesh R,9999,0,9999,0
1668093830279,ECE 200,040,103625,Rebeiz; Gabriel,9999,0,9999,0
1668093830279,ECE 200,041,103626,Sanford; John R,9999,0,9999,0
1668093830279,ECE 200,042,103627,Siegel; Paul H.,9999,0,9999,0
1668093830279,ECE 200,043,103628,Sievenpiper; Daniel F.,9999,0,9999,0
1668093830279,ECE 200,044,103629,Sworder; David D.,9999,0,9999,0
1668093830279,ECE 200,045,103630,Taur; Yuan,9999,0,9999,0
1668093830279,ECE 200,046,103631,Touri; Behrouz,9999,0,9999,0
1668093830279,ECE 200,047,103632,Trivedi; Mohan M.,9999,0,9999,0
1668093830279,ECE 200,048,103633,Vasconcelos; Nuno,9999,0,9999,0
1668093830279,ECE 200,049,103634,Wang; Xiaolong,9999,0,9999,0
1668093830279,ECE 200,050,103635,Xie; Pengtao,9999,0,9999,0
1668093830279,ECE 200,051,103636,Yip; Michael,9999,0,9999,0
1668093830279,ECE 200,052,103637,Zeger; Kenneth A.,999,0,999,0
1668093830279,ECE 200,053,103638,Zhang; Xinyu,9999,0,9999,0
1668093830279,ECE 200,054,103639,Turakhia; Yatish Girish,9999,0,9999,0
1668093830279,ECE 200,055,103640,Kang; Mingu,9999,0,9999,0
1668093830279,ECE 200,056,103641,Shi; Yuanyuan,9999,0,9999,0
1668093830279,ECE 200,057,103642,Wang; Edward Jay,9999,0,9999,0
1668093830279,ECE 200,058,103643,Zheng; Yang,9999,0,9999,0
1668093830706,ECE 202,A00,103644,Kuzum; Duygu,0,0,0,0
1668093831130,ECE 212BN,A00,103646,Ng; Tse Nga,0,0,0,0
1668093831559,ECE 221,A00,111493,Staff,0,0,0,0
1668093831986,ECE 222B,A00,103647,Lomakin; Vitaliy,0,0,0,0
1668093832413,ECE 230B,A00,103648,Taur; Yuan,0,0,0,0
1668093832842,ECE 238B,A00,103649,Garay; Javier,0,0,0,0
1668093833273,ECE 240B,A00,112900,Fainman; Yeshaiahu,0,0,0,0
1668093833700,ECE 247A,A00,103650,Jokerst; Jesse Vincent,0,0,0,0
1668093834134,ECE 247B,A00,103651,Wang; Joseph,0,0,0,0
1668093834557,ECE 250,A00,103652,Siegel; Paul H.,0,0,0,0
1668093834979,ECE 251A,A00,103654,Rao; Bhaskar D.,0,0,0,0
1668093835403,ECE 257B,A00,103655,Bharadia; Dinesh,0,0,0,0
1668093835826,ECE 258A,A00,103656,Milstein; Laurence B.,0,0,0,0
1668093836249,ECE 260B,A00,103658,Kang; Mingu,0,0,0,0
1668093836676,ECE 264A,A00,103659,Galton; Ian A,0,0,0,0
1668093837100,ECE 265A,A00,103661,Gudem; Prasad S.S.,0,0,0,0
1668093837530,ECE 265D,A00,103662,Gudem; Prasad S.S.,0,0,0,0
1668093837954,ECE 268,A00,103663,Koushanfar; Farinaz,0,0,0,0
1668093838404,ECE 269,A01,103665,Pal; Piya,0,0,0,0
1668093838829,ECE 271B,A00,103666,Vasconcelos; Manuela,0,0,0,0
1668093839253,ECE 276A,A00,103667,Atanasov; Nikolay A.,0,0,0,0
1668093839682,ECE 277,A00,103668,An; Cheolhong,0,0,0,0
1668093840108,ECE 279,A00,117947,Hall; Drew A.,0,0,0,0
1668093840961,ECE 283,A00,103670,Hsueh; Tzu-Chien,0,0,0,0
1668093841391,ECE 284,A00,103671,Turakhia; Yatish Girish,0,0,0,0
1668093841813,ECE 285,A00,103672,Zheng; Yang,0,0,0,0
1668093841813,ECE 285,B00,103673,Sworder; David D.,0,0,0,0
1668093842241,ECE 287,A00,103676,Javidi; Tara,0,0,0,0
1668093842667,MATH 200B,A00,098023,Salehi Golsefidy; Alireza,13,0,15,2
1668093843103,MATH 202B,A00,098024,Rhoades; Brendon Patrick,9,0,15,6
1668093843528,MATH 203B,A00,098025,Oprea; Dragos N.,10,0,15,5
1668093843958,MATH 204B,A00,098026,Sorensen; Claus M,13,0,15,2
1668093844386,MATH 208,A00,098027,Izadi; Elham,7,0,10,3
1668093844823,MATH 209,A00,098028,Pollack; Aaron,10,0,10,0
1668093845259,MATH 211A,A00,112919,Rogalski; Daniel,9,0,10,1
1668093845684,MATH 211B,A00,112920,Seward; Brandon M.,9,0,10,1
1668093846203,MATH 218,A00,098029,Li; Bo,10,0,10,0
1668093846626,MATH 220B,A00,098030,Novak; Jonathan I,12,0,15,3
1668093847049,MATH 221A,A00,098031,Ebenfelt; Peter F,13,0,15,2
1668093847481,MATH 231B,A00,098032,Zlatos; Andrej,12,0,15,3
1668093847905,MATH 240B,A00,098033,Ni; Lei,9,0,15,6
1668093848329,MATH 243,A00,098034,Jekel; David Andrew,10,0,10,0
1668093848764,MATH 245A,A00,098035,Nie; Jiawang,0,0,15,16
1668093849187,MATH 248,A00,098036,Bejenaru; Ioan,10,0,10,0
1668093849610,MATH 250B,A00,098037,Spolaor; Luca,14,0,15,1
1668093850037,MATH 258,A00,098038,Ni; Lei,10,0,10,0
1668093850463,MATH 264B,A00,098041,Rhoades; Brendon Patrick,10,0,15,5
1668093850889,MATH 268,A00,098042,Buss; Samuel R,10,0,10,0
1668093851321,MATH 269,A00,098043,Rhoades; Brendon Patrick,10,0,10,0
1668093851761,MATH 270B,A00,098044,Li; Bo,11,0,15,4
1668093852190,MATH 272B,A00,098045,Holst; Michael J,13,0,15,2
1668093852614,MATH 273A,A00,098046,Tian; Xiaochuan,10,0,15,5
1668093853042,MATH 275,A01,098048,Tian; Xiaochuan,6,0,10,4
1668093853464,MATH 278A,A00,098049,Holst; Michael J,8,0,10,2
1668093853892,MATH 278B,A00,098050,Cloninger; Alexander,10,0,10,0
1668093854330,MATH 278C,A00,098051,Nie; Jiawang,7,0,10,3
1668093854758,MATH 280B,A00,098052,Zheng; Tianyi,10,0,15,5
1668093855183,MATH 281B,A00,098053,Bradic; Jelena,3,0,15,12
1668093855604,MATH 282B,A00,098054,Arias-Castro; Ery,0,0,15,15
1668093856027,MATH 285,A00,098055,Fitzsimmons; Patrick J,0,0,15,17
1668093856455,MATH 287B,A00,098056,Arias-Castro; Ery,3,0,15,12
1668093856881,MATH 288,A00,098057,Agarwal; Pooja,9,0,10,1
1668093856881,MATH 288,B00,098058,Zhang; Danna,8,0,10,2
1668093856881,MATH 288,C00,098059,Williams; Ruth J,10,0,10,0
1668093857319,MATH 290B,A00,098060,Roberts; Justin Deritter,13,0,15,2
1668093857745,MATH 292,A00,098061,Belmont; Eva Kinoshita,10,0,10,0
1668093858178,MATH 295,A00,098062,Suk; Andrew Hoon,48,0,50,2
1668093858608,MATH 296,A00,098063,Novak; Jonathan I,20,0,20,0
1668093859032,MATH 297,001,098064,Gamst; Anthony Collins,9997,0,9999,2
1668094360037,COGS 205,A00,101395,Chiba; Andrea,19,0,20,1
1668094360461,COGS 210B,001,101404,Greene; Deanna Jacquelyn,9998,0,9999,1
1668094360461,COGS 210B,002,101417,Xia; Haijun,9999,0,9999,0
1668094360461,COGS 210B,003,101422,Nitz; Douglas A.,9999,0,9999,0
1668094360461,COGS 210B,004,101423,Hollan; James D.,9998,0,9999,1
1668094360461,COGS 210B,005,101424,Deak; Gedeon O.,9998,0,9999,1
1668094360461,COGS 210B,006,101425,Rossano; Federico,9999,0,9999,0
1668094360886,COGS 211B,A00,101427,Coulson; Seana M,9996,0,9999,3
1668094361309,COGS 220,A00,101428,Hollan; James D.,0,0,25,25
1668094361732,COGS 229,A00,101429,Dow; Steven P,18,0,25,7
1668094362157,COGS 230,A00,101430,Klemmer; Scott R,13,0,17,4
1668094362588,COGS 234,A00,101431,Xia; Haijun,3,0,25,22
1668094363010,COGS 260,A00,101432,Kiyonaga; Anastasia,19,0,25,6
1668094363010,COGS 260,B00,101433,Kirsh; David Joel,16,0,25,9
1668094363432,CSE 202,A00,102371,Impagliazzo; Russell,0,0,0,0
1668094363866,CSE 203B,A01,102373,Cheng; Chung Kuan,0,0,0,0
1668094364304,CSE 208,A00,102374,Micciancio; Daniele,0,0,0,0
1668094364743,CSE 209A,A00,112895,Impagliazzo; Russell,0,0,15,15
1668094365169,CSE 209B,A00,108005,Bellare; Mihir,0,0,0,0
1668094365593,CSE 210,A00,113163,Coblenz; Michael J,0,0,0,0
1668094366028,CSE 219,A00,106111,Dow; Steven P,0,0,20,20
1668094366460,CSE 221,A00,102376,Voelker; Geoffrey M.,0,0,0,0
1668094366883,CSE 224,A01,102378,Porter; George M,0,0,0,0
1668094367378,CSE 229A,A00,102379,Savage; Stefan,0,0,0,0
1668094367802,CSE 229C,A00,102380,Munyaka; Imani N. S.,0,0,0,0
1668094368241,CSE 232B,A00,102382,Deutsch; Alin Bernard,0,0,0,0
1668094368672,CSE 234,A01,112904,Kumar; Arun Kumar,0,0,0,0
1668094369097,CSE 237A,A00,102383,Rosing; Tajana Simunic,0,0,0,0
1668094369521,CSE 239A,A00,102384,Deutsch; Alin Bernard,0,0,0,0
1668094369947,CSE 239B,A00,102385,Polikarpova; Nadezhda,0,0,0,0
1668094370368,CSE 240A,A00,102386,Pannuto; Patrick William,0,0,0,0
1668094370792,CSE 240B,A00,102387,Zhao; Jishen,0,0,0,0
1668094371228,CSE 241A,A00,106406,Kang; Mingu,0,0,0,0
1668094371650,CSE 249B,A00,102388,Kahng; Andrew Byun,0,0,8,8
1668094372081,CSE 251B,A01,102392,Cottrell; Garrison W,0,0,0,0
1668094372081,CSE 251B,A02,102393,Cottrell; Garrison W,0,0,0,0
1668094372507,CSE 252B,A00,102394,Ochoa; Benjamin Lawrence,0,0,0,0
1668094372931,CSE 257,A01,102396,Gao; Sicun,0,0,0,0
1668094373357,CSE 272,A00,102397,Li; Tzumao,0,0,0,0
1668094373781,CSE 274,A00,111323,Chern; Albert Ren-Haur,0,0,0,0
1668094374204,CSE 282,A00,102398,Pevzner; Pavel Arkadjevich,0,0,0,0
1668094374632,CSE 284,A00,114175,Gymrek; Melissa Ann,0,0,0,0
1668094375060,CSE 290,A00,102399,Chandraker; Manmohan Krishna,0,0,0,0
1668094375060,CSE 290,B00,102400,Vaccaro; Kristen Marie,0,0,25,25
1668094375060,CSE 290,C00,102414,Pannuto; Patrick William,0,0,25,25
1668094375060,CSE 290,D00,102427,Pevzner; Pavel Arkadjevich,0,0,0,0
1668094375060,CSE 290,E00,102429,Zhao; Jishen,0,0,0,0
1668094375060,CSE 290,F00,102436,Tullsen; Dean Michael,0,0,0,0
1668094375060,CSE 290,G00,102440,Christensen; Henrik I,0,0,20,20
1668094375485,CSE 291,A00,102443,Su; Hao,0,0,0,0
1668094375485,CSE 291,B00,102448,Polikarpova; Nadezhda,0,0,0,0
1668094375485,CSE 291,C00,102453,Vaccaro; Kristen Marie,0,0,0,0
1668094375485,CSE 291,D00,111343,Savage; Stefan,0,0,0,0
1668094375485,CSE 291,E00,116474,Claffy; Kimberly Claire,0,0,0,0
1668094375485,CSE 291,F00,116479,Pasquale; Joseph,0,0,0,0
1668094375910,CSE 293,001,119111,Bafna; Vineet,9999,0,9999,0
1668094375910,CSE 293,002,119118,Bellare; Mihir,9999,0,9999,0
1668094375910,CSE 293,003,119122,Berg-Kirkpatrick; Taylor D,9999,0,9999,0
1668094375910,CSE 293,004,119135,Christensen; Henrik I,9999,0,9999,0
1668094375910,CSE 293,005,119142,Cottrell; Garrison W,9999,0,9999,0
1668094375910,CSE 293,006,119146,Deutsch; Alin Bernard,9999,0,9999,0
1668094375910,CSE 293,007,119159,Esmaeilzadeh; Hadi,9999,0,9999,0
1668094375910,CSE 293,008,119166,Freund; Yoav,9999,0,9999,0
1668094375910,CSE 293,009,119170,Griswold; William G.,9999,0,9999,0
1668094375910,CSE 293,010,119183,Gymrek; Melissa Ann,9999,0,9999,0
1668094375910,CSE 293,011,119190,Heninger; Nadia A,9999,0,9999,0
1668094375910,CSE 293,012,119230,Impagliazzo; Russell,9999,0,9999,0
1668094375910,CSE 293,013,119232,Jhala; Ranjit,9999,0,9999,0
1668094375910,CSE 293,014,119233,Kahng; Andrew Byun,9999,0,9999,0
1668094375910,CSE 293,015,119298,Kane; Daniel Mertz,9999,0,9999,0
1668094375910,CSE 293,016,119299,Kriegman; David J,9999,0,9999,0
1668094375910,CSE 293,017,119300,Kumar; Arun Kumar,9999,0,9999,0
1668094375910,CSE 293,018,119301,Lerner; Sorin,9999,0,9999,0
1668094375910,CSE 293,019,119302,Lovett; Shachar,9999,0,9999,0
1668094375910,CSE 293,020,119303,McAuley; Julian John,9999,0,9999,0
1668094375910,CSE 293,021,119304,Micciancio; Daniele,9999,0,9999,0
1668094375910,CSE 293,022,119367,Orailoglu; Alex,9999,0,9999,0
1668094375910,CSE 293,023,119382,Paturi; Ramamohan,9999,0,9999,0
1668094375910,CSE 293,024,119404,Polikarpova; Nadezhda,9999,0,9999,0
1668094375910,CSE 293,025,119406,Politz; Joseph Gibbs,9999,0,9999,0
1668094375910,CSE 293,026,119411,Porter; George M,9999,0,9999,0
1668094375910,CSE 293,027,119414,Porter; Leonard Emerson,9999,0,9999,0
1668094375910,CSE 293,028,119416,Ramamoorthi; Ravi,9999,0,9999,0
1668094375910,CSE 293,029,119417,Sahoo; Debashis,9999,0,9999,0
1668094375910,CSE 293,030,119420,Saul; Lawrence,9999,0,9999,0
1668094375910,CSE 293,031,119421,Savage; Stefan,9999,0,9999,0
1668094375910,CSE 293,032,119425,Schulze; Jurgen P.,9999,0,9999,0
1668094375910,CSE 293,033,119426,Snoeren; Alex C.,9999,0,9999,0
1668094375910,CSE 293,034,119428,Shang; Jingbo,9999,0,9999,0
1668094375910,CSE 293,035,119430,Stefan; Deian,9999,0,9999,0
1668094375910,CSE 293,036,119431,Su; Hao,9999,0,9999,0
1668094375910,CSE 293,037,119433,Swanson; Steven James,9999,0,9999,0
1668094375910,CSE 293,038,119435,Tullsen; Dean Michael,9999,0,9999,0
1668094375910,CSE 293,039,119483,Voelker; Geoffrey M.,9999,0,9999,0
1668094375910,CSE 293,040,119537,Zhao; Jishen,9999,0,9999,0
1668094375910,CSE 293,041,119538,Zhou; Yuan-Yuan,9999,0,9999,0
1668094375910,CSE 293,042,119539,Gao; Sicun,9999,0,9999,0
1668094375910,CSE 293,043,119540,Weibel; Nadir,9999,0,9999,0
1668094375910,CSE 293,044,119541,Gupta; Rajesh K.,9999,0,9999,0
1668094375910,CSE 293,045,126410,Vaccaro; Kristen Marie,9999,0,9999,0
1668094375910,CSE 293,046,126411,Klemke; Richard,9999,0,9999,0
1668094376336,CSE 294,A00,102459,Voelker; Geoffrey M.,0,0,0,0
1668094376336,CSE 294,B00,111322,Orailoglu; Alex,0,0,0,0
1668094376774,DSE 201,A00,096914,Deutsch; Alin Bernard,30,0,30,0
1668094377201,DSE 210,A00,096915,Dasgupta; Sanjoy,30,0,30,0
1668094377622,DSE 260A,A00,096916,Altintas De Callaf; Ilkay,30,0,30,0
1668094378058,ECE 200,001,103586,Antipa; Nicholas A,9999,0,9999,0
1668094378058,ECE 200,002,103587,Atanasov; Nikolay A.,9999,0,9999,0
1668094378058,ECE 200,003,103588,Bharadia; Dinesh,9999,0,9999,0
1668094378058,ECE 200,004,103589,Cheng; Chung Kuan,9999,0,9999,0
1668094378058,ECE 200,005,103590,Cosman; Pamela C.,9999,0,9999,0
1668094378058,ECE 200,006,103591,Dayeh; Shadi Ahmad,9999,0,9999,0
1668094378058,ECE 200,007,103592,Fainman; Yeshaiahu,9999,0,9999,0
1668094378058,ECE 200,008,103593,Ford; Joseph Earl,9999,0,9999,0
1668094378058,ECE 200,009,103594,Franceschetti; Massimo,9999,0,9999,0
1668094378058,ECE 200,010,103595,Fullerton; Eric E,9999,0,9999,0
1668094378058,ECE 200,011,103596,Galton; Ian A,9999,0,9999,0
1668094378058,ECE 200,012,103597,Gilja; Vikash,9999,0,9999,0
1668094378058,ECE 200,013,103598,Hall; Drew A.,9999,0,9999,0
1668094378058,ECE 200,014,103599,Hsueh; Tzu-Chien,9999,0,9999,0
1668094378058,ECE 200,015,103600,Javidi; Tara,9999,0,9999,0
1668094378058,ECE 200,016,103601,Kahng; Andrew Byun,9999,0,9999,0
1668094378058,ECE 200,017,103602,Kim; Young-Han,9999,0,9999,0
1668094378058,ECE 200,018,103603,Koushanfar; Farinaz,9999,0,9999,0
1668094378058,ECE 200,019,103604,Kuzum; Duygu,9999,0,9999,0
1668094378058,ECE 200,020,103605,Le; Hanh-Phuc,9999,0,9999,0
1668094378058,ECE 200,021,103606,Lin; Bill,9999,0,9999,0
1668094378058,ECE 200,022,103607,Liu; Zhaowei,9998,0,9999,1
1668094378058,ECE 200,023,103608,Lo; Yu-Hwa,9999,0,9999,0
1668094378058,ECE 200,024,103609,Lomakin; Vitaliy,9999,0,9999,0
1668094378058,ECE 200,025,103610,Mercier; Patrick Philip,9999,0,9999,0
1668094378058,ECE 200,026,103611,Meyer; Florian,9999,0,9999,0
1668094378058,ECE 200,027,103612,Milstein; Laurence B.,9999,0,9999,0
1668094378058,ECE 200,028,103613,Mir Arabbaygi; Siavash,9999,0,9999,0
1668094378058,ECE 200,029,103614,Mookherjea; Shayan,9999,0,9999,0
1668094378058,ECE 200,030,103615,Morris; Karcher William,9999,0,9999,0
1668094378058,ECE 200,031,103616,Ng; Tse Nga,9999,0,9999,0
1668094378058,ECE 200,032,103617,Nguyen; Truong Quang,9999,0,9999,0
1668094378058,ECE 200,033,103618,Nomura; Kenji,9999,0,9999,0
1668094378058,ECE 200,034,103619,Orlitsky; Alon,9999,0,9999,0
1668094378058,ECE 200,035,103620,Pal; Piya,9999,0,9999,0
1668094378058,ECE 200,036,103621,Papen; George C.,9999,0,9999,0
1668094378058,ECE 200,037,103622,Radic; Stojan,9999,0,9999,0
1668094378058,ECE 200,038,103623,Rao; Bhaskar D.,9999,0,9999,0
1668094378058,ECE 200,039,103624,Rao; Ramesh R,9999,0,9999,0
1668094378058,ECE 200,040,103625,Rebeiz; Gabriel,9999,0,9999,0
1668094378058,ECE 200,041,103626,Sanford; John R,9999,0,9999,0
1668094378058,ECE 200,042,103627,Siegel; Paul H.,9999,0,9999,0
1668094378058,ECE 200,043,103628,Sievenpiper; Daniel F.,9999,0,9999,0
1668094378058,ECE 200,044,103629,Sworder; David D.,9999,0,9999,0
1668094378058,ECE 200,045,103630,Taur; Yuan,9999,0,9999,0
1668094378058,ECE 200,046,103631,Touri; Behrouz,9999,0,9999,0
1668094378058,ECE 200,047,103632,Trivedi; Mohan M.,9999,0,9999,0
1668094378058,ECE 200,048,103633,Vasconcelos; Nuno,9999,0,9999,0
1668094378058,ECE 200,049,103634,Wang; Xiaolong,9999,0,9999,0
1668094378058,ECE 200,050,103635,Xie; Pengtao,9999,0,9999,0
1668094378058,ECE 200,051,103636,Yip; Michael,9999,0,9999,0
1668094378058,ECE 200,052,103637,Zeger; Kenneth A.,999,0,999,0
1668094378058,ECE 200,053,103638,Zhang; Xinyu,9999,0,9999,0
1668094378058,ECE 200,054,103639,Turakhia; Yatish Girish,9999,0,9999,0
1668094378058,ECE 200,055,103640,Kang; Mingu,9999,0,9999,0
1668094378058,ECE 200,056,103641,Shi; Yuanyuan,9999,0,9999,0
1668094378058,ECE 200,057,103642,Wang; Edward Jay,9999,0,9999,0
1668094378058,ECE 200,058,103643,Zheng; Yang,9999,0,9999,0
1668094378481,ECE 202,A00,103644,Kuzum; Duygu,0,0,0,0
1668094378908,ECE 212BN,A00,103646,Ng; Tse Nga,0,0,0,0
1668094379332,ECE 221,A00,111493,Staff,0,0,0,0
1668094379769,ECE 222B,A00,103647,Lomakin; Vitaliy,0,0,0,0
1668094380201,ECE 230B,A00,103648,Taur; Yuan,0,0,0,0
1668094380635,ECE 238B,A00,103649,Garay; Javier,0,0,0,0
1668094381062,ECE 240B,A00,112900,Fainman; Yeshaiahu,0,0,0,0
1668094381485,ECE 247A,A00,103650,Jokerst; Jesse Vincent,0,0,0,0
1668094381917,ECE 247B,A00,103651,Wang; Joseph,0,0,0,0
1668094382343,ECE 250,A00,103652,Siegel; Paul H.,0,0,0,0
1668094382774,ECE 251A,A00,103654,Rao; Bhaskar D.,0,0,0,0
1668094383208,ECE 257B,A00,103655,Bharadia; Dinesh,0,0,0,0
1668094383632,ECE 258A,A00,103656,Milstein; Laurence B.,0,0,0,0
1668094384063,ECE 260B,A00,103658,Kang; Mingu,0,0,0,0
1668094384489,ECE 264A,A00,103659,Galton; Ian A,0,0,0,0
1668094384912,ECE 265A,A00,103661,Gudem; Prasad S.S.,0,0,0,0
1668094385338,ECE 265D,A00,103662,Gudem; Prasad S.S.,0,0,0,0
1668094385761,ECE 268,A00,103663,Koushanfar; Farinaz,0,0,0,0
1668094386185,ECE 269,A01,103665,Pal; Piya,0,0,0,0
1668094386615,ECE 271B,A00,103666,Vasconcelos; Manuela,0,0,0,0
1668094387039,ECE 276A,A00,103667,Atanasov; Nikolay A.,0,0,0,0
1668094387464,ECE 277,A00,103668,An; Cheolhong,0,0,0,0
1668094387887,ECE 279,A00,117947,Hall; Drew A.,0,0,0,0
1668094388742,ECE 283,A00,103670,Hsueh; Tzu-Chien,0,0,0,0
1668094389165,ECE 284,A00,103671,Turakhia; Yatish Girish,0,0,0,0
1668094389589,ECE 285,A00,103672,Zheng; Yang,0,0,0,0
1668094389589,ECE 285,B00,103673,Sworder; David D.,0,0,0,0
1668094390013,ECE 287,A00,103676,Javidi; Tara,0,0,0,0
1668094390446,MATH 200B,A00,098023,Salehi Golsefidy; Alireza,13,0,15,2
1668094390871,MATH 202B,A00,098024,Rhoades; Brendon Patrick,9,0,15,6
1668094391309,MATH 203B,A00,098025,Oprea; Dragos N.,10,0,15,5
1668094391740,MATH 204B,A00,098026,Sorensen; Claus M,13,0,15,2
1668094392170,MATH 208,A00,098027,Izadi; Elham,7,0,10,3
1668094392599,MATH 209,A00,098028,Pollack; Aaron,10,0,10,0
1668094393023,MATH 211A,A00,112919,Rogalski; Daniel,9,0,10,1
1668094393446,MATH 211B,A00,112920,Seward; Brandon M.,9,0,10,1
1668094393876,MATH 218,A00,098029,Li; Bo,10,0,10,0
1668094394311,MATH 220B,A00,098030,Novak; Jonathan I,12,0,15,3
1668094394747,MATH 221A,A00,098031,Ebenfelt; Peter F,13,0,15,2
1668094395170,MATH 231B,A00,098032,Zlatos; Andrej,12,0,15,3
1668094395593,MATH 240B,A00,098033,Ni; Lei,9,0,15,6
1668094396020,MATH 243,A00,098034,Jekel; David Andrew,10,0,10,0
1668094396445,MATH 245A,A00,098035,Nie; Jiawang,0,0,15,16
1668094396871,MATH 248,A00,098036,Bejenaru; Ioan,10,0,10,0
1668094397296,MATH 250B,A00,098037,Spolaor; Luca,14,0,15,1
1668094397720,MATH 258,A00,098038,Ni; Lei,10,0,10,0
1668094398151,MATH 264B,A00,098041,Rhoades; Brendon Patrick,10,0,15,5
1668094398590,MATH 268,A00,098042,Buss; Samuel R,10,0,10,0
1668094399014,MATH 269,A00,098043,Rhoades; Brendon Patrick,10,0,10,0
1668094399438,MATH 270B,A00,098044,Li; Bo,11,0,15,4
1668094399866,MATH 272B,A00,098045,Holst; Michael J,13,0,15,2
1668094400291,MATH 273A,A00,098046,Tian; Xiaochuan,10,0,15,5
1668094400722,MATH 275,A01,098048,Tian; Xiaochuan,6,0,10,4
1668094401159,MATH 278A,A00,098049,Holst; Michael J,8,0,10,2
1668094401581,MATH 278B,A00,098050,Cloninger; Alexander,10,0,10,0
1668094402008,MATH 278C,A00,098051,Nie; Jiawang,7,0,10,3
1668094402434,MATH 280B,A00,098052,Zheng; Tianyi,10,0,15,5
1668094402864,MATH 281B,A00,098053,Bradic; Jelena,3,0,15,12
1668094403290,MATH 282B,A00,098054,Arias-Castro; Ery,0,0,15,15
1668094403714,MATH 285,A00,098055,Fitzsimmons; Patrick J,0,0,15,17
1668094404153,MATH 287B,A00,098056,Arias-Castro; Ery,3,0,15,12
1668094404577,MATH 288,A00,098057,Agarwal; Pooja,9,0,10,1
1668094404577,MATH 288,B00,098058,Zhang; Danna,8,0,10,2
1668094404577,MATH 288,C00,098059,Williams; Ruth J,10,0,10,0
1668094405002,MATH 290B,A00,098060,Roberts; Justin Deritter,13,0,15,2
1668094405428,MATH 292,A00,098061,Belmont; Eva Kinoshita,10,0,10,0
1668094405852,MATH 295,A00,098062,Suk; Andrew Hoon,48,0,50,2
1668094406276,MATH 296,A00,098063,Novak; Jonathan I,20,0,20,0
1668094406702,MATH 297,001,098064,Gamst; Anthony Collins,9997,0,9999,2
1668094907998,COGS 205,A00,101395,Chiba; Andrea,19,0,20,1
1668094908430,COGS 210B,001,101404,Greene; Deanna Jacquelyn,9998,0,9999,1
1668094908430,COGS 210B,002,101417,Xia; Haijun,9999,0,9999,0
1668094908430,COGS 210B,003,101422,Nitz; Douglas A.,9999,0,9999,0
1668094908430,COGS 210B,004,101423,Hollan; James D.,9998,0,9999,1
1668094908430,COGS 210B,005,101424,Deak; Gedeon O.,9998,0,9999,1
1668094908430,COGS 210B,006,101425,Rossano; Federico,9999,0,9999,0
1668094908855,COGS 211B,A00,101427,Coulson; Seana M,9996,0,9999,3
1668094909283,COGS 220,A00,101428,Hollan; James D.,0,0,25,25
1668094909710,COGS 229,A00,101429,Dow; Steven P,18,0,25,7
1668094910134,COGS 230,A00,101430,Klemmer; Scott R,13,0,17,4
1668094910560,COGS 234,A00,101431,Xia; Haijun,3,0,25,22
1668094910987,COGS 260,A00,101432,Kiyonaga; Anastasia,19,0,25,6
1668094910987,COGS 260,B00,101433,Kirsh; David Joel,16,0,25,9
1668094911411,CSE 202,A00,102371,Impagliazzo; Russell,0,0,0,0
1668094911838,CSE 203B,A01,102373,Cheng; Chung Kuan,0,0,0,0
1668094912262,CSE 208,A00,102374,Micciancio; Daniele,0,0,0,0
1668094912690,CSE 209A,A00,112895,Impagliazzo; Russell,0,0,15,15
1668094913117,CSE 209B,A00,108005,Bellare; Mihir,0,0,0,0
1668094913549,CSE 210,A00,113163,Coblenz; Michael J,0,0,0,0
1668094913983,CSE 219,A00,106111,Dow; Steven P,0,0,20,20
1668094914411,CSE 221,A00,102376,Voelker; Geoffrey M.,0,0,0,0
1668094914846,CSE 224,A01,102378,Porter; George M,0,0,0,0
1668094915274,CSE 229A,A00,102379,Savage; Stefan,0,0,0,0
1668094915714,CSE 229C,A00,102380,Munyaka; Imani N. S.,0,0,0,0
1668094916138,CSE 232B,A00,102382,Deutsch; Alin Bernard,0,0,0,0
1668094916561,CSE 234,A01,112904,Kumar; Arun Kumar,0,0,0,0
1668094916986,CSE 237A,A00,102383,Rosing; Tajana Simunic,0,0,0,0
1668094917415,CSE 239A,A00,102384,Deutsch; Alin Bernard,0,0,0,0
1668094917841,CSE 239B,A00,102385,Polikarpova; Nadezhda,0,0,0,0
1668094918278,CSE 240A,A00,102386,Pannuto; Patrick William,0,0,0,0
1668094918701,CSE 240B,A00,102387,Zhao; Jishen,0,0,0,0
1668094919178,CSE 241A,A00,106406,Kang; Mingu,0,0,0,0
1668094919602,CSE 249B,A00,102388,Kahng; Andrew Byun,0,0,8,8
1668094920042,CSE 251B,A01,102392,Cottrell; Garrison W,0,0,0,0
1668094920042,CSE 251B,A02,102393,Cottrell; Garrison W,0,0,0,0
1668094920469,CSE 252B,A00,102394,Ochoa; Benjamin Lawrence,0,0,0,0
1668094920891,CSE 257,A01,102396,Gao; Sicun,0,0,0,0
1668094921318,CSE 272,A00,102397,Li; Tzumao,0,0,0,0
1668094921747,CSE 274,A00,111323,Chern; Albert Ren-Haur,0,0,0,0
1668094922170,CSE 282,A00,102398,Pevzner; Pavel Arkadjevich,0,0,0,0
1668094922599,CSE 284,A00,114175,Gymrek; Melissa Ann,0,0,0,0
1668094923034,CSE 290,A00,102399,Chandraker; Manmohan Krishna,0,0,0,0
1668094923034,CSE 290,B00,102400,Vaccaro; Kristen Marie,0,0,25,25
1668094923034,CSE 290,C00,102414,Pannuto; Patrick William,0,0,25,25
1668094923034,CSE 290,D00,102427,Pevzner; Pavel Arkadjevich,0,0,0,0
1668094923034,CSE 290,E00,102429,Zhao; Jishen,0,0,0,0
1668094923034,CSE 290,F00,102436,Tullsen; Dean Michael,0,0,0,0
1668094923034,CSE 290,G00,102440,Christensen; Henrik I,0,0,20,20
1668094923458,CSE 291,A00,102443,Su; Hao,0,0,0,0
1668094923458,CSE 291,B00,102448,Polikarpova; Nadezhda,0,0,0,0
1668094923458,CSE 291,C00,102453,Vaccaro; Kristen Marie,0,0,0,0
1668094923458,CSE 291,D00,111343,Savage; Stefan,0,0,0,0
1668094923458,CSE 291,E00,116474,Claffy; Kimberly Claire,0,0,0,0
1668094923458,CSE 291,F00,116479,Pasquale; Joseph,0,0,0,0
1668094923902,CSE 293,001,119111,Bafna; Vineet,9999,0,9999,0
1668094923902,CSE 293,002,119118,Bellare; Mihir,9999,0,9999,0
1668094923902,CSE 293,003,119122,Berg-Kirkpatrick; Taylor D,9999,0,9999,0
1668094923902,CSE 293,004,119135,Christensen; Henrik I,9999,0,9999,0
1668094923902,CSE 293,005,119142,Cottrell; Garrison W,9999,0,9999,0
1668094923902,CSE 293,006,119146,Deutsch; Alin Bernard,9999,0,9999,0
1668094923902,CSE 293,007,119159,Esmaeilzadeh; Hadi,9999,0,9999,0
1668094923902,CSE 293,008,119166,Freund; Yoav,9999,0,9999,0
1668094923902,CSE 293,009,119170,Griswold; William G.,9999,0,9999,0
1668094923902,CSE 293,010,119183,Gymrek; Melissa Ann,9999,0,9999,0
1668094923902,CSE 293,011,119190,Heninger; Nadia A,9999,0,9999,0
1668094923902,CSE 293,012,119230,Impagliazzo; Russell,9999,0,9999,0
1668094923902,CSE 293,013,119232,Jhala; Ranjit,9999,0,9999,0
1668094923902,CSE 293,014,119233,Kahng; Andrew Byun,9999,0,9999,0
1668094923902,CSE 293,015,119298,Kane; Daniel Mertz,9999,0,9999,0
1668094923902,CSE 293,016,119299,Kriegman; David J,9999,0,9999,0
1668094923902,CSE 293,017,119300,Kumar; Arun Kumar,9999,0,9999,0
1668094923902,CSE 293,018,119301,Lerner; Sorin,9999,0,9999,0
1668094923902,CSE 293,019,119302,Lovett; Shachar,9999,0,9999,0
1668094923902,CSE 293,020,119303,McAuley; Julian John,9999,0,9999,0
1668094923902,CSE 293,021,119304,Micciancio; Daniele,9999,0,9999,0
1668094923902,CSE 293,022,119367,Orailoglu; Alex,9999,0,9999,0
1668094923902,CSE 293,023,119382,Paturi; Ramamohan,9999,0,9999,0
1668094923902,CSE 293,024,119404,Polikarpova; Nadezhda,9999,0,9999,0
1668094923902,CSE 293,025,119406,Politz; Joseph Gibbs,9999,0,9999,0
1668094923902,CSE 293,026,119411,Porter; George M,9999,0,9999,0
1668094923902,CSE 293,027,119414,Porter; Leonard Emerson,9999,0,9999,0
1668094923902,CSE 293,028,119416,Ramamoorthi; Ravi,9999,0,9999,0
1668094923902,CSE 293,029,119417,Sahoo; Debashis,9999,0,9999,0
1668094923902,CSE 293,030,119420,Saul; Lawrence,9999,0,9999,0
1668094923902,CSE 293,031,119421,Savage; Stefan,9999,0,9999,0
1668094923902,CSE 293,032,119425,Schulze; Jurgen P.,9999,0,9999,0
1668094923902,CSE 293,033,119426,Snoeren; Alex C.,9999,0,9999,0
1668094923902,CSE 293,034,119428,Shang; Jingbo,9999,0,9999,0
1668094923902,CSE 293,035,119430,Stefan; Deian,9999,0,9999,0
1668094923902,CSE 293,036,119431,Su; Hao,9999,0,9999,0
1668094923902,CSE 293,037,119433,Swanson; Steven James,9999,0,9999,0
1668094923902,CSE 293,038,119435,Tullsen; Dean Michael,9999,0,9999,0
1668094923902,CSE 293,039,119483,Voelker; Geoffrey M.,9999,0,9999,0
1668094923902,CSE 293,040,119537,Zhao; Jishen,9999,0,9999,0
1668094923902,CSE 293,041,119538,Zhou; Yuan-Yuan,9999,0,9999,0
1668094923902,CSE 293,042,119539,Gao; Sicun,9999,0,9999,0
1668094923902,CSE 293,043,119540,Weibel; Nadir,9999,0,9999,0
1668094923902,CSE 293,044,119541,Gupta; Rajesh K.,9999,0,9999,0
1668094923902,CSE 293,045,126410,Vaccaro; Kristen Marie,9999,0,9999,0
1668094923902,CSE 293,046,126411,Klemke; Richard,9999,0,9999,0
1668094924325,CSE 294,A00,102459,Voelker; Geoffrey M.,0,0,0,0
1668094924325,CSE 294,B00,111322,Orailoglu; Alex,0,0,0,0
1668094924749,DSE 201,A00,096914,Deutsch; Alin Bernard,30,0,30,0
1668094925176,DSE 210,A00,096915,Dasgupta; Sanjoy,30,0,30,0
1668094925603,DSE 260A,A00,096916,Altintas De Callaf; Ilkay,30,0,30,0
1668094926048,ECE 200,001,103586,Antipa; Nicholas A,9999,0,9999,0
1668094926048,ECE 200,002,103587,Atanasov; Nikolay A.,9999,0,9999,0
1668094926048,ECE 200,003,103588,Bharadia; Dinesh,9999,0,9999,0
1668094926048,ECE 200,004,103589,Cheng; Chung Kuan,9999,0,9999,0
1668094926048,ECE 200,005,103590,Cosman; Pamela C.,9999,0,9999,0
1668094926048,ECE 200,006,103591,Dayeh; Shadi Ahmad,9999,0,9999,0
1668094926048,ECE 200,007,103592,Fainman; Yeshaiahu,9999,0,9999,0
1668094926048,ECE 200,008,103593,Ford; Joseph Earl,9999,0,9999,0
1668094926048,ECE 200,009,103594,Franceschetti; Massimo,9999,0,9999,0
1668094926048,ECE 200,010,103595,Fullerton; Eric E,9999,0,9999,0
1668094926048,ECE 200,011,103596,Galton; Ian A,9999,0,9999,0
1668094926048,ECE 200,012,103597,Gilja; Vikash,9999,0,9999,0
1668094926048,ECE 200,013,103598,Hall; Drew A.,9999,0,9999,0
1668094926048,ECE 200,014,103599,Hsueh; Tzu-Chien,9999,0,9999,0
1668094926048,ECE 200,015,103600,Javidi; Tara,9999,0,9999,0
1668094926048,ECE 200,016,103601,Kahng; Andrew Byun,9999,0,9999,0
1668094926048,ECE 200,017,103602,Kim; Young-Han,9999,0,9999,0
1668094926048,ECE 200,018,103603,Koushanfar; Farinaz,9999,0,9999,0
1668094926048,ECE 200,019,103604,Kuzum; Duygu,9999,0,9999,0
1668094926048,ECE 200,020,103605,Le; Hanh-Phuc,9999,0,9999,0
1668094926048,ECE 200,021,103606,Lin; Bill,9999,0,9999,0
1668094926048,ECE 200,022,103607,Liu; Zhaowei,9998,0,9999,1
1668094926048,ECE 200,023,103608,Lo; Yu-Hwa,9999,0,9999,0
1668094926048,ECE 200,024,103609,Lomakin; Vitaliy,9999,0,9999,0
1668094926048,ECE 200,025,103610,Mercier; Patrick Philip,9999,0,9999,0
1668094926048,ECE 200,026,103611,Meyer; Florian,9999,0,9999,0
1668094926048,ECE 200,027,103612,Milstein; Laurence B.,9999,0,9999,0
1668094926048,ECE 200,028,103613,Mir Arabbaygi; Siavash,9999,0,9999,0
1668094926048,ECE 200,029,103614,Mookherjea; Shayan,9999,0,9999,0
1668094926048,ECE 200,030,103615,Morris; Karcher William,9999,0,9999,0
1668094926048,ECE 200,031,103616,Ng; Tse Nga,9999,0,9999,0
1668094926048,ECE 200,032,103617,Nguyen; Truong Quang,9999,0,9999,0
1668094926048,ECE 200,033,103618,Nomura; Kenji,9999,0,9999,0
1668094926048,ECE 200,034,103619,Orlitsky; Alon,9999,0,9999,0
1668094926048,ECE 200,035,103620,Pal; Piya,9999,0,9999,0
1668094926048,ECE 200,036,103621,Papen; George C.,9999,0,9999,0
1668094926048,ECE 200,037,103622,Radic; Stojan,9999,0,9999,0
1668094926048,ECE 200,038,103623,Rao; Bhaskar D.,9999,0,9999,0
1668094926048,ECE 200,039,103624,Rao; Ramesh R,9999,0,9999,0
1668094926048,ECE 200,040,103625,Rebeiz; Gabriel,9999,0,9999,0
1668094926048,ECE 200,041,103626,Sanford; John R,9999,0,9999,0
1668094926048,ECE 200,042,103627,Siegel; Paul H.,9999,0,9999,0
1668094926048,ECE 200,043,103628,Sievenpiper; Daniel F.,9999,0,9999,0
1668094926048,ECE 200,044,103629,Sworder; David D.,9999,0,9999,0
1668094926048,ECE 200,045,103630,Taur; Yuan,9999,0,9999,0
1668094926048,ECE 200,046,103631,Touri; Behrouz,9999,0,9999,0
1668094926048,ECE 200,047,103632,Trivedi; Mohan M.,9999,0,9999,0
1668094926048,ECE 200,048,103633,Vasconcelos; Nuno,9999,0,9999,0
1668094926048,ECE 200,049,103634,Wang; Xiaolong,9999,0,9999,0
1668094926048,ECE 200,050,103635,Xie; Pengtao,9999,0,9999,0
1668094926048,ECE 200,051,103636,Yip; Michael,9999,0,9999,0
1668094926048,ECE 200,052,103637,Zeger; Kenneth A.,999,0,999,0
1668094926048,ECE 200,053,103638,Zhang; Xinyu,9999,0,9999,0
1668094926048,ECE 200,054,103639,Turakhia; Yatish Girish,9999,0,9999,0
1668094926048,ECE 200,055,103640,Kang; Mingu,9999,0,9999,0
1668094926048,ECE 200,056,103641,Shi; Yuanyuan,9999,0,9999,0
1668094926048,ECE 200,057,103642,Wang; Edward Jay,9999,0,9999,0
1668094926048,ECE 200,058,103643,Zheng; Yang,9999,0,9999,0
1668094926477,ECE 202,A00,103644,Kuzum; Duygu,0,0,0,0
1668094926908,ECE 212BN,A00,103646,Ng; Tse Nga,0,0,0,0
1668094927331,ECE 221,A00,111493,Staff,0,0,0,0
1668094927755,ECE 222B,A00,103647,Lomakin; Vitaliy,0,0,0,0
1668094928180,ECE 230B,A00,103648,Taur; Yuan,0,0,0,0
1668094928609,ECE 238B,A00,103649,Garay; Javier,0,0,0,0
1668094929031,ECE 240B,A00,112900,Fainman; Yeshaiahu,0,0,0,0
1668094929467,ECE 247A,A00,103650,Jokerst; Jesse Vincent,0,0,0,0
1668094929895,ECE 247B,A00,103651,Wang; Joseph,0,0,0,0
1668094930327,ECE 250,A00,103652,Siegel; Paul H.,0,0,0,0
1668094930750,ECE 251A,A00,103654,Rao; Bhaskar D.,0,0,0,0
1668094931188,ECE 257B,A00,103655,Bharadia; Dinesh,0,0,0,0
1668094931613,ECE 258A,A00,103656,Milstein; Laurence B.,0,0,0,0
1668094932134,ECE 260B,A00,103658,Kang; Mingu,0,0,0,0
1668094932564,ECE 264A,A00,103659,Galton; Ian A,0,0,0,0
1668094932991,ECE 265A,A00,103661,Gudem; Prasad S.S.,0,0,0,0
1668094933414,ECE 265D,A00,103662,Gudem; Prasad S.S.,0,0,0,0
1668094933839,ECE 268,A00,103663,Koushanfar; Farinaz,0,0,0,0
1668094934277,ECE 269,A01,103665,Pal; Piya,0,0,0,0
1668094934700,ECE 271B,A00,103666,Vasconcelos; Manuela,0,0,0,0
1668094935122,ECE 276A,A00,103667,Atanasov; Nikolay A.,0,0,0,0
1668094935544,ECE 277,A00,103668,An; Cheolhong,0,0,0,0
1668094935974,ECE 279,A00,117947,Hall; Drew A.,0,0,0,0
1668094936833,ECE 283,A00,103670,Hsueh; Tzu-Chien,0,0,0,0
1668094937260,ECE 284,A00,103671,Turakhia; Yatish Girish,0,0,0,0
1668094937683,ECE 285,A00,103672,Zheng; Yang,0,0,0,0
1668094937683,ECE 285,B00,103673,Sworder; David D.,0,0,0,0
1668094938107,ECE 287,A00,103676,Javidi; Tara,0,0,0,0
1668094938535,MATH 200B,A00,098023,Salehi Golsefidy; Alireza,13,0,15,2
1668094938960,MATH 202B,A00,098024,Rhoades; Brendon Patrick,9,0,15,6
1668094939388,MATH 203B,A00,098025,Oprea; Dragos N.,10,0,15,5
1668094939813,MATH 204B,A00,098026,Sorensen; Claus M,13,0,15,2
1668094940236,MATH 208,A00,098027,Izadi; Elham,7,0,10,3
1668094940660,MATH 209,A00,098028,Pollack; Aaron,10,0,10,0
1668094941086,MATH 211A,A00,112919,Rogalski; Daniel,9,0,10,1
1668094941507,MATH 211B,A00,112920,Seward; Brandon M.,9,0,10,1
1668094941948,MATH 218,A00,098029,Li; Bo,10,0,10,0
1668094942375,MATH 220B,A00,098030,Novak; Jonathan I,12,0,15,3
1668094942809,MATH 221A,A00,098031,Ebenfelt; Peter F,13,0,15,2
1668094943233,MATH 231B,A00,098032,Zlatos; Andrej,12,0,15,3
1668094943672,MATH 240B,A00,098033,Ni; Lei,9,0,15,6
1668094944101,MATH 243,A00,098034,Jekel; David Andrew,10,0,10,0
1668094944531,MATH 245A,A00,098035,Nie; Jiawang,0,0,15,16
1668094944959,MATH 248,A00,098036,Bejenaru; Ioan,10,0,10,0
1668094945380,MATH 250B,A00,098037,Spolaor; Luca,14,0,15,1
1668094945803,MATH 258,A00,098038,Ni; Lei,10,0,10,0
1668094946227,MATH 264B,A00,098041,Rhoades; Brendon Patrick,10,0,15,5
1668094946660,MATH 268,A00,098042,Buss; Samuel R,10,0,10,0
1668094947086,MATH 269,A00,098043,Rhoades; Brendon Patrick,10,0,10,0
1668094947521,MATH 270B,A00,098044,Li; Bo,11,0,15,4
1668094947943,MATH 272B,A00,098045,Holst; Michael J,13,0,15,2
1668094948367,MATH 273A,A00,098046,Tian; Xiaochuan,10,0,15,5
1668094948789,MATH 275,A01,098048,Tian; Xiaochuan,6,0,10,4
1668094949212,MATH 278A,A00,098049,Holst; Michael J,8,0,10,2
1668094949636,MATH 278B,A00,098050,Cloninger; Alexander,10,0,10,0
1668094950059,MATH 278C,A00,098051,Nie; Jiawang,7,0,10,3
1668094950482,MATH 280B,A00,098052,Zheng; Tianyi,10,0,15,5
1668094950920,MATH 281B,A00,098053,Bradic; Jelena,3,0,15,12
1668094951346,MATH 282B,A00,098054,Arias-Castro; Ery,0,0,15,15
1668094951768,MATH 285,A00,098055,Fitzsimmons; Patrick J,0,0,15,17
1668094952201,MATH 287B,A00,098056,Arias-Castro; Ery,3,0,15,12
1668094952630,MATH 288,A00,098057,Agarwal; Pooja,9,0,10,1
1668094952630,MATH 288,B00,098058,Zhang; Danna,8,0,10,2
1668094952630,MATH 288,C00,098059,Williams; Ruth J,10,0,10,0
1668094953054,MATH 290B,A00,098060,Roberts; Justin Deritter,13,0,15,2
1668094953478,MATH 292,A00,098061,Belmont; Eva Kinoshita,10,0,10,0
1668094953904,MATH 295,A00,098062,Suk; Andrew Hoon,48,0,50,2
1668094954330,MATH 296,A00,098063,Novak; Jonathan I,20,0,20,0
1668094954754,MATH 297,001,098064,Gamst; Anthony Collins,9997,0,9999,2
1668095455805,COGS 205,A00,101395,Chiba; Andrea,19,0,20,1
1668095456229,COGS 210B,001,101404,Greene; Deanna Jacquelyn,9998,0,9999,1
1668095456229,COGS 210B,002,101417,Xia; Haijun,9999,0,9999,0
1668095456229,COGS 210B,003,101422,Nitz; Douglas A.,9999,0,9999,0
1668095456229,COGS 210B,004,101423,Hollan; James D.,9998,0,9999,1
1668095456229,COGS 210B,005,101424,Deak; Gedeon O.,9998,0,9999,1
1668095456229,COGS 210B,006,101425,Rossano; Federico,9999,0,9999,0
1668095456653,COGS 211B,A00,101427,Coulson; Seana M,9996,0,9999,3
1668095457075,COGS 220,A00,101428,Hollan; James D.,0,0,25,25
1668095457498,COGS 229,A00,101429,Dow; Steven P,18,0,25,7
1668095457929,COGS 230,A00,101430,Klemmer; Scott R,13,0,17,4
1668095458356,COGS 234,A00,101431,Xia; Haijun,3,0,25,22
1668095458778,COGS 260,A00,101432,Kiyonaga; Anastasia,19,0,25,6
1668095458778,COGS 260,B00,101433,Kirsh; David Joel,16,0,25,9
1668095459200,CSE 202,A00,102371,Impagliazzo; Russell,0,0,0,0
1668095459624,CSE 203B,A01,102373,Cheng; Chung Kuan,0,0,0,0
1668095460048,CSE 208,A00,102374,Micciancio; Daniele,0,0,0,0
1668095460473,CSE 209A,A00,112895,Impagliazzo; Russell,0,0,15,15
1668095460897,CSE 209B,A00,108005,Bellare; Mihir,0,0,0,0
1668095461330,CSE 210,A00,113163,Coblenz; Michael J,0,0,0,0
1668095461752,CSE 219,A00,106111,Dow; Steven P,0,0,20,20
1668095462189,CSE 221,A00,102376,Voelker; Geoffrey M.,0,0,0,0
1668095462613,CSE 224,A01,102378,Porter; George M,0,0,0,0
1668095463036,CSE 229A,A00,102379,Savage; Stefan,0,0,0,0
1668095463468,CSE 229C,A00,102380,Munyaka; Imani N. S.,0,0,0,0
1668095463892,CSE 232B,A00,102382,Deutsch; Alin Bernard,0,0,0,0
1668095464316,CSE 234,A01,112904,Kumar; Arun Kumar,0,0,0,0
1668095464746,CSE 237A,A00,102383,Rosing; Tajana Simunic,0,0,0,0
1668095465168,CSE 239A,A00,102384,Deutsch; Alin Bernard,0,0,0,0
1668095465601,CSE 239B,A00,102385,Polikarpova; Nadezhda,0,0,0,0
1668095466026,CSE 240A,A00,102386,Pannuto; Patrick William,0,0,0,0
1668095466450,CSE 240B,A00,102387,Zhao; Jishen,0,0,0,0
1668095466872,CSE 241A,A00,106406,Kang; Mingu,0,0,0,0
1668095467295,CSE 249B,A00,102388,Kahng; Andrew Byun,0,0,8,8
1668095467720,CSE 251B,A01,102392,Cottrell; Garrison W,0,0,0,0
1668095467720,CSE 251B,A02,102393,Cottrell; Garrison W,0,0,0,0
1668095468143,CSE 252B,A00,102394,Ochoa; Benjamin Lawrence,0,0,0,0
1668095468578,CSE 257,A01,102396,Gao; Sicun,0,0,0,0
1668095469000,CSE 272,A00,102397,Li; Tzumao,0,0,0,0
1668095469423,CSE 274,A00,111323,Chern; Albert Ren-Haur,0,0,0,0
1668095469848,CSE 282,A00,102398,Pevzner; Pavel Arkadjevich,0,0,0,0
1668095470270,CSE 284,A00,114175,Gymrek; Melissa Ann,0,0,0,0
1668095470692,CSE 290,A00,102399,Chandraker; Manmohan Krishna,0,0,0,0
1668095470692,CSE 290,B00,102400,Vaccaro; Kristen Marie,0,0,25,25
1668095470692,CSE 290,C00,102414,Pannuto; Patrick William,0,0,25,25
1668095470692,CSE 290,D00,102427,Pevzner; Pavel Arkadjevich,0,0,0,0
1668095470692,CSE 290,E00,102429,Zhao; Jishen,0,0,0,0
1668095470692,CSE 290,F00,102436,Tullsen; Dean Michael,0,0,0,0
1668095470692,CSE 290,G00,102440,Christensen; Henrik I,0,0,20,20
1668095471117,CSE 291,A00,102443,Su; Hao,0,0,0,0
1668095471117,CSE 291,B00,102448,Polikarpova; Nadezhda,0,0,0,0
1668095471117,CSE 291,C00,102453,Vaccaro; Kristen Marie,0,0,0,0
1668095471117,CSE 291,D00,111343,Savage; Stefan,0,0,0,0
1668095471117,CSE 291,E00,116474,Claffy; Kimberly Claire,0,0,0,0
1668095471117,CSE 291,F00,116479,Pasquale; Joseph,0,0,0,0
1668095471548,CSE 293,001,119111,Bafna; Vineet,9999,0,9999,0
1668095471548,CSE 293,002,119118,Bellare; Mihir,9999,0,9999,0
1668095471548,CSE 293,003,119122,Berg-Kirkpatrick; Taylor D,9999,0,9999,0
1668095471548,CSE 293,004,119135,Christensen; Henrik I,9999,0,9999,0
1668095471548,CSE 293,005,119142,Cottrell; Garrison W,9999,0,9999,0
1668095471548,CSE 293,006,119146,Deutsch; Alin Bernard,9999,0,9999,0
1668095471548,CSE 293,007,119159,Esmaeilzadeh; Hadi,9999,0,9999,0
1668095471548,CSE 293,008,119166,Freund; Yoav,9999,0,9999,0
1668095471548,CSE 293,009,119170,Griswold; William G.,9999,0,9999,0
1668095471548,CSE 293,010,119183,Gymrek; Melissa Ann,9999,0,9999,0
1668095471548,CSE 293,011,119190,Heninger; Nadia A,9999,0,9999,0
1668095471548,CSE 293,012,119230,Impagliazzo; Russell,9999,0,9999,0
1668095471548,CSE 293,013,119232,Jhala; Ranjit,9999,0,9999,0
1668095471548,CSE 293,014,119233,Kahng; Andrew Byun,9999,0,9999,0
1668095471548,CSE 293,015,119298,Kane; Daniel Mertz,9999,0,9999,0
1668095471548,CSE 293,016,119299,Kriegman; David J,9999,0,9999,0
1668095471548,CSE 293,017,119300,Kumar; Arun Kumar,9999,0,9999,0
1668095471548,CSE 293,018,119301,Lerner; Sorin,9999,0,9999,0
1668095471548,CSE 293,019,119302,Lovett; Shachar,9999,0,9999,0
1668095471548,CSE 293,020,119303,McAuley; Julian John,9999,0,9999,0
1668095471548,CSE 293,021,119304,Micciancio; Daniele,9999,0,9999,0
1668095471548,CSE 293,022,119367,Orailoglu; Alex,9999,0,9999,0
1668095471548,CSE 293,023,119382,Paturi; Ramamohan,9999,0,9999,0
1668095471548,CSE 293,024,119404,Polikarpova; Nadezhda,9999,0,9999,0
1668095471548,CSE 293,025,119406,Politz; Joseph Gibbs,9999,0,9999,0
1668095471548,CSE 293,026,119411,Porter; George M,9999,0,9999,0
1668095471548,CSE 293,027,119414,Porter; Leonard Emerson,9999,0,9999,0
1668095471548,CSE 293,028,119416,Ramamoorthi; Ravi,9999,0,9999,0
1668095471548,CSE 293,029,119417,Sahoo; Debashis,9999,0,9999,0
1668095471548,CSE 293,030,119420,Saul; Lawrence,9999,0,9999,0
1668095471548,CSE 293,031,119421,Savage; Stefan,9999,0,9999,0
1668095471548,CSE 293,032,119425,Schulze; Jurgen P.,9999,0,9999,0
1668095471548,CSE 293,033,119426,Snoeren; Alex C.,9999,0,9999,0
1668095471548,CSE 293,034,119428,Shang; Jingbo,9999,0,9999,0
1668095471548,CSE 293,035,119430,Stefan; Deian,9999,0,9999,0
1668095471548,CSE 293,036,119431,Su; Hao,9999,0,9999,0
1668095471548,CSE 293,037,119433,Swanson; Steven James,9999,0,9999,0
1668095471548,CSE 293,038,119435,Tullsen; Dean Michael,9999,0,9999,0
1668095471548,CSE 293,039,119483,Voelker; Geoffrey M.,9999,0,9999,0
1668095471548,CSE 293,040,119537,Zhao; Jishen,9999,0,9999,0
1668095471548,CSE 293,041,119538,Zhou; Yuan-Yuan,9999,0,9999,0
1668095471548,CSE 293,042,119539,Gao; Sicun,9999,0,9999,0
1668095471548,CSE 293,043,119540,Weibel; Nadir,9999,0,9999,0
1668095471548,CSE 293,044,119541,Gupta; Rajesh K.,9999,0,9999,0
1668095471548,CSE 293,045,126410,Vaccaro; Kristen Marie,9999,0,9999,0
1668095471548,CSE 293,046,126411,Klemke; Richard,9999,0,9999,0
1668095471974,CSE 294,A00,102459,Voelker; Geoffrey M.,0,0,0,0
1668095471974,CSE 294,B00,111322,Orailoglu; Alex,0,0,0,0
1668095472395,DSE 201,A00,096914,Deutsch; Alin Bernard,30,0,30,0
1668095472824,DSE 210,A00,096915,Dasgupta; Sanjoy,30,0,30,0
1668095473249,DSE 260A,A00,096916,Altintas De Callaf; Ilkay,30,0,30,0
1668095473677,ECE 200,001,103586,Antipa; Nicholas A,9999,0,9999,0
1668095473677,ECE 200,002,103587,Atanasov; Nikolay A.,9999,0,9999,0
1668095473677,ECE 200,003,103588,Bharadia; Dinesh,9999,0,9999,0
1668095473677,ECE 200,004,103589,Cheng; Chung Kuan,9999,0,9999,0
1668095473677,ECE 200,005,103590,Cosman; Pamela C.,9999,0,9999,0
1668095473677,ECE 200,006,103591,Dayeh; Shadi Ahmad,9999,0,9999,0
1668095473677,ECE 200,007,103592,Fainman; Yeshaiahu,9999,0,9999,0
1668095473677,ECE 200,008,103593,Ford; Joseph Earl,9999,0,9999,0
1668095473677,ECE 200,009,103594,Franceschetti; Massimo,9999,0,9999,0
1668095473677,ECE 200,010,103595,Fullerton; Eric E,9999,0,9999,0
1668095473677,ECE 200,011,103596,Galton; Ian A,9999,0,9999,0
1668095473677,ECE 200,012,103597,Gilja; Vikash,9999,0,9999,0
1668095473677,ECE 200,013,103598,Hall; Drew A.,9999,0,9999,0
1668095473677,ECE 200,014,103599,Hsueh; Tzu-Chien,9999,0,9999,0
1668095473677,ECE 200,015,103600,Javidi; Tara,9999,0,9999,0
1668095473677,ECE 200,016,103601,Kahng; Andrew Byun,9999,0,9999,0
1668095473677,ECE 200,017,103602,Kim; Young-Han,9999,0,9999,0
1668095473677,ECE 200,018,103603,Koushanfar; Farinaz,9999,0,9999,0
1668095473677,ECE 200,019,103604,Kuzum; Duygu,9999,0,9999,0
1668095473677,ECE 200,020,103605,Le; Hanh-Phuc,9999,0,9999,0
1668095473677,ECE 200,021,103606,Lin; Bill,9999,0,9999,0
1668095473677,ECE 200,022,103607,Liu; Zhaowei,9998,0,9999,1
1668095473677,ECE 200,023,103608,Lo; Yu-Hwa,9999,0,9999,0
1668095473677,ECE 200,024,103609,Lomakin; Vitaliy,9999,0,9999,0
1668095473677,ECE 200,025,103610,Mercier; Patrick Philip,9999,0,9999,0
1668095473677,ECE 200,026,103611,Meyer; Florian,9999,0,9999,0
1668095473677,ECE 200,027,103612,Milstein; Laurence B.,9999,0,9999,0
1668095473677,ECE 200,028,103613,Mir Arabbaygi; Siavash,9999,0,9999,0
1668095473677,ECE 200,029,103614,Mookherjea; Shayan,9999,0,9999,0
1668095473677,ECE 200,030,103615,Morris; Karcher William,9999,0,9999,0
1668095473677,ECE 200,031,103616,Ng; Tse Nga,9999,0,9999,0
1668095473677,ECE 200,032,103617,Nguyen; Truong Quang,9999,0,9999,0
1668095473677,ECE 200,033,103618,Nomura; Kenji,9999,0,9999,0
1668095473677,ECE 200,034,103619,Orlitsky; Alon,9999,0,9999,0
1668095473677,ECE 200,035,103620,Pal; Piya,9999,0,9999,0
1668095473677,ECE 200,036,103621,Papen; George C.,9999,0,9999,0
1668095473677,ECE 200,037,103622,Radic; Stojan,9999,0,9999,0
1668095473677,ECE 200,038,103623,Rao; Bhaskar D.,9999,0,9999,0
1668095473677,ECE 200,039,103624,Rao; Ramesh R,9999,0,9999,0
1668095473677,ECE 200,040,103625,Rebeiz; Gabriel,9999,0,9999,0
1668095473677,ECE 200,041,103626,Sanford; John R,9999,0,9999,0
1668095473677,ECE 200,042,103627,Siegel; Paul H.,9999,0,9999,0
1668095473677,ECE 200,043,103628,Sievenpiper; Daniel F.,9999,0,9999,0
1668095473677,ECE 200,044,103629,Sworder; David D.,9999,0,9999,0
1668095473677,ECE 200,045,103630,Taur; Yuan,9999,0,9999,0
1668095473677,ECE 200,046,103631,Touri; Behrouz,9999,0,9999,0
1668095473677,ECE 200,047,103632,Trivedi; Mohan M.,9999,0,9999,0
1668095473677,ECE 200,048,103633,Vasconcelos; Nuno,9999,0,9999,0
1668095473677,ECE 200,049,103634,Wang; Xiaolong,9999,0,9999,0
1668095473677,ECE 200,050,103635,Xie; Pengtao,9999,0,9999,0
1668095473677,ECE 200,051,103636,Yip; Michael,9999,0,9999,0
1668095473677,ECE 200,052,103637,Zeger; Kenneth A.,999,0,999,0
1668095473677,ECE 200,053,103638,Zhang; Xinyu,9999,0,9999,0
1668095473677,ECE 200,054,103639,Turakhia; Yatish Girish,9999,0,9999,0
1668095473677,ECE 200,055,103640,Kang; Mingu,9999,0,9999,0
1668095473677,ECE 200,056,103641,Shi; Yuanyuan,9999,0,9999,0
1668095473677,ECE 200,057,103642,Wang; Edward Jay,9999,0,9999,0
1668095473677,ECE 200,058,103643,Zheng; Yang,9999,0,9999,0
1668095474105,ECE 202,A00,103644,Kuzum; Duygu,0,0,0,0
1668095474530,ECE 212BN,A00,103646,Ng; Tse Nga,0,0,0,0
1668095474960,ECE 221,A00,111493,Staff,0,0,0,0
1668095475389,ECE 222B,A00,103647,Lomakin; Vitaliy,0,0,0,0
1668095475817,ECE 230B,A00,103648,Taur; Yuan,0,0,0,0
1668095476240,ECE 238B,A00,103649,Garay; Javier,0,0,0,0
1668095476669,ECE 240B,A00,112900,Fainman; Yeshaiahu,0,0,0,0
1668095477096,ECE 247A,A00,103650,Jokerst; Jesse Vincent,0,0,0,0
1668095477530,ECE 247B,A00,103651,Wang; Joseph,0,0,0,0
1668095477960,ECE 250,A00,103652,Siegel; Paul H.,0,0,0,0
1668095478392,ECE 251A,A00,103654,Rao; Bhaskar D.,0,0,0,0
1668095478828,ECE 257B,A00,103655,Bharadia; Dinesh,0,0,0,0
1668095479261,ECE 258A,A00,103656,Milstein; Laurence B.,0,0,0,0
1668095479692,ECE 260B,A00,103658,Kang; Mingu,0,0,0,0
1668095480116,ECE 264A,A00,103659,Galton; Ian A,0,0,0,0
1668095480540,ECE 265A,A00,103661,Gudem; Prasad S.S.,0,0,0,0
1668095480977,ECE 265D,A00,103662,Gudem; Prasad S.S.,0,0,0,0
1668095481407,ECE 268,A00,103663,Koushanfar; Farinaz,0,0,0,0
1668095481831,ECE 269,A01,103665,Pal; Piya,0,0,0,0
1668095482266,ECE 271B,A00,103666,Vasconcelos; Manuela,0,0,0,0
1668095482692,ECE 276A,A00,103667,Atanasov; Nikolay A.,0,0,0,0
1668095483121,ECE 277,A00,103668,An; Cheolhong,0,0,0,0
1668095483547,ECE 279,A00,117947,Hall; Drew A.,0,0,0,0
1668095484410,ECE 283,A00,103670,Hsueh; Tzu-Chien,0,0,0,0
1668095484834,ECE 284,A00,103671,Turakhia; Yatish Girish,0,0,0,0
1668095485260,ECE 285,A00,103672,Zheng; Yang,0,0,0,0
1668095485260,ECE 285,B00,103673,Sworder; David D.,0,0,0,0
1668095485690,ECE 287,A00,103676,Javidi; Tara,0,0,0,0
1668095486113,MATH 200B,A00,098023,Salehi Golsefidy; Alireza,13,0,15,2
1668095486546,MATH 202B,A00,098024,Rhoades; Brendon Patrick,9,0,15,6
1668095486967,MATH 203B,A00,098025,Oprea; Dragos N.,10,0,15,5
1668095487402,MATH 204B,A00,098026,Sorensen; Claus M,13,0,15,2
1668095487825,MATH 208,A00,098027,Izadi; Elham,7,0,10,3
1668095488248,MATH 209,A00,098028,Pollack; Aaron,10,0,10,0
1668095488672,MATH 211A,A00,112919,Rogalski; Daniel,9,0,10,1
1668095489105,MATH 211B,A00,112920,Seward; Brandon M.,9,0,10,1
1668095489545,MATH 218,A00,098029,Li; Bo,10,0,10,0
1668095489969,MATH 220B,A00,098030,Novak; Jonathan I,12,0,15,3
1668095490398,MATH 221A,A00,098031,Ebenfelt; Peter F,13,0,15,2
1668095490821,MATH 231B,A00,098032,Zlatos; Andrej,12,0,15,3
1668095491246,MATH 240B,A00,098033,Ni; Lei,9,0,15,6
1668095491670,MATH 243,A00,098034,Jekel; David Andrew,10,0,10,0
1668095492095,MATH 245A,A00,098035,Nie; Jiawang,0,0,15,16
1668095492517,MATH 248,A00,098036,Bejenaru; Ioan,10,0,10,0
1668095492940,MATH 250B,A00,098037,Spolaor; Luca,14,0,15,1
1668095493372,MATH 258,A00,098038,Ni; Lei,10,0,10,0
1668095493794,MATH 264B,A00,098041,Rhoades; Brendon Patrick,10,0,15,5
1668095494217,MATH 268,A00,098042,Buss; Samuel R,10,0,10,0
1668095494638,MATH 269,A00,098043,Rhoades; Brendon Patrick,10,0,10,0
1668095495061,MATH 270B,A00,098044,Li; Bo,11,0,15,4
1668095495485,MATH 272B,A00,098045,Holst; Michael J,13,0,15,2
1668095495910,MATH 273A,A00,098046,Tian; Xiaochuan,10,0,15,5
1668095496436,MATH 275,A01,098048,Tian; Xiaochuan,6,0,10,4
1668095496867,MATH 278A,A00,098049,Holst; Michael J,8,0,10,2
1668095497296,MATH 278B,A00,098050,Cloninger; Alexander,10,0,10,0
1668095497726,MATH 278C,A00,098051,Nie; Jiawang,7,0,10,3
1668095498148,MATH 280B,A00,098052,Zheng; Tianyi,10,0,15,5
1668095498573,MATH 281B,A00,098053,Bradic; Jelena,3,0,15,12
1668095498995,MATH 282B,A00,098054,Arias-Castro; Ery,0,0,15,15
1668095499431,MATH 285,A00,098055,Fitzsimmons; Patrick J,0,0,15,17
1668095499855,MATH 287B,A00,098056,Arias-Castro; Ery,3,0,15,12
1668095500277,MATH 288,A00,098057,Agarwal; Pooja,9,0,10,1
1668095500277,MATH 288,B00,098058,Zhang; Danna,8,0,10,2
1668095500277,MATH 288,C00,098059,Williams; Ruth J,10,0,10,0
1668095500724,MATH 290B,A00,098060,Roberts; Justin Deritter,13,0,15,2
1668095501146,MATH 292,A00,098061,Belmont; Eva Kinoshita,10,0,10,0
1668095501572,MATH 295,A00,098062,Suk; Andrew Hoon,48,0,50,2
1668095501994,MATH 296,A00,098063,Novak; Jonathan I,20,0,20,0
1668095502418,MATH 297,001,098064,Gamst; Anthony Collins,9997,0,9999,2
1668096004259,COGS 205,A00,101395,Chiba; Andrea,19,0,20,1
1668096004717,COGS 210B,001,101404,Greene; Deanna Jacquelyn,9998,0,9999,1
1668096004717,COGS 210B,002,101417,Xia; Haijun,9999,0,9999,0
1668096004717,COGS 210B,003,101422,Nitz; Douglas A.,9999,0,9999,0
1668096004717,COGS 210B,004,101423,Hollan; James D.,9998,0,9999,1
1668096004717,COGS 210B,005,101424,Deak; Gedeon O.,9998,0,9999,1
1668096004717,COGS 210B,006,101425,Rossano; Federico,9999,0,9999,0
1668096005148,COGS 211B,A00,101427,Coulson; Seana M,9996,0,9999,3
1668096005586,COGS 220,A00,101428,Hollan; James D.,0,0,25,25
1668096006023,COGS 229,A00,101429,Dow; Steven P,18,0,25,7
1668096006454,COGS 230,A00,101430,Klemmer; Scott R,13,0,17,4
1668096006904,COGS 234,A00,101431,Xia; Haijun,3,0,25,22
1668096007334,COGS 260,A00,101432,Kiyonaga; Anastasia,19,0,25,6
1668096007334,COGS 260,B00,101433,Kirsh; David Joel,16,0,25,9
1668096007857,CSE 202,A00,102371,Impagliazzo; Russell,0,0,0,0
1668096008283,CSE 203B,A01,102373,Cheng; Chung Kuan,0,0,0,0
1668096008716,CSE 208,A00,102374,Micciancio; Daniele,0,0,0,0
1668096009165,CSE 209A,A00,112895,Impagliazzo; Russell,0,0,15,15
1668096009586,CSE 209B,A00,108005,Bellare; Mihir,0,0,0,0
1668096010022,CSE 210,A00,113163,Coblenz; Michael J,0,0,0,0
1668096010450,CSE 219,A00,106111,Dow; Steven P,0,0,20,20
1668096010875,CSE 221,A00,102376,Voelker; Geoffrey M.,0,0,0,0
1668096011329,CSE 224,A01,102378,Porter; George M,0,0,0,0
1668096011768,CSE 229A,A00,102379,Savage; Stefan,0,0,0,0
1668096012192,CSE 229C,A00,102380,Munyaka; Imani N. S.,0,0,0,0
1668096012626,CSE 232B,A00,102382,Deutsch; Alin Bernard,0,0,0,0
1668096013058,CSE 234,A01,112904,Kumar; Arun Kumar,0,0,0,0
1668096013500,CSE 237A,A00,102383,Rosing; Tajana Simunic,0,0,0,0
1668096013928,CSE 239A,A00,102384,Deutsch; Alin Bernard,0,0,0,0
1668096014351,CSE 239B,A00,102385,Polikarpova; Nadezhda,0,0,0,0
1668096014780,CSE 240A,A00,102386,Pannuto; Patrick William,0,0,0,0
1668096015204,CSE 240B,A00,102387,Zhao; Jishen,0,0,0,0
1668096015628,CSE 241A,A00,106406,Kang; Mingu,0,0,0,0
1668096016057,CSE 249B,A00,102388,Kahng; Andrew Byun,0,0,8,8
1668096016481,CSE 251B,A01,102392,Cottrell; Garrison W,0,0,0,0
1668096016481,CSE 251B,A02,102393,Cottrell; Garrison W,0,0,0,0
1668096016906,CSE 252B,A00,102394,Ochoa; Benjamin Lawrence,0,0,0,0
1668096017335,CSE 257,A01,102396,Gao; Sicun,0,0,0,0
1668096017758,CSE 272,A00,102397,Li; Tzumao,0,0,0,0
1668096018184,CSE 274,A00,111323,Chern; Albert Ren-Haur,0,0,0,0
1668096018685,CSE 282,A00,102398,Pevzner; Pavel Arkadjevich,0,0,0,0
1668096019121,CSE 284,A00,114175,Gymrek; Melissa Ann,0,0,0,0
1668096019544,CSE 290,A00,102399,Chandraker; Manmohan Krishna,0,0,0,0
1668096019544,CSE 290,B00,102400,Vaccaro; Kristen Marie,0,0,25,25
1668096019544,CSE 290,C00,102414,Pannuto; Patrick William,0,0,25,25
1668096019544,CSE 290,D00,102427,Pevzner; Pavel Arkadjevich,0,0,0,0
1668096019544,CSE 290,E00,102429,Zhao; Jishen,0,0,0,0
1668096019544,CSE 290,F00,102436,Tullsen; Dean Michael,0,0,0,0
1668096019544,CSE 290,G00,102440,Christensen; Henrik I,0,0,20,20
1668096019972,CSE 291,A00,102443,Su; Hao,0,0,0,0
1668096019972,CSE 291,B00,102448,Polikarpova; Nadezhda,0,0,0,0
1668096019972,CSE 291,C00,102453,Vaccaro; Kristen Marie,0,0,0,0
1668096019972,CSE 291,D00,111343,Savage; Stefan,0,0,0,0
1668096019972,CSE 291,E00,116474,Claffy; Kimberly Claire,0,0,0,0
1668096019972,CSE 291,F00,116479,Pasquale; Joseph,0,0,0,0
1668096020410,CSE 293,001,119111,Bafna; Vineet,9999,0,9999,0
1668096020410,CSE 293,002,119118,Bellare; Mihir,9999,0,9999,0
1668096020410,CSE 293,003,119122,Berg-Kirkpatrick; Taylor D,9999,0,9999,0
1668096020410,CSE 293,004,119135,Christensen; Henrik I,9999,0,9999,0
1668096020410,CSE 293,005,119142,Cottrell; Garrison W,9999,0,9999,0
1668096020410,CSE 293,006,119146,Deutsch; Alin Bernard,9999,0,9999,0
1668096020410,CSE 293,007,119159,Esmaeilzadeh; Hadi,9999,0,9999,0
1668096020410,CSE 293,008,119166,Freund; Yoav,9999,0,9999,0
1668096020410,CSE 293,009,119170,Griswold; William G.,9999,0,9999,0
1668096020410,CSE 293,010,119183,Gymrek; Melissa Ann,9999,0,9999,0
1668096020410,CSE 293,011,119190,Heninger; Nadia A,9999,0,9999,0
1668096020410,CSE 293,012,119230,Impagliazzo; Russell,9999,0,9999,0
1668096020410,CSE 293,013,119232,Jhala; Ranjit,9999,0,9999,0
1668096020410,CSE 293,014,119233,Kahng; Andrew Byun,9999,0,9999,0
1668096020410,CSE 293,015,119298,Kane; Daniel Mertz,9999,0,9999,0
1668096020410,CSE 293,016,119299,Kriegman; David J,9999,0,9999,0
1668096020410,CSE 293,017,119300,Kumar; Arun Kumar,9999,0,9999,0
1668096020410,CSE 293,018,119301,Lerner; Sorin,9999,0,9999,0
1668096020410,CSE 293,019,119302,Lovett; Shachar,9999,0,9999,0
1668096020410,CSE 293,020,119303,McAuley; Julian John,9999,0,9999,0
1668096020410,CSE 293,021,119304,Micciancio; Daniele,9999,0,9999,0
1668096020410,CSE 293,022,119367,Orailoglu; Alex,9999,0,9999,0
1668096020410,CSE 293,023,119382,Paturi; Ramamohan,9999,0,9999,0
1668096020410,CSE 293,024,119404,Polikarpova; Nadezhda,9999,0,9999,0
1668096020410,CSE 293,025,119406,Politz; Joseph Gibbs,9999,0,9999,0
1668096020410,CSE 293,026,119411,Porter; George M,9999,0,9999,0
1668096020410,CSE 293,027,119414,Porter; Leonard Emerson,9999,0,9999,0
1668096020410,CSE 293,028,119416,Ramamoorthi; Ravi,9999,0,9999,0
1668096020410,CSE 293,029,119417,Sahoo; Debashis,9999,0,9999,0
1668096020410,CSE 293,030,119420,Saul; Lawrence,9999,0,9999,0
1668096020410,CSE 293,031,119421,Savage; Stefan,9999,0,9999,0
1668096020410,CSE 293,032,119425,Schulze; Jurgen P.,9999,0,9999,0
1668096020410,CSE 293,033,119426,Snoeren; Alex C.,9999,0,9999,0
1668096020410,CSE 293,034,119428,Shang; Jingbo,9999,0,9999,0
1668096020410,CSE 293,035,119430,Stefan; Deian,9999,0,9999,0
1668096020410,CSE 293,036,119431,Su; Hao,9999,0,9999,0
1668096020410,CSE 293,037,119433,Swanson; Steven James,9999,0,9999,0
1668096020410,CSE 293,038,119435,Tullsen; Dean Michael,9999,0,9999,0
1668096020410,CSE 293,039,119483,Voelker; Geoffrey M.,9999,0,9999,0
1668096020410,CSE 293,040,119537,Zhao; Jishen,9999,0,9999,0
1668096020410,CSE 293,041,119538,Zhou; Yuan-Yuan,9999,0,9999,0
1668096020410,CSE 293,042,119539,Gao; Sicun,9999,0,9999,0
1668096020410,CSE 293,043,119540,Weibel; Nadir,9999,0,9999,0
1668096020410,CSE 293,044,119541,Gupta; Rajesh K.,9999,0,9999,0
1668096020410,CSE 293,045,126410,Vaccaro; Kristen Marie,9999,0,9999,0
1668096020410,CSE 293,046,126411,Klemke; Richard,9999,0,9999,0
1668096020840,CSE 294,A00,102459,Voelker; Geoffrey M.,0,0,0,0
1668096020840,CSE 294,B00,111322,Orailoglu; Alex,0,0,0,0
1668096021262,DSE 201,A00,096914,Deutsch; Alin Bernard,30,0,30,0
1668096021693,DSE 210,A00,096915,Dasgupta; Sanjoy,30,0,30,0
1668096022123,DSE 260A,A00,096916,Altintas De Callaf; Ilkay,30,0,30,0
1668096022551,ECE 200,001,103586,Antipa; Nicholas A,9999,0,9999,0
1668096022551,ECE 200,002,103587,Atanasov; Nikolay A.,9999,0,9999,0
1668096022551,ECE 200,003,103588,Bharadia; Dinesh,9999,0,9999,0
1668096022551,ECE 200,004,103589,Cheng; Chung Kuan,9999,0,9999,0
1668096022551,ECE 200,005,103590,Cosman; Pamela C.,9999,0,9999,0
1668096022551,ECE 200,006,103591,Dayeh; Shadi Ahmad,9999,0,9999,0
1668096022551,ECE 200,007,103592,Fainman; Yeshaiahu,9999,0,9999,0
1668096022551,ECE 200,008,103593,Ford; Joseph Earl,9999,0,9999,0
1668096022551,ECE 200,009,103594,Franceschetti; Massimo,9999,0,9999,0
1668096022551,ECE 200,010,103595,Fullerton; Eric E,9999,0,9999,0
1668096022551,ECE 200,011,103596,Galton; Ian A,9999,0,9999,0
1668096022551,ECE 200,012,103597,Gilja; Vikash,9999,0,9999,0
1668096022551,ECE 200,013,103598,Hall; Drew A.,9999,0,9999,0
1668096022551,ECE 200,014,103599,Hsueh; Tzu-Chien,9999,0,9999,0
1668096022551,ECE 200,015,103600,Javidi; Tara,9999,0,9999,0
1668096022551,ECE 200,016,103601,Kahng; Andrew Byun,9999,0,9999,0
1668096022551,ECE 200,017,103602,Kim; Young-Han,9999,0,9999,0
1668096022551,ECE 200,018,103603,Koushanfar; Farinaz,9999,0,9999,0
1668096022551,ECE 200,019,103604,Kuzum; Duygu,9999,0,9999,0
1668096022551,ECE 200,020,103605,Le; Hanh-Phuc,9999,0,9999,0
1668096022551,ECE 200,021,103606,Lin; Bill,9999,0,9999,0
1668096022551,ECE 200,022,103607,Liu; Zhaowei,9998,0,9999,1
1668096022551,ECE 200,023,103608,Lo; Yu-Hwa,9999,0,9999,0
1668096022551,ECE 200,024,103609,Lomakin; Vitaliy,9999,0,9999,0
1668096022551,ECE 200,025,103610,Mercier; Patrick Philip,9999,0,9999,0
1668096022551,ECE 200,026,103611,Meyer; Florian,9999,0,9999,0
1668096022551,ECE 200,027,103612,Milstein; Laurence B.,9999,0,9999,0
1668096022551,ECE 200,028,103613,Mir Arabbaygi; Siavash,9999,0,9999,0
1668096022551,ECE 200,029,103614,Mookherjea; Shayan,9999,0,9999,0
1668096022551,ECE 200,030,103615,Morris; Karcher William,9999,0,9999,0
1668096022551,ECE 200,031,103616,Ng; Tse Nga,9999,0,9999,0
1668096022551,ECE 200,032,103617,Nguyen; Truong Quang,9999,0,9999,0
1668096022551,ECE 200,033,103618,Nomura; Kenji,9999,0,9999,0
1668096022551,ECE 200,034,103619,Orlitsky; Alon,9999,0,9999,0
1668096022551,ECE 200,035,103620,Pal; Piya,9999,0,9999,0
1668096022551,ECE 200,036,103621,Papen; George C.,9999,0,9999,0
1668096022551,ECE 200,037,103622,Radic; Stojan,9999,0,9999,0
1668096022551,ECE 200,038,103623,Rao; Bhaskar D.,9999,0,9999,0
1668096022551,ECE 200,039,103624,Rao; Ramesh R,9999,0,9999,0
1668096022551,ECE 200,040,103625,Rebeiz; Gabriel,9999,0,9999,0
1668096022551,ECE 200,041,103626,Sanford; John R,9999,0,9999,0
1668096022551,ECE 200,042,103627,Siegel; Paul H.,9999,0,9999,0
1668096022551,ECE 200,043,103628,Sievenpiper; Daniel F.,9999,0,9999,0
1668096022551,ECE 200,044,103629,Sworder; David D.,9999,0,9999,0
1668096022551,ECE 200,045,103630,Taur; Yuan,9999,0,9999,0
1668096022551,ECE 200,046,103631,Touri; Behrouz,9999,0,9999,0
1668096022551,ECE 200,047,103632,Trivedi; Mohan M.,9999,0,9999,0
1668096022551,ECE 200,048,103633,Vasconcelos; Nuno,9999,0,9999,0
1668096022551,ECE 200,049,103634,Wang; Xiaolong,9999,0,9999,0
1668096022551,ECE 200,050,103635,Xie; Pengtao,9999,0,9999,0
1668096022551,ECE 200,051,103636,Yip; Michael,9999,0,9999,0
1668096022551,ECE 200,052,103637,Zeger; Kenneth A.,999,0,999,0
1668096022551,ECE 200,053,103638,Zhang; Xinyu,9999,0,9999,0
1668096022551,ECE 200,054,103639,Turakhia; Yatish Girish,9999,0,9999,0
1668096022551,ECE 200,055,103640,Kang; Mingu,9999,0,9999,0
1668096022551,ECE 200,056,103641,Shi; Yuanyuan,9999,0,9999,0
1668096022551,ECE 200,057,103642,Wang; Edward Jay,9999,0,9999,0
1668096022551,ECE 200,058,103643,Zheng; Yang,9999,0,9999,0
1668096022975,ECE 202,A00,103644,Kuzum; Duygu,0,0,0,0
1668096023414,ECE 212BN,A00,103646,Ng; Tse Nga,0,0,0,0
1668096023836,ECE 221,A00,111493,Staff,0,0,0,0
1668096024266,ECE 222B,A00,103647,Lomakin; Vitaliy,0,0,0,0
1668096024701,ECE 230B,A00,103648,Taur; Yuan,0,0,0,0
1668096025125,ECE 238B,A00,103649,Garay; Javier,0,0,0,0
1668096025550,ECE 240B,A00,112900,Fainman; Yeshaiahu,0,0,0,0
1668096025983,ECE 247A,A00,103650,Jokerst; Jesse Vincent,0,0,0,0
1668096026407,ECE 247B,A00,103651,Wang; Joseph,0,0,0,0
1668096026832,ECE 250,A00,103652,Siegel; Paul H.,0,0,0,0
1668096027262,ECE 251A,A00,103654,Rao; Bhaskar D.,0,0,0,0
1668096027694,ECE 257B,A00,103655,Bharadia; Dinesh,0,0,0,0
1668096028125,ECE 258A,A00,103656,Milstein; Laurence B.,0,0,0,0
1668096028562,ECE 260B,A00,103658,Kang; Mingu,0,0,0,0
1668096028990,ECE 264A,A00,103659,Galton; Ian A,0,0,0,0
1668096029413,ECE 265A,A00,103661,Gudem; Prasad S.S.,0,0,0,0
1668096029836,ECE 265D,A00,103662,Gudem; Prasad S.S.,0,0,0,0
1668096030261,ECE 268,A00,103663,Koushanfar; Farinaz,0,0,0,0
1668096030693,ECE 269,A01,103665,Pal; Piya,0,0,0,0
1668096031134,ECE 271B,A00,103666,Vasconcelos; Manuela,0,0,0,0
1668096031564,ECE 276A,A00,103667,Atanasov; Nikolay A.,0,0,0,0
1668096031999,ECE 277,A00,103668,An; Cheolhong,0,0,0,0
1668096032421,ECE 279,A00,117947,Hall; Drew A.,0,0,0,0
1668096033275,ECE 283,A00,103670,Hsueh; Tzu-Chien,0,0,0,0
1668096033700,ECE 284,A00,103671,Turakhia; Yatish Girish,0,0,0,0
1668096034123,ECE 285,A00,103672,Zheng; Yang,0,0,0,0
1668096034123,ECE 285,B00,103673,Sworder; David D.,0,0,0,0
1668096034547,ECE 287,A00,103676,Javidi; Tara,0,0,0,0
1668096034971,MATH 200B,A00,098023,Salehi Golsefidy; Alireza,13,0,15,2
1668096035392,MATH 202B,A00,098024,Rhoades; Brendon Patrick,9,0,15,6
1668096035820,MATH 203B,A00,098025,Oprea; Dragos N.,10,0,15,5
1668096036244,MATH 204B,A00,098026,Sorensen; Claus M,13,0,15,2
1668096036678,MATH 208,A00,098027,Izadi; Elham,7,0,10,3
1668096037104,MATH 209,A00,098028,Pollack; Aaron,10,0,10,0
1668096037544,MATH 211A,A00,112919,Rogalski; Daniel,9,0,10,1
1668096037968,MATH 211B,A00,112920,Seward; Brandon M.,9,0,10,1
1668096038391,MATH 218,A00,098029,Li; Bo,10,0,10,0
1668096038813,MATH 220B,A00,098030,Novak; Jonathan I,12,0,15,3
1668096039245,MATH 221A,A00,098031,Ebenfelt; Peter F,13,0,15,2
1668096039671,MATH 231B,A00,098032,Zlatos; Andrej,12,0,15,3
1668096040095,MATH 240B,A00,098033,Ni; Lei,9,0,15,6
1668096040525,MATH 243,A00,098034,Jekel; David Andrew,10,0,10,0
1668096040952,MATH 245A,A00,098035,Nie; Jiawang,0,0,15,16
1668096041373,MATH 248,A00,098036,Bejenaru; Ioan,10,0,10,0
1668096041796,MATH 250B,A00,098037,Spolaor; Luca,14,0,15,1
1668096042228,MATH 258,A00,098038,Ni; Lei,10,0,10,0
1668096042652,MATH 264B,A00,098041,Rhoades; Brendon Patrick,10,0,15,5
1668096043078,MATH 268,A00,098042,Buss; Samuel R,10,0,10,0
1668096043511,MATH 269,A00,098043,Rhoades; Brendon Patrick,10,0,10,0
1668096043935,MATH 270B,A00,098044,Li; Bo,11,0,15,4
1668096044357,MATH 272B,A00,098045,Holst; Michael J,13,0,15,2
1668096044790,MATH 273A,A00,098046,Tian; Xiaochuan,10,0,15,5
1668096045227,MATH 275,A01,098048,Tian; Xiaochuan,6,0,10,4
1668096045649,MATH 278A,A00,098049,Holst; Michael J,8,0,10,2
1668096046082,MATH 278B,A00,098050,Cloninger; Alexander,10,0,10,0
1668096046508,MATH 278C,A00,098051,Nie; Jiawang,7,0,10,3
1668096046932,MATH 280B,A00,098052,Zheng; Tianyi,10,0,15,5
1668096047355,MATH 281B,A00,098053,Bradic; Jelena,3,0,15,12
1668096047785,MATH 282B,A00,098054,Arias-Castro; Ery,0,0,15,15
1668096048208,MATH 285,A00,098055,Fitzsimmons; Patrick J,0,0,15,17
1668096048643,MATH 287B,A00,098056,Arias-Castro; Ery,3,0,15,12
1668096049079,MATH 288,A00,098057,Agarwal; Pooja,9,0,10,1
1668096049079,MATH 288,B00,098058,Zhang; Danna,8,0,10,2
1668096049079,MATH 288,C00,098059,Williams; Ruth J,10,0,10,0
1668096049522,MATH 290B,A00,098060,Roberts; Justin Deritter,13,0,15,2
1668096049945,MATH 292,A00,098061,Belmont; Eva Kinoshita,10,0,10,0
1668096050374,MATH 295,A00,098062,Suk; Andrew Hoon,48,0,50,2
1668096050799,MATH 296,A00,098063,Novak; Jonathan I,20,0,20,0
1668096051220,MATH 297,001,098064,Gamst; Anthony Collins,9997,0,9999,2
1668096553136,COGS 205,A00,101395,Chiba; Andrea,19,0,20,1
1668096553571,COGS 210B,001,101404,Greene; Deanna Jacquelyn,9998,0,9999,1
1668096553571,COGS 210B,002,101417,Xia; Haijun,9999,0,9999,0
1668096553571,COGS 210B,003,101422,Nitz; Douglas A.,9999,0,9999,0
1668096553571,COGS 210B,004,101423,Hollan; James D.,9998,0,9999,1
1668096553571,COGS 210B,005,101424,Deak; Gedeon O.,9998,0,9999,1
1668096553571,COGS 210B,006,101425,Rossano; Federico,9999,0,9999,0
1668096553996,COGS 211B,A00,101427,Coulson; Seana M,9996,0,9999,3
1668096554419,COGS 220,A00,101428,Hollan; James D.,0,0,25,25
1668096554845,COGS 229,A00,101429,Dow; Steven P,18,0,25,7
1668096555267,COGS 230,A00,101430,Klemmer; Scott R,13,0,17,4
1668096555698,COGS 234,A00,101431,Xia; Haijun,3,0,25,22
1668096556128,COGS 260,A00,101432,Kiyonaga; Anastasia,19,0,25,6
1668096556128,COGS 260,B00,101433,Kirsh; David Joel,16,0,25,9
1668096556557,CSE 202,A00,102371,Impagliazzo; Russell,0,0,0,0
1668096556983,CSE 203B,A01,102373,Cheng; Chung Kuan,0,0,0,0
1668096557405,CSE 208,A00,102374,Micciancio; Daniele,0,0,0,0
1668096557828,CSE 209A,A00,112895,Impagliazzo; Russell,0,0,15,15
1668096558264,CSE 209B,A00,108005,Bellare; Mihir,0,0,0,0
1668096558687,CSE 210,A00,113163,Coblenz; Michael J,0,0,0,0
1668096559124,CSE 219,A00,106111,Dow; Steven P,0,0,20,20
1668096559548,CSE 221,A00,102376,Voelker; Geoffrey M.,0,0,0,0
1668096559974,CSE 224,A01,102378,Porter; George M,0,0,0,0
1668096560397,CSE 229A,A00,102379,Savage; Stefan,0,0,0,0
1668096560828,CSE 229C,A00,102380,Munyaka; Imani N. S.,0,0,0,0
1668096561252,CSE 232B,A00,102382,Deutsch; Alin Bernard,0,0,0,0
1668096561679,CSE 234,A01,112904,Kumar; Arun Kumar,0,0,0,0
1668096562107,CSE 237A,A00,102383,Rosing; Tajana Simunic,0,0,0,0
1668096562532,CSE 239A,A00,102384,Deutsch; Alin Bernard,0,0,0,0
1668096562957,CSE 239B,A00,102385,Polikarpova; Nadezhda,0,0,0,0
1668096563401,CSE 240A,A00,102386,Pannuto; Patrick William,0,0,0,0
1668096563826,CSE 240B,A00,102387,Zhao; Jishen,0,0,0,0
1668096564251,CSE 241A,A00,106406,Kang; Mingu,0,0,0,0
1668096564685,CSE 249B,A00,102388,Kahng; Andrew Byun,0,0,8,8
1668096565109,CSE 251B,A01,102392,Cottrell; Garrison W,0,0,0,0
1668096565109,CSE 251B,A02,102393,Cottrell; Garrison W,0,0,0,0
1668096565545,CSE 252B,A00,102394,Ochoa; Benjamin Lawrence,0,0,0,0
1668096565968,CSE 257,A01,102396,Gao; Sicun,0,0,0,0
1668096566396,CSE 272,A00,102397,Li; Tzumao,0,0,0,0
1668096566819,CSE 274,A00,111323,Chern; Albert Ren-Haur,0,0,0,0
1668096567249,CSE 282,A00,102398,Pevzner; Pavel Arkadjevich,0,0,0,0
1668096567673,CSE 284,A00,114175,Gymrek; Melissa Ann,0,0,0,0
1668096568096,CSE 290,A00,102399,Chandraker; Manmohan Krishna,0,0,0,0
1668096568096,CSE 290,B00,102400,Vaccaro; Kristen Marie,0,0,25,25
1668096568096,CSE 290,C00,102414,Pannuto; Patrick William,0,0,25,25
1668096568096,CSE 290,D00,102427,Pevzner; Pavel Arkadjevich,0,0,0,0
1668096568096,CSE 290,E00,102429,Zhao; Jishen,0,0,0,0
1668096568096,CSE 290,F00,102436,Tullsen; Dean Michael,0,0,0,0
1668096568096,CSE 290,G00,102440,Christensen; Henrik I,0,0,20,20
1668096568533,CSE 291,A00,102443,Su; Hao,0,0,0,0
1668096568533,CSE 291,B00,102448,Polikarpova; Nadezhda,0,0,0,0
1668096568533,CSE 291,C00,102453,Vaccaro; Kristen Marie,0,0,0,0
1668096568533,CSE 291,D00,111343,Savage; Stefan,0,0,0,0
1668096568533,CSE 291,E00,116474,Claffy; Kimberly Claire,0,0,0,0
1668096568533,CSE 291,F00,116479,Pasquale; Joseph,0,0,0,0
1668096568961,CSE 293,001,119111,Bafna; Vineet,9999,0,9999,0
1668096568961,CSE 293,002,119118,Bellare; Mihir,9999,0,9999,0
1668096568961,CSE 293,003,119122,Berg-Kirkpatrick; Taylor D,9999,0,9999,0
1668096568961,CSE 293,004,119135,Christensen; Henrik I,9999,0,9999,0
1668096568961,CSE 293,005,119142,Cottrell; Garrison W,9999,0,9999,0
1668096568961,CSE 293,006,119146,Deutsch; Alin Bernard,9999,0,9999,0
1668096568961,CSE 293,007,119159,Esmaeilzadeh; Hadi,9999,0,9999,0
1668096568961,CSE 293,008,119166,Freund; Yoav,9999,0,9999,0
1668096568961,CSE 293,009,119170,Griswold; William G.,9999,0,9999,0
1668096568961,CSE 293,010,119183,Gymrek; Melissa Ann,9999,0,9999,0
1668096568961,CSE 293,011,119190,Heninger; Nadia A,9999,0,9999,0
1668096568961,CSE 293,012,119230,Impagliazzo; Russell,9999,0,9999,0
1668096568961,CSE 293,013,119232,Jhala; Ranjit,9999,0,9999,0
1668096568961,CSE 293,014,119233,Kahng; Andrew Byun,9999,0,9999,0
1668096568961,CSE 293,015,119298,Kane; Daniel Mertz,9999,0,9999,0
1668096568961,CSE 293,016,119299,Kriegman; David J,9999,0,9999,0
1668096568961,CSE 293,017,119300,Kumar; Arun Kumar,9999,0,9999,0
1668096568961,CSE 293,018,119301,Lerner; Sorin,9999,0,9999,0
1668096568961,CSE 293,019,119302,Lovett; Shachar,9999,0,9999,0
1668096568961,CSE 293,020,119303,McAuley; Julian John,9999,0,9999,0
1668096568961,CSE 293,021,119304,Micciancio; Daniele,9999,0,9999,0
1668096568961,CSE 293,022,119367,Orailoglu; Alex,9999,0,9999,0
1668096568961,CSE 293,023,119382,Paturi; Ramamohan,9999,0,9999,0
1668096568961,CSE 293,024,119404,Polikarpova; Nadezhda,9999,0,9999,0
1668096568961,CSE 293,025,119406,Politz; Joseph Gibbs,9999,0,9999,0
1668096568961,CSE 293,026,119411,Porter; George M,9999,0,9999,0
1668096568961,CSE 293,027,119414,Porter; Leonard Emerson,9999,0,9999,0
1668096568961,CSE 293,028,119416,Ramamoorthi; Ravi,9999,0,9999,0
1668096568961,CSE 293,029,119417,Sahoo; Debashis,9999,0,9999,0
1668096568961,CSE 293,030,119420,Saul; Lawrence,9999,0,9999,0
1668096568961,CSE 293,031,119421,Savage; Stefan,9999,0,9999,0
1668096568961,CSE 293,032,119425,Schulze; Jurgen P.,9999,0,9999,0
1668096568961,CSE 293,033,119426,Snoeren; Alex C.,9999,0,9999,0
1668096568961,CSE 293,034,119428,Shang; Jingbo,9999,0,9999,0
1668096568961,CSE 293,035,119430,Stefan; Deian,9999,0,9999,0
1668096568961,CSE 293,036,119431,Su; Hao,9999,0,9999,0
1668096568961,CSE 293,037,119433,Swanson; Steven James,9999,0,9999,0
1668096568961,CSE 293,038,119435,Tullsen; Dean Michael,9999,0,9999,0
1668096568961,CSE 293,039,119483,Voelker; Geoffrey M.,9999,0,9999,0
1668096568961,CSE 293,040,119537,Zhao; Jishen,9999,0,9999,0
1668096568961,CSE 293,041,119538,Zhou; Yuan-Yuan,9999,0,9999,0
1668096568961,CSE 293,042,119539,Gao; Sicun,9999,0,9999,0
1668096568961,CSE 293,043,119540,Weibel; Nadir,9999,0,9999,0
1668096568961,CSE 293,044,119541,Gupta; Rajesh K.,9999,0,9999,0
1668096568961,CSE 293,045,126410,Vaccaro; Kristen Marie,9999,0,9999,0
1668096568961,CSE 293,046,126411,Klemke; Richard,9999,0,9999,0
1668096569388,CSE 294,A00,102459,Voelker; Geoffrey M.,0,0,0,0
1668096569388,CSE 294,B00,111322,Orailoglu; Alex,0,0,0,0
1668096569816,DSE 201,A00,096914,Deutsch; Alin Bernard,30,0,30,0
1668096570239,DSE 210,A00,096915,Dasgupta; Sanjoy,30,0,30,0
1668096570661,DSE 260A,A00,096916,Altintas De Callaf; Ilkay,30,0,30,0
1668096571096,ECE 200,001,103586,Antipa; Nicholas A,9999,0,9999,0
1668096571096,ECE 200,002,103587,Atanasov; Nikolay A.,9999,0,9999,0
1668096571096,ECE 200,003,103588,Bharadia; Dinesh,9999,0,9999,0
1668096571096,ECE 200,004,103589,Cheng; Chung Kuan,9999,0,9999,0
1668096571096,ECE 200,005,103590,Cosman; Pamela C.,9999,0,9999,0
1668096571096,ECE 200,006,103591,Dayeh; Shadi Ahmad,9999,0,9999,0
1668096571096,ECE 200,007,103592,Fainman; Yeshaiahu,9999,0,9999,0
1668096571096,ECE 200,008,103593,Ford; Joseph Earl,9999,0,9999,0
1668096571096,ECE 200,009,103594,Franceschetti; Massimo,9999,0,9999,0
1668096571096,ECE 200,010,103595,Fullerton; Eric E,9999,0,9999,0
1668096571096,ECE 200,011,103596,Galton; Ian A,9999,0,9999,0
1668096571096,ECE 200,012,103597,Gilja; Vikash,9999,0,9999,0
1668096571096,ECE 200,013,103598,Hall; Drew A.,9999,0,9999,0
1668096571096,ECE 200,014,103599,Hsueh; Tzu-Chien,9999,0,9999,0
1668096571096,ECE 200,015,103600,Javidi; Tara,9999,0,9999,0
1668096571096,ECE 200,016,103601,Kahng; Andrew Byun,9999,0,9999,0
1668096571096,ECE 200,017,103602,Kim; Young-Han,9999,0,9999,0
1668096571096,ECE 200,018,103603,Koushanfar; Farinaz,9999,0,9999,0
1668096571096,ECE 200,019,103604,Kuzum; Duygu,9999,0,9999,0
1668096571096,ECE 200,020,103605,Le; Hanh-Phuc,9999,0,9999,0
1668096571096,ECE 200,021,103606,Lin; Bill,9999,0,9999,0
1668096571096,ECE 200,022,103607,Liu; Zhaowei,9998,0,9999,1
1668096571096,ECE 200,023,103608,Lo; Yu-Hwa,9999,0,9999,0
1668096571096,ECE 200,024,103609,Lomakin; Vitaliy,9999,0,9999,0
1668096571096,ECE 200,025,103610,Mercier; Patrick Philip,9999,0,9999,0
1668096571096,ECE 200,026,103611,Meyer; Florian,9999,0,9999,0
1668096571096,ECE 200,027,103612,Milstein; Laurence B.,9999,0,9999,0
1668096571096,ECE 200,028,103613,Mir Arabbaygi; Siavash,9999,0,9999,0
1668096571096,ECE 200,029,103614,Mookherjea; Shayan,9999,0,9999,0
1668096571096,ECE 200,030,103615,Morris; Karcher William,9999,0,9999,0
1668096571096,ECE 200,031,103616,Ng; Tse Nga,9999,0,9999,0
1668096571096,ECE 200,032,103617,Nguyen; Truong Quang,9999,0,9999,0
1668096571096,ECE 200,033,103618,Nomura; Kenji,9999,0,9999,0
1668096571096,ECE 200,034,103619,Orlitsky; Alon,9999,0,9999,0
1668096571096,ECE 200,035,103620,Pal; Piya,9999,0,9999,0
1668096571096,ECE 200,036,103621,Papen; George C.,9999,0,9999,0
1668096571096,ECE 200,037,103622,Radic; Stojan,9999,0,9999,0
1668096571096,ECE 200,038,103623,Rao; Bhaskar D.,9999,0,9999,0
1668096571096,ECE 200,039,103624,Rao; Ramesh R,9999,0,9999,0
1668096571096,ECE 200,040,103625,Rebeiz; Gabriel,9999,0,9999,0
1668096571096,ECE 200,041,103626,Sanford; John R,9999,0,9999,0
1668096571096,ECE 200,042,103627,Siegel; Paul H.,9999,0,9999,0
1668096571096,ECE 200,043,103628,Sievenpiper; Daniel F.,9999,0,9999,0
1668096571096,ECE 200,044,103629,Sworder; David D.,9999,0,9999,0
1668096571096,ECE 200,045,103630,Taur; Yuan,9999,0,9999,0
1668096571096,ECE 200,046,103631,Touri; Behrouz,9999,0,9999,0
1668096571096,ECE 200,047,103632,Trivedi; Mohan M.,9999,0,9999,0
1668096571096,ECE 200,048,103633,Vasconcelos; Nuno,9999,0,9999,0
1668096571096,ECE 200,049,103634,Wang; Xiaolong,9999,0,9999,0
1668096571096,ECE 200,050,103635,Xie; Pengtao,9999,0,9999,0
1668096571096,ECE 200,051,103636,Yip; Michael,9999,0,9999,0
1668096571096,ECE 200,052,103637,Zeger; Kenneth A.,999,0,999,0
1668096571096,ECE 200,053,103638,Zhang; Xinyu,9999,0,9999,0
1668096571096,ECE 200,054,103639,Turakhia; Yatish Girish,9999,0,9999,0
1668096571096,ECE 200,055,103640,Kang; Mingu,9999,0,9999,0
1668096571096,ECE 200,056,103641,Shi; Yuanyuan,9999,0,9999,0
1668096571096,ECE 200,057,103642,Wang; Edward Jay,9999,0,9999,0
1668096571096,ECE 200,058,103643,Zheng; Yang,9999,0,9999,0
1668096571530,ECE 202,A00,103644,Kuzum; Duygu,0,0,0,0
1668096571956,ECE 212BN,A00,103646,Ng; Tse Nga,0,0,0,0
1668096572391,ECE 221,A00,111493,Staff,0,0,0,0
1668096572828,ECE 222B,A00,103647,Lomakin; Vitaliy,0,0,0,0
1668096573262,ECE 230B,A00,103648,Taur; Yuan,0,0,0,0
1668096573689,ECE 238B,A00,103649,Garay; Javier,0,0,0,0
1668096574113,ECE 240B,A00,112900,Fainman; Yeshaiahu,0,0,0,0
1668096574549,ECE 247A,A00,103650,Jokerst; Jesse Vincent,0,0,0,0
1668096574973,ECE 247B,A00,103651,Wang; Joseph,0,0,0,0
1668096575407,ECE 250,A00,103652,Siegel; Paul H.,0,0,0,0
1668096575838,ECE 251A,A00,103654,Rao; Bhaskar D.,0,0,0,0
1668096576267,ECE 257B,A00,103655,Bharadia; Dinesh,0,0,0,0
1668096576690,ECE 258A,A00,103656,Milstein; Laurence B.,0,0,0,0
1668096577133,ECE 260B,A00,103658,Kang; Mingu,0,0,0,0
1668096577567,ECE 264A,A00,103659,Galton; Ian A,0,0,0,0
1668096577994,ECE 265A,A00,103661,Gudem; Prasad S.S.,0,0,0,0
1668096578417,ECE 265D,A00,103662,Gudem; Prasad S.S.,0,0,0,0
1668096578844,ECE 268,A00,103663,Koushanfar; Farinaz,0,0,0,0
1668096579267,ECE 269,A01,103665,Pal; Piya,0,0,0,0
1668096579702,ECE 271B,A00,103666,Vasconcelos; Manuela,0,0,0,0
1668096580132,ECE 276A,A00,103667,Atanasov; Nikolay A.,0,0,0,0
1668096580556,ECE 277,A00,103668,An; Cheolhong,0,0,0,0
1668096580991,ECE 279,A00,117947,Hall; Drew A.,0,0,0,0
1668096581839,ECE 283,A00,103670,Hsueh; Tzu-Chien,0,0,0,0
1668096582264,ECE 284,A00,103671,Turakhia; Yatish Girish,0,0,0,0
1668096582688,ECE 285,A00,103672,Zheng; Yang,0,0,0,0
1668096582688,ECE 285,B00,103673,Sworder; David D.,0,0,0,0
1668096583113,ECE 287,A00,103676,Javidi; Tara,0,0,0,0
1668096583538,MATH 200B,A00,098023,Salehi Golsefidy; Alireza,13,0,15,2
1668096584032,MATH 202B,A00,098024,Rhoades; Brendon Patrick,9,0,15,6
1668096584456,MATH 203B,A00,098025,Oprea; Dragos N.,10,0,15,5
1668096584887,MATH 204B,A00,098026,Sorensen; Claus M,13,0,15,2
1668096585310,MATH 208,A00,098027,Izadi; Elham,7,0,10,3
1668096585746,MATH 209,A00,098028,Pollack; Aaron,10,0,10,0
1668096586175,MATH 211A,A00,112919,Rogalski; Daniel,9,0,10,1
1668096586608,MATH 211B,A00,112920,Seward; Brandon M.,9,0,10,1
1668096587043,MATH 218,A00,098029,Li; Bo,10,0,10,0
1668096587467,MATH 220B,A00,098030,Novak; Jonathan I,12,0,15,3
1668096587915,MATH 221A,A00,098031,Ebenfelt; Peter F,13,0,15,2
1668096588338,MATH 231B,A00,098032,Zlatos; Andrej,12,0,15,3
1668096588777,MATH 240B,A00,098033,Ni; Lei,9,0,15,6
1668096589200,MATH 243,A00,098034,Jekel; David Andrew,10,0,10,0
1668096589625,MATH 245A,A00,098035,Nie; Jiawang,0,0,15,16
1668096590056,MATH 248,A00,098036,Bejenaru; Ioan,10,0,10,0
1668096590482,MATH 250B,A00,098037,Spolaor; Luca,14,0,15,1
1668096590912,MATH 258,A00,098038,Ni; Lei,10,0,10,0
1668096591336,MATH 264B,A00,098041,Rhoades; Brendon Patrick,10,0,15,5
1668096591757,MATH 268,A00,098042,Buss; Samuel R,10,0,10,0
1668096592180,MATH 269,A00,098043,Rhoades; Brendon Patrick,10,0,10,0
1668096592602,MATH 270B,A00,098044,Li; Bo,11,0,15,4
1668096593033,MATH 272B,A00,098045,Holst; Michael J,13,0,15,2
1668096593460,MATH 273A,A00,098046,Tian; Xiaochuan,10,0,15,5
1668096593884,MATH 275,A01,098048,Tian; Xiaochuan,6,0,10,4
1668096594306,MATH 278A,A00,098049,Holst; Michael J,8,0,10,2
1668096594731,MATH 278B,A00,098050,Cloninger; Alexander,10,0,10,0
1668096595161,MATH 278C,A00,098051,Nie; Jiawang,7,0,10,3
1668096595599,MATH 280B,A00,098052,Zheng; Tianyi,10,0,15,5
1668096596020,MATH 281B,A00,098053,Bradic; Jelena,3,0,15,12
1668096596460,MATH 282B,A00,098054,Arias-Castro; Ery,0,0,15,15
1668096596887,MATH 285,A00,098055,Fitzsimmons; Patrick J,0,0,15,17
1668096597324,MATH 287B,A00,098056,Arias-Castro; Ery,3,0,15,12
1668096597749,MATH 288,A00,098057,Agarwal; Pooja,9,0,10,1
1668096597749,MATH 288,B00,098058,Zhang; Danna,8,0,10,2
1668096597749,MATH 288,C00,098059,Williams; Ruth J,10,0,10,0
1668096598177,MATH 290B,A00,098060,Roberts; Justin Deritter,13,0,15,2
1668096598598,MATH 292,A00,098061,Belmont; Eva Kinoshita,10,0,10,0
1668096599023,MATH 295,A00,098062,Suk; Andrew Hoon,48,0,50,2
1668096599445,MATH 296,A00,098063,Novak; Jonathan I,20,0,20,0
1668096599867,MATH 297,001,098064,Gamst; Anthony Collins,9997,0,9999,2
1668097101124,COGS 205,A00,101395,Chiba; Andrea,19,0,20,1
1668097101548,COGS 210B,001,101404,Greene; Deanna Jacquelyn,9998,0,9999,1
1668097101548,COGS 210B,002,101417,Xia; Haijun,9999,0,9999,0
1668097101548,COGS 210B,003,101422,Nitz; Douglas A.,9999,0,9999,0
1668097101548,COGS 210B,004,101423,Hollan; James D.,9998,0,9999,1
1668097101548,COGS 210B,005,101424,Deak; Gedeon O.,9998,0,9999,1
1668097101548,COGS 210B,006,101425,Rossano; Federico,9999,0,9999,0
1668097101977,COGS 211B,A00,101427,Coulson; Seana M,9996,0,9999,3
1668097102409,COGS 220,A00,101428,Hollan; James D.,0,0,25,25
1668097102841,COGS 229,A00,101429,Dow; Steven P,18,0,25,7
1668097103280,COGS 230,A00,101430,Klemmer; Scott R,13,0,17,4
1668097103703,COGS 234,A00,101431,Xia; Haijun,3,0,25,22
1668097104139,COGS 260,A00,101432,Kiyonaga; Anastasia,19,0,25,6
1668097104139,COGS 260,B00,101433,Kirsh; David Joel,16,0,25,9
1668097104560,CSE 202,A00,102371,Impagliazzo; Russell,0,0,0,0
1668097104996,CSE 203B,A01,102373,Cheng; Chung Kuan,0,0,0,0
1668097105510,CSE 208,A00,102374,Micciancio; Daniele,0,0,0,0
1668097105934,CSE 209A,A00,112895,Impagliazzo; Russell,0,0,15,15
1668097106360,CSE 209B,A00,108005,Bellare; Mihir,0,0,0,0
1668097106782,CSE 210,A00,113163,Coblenz; Michael J,0,0,0,0
1668097107212,CSE 219,A00,106111,Dow; Steven P,0,0,20,20
1668097107640,CSE 221,A00,102376,Voelker; Geoffrey M.,0,0,0,0
1668097108064,CSE 224,A01,102378,Porter; George M,0,0,0,0
1668097108485,CSE 229A,A00,102379,Savage; Stefan,0,0,0,0
1668097108909,CSE 229C,A00,102380,Munyaka; Imani N. S.,0,0,0,0
1668097109331,CSE 232B,A00,102382,Deutsch; Alin Bernard,0,0,0,0
1668097109756,CSE 234,A01,112904,Kumar; Arun Kumar,0,0,0,0
1668097110182,CSE 237A,A00,102383,Rosing; Tajana Simunic,0,0,0,0
1668097110613,CSE 239A,A00,102384,Deutsch; Alin Bernard,0,0,0,0
1668097111034,CSE 239B,A00,102385,Polikarpova; Nadezhda,0,0,0,0
1668097111535,CSE 240A,A00,102386,Pannuto; Patrick William,0,0,0,0
1668097111956,CSE 240B,A00,102387,Zhao; Jishen,0,0,0,0
1668097112378,CSE 241A,A00,106406,Kang; Mingu,0,0,0,0
1668097112801,CSE 249B,A00,102388,Kahng; Andrew Byun,0,0,8,8
1668097113226,CSE 251B,A01,102392,Cottrell; Garrison W,0,0,0,0
1668097113226,CSE 251B,A02,102393,Cottrell; Garrison W,0,0,0,0
1668097113653,CSE 252B,A00,102394,Ochoa; Benjamin Lawrence,0,0,0,0
1668097114091,CSE 257,A01,102396,Gao; Sicun,0,0,0,0
1668097114528,CSE 272,A00,102397,Li; Tzumao,0,0,0,0
1668097114955,CSE 274,A00,111323,Chern; Albert Ren-Haur,0,0,0,0
1668097115397,CSE 282,A00,102398,Pevzner; Pavel Arkadjevich,0,0,0,0
1668097115819,CSE 284,A00,114175,Gymrek; Melissa Ann,0,0,0,0
1668097116262,CSE 290,A00,102399,Chandraker; Manmohan Krishna,0,0,0,0
1668097116262,CSE 290,B00,102400,Vaccaro; Kristen Marie,0,0,25,25
1668097116262,CSE 290,C00,102414,Pannuto; Patrick William,0,0,25,25
1668097116262,CSE 290,D00,102427,Pevzner; Pavel Arkadjevich,0,0,0,0
1668097116262,CSE 290,E00,102429,Zhao; Jishen,0,0,0,0
1668097116262,CSE 290,F00,102436,Tullsen; Dean Michael,0,0,0,0
1668097116262,CSE 290,G00,102440,Christensen; Henrik I,0,0,20,20
1668097116691,CSE 291,A00,102443,Su; Hao,0,0,0,0
1668097116691,CSE 291,B00,102448,Polikarpova; Nadezhda,0,0,0,0
1668097116691,CSE 291,C00,102453,Vaccaro; Kristen Marie,0,0,0,0
1668097116691,CSE 291,D00,111343,Savage; Stefan,0,0,0,0
1668097116691,CSE 291,E00,116474,Claffy; Kimberly Claire,0,0,0,0
1668097116691,CSE 291,F00,116479,Pasquale; Joseph,0,0,0,0
1668097117154,CSE 293,001,119111,Bafna; Vineet,9999,0,9999,0
1668097117154,CSE 293,002,119118,Bellare; Mihir,9999,0,9999,0
1668097117154,CSE 293,003,119122,Berg-Kirkpatrick; Taylor D,9999,0,9999,0
1668097117154,CSE 293,004,119135,Christensen; Henrik I,9999,0,9999,0
1668097117154,CSE 293,005,119142,Cottrell; Garrison W,9999,0,9999,0
1668097117154,CSE 293,006,119146,Deutsch; Alin Bernard,9999,0,9999,0
1668097117154,CSE 293,007,119159,Esmaeilzadeh; Hadi,9999,0,9999,0
1668097117154,CSE 293,008,119166,Freund; Yoav,9999,0,9999,0
1668097117154,CSE 293,009,119170,Griswold; William G.,9999,0,9999,0
1668097117154,CSE 293,010,119183,Gymrek; Melissa Ann,9999,0,9999,0
1668097117154,CSE 293,011,119190,Heninger; Nadia A,9999,0,9999,0
1668097117154,CSE 293,012,119230,Impagliazzo; Russell,9999,0,9999,0
1668097117154,CSE 293,013,119232,Jhala; Ranjit,9999,0,9999,0
1668097117154,CSE 293,014,119233,Kahng; Andrew Byun,9999,0,9999,0
1668097117154,CSE 293,015,119298,Kane; Daniel Mertz,9999,0,9999,0
1668097117154,CSE 293,016,119299,Kriegman; David J,9999,0,9999,0
1668097117154,CSE 293,017,119300,Kumar; Arun Kumar,9999,0,9999,0
1668097117154,CSE 293,018,119301,Lerner; Sorin,9999,0,9999,0
1668097117154,CSE 293,019,119302,Lovett; Shachar,9999,0,9999,0
1668097117154,CSE 293,020,119303,McAuley; Julian John,9999,0,9999,0
1668097117154,CSE 293,021,119304,Micciancio; Daniele,9999,0,9999,0
1668097117154,CSE 293,022,119367,Orailoglu; Alex,9999,0,9999,0
1668097117154,CSE 293,023,119382,Paturi; Ramamohan,9999,0,9999,0
1668097117154,CSE 293,024,119404,Polikarpova; Nadezhda,9999,0,9999,0
1668097117154,CSE 293,025,119406,Politz; Joseph Gibbs,9999,0,9999,0
1668097117154,CSE 293,026,119411,Porter; George M,9999,0,9999,0
1668097117154,CSE 293,027,119414,Porter; Leonard Emerson,9999,0,9999,0
1668097117154,CSE 293,028,119416,Ramamoorthi; Ravi,9999,0,9999,0
1668097117154,CSE 293,029,119417,Sahoo; Debashis,9999,0,9999,0
1668097117154,CSE 293,030,119420,Saul; Lawrence,9999,0,9999,0
1668097117154,CSE 293,031,119421,Savage; Stefan,9999,0,9999,0
1668097117154,CSE 293,032,119425,Schulze; Jurgen P.,9999,0,9999,0
1668097117154,CSE 293,033,119426,Snoeren; Alex C.,9999,0,9999,0
1668097117154,CSE 293,034,119428,Shang; Jingbo,9999,0,9999,0
1668097117154,CSE 293,035,119430,Stefan; Deian,9999,0,9999,0
1668097117154,CSE 293,036,119431,Su; Hao,9999,0,9999,0
1668097117154,CSE 293,037,119433,Swanson; Steven James,9999,0,9999,0
1668097117154,CSE 293,038,119435,Tullsen; Dean Michael,9999,0,9999,0
1668097117154,CSE 293,039,119483,Voelker; Geoffrey M.,9999,0,9999,0
1668097117154,CSE 293,040,119537,Zhao; Jishen,9999,0,9999,0
1668097117154,CSE 293,041,119538,Zhou; Yuan-Yuan,9999,0,9999,0
1668097117154,CSE 293,042,119539,Gao; Sicun,9999,0,9999,0
1668097117154,CSE 293,043,119540,Weibel; Nadir,9999,0,9999,0
1668097117154,CSE 293,044,119541,Gupta; Rajesh K.,9999,0,9999,0
1668097117154,CSE 293,045,126410,Vaccaro; Kristen Marie,9999,0,9999,0
1668097117154,CSE 293,046,126411,Klemke; Richard,9999,0,9999,0
1668097117581,CSE 294,A00,102459,Voelker; Geoffrey M.,0,0,0,0
1668097117581,CSE 294,B00,111322,Orailoglu; Alex,0,0,0,0
1668097118005,DSE 201,A00,096914,Deutsch; Alin Bernard,30,0,30,0
1668097118427,DSE 210,A00,096915,Dasgupta; Sanjoy,30,0,30,0
1668097118858,DSE 260A,A00,096916,Altintas De Callaf; Ilkay,30,0,30,0
1668097119295,ECE 200,001,103586,Antipa; Nicholas A,9999,0,9999,0
1668097119295,ECE 200,002,103587,Atanasov; Nikolay A.,9999,0,9999,0
1668097119295,ECE 200,003,103588,Bharadia; Dinesh,9999,0,9999,0
1668097119295,ECE 200,004,103589,Cheng; Chung Kuan,9999,0,9999,0
1668097119295,ECE 200,005,103590,Cosman; Pamela C.,9999,0,9999,0
1668097119295,ECE 200,006,103591,Dayeh; Shadi Ahmad,9999,0,9999,0
1668097119295,ECE 200,007,103592,Fainman; Yeshaiahu,9999,0,9999,0
1668097119295,ECE 200,008,103593,Ford; Joseph Earl,9999,0,9999,0
1668097119295,ECE 200,009,103594,Franceschetti; Massimo,9999,0,9999,0
1668097119295,ECE 200,010,103595,Fullerton; Eric E,9999,0,9999,0
1668097119295,ECE 200,011,103596,Galton; Ian A,9999,0,9999,0
1668097119295,ECE 200,012,103597,Gilja; Vikash,9999,0,9999,0
1668097119295,ECE 200,013,103598,Hall; Drew A.,9999,0,9999,0
1668097119295,ECE 200,014,103599,Hsueh; Tzu-Chien,9999,0,9999,0
1668097119295,ECE 200,015,103600,Javidi; Tara,9999,0,9999,0
1668097119295,ECE 200,016,103601,Kahng; Andrew Byun,9999,0,9999,0
1668097119295,ECE 200,017,103602,Kim; Young-Han,9999,0,9999,0
1668097119295,ECE 200,018,103603,Koushanfar; Farinaz,9999,0,9999,0
1668097119295,ECE 200,019,103604,Kuzum; Duygu,9999,0,9999,0
1668097119295,ECE 200,020,103605,Le; Hanh-Phuc,9999,0,9999,0
1668097119295,ECE 200,021,103606,Lin; Bill,9999,0,9999,0
1668097119295,ECE 200,022,103607,Liu; Zhaowei,9998,0,9999,1
1668097119295,ECE 200,023,103608,Lo; Yu-Hwa,9999,0,9999,0
1668097119295,ECE 200,024,103609,Lomakin; Vitaliy,9999,0,9999,0
1668097119295,ECE 200,025,103610,Mercier; Patrick Philip,9999,0,9999,0
1668097119295,ECE 200,026,103611,Meyer; Florian,9999,0,9999,0
1668097119295,ECE 200,027,103612,Milstein; Laurence B.,9999,0,9999,0
1668097119295,ECE 200,028,103613,Mir Arabbaygi; Siavash,9999,0,9999,0
1668097119295,ECE 200,029,103614,Mookherjea; Shayan,9999,0,9999,0
1668097119295,ECE 200,030,103615,Morris; Karcher William,9999,0,9999,0
1668097119295,ECE 200,031,103616,Ng; Tse Nga,9999,0,9999,0
1668097119295,ECE 200,032,103617,Nguyen; Truong Quang,9999,0,9999,0
1668097119295,ECE 200,033,103618,Nomura; Kenji,9999,0,9999,0
1668097119295,ECE 200,034,103619,Orlitsky; Alon,9999,0,9999,0
1668097119295,ECE 200,035,103620,Pal; Piya,9999,0,9999,0
1668097119295,ECE 200,036,103621,Papen; George C.,9999,0,9999,0
1668097119295,ECE 200,037,103622,Radic; Stojan,9999,0,9999,0
1668097119295,ECE 200,038,103623,Rao; Bhaskar D.,9999,0,9999,0
1668097119295,ECE 200,039,103624,Rao; Ramesh R,9999,0,9999,0
1668097119295,ECE 200,040,103625,Rebeiz; Gabriel,9999,0,9999,0
1668097119295,ECE 200,041,103626,Sanford; John R,9999,0,9999,0
1668097119295,ECE 200,042,103627,Siegel; Paul H.,9999,0,9999,0
1668097119295,ECE 200,043,103628,Sievenpiper; Daniel F.,9999,0,9999,0
1668097119295,ECE 200,044,103629,Sworder; David D.,9999,0,9999,0
1668097119295,ECE 200,045,103630,Taur; Yuan,9999,0,9999,0
1668097119295,ECE 200,046,103631,Touri; Behrouz,9999,0,9999,0
1668097119295,ECE 200,047,103632,Trivedi; Mohan M.,9999,0,9999,0
1668097119295,ECE 200,048,103633,Vasconcelos; Nuno,9999,0,9999,0
1668097119295,ECE 200,049,103634,Wang; Xiaolong,9999,0,9999,0
1668097119295,ECE 200,050,103635,Xie; Pengtao,9999,0,9999,0
1668097119295,ECE 200,051,103636,Yip; Michael,9999,0,9999,0
1668097119295,ECE 200,052,103637,Zeger; Kenneth A.,999,0,999,0
1668097119295,ECE 200,053,103638,Zhang; Xinyu,9999,0,9999,0
1668097119295,ECE 200,054,103639,Turakhia; Yatish Girish,9999,0,9999,0
1668097119295,ECE 200,055,103640,Kang; Mingu,9999,0,9999,0
1668097119295,ECE 200,056,103641,Shi; Yuanyuan,9999,0,9999,0
1668097119295,ECE 200,057,103642,Wang; Edward Jay,9999,0,9999,0
1668097119295,ECE 200,058,103643,Zheng; Yang,9999,0,9999,0
1668097119720,ECE 202,A00,103644,Kuzum; Duygu,0,0,0,0
1668097120145,ECE 212BN,A00,103646,Ng; Tse Nga,0,0,0,0
1668097120575,ECE 221,A00,111493,Staff,0,0,0,0
1668097121006,ECE 222B,A00,103647,Lomakin; Vitaliy,0,0,0,0
1668097121431,ECE 230B,A00,103648,Taur; Yuan,0,0,0,0
1668097121867,ECE 238B,A00,103649,Garay; Javier,0,0,0,0
1668097122289,ECE 240B,A00,112900,Fainman; Yeshaiahu,0,0,0,0
1668097122720,ECE 247A,A00,103650,Jokerst; Jesse Vincent,0,0,0,0
1668097123146,ECE 247B,A00,103651,Wang; Joseph,0,0,0,0
1668097123568,ECE 250,A00,103652,Siegel; Paul H.,0,0,0,0
1668097123992,ECE 251A,A00,103654,Rao; Bhaskar D.,0,0,0,0
1668097124415,ECE 257B,A00,103655,Bharadia; Dinesh,0,0,0,0
1668097124845,ECE 258A,A00,103656,Milstein; Laurence B.,0,0,0,0
1668097125277,ECE 260B,A00,103658,Kang; Mingu,0,0,0,0
1668097125787,ECE 264A,A00,103659,Galton; Ian A,0,0,0,0
1668097126212,ECE 265A,A00,103661,Gudem; Prasad S.S.,0,0,0,0
1668097126648,ECE 265D,A00,103662,Gudem; Prasad S.S.,0,0,0,0
1668097127070,ECE 268,A00,103663,Koushanfar; Farinaz,0,0,0,0
1668097127492,ECE 269,A01,103665,Pal; Piya,0,0,0,0
1668097127923,ECE 271B,A00,103666,Vasconcelos; Manuela,0,0,0,0
1668097128359,ECE 276A,A00,103667,Atanasov; Nikolay A.,0,0,0,0
1668097128782,ECE 277,A00,103668,An; Cheolhong,0,0,0,0
1668097129205,ECE 279,A00,117947,Hall; Drew A.,0,0,0,0
1668097130057,ECE 283,A00,103670,Hsueh; Tzu-Chien,0,0,0,0
1668097130483,ECE 284,A00,103671,Turakhia; Yatish Girish,0,0,0,0
1668097130907,ECE 285,A00,103672,Zheng; Yang,0,0,0,0
1668097130907,ECE 285,B00,103673,Sworder; David D.,0,0,0,0
1668097131342,ECE 287,A00,103676,Javidi; Tara,0,0,0,0
1668097131772,MATH 200B,A00,098023,Salehi Golsefidy; Alireza,13,0,15,2
1668097132205,MATH 202B,A00,098024,Rhoades; Brendon Patrick,9,0,15,6
1668097132643,MATH 203B,A00,098025,Oprea; Dragos N.,10,0,15,5
1668097133066,MATH 204B,A00,098026,Sorensen; Claus M,13,0,15,2
1668097133502,MATH 208,A00,098027,Izadi; Elham,7,0,10,3
1668097133925,MATH 209,A00,098028,Pollack; Aaron,10,0,10,0
1668097134349,MATH 211A,A00,112919,Rogalski; Daniel,9,0,10,1
1668097134773,MATH 211B,A00,112920,Seward; Brandon M.,9,0,10,1
1668097135208,MATH 218,A00,098029,Li; Bo,10,0,10,0
1668097135640,MATH 220B,A00,098030,Novak; Jonathan I,12,0,15,3
1668097136065,MATH 221A,A00,098031,Ebenfelt; Peter F,13,0,15,2
1668097136491,MATH 231B,A00,098032,Zlatos; Andrej,12,0,15,3
1668097136913,MATH 240B,A00,098033,Ni; Lei,9,0,15,6
1668097137355,MATH 243,A00,098034,Jekel; David Andrew,10,0,10,0
1668097137781,MATH 245A,A00,098035,Nie; Jiawang,0,0,15,16
1668097138215,MATH 248,A00,098036,Bejenaru; Ioan,10,0,10,0
1668097138639,MATH 250B,A00,098037,Spolaor; Luca,14,0,15,1
1668097139063,MATH 258,A00,098038,Ni; Lei,10,0,10,0
1668097139490,MATH 264B,A00,098041,Rhoades; Brendon Patrick,10,0,15,5
1668097139914,MATH 268,A00,098042,Buss; Samuel R,10,0,10,0
1668097140338,MATH 269,A00,098043,Rhoades; Brendon Patrick,10,0,10,0
1668097140761,MATH 270B,A00,098044,Li; Bo,11,0,15,4
1668097141196,MATH 272B,A00,098045,Holst; Michael J,13,0,15,2
1668097141623,MATH 273A,A00,098046,Tian; Xiaochuan,10,0,15,5
1668097142051,MATH 275,A01,098048,Tian; Xiaochuan,6,0,10,4
1668097142486,MATH 278A,A00,098049,Holst; Michael J,8,0,10,2
1668097142913,MATH 278B,A00,098050,Cloninger; Alexander,10,0,10,0
1668097143335,MATH 278C,A00,098051,Nie; Jiawang,7,0,10,3
1668097143776,MATH 280B,A00,098052,Zheng; Tianyi,10,0,15,5
1668097144201,MATH 281B,A00,098053,Bradic; Jelena,3,0,15,12
1668097144623,MATH 282B,A00,098054,Arias-Castro; Ery,0,0,15,15
1668097145057,MATH 285,A00,098055,Fitzsimmons; Patrick J,0,0,15,17
1668097145487,MATH 287B,A00,098056,Arias-Castro; Ery,3,0,15,12
1668097145915,MATH 288,A00,098057,Agarwal; Pooja,9,0,10,1
1668097145915,MATH 288,B00,098058,Zhang; Danna,8,0,10,2
1668097145915,MATH 288,C00,098059,Williams; Ruth J,10,0,10,0
1668097146338,MATH 290B,A00,098060,Roberts; Justin Deritter,13,0,15,2
1668097146762,MATH 292,A00,098061,Belmont; Eva Kinoshita,10,0,10,0
1668097147192,MATH 295,A00,098062,Suk; Andrew Hoon,48,0,50,2
1668097147619,MATH 296,A00,098063,Novak; Jonathan I,20,0,20,0
1668097148043,MATH 297,001,098064,Gamst; Anthony Collins,9997,0,9999,2
1668097650280,COGS 205,A00,101395,Chiba; Andrea,19,0,20,1
1668097650710,COGS 210B,001,101404,Greene; Deanna Jacquelyn,9998,0,9999,1
1668097650710,COGS 210B,002,101417,Xia; Haijun,9999,0,9999,0
1668097650710,COGS 210B,003,101422,Nitz; Douglas A.,9999,0,9999,0
1668097650710,COGS 210B,004,101423,Hollan; James D.,9998,0,9999,1
1668097650710,COGS 210B,005,101424,Deak; Gedeon O.,9998,0,9999,1
1668097650710,COGS 210B,006,101425,Rossano; Federico,9999,0,9999,0
1668097651134,COGS 211B,A00,101427,Coulson; Seana M,9996,0,9999,3
1668097651558,COGS 220,A00,101428,Hollan; James D.,0,0,25,25
1668097651982,COGS 229,A00,101429,Dow; Steven P,18,0,25,7
1668097652407,COGS 230,A00,101430,Klemmer; Scott R,13,0,17,4
1668097652832,COGS 234,A00,101431,Xia; Haijun,3,0,25,22
1668097653254,COGS 260,A00,101432,Kiyonaga; Anastasia,19,0,25,6
1668097653254,COGS 260,B00,101433,Kirsh; David Joel,16,0,25,9
1668097653676,CSE 202,A00,102371,Impagliazzo; Russell,0,0,0,0
1668097654106,CSE 203B,A01,102373,Cheng; Chung Kuan,0,0,0,0
1668097654534,CSE 208,A00,102374,Micciancio; Daniele,0,0,0,0
1668097654963,CSE 209A,A00,112895,Impagliazzo; Russell,0,0,15,15
1668097655387,CSE 209B,A00,108005,Bellare; Mihir,0,0,0,0
1668097655819,CSE 210,A00,113163,Coblenz; Michael J,0,0,0,0
1668097656258,CSE 219,A00,106111,Dow; Steven P,0,0,20,20
1668097656682,CSE 221,A00,102376,Voelker; Geoffrey M.,0,0,0,0
1668097657108,CSE 224,A01,102378,Porter; George M,0,0,0,0
1668097657532,CSE 229A,A00,102379,Savage; Stefan,0,0,0,0
1668097657956,CSE 229C,A00,102380,Munyaka; Imani N. S.,0,0,0,0
1668097658383,CSE 232B,A00,102382,Deutsch; Alin Bernard,0,0,0,0
1668097658805,CSE 234,A01,112904,Kumar; Arun Kumar,0,0,0,0
1668097659227,CSE 237A,A00,102383,Rosing; Tajana Simunic,0,0,0,0
1668097659662,CSE 239A,A00,102384,Deutsch; Alin Bernard,0,0,0,0
1668097660085,CSE 239B,A00,102385,Polikarpova; Nadezhda,0,0,0,0
1668097660523,CSE 240A,A00,102386,Pannuto; Patrick William,0,0,0,0
1668097660960,CSE 240B,A00,102387,Zhao; Jishen,0,0,0,0
1668097661384,CSE 241A,A00,106406,Kang; Mingu,0,0,0,0
1668097661807,CSE 249B,A00,102388,Kahng; Andrew Byun,0,0,8,8
1668097662231,CSE 251B,A01,102392,Cottrell; Garrison W,0,0,0,0
1668097662231,CSE 251B,A02,102393,Cottrell; Garrison W,0,0,0,0
1668097662657,CSE 252B,A00,102394,Ochoa; Benjamin Lawrence,0,0,0,0
1668097663081,CSE 257,A01,102396,Gao; Sicun,0,0,0,0
1668097663504,CSE 272,A00,102397,Li; Tzumao,0,0,0,0
1668097663928,CSE 274,A00,111323,Chern; Albert Ren-Haur,0,0,0,0
1668097664351,CSE 282,A00,102398,Pevzner; Pavel Arkadjevich,0,0,0,0
1668097664782,CSE 284,A00,114175,Gymrek; Melissa Ann,0,0,0,0
1668097665225,CSE 290,A00,102399,Chandraker; Manmohan Krishna,0,0,0,0
1668097665225,CSE 290,B00,102400,Vaccaro; Kristen Marie,0,0,25,25
1668097665225,CSE 290,C00,102414,Pannuto; Patrick William,0,0,25,25
1668097665225,CSE 290,D00,102427,Pevzner; Pavel Arkadjevich,0,0,0,0
1668097665225,CSE 290,E00,102429,Zhao; Jishen,0,0,0,0
1668097665225,CSE 290,F00,102436,Tullsen; Dean Michael,0,0,0,0
1668097665225,CSE 290,G00,102440,Christensen; Henrik I,0,0,20,20
1668097665648,CSE 291,A00,102443,Su; Hao,0,0,0,0
1668097665648,CSE 291,B00,102448,Polikarpova; Nadezhda,0,0,0,0
1668097665648,CSE 291,C00,102453,Vaccaro; Kristen Marie,0,0,0,0
1668097665648,CSE 291,D00,111343,Savage; Stefan,0,0,0,0
1668097665648,CSE 291,E00,116474,Claffy; Kimberly Claire,0,0,0,0
1668097665648,CSE 291,F00,116479,Pasquale; Joseph,0,0,0,0
1668097666086,CSE 293,001,119111,Bafna; Vineet,9999,0,9999,0
1668097666086,CSE 293,002,119118,Bellare; Mihir,9999,0,9999,0
1668097666086,CSE 293,003,119122,Berg-Kirkpatrick; Taylor D,9999,0,9999,0
1668097666086,CSE 293,004,119135,Christensen; Henrik I,9999,0,9999,0
1668097666086,CSE 293,005,119142,Cottrell; Garrison W,9999,0,9999,0
1668097666086,CSE 293,006,119146,Deutsch; Alin Bernard,9999,0,9999,0
1668097666086,CSE 293,007,119159,Esmaeilzadeh; Hadi,9999,0,9999,0
1668097666086,CSE 293,008,119166,Freund; Yoav,9999,0,9999,0
1668097666086,CSE 293,009,119170,Griswold; William G.,9999,0,9999,0
1668097666086,CSE 293,010,119183,Gymrek; Melissa Ann,9999,0,9999,0
1668097666086,CSE 293,011,119190,Heninger; Nadia A,9999,0,9999,0
1668097666086,CSE 293,012,119230,Impagliazzo; Russell,9999,0,9999,0
1668097666086,CSE 293,013,119232,Jhala; Ranjit,9999,0,9999,0
1668097666086,CSE 293,014,119233,Kahng; Andrew Byun,9999,0,9999,0
1668097666086,CSE 293,015,119298,Kane; Daniel Mertz,9999,0,9999,0
1668097666086,CSE 293,016,119299,Kriegman; David J,9999,0,9999,0
1668097666086,CSE 293,017,119300,Kumar; Arun Kumar,9999,0,9999,0
1668097666086,CSE 293,018,119301,Lerner; Sorin,9999,0,9999,0
1668097666086,CSE 293,019,119302,Lovett; Shachar,9999,0,9999,0
1668097666086,CSE 293,020,119303,McAuley; Julian John,9999,0,9999,0
1668097666086,CSE 293,021,119304,Micciancio; Daniele,9999,0,9999,0
1668097666086,CSE 293,022,119367,Orailoglu; Alex,9999,0,9999,0
1668097666086,CSE 293,023,119382,Paturi; Ramamohan,9999,0,9999,0
1668097666086,CSE 293,024,119404,Polikarpova; Nadezhda,9999,0,9999,0
1668097666086,CSE 293,025,119406,Politz; Joseph Gibbs,9999,0,9999,0
1668097666086,CSE 293,026,119411,Porter; George M,9999,0,9999,0
1668097666086,CSE 293,027,119414,Porter; Leonard Emerson,9999,0,9999,0
1668097666086,CSE 293,028,119416,Ramamoorthi; Ravi,9999,0,9999,0
1668097666086,CSE 293,029,119417,Sahoo; Debashis,9999,0,9999,0
1668097666086,CSE 293,030,119420,Saul; Lawrence,9999,0,9999,0
1668097666086,CSE 293,031,119421,Savage; Stefan,9999,0,9999,0
1668097666086,CSE 293,032,119425,Schulze; Jurgen P.,9999,0,9999,0
1668097666086,CSE 293,033,119426,Snoeren; Alex C.,9999,0,9999,0
1668097666086,CSE 293,034,119428,Shang; Jingbo,9999,0,9999,0
1668097666086,CSE 293,035,119430,Stefan; Deian,9999,0,9999,0
1668097666086,CSE 293,036,119431,Su; Hao,9999,0,9999,0
1668097666086,CSE 293,037,119433,Swanson; Steven James,9999,0,9999,0
1668097666086,CSE 293,038,119435,Tullsen; Dean Michael,9999,0,9999,0
1668097666086,CSE 293,039,119483,Voelker; Geoffrey M.,9999,0,9999,0
1668097666086,CSE 293,040,119537,Zhao; Jishen,9999,0,9999,0
1668097666086,CSE 293,041,119538,Zhou; Yuan-Yuan,9999,0,9999,0
1668097666086,CSE 293,042,119539,Gao; Sicun,9999,0,9999,0
1668097666086,CSE 293,043,119540,Weibel; Nadir,9999,0,9999,0
1668097666086,CSE 293,044,119541,Gupta; Rajesh K.,9999,0,9999,0
1668097666086,CSE 293,045,126410,Vaccaro; Kristen Marie,9999,0,9999,0
1668097666086,CSE 293,046,126411,Klemke; Richard,9999,0,9999,0
1668097666513,CSE 294,A00,102459,Voelker; Geoffrey M.,0,0,0,0
1668097666513,CSE 294,B00,111322,Orailoglu; Alex,0,0,0,0
1668097666936,DSE 201,A00,096914,Deutsch; Alin Bernard,30,0,30,0
1668097667360,DSE 210,A00,096915,Dasgupta; Sanjoy,30,0,30,0
1668097667788,DSE 260A,A00,096916,Altintas De Callaf; Ilkay,30,0,30,0
1668097668221,ECE 200,001,103586,Antipa; Nicholas A,9999,0,9999,0
1668097668221,ECE 200,002,103587,Atanasov; Nikolay A.,9999,0,9999,0
1668097668221,ECE 200,003,103588,Bharadia; Dinesh,9999,0,9999,0
1668097668221,ECE 200,004,103589,Cheng; Chung Kuan,9999,0,9999,0
1668097668221,ECE 200,005,103590,Cosman; Pamela C.,9999,0,9999,0
1668097668221,ECE 200,006,103591,Dayeh; Shadi Ahmad,9999,0,9999,0
1668097668221,ECE 200,007,103592,Fainman; Yeshaiahu,9999,0,9999,0
1668097668221,ECE 200,008,103593,Ford; Joseph Earl,9999,0,9999,0
1668097668221,ECE 200,009,103594,Franceschetti; Massimo,9999,0,9999,0
1668097668221,ECE 200,010,103595,Fullerton; Eric E,9999,0,9999,0
1668097668221,ECE 200,011,103596,Galton; Ian A,9999,0,9999,0
1668097668221,ECE 200,012,103597,Gilja; Vikash,9999,0,9999,0
1668097668221,ECE 200,013,103598,Hall; Drew A.,9999,0,9999,0
1668097668221,ECE 200,014,103599,Hsueh; Tzu-Chien,9999,0,9999,0
1668097668221,ECE 200,015,103600,Javidi; Tara,9999,0,9999,0
1668097668221,ECE 200,016,103601,Kahng; Andrew Byun,9999,0,9999,0
1668097668221,ECE 200,017,103602,Kim; Young-Han,9999,0,9999,0
1668097668221,ECE 200,018,103603,Koushanfar; Farinaz,9999,0,9999,0
1668097668221,ECE 200,019,103604,Kuzum; Duygu,9999,0,9999,0
1668097668221,ECE 200,020,103605,Le; Hanh-Phuc,9999,0,9999,0
1668097668221,ECE 200,021,103606,Lin; Bill,9999,0,9999,0
1668097668221,ECE 200,022,103607,Liu; Zhaowei,9998,0,9999,1
1668097668221,ECE 200,023,103608,Lo; Yu-Hwa,9999,0,9999,0
1668097668221,ECE 200,024,103609,Lomakin; Vitaliy,9999,0,9999,0
1668097668221,ECE 200,025,103610,Mercier; Patrick Philip,9999,0,9999,0
1668097668221,ECE 200,026,103611,Meyer; Florian,9999,0,9999,0
1668097668221,ECE 200,027,103612,Milstein; Laurence B.,9999,0,9999,0
1668097668221,ECE 200,028,103613,Mir Arabbaygi; Siavash,9999,0,9999,0
1668097668221,ECE 200,029,103614,Mookherjea; Shayan,9999,0,9999,0
1668097668221,ECE 200,030,103615,Morris; Karcher William,9999,0,9999,0
1668097668221,ECE 200,031,103616,Ng; Tse Nga,9999,0,9999,0
1668097668221,ECE 200,032,103617,Nguyen; Truong Quang,9999,0,9999,0
1668097668221,ECE 200,033,103618,Nomura; Kenji,9999,0,9999,0
1668097668221,ECE 200,034,103619,Orlitsky; Alon,9999,0,9999,0
1668097668221,ECE 200,035,103620,Pal; Piya,9999,0,9999,0
1668097668221,ECE 200,036,103621,Papen; George C.,9999,0,9999,0
1668097668221,ECE 200,037,103622,Radic; Stojan,9999,0,9999,0
1668097668221,ECE 200,038,103623,Rao; Bhaskar D.,9999,0,9999,0
1668097668221,ECE 200,039,103624,Rao; Ramesh R,9999,0,9999,0
1668097668221,ECE 200,040,103625,Rebeiz; Gabriel,9999,0,9999,0
1668097668221,ECE 200,041,103626,Sanford; John R,9999,0,9999,0
1668097668221,ECE 200,042,103627,Siegel; Paul H.,9999,0,9999,0
1668097668221,ECE 200,043,103628,Sievenpiper; Daniel F.,9999,0,9999,0
1668097668221,ECE 200,044,103629,Sworder; David D.,9999,0,9999,0
1668097668221,ECE 200,045,103630,Taur; Yuan,9999,0,9999,0
1668097668221,ECE 200,046,103631,Touri; Behrouz,9999,0,9999,0
1668097668221,ECE 200,047,103632,Trivedi; Mohan M.,9999,0,9999,0
1668097668221,ECE 200,048,103633,Vasconcelos; Nuno,9999,0,9999,0
1668097668221,ECE 200,049,103634,Wang; Xiaolong,9999,0,9999,0
1668097668221,ECE 200,050,103635,Xie; Pengtao,9999,0,9999,0
1668097668221,ECE 200,051,103636,Yip; Michael,9999,0,9999,0
1668097668221,ECE 200,052,103637,Zeger; Kenneth A.,999,0,999,0
1668097668221,ECE 200,053,103638,Zhang; Xinyu,9999,0,9999,0
1668097668221,ECE 200,054,103639,Turakhia; Yatish Girish,9999,0,9999,0
1668097668221,ECE 200,055,103640,Kang; Mingu,9999,0,9999,0
1668097668221,ECE 200,056,103641,Shi; Yuanyuan,9999,0,9999,0
1668097668221,ECE 200,057,103642,Wang; Edward Jay,9999,0,9999,0
1668097668221,ECE 200,058,103643,Zheng; Yang,9999,0,9999,0
1668097668644,ECE 202,A00,103644,Kuzum; Duygu,0,0,0,0
1668097669069,ECE 212BN,A00,103646,Ng; Tse Nga,0,0,0,0
1668097669496,ECE 221,A00,111493,Staff,0,0,0,0
1668097669930,ECE 222B,A00,103647,Lomakin; Vitaliy,0,0,0,0
1668097670372,ECE 230B,A00,103648,Taur; Yuan,0,0,0,0
1668097670796,ECE 238B,A00,103649,Garay; Javier,0,0,0,0
1668097671307,ECE 240B,A00,112900,Fainman; Yeshaiahu,0,0,0,0
1668097671731,ECE 247A,A00,103650,Jokerst; Jesse Vincent,0,0,0,0
1668097672155,ECE 247B,A00,103651,Wang; Joseph,0,0,0,0
1668097672578,ECE 250,A00,103652,Siegel; Paul H.,0,0,0,0
1668097673002,ECE 251A,A00,103654,Rao; Bhaskar D.,0,0,0,0
1668097673428,ECE 257B,A00,103655,Bharadia; Dinesh,0,0,0,0
1668097673855,ECE 258A,A00,103656,Milstein; Laurence B.,0,0,0,0
1668097674278,ECE 260B,A00,103658,Kang; Mingu,0,0,0,0
1668097674703,ECE 264A,A00,103659,Galton; Ian A,0,0,0,0
1668097675130,ECE 265A,A00,103661,Gudem; Prasad S.S.,0,0,0,0
1668097675557,ECE 265D,A00,103662,Gudem; Prasad S.S.,0,0,0,0
1668097675990,ECE 268,A00,103663,Koushanfar; Farinaz,0,0,0,0
1668097676421,ECE 269,A01,103665,Pal; Piya,0,0,0,0
1668097676857,ECE 271B,A00,103666,Vasconcelos; Manuela,0,0,0,0
1668097677286,ECE 276A,A00,103667,Atanasov; Nikolay A.,0,0,0,0
1668097677713,ECE 277,A00,103668,An; Cheolhong,0,0,0,0
1668097678147,ECE 279,A00,117947,Hall; Drew A.,0,0,0,0
1668097679015,ECE 283,A00,103670,Hsueh; Tzu-Chien,0,0,0,0
1668097679452,ECE 284,A00,103671,Turakhia; Yatish Girish,0,0,0,0
1668097679879,ECE 285,A00,103672,Zheng; Yang,0,0,0,0
1668097679879,ECE 285,B00,103673,Sworder; David D.,0,0,0,0
1668097680313,ECE 287,A00,103676,Javidi; Tara,0,0,0,0
1668097680737,MATH 200B,A00,098023,Salehi Golsefidy; Alireza,13,0,15,2
1668097681171,MATH 202B,A00,098024,Rhoades; Brendon Patrick,9,0,15,6
1668097681609,MATH 203B,A00,098025,Oprea; Dragos N.,10,0,15,5
1668097682033,MATH 204B,A00,098026,Sorensen; Claus M,13,0,15,2
1668097682457,MATH 208,A00,098027,Izadi; Elham,7,0,10,3
1668097682879,MATH 209,A00,098028,Pollack; Aaron,10,0,10,0
1668097683303,MATH 211A,A00,112919,Rogalski; Daniel,9,0,10,1
1668097683726,MATH 211B,A00,112920,Seward; Brandon M.,9,0,10,1
1668097684154,MATH 218,A00,098029,Li; Bo,10,0,10,0
1668097684578,MATH 220B,A00,098030,Novak; Jonathan I,12,0,15,3
1668097685001,MATH 221A,A00,098031,Ebenfelt; Peter F,13,0,15,2
1668097685423,MATH 231B,A00,098032,Zlatos; Andrej,12,0,15,3
1668097685854,MATH 240B,A00,098033,Ni; Lei,9,0,15,6
1668097686285,MATH 243,A00,098034,Jekel; David Andrew,10,0,10,0
1668097686718,MATH 245A,A00,098035,Nie; Jiawang,0,0,15,16
1668097687144,MATH 248,A00,098036,Bejenaru; Ioan,10,0,10,0
1668097687578,MATH 250B,A00,098037,Spolaor; Luca,14,0,15,1
1668097688022,MATH 258,A00,098038,Ni; Lei,10,0,10,0
1668097688445,MATH 264B,A00,098041,Rhoades; Brendon Patrick,10,0,15,5
1668097688880,MATH 268,A00,098042,Buss; Samuel R,10,0,10,0
1668097689321,MATH 269,A00,098043,Rhoades; Brendon Patrick,10,0,10,0
1668097689750,MATH 270B,A00,098044,Li; Bo,11,0,15,4
1668097690177,MATH 272B,A00,098045,Holst; Michael J,13,0,15,2
1668097690602,MATH 273A,A00,098046,Tian; Xiaochuan,10,0,15,5
1668097691038,MATH 275,A01,098048,Tian; Xiaochuan,6,0,10,4
1668097691465,MATH 278A,A00,098049,Holst; Michael J,8,0,10,2
1668097691894,MATH 278B,A00,098050,Cloninger; Alexander,10,0,10,0
1668097692317,MATH 278C,A00,098051,Nie; Jiawang,7,0,10,3
1668097692742,MATH 280B,A00,098052,Zheng; Tianyi,10,0,15,5
1668097693172,MATH 281B,A00,098053,Bradic; Jelena,3,0,15,12
1668097693594,MATH 282B,A00,098054,Arias-Castro; Ery,0,0,15,15
1668097694019,MATH 285,A00,098055,Fitzsimmons; Patrick J,0,0,15,17
1668097694449,MATH 287B,A00,098056,Arias-Castro; Ery,3,0,15,12
1668097694874,MATH 288,A00,098057,Agarwal; Pooja,9,0,10,1
1668097694874,MATH 288,B00,098058,Zhang; Danna,8,0,10,2
1668097694874,MATH 288,C00,098059,Williams; Ruth J,10,0,10,0
1668097695299,MATH 290B,A00,098060,Roberts; Justin Deritter,13,0,15,2
1668097695729,MATH 292,A00,098061,Belmont; Eva Kinoshita,10,0,10,0
1668097696174,MATH 295,A00,098062,Suk; Andrew Hoon,48,0,50,2
1668097696602,MATH 296,A00,098063,Novak; Jonathan I,20,0,20,0
1668097697024,MATH 297,001,098064,Gamst; Anthony Collins,9997,0,9999,2
1668098197999,COGS 205,A00,101395,Chiba; Andrea,19,0,20,1
1668098198424,COGS 210B,001,101404,Greene; Deanna Jacquelyn,9998,0,9999,1
1668098198424,COGS 210B,002,101417,Xia; Haijun,9999,0,9999,0
1668098198424,COGS 210B,003,101422,Nitz; Douglas A.,9999,0,9999,0
1668098198424,COGS 210B,004,101423,Hollan; James D.,9998,0,9999,1
1668098198424,COGS 210B,005,101424,Deak; Gedeon O.,9998,0,9999,1
1668098198424,COGS 210B,006,101425,Rossano; Federico,9999,0,9999,0
1668098198846,COGS 211B,A00,101427,Coulson; Seana M,9996,0,9999,3
1668098199268,COGS 220,A00,101428,Hollan; James D.,0,0,25,25
1668098199693,COGS 229,A00,101429,Dow; Steven P,18,0,25,7
1668098200116,COGS 230,A00,101430,Klemmer; Scott R,13,0,17,4
1668098200539,COGS 234,A00,101431,Xia; Haijun,3,0,25,22
1668098200972,COGS 260,A00,101432,Kiyonaga; Anastasia,19,0,25,6
1668098200972,COGS 260,B00,101433,Kirsh; David Joel,16,0,25,9
1668098201395,CSE 202,A00,102371,Impagliazzo; Russell,0,0,0,0
1668098201837,CSE 203B,A01,102373,Cheng; Chung Kuan,0,0,0,0
1668098202267,CSE 208,A00,102374,Micciancio; Daniele,0,0,0,0
1668098202692,CSE 209A,A00,112895,Impagliazzo; Russell,0,0,15,15
1668098203120,CSE 209B,A00,108005,Bellare; Mihir,0,0,0,0
1668098203543,CSE 210,A00,113163,Coblenz; Michael J,0,0,0,0
1668098203966,CSE 219,A00,106111,Dow; Steven P,0,0,20,20
1668098204391,CSE 221,A00,102376,Voelker; Geoffrey M.,0,0,0,0
1668098204823,CSE 224,A01,102378,Porter; George M,0,0,0,0
1668098205245,CSE 229A,A00,102379,Savage; Stefan,0,0,0,0
1668098205670,CSE 229C,A00,102380,Munyaka; Imani N. S.,0,0,0,0
1668098206096,CSE 232B,A00,102382,Deutsch; Alin Bernard,0,0,0,0
1668098206520,CSE 234,A01,112904,Kumar; Arun Kumar,0,0,0,0
1668098206947,CSE 237A,A00,102383,Rosing; Tajana Simunic,0,0,0,0
1668098207374,CSE 239A,A00,102384,Deutsch; Alin Bernard,0,0,0,0
1668098207801,CSE 239B,A00,102385,Polikarpova; Nadezhda,0,0,0,0
1668098208228,CSE 240A,A00,102386,Pannuto; Patrick William,0,0,0,0
1668098208663,CSE 240B,A00,102387,Zhao; Jishen,0,0,0,0
1668098209096,CSE 241A,A00,106406,Kang; Mingu,0,0,0,0
1668098209521,CSE 249B,A00,102388,Kahng; Andrew Byun,0,0,8,8
1668098209953,CSE 251B,A01,102392,Cottrell; Garrison W,0,0,0,0
1668098209953,CSE 251B,A02,102393,Cottrell; Garrison W,0,0,0,0
1668098210378,CSE 252B,A00,102394,Ochoa; Benjamin Lawrence,0,0,0,0
1668098210809,CSE 257,A01,102396,Gao; Sicun,0,0,0,0
1668098211241,CSE 272,A00,102397,Li; Tzumao,0,0,0,0
1668098211677,CSE 274,A00,111323,Chern; Albert Ren-Haur,0,0,0,0
1668098212099,CSE 282,A00,102398,Pevzner; Pavel Arkadjevich,0,0,0,0
1668098212521,CSE 284,A00,114175,Gymrek; Melissa Ann,0,0,0,0
1668098212944,CSE 290,A00,102399,Chandraker; Manmohan Krishna,0,0,0,0
1668098212944,CSE 290,B00,102400,Vaccaro; Kristen Marie,0,0,25,25
1668098212944,CSE 290,C00,102414,Pannuto; Patrick William,0,0,25,25
1668098212944,CSE 290,D00,102427,Pevzner; Pavel Arkadjevich,0,0,0,0
1668098212944,CSE 290,E00,102429,Zhao; Jishen,0,0,0,0
1668098212944,CSE 290,F00,102436,Tullsen; Dean Michael,0,0,0,0
1668098212944,CSE 290,G00,102440,Christensen; Henrik I,0,0,20,20
1668098213373,CSE 291,A00,102443,Su; Hao,0,0,0,0
1668098213373,CSE 291,B00,102448,Polikarpova; Nadezhda,0,0,0,0
1668098213373,CSE 291,C00,102453,Vaccaro; Kristen Marie,0,0,0,0
1668098213373,CSE 291,D00,111343,Savage; Stefan,0,0,0,0
1668098213373,CSE 291,E00,116474,Claffy; Kimberly Claire,0,0,0,0
1668098213373,CSE 291,F00,116479,Pasquale; Joseph,0,0,0,0
1668098213800,CSE 293,001,119111,Bafna; Vineet,9999,0,9999,0
1668098213800,CSE 293,002,119118,Bellare; Mihir,9999,0,9999,0
1668098213800,CSE 293,003,119122,Berg-Kirkpatrick; Taylor D,9999,0,9999,0
1668098213800,CSE 293,004,119135,Christensen; Henrik I,9999,0,9999,0
1668098213800,CSE 293,005,119142,Cottrell; Garrison W,9999,0,9999,0
1668098213800,CSE 293,006,119146,Deutsch; Alin Bernard,9999,0,9999,0
1668098213800,CSE 293,007,119159,Esmaeilzadeh; Hadi,9999,0,9999,0
1668098213800,CSE 293,008,119166,Freund; Yoav,9999,0,9999,0
1668098213800,CSE 293,009,119170,Griswold; William G.,9999,0,9999,0
1668098213800,CSE 293,010,119183,Gymrek; Melissa Ann,9999,0,9999,0
1668098213800,CSE 293,011,119190,Heninger; Nadia A,9999,0,9999,0
1668098213800,CSE 293,012,119230,Impagliazzo; Russell,9999,0,9999,0
1668098213800,CSE 293,013,119232,Jhala; Ranjit,9999,0,9999,0
1668098213800,CSE 293,014,119233,Kahng; Andrew Byun,9999,0,9999,0
1668098213800,CSE 293,015,119298,Kane; Daniel Mertz,9999,0,9999,0
1668098213800,CSE 293,016,119299,Kriegman; David J,9999,0,9999,0
1668098213800,CSE 293,017,119300,Kumar; Arun Kumar,9999,0,9999,0
1668098213800,CSE 293,018,119301,Lerner; Sorin,9999,0,9999,0
1668098213800,CSE 293,019,119302,Lovett; Shachar,9999,0,9999,0
1668098213800,CSE 293,020,119303,McAuley; Julian John,9999,0,9999,0
1668098213800,CSE 293,021,119304,Micciancio; Daniele,9999,0,9999,0
1668098213800,CSE 293,022,119367,Orailoglu; Alex,9999,0,9999,0
1668098213800,CSE 293,023,119382,Paturi; Ramamohan,9999,0,9999,0
1668098213800,CSE 293,024,119404,Polikarpova; Nadezhda,9999,0,9999,0
1668098213800,CSE 293,025,119406,Politz; Joseph Gibbs,9999,0,9999,0
1668098213800,CSE 293,026,119411,Porter; George M,9999,0,9999,0
1668098213800,CSE 293,027,119414,Porter; Leonard Emerson,9999,0,9999,0
1668098213800,CSE 293,028,119416,Ramamoorthi; Ravi,9999,0,9999,0
1668098213800,CSE 293,029,119417,Sahoo; Debashis,9999,0,9999,0
1668098213800,CSE 293,030,119420,Saul; Lawrence,9999,0,9999,0
1668098213800,CSE 293,031,119421,Savage; Stefan,9999,0,9999,0
1668098213800,CSE 293,032,119425,Schulze; Jurgen P.,9999,0,9999,0
1668098213800,CSE 293,033,119426,Snoeren; Alex C.,9999,0,9999,0
1668098213800,CSE 293,034,119428,Shang; Jingbo,9999,0,9999,0
1668098213800,CSE 293,035,119430,Stefan; Deian,9999,0,9999,0
1668098213800,CSE 293,036,119431,Su; Hao,9999,0,9999,0
1668098213800,CSE 293,037,119433,Swanson; Steven James,9999,0,9999,0
1668098213800,CSE 293,038,119435,Tullsen; Dean Michael,9999,0,9999,0
1668098213800,CSE 293,039,119483,Voelker; Geoffrey M.,9999,0,9999,0
1668098213800,CSE 293,040,119537,Zhao; Jishen,9999,0,9999,0
1668098213800,CSE 293,041,119538,Zhou; Yuan-Yuan,9999,0,9999,0
1668098213800,CSE 293,042,119539,Gao; Sicun,9999,0,9999,0
1668098213800,CSE 293,043,119540,Weibel; Nadir,9999,0,9999,0
1668098213800,CSE 293,044,119541,Gupta; Rajesh K.,9999,0,9999,0
1668098213800,CSE 293,045,126410,Vaccaro; Kristen Marie,9999,0,9999,0
1668098213800,CSE 293,046,126411,Klemke; Richard,9999,0,9999,0
1668098214224,CSE 294,A00,102459,Voelker; Geoffrey M.,0,0,0,0
1668098214224,CSE 294,B00,111322,Orailoglu; Alex,0,0,0,0
1668098214650,DSE 201,A00,096914,Deutsch; Alin Bernard,30,0,30,0
1668098215079,DSE 210,A00,096915,Dasgupta; Sanjoy,30,0,30,0
1668098215504,DSE 260A,A00,096916,Altintas De Callaf; Ilkay,30,0,30,0
1668098215942,ECE 200,001,103586,Antipa; Nicholas A,9999,0,9999,0
1668098215942,ECE 200,002,103587,Atanasov; Nikolay A.,9999,0,9999,0
1668098215942,ECE 200,003,103588,Bharadia; Dinesh,9999,0,9999,0
1668098215942,ECE 200,004,103589,Cheng; Chung Kuan,9999,0,9999,0
1668098215942,ECE 200,005,103590,Cosman; Pamela C.,9999,0,9999,0
1668098215942,ECE 200,006,103591,Dayeh; Shadi Ahmad,9999,0,9999,0
1668098215942,ECE 200,007,103592,Fainman; Yeshaiahu,9999,0,9999,0
1668098215942,ECE 200,008,103593,Ford; Joseph Earl,9999,0,9999,0
1668098215942,ECE 200,009,103594,Franceschetti; Massimo,9999,0,9999,0
1668098215942,ECE 200,010,103595,Fullerton; Eric E,9999,0,9999,0
1668098215942,ECE 200,011,103596,Galton; Ian A,9999,0,9999,0
1668098215942,ECE 200,012,103597,Gilja; Vikash,9999,0,9999,0
1668098215942,ECE 200,013,103598,Hall; Drew A.,9999,0,9999,0
1668098215942,ECE 200,014,103599,Hsueh; Tzu-Chien,9999,0,9999,0
1668098215942,ECE 200,015,103600,Javidi; Tara,9999,0,9999,0
1668098215942,ECE 200,016,103601,Kahng; Andrew Byun,9999,0,9999,0
1668098215942,ECE 200,017,103602,Kim; Young-Han,9999,0,9999,0
1668098215942,ECE 200,018,103603,Koushanfar; Farinaz,9999,0,9999,0
1668098215942,ECE 200,019,103604,Kuzum; Duygu,9999,0,9999,0
1668098215942,ECE 200,020,103605,Le; Hanh-Phuc,9999,0,9999,0
1668098215942,ECE 200,021,103606,Lin; Bill,9999,0,9999,0
1668098215942,ECE 200,022,103607,Liu; Zhaowei,9998,0,9999,1
1668098215942,ECE 200,023,103608,Lo; Yu-Hwa,9999,0,9999,0
1668098215942,ECE 200,024,103609,Lomakin; Vitaliy,9999,0,9999,0
1668098215942,ECE 200,025,103610,Mercier; Patrick Philip,9999,0,9999,0
1668098215942,ECE 200,026,103611,Meyer; Florian,9999,0,9999,0
1668098215942,ECE 200,027,103612,Milstein; Laurence B.,9999,0,9999,0
1668098215942,ECE 200,028,103613,Mir Arabbaygi; Siavash,9999,0,9999,0
1668098215942,ECE 200,029,103614,Mookherjea; Shayan,9999,0,9999,0
1668098215942,ECE 200,030,103615,Morris; Karcher William,9999,0,9999,0
1668098215942,ECE 200,031,103616,Ng; Tse Nga,9999,0,9999,0
1668098215942,ECE 200,032,103617,Nguyen; Truong Quang,9999,0,9999,0
1668098215942,ECE 200,033,103618,Nomura; Kenji,9999,0,9999,0
1668098215942,ECE 200,034,103619,Orlitsky; Alon,9999,0,9999,0
1668098215942,ECE 200,035,103620,Pal; Piya,9999,0,9999,0
1668098215942,ECE 200,036,103621,Papen; George C.,9999,0,9999,0
1668098215942,ECE 200,037,103622,Radic; Stojan,9999,0,9999,0
1668098215942,ECE 200,038,103623,Rao; Bhaskar D.,9999,0,9999,0
1668098215942,ECE 200,039,103624,Rao; Ramesh R,9999,0,9999,0
1668098215942,ECE 200,040,103625,Rebeiz; Gabriel,9999,0,9999,0
1668098215942,ECE 200,041,103626,Sanford; John R,9999,0,9999,0
1668098215942,ECE 200,042,103627,Siegel; Paul H.,9999,0,9999,0
1668098215942,ECE 200,043,103628,Sievenpiper; Daniel F.,9999,0,9999,0
1668098215942,ECE 200,044,103629,Sworder; David D.,9999,0,9999,0
1668098215942,ECE 200,045,103630,Taur; Yuan,9999,0,9999,0
1668098215942,ECE 200,046,103631,Touri; Behrouz,9999,0,9999,0
1668098215942,ECE 200,047,103632,Trivedi; Mohan M.,9999,0,9999,0
1668098215942,ECE 200,048,103633,Vasconcelos; Nuno,9999,0,9999,0
1668098215942,ECE 200,049,103634,Wang; Xiaolong,9999,0,9999,0
1668098215942,ECE 200,050,103635,Xie; Pengtao,9999,0,9999,0
1668098215942,ECE 200,051,103636,Yip; Michael,9999,0,9999,0
1668098215942,ECE 200,052,103637,Zeger; Kenneth A.,999,0,999,0
1668098215942,ECE 200,053,103638,Zhang; Xinyu,9999,0,9999,0
1668098215942,ECE 200,054,103639,Turakhia; Yatish Girish,9999,0,9999,0
1668098215942,ECE 200,055,103640,Kang; Mingu,9999,0,9999,0
1668098215942,ECE 200,056,103641,Shi; Yuanyuan,9999,0,9999,0
1668098215942,ECE 200,057,103642,Wang; Edward Jay,9999,0,9999,0
1668098215942,ECE 200,058,103643,Zheng; Yang,9999,0,9999,0
1668098216376,ECE 202,A00,103644,Kuzum; Duygu,0,0,0,0
1668098216804,ECE 212BN,A00,103646,Ng; Tse Nga,0,0,0,0
1668098217229,ECE 221,A00,111493,Staff,0,0,0,0
1668098217652,ECE 222B,A00,103647,Lomakin; Vitaliy,0,0,0,0
1668098218083,ECE 230B,A00,103648,Taur; Yuan,0,0,0,0
1668098218507,ECE 238B,A00,103649,Garay; Javier,0,0,0,0
1668098218931,ECE 240B,A00,112900,Fainman; Yeshaiahu,0,0,0,0
1668098219355,ECE 247A,A00,103650,Jokerst; Jesse Vincent,0,0,0,0
1668098219781,ECE 247B,A00,103651,Wang; Joseph,0,0,0,0
1668098220203,ECE 250,A00,103652,Siegel; Paul H.,0,0,0,0
1668098220629,ECE 251A,A00,103654,Rao; Bhaskar D.,0,0,0,0
1668098221066,ECE 257B,A00,103655,Bharadia; Dinesh,0,0,0,0
1668098221488,ECE 258A,A00,103656,Milstein; Laurence B.,0,0,0,0
1668098221912,ECE 260B,A00,103658,Kang; Mingu,0,0,0,0
1668098222343,ECE 264A,A00,103659,Galton; Ian A,0,0,0,0
1668098222765,ECE 265A,A00,103661,Gudem; Prasad S.S.,0,0,0,0
1668098223188,ECE 265D,A00,103662,Gudem; Prasad S.S.,0,0,0,0
1668098223614,ECE 268,A00,103663,Koushanfar; Farinaz,0,0,0,0
1668098224037,ECE 269,A01,103665,Pal; Piya,0,0,0,0
1668098224462,ECE 271B,A00,103666,Vasconcelos; Manuela,0,0,0,0
1668098224886,ECE 276A,A00,103667,Atanasov; Nikolay A.,0,0,0,0
1668098225318,ECE 277,A00,103668,An; Cheolhong,0,0,0,0
1668098225755,ECE 279,A00,117947,Hall; Drew A.,0,0,0,0
1668098226603,ECE 283,A00,103670,Hsueh; Tzu-Chien,0,0,0,0
1668098227026,ECE 284,A00,103671,Turakhia; Yatish Girish,0,0,0,0
1668098227451,ECE 285,A00,103672,Zheng; Yang,0,0,0,0
1668098227451,ECE 285,B00,103673,Sworder; David D.,0,0,0,0
1668098227874,ECE 287,A00,103676,Javidi; Tara,0,0,0,0
1668098228301,MATH 200B,A00,098023,Salehi Golsefidy; Alireza,13,0,15,2
1668098228726,MATH 202B,A00,098024,Rhoades; Brendon Patrick,9,0,15,6
1668098229155,MATH 203B,A00,098025,Oprea; Dragos N.,10,0,15,5
1668098229577,MATH 204B,A00,098026,Sorensen; Claus M,13,0,15,2
1668098230012,MATH 208,A00,098027,Izadi; Elham,7,0,10,3
1668098230436,MATH 209,A00,098028,Pollack; Aaron,10,0,10,0
1668098230872,MATH 211A,A00,112919,Rogalski; Daniel,9,0,10,1
1668098231295,MATH 211B,A00,112920,Seward; Brandon M.,9,0,10,1
1668098231729,MATH 218,A00,098029,Li; Bo,10,0,10,0
1668098232165,MATH 220B,A00,098030,Novak; Jonathan I,12,0,15,3
1668098232589,MATH 221A,A00,098031,Ebenfelt; Peter F,13,0,15,2
1668098233020,MATH 231B,A00,098032,Zlatos; Andrej,12,0,15,3
1668098233448,MATH 240B,A00,098033,Ni; Lei,9,0,15,6
1668098233869,MATH 243,A00,098034,Jekel; David Andrew,10,0,10,0
1668098234292,MATH 245A,A00,098035,Nie; Jiawang,0,0,15,16
1668098234715,MATH 248,A00,098036,Bejenaru; Ioan,10,0,10,0
1668098235143,MATH 250B,A00,098037,Spolaor; Luca,14,0,15,1
1668098235687,MATH 258,A00,098038,Ni; Lei,10,0,10,0
1668098236111,MATH 264B,A00,098041,Rhoades; Brendon Patrick,10,0,15,5
1668098236549,MATH 268,A00,098042,Buss; Samuel R,10,0,10,0
1668098236991,MATH 269,A00,098043,Rhoades; Brendon Patrick,10,0,10,0
1668098237417,MATH 270B,A00,098044,Li; Bo,11,0,15,4
1668098237841,MATH 272B,A00,098045,Holst; Michael J,13,0,15,2
1668098238269,MATH 273A,A00,098046,Tian; Xiaochuan,10,0,15,5
1668098238693,MATH 275,A01,098048,Tian; Xiaochuan,6,0,10,4
1668098239115,MATH 278A,A00,098049,Holst; Michael J,8,0,10,2
1668098239547,MATH 278B,A00,098050,Cloninger; Alexander,10,0,10,0
1668098239970,MATH 278C,A00,098051,Nie; Jiawang,7,0,10,3
1668098240397,MATH 280B,A00,098052,Zheng; Tianyi,10,0,15,5
1668098240828,MATH 281B,A00,098053,Bradic; Jelena,3,0,15,12
1668098241255,MATH 282B,A00,098054,Arias-Castro; Ery,0,0,15,15
1668098241677,MATH 285,A00,098055,Fitzsimmons; Patrick J,0,0,15,17
1668098242100,MATH 287B,A00,098056,Arias-Castro; Ery,3,0,15,12
1668098242523,MATH 288,A00,098057,Agarwal; Pooja,9,0,10,1
1668098242523,MATH 288,B00,098058,Zhang; Danna,8,0,10,2
1668098242523,MATH 288,C00,098059,Williams; Ruth J,10,0,10,0
1668098242947,MATH 290B,A00,098060,Roberts; Justin Deritter,13,0,15,2
1668098243378,MATH 292,A00,098061,Belmont; Eva Kinoshita,10,0,10,0
1668098243801,MATH 295,A00,098062,Suk; Andrew Hoon,48,0,50,2
1668098244225,MATH 296,A00,098063,Novak; Jonathan I,20,0,20,0
1668098244649,MATH 297,001,098064,Gamst; Anthony Collins,9997,0,9999,2
1668098755743,COGS 205,A00,101395,Chiba; Andrea,19,0,20,1
1668098756172,COGS 210B,001,101404,Greene; Deanna Jacquelyn,9998,0,9999,1
1668098756172,COGS 210B,002,101417,Xia; Haijun,9999,0,9999,0
1668098756172,COGS 210B,003,101422,Nitz; Douglas A.,9999,0,9999,0
1668098756172,COGS 210B,004,101423,Hollan; James D.,9998,0,9999,1
1668098756172,COGS 210B,005,101424,Deak; Gedeon O.,9998,0,9999,1
1668098756172,COGS 210B,006,101425,Rossano; Federico,9999,0,9999,0
1668098756605,COGS 211B,A00,101427,Coulson; Seana M,9996,0,9999,3
1668098757028,COGS 220,A00,101428,Hollan; James D.,0,0,25,25
1668098757456,COGS 229,A00,101429,Dow; Steven P,18,0,25,7
1668098757885,COGS 230,A00,101430,Klemmer; Scott R,13,0,17,4
1668098758309,COGS 234,A00,101431,Xia; Haijun,3,0,25,22
1668098758737,COGS 260,A00,101432,Kiyonaga; Anastasia,19,0,25,6
1668098758737,COGS 260,B00,101433,Kirsh; David Joel,16,0,25,9
1668098759161,CSE 202,A00,102371,Impagliazzo; Russell,0,0,0,0
1668098759590,CSE 203B,A01,102373,Cheng; Chung Kuan,0,0,0,0
1668098760012,CSE 208,A00,102374,Micciancio; Daniele,0,0,0,0
1668098760433,CSE 209A,A00,112895,Impagliazzo; Russell,0,0,15,15
1668098760869,CSE 209B,A00,108005,Bellare; Mihir,0,0,0,0
1668098761299,CSE 210,A00,113163,Coblenz; Michael J,0,0,0,0
1668098761726,CSE 219,A00,106111,Dow; Steven P,0,0,20,20
1668098762151,CSE 221,A00,102376,Voelker; Geoffrey M.,0,0,0,0
1668098762578,CSE 224,A01,102378,Porter; George M,0,0,0,0
1668098763015,CSE 229A,A00,102379,Savage; Stefan,0,0,0,0
1668098763441,CSE 229C,A00,102380,Munyaka; Imani N. S.,0,0,0,0
1668098763873,CSE 232B,A00,102382,Deutsch; Alin Bernard,0,0,0,0
1668098764299,CSE 234,A01,112904,Kumar; Arun Kumar,0,0,0,0
1668098764723,CSE 237A,A00,102383,Rosing; Tajana Simunic,0,0,0,0
1668098765149,CSE 239A,A00,102384,Deutsch; Alin Bernard,0,0,0,0
1668098765574,CSE 239B,A00,102385,Polikarpova; Nadezhda,0,0,0,0
1668098766002,CSE 240A,A00,102386,Pannuto; Patrick William,0,0,0,0
1668098766427,CSE 240B,A00,102387,Zhao; Jishen,0,0,0,0
1668098766953,CSE 241A,A00,106406,Kang; Mingu,0,0,0,0
1668098767390,CSE 249B,A00,102388,Kahng; Andrew Byun,0,0,8,8
1668098767823,CSE 251B,A01,102392,Cottrell; Garrison W,0,0,0,0
1668098767823,CSE 251B,A02,102393,Cottrell; Garrison W,0,0,0,0
1668098768246,CSE 252B,A00,102394,Ochoa; Benjamin Lawrence,0,0,0,0
1668098768670,CSE 257,A01,102396,Gao; Sicun,0,0,0,0
1668098769097,CSE 272,A00,102397,Li; Tzumao,0,0,0,0
1668098769519,CSE 274,A00,111323,Chern; Albert Ren-Haur,0,0,0,0
1668098769943,CSE 282,A00,102398,Pevzner; Pavel Arkadjevich,0,0,0,0
1668098770367,CSE 284,A00,114175,Gymrek; Melissa Ann,0,0,0,0
1668098770794,CSE 290,A00,102399,Chandraker; Manmohan Krishna,0,0,0,0
1668098770794,CSE 290,B00,102400,Vaccaro; Kristen Marie,0,0,25,25
1668098770794,CSE 290,C00,102414,Pannuto; Patrick William,0,0,25,25
1668098770794,CSE 290,D00,102427,Pevzner; Pavel Arkadjevich,0,0,0,0
1668098770794,CSE 290,E00,102429,Zhao; Jishen,0,0,0,0
1668098770794,CSE 290,F00,102436,Tullsen; Dean Michael,0,0,0,0
1668098770794,CSE 290,G00,102440,Christensen; Henrik I,0,0,20,20
1668098771225,CSE 291,A00,102443,Su; Hao,0,0,0,0
1668098771225,CSE 291,B00,102448,Polikarpova; Nadezhda,0,0,0,0
1668098771225,CSE 291,C00,102453,Vaccaro; Kristen Marie,0,0,0,0
1668098771225,CSE 291,D00,111343,Savage; Stefan,0,0,0,0
1668098771225,CSE 291,E00,116474,Claffy; Kimberly Claire,0,0,0,0
1668098771225,CSE 291,F00,116479,Pasquale; Joseph,0,0,0,0
1668098771663,CSE 293,001,119111,Bafna; Vineet,9999,0,9999,0
1668098771663,CSE 293,002,119118,Bellare; Mihir,9999,0,9999,0
1668098771663,CSE 293,003,119122,Berg-Kirkpatrick; Taylor D,9999,0,9999,0
1668098771663,CSE 293,004,119135,Christensen; Henrik I,9999,0,9999,0
1668098771663,CSE 293,005,119142,Cottrell; Garrison W,9999,0,9999,0
1668098771663,CSE 293,006,119146,Deutsch; Alin Bernard,9999,0,9999,0
1668098771663,CSE 293,007,119159,Esmaeilzadeh; Hadi,9999,0,9999,0
1668098771663,CSE 293,008,119166,Freund; Yoav,9999,0,9999,0
1668098771663,CSE 293,009,119170,Griswold; William G.,9999,0,9999,0
1668098771663,CSE 293,010,119183,Gymrek; Melissa Ann,9999,0,9999,0
1668098771663,CSE 293,011,119190,Heninger; Nadia A,9999,0,9999,0
1668098771663,CSE 293,012,119230,Impagliazzo; Russell,9999,0,9999,0
1668098771663,CSE 293,013,119232,Jhala; Ranjit,9999,0,9999,0
1668098771663,CSE 293,014,119233,Kahng; Andrew Byun,9999,0,9999,0
1668098771663,CSE 293,015,119298,Kane; Daniel Mertz,9999,0,9999,0
1668098771663,CSE 293,016,119299,Kriegman; David J,9999,0,9999,0
1668098771663,CSE 293,017,119300,Kumar; Arun Kumar,9999,0,9999,0
1668098771663,CSE 293,018,119301,Lerner; Sorin,9999,0,9999,0
1668098771663,CSE 293,019,119302,Lovett; Shachar,9999,0,9999,0
1668098771663,CSE 293,020,119303,McAuley; Julian John,9999,0,9999,0
1668098771663,CSE 293,021,119304,Micciancio; Daniele,9999,0,9999,0
1668098771663,CSE 293,022,119367,Orailoglu; Alex,9999,0,9999,0
1668098771663,CSE 293,023,119382,Paturi; Ramamohan,9999,0,9999,0
1668098771663,CSE 293,024,119404,Polikarpova; Nadezhda,9999,0,9999,0
1668098771663,CSE 293,025,119406,Politz; Joseph Gibbs,9999,0,9999,0
1668098771663,CSE 293,026,119411,Porter; George M,9999,0,9999,0
1668098771663,CSE 293,027,119414,Porter; Leonard Emerson,9999,0,9999,0
1668098771663,CSE 293,028,119416,Ramamoorthi; Ravi,9999,0,9999,0
1668098771663,CSE 293,029,119417,Sahoo; Debashis,9999,0,9999,0
1668098771663,CSE 293,030,119420,Saul; Lawrence,9999,0,9999,0
1668098771663,CSE 293,031,119421,Savage; Stefan,9999,0,9999,0
1668098771663,CSE 293,032,119425,Schulze; Jurgen P.,9999,0,9999,0
1668098771663,CSE 293,033,119426,Snoeren; Alex C.,9999,0,9999,0
1668098771663,CSE 293,034,119428,Shang; Jingbo,9999,0,9999,0
1668098771663,CSE 293,035,119430,Stefan; Deian,9999,0,9999,0
1668098771663,CSE 293,036,119431,Su; Hao,9999,0,9999,0
1668098771663,CSE 293,037,119433,Swanson; Steven James,9999,0,9999,0
1668098771663,CSE 293,038,119435,Tullsen; Dean Michael,9999,0,9999,0
1668098771663,CSE 293,039,119483,Voelker; Geoffrey M.,9999,0,9999,0
1668098771663,CSE 293,040,119537,Zhao; Jishen,9999,0,9999,0
1668098771663,CSE 293,041,119538,Zhou; Yuan-Yuan,9999,0,9999,0
1668098771663,CSE 293,042,119539,Gao; Sicun,9999,0,9999,0
1668098771663,CSE 293,043,119540,Weibel; Nadir,9999,0,9999,0
1668098771663,CSE 293,044,119541,Gupta; Rajesh K.,9999,0,9999,0
1668098771663,CSE 293,045,126410,Vaccaro; Kristen Marie,9999,0,9999,0
1668098771663,CSE 293,046,126411,Klemke; Richard,9999,0,9999,0
1668098772090,CSE 294,A00,102459,Voelker; Geoffrey M.,0,0,0,0
1668098772090,CSE 294,B00,111322,Orailoglu; Alex,0,0,0,0
1668098772513,DSE 201,A00,096914,Deutsch; Alin Bernard,30,0,30,0
1668098772939,DSE 210,A00,096915,Dasgupta; Sanjoy,30,0,30,0
1668098773370,DSE 260A,A00,096916,Altintas De Callaf; Ilkay,30,0,30,0
1668098773839,ECE 200,001,103586,Antipa; Nicholas A,9999,0,9999,0
1668098773839,ECE 200,002,103587,Atanasov; Nikolay A.,9999,0,9999,0
1668098773839,ECE 200,003,103588,Bharadia; Dinesh,9999,0,9999,0
1668098773839,ECE 200,004,103589,Cheng; Chung Kuan,9999,0,9999,0
1668098773839,ECE 200,005,103590,Cosman; Pamela C.,9999,0,9999,0
1668098773839,ECE 200,006,103591,Dayeh; Shadi Ahmad,9999,0,9999,0
1668098773839,ECE 200,007,103592,Fainman; Yeshaiahu,9999,0,9999,0
1668098773839,ECE 200,008,103593,Ford; Joseph Earl,9999,0,9999,0
1668098773839,ECE 200,009,103594,Franceschetti; Massimo,9999,0,9999,0
1668098773839,ECE 200,010,103595,Fullerton; Eric E,9999,0,9999,0
1668098773839,ECE 200,011,103596,Galton; Ian A,9999,0,9999,0
1668098773839,ECE 200,012,103597,Gilja; Vikash,9999,0,9999,0
1668098773839,ECE 200,013,103598,Hall; Drew A.,9999,0,9999,0
1668098773839,ECE 200,014,103599,Hsueh; Tzu-Chien,9999,0,9999,0
1668098773839,ECE 200,015,103600,Javidi; Tara,9999,0,9999,0
1668098773839,ECE 200,016,103601,Kahng; Andrew Byun,9999,0,9999,0
1668098773839,ECE 200,017,103602,Kim; Young-Han,9999,0,9999,0
1668098773839,ECE 200,018,103603,Koushanfar; Farinaz,9999,0,9999,0
1668098773839,ECE 200,019,103604,Kuzum; Duygu,9999,0,9999,0
1668098773839,ECE 200,020,103605,Le; Hanh-Phuc,9999,0,9999,0
1668098773839,ECE 200,021,103606,Lin; Bill,9999,0,9999,0
1668098773839,ECE 200,022,103607,Liu; Zhaowei,9998,0,9999,1
1668098773839,ECE 200,023,103608,Lo; Yu-Hwa,9999,0,9999,0
1668098773839,ECE 200,024,103609,Lomakin; Vitaliy,9999,0,9999,0
1668098773839,ECE 200,025,103610,Mercier; Patrick Philip,9999,0,9999,0
1668098773839,ECE 200,026,103611,Meyer; Florian,9999,0,9999,0
1668098773839,ECE 200,027,103612,Milstein; Laurence B.,9999,0,9999,0
1668098773839,ECE 200,028,103613,Mir Arabbaygi; Siavash,9999,0,9999,0
1668098773839,ECE 200,029,103614,Mookherjea; Shayan,9999,0,9999,0
1668098773839,ECE 200,030,103615,Morris; Karcher William,9999,0,9999,0
1668098773839,ECE 200,031,103616,Ng; Tse Nga,9999,0,9999,0
1668098773839,ECE 200,032,103617,Nguyen; Truong Quang,9999,0,9999,0
1668098773839,ECE 200,033,103618,Nomura; Kenji,9999,0,9999,0
1668098773839,ECE 200,034,103619,Orlitsky; Alon,9999,0,9999,0
1668098773839,ECE 200,035,103620,Pal; Piya,9999,0,9999,0
1668098773839,ECE 200,036,103621,Papen; George C.,9999,0,9999,0
1668098773839,ECE 200,037,103622,Radic; Stojan,9999,0,9999,0
1668098773839,ECE 200,038,103623,Rao; Bhaskar D.,9999,0,9999,0
1668098773839,ECE 200,039,103624,Rao; Ramesh R,9999,0,9999,0
1668098773839,ECE 200,040,103625,Rebeiz; Gabriel,9999,0,9999,0
1668098773839,ECE 200,041,103626,Sanford; John R,9999,0,9999,0
1668098773839,ECE 200,042,103627,Siegel; Paul H.,9999,0,9999,0
1668098773839,ECE 200,043,103628,Sievenpiper; Daniel F.,9999,0,9999,0
1668098773839,ECE 200,044,103629,Sworder; David D.,9999,0,9999,0
1668098773839,ECE 200,045,103630,Taur; Yuan,9999,0,9999,0
1668098773839,ECE 200,046,103631,Touri; Behrouz,9999,0,9999,0
1668098773839,ECE 200,047,103632,Trivedi; Mohan M.,9999,0,9999,0
1668098773839,ECE 200,048,103633,Vasconcelos; Nuno,9999,0,9999,0
1668098773839,ECE 200,049,103634,Wang; Xiaolong,9999,0,9999,0
1668098773839,ECE 200,050,103635,Xie; Pengtao,9999,0,9999,0
1668098773839,ECE 200,051,103636,Yip; Michael,9999,0,9999,0
1668098773839,ECE 200,052,103637,Zeger; Kenneth A.,999,0,999,0
1668098773839,ECE 200,053,103638,Zhang; Xinyu,9999,0,9999,0
1668098773839,ECE 200,054,103639,Turakhia; Yatish Girish,9999,0,9999,0
1668098773839,ECE 200,055,103640,Kang; Mingu,9999,0,9999,0
1668098773839,ECE 200,056,103641,Shi; Yuanyuan,9999,0,9999,0
1668098773839,ECE 200,057,103642,Wang; Edward Jay,9999,0,9999,0
1668098773839,ECE 200,058,103643,Zheng; Yang,9999,0,9999,0
1668098774263,ECE 202,A00,103644,Kuzum; Duygu,0,0,0,0
1668098774686,ECE 212BN,A00,103646,Ng; Tse Nga,0,0,0,0
1668098775125,ECE 221,A00,111493,Staff,0,0,0,0
1668098775558,ECE 222B,A00,103647,Lomakin; Vitaliy,0,0,0,0
1668098775979,ECE 230B,A00,103648,Taur; Yuan,0,0,0,0
1668098776419,ECE 238B,A00,103649,Garay; Javier,0,0,0,0
1668098776908,ECE 240B,A00,112900,Fainman; Yeshaiahu,0,0,0,0
1668098777331,ECE 247A,A00,103650,Jokerst; Jesse Vincent,0,0,0,0
1668098777755,ECE 247B,A00,103651,Wang; Joseph,0,0,0,0
1668098778186,ECE 250,A00,103652,Siegel; Paul H.,0,0,0,0
1668098778620,ECE 251A,A00,103654,Rao; Bhaskar D.,0,0,0,0
1668098779055,ECE 257B,A00,103655,Bharadia; Dinesh,0,0,0,0
1668098779490,ECE 258A,A00,103656,Milstein; Laurence B.,0,0,0,0
1668098779933,ECE 260B,A00,103658,Kang; Mingu,0,0,0,0
1668098780361,ECE 264A,A00,103659,Galton; Ian A,0,0,0,0
1668098780789,ECE 265A,A00,103661,Gudem; Prasad S.S.,0,0,0,0
1668098781232,ECE 265D,A00,103662,Gudem; Prasad S.S.,0,0,0,0
1668098781655,ECE 268,A00,103663,Koushanfar; Farinaz,0,0,0,0
1668098782087,ECE 269,A01,103665,Pal; Piya,0,0,0,0
1668098782509,ECE 271B,A00,103666,Vasconcelos; Manuela,0,0,0,0
1668098782939,ECE 276A,A00,103667,Atanasov; Nikolay A.,0,0,0,0
1668098783363,ECE 277,A00,103668,An; Cheolhong,0,0,0,0
1668098783795,ECE 279,A00,117947,Hall; Drew A.,0,0,0,0
1668098784656,ECE 283,A00,103670,Hsueh; Tzu-Chien,0,0,0,0
1668098785084,ECE 284,A00,103671,Turakhia; Yatish Girish,0,0,0,0
1668098785533,ECE 285,A00,103672,Zheng; Yang,0,0,0,0
1668098785533,ECE 285,B00,103673,Sworder; David D.,0,0,0,0
1668098785956,ECE 287,A00,103676,Javidi; Tara,0,0,0,0
1668098786381,MATH 200B,A00,098023,Salehi Golsefidy; Alireza,13,0,15,2
1668098786804,MATH 202B,A00,098024,Rhoades; Brendon Patrick,9,0,15,6
1668098787231,MATH 203B,A00,098025,Oprea; Dragos N.,10,0,15,5
1668098787654,MATH 204B,A00,098026,Sorensen; Claus M,13,0,15,2
1668098788079,MATH 208,A00,098027,Izadi; Elham,7,0,10,3
1668098788509,MATH 209,A00,098028,Pollack; Aaron,10,0,10,0
1668098788937,MATH 211A,A00,112919,Rogalski; Daniel,9,0,10,1
1668098789365,MATH 211B,A00,112920,Seward; Brandon M.,9,0,10,1
1668098789806,MATH 218,A00,098029,Li; Bo,10,0,10,0
1668098790239,MATH 220B,A00,098030,Novak; Jonathan I,12,0,15,3
1668098790669,MATH 221A,A00,098031,Ebenfelt; Peter F,13,0,15,2
1668098791093,MATH 231B,A00,098032,Zlatos; Andrej,12,0,15,3
1668098791515,MATH 240B,A00,098033,Ni; Lei,9,0,15,6
1668098791936,MATH 243,A00,098034,Jekel; David Andrew,10,0,10,0
1668098792364,MATH 245A,A00,098035,Nie; Jiawang,0,0,15,16
1668098792787,MATH 248,A00,098036,Bejenaru; Ioan,10,0,10,0
1668098793213,MATH 250B,A00,098037,Spolaor; Luca,14,0,15,1
1668098793645,MATH 258,A00,098038,Ni; Lei,10,0,10,0
1668098794073,MATH 264B,A00,098041,Rhoades; Brendon Patrick,10,0,15,5
1668098794509,MATH 268,A00,098042,Buss; Samuel R,10,0,10,0
1668098794935,MATH 269,A00,098043,Rhoades; Brendon Patrick,10,0,10,0
1668098795362,MATH 270B,A00,098044,Li; Bo,11,0,15,4
1668098795788,MATH 272B,A00,098045,Holst; Michael J,13,0,15,2
1668098796211,MATH 273A,A00,098046,Tian; Xiaochuan,10,0,15,5
1668098796641,MATH 275,A01,098048,Tian; Xiaochuan,6,0,10,4
1668098797067,MATH 278A,A00,098049,Holst; Michael J,8,0,10,2
1668098797493,MATH 278B,A00,098050,Cloninger; Alexander,10,0,10,0
1668098797916,MATH 278C,A00,098051,Nie; Jiawang,7,0,10,3
1668098798348,MATH 280B,A00,098052,Zheng; Tianyi,10,0,15,5
1668098798778,MATH 281B,A00,098053,Bradic; Jelena,3,0,15,12
1668098799214,MATH 282B,A00,098054,Arias-Castro; Ery,0,0,15,15
1668098799637,MATH 285,A00,098055,Fitzsimmons; Patrick J,0,0,15,17
1668098800061,MATH 287B,A00,098056,Arias-Castro; Ery,3,0,15,12
1668098800485,MATH 288,A00,098057,Agarwal; Pooja,9,0,10,1
1668098800485,MATH 288,B00,098058,Zhang; Danna,8,0,10,2
1668098800485,MATH 288,C00,098059,Williams; Ruth J,10,0,10,0
1668098800907,MATH 290B,A00,098060,Roberts; Justin Deritter,13,0,15,2
1668098801330,MATH 292,A00,098061,Belmont; Eva Kinoshita,10,0,10,0
1668098801765,MATH 295,A00,098062,Suk; Andrew Hoon,48,0,50,2
1668098802190,MATH 296,A00,098063,Novak; Jonathan I,20,0,20,0
1668098802613,MATH 297,001,098064,Gamst; Anthony Collins,9997,0,9999,2
1668099303918,COGS 205,A00,101395,Chiba; Andrea,19,0,20,1
1668099304342,COGS 210B,001,101404,Greene; Deanna Jacquelyn,9998,0,9999,1
1668099304342,COGS 210B,002,101417,Xia; Haijun,9999,0,9999,0
1668099304342,COGS 210B,003,101422,Nitz; Douglas A.,9999,0,9999,0
1668099304342,COGS 210B,004,101423,Hollan; James D.,9998,0,9999,1
1668099304342,COGS 210B,005,101424,Deak; Gedeon O.,9998,0,9999,1
1668099304342,COGS 210B,006,101425,Rossano; Federico,9999,0,9999,0
1668099304768,COGS 211B,A00,101427,Coulson; Seana M,9996,0,9999,3
1668099305193,COGS 220,A00,101428,Hollan; James D.,0,0,25,25
1668099305626,COGS 229,A00,101429,Dow; Steven P,18,0,25,7
1668099306055,COGS 230,A00,101430,Klemmer; Scott R,13,0,17,4
1668099306479,COGS 234,A00,101431,Xia; Haijun,3,0,25,22
1668099306902,COGS 260,A00,101432,Kiyonaga; Anastasia,19,0,25,6
1668099306902,COGS 260,B00,101433,Kirsh; David Joel,16,0,25,9
1668099307329,CSE 202,A00,102371,Impagliazzo; Russell,0,0,0,0
1668099307756,CSE 203B,A01,102373,Cheng; Chung Kuan,0,0,0,0
1668099308181,CSE 208,A00,102374,Micciancio; Daniele,0,0,0,0
1668099308603,CSE 209A,A00,112895,Impagliazzo; Russell,0,0,15,15
1668099309025,CSE 209B,A00,108005,Bellare; Mihir,0,0,0,0
1668099309446,CSE 210,A00,113163,Coblenz; Michael J,0,0,0,0
1668099309872,CSE 219,A00,106111,Dow; Steven P,0,0,20,20
1668099310305,CSE 221,A00,102376,Voelker; Geoffrey M.,0,0,0,0
1668099310742,CSE 224,A01,102378,Porter; George M,0,0,0,0
1668099311172,CSE 229A,A00,102379,Savage; Stefan,0,0,0,0
1668099311596,CSE 229C,A00,102380,Munyaka; Imani N. S.,0,0,0,0
1668099312026,CSE 232B,A00,102382,Deutsch; Alin Bernard,0,0,0,0
1668099312449,CSE 234,A01,112904,Kumar; Arun Kumar,0,0,0,0
1668099312873,CSE 237A,A00,102383,Rosing; Tajana Simunic,0,0,0,0
1668099313299,CSE 239A,A00,102384,Deutsch; Alin Bernard,0,0,0,0
1668099313731,CSE 239B,A00,102385,Polikarpova; Nadezhda,0,0,0,0
1668099314161,CSE 240A,A00,102386,Pannuto; Patrick William,0,0,0,0
1668099314587,CSE 240B,A00,102387,Zhao; Jishen,0,0,0,0
1668099315012,CSE 241A,A00,106406,Kang; Mingu,0,0,0,0
1668099315434,CSE 249B,A00,102388,Kahng; Andrew Byun,0,0,8,8
1668099315856,CSE 251B,A01,102392,Cottrell; Garrison W,0,0,0,0
1668099315856,CSE 251B,A02,102393,Cottrell; Garrison W,0,0,0,0
1668099316282,CSE 252B,A00,102394,Ochoa; Benjamin Lawrence,0,0,0,0
1668099316719,CSE 257,A01,102396,Gao; Sicun,0,0,0,0
1668099317142,CSE 272,A00,102397,Li; Tzumao,0,0,0,0
1668099317572,CSE 274,A00,111323,Chern; Albert Ren-Haur,0,0,0,0
1668099317998,CSE 282,A00,102398,Pevzner; Pavel Arkadjevich,0,0,0,0
1668099318424,CSE 284,A00,114175,Gymrek; Melissa Ann,0,0,0,0
1668099318848,CSE 290,A00,102399,Chandraker; Manmohan Krishna,0,0,0,0
1668099318848,CSE 290,B00,102400,Vaccaro; Kristen Marie,0,0,25,25
1668099318848,CSE 290,C00,102414,Pannuto; Patrick William,0,0,25,25
1668099318848,CSE 290,D00,102427,Pevzner; Pavel Arkadjevich,0,0,0,0
1668099318848,CSE 290,E00,102429,Zhao; Jishen,0,0,0,0
1668099318848,CSE 290,F00,102436,Tullsen; Dean Michael,0,0,0,0
1668099318848,CSE 290,G00,102440,Christensen; Henrik I,0,0,20,20
1668099319278,CSE 291,A00,102443,Su; Hao,0,0,0,0
1668099319278,CSE 291,B00,102448,Polikarpova; Nadezhda,0,0,0,0
1668099319278,CSE 291,C00,102453,Vaccaro; Kristen Marie,0,0,0,0
1668099319278,CSE 291,D00,111343,Savage; Stefan,0,0,0,0
1668099319278,CSE 291,E00,116474,Claffy; Kimberly Claire,0,0,0,0
1668099319278,CSE 291,F00,116479,Pasquale; Joseph,0,0,0,0
1668099319715,CSE 293,001,119111,Bafna; Vineet,9999,0,9999,0
1668099319715,CSE 293,002,119118,Bellare; Mihir,9999,0,9999,0
1668099319715,CSE 293,003,119122,Berg-Kirkpatrick; Taylor D,9999,0,9999,0
1668099319715,CSE 293,004,119135,Christensen; Henrik I,9999,0,9999,0
1668099319715,CSE 293,005,119142,Cottrell; Garrison W,9999,0,9999,0
1668099319715,CSE 293,006,119146,Deutsch; Alin Bernard,9999,0,9999,0
1668099319715,CSE 293,007,119159,Esmaeilzadeh; Hadi,9999,0,9999,0
1668099319715,CSE 293,008,119166,Freund; Yoav,9999,0,9999,0
1668099319715,CSE 293,009,119170,Griswold; William G.,9999,0,9999,0
1668099319715,CSE 293,010,119183,Gymrek; Melissa Ann,9999,0,9999,0
1668099319715,CSE 293,011,119190,Heninger; Nadia A,9999,0,9999,0
1668099319715,CSE 293,012,119230,Impagliazzo; Russell,9999,0,9999,0
1668099319715,CSE 293,013,119232,Jhala; Ranjit,9999,0,9999,0
1668099319715,CSE 293,014,119233,Kahng; Andrew Byun,9999,0,9999,0
1668099319715,CSE 293,015,119298,Kane; Daniel Mertz,9999,0,9999,0
1668099319715,CSE 293,016,119299,Kriegman; David J,9999,0,9999,0
1668099319715,CSE 293,017,119300,Kumar; Arun Kumar,9999,0,9999,0
1668099319715,CSE 293,018,119301,Lerner; Sorin,9999,0,9999,0
1668099319715,CSE 293,019,119302,Lovett; Shachar,9999,0,9999,0
1668099319715,CSE 293,020,119303,McAuley; Julian John,9999,0,9999,0
1668099319715,CSE 293,021,119304,Micciancio; Daniele,9999,0,9999,0
1668099319715,CSE 293,022,119367,Orailoglu; Alex,9999,0,9999,0
1668099319715,CSE 293,023,119382,Paturi; Ramamohan,9999,0,9999,0
1668099319715,CSE 293,024,119404,Polikarpova; Nadezhda,9999,0,9999,0
1668099319715,CSE 293,025,119406,Politz; Joseph Gibbs,9999,0,9999,0
1668099319715,CSE 293,026,119411,Porter; George M,9999,0,9999,0
1668099319715,CSE 293,027,119414,Porter; Leonard Emerson,9999,0,9999,0
1668099319715,CSE 293,028,119416,Ramamoorthi; Ravi,9999,0,9999,0
1668099319715,CSE 293,029,119417,Sahoo; Debashis,9999,0,9999,0
1668099319715,CSE 293,030,119420,Saul; Lawrence,9999,0,9999,0
1668099319715,CSE 293,031,119421,Savage; Stefan,9999,0,9999,0
1668099319715,CSE 293,032,119425,Schulze; Jurgen P.,9999,0,9999,0
1668099319715,CSE 293,033,119426,Snoeren; Alex C.,9999,0,9999,0
1668099319715,CSE 293,034,119428,Shang; Jingbo,9999,0,9999,0
1668099319715,CSE 293,035,119430,Stefan; Deian,9999,0,9999,0
1668099319715,CSE 293,036,119431,Su; Hao,9999,0,9999,0
1668099319715,CSE 293,037,119433,Swanson; Steven James,9999,0,9999,0
1668099319715,CSE 293,038,119435,Tullsen; Dean Michael,9999,0,9999,0
1668099319715,CSE 293,039,119483,Voelker; Geoffrey M.,9999,0,9999,0
1668099319715,CSE 293,040,119537,Zhao; Jishen,9999,0,9999,0
1668099319715,CSE 293,041,119538,Zhou; Yuan-Yuan,9999,0,9999,0
1668099319715,CSE 293,042,119539,Gao; Sicun,9999,0,9999,0
1668099319715,CSE 293,043,119540,Weibel; Nadir,9999,0,9999,0
1668099319715,CSE 293,044,119541,Gupta; Rajesh K.,9999,0,9999,0
1668099319715,CSE 293,045,126410,Vaccaro; Kristen Marie,9999,0,9999,0
1668099319715,CSE 293,046,126411,Klemke; Richard,9999,0,9999,0
1668099320152,CSE 294,A00,102459,Voelker; Geoffrey M.,0,0,0,0
1668099320152,CSE 294,B00,111322,Orailoglu; Alex,0,0,0,0
1668099320578,DSE 201,A00,096914,Deutsch; Alin Bernard,30,0,30,0
1668099321005,DSE 210,A00,096915,Dasgupta; Sanjoy,30,0,30,0
1668099321428,DSE 260A,A00,096916,Altintas De Callaf; Ilkay,30,0,30,0
1668099321857,ECE 200,001,103586,Antipa; Nicholas A,9999,0,9999,0
1668099321857,ECE 200,002,103587,Atanasov; Nikolay A.,9999,0,9999,0
1668099321857,ECE 200,003,103588,Bharadia; Dinesh,9999,0,9999,0
1668099321857,ECE 200,004,103589,Cheng; Chung Kuan,9999,0,9999,0
1668099321857,ECE 200,005,103590,Cosman; Pamela C.,9999,0,9999,0
1668099321857,ECE 200,006,103591,Dayeh; Shadi Ahmad,9999,0,9999,0
1668099321857,ECE 200,007,103592,Fainman; Yeshaiahu,9999,0,9999,0
1668099321857,ECE 200,008,103593,Ford; Joseph Earl,9999,0,9999,0
1668099321857,ECE 200,009,103594,Franceschetti; Massimo,9999,0,9999,0
1668099321857,ECE 200,010,103595,Fullerton; Eric E,9999,0,9999,0
1668099321857,ECE 200,011,103596,Galton; Ian A,9999,0,9999,0
1668099321857,ECE 200,012,103597,Gilja; Vikash,9999,0,9999,0
1668099321857,ECE 200,013,103598,Hall; Drew A.,9999,0,9999,0
1668099321857,ECE 200,014,103599,Hsueh; Tzu-Chien,9999,0,9999,0
1668099321857,ECE 200,015,103600,Javidi; Tara,9999,0,9999,0
1668099321857,ECE 200,016,103601,Kahng; Andrew Byun,9999,0,9999,0
1668099321857,ECE 200,017,103602,Kim; Young-Han,9999,0,9999,0
1668099321857,ECE 200,018,103603,Koushanfar; Farinaz,9999,0,9999,0
1668099321857,ECE 200,019,103604,Kuzum; Duygu,9999,0,9999,0
1668099321857,ECE 200,020,103605,Le; Hanh-Phuc,9999,0,9999,0
1668099321857,ECE 200,021,103606,Lin; Bill,9999,0,9999,0
1668099321857,ECE 200,022,103607,Liu; Zhaowei,9998,0,9999,1
1668099321857,ECE 200,023,103608,Lo; Yu-Hwa,9999,0,9999,0
1668099321857,ECE 200,024,103609,Lomakin; Vitaliy,9999,0,9999,0
1668099321857,ECE 200,025,103610,Mercier; Patrick Philip,9999,0,9999,0
1668099321857,ECE 200,026,103611,Meyer; Florian,9999,0,9999,0
1668099321857,ECE 200,027,103612,Milstein; Laurence B.,9999,0,9999,0
1668099321857,ECE 200,028,103613,Mir Arabbaygi; Siavash,9999,0,9999,0
1668099321857,ECE 200,029,103614,Mookherjea; Shayan,9999,0,9999,0
1668099321857,ECE 200,030,103615,Morris; Karcher William,9999,0,9999,0
1668099321857,ECE 200,031,103616,Ng; Tse Nga,9999,0,9999,0
1668099321857,ECE 200,032,103617,Nguyen; Truong Quang,9999,0,9999,0
1668099321857,ECE 200,033,103618,Nomura; Kenji,9999,0,9999,0
1668099321857,ECE 200,034,103619,Orlitsky; Alon,9999,0,9999,0
1668099321857,ECE 200,035,103620,Pal; Piya,9999,0,9999,0
1668099321857,ECE 200,036,103621,Papen; George C.,9999,0,9999,0
1668099321857,ECE 200,037,103622,Radic; Stojan,9999,0,9999,0
1668099321857,ECE 200,038,103623,Rao; Bhaskar D.,9999,0,9999,0
1668099321857,ECE 200,039,103624,Rao; Ramesh R,9999,0,9999,0
1668099321857,ECE 200,040,103625,Rebeiz; Gabriel,9999,0,9999,0
1668099321857,ECE 200,041,103626,Sanford; John R,9999,0,9999,0
1668099321857,ECE 200,042,103627,Siegel; Paul H.,9999,0,9999,0
1668099321857,ECE 200,043,103628,Sievenpiper; Daniel F.,9999,0,9999,0
1668099321857,ECE 200,044,103629,Sworder; David D.,9999,0,9999,0
1668099321857,ECE 200,045,103630,Taur; Yuan,9999,0,9999,0
1668099321857,ECE 200,046,103631,Touri; Behrouz,9999,0,9999,0
1668099321857,ECE 200,047,103632,Trivedi; Mohan M.,9999,0,9999,0
1668099321857,ECE 200,048,103633,Vasconcelos; Nuno,9999,0,9999,0
1668099321857,ECE 200,049,103634,Wang; Xiaolong,9999,0,9999,0
1668099321857,ECE 200,050,103635,Xie; Pengtao,9999,0,9999,0
1668099321857,ECE 200,051,103636,Yip; Michael,9999,0,9999,0
1668099321857,ECE 200,052,103637,Zeger; Kenneth A.,999,0,999,0
1668099321857,ECE 200,053,103638,Zhang; Xinyu,9999,0,9999,0
1668099321857,ECE 200,054,103639,Turakhia; Yatish Girish,9999,0,9999,0
1668099321857,ECE 200,055,103640,Kang; Mingu,9999,0,9999,0
1668099321857,ECE 200,056,103641,Shi; Yuanyuan,9999,0,9999,0
1668099321857,ECE 200,057,103642,Wang; Edward Jay,9999,0,9999,0
1668099321857,ECE 200,058,103643,Zheng; Yang,9999,0,9999,0
1668099322284,ECE 202,A00,103644,Kuzum; Duygu,0,0,0,0
1668099322713,ECE 212BN,A00,103646,Ng; Tse Nga,0,0,0,0
1668099323137,ECE 221,A00,111493,Staff,0,0,0,0
1668099323565,ECE 222B,A00,103647,Lomakin; Vitaliy,0,0,0,0
1668099323998,ECE 230B,A00,103648,Taur; Yuan,0,0,0,0
1668099324429,ECE 238B,A00,103649,Garay; Javier,0,0,0,0
1668099324852,ECE 240B,A00,112900,Fainman; Yeshaiahu,0,0,0,0
1668099325276,ECE 247A,A00,103650,Jokerst; Jesse Vincent,0,0,0,0
1668099325702,ECE 247B,A00,103651,Wang; Joseph,0,0,0,0
1668099326129,ECE 250,A00,103652,Siegel; Paul H.,0,0,0,0
1668099326556,ECE 251A,A00,103654,Rao; Bhaskar D.,0,0,0,0
1668099326978,ECE 257B,A00,103655,Bharadia; Dinesh,0,0,0,0
1668099327407,ECE 258A,A00,103656,Milstein; Laurence B.,0,0,0,0
1668099327831,ECE 260B,A00,103658,Kang; Mingu,0,0,0,0
1668099328274,ECE 264A,A00,103659,Galton; Ian A,0,0,0,0
1668099328698,ECE 265A,A00,103661,Gudem; Prasad S.S.,0,0,0,0
1668099329125,ECE 265D,A00,103662,Gudem; Prasad S.S.,0,0,0,0
1668099329550,ECE 268,A00,103663,Koushanfar; Farinaz,0,0,0,0
1668099329974,ECE 269,A01,103665,Pal; Piya,0,0,0,0
1668099330397,ECE 271B,A00,103666,Vasconcelos; Manuela,0,0,0,0
1668099330821,ECE 276A,A00,103667,Atanasov; Nikolay A.,0,0,0,0
1668099331247,ECE 277,A00,103668,An; Cheolhong,0,0,0,0
1668099331761,ECE 279,A00,117947,Hall; Drew A.,0,0,0,0
1668099332620,ECE 283,A00,103670,Hsueh; Tzu-Chien,0,0,0,0
1668099333046,ECE 284,A00,103671,Turakhia; Yatish Girish,0,0,0,0
1668099333480,ECE 285,A00,103672,Zheng; Yang,0,0,0,0
1668099333480,ECE 285,B00,103673,Sworder; David D.,0,0,0,0
1668099333904,ECE 287,A00,103676,Javidi; Tara,0,0,0,0
1668099334328,MATH 200B,A00,098023,Salehi Golsefidy; Alireza,13,0,15,2
1668099334763,MATH 202B,A00,098024,Rhoades; Brendon Patrick,9,0,15,6
1668099335192,MATH 203B,A00,098025,Oprea; Dragos N.,10,0,15,5
1668099335616,MATH 204B,A00,098026,Sorensen; Claus M,13,0,15,2
1668099336040,MATH 208,A00,098027,Izadi; Elham,7,0,10,3
1668099336463,MATH 209,A00,098028,Pollack; Aaron,10,0,10,0
1668099336891,MATH 211A,A00,112919,Rogalski; Daniel,9,0,10,1
1668099337314,MATH 211B,A00,112920,Seward; Brandon M.,9,0,10,1
1668099337741,MATH 218,A00,098029,Li; Bo,10,0,10,0
1668099338165,MATH 220B,A00,098030,Novak; Jonathan I,12,0,15,3
1668099338596,MATH 221A,A00,098031,Ebenfelt; Peter F,13,0,15,2
1668099339022,MATH 231B,A00,098032,Zlatos; Andrej,12,0,15,3
1668099339443,MATH 240B,A00,098033,Ni; Lei,9,0,15,6
1668099339870,MATH 243,A00,098034,Jekel; David Andrew,10,0,10,0
1668099340292,MATH 245A,A00,098035,Nie; Jiawang,0,0,15,16
1668099340716,MATH 248,A00,098036,Bejenaru; Ioan,10,0,10,0
1668099341139,MATH 250B,A00,098037,Spolaor; Luca,14,0,15,1
1668099341571,MATH 258,A00,098038,Ni; Lei,10,0,10,0
1668099341995,MATH 264B,A00,098041,Rhoades; Brendon Patrick,10,0,15,5
1668099342417,MATH 268,A00,098042,Buss; Samuel R,10,0,10,0
1668099342841,MATH 269,A00,098043,Rhoades; Brendon Patrick,10,0,10,0
1668099343276,MATH 270B,A00,098044,Li; Bo,11,0,15,4
1668099343700,MATH 272B,A00,098045,Holst; Michael J,13,0,15,2
1668099344130,MATH 273A,A00,098046,Tian; Xiaochuan,10,0,15,5
1668099344557,MATH 275,A01,098048,Tian; Xiaochuan,6,0,10,4
1668099344978,MATH 278A,A00,098049,Holst; Michael J,8,0,10,2
1668099345400,MATH 278B,A00,098050,Cloninger; Alexander,10,0,10,0
1668099345834,MATH 278C,A00,098051,Nie; Jiawang,7,0,10,3
1668099346260,MATH 280B,A00,098052,Zheng; Tianyi,10,0,15,5
1668099346688,MATH 281B,A00,098053,Bradic; Jelena,3,0,15,12
1668099347112,MATH 282B,A00,098054,Arias-Castro; Ery,0,0,15,15
1668099347536,MATH 285,A00,098055,Fitzsimmons; Patrick J,0,0,15,17
1668099347959,MATH 287B,A00,098056,Arias-Castro; Ery,3,0,15,12
1668099348391,MATH 288,A00,098057,Agarwal; Pooja,9,0,10,1
1668099348391,MATH 288,B00,098058,Zhang; Danna,8,0,10,2
1668099348391,MATH 288,C00,098059,Williams; Ruth J,10,0,10,0
1668099348813,MATH 290B,A00,098060,Roberts; Justin Deritter,13,0,15,2
1668099349239,MATH 292,A00,098061,Belmont; Eva Kinoshita,10,0,10,0
1668099349667,MATH 295,A00,098062,Suk; Andrew Hoon,48,0,50,2
1668099350090,MATH 296,A00,098063,Novak; Jonathan I,20,0,20,0
1668099350513,MATH 297,001,098064,Gamst; Anthony Collins,9997,0,9999,2
1668099852981,COGS 205,A00,101395,Chiba; Andrea,19,0,20,1
1668099853406,COGS 210B,001,101404,Greene; Deanna Jacquelyn,9998,0,9999,1
1668099853406,COGS 210B,002,101417,Xia; Haijun,9999,0,9999,0
1668099853406,COGS 210B,003,101422,Nitz; Douglas A.,9999,0,9999,0
1668099853406,COGS 210B,004,101423,Hollan; James D.,9998,0,9999,1
1668099853406,COGS 210B,005,101424,Deak; Gedeon O.,9998,0,9999,1
1668099853406,COGS 210B,006,101425,Rossano; Federico,9999,0,9999,0
1668099853834,COGS 211B,A00,101427,Coulson; Seana M,9996,0,9999,3
1668099854330,COGS 220,A00,101428,Hollan; James D.,0,0,25,25
1668099854760,COGS 229,A00,101429,Dow; Steven P,18,0,25,7
1668099855192,COGS 230,A00,101430,Klemmer; Scott R,13,0,17,4
1668099855614,COGS 234,A00,101431,Xia; Haijun,3,0,25,22
1668099856045,COGS 260,A00,101432,Kiyonaga; Anastasia,19,0,25,6
1668099856045,COGS 260,B00,101433,Kirsh; David Joel,16,0,25,9
1668099856471,CSE 202,A00,102371,Impagliazzo; Russell,0,0,0,0
1668099856907,CSE 203B,A01,102373,Cheng; Chung Kuan,0,0,0,0
1668099857330,CSE 208,A00,102374,Micciancio; Daniele,0,0,0,0
1668099857752,CSE 209A,A00,112895,Impagliazzo; Russell,0,0,15,15
1668099858174,CSE 209B,A00,108005,Bellare; Mihir,0,0,0,0
1668099858603,CSE 210,A00,113163,Coblenz; Michael J,0,0,0,0
1668099859028,CSE 219,A00,106111,Dow; Steven P,0,0,20,20
1668099859450,CSE 221,A00,102376,Voelker; Geoffrey M.,0,0,0,0
1668099859877,CSE 224,A01,102378,Porter; George M,0,0,0,0
1668099860309,CSE 229A,A00,102379,Savage; Stefan,0,0,0,0
1668099860741,CSE 229C,A00,102380,Munyaka; Imani N. S.,0,0,0,0
1668099861163,CSE 232B,A00,102382,Deutsch; Alin Bernard,0,0,0,0
1668099861597,CSE 234,A01,112904,Kumar; Arun Kumar,0,0,0,0
1668099862033,CSE 237A,A00,102383,Rosing; Tajana Simunic,0,0,0,0
1668099862456,CSE 239A,A00,102384,Deutsch; Alin Bernard,0,0,0,0
1668099862881,CSE 239B,A00,102385,Polikarpova; Nadezhda,0,0,0,0
1668099863305,CSE 240A,A00,102386,Pannuto; Patrick William,0,0,0,0
1668099863728,CSE 240B,A00,102387,Zhao; Jishen,0,0,0,0
1668099864162,CSE 241A,A00,106406,Kang; Mingu,0,0,0,0
1668099864586,CSE 249B,A00,102388,Kahng; Andrew Byun,0,0,8,8
1668099865010,CSE 251B,A01,102392,Cottrell; Garrison W,0,0,0,0
1668099865010,CSE 251B,A02,102393,Cottrell; Garrison W,0,0,0,0
1668099865434,CSE 252B,A00,102394,Ochoa; Benjamin Lawrence,0,0,0,0
1668099865877,CSE 257,A01,102396,Gao; Sicun,0,0,0,0
1668099866303,CSE 272,A00,102397,Li; Tzumao,0,0,0,0
1668099866726,CSE 274,A00,111323,Chern; Albert Ren-Haur,0,0,0,0
1668099867155,CSE 282,A00,102398,Pevzner; Pavel Arkadjevich,0,0,0,0
1668099867602,CSE 284,A00,114175,Gymrek; Melissa Ann,0,0,0,0
1668099868031,CSE 290,A00,102399,Chandraker; Manmohan Krishna,0,0,0,0
1668099868031,CSE 290,B00,102400,Vaccaro; Kristen Marie,0,0,25,25
1668099868031,CSE 290,C00,102414,Pannuto; Patrick William,0,0,25,25
1668099868031,CSE 290,D00,102427,Pevzner; Pavel Arkadjevich,0,0,0,0
1668099868031,CSE 290,E00,102429,Zhao; Jishen,0,0,0,0
1668099868031,CSE 290,F00,102436,Tullsen; Dean Michael,0,0,0,0
1668099868031,CSE 290,G00,102440,Christensen; Henrik I,0,0,20,20
1668099868454,CSE 291,A00,102443,Su; Hao,0,0,0,0
1668099868454,CSE 291,B00,102448,Polikarpova; Nadezhda,0,0,0,0
1668099868454,CSE 291,C00,102453,Vaccaro; Kristen Marie,0,0,0,0
1668099868454,CSE 291,D00,111343,Savage; Stefan,0,0,0,0
1668099868454,CSE 291,E00,116474,Claffy; Kimberly Claire,0,0,0,0
1668099868454,CSE 291,F00,116479,Pasquale; Joseph,0,0,0,0
1668099868892,CSE 293,001,119111,Bafna; Vineet,9999,0,9999,0
1668099868892,CSE 293,002,119118,Bellare; Mihir,9999,0,9999,0
1668099868892,CSE 293,003,119122,Berg-Kirkpatrick; Taylor D,9999,0,9999,0
1668099868892,CSE 293,004,119135,Christensen; Henrik I,9999,0,9999,0
1668099868892,CSE 293,005,119142,Cottrell; Garrison W,9999,0,9999,0
1668099868892,CSE 293,006,119146,Deutsch; Alin Bernard,9999,0,9999,0
1668099868892,CSE 293,007,119159,Esmaeilzadeh; Hadi,9999,0,9999,0
1668099868892,CSE 293,008,119166,Freund; Yoav,9999,0,9999,0
1668099868892,CSE 293,009,119170,Griswold; William G.,9999,0,9999,0
1668099868892,CSE 293,010,119183,Gymrek; Melissa Ann,9999,0,9999,0
1668099868892,CSE 293,011,119190,Heninger; Nadia A,9999,0,9999,0
1668099868892,CSE 293,012,119230,Impagliazzo; Russell,9999,0,9999,0
1668099868892,CSE 293,013,119232,Jhala; Ranjit,9999,0,9999,0
1668099868892,CSE 293,014,119233,Kahng; Andrew Byun,9999,0,9999,0
1668099868892,CSE 293,015,119298,Kane; Daniel Mertz,9999,0,9999,0
1668099868892,CSE 293,016,119299,Kriegman; David J,9999,0,9999,0
1668099868892,CSE 293,017,119300,Kumar; Arun Kumar,9999,0,9999,0
1668099868892,CSE 293,018,119301,Lerner; Sorin,9999,0,9999,0
1668099868892,CSE 293,019,119302,Lovett; Shachar,9999,0,9999,0
1668099868892,CSE 293,020,119303,McAuley; Julian John,9999,0,9999,0
1668099868892,CSE 293,021,119304,Micciancio; Daniele,9999,0,9999,0
1668099868892,CSE 293,022,119367,Orailoglu; Alex,9999,0,9999,0
1668099868892,CSE 293,023,119382,Paturi; Ramamohan,9999,0,9999,0
1668099868892,CSE 293,024,119404,Polikarpova; Nadezhda,9999,0,9999,0
1668099868892,CSE 293,025,119406,Politz; Joseph Gibbs,9999,0,9999,0
1668099868892,CSE 293,026,119411,Porter; George M,9999,0,9999,0
1668099868892,CSE 293,027,119414,Porter; Leonard Emerson,9999,0,9999,0
1668099868892,CSE 293,028,119416,Ramamoorthi; Ravi,9999,0,9999,0
1668099868892,CSE 293,029,119417,Sahoo; Debashis,9999,0,9999,0
1668099868892,CSE 293,030,119420,Saul; Lawrence,9999,0,9999,0
1668099868892,CSE 293,031,119421,Savage; Stefan,9999,0,9999,0
1668099868892,CSE 293,032,119425,Schulze; Jurgen P.,9999,0,9999,0
1668099868892,CSE 293,033,119426,Snoeren; Alex C.,9999,0,9999,0
1668099868892,CSE 293,034,119428,Shang; Jingbo,9999,0,9999,0
1668099868892,CSE 293,035,119430,Stefan; Deian,9999,0,9999,0
1668099868892,CSE 293,036,119431,Su; Hao,9999,0,9999,0
1668099868892,CSE 293,037,119433,Swanson; Steven James,9999,0,9999,0
1668099868892,CSE 293,038,119435,Tullsen; Dean Michael,9999,0,9999,0
1668099868892,CSE 293,039,119483,Voelker; Geoffrey M.,9999,0,9999,0
1668099868892,CSE 293,040,119537,Zhao; Jishen,9999,0,9999,0
1668099868892,CSE 293,041,119538,Zhou; Yuan-Yuan,9999,0,9999,0
1668099868892,CSE 293,042,119539,Gao; Sicun,9999,0,9999,0
1668099868892,CSE 293,043,119540,Weibel; Nadir,9999,0,9999,0
1668099868892,CSE 293,044,119541,Gupta; Rajesh K.,9999,0,9999,0
1668099868892,CSE 293,045,126410,Vaccaro; Kristen Marie,9999,0,9999,0
1668099868892,CSE 293,046,126411,Klemke; Richard,9999,0,9999,0
1668099869316,CSE 294,A00,102459,Voelker; Geoffrey M.,0,0,0,0
1668099869316,CSE 294,B00,111322,Orailoglu; Alex,0,0,0,0
1668099869742,DSE 201,A00,096914,Deutsch; Alin Bernard,30,0,30,0
1668099870166,DSE 210,A00,096915,Dasgupta; Sanjoy,30,0,30,0
1668099870623,DSE 260A,A00,096916,Altintas De Callaf; Ilkay,30,0,30,0
1668099871054,ECE 200,001,103586,Antipa; Nicholas A,9999,0,9999,0
1668099871054,ECE 200,002,103587,Atanasov; Nikolay A.,9999,0,9999,0
1668099871054,ECE 200,003,103588,Bharadia; Dinesh,9999,0,9999,0
1668099871054,ECE 200,004,103589,Cheng; Chung Kuan,9999,0,9999,0
1668099871054,ECE 200,005,103590,Cosman; Pamela C.,9999,0,9999,0
1668099871054,ECE 200,006,103591,Dayeh; Shadi Ahmad,9999,0,9999,0
1668099871054,ECE 200,007,103592,Fainman; Yeshaiahu,9999,0,9999,0
1668099871054,ECE 200,008,103593,Ford; Joseph Earl,9999,0,9999,0
1668099871054,ECE 200,009,103594,Franceschetti; Massimo,9999,0,9999,0
1668099871054,ECE 200,010,103595,Fullerton; Eric E,9999,0,9999,0
1668099871054,ECE 200,011,103596,Galton; Ian A,9999,0,9999,0
1668099871054,ECE 200,012,103597,Gilja; Vikash,9999,0,9999,0
1668099871054,ECE 200,013,103598,Hall; Drew A.,9999,0,9999,0
1668099871054,ECE 200,014,103599,Hsueh; Tzu-Chien,9999,0,9999,0
1668099871054,ECE 200,015,103600,Javidi; Tara,9999,0,9999,0
1668099871054,ECE 200,016,103601,Kahng; Andrew Byun,9999,0,9999,0
1668099871054,ECE 200,017,103602,Kim; Young-Han,9999,0,9999,0
1668099871054,ECE 200,018,103603,Koushanfar; Farinaz,9999,0,9999,0
1668099871054,ECE 200,019,103604,Kuzum; Duygu,9999,0,9999,0
1668099871054,ECE 200,020,103605,Le; Hanh-Phuc,9999,0,9999,0
1668099871054,ECE 200,021,103606,Lin; Bill,9999,0,9999,0
1668099871054,ECE 200,022,103607,Liu; Zhaowei,9998,0,9999,1
1668099871054,ECE 200,023,103608,Lo; Yu-Hwa,9999,0,9999,0
1668099871054,ECE 200,024,103609,Lomakin; Vitaliy,9999,0,9999,0
1668099871054,ECE 200,025,103610,Mercier; Patrick Philip,9999,0,9999,0
1668099871054,ECE 200,026,103611,Meyer; Florian,9999,0,9999,0
1668099871054,ECE 200,027,103612,Milstein; Laurence B.,9999,0,9999,0
1668099871054,ECE 200,028,103613,Mir Arabbaygi; Siavash,9999,0,9999,0
1668099871054,ECE 200,029,103614,Mookherjea; Shayan,9999,0,9999,0
1668099871054,ECE 200,030,103615,Morris; Karcher William,9999,0,9999,0
1668099871054,ECE 200,031,103616,Ng; Tse Nga,9999,0,9999,0
1668099871054,ECE 200,032,103617,Nguyen; Truong Quang,9999,0,9999,0
1668099871054,ECE 200,033,103618,Nomura; Kenji,9999,0,9999,0
1668099871054,ECE 200,034,103619,Orlitsky; Alon,9999,0,9999,0
1668099871054,ECE 200,035,103620,Pal; Piya,9999,0,9999,0
1668099871054,ECE 200,036,103621,Papen; George C.,9999,0,9999,0
1668099871054,ECE 200,037,103622,Radic; Stojan,9999,0,9999,0
1668099871054,ECE 200,038,103623,Rao; Bhaskar D.,9999,0,9999,0
1668099871054,ECE 200,039,103624,Rao; Ramesh R,9999,0,9999,0
1668099871054,ECE 200,040,103625,Rebeiz; Gabriel,9999,0,9999,0
1668099871054,ECE 200,041,103626,Sanford; John R,9999,0,9999,0
1668099871054,ECE 200,042,103627,Siegel; Paul H.,9999,0,9999,0
1668099871054,ECE 200,043,103628,Sievenpiper; Daniel F.,9999,0,9999,0
1668099871054,ECE 200,044,103629,Sworder; David D.,9999,0,9999,0
1668099871054,ECE 200,045,103630,Taur; Yuan,9999,0,9999,0
1668099871054,ECE 200,046,103631,Touri; Behrouz,9999,0,9999,0
1668099871054,ECE 200,047,103632,Trivedi; Mohan M.,9999,0,9999,0
1668099871054,ECE 200,048,103633,Vasconcelos; Nuno,9999,0,9999,0
1668099871054,ECE 200,049,103634,Wang; Xiaolong,9999,0,9999,0
1668099871054,ECE 200,050,103635,Xie; Pengtao,9999,0,9999,0
1668099871054,ECE 200,051,103636,Yip; Michael,9999,0,9999,0
1668099871054,ECE 200,052,103637,Zeger; Kenneth A.,999,0,999,0
1668099871054,ECE 200,053,103638,Zhang; Xinyu,9999,0,9999,0
1668099871054,ECE 200,054,103639,Turakhia; Yatish Girish,9999,0,9999,0
1668099871054,ECE 200,055,103640,Kang; Mingu,9999,0,9999,0
1668099871054,ECE 200,056,103641,Shi; Yuanyuan,9999,0,9999,0
1668099871054,ECE 200,057,103642,Wang; Edward Jay,9999,0,9999,0
1668099871054,ECE 200,058,103643,Zheng; Yang,9999,0,9999,0
1668099871507,ECE 202,A00,103644,Kuzum; Duygu,0,0,0,0
1668099871936,ECE 212BN,A00,103646,Ng; Tse Nga,0,0,0,0
1668099872364,ECE 221,A00,111493,Staff,0,0,0,0
1668099872792,ECE 222B,A00,103647,Lomakin; Vitaliy,0,0,0,0
1668099873214,ECE 230B,A00,103648,Taur; Yuan,0,0,0,0
1668099873638,ECE 238B,A00,103649,Garay; Javier,0,0,0,0
1668099874069,ECE 240B,A00,112900,Fainman; Yeshaiahu,0,0,0,0
1668099874491,ECE 247A,A00,103650,Jokerst; Jesse Vincent,0,0,0,0
1668099874919,ECE 247B,A00,103651,Wang; Joseph,0,0,0,0
1668099875344,ECE 250,A00,103652,Siegel; Paul H.,0,0,0,0
1668099875774,ECE 251A,A00,103654,Rao; Bhaskar D.,0,0,0,0
1668099876202,ECE 257B,A00,103655,Bharadia; Dinesh,0,0,0,0
1668099876624,ECE 258A,A00,103656,Milstein; Laurence B.,0,0,0,0
1668099877054,ECE 260B,A00,103658,Kang; Mingu,0,0,0,0
1668099877475,ECE 264A,A00,103659,Galton; Ian A,0,0,0,0
1668099877908,ECE 265A,A00,103661,Gudem; Prasad S.S.,0,0,0,0
1668099878330,ECE 265D,A00,103662,Gudem; Prasad S.S.,0,0,0,0
1668099878756,ECE 268,A00,103663,Koushanfar; Farinaz,0,0,0,0
1668099879179,ECE 269,A01,103665,Pal; Piya,0,0,0,0
1668099879735,ECE 271B,A00,103666,Vasconcelos; Manuela,0,0,0,0
1668099880162,ECE 276A,A00,103667,Atanasov; Nikolay A.,0,0,0,0
1668099880587,ECE 277,A00,103668,An; Cheolhong,0,0,0,0
1668099881017,ECE 279,A00,117947,Hall; Drew A.,0,0,0,0
1668099881864,ECE 283,A00,103670,Hsueh; Tzu-Chien,0,0,0,0
1668099882288,ECE 284,A00,103671,Turakhia; Yatish Girish,0,0,0,0
1668099882714,ECE 285,A00,103672,Zheng; Yang,0,0,0,0
1668099882714,ECE 285,B00,103673,Sworder; David D.,0,0,0,0
1668099883140,ECE 287,A00,103676,Javidi; Tara,0,0,0,0
1668099883569,MATH 200B,A00,098023,Salehi Golsefidy; Alireza,13,0,15,2
1668099883997,MATH 202B,A00,098024,Rhoades; Brendon Patrick,9,0,15,6
1668099884426,MATH 203B,A00,098025,Oprea; Dragos N.,10,0,15,5
1668099884851,MATH 204B,A00,098026,Sorensen; Claus M,13,0,15,2
1668099885278,MATH 208,A00,098027,Izadi; Elham,7,0,10,3
1668099885702,MATH 209,A00,098028,Pollack; Aaron,10,0,10,0
1668099886126,MATH 211A,A00,112919,Rogalski; Daniel,9,0,10,1
1668099886553,MATH 211B,A00,112920,Seward; Brandon M.,9,0,10,1
1668099886981,MATH 218,A00,098029,Li; Bo,10,0,10,0
1668099887416,MATH 220B,A00,098030,Novak; Jonathan I,12,0,15,3
1668099887873,MATH 221A,A00,098031,Ebenfelt; Peter F,13,0,15,2
1668099888304,MATH 231B,A00,098032,Zlatos; Andrej,12,0,15,3
1668099888728,MATH 240B,A00,098033,Ni; Lei,9,0,15,6
1668099889152,MATH 243,A00,098034,Jekel; David Andrew,10,0,10,0
1668099889576,MATH 245A,A00,098035,Nie; Jiawang,0,0,15,16
1668099890013,MATH 248,A00,098036,Bejenaru; Ioan,10,0,10,0
1668099890462,MATH 250B,A00,098037,Spolaor; Luca,14,0,15,1
1668099890896,MATH 258,A00,098038,Ni; Lei,10,0,10,0
1668099891321,MATH 264B,A00,098041,Rhoades; Brendon Patrick,10,0,15,5
1668099891744,MATH 268,A00,098042,Buss; Samuel R,10,0,10,0
1668099892170,MATH 269,A00,098043,Rhoades; Brendon Patrick,10,0,10,0
1668099892596,MATH 270B,A00,098044,Li; Bo,11,0,15,4
1668099893017,MATH 272B,A00,098045,Holst; Michael J,13,0,15,2
1668099893442,MATH 273A,A00,098046,Tian; Xiaochuan,10,0,15,5
1668099893876,MATH 275,A01,098048,Tian; Xiaochuan,6,0,10,4
1668099894299,MATH 278A,A00,098049,Holst; Michael J,8,0,10,2
1668099894721,MATH 278B,A00,098050,Cloninger; Alexander,10,0,10,0
1668099895144,MATH 278C,A00,098051,Nie; Jiawang,7,0,10,3
1668099895576,MATH 280B,A00,098052,Zheng; Tianyi,10,0,15,5
1668099896000,MATH 281B,A00,098053,Bradic; Jelena,3,0,15,12
1668099896425,MATH 282B,A00,098054,Arias-Castro; Ery,0,0,15,15
1668099896858,MATH 285,A00,098055,Fitzsimmons; Patrick J,0,0,15,17
1668099897289,MATH 287B,A00,098056,Arias-Castro; Ery,3,0,15,12
1668099897808,MATH 288,A00,098057,Agarwal; Pooja,9,0,10,1
1668099897808,MATH 288,B00,098058,Zhang; Danna,8,0,10,2
1668099897808,MATH 288,C00,098059,Williams; Ruth J,10,0,10,0
1668099898230,MATH 290B,A00,098060,Roberts; Justin Deritter,13,0,15,2
1668099898658,MATH 292,A00,098061,Belmont; Eva Kinoshita,10,0,10,0
1668099899081,MATH 295,A00,098062,Suk; Andrew Hoon,48,0,50,2
1668099899504,MATH 296,A00,098063,Novak; Jonathan I,20,0,20,0
1668099899926,MATH 297,001,098064,Gamst; Anthony Collins,9997,0,9999,2
1668100402864,COGS 205,A00,101395,Chiba; Andrea,19,0,20,1
1668100403291,COGS 210B,001,101404,Greene; Deanna Jacquelyn,9998,0,9999,1
1668100403291,COGS 210B,002,101417,Xia; Haijun,9999,0,9999,0
1668100403291,COGS 210B,003,101422,Nitz; Douglas A.,9999,0,9999,0
1668100403291,COGS 210B,004,101423,Hollan; James D.,9998,0,9999,1
1668100403291,COGS 210B,005,101424,Deak; Gedeon O.,9998,0,9999,1
1668100403291,COGS 210B,006,101425,Rossano; Federico,9999,0,9999,0
1668100403731,COGS 211B,A00,101427,Coulson; Seana M,9996,0,9999,3
1668100404156,COGS 220,A00,101428,Hollan; James D.,0,0,25,25
1668100404588,COGS 229,A00,101429,Dow; Steven P,18,0,25,7
1668100405012,COGS 230,A00,101430,Klemmer; Scott R,13,0,17,4
1668100405442,COGS 234,A00,101431,Xia; Haijun,3,0,25,22
1668100405871,COGS 260,A00,101432,Kiyonaga; Anastasia,19,0,25,6
1668100405871,COGS 260,B00,101433,Kirsh; David Joel,16,0,25,9
1668100406296,CSE 202,A00,102371,Impagliazzo; Russell,0,0,0,0
1668100406719,CSE 203B,A01,102373,Cheng; Chung Kuan,0,0,0,0
1668100407146,CSE 208,A00,102374,Micciancio; Daniele,0,0,0,0
1668100407572,CSE 209A,A00,112895,Impagliazzo; Russell,0,0,15,15
1668100408002,CSE 209B,A00,108005,Bellare; Mihir,0,0,0,0
1668100408441,CSE 210,A00,113163,Coblenz; Michael J,0,0,0,0
1668100408873,CSE 219,A00,106111,Dow; Steven P,0,0,20,20
1668100409308,CSE 221,A00,102376,Voelker; Geoffrey M.,0,0,0,0
1668100409734,CSE 224,A01,102378,Porter; George M,0,0,0,0
1668100410167,CSE 229A,A00,102379,Savage; Stefan,0,0,0,0
1668100410590,CSE 229C,A00,102380,Munyaka; Imani N. S.,0,0,0,0
1668100411018,CSE 232B,A00,102382,Deutsch; Alin Bernard,0,0,0,0
1668100411439,CSE 234,A01,112904,Kumar; Arun Kumar,0,0,0,0
1668100411864,CSE 237A,A00,102383,Rosing; Tajana Simunic,0,0,0,0
1668100412306,CSE 239A,A00,102384,Deutsch; Alin Bernard,0,0,0,0
1668100412731,CSE 239B,A00,102385,Polikarpova; Nadezhda,0,0,0,0
1668100413232,CSE 240A,A00,102386,Pannuto; Patrick William,0,0,0,0
1668100413659,CSE 240B,A00,102387,Zhao; Jishen,0,0,0,0
1668100414091,CSE 241A,A00,106406,Kang; Mingu,0,0,0,0
1668100414517,CSE 249B,A00,102388,Kahng; Andrew Byun,0,0,8,8
1668100414941,CSE 251B,A01,102392,Cottrell; Garrison W,0,0,0,0
1668100414941,CSE 251B,A02,102393,Cottrell; Garrison W,0,0,0,0
1668100415367,CSE 252B,A00,102394,Ochoa; Benjamin Lawrence,0,0,0,0
1668100415794,CSE 257,A01,102396,Gao; Sicun,0,0,0,0
1668100416220,CSE 272,A00,102397,Li; Tzumao,0,0,0,0
1668100416643,CSE 274,A00,111323,Chern; Albert Ren-Haur,0,0,0,0
1668100417066,CSE 282,A00,102398,Pevzner; Pavel Arkadjevich,0,0,0,0
1668100417500,CSE 284,A00,114175,Gymrek; Melissa Ann,0,0,0,0
1668100417930,CSE 290,A00,102399,Chandraker; Manmohan Krishna,0,0,0,0
1668100417930,CSE 290,B00,102400,Vaccaro; Kristen Marie,0,0,25,25
1668100417930,CSE 290,C00,102414,Pannuto; Patrick William,0,0,25,25
1668100417930,CSE 290,D00,102427,Pevzner; Pavel Arkadjevich,0,0,0,0
1668100417930,CSE 290,E00,102429,Zhao; Jishen,0,0,0,0
1668100417930,CSE 290,F00,102436,Tullsen; Dean Michael,0,0,0,0
1668100417930,CSE 290,G00,102440,Christensen; Henrik I,0,0,20,20
1668100418359,CSE 291,A00,102443,Su; Hao,0,0,0,0
1668100418359,CSE 291,B00,102448,Polikarpova; Nadezhda,0,0,0,0
1668100418359,CSE 291,C00,102453,Vaccaro; Kristen Marie,0,0,0,0
1668100418359,CSE 291,D00,111343,Savage; Stefan,0,0,0,0
1668100418359,CSE 291,E00,116474,Claffy; Kimberly Claire,0,0,0,0
1668100418359,CSE 291,F00,116479,Pasquale; Joseph,0,0,0,0
1668100418802,CSE 293,001,119111,Bafna; Vineet,9999,0,9999,0
1668100418802,CSE 293,002,119118,Bellare; Mihir,9999,0,9999,0
1668100418802,CSE 293,003,119122,Berg-Kirkpatrick; Taylor D,9999,0,9999,0
1668100418802,CSE 293,004,119135,Christensen; Henrik I,9999,0,9999,0
1668100418802,CSE 293,005,119142,Cottrell; Garrison W,9999,0,9999,0
1668100418802,CSE 293,006,119146,Deutsch; Alin Bernard,9999,0,9999,0
1668100418802,CSE 293,007,119159,Esmaeilzadeh; Hadi,9999,0,9999,0
1668100418802,CSE 293,008,119166,Freund; Yoav,9999,0,9999,0
1668100418802,CSE 293,009,119170,Griswold; William G.,9999,0,9999,0
1668100418802,CSE 293,010,119183,Gymrek; Melissa Ann,9999,0,9999,0
1668100418802,CSE 293,011,119190,Heninger; Nadia A,9999,0,9999,0
1668100418802,CSE 293,012,119230,Impagliazzo; Russell,9999,0,9999,0
1668100418802,CSE 293,013,119232,Jhala; Ranjit,9999,0,9999,0
1668100418802,CSE 293,014,119233,Kahng; Andrew Byun,9999,0,9999,0
1668100418802,CSE 293,015,119298,Kane; Daniel Mertz,9999,0,9999,0
1668100418802,CSE 293,016,119299,Kriegman; David J,9999,0,9999,0
1668100418802,CSE 293,017,119300,Kumar; Arun Kumar,9999,0,9999,0
1668100418802,CSE 293,018,119301,Lerner; Sorin,9999,0,9999,0
1668100418802,CSE 293,019,119302,Lovett; Shachar,9999,0,9999,0
1668100418802,CSE 293,020,119303,McAuley; Julian John,9999,0,9999,0
1668100418802,CSE 293,021,119304,Micciancio; Daniele,9999,0,9999,0
1668100418802,CSE 293,022,119367,Orailoglu; Alex,9999,0,9999,0
1668100418802,CSE 293,023,119382,Paturi; Ramamohan,9999,0,9999,0
1668100418802,CSE 293,024,119404,Polikarpova; Nadezhda,9999,0,9999,0
1668100418802,CSE 293,025,119406,Politz; Joseph Gibbs,9999,0,9999,0
1668100418802,CSE 293,026,119411,Porter; George M,9999,0,9999,0
1668100418802,CSE 293,027,119414,Porter; Leonard Emerson,9999,0,9999,0
1668100418802,CSE 293,028,119416,Ramamoorthi; Ravi,9999,0,9999,0
1668100418802,CSE 293,029,119417,Sahoo; Debashis,9999,0,9999,0
1668100418802,CSE 293,030,119420,Saul; Lawrence,9999,0,9999,0
1668100418802,CSE 293,031,119421,Savage; Stefan,9999,0,9999,0
1668100418802,CSE 293,032,119425,Schulze; Jurgen P.,9999,0,9999,0
1668100418802,CSE 293,033,119426,Snoeren; Alex C.,9999,0,9999,0
1668100418802,CSE 293,034,119428,Shang; Jingbo,9999,0,9999,0
1668100418802,CSE 293,035,119430,Stefan; Deian,9999,0,9999,0
1668100418802,CSE 293,036,119431,Su; Hao,9999,0,9999,0
1668100418802,CSE 293,037,119433,Swanson; Steven James,9999,0,9999,0
1668100418802,CSE 293,038,119435,Tullsen; Dean Michael,9999,0,9999,0
1668100418802,CSE 293,039,119483,Voelker; Geoffrey M.,9999,0,9999,0
1668100418802,CSE 293,040,119537,Zhao; Jishen,9999,0,9999,0
1668100418802,CSE 293,041,119538,Zhou; Yuan-Yuan,9999,0,9999,0
1668100418802,CSE 293,042,119539,Gao; Sicun,9999,0,9999,0
1668100418802,CSE 293,043,119540,Weibel; Nadir,9999,0,9999,0
1668100418802,CSE 293,044,119541,Gupta; Rajesh K.,9999,0,9999,0
1668100418802,CSE 293,045,126410,Vaccaro; Kristen Marie,9999,0,9999,0
1668100418802,CSE 293,046,126411,Klemke; Richard,9999,0,9999,0
1668100419225,CSE 294,A00,102459,Voelker; Geoffrey M.,0,0,0,0
1668100419225,CSE 294,B00,111322,Orailoglu; Alex,0,0,0,0
1668100419658,DSE 201,A00,096914,Deutsch; Alin Bernard,30,0,30,0
1668100420084,DSE 210,A00,096915,Dasgupta; Sanjoy,30,0,30,0
1668100420517,DSE 260A,A00,096916,Altintas De Callaf; Ilkay,30,0,30,0
1668100421059,ECE 200,001,103586,Antipa; Nicholas A,9999,0,9999,0
1668100421059,ECE 200,002,103587,Atanasov; Nikolay A.,9999,0,9999,0
1668100421059,ECE 200,003,103588,Bharadia; Dinesh,9999,0,9999,0
1668100421059,ECE 200,004,103589,Cheng; Chung Kuan,9999,0,9999,0
1668100421059,ECE 200,005,103590,Cosman; Pamela C.,9999,0,9999,0
1668100421059,ECE 200,006,103591,Dayeh; Shadi Ahmad,9999,0,9999,0
1668100421059,ECE 200,007,103592,Fainman; Yeshaiahu,9999,0,9999,0
1668100421059,ECE 200,008,103593,Ford; Joseph Earl,9999,0,9999,0
1668100421059,ECE 200,009,103594,Franceschetti; Massimo,9999,0,9999,0
1668100421059,ECE 200,010,103595,Fullerton; Eric E,9999,0,9999,0
1668100421059,ECE 200,011,103596,Galton; Ian A,9999,0,9999,0
1668100421059,ECE 200,012,103597,Gilja; Vikash,9999,0,9999,0
1668100421059,ECE 200,013,103598,Hall; Drew A.,9999,0,9999,0
1668100421059,ECE 200,014,103599,Hsueh; Tzu-Chien,9999,0,9999,0
1668100421059,ECE 200,015,103600,Javidi; Tara,9999,0,9999,0
1668100421059,ECE 200,016,103601,Kahng; Andrew Byun,9999,0,9999,0
1668100421059,ECE 200,017,103602,Kim; Young-Han,9999,0,9999,0
1668100421059,ECE 200,018,103603,Koushanfar; Farinaz,9999,0,9999,0
1668100421059,ECE 200,019,103604,Kuzum; Duygu,9999,0,9999,0
1668100421059,ECE 200,020,103605,Le; Hanh-Phuc,9999,0,9999,0
1668100421059,ECE 200,021,103606,Lin; Bill,9999,0,9999,0
1668100421059,ECE 200,022,103607,Liu; Zhaowei,9998,0,9999,1
1668100421059,ECE 200,023,103608,Lo; Yu-Hwa,9999,0,9999,0
1668100421059,ECE 200,024,103609,Lomakin; Vitaliy,9999,0,9999,0
1668100421059,ECE 200,025,103610,Mercier; Patrick Philip,9999,0,9999,0
1668100421059,ECE 200,026,103611,Meyer; Florian,9999,0,9999,0
1668100421059,ECE 200,027,103612,Milstein; Laurence B.,9999,0,9999,0
1668100421059,ECE 200,028,103613,Mir Arabbaygi; Siavash,9999,0,9999,0
1668100421059,ECE 200,029,103614,Mookherjea; Shayan,9999,0,9999,0
1668100421059,ECE 200,030,103615,Morris; Karcher William,9999,0,9999,0
1668100421059,ECE 200,031,103616,Ng; Tse Nga,9999,0,9999,0
1668100421059,ECE 200,032,103617,Nguyen; Truong Quang,9999,0,9999,0
1668100421059,ECE 200,033,103618,Nomura; Kenji,9999,0,9999,0
1668100421059,ECE 200,034,103619,Orlitsky; Alon,9999,0,9999,0
1668100421059,ECE 200,035,103620,Pal; Piya,9999,0,9999,0
1668100421059,ECE 200,036,103621,Papen; George C.,9999,0,9999,0
1668100421059,ECE 200,037,103622,Radic; Stojan,9999,0,9999,0
1668100421059,ECE 200,038,103623,Rao; Bhaskar D.,9999,0,9999,0
1668100421059,ECE 200,039,103624,Rao; Ramesh R,9999,0,9999,0
1668100421059,ECE 200,040,103625,Rebeiz; Gabriel,9999,0,9999,0
1668100421059,ECE 200,041,103626,Sanford; John R,9999,0,9999,0
1668100421059,ECE 200,042,103627,Siegel; Paul H.,9999,0,9999,0
1668100421059,ECE 200,043,103628,Sievenpiper; Daniel F.,9999,0,9999,0
1668100421059,ECE 200,044,103629,Sworder; David D.,9999,0,9999,0
1668100421059,ECE 200,045,103630,Taur; Yuan,9999,0,9999,0
1668100421059,ECE 200,046,103631,Touri; Behrouz,9999,0,9999,0
1668100421059,ECE 200,047,103632,Trivedi; Mohan M.,9999,0,9999,0
1668100421059,ECE 200,048,103633,Vasconcelos; Nuno,9999,0,9999,0
1668100421059,ECE 200,049,103634,Wang; Xiaolong,9999,0,9999,0
1668100421059,ECE 200,050,103635,Xie; Pengtao,9999,0,9999,0
1668100421059,ECE 200,051,103636,Yip; Michael,9999,0,9999,0
1668100421059,ECE 200,052,103637,Zeger; Kenneth A.,999,0,999,0
1668100421059,ECE 200,053,103638,Zhang; Xinyu,9999,0,9999,0
1668100421059,ECE 200,054,103639,Turakhia; Yatish Girish,9999,0,9999,0
1668100421059,ECE 200,055,103640,Kang; Mingu,9999,0,9999,0
1668100421059,ECE 200,056,103641,Shi; Yuanyuan,9999,0,9999,0
1668100421059,ECE 200,057,103642,Wang; Edward Jay,9999,0,9999,0
1668100421059,ECE 200,058,103643,Zheng; Yang,9999,0,9999,0
1668100421484,ECE 202,A00,103644,Kuzum; Duygu,0,0,0,0
1668100421907,ECE 212BN,A00,103646,Ng; Tse Nga,0,0,0,0
1668100422337,ECE 221,A00,111493,Staff,0,0,0,0
1668100422776,ECE 222B,A00,103647,Lomakin; Vitaliy,0,0,0,0
1668100423212,ECE 230B,A00,103648,Taur; Yuan,0,0,0,0
1668100423640,ECE 238B,A00,103649,Garay; Javier,0,0,0,0
1668100424063,ECE 240B,A00,112900,Fainman; Yeshaiahu,0,0,0,0
1668100424488,ECE 247A,A00,103650,Jokerst; Jesse Vincent,0,0,0,0
1668100424912,ECE 247B,A00,103651,Wang; Joseph,0,0,0,0
1668100425338,ECE 250,A00,103652,Siegel; Paul H.,0,0,0,0
1668100425761,ECE 251A,A00,103654,Rao; Bhaskar D.,0,0,0,0
1668100426184,ECE 257B,A00,103655,Bharadia; Dinesh,0,0,0,0
1668100426613,ECE 258A,A00,103656,Milstein; Laurence B.,0,0,0,0
1668100427035,ECE 260B,A00,103658,Kang; Mingu,0,0,0,0
1668100427466,ECE 264A,A00,103659,Galton; Ian A,0,0,0,0
1668100427889,ECE 265A,A00,103661,Gudem; Prasad S.S.,0,0,0,0
1668100428320,ECE 265D,A00,103662,Gudem; Prasad S.S.,0,0,0,0
1668100428759,ECE 268,A00,103663,Koushanfar; Farinaz,0,0,0,0
1668100429183,ECE 269,A01,103665,Pal; Piya,0,0,0,0
1668100429605,ECE 271B,A00,103666,Vasconcelos; Manuela,0,0,0,0
1668100430029,ECE 276A,A00,103667,Atanasov; Nikolay A.,0,0,0,0
1668100430452,ECE 277,A00,103668,An; Cheolhong,0,0,0,0
1668100430877,ECE 279,A00,117947,Hall; Drew A.,0,0,0,0
1668100431744,ECE 283,A00,103670,Hsueh; Tzu-Chien,0,0,0,0
1668100432181,ECE 284,A00,103671,Turakhia; Yatish Girish,0,0,0,0
1668100432603,ECE 285,A00,103672,Zheng; Yang,0,0,0,0
1668100432603,ECE 285,B00,103673,Sworder; David D.,0,0,0,0
1668100433029,ECE 287,A00,103676,Javidi; Tara,0,0,0,0
1668100433462,MATH 200B,A00,098023,Salehi Golsefidy; Alireza,13,0,15,2
1668100433897,MATH 202B,A00,098024,Rhoades; Brendon Patrick,9,0,15,6
1668100434323,MATH 203B,A00,098025,Oprea; Dragos N.,10,0,15,5
1668100434746,MATH 204B,A00,098026,Sorensen; Claus M,13,0,15,2
1668100435182,MATH 208,A00,098027,Izadi; Elham,7,0,10,3
1668100435607,MATH 209,A00,098028,Pollack; Aaron,10,0,10,0
1668100436032,MATH 211A,A00,112919,Rogalski; Daniel,9,0,10,1
1668100436457,MATH 211B,A00,112920,Seward; Brandon M.,9,0,10,1
1668100436884,MATH 218,A00,098029,Li; Bo,10,0,10,0
1668100437312,MATH 220B,A00,098030,Novak; Jonathan I,12,0,15,3
1668100437737,MATH 221A,A00,098031,Ebenfelt; Peter F,13,0,15,2
1668100438167,MATH 231B,A00,098032,Zlatos; Andrej,12,0,15,3
1668100438595,MATH 240B,A00,098033,Ni; Lei,9,0,15,6
1668100439017,MATH 243,A00,098034,Jekel; David Andrew,10,0,10,0
1668100439441,MATH 245A,A00,098035,Nie; Jiawang,0,0,15,16
1668100439868,MATH 248,A00,098036,Bejenaru; Ioan,10,0,10,0
1668100440305,MATH 250B,A00,098037,Spolaor; Luca,14,0,15,1
1668100440728,MATH 258,A00,098038,Ni; Lei,10,0,10,0
1668100441157,MATH 264B,A00,098041,Rhoades; Brendon Patrick,10,0,15,5
1668100441596,MATH 268,A00,098042,Buss; Samuel R,10,0,10,0
1668100442046,MATH 269,A00,098043,Rhoades; Brendon Patrick,10,0,10,0
1668100442467,MATH 270B,A00,098044,Li; Bo,11,0,15,4
1668100442896,MATH 272B,A00,098045,Holst; Michael J,13,0,15,2
1668100443319,MATH 273A,A00,098046,Tian; Xiaochuan,10,0,15,5
1668100443740,MATH 275,A01,098048,Tian; Xiaochuan,6,0,10,4
1668100444163,MATH 278A,A00,098049,Holst; Michael J,8,0,10,2
1668100444590,MATH 278B,A00,098050,Cloninger; Alexander,10,0,10,0
1668100445023,MATH 278C,A00,098051,Nie; Jiawang,7,0,10,3
1668100445445,MATH 280B,A00,098052,Zheng; Tianyi,10,0,15,5
1668100445871,MATH 281B,A00,098053,Bradic; Jelena,2,0,15,13
1668100446298,MATH 282B,A00,098054,Arias-Castro; Ery,0,0,15,15
1668100446728,MATH 285,A00,098055,Fitzsimmons; Patrick J,0,0,15,17
1668100447155,MATH 287B,A00,098056,Arias-Castro; Ery,3,0,15,12
1668100447579,MATH 288,A00,098057,Agarwal; Pooja,9,0,10,1
1668100447579,MATH 288,B00,098058,Zhang; Danna,8,0,10,2
1668100447579,MATH 288,C00,098059,Williams; Ruth J,10,0,10,0
1668100448005,MATH 290B,A00,098060,Roberts; Justin Deritter,13,0,15,2
1668100448429,MATH 292,A00,098061,Belmont; Eva Kinoshita,10,0,10,0
1668100448855,MATH 295,A00,098062,Suk; Andrew Hoon,48,0,50,2
1668100449279,MATH 296,A00,098063,Novak; Jonathan I,20,0,20,0
1668100449701,MATH 297,001,098064,Gamst; Anthony Collins,9997,0,9999,2
1668100952013,COGS 205,A00,101395,Chiba; Andrea,19,0,20,1
1668100952436,COGS 210B,001,101404,Greene; Deanna Jacquelyn,9998,0,9999,1
1668100952436,COGS 210B,002,101417,Xia; Haijun,9999,0,9999,0
1668100952436,COGS 210B,003,101422,Nitz; Douglas A.,9999,0,9999,0
1668100952436,COGS 210B,004,101423,Hollan; James D.,9998,0,9999,1
1668100952436,COGS 210B,005,101424,Deak; Gedeon O.,9998,0,9999,1
1668100952436,COGS 210B,006,101425,Rossano; Federico,9999,0,9999,0
1668100952871,COGS 211B,A00,101427,Coulson; Seana M,9996,0,9999,3
1668100953319,COGS 220,A00,101428,Hollan; James D.,0,0,25,25
1668100953742,COGS 229,A00,101429,Dow; Steven P,18,0,25,7
1668100954170,COGS 230,A00,101430,Klemmer; Scott R,13,0,17,4
1668100954592,COGS 234,A00,101431,Xia; Haijun,3,0,25,22
1668100955015,COGS 260,A00,101432,Kiyonaga; Anastasia,19,0,25,6
1668100955015,COGS 260,B00,101433,Kirsh; David Joel,16,0,25,9
1668100955443,CSE 202,A00,102371,Impagliazzo; Russell,0,0,0,0
1668100955869,CSE 203B,A01,102373,Cheng; Chung Kuan,0,0,0,0
1668100956293,CSE 208,A00,102374,Micciancio; Daniele,0,0,0,0
1668100956731,CSE 209A,A00,112895,Impagliazzo; Russell,0,0,15,15
1668100957156,CSE 209B,A00,108005,Bellare; Mihir,0,0,0,0
1668100957588,CSE 210,A00,113163,Coblenz; Michael J,0,0,0,0
1668100958010,CSE 219,A00,106111,Dow; Steven P,0,0,20,20
1668100958434,CSE 221,A00,102376,Voelker; Geoffrey M.,0,0,0,0
1668100958871,CSE 224,A01,102378,Porter; George M,0,0,0,0
1668100959296,CSE 229A,A00,102379,Savage; Stefan,0,0,0,0
1668100959737,CSE 229C,A00,102380,Munyaka; Imani N. S.,0,0,0,0
1668100960166,CSE 232B,A00,102382,Deutsch; Alin Bernard,0,0,0,0
1668100960604,CSE 234,A01,112904,Kumar; Arun Kumar,0,0,0,0
1668100961034,CSE 237A,A00,102383,Rosing; Tajana Simunic,0,0,0,0
1668100961460,CSE 239A,A00,102384,Deutsch; Alin Bernard,0,0,0,0
1668100961885,CSE 239B,A00,102385,Polikarpova; Nadezhda,0,0,0,0
1668100962313,CSE 240A,A00,102386,Pannuto; Patrick William,0,0,0,0
1668100962737,CSE 240B,A00,102387,Zhao; Jishen,0,0,0,0
1668100963172,CSE 241A,A00,106406,Kang; Mingu,0,0,0,0
1668100963597,CSE 249B,A00,102388,Kahng; Andrew Byun,0,0,8,8
1668100964023,CSE 251B,A01,102392,Cottrell; Garrison W,0,0,0,0
1668100964023,CSE 251B,A02,102393,Cottrell; Garrison W,0,0,0,0
1668100964448,CSE 252B,A00,102394,Ochoa; Benjamin Lawrence,0,0,0,0
1668100964872,CSE 257,A01,102396,Gao; Sicun,0,0,0,0
1668100965297,CSE 272,A00,102397,Li; Tzumao,0,0,0,0
1668100965722,CSE 274,A00,111323,Chern; Albert Ren-Haur,0,0,0,0
1668100966195,CSE 282,A00,102398,Pevzner; Pavel Arkadjevich,0,0,0,0
1668100966626,CSE 284,A00,114175,Gymrek; Melissa Ann,0,0,0,0
1668100967059,CSE 290,A00,102399,Chandraker; Manmohan Krishna,0,0,0,0
1668100967059,CSE 290,B00,102400,Vaccaro; Kristen Marie,0,0,25,25
1668100967059,CSE 290,C00,102414,Pannuto; Patrick William,0,0,25,25
1668100967059,CSE 290,D00,102427,Pevzner; Pavel Arkadjevich,0,0,0,0
1668100967059,CSE 290,E00,102429,Zhao; Jishen,0,0,0,0
1668100967059,CSE 290,F00,102436,Tullsen; Dean Michael,0,0,0,0
1668100967059,CSE 290,G00,102440,Christensen; Henrik I,0,0,20,20
1668100967484,CSE 291,A00,102443,Su; Hao,0,0,0,0
1668100967484,CSE 291,B00,102448,Polikarpova; Nadezhda,0,0,0,0
1668100967484,CSE 291,C00,102453,Vaccaro; Kristen Marie,0,0,0,0
1668100967484,CSE 291,D00,111343,Savage; Stefan,0,0,0,0
1668100967484,CSE 291,E00,116474,Claffy; Kimberly Claire,0,0,0,0
1668100967484,CSE 291,F00,116479,Pasquale; Joseph,0,0,0,0
1668100967921,CSE 293,001,119111,Bafna; Vineet,9999,0,9999,0
1668100967921,CSE 293,002,119118,Bellare; Mihir,9999,0,9999,0
1668100967921,CSE 293,003,119122,Berg-Kirkpatrick; Taylor D,9999,0,9999,0
1668100967921,CSE 293,004,119135,Christensen; Henrik I,9999,0,9999,0
1668100967921,CSE 293,005,119142,Cottrell; Garrison W,9999,0,9999,0
1668100967921,CSE 293,006,119146,Deutsch; Alin Bernard,9999,0,9999,0
1668100967921,CSE 293,007,119159,Esmaeilzadeh; Hadi,9999,0,9999,0
1668100967921,CSE 293,008,119166,Freund; Yoav,9999,0,9999,0
1668100967921,CSE 293,009,119170,Griswold; William G.,9999,0,9999,0
1668100967921,CSE 293,010,119183,Gymrek; Melissa Ann,9999,0,9999,0
1668100967921,CSE 293,011,119190,Heninger; Nadia A,9999,0,9999,0
1668100967921,CSE 293,012,119230,Impagliazzo; Russell,9999,0,9999,0
1668100967921,CSE 293,013,119232,Jhala; Ranjit,9999,0,9999,0
1668100967921,CSE 293,014,119233,Kahng; Andrew Byun,9999,0,9999,0
1668100967921,CSE 293,015,119298,Kane; Daniel Mertz,9999,0,9999,0
1668100967921,CSE 293,016,119299,Kriegman; David J,9999,0,9999,0
1668100967921,CSE 293,017,119300,Kumar; Arun Kumar,9999,0,9999,0
1668100967921,CSE 293,018,119301,Lerner; Sorin,9999,0,9999,0
1668100967921,CSE 293,019,119302,Lovett; Shachar,9999,0,9999,0
1668100967921,CSE 293,020,119303,McAuley; Julian John,9999,0,9999,0
1668100967921,CSE 293,021,119304,Micciancio; Daniele,9999,0,9999,0
1668100967921,CSE 293,022,119367,Orailoglu; Alex,9999,0,9999,0
1668100967921,CSE 293,023,119382,Paturi; Ramamohan,9999,0,9999,0
1668100967921,CSE 293,024,119404,Polikarpova; Nadezhda,9999,0,9999,0
1668100967921,CSE 293,025,119406,Politz; Joseph Gibbs,9999,0,9999,0
1668100967921,CSE 293,026,119411,Porter; George M,9999,0,9999,0
1668100967921,CSE 293,027,119414,Porter; Leonard Emerson,9999,0,9999,0
1668100967921,CSE 293,028,119416,Ramamoorthi; Ravi,9999,0,9999,0
1668100967921,CSE 293,029,119417,Sahoo; Debashis,9999,0,9999,0
1668100967921,CSE 293,030,119420,Saul; Lawrence,9999,0,9999,0
1668100967921,CSE 293,031,119421,Savage; Stefan,9999,0,9999,0
1668100967921,CSE 293,032,119425,Schulze; Jurgen P.,9999,0,9999,0
1668100967921,CSE 293,033,119426,Snoeren; Alex C.,9999,0,9999,0
1668100967921,CSE 293,034,119428,Shang; Jingbo,9999,0,9999,0
1668100967921,CSE 293,035,119430,Stefan; Deian,9999,0,9999,0
1668100967921,CSE 293,036,119431,Su; Hao,9999,0,9999,0
1668100967921,CSE 293,037,119433,Swanson; Steven James,9999,0,9999,0
1668100967921,CSE 293,038,119435,Tullsen; Dean Michael,9999,0,9999,0
1668100967921,CSE 293,039,119483,Voelker; Geoffrey M.,9999,0,9999,0
1668100967921,CSE 293,040,119537,Zhao; Jishen,9999,0,9999,0
1668100967921,CSE 293,041,119538,Zhou; Yuan-Yuan,9999,0,9999,0
1668100967921,CSE 293,042,119539,Gao; Sicun,9999,0,9999,0
1668100967921,CSE 293,043,119540,Weibel; Nadir,9999,0,9999,0
1668100967921,CSE 293,044,119541,Gupta; Rajesh K.,9999,0,9999,0
1668100967921,CSE 293,045,126410,Vaccaro; Kristen Marie,9999,0,9999,0
1668100967921,CSE 293,046,126411,Klemke; Richard,9999,0,9999,0
1668100968358,CSE 294,A00,102459,Voelker; Geoffrey M.,0,0,0,0
1668100968358,CSE 294,B00,111322,Orailoglu; Alex,0,0,0,0
1668100968783,DSE 201,A00,096914,Deutsch; Alin Bernard,30,0,30,0
1668100969211,DSE 210,A00,096915,Dasgupta; Sanjoy,30,0,30,0
1668100969637,DSE 260A,A00,096916,Altintas De Callaf; Ilkay,30,0,30,0
1668100970079,ECE 200,001,103586,Antipa; Nicholas A,9999,0,9999,0
1668100970079,ECE 200,002,103587,Atanasov; Nikolay A.,9999,0,9999,0
1668100970079,ECE 200,003,103588,Bharadia; Dinesh,9999,0,9999,0
1668100970079,ECE 200,004,103589,Cheng; Chung Kuan,9999,0,9999,0
1668100970079,ECE 200,005,103590,Cosman; Pamela C.,9999,0,9999,0
1668100970079,ECE 200,006,103591,Dayeh; Shadi Ahmad,9999,0,9999,0
1668100970079,ECE 200,007,103592,Fainman; Yeshaiahu,9999,0,9999,0
1668100970079,ECE 200,008,103593,Ford; Joseph Earl,9999,0,9999,0
1668100970079,ECE 200,009,103594,Franceschetti; Massimo,9999,0,9999,0
1668100970079,ECE 200,010,103595,Fullerton; Eric E,9999,0,9999,0
1668100970079,ECE 200,011,103596,Galton; Ian A,9999,0,9999,0
1668100970079,ECE 200,012,103597,Gilja; Vikash,9999,0,9999,0
1668100970079,ECE 200,013,103598,Hall; Drew A.,9999,0,9999,0
1668100970079,ECE 200,014,103599,Hsueh; Tzu-Chien,9999,0,9999,0
1668100970079,ECE 200,015,103600,Javidi; Tara,9999,0,9999,0
1668100970079,ECE 200,016,103601,Kahng; Andrew Byun,9999,0,9999,0
1668100970079,ECE 200,017,103602,Kim; Young-Han,9999,0,9999,0
1668100970079,ECE 200,018,103603,Koushanfar; Farinaz,9999,0,9999,0
1668100970079,ECE 200,019,103604,Kuzum; Duygu,9999,0,9999,0
1668100970079,ECE 200,020,103605,Le; Hanh-Phuc,9999,0,9999,0
1668100970079,ECE 200,021,103606,Lin; Bill,9999,0,9999,0
1668100970079,ECE 200,022,103607,Liu; Zhaowei,9998,0,9999,1
1668100970079,ECE 200,023,103608,Lo; Yu-Hwa,9999,0,9999,0
1668100970079,ECE 200,024,103609,Lomakin; Vitaliy,9999,0,9999,0
1668100970079,ECE 200,025,103610,Mercier; Patrick Philip,9999,0,9999,0
1668100970079,ECE 200,026,103611,Meyer; Florian,9999,0,9999,0
1668100970079,ECE 200,027,103612,Milstein; Laurence B.,9999,0,9999,0
1668100970079,ECE 200,028,103613,Mir Arabbaygi; Siavash,9999,0,9999,0
1668100970079,ECE 200,029,103614,Mookherjea; Shayan,9999,0,9999,0
1668100970079,ECE 200,030,103615,Morris; Karcher William,9999,0,9999,0
1668100970079,ECE 200,031,103616,Ng; Tse Nga,9999,0,9999,0
1668100970079,ECE 200,032,103617,Nguyen; Truong Quang,9999,0,9999,0
1668100970079,ECE 200,033,103618,Nomura; Kenji,9999,0,9999,0
1668100970079,ECE 200,034,103619,Orlitsky; Alon,9999,0,9999,0
1668100970079,ECE 200,035,103620,Pal; Piya,9999,0,9999,0
1668100970079,ECE 200,036,103621,Papen; George C.,9999,0,9999,0
1668100970079,ECE 200,037,103622,Radic; Stojan,9999,0,9999,0
1668100970079,ECE 200,038,103623,Rao; Bhaskar D.,9999,0,9999,0
1668100970079,ECE 200,039,103624,Rao; Ramesh R,9999,0,9999,0
1668100970079,ECE 200,040,103625,Rebeiz; Gabriel,9999,0,9999,0
1668100970079,ECE 200,041,103626,Sanford; John R,9999,0,9999,0
1668100970079,ECE 200,042,103627,Siegel; Paul H.,9999,0,9999,0
1668100970079,ECE 200,043,103628,Sievenpiper; Daniel F.,9999,0,9999,0
1668100970079,ECE 200,044,103629,Sworder; David D.,9999,0,9999,0
1668100970079,ECE 200,045,103630,Taur; Yuan,9999,0,9999,0
1668100970079,ECE 200,046,103631,Touri; Behrouz,9999,0,9999,0
1668100970079,ECE 200,047,103632,Trivedi; Mohan M.,9999,0,9999,0
1668100970079,ECE 200,048,103633,Vasconcelos; Nuno,9999,0,9999,0
1668100970079,ECE 200,049,103634,Wang; Xiaolong,9999,0,9999,0
1668100970079,ECE 200,050,103635,Xie; Pengtao,9999,0,9999,0
1668100970079,ECE 200,051,103636,Yip; Michael,9999,0,9999,0
1668100970079,ECE 200,052,103637,Zeger; Kenneth A.,999,0,999,0
1668100970079,ECE 200,053,103638,Zhang; Xinyu,9999,0,9999,0
1668100970079,ECE 200,054,103639,Turakhia; Yatish Girish,9999,0,9999,0
1668100970079,ECE 200,055,103640,Kang; Mingu,9999,0,9999,0
1668100970079,ECE 200,056,103641,Shi; Yuanyuan,9999,0,9999,0
1668100970079,ECE 200,057,103642,Wang; Edward Jay,9999,0,9999,0
1668100970079,ECE 200,058,103643,Zheng; Yang,9999,0,9999,0
1668100970511,ECE 202,A00,103644,Kuzum; Duygu,0,0,0,0
1668100970933,ECE 212BN,A00,103646,Ng; Tse Nga,0,0,0,0
1668100971362,ECE 221,A00,111493,Staff,0,0,0,0
1668100971784,ECE 222B,A00,103647,Lomakin; Vitaliy,0,0,0,0
1668100972207,ECE 230B,A00,103648,Taur; Yuan,0,0,0,0
1668100972636,ECE 238B,A00,103649,Garay; Javier,0,0,0,0
1668100973064,ECE 240B,A00,112900,Fainman; Yeshaiahu,0,0,0,0
1668100973486,ECE 247A,A00,103650,Jokerst; Jesse Vincent,0,0,0,0
1668100973912,ECE 247B,A00,103651,Wang; Joseph,0,0,0,0
1668100974337,ECE 250,A00,103652,Siegel; Paul H.,0,0,0,0
1668100974771,ECE 251A,A00,103654,Rao; Bhaskar D.,0,0,0,0
1668100975195,ECE 257B,A00,103655,Bharadia; Dinesh,0,0,0,0
1668100975621,ECE 258A,A00,103656,Milstein; Laurence B.,0,0,0,0
1668100976047,ECE 260B,A00,103658,Kang; Mingu,0,0,0,0
1668100976475,ECE 264A,A00,103659,Galton; Ian A,0,0,0,0
1668100976908,ECE 265A,A00,103661,Gudem; Prasad S.S.,0,0,0,0
1668100977356,ECE 265D,A00,103662,Gudem; Prasad S.S.,0,0,0,0
1668100977791,ECE 268,A00,103663,Koushanfar; Farinaz,0,0,0,0
1668100978230,ECE 269,A01,103665,Pal; Piya,0,0,0,0
1668100978661,ECE 271B,A00,103666,Vasconcelos; Manuela,0,0,0,0
1668100979094,ECE 276A,A00,103667,Atanasov; Nikolay A.,0,0,0,0
1668100979527,ECE 277,A00,103668,An; Cheolhong,0,0,0,0
1668100979951,ECE 279,A00,117947,Hall; Drew A.,0,0,0,0
1668100980813,ECE 283,A00,103670,Hsueh; Tzu-Chien,0,0,0,0
1668100981236,ECE 284,A00,103671,Turakhia; Yatish Girish,0,0,0,0
1668100981664,ECE 285,A00,103672,Zheng; Yang,0,0,0,0
1668100981664,ECE 285,B00,103673,Sworder; David D.,0,0,0,0
1668100982091,ECE 287,A00,103676,Javidi; Tara,0,0,0,0
1668100982517,MATH 200B,A00,098023,Salehi Golsefidy; Alireza,13,0,15,2
1668100982946,MATH 202B,A00,098024,Rhoades; Brendon Patrick,9,0,15,6
1668100983373,MATH 203B,A00,098025,Oprea; Dragos N.,10,0,15,5
1668100983799,MATH 204B,A00,098026,Sorensen; Claus M,13,0,15,2
1668100984244,MATH 208,A00,098027,Izadi; Elham,7,0,10,3
1668100984669,MATH 209,A00,098028,Pollack; Aaron,10,0,10,0
1668100985101,MATH 211A,A00,112919,Rogalski; Daniel,9,0,10,1
1668100985535,MATH 211B,A00,112920,Seward; Brandon M.,9,0,10,1
1668100985964,MATH 218,A00,098029,Li; Bo,10,0,10,0
1668100986391,MATH 220B,A00,098030,Novak; Jonathan I,12,0,15,3
1668100986891,MATH 221A,A00,098031,Ebenfelt; Peter F,13,0,15,2
1668100987319,MATH 231B,A00,098032,Zlatos; Andrej,12,0,15,3
1668100987743,MATH 240B,A00,098033,Ni; Lei,9,0,15,6
1668100988168,MATH 243,A00,098034,Jekel; David Andrew,10,0,10,0
1668100988606,MATH 245A,A00,098035,Nie; Jiawang,0,0,15,16
1668100989031,MATH 248,A00,098036,Bejenaru; Ioan,10,0,10,0
1668100989455,MATH 250B,A00,098037,Spolaor; Luca,14,0,15,1
1668100989879,MATH 258,A00,098038,Ni; Lei,10,0,10,0
1668100990303,MATH 264B,A00,098041,Rhoades; Brendon Patrick,10,0,15,5
1668100990730,MATH 268,A00,098042,Buss; Samuel R,10,0,10,0
1668100991153,MATH 269,A00,098043,Rhoades; Brendon Patrick,10,0,10,0
1668100991581,MATH 270B,A00,098044,Li; Bo,11,0,15,4
1668100992007,MATH 272B,A00,098045,Holst; Michael J,13,0,15,2
1668100992430,MATH 273A,A00,098046,Tian; Xiaochuan,10,0,15,5
1668100992855,MATH 275,A01,098048,Tian; Xiaochuan,6,0,10,4
1668100993281,MATH 278A,A00,098049,Holst; Michael J,8,0,10,2
1668100993704,MATH 278B,A00,098050,Cloninger; Alexander,10,0,10,0
1668100994127,MATH 278C,A00,098051,Nie; Jiawang,7,0,10,3
1668100994549,MATH 280B,A00,098052,Zheng; Tianyi,10,0,15,5
1668100994978,MATH 281B,A00,098053,Bradic; Jelena,2,0,15,13
1668100995400,MATH 282B,A00,098054,Arias-Castro; Ery,0,0,15,15
1668100995833,MATH 285,A00,098055,Fitzsimmons; Patrick J,0,0,15,17
1668100996268,MATH 287B,A00,098056,Arias-Castro; Ery,3,0,15,12
1668100996697,MATH 288,A00,098057,Agarwal; Pooja,9,0,10,1
1668100996697,MATH 288,B00,098058,Zhang; Danna,8,0,10,2
1668100996697,MATH 288,C00,098059,Williams; Ruth J,10,0,10,0
1668100997122,MATH 290B,A00,098060,Roberts; Justin Deritter,13,0,15,2
1668100997549,MATH 292,A00,098061,Belmont; Eva Kinoshita,10,0,10,0
1668100997973,MATH 295,A00,098062,Suk; Andrew Hoon,48,0,50,2
1668100998412,MATH 296,A00,098063,Novak; Jonathan I,20,0,20,0
1668100998851,MATH 297,001,098064,Gamst; Anthony Collins,9997,0,9999,2
1668101502617,COGS 205,A00,101395,Chiba; Andrea,19,0,20,1
1668101503039,COGS 210B,001,101404,Greene; Deanna Jacquelyn,9998,0,9999,1
1668101503039,COGS 210B,002,101417,Xia; Haijun,9999,0,9999,0
1668101503039,COGS 210B,003,101422,Nitz; Douglas A.,9999,0,9999,0
1668101503039,COGS 210B,004,101423,Hollan; James D.,9998,0,9999,1
1668101503039,COGS 210B,005,101424,Deak; Gedeon O.,9998,0,9999,1
1668101503039,COGS 210B,006,101425,Rossano; Federico,9999,0,9999,0
1668101503465,COGS 211B,A00,101427,Coulson; Seana M,9996,0,9999,3
1668101503890,COGS 220,A00,101428,Hollan; James D.,0,0,25,25
1668101504314,COGS 229,A00,101429,Dow; Steven P,18,0,25,7
1668101504739,COGS 230,A00,101430,Klemmer; Scott R,13,0,17,4
1668101505176,COGS 234,A00,101431,Xia; Haijun,3,0,25,22
1668101505605,COGS 260,A00,101432,Kiyonaga; Anastasia,19,0,25,6
1668101505605,COGS 260,B00,101433,Kirsh; David Joel,16,0,25,9
1668101506045,CSE 202,A00,102371,Impagliazzo; Russell,0,0,0,0
1668101506473,CSE 203B,A01,102373,Cheng; Chung Kuan,0,0,0,0
1668101506900,CSE 208,A00,102374,Micciancio; Daniele,0,0,0,0
1668101507328,CSE 209A,A00,112895,Impagliazzo; Russell,0,0,15,15
1668101507756,CSE 209B,A00,108005,Bellare; Mihir,0,0,0,0
1668101508183,CSE 210,A00,113163,Coblenz; Michael J,0,0,0,0
1668101508610,CSE 219,A00,106111,Dow; Steven P,0,0,20,20
1668101509041,CSE 221,A00,102376,Voelker; Geoffrey M.,0,0,0,0
1668101509475,CSE 224,A01,102378,Porter; George M,0,0,0,0
1668101509906,CSE 229A,A00,102379,Savage; Stefan,0,0,0,0
1668101510333,CSE 229C,A00,102380,Munyaka; Imani N. S.,0,0,0,0
1668101510837,CSE 232B,A00,102382,Deutsch; Alin Bernard,0,0,0,0
1668101511267,CSE 234,A01,112904,Kumar; Arun Kumar,0,0,0,0
1668101511692,CSE 237A,A00,102383,Rosing; Tajana Simunic,0,0,0,0
1668101512129,CSE 239A,A00,102384,Deutsch; Alin Bernard,0,0,0,0
1668101512571,CSE 239B,A00,102385,Polikarpova; Nadezhda,0,0,0,0
1668101512999,CSE 240A,A00,102386,Pannuto; Patrick William,0,0,0,0
1668101513424,CSE 240B,A00,102387,Zhao; Jishen,0,0,0,0
1668101513865,CSE 241A,A00,106406,Kang; Mingu,0,0,0,0
1668101514294,CSE 249B,A00,102388,Kahng; Andrew Byun,0,0,8,8
1668101514720,CSE 251B,A01,102392,Cottrell; Garrison W,0,0,0,0
1668101514720,CSE 251B,A02,102393,Cottrell; Garrison W,0,0,0,0
1668101515144,CSE 252B,A00,102394,Ochoa; Benjamin Lawrence,0,0,0,0
1668101515567,CSE 257,A01,102396,Gao; Sicun,0,0,0,0
1668101515989,CSE 272,A00,102397,Li; Tzumao,0,0,0,0
1668101516418,CSE 274,A00,111323,Chern; Albert Ren-Haur,0,0,0,0
1668101516850,CSE 282,A00,102398,Pevzner; Pavel Arkadjevich,0,0,0,0
1668101517287,CSE 284,A00,114175,Gymrek; Melissa Ann,0,0,0,0
1668101517721,CSE 290,A00,102399,Chandraker; Manmohan Krishna,0,0,0,0
1668101517721,CSE 290,B00,102400,Vaccaro; Kristen Marie,0,0,25,25
1668101517721,CSE 290,C00,102414,Pannuto; Patrick William,0,0,25,25
1668101517721,CSE 290,D00,102427,Pevzner; Pavel Arkadjevich,0,0,0,0
1668101517721,CSE 290,E00,102429,Zhao; Jishen,0,0,0,0
1668101517721,CSE 290,F00,102436,Tullsen; Dean Michael,0,0,0,0
1668101517721,CSE 290,G00,102440,Christensen; Henrik I,0,0,20,20
1668101518145,CSE 291,A00,102443,Su; Hao,0,0,0,0
1668101518145,CSE 291,B00,102448,Polikarpova; Nadezhda,0,0,0,0
1668101518145,CSE 291,C00,102453,Vaccaro; Kristen Marie,0,0,0,0
1668101518145,CSE 291,D00,111343,Savage; Stefan,0,0,0,0
1668101518145,CSE 291,E00,116474,Claffy; Kimberly Claire,0,0,0,0
1668101518145,CSE 291,F00,116479,Pasquale; Joseph,0,0,0,0
1668101518573,CSE 293,001,119111,Bafna; Vineet,9999,0,9999,0
1668101518573,CSE 293,002,119118,Bellare; Mihir,9999,0,9999,0
1668101518573,CSE 293,003,119122,Berg-Kirkpatrick; Taylor D,9999,0,9999,0
1668101518573,CSE 293,004,119135,Christensen; Henrik I,9999,0,9999,0
1668101518573,CSE 293,005,119142,Cottrell; Garrison W,9999,0,9999,0
1668101518573,CSE 293,006,119146,Deutsch; Alin Bernard,9999,0,9999,0
1668101518573,CSE 293,007,119159,Esmaeilzadeh; Hadi,9999,0,9999,0
1668101518573,CSE 293,008,119166,Freund; Yoav,9999,0,9999,0
1668101518573,CSE 293,009,119170,Griswold; William G.,9999,0,9999,0
1668101518573,CSE 293,010,119183,Gymrek; Melissa Ann,9999,0,9999,0
1668101518573,CSE 293,011,119190,Heninger; Nadia A,9999,0,9999,0
1668101518573,CSE 293,012,119230,Impagliazzo; Russell,9999,0,9999,0
1668101518573,CSE 293,013,119232,Jhala; Ranjit,9999,0,9999,0
1668101518573,CSE 293,014,119233,Kahng; Andrew Byun,9999,0,9999,0
1668101518573,CSE 293,015,119298,Kane; Daniel Mertz,9999,0,9999,0
1668101518573,CSE 293,016,119299,Kriegman; David J,9999,0,9999,0
1668101518573,CSE 293,017,119300,Kumar; Arun Kumar,9999,0,9999,0
1668101518573,CSE 293,018,119301,Lerner; Sorin,9999,0,9999,0
1668101518573,CSE 293,019,119302,Lovett; Shachar,9999,0,9999,0
1668101518573,CSE 293,020,119303,McAuley; Julian John,9999,0,9999,0
1668101518573,CSE 293,021,119304,Micciancio; Daniele,9999,0,9999,0
1668101518573,CSE 293,022,119367,Orailoglu; Alex,9999,0,9999,0
1668101518573,CSE 293,023,119382,Paturi; Ramamohan,9999,0,9999,0
1668101518573,CSE 293,024,119404,Polikarpova; Nadezhda,9999,0,9999,0
1668101518573,CSE 293,025,119406,Politz; Joseph Gibbs,9999,0,9999,0
1668101518573,CSE 293,026,119411,Porter; George M,9999,0,9999,0
1668101518573,CSE 293,027,119414,Porter; Leonard Emerson,9999,0,9999,0
1668101518573,CSE 293,028,119416,Ramamoorthi; Ravi,9999,0,9999,0
1668101518573,CSE 293,029,119417,Sahoo; Debashis,9999,0,9999,0
1668101518573,CSE 293,030,119420,Saul; Lawrence,9999,0,9999,0
1668101518573,CSE 293,031,119421,Savage; Stefan,9999,0,9999,0
1668101518573,CSE 293,032,119425,Schulze; Jurgen P.,9999,0,9999,0
1668101518573,CSE 293,033,119426,Snoeren; Alex C.,9999,0,9999,0
1668101518573,CSE 293,034,119428,Shang; Jingbo,9999,0,9999,0
1668101518573,CSE 293,035,119430,Stefan; Deian,9999,0,9999,0
1668101518573,CSE 293,036,119431,Su; Hao,9999,0,9999,0
1668101518573,CSE 293,037,119433,Swanson; Steven James,9999,0,9999,0
1668101518573,CSE 293,038,119435,Tullsen; Dean Michael,9999,0,9999,0
1668101518573,CSE 293,039,119483,Voelker; Geoffrey M.,9999,0,9999,0
1668101518573,CSE 293,040,119537,Zhao; Jishen,9999,0,9999,0
1668101518573,CSE 293,041,119538,Zhou; Yuan-Yuan,9999,0,9999,0
1668101518573,CSE 293,042,119539,Gao; Sicun,9999,0,9999,0
1668101518573,CSE 293,043,119540,Weibel; Nadir,9999,0,9999,0
1668101518573,CSE 293,044,119541,Gupta; Rajesh K.,9999,0,9999,0
1668101518573,CSE 293,045,126410,Vaccaro; Kristen Marie,9999,0,9999,0
1668101518573,CSE 293,046,126411,Klemke; Richard,9999,0,9999,0
1668101519013,CSE 294,A00,102459,Voelker; Geoffrey M.,0,0,0,0
1668101519013,CSE 294,B00,111322,Orailoglu; Alex,0,0,0,0
1668101519440,DSE 201,A00,096914,Deutsch; Alin Bernard,30,0,30,0
1668101519863,DSE 210,A00,096915,Dasgupta; Sanjoy,30,0,30,0
1668101520297,DSE 260A,A00,096916,Altintas De Callaf; Ilkay,30,0,30,0
1668101520730,ECE 200,001,103586,Antipa; Nicholas A,9999,0,9999,0
1668101520730,ECE 200,002,103587,Atanasov; Nikolay A.,9999,0,9999,0
1668101520730,ECE 200,003,103588,Bharadia; Dinesh,9999,0,9999,0
1668101520730,ECE 200,004,103589,Cheng; Chung Kuan,9999,0,9999,0
1668101520730,ECE 200,005,103590,Cosman; Pamela C.,9999,0,9999,0
1668101520730,ECE 200,006,103591,Dayeh; Shadi Ahmad,9999,0,9999,0
1668101520730,ECE 200,007,103592,Fainman; Yeshaiahu,9999,0,9999,0
1668101520730,ECE 200,008,103593,Ford; Joseph Earl,9999,0,9999,0
1668101520730,ECE 200,009,103594,Franceschetti; Massimo,9999,0,9999,0
1668101520730,ECE 200,010,103595,Fullerton; Eric E,9999,0,9999,0
1668101520730,ECE 200,011,103596,Galton; Ian A,9999,0,9999,0
1668101520730,ECE 200,012,103597,Gilja; Vikash,9999,0,9999,0
1668101520730,ECE 200,013,103598,Hall; Drew A.,9999,0,9999,0
1668101520730,ECE 200,014,103599,Hsueh; Tzu-Chien,9999,0,9999,0
1668101520730,ECE 200,015,103600,Javidi; Tara,9999,0,9999,0
1668101520730,ECE 200,016,103601,Kahng; Andrew Byun,9999,0,9999,0
1668101520730,ECE 200,017,103602,Kim; Young-Han,9999,0,9999,0
1668101520730,ECE 200,018,103603,Koushanfar; Farinaz,9999,0,9999,0
1668101520730,ECE 200,019,103604,Kuzum; Duygu,9999,0,9999,0
1668101520730,ECE 200,020,103605,Le; Hanh-Phuc,9999,0,9999,0
1668101520730,ECE 200,021,103606,Lin; Bill,9999,0,9999,0
1668101520730,ECE 200,022,103607,Liu; Zhaowei,9998,0,9999,1
1668101520730,ECE 200,023,103608,Lo; Yu-Hwa,9999,0,9999,0
1668101520730,ECE 200,024,103609,Lomakin; Vitaliy,9999,0,9999,0
1668101520730,ECE 200,025,103610,Mercier; Patrick Philip,9999,0,9999,0
1668101520730,ECE 200,026,103611,Meyer; Florian,9999,0,9999,0
1668101520730,ECE 200,027,103612,Milstein; Laurence B.,9999,0,9999,0
1668101520730,ECE 200,028,103613,Mir Arabbaygi; Siavash,9999,0,9999,0
1668101520730,ECE 200,029,103614,Mookherjea; Shayan,9999,0,9999,0
1668101520730,ECE 200,030,103615,Morris; Karcher William,9999,0,9999,0
1668101520730,ECE 200,031,103616,Ng; Tse Nga,9999,0,9999,0
1668101520730,ECE 200,032,103617,Nguyen; Truong Quang,9999,0,9999,0
1668101520730,ECE 200,033,103618,Nomura; Kenji,9999,0,9999,0
1668101520730,ECE 200,034,103619,Orlitsky; Alon,9999,0,9999,0
1668101520730,ECE 200,035,103620,Pal; Piya,9999,0,9999,0
1668101520730,ECE 200,036,103621,Papen; George C.,9999,0,9999,0
1668101520730,ECE 200,037,103622,Radic; Stojan,9999,0,9999,0
1668101520730,ECE 200,038,103623,Rao; Bhaskar D.,9999,0,9999,0
1668101520730,ECE 200,039,103624,Rao; Ramesh R,9999,0,9999,0
1668101520730,ECE 200,040,103625,Rebeiz; Gabriel,9999,0,9999,0
1668101520730,ECE 200,041,103626,Sanford; John R,9999,0,9999,0
1668101520730,ECE 200,042,103627,Siegel; Paul H.,9999,0,9999,0
1668101520730,ECE 200,043,103628,Sievenpiper; Daniel F.,9999,0,9999,0
1668101520730,ECE 200,044,103629,Sworder; David D.,9999,0,9999,0
1668101520730,ECE 200,045,103630,Taur; Yuan,9999,0,9999,0
1668101520730,ECE 200,046,103631,Touri; Behrouz,9999,0,9999,0
1668101520730,ECE 200,047,103632,Trivedi; Mohan M.,9999,0,9999,0
1668101520730,ECE 200,048,103633,Vasconcelos; Nuno,9999,0,9999,0
1668101520730,ECE 200,049,103634,Wang; Xiaolong,9999,0,9999,0
1668101520730,ECE 200,050,103635,Xie; Pengtao,9999,0,9999,0
1668101520730,ECE 200,051,103636,Yip; Michael,9999,0,9999,0
1668101520730,ECE 200,052,103637,Zeger; Kenneth A.,999,0,999,0
1668101520730,ECE 200,053,103638,Zhang; Xinyu,9999,0,9999,0
1668101520730,ECE 200,054,103639,Turakhia; Yatish Girish,9999,0,9999,0
1668101520730,ECE 200,055,103640,Kang; Mingu,9999,0,9999,0
1668101520730,ECE 200,056,103641,Shi; Yuanyuan,9999,0,9999,0
1668101520730,ECE 200,057,103642,Wang; Edward Jay,9999,0,9999,0
1668101520730,ECE 200,058,103643,Zheng; Yang,9999,0,9999,0
1668101521154,ECE 202,A00,103644,Kuzum; Duygu,0,0,0,0
1668101521580,ECE 212BN,A00,103646,Ng; Tse Nga,0,0,0,0
1668101522010,ECE 221,A00,111493,Staff,0,0,0,0
1668101522435,ECE 222B,A00,103647,Lomakin; Vitaliy,0,0,0,0
1668101522873,ECE 230B,A00,103648,Taur; Yuan,0,0,0,0
1668101523306,ECE 238B,A00,103649,Garay; Javier,0,0,0,0
1668101523733,ECE 240B,A00,112900,Fainman; Yeshaiahu,0,0,0,0
1668101524158,ECE 247A,A00,103650,Jokerst; Jesse Vincent,0,0,0,0
1668101524592,ECE 247B,A00,103651,Wang; Joseph,0,0,0,0
1668101525016,ECE 250,A00,103652,Siegel; Paul H.,0,0,0,0
1668101525463,ECE 251A,A00,103654,Rao; Bhaskar D.,0,0,0,0
1668101525886,ECE 257B,A00,103655,Bharadia; Dinesh,0,0,0,0
1668101526311,ECE 258A,A00,103656,Milstein; Laurence B.,0,0,0,0
1668101526738,ECE 260B,A00,103658,Kang; Mingu,0,0,0,0
1668101527175,ECE 264A,A00,103659,Galton; Ian A,0,0,0,0
1668101527598,ECE 265A,A00,103661,Gudem; Prasad S.S.,0,0,0,0
1668101528030,ECE 265D,A00,103662,Gudem; Prasad S.S.,0,0,0,0
1668101528454,ECE 268,A00,103663,Koushanfar; Farinaz,0,0,0,0
1668101528889,ECE 269,A01,103665,Pal; Piya,0,0,0,0
1668101529384,ECE 271B,A00,103666,Vasconcelos; Manuela,0,0,0,0
1668101529815,ECE 276A,A00,103667,Atanasov; Nikolay A.,0,0,0,0
1668101530251,ECE 277,A00,103668,An; Cheolhong,0,0,0,0
1668101530683,ECE 279,A00,117947,Hall; Drew A.,0,0,0,0
1668101531537,ECE 283,A00,103670,Hsueh; Tzu-Chien,0,0,0,0
1668101531972,ECE 284,A00,103671,Turakhia; Yatish Girish,0,0,0,0
1668101532423,ECE 285,A00,103672,Zheng; Yang,0,0,0,0
1668101532423,ECE 285,B00,103673,Sworder; David D.,0,0,0,0
1668101532857,ECE 287,A00,103676,Javidi; Tara,0,0,0,0
1668101533284,MATH 200B,A00,098023,Salehi Golsefidy; Alireza,13,0,15,2
1668101533711,MATH 202B,A00,098024,Rhoades; Brendon Patrick,9,0,15,6
1668101534139,MATH 203B,A00,098025,Oprea; Dragos N.,10,0,15,5
1668101534562,MATH 204B,A00,098026,Sorensen; Claus M,13,0,15,2
1668101534984,MATH 208,A00,098027,Izadi; Elham,7,0,10,3
1668101535407,MATH 209,A00,098028,Pollack; Aaron,10,0,10,0
1668101535829,MATH 211A,A00,112919,Rogalski; Daniel,9,0,10,1
1668101536259,MATH 211B,A00,112920,Seward; Brandon M.,9,0,10,1
1668101536684,MATH 218,A00,098029,Li; Bo,10,0,10,0
1668101537109,MATH 220B,A00,098030,Novak; Jonathan I,12,0,15,3
1668101537532,MATH 221A,A00,098031,Ebenfelt; Peter F,13,0,15,2
1668101537969,MATH 231B,A00,098032,Zlatos; Andrej,12,0,15,3
1668101538394,MATH 240B,A00,098033,Ni; Lei,9,0,15,6
1668101538834,MATH 243,A00,098034,Jekel; David Andrew,10,0,10,0
1668101539263,MATH 245A,A00,098035,Nie; Jiawang,0,0,15,16
1668101539694,MATH 248,A00,098036,Bejenaru; Ioan,10,0,10,0
1668101540120,MATH 250B,A00,098037,Spolaor; Luca,14,0,15,1
1668101540557,MATH 258,A00,098038,Ni; Lei,10,0,10,0
1668101540990,MATH 264B,A00,098041,Rhoades; Brendon Patrick,10,0,15,5
1668101541435,MATH 268,A00,098042,Buss; Samuel R,10,0,10,0
1668101541864,MATH 269,A00,098043,Rhoades; Brendon Patrick,10,0,10,0
1668101542295,MATH 270B,A00,098044,Li; Bo,11,0,15,4
1668101542718,MATH 272B,A00,098045,Holst; Michael J,13,0,15,2
1668101543155,MATH 273A,A00,098046,Tian; Xiaochuan,10,0,15,5
1668101543578,MATH 275,A01,098048,Tian; Xiaochuan,6,0,10,4
1668101544007,MATH 278A,A00,098049,Holst; Michael J,8,0,10,2
1668101544442,MATH 278B,A00,098050,Cloninger; Alexander,10,0,10,0
1668101544869,MATH 278C,A00,098051,Nie; Jiawang,7,0,10,3
1668101545303,MATH 280B,A00,098052,Zheng; Tianyi,10,0,15,5
1668101545735,MATH 281B,A00,098053,Bradic; Jelena,2,0,15,13
1668101546159,MATH 282B,A00,098054,Arias-Castro; Ery,0,0,15,15
1668101546583,MATH 285,A00,098055,Fitzsimmons; Patrick J,0,0,15,17
1668101547008,MATH 287B,A00,098056,Arias-Castro; Ery,3,0,15,12
1668101547458,MATH 288,A00,098057,Agarwal; Pooja,9,0,10,1
1668101547458,MATH 288,B00,098058,Zhang; Danna,8,0,10,2
1668101547458,MATH 288,C00,098059,Williams; Ruth J,10,0,10,0
1668101547891,MATH 290B,A00,098060,Roberts; Justin Deritter,13,0,15,2
1668101548322,MATH 292,A00,098061,Belmont; Eva Kinoshita,10,0,10,0
1668101548757,MATH 295,A00,098062,Suk; Andrew Hoon,48,0,50,2
1668101549182,MATH 296,A00,098063,Novak; Jonathan I,20,0,20,0
1668101549613,MATH 297,001,098064,Gamst; Anthony Collins,9997,0,9999,2
1668102053985,COGS 205,A00,101395,Chiba; Andrea,19,0,20,1
1668102054413,COGS 210B,001,101404,Greene; Deanna Jacquelyn,9998,0,9999,1
1668102054413,COGS 210B,002,101417,Xia; Haijun,9999,0,9999,0
1668102054413,COGS 210B,003,101422,Nitz; Douglas A.,9999,0,9999,0
1668102054413,COGS 210B,004,101423,Hollan; James D.,9998,0,9999,1
1668102054413,COGS 210B,005,101424,Deak; Gedeon O.,9998,0,9999,1
1668102054413,COGS 210B,006,101425,Rossano; Federico,9999,0,9999,0
1668102054836,COGS 211B,A00,101427,Coulson; Seana M,9996,0,9999,3
1668102055268,COGS 220,A00,101428,Hollan; James D.,0,0,25,25
1668102055703,COGS 229,A00,101429,Dow; Steven P,18,0,25,7
1668102056138,COGS 230,A00,101430,Klemmer; Scott R,13,0,17,4
1668102056562,COGS 234,A00,101431,Xia; Haijun,3,0,25,22
1668102056994,COGS 260,A00,101432,Kiyonaga; Anastasia,19,0,25,6
1668102056994,COGS 260,B00,101433,Kirsh; David Joel,16,0,25,9
1668102057425,CSE 202,A00,102371,Impagliazzo; Russell,0,0,0,0
1668102057850,CSE 203B,A01,102373,Cheng; Chung Kuan,0,0,0,0
1668102058283,CSE 208,A00,102374,Micciancio; Daniele,0,0,0,0
1668102058717,CSE 209A,A00,112895,Impagliazzo; Russell,0,0,15,15
1668102059140,CSE 209B,A00,108005,Bellare; Mihir,0,0,0,0
1668102059570,CSE 210,A00,113163,Coblenz; Michael J,0,0,0,0
1668102059999,CSE 219,A00,106111,Dow; Steven P,0,0,20,20
1668102060433,CSE 221,A00,102376,Voelker; Geoffrey M.,0,0,0,0
1668102060869,CSE 224,A01,102378,Porter; George M,0,0,0,0
1668102061297,CSE 229A,A00,102379,Savage; Stefan,0,0,0,0
1668102061724,CSE 229C,A00,102380,Munyaka; Imani N. S.,0,0,0,0
1668102062150,CSE 232B,A00,102382,Deutsch; Alin Bernard,0,0,0,0
1668102062582,CSE 234,A01,112904,Kumar; Arun Kumar,0,0,0,0
1668102063017,CSE 237A,A00,102383,Rosing; Tajana Simunic,0,0,0,0
1668102063441,CSE 239A,A00,102384,Deutsch; Alin Bernard,0,0,0,0
1668102063872,CSE 239B,A00,102385,Polikarpova; Nadezhda,0,0,0,0
1668102064314,CSE 240A,A00,102386,Pannuto; Patrick William,0,0,0,0
1668102064769,CSE 240B,A00,102387,Zhao; Jishen,0,0,0,0
1668102065194,CSE 241A,A00,106406,Kang; Mingu,0,0,0,0
1668102065615,CSE 249B,A00,102388,Kahng; Andrew Byun,0,0,8,8
1668102066051,CSE 251B,A01,102392,Cottrell; Garrison W,0,0,0,0
1668102066051,CSE 251B,A02,102393,Cottrell; Garrison W,0,0,0,0
1668102066488,CSE 252B,A00,102394,Ochoa; Benjamin Lawrence,0,0,0,0
1668102066913,CSE 257,A01,102396,Gao; Sicun,0,0,0,0
1668102067342,CSE 272,A00,102397,Li; Tzumao,0,0,0,0
1668102067777,CSE 274,A00,111323,Chern; Albert Ren-Haur,0,0,0,0
1668102068220,CSE 282,A00,102398,Pevzner; Pavel Arkadjevich,0,0,0,0
1668102068644,CSE 284,A00,114175,Gymrek; Melissa Ann,0,0,0,0
1668102069079,CSE 290,A00,102399,Chandraker; Manmohan Krishna,0,0,0,0
1668102069079,CSE 290,B00,102400,Vaccaro; Kristen Marie,0,0,25,25
1668102069079,CSE 290,C00,102414,Pannuto; Patrick William,0,0,25,25
1668102069079,CSE 290,D00,102427,Pevzner; Pavel Arkadjevich,0,0,0,0
1668102069079,CSE 290,E00,102429,Zhao; Jishen,0,0,0,0
1668102069079,CSE 290,F00,102436,Tullsen; Dean Michael,0,0,0,0
1668102069079,CSE 290,G00,102440,Christensen; Henrik I,0,0,20,20
1668102069506,CSE 291,A00,102443,Su; Hao,0,0,0,0
1668102069506,CSE 291,B00,102448,Polikarpova; Nadezhda,0,0,0,0
1668102069506,CSE 291,C00,102453,Vaccaro; Kristen Marie,0,0,0,0
1668102069506,CSE 291,D00,111343,Savage; Stefan,0,0,0,0
1668102069506,CSE 291,E00,116474,Claffy; Kimberly Claire,0,0,0,0
1668102069506,CSE 291,F00,116479,Pasquale; Joseph,0,0,0,0
1668102069934,CSE 293,001,119111,Bafna; Vineet,9999,0,9999,0
1668102069934,CSE 293,002,119118,Bellare; Mihir,9999,0,9999,0
1668102069934,CSE 293,003,119122,Berg-Kirkpatrick; Taylor D,9999,0,9999,0
1668102069934,CSE 293,004,119135,Christensen; Henrik I,9999,0,9999,0
1668102069934,CSE 293,005,119142,Cottrell; Garrison W,9999,0,9999,0
1668102069934,CSE 293,006,119146,Deutsch; Alin Bernard,9999,0,9999,0
1668102069934,CSE 293,007,119159,Esmaeilzadeh; Hadi,9999,0,9999,0
1668102069934,CSE 293,008,119166,Freund; Yoav,9999,0,9999,0
1668102069934,CSE 293,009,119170,Griswold; William G.,9999,0,9999,0
1668102069934,CSE 293,010,119183,Gymrek; Melissa Ann,9999,0,9999,0
1668102069934,CSE 293,011,119190,Heninger; Nadia A,9999,0,9999,0
1668102069934,CSE 293,012,119230,Impagliazzo; Russell,9999,0,9999,0
1668102069934,CSE 293,013,119232,Jhala; Ranjit,9999,0,9999,0
1668102069934,CSE 293,014,119233,Kahng; Andrew Byun,9999,0,9999,0
1668102069934,CSE 293,015,119298,Kane; Daniel Mertz,9999,0,9999,0
1668102069934,CSE 293,016,119299,Kriegman; David J,9999,0,9999,0
1668102069934,CSE 293,017,119300,Kumar; Arun Kumar,9999,0,9999,0
1668102069934,CSE 293,018,119301,Lerner; Sorin,9999,0,9999,0
1668102069934,CSE 293,019,119302,Lovett; Shachar,9999,0,9999,0
1668102069934,CSE 293,020,119303,McAuley; Julian John,9999,0,9999,0
1668102069934,CSE 293,021,119304,Micciancio; Daniele,9999,0,9999,0
1668102069934,CSE 293,022,119367,Orailoglu; Alex,9999,0,9999,0
1668102069934,CSE 293,023,119382,Paturi; Ramamohan,9999,0,9999,0
1668102069934,CSE 293,024,119404,Polikarpova; Nadezhda,9999,0,9999,0
1668102069934,CSE 293,025,119406,Politz; Joseph Gibbs,9999,0,9999,0
1668102069934,CSE 293,026,119411,Porter; George M,9999,0,9999,0
1668102069934,CSE 293,027,119414,Porter; Leonard Emerson,9999,0,9999,0
1668102069934,CSE 293,028,119416,Ramamoorthi; Ravi,9999,0,9999,0
1668102069934,CSE 293,029,119417,Sahoo; Debashis,9999,0,9999,0
1668102069934,CSE 293,030,119420,Saul; Lawrence,9999,0,9999,0
1668102069934,CSE 293,031,119421,Savage; Stefan,9999,0,9999,0
1668102069934,CSE 293,032,119425,Schulze; Jurgen P.,9999,0,9999,0
1668102069934,CSE 293,033,119426,Snoeren; Alex C.,9999,0,9999,0
1668102069934,CSE 293,034,119428,Shang; Jingbo,9999,0,9999,0
1668102069934,CSE 293,035,119430,Stefan; Deian,9999,0,9999,0
1668102069934,CSE 293,036,119431,Su; Hao,9999,0,9999,0
1668102069934,CSE 293,037,119433,Swanson; Steven James,9999,0,9999,0
1668102069934,CSE 293,038,119435,Tullsen; Dean Michael,9999,0,9999,0
1668102069934,CSE 293,039,119483,Voelker; Geoffrey M.,9999,0,9999,0
1668102069934,CSE 293,040,119537,Zhao; Jishen,9999,0,9999,0
1668102069934,CSE 293,041,119538,Zhou; Yuan-Yuan,9999,0,9999,0
1668102069934,CSE 293,042,119539,Gao; Sicun,9999,0,9999,0
1668102069934,CSE 293,043,119540,Weibel; Nadir,9999,0,9999,0
1668102069934,CSE 293,044,119541,Gupta; Rajesh K.,9999,0,9999,0
1668102069934,CSE 293,045,126410,Vaccaro; Kristen Marie,9999,0,9999,0
1668102069934,CSE 293,046,126411,Klemke; Richard,9999,0,9999,0
1668102070358,CSE 294,A00,102459,Voelker; Geoffrey M.,0,0,0,0
1668102070358,CSE 294,B00,111322,Orailoglu; Alex,0,0,0,0
1668102070782,DSE 201,A00,096914,Deutsch; Alin Bernard,30,0,30,0
1668102071209,DSE 210,A00,096915,Dasgupta; Sanjoy,30,0,30,0
1668102071635,DSE 260A,A00,096916,Altintas De Callaf; Ilkay,30,0,30,0
1668102072104,ECE 200,001,103586,Antipa; Nicholas A,9999,0,9999,0
1668102072104,ECE 200,002,103587,Atanasov; Nikolay A.,9999,0,9999,0
1668102072104,ECE 200,003,103588,Bharadia; Dinesh,9999,0,9999,0
1668102072104,ECE 200,004,103589,Cheng; Chung Kuan,9999,0,9999,0
1668102072104,ECE 200,005,103590,Cosman; Pamela C.,9999,0,9999,0
1668102072104,ECE 200,006,103591,Dayeh; Shadi Ahmad,9999,0,9999,0
1668102072104,ECE 200,007,103592,Fainman; Yeshaiahu,9999,0,9999,0
1668102072104,ECE 200,008,103593,Ford; Joseph Earl,9999,0,9999,0
1668102072104,ECE 200,009,103594,Franceschetti; Massimo,9999,0,9999,0
1668102072104,ECE 200,010,103595,Fullerton; Eric E,9999,0,9999,0
1668102072104,ECE 200,011,103596,Galton; Ian A,9999,0,9999,0
1668102072104,ECE 200,012,103597,Gilja; Vikash,9999,0,9999,0
1668102072104,ECE 200,013,103598,Hall; Drew A.,9999,0,9999,0
1668102072104,ECE 200,014,103599,Hsueh; Tzu-Chien,9999,0,9999,0
1668102072104,ECE 200,015,103600,Javidi; Tara,9999,0,9999,0
1668102072104,ECE 200,016,103601,Kahng; Andrew Byun,9999,0,9999,0
1668102072104,ECE 200,017,103602,Kim; Young-Han,9999,0,9999,0
1668102072104,ECE 200,018,103603,Koushanfar; Farinaz,9999,0,9999,0
1668102072104,ECE 200,019,103604,Kuzum; Duygu,9999,0,9999,0
1668102072104,ECE 200,020,103605,Le; Hanh-Phuc,9999,0,9999,0
1668102072104,ECE 200,021,103606,Lin; Bill,9999,0,9999,0
1668102072104,ECE 200,022,103607,Liu; Zhaowei,9998,0,9999,1
1668102072104,ECE 200,023,103608,Lo; Yu-Hwa,9999,0,9999,0
1668102072104,ECE 200,024,103609,Lomakin; Vitaliy,9999,0,9999,0
1668102072104,ECE 200,025,103610,Mercier; Patrick Philip,9999,0,9999,0
1668102072104,ECE 200,026,103611,Meyer; Florian,9999,0,9999,0
1668102072104,ECE 200,027,103612,Milstein; Laurence B.,9999,0,9999,0
1668102072104,ECE 200,028,103613,Mir Arabbaygi; Siavash,9999,0,9999,0
1668102072104,ECE 200,029,103614,Mookherjea; Shayan,9999,0,9999,0
1668102072104,ECE 200,030,103615,Morris; Karcher William,9999,0,9999,0
1668102072104,ECE 200,031,103616,Ng; Tse Nga,9999,0,9999,0
1668102072104,ECE 200,032,103617,Nguyen; Truong Quang,9999,0,9999,0
1668102072104,ECE 200,033,103618,Nomura; Kenji,9999,0,9999,0
1668102072104,ECE 200,034,103619,Orlitsky; Alon,9999,0,9999,0
1668102072104,ECE 200,035,103620,Pal; Piya,9999,0,9999,0
1668102072104,ECE 200,036,103621,Papen; George C.,9999,0,9999,0
1668102072104,ECE 200,037,103622,Radic; Stojan,9999,0,9999,0
1668102072104,ECE 200,038,103623,Rao; Bhaskar D.,9999,0,9999,0
1668102072104,ECE 200,039,103624,Rao; Ramesh R,9999,0,9999,0
1668102072104,ECE 200,040,103625,Rebeiz; Gabriel,9999,0,9999,0
1668102072104,ECE 200,041,103626,Sanford; John R,9999,0,9999,0
1668102072104,ECE 200,042,103627,Siegel; Paul H.,9999,0,9999,0
1668102072104,ECE 200,043,103628,Sievenpiper; Daniel F.,9999,0,9999,0
1668102072104,ECE 200,044,103629,Sworder; David D.,9999,0,9999,0
1668102072104,ECE 200,045,103630,Taur; Yuan,9999,0,9999,0
1668102072104,ECE 200,046,103631,Touri; Behrouz,9999,0,9999,0
1668102072104,ECE 200,047,103632,Trivedi; Mohan M.,9999,0,9999,0
1668102072104,ECE 200,048,103633,Vasconcelos; Nuno,9999,0,9999,0
1668102072104,ECE 200,049,103634,Wang; Xiaolong,9999,0,9999,0
1668102072104,ECE 200,050,103635,Xie; Pengtao,9999,0,9999,0
1668102072104,ECE 200,051,103636,Yip; Michael,9999,0,9999,0
1668102072104,ECE 200,052,103637,Zeger; Kenneth A.,999,0,999,0
1668102072104,ECE 200,053,103638,Zhang; Xinyu,9999,0,9999,0
1668102072104,ECE 200,054,103639,Turakhia; Yatish Girish,9999,0,9999,0
1668102072104,ECE 200,055,103640,Kang; Mingu,9999,0,9999,0
1668102072104,ECE 200,056,103641,Shi; Yuanyuan,9999,0,9999,0
1668102072104,ECE 200,057,103642,Wang; Edward Jay,9999,0,9999,0
1668102072104,ECE 200,058,103643,Zheng; Yang,9999,0,9999,0
1668102072525,ECE 202,A00,103644,Kuzum; Duygu,0,0,0,0
1668102072956,ECE 212BN,A00,103646,Ng; Tse Nga,0,0,0,0
1668102073380,ECE 221,A00,111493,Staff,0,0,0,0
1668102073804,ECE 222B,A00,103647,Lomakin; Vitaliy,0,0,0,0
1668102074231,ECE 230B,A00,103648,Taur; Yuan,0,0,0,0
1668102074663,ECE 238B,A00,103649,Garay; Javier,0,0,0,0
1668102075088,ECE 240B,A00,112900,Fainman; Yeshaiahu,0,0,0,0
1668102075514,ECE 247A,A00,103650,Jokerst; Jesse Vincent,0,0,0,0
1668102075938,ECE 247B,A00,103651,Wang; Joseph,0,0,0,0
1668102076363,ECE 250,A00,103652,Siegel; Paul H.,0,0,0,0
1668102076797,ECE 251A,A00,103654,Rao; Bhaskar D.,0,0,0,0
1668102077227,ECE 257B,A00,103655,Bharadia; Dinesh,0,0,0,0
1668102077658,ECE 258A,A00,103656,Milstein; Laurence B.,0,0,0,0
1668102078084,ECE 260B,A00,103658,Kang; Mingu,0,0,0,0
1668102078510,ECE 264A,A00,103659,Galton; Ian A,0,0,0,0
1668102079033,ECE 265A,A00,103661,Gudem; Prasad S.S.,0,0,0,0
1668102079465,ECE 265D,A00,103662,Gudem; Prasad S.S.,0,0,0,0
1668102079896,ECE 268,A00,103663,Koushanfar; Farinaz,0,0,0,0
1668102080328,ECE 269,A01,103665,Pal; Piya,0,0,0,0
1668102080770,ECE 271B,A00,103666,Vasconcelos; Manuela,0,0,0,0
1668102081199,ECE 276A,A00,103667,Atanasov; Nikolay A.,0,0,0,0
1668102081622,ECE 277,A00,103668,An; Cheolhong,0,0,0,0
1668102082072,ECE 279,A00,117947,Hall; Drew A.,0,0,0,0
1668102082936,ECE 283,A00,103670,Hsueh; Tzu-Chien,0,0,0,0
1668102083366,ECE 284,A00,103671,Turakhia; Yatish Girish,0,0,0,0
1668102083790,ECE 285,A00,103672,Zheng; Yang,0,0,0,0
1668102083790,ECE 285,B00,103673,Sworder; David D.,0,0,0,0
1668102084217,ECE 287,A00,103676,Javidi; Tara,0,0,0,0
1668102084654,MATH 200B,A00,098023,Salehi Golsefidy; Alireza,13,0,15,2
1668102085081,MATH 202B,A00,098024,Rhoades; Brendon Patrick,9,0,15,6
1668102085514,MATH 203B,A00,098025,Oprea; Dragos N.,10,0,15,5
1668102085938,MATH 204B,A00,098026,Sorensen; Claus M,13,0,15,2
1668102086364,MATH 208,A00,098027,Izadi; Elham,7,0,10,3
1668102086786,MATH 209,A00,098028,Pollack; Aaron,10,0,10,0
1668102087209,MATH 211A,A00,112919,Rogalski; Daniel,9,0,10,1
1668102087634,MATH 211B,A00,112920,Seward; Brandon M.,9,0,10,1
1668102088057,MATH 218,A00,098029,Li; Bo,10,0,10,0
1668102088481,MATH 220B,A00,098030,Novak; Jonathan I,12,0,15,3
1668102088905,MATH 221A,A00,098031,Ebenfelt; Peter F,13,0,15,2
1668102089326,MATH 231B,A00,098032,Zlatos; Andrej,12,0,15,3
1668102089750,MATH 240B,A00,098033,Ni; Lei,9,0,15,6
1668102090197,MATH 243,A00,098034,Jekel; David Andrew,10,0,10,0
1668102090621,MATH 245A,A00,098035,Nie; Jiawang,0,0,15,16
1668102091047,MATH 248,A00,098036,Bejenaru; Ioan,10,0,10,0
1668102091471,MATH 250B,A00,098037,Spolaor; Luca,14,0,15,1
1668102091895,MATH 258,A00,098038,Ni; Lei,10,0,10,0
1668102092321,MATH 264B,A00,098041,Rhoades; Brendon Patrick,10,0,15,5
1668102092744,MATH 268,A00,098042,Buss; Samuel R,10,0,10,0
1668102093173,MATH 269,A00,098043,Rhoades; Brendon Patrick,10,0,10,0
1668102093599,MATH 270B,A00,098044,Li; Bo,11,0,15,4
1668102094022,MATH 272B,A00,098045,Holst; Michael J,13,0,15,2
1668102094600,MATH 273A,A00,098046,Tian; Xiaochuan,10,0,15,5
1668102095025,MATH 275,A01,098048,Tian; Xiaochuan,6,0,10,4
1668102095458,MATH 278A,A00,098049,Holst; Michael J,8,0,10,2
1668102095881,MATH 278B,A00,098050,Cloninger; Alexander,10,0,10,0
1668102096308,MATH 278C,A00,098051,Nie; Jiawang,7,0,10,3
1668102096734,MATH 280B,A00,098052,Zheng; Tianyi,10,0,15,5
1668102097162,MATH 281B,A00,098053,Bradic; Jelena,2,0,15,13
1668102097592,MATH 282B,A00,098054,Arias-Castro; Ery,0,0,15,15
1668102098015,MATH 285,A00,098055,Fitzsimmons; Patrick J,0,0,15,17
1668102098454,MATH 287B,A00,098056,Arias-Castro; Ery,3,0,15,12
1668102098882,MATH 288,A00,098057,Agarwal; Pooja,9,0,10,1
1668102098882,MATH 288,B00,098058,Zhang; Danna,8,0,10,2
1668102098882,MATH 288,C00,098059,Williams; Ruth J,10,0,10,0
1668102099309,MATH 290B,A00,098060,Roberts; Justin Deritter,13,0,15,2
1668102099743,MATH 292,A00,098061,Belmont; Eva Kinoshita,10,0,10,0
1668102100164,MATH 295,A00,098062,Suk; Andrew Hoon,48,0,50,2
1668102100588,MATH 296,A00,098063,Novak; Jonathan I,20,0,20,0
1668102101012,MATH 297,001,098064,Gamst; Anthony Collins,9997,0,9999,2
1668102604849,COGS 205,A00,101395,Chiba; Andrea,19,0,20,1
1668102605286,COGS 210B,001,101404,Greene; Deanna Jacquelyn,9998,0,9999,1
1668102605286,COGS 210B,002,101417,Xia; Haijun,9999,0,9999,0
1668102605286,COGS 210B,003,101422,Nitz; Douglas A.,9999,0,9999,0
1668102605286,COGS 210B,004,101423,Hollan; James D.,9998,0,9999,1
1668102605286,COGS 210B,005,101424,Deak; Gedeon O.,9998,0,9999,1
1668102605286,COGS 210B,006,101425,Rossano; Federico,9999,0,9999,0
1668102605716,COGS 211B,A00,101427,Coulson; Seana M,9996,0,9999,3
1668102606153,COGS 220,A00,101428,Hollan; James D.,0,0,25,25
1668102606596,COGS 229,A00,101429,Dow; Steven P,18,0,25,7
1668102607018,COGS 230,A00,101430,Klemmer; Scott R,13,0,17,4
1668102607448,COGS 234,A00,101431,Xia; Haijun,3,0,25,22
1668102607871,COGS 260,A00,101432,Kiyonaga; Anastasia,19,0,25,6
1668102607871,COGS 260,B00,101433,Kirsh; David Joel,16,0,25,9
1668102608306,CSE 202,A00,102371,Impagliazzo; Russell,0,0,0,0
1668102608732,CSE 203B,A01,102373,Cheng; Chung Kuan,0,0,0,0
1668102609166,CSE 208,A00,102374,Micciancio; Daniele,0,0,0,0
1668102609590,CSE 209A,A00,112895,Impagliazzo; Russell,0,0,15,15
1668102610020,CSE 209B,A00,108005,Bellare; Mihir,0,0,0,0
1668102610444,CSE 210,A00,113163,Coblenz; Michael J,0,0,0,0
1668102610874,CSE 219,A00,106111,Dow; Steven P,0,0,20,20
1668102611306,CSE 221,A00,102376,Voelker; Geoffrey M.,0,0,0,0
1668102611729,CSE 224,A01,102378,Porter; George M,0,0,0,0
1668102612153,CSE 229A,A00,102379,Savage; Stefan,0,0,0,0
1668102612603,CSE 229C,A00,102380,Munyaka; Imani N. S.,0,0,0,0
1668102613028,CSE 232B,A00,102382,Deutsch; Alin Bernard,0,0,0,0
1668102613459,CSE 234,A01,112904,Kumar; Arun Kumar,0,0,0,0
1668102613883,CSE 237A,A00,102383,Rosing; Tajana Simunic,0,0,0,0
1668102614320,CSE 239A,A00,102384,Deutsch; Alin Bernard,0,0,0,0
1668102614764,CSE 239B,A00,102385,Polikarpova; Nadezhda,0,0,0,0
1668102615196,CSE 240A,A00,102386,Pannuto; Patrick William,0,0,0,0
1668102615623,CSE 240B,A00,102387,Zhao; Jishen,0,0,0,0
1668102616097,CSE 241A,A00,106406,Kang; Mingu,0,0,0,0
1668102616533,CSE 249B,A00,102388,Kahng; Andrew Byun,0,0,8,8
1668102616963,CSE 251B,A01,102392,Cottrell; Garrison W,0,0,0,0
1668102616963,CSE 251B,A02,102393,Cottrell; Garrison W,0,0,0,0
1668102617393,CSE 252B,A00,102394,Ochoa; Benjamin Lawrence,0,0,0,0
1668102617823,CSE 257,A01,102396,Gao; Sicun,0,0,0,0
1668102618251,CSE 272,A00,102397,Li; Tzumao,0,0,0,0
1668102618677,CSE 274,A00,111323,Chern; Albert Ren-Haur,0,0,0,0
1668102619127,CSE 282,A00,102398,Pevzner; Pavel Arkadjevich,0,0,0,0
1668102619580,CSE 284,A00,114175,Gymrek; Melissa Ann,0,0,0,0
1668102620013,CSE 290,A00,102399,Chandraker; Manmohan Krishna,0,0,0,0
1668102620013,CSE 290,B00,102400,Vaccaro; Kristen Marie,0,0,25,25
1668102620013,CSE 290,C00,102414,Pannuto; Patrick William,0,0,25,25
1668102620013,CSE 290,D00,102427,Pevzner; Pavel Arkadjevich,0,0,0,0
1668102620013,CSE 290,E00,102429,Zhao; Jishen,0,0,0,0
1668102620013,CSE 290,F00,102436,Tullsen; Dean Michael,0,0,0,0
1668102620013,CSE 290,G00,102440,Christensen; Henrik I,0,0,20,20
1668102620436,CSE 291,A00,102443,Su; Hao,0,0,0,0
1668102620436,CSE 291,B00,102448,Polikarpova; Nadezhda,0,0,0,0
1668102620436,CSE 291,C00,102453,Vaccaro; Kristen Marie,0,0,0,0
1668102620436,CSE 291,D00,111343,Savage; Stefan,0,0,0,0
1668102620436,CSE 291,E00,116474,Claffy; Kimberly Claire,0,0,0,0
1668102620436,CSE 291,F00,116479,Pasquale; Joseph,0,0,0,0
1668102620881,CSE 293,001,119111,Bafna; Vineet,9999,0,9999,0
1668102620881,CSE 293,002,119118,Bellare; Mihir,9999,0,9999,0
1668102620881,CSE 293,003,119122,Berg-Kirkpatrick; Taylor D,9999,0,9999,0
1668102620881,CSE 293,004,119135,Christensen; Henrik I,9999,0,9999,0
1668102620881,CSE 293,005,119142,Cottrell; Garrison W,9999,0,9999,0
1668102620881,CSE 293,006,119146,Deutsch; Alin Bernard,9999,0,9999,0
1668102620881,CSE 293,007,119159,Esmaeilzadeh; Hadi,9999,0,9999,0
1668102620881,CSE 293,008,119166,Freund; Yoav,9999,0,9999,0
1668102620881,CSE 293,009,119170,Griswold; William G.,9999,0,9999,0
1668102620881,CSE 293,010,119183,Gymrek; Melissa Ann,9999,0,9999,0
1668102620881,CSE 293,011,119190,Heninger; Nadia A,9999,0,9999,0
1668102620881,CSE 293,012,119230,Impagliazzo; Russell,9999,0,9999,0
1668102620881,CSE 293,013,119232,Jhala; Ranjit,9999,0,9999,0
1668102620881,CSE 293,014,119233,Kahng; Andrew Byun,9999,0,9999,0
1668102620881,CSE 293,015,119298,Kane; Daniel Mertz,9999,0,9999,0
1668102620881,CSE 293,016,119299,Kriegman; David J,9999,0,9999,0
1668102620881,CSE 293,017,119300,Kumar; Arun Kumar,9999,0,9999,0
1668102620881,CSE 293,018,119301,Lerner; Sorin,9999,0,9999,0
1668102620881,CSE 293,019,119302,Lovett; Shachar,9999,0,9999,0
1668102620881,CSE 293,020,119303,McAuley; Julian John,9999,0,9999,0
1668102620881,CSE 293,021,119304,Micciancio; Daniele,9999,0,9999,0
1668102620881,CSE 293,022,119367,Orailoglu; Alex,9999,0,9999,0
1668102620881,CSE 293,023,119382,Paturi; Ramamohan,9999,0,9999,0
1668102620881,CSE 293,024,119404,Polikarpova; Nadezhda,9999,0,9999,0
1668102620881,CSE 293,025,119406,Politz; Joseph Gibbs,9999,0,9999,0
1668102620881,CSE 293,026,119411,Porter; George M,9999,0,9999,0
1668102620881,CSE 293,027,119414,Porter; Leonard Emerson,9999,0,9999,0
1668102620881,CSE 293,028,119416,Ramamoorthi; Ravi,9999,0,9999,0
1668102620881,CSE 293,029,119417,Sahoo; Debashis,9999,0,9999,0
1668102620881,CSE 293,030,119420,Saul; Lawrence,9999,0,9999,0
1668102620881,CSE 293,031,119421,Savage; Stefan,9999,0,9999,0
1668102620881,CSE 293,032,119425,Schulze; Jurgen P.,9999,0,9999,0
1668102620881,CSE 293,033,119426,Snoeren; Alex C.,9999,0,9999,0
1668102620881,CSE 293,034,119428,Shang; Jingbo,9999,0,9999,0
1668102620881,CSE 293,035,119430,Stefan; Deian,9999,0,9999,0
1668102620881,CSE 293,036,119431,Su; Hao,9999,0,9999,0
1668102620881,CSE 293,037,119433,Swanson; Steven James,9999,0,9999,0
1668102620881,CSE 293,038,119435,Tullsen; Dean Michael,9999,0,9999,0
1668102620881,CSE 293,039,119483,Voelker; Geoffrey M.,9999,0,9999,0
1668102620881,CSE 293,040,119537,Zhao; Jishen,9999,0,9999,0
1668102620881,CSE 293,041,119538,Zhou; Yuan-Yuan,9999,0,9999,0
1668102620881,CSE 293,042,119539,Gao; Sicun,9999,0,9999,0
1668102620881,CSE 293,043,119540,Weibel; Nadir,9999,0,9999,0
1668102620881,CSE 293,044,119541,Gupta; Rajesh K.,9999,0,9999,0
1668102620881,CSE 293,045,126410,Vaccaro; Kristen Marie,9999,0,9999,0
1668102620881,CSE 293,046,126411,Klemke; Richard,9999,0,9999,0
1668102621326,CSE 294,A00,102459,Voelker; Geoffrey M.,0,0,0,0
1668102621326,CSE 294,B00,111322,Orailoglu; Alex,0,0,0,0
1668102621757,DSE 201,A00,096914,Deutsch; Alin Bernard,30,0,30,0
1668102622181,DSE 210,A00,096915,Dasgupta; Sanjoy,30,0,30,0
1668102622623,DSE 260A,A00,096916,Altintas De Callaf; Ilkay,30,0,30,0
1668102623115,ECE 200,001,103586,Antipa; Nicholas A,9999,0,9999,0
1668102623115,ECE 200,002,103587,Atanasov; Nikolay A.,9999,0,9999,0
1668102623115,ECE 200,003,103588,Bharadia; Dinesh,9999,0,9999,0
1668102623115,ECE 200,004,103589,Cheng; Chung Kuan,9999,0,9999,0
1668102623115,ECE 200,005,103590,Cosman; Pamela C.,9999,0,9999,0
1668102623115,ECE 200,006,103591,Dayeh; Shadi Ahmad,9999,0,9999,0
1668102623115,ECE 200,007,103592,Fainman; Yeshaiahu,9999,0,9999,0
1668102623115,ECE 200,008,103593,Ford; Joseph Earl,9999,0,9999,0
1668102623115,ECE 200,009,103594,Franceschetti; Massimo,9999,0,9999,0
1668102623115,ECE 200,010,103595,Fullerton; Eric E,9999,0,9999,0
1668102623115,ECE 200,011,103596,Galton; Ian A,9999,0,9999,0
1668102623115,ECE 200,012,103597,Gilja; Vikash,9999,0,9999,0
1668102623115,ECE 200,013,103598,Hall; Drew A.,9999,0,9999,0
1668102623115,ECE 200,014,103599,Hsueh; Tzu-Chien,9999,0,9999,0
1668102623115,ECE 200,015,103600,Javidi; Tara,9999,0,9999,0
1668102623115,ECE 200,016,103601,Kahng; Andrew Byun,9999,0,9999,0
1668102623115,ECE 200,017,103602,Kim; Young-Han,9999,0,9999,0
1668102623115,ECE 200,018,103603,Koushanfar; Farinaz,9999,0,9999,0
1668102623115,ECE 200,019,103604,Kuzum; Duygu,9999,0,9999,0
1668102623115,ECE 200,020,103605,Le; Hanh-Phuc,9999,0,9999,0
1668102623115,ECE 200,021,103606,Lin; Bill,9999,0,9999,0
1668102623115,ECE 200,022,103607,Liu; Zhaowei,9998,0,9999,1
1668102623115,ECE 200,023,103608,Lo; Yu-Hwa,9999,0,9999,0
1668102623115,ECE 200,024,103609,Lomakin; Vitaliy,9999,0,9999,0
1668102623115,ECE 200,025,103610,Mercier; Patrick Philip,9999,0,9999,0
1668102623115,ECE 200,026,103611,Meyer; Florian,9999,0,9999,0
1668102623115,ECE 200,027,103612,Milstein; Laurence B.,9999,0,9999,0
1668102623115,ECE 200,028,103613,Mir Arabbaygi; Siavash,9999,0,9999,0
1668102623115,ECE 200,029,103614,Mookherjea; Shayan,9999,0,9999,0
1668102623115,ECE 200,030,103615,Morris; Karcher William,9999,0,9999,0
1668102623115,ECE 200,031,103616,Ng; Tse Nga,9999,0,9999,0
1668102623115,ECE 200,032,103617,Nguyen; Truong Quang,9999,0,9999,0
1668102623115,ECE 200,033,103618,Nomura; Kenji,9999,0,9999,0
1668102623115,ECE 200,034,103619,Orlitsky; Alon,9999,0,9999,0
1668102623115,ECE 200,035,103620,Pal; Piya,9999,0,9999,0
1668102623115,ECE 200,036,103621,Papen; George C.,9999,0,9999,0
1668102623115,ECE 200,037,103622,Radic; Stojan,9999,0,9999,0
1668102623115,ECE 200,038,103623,Rao; Bhaskar D.,9999,0,9999,0
1668102623115,ECE 200,039,103624,Rao; Ramesh R,9999,0,9999,0
1668102623115,ECE 200,040,103625,Rebeiz; Gabriel,9999,0,9999,0
1668102623115,ECE 200,041,103626,Sanford; John R,9999,0,9999,0
1668102623115,ECE 200,042,103627,Siegel; Paul H.,9999,0,9999,0
1668102623115,ECE 200,043,103628,Sievenpiper; Daniel F.,9999,0,9999,0
1668102623115,ECE 200,044,103629,Sworder; David D.,9999,0,9999,0
1668102623115,ECE 200,045,103630,Taur; Yuan,9999,0,9999,0
1668102623115,ECE 200,046,103631,Touri; Behrouz,9999,0,9999,0
1668102623115,ECE 200,047,103632,Trivedi; Mohan M.,9999,0,9999,0
1668102623115,ECE 200,048,103633,Vasconcelos; Nuno,9999,0,9999,0
1668102623115,ECE 200,049,103634,Wang; Xiaolong,9999,0,9999,0
1668102623115,ECE 200,050,103635,Xie; Pengtao,9999,0,9999,0
1668102623115,ECE 200,051,103636,Yip; Michael,9999,0,9999,0
1668102623115,ECE 200,052,103637,Zeger; Kenneth A.,999,0,999,0
1668102623115,ECE 200,053,103638,Zhang; Xinyu,9999,0,9999,0
1668102623115,ECE 200,054,103639,Turakhia; Yatish Girish,9999,0,9999,0
1668102623115,ECE 200,055,103640,Kang; Mingu,9999,0,9999,0
1668102623115,ECE 200,056,103641,Shi; Yuanyuan,9999,0,9999,0
1668102623115,ECE 200,057,103642,Wang; Edward Jay,9999,0,9999,0
1668102623115,ECE 200,058,103643,Zheng; Yang,9999,0,9999,0
1668102623540,ECE 202,A00,103644,Kuzum; Duygu,0,0,0,0
1668102623968,ECE 212BN,A00,103646,Ng; Tse Nga,0,0,0,0
1668102624396,ECE 221,A00,111493,Staff,0,0,0,0
1668102624820,ECE 222B,A00,103647,Lomakin; Vitaliy,0,0,0,0
1668102625243,ECE 230B,A00,103648,Taur; Yuan,0,0,0,0
1668102625674,ECE 238B,A00,103649,Garay; Javier,0,0,0,0
1668102626100,ECE 240B,A00,112900,Fainman; Yeshaiahu,0,0,0,0
1668102626526,ECE 247A,A00,103650,Jokerst; Jesse Vincent,0,0,0,0
1668102626957,ECE 247B,A00,103651,Wang; Joseph,0,0,0,0
1668102627384,ECE 250,A00,103652,Siegel; Paul H.,0,0,0,0
1668102627809,ECE 251A,A00,103654,Rao; Bhaskar D.,0,0,0,0
1668102628231,ECE 257B,A00,103655,Bharadia; Dinesh,0,0,0,0
1668102628662,ECE 258A,A00,103656,Milstein; Laurence B.,0,0,0,0
1668102629101,ECE 260B,A00,103658,Kang; Mingu,0,0,0,0
1668102629523,ECE 264A,A00,103659,Galton; Ian A,0,0,0,0
1668102629959,ECE 265A,A00,103661,Gudem; Prasad S.S.,0,0,0,0
1668102630382,ECE 265D,A00,103662,Gudem; Prasad S.S.,0,0,0,0
1668102630811,ECE 268,A00,103663,Koushanfar; Farinaz,0,0,0,0
1668102631239,ECE 269,A01,103665,Pal; Piya,0,0,0,0
1668102631677,ECE 271B,A00,103666,Vasconcelos; Manuela,0,0,0,0
1668102632108,ECE 276A,A00,103667,Atanasov; Nikolay A.,0,0,0,0
1668102632540,ECE 277,A00,103668,An; Cheolhong,0,0,0,0
1668102632967,ECE 279,A00,117947,Hall; Drew A.,0,0,0,0
1668102633816,ECE 283,A00,103670,Hsueh; Tzu-Chien,0,0,0,0
1668102634291,ECE 284,A00,103671,Turakhia; Yatish Girish,0,0,0,0
1668102634737,ECE 285,A00,103672,Zheng; Yang,0,0,0,0
1668102634737,ECE 285,B00,103673,Sworder; David D.,0,0,0,0
1668102635160,ECE 287,A00,103676,Javidi; Tara,0,0,0,0
1668102635584,MATH 200B,A00,098023,Salehi Golsefidy; Alireza,13,0,15,2
1668102636022,MATH 202B,A00,098024,Rhoades; Brendon Patrick,9,0,15,6
1668102636446,MATH 203B,A00,098025,Oprea; Dragos N.,10,0,15,5
1668102636869,MATH 204B,A00,098026,Sorensen; Claus M,13,0,15,2
1668102637296,MATH 208,A00,098027,Izadi; Elham,7,0,10,3
1668102637722,MATH 209,A00,098028,Pollack; Aaron,10,0,10,0
1668102638153,MATH 211A,A00,112919,Rogalski; Daniel,9,0,10,1
1668102638590,MATH 211B,A00,112920,Seward; Brandon M.,9,0,10,1
1668102639015,MATH 218,A00,098029,Li; Bo,10,0,10,0
1668102639439,MATH 220B,A00,098030,Novak; Jonathan I,12,0,15,3
1668102639863,MATH 221A,A00,098031,Ebenfelt; Peter F,13,0,15,2
1668102640289,MATH 231B,A00,098032,Zlatos; Andrej,12,0,15,3
1668102640715,MATH 240B,A00,098033,Ni; Lei,9,0,15,6
1668102641138,MATH 243,A00,098034,Jekel; David Andrew,10,0,10,0
1668102641563,MATH 245A,A00,098035,Nie; Jiawang,0,0,15,16
1668102641989,MATH 248,A00,098036,Bejenaru; Ioan,10,0,10,0
1668102642414,MATH 250B,A00,098037,Spolaor; Luca,14,0,15,1
1668102642837,MATH 258,A00,098038,Ni; Lei,10,0,10,0
1668102643267,MATH 264B,A00,098041,Rhoades; Brendon Patrick,10,0,15,5
1668102643690,MATH 268,A00,098042,Buss; Samuel R,10,0,10,0
1668102644123,MATH 269,A00,098043,Rhoades; Brendon Patrick,10,0,10,0
1668102644546,MATH 270B,A00,098044,Li; Bo,11,0,15,4
1668102644968,MATH 272B,A00,098045,Holst; Michael J,13,0,15,2
1668102645405,MATH 273A,A00,098046,Tian; Xiaochuan,10,0,15,5
1668102645828,MATH 275,A01,098048,Tian; Xiaochuan,6,0,10,4
1668102646256,MATH 278A,A00,098049,Holst; Michael J,8,0,10,2
1668102646760,MATH 278B,A00,098050,Cloninger; Alexander,10,0,10,0
1668102647181,MATH 278C,A00,098051,Nie; Jiawang,7,0,10,3
1668102647605,MATH 280B,A00,098052,Zheng; Tianyi,10,0,15,5
1668102648037,MATH 281B,A00,098053,Bradic; Jelena,2,0,15,13
1668102648480,MATH 282B,A00,098054,Arias-Castro; Ery,0,0,15,15
1668102648907,MATH 285,A00,098055,Fitzsimmons; Patrick J,0,0,15,17
1668102649334,MATH 287B,A00,098056,Arias-Castro; Ery,3,0,15,12
1668102649773,MATH 288,A00,098057,Agarwal; Pooja,9,0,10,1
1668102649773,MATH 288,B00,098058,Zhang; Danna,8,0,10,2
1668102649773,MATH 288,C00,098059,Williams; Ruth J,10,0,10,0
1668102650198,MATH 290B,A00,098060,Roberts; Justin Deritter,13,0,15,2
1668102650622,MATH 292,A00,098061,Belmont; Eva Kinoshita,10,0,10,0
1668102651049,MATH 295,A00,098062,Suk; Andrew Hoon,48,0,50,2
1668102651480,MATH 296,A00,098063,Novak; Jonathan I,20,0,20,0
1668102651905,MATH 297,001,098064,Gamst; Anthony Collins,9997,0,9999,2
1668103165572,COGS 205,A00,101395,Chiba; Andrea,19,0,20,1
1668103166018,COGS 210B,001,101404,Greene; Deanna Jacquelyn,9998,0,9999,1
1668103166018,COGS 210B,002,101417,Xia; Haijun,9999,0,9999,0
1668103166018,COGS 210B,003,101422,Nitz; Douglas A.,9999,0,9999,0
1668103166018,COGS 210B,004,101423,Hollan; James D.,9998,0,9999,1
1668103166018,COGS 210B,005,101424,Deak; Gedeon O.,9998,0,9999,1
1668103166018,COGS 210B,006,101425,Rossano; Federico,9999,0,9999,0
1668103166443,COGS 211B,A00,101427,Coulson; Seana M,9996,0,9999,3
1668103166867,COGS 220,A00,101428,Hollan; James D.,0,0,25,25
1668103167295,COGS 229,A00,101429,Dow; Steven P,18,0,25,7
1668103167717,COGS 230,A00,101430,Klemmer; Scott R,13,0,17,4
1668103168148,COGS 234,A00,101431,Xia; Haijun,3,0,25,22
1668103168577,COGS 260,A00,101432,Kiyonaga; Anastasia,19,0,25,6
1668103168577,COGS 260,B00,101433,Kirsh; David Joel,16,0,25,9
1668103169001,CSE 202,A00,102371,Impagliazzo; Russell,0,0,0,0
1668103169439,CSE 203B,A01,102373,Cheng; Chung Kuan,0,0,0,0
1668103169875,CSE 208,A00,102374,Micciancio; Daniele,0,0,0,0
1668103170306,CSE 209A,A00,112895,Impagliazzo; Russell,0,0,15,15
1668103170730,CSE 209B,A00,108005,Bellare; Mihir,0,0,0,0
1668103171164,CSE 210,A00,113163,Coblenz; Michael J,0,0,0,0
1668103171593,CSE 219,A00,106111,Dow; Steven P,0,0,20,20
1668103172021,CSE 221,A00,102376,Voelker; Geoffrey M.,0,0,0,0
1668103172446,CSE 224,A01,102378,Porter; George M,0,0,0,0
1668103172871,CSE 229A,A00,102379,Savage; Stefan,0,0,0,0
1668103173299,CSE 229C,A00,102380,Munyaka; Imani N. S.,0,0,0,0
1668103173721,CSE 232B,A00,102382,Deutsch; Alin Bernard,0,0,0,0
1668103174145,CSE 234,A01,112904,Kumar; Arun Kumar,0,0,0,0
1668103174568,CSE 237A,A00,102383,Rosing; Tajana Simunic,0,0,0,0
1668103174993,CSE 239A,A00,102384,Deutsch; Alin Bernard,0,0,0,0
1668103175424,CSE 239B,A00,102385,Polikarpova; Nadezhda,0,0,0,0
1668103175854,CSE 240A,A00,102386,Pannuto; Patrick William,0,0,0,0
1668103176288,CSE 240B,A00,102387,Zhao; Jishen,0,0,0,0
1668103176712,CSE 241A,A00,106406,Kang; Mingu,0,0,0,0
1668103177136,CSE 249B,A00,102388,Kahng; Andrew Byun,0,0,8,8
1668103177569,CSE 251B,A01,102392,Cottrell; Garrison W,0,0,0,0
1668103177569,CSE 251B,A02,102393,Cottrell; Garrison W,0,0,0,0
1668103177993,CSE 252B,A00,102394,Ochoa; Benjamin Lawrence,0,0,0,0
1668103178420,CSE 257,A01,102396,Gao; Sicun,0,0,0,0
1668103178863,CSE 272,A00,102397,Li; Tzumao,0,0,0,0
1668103179289,CSE 274,A00,111323,Chern; Albert Ren-Haur,0,0,0,0
1668103179722,CSE 282,A00,102398,Pevzner; Pavel Arkadjevich,0,0,0,0
1668103180152,CSE 284,A00,114175,Gymrek; Melissa Ann,0,0,0,0
1668103180672,CSE 290,A00,102399,Chandraker; Manmohan Krishna,0,0,0,0
1668103180672,CSE 290,B00,102400,Vaccaro; Kristen Marie,0,0,25,25
1668103180672,CSE 290,C00,102414,Pannuto; Patrick William,0,0,25,25
1668103180672,CSE 290,D00,102427,Pevzner; Pavel Arkadjevich,0,0,0,0
1668103180672,CSE 290,E00,102429,Zhao; Jishen,0,0,0,0
1668103180672,CSE 290,F00,102436,Tullsen; Dean Michael,0,0,0,0
1668103180672,CSE 290,G00,102440,Christensen; Henrik I,0,0,20,20
1668103181104,CSE 291,A00,102443,Su; Hao,0,0,0,0
1668103181104,CSE 291,B00,102448,Polikarpova; Nadezhda,0,0,0,0
1668103181104,CSE 291,C00,102453,Vaccaro; Kristen Marie,0,0,0,0
1668103181104,CSE 291,D00,111343,Savage; Stefan,0,0,0,0
1668103181104,CSE 291,E00,116474,Claffy; Kimberly Claire,0,0,0,0
1668103181104,CSE 291,F00,116479,Pasquale; Joseph,0,0,0,0
1668103181573,CSE 293,001,119111,Bafna; Vineet,9999,0,9999,0
1668103181573,CSE 293,002,119118,Bellare; Mihir,9999,0,9999,0
1668103181573,CSE 293,003,119122,Berg-Kirkpatrick; Taylor D,9999,0,9999,0
1668103181573,CSE 293,004,119135,Christensen; Henrik I,9999,0,9999,0
1668103181573,CSE 293,005,119142,Cottrell; Garrison W,9999,0,9999,0
1668103181573,CSE 293,006,119146,Deutsch; Alin Bernard,9999,0,9999,0
1668103181573,CSE 293,007,119159,Esmaeilzadeh; Hadi,9999,0,9999,0
1668103181573,CSE 293,008,119166,Freund; Yoav,9999,0,9999,0
1668103181573,CSE 293,009,119170,Griswold; William G.,9999,0,9999,0
1668103181573,CSE 293,010,119183,Gymrek; Melissa Ann,9999,0,9999,0
1668103181573,CSE 293,011,119190,Heninger; Nadia A,9999,0,9999,0
1668103181573,CSE 293,012,119230,Impagliazzo; Russell,9999,0,9999,0
1668103181573,CSE 293,013,119232,Jhala; Ranjit,9999,0,9999,0
1668103181573,CSE 293,014,119233,Kahng; Andrew Byun,9999,0,9999,0
1668103181573,CSE 293,015,119298,Kane; Daniel Mertz,9999,0,9999,0
1668103181573,CSE 293,016,119299,Kriegman; David J,9999,0,9999,0
1668103181573,CSE 293,017,119300,Kumar; Arun Kumar,9999,0,9999,0
1668103181573,CSE 293,018,119301,Lerner; Sorin,9999,0,9999,0
1668103181573,CSE 293,019,119302,Lovett; Shachar,9999,0,9999,0
1668103181573,CSE 293,020,119303,McAuley; Julian John,9999,0,9999,0
1668103181573,CSE 293,021,119304,Micciancio; Daniele,9999,0,9999,0
1668103181573,CSE 293,022,119367,Orailoglu; Alex,9999,0,9999,0
1668103181573,CSE 293,023,119382,Paturi; Ramamohan,9999,0,9999,0
1668103181573,CSE 293,024,119404,Polikarpova; Nadezhda,9999,0,9999,0
1668103181573,CSE 293,025,119406,Politz; Joseph Gibbs,9999,0,9999,0
1668103181573,CSE 293,026,119411,Porter; George M,9999,0,9999,0
1668103181573,CSE 293,027,119414,Porter; Leonard Emerson,9999,0,9999,0
1668103181573,CSE 293,028,119416,Ramamoorthi; Ravi,9999,0,9999,0
1668103181573,CSE 293,029,119417,Sahoo; Debashis,9999,0,9999,0
1668103181573,CSE 293,030,119420,Saul; Lawrence,9999,0,9999,0
1668103181573,CSE 293,031,119421,Savage; Stefan,9999,0,9999,0
1668103181573,CSE 293,032,119425,Schulze; Jurgen P.,9999,0,9999,0
1668103181573,CSE 293,033,119426,Snoeren; Alex C.,9999,0,9999,0
1668103181573,CSE 293,034,119428,Shang; Jingbo,9999,0,9999,0
1668103181573,CSE 293,035,119430,Stefan; Deian,9999,0,9999,0
1668103181573,CSE 293,036,119431,Su; Hao,9999,0,9999,0
1668103181573,CSE 293,037,119433,Swanson; Steven James,9999,0,9999,0
1668103181573,CSE 293,038,119435,Tullsen; Dean Michael,9999,0,9999,0
1668103181573,CSE 293,039,119483,Voelker; Geoffrey M.,9999,0,9999,0
1668103181573,CSE 293,040,119537,Zhao; Jishen,9999,0,9999,0
1668103181573,CSE 293,041,119538,Zhou; Yuan-Yuan,9999,0,9999,0
1668103181573,CSE 293,042,119539,Gao; Sicun,9999,0,9999,0
1668103181573,CSE 293,043,119540,Weibel; Nadir,9999,0,9999,0
1668103181573,CSE 293,044,119541,Gupta; Rajesh K.,9999,0,9999,0
1668103181573,CSE 293,045,126410,Vaccaro; Kristen Marie,9999,0,9999,0
1668103181573,CSE 293,046,126411,Klemke; Richard,9999,0,9999,0
1668103181999,CSE 294,A00,102459,Voelker; Geoffrey M.,0,0,0,0
1668103181999,CSE 294,B00,111322,Orailoglu; Alex,0,0,0,0
1668103182424,DSE 201,A00,096914,Deutsch; Alin Bernard,30,0,30,0
1668103182846,DSE 210,A00,096915,Dasgupta; Sanjoy,30,0,30,0
1668103183272,DSE 260A,A00,096916,Altintas De Callaf; Ilkay,30,0,30,0
1668103183703,ECE 200,001,103586,Antipa; Nicholas A,9999,0,9999,0
1668103183703,ECE 200,002,103587,Atanasov; Nikolay A.,9999,0,9999,0
1668103183703,ECE 200,003,103588,Bharadia; Dinesh,9999,0,9999,0
1668103183703,ECE 200,004,103589,Cheng; Chung Kuan,9999,0,9999,0
1668103183703,ECE 200,005,103590,Cosman; Pamela C.,9999,0,9999,0
1668103183703,ECE 200,006,103591,Dayeh; Shadi Ahmad,9999,0,9999,0
1668103183703,ECE 200,007,103592,Fainman; Yeshaiahu,9999,0,9999,0
1668103183703,ECE 200,008,103593,Ford; Joseph Earl,9999,0,9999,0
1668103183703,ECE 200,009,103594,Franceschetti; Massimo,9999,0,9999,0
1668103183703,ECE 200,010,103595,Fullerton; Eric E,9999,0,9999,0
1668103183703,ECE 200,011,103596,Galton; Ian A,9999,0,9999,0
1668103183703,ECE 200,012,103597,Gilja; Vikash,9999,0,9999,0
1668103183703,ECE 200,013,103598,Hall; Drew A.,9999,0,9999,0
1668103183703,ECE 200,014,103599,Hsueh; Tzu-Chien,9999,0,9999,0
1668103183703,ECE 200,015,103600,Javidi; Tara,9999,0,9999,0
1668103183703,ECE 200,016,103601,Kahng; Andrew Byun,9999,0,9999,0
1668103183703,ECE 200,017,103602,Kim; Young-Han,9999,0,9999,0
1668103183703,ECE 200,018,103603,Koushanfar; Farinaz,9999,0,9999,0
1668103183703,ECE 200,019,103604,Kuzum; Duygu,9999,0,9999,0
1668103183703,ECE 200,020,103605,Le; Hanh-Phuc,9999,0,9999,0
1668103183703,ECE 200,021,103606,Lin; Bill,9999,0,9999,0
1668103183703,ECE 200,022,103607,Liu; Zhaowei,9998,0,9999,1
1668103183703,ECE 200,023,103608,Lo; Yu-Hwa,9999,0,9999,0
1668103183703,ECE 200,024,103609,Lomakin; Vitaliy,9999,0,9999,0
1668103183703,ECE 200,025,103610,Mercier; Patrick Philip,9999,0,9999,0
1668103183703,ECE 200,026,103611,Meyer; Florian,9999,0,9999,0
1668103183703,ECE 200,027,103612,Milstein; Laurence B.,9999,0,9999,0
1668103183703,ECE 200,028,103613,Mir Arabbaygi; Siavash,9999,0,9999,0
1668103183703,ECE 200,029,103614,Mookherjea; Shayan,9999,0,9999,0
1668103183703,ECE 200,030,103615,Morris; Karcher William,9999,0,9999,0
1668103183703,ECE 200,031,103616,Ng; Tse Nga,9999,0,9999,0
1668103183703,ECE 200,032,103617,Nguyen; Truong Quang,9999,0,9999,0
1668103183703,ECE 200,033,103618,Nomura; Kenji,9999,0,9999,0
1668103183703,ECE 200,034,103619,Orlitsky; Alon,9999,0,9999,0
1668103183703,ECE 200,035,103620,Pal; Piya,9999,0,9999,0
1668103183703,ECE 200,036,103621,Papen; George C.,9999,0,9999,0
1668103183703,ECE 200,037,103622,Radic; Stojan,9999,0,9999,0
1668103183703,ECE 200,038,103623,Rao; Bhaskar D.,9999,0,9999,0
1668103183703,ECE 200,039,103624,Rao; Ramesh R,9999,0,9999,0
1668103183703,ECE 200,040,103625,Rebeiz; Gabriel,9999,0,9999,0
1668103183703,ECE 200,041,103626,Sanford; John R,9999,0,9999,0
1668103183703,ECE 200,042,103627,Siegel; Paul H.,9999,0,9999,0
1668103183703,ECE 200,043,103628,Sievenpiper; Daniel F.,9999,0,9999,0
1668103183703,ECE 200,044,103629,Sworder; David D.,9999,0,9999,0
1668103183703,ECE 200,045,103630,Taur; Yuan,9999,0,9999,0
1668103183703,ECE 200,046,103631,Touri; Behrouz,9999,0,9999,0
1668103183703,ECE 200,047,103632,Trivedi; Mohan M.,9999,0,9999,0
1668103183703,ECE 200,048,103633,Vasconcelos; Nuno,9999,0,9999,0
1668103183703,ECE 200,049,103634,Wang; Xiaolong,9999,0,9999,0
1668103183703,ECE 200,050,103635,Xie; Pengtao,9999,0,9999,0
1668103183703,ECE 200,051,103636,Yip; Michael,9999,0,9999,0
1668103183703,ECE 200,052,103637,Zeger; Kenneth A.,999,0,999,0
1668103183703,ECE 200,053,103638,Zhang; Xinyu,9999,0,9999,0
1668103183703,ECE 200,054,103639,Turakhia; Yatish Girish,9999,0,9999,0
1668103183703,ECE 200,055,103640,Kang; Mingu,9999,0,9999,0
1668103183703,ECE 200,056,103641,Shi; Yuanyuan,9999,0,9999,0
1668103183703,ECE 200,057,103642,Wang; Edward Jay,9999,0,9999,0
1668103183703,ECE 200,058,103643,Zheng; Yang,9999,0,9999,0
1668103184128,ECE 202,A00,103644,Kuzum; Duygu,0,0,0,0
1668103184552,ECE 212BN,A00,103646,Ng; Tse Nga,0,0,0,0
1668103184992,ECE 221,A00,111493,Staff,0,0,0,0
1668103185420,ECE 222B,A00,103647,Lomakin; Vitaliy,0,0,0,0
1668103185845,ECE 230B,A00,103648,Taur; Yuan,0,0,0,0
1668103186276,ECE 238B,A00,103649,Garay; Javier,0,0,0,0
1668103186699,ECE 240B,A00,112900,Fainman; Yeshaiahu,0,0,0,0
1668103187128,ECE 247A,A00,103650,Jokerst; Jesse Vincent,0,0,0,0
1668103187551,ECE 247B,A00,103651,Wang; Joseph,0,0,0,0
1668103187980,ECE 250,A00,103652,Siegel; Paul H.,0,0,0,0
1668103188409,ECE 251A,A00,103654,Rao; Bhaskar D.,0,0,0,0
1668103188835,ECE 257B,A00,103655,Bharadia; Dinesh,0,0,0,0
1668103189260,ECE 258A,A00,103656,Milstein; Laurence B.,0,0,0,0
1668103189684,ECE 260B,A00,103658,Kang; Mingu,0,0,0,0
1668103190108,ECE 264A,A00,103659,Galton; Ian A,0,0,0,0
1668103190538,ECE 265A,A00,103661,Gudem; Prasad S.S.,0,0,0,0
1668103190966,ECE 265D,A00,103662,Gudem; Prasad S.S.,0,0,0,0
1668103191402,ECE 268,A00,103663,Koushanfar; Farinaz,0,0,0,0
1668103191833,ECE 269,A01,103665,Pal; Piya,0,0,0,0
1668103192256,ECE 271B,A00,103666,Vasconcelos; Manuela,0,0,0,0
1668103192679,ECE 276A,A00,103667,Atanasov; Nikolay A.,0,0,0,0
1668103193129,ECE 277,A00,103668,An; Cheolhong,0,0,0,0
1668103193563,ECE 279,A00,117947,Hall; Drew A.,0,0,0,0
1668103194421,ECE 283,A00,103670,Hsueh; Tzu-Chien,0,0,0,0
1668103194843,ECE 284,A00,103671,Turakhia; Yatish Girish,0,0,0,0
1668103195275,ECE 285,A00,103672,Zheng; Yang,0,0,0,0
1668103195275,ECE 285,B00,103673,Sworder; David D.,0,0,0,0
1668103195703,ECE 287,A00,103676,Javidi; Tara,0,0,0,0
1668103196141,MATH 200B,A00,098023,Salehi Golsefidy; Alireza,12,0,15,3
1668103196572,MATH 202B,A00,098024,Rhoades; Brendon Patrick,9,0,15,6
1668103196997,MATH 203B,A00,098025,Oprea; Dragos N.,10,0,15,5
1668103197420,MATH 204B,A00,098026,Sorensen; Claus M,13,0,15,2
1668103197843,MATH 208,A00,098027,Izadi; Elham,7,0,10,3
1668103198290,MATH 209,A00,098028,Pollack; Aaron,10,0,10,0
1668103198724,MATH 211A,A00,112919,Rogalski; Daniel,9,0,10,1
1668103199155,MATH 211B,A00,112920,Seward; Brandon M.,9,0,10,1
1668103199584,MATH 218,A00,098029,Li; Bo,10,0,10,0
1668103200016,MATH 220B,A00,098030,Novak; Jonathan I,11,0,15,4
1668103200447,MATH 221A,A00,098031,Ebenfelt; Peter F,13,0,15,2
1668103201262,MATH 231B,A00,098032,Zlatos; Andrej,12,0,15,3
1668103201705,MATH 240B,A00,098033,Ni; Lei,9,0,15,6
1668103202141,MATH 243,A00,098034,Jekel; David Andrew,10,0,10,0
1668103202575,MATH 245A,A00,098035,Nie; Jiawang,0,0,15,16
1668103202997,MATH 248,A00,098036,Bejenaru; Ioan,10,0,10,0
1668103203425,MATH 250B,A00,098037,Spolaor; Luca,14,0,15,1
1668103203847,MATH 258,A00,098038,Ni; Lei,10,0,10,0
1668103204280,MATH 264B,A00,098041,Rhoades; Brendon Patrick,9,0,15,6
1668103204758,MATH 268,A00,098042,Buss; Samuel R,10,0,10,0
1668103205189,MATH 269,A00,098043,Rhoades; Brendon Patrick,10,0,10,0
1668103205632,MATH 270B,A00,098044,Li; Bo,11,0,15,4
1668103206168,MATH 272B,A00,098045,Holst; Michael J,13,0,15,2
1668103206600,MATH 273A,A00,098046,Tian; Xiaochuan,10,0,15,5
1668103207035,MATH 275,A01,098048,Tian; Xiaochuan,6,0,10,4
1668103207457,MATH 278A,A00,098049,Holst; Michael J,8,0,10,2
1668103207893,MATH 278B,A00,098050,Cloninger; Alexander,10,0,10,0
1668103208322,MATH 278C,A00,098051,Nie; Jiawang,7,0,10,3
1668103208792,MATH 280B,A00,098052,Zheng; Tianyi,10,0,15,5
1668103209217,MATH 281B,A00,098053,Bradic; Jelena,2,0,15,13
1668103209645,MATH 282B,A00,098054,Arias-Castro; Ery,0,0,15,15
1668103210068,MATH 285,A00,098055,Fitzsimmons; Patrick J,0,0,15,17
1668103210492,MATH 287B,A00,098056,Arias-Castro; Ery,3,0,15,12
1668103210925,MATH 288,A00,098057,Agarwal; Pooja,9,0,10,1
1668103210925,MATH 288,B00,098058,Zhang; Danna,8,0,10,2
1668103210925,MATH 288,C00,098059,Williams; Ruth J,10,0,10,0
1668103211366,MATH 290B,A00,098060,Roberts; Justin Deritter,13,0,15,2
1668103211832,MATH 292,A00,098061,Belmont; Eva Kinoshita,10,0,10,0
1668103212259,MATH 295,A00,098062,Suk; Andrew Hoon,48,0,50,2
1668103212690,MATH 296,A00,098063,Novak; Jonathan I,20,0,20,0
1668103213114,MATH 297,001,098064,Gamst; Anthony Collins,9997,0,9999,2
1668103718345,COGS 205,A00,101395,Chiba; Andrea,19,0,20,1
1668103718779,COGS 210B,001,101404,Greene; Deanna Jacquelyn,9998,0,9999,1
1668103718779,COGS 210B,002,101417,Xia; Haijun,9999,0,9999,0
1668103718779,COGS 210B,003,101422,Nitz; Douglas A.,9999,0,9999,0
1668103718779,COGS 210B,004,101423,Hollan; James D.,9998,0,9999,1
1668103718779,COGS 210B,005,101424,Deak; Gedeon O.,9998,0,9999,1
1668103718779,COGS 210B,006,101425,Rossano; Federico,9999,0,9999,0
1668103719216,COGS 211B,A00,101427,Coulson; Seana M,9996,0,9999,3
1668103719639,COGS 220,A00,101428,Hollan; James D.,0,0,25,25
1668103720078,COGS 229,A00,101429,Dow; Steven P,18,0,25,7
1668103720508,COGS 230,A00,101430,Klemmer; Scott R,13,0,17,4
1668103720931,COGS 234,A00,101431,Xia; Haijun,3,0,25,22
1668103721359,COGS 260,A00,101432,Kiyonaga; Anastasia,19,0,25,6
1668103721359,COGS 260,B00,101433,Kirsh; David Joel,16,0,25,9
1668103721793,CSE 202,A00,102371,Impagliazzo; Russell,0,0,0,0
1668103722221,CSE 203B,A01,102373,Cheng; Chung Kuan,0,0,0,0
1668103722650,CSE 208,A00,102374,Micciancio; Daniele,0,0,0,0
1668103723079,CSE 209A,A00,112895,Impagliazzo; Russell,0,0,15,15
1668103723506,CSE 209B,A00,108005,Bellare; Mihir,0,0,0,0
1668103723933,CSE 210,A00,113163,Coblenz; Michael J,0,0,0,0
1668103724359,CSE 219,A00,106111,Dow; Steven P,0,0,20,20
1668103724782,CSE 221,A00,102376,Voelker; Geoffrey M.,0,0,0,0
1668103725204,CSE 224,A01,102378,Porter; George M,0,0,0,0
1668103725633,CSE 229A,A00,102379,Savage; Stefan,0,0,0,0
1668103726070,CSE 229C,A00,102380,Munyaka; Imani N. S.,0,0,0,0
1668103726494,CSE 232B,A00,102382,Deutsch; Alin Bernard,0,0,0,0
1668103726926,CSE 234,A01,112904,Kumar; Arun Kumar,0,0,0,0
1668103727352,CSE 237A,A00,102383,Rosing; Tajana Simunic,0,0,0,0
1668103727776,CSE 239A,A00,102384,Deutsch; Alin Bernard,0,0,0,0
1668103728209,CSE 239B,A00,102385,Polikarpova; Nadezhda,0,0,0,0
1668103728640,CSE 240A,A00,102386,Pannuto; Patrick William,0,0,0,0
1668103729067,CSE 240B,A00,102387,Zhao; Jishen,0,0,0,0
1668103729491,CSE 241A,A00,106406,Kang; Mingu,0,0,0,0
1668103729922,CSE 249B,A00,102388,Kahng; Andrew Byun,0,0,8,8
1668103730350,CSE 251B,A01,102392,Cottrell; Garrison W,0,0,0,0
1668103730350,CSE 251B,A02,102393,Cottrell; Garrison W,0,0,0,0
1668103730789,CSE 252B,A00,102394,Ochoa; Benjamin Lawrence,0,0,0,0
1668103731217,CSE 257,A01,102396,Gao; Sicun,0,0,0,0
1668103731642,CSE 272,A00,102397,Li; Tzumao,0,0,0,0
1668103732067,CSE 274,A00,111323,Chern; Albert Ren-Haur,0,0,0,0
1668103732498,CSE 282,A00,102398,Pevzner; Pavel Arkadjevich,0,0,0,0
1668103732922,CSE 284,A00,114175,Gymrek; Melissa Ann,0,0,0,0
1668103733360,CSE 290,A00,102399,Chandraker; Manmohan Krishna,0,0,0,0
1668103733360,CSE 290,B00,102400,Vaccaro; Kristen Marie,0,0,25,25
1668103733360,CSE 290,C00,102414,Pannuto; Patrick William,0,0,25,25
1668103733360,CSE 290,D00,102427,Pevzner; Pavel Arkadjevich,0,0,0,0
1668103733360,CSE 290,E00,102429,Zhao; Jishen,0,0,0,0
1668103733360,CSE 290,F00,102436,Tullsen; Dean Michael,0,0,0,0
1668103733360,CSE 290,G00,102440,Christensen; Henrik I,0,0,20,20
1668103733799,CSE 291,A00,102443,Su; Hao,0,0,0,0
1668103733799,CSE 291,B00,102448,Polikarpova; Nadezhda,0,0,0,0
1668103733799,CSE 291,C00,102453,Vaccaro; Kristen Marie,0,0,0,0
1668103733799,CSE 291,D00,111343,Savage; Stefan,0,0,0,0
1668103733799,CSE 291,E00,116474,Claffy; Kimberly Claire,0,0,0,0
1668103733799,CSE 291,F00,116479,Pasquale; Joseph,0,0,0,0
1668103734274,CSE 293,001,119111,Bafna; Vineet,9999,0,9999,0
1668103734274,CSE 293,002,119118,Bellare; Mihir,9999,0,9999,0
1668103734274,CSE 293,003,119122,Berg-Kirkpatrick; Taylor D,9999,0,9999,0
1668103734274,CSE 293,004,119135,Christensen; Henrik I,9999,0,9999,0
1668103734274,CSE 293,005,119142,Cottrell; Garrison W,9999,0,9999,0
1668103734274,CSE 293,006,119146,Deutsch; Alin Bernard,9999,0,9999,0
1668103734274,CSE 293,007,119159,Esmaeilzadeh; Hadi,9999,0,9999,0
1668103734274,CSE 293,008,119166,Freund; Yoav,9999,0,9999,0
1668103734274,CSE 293,009,119170,Griswold; William G.,9999,0,9999,0
1668103734274,CSE 293,010,119183,Gymrek; Melissa Ann,9999,0,9999,0
1668103734274,CSE 293,011,119190,Heninger; Nadia A,9999,0,9999,0
1668103734274,CSE 293,012,119230,Impagliazzo; Russell,9999,0,9999,0
1668103734274,CSE 293,013,119232,Jhala; Ranjit,9999,0,9999,0
1668103734274,CSE 293,014,119233,Kahng; Andrew Byun,9999,0,9999,0
1668103734274,CSE 293,015,119298,Kane; Daniel Mertz,9999,0,9999,0
1668103734274,CSE 293,016,119299,Kriegman; David J,9999,0,9999,0
1668103734274,CSE 293,017,119300,Kumar; Arun Kumar,9999,0,9999,0
1668103734274,CSE 293,018,119301,Lerner; Sorin,9999,0,9999,0
1668103734274,CSE 293,019,119302,Lovett; Shachar,9999,0,9999,0
1668103734274,CSE 293,020,119303,McAuley; Julian John,9999,0,9999,0
1668103734274,CSE 293,021,119304,Micciancio; Daniele,9999,0,9999,0
1668103734274,CSE 293,022,119367,Orailoglu; Alex,9999,0,9999,0
1668103734274,CSE 293,023,119382,Paturi; Ramamohan,9999,0,9999,0
1668103734274,CSE 293,024,119404,Polikarpova; Nadezhda,9999,0,9999,0
1668103734274,CSE 293,025,119406,Politz; Joseph Gibbs,9999,0,9999,0
1668103734274,CSE 293,026,119411,Porter; George M,9999,0,9999,0
1668103734274,CSE 293,027,119414,Porter; Leonard Emerson,9999,0,9999,0
1668103734274,CSE 293,028,119416,Ramamoorthi; Ravi,9999,0,9999,0
1668103734274,CSE 293,029,119417,Sahoo; Debashis,9999,0,9999,0
1668103734274,CSE 293,030,119420,Saul; Lawrence,9999,0,9999,0
1668103734274,CSE 293,031,119421,Savage; Stefan,9999,0,9999,0
1668103734274,CSE 293,032,119425,Schulze; Jurgen P.,9999,0,9999,0
1668103734274,CSE 293,033,119426,Snoeren; Alex C.,9999,0,9999,0
1668103734274,CSE 293,034,119428,Shang; Jingbo,9999,0,9999,0
1668103734274,CSE 293,035,119430,Stefan; Deian,9999,0,9999,0
1668103734274,CSE 293,036,119431,Su; Hao,9999,0,9999,0
1668103734274,CSE 293,037,119433,Swanson; Steven James,9999,0,9999,0
1668103734274,CSE 293,038,119435,Tullsen; Dean Michael,9999,0,9999,0
1668103734274,CSE 293,039,119483,Voelker; Geoffrey M.,9999,0,9999,0
1668103734274,CSE 293,040,119537,Zhao; Jishen,9999,0,9999,0
1668103734274,CSE 293,041,119538,Zhou; Yuan-Yuan,9999,0,9999,0
1668103734274,CSE 293,042,119539,Gao; Sicun,9999,0,9999,0
1668103734274,CSE 293,043,119540,Weibel; Nadir,9999,0,9999,0
1668103734274,CSE 293,044,119541,Gupta; Rajesh K.,9999,0,9999,0
1668103734274,CSE 293,045,126410,Vaccaro; Kristen Marie,9999,0,9999,0
1668103734274,CSE 293,046,126411,Klemke; Richard,9999,0,9999,0
1668103734701,CSE 294,A00,102459,Voelker; Geoffrey M.,0,0,0,0
1668103734701,CSE 294,B00,111322,Orailoglu; Alex,0,0,0,0
1668103735132,DSE 201,A00,096914,Deutsch; Alin Bernard,30,0,30,0
1668103735556,DSE 210,A00,096915,Dasgupta; Sanjoy,30,0,30,0
1668103735985,DSE 260A,A00,096916,Altintas De Callaf; Ilkay,30,0,30,0
1668103736452,ECE 200,001,103586,Antipa; Nicholas A,9999,0,9999,0
1668103736452,ECE 200,002,103587,Atanasov; Nikolay A.,9999,0,9999,0
1668103736452,ECE 200,003,103588,Bharadia; Dinesh,9999,0,9999,0
1668103736452,ECE 200,004,103589,Cheng; Chung Kuan,9999,0,9999,0
1668103736452,ECE 200,005,103590,Cosman; Pamela C.,9999,0,9999,0
1668103736452,ECE 200,006,103591,Dayeh; Shadi Ahmad,9999,0,9999,0
1668103736452,ECE 200,007,103592,Fainman; Yeshaiahu,9999,0,9999,0
1668103736452,ECE 200,008,103593,Ford; Joseph Earl,9999,0,9999,0
1668103736452,ECE 200,009,103594,Franceschetti; Massimo,9999,0,9999,0
1668103736452,ECE 200,010,103595,Fullerton; Eric E,9999,0,9999,0
1668103736452,ECE 200,011,103596,Galton; Ian A,9999,0,9999,0
1668103736452,ECE 200,012,103597,Gilja; Vikash,9999,0,9999,0
1668103736452,ECE 200,013,103598,Hall; Drew A.,9999,0,9999,0
1668103736452,ECE 200,014,103599,Hsueh; Tzu-Chien,9999,0,9999,0
1668103736452,ECE 200,015,103600,Javidi; Tara,9999,0,9999,0
1668103736452,ECE 200,016,103601,Kahng; Andrew Byun,9999,0,9999,0
1668103736452,ECE 200,017,103602,Kim; Young-Han,9999,0,9999,0
1668103736452,ECE 200,018,103603,Koushanfar; Farinaz,9999,0,9999,0
1668103736452,ECE 200,019,103604,Kuzum; Duygu,9999,0,9999,0
1668103736452,ECE 200,020,103605,Le; Hanh-Phuc,9999,0,9999,0
1668103736452,ECE 200,021,103606,Lin; Bill,9999,0,9999,0
1668103736452,ECE 200,022,103607,Liu; Zhaowei,9998,0,9999,1
1668103736452,ECE 200,023,103608,Lo; Yu-Hwa,9999,0,9999,0
1668103736452,ECE 200,024,103609,Lomakin; Vitaliy,9999,0,9999,0
1668103736452,ECE 200,025,103610,Mercier; Patrick Philip,9999,0,9999,0
1668103736452,ECE 200,026,103611,Meyer; Florian,9999,0,9999,0
1668103736452,ECE 200,027,103612,Milstein; Laurence B.,9999,0,9999,0
1668103736452,ECE 200,028,103613,Mir Arabbaygi; Siavash,9999,0,9999,0
1668103736452,ECE 200,029,103614,Mookherjea; Shayan,9999,0,9999,0
1668103736452,ECE 200,030,103615,Morris; Karcher William,9999,0,9999,0
1668103736452,ECE 200,031,103616,Ng; Tse Nga,9999,0,9999,0
1668103736452,ECE 200,032,103617,Nguyen; Truong Quang,9999,0,9999,0
1668103736452,ECE 200,033,103618,Nomura; Kenji,9999,0,9999,0
1668103736452,ECE 200,034,103619,Orlitsky; Alon,9999,0,9999,0
1668103736452,ECE 200,035,103620,Pal; Piya,9999,0,9999,0
1668103736452,ECE 200,036,103621,Papen; George C.,9999,0,9999,0
1668103736452,ECE 200,037,103622,Radic; Stojan,9999,0,9999,0
1668103736452,ECE 200,038,103623,Rao; Bhaskar D.,9999,0,9999,0
1668103736452,ECE 200,039,103624,Rao; Ramesh R,9999,0,9999,0
1668103736452,ECE 200,040,103625,Rebeiz; Gabriel,9999,0,9999,0
1668103736452,ECE 200,041,103626,Sanford; John R,9999,0,9999,0
1668103736452,ECE 200,042,103627,Siegel; Paul H.,9999,0,9999,0
1668103736452,ECE 200,043,103628,Sievenpiper; Daniel F.,9999,0,9999,0
1668103736452,ECE 200,044,103629,Sworder; David D.,9999,0,9999,0
1668103736452,ECE 200,045,103630,Taur; Yuan,9999,0,9999,0
1668103736452,ECE 200,046,103631,Touri; Behrouz,9999,0,9999,0
1668103736452,ECE 200,047,103632,Trivedi; Mohan M.,9999,0,9999,0
1668103736452,ECE 200,048,103633,Vasconcelos; Nuno,9999,0,9999,0
1668103736452,ECE 200,049,103634,Wang; Xiaolong,9999,0,9999,0
1668103736452,ECE 200,050,103635,Xie; Pengtao,9999,0,9999,0
1668103736452,ECE 200,051,103636,Yip; Michael,9999,0,9999,0
1668103736452,ECE 200,052,103637,Zeger; Kenneth A.,999,0,999,0
1668103736452,ECE 200,053,103638,Zhang; Xinyu,9999,0,9999,0
1668103736452,ECE 200,054,103639,Turakhia; Yatish Girish,9999,0,9999,0
1668103736452,ECE 200,055,103640,Kang; Mingu,9999,0,9999,0
1668103736452,ECE 200,056,103641,Shi; Yuanyuan,9999,0,9999,0
1668103736452,ECE 200,057,103642,Wang; Edward Jay,9999,0,9999,0
1668103736452,ECE 200,058,103643,Zheng; Yang,9999,0,9999,0
1668103736879,ECE 202,A00,103644,Kuzum; Duygu,0,0,0,0
1668103737315,ECE 212BN,A00,103646,Ng; Tse Nga,0,0,0,0
1668103737738,ECE 221,A00,111493,Staff,0,0,0,0
1668103738175,ECE 222B,A00,103647,Lomakin; Vitaliy,0,0,0,0
1668103738604,ECE 230B,A00,103648,Taur; Yuan,0,0,0,0
1668103739030,ECE 238B,A00,103649,Garay; Javier,0,0,0,0
1668103739453,ECE 240B,A00,112900,Fainman; Yeshaiahu,0,0,0,0
1668103739879,ECE 247A,A00,103650,Jokerst; Jesse Vincent,0,0,0,0
1668103740310,ECE 247B,A00,103651,Wang; Joseph,0,0,0,0
1668103740732,ECE 250,A00,103652,Siegel; Paul H.,0,0,0,0
1668103741164,ECE 251A,A00,103654,Rao; Bhaskar D.,0,0,0,0
1668103741593,ECE 257B,A00,103655,Bharadia; Dinesh,0,0,0,0
1668103742016,ECE 258A,A00,103656,Milstein; Laurence B.,0,0,0,0
1668103742437,ECE 260B,A00,103658,Kang; Mingu,0,0,0,0
1668103742871,ECE 264A,A00,103659,Galton; Ian A,0,0,0,0
1668103743309,ECE 265A,A00,103661,Gudem; Prasad S.S.,0,0,0,0
1668103743732,ECE 265D,A00,103662,Gudem; Prasad S.S.,0,0,0,0
1668103744161,ECE 268,A00,103663,Koushanfar; Farinaz,0,0,0,0
1668103744589,ECE 269,A01,103665,Pal; Piya,0,0,0,0
1668103745017,ECE 271B,A00,103666,Vasconcelos; Manuela,0,0,0,0
1668103745443,ECE 276A,A00,103667,Atanasov; Nikolay A.,0,0,0,0
1668103745866,ECE 277,A00,103668,An; Cheolhong,0,0,0,0
1668103746287,ECE 279,A00,117947,Hall; Drew A.,0,0,0,0
1668103747144,ECE 283,A00,103670,Hsueh; Tzu-Chien,0,0,0,0
1668103747574,ECE 284,A00,103671,Turakhia; Yatish Girish,0,0,0,0
1668103747996,ECE 285,A00,103672,Zheng; Yang,0,0,0,0
1668103747996,ECE 285,B00,103673,Sworder; David D.,0,0,0,0
1668103748431,ECE 287,A00,103676,Javidi; Tara,0,0,0,0
1668103748855,MATH 200B,A00,098023,Salehi Golsefidy; Alireza,12,0,15,3
1668103749280,MATH 202B,A00,098024,Rhoades; Brendon Patrick,9,0,15,6
1668103749727,MATH 203B,A00,098025,Oprea; Dragos N.,10,0,15,5
1668103750251,MATH 204B,A00,098026,Sorensen; Claus M,13,0,15,2
1668103750673,MATH 208,A00,098027,Izadi; Elham,7,0,10,3
1668103751096,MATH 209,A00,098028,Pollack; Aaron,10,0,10,0
1668103751526,MATH 211A,A00,112919,Rogalski; Daniel,9,0,10,1
1668103751950,MATH 211B,A00,112920,Seward; Brandon M.,9,0,10,1
1668103752375,MATH 218,A00,098029,Li; Bo,10,0,10,0
1668103752811,MATH 220B,A00,098030,Novak; Jonathan I,11,0,15,4
1668103753234,MATH 221A,A00,098031,Ebenfelt; Peter F,13,0,15,2
1668103753658,MATH 231B,A00,098032,Zlatos; Andrej,12,0,15,3
1668103754088,MATH 240B,A00,098033,Ni; Lei,9,0,15,6
1668103754513,MATH 243,A00,098034,Jekel; David Andrew,10,0,10,0
1668103754935,MATH 245A,A00,098035,Nie; Jiawang,0,0,15,16
1668103755358,MATH 248,A00,098036,Bejenaru; Ioan,10,0,10,0
1668103755780,MATH 250B,A00,098037,Spolaor; Luca,14,0,15,1
1668103756203,MATH 258,A00,098038,Ni; Lei,10,0,10,0
1668103756626,MATH 264B,A00,098041,Rhoades; Brendon Patrick,9,0,15,6
1668103757050,MATH 268,A00,098042,Buss; Samuel R,10,0,10,0
1668103757472,MATH 269,A00,098043,Rhoades; Brendon Patrick,10,0,10,0
1668103757898,MATH 270B,A00,098044,Li; Bo,11,0,15,4
1668103758330,MATH 272B,A00,098045,Holst; Michael J,13,0,15,2
1668103758755,MATH 273A,A00,098046,Tian; Xiaochuan,10,0,15,5
1668103759180,MATH 275,A01,098048,Tian; Xiaochuan,6,0,10,4
1668103759620,MATH 278A,A00,098049,Holst; Michael J,8,0,10,2
1668103760055,MATH 278B,A00,098050,Cloninger; Alexander,10,0,10,0
1668103760479,MATH 278C,A00,098051,Nie; Jiawang,7,0,10,3
1668103760902,MATH 280B,A00,098052,Zheng; Tianyi,10,0,15,5
1668103761328,MATH 281B,A00,098053,Bradic; Jelena,2,0,15,13
1668103761751,MATH 282B,A00,098054,Arias-Castro; Ery,0,0,15,15
1668103762180,MATH 285,A00,098055,Fitzsimmons; Patrick J,0,0,15,17
1668103762622,MATH 287B,A00,098056,Arias-Castro; Ery,3,0,15,12
1668103763047,MATH 288,A00,098057,Agarwal; Pooja,9,0,10,1
1668103763047,MATH 288,B00,098058,Zhang; Danna,8,0,10,2
1668103763047,MATH 288,C00,098059,Williams; Ruth J,10,0,10,0
1668103763481,MATH 290B,A00,098060,Roberts; Justin Deritter,13,0,15,2
1668103763906,MATH 292,A00,098061,Belmont; Eva Kinoshita,10,0,10,0
1668103764333,MATH 295,A00,098062,Suk; Andrew Hoon,48,0,50,2
1668103764755,MATH 296,A00,098063,Novak; Jonathan I,20,0,20,0
1668103765180,MATH 297,001,098064,Gamst; Anthony Collins,9997,0,9999,2
1668104269622,COGS 205,A00,101395,Chiba; Andrea,19,0,20,1
1668104270046,COGS 210B,001,101404,Greene; Deanna Jacquelyn,9998,0,9999,1
1668104270046,COGS 210B,002,101417,Xia; Haijun,9999,0,9999,0
1668104270046,COGS 210B,003,101422,Nitz; Douglas A.,9999,0,9999,0
1668104270046,COGS 210B,004,101423,Hollan; James D.,9998,0,9999,1
1668104270046,COGS 210B,005,101424,Deak; Gedeon O.,9998,0,9999,1
1668104270046,COGS 210B,006,101425,Rossano; Federico,9999,0,9999,0
1668104270487,COGS 211B,A00,101427,Coulson; Seana M,9996,0,9999,3
1668104270912,COGS 220,A00,101428,Hollan; James D.,0,0,25,25
1668104271353,COGS 229,A00,101429,Dow; Steven P,18,0,25,7
1668104271783,COGS 230,A00,101430,Klemmer; Scott R,13,0,17,4
1668104272218,COGS 234,A00,101431,Xia; Haijun,3,0,25,22
1668104272639,COGS 260,A00,101432,Kiyonaga; Anastasia,19,0,25,6
1668104272639,COGS 260,B00,101433,Kirsh; David Joel,16,0,25,9
1668104273082,CSE 202,A00,102371,Impagliazzo; Russell,0,0,0,0
1668104273504,CSE 203B,A01,102373,Cheng; Chung Kuan,0,0,0,0
1668104273929,CSE 208,A00,102374,Micciancio; Daniele,0,0,0,0
1668104274360,CSE 209A,A00,112895,Impagliazzo; Russell,0,0,15,15
1668104274858,CSE 209B,A00,108005,Bellare; Mihir,0,0,0,0
1668104275280,CSE 210,A00,113163,Coblenz; Michael J,0,0,0,0
1668104275704,CSE 219,A00,106111,Dow; Steven P,0,0,20,20
1668104276128,CSE 221,A00,102376,Voelker; Geoffrey M.,0,0,0,0
1668104276556,CSE 224,A01,102378,Porter; George M,0,0,0,0
1668104276985,CSE 229A,A00,102379,Savage; Stefan,0,0,0,0
1668104277427,CSE 229C,A00,102380,Munyaka; Imani N. S.,0,0,0,0
1668104277856,CSE 232B,A00,102382,Deutsch; Alin Bernard,0,0,0,0
1668104278291,CSE 234,A01,112904,Kumar; Arun Kumar,0,0,0,0
1668104278723,CSE 237A,A00,102383,Rosing; Tajana Simunic,0,0,0,0
1668104279152,CSE 239A,A00,102384,Deutsch; Alin Bernard,0,0,0,0
1668104279580,CSE 239B,A00,102385,Polikarpova; Nadezhda,0,0,0,0
1668104280006,CSE 240A,A00,102386,Pannuto; Patrick William,0,0,0,0
1668104280448,CSE 240B,A00,102387,Zhao; Jishen,0,0,0,0
1668104280881,CSE 241A,A00,106406,Kang; Mingu,0,0,0,0
1668104281310,CSE 249B,A00,102388,Kahng; Andrew Byun,0,0,8,8
1668104281732,CSE 251B,A01,102392,Cottrell; Garrison W,0,0,0,0
1668104281732,CSE 251B,A02,102393,Cottrell; Garrison W,0,0,0,0
1668104282157,CSE 252B,A00,102394,Ochoa; Benjamin Lawrence,0,0,0,0
1668104282588,CSE 257,A01,102396,Gao; Sicun,0,0,0,0
1668104283025,CSE 272,A00,102397,Li; Tzumao,0,0,0,0
1668104283451,CSE 274,A00,111323,Chern; Albert Ren-Haur,0,0,0,0
1668104283875,CSE 282,A00,102398,Pevzner; Pavel Arkadjevich,0,0,0,0
1668104284298,CSE 284,A00,114175,Gymrek; Melissa Ann,0,0,0,0
1668104284750,CSE 290,A00,102399,Chandraker; Manmohan Krishna,0,0,0,0
1668104284750,CSE 290,B00,102400,Vaccaro; Kristen Marie,0,0,25,25
1668104284750,CSE 290,C00,102414,Pannuto; Patrick William,0,0,25,25
1668104284750,CSE 290,D00,102427,Pevzner; Pavel Arkadjevich,0,0,0,0
1668104284750,CSE 290,E00,102429,Zhao; Jishen,0,0,0,0
1668104284750,CSE 290,F00,102436,Tullsen; Dean Michael,0,0,0,0
1668104284750,CSE 290,G00,102440,Christensen; Henrik I,0,0,20,20
1668104285174,CSE 291,A00,102443,Su; Hao,0,0,0,0
1668104285174,CSE 291,B00,102448,Polikarpova; Nadezhda,0,0,0,0
1668104285174,CSE 291,C00,102453,Vaccaro; Kristen Marie,0,0,0,0
1668104285174,CSE 291,D00,111343,Savage; Stefan,0,0,0,0
1668104285174,CSE 291,E00,116474,Claffy; Kimberly Claire,0,0,0,0
1668104285174,CSE 291,F00,116479,Pasquale; Joseph,0,0,0,0
1668104285610,CSE 293,001,119111,Bafna; Vineet,9999,0,9999,0
1668104285610,CSE 293,002,119118,Bellare; Mihir,9999,0,9999,0
1668104285610,CSE 293,003,119122,Berg-Kirkpatrick; Taylor D,9999,0,9999,0
1668104285610,CSE 293,004,119135,Christensen; Henrik I,9999,0,9999,0
1668104285610,CSE 293,005,119142,Cottrell; Garrison W,9999,0,9999,0
1668104285610,CSE 293,006,119146,Deutsch; Alin Bernard,9999,0,9999,0
1668104285610,CSE 293,007,119159,Esmaeilzadeh; Hadi,9999,0,9999,0
1668104285610,CSE 293,008,119166,Freund; Yoav,9999,0,9999,0
1668104285610,CSE 293,009,119170,Griswold; William G.,9999,0,9999,0
1668104285610,CSE 293,010,119183,Gymrek; Melissa Ann,9999,0,9999,0
1668104285610,CSE 293,011,119190,Heninger; Nadia A,9999,0,9999,0
1668104285610,CSE 293,012,119230,Impagliazzo; Russell,9999,0,9999,0
1668104285610,CSE 293,013,119232,Jhala; Ranjit,9999,0,9999,0
1668104285610,CSE 293,014,119233,Kahng; Andrew Byun,9999,0,9999,0
1668104285610,CSE 293,015,119298,Kane; Daniel Mertz,9999,0,9999,0
1668104285610,CSE 293,016,119299,Kriegman; David J,9999,0,9999,0
1668104285610,CSE 293,017,119300,Kumar; Arun Kumar,9999,0,9999,0
1668104285610,CSE 293,018,119301,Lerner; Sorin,9999,0,9999,0
1668104285610,CSE 293,019,119302,Lovett; Shachar,9999,0,9999,0
1668104285610,CSE 293,020,119303,McAuley; Julian John,9999,0,9999,0
1668104285610,CSE 293,021,119304,Micciancio; Daniele,9999,0,9999,0
1668104285610,CSE 293,022,119367,Orailoglu; Alex,9999,0,9999,0
1668104285610,CSE 293,023,119382,Paturi; Ramamohan,9999,0,9999,0
1668104285610,CSE 293,024,119404,Polikarpova; Nadezhda,9999,0,9999,0
1668104285610,CSE 293,025,119406,Politz; Joseph Gibbs,9999,0,9999,0
1668104285610,CSE 293,026,119411,Porter; George M,9999,0,9999,0
1668104285610,CSE 293,027,119414,Porter; Leonard Emerson,9999,0,9999,0
1668104285610,CSE 293,028,119416,Ramamoorthi; Ravi,9999,0,9999,0
1668104285610,CSE 293,029,119417,Sahoo; Debashis,9999,0,9999,0
1668104285610,CSE 293,030,119420,Saul; Lawrence,9999,0,9999,0
1668104285610,CSE 293,031,119421,Savage; Stefan,9999,0,9999,0
1668104285610,CSE 293,032,119425,Schulze; Jurgen P.,9999,0,9999,0
1668104285610,CSE 293,033,119426,Snoeren; Alex C.,9999,0,9999,0
1668104285610,CSE 293,034,119428,Shang; Jingbo,9999,0,9999,0
1668104285610,CSE 293,035,119430,Stefan; Deian,9999,0,9999,0
1668104285610,CSE 293,036,119431,Su; Hao,9999,0,9999,0
1668104285610,CSE 293,037,119433,Swanson; Steven James,9999,0,9999,0
1668104285610,CSE 293,038,119435,Tullsen; Dean Michael,9999,0,9999,0
1668104285610,CSE 293,039,119483,Voelker; Geoffrey M.,9999,0,9999,0
1668104285610,CSE 293,040,119537,Zhao; Jishen,9999,0,9999,0
1668104285610,CSE 293,041,119538,Zhou; Yuan-Yuan,9999,0,9999,0
1668104285610,CSE 293,042,119539,Gao; Sicun,9999,0,9999,0
1668104285610,CSE 293,043,119540,Weibel; Nadir,9999,0,9999,0
1668104285610,CSE 293,044,119541,Gupta; Rajesh K.,9999,0,9999,0
1668104285610,CSE 293,045,126410,Vaccaro; Kristen Marie,9999,0,9999,0
1668104285610,CSE 293,046,126411,Klemke; Richard,9999,0,9999,0
1668104286038,CSE 294,A00,102459,Voelker; Geoffrey M.,0,0,0,0
1668104286038,CSE 294,B00,111322,Orailoglu; Alex,0,0,0,0
1668104286478,DSE 201,A00,096914,Deutsch; Alin Bernard,30,0,30,0
1668104286917,DSE 210,A00,096915,Dasgupta; Sanjoy,30,0,30,0
1668104287339,DSE 260A,A00,096916,Altintas De Callaf; Ilkay,30,0,30,0
1668104287771,ECE 200,001,103586,Antipa; Nicholas A,9999,0,9999,0
1668104287771,ECE 200,002,103587,Atanasov; Nikolay A.,9999,0,9999,0
1668104287771,ECE 200,003,103588,Bharadia; Dinesh,9999,0,9999,0
1668104287771,ECE 200,004,103589,Cheng; Chung Kuan,9999,0,9999,0
1668104287771,ECE 200,005,103590,Cosman; Pamela C.,9999,0,9999,0
1668104287771,ECE 200,006,103591,Dayeh; Shadi Ahmad,9999,0,9999,0
1668104287771,ECE 200,007,103592,Fainman; Yeshaiahu,9999,0,9999,0
1668104287771,ECE 200,008,103593,Ford; Joseph Earl,9999,0,9999,0
1668104287771,ECE 200,009,103594,Franceschetti; Massimo,9999,0,9999,0
1668104287771,ECE 200,010,103595,Fullerton; Eric E,9999,0,9999,0
1668104287771,ECE 200,011,103596,Galton; Ian A,9999,0,9999,0
1668104287771,ECE 200,012,103597,Gilja; Vikash,9999,0,9999,0
1668104287771,ECE 200,013,103598,Hall; Drew A.,9999,0,9999,0
1668104287771,ECE 200,014,103599,Hsueh; Tzu-Chien,9999,0,9999,0
1668104287771,ECE 200,015,103600,Javidi; Tara,9999,0,9999,0
1668104287771,ECE 200,016,103601,Kahng; Andrew Byun,9999,0,9999,0
1668104287771,ECE 200,017,103602,Kim; Young-Han,9999,0,9999,0
1668104287771,ECE 200,018,103603,Koushanfar; Farinaz,9999,0,9999,0
1668104287771,ECE 200,019,103604,Kuzum; Duygu,9999,0,9999,0
1668104287771,ECE 200,020,103605,Le; Hanh-Phuc,9999,0,9999,0
1668104287771,ECE 200,021,103606,Lin; Bill,9999,0,9999,0
1668104287771,ECE 200,022,103607,Liu; Zhaowei,9998,0,9999,1
1668104287771,ECE 200,023,103608,Lo; Yu-Hwa,9999,0,9999,0
1668104287771,ECE 200,024,103609,Lomakin; Vitaliy,9999,0,9999,0
1668104287771,ECE 200,025,103610,Mercier; Patrick Philip,9999,0,9999,0
1668104287771,ECE 200,026,103611,Meyer; Florian,9999,0,9999,0
1668104287771,ECE 200,027,103612,Milstein; Laurence B.,9999,0,9999,0
1668104287771,ECE 200,028,103613,Mir Arabbaygi; Siavash,9999,0,9999,0
1668104287771,ECE 200,029,103614,Mookherjea; Shayan,9999,0,9999,0
1668104287771,ECE 200,030,103615,Morris; Karcher William,9999,0,9999,0
1668104287771,ECE 200,031,103616,Ng; Tse Nga,9999,0,9999,0
1668104287771,ECE 200,032,103617,Nguyen; Truong Quang,9999,0,9999,0
1668104287771,ECE 200,033,103618,Nomura; Kenji,9999,0,9999,0
1668104287771,ECE 200,034,103619,Orlitsky; Alon,9999,0,9999,0
1668104287771,ECE 200,035,103620,Pal; Piya,9999,0,9999,0
1668104287771,ECE 200,036,103621,Papen; George C.,9999,0,9999,0
1668104287771,ECE 200,037,103622,Radic; Stojan,9999,0,9999,0
1668104287771,ECE 200,038,103623,Rao; Bhaskar D.,9999,0,9999,0
1668104287771,ECE 200,039,103624,Rao; Ramesh R,9999,0,9999,0
1668104287771,ECE 200,040,103625,Rebeiz; Gabriel,9999,0,9999,0
1668104287771,ECE 200,041,103626,Sanford; John R,9999,0,9999,0
1668104287771,ECE 200,042,103627,Siegel; Paul H.,9999,0,9999,0
1668104287771,ECE 200,043,103628,Sievenpiper; Daniel F.,9999,0,9999,0
1668104287771,ECE 200,044,103629,Sworder; David D.,9999,0,9999,0
1668104287771,ECE 200,045,103630,Taur; Yuan,9999,0,9999,0
1668104287771,ECE 200,046,103631,Touri; Behrouz,9999,0,9999,0
1668104287771,ECE 200,047,103632,Trivedi; Mohan M.,9999,0,9999,0
1668104287771,ECE 200,048,103633,Vasconcelos; Nuno,9999,0,9999,0
1668104287771,ECE 200,049,103634,Wang; Xiaolong,9999,0,9999,0
1668104287771,ECE 200,050,103635,Xie; Pengtao,9999,0,9999,0
1668104287771,ECE 200,051,103636,Yip; Michael,9999,0,9999,0
1668104287771,ECE 200,052,103637,Zeger; Kenneth A.,999,0,999,0
1668104287771,ECE 200,053,103638,Zhang; Xinyu,9999,0,9999,0
1668104287771,ECE 200,054,103639,Turakhia; Yatish Girish,9999,0,9999,0
1668104287771,ECE 200,055,103640,Kang; Mingu,9999,0,9999,0
1668104287771,ECE 200,056,103641,Shi; Yuanyuan,9999,0,9999,0
1668104287771,ECE 200,057,103642,Wang; Edward Jay,9999,0,9999,0
1668104287771,ECE 200,058,103643,Zheng; Yang,9999,0,9999,0
1668104288208,ECE 202,A00,103644,Kuzum; Duygu,0,0,0,0
1668104288633,ECE 212BN,A00,103646,Ng; Tse Nga,0,0,0,0
1668104289058,ECE 221,A00,111493,Staff,0,0,0,0
1668104289493,ECE 222B,A00,103647,Lomakin; Vitaliy,0,0,0,0
1668104289916,ECE 230B,A00,103648,Taur; Yuan,0,0,0,0
1668104290345,ECE 238B,A00,103649,Garay; Javier,0,0,0,0
1668104290768,ECE 240B,A00,112900,Fainman; Yeshaiahu,0,0,0,0
1668104291195,ECE 247A,A00,103650,Jokerst; Jesse Vincent,0,0,0,0
1668104291625,ECE 247B,A00,103651,Wang; Joseph,0,0,0,0
1668104292063,ECE 250,A00,103652,Siegel; Paul H.,0,0,0,0
1668104292491,ECE 251A,A00,103654,Rao; Bhaskar D.,0,0,0,0
1668104292913,ECE 257B,A00,103655,Bharadia; Dinesh,0,0,0,0
1668104293346,ECE 258A,A00,103656,Milstein; Laurence B.,0,0,0,0
1668104293771,ECE 260B,A00,103658,Kang; Mingu,0,0,0,0
1668104294196,ECE 264A,A00,103659,Galton; Ian A,0,0,0,0
1668104294632,ECE 265A,A00,103661,Gudem; Prasad S.S.,0,0,0,0
1668104295056,ECE 265D,A00,103662,Gudem; Prasad S.S.,0,0,0,0
1668104295485,ECE 268,A00,103663,Koushanfar; Farinaz,0,0,0,0
1668104295920,ECE 269,A01,103665,Pal; Piya,0,0,0,0
1668104296342,ECE 271B,A00,103666,Vasconcelos; Manuela,0,0,0,0
1668104296783,ECE 276A,A00,103667,Atanasov; Nikolay A.,0,0,0,0
1668104297207,ECE 277,A00,103668,An; Cheolhong,0,0,0,0
1668104297635,ECE 279,A00,117947,Hall; Drew A.,0,0,0,0
1668104298494,ECE 283,A00,103670,Hsueh; Tzu-Chien,0,0,0,0
1668104298921,ECE 284,A00,103671,Turakhia; Yatish Girish,0,0,0,0
1668104299343,ECE 285,A00,103672,Zheng; Yang,0,0,0,0
1668104299343,ECE 285,B00,103673,Sworder; David D.,0,0,0,0
1668104299767,ECE 287,A00,103676,Javidi; Tara,0,0,0,0
1668104300193,MATH 200B,A00,098023,Salehi Golsefidy; Alireza,12,0,15,3
1668104300622,MATH 202B,A00,098024,Rhoades; Brendon Patrick,9,0,15,6
1668104301052,MATH 203B,A00,098025,Oprea; Dragos N.,10,0,15,5
1668104301478,MATH 204B,A00,098026,Sorensen; Claus M,13,0,15,2
1668104301912,MATH 208,A00,098027,Izadi; Elham,7,0,10,3
1668104302345,MATH 209,A00,098028,Pollack; Aaron,10,0,10,0
1668104302767,MATH 211A,A00,112919,Rogalski; Daniel,9,0,10,1
1668104303191,MATH 211B,A00,112920,Seward; Brandon M.,9,0,10,1
1668104303616,MATH 218,A00,098029,Li; Bo,10,0,10,0
1668104304040,MATH 220B,A00,098030,Novak; Jonathan I,11,0,15,4
1668104304469,MATH 221A,A00,098031,Ebenfelt; Peter F,13,0,15,2
1668104304898,MATH 231B,A00,098032,Zlatos; Andrej,12,0,15,3
1668104305328,MATH 240B,A00,098033,Ni; Lei,9,0,15,6
1668104305772,MATH 243,A00,098034,Jekel; David Andrew,10,0,10,0
1668104306205,MATH 245A,A00,098035,Nie; Jiawang,0,0,15,16
1668104306647,MATH 248,A00,098036,Bejenaru; Ioan,10,0,10,0
1668104307083,MATH 250B,A00,098037,Spolaor; Luca,14,0,15,1
1668104307509,MATH 258,A00,098038,Ni; Lei,10,0,10,0
1668104307940,MATH 264B,A00,098041,Rhoades; Brendon Patrick,9,0,15,6
1668104308365,MATH 268,A00,098042,Buss; Samuel R,10,0,10,0
1668104308789,MATH 269,A00,098043,Rhoades; Brendon Patrick,10,0,10,0
1668104309219,MATH 270B,A00,098044,Li; Bo,10,0,15,5
1668104309644,MATH 272B,A00,098045,Holst; Michael J,13,0,15,2
1668104310079,MATH 273A,A00,098046,Tian; Xiaochuan,10,0,15,5
1668104310504,MATH 275,A01,098048,Tian; Xiaochuan,6,0,10,4
1668104310929,MATH 278A,A00,098049,Holst; Michael J,8,0,10,2
1668104311363,MATH 278B,A00,098050,Cloninger; Alexander,10,0,10,0
1668104311785,MATH 278C,A00,098051,Nie; Jiawang,7,0,10,3
1668104312207,MATH 280B,A00,098052,Zheng; Tianyi,10,0,15,5
1668104312638,MATH 281B,A00,098053,Bradic; Jelena,2,0,15,13
1668104313060,MATH 282B,A00,098054,Arias-Castro; Ery,0,0,15,15
1668104313484,MATH 285,A00,098055,Fitzsimmons; Patrick J,0,0,15,17
1668104313907,MATH 287B,A00,098056,Arias-Castro; Ery,3,0,15,12
1668104314328,MATH 288,A00,098057,Agarwal; Pooja,9,0,10,1
1668104314328,MATH 288,B00,098058,Zhang; Danna,8,0,10,2
1668104314328,MATH 288,C00,098059,Williams; Ruth J,10,0,10,0
1668104314753,MATH 290B,A00,098060,Roberts; Justin Deritter,13,0,15,2
1668104315175,MATH 292,A00,098061,Belmont; Eva Kinoshita,10,0,10,0
1668104315607,MATH 295,A00,098062,Suk; Andrew Hoon,48,0,50,2
1668104316043,MATH 296,A00,098063,Novak; Jonathan I,20,0,20,0
1668104316479,MATH 297,001,098064,Gamst; Anthony Collins,9997,0,9999,2
1668104820627,COGS 205,A00,101395,Chiba; Andrea,19,0,20,1
1668104821052,COGS 210B,001,101404,Greene; Deanna Jacquelyn,9998,0,9999,1
1668104821052,COGS 210B,002,101417,Xia; Haijun,9999,0,9999,0
1668104821052,COGS 210B,003,101422,Nitz; Douglas A.,9999,0,9999,0
1668104821052,COGS 210B,004,101423,Hollan; James D.,9998,0,9999,1
1668104821052,COGS 210B,005,101424,Deak; Gedeon O.,9998,0,9999,1
1668104821052,COGS 210B,006,101425,Rossano; Federico,9999,0,9999,0
1668104821487,COGS 211B,A00,101427,Coulson; Seana M,9996,0,9999,3
1668104821911,COGS 220,A00,101428,Hollan; James D.,0,0,25,25
1668104822341,COGS 229,A00,101429,Dow; Steven P,18,0,25,7
1668104822774,COGS 230,A00,101430,Klemmer; Scott R,13,0,17,4
1668104823203,COGS 234,A00,101431,Xia; Haijun,3,0,25,22
1668104823659,COGS 260,A00,101432,Kiyonaga; Anastasia,19,0,25,6
1668104823659,COGS 260,B00,101433,Kirsh; David Joel,16,0,25,9
1668104824082,CSE 202,A00,102371,Impagliazzo; Russell,0,0,0,0
1668104824505,CSE 203B,A01,102373,Cheng; Chung Kuan,0,0,0,0
1668104824927,CSE 208,A00,102374,Micciancio; Daniele,0,0,0,0
1668104825364,CSE 209A,A00,112895,Impagliazzo; Russell,0,0,15,15
1668104825788,CSE 209B,A00,108005,Bellare; Mihir,0,0,0,0
1668104826219,CSE 210,A00,113163,Coblenz; Michael J,0,0,0,0
1668104826651,CSE 219,A00,106111,Dow; Steven P,0,0,20,20
1668104827074,CSE 221,A00,102376,Voelker; Geoffrey M.,0,0,0,0
1668104827499,CSE 224,A01,102378,Porter; George M,0,0,0,0
1668104827933,CSE 229A,A00,102379,Savage; Stefan,0,0,0,0
1668104828366,CSE 229C,A00,102380,Munyaka; Imani N. S.,0,0,0,0
1668104828797,CSE 232B,A00,102382,Deutsch; Alin Bernard,0,0,0,0
1668104829228,CSE 234,A01,112904,Kumar; Arun Kumar,0,0,0,0
1668104829671,CSE 237A,A00,102383,Rosing; Tajana Simunic,0,0,0,0
1668104830109,CSE 239A,A00,102384,Deutsch; Alin Bernard,0,0,0,0
1668104830539,CSE 239B,A00,102385,Polikarpova; Nadezhda,0,0,0,0
1668104830963,CSE 240A,A00,102386,Pannuto; Patrick William,0,0,0,0
1668104831394,CSE 240B,A00,102387,Zhao; Jishen,0,0,0,0
1668104831816,CSE 241A,A00,106406,Kang; Mingu,0,0,0,0
1668104832244,CSE 249B,A00,102388,Kahng; Andrew Byun,0,0,8,8
1668104832679,CSE 251B,A01,102392,Cottrell; Garrison W,0,0,0,0
1668104832679,CSE 251B,A02,102393,Cottrell; Garrison W,0,0,0,0
1668104833102,CSE 252B,A00,102394,Ochoa; Benjamin Lawrence,0,0,0,0
1668104833528,CSE 257,A01,102396,Gao; Sicun,0,0,0,0
1668104833952,CSE 272,A00,102397,Li; Tzumao,0,0,0,0
1668104834380,CSE 274,A00,111323,Chern; Albert Ren-Haur,0,0,0,0
1668104834804,CSE 282,A00,102398,Pevzner; Pavel Arkadjevich,0,0,0,0
1668104835231,CSE 284,A00,114175,Gymrek; Melissa Ann,0,0,0,0
1668104835653,CSE 290,A00,102399,Chandraker; Manmohan Krishna,0,0,0,0
1668104835653,CSE 290,B00,102400,Vaccaro; Kristen Marie,0,0,25,25
1668104835653,CSE 290,C00,102414,Pannuto; Patrick William,0,0,25,25
1668104835653,CSE 290,D00,102427,Pevzner; Pavel Arkadjevich,0,0,0,0
1668104835653,CSE 290,E00,102429,Zhao; Jishen,0,0,0,0
1668104835653,CSE 290,F00,102436,Tullsen; Dean Michael,0,0,0,0
1668104835653,CSE 290,G00,102440,Christensen; Henrik I,0,0,20,20
1668104836081,CSE 291,A00,102443,Su; Hao,0,0,0,0
1668104836081,CSE 291,B00,102448,Polikarpova; Nadezhda,0,0,0,0
1668104836081,CSE 291,C00,102453,Vaccaro; Kristen Marie,0,0,0,0
1668104836081,CSE 291,D00,111343,Savage; Stefan,0,0,0,0
1668104836081,CSE 291,E00,116474,Claffy; Kimberly Claire,0,0,0,0
1668104836081,CSE 291,F00,116479,Pasquale; Joseph,0,0,0,0
1668104836524,CSE 293,001,119111,Bafna; Vineet,9999,0,9999,0
1668104836524,CSE 293,002,119118,Bellare; Mihir,9999,0,9999,0
1668104836524,CSE 293,003,119122,Berg-Kirkpatrick; Taylor D,9999,0,9999,0
1668104836524,CSE 293,004,119135,Christensen; Henrik I,9999,0,9999,0
1668104836524,CSE 293,005,119142,Cottrell; Garrison W,9999,0,9999,0
1668104836524,CSE 293,006,119146,Deutsch; Alin Bernard,9999,0,9999,0
1668104836524,CSE 293,007,119159,Esmaeilzadeh; Hadi,9999,0,9999,0
1668104836524,CSE 293,008,119166,Freund; Yoav,9999,0,9999,0
1668104836524,CSE 293,009,119170,Griswold; William G.,9999,0,9999,0
1668104836524,CSE 293,010,119183,Gymrek; Melissa Ann,9999,0,9999,0
1668104836524,CSE 293,011,119190,Heninger; Nadia A,9999,0,9999,0
1668104836524,CSE 293,012,119230,Impagliazzo; Russell,9999,0,9999,0
1668104836524,CSE 293,013,119232,Jhala; Ranjit,9999,0,9999,0
1668104836524,CSE 293,014,119233,Kahng; Andrew Byun,9999,0,9999,0
1668104836524,CSE 293,015,119298,Kane; Daniel Mertz,9999,0,9999,0
1668104836524,CSE 293,016,119299,Kriegman; David J,9999,0,9999,0
1668104836524,CSE 293,017,119300,Kumar; Arun Kumar,9999,0,9999,0
1668104836524,CSE 293,018,119301,Lerner; Sorin,9999,0,9999,0
1668104836524,CSE 293,019,119302,Lovett; Shachar,9999,0,9999,0
1668104836524,CSE 293,020,119303,McAuley; Julian John,9999,0,9999,0
1668104836524,CSE 293,021,119304,Micciancio; Daniele,9999,0,9999,0
1668104836524,CSE 293,022,119367,Orailoglu; Alex,9999,0,9999,0
1668104836524,CSE 293,023,119382,Paturi; Ramamohan,9999,0,9999,0
1668104836524,CSE 293,024,119404,Polikarpova; Nadezhda,9999,0,9999,0
1668104836524,CSE 293,025,119406,Politz; Joseph Gibbs,9999,0,9999,0
1668104836524,CSE 293,026,119411,Porter; George M,9999,0,9999,0
1668104836524,CSE 293,027,119414,Porter; Leonard Emerson,9999,0,9999,0
1668104836524,CSE 293,028,119416,Ramamoorthi; Ravi,9999,0,9999,0
1668104836524,CSE 293,029,119417,Sahoo; Debashis,9999,0,9999,0
1668104836524,CSE 293,030,119420,Saul; Lawrence,9999,0,9999,0
1668104836524,CSE 293,031,119421,Savage; Stefan,9999,0,9999,0
1668104836524,CSE 293,032,119425,Schulze; Jurgen P.,9999,0,9999,0
1668104836524,CSE 293,033,119426,Snoeren; Alex C.,9999,0,9999,0
1668104836524,CSE 293,034,119428,Shang; Jingbo,9999,0,9999,0
1668104836524,CSE 293,035,119430,Stefan; Deian,9999,0,9999,0
1668104836524,CSE 293,036,119431,Su; Hao,9999,0,9999,0
1668104836524,CSE 293,037,119433,Swanson; Steven James,9999,0,9999,0
1668104836524,CSE 293,038,119435,Tullsen; Dean Michael,9999,0,9999,0
1668104836524,CSE 293,039,119483,Voelker; Geoffrey M.,9999,0,9999,0
1668104836524,CSE 293,040,119537,Zhao; Jishen,9999,0,9999,0
1668104836524,CSE 293,041,119538,Zhou; Yuan-Yuan,9999,0,9999,0
1668104836524,CSE 293,042,119539,Gao; Sicun,9999,0,9999,0
1668104836524,CSE 293,043,119540,Weibel; Nadir,9999,0,9999,0
1668104836524,CSE 293,044,119541,Gupta; Rajesh K.,9999,0,9999,0
1668104836524,CSE 293,045,126410,Vaccaro; Kristen Marie,9999,0,9999,0
1668104836524,CSE 293,046,126411,Klemke; Richard,9999,0,9999,0
1668104836954,CSE 294,A00,102459,Voelker; Geoffrey M.,0,0,0,0
1668104836954,CSE 294,B00,111322,Orailoglu; Alex,0,0,0,0
1668104837376,DSE 201,A00,096914,Deutsch; Alin Bernard,30,0,30,0
1668104837798,DSE 210,A00,096915,Dasgupta; Sanjoy,30,0,30,0
1668104838221,DSE 260A,A00,096916,Altintas De Callaf; Ilkay,30,0,30,0
1668104838675,ECE 200,001,103586,Antipa; Nicholas A,9999,0,9999,0
1668104838675,ECE 200,002,103587,Atanasov; Nikolay A.,9999,0,9999,0
1668104838675,ECE 200,003,103588,Bharadia; Dinesh,9999,0,9999,0
1668104838675,ECE 200,004,103589,Cheng; Chung Kuan,9999,0,9999,0
1668104838675,ECE 200,005,103590,Cosman; Pamela C.,9999,0,9999,0
1668104838675,ECE 200,006,103591,Dayeh; Shadi Ahmad,9999,0,9999,0
1668104838675,ECE 200,007,103592,Fainman; Yeshaiahu,9999,0,9999,0
1668104838675,ECE 200,008,103593,Ford; Joseph Earl,9999,0,9999,0
1668104838675,ECE 200,009,103594,Franceschetti; Massimo,9999,0,9999,0
1668104838675,ECE 200,010,103595,Fullerton; Eric E,9999,0,9999,0
1668104838675,ECE 200,011,103596,Galton; Ian A,9999,0,9999,0
1668104838675,ECE 200,012,103597,Gilja; Vikash,9999,0,9999,0
1668104838675,ECE 200,013,103598,Hall; Drew A.,9999,0,9999,0
1668104838675,ECE 200,014,103599,Hsueh; Tzu-Chien,9999,0,9999,0
1668104838675,ECE 200,015,103600,Javidi; Tara,9999,0,9999,0
1668104838675,ECE 200,016,103601,Kahng; Andrew Byun,9999,0,9999,0
1668104838675,ECE 200,017,103602,Kim; Young-Han,9999,0,9999,0
1668104838675,ECE 200,018,103603,Koushanfar; Farinaz,9999,0,9999,0
1668104838675,ECE 200,019,103604,Kuzum; Duygu,9999,0,9999,0
1668104838675,ECE 200,020,103605,Le; Hanh-Phuc,9999,0,9999,0
1668104838675,ECE 200,021,103606,Lin; Bill,9999,0,9999,0
1668104838675,ECE 200,022,103607,Liu; Zhaowei,9998,0,9999,1
1668104838675,ECE 200,023,103608,Lo; Yu-Hwa,9999,0,9999,0
1668104838675,ECE 200,024,103609,Lomakin; Vitaliy,9999,0,9999,0
1668104838675,ECE 200,025,103610,Mercier; Patrick Philip,9999,0,9999,0
1668104838675,ECE 200,026,103611,Meyer; Florian,9999,0,9999,0
1668104838675,ECE 200,027,103612,Milstein; Laurence B.,9999,0,9999,0
1668104838675,ECE 200,028,103613,Mir Arabbaygi; Siavash,9999,0,9999,0
1668104838675,ECE 200,029,103614,Mookherjea; Shayan,9999,0,9999,0
1668104838675,ECE 200,030,103615,Morris; Karcher William,9999,0,9999,0
1668104838675,ECE 200,031,103616,Ng; Tse Nga,9999,0,9999,0
1668104838675,ECE 200,032,103617,Nguyen; Truong Quang,9999,0,9999,0
1668104838675,ECE 200,033,103618,Nomura; Kenji,9999,0,9999,0
1668104838675,ECE 200,034,103619,Orlitsky; Alon,9999,0,9999,0
1668104838675,ECE 200,035,103620,Pal; Piya,9999,0,9999,0
1668104838675,ECE 200,036,103621,Papen; George C.,9999,0,9999,0
1668104838675,ECE 200,037,103622,Radic; Stojan,9999,0,9999,0
1668104838675,ECE 200,038,103623,Rao; Bhaskar D.,9999,0,9999,0
1668104838675,ECE 200,039,103624,Rao; Ramesh R,9999,0,9999,0
1668104838675,ECE 200,040,103625,Rebeiz; Gabriel,9999,0,9999,0
1668104838675,ECE 200,041,103626,Sanford; John R,9999,0,9999,0
1668104838675,ECE 200,042,103627,Siegel; Paul H.,9999,0,9999,0
1668104838675,ECE 200,043,103628,Sievenpiper; Daniel F.,9999,0,9999,0
1668104838675,ECE 200,044,103629,Sworder; David D.,9999,0,9999,0
1668104838675,ECE 200,045,103630,Taur; Yuan,9999,0,9999,0
1668104838675,ECE 200,046,103631,Touri; Behrouz,9999,0,9999,0
1668104838675,ECE 200,047,103632,Trivedi; Mohan M.,9999,0,9999,0
1668104838675,ECE 200,048,103633,Vasconcelos; Nuno,9999,0,9999,0
1668104838675,ECE 200,049,103634,Wang; Xiaolong,9999,0,9999,0
1668104838675,ECE 200,050,103635,Xie; Pengtao,9999,0,9999,0
1668104838675,ECE 200,051,103636,Yip; Michael,9999,0,9999,0
1668104838675,ECE 200,052,103637,Zeger; Kenneth A.,999,0,999,0
1668104838675,ECE 200,053,103638,Zhang; Xinyu,9999,0,9999,0
1668104838675,ECE 200,054,103639,Turakhia; Yatish Girish,9999,0,9999,0
1668104838675,ECE 200,055,103640,Kang; Mingu,9999,0,9999,0
1668104838675,ECE 200,056,103641,Shi; Yuanyuan,9999,0,9999,0
1668104838675,ECE 200,057,103642,Wang; Edward Jay,9999,0,9999,0
1668104838675,ECE 200,058,103643,Zheng; Yang,9999,0,9999,0
1668104839108,ECE 202,A00,103644,Kuzum; Duygu,0,0,0,0
1668104839533,ECE 212BN,A00,103646,Ng; Tse Nga,0,0,0,0
1668104839971,ECE 221,A00,111493,Staff,0,0,0,0
1668104840408,ECE 222B,A00,103647,Lomakin; Vitaliy,0,0,0,0
1668104840832,ECE 230B,A00,103648,Taur; Yuan,0,0,0,0
1668104841255,ECE 238B,A00,103649,Garay; Javier,0,0,0,0
1668104841681,ECE 240B,A00,112900,Fainman; Yeshaiahu,0,0,0,0
1668104842109,ECE 247A,A00,103650,Jokerst; Jesse Vincent,0,0,0,0
1668104842653,ECE 247B,A00,103651,Wang; Joseph,0,0,0,0
1668104843075,ECE 250,A00,103652,Siegel; Paul H.,0,0,0,0
1668104843506,ECE 251A,A00,103654,Rao; Bhaskar D.,0,0,0,0
1668104843929,ECE 257B,A00,103655,Bharadia; Dinesh,0,0,0,0
1668104844356,ECE 258A,A00,103656,Milstein; Laurence B.,0,0,0,0
1668104844804,ECE 260B,A00,103658,Kang; Mingu,0,0,0,0
1668104845237,ECE 264A,A00,103659,Galton; Ian A,0,0,0,0
1668104845672,ECE 265A,A00,103661,Gudem; Prasad S.S.,0,0,0,0
1668104846107,ECE 265D,A00,103662,Gudem; Prasad S.S.,0,0,0,0
1668104846541,ECE 268,A00,103663,Koushanfar; Farinaz,0,0,0,0
1668104846964,ECE 269,A01,103665,Pal; Piya,0,0,0,0
1668104847392,ECE 271B,A00,103666,Vasconcelos; Manuela,0,0,0,0
1668104847818,ECE 276A,A00,103667,Atanasov; Nikolay A.,0,0,0,0
1668104848255,ECE 277,A00,103668,An; Cheolhong,0,0,0,0
1668104848680,ECE 279,A00,117947,Hall; Drew A.,0,0,0,0
1668104849529,ECE 283,A00,103670,Hsueh; Tzu-Chien,0,0,0,0
1668104849966,ECE 284,A00,103671,Turakhia; Yatish Girish,0,0,0,0
1668104850393,ECE 285,A00,103672,Zheng; Yang,0,0,0,0
1668104850393,ECE 285,B00,103673,Sworder; David D.,0,0,0,0
1668104850822,ECE 287,A00,103676,Javidi; Tara,0,0,0,0
1668104851245,MATH 200B,A00,098023,Salehi Golsefidy; Alireza,12,0,15,3
1668104851666,MATH 202B,A00,098024,Rhoades; Brendon Patrick,9,0,15,6
1668104852092,MATH 203B,A00,098025,Oprea; Dragos N.,10,0,15,5
1668104852518,MATH 204B,A00,098026,Sorensen; Claus M,13,0,15,2
1668104852952,MATH 208,A00,098027,Izadi; Elham,7,0,10,3
1668104853377,MATH 209,A00,098028,Pollack; Aaron,10,0,10,0
1668104853799,MATH 211A,A00,112919,Rogalski; Daniel,9,0,10,1
1668104854235,MATH 211B,A00,112920,Seward; Brandon M.,9,0,10,1
1668104854657,MATH 218,A00,098029,Li; Bo,10,0,10,0
1668104855081,MATH 220B,A00,098030,Novak; Jonathan I,11,0,15,4
1668104855504,MATH 221A,A00,098031,Ebenfelt; Peter F,13,0,15,2
1668104855940,MATH 231B,A00,098032,Zlatos; Andrej,12,0,15,3
1668104856366,MATH 240B,A00,098033,Ni; Lei,9,0,15,6
1668104856798,MATH 243,A00,098034,Jekel; David Andrew,10,0,10,0
1668104857224,MATH 245A,A00,098035,Nie; Jiawang,0,0,15,16
1668104857654,MATH 248,A00,098036,Bejenaru; Ioan,10,0,10,0
1668104858079,MATH 250B,A00,098037,Spolaor; Luca,14,0,15,1
1668104858510,MATH 258,A00,098038,Ni; Lei,10,0,10,0
1668104858938,MATH 264B,A00,098041,Rhoades; Brendon Patrick,9,0,15,6
1668104859360,MATH 268,A00,098042,Buss; Samuel R,10,0,10,0
1668104859785,MATH 269,A00,098043,Rhoades; Brendon Patrick,10,0,10,0
1668104860211,MATH 270B,A00,098044,Li; Bo,10,0,15,5
1668104860643,MATH 272B,A00,098045,Holst; Michael J,13,0,15,2
1668104861068,MATH 273A,A00,098046,Tian; Xiaochuan,10,0,15,5
1668104861492,MATH 275,A01,098048,Tian; Xiaochuan,6,0,10,4
1668104861922,MATH 278A,A00,098049,Holst; Michael J,8,0,10,2
1668104862345,MATH 278B,A00,098050,Cloninger; Alexander,10,0,10,0
1668104862770,MATH 278C,A00,098051,Nie; Jiawang,7,0,10,3
1668104863195,MATH 280B,A00,098052,Zheng; Tianyi,10,0,15,5
1668104863617,MATH 281B,A00,098053,Bradic; Jelena,2,0,15,13
1668104864047,MATH 282B,A00,098054,Arias-Castro; Ery,0,0,15,15
1668104864476,MATH 285,A00,098055,Fitzsimmons; Patrick J,0,0,15,17
1668104864899,MATH 287B,A00,098056,Arias-Castro; Ery,3,0,15,12
1668104865322,MATH 288,A00,098057,Agarwal; Pooja,9,0,10,1
1668104865322,MATH 288,B00,098058,Zhang; Danna,8,0,10,2
1668104865322,MATH 288,C00,098059,Williams; Ruth J,10,0,10,0
1668104865747,MATH 290B,A00,098060,Roberts; Justin Deritter,13,0,15,2
1668104866174,MATH 292,A00,098061,Belmont; Eva Kinoshita,10,0,10,0
1668104866599,MATH 295,A00,098062,Suk; Andrew Hoon,48,0,50,2
1668104867030,MATH 296,A00,098063,Novak; Jonathan I,20,0,20,0
1668104867470,MATH 297,001,098064,Gamst; Anthony Collins,9997,0,9999,2
1668105372437,COGS 205,A00,101395,Chiba; Andrea,19,0,20,1
1668105372861,COGS 210B,001,101404,Greene; Deanna Jacquelyn,9998,0,9999,1
1668105372861,COGS 210B,002,101417,Xia; Haijun,9999,0,9999,0
1668105372861,COGS 210B,003,101422,Nitz; Douglas A.,9999,0,9999,0
1668105372861,COGS 210B,004,101423,Hollan; James D.,9998,0,9999,1
1668105372861,COGS 210B,005,101424,Deak; Gedeon O.,9998,0,9999,1
1668105372861,COGS 210B,006,101425,Rossano; Federico,9999,0,9999,0
1668105373289,COGS 211B,A00,101427,Coulson; Seana M,9996,0,9999,3
1668105373723,COGS 220,A00,101428,Hollan; James D.,0,0,25,25
1668105374147,COGS 229,A00,101429,Dow; Steven P,18,0,25,7
1668105374571,COGS 230,A00,101430,Klemmer; Scott R,13,0,17,4
1668105374998,COGS 234,A00,101431,Xia; Haijun,3,0,25,22
1668105375430,COGS 260,A00,101432,Kiyonaga; Anastasia,19,0,25,6
1668105375430,COGS 260,B00,101433,Kirsh; David Joel,16,0,25,9
1668105375855,CSE 202,A00,102371,Impagliazzo; Russell,0,0,0,0
1668105376280,CSE 203B,A01,102373,Cheng; Chung Kuan,0,0,0,0
1668105376707,CSE 208,A00,102374,Micciancio; Daniele,0,0,0,0
1668105377141,CSE 209A,A00,112895,Impagliazzo; Russell,0,0,15,15
1668105377568,CSE 209B,A00,108005,Bellare; Mihir,0,0,0,0
1668105377997,CSE 210,A00,113163,Coblenz; Michael J,0,0,0,0
1668105378423,CSE 219,A00,106111,Dow; Steven P,0,0,20,20
1668105378853,CSE 221,A00,102376,Voelker; Geoffrey M.,0,0,0,0
1668105379294,CSE 224,A01,102378,Porter; George M,0,0,0,0
1668105379734,CSE 229A,A00,102379,Savage; Stefan,0,0,0,0
1668105380162,CSE 229C,A00,102380,Munyaka; Imani N. S.,0,0,0,0
1668105380598,CSE 232B,A00,102382,Deutsch; Alin Bernard,0,0,0,0
1668105381031,CSE 234,A01,112904,Kumar; Arun Kumar,0,0,0,0
1668105381455,CSE 237A,A00,102383,Rosing; Tajana Simunic,0,0,0,0
1668105381879,CSE 239A,A00,102384,Deutsch; Alin Bernard,0,0,0,0
1668105382303,CSE 239B,A00,102385,Polikarpova; Nadezhda,0,0,0,0
1668105382730,CSE 240A,A00,102386,Pannuto; Patrick William,0,0,0,0
1668105383172,CSE 240B,A00,102387,Zhao; Jishen,0,0,0,0
1668105383606,CSE 241A,A00,106406,Kang; Mingu,0,0,0,0
1668105384032,CSE 249B,A00,102388,Kahng; Andrew Byun,0,0,8,8
1668105384461,CSE 251B,A01,102392,Cottrell; Garrison W,0,0,0,0
1668105384461,CSE 251B,A02,102393,Cottrell; Garrison W,0,0,0,0
1668105384890,CSE 252B,A00,102394,Ochoa; Benjamin Lawrence,0,0,0,0
1668105385314,CSE 257,A01,102396,Gao; Sicun,0,0,0,0
1668105385737,CSE 272,A00,102397,Li; Tzumao,0,0,0,0
1668105386162,CSE 274,A00,111323,Chern; Albert Ren-Haur,0,0,0,0
1668105386585,CSE 282,A00,102398,Pevzner; Pavel Arkadjevich,0,0,0,0
1668105387019,CSE 284,A00,114175,Gymrek; Melissa Ann,0,0,0,0
1668105387442,CSE 290,A00,102399,Chandraker; Manmohan Krishna,0,0,0,0
1668105387442,CSE 290,B00,102400,Vaccaro; Kristen Marie,0,0,25,25
1668105387442,CSE 290,C00,102414,Pannuto; Patrick William,0,0,25,25
1668105387442,CSE 290,D00,102427,Pevzner; Pavel Arkadjevich,0,0,0,0
1668105387442,CSE 290,E00,102429,Zhao; Jishen,0,0,0,0
1668105387442,CSE 290,F00,102436,Tullsen; Dean Michael,0,0,0,0
1668105387442,CSE 290,G00,102440,Christensen; Henrik I,0,0,20,20
1668105387877,CSE 291,A00,102443,Su; Hao,0,0,0,0
1668105387877,CSE 291,B00,102448,Polikarpova; Nadezhda,0,0,0,0
1668105387877,CSE 291,C00,102453,Vaccaro; Kristen Marie,0,0,0,0
1668105387877,CSE 291,D00,111343,Savage; Stefan,0,0,0,0
1668105387877,CSE 291,E00,116474,Claffy; Kimberly Claire,0,0,0,0
1668105387877,CSE 291,F00,116479,Pasquale; Joseph,0,0,0,0
1668105388305,CSE 293,001,119111,Bafna; Vineet,9999,0,9999,0
1668105388305,CSE 293,002,119118,Bellare; Mihir,9999,0,9999,0
1668105388305,CSE 293,003,119122,Berg-Kirkpatrick; Taylor D,9999,0,9999,0
1668105388305,CSE 293,004,119135,Christensen; Henrik I,9999,0,9999,0
1668105388305,CSE 293,005,119142,Cottrell; Garrison W,9999,0,9999,0
1668105388305,CSE 293,006,119146,Deutsch; Alin Bernard,9999,0,9999,0
1668105388305,CSE 293,007,119159,Esmaeilzadeh; Hadi,9999,0,9999,0
1668105388305,CSE 293,008,119166,Freund; Yoav,9999,0,9999,0
1668105388305,CSE 293,009,119170,Griswold; William G.,9999,0,9999,0
1668105388305,CSE 293,010,119183,Gymrek; Melissa Ann,9999,0,9999,0
1668105388305,CSE 293,011,119190,Heninger; Nadia A,9999,0,9999,0
1668105388305,CSE 293,012,119230,Impagliazzo; Russell,9999,0,9999,0
1668105388305,CSE 293,013,119232,Jhala; Ranjit,9999,0,9999,0
1668105388305,CSE 293,014,119233,Kahng; Andrew Byun,9999,0,9999,0
1668105388305,CSE 293,015,119298,Kane; Daniel Mertz,9999,0,9999,0
1668105388305,CSE 293,016,119299,Kriegman; David J,9999,0,9999,0
1668105388305,CSE 293,017,119300,Kumar; Arun Kumar,9999,0,9999,0
1668105388305,CSE 293,018,119301,Lerner; Sorin,9999,0,9999,0
1668105388305,CSE 293,019,119302,Lovett; Shachar,9999,0,9999,0
1668105388305,CSE 293,020,119303,McAuley; Julian John,9999,0,9999,0
1668105388305,CSE 293,021,119304,Micciancio; Daniele,9999,0,9999,0
1668105388305,CSE 293,022,119367,Orailoglu; Alex,9999,0,9999,0
1668105388305,CSE 293,023,119382,Paturi; Ramamohan,9999,0,9999,0
1668105388305,CSE 293,024,119404,Polikarpova; Nadezhda,9999,0,9999,0
1668105388305,CSE 293,025,119406,Politz; Joseph Gibbs,9999,0,9999,0
1668105388305,CSE 293,026,119411,Porter; George M,9999,0,9999,0
1668105388305,CSE 293,027,119414,Porter; Leonard Emerson,9999,0,9999,0
1668105388305,CSE 293,028,119416,Ramamoorthi; Ravi,9999,0,9999,0
1668105388305,CSE 293,029,119417,Sahoo; Debashis,9999,0,9999,0
1668105388305,CSE 293,030,119420,Saul; Lawrence,9999,0,9999,0
1668105388305,CSE 293,031,119421,Savage; Stefan,9999,0,9999,0
1668105388305,CSE 293,032,119425,Schulze; Jurgen P.,9999,0,9999,0
1668105388305,CSE 293,033,119426,Snoeren; Alex C.,9999,0,9999,0
1668105388305,CSE 293,034,119428,Shang; Jingbo,9999,0,9999,0
1668105388305,CSE 293,035,119430,Stefan; Deian,9999,0,9999,0
1668105388305,CSE 293,036,119431,Su; Hao,9999,0,9999,0
1668105388305,CSE 293,037,119433,Swanson; Steven James,9999,0,9999,0
1668105388305,CSE 293,038,119435,Tullsen; Dean Michael,9999,0,9999,0
1668105388305,CSE 293,039,119483,Voelker; Geoffrey M.,9999,0,9999,0
1668105388305,CSE 293,040,119537,Zhao; Jishen,9999,0,9999,0
1668105388305,CSE 293,041,119538,Zhou; Yuan-Yuan,9999,0,9999,0
1668105388305,CSE 293,042,119539,Gao; Sicun,9999,0,9999,0
1668105388305,CSE 293,043,119540,Weibel; Nadir,9999,0,9999,0
1668105388305,CSE 293,044,119541,Gupta; Rajesh K.,9999,0,9999,0
1668105388305,CSE 293,045,126410,Vaccaro; Kristen Marie,9999,0,9999,0
1668105388305,CSE 293,046,126411,Klemke; Richard,9999,0,9999,0
1668105388734,CSE 294,A00,102459,Voelker; Geoffrey M.,0,0,0,0
1668105388734,CSE 294,B00,111322,Orailoglu; Alex,0,0,0,0
1668105389172,DSE 201,A00,096914,Deutsch; Alin Bernard,30,0,30,0
1668105389603,DSE 210,A00,096915,Dasgupta; Sanjoy,30,0,30,0
1668105390033,DSE 260A,A00,096916,Altintas De Callaf; Ilkay,30,0,30,0
1668105390475,ECE 200,001,103586,Antipa; Nicholas A,9999,0,9999,0
1668105390475,ECE 200,002,103587,Atanasov; Nikolay A.,9999,0,9999,0
1668105390475,ECE 200,003,103588,Bharadia; Dinesh,9999,0,9999,0
1668105390475,ECE 200,004,103589,Cheng; Chung Kuan,9999,0,9999,0
1668105390475,ECE 200,005,103590,Cosman; Pamela C.,9999,0,9999,0
1668105390475,ECE 200,006,103591,Dayeh; Shadi Ahmad,9999,0,9999,0
1668105390475,ECE 200,007,103592,Fainman; Yeshaiahu,9999,0,9999,0
1668105390475,ECE 200,008,103593,Ford; Joseph Earl,9999,0,9999,0
1668105390475,ECE 200,009,103594,Franceschetti; Massimo,9999,0,9999,0
1668105390475,ECE 200,010,103595,Fullerton; Eric E,9999,0,9999,0
1668105390475,ECE 200,011,103596,Galton; Ian A,9999,0,9999,0
1668105390475,ECE 200,012,103597,Gilja; Vikash,9999,0,9999,0
1668105390475,ECE 200,013,103598,Hall; Drew A.,9999,0,9999,0
1668105390475,ECE 200,014,103599,Hsueh; Tzu-Chien,9999,0,9999,0
1668105390475,ECE 200,015,103600,Javidi; Tara,9999,0,9999,0
1668105390475,ECE 200,016,103601,Kahng; Andrew Byun,9999,0,9999,0
1668105390475,ECE 200,017,103602,Kim; Young-Han,9999,0,9999,0
1668105390475,ECE 200,018,103603,Koushanfar; Farinaz,9999,0,9999,0
1668105390475,ECE 200,019,103604,Kuzum; Duygu,9999,0,9999,0
1668105390475,ECE 200,020,103605,Le; Hanh-Phuc,9999,0,9999,0
1668105390475,ECE 200,021,103606,Lin; Bill,9999,0,9999,0
1668105390475,ECE 200,022,103607,Liu; Zhaowei,9998,0,9999,1
1668105390475,ECE 200,023,103608,Lo; Yu-Hwa,9999,0,9999,0
1668105390475,ECE 200,024,103609,Lomakin; Vitaliy,9999,0,9999,0
1668105390475,ECE 200,025,103610,Mercier; Patrick Philip,9999,0,9999,0
1668105390475,ECE 200,026,103611,Meyer; Florian,9999,0,9999,0
1668105390475,ECE 200,027,103612,Milstein; Laurence B.,9999,0,9999,0
1668105390475,ECE 200,028,103613,Mir Arabbaygi; Siavash,9999,0,9999,0
1668105390475,ECE 200,029,103614,Mookherjea; Shayan,9999,0,9999,0
1668105390475,ECE 200,030,103615,Morris; Karcher William,9999,0,9999,0
1668105390475,ECE 200,031,103616,Ng; Tse Nga,9999,0,9999,0
1668105390475,ECE 200,032,103617,Nguyen; Truong Quang,9999,0,9999,0
1668105390475,ECE 200,033,103618,Nomura; Kenji,9999,0,9999,0
1668105390475,ECE 200,034,103619,Orlitsky; Alon,9999,0,9999,0
1668105390475,ECE 200,035,103620,Pal; Piya,9999,0,9999,0
1668105390475,ECE 200,036,103621,Papen; George C.,9999,0,9999,0
1668105390475,ECE 200,037,103622,Radic; Stojan,9999,0,9999,0
1668105390475,ECE 200,038,103623,Rao; Bhaskar D.,9999,0,9999,0
1668105390475,ECE 200,039,103624,Rao; Ramesh R,9999,0,9999,0
1668105390475,ECE 200,040,103625,Rebeiz; Gabriel,9999,0,9999,0
1668105390475,ECE 200,041,103626,Sanford; John R,9999,0,9999,0
1668105390475,ECE 200,042,103627,Siegel; Paul H.,9999,0,9999,0
1668105390475,ECE 200,043,103628,Sievenpiper; Daniel F.,9999,0,9999,0
1668105390475,ECE 200,044,103629,Sworder; David D.,9999,0,9999,0
1668105390475,ECE 200,045,103630,Taur; Yuan,9999,0,9999,0
1668105390475,ECE 200,046,103631,Touri; Behrouz,9999,0,9999,0
1668105390475,ECE 200,047,103632,Trivedi; Mohan M.,9999,0,9999,0
1668105390475,ECE 200,048,103633,Vasconcelos; Nuno,9999,0,9999,0
1668105390475,ECE 200,049,103634,Wang; Xiaolong,9999,0,9999,0
1668105390475,ECE 200,050,103635,Xie; Pengtao,9999,0,9999,0
1668105390475,ECE 200,051,103636,Yip; Michael,9999,0,9999,0
1668105390475,ECE 200,052,103637,Zeger; Kenneth A.,999,0,999,0
1668105390475,ECE 200,053,103638,Zhang; Xinyu,9999,0,9999,0
1668105390475,ECE 200,054,103639,Turakhia; Yatish Girish,9999,0,9999,0
1668105390475,ECE 200,055,103640,Kang; Mingu,9999,0,9999,0
1668105390475,ECE 200,056,103641,Shi; Yuanyuan,9999,0,9999,0
1668105390475,ECE 200,057,103642,Wang; Edward Jay,9999,0,9999,0
1668105390475,ECE 200,058,103643,Zheng; Yang,9999,0,9999,0
1668105390903,ECE 202,A00,103644,Kuzum; Duygu,0,0,0,0
1668105391328,ECE 212BN,A00,103646,Ng; Tse Nga,0,0,0,0
1668105391756,ECE 221,A00,111493,Staff,0,0,0,0
1668105392195,ECE 222B,A00,103647,Lomakin; Vitaliy,0,0,0,0
1668105392629,ECE 230B,A00,103648,Taur; Yuan,0,0,0,0
1668105393057,ECE 238B,A00,103649,Garay; Javier,0,0,0,0
1668105393482,ECE 240B,A00,112900,Fainman; Yeshaiahu,0,0,0,0
1668105393920,ECE 247A,A00,103650,Jokerst; Jesse Vincent,0,0,0,0
1668105394346,ECE 247B,A00,103651,Wang; Joseph,0,0,0,0
1668105394778,ECE 250,A00,103652,Siegel; Paul H.,0,0,0,0
1668105395203,ECE 251A,A00,103654,Rao; Bhaskar D.,0,0,0,0
1668105395640,ECE 257B,A00,103655,Bharadia; Dinesh,0,0,0,0
1668105396062,ECE 258A,A00,103656,Milstein; Laurence B.,0,0,0,0
1668105396491,ECE 260B,A00,103658,Kang; Mingu,0,0,0,0
1668105396932,ECE 264A,A00,103659,Galton; Ian A,0,0,0,0
1668105397355,ECE 265A,A00,103661,Gudem; Prasad S.S.,0,0,0,0
1668105397780,ECE 265D,A00,103662,Gudem; Prasad S.S.,0,0,0,0
1668105398206,ECE 268,A00,103663,Koushanfar; Farinaz,0,0,0,0
1668105398635,ECE 269,A01,103665,Pal; Piya,0,0,0,0
1668105399060,ECE 271B,A00,103666,Vasconcelos; Manuela,0,0,0,0
1668105399487,ECE 276A,A00,103667,Atanasov; Nikolay A.,0,0,0,0
1668105399909,ECE 277,A00,103668,An; Cheolhong,0,0,0,0
1668105400332,ECE 279,A00,117947,Hall; Drew A.,0,0,0,0
1668105401177,ECE 283,A00,103670,Hsueh; Tzu-Chien,0,0,0,0
1668105401609,ECE 284,A00,103671,Turakhia; Yatish Girish,0,0,0,0
1668105402035,ECE 285,A00,103672,Zheng; Yang,0,0,0,0
1668105402035,ECE 285,B00,103673,Sworder; David D.,0,0,0,0
1668105402456,ECE 287,A00,103676,Javidi; Tara,0,0,0,0
1668105402900,MATH 200B,A00,098023,Salehi Golsefidy; Alireza,12,0,15,3
1668105403327,MATH 202B,A00,098024,Rhoades; Brendon Patrick,9,0,15,6
1668105403756,MATH 203B,A00,098025,Oprea; Dragos N.,10,0,15,5
1668105404182,MATH 204B,A00,098026,Sorensen; Claus M,13,0,15,2
1668105404620,MATH 208,A00,098027,Izadi; Elham,7,0,10,3
1668105405045,MATH 209,A00,098028,Pollack; Aaron,10,0,10,0
1668105405466,MATH 211A,A00,112919,Rogalski; Daniel,9,0,10,1
1668105405893,MATH 211B,A00,112920,Seward; Brandon M.,9,0,10,1
1668105406317,MATH 218,A00,098029,Li; Bo,10,0,10,0
1668105406741,MATH 220B,A00,098030,Novak; Jonathan I,11,0,15,4
1668105407169,MATH 221A,A00,098031,Ebenfelt; Peter F,13,0,15,2
1668105407606,MATH 231B,A00,098032,Zlatos; Andrej,12,0,15,3
1668105408038,MATH 240B,A00,098033,Ni; Lei,9,0,15,6
1668105408463,MATH 243,A00,098034,Jekel; David Andrew,10,0,10,0
1668105408889,MATH 245A,A00,098035,Nie; Jiawang,0,0,15,16
1668105409313,MATH 248,A00,098036,Bejenaru; Ioan,10,0,10,0
1668105409746,MATH 250B,A00,098037,Spolaor; Luca,14,0,15,1
1668105410172,MATH 258,A00,098038,Ni; Lei,10,0,10,0
1668105410595,MATH 264B,A00,098041,Rhoades; Brendon Patrick,9,0,15,6
1668105411109,MATH 268,A00,098042,Buss; Samuel R,10,0,10,0
1668105411532,MATH 269,A00,098043,Rhoades; Brendon Patrick,10,0,10,0
1668105411955,MATH 270B,A00,098044,Li; Bo,10,0,15,5
1668105412379,MATH 272B,A00,098045,Holst; Michael J,13,0,15,2
1668105412821,MATH 273A,A00,098046,Tian; Xiaochuan,10,0,15,5
1668105413249,MATH 275,A01,098048,Tian; Xiaochuan,6,0,10,4
1668105413675,MATH 278A,A00,098049,Holst; Michael J,8,0,10,2
1668105414100,MATH 278B,A00,098050,Cloninger; Alexander,10,0,10,0
1668105414540,MATH 278C,A00,098051,Nie; Jiawang,7,0,10,3
1668105414962,MATH 280B,A00,098052,Zheng; Tianyi,10,0,15,5
1668105415388,MATH 281B,A00,098053,Bradic; Jelena,2,0,15,13
1668105415820,MATH 282B,A00,098054,Arias-Castro; Ery,0,0,15,15
1668105416259,MATH 285,A00,098055,Fitzsimmons; Patrick J,0,0,15,17
1668105416695,MATH 287B,A00,098056,Arias-Castro; Ery,3,0,15,12
1668105417123,MATH 288,A00,098057,Agarwal; Pooja,9,0,10,1
1668105417123,MATH 288,B00,098058,Zhang; Danna,8,0,10,2
1668105417123,MATH 288,C00,098059,Williams; Ruth J,10,0,10,0
1668105417555,MATH 290B,A00,098060,Roberts; Justin Deritter,13,0,15,2
1668105417979,MATH 292,A00,098061,Belmont; Eva Kinoshita,10,0,10,0
1668105418401,MATH 295,A00,098062,Suk; Andrew Hoon,48,0,50,2
1668105418834,MATH 296,A00,098063,Novak; Jonathan I,20,0,20,0
1668105419258,MATH 297,001,098064,Gamst; Anthony Collins,9997,0,9999,2
1668105934467,COGS 205,A00,101395,Chiba; Andrea,19,0,20,1
1668105934890,COGS 210B,001,101404,Greene; Deanna Jacquelyn,9998,0,9999,1
1668105934890,COGS 210B,002,101417,Xia; Haijun,9999,0,9999,0
1668105934890,COGS 210B,003,101422,Nitz; Douglas A.,9999,0,9999,0
1668105934890,COGS 210B,004,101423,Hollan; James D.,9998,0,9999,1
1668105934890,COGS 210B,005,101424,Deak; Gedeon O.,9998,0,9999,1
1668105934890,COGS 210B,006,101425,Rossano; Federico,9999,0,9999,0
1668105935330,COGS 211B,A00,101427,Coulson; Seana M,9996,0,9999,3
1668105935752,COGS 220,A00,101428,Hollan; James D.,0,0,25,25
1668105936187,COGS 229,A00,101429,Dow; Steven P,18,0,25,7
1668105936622,COGS 230,A00,101430,Klemmer; Scott R,13,0,17,4
1668105937068,COGS 234,A00,101431,Xia; Haijun,3,0,25,22
1668105937493,COGS 260,A00,101432,Kiyonaga; Anastasia,19,0,25,6
1668105937493,COGS 260,B00,101433,Kirsh; David Joel,16,0,25,9
1668105937935,CSE 202,A00,102371,Impagliazzo; Russell,0,0,0,0
1668105938377,CSE 203B,A01,102373,Cheng; Chung Kuan,0,0,0,0
1668105938822,CSE 208,A00,102374,Micciancio; Daniele,0,0,0,0
1668105939260,CSE 209A,A00,112895,Impagliazzo; Russell,0,0,15,15
1668105939684,CSE 209B,A00,108005,Bellare; Mihir,0,0,0,0
1668105940121,CSE 210,A00,113163,Coblenz; Michael J,0,0,0,0
1668105940565,CSE 219,A00,106111,Dow; Steven P,0,0,20,20
1668105940989,CSE 221,A00,102376,Voelker; Geoffrey M.,0,0,0,0
1668105941417,CSE 224,A01,102378,Porter; George M,0,0,0,0
1668105941839,CSE 229A,A00,102379,Savage; Stefan,0,0,0,0
1668105942271,CSE 229C,A00,102380,Munyaka; Imani N. S.,0,0,0,0
1668105942697,CSE 232B,A00,102382,Deutsch; Alin Bernard,0,0,0,0
1668105943135,CSE 234,A01,112904,Kumar; Arun Kumar,0,0,0,0
1668105943565,CSE 237A,A00,102383,Rosing; Tajana Simunic,0,0,0,0
1668105943986,CSE 239A,A00,102384,Deutsch; Alin Bernard,0,0,0,0
1668105944411,CSE 239B,A00,102385,Polikarpova; Nadezhda,0,0,0,0
1668105944837,CSE 240A,A00,102386,Pannuto; Patrick William,0,0,0,0
1668105945265,CSE 240B,A00,102387,Zhao; Jishen,0,0,0,0
1668105945705,CSE 241A,A00,106406,Kang; Mingu,0,0,0,0
1668105946131,CSE 249B,A00,102388,Kahng; Andrew Byun,0,0,8,8
1668105946671,CSE 251B,A01,102392,Cottrell; Garrison W,0,0,0,0
1668105946671,CSE 251B,A02,102393,Cottrell; Garrison W,0,0,0,0
1668105947099,CSE 252B,A00,102394,Ochoa; Benjamin Lawrence,0,0,0,0
1668105947524,CSE 257,A01,102396,Gao; Sicun,0,0,0,0
1668105947957,CSE 272,A00,102397,Li; Tzumao,0,0,0,0
1668105948379,CSE 274,A00,111323,Chern; Albert Ren-Haur,0,0,0,0
1668105948802,CSE 282,A00,102398,Pevzner; Pavel Arkadjevich,0,0,0,0
1668105949239,CSE 284,A00,114175,Gymrek; Melissa Ann,0,0,0,0
1668105949675,CSE 290,A00,102399,Chandraker; Manmohan Krishna,0,0,0,0
1668105949675,CSE 290,B00,102400,Vaccaro; Kristen Marie,0,0,25,25
1668105949675,CSE 290,C00,102414,Pannuto; Patrick William,0,0,25,25
1668105949675,CSE 290,D00,102427,Pevzner; Pavel Arkadjevich,0,0,0,0
1668105949675,CSE 290,E00,102429,Zhao; Jishen,0,0,0,0
1668105949675,CSE 290,F00,102436,Tullsen; Dean Michael,0,0,0,0
1668105949675,CSE 290,G00,102440,Christensen; Henrik I,0,0,20,20
1668105950099,CSE 291,A00,102443,Su; Hao,0,0,0,0
1668105950099,CSE 291,B00,102448,Polikarpova; Nadezhda,0,0,0,0
1668105950099,CSE 291,C00,102453,Vaccaro; Kristen Marie,0,0,0,0
1668105950099,CSE 291,D00,111343,Savage; Stefan,0,0,0,0
1668105950099,CSE 291,E00,116474,Claffy; Kimberly Claire,0,0,0,0
1668105950099,CSE 291,F00,116479,Pasquale; Joseph,0,0,0,0
1668105950536,CSE 293,001,119111,Bafna; Vineet,9999,0,9999,0
1668105950536,CSE 293,002,119118,Bellare; Mihir,9999,0,9999,0
1668105950536,CSE 293,003,119122,Berg-Kirkpatrick; Taylor D,9999,0,9999,0
1668105950536,CSE 293,004,119135,Christensen; Henrik I,9999,0,9999,0
1668105950536,CSE 293,005,119142,Cottrell; Garrison W,9999,0,9999,0
1668105950536,CSE 293,006,119146,Deutsch; Alin Bernard,9999,0,9999,0
1668105950536,CSE 293,007,119159,Esmaeilzadeh; Hadi,9999,0,9999,0
1668105950536,CSE 293,008,119166,Freund; Yoav,9999,0,9999,0
1668105950536,CSE 293,009,119170,Griswold; William G.,9999,0,9999,0
1668105950536,CSE 293,010,119183,Gymrek; Melissa Ann,9999,0,9999,0
1668105950536,CSE 293,011,119190,Heninger; Nadia A,9999,0,9999,0
1668105950536,CSE 293,012,119230,Impagliazzo; Russell,9999,0,9999,0
1668105950536,CSE 293,013,119232,Jhala; Ranjit,9999,0,9999,0
1668105950536,CSE 293,014,119233,Kahng; Andrew Byun,9999,0,9999,0
1668105950536,CSE 293,015,119298,Kane; Daniel Mertz,9999,0,9999,0
1668105950536,CSE 293,016,119299,Kriegman; David J,9999,0,9999,0
1668105950536,CSE 293,017,119300,Kumar; Arun Kumar,9999,0,9999,0
1668105950536,CSE 293,018,119301,Lerner; Sorin,9999,0,9999,0
1668105950536,CSE 293,019,119302,Lovett; Shachar,9999,0,9999,0
1668105950536,CSE 293,020,119303,McAuley; Julian John,9999,0,9999,0
1668105950536,CSE 293,021,119304,Micciancio; Daniele,9999,0,9999,0
1668105950536,CSE 293,022,119367,Orailoglu; Alex,9999,0,9999,0
1668105950536,CSE 293,023,119382,Paturi; Ramamohan,9999,0,9999,0
1668105950536,CSE 293,024,119404,Polikarpova; Nadezhda,9999,0,9999,0
1668105950536,CSE 293,025,119406,Politz; Joseph Gibbs,9999,0,9999,0
1668105950536,CSE 293,026,119411,Porter; George M,9999,0,9999,0
1668105950536,CSE 293,027,119414,Porter; Leonard Emerson,9999,0,9999,0
1668105950536,CSE 293,028,119416,Ramamoorthi; Ravi,9999,0,9999,0
1668105950536,CSE 293,029,119417,Sahoo; Debashis,9999,0,9999,0
1668105950536,CSE 293,030,119420,Saul; Lawrence,9999,0,9999,0
1668105950536,CSE 293,031,119421,Savage; Stefan,9999,0,9999,0
1668105950536,CSE 293,032,119425,Schulze; Jurgen P.,9999,0,9999,0
1668105950536,CSE 293,033,119426,Snoeren; Alex C.,9999,0,9999,0
1668105950536,CSE 293,034,119428,Shang; Jingbo,9999,0,9999,0
1668105950536,CSE 293,035,119430,Stefan; Deian,9999,0,9999,0
1668105950536,CSE 293,036,119431,Su; Hao,9999,0,9999,0
1668105950536,CSE 293,037,119433,Swanson; Steven James,9999,0,9999,0
1668105950536,CSE 293,038,119435,Tullsen; Dean Michael,9999,0,9999,0
1668105950536,CSE 293,039,119483,Voelker; Geoffrey M.,9999,0,9999,0
1668105950536,CSE 293,040,119537,Zhao; Jishen,9999,0,9999,0
1668105950536,CSE 293,041,119538,Zhou; Yuan-Yuan,9999,0,9999,0
1668105950536,CSE 293,042,119539,Gao; Sicun,9999,0,9999,0
1668105950536,CSE 293,043,119540,Weibel; Nadir,9999,0,9999,0
1668105950536,CSE 293,044,119541,Gupta; Rajesh K.,9999,0,9999,0
1668105950536,CSE 293,045,126410,Vaccaro; Kristen Marie,9999,0,9999,0
1668105950536,CSE 293,046,126411,Klemke; Richard,9999,0,9999,0
1668105950960,CSE 294,A00,102459,Voelker; Geoffrey M.,0,0,0,0
1668105950960,CSE 294,B00,111322,Orailoglu; Alex,0,0,0,0
1668105951397,DSE 201,A00,096914,Deutsch; Alin Bernard,30,0,30,0
1668105951822,DSE 210,A00,096915,Dasgupta; Sanjoy,30,0,30,0
1668105952252,DSE 260A,A00,096916,Altintas De Callaf; Ilkay,30,0,30,0
1668105952735,ECE 200,001,103586,Antipa; Nicholas A,9999,0,9999,0
1668105952735,ECE 200,002,103587,Atanasov; Nikolay A.,9999,0,9999,0
1668105952735,ECE 200,003,103588,Bharadia; Dinesh,9999,0,9999,0
1668105952735,ECE 200,004,103589,Cheng; Chung Kuan,9999,0,9999,0
1668105952735,ECE 200,005,103590,Cosman; Pamela C.,9999,0,9999,0
1668105952735,ECE 200,006,103591,Dayeh; Shadi Ahmad,9999,0,9999,0
1668105952735,ECE 200,007,103592,Fainman; Yeshaiahu,9999,0,9999,0
1668105952735,ECE 200,008,103593,Ford; Joseph Earl,9999,0,9999,0
1668105952735,ECE 200,009,103594,Franceschetti; Massimo,9999,0,9999,0
1668105952735,ECE 200,010,103595,Fullerton; Eric E,9999,0,9999,0
1668105952735,ECE 200,011,103596,Galton; Ian A,9999,0,9999,0
1668105952735,ECE 200,012,103597,Gilja; Vikash,9999,0,9999,0
1668105952735,ECE 200,013,103598,Hall; Drew A.,9999,0,9999,0
1668105952735,ECE 200,014,103599,Hsueh; Tzu-Chien,9999,0,9999,0
1668105952735,ECE 200,015,103600,Javidi; Tara,9999,0,9999,0
1668105952735,ECE 200,016,103601,Kahng; Andrew Byun,9999,0,9999,0
1668105952735,ECE 200,017,103602,Kim; Young-Han,9999,0,9999,0
1668105952735,ECE 200,018,103603,Koushanfar; Farinaz,9999,0,9999,0
1668105952735,ECE 200,019,103604,Kuzum; Duygu,9999,0,9999,0
1668105952735,ECE 200,020,103605,Le; Hanh-Phuc,9999,0,9999,0
1668105952735,ECE 200,021,103606,Lin; Bill,9999,0,9999,0
1668105952735,ECE 200,022,103607,Liu; Zhaowei,9998,0,9999,1
1668105952735,ECE 200,023,103608,Lo; Yu-Hwa,9999,0,9999,0
1668105952735,ECE 200,024,103609,Lomakin; Vitaliy,9999,0,9999,0
1668105952735,ECE 200,025,103610,Mercier; Patrick Philip,9999,0,9999,0
1668105952735,ECE 200,026,103611,Meyer; Florian,9999,0,9999,0
1668105952735,ECE 200,027,103612,Milstein; Laurence B.,9999,0,9999,0
1668105952735,ECE 200,028,103613,Mir Arabbaygi; Siavash,9999,0,9999,0
1668105952735,ECE 200,029,103614,Mookherjea; Shayan,9999,0,9999,0
1668105952735,ECE 200,030,103615,Morris; Karcher William,9999,0,9999,0
1668105952735,ECE 200,031,103616,Ng; Tse Nga,9999,0,9999,0
1668105952735,ECE 200,032,103617,Nguyen; Truong Quang,9999,0,9999,0
1668105952735,ECE 200,033,103618,Nomura; Kenji,9999,0,9999,0
1668105952735,ECE 200,034,103619,Orlitsky; Alon,9999,0,9999,0
1668105952735,ECE 200,035,103620,Pal; Piya,9999,0,9999,0
1668105952735,ECE 200,036,103621,Papen; George C.,9999,0,9999,0
1668105952735,ECE 200,037,103622,Radic; Stojan,9999,0,9999,0
1668105952735,ECE 200,038,103623,Rao; Bhaskar D.,9999,0,9999,0
1668105952735,ECE 200,039,103624,Rao; Ramesh R,9999,0,9999,0
1668105952735,ECE 200,040,103625,Rebeiz; Gabriel,9999,0,9999,0
1668105952735,ECE 200,041,103626,Sanford; John R,9999,0,9999,0
1668105952735,ECE 200,042,103627,Siegel; Paul H.,9999,0,9999,0
1668105952735,ECE 200,043,103628,Sievenpiper; Daniel F.,9999,0,9999,0
1668105952735,ECE 200,044,103629,Sworder; David D.,9999,0,9999,0
1668105952735,ECE 200,045,103630,Taur; Yuan,9999,0,9999,0
1668105952735,ECE 200,046,103631,Touri; Behrouz,9999,0,9999,0
1668105952735,ECE 200,047,103632,Trivedi; Mohan M.,9999,0,9999,0
1668105952735,ECE 200,048,103633,Vasconcelos; Nuno,9999,0,9999,0
1668105952735,ECE 200,049,103634,Wang; Xiaolong,9999,0,9999,0
1668105952735,ECE 200,050,103635,Xie; Pengtao,9999,0,9999,0
1668105952735,ECE 200,051,103636,Yip; Michael,9999,0,9999,0
1668105952735,ECE 200,052,103637,Zeger; Kenneth A.,999,0,999,0
1668105952735,ECE 200,053,103638,Zhang; Xinyu,9999,0,9999,0
1668105952735,ECE 200,054,103639,Turakhia; Yatish Girish,9999,0,9999,0
1668105952735,ECE 200,055,103640,Kang; Mingu,9999,0,9999,0
1668105952735,ECE 200,056,103641,Shi; Yuanyuan,9999,0,9999,0
1668105952735,ECE 200,057,103642,Wang; Edward Jay,9999,0,9999,0
1668105952735,ECE 200,058,103643,Zheng; Yang,9999,0,9999,0
1668105953161,ECE 202,A00,103644,Kuzum; Duygu,0,0,0,0
1668105953584,ECE 212BN,A00,103646,Ng; Tse Nga,0,0,0,0
1668105954016,ECE 221,A00,111493,Staff,0,0,0,0
1668105954439,ECE 222B,A00,103647,Lomakin; Vitaliy,0,0,0,0
1668105954860,ECE 230B,A00,103648,Taur; Yuan,0,0,0,0
1668105955293,ECE 238B,A00,103649,Garay; Javier,0,0,0,0
1668105955716,ECE 240B,A00,112900,Fainman; Yeshaiahu,0,0,0,0
1668105956161,ECE 247A,A00,103650,Jokerst; Jesse Vincent,0,0,0,0
1668105956586,ECE 247B,A00,103651,Wang; Joseph,0,0,0,0
1668105957020,ECE 250,A00,103652,Siegel; Paul H.,0,0,0,0
1668105957447,ECE 251A,A00,103654,Rao; Bhaskar D.,0,0,0,0
1668105957886,ECE 257B,A00,103655,Bharadia; Dinesh,0,0,0,0
1668105958311,ECE 258A,A00,103656,Milstein; Laurence B.,0,0,0,0
1668105958736,ECE 260B,A00,103658,Kang; Mingu,0,0,0,0
1668105959162,ECE 264A,A00,103659,Galton; Ian A,0,0,0,0
1668105959595,ECE 265A,A00,103661,Gudem; Prasad S.S.,0,0,0,0
1668105960027,ECE 265D,A00,103662,Gudem; Prasad S.S.,0,0,0,0
1668105960449,ECE 268,A00,103663,Koushanfar; Farinaz,0,0,0,0
1668105960871,ECE 269,A01,103665,Pal; Piya,0,0,0,0
1668105961294,ECE 271B,A00,103666,Vasconcelos; Manuela,0,0,0,0
1668105961732,ECE 276A,A00,103667,Atanasov; Nikolay A.,0,0,0,0
1668105962167,ECE 277,A00,103668,An; Cheolhong,0,0,0,0
1668105962596,ECE 279,A00,117947,Hall; Drew A.,0,0,0,0
1668105963445,ECE 283,A00,103670,Hsueh; Tzu-Chien,0,0,0,0
1668105963871,ECE 284,A00,103671,Turakhia; Yatish Girish,0,0,0,0
1668105964314,ECE 285,A00,103672,Zheng; Yang,0,0,0,0
1668105964314,ECE 285,B00,103673,Sworder; David D.,0,0,0,0
1668105964739,ECE 287,A00,103676,Javidi; Tara,0,0,0,0
1668105965166,MATH 200B,A00,098023,Salehi Golsefidy; Alireza,12,0,15,3
1668105965597,MATH 202B,A00,098024,Rhoades; Brendon Patrick,9,0,15,6
1668105966026,MATH 203B,A00,098025,Oprea; Dragos N.,10,0,15,5
1668105966452,MATH 204B,A00,098026,Sorensen; Claus M,13,0,15,2
1668105966877,MATH 208,A00,098027,Izadi; Elham,7,0,10,3
1668105967301,MATH 209,A00,098028,Pollack; Aaron,10,0,10,0
1668105967725,MATH 211A,A00,112919,Rogalski; Daniel,9,0,10,1
1668105968160,MATH 211B,A00,112920,Seward; Brandon M.,9,0,10,1
1668105968586,MATH 218,A00,098029,Li; Bo,10,0,10,0
1668105969009,MATH 220B,A00,098030,Novak; Jonathan I,11,0,15,4
1668105969440,MATH 221A,A00,098031,Ebenfelt; Peter F,13,0,15,2
1668105969869,MATH 231B,A00,098032,Zlatos; Andrej,12,0,15,3
1668105970293,MATH 240B,A00,098033,Ni; Lei,9,0,15,6
1668105970722,MATH 243,A00,098034,Jekel; David Andrew,10,0,10,0
1668105971165,MATH 245A,A00,098035,Nie; Jiawang,0,0,15,16
1668105971600,MATH 248,A00,098036,Bejenaru; Ioan,10,0,10,0
1668105972029,MATH 250B,A00,098037,Spolaor; Luca,14,0,15,1
1668105972456,MATH 258,A00,098038,Ni; Lei,10,0,10,0
1668105972880,MATH 264B,A00,098041,Rhoades; Brendon Patrick,9,0,15,6
1668105973306,MATH 268,A00,098042,Buss; Samuel R,10,0,10,0
1668105973738,MATH 269,A00,098043,Rhoades; Brendon Patrick,10,0,10,0
1668105974161,MATH 270B,A00,098044,Li; Bo,10,0,15,5
1668105974587,MATH 272B,A00,098045,Holst; Michael J,13,0,15,2
1668105975015,MATH 273A,A00,098046,Tian; Xiaochuan,10,0,15,5
1668105975441,MATH 275,A01,098048,Tian; Xiaochuan,6,0,10,4
1668105975864,MATH 278A,A00,098049,Holst; Michael J,8,0,10,2
1668105976299,MATH 278B,A00,098050,Cloninger; Alexander,10,0,10,0
1668105976730,MATH 278C,A00,098051,Nie; Jiawang,7,0,10,3
1668105977168,MATH 280B,A00,098052,Zheng; Tianyi,10,0,15,5
1668105977595,MATH 281B,A00,098053,Bradic; Jelena,2,0,15,13
1668105978021,MATH 282B,A00,098054,Arias-Castro; Ery,0,0,15,15
1668105978455,MATH 285,A00,098055,Fitzsimmons; Patrick J,0,0,15,17
1668105978887,MATH 287B,A00,098056,Arias-Castro; Ery,3,0,15,12
1668105979310,MATH 288,A00,098057,Agarwal; Pooja,9,0,10,1
1668105979310,MATH 288,B00,098058,Zhang; Danna,8,0,10,2
1668105979310,MATH 288,C00,098059,Williams; Ruth J,10,0,10,0
1668105979739,MATH 290B,A00,098060,Roberts; Justin Deritter,13,0,15,2
1668105980177,MATH 292,A00,098061,Belmont; Eva Kinoshita,10,0,10,0
1668105980619,MATH 295,A00,098062,Suk; Andrew Hoon,48,0,50,2
1668105981044,MATH 296,A00,098063,Novak; Jonathan I,20,0,20,0
1668105981473,MATH 297,001,098064,Gamst; Anthony Collins,9997,0,9999,2
1668106486052,COGS 205,A00,101395,Chiba; Andrea,19,0,20,1
1668106486478,COGS 210B,001,101404,Greene; Deanna Jacquelyn,9998,0,9999,1
1668106486478,COGS 210B,002,101417,Xia; Haijun,9999,0,9999,0
1668106486478,COGS 210B,003,101422,Nitz; Douglas A.,9999,0,9999,0
1668106486478,COGS 210B,004,101423,Hollan; James D.,9998,0,9999,1
1668106486478,COGS 210B,005,101424,Deak; Gedeon O.,9998,0,9999,1
1668106486478,COGS 210B,006,101425,Rossano; Federico,9999,0,9999,0
1668106486907,COGS 211B,A00,101427,Coulson; Seana M,9996,0,9999,3
1668106487337,COGS 220,A00,101428,Hollan; James D.,0,0,25,25
1668106487780,COGS 229,A00,101429,Dow; Steven P,18,0,25,7
1668106488209,COGS 230,A00,101430,Klemmer; Scott R,13,0,17,4
1668106488633,COGS 234,A00,101431,Xia; Haijun,3,0,25,22
1668106489076,COGS 260,A00,101432,Kiyonaga; Anastasia,19,0,25,6
1668106489076,COGS 260,B00,101433,Kirsh; David Joel,16,0,25,9
1668106489509,CSE 202,A00,102371,Impagliazzo; Russell,0,0,0,0
1668106489932,CSE 203B,A01,102373,Cheng; Chung Kuan,0,0,0,0
1668106490363,CSE 208,A00,102374,Micciancio; Daniele,0,0,0,0
1668106490788,CSE 209A,A00,112895,Impagliazzo; Russell,0,0,15,15
1668106491215,CSE 209B,A00,108005,Bellare; Mihir,0,0,0,0
1668106491662,CSE 210,A00,113163,Coblenz; Michael J,0,0,0,0
1668106492088,CSE 219,A00,106111,Dow; Steven P,0,0,20,20
1668106492525,CSE 221,A00,102376,Voelker; Geoffrey M.,0,0,0,0
1668106492951,CSE 224,A01,102378,Porter; George M,0,0,0,0
1668106493381,CSE 229A,A00,102379,Savage; Stefan,0,0,0,0
1668106493807,CSE 229C,A00,102380,Munyaka; Imani N. S.,0,0,0,0
1668106494238,CSE 232B,A00,102382,Deutsch; Alin Bernard,0,0,0,0
1668106494667,CSE 234,A01,112904,Kumar; Arun Kumar,0,0,0,0
1668106495098,CSE 237A,A00,102383,Rosing; Tajana Simunic,0,0,0,0
1668106495520,CSE 239A,A00,102384,Deutsch; Alin Bernard,0,0,0,0
1668106495943,CSE 239B,A00,102385,Polikarpova; Nadezhda,0,0,0,0
1668106496375,CSE 240A,A00,102386,Pannuto; Patrick William,0,0,0,0
1668106496815,CSE 240B,A00,102387,Zhao; Jishen,0,0,0,0
1668106497248,CSE 241A,A00,106406,Kang; Mingu,0,0,0,0
1668106497697,CSE 249B,A00,102388,Kahng; Andrew Byun,0,0,8,8
1668106498120,CSE 251B,A01,102392,Cottrell; Garrison W,0,0,0,0
1668106498120,CSE 251B,A02,102393,Cottrell; Garrison W,0,0,0,0
1668106498545,CSE 252B,A00,102394,Ochoa; Benjamin Lawrence,0,0,0,0
1668106498974,CSE 257,A01,102396,Gao; Sicun,0,0,0,0
1668106499397,CSE 272,A00,102397,Li; Tzumao,0,0,0,0
1668106499833,CSE 274,A00,111323,Chern; Albert Ren-Haur,0,0,0,0
1668106500257,CSE 282,A00,102398,Pevzner; Pavel Arkadjevich,0,0,0,0
1668106500681,CSE 284,A00,114175,Gymrek; Melissa Ann,0,0,0,0
1668106501123,CSE 290,A00,102399,Chandraker; Manmohan Krishna,0,0,0,0
1668106501123,CSE 290,B00,102400,Vaccaro; Kristen Marie,0,0,25,25
1668106501123,CSE 290,C00,102414,Pannuto; Patrick William,0,0,25,25
1668106501123,CSE 290,D00,102427,Pevzner; Pavel Arkadjevich,0,0,0,0
1668106501123,CSE 290,E00,102429,Zhao; Jishen,0,0,0,0
1668106501123,CSE 290,F00,102436,Tullsen; Dean Michael,0,0,0,0
1668106501123,CSE 290,G00,102440,Christensen; Henrik I,0,0,20,20
1668106501548,CSE 291,A00,102443,Su; Hao,0,0,0,0
1668106501548,CSE 291,B00,102448,Polikarpova; Nadezhda,0,0,0,0
1668106501548,CSE 291,C00,102453,Vaccaro; Kristen Marie,0,0,0,0
1668106501548,CSE 291,D00,111343,Savage; Stefan,0,0,0,0
1668106501548,CSE 291,E00,116474,Claffy; Kimberly Claire,0,0,0,0
1668106501548,CSE 291,F00,116479,Pasquale; Joseph,0,0,0,0
1668106502015,CSE 293,001,119111,Bafna; Vineet,9999,0,9999,0
1668106502015,CSE 293,002,119118,Bellare; Mihir,9999,0,9999,0
1668106502015,CSE 293,003,119122,Berg-Kirkpatrick; Taylor D,9999,0,9999,0
1668106502015,CSE 293,004,119135,Christensen; Henrik I,9999,0,9999,0
1668106502015,CSE 293,005,119142,Cottrell; Garrison W,9999,0,9999,0
1668106502015,CSE 293,006,119146,Deutsch; Alin Bernard,9999,0,9999,0
1668106502015,CSE 293,007,119159,Esmaeilzadeh; Hadi,9999,0,9999,0
1668106502015,CSE 293,008,119166,Freund; Yoav,9999,0,9999,0
1668106502015,CSE 293,009,119170,Griswold; William G.,9999,0,9999,0
1668106502015,CSE 293,010,119183,Gymrek; Melissa Ann,9999,0,9999,0
1668106502015,CSE 293,011,119190,Heninger; Nadia A,9999,0,9999,0
1668106502015,CSE 293,012,119230,Impagliazzo; Russell,9999,0,9999,0
1668106502015,CSE 293,013,119232,Jhala; Ranjit,9999,0,9999,0
1668106502015,CSE 293,014,119233,Kahng; Andrew Byun,9999,0,9999,0
1668106502015,CSE 293,015,119298,Kane; Daniel Mertz,9999,0,9999,0
1668106502015,CSE 293,016,119299,Kriegman; David J,9999,0,9999,0
1668106502015,CSE 293,017,119300,Kumar; Arun Kumar,9999,0,9999,0
1668106502015,CSE 293,018,119301,Lerner; Sorin,9999,0,9999,0
1668106502015,CSE 293,019,119302,Lovett; Shachar,9999,0,9999,0
1668106502015,CSE 293,020,119303,McAuley; Julian John,9999,0,9999,0
1668106502015,CSE 293,021,119304,Micciancio; Daniele,9999,0,9999,0
1668106502015,CSE 293,022,119367,Orailoglu; Alex,9999,0,9999,0
1668106502015,CSE 293,023,119382,Paturi; Ramamohan,9999,0,9999,0
1668106502015,CSE 293,024,119404,Polikarpova; Nadezhda,9999,0,9999,0
1668106502015,CSE 293,025,119406,Politz; Joseph Gibbs,9999,0,9999,0
1668106502015,CSE 293,026,119411,Porter; George M,9999,0,9999,0
1668106502015,CSE 293,027,119414,Porter; Leonard Emerson,9999,0,9999,0
1668106502015,CSE 293,028,119416,Ramamoorthi; Ravi,9999,0,9999,0
1668106502015,CSE 293,029,119417,Sahoo; Debashis,9999,0,9999,0
1668106502015,CSE 293,030,119420,Saul; Lawrence,9999,0,9999,0
1668106502015,CSE 293,031,119421,Savage; Stefan,9999,0,9999,0
1668106502015,CSE 293,032,119425,Schulze; Jurgen P.,9999,0,9999,0
1668106502015,CSE 293,033,119426,Snoeren; Alex C.,9999,0,9999,0
1668106502015,CSE 293,034,119428,Shang; Jingbo,9999,0,9999,0
1668106502015,CSE 293,035,119430,Stefan; Deian,9999,0,9999,0
1668106502015,CSE 293,036,119431,Su; Hao,9999,0,9999,0
1668106502015,CSE 293,037,119433,Swanson; Steven James,9999,0,9999,0
1668106502015,CSE 293,038,119435,Tullsen; Dean Michael,9999,0,9999,0
1668106502015,CSE 293,039,119483,Voelker; Geoffrey M.,9999,0,9999,0
1668106502015,CSE 293,040,119537,Zhao; Jishen,9999,0,9999,0
1668106502015,CSE 293,041,119538,Zhou; Yuan-Yuan,9999,0,9999,0
1668106502015,CSE 293,042,119539,Gao; Sicun,9999,0,9999,0
1668106502015,CSE 293,043,119540,Weibel; Nadir,9999,0,9999,0
1668106502015,CSE 293,044,119541,Gupta; Rajesh K.,9999,0,9999,0
1668106502015,CSE 293,045,126410,Vaccaro; Kristen Marie,9999,0,9999,0
1668106502015,CSE 293,046,126411,Klemke; Richard,9999,0,9999,0
1668106502444,CSE 294,A00,102459,Voelker; Geoffrey M.,0,0,0,0
1668106502444,CSE 294,B00,111322,Orailoglu; Alex,0,0,0,0
1668106502879,DSE 201,A00,096914,Deutsch; Alin Bernard,30,0,30,0
1668106503304,DSE 210,A00,096915,Dasgupta; Sanjoy,30,0,30,0
1668106503741,DSE 260A,A00,096916,Altintas De Callaf; Ilkay,30,0,30,0
1668106504179,ECE 200,001,103586,Antipa; Nicholas A,9999,0,9999,0
1668106504179,ECE 200,002,103587,Atanasov; Nikolay A.,9999,0,9999,0
1668106504179,ECE 200,003,103588,Bharadia; Dinesh,9999,0,9999,0
1668106504179,ECE 200,004,103589,Cheng; Chung Kuan,9999,0,9999,0
1668106504179,ECE 200,005,103590,Cosman; Pamela C.,9999,0,9999,0
1668106504179,ECE 200,006,103591,Dayeh; Shadi Ahmad,9999,0,9999,0
1668106504179,ECE 200,007,103592,Fainman; Yeshaiahu,9999,0,9999,0
1668106504179,ECE 200,008,103593,Ford; Joseph Earl,9999,0,9999,0
1668106504179,ECE 200,009,103594,Franceschetti; Massimo,9999,0,9999,0
1668106504179,ECE 200,010,103595,Fullerton; Eric E,9999,0,9999,0
1668106504179,ECE 200,011,103596,Galton; Ian A,9999,0,9999,0
1668106504179,ECE 200,012,103597,Gilja; Vikash,9999,0,9999,0
1668106504179,ECE 200,013,103598,Hall; Drew A.,9999,0,9999,0
1668106504179,ECE 200,014,103599,Hsueh; Tzu-Chien,9999,0,9999,0
1668106504179,ECE 200,015,103600,Javidi; Tara,9999,0,9999,0
1668106504179,ECE 200,016,103601,Kahng; Andrew Byun,9999,0,9999,0
1668106504179,ECE 200,017,103602,Kim; Young-Han,9999,0,9999,0
1668106504179,ECE 200,018,103603,Koushanfar; Farinaz,9999,0,9999,0
1668106504179,ECE 200,019,103604,Kuzum; Duygu,9999,0,9999,0
1668106504179,ECE 200,020,103605,Le; Hanh-Phuc,9999,0,9999,0
1668106504179,ECE 200,021,103606,Lin; Bill,9999,0,9999,0
1668106504179,ECE 200,022,103607,Liu; Zhaowei,9998,0,9999,1
1668106504179,ECE 200,023,103608,Lo; Yu-Hwa,9999,0,9999,0
1668106504179,ECE 200,024,103609,Lomakin; Vitaliy,9999,0,9999,0
1668106504179,ECE 200,025,103610,Mercier; Patrick Philip,9999,0,9999,0
1668106504179,ECE 200,026,103611,Meyer; Florian,9999,0,9999,0
1668106504179,ECE 200,027,103612,Milstein; Laurence B.,9999,0,9999,0
1668106504179,ECE 200,028,103613,Mir Arabbaygi; Siavash,9999,0,9999,0
1668106504179,ECE 200,029,103614,Mookherjea; Shayan,9999,0,9999,0
1668106504179,ECE 200,030,103615,Morris; Karcher William,9999,0,9999,0
1668106504179,ECE 200,031,103616,Ng; Tse Nga,9999,0,9999,0
1668106504179,ECE 200,032,103617,Nguyen; Truong Quang,9999,0,9999,0
1668106504179,ECE 200,033,103618,Nomura; Kenji,9999,0,9999,0
1668106504179,ECE 200,034,103619,Orlitsky; Alon,9999,0,9999,0
1668106504179,ECE 200,035,103620,Pal; Piya,9999,0,9999,0
1668106504179,ECE 200,036,103621,Papen; George C.,9999,0,9999,0
1668106504179,ECE 200,037,103622,Radic; Stojan,9999,0,9999,0
1668106504179,ECE 200,038,103623,Rao; Bhaskar D.,9999,0,9999,0
1668106504179,ECE 200,039,103624,Rao; Ramesh R,9999,0,9999,0
1668106504179,ECE 200,040,103625,Rebeiz; Gabriel,9999,0,9999,0
1668106504179,ECE 200,041,103626,Sanford; John R,9999,0,9999,0
1668106504179,ECE 200,042,103627,Siegel; Paul H.,9999,0,9999,0
1668106504179,ECE 200,043,103628,Sievenpiper; Daniel F.,9999,0,9999,0
1668106504179,ECE 200,044,103629,Sworder; David D.,9999,0,9999,0
1668106504179,ECE 200,045,103630,Taur; Yuan,9999,0,9999,0
1668106504179,ECE 200,046,103631,Touri; Behrouz,9999,0,9999,0
1668106504179,ECE 200,047,103632,Trivedi; Mohan M.,9999,0,9999,0
1668106504179,ECE 200,048,103633,Vasconcelos; Nuno,9999,0,9999,0
1668106504179,ECE 200,049,103634,Wang; Xiaolong,9999,0,9999,0
1668106504179,ECE 200,050,103635,Xie; Pengtao,9999,0,9999,0
1668106504179,ECE 200,051,103636,Yip; Michael,9999,0,9999,0
1668106504179,ECE 200,052,103637,Zeger; Kenneth A.,999,0,999,0
1668106504179,ECE 200,053,103638,Zhang; Xinyu,9999,0,9999,0
1668106504179,ECE 200,054,103639,Turakhia; Yatish Girish,9999,0,9999,0
1668106504179,ECE 200,055,103640,Kang; Mingu,9999,0,9999,0
1668106504179,ECE 200,056,103641,Shi; Yuanyuan,9999,0,9999,0
1668106504179,ECE 200,057,103642,Wang; Edward Jay,9999,0,9999,0
1668106504179,ECE 200,058,103643,Zheng; Yang,9999,0,9999,0
1668106504614,ECE 202,A00,103644,Kuzum; Duygu,0,0,0,0
1668106505037,ECE 212BN,A00,103646,Ng; Tse Nga,0,0,0,0
1668106505472,ECE 221,A00,111493,Staff,0,0,0,0
1668106505905,ECE 222B,A00,103647,Lomakin; Vitaliy,0,0,0,0
1668106506345,ECE 230B,A00,103648,Taur; Yuan,0,0,0,0
1668106506771,ECE 238B,A00,103649,Garay; Javier,0,0,0,0
1668106507203,ECE 240B,A00,112900,Fainman; Yeshaiahu,0,0,0,0
1668106507647,ECE 247A,A00,103650,Jokerst; Jesse Vincent,0,0,0,0
1668106508074,ECE 247B,A00,103651,Wang; Joseph,0,0,0,0
1668106508507,ECE 250,A00,103652,Siegel; Paul H.,0,0,0,0
1668106508933,ECE 251A,A00,103654,Rao; Bhaskar D.,0,0,0,0
1668106509368,ECE 257B,A00,103655,Bharadia; Dinesh,0,0,0,0
1668106509793,ECE 258A,A00,103656,Milstein; Laurence B.,0,0,0,0
1668106510218,ECE 260B,A00,103658,Kang; Mingu,0,0,0,0
1668106510649,ECE 264A,A00,103659,Galton; Ian A,0,0,0,0
1668106511075,ECE 265A,A00,103661,Gudem; Prasad S.S.,0,0,0,0
1668106511507,ECE 265D,A00,103662,Gudem; Prasad S.S.,0,0,0,0
1668106511933,ECE 268,A00,103663,Koushanfar; Farinaz,0,0,0,0
1668106512365,ECE 269,A01,103665,Pal; Piya,0,0,0,0
1668106512791,ECE 271B,A00,103666,Vasconcelos; Manuela,0,0,0,0
1668106513216,ECE 276A,A00,103667,Atanasov; Nikolay A.,0,0,0,0
1668106513643,ECE 277,A00,103668,An; Cheolhong,0,0,0,0
1668106514071,ECE 279,A00,117947,Hall; Drew A.,0,0,0,0
1668106515031,ECE 283,A00,103670,Hsueh; Tzu-Chien,0,0,0,0
1668106515464,ECE 284,A00,103671,Turakhia; Yatish Girish,0,0,0,0
1668106515888,ECE 285,A00,103672,Zheng; Yang,0,0,0,0
1668106515888,ECE 285,B00,103673,Sworder; David D.,0,0,0,0
1668106516313,ECE 287,A00,103676,Javidi; Tara,0,0,0,0
1668106516753,MATH 200B,A00,098023,Salehi Golsefidy; Alireza,12,0,15,3
1668106517176,MATH 202B,A00,098024,Rhoades; Brendon Patrick,9,0,15,6
1668106517599,MATH 203B,A00,098025,Oprea; Dragos N.,10,0,15,5
1668106518036,MATH 204B,A00,098026,Sorensen; Claus M,13,0,15,2
1668106518460,MATH 208,A00,098027,Izadi; Elham,7,0,10,3
1668106518891,MATH 209,A00,098028,Pollack; Aaron,10,0,10,0
1668106519314,MATH 211A,A00,112919,Rogalski; Daniel,9,0,10,1
1668106519746,MATH 211B,A00,112920,Seward; Brandon M.,9,0,10,1
1668106520168,MATH 218,A00,098029,Li; Bo,10,0,10,0
1668106520597,MATH 220B,A00,098030,Novak; Jonathan I,11,0,15,4
1668106521023,MATH 221A,A00,098031,Ebenfelt; Peter F,13,0,15,2
1668106521450,MATH 231B,A00,098032,Zlatos; Andrej,12,0,15,3
1668106521883,MATH 240B,A00,098033,Ni; Lei,9,0,15,6
1668106522309,MATH 243,A00,098034,Jekel; David Andrew,10,0,10,0
1668106522744,MATH 245A,A00,098035,Nie; Jiawang,0,0,15,16
1668106523166,MATH 248,A00,098036,Bejenaru; Ioan,10,0,10,0
1668106523601,MATH 250B,A00,098037,Spolaor; Luca,14,0,15,1
1668106524028,MATH 258,A00,098038,Ni; Lei,10,0,10,0
1668106524462,MATH 264B,A00,098041,Rhoades; Brendon Patrick,9,0,15,6
1668106524901,MATH 268,A00,098042,Buss; Samuel R,10,0,10,0
1668106525333,MATH 269,A00,098043,Rhoades; Brendon Patrick,10,0,10,0
1668106525756,MATH 270B,A00,098044,Li; Bo,10,0,15,5
1668106526189,MATH 272B,A00,098045,Holst; Michael J,13,0,15,2
1668106526632,MATH 273A,A00,098046,Tian; Xiaochuan,10,0,15,5
1668106527055,MATH 275,A01,098048,Tian; Xiaochuan,6,0,10,4
1668106527479,MATH 278A,A00,098049,Holst; Michael J,8,0,10,2
1668106527907,MATH 278B,A00,098050,Cloninger; Alexander,10,0,10,0
1668106528333,MATH 278C,A00,098051,Nie; Jiawang,7,0,10,3
1668106528764,MATH 280B,A00,098052,Zheng; Tianyi,10,0,15,5
1668106529201,MATH 281B,A00,098053,Bradic; Jelena,2,0,15,13
1668106529625,MATH 282B,A00,098054,Arias-Castro; Ery,0,0,15,15
1668106530049,MATH 285,A00,098055,Fitzsimmons; Patrick J,0,0,15,17
1668106530490,MATH 287B,A00,098056,Arias-Castro; Ery,3,0,15,12
1668106530913,MATH 288,A00,098057,Agarwal; Pooja,9,0,10,1
1668106530913,MATH 288,B00,098058,Zhang; Danna,8,0,10,2
1668106530913,MATH 288,C00,098059,Williams; Ruth J,10,0,10,0
1668106531349,MATH 290B,A00,098060,Roberts; Justin Deritter,13,0,15,2
1668106531772,MATH 292,A00,098061,Belmont; Eva Kinoshita,10,0,10,0
1668106532218,MATH 295,A00,098062,Suk; Andrew Hoon,48,0,50,2
1668106532649,MATH 296,A00,098063,Novak; Jonathan I,20,0,20,0
1668106533075,MATH 297,001,098064,Gamst; Anthony Collins,9997,0,9999,2
1668107041601,COGS 205,A00,101395,Chiba; Andrea,19,0,20,1
1668107042036,COGS 210B,001,101404,Greene; Deanna Jacquelyn,9998,0,9999,1
1668107042036,COGS 210B,002,101417,Xia; Haijun,9999,0,9999,0
1668107042036,COGS 210B,003,101422,Nitz; Douglas A.,9999,0,9999,0
1668107042036,COGS 210B,004,101423,Hollan; James D.,9998,0,9999,1
1668107042036,COGS 210B,005,101424,Deak; Gedeon O.,9998,0,9999,1
1668107042036,COGS 210B,006,101425,Rossano; Federico,9999,0,9999,0
1668107042474,COGS 211B,A00,101427,Coulson; Seana M,9996,0,9999,3
1668107042903,COGS 220,A00,101428,Hollan; James D.,0,0,25,25
1668107043327,COGS 229,A00,101429,Dow; Steven P,18,0,25,7
1668107043848,COGS 230,A00,101430,Klemmer; Scott R,13,0,17,4
1668107044272,COGS 234,A00,101431,Xia; Haijun,3,0,25,22
1668107044711,COGS 260,A00,101432,Kiyonaga; Anastasia,19,0,25,6
1668107044711,COGS 260,B00,101433,Kirsh; David Joel,16,0,25,9
1668107045134,CSE 202,A00,102371,Impagliazzo; Russell,0,0,0,0
1668107045568,CSE 203B,A01,102373,Cheng; Chung Kuan,0,0,0,0
1668107045993,CSE 208,A00,102374,Micciancio; Daniele,0,0,0,0
1668107046417,CSE 209A,A00,112895,Impagliazzo; Russell,0,0,15,15
1668107046848,CSE 209B,A00,108005,Bellare; Mihir,0,0,0,0
1668107047276,CSE 210,A00,113163,Coblenz; Michael J,0,0,0,0
1668107047737,CSE 219,A00,106111,Dow; Steven P,0,0,20,20
1668107048164,CSE 221,A00,102376,Voelker; Geoffrey M.,0,0,0,0
1668107048607,CSE 224,A01,102378,Porter; George M,0,0,0,0
1668107049034,CSE 229A,A00,102379,Savage; Stefan,0,0,0,0
1668107049464,CSE 229C,A00,102380,Munyaka; Imani N. S.,0,0,0,0
1668107049902,CSE 232B,A00,102382,Deutsch; Alin Bernard,0,0,0,0
1668107050337,CSE 234,A01,112904,Kumar; Arun Kumar,0,0,0,0
1668107050773,CSE 237A,A00,102383,Rosing; Tajana Simunic,0,0,0,0
1668107051200,CSE 239A,A00,102384,Deutsch; Alin Bernard,0,0,0,0
1668107051637,CSE 239B,A00,102385,Polikarpova; Nadezhda,0,0,0,0
1668107052073,CSE 240A,A00,102386,Pannuto; Patrick William,0,0,0,0
1668107052506,CSE 240B,A00,102387,Zhao; Jishen,0,0,0,0
1668107052935,CSE 241A,A00,106406,Kang; Mingu,0,0,0,0
1668107053369,CSE 249B,A00,102388,Kahng; Andrew Byun,0,0,8,8
1668107053793,CSE 251B,A01,102392,Cottrell; Garrison W,0,0,0,0
1668107053793,CSE 251B,A02,102393,Cottrell; Garrison W,0,0,0,0
1668107054221,CSE 252B,A00,102394,Ochoa; Benjamin Lawrence,0,0,0,0
1668107054644,CSE 257,A01,102396,Gao; Sicun,0,0,0,0
1668107055073,CSE 272,A00,102397,Li; Tzumao,0,0,0,0
1668107055506,CSE 274,A00,111323,Chern; Albert Ren-Haur,0,0,0,0
1668107055935,CSE 282,A00,102398,Pevzner; Pavel Arkadjevich,0,0,0,0
1668107056363,CSE 284,A00,114175,Gymrek; Melissa Ann,0,0,0,0
1668107056802,CSE 290,A00,102399,Chandraker; Manmohan Krishna,0,0,0,0
1668107056802,CSE 290,B00,102400,Vaccaro; Kristen Marie,0,0,25,25
1668107056802,CSE 290,C00,102414,Pannuto; Patrick William,0,0,25,25
1668107056802,CSE 290,D00,102427,Pevzner; Pavel Arkadjevich,0,0,0,0
1668107056802,CSE 290,E00,102429,Zhao; Jishen,0,0,0,0
1668107056802,CSE 290,F00,102436,Tullsen; Dean Michael,0,0,0,0
1668107056802,CSE 290,G00,102440,Christensen; Henrik I,0,0,20,20
1668107057227,CSE 291,A00,102443,Su; Hao,0,0,0,0
1668107057227,CSE 291,B00,102448,Polikarpova; Nadezhda,0,0,0,0
1668107057227,CSE 291,C00,102453,Vaccaro; Kristen Marie,0,0,0,0
1668107057227,CSE 291,D00,111343,Savage; Stefan,0,0,0,0
1668107057227,CSE 291,E00,116474,Claffy; Kimberly Claire,0,0,0,0
1668107057227,CSE 291,F00,116479,Pasquale; Joseph,0,0,0,0
1668107057666,CSE 293,001,119111,Bafna; Vineet,9999,0,9999,0
1668107057666,CSE 293,002,119118,Bellare; Mihir,9999,0,9999,0
1668107057666,CSE 293,003,119122,Berg-Kirkpatrick; Taylor D,9999,0,9999,0
1668107057666,CSE 293,004,119135,Christensen; Henrik I,9999,0,9999,0
1668107057666,CSE 293,005,119142,Cottrell; Garrison W,9999,0,9999,0
1668107057666,CSE 293,006,119146,Deutsch; Alin Bernard,9999,0,9999,0
1668107057666,CSE 293,007,119159,Esmaeilzadeh; Hadi,9999,0,9999,0
1668107057666,CSE 293,008,119166,Freund; Yoav,9999,0,9999,0
1668107057666,CSE 293,009,119170,Griswold; William G.,9999,0,9999,0
1668107057666,CSE 293,010,119183,Gymrek; Melissa Ann,9999,0,9999,0
1668107057666,CSE 293,011,119190,Heninger; Nadia A,9999,0,9999,0
1668107057666,CSE 293,012,119230,Impagliazzo; Russell,9999,0,9999,0
1668107057666,CSE 293,013,119232,Jhala; Ranjit,9999,0,9999,0
1668107057666,CSE 293,014,119233,Kahng; Andrew Byun,9999,0,9999,0
1668107057666,CSE 293,015,119298,Kane; Daniel Mertz,9999,0,9999,0
1668107057666,CSE 293,016,119299,Kriegman; David J,9999,0,9999,0
1668107057666,CSE 293,017,119300,Kumar; Arun Kumar,9999,0,9999,0
1668107057666,CSE 293,018,119301,Lerner; Sorin,9999,0,9999,0
1668107057666,CSE 293,019,119302,Lovett; Shachar,9999,0,9999,0
1668107057666,CSE 293,020,119303,McAuley; Julian John,9999,0,9999,0
1668107057666,CSE 293,021,119304,Micciancio; Daniele,9999,0,9999,0
1668107057666,CSE 293,022,119367,Orailoglu; Alex,9999,0,9999,0
1668107057666,CSE 293,023,119382,Paturi; Ramamohan,9999,0,9999,0
1668107057666,CSE 293,024,119404,Polikarpova; Nadezhda,9999,0,9999,0
1668107057666,CSE 293,025,119406,Politz; Joseph Gibbs,9999,0,9999,0
1668107057666,CSE 293,026,119411,Porter; George M,9999,0,9999,0
1668107057666,CSE 293,027,119414,Porter; Leonard Emerson,9999,0,9999,0
1668107057666,CSE 293,028,119416,Ramamoorthi; Ravi,9999,0,9999,0
1668107057666,CSE 293,029,119417,Sahoo; Debashis,9999,0,9999,0
1668107057666,CSE 293,030,119420,Saul; Lawrence,9999,0,9999,0
1668107057666,CSE 293,031,119421,Savage; Stefan,9999,0,9999,0
1668107057666,CSE 293,032,119425,Schulze; Jurgen P.,9999,0,9999,0
1668107057666,CSE 293,033,119426,Snoeren; Alex C.,9999,0,9999,0
1668107057666,CSE 293,034,119428,Shang; Jingbo,9999,0,9999,0
1668107057666,CSE 293,035,119430,Stefan; Deian,9999,0,9999,0
1668107057666,CSE 293,036,119431,Su; Hao,9999,0,9999,0
1668107057666,CSE 293,037,119433,Swanson; Steven James,9999,0,9999,0
1668107057666,CSE 293,038,119435,Tullsen; Dean Michael,9999,0,9999,0
1668107057666,CSE 293,039,119483,Voelker; Geoffrey M.,9999,0,9999,0
1668107057666,CSE 293,040,119537,Zhao; Jishen,9999,0,9999,0
1668107057666,CSE 293,041,119538,Zhou; Yuan-Yuan,9999,0,9999,0
1668107057666,CSE 293,042,119539,Gao; Sicun,9999,0,9999,0
1668107057666,CSE 293,043,119540,Weibel; Nadir,9999,0,9999,0
1668107057666,CSE 293,044,119541,Gupta; Rajesh K.,9999,0,9999,0
1668107057666,CSE 293,045,126410,Vaccaro; Kristen Marie,9999,0,9999,0
1668107057666,CSE 293,046,126411,Klemke; Richard,9999,0,9999,0
1668107058093,CSE 294,A00,102459,Voelker; Geoffrey M.,0,0,0,0
1668107058093,CSE 294,B00,111322,Orailoglu; Alex,0,0,0,0
1668107058522,DSE 201,A00,096914,Deutsch; Alin Bernard,30,0,30,0
1668107058951,DSE 210,A00,096915,Dasgupta; Sanjoy,30,0,30,0
1668107059385,DSE 260A,A00,096916,Altintas De Callaf; Ilkay,30,0,30,0
1668107059823,ECE 200,001,103586,Antipa; Nicholas A,9999,0,9999,0
1668107059823,ECE 200,002,103587,Atanasov; Nikolay A.,9999,0,9999,0
1668107059823,ECE 200,003,103588,Bharadia; Dinesh,9999,0,9999,0
1668107059823,ECE 200,004,103589,Cheng; Chung Kuan,9999,0,9999,0
1668107059823,ECE 200,005,103590,Cosman; Pamela C.,9999,0,9999,0
1668107059823,ECE 200,006,103591,Dayeh; Shadi Ahmad,9999,0,9999,0
1668107059823,ECE 200,007,103592,Fainman; Yeshaiahu,9999,0,9999,0
1668107059823,ECE 200,008,103593,Ford; Joseph Earl,9999,0,9999,0
1668107059823,ECE 200,009,103594,Franceschetti; Massimo,9999,0,9999,0
1668107059823,ECE 200,010,103595,Fullerton; Eric E,9999,0,9999,0
1668107059823,ECE 200,011,103596,Galton; Ian A,9999,0,9999,0
1668107059823,ECE 200,012,103597,Gilja; Vikash,9999,0,9999,0
1668107059823,ECE 200,013,103598,Hall; Drew A.,9999,0,9999,0
1668107059823,ECE 200,014,103599,Hsueh; Tzu-Chien,9999,0,9999,0
1668107059823,ECE 200,015,103600,Javidi; Tara,9999,0,9999,0
1668107059823,ECE 200,016,103601,Kahng; Andrew Byun,9999,0,9999,0
1668107059823,ECE 200,017,103602,Kim; Young-Han,9999,0,9999,0
1668107059823,ECE 200,018,103603,Koushanfar; Farinaz,9999,0,9999,0
1668107059823,ECE 200,019,103604,Kuzum; Duygu,9999,0,9999,0
1668107059823,ECE 200,020,103605,Le; Hanh-Phuc,9999,0,9999,0
1668107059823,ECE 200,021,103606,Lin; Bill,9999,0,9999,0
1668107059823,ECE 200,022,103607,Liu; Zhaowei,9998,0,9999,1
1668107059823,ECE 200,023,103608,Lo; Yu-Hwa,9999,0,9999,0
1668107059823,ECE 200,024,103609,Lomakin; Vitaliy,9999,0,9999,0
1668107059823,ECE 200,025,103610,Mercier; Patrick Philip,9999,0,9999,0
1668107059823,ECE 200,026,103611,Meyer; Florian,9999,0,9999,0
1668107059823,ECE 200,027,103612,Milstein; Laurence B.,9999,0,9999,0
1668107059823,ECE 200,028,103613,Mir Arabbaygi; Siavash,9999,0,9999,0
1668107059823,ECE 200,029,103614,Mookherjea; Shayan,9999,0,9999,0
1668107059823,ECE 200,030,103615,Morris; Karcher William,9999,0,9999,0
1668107059823,ECE 200,031,103616,Ng; Tse Nga,9999,0,9999,0
1668107059823,ECE 200,032,103617,Nguyen; Truong Quang,9999,0,9999,0
1668107059823,ECE 200,033,103618,Nomura; Kenji,9999,0,9999,0
1668107059823,ECE 200,034,103619,Orlitsky; Alon,9999,0,9999,0
1668107059823,ECE 200,035,103620,Pal; Piya,9999,0,9999,0
1668107059823,ECE 200,036,103621,Papen; George C.,9999,0,9999,0
1668107059823,ECE 200,037,103622,Radic; Stojan,9999,0,9999,0
1668107059823,ECE 200,038,103623,Rao; Bhaskar D.,9999,0,9999,0
1668107059823,ECE 200,039,103624,Rao; Ramesh R,9999,0,9999,0
1668107059823,ECE 200,040,103625,Rebeiz; Gabriel,9999,0,9999,0
1668107059823,ECE 200,041,103626,Sanford; John R,9999,0,9999,0
1668107059823,ECE 200,042,103627,Siegel; Paul H.,9999,0,9999,0
1668107059823,ECE 200,043,103628,Sievenpiper; Daniel F.,9999,0,9999,0
1668107059823,ECE 200,044,103629,Sworder; David D.,9999,0,9999,0
1668107059823,ECE 200,045,103630,Taur; Yuan,9999,0,9999,0
1668107059823,ECE 200,046,103631,Touri; Behrouz,9999,0,9999,0
1668107059823,ECE 200,047,103632,Trivedi; Mohan M.,9999,0,9999,0
1668107059823,ECE 200,048,103633,Vasconcelos; Nuno,9999,0,9999,0
1668107059823,ECE 200,049,103634,Wang; Xiaolong,9999,0,9999,0
1668107059823,ECE 200,050,103635,Xie; Pengtao,9999,0,9999,0
1668107059823,ECE 200,051,103636,Yip; Michael,9999,0,9999,0
1668107059823,ECE 200,052,103637,Zeger; Kenneth A.,999,0,999,0
1668107059823,ECE 200,053,103638,Zhang; Xinyu,9999,0,9999,0
1668107059823,ECE 200,054,103639,Turakhia; Yatish Girish,9999,0,9999,0
1668107059823,ECE 200,055,103640,Kang; Mingu,9999,0,9999,0
1668107059823,ECE 200,056,103641,Shi; Yuanyuan,9999,0,9999,0
1668107059823,ECE 200,057,103642,Wang; Edward Jay,9999,0,9999,0
1668107059823,ECE 200,058,103643,Zheng; Yang,9999,0,9999,0
1668107060253,ECE 202,A00,103644,Kuzum; Duygu,0,0,0,0
1668107060689,ECE 212BN,A00,103646,Ng; Tse Nga,0,0,0,0
1668107061114,ECE 221,A00,111493,Staff,0,0,0,0
1668107061545,ECE 222B,A00,103647,Lomakin; Vitaliy,0,0,0,0
1668107061983,ECE 230B,A00,103648,Taur; Yuan,0,0,0,0
1668107062417,ECE 238B,A00,103649,Garay; Javier,0,0,0,0
1668107062846,ECE 240B,A00,112900,Fainman; Yeshaiahu,0,0,0,0
1668107063280,ECE 247A,A00,103650,Jokerst; Jesse Vincent,0,0,0,0
1668107063712,ECE 247B,A00,103651,Wang; Joseph,0,0,0,0
1668107064152,ECE 250,A00,103652,Siegel; Paul H.,0,0,0,0
1668107064575,ECE 251A,A00,103654,Rao; Bhaskar D.,0,0,0,0
1668107065014,ECE 257B,A00,103655,Bharadia; Dinesh,0,0,0,0
1668107065441,ECE 258A,A00,103656,Milstein; Laurence B.,0,0,0,0
1668107065870,ECE 260B,A00,103658,Kang; Mingu,0,0,0,0
1668107066302,ECE 264A,A00,103659,Galton; Ian A,0,0,0,0
1668107066730,ECE 265A,A00,103661,Gudem; Prasad S.S.,0,0,0,0
1668107067154,ECE 265D,A00,103662,Gudem; Prasad S.S.,0,0,0,0
1668107067579,ECE 268,A00,103663,Koushanfar; Farinaz,0,0,0,0
1668107068021,ECE 269,A01,103665,Pal; Piya,0,0,0,0
1668107068443,ECE 271B,A00,103666,Vasconcelos; Manuela,0,0,0,0
1668107068874,ECE 276A,A00,103667,Atanasov; Nikolay A.,0,0,0,0
1668107069308,ECE 277,A00,103668,An; Cheolhong,0,0,0,0
1668107069764,ECE 279,A00,117947,Hall; Drew A.,0,0,0,0
1668107070621,ECE 283,A00,103670,Hsueh; Tzu-Chien,0,0,0,0
1668107071049,ECE 284,A00,103671,Turakhia; Yatish Girish,0,0,0,0
1668107071472,ECE 285,A00,103672,Zheng; Yang,0,0,0,0
1668107071472,ECE 285,B00,103673,Sworder; David D.,0,0,0,0
1668107071894,ECE 287,A00,103676,Javidi; Tara,0,0,0,0
1668107072326,MATH 200B,A00,098023,Salehi Golsefidy; Alireza,12,0,15,3
1668107072760,MATH 202B,A00,098024,Rhoades; Brendon Patrick,9,0,15,6
1668107073190,MATH 203B,A00,098025,Oprea; Dragos N.,10,0,15,5
1668107073614,MATH 204B,A00,098026,Sorensen; Claus M,13,0,15,2
1668107074046,MATH 208,A00,098027,Izadi; Elham,7,0,10,3
1668107074472,MATH 209,A00,098028,Pollack; Aaron,10,0,10,0
1668107074899,MATH 211A,A00,112919,Rogalski; Daniel,9,0,10,1
1668107075324,MATH 211B,A00,112920,Seward; Brandon M.,9,0,10,1
1668107075748,MATH 218,A00,098029,Li; Bo,10,0,10,0
1668107076171,MATH 220B,A00,098030,Novak; Jonathan I,11,0,15,4
1668107076596,MATH 221A,A00,098031,Ebenfelt; Peter F,13,0,15,2
1668107077033,MATH 231B,A00,098032,Zlatos; Andrej,12,0,15,3
1668107077456,MATH 240B,A00,098033,Ni; Lei,9,0,15,6
1668107077890,MATH 243,A00,098034,Jekel; David Andrew,10,0,10,0
1668107078314,MATH 245A,A00,098035,Nie; Jiawang,0,0,15,16
1668107078736,MATH 248,A00,098036,Bejenaru; Ioan,10,0,10,0
1668107079167,MATH 250B,A00,098037,Spolaor; Luca,14,0,15,1
1668107079598,MATH 258,A00,098038,Ni; Lei,10,0,10,0
1668107080035,MATH 264B,A00,098041,Rhoades; Brendon Patrick,9,0,15,6
1668107080463,MATH 268,A00,098042,Buss; Samuel R,10,0,10,0
1668107080911,MATH 269,A00,098043,Rhoades; Brendon Patrick,10,0,10,0
1668107081341,MATH 270B,A00,098044,Li; Bo,10,0,15,5
1668107081767,MATH 272B,A00,098045,Holst; Michael J,13,0,15,2
1668107082191,MATH 273A,A00,098046,Tian; Xiaochuan,10,0,15,5
1668107082623,MATH 275,A01,098048,Tian; Xiaochuan,6,0,10,4
1668107083048,MATH 278A,A00,098049,Holst; Michael J,8,0,10,2
1668107083483,MATH 278B,A00,098050,Cloninger; Alexander,10,0,10,0
1668107083906,MATH 278C,A00,098051,Nie; Jiawang,7,0,10,3
1668107084338,MATH 280B,A00,098052,Zheng; Tianyi,10,0,15,5
1668107084766,MATH 281B,A00,098053,Bradic; Jelena,2,0,15,13
1668107085191,MATH 282B,A00,098054,Arias-Castro; Ery,0,0,15,15
1668107085619,MATH 285,A00,098055,Fitzsimmons; Patrick J,0,0,15,17
1668107086046,MATH 287B,A00,098056,Arias-Castro; Ery,3,0,15,12
1668107086485,MATH 288,A00,098057,Agarwal; Pooja,9,0,10,1
1668107086485,MATH 288,B00,098058,Zhang; Danna,8,0,10,2
1668107086485,MATH 288,C00,098059,Williams; Ruth J,10,0,10,0
1668107086908,MATH 290B,A00,098060,Roberts; Justin Deritter,13,0,15,2
1668107087416,MATH 292,A00,098061,Belmont; Eva Kinoshita,10,0,10,0
1668107087842,MATH 295,A00,098062,Suk; Andrew Hoon,48,0,50,2
1668107088273,MATH 296,A00,098063,Novak; Jonathan I,20,0,20,0
1668107088703,MATH 297,001,098064,Gamst; Anthony Collins,9997,0,9999,2
1668107594929,COGS 205,A00,101395,Chiba; Andrea,19,0,20,1
1668107595352,COGS 210B,001,101404,Greene; Deanna Jacquelyn,9998,0,9999,1
1668107595352,COGS 210B,002,101417,Xia; Haijun,9999,0,9999,0
1668107595352,COGS 210B,003,101422,Nitz; Douglas A.,9999,0,9999,0
1668107595352,COGS 210B,004,101423,Hollan; James D.,9998,0,9999,1
1668107595352,COGS 210B,005,101424,Deak; Gedeon O.,9998,0,9999,1
1668107595352,COGS 210B,006,101425,Rossano; Federico,9999,0,9999,0
1668107595782,COGS 211B,A00,101427,Coulson; Seana M,9996,0,9999,3
1668107596208,COGS 220,A00,101428,Hollan; James D.,0,0,25,25
1668107596638,COGS 229,A00,101429,Dow; Steven P,18,0,25,7
1668107597061,COGS 230,A00,101430,Klemmer; Scott R,13,0,17,4
1668107597499,COGS 234,A00,101431,Xia; Haijun,3,0,25,22
1668107597922,COGS 260,A00,101432,Kiyonaga; Anastasia,19,0,25,6
1668107597922,COGS 260,B00,101433,Kirsh; David Joel,16,0,25,9
1668107598361,CSE 202,A00,102371,Impagliazzo; Russell,0,0,0,0
1668107598811,CSE 203B,A01,102373,Cheng; Chung Kuan,0,0,0,0
1668107599240,CSE 208,A00,102374,Micciancio; Daniele,0,0,0,0
1668107599666,CSE 209A,A00,112895,Impagliazzo; Russell,0,0,15,15
1668107600088,CSE 209B,A00,108005,Bellare; Mihir,0,0,0,0
1668107600515,CSE 210,A00,113163,Coblenz; Michael J,0,0,0,0
1668107600943,CSE 219,A00,106111,Dow; Steven P,0,0,20,20
1668107601375,CSE 221,A00,102376,Voelker; Geoffrey M.,0,0,0,0
1668107601808,CSE 224,A01,102378,Porter; George M,0,0,0,0
1668107602231,CSE 229A,A00,102379,Savage; Stefan,0,0,0,0
1668107602658,CSE 229C,A00,102380,Munyaka; Imani N. S.,0,0,0,0
1668107603082,CSE 232B,A00,102382,Deutsch; Alin Bernard,0,0,0,0
1668107603520,CSE 234,A01,112904,Kumar; Arun Kumar,0,0,0,0
1668107603948,CSE 237A,A00,102383,Rosing; Tajana Simunic,0,0,0,0
1668107604382,CSE 239A,A00,102384,Deutsch; Alin Bernard,0,0,0,0
1668107604811,CSE 239B,A00,102385,Polikarpova; Nadezhda,0,0,0,0
1668107605237,CSE 240A,A00,102386,Pannuto; Patrick William,0,0,0,0
1668107605662,CSE 240B,A00,102387,Zhao; Jishen,0,0,0,0
1668107606084,CSE 241A,A00,106406,Kang; Mingu,0,0,0,0
1668107606537,CSE 249B,A00,102388,Kahng; Andrew Byun,0,0,8,8
1668107606963,CSE 251B,A01,102392,Cottrell; Garrison W,0,0,0,0
1668107606963,CSE 251B,A02,102393,Cottrell; Garrison W,0,0,0,0
1668107607398,CSE 252B,A00,102394,Ochoa; Benjamin Lawrence,0,0,0,0
1668107607821,CSE 257,A01,102396,Gao; Sicun,0,0,0,0
1668107608247,CSE 272,A00,102397,Li; Tzumao,0,0,0,0
1668107608687,CSE 274,A00,111323,Chern; Albert Ren-Haur,0,0,0,0
1668107609127,CSE 282,A00,102398,Pevzner; Pavel Arkadjevich,0,0,0,0
1668107609550,CSE 284,A00,114175,Gymrek; Melissa Ann,0,0,0,0
1668107609975,CSE 290,A00,102399,Chandraker; Manmohan Krishna,0,0,0,0
1668107609975,CSE 290,B00,102400,Vaccaro; Kristen Marie,0,0,25,25
1668107609975,CSE 290,C00,102414,Pannuto; Patrick William,0,0,25,25
1668107609975,CSE 290,D00,102427,Pevzner; Pavel Arkadjevich,0,0,0,0
1668107609975,CSE 290,E00,102429,Zhao; Jishen,0,0,0,0
1668107609975,CSE 290,F00,102436,Tullsen; Dean Michael,0,0,0,0
1668107609975,CSE 290,G00,102440,Christensen; Henrik I,0,0,20,20
1668107610402,CSE 291,A00,102443,Su; Hao,0,0,0,0
1668107610402,CSE 291,B00,102448,Polikarpova; Nadezhda,0,0,0,0
1668107610402,CSE 291,C00,102453,Vaccaro; Kristen Marie,0,0,0,0
1668107610402,CSE 291,D00,111343,Savage; Stefan,0,0,0,0
1668107610402,CSE 291,E00,116474,Claffy; Kimberly Claire,0,0,0,0
1668107610402,CSE 291,F00,116479,Pasquale; Joseph,0,0,0,0
1668107610841,CSE 293,001,119111,Bafna; Vineet,9999,0,9999,0
1668107610841,CSE 293,002,119118,Bellare; Mihir,9999,0,9999,0
1668107610841,CSE 293,003,119122,Berg-Kirkpatrick; Taylor D,9999,0,9999,0
1668107610841,CSE 293,004,119135,Christensen; Henrik I,9999,0,9999,0
1668107610841,CSE 293,005,119142,Cottrell; Garrison W,9999,0,9999,0
1668107610841,CSE 293,006,119146,Deutsch; Alin Bernard,9999,0,9999,0
1668107610841,CSE 293,007,119159,Esmaeilzadeh; Hadi,9999,0,9999,0
1668107610841,CSE 293,008,119166,Freund; Yoav,9999,0,9999,0
1668107610841,CSE 293,009,119170,Griswold; William G.,9999,0,9999,0
1668107610841,CSE 293,010,119183,Gymrek; Melissa Ann,9999,0,9999,0
1668107610841,CSE 293,011,119190,Heninger; Nadia A,9999,0,9999,0
1668107610841,CSE 293,012,119230,Impagliazzo; Russell,9999,0,9999,0
1668107610841,CSE 293,013,119232,Jhala; Ranjit,9999,0,9999,0
1668107610841,CSE 293,014,119233,Kahng; Andrew Byun,9999,0,9999,0
1668107610841,CSE 293,015,119298,Kane; Daniel Mertz,9999,0,9999,0
1668107610841,CSE 293,016,119299,Kriegman; David J,9999,0,9999,0
1668107610841,CSE 293,017,119300,Kumar; Arun Kumar,9999,0,9999,0
1668107610841,CSE 293,018,119301,Lerner; Sorin,9999,0,9999,0
1668107610841,CSE 293,019,119302,Lovett; Shachar,9999,0,9999,0
1668107610841,CSE 293,020,119303,McAuley; Julian John,9999,0,9999,0
1668107610841,CSE 293,021,119304,Micciancio; Daniele,9999,0,9999,0
1668107610841,CSE 293,022,119367,Orailoglu; Alex,9999,0,9999,0
1668107610841,CSE 293,023,119382,Paturi; Ramamohan,9999,0,9999,0
1668107610841,CSE 293,024,119404,Polikarpova; Nadezhda,9999,0,9999,0
1668107610841,CSE 293,025,119406,Politz; Joseph Gibbs,9999,0,9999,0
1668107610841,CSE 293,026,119411,Porter; George M,9999,0,9999,0
1668107610841,CSE 293,027,119414,Porter; Leonard Emerson,9999,0,9999,0
1668107610841,CSE 293,028,119416,Ramamoorthi; Ravi,9999,0,9999,0
1668107610841,CSE 293,029,119417,Sahoo; Debashis,9999,0,9999,0
1668107610841,CSE 293,030,119420,Saul; Lawrence,9999,0,9999,0
1668107610841,CSE 293,031,119421,Savage; Stefan,9999,0,9999,0
1668107610841,CSE 293,032,119425,Schulze; Jurgen P.,9999,0,9999,0
1668107610841,CSE 293,033,119426,Snoeren; Alex C.,9999,0,9999,0
1668107610841,CSE 293,034,119428,Shang; Jingbo,9999,0,9999,0
1668107610841,CSE 293,035,119430,Stefan; Deian,9999,0,9999,0
1668107610841,CSE 293,036,119431,Su; Hao,9999,0,9999,0
1668107610841,CSE 293,037,119433,Swanson; Steven James,9999,0,9999,0
1668107610841,CSE 293,038,119435,Tullsen; Dean Michael,9999,0,9999,0
1668107610841,CSE 293,039,119483,Voelker; Geoffrey M.,9999,0,9999,0
1668107610841,CSE 293,040,119537,Zhao; Jishen,9999,0,9999,0
1668107610841,CSE 293,041,119538,Zhou; Yuan-Yuan,9999,0,9999,0
1668107610841,CSE 293,042,119539,Gao; Sicun,9999,0,9999,0
1668107610841,CSE 293,043,119540,Weibel; Nadir,9999,0,9999,0
1668107610841,CSE 293,044,119541,Gupta; Rajesh K.,9999,0,9999,0
1668107610841,CSE 293,045,126410,Vaccaro; Kristen Marie,9999,0,9999,0
1668107610841,CSE 293,046,126411,Klemke; Richard,9999,0,9999,0
1668107611264,CSE 294,A00,102459,Voelker; Geoffrey M.,0,0,0,0
1668107611264,CSE 294,B00,111322,Orailoglu; Alex,0,0,0,0
1668107611694,DSE 201,A00,096914,Deutsch; Alin Bernard,30,0,30,0
1668107612117,DSE 210,A00,096915,Dasgupta; Sanjoy,30,0,30,0
1668107612553,DSE 260A,A00,096916,Altintas De Callaf; Ilkay,30,0,30,0
1668107613045,ECE 200,001,103586,Antipa; Nicholas A,9999,0,9999,0
1668107613045,ECE 200,002,103587,Atanasov; Nikolay A.,9999,0,9999,0
1668107613045,ECE 200,003,103588,Bharadia; Dinesh,9999,0,9999,0
1668107613045,ECE 200,004,103589,Cheng; Chung Kuan,9999,0,9999,0
1668107613045,ECE 200,005,103590,Cosman; Pamela C.,9999,0,9999,0
1668107613045,ECE 200,006,103591,Dayeh; Shadi Ahmad,9999,0,9999,0
1668107613045,ECE 200,007,103592,Fainman; Yeshaiahu,9999,0,9999,0
1668107613045,ECE 200,008,103593,Ford; Joseph Earl,9999,0,9999,0
1668107613045,ECE 200,009,103594,Franceschetti; Massimo,9999,0,9999,0
1668107613045,ECE 200,010,103595,Fullerton; Eric E,9999,0,9999,0
1668107613045,ECE 200,011,103596,Galton; Ian A,9999,0,9999,0
1668107613045,ECE 200,012,103597,Gilja; Vikash,9999,0,9999,0
1668107613045,ECE 200,013,103598,Hall; Drew A.,9999,0,9999,0
1668107613045,ECE 200,014,103599,Hsueh; Tzu-Chien,9999,0,9999,0
1668107613045,ECE 200,015,103600,Javidi; Tara,9999,0,9999,0
1668107613045,ECE 200,016,103601,Kahng; Andrew Byun,9999,0,9999,0
1668107613045,ECE 200,017,103602,Kim; Young-Han,9999,0,9999,0
1668107613045,ECE 200,018,103603,Koushanfar; Farinaz,9999,0,9999,0
1668107613045,ECE 200,019,103604,Kuzum; Duygu,9999,0,9999,0
1668107613045,ECE 200,020,103605,Le; Hanh-Phuc,9999,0,9999,0
1668107613045,ECE 200,021,103606,Lin; Bill,9999,0,9999,0
1668107613045,ECE 200,022,103607,Liu; Zhaowei,9998,0,9999,1
1668107613045,ECE 200,023,103608,Lo; Yu-Hwa,9999,0,9999,0
1668107613045,ECE 200,024,103609,Lomakin; Vitaliy,9999,0,9999,0
1668107613045,ECE 200,025,103610,Mercier; Patrick Philip,9999,0,9999,0
1668107613045,ECE 200,026,103611,Meyer; Florian,9999,0,9999,0
1668107613045,ECE 200,027,103612,Milstein; Laurence B.,9999,0,9999,0
1668107613045,ECE 200,028,103613,Mir Arabbaygi; Siavash,9999,0,9999,0
1668107613045,ECE 200,029,103614,Mookherjea; Shayan,9999,0,9999,0
1668107613045,ECE 200,030,103615,Morris; Karcher William,9999,0,9999,0
1668107613045,ECE 200,031,103616,Ng; Tse Nga,9999,0,9999,0
1668107613045,ECE 200,032,103617,Nguyen; Truong Quang,9999,0,9999,0
1668107613045,ECE 200,033,103618,Nomura; Kenji,9999,0,9999,0
1668107613045,ECE 200,034,103619,Orlitsky; Alon,9999,0,9999,0
1668107613045,ECE 200,035,103620,Pal; Piya,9999,0,9999,0
1668107613045,ECE 200,036,103621,Papen; George C.,9999,0,9999,0
1668107613045,ECE 200,037,103622,Radic; Stojan,9999,0,9999,0
1668107613045,ECE 200,038,103623,Rao; Bhaskar D.,9999,0,9999,0
1668107613045,ECE 200,039,103624,Rao; Ramesh R,9999,0,9999,0
1668107613045,ECE 200,040,103625,Rebeiz; Gabriel,9999,0,9999,0
1668107613045,ECE 200,041,103626,Sanford; John R,9999,0,9999,0
1668107613045,ECE 200,042,103627,Siegel; Paul H.,9999,0,9999,0
1668107613045,ECE 200,043,103628,Sievenpiper; Daniel F.,9999,0,9999,0
1668107613045,ECE 200,044,103629,Sworder; David D.,9999,0,9999,0
1668107613045,ECE 200,045,103630,Taur; Yuan,9999,0,9999,0
1668107613045,ECE 200,046,103631,Touri; Behrouz,9999,0,9999,0
1668107613045,ECE 200,047,103632,Trivedi; Mohan M.,9999,0,9999,0
1668107613045,ECE 200,048,103633,Vasconcelos; Nuno,9999,0,9999,0
1668107613045,ECE 200,049,103634,Wang; Xiaolong,9999,0,9999,0
1668107613045,ECE 200,050,103635,Xie; Pengtao,9999,0,9999,0
1668107613045,ECE 200,051,103636,Yip; Michael,9999,0,9999,0
1668107613045,ECE 200,052,103637,Zeger; Kenneth A.,999,0,999,0
1668107613045,ECE 200,053,103638,Zhang; Xinyu,9999,0,9999,0
1668107613045,ECE 200,054,103639,Turakhia; Yatish Girish,9999,0,9999,0
1668107613045,ECE 200,055,103640,Kang; Mingu,9999,0,9999,0
1668107613045,ECE 200,056,103641,Shi; Yuanyuan,9999,0,9999,0
1668107613045,ECE 200,057,103642,Wang; Edward Jay,9999,0,9999,0
1668107613045,ECE 200,058,103643,Zheng; Yang,9999,0,9999,0
1668107613475,ECE 202,A00,103644,Kuzum; Duygu,0,0,0,0
1668107613973,ECE 212BN,A00,103646,Ng; Tse Nga,0,0,0,0
1668107614404,ECE 221,A00,111493,Staff,0,0,0,0
1668107614835,ECE 222B,A00,103647,Lomakin; Vitaliy,0,0,0,0
1668107615268,ECE 230B,A00,103648,Taur; Yuan,0,0,0,0
1668107615692,ECE 238B,A00,103649,Garay; Javier,0,0,0,0
1668107616123,ECE 240B,A00,112900,Fainman; Yeshaiahu,0,0,0,0
1668107616545,ECE 247A,A00,103650,Jokerst; Jesse Vincent,0,0,0,0
1668107616976,ECE 247B,A00,103651,Wang; Joseph,0,0,0,0
1668107617416,ECE 250,A00,103652,Siegel; Paul H.,0,0,0,0
1668107617847,ECE 251A,A00,103654,Rao; Bhaskar D.,0,0,0,0
1668107618272,ECE 257B,A00,103655,Bharadia; Dinesh,0,0,0,0
1668107618694,ECE 258A,A00,103656,Milstein; Laurence B.,0,0,0,0
1668107619122,ECE 260B,A00,103658,Kang; Mingu,0,0,0,0
1668107619544,ECE 264A,A00,103659,Galton; Ian A,0,0,0,0
1668107619978,ECE 265A,A00,103661,Gudem; Prasad S.S.,0,0,0,0
1668107620420,ECE 265D,A00,103662,Gudem; Prasad S.S.,0,0,0,0
1668107620845,ECE 268,A00,103663,Koushanfar; Farinaz,0,0,0,0
1668107621277,ECE 269,A01,103665,Pal; Piya,0,0,0,0
1668107621715,ECE 271B,A00,103666,Vasconcelos; Manuela,0,0,0,0
1668107622164,ECE 276A,A00,103667,Atanasov; Nikolay A.,0,0,0,0
1668107622590,ECE 277,A00,103668,An; Cheolhong,0,0,0,0
1668107623015,ECE 279,A00,117947,Hall; Drew A.,0,0,0,0
1668107623897,ECE 283,A00,103670,Hsueh; Tzu-Chien,0,0,0,0
1668107624338,ECE 284,A00,103671,Turakhia; Yatish Girish,0,0,0,0
1668107624775,ECE 285,A00,103672,Zheng; Yang,0,0,0,0
1668107624775,ECE 285,B00,103673,Sworder; David D.,0,0,0,0
1668107625199,ECE 287,A00,103676,Javidi; Tara,0,0,0,0
1668107625639,MATH 200B,A00,098023,Salehi Golsefidy; Alireza,12,0,15,3
1668107626066,MATH 202B,A00,098024,Rhoades; Brendon Patrick,9,0,15,6
1668107626499,MATH 203B,A00,098025,Oprea; Dragos N.,10,0,15,5
1668107626924,MATH 204B,A00,098026,Sorensen; Claus M,13,0,15,2
1668107627347,MATH 208,A00,098027,Izadi; Elham,7,0,10,3
1668107627788,MATH 209,A00,098028,Pollack; Aaron,10,0,10,0
1668107628216,MATH 211A,A00,112919,Rogalski; Daniel,9,0,10,1
1668107628642,MATH 211B,A00,112920,Seward; Brandon M.,9,0,10,1
1668107629074,MATH 218,A00,098029,Li; Bo,10,0,10,0
1668107629506,MATH 220B,A00,098030,Novak; Jonathan I,11,0,15,4
1668107629931,MATH 221A,A00,098031,Ebenfelt; Peter F,13,0,15,2
1668107630355,MATH 231B,A00,098032,Zlatos; Andrej,12,0,15,3
1668107630803,MATH 240B,A00,098033,Ni; Lei,9,0,15,6
1668107631225,MATH 243,A00,098034,Jekel; David Andrew,10,0,10,0
1668107631657,MATH 245A,A00,098035,Nie; Jiawang,0,0,15,16
1668107632080,MATH 248,A00,098036,Bejenaru; Ioan,10,0,10,0
1668107632504,MATH 250B,A00,098037,Spolaor; Luca,14,0,15,1
1668107632929,MATH 258,A00,098038,Ni; Lei,10,0,10,0
1668107633353,MATH 264B,A00,098041,Rhoades; Brendon Patrick,9,0,15,6
1668107633775,MATH 268,A00,098042,Buss; Samuel R,10,0,10,0
1668107634206,MATH 269,A00,098043,Rhoades; Brendon Patrick,10,0,10,0
1668107634641,MATH 270B,A00,098044,Li; Bo,10,0,15,5
1668107635065,MATH 272B,A00,098045,Holst; Michael J,13,0,15,2
1668107635491,MATH 273A,A00,098046,Tian; Xiaochuan,10,0,15,5
1668107635917,MATH 275,A01,098048,Tian; Xiaochuan,6,0,10,4
1668107636342,MATH 278A,A00,098049,Holst; Michael J,8,0,10,2
1668107636773,MATH 278B,A00,098050,Cloninger; Alexander,10,0,10,0
1668107637197,MATH 278C,A00,098051,Nie; Jiawang,7,0,10,3
1668107637619,MATH 280B,A00,098052,Zheng; Tianyi,10,0,15,5
1668107638045,MATH 281B,A00,098053,Bradic; Jelena,2,0,15,13
1668107638470,MATH 282B,A00,098054,Arias-Castro; Ery,0,0,15,15
1668107638905,MATH 285,A00,098055,Fitzsimmons; Patrick J,0,0,15,17
1668107639333,MATH 287B,A00,098056,Arias-Castro; Ery,3,0,15,12
1668107639771,MATH 288,A00,098057,Agarwal; Pooja,9,0,10,1
1668107639771,MATH 288,B00,098058,Zhang; Danna,8,0,10,2
1668107639771,MATH 288,C00,098059,Williams; Ruth J,10,0,10,0
1668107640196,MATH 290B,A00,098060,Roberts; Justin Deritter,13,0,15,2
1668107640623,MATH 292,A00,098061,Belmont; Eva Kinoshita,10,0,10,0
1668107641045,MATH 295,A00,098062,Suk; Andrew Hoon,48,0,50,2
1668107641481,MATH 296,A00,098063,Novak; Jonathan I,20,0,20,0
1668107641907,MATH 297,001,098064,Gamst; Anthony Collins,9997,0,9999,2
1668108146924,COGS 205,A00,101395,Chiba; Andrea,19,0,20,1
1668108147364,COGS 210B,001,101404,Greene; Deanna Jacquelyn,9998,0,9999,1
1668108147364,COGS 210B,002,101417,Xia; Haijun,9999,0,9999,0
1668108147364,COGS 210B,003,101422,Nitz; Douglas A.,9999,0,9999,0
1668108147364,COGS 210B,004,101423,Hollan; James D.,9998,0,9999,1
1668108147364,COGS 210B,005,101424,Deak; Gedeon O.,9998,0,9999,1
1668108147364,COGS 210B,006,101425,Rossano; Federico,9999,0,9999,0
1668108147788,COGS 211B,A00,101427,Coulson; Seana M,9996,0,9999,3
1668108148218,COGS 220,A00,101428,Hollan; James D.,0,0,25,25
1668108148653,COGS 229,A00,101429,Dow; Steven P,18,0,25,7
1668108149085,COGS 230,A00,101430,Klemmer; Scott R,12,0,17,5
1668108149514,COGS 234,A00,101431,Xia; Haijun,3,0,25,22
1668108149943,COGS 260,A00,101432,Kiyonaga; Anastasia,20,0,25,5
1668108149943,COGS 260,B00,101433,Kirsh; David Joel,16,0,25,9
1668108150379,CSE 202,A00,102371,Impagliazzo; Russell,0,0,0,0
1668108150815,CSE 203B,A01,102373,Cheng; Chung Kuan,0,0,0,0
1668108151248,CSE 208,A00,102374,Micciancio; Daniele,0,0,0,0
1668108151671,CSE 209A,A00,112895,Impagliazzo; Russell,0,0,15,15
1668108152106,CSE 209B,A00,108005,Bellare; Mihir,0,0,0,0
1668108152531,CSE 210,A00,113163,Coblenz; Michael J,0,0,0,0
1668108152955,CSE 219,A00,106111,Dow; Steven P,0,0,20,20
1668108153382,CSE 221,A00,102376,Voelker; Geoffrey M.,0,0,0,0
1668108153807,CSE 224,A01,102378,Porter; George M,0,0,0,0
1668108154231,CSE 229A,A00,102379,Savage; Stefan,0,0,0,0
1668108154657,CSE 229C,A00,102380,Munyaka; Imani N. S.,0,0,0,0
1668108155086,CSE 232B,A00,102382,Deutsch; Alin Bernard,0,0,0,0
1668108155510,CSE 234,A01,112904,Kumar; Arun Kumar,0,0,0,0
1668108155943,CSE 237A,A00,102383,Rosing; Tajana Simunic,0,0,0,0
1668108156377,CSE 239A,A00,102384,Deutsch; Alin Bernard,0,0,0,0
1668108156804,CSE 239B,A00,102385,Polikarpova; Nadezhda,0,0,0,0
1668108157227,CSE 240A,A00,102386,Pannuto; Patrick William,0,0,0,0
1668108157656,CSE 240B,A00,102387,Zhao; Jishen,0,0,0,0
1668108158080,CSE 241A,A00,106406,Kang; Mingu,0,0,0,0
1668108158511,CSE 249B,A00,102388,Kahng; Andrew Byun,0,0,8,8
1668108158937,CSE 251B,A01,102392,Cottrell; Garrison W,0,0,0,0
1668108158937,CSE 251B,A02,102393,Cottrell; Garrison W,0,0,0,0
1668108159378,CSE 252B,A00,102394,Ochoa; Benjamin Lawrence,0,0,0,0
1668108159812,CSE 257,A01,102396,Gao; Sicun,0,0,0,0
1668108160235,CSE 272,A00,102397,Li; Tzumao,0,0,0,0
1668108160660,CSE 274,A00,111323,Chern; Albert Ren-Haur,0,0,0,0
1668108161088,CSE 282,A00,102398,Pevzner; Pavel Arkadjevich,0,0,0,0
1668108161513,CSE 284,A00,114175,Gymrek; Melissa Ann,0,0,0,0
1668108161937,CSE 290,A00,102399,Chandraker; Manmohan Krishna,0,0,0,0
1668108161937,CSE 290,B00,102400,Vaccaro; Kristen Marie,0,0,25,25
1668108161937,CSE 290,C00,102414,Pannuto; Patrick William,0,0,25,25
1668108161937,CSE 290,D00,102427,Pevzner; Pavel Arkadjevich,0,0,0,0
1668108161937,CSE 290,E00,102429,Zhao; Jishen,0,0,0,0
1668108161937,CSE 290,F00,102436,Tullsen; Dean Michael,0,0,0,0
1668108161937,CSE 290,G00,102440,Christensen; Henrik I,0,0,20,20
1668108162361,CSE 291,A00,102443,Su; Hao,0,0,0,0
1668108162361,CSE 291,B00,102448,Polikarpova; Nadezhda,0,0,0,0
1668108162361,CSE 291,C00,102453,Vaccaro; Kristen Marie,0,0,0,0
1668108162361,CSE 291,D00,111343,Savage; Stefan,0,0,0,0
1668108162361,CSE 291,E00,116474,Claffy; Kimberly Claire,0,0,0,0
1668108162361,CSE 291,F00,116479,Pasquale; Joseph,0,0,0,0
1668108162787,CSE 293,001,119111,Bafna; Vineet,9999,0,9999,0
1668108162787,CSE 293,002,119118,Bellare; Mihir,9999,0,9999,0
1668108162787,CSE 293,003,119122,Berg-Kirkpatrick; Taylor D,9999,0,9999,0
1668108162787,CSE 293,004,119135,Christensen; Henrik I,9999,0,9999,0
1668108162787,CSE 293,005,119142,Cottrell; Garrison W,9999,0,9999,0
1668108162787,CSE 293,006,119146,Deutsch; Alin Bernard,9999,0,9999,0
1668108162787,CSE 293,007,119159,Esmaeilzadeh; Hadi,9999,0,9999,0
1668108162787,CSE 293,008,119166,Freund; Yoav,9999,0,9999,0
1668108162787,CSE 293,009,119170,Griswold; William G.,9999,0,9999,0
1668108162787,CSE 293,010,119183,Gymrek; Melissa Ann,9999,0,9999,0
1668108162787,CSE 293,011,119190,Heninger; Nadia A,9999,0,9999,0
1668108162787,CSE 293,012,119230,Impagliazzo; Russell,9999,0,9999,0
1668108162787,CSE 293,013,119232,Jhala; Ranjit,9999,0,9999,0
1668108162787,CSE 293,014,119233,Kahng; Andrew Byun,9999,0,9999,0
1668108162787,CSE 293,015,119298,Kane; Daniel Mertz,9999,0,9999,0
1668108162787,CSE 293,016,119299,Kriegman; David J,9999,0,9999,0
1668108162787,CSE 293,017,119300,Kumar; Arun Kumar,9999,0,9999,0
1668108162787,CSE 293,018,119301,Lerner; Sorin,9999,0,9999,0
1668108162787,CSE 293,019,119302,Lovett; Shachar,9999,0,9999,0
1668108162787,CSE 293,020,119303,McAuley; Julian John,9999,0,9999,0
1668108162787,CSE 293,021,119304,Micciancio; Daniele,9999,0,9999,0
1668108162787,CSE 293,022,119367,Orailoglu; Alex,9999,0,9999,0
1668108162787,CSE 293,023,119382,Paturi; Ramamohan,9999,0,9999,0
1668108162787,CSE 293,024,119404,Polikarpova; Nadezhda,9999,0,9999,0
1668108162787,CSE 293,025,119406,Politz; Joseph Gibbs,9999,0,9999,0
1668108162787,CSE 293,026,119411,Porter; George M,9999,0,9999,0
1668108162787,CSE 293,027,119414,Porter; Leonard Emerson,9999,0,9999,0
1668108162787,CSE 293,028,119416,Ramamoorthi; Ravi,9999,0,9999,0
1668108162787,CSE 293,029,119417,Sahoo; Debashis,9999,0,9999,0
1668108162787,CSE 293,030,119420,Saul; Lawrence,9999,0,9999,0
1668108162787,CSE 293,031,119421,Savage; Stefan,9999,0,9999,0
1668108162787,CSE 293,032,119425,Schulze; Jurgen P.,9999,0,9999,0
1668108162787,CSE 293,033,119426,Snoeren; Alex C.,9999,0,9999,0
1668108162787,CSE 293,034,119428,Shang; Jingbo,9999,0,9999,0
1668108162787,CSE 293,035,119430,Stefan; Deian,9999,0,9999,0
1668108162787,CSE 293,036,119431,Su; Hao,9999,0,9999,0
1668108162787,CSE 293,037,119433,Swanson; Steven James,9999,0,9999,0
1668108162787,CSE 293,038,119435,Tullsen; Dean Michael,9999,0,9999,0
1668108162787,CSE 293,039,119483,Voelker; Geoffrey M.,9999,0,9999,0
1668108162787,CSE 293,040,119537,Zhao; Jishen,9999,0,9999,0
1668108162787,CSE 293,041,119538,Zhou; Yuan-Yuan,9999,0,9999,0
1668108162787,CSE 293,042,119539,Gao; Sicun,9999,0,9999,0
1668108162787,CSE 293,043,119540,Weibel; Nadir,9999,0,9999,0
1668108162787,CSE 293,044,119541,Gupta; Rajesh K.,9999,0,9999,0
1668108162787,CSE 293,045,126410,Vaccaro; Kristen Marie,9999,0,9999,0
1668108162787,CSE 293,046,126411,Klemke; Richard,9999,0,9999,0
1668108163239,CSE 294,A00,102459,Voelker; Geoffrey M.,0,0,0,0
1668108163239,CSE 294,B00,111322,Orailoglu; Alex,0,0,0,0
1668108163662,DSE 201,A00,096914,Deutsch; Alin Bernard,30,0,30,0
1668108164086,DSE 210,A00,096915,Dasgupta; Sanjoy,30,0,30,0
1668108164512,DSE 260A,A00,096916,Altintas De Callaf; Ilkay,30,0,30,0
1668108164944,ECE 200,001,103586,Antipa; Nicholas A,9999,0,9999,0
1668108164944,ECE 200,002,103587,Atanasov; Nikolay A.,9999,0,9999,0
1668108164944,ECE 200,003,103588,Bharadia; Dinesh,9999,0,9999,0
1668108164944,ECE 200,004,103589,Cheng; Chung Kuan,9999,0,9999,0
1668108164944,ECE 200,005,103590,Cosman; Pamela C.,9999,0,9999,0
1668108164944,ECE 200,006,103591,Dayeh; Shadi Ahmad,9999,0,9999,0
1668108164944,ECE 200,007,103592,Fainman; Yeshaiahu,9999,0,9999,0
1668108164944,ECE 200,008,103593,Ford; Joseph Earl,9999,0,9999,0
1668108164944,ECE 200,009,103594,Franceschetti; Massimo,9999,0,9999,0
1668108164944,ECE 200,010,103595,Fullerton; Eric E,9999,0,9999,0
1668108164944,ECE 200,011,103596,Galton; Ian A,9999,0,9999,0
1668108164944,ECE 200,012,103597,Gilja; Vikash,9999,0,9999,0
1668108164944,ECE 200,013,103598,Hall; Drew A.,9999,0,9999,0
1668108164944,ECE 200,014,103599,Hsueh; Tzu-Chien,9999,0,9999,0
1668108164944,ECE 200,015,103600,Javidi; Tara,9999,0,9999,0
1668108164944,ECE 200,016,103601,Kahng; Andrew Byun,9999,0,9999,0
1668108164944,ECE 200,017,103602,Kim; Young-Han,9999,0,9999,0
1668108164944,ECE 200,018,103603,Koushanfar; Farinaz,9999,0,9999,0
1668108164944,ECE 200,019,103604,Kuzum; Duygu,9999,0,9999,0
1668108164944,ECE 200,020,103605,Le; Hanh-Phuc,9999,0,9999,0
1668108164944,ECE 200,021,103606,Lin; Bill,9999,0,9999,0
1668108164944,ECE 200,022,103607,Liu; Zhaowei,9998,0,9999,1
1668108164944,ECE 200,023,103608,Lo; Yu-Hwa,9999,0,9999,0
1668108164944,ECE 200,024,103609,Lomakin; Vitaliy,9999,0,9999,0
1668108164944,ECE 200,025,103610,Mercier; Patrick Philip,9999,0,9999,0
1668108164944,ECE 200,026,103611,Meyer; Florian,9999,0,9999,0
1668108164944,ECE 200,027,103612,Milstein; Laurence B.,9999,0,9999,0
1668108164944,ECE 200,028,103613,Mir Arabbaygi; Siavash,9999,0,9999,0
1668108164944,ECE 200,029,103614,Mookherjea; Shayan,9999,0,9999,0
1668108164944,ECE 200,030,103615,Morris; Karcher William,9999,0,9999,0
1668108164944,ECE 200,031,103616,Ng; Tse Nga,9999,0,9999,0
1668108164944,ECE 200,032,103617,Nguyen; Truong Quang,9999,0,9999,0
1668108164944,ECE 200,033,103618,Nomura; Kenji,9999,0,9999,0
1668108164944,ECE 200,034,103619,Orlitsky; Alon,9999,0,9999,0
1668108164944,ECE 200,035,103620,Pal; Piya,9999,0,9999,0
1668108164944,ECE 200,036,103621,Papen; George C.,9999,0,9999,0
1668108164944,ECE 200,037,103622,Radic; Stojan,9999,0,9999,0
1668108164944,ECE 200,038,103623,Rao; Bhaskar D.,9999,0,9999,0
1668108164944,ECE 200,039,103624,Rao; Ramesh R,9999,0,9999,0
1668108164944,ECE 200,040,103625,Rebeiz; Gabriel,9999,0,9999,0
1668108164944,ECE 200,041,103626,Sanford; John R,9999,0,9999,0
1668108164944,ECE 200,042,103627,Siegel; Paul H.,9999,0,9999,0
1668108164944,ECE 200,043,103628,Sievenpiper; Daniel F.,9999,0,9999,0
1668108164944,ECE 200,044,103629,Sworder; David D.,9999,0,9999,0
1668108164944,ECE 200,045,103630,Taur; Yuan,9999,0,9999,0
1668108164944,ECE 200,046,103631,Touri; Behrouz,9999,0,9999,0
1668108164944,ECE 200,047,103632,Trivedi; Mohan M.,9999,0,9999,0
1668108164944,ECE 200,048,103633,Vasconcelos; Nuno,9999,0,9999,0
1668108164944,ECE 200,049,103634,Wang; Xiaolong,9999,0,9999,0
1668108164944,ECE 200,050,103635,Xie; Pengtao,9999,0,9999,0
1668108164944,ECE 200,051,103636,Yip; Michael,9999,0,9999,0
1668108164944,ECE 200,052,103637,Zeger; Kenneth A.,999,0,999,0
1668108164944,ECE 200,053,103638,Zhang; Xinyu,9999,0,9999,0
1668108164944,ECE 200,054,103639,Turakhia; Yatish Girish,9999,0,9999,0
1668108164944,ECE 200,055,103640,Kang; Mingu,9999,0,9999,0
1668108164944,ECE 200,056,103641,Shi; Yuanyuan,9999,0,9999,0
1668108164944,ECE 200,057,103642,Wang; Edward Jay,9999,0,9999,0
1668108164944,ECE 200,058,103643,Zheng; Yang,9999,0,9999,0
1668108165373,ECE 202,A00,103644,Kuzum; Duygu,0,0,0,0
1668108165797,ECE 212BN,A00,103646,Ng; Tse Nga,0,0,0,0
1668108166221,ECE 221,A00,111493,Staff,0,0,0,0
1668108166645,ECE 222B,A00,103647,Lomakin; Vitaliy,0,0,0,0
1668108167072,ECE 230B,A00,103648,Taur; Yuan,0,0,0,0
1668108167499,ECE 238B,A00,103649,Garay; Javier,0,0,0,0
1668108167925,ECE 240B,A00,112900,Fainman; Yeshaiahu,0,0,0,0
1668108168355,ECE 247A,A00,103650,Jokerst; Jesse Vincent,0,0,0,0
1668108168776,ECE 247B,A00,103651,Wang; Joseph,0,0,0,0
1668108169204,ECE 250,A00,103652,Siegel; Paul H.,0,0,0,0
1668108169634,ECE 251A,A00,103654,Rao; Bhaskar D.,0,0,0,0
1668108170066,ECE 257B,A00,103655,Bharadia; Dinesh,0,0,0,0
1668108170492,ECE 258A,A00,103656,Milstein; Laurence B.,0,0,0,0
1668108170916,ECE 260B,A00,103658,Kang; Mingu,0,0,0,0
1668108171340,ECE 264A,A00,103659,Galton; Ian A,0,0,0,0
1668108171771,ECE 265A,A00,103661,Gudem; Prasad S.S.,0,0,0,0
1668108172201,ECE 265D,A00,103662,Gudem; Prasad S.S.,0,0,0,0
1668108172623,ECE 268,A00,103663,Koushanfar; Farinaz,0,0,0,0
1668108173047,ECE 269,A01,103665,Pal; Piya,0,0,0,0
1668108173471,ECE 271B,A00,103666,Vasconcelos; Manuela,0,0,0,0
1668108173903,ECE 276A,A00,103667,Atanasov; Nikolay A.,0,0,0,0
1668108174326,ECE 277,A00,103668,An; Cheolhong,0,0,0,0
1668108174764,ECE 279,A00,117947,Hall; Drew A.,0,0,0,0
1668108175645,ECE 283,A00,103670,Hsueh; Tzu-Chien,0,0,0,0
1668108176079,ECE 284,A00,103671,Turakhia; Yatish Girish,0,0,0,0
1668108176504,ECE 285,A00,103672,Zheng; Yang,0,0,0,0
1668108176504,ECE 285,B00,103673,Sworder; David D.,0,0,0,0
1668108176930,ECE 287,A00,103676,Javidi; Tara,0,0,0,0
1668108177378,MATH 200B,A00,098023,Salehi Golsefidy; Alireza,12,0,15,3
1668108177799,MATH 202B,A00,098024,Rhoades; Brendon Patrick,9,0,15,6
1668108178229,MATH 203B,A00,098025,Oprea; Dragos N.,10,0,15,5
1668108178662,MATH 204B,A00,098026,Sorensen; Claus M,13,0,15,2
1668108179100,MATH 208,A00,098027,Izadi; Elham,7,0,10,3
1668108179525,MATH 209,A00,098028,Pollack; Aaron,10,0,10,0
1668108179947,MATH 211A,A00,112919,Rogalski; Daniel,9,0,10,1
1668108180387,MATH 211B,A00,112920,Seward; Brandon M.,9,0,10,1
1668108180823,MATH 218,A00,098029,Li; Bo,10,0,10,0
1668108181249,MATH 220B,A00,098030,Novak; Jonathan I,11,0,15,4
1668108181683,MATH 221A,A00,098031,Ebenfelt; Peter F,13,0,15,2
1668108182126,MATH 231B,A00,098032,Zlatos; Andrej,12,0,15,3
1668108182680,MATH 240B,A00,098033,Ni; Lei,9,0,15,6
1668108183111,MATH 243,A00,098034,Jekel; David Andrew,10,0,10,0
1668108183534,MATH 245A,A00,098035,Nie; Jiawang,0,0,15,16
1668108183958,MATH 248,A00,098036,Bejenaru; Ioan,10,0,10,0
1668108184384,MATH 250B,A00,098037,Spolaor; Luca,14,0,15,1
1668108184808,MATH 258,A00,098038,Ni; Lei,10,0,10,0
1668108185245,MATH 264B,A00,098041,Rhoades; Brendon Patrick,9,0,15,6
1668108185670,MATH 268,A00,098042,Buss; Samuel R,10,0,10,0
1668108186098,MATH 269,A00,098043,Rhoades; Brendon Patrick,10,0,10,0
1668108186524,MATH 270B,A00,098044,Li; Bo,10,0,15,5
1668108186948,MATH 272B,A00,098045,Holst; Michael J,13,0,15,2
1668108187377,MATH 273A,A00,098046,Tian; Xiaochuan,10,0,15,5
1668108187802,MATH 275,A01,098048,Tian; Xiaochuan,6,0,10,4
1668108188227,MATH 278A,A00,098049,Holst; Michael J,8,0,10,2
1668108188654,MATH 278B,A00,098050,Cloninger; Alexander,10,0,10,0
1668108189079,MATH 278C,A00,098051,Nie; Jiawang,7,0,10,3
1668108189519,MATH 280B,A00,098052,Zheng; Tianyi,10,0,15,5
1668108189943,MATH 281B,A00,098053,Bradic; Jelena,2,0,15,13
1668108190368,MATH 282B,A00,098054,Arias-Castro; Ery,0,0,15,15
1668108190804,MATH 285,A00,098055,Fitzsimmons; Patrick J,0,0,15,17
1668108191228,MATH 287B,A00,098056,Arias-Castro; Ery,3,0,15,12
1668108191652,MATH 288,A00,098057,Agarwal; Pooja,9,0,10,1
1668108191652,MATH 288,B00,098058,Zhang; Danna,8,0,10,2
1668108191652,MATH 288,C00,098059,Williams; Ruth J,10,0,10,0
1668108192078,MATH 290B,A00,098060,Roberts; Justin Deritter,13,0,15,2
1668108192504,MATH 292,A00,098061,Belmont; Eva Kinoshita,10,0,10,0
1668108192929,MATH 295,A00,098062,Suk; Andrew Hoon,48,0,50,2
1668108193353,MATH 296,A00,098063,Novak; Jonathan I,20,0,20,0
1668108193775,MATH 297,001,098064,Gamst; Anthony Collins,9997,0,9999,2
1668108707830,COGS 205,A00,101395,Chiba; Andrea,19,0,20,1
1668108708276,COGS 210B,001,101404,Greene; Deanna Jacquelyn,9998,0,9999,1
1668108708276,COGS 210B,002,101417,Xia; Haijun,9999,0,9999,0
1668108708276,COGS 210B,003,101422,Nitz; Douglas A.,9999,0,9999,0
1668108708276,COGS 210B,004,101423,Hollan; James D.,9998,0,9999,1
1668108708276,COGS 210B,005,101424,Deak; Gedeon O.,9998,0,9999,1
1668108708276,COGS 210B,006,101425,Rossano; Federico,9999,0,9999,0
1668108708699,COGS 211B,A00,101427,Coulson; Seana M,9996,0,9999,3
1668108709140,COGS 220,A00,101428,Hollan; James D.,0,0,25,25
1668108709567,COGS 229,A00,101429,Dow; Steven P,18,0,25,7
1668108709991,COGS 230,A00,101430,Klemmer; Scott R,12,0,17,5
1668108710428,COGS 234,A00,101431,Xia; Haijun,3,0,25,22
1668108710852,COGS 260,A00,101432,Kiyonaga; Anastasia,20,0,25,5
1668108710852,COGS 260,B00,101433,Kirsh; David Joel,16,0,25,9
1668108711278,CSE 202,A00,102371,Impagliazzo; Russell,0,0,0,0
1668108711709,CSE 203B,A01,102373,Cheng; Chung Kuan,0,0,0,0
1668108712133,CSE 208,A00,102374,Micciancio; Daniele,0,0,0,0
1668108712563,CSE 209A,A00,112895,Impagliazzo; Russell,0,0,15,15
1668108712987,CSE 209B,A00,108005,Bellare; Mihir,0,0,0,0
1668108713410,CSE 210,A00,113163,Coblenz; Michael J,0,0,0,0
1668108713831,CSE 219,A00,106111,Dow; Steven P,0,0,20,20
1668108714256,CSE 221,A00,102376,Voelker; Geoffrey M.,0,0,0,0
1668108714678,CSE 224,A01,102378,Porter; George M,0,0,0,0
1668108715105,CSE 229A,A00,102379,Savage; Stefan,0,0,0,0
1668108715527,CSE 229C,A00,102380,Munyaka; Imani N. S.,0,0,0,0
1668108715954,CSE 232B,A00,102382,Deutsch; Alin Bernard,0,0,0,0
1668108716412,CSE 234,A01,112904,Kumar; Arun Kumar,0,0,0,0
1668108716959,CSE 237A,A00,102383,Rosing; Tajana Simunic,0,0,0,0
1668108717389,CSE 239A,A00,102384,Deutsch; Alin Bernard,0,0,0,0
1668108717817,CSE 239B,A00,102385,Polikarpova; Nadezhda,0,0,0,0
1668108718245,CSE 240A,A00,102386,Pannuto; Patrick William,0,0,0,0
1668108718668,CSE 240B,A00,102387,Zhao; Jishen,0,0,0,0
1668108719093,CSE 241A,A00,106406,Kang; Mingu,0,0,0,0
1668108719518,CSE 249B,A00,102388,Kahng; Andrew Byun,0,0,8,8
1668108719948,CSE 251B,A01,102392,Cottrell; Garrison W,0,0,0,0
1668108719948,CSE 251B,A02,102393,Cottrell; Garrison W,0,0,0,0
1668108720375,CSE 252B,A00,102394,Ochoa; Benjamin Lawrence,0,0,0,0
1668108720801,CSE 257,A01,102396,Gao; Sicun,0,0,0,0
1668108721224,CSE 272,A00,102397,Li; Tzumao,0,0,0,0
1668108721654,CSE 274,A00,111323,Chern; Albert Ren-Haur,0,0,0,0
1668108722098,CSE 282,A00,102398,Pevzner; Pavel Arkadjevich,0,0,0,0
1668108722521,CSE 284,A00,114175,Gymrek; Melissa Ann,0,0,0,0
1668108722950,CSE 290,A00,102399,Chandraker; Manmohan Krishna,0,0,0,0
1668108722950,CSE 290,B00,102400,Vaccaro; Kristen Marie,0,0,25,25
1668108722950,CSE 290,C00,102414,Pannuto; Patrick William,0,0,25,25
1668108722950,CSE 290,D00,102427,Pevzner; Pavel Arkadjevich,0,0,0,0
1668108722950,CSE 290,E00,102429,Zhao; Jishen,0,0,0,0
1668108722950,CSE 290,F00,102436,Tullsen; Dean Michael,0,0,0,0
1668108722950,CSE 290,G00,102440,Christensen; Henrik I,0,0,20,20
1668108723378,CSE 291,A00,102443,Su; Hao,0,0,0,0
1668108723378,CSE 291,B00,102448,Polikarpova; Nadezhda,0,0,0,0
1668108723378,CSE 291,C00,102453,Vaccaro; Kristen Marie,0,0,0,0
1668108723378,CSE 291,D00,111343,Savage; Stefan,0,0,0,0
1668108723378,CSE 291,E00,116474,Claffy; Kimberly Claire,0,0,0,0
1668108723378,CSE 291,F00,116479,Pasquale; Joseph,0,0,0,0
1668108723842,CSE 293,001,119111,Bafna; Vineet,9999,0,9999,0
1668108723842,CSE 293,002,119118,Bellare; Mihir,9999,0,9999,0
1668108723842,CSE 293,003,119122,Berg-Kirkpatrick; Taylor D,9999,0,9999,0
1668108723842,CSE 293,004,119135,Christensen; Henrik I,9999,0,9999,0
1668108723842,CSE 293,005,119142,Cottrell; Garrison W,9999,0,9999,0
1668108723842,CSE 293,006,119146,Deutsch; Alin Bernard,9999,0,9999,0
1668108723842,CSE 293,007,119159,Esmaeilzadeh; Hadi,9999,0,9999,0
1668108723842,CSE 293,008,119166,Freund; Yoav,9999,0,9999,0
1668108723842,CSE 293,009,119170,Griswold; William G.,9999,0,9999,0
1668108723842,CSE 293,010,119183,Gymrek; Melissa Ann,9999,0,9999,0
1668108723842,CSE 293,011,119190,Heninger; Nadia A,9999,0,9999,0
1668108723842,CSE 293,012,119230,Impagliazzo; Russell,9999,0,9999,0
1668108723842,CSE 293,013,119232,Jhala; Ranjit,9999,0,9999,0
1668108723842,CSE 293,014,119233,Kahng; Andrew Byun,9999,0,9999,0
1668108723842,CSE 293,015,119298,Kane; Daniel Mertz,9999,0,9999,0
1668108723842,CSE 293,016,119299,Kriegman; David J,9999,0,9999,0
1668108723842,CSE 293,017,119300,Kumar; Arun Kumar,9999,0,9999,0
1668108723842,CSE 293,018,119301,Lerner; Sorin,9999,0,9999,0
1668108723842,CSE 293,019,119302,Lovett; Shachar,9999,0,9999,0
1668108723842,CSE 293,020,119303,McAuley; Julian John,9999,0,9999,0
1668108723842,CSE 293,021,119304,Micciancio; Daniele,9999,0,9999,0
1668108723842,CSE 293,022,119367,Orailoglu; Alex,9999,0,9999,0
1668108723842,CSE 293,023,119382,Paturi; Ramamohan,9999,0,9999,0
1668108723842,CSE 293,024,119404,Polikarpova; Nadezhda,9999,0,9999,0
1668108723842,CSE 293,025,119406,Politz; Joseph Gibbs,9999,0,9999,0
1668108723842,CSE 293,026,119411,Porter; George M,9999,0,9999,0
1668108723842,CSE 293,027,119414,Porter; Leonard Emerson,9999,0,9999,0
1668108723842,CSE 293,028,119416,Ramamoorthi; Ravi,9999,0,9999,0
1668108723842,CSE 293,029,119417,Sahoo; Debashis,9999,0,9999,0
1668108723842,CSE 293,030,119420,Saul; Lawrence,9999,0,9999,0
1668108723842,CSE 293,031,119421,Savage; Stefan,9999,0,9999,0
1668108723842,CSE 293,032,119425,Schulze; Jurgen P.,9999,0,9999,0
1668108723842,CSE 293,033,119426,Snoeren; Alex C.,9999,0,9999,0
1668108723842,CSE 293,034,119428,Shang; Jingbo,9999,0,9999,0
1668108723842,CSE 293,035,119430,Stefan; Deian,9999,0,9999,0
1668108723842,CSE 293,036,119431,Su; Hao,9999,0,9999,0
1668108723842,CSE 293,037,119433,Swanson; Steven James,9999,0,9999,0
1668108723842,CSE 293,038,119435,Tullsen; Dean Michael,9999,0,9999,0
1668108723842,CSE 293,039,119483,Voelker; Geoffrey M.,9999,0,9999,0
1668108723842,CSE 293,040,119537,Zhao; Jishen,9999,0,9999,0
1668108723842,CSE 293,041,119538,Zhou; Yuan-Yuan,9999,0,9999,0
1668108723842,CSE 293,042,119539,Gao; Sicun,9999,0,9999,0
1668108723842,CSE 293,043,119540,Weibel; Nadir,9999,0,9999,0
1668108723842,CSE 293,044,119541,Gupta; Rajesh K.,9999,0,9999,0
1668108723842,CSE 293,045,126410,Vaccaro; Kristen Marie,9999,0,9999,0
1668108723842,CSE 293,046,126411,Klemke; Richard,9999,0,9999,0
1668108724268,CSE 294,A00,102459,Voelker; Geoffrey M.,0,0,0,0
1668108724268,CSE 294,B00,111322,Orailoglu; Alex,0,0,0,0
1668108724691,DSE 201,A00,096914,Deutsch; Alin Bernard,30,0,30,0
1668108725113,DSE 210,A00,096915,Dasgupta; Sanjoy,30,0,30,0
1668108725537,DSE 260A,A00,096916,Altintas De Callaf; Ilkay,30,0,30,0
1668108725967,ECE 200,001,103586,Antipa; Nicholas A,9999,0,9999,0
1668108725967,ECE 200,002,103587,Atanasov; Nikolay A.,9999,0,9999,0
1668108725967,ECE 200,003,103588,Bharadia; Dinesh,9999,0,9999,0
1668108725967,ECE 200,004,103589,Cheng; Chung Kuan,9999,0,9999,0
1668108725967,ECE 200,005,103590,Cosman; Pamela C.,9999,0,9999,0
1668108725967,ECE 200,006,103591,Dayeh; Shadi Ahmad,9999,0,9999,0
1668108725967,ECE 200,007,103592,Fainman; Yeshaiahu,9999,0,9999,0
1668108725967,ECE 200,008,103593,Ford; Joseph Earl,9999,0,9999,0
1668108725967,ECE 200,009,103594,Franceschetti; Massimo,9999,0,9999,0
1668108725967,ECE 200,010,103595,Fullerton; Eric E,9999,0,9999,0
1668108725967,ECE 200,011,103596,Galton; Ian A,9999,0,9999,0
1668108725967,ECE 200,012,103597,Gilja; Vikash,9999,0,9999,0
1668108725967,ECE 200,013,103598,Hall; Drew A.,9999,0,9999,0
1668108725967,ECE 200,014,103599,Hsueh; Tzu-Chien,9999,0,9999,0
1668108725967,ECE 200,015,103600,Javidi; Tara,9999,0,9999,0
1668108725967,ECE 200,016,103601,Kahng; Andrew Byun,9999,0,9999,0
1668108725967,ECE 200,017,103602,Kim; Young-Han,9999,0,9999,0
1668108725967,ECE 200,018,103603,Koushanfar; Farinaz,9999,0,9999,0
1668108725967,ECE 200,019,103604,Kuzum; Duygu,9999,0,9999,0
1668108725967,ECE 200,020,103605,Le; Hanh-Phuc,9999,0,9999,0
1668108725967,ECE 200,021,103606,Lin; Bill,9999,0,9999,0
1668108725967,ECE 200,022,103607,Liu; Zhaowei,9998,0,9999,1
1668108725967,ECE 200,023,103608,Lo; Yu-Hwa,9999,0,9999,0
1668108725967,ECE 200,024,103609,Lomakin; Vitaliy,9999,0,9999,0
1668108725967,ECE 200,025,103610,Mercier; Patrick Philip,9999,0,9999,0
1668108725967,ECE 200,026,103611,Meyer; Florian,9999,0,9999,0
1668108725967,ECE 200,027,103612,Milstein; Laurence B.,9999,0,9999,0
1668108725967,ECE 200,028,103613,Mir Arabbaygi; Siavash,9999,0,9999,0
1668108725967,ECE 200,029,103614,Mookherjea; Shayan,9999,0,9999,0
1668108725967,ECE 200,030,103615,Morris; Karcher William,9999,0,9999,0
1668108725967,ECE 200,031,103616,Ng; Tse Nga,9999,0,9999,0
1668108725967,ECE 200,032,103617,Nguyen; Truong Quang,9999,0,9999,0
1668108725967,ECE 200,033,103618,Nomura; Kenji,9999,0,9999,0
1668108725967,ECE 200,034,103619,Orlitsky; Alon,9999,0,9999,0
1668108725967,ECE 200,035,103620,Pal; Piya,9999,0,9999,0
1668108725967,ECE 200,036,103621,Papen; George C.,9999,0,9999,0
1668108725967,ECE 200,037,103622,Radic; Stojan,9999,0,9999,0
1668108725967,ECE 200,038,103623,Rao; Bhaskar D.,9999,0,9999,0
1668108725967,ECE 200,039,103624,Rao; Ramesh R,9999,0,9999,0
1668108725967,ECE 200,040,103625,Rebeiz; Gabriel,9999,0,9999,0
1668108725967,ECE 200,041,103626,Sanford; John R,9999,0,9999,0
1668108725967,ECE 200,042,103627,Siegel; Paul H.,9999,0,9999,0
1668108725967,ECE 200,043,103628,Sievenpiper; Daniel F.,9999,0,9999,0
1668108725967,ECE 200,044,103629,Sworder; David D.,9999,0,9999,0
1668108725967,ECE 200,045,103630,Taur; Yuan,9999,0,9999,0
1668108725967,ECE 200,046,103631,Touri; Behrouz,9999,0,9999,0
1668108725967,ECE 200,047,103632,Trivedi; Mohan M.,9999,0,9999,0
1668108725967,ECE 200,048,103633,Vasconcelos; Nuno,9999,0,9999,0
1668108725967,ECE 200,049,103634,Wang; Xiaolong,9999,0,9999,0
1668108725967,ECE 200,050,103635,Xie; Pengtao,9999,0,9999,0
1668108725967,ECE 200,051,103636,Yip; Michael,9999,0,9999,0
1668108725967,ECE 200,052,103637,Zeger; Kenneth A.,999,0,999,0
1668108725967,ECE 200,053,103638,Zhang; Xinyu,9999,0,9999,0
1668108725967,ECE 200,054,103639,Turakhia; Yatish Girish,9999,0,9999,0
1668108725967,ECE 200,055,103640,Kang; Mingu,9999,0,9999,0
1668108725967,ECE 200,056,103641,Shi; Yuanyuan,9999,0,9999,0
1668108725967,ECE 200,057,103642,Wang; Edward Jay,9999,0,9999,0
1668108725967,ECE 200,058,103643,Zheng; Yang,9999,0,9999,0
1668108726392,ECE 202,A00,103644,Kuzum; Duygu,0,0,0,0
1668108726819,ECE 212BN,A00,103646,Ng; Tse Nga,0,0,0,0
1668108727243,ECE 221,A00,111493,Staff,0,0,0,0
1668108727675,ECE 222B,A00,103647,Lomakin; Vitaliy,0,0,0,0
1668108728100,ECE 230B,A00,103648,Taur; Yuan,0,0,0,0
1668108728527,ECE 238B,A00,103649,Garay; Javier,0,0,0,0
1668108728955,ECE 240B,A00,112900,Fainman; Yeshaiahu,0,0,0,0
1668108729391,ECE 247A,A00,103650,Jokerst; Jesse Vincent,0,0,0,0
1668108729827,ECE 247B,A00,103651,Wang; Joseph,0,0,0,0
1668108730252,ECE 250,A00,103652,Siegel; Paul H.,0,0,0,0
1668108730696,ECE 251A,A00,103654,Rao; Bhaskar D.,0,0,0,0
1668108731128,ECE 257B,A00,103655,Bharadia; Dinesh,0,0,0,0
1668108731559,ECE 258A,A00,103656,Milstein; Laurence B.,0,0,0,0
1668108731992,ECE 260B,A00,103658,Kang; Mingu,0,0,0,0
1668108732431,ECE 264A,A00,103659,Galton; Ian A,0,0,0,0
1668108732853,ECE 265A,A00,103661,Gudem; Prasad S.S.,0,0,0,0
1668108733278,ECE 265D,A00,103662,Gudem; Prasad S.S.,0,0,0,0
1668108733701,ECE 268,A00,103663,Koushanfar; Farinaz,0,0,0,0
1668108734126,ECE 269,A01,103665,Pal; Piya,0,0,0,0
1668108734552,ECE 271B,A00,103666,Vasconcelos; Manuela,0,0,0,0
1668108734987,ECE 276A,A00,103667,Atanasov; Nikolay A.,0,0,0,0
1668108735423,ECE 277,A00,103668,An; Cheolhong,0,0,0,0
1668108735848,ECE 279,A00,117947,Hall; Drew A.,0,0,0,0
1668108736711,ECE 283,A00,103670,Hsueh; Tzu-Chien,0,0,0,0
1668108737140,ECE 284,A00,103671,Turakhia; Yatish Girish,0,0,0,0
1668108737566,ECE 285,A00,103672,Zheng; Yang,0,0,0,0
1668108737566,ECE 285,B00,103673,Sworder; David D.,0,0,0,0
1668108737989,ECE 287,A00,103676,Javidi; Tara,0,0,0,0
1668108738424,MATH 200B,A00,098023,Salehi Golsefidy; Alireza,12,0,15,3
1668108738848,MATH 202B,A00,098024,Rhoades; Brendon Patrick,9,0,15,6
1668108739277,MATH 203B,A00,098025,Oprea; Dragos N.,10,0,15,5
1668108739701,MATH 204B,A00,098026,Sorensen; Claus M,13,0,15,2
1668108740128,MATH 208,A00,098027,Izadi; Elham,7,0,10,3
1668108740552,MATH 209,A00,098028,Pollack; Aaron,10,0,10,0
1668108740975,MATH 211A,A00,112919,Rogalski; Daniel,9,0,10,1
1668108741415,MATH 211B,A00,112920,Seward; Brandon M.,9,0,10,1
1668108741845,MATH 218,A00,098029,Li; Bo,10,0,10,0
1668108742279,MATH 220B,A00,098030,Novak; Jonathan I,11,0,15,4
1668108742709,MATH 221A,A00,098031,Ebenfelt; Peter F,13,0,15,2
1668108743136,MATH 231B,A00,098032,Zlatos; Andrej,12,0,15,3
1668108743558,MATH 240B,A00,098033,Ni; Lei,9,0,15,6
1668108743997,MATH 243,A00,098034,Jekel; David Andrew,10,0,10,0
1668108744426,MATH 245A,A00,098035,Nie; Jiawang,0,0,15,16
1668108744850,MATH 248,A00,098036,Bejenaru; Ioan,10,0,10,0
1668108745276,MATH 250B,A00,098037,Spolaor; Luca,14,0,15,1
1668108745703,MATH 258,A00,098038,Ni; Lei,10,0,10,0
1668108746142,MATH 264B,A00,098041,Rhoades; Brendon Patrick,9,0,15,6
1668108746568,MATH 268,A00,098042,Buss; Samuel R,10,0,10,0
1668108746998,MATH 269,A00,098043,Rhoades; Brendon Patrick,10,0,10,0
1668108747426,MATH 270B,A00,098044,Li; Bo,10,0,15,5
1668108747861,MATH 272B,A00,098045,Holst; Michael J,13,0,15,2
1668108748286,MATH 273A,A00,098046,Tian; Xiaochuan,10,0,15,5
1668108748709,MATH 275,A01,098048,Tian; Xiaochuan,6,0,10,4
1668108749139,MATH 278A,A00,098049,Holst; Michael J,8,0,10,2
1668108749567,MATH 278B,A00,098050,Cloninger; Alexander,10,0,10,0
1668108749990,MATH 278C,A00,098051,Nie; Jiawang,7,0,10,3
1668108750415,MATH 280B,A00,098052,Zheng; Tianyi,10,0,15,5
1668108750838,MATH 281B,A00,098053,Bradic; Jelena,2,0,15,13
1668108751266,MATH 282B,A00,098054,Arias-Castro; Ery,0,0,15,15
1668108751695,MATH 285,A00,098055,Fitzsimmons; Patrick J,0,0,15,17
1668108752119,MATH 287B,A00,098056,Arias-Castro; Ery,3,0,15,12
1668108752559,MATH 288,A00,098057,Agarwal; Pooja,9,0,10,1
1668108752559,MATH 288,B00,098058,Zhang; Danna,8,0,10,2
1668108752559,MATH 288,C00,098059,Williams; Ruth J,10,0,10,0
1668108752984,MATH 290B,A00,098060,Roberts; Justin Deritter,13,0,15,2
1668108753407,MATH 292,A00,098061,Belmont; Eva Kinoshita,10,0,10,0
1668108753844,MATH 295,A00,098062,Suk; Andrew Hoon,48,0,50,2
1668108754266,MATH 296,A00,098063,Novak; Jonathan I,20,0,20,0
1668108754688,MATH 297,001,098064,Gamst; Anthony Collins,9997,0,9999,2
1668109261455,COGS 205,A00,101395,Chiba; Andrea,19,0,20,1
1668109261889,COGS 210B,001,101404,Greene; Deanna Jacquelyn,9998,0,9999,1
1668109261889,COGS 210B,002,101417,Xia; Haijun,9999,0,9999,0
1668109261889,COGS 210B,003,101422,Nitz; Douglas A.,9999,0,9999,0
1668109261889,COGS 210B,004,101423,Hollan; James D.,9998,0,9999,1
1668109261889,COGS 210B,005,101424,Deak; Gedeon O.,9998,0,9999,1
1668109261889,COGS 210B,006,101425,Rossano; Federico,9999,0,9999,0
1668109262312,COGS 211B,A00,101427,Coulson; Seana M,9996,0,9999,3
1668109262735,COGS 220,A00,101428,Hollan; James D.,0,0,25,25
1668109263167,COGS 229,A00,101429,Dow; Steven P,18,0,25,7
1668109263591,COGS 230,A00,101430,Klemmer; Scott R,12,0,17,5
1668109264018,COGS 234,A00,101431,Xia; Haijun,3,0,25,22
1668109264440,COGS 260,A00,101432,Kiyonaga; Anastasia,20,0,25,5
1668109264440,COGS 260,B00,101433,Kirsh; David Joel,16,0,25,9
1668109264865,CSE 202,A00,102371,Impagliazzo; Russell,0,0,0,0
1668109265292,CSE 203B,A01,102373,Cheng; Chung Kuan,0,0,0,0
1668109265726,CSE 208,A00,102374,Micciancio; Daniele,0,0,0,0
1668109266149,CSE 209A,A00,112895,Impagliazzo; Russell,0,0,15,15
1668109266575,CSE 209B,A00,108005,Bellare; Mihir,0,0,0,0
1668109266997,CSE 210,A00,113163,Coblenz; Michael J,0,0,0,0
1668109267421,CSE 219,A00,106111,Dow; Steven P,0,0,20,20
1668109267847,CSE 221,A00,102376,Voelker; Geoffrey M.,0,0,0,0
1668109268276,CSE 224,A01,102378,Porter; George M,0,0,0,0
1668109268718,CSE 229A,A00,102379,Savage; Stefan,0,0,0,0
1668109269149,CSE 229C,A00,102380,Munyaka; Imani N. S.,0,0,0,0
1668109269571,CSE 232B,A00,102382,Deutsch; Alin Bernard,0,0,0,0
1668109270000,CSE 234,A01,112904,Kumar; Arun Kumar,0,0,0,0
1668109270425,CSE 237A,A00,102383,Rosing; Tajana Simunic,0,0,0,0
1668109270855,CSE 239A,A00,102384,Deutsch; Alin Bernard,0,0,0,0
1668109271288,CSE 239B,A00,102385,Polikarpova; Nadezhda,0,0,0,0
1668109271727,CSE 240A,A00,102386,Pannuto; Patrick William,0,0,0,0
1668109272172,CSE 240B,A00,102387,Zhao; Jishen,0,0,0,0
1668109272596,CSE 241A,A00,106406,Kang; Mingu,0,0,0,0
1668109273021,CSE 249B,A00,102388,Kahng; Andrew Byun,0,0,8,8
1668109273443,CSE 251B,A01,102392,Cottrell; Garrison W,0,0,0,0
1668109273443,CSE 251B,A02,102393,Cottrell; Garrison W,0,0,0,0
1668109273877,CSE 252B,A00,102394,Ochoa; Benjamin Lawrence,0,0,0,0
1668109274301,CSE 257,A01,102396,Gao; Sicun,0,0,0,0
1668109274742,CSE 272,A00,102397,Li; Tzumao,0,0,0,0
1668109275176,CSE 274,A00,111323,Chern; Albert Ren-Haur,0,0,0,0
1668109275602,CSE 282,A00,102398,Pevzner; Pavel Arkadjevich,0,0,0,0
1668109276043,CSE 284,A00,114175,Gymrek; Melissa Ann,0,0,0,0
1668109276479,CSE 290,A00,102399,Chandraker; Manmohan Krishna,0,0,0,0
1668109276479,CSE 290,B00,102400,Vaccaro; Kristen Marie,0,0,25,25
1668109276479,CSE 290,C00,102414,Pannuto; Patrick William,0,0,25,25
1668109276479,CSE 290,D00,102427,Pevzner; Pavel Arkadjevich,0,0,0,0
1668109276479,CSE 290,E00,102429,Zhao; Jishen,0,0,0,0
1668109276479,CSE 290,F00,102436,Tullsen; Dean Michael,0,0,0,0
1668109276479,CSE 290,G00,102440,Christensen; Henrik I,0,0,20,20
1668109276910,CSE 291,A00,102443,Su; Hao,0,0,0,0
1668109276910,CSE 291,B00,102448,Polikarpova; Nadezhda,0,0,0,0
1668109276910,CSE 291,C00,102453,Vaccaro; Kristen Marie,0,0,0,0
1668109276910,CSE 291,D00,111343,Savage; Stefan,0,0,0,0
1668109276910,CSE 291,E00,116474,Claffy; Kimberly Claire,0,0,0,0
1668109276910,CSE 291,F00,116479,Pasquale; Joseph,0,0,0,0
1668109277355,CSE 293,001,119111,Bafna; Vineet,9999,0,9999,0
1668109277355,CSE 293,002,119118,Bellare; Mihir,9999,0,9999,0
1668109277355,CSE 293,003,119122,Berg-Kirkpatrick; Taylor D,9999,0,9999,0
1668109277355,CSE 293,004,119135,Christensen; Henrik I,9999,0,9999,0
1668109277355,CSE 293,005,119142,Cottrell; Garrison W,9999,0,9999,0
1668109277355,CSE 293,006,119146,Deutsch; Alin Bernard,9999,0,9999,0
1668109277355,CSE 293,007,119159,Esmaeilzadeh; Hadi,9999,0,9999,0
1668109277355,CSE 293,008,119166,Freund; Yoav,9999,0,9999,0
1668109277355,CSE 293,009,119170,Griswold; William G.,9999,0,9999,0
1668109277355,CSE 293,010,119183,Gymrek; Melissa Ann,9999,0,9999,0
1668109277355,CSE 293,011,119190,Heninger; Nadia A,9999,0,9999,0
1668109277355,CSE 293,012,119230,Impagliazzo; Russell,9999,0,9999,0
1668109277355,CSE 293,013,119232,Jhala; Ranjit,9999,0,9999,0
1668109277355,CSE 293,014,119233,Kahng; Andrew Byun,9999,0,9999,0
1668109277355,CSE 293,015,119298,Kane; Daniel Mertz,9999,0,9999,0
1668109277355,CSE 293,016,119299,Kriegman; David J,9999,0,9999,0
1668109277355,CSE 293,017,119300,Kumar; Arun Kumar,9999,0,9999,0
1668109277355,CSE 293,018,119301,Lerner; Sorin,9999,0,9999,0
1668109277355,CSE 293,019,119302,Lovett; Shachar,9999,0,9999,0
1668109277355,CSE 293,020,119303,McAuley; Julian John,9999,0,9999,0
1668109277355,CSE 293,021,119304,Micciancio; Daniele,9999,0,9999,0
1668109277355,CSE 293,022,119367,Orailoglu; Alex,9999,0,9999,0
1668109277355,CSE 293,023,119382,Paturi; Ramamohan,9999,0,9999,0
1668109277355,CSE 293,024,119404,Polikarpova; Nadezhda,9999,0,9999,0
1668109277355,CSE 293,025,119406,Politz; Joseph Gibbs,9999,0,9999,0
1668109277355,CSE 293,026,119411,Porter; George M,9999,0,9999,0
1668109277355,CSE 293,027,119414,Porter; Leonard Emerson,9999,0,9999,0
1668109277355,CSE 293,028,119416,Ramamoorthi; Ravi,9999,0,9999,0
1668109277355,CSE 293,029,119417,Sahoo; Debashis,9999,0,9999,0
1668109277355,CSE 293,030,119420,Saul; Lawrence,9999,0,9999,0
1668109277355,CSE 293,031,119421,Savage; Stefan,9999,0,9999,0
1668109277355,CSE 293,032,119425,Schulze; Jurgen P.,9999,0,9999,0
1668109277355,CSE 293,033,119426,Snoeren; Alex C.,9999,0,9999,0
1668109277355,CSE 293,034,119428,Shang; Jingbo,9999,0,9999,0
1668109277355,CSE 293,035,119430,Stefan; Deian,9999,0,9999,0
1668109277355,CSE 293,036,119431,Su; Hao,9999,0,9999,0
1668109277355,CSE 293,037,119433,Swanson; Steven James,9999,0,9999,0
1668109277355,CSE 293,038,119435,Tullsen; Dean Michael,9999,0,9999,0
1668109277355,CSE 293,039,119483,Voelker; Geoffrey M.,9999,0,9999,0
1668109277355,CSE 293,040,119537,Zhao; Jishen,9999,0,9999,0
1668109277355,CSE 293,041,119538,Zhou; Yuan-Yuan,9999,0,9999,0
1668109277355,CSE 293,042,119539,Gao; Sicun,9999,0,9999,0
1668109277355,CSE 293,043,119540,Weibel; Nadir,9999,0,9999,0
1668109277355,CSE 293,044,119541,Gupta; Rajesh K.,9999,0,9999,0
1668109277355,CSE 293,045,126410,Vaccaro; Kristen Marie,9999,0,9999,0
1668109277355,CSE 293,046,126411,Klemke; Richard,9999,0,9999,0
1668109277784,CSE 294,A00,102459,Voelker; Geoffrey M.,0,0,0,0
1668109277784,CSE 294,B00,111322,Orailoglu; Alex,0,0,0,0
1668109278207,DSE 201,A00,096914,Deutsch; Alin Bernard,30,0,30,0
1668109278640,DSE 210,A00,096915,Dasgupta; Sanjoy,30,0,30,0
1668109279070,DSE 260A,A00,096916,Altintas De Callaf; Ilkay,30,0,30,0
1668109279536,ECE 200,001,103586,Antipa; Nicholas A,9999,0,9999,0
1668109279536,ECE 200,002,103587,Atanasov; Nikolay A.,9999,0,9999,0
1668109279536,ECE 200,003,103588,Bharadia; Dinesh,9999,0,9999,0
1668109279536,ECE 200,004,103589,Cheng; Chung Kuan,9999,0,9999,0
1668109279536,ECE 200,005,103590,Cosman; Pamela C.,9999,0,9999,0
1668109279536,ECE 200,006,103591,Dayeh; Shadi Ahmad,9999,0,9999,0
1668109279536,ECE 200,007,103592,Fainman; Yeshaiahu,9999,0,9999,0
1668109279536,ECE 200,008,103593,Ford; Joseph Earl,9999,0,9999,0
1668109279536,ECE 200,009,103594,Franceschetti; Massimo,9999,0,9999,0
1668109279536,ECE 200,010,103595,Fullerton; Eric E,9999,0,9999,0
1668109279536,ECE 200,011,103596,Galton; Ian A,9999,0,9999,0
1668109279536,ECE 200,012,103597,Gilja; Vikash,9999,0,9999,0
1668109279536,ECE 200,013,103598,Hall; Drew A.,9999,0,9999,0
1668109279536,ECE 200,014,103599,Hsueh; Tzu-Chien,9999,0,9999,0
1668109279536,ECE 200,015,103600,Javidi; Tara,9999,0,9999,0
1668109279536,ECE 200,016,103601,Kahng; Andrew Byun,9999,0,9999,0
1668109279536,ECE 200,017,103602,Kim; Young-Han,9999,0,9999,0
1668109279536,ECE 200,018,103603,Koushanfar; Farinaz,9999,0,9999,0
1668109279536,ECE 200,019,103604,Kuzum; Duygu,9999,0,9999,0
1668109279536,ECE 200,020,103605,Le; Hanh-Phuc,9999,0,9999,0
1668109279536,ECE 200,021,103606,Lin; Bill,9999,0,9999,0
1668109279536,ECE 200,022,103607,Liu; Zhaowei,9998,0,9999,1
1668109279536,ECE 200,023,103608,Lo; Yu-Hwa,9999,0,9999,0
1668109279536,ECE 200,024,103609,Lomakin; Vitaliy,9999,0,9999,0
1668109279536,ECE 200,025,103610,Mercier; Patrick Philip,9999,0,9999,0
1668109279536,ECE 200,026,103611,Meyer; Florian,9999,0,9999,0
1668109279536,ECE 200,027,103612,Milstein; Laurence B.,9999,0,9999,0
1668109279536,ECE 200,028,103613,Mir Arabbaygi; Siavash,9999,0,9999,0
1668109279536,ECE 200,029,103614,Mookherjea; Shayan,9999,0,9999,0
1668109279536,ECE 200,030,103615,Morris; Karcher William,9999,0,9999,0
1668109279536,ECE 200,031,103616,Ng; Tse Nga,9999,0,9999,0
1668109279536,ECE 200,032,103617,Nguyen; Truong Quang,9999,0,9999,0
1668109279536,ECE 200,033,103618,Nomura; Kenji,9999,0,9999,0
1668109279536,ECE 200,034,103619,Orlitsky; Alon,9999,0,9999,0
1668109279536,ECE 200,035,103620,Pal; Piya,9999,0,9999,0
1668109279536,ECE 200,036,103621,Papen; George C.,9999,0,9999,0
1668109279536,ECE 200,037,103622,Radic; Stojan,9999,0,9999,0
1668109279536,ECE 200,038,103623,Rao; Bhaskar D.,9999,0,9999,0
1668109279536,ECE 200,039,103624,Rao; Ramesh R,9999,0,9999,0
1668109279536,ECE 200,040,103625,Rebeiz; Gabriel,9999,0,9999,0
1668109279536,ECE 200,041,103626,Sanford; John R,9999,0,9999,0
1668109279536,ECE 200,042,103627,Siegel; Paul H.,9999,0,9999,0
1668109279536,ECE 200,043,103628,Sievenpiper; Daniel F.,9999,0,9999,0
1668109279536,ECE 200,044,103629,Sworder; David D.,9999,0,9999,0
1668109279536,ECE 200,045,103630,Taur; Yuan,9999,0,9999,0
1668109279536,ECE 200,046,103631,Touri; Behrouz,9999,0,9999,0
1668109279536,ECE 200,047,103632,Trivedi; Mohan M.,9999,0,9999,0
1668109279536,ECE 200,048,103633,Vasconcelos; Nuno,9999,0,9999,0
1668109279536,ECE 200,049,103634,Wang; Xiaolong,9999,0,9999,0
1668109279536,ECE 200,050,103635,Xie; Pengtao,9999,0,9999,0
1668109279536,ECE 200,051,103636,Yip; Michael,9999,0,9999,0
1668109279536,ECE 200,052,103637,Zeger; Kenneth A.,999,0,999,0
1668109279536,ECE 200,053,103638,Zhang; Xinyu,9999,0,9999,0
1668109279536,ECE 200,054,103639,Turakhia; Yatish Girish,9999,0,9999,0
1668109279536,ECE 200,055,103640,Kang; Mingu,9999,0,9999,0
1668109279536,ECE 200,056,103641,Shi; Yuanyuan,9999,0,9999,0
1668109279536,ECE 200,057,103642,Wang; Edward Jay,9999,0,9999,0
1668109279536,ECE 200,058,103643,Zheng; Yang,9999,0,9999,0
1668109279961,ECE 202,A00,103644,Kuzum; Duygu,0,0,0,0
1668109280384,ECE 212BN,A00,103646,Ng; Tse Nga,0,0,0,0
1668109280810,ECE 221,A00,111493,Staff,0,0,0,0
1668109281242,ECE 222B,A00,103647,Lomakin; Vitaliy,0,0,0,0
1668109281676,ECE 230B,A00,103648,Taur; Yuan,0,0,0,0
1668109282101,ECE 238B,A00,103649,Garay; Javier,0,0,0,0
1668109282526,ECE 240B,A00,112900,Fainman; Yeshaiahu,0,0,0,0
1668109282956,ECE 247A,A00,103650,Jokerst; Jesse Vincent,0,0,0,0
1668109283378,ECE 247B,A00,103651,Wang; Joseph,0,0,0,0
1668109283807,ECE 250,A00,103652,Siegel; Paul H.,0,0,0,0
1668109284231,ECE 251A,A00,103654,Rao; Bhaskar D.,0,0,0,0
1668109284662,ECE 257B,A00,103655,Bharadia; Dinesh,0,0,0,0
1668109285087,ECE 258A,A00,103656,Milstein; Laurence B.,0,0,0,0
1668109285519,ECE 260B,A00,103658,Kang; Mingu,0,0,0,0
1668109285959,ECE 264A,A00,103659,Galton; Ian A,0,0,0,0
1668109286382,ECE 265A,A00,103661,Gudem; Prasad S.S.,0,0,0,0
1668109286807,ECE 265D,A00,103662,Gudem; Prasad S.S.,0,0,0,0
1668109287307,ECE 268,A00,103663,Koushanfar; Farinaz,0,0,0,0
1668109287742,ECE 269,A01,103665,Pal; Piya,0,0,0,0
1668109288195,ECE 271B,A00,103666,Vasconcelos; Manuela,0,0,0,0
1668109288620,ECE 276A,A00,103667,Atanasov; Nikolay A.,0,0,0,0
1668109289054,ECE 277,A00,103668,An; Cheolhong,0,0,0,0
1668109289482,ECE 279,A00,117947,Hall; Drew A.,0,0,0,0
1668109290341,ECE 283,A00,103670,Hsueh; Tzu-Chien,0,0,0,0
1668109290783,ECE 284,A00,103671,Turakhia; Yatish Girish,0,0,0,0
1668109291206,ECE 285,A00,103672,Zheng; Yang,0,0,0,0
1668109291206,ECE 285,B00,103673,Sworder; David D.,0,0,0,0
1668109291631,ECE 287,A00,103676,Javidi; Tara,0,0,0,0
1668109292056,MATH 200B,A00,098023,Salehi Golsefidy; Alireza,12,0,15,3
1668109292490,MATH 202B,A00,098024,Rhoades; Brendon Patrick,9,0,15,6
1668109292918,MATH 203B,A00,098025,Oprea; Dragos N.,10,0,15,5
1668109293343,MATH 204B,A00,098026,Sorensen; Claus M,13,0,15,2
1668109293768,MATH 208,A00,098027,Izadi; Elham,7,0,10,3
1668109294216,MATH 209,A00,098028,Pollack; Aaron,10,0,10,0
1668109294641,MATH 211A,A00,112919,Rogalski; Daniel,9,0,10,1
1668109295065,MATH 211B,A00,112920,Seward; Brandon M.,9,0,10,1
1668109295512,MATH 218,A00,098029,Li; Bo,10,0,10,0
1668109295936,MATH 220B,A00,098030,Novak; Jonathan I,11,0,15,4
1668109296372,MATH 221A,A00,098031,Ebenfelt; Peter F,13,0,15,2
1668109296810,MATH 231B,A00,098032,Zlatos; Andrej,12,0,15,3
1668109297234,MATH 240B,A00,098033,Ni; Lei,9,0,15,6
1668109297675,MATH 243,A00,098034,Jekel; David Andrew,10,0,10,0
1668109298103,MATH 245A,A00,098035,Nie; Jiawang,0,0,15,16
1668109298526,MATH 248,A00,098036,Bejenaru; Ioan,10,0,10,0
1668109298953,MATH 250B,A00,098037,Spolaor; Luca,14,0,15,1
1668109299376,MATH 258,A00,098038,Ni; Lei,10,0,10,0
1668109299799,MATH 264B,A00,098041,Rhoades; Brendon Patrick,9,0,15,6
1668109300249,MATH 268,A00,098042,Buss; Samuel R,10,0,10,0
1668109300678,MATH 269,A00,098043,Rhoades; Brendon Patrick,10,0,10,0
1668109301107,MATH 270B,A00,098044,Li; Bo,10,0,15,5
1668109301536,MATH 272B,A00,098045,Holst; Michael J,13,0,15,2
1668109301960,MATH 273A,A00,098046,Tian; Xiaochuan,10,0,15,5
1668109302388,MATH 275,A01,098048,Tian; Xiaochuan,6,0,10,4
1668109302815,MATH 278A,A00,098049,Holst; Michael J,8,0,10,2
1668109303238,MATH 278B,A00,098050,Cloninger; Alexander,10,0,10,0
1668109303669,MATH 278C,A00,098051,Nie; Jiawang,7,0,10,3
1668109304101,MATH 280B,A00,098052,Zheng; Tianyi,10,0,15,5
1668109304532,MATH 281B,A00,098053,Bradic; Jelena,2,0,15,13
1668109304956,MATH 282B,A00,098054,Arias-Castro; Ery,0,0,15,15
1668109305382,MATH 285,A00,098055,Fitzsimmons; Patrick J,0,0,15,17
1668109305824,MATH 287B,A00,098056,Arias-Castro; Ery,3,0,15,12
1668109306258,MATH 288,A00,098057,Agarwal; Pooja,9,0,10,1
1668109306258,MATH 288,B00,098058,Zhang; Danna,8,0,10,2
1668109306258,MATH 288,C00,098059,Williams; Ruth J,10,0,10,0
1668109306688,MATH 290B,A00,098060,Roberts; Justin Deritter,13,0,15,2
1668109307120,MATH 292,A00,098061,Belmont; Eva Kinoshita,10,0,10,0
1668109307560,MATH 295,A00,098062,Suk; Andrew Hoon,48,0,50,2
1668109307988,MATH 296,A00,098063,Novak; Jonathan I,20,0,20,0
1668109308425,MATH 297,001,098064,Gamst; Anthony Collins,9997,0,9999,2
1668109813603,COGS 205,A00,101395,Chiba; Andrea,19,0,20,1
1668109814034,COGS 210B,001,101404,Greene; Deanna Jacquelyn,9998,0,9999,1
1668109814034,COGS 210B,002,101417,Xia; Haijun,9999,0,9999,0
1668109814034,COGS 210B,003,101422,Nitz; Douglas A.,9999,0,9999,0
1668109814034,COGS 210B,004,101423,Hollan; James D.,9998,0,9999,1
1668109814034,COGS 210B,005,101424,Deak; Gedeon O.,9998,0,9999,1
1668109814034,COGS 210B,006,101425,Rossano; Federico,9999,0,9999,0
1668109814459,COGS 211B,A00,101427,Coulson; Seana M,9996,0,9999,3
1668109814895,COGS 220,A00,101428,Hollan; James D.,0,0,25,25
1668109815322,COGS 229,A00,101429,Dow; Steven P,18,0,25,7
1668109815749,COGS 230,A00,101430,Klemmer; Scott R,12,0,17,5
1668109816172,COGS 234,A00,101431,Xia; Haijun,3,0,25,22
1668109816597,COGS 260,A00,101432,Kiyonaga; Anastasia,20,0,25,5
1668109816597,COGS 260,B00,101433,Kirsh; David Joel,16,0,25,9
1668109817027,CSE 202,A00,102371,Impagliazzo; Russell,0,0,0,0
1668109817449,CSE 203B,A01,102373,Cheng; Chung Kuan,0,0,0,0
1668109817873,CSE 208,A00,102374,Micciancio; Daniele,0,0,0,0
1668109818299,CSE 209A,A00,112895,Impagliazzo; Russell,0,0,15,15
1668109818725,CSE 209B,A00,108005,Bellare; Mihir,0,0,0,0
1668109819255,CSE 210,A00,113163,Coblenz; Michael J,0,0,0,0
1668109819695,CSE 219,A00,106111,Dow; Steven P,0,0,20,20
1668109820125,CSE 221,A00,102376,Voelker; Geoffrey M.,0,0,0,0
1668109820555,CSE 224,A01,102378,Porter; George M,0,0,0,0
1668109820993,CSE 229A,A00,102379,Savage; Stefan,0,0,0,0
1668109821420,CSE 229C,A00,102380,Munyaka; Imani N. S.,0,0,0,0
1668109821842,CSE 232B,A00,102382,Deutsch; Alin Bernard,0,0,0,0
1668109822270,CSE 234,A01,112904,Kumar; Arun Kumar,0,0,0,0
1668109822702,CSE 237A,A00,102383,Rosing; Tajana Simunic,0,0,0,0
1668109823129,CSE 239A,A00,102384,Deutsch; Alin Bernard,0,0,0,0
1668109823564,CSE 239B,A00,102385,Polikarpova; Nadezhda,0,0,0,0
1668109823991,CSE 240A,A00,102386,Pannuto; Patrick William,0,0,0,0
1668109824426,CSE 240B,A00,102387,Zhao; Jishen,0,0,0,0
1668109824859,CSE 241A,A00,106406,Kang; Mingu,0,0,0,0
1668109825284,CSE 249B,A00,102388,Kahng; Andrew Byun,0,0,8,8
1668109825716,CSE 251B,A01,102392,Cottrell; Garrison W,0,0,0,0
1668109825716,CSE 251B,A02,102393,Cottrell; Garrison W,0,0,0,0
1668109826149,CSE 252B,A00,102394,Ochoa; Benjamin Lawrence,0,0,0,0
1668109826572,CSE 257,A01,102396,Gao; Sicun,0,0,0,0
1668109827006,CSE 272,A00,102397,Li; Tzumao,0,0,0,0
1668109827430,CSE 274,A00,111323,Chern; Albert Ren-Haur,0,0,0,0
1668109827855,CSE 282,A00,102398,Pevzner; Pavel Arkadjevich,0,0,0,0
1668109828284,CSE 284,A00,114175,Gymrek; Melissa Ann,0,0,0,0
1668109828717,CSE 290,A00,102399,Chandraker; Manmohan Krishna,0,0,0,0
1668109828717,CSE 290,B00,102400,Vaccaro; Kristen Marie,0,0,25,25
1668109828717,CSE 290,C00,102414,Pannuto; Patrick William,0,0,25,25
1668109828717,CSE 290,D00,102427,Pevzner; Pavel Arkadjevich,0,0,0,0
1668109828717,CSE 290,E00,102429,Zhao; Jishen,0,0,0,0
1668109828717,CSE 290,F00,102436,Tullsen; Dean Michael,0,0,0,0
1668109828717,CSE 290,G00,102440,Christensen; Henrik I,0,0,20,20
1668109829152,CSE 291,A00,102443,Su; Hao,0,0,0,0
1668109829152,CSE 291,B00,102448,Polikarpova; Nadezhda,0,0,0,0
1668109829152,CSE 291,C00,102453,Vaccaro; Kristen Marie,0,0,0,0
1668109829152,CSE 291,D00,111343,Savage; Stefan,0,0,0,0
1668109829152,CSE 291,E00,116474,Claffy; Kimberly Claire,0,0,0,0
1668109829152,CSE 291,F00,116479,Pasquale; Joseph,0,0,0,0
1668109829584,CSE 293,001,119111,Bafna; Vineet,9999,0,9999,0
1668109829584,CSE 293,002,119118,Bellare; Mihir,9999,0,9999,0
1668109829584,CSE 293,003,119122,Berg-Kirkpatrick; Taylor D,9999,0,9999,0
1668109829584,CSE 293,004,119135,Christensen; Henrik I,9999,0,9999,0
1668109829584,CSE 293,005,119142,Cottrell; Garrison W,9999,0,9999,0
1668109829584,CSE 293,006,119146,Deutsch; Alin Bernard,9999,0,9999,0
1668109829584,CSE 293,007,119159,Esmaeilzadeh; Hadi,9999,0,9999,0
1668109829584,CSE 293,008,119166,Freund; Yoav,9999,0,9999,0
1668109829584,CSE 293,009,119170,Griswold; William G.,9999,0,9999,0
1668109829584,CSE 293,010,119183,Gymrek; Melissa Ann,9999,0,9999,0
1668109829584,CSE 293,011,119190,Heninger; Nadia A,9999,0,9999,0
1668109829584,CSE 293,012,119230,Impagliazzo; Russell,9999,0,9999,0
1668109829584,CSE 293,013,119232,Jhala; Ranjit,9999,0,9999,0
1668109829584,CSE 293,014,119233,Kahng; Andrew Byun,9999,0,9999,0
1668109829584,CSE 293,015,119298,Kane; Daniel Mertz,9999,0,9999,0
1668109829584,CSE 293,016,119299,Kriegman; David J,9999,0,9999,0
1668109829584,CSE 293,017,119300,Kumar; Arun Kumar,9999,0,9999,0
1668109829584,CSE 293,018,119301,Lerner; Sorin,9999,0,9999,0
1668109829584,CSE 293,019,119302,Lovett; Shachar,9999,0,9999,0
1668109829584,CSE 293,020,119303,McAuley; Julian John,9999,0,9999,0
1668109829584,CSE 293,021,119304,Micciancio; Daniele,9999,0,9999,0
1668109829584,CSE 293,022,119367,Orailoglu; Alex,9999,0,9999,0
1668109829584,CSE 293,023,119382,Paturi; Ramamohan,9999,0,9999,0
1668109829584,CSE 293,024,119404,Polikarpova; Nadezhda,9999,0,9999,0
1668109829584,CSE 293,025,119406,Politz; Joseph Gibbs,9999,0,9999,0
1668109829584,CSE 293,026,119411,Porter; George M,9999,0,9999,0
1668109829584,CSE 293,027,119414,Porter; Leonard Emerson,9999,0,9999,0
1668109829584,CSE 293,028,119416,Ramamoorthi; Ravi,9999,0,9999,0
1668109829584,CSE 293,029,119417,Sahoo; Debashis,9999,0,9999,0
1668109829584,CSE 293,030,119420,Saul; Lawrence,9999,0,9999,0
1668109829584,CSE 293,031,119421,Savage; Stefan,9999,0,9999,0
1668109829584,CSE 293,032,119425,Schulze; Jurgen P.,9999,0,9999,0
1668109829584,CSE 293,033,119426,Snoeren; Alex C.,9999,0,9999,0
1668109829584,CSE 293,034,119428,Shang; Jingbo,9999,0,9999,0
1668109829584,CSE 293,035,119430,Stefan; Deian,9999,0,9999,0
1668109829584,CSE 293,036,119431,Su; Hao,9999,0,9999,0
1668109829584,CSE 293,037,119433,Swanson; Steven James,9999,0,9999,0
1668109829584,CSE 293,038,119435,Tullsen; Dean Michael,9999,0,9999,0
1668109829584,CSE 293,039,119483,Voelker; Geoffrey M.,9999,0,9999,0
1668109829584,CSE 293,040,119537,Zhao; Jishen,9999,0,9999,0
1668109829584,CSE 293,041,119538,Zhou; Yuan-Yuan,9999,0,9999,0
1668109829584,CSE 293,042,119539,Gao; Sicun,9999,0,9999,0
1668109829584,CSE 293,043,119540,Weibel; Nadir,9999,0,9999,0
1668109829584,CSE 293,044,119541,Gupta; Rajesh K.,9999,0,9999,0
1668109829584,CSE 293,045,126410,Vaccaro; Kristen Marie,9999,0,9999,0
1668109829584,CSE 293,046,126411,Klemke; Richard,9999,0,9999,0
1668109830023,CSE 294,A00,102459,Voelker; Geoffrey M.,0,0,0,0
1668109830023,CSE 294,B00,111322,Orailoglu; Alex,0,0,0,0
1668109830447,DSE 201,A00,096914,Deutsch; Alin Bernard,30,0,30,0
1668109830879,DSE 210,A00,096915,Dasgupta; Sanjoy,30,0,30,0
1668109831310,DSE 260A,A00,096916,Altintas De Callaf; Ilkay,30,0,30,0
1668109831794,ECE 200,001,103586,Antipa; Nicholas A,9999,0,9999,0
1668109831794,ECE 200,002,103587,Atanasov; Nikolay A.,9999,0,9999,0
1668109831794,ECE 200,003,103588,Bharadia; Dinesh,9999,0,9999,0
1668109831794,ECE 200,004,103589,Cheng; Chung Kuan,9999,0,9999,0
1668109831794,ECE 200,005,103590,Cosman; Pamela C.,9999,0,9999,0
1668109831794,ECE 200,006,103591,Dayeh; Shadi Ahmad,9999,0,9999,0
1668109831794,ECE 200,007,103592,Fainman; Yeshaiahu,9999,0,9999,0
1668109831794,ECE 200,008,103593,Ford; Joseph Earl,9999,0,9999,0
1668109831794,ECE 200,009,103594,Franceschetti; Massimo,9999,0,9999,0
1668109831794,ECE 200,010,103595,Fullerton; Eric E,9999,0,9999,0
1668109831794,ECE 200,011,103596,Galton; Ian A,9999,0,9999,0
1668109831794,ECE 200,012,103597,Gilja; Vikash,9999,0,9999,0
1668109831794,ECE 200,013,103598,Hall; Drew A.,9999,0,9999,0
1668109831794,ECE 200,014,103599,Hsueh; Tzu-Chien,9999,0,9999,0
1668109831794,ECE 200,015,103600,Javidi; Tara,9999,0,9999,0
1668109831794,ECE 200,016,103601,Kahng; Andrew Byun,9999,0,9999,0
1668109831794,ECE 200,017,103602,Kim; Young-Han,9999,0,9999,0
1668109831794,ECE 200,018,103603,Koushanfar; Farinaz,9999,0,9999,0
1668109831794,ECE 200,019,103604,Kuzum; Duygu,9999,0,9999,0
1668109831794,ECE 200,020,103605,Le; Hanh-Phuc,9999,0,9999,0
1668109831794,ECE 200,021,103606,Lin; Bill,9999,0,9999,0
1668109831794,ECE 200,022,103607,Liu; Zhaowei,9998,0,9999,1
1668109831794,ECE 200,023,103608,Lo; Yu-Hwa,9999,0,9999,0
1668109831794,ECE 200,024,103609,Lomakin; Vitaliy,9999,0,9999,0
1668109831794,ECE 200,025,103610,Mercier; Patrick Philip,9999,0,9999,0
1668109831794,ECE 200,026,103611,Meyer; Florian,9999,0,9999,0
1668109831794,ECE 200,027,103612,Milstein; Laurence B.,9999,0,9999,0
1668109831794,ECE 200,028,103613,Mir Arabbaygi; Siavash,9999,0,9999,0
1668109831794,ECE 200,029,103614,Mookherjea; Shayan,9999,0,9999,0
1668109831794,ECE 200,030,103615,Morris; Karcher William,9999,0,9999,0
1668109831794,ECE 200,031,103616,Ng; Tse Nga,9999,0,9999,0
1668109831794,ECE 200,032,103617,Nguyen; Truong Quang,9999,0,9999,0
1668109831794,ECE 200,033,103618,Nomura; Kenji,9999,0,9999,0
1668109831794,ECE 200,034,103619,Orlitsky; Alon,9999,0,9999,0
1668109831794,ECE 200,035,103620,Pal; Piya,9999,0,9999,0
1668109831794,ECE 200,036,103621,Papen; George C.,9999,0,9999,0
1668109831794,ECE 200,037,103622,Radic; Stojan,9999,0,9999,0
1668109831794,ECE 200,038,103623,Rao; Bhaskar D.,9999,0,9999,0
1668109831794,ECE 200,039,103624,Rao; Ramesh R,9999,0,9999,0
1668109831794,ECE 200,040,103625,Rebeiz; Gabriel,9999,0,9999,0
1668109831794,ECE 200,041,103626,Sanford; John R,9999,0,9999,0
1668109831794,ECE 200,042,103627,Siegel; Paul H.,9999,0,9999,0
1668109831794,ECE 200,043,103628,Sievenpiper; Daniel F.,9999,0,9999,0
1668109831794,ECE 200,044,103629,Sworder; David D.,9999,0,9999,0
1668109831794,ECE 200,045,103630,Taur; Yuan,9999,0,9999,0
1668109831794,ECE 200,046,103631,Touri; Behrouz,9999,0,9999,0
1668109831794,ECE 200,047,103632,Trivedi; Mohan M.,9999,0,9999,0
1668109831794,ECE 200,048,103633,Vasconcelos; Nuno,9999,0,9999,0
1668109831794,ECE 200,049,103634,Wang; Xiaolong,9999,0,9999,0
1668109831794,ECE 200,050,103635,Xie; Pengtao,9999,0,9999,0
1668109831794,ECE 200,051,103636,Yip; Michael,9999,0,9999,0
1668109831794,ECE 200,052,103637,Zeger; Kenneth A.,999,0,999,0
1668109831794,ECE 200,053,103638,Zhang; Xinyu,9999,0,9999,0
1668109831794,ECE 200,054,103639,Turakhia; Yatish Girish,9999,0,9999,0
1668109831794,ECE 200,055,103640,Kang; Mingu,9999,0,9999,0
1668109831794,ECE 200,056,103641,Shi; Yuanyuan,9999,0,9999,0
1668109831794,ECE 200,057,103642,Wang; Edward Jay,9999,0,9999,0
1668109831794,ECE 200,058,103643,Zheng; Yang,9999,0,9999,0
1668109832227,ECE 202,A00,103644,Kuzum; Duygu,0,0,0,0
1668109832659,ECE 212BN,A00,103646,Ng; Tse Nga,0,0,0,0
1668109833086,ECE 221,A00,111493,Staff,0,0,0,0
1668109833533,ECE 222B,A00,103647,Lomakin; Vitaliy,0,0,0,0
1668109833959,ECE 230B,A00,103648,Taur; Yuan,0,0,0,0
1668109834389,ECE 238B,A00,103649,Garay; Javier,0,0,0,0
1668109834814,ECE 240B,A00,112900,Fainman; Yeshaiahu,0,0,0,0
1668109835238,ECE 247A,A00,103650,Jokerst; Jesse Vincent,0,0,0,0
1668109835663,ECE 247B,A00,103651,Wang; Joseph,0,0,0,0
1668109836088,ECE 250,A00,103652,Siegel; Paul H.,0,0,0,0
1668109836510,ECE 251A,A00,103654,Rao; Bhaskar D.,0,0,0,0
1668109836933,ECE 257B,A00,103655,Bharadia; Dinesh,0,0,0,0
1668109837357,ECE 258A,A00,103656,Milstein; Laurence B.,0,0,0,0
1668109837795,ECE 260B,A00,103658,Kang; Mingu,0,0,0,0
1668109838224,ECE 264A,A00,103659,Galton; Ian A,0,0,0,0
1668109838650,ECE 265A,A00,103661,Gudem; Prasad S.S.,0,0,0,0
1668109839076,ECE 265D,A00,103662,Gudem; Prasad S.S.,0,0,0,0
1668109839501,ECE 268,A00,103663,Koushanfar; Farinaz,0,0,0,0
1668109839925,ECE 269,A01,103665,Pal; Piya,0,0,0,0
1668109840359,ECE 271B,A00,103666,Vasconcelos; Manuela,0,0,0,0
1668109840788,ECE 276A,A00,103667,Atanasov; Nikolay A.,0,0,0,0
1668109841213,ECE 277,A00,103668,An; Cheolhong,0,0,0,0
1668109841650,ECE 279,A00,117947,Hall; Drew A.,0,0,0,0
1668109842524,ECE 283,A00,103670,Hsueh; Tzu-Chien,0,0,0,0
1668109842947,ECE 284,A00,103671,Turakhia; Yatish Girish,0,0,0,0
1668109843386,ECE 285,A00,103672,Zheng; Yang,0,0,0,0
1668109843386,ECE 285,B00,103673,Sworder; David D.,0,0,0,0
1668109843815,ECE 287,A00,103676,Javidi; Tara,0,0,0,0
1668109844247,MATH 200B,A00,098023,Salehi Golsefidy; Alireza,12,0,15,3
1668109844674,MATH 202B,A00,098024,Rhoades; Brendon Patrick,9,0,15,6
1668109845099,MATH 203B,A00,098025,Oprea; Dragos N.,10,0,15,5
1668109845523,MATH 204B,A00,098026,Sorensen; Claus M,13,0,15,2
1668109845948,MATH 208,A00,098027,Izadi; Elham,7,0,10,3
1668109846375,MATH 209,A00,098028,Pollack; Aaron,10,0,10,0
1668109846798,MATH 211A,A00,112919,Rogalski; Daniel,9,0,10,1
1668109847230,MATH 211B,A00,112920,Seward; Brandon M.,9,0,10,1
1668109847655,MATH 218,A00,098029,Li; Bo,10,0,10,0
1668109848084,MATH 220B,A00,098030,Novak; Jonathan I,11,0,15,4
1668109848510,MATH 221A,A00,098031,Ebenfelt; Peter F,13,0,15,2
1668109848935,MATH 231B,A00,098032,Zlatos; Andrej,12,0,15,3
1668109849363,MATH 240B,A00,098033,Ni; Lei,9,0,15,6
1668109849788,MATH 243,A00,098034,Jekel; David Andrew,10,0,10,0
1668109850221,MATH 245A,A00,098035,Nie; Jiawang,0,0,15,16
1668109850645,MATH 248,A00,098036,Bejenaru; Ioan,10,0,10,0
1668109851094,MATH 250B,A00,098037,Spolaor; Luca,14,0,15,1
1668109851531,MATH 258,A00,098038,Ni; Lei,10,0,10,0
1668109851966,MATH 264B,A00,098041,Rhoades; Brendon Patrick,9,0,15,6
1668109852392,MATH 268,A00,098042,Buss; Samuel R,10,0,10,0
1668109852827,MATH 269,A00,098043,Rhoades; Brendon Patrick,10,0,10,0
1668109853252,MATH 270B,A00,098044,Li; Bo,10,0,15,5
1668109853684,MATH 272B,A00,098045,Holst; Michael J,13,0,15,2
1668109854109,MATH 273A,A00,098046,Tian; Xiaochuan,10,0,15,5
1668109854539,MATH 275,A01,098048,Tian; Xiaochuan,6,0,10,4
1668109854975,MATH 278A,A00,098049,Holst; Michael J,8,0,10,2
1668109855410,MATH 278B,A00,098050,Cloninger; Alexander,10,0,10,0
1668109855835,MATH 278C,A00,098051,Nie; Jiawang,7,0,10,3
1668109856542,MATH 280B,A00,098052,Zheng; Tianyi,10,0,15,5
1668109856975,MATH 281B,A00,098053,Bradic; Jelena,2,0,15,13
1668109857407,MATH 282B,A00,098054,Arias-Castro; Ery,0,0,15,15
1668109857832,MATH 285,A00,098055,Fitzsimmons; Patrick J,0,0,15,17
1668109858274,MATH 287B,A00,098056,Arias-Castro; Ery,3,0,15,12
1668109858698,MATH 288,A00,098057,Agarwal; Pooja,9,0,10,1
1668109858698,MATH 288,B00,098058,Zhang; Danna,8,0,10,2
1668109858698,MATH 288,C00,098059,Williams; Ruth J,10,0,10,0
1668109859131,MATH 290B,A00,098060,Roberts; Justin Deritter,13,0,15,2
1668109859559,MATH 292,A00,098061,Belmont; Eva Kinoshita,10,0,10,0
1668109859984,MATH 295,A00,098062,Suk; Andrew Hoon,48,0,50,2
1668109860418,MATH 296,A00,098063,Novak; Jonathan I,20,0,20,0
1668109860850,MATH 297,001,098064,Gamst; Anthony Collins,9997,0,9999,2
1668110364272,COGS 205,A00,101395,Chiba; Andrea,19,0,20,1
1668110364707,COGS 210B,001,101404,Greene; Deanna Jacquelyn,9998,0,9999,1
1668110364707,COGS 210B,002,101417,Xia; Haijun,9999,0,9999,0
1668110364707,COGS 210B,003,101422,Nitz; Douglas A.,9999,0,9999,0
1668110364707,COGS 210B,004,101423,Hollan; James D.,9998,0,9999,1
1668110364707,COGS 210B,005,101424,Deak; Gedeon O.,9998,0,9999,1
1668110364707,COGS 210B,006,101425,Rossano; Federico,9999,0,9999,0
1668110365132,COGS 211B,A00,101427,Coulson; Seana M,9996,0,9999,3
1668110365559,COGS 220,A00,101428,Hollan; James D.,0,0,25,25
1668110365982,COGS 229,A00,101429,Dow; Steven P,18,0,25,7
1668110366410,COGS 230,A00,101430,Klemmer; Scott R,12,0,17,5
1668110366836,COGS 234,A00,101431,Xia; Haijun,3,0,25,22
1668110367272,COGS 260,A00,101432,Kiyonaga; Anastasia,20,0,25,5
1668110367272,COGS 260,B00,101433,Kirsh; David Joel,16,0,25,9
1668110367695,CSE 202,A00,102371,Impagliazzo; Russell,0,0,0,0
1668110368123,CSE 203B,A01,102373,Cheng; Chung Kuan,0,0,0,0
1668110368549,CSE 208,A00,102374,Micciancio; Daniele,0,0,0,0
1668110368972,CSE 209A,A00,112895,Impagliazzo; Russell,0,0,15,15
1668110369398,CSE 209B,A00,108005,Bellare; Mihir,0,0,0,0
1668110369830,CSE 210,A00,113163,Coblenz; Michael J,0,0,0,0
1668110370254,CSE 219,A00,106111,Dow; Steven P,0,0,20,20
1668110370678,CSE 221,A00,102376,Voelker; Geoffrey M.,0,0,0,0
1668110371101,CSE 224,A01,102378,Porter; George M,0,0,0,0
1668110371530,CSE 229A,A00,102379,Savage; Stefan,0,0,0,0
1668110371963,CSE 229C,A00,102380,Munyaka; Imani N. S.,0,0,0,0
1668110372402,CSE 232B,A00,102382,Deutsch; Alin Bernard,0,0,0,0
1668110372839,CSE 234,A01,112904,Kumar; Arun Kumar,0,0,0,0
1668110373277,CSE 237A,A00,102383,Rosing; Tajana Simunic,0,0,0,0
1668110373708,CSE 239A,A00,102384,Deutsch; Alin Bernard,0,0,0,0
1668110374135,CSE 239B,A00,102385,Polikarpova; Nadezhda,0,0,0,0
1668110374568,CSE 240A,A00,102386,Pannuto; Patrick William,0,0,0,0
1668110374991,CSE 240B,A00,102387,Zhao; Jishen,0,0,0,0
1668110375450,CSE 241A,A00,106406,Kang; Mingu,0,0,0,0
1668110375873,CSE 249B,A00,102388,Kahng; Andrew Byun,0,0,8,8
1668110376300,CSE 251B,A01,102392,Cottrell; Garrison W,0,0,0,0
1668110376300,CSE 251B,A02,102393,Cottrell; Garrison W,0,0,0,0
1668110376731,CSE 252B,A00,102394,Ochoa; Benjamin Lawrence,0,0,0,0
1668110377158,CSE 257,A01,102396,Gao; Sicun,0,0,0,0
1668110377583,CSE 272,A00,102397,Li; Tzumao,0,0,0,0
1668110378016,CSE 274,A00,111323,Chern; Albert Ren-Haur,0,0,0,0
1668110378438,CSE 282,A00,102398,Pevzner; Pavel Arkadjevich,0,0,0,0
1668110378863,CSE 284,A00,114175,Gymrek; Melissa Ann,0,0,0,0
1668110379285,CSE 290,A00,102399,Chandraker; Manmohan Krishna,0,0,0,0
1668110379285,CSE 290,B00,102400,Vaccaro; Kristen Marie,0,0,25,25
1668110379285,CSE 290,C00,102414,Pannuto; Patrick William,0,0,25,25
1668110379285,CSE 290,D00,102427,Pevzner; Pavel Arkadjevich,0,0,0,0
1668110379285,CSE 290,E00,102429,Zhao; Jishen,0,0,0,0
1668110379285,CSE 290,F00,102436,Tullsen; Dean Michael,0,0,0,0
1668110379285,CSE 290,G00,102440,Christensen; Henrik I,0,0,20,20
1668110379736,CSE 291,A00,102443,Su; Hao,0,0,0,0
1668110379736,CSE 291,B00,102448,Polikarpova; Nadezhda,0,0,0,0
1668110379736,CSE 291,C00,102453,Vaccaro; Kristen Marie,0,0,0,0
1668110379736,CSE 291,D00,111343,Savage; Stefan,0,0,0,0
1668110379736,CSE 291,E00,116474,Claffy; Kimberly Claire,0,0,0,0
1668110379736,CSE 291,F00,116479,Pasquale; Joseph,0,0,0,0
1668110380286,CSE 293,001,119111,Bafna; Vineet,9999,0,9999,0
1668110380286,CSE 293,002,119118,Bellare; Mihir,9999,0,9999,0
1668110380286,CSE 293,003,119122,Berg-Kirkpatrick; Taylor D,9999,0,9999,0
1668110380286,CSE 293,004,119135,Christensen; Henrik I,9999,0,9999,0
1668110380286,CSE 293,005,119142,Cottrell; Garrison W,9999,0,9999,0
1668110380286,CSE 293,006,119146,Deutsch; Alin Bernard,9999,0,9999,0
1668110380286,CSE 293,007,119159,Esmaeilzadeh; Hadi,9999,0,9999,0
1668110380286,CSE 293,008,119166,Freund; Yoav,9999,0,9999,0
1668110380286,CSE 293,009,119170,Griswold; William G.,9999,0,9999,0
1668110380286,CSE 293,010,119183,Gymrek; Melissa Ann,9999,0,9999,0
1668110380286,CSE 293,011,119190,Heninger; Nadia A,9999,0,9999,0
1668110380286,CSE 293,012,119230,Impagliazzo; Russell,9999,0,9999,0
1668110380286,CSE 293,013,119232,Jhala; Ranjit,9999,0,9999,0
1668110380286,CSE 293,014,119233,Kahng; Andrew Byun,9999,0,9999,0
1668110380286,CSE 293,015,119298,Kane; Daniel Mertz,9999,0,9999,0
1668110380286,CSE 293,016,119299,Kriegman; David J,9999,0,9999,0
1668110380286,CSE 293,017,119300,Kumar; Arun Kumar,9999,0,9999,0
1668110380286,CSE 293,018,119301,Lerner; Sorin,9999,0,9999,0
1668110380286,CSE 293,019,119302,Lovett; Shachar,9999,0,9999,0
1668110380286,CSE 293,020,119303,McAuley; Julian John,9999,0,9999,0
1668110380286,CSE 293,021,119304,Micciancio; Daniele,9999,0,9999,0
1668110380286,CSE 293,022,119367,Orailoglu; Alex,9999,0,9999,0
1668110380286,CSE 293,023,119382,Paturi; Ramamohan,9999,0,9999,0
1668110380286,CSE 293,024,119404,Polikarpova; Nadezhda,9999,0,9999,0
1668110380286,CSE 293,025,119406,Politz; Joseph Gibbs,9999,0,9999,0
1668110380286,CSE 293,026,119411,Porter; George M,9999,0,9999,0
1668110380286,CSE 293,027,119414,Porter; Leonard Emerson,9999,0,9999,0
1668110380286,CSE 293,028,119416,Ramamoorthi; Ravi,9999,0,9999,0
1668110380286,CSE 293,029,119417,Sahoo; Debashis,9999,0,9999,0
1668110380286,CSE 293,030,119420,Saul; Lawrence,9999,0,9999,0
1668110380286,CSE 293,031,119421,Savage; Stefan,9999,0,9999,0
1668110380286,CSE 293,032,119425,Schulze; Jurgen P.,9999,0,9999,0
1668110380286,CSE 293,033,119426,Snoeren; Alex C.,9999,0,9999,0
1668110380286,CSE 293,034,119428,Shang; Jingbo,9999,0,9999,0
1668110380286,CSE 293,035,119430,Stefan; Deian,9999,0,9999,0
1668110380286,CSE 293,036,119431,Su; Hao,9999,0,9999,0
1668110380286,CSE 293,037,119433,Swanson; Steven James,9999,0,9999,0
1668110380286,CSE 293,038,119435,Tullsen; Dean Michael,9999,0,9999,0
1668110380286,CSE 293,039,119483,Voelker; Geoffrey M.,9999,0,9999,0
1668110380286,CSE 293,040,119537,Zhao; Jishen,9999,0,9999,0
1668110380286,CSE 293,041,119538,Zhou; Yuan-Yuan,9999,0,9999,0
1668110380286,CSE 293,042,119539,Gao; Sicun,9999,0,9999,0
1668110380286,CSE 293,043,119540,Weibel; Nadir,9999,0,9999,0
1668110380286,CSE 293,044,119541,Gupta; Rajesh K.,9999,0,9999,0
1668110380286,CSE 293,045,126410,Vaccaro; Kristen Marie,9999,0,9999,0
1668110380286,CSE 293,046,126411,Klemke; Richard,9999,0,9999,0
1668110380714,CSE 294,A00,102459,Voelker; Geoffrey M.,0,0,0,0
1668110380714,CSE 294,B00,111322,Orailoglu; Alex,0,0,0,0
1668110381154,DSE 201,A00,096914,Deutsch; Alin Bernard,30,0,30,0
1668110381580,DSE 210,A00,096915,Dasgupta; Sanjoy,30,0,30,0
1668110382013,DSE 260A,A00,096916,Altintas De Callaf; Ilkay,30,0,30,0
1668110382442,ECE 200,001,103586,Antipa; Nicholas A,9999,0,9999,0
1668110382442,ECE 200,002,103587,Atanasov; Nikolay A.,9999,0,9999,0
1668110382442,ECE 200,003,103588,Bharadia; Dinesh,9999,0,9999,0
1668110382442,ECE 200,004,103589,Cheng; Chung Kuan,9999,0,9999,0
1668110382442,ECE 200,005,103590,Cosman; Pamela C.,9999,0,9999,0
1668110382442,ECE 200,006,103591,Dayeh; Shadi Ahmad,9999,0,9999,0
1668110382442,ECE 200,007,103592,Fainman; Yeshaiahu,9999,0,9999,0
1668110382442,ECE 200,008,103593,Ford; Joseph Earl,9999,0,9999,0
1668110382442,ECE 200,009,103594,Franceschetti; Massimo,9999,0,9999,0
1668110382442,ECE 200,010,103595,Fullerton; Eric E,9999,0,9999,0
1668110382442,ECE 200,011,103596,Galton; Ian A,9999,0,9999,0
1668110382442,ECE 200,012,103597,Gilja; Vikash,9999,0,9999,0
1668110382442,ECE 200,013,103598,Hall; Drew A.,9999,0,9999,0
1668110382442,ECE 200,014,103599,Hsueh; Tzu-Chien,9999,0,9999,0
1668110382442,ECE 200,015,103600,Javidi; Tara,9999,0,9999,0
1668110382442,ECE 200,016,103601,Kahng; Andrew Byun,9999,0,9999,0
1668110382442,ECE 200,017,103602,Kim; Young-Han,9999,0,9999,0
1668110382442,ECE 200,018,103603,Koushanfar; Farinaz,9999,0,9999,0
1668110382442,ECE 200,019,103604,Kuzum; Duygu,9999,0,9999,0
1668110382442,ECE 200,020,103605,Le; Hanh-Phuc,9999,0,9999,0
1668110382442,ECE 200,021,103606,Lin; Bill,9999,0,9999,0
1668110382442,ECE 200,022,103607,Liu; Zhaowei,9998,0,9999,1
1668110382442,ECE 200,023,103608,Lo; Yu-Hwa,9999,0,9999,0
1668110382442,ECE 200,024,103609,Lomakin; Vitaliy,9999,0,9999,0
1668110382442,ECE 200,025,103610,Mercier; Patrick Philip,9999,0,9999,0
1668110382442,ECE 200,026,103611,Meyer; Florian,9999,0,9999,0
1668110382442,ECE 200,027,103612,Milstein; Laurence B.,9999,0,9999,0
1668110382442,ECE 200,028,103613,Mir Arabbaygi; Siavash,9999,0,9999,0
1668110382442,ECE 200,029,103614,Mookherjea; Shayan,9999,0,9999,0
1668110382442,ECE 200,030,103615,Morris; Karcher William,9999,0,9999,0
1668110382442,ECE 200,031,103616,Ng; Tse Nga,9999,0,9999,0
1668110382442,ECE 200,032,103617,Nguyen; Truong Quang,9999,0,9999,0
1668110382442,ECE 200,033,103618,Nomura; Kenji,9999,0,9999,0
1668110382442,ECE 200,034,103619,Orlitsky; Alon,9999,0,9999,0
1668110382442,ECE 200,035,103620,Pal; Piya,9999,0,9999,0
1668110382442,ECE 200,036,103621,Papen; George C.,9999,0,9999,0
1668110382442,ECE 200,037,103622,Radic; Stojan,9999,0,9999,0
1668110382442,ECE 200,038,103623,Rao; Bhaskar D.,9999,0,9999,0
1668110382442,ECE 200,039,103624,Rao; Ramesh R,9999,0,9999,0
1668110382442,ECE 200,040,103625,Rebeiz; Gabriel,9999,0,9999,0
1668110382442,ECE 200,041,103626,Sanford; John R,9999,0,9999,0
1668110382442,ECE 200,042,103627,Siegel; Paul H.,9999,0,9999,0
1668110382442,ECE 200,043,103628,Sievenpiper; Daniel F.,9999,0,9999,0
1668110382442,ECE 200,044,103629,Sworder; David D.,9999,0,9999,0
1668110382442,ECE 200,045,103630,Taur; Yuan,9999,0,9999,0
1668110382442,ECE 200,046,103631,Touri; Behrouz,9999,0,9999,0
1668110382442,ECE 200,047,103632,Trivedi; Mohan M.,9999,0,9999,0
1668110382442,ECE 200,048,103633,Vasconcelos; Nuno,9999,0,9999,0
1668110382442,ECE 200,049,103634,Wang; Xiaolong,9999,0,9999,0
1668110382442,ECE 200,050,103635,Xie; Pengtao,9999,0,9999,0
1668110382442,ECE 200,051,103636,Yip; Michael,9999,0,9999,0
1668110382442,ECE 200,052,103637,Zeger; Kenneth A.,999,0,999,0
1668110382442,ECE 200,053,103638,Zhang; Xinyu,9999,0,9999,0
1668110382442,ECE 200,054,103639,Turakhia; Yatish Girish,9999,0,9999,0
1668110382442,ECE 200,055,103640,Kang; Mingu,9999,0,9999,0
1668110382442,ECE 200,056,103641,Shi; Yuanyuan,9999,0,9999,0
1668110382442,ECE 200,057,103642,Wang; Edward Jay,9999,0,9999,0
1668110382442,ECE 200,058,103643,Zheng; Yang,9999,0,9999,0
1668110382881,ECE 202,A00,103644,Kuzum; Duygu,0,0,0,0
1668110383314,ECE 212BN,A00,103646,Ng; Tse Nga,0,0,0,0
1668110383736,ECE 221,A00,111493,Staff,0,0,0,0
1668110384178,ECE 222B,A00,103647,Lomakin; Vitaliy,0,0,0,0
1668110384603,ECE 230B,A00,103648,Taur; Yuan,0,0,0,0
1668110385035,ECE 238B,A00,103649,Garay; Javier,0,0,0,0
1668110385466,ECE 240B,A00,112900,Fainman; Yeshaiahu,0,0,0,0
1668110385888,ECE 247A,A00,103650,Jokerst; Jesse Vincent,0,0,0,0
1668110386326,ECE 247B,A00,103651,Wang; Joseph,0,0,0,0
1668110386756,ECE 250,A00,103652,Siegel; Paul H.,0,0,0,0
1668110387180,ECE 251A,A00,103654,Rao; Bhaskar D.,0,0,0,0
1668110387621,ECE 257B,A00,103655,Bharadia; Dinesh,0,0,0,0
1668110388062,ECE 258A,A00,103656,Milstein; Laurence B.,0,0,0,0
1668110388487,ECE 260B,A00,103658,Kang; Mingu,0,0,0,0
1668110388914,ECE 264A,A00,103659,Galton; Ian A,0,0,0,0
1668110389351,ECE 265A,A00,103661,Gudem; Prasad S.S.,0,0,0,0
1668110389776,ECE 265D,A00,103662,Gudem; Prasad S.S.,0,0,0,0
1668110390207,ECE 268,A00,103663,Koushanfar; Farinaz,0,0,0,0
1668110390634,ECE 269,A01,103665,Pal; Piya,0,0,0,0
1668110391059,ECE 271B,A00,103666,Vasconcelos; Manuela,0,0,0,0
1668110391498,ECE 276A,A00,103667,Atanasov; Nikolay A.,0,0,0,0
1668110391932,ECE 277,A00,103668,An; Cheolhong,0,0,0,0
1668110392363,ECE 279,A00,117947,Hall; Drew A.,0,0,0,0
1668110393218,ECE 283,A00,103670,Hsueh; Tzu-Chien,0,0,0,0
1668110393641,ECE 284,A00,103671,Turakhia; Yatish Girish,0,0,0,0
1668110394069,ECE 285,A00,103672,Zheng; Yang,0,0,0,0
1668110394069,ECE 285,B00,103673,Sworder; David D.,0,0,0,0
1668110394496,ECE 287,A00,103676,Javidi; Tara,0,0,0,0
1668110394923,MATH 200B,A00,098023,Salehi Golsefidy; Alireza,12,0,15,3
1668110395345,MATH 202B,A00,098024,Rhoades; Brendon Patrick,9,0,15,6
1668110395772,MATH 203B,A00,098025,Oprea; Dragos N.,10,0,15,5
1668110396203,MATH 204B,A00,098026,Sorensen; Claus M,13,0,15,2
1668110396626,MATH 208,A00,098027,Izadi; Elham,7,0,10,3
1668110397050,MATH 209,A00,098028,Pollack; Aaron,10,0,10,0
1668110397487,MATH 211A,A00,112919,Rogalski; Daniel,9,0,10,1
1668110397923,MATH 211B,A00,112920,Seward; Brandon M.,9,0,10,1
1668110398358,MATH 218,A00,098029,Li; Bo,10,0,10,0
1668110398792,MATH 220B,A00,098030,Novak; Jonathan I,11,0,15,4
1668110399214,MATH 221A,A00,098031,Ebenfelt; Peter F,13,0,15,2
1668110399639,MATH 231B,A00,098032,Zlatos; Andrej,12,0,15,3
1668110400060,MATH 240B,A00,098033,Ni; Lei,9,0,15,6
1668110400519,MATH 243,A00,098034,Jekel; David Andrew,10,0,10,0
1668110401397,MATH 245A,A00,098035,Nie; Jiawang,0,0,15,16
1668110401835,MATH 248,A00,098036,Bejenaru; Ioan,10,0,10,0
1668110402263,MATH 250B,A00,098037,Spolaor; Luca,14,0,15,1
1668110402984,MATH 258,A00,098038,Ni; Lei,10,0,10,0
1668110403423,MATH 264B,A00,098041,Rhoades; Brendon Patrick,9,0,15,6
1668110403855,MATH 268,A00,098042,Buss; Samuel R,10,0,10,0
1668110404284,MATH 269,A00,098043,Rhoades; Brendon Patrick,10,0,10,0
1668110404710,MATH 270B,A00,098044,Li; Bo,10,0,15,5
1668110405619,MATH 272B,A00,098045,Holst; Michael J,13,0,15,2
1668110406042,MATH 273A,A00,098046,Tian; Xiaochuan,10,0,15,5
1668110406467,MATH 275,A01,098048,Tian; Xiaochuan,6,0,10,4
1668110406896,MATH 278A,A00,098049,Holst; Michael J,8,0,10,2
1668110407431,MATH 278B,A00,098050,Cloninger; Alexander,10,0,10,0
1668110407963,MATH 278C,A00,098051,Nie; Jiawang,7,0,10,3
1668110408391,MATH 280B,A00,098052,Zheng; Tianyi,10,0,15,5
1668110408840,MATH 281B,A00,098053,Bradic; Jelena,2,0,15,13
1668110409426,MATH 282B,A00,098054,Arias-Castro; Ery,0,0,15,15
1668110409851,MATH 285,A00,098055,Fitzsimmons; Patrick J,0,0,15,17
1668110410309,MATH 287B,A00,098056,Arias-Castro; Ery,3,0,15,12
1668110410744,MATH 288,A00,098057,Agarwal; Pooja,9,0,10,1
1668110410744,MATH 288,B00,098058,Zhang; Danna,8,0,10,2
1668110410744,MATH 288,C00,098059,Williams; Ruth J,10,0,10,0
1668110411177,MATH 290B,A00,098060,Roberts; Justin Deritter,13,0,15,2
1668110411599,MATH 292,A00,098061,Belmont; Eva Kinoshita,10,0,10,0
1668110412038,MATH 295,A00,098062,Suk; Andrew Hoon,48,0,50,2
1668110412472,MATH 296,A00,098063,Novak; Jonathan I,20,0,20,0
1668110412896,MATH 297,001,098064,Gamst; Anthony Collins,9997,0,9999,2
1668110927140,COGS 205,A00,101395,Chiba; Andrea,19,0,20,1
1668110927573,COGS 210B,001,101404,Greene; Deanna Jacquelyn,9998,0,9999,1
1668110927573,COGS 210B,002,101417,Xia; Haijun,9999,0,9999,0
1668110927573,COGS 210B,003,101422,Nitz; Douglas A.,9999,0,9999,0
1668110927573,COGS 210B,004,101423,Hollan; James D.,9998,0,9999,1
1668110927573,COGS 210B,005,101424,Deak; Gedeon O.,9998,0,9999,1
1668110927573,COGS 210B,006,101425,Rossano; Federico,9999,0,9999,0
1668110928009,COGS 211B,A00,101427,Coulson; Seana M,9996,0,9999,3
1668110928435,COGS 220,A00,101428,Hollan; James D.,0,0,25,25
1668110928868,COGS 229,A00,101429,Dow; Steven P,18,0,25,7
1668110929294,COGS 230,A00,101430,Klemmer; Scott R,12,0,17,5
1668110929722,COGS 234,A00,101431,Xia; Haijun,3,0,25,22
1668110930145,COGS 260,A00,101432,Kiyonaga; Anastasia,20,0,25,5
1668110930145,COGS 260,B00,101433,Kirsh; David Joel,16,0,25,9
1668110930569,CSE 202,A00,102371,Impagliazzo; Russell,0,0,0,0
1668110930997,CSE 203B,A01,102373,Cheng; Chung Kuan,0,0,0,0
1668110931420,CSE 208,A00,102374,Micciancio; Daniele,0,0,0,0
1668110931850,CSE 209A,A00,112895,Impagliazzo; Russell,0,0,15,15
1668110932272,CSE 209B,A00,108005,Bellare; Mihir,0,0,0,0
1668110932697,CSE 210,A00,113163,Coblenz; Michael J,0,0,0,0
1668110933124,CSE 219,A00,106111,Dow; Steven P,0,0,20,20
1668110933546,CSE 221,A00,102376,Voelker; Geoffrey M.,0,0,0,0
1668110933982,CSE 224,A01,102378,Porter; George M,0,0,0,0
1668110934421,CSE 229A,A00,102379,Savage; Stefan,0,0,0,0
1668110934849,CSE 229C,A00,102380,Munyaka; Imani N. S.,0,0,0,0
1668110935276,CSE 232B,A00,102382,Deutsch; Alin Bernard,0,0,0,0
1668110935715,CSE 234,A01,112904,Kumar; Arun Kumar,0,0,0,0
1668110936139,CSE 237A,A00,102383,Rosing; Tajana Simunic,0,0,0,0
1668110936569,CSE 239A,A00,102384,Deutsch; Alin Bernard,0,0,0,0
1668110936991,CSE 239B,A00,102385,Polikarpova; Nadezhda,0,0,0,0
1668110937427,CSE 240A,A00,102386,Pannuto; Patrick William,0,0,0,0
1668110937855,CSE 240B,A00,102387,Zhao; Jishen,0,0,0,0
1668110938280,CSE 241A,A00,106406,Kang; Mingu,0,0,0,0
1668110938711,CSE 249B,A00,102388,Kahng; Andrew Byun,0,0,8,8
1668110939136,CSE 251B,A01,102392,Cottrell; Garrison W,0,0,0,0
1668110939136,CSE 251B,A02,102393,Cottrell; Garrison W,0,0,0,0
1668110939560,CSE 252B,A00,102394,Ochoa; Benjamin Lawrence,0,0,0,0
1668110939996,CSE 257,A01,102396,Gao; Sicun,0,0,0,0
1668110940423,CSE 272,A00,102397,Li; Tzumao,0,0,0,0
1668110940856,CSE 274,A00,111323,Chern; Albert Ren-Haur,0,0,0,0
1668110941282,CSE 282,A00,102398,Pevzner; Pavel Arkadjevich,0,0,0,0
1668110941709,CSE 284,A00,114175,Gymrek; Melissa Ann,0,0,0,0
1668110942153,CSE 290,A00,102399,Chandraker; Manmohan Krishna,0,0,0,0
1668110942153,CSE 290,B00,102400,Vaccaro; Kristen Marie,0,0,25,25
1668110942153,CSE 290,C00,102414,Pannuto; Patrick William,0,0,25,25
1668110942153,CSE 290,D00,102427,Pevzner; Pavel Arkadjevich,0,0,0,0
1668110942153,CSE 290,E00,102429,Zhao; Jishen,0,0,0,0
1668110942153,CSE 290,F00,102436,Tullsen; Dean Michael,0,0,0,0
1668110942153,CSE 290,G00,102440,Christensen; Henrik I,0,0,20,20
1668110942578,CSE 291,A00,102443,Su; Hao,0,0,0,0
1668110942578,CSE 291,B00,102448,Polikarpova; Nadezhda,0,0,0,0
1668110942578,CSE 291,C00,102453,Vaccaro; Kristen Marie,0,0,0,0
1668110942578,CSE 291,D00,111343,Savage; Stefan,0,0,0,0
1668110942578,CSE 291,E00,116474,Claffy; Kimberly Claire,0,0,0,0
1668110942578,CSE 291,F00,116479,Pasquale; Joseph,0,0,0,0
1668110943004,CSE 293,001,119111,Bafna; Vineet,9999,0,9999,0
1668110943004,CSE 293,002,119118,Bellare; Mihir,9999,0,9999,0
1668110943004,CSE 293,003,119122,Berg-Kirkpatrick; Taylor D,9999,0,9999,0
1668110943004,CSE 293,004,119135,Christensen; Henrik I,9999,0,9999,0
1668110943004,CSE 293,005,119142,Cottrell; Garrison W,9999,0,9999,0
1668110943004,CSE 293,006,119146,Deutsch; Alin Bernard,9999,0,9999,0
1668110943004,CSE 293,007,119159,Esmaeilzadeh; Hadi,9999,0,9999,0
1668110943004,CSE 293,008,119166,Freund; Yoav,9999,0,9999,0
1668110943004,CSE 293,009,119170,Griswold; William G.,9999,0,9999,0
1668110943004,CSE 293,010,119183,Gymrek; Melissa Ann,9999,0,9999,0
1668110943004,CSE 293,011,119190,Heninger; Nadia A,9999,0,9999,0
1668110943004,CSE 293,012,119230,Impagliazzo; Russell,9999,0,9999,0
1668110943004,CSE 293,013,119232,Jhala; Ranjit,9999,0,9999,0
1668110943004,CSE 293,014,119233,Kahng; Andrew Byun,9999,0,9999,0
1668110943004,CSE 293,015,119298,Kane; Daniel Mertz,9999,0,9999,0
1668110943004,CSE 293,016,119299,Kriegman; David J,9999,0,9999,0
1668110943004,CSE 293,017,119300,Kumar; Arun Kumar,9999,0,9999,0
1668110943004,CSE 293,018,119301,Lerner; Sorin,9999,0,9999,0
1668110943004,CSE 293,019,119302,Lovett; Shachar,9999,0,9999,0
1668110943004,CSE 293,020,119303,McAuley; Julian John,9999,0,9999,0
1668110943004,CSE 293,021,119304,Micciancio; Daniele,9999,0,9999,0
1668110943004,CSE 293,022,119367,Orailoglu; Alex,9999,0,9999,0
1668110943004,CSE 293,023,119382,Paturi; Ramamohan,9999,0,9999,0
1668110943004,CSE 293,024,119404,Polikarpova; Nadezhda,9999,0,9999,0
1668110943004,CSE 293,025,119406,Politz; Joseph Gibbs,9999,0,9999,0
1668110943004,CSE 293,026,119411,Porter; George M,9999,0,9999,0
1668110943004,CSE 293,027,119414,Porter; Leonard Emerson,9999,0,9999,0
1668110943004,CSE 293,028,119416,Ramamoorthi; Ravi,9999,0,9999,0
1668110943004,CSE 293,029,119417,Sahoo; Debashis,9999,0,9999,0
1668110943004,CSE 293,030,119420,Saul; Lawrence,9999,0,9999,0
1668110943004,CSE 293,031,119421,Savage; Stefan,9999,0,9999,0
1668110943004,CSE 293,032,119425,Schulze; Jurgen P.,9999,0,9999,0
1668110943004,CSE 293,033,119426,Snoeren; Alex C.,9999,0,9999,0
1668110943004,CSE 293,034,119428,Shang; Jingbo,9999,0,9999,0
1668110943004,CSE 293,035,119430,Stefan; Deian,9999,0,9999,0
1668110943004,CSE 293,036,119431,Su; Hao,9999,0,9999,0
1668110943004,CSE 293,037,119433,Swanson; Steven James,9999,0,9999,0
1668110943004,CSE 293,038,119435,Tullsen; Dean Michael,9999,0,9999,0
1668110943004,CSE 293,039,119483,Voelker; Geoffrey M.,9999,0,9999,0
1668110943004,CSE 293,040,119537,Zhao; Jishen,9999,0,9999,0
1668110943004,CSE 293,041,119538,Zhou; Yuan-Yuan,9999,0,9999,0
1668110943004,CSE 293,042,119539,Gao; Sicun,9999,0,9999,0
1668110943004,CSE 293,043,119540,Weibel; Nadir,9999,0,9999,0
1668110943004,CSE 293,044,119541,Gupta; Rajesh K.,9999,0,9999,0
1668110943004,CSE 293,045,126410,Vaccaro; Kristen Marie,9999,0,9999,0
1668110943004,CSE 293,046,126411,Klemke; Richard,9999,0,9999,0
1668110943425,CSE 294,A00,102459,Voelker; Geoffrey M.,0,0,0,0
1668110943425,CSE 294,B00,111322,Orailoglu; Alex,0,0,0,0
1668110943858,DSE 201,A00,096914,Deutsch; Alin Bernard,30,0,30,0
1668110944287,DSE 210,A00,096915,Dasgupta; Sanjoy,30,0,30,0
1668110944733,DSE 260A,A00,096916,Altintas De Callaf; Ilkay,30,0,30,0
1668110945164,ECE 200,001,103586,Antipa; Nicholas A,9999,0,9999,0
1668110945164,ECE 200,002,103587,Atanasov; Nikolay A.,9999,0,9999,0
1668110945164,ECE 200,003,103588,Bharadia; Dinesh,9999,0,9999,0
1668110945164,ECE 200,004,103589,Cheng; Chung Kuan,9999,0,9999,0
1668110945164,ECE 200,005,103590,Cosman; Pamela C.,9999,0,9999,0
1668110945164,ECE 200,006,103591,Dayeh; Shadi Ahmad,9999,0,9999,0
1668110945164,ECE 200,007,103592,Fainman; Yeshaiahu,9999,0,9999,0
1668110945164,ECE 200,008,103593,Ford; Joseph Earl,9999,0,9999,0
1668110945164,ECE 200,009,103594,Franceschetti; Massimo,9999,0,9999,0
1668110945164,ECE 200,010,103595,Fullerton; Eric E,9999,0,9999,0
1668110945164,ECE 200,011,103596,Galton; Ian A,9999,0,9999,0
1668110945164,ECE 200,012,103597,Gilja; Vikash,9999,0,9999,0
1668110945164,ECE 200,013,103598,Hall; Drew A.,9999,0,9999,0
1668110945164,ECE 200,014,103599,Hsueh; Tzu-Chien,9999,0,9999,0
1668110945164,ECE 200,015,103600,Javidi; Tara,9999,0,9999,0
1668110945164,ECE 200,016,103601,Kahng; Andrew Byun,9999,0,9999,0
1668110945164,ECE 200,017,103602,Kim; Young-Han,9999,0,9999,0
1668110945164,ECE 200,018,103603,Koushanfar; Farinaz,9999,0,9999,0
1668110945164,ECE 200,019,103604,Kuzum; Duygu,9999,0,9999,0
1668110945164,ECE 200,020,103605,Le; Hanh-Phuc,9999,0,9999,0
1668110945164,ECE 200,021,103606,Lin; Bill,9999,0,9999,0
1668110945164,ECE 200,022,103607,Liu; Zhaowei,9998,0,9999,1
1668110945164,ECE 200,023,103608,Lo; Yu-Hwa,9999,0,9999,0
1668110945164,ECE 200,024,103609,Lomakin; Vitaliy,9999,0,9999,0
1668110945164,ECE 200,025,103610,Mercier; Patrick Philip,9999,0,9999,0
1668110945164,ECE 200,026,103611,Meyer; Florian,9999,0,9999,0
1668110945164,ECE 200,027,103612,Milstein; Laurence B.,9999,0,9999,0
1668110945164,ECE 200,028,103613,Mir Arabbaygi; Siavash,9999,0,9999,0
1668110945164,ECE 200,029,103614,Mookherjea; Shayan,9999,0,9999,0
1668110945164,ECE 200,030,103615,Morris; Karcher William,9999,0,9999,0
1668110945164,ECE 200,031,103616,Ng; Tse Nga,9999,0,9999,0
1668110945164,ECE 200,032,103617,Nguyen; Truong Quang,9999,0,9999,0
1668110945164,ECE 200,033,103618,Nomura; Kenji,9999,0,9999,0
1668110945164,ECE 200,034,103619,Orlitsky; Alon,9999,0,9999,0
1668110945164,ECE 200,035,103620,Pal; Piya,9999,0,9999,0
1668110945164,ECE 200,036,103621,Papen; George C.,9999,0,9999,0
1668110945164,ECE 200,037,103622,Radic; Stojan,9999,0,9999,0
1668110945164,ECE 200,038,103623,Rao; Bhaskar D.,9999,0,9999,0
1668110945164,ECE 200,039,103624,Rao; Ramesh R,9999,0,9999,0
1668110945164,ECE 200,040,103625,Rebeiz; Gabriel,9999,0,9999,0
1668110945164,ECE 200,041,103626,Sanford; John R,9999,0,9999,0
1668110945164,ECE 200,042,103627,Siegel; Paul H.,9999,0,9999,0
1668110945164,ECE 200,043,103628,Sievenpiper; Daniel F.,9999,0,9999,0
1668110945164,ECE 200,044,103629,Sworder; David D.,9999,0,9999,0
1668110945164,ECE 200,045,103630,Taur; Yuan,9999,0,9999,0
1668110945164,ECE 200,046,103631,Touri; Behrouz,9999,0,9999,0
1668110945164,ECE 200,047,103632,Trivedi; Mohan M.,9999,0,9999,0
1668110945164,ECE 200,048,103633,Vasconcelos; Nuno,9999,0,9999,0
1668110945164,ECE 200,049,103634,Wang; Xiaolong,9999,0,9999,0
1668110945164,ECE 200,050,103635,Xie; Pengtao,9999,0,9999,0
1668110945164,ECE 200,051,103636,Yip; Michael,9999,0,9999,0
1668110945164,ECE 200,052,103637,Zeger; Kenneth A.,999,0,999,0
1668110945164,ECE 200,053,103638,Zhang; Xinyu,9999,0,9999,0
1668110945164,ECE 200,054,103639,Turakhia; Yatish Girish,9999,0,9999,0
1668110945164,ECE 200,055,103640,Kang; Mingu,9999,0,9999,0
1668110945164,ECE 200,056,103641,Shi; Yuanyuan,9999,0,9999,0
1668110945164,ECE 200,057,103642,Wang; Edward Jay,9999,0,9999,0
1668110945164,ECE 200,058,103643,Zheng; Yang,9999,0,9999,0
1668110945591,ECE 202,A00,103644,Kuzum; Duygu,0,0,0,0
1668110946019,ECE 212BN,A00,103646,Ng; Tse Nga,0,0,0,0
1668110946466,ECE 221,A00,111493,Staff,0,0,0,0
1668110946887,ECE 222B,A00,103647,Lomakin; Vitaliy,0,0,0,0
1668110947311,ECE 230B,A00,103648,Taur; Yuan,0,0,0,0
1668110947732,ECE 238B,A00,103649,Garay; Javier,0,0,0,0
1668110948157,ECE 240B,A00,112900,Fainman; Yeshaiahu,0,0,0,0
1668110948588,ECE 247A,A00,103650,Jokerst; Jesse Vincent,0,0,0,0
1668110949021,ECE 247B,A00,103651,Wang; Joseph,0,0,0,0
1668110949447,ECE 250,A00,103652,Siegel; Paul H.,0,0,0,0
1668110949871,ECE 251A,A00,103654,Rao; Bhaskar D.,0,0,0,0
1668110950301,ECE 257B,A00,103655,Bharadia; Dinesh,0,0,0,0
1668110950724,ECE 258A,A00,103656,Milstein; Laurence B.,0,0,0,0
1668110951157,ECE 260B,A00,103658,Kang; Mingu,0,0,0,0
1668110951586,ECE 264A,A00,103659,Galton; Ian A,0,0,0,0
1668110952012,ECE 265A,A00,103661,Gudem; Prasad S.S.,0,0,0,0
1668110952439,ECE 265D,A00,103662,Gudem; Prasad S.S.,0,0,0,0
1668110952872,ECE 268,A00,103663,Koushanfar; Farinaz,0,0,0,0
1668110953303,ECE 269,A01,103665,Pal; Piya,0,0,0,0
1668110953726,ECE 271B,A00,103666,Vasconcelos; Manuela,0,0,0,0
1668110954151,ECE 276A,A00,103667,Atanasov; Nikolay A.,0,0,0,0
1668110954575,ECE 277,A00,103668,An; Cheolhong,0,0,0,0
1668110955003,ECE 279,A00,117947,Hall; Drew A.,0,0,0,0
1668110955847,ECE 283,A00,103670,Hsueh; Tzu-Chien,0,0,0,0
1668110956271,ECE 284,A00,103671,Turakhia; Yatish Girish,0,0,0,0
1668110956695,ECE 285,A00,103672,Zheng; Yang,0,0,0,0
1668110956695,ECE 285,B00,103673,Sworder; David D.,0,0,0,0
1668110957131,ECE 287,A00,103676,Javidi; Tara,0,0,0,0
1668110957556,MATH 200B,A00,098023,Salehi Golsefidy; Alireza,12,0,15,3
1668110957987,MATH 202B,A00,098024,Rhoades; Brendon Patrick,9,0,15,6
1668110958410,MATH 203B,A00,098025,Oprea; Dragos N.,10,0,15,5
1668110958835,MATH 204B,A00,098026,Sorensen; Claus M,13,0,15,2
1668110959267,MATH 208,A00,098027,Izadi; Elham,7,0,10,3
1668110959782,MATH 209,A00,098028,Pollack; Aaron,10,0,10,0
1668110960204,MATH 211A,A00,112919,Rogalski; Daniel,9,0,10,1
1668110960627,MATH 211B,A00,112920,Seward; Brandon M.,9,0,10,1
1668110961051,MATH 218,A00,098029,Li; Bo,10,0,10,0
1668110961503,MATH 220B,A00,098030,Novak; Jonathan I,11,0,15,4
1668110961951,MATH 221A,A00,098031,Ebenfelt; Peter F,13,0,15,2
1668110962378,MATH 231B,A00,098032,Zlatos; Andrej,12,0,15,3
1668110962812,MATH 240B,A00,098033,Ni; Lei,9,0,15,6
1668110963259,MATH 243,A00,098034,Jekel; David Andrew,10,0,10,0
1668110963683,MATH 245A,A00,098035,Nie; Jiawang,0,0,15,16
1668110964105,MATH 248,A00,098036,Bejenaru; Ioan,10,0,10,0
1668110964535,MATH 250B,A00,098037,Spolaor; Luca,14,0,15,1
1668110964960,MATH 258,A00,098038,Ni; Lei,10,0,10,0
1668110965387,MATH 264B,A00,098041,Rhoades; Brendon Patrick,9,0,15,6
1668110965810,MATH 268,A00,098042,Buss; Samuel R,10,0,10,0
1668110966244,MATH 269,A00,098043,Rhoades; Brendon Patrick,10,0,10,0
1668110966676,MATH 270B,A00,098044,Li; Bo,10,0,15,5
1668110967102,MATH 272B,A00,098045,Holst; Michael J,13,0,15,2
1668110967524,MATH 273A,A00,098046,Tian; Xiaochuan,10,0,15,5
1668110967947,MATH 275,A01,098048,Tian; Xiaochuan,6,0,10,4
1668110968383,MATH 278A,A00,098049,Holst; Michael J,8,0,10,2
1668110968809,MATH 278B,A00,098050,Cloninger; Alexander,10,0,10,0
1668110969233,MATH 278C,A00,098051,Nie; Jiawang,7,0,10,3
1668110969657,MATH 280B,A00,098052,Zheng; Tianyi,10,0,15,5
1668110970079,MATH 281B,A00,098053,Bradic; Jelena,2,0,15,13
1668110970501,MATH 282B,A00,098054,Arias-Castro; Ery,0,0,15,15
1668110970940,MATH 285,A00,098055,Fitzsimmons; Patrick J,0,0,15,17
1668110971373,MATH 287B,A00,098056,Arias-Castro; Ery,3,0,15,12
1668110971798,MATH 288,A00,098057,Agarwal; Pooja,9,0,10,1
1668110971798,MATH 288,B00,098058,Zhang; Danna,8,0,10,2
1668110971798,MATH 288,C00,098059,Williams; Ruth J,10,0,10,0
1668110972224,MATH 290B,A00,098060,Roberts; Justin Deritter,13,0,15,2
1668110972650,MATH 292,A00,098061,Belmont; Eva Kinoshita,10,0,10,0
1668110973075,MATH 295,A00,098062,Suk; Andrew Hoon,48,0,50,2
1668110973500,MATH 296,A00,098063,Novak; Jonathan I,20,0,20,0
1668110973938,MATH 297,001,098064,Gamst; Anthony Collins,9997,0,9999,2
1668111478271,COGS 205,A00,101395,Chiba; Andrea,19,0,20,1
1668111478705,COGS 210B,001,101404,Greene; Deanna Jacquelyn,9998,0,9999,1
1668111478705,COGS 210B,002,101417,Xia; Haijun,9999,0,9999,0
1668111478705,COGS 210B,003,101422,Nitz; Douglas A.,9999,0,9999,0
1668111478705,COGS 210B,004,101423,Hollan; James D.,9998,0,9999,1
1668111478705,COGS 210B,005,101424,Deak; Gedeon O.,9998,0,9999,1
1668111478705,COGS 210B,006,101425,Rossano; Federico,9999,0,9999,0
1668111479130,COGS 211B,A00,101427,Coulson; Seana M,9996,0,9999,3
1668111479560,COGS 220,A00,101428,Hollan; James D.,0,0,25,25
1668111479985,COGS 229,A00,101429,Dow; Steven P,18,0,25,7
1668111480412,COGS 230,A00,101430,Klemmer; Scott R,12,0,17,5
1668111480840,COGS 234,A00,101431,Xia; Haijun,3,0,25,22
1668111481273,COGS 260,A00,101432,Kiyonaga; Anastasia,20,0,25,5
1668111481273,COGS 260,B00,101433,Kirsh; David Joel,16,0,25,9
1668111481699,CSE 202,A00,102371,Impagliazzo; Russell,0,0,0,0
1668111482124,CSE 203B,A01,102373,Cheng; Chung Kuan,0,0,0,0
1668111482548,CSE 208,A00,102374,Micciancio; Daniele,0,0,0,0
1668111482970,CSE 209A,A00,112895,Impagliazzo; Russell,0,0,15,15
1668111483401,CSE 209B,A00,108005,Bellare; Mihir,0,0,0,0
1668111483826,CSE 210,A00,113163,Coblenz; Michael J,0,0,0,0
1668111484358,CSE 219,A00,106111,Dow; Steven P,0,0,20,20
1668111484789,CSE 221,A00,102376,Voelker; Geoffrey M.,0,0,0,0
1668111485213,CSE 224,A01,102378,Porter; George M,0,0,0,0
1668111485641,CSE 229A,A00,102379,Savage; Stefan,0,0,0,0
1668111486063,CSE 229C,A00,102380,Munyaka; Imani N. S.,0,0,0,0
1668111486491,CSE 232B,A00,102382,Deutsch; Alin Bernard,0,0,0,0
1668111486917,CSE 234,A01,112904,Kumar; Arun Kumar,0,0,0,0
1668111487342,CSE 237A,A00,102383,Rosing; Tajana Simunic,0,0,0,0
1668111487768,CSE 239A,A00,102384,Deutsch; Alin Bernard,0,0,0,0
1668111488202,CSE 239B,A00,102385,Polikarpova; Nadezhda,0,0,0,0
1668111488626,CSE 240A,A00,102386,Pannuto; Patrick William,0,0,0,0
1668111489054,CSE 240B,A00,102387,Zhao; Jishen,0,0,0,0
1668111489481,CSE 241A,A00,106406,Kang; Mingu,0,0,0,0
1668111489906,CSE 249B,A00,102388,Kahng; Andrew Byun,0,0,8,8
1668111490328,CSE 251B,A01,102392,Cottrell; Garrison W,0,0,0,0
1668111490328,CSE 251B,A02,102393,Cottrell; Garrison W,0,0,0,0
1668111490755,CSE 252B,A00,102394,Ochoa; Benjamin Lawrence,0,0,0,0
1668111491181,CSE 257,A01,102396,Gao; Sicun,0,0,0,0
1668111491613,CSE 272,A00,102397,Li; Tzumao,0,0,0,0
1668111492035,CSE 274,A00,111323,Chern; Albert Ren-Haur,0,0,0,0
1668111492483,CSE 282,A00,102398,Pevzner; Pavel Arkadjevich,0,0,0,0
1668111492915,CSE 284,A00,114175,Gymrek; Melissa Ann,0,0,0,0
1668111493345,CSE 290,A00,102399,Chandraker; Manmohan Krishna,0,0,0,0
1668111493345,CSE 290,B00,102400,Vaccaro; Kristen Marie,0,0,25,25
1668111493345,CSE 290,C00,102414,Pannuto; Patrick William,0,0,25,25
1668111493345,CSE 290,D00,102427,Pevzner; Pavel Arkadjevich,0,0,0,0
1668111493345,CSE 290,E00,102429,Zhao; Jishen,0,0,0,0
1668111493345,CSE 290,F00,102436,Tullsen; Dean Michael,0,0,0,0
1668111493345,CSE 290,G00,102440,Christensen; Henrik I,0,0,20,20
1668111493772,CSE 291,A00,102443,Su; Hao,0,0,0,0
1668111493772,CSE 291,B00,102448,Polikarpova; Nadezhda,0,0,0,0
1668111493772,CSE 291,C00,102453,Vaccaro; Kristen Marie,0,0,0,0
1668111493772,CSE 291,D00,111343,Savage; Stefan,0,0,0,0
1668111493772,CSE 291,E00,116474,Claffy; Kimberly Claire,0,0,0,0
1668111493772,CSE 291,F00,116479,Pasquale; Joseph,0,0,0,0
1668111494204,CSE 293,001,119111,Bafna; Vineet,9999,0,9999,0
1668111494204,CSE 293,002,119118,Bellare; Mihir,9999,0,9999,0
1668111494204,CSE 293,003,119122,Berg-Kirkpatrick; Taylor D,9999,0,9999,0
1668111494204,CSE 293,004,119135,Christensen; Henrik I,9999,0,9999,0
1668111494204,CSE 293,005,119142,Cottrell; Garrison W,9999,0,9999,0
1668111494204,CSE 293,006,119146,Deutsch; Alin Bernard,9999,0,9999,0
1668111494204,CSE 293,007,119159,Esmaeilzadeh; Hadi,9999,0,9999,0
1668111494204,CSE 293,008,119166,Freund; Yoav,9999,0,9999,0
1668111494204,CSE 293,009,119170,Griswold; William G.,9999,0,9999,0
1668111494204,CSE 293,010,119183,Gymrek; Melissa Ann,9999,0,9999,0
1668111494204,CSE 293,011,119190,Heninger; Nadia A,9999,0,9999,0
1668111494204,CSE 293,012,119230,Impagliazzo; Russell,9999,0,9999,0
1668111494204,CSE 293,013,119232,Jhala; Ranjit,9999,0,9999,0
1668111494204,CSE 293,014,119233,Kahng; Andrew Byun,9999,0,9999,0
1668111494204,CSE 293,015,119298,Kane; Daniel Mertz,9999,0,9999,0
1668111494204,CSE 293,016,119299,Kriegman; David J,9999,0,9999,0
1668111494204,CSE 293,017,119300,Kumar; Arun Kumar,9999,0,9999,0
1668111494204,CSE 293,018,119301,Lerner; Sorin,9999,0,9999,0
1668111494204,CSE 293,019,119302,Lovett; Shachar,9999,0,9999,0
1668111494204,CSE 293,020,119303,McAuley; Julian John,9999,0,9999,0
1668111494204,CSE 293,021,119304,Micciancio; Daniele,9999,0,9999,0
1668111494204,CSE 293,022,119367,Orailoglu; Alex,9999,0,9999,0
1668111494204,CSE 293,023,119382,Paturi; Ramamohan,9999,0,9999,0
1668111494204,CSE 293,024,119404,Polikarpova; Nadezhda,9999,0,9999,0
1668111494204,CSE 293,025,119406,Politz; Joseph Gibbs,9999,0,9999,0
1668111494204,CSE 293,026,119411,Porter; George M,9999,0,9999,0
1668111494204,CSE 293,027,119414,Porter; Leonard Emerson,9999,0,9999,0
1668111494204,CSE 293,028,119416,Ramamoorthi; Ravi,9999,0,9999,0
1668111494204,CSE 293,029,119417,Sahoo; Debashis,9999,0,9999,0
1668111494204,CSE 293,030,119420,Saul; Lawrence,9999,0,9999,0
1668111494204,CSE 293,031,119421,Savage; Stefan,9999,0,9999,0
1668111494204,CSE 293,032,119425,Schulze; Jurgen P.,9999,0,9999,0
1668111494204,CSE 293,033,119426,Snoeren; Alex C.,9999,0,9999,0
1668111494204,CSE 293,034,119428,Shang; Jingbo,9999,0,9999,0
1668111494204,CSE 293,035,119430,Stefan; Deian,9999,0,9999,0
1668111494204,CSE 293,036,119431,Su; Hao,9999,0,9999,0
1668111494204,CSE 293,037,119433,Swanson; Steven James,9999,0,9999,0
1668111494204,CSE 293,038,119435,Tullsen; Dean Michael,9999,0,9999,0
1668111494204,CSE 293,039,119483,Voelker; Geoffrey M.,9999,0,9999,0
1668111494204,CSE 293,040,119537,Zhao; Jishen,9999,0,9999,0
1668111494204,CSE 293,041,119538,Zhou; Yuan-Yuan,9999,0,9999,0
1668111494204,CSE 293,042,119539,Gao; Sicun,9999,0,9999,0
1668111494204,CSE 293,043,119540,Weibel; Nadir,9999,0,9999,0
1668111494204,CSE 293,044,119541,Gupta; Rajesh K.,9999,0,9999,0
1668111494204,CSE 293,045,126410,Vaccaro; Kristen Marie,9999,0,9999,0
1668111494204,CSE 293,046,126411,Klemke; Richard,9999,0,9999,0
1668111494813,CSE 294,A00,102459,Voelker; Geoffrey M.,0,0,0,0
1668111494813,CSE 294,B00,111322,Orailoglu; Alex,0,0,0,0
1668111495239,DSE 201,A00,096914,Deutsch; Alin Bernard,30,0,30,0
1668111495664,DSE 210,A00,096915,Dasgupta; Sanjoy,30,0,30,0
1668111496095,DSE 260A,A00,096916,Altintas De Callaf; Ilkay,30,0,30,0
1668111496547,ECE 200,001,103586,Antipa; Nicholas A,9999,0,9999,0
1668111496547,ECE 200,002,103587,Atanasov; Nikolay A.,9999,0,9999,0
1668111496547,ECE 200,003,103588,Bharadia; Dinesh,9999,0,9999,0
1668111496547,ECE 200,004,103589,Cheng; Chung Kuan,9999,0,9999,0
1668111496547,ECE 200,005,103590,Cosman; Pamela C.,9999,0,9999,0
1668111496547,ECE 200,006,103591,Dayeh; Shadi Ahmad,9999,0,9999,0
1668111496547,ECE 200,007,103592,Fainman; Yeshaiahu,9999,0,9999,0
1668111496547,ECE 200,008,103593,Ford; Joseph Earl,9999,0,9999,0
1668111496547,ECE 200,009,103594,Franceschetti; Massimo,9999,0,9999,0
1668111496547,ECE 200,010,103595,Fullerton; Eric E,9999,0,9999,0
1668111496547,ECE 200,011,103596,Galton; Ian A,9999,0,9999,0
1668111496547,ECE 200,012,103597,Gilja; Vikash,9999,0,9999,0
1668111496547,ECE 200,013,103598,Hall; Drew A.,9999,0,9999,0
1668111496547,ECE 200,014,103599,Hsueh; Tzu-Chien,9999,0,9999,0
1668111496547,ECE 200,015,103600,Javidi; Tara,9999,0,9999,0
1668111496547,ECE 200,016,103601,Kahng; Andrew Byun,9999,0,9999,0
1668111496547,ECE 200,017,103602,Kim; Young-Han,9999,0,9999,0
1668111496547,ECE 200,018,103603,Koushanfar; Farinaz,9999,0,9999,0
1668111496547,ECE 200,019,103604,Kuzum; Duygu,9999,0,9999,0
1668111496547,ECE 200,020,103605,Le; Hanh-Phuc,9999,0,9999,0
1668111496547,ECE 200,021,103606,Lin; Bill,9999,0,9999,0
1668111496547,ECE 200,022,103607,Liu; Zhaowei,9998,0,9999,1
1668111496547,ECE 200,023,103608,Lo; Yu-Hwa,9999,0,9999,0
1668111496547,ECE 200,024,103609,Lomakin; Vitaliy,9999,0,9999,0
1668111496547,ECE 200,025,103610,Mercier; Patrick Philip,9999,0,9999,0
1668111496547,ECE 200,026,103611,Meyer; Florian,9999,0,9999,0
1668111496547,ECE 200,027,103612,Milstein; Laurence B.,9999,0,9999,0
1668111496547,ECE 200,028,103613,Mir Arabbaygi; Siavash,9999,0,9999,0
1668111496547,ECE 200,029,103614,Mookherjea; Shayan,9999,0,9999,0
1668111496547,ECE 200,030,103615,Morris; Karcher William,9999,0,9999,0
1668111496547,ECE 200,031,103616,Ng; Tse Nga,9999,0,9999,0
1668111496547,ECE 200,032,103617,Nguyen; Truong Quang,9999,0,9999,0
1668111496547,ECE 200,033,103618,Nomura; Kenji,9999,0,9999,0
1668111496547,ECE 200,034,103619,Orlitsky; Alon,9999,0,9999,0
1668111496547,ECE 200,035,103620,Pal; Piya,9999,0,9999,0
1668111496547,ECE 200,036,103621,Papen; George C.,9999,0,9999,0
1668111496547,ECE 200,037,103622,Radic; Stojan,9999,0,9999,0
1668111496547,ECE 200,038,103623,Rao; Bhaskar D.,9999,0,9999,0
1668111496547,ECE 200,039,103624,Rao; Ramesh R,9999,0,9999,0
1668111496547,ECE 200,040,103625,Rebeiz; Gabriel,9999,0,9999,0
1668111496547,ECE 200,041,103626,Sanford; John R,9999,0,9999,0
1668111496547,ECE 200,042,103627,Siegel; Paul H.,9999,0,9999,0
1668111496547,ECE 200,043,103628,Sievenpiper; Daniel F.,9999,0,9999,0
1668111496547,ECE 200,044,103629,Sworder; David D.,9999,0,9999,0
1668111496547,ECE 200,045,103630,Taur; Yuan,9999,0,9999,0
1668111496547,ECE 200,046,103631,Touri; Behrouz,9999,0,9999,0
1668111496547,ECE 200,047,103632,Trivedi; Mohan M.,9999,0,9999,0
1668111496547,ECE 200,048,103633,Vasconcelos; Nuno,9999,0,9999,0
1668111496547,ECE 200,049,103634,Wang; Xiaolong,9999,0,9999,0
1668111496547,ECE 200,050,103635,Xie; Pengtao,9999,0,9999,0
1668111496547,ECE 200,051,103636,Yip; Michael,9999,0,9999,0
1668111496547,ECE 200,052,103637,Zeger; Kenneth A.,999,0,999,0
1668111496547,ECE 200,053,103638,Zhang; Xinyu,9999,0,9999,0
1668111496547,ECE 200,054,103639,Turakhia; Yatish Girish,9999,0,9999,0
1668111496547,ECE 200,055,103640,Kang; Mingu,9999,0,9999,0
1668111496547,ECE 200,056,103641,Shi; Yuanyuan,9999,0,9999,0
1668111496547,ECE 200,057,103642,Wang; Edward Jay,9999,0,9999,0
1668111496547,ECE 200,058,103643,Zheng; Yang,9999,0,9999,0
1668111496971,ECE 202,A00,103644,Kuzum; Duygu,0,0,0,0
1668111497438,ECE 212BN,A00,103646,Ng; Tse Nga,0,0,0,0
1668111497861,ECE 221,A00,111493,Staff,0,0,0,0
1668111498291,ECE 222B,A00,103647,Lomakin; Vitaliy,0,0,0,0
1668111498718,ECE 230B,A00,103648,Taur; Yuan,0,0,0,0
1668111499153,ECE 238B,A00,103649,Garay; Javier,0,0,0,0
1668111499590,ECE 240B,A00,112900,Fainman; Yeshaiahu,0,0,0,0
1668111500019,ECE 247A,A00,103650,Jokerst; Jesse Vincent,0,0,0,0
1668111500452,ECE 247B,A00,103651,Wang; Joseph,0,0,0,0
1668111500877,ECE 250,A00,103652,Siegel; Paul H.,0,0,0,0
1668111501303,ECE 251A,A00,103654,Rao; Bhaskar D.,0,0,0,0
1668111501732,ECE 257B,A00,103655,Bharadia; Dinesh,0,0,0,0
1668111502158,ECE 258A,A00,103656,Milstein; Laurence B.,0,0,0,0
1668111502586,ECE 260B,A00,103658,Kang; Mingu,0,0,0,0
1668111503019,ECE 264A,A00,103659,Galton; Ian A,0,0,0,0
1668111503445,ECE 265A,A00,103661,Gudem; Prasad S.S.,0,0,0,0
1668111503880,ECE 265D,A00,103662,Gudem; Prasad S.S.,0,0,0,0
1668111504304,ECE 268,A00,103663,Koushanfar; Farinaz,0,0,0,0
1668111504734,ECE 269,A01,103665,Pal; Piya,0,0,0,0
1668111505164,ECE 271B,A00,103666,Vasconcelos; Manuela,0,0,0,0
1668111505593,ECE 276A,A00,103667,Atanasov; Nikolay A.,0,0,0,0
1668111506026,ECE 277,A00,103668,An; Cheolhong,0,0,0,0
1668111506454,ECE 279,A00,117947,Hall; Drew A.,0,0,0,0
1668111507307,ECE 283,A00,103670,Hsueh; Tzu-Chien,0,0,0,0
1668111507730,ECE 284,A00,103671,Turakhia; Yatish Girish,0,0,0,0
1668111508157,ECE 285,A00,103672,Zheng; Yang,0,0,0,0
1668111508157,ECE 285,B00,103673,Sworder; David D.,0,0,0,0
1668111508585,ECE 287,A00,103676,Javidi; Tara,0,0,0,0
1668111509020,MATH 200B,A00,098023,Salehi Golsefidy; Alireza,12,0,15,3
1668111509445,MATH 202B,A00,098024,Rhoades; Brendon Patrick,9,0,15,6
1668111509867,MATH 203B,A00,098025,Oprea; Dragos N.,10,0,15,5
1668111510291,MATH 204B,A00,098026,Sorensen; Claus M,13,0,15,2
1668111510714,MATH 208,A00,098027,Izadi; Elham,7,0,10,3
1668111511155,MATH 209,A00,098028,Pollack; Aaron,10,0,10,0
1668111511581,MATH 211A,A00,112919,Rogalski; Daniel,9,0,10,1
1668111512014,MATH 211B,A00,112920,Seward; Brandon M.,9,0,10,1
1668111512440,MATH 218,A00,098029,Li; Bo,10,0,10,0
1668111512866,MATH 220B,A00,098030,Novak; Jonathan I,11,0,15,4
1668111513290,MATH 221A,A00,098031,Ebenfelt; Peter F,13,0,15,2
1668111513712,MATH 231B,A00,098032,Zlatos; Andrej,12,0,15,3
1668111514145,MATH 240B,A00,098033,Ni; Lei,9,0,15,6
1668111514569,MATH 243,A00,098034,Jekel; David Andrew,10,0,10,0
1668111514994,MATH 245A,A00,098035,Nie; Jiawang,0,0,15,16
1668111515440,MATH 248,A00,098036,Bejenaru; Ioan,10,0,10,0
1668111515864,MATH 250B,A00,098037,Spolaor; Luca,14,0,15,1
1668111516293,MATH 258,A00,098038,Ni; Lei,10,0,10,0
1668111516725,MATH 264B,A00,098041,Rhoades; Brendon Patrick,9,0,15,6
1668111517150,MATH 268,A00,098042,Buss; Samuel R,10,0,10,0
1668111517573,MATH 269,A00,098043,Rhoades; Brendon Patrick,10,0,10,0
1668111518003,MATH 270B,A00,098044,Li; Bo,10,0,15,5
1668111518430,MATH 272B,A00,098045,Holst; Michael J,13,0,15,2
1668111518869,MATH 273A,A00,098046,Tian; Xiaochuan,10,0,15,5
1668111519315,MATH 275,A01,098048,Tian; Xiaochuan,6,0,10,4
1668111519743,MATH 278A,A00,098049,Holst; Michael J,8,0,10,2
1668111520165,MATH 278B,A00,098050,Cloninger; Alexander,10,0,10,0
1668111520600,MATH 278C,A00,098051,Nie; Jiawang,7,0,10,3
1668111521023,MATH 280B,A00,098052,Zheng; Tianyi,10,0,15,5
1668111521456,MATH 281B,A00,098053,Bradic; Jelena,2,0,15,13
1668111521911,MATH 282B,A00,098054,Arias-Castro; Ery,0,0,15,15
1668111522334,MATH 285,A00,098055,Fitzsimmons; Patrick J,0,0,15,17
1668111522758,MATH 287B,A00,098056,Arias-Castro; Ery,3,0,15,12
1668111523181,MATH 288,A00,098057,Agarwal; Pooja,9,0,10,1
1668111523181,MATH 288,B00,098058,Zhang; Danna,8,0,10,2
1668111523181,MATH 288,C00,098059,Williams; Ruth J,10,0,10,0
1668111523606,MATH 290B,A00,098060,Roberts; Justin Deritter,13,0,15,2
1668111524033,MATH 292,A00,098061,Belmont; Eva Kinoshita,10,0,10,0
1668111524457,MATH 295,A00,098062,Suk; Andrew Hoon,48,0,50,2
1668111524882,MATH 296,A00,098063,Novak; Jonathan I,20,0,20,0
1668111525310,MATH 297,001,098064,Gamst; Anthony Collins,9997,0,9999,2
1668112029073,COGS 205,A00,101395,Chiba; Andrea,19,0,20,1
1668112029498,COGS 210B,001,101404,Greene; Deanna Jacquelyn,9998,0,9999,1
1668112029498,COGS 210B,002,101417,Xia; Haijun,9999,0,9999,0
1668112029498,COGS 210B,003,101422,Nitz; Douglas A.,9999,0,9999,0
1668112029498,COGS 210B,004,101423,Hollan; James D.,9998,0,9999,1
1668112029498,COGS 210B,005,101424,Deak; Gedeon O.,9998,0,9999,1
1668112029498,COGS 210B,006,101425,Rossano; Federico,9999,0,9999,0
1668112029931,COGS 211B,A00,101427,Coulson; Seana M,9996,0,9999,3
1668112030357,COGS 220,A00,101428,Hollan; James D.,0,0,25,25
1668112030786,COGS 229,A00,101429,Dow; Steven P,18,0,25,7
1668112031213,COGS 230,A00,101430,Klemmer; Scott R,12,0,17,5
1668112031637,COGS 234,A00,101431,Xia; Haijun,3,0,25,22
1668112032060,COGS 260,A00,101432,Kiyonaga; Anastasia,20,0,25,5
1668112032060,COGS 260,B00,101433,Kirsh; David Joel,16,0,25,9
1668112032494,CSE 202,A00,102371,Impagliazzo; Russell,0,0,0,0
1668112032922,CSE 203B,A01,102373,Cheng; Chung Kuan,0,0,0,0
1668112033348,CSE 208,A00,102374,Micciancio; Daniele,0,0,0,0
1668112033783,CSE 209A,A00,112895,Impagliazzo; Russell,0,0,15,15
1668112034214,CSE 209B,A00,108005,Bellare; Mihir,0,0,0,0
1668112034646,CSE 210,A00,113163,Coblenz; Michael J,0,0,0,0
1668112035082,CSE 219,A00,106111,Dow; Steven P,0,0,20,20
1668112035514,CSE 221,A00,102376,Voelker; Geoffrey M.,0,0,0,0
1668112035939,CSE 224,A01,102378,Porter; George M,0,0,0,0
1668112036366,CSE 229A,A00,102379,Savage; Stefan,0,0,0,0
1668112036793,CSE 229C,A00,102380,Munyaka; Imani N. S.,0,0,0,0
1668112037239,CSE 232B,A00,102382,Deutsch; Alin Bernard,0,0,0,0
1668112037671,CSE 234,A01,112904,Kumar; Arun Kumar,0,0,0,0
1668112038106,CSE 237A,A00,102383,Rosing; Tajana Simunic,0,0,0,0
1668112038536,CSE 239A,A00,102384,Deutsch; Alin Bernard,0,0,0,0
1668112038960,CSE 239B,A00,102385,Polikarpova; Nadezhda,0,0,0,0
1668112039385,CSE 240A,A00,102386,Pannuto; Patrick William,0,0,0,0
1668112039818,CSE 240B,A00,102387,Zhao; Jishen,0,0,0,0
1668112040248,CSE 241A,A00,106406,Kang; Mingu,0,0,0,0
1668112040671,CSE 249B,A00,102388,Kahng; Andrew Byun,0,0,8,8
1668112041095,CSE 251B,A01,102392,Cottrell; Garrison W,0,0,0,0
1668112041095,CSE 251B,A02,102393,Cottrell; Garrison W,0,0,0,0
1668112041517,CSE 252B,A00,102394,Ochoa; Benjamin Lawrence,0,0,0,0
1668112041943,CSE 257,A01,102396,Gao; Sicun,0,0,0,0
1668112042370,CSE 272,A00,102397,Li; Tzumao,0,0,0,0
1668112042795,CSE 274,A00,111323,Chern; Albert Ren-Haur,0,0,0,0
1668112043217,CSE 282,A00,102398,Pevzner; Pavel Arkadjevich,0,0,0,0
1668112043652,CSE 284,A00,114175,Gymrek; Melissa Ann,0,0,0,0
1668112044081,CSE 290,A00,102399,Chandraker; Manmohan Krishna,0,0,0,0
1668112044081,CSE 290,B00,102400,Vaccaro; Kristen Marie,0,0,25,25
1668112044081,CSE 290,C00,102414,Pannuto; Patrick William,0,0,25,25
1668112044081,CSE 290,D00,102427,Pevzner; Pavel Arkadjevich,0,0,0,0
1668112044081,CSE 290,E00,102429,Zhao; Jishen,0,0,0,0
1668112044081,CSE 290,F00,102436,Tullsen; Dean Michael,0,0,0,0
1668112044081,CSE 290,G00,102440,Christensen; Henrik I,0,0,20,20
1668112044502,CSE 291,A00,102443,Su; Hao,0,0,0,0
1668112044502,CSE 291,B00,102448,Polikarpova; Nadezhda,0,0,0,0
1668112044502,CSE 291,C00,102453,Vaccaro; Kristen Marie,0,0,0,0
1668112044502,CSE 291,D00,111343,Savage; Stefan,0,0,0,0
1668112044502,CSE 291,E00,116474,Claffy; Kimberly Claire,0,0,0,0
1668112044502,CSE 291,F00,116479,Pasquale; Joseph,0,0,0,0
1668112044930,CSE 293,001,119111,Bafna; Vineet,9999,0,9999,0
1668112044930,CSE 293,002,119118,Bellare; Mihir,9999,0,9999,0
1668112044930,CSE 293,003,119122,Berg-Kirkpatrick; Taylor D,9999,0,9999,0
1668112044930,CSE 293,004,119135,Christensen; Henrik I,9999,0,9999,0
1668112044930,CSE 293,005,119142,Cottrell; Garrison W,9999,0,9999,0
1668112044930,CSE 293,006,119146,Deutsch; Alin Bernard,9999,0,9999,0
1668112044930,CSE 293,007,119159,Esmaeilzadeh; Hadi,9999,0,9999,0
1668112044930,CSE 293,008,119166,Freund; Yoav,9999,0,9999,0
1668112044930,CSE 293,009,119170,Griswold; William G.,9999,0,9999,0
1668112044930,CSE 293,010,119183,Gymrek; Melissa Ann,9999,0,9999,0
1668112044930,CSE 293,011,119190,Heninger; Nadia A,9999,0,9999,0
1668112044930,CSE 293,012,119230,Impagliazzo; Russell,9999,0,9999,0
1668112044930,CSE 293,013,119232,Jhala; Ranjit,9999,0,9999,0
1668112044930,CSE 293,014,119233,Kahng; Andrew Byun,9999,0,9999,0
1668112044930,CSE 293,015,119298,Kane; Daniel Mertz,9999,0,9999,0
1668112044930,CSE 293,016,119299,Kriegman; David J,9999,0,9999,0
1668112044930,CSE 293,017,119300,Kumar; Arun Kumar,9999,0,9999,0
1668112044930,CSE 293,018,119301,Lerner; Sorin,9999,0,9999,0
1668112044930,CSE 293,019,119302,Lovett; Shachar,9999,0,9999,0
1668112044930,CSE 293,020,119303,McAuley; Julian John,9999,0,9999,0
1668112044930,CSE 293,021,119304,Micciancio; Daniele,9999,0,9999,0
1668112044930,CSE 293,022,119367,Orailoglu; Alex,9999,0,9999,0
1668112044930,CSE 293,023,119382,Paturi; Ramamohan,9999,0,9999,0
1668112044930,CSE 293,024,119404,Polikarpova; Nadezhda,9999,0,9999,0
1668112044930,CSE 293,025,119406,Politz; Joseph Gibbs,9999,0,9999,0
1668112044930,CSE 293,026,119411,Porter; George M,9999,0,9999,0
1668112044930,CSE 293,027,119414,Porter; Leonard Emerson,9999,0,9999,0
1668112044930,CSE 293,028,119416,Ramamoorthi; Ravi,9999,0,9999,0
1668112044930,CSE 293,029,119417,Sahoo; Debashis,9999,0,9999,0
1668112044930,CSE 293,030,119420,Saul; Lawrence,9999,0,9999,0
1668112044930,CSE 293,031,119421,Savage; Stefan,9999,0,9999,0
1668112044930,CSE 293,032,119425,Schulze; Jurgen P.,9999,0,9999,0
1668112044930,CSE 293,033,119426,Snoeren; Alex C.,9999,0,9999,0
1668112044930,CSE 293,034,119428,Shang; Jingbo,9999,0,9999,0
1668112044930,CSE 293,035,119430,Stefan; Deian,9999,0,9999,0
1668112044930,CSE 293,036,119431,Su; Hao,9999,0,9999,0
1668112044930,CSE 293,037,119433,Swanson; Steven James,9999,0,9999,0
1668112044930,CSE 293,038,119435,Tullsen; Dean Michael,9999,0,9999,0
1668112044930,CSE 293,039,119483,Voelker; Geoffrey M.,9999,0,9999,0
1668112044930,CSE 293,040,119537,Zhao; Jishen,9999,0,9999,0
1668112044930,CSE 293,041,119538,Zhou; Yuan-Yuan,9999,0,9999,0
1668112044930,CSE 293,042,119539,Gao; Sicun,9999,0,9999,0
1668112044930,CSE 293,043,119540,Weibel; Nadir,9999,0,9999,0
1668112044930,CSE 293,044,119541,Gupta; Rajesh K.,9999,0,9999,0
1668112044930,CSE 293,045,126410,Vaccaro; Kristen Marie,9999,0,9999,0
1668112044930,CSE 293,046,126411,Klemke; Richard,9999,0,9999,0
1668112045355,CSE 294,A00,102459,Voelker; Geoffrey M.,0,0,0,0
1668112045355,CSE 294,B00,111322,Orailoglu; Alex,0,0,0,0
1668112045782,DSE 201,A00,096914,Deutsch; Alin Bernard,30,0,30,0
1668112046210,DSE 210,A00,096915,Dasgupta; Sanjoy,30,0,30,0
1668112046643,DSE 260A,A00,096916,Altintas De Callaf; Ilkay,30,0,30,0
1668112047080,ECE 200,001,103586,Antipa; Nicholas A,9999,0,9999,0
1668112047080,ECE 200,002,103587,Atanasov; Nikolay A.,9999,0,9999,0
1668112047080,ECE 200,003,103588,Bharadia; Dinesh,9999,0,9999,0
1668112047080,ECE 200,004,103589,Cheng; Chung Kuan,9999,0,9999,0
1668112047080,ECE 200,005,103590,Cosman; Pamela C.,9999,0,9999,0
1668112047080,ECE 200,006,103591,Dayeh; Shadi Ahmad,9999,0,9999,0
1668112047080,ECE 200,007,103592,Fainman; Yeshaiahu,9999,0,9999,0
1668112047080,ECE 200,008,103593,Ford; Joseph Earl,9999,0,9999,0
1668112047080,ECE 200,009,103594,Franceschetti; Massimo,9999,0,9999,0
1668112047080,ECE 200,010,103595,Fullerton; Eric E,9999,0,9999,0
1668112047080,ECE 200,011,103596,Galton; Ian A,9999,0,9999,0
1668112047080,ECE 200,012,103597,Gilja; Vikash,9999,0,9999,0
1668112047080,ECE 200,013,103598,Hall; Drew A.,9999,0,9999,0
1668112047080,ECE 200,014,103599,Hsueh; Tzu-Chien,9999,0,9999,0
1668112047080,ECE 200,015,103600,Javidi; Tara,9999,0,9999,0
1668112047080,ECE 200,016,103601,Kahng; Andrew Byun,9999,0,9999,0
1668112047080,ECE 200,017,103602,Kim; Young-Han,9999,0,9999,0
1668112047080,ECE 200,018,103603,Koushanfar; Farinaz,9999,0,9999,0
1668112047080,ECE 200,019,103604,Kuzum; Duygu,9999,0,9999,0
1668112047080,ECE 200,020,103605,Le; Hanh-Phuc,9999,0,9999,0
1668112047080,ECE 200,021,103606,Lin; Bill,9999,0,9999,0
1668112047080,ECE 200,022,103607,Liu; Zhaowei,9998,0,9999,1
1668112047080,ECE 200,023,103608,Lo; Yu-Hwa,9999,0,9999,0
1668112047080,ECE 200,024,103609,Lomakin; Vitaliy,9999,0,9999,0
1668112047080,ECE 200,025,103610,Mercier; Patrick Philip,9999,0,9999,0
1668112047080,ECE 200,026,103611,Meyer; Florian,9999,0,9999,0
1668112047080,ECE 200,027,103612,Milstein; Laurence B.,9999,0,9999,0
1668112047080,ECE 200,028,103613,Mir Arabbaygi; Siavash,9999,0,9999,0
1668112047080,ECE 200,029,103614,Mookherjea; Shayan,9999,0,9999,0
1668112047080,ECE 200,030,103615,Morris; Karcher William,9999,0,9999,0
1668112047080,ECE 200,031,103616,Ng; Tse Nga,9999,0,9999,0
1668112047080,ECE 200,032,103617,Nguyen; Truong Quang,9999,0,9999,0
1668112047080,ECE 200,033,103618,Nomura; Kenji,9999,0,9999,0
1668112047080,ECE 200,034,103619,Orlitsky; Alon,9999,0,9999,0
1668112047080,ECE 200,035,103620,Pal; Piya,9999,0,9999,0
1668112047080,ECE 200,036,103621,Papen; George C.,9999,0,9999,0
1668112047080,ECE 200,037,103622,Radic; Stojan,9999,0,9999,0
1668112047080,ECE 200,038,103623,Rao; Bhaskar D.,9999,0,9999,0
1668112047080,ECE 200,039,103624,Rao; Ramesh R,9999,0,9999,0
1668112047080,ECE 200,040,103625,Rebeiz; Gabriel,9999,0,9999,0
1668112047080,ECE 200,041,103626,Sanford; John R,9999,0,9999,0
1668112047080,ECE 200,042,103627,Siegel; Paul H.,9999,0,9999,0
1668112047080,ECE 200,043,103628,Sievenpiper; Daniel F.,9999,0,9999,0
1668112047080,ECE 200,044,103629,Sworder; David D.,9999,0,9999,0
1668112047080,ECE 200,045,103630,Taur; Yuan,9999,0,9999,0
1668112047080,ECE 200,046,103631,Touri; Behrouz,9999,0,9999,0
1668112047080,ECE 200,047,103632,Trivedi; Mohan M.,9999,0,9999,0
1668112047080,ECE 200,048,103633,Vasconcelos; Nuno,9999,0,9999,0
1668112047080,ECE 200,049,103634,Wang; Xiaolong,9999,0,9999,0
1668112047080,ECE 200,050,103635,Xie; Pengtao,9999,0,9999,0
1668112047080,ECE 200,051,103636,Yip; Michael,9999,0,9999,0
1668112047080,ECE 200,052,103637,Zeger; Kenneth A.,999,0,999,0
1668112047080,ECE 200,053,103638,Zhang; Xinyu,9999,0,9999,0
1668112047080,ECE 200,054,103639,Turakhia; Yatish Girish,9999,0,9999,0
1668112047080,ECE 200,055,103640,Kang; Mingu,9999,0,9999,0
1668112047080,ECE 200,056,103641,Shi; Yuanyuan,9999,0,9999,0
1668112047080,ECE 200,057,103642,Wang; Edward Jay,9999,0,9999,0
1668112047080,ECE 200,058,103643,Zheng; Yang,9999,0,9999,0
1668112047518,ECE 202,A00,103644,Kuzum; Duygu,0,0,0,0
1668112047943,ECE 212BN,A00,103646,Ng; Tse Nga,0,0,0,0
1668112048364,ECE 221,A00,111493,Staff,0,0,0,0
1668112048794,ECE 222B,A00,103647,Lomakin; Vitaliy,0,0,0,0
1668112049218,ECE 230B,A00,103648,Taur; Yuan,0,0,0,0
1668112049642,ECE 238B,A00,103649,Garay; Javier,0,0,0,0
1668112050068,ECE 240B,A00,112900,Fainman; Yeshaiahu,0,0,0,0
1668112050497,ECE 247A,A00,103650,Jokerst; Jesse Vincent,0,0,0,0
1668112050939,ECE 247B,A00,103651,Wang; Joseph,0,0,0,0
1668112051368,ECE 250,A00,103652,Siegel; Paul H.,0,0,0,0
1668112051887,ECE 251A,A00,103654,Rao; Bhaskar D.,0,0,0,0
1668112052313,ECE 257B,A00,103655,Bharadia; Dinesh,0,0,0,0
1668112052738,ECE 258A,A00,103656,Milstein; Laurence B.,0,0,0,0
1668112053164,ECE 260B,A00,103658,Kang; Mingu,0,0,0,0
1668112053598,ECE 264A,A00,103659,Galton; Ian A,0,0,0,0
1668112054021,ECE 265A,A00,103661,Gudem; Prasad S.S.,0,0,0,0
1668112054444,ECE 265D,A00,103662,Gudem; Prasad S.S.,0,0,0,0
1668112054878,ECE 268,A00,103663,Koushanfar; Farinaz,0,0,0,0
1668112055310,ECE 269,A01,103665,Pal; Piya,0,0,0,0
1668112055733,ECE 271B,A00,103666,Vasconcelos; Manuela,0,0,0,0
1668112056166,ECE 276A,A00,103667,Atanasov; Nikolay A.,0,0,0,0
1668112056589,ECE 277,A00,103668,An; Cheolhong,0,0,0,0
1668112057022,ECE 279,A00,117947,Hall; Drew A.,0,0,0,0
1668112057889,ECE 283,A00,103670,Hsueh; Tzu-Chien,0,0,0,0
1668112058320,ECE 284,A00,103671,Turakhia; Yatish Girish,0,0,0,0
1668112058743,ECE 285,A00,103672,Zheng; Yang,0,0,0,0
1668112058743,ECE 285,B00,103673,Sworder; David D.,0,0,0,0
1668112059170,ECE 287,A00,103676,Javidi; Tara,0,0,0,0
1668112059601,MATH 200B,A00,098023,Salehi Golsefidy; Alireza,12,0,15,3
1668112060033,MATH 202B,A00,098024,Rhoades; Brendon Patrick,9,0,15,6
1668112060463,MATH 203B,A00,098025,Oprea; Dragos N.,10,0,15,5
1668112060888,MATH 204B,A00,098026,Sorensen; Claus M,13,0,15,2
1668112061314,MATH 208,A00,098027,Izadi; Elham,7,0,10,3
1668112061736,MATH 209,A00,098028,Pollack; Aaron,10,0,10,0
1668112062161,MATH 211A,A00,112919,Rogalski; Daniel,9,0,10,1
1668112062596,MATH 211B,A00,112920,Seward; Brandon M.,9,0,10,1
1668112063019,MATH 218,A00,098029,Li; Bo,10,0,10,0
1668112063443,MATH 220B,A00,098030,Novak; Jonathan I,11,0,15,4
1668112063868,MATH 221A,A00,098031,Ebenfelt; Peter F,13,0,15,2
1668112064298,MATH 231B,A00,098032,Zlatos; Andrej,12,0,15,3
1668112064726,MATH 240B,A00,098033,Ni; Lei,9,0,15,6
1668112065147,MATH 243,A00,098034,Jekel; David Andrew,10,0,10,0
1668112065570,MATH 245A,A00,098035,Nie; Jiawang,0,0,15,16
1668112065991,MATH 248,A00,098036,Bejenaru; Ioan,10,0,10,0
1668112066415,MATH 250B,A00,098037,Spolaor; Luca,14,0,15,1
1668112066846,MATH 258,A00,098038,Ni; Lei,10,0,10,0
1668112067276,MATH 264B,A00,098041,Rhoades; Brendon Patrick,9,0,15,6
1668112067709,MATH 268,A00,098042,Buss; Samuel R,10,0,10,0
1668112068134,MATH 269,A00,098043,Rhoades; Brendon Patrick,10,0,10,0
1668112068559,MATH 270B,A00,098044,Li; Bo,10,0,15,5
1668112068989,MATH 272B,A00,098045,Holst; Michael J,13,0,15,2
1668112069413,MATH 273A,A00,098046,Tian; Xiaochuan,10,0,15,5
1668112069849,MATH 275,A01,098048,Tian; Xiaochuan,6,0,10,4
1668112070271,MATH 278A,A00,098049,Holst; Michael J,8,0,10,2
1668112070710,MATH 278B,A00,098050,Cloninger; Alexander,10,0,10,0
1668112071146,MATH 278C,A00,098051,Nie; Jiawang,7,0,10,3
1668112071571,MATH 280B,A00,098052,Zheng; Tianyi,10,0,15,5
1668112071996,MATH 281B,A00,098053,Bradic; Jelena,2,0,15,13
1668112072422,MATH 282B,A00,098054,Arias-Castro; Ery,0,0,15,15
1668112072845,MATH 285,A00,098055,Fitzsimmons; Patrick J,0,0,15,17
1668112073271,MATH 287B,A00,098056,Arias-Castro; Ery,3,0,15,12
1668112073694,MATH 288,A00,098057,Agarwal; Pooja,9,0,10,1
1668112073694,MATH 288,B00,098058,Zhang; Danna,8,0,10,2
1668112073694,MATH 288,C00,098059,Williams; Ruth J,10,0,10,0
1668112074132,MATH 290B,A00,098060,Roberts; Justin Deritter,13,0,15,2
1668112074566,MATH 292,A00,098061,Belmont; Eva Kinoshita,10,0,10,0
1668112074999,MATH 295,A00,098062,Suk; Andrew Hoon,48,0,50,2
1668112075423,MATH 296,A00,098063,Novak; Jonathan I,20,0,20,0
1668112075859,MATH 297,001,098064,Gamst; Anthony Collins,9997,0,9999,2
1668112591985,COGS 205,A00,101395,Chiba; Andrea,19,0,20,1
1668112592414,COGS 210B,001,101404,Greene; Deanna Jacquelyn,9998,0,9999,1
1668112592414,COGS 210B,002,101417,Xia; Haijun,9999,0,9999,0
1668112592414,COGS 210B,003,101422,Nitz; Douglas A.,9999,0,9999,0
1668112592414,COGS 210B,004,101423,Hollan; James D.,9998,0,9999,1
1668112592414,COGS 210B,005,101424,Deak; Gedeon O.,9998,0,9999,1
1668112592414,COGS 210B,006,101425,Rossano; Federico,9999,0,9999,0
1668112592836,COGS 211B,A00,101427,Coulson; Seana M,9996,0,9999,3
1668112593267,COGS 220,A00,101428,Hollan; James D.,0,0,25,25
1668112593688,COGS 229,A00,101429,Dow; Steven P,18,0,25,7
1668112594112,COGS 230,A00,101430,Klemmer; Scott R,12,0,17,5
1668112594533,COGS 234,A00,101431,Xia; Haijun,3,0,25,22
1668112594956,COGS 260,A00,101432,Kiyonaga; Anastasia,20,0,25,5
1668112594956,COGS 260,B00,101433,Kirsh; David Joel,16,0,25,9
1668112595391,CSE 202,A00,102371,Impagliazzo; Russell,0,0,0,0
1668112595815,CSE 203B,A01,102373,Cheng; Chung Kuan,0,0,0,0
1668112596241,CSE 208,A00,102374,Micciancio; Daniele,0,0,0,0
1668112596672,CSE 209A,A00,112895,Impagliazzo; Russell,0,0,15,15
1668112597108,CSE 209B,A00,108005,Bellare; Mihir,0,0,0,0
1668112597530,CSE 210,A00,113163,Coblenz; Michael J,0,0,0,0
1668112597951,CSE 219,A00,106111,Dow; Steven P,0,0,20,20
1668112598387,CSE 221,A00,102376,Voelker; Geoffrey M.,0,0,0,0
1668112598813,CSE 224,A01,102378,Porter; George M,0,0,0,0
1668112599238,CSE 229A,A00,102379,Savage; Stefan,0,0,0,0
1668112599661,CSE 229C,A00,102380,Munyaka; Imani N. S.,0,0,0,0
1668112600083,CSE 232B,A00,102382,Deutsch; Alin Bernard,0,0,0,0
1668112600522,CSE 234,A01,112904,Kumar; Arun Kumar,0,0,0,0
1668112600954,CSE 237A,A00,102383,Rosing; Tajana Simunic,0,0,0,0
1668112601380,CSE 239A,A00,102384,Deutsch; Alin Bernard,0,0,0,0
1668112601808,CSE 239B,A00,102385,Polikarpova; Nadezhda,0,0,0,0
1668112602233,CSE 240A,A00,102386,Pannuto; Patrick William,0,0,0,0
1668112602658,CSE 240B,A00,102387,Zhao; Jishen,0,0,0,0
1668112603084,CSE 241A,A00,106406,Kang; Mingu,0,0,0,0
1668112603507,CSE 249B,A00,102388,Kahng; Andrew Byun,0,0,8,8
1668112603930,CSE 251B,A01,102392,Cottrell; Garrison W,0,0,0,0
1668112603930,CSE 251B,A02,102393,Cottrell; Garrison W,0,0,0,0
1668112604357,CSE 252B,A00,102394,Ochoa; Benjamin Lawrence,0,0,0,0
1668112604788,CSE 257,A01,102396,Gao; Sicun,0,0,0,0
1668112605221,CSE 272,A00,102397,Li; Tzumao,0,0,0,0
1668112605645,CSE 274,A00,111323,Chern; Albert Ren-Haur,0,0,0,0
1668112606069,CSE 282,A00,102398,Pevzner; Pavel Arkadjevich,0,0,0,0
1668112606572,CSE 284,A00,114175,Gymrek; Melissa Ann,0,0,0,0
1668112606997,CSE 290,A00,102399,Chandraker; Manmohan Krishna,0,0,0,0
1668112606997,CSE 290,B00,102400,Vaccaro; Kristen Marie,0,0,25,25
1668112606997,CSE 290,C00,102414,Pannuto; Patrick William,0,0,25,25
1668112606997,CSE 290,D00,102427,Pevzner; Pavel Arkadjevich,0,0,0,0
1668112606997,CSE 290,E00,102429,Zhao; Jishen,0,0,0,0
1668112606997,CSE 290,F00,102436,Tullsen; Dean Michael,0,0,0,0
1668112606997,CSE 290,G00,102440,Christensen; Henrik I,0,0,20,20
1668112607444,CSE 291,A00,102443,Su; Hao,0,0,0,0
1668112607444,CSE 291,B00,102448,Polikarpova; Nadezhda,0,0,0,0
1668112607444,CSE 291,C00,102453,Vaccaro; Kristen Marie,0,0,0,0
1668112607444,CSE 291,D00,111343,Savage; Stefan,0,0,0,0
1668112607444,CSE 291,E00,116474,Claffy; Kimberly Claire,0,0,0,0
1668112607444,CSE 291,F00,116479,Pasquale; Joseph,0,0,0,0
1668112607881,CSE 293,001,119111,Bafna; Vineet,9999,0,9999,0
1668112607881,CSE 293,002,119118,Bellare; Mihir,9999,0,9999,0
1668112607881,CSE 293,003,119122,Berg-Kirkpatrick; Taylor D,9999,0,9999,0
1668112607881,CSE 293,004,119135,Christensen; Henrik I,9999,0,9999,0
1668112607881,CSE 293,005,119142,Cottrell; Garrison W,9999,0,9999,0
1668112607881,CSE 293,006,119146,Deutsch; Alin Bernard,9999,0,9999,0
1668112607881,CSE 293,007,119159,Esmaeilzadeh; Hadi,9999,0,9999,0
1668112607881,CSE 293,008,119166,Freund; Yoav,9999,0,9999,0
1668112607881,CSE 293,009,119170,Griswold; William G.,9999,0,9999,0
1668112607881,CSE 293,010,119183,Gymrek; Melissa Ann,9999,0,9999,0
1668112607881,CSE 293,011,119190,Heninger; Nadia A,9999,0,9999,0
1668112607881,CSE 293,012,119230,Impagliazzo; Russell,9999,0,9999,0
1668112607881,CSE 293,013,119232,Jhala; Ranjit,9999,0,9999,0
1668112607881,CSE 293,014,119233,Kahng; Andrew Byun,9999,0,9999,0
1668112607881,CSE 293,015,119298,Kane; Daniel Mertz,9999,0,9999,0
1668112607881,CSE 293,016,119299,Kriegman; David J,9999,0,9999,0
1668112607881,CSE 293,017,119300,Kumar; Arun Kumar,9999,0,9999,0
1668112607881,CSE 293,018,119301,Lerner; Sorin,9999,0,9999,0
1668112607881,CSE 293,019,119302,Lovett; Shachar,9999,0,9999,0
1668112607881,CSE 293,020,119303,McAuley; Julian John,9999,0,9999,0
1668112607881,CSE 293,021,119304,Micciancio; Daniele,9999,0,9999,0
1668112607881,CSE 293,022,119367,Orailoglu; Alex,9999,0,9999,0
1668112607881,CSE 293,023,119382,Paturi; Ramamohan,9999,0,9999,0
1668112607881,CSE 293,024,119404,Polikarpova; Nadezhda,9999,0,9999,0
1668112607881,CSE 293,025,119406,Politz; Joseph Gibbs,9999,0,9999,0
1668112607881,CSE 293,026,119411,Porter; George M,9999,0,9999,0
1668112607881,CSE 293,027,119414,Porter; Leonard Emerson,9999,0,9999,0
1668112607881,CSE 293,028,119416,Ramamoorthi; Ravi,9999,0,9999,0
1668112607881,CSE 293,029,119417,Sahoo; Debashis,9999,0,9999,0
1668112607881,CSE 293,030,119420,Saul; Lawrence,9999,0,9999,0
1668112607881,CSE 293,031,119421,Savage; Stefan,9999,0,9999,0
1668112607881,CSE 293,032,119425,Schulze; Jurgen P.,9999,0,9999,0
1668112607881,CSE 293,033,119426,Snoeren; Alex C.,9999,0,9999,0
1668112607881,CSE 293,034,119428,Shang; Jingbo,9999,0,9999,0
1668112607881,CSE 293,035,119430,Stefan; Deian,9999,0,9999,0
1668112607881,CSE 293,036,119431,Su; Hao,9999,0,9999,0
1668112607881,CSE 293,037,119433,Swanson; Steven James,9999,0,9999,0
1668112607881,CSE 293,038,119435,Tullsen; Dean Michael,9999,0,9999,0
1668112607881,CSE 293,039,119483,Voelker; Geoffrey M.,9999,0,9999,0
1668112607881,CSE 293,040,119537,Zhao; Jishen,9999,0,9999,0
1668112607881,CSE 293,041,119538,Zhou; Yuan-Yuan,9999,0,9999,0
1668112607881,CSE 293,042,119539,Gao; Sicun,9999,0,9999,0
1668112607881,CSE 293,043,119540,Weibel; Nadir,9999,0,9999,0
1668112607881,CSE 293,044,119541,Gupta; Rajesh K.,9999,0,9999,0
1668112607881,CSE 293,045,126410,Vaccaro; Kristen Marie,9999,0,9999,0
1668112607881,CSE 293,046,126411,Klemke; Richard,9999,0,9999,0
1668112608310,CSE 294,A00,102459,Voelker; Geoffrey M.,0,0,0,0
1668112608310,CSE 294,B00,111322,Orailoglu; Alex,0,0,0,0
1668112608733,DSE 201,A00,096914,Deutsch; Alin Bernard,30,0,30,0
1668112609155,DSE 210,A00,096915,Dasgupta; Sanjoy,30,0,30,0
1668112609579,DSE 260A,A00,096916,Altintas De Callaf; Ilkay,30,0,30,0
1668112610024,ECE 200,001,103586,Antipa; Nicholas A,9999,0,9999,0
1668112610024,ECE 200,002,103587,Atanasov; Nikolay A.,9999,0,9999,0
1668112610024,ECE 200,003,103588,Bharadia; Dinesh,9999,0,9999,0
1668112610024,ECE 200,004,103589,Cheng; Chung Kuan,9999,0,9999,0
1668112610024,ECE 200,005,103590,Cosman; Pamela C.,9999,0,9999,0
1668112610024,ECE 200,006,103591,Dayeh; Shadi Ahmad,9999,0,9999,0
1668112610024,ECE 200,007,103592,Fainman; Yeshaiahu,9999,0,9999,0
1668112610024,ECE 200,008,103593,Ford; Joseph Earl,9999,0,9999,0
1668112610024,ECE 200,009,103594,Franceschetti; Massimo,9999,0,9999,0
1668112610024,ECE 200,010,103595,Fullerton; Eric E,9999,0,9999,0
1668112610024,ECE 200,011,103596,Galton; Ian A,9999,0,9999,0
1668112610024,ECE 200,012,103597,Gilja; Vikash,9999,0,9999,0
1668112610024,ECE 200,013,103598,Hall; Drew A.,9999,0,9999,0
1668112610024,ECE 200,014,103599,Hsueh; Tzu-Chien,9999,0,9999,0
1668112610024,ECE 200,015,103600,Javidi; Tara,9999,0,9999,0
1668112610024,ECE 200,016,103601,Kahng; Andrew Byun,9999,0,9999,0
1668112610024,ECE 200,017,103602,Kim; Young-Han,9999,0,9999,0
1668112610024,ECE 200,018,103603,Koushanfar; Farinaz,9999,0,9999,0
1668112610024,ECE 200,019,103604,Kuzum; Duygu,9999,0,9999,0
1668112610024,ECE 200,020,103605,Le; Hanh-Phuc,9999,0,9999,0
1668112610024,ECE 200,021,103606,Lin; Bill,9999,0,9999,0
1668112610024,ECE 200,022,103607,Liu; Zhaowei,9998,0,9999,1
1668112610024,ECE 200,023,103608,Lo; Yu-Hwa,9999,0,9999,0
1668112610024,ECE 200,024,103609,Lomakin; Vitaliy,9999,0,9999,0
1668112610024,ECE 200,025,103610,Mercier; Patrick Philip,9999,0,9999,0
1668112610024,ECE 200,026,103611,Meyer; Florian,9999,0,9999,0
1668112610024,ECE 200,027,103612,Milstein; Laurence B.,9999,0,9999,0
1668112610024,ECE 200,028,103613,Mir Arabbaygi; Siavash,9999,0,9999,0
1668112610024,ECE 200,029,103614,Mookherjea; Shayan,9999,0,9999,0
1668112610024,ECE 200,030,103615,Morris; Karcher William,9999,0,9999,0
1668112610024,ECE 200,031,103616,Ng; Tse Nga,9999,0,9999,0
1668112610024,ECE 200,032,103617,Nguyen; Truong Quang,9999,0,9999,0
1668112610024,ECE 200,033,103618,Nomura; Kenji,9999,0,9999,0
1668112610024,ECE 200,034,103619,Orlitsky; Alon,9999,0,9999,0
1668112610024,ECE 200,035,103620,Pal; Piya,9999,0,9999,0
1668112610024,ECE 200,036,103621,Papen; George C.,9999,0,9999,0
1668112610024,ECE 200,037,103622,Radic; Stojan,9999,0,9999,0
1668112610024,ECE 200,038,103623,Rao; Bhaskar D.,9999,0,9999,0
1668112610024,ECE 200,039,103624,Rao; Ramesh R,9999,0,9999,0
1668112610024,ECE 200,040,103625,Rebeiz; Gabriel,9999,0,9999,0
1668112610024,ECE 200,041,103626,Sanford; John R,9999,0,9999,0
1668112610024,ECE 200,042,103627,Siegel; Paul H.,9999,0,9999,0
1668112610024,ECE 200,043,103628,Sievenpiper; Daniel F.,9999,0,9999,0
1668112610024,ECE 200,044,103629,Sworder; David D.,9999,0,9999,0
1668112610024,ECE 200,045,103630,Taur; Yuan,9999,0,9999,0
1668112610024,ECE 200,046,103631,Touri; Behrouz,9999,0,9999,0
1668112610024,ECE 200,047,103632,Trivedi; Mohan M.,9999,0,9999,0
1668112610024,ECE 200,048,103633,Vasconcelos; Nuno,9999,0,9999,0
1668112610024,ECE 200,049,103634,Wang; Xiaolong,9999,0,9999,0
1668112610024,ECE 200,050,103635,Xie; Pengtao,9999,0,9999,0
1668112610024,ECE 200,051,103636,Yip; Michael,9999,0,9999,0
1668112610024,ECE 200,052,103637,Zeger; Kenneth A.,999,0,999,0
1668112610024,ECE 200,053,103638,Zhang; Xinyu,9999,0,9999,0
1668112610024,ECE 200,054,103639,Turakhia; Yatish Girish,9999,0,9999,0
1668112610024,ECE 200,055,103640,Kang; Mingu,9999,0,9999,0
1668112610024,ECE 200,056,103641,Shi; Yuanyuan,9999,0,9999,0
1668112610024,ECE 200,057,103642,Wang; Edward Jay,9999,0,9999,0
1668112610024,ECE 200,058,103643,Zheng; Yang,9999,0,9999,0
1668112610470,ECE 202,A00,103644,Kuzum; Duygu,0,0,0,0
1668112610904,ECE 212BN,A00,103646,Ng; Tse Nga,0,0,0,0
1668112611326,ECE 221,A00,111493,Staff,0,0,0,0
1668112611756,ECE 222B,A00,103647,Lomakin; Vitaliy,0,0,0,0
1668112612184,ECE 230B,A00,103648,Taur; Yuan,0,0,0,0
1668112612611,ECE 238B,A00,103649,Garay; Javier,0,0,0,0
1668112613035,ECE 240B,A00,112900,Fainman; Yeshaiahu,0,0,0,0
1668112613468,ECE 247A,A00,103650,Jokerst; Jesse Vincent,0,0,0,0
1668112613934,ECE 247B,A00,103651,Wang; Joseph,0,0,0,0
1668112614380,ECE 250,A00,103652,Siegel; Paul H.,0,0,0,0
1668112614808,ECE 251A,A00,103654,Rao; Bhaskar D.,0,0,0,0
1668112615230,ECE 257B,A00,103655,Bharadia; Dinesh,0,0,0,0
1668112615655,ECE 258A,A00,103656,Milstein; Laurence B.,0,0,0,0
1668112616089,ECE 260B,A00,103658,Kang; Mingu,0,0,0,0
1668112616517,ECE 264A,A00,103659,Galton; Ian A,0,0,0,0
1668112616940,ECE 265A,A00,103661,Gudem; Prasad S.S.,0,0,0,0
1668112617366,ECE 265D,A00,103662,Gudem; Prasad S.S.,0,0,0,0
1668112617789,ECE 268,A00,103663,Koushanfar; Farinaz,0,0,0,0
1668112618212,ECE 269,A01,103665,Pal; Piya,0,0,0,0
1668112618640,ECE 271B,A00,103666,Vasconcelos; Manuela,0,0,0,0
1668112619063,ECE 276A,A00,103667,Atanasov; Nikolay A.,0,0,0,0
1668112619486,ECE 277,A00,103668,An; Cheolhong,0,0,0,0
1668112619919,ECE 279,A00,117947,Hall; Drew A.,0,0,0,0
1668112620784,ECE 283,A00,103670,Hsueh; Tzu-Chien,0,0,0,0
1668112621210,ECE 284,A00,103671,Turakhia; Yatish Girish,0,0,0,0
1668112621636,ECE 285,A00,103672,Zheng; Yang,0,0,0,0
1668112621636,ECE 285,B00,103673,Sworder; David D.,0,0,0,0
1668112622070,ECE 287,A00,103676,Javidi; Tara,0,0,0,0
1668112622513,MATH 200B,A00,098023,Salehi Golsefidy; Alireza,12,0,15,3
1668112622941,MATH 202B,A00,098024,Rhoades; Brendon Patrick,9,0,15,6
1668112623365,MATH 203B,A00,098025,Oprea; Dragos N.,10,0,15,5
1668112623925,MATH 204B,A00,098026,Sorensen; Claus M,13,0,15,2
1668112624352,MATH 208,A00,098027,Izadi; Elham,7,0,10,3
1668112624789,MATH 209,A00,098028,Pollack; Aaron,10,0,10,0
1668112625225,MATH 211A,A00,112919,Rogalski; Daniel,9,0,10,1
1668112625649,MATH 211B,A00,112920,Seward; Brandon M.,9,0,10,1
1668112626076,MATH 218,A00,098029,Li; Bo,10,0,10,0
1668112626499,MATH 220B,A00,098030,Novak; Jonathan I,11,0,15,4
1668112626929,MATH 221A,A00,098031,Ebenfelt; Peter F,13,0,15,2
1668112627366,MATH 231B,A00,098032,Zlatos; Andrej,12,0,15,3
1668112627796,MATH 240B,A00,098033,Ni; Lei,9,0,15,6
1668112628220,MATH 243,A00,098034,Jekel; David Andrew,10,0,10,0
1668112628642,MATH 245A,A00,098035,Nie; Jiawang,0,0,15,16
1668112629079,MATH 248,A00,098036,Bejenaru; Ioan,10,0,10,0
1668112629501,MATH 250B,A00,098037,Spolaor; Luca,14,0,15,1
1668112629926,MATH 258,A00,098038,Ni; Lei,10,0,10,0
1668112630358,MATH 264B,A00,098041,Rhoades; Brendon Patrick,9,0,15,6
1668112630789,MATH 268,A00,098042,Buss; Samuel R,10,0,10,0
1668112631214,MATH 269,A00,098043,Rhoades; Brendon Patrick,10,0,10,0
1668112631712,MATH 270B,A00,098044,Li; Bo,10,0,15,5
1668112632136,MATH 272B,A00,098045,Holst; Michael J,13,0,15,2
1668112632567,MATH 273A,A00,098046,Tian; Xiaochuan,10,0,15,5
1668112632996,MATH 275,A01,098048,Tian; Xiaochuan,6,0,10,4
1668112633426,MATH 278A,A00,098049,Holst; Michael J,8,0,10,2
1668112633849,MATH 278B,A00,098050,Cloninger; Alexander,10,0,10,0
1668112634293,MATH 278C,A00,098051,Nie; Jiawang,7,0,10,3
1668112634718,MATH 280B,A00,098052,Zheng; Tianyi,10,0,15,5
1668112635147,MATH 281B,A00,098053,Bradic; Jelena,2,0,15,13
1668112635579,MATH 282B,A00,098054,Arias-Castro; Ery,0,0,15,15
1668112636012,MATH 285,A00,098055,Fitzsimmons; Patrick J,0,0,15,17
1668112636446,MATH 287B,A00,098056,Arias-Castro; Ery,3,0,15,12
1668112636879,MATH 288,A00,098057,Agarwal; Pooja,9,0,10,1
1668112636879,MATH 288,B00,098058,Zhang; Danna,8,0,10,2
1668112636879,MATH 288,C00,098059,Williams; Ruth J,10,0,10,0
1668112637310,MATH 290B,A00,098060,Roberts; Justin Deritter,13,0,15,2
1668112637734,MATH 292,A00,098061,Belmont; Eva Kinoshita,10,0,10,0
1668112638158,MATH 295,A00,098062,Suk; Andrew Hoon,48,0,50,2
1668112638586,MATH 296,A00,098063,Novak; Jonathan I,20,0,20,0
1668112639017,MATH 297,001,098064,Gamst; Anthony Collins,9997,0,9999,2
1668113144236,COGS 205,A00,101395,Chiba; Andrea,19,0,20,1
1668113144668,COGS 210B,001,101404,Greene; Deanna Jacquelyn,9998,0,9999,1
1668113144668,COGS 210B,002,101417,Xia; Haijun,9999,0,9999,0
1668113144668,COGS 210B,003,101422,Nitz; Douglas A.,9999,0,9999,0
1668113144668,COGS 210B,004,101423,Hollan; James D.,9998,0,9999,1
1668113144668,COGS 210B,005,101424,Deak; Gedeon O.,9998,0,9999,1
1668113144668,COGS 210B,006,101425,Rossano; Federico,9999,0,9999,0
1668113145093,COGS 211B,A00,101427,Coulson; Seana M,9996,0,9999,3
1668113145516,COGS 220,A00,101428,Hollan; James D.,0,0,25,25
1668113145956,COGS 229,A00,101429,Dow; Steven P,18,0,25,7
1668113146386,COGS 230,A00,101430,Klemmer; Scott R,12,0,17,5
1668113146820,COGS 234,A00,101431,Xia; Haijun,3,0,25,22
1668113147245,COGS 260,A00,101432,Kiyonaga; Anastasia,20,0,25,5
1668113147245,COGS 260,B00,101433,Kirsh; David Joel,16,0,25,9
1668113147673,CSE 202,A00,102371,Impagliazzo; Russell,0,0,0,0
1668113148098,CSE 203B,A01,102373,Cheng; Chung Kuan,0,0,0,0
1668113148537,CSE 208,A00,102374,Micciancio; Daniele,0,0,0,0
1668113148968,CSE 209A,A00,112895,Impagliazzo; Russell,0,0,15,15
1668113149392,CSE 209B,A00,108005,Bellare; Mihir,0,0,0,0
1668113149815,CSE 210,A00,113163,Coblenz; Michael J,0,0,0,0
1668113150248,CSE 219,A00,106111,Dow; Steven P,0,0,20,20
1668113150672,CSE 221,A00,102376,Voelker; Geoffrey M.,0,0,0,0
1668113151094,CSE 224,A01,102378,Porter; George M,0,0,0,0
1668113151532,CSE 229A,A00,102379,Savage; Stefan,0,0,0,0
1668113151966,CSE 229C,A00,102380,Munyaka; Imani N. S.,0,0,0,0
1668113152390,CSE 232B,A00,102382,Deutsch; Alin Bernard,0,0,0,0
1668113152855,CSE 234,A01,112904,Kumar; Arun Kumar,0,0,0,0
1668113153291,CSE 237A,A00,102383,Rosing; Tajana Simunic,0,0,0,0
1668113153717,CSE 239A,A00,102384,Deutsch; Alin Bernard,0,0,0,0
1668113154139,CSE 239B,A00,102385,Polikarpova; Nadezhda,0,0,0,0
1668113154565,CSE 240A,A00,102386,Pannuto; Patrick William,0,0,0,0
1668113154994,CSE 240B,A00,102387,Zhao; Jishen,0,0,0,0
1668113155427,CSE 241A,A00,106406,Kang; Mingu,0,0,0,0
1668113155856,CSE 249B,A00,102388,Kahng; Andrew Byun,0,0,8,8
1668113156284,CSE 251B,A01,102392,Cottrell; Garrison W,0,0,0,0
1668113156284,CSE 251B,A02,102393,Cottrell; Garrison W,0,0,0,0
1668113156708,CSE 252B,A00,102394,Ochoa; Benjamin Lawrence,0,0,0,0
1668113157222,CSE 257,A01,102396,Gao; Sicun,0,0,0,0
1668113157643,CSE 272,A00,102397,Li; Tzumao,0,0,0,0
1668113158067,CSE 274,A00,111323,Chern; Albert Ren-Haur,0,0,0,0
1668113158493,CSE 282,A00,102398,Pevzner; Pavel Arkadjevich,0,0,0,0
1668113158915,CSE 284,A00,114175,Gymrek; Melissa Ann,0,0,0,0
1668113159342,CSE 290,A00,102399,Chandraker; Manmohan Krishna,0,0,0,0
1668113159342,CSE 290,B00,102400,Vaccaro; Kristen Marie,0,0,25,25
1668113159342,CSE 290,C00,102414,Pannuto; Patrick William,0,0,25,25
1668113159342,CSE 290,D00,102427,Pevzner; Pavel Arkadjevich,0,0,0,0
1668113159342,CSE 290,E00,102429,Zhao; Jishen,0,0,0,0
1668113159342,CSE 290,F00,102436,Tullsen; Dean Michael,0,0,0,0
1668113159342,CSE 290,G00,102440,Christensen; Henrik I,0,0,20,20
1668113159772,CSE 291,A00,102443,Su; Hao,0,0,0,0
1668113159772,CSE 291,B00,102448,Polikarpova; Nadezhda,0,0,0,0
1668113159772,CSE 291,C00,102453,Vaccaro; Kristen Marie,0,0,0,0
1668113159772,CSE 291,D00,111343,Savage; Stefan,0,0,0,0
1668113159772,CSE 291,E00,116474,Claffy; Kimberly Claire,0,0,0,0
1668113159772,CSE 291,F00,116479,Pasquale; Joseph,0,0,0,0
1668113160198,CSE 293,001,119111,Bafna; Vineet,9999,0,9999,0
1668113160198,CSE 293,002,119118,Bellare; Mihir,9999,0,9999,0
1668113160198,CSE 293,003,119122,Berg-Kirkpatrick; Taylor D,9999,0,9999,0
1668113160198,CSE 293,004,119135,Christensen; Henrik I,9999,0,9999,0
1668113160198,CSE 293,005,119142,Cottrell; Garrison W,9999,0,9999,0
1668113160198,CSE 293,006,119146,Deutsch; Alin Bernard,9999,0,9999,0
1668113160198,CSE 293,007,119159,Esmaeilzadeh; Hadi,9999,0,9999,0
1668113160198,CSE 293,008,119166,Freund; Yoav,9999,0,9999,0
1668113160198,CSE 293,009,119170,Griswold; William G.,9999,0,9999,0
1668113160198,CSE 293,010,119183,Gymrek; Melissa Ann,9999,0,9999,0
1668113160198,CSE 293,011,119190,Heninger; Nadia A,9999,0,9999,0
1668113160198,CSE 293,012,119230,Impagliazzo; Russell,9999,0,9999,0
1668113160198,CSE 293,013,119232,Jhala; Ranjit,9999,0,9999,0
1668113160198,CSE 293,014,119233,Kahng; Andrew Byun,9999,0,9999,0
1668113160198,CSE 293,015,119298,Kane; Daniel Mertz,9999,0,9999,0
1668113160198,CSE 293,016,119299,Kriegman; David J,9999,0,9999,0
1668113160198,CSE 293,017,119300,Kumar; Arun Kumar,9999,0,9999,0
1668113160198,CSE 293,018,119301,Lerner; Sorin,9999,0,9999,0
1668113160198,CSE 293,019,119302,Lovett; Shachar,9999,0,9999,0
1668113160198,CSE 293,020,119303,McAuley; Julian John,9999,0,9999,0
1668113160198,CSE 293,021,119304,Micciancio; Daniele,9999,0,9999,0
1668113160198,CSE 293,022,119367,Orailoglu; Alex,9999,0,9999,0
1668113160198,CSE 293,023,119382,Paturi; Ramamohan,9999,0,9999,0
1668113160198,CSE 293,024,119404,Polikarpova; Nadezhda,9999,0,9999,0
1668113160198,CSE 293,025,119406,Politz; Joseph Gibbs,9999,0,9999,0
1668113160198,CSE 293,026,119411,Porter; George M,9999,0,9999,0
1668113160198,CSE 293,027,119414,Porter; Leonard Emerson,9999,0,9999,0
1668113160198,CSE 293,028,119416,Ramamoorthi; Ravi,9999,0,9999,0
1668113160198,CSE 293,029,119417,Sahoo; Debashis,9999,0,9999,0
1668113160198,CSE 293,030,119420,Saul; Lawrence,9999,0,9999,0
1668113160198,CSE 293,031,119421,Savage; Stefan,9999,0,9999,0
1668113160198,CSE 293,032,119425,Schulze; Jurgen P.,9999,0,9999,0
1668113160198,CSE 293,033,119426,Snoeren; Alex C.,9999,0,9999,0
1668113160198,CSE 293,034,119428,Shang; Jingbo,9999,0,9999,0
1668113160198,CSE 293,035,119430,Stefan; Deian,9999,0,9999,0
1668113160198,CSE 293,036,119431,Su; Hao,9999,0,9999,0
1668113160198,CSE 293,037,119433,Swanson; Steven James,9999,0,9999,0
1668113160198,CSE 293,038,119435,Tullsen; Dean Michael,9999,0,9999,0
1668113160198,CSE 293,039,119483,Voelker; Geoffrey M.,9999,0,9999,0
1668113160198,CSE 293,040,119537,Zhao; Jishen,9999,0,9999,0
1668113160198,CSE 293,041,119538,Zhou; Yuan-Yuan,9999,0,9999,0
1668113160198,CSE 293,042,119539,Gao; Sicun,9999,0,9999,0
1668113160198,CSE 293,043,119540,Weibel; Nadir,9999,0,9999,0
1668113160198,CSE 293,044,119541,Gupta; Rajesh K.,9999,0,9999,0
1668113160198,CSE 293,045,126410,Vaccaro; Kristen Marie,9999,0,9999,0
1668113160198,CSE 293,046,126411,Klemke; Richard,9999,0,9999,0
1668113160626,CSE 294,A00,102459,Voelker; Geoffrey M.,0,0,0,0
1668113160626,CSE 294,B00,111322,Orailoglu; Alex,0,0,0,0
1668113161062,DSE 201,A00,096914,Deutsch; Alin Bernard,30,0,30,0
1668113161490,DSE 210,A00,096915,Dasgupta; Sanjoy,30,0,30,0
1668113161915,DSE 260A,A00,096916,Altintas De Callaf; Ilkay,30,0,30,0
1668113162366,ECE 200,001,103586,Antipa; Nicholas A,9999,0,9999,0
1668113162366,ECE 200,002,103587,Atanasov; Nikolay A.,9999,0,9999,0
1668113162366,ECE 200,003,103588,Bharadia; Dinesh,9999,0,9999,0
1668113162366,ECE 200,004,103589,Cheng; Chung Kuan,9999,0,9999,0
1668113162366,ECE 200,005,103590,Cosman; Pamela C.,9999,0,9999,0
1668113162366,ECE 200,006,103591,Dayeh; Shadi Ahmad,9999,0,9999,0
1668113162366,ECE 200,007,103592,Fainman; Yeshaiahu,9999,0,9999,0
1668113162366,ECE 200,008,103593,Ford; Joseph Earl,9999,0,9999,0
1668113162366,ECE 200,009,103594,Franceschetti; Massimo,9999,0,9999,0
1668113162366,ECE 200,010,103595,Fullerton; Eric E,9999,0,9999,0
1668113162366,ECE 200,011,103596,Galton; Ian A,9999,0,9999,0
1668113162366,ECE 200,012,103597,Gilja; Vikash,9999,0,9999,0
1668113162366,ECE 200,013,103598,Hall; Drew A.,9999,0,9999,0
1668113162366,ECE 200,014,103599,Hsueh; Tzu-Chien,9999,0,9999,0
1668113162366,ECE 200,015,103600,Javidi; Tara,9999,0,9999,0
1668113162366,ECE 200,016,103601,Kahng; Andrew Byun,9999,0,9999,0
1668113162366,ECE 200,017,103602,Kim; Young-Han,9999,0,9999,0
1668113162366,ECE 200,018,103603,Koushanfar; Farinaz,9999,0,9999,0
1668113162366,ECE 200,019,103604,Kuzum; Duygu,9999,0,9999,0
1668113162366,ECE 200,020,103605,Le; Hanh-Phuc,9999,0,9999,0
1668113162366,ECE 200,021,103606,Lin; Bill,9999,0,9999,0
1668113162366,ECE 200,022,103607,Liu; Zhaowei,9998,0,9999,1
1668113162366,ECE 200,023,103608,Lo; Yu-Hwa,9999,0,9999,0
1668113162366,ECE 200,024,103609,Lomakin; Vitaliy,9999,0,9999,0
1668113162366,ECE 200,025,103610,Mercier; Patrick Philip,9999,0,9999,0
1668113162366,ECE 200,026,103611,Meyer; Florian,9999,0,9999,0
1668113162366,ECE 200,027,103612,Milstein; Laurence B.,9999,0,9999,0
1668113162366,ECE 200,028,103613,Mir Arabbaygi; Siavash,9999,0,9999,0
1668113162366,ECE 200,029,103614,Mookherjea; Shayan,9999,0,9999,0
1668113162366,ECE 200,030,103615,Morris; Karcher William,9999,0,9999,0
1668113162366,ECE 200,031,103616,Ng; Tse Nga,9999,0,9999,0
1668113162366,ECE 200,032,103617,Nguyen; Truong Quang,9999,0,9999,0
1668113162366,ECE 200,033,103618,Nomura; Kenji,9999,0,9999,0
1668113162366,ECE 200,034,103619,Orlitsky; Alon,9999,0,9999,0
1668113162366,ECE 200,035,103620,Pal; Piya,9999,0,9999,0
1668113162366,ECE 200,036,103621,Papen; George C.,9999,0,9999,0
1668113162366,ECE 200,037,103622,Radic; Stojan,9999,0,9999,0
1668113162366,ECE 200,038,103623,Rao; Bhaskar D.,9999,0,9999,0
1668113162366,ECE 200,039,103624,Rao; Ramesh R,9999,0,9999,0
1668113162366,ECE 200,040,103625,Rebeiz; Gabriel,9999,0,9999,0
1668113162366,ECE 200,041,103626,Sanford; John R,9999,0,9999,0
1668113162366,ECE 200,042,103627,Siegel; Paul H.,9999,0,9999,0
1668113162366,ECE 200,043,103628,Sievenpiper; Daniel F.,9999,0,9999,0
1668113162366,ECE 200,044,103629,Sworder; David D.,9999,0,9999,0
1668113162366,ECE 200,045,103630,Taur; Yuan,9999,0,9999,0
1668113162366,ECE 200,046,103631,Touri; Behrouz,9999,0,9999,0
1668113162366,ECE 200,047,103632,Trivedi; Mohan M.,9999,0,9999,0
1668113162366,ECE 200,048,103633,Vasconcelos; Nuno,9999,0,9999,0
1668113162366,ECE 200,049,103634,Wang; Xiaolong,9999,0,9999,0
1668113162366,ECE 200,050,103635,Xie; Pengtao,9999,0,9999,0
1668113162366,ECE 200,051,103636,Yip; Michael,9999,0,9999,0
1668113162366,ECE 200,052,103637,Zeger; Kenneth A.,999,0,999,0
1668113162366,ECE 200,053,103638,Zhang; Xinyu,9999,0,9999,0
1668113162366,ECE 200,054,103639,Turakhia; Yatish Girish,9999,0,9999,0
1668113162366,ECE 200,055,103640,Kang; Mingu,9999,0,9999,0
1668113162366,ECE 200,056,103641,Shi; Yuanyuan,9999,0,9999,0
1668113162366,ECE 200,057,103642,Wang; Edward Jay,9999,0,9999,0
1668113162366,ECE 200,058,103643,Zheng; Yang,9999,0,9999,0
1668113162795,ECE 202,A00,103644,Kuzum; Duygu,0,0,0,0
1668113163217,ECE 212BN,A00,103646,Ng; Tse Nga,0,0,0,0
1668113163646,ECE 221,A00,111493,Staff,0,0,0,0
1668113164082,ECE 222B,A00,103647,Lomakin; Vitaliy,0,0,0,0
1668113164509,ECE 230B,A00,103648,Taur; Yuan,0,0,0,0
1668113164932,ECE 238B,A00,103649,Garay; Javier,0,0,0,0
1668113165354,ECE 240B,A00,112900,Fainman; Yeshaiahu,0,0,0,0
1668113165778,ECE 247A,A00,103650,Jokerst; Jesse Vincent,0,0,0,0
1668113166202,ECE 247B,A00,103651,Wang; Joseph,0,0,0,0
1668113166643,ECE 250,A00,103652,Siegel; Paul H.,0,0,0,0
1668113167065,ECE 251A,A00,103654,Rao; Bhaskar D.,0,0,0,0
1668113167489,ECE 257B,A00,103655,Bharadia; Dinesh,0,0,0,0
1668113167920,ECE 258A,A00,103656,Milstein; Laurence B.,0,0,0,0
1668113168351,ECE 260B,A00,103658,Kang; Mingu,0,0,0,0
1668113168779,ECE 264A,A00,103659,Galton; Ian A,0,0,0,0
1668113169206,ECE 265A,A00,103661,Gudem; Prasad S.S.,0,0,0,0
1668113169637,ECE 265D,A00,103662,Gudem; Prasad S.S.,0,0,0,0
1668113170073,ECE 268,A00,103663,Koushanfar; Farinaz,0,0,0,0
1668113170500,ECE 269,A01,103665,Pal; Piya,0,0,0,0
1668113170937,ECE 271B,A00,103666,Vasconcelos; Manuela,0,0,0,0
1668113171362,ECE 276A,A00,103667,Atanasov; Nikolay A.,0,0,0,0
1668113171801,ECE 277,A00,103668,An; Cheolhong,0,0,0,0
1668113172223,ECE 279,A00,117947,Hall; Drew A.,0,0,0,0
1668113173085,ECE 283,A00,103670,Hsueh; Tzu-Chien,0,0,0,0
1668113173513,ECE 284,A00,103671,Turakhia; Yatish Girish,0,0,0,0
1668113173937,ECE 285,A00,103672,Zheng; Yang,0,0,0,0
1668113173937,ECE 285,B00,103673,Sworder; David D.,0,0,0,0
1668113174363,ECE 287,A00,103676,Javidi; Tara,0,0,0,0
1668113174798,MATH 200B,A00,098023,Salehi Golsefidy; Alireza,12,0,15,3
1668113175223,MATH 202B,A00,098024,Rhoades; Brendon Patrick,9,0,15,6
1668113175650,MATH 203B,A00,098025,Oprea; Dragos N.,10,0,15,5
1668113176077,MATH 204B,A00,098026,Sorensen; Claus M,13,0,15,2
1668113176503,MATH 208,A00,098027,Izadi; Elham,7,0,10,3
1668113176930,MATH 209,A00,098028,Pollack; Aaron,10,0,10,0
1668113177366,MATH 211A,A00,112919,Rogalski; Daniel,9,0,10,1
1668113177806,MATH 211B,A00,112920,Seward; Brandon M.,9,0,10,1
1668113178227,MATH 218,A00,098029,Li; Bo,10,0,10,0
1668113178655,MATH 220B,A00,098030,Novak; Jonathan I,11,0,15,4
1668113179079,MATH 221A,A00,098031,Ebenfelt; Peter F,13,0,15,2
1668113179509,MATH 231B,A00,098032,Zlatos; Andrej,12,0,15,3
1668113179942,MATH 240B,A00,098033,Ni; Lei,9,0,15,6
1668113180370,MATH 243,A00,098034,Jekel; David Andrew,10,0,10,0
1668113180806,MATH 245A,A00,098035,Nie; Jiawang,0,0,15,16
1668113181229,MATH 248,A00,098036,Bejenaru; Ioan,10,0,10,0
1668113181652,MATH 250B,A00,098037,Spolaor; Luca,14,0,15,1
1668113182090,MATH 258,A00,098038,Ni; Lei,10,0,10,0
1668113182514,MATH 264B,A00,098041,Rhoades; Brendon Patrick,9,0,15,6
1668113182948,MATH 268,A00,098042,Buss; Samuel R,10,0,10,0
1668113183372,MATH 269,A00,098043,Rhoades; Brendon Patrick,10,0,10,0
1668113183793,MATH 270B,A00,098044,Li; Bo,10,0,15,5
1668113184231,MATH 272B,A00,098045,Holst; Michael J,13,0,15,2
1668113184656,MATH 273A,A00,098046,Tian; Xiaochuan,10,0,15,5
1668113185080,MATH 275,A01,098048,Tian; Xiaochuan,6,0,10,4
1668113185511,MATH 278A,A00,098049,Holst; Michael J,8,0,10,2
1668113185950,MATH 278B,A00,098050,Cloninger; Alexander,10,0,10,0
1668113186371,MATH 278C,A00,098051,Nie; Jiawang,7,0,10,3
1668113186796,MATH 280B,A00,098052,Zheng; Tianyi,10,0,15,5
1668113187223,MATH 281B,A00,098053,Bradic; Jelena,2,0,15,13
1668113187653,MATH 282B,A00,098054,Arias-Castro; Ery,0,0,15,15
1668113188088,MATH 285,A00,098055,Fitzsimmons; Patrick J,0,0,15,17
1668113188526,MATH 287B,A00,098056,Arias-Castro; Ery,3,0,15,12
1668113188952,MATH 288,A00,098057,Agarwal; Pooja,9,0,10,1
1668113188952,MATH 288,B00,098058,Zhang; Danna,8,0,10,2
1668113188952,MATH 288,C00,098059,Williams; Ruth J,10,0,10,0
1668113189390,MATH 290B,A00,098060,Roberts; Justin Deritter,13,0,15,2
1668113189825,MATH 292,A00,098061,Belmont; Eva Kinoshita,10,0,10,0
1668113190247,MATH 295,A00,098062,Suk; Andrew Hoon,48,0,50,2
1668113190675,MATH 296,A00,098063,Novak; Jonathan I,20,0,20,0
1668113191099,MATH 297,001,098064,Gamst; Anthony Collins,9997,0,9999,2
1668113695673,COGS 205,A00,101395,Chiba; Andrea,19,0,20,1
1668113696104,COGS 210B,001,101404,Greene; Deanna Jacquelyn,9998,0,9999,1
1668113696104,COGS 210B,002,101417,Xia; Haijun,9999,0,9999,0
1668113696104,COGS 210B,003,101422,Nitz; Douglas A.,9999,0,9999,0
1668113696104,COGS 210B,004,101423,Hollan; James D.,9998,0,9999,1
1668113696104,COGS 210B,005,101424,Deak; Gedeon O.,9998,0,9999,1
1668113696104,COGS 210B,006,101425,Rossano; Federico,9999,0,9999,0
1668113696529,COGS 211B,A00,101427,Coulson; Seana M,9996,0,9999,3
1668113696953,COGS 220,A00,101428,Hollan; James D.,0,0,25,25
1668113697386,COGS 229,A00,101429,Dow; Steven P,18,0,25,7
1668113697827,COGS 230,A00,101430,Klemmer; Scott R,12,0,17,5
1668113698280,COGS 234,A00,101431,Xia; Haijun,3,0,25,22
1668113698720,COGS 260,A00,101432,Kiyonaga; Anastasia,20,0,25,5
1668113698720,COGS 260,B00,101433,Kirsh; David Joel,16,0,25,9
1668113699147,CSE 202,A00,102371,Impagliazzo; Russell,0,0,0,0
1668113699580,CSE 203B,A01,102373,Cheng; Chung Kuan,0,0,0,0
1668113700019,CSE 208,A00,102374,Micciancio; Daniele,0,0,0,0
1668113700452,CSE 209A,A00,112895,Impagliazzo; Russell,0,0,15,15
1668113700882,CSE 209B,A00,108005,Bellare; Mihir,0,0,0,0
1668113701309,CSE 210,A00,113163,Coblenz; Michael J,0,0,0,0
1668113701746,CSE 219,A00,106111,Dow; Steven P,0,0,20,20
1668113702171,CSE 221,A00,102376,Voelker; Geoffrey M.,0,0,0,0
1668113702599,CSE 224,A01,102378,Porter; George M,0,0,0,0
1668113703023,CSE 229A,A00,102379,Savage; Stefan,0,0,0,0
1668113703449,CSE 229C,A00,102380,Munyaka; Imani N. S.,0,0,0,0
1668113703883,CSE 232B,A00,102382,Deutsch; Alin Bernard,0,0,0,0
1668113704305,CSE 234,A01,112904,Kumar; Arun Kumar,0,0,0,0
1668113704733,CSE 237A,A00,102383,Rosing; Tajana Simunic,0,0,0,0
1668113705157,CSE 239A,A00,102384,Deutsch; Alin Bernard,0,0,0,0
1668113705588,CSE 239B,A00,102385,Polikarpova; Nadezhda,0,0,0,0
1668113706012,CSE 240A,A00,102386,Pannuto; Patrick William,0,0,0,0
1668113706436,CSE 240B,A00,102387,Zhao; Jishen,0,0,0,0
1668113706862,CSE 241A,A00,106406,Kang; Mingu,0,0,0,0
1668113707292,CSE 249B,A00,102388,Kahng; Andrew Byun,0,0,8,8
1668113707721,CSE 251B,A01,102392,Cottrell; Garrison W,0,0,0,0
1668113707721,CSE 251B,A02,102393,Cottrell; Garrison W,0,0,0,0
1668113708158,CSE 252B,A00,102394,Ochoa; Benjamin Lawrence,0,0,0,0
1668113708589,CSE 257,A01,102396,Gao; Sicun,0,0,0,0
1668113709021,CSE 272,A00,102397,Li; Tzumao,0,0,0,0
1668113709455,CSE 274,A00,111323,Chern; Albert Ren-Haur,0,0,0,0
1668113709878,CSE 282,A00,102398,Pevzner; Pavel Arkadjevich,0,0,0,0
1668113710307,CSE 284,A00,114175,Gymrek; Melissa Ann,0,0,0,0
1668113710737,CSE 290,A00,102399,Chandraker; Manmohan Krishna,0,0,0,0
1668113710737,CSE 290,B00,102400,Vaccaro; Kristen Marie,0,0,25,25
1668113710737,CSE 290,C00,102414,Pannuto; Patrick William,0,0,25,25
1668113710737,CSE 290,D00,102427,Pevzner; Pavel Arkadjevich,0,0,0,0
1668113710737,CSE 290,E00,102429,Zhao; Jishen,0,0,0,0
1668113710737,CSE 290,F00,102436,Tullsen; Dean Michael,0,0,0,0
1668113710737,CSE 290,G00,102440,Christensen; Henrik I,0,0,20,20
1668113711183,CSE 291,A00,102443,Su; Hao,0,0,0,0
1668113711183,CSE 291,B00,102448,Polikarpova; Nadezhda,0,0,0,0
1668113711183,CSE 291,C00,102453,Vaccaro; Kristen Marie,0,0,0,0
1668113711183,CSE 291,D00,111343,Savage; Stefan,0,0,0,0
1668113711183,CSE 291,E00,116474,Claffy; Kimberly Claire,0,0,0,0
1668113711183,CSE 291,F00,116479,Pasquale; Joseph,0,0,0,0
1668113711610,CSE 293,001,119111,Bafna; Vineet,9999,0,9999,0
1668113711610,CSE 293,002,119118,Bellare; Mihir,9999,0,9999,0
1668113711610,CSE 293,003,119122,Berg-Kirkpatrick; Taylor D,9999,0,9999,0
1668113711610,CSE 293,004,119135,Christensen; Henrik I,9999,0,9999,0
1668113711610,CSE 293,005,119142,Cottrell; Garrison W,9999,0,9999,0
1668113711610,CSE 293,006,119146,Deutsch; Alin Bernard,9999,0,9999,0
1668113711610,CSE 293,007,119159,Esmaeilzadeh; Hadi,9999,0,9999,0
1668113711610,CSE 293,008,119166,Freund; Yoav,9999,0,9999,0
1668113711610,CSE 293,009,119170,Griswold; William G.,9999,0,9999,0
1668113711610,CSE 293,010,119183,Gymrek; Melissa Ann,9999,0,9999,0
1668113711610,CSE 293,011,119190,Heninger; Nadia A,9999,0,9999,0
1668113711610,CSE 293,012,119230,Impagliazzo; Russell,9999,0,9999,0
1668113711610,CSE 293,013,119232,Jhala; Ranjit,9999,0,9999,0
1668113711610,CSE 293,014,119233,Kahng; Andrew Byun,9999,0,9999,0
1668113711610,CSE 293,015,119298,Kane; Daniel Mertz,9999,0,9999,0
1668113711610,CSE 293,016,119299,Kriegman; David J,9999,0,9999,0
1668113711610,CSE 293,017,119300,Kumar; Arun Kumar,9999,0,9999,0
1668113711610,CSE 293,018,119301,Lerner; Sorin,9999,0,9999,0
1668113711610,CSE 293,019,119302,Lovett; Shachar,9999,0,9999,0
1668113711610,CSE 293,020,119303,McAuley; Julian John,9999,0,9999,0
1668113711610,CSE 293,021,119304,Micciancio; Daniele,9999,0,9999,0
1668113711610,CSE 293,022,119367,Orailoglu; Alex,9999,0,9999,0
1668113711610,CSE 293,023,119382,Paturi; Ramamohan,9999,0,9999,0
1668113711610,CSE 293,024,119404,Polikarpova; Nadezhda,9999,0,9999,0
1668113711610,CSE 293,025,119406,Politz; Joseph Gibbs,9999,0,9999,0
1668113711610,CSE 293,026,119411,Porter; George M,9999,0,9999,0
1668113711610,CSE 293,027,119414,Porter; Leonard Emerson,9999,0,9999,0
1668113711610,CSE 293,028,119416,Ramamoorthi; Ravi,9999,0,9999,0
1668113711610,CSE 293,029,119417,Sahoo; Debashis,9999,0,9999,0
1668113711610,CSE 293,030,119420,Saul; Lawrence,9999,0,9999,0
1668113711610,CSE 293,031,119421,Savage; Stefan,9999,0,9999,0
1668113711610,CSE 293,032,119425,Schulze; Jurgen P.,9999,0,9999,0
1668113711610,CSE 293,033,119426,Snoeren; Alex C.,9999,0,9999,0
1668113711610,CSE 293,034,119428,Shang; Jingbo,9999,0,9999,0
1668113711610,CSE 293,035,119430,Stefan; Deian,9999,0,9999,0
1668113711610,CSE 293,036,119431,Su; Hao,9999,0,9999,0
1668113711610,CSE 293,037,119433,Swanson; Steven James,9999,0,9999,0
1668113711610,CSE 293,038,119435,Tullsen; Dean Michael,9999,0,9999,0
1668113711610,CSE 293,039,119483,Voelker; Geoffrey M.,9999,0,9999,0
1668113711610,CSE 293,040,119537,Zhao; Jishen,9999,0,9999,0
1668113711610,CSE 293,041,119538,Zhou; Yuan-Yuan,9999,0,9999,0
1668113711610,CSE 293,042,119539,Gao; Sicun,9999,0,9999,0
1668113711610,CSE 293,043,119540,Weibel; Nadir,9999,0,9999,0
1668113711610,CSE 293,044,119541,Gupta; Rajesh K.,9999,0,9999,0
1668113711610,CSE 293,045,126410,Vaccaro; Kristen Marie,9999,0,9999,0
1668113711610,CSE 293,046,126411,Klemke; Richard,9999,0,9999,0
1668113712035,CSE 294,A00,102459,Voelker; Geoffrey M.,0,0,0,0
1668113712035,CSE 294,B00,111322,Orailoglu; Alex,0,0,0,0
1668113712458,DSE 201,A00,096914,Deutsch; Alin Bernard,30,0,30,0
1668113712885,DSE 210,A00,096915,Dasgupta; Sanjoy,30,0,30,0
1668113713310,DSE 260A,A00,096916,Altintas De Callaf; Ilkay,30,0,30,0
1668113713747,ECE 200,001,103586,Antipa; Nicholas A,9999,0,9999,0
1668113713747,ECE 200,002,103587,Atanasov; Nikolay A.,9999,0,9999,0
1668113713747,ECE 200,003,103588,Bharadia; Dinesh,9999,0,9999,0
1668113713747,ECE 200,004,103589,Cheng; Chung Kuan,9999,0,9999,0
1668113713747,ECE 200,005,103590,Cosman; Pamela C.,9999,0,9999,0
1668113713747,ECE 200,006,103591,Dayeh; Shadi Ahmad,9999,0,9999,0
1668113713747,ECE 200,007,103592,Fainman; Yeshaiahu,9999,0,9999,0
1668113713747,ECE 200,008,103593,Ford; Joseph Earl,9999,0,9999,0
1668113713747,ECE 200,009,103594,Franceschetti; Massimo,9999,0,9999,0
1668113713747,ECE 200,010,103595,Fullerton; Eric E,9999,0,9999,0
1668113713747,ECE 200,011,103596,Galton; Ian A,9999,0,9999,0
1668113713747,ECE 200,012,103597,Gilja; Vikash,9999,0,9999,0
1668113713747,ECE 200,013,103598,Hall; Drew A.,9999,0,9999,0
1668113713747,ECE 200,014,103599,Hsueh; Tzu-Chien,9999,0,9999,0
1668113713747,ECE 200,015,103600,Javidi; Tara,9999,0,9999,0
1668113713747,ECE 200,016,103601,Kahng; Andrew Byun,9999,0,9999,0
1668113713747,ECE 200,017,103602,Kim; Young-Han,9999,0,9999,0
1668113713747,ECE 200,018,103603,Koushanfar; Farinaz,9999,0,9999,0
1668113713747,ECE 200,019,103604,Kuzum; Duygu,9999,0,9999,0
1668113713747,ECE 200,020,103605,Le; Hanh-Phuc,9999,0,9999,0
1668113713747,ECE 200,021,103606,Lin; Bill,9999,0,9999,0
1668113713747,ECE 200,022,103607,Liu; Zhaowei,9998,0,9999,1
1668113713747,ECE 200,023,103608,Lo; Yu-Hwa,9999,0,9999,0
1668113713747,ECE 200,024,103609,Lomakin; Vitaliy,9999,0,9999,0
1668113713747,ECE 200,025,103610,Mercier; Patrick Philip,9999,0,9999,0
1668113713747,ECE 200,026,103611,Meyer; Florian,9999,0,9999,0
1668113713747,ECE 200,027,103612,Milstein; Laurence B.,9999,0,9999,0
1668113713747,ECE 200,028,103613,Mir Arabbaygi; Siavash,9999,0,9999,0
1668113713747,ECE 200,029,103614,Mookherjea; Shayan,9999,0,9999,0
1668113713747,ECE 200,030,103615,Morris; Karcher William,9999,0,9999,0
1668113713747,ECE 200,031,103616,Ng; Tse Nga,9999,0,9999,0
1668113713747,ECE 200,032,103617,Nguyen; Truong Quang,9999,0,9999,0
1668113713747,ECE 200,033,103618,Nomura; Kenji,9999,0,9999,0
1668113713747,ECE 200,034,103619,Orlitsky; Alon,9999,0,9999,0
1668113713747,ECE 200,035,103620,Pal; Piya,9999,0,9999,0
1668113713747,ECE 200,036,103621,Papen; George C.,9999,0,9999,0
1668113713747,ECE 200,037,103622,Radic; Stojan,9999,0,9999,0
1668113713747,ECE 200,038,103623,Rao; Bhaskar D.,9999,0,9999,0
1668113713747,ECE 200,039,103624,Rao; Ramesh R,9999,0,9999,0
1668113713747,ECE 200,040,103625,Rebeiz; Gabriel,9999,0,9999,0
1668113713747,ECE 200,041,103626,Sanford; John R,9999,0,9999,0
1668113713747,ECE 200,042,103627,Siegel; Paul H.,9999,0,9999,0
1668113713747,ECE 200,043,103628,Sievenpiper; Daniel F.,9999,0,9999,0
1668113713747,ECE 200,044,103629,Sworder; David D.,9999,0,9999,0
1668113713747,ECE 200,045,103630,Taur; Yuan,9999,0,9999,0
1668113713747,ECE 200,046,103631,Touri; Behrouz,9999,0,9999,0
1668113713747,ECE 200,047,103632,Trivedi; Mohan M.,9999,0,9999,0
1668113713747,ECE 200,048,103633,Vasconcelos; Nuno,9999,0,9999,0
1668113713747,ECE 200,049,103634,Wang; Xiaolong,9999,0,9999,0
1668113713747,ECE 200,050,103635,Xie; Pengtao,9999,0,9999,0
1668113713747,ECE 200,051,103636,Yip; Michael,9999,0,9999,0
1668113713747,ECE 200,052,103637,Zeger; Kenneth A.,999,0,999,0
1668113713747,ECE 200,053,103638,Zhang; Xinyu,9999,0,9999,0
1668113713747,ECE 200,054,103639,Turakhia; Yatish Girish,9999,0,9999,0
1668113713747,ECE 200,055,103640,Kang; Mingu,9999,0,9999,0
1668113713747,ECE 200,056,103641,Shi; Yuanyuan,9999,0,9999,0
1668113713747,ECE 200,057,103642,Wang; Edward Jay,9999,0,9999,0
1668113713747,ECE 200,058,103643,Zheng; Yang,9999,0,9999,0
1668113714185,ECE 202,A00,103644,Kuzum; Duygu,0,0,0,0
1668113714610,ECE 212BN,A00,103646,Ng; Tse Nga,0,0,0,0
1668113715039,ECE 221,A00,111493,Staff,0,0,0,0
1668113715462,ECE 222B,A00,103647,Lomakin; Vitaliy,0,0,0,0
1668113715886,ECE 230B,A00,103648,Taur; Yuan,0,0,0,0
1668113716314,ECE 238B,A00,103649,Garay; Javier,0,0,0,0
1668113716742,ECE 240B,A00,112900,Fainman; Yeshaiahu,0,0,0,0
1668113717172,ECE 247A,A00,103650,Jokerst; Jesse Vincent,0,0,0,0
1668113717601,ECE 247B,A00,103651,Wang; Joseph,0,0,0,0
1668113718028,ECE 250,A00,103652,Siegel; Paul H.,0,0,0,0
1668113718459,ECE 251A,A00,103654,Rao; Bhaskar D.,0,0,0,0
1668113718883,ECE 257B,A00,103655,Bharadia; Dinesh,0,0,0,0
1668113719313,ECE 258A,A00,103656,Milstein; Laurence B.,0,0,0,0
1668113719738,ECE 260B,A00,103658,Kang; Mingu,0,0,0,0
1668113720172,ECE 264A,A00,103659,Galton; Ian A,0,0,0,0
1668113720599,ECE 265A,A00,103661,Gudem; Prasad S.S.,0,0,0,0
1668113721028,ECE 265D,A00,103662,Gudem; Prasad S.S.,0,0,0,0
1668113721461,ECE 268,A00,103663,Koushanfar; Farinaz,0,0,0,0
1668113721886,ECE 269,A01,103665,Pal; Piya,0,0,0,0
1668113722314,ECE 271B,A00,103666,Vasconcelos; Manuela,0,0,0,0
1668113722741,ECE 276A,A00,103667,Atanasov; Nikolay A.,0,0,0,0
1668113723167,ECE 277,A00,103668,An; Cheolhong,0,0,0,0
1668113723592,ECE 279,A00,117947,Hall; Drew A.,0,0,0,0
1668113724458,ECE 283,A00,103670,Hsueh; Tzu-Chien,0,0,0,0
1668113724885,ECE 284,A00,103671,Turakhia; Yatish Girish,0,0,0,0
1668113725448,ECE 285,A00,103672,Zheng; Yang,0,0,0,0
1668113725448,ECE 285,B00,103673,Sworder; David D.,0,0,0,0
1668113725882,ECE 287,A00,103676,Javidi; Tara,0,0,0,0
1668113726305,MATH 200B,A00,098023,Salehi Golsefidy; Alireza,12,0,15,3
1668113726730,MATH 202B,A00,098024,Rhoades; Brendon Patrick,9,0,15,6
1668113727170,MATH 203B,A00,098025,Oprea; Dragos N.,10,0,15,5
1668113727609,MATH 204B,A00,098026,Sorensen; Claus M,13,0,15,2
1668113728051,MATH 208,A00,098027,Izadi; Elham,7,0,10,3
1668113728477,MATH 209,A00,098028,Pollack; Aaron,10,0,10,0
1668113728908,MATH 211A,A00,112919,Rogalski; Daniel,9,0,10,1
1668113729330,MATH 211B,A00,112920,Seward; Brandon M.,9,0,10,1
1668113729756,MATH 218,A00,098029,Li; Bo,10,0,10,0
1668113730190,MATH 220B,A00,098030,Novak; Jonathan I,11,0,15,4
1668113730622,MATH 221A,A00,098031,Ebenfelt; Peter F,13,0,15,2
1668113731049,MATH 231B,A00,098032,Zlatos; Andrej,12,0,15,3
1668113731473,MATH 240B,A00,098033,Ni; Lei,9,0,15,6
1668113731895,MATH 243,A00,098034,Jekel; David Andrew,10,0,10,0
1668113732325,MATH 245A,A00,098035,Nie; Jiawang,0,0,15,16
1668113732771,MATH 248,A00,098036,Bejenaru; Ioan,10,0,10,0
1668113733195,MATH 250B,A00,098037,Spolaor; Luca,14,0,15,1
1668113733617,MATH 258,A00,098038,Ni; Lei,10,0,10,0
1668113734043,MATH 264B,A00,098041,Rhoades; Brendon Patrick,9,0,15,6
1668113734466,MATH 268,A00,098042,Buss; Samuel R,10,0,10,0
1668113734895,MATH 269,A00,098043,Rhoades; Brendon Patrick,10,0,10,0
1668113735319,MATH 270B,A00,098044,Li; Bo,10,0,15,5
1668113735747,MATH 272B,A00,098045,Holst; Michael J,13,0,15,2
1668113736174,MATH 273A,A00,098046,Tian; Xiaochuan,10,0,15,5
1668113736609,MATH 275,A01,098048,Tian; Xiaochuan,6,0,10,4
1668113737036,MATH 278A,A00,098049,Holst; Michael J,8,0,10,2
1668113737473,MATH 278B,A00,098050,Cloninger; Alexander,10,0,10,0
1668113737896,MATH 278C,A00,098051,Nie; Jiawang,7,0,10,3
1668113738325,MATH 280B,A00,098052,Zheng; Tianyi,10,0,15,5
1668113738749,MATH 281B,A00,098053,Bradic; Jelena,2,0,15,13
1668113739185,MATH 282B,A00,098054,Arias-Castro; Ery,0,0,15,15
1668113739612,MATH 285,A00,098055,Fitzsimmons; Patrick J,0,0,15,17
1668113740038,MATH 287B,A00,098056,Arias-Castro; Ery,3,0,15,12
1668113740480,MATH 288,A00,098057,Agarwal; Pooja,9,0,10,1
1668113740480,MATH 288,B00,098058,Zhang; Danna,8,0,10,2
1668113740480,MATH 288,C00,098059,Williams; Ruth J,10,0,10,0
1668113740914,MATH 290B,A00,098060,Roberts; Justin Deritter,13,0,15,2
1668113741343,MATH 292,A00,098061,Belmont; Eva Kinoshita,10,0,10,0
1668113741786,MATH 295,A00,098062,Suk; Andrew Hoon,48,0,50,2
1668113742225,MATH 296,A00,098063,Novak; Jonathan I,20,0,20,0
1668113742647,MATH 297,001,098064,Gamst; Anthony Collins,9997,0,9999,2
1668114247027,COGS 205,A00,101395,Chiba; Andrea,19,0,20,1
1668114247456,COGS 210B,001,101404,Greene; Deanna Jacquelyn,9998,0,9999,1
1668114247456,COGS 210B,002,101417,Xia; Haijun,9999,0,9999,0
1668114247456,COGS 210B,003,101422,Nitz; Douglas A.,9999,0,9999,0
1668114247456,COGS 210B,004,101423,Hollan; James D.,9998,0,9999,1
1668114247456,COGS 210B,005,101424,Deak; Gedeon O.,9998,0,9999,1
1668114247456,COGS 210B,006,101425,Rossano; Federico,9999,0,9999,0
1668114247888,COGS 211B,A00,101427,Coulson; Seana M,9996,0,9999,3
1668114248313,COGS 220,A00,101428,Hollan; James D.,0,0,25,25
1668114248744,COGS 229,A00,101429,Dow; Steven P,18,0,25,7
1668114249171,COGS 230,A00,101430,Klemmer; Scott R,12,0,17,5
1668114249607,COGS 234,A00,101431,Xia; Haijun,3,0,25,22
1668114250137,COGS 260,A00,101432,Kiyonaga; Anastasia,20,0,25,5
1668114250137,COGS 260,B00,101433,Kirsh; David Joel,16,0,25,9
1668114250570,CSE 202,A00,102371,Impagliazzo; Russell,0,0,0,0
1668114250999,CSE 203B,A01,102373,Cheng; Chung Kuan,0,0,0,0
1668114251434,CSE 208,A00,102374,Micciancio; Daniele,0,0,0,0
1668114251859,CSE 209A,A00,112895,Impagliazzo; Russell,0,0,15,15
1668114252288,CSE 209B,A00,108005,Bellare; Mihir,0,0,0,0
1668114252714,CSE 210,A00,113163,Coblenz; Michael J,0,0,0,0
1668114253139,CSE 219,A00,106111,Dow; Steven P,0,0,20,20
1668114253568,CSE 221,A00,102376,Voelker; Geoffrey M.,0,0,0,0
1668114253999,CSE 224,A01,102378,Porter; George M,0,0,0,0
1668114254432,CSE 229A,A00,102379,Savage; Stefan,0,0,0,0
1668114254858,CSE 229C,A00,102380,Munyaka; Imani N. S.,0,0,0,0
1668114255285,CSE 232B,A00,102382,Deutsch; Alin Bernard,0,0,0,0
1668114255711,CSE 234,A01,112904,Kumar; Arun Kumar,0,0,0,0
1668114256140,CSE 237A,A00,102383,Rosing; Tajana Simunic,0,0,0,0
1668114256563,CSE 239A,A00,102384,Deutsch; Alin Bernard,0,0,0,0
1668114256986,CSE 239B,A00,102385,Polikarpova; Nadezhda,0,0,0,0
1668114257411,CSE 240A,A00,102386,Pannuto; Patrick William,0,0,0,0
1668114257844,CSE 240B,A00,102387,Zhao; Jishen,0,0,0,0
1668114258268,CSE 241A,A00,106406,Kang; Mingu,0,0,0,0
1668114258697,CSE 249B,A00,102388,Kahng; Andrew Byun,0,0,8,8
1668114259121,CSE 251B,A01,102392,Cottrell; Garrison W,0,0,0,0
1668114259121,CSE 251B,A02,102393,Cottrell; Garrison W,0,0,0,0
1668114259550,CSE 252B,A00,102394,Ochoa; Benjamin Lawrence,0,0,0,0
1668114259989,CSE 257,A01,102396,Gao; Sicun,0,0,0,0
1668114260414,CSE 272,A00,102397,Li; Tzumao,0,0,0,0
1668114260847,CSE 274,A00,111323,Chern; Albert Ren-Haur,0,0,0,0
1668114261273,CSE 282,A00,102398,Pevzner; Pavel Arkadjevich,0,0,0,0
1668114261698,CSE 284,A00,114175,Gymrek; Melissa Ann,0,0,0,0
1668114262127,CSE 290,A00,102399,Chandraker; Manmohan Krishna,0,0,0,0
1668114262127,CSE 290,B00,102400,Vaccaro; Kristen Marie,0,0,25,25
1668114262127,CSE 290,C00,102414,Pannuto; Patrick William,0,0,25,25
1668114262127,CSE 290,D00,102427,Pevzner; Pavel Arkadjevich,0,0,0,0
1668114262127,CSE 290,E00,102429,Zhao; Jishen,0,0,0,0
1668114262127,CSE 290,F00,102436,Tullsen; Dean Michael,0,0,0,0
1668114262127,CSE 290,G00,102440,Christensen; Henrik I,0,0,20,20
1668114262558,CSE 291,A00,102443,Su; Hao,0,0,0,0
1668114262558,CSE 291,B00,102448,Polikarpova; Nadezhda,0,0,0,0
1668114262558,CSE 291,C00,102453,Vaccaro; Kristen Marie,0,0,0,0
1668114262558,CSE 291,D00,111343,Savage; Stefan,0,0,0,0
1668114262558,CSE 291,E00,116474,Claffy; Kimberly Claire,0,0,0,0
1668114262558,CSE 291,F00,116479,Pasquale; Joseph,0,0,0,0
1668114263009,CSE 293,001,119111,Bafna; Vineet,9999,0,9999,0
1668114263009,CSE 293,002,119118,Bellare; Mihir,9999,0,9999,0
1668114263009,CSE 293,003,119122,Berg-Kirkpatrick; Taylor D,9999,0,9999,0
1668114263009,CSE 293,004,119135,Christensen; Henrik I,9999,0,9999,0
1668114263009,CSE 293,005,119142,Cottrell; Garrison W,9999,0,9999,0
1668114263009,CSE 293,006,119146,Deutsch; Alin Bernard,9999,0,9999,0
1668114263009,CSE 293,007,119159,Esmaeilzadeh; Hadi,9999,0,9999,0
1668114263009,CSE 293,008,119166,Freund; Yoav,9999,0,9999,0
1668114263009,CSE 293,009,119170,Griswold; William G.,9999,0,9999,0
1668114263009,CSE 293,010,119183,Gymrek; Melissa Ann,9999,0,9999,0
1668114263009,CSE 293,011,119190,Heninger; Nadia A,9999,0,9999,0
1668114263009,CSE 293,012,119230,Impagliazzo; Russell,9999,0,9999,0
1668114263009,CSE 293,013,119232,Jhala; Ranjit,9999,0,9999,0
1668114263009,CSE 293,014,119233,Kahng; Andrew Byun,9999,0,9999,0
1668114263009,CSE 293,015,119298,Kane; Daniel Mertz,9999,0,9999,0
1668114263009,CSE 293,016,119299,Kriegman; David J,9999,0,9999,0
1668114263009,CSE 293,017,119300,Kumar; Arun Kumar,9999,0,9999,0
1668114263009,CSE 293,018,119301,Lerner; Sorin,9999,0,9999,0
1668114263009,CSE 293,019,119302,Lovett; Shachar,9999,0,9999,0
1668114263009,CSE 293,020,119303,McAuley; Julian John,9999,0,9999,0
1668114263009,CSE 293,021,119304,Micciancio; Daniele,9999,0,9999,0
1668114263009,CSE 293,022,119367,Orailoglu; Alex,9999,0,9999,0
1668114263009,CSE 293,023,119382,Paturi; Ramamohan,9999,0,9999,0
1668114263009,CSE 293,024,119404,Polikarpova; Nadezhda,9999,0,9999,0
1668114263009,CSE 293,025,119406,Politz; Joseph Gibbs,9999,0,9999,0
1668114263009,CSE 293,026,119411,Porter; George M,9999,0,9999,0
1668114263009,CSE 293,027,119414,Porter; Leonard Emerson,9999,0,9999,0
1668114263009,CSE 293,028,119416,Ramamoorthi; Ravi,9999,0,9999,0
1668114263009,CSE 293,029,119417,Sahoo; Debashis,9999,0,9999,0
1668114263009,CSE 293,030,119420,Saul; Lawrence,9999,0,9999,0
1668114263009,CSE 293,031,119421,Savage; Stefan,9999,0,9999,0
1668114263009,CSE 293,032,119425,Schulze; Jurgen P.,9999,0,9999,0
1668114263009,CSE 293,033,119426,Snoeren; Alex C.,9999,0,9999,0
1668114263009,CSE 293,034,119428,Shang; Jingbo,9999,0,9999,0
1668114263009,CSE 293,035,119430,Stefan; Deian,9999,0,9999,0
1668114263009,CSE 293,036,119431,Su; Hao,9999,0,9999,0
1668114263009,CSE 293,037,119433,Swanson; Steven James,9999,0,9999,0
1668114263009,CSE 293,038,119435,Tullsen; Dean Michael,9999,0,9999,0
1668114263009,CSE 293,039,119483,Voelker; Geoffrey M.,9999,0,9999,0
1668114263009,CSE 293,040,119537,Zhao; Jishen,9999,0,9999,0
1668114263009,CSE 293,041,119538,Zhou; Yuan-Yuan,9999,0,9999,0
1668114263009,CSE 293,042,119539,Gao; Sicun,9999,0,9999,0
1668114263009,CSE 293,043,119540,Weibel; Nadir,9999,0,9999,0
1668114263009,CSE 293,044,119541,Gupta; Rajesh K.,9999,0,9999,0
1668114263009,CSE 293,045,126410,Vaccaro; Kristen Marie,9999,0,9999,0
1668114263009,CSE 293,046,126411,Klemke; Richard,9999,0,9999,0
1668114263436,CSE 294,A00,102459,Voelker; Geoffrey M.,0,0,0,0
1668114263436,CSE 294,B00,111322,Orailoglu; Alex,0,0,0,0
1668114263882,DSE 201,A00,096914,Deutsch; Alin Bernard,30,0,30,0
1668114264321,DSE 210,A00,096915,Dasgupta; Sanjoy,30,0,30,0
1668114264748,DSE 260A,A00,096916,Altintas De Callaf; Ilkay,30,0,30,0
1668114265181,ECE 200,001,103586,Antipa; Nicholas A,9999,0,9999,0
1668114265181,ECE 200,002,103587,Atanasov; Nikolay A.,9999,0,9999,0
1668114265181,ECE 200,003,103588,Bharadia; Dinesh,9999,0,9999,0
1668114265181,ECE 200,004,103589,Cheng; Chung Kuan,9999,0,9999,0
1668114265181,ECE 200,005,103590,Cosman; Pamela C.,9999,0,9999,0
1668114265181,ECE 200,006,103591,Dayeh; Shadi Ahmad,9999,0,9999,0
1668114265181,ECE 200,007,103592,Fainman; Yeshaiahu,9999,0,9999,0
1668114265181,ECE 200,008,103593,Ford; Joseph Earl,9999,0,9999,0
1668114265181,ECE 200,009,103594,Franceschetti; Massimo,9999,0,9999,0
1668114265181,ECE 200,010,103595,Fullerton; Eric E,9999,0,9999,0
1668114265181,ECE 200,011,103596,Galton; Ian A,9999,0,9999,0
1668114265181,ECE 200,012,103597,Gilja; Vikash,9999,0,9999,0
1668114265181,ECE 200,013,103598,Hall; Drew A.,9999,0,9999,0
1668114265181,ECE 200,014,103599,Hsueh; Tzu-Chien,9999,0,9999,0
1668114265181,ECE 200,015,103600,Javidi; Tara,9999,0,9999,0
1668114265181,ECE 200,016,103601,Kahng; Andrew Byun,9999,0,9999,0
1668114265181,ECE 200,017,103602,Kim; Young-Han,9999,0,9999,0
1668114265181,ECE 200,018,103603,Koushanfar; Farinaz,9999,0,9999,0
1668114265181,ECE 200,019,103604,Kuzum; Duygu,9999,0,9999,0
1668114265181,ECE 200,020,103605,Le; Hanh-Phuc,9999,0,9999,0
1668114265181,ECE 200,021,103606,Lin; Bill,9999,0,9999,0
1668114265181,ECE 200,022,103607,Liu; Zhaowei,9998,0,9999,1
1668114265181,ECE 200,023,103608,Lo; Yu-Hwa,9999,0,9999,0
1668114265181,ECE 200,024,103609,Lomakin; Vitaliy,9999,0,9999,0
1668114265181,ECE 200,025,103610,Mercier; Patrick Philip,9999,0,9999,0
1668114265181,ECE 200,026,103611,Meyer; Florian,9999,0,9999,0
1668114265181,ECE 200,027,103612,Milstein; Laurence B.,9999,0,9999,0
1668114265181,ECE 200,028,103613,Mir Arabbaygi; Siavash,9999,0,9999,0
1668114265181,ECE 200,029,103614,Mookherjea; Shayan,9999,0,9999,0
1668114265181,ECE 200,030,103615,Morris; Karcher William,9999,0,9999,0
1668114265181,ECE 200,031,103616,Ng; Tse Nga,9999,0,9999,0
1668114265181,ECE 200,032,103617,Nguyen; Truong Quang,9999,0,9999,0
1668114265181,ECE 200,033,103618,Nomura; Kenji,9999,0,9999,0
1668114265181,ECE 200,034,103619,Orlitsky; Alon,9999,0,9999,0
1668114265181,ECE 200,035,103620,Pal; Piya,9999,0,9999,0
1668114265181,ECE 200,036,103621,Papen; George C.,9999,0,9999,0
1668114265181,ECE 200,037,103622,Radic; Stojan,9999,0,9999,0
1668114265181,ECE 200,038,103623,Rao; Bhaskar D.,9999,0,9999,0
1668114265181,ECE 200,039,103624,Rao; Ramesh R,9999,0,9999,0
1668114265181,ECE 200,040,103625,Rebeiz; Gabriel,9999,0,9999,0
1668114265181,ECE 200,041,103626,Sanford; John R,9999,0,9999,0
1668114265181,ECE 200,042,103627,Siegel; Paul H.,9999,0,9999,0
1668114265181,ECE 200,043,103628,Sievenpiper; Daniel F.,9999,0,9999,0
1668114265181,ECE 200,044,103629,Sworder; David D.,9999,0,9999,0
1668114265181,ECE 200,045,103630,Taur; Yuan,9999,0,9999,0
1668114265181,ECE 200,046,103631,Touri; Behrouz,9999,0,9999,0
1668114265181,ECE 200,047,103632,Trivedi; Mohan M.,9999,0,9999,0
1668114265181,ECE 200,048,103633,Vasconcelos; Nuno,9999,0,9999,0
1668114265181,ECE 200,049,103634,Wang; Xiaolong,9999,0,9999,0
1668114265181,ECE 200,050,103635,Xie; Pengtao,9999,0,9999,0
1668114265181,ECE 200,051,103636,Yip; Michael,9999,0,9999,0
1668114265181,ECE 200,052,103637,Zeger; Kenneth A.,999,0,999,0
1668114265181,ECE 200,053,103638,Zhang; Xinyu,9999,0,9999,0
1668114265181,ECE 200,054,103639,Turakhia; Yatish Girish,9999,0,9999,0
1668114265181,ECE 200,055,103640,Kang; Mingu,9999,0,9999,0
1668114265181,ECE 200,056,103641,Shi; Yuanyuan,9999,0,9999,0
1668114265181,ECE 200,057,103642,Wang; Edward Jay,9999,0,9999,0
1668114265181,ECE 200,058,103643,Zheng; Yang,9999,0,9999,0
1668114265606,ECE 202,A00,103644,Kuzum; Duygu,0,0,0,0
1668114266039,ECE 212BN,A00,103646,Ng; Tse Nga,0,0,0,0
1668114266471,ECE 221,A00,111493,Staff,0,0,0,0
1668114266898,ECE 222B,A00,103647,Lomakin; Vitaliy,0,0,0,0
1668114267322,ECE 230B,A00,103648,Taur; Yuan,0,0,0,0
1668114267746,ECE 238B,A00,103649,Garay; Javier,0,0,0,0
1668114268172,ECE 240B,A00,112900,Fainman; Yeshaiahu,0,0,0,0
1668114268606,ECE 247A,A00,103650,Jokerst; Jesse Vincent,0,0,0,0
1668114269040,ECE 247B,A00,103651,Wang; Joseph,0,0,0,0
1668114269461,ECE 250,A00,103652,Siegel; Paul H.,0,0,0,0
1668114269886,ECE 251A,A00,103654,Rao; Bhaskar D.,0,0,0,0
1668114270341,ECE 257B,A00,103655,Bharadia; Dinesh,0,0,0,0
1668114270765,ECE 258A,A00,103656,Milstein; Laurence B.,0,0,0,0
1668114271206,ECE 260B,A00,103658,Kang; Mingu,0,0,0,0
1668114271645,ECE 264A,A00,103659,Galton; Ian A,0,0,0,0
1668114272082,ECE 265A,A00,103661,Gudem; Prasad S.S.,0,0,0,0
1668114272512,ECE 265D,A00,103662,Gudem; Prasad S.S.,0,0,0,0
1668114272937,ECE 268,A00,103663,Koushanfar; Farinaz,0,0,0,0
1668114273364,ECE 269,A01,103665,Pal; Piya,0,0,0,0
1668114273799,ECE 271B,A00,103666,Vasconcelos; Manuela,0,0,0,0
1668114274233,ECE 276A,A00,103667,Atanasov; Nikolay A.,0,0,0,0
1668114274668,ECE 277,A00,103668,An; Cheolhong,0,0,0,0
1668114275091,ECE 279,A00,117947,Hall; Drew A.,0,0,0,0
1668114275947,ECE 283,A00,103670,Hsueh; Tzu-Chien,0,0,0,0
1668114276380,ECE 284,A00,103671,Turakhia; Yatish Girish,0,0,0,0
1668114276815,ECE 285,A00,103672,Zheng; Yang,0,0,0,0
1668114276815,ECE 285,B00,103673,Sworder; David D.,0,0,0,0
1668114277250,ECE 287,A00,103676,Javidi; Tara,0,0,0,0
1668114277677,MATH 200B,A00,098023,Salehi Golsefidy; Alireza,12,0,15,3
1668114278109,MATH 202B,A00,098024,Rhoades; Brendon Patrick,9,0,15,6
1668114278538,MATH 203B,A00,098025,Oprea; Dragos N.,10,0,15,5
1668114278972,MATH 204B,A00,098026,Sorensen; Claus M,13,0,15,2
1668114279413,MATH 208,A00,098027,Izadi; Elham,7,0,10,3
1668114279857,MATH 209,A00,098028,Pollack; Aaron,10,0,10,0
1668114280290,MATH 211A,A00,112919,Rogalski; Daniel,9,0,10,1
1668114280714,MATH 211B,A00,112920,Seward; Brandon M.,9,0,10,1
1668114281147,MATH 218,A00,098029,Li; Bo,10,0,10,0
1668114281584,MATH 220B,A00,098030,Novak; Jonathan I,11,0,15,4
1668114282008,MATH 221A,A00,098031,Ebenfelt; Peter F,13,0,15,2
1668114282431,MATH 231B,A00,098032,Zlatos; Andrej,12,0,15,3
1668114282854,MATH 240B,A00,098033,Ni; Lei,9,0,15,6
1668114283276,MATH 243,A00,098034,Jekel; David Andrew,10,0,10,0
1668114283698,MATH 245A,A00,098035,Nie; Jiawang,0,0,15,16
1668114284134,MATH 248,A00,098036,Bejenaru; Ioan,10,0,10,0
1668114284568,MATH 250B,A00,098037,Spolaor; Luca,14,0,15,1
1668114284993,MATH 258,A00,098038,Ni; Lei,10,0,10,0
1668114285418,MATH 264B,A00,098041,Rhoades; Brendon Patrick,9,0,15,6
1668114285849,MATH 268,A00,098042,Buss; Samuel R,10,0,10,0
1668114286275,MATH 269,A00,098043,Rhoades; Brendon Patrick,10,0,10,0
1668114286706,MATH 270B,A00,098044,Li; Bo,10,0,15,5
1668114287132,MATH 272B,A00,098045,Holst; Michael J,13,0,15,2
1668114287555,MATH 273A,A00,098046,Tian; Xiaochuan,10,0,15,5
1668114287989,MATH 275,A01,098048,Tian; Xiaochuan,6,0,10,4
1668114288414,MATH 278A,A00,098049,Holst; Michael J,8,0,10,2
1668114288861,MATH 278B,A00,098050,Cloninger; Alexander,10,0,10,0
1668114289291,MATH 278C,A00,098051,Nie; Jiawang,7,0,10,3
1668114289723,MATH 280B,A00,098052,Zheng; Tianyi,10,0,15,5
1668114290160,MATH 281B,A00,098053,Bradic; Jelena,2,0,15,13
1668114290601,MATH 282B,A00,098054,Arias-Castro; Ery,0,0,15,15
1668114291023,MATH 285,A00,098055,Fitzsimmons; Patrick J,0,0,15,17
1668114291447,MATH 287B,A00,098056,Arias-Castro; Ery,3,0,15,12
1668114291884,MATH 288,A00,098057,Agarwal; Pooja,9,0,10,1
1668114291884,MATH 288,B00,098058,Zhang; Danna,8,0,10,2
1668114291884,MATH 288,C00,098059,Williams; Ruth J,10,0,10,0
1668114292316,MATH 290B,A00,098060,Roberts; Justin Deritter,13,0,15,2
1668114292740,MATH 292,A00,098061,Belmont; Eva Kinoshita,10,0,10,0
1668114293172,MATH 295,A00,098062,Suk; Andrew Hoon,48,0,50,2
1668114293693,MATH 296,A00,098063,Novak; Jonathan I,20,0,20,0
1668114294118,MATH 297,001,098064,Gamst; Anthony Collins,9997,0,9999,2
1668114810973,COGS 205,A00,101395,Chiba; Andrea,19,0,20,1
1668114811410,COGS 210B,001,101404,Greene; Deanna Jacquelyn,9998,0,9999,1
1668114811410,COGS 210B,002,101417,Xia; Haijun,9999,0,9999,0
1668114811410,COGS 210B,003,101422,Nitz; Douglas A.,9999,0,9999,0
1668114811410,COGS 210B,004,101423,Hollan; James D.,9998,0,9999,1
1668114811410,COGS 210B,005,101424,Deak; Gedeon O.,9998,0,9999,1
1668114811410,COGS 210B,006,101425,Rossano; Federico,9999,0,9999,0
1668114811831,COGS 211B,A00,101427,Coulson; Seana M,9996,0,9999,3
1668114812260,COGS 220,A00,101428,Hollan; James D.,0,0,25,25
1668114812684,COGS 229,A00,101429,Dow; Steven P,18,0,25,7
1668114813110,COGS 230,A00,101430,Klemmer; Scott R,12,0,17,5
1668114813533,COGS 234,A00,101431,Xia; Haijun,3,0,25,22
1668114813960,COGS 260,A00,101432,Kiyonaga; Anastasia,20,0,25,5
1668114813960,COGS 260,B00,101433,Kirsh; David Joel,16,0,25,9
1668114814384,CSE 202,A00,102371,Impagliazzo; Russell,0,0,0,0
1668114814814,CSE 203B,A01,102373,Cheng; Chung Kuan,0,0,0,0
1668114815239,CSE 208,A00,102374,Micciancio; Daniele,0,0,0,0
1668114815674,CSE 209A,A00,112895,Impagliazzo; Russell,0,0,15,15
1668114816105,CSE 209B,A00,108005,Bellare; Mihir,0,0,0,0
1668114816546,CSE 210,A00,113163,Coblenz; Michael J,0,0,0,0
1668114816968,CSE 219,A00,106111,Dow; Steven P,0,0,20,20
1668114817398,CSE 221,A00,102376,Voelker; Geoffrey M.,0,0,0,0
1668114817823,CSE 224,A01,102378,Porter; George M,0,0,0,0
1668114818263,CSE 229A,A00,102379,Savage; Stefan,0,0,0,0
1668114818688,CSE 229C,A00,102380,Munyaka; Imani N. S.,0,0,0,0
1668114819114,CSE 232B,A00,102382,Deutsch; Alin Bernard,0,0,0,0
1668114819542,CSE 234,A01,112904,Kumar; Arun Kumar,0,0,0,0
1668114819965,CSE 237A,A00,102383,Rosing; Tajana Simunic,0,0,0,0
1668114820404,CSE 239A,A00,102384,Deutsch; Alin Bernard,0,0,0,0
1668114820828,CSE 239B,A00,102385,Polikarpova; Nadezhda,0,0,0,0
1668114821251,CSE 240A,A00,102386,Pannuto; Patrick William,0,0,0,0
1668114821681,CSE 240B,A00,102387,Zhao; Jishen,0,0,0,0
1668114822112,CSE 241A,A00,106406,Kang; Mingu,0,0,0,0
1668114822534,CSE 249B,A00,102388,Kahng; Andrew Byun,0,0,8,8
1668114822981,CSE 251B,A01,102392,Cottrell; Garrison W,0,0,0,0
1668114822981,CSE 251B,A02,102393,Cottrell; Garrison W,0,0,0,0
1668114823420,CSE 252B,A00,102394,Ochoa; Benjamin Lawrence,0,0,0,0
1668114823861,CSE 257,A01,102396,Gao; Sicun,0,0,0,0
1668114824293,CSE 272,A00,102397,Li; Tzumao,0,0,0,0
1668114824724,CSE 274,A00,111323,Chern; Albert Ren-Haur,0,0,0,0
1668114825163,CSE 282,A00,102398,Pevzner; Pavel Arkadjevich,0,0,0,0
1668114825588,CSE 284,A00,114175,Gymrek; Melissa Ann,0,0,0,0
1668114826014,CSE 290,A00,102399,Chandraker; Manmohan Krishna,0,0,0,0
1668114826014,CSE 290,B00,102400,Vaccaro; Kristen Marie,0,0,25,25
1668114826014,CSE 290,C00,102414,Pannuto; Patrick William,0,0,25,25
1668114826014,CSE 290,D00,102427,Pevzner; Pavel Arkadjevich,0,0,0,0
1668114826014,CSE 290,E00,102429,Zhao; Jishen,0,0,0,0
1668114826014,CSE 290,F00,102436,Tullsen; Dean Michael,0,0,0,0
1668114826014,CSE 290,G00,102440,Christensen; Henrik I,0,0,20,20
1668114826436,CSE 291,A00,102443,Su; Hao,0,0,0,0
1668114826436,CSE 291,B00,102448,Polikarpova; Nadezhda,0,0,0,0
1668114826436,CSE 291,C00,102453,Vaccaro; Kristen Marie,0,0,0,0
1668114826436,CSE 291,D00,111343,Savage; Stefan,0,0,0,0
1668114826436,CSE 291,E00,116474,Claffy; Kimberly Claire,0,0,0,0
1668114826436,CSE 291,F00,116479,Pasquale; Joseph,0,0,0,0
1668114826897,CSE 293,001,119111,Bafna; Vineet,9999,0,9999,0
1668114826897,CSE 293,002,119118,Bellare; Mihir,9999,0,9999,0
1668114826897,CSE 293,003,119122,Berg-Kirkpatrick; Taylor D,9999,0,9999,0
1668114826897,CSE 293,004,119135,Christensen; Henrik I,9999,0,9999,0
1668114826897,CSE 293,005,119142,Cottrell; Garrison W,9999,0,9999,0
1668114826897,CSE 293,006,119146,Deutsch; Alin Bernard,9999,0,9999,0
1668114826897,CSE 293,007,119159,Esmaeilzadeh; Hadi,9999,0,9999,0
1668114826897,CSE 293,008,119166,Freund; Yoav,9999,0,9999,0
1668114826897,CSE 293,009,119170,Griswold; William G.,9999,0,9999,0
1668114826897,CSE 293,010,119183,Gymrek; Melissa Ann,9999,0,9999,0
1668114826897,CSE 293,011,119190,Heninger; Nadia A,9999,0,9999,0
1668114826897,CSE 293,012,119230,Impagliazzo; Russell,9999,0,9999,0
1668114826897,CSE 293,013,119232,Jhala; Ranjit,9999,0,9999,0
1668114826897,CSE 293,014,119233,Kahng; Andrew Byun,9999,0,9999,0
1668114826897,CSE 293,015,119298,Kane; Daniel Mertz,9999,0,9999,0
1668114826897,CSE 293,016,119299,Kriegman; David J,9999,0,9999,0
1668114826897,CSE 293,017,119300,Kumar; Arun Kumar,9999,0,9999,0
1668114826897,CSE 293,018,119301,Lerner; Sorin,9999,0,9999,0
1668114826897,CSE 293,019,119302,Lovett; Shachar,9999,0,9999,0
1668114826897,CSE 293,020,119303,McAuley; Julian John,9999,0,9999,0
1668114826897,CSE 293,021,119304,Micciancio; Daniele,9999,0,9999,0
1668114826897,CSE 293,022,119367,Orailoglu; Alex,9999,0,9999,0
1668114826897,CSE 293,023,119382,Paturi; Ramamohan,9999,0,9999,0
1668114826897,CSE 293,024,119404,Polikarpova; Nadezhda,9999,0,9999,0
1668114826897,CSE 293,025,119406,Politz; Joseph Gibbs,9999,0,9999,0
1668114826897,CSE 293,026,119411,Porter; George M,9999,0,9999,0
1668114826897,CSE 293,027,119414,Porter; Leonard Emerson,9999,0,9999,0
1668114826897,CSE 293,028,119416,Ramamoorthi; Ravi,9999,0,9999,0
1668114826897,CSE 293,029,119417,Sahoo; Debashis,9999,0,9999,0
1668114826897,CSE 293,030,119420,Saul; Lawrence,9999,0,9999,0
1668114826897,CSE 293,031,119421,Savage; Stefan,9999,0,9999,0
1668114826897,CSE 293,032,119425,Schulze; Jurgen P.,9999,0,9999,0
1668114826897,CSE 293,033,119426,Snoeren; Alex C.,9999,0,9999,0
1668114826897,CSE 293,034,119428,Shang; Jingbo,9999,0,9999,0
1668114826897,CSE 293,035,119430,Stefan; Deian,9999,0,9999,0
1668114826897,CSE 293,036,119431,Su; Hao,9999,0,9999,0
1668114826897,CSE 293,037,119433,Swanson; Steven James,9999,0,9999,0
1668114826897,CSE 293,038,119435,Tullsen; Dean Michael,9999,0,9999,0
1668114826897,CSE 293,039,119483,Voelker; Geoffrey M.,9999,0,9999,0
1668114826897,CSE 293,040,119537,Zhao; Jishen,9999,0,9999,0
1668114826897,CSE 293,041,119538,Zhou; Yuan-Yuan,9999,0,9999,0
1668114826897,CSE 293,042,119539,Gao; Sicun,9999,0,9999,0
1668114826897,CSE 293,043,119540,Weibel; Nadir,9999,0,9999,0
1668114826897,CSE 293,044,119541,Gupta; Rajesh K.,9999,0,9999,0
1668114826897,CSE 293,045,126410,Vaccaro; Kristen Marie,9999,0,9999,0
1668114826897,CSE 293,046,126411,Klemke; Richard,9999,0,9999,0
1668114827320,CSE 294,A00,102459,Voelker; Geoffrey M.,0,0,0,0
1668114827320,CSE 294,B00,111322,Orailoglu; Alex,0,0,0,0
1668114827759,DSE 201,A00,096914,Deutsch; Alin Bernard,30,0,30,0
1668114828184,DSE 210,A00,096915,Dasgupta; Sanjoy,30,0,30,0
1668114828621,DSE 260A,A00,096916,Altintas De Callaf; Ilkay,30,0,30,0
1668114829094,ECE 200,001,103586,Antipa; Nicholas A,9999,0,9999,0
1668114829094,ECE 200,002,103587,Atanasov; Nikolay A.,9999,0,9999,0
1668114829094,ECE 200,003,103588,Bharadia; Dinesh,9999,0,9999,0
1668114829094,ECE 200,004,103589,Cheng; Chung Kuan,9999,0,9999,0
1668114829094,ECE 200,005,103590,Cosman; Pamela C.,9999,0,9999,0
1668114829094,ECE 200,006,103591,Dayeh; Shadi Ahmad,9999,0,9999,0
1668114829094,ECE 200,007,103592,Fainman; Yeshaiahu,9999,0,9999,0
1668114829094,ECE 200,008,103593,Ford; Joseph Earl,9999,0,9999,0
1668114829094,ECE 200,009,103594,Franceschetti; Massimo,9999,0,9999,0
1668114829094,ECE 200,010,103595,Fullerton; Eric E,9999,0,9999,0
1668114829094,ECE 200,011,103596,Galton; Ian A,9999,0,9999,0
1668114829094,ECE 200,012,103597,Gilja; Vikash,9999,0,9999,0
1668114829094,ECE 200,013,103598,Hall; Drew A.,9999,0,9999,0
1668114829094,ECE 200,014,103599,Hsueh; Tzu-Chien,9999,0,9999,0
1668114829094,ECE 200,015,103600,Javidi; Tara,9999,0,9999,0
1668114829094,ECE 200,016,103601,Kahng; Andrew Byun,9999,0,9999,0
1668114829094,ECE 200,017,103602,Kim; Young-Han,9999,0,9999,0
1668114829094,ECE 200,018,103603,Koushanfar; Farinaz,9999,0,9999,0
1668114829094,ECE 200,019,103604,Kuzum; Duygu,9999,0,9999,0
1668114829094,ECE 200,020,103605,Le; Hanh-Phuc,9999,0,9999,0
1668114829094,ECE 200,021,103606,Lin; Bill,9999,0,9999,0
1668114829094,ECE 200,022,103607,Liu; Zhaowei,9998,0,9999,1
1668114829094,ECE 200,023,103608,Lo; Yu-Hwa,9999,0,9999,0
1668114829094,ECE 200,024,103609,Lomakin; Vitaliy,9999,0,9999,0
1668114829094,ECE 200,025,103610,Mercier; Patrick Philip,9999,0,9999,0
1668114829094,ECE 200,026,103611,Meyer; Florian,9999,0,9999,0
1668114829094,ECE 200,027,103612,Milstein; Laurence B.,9999,0,9999,0
1668114829094,ECE 200,028,103613,Mir Arabbaygi; Siavash,9999,0,9999,0
1668114829094,ECE 200,029,103614,Mookherjea; Shayan,9999,0,9999,0
1668114829094,ECE 200,030,103615,Morris; Karcher William,9999,0,9999,0
1668114829094,ECE 200,031,103616,Ng; Tse Nga,9999,0,9999,0
1668114829094,ECE 200,032,103617,Nguyen; Truong Quang,9999,0,9999,0
1668114829094,ECE 200,033,103618,Nomura; Kenji,9999,0,9999,0
1668114829094,ECE 200,034,103619,Orlitsky; Alon,9999,0,9999,0
1668114829094,ECE 200,035,103620,Pal; Piya,9999,0,9999,0
1668114829094,ECE 200,036,103621,Papen; George C.,9999,0,9999,0
1668114829094,ECE 200,037,103622,Radic; Stojan,9999,0,9999,0
1668114829094,ECE 200,038,103623,Rao; Bhaskar D.,9999,0,9999,0
1668114829094,ECE 200,039,103624,Rao; Ramesh R,9999,0,9999,0
1668114829094,ECE 200,040,103625,Rebeiz; Gabriel,9999,0,9999,0
1668114829094,ECE 200,041,103626,Sanford; John R,9999,0,9999,0
1668114829094,ECE 200,042,103627,Siegel; Paul H.,9999,0,9999,0
1668114829094,ECE 200,043,103628,Sievenpiper; Daniel F.,9999,0,9999,0
1668114829094,ECE 200,044,103629,Sworder; David D.,9999,0,9999,0
1668114829094,ECE 200,045,103630,Taur; Yuan,9999,0,9999,0
1668114829094,ECE 200,046,103631,Touri; Behrouz,9999,0,9999,0
1668114829094,ECE 200,047,103632,Trivedi; Mohan M.,9999,0,9999,0
1668114829094,ECE 200,048,103633,Vasconcelos; Nuno,9999,0,9999,0
1668114829094,ECE 200,049,103634,Wang; Xiaolong,9999,0,9999,0
1668114829094,ECE 200,050,103635,Xie; Pengtao,9999,0,9999,0
1668114829094,ECE 200,051,103636,Yip; Michael,9999,0,9999,0
1668114829094,ECE 200,052,103637,Zeger; Kenneth A.,999,0,999,0
1668114829094,ECE 200,053,103638,Zhang; Xinyu,9999,0,9999,0
1668114829094,ECE 200,054,103639,Turakhia; Yatish Girish,9999,0,9999,0
1668114829094,ECE 200,055,103640,Kang; Mingu,9999,0,9999,0
1668114829094,ECE 200,056,103641,Shi; Yuanyuan,9999,0,9999,0
1668114829094,ECE 200,057,103642,Wang; Edward Jay,9999,0,9999,0
1668114829094,ECE 200,058,103643,Zheng; Yang,9999,0,9999,0
1668114829519,ECE 202,A00,103644,Kuzum; Duygu,0,0,0,0
1668114829946,ECE 212BN,A00,103646,Ng; Tse Nga,0,0,0,0
1668114830376,ECE 221,A00,111493,Staff,0,0,0,0
1668114830946,ECE 222B,A00,103647,Lomakin; Vitaliy,0,0,0,0
1668114831373,ECE 230B,A00,103648,Taur; Yuan,0,0,0,0
1668114831809,ECE 238B,A00,103649,Garay; Javier,0,0,0,0
1668114832248,ECE 240B,A00,112900,Fainman; Yeshaiahu,0,0,0,0
1668114832815,ECE 247A,A00,103650,Jokerst; Jesse Vincent,0,0,0,0
1668114833247,ECE 247B,A00,103651,Wang; Joseph,0,0,0,0
1668114833671,ECE 250,A00,103652,Siegel; Paul H.,0,0,0,0
1668114834103,ECE 251A,A00,103654,Rao; Bhaskar D.,0,0,0,0
1668114834547,ECE 257B,A00,103655,Bharadia; Dinesh,0,0,0,0
1668114834970,ECE 258A,A00,103656,Milstein; Laurence B.,0,0,0,0
1668114835393,ECE 260B,A00,103658,Kang; Mingu,0,0,0,0
1668114835816,ECE 264A,A00,103659,Galton; Ian A,0,0,0,0
1668114836243,ECE 265A,A00,103661,Gudem; Prasad S.S.,0,0,0,0
1668114836679,ECE 265D,A00,103662,Gudem; Prasad S.S.,0,0,0,0
1668114837126,ECE 268,A00,103663,Koushanfar; Farinaz,0,0,0,0
1668114837565,ECE 269,A01,103665,Pal; Piya,0,0,0,0
1668114838001,ECE 271B,A00,103666,Vasconcelos; Manuela,0,0,0,0
1668114838435,ECE 276A,A00,103667,Atanasov; Nikolay A.,0,0,0,0
1668114838879,ECE 277,A00,103668,An; Cheolhong,0,0,0,0
1668114839311,ECE 279,A00,117947,Hall; Drew A.,0,0,0,0
1668114840168,ECE 283,A00,103670,Hsueh; Tzu-Chien,0,0,0,0
1668114840606,ECE 284,A00,103671,Turakhia; Yatish Girish,0,0,0,0
1668114841037,ECE 285,A00,103672,Zheng; Yang,0,0,0,0
1668114841037,ECE 285,B00,103673,Sworder; David D.,0,0,0,0
1668114841460,ECE 287,A00,103676,Javidi; Tara,0,0,0,0
1668114841885,MATH 200B,A00,098023,Salehi Golsefidy; Alireza,12,0,15,3
1668114842312,MATH 202B,A00,098024,Rhoades; Brendon Patrick,9,0,15,6
1668114842734,MATH 203B,A00,098025,Oprea; Dragos N.,10,0,15,5
1668114843166,MATH 204B,A00,098026,Sorensen; Claus M,13,0,15,2
1668114843595,MATH 208,A00,098027,Izadi; Elham,7,0,10,3
1668114844018,MATH 209,A00,098028,Pollack; Aaron,10,0,10,0
1668114844449,MATH 211A,A00,112919,Rogalski; Daniel,9,0,10,1
1668114844873,MATH 211B,A00,112920,Seward; Brandon M.,9,0,10,1
1668114845305,MATH 218,A00,098029,Li; Bo,10,0,10,0
1668114845730,MATH 220B,A00,098030,Novak; Jonathan I,11,0,15,4
1668114846155,MATH 221A,A00,098031,Ebenfelt; Peter F,13,0,15,2
1668114846579,MATH 231B,A00,098032,Zlatos; Andrej,12,0,15,3
1668114847009,MATH 240B,A00,098033,Ni; Lei,9,0,15,6
1668114847438,MATH 243,A00,098034,Jekel; David Andrew,10,0,10,0
1668114847874,MATH 245A,A00,098035,Nie; Jiawang,0,0,15,16
1668114848302,MATH 248,A00,098036,Bejenaru; Ioan,10,0,10,0
1668114848738,MATH 250B,A00,098037,Spolaor; Luca,14,0,15,1
1668114849161,MATH 258,A00,098038,Ni; Lei,10,0,10,0
1668114849592,MATH 264B,A00,098041,Rhoades; Brendon Patrick,9,0,15,6
1668114850022,MATH 268,A00,098042,Buss; Samuel R,10,0,10,0
1668114850445,MATH 269,A00,098043,Rhoades; Brendon Patrick,10,0,10,0
1668114850871,MATH 270B,A00,098044,Li; Bo,10,0,15,5
1668114851307,MATH 272B,A00,098045,Holst; Michael J,13,0,15,2
1668114851738,MATH 273A,A00,098046,Tian; Xiaochuan,10,0,15,5
1668114852161,MATH 275,A01,098048,Tian; Xiaochuan,6,0,10,4
1668114852590,MATH 278A,A00,098049,Holst; Michael J,8,0,10,2
1668114853024,MATH 278B,A00,098050,Cloninger; Alexander,10,0,10,0
1668114853457,MATH 278C,A00,098051,Nie; Jiawang,7,0,10,3
1668114853886,MATH 280B,A00,098052,Zheng; Tianyi,10,0,15,5
1668114854320,MATH 281B,A00,098053,Bradic; Jelena,2,0,15,13
1668114854744,MATH 282B,A00,098054,Arias-Castro; Ery,0,0,15,15
1668114855178,MATH 285,A00,098055,Fitzsimmons; Patrick J,0,0,15,17
1668114855602,MATH 287B,A00,098056,Arias-Castro; Ery,3,0,15,12
1668114856026,MATH 288,A00,098057,Agarwal; Pooja,9,0,10,1
1668114856026,MATH 288,B00,098058,Zhang; Danna,8,0,10,2
1668114856026,MATH 288,C00,098059,Williams; Ruth J,10,0,10,0
1668114856448,MATH 290B,A00,098060,Roberts; Justin Deritter,13,0,15,2
1668114856876,MATH 292,A00,098061,Belmont; Eva Kinoshita,10,0,10,0
1668114857312,MATH 295,A00,098062,Suk; Andrew Hoon,48,0,50,2
1668114857741,MATH 296,A00,098063,Novak; Jonathan I,20,0,20,0
1668114858164,MATH 297,001,098064,Gamst; Anthony Collins,9997,0,9999,2
1668115362863,COGS 205,A00,101395,Chiba; Andrea,19,0,20,1
1668115363285,COGS 210B,001,101404,Greene; Deanna Jacquelyn,9998,0,9999,1
1668115363285,COGS 210B,002,101417,Xia; Haijun,9999,0,9999,0
1668115363285,COGS 210B,003,101422,Nitz; Douglas A.,9999,0,9999,0
1668115363285,COGS 210B,004,101423,Hollan; James D.,9998,0,9999,1
1668115363285,COGS 210B,005,101424,Deak; Gedeon O.,9998,0,9999,1
1668115363285,COGS 210B,006,101425,Rossano; Federico,9999,0,9999,0
1668115363730,COGS 211B,A00,101427,Coulson; Seana M,9996,0,9999,3
1668115364154,COGS 220,A00,101428,Hollan; James D.,0,0,25,25
1668115364583,COGS 229,A00,101429,Dow; Steven P,18,0,25,7
1668115365008,COGS 230,A00,101430,Klemmer; Scott R,12,0,17,5
1668115365452,COGS 234,A00,101431,Xia; Haijun,3,0,25,22
1668115365876,COGS 260,A00,101432,Kiyonaga; Anastasia,20,0,25,5
1668115365876,COGS 260,B00,101433,Kirsh; David Joel,16,0,25,9
1668115366307,CSE 202,A00,102371,Impagliazzo; Russell,0,0,0,0
1668115366734,CSE 203B,A01,102373,Cheng; Chung Kuan,0,0,0,0
1668115367165,CSE 208,A00,102374,Micciancio; Daniele,0,0,0,0
1668115367591,CSE 209A,A00,112895,Impagliazzo; Russell,0,0,15,15
1668115368016,CSE 209B,A00,108005,Bellare; Mihir,0,0,0,0
1668115368445,CSE 210,A00,113163,Coblenz; Michael J,0,0,0,0
1668115368875,CSE 219,A00,106111,Dow; Steven P,0,0,20,20
1668115369298,CSE 221,A00,102376,Voelker; Geoffrey M.,0,0,0,0
1668115369725,CSE 224,A01,102378,Porter; George M,0,0,0,0
1668115370153,CSE 229A,A00,102379,Savage; Stefan,0,0,0,0
1668115370583,CSE 229C,A00,102380,Munyaka; Imani N. S.,0,0,0,0
1668115371020,CSE 232B,A00,102382,Deutsch; Alin Bernard,0,0,0,0
1668115371460,CSE 234,A01,112904,Kumar; Arun Kumar,0,0,0,0
1668115371885,CSE 237A,A00,102383,Rosing; Tajana Simunic,0,0,0,0
1668115372326,CSE 239A,A00,102384,Deutsch; Alin Bernard,0,0,0,0
1668115372762,CSE 239B,A00,102385,Polikarpova; Nadezhda,0,0,0,0
1668115373185,CSE 240A,A00,102386,Pannuto; Patrick William,0,0,0,0
1668115373615,CSE 240B,A00,102387,Zhao; Jishen,0,0,0,0
1668115374041,CSE 241A,A00,106406,Kang; Mingu,0,0,0,0
1668115374468,CSE 249B,A00,102388,Kahng; Andrew Byun,0,0,8,8
1668115374891,CSE 251B,A01,102392,Cottrell; Garrison W,0,0,0,0
1668115374891,CSE 251B,A02,102393,Cottrell; Garrison W,0,0,0,0
1668115375327,CSE 252B,A00,102394,Ochoa; Benjamin Lawrence,0,0,0,0
1668115375754,CSE 257,A01,102396,Gao; Sicun,0,0,0,0
1668115376185,CSE 272,A00,102397,Li; Tzumao,0,0,0,0
1668115376611,CSE 274,A00,111323,Chern; Albert Ren-Haur,0,0,0,0
1668115377132,CSE 282,A00,102398,Pevzner; Pavel Arkadjevich,0,0,0,0
1668115377563,CSE 284,A00,114175,Gymrek; Melissa Ann,0,0,0,0
1668115377988,CSE 290,A00,102399,Chandraker; Manmohan Krishna,0,0,0,0
1668115377988,CSE 290,B00,102400,Vaccaro; Kristen Marie,0,0,25,25
1668115377988,CSE 290,C00,102414,Pannuto; Patrick William,0,0,25,25
1668115377988,CSE 290,D00,102427,Pevzner; Pavel Arkadjevich,0,0,0,0
1668115377988,CSE 290,E00,102429,Zhao; Jishen,0,0,0,0
1668115377988,CSE 290,F00,102436,Tullsen; Dean Michael,0,0,0,0
1668115377988,CSE 290,G00,102440,Christensen; Henrik I,0,0,20,20
1668115378420,CSE 291,A00,102443,Su; Hao,0,0,0,0
1668115378420,CSE 291,B00,102448,Polikarpova; Nadezhda,0,0,0,0
1668115378420,CSE 291,C00,102453,Vaccaro; Kristen Marie,0,0,0,0
1668115378420,CSE 291,D00,111343,Savage; Stefan,0,0,0,0
1668115378420,CSE 291,E00,116474,Claffy; Kimberly Claire,0,0,0,0
1668115378420,CSE 291,F00,116479,Pasquale; Joseph,0,0,0,0
1668115378867,CSE 293,001,119111,Bafna; Vineet,9999,0,9999,0
1668115378867,CSE 293,002,119118,Bellare; Mihir,9999,0,9999,0
1668115378867,CSE 293,003,119122,Berg-Kirkpatrick; Taylor D,9999,0,9999,0
1668115378867,CSE 293,004,119135,Christensen; Henrik I,9999,0,9999,0
1668115378867,CSE 293,005,119142,Cottrell; Garrison W,9999,0,9999,0
1668115378867,CSE 293,006,119146,Deutsch; Alin Bernard,9999,0,9999,0
1668115378867,CSE 293,007,119159,Esmaeilzadeh; Hadi,9999,0,9999,0
1668115378867,CSE 293,008,119166,Freund; Yoav,9999,0,9999,0
1668115378867,CSE 293,009,119170,Griswold; William G.,9999,0,9999,0
1668115378867,CSE 293,010,119183,Gymrek; Melissa Ann,9999,0,9999,0
1668115378867,CSE 293,011,119190,Heninger; Nadia A,9999,0,9999,0
1668115378867,CSE 293,012,119230,Impagliazzo; Russell,9999,0,9999,0
1668115378867,CSE 293,013,119232,Jhala; Ranjit,9999,0,9999,0
1668115378867,CSE 293,014,119233,Kahng; Andrew Byun,9999,0,9999,0
1668115378867,CSE 293,015,119298,Kane; Daniel Mertz,9999,0,9999,0
1668115378867,CSE 293,016,119299,Kriegman; David J,9999,0,9999,0
1668115378867,CSE 293,017,119300,Kumar; Arun Kumar,9999,0,9999,0
1668115378867,CSE 293,018,119301,Lerner; Sorin,9999,0,9999,0
1668115378867,CSE 293,019,119302,Lovett; Shachar,9999,0,9999,0
1668115378867,CSE 293,020,119303,McAuley; Julian John,9999,0,9999,0
1668115378867,CSE 293,021,119304,Micciancio; Daniele,9999,0,9999,0
1668115378867,CSE 293,022,119367,Orailoglu; Alex,9999,0,9999,0
1668115378867,CSE 293,023,119382,Paturi; Ramamohan,9999,0,9999,0
1668115378867,CSE 293,024,119404,Polikarpova; Nadezhda,9999,0,9999,0
1668115378867,CSE 293,025,119406,Politz; Joseph Gibbs,9999,0,9999,0
1668115378867,CSE 293,026,119411,Porter; George M,9999,0,9999,0
1668115378867,CSE 293,027,119414,Porter; Leonard Emerson,9999,0,9999,0
1668115378867,CSE 293,028,119416,Ramamoorthi; Ravi,9999,0,9999,0
1668115378867,CSE 293,029,119417,Sahoo; Debashis,9999,0,9999,0
1668115378867,CSE 293,030,119420,Saul; Lawrence,9999,0,9999,0
1668115378867,CSE 293,031,119421,Savage; Stefan,9999,0,9999,0
1668115378867,CSE 293,032,119425,Schulze; Jurgen P.,9999,0,9999,0
1668115378867,CSE 293,033,119426,Snoeren; Alex C.,9999,0,9999,0
1668115378867,CSE 293,034,119428,Shang; Jingbo,9999,0,9999,0
1668115378867,CSE 293,035,119430,Stefan; Deian,9999,0,9999,0
1668115378867,CSE 293,036,119431,Su; Hao,9999,0,9999,0
1668115378867,CSE 293,037,119433,Swanson; Steven James,9999,0,9999,0
1668115378867,CSE 293,038,119435,Tullsen; Dean Michael,9999,0,9999,0
1668115378867,CSE 293,039,119483,Voelker; Geoffrey M.,9999,0,9999,0
1668115378867,CSE 293,040,119537,Zhao; Jishen,9999,0,9999,0
1668115378867,CSE 293,041,119538,Zhou; Yuan-Yuan,9999,0,9999,0
1668115378867,CSE 293,042,119539,Gao; Sicun,9999,0,9999,0
1668115378867,CSE 293,043,119540,Weibel; Nadir,9999,0,9999,0
1668115378867,CSE 293,044,119541,Gupta; Rajesh K.,9999,0,9999,0
1668115378867,CSE 293,045,126410,Vaccaro; Kristen Marie,9999,0,9999,0
1668115378867,CSE 293,046,126411,Klemke; Richard,9999,0,9999,0
1668115379293,CSE 294,A00,102459,Voelker; Geoffrey M.,0,0,0,0
1668115379293,CSE 294,B00,111322,Orailoglu; Alex,0,0,0,0
1668115379725,DSE 201,A00,096914,Deutsch; Alin Bernard,30,0,30,0
1668115380149,DSE 210,A00,096915,Dasgupta; Sanjoy,30,0,30,0
1668115380572,DSE 260A,A00,096916,Altintas De Callaf; Ilkay,30,0,30,0
1668115381003,ECE 200,001,103586,Antipa; Nicholas A,9999,0,9999,0
1668115381003,ECE 200,002,103587,Atanasov; Nikolay A.,9999,0,9999,0
1668115381003,ECE 200,003,103588,Bharadia; Dinesh,9999,0,9999,0
1668115381003,ECE 200,004,103589,Cheng; Chung Kuan,9999,0,9999,0
1668115381003,ECE 200,005,103590,Cosman; Pamela C.,9999,0,9999,0
1668115381003,ECE 200,006,103591,Dayeh; Shadi Ahmad,9999,0,9999,0
1668115381003,ECE 200,007,103592,Fainman; Yeshaiahu,9999,0,9999,0
1668115381003,ECE 200,008,103593,Ford; Joseph Earl,9999,0,9999,0
1668115381003,ECE 200,009,103594,Franceschetti; Massimo,9999,0,9999,0
1668115381003,ECE 200,010,103595,Fullerton; Eric E,9999,0,9999,0
1668115381003,ECE 200,011,103596,Galton; Ian A,9999,0,9999,0
1668115381003,ECE 200,012,103597,Gilja; Vikash,9999,0,9999,0
1668115381003,ECE 200,013,103598,Hall; Drew A.,9999,0,9999,0
1668115381003,ECE 200,014,103599,Hsueh; Tzu-Chien,9999,0,9999,0
1668115381003,ECE 200,015,103600,Javidi; Tara,9999,0,9999,0
1668115381003,ECE 200,016,103601,Kahng; Andrew Byun,9999,0,9999,0
1668115381003,ECE 200,017,103602,Kim; Young-Han,9999,0,9999,0
1668115381003,ECE 200,018,103603,Koushanfar; Farinaz,9999,0,9999,0
1668115381003,ECE 200,019,103604,Kuzum; Duygu,9999,0,9999,0
1668115381003,ECE 200,020,103605,Le; Hanh-Phuc,9999,0,9999,0
1668115381003,ECE 200,021,103606,Lin; Bill,9999,0,9999,0
1668115381003,ECE 200,022,103607,Liu; Zhaowei,9998,0,9999,1
1668115381003,ECE 200,023,103608,Lo; Yu-Hwa,9999,0,9999,0
1668115381003,ECE 200,024,103609,Lomakin; Vitaliy,9999,0,9999,0
1668115381003,ECE 200,025,103610,Mercier; Patrick Philip,9999,0,9999,0
1668115381003,ECE 200,026,103611,Meyer; Florian,9999,0,9999,0
1668115381003,ECE 200,027,103612,Milstein; Laurence B.,9999,0,9999,0
1668115381003,ECE 200,028,103613,Mir Arabbaygi; Siavash,9999,0,9999,0
1668115381003,ECE 200,029,103614,Mookherjea; Shayan,9999,0,9999,0
1668115381003,ECE 200,030,103615,Morris; Karcher William,9999,0,9999,0
1668115381003,ECE 200,031,103616,Ng; Tse Nga,9999,0,9999,0
1668115381003,ECE 200,032,103617,Nguyen; Truong Quang,9999,0,9999,0
1668115381003,ECE 200,033,103618,Nomura; Kenji,9999,0,9999,0
1668115381003,ECE 200,034,103619,Orlitsky; Alon,9999,0,9999,0
1668115381003,ECE 200,035,103620,Pal; Piya,9999,0,9999,0
1668115381003,ECE 200,036,103621,Papen; George C.,9999,0,9999,0
1668115381003,ECE 200,037,103622,Radic; Stojan,9999,0,9999,0
1668115381003,ECE 200,038,103623,Rao; Bhaskar D.,9999,0,9999,0
1668115381003,ECE 200,039,103624,Rao; Ramesh R,9999,0,9999,0
1668115381003,ECE 200,040,103625,Rebeiz; Gabriel,9999,0,9999,0
1668115381003,ECE 200,041,103626,Sanford; John R,9999,0,9999,0
1668115381003,ECE 200,042,103627,Siegel; Paul H.,9999,0,9999,0
1668115381003,ECE 200,043,103628,Sievenpiper; Daniel F.,9999,0,9999,0
1668115381003,ECE 200,044,103629,Sworder; David D.,9999,0,9999,0
1668115381003,ECE 200,045,103630,Taur; Yuan,9999,0,9999,0
1668115381003,ECE 200,046,103631,Touri; Behrouz,9999,0,9999,0
1668115381003,ECE 200,047,103632,Trivedi; Mohan M.,9999,0,9999,0
1668115381003,ECE 200,048,103633,Vasconcelos; Nuno,9999,0,9999,0
1668115381003,ECE 200,049,103634,Wang; Xiaolong,9999,0,9999,0
1668115381003,ECE 200,050,103635,Xie; Pengtao,9999,0,9999,0
1668115381003,ECE 200,051,103636,Yip; Michael,9999,0,9999,0
1668115381003,ECE 200,052,103637,Zeger; Kenneth A.,999,0,999,0
1668115381003,ECE 200,053,103638,Zhang; Xinyu,9999,0,9999,0
1668115381003,ECE 200,054,103639,Turakhia; Yatish Girish,9999,0,9999,0
1668115381003,ECE 200,055,103640,Kang; Mingu,9999,0,9999,0
1668115381003,ECE 200,056,103641,Shi; Yuanyuan,9999,0,9999,0
1668115381003,ECE 200,057,103642,Wang; Edward Jay,9999,0,9999,0
1668115381003,ECE 200,058,103643,Zheng; Yang,9999,0,9999,0
1668115381429,ECE 202,A00,103644,Kuzum; Duygu,0,0,0,0
1668115381851,ECE 212BN,A00,103646,Ng; Tse Nga,0,0,0,0
1668115382302,ECE 221,A00,111493,Staff,0,0,0,0
1668115382728,ECE 222B,A00,103647,Lomakin; Vitaliy,0,0,0,0
1668115383168,ECE 230B,A00,103648,Taur; Yuan,0,0,0,0
1668115383602,ECE 238B,A00,103649,Garay; Javier,0,0,0,0
1668115384034,ECE 240B,A00,112900,Fainman; Yeshaiahu,0,0,0,0
1668115384458,ECE 247A,A00,103650,Jokerst; Jesse Vincent,0,0,0,0
1668115384906,ECE 247B,A00,103651,Wang; Joseph,0,0,0,0
1668115385327,ECE 250,A00,103652,Siegel; Paul H.,0,0,0,0
1668115385752,ECE 251A,A00,103654,Rao; Bhaskar D.,0,0,0,0
1668115386174,ECE 257B,A00,103655,Bharadia; Dinesh,0,0,0,0
1668115386600,ECE 258A,A00,103656,Milstein; Laurence B.,0,0,0,0
1668115387037,ECE 260B,A00,103658,Kang; Mingu,0,0,0,0
1668115387476,ECE 264A,A00,103659,Galton; Ian A,0,0,0,0
1668115387909,ECE 265A,A00,103661,Gudem; Prasad S.S.,0,0,0,0
1668115388346,ECE 265D,A00,103662,Gudem; Prasad S.S.,0,0,0,0
1668115388772,ECE 268,A00,103663,Koushanfar; Farinaz,0,0,0,0
1668115389196,ECE 269,A01,103665,Pal; Piya,0,0,0,0
1668115389628,ECE 271B,A00,103666,Vasconcelos; Manuela,0,0,0,0
1668115390070,ECE 276A,A00,103667,Atanasov; Nikolay A.,0,0,0,0
1668115390498,ECE 277,A00,103668,An; Cheolhong,0,0,0,0
1668115390926,ECE 279,A00,117947,Hall; Drew A.,0,0,0,0
1668115391800,ECE 283,A00,103670,Hsueh; Tzu-Chien,0,0,0,0
1668115392223,ECE 284,A00,103671,Turakhia; Yatish Girish,0,0,0,0
1668115392766,ECE 285,A00,103672,Zheng; Yang,0,0,0,0
1668115392766,ECE 285,B00,103673,Sworder; David D.,0,0,0,0
1668115393192,ECE 287,A00,103676,Javidi; Tara,0,0,0,0
1668115393628,MATH 200B,A00,098023,Salehi Golsefidy; Alireza,12,0,15,3
1668115394053,MATH 202B,A00,098024,Rhoades; Brendon Patrick,9,0,15,6
1668115394488,MATH 203B,A00,098025,Oprea; Dragos N.,10,0,15,5
1668115394916,MATH 204B,A00,098026,Sorensen; Claus M,13,0,15,2
1668115395342,MATH 208,A00,098027,Izadi; Elham,7,0,10,3
1668115395779,MATH 209,A00,098028,Pollack; Aaron,10,0,10,0
1668115396202,MATH 211A,A00,112919,Rogalski; Daniel,9,0,10,1
1668115396627,MATH 211B,A00,112920,Seward; Brandon M.,9,0,10,1
1668115397054,MATH 218,A00,098029,Li; Bo,10,0,10,0
1668115397484,MATH 220B,A00,098030,Novak; Jonathan I,11,0,15,4
1668115397917,MATH 221A,A00,098031,Ebenfelt; Peter F,13,0,15,2
1668115398339,MATH 231B,A00,098032,Zlatos; Andrej,12,0,15,3
1668115398762,MATH 240B,A00,098033,Ni; Lei,9,0,15,6
1668115399193,MATH 243,A00,098034,Jekel; David Andrew,10,0,10,0
1668115399711,MATH 245A,A00,098035,Nie; Jiawang,0,0,15,16
1668115400137,MATH 248,A00,098036,Bejenaru; Ioan,10,0,10,0
1668115400559,MATH 250B,A00,098037,Spolaor; Luca,14,0,15,1
1668115400985,MATH 258,A00,098038,Ni; Lei,10,0,10,0
1668115401410,MATH 264B,A00,098041,Rhoades; Brendon Patrick,9,0,15,6
1668115401836,MATH 268,A00,098042,Buss; Samuel R,10,0,10,0
1668115402269,MATH 269,A00,098043,Rhoades; Brendon Patrick,10,0,10,0
1668115402693,MATH 270B,A00,098044,Li; Bo,10,0,15,5
1668115403131,MATH 272B,A00,098045,Holst; Michael J,13,0,15,2
1668115403561,MATH 273A,A00,098046,Tian; Xiaochuan,10,0,15,5
1668115403991,MATH 275,A01,098048,Tian; Xiaochuan,6,0,10,4
1668115404428,MATH 278A,A00,098049,Holst; Michael J,8,0,10,2
1668115404869,MATH 278B,A00,098050,Cloninger; Alexander,10,0,10,0
1668115405315,MATH 278C,A00,098051,Nie; Jiawang,7,0,10,3
1668115405739,MATH 280B,A00,098052,Zheng; Tianyi,10,0,15,5
1668115406168,MATH 281B,A00,098053,Bradic; Jelena,2,0,15,13
1668115406595,MATH 282B,A00,098054,Arias-Castro; Ery,0,0,15,15
1668115407051,MATH 285,A00,098055,Fitzsimmons; Patrick J,0,0,15,17
1668115407474,MATH 287B,A00,098056,Arias-Castro; Ery,3,0,15,12
1668115407902,MATH 288,A00,098057,Agarwal; Pooja,9,0,10,1
1668115407902,MATH 288,B00,098058,Zhang; Danna,8,0,10,2
1668115407902,MATH 288,C00,098059,Williams; Ruth J,10,0,10,0
1668115408335,MATH 290B,A00,098060,Roberts; Justin Deritter,13,0,15,2
1668115408760,MATH 292,A00,098061,Belmont; Eva Kinoshita,10,0,10,0
1668115409194,MATH 295,A00,098062,Suk; Andrew Hoon,48,0,50,2
1668115409614,MATH 296,A00,098063,Novak; Jonathan I,20,0,20,0
1668115410050,MATH 297,001,098064,Gamst; Anthony Collins,9997,0,9999,2
1668115915487,COGS 205,A00,101395,Chiba; Andrea,19,0,20,1
1668115915935,COGS 210B,001,101404,Greene; Deanna Jacquelyn,9998,0,9999,1
1668115915935,COGS 210B,002,101417,Xia; Haijun,9999,0,9999,0
1668115915935,COGS 210B,003,101422,Nitz; Douglas A.,9999,0,9999,0
1668115915935,COGS 210B,004,101423,Hollan; James D.,9998,0,9999,1
1668115915935,COGS 210B,005,101424,Deak; Gedeon O.,9998,0,9999,1
1668115915935,COGS 210B,006,101425,Rossano; Federico,9999,0,9999,0
1668115916359,COGS 211B,A00,101427,Coulson; Seana M,9996,0,9999,3
1668115916793,COGS 220,A00,101428,Hollan; James D.,0,0,25,25
1668115917217,COGS 229,A00,101429,Dow; Steven P,18,0,25,7
1668115917643,COGS 230,A00,101430,Klemmer; Scott R,12,0,17,5
1668115918080,COGS 234,A00,101431,Xia; Haijun,3,0,25,22
1668115918510,COGS 260,A00,101432,Kiyonaga; Anastasia,20,0,25,5
1668115918510,COGS 260,B00,101433,Kirsh; David Joel,16,0,25,9
1668115918944,CSE 202,A00,102371,Impagliazzo; Russell,0,0,0,0
1668115919370,CSE 203B,A01,102373,Cheng; Chung Kuan,0,0,0,0
1668115919805,CSE 208,A00,102374,Micciancio; Daniele,0,0,0,0
1668115920251,CSE 209A,A00,112895,Impagliazzo; Russell,0,0,15,15
1668115920688,CSE 209B,A00,108005,Bellare; Mihir,0,0,0,0
1668115921124,CSE 210,A00,113163,Coblenz; Michael J,0,0,0,0
1668115921545,CSE 219,A00,106111,Dow; Steven P,0,0,20,20
1668115921987,CSE 221,A00,102376,Voelker; Geoffrey M.,0,0,0,0
1668115922422,CSE 224,A01,102378,Porter; George M,0,0,0,0
1668115922849,CSE 229A,A00,102379,Savage; Stefan,0,0,0,0
1668115923272,CSE 229C,A00,102380,Munyaka; Imani N. S.,0,0,0,0
1668115923705,CSE 232B,A00,102382,Deutsch; Alin Bernard,0,0,0,0
1668115924131,CSE 234,A01,112904,Kumar; Arun Kumar,0,0,0,0
1668115924565,CSE 237A,A00,102383,Rosing; Tajana Simunic,0,0,0,0
1668115924987,CSE 239A,A00,102384,Deutsch; Alin Bernard,0,0,0,0
1668115925532,CSE 239B,A00,102385,Polikarpova; Nadezhda,0,0,0,0
1668115925958,CSE 240A,A00,102386,Pannuto; Patrick William,0,0,0,0
1668115926382,CSE 240B,A00,102387,Zhao; Jishen,0,0,0,0
1668115926805,CSE 241A,A00,106406,Kang; Mingu,0,0,0,0
1668115927234,CSE 249B,A00,102388,Kahng; Andrew Byun,0,0,8,8
1668115927663,CSE 251B,A01,102392,Cottrell; Garrison W,0,0,0,0
1668115927663,CSE 251B,A02,102393,Cottrell; Garrison W,0,0,0,0
1668115928090,CSE 252B,A00,102394,Ochoa; Benjamin Lawrence,0,0,0,0
1668115928514,CSE 257,A01,102396,Gao; Sicun,0,0,0,0
1668115928946,CSE 272,A00,102397,Li; Tzumao,0,0,0,0
1668115929375,CSE 274,A00,111323,Chern; Albert Ren-Haur,0,0,0,0
1668115929808,CSE 282,A00,102398,Pevzner; Pavel Arkadjevich,0,0,0,0
1668115930232,CSE 284,A00,114175,Gymrek; Melissa Ann,0,0,0,0
1668115930658,CSE 290,A00,102399,Chandraker; Manmohan Krishna,0,0,0,0
1668115930658,CSE 290,B00,102400,Vaccaro; Kristen Marie,0,0,25,25
1668115930658,CSE 290,C00,102414,Pannuto; Patrick William,0,0,25,25
1668115930658,CSE 290,D00,102427,Pevzner; Pavel Arkadjevich,0,0,0,0
1668115930658,CSE 290,E00,102429,Zhao; Jishen,0,0,0,0
1668115930658,CSE 290,F00,102436,Tullsen; Dean Michael,0,0,0,0
1668115930658,CSE 290,G00,102440,Christensen; Henrik I,0,0,20,20
1668115931098,CSE 291,A00,102443,Su; Hao,0,0,0,0
1668115931098,CSE 291,B00,102448,Polikarpova; Nadezhda,0,0,0,0
1668115931098,CSE 291,C00,102453,Vaccaro; Kristen Marie,0,0,0,0
1668115931098,CSE 291,D00,111343,Savage; Stefan,0,0,0,0
1668115931098,CSE 291,E00,116474,Claffy; Kimberly Claire,0,0,0,0
1668115931098,CSE 291,F00,116479,Pasquale; Joseph,0,0,0,0
1668115931525,CSE 293,001,119111,Bafna; Vineet,9999,0,9999,0
1668115931525,CSE 293,002,119118,Bellare; Mihir,9999,0,9999,0
1668115931525,CSE 293,003,119122,Berg-Kirkpatrick; Taylor D,9999,0,9999,0
1668115931525,CSE 293,004,119135,Christensen; Henrik I,9999,0,9999,0
1668115931525,CSE 293,005,119142,Cottrell; Garrison W,9999,0,9999,0
1668115931525,CSE 293,006,119146,Deutsch; Alin Bernard,9999,0,9999,0
1668115931525,CSE 293,007,119159,Esmaeilzadeh; Hadi,9999,0,9999,0
1668115931525,CSE 293,008,119166,Freund; Yoav,9999,0,9999,0
1668115931525,CSE 293,009,119170,Griswold; William G.,9999,0,9999,0
1668115931525,CSE 293,010,119183,Gymrek; Melissa Ann,9999,0,9999,0
1668115931525,CSE 293,011,119190,Heninger; Nadia A,9999,0,9999,0
1668115931525,CSE 293,012,119230,Impagliazzo; Russell,9999,0,9999,0
1668115931525,CSE 293,013,119232,Jhala; Ranjit,9999,0,9999,0
1668115931525,CSE 293,014,119233,Kahng; Andrew Byun,9999,0,9999,0
1668115931525,CSE 293,015,119298,Kane; Daniel Mertz,9999,0,9999,0
1668115931525,CSE 293,016,119299,Kriegman; David J,9999,0,9999,0
1668115931525,CSE 293,017,119300,Kumar; Arun Kumar,9999,0,9999,0
1668115931525,CSE 293,018,119301,Lerner; Sorin,9999,0,9999,0
1668115931525,CSE 293,019,119302,Lovett; Shachar,9999,0,9999,0
1668115931525,CSE 293,020,119303,McAuley; Julian John,9999,0,9999,0
1668115931525,CSE 293,021,119304,Micciancio; Daniele,9999,0,9999,0
1668115931525,CSE 293,022,119367,Orailoglu; Alex,9999,0,9999,0
1668115931525,CSE 293,023,119382,Paturi; Ramamohan,9999,0,9999,0
1668115931525,CSE 293,024,119404,Polikarpova; Nadezhda,9999,0,9999,0
1668115931525,CSE 293,025,119406,Politz; Joseph Gibbs,9999,0,9999,0
1668115931525,CSE 293,026,119411,Porter; George M,9999,0,9999,0
1668115931525,CSE 293,027,119414,Porter; Leonard Emerson,9999,0,9999,0
1668115931525,CSE 293,028,119416,Ramamoorthi; Ravi,9999,0,9999,0
1668115931525,CSE 293,029,119417,Sahoo; Debashis,9999,0,9999,0
1668115931525,CSE 293,030,119420,Saul; Lawrence,9999,0,9999,0
1668115931525,CSE 293,031,119421,Savage; Stefan,9999,0,9999,0
1668115931525,CSE 293,032,119425,Schulze; Jurgen P.,9999,0,9999,0
1668115931525,CSE 293,033,119426,Snoeren; Alex C.,9999,0,9999,0
1668115931525,CSE 293,034,119428,Shang; Jingbo,9999,0,9999,0
1668115931525,CSE 293,035,119430,Stefan; Deian,9999,0,9999,0
1668115931525,CSE 293,036,119431,Su; Hao,9999,0,9999,0
1668115931525,CSE 293,037,119433,Swanson; Steven James,9999,0,9999,0
1668115931525,CSE 293,038,119435,Tullsen; Dean Michael,9999,0,9999,0
1668115931525,CSE 293,039,119483,Voelker; Geoffrey M.,9999,0,9999,0
1668115931525,CSE 293,040,119537,Zhao; Jishen,9999,0,9999,0
1668115931525,CSE 293,041,119538,Zhou; Yuan-Yuan,9999,0,9999,0
1668115931525,CSE 293,042,119539,Gao; Sicun,9999,0,9999,0
1668115931525,CSE 293,043,119540,Weibel; Nadir,9999,0,9999,0
1668115931525,CSE 293,044,119541,Gupta; Rajesh K.,9999,0,9999,0
1668115931525,CSE 293,045,126410,Vaccaro; Kristen Marie,9999,0,9999,0
1668115931525,CSE 293,046,126411,Klemke; Richard,9999,0,9999,0
1668115931947,CSE 294,A00,102459,Voelker; Geoffrey M.,0,0,0,0
1668115931947,CSE 294,B00,111322,Orailoglu; Alex,0,0,0,0
1668115932370,DSE 201,A00,096914,Deutsch; Alin Bernard,30,0,30,0
1668115932797,DSE 210,A00,096915,Dasgupta; Sanjoy,30,0,30,0
1668115933225,DSE 260A,A00,096916,Altintas De Callaf; Ilkay,30,0,30,0
1668115933655,ECE 200,001,103586,Antipa; Nicholas A,9999,0,9999,0
1668115933655,ECE 200,002,103587,Atanasov; Nikolay A.,9999,0,9999,0
1668115933655,ECE 200,003,103588,Bharadia; Dinesh,9999,0,9999,0
1668115933655,ECE 200,004,103589,Cheng; Chung Kuan,9999,0,9999,0
1668115933655,ECE 200,005,103590,Cosman; Pamela C.,9999,0,9999,0
1668115933655,ECE 200,006,103591,Dayeh; Shadi Ahmad,9999,0,9999,0
1668115933655,ECE 200,007,103592,Fainman; Yeshaiahu,9999,0,9999,0
1668115933655,ECE 200,008,103593,Ford; Joseph Earl,9999,0,9999,0
1668115933655,ECE 200,009,103594,Franceschetti; Massimo,9999,0,9999,0
1668115933655,ECE 200,010,103595,Fullerton; Eric E,9999,0,9999,0
1668115933655,ECE 200,011,103596,Galton; Ian A,9999,0,9999,0
1668115933655,ECE 200,012,103597,Gilja; Vikash,9999,0,9999,0
1668115933655,ECE 200,013,103598,Hall; Drew A.,9999,0,9999,0
1668115933655,ECE 200,014,103599,Hsueh; Tzu-Chien,9999,0,9999,0
1668115933655,ECE 200,015,103600,Javidi; Tara,9999,0,9999,0
1668115933655,ECE 200,016,103601,Kahng; Andrew Byun,9999,0,9999,0
1668115933655,ECE 200,017,103602,Kim; Young-Han,9999,0,9999,0
1668115933655,ECE 200,018,103603,Koushanfar; Farinaz,9999,0,9999,0
1668115933655,ECE 200,019,103604,Kuzum; Duygu,9999,0,9999,0
1668115933655,ECE 200,020,103605,Le; Hanh-Phuc,9999,0,9999,0
1668115933655,ECE 200,021,103606,Lin; Bill,9999,0,9999,0
1668115933655,ECE 200,022,103607,Liu; Zhaowei,9998,0,9999,1
1668115933655,ECE 200,023,103608,Lo; Yu-Hwa,9999,0,9999,0
1668115933655,ECE 200,024,103609,Lomakin; Vitaliy,9999,0,9999,0
1668115933655,ECE 200,025,103610,Mercier; Patrick Philip,9999,0,9999,0
1668115933655,ECE 200,026,103611,Meyer; Florian,9999,0,9999,0
1668115933655,ECE 200,027,103612,Milstein; Laurence B.,9999,0,9999,0
1668115933655,ECE 200,028,103613,Mir Arabbaygi; Siavash,9999,0,9999,0
1668115933655,ECE 200,029,103614,Mookherjea; Shayan,9999,0,9999,0
1668115933655,ECE 200,030,103615,Morris; Karcher William,9999,0,9999,0
1668115933655,ECE 200,031,103616,Ng; Tse Nga,9999,0,9999,0
1668115933655,ECE 200,032,103617,Nguyen; Truong Quang,9999,0,9999,0
1668115933655,ECE 200,033,103618,Nomura; Kenji,9999,0,9999,0
1668115933655,ECE 200,034,103619,Orlitsky; Alon,9999,0,9999,0
1668115933655,ECE 200,035,103620,Pal; Piya,9999,0,9999,0
1668115933655,ECE 200,036,103621,Papen; George C.,9999,0,9999,0
1668115933655,ECE 200,037,103622,Radic; Stojan,9999,0,9999,0
1668115933655,ECE 200,038,103623,Rao; Bhaskar D.,9999,0,9999,0
1668115933655,ECE 200,039,103624,Rao; Ramesh R,9999,0,9999,0
1668115933655,ECE 200,040,103625,Rebeiz; Gabriel,9999,0,9999,0
1668115933655,ECE 200,041,103626,Sanford; John R,9999,0,9999,0
1668115933655,ECE 200,042,103627,Siegel; Paul H.,9999,0,9999,0
1668115933655,ECE 200,043,103628,Sievenpiper; Daniel F.,9999,0,9999,0
1668115933655,ECE 200,044,103629,Sworder; David D.,9999,0,9999,0
1668115933655,ECE 200,045,103630,Taur; Yuan,9999,0,9999,0
1668115933655,ECE 200,046,103631,Touri; Behrouz,9999,0,9999,0
1668115933655,ECE 200,047,103632,Trivedi; Mohan M.,9999,0,9999,0
1668115933655,ECE 200,048,103633,Vasconcelos; Nuno,9999,0,9999,0
1668115933655,ECE 200,049,103634,Wang; Xiaolong,9999,0,9999,0
1668115933655,ECE 200,050,103635,Xie; Pengtao,9999,0,9999,0
1668115933655,ECE 200,051,103636,Yip; Michael,9999,0,9999,0
1668115933655,ECE 200,052,103637,Zeger; Kenneth A.,999,0,999,0
1668115933655,ECE 200,053,103638,Zhang; Xinyu,9999,0,9999,0
1668115933655,ECE 200,054,103639,Turakhia; Yatish Girish,9999,0,9999,0
1668115933655,ECE 200,055,103640,Kang; Mingu,9999,0,9999,0
1668115933655,ECE 200,056,103641,Shi; Yuanyuan,9999,0,9999,0
1668115933655,ECE 200,057,103642,Wang; Edward Jay,9999,0,9999,0
1668115933655,ECE 200,058,103643,Zheng; Yang,9999,0,9999,0
1668115934087,ECE 202,A00,103644,Kuzum; Duygu,0,0,0,0
1668115934523,ECE 212BN,A00,103646,Ng; Tse Nga,0,0,0,0
1668115934962,ECE 221,A00,111493,Staff,0,0,0,0
1668115935394,ECE 222B,A00,103647,Lomakin; Vitaliy,0,0,0,0
1668115935835,ECE 230B,A00,103648,Taur; Yuan,0,0,0,0
1668115936269,ECE 238B,A00,103649,Garay; Javier,0,0,0,0
1668115936694,ECE 240B,A00,112900,Fainman; Yeshaiahu,0,0,0,0
1668115937127,ECE 247A,A00,103650,Jokerst; Jesse Vincent,0,0,0,0
1668115937551,ECE 247B,A00,103651,Wang; Joseph,0,0,0,0
1668115937977,ECE 250,A00,103652,Siegel; Paul H.,0,0,0,0
1668115938404,ECE 251A,A00,103654,Rao; Bhaskar D.,0,0,0,0
1668115938840,ECE 257B,A00,103655,Bharadia; Dinesh,0,0,0,0
1668115939273,ECE 258A,A00,103656,Milstein; Laurence B.,0,0,0,0
1668115939716,ECE 260B,A00,103658,Kang; Mingu,0,0,0,0
1668115940150,ECE 264A,A00,103659,Galton; Ian A,0,0,0,0
1668115940587,ECE 265A,A00,103661,Gudem; Prasad S.S.,0,0,0,0
1668115941013,ECE 265D,A00,103662,Gudem; Prasad S.S.,0,0,0,0
1668115941444,ECE 268,A00,103663,Koushanfar; Farinaz,0,0,0,0
1668115941892,ECE 269,A01,103665,Pal; Piya,0,0,0,0
1668115942317,ECE 271B,A00,103666,Vasconcelos; Manuela,0,0,0,0
1668115942741,ECE 276A,A00,103667,Atanasov; Nikolay A.,0,0,0,0
1668115943170,ECE 277,A00,103668,An; Cheolhong,0,0,0,0
1668115943593,ECE 279,A00,117947,Hall; Drew A.,0,0,0,0
1668115944461,ECE 283,A00,103670,Hsueh; Tzu-Chien,0,0,0,0
1668115944884,ECE 284,A00,103671,Turakhia; Yatish Girish,0,0,0,0
1668115945312,ECE 285,A00,103672,Zheng; Yang,0,0,0,0
1668115945312,ECE 285,B00,103673,Sworder; David D.,0,0,0,0
1668115945740,ECE 287,A00,103676,Javidi; Tara,0,0,0,0
1668115946177,MATH 200B,A00,098023,Salehi Golsefidy; Alireza,12,0,15,3
1668115946607,MATH 202B,A00,098024,Rhoades; Brendon Patrick,9,0,15,6
1668115947030,MATH 203B,A00,098025,Oprea; Dragos N.,10,0,15,5
1668115947462,MATH 204B,A00,098026,Sorensen; Claus M,13,0,15,2
1668115947893,MATH 208,A00,098027,Izadi; Elham,7,0,10,3
1668115948335,MATH 209,A00,098028,Pollack; Aaron,10,0,10,0
1668115948776,MATH 211A,A00,112919,Rogalski; Daniel,9,0,10,1
1668115949206,MATH 211B,A00,112920,Seward; Brandon M.,9,0,10,1
1668115949629,MATH 218,A00,098029,Li; Bo,10,0,10,0
1668115950052,MATH 220B,A00,098030,Novak; Jonathan I,11,0,15,4
1668115950478,MATH 221A,A00,098031,Ebenfelt; Peter F,13,0,15,2
1668115950909,MATH 231B,A00,098032,Zlatos; Andrej,12,0,15,3
1668115951335,MATH 240B,A00,098033,Ni; Lei,9,0,15,6
1668115951762,MATH 243,A00,098034,Jekel; David Andrew,10,0,10,0
1668115952193,MATH 245A,A00,098035,Nie; Jiawang,0,0,15,16
1668115952621,MATH 248,A00,098036,Bejenaru; Ioan,10,0,10,0
1668115953044,MATH 250B,A00,098037,Spolaor; Luca,14,0,15,1
1668115953476,MATH 258,A00,098038,Ni; Lei,10,0,10,0
1668115953909,MATH 264B,A00,098041,Rhoades; Brendon Patrick,9,0,15,6
1668115954350,MATH 268,A00,098042,Buss; Samuel R,10,0,10,0
1668115954791,MATH 269,A00,098043,Rhoades; Brendon Patrick,10,0,10,0
1668115955215,MATH 270B,A00,098044,Li; Bo,10,0,15,5
1668115955643,MATH 272B,A00,098045,Holst; Michael J,13,0,15,2
1668115956073,MATH 273A,A00,098046,Tian; Xiaochuan,10,0,15,5
1668115956513,MATH 275,A01,098048,Tian; Xiaochuan,6,0,10,4
1668115956946,MATH 278A,A00,098049,Holst; Michael J,8,0,10,2
1668115957373,MATH 278B,A00,098050,Cloninger; Alexander,10,0,10,0
1668115957815,MATH 278C,A00,098051,Nie; Jiawang,7,0,10,3
1668115958249,MATH 280B,A00,098052,Zheng; Tianyi,10,0,15,5
1668115958673,MATH 281B,A00,098053,Bradic; Jelena,2,0,15,13
1668115959098,MATH 282B,A00,098054,Arias-Castro; Ery,0,0,15,15
1668115959525,MATH 285,A00,098055,Fitzsimmons; Patrick J,0,0,15,17
1668115959952,MATH 287B,A00,098056,Arias-Castro; Ery,3,0,15,12
1668115960388,MATH 288,A00,098057,Agarwal; Pooja,9,0,10,1
1668115960388,MATH 288,B00,098058,Zhang; Danna,8,0,10,2
1668115960388,MATH 288,C00,098059,Williams; Ruth J,10,0,10,0
1668115960849,MATH 290B,A00,098060,Roberts; Justin Deritter,13,0,15,2
1668115961271,MATH 292,A00,098061,Belmont; Eva Kinoshita,10,0,10,0
1668115961709,MATH 295,A00,098062,Suk; Andrew Hoon,48,0,50,2
1668115962261,MATH 296,A00,098063,Novak; Jonathan I,20,0,20,0
1668115962689,MATH 297,001,098064,Gamst; Anthony Collins,9997,0,9999,2
1668116478559,COGS 205,A00,101395,Chiba; Andrea,19,0,20,1
1668116478990,COGS 210B,001,101404,Greene; Deanna Jacquelyn,9998,0,9999,1
1668116478990,COGS 210B,002,101417,Xia; Haijun,9999,0,9999,0
1668116478990,COGS 210B,003,101422,Nitz; Douglas A.,9999,0,9999,0
1668116478990,COGS 210B,004,101423,Hollan; James D.,9998,0,9999,1
1668116478990,COGS 210B,005,101424,Deak; Gedeon O.,9998,0,9999,1
1668116478990,COGS 210B,006,101425,Rossano; Federico,9999,0,9999,0
1668116479424,COGS 211B,A00,101427,Coulson; Seana M,9996,0,9999,3
1668116479852,COGS 220,A00,101428,Hollan; James D.,0,0,25,25
1668116480287,COGS 229,A00,101429,Dow; Steven P,18,0,25,7
1668116480714,COGS 230,A00,101430,Klemmer; Scott R,12,0,17,5
1668116481138,COGS 234,A00,101431,Xia; Haijun,3,0,25,22
1668116481571,COGS 260,A00,101432,Kiyonaga; Anastasia,20,0,25,5
1668116481571,COGS 260,B00,101433,Kirsh; David Joel,16,0,25,9
1668116482005,CSE 202,A00,102371,Impagliazzo; Russell,0,0,0,0
1668116482429,CSE 203B,A01,102373,Cheng; Chung Kuan,0,0,0,0
1668116482860,CSE 208,A00,102374,Micciancio; Daniele,0,0,0,0
1668116483294,CSE 209A,A00,112895,Impagliazzo; Russell,0,0,15,15
1668116483741,CSE 209B,A00,108005,Bellare; Mihir,0,0,0,0
1668116484173,CSE 210,A00,113163,Coblenz; Michael J,0,0,0,0
1668116484599,CSE 219,A00,106111,Dow; Steven P,0,0,20,20
1668116485031,CSE 221,A00,102376,Voelker; Geoffrey M.,0,0,0,0
1668116485460,CSE 224,A01,102378,Porter; George M,0,0,0,0
1668116485890,CSE 229A,A00,102379,Savage; Stefan,0,0,0,0
1668116486315,CSE 229C,A00,102380,Munyaka; Imani N. S.,0,0,0,0
1668116486741,CSE 232B,A00,102382,Deutsch; Alin Bernard,0,0,0,0
1668116487165,CSE 234,A01,112904,Kumar; Arun Kumar,0,0,0,0
1668116487586,CSE 237A,A00,102383,Rosing; Tajana Simunic,0,0,0,0
1668116488012,CSE 239A,A00,102384,Deutsch; Alin Bernard,0,0,0,0
1668116488450,CSE 239B,A00,102385,Polikarpova; Nadezhda,0,0,0,0
1668116488880,CSE 240A,A00,102386,Pannuto; Patrick William,0,0,0,0
1668116489302,CSE 240B,A00,102387,Zhao; Jishen,0,0,0,0
1668116489727,CSE 241A,A00,106406,Kang; Mingu,0,0,0,0
1668116490151,CSE 249B,A00,102388,Kahng; Andrew Byun,0,0,8,8
1668116490576,CSE 251B,A01,102392,Cottrell; Garrison W,0,0,0,0
1668116490576,CSE 251B,A02,102393,Cottrell; Garrison W,0,0,0,0
1668116490999,CSE 252B,A00,102394,Ochoa; Benjamin Lawrence,0,0,0,0
1668116491422,CSE 257,A01,102396,Gao; Sicun,0,0,0,0
1668116491844,CSE 272,A00,102397,Li; Tzumao,0,0,0,0
1668116492284,CSE 274,A00,111323,Chern; Albert Ren-Haur,0,0,0,0
1668116492708,CSE 282,A00,102398,Pevzner; Pavel Arkadjevich,0,0,0,0
1668116493132,CSE 284,A00,114175,Gymrek; Melissa Ann,0,0,0,0
1668116493554,CSE 290,A00,102399,Chandraker; Manmohan Krishna,0,0,0,0
1668116493554,CSE 290,B00,102400,Vaccaro; Kristen Marie,0,0,25,25
1668116493554,CSE 290,C00,102414,Pannuto; Patrick William,0,0,25,25
1668116493554,CSE 290,D00,102427,Pevzner; Pavel Arkadjevich,0,0,0,0
1668116493554,CSE 290,E00,102429,Zhao; Jishen,0,0,0,0
1668116493554,CSE 290,F00,102436,Tullsen; Dean Michael,0,0,0,0
1668116493554,CSE 290,G00,102440,Christensen; Henrik I,0,0,20,20
1668116493982,CSE 291,A00,102443,Su; Hao,0,0,0,0
1668116493982,CSE 291,B00,102448,Polikarpova; Nadezhda,0,0,0,0
1668116493982,CSE 291,C00,102453,Vaccaro; Kristen Marie,0,0,0,0
1668116493982,CSE 291,D00,111343,Savage; Stefan,0,0,0,0
1668116493982,CSE 291,E00,116474,Claffy; Kimberly Claire,0,0,0,0
1668116493982,CSE 291,F00,116479,Pasquale; Joseph,0,0,0,0
1668116494454,CSE 293,001,119111,Bafna; Vineet,9999,0,9999,0
1668116494454,CSE 293,002,119118,Bellare; Mihir,9999,0,9999,0
1668116494454,CSE 293,003,119122,Berg-Kirkpatrick; Taylor D,9999,0,9999,0
1668116494454,CSE 293,004,119135,Christensen; Henrik I,9999,0,9999,0
1668116494454,CSE 293,005,119142,Cottrell; Garrison W,9999,0,9999,0
1668116494454,CSE 293,006,119146,Deutsch; Alin Bernard,9999,0,9999,0
1668116494454,CSE 293,007,119159,Esmaeilzadeh; Hadi,9999,0,9999,0
1668116494454,CSE 293,008,119166,Freund; Yoav,9999,0,9999,0
1668116494454,CSE 293,009,119170,Griswold; William G.,9999,0,9999,0
1668116494454,CSE 293,010,119183,Gymrek; Melissa Ann,9999,0,9999,0
1668116494454,CSE 293,011,119190,Heninger; Nadia A,9999,0,9999,0
1668116494454,CSE 293,012,119230,Impagliazzo; Russell,9999,0,9999,0
1668116494454,CSE 293,013,119232,Jhala; Ranjit,9999,0,9999,0
1668116494454,CSE 293,014,119233,Kahng; Andrew Byun,9999,0,9999,0
1668116494454,CSE 293,015,119298,Kane; Daniel Mertz,9999,0,9999,0
1668116494454,CSE 293,016,119299,Kriegman; David J,9999,0,9999,0
1668116494454,CSE 293,017,119300,Kumar; Arun Kumar,9999,0,9999,0
1668116494454,CSE 293,018,119301,Lerner; Sorin,9999,0,9999,0
1668116494454,CSE 293,019,119302,Lovett; Shachar,9999,0,9999,0
1668116494454,CSE 293,020,119303,McAuley; Julian John,9999,0,9999,0
1668116494454,CSE 293,021,119304,Micciancio; Daniele,9999,0,9999,0
1668116494454,CSE 293,022,119367,Orailoglu; Alex,9999,0,9999,0
1668116494454,CSE 293,023,119382,Paturi; Ramamohan,9999,0,9999,0
1668116494454,CSE 293,024,119404,Polikarpova; Nadezhda,9999,0,9999,0
1668116494454,CSE 293,025,119406,Politz; Joseph Gibbs,9999,0,9999,0
1668116494454,CSE 293,026,119411,Porter; George M,9999,0,9999,0
1668116494454,CSE 293,027,119414,Porter; Leonard Emerson,9999,0,9999,0
1668116494454,CSE 293,028,119416,Ramamoorthi; Ravi,9999,0,9999,0
1668116494454,CSE 293,029,119417,Sahoo; Debashis,9999,0,9999,0
1668116494454,CSE 293,030,119420,Saul; Lawrence,9999,0,9999,0
1668116494454,CSE 293,031,119421,Savage; Stefan,9999,0,9999,0
1668116494454,CSE 293,032,119425,Schulze; Jurgen P.,9999,0,9999,0
1668116494454,CSE 293,033,119426,Snoeren; Alex C.,9999,0,9999,0
1668116494454,CSE 293,034,119428,Shang; Jingbo,9999,0,9999,0
1668116494454,CSE 293,035,119430,Stefan; Deian,9999,0,9999,0
1668116494454,CSE 293,036,119431,Su; Hao,9999,0,9999,0
1668116494454,CSE 293,037,119433,Swanson; Steven James,9999,0,9999,0
1668116494454,CSE 293,038,119435,Tullsen; Dean Michael,9999,0,9999,0
1668116494454,CSE 293,039,119483,Voelker; Geoffrey M.,9999,0,9999,0
1668116494454,CSE 293,040,119537,Zhao; Jishen,9999,0,9999,0
1668116494454,CSE 293,041,119538,Zhou; Yuan-Yuan,9999,0,9999,0
1668116494454,CSE 293,042,119539,Gao; Sicun,9999,0,9999,0
1668116494454,CSE 293,043,119540,Weibel; Nadir,9999,0,9999,0
1668116494454,CSE 293,044,119541,Gupta; Rajesh K.,9999,0,9999,0
1668116494454,CSE 293,045,126410,Vaccaro; Kristen Marie,9999,0,9999,0
1668116494454,CSE 293,046,126411,Klemke; Richard,9999,0,9999,0
1668116494884,CSE 294,A00,102459,Voelker; Geoffrey M.,0,0,0,0
1668116494884,CSE 294,B00,111322,Orailoglu; Alex,0,0,0,0
1668116495313,DSE 201,A00,096914,Deutsch; Alin Bernard,30,0,30,0
1668116495737,DSE 210,A00,096915,Dasgupta; Sanjoy,30,0,30,0
1668116496160,DSE 260A,A00,096916,Altintas De Callaf; Ilkay,30,0,30,0
1668116496591,ECE 200,001,103586,Antipa; Nicholas A,9999,0,9999,0
1668116496591,ECE 200,002,103587,Atanasov; Nikolay A.,9999,0,9999,0
1668116496591,ECE 200,003,103588,Bharadia; Dinesh,9999,0,9999,0
1668116496591,ECE 200,004,103589,Cheng; Chung Kuan,9999,0,9999,0
1668116496591,ECE 200,005,103590,Cosman; Pamela C.,9999,0,9999,0
1668116496591,ECE 200,006,103591,Dayeh; Shadi Ahmad,9999,0,9999,0
1668116496591,ECE 200,007,103592,Fainman; Yeshaiahu,9999,0,9999,0
1668116496591,ECE 200,008,103593,Ford; Joseph Earl,9999,0,9999,0
1668116496591,ECE 200,009,103594,Franceschetti; Massimo,9999,0,9999,0
1668116496591,ECE 200,010,103595,Fullerton; Eric E,9999,0,9999,0
1668116496591,ECE 200,011,103596,Galton; Ian A,9999,0,9999,0
1668116496591,ECE 200,012,103597,Gilja; Vikash,9999,0,9999,0
1668116496591,ECE 200,013,103598,Hall; Drew A.,9999,0,9999,0
1668116496591,ECE 200,014,103599,Hsueh; Tzu-Chien,9999,0,9999,0
1668116496591,ECE 200,015,103600,Javidi; Tara,9999,0,9999,0
1668116496591,ECE 200,016,103601,Kahng; Andrew Byun,9999,0,9999,0
1668116496591,ECE 200,017,103602,Kim; Young-Han,9999,0,9999,0
1668116496591,ECE 200,018,103603,Koushanfar; Farinaz,9999,0,9999,0
1668116496591,ECE 200,019,103604,Kuzum; Duygu,9999,0,9999,0
1668116496591,ECE 200,020,103605,Le; Hanh-Phuc,9999,0,9999,0
1668116496591,ECE 200,021,103606,Lin; Bill,9999,0,9999,0
1668116496591,ECE 200,022,103607,Liu; Zhaowei,9998,0,9999,1
1668116496591,ECE 200,023,103608,Lo; Yu-Hwa,9999,0,9999,0
1668116496591,ECE 200,024,103609,Lomakin; Vitaliy,9999,0,9999,0
1668116496591,ECE 200,025,103610,Mercier; Patrick Philip,9999,0,9999,0
1668116496591,ECE 200,026,103611,Meyer; Florian,9999,0,9999,0
1668116496591,ECE 200,027,103612,Milstein; Laurence B.,9999,0,9999,0
1668116496591,ECE 200,028,103613,Mir Arabbaygi; Siavash,9999,0,9999,0
1668116496591,ECE 200,029,103614,Mookherjea; Shayan,9999,0,9999,0
1668116496591,ECE 200,030,103615,Morris; Karcher William,9999,0,9999,0
1668116496591,ECE 200,031,103616,Ng; Tse Nga,9999,0,9999,0
1668116496591,ECE 200,032,103617,Nguyen; Truong Quang,9999,0,9999,0
1668116496591,ECE 200,033,103618,Nomura; Kenji,9999,0,9999,0
1668116496591,ECE 200,034,103619,Orlitsky; Alon,9999,0,9999,0
1668116496591,ECE 200,035,103620,Pal; Piya,9999,0,9999,0
1668116496591,ECE 200,036,103621,Papen; George C.,9999,0,9999,0
1668116496591,ECE 200,037,103622,Radic; Stojan,9999,0,9999,0
1668116496591,ECE 200,038,103623,Rao; Bhaskar D.,9999,0,9999,0
1668116496591,ECE 200,039,103624,Rao; Ramesh R,9999,0,9999,0
1668116496591,ECE 200,040,103625,Rebeiz; Gabriel,9999,0,9999,0
1668116496591,ECE 200,041,103626,Sanford; John R,9999,0,9999,0
1668116496591,ECE 200,042,103627,Siegel; Paul H.,9999,0,9999,0
1668116496591,ECE 200,043,103628,Sievenpiper; Daniel F.,9999,0,9999,0
1668116496591,ECE 200,044,103629,Sworder; David D.,9999,0,9999,0
1668116496591,ECE 200,045,103630,Taur; Yuan,9999,0,9999,0
1668116496591,ECE 200,046,103631,Touri; Behrouz,9999,0,9999,0
1668116496591,ECE 200,047,103632,Trivedi; Mohan M.,9999,0,9999,0
1668116496591,ECE 200,048,103633,Vasconcelos; Nuno,9999,0,9999,0
1668116496591,ECE 200,049,103634,Wang; Xiaolong,9999,0,9999,0
1668116496591,ECE 200,050,103635,Xie; Pengtao,9999,0,9999,0
1668116496591,ECE 200,051,103636,Yip; Michael,9999,0,9999,0
1668116496591,ECE 200,052,103637,Zeger; Kenneth A.,999,0,999,0
1668116496591,ECE 200,053,103638,Zhang; Xinyu,9999,0,9999,0
1668116496591,ECE 200,054,103639,Turakhia; Yatish Girish,9999,0,9999,0
1668116496591,ECE 200,055,103640,Kang; Mingu,9999,0,9999,0
1668116496591,ECE 200,056,103641,Shi; Yuanyuan,9999,0,9999,0
1668116496591,ECE 200,057,103642,Wang; Edward Jay,9999,0,9999,0
1668116496591,ECE 200,058,103643,Zheng; Yang,9999,0,9999,0
1668116497021,ECE 202,A00,103644,Kuzum; Duygu,0,0,0,0
1668116497448,ECE 212BN,A00,103646,Ng; Tse Nga,0,0,0,0
1668116497876,ECE 221,A00,111493,Staff,0,0,0,0
1668116498322,ECE 222B,A00,103647,Lomakin; Vitaliy,0,0,0,0
1668116498762,ECE 230B,A00,103648,Taur; Yuan,0,0,0,0
1668116499185,ECE 238B,A00,103649,Garay; Javier,0,0,0,0
1668116499608,ECE 240B,A00,112900,Fainman; Yeshaiahu,0,0,0,0
1668116500033,ECE 247A,A00,103650,Jokerst; Jesse Vincent,0,0,0,0
1668116500463,ECE 247B,A00,103651,Wang; Joseph,0,0,0,0
1668116500902,ECE 250,A00,103652,Siegel; Paul H.,0,0,0,0
1668116501339,ECE 251A,A00,103654,Rao; Bhaskar D.,0,0,0,0
1668116501766,ECE 257B,A00,103655,Bharadia; Dinesh,0,0,0,0
1668116502201,ECE 258A,A00,103656,Milstein; Laurence B.,0,0,0,0
1668116502633,ECE 260B,A00,103658,Kang; Mingu,0,0,0,0
1668116503059,ECE 264A,A00,103659,Galton; Ian A,0,0,0,0
1668116503489,ECE 265A,A00,103661,Gudem; Prasad S.S.,0,0,0,0
1668116503922,ECE 265D,A00,103662,Gudem; Prasad S.S.,0,0,0,0
1668116504357,ECE 268,A00,103663,Koushanfar; Farinaz,0,0,0,0
1668116504782,ECE 269,A01,103665,Pal; Piya,0,0,0,0
1668116505293,ECE 271B,A00,103666,Vasconcelos; Manuela,0,0,0,0
1668116505718,ECE 276A,A00,103667,Atanasov; Nikolay A.,0,0,0,0
1668116506141,ECE 277,A00,103668,An; Cheolhong,0,0,0,0
1668116506570,ECE 279,A00,117947,Hall; Drew A.,0,0,0,0
1668116507422,ECE 283,A00,103670,Hsueh; Tzu-Chien,0,0,0,0
1668116507846,ECE 284,A00,103671,Turakhia; Yatish Girish,0,0,0,0
1668116508286,ECE 285,A00,103672,Zheng; Yang,0,0,0,0
1668116508286,ECE 285,B00,103673,Sworder; David D.,0,0,0,0
1668116508711,ECE 287,A00,103676,Javidi; Tara,0,0,0,0
1668116509142,MATH 200B,A00,098023,Salehi Golsefidy; Alireza,12,0,15,3
1668116509578,MATH 202B,A00,098024,Rhoades; Brendon Patrick,9,0,15,6
1668116510006,MATH 203B,A00,098025,Oprea; Dragos N.,10,0,15,5
1668116510429,MATH 204B,A00,098026,Sorensen; Claus M,13,0,15,2
1668116510858,MATH 208,A00,098027,Izadi; Elham,7,0,10,3
1668116511280,MATH 209,A00,098028,Pollack; Aaron,10,0,10,0
1668116511704,MATH 211A,A00,112919,Rogalski; Daniel,9,0,10,1
1668116512130,MATH 211B,A00,112920,Seward; Brandon M.,9,0,10,1
1668116512573,MATH 218,A00,098029,Li; Bo,10,0,10,0
1668116513015,MATH 220B,A00,098030,Novak; Jonathan I,11,0,15,4
1668116513441,MATH 221A,A00,098031,Ebenfelt; Peter F,13,0,15,2
1668116513870,MATH 231B,A00,098032,Zlatos; Andrej,12,0,15,3
1668116514295,MATH 240B,A00,098033,Ni; Lei,9,0,15,6
1668116514722,MATH 243,A00,098034,Jekel; David Andrew,10,0,10,0
1668116515148,MATH 245A,A00,098035,Nie; Jiawang,0,0,15,16
1668116515570,MATH 248,A00,098036,Bejenaru; Ioan,10,0,10,0
1668116515994,MATH 250B,A00,098037,Spolaor; Luca,14,0,15,1
1668116516423,MATH 258,A00,098038,Ni; Lei,10,0,10,0
1668116516847,MATH 264B,A00,098041,Rhoades; Brendon Patrick,9,0,15,6
1668116517274,MATH 268,A00,098042,Buss; Samuel R,10,0,10,0
1668116517702,MATH 269,A00,098043,Rhoades; Brendon Patrick,10,0,10,0
1668116518135,MATH 270B,A00,098044,Li; Bo,10,0,15,5
1668116518568,MATH 272B,A00,098045,Holst; Michael J,13,0,15,2
1668116518992,MATH 273A,A00,098046,Tian; Xiaochuan,10,0,15,5
1668116519416,MATH 275,A01,098048,Tian; Xiaochuan,6,0,10,4
1668116519840,MATH 278A,A00,098049,Holst; Michael J,8,0,10,2
1668116520274,MATH 278B,A00,098050,Cloninger; Alexander,10,0,10,0
1668116520706,MATH 278C,A00,098051,Nie; Jiawang,7,0,10,3
1668116521127,MATH 280B,A00,098052,Zheng; Tianyi,10,0,15,5
1668116521558,MATH 281B,A00,098053,Bradic; Jelena,2,0,15,13
1668116521981,MATH 282B,A00,098054,Arias-Castro; Ery,0,0,15,15
1668116522407,MATH 285,A00,098055,Fitzsimmons; Patrick J,0,0,15,17
1668116522830,MATH 287B,A00,098056,Arias-Castro; Ery,3,0,15,12
1668116523257,MATH 288,A00,098057,Agarwal; Pooja,9,0,10,1
1668116523257,MATH 288,B00,098058,Zhang; Danna,8,0,10,2
1668116523257,MATH 288,C00,098059,Williams; Ruth J,10,0,10,0
1668116523687,MATH 290B,A00,098060,Roberts; Justin Deritter,13,0,15,2
1668116524111,MATH 292,A00,098061,Belmont; Eva Kinoshita,10,0,10,0
1668116524541,MATH 295,A00,098062,Suk; Andrew Hoon,48,0,50,2
1668116524965,MATH 296,A00,098063,Novak; Jonathan I,20,0,20,0
1668116525389,MATH 297,001,098064,Gamst; Anthony Collins,9997,0,9999,2
1668117031023,COGS 205,A00,101395,Chiba; Andrea,19,0,20,1
1668117031467,COGS 210B,001,101404,Greene; Deanna Jacquelyn,9998,0,9999,1
1668117031467,COGS 210B,002,101417,Xia; Haijun,9999,0,9999,0
1668117031467,COGS 210B,003,101422,Nitz; Douglas A.,9999,0,9999,0
1668117031467,COGS 210B,004,101423,Hollan; James D.,9998,0,9999,1
1668117031467,COGS 210B,005,101424,Deak; Gedeon O.,9998,0,9999,1
1668117031467,COGS 210B,006,101425,Rossano; Federico,9999,0,9999,0
1668117031891,COGS 211B,A00,101427,Coulson; Seana M,9996,0,9999,3
1668117032314,COGS 220,A00,101428,Hollan; James D.,0,0,25,25
1668117032741,COGS 229,A00,101429,Dow; Steven P,18,0,25,7
1668117033172,COGS 230,A00,101430,Klemmer; Scott R,12,0,17,5
1668117033597,COGS 234,A00,101431,Xia; Haijun,3,0,25,22
1668117034031,COGS 260,A00,101432,Kiyonaga; Anastasia,20,0,25,5
1668117034031,COGS 260,B00,101433,Kirsh; David Joel,16,0,25,9
1668117034463,CSE 202,A00,102371,Impagliazzo; Russell,0,0,0,0
1668117034903,CSE 203B,A01,102373,Cheng; Chung Kuan,0,0,0,0
1668117035326,CSE 208,A00,102374,Micciancio; Daniele,0,0,0,0
1668117035752,CSE 209A,A00,112895,Impagliazzo; Russell,0,0,15,15
1668117036191,CSE 209B,A00,108005,Bellare; Mihir,0,0,0,0
1668117036617,CSE 210,A00,113163,Coblenz; Michael J,0,0,0,0
1668117037043,CSE 219,A00,106111,Dow; Steven P,0,0,20,20
1668117037467,CSE 221,A00,102376,Voelker; Geoffrey M.,0,0,0,0
1668117037900,CSE 224,A01,102378,Porter; George M,0,0,0,0
1668117038323,CSE 229A,A00,102379,Savage; Stefan,0,0,0,0
1668117038745,CSE 229C,A00,102380,Munyaka; Imani N. S.,0,0,0,0
1668117039168,CSE 232B,A00,102382,Deutsch; Alin Bernard,0,0,0,0
1668117039593,CSE 234,A01,112904,Kumar; Arun Kumar,0,0,0,0
1668117040019,CSE 237A,A00,102383,Rosing; Tajana Simunic,0,0,0,0
1668117040440,CSE 239A,A00,102384,Deutsch; Alin Bernard,0,0,0,0
1668117040863,CSE 239B,A00,102385,Polikarpova; Nadezhda,0,0,0,0
1668117041290,CSE 240A,A00,102386,Pannuto; Patrick William,0,0,0,0
1668117041712,CSE 240B,A00,102387,Zhao; Jishen,0,0,0,0
1668117042139,CSE 241A,A00,106406,Kang; Mingu,0,0,0,0
1668117042562,CSE 249B,A00,102388,Kahng; Andrew Byun,0,0,8,8
1668117043023,CSE 251B,A01,102392,Cottrell; Garrison W,0,0,0,0
1668117043023,CSE 251B,A02,102393,Cottrell; Garrison W,0,0,0,0
1668117043451,CSE 252B,A00,102394,Ochoa; Benjamin Lawrence,0,0,0,0
1668117043878,CSE 257,A01,102396,Gao; Sicun,0,0,0,0
1668117044313,CSE 272,A00,102397,Li; Tzumao,0,0,0,0
1668117044742,CSE 274,A00,111323,Chern; Albert Ren-Haur,0,0,0,0
1668117045170,CSE 282,A00,102398,Pevzner; Pavel Arkadjevich,0,0,0,0
1668117045598,CSE 284,A00,114175,Gymrek; Melissa Ann,0,0,0,0
1668117046020,CSE 290,A00,102399,Chandraker; Manmohan Krishna,0,0,0,0
1668117046020,CSE 290,B00,102400,Vaccaro; Kristen Marie,0,0,25,25
1668117046020,CSE 290,C00,102414,Pannuto; Patrick William,0,0,25,25
1668117046020,CSE 290,D00,102427,Pevzner; Pavel Arkadjevich,0,0,0,0
1668117046020,CSE 290,E00,102429,Zhao; Jishen,0,0,0,0
1668117046020,CSE 290,F00,102436,Tullsen; Dean Michael,0,0,0,0
1668117046020,CSE 290,G00,102440,Christensen; Henrik I,0,0,20,20
1668117046453,CSE 291,A00,102443,Su; Hao,0,0,0,0
1668117046453,CSE 291,B00,102448,Polikarpova; Nadezhda,0,0,0,0
1668117046453,CSE 291,C00,102453,Vaccaro; Kristen Marie,0,0,0,0
1668117046453,CSE 291,D00,111343,Savage; Stefan,0,0,0,0
1668117046453,CSE 291,E00,116474,Claffy; Kimberly Claire,0,0,0,0
1668117046453,CSE 291,F00,116479,Pasquale; Joseph,0,0,0,0
1668117046886,CSE 293,001,119111,Bafna; Vineet,9999,0,9999,0
1668117046886,CSE 293,002,119118,Bellare; Mihir,9999,0,9999,0
1668117046886,CSE 293,003,119122,Berg-Kirkpatrick; Taylor D,9999,0,9999,0
1668117046886,CSE 293,004,119135,Christensen; Henrik I,9999,0,9999,0
1668117046886,CSE 293,005,119142,Cottrell; Garrison W,9999,0,9999,0
1668117046886,CSE 293,006,119146,Deutsch; Alin Bernard,9999,0,9999,0
1668117046886,CSE 293,007,119159,Esmaeilzadeh; Hadi,9999,0,9999,0
1668117046886,CSE 293,008,119166,Freund; Yoav,9999,0,9999,0
1668117046886,CSE 293,009,119170,Griswold; William G.,9999,0,9999,0
1668117046886,CSE 293,010,119183,Gymrek; Melissa Ann,9999,0,9999,0
1668117046886,CSE 293,011,119190,Heninger; Nadia A,9999,0,9999,0
1668117046886,CSE 293,012,119230,Impagliazzo; Russell,9999,0,9999,0
1668117046886,CSE 293,013,119232,Jhala; Ranjit,9999,0,9999,0
1668117046886,CSE 293,014,119233,Kahng; Andrew Byun,9999,0,9999,0
1668117046886,CSE 293,015,119298,Kane; Daniel Mertz,9999,0,9999,0
1668117046886,CSE 293,016,119299,Kriegman; David J,9999,0,9999,0
1668117046886,CSE 293,017,119300,Kumar; Arun Kumar,9999,0,9999,0
1668117046886,CSE 293,018,119301,Lerner; Sorin,9999,0,9999,0
1668117046886,CSE 293,019,119302,Lovett; Shachar,9999,0,9999,0
1668117046886,CSE 293,020,119303,McAuley; Julian John,9999,0,9999,0
1668117046886,CSE 293,021,119304,Micciancio; Daniele,9999,0,9999,0
1668117046886,CSE 293,022,119367,Orailoglu; Alex,9999,0,9999,0
1668117046886,CSE 293,023,119382,Paturi; Ramamohan,9999,0,9999,0
1668117046886,CSE 293,024,119404,Polikarpova; Nadezhda,9999,0,9999,0
1668117046886,CSE 293,025,119406,Politz; Joseph Gibbs,9999,0,9999,0
1668117046886,CSE 293,026,119411,Porter; George M,9999,0,9999,0
1668117046886,CSE 293,027,119414,Porter; Leonard Emerson,9999,0,9999,0
1668117046886,CSE 293,028,119416,Ramamoorthi; Ravi,9999,0,9999,0
1668117046886,CSE 293,029,119417,Sahoo; Debashis,9999,0,9999,0
1668117046886,CSE 293,030,119420,Saul; Lawrence,9999,0,9999,0
1668117046886,CSE 293,031,119421,Savage; Stefan,9999,0,9999,0
1668117046886,CSE 293,032,119425,Schulze; Jurgen P.,9999,0,9999,0
1668117046886,CSE 293,033,119426,Snoeren; Alex C.,9999,0,9999,0
1668117046886,CSE 293,034,119428,Shang; Jingbo,9999,0,9999,0
1668117046886,CSE 293,035,119430,Stefan; Deian,9999,0,9999,0
1668117046886,CSE 293,036,119431,Su; Hao,9999,0,9999,0
1668117046886,CSE 293,037,119433,Swanson; Steven James,9999,0,9999,0
1668117046886,CSE 293,038,119435,Tullsen; Dean Michael,9999,0,9999,0
1668117046886,CSE 293,039,119483,Voelker; Geoffrey M.,9999,0,9999,0
1668117046886,CSE 293,040,119537,Zhao; Jishen,9999,0,9999,0
1668117046886,CSE 293,041,119538,Zhou; Yuan-Yuan,9999,0,9999,0
1668117046886,CSE 293,042,119539,Gao; Sicun,9999,0,9999,0
1668117046886,CSE 293,043,119540,Weibel; Nadir,9999,0,9999,0
1668117046886,CSE 293,044,119541,Gupta; Rajesh K.,9999,0,9999,0
1668117046886,CSE 293,045,126410,Vaccaro; Kristen Marie,9999,0,9999,0
1668117046886,CSE 293,046,126411,Klemke; Richard,9999,0,9999,0
1668117047324,CSE 294,A00,102459,Voelker; Geoffrey M.,0,0,0,0
1668117047324,CSE 294,B00,111322,Orailoglu; Alex,0,0,0,0
1668117047752,DSE 201,A00,096914,Deutsch; Alin Bernard,30,0,30,0
1668117048190,DSE 210,A00,096915,Dasgupta; Sanjoy,30,0,30,0
1668117048620,DSE 260A,A00,096916,Altintas De Callaf; Ilkay,30,0,30,0
1668117049054,ECE 200,001,103586,Antipa; Nicholas A,9999,0,9999,0
1668117049054,ECE 200,002,103587,Atanasov; Nikolay A.,9999,0,9999,0
1668117049054,ECE 200,003,103588,Bharadia; Dinesh,9999,0,9999,0
1668117049054,ECE 200,004,103589,Cheng; Chung Kuan,9999,0,9999,0
1668117049054,ECE 200,005,103590,Cosman; Pamela C.,9999,0,9999,0
1668117049054,ECE 200,006,103591,Dayeh; Shadi Ahmad,9999,0,9999,0
1668117049054,ECE 200,007,103592,Fainman; Yeshaiahu,9999,0,9999,0
1668117049054,ECE 200,008,103593,Ford; Joseph Earl,9999,0,9999,0
1668117049054,ECE 200,009,103594,Franceschetti; Massimo,9999,0,9999,0
1668117049054,ECE 200,010,103595,Fullerton; Eric E,9999,0,9999,0
1668117049054,ECE 200,011,103596,Galton; Ian A,9999,0,9999,0
1668117049054,ECE 200,012,103597,Gilja; Vikash,9999,0,9999,0
1668117049054,ECE 200,013,103598,Hall; Drew A.,9999,0,9999,0
1668117049054,ECE 200,014,103599,Hsueh; Tzu-Chien,9999,0,9999,0
1668117049054,ECE 200,015,103600,Javidi; Tara,9999,0,9999,0
1668117049054,ECE 200,016,103601,Kahng; Andrew Byun,9999,0,9999,0
1668117049054,ECE 200,017,103602,Kim; Young-Han,9999,0,9999,0
1668117049054,ECE 200,018,103603,Koushanfar; Farinaz,9999,0,9999,0
1668117049054,ECE 200,019,103604,Kuzum; Duygu,9999,0,9999,0
1668117049054,ECE 200,020,103605,Le; Hanh-Phuc,9999,0,9999,0
1668117049054,ECE 200,021,103606,Lin; Bill,9999,0,9999,0
1668117049054,ECE 200,022,103607,Liu; Zhaowei,9998,0,9999,1
1668117049054,ECE 200,023,103608,Lo; Yu-Hwa,9999,0,9999,0
1668117049054,ECE 200,024,103609,Lomakin; Vitaliy,9999,0,9999,0
1668117049054,ECE 200,025,103610,Mercier; Patrick Philip,9999,0,9999,0
1668117049054,ECE 200,026,103611,Meyer; Florian,9999,0,9999,0
1668117049054,ECE 200,027,103612,Milstein; Laurence B.,9999,0,9999,0
1668117049054,ECE 200,028,103613,Mir Arabbaygi; Siavash,9999,0,9999,0
1668117049054,ECE 200,029,103614,Mookherjea; Shayan,9999,0,9999,0
1668117049054,ECE 200,030,103615,Morris; Karcher William,9999,0,9999,0
1668117049054,ECE 200,031,103616,Ng; Tse Nga,9999,0,9999,0
1668117049054,ECE 200,032,103617,Nguyen; Truong Quang,9999,0,9999,0
1668117049054,ECE 200,033,103618,Nomura; Kenji,9999,0,9999,0
1668117049054,ECE 200,034,103619,Orlitsky; Alon,9999,0,9999,0
1668117049054,ECE 200,035,103620,Pal; Piya,9999,0,9999,0
1668117049054,ECE 200,036,103621,Papen; George C.,9999,0,9999,0
1668117049054,ECE 200,037,103622,Radic; Stojan,9999,0,9999,0
1668117049054,ECE 200,038,103623,Rao; Bhaskar D.,9999,0,9999,0
1668117049054,ECE 200,039,103624,Rao; Ramesh R,9999,0,9999,0
1668117049054,ECE 200,040,103625,Rebeiz; Gabriel,9999,0,9999,0
1668117049054,ECE 200,041,103626,Sanford; John R,9999,0,9999,0
1668117049054,ECE 200,042,103627,Siegel; Paul H.,9999,0,9999,0
1668117049054,ECE 200,043,103628,Sievenpiper; Daniel F.,9999,0,9999,0
1668117049054,ECE 200,044,103629,Sworder; David D.,9999,0,9999,0
1668117049054,ECE 200,045,103630,Taur; Yuan,9999,0,9999,0
1668117049054,ECE 200,046,103631,Touri; Behrouz,9999,0,9999,0
1668117049054,ECE 200,047,103632,Trivedi; Mohan M.,9999,0,9999,0
1668117049054,ECE 200,048,103633,Vasconcelos; Nuno,9999,0,9999,0
1668117049054,ECE 200,049,103634,Wang; Xiaolong,9999,0,9999,0
1668117049054,ECE 200,050,103635,Xie; Pengtao,9999,0,9999,0
1668117049054,ECE 200,051,103636,Yip; Michael,9999,0,9999,0
1668117049054,ECE 200,052,103637,Zeger; Kenneth A.,999,0,999,0
1668117049054,ECE 200,053,103638,Zhang; Xinyu,9999,0,9999,0
1668117049054,ECE 200,054,103639,Turakhia; Yatish Girish,9999,0,9999,0
1668117049054,ECE 200,055,103640,Kang; Mingu,9999,0,9999,0
1668117049054,ECE 200,056,103641,Shi; Yuanyuan,9999,0,9999,0
1668117049054,ECE 200,057,103642,Wang; Edward Jay,9999,0,9999,0
1668117049054,ECE 200,058,103643,Zheng; Yang,9999,0,9999,0
1668117049478,ECE 202,A00,103644,Kuzum; Duygu,0,0,0,0
1668117050064,ECE 212BN,A00,103646,Ng; Tse Nga,0,0,0,0
1668117050489,ECE 221,A00,111493,Staff,0,0,0,0
1668117050920,ECE 222B,A00,103647,Lomakin; Vitaliy,0,0,0,0
1668117051353,ECE 230B,A00,103648,Taur; Yuan,0,0,0,0
1668117051780,ECE 238B,A00,103649,Garay; Javier,0,0,0,0
1668117052209,ECE 240B,A00,112900,Fainman; Yeshaiahu,0,0,0,0
1668117052632,ECE 247A,A00,103650,Jokerst; Jesse Vincent,0,0,0,0
1668117053056,ECE 247B,A00,103651,Wang; Joseph,0,0,0,0
1668117053481,ECE 250,A00,103652,Siegel; Paul H.,0,0,0,0
1668117053907,ECE 251A,A00,103654,Rao; Bhaskar D.,0,0,0,0
1668117054328,ECE 257B,A00,103655,Bharadia; Dinesh,0,0,0,0
1668117054753,ECE 258A,A00,103656,Milstein; Laurence B.,0,0,0,0
1668117055178,ECE 260B,A00,103658,Kang; Mingu,0,0,0,0
1668117055605,ECE 264A,A00,103659,Galton; Ian A,0,0,0,0
1668117056043,ECE 265A,A00,103661,Gudem; Prasad S.S.,0,0,0,0
1668117056493,ECE 265D,A00,103662,Gudem; Prasad S.S.,0,0,0,0
1668117056926,ECE 268,A00,103663,Koushanfar; Farinaz,0,0,0,0
1668117057359,ECE 269,A01,103665,Pal; Piya,0,0,0,0
1668117057787,ECE 271B,A00,103666,Vasconcelos; Manuela,0,0,0,0
1668117058211,ECE 276A,A00,103667,Atanasov; Nikolay A.,0,0,0,0
1668117058642,ECE 277,A00,103668,An; Cheolhong,0,0,0,0
1668117059074,ECE 279,A00,117947,Hall; Drew A.,0,0,0,0
1668117059934,ECE 283,A00,103670,Hsueh; Tzu-Chien,0,0,0,0
1668117060361,ECE 284,A00,103671,Turakhia; Yatish Girish,0,0,0,0
1668117060793,ECE 285,A00,103672,Zheng; Yang,0,0,0,0
1668117060793,ECE 285,B00,103673,Sworder; David D.,0,0,0,0
1668117061217,ECE 287,A00,103676,Javidi; Tara,0,0,0,0
1668117061666,MATH 200B,A00,098023,Salehi Golsefidy; Alireza,12,0,15,3
1668117062107,MATH 202B,A00,098024,Rhoades; Brendon Patrick,9,0,15,6
1668117062535,MATH 203B,A00,098025,Oprea; Dragos N.,10,0,15,5
1668117062971,MATH 204B,A00,098026,Sorensen; Claus M,13,0,15,2
1668117063393,MATH 208,A00,098027,Izadi; Elham,7,0,10,3
1668117063830,MATH 209,A00,098028,Pollack; Aaron,10,0,10,0
1668117064255,MATH 211A,A00,112919,Rogalski; Daniel,9,0,10,1
1668117064678,MATH 211B,A00,112920,Seward; Brandon M.,9,0,10,1
1668117065101,MATH 218,A00,098029,Li; Bo,10,0,10,0
1668117065526,MATH 220B,A00,098030,Novak; Jonathan I,11,0,15,4
1668117065952,MATH 221A,A00,098031,Ebenfelt; Peter F,13,0,15,2
1668117066386,MATH 231B,A00,098032,Zlatos; Andrej,12,0,15,3
1668117066810,MATH 240B,A00,098033,Ni; Lei,9,0,15,6
1668117067234,MATH 243,A00,098034,Jekel; David Andrew,10,0,10,0
1668117067658,MATH 245A,A00,098035,Nie; Jiawang,0,0,15,16
1668117068083,MATH 248,A00,098036,Bejenaru; Ioan,10,0,10,0
1668117068507,MATH 250B,A00,098037,Spolaor; Luca,14,0,15,1
1668117068936,MATH 258,A00,098038,Ni; Lei,10,0,10,0
1668117069390,MATH 264B,A00,098041,Rhoades; Brendon Patrick,9,0,15,6
1668117069815,MATH 268,A00,098042,Buss; Samuel R,10,0,10,0
1668117070241,MATH 269,A00,098043,Rhoades; Brendon Patrick,10,0,10,0
1668117070679,MATH 270B,A00,098044,Li; Bo,10,0,15,5
1668117071113,MATH 272B,A00,098045,Holst; Michael J,13,0,15,2
1668117071536,MATH 273A,A00,098046,Tian; Xiaochuan,10,0,15,5
1668117071960,MATH 275,A01,098048,Tian; Xiaochuan,6,0,10,4
1668117072403,MATH 278A,A00,098049,Holst; Michael J,8,0,10,2
1668117072837,MATH 278B,A00,098050,Cloninger; Alexander,10,0,10,0
1668117073283,MATH 278C,A00,098051,Nie; Jiawang,7,0,10,3
1668117073715,MATH 280B,A00,098052,Zheng; Tianyi,10,0,15,5
1668117074148,MATH 281B,A00,098053,Bradic; Jelena,2,0,15,13
1668117074685,MATH 282B,A00,098054,Arias-Castro; Ery,0,0,15,15
1668117075119,MATH 285,A00,098055,Fitzsimmons; Patrick J,0,0,15,17
1668117075552,MATH 287B,A00,098056,Arias-Castro; Ery,3,0,15,12
1668117075975,MATH 288,A00,098057,Agarwal; Pooja,9,0,10,1
1668117075975,MATH 288,B00,098058,Zhang; Danna,8,0,10,2
1668117075975,MATH 288,C00,098059,Williams; Ruth J,10,0,10,0
1668117076403,MATH 290B,A00,098060,Roberts; Justin Deritter,13,0,15,2
1668117076826,MATH 292,A00,098061,Belmont; Eva Kinoshita,10,0,10,0
1668117077248,MATH 295,A00,098062,Suk; Andrew Hoon,48,0,50,2
1668117077681,MATH 296,A00,098063,Novak; Jonathan I,20,0,20,0
1668117078106,MATH 297,001,098064,Gamst; Anthony Collins,9997,0,9999,2
1668117582927,COGS 205,A00,101395,Chiba; Andrea,19,0,20,1
1668117583359,COGS 210B,001,101404,Greene; Deanna Jacquelyn,9998,0,9999,1
1668117583359,COGS 210B,002,101417,Xia; Haijun,9999,0,9999,0
1668117583359,COGS 210B,003,101422,Nitz; Douglas A.,9999,0,9999,0
1668117583359,COGS 210B,004,101423,Hollan; James D.,9998,0,9999,1
1668117583359,COGS 210B,005,101424,Deak; Gedeon O.,9998,0,9999,1
1668117583359,COGS 210B,006,101425,Rossano; Federico,9999,0,9999,0
1668117583803,COGS 211B,A00,101427,Coulson; Seana M,9996,0,9999,3
1668117584231,COGS 220,A00,101428,Hollan; James D.,0,0,25,25
1668117584659,COGS 229,A00,101429,Dow; Steven P,18,0,25,7
1668117585083,COGS 230,A00,101430,Klemmer; Scott R,12,0,17,5
1668117585512,COGS 234,A00,101431,Xia; Haijun,3,0,25,22
1668117585943,COGS 260,A00,101432,Kiyonaga; Anastasia,20,0,25,5
1668117585943,COGS 260,B00,101433,Kirsh; David Joel,16,0,25,9
1668117586367,CSE 202,A00,102371,Impagliazzo; Russell,0,0,0,0
1668117586803,CSE 203B,A01,102373,Cheng; Chung Kuan,0,0,0,0
1668117587230,CSE 208,A00,102374,Micciancio; Daniele,0,0,0,0
1668117587659,CSE 209A,A00,112895,Impagliazzo; Russell,0,0,15,15
1668117588095,CSE 209B,A00,108005,Bellare; Mihir,0,0,0,0
1668117588523,CSE 210,A00,113163,Coblenz; Michael J,0,0,0,0
1668117588946,CSE 219,A00,106111,Dow; Steven P,0,0,20,20
1668117589390,CSE 221,A00,102376,Voelker; Geoffrey M.,0,0,0,0
1668117589818,CSE 224,A01,102378,Porter; George M,0,0,0,0
1668117590241,CSE 229A,A00,102379,Savage; Stefan,0,0,0,0
1668117590667,CSE 229C,A00,102380,Munyaka; Imani N. S.,0,0,0,0
1668117591098,CSE 232B,A00,102382,Deutsch; Alin Bernard,0,0,0,0
1668117591534,CSE 234,A01,112904,Kumar; Arun Kumar,0,0,0,0
1668117591960,CSE 237A,A00,102383,Rosing; Tajana Simunic,0,0,0,0
1668117592399,CSE 239A,A00,102384,Deutsch; Alin Bernard,0,0,0,0
1668117592822,CSE 239B,A00,102385,Polikarpova; Nadezhda,0,0,0,0
1668117593253,CSE 240A,A00,102386,Pannuto; Patrick William,0,0,0,0
1668117593676,CSE 240B,A00,102387,Zhao; Jishen,0,0,0,0
1668117594110,CSE 241A,A00,106406,Kang; Mingu,0,0,0,0
1668117594544,CSE 249B,A00,102388,Kahng; Andrew Byun,0,0,8,8
1668117594999,CSE 251B,A01,102392,Cottrell; Garrison W,0,0,0,0
1668117594999,CSE 251B,A02,102393,Cottrell; Garrison W,0,0,0,0
1668117595423,CSE 252B,A00,102394,Ochoa; Benjamin Lawrence,0,0,0,0
1668117595847,CSE 257,A01,102396,Gao; Sicun,0,0,0,0
1668117596272,CSE 272,A00,102397,Li; Tzumao,0,0,0,0
1668117596714,CSE 274,A00,111323,Chern; Albert Ren-Haur,0,0,0,0
1668117597145,CSE 282,A00,102398,Pevzner; Pavel Arkadjevich,0,0,0,0
1668117597574,CSE 284,A00,114175,Gymrek; Melissa Ann,0,0,0,0
1668117598015,CSE 290,A00,102399,Chandraker; Manmohan Krishna,0,0,0,0
1668117598015,CSE 290,B00,102400,Vaccaro; Kristen Marie,0,0,25,25
1668117598015,CSE 290,C00,102414,Pannuto; Patrick William,0,0,25,25
1668117598015,CSE 290,D00,102427,Pevzner; Pavel Arkadjevich,0,0,0,0
1668117598015,CSE 290,E00,102429,Zhao; Jishen,0,0,0,0
1668117598015,CSE 290,F00,102436,Tullsen; Dean Michael,0,0,0,0
1668117598015,CSE 290,G00,102440,Christensen; Henrik I,0,0,20,20
1668117598449,CSE 291,A00,102443,Su; Hao,0,0,0,0
1668117598449,CSE 291,B00,102448,Polikarpova; Nadezhda,0,0,0,0
1668117598449,CSE 291,C00,102453,Vaccaro; Kristen Marie,0,0,0,0
1668117598449,CSE 291,D00,111343,Savage; Stefan,0,0,0,0
1668117598449,CSE 291,E00,116474,Claffy; Kimberly Claire,0,0,0,0
1668117598449,CSE 291,F00,116479,Pasquale; Joseph,0,0,0,0
1668117598933,CSE 293,001,119111,Bafna; Vineet,9999,0,9999,0
1668117598933,CSE 293,002,119118,Bellare; Mihir,9999,0,9999,0
1668117598933,CSE 293,003,119122,Berg-Kirkpatrick; Taylor D,9999,0,9999,0
1668117598933,CSE 293,004,119135,Christensen; Henrik I,9999,0,9999,0
1668117598933,CSE 293,005,119142,Cottrell; Garrison W,9999,0,9999,0
1668117598933,CSE 293,006,119146,Deutsch; Alin Bernard,9999,0,9999,0
1668117598933,CSE 293,007,119159,Esmaeilzadeh; Hadi,9999,0,9999,0
1668117598933,CSE 293,008,119166,Freund; Yoav,9999,0,9999,0
1668117598933,CSE 293,009,119170,Griswold; William G.,9999,0,9999,0
1668117598933,CSE 293,010,119183,Gymrek; Melissa Ann,9999,0,9999,0
1668117598933,CSE 293,011,119190,Heninger; Nadia A,9999,0,9999,0
1668117598933,CSE 293,012,119230,Impagliazzo; Russell,9999,0,9999,0
1668117598933,CSE 293,013,119232,Jhala; Ranjit,9999,0,9999,0
1668117598933,CSE 293,014,119233,Kahng; Andrew Byun,9999,0,9999,0
1668117598933,CSE 293,015,119298,Kane; Daniel Mertz,9999,0,9999,0
1668117598933,CSE 293,016,119299,Kriegman; David J,9999,0,9999,0
1668117598933,CSE 293,017,119300,Kumar; Arun Kumar,9999,0,9999,0
1668117598933,CSE 293,018,119301,Lerner; Sorin,9999,0,9999,0
1668117598933,CSE 293,019,119302,Lovett; Shachar,9999,0,9999,0
1668117598933,CSE 293,020,119303,McAuley; Julian John,9999,0,9999,0
1668117598933,CSE 293,021,119304,Micciancio; Daniele,9999,0,9999,0
1668117598933,CSE 293,022,119367,Orailoglu; Alex,9999,0,9999,0
1668117598933,CSE 293,023,119382,Paturi; Ramamohan,9999,0,9999,0
1668117598933,CSE 293,024,119404,Polikarpova; Nadezhda,9999,0,9999,0
1668117598933,CSE 293,025,119406,Politz; Joseph Gibbs,9999,0,9999,0
1668117598933,CSE 293,026,119411,Porter; George M,9999,0,9999,0
1668117598933,CSE 293,027,119414,Porter; Leonard Emerson,9999,0,9999,0
1668117598933,CSE 293,028,119416,Ramamoorthi; Ravi,9999,0,9999,0
1668117598933,CSE 293,029,119417,Sahoo; Debashis,9999,0,9999,0
1668117598933,CSE 293,030,119420,Saul; Lawrence,9999,0,9999,0
1668117598933,CSE 293,031,119421,Savage; Stefan,9999,0,9999,0
1668117598933,CSE 293,032,119425,Schulze; Jurgen P.,9999,0,9999,0
1668117598933,CSE 293,033,119426,Snoeren; Alex C.,9999,0,9999,0
1668117598933,CSE 293,034,119428,Shang; Jingbo,9999,0,9999,0
1668117598933,CSE 293,035,119430,Stefan; Deian,9999,0,9999,0
1668117598933,CSE 293,036,119431,Su; Hao,9999,0,9999,0
1668117598933,CSE 293,037,119433,Swanson; Steven James,9999,0,9999,0
1668117598933,CSE 293,038,119435,Tullsen; Dean Michael,9999,0,9999,0
1668117598933,CSE 293,039,119483,Voelker; Geoffrey M.,9999,0,9999,0
1668117598933,CSE 293,040,119537,Zhao; Jishen,9999,0,9999,0
1668117598933,CSE 293,041,119538,Zhou; Yuan-Yuan,9999,0,9999,0
1668117598933,CSE 293,042,119539,Gao; Sicun,9999,0,9999,0
1668117598933,CSE 293,043,119540,Weibel; Nadir,9999,0,9999,0
1668117598933,CSE 293,044,119541,Gupta; Rajesh K.,9999,0,9999,0
1668117598933,CSE 293,045,126410,Vaccaro; Kristen Marie,9999,0,9999,0
1668117598933,CSE 293,046,126411,Klemke; Richard,9999,0,9999,0
1668117599379,CSE 294,A00,102459,Voelker; Geoffrey M.,0,0,0,0
1668117599379,CSE 294,B00,111322,Orailoglu; Alex,0,0,0,0
1668117599897,DSE 201,A00,096914,Deutsch; Alin Bernard,30,0,30,0
1668117600330,DSE 210,A00,096915,Dasgupta; Sanjoy,30,0,30,0
1668117601208,DSE 260A,A00,096916,Altintas De Callaf; Ilkay,30,0,30,0
1668117601709,ECE 200,001,103586,Antipa; Nicholas A,9999,0,9999,0
1668117601709,ECE 200,002,103587,Atanasov; Nikolay A.,9999,0,9999,0
1668117601709,ECE 200,003,103588,Bharadia; Dinesh,9999,0,9999,0
1668117601709,ECE 200,004,103589,Cheng; Chung Kuan,9999,0,9999,0
1668117601709,ECE 200,005,103590,Cosman; Pamela C.,9999,0,9999,0
1668117601709,ECE 200,006,103591,Dayeh; Shadi Ahmad,9999,0,9999,0
1668117601709,ECE 200,007,103592,Fainman; Yeshaiahu,9999,0,9999,0
1668117601709,ECE 200,008,103593,Ford; Joseph Earl,9999,0,9999,0
1668117601709,ECE 200,009,103594,Franceschetti; Massimo,9999,0,9999,0
1668117601709,ECE 200,010,103595,Fullerton; Eric E,9999,0,9999,0
1668117601709,ECE 200,011,103596,Galton; Ian A,9999,0,9999,0
1668117601709,ECE 200,012,103597,Gilja; Vikash,9999,0,9999,0
1668117601709,ECE 200,013,103598,Hall; Drew A.,9999,0,9999,0
1668117601709,ECE 200,014,103599,Hsueh; Tzu-Chien,9999,0,9999,0
1668117601709,ECE 200,015,103600,Javidi; Tara,9999,0,9999,0
1668117601709,ECE 200,016,103601,Kahng; Andrew Byun,9999,0,9999,0
1668117601709,ECE 200,017,103602,Kim; Young-Han,9999,0,9999,0
1668117601709,ECE 200,018,103603,Koushanfar; Farinaz,9999,0,9999,0
1668117601709,ECE 200,019,103604,Kuzum; Duygu,9999,0,9999,0
1668117601709,ECE 200,020,103605,Le; Hanh-Phuc,9999,0,9999,0
1668117601709,ECE 200,021,103606,Lin; Bill,9999,0,9999,0
1668117601709,ECE 200,022,103607,Liu; Zhaowei,9998,0,9999,1
1668117601709,ECE 200,023,103608,Lo; Yu-Hwa,9999,0,9999,0
1668117601709,ECE 200,024,103609,Lomakin; Vitaliy,9999,0,9999,0
1668117601709,ECE 200,025,103610,Mercier; Patrick Philip,9999,0,9999,0
1668117601709,ECE 200,026,103611,Meyer; Florian,9999,0,9999,0
1668117601709,ECE 200,027,103612,Milstein; Laurence B.,9999,0,9999,0
1668117601709,ECE 200,028,103613,Mir Arabbaygi; Siavash,9999,0,9999,0
1668117601709,ECE 200,029,103614,Mookherjea; Shayan,9999,0,9999,0
1668117601709,ECE 200,030,103615,Morris; Karcher William,9999,0,9999,0
1668117601709,ECE 200,031,103616,Ng; Tse Nga,9999,0,9999,0
1668117601709,ECE 200,032,103617,Nguyen; Truong Quang,9999,0,9999,0
1668117601709,ECE 200,033,103618,Nomura; Kenji,9999,0,9999,0
1668117601709,ECE 200,034,103619,Orlitsky; Alon,9999,0,9999,0
1668117601709,ECE 200,035,103620,Pal; Piya,9999,0,9999,0
1668117601709,ECE 200,036,103621,Papen; George C.,9999,0,9999,0
1668117601709,ECE 200,037,103622,Radic; Stojan,9999,0,9999,0
1668117601709,ECE 200,038,103623,Rao; Bhaskar D.,9999,0,9999,0
1668117601709,ECE 200,039,103624,Rao; Ramesh R,9999,0,9999,0
1668117601709,ECE 200,040,103625,Rebeiz; Gabriel,9999,0,9999,0
1668117601709,ECE 200,041,103626,Sanford; John R,9999,0,9999,0
1668117601709,ECE 200,042,103627,Siegel; Paul H.,9999,0,9999,0
1668117601709,ECE 200,043,103628,Sievenpiper; Daniel F.,9999,0,9999,0
1668117601709,ECE 200,044,103629,Sworder; David D.,9999,0,9999,0
1668117601709,ECE 200,045,103630,Taur; Yuan,9999,0,9999,0
1668117601709,ECE 200,046,103631,Touri; Behrouz,9999,0,9999,0
1668117601709,ECE 200,047,103632,Trivedi; Mohan M.,9999,0,9999,0
1668117601709,ECE 200,048,103633,Vasconcelos; Nuno,9999,0,9999,0
1668117601709,ECE 200,049,103634,Wang; Xiaolong,9999,0,9999,0
1668117601709,ECE 200,050,103635,Xie; Pengtao,9999,0,9999,0
1668117601709,ECE 200,051,103636,Yip; Michael,9999,0,9999,0
1668117601709,ECE 200,052,103637,Zeger; Kenneth A.,999,0,999,0
1668117601709,ECE 200,053,103638,Zhang; Xinyu,9999,0,9999,0
1668117601709,ECE 200,054,103639,Turakhia; Yatish Girish,9999,0,9999,0
1668117601709,ECE 200,055,103640,Kang; Mingu,9999,0,9999,0
1668117601709,ECE 200,056,103641,Shi; Yuanyuan,9999,0,9999,0
1668117601709,ECE 200,057,103642,Wang; Edward Jay,9999,0,9999,0
1668117601709,ECE 200,058,103643,Zheng; Yang,9999,0,9999,0
1668117602138,ECE 202,A00,103644,Kuzum; Duygu,0,0,0,0
1668117602627,ECE 212BN,A00,103646,Ng; Tse Nga,0,0,0,0
1668117603064,ECE 221,A00,111493,Staff,0,0,0,0
1668117603548,ECE 222B,A00,103647,Lomakin; Vitaliy,0,0,0,0
1668117603974,ECE 230B,A00,103648,Taur; Yuan,0,0,0,0
1668117604408,ECE 238B,A00,103649,Garay; Javier,0,0,0,0
1668117604976,ECE 240B,A00,112900,Fainman; Yeshaiahu,0,0,0,0
1668117605403,ECE 247A,A00,103650,Jokerst; Jesse Vincent,0,0,0,0
1668117605900,ECE 247B,A00,103651,Wang; Joseph,0,0,0,0
1668117606323,ECE 250,A00,103652,Siegel; Paul H.,0,0,0,0
1668117606757,ECE 251A,A00,103654,Rao; Bhaskar D.,0,0,0,0
1668117607195,ECE 257B,A00,103655,Bharadia; Dinesh,0,0,0,0
1668117607619,ECE 258A,A00,103656,Milstein; Laurence B.,0,0,0,0
1668117608047,ECE 260B,A00,103658,Kang; Mingu,0,0,0,0
1668117608544,ECE 264A,A00,103659,Galton; Ian A,0,0,0,0
1668117608990,ECE 265A,A00,103661,Gudem; Prasad S.S.,0,0,0,0
1668117609541,ECE 265D,A00,103662,Gudem; Prasad S.S.,0,0,0,0
1668117609968,ECE 268,A00,103663,Koushanfar; Farinaz,0,0,0,0
1668117610397,ECE 269,A01,103665,Pal; Piya,0,0,0,0
1668117610821,ECE 271B,A00,103666,Vasconcelos; Manuela,0,0,0,0
1668117611263,ECE 276A,A00,103667,Atanasov; Nikolay A.,0,0,0,0
1668117611707,ECE 277,A00,103668,An; Cheolhong,0,0,0,0
1668117612148,ECE 279,A00,117947,Hall; Drew A.,0,0,0,0
1668117613064,ECE 283,A00,103670,Hsueh; Tzu-Chien,0,0,0,0
1668117613489,ECE 284,A00,103671,Turakhia; Yatish Girish,0,0,0,0
1668117613931,ECE 285,A00,103672,Zheng; Yang,0,0,0,0
1668117613931,ECE 285,B00,103673,Sworder; David D.,0,0,0,0
1668117614368,ECE 287,A00,103676,Javidi; Tara,0,0,0,0
1668117614817,MATH 200B,A00,098023,Salehi Golsefidy; Alireza,12,0,15,3
1668117615249,MATH 202B,A00,098024,Rhoades; Brendon Patrick,9,0,15,6
1668117615687,MATH 203B,A00,098025,Oprea; Dragos N.,10,0,15,5
1668117616125,MATH 204B,A00,098026,Sorensen; Claus M,13,0,15,2
1668117616551,MATH 208,A00,098027,Izadi; Elham,7,0,10,3
1668117616981,MATH 209,A00,098028,Pollack; Aaron,10,0,10,0
1668117617417,MATH 211A,A00,112919,Rogalski; Daniel,9,0,10,1
1668117617866,MATH 211B,A00,112920,Seward; Brandon M.,9,0,10,1
1668117618290,MATH 218,A00,098029,Li; Bo,10,0,10,0
1668117618722,MATH 220B,A00,098030,Novak; Jonathan I,11,0,15,4
1668117619154,MATH 221A,A00,098031,Ebenfelt; Peter F,13,0,15,2
1668117619587,MATH 231B,A00,098032,Zlatos; Andrej,12,0,15,3
1668117620029,MATH 240B,A00,098033,Ni; Lei,9,0,15,6
1668117620457,MATH 243,A00,098034,Jekel; David Andrew,10,0,10,0
1668117620891,MATH 245A,A00,098035,Nie; Jiawang,0,0,15,16
1668117621332,MATH 248,A00,098036,Bejenaru; Ioan,10,0,10,0
1668117621776,MATH 250B,A00,098037,Spolaor; Luca,14,0,15,1
1668117622244,MATH 258,A00,098038,Ni; Lei,10,0,10,0
1668117622671,MATH 264B,A00,098041,Rhoades; Brendon Patrick,9,0,15,6
1668117623106,MATH 268,A00,098042,Buss; Samuel R,10,0,10,0
1668117623535,MATH 269,A00,098043,Rhoades; Brendon Patrick,10,0,10,0
1668117623960,MATH 270B,A00,098044,Li; Bo,10,0,15,5
1668117624394,MATH 272B,A00,098045,Holst; Michael J,13,0,15,2
1668117624825,MATH 273A,A00,098046,Tian; Xiaochuan,10,0,15,5
1668117625262,MATH 275,A01,098048,Tian; Xiaochuan,6,0,10,4
1668117625696,MATH 278A,A00,098049,Holst; Michael J,8,0,10,2
1668117626130,MATH 278B,A00,098050,Cloninger; Alexander,10,0,10,0
1668117626553,MATH 278C,A00,098051,Nie; Jiawang,7,0,10,3
1668117626986,MATH 280B,A00,098052,Zheng; Tianyi,10,0,15,5
1668117627424,MATH 281B,A00,098053,Bradic; Jelena,2,0,15,13
1668117627847,MATH 282B,A00,098054,Arias-Castro; Ery,0,0,15,15
1668117628288,MATH 285,A00,098055,Fitzsimmons; Patrick J,0,0,15,17
1668117628712,MATH 287B,A00,098056,Arias-Castro; Ery,3,0,15,12
1668117629136,MATH 288,A00,098057,Agarwal; Pooja,9,0,10,1
1668117629136,MATH 288,B00,098058,Zhang; Danna,8,0,10,2
1668117629136,MATH 288,C00,098059,Williams; Ruth J,10,0,10,0
1668117629571,MATH 290B,A00,098060,Roberts; Justin Deritter,13,0,15,2
1668117629996,MATH 292,A00,098061,Belmont; Eva Kinoshita,10,0,10,0
1668117630424,MATH 295,A00,098062,Suk; Andrew Hoon,48,0,50,2
1668117630872,MATH 296,A00,098063,Novak; Jonathan I,20,0,20,0
1668117631314,MATH 297,001,098064,Gamst; Anthony Collins,9997,0,9999,2
1668118140194,COGS 205,A00,101395,Chiba; Andrea,19,0,20,1
1668118140621,COGS 210B,001,101404,Greene; Deanna Jacquelyn,9998,0,9999,1
1668118140621,COGS 210B,002,101417,Xia; Haijun,9999,0,9999,0
1668118140621,COGS 210B,003,101422,Nitz; Douglas A.,9999,0,9999,0
1668118140621,COGS 210B,004,101423,Hollan; James D.,9998,0,9999,1
1668118140621,COGS 210B,005,101424,Deak; Gedeon O.,9998,0,9999,1
1668118140621,COGS 210B,006,101425,Rossano; Federico,9999,0,9999,0
1668118141053,COGS 211B,A00,101427,Coulson; Seana M,9996,0,9999,3
1668118141487,COGS 220,A00,101428,Hollan; James D.,0,0,25,25
1668118141921,COGS 229,A00,101429,Dow; Steven P,18,0,25,7
1668118142369,COGS 230,A00,101430,Klemmer; Scott R,12,0,17,5
1668118142797,COGS 234,A00,101431,Xia; Haijun,3,0,25,22
1668118143221,COGS 260,A00,101432,Kiyonaga; Anastasia,20,0,25,5
1668118143221,COGS 260,B00,101433,Kirsh; David Joel,16,0,25,9
1668118143643,CSE 202,A00,102371,Impagliazzo; Russell,0,0,0,0
1668118144083,CSE 203B,A01,102373,Cheng; Chung Kuan,0,0,0,0
1668118144509,CSE 208,A00,102374,Micciancio; Daniele,0,0,0,0
1668118144942,CSE 209A,A00,112895,Impagliazzo; Russell,0,0,15,15
1668118145374,CSE 209B,A00,108005,Bellare; Mihir,0,0,0,0
1668118145800,CSE 210,A00,113163,Coblenz; Michael J,0,0,0,0
1668118146251,CSE 219,A00,106111,Dow; Steven P,0,0,20,20
1668118146676,CSE 221,A00,102376,Voelker; Geoffrey M.,0,0,0,0
1668118147107,CSE 224,A01,102378,Porter; George M,0,0,0,0
1668118147536,CSE 229A,A00,102379,Savage; Stefan,0,0,0,0
1668118147959,CSE 229C,A00,102380,Munyaka; Imani N. S.,0,0,0,0
1668118148394,CSE 232B,A00,102382,Deutsch; Alin Bernard,0,0,0,0
1668118148844,CSE 234,A01,112904,Kumar; Arun Kumar,0,0,0,0
1668118149269,CSE 237A,A00,102383,Rosing; Tajana Simunic,0,0,0,0
1668118149691,CSE 239A,A00,102384,Deutsch; Alin Bernard,0,0,0,0
1668118150116,CSE 239B,A00,102385,Polikarpova; Nadezhda,0,0,0,0
1668118150543,CSE 240A,A00,102386,Pannuto; Patrick William,0,0,0,0
1668118150975,CSE 240B,A00,102387,Zhao; Jishen,0,0,0,0
1668118151403,CSE 241A,A00,106406,Kang; Mingu,0,0,0,0
1668118151833,CSE 249B,A00,102388,Kahng; Andrew Byun,0,0,8,8
1668118152261,CSE 251B,A01,102392,Cottrell; Garrison W,0,0,0,0
1668118152261,CSE 251B,A02,102393,Cottrell; Garrison W,0,0,0,0
1668118152694,CSE 252B,A00,102394,Ochoa; Benjamin Lawrence,0,0,0,0
1668118153121,CSE 257,A01,102396,Gao; Sicun,0,0,0,0
1668118153544,CSE 272,A00,102397,Li; Tzumao,0,0,0,0
1668118153975,CSE 274,A00,111323,Chern; Albert Ren-Haur,0,0,0,0
1668118154406,CSE 282,A00,102398,Pevzner; Pavel Arkadjevich,0,0,0,0
1668118154853,CSE 284,A00,114175,Gymrek; Melissa Ann,0,0,0,0
1668118155277,CSE 290,A00,102399,Chandraker; Manmohan Krishna,0,0,0,0
1668118155277,CSE 290,B00,102400,Vaccaro; Kristen Marie,0,0,25,25
1668118155277,CSE 290,C00,102414,Pannuto; Patrick William,0,0,25,25
1668118155277,CSE 290,D00,102427,Pevzner; Pavel Arkadjevich,0,0,0,0
1668118155277,CSE 290,E00,102429,Zhao; Jishen,0,0,0,0
1668118155277,CSE 290,F00,102436,Tullsen; Dean Michael,0,0,0,0
1668118155277,CSE 290,G00,102440,Christensen; Henrik I,0,0,20,20
1668118155710,CSE 291,A00,102443,Su; Hao,0,0,0,0
1668118155710,CSE 291,B00,102448,Polikarpova; Nadezhda,0,0,0,0
1668118155710,CSE 291,C00,102453,Vaccaro; Kristen Marie,0,0,0,0
1668118155710,CSE 291,D00,111343,Savage; Stefan,0,0,0,0
1668118155710,CSE 291,E00,116474,Claffy; Kimberly Claire,0,0,0,0
1668118155710,CSE 291,F00,116479,Pasquale; Joseph,0,0,0,0
1668118156140,CSE 293,001,119111,Bafna; Vineet,9999,0,9999,0
1668118156140,CSE 293,002,119118,Bellare; Mihir,9999,0,9999,0
1668118156140,CSE 293,003,119122,Berg-Kirkpatrick; Taylor D,9999,0,9999,0
1668118156140,CSE 293,004,119135,Christensen; Henrik I,9999,0,9999,0
1668118156140,CSE 293,005,119142,Cottrell; Garrison W,9999,0,9999,0
1668118156140,CSE 293,006,119146,Deutsch; Alin Bernard,9999,0,9999,0
1668118156140,CSE 293,007,119159,Esmaeilzadeh; Hadi,9999,0,9999,0
1668118156140,CSE 293,008,119166,Freund; Yoav,9999,0,9999,0
1668118156140,CSE 293,009,119170,Griswold; William G.,9999,0,9999,0
1668118156140,CSE 293,010,119183,Gymrek; Melissa Ann,9999,0,9999,0
1668118156140,CSE 293,011,119190,Heninger; Nadia A,9999,0,9999,0
1668118156140,CSE 293,012,119230,Impagliazzo; Russell,9999,0,9999,0
1668118156140,CSE 293,013,119232,Jhala; Ranjit,9999,0,9999,0
1668118156140,CSE 293,014,119233,Kahng; Andrew Byun,9999,0,9999,0
1668118156140,CSE 293,015,119298,Kane; Daniel Mertz,9999,0,9999,0
1668118156140,CSE 293,016,119299,Kriegman; David J,9999,0,9999,0
1668118156140,CSE 293,017,119300,Kumar; Arun Kumar,9999,0,9999,0
1668118156140,CSE 293,018,119301,Lerner; Sorin,9999,0,9999,0
1668118156140,CSE 293,019,119302,Lovett; Shachar,9999,0,9999,0
1668118156140,CSE 293,020,119303,McAuley; Julian John,9999,0,9999,0
1668118156140,CSE 293,021,119304,Micciancio; Daniele,9999,0,9999,0
1668118156140,CSE 293,022,119367,Orailoglu; Alex,9999,0,9999,0
1668118156140,CSE 293,023,119382,Paturi; Ramamohan,9999,0,9999,0
1668118156140,CSE 293,024,119404,Polikarpova; Nadezhda,9999,0,9999,0
1668118156140,CSE 293,025,119406,Politz; Joseph Gibbs,9999,0,9999,0
1668118156140,CSE 293,026,119411,Porter; George M,9999,0,9999,0
1668118156140,CSE 293,027,119414,Porter; Leonard Emerson,9999,0,9999,0
1668118156140,CSE 293,028,119416,Ramamoorthi; Ravi,9999,0,9999,0
1668118156140,CSE 293,029,119417,Sahoo; Debashis,9999,0,9999,0
1668118156140,CSE 293,030,119420,Saul; Lawrence,9999,0,9999,0
1668118156140,CSE 293,031,119421,Savage; Stefan,9999,0,9999,0
1668118156140,CSE 293,032,119425,Schulze; Jurgen P.,9999,0,9999,0
1668118156140,CSE 293,033,119426,Snoeren; Alex C.,9999,0,9999,0
1668118156140,CSE 293,034,119428,Shang; Jingbo,9999,0,9999,0
1668118156140,CSE 293,035,119430,Stefan; Deian,9999,0,9999,0
1668118156140,CSE 293,036,119431,Su; Hao,9999,0,9999,0
1668118156140,CSE 293,037,119433,Swanson; Steven James,9999,0,9999,0
1668118156140,CSE 293,038,119435,Tullsen; Dean Michael,9999,0,9999,0
1668118156140,CSE 293,039,119483,Voelker; Geoffrey M.,9999,0,9999,0
1668118156140,CSE 293,040,119537,Zhao; Jishen,9999,0,9999,0
1668118156140,CSE 293,041,119538,Zhou; Yuan-Yuan,9999,0,9999,0
1668118156140,CSE 293,042,119539,Gao; Sicun,9999,0,9999,0
1668118156140,CSE 293,043,119540,Weibel; Nadir,9999,0,9999,0
1668118156140,CSE 293,044,119541,Gupta; Rajesh K.,9999,0,9999,0
1668118156140,CSE 293,045,126410,Vaccaro; Kristen Marie,9999,0,9999,0
1668118156140,CSE 293,046,126411,Klemke; Richard,9999,0,9999,0
1668118156569,CSE 294,A00,102459,Voelker; Geoffrey M.,0,0,0,0
1668118156569,CSE 294,B00,111322,Orailoglu; Alex,0,0,0,0
1668118156991,DSE 201,A00,096914,Deutsch; Alin Bernard,30,0,30,0
1668118157424,DSE 210,A00,096915,Dasgupta; Sanjoy,30,0,30,0
1668118157852,DSE 260A,A00,096916,Altintas De Callaf; Ilkay,30,0,30,0
1668118158288,ECE 200,001,103586,Antipa; Nicholas A,9999,0,9999,0
1668118158288,ECE 200,002,103587,Atanasov; Nikolay A.,9999,0,9999,0
1668118158288,ECE 200,003,103588,Bharadia; Dinesh,9999,0,9999,0
1668118158288,ECE 200,004,103589,Cheng; Chung Kuan,9999,0,9999,0
1668118158288,ECE 200,005,103590,Cosman; Pamela C.,9999,0,9999,0
1668118158288,ECE 200,006,103591,Dayeh; Shadi Ahmad,9999,0,9999,0
1668118158288,ECE 200,007,103592,Fainman; Yeshaiahu,9999,0,9999,0
1668118158288,ECE 200,008,103593,Ford; Joseph Earl,9999,0,9999,0
1668118158288,ECE 200,009,103594,Franceschetti; Massimo,9999,0,9999,0
1668118158288,ECE 200,010,103595,Fullerton; Eric E,9999,0,9999,0
1668118158288,ECE 200,011,103596,Galton; Ian A,9999,0,9999,0
1668118158288,ECE 200,012,103597,Gilja; Vikash,9999,0,9999,0
1668118158288,ECE 200,013,103598,Hall; Drew A.,9999,0,9999,0
1668118158288,ECE 200,014,103599,Hsueh; Tzu-Chien,9999,0,9999,0
1668118158288,ECE 200,015,103600,Javidi; Tara,9999,0,9999,0
1668118158288,ECE 200,016,103601,Kahng; Andrew Byun,9999,0,9999,0
1668118158288,ECE 200,017,103602,Kim; Young-Han,9999,0,9999,0
1668118158288,ECE 200,018,103603,Koushanfar; Farinaz,9999,0,9999,0
1668118158288,ECE 200,019,103604,Kuzum; Duygu,9999,0,9999,0
1668118158288,ECE 200,020,103605,Le; Hanh-Phuc,9999,0,9999,0
1668118158288,ECE 200,021,103606,Lin; Bill,9999,0,9999,0
1668118158288,ECE 200,022,103607,Liu; Zhaowei,9998,0,9999,1
1668118158288,ECE 200,023,103608,Lo; Yu-Hwa,9999,0,9999,0
1668118158288,ECE 200,024,103609,Lomakin; Vitaliy,9999,0,9999,0
1668118158288,ECE 200,025,103610,Mercier; Patrick Philip,9999,0,9999,0
1668118158288,ECE 200,026,103611,Meyer; Florian,9999,0,9999,0
1668118158288,ECE 200,027,103612,Milstein; Laurence B.,9999,0,9999,0
1668118158288,ECE 200,028,103613,Mir Arabbaygi; Siavash,9999,0,9999,0
1668118158288,ECE 200,029,103614,Mookherjea; Shayan,9999,0,9999,0
1668118158288,ECE 200,030,103615,Morris; Karcher William,9999,0,9999,0
1668118158288,ECE 200,031,103616,Ng; Tse Nga,9999,0,9999,0
1668118158288,ECE 200,032,103617,Nguyen; Truong Quang,9999,0,9999,0
1668118158288,ECE 200,033,103618,Nomura; Kenji,9999,0,9999,0
1668118158288,ECE 200,034,103619,Orlitsky; Alon,9999,0,9999,0
1668118158288,ECE 200,035,103620,Pal; Piya,9999,0,9999,0
1668118158288,ECE 200,036,103621,Papen; George C.,9999,0,9999,0
1668118158288,ECE 200,037,103622,Radic; Stojan,9999,0,9999,0
1668118158288,ECE 200,038,103623,Rao; Bhaskar D.,9999,0,9999,0
1668118158288,ECE 200,039,103624,Rao; Ramesh R,9999,0,9999,0
1668118158288,ECE 200,040,103625,Rebeiz; Gabriel,9999,0,9999,0
1668118158288,ECE 200,041,103626,Sanford; John R,9999,0,9999,0
1668118158288,ECE 200,042,103627,Siegel; Paul H.,9999,0,9999,0
1668118158288,ECE 200,043,103628,Sievenpiper; Daniel F.,9999,0,9999,0
1668118158288,ECE 200,044,103629,Sworder; David D.,9999,0,9999,0
1668118158288,ECE 200,045,103630,Taur; Yuan,9999,0,9999,0
1668118158288,ECE 200,046,103631,Touri; Behrouz,9999,0,9999,0
1668118158288,ECE 200,047,103632,Trivedi; Mohan M.,9999,0,9999,0
1668118158288,ECE 200,048,103633,Vasconcelos; Nuno,9999,0,9999,0
1668118158288,ECE 200,049,103634,Wang; Xiaolong,9999,0,9999,0
1668118158288,ECE 200,050,103635,Xie; Pengtao,9999,0,9999,0
1668118158288,ECE 200,051,103636,Yip; Michael,9999,0,9999,0
1668118158288,ECE 200,052,103637,Zeger; Kenneth A.,999,0,999,0
1668118158288,ECE 200,053,103638,Zhang; Xinyu,9999,0,9999,0
1668118158288,ECE 200,054,103639,Turakhia; Yatish Girish,9999,0,9999,0
1668118158288,ECE 200,055,103640,Kang; Mingu,9999,0,9999,0
1668118158288,ECE 200,056,103641,Shi; Yuanyuan,9999,0,9999,0
1668118158288,ECE 200,057,103642,Wang; Edward Jay,9999,0,9999,0
1668118158288,ECE 200,058,103643,Zheng; Yang,9999,0,9999,0
1668118158715,ECE 202,A00,103644,Kuzum; Duygu,0,0,0,0
1668118159152,ECE 212BN,A00,103646,Ng; Tse Nga,0,0,0,0
1668118159575,ECE 221,A00,111493,Staff,0,0,0,0
1668118160000,ECE 222B,A00,103647,Lomakin; Vitaliy,0,0,0,0
1668118160437,ECE 230B,A00,103648,Taur; Yuan,0,0,0,0
1668118160860,ECE 238B,A00,103649,Garay; Javier,0,0,0,0
1668118161284,ECE 240B,A00,112900,Fainman; Yeshaiahu,0,0,0,0
1668118161718,ECE 247A,A00,103650,Jokerst; Jesse Vincent,0,0,0,0
1668118162145,ECE 247B,A00,103651,Wang; Joseph,0,0,0,0
1668118162575,ECE 250,A00,103652,Siegel; Paul H.,0,0,0,0
1668118162997,ECE 251A,A00,103654,Rao; Bhaskar D.,0,0,0,0
1668118163426,ECE 257B,A00,103655,Bharadia; Dinesh,0,0,0,0
1668118163849,ECE 258A,A00,103656,Milstein; Laurence B.,0,0,0,0
1668118164279,ECE 260B,A00,103658,Kang; Mingu,0,0,0,0
1668118164705,ECE 264A,A00,103659,Galton; Ian A,0,0,0,0
1668118175457,ECE 265A,A00,103661,Gudem; Prasad S.S.,0,0,0,0
1668118175879,ECE 265D,A00,103662,Gudem; Prasad S.S.,0,0,0,0
1668118176304,ECE 268,A00,103663,Koushanfar; Farinaz,0,0,0,0
1668118176743,ECE 269,A01,103665,Pal; Piya,0,0,0,0
1668118177168,ECE 271B,A00,103666,Vasconcelos; Manuela,0,0,0,0
1668118177604,ECE 276A,A00,103667,Atanasov; Nikolay A.,0,0,0,0
1668118178038,ECE 277,A00,103668,An; Cheolhong,0,0,0,0
1668118178475,ECE 279,A00,117947,Hall; Drew A.,0,0,0,0
1668118179364,ECE 283,A00,103670,Hsueh; Tzu-Chien,0,0,0,0
1668118179799,ECE 284,A00,103671,Turakhia; Yatish Girish,0,0,0,0
1668118180228,ECE 285,A00,103672,Zheng; Yang,0,0,0,0
1668118180228,ECE 285,B00,103673,Sworder; David D.,0,0,0,0
1668118180666,ECE 287,A00,103676,Javidi; Tara,0,0,0,0
1668118181094,MATH 200B,A00,098023,Salehi Golsefidy; Alireza,12,0,15,3
1668118181534,MATH 202B,A00,098024,Rhoades; Brendon Patrick,9,0,15,6
1668118181957,MATH 203B,A00,098025,Oprea; Dragos N.,10,0,15,5
1668118182381,MATH 204B,A00,098026,Sorensen; Claus M,13,0,15,2
1668118182804,MATH 208,A00,098027,Izadi; Elham,7,0,10,3
1668118183230,MATH 209,A00,098028,Pollack; Aaron,10,0,10,0
1668118183657,MATH 211A,A00,112919,Rogalski; Daniel,9,0,10,1
1668118184162,MATH 211B,A00,112920,Seward; Brandon M.,9,0,10,1
1668118184585,MATH 218,A00,098029,Li; Bo,10,0,10,0
1668118185013,MATH 220B,A00,098030,Novak; Jonathan I,11,0,15,4
1668118185439,MATH 221A,A00,098031,Ebenfelt; Peter F,13,0,15,2
1668118185864,MATH 231B,A00,098032,Zlatos; Andrej,12,0,15,3
1668118186290,MATH 240B,A00,098033,Ni; Lei,9,0,15,6
1668118186725,MATH 243,A00,098034,Jekel; David Andrew,10,0,10,0
1668118187163,MATH 245A,A00,098035,Nie; Jiawang,0,0,15,16
1668118187586,MATH 248,A00,098036,Bejenaru; Ioan,10,0,10,0
1668118188030,MATH 250B,A00,098037,Spolaor; Luca,14,0,15,1
1668118188469,MATH 258,A00,098038,Ni; Lei,10,0,10,0
1668118188904,MATH 264B,A00,098041,Rhoades; Brendon Patrick,9,0,15,6
1668118189341,MATH 268,A00,098042,Buss; Samuel R,10,0,10,0
1668118189764,MATH 269,A00,098043,Rhoades; Brendon Patrick,10,0,10,0
1668118190186,MATH 270B,A00,098044,Li; Bo,10,0,15,5
1668118190629,MATH 272B,A00,098045,Holst; Michael J,13,0,15,2
1668118191072,MATH 273A,A00,098046,Tian; Xiaochuan,10,0,15,5
1668118191513,MATH 275,A01,098048,Tian; Xiaochuan,6,0,10,4
1668118191949,MATH 278A,A00,098049,Holst; Michael J,8,0,10,2
1668118192376,MATH 278B,A00,098050,Cloninger; Alexander,10,0,10,0
1668118192800,MATH 278C,A00,098051,Nie; Jiawang,7,0,10,3
1668118193236,MATH 280B,A00,098052,Zheng; Tianyi,10,0,15,5
1668118193675,MATH 281B,A00,098053,Bradic; Jelena,2,0,15,13
1668118194109,MATH 282B,A00,098054,Arias-Castro; Ery,0,0,15,15
1668118194545,MATH 285,A00,098055,Fitzsimmons; Patrick J,0,0,15,17
1668118194986,MATH 287B,A00,098056,Arias-Castro; Ery,3,0,15,12
1668118195411,MATH 288,A00,098057,Agarwal; Pooja,9,0,10,1
1668118195411,MATH 288,B00,098058,Zhang; Danna,8,0,10,2
1668118195411,MATH 288,C00,098059,Williams; Ruth J,10,0,10,0
1668118195850,MATH 290B,A00,098060,Roberts; Justin Deritter,13,0,15,2
1668118196272,MATH 292,A00,098061,Belmont; Eva Kinoshita,10,0,10,0
1668118196696,MATH 295,A00,098062,Suk; Andrew Hoon,48,0,50,2
1668118197118,MATH 296,A00,098063,Novak; Jonathan I,20,0,20,0
1668118197556,MATH 297,001,098064,Gamst; Anthony Collins,9997,0,9999,2
1668118703541,COGS 205,A00,101395,Chiba; Andrea,19,0,20,1
1668118703972,COGS 210B,001,101404,Greene; Deanna Jacquelyn,9998,0,9999,1
1668118703972,COGS 210B,002,101417,Xia; Haijun,9999,0,9999,0
1668118703972,COGS 210B,003,101422,Nitz; Douglas A.,9999,0,9999,0
1668118703972,COGS 210B,004,101423,Hollan; James D.,9998,0,9999,1
1668118703972,COGS 210B,005,101424,Deak; Gedeon O.,9998,0,9999,1
1668118703972,COGS 210B,006,101425,Rossano; Federico,9999,0,9999,0
1668118704410,COGS 211B,A00,101427,Coulson; Seana M,9996,0,9999,3
1668118704832,COGS 220,A00,101428,Hollan; James D.,0,0,25,25
1668118705261,COGS 229,A00,101429,Dow; Steven P,18,0,25,7
1668118705697,COGS 230,A00,101430,Klemmer; Scott R,12,0,17,5
1668118706121,COGS 234,A00,101431,Xia; Haijun,3,0,25,22
1668118706546,COGS 260,A00,101432,Kiyonaga; Anastasia,20,0,25,5
1668118706546,COGS 260,B00,101433,Kirsh; David Joel,16,0,25,9
1668118706970,CSE 202,A00,102371,Impagliazzo; Russell,0,0,0,0
1668118707396,CSE 203B,A01,102373,Cheng; Chung Kuan,0,0,0,0
1668118707831,CSE 208,A00,102374,Micciancio; Daniele,0,0,0,0
1668118708265,CSE 209A,A00,112895,Impagliazzo; Russell,0,0,15,15
1668118708706,CSE 209B,A00,108005,Bellare; Mihir,0,0,0,0
1668118709129,CSE 210,A00,113163,Coblenz; Michael J,0,0,0,0
1668118709552,CSE 219,A00,106111,Dow; Steven P,0,0,20,20
1668118709980,CSE 221,A00,102376,Voelker; Geoffrey M.,0,0,0,0
1668118710502,CSE 224,A01,102378,Porter; George M,0,0,0,0
1668118710929,CSE 229A,A00,102379,Savage; Stefan,0,0,0,0
1668118711363,CSE 229C,A00,102380,Munyaka; Imani N. S.,0,0,0,0
1668118711785,CSE 232B,A00,102382,Deutsch; Alin Bernard,0,0,0,0
1668118712229,CSE 234,A01,112904,Kumar; Arun Kumar,0,0,0,0
1668118712663,CSE 237A,A00,102383,Rosing; Tajana Simunic,0,0,0,0
1668118713090,CSE 239A,A00,102384,Deutsch; Alin Bernard,0,0,0,0
1668118713521,CSE 239B,A00,102385,Polikarpova; Nadezhda,0,0,0,0
1668118713958,CSE 240A,A00,102386,Pannuto; Patrick William,0,0,0,0
1668118714384,CSE 240B,A00,102387,Zhao; Jishen,0,0,0,0
1668118714806,CSE 241A,A00,106406,Kang; Mingu,0,0,0,0
1668118715231,CSE 249B,A00,102388,Kahng; Andrew Byun,0,0,8,8
1668118715658,CSE 251B,A01,102392,Cottrell; Garrison W,0,0,0,0
1668118715658,CSE 251B,A02,102393,Cottrell; Garrison W,0,0,0,0
1668118716088,CSE 252B,A00,102394,Ochoa; Benjamin Lawrence,0,0,0,0
1668118716515,CSE 257,A01,102396,Gao; Sicun,0,0,0,0
1668118716946,CSE 272,A00,102397,Li; Tzumao,0,0,0,0
1668118717372,CSE 274,A00,111323,Chern; Albert Ren-Haur,0,0,0,0
1668118717800,CSE 282,A00,102398,Pevzner; Pavel Arkadjevich,0,0,0,0
1668118718224,CSE 284,A00,114175,Gymrek; Melissa Ann,0,0,0,0
1668118718653,CSE 290,A00,102399,Chandraker; Manmohan Krishna,0,0,0,0
1668118718653,CSE 290,B00,102400,Vaccaro; Kristen Marie,0,0,25,25
1668118718653,CSE 290,C00,102414,Pannuto; Patrick William,0,0,25,25
1668118718653,CSE 290,D00,102427,Pevzner; Pavel Arkadjevich,0,0,0,0
1668118718653,CSE 290,E00,102429,Zhao; Jishen,0,0,0,0
1668118718653,CSE 290,F00,102436,Tullsen; Dean Michael,0,0,0,0
1668118718653,CSE 290,G00,102440,Christensen; Henrik I,0,0,20,20
1668118719085,CSE 291,A00,102443,Su; Hao,0,0,0,0
1668118719085,CSE 291,B00,102448,Polikarpova; Nadezhda,0,0,0,0
1668118719085,CSE 291,C00,102453,Vaccaro; Kristen Marie,0,0,0,0
1668118719085,CSE 291,D00,111343,Savage; Stefan,0,0,0,0
1668118719085,CSE 291,E00,116474,Claffy; Kimberly Claire,0,0,0,0
1668118719085,CSE 291,F00,116479,Pasquale; Joseph,0,0,0,0
1668118719513,CSE 293,001,119111,Bafna; Vineet,9999,0,9999,0
1668118719513,CSE 293,002,119118,Bellare; Mihir,9999,0,9999,0
1668118719513,CSE 293,003,119122,Berg-Kirkpatrick; Taylor D,9999,0,9999,0
1668118719513,CSE 293,004,119135,Christensen; Henrik I,9999,0,9999,0
1668118719513,CSE 293,005,119142,Cottrell; Garrison W,9999,0,9999,0
1668118719513,CSE 293,006,119146,Deutsch; Alin Bernard,9999,0,9999,0
1668118719513,CSE 293,007,119159,Esmaeilzadeh; Hadi,9999,0,9999,0
1668118719513,CSE 293,008,119166,Freund; Yoav,9999,0,9999,0
1668118719513,CSE 293,009,119170,Griswold; William G.,9999,0,9999,0
1668118719513,CSE 293,010,119183,Gymrek; Melissa Ann,9999,0,9999,0
1668118719513,CSE 293,011,119190,Heninger; Nadia A,9999,0,9999,0
1668118719513,CSE 293,012,119230,Impagliazzo; Russell,9999,0,9999,0
1668118719513,CSE 293,013,119232,Jhala; Ranjit,9999,0,9999,0
1668118719513,CSE 293,014,119233,Kahng; Andrew Byun,9999,0,9999,0
1668118719513,CSE 293,015,119298,Kane; Daniel Mertz,9999,0,9999,0
1668118719513,CSE 293,016,119299,Kriegman; David J,9999,0,9999,0
1668118719513,CSE 293,017,119300,Kumar; Arun Kumar,9999,0,9999,0
1668118719513,CSE 293,018,119301,Lerner; Sorin,9999,0,9999,0
1668118719513,CSE 293,019,119302,Lovett; Shachar,9999,0,9999,0
1668118719513,CSE 293,020,119303,McAuley; Julian John,9999,0,9999,0
1668118719513,CSE 293,021,119304,Micciancio; Daniele,9999,0,9999,0
1668118719513,CSE 293,022,119367,Orailoglu; Alex,9999,0,9999,0
1668118719513,CSE 293,023,119382,Paturi; Ramamohan,9999,0,9999,0
1668118719513,CSE 293,024,119404,Polikarpova; Nadezhda,9999,0,9999,0
1668118719513,CSE 293,025,119406,Politz; Joseph Gibbs,9999,0,9999,0
1668118719513,CSE 293,026,119411,Porter; George M,9999,0,9999,0
1668118719513,CSE 293,027,119414,Porter; Leonard Emerson,9999,0,9999,0
1668118719513,CSE 293,028,119416,Ramamoorthi; Ravi,9999,0,9999,0
1668118719513,CSE 293,029,119417,Sahoo; Debashis,9999,0,9999,0
1668118719513,CSE 293,030,119420,Saul; Lawrence,9999,0,9999,0
1668118719513,CSE 293,031,119421,Savage; Stefan,9999,0,9999,0
1668118719513,CSE 293,032,119425,Schulze; Jurgen P.,9999,0,9999,0
1668118719513,CSE 293,033,119426,Snoeren; Alex C.,9999,0,9999,0
1668118719513,CSE 293,034,119428,Shang; Jingbo,9999,0,9999,0
1668118719513,CSE 293,035,119430,Stefan; Deian,9999,0,9999,0
1668118719513,CSE 293,036,119431,Su; Hao,9999,0,9999,0
1668118719513,CSE 293,037,119433,Swanson; Steven James,9999,0,9999,0
1668118719513,CSE 293,038,119435,Tullsen; Dean Michael,9999,0,9999,0
1668118719513,CSE 293,039,119483,Voelker; Geoffrey M.,9999,0,9999,0
1668118719513,CSE 293,040,119537,Zhao; Jishen,9999,0,9999,0
1668118719513,CSE 293,041,119538,Zhou; Yuan-Yuan,9999,0,9999,0
1668118719513,CSE 293,042,119539,Gao; Sicun,9999,0,9999,0
1668118719513,CSE 293,043,119540,Weibel; Nadir,9999,0,9999,0
1668118719513,CSE 293,044,119541,Gupta; Rajesh K.,9999,0,9999,0
1668118719513,CSE 293,045,126410,Vaccaro; Kristen Marie,9999,0,9999,0
1668118719513,CSE 293,046,126411,Klemke; Richard,9999,0,9999,0
1668118719943,CSE 294,A00,102459,Voelker; Geoffrey M.,0,0,0,0
1668118719943,CSE 294,B00,111322,Orailoglu; Alex,0,0,0,0
1668118720378,DSE 201,A00,096914,Deutsch; Alin Bernard,30,0,30,0
1668118720804,DSE 210,A00,096915,Dasgupta; Sanjoy,30,0,30,0
1668118721242,DSE 260A,A00,096916,Altintas De Callaf; Ilkay,30,0,30,0
1668118721681,ECE 200,001,103586,Antipa; Nicholas A,9999,0,9999,0
1668118721681,ECE 200,002,103587,Atanasov; Nikolay A.,9999,0,9999,0
1668118721681,ECE 200,003,103588,Bharadia; Dinesh,9999,0,9999,0
1668118721681,ECE 200,004,103589,Cheng; Chung Kuan,9999,0,9999,0
1668118721681,ECE 200,005,103590,Cosman; Pamela C.,9999,0,9999,0
1668118721681,ECE 200,006,103591,Dayeh; Shadi Ahmad,9999,0,9999,0
1668118721681,ECE 200,007,103592,Fainman; Yeshaiahu,9999,0,9999,0
1668118721681,ECE 200,008,103593,Ford; Joseph Earl,9999,0,9999,0
1668118721681,ECE 200,009,103594,Franceschetti; Massimo,9999,0,9999,0
1668118721681,ECE 200,010,103595,Fullerton; Eric E,9999,0,9999,0
1668118721681,ECE 200,011,103596,Galton; Ian A,9999,0,9999,0
1668118721681,ECE 200,012,103597,Gilja; Vikash,9999,0,9999,0
1668118721681,ECE 200,013,103598,Hall; Drew A.,9999,0,9999,0
1668118721681,ECE 200,014,103599,Hsueh; Tzu-Chien,9999,0,9999,0
1668118721681,ECE 200,015,103600,Javidi; Tara,9999,0,9999,0
1668118721681,ECE 200,016,103601,Kahng; Andrew Byun,9999,0,9999,0
1668118721681,ECE 200,017,103602,Kim; Young-Han,9999,0,9999,0
1668118721681,ECE 200,018,103603,Koushanfar; Farinaz,9999,0,9999,0
1668118721681,ECE 200,019,103604,Kuzum; Duygu,9999,0,9999,0
1668118721681,ECE 200,020,103605,Le; Hanh-Phuc,9999,0,9999,0
1668118721681,ECE 200,021,103606,Lin; Bill,9999,0,9999,0
1668118721681,ECE 200,022,103607,Liu; Zhaowei,9998,0,9999,1
1668118721681,ECE 200,023,103608,Lo; Yu-Hwa,9999,0,9999,0
1668118721681,ECE 200,024,103609,Lomakin; Vitaliy,9999,0,9999,0
1668118721681,ECE 200,025,103610,Mercier; Patrick Philip,9999,0,9999,0
1668118721681,ECE 200,026,103611,Meyer; Florian,9999,0,9999,0
1668118721681,ECE 200,027,103612,Milstein; Laurence B.,9999,0,9999,0
1668118721681,ECE 200,028,103613,Mir Arabbaygi; Siavash,9999,0,9999,0
1668118721681,ECE 200,029,103614,Mookherjea; Shayan,9999,0,9999,0
1668118721681,ECE 200,030,103615,Morris; Karcher William,9999,0,9999,0
1668118721681,ECE 200,031,103616,Ng; Tse Nga,9999,0,9999,0
1668118721681,ECE 200,032,103617,Nguyen; Truong Quang,9999,0,9999,0
1668118721681,ECE 200,033,103618,Nomura; Kenji,9999,0,9999,0
1668118721681,ECE 200,034,103619,Orlitsky; Alon,9999,0,9999,0
1668118721681,ECE 200,035,103620,Pal; Piya,9999,0,9999,0
1668118721681,ECE 200,036,103621,Papen; George C.,9999,0,9999,0
1668118721681,ECE 200,037,103622,Radic; Stojan,9999,0,9999,0
1668118721681,ECE 200,038,103623,Rao; Bhaskar D.,9999,0,9999,0
1668118721681,ECE 200,039,103624,Rao; Ramesh R,9999,0,9999,0
1668118721681,ECE 200,040,103625,Rebeiz; Gabriel,9999,0,9999,0
1668118721681,ECE 200,041,103626,Sanford; John R,9999,0,9999,0
1668118721681,ECE 200,042,103627,Siegel; Paul H.,9999,0,9999,0
1668118721681,ECE 200,043,103628,Sievenpiper; Daniel F.,9999,0,9999,0
1668118721681,ECE 200,044,103629,Sworder; David D.,9999,0,9999,0
1668118721681,ECE 200,045,103630,Taur; Yuan,9999,0,9999,0
1668118721681,ECE 200,046,103631,Touri; Behrouz,9999,0,9999,0
1668118721681,ECE 200,047,103632,Trivedi; Mohan M.,9999,0,9999,0
1668118721681,ECE 200,048,103633,Vasconcelos; Nuno,9999,0,9999,0
1668118721681,ECE 200,049,103634,Wang; Xiaolong,9999,0,9999,0
1668118721681,ECE 200,050,103635,Xie; Pengtao,9999,0,9999,0
1668118721681,ECE 200,051,103636,Yip; Michael,9999,0,9999,0
1668118721681,ECE 200,052,103637,Zeger; Kenneth A.,999,0,999,0
1668118721681,ECE 200,053,103638,Zhang; Xinyu,9999,0,9999,0
1668118721681,ECE 200,054,103639,Turakhia; Yatish Girish,9999,0,9999,0
1668118721681,ECE 200,055,103640,Kang; Mingu,9999,0,9999,0
1668118721681,ECE 200,056,103641,Shi; Yuanyuan,9999,0,9999,0
1668118721681,ECE 200,057,103642,Wang; Edward Jay,9999,0,9999,0
1668118721681,ECE 200,058,103643,Zheng; Yang,9999,0,9999,0
1668118722106,ECE 202,A00,103644,Kuzum; Duygu,0,0,0,0
1668118722542,ECE 212BN,A00,103646,Ng; Tse Nga,0,0,0,0
1668118722969,ECE 221,A00,111493,Staff,0,0,0,0
1668118723394,ECE 222B,A00,103647,Lomakin; Vitaliy,0,0,0,0
1668118723829,ECE 230B,A00,103648,Taur; Yuan,0,0,0,0
1668118724276,ECE 238B,A00,103649,Garay; Javier,0,0,0,0
1668118724704,ECE 240B,A00,112900,Fainman; Yeshaiahu,0,0,0,0
1668118725148,ECE 247A,A00,103650,Jokerst; Jesse Vincent,0,0,0,0
1668118725581,ECE 247B,A00,103651,Wang; Joseph,0,0,0,0
1668118726017,ECE 250,A00,103652,Siegel; Paul H.,0,0,0,0
1668118726440,ECE 251A,A00,103654,Rao; Bhaskar D.,0,0,0,0
1668118726863,ECE 257B,A00,103655,Bharadia; Dinesh,0,0,0,0
1668118727291,ECE 258A,A00,103656,Milstein; Laurence B.,0,0,0,0
1668118727716,ECE 260B,A00,103658,Kang; Mingu,0,0,0,0
1668118728156,ECE 264A,A00,103659,Galton; Ian A,0,0,0,0
1668118728590,ECE 265A,A00,103661,Gudem; Prasad S.S.,0,0,0,0
1668118729016,ECE 265D,A00,103662,Gudem; Prasad S.S.,0,0,0,0
1668118729442,ECE 268,A00,103663,Koushanfar; Farinaz,0,0,0,0
1668118729875,ECE 269,A01,103665,Pal; Piya,0,0,0,0
1668118730309,ECE 271B,A00,103666,Vasconcelos; Manuela,0,0,0,0
1668118730745,ECE 276A,A00,103667,Atanasov; Nikolay A.,0,0,0,0
1668118731168,ECE 277,A00,103668,An; Cheolhong,0,0,0,0
1668118731597,ECE 279,A00,117947,Hall; Drew A.,0,0,0,0
1668118732449,ECE 283,A00,103670,Hsueh; Tzu-Chien,0,0,0,0
1668118732882,ECE 284,A00,103671,Turakhia; Yatish Girish,0,0,0,0
1668118733307,ECE 285,A00,103672,Zheng; Yang,0,0,0,0
1668118733307,ECE 285,B00,103673,Sworder; David D.,0,0,0,0
1668118733733,ECE 287,A00,103676,Javidi; Tara,0,0,0,0
1668118734160,MATH 200B,A00,098023,Salehi Golsefidy; Alireza,12,0,15,3
1668118734599,MATH 202B,A00,098024,Rhoades; Brendon Patrick,9,0,15,6
1668118735028,MATH 203B,A00,098025,Oprea; Dragos N.,10,0,15,5
1668118735454,MATH 204B,A00,098026,Sorensen; Claus M,13,0,15,2
1668118735887,MATH 208,A00,098027,Izadi; Elham,7,0,10,3
1668118736308,MATH 209,A00,098028,Pollack; Aaron,10,0,10,0
1668118736743,MATH 211A,A00,112919,Rogalski; Daniel,9,0,10,1
1668118737179,MATH 211B,A00,112920,Seward; Brandon M.,9,0,10,1
1668118737618,MATH 218,A00,098029,Li; Bo,10,0,10,0
1668118738051,MATH 220B,A00,098030,Novak; Jonathan I,11,0,15,4
1668118738478,MATH 221A,A00,098031,Ebenfelt; Peter F,13,0,15,2
1668118738906,MATH 231B,A00,098032,Zlatos; Andrej,12,0,15,3
1668118739340,MATH 240B,A00,098033,Ni; Lei,9,0,15,6
1668118739762,MATH 243,A00,098034,Jekel; David Andrew,10,0,10,0
1668118740193,MATH 245A,A00,098035,Nie; Jiawang,0,0,15,16
1668118740617,MATH 248,A00,098036,Bejenaru; Ioan,10,0,10,0
1668118741053,MATH 250B,A00,098037,Spolaor; Luca,14,0,15,1
1668118741481,MATH 258,A00,098038,Ni; Lei,10,0,10,0
1668118741909,MATH 264B,A00,098041,Rhoades; Brendon Patrick,9,0,15,6
1668118742340,MATH 268,A00,098042,Buss; Samuel R,10,0,10,0
1668118742772,MATH 269,A00,098043,Rhoades; Brendon Patrick,10,0,10,0
1668118743197,MATH 270B,A00,098044,Li; Bo,10,0,15,5
1668118743627,MATH 272B,A00,098045,Holst; Michael J,13,0,15,2
1668118744052,MATH 273A,A00,098046,Tian; Xiaochuan,10,0,15,5
1668118744493,MATH 275,A01,098048,Tian; Xiaochuan,6,0,10,4
1668118744919,MATH 278A,A00,098049,Holst; Michael J,8,0,10,2
1668118745342,MATH 278B,A00,098050,Cloninger; Alexander,10,0,10,0
1668118745767,MATH 278C,A00,098051,Nie; Jiawang,7,0,10,3
1668118746199,MATH 280B,A00,098052,Zheng; Tianyi,10,0,15,5
1668118746624,MATH 281B,A00,098053,Bradic; Jelena,2,0,15,13
1668118747048,MATH 282B,A00,098054,Arias-Castro; Ery,0,0,15,15
1668118747471,MATH 285,A00,098055,Fitzsimmons; Patrick J,0,0,15,17
1668118747899,MATH 287B,A00,098056,Arias-Castro; Ery,3,0,15,12
1668118748327,MATH 288,A00,098057,Agarwal; Pooja,9,0,10,1
1668118748327,MATH 288,B00,098058,Zhang; Danna,8,0,10,2
1668118748327,MATH 288,C00,098059,Williams; Ruth J,10,0,10,0
1668118748764,MATH 290B,A00,098060,Roberts; Justin Deritter,13,0,15,2
1668118749195,MATH 292,A00,098061,Belmont; Eva Kinoshita,10,0,10,0
1668118749616,MATH 295,A00,098062,Suk; Andrew Hoon,48,0,50,2
1668118750056,MATH 296,A00,098063,Novak; Jonathan I,20,0,20,0
1668118750484,MATH 297,001,098064,Gamst; Anthony Collins,9997,0,9999,2
1668119258055,COGS 205,A00,101395,Chiba; Andrea,19,0,20,1
1668119258482,COGS 210B,001,101404,Greene; Deanna Jacquelyn,9998,0,9999,1
1668119258482,COGS 210B,002,101417,Xia; Haijun,9999,0,9999,0
1668119258482,COGS 210B,003,101422,Nitz; Douglas A.,9999,0,9999,0
1668119258482,COGS 210B,004,101423,Hollan; James D.,9998,0,9999,1
1668119258482,COGS 210B,005,101424,Deak; Gedeon O.,9998,0,9999,1
1668119258482,COGS 210B,006,101425,Rossano; Federico,9999,0,9999,0
1668119258910,COGS 211B,A00,101427,Coulson; Seana M,9996,0,9999,3
1668119259333,COGS 220,A00,101428,Hollan; James D.,0,0,25,25
1668119259756,COGS 229,A00,101429,Dow; Steven P,18,0,25,7
1668119260180,COGS 230,A00,101430,Klemmer; Scott R,12,0,17,5
1668119260623,COGS 234,A00,101431,Xia; Haijun,3,0,25,22
1668119261057,COGS 260,A00,101432,Kiyonaga; Anastasia,20,0,25,5
1668119261057,COGS 260,B00,101433,Kirsh; David Joel,16,0,25,9
1668119261491,CSE 202,A00,102371,Impagliazzo; Russell,0,0,0,0
1668119261970,CSE 203B,A01,102373,Cheng; Chung Kuan,0,0,0,0
1668119262403,CSE 208,A00,102374,Micciancio; Daniele,0,0,0,0
1668119262837,CSE 209A,A00,112895,Impagliazzo; Russell,0,0,15,15
1668119263282,CSE 209B,A00,108005,Bellare; Mihir,0,0,0,0
1668119263706,CSE 210,A00,113163,Coblenz; Michael J,0,0,0,0
1668119264133,CSE 219,A00,106111,Dow; Steven P,0,0,20,20
1668119264566,CSE 221,A00,102376,Voelker; Geoffrey M.,0,0,0,0
1668119265004,CSE 224,A01,102378,Porter; George M,0,0,0,0
1668119265431,CSE 229A,A00,102379,Savage; Stefan,0,0,0,0
1668119265857,CSE 229C,A00,102380,Munyaka; Imani N. S.,0,0,0,0
1668119266290,CSE 232B,A00,102382,Deutsch; Alin Bernard,0,0,0,0
1668119266726,CSE 234,A01,112904,Kumar; Arun Kumar,0,0,0,0
1668119267150,CSE 237A,A00,102383,Rosing; Tajana Simunic,0,0,0,0
1668119267575,CSE 239A,A00,102384,Deutsch; Alin Bernard,0,0,0,0
1668119268006,CSE 239B,A00,102385,Polikarpova; Nadezhda,0,0,0,0
1668119268429,CSE 240A,A00,102386,Pannuto; Patrick William,0,0,0,0
1668119268870,CSE 240B,A00,102387,Zhao; Jishen,0,0,0,0
1668119269301,CSE 241A,A00,106406,Kang; Mingu,0,0,0,0
1668119269724,CSE 249B,A00,102388,Kahng; Andrew Byun,0,0,8,8
1668119270148,CSE 251B,A01,102392,Cottrell; Garrison W,0,0,0,0
1668119270148,CSE 251B,A02,102393,Cottrell; Garrison W,0,0,0,0
1668119270591,CSE 252B,A00,102394,Ochoa; Benjamin Lawrence,0,0,0,0
1668119271015,CSE 257,A01,102396,Gao; Sicun,0,0,0,0
1668119271448,CSE 272,A00,102397,Li; Tzumao,0,0,0,0
1668119271873,CSE 274,A00,111323,Chern; Albert Ren-Haur,0,0,0,0
1668119272308,CSE 282,A00,102398,Pevzner; Pavel Arkadjevich,0,0,0,0
1668119272754,CSE 284,A00,114175,Gymrek; Melissa Ann,0,0,0,0
1668119273184,CSE 290,A00,102399,Chandraker; Manmohan Krishna,0,0,0,0
1668119273184,CSE 290,B00,102400,Vaccaro; Kristen Marie,0,0,25,25
1668119273184,CSE 290,C00,102414,Pannuto; Patrick William,0,0,25,25
1668119273184,CSE 290,D00,102427,Pevzner; Pavel Arkadjevich,0,0,0,0
1668119273184,CSE 290,E00,102429,Zhao; Jishen,0,0,0,0
1668119273184,CSE 290,F00,102436,Tullsen; Dean Michael,0,0,0,0
1668119273184,CSE 290,G00,102440,Christensen; Henrik I,0,0,20,20
1668119273616,CSE 291,A00,102443,Su; Hao,0,0,0,0
1668119273616,CSE 291,B00,102448,Polikarpova; Nadezhda,0,0,0,0
1668119273616,CSE 291,C00,102453,Vaccaro; Kristen Marie,0,0,0,0
1668119273616,CSE 291,D00,111343,Savage; Stefan,0,0,0,0
1668119273616,CSE 291,E00,116474,Claffy; Kimberly Claire,0,0,0,0
1668119273616,CSE 291,F00,116479,Pasquale; Joseph,0,0,0,0
1668119274052,CSE 293,001,119111,Bafna; Vineet,9999,0,9999,0
1668119274052,CSE 293,002,119118,Bellare; Mihir,9999,0,9999,0
1668119274052,CSE 293,003,119122,Berg-Kirkpatrick; Taylor D,9999,0,9999,0
1668119274052,CSE 293,004,119135,Christensen; Henrik I,9999,0,9999,0
1668119274052,CSE 293,005,119142,Cottrell; Garrison W,9999,0,9999,0
1668119274052,CSE 293,006,119146,Deutsch; Alin Bernard,9999,0,9999,0
1668119274052,CSE 293,007,119159,Esmaeilzadeh; Hadi,9999,0,9999,0
1668119274052,CSE 293,008,119166,Freund; Yoav,9999,0,9999,0
1668119274052,CSE 293,009,119170,Griswold; William G.,9999,0,9999,0
1668119274052,CSE 293,010,119183,Gymrek; Melissa Ann,9999,0,9999,0
1668119274052,CSE 293,011,119190,Heninger; Nadia A,9999,0,9999,0
1668119274052,CSE 293,012,119230,Impagliazzo; Russell,9999,0,9999,0
1668119274052,CSE 293,013,119232,Jhala; Ranjit,9999,0,9999,0
1668119274052,CSE 293,014,119233,Kahng; Andrew Byun,9999,0,9999,0
1668119274052,CSE 293,015,119298,Kane; Daniel Mertz,9999,0,9999,0
1668119274052,CSE 293,016,119299,Kriegman; David J,9999,0,9999,0
1668119274052,CSE 293,017,119300,Kumar; Arun Kumar,9999,0,9999,0
1668119274052,CSE 293,018,119301,Lerner; Sorin,9999,0,9999,0
1668119274052,CSE 293,019,119302,Lovett; Shachar,9999,0,9999,0
1668119274052,CSE 293,020,119303,McAuley; Julian John,9999,0,9999,0
1668119274052,CSE 293,021,119304,Micciancio; Daniele,9999,0,9999,0
1668119274052,CSE 293,022,119367,Orailoglu; Alex,9999,0,9999,0
1668119274052,CSE 293,023,119382,Paturi; Ramamohan,9999,0,9999,0
1668119274052,CSE 293,024,119404,Polikarpova; Nadezhda,9999,0,9999,0
1668119274052,CSE 293,025,119406,Politz; Joseph Gibbs,9999,0,9999,0
1668119274052,CSE 293,026,119411,Porter; George M,9999,0,9999,0
1668119274052,CSE 293,027,119414,Porter; Leonard Emerson,9999,0,9999,0
1668119274052,CSE 293,028,119416,Ramamoorthi; Ravi,9999,0,9999,0
1668119274052,CSE 293,029,119417,Sahoo; Debashis,9999,0,9999,0
1668119274052,CSE 293,030,119420,Saul; Lawrence,9999,0,9999,0
1668119274052,CSE 293,031,119421,Savage; Stefan,9999,0,9999,0
1668119274052,CSE 293,032,119425,Schulze; Jurgen P.,9999,0,9999,0
1668119274052,CSE 293,033,119426,Snoeren; Alex C.,9999,0,9999,0
1668119274052,CSE 293,034,119428,Shang; Jingbo,9999,0,9999,0
1668119274052,CSE 293,035,119430,Stefan; Deian,9999,0,9999,0
1668119274052,CSE 293,036,119431,Su; Hao,9999,0,9999,0
1668119274052,CSE 293,037,119433,Swanson; Steven James,9999,0,9999,0
1668119274052,CSE 293,038,119435,Tullsen; Dean Michael,9999,0,9999,0
1668119274052,CSE 293,039,119483,Voelker; Geoffrey M.,9999,0,9999,0
1668119274052,CSE 293,040,119537,Zhao; Jishen,9999,0,9999,0
1668119274052,CSE 293,041,119538,Zhou; Yuan-Yuan,9999,0,9999,0
1668119274052,CSE 293,042,119539,Gao; Sicun,9999,0,9999,0
1668119274052,CSE 293,043,119540,Weibel; Nadir,9999,0,9999,0
1668119274052,CSE 293,044,119541,Gupta; Rajesh K.,9999,0,9999,0
1668119274052,CSE 293,045,126410,Vaccaro; Kristen Marie,9999,0,9999,0
1668119274052,CSE 293,046,126411,Klemke; Richard,9999,0,9999,0
1668119274490,CSE 294,A00,102459,Voelker; Geoffrey M.,0,0,0,0
1668119274490,CSE 294,B00,111322,Orailoglu; Alex,0,0,0,0
1668119274920,DSE 201,A00,096914,Deutsch; Alin Bernard,30,0,30,0
1668119275350,DSE 210,A00,096915,Dasgupta; Sanjoy,30,0,30,0
1668119275779,DSE 260A,A00,096916,Altintas De Callaf; Ilkay,30,0,30,0
1668119276207,ECE 200,001,103586,Antipa; Nicholas A,9999,0,9999,0
1668119276207,ECE 200,002,103587,Atanasov; Nikolay A.,9999,0,9999,0
1668119276207,ECE 200,003,103588,Bharadia; Dinesh,9999,0,9999,0
1668119276207,ECE 200,004,103589,Cheng; Chung Kuan,9999,0,9999,0
1668119276207,ECE 200,005,103590,Cosman; Pamela C.,9999,0,9999,0
1668119276207,ECE 200,006,103591,Dayeh; Shadi Ahmad,9999,0,9999,0
1668119276207,ECE 200,007,103592,Fainman; Yeshaiahu,9999,0,9999,0
1668119276207,ECE 200,008,103593,Ford; Joseph Earl,9999,0,9999,0
1668119276207,ECE 200,009,103594,Franceschetti; Massimo,9999,0,9999,0
1668119276207,ECE 200,010,103595,Fullerton; Eric E,9999,0,9999,0
1668119276207,ECE 200,011,103596,Galton; Ian A,9999,0,9999,0
1668119276207,ECE 200,012,103597,Gilja; Vikash,9999,0,9999,0
1668119276207,ECE 200,013,103598,Hall; Drew A.,9999,0,9999,0
1668119276207,ECE 200,014,103599,Hsueh; Tzu-Chien,9999,0,9999,0
1668119276207,ECE 200,015,103600,Javidi; Tara,9999,0,9999,0
1668119276207,ECE 200,016,103601,Kahng; Andrew Byun,9999,0,9999,0
1668119276207,ECE 200,017,103602,Kim; Young-Han,9999,0,9999,0
1668119276207,ECE 200,018,103603,Koushanfar; Farinaz,9999,0,9999,0
1668119276207,ECE 200,019,103604,Kuzum; Duygu,9999,0,9999,0
1668119276207,ECE 200,020,103605,Le; Hanh-Phuc,9999,0,9999,0
1668119276207,ECE 200,021,103606,Lin; Bill,9999,0,9999,0
1668119276207,ECE 200,022,103607,Liu; Zhaowei,9998,0,9999,1
1668119276207,ECE 200,023,103608,Lo; Yu-Hwa,9999,0,9999,0
1668119276207,ECE 200,024,103609,Lomakin; Vitaliy,9999,0,9999,0
1668119276207,ECE 200,025,103610,Mercier; Patrick Philip,9999,0,9999,0
1668119276207,ECE 200,026,103611,Meyer; Florian,9999,0,9999,0
1668119276207,ECE 200,027,103612,Milstein; Laurence B.,9999,0,9999,0
1668119276207,ECE 200,028,103613,Mir Arabbaygi; Siavash,9999,0,9999,0
1668119276207,ECE 200,029,103614,Mookherjea; Shayan,9999,0,9999,0
1668119276207,ECE 200,030,103615,Morris; Karcher William,9999,0,9999,0
1668119276207,ECE 200,031,103616,Ng; Tse Nga,9999,0,9999,0
1668119276207,ECE 200,032,103617,Nguyen; Truong Quang,9999,0,9999,0
1668119276207,ECE 200,033,103618,Nomura; Kenji,9999,0,9999,0
1668119276207,ECE 200,034,103619,Orlitsky; Alon,9999,0,9999,0
1668119276207,ECE 200,035,103620,Pal; Piya,9999,0,9999,0
1668119276207,ECE 200,036,103621,Papen; George C.,9999,0,9999,0
1668119276207,ECE 200,037,103622,Radic; Stojan,9999,0,9999,0
1668119276207,ECE 200,038,103623,Rao; Bhaskar D.,9999,0,9999,0
1668119276207,ECE 200,039,103624,Rao; Ramesh R,9999,0,9999,0
1668119276207,ECE 200,040,103625,Rebeiz; Gabriel,9999,0,9999,0
1668119276207,ECE 200,041,103626,Sanford; John R,9999,0,9999,0
1668119276207,ECE 200,042,103627,Siegel; Paul H.,9999,0,9999,0
1668119276207,ECE 200,043,103628,Sievenpiper; Daniel F.,9999,0,9999,0
1668119276207,ECE 200,044,103629,Sworder; David D.,9999,0,9999,0
1668119276207,ECE 200,045,103630,Taur; Yuan,9999,0,9999,0
1668119276207,ECE 200,046,103631,Touri; Behrouz,9999,0,9999,0
1668119276207,ECE 200,047,103632,Trivedi; Mohan M.,9999,0,9999,0
1668119276207,ECE 200,048,103633,Vasconcelos; Nuno,9999,0,9999,0
1668119276207,ECE 200,049,103634,Wang; Xiaolong,9999,0,9999,0
1668119276207,ECE 200,050,103635,Xie; Pengtao,9999,0,9999,0
1668119276207,ECE 200,051,103636,Yip; Michael,9999,0,9999,0
1668119276207,ECE 200,052,103637,Zeger; Kenneth A.,999,0,999,0
1668119276207,ECE 200,053,103638,Zhang; Xinyu,9999,0,9999,0
1668119276207,ECE 200,054,103639,Turakhia; Yatish Girish,9999,0,9999,0
1668119276207,ECE 200,055,103640,Kang; Mingu,9999,0,9999,0
1668119276207,ECE 200,056,103641,Shi; Yuanyuan,9999,0,9999,0
1668119276207,ECE 200,057,103642,Wang; Edward Jay,9999,0,9999,0
1668119276207,ECE 200,058,103643,Zheng; Yang,9999,0,9999,0
1668119276632,ECE 202,A00,103644,Kuzum; Duygu,0,0,0,0
1668119277054,ECE 212BN,A00,103646,Ng; Tse Nga,0,0,0,0
1668119277478,ECE 221,A00,111493,Staff,0,0,0,0
1668119277899,ECE 222B,A00,103647,Lomakin; Vitaliy,0,0,0,0
1668119278320,ECE 230B,A00,103648,Taur; Yuan,0,0,0,0
1668119278744,ECE 238B,A00,103649,Garay; Javier,0,0,0,0
1668119279182,ECE 240B,A00,112900,Fainman; Yeshaiahu,0,0,0,0
1668119279606,ECE 247A,A00,103650,Jokerst; Jesse Vincent,0,0,0,0
1668119280031,ECE 247B,A00,103651,Wang; Joseph,0,0,0,0
1668119280462,ECE 250,A00,103652,Siegel; Paul H.,0,0,0,0
1668119280896,ECE 251A,A00,103654,Rao; Bhaskar D.,0,0,0,0
1668119281321,ECE 257B,A00,103655,Bharadia; Dinesh,0,0,0,0
1668119281856,ECE 258A,A00,103656,Milstein; Laurence B.,0,0,0,0
1668119282284,ECE 260B,A00,103658,Kang; Mingu,0,0,0,0
1668119282721,ECE 264A,A00,103659,Galton; Ian A,0,0,0,0
1668119283159,ECE 265A,A00,103661,Gudem; Prasad S.S.,0,0,0,0
1668119283597,ECE 265D,A00,103662,Gudem; Prasad S.S.,0,0,0,0
1668119284024,ECE 268,A00,103663,Koushanfar; Farinaz,0,0,0,0
1668119284448,ECE 269,A01,103665,Pal; Piya,0,0,0,0
1668119284874,ECE 271B,A00,103666,Vasconcelos; Manuela,0,0,0,0
1668119285298,ECE 276A,A00,103667,Atanasov; Nikolay A.,0,0,0,0
1668119285721,ECE 277,A00,103668,An; Cheolhong,0,0,0,0
1668119286158,ECE 279,A00,117947,Hall; Drew A.,0,0,0,0
1668119287012,ECE 283,A00,103670,Hsueh; Tzu-Chien,0,0,0,0
1668119287438,ECE 284,A00,103671,Turakhia; Yatish Girish,0,0,0,0
1668119287862,ECE 285,A00,103672,Zheng; Yang,0,0,0,0
1668119287862,ECE 285,B00,103673,Sworder; David D.,0,0,0,0
1668119288291,ECE 287,A00,103676,Javidi; Tara,0,0,0,0
1668119288726,MATH 200B,A00,098023,Salehi Golsefidy; Alireza,12,0,15,3
1668119289151,MATH 202B,A00,098024,Rhoades; Brendon Patrick,9,0,15,6
1668119289581,MATH 203B,A00,098025,Oprea; Dragos N.,10,0,15,5
1668119290005,MATH 204B,A00,098026,Sorensen; Claus M,13,0,15,2
1668119290430,MATH 208,A00,098027,Izadi; Elham,7,0,10,3
1668119290852,MATH 209,A00,098028,Pollack; Aaron,10,0,10,0
1668119291283,MATH 211A,A00,112919,Rogalski; Daniel,9,0,10,1
1668119291735,MATH 211B,A00,112920,Seward; Brandon M.,9,0,10,1
1668119292158,MATH 218,A00,098029,Li; Bo,10,0,10,0
1668119292582,MATH 220B,A00,098030,Novak; Jonathan I,11,0,15,4
1668119293011,MATH 221A,A00,098031,Ebenfelt; Peter F,13,0,15,2
1668119293440,MATH 231B,A00,098032,Zlatos; Andrej,12,0,15,3
1668119293874,MATH 240B,A00,098033,Ni; Lei,9,0,15,6
1668119294305,MATH 243,A00,098034,Jekel; David Andrew,10,0,10,0
1668119294746,MATH 245A,A00,098035,Nie; Jiawang,0,0,15,16
1668119295182,MATH 248,A00,098036,Bejenaru; Ioan,10,0,10,0
1668119295604,MATH 250B,A00,098037,Spolaor; Luca,14,0,15,1
1668119296027,MATH 258,A00,098038,Ni; Lei,10,0,10,0
1668119296452,MATH 264B,A00,098041,Rhoades; Brendon Patrick,9,0,15,6
1668119296877,MATH 268,A00,098042,Buss; Samuel R,10,0,10,0
1668119297303,MATH 269,A00,098043,Rhoades; Brendon Patrick,10,0,10,0
1668119297731,MATH 270B,A00,098044,Li; Bo,10,0,15,5
1668119298155,MATH 272B,A00,098045,Holst; Michael J,13,0,15,2
1668119298589,MATH 273A,A00,098046,Tian; Xiaochuan,10,0,15,5
1668119299018,MATH 275,A01,098048,Tian; Xiaochuan,6,0,10,4
1668119299456,MATH 278A,A00,098049,Holst; Michael J,8,0,10,2
1668119299881,MATH 278B,A00,098050,Cloninger; Alexander,10,0,10,0
1668119300304,MATH 278C,A00,098051,Nie; Jiawang,7,0,10,3
1668119300730,MATH 280B,A00,098052,Zheng; Tianyi,10,0,15,5
1668119301153,MATH 281B,A00,098053,Bradic; Jelena,2,0,15,13
1668119301583,MATH 282B,A00,098054,Arias-Castro; Ery,0,0,15,15
1668119302008,MATH 285,A00,098055,Fitzsimmons; Patrick J,0,0,15,17
1668119302440,MATH 287B,A00,098056,Arias-Castro; Ery,3,0,15,12
1668119302871,MATH 288,A00,098057,Agarwal; Pooja,9,0,10,1
1668119302871,MATH 288,B00,098058,Zhang; Danna,8,0,10,2
1668119302871,MATH 288,C00,098059,Williams; Ruth J,10,0,10,0
1668119303300,MATH 290B,A00,098060,Roberts; Justin Deritter,13,0,15,2
1668119303728,MATH 292,A00,098061,Belmont; Eva Kinoshita,10,0,10,0
1668119304153,MATH 295,A00,098062,Suk; Andrew Hoon,48,0,50,2
1668119304576,MATH 296,A00,098063,Novak; Jonathan I,20,0,20,0
1668119305015,MATH 297,001,098064,Gamst; Anthony Collins,9997,0,9999,2
1668119810759,COGS 205,A00,101395,Chiba; Andrea,19,0,20,1
1668119811186,COGS 210B,001,101404,Greene; Deanna Jacquelyn,9998,0,9999,1
1668119811186,COGS 210B,002,101417,Xia; Haijun,9999,0,9999,0
1668119811186,COGS 210B,003,101422,Nitz; Douglas A.,9999,0,9999,0
1668119811186,COGS 210B,004,101423,Hollan; James D.,9998,0,9999,1
1668119811186,COGS 210B,005,101424,Deak; Gedeon O.,9998,0,9999,1
1668119811186,COGS 210B,006,101425,Rossano; Federico,9999,0,9999,0
1668119811625,COGS 211B,A00,101427,Coulson; Seana M,9996,0,9999,3
1668119812067,COGS 220,A00,101428,Hollan; James D.,0,0,25,25
1668119812490,COGS 229,A00,101429,Dow; Steven P,18,0,25,7
1668119812915,COGS 230,A00,101430,Klemmer; Scott R,12,0,17,5
1668119813346,COGS 234,A00,101431,Xia; Haijun,3,0,25,22
1668119813769,COGS 260,A00,101432,Kiyonaga; Anastasia,20,0,25,5
1668119813769,COGS 260,B00,101433,Kirsh; David Joel,16,0,25,9
1668119814195,CSE 202,A00,102371,Impagliazzo; Russell,0,0,0,0
1668119814623,CSE 203B,A01,102373,Cheng; Chung Kuan,0,0,0,0
1668119815069,CSE 208,A00,102374,Micciancio; Daniele,0,0,0,0
1668119815500,CSE 209A,A00,112895,Impagliazzo; Russell,0,0,15,15
1668119815925,CSE 209B,A00,108005,Bellare; Mihir,0,0,0,0
1668119816354,CSE 210,A00,113163,Coblenz; Michael J,0,0,0,0
1668119816809,CSE 219,A00,106111,Dow; Steven P,0,0,20,20
1668119817238,CSE 221,A00,102376,Voelker; Geoffrey M.,0,0,0,0
1668119817664,CSE 224,A01,102378,Porter; George M,0,0,0,0
1668119818093,CSE 229A,A00,102379,Savage; Stefan,0,0,0,0
1668119818530,CSE 229C,A00,102380,Munyaka; Imani N. S.,0,0,0,0
1668119818957,CSE 232B,A00,102382,Deutsch; Alin Bernard,0,0,0,0
1668119819384,CSE 234,A01,112904,Kumar; Arun Kumar,0,0,0,0
1668119819808,CSE 237A,A00,102383,Rosing; Tajana Simunic,0,0,0,0
1668119820231,CSE 239A,A00,102384,Deutsch; Alin Bernard,0,0,0,0
1668119820657,CSE 239B,A00,102385,Polikarpova; Nadezhda,0,0,0,0
1668119821087,CSE 240A,A00,102386,Pannuto; Patrick William,0,0,0,0
1668119821514,CSE 240B,A00,102387,Zhao; Jishen,0,0,0,0
1668119821949,CSE 241A,A00,106406,Kang; Mingu,0,0,0,0
1668119822376,CSE 249B,A00,102388,Kahng; Andrew Byun,0,0,8,8
1668119822799,CSE 251B,A01,102392,Cottrell; Garrison W,0,0,0,0
1668119822799,CSE 251B,A02,102393,Cottrell; Garrison W,0,0,0,0
1668119823226,CSE 252B,A00,102394,Ochoa; Benjamin Lawrence,0,0,0,0
1668119823668,CSE 257,A01,102396,Gao; Sicun,0,0,0,0
1668119824094,CSE 272,A00,102397,Li; Tzumao,0,0,0,0
1668119824516,CSE 274,A00,111323,Chern; Albert Ren-Haur,0,0,0,0
1668119824943,CSE 282,A00,102398,Pevzner; Pavel Arkadjevich,0,0,0,0
1668119825371,CSE 284,A00,114175,Gymrek; Melissa Ann,0,0,0,0
1668119825812,CSE 290,A00,102399,Chandraker; Manmohan Krishna,0,0,0,0
1668119825812,CSE 290,B00,102400,Vaccaro; Kristen Marie,0,0,25,25
1668119825812,CSE 290,C00,102414,Pannuto; Patrick William,0,0,25,25
1668119825812,CSE 290,D00,102427,Pevzner; Pavel Arkadjevich,0,0,0,0
1668119825812,CSE 290,E00,102429,Zhao; Jishen,0,0,0,0
1668119825812,CSE 290,F00,102436,Tullsen; Dean Michael,0,0,0,0
1668119825812,CSE 290,G00,102440,Christensen; Henrik I,0,0,20,20
1668119826239,CSE 291,A00,102443,Su; Hao,0,0,0,0
1668119826239,CSE 291,B00,102448,Polikarpova; Nadezhda,0,0,0,0
1668119826239,CSE 291,C00,102453,Vaccaro; Kristen Marie,0,0,0,0
1668119826239,CSE 291,D00,111343,Savage; Stefan,0,0,0,0
1668119826239,CSE 291,E00,116474,Claffy; Kimberly Claire,0,0,0,0
1668119826239,CSE 291,F00,116479,Pasquale; Joseph,0,0,0,0
1668119826683,CSE 293,001,119111,Bafna; Vineet,9999,0,9999,0
1668119826683,CSE 293,002,119118,Bellare; Mihir,9999,0,9999,0
1668119826683,CSE 293,003,119122,Berg-Kirkpatrick; Taylor D,9999,0,9999,0
1668119826683,CSE 293,004,119135,Christensen; Henrik I,9999,0,9999,0
1668119826683,CSE 293,005,119142,Cottrell; Garrison W,9999,0,9999,0
1668119826683,CSE 293,006,119146,Deutsch; Alin Bernard,9999,0,9999,0
1668119826683,CSE 293,007,119159,Esmaeilzadeh; Hadi,9999,0,9999,0
1668119826683,CSE 293,008,119166,Freund; Yoav,9999,0,9999,0
1668119826683,CSE 293,009,119170,Griswold; William G.,9999,0,9999,0
1668119826683,CSE 293,010,119183,Gymrek; Melissa Ann,9999,0,9999,0
1668119826683,CSE 293,011,119190,Heninger; Nadia A,9999,0,9999,0
1668119826683,CSE 293,012,119230,Impagliazzo; Russell,9999,0,9999,0
1668119826683,CSE 293,013,119232,Jhala; Ranjit,9999,0,9999,0
1668119826683,CSE 293,014,119233,Kahng; Andrew Byun,9999,0,9999,0
1668119826683,CSE 293,015,119298,Kane; Daniel Mertz,9999,0,9999,0
1668119826683,CSE 293,016,119299,Kriegman; David J,9999,0,9999,0
1668119826683,CSE 293,017,119300,Kumar; Arun Kumar,9999,0,9999,0
1668119826683,CSE 293,018,119301,Lerner; Sorin,9999,0,9999,0
1668119826683,CSE 293,019,119302,Lovett; Shachar,9999,0,9999,0
1668119826683,CSE 293,020,119303,McAuley; Julian John,9999,0,9999,0
1668119826683,CSE 293,021,119304,Micciancio; Daniele,9999,0,9999,0
1668119826683,CSE 293,022,119367,Orailoglu; Alex,9999,0,9999,0
1668119826683,CSE 293,023,119382,Paturi; Ramamohan,9999,0,9999,0
1668119826683,CSE 293,024,119404,Polikarpova; Nadezhda,9999,0,9999,0
1668119826683,CSE 293,025,119406,Politz; Joseph Gibbs,9999,0,9999,0
1668119826683,CSE 293,026,119411,Porter; George M,9999,0,9999,0
1668119826683,CSE 293,027,119414,Porter; Leonard Emerson,9999,0,9999,0
1668119826683,CSE 293,028,119416,Ramamoorthi; Ravi,9999,0,9999,0
1668119826683,CSE 293,029,119417,Sahoo; Debashis,9999,0,9999,0
1668119826683,CSE 293,030,119420,Saul; Lawrence,9999,0,9999,0
1668119826683,CSE 293,031,119421,Savage; Stefan,9999,0,9999,0
1668119826683,CSE 293,032,119425,Schulze; Jurgen P.,9999,0,9999,0
1668119826683,CSE 293,033,119426,Snoeren; Alex C.,9999,0,9999,0
1668119826683,CSE 293,034,119428,Shang; Jingbo,9999,0,9999,0
1668119826683,CSE 293,035,119430,Stefan; Deian,9999,0,9999,0
1668119826683,CSE 293,036,119431,Su; Hao,9999,0,9999,0
1668119826683,CSE 293,037,119433,Swanson; Steven James,9999,0,9999,0
1668119826683,CSE 293,038,119435,Tullsen; Dean Michael,9999,0,9999,0
1668119826683,CSE 293,039,119483,Voelker; Geoffrey M.,9999,0,9999,0
1668119826683,CSE 293,040,119537,Zhao; Jishen,9999,0,9999,0
1668119826683,CSE 293,041,119538,Zhou; Yuan-Yuan,9999,0,9999,0
1668119826683,CSE 293,042,119539,Gao; Sicun,9999,0,9999,0
1668119826683,CSE 293,043,119540,Weibel; Nadir,9999,0,9999,0
1668119826683,CSE 293,044,119541,Gupta; Rajesh K.,9999,0,9999,0
1668119826683,CSE 293,045,126410,Vaccaro; Kristen Marie,9999,0,9999,0
1668119826683,CSE 293,046,126411,Klemke; Richard,9999,0,9999,0
1668119827106,CSE 294,A00,102459,Voelker; Geoffrey M.,0,0,0,0
1668119827106,CSE 294,B00,111322,Orailoglu; Alex,0,0,0,0
1668119827530,DSE 201,A00,096914,Deutsch; Alin Bernard,30,0,30,0
1668119827964,DSE 210,A00,096915,Dasgupta; Sanjoy,30,0,30,0
1668119828400,DSE 260A,A00,096916,Altintas De Callaf; Ilkay,30,0,30,0
1668119828854,ECE 200,001,103586,Antipa; Nicholas A,9999,0,9999,0
1668119828854,ECE 200,002,103587,Atanasov; Nikolay A.,9999,0,9999,0
1668119828854,ECE 200,003,103588,Bharadia; Dinesh,9999,0,9999,0
1668119828854,ECE 200,004,103589,Cheng; Chung Kuan,9999,0,9999,0
1668119828854,ECE 200,005,103590,Cosman; Pamela C.,9999,0,9999,0
1668119828854,ECE 200,006,103591,Dayeh; Shadi Ahmad,9999,0,9999,0
1668119828854,ECE 200,007,103592,Fainman; Yeshaiahu,9999,0,9999,0
1668119828854,ECE 200,008,103593,Ford; Joseph Earl,9999,0,9999,0
1668119828854,ECE 200,009,103594,Franceschetti; Massimo,9999,0,9999,0
1668119828854,ECE 200,010,103595,Fullerton; Eric E,9999,0,9999,0
1668119828854,ECE 200,011,103596,Galton; Ian A,9999,0,9999,0
1668119828854,ECE 200,012,103597,Gilja; Vikash,9999,0,9999,0
1668119828854,ECE 200,013,103598,Hall; Drew A.,9999,0,9999,0
1668119828854,ECE 200,014,103599,Hsueh; Tzu-Chien,9999,0,9999,0
1668119828854,ECE 200,015,103600,Javidi; Tara,9999,0,9999,0
1668119828854,ECE 200,016,103601,Kahng; Andrew Byun,9999,0,9999,0
1668119828854,ECE 200,017,103602,Kim; Young-Han,9999,0,9999,0
1668119828854,ECE 200,018,103603,Koushanfar; Farinaz,9999,0,9999,0
1668119828854,ECE 200,019,103604,Kuzum; Duygu,9999,0,9999,0
1668119828854,ECE 200,020,103605,Le; Hanh-Phuc,9999,0,9999,0
1668119828854,ECE 200,021,103606,Lin; Bill,9999,0,9999,0
1668119828854,ECE 200,022,103607,Liu; Zhaowei,9998,0,9999,1
1668119828854,ECE 200,023,103608,Lo; Yu-Hwa,9999,0,9999,0
1668119828854,ECE 200,024,103609,Lomakin; Vitaliy,9999,0,9999,0
1668119828854,ECE 200,025,103610,Mercier; Patrick Philip,9999,0,9999,0
1668119828854,ECE 200,026,103611,Meyer; Florian,9999,0,9999,0
1668119828854,ECE 200,027,103612,Milstein; Laurence B.,9999,0,9999,0
1668119828854,ECE 200,028,103613,Mir Arabbaygi; Siavash,9999,0,9999,0
1668119828854,ECE 200,029,103614,Mookherjea; Shayan,9999,0,9999,0
1668119828854,ECE 200,030,103615,Morris; Karcher William,9999,0,9999,0
1668119828854,ECE 200,031,103616,Ng; Tse Nga,9999,0,9999,0
1668119828854,ECE 200,032,103617,Nguyen; Truong Quang,9999,0,9999,0
1668119828854,ECE 200,033,103618,Nomura; Kenji,9999,0,9999,0
1668119828854,ECE 200,034,103619,Orlitsky; Alon,9999,0,9999,0
1668119828854,ECE 200,035,103620,Pal; Piya,9999,0,9999,0
1668119828854,ECE 200,036,103621,Papen; George C.,9999,0,9999,0
1668119828854,ECE 200,037,103622,Radic; Stojan,9999,0,9999,0
1668119828854,ECE 200,038,103623,Rao; Bhaskar D.,9999,0,9999,0
1668119828854,ECE 200,039,103624,Rao; Ramesh R,9999,0,9999,0
1668119828854,ECE 200,040,103625,Rebeiz; Gabriel,9999,0,9999,0
1668119828854,ECE 200,041,103626,Sanford; John R,9999,0,9999,0
1668119828854,ECE 200,042,103627,Siegel; Paul H.,9999,0,9999,0
1668119828854,ECE 200,043,103628,Sievenpiper; Daniel F.,9999,0,9999,0
1668119828854,ECE 200,044,103629,Sworder; David D.,9999,0,9999,0
1668119828854,ECE 200,045,103630,Taur; Yuan,9999,0,9999,0
1668119828854,ECE 200,046,103631,Touri; Behrouz,9999,0,9999,0
1668119828854,ECE 200,047,103632,Trivedi; Mohan M.,9999,0,9999,0
1668119828854,ECE 200,048,103633,Vasconcelos; Nuno,9999,0,9999,0
1668119828854,ECE 200,049,103634,Wang; Xiaolong,9999,0,9999,0
1668119828854,ECE 200,050,103635,Xie; Pengtao,9999,0,9999,0
1668119828854,ECE 200,051,103636,Yip; Michael,9999,0,9999,0
1668119828854,ECE 200,052,103637,Zeger; Kenneth A.,999,0,999,0
1668119828854,ECE 200,053,103638,Zhang; Xinyu,9999,0,9999,0
1668119828854,ECE 200,054,103639,Turakhia; Yatish Girish,9999,0,9999,0
1668119828854,ECE 200,055,103640,Kang; Mingu,9999,0,9999,0
1668119828854,ECE 200,056,103641,Shi; Yuanyuan,9999,0,9999,0
1668119828854,ECE 200,057,103642,Wang; Edward Jay,9999,0,9999,0
1668119828854,ECE 200,058,103643,Zheng; Yang,9999,0,9999,0
1668119829285,ECE 202,A00,103644,Kuzum; Duygu,0,0,0,0
1668119829720,ECE 212BN,A00,103646,Ng; Tse Nga,0,0,0,0
1668119830149,ECE 221,A00,111493,Staff,0,0,0,0
1668119830574,ECE 222B,A00,103647,Lomakin; Vitaliy,0,0,0,0
1668119830997,ECE 230B,A00,103648,Taur; Yuan,0,0,0,0
1668119831425,ECE 238B,A00,103649,Garay; Javier,0,0,0,0
1668119831851,ECE 240B,A00,112900,Fainman; Yeshaiahu,0,0,0,0
1668119832274,ECE 247A,A00,103650,Jokerst; Jesse Vincent,0,0,0,0
1668119832705,ECE 247B,A00,103651,Wang; Joseph,0,0,0,0
1668119833130,ECE 250,A00,103652,Siegel; Paul H.,0,0,0,0
1668119833558,ECE 251A,A00,103654,Rao; Bhaskar D.,0,0,0,0
1668119833981,ECE 257B,A00,103655,Bharadia; Dinesh,0,0,0,0
1668119834409,ECE 258A,A00,103656,Milstein; Laurence B.,0,0,0,0
1668119834835,ECE 260B,A00,103658,Kang; Mingu,0,0,0,0
1668119835263,ECE 264A,A00,103659,Galton; Ian A,0,0,0,0
1668119835689,ECE 265A,A00,103661,Gudem; Prasad S.S.,0,0,0,0
1668119836121,ECE 265D,A00,103662,Gudem; Prasad S.S.,0,0,0,0
1668119836551,ECE 268,A00,103663,Koushanfar; Farinaz,0,0,0,0
1668119836977,ECE 269,A01,103665,Pal; Piya,0,0,0,0
1668119837400,ECE 271B,A00,103666,Vasconcelos; Manuela,0,0,0,0
1668119837822,ECE 276A,A00,103667,Atanasov; Nikolay A.,0,0,0,0
1668119838246,ECE 277,A00,103668,An; Cheolhong,0,0,0,0
1668119838682,ECE 279,A00,117947,Hall; Drew A.,0,0,0,0
1668119839539,ECE 283,A00,103670,Hsueh; Tzu-Chien,0,0,0,0
1668119839975,ECE 284,A00,103671,Turakhia; Yatish Girish,0,0,0,0
1668119840405,ECE 285,A00,103672,Zheng; Yang,0,0,0,0
1668119840405,ECE 285,B00,103673,Sworder; David D.,0,0,0,0
1668119840828,ECE 287,A00,103676,Javidi; Tara,0,0,0,0
1668119841263,MATH 200B,A00,098023,Salehi Golsefidy; Alireza,12,0,15,3
1668119841696,MATH 202B,A00,098024,Rhoades; Brendon Patrick,9,0,15,6
1668119842125,MATH 203B,A00,098025,Oprea; Dragos N.,10,0,15,5
1668119842558,MATH 204B,A00,098026,Sorensen; Claus M,13,0,15,2
1668119842980,MATH 208,A00,098027,Izadi; Elham,7,0,10,3
1668119843407,MATH 209,A00,098028,Pollack; Aaron,10,0,10,0
1668119843829,MATH 211A,A00,112919,Rogalski; Daniel,9,0,10,1
1668119844259,MATH 211B,A00,112920,Seward; Brandon M.,9,0,10,1
1668119844692,MATH 218,A00,098029,Li; Bo,10,0,10,0
1668119845117,MATH 220B,A00,098030,Novak; Jonathan I,11,0,15,4
1668119845546,MATH 221A,A00,098031,Ebenfelt; Peter F,13,0,15,2
1668119845971,MATH 231B,A00,098032,Zlatos; Andrej,12,0,15,3
1668119846396,MATH 240B,A00,098033,Ni; Lei,9,0,15,6
1668119846829,MATH 243,A00,098034,Jekel; David Andrew,10,0,10,0
1668119847255,MATH 245A,A00,098035,Nie; Jiawang,0,0,15,16
1668119847683,MATH 248,A00,098036,Bejenaru; Ioan,10,0,10,0
1668119848108,MATH 250B,A00,098037,Spolaor; Luca,14,0,15,1
1668119848551,MATH 258,A00,098038,Ni; Lei,10,0,10,0
1668119848976,MATH 264B,A00,098041,Rhoades; Brendon Patrick,9,0,15,6
1668119849406,MATH 268,A00,098042,Buss; Samuel R,10,0,10,0
1668119849840,MATH 269,A00,098043,Rhoades; Brendon Patrick,10,0,10,0
1668119850273,MATH 270B,A00,098044,Li; Bo,10,0,15,5
1668119850703,MATH 272B,A00,098045,Holst; Michael J,13,0,15,2
1668119851213,MATH 273A,A00,098046,Tian; Xiaochuan,10,0,15,5
1668119851637,MATH 275,A01,098048,Tian; Xiaochuan,6,0,10,4
1668119852082,MATH 278A,A00,098049,Holst; Michael J,8,0,10,2
1668119852520,MATH 278B,A00,098050,Cloninger; Alexander,10,0,10,0
1668119852960,MATH 278C,A00,098051,Nie; Jiawang,7,0,10,3
1668119853395,MATH 280B,A00,098052,Zheng; Tianyi,10,0,15,5
1668119853836,MATH 281B,A00,098053,Bradic; Jelena,2,0,15,13
1668119854263,MATH 282B,A00,098054,Arias-Castro; Ery,0,0,15,15
1668119854688,MATH 285,A00,098055,Fitzsimmons; Patrick J,0,0,15,17
1668119855115,MATH 287B,A00,098056,Arias-Castro; Ery,3,0,15,12
1668119855541,MATH 288,A00,098057,Agarwal; Pooja,9,0,10,1
1668119855541,MATH 288,B00,098058,Zhang; Danna,8,0,10,2
1668119855541,MATH 288,C00,098059,Williams; Ruth J,10,0,10,0
1668119855974,MATH 290B,A00,098060,Roberts; Justin Deritter,13,0,15,2
1668119856402,MATH 292,A00,098061,Belmont; Eva Kinoshita,10,0,10,0
1668119864428,MATH 295,A00,098062,Suk; Andrew Hoon,48,0,50,2
1668119869110,MATH 296,A00,098063,Novak; Jonathan I,20,0,20,0
1668119869554,MATH 297,001,098064,Gamst; Anthony Collins,9997,0,9999,2
1668120374455,COGS 205,A00,101395,Chiba; Andrea,19,0,20,1
1668120374878,COGS 210B,001,101404,Greene; Deanna Jacquelyn,9998,0,9999,1
1668120374878,COGS 210B,002,101417,Xia; Haijun,9999,0,9999,0
1668120374878,COGS 210B,003,101422,Nitz; Douglas A.,9999,0,9999,0
1668120374878,COGS 210B,004,101423,Hollan; James D.,9998,0,9999,1
1668120374878,COGS 210B,005,101424,Deak; Gedeon O.,9998,0,9999,1
1668120374878,COGS 210B,006,101425,Rossano; Federico,9999,0,9999,0
1668120375300,COGS 211B,A00,101427,Coulson; Seana M,9996,0,9999,3
1668120375732,COGS 220,A00,101428,Hollan; James D.,0,0,25,25
1668120376159,COGS 229,A00,101429,Dow; Steven P,18,0,25,7
1668120376596,COGS 230,A00,101430,Klemmer; Scott R,12,0,17,5
1668120377024,COGS 234,A00,101431,Xia; Haijun,3,0,25,22
1668120377446,COGS 260,A00,101432,Kiyonaga; Anastasia,20,0,25,5
1668120377446,COGS 260,B00,101433,Kirsh; David Joel,16,0,25,9
1668120377869,CSE 202,A00,102371,Impagliazzo; Russell,0,0,0,0
1668120378294,CSE 203B,A01,102373,Cheng; Chung Kuan,0,0,0,0
1668120378720,CSE 208,A00,102374,Micciancio; Daniele,0,0,0,0
1668120379142,CSE 209A,A00,112895,Impagliazzo; Russell,0,0,15,15
1668120379566,CSE 209B,A00,108005,Bellare; Mihir,0,0,0,0
1668120379988,CSE 210,A00,113163,Coblenz; Michael J,0,0,0,0
1668120380423,CSE 219,A00,106111,Dow; Steven P,0,0,20,20
1668120380851,CSE 221,A00,102376,Voelker; Geoffrey M.,0,0,0,0
1668120381284,CSE 224,A01,102378,Porter; George M,0,0,0,0
1668120381712,CSE 229A,A00,102379,Savage; Stefan,0,0,0,0
1668120382152,CSE 229C,A00,102380,Munyaka; Imani N. S.,0,0,0,0
1668120382584,CSE 232B,A00,102382,Deutsch; Alin Bernard,0,0,0,0
1668120383020,CSE 234,A01,112904,Kumar; Arun Kumar,0,0,0,0
1668120383444,CSE 237A,A00,102383,Rosing; Tajana Simunic,0,0,0,0
1668120383871,CSE 239A,A00,102384,Deutsch; Alin Bernard,0,0,0,0
1668120384294,CSE 239B,A00,102385,Polikarpova; Nadezhda,0,0,0,0
1668120384717,CSE 240A,A00,102386,Pannuto; Patrick William,0,0,0,0
1668120385158,CSE 240B,A00,102387,Zhao; Jishen,0,0,0,0
1668120385581,CSE 241A,A00,106406,Kang; Mingu,0,0,0,0
1668120386006,CSE 249B,A00,102388,Kahng; Andrew Byun,0,0,8,8
1668120386434,CSE 251B,A01,102392,Cottrell; Garrison W,0,0,0,0
1668120386434,CSE 251B,A02,102393,Cottrell; Garrison W,0,0,0,0
1668120386870,CSE 252B,A00,102394,Ochoa; Benjamin Lawrence,0,0,0,0
1668120387306,CSE 257,A01,102396,Gao; Sicun,0,0,0,0
1668120387743,CSE 272,A00,102397,Li; Tzumao,0,0,0,0
1668120388265,CSE 274,A00,111323,Chern; Albert Ren-Haur,0,0,0,0
1668120388689,CSE 282,A00,102398,Pevzner; Pavel Arkadjevich,0,0,0,0
1668120389115,CSE 284,A00,114175,Gymrek; Melissa Ann,0,0,0,0
1668120389540,CSE 290,A00,102399,Chandraker; Manmohan Krishna,0,0,0,0
1668120389540,CSE 290,B00,102400,Vaccaro; Kristen Marie,0,0,25,25
1668120389540,CSE 290,C00,102414,Pannuto; Patrick William,0,0,25,25
1668120389540,CSE 290,D00,102427,Pevzner; Pavel Arkadjevich,0,0,0,0
1668120389540,CSE 290,E00,102429,Zhao; Jishen,0,0,0,0
1668120389540,CSE 290,F00,102436,Tullsen; Dean Michael,0,0,0,0
1668120389540,CSE 290,G00,102440,Christensen; Henrik I,0,0,20,20
1668120389968,CSE 291,A00,102443,Su; Hao,0,0,0,0
1668120389968,CSE 291,B00,102448,Polikarpova; Nadezhda,0,0,0,0
1668120389968,CSE 291,C00,102453,Vaccaro; Kristen Marie,0,0,0,0
1668120389968,CSE 291,D00,111343,Savage; Stefan,0,0,0,0
1668120389968,CSE 291,E00,116474,Claffy; Kimberly Claire,0,0,0,0
1668120389968,CSE 291,F00,116479,Pasquale; Joseph,0,0,0,0
1668120390462,CSE 293,001,119111,Bafna; Vineet,9999,0,9999,0
1668120390462,CSE 293,002,119118,Bellare; Mihir,9999,0,9999,0
1668120390462,CSE 293,003,119122,Berg-Kirkpatrick; Taylor D,9999,0,9999,0
1668120390462,CSE 293,004,119135,Christensen; Henrik I,9999,0,9999,0
1668120390462,CSE 293,005,119142,Cottrell; Garrison W,9999,0,9999,0
1668120390462,CSE 293,006,119146,Deutsch; Alin Bernard,9999,0,9999,0
1668120390462,CSE 293,007,119159,Esmaeilzadeh; Hadi,9999,0,9999,0
1668120390462,CSE 293,008,119166,Freund; Yoav,9999,0,9999,0
1668120390462,CSE 293,009,119170,Griswold; William G.,9999,0,9999,0
1668120390462,CSE 293,010,119183,Gymrek; Melissa Ann,9999,0,9999,0
1668120390462,CSE 293,011,119190,Heninger; Nadia A,9999,0,9999,0
1668120390462,CSE 293,012,119230,Impagliazzo; Russell,9999,0,9999,0
1668120390462,CSE 293,013,119232,Jhala; Ranjit,9999,0,9999,0
1668120390462,CSE 293,014,119233,Kahng; Andrew Byun,9999,0,9999,0
1668120390462,CSE 293,015,119298,Kane; Daniel Mertz,9999,0,9999,0
1668120390462,CSE 293,016,119299,Kriegman; David J,9999,0,9999,0
1668120390462,CSE 293,017,119300,Kumar; Arun Kumar,9999,0,9999,0
1668120390462,CSE 293,018,119301,Lerner; Sorin,9999,0,9999,0
1668120390462,CSE 293,019,119302,Lovett; Shachar,9999,0,9999,0
1668120390462,CSE 293,020,119303,McAuley; Julian John,9999,0,9999,0
1668120390462,CSE 293,021,119304,Micciancio; Daniele,9999,0,9999,0
1668120390462,CSE 293,022,119367,Orailoglu; Alex,9999,0,9999,0
1668120390462,CSE 293,023,119382,Paturi; Ramamohan,9999,0,9999,0
1668120390462,CSE 293,024,119404,Polikarpova; Nadezhda,9999,0,9999,0
1668120390462,CSE 293,025,119406,Politz; Joseph Gibbs,9999,0,9999,0
1668120390462,CSE 293,026,119411,Porter; George M,9999,0,9999,0
1668120390462,CSE 293,027,119414,Porter; Leonard Emerson,9999,0,9999,0
1668120390462,CSE 293,028,119416,Ramamoorthi; Ravi,9999,0,9999,0
1668120390462,CSE 293,029,119417,Sahoo; Debashis,9999,0,9999,0
1668120390462,CSE 293,030,119420,Saul; Lawrence,9999,0,9999,0
1668120390462,CSE 293,031,119421,Savage; Stefan,9999,0,9999,0
1668120390462,CSE 293,032,119425,Schulze; Jurgen P.,9999,0,9999,0
1668120390462,CSE 293,033,119426,Snoeren; Alex C.,9999,0,9999,0
1668120390462,CSE 293,034,119428,Shang; Jingbo,9999,0,9999,0
1668120390462,CSE 293,035,119430,Stefan; Deian,9999,0,9999,0
1668120390462,CSE 293,036,119431,Su; Hao,9999,0,9999,0
1668120390462,CSE 293,037,119433,Swanson; Steven James,9999,0,9999,0
1668120390462,CSE 293,038,119435,Tullsen; Dean Michael,9999,0,9999,0
1668120390462,CSE 293,039,119483,Voelker; Geoffrey M.,9999,0,9999,0
1668120390462,CSE 293,040,119537,Zhao; Jishen,9999,0,9999,0
1668120390462,CSE 293,041,119538,Zhou; Yuan-Yuan,9999,0,9999,0
1668120390462,CSE 293,042,119539,Gao; Sicun,9999,0,9999,0
1668120390462,CSE 293,043,119540,Weibel; Nadir,9999,0,9999,0
1668120390462,CSE 293,044,119541,Gupta; Rajesh K.,9999,0,9999,0
1668120390462,CSE 293,045,126410,Vaccaro; Kristen Marie,9999,0,9999,0
1668120390462,CSE 293,046,126411,Klemke; Richard,9999,0,9999,0
1668120390887,CSE 294,A00,102459,Voelker; Geoffrey M.,0,0,0,0
1668120390887,CSE 294,B00,111322,Orailoglu; Alex,0,0,0,0
1668120391310,DSE 201,A00,096914,Deutsch; Alin Bernard,30,0,30,0
1668120391735,DSE 210,A00,096915,Dasgupta; Sanjoy,30,0,30,0
1668120392174,DSE 260A,A00,096916,Altintas De Callaf; Ilkay,30,0,30,0
1668120392609,ECE 200,001,103586,Antipa; Nicholas A,9999,0,9999,0
1668120392609,ECE 200,002,103587,Atanasov; Nikolay A.,9999,0,9999,0
1668120392609,ECE 200,003,103588,Bharadia; Dinesh,9999,0,9999,0
1668120392609,ECE 200,004,103589,Cheng; Chung Kuan,9999,0,9999,0
1668120392609,ECE 200,005,103590,Cosman; Pamela C.,9999,0,9999,0
1668120392609,ECE 200,006,103591,Dayeh; Shadi Ahmad,9999,0,9999,0
1668120392609,ECE 200,007,103592,Fainman; Yeshaiahu,9999,0,9999,0
1668120392609,ECE 200,008,103593,Ford; Joseph Earl,9999,0,9999,0
1668120392609,ECE 200,009,103594,Franceschetti; Massimo,9999,0,9999,0
1668120392609,ECE 200,010,103595,Fullerton; Eric E,9999,0,9999,0
1668120392609,ECE 200,011,103596,Galton; Ian A,9999,0,9999,0
1668120392609,ECE 200,012,103597,Gilja; Vikash,9999,0,9999,0
1668120392609,ECE 200,013,103598,Hall; Drew A.,9999,0,9999,0
1668120392609,ECE 200,014,103599,Hsueh; Tzu-Chien,9999,0,9999,0
1668120392609,ECE 200,015,103600,Javidi; Tara,9999,0,9999,0
1668120392609,ECE 200,016,103601,Kahng; Andrew Byun,9999,0,9999,0
1668120392609,ECE 200,017,103602,Kim; Young-Han,9999,0,9999,0
1668120392609,ECE 200,018,103603,Koushanfar; Farinaz,9999,0,9999,0
1668120392609,ECE 200,019,103604,Kuzum; Duygu,9999,0,9999,0
1668120392609,ECE 200,020,103605,Le; Hanh-Phuc,9999,0,9999,0
1668120392609,ECE 200,021,103606,Lin; Bill,9999,0,9999,0
1668120392609,ECE 200,022,103607,Liu; Zhaowei,9998,0,9999,1
1668120392609,ECE 200,023,103608,Lo; Yu-Hwa,9999,0,9999,0
1668120392609,ECE 200,024,103609,Lomakin; Vitaliy,9999,0,9999,0
1668120392609,ECE 200,025,103610,Mercier; Patrick Philip,9999,0,9999,0
1668120392609,ECE 200,026,103611,Meyer; Florian,9999,0,9999,0
1668120392609,ECE 200,027,103612,Milstein; Laurence B.,9999,0,9999,0
1668120392609,ECE 200,028,103613,Mir Arabbaygi; Siavash,9999,0,9999,0
1668120392609,ECE 200,029,103614,Mookherjea; Shayan,9999,0,9999,0
1668120392609,ECE 200,030,103615,Morris; Karcher William,9999,0,9999,0
1668120392609,ECE 200,031,103616,Ng; Tse Nga,9999,0,9999,0
1668120392609,ECE 200,032,103617,Nguyen; Truong Quang,9999,0,9999,0
1668120392609,ECE 200,033,103618,Nomura; Kenji,9999,0,9999,0
1668120392609,ECE 200,034,103619,Orlitsky; Alon,9999,0,9999,0
1668120392609,ECE 200,035,103620,Pal; Piya,9999,0,9999,0
1668120392609,ECE 200,036,103621,Papen; George C.,9999,0,9999,0
1668120392609,ECE 200,037,103622,Radic; Stojan,9999,0,9999,0
1668120392609,ECE 200,038,103623,Rao; Bhaskar D.,9999,0,9999,0
1668120392609,ECE 200,039,103624,Rao; Ramesh R,9999,0,9999,0
1668120392609,ECE 200,040,103625,Rebeiz; Gabriel,9999,0,9999,0
1668120392609,ECE 200,041,103626,Sanford; John R,9999,0,9999,0
1668120392609,ECE 200,042,103627,Siegel; Paul H.,9999,0,9999,0
1668120392609,ECE 200,043,103628,Sievenpiper; Daniel F.,9999,0,9999,0
1668120392609,ECE 200,044,103629,Sworder; David D.,9999,0,9999,0
1668120392609,ECE 200,045,103630,Taur; Yuan,9999,0,9999,0
1668120392609,ECE 200,046,103631,Touri; Behrouz,9999,0,9999,0
1668120392609,ECE 200,047,103632,Trivedi; Mohan M.,9999,0,9999,0
1668120392609,ECE 200,048,103633,Vasconcelos; Nuno,9999,0,9999,0
1668120392609,ECE 200,049,103634,Wang; Xiaolong,9999,0,9999,0
1668120392609,ECE 200,050,103635,Xie; Pengtao,9999,0,9999,0
1668120392609,ECE 200,051,103636,Yip; Michael,9999,0,9999,0
1668120392609,ECE 200,052,103637,Zeger; Kenneth A.,999,0,999,0
1668120392609,ECE 200,053,103638,Zhang; Xinyu,9999,0,9999,0
1668120392609,ECE 200,054,103639,Turakhia; Yatish Girish,9999,0,9999,0
1668120392609,ECE 200,055,103640,Kang; Mingu,9999,0,9999,0
1668120392609,ECE 200,056,103641,Shi; Yuanyuan,9999,0,9999,0
1668120392609,ECE 200,057,103642,Wang; Edward Jay,9999,0,9999,0
1668120392609,ECE 200,058,103643,Zheng; Yang,9999,0,9999,0
1668120393044,ECE 202,A00,103644,Kuzum; Duygu,0,0,0,0
1668120393474,ECE 212BN,A00,103646,Ng; Tse Nga,0,0,0,0
1668120393907,ECE 221,A00,111493,Staff,0,0,0,0
1668120394332,ECE 222B,A00,103647,Lomakin; Vitaliy,0,0,0,0
1668120394762,ECE 230B,A00,103648,Taur; Yuan,0,0,0,0
1668120395187,ECE 238B,A00,103649,Garay; Javier,0,0,0,0
1668120395614,ECE 240B,A00,112900,Fainman; Yeshaiahu,0,0,0,0
1668120396039,ECE 247A,A00,103650,Jokerst; Jesse Vincent,0,0,0,0
1668120396469,ECE 247B,A00,103651,Wang; Joseph,0,0,0,0
1668120396898,ECE 250,A00,103652,Siegel; Paul H.,0,0,0,0
1668120397324,ECE 251A,A00,103654,Rao; Bhaskar D.,0,0,0,0
1668120397750,ECE 257B,A00,103655,Bharadia; Dinesh,0,0,0,0
1668120398182,ECE 258A,A00,103656,Milstein; Laurence B.,0,0,0,0
1668120398606,ECE 260B,A00,103658,Kang; Mingu,0,0,0,0
1668120399043,ECE 264A,A00,103659,Galton; Ian A,0,0,0,0
1668120399473,ECE 265A,A00,103661,Gudem; Prasad S.S.,0,0,0,0
1668120399897,ECE 265D,A00,103662,Gudem; Prasad S.S.,0,0,0,0
1668120400325,ECE 268,A00,103663,Koushanfar; Farinaz,0,0,0,0
1668120400769,ECE 269,A01,103665,Pal; Piya,0,0,0,0
1668120401192,ECE 271B,A00,103666,Vasconcelos; Manuela,0,0,0,0
1668120401621,ECE 276A,A00,103667,Atanasov; Nikolay A.,0,0,0,0
1668120402048,ECE 277,A00,103668,An; Cheolhong,0,0,0,0
1668120402487,ECE 279,A00,117947,Hall; Drew A.,0,0,0,0
1668120403338,ECE 283,A00,103670,Hsueh; Tzu-Chien,0,0,0,0
1668120403762,ECE 284,A00,103671,Turakhia; Yatish Girish,0,0,0,0
1668120404191,ECE 285,A00,103672,Zheng; Yang,0,0,0,0
1668120404191,ECE 285,B00,103673,Sworder; David D.,0,0,0,0
1668120404618,ECE 287,A00,103676,Javidi; Tara,0,0,0,0
1668120405046,MATH 200B,A00,098023,Salehi Golsefidy; Alireza,12,0,15,3
1668120405472,MATH 202B,A00,098024,Rhoades; Brendon Patrick,9,0,15,6
1668120405905,MATH 203B,A00,098025,Oprea; Dragos N.,10,0,15,5
1668120406330,MATH 204B,A00,098026,Sorensen; Claus M,13,0,15,2
1668120406765,MATH 208,A00,098027,Izadi; Elham,7,0,10,3
1668120407191,MATH 209,A00,098028,Pollack; Aaron,10,0,10,0
1668120407621,MATH 211A,A00,112919,Rogalski; Daniel,9,0,10,1
1668120408046,MATH 211B,A00,112920,Seward; Brandon M.,9,0,10,1
1668120408490,MATH 218,A00,098029,Li; Bo,10,0,10,0
1668120408914,MATH 220B,A00,098030,Novak; Jonathan I,11,0,15,4
1668120409341,MATH 221A,A00,098031,Ebenfelt; Peter F,13,0,15,2
1668120409779,MATH 231B,A00,098032,Zlatos; Andrej,12,0,15,3
1668120410205,MATH 240B,A00,098033,Ni; Lei,9,0,15,6
1668120410627,MATH 243,A00,098034,Jekel; David Andrew,10,0,10,0
1668120411053,MATH 245A,A00,098035,Nie; Jiawang,0,0,15,16
1668120411478,MATH 248,A00,098036,Bejenaru; Ioan,10,0,10,0
1668120411910,MATH 250B,A00,098037,Spolaor; Luca,14,0,15,1
1668120412350,MATH 258,A00,098038,Ni; Lei,10,0,10,0
1668120412772,MATH 264B,A00,098041,Rhoades; Brendon Patrick,9,0,15,6
1668120413202,MATH 268,A00,098042,Buss; Samuel R,10,0,10,0
1668120413625,MATH 269,A00,098043,Rhoades; Brendon Patrick,10,0,10,0
1668120414057,MATH 270B,A00,098044,Li; Bo,10,0,15,5
1668120414480,MATH 272B,A00,098045,Holst; Michael J,13,0,15,2
1668120414913,MATH 273A,A00,098046,Tian; Xiaochuan,10,0,15,5
1668120415346,MATH 275,A01,098048,Tian; Xiaochuan,6,0,10,4
1668120415776,MATH 278A,A00,098049,Holst; Michael J,8,0,10,2
1668120416207,MATH 278B,A00,098050,Cloninger; Alexander,10,0,10,0
1668120416636,MATH 278C,A00,098051,Nie; Jiawang,7,0,10,3
1668120417063,MATH 280B,A00,098052,Zheng; Tianyi,10,0,15,5
1668120417485,MATH 281B,A00,098053,Bradic; Jelena,2,0,15,13
1668120417914,MATH 282B,A00,098054,Arias-Castro; Ery,0,0,15,15
1668120418335,MATH 285,A00,098055,Fitzsimmons; Patrick J,0,0,15,17
1668120418768,MATH 287B,A00,098056,Arias-Castro; Ery,3,0,15,12
1668120419198,MATH 288,A00,098057,Agarwal; Pooja,9,0,10,1
1668120419198,MATH 288,B00,098058,Zhang; Danna,8,0,10,2
1668120419198,MATH 288,C00,098059,Williams; Ruth J,10,0,10,0
1668120419626,MATH 290B,A00,098060,Roberts; Justin Deritter,13,0,15,2
1668120420053,MATH 292,A00,098061,Belmont; Eva Kinoshita,10,0,10,0
1668120420487,MATH 295,A00,098062,Suk; Andrew Hoon,48,0,50,2
1668120420924,MATH 296,A00,098063,Novak; Jonathan I,20,0,20,0
1668120421355,MATH 297,001,098064,Gamst; Anthony Collins,9997,0,9999,2
1668120926598,COGS 205,A00,101395,Chiba; Andrea,19,0,20,1
1668120927023,COGS 210B,001,101404,Greene; Deanna Jacquelyn,9998,0,9999,1
1668120927023,COGS 210B,002,101417,Xia; Haijun,9999,0,9999,0
1668120927023,COGS 210B,003,101422,Nitz; Douglas A.,9999,0,9999,0
1668120927023,COGS 210B,004,101423,Hollan; James D.,9998,0,9999,1
1668120927023,COGS 210B,005,101424,Deak; Gedeon O.,9998,0,9999,1
1668120927023,COGS 210B,006,101425,Rossano; Federico,9999,0,9999,0
1668120927466,COGS 211B,A00,101427,Coulson; Seana M,9996,0,9999,3
1668120927895,COGS 220,A00,101428,Hollan; James D.,0,0,25,25
1668120928329,COGS 229,A00,101429,Dow; Steven P,18,0,25,7
1668120928754,COGS 230,A00,101430,Klemmer; Scott R,12,0,17,5
1668120929180,COGS 234,A00,101431,Xia; Haijun,3,0,25,22
1668120929620,COGS 260,A00,101432,Kiyonaga; Anastasia,20,0,25,5
1668120929620,COGS 260,B00,101433,Kirsh; David Joel,16,0,25,9
1668120930052,CSE 202,A00,102371,Impagliazzo; Russell,0,0,0,0
1668120930475,CSE 203B,A01,102373,Cheng; Chung Kuan,0,0,0,0
1668120930901,CSE 208,A00,102374,Micciancio; Daniele,0,0,0,0
1668120931330,CSE 209A,A00,112895,Impagliazzo; Russell,0,0,15,15
1668120931763,CSE 209B,A00,108005,Bellare; Mihir,0,0,0,0
1668120932187,CSE 210,A00,113163,Coblenz; Michael J,0,0,0,0
1668120932618,CSE 219,A00,106111,Dow; Steven P,0,0,20,20
1668120933042,CSE 221,A00,102376,Voelker; Geoffrey M.,0,0,0,0
1668120933468,CSE 224,A01,102378,Porter; George M,0,0,0,0
1668120933899,CSE 229A,A00,102379,Savage; Stefan,0,0,0,0
1668120934332,CSE 229C,A00,102380,Munyaka; Imani N. S.,0,0,0,0
1668120934759,CSE 232B,A00,102382,Deutsch; Alin Bernard,0,0,0,0
1668120935186,CSE 234,A01,112904,Kumar; Arun Kumar,0,0,0,0
1668120935609,CSE 237A,A00,102383,Rosing; Tajana Simunic,0,0,0,0
1668120936043,CSE 239A,A00,102384,Deutsch; Alin Bernard,0,0,0,0
1668120936472,CSE 239B,A00,102385,Polikarpova; Nadezhda,0,0,0,0
1668120936905,CSE 240A,A00,102386,Pannuto; Patrick William,0,0,0,0
1668120937330,CSE 240B,A00,102387,Zhao; Jishen,0,0,0,0
1668120937756,CSE 241A,A00,106406,Kang; Mingu,0,0,0,0
1668120938190,CSE 249B,A00,102388,Kahng; Andrew Byun,0,0,8,8
1668120938620,CSE 251B,A01,102392,Cottrell; Garrison W,0,0,0,0
1668120938620,CSE 251B,A02,102393,Cottrell; Garrison W,0,0,0,0
1668120939054,CSE 252B,A00,102394,Ochoa; Benjamin Lawrence,0,0,0,0
1668120939481,CSE 257,A01,102396,Gao; Sicun,0,0,0,0
1668120939913,CSE 272,A00,102397,Li; Tzumao,0,0,0,0
1668120940357,CSE 274,A00,111323,Chern; Albert Ren-Haur,0,0,0,0
1668120940779,CSE 282,A00,102398,Pevzner; Pavel Arkadjevich,0,0,0,0
1668120941208,CSE 284,A00,114175,Gymrek; Melissa Ann,0,0,0,0
1668120941631,CSE 290,A00,102399,Chandraker; Manmohan Krishna,0,0,0,0
1668120941631,CSE 290,B00,102400,Vaccaro; Kristen Marie,0,0,25,25
1668120941631,CSE 290,C00,102414,Pannuto; Patrick William,0,0,25,25
1668120941631,CSE 290,D00,102427,Pevzner; Pavel Arkadjevich,0,0,0,0
1668120941631,CSE 290,E00,102429,Zhao; Jishen,0,0,0,0
1668120941631,CSE 290,F00,102436,Tullsen; Dean Michael,0,0,0,0
1668120941631,CSE 290,G00,102440,Christensen; Henrik I,0,0,20,20
1668120942057,CSE 291,A00,102443,Su; Hao,0,0,0,0
1668120942057,CSE 291,B00,102448,Polikarpova; Nadezhda,0,0,0,0
1668120942057,CSE 291,C00,102453,Vaccaro; Kristen Marie,0,0,0,0
1668120942057,CSE 291,D00,111343,Savage; Stefan,0,0,0,0
1668120942057,CSE 291,E00,116474,Claffy; Kimberly Claire,0,0,0,0
1668120942057,CSE 291,F00,116479,Pasquale; Joseph,0,0,0,0
1668120942500,CSE 293,001,119111,Bafna; Vineet,9999,0,9999,0
1668120942500,CSE 293,002,119118,Bellare; Mihir,9999,0,9999,0
1668120942500,CSE 293,003,119122,Berg-Kirkpatrick; Taylor D,9999,0,9999,0
1668120942500,CSE 293,004,119135,Christensen; Henrik I,9999,0,9999,0
1668120942500,CSE 293,005,119142,Cottrell; Garrison W,9999,0,9999,0
1668120942500,CSE 293,006,119146,Deutsch; Alin Bernard,9999,0,9999,0
1668120942500,CSE 293,007,119159,Esmaeilzadeh; Hadi,9999,0,9999,0
1668120942500,CSE 293,008,119166,Freund; Yoav,9999,0,9999,0
1668120942500,CSE 293,009,119170,Griswold; William G.,9999,0,9999,0
1668120942500,CSE 293,010,119183,Gymrek; Melissa Ann,9999,0,9999,0
1668120942500,CSE 293,011,119190,Heninger; Nadia A,9999,0,9999,0
1668120942500,CSE 293,012,119230,Impagliazzo; Russell,9999,0,9999,0
1668120942500,CSE 293,013,119232,Jhala; Ranjit,9999,0,9999,0
1668120942500,CSE 293,014,119233,Kahng; Andrew Byun,9999,0,9999,0
1668120942500,CSE 293,015,119298,Kane; Daniel Mertz,9999,0,9999,0
1668120942500,CSE 293,016,119299,Kriegman; David J,9999,0,9999,0
1668120942500,CSE 293,017,119300,Kumar; Arun Kumar,9999,0,9999,0
1668120942500,CSE 293,018,119301,Lerner; Sorin,9999,0,9999,0
1668120942500,CSE 293,019,119302,Lovett; Shachar,9999,0,9999,0
1668120942500,CSE 293,020,119303,McAuley; Julian John,9999,0,9999,0
1668120942500,CSE 293,021,119304,Micciancio; Daniele,9999,0,9999,0
1668120942500,CSE 293,022,119367,Orailoglu; Alex,9999,0,9999,0
1668120942500,CSE 293,023,119382,Paturi; Ramamohan,9999,0,9999,0
1668120942500,CSE 293,024,119404,Polikarpova; Nadezhda,9999,0,9999,0
1668120942500,CSE 293,025,119406,Politz; Joseph Gibbs,9999,0,9999,0
1668120942500,CSE 293,026,119411,Porter; George M,9999,0,9999,0
1668120942500,CSE 293,027,119414,Porter; Leonard Emerson,9999,0,9999,0
1668120942500,CSE 293,028,119416,Ramamoorthi; Ravi,9999,0,9999,0
1668120942500,CSE 293,029,119417,Sahoo; Debashis,9999,0,9999,0
1668120942500,CSE 293,030,119420,Saul; Lawrence,9999,0,9999,0
1668120942500,CSE 293,031,119421,Savage; Stefan,9999,0,9999,0
1668120942500,CSE 293,032,119425,Schulze; Jurgen P.,9999,0,9999,0
1668120942500,CSE 293,033,119426,Snoeren; Alex C.,9999,0,9999,0
1668120942500,CSE 293,034,119428,Shang; Jingbo,9999,0,9999,0
1668120942500,CSE 293,035,119430,Stefan; Deian,9999,0,9999,0
1668120942500,CSE 293,036,119431,Su; Hao,9999,0,9999,0
1668120942500,CSE 293,037,119433,Swanson; Steven James,9999,0,9999,0
1668120942500,CSE 293,038,119435,Tullsen; Dean Michael,9999,0,9999,0
1668120942500,CSE 293,039,119483,Voelker; Geoffrey M.,9999,0,9999,0
1668120942500,CSE 293,040,119537,Zhao; Jishen,9999,0,9999,0
1668120942500,CSE 293,041,119538,Zhou; Yuan-Yuan,9999,0,9999,0
1668120942500,CSE 293,042,119539,Gao; Sicun,9999,0,9999,0
1668120942500,CSE 293,043,119540,Weibel; Nadir,9999,0,9999,0
1668120942500,CSE 293,044,119541,Gupta; Rajesh K.,9999,0,9999,0
1668120942500,CSE 293,045,126410,Vaccaro; Kristen Marie,9999,0,9999,0
1668120942500,CSE 293,046,126411,Klemke; Richard,9999,0,9999,0
1668120942924,CSE 294,A00,102459,Voelker; Geoffrey M.,0,0,0,0
1668120942924,CSE 294,B00,111322,Orailoglu; Alex,0,0,0,0
1668120943351,DSE 201,A00,096914,Deutsch; Alin Bernard,30,0,30,0
1668120943778,DSE 210,A00,096915,Dasgupta; Sanjoy,30,0,30,0
1668120944207,DSE 260A,A00,096916,Altintas De Callaf; Ilkay,30,0,30,0
1668120944688,ECE 200,001,103586,Antipa; Nicholas A,9999,0,9999,0
1668120944688,ECE 200,002,103587,Atanasov; Nikolay A.,9999,0,9999,0
1668120944688,ECE 200,003,103588,Bharadia; Dinesh,9999,0,9999,0
1668120944688,ECE 200,004,103589,Cheng; Chung Kuan,9999,0,9999,0
1668120944688,ECE 200,005,103590,Cosman; Pamela C.,9999,0,9999,0
1668120944688,ECE 200,006,103591,Dayeh; Shadi Ahmad,9999,0,9999,0
1668120944688,ECE 200,007,103592,Fainman; Yeshaiahu,9999,0,9999,0
1668120944688,ECE 200,008,103593,Ford; Joseph Earl,9999,0,9999,0
1668120944688,ECE 200,009,103594,Franceschetti; Massimo,9999,0,9999,0
1668120944688,ECE 200,010,103595,Fullerton; Eric E,9999,0,9999,0
1668120944688,ECE 200,011,103596,Galton; Ian A,9999,0,9999,0
1668120944688,ECE 200,012,103597,Gilja; Vikash,9999,0,9999,0
1668120944688,ECE 200,013,103598,Hall; Drew A.,9999,0,9999,0
1668120944688,ECE 200,014,103599,Hsueh; Tzu-Chien,9999,0,9999,0
1668120944688,ECE 200,015,103600,Javidi; Tara,9999,0,9999,0
1668120944688,ECE 200,016,103601,Kahng; Andrew Byun,9999,0,9999,0
1668120944688,ECE 200,017,103602,Kim; Young-Han,9999,0,9999,0
1668120944688,ECE 200,018,103603,Koushanfar; Farinaz,9999,0,9999,0
1668120944688,ECE 200,019,103604,Kuzum; Duygu,9999,0,9999,0
1668120944688,ECE 200,020,103605,Le; Hanh-Phuc,9999,0,9999,0
1668120944688,ECE 200,021,103606,Lin; Bill,9999,0,9999,0
1668120944688,ECE 200,022,103607,Liu; Zhaowei,9998,0,9999,1
1668120944688,ECE 200,023,103608,Lo; Yu-Hwa,9999,0,9999,0
1668120944688,ECE 200,024,103609,Lomakin; Vitaliy,9999,0,9999,0
1668120944688,ECE 200,025,103610,Mercier; Patrick Philip,9999,0,9999,0
1668120944688,ECE 200,026,103611,Meyer; Florian,9999,0,9999,0
1668120944688,ECE 200,027,103612,Milstein; Laurence B.,9999,0,9999,0
1668120944688,ECE 200,028,103613,Mir Arabbaygi; Siavash,9999,0,9999,0
1668120944688,ECE 200,029,103614,Mookherjea; Shayan,9999,0,9999,0
1668120944688,ECE 200,030,103615,Morris; Karcher William,9999,0,9999,0
1668120944688,ECE 200,031,103616,Ng; Tse Nga,9999,0,9999,0
1668120944688,ECE 200,032,103617,Nguyen; Truong Quang,9999,0,9999,0
1668120944688,ECE 200,033,103618,Nomura; Kenji,9999,0,9999,0
1668120944688,ECE 200,034,103619,Orlitsky; Alon,9999,0,9999,0
1668120944688,ECE 200,035,103620,Pal; Piya,9999,0,9999,0
1668120944688,ECE 200,036,103621,Papen; George C.,9999,0,9999,0
1668120944688,ECE 200,037,103622,Radic; Stojan,9999,0,9999,0
1668120944688,ECE 200,038,103623,Rao; Bhaskar D.,9999,0,9999,0
1668120944688,ECE 200,039,103624,Rao; Ramesh R,9999,0,9999,0
1668120944688,ECE 200,040,103625,Rebeiz; Gabriel,9999,0,9999,0
1668120944688,ECE 200,041,103626,Sanford; John R,9999,0,9999,0
1668120944688,ECE 200,042,103627,Siegel; Paul H.,9999,0,9999,0
1668120944688,ECE 200,043,103628,Sievenpiper; Daniel F.,9999,0,9999,0
1668120944688,ECE 200,044,103629,Sworder; David D.,9999,0,9999,0
1668120944688,ECE 200,045,103630,Taur; Yuan,9999,0,9999,0
1668120944688,ECE 200,046,103631,Touri; Behrouz,9999,0,9999,0
1668120944688,ECE 200,047,103632,Trivedi; Mohan M.,9999,0,9999,0
1668120944688,ECE 200,048,103633,Vasconcelos; Nuno,9999,0,9999,0
1668120944688,ECE 200,049,103634,Wang; Xiaolong,9999,0,9999,0
1668120944688,ECE 200,050,103635,Xie; Pengtao,9999,0,9999,0
1668120944688,ECE 200,051,103636,Yip; Michael,9999,0,9999,0
1668120944688,ECE 200,052,103637,Zeger; Kenneth A.,999,0,999,0
1668120944688,ECE 200,053,103638,Zhang; Xinyu,9999,0,9999,0
1668120944688,ECE 200,054,103639,Turakhia; Yatish Girish,9999,0,9999,0
1668120944688,ECE 200,055,103640,Kang; Mingu,9999,0,9999,0
1668120944688,ECE 200,056,103641,Shi; Yuanyuan,9999,0,9999,0
1668120944688,ECE 200,057,103642,Wang; Edward Jay,9999,0,9999,0
1668120944688,ECE 200,058,103643,Zheng; Yang,9999,0,9999,0
1668120945113,ECE 202,A00,103644,Kuzum; Duygu,0,0,0,0
1668120945544,ECE 212BN,A00,103646,Ng; Tse Nga,0,0,0,0
1668120945971,ECE 221,A00,111493,Staff,0,0,0,0
1668120946394,ECE 222B,A00,103647,Lomakin; Vitaliy,0,0,0,0
1668120946820,ECE 230B,A00,103648,Taur; Yuan,0,0,0,0
1668120947254,ECE 238B,A00,103649,Garay; Javier,0,0,0,0
1668120947677,ECE 240B,A00,112900,Fainman; Yeshaiahu,0,0,0,0
1668120948113,ECE 247A,A00,103650,Jokerst; Jesse Vincent,0,0,0,0
1668120948543,ECE 247B,A00,103651,Wang; Joseph,0,0,0,0
1668120948965,ECE 250,A00,103652,Siegel; Paul H.,0,0,0,0
1668120949404,ECE 251A,A00,103654,Rao; Bhaskar D.,0,0,0,0
1668120949836,ECE 257B,A00,103655,Bharadia; Dinesh,0,0,0,0
1668120950269,ECE 258A,A00,103656,Milstein; Laurence B.,0,0,0,0
1668120950690,ECE 260B,A00,103658,Kang; Mingu,0,0,0,0
1668120951125,ECE 264A,A00,103659,Galton; Ian A,0,0,0,0
1668120951558,ECE 265A,A00,103661,Gudem; Prasad S.S.,0,0,0,0
1668120951985,ECE 265D,A00,103662,Gudem; Prasad S.S.,0,0,0,0
1668120952410,ECE 268,A00,103663,Koushanfar; Farinaz,0,0,0,0
1668120952846,ECE 269,A01,103665,Pal; Piya,0,0,0,0
1668120953271,ECE 271B,A00,103666,Vasconcelos; Manuela,0,0,0,0
1668120953698,ECE 276A,A00,103667,Atanasov; Nikolay A.,0,0,0,0
1668120954132,ECE 277,A00,103668,An; Cheolhong,0,0,0,0
1668120954569,ECE 279,A00,117947,Hall; Drew A.,0,0,0,0
1668120955417,ECE 283,A00,103670,Hsueh; Tzu-Chien,0,0,0,0
1668120955846,ECE 284,A00,103671,Turakhia; Yatish Girish,0,0,0,0
1668120956271,ECE 285,A00,103672,Zheng; Yang,0,0,0,0
1668120956271,ECE 285,B00,103673,Sworder; David D.,0,0,0,0
1668120956704,ECE 287,A00,103676,Javidi; Tara,0,0,0,0
1668120957218,MATH 200B,A00,098023,Salehi Golsefidy; Alireza,12,0,15,3
1668120957662,MATH 202B,A00,098024,Rhoades; Brendon Patrick,9,0,15,6
1668120958086,MATH 203B,A00,098025,Oprea; Dragos N.,10,0,15,5
1668120958513,MATH 204B,A00,098026,Sorensen; Claus M,13,0,15,2
1668120958937,MATH 208,A00,098027,Izadi; Elham,7,0,10,3
1668120959358,MATH 209,A00,098028,Pollack; Aaron,10,0,10,0
1668120959782,MATH 211A,A00,112919,Rogalski; Daniel,9,0,10,1
1668120960208,MATH 211B,A00,112920,Seward; Brandon M.,9,0,10,1
1668120960631,MATH 218,A00,098029,Li; Bo,10,0,10,0
1668120961059,MATH 220B,A00,098030,Novak; Jonathan I,11,0,15,4
1668120961487,MATH 221A,A00,098031,Ebenfelt; Peter F,13,0,15,2
1668120961924,MATH 231B,A00,098032,Zlatos; Andrej,12,0,15,3
1668120962362,MATH 240B,A00,098033,Ni; Lei,9,0,15,6
1668120962802,MATH 243,A00,098034,Jekel; David Andrew,10,0,10,0
1668120963228,MATH 245A,A00,098035,Nie; Jiawang,0,0,15,16
1668120963651,MATH 248,A00,098036,Bejenaru; Ioan,10,0,10,0
1668120964075,MATH 250B,A00,098037,Spolaor; Luca,14,0,15,1
1668120964507,MATH 258,A00,098038,Ni; Lei,10,0,10,0
1668120964933,MATH 264B,A00,098041,Rhoades; Brendon Patrick,9,0,15,6
1668120965364,MATH 268,A00,098042,Buss; Samuel R,10,0,10,0
1668120965788,MATH 269,A00,098043,Rhoades; Brendon Patrick,10,0,10,0
1668120966220,MATH 270B,A00,098044,Li; Bo,10,0,15,5
1668120966645,MATH 272B,A00,098045,Holst; Michael J,13,0,15,2
1668120967080,MATH 273A,A00,098046,Tian; Xiaochuan,10,0,15,5
1668120967503,MATH 275,A01,098048,Tian; Xiaochuan,6,0,10,4
1668120967931,MATH 278A,A00,098049,Holst; Michael J,8,0,10,2
1668120968355,MATH 278B,A00,098050,Cloninger; Alexander,10,0,10,0
1668120968784,MATH 278C,A00,098051,Nie; Jiawang,7,0,10,3
1668120969210,MATH 280B,A00,098052,Zheng; Tianyi,10,0,15,5
1668120969635,MATH 281B,A00,098053,Bradic; Jelena,2,0,15,13
1668120970061,MATH 282B,A00,098054,Arias-Castro; Ery,0,0,15,15
1668120970486,MATH 285,A00,098055,Fitzsimmons; Patrick J,0,0,15,17
1668120970926,MATH 287B,A00,098056,Arias-Castro; Ery,3,0,15,12
1668120971350,MATH 288,A00,098057,Agarwal; Pooja,9,0,10,1
1668120971350,MATH 288,B00,098058,Zhang; Danna,8,0,10,2
1668120971350,MATH 288,C00,098059,Williams; Ruth J,10,0,10,0
1668120971775,MATH 290B,A00,098060,Roberts; Justin Deritter,13,0,15,2
1668120972203,MATH 292,A00,098061,Belmont; Eva Kinoshita,10,0,10,0
1668120972634,MATH 295,A00,098062,Suk; Andrew Hoon,48,0,50,2
1668120973058,MATH 296,A00,098063,Novak; Jonathan I,20,0,20,0
1668120973494,MATH 297,001,098064,Gamst; Anthony Collins,9997,0,9999,2
1668121479689,COGS 205,A00,101395,Chiba; Andrea,19,0,20,1
1668121480114,COGS 210B,001,101404,Greene; Deanna Jacquelyn,9998,0,9999,1
1668121480114,COGS 210B,002,101417,Xia; Haijun,9999,0,9999,0
1668121480114,COGS 210B,003,101422,Nitz; Douglas A.,9999,0,9999,0
1668121480114,COGS 210B,004,101423,Hollan; James D.,9998,0,9999,1
1668121480114,COGS 210B,005,101424,Deak; Gedeon O.,9998,0,9999,1
1668121480114,COGS 210B,006,101425,Rossano; Federico,9999,0,9999,0
1668121480547,COGS 211B,A00,101427,Coulson; Seana M,9996,0,9999,3
1668121480991,COGS 220,A00,101428,Hollan; James D.,0,0,25,25
1668121481419,COGS 229,A00,101429,Dow; Steven P,18,0,25,7
1668121481848,COGS 230,A00,101430,Klemmer; Scott R,12,0,17,5
1668121482270,COGS 234,A00,101431,Xia; Haijun,3,0,25,22
1668121482702,COGS 260,A00,101432,Kiyonaga; Anastasia,20,0,25,5
1668121482702,COGS 260,B00,101433,Kirsh; David Joel,16,0,25,9
1668121483124,CSE 202,A00,102371,Impagliazzo; Russell,0,0,0,0
1668121483640,CSE 203B,A01,102373,Cheng; Chung Kuan,0,0,0,0
1668121484079,CSE 208,A00,102374,Micciancio; Daniele,0,0,0,0
1668121484505,CSE 209A,A00,112895,Impagliazzo; Russell,0,0,15,15
1668121484933,CSE 209B,A00,108005,Bellare; Mihir,0,0,0,0
1668121485369,CSE 210,A00,113163,Coblenz; Michael J,0,0,0,0
1668121485800,CSE 219,A00,106111,Dow; Steven P,0,0,20,20
1668121486229,CSE 221,A00,102376,Voelker; Geoffrey M.,0,0,0,0
1668121486652,CSE 224,A01,102378,Porter; George M,0,0,0,0
1668121487074,CSE 229A,A00,102379,Savage; Stefan,0,0,0,0
1668121487501,CSE 229C,A00,102380,Munyaka; Imani N. S.,0,0,0,0
1668121487924,CSE 232B,A00,102382,Deutsch; Alin Bernard,0,0,0,0
1668121488368,CSE 234,A01,112904,Kumar; Arun Kumar,0,0,0,0
1668121488789,CSE 237A,A00,102383,Rosing; Tajana Simunic,0,0,0,0
1668121489224,CSE 239A,A00,102384,Deutsch; Alin Bernard,0,0,0,0
1668121489658,CSE 239B,A00,102385,Polikarpova; Nadezhda,0,0,0,0
1668121490086,CSE 240A,A00,102386,Pannuto; Patrick William,0,0,0,0
1668121490509,CSE 240B,A00,102387,Zhao; Jishen,0,0,0,0
1668121490932,CSE 241A,A00,106406,Kang; Mingu,0,0,0,0
1668121491367,CSE 249B,A00,102388,Kahng; Andrew Byun,0,0,8,8
1668121491795,CSE 251B,A01,102392,Cottrell; Garrison W,0,0,0,0
1668121491795,CSE 251B,A02,102393,Cottrell; Garrison W,0,0,0,0
1668121492221,CSE 252B,A00,102394,Ochoa; Benjamin Lawrence,0,0,0,0
1668121492650,CSE 257,A01,102396,Gao; Sicun,0,0,0,0
1668121493074,CSE 272,A00,102397,Li; Tzumao,0,0,0,0
1668121493510,CSE 274,A00,111323,Chern; Albert Ren-Haur,0,0,0,0
1668121493933,CSE 282,A00,102398,Pevzner; Pavel Arkadjevich,0,0,0,0
1668121494357,CSE 284,A00,114175,Gymrek; Melissa Ann,0,0,0,0
1668121494786,CSE 290,A00,102399,Chandraker; Manmohan Krishna,0,0,0,0
1668121494786,CSE 290,B00,102400,Vaccaro; Kristen Marie,0,0,25,25
1668121494786,CSE 290,C00,102414,Pannuto; Patrick William,0,0,25,25
1668121494786,CSE 290,D00,102427,Pevzner; Pavel Arkadjevich,0,0,0,0
1668121494786,CSE 290,E00,102429,Zhao; Jishen,0,0,0,0
1668121494786,CSE 290,F00,102436,Tullsen; Dean Michael,0,0,0,0
1668121494786,CSE 290,G00,102440,Christensen; Henrik I,0,0,20,20
1668121495215,CSE 291,A00,102443,Su; Hao,0,0,0,0
1668121495215,CSE 291,B00,102448,Polikarpova; Nadezhda,0,0,0,0
1668121495215,CSE 291,C00,102453,Vaccaro; Kristen Marie,0,0,0,0
1668121495215,CSE 291,D00,111343,Savage; Stefan,0,0,0,0
1668121495215,CSE 291,E00,116474,Claffy; Kimberly Claire,0,0,0,0
1668121495215,CSE 291,F00,116479,Pasquale; Joseph,0,0,0,0
1668121495649,CSE 293,001,119111,Bafna; Vineet,9999,0,9999,0
1668121495649,CSE 293,002,119118,Bellare; Mihir,9999,0,9999,0
1668121495649,CSE 293,003,119122,Berg-Kirkpatrick; Taylor D,9999,0,9999,0
1668121495649,CSE 293,004,119135,Christensen; Henrik I,9999,0,9999,0
1668121495649,CSE 293,005,119142,Cottrell; Garrison W,9999,0,9999,0
1668121495649,CSE 293,006,119146,Deutsch; Alin Bernard,9999,0,9999,0
1668121495649,CSE 293,007,119159,Esmaeilzadeh; Hadi,9999,0,9999,0
1668121495649,CSE 293,008,119166,Freund; Yoav,9999,0,9999,0
1668121495649,CSE 293,009,119170,Griswold; William G.,9999,0,9999,0
1668121495649,CSE 293,010,119183,Gymrek; Melissa Ann,9999,0,9999,0
1668121495649,CSE 293,011,119190,Heninger; Nadia A,9999,0,9999,0
1668121495649,CSE 293,012,119230,Impagliazzo; Russell,9999,0,9999,0
1668121495649,CSE 293,013,119232,Jhala; Ranjit,9999,0,9999,0
1668121495649,CSE 293,014,119233,Kahng; Andrew Byun,9999,0,9999,0
1668121495649,CSE 293,015,119298,Kane; Daniel Mertz,9999,0,9999,0
1668121495649,CSE 293,016,119299,Kriegman; David J,9999,0,9999,0
1668121495649,CSE 293,017,119300,Kumar; Arun Kumar,9999,0,9999,0
1668121495649,CSE 293,018,119301,Lerner; Sorin,9999,0,9999,0
1668121495649,CSE 293,019,119302,Lovett; Shachar,9999,0,9999,0
1668121495649,CSE 293,020,119303,McAuley; Julian John,9999,0,9999,0
1668121495649,CSE 293,021,119304,Micciancio; Daniele,9999,0,9999,0
1668121495649,CSE 293,022,119367,Orailoglu; Alex,9999,0,9999,0
1668121495649,CSE 293,023,119382,Paturi; Ramamohan,9999,0,9999,0
1668121495649,CSE 293,024,119404,Polikarpova; Nadezhda,9999,0,9999,0
1668121495649,CSE 293,025,119406,Politz; Joseph Gibbs,9999,0,9999,0
1668121495649,CSE 293,026,119411,Porter; George M,9999,0,9999,0
1668121495649,CSE 293,027,119414,Porter; Leonard Emerson,9999,0,9999,0
1668121495649,CSE 293,028,119416,Ramamoorthi; Ravi,9999,0,9999,0
1668121495649,CSE 293,029,119417,Sahoo; Debashis,9999,0,9999,0
1668121495649,CSE 293,030,119420,Saul; Lawrence,9999,0,9999,0
1668121495649,CSE 293,031,119421,Savage; Stefan,9999,0,9999,0
1668121495649,CSE 293,032,119425,Schulze; Jurgen P.,9999,0,9999,0
1668121495649,CSE 293,033,119426,Snoeren; Alex C.,9999,0,9999,0
1668121495649,CSE 293,034,119428,Shang; Jingbo,9999,0,9999,0
1668121495649,CSE 293,035,119430,Stefan; Deian,9999,0,9999,0
1668121495649,CSE 293,036,119431,Su; Hao,9999,0,9999,0
1668121495649,CSE 293,037,119433,Swanson; Steven James,9999,0,9999,0
1668121495649,CSE 293,038,119435,Tullsen; Dean Michael,9999,0,9999,0
1668121495649,CSE 293,039,119483,Voelker; Geoffrey M.,9999,0,9999,0
1668121495649,CSE 293,040,119537,Zhao; Jishen,9999,0,9999,0
1668121495649,CSE 293,041,119538,Zhou; Yuan-Yuan,9999,0,9999,0
1668121495649,CSE 293,042,119539,Gao; Sicun,9999,0,9999,0
1668121495649,CSE 293,043,119540,Weibel; Nadir,9999,0,9999,0
1668121495649,CSE 293,044,119541,Gupta; Rajesh K.,9999,0,9999,0
1668121495649,CSE 293,045,126410,Vaccaro; Kristen Marie,9999,0,9999,0
1668121495649,CSE 293,046,126411,Klemke; Richard,9999,0,9999,0
1668121496084,CSE 294,A00,102459,Voelker; Geoffrey M.,0,0,0,0
1668121496084,CSE 294,B00,111322,Orailoglu; Alex,0,0,0,0
1668121496528,DSE 201,A00,096914,Deutsch; Alin Bernard,30,0,30,0
1668121496956,DSE 210,A00,096915,Dasgupta; Sanjoy,30,0,30,0
1668121497384,DSE 260A,A00,096916,Altintas De Callaf; Ilkay,30,0,30,0
1668121497814,ECE 200,001,103586,Antipa; Nicholas A,9999,0,9999,0
1668121497814,ECE 200,002,103587,Atanasov; Nikolay A.,9999,0,9999,0
1668121497814,ECE 200,003,103588,Bharadia; Dinesh,9999,0,9999,0
1668121497814,ECE 200,004,103589,Cheng; Chung Kuan,9999,0,9999,0
1668121497814,ECE 200,005,103590,Cosman; Pamela C.,9999,0,9999,0
1668121497814,ECE 200,006,103591,Dayeh; Shadi Ahmad,9999,0,9999,0
1668121497814,ECE 200,007,103592,Fainman; Yeshaiahu,9999,0,9999,0
1668121497814,ECE 200,008,103593,Ford; Joseph Earl,9999,0,9999,0
1668121497814,ECE 200,009,103594,Franceschetti; Massimo,9999,0,9999,0
1668121497814,ECE 200,010,103595,Fullerton; Eric E,9999,0,9999,0
1668121497814,ECE 200,011,103596,Galton; Ian A,9999,0,9999,0
1668121497814,ECE 200,012,103597,Gilja; Vikash,9999,0,9999,0
1668121497814,ECE 200,013,103598,Hall; Drew A.,9999,0,9999,0
1668121497814,ECE 200,014,103599,Hsueh; Tzu-Chien,9999,0,9999,0
1668121497814,ECE 200,015,103600,Javidi; Tara,9999,0,9999,0
1668121497814,ECE 200,016,103601,Kahng; Andrew Byun,9999,0,9999,0
1668121497814,ECE 200,017,103602,Kim; Young-Han,9999,0,9999,0
1668121497814,ECE 200,018,103603,Koushanfar; Farinaz,9999,0,9999,0
1668121497814,ECE 200,019,103604,Kuzum; Duygu,9999,0,9999,0
1668121497814,ECE 200,020,103605,Le; Hanh-Phuc,9999,0,9999,0
1668121497814,ECE 200,021,103606,Lin; Bill,9999,0,9999,0
1668121497814,ECE 200,022,103607,Liu; Zhaowei,9998,0,9999,1
1668121497814,ECE 200,023,103608,Lo; Yu-Hwa,9999,0,9999,0
1668121497814,ECE 200,024,103609,Lomakin; Vitaliy,9999,0,9999,0
1668121497814,ECE 200,025,103610,Mercier; Patrick Philip,9999,0,9999,0
1668121497814,ECE 200,026,103611,Meyer; Florian,9999,0,9999,0
1668121497814,ECE 200,027,103612,Milstein; Laurence B.,9999,0,9999,0
1668121497814,ECE 200,028,103613,Mir Arabbaygi; Siavash,9999,0,9999,0
1668121497814,ECE 200,029,103614,Mookherjea; Shayan,9999,0,9999,0
1668121497814,ECE 200,030,103615,Morris; Karcher William,9999,0,9999,0
1668121497814,ECE 200,031,103616,Ng; Tse Nga,9999,0,9999,0
1668121497814,ECE 200,032,103617,Nguyen; Truong Quang,9999,0,9999,0
1668121497814,ECE 200,033,103618,Nomura; Kenji,9999,0,9999,0
1668121497814,ECE 200,034,103619,Orlitsky; Alon,9999,0,9999,0
1668121497814,ECE 200,035,103620,Pal; Piya,9999,0,9999,0
1668121497814,ECE 200,036,103621,Papen; George C.,9999,0,9999,0
1668121497814,ECE 200,037,103622,Radic; Stojan,9999,0,9999,0
1668121497814,ECE 200,038,103623,Rao; Bhaskar D.,9999,0,9999,0
1668121497814,ECE 200,039,103624,Rao; Ramesh R,9999,0,9999,0
1668121497814,ECE 200,040,103625,Rebeiz; Gabriel,9999,0,9999,0
1668121497814,ECE 200,041,103626,Sanford; John R,9999,0,9999,0
1668121497814,ECE 200,042,103627,Siegel; Paul H.,9999,0,9999,0
1668121497814,ECE 200,043,103628,Sievenpiper; Daniel F.,9999,0,9999,0
1668121497814,ECE 200,044,103629,Sworder; David D.,9999,0,9999,0
1668121497814,ECE 200,045,103630,Taur; Yuan,9999,0,9999,0
1668121497814,ECE 200,046,103631,Touri; Behrouz,9999,0,9999,0
1668121497814,ECE 200,047,103632,Trivedi; Mohan M.,9999,0,9999,0
1668121497814,ECE 200,048,103633,Vasconcelos; Nuno,9999,0,9999,0
1668121497814,ECE 200,049,103634,Wang; Xiaolong,9999,0,9999,0
1668121497814,ECE 200,050,103635,Xie; Pengtao,9999,0,9999,0
1668121497814,ECE 200,051,103636,Yip; Michael,9999,0,9999,0
1668121497814,ECE 200,052,103637,Zeger; Kenneth A.,999,0,999,0
1668121497814,ECE 200,053,103638,Zhang; Xinyu,9999,0,9999,0
1668121497814,ECE 200,054,103639,Turakhia; Yatish Girish,9999,0,9999,0
1668121497814,ECE 200,055,103640,Kang; Mingu,9999,0,9999,0
1668121497814,ECE 200,056,103641,Shi; Yuanyuan,9999,0,9999,0
1668121497814,ECE 200,057,103642,Wang; Edward Jay,9999,0,9999,0
1668121497814,ECE 200,058,103643,Zheng; Yang,9999,0,9999,0
1668121498242,ECE 202,A00,103644,Kuzum; Duygu,0,0,0,0
1668121498665,ECE 212BN,A00,103646,Ng; Tse Nga,0,0,0,0
1668121499091,ECE 221,A00,111493,Staff,0,0,0,0
1668121499514,ECE 222B,A00,103647,Lomakin; Vitaliy,0,0,0,0
1668121499937,ECE 230B,A00,103648,Taur; Yuan,0,0,0,0
1668121500366,ECE 238B,A00,103649,Garay; Javier,0,0,0,0
1668121500788,ECE 240B,A00,112900,Fainman; Yeshaiahu,0,0,0,0
1668121501211,ECE 247A,A00,103650,Jokerst; Jesse Vincent,0,0,0,0
1668121501636,ECE 247B,A00,103651,Wang; Joseph,0,0,0,0
1668121502062,ECE 250,A00,103652,Siegel; Paul H.,0,0,0,0
1668121502494,ECE 251A,A00,103654,Rao; Bhaskar D.,0,0,0,0
1668121502916,ECE 257B,A00,103655,Bharadia; Dinesh,0,0,0,0
1668121503342,ECE 258A,A00,103656,Milstein; Laurence B.,0,0,0,0
1668121503764,ECE 260B,A00,103658,Kang; Mingu,0,0,0,0
1668121504191,ECE 264A,A00,103659,Galton; Ian A,0,0,0,0
1668121504620,ECE 265A,A00,103661,Gudem; Prasad S.S.,0,0,0,0
1668121505041,ECE 265D,A00,103662,Gudem; Prasad S.S.,0,0,0,0
1668121505482,ECE 268,A00,103663,Koushanfar; Farinaz,0,0,0,0
1668121505903,ECE 269,A01,103665,Pal; Piya,0,0,0,0
1668121506329,ECE 271B,A00,103666,Vasconcelos; Manuela,0,0,0,0
1668121506753,ECE 276A,A00,103667,Atanasov; Nikolay A.,0,0,0,0
1668121507176,ECE 277,A00,103668,An; Cheolhong,0,0,0,0
1668121507603,ECE 279,A00,117947,Hall; Drew A.,0,0,0,0
1668121508465,ECE 283,A00,103670,Hsueh; Tzu-Chien,0,0,0,0
1668121508892,ECE 284,A00,103671,Turakhia; Yatish Girish,0,0,0,0
1668121509314,ECE 285,A00,103672,Zheng; Yang,0,0,0,0
1668121509314,ECE 285,B00,103673,Sworder; David D.,0,0,0,0
1668121509745,ECE 287,A00,103676,Javidi; Tara,0,0,0,0
1668121510185,MATH 200B,A00,098023,Salehi Golsefidy; Alireza,12,0,15,3
1668121510608,MATH 202B,A00,098024,Rhoades; Brendon Patrick,9,0,15,6
1668121511031,MATH 203B,A00,098025,Oprea; Dragos N.,10,0,15,5
1668121511454,MATH 204B,A00,098026,Sorensen; Claus M,13,0,15,2
1668121511878,MATH 208,A00,098027,Izadi; Elham,7,0,10,3
1668121512304,MATH 209,A00,098028,Pollack; Aaron,10,0,10,0
1668121512726,MATH 211A,A00,112919,Rogalski; Daniel,9,0,10,1
1668121513156,MATH 211B,A00,112920,Seward; Brandon M.,9,0,10,1
1668121513587,MATH 218,A00,098029,Li; Bo,10,0,10,0
1668121514014,MATH 220B,A00,098030,Novak; Jonathan I,11,0,15,4
1668121514439,MATH 221A,A00,098031,Ebenfelt; Peter F,13,0,15,2
1668121514864,MATH 231B,A00,098032,Zlatos; Andrej,12,0,15,3
1668121515290,MATH 240B,A00,098033,Ni; Lei,9,0,15,6
1668121515714,MATH 243,A00,098034,Jekel; David Andrew,10,0,10,0
1668121516145,MATH 245A,A00,098035,Nie; Jiawang,0,0,15,16
1668121516578,MATH 248,A00,098036,Bejenaru; Ioan,10,0,10,0
1668121517004,MATH 250B,A00,098037,Spolaor; Luca,14,0,15,1
1668121517427,MATH 258,A00,098038,Ni; Lei,10,0,10,0
1668121517850,MATH 264B,A00,098041,Rhoades; Brendon Patrick,9,0,15,6
1668121518278,MATH 268,A00,098042,Buss; Samuel R,10,0,10,0
1668121518699,MATH 269,A00,098043,Rhoades; Brendon Patrick,10,0,10,0
1668121519134,MATH 270B,A00,098044,Li; Bo,10,0,15,5
1668121519570,MATH 272B,A00,098045,Holst; Michael J,13,0,15,2
1668121519995,MATH 273A,A00,098046,Tian; Xiaochuan,10,0,15,5
1668121520428,MATH 275,A01,098048,Tian; Xiaochuan,6,0,10,4
1668121520850,MATH 278A,A00,098049,Holst; Michael J,8,0,10,2
1668121521276,MATH 278B,A00,098050,Cloninger; Alexander,10,0,10,0
1668121521701,MATH 278C,A00,098051,Nie; Jiawang,7,0,10,3
1668121522137,MATH 280B,A00,098052,Zheng; Tianyi,10,0,15,5
1668121522568,MATH 281B,A00,098053,Bradic; Jelena,2,0,15,13
1668121522996,MATH 282B,A00,098054,Arias-Castro; Ery,0,0,15,15
1668121523419,MATH 285,A00,098055,Fitzsimmons; Patrick J,0,0,15,17
1668121523849,MATH 287B,A00,098056,Arias-Castro; Ery,3,0,15,12
1668121524289,MATH 288,A00,098057,Agarwal; Pooja,9,0,10,1
1668121524289,MATH 288,B00,098058,Zhang; Danna,8,0,10,2
1668121524289,MATH 288,C00,098059,Williams; Ruth J,10,0,10,0
1668121524711,MATH 290B,A00,098060,Roberts; Justin Deritter,13,0,15,2
1668121525139,MATH 292,A00,098061,Belmont; Eva Kinoshita,10,0,10,0
1668121525562,MATH 295,A00,098062,Suk; Andrew Hoon,48,0,50,2
1668121525992,MATH 296,A00,098063,Novak; Jonathan I,20,0,20,0
1668121526421,MATH 297,001,098064,Gamst; Anthony Collins,9997,0,9999,2
1668122043301,COGS 205,A00,101395,Chiba; Andrea,19,0,20,1
1668122043744,COGS 210B,001,101404,Greene; Deanna Jacquelyn,9998,0,9999,1
1668122043744,COGS 210B,002,101417,Xia; Haijun,9999,0,9999,0
1668122043744,COGS 210B,003,101422,Nitz; Douglas A.,9999,0,9999,0
1668122043744,COGS 210B,004,101423,Hollan; James D.,9998,0,9999,1
1668122043744,COGS 210B,005,101424,Deak; Gedeon O.,9998,0,9999,1
1668122043744,COGS 210B,006,101425,Rossano; Federico,9999,0,9999,0
1668122044168,COGS 211B,A00,101427,Coulson; Seana M,9996,0,9999,3
1668122044598,COGS 220,A00,101428,Hollan; James D.,0,0,25,25
1668122045036,COGS 229,A00,101429,Dow; Steven P,18,0,25,7
1668122045471,COGS 230,A00,101430,Klemmer; Scott R,12,0,17,5
1668122045903,COGS 234,A00,101431,Xia; Haijun,3,0,25,22
1668122046334,COGS 260,A00,101432,Kiyonaga; Anastasia,20,0,25,5
1668122046334,COGS 260,B00,101433,Kirsh; David Joel,16,0,25,9
1668122046816,CSE 202,A00,102371,Impagliazzo; Russell,0,0,0,0
1668122047254,CSE 203B,A01,102373,Cheng; Chung Kuan,0,0,0,0
1668122047678,CSE 208,A00,102374,Micciancio; Daniele,0,0,0,0
1668122048102,CSE 209A,A00,112895,Impagliazzo; Russell,0,0,15,15
1668122048526,CSE 209B,A00,108005,Bellare; Mihir,0,0,0,0
1668122048962,CSE 210,A00,113163,Coblenz; Michael J,0,0,0,0
1668122049402,CSE 219,A00,106111,Dow; Steven P,0,0,20,20
1668122049839,CSE 221,A00,102376,Voelker; Geoffrey M.,0,0,0,0
1668122050278,CSE 224,A01,102378,Porter; George M,0,0,0,0
1668122050710,CSE 229A,A00,102379,Savage; Stefan,0,0,0,0
1668122051165,CSE 229C,A00,102380,Munyaka; Imani N. S.,0,0,0,0
1668122051588,CSE 232B,A00,102382,Deutsch; Alin Bernard,0,0,0,0
1668122052017,CSE 234,A01,112904,Kumar; Arun Kumar,0,0,0,0
1668122052439,CSE 237A,A00,102383,Rosing; Tajana Simunic,0,0,0,0
1668122052870,CSE 239A,A00,102384,Deutsch; Alin Bernard,0,0,0,0
1668122053298,CSE 239B,A00,102385,Polikarpova; Nadezhda,0,0,0,0
1668122053727,CSE 240A,A00,102386,Pannuto; Patrick William,0,0,0,0
1668122054181,CSE 240B,A00,102387,Zhao; Jishen,0,0,0,0
1668122054608,CSE 241A,A00,106406,Kang; Mingu,0,0,0,0
1668122055034,CSE 249B,A00,102388,Kahng; Andrew Byun,0,0,8,8
1668122055467,CSE 251B,A01,102392,Cottrell; Garrison W,0,0,0,0
1668122055467,CSE 251B,A02,102393,Cottrell; Garrison W,0,0,0,0
1668122055900,CSE 252B,A00,102394,Ochoa; Benjamin Lawrence,0,0,0,0
1668122056324,CSE 257,A01,102396,Gao; Sicun,0,0,0,0
1668122056753,CSE 272,A00,102397,Li; Tzumao,0,0,0,0
1668122057179,CSE 274,A00,111323,Chern; Albert Ren-Haur,0,0,0,0
1668122057609,CSE 282,A00,102398,Pevzner; Pavel Arkadjevich,0,0,0,0
1668122058052,CSE 284,A00,114175,Gymrek; Melissa Ann,0,0,0,0
1668122058493,CSE 290,A00,102399,Chandraker; Manmohan Krishna,0,0,0,0
1668122058493,CSE 290,B00,102400,Vaccaro; Kristen Marie,0,0,25,25
1668122058493,CSE 290,C00,102414,Pannuto; Patrick William,0,0,25,25
1668122058493,CSE 290,D00,102427,Pevzner; Pavel Arkadjevich,0,0,0,0
1668122058493,CSE 290,E00,102429,Zhao; Jishen,0,0,0,0
1668122058493,CSE 290,F00,102436,Tullsen; Dean Michael,0,0,0,0
1668122058493,CSE 290,G00,102440,Christensen; Henrik I,0,0,20,20
1668122058918,CSE 291,A00,102443,Su; Hao,0,0,0,0
1668122058918,CSE 291,B00,102448,Polikarpova; Nadezhda,0,0,0,0
1668122058918,CSE 291,C00,102453,Vaccaro; Kristen Marie,0,0,0,0
1668122058918,CSE 291,D00,111343,Savage; Stefan,0,0,0,0
1668122058918,CSE 291,E00,116474,Claffy; Kimberly Claire,0,0,0,0
1668122058918,CSE 291,F00,116479,Pasquale; Joseph,0,0,0,0
1668122059365,CSE 293,001,119111,Bafna; Vineet,9999,0,9999,0
1668122059365,CSE 293,002,119118,Bellare; Mihir,9999,0,9999,0
1668122059365,CSE 293,003,119122,Berg-Kirkpatrick; Taylor D,9999,0,9999,0
1668122059365,CSE 293,004,119135,Christensen; Henrik I,9999,0,9999,0
1668122059365,CSE 293,005,119142,Cottrell; Garrison W,9999,0,9999,0
1668122059365,CSE 293,006,119146,Deutsch; Alin Bernard,9999,0,9999,0
1668122059365,CSE 293,007,119159,Esmaeilzadeh; Hadi,9999,0,9999,0
1668122059365,CSE 293,008,119166,Freund; Yoav,9999,0,9999,0
1668122059365,CSE 293,009,119170,Griswold; William G.,9999,0,9999,0
1668122059365,CSE 293,010,119183,Gymrek; Melissa Ann,9999,0,9999,0
1668122059365,CSE 293,011,119190,Heninger; Nadia A,9999,0,9999,0
1668122059365,CSE 293,012,119230,Impagliazzo; Russell,9999,0,9999,0
1668122059365,CSE 293,013,119232,Jhala; Ranjit,9999,0,9999,0
1668122059365,CSE 293,014,119233,Kahng; Andrew Byun,9999,0,9999,0
1668122059365,CSE 293,015,119298,Kane; Daniel Mertz,9999,0,9999,0
1668122059365,CSE 293,016,119299,Kriegman; David J,9999,0,9999,0
1668122059365,CSE 293,017,119300,Kumar; Arun Kumar,9999,0,9999,0
1668122059365,CSE 293,018,119301,Lerner; Sorin,9999,0,9999,0
1668122059365,CSE 293,019,119302,Lovett; Shachar,9999,0,9999,0
1668122059365,CSE 293,020,119303,McAuley; Julian John,9999,0,9999,0
1668122059365,CSE 293,021,119304,Micciancio; Daniele,9999,0,9999,0
1668122059365,CSE 293,022,119367,Orailoglu; Alex,9999,0,9999,0
1668122059365,CSE 293,023,119382,Paturi; Ramamohan,9999,0,9999,0
1668122059365,CSE 293,024,119404,Polikarpova; Nadezhda,9999,0,9999,0
1668122059365,CSE 293,025,119406,Politz; Joseph Gibbs,9999,0,9999,0
1668122059365,CSE 293,026,119411,Porter; George M,9999,0,9999,0
1668122059365,CSE 293,027,119414,Porter; Leonard Emerson,9999,0,9999,0
1668122059365,CSE 293,028,119416,Ramamoorthi; Ravi,9999,0,9999,0
1668122059365,CSE 293,029,119417,Sahoo; Debashis,9999,0,9999,0
1668122059365,CSE 293,030,119420,Saul; Lawrence,9999,0,9999,0
1668122059365,CSE 293,031,119421,Savage; Stefan,9999,0,9999,0
1668122059365,CSE 293,032,119425,Schulze; Jurgen P.,9999,0,9999,0
1668122059365,CSE 293,033,119426,Snoeren; Alex C.,9999,0,9999,0
1668122059365,CSE 293,034,119428,Shang; Jingbo,9999,0,9999,0
1668122059365,CSE 293,035,119430,Stefan; Deian,9999,0,9999,0
1668122059365,CSE 293,036,119431,Su; Hao,9999,0,9999,0
1668122059365,CSE 293,037,119433,Swanson; Steven James,9999,0,9999,0
1668122059365,CSE 293,038,119435,Tullsen; Dean Michael,9999,0,9999,0
1668122059365,CSE 293,039,119483,Voelker; Geoffrey M.,9999,0,9999,0
1668122059365,CSE 293,040,119537,Zhao; Jishen,9999,0,9999,0
1668122059365,CSE 293,041,119538,Zhou; Yuan-Yuan,9999,0,9999,0
1668122059365,CSE 293,042,119539,Gao; Sicun,9999,0,9999,0
1668122059365,CSE 293,043,119540,Weibel; Nadir,9999,0,9999,0
1668122059365,CSE 293,044,119541,Gupta; Rajesh K.,9999,0,9999,0
1668122059365,CSE 293,045,126410,Vaccaro; Kristen Marie,9999,0,9999,0
1668122059365,CSE 293,046,126411,Klemke; Richard,9999,0,9999,0
1668122059807,CSE 294,A00,102459,Voelker; Geoffrey M.,0,0,0,0
1668122059807,CSE 294,B00,111322,Orailoglu; Alex,0,0,0,0
1668122060246,DSE 201,A00,096914,Deutsch; Alin Bernard,30,0,30,0
1668122060678,DSE 210,A00,096915,Dasgupta; Sanjoy,30,0,30,0
1668122061111,DSE 260A,A00,096916,Altintas De Callaf; Ilkay,30,0,30,0
1668122061577,ECE 200,001,103586,Antipa; Nicholas A,9999,0,9999,0
1668122061577,ECE 200,002,103587,Atanasov; Nikolay A.,9999,0,9999,0
1668122061577,ECE 200,003,103588,Bharadia; Dinesh,9999,0,9999,0
1668122061577,ECE 200,004,103589,Cheng; Chung Kuan,9999,0,9999,0
1668122061577,ECE 200,005,103590,Cosman; Pamela C.,9999,0,9999,0
1668122061577,ECE 200,006,103591,Dayeh; Shadi Ahmad,9999,0,9999,0
1668122061577,ECE 200,007,103592,Fainman; Yeshaiahu,9999,0,9999,0
1668122061577,ECE 200,008,103593,Ford; Joseph Earl,9999,0,9999,0
1668122061577,ECE 200,009,103594,Franceschetti; Massimo,9999,0,9999,0
1668122061577,ECE 200,010,103595,Fullerton; Eric E,9999,0,9999,0
1668122061577,ECE 200,011,103596,Galton; Ian A,9999,0,9999,0
1668122061577,ECE 200,012,103597,Gilja; Vikash,9999,0,9999,0
1668122061577,ECE 200,013,103598,Hall; Drew A.,9999,0,9999,0
1668122061577,ECE 200,014,103599,Hsueh; Tzu-Chien,9999,0,9999,0
1668122061577,ECE 200,015,103600,Javidi; Tara,9999,0,9999,0
1668122061577,ECE 200,016,103601,Kahng; Andrew Byun,9999,0,9999,0
1668122061577,ECE 200,017,103602,Kim; Young-Han,9999,0,9999,0
1668122061577,ECE 200,018,103603,Koushanfar; Farinaz,9999,0,9999,0
1668122061577,ECE 200,019,103604,Kuzum; Duygu,9999,0,9999,0
1668122061577,ECE 200,020,103605,Le; Hanh-Phuc,9999,0,9999,0
1668122061577,ECE 200,021,103606,Lin; Bill,9999,0,9999,0
1668122061577,ECE 200,022,103607,Liu; Zhaowei,9998,0,9999,1
1668122061577,ECE 200,023,103608,Lo; Yu-Hwa,9999,0,9999,0
1668122061577,ECE 200,024,103609,Lomakin; Vitaliy,9999,0,9999,0
1668122061577,ECE 200,025,103610,Mercier; Patrick Philip,9999,0,9999,0
1668122061577,ECE 200,026,103611,Meyer; Florian,9999,0,9999,0
1668122061577,ECE 200,027,103612,Milstein; Laurence B.,9999,0,9999,0
1668122061577,ECE 200,028,103613,Mir Arabbaygi; Siavash,9999,0,9999,0
1668122061577,ECE 200,029,103614,Mookherjea; Shayan,9999,0,9999,0
1668122061577,ECE 200,030,103615,Morris; Karcher William,9999,0,9999,0
1668122061577,ECE 200,031,103616,Ng; Tse Nga,9999,0,9999,0
1668122061577,ECE 200,032,103617,Nguyen; Truong Quang,9999,0,9999,0
1668122061577,ECE 200,033,103618,Nomura; Kenji,9999,0,9999,0
1668122061577,ECE 200,034,103619,Orlitsky; Alon,9999,0,9999,0
1668122061577,ECE 200,035,103620,Pal; Piya,9999,0,9999,0
1668122061577,ECE 200,036,103621,Papen; George C.,9999,0,9999,0
1668122061577,ECE 200,037,103622,Radic; Stojan,9999,0,9999,0
1668122061577,ECE 200,038,103623,Rao; Bhaskar D.,9999,0,9999,0
1668122061577,ECE 200,039,103624,Rao; Ramesh R,9999,0,9999,0
1668122061577,ECE 200,040,103625,Rebeiz; Gabriel,9999,0,9999,0
1668122061577,ECE 200,041,103626,Sanford; John R,9999,0,9999,0
1668122061577,ECE 200,042,103627,Siegel; Paul H.,9999,0,9999,0
1668122061577,ECE 200,043,103628,Sievenpiper; Daniel F.,9999,0,9999,0
1668122061577,ECE 200,044,103629,Sworder; David D.,9999,0,9999,0
1668122061577,ECE 200,045,103630,Taur; Yuan,9999,0,9999,0
1668122061577,ECE 200,046,103631,Touri; Behrouz,9999,0,9999,0
1668122061577,ECE 200,047,103632,Trivedi; Mohan M.,9999,0,9999,0
1668122061577,ECE 200,048,103633,Vasconcelos; Nuno,9999,0,9999,0
1668122061577,ECE 200,049,103634,Wang; Xiaolong,9999,0,9999,0
1668122061577,ECE 200,050,103635,Xie; Pengtao,9999,0,9999,0
1668122061577,ECE 200,051,103636,Yip; Michael,9999,0,9999,0
1668122061577,ECE 200,052,103637,Zeger; Kenneth A.,999,0,999,0
1668122061577,ECE 200,053,103638,Zhang; Xinyu,9999,0,9999,0
1668122061577,ECE 200,054,103639,Turakhia; Yatish Girish,9999,0,9999,0
1668122061577,ECE 200,055,103640,Kang; Mingu,9999,0,9999,0
1668122061577,ECE 200,056,103641,Shi; Yuanyuan,9999,0,9999,0
1668122061577,ECE 200,057,103642,Wang; Edward Jay,9999,0,9999,0
1668122061577,ECE 200,058,103643,Zheng; Yang,9999,0,9999,0
1668122062002,ECE 202,A00,103644,Kuzum; Duygu,0,0,0,0
1668122062425,ECE 212BN,A00,103646,Ng; Tse Nga,0,0,0,0
1668122062862,ECE 221,A00,111493,Staff,0,0,0,0
1668122063291,ECE 222B,A00,103647,Lomakin; Vitaliy,0,0,0,0
1668122063721,ECE 230B,A00,103648,Taur; Yuan,0,0,0,0
1668122064240,ECE 238B,A00,103649,Garay; Javier,0,0,0,0
1668122064662,ECE 240B,A00,112900,Fainman; Yeshaiahu,0,0,0,0
1668122065096,ECE 247A,A00,103650,Jokerst; Jesse Vincent,0,0,0,0
1668122065523,ECE 247B,A00,103651,Wang; Joseph,0,0,0,0
1668122065951,ECE 250,A00,103652,Siegel; Paul H.,0,0,0,0
1668122066386,ECE 251A,A00,103654,Rao; Bhaskar D.,0,0,0,0
1668122066892,ECE 257B,A00,103655,Bharadia; Dinesh,0,0,0,0
1668122067317,ECE 258A,A00,103656,Milstein; Laurence B.,0,0,0,0
1668122067742,ECE 260B,A00,103658,Kang; Mingu,0,0,0,0
1668122068172,ECE 264A,A00,103659,Galton; Ian A,0,0,0,0
1668122068604,ECE 265A,A00,103661,Gudem; Prasad S.S.,0,0,0,0
1668122069030,ECE 265D,A00,103662,Gudem; Prasad S.S.,0,0,0,0
1668122069459,ECE 268,A00,103663,Koushanfar; Farinaz,0,0,0,0
1668122069892,ECE 269,A01,103665,Pal; Piya,0,0,0,0
1668122070322,ECE 271B,A00,103666,Vasconcelos; Manuela,0,0,0,0
1668122070750,ECE 276A,A00,103667,Atanasov; Nikolay A.,0,0,0,0
1668122071179,ECE 277,A00,103668,An; Cheolhong,0,0,0,0
1668122071604,ECE 279,A00,117947,Hall; Drew A.,0,0,0,0
1668122072473,ECE 283,A00,103670,Hsueh; Tzu-Chien,0,0,0,0
1668122072904,ECE 284,A00,103671,Turakhia; Yatish Girish,0,0,0,0
1668122073327,ECE 285,A00,103672,Zheng; Yang,0,0,0,0
1668122073327,ECE 285,B00,103673,Sworder; David D.,0,0,0,0
1668122073748,ECE 287,A00,103676,Javidi; Tara,0,0,0,0
1668122074189,MATH 200B,A00,098023,Salehi Golsefidy; Alireza,12,0,15,3
1668122074618,MATH 202B,A00,098024,Rhoades; Brendon Patrick,9,0,15,6
1668122075042,MATH 203B,A00,098025,Oprea; Dragos N.,10,0,15,5
1668122075465,MATH 204B,A00,098026,Sorensen; Claus M,13,0,15,2
1668122075887,MATH 208,A00,098027,Izadi; Elham,7,0,10,3
1668122076319,MATH 209,A00,098028,Pollack; Aaron,10,0,10,0
1668122076755,MATH 211A,A00,112919,Rogalski; Daniel,9,0,10,1
1668122077178,MATH 211B,A00,112920,Seward; Brandon M.,9,0,10,1
1668122077611,MATH 218,A00,098029,Li; Bo,10,0,10,0
1668122078042,MATH 220B,A00,098030,Novak; Jonathan I,11,0,15,4
1668122078469,MATH 221A,A00,098031,Ebenfelt; Peter F,13,0,15,2
1668122078894,MATH 231B,A00,098032,Zlatos; Andrej,12,0,15,3
1668122079318,MATH 240B,A00,098033,Ni; Lei,9,0,15,6
1668122079752,MATH 243,A00,098034,Jekel; David Andrew,10,0,10,0
1668122080178,MATH 245A,A00,098035,Nie; Jiawang,0,0,15,16
1668122080603,MATH 248,A00,098036,Bejenaru; Ioan,10,0,10,0
1668122081033,MATH 250B,A00,098037,Spolaor; Luca,14,0,15,1
1668122081459,MATH 258,A00,098038,Ni; Lei,10,0,10,0
1668122081883,MATH 264B,A00,098041,Rhoades; Brendon Patrick,9,0,15,6
1668122082307,MATH 268,A00,098042,Buss; Samuel R,10,0,10,0
1668122082740,MATH 269,A00,098043,Rhoades; Brendon Patrick,10,0,10,0
1668122083164,MATH 270B,A00,098044,Li; Bo,10,0,15,5
1668122083593,MATH 272B,A00,098045,Holst; Michael J,13,0,15,2
1668122084023,MATH 273A,A00,098046,Tian; Xiaochuan,10,0,15,5
1668122084450,MATH 275,A01,098048,Tian; Xiaochuan,6,0,10,4
1668122084873,MATH 278A,A00,098049,Holst; Michael J,8,0,10,2
1668122085300,MATH 278B,A00,098050,Cloninger; Alexander,10,0,10,0
1668122085725,MATH 278C,A00,098051,Nie; Jiawang,7,0,10,3
1668122086150,MATH 280B,A00,098052,Zheng; Tianyi,10,0,15,5
1668122086574,MATH 281B,A00,098053,Bradic; Jelena,2,0,15,13
1668122086999,MATH 282B,A00,098054,Arias-Castro; Ery,0,0,15,15
1668122087435,MATH 285,A00,098055,Fitzsimmons; Patrick J,0,0,15,17
1668122087871,MATH 287B,A00,098056,Arias-Castro; Ery,3,0,15,12
1668122088305,MATH 288,A00,098057,Agarwal; Pooja,9,0,10,1
1668122088305,MATH 288,B00,098058,Zhang; Danna,8,0,10,2
1668122088305,MATH 288,C00,098059,Williams; Ruth J,10,0,10,0
1668122088736,MATH 290B,A00,098060,Roberts; Justin Deritter,13,0,15,2
1668122089170,MATH 292,A00,098061,Belmont; Eva Kinoshita,10,0,10,0
1668122089598,MATH 295,A00,098062,Suk; Andrew Hoon,48,0,50,2
1668122090026,MATH 296,A00,098063,Novak; Jonathan I,20,0,20,0
1668122090461,MATH 297,001,098064,Gamst; Anthony Collins,9997,0,9999,2
1668122594623,COGS 205,A00,101395,Chiba; Andrea,19,0,20,1
1668122595057,COGS 210B,001,101404,Greene; Deanna Jacquelyn,9998,0,9999,1
1668122595057,COGS 210B,002,101417,Xia; Haijun,9999,0,9999,0
1668122595057,COGS 210B,003,101422,Nitz; Douglas A.,9999,0,9999,0
1668122595057,COGS 210B,004,101423,Hollan; James D.,9998,0,9999,1
1668122595057,COGS 210B,005,101424,Deak; Gedeon O.,9998,0,9999,1
1668122595057,COGS 210B,006,101425,Rossano; Federico,9999,0,9999,0
1668122595485,COGS 211B,A00,101427,Coulson; Seana M,9996,0,9999,3
1668122595944,COGS 220,A00,101428,Hollan; James D.,0,0,25,25
1668122596367,COGS 229,A00,101429,Dow; Steven P,18,0,25,7
1668122596803,COGS 230,A00,101430,Klemmer; Scott R,12,0,17,5
1668122597238,COGS 234,A00,101431,Xia; Haijun,3,0,25,22
1668122597668,COGS 260,A00,101432,Kiyonaga; Anastasia,20,0,25,5
1668122597668,COGS 260,B00,101433,Kirsh; David Joel,16,0,25,9
1668122598110,CSE 202,A00,102371,Impagliazzo; Russell,0,0,0,0
1668122598536,CSE 203B,A01,102373,Cheng; Chung Kuan,0,0,0,0
1668122598964,CSE 208,A00,102374,Micciancio; Daniele,0,0,0,0
1668122599404,CSE 209A,A00,112895,Impagliazzo; Russell,0,0,15,15
1668122599848,CSE 209B,A00,108005,Bellare; Mihir,0,0,0,0
1668122600280,CSE 210,A00,113163,Coblenz; Michael J,0,0,0,0
1668122600712,CSE 219,A00,106111,Dow; Steven P,0,0,20,20
1668122601151,CSE 221,A00,102376,Voelker; Geoffrey M.,0,0,0,0
1668122601576,CSE 224,A01,102378,Porter; George M,0,0,0,0
1668122602003,CSE 229A,A00,102379,Savage; Stefan,0,0,0,0
1668122602433,CSE 229C,A00,102380,Munyaka; Imani N. S.,0,0,0,0
1668122602872,CSE 232B,A00,102382,Deutsch; Alin Bernard,0,0,0,0
1668122603309,CSE 234,A01,112904,Kumar; Arun Kumar,0,0,0,0
1668122603740,CSE 237A,A00,102383,Rosing; Tajana Simunic,0,0,0,0
1668122604165,CSE 239A,A00,102384,Deutsch; Alin Bernard,0,0,0,0
1668122604586,CSE 239B,A00,102385,Polikarpova; Nadezhda,0,0,0,0
1668122605016,CSE 240A,A00,102386,Pannuto; Patrick William,0,0,0,0
1668122605443,CSE 240B,A00,102387,Zhao; Jishen,0,0,0,0
1668122605879,CSE 241A,A00,106406,Kang; Mingu,0,0,0,0
1668122606312,CSE 249B,A00,102388,Kahng; Andrew Byun,0,0,8,8
1668122606742,CSE 251B,A01,102392,Cottrell; Garrison W,0,0,0,0
1668122606742,CSE 251B,A02,102393,Cottrell; Garrison W,0,0,0,0
1668122607166,CSE 252B,A00,102394,Ochoa; Benjamin Lawrence,0,0,0,0
1668122607588,CSE 257,A01,102396,Gao; Sicun,0,0,0,0
1668122608019,CSE 272,A00,102397,Li; Tzumao,0,0,0,0
1668122608466,CSE 274,A00,111323,Chern; Albert Ren-Haur,0,0,0,0
1668122608906,CSE 282,A00,102398,Pevzner; Pavel Arkadjevich,0,0,0,0
1668122609333,CSE 284,A00,114175,Gymrek; Melissa Ann,0,0,0,0
1668122609756,CSE 290,A00,102399,Chandraker; Manmohan Krishna,0,0,0,0
1668122609756,CSE 290,B00,102400,Vaccaro; Kristen Marie,0,0,25,25
1668122609756,CSE 290,C00,102414,Pannuto; Patrick William,0,0,25,25
1668122609756,CSE 290,D00,102427,Pevzner; Pavel Arkadjevich,0,0,0,0
1668122609756,CSE 290,E00,102429,Zhao; Jishen,0,0,0,0
1668122609756,CSE 290,F00,102436,Tullsen; Dean Michael,0,0,0,0
1668122609756,CSE 290,G00,102440,Christensen; Henrik I,0,0,20,20
1668122610187,CSE 291,A00,102443,Su; Hao,0,0,0,0
1668122610187,CSE 291,B00,102448,Polikarpova; Nadezhda,0,0,0,0
1668122610187,CSE 291,C00,102453,Vaccaro; Kristen Marie,0,0,0,0
1668122610187,CSE 291,D00,111343,Savage; Stefan,0,0,0,0
1668122610187,CSE 291,E00,116474,Claffy; Kimberly Claire,0,0,0,0
1668122610187,CSE 291,F00,116479,Pasquale; Joseph,0,0,0,0
1668122610616,CSE 293,001,119111,Bafna; Vineet,9999,0,9999,0
1668122610616,CSE 293,002,119118,Bellare; Mihir,9999,0,9999,0
1668122610616,CSE 293,003,119122,Berg-Kirkpatrick; Taylor D,9999,0,9999,0
1668122610616,CSE 293,004,119135,Christensen; Henrik I,9999,0,9999,0
1668122610616,CSE 293,005,119142,Cottrell; Garrison W,9999,0,9999,0
1668122610616,CSE 293,006,119146,Deutsch; Alin Bernard,9999,0,9999,0
1668122610616,CSE 293,007,119159,Esmaeilzadeh; Hadi,9999,0,9999,0
1668122610616,CSE 293,008,119166,Freund; Yoav,9999,0,9999,0
1668122610616,CSE 293,009,119170,Griswold; William G.,9999,0,9999,0
1668122610616,CSE 293,010,119183,Gymrek; Melissa Ann,9999,0,9999,0
1668122610616,CSE 293,011,119190,Heninger; Nadia A,9999,0,9999,0
1668122610616,CSE 293,012,119230,Impagliazzo; Russell,9999,0,9999,0
1668122610616,CSE 293,013,119232,Jhala; Ranjit,9999,0,9999,0
1668122610616,CSE 293,014,119233,Kahng; Andrew Byun,9999,0,9999,0
1668122610616,CSE 293,015,119298,Kane; Daniel Mertz,9999,0,9999,0
1668122610616,CSE 293,016,119299,Kriegman; David J,9999,0,9999,0
1668122610616,CSE 293,017,119300,Kumar; Arun Kumar,9999,0,9999,0
1668122610616,CSE 293,018,119301,Lerner; Sorin,9999,0,9999,0
1668122610616,CSE 293,019,119302,Lovett; Shachar,9999,0,9999,0
1668122610616,CSE 293,020,119303,McAuley; Julian John,9999,0,9999,0
1668122610616,CSE 293,021,119304,Micciancio; Daniele,9999,0,9999,0
1668122610616,CSE 293,022,119367,Orailoglu; Alex,9999,0,9999,0
1668122610616,CSE 293,023,119382,Paturi; Ramamohan,9999,0,9999,0
1668122610616,CSE 293,024,119404,Polikarpova; Nadezhda,9999,0,9999,0
1668122610616,CSE 293,025,119406,Politz; Joseph Gibbs,9999,0,9999,0
1668122610616,CSE 293,026,119411,Porter; George M,9999,0,9999,0
1668122610616,CSE 293,027,119414,Porter; Leonard Emerson,9999,0,9999,0
1668122610616,CSE 293,028,119416,Ramamoorthi; Ravi,9999,0,9999,0
1668122610616,CSE 293,029,119417,Sahoo; Debashis,9999,0,9999,0
1668122610616,CSE 293,030,119420,Saul; Lawrence,9999,0,9999,0
1668122610616,CSE 293,031,119421,Savage; Stefan,9999,0,9999,0
1668122610616,CSE 293,032,119425,Schulze; Jurgen P.,9999,0,9999,0
1668122610616,CSE 293,033,119426,Snoeren; Alex C.,9999,0,9999,0
1668122610616,CSE 293,034,119428,Shang; Jingbo,9999,0,9999,0
1668122610616,CSE 293,035,119430,Stefan; Deian,9999,0,9999,0
1668122610616,CSE 293,036,119431,Su; Hao,9999,0,9999,0
1668122610616,CSE 293,037,119433,Swanson; Steven James,9999,0,9999,0
1668122610616,CSE 293,038,119435,Tullsen; Dean Michael,9999,0,9999,0
1668122610616,CSE 293,039,119483,Voelker; Geoffrey M.,9999,0,9999,0
1668122610616,CSE 293,040,119537,Zhao; Jishen,9999,0,9999,0
1668122610616,CSE 293,041,119538,Zhou; Yuan-Yuan,9999,0,9999,0
1668122610616,CSE 293,042,119539,Gao; Sicun,9999,0,9999,0
1668122610616,CSE 293,043,119540,Weibel; Nadir,9999,0,9999,0
1668122610616,CSE 293,044,119541,Gupta; Rajesh K.,9999,0,9999,0
1668122610616,CSE 293,045,126410,Vaccaro; Kristen Marie,9999,0,9999,0
1668122610616,CSE 293,046,126411,Klemke; Richard,9999,0,9999,0
1668122611047,CSE 294,A00,102459,Voelker; Geoffrey M.,0,0,0,0
1668122611047,CSE 294,B00,111322,Orailoglu; Alex,0,0,0,0
1668122611477,DSE 201,A00,096914,Deutsch; Alin Bernard,30,0,30,0
1668122611900,DSE 210,A00,096915,Dasgupta; Sanjoy,30,0,30,0
1668122612327,DSE 260A,A00,096916,Altintas De Callaf; Ilkay,30,0,30,0
1668122612792,ECE 200,001,103586,Antipa; Nicholas A,9999,0,9999,0
1668122612792,ECE 200,002,103587,Atanasov; Nikolay A.,9999,0,9999,0
1668122612792,ECE 200,003,103588,Bharadia; Dinesh,9999,0,9999,0
1668122612792,ECE 200,004,103589,Cheng; Chung Kuan,9999,0,9999,0
1668122612792,ECE 200,005,103590,Cosman; Pamela C.,9999,0,9999,0
1668122612792,ECE 200,006,103591,Dayeh; Shadi Ahmad,9999,0,9999,0
1668122612792,ECE 200,007,103592,Fainman; Yeshaiahu,9999,0,9999,0
1668122612792,ECE 200,008,103593,Ford; Joseph Earl,9999,0,9999,0
1668122612792,ECE 200,009,103594,Franceschetti; Massimo,9999,0,9999,0
1668122612792,ECE 200,010,103595,Fullerton; Eric E,9999,0,9999,0
1668122612792,ECE 200,011,103596,Galton; Ian A,9999,0,9999,0
1668122612792,ECE 200,012,103597,Gilja; Vikash,9999,0,9999,0
1668122612792,ECE 200,013,103598,Hall; Drew A.,9999,0,9999,0
1668122612792,ECE 200,014,103599,Hsueh; Tzu-Chien,9999,0,9999,0
1668122612792,ECE 200,015,103600,Javidi; Tara,9999,0,9999,0
1668122612792,ECE 200,016,103601,Kahng; Andrew Byun,9999,0,9999,0
1668122612792,ECE 200,017,103602,Kim; Young-Han,9999,0,9999,0
1668122612792,ECE 200,018,103603,Koushanfar; Farinaz,9999,0,9999,0
1668122612792,ECE 200,019,103604,Kuzum; Duygu,9999,0,9999,0
1668122612792,ECE 200,020,103605,Le; Hanh-Phuc,9999,0,9999,0
1668122612792,ECE 200,021,103606,Lin; Bill,9999,0,9999,0
1668122612792,ECE 200,022,103607,Liu; Zhaowei,9998,0,9999,1
1668122612792,ECE 200,023,103608,Lo; Yu-Hwa,9999,0,9999,0
1668122612792,ECE 200,024,103609,Lomakin; Vitaliy,9999,0,9999,0
1668122612792,ECE 200,025,103610,Mercier; Patrick Philip,9999,0,9999,0
1668122612792,ECE 200,026,103611,Meyer; Florian,9999,0,9999,0
1668122612792,ECE 200,027,103612,Milstein; Laurence B.,9999,0,9999,0
1668122612792,ECE 200,028,103613,Mir Arabbaygi; Siavash,9999,0,9999,0
1668122612792,ECE 200,029,103614,Mookherjea; Shayan,9999,0,9999,0
1668122612792,ECE 200,030,103615,Morris; Karcher William,9999,0,9999,0
1668122612792,ECE 200,031,103616,Ng; Tse Nga,9999,0,9999,0
1668122612792,ECE 200,032,103617,Nguyen; Truong Quang,9999,0,9999,0
1668122612792,ECE 200,033,103618,Nomura; Kenji,9999,0,9999,0
1668122612792,ECE 200,034,103619,Orlitsky; Alon,9999,0,9999,0
1668122612792,ECE 200,035,103620,Pal; Piya,9999,0,9999,0
1668122612792,ECE 200,036,103621,Papen; George C.,9999,0,9999,0
1668122612792,ECE 200,037,103622,Radic; Stojan,9999,0,9999,0
1668122612792,ECE 200,038,103623,Rao; Bhaskar D.,9999,0,9999,0
1668122612792,ECE 200,039,103624,Rao; Ramesh R,9999,0,9999,0
1668122612792,ECE 200,040,103625,Rebeiz; Gabriel,9999,0,9999,0
1668122612792,ECE 200,041,103626,Sanford; John R,9999,0,9999,0
1668122612792,ECE 200,042,103627,Siegel; Paul H.,9999,0,9999,0
1668122612792,ECE 200,043,103628,Sievenpiper; Daniel F.,9999,0,9999,0
1668122612792,ECE 200,044,103629,Sworder; David D.,9999,0,9999,0
1668122612792,ECE 200,045,103630,Taur; Yuan,9999,0,9999,0
1668122612792,ECE 200,046,103631,Touri; Behrouz,9999,0,9999,0
1668122612792,ECE 200,047,103632,Trivedi; Mohan M.,9999,0,9999,0
1668122612792,ECE 200,048,103633,Vasconcelos; Nuno,9999,0,9999,0
1668122612792,ECE 200,049,103634,Wang; Xiaolong,9999,0,9999,0
1668122612792,ECE 200,050,103635,Xie; Pengtao,9999,0,9999,0
1668122612792,ECE 200,051,103636,Yip; Michael,9999,0,9999,0
1668122612792,ECE 200,052,103637,Zeger; Kenneth A.,999,0,999,0
1668122612792,ECE 200,053,103638,Zhang; Xinyu,9999,0,9999,0
1668122612792,ECE 200,054,103639,Turakhia; Yatish Girish,9999,0,9999,0
1668122612792,ECE 200,055,103640,Kang; Mingu,9999,0,9999,0
1668122612792,ECE 200,056,103641,Shi; Yuanyuan,9999,0,9999,0
1668122612792,ECE 200,057,103642,Wang; Edward Jay,9999,0,9999,0
1668122612792,ECE 200,058,103643,Zheng; Yang,9999,0,9999,0
1668122613224,ECE 202,A00,103644,Kuzum; Duygu,0,0,0,0
1668122613657,ECE 212BN,A00,103646,Ng; Tse Nga,0,0,0,0
1668122614079,ECE 221,A00,111493,Staff,0,0,0,0
1668122614506,ECE 222B,A00,103647,Lomakin; Vitaliy,0,0,0,0
1668122614939,ECE 230B,A00,103648,Taur; Yuan,0,0,0,0
1668122615369,ECE 238B,A00,103649,Garay; Javier,0,0,0,0
1668122615795,ECE 240B,A00,112900,Fainman; Yeshaiahu,0,0,0,0
1668122616218,ECE 247A,A00,103650,Jokerst; Jesse Vincent,0,0,0,0
1668122616646,ECE 247B,A00,103651,Wang; Joseph,0,0,0,0
1668122617085,ECE 250,A00,103652,Siegel; Paul H.,0,0,0,0
1668122617516,ECE 251A,A00,103654,Rao; Bhaskar D.,0,0,0,0
1668122617953,ECE 257B,A00,103655,Bharadia; Dinesh,0,0,0,0
1668122618384,ECE 258A,A00,103656,Milstein; Laurence B.,0,0,0,0
1668122618829,ECE 260B,A00,103658,Kang; Mingu,0,0,0,0
1668122619264,ECE 264A,A00,103659,Galton; Ian A,0,0,0,0
1668122619694,ECE 265A,A00,103661,Gudem; Prasad S.S.,0,0,0,0
1668122620124,ECE 265D,A00,103662,Gudem; Prasad S.S.,0,0,0,0
1668122620559,ECE 268,A00,103663,Koushanfar; Farinaz,0,0,0,0
1668122620989,ECE 269,A01,103665,Pal; Piya,0,0,0,0
1668122621414,ECE 271B,A00,103666,Vasconcelos; Manuela,0,0,0,0
1668122621838,ECE 276A,A00,103667,Atanasov; Nikolay A.,0,0,0,0
1668122622264,ECE 277,A00,103668,An; Cheolhong,0,0,0,0
1668122622688,ECE 279,A00,117947,Hall; Drew A.,0,0,0,0
1668122623723,ECE 283,A00,103670,Hsueh; Tzu-Chien,0,0,0,0
1668122624157,ECE 284,A00,103671,Turakhia; Yatish Girish,0,0,0,0
1668122624581,ECE 285,A00,103672,Zheng; Yang,0,0,0,0
1668122624581,ECE 285,B00,103673,Sworder; David D.,0,0,0,0
1668122625006,ECE 287,A00,103676,Javidi; Tara,0,0,0,0
1668122625440,MATH 200B,A00,098023,Salehi Golsefidy; Alireza,12,0,15,3
1668122625865,MATH 202B,A00,098024,Rhoades; Brendon Patrick,9,0,15,6
1668122626290,MATH 203B,A00,098025,Oprea; Dragos N.,10,0,15,5
1668122626716,MATH 204B,A00,098026,Sorensen; Claus M,13,0,15,2
1668122627138,MATH 208,A00,098027,Izadi; Elham,7,0,10,3
1668122627586,MATH 209,A00,098028,Pollack; Aaron,10,0,10,0
1668122628014,MATH 211A,A00,112919,Rogalski; Daniel,9,0,10,1
1668122628435,MATH 211B,A00,112920,Seward; Brandon M.,9,0,10,1
1668122628868,MATH 218,A00,098029,Li; Bo,10,0,10,0
1668122629292,MATH 220B,A00,098030,Novak; Jonathan I,11,0,15,4
1668122629726,MATH 221A,A00,098031,Ebenfelt; Peter F,13,0,15,2
1668122630156,MATH 231B,A00,098032,Zlatos; Andrej,12,0,15,3
1668122630591,MATH 240B,A00,098033,Ni; Lei,9,0,15,6
1668122631015,MATH 243,A00,098034,Jekel; David Andrew,10,0,10,0
1668122631441,MATH 245A,A00,098035,Nie; Jiawang,0,0,15,16
1668122631863,MATH 248,A00,098036,Bejenaru; Ioan,10,0,10,0
1668122632384,MATH 250B,A00,098037,Spolaor; Luca,14,0,15,1
1668122632808,MATH 258,A00,098038,Ni; Lei,10,0,10,0
1668122633231,MATH 264B,A00,098041,Rhoades; Brendon Patrick,9,0,15,6
1668122633660,MATH 268,A00,098042,Buss; Samuel R,10,0,10,0
1668122634084,MATH 269,A00,098043,Rhoades; Brendon Patrick,10,0,10,0
1668122634508,MATH 270B,A00,098044,Li; Bo,10,0,15,5
1668122634935,MATH 272B,A00,098045,Holst; Michael J,13,0,15,2
1668122635364,MATH 273A,A00,098046,Tian; Xiaochuan,10,0,15,5
1668122635792,MATH 275,A01,098048,Tian; Xiaochuan,6,0,10,4
1668122636214,MATH 278A,A00,098049,Holst; Michael J,8,0,10,2
1668122636640,MATH 278B,A00,098050,Cloninger; Alexander,10,0,10,0
1668122637063,MATH 278C,A00,098051,Nie; Jiawang,7,0,10,3
1668122637486,MATH 280B,A00,098052,Zheng; Tianyi,10,0,15,5
1668122637924,MATH 281B,A00,098053,Bradic; Jelena,2,0,15,13
1668122638360,MATH 282B,A00,098054,Arias-Castro; Ery,0,0,15,15
1668122638795,MATH 285,A00,098055,Fitzsimmons; Patrick J,0,0,15,17
1668122639222,MATH 287B,A00,098056,Arias-Castro; Ery,3,0,15,12
1668122639646,MATH 288,A00,098057,Agarwal; Pooja,9,0,10,1
1668122639646,MATH 288,B00,098058,Zhang; Danna,8,0,10,2
1668122639646,MATH 288,C00,098059,Williams; Ruth J,10,0,10,0
1668122640083,MATH 290B,A00,098060,Roberts; Justin Deritter,13,0,15,2
1668122640528,MATH 292,A00,098061,Belmont; Eva Kinoshita,10,0,10,0
1668122640968,MATH 295,A00,098062,Suk; Andrew Hoon,48,0,50,2
1668122641406,MATH 296,A00,098063,Novak; Jonathan I,20,0,20,0
1668122641844,MATH 297,001,098064,Gamst; Anthony Collins,9997,0,9999,2
1668123148838,COGS 205,A00,101395,Chiba; Andrea,19,0,20,1
1668123149284,COGS 210B,001,101404,Greene; Deanna Jacquelyn,9998,0,9999,1
1668123149284,COGS 210B,002,101417,Xia; Haijun,9999,0,9999,0
1668123149284,COGS 210B,003,101422,Nitz; Douglas A.,9999,0,9999,0
1668123149284,COGS 210B,004,101423,Hollan; James D.,9998,0,9999,1
1668123149284,COGS 210B,005,101424,Deak; Gedeon O.,9998,0,9999,1
1668123149284,COGS 210B,006,101425,Rossano; Federico,9999,0,9999,0
1668123149705,COGS 211B,A00,101427,Coulson; Seana M,9996,0,9999,3
1668123150132,COGS 220,A00,101428,Hollan; James D.,0,0,25,25
1668123150571,COGS 229,A00,101429,Dow; Steven P,18,0,25,7
1668123151000,COGS 230,A00,101430,Klemmer; Scott R,12,0,17,5
1668123151422,COGS 234,A00,101431,Xia; Haijun,3,0,25,22
1668123151844,COGS 260,A00,101432,Kiyonaga; Anastasia,20,0,25,5
1668123151844,COGS 260,B00,101433,Kirsh; David Joel,16,0,25,9
1668123152271,CSE 202,A00,102371,Impagliazzo; Russell,0,0,0,0
1668123152694,CSE 203B,A01,102373,Cheng; Chung Kuan,0,0,0,0
1668123153117,CSE 208,A00,102374,Micciancio; Daniele,0,0,0,0
1668123153546,CSE 209A,A00,112895,Impagliazzo; Russell,0,0,15,15
1668123153979,CSE 209B,A00,108005,Bellare; Mihir,0,0,0,0
1668123154408,CSE 210,A00,113163,Coblenz; Michael J,0,0,0,0
1668123154832,CSE 219,A00,106111,Dow; Steven P,0,0,20,20
1668123155256,CSE 221,A00,102376,Voelker; Geoffrey M.,0,0,0,0
1668123155694,CSE 224,A01,102378,Porter; George M,0,0,0,0
1668123156127,CSE 229A,A00,102379,Savage; Stefan,0,0,0,0
1668123156565,CSE 229C,A00,102380,Munyaka; Imani N. S.,0,0,0,0
1668123157002,CSE 232B,A00,102382,Deutsch; Alin Bernard,0,0,0,0
1668123157427,CSE 234,A01,112904,Kumar; Arun Kumar,0,0,0,0
1668123157868,CSE 237A,A00,102383,Rosing; Tajana Simunic,0,0,0,0
1668123158291,CSE 239A,A00,102384,Deutsch; Alin Bernard,0,0,0,0
1668123158715,CSE 239B,A00,102385,Polikarpova; Nadezhda,0,0,0,0
1668123159143,CSE 240A,A00,102386,Pannuto; Patrick William,0,0,0,0
1668123159679,CSE 240B,A00,102387,Zhao; Jishen,0,0,0,0
1668123160106,CSE 241A,A00,106406,Kang; Mingu,0,0,0,0
1668123160535,CSE 249B,A00,102388,Kahng; Andrew Byun,0,0,8,8
1668123160964,CSE 251B,A01,102392,Cottrell; Garrison W,0,0,0,0
1668123160964,CSE 251B,A02,102393,Cottrell; Garrison W,0,0,0,0
1668123161390,CSE 252B,A00,102394,Ochoa; Benjamin Lawrence,0,0,0,0
1668123161816,CSE 257,A01,102396,Gao; Sicun,0,0,0,0
1668123162241,CSE 272,A00,102397,Li; Tzumao,0,0,0,0
1668123162665,CSE 274,A00,111323,Chern; Albert Ren-Haur,0,0,0,0
1668123163099,CSE 282,A00,102398,Pevzner; Pavel Arkadjevich,0,0,0,0
1668123163522,CSE 284,A00,114175,Gymrek; Melissa Ann,0,0,0,0
1668123163947,CSE 290,A00,102399,Chandraker; Manmohan Krishna,0,0,0,0
1668123163947,CSE 290,B00,102400,Vaccaro; Kristen Marie,0,0,25,25
1668123163947,CSE 290,C00,102414,Pannuto; Patrick William,0,0,25,25
1668123163947,CSE 290,D00,102427,Pevzner; Pavel Arkadjevich,0,0,0,0
1668123163947,CSE 290,E00,102429,Zhao; Jishen,0,0,0,0
1668123163947,CSE 290,F00,102436,Tullsen; Dean Michael,0,0,0,0
1668123163947,CSE 290,G00,102440,Christensen; Henrik I,0,0,20,20
1668123164390,CSE 291,A00,102443,Su; Hao,0,0,0,0
1668123164390,CSE 291,B00,102448,Polikarpova; Nadezhda,0,0,0,0
1668123164390,CSE 291,C00,102453,Vaccaro; Kristen Marie,0,0,0,0
1668123164390,CSE 291,D00,111343,Savage; Stefan,0,0,0,0
1668123164390,CSE 291,E00,116474,Claffy; Kimberly Claire,0,0,0,0
1668123164390,CSE 291,F00,116479,Pasquale; Joseph,0,0,0,0
1668123164829,CSE 293,001,119111,Bafna; Vineet,9999,0,9999,0
1668123164829,CSE 293,002,119118,Bellare; Mihir,9999,0,9999,0
1668123164829,CSE 293,003,119122,Berg-Kirkpatrick; Taylor D,9999,0,9999,0
1668123164829,CSE 293,004,119135,Christensen; Henrik I,9999,0,9999,0
1668123164829,CSE 293,005,119142,Cottrell; Garrison W,9999,0,9999,0
1668123164829,CSE 293,006,119146,Deutsch; Alin Bernard,9999,0,9999,0
1668123164829,CSE 293,007,119159,Esmaeilzadeh; Hadi,9999,0,9999,0
1668123164829,CSE 293,008,119166,Freund; Yoav,9999,0,9999,0
1668123164829,CSE 293,009,119170,Griswold; William G.,9999,0,9999,0
1668123164829,CSE 293,010,119183,Gymrek; Melissa Ann,9999,0,9999,0
1668123164829,CSE 293,011,119190,Heninger; Nadia A,9999,0,9999,0
1668123164829,CSE 293,012,119230,Impagliazzo; Russell,9999,0,9999,0
1668123164829,CSE 293,013,119232,Jhala; Ranjit,9999,0,9999,0
1668123164829,CSE 293,014,119233,Kahng; Andrew Byun,9999,0,9999,0
1668123164829,CSE 293,015,119298,Kane; Daniel Mertz,9999,0,9999,0
1668123164829,CSE 293,016,119299,Kriegman; David J,9999,0,9999,0
1668123164829,CSE 293,017,119300,Kumar; Arun Kumar,9999,0,9999,0
1668123164829,CSE 293,018,119301,Lerner; Sorin,9999,0,9999,0
1668123164829,CSE 293,019,119302,Lovett; Shachar,9999,0,9999,0
1668123164829,CSE 293,020,119303,McAuley; Julian John,9999,0,9999,0
1668123164829,CSE 293,021,119304,Micciancio; Daniele,9999,0,9999,0
1668123164829,CSE 293,022,119367,Orailoglu; Alex,9999,0,9999,0
1668123164829,CSE 293,023,119382,Paturi; Ramamohan,9999,0,9999,0
1668123164829,CSE 293,024,119404,Polikarpova; Nadezhda,9999,0,9999,0
1668123164829,CSE 293,025,119406,Politz; Joseph Gibbs,9999,0,9999,0
1668123164829,CSE 293,026,119411,Porter; George M,9999,0,9999,0
1668123164829,CSE 293,027,119414,Porter; Leonard Emerson,9999,0,9999,0
1668123164829,CSE 293,028,119416,Ramamoorthi; Ravi,9999,0,9999,0
1668123164829,CSE 293,029,119417,Sahoo; Debashis,9999,0,9999,0
1668123164829,CSE 293,030,119420,Saul; Lawrence,9999,0,9999,0
1668123164829,CSE 293,031,119421,Savage; Stefan,9999,0,9999,0
1668123164829,CSE 293,032,119425,Schulze; Jurgen P.,9999,0,9999,0
1668123164829,CSE 293,033,119426,Snoeren; Alex C.,9999,0,9999,0
1668123164829,CSE 293,034,119428,Shang; Jingbo,9999,0,9999,0
1668123164829,CSE 293,035,119430,Stefan; Deian,9999,0,9999,0
1668123164829,CSE 293,036,119431,Su; Hao,9999,0,9999,0
1668123164829,CSE 293,037,119433,Swanson; Steven James,9999,0,9999,0
1668123164829,CSE 293,038,119435,Tullsen; Dean Michael,9999,0,9999,0
1668123164829,CSE 293,039,119483,Voelker; Geoffrey M.,9999,0,9999,0
1668123164829,CSE 293,040,119537,Zhao; Jishen,9999,0,9999,0
1668123164829,CSE 293,041,119538,Zhou; Yuan-Yuan,9999,0,9999,0
1668123164829,CSE 293,042,119539,Gao; Sicun,9999,0,9999,0
1668123164829,CSE 293,043,119540,Weibel; Nadir,9999,0,9999,0
1668123164829,CSE 293,044,119541,Gupta; Rajesh K.,9999,0,9999,0
1668123164829,CSE 293,045,126410,Vaccaro; Kristen Marie,9999,0,9999,0
1668123164829,CSE 293,046,126411,Klemke; Richard,9999,0,9999,0
1668123165267,CSE 294,A00,102459,Voelker; Geoffrey M.,0,0,0,0
1668123165267,CSE 294,B00,111322,Orailoglu; Alex,0,0,0,0
1668123165688,DSE 201,A00,096914,Deutsch; Alin Bernard,30,0,30,0
1668123166110,DSE 210,A00,096915,Dasgupta; Sanjoy,30,0,30,0
1668123166537,DSE 260A,A00,096916,Altintas De Callaf; Ilkay,30,0,30,0
1668123166978,ECE 200,001,103586,Antipa; Nicholas A,9999,0,9999,0
1668123166978,ECE 200,002,103587,Atanasov; Nikolay A.,9999,0,9999,0
1668123166978,ECE 200,003,103588,Bharadia; Dinesh,9999,0,9999,0
1668123166978,ECE 200,004,103589,Cheng; Chung Kuan,9999,0,9999,0
1668123166978,ECE 200,005,103590,Cosman; Pamela C.,9999,0,9999,0
1668123166978,ECE 200,006,103591,Dayeh; Shadi Ahmad,9999,0,9999,0
1668123166978,ECE 200,007,103592,Fainman; Yeshaiahu,9999,0,9999,0
1668123166978,ECE 200,008,103593,Ford; Joseph Earl,9999,0,9999,0
1668123166978,ECE 200,009,103594,Franceschetti; Massimo,9999,0,9999,0
1668123166978,ECE 200,010,103595,Fullerton; Eric E,9999,0,9999,0
1668123166978,ECE 200,011,103596,Galton; Ian A,9999,0,9999,0
1668123166978,ECE 200,012,103597,Gilja; Vikash,9999,0,9999,0
1668123166978,ECE 200,013,103598,Hall; Drew A.,9999,0,9999,0
1668123166978,ECE 200,014,103599,Hsueh; Tzu-Chien,9999,0,9999,0
1668123166978,ECE 200,015,103600,Javidi; Tara,9999,0,9999,0
1668123166978,ECE 200,016,103601,Kahng; Andrew Byun,9999,0,9999,0
1668123166978,ECE 200,017,103602,Kim; Young-Han,9999,0,9999,0
1668123166978,ECE 200,018,103603,Koushanfar; Farinaz,9999,0,9999,0
1668123166978,ECE 200,019,103604,Kuzum; Duygu,9999,0,9999,0
1668123166978,ECE 200,020,103605,Le; Hanh-Phuc,9999,0,9999,0
1668123166978,ECE 200,021,103606,Lin; Bill,9999,0,9999,0
1668123166978,ECE 200,022,103607,Liu; Zhaowei,9998,0,9999,1
1668123166978,ECE 200,023,103608,Lo; Yu-Hwa,9999,0,9999,0
1668123166978,ECE 200,024,103609,Lomakin; Vitaliy,9999,0,9999,0
1668123166978,ECE 200,025,103610,Mercier; Patrick Philip,9999,0,9999,0
1668123166978,ECE 200,026,103611,Meyer; Florian,9999,0,9999,0
1668123166978,ECE 200,027,103612,Milstein; Laurence B.,9999,0,9999,0
1668123166978,ECE 200,028,103613,Mir Arabbaygi; Siavash,9999,0,9999,0
1668123166978,ECE 200,029,103614,Mookherjea; Shayan,9999,0,9999,0
1668123166978,ECE 200,030,103615,Morris; Karcher William,9999,0,9999,0
1668123166978,ECE 200,031,103616,Ng; Tse Nga,9999,0,9999,0
1668123166978,ECE 200,032,103617,Nguyen; Truong Quang,9999,0,9999,0
1668123166978,ECE 200,033,103618,Nomura; Kenji,9999,0,9999,0
1668123166978,ECE 200,034,103619,Orlitsky; Alon,9999,0,9999,0
1668123166978,ECE 200,035,103620,Pal; Piya,9999,0,9999,0
1668123166978,ECE 200,036,103621,Papen; George C.,9999,0,9999,0
1668123166978,ECE 200,037,103622,Radic; Stojan,9999,0,9999,0
1668123166978,ECE 200,038,103623,Rao; Bhaskar D.,9999,0,9999,0
1668123166978,ECE 200,039,103624,Rao; Ramesh R,9999,0,9999,0
1668123166978,ECE 200,040,103625,Rebeiz; Gabriel,9999,0,9999,0
1668123166978,ECE 200,041,103626,Sanford; John R,9999,0,9999,0
1668123166978,ECE 200,042,103627,Siegel; Paul H.,9999,0,9999,0
1668123166978,ECE 200,043,103628,Sievenpiper; Daniel F.,9999,0,9999,0
1668123166978,ECE 200,044,103629,Sworder; David D.,9999,0,9999,0
1668123166978,ECE 200,045,103630,Taur; Yuan,9999,0,9999,0
1668123166978,ECE 200,046,103631,Touri; Behrouz,9999,0,9999,0
1668123166978,ECE 200,047,103632,Trivedi; Mohan M.,9999,0,9999,0
1668123166978,ECE 200,048,103633,Vasconcelos; Nuno,9999,0,9999,0
1668123166978,ECE 200,049,103634,Wang; Xiaolong,9999,0,9999,0
1668123166978,ECE 200,050,103635,Xie; Pengtao,9999,0,9999,0
1668123166978,ECE 200,051,103636,Yip; Michael,9999,0,9999,0
1668123166978,ECE 200,052,103637,Zeger; Kenneth A.,999,0,999,0
1668123166978,ECE 200,053,103638,Zhang; Xinyu,9999,0,9999,0
1668123166978,ECE 200,054,103639,Turakhia; Yatish Girish,9999,0,9999,0
1668123166978,ECE 200,055,103640,Kang; Mingu,9999,0,9999,0
1668123166978,ECE 200,056,103641,Shi; Yuanyuan,9999,0,9999,0
1668123166978,ECE 200,057,103642,Wang; Edward Jay,9999,0,9999,0
1668123166978,ECE 200,058,103643,Zheng; Yang,9999,0,9999,0
1668123167421,ECE 202,A00,103644,Kuzum; Duygu,0,0,0,0
1668123168007,ECE 212BN,A00,103646,Ng; Tse Nga,0,0,0,0
1668123168439,ECE 221,A00,111493,Staff,0,0,0,0
1668123168864,ECE 222B,A00,103647,Lomakin; Vitaliy,0,0,0,0
1668123169297,ECE 230B,A00,103648,Taur; Yuan,0,0,0,0
1668123169719,ECE 238B,A00,103649,Garay; Javier,0,0,0,0
1668123170144,ECE 240B,A00,112900,Fainman; Yeshaiahu,0,0,0,0
1668123170571,ECE 247A,A00,103650,Jokerst; Jesse Vincent,0,0,0,0
1668123171011,ECE 247B,A00,103651,Wang; Joseph,0,0,0,0
1668123171449,ECE 250,A00,103652,Siegel; Paul H.,0,0,0,0
1668123171887,ECE 251A,A00,103654,Rao; Bhaskar D.,0,0,0,0
1668123172311,ECE 257B,A00,103655,Bharadia; Dinesh,0,0,0,0
1668123172736,ECE 258A,A00,103656,Milstein; Laurence B.,0,0,0,0
1668123173162,ECE 260B,A00,103658,Kang; Mingu,0,0,0,0
1668123173585,ECE 264A,A00,103659,Galton; Ian A,0,0,0,0
1668123174015,ECE 265A,A00,103661,Gudem; Prasad S.S.,0,0,0,0
1668123174445,ECE 265D,A00,103662,Gudem; Prasad S.S.,0,0,0,0
1668123174870,ECE 268,A00,103663,Koushanfar; Farinaz,0,0,0,0
1668123175293,ECE 269,A01,103665,Pal; Piya,0,0,0,0
1668123175718,ECE 271B,A00,103666,Vasconcelos; Manuela,0,0,0,0
1668123176144,ECE 276A,A00,103667,Atanasov; Nikolay A.,0,0,0,0
1668123176577,ECE 277,A00,103668,An; Cheolhong,0,0,0,0
1668123177000,ECE 279,A00,117947,Hall; Drew A.,0,0,0,0
1668123177846,ECE 283,A00,103670,Hsueh; Tzu-Chien,0,0,0,0
1668123178283,ECE 284,A00,103671,Turakhia; Yatish Girish,0,0,0,0
1668123178711,ECE 285,A00,103672,Zheng; Yang,0,0,0,0
1668123178711,ECE 285,B00,103673,Sworder; David D.,0,0,0,0
1668123179143,ECE 287,A00,103676,Javidi; Tara,0,0,0,0
1668123179579,MATH 200B,A00,098023,Salehi Golsefidy; Alireza,12,0,15,3
1668123180012,MATH 202B,A00,098024,Rhoades; Brendon Patrick,9,0,15,6
1668123180447,MATH 203B,A00,098025,Oprea; Dragos N.,10,0,15,5
1668123180876,MATH 204B,A00,098026,Sorensen; Claus M,13,0,15,2
1668123181303,MATH 208,A00,098027,Izadi; Elham,7,0,10,3
1668123181724,MATH 209,A00,098028,Pollack; Aaron,10,0,10,0
1668123182158,MATH 211A,A00,112919,Rogalski; Daniel,9,0,10,1
1668123182588,MATH 211B,A00,112920,Seward; Brandon M.,9,0,10,1
1668123183018,MATH 218,A00,098029,Li; Bo,10,0,10,0
1668123183450,MATH 220B,A00,098030,Novak; Jonathan I,11,0,15,4
1668123183888,MATH 221A,A00,098031,Ebenfelt; Peter F,13,0,15,2
1668123184310,MATH 231B,A00,098032,Zlatos; Andrej,12,0,15,3
1668123184740,MATH 240B,A00,098033,Ni; Lei,9,0,15,6
1668123185176,MATH 243,A00,098034,Jekel; David Andrew,10,0,10,0
1668123185598,MATH 245A,A00,098035,Nie; Jiawang,0,0,15,16
1668123186022,MATH 248,A00,098036,Bejenaru; Ioan,10,0,10,0
1668123186451,MATH 250B,A00,098037,Spolaor; Luca,14,0,15,1
1668123186873,MATH 258,A00,098038,Ni; Lei,10,0,10,0
1668123187313,MATH 264B,A00,098041,Rhoades; Brendon Patrick,9,0,15,6
1668123187771,MATH 268,A00,098042,Buss; Samuel R,10,0,10,0
1668123188198,MATH 269,A00,098043,Rhoades; Brendon Patrick,10,0,10,0
1668123188624,MATH 270B,A00,098044,Li; Bo,10,0,15,5
1668123189168,MATH 272B,A00,098045,Holst; Michael J,13,0,15,2
1668123189599,MATH 273A,A00,098046,Tian; Xiaochuan,10,0,15,5
1668123190038,MATH 275,A01,098048,Tian; Xiaochuan,6,0,10,4
1668123190462,MATH 278A,A00,098049,Holst; Michael J,8,0,10,2
1668123190888,MATH 278B,A00,098050,Cloninger; Alexander,10,0,10,0
1668123191322,MATH 278C,A00,098051,Nie; Jiawang,7,0,10,3
1668123191753,MATH 280B,A00,098052,Zheng; Tianyi,10,0,15,5
1668123192197,MATH 281B,A00,098053,Bradic; Jelena,2,0,15,13
1668123192622,MATH 282B,A00,098054,Arias-Castro; Ery,0,0,15,15
1668123193058,MATH 285,A00,098055,Fitzsimmons; Patrick J,0,0,15,17
1668123193490,MATH 287B,A00,098056,Arias-Castro; Ery,3,0,15,12
1668123193914,MATH 288,A00,098057,Agarwal; Pooja,9,0,10,1
1668123193914,MATH 288,B00,098058,Zhang; Danna,8,0,10,2
1668123193914,MATH 288,C00,098059,Williams; Ruth J,10,0,10,0
1668123194336,MATH 290B,A00,098060,Roberts; Justin Deritter,13,0,15,2
1668123194765,MATH 292,A00,098061,Belmont; Eva Kinoshita,10,0,10,0
1668123195194,MATH 295,A00,098062,Suk; Andrew Hoon,48,0,50,2
1668123195623,MATH 296,A00,098063,Novak; Jonathan I,20,0,20,0
1668123196052,MATH 297,001,098064,Gamst; Anthony Collins,9997,0,9999,2
1668123712381,COGS 205,A00,101395,Chiba; Andrea,19,0,20,1
1668123712816,COGS 210B,001,101404,Greene; Deanna Jacquelyn,9998,0,9999,1
1668123712816,COGS 210B,002,101417,Xia; Haijun,9999,0,9999,0
1668123712816,COGS 210B,003,101422,Nitz; Douglas A.,9999,0,9999,0
1668123712816,COGS 210B,004,101423,Hollan; James D.,9998,0,9999,1
1668123712816,COGS 210B,005,101424,Deak; Gedeon O.,9998,0,9999,1
1668123712816,COGS 210B,006,101425,Rossano; Federico,9999,0,9999,0
1668123713239,COGS 211B,A00,101427,Coulson; Seana M,9996,0,9999,3
1668123713672,COGS 220,A00,101428,Hollan; James D.,0,0,25,25
1668123714097,COGS 229,A00,101429,Dow; Steven P,18,0,25,7
1668123714534,COGS 230,A00,101430,Klemmer; Scott R,12,0,17,5
1668123714970,COGS 234,A00,101431,Xia; Haijun,3,0,25,22
1668123715400,COGS 260,A00,101432,Kiyonaga; Anastasia,20,0,25,5
1668123715400,COGS 260,B00,101433,Kirsh; David Joel,16,0,25,9
1668123715833,CSE 202,A00,102371,Impagliazzo; Russell,0,0,0,0
1668123716266,CSE 203B,A01,102373,Cheng; Chung Kuan,0,0,0,0
1668123716692,CSE 208,A00,102374,Micciancio; Daniele,0,0,0,0
1668123717117,CSE 209A,A00,112895,Impagliazzo; Russell,0,0,15,15
1668123717547,CSE 209B,A00,108005,Bellare; Mihir,0,0,0,0
1668123717971,CSE 210,A00,113163,Coblenz; Michael J,0,0,0,0
1668123718406,CSE 219,A00,106111,Dow; Steven P,0,0,20,20
1668123718830,CSE 221,A00,102376,Voelker; Geoffrey M.,0,0,0,0
1668123719267,CSE 224,A01,102378,Porter; George M,0,0,0,0
1668123719701,CSE 229A,A00,102379,Savage; Stefan,0,0,0,0
1668123720133,CSE 229C,A00,102380,Munyaka; Imani N. S.,0,0,0,0
1668123720560,CSE 232B,A00,102382,Deutsch; Alin Bernard,0,0,0,0
1668123720983,CSE 234,A01,112904,Kumar; Arun Kumar,0,0,0,0
1668123721416,CSE 237A,A00,102383,Rosing; Tajana Simunic,0,0,0,0
1668123721844,CSE 239A,A00,102384,Deutsch; Alin Bernard,0,0,0,0
1668123722280,CSE 239B,A00,102385,Polikarpova; Nadezhda,0,0,0,0
1668123722705,CSE 240A,A00,102386,Pannuto; Patrick William,0,0,0,0
1668123723138,CSE 240B,A00,102387,Zhao; Jishen,0,0,0,0
1668123723564,CSE 241A,A00,106406,Kang; Mingu,0,0,0,0
1668123723986,CSE 249B,A00,102388,Kahng; Andrew Byun,0,0,8,8
1668123724412,CSE 251B,A01,102392,Cottrell; Garrison W,0,0,0,0
1668123724412,CSE 251B,A02,102393,Cottrell; Garrison W,0,0,0,0
1668123724865,CSE 252B,A00,102394,Ochoa; Benjamin Lawrence,0,0,0,0
1668123725292,CSE 257,A01,102396,Gao; Sicun,0,0,0,0
1668123725722,CSE 272,A00,102397,Li; Tzumao,0,0,0,0
1668123726146,CSE 274,A00,111323,Chern; Albert Ren-Haur,0,0,0,0
1668123726568,CSE 282,A00,102398,Pevzner; Pavel Arkadjevich,0,0,0,0
1668123727000,CSE 284,A00,114175,Gymrek; Melissa Ann,0,0,0,0
1668123727422,CSE 290,A00,102399,Chandraker; Manmohan Krishna,0,0,0,0
1668123727422,CSE 290,B00,102400,Vaccaro; Kristen Marie,0,0,25,25
1668123727422,CSE 290,C00,102414,Pannuto; Patrick William,0,0,25,25
1668123727422,CSE 290,D00,102427,Pevzner; Pavel Arkadjevich,0,0,0,0
1668123727422,CSE 290,E00,102429,Zhao; Jishen,0,0,0,0
1668123727422,CSE 290,F00,102436,Tullsen; Dean Michael,0,0,0,0
1668123727422,CSE 290,G00,102440,Christensen; Henrik I,0,0,20,20
1668123727847,CSE 291,A00,102443,Su; Hao,0,0,0,0
1668123727847,CSE 291,B00,102448,Polikarpova; Nadezhda,0,0,0,0
1668123727847,CSE 291,C00,102453,Vaccaro; Kristen Marie,0,0,0,0
1668123727847,CSE 291,D00,111343,Savage; Stefan,0,0,0,0
1668123727847,CSE 291,E00,116474,Claffy; Kimberly Claire,0,0,0,0
1668123727847,CSE 291,F00,116479,Pasquale; Joseph,0,0,0,0
1668123728276,CSE 293,001,119111,Bafna; Vineet,9999,0,9999,0
1668123728276,CSE 293,002,119118,Bellare; Mihir,9999,0,9999,0
1668123728276,CSE 293,003,119122,Berg-Kirkpatrick; Taylor D,9999,0,9999,0
1668123728276,CSE 293,004,119135,Christensen; Henrik I,9999,0,9999,0
1668123728276,CSE 293,005,119142,Cottrell; Garrison W,9999,0,9999,0
1668123728276,CSE 293,006,119146,Deutsch; Alin Bernard,9999,0,9999,0
1668123728276,CSE 293,007,119159,Esmaeilzadeh; Hadi,9999,0,9999,0
1668123728276,CSE 293,008,119166,Freund; Yoav,9999,0,9999,0
1668123728276,CSE 293,009,119170,Griswold; William G.,9999,0,9999,0
1668123728276,CSE 293,010,119183,Gymrek; Melissa Ann,9999,0,9999,0
1668123728276,CSE 293,011,119190,Heninger; Nadia A,9999,0,9999,0
1668123728276,CSE 293,012,119230,Impagliazzo; Russell,9999,0,9999,0
1668123728276,CSE 293,013,119232,Jhala; Ranjit,9999,0,9999,0
1668123728276,CSE 293,014,119233,Kahng; Andrew Byun,9999,0,9999,0
1668123728276,CSE 293,015,119298,Kane; Daniel Mertz,9999,0,9999,0
1668123728276,CSE 293,016,119299,Kriegman; David J,9999,0,9999,0
1668123728276,CSE 293,017,119300,Kumar; Arun Kumar,9999,0,9999,0
1668123728276,CSE 293,018,119301,Lerner; Sorin,9999,0,9999,0
1668123728276,CSE 293,019,119302,Lovett; Shachar,9999,0,9999,0
1668123728276,CSE 293,020,119303,McAuley; Julian John,9999,0,9999,0
1668123728276,CSE 293,021,119304,Micciancio; Daniele,9999,0,9999,0
1668123728276,CSE 293,022,119367,Orailoglu; Alex,9999,0,9999,0
1668123728276,CSE 293,023,119382,Paturi; Ramamohan,9999,0,9999,0
1668123728276,CSE 293,024,119404,Polikarpova; Nadezhda,9999,0,9999,0
1668123728276,CSE 293,025,119406,Politz; Joseph Gibbs,9999,0,9999,0
1668123728276,CSE 293,026,119411,Porter; George M,9999,0,9999,0
1668123728276,CSE 293,027,119414,Porter; Leonard Emerson,9999,0,9999,0
1668123728276,CSE 293,028,119416,Ramamoorthi; Ravi,9999,0,9999,0
1668123728276,CSE 293,029,119417,Sahoo; Debashis,9999,0,9999,0
1668123728276,CSE 293,030,119420,Saul; Lawrence,9999,0,9999,0
1668123728276,CSE 293,031,119421,Savage; Stefan,9999,0,9999,0
1668123728276,CSE 293,032,119425,Schulze; Jurgen P.,9999,0,9999,0
1668123728276,CSE 293,033,119426,Snoeren; Alex C.,9999,0,9999,0
1668123728276,CSE 293,034,119428,Shang; Jingbo,9999,0,9999,0
1668123728276,CSE 293,035,119430,Stefan; Deian,9999,0,9999,0
1668123728276,CSE 293,036,119431,Su; Hao,9999,0,9999,0
1668123728276,CSE 293,037,119433,Swanson; Steven James,9999,0,9999,0
1668123728276,CSE 293,038,119435,Tullsen; Dean Michael,9999,0,9999,0
1668123728276,CSE 293,039,119483,Voelker; Geoffrey M.,9999,0,9999,0
1668123728276,CSE 293,040,119537,Zhao; Jishen,9999,0,9999,0
1668123728276,CSE 293,041,119538,Zhou; Yuan-Yuan,9999,0,9999,0
1668123728276,CSE 293,042,119539,Gao; Sicun,9999,0,9999,0
1668123728276,CSE 293,043,119540,Weibel; Nadir,9999,0,9999,0
1668123728276,CSE 293,044,119541,Gupta; Rajesh K.,9999,0,9999,0
1668123728276,CSE 293,045,126410,Vaccaro; Kristen Marie,9999,0,9999,0
1668123728276,CSE 293,046,126411,Klemke; Richard,9999,0,9999,0
1668123728707,CSE 294,A00,102459,Voelker; Geoffrey M.,0,0,0,0
1668123728707,CSE 294,B00,111322,Orailoglu; Alex,0,0,0,0
1668123729130,DSE 201,A00,096914,Deutsch; Alin Bernard,30,0,30,0
1668123729565,DSE 210,A00,096915,Dasgupta; Sanjoy,30,0,30,0
1668123729988,DSE 260A,A00,096916,Altintas De Callaf; Ilkay,30,0,30,0
1668123730416,ECE 200,001,103586,Antipa; Nicholas A,9999,0,9999,0
1668123730416,ECE 200,002,103587,Atanasov; Nikolay A.,9999,0,9999,0
1668123730416,ECE 200,003,103588,Bharadia; Dinesh,9999,0,9999,0
1668123730416,ECE 200,004,103589,Cheng; Chung Kuan,9999,0,9999,0
1668123730416,ECE 200,005,103590,Cosman; Pamela C.,9999,0,9999,0
1668123730416,ECE 200,006,103591,Dayeh; Shadi Ahmad,9999,0,9999,0
1668123730416,ECE 200,007,103592,Fainman; Yeshaiahu,9999,0,9999,0
1668123730416,ECE 200,008,103593,Ford; Joseph Earl,9999,0,9999,0
1668123730416,ECE 200,009,103594,Franceschetti; Massimo,9999,0,9999,0
1668123730416,ECE 200,010,103595,Fullerton; Eric E,9999,0,9999,0
1668123730416,ECE 200,011,103596,Galton; Ian A,9999,0,9999,0
1668123730416,ECE 200,012,103597,Gilja; Vikash,9999,0,9999,0
1668123730416,ECE 200,013,103598,Hall; Drew A.,9999,0,9999,0
1668123730416,ECE 200,014,103599,Hsueh; Tzu-Chien,9999,0,9999,0
1668123730416,ECE 200,015,103600,Javidi; Tara,9999,0,9999,0
1668123730416,ECE 200,016,103601,Kahng; Andrew Byun,9999,0,9999,0
1668123730416,ECE 200,017,103602,Kim; Young-Han,9999,0,9999,0
1668123730416,ECE 200,018,103603,Koushanfar; Farinaz,9999,0,9999,0
1668123730416,ECE 200,019,103604,Kuzum; Duygu,9999,0,9999,0
1668123730416,ECE 200,020,103605,Le; Hanh-Phuc,9999,0,9999,0
1668123730416,ECE 200,021,103606,Lin; Bill,9999,0,9999,0
1668123730416,ECE 200,022,103607,Liu; Zhaowei,9998,0,9999,1
1668123730416,ECE 200,023,103608,Lo; Yu-Hwa,9999,0,9999,0
1668123730416,ECE 200,024,103609,Lomakin; Vitaliy,9999,0,9999,0
1668123730416,ECE 200,025,103610,Mercier; Patrick Philip,9999,0,9999,0
1668123730416,ECE 200,026,103611,Meyer; Florian,9999,0,9999,0
1668123730416,ECE 200,027,103612,Milstein; Laurence B.,9999,0,9999,0
1668123730416,ECE 200,028,103613,Mir Arabbaygi; Siavash,9999,0,9999,0
1668123730416,ECE 200,029,103614,Mookherjea; Shayan,9999,0,9999,0
1668123730416,ECE 200,030,103615,Morris; Karcher William,9999,0,9999,0
1668123730416,ECE 200,031,103616,Ng; Tse Nga,9999,0,9999,0
1668123730416,ECE 200,032,103617,Nguyen; Truong Quang,9999,0,9999,0
1668123730416,ECE 200,033,103618,Nomura; Kenji,9999,0,9999,0
1668123730416,ECE 200,034,103619,Orlitsky; Alon,9999,0,9999,0
1668123730416,ECE 200,035,103620,Pal; Piya,9999,0,9999,0
1668123730416,ECE 200,036,103621,Papen; George C.,9999,0,9999,0
1668123730416,ECE 200,037,103622,Radic; Stojan,9999,0,9999,0
1668123730416,ECE 200,038,103623,Rao; Bhaskar D.,9999,0,9999,0
1668123730416,ECE 200,039,103624,Rao; Ramesh R,9999,0,9999,0
1668123730416,ECE 200,040,103625,Rebeiz; Gabriel,9999,0,9999,0
1668123730416,ECE 200,041,103626,Sanford; John R,9999,0,9999,0
1668123730416,ECE 200,042,103627,Siegel; Paul H.,9999,0,9999,0
1668123730416,ECE 200,043,103628,Sievenpiper; Daniel F.,9999,0,9999,0
1668123730416,ECE 200,044,103629,Sworder; David D.,9999,0,9999,0
1668123730416,ECE 200,045,103630,Taur; Yuan,9999,0,9999,0
1668123730416,ECE 200,046,103631,Touri; Behrouz,9999,0,9999,0
1668123730416,ECE 200,047,103632,Trivedi; Mohan M.,9999,0,9999,0
1668123730416,ECE 200,048,103633,Vasconcelos; Nuno,9999,0,9999,0
1668123730416,ECE 200,049,103634,Wang; Xiaolong,9999,0,9999,0
1668123730416,ECE 200,050,103635,Xie; Pengtao,9999,0,9999,0
1668123730416,ECE 200,051,103636,Yip; Michael,9999,0,9999,0
1668123730416,ECE 200,052,103637,Zeger; Kenneth A.,999,0,999,0
1668123730416,ECE 200,053,103638,Zhang; Xinyu,9999,0,9999,0
1668123730416,ECE 200,054,103639,Turakhia; Yatish Girish,9999,0,9999,0
1668123730416,ECE 200,055,103640,Kang; Mingu,9999,0,9999,0
1668123730416,ECE 200,056,103641,Shi; Yuanyuan,9999,0,9999,0
1668123730416,ECE 200,057,103642,Wang; Edward Jay,9999,0,9999,0
1668123730416,ECE 200,058,103643,Zheng; Yang,9999,0,9999,0
1668123730838,ECE 202,A00,103644,Kuzum; Duygu,0,0,0,0
1668123731269,ECE 212BN,A00,103646,Ng; Tse Nga,0,0,0,0
1668123731694,ECE 221,A00,111493,Staff,0,0,0,0
1668123732117,ECE 222B,A00,103647,Lomakin; Vitaliy,0,0,0,0
1668123732544,ECE 230B,A00,103648,Taur; Yuan,0,0,0,0
1668123732970,ECE 238B,A00,103649,Garay; Javier,0,0,0,0
1668123733399,ECE 240B,A00,112900,Fainman; Yeshaiahu,0,0,0,0
1668123733823,ECE 247A,A00,103650,Jokerst; Jesse Vincent,0,0,0,0
1668123734246,ECE 247B,A00,103651,Wang; Joseph,0,0,0,0
1668123734669,ECE 250,A00,103652,Siegel; Paul H.,0,0,0,0
1668123735094,ECE 251A,A00,103654,Rao; Bhaskar D.,0,0,0,0
1668123735520,ECE 257B,A00,103655,Bharadia; Dinesh,0,0,0,0
1668123735956,ECE 258A,A00,103656,Milstein; Laurence B.,0,0,0,0
1668123736386,ECE 260B,A00,103658,Kang; Mingu,0,0,0,0
1668123736819,ECE 264A,A00,103659,Galton; Ian A,0,0,0,0
1668123737247,ECE 265A,A00,103661,Gudem; Prasad S.S.,0,0,0,0
1668123737674,ECE 265D,A00,103662,Gudem; Prasad S.S.,0,0,0,0
1668123738098,ECE 268,A00,103663,Koushanfar; Farinaz,0,0,0,0
1668123738519,ECE 269,A01,103665,Pal; Piya,0,0,0,0
1668123738950,ECE 271B,A00,103666,Vasconcelos; Manuela,0,0,0,0
1668123739526,ECE 276A,A00,103667,Atanasov; Nikolay A.,0,0,0,0
1668123740054,ECE 277,A00,103668,An; Cheolhong,0,0,0,0
1668123740485,ECE 279,A00,117947,Hall; Drew A.,0,0,0,0
1668123741331,ECE 283,A00,103670,Hsueh; Tzu-Chien,0,0,0,0
1668123741764,ECE 284,A00,103671,Turakhia; Yatish Girish,0,0,0,0
1668123742201,ECE 285,A00,103672,Zheng; Yang,0,0,0,0
1668123742201,ECE 285,B00,103673,Sworder; David D.,0,0,0,0
1668123742642,ECE 287,A00,103676,Javidi; Tara,0,0,0,0
1668123743075,MATH 200B,A00,098023,Salehi Golsefidy; Alireza,12,0,15,3
1668123743503,MATH 202B,A00,098024,Rhoades; Brendon Patrick,9,0,15,6
1668123743936,MATH 203B,A00,098025,Oprea; Dragos N.,10,0,15,5
1668123744359,MATH 204B,A00,098026,Sorensen; Claus M,13,0,15,2
1668123744796,MATH 208,A00,098027,Izadi; Elham,7,0,10,3
1668123745242,MATH 209,A00,098028,Pollack; Aaron,10,0,10,0
1668123745665,MATH 211A,A00,112919,Rogalski; Daniel,9,0,10,1
1668123746092,MATH 211B,A00,112920,Seward; Brandon M.,9,0,10,1
1668123746524,MATH 218,A00,098029,Li; Bo,10,0,10,0
1668123746949,MATH 220B,A00,098030,Novak; Jonathan I,11,0,15,4
1668123747372,MATH 221A,A00,098031,Ebenfelt; Peter F,13,0,15,2
1668123747802,MATH 231B,A00,098032,Zlatos; Andrej,12,0,15,3
1668123748233,MATH 240B,A00,098033,Ni; Lei,9,0,15,6
1668123748666,MATH 243,A00,098034,Jekel; David Andrew,10,0,10,0
1668123749091,MATH 245A,A00,098035,Nie; Jiawang,0,0,15,16
1668123749514,MATH 248,A00,098036,Bejenaru; Ioan,10,0,10,0
1668123749936,MATH 250B,A00,098037,Spolaor; Luca,14,0,15,1
1668123750361,MATH 258,A00,098038,Ni; Lei,10,0,10,0
1668123750782,MATH 264B,A00,098041,Rhoades; Brendon Patrick,9,0,15,6
1668123751208,MATH 268,A00,098042,Buss; Samuel R,10,0,10,0
1668123751638,MATH 269,A00,098043,Rhoades; Brendon Patrick,10,0,10,0
1668123752065,MATH 270B,A00,098044,Li; Bo,10,0,15,5
1668123752487,MATH 272B,A00,098045,Holst; Michael J,13,0,15,2
1668123752910,MATH 273A,A00,098046,Tian; Xiaochuan,10,0,15,5
1668123753342,MATH 275,A01,098048,Tian; Xiaochuan,6,0,10,4
1668123753777,MATH 278A,A00,098049,Holst; Michael J,8,0,10,2
1668123754207,MATH 278B,A00,098050,Cloninger; Alexander,10,0,10,0
1668123754633,MATH 278C,A00,098051,Nie; Jiawang,7,0,10,3
1668123755062,MATH 280B,A00,098052,Zheng; Tianyi,10,0,15,5
1668123755485,MATH 281B,A00,098053,Bradic; Jelena,2,0,15,13
1668123755913,MATH 282B,A00,098054,Arias-Castro; Ery,0,0,15,15
1668123756336,MATH 285,A00,098055,Fitzsimmons; Patrick J,0,0,15,17
1668123756761,MATH 287B,A00,098056,Arias-Castro; Ery,3,0,15,12
1668123757194,MATH 288,A00,098057,Agarwal; Pooja,9,0,10,1
1668123757194,MATH 288,B00,098058,Zhang; Danna,8,0,10,2
1668123757194,MATH 288,C00,098059,Williams; Ruth J,10,0,10,0
1668123757658,MATH 290B,A00,098060,Roberts; Justin Deritter,13,0,15,2
1668123758090,MATH 292,A00,098061,Belmont; Eva Kinoshita,10,0,10,0
1668123758514,MATH 295,A00,098062,Suk; Andrew Hoon,48,0,50,2
1668123758944,MATH 296,A00,098063,Novak; Jonathan I,20,0,20,0
1668123759377,MATH 297,001,098064,Gamst; Anthony Collins,9997,0,9999,2
1668124263982,COGS 205,A00,101395,Chiba; Andrea,19,0,20,1
1668124264411,COGS 210B,001,101404,Greene; Deanna Jacquelyn,9998,0,9999,1
1668124264411,COGS 210B,002,101417,Xia; Haijun,9999,0,9999,0
1668124264411,COGS 210B,003,101422,Nitz; Douglas A.,9999,0,9999,0
1668124264411,COGS 210B,004,101423,Hollan; James D.,9998,0,9999,1
1668124264411,COGS 210B,005,101424,Deak; Gedeon O.,9998,0,9999,1
1668124264411,COGS 210B,006,101425,Rossano; Federico,9999,0,9999,0
1668124264912,COGS 211B,A00,101427,Coulson; Seana M,9996,0,9999,3
1668124265336,COGS 220,A00,101428,Hollan; James D.,0,0,25,25
1668124265769,COGS 229,A00,101429,Dow; Steven P,18,0,25,7
1668124266199,COGS 230,A00,101430,Klemmer; Scott R,12,0,17,5
1668124266631,COGS 234,A00,101431,Xia; Haijun,3,0,25,22
1668124267054,COGS 260,A00,101432,Kiyonaga; Anastasia,20,0,25,5
1668124267054,COGS 260,B00,101433,Kirsh; David Joel,16,0,25,9
1668124267478,CSE 202,A00,102371,Impagliazzo; Russell,0,0,0,0
1668124267899,CSE 203B,A01,102373,Cheng; Chung Kuan,0,0,0,0
1668124268334,CSE 208,A00,102374,Micciancio; Daniele,0,0,0,0
1668124268758,CSE 209A,A00,112895,Impagliazzo; Russell,0,0,15,15
1668124269181,CSE 209B,A00,108005,Bellare; Mihir,0,0,0,0
1668124269622,CSE 210,A00,113163,Coblenz; Michael J,0,0,0,0
1668124270072,CSE 219,A00,106111,Dow; Steven P,0,0,20,20
1668124270507,CSE 221,A00,102376,Voelker; Geoffrey M.,0,0,0,0
1668124270951,CSE 224,A01,102378,Porter; George M,0,0,0,0
1668124271375,CSE 229A,A00,102379,Savage; Stefan,0,0,0,0
1668124271809,CSE 229C,A00,102380,Munyaka; Imani N. S.,0,0,0,0
1668124272234,CSE 232B,A00,102382,Deutsch; Alin Bernard,0,0,0,0
1668124272661,CSE 234,A01,112904,Kumar; Arun Kumar,0,0,0,0
1668124273090,CSE 237A,A00,102383,Rosing; Tajana Simunic,0,0,0,0
1668124273518,CSE 239A,A00,102384,Deutsch; Alin Bernard,0,0,0,0
1668124273947,CSE 239B,A00,102385,Polikarpova; Nadezhda,0,0,0,0
1668124274372,CSE 240A,A00,102386,Pannuto; Patrick William,0,0,0,0
1668124274801,CSE 240B,A00,102387,Zhao; Jishen,0,0,0,0
1668124275225,CSE 241A,A00,106406,Kang; Mingu,0,0,0,0
1668124275648,CSE 249B,A00,102388,Kahng; Andrew Byun,0,0,8,8
1668124276079,CSE 251B,A01,102392,Cottrell; Garrison W,0,0,0,0
1668124276079,CSE 251B,A02,102393,Cottrell; Garrison W,0,0,0,0
1668124276504,CSE 252B,A00,102394,Ochoa; Benjamin Lawrence,0,0,0,0
1668124276935,CSE 257,A01,102396,Gao; Sicun,0,0,0,0
1668124277370,CSE 272,A00,102397,Li; Tzumao,0,0,0,0
1668124277810,CSE 274,A00,111323,Chern; Albert Ren-Haur,0,0,0,0
1668124278235,CSE 282,A00,102398,Pevzner; Pavel Arkadjevich,0,0,0,0
1668124278662,CSE 284,A00,114175,Gymrek; Melissa Ann,0,0,0,0
1668124279084,CSE 290,A00,102399,Chandraker; Manmohan Krishna,0,0,0,0
1668124279084,CSE 290,B00,102400,Vaccaro; Kristen Marie,0,0,25,25
1668124279084,CSE 290,C00,102414,Pannuto; Patrick William,0,0,25,25
1668124279084,CSE 290,D00,102427,Pevzner; Pavel Arkadjevich,0,0,0,0
1668124279084,CSE 290,E00,102429,Zhao; Jishen,0,0,0,0
1668124279084,CSE 290,F00,102436,Tullsen; Dean Michael,0,0,0,0
1668124279084,CSE 290,G00,102440,Christensen; Henrik I,0,0,20,20
1668124279514,CSE 291,A00,102443,Su; Hao,0,0,0,0
1668124279514,CSE 291,B00,102448,Polikarpova; Nadezhda,0,0,0,0
1668124279514,CSE 291,C00,102453,Vaccaro; Kristen Marie,0,0,0,0
1668124279514,CSE 291,D00,111343,Savage; Stefan,0,0,0,0
1668124279514,CSE 291,E00,116474,Claffy; Kimberly Claire,0,0,0,0
1668124279514,CSE 291,F00,116479,Pasquale; Joseph,0,0,0,0
1668124279947,CSE 293,001,119111,Bafna; Vineet,9999,0,9999,0
1668124279947,CSE 293,002,119118,Bellare; Mihir,9999,0,9999,0
1668124279947,CSE 293,003,119122,Berg-Kirkpatrick; Taylor D,9999,0,9999,0
1668124279947,CSE 293,004,119135,Christensen; Henrik I,9999,0,9999,0
1668124279947,CSE 293,005,119142,Cottrell; Garrison W,9999,0,9999,0
1668124279947,CSE 293,006,119146,Deutsch; Alin Bernard,9999,0,9999,0
1668124279947,CSE 293,007,119159,Esmaeilzadeh; Hadi,9999,0,9999,0
1668124279947,CSE 293,008,119166,Freund; Yoav,9999,0,9999,0
1668124279947,CSE 293,009,119170,Griswold; William G.,9999,0,9999,0
1668124279947,CSE 293,010,119183,Gymrek; Melissa Ann,9999,0,9999,0
1668124279947,CSE 293,011,119190,Heninger; Nadia A,9999,0,9999,0
1668124279947,CSE 293,012,119230,Impagliazzo; Russell,9999,0,9999,0
1668124279947,CSE 293,013,119232,Jhala; Ranjit,9999,0,9999,0
1668124279947,CSE 293,014,119233,Kahng; Andrew Byun,9999,0,9999,0
1668124279947,CSE 293,015,119298,Kane; Daniel Mertz,9999,0,9999,0
1668124279947,CSE 293,016,119299,Kriegman; David J,9999,0,9999,0
1668124279947,CSE 293,017,119300,Kumar; Arun Kumar,9999,0,9999,0
1668124279947,CSE 293,018,119301,Lerner; Sorin,9999,0,9999,0
1668124279947,CSE 293,019,119302,Lovett; Shachar,9999,0,9999,0
1668124279947,CSE 293,020,119303,McAuley; Julian John,9999,0,9999,0
1668124279947,CSE 293,021,119304,Micciancio; Daniele,9999,0,9999,0
1668124279947,CSE 293,022,119367,Orailoglu; Alex,9999,0,9999,0
1668124279947,CSE 293,023,119382,Paturi; Ramamohan,9999,0,9999,0
1668124279947,CSE 293,024,119404,Polikarpova; Nadezhda,9999,0,9999,0
1668124279947,CSE 293,025,119406,Politz; Joseph Gibbs,9999,0,9999,0
1668124279947,CSE 293,026,119411,Porter; George M,9999,0,9999,0
1668124279947,CSE 293,027,119414,Porter; Leonard Emerson,9999,0,9999,0
1668124279947,CSE 293,028,119416,Ramamoorthi; Ravi,9999,0,9999,0
1668124279947,CSE 293,029,119417,Sahoo; Debashis,9999,0,9999,0
1668124279947,CSE 293,030,119420,Saul; Lawrence,9999,0,9999,0
1668124279947,CSE 293,031,119421,Savage; Stefan,9999,0,9999,0
1668124279947,CSE 293,032,119425,Schulze; Jurgen P.,9999,0,9999,0
1668124279947,CSE 293,033,119426,Snoeren; Alex C.,9999,0,9999,0
1668124279947,CSE 293,034,119428,Shang; Jingbo,9999,0,9999,0
1668124279947,CSE 293,035,119430,Stefan; Deian,9999,0,9999,0
1668124279947,CSE 293,036,119431,Su; Hao,9999,0,9999,0
1668124279947,CSE 293,037,119433,Swanson; Steven James,9999,0,9999,0
1668124279947,CSE 293,038,119435,Tullsen; Dean Michael,9999,0,9999,0
1668124279947,CSE 293,039,119483,Voelker; Geoffrey M.,9999,0,9999,0
1668124279947,CSE 293,040,119537,Zhao; Jishen,9999,0,9999,0
1668124279947,CSE 293,041,119538,Zhou; Yuan-Yuan,9999,0,9999,0
1668124279947,CSE 293,042,119539,Gao; Sicun,9999,0,9999,0
1668124279947,CSE 293,043,119540,Weibel; Nadir,9999,0,9999,0
1668124279947,CSE 293,044,119541,Gupta; Rajesh K.,9999,0,9999,0
1668124279947,CSE 293,045,126410,Vaccaro; Kristen Marie,9999,0,9999,0
1668124279947,CSE 293,046,126411,Klemke; Richard,9999,0,9999,0
1668124280374,CSE 294,A00,102459,Voelker; Geoffrey M.,0,0,0,0
1668124280374,CSE 294,B00,111322,Orailoglu; Alex,0,0,0,0
1668124280809,DSE 201,A00,096914,Deutsch; Alin Bernard,30,0,30,0
1668124281247,DSE 210,A00,096915,Dasgupta; Sanjoy,30,0,30,0
1668124281669,DSE 260A,A00,096916,Altintas De Callaf; Ilkay,30,0,30,0
1668124282123,ECE 200,001,103586,Antipa; Nicholas A,9999,0,9999,0
1668124282123,ECE 200,002,103587,Atanasov; Nikolay A.,9999,0,9999,0
1668124282123,ECE 200,003,103588,Bharadia; Dinesh,9999,0,9999,0
1668124282123,ECE 200,004,103589,Cheng; Chung Kuan,9999,0,9999,0
1668124282123,ECE 200,005,103590,Cosman; Pamela C.,9999,0,9999,0
1668124282123,ECE 200,006,103591,Dayeh; Shadi Ahmad,9999,0,9999,0
1668124282123,ECE 200,007,103592,Fainman; Yeshaiahu,9999,0,9999,0
1668124282123,ECE 200,008,103593,Ford; Joseph Earl,9999,0,9999,0
1668124282123,ECE 200,009,103594,Franceschetti; Massimo,9999,0,9999,0
1668124282123,ECE 200,010,103595,Fullerton; Eric E,9999,0,9999,0
1668124282123,ECE 200,011,103596,Galton; Ian A,9999,0,9999,0
1668124282123,ECE 200,012,103597,Gilja; Vikash,9999,0,9999,0
1668124282123,ECE 200,013,103598,Hall; Drew A.,9999,0,9999,0
1668124282123,ECE 200,014,103599,Hsueh; Tzu-Chien,9999,0,9999,0
1668124282123,ECE 200,015,103600,Javidi; Tara,9999,0,9999,0
1668124282123,ECE 200,016,103601,Kahng; Andrew Byun,9999,0,9999,0
1668124282123,ECE 200,017,103602,Kim; Young-Han,9999,0,9999,0
1668124282123,ECE 200,018,103603,Koushanfar; Farinaz,9999,0,9999,0
1668124282123,ECE 200,019,103604,Kuzum; Duygu,9999,0,9999,0
1668124282123,ECE 200,020,103605,Le; Hanh-Phuc,9999,0,9999,0
1668124282123,ECE 200,021,103606,Lin; Bill,9999,0,9999,0
1668124282123,ECE 200,022,103607,Liu; Zhaowei,9998,0,9999,1
1668124282123,ECE 200,023,103608,Lo; Yu-Hwa,9999,0,9999,0
1668124282123,ECE 200,024,103609,Lomakin; Vitaliy,9999,0,9999,0
1668124282123,ECE 200,025,103610,Mercier; Patrick Philip,9999,0,9999,0
1668124282123,ECE 200,026,103611,Meyer; Florian,9999,0,9999,0
1668124282123,ECE 200,027,103612,Milstein; Laurence B.,9999,0,9999,0
1668124282123,ECE 200,028,103613,Mir Arabbaygi; Siavash,9999,0,9999,0
1668124282123,ECE 200,029,103614,Mookherjea; Shayan,9999,0,9999,0
1668124282123,ECE 200,030,103615,Morris; Karcher William,9999,0,9999,0
1668124282123,ECE 200,031,103616,Ng; Tse Nga,9999,0,9999,0
1668124282123,ECE 200,032,103617,Nguyen; Truong Quang,9999,0,9999,0
1668124282123,ECE 200,033,103618,Nomura; Kenji,9999,0,9999,0
1668124282123,ECE 200,034,103619,Orlitsky; Alon,9999,0,9999,0
1668124282123,ECE 200,035,103620,Pal; Piya,9999,0,9999,0
1668124282123,ECE 200,036,103621,Papen; George C.,9999,0,9999,0
1668124282123,ECE 200,037,103622,Radic; Stojan,9999,0,9999,0
1668124282123,ECE 200,038,103623,Rao; Bhaskar D.,9999,0,9999,0
1668124282123,ECE 200,039,103624,Rao; Ramesh R,9999,0,9999,0
1668124282123,ECE 200,040,103625,Rebeiz; Gabriel,9999,0,9999,0
1668124282123,ECE 200,041,103626,Sanford; John R,9999,0,9999,0
1668124282123,ECE 200,042,103627,Siegel; Paul H.,9999,0,9999,0
1668124282123,ECE 200,043,103628,Sievenpiper; Daniel F.,9999,0,9999,0
1668124282123,ECE 200,044,103629,Sworder; David D.,9999,0,9999,0
1668124282123,ECE 200,045,103630,Taur; Yuan,9999,0,9999,0
1668124282123,ECE 200,046,103631,Touri; Behrouz,9999,0,9999,0
1668124282123,ECE 200,047,103632,Trivedi; Mohan M.,9999,0,9999,0
1668124282123,ECE 200,048,103633,Vasconcelos; Nuno,9999,0,9999,0
1668124282123,ECE 200,049,103634,Wang; Xiaolong,9999,0,9999,0
1668124282123,ECE 200,050,103635,Xie; Pengtao,9999,0,9999,0
1668124282123,ECE 200,051,103636,Yip; Michael,9999,0,9999,0
1668124282123,ECE 200,052,103637,Zeger; Kenneth A.,999,0,999,0
1668124282123,ECE 200,053,103638,Zhang; Xinyu,9999,0,9999,0
1668124282123,ECE 200,054,103639,Turakhia; Yatish Girish,9999,0,9999,0
1668124282123,ECE 200,055,103640,Kang; Mingu,9999,0,9999,0
1668124282123,ECE 200,056,103641,Shi; Yuanyuan,9999,0,9999,0
1668124282123,ECE 200,057,103642,Wang; Edward Jay,9999,0,9999,0
1668124282123,ECE 200,058,103643,Zheng; Yang,9999,0,9999,0
1668124282544,ECE 202,A00,103644,Kuzum; Duygu,0,0,0,0
1668124282974,ECE 212BN,A00,103646,Ng; Tse Nga,0,0,0,0
1668124283503,ECE 221,A00,111493,Staff,0,0,0,0
1668124283947,ECE 222B,A00,103647,Lomakin; Vitaliy,0,0,0,0
1668124284374,ECE 230B,A00,103648,Taur; Yuan,0,0,0,0
1668124284798,ECE 238B,A00,103649,Garay; Javier,0,0,0,0
1668124285229,ECE 240B,A00,112900,Fainman; Yeshaiahu,0,0,0,0
1668124285655,ECE 247A,A00,103650,Jokerst; Jesse Vincent,0,0,0,0
1668124286076,ECE 247B,A00,103651,Wang; Joseph,0,0,0,0
1668124286502,ECE 250,A00,103652,Siegel; Paul H.,0,0,0,0
1668124286932,ECE 251A,A00,103654,Rao; Bhaskar D.,0,0,0,0
1668124287375,ECE 257B,A00,103655,Bharadia; Dinesh,0,0,0,0
1668124287808,ECE 258A,A00,103656,Milstein; Laurence B.,0,0,0,0
1668124288245,ECE 260B,A00,103658,Kang; Mingu,0,0,0,0
1668124288672,ECE 264A,A00,103659,Galton; Ian A,0,0,0,0
1668124289095,ECE 265A,A00,103661,Gudem; Prasad S.S.,0,0,0,0
1668124289519,ECE 265D,A00,103662,Gudem; Prasad S.S.,0,0,0,0
1668124289943,ECE 268,A00,103663,Koushanfar; Farinaz,0,0,0,0
1668124290374,ECE 269,A01,103665,Pal; Piya,0,0,0,0
1668124290799,ECE 271B,A00,103666,Vasconcelos; Manuela,0,0,0,0
1668124291228,ECE 276A,A00,103667,Atanasov; Nikolay A.,0,0,0,0
1668124291650,ECE 277,A00,103668,An; Cheolhong,0,0,0,0
1668124292076,ECE 279,A00,117947,Hall; Drew A.,0,0,0,0
1668124292927,ECE 283,A00,103670,Hsueh; Tzu-Chien,0,0,0,0
1668124293351,ECE 284,A00,103671,Turakhia; Yatish Girish,0,0,0,0
1668124293801,ECE 285,A00,103672,Zheng; Yang,0,0,0,0
1668124293801,ECE 285,B00,103673,Sworder; David D.,0,0,0,0
1668124294232,ECE 287,A00,103676,Javidi; Tara,0,0,0,0
1668124294658,MATH 200B,A00,098023,Salehi Golsefidy; Alireza,12,0,15,3
1668124295088,MATH 202B,A00,098024,Rhoades; Brendon Patrick,9,0,15,6
1668124295515,MATH 203B,A00,098025,Oprea; Dragos N.,10,0,15,5
1668124295938,MATH 204B,A00,098026,Sorensen; Claus M,13,0,15,2
1668124296370,MATH 208,A00,098027,Izadi; Elham,7,0,10,3
1668124296803,MATH 209,A00,098028,Pollack; Aaron,10,0,10,0
1668124297226,MATH 211A,A00,112919,Rogalski; Daniel,9,0,10,1
1668124297658,MATH 211B,A00,112920,Seward; Brandon M.,9,0,10,1
1668124298095,MATH 218,A00,098029,Li; Bo,10,0,10,0
1668124298527,MATH 220B,A00,098030,Novak; Jonathan I,11,0,15,4
1668124298955,MATH 221A,A00,098031,Ebenfelt; Peter F,13,0,15,2
1668124299385,MATH 231B,A00,098032,Zlatos; Andrej,12,0,15,3
1668124299820,MATH 240B,A00,098033,Ni; Lei,9,0,15,6
1668124300254,MATH 243,A00,098034,Jekel; David Andrew,10,0,10,0
1668124300676,MATH 245A,A00,098035,Nie; Jiawang,0,0,15,16
1668124301106,MATH 248,A00,098036,Bejenaru; Ioan,10,0,10,0
1668124301531,MATH 250B,A00,098037,Spolaor; Luca,14,0,15,1
1668124301954,MATH 258,A00,098038,Ni; Lei,10,0,10,0
1668124302379,MATH 264B,A00,098041,Rhoades; Brendon Patrick,9,0,15,6
1668124302813,MATH 268,A00,098042,Buss; Samuel R,10,0,10,0
1668124303244,MATH 269,A00,098043,Rhoades; Brendon Patrick,10,0,10,0
1668124303672,MATH 270B,A00,098044,Li; Bo,10,0,15,5
1668124304101,MATH 272B,A00,098045,Holst; Michael J,13,0,15,2
1668124304530,MATH 273A,A00,098046,Tian; Xiaochuan,10,0,15,5
1668124304973,MATH 275,A01,098048,Tian; Xiaochuan,6,0,10,4
1668124305396,MATH 278A,A00,098049,Holst; Michael J,8,0,10,2
1668124305824,MATH 278B,A00,098050,Cloninger; Alexander,10,0,10,0
1668124306250,MATH 278C,A00,098051,Nie; Jiawang,7,0,10,3
1668124306682,MATH 280B,A00,098052,Zheng; Tianyi,10,0,15,5
1668124307107,MATH 281B,A00,098053,Bradic; Jelena,2,0,15,13
1668124307537,MATH 282B,A00,098054,Arias-Castro; Ery,0,0,15,15
1668124307979,MATH 285,A00,098055,Fitzsimmons; Patrick J,0,0,15,17
1668124308534,MATH 287B,A00,098056,Arias-Castro; Ery,3,0,15,12
1668124308957,MATH 288,A00,098057,Agarwal; Pooja,9,0,10,1
1668124308957,MATH 288,B00,098058,Zhang; Danna,8,0,10,2
1668124308957,MATH 288,C00,098059,Williams; Ruth J,10,0,10,0
1668124309391,MATH 290B,A00,098060,Roberts; Justin Deritter,13,0,15,2
1668124309829,MATH 292,A00,098061,Belmont; Eva Kinoshita,10,0,10,0
1668124310253,MATH 295,A00,098062,Suk; Andrew Hoon,48,0,50,2
1668124310677,MATH 296,A00,098063,Novak; Jonathan I,20,0,20,0
1668124311101,MATH 297,001,098064,Gamst; Anthony Collins,9997,0,9999,2
1668124816342,COGS 205,A00,101395,Chiba; Andrea,19,0,20,1
1668124816793,COGS 210B,001,101404,Greene; Deanna Jacquelyn,9998,0,9999,1
1668124816793,COGS 210B,002,101417,Xia; Haijun,9999,0,9999,0
1668124816793,COGS 210B,003,101422,Nitz; Douglas A.,9999,0,9999,0
1668124816793,COGS 210B,004,101423,Hollan; James D.,9998,0,9999,1
1668124816793,COGS 210B,005,101424,Deak; Gedeon O.,9998,0,9999,1
1668124816793,COGS 210B,006,101425,Rossano; Federico,9999,0,9999,0
1668124817226,COGS 211B,A00,101427,Coulson; Seana M,9996,0,9999,3
1668124817659,COGS 220,A00,101428,Hollan; James D.,0,0,25,25
1668124818093,COGS 229,A00,101429,Dow; Steven P,18,0,25,7
1668124818527,COGS 230,A00,101430,Klemmer; Scott R,12,0,17,5
1668124819047,COGS 234,A00,101431,Xia; Haijun,3,0,25,22
1668124819494,COGS 260,A00,101432,Kiyonaga; Anastasia,20,0,25,5
1668124819494,COGS 260,B00,101433,Kirsh; David Joel,16,0,25,9
1668124819932,CSE 202,A00,102371,Impagliazzo; Russell,0,0,0,0
1668124820368,CSE 203B,A01,102373,Cheng; Chung Kuan,0,0,0,0
1668124820798,CSE 208,A00,102374,Micciancio; Daniele,0,0,0,0
1668124821240,CSE 209A,A00,112895,Impagliazzo; Russell,0,0,15,15
1668124821665,CSE 209B,A00,108005,Bellare; Mihir,0,0,0,0
1668124822097,CSE 210,A00,113163,Coblenz; Michael J,0,0,0,0
1668124822529,CSE 219,A00,106111,Dow; Steven P,0,0,20,20
1668124822964,CSE 221,A00,102376,Voelker; Geoffrey M.,0,0,0,0
1668124823394,CSE 224,A01,102378,Porter; George M,0,0,0,0
1668124823832,CSE 229A,A00,102379,Savage; Stefan,0,0,0,0
1668124824266,CSE 229C,A00,102380,Munyaka; Imani N. S.,0,0,0,0
1668124824693,CSE 232B,A00,102382,Deutsch; Alin Bernard,0,0,0,0
1668124825115,CSE 234,A01,112904,Kumar; Arun Kumar,0,0,0,0
1668124825542,CSE 237A,A00,102383,Rosing; Tajana Simunic,0,0,0,0
1668124825969,CSE 239A,A00,102384,Deutsch; Alin Bernard,0,0,0,0
1668124826394,CSE 239B,A00,102385,Polikarpova; Nadezhda,0,0,0,0
1668124826843,CSE 240A,A00,102386,Pannuto; Patrick William,0,0,0,0
1668124827269,CSE 240B,A00,102387,Zhao; Jishen,0,0,0,0
1668124827694,CSE 241A,A00,106406,Kang; Mingu,0,0,0,0
1668124828121,CSE 249B,A00,102388,Kahng; Andrew Byun,0,0,8,8
1668124828548,CSE 251B,A01,102392,Cottrell; Garrison W,0,0,0,0
1668124828548,CSE 251B,A02,102393,Cottrell; Garrison W,0,0,0,0
1668124828976,CSE 252B,A00,102394,Ochoa; Benjamin Lawrence,0,0,0,0
1668124829408,CSE 257,A01,102396,Gao; Sicun,0,0,0,0
1668124829863,CSE 272,A00,102397,Li; Tzumao,0,0,0,0
1668124830289,CSE 274,A00,111323,Chern; Albert Ren-Haur,0,0,0,0
1668124830716,CSE 282,A00,102398,Pevzner; Pavel Arkadjevich,0,0,0,0
1668124831147,CSE 284,A00,114175,Gymrek; Melissa Ann,0,0,0,0
1668124831570,CSE 290,A00,102399,Chandraker; Manmohan Krishna,0,0,0,0
1668124831570,CSE 290,B00,102400,Vaccaro; Kristen Marie,0,0,25,25
1668124831570,CSE 290,C00,102414,Pannuto; Patrick William,0,0,25,25
1668124831570,CSE 290,D00,102427,Pevzner; Pavel Arkadjevich,0,0,0,0
1668124831570,CSE 290,E00,102429,Zhao; Jishen,0,0,0,0
1668124831570,CSE 290,F00,102436,Tullsen; Dean Michael,0,0,0,0
1668124831570,CSE 290,G00,102440,Christensen; Henrik I,0,0,20,20
1668124831994,CSE 291,A00,102443,Su; Hao,0,0,0,0
1668124831994,CSE 291,B00,102448,Polikarpova; Nadezhda,0,0,0,0
1668124831994,CSE 291,C00,102453,Vaccaro; Kristen Marie,0,0,0,0
1668124831994,CSE 291,D00,111343,Savage; Stefan,0,0,0,0
1668124831994,CSE 291,E00,116474,Claffy; Kimberly Claire,0,0,0,0
1668124831994,CSE 291,F00,116479,Pasquale; Joseph,0,0,0,0
1668124832422,CSE 293,001,119111,Bafna; Vineet,9999,0,9999,0
1668124832422,CSE 293,002,119118,Bellare; Mihir,9999,0,9999,0
1668124832422,CSE 293,003,119122,Berg-Kirkpatrick; Taylor D,9999,0,9999,0
1668124832422,CSE 293,004,119135,Christensen; Henrik I,9999,0,9999,0
1668124832422,CSE 293,005,119142,Cottrell; Garrison W,9999,0,9999,0
1668124832422,CSE 293,006,119146,Deutsch; Alin Bernard,9999,0,9999,0
1668124832422,CSE 293,007,119159,Esmaeilzadeh; Hadi,9999,0,9999,0
1668124832422,CSE 293,008,119166,Freund; Yoav,9999,0,9999,0
1668124832422,CSE 293,009,119170,Griswold; William G.,9999,0,9999,0
1668124832422,CSE 293,010,119183,Gymrek; Melissa Ann,9999,0,9999,0
1668124832422,CSE 293,011,119190,Heninger; Nadia A,9999,0,9999,0
1668124832422,CSE 293,012,119230,Impagliazzo; Russell,9999,0,9999,0
1668124832422,CSE 293,013,119232,Jhala; Ranjit,9999,0,9999,0
1668124832422,CSE 293,014,119233,Kahng; Andrew Byun,9999,0,9999,0
1668124832422,CSE 293,015,119298,Kane; Daniel Mertz,9999,0,9999,0
1668124832422,CSE 293,016,119299,Kriegman; David J,9999,0,9999,0
1668124832422,CSE 293,017,119300,Kumar; Arun Kumar,9999,0,9999,0
1668124832422,CSE 293,018,119301,Lerner; Sorin,9999,0,9999,0
1668124832422,CSE 293,019,119302,Lovett; Shachar,9999,0,9999,0
1668124832422,CSE 293,020,119303,McAuley; Julian John,9999,0,9999,0
1668124832422,CSE 293,021,119304,Micciancio; Daniele,9999,0,9999,0
1668124832422,CSE 293,022,119367,Orailoglu; Alex,9999,0,9999,0
1668124832422,CSE 293,023,119382,Paturi; Ramamohan,9999,0,9999,0
1668124832422,CSE 293,024,119404,Polikarpova; Nadezhda,9999,0,9999,0
1668124832422,CSE 293,025,119406,Politz; Joseph Gibbs,9999,0,9999,0
1668124832422,CSE 293,026,119411,Porter; George M,9999,0,9999,0
1668124832422,CSE 293,027,119414,Porter; Leonard Emerson,9999,0,9999,0
1668124832422,CSE 293,028,119416,Ramamoorthi; Ravi,9999,0,9999,0
1668124832422,CSE 293,029,119417,Sahoo; Debashis,9999,0,9999,0
1668124832422,CSE 293,030,119420,Saul; Lawrence,9999,0,9999,0
1668124832422,CSE 293,031,119421,Savage; Stefan,9999,0,9999,0
1668124832422,CSE 293,032,119425,Schulze; Jurgen P.,9999,0,9999,0
1668124832422,CSE 293,033,119426,Snoeren; Alex C.,9999,0,9999,0
1668124832422,CSE 293,034,119428,Shang; Jingbo,9999,0,9999,0
1668124832422,CSE 293,035,119430,Stefan; Deian,9999,0,9999,0
1668124832422,CSE 293,036,119431,Su; Hao,9999,0,9999,0
1668124832422,CSE 293,037,119433,Swanson; Steven James,9999,0,9999,0
1668124832422,CSE 293,038,119435,Tullsen; Dean Michael,9999,0,9999,0
1668124832422,CSE 293,039,119483,Voelker; Geoffrey M.,9999,0,9999,0
1668124832422,CSE 293,040,119537,Zhao; Jishen,9999,0,9999,0
1668124832422,CSE 293,041,119538,Zhou; Yuan-Yuan,9999,0,9999,0
1668124832422,CSE 293,042,119539,Gao; Sicun,9999,0,9999,0
1668124832422,CSE 293,043,119540,Weibel; Nadir,9999,0,9999,0
1668124832422,CSE 293,044,119541,Gupta; Rajesh K.,9999,0,9999,0
1668124832422,CSE 293,045,126410,Vaccaro; Kristen Marie,9999,0,9999,0
1668124832422,CSE 293,046,126411,Klemke; Richard,9999,0,9999,0
1668124832859,CSE 294,A00,102459,Voelker; Geoffrey M.,0,0,0,0
1668124832859,CSE 294,B00,111322,Orailoglu; Alex,0,0,0,0
1668124833296,DSE 201,A00,096914,Deutsch; Alin Bernard,30,0,30,0
1668124833726,DSE 210,A00,096915,Dasgupta; Sanjoy,30,0,30,0
1668124834236,DSE 260A,A00,096916,Altintas De Callaf; Ilkay,30,0,30,0
1668124834682,ECE 200,001,103586,Antipa; Nicholas A,9999,0,9999,0
1668124834682,ECE 200,002,103587,Atanasov; Nikolay A.,9999,0,9999,0
1668124834682,ECE 200,003,103588,Bharadia; Dinesh,9999,0,9999,0
1668124834682,ECE 200,004,103589,Cheng; Chung Kuan,9999,0,9999,0
1668124834682,ECE 200,005,103590,Cosman; Pamela C.,9999,0,9999,0
1668124834682,ECE 200,006,103591,Dayeh; Shadi Ahmad,9999,0,9999,0
1668124834682,ECE 200,007,103592,Fainman; Yeshaiahu,9999,0,9999,0
1668124834682,ECE 200,008,103593,Ford; Joseph Earl,9999,0,9999,0
1668124834682,ECE 200,009,103594,Franceschetti; Massimo,9999,0,9999,0
1668124834682,ECE 200,010,103595,Fullerton; Eric E,9999,0,9999,0
1668124834682,ECE 200,011,103596,Galton; Ian A,9999,0,9999,0
1668124834682,ECE 200,012,103597,Gilja; Vikash,9999,0,9999,0
1668124834682,ECE 200,013,103598,Hall; Drew A.,9999,0,9999,0
1668124834682,ECE 200,014,103599,Hsueh; Tzu-Chien,9999,0,9999,0
1668124834682,ECE 200,015,103600,Javidi; Tara,9999,0,9999,0
1668124834682,ECE 200,016,103601,Kahng; Andrew Byun,9999,0,9999,0
1668124834682,ECE 200,017,103602,Kim; Young-Han,9999,0,9999,0
1668124834682,ECE 200,018,103603,Koushanfar; Farinaz,9999,0,9999,0
1668124834682,ECE 200,019,103604,Kuzum; Duygu,9999,0,9999,0
1668124834682,ECE 200,020,103605,Le; Hanh-Phuc,9999,0,9999,0
1668124834682,ECE 200,021,103606,Lin; Bill,9999,0,9999,0
1668124834682,ECE 200,022,103607,Liu; Zhaowei,9998,0,9999,1
1668124834682,ECE 200,023,103608,Lo; Yu-Hwa,9999,0,9999,0
1668124834682,ECE 200,024,103609,Lomakin; Vitaliy,9999,0,9999,0
1668124834682,ECE 200,025,103610,Mercier; Patrick Philip,9999,0,9999,0
1668124834682,ECE 200,026,103611,Meyer; Florian,9999,0,9999,0
1668124834682,ECE 200,027,103612,Milstein; Laurence B.,9999,0,9999,0
1668124834682,ECE 200,028,103613,Mir Arabbaygi; Siavash,9999,0,9999,0
1668124834682,ECE 200,029,103614,Mookherjea; Shayan,9999,0,9999,0
1668124834682,ECE 200,030,103615,Morris; Karcher William,9999,0,9999,0
1668124834682,ECE 200,031,103616,Ng; Tse Nga,9999,0,9999,0
1668124834682,ECE 200,032,103617,Nguyen; Truong Quang,9999,0,9999,0
1668124834682,ECE 200,033,103618,Nomura; Kenji,9999,0,9999,0
1668124834682,ECE 200,034,103619,Orlitsky; Alon,9999,0,9999,0
1668124834682,ECE 200,035,103620,Pal; Piya,9999,0,9999,0
1668124834682,ECE 200,036,103621,Papen; George C.,9999,0,9999,0
1668124834682,ECE 200,037,103622,Radic; Stojan,9999,0,9999,0
1668124834682,ECE 200,038,103623,Rao; Bhaskar D.,9999,0,9999,0
1668124834682,ECE 200,039,103624,Rao; Ramesh R,9999,0,9999,0
1668124834682,ECE 200,040,103625,Rebeiz; Gabriel,9999,0,9999,0
1668124834682,ECE 200,041,103626,Sanford; John R,9999,0,9999,0
1668124834682,ECE 200,042,103627,Siegel; Paul H.,9999,0,9999,0
1668124834682,ECE 200,043,103628,Sievenpiper; Daniel F.,9999,0,9999,0
1668124834682,ECE 200,044,103629,Sworder; David D.,9999,0,9999,0
1668124834682,ECE 200,045,103630,Taur; Yuan,9999,0,9999,0
1668124834682,ECE 200,046,103631,Touri; Behrouz,9999,0,9999,0
1668124834682,ECE 200,047,103632,Trivedi; Mohan M.,9999,0,9999,0
1668124834682,ECE 200,048,103633,Vasconcelos; Nuno,9999,0,9999,0
1668124834682,ECE 200,049,103634,Wang; Xiaolong,9999,0,9999,0
1668124834682,ECE 200,050,103635,Xie; Pengtao,9999,0,9999,0
1668124834682,ECE 200,051,103636,Yip; Michael,9999,0,9999,0
1668124834682,ECE 200,052,103637,Zeger; Kenneth A.,999,0,999,0
1668124834682,ECE 200,053,103638,Zhang; Xinyu,9999,0,9999,0
1668124834682,ECE 200,054,103639,Turakhia; Yatish Girish,9999,0,9999,0
1668124834682,ECE 200,055,103640,Kang; Mingu,9999,0,9999,0
1668124834682,ECE 200,056,103641,Shi; Yuanyuan,9999,0,9999,0
1668124834682,ECE 200,057,103642,Wang; Edward Jay,9999,0,9999,0
1668124834682,ECE 200,058,103643,Zheng; Yang,9999,0,9999,0
1668124835105,ECE 202,A00,103644,Kuzum; Duygu,0,0,0,0
1668124835572,ECE 212BN,A00,103646,Ng; Tse Nga,0,0,0,0
1668124835994,ECE 221,A00,111493,Staff,0,0,0,0
1668124836422,ECE 222B,A00,103647,Lomakin; Vitaliy,0,0,0,0
1668124836854,ECE 230B,A00,103648,Taur; Yuan,0,0,0,0
1668124837282,ECE 238B,A00,103649,Garay; Javier,0,0,0,0
1668124837711,ECE 240B,A00,112900,Fainman; Yeshaiahu,0,0,0,0
1668124838133,ECE 247A,A00,103650,Jokerst; Jesse Vincent,0,0,0,0
1668124838559,ECE 247B,A00,103651,Wang; Joseph,0,0,0,0
1668124838986,ECE 250,A00,103652,Siegel; Paul H.,0,0,0,0
1668124839409,ECE 251A,A00,103654,Rao; Bhaskar D.,0,0,0,0
1668124839830,ECE 257B,A00,103655,Bharadia; Dinesh,0,0,0,0
1668124840261,ECE 258A,A00,103656,Milstein; Laurence B.,0,0,0,0
1668124840688,ECE 260B,A00,103658,Kang; Mingu,0,0,0,0
1668124841116,ECE 264A,A00,103659,Galton; Ian A,0,0,0,0
1668124841547,ECE 265A,A00,103661,Gudem; Prasad S.S.,0,0,0,0
1668124841978,ECE 265D,A00,103662,Gudem; Prasad S.S.,0,0,0,0
1668124842412,ECE 268,A00,103663,Koushanfar; Farinaz,0,0,0,0
1668124842835,ECE 269,A01,103665,Pal; Piya,0,0,0,0
1668124843274,ECE 271B,A00,103666,Vasconcelos; Manuela,0,0,0,0
1668124843698,ECE 276A,A00,103667,Atanasov; Nikolay A.,0,0,0,0
1668124844138,ECE 277,A00,103668,An; Cheolhong,0,0,0,0
1668124844568,ECE 279,A00,117947,Hall; Drew A.,0,0,0,0
1668124845422,ECE 283,A00,103670,Hsueh; Tzu-Chien,0,0,0,0
1668124845849,ECE 284,A00,103671,Turakhia; Yatish Girish,0,0,0,0
1668124846276,ECE 285,A00,103672,Zheng; Yang,0,0,0,0
1668124846276,ECE 285,B00,103673,Sworder; David D.,0,0,0,0
1668124846701,ECE 287,A00,103676,Javidi; Tara,0,0,0,0
1668124847130,MATH 200B,A00,098023,Salehi Golsefidy; Alireza,12,0,15,3
1668124847554,MATH 202B,A00,098024,Rhoades; Brendon Patrick,9,0,15,6
1668124847978,MATH 203B,A00,098025,Oprea; Dragos N.,10,0,15,5
1668124848405,MATH 204B,A00,098026,Sorensen; Claus M,13,0,15,2
1668124848827,MATH 208,A00,098027,Izadi; Elham,7,0,10,3
1668124849251,MATH 209,A00,098028,Pollack; Aaron,10,0,10,0
1668124849676,MATH 211A,A00,112919,Rogalski; Daniel,9,0,10,1
1668124850109,MATH 211B,A00,112920,Seward; Brandon M.,9,0,10,1
1668124850532,MATH 218,A00,098029,Li; Bo,10,0,10,0
1668124850959,MATH 220B,A00,098030,Novak; Jonathan I,11,0,15,4
1668124851388,MATH 221A,A00,098031,Ebenfelt; Peter F,13,0,15,2
1668124851818,MATH 231B,A00,098032,Zlatos; Andrej,12,0,15,3
1668124852251,MATH 240B,A00,098033,Ni; Lei,9,0,15,6
1668124852674,MATH 243,A00,098034,Jekel; David Andrew,10,0,10,0
1668124853111,MATH 245A,A00,098035,Nie; Jiawang,0,0,15,16
1668124853534,MATH 248,A00,098036,Bejenaru; Ioan,10,0,10,0
1668124853959,MATH 250B,A00,098037,Spolaor; Luca,14,0,15,1
1668124854381,MATH 258,A00,098038,Ni; Lei,10,0,10,0
1668124854816,MATH 264B,A00,098041,Rhoades; Brendon Patrick,9,0,15,6
1668124855255,MATH 268,A00,098042,Buss; Samuel R,10,0,10,0
1668124855688,MATH 269,A00,098043,Rhoades; Brendon Patrick,10,0,10,0
1668124856113,MATH 270B,A00,098044,Li; Bo,10,0,15,5
1668124856536,MATH 272B,A00,098045,Holst; Michael J,13,0,15,2
1668124856971,MATH 273A,A00,098046,Tian; Xiaochuan,10,0,15,5
1668124857403,MATH 275,A01,098048,Tian; Xiaochuan,6,0,10,4
1668124857827,MATH 278A,A00,098049,Holst; Michael J,8,0,10,2
1668124858252,MATH 278B,A00,098050,Cloninger; Alexander,10,0,10,0
1668124858687,MATH 278C,A00,098051,Nie; Jiawang,7,0,10,3
1668124859113,MATH 280B,A00,098052,Zheng; Tianyi,10,0,15,5
1668124859538,MATH 281B,A00,098053,Bradic; Jelena,2,0,15,13
1668124859962,MATH 282B,A00,098054,Arias-Castro; Ery,0,0,15,15
1668124860396,MATH 285,A00,098055,Fitzsimmons; Patrick J,0,0,15,17
1668124860827,MATH 287B,A00,098056,Arias-Castro; Ery,3,0,15,12
1668124861267,MATH 288,A00,098057,Agarwal; Pooja,9,0,10,1
1668124861267,MATH 288,B00,098058,Zhang; Danna,8,0,10,2
1668124861267,MATH 288,C00,098059,Williams; Ruth J,10,0,10,0
1668124861775,MATH 290B,A00,098060,Roberts; Justin Deritter,13,0,15,2
1668124862204,MATH 292,A00,098061,Belmont; Eva Kinoshita,10,0,10,0
1668124862638,MATH 295,A00,098062,Suk; Andrew Hoon,48,0,50,2
1668124863067,MATH 296,A00,098063,Novak; Jonathan I,20,0,20,0
1668124863490,MATH 297,001,098064,Gamst; Anthony Collins,9997,0,9999,2
1668125367332,COGS 205,A00,101395,Chiba; Andrea,19,0,20,1
1668125367755,COGS 210B,001,101404,Greene; Deanna Jacquelyn,9998,0,9999,1
1668125367755,COGS 210B,002,101417,Xia; Haijun,9999,0,9999,0
1668125367755,COGS 210B,003,101422,Nitz; Douglas A.,9999,0,9999,0
1668125367755,COGS 210B,004,101423,Hollan; James D.,9998,0,9999,1
1668125367755,COGS 210B,005,101424,Deak; Gedeon O.,9998,0,9999,1
1668125367755,COGS 210B,006,101425,Rossano; Federico,9999,0,9999,0
1668125368180,COGS 211B,A00,101427,Coulson; Seana M,9996,0,9999,3
1668125368602,COGS 220,A00,101428,Hollan; James D.,0,0,25,25
1668125369040,COGS 229,A00,101429,Dow; Steven P,18,0,25,7
1668125369465,COGS 230,A00,101430,Klemmer; Scott R,12,0,17,5
1668125369887,COGS 234,A00,101431,Xia; Haijun,3,0,25,22
1668125370315,COGS 260,A00,101432,Kiyonaga; Anastasia,20,0,25,5
1668125370315,COGS 260,B00,101433,Kirsh; David Joel,16,0,25,9
1668125370741,CSE 202,A00,102371,Impagliazzo; Russell,0,0,0,0
1668125371170,CSE 203B,A01,102373,Cheng; Chung Kuan,0,0,0,0
1668125371593,CSE 208,A00,102374,Micciancio; Daniele,0,0,0,0
1668125372021,CSE 209A,A00,112895,Impagliazzo; Russell,0,0,15,15
1668125372447,CSE 209B,A00,108005,Bellare; Mihir,0,0,0,0
1668125372883,CSE 210,A00,113163,Coblenz; Michael J,0,0,0,0
1668125373310,CSE 219,A00,106111,Dow; Steven P,0,0,20,20
1668125373734,CSE 221,A00,102376,Voelker; Geoffrey M.,0,0,0,0
1668125374167,CSE 224,A01,102378,Porter; George M,0,0,0,0
1668125374592,CSE 229A,A00,102379,Savage; Stefan,0,0,0,0
1668125375028,CSE 229C,A00,102380,Munyaka; Imani N. S.,0,0,0,0
1668125375453,CSE 232B,A00,102382,Deutsch; Alin Bernard,0,0,0,0
1668125375888,CSE 234,A01,112904,Kumar; Arun Kumar,0,0,0,0
1668125376319,CSE 237A,A00,102383,Rosing; Tajana Simunic,0,0,0,0
1668125376742,CSE 239A,A00,102384,Deutsch; Alin Bernard,0,0,0,0
1668125377179,CSE 239B,A00,102385,Polikarpova; Nadezhda,0,0,0,0
1668125377603,CSE 240A,A00,102386,Pannuto; Patrick William,0,0,0,0
1668125378032,CSE 240B,A00,102387,Zhao; Jishen,0,0,0,0
1668125378459,CSE 241A,A00,106406,Kang; Mingu,0,0,0,0
1668125378883,CSE 249B,A00,102388,Kahng; Andrew Byun,0,0,8,8
1668125379319,CSE 251B,A01,102392,Cottrell; Garrison W,0,0,0,0
1668125379319,CSE 251B,A02,102393,Cottrell; Garrison W,0,0,0,0
1668125379756,CSE 252B,A00,102394,Ochoa; Benjamin Lawrence,0,0,0,0
1668125380186,CSE 257,A01,102396,Gao; Sicun,0,0,0,0
1668125380625,CSE 272,A00,102397,Li; Tzumao,0,0,0,0
1668125381055,CSE 274,A00,111323,Chern; Albert Ren-Haur,0,0,0,0
1668125381478,CSE 282,A00,102398,Pevzner; Pavel Arkadjevich,0,0,0,0
1668125381903,CSE 284,A00,114175,Gymrek; Melissa Ann,0,0,0,0
1668125382331,CSE 290,A00,102399,Chandraker; Manmohan Krishna,0,0,0,0
1668125382331,CSE 290,B00,102400,Vaccaro; Kristen Marie,0,0,25,25
1668125382331,CSE 290,C00,102414,Pannuto; Patrick William,0,0,25,25
1668125382331,CSE 290,D00,102427,Pevzner; Pavel Arkadjevich,0,0,0,0
1668125382331,CSE 290,E00,102429,Zhao; Jishen,0,0,0,0
1668125382331,CSE 290,F00,102436,Tullsen; Dean Michael,0,0,0,0
1668125382331,CSE 290,G00,102440,Christensen; Henrik I,0,0,20,20
1668125382765,CSE 291,A00,102443,Su; Hao,0,0,0,0
1668125382765,CSE 291,B00,102448,Polikarpova; Nadezhda,0,0,0,0
1668125382765,CSE 291,C00,102453,Vaccaro; Kristen Marie,0,0,0,0
1668125382765,CSE 291,D00,111343,Savage; Stefan,0,0,0,0
1668125382765,CSE 291,E00,116474,Claffy; Kimberly Claire,0,0,0,0
1668125382765,CSE 291,F00,116479,Pasquale; Joseph,0,0,0,0
1668125383196,CSE 293,001,119111,Bafna; Vineet,9999,0,9999,0
1668125383196,CSE 293,002,119118,Bellare; Mihir,9999,0,9999,0
1668125383196,CSE 293,003,119122,Berg-Kirkpatrick; Taylor D,9999,0,9999,0
1668125383196,CSE 293,004,119135,Christensen; Henrik I,9999,0,9999,0
1668125383196,CSE 293,005,119142,Cottrell; Garrison W,9999,0,9999,0
1668125383196,CSE 293,006,119146,Deutsch; Alin Bernard,9999,0,9999,0
1668125383196,CSE 293,007,119159,Esmaeilzadeh; Hadi,9999,0,9999,0
1668125383196,CSE 293,008,119166,Freund; Yoav,9999,0,9999,0
1668125383196,CSE 293,009,119170,Griswold; William G.,9999,0,9999,0
1668125383196,CSE 293,010,119183,Gymrek; Melissa Ann,9999,0,9999,0
1668125383196,CSE 293,011,119190,Heninger; Nadia A,9999,0,9999,0
1668125383196,CSE 293,012,119230,Impagliazzo; Russell,9999,0,9999,0
1668125383196,CSE 293,013,119232,Jhala; Ranjit,9999,0,9999,0
1668125383196,CSE 293,014,119233,Kahng; Andrew Byun,9999,0,9999,0
1668125383196,CSE 293,015,119298,Kane; Daniel Mertz,9999,0,9999,0
1668125383196,CSE 293,016,119299,Kriegman; David J,9999,0,9999,0
1668125383196,CSE 293,017,119300,Kumar; Arun Kumar,9999,0,9999,0
1668125383196,CSE 293,018,119301,Lerner; Sorin,9999,0,9999,0
1668125383196,CSE 293,019,119302,Lovett; Shachar,9999,0,9999,0
1668125383196,CSE 293,020,119303,McAuley; Julian John,9999,0,9999,0
1668125383196,CSE 293,021,119304,Micciancio; Daniele,9999,0,9999,0
1668125383196,CSE 293,022,119367,Orailoglu; Alex,9999,0,9999,0
1668125383196,CSE 293,023,119382,Paturi; Ramamohan,9999,0,9999,0
1668125383196,CSE 293,024,119404,Polikarpova; Nadezhda,9999,0,9999,0
1668125383196,CSE 293,025,119406,Politz; Joseph Gibbs,9999,0,9999,0
1668125383196,CSE 293,026,119411,Porter; George M,9999,0,9999,0
1668125383196,CSE 293,027,119414,Porter; Leonard Emerson,9999,0,9999,0
1668125383196,CSE 293,028,119416,Ramamoorthi; Ravi,9999,0,9999,0
1668125383196,CSE 293,029,119417,Sahoo; Debashis,9999,0,9999,0
1668125383196,CSE 293,030,119420,Saul; Lawrence,9999,0,9999,0
1668125383196,CSE 293,031,119421,Savage; Stefan,9999,0,9999,0
1668125383196,CSE 293,032,119425,Schulze; Jurgen P.,9999,0,9999,0
1668125383196,CSE 293,033,119426,Snoeren; Alex C.,9999,0,9999,0
1668125383196,CSE 293,034,119428,Shang; Jingbo,9999,0,9999,0
1668125383196,CSE 293,035,119430,Stefan; Deian,9999,0,9999,0
1668125383196,CSE 293,036,119431,Su; Hao,9999,0,9999,0
1668125383196,CSE 293,037,119433,Swanson; Steven James,9999,0,9999,0
1668125383196,CSE 293,038,119435,Tullsen; Dean Michael,9999,0,9999,0
1668125383196,CSE 293,039,119483,Voelker; Geoffrey M.,9999,0,9999,0
1668125383196,CSE 293,040,119537,Zhao; Jishen,9999,0,9999,0
1668125383196,CSE 293,041,119538,Zhou; Yuan-Yuan,9999,0,9999,0
1668125383196,CSE 293,042,119539,Gao; Sicun,9999,0,9999,0
1668125383196,CSE 293,043,119540,Weibel; Nadir,9999,0,9999,0
1668125383196,CSE 293,044,119541,Gupta; Rajesh K.,9999,0,9999,0
1668125383196,CSE 293,045,126410,Vaccaro; Kristen Marie,9999,0,9999,0
1668125383196,CSE 293,046,126411,Klemke; Richard,9999,0,9999,0
1668125383623,CSE 294,A00,102459,Voelker; Geoffrey M.,0,0,0,0
1668125383623,CSE 294,B00,111322,Orailoglu; Alex,0,0,0,0
1668125384051,DSE 201,A00,096914,Deutsch; Alin Bernard,30,0,30,0
1668125384484,DSE 210,A00,096915,Dasgupta; Sanjoy,30,0,30,0
1668125384907,DSE 260A,A00,096916,Altintas De Callaf; Ilkay,30,0,30,0
1668125385337,ECE 200,001,103586,Antipa; Nicholas A,9999,0,9999,0
1668125385337,ECE 200,002,103587,Atanasov; Nikolay A.,9999,0,9999,0
1668125385337,ECE 200,003,103588,Bharadia; Dinesh,9999,0,9999,0
1668125385337,ECE 200,004,103589,Cheng; Chung Kuan,9999,0,9999,0
1668125385337,ECE 200,005,103590,Cosman; Pamela C.,9999,0,9999,0
1668125385337,ECE 200,006,103591,Dayeh; Shadi Ahmad,9999,0,9999,0
1668125385337,ECE 200,007,103592,Fainman; Yeshaiahu,9999,0,9999,0
1668125385337,ECE 200,008,103593,Ford; Joseph Earl,9999,0,9999,0
1668125385337,ECE 200,009,103594,Franceschetti; Massimo,9999,0,9999,0
1668125385337,ECE 200,010,103595,Fullerton; Eric E,9999,0,9999,0
1668125385337,ECE 200,011,103596,Galton; Ian A,9999,0,9999,0
1668125385337,ECE 200,012,103597,Gilja; Vikash,9999,0,9999,0
1668125385337,ECE 200,013,103598,Hall; Drew A.,9999,0,9999,0
1668125385337,ECE 200,014,103599,Hsueh; Tzu-Chien,9999,0,9999,0
1668125385337,ECE 200,015,103600,Javidi; Tara,9999,0,9999,0
1668125385337,ECE 200,016,103601,Kahng; Andrew Byun,9999,0,9999,0
1668125385337,ECE 200,017,103602,Kim; Young-Han,9999,0,9999,0
1668125385337,ECE 200,018,103603,Koushanfar; Farinaz,9999,0,9999,0
1668125385337,ECE 200,019,103604,Kuzum; Duygu,9999,0,9999,0
1668125385337,ECE 200,020,103605,Le; Hanh-Phuc,9999,0,9999,0
1668125385337,ECE 200,021,103606,Lin; Bill,9999,0,9999,0
1668125385337,ECE 200,022,103607,Liu; Zhaowei,9998,0,9999,1
1668125385337,ECE 200,023,103608,Lo; Yu-Hwa,9999,0,9999,0
1668125385337,ECE 200,024,103609,Lomakin; Vitaliy,9999,0,9999,0
1668125385337,ECE 200,025,103610,Mercier; Patrick Philip,9999,0,9999,0
1668125385337,ECE 200,026,103611,Meyer; Florian,9999,0,9999,0
1668125385337,ECE 200,027,103612,Milstein; Laurence B.,9999,0,9999,0
1668125385337,ECE 200,028,103613,Mir Arabbaygi; Siavash,9999,0,9999,0
1668125385337,ECE 200,029,103614,Mookherjea; Shayan,9999,0,9999,0
1668125385337,ECE 200,030,103615,Morris; Karcher William,9999,0,9999,0
1668125385337,ECE 200,031,103616,Ng; Tse Nga,9999,0,9999,0
1668125385337,ECE 200,032,103617,Nguyen; Truong Quang,9999,0,9999,0
1668125385337,ECE 200,033,103618,Nomura; Kenji,9999,0,9999,0
1668125385337,ECE 200,034,103619,Orlitsky; Alon,9999,0,9999,0
1668125385337,ECE 200,035,103620,Pal; Piya,9999,0,9999,0
1668125385337,ECE 200,036,103621,Papen; George C.,9999,0,9999,0
1668125385337,ECE 200,037,103622,Radic; Stojan,9999,0,9999,0
1668125385337,ECE 200,038,103623,Rao; Bhaskar D.,9999,0,9999,0
1668125385337,ECE 200,039,103624,Rao; Ramesh R,9999,0,9999,0
1668125385337,ECE 200,040,103625,Rebeiz; Gabriel,9999,0,9999,0
1668125385337,ECE 200,041,103626,Sanford; John R,9999,0,9999,0
1668125385337,ECE 200,042,103627,Siegel; Paul H.,9999,0,9999,0
1668125385337,ECE 200,043,103628,Sievenpiper; Daniel F.,9999,0,9999,0
1668125385337,ECE 200,044,103629,Sworder; David D.,9999,0,9999,0
1668125385337,ECE 200,045,103630,Taur; Yuan,9999,0,9999,0
1668125385337,ECE 200,046,103631,Touri; Behrouz,9999,0,9999,0
1668125385337,ECE 200,047,103632,Trivedi; Mohan M.,9999,0,9999,0
1668125385337,ECE 200,048,103633,Vasconcelos; Nuno,9999,0,9999,0
1668125385337,ECE 200,049,103634,Wang; Xiaolong,9999,0,9999,0
1668125385337,ECE 200,050,103635,Xie; Pengtao,9999,0,9999,0
1668125385337,ECE 200,051,103636,Yip; Michael,9999,0,9999,0
1668125385337,ECE 200,052,103637,Zeger; Kenneth A.,999,0,999,0
1668125385337,ECE 200,053,103638,Zhang; Xinyu,9999,0,9999,0
1668125385337,ECE 200,054,103639,Turakhia; Yatish Girish,9999,0,9999,0
1668125385337,ECE 200,055,103640,Kang; Mingu,9999,0,9999,0
1668125385337,ECE 200,056,103641,Shi; Yuanyuan,9999,0,9999,0
1668125385337,ECE 200,057,103642,Wang; Edward Jay,9999,0,9999,0
1668125385337,ECE 200,058,103643,Zheng; Yang,9999,0,9999,0
1668125385759,ECE 202,A00,103644,Kuzum; Duygu,0,0,0,0
1668125386182,ECE 212BN,A00,103646,Ng; Tse Nga,0,0,0,0
1668125386621,ECE 221,A00,111493,Staff,0,0,0,0
1668125387046,ECE 222B,A00,103647,Lomakin; Vitaliy,0,0,0,0
1668125387474,ECE 230B,A00,103648,Taur; Yuan,0,0,0,0
1668125387901,ECE 238B,A00,103649,Garay; Javier,0,0,0,0
1668125388340,ECE 240B,A00,112900,Fainman; Yeshaiahu,0,0,0,0
1668125388783,ECE 247A,A00,103650,Jokerst; Jesse Vincent,0,0,0,0
1668125389212,ECE 247B,A00,103651,Wang; Joseph,0,0,0,0
1668125389643,ECE 250,A00,103652,Siegel; Paul H.,0,0,0,0
1668125390078,ECE 251A,A00,103654,Rao; Bhaskar D.,0,0,0,0
1668125390515,ECE 257B,A00,103655,Bharadia; Dinesh,0,0,0,0
1668125390950,ECE 258A,A00,103656,Milstein; Laurence B.,0,0,0,0
1668125391377,ECE 260B,A00,103658,Kang; Mingu,0,0,0,0
1668125391800,ECE 264A,A00,103659,Galton; Ian A,0,0,0,0
1668125392222,ECE 265A,A00,103661,Gudem; Prasad S.S.,0,0,0,0
1668125392657,ECE 265D,A00,103662,Gudem; Prasad S.S.,0,0,0,0
1668125393087,ECE 268,A00,103663,Koushanfar; Farinaz,0,0,0,0
1668125393515,ECE 269,A01,103665,Pal; Piya,0,0,0,0
1668125393938,ECE 271B,A00,103666,Vasconcelos; Manuela,0,0,0,0
1668125394360,ECE 276A,A00,103667,Atanasov; Nikolay A.,0,0,0,0
1668125394791,ECE 277,A00,103668,An; Cheolhong,0,0,0,0
1668125395216,ECE 279,A00,117947,Hall; Drew A.,0,0,0,0
1668125396061,ECE 283,A00,103670,Hsueh; Tzu-Chien,0,0,0,0
1668125396488,ECE 284,A00,103671,Turakhia; Yatish Girish,0,0,0,0
1668125396919,ECE 285,A00,103672,Zheng; Yang,0,0,0,0
1668125396919,ECE 285,B00,103673,Sworder; David D.,0,0,0,0
1668125397341,ECE 287,A00,103676,Javidi; Tara,0,0,0,0
1668125397764,MATH 200B,A00,098023,Salehi Golsefidy; Alireza,12,0,15,3
1668125398201,MATH 202B,A00,098024,Rhoades; Brendon Patrick,9,0,15,6
1668125398623,MATH 203B,A00,098025,Oprea; Dragos N.,10,0,15,5
1668125399046,MATH 204B,A00,098026,Sorensen; Claus M,13,0,15,2
1668125399477,MATH 208,A00,098027,Izadi; Elham,7,0,10,3
1668125399906,MATH 209,A00,098028,Pollack; Aaron,10,0,10,0
1668125400340,MATH 211A,A00,112919,Rogalski; Daniel,9,0,10,1
1668125401186,MATH 211B,A00,112920,Seward; Brandon M.,9,0,10,1
1668125401619,MATH 218,A00,098029,Li; Bo,10,0,10,0
1668125402150,MATH 220B,A00,098030,Novak; Jonathan I,11,0,15,4
1668125402587,MATH 221A,A00,098031,Ebenfelt; Peter F,13,0,15,2
1668125403012,MATH 231B,A00,098032,Zlatos; Andrej,12,0,15,3
1668125403437,MATH 240B,A00,098033,Ni; Lei,9,0,15,6
1668125403869,MATH 243,A00,098034,Jekel; David Andrew,10,0,10,0
1668125404294,MATH 245A,A00,098035,Nie; Jiawang,0,0,15,16
1668125404721,MATH 248,A00,098036,Bejenaru; Ioan,10,0,10,0
1668125405156,MATH 250B,A00,098037,Spolaor; Luca,14,0,15,1
1668125405586,MATH 258,A00,098038,Ni; Lei,10,0,10,0
1668125406015,MATH 264B,A00,098041,Rhoades; Brendon Patrick,9,0,15,6
1668125406443,MATH 268,A00,098042,Buss; Samuel R,10,0,10,0
1668125406876,MATH 269,A00,098043,Rhoades; Brendon Patrick,10,0,10,0
1668125407301,MATH 270B,A00,098044,Li; Bo,10,0,15,5
1668125407724,MATH 272B,A00,098045,Holst; Michael J,13,0,15,2
1668125408167,MATH 273A,A00,098046,Tian; Xiaochuan,10,0,15,5
1668125408602,MATH 275,A01,098048,Tian; Xiaochuan,6,0,10,4
1668125409025,MATH 278A,A00,098049,Holst; Michael J,8,0,10,2
1668125409519,MATH 278B,A00,098050,Cloninger; Alexander,10,0,10,0
1668125409943,MATH 278C,A00,098051,Nie; Jiawang,7,0,10,3
1668125410371,MATH 280B,A00,098052,Zheng; Tianyi,10,0,15,5
1668125410798,MATH 281B,A00,098053,Bradic; Jelena,2,0,15,13
1668125411239,MATH 282B,A00,098054,Arias-Castro; Ery,0,0,15,15
1668125411662,MATH 285,A00,098055,Fitzsimmons; Patrick J,0,0,15,17
1668125412086,MATH 287B,A00,098056,Arias-Castro; Ery,3,0,15,12
1668125412512,MATH 288,A00,098057,Agarwal; Pooja,9,0,10,1
1668125412512,MATH 288,B00,098058,Zhang; Danna,8,0,10,2
1668125412512,MATH 288,C00,098059,Williams; Ruth J,10,0,10,0
1668125412974,MATH 290B,A00,098060,Roberts; Justin Deritter,13,0,15,2
1668125413398,MATH 292,A00,098061,Belmont; Eva Kinoshita,10,0,10,0
1668125413832,MATH 295,A00,098062,Suk; Andrew Hoon,48,0,50,2
1668125414279,MATH 296,A00,098063,Novak; Jonathan I,20,0,20,0
1668125414717,MATH 297,001,098064,Gamst; Anthony Collins,9997,0,9999,2
1668125928904,COGS 205,A00,101395,Chiba; Andrea,19,0,20,1
1668125929329,COGS 210B,001,101404,Greene; Deanna Jacquelyn,9998,0,9999,1
1668125929329,COGS 210B,002,101417,Xia; Haijun,9999,0,9999,0
1668125929329,COGS 210B,003,101422,Nitz; Douglas A.,9999,0,9999,0
1668125929329,COGS 210B,004,101423,Hollan; James D.,9998,0,9999,1
1668125929329,COGS 210B,005,101424,Deak; Gedeon O.,9998,0,9999,1
1668125929329,COGS 210B,006,101425,Rossano; Federico,9999,0,9999,0
1668125929750,COGS 211B,A00,101427,Coulson; Seana M,9996,0,9999,3
1668125930179,COGS 220,A00,101428,Hollan; James D.,0,0,25,25
1668125930604,COGS 229,A00,101429,Dow; Steven P,18,0,25,7
1668125931028,COGS 230,A00,101430,Klemmer; Scott R,12,0,17,5
1668125931461,COGS 234,A00,101431,Xia; Haijun,3,0,25,22
1668125931893,COGS 260,A00,101432,Kiyonaga; Anastasia,20,0,25,5
1668125931893,COGS 260,B00,101433,Kirsh; David Joel,16,0,25,9
1668125932325,CSE 202,A00,102371,Impagliazzo; Russell,0,0,0,0
1668125932747,CSE 203B,A01,102373,Cheng; Chung Kuan,0,0,0,0
1668125933177,CSE 208,A00,102374,Micciancio; Daniele,0,0,0,0
1668125933602,CSE 209A,A00,112895,Impagliazzo; Russell,0,0,15,15
1668125934032,CSE 209B,A00,108005,Bellare; Mihir,0,0,0,0
1668125934463,CSE 210,A00,113163,Coblenz; Michael J,0,0,0,0
1668125934887,CSE 219,A00,106111,Dow; Steven P,0,0,20,20
1668125935313,CSE 221,A00,102376,Voelker; Geoffrey M.,0,0,0,0
1668125935747,CSE 224,A01,102378,Porter; George M,0,0,0,0
1668125936169,CSE 229A,A00,102379,Savage; Stefan,0,0,0,0
1668125936666,CSE 229C,A00,102380,Munyaka; Imani N. S.,0,0,0,0
1668125937101,CSE 232B,A00,102382,Deutsch; Alin Bernard,0,0,0,0
1668125937528,CSE 234,A01,112904,Kumar; Arun Kumar,0,0,0,0
1668125937958,CSE 237A,A00,102383,Rosing; Tajana Simunic,0,0,0,0
1668125938391,CSE 239A,A00,102384,Deutsch; Alin Bernard,0,0,0,0
1668125938815,CSE 239B,A00,102385,Polikarpova; Nadezhda,0,0,0,0
1668125939244,CSE 240A,A00,102386,Pannuto; Patrick William,0,0,0,0
1668125939679,CSE 240B,A00,102387,Zhao; Jishen,0,0,0,0
1668125940111,CSE 241A,A00,106406,Kang; Mingu,0,0,0,0
1668125940552,CSE 249B,A00,102388,Kahng; Andrew Byun,0,0,8,8
1668125940974,CSE 251B,A01,102392,Cottrell; Garrison W,0,0,0,0
1668125940974,CSE 251B,A02,102393,Cottrell; Garrison W,0,0,0,0
1668125941413,CSE 252B,A00,102394,Ochoa; Benjamin Lawrence,0,0,0,0
1668125941837,CSE 257,A01,102396,Gao; Sicun,0,0,0,0
1668125942270,CSE 272,A00,102397,Li; Tzumao,0,0,0,0
1668125942706,CSE 274,A00,111323,Chern; Albert Ren-Haur,0,0,0,0
1668125943139,CSE 282,A00,102398,Pevzner; Pavel Arkadjevich,0,0,0,0
1668125943567,CSE 284,A00,114175,Gymrek; Melissa Ann,0,0,0,0
1668125944004,CSE 290,A00,102399,Chandraker; Manmohan Krishna,0,0,0,0
1668125944004,CSE 290,B00,102400,Vaccaro; Kristen Marie,0,0,25,25
1668125944004,CSE 290,C00,102414,Pannuto; Patrick William,0,0,25,25
1668125944004,CSE 290,D00,102427,Pevzner; Pavel Arkadjevich,0,0,0,0
1668125944004,CSE 290,E00,102429,Zhao; Jishen,0,0,0,0
1668125944004,CSE 290,F00,102436,Tullsen; Dean Michael,0,0,0,0
1668125944004,CSE 290,G00,102440,Christensen; Henrik I,0,0,20,20
1668125944428,CSE 291,A00,102443,Su; Hao,0,0,0,0
1668125944428,CSE 291,B00,102448,Polikarpova; Nadezhda,0,0,0,0
1668125944428,CSE 291,C00,102453,Vaccaro; Kristen Marie,0,0,0,0
1668125944428,CSE 291,D00,111343,Savage; Stefan,0,0,0,0
1668125944428,CSE 291,E00,116474,Claffy; Kimberly Claire,0,0,0,0
1668125944428,CSE 291,F00,116479,Pasquale; Joseph,0,0,0,0
1668125944926,CSE 293,001,119111,Bafna; Vineet,9999,0,9999,0
1668125944926,CSE 293,002,119118,Bellare; Mihir,9999,0,9999,0
1668125944926,CSE 293,003,119122,Berg-Kirkpatrick; Taylor D,9999,0,9999,0
1668125944926,CSE 293,004,119135,Christensen; Henrik I,9999,0,9999,0
1668125944926,CSE 293,005,119142,Cottrell; Garrison W,9999,0,9999,0
1668125944926,CSE 293,006,119146,Deutsch; Alin Bernard,9999,0,9999,0
1668125944926,CSE 293,007,119159,Esmaeilzadeh; Hadi,9999,0,9999,0
1668125944926,CSE 293,008,119166,Freund; Yoav,9999,0,9999,0
1668125944926,CSE 293,009,119170,Griswold; William G.,9999,0,9999,0
1668125944926,CSE 293,010,119183,Gymrek; Melissa Ann,9999,0,9999,0
1668125944926,CSE 293,011,119190,Heninger; Nadia A,9999,0,9999,0
1668125944926,CSE 293,012,119230,Impagliazzo; Russell,9999,0,9999,0
1668125944926,CSE 293,013,119232,Jhala; Ranjit,9999,0,9999,0
1668125944926,CSE 293,014,119233,Kahng; Andrew Byun,9999,0,9999,0
1668125944926,CSE 293,015,119298,Kane; Daniel Mertz,9999,0,9999,0
1668125944926,CSE 293,016,119299,Kriegman; David J,9999,0,9999,0
1668125944926,CSE 293,017,119300,Kumar; Arun Kumar,9999,0,9999,0
1668125944926,CSE 293,018,119301,Lerner; Sorin,9999,0,9999,0
1668125944926,CSE 293,019,119302,Lovett; Shachar,9999,0,9999,0
1668125944926,CSE 293,020,119303,McAuley; Julian John,9999,0,9999,0
1668125944926,CSE 293,021,119304,Micciancio; Daniele,9999,0,9999,0
1668125944926,CSE 293,022,119367,Orailoglu; Alex,9999,0,9999,0
1668125944926,CSE 293,023,119382,Paturi; Ramamohan,9999,0,9999,0
1668125944926,CSE 293,024,119404,Polikarpova; Nadezhda,9999,0,9999,0
1668125944926,CSE 293,025,119406,Politz; Joseph Gibbs,9999,0,9999,0
1668125944926,CSE 293,026,119411,Porter; George M,9999,0,9999,0
1668125944926,CSE 293,027,119414,Porter; Leonard Emerson,9999,0,9999,0
1668125944926,CSE 293,028,119416,Ramamoorthi; Ravi,9999,0,9999,0
1668125944926,CSE 293,029,119417,Sahoo; Debashis,9999,0,9999,0
1668125944926,CSE 293,030,119420,Saul; Lawrence,9999,0,9999,0
1668125944926,CSE 293,031,119421,Savage; Stefan,9999,0,9999,0
1668125944926,CSE 293,032,119425,Schulze; Jurgen P.,9999,0,9999,0
1668125944926,CSE 293,033,119426,Snoeren; Alex C.,9999,0,9999,0
1668125944926,CSE 293,034,119428,Shang; Jingbo,9999,0,9999,0
1668125944926,CSE 293,035,119430,Stefan; Deian,9999,0,9999,0
1668125944926,CSE 293,036,119431,Su; Hao,9999,0,9999,0
1668125944926,CSE 293,037,119433,Swanson; Steven James,9999,0,9999,0
1668125944926,CSE 293,038,119435,Tullsen; Dean Michael,9999,0,9999,0
1668125944926,CSE 293,039,119483,Voelker; Geoffrey M.,9999,0,9999,0
1668125944926,CSE 293,040,119537,Zhao; Jishen,9999,0,9999,0
1668125944926,CSE 293,041,119538,Zhou; Yuan-Yuan,9999,0,9999,0
1668125944926,CSE 293,042,119539,Gao; Sicun,9999,0,9999,0
1668125944926,CSE 293,043,119540,Weibel; Nadir,9999,0,9999,0
1668125944926,CSE 293,044,119541,Gupta; Rajesh K.,9999,0,9999,0
1668125944926,CSE 293,045,126410,Vaccaro; Kristen Marie,9999,0,9999,0
1668125944926,CSE 293,046,126411,Klemke; Richard,9999,0,9999,0
1668125945359,CSE 294,A00,102459,Voelker; Geoffrey M.,0,0,0,0
1668125945359,CSE 294,B00,111322,Orailoglu; Alex,0,0,0,0
1668125945784,DSE 201,A00,096914,Deutsch; Alin Bernard,30,0,30,0
1668125946209,DSE 210,A00,096915,Dasgupta; Sanjoy,30,0,30,0
1668125946639,DSE 260A,A00,096916,Altintas De Callaf; Ilkay,30,0,30,0
1668125947072,ECE 200,001,103586,Antipa; Nicholas A,9999,0,9999,0
1668125947072,ECE 200,002,103587,Atanasov; Nikolay A.,9999,0,9999,0
1668125947072,ECE 200,003,103588,Bharadia; Dinesh,9999,0,9999,0
1668125947072,ECE 200,004,103589,Cheng; Chung Kuan,9999,0,9999,0
1668125947072,ECE 200,005,103590,Cosman; Pamela C.,9999,0,9999,0
1668125947072,ECE 200,006,103591,Dayeh; Shadi Ahmad,9999,0,9999,0
1668125947072,ECE 200,007,103592,Fainman; Yeshaiahu,9999,0,9999,0
1668125947072,ECE 200,008,103593,Ford; Joseph Earl,9999,0,9999,0
1668125947072,ECE 200,009,103594,Franceschetti; Massimo,9999,0,9999,0
1668125947072,ECE 200,010,103595,Fullerton; Eric E,9999,0,9999,0
1668125947072,ECE 200,011,103596,Galton; Ian A,9999,0,9999,0
1668125947072,ECE 200,012,103597,Gilja; Vikash,9999,0,9999,0
1668125947072,ECE 200,013,103598,Hall; Drew A.,9999,0,9999,0
1668125947072,ECE 200,014,103599,Hsueh; Tzu-Chien,9999,0,9999,0
1668125947072,ECE 200,015,103600,Javidi; Tara,9999,0,9999,0
1668125947072,ECE 200,016,103601,Kahng; Andrew Byun,9999,0,9999,0
1668125947072,ECE 200,017,103602,Kim; Young-Han,9999,0,9999,0
1668125947072,ECE 200,018,103603,Koushanfar; Farinaz,9999,0,9999,0
1668125947072,ECE 200,019,103604,Kuzum; Duygu,9999,0,9999,0
1668125947072,ECE 200,020,103605,Le; Hanh-Phuc,9999,0,9999,0
1668125947072,ECE 200,021,103606,Lin; Bill,9999,0,9999,0
1668125947072,ECE 200,022,103607,Liu; Zhaowei,9998,0,9999,1
1668125947072,ECE 200,023,103608,Lo; Yu-Hwa,9999,0,9999,0
1668125947072,ECE 200,024,103609,Lomakin; Vitaliy,9999,0,9999,0
1668125947072,ECE 200,025,103610,Mercier; Patrick Philip,9999,0,9999,0
1668125947072,ECE 200,026,103611,Meyer; Florian,9999,0,9999,0
1668125947072,ECE 200,027,103612,Milstein; Laurence B.,9999,0,9999,0
1668125947072,ECE 200,028,103613,Mir Arabbaygi; Siavash,9999,0,9999,0
1668125947072,ECE 200,029,103614,Mookherjea; Shayan,9999,0,9999,0
1668125947072,ECE 200,030,103615,Morris; Karcher William,9999,0,9999,0
1668125947072,ECE 200,031,103616,Ng; Tse Nga,9999,0,9999,0
1668125947072,ECE 200,032,103617,Nguyen; Truong Quang,9999,0,9999,0
1668125947072,ECE 200,033,103618,Nomura; Kenji,9999,0,9999,0
1668125947072,ECE 200,034,103619,Orlitsky; Alon,9999,0,9999,0
1668125947072,ECE 200,035,103620,Pal; Piya,9999,0,9999,0
1668125947072,ECE 200,036,103621,Papen; George C.,9999,0,9999,0
1668125947072,ECE 200,037,103622,Radic; Stojan,9999,0,9999,0
1668125947072,ECE 200,038,103623,Rao; Bhaskar D.,9999,0,9999,0
1668125947072,ECE 200,039,103624,Rao; Ramesh R,9999,0,9999,0
1668125947072,ECE 200,040,103625,Rebeiz; Gabriel,9999,0,9999,0
1668125947072,ECE 200,041,103626,Sanford; John R,9999,0,9999,0
1668125947072,ECE 200,042,103627,Siegel; Paul H.,9999,0,9999,0
1668125947072,ECE 200,043,103628,Sievenpiper; Daniel F.,9999,0,9999,0
1668125947072,ECE 200,044,103629,Sworder; David D.,9999,0,9999,0
1668125947072,ECE 200,045,103630,Taur; Yuan,9999,0,9999,0
1668125947072,ECE 200,046,103631,Touri; Behrouz,9999,0,9999,0
1668125947072,ECE 200,047,103632,Trivedi; Mohan M.,9999,0,9999,0
1668125947072,ECE 200,048,103633,Vasconcelos; Nuno,9999,0,9999,0
1668125947072,ECE 200,049,103634,Wang; Xiaolong,9999,0,9999,0
1668125947072,ECE 200,050,103635,Xie; Pengtao,9999,0,9999,0
1668125947072,ECE 200,051,103636,Yip; Michael,9999,0,9999,0
1668125947072,ECE 200,052,103637,Zeger; Kenneth A.,999,0,999,0
1668125947072,ECE 200,053,103638,Zhang; Xinyu,9999,0,9999,0
1668125947072,ECE 200,054,103639,Turakhia; Yatish Girish,9999,0,9999,0
1668125947072,ECE 200,055,103640,Kang; Mingu,9999,0,9999,0
1668125947072,ECE 200,056,103641,Shi; Yuanyuan,9999,0,9999,0
1668125947072,ECE 200,057,103642,Wang; Edward Jay,9999,0,9999,0
1668125947072,ECE 200,058,103643,Zheng; Yang,9999,0,9999,0
1668125947512,ECE 202,A00,103644,Kuzum; Duygu,0,0,0,0
1668125947940,ECE 212BN,A00,103646,Ng; Tse Nga,0,0,0,0
1668125948368,ECE 221,A00,111493,Staff,0,0,0,0
1668125948808,ECE 222B,A00,103647,Lomakin; Vitaliy,0,0,0,0
1668125949234,ECE 230B,A00,103648,Taur; Yuan,0,0,0,0
1668125949657,ECE 238B,A00,103649,Garay; Javier,0,0,0,0
1668125950090,ECE 240B,A00,112900,Fainman; Yeshaiahu,0,0,0,0
1668125950517,ECE 247A,A00,103650,Jokerst; Jesse Vincent,0,0,0,0
1668125950945,ECE 247B,A00,103651,Wang; Joseph,0,0,0,0
1668125951372,ECE 250,A00,103652,Siegel; Paul H.,0,0,0,0
1668125951804,ECE 251A,A00,103654,Rao; Bhaskar D.,0,0,0,0
1668125952227,ECE 257B,A00,103655,Bharadia; Dinesh,0,0,0,0
1668125952652,ECE 258A,A00,103656,Milstein; Laurence B.,0,0,0,0
1668125953082,ECE 260B,A00,103658,Kang; Mingu,0,0,0,0
1668125953524,ECE 264A,A00,103659,Galton; Ian A,0,0,0,0
1668125953946,ECE 265A,A00,103661,Gudem; Prasad S.S.,0,0,0,0
1668125954372,ECE 265D,A00,103662,Gudem; Prasad S.S.,0,0,0,0
1668125954803,ECE 268,A00,103663,Koushanfar; Farinaz,0,0,0,0
1668125955231,ECE 269,A01,103665,Pal; Piya,0,0,0,0
1668125955656,ECE 271B,A00,103666,Vasconcelos; Manuela,0,0,0,0
1668125956087,ECE 276A,A00,103667,Atanasov; Nikolay A.,0,0,0,0
1668125956509,ECE 277,A00,103668,An; Cheolhong,0,0,0,0
1668125956932,ECE 279,A00,117947,Hall; Drew A.,0,0,0,0
1668125957797,ECE 283,A00,103670,Hsueh; Tzu-Chien,0,0,0,0
1668125958221,ECE 284,A00,103671,Turakhia; Yatish Girish,0,0,0,0
1668125958652,ECE 285,A00,103672,Zheng; Yang,0,0,0,0
1668125958652,ECE 285,B00,103673,Sworder; David D.,0,0,0,0
1668125959075,ECE 287,A00,103676,Javidi; Tara,0,0,0,0
1668125959499,MATH 200B,A00,098023,Salehi Golsefidy; Alireza,12,0,15,3
1668125959926,MATH 202B,A00,098024,Rhoades; Brendon Patrick,9,0,15,6
1668125960353,MATH 203B,A00,098025,Oprea; Dragos N.,10,0,15,5
1668125960786,MATH 204B,A00,098026,Sorensen; Claus M,13,0,15,2
1668125961215,MATH 208,A00,098027,Izadi; Elham,7,0,10,3
1668125961645,MATH 209,A00,098028,Pollack; Aaron,10,0,10,0
1668125962085,MATH 211A,A00,112919,Rogalski; Daniel,9,0,10,1
1668125962508,MATH 211B,A00,112920,Seward; Brandon M.,9,0,10,1
1668125962935,MATH 218,A00,098029,Li; Bo,10,0,10,0
1668125963360,MATH 220B,A00,098030,Novak; Jonathan I,11,0,15,4
1668125963790,MATH 221A,A00,098031,Ebenfelt; Peter F,13,0,15,2
1668125964221,MATH 231B,A00,098032,Zlatos; Andrej,12,0,15,3
1668125964651,MATH 240B,A00,098033,Ni; Lei,9,0,15,6
1668125965074,MATH 243,A00,098034,Jekel; David Andrew,10,0,10,0
1668125965497,MATH 245A,A00,098035,Nie; Jiawang,0,0,15,16
1668125965931,MATH 248,A00,098036,Bejenaru; Ioan,10,0,10,0
1668125966354,MATH 250B,A00,098037,Spolaor; Luca,14,0,15,1
1668125966789,MATH 258,A00,098038,Ni; Lei,10,0,10,0
1668125967230,MATH 264B,A00,098041,Rhoades; Brendon Patrick,9,0,15,6
1668125967653,MATH 268,A00,098042,Buss; Samuel R,10,0,10,0
1668125968087,MATH 269,A00,098043,Rhoades; Brendon Patrick,10,0,10,0
1668125968527,MATH 270B,A00,098044,Li; Bo,10,0,15,5
1668125968970,MATH 272B,A00,098045,Holst; Michael J,13,0,15,2
1668125969407,MATH 273A,A00,098046,Tian; Xiaochuan,10,0,15,5
1668125969834,MATH 275,A01,098048,Tian; Xiaochuan,6,0,10,4
1668125970271,MATH 278A,A00,098049,Holst; Michael J,8,0,10,2
1668125970700,MATH 278B,A00,098050,Cloninger; Alexander,10,0,10,0
1668125971123,MATH 278C,A00,098051,Nie; Jiawang,7,0,10,3
1668125971558,MATH 280B,A00,098052,Zheng; Tianyi,10,0,15,5
1668125971994,MATH 281B,A00,098053,Bradic; Jelena,2,0,15,13
1668125972422,MATH 282B,A00,098054,Arias-Castro; Ery,0,0,15,15
1668125972847,MATH 285,A00,098055,Fitzsimmons; Patrick J,0,0,15,17
1668125973270,MATH 287B,A00,098056,Arias-Castro; Ery,3,0,15,12
1668125973691,MATH 288,A00,098057,Agarwal; Pooja,9,0,10,1
1668125973691,MATH 288,B00,098058,Zhang; Danna,8,0,10,2
1668125973691,MATH 288,C00,098059,Williams; Ruth J,10,0,10,0
1668125974122,MATH 290B,A00,098060,Roberts; Justin Deritter,13,0,15,2
1668125974558,MATH 292,A00,098061,Belmont; Eva Kinoshita,10,0,10,0
1668125974998,MATH 295,A00,098062,Suk; Andrew Hoon,48,0,50,2
1668125975434,MATH 296,A00,098063,Novak; Jonathan I,20,0,20,0
1668125975867,MATH 297,001,098064,Gamst; Anthony Collins,9997,0,9999,2
1668126479983,COGS 205,A00,101395,Chiba; Andrea,19,0,20,1
1668126480426,COGS 210B,001,101404,Greene; Deanna Jacquelyn,9998,0,9999,1
1668126480426,COGS 210B,002,101417,Xia; Haijun,9999,0,9999,0
1668126480426,COGS 210B,003,101422,Nitz; Douglas A.,9999,0,9999,0
1668126480426,COGS 210B,004,101423,Hollan; James D.,9998,0,9999,1
1668126480426,COGS 210B,005,101424,Deak; Gedeon O.,9998,0,9999,1
1668126480426,COGS 210B,006,101425,Rossano; Federico,9999,0,9999,0
1668126480852,COGS 211B,A00,101427,Coulson; Seana M,9996,0,9999,3
1668126481280,COGS 220,A00,101428,Hollan; James D.,0,0,25,25
1668126481705,COGS 229,A00,101429,Dow; Steven P,18,0,25,7
1668126482128,COGS 230,A00,101430,Klemmer; Scott R,12,0,17,5
1668126482562,COGS 234,A00,101431,Xia; Haijun,3,0,25,22
1668126482997,COGS 260,A00,101432,Kiyonaga; Anastasia,20,0,25,5
1668126482997,COGS 260,B00,101433,Kirsh; David Joel,16,0,25,9
1668126483429,CSE 202,A00,102371,Impagliazzo; Russell,0,0,0,0
1668126483860,CSE 203B,A01,102373,Cheng; Chung Kuan,0,0,0,0
1668126484301,CSE 208,A00,102374,Micciancio; Daniele,0,0,0,0
1668126484732,CSE 209A,A00,112895,Impagliazzo; Russell,0,0,15,15
1668126485173,CSE 209B,A00,108005,Bellare; Mihir,0,0,0,0
1668126485612,CSE 210,A00,113163,Coblenz; Michael J,0,0,0,0
1668126486043,CSE 219,A00,106111,Dow; Steven P,0,0,20,20
1668126486475,CSE 221,A00,102376,Voelker; Geoffrey M.,0,0,0,0
1668126486908,CSE 224,A01,102378,Porter; George M,0,0,0,0
1668126487343,CSE 229A,A00,102379,Savage; Stefan,0,0,0,0
1668126487765,CSE 229C,A00,102380,Munyaka; Imani N. S.,0,0,0,0
1668126488201,CSE 232B,A00,102382,Deutsch; Alin Bernard,0,0,0,0
1668126488633,CSE 234,A01,112904,Kumar; Arun Kumar,0,0,0,0
1668126489062,CSE 237A,A00,102383,Rosing; Tajana Simunic,0,0,0,0
1668126489497,CSE 239A,A00,102384,Deutsch; Alin Bernard,0,0,0,0
1668126489929,CSE 239B,A00,102385,Polikarpova; Nadezhda,0,0,0,0
1668126490354,CSE 240A,A00,102386,Pannuto; Patrick William,0,0,0,0
1668126490776,CSE 240B,A00,102387,Zhao; Jishen,0,0,0,0
1668126491200,CSE 241A,A00,106406,Kang; Mingu,0,0,0,0
1668126491632,CSE 249B,A00,102388,Kahng; Andrew Byun,0,0,8,8
1668126492069,CSE 251B,A01,102392,Cottrell; Garrison W,0,0,0,0
1668126492069,CSE 251B,A02,102393,Cottrell; Garrison W,0,0,0,0
1668126492499,CSE 252B,A00,102394,Ochoa; Benjamin Lawrence,0,0,0,0
1668126492923,CSE 257,A01,102396,Gao; Sicun,0,0,0,0
1668126493356,CSE 272,A00,102397,Li; Tzumao,0,0,0,0
1668126493784,CSE 274,A00,111323,Chern; Albert Ren-Haur,0,0,0,0
1668126494209,CSE 282,A00,102398,Pevzner; Pavel Arkadjevich,0,0,0,0
1668126494642,CSE 284,A00,114175,Gymrek; Melissa Ann,0,0,0,0
1668126495097,CSE 290,A00,102399,Chandraker; Manmohan Krishna,0,0,0,0
1668126495097,CSE 290,B00,102400,Vaccaro; Kristen Marie,0,0,25,25
1668126495097,CSE 290,C00,102414,Pannuto; Patrick William,0,0,25,25
1668126495097,CSE 290,D00,102427,Pevzner; Pavel Arkadjevich,0,0,0,0
1668126495097,CSE 290,E00,102429,Zhao; Jishen,0,0,0,0
1668126495097,CSE 290,F00,102436,Tullsen; Dean Michael,0,0,0,0
1668126495097,CSE 290,G00,102440,Christensen; Henrik I,0,0,20,20
1668126495529,CSE 291,A00,102443,Su; Hao,0,0,0,0
1668126495529,CSE 291,B00,102448,Polikarpova; Nadezhda,0,0,0,0
1668126495529,CSE 291,C00,102453,Vaccaro; Kristen Marie,0,0,0,0
1668126495529,CSE 291,D00,111343,Savage; Stefan,0,0,0,0
1668126495529,CSE 291,E00,116474,Claffy; Kimberly Claire,0,0,0,0
1668126495529,CSE 291,F00,116479,Pasquale; Joseph,0,0,0,0
1668126495965,CSE 293,001,119111,Bafna; Vineet,9999,0,9999,0
1668126495965,CSE 293,002,119118,Bellare; Mihir,9999,0,9999,0
1668126495965,CSE 293,003,119122,Berg-Kirkpatrick; Taylor D,9999,0,9999,0
1668126495965,CSE 293,004,119135,Christensen; Henrik I,9999,0,9999,0
1668126495965,CSE 293,005,119142,Cottrell; Garrison W,9999,0,9999,0
1668126495965,CSE 293,006,119146,Deutsch; Alin Bernard,9999,0,9999,0
1668126495965,CSE 293,007,119159,Esmaeilzadeh; Hadi,9999,0,9999,0
1668126495965,CSE 293,008,119166,Freund; Yoav,9999,0,9999,0
1668126495965,CSE 293,009,119170,Griswold; William G.,9999,0,9999,0
1668126495965,CSE 293,010,119183,Gymrek; Melissa Ann,9999,0,9999,0
1668126495965,CSE 293,011,119190,Heninger; Nadia A,9999,0,9999,0
1668126495965,CSE 293,012,119230,Impagliazzo; Russell,9999,0,9999,0
1668126495965,CSE 293,013,119232,Jhala; Ranjit,9999,0,9999,0
1668126495965,CSE 293,014,119233,Kahng; Andrew Byun,9999,0,9999,0
1668126495965,CSE 293,015,119298,Kane; Daniel Mertz,9999,0,9999,0
1668126495965,CSE 293,016,119299,Kriegman; David J,9999,0,9999,0
1668126495965,CSE 293,017,119300,Kumar; Arun Kumar,9999,0,9999,0
1668126495965,CSE 293,018,119301,Lerner; Sorin,9999,0,9999,0
1668126495965,CSE 293,019,119302,Lovett; Shachar,9999,0,9999,0
1668126495965,CSE 293,020,119303,McAuley; Julian John,9999,0,9999,0
1668126495965,CSE 293,021,119304,Micciancio; Daniele,9999,0,9999,0
1668126495965,CSE 293,022,119367,Orailoglu; Alex,9999,0,9999,0
1668126495965,CSE 293,023,119382,Paturi; Ramamohan,9999,0,9999,0
1668126495965,CSE 293,024,119404,Polikarpova; Nadezhda,9999,0,9999,0
1668126495965,CSE 293,025,119406,Politz; Joseph Gibbs,9999,0,9999,0
1668126495965,CSE 293,026,119411,Porter; George M,9999,0,9999,0
1668126495965,CSE 293,027,119414,Porter; Leonard Emerson,9999,0,9999,0
1668126495965,CSE 293,028,119416,Ramamoorthi; Ravi,9999,0,9999,0
1668126495965,CSE 293,029,119417,Sahoo; Debashis,9999,0,9999,0
1668126495965,CSE 293,030,119420,Saul; Lawrence,9999,0,9999,0
1668126495965,CSE 293,031,119421,Savage; Stefan,9999,0,9999,0
1668126495965,CSE 293,032,119425,Schulze; Jurgen P.,9999,0,9999,0
1668126495965,CSE 293,033,119426,Snoeren; Alex C.,9999,0,9999,0
1668126495965,CSE 293,034,119428,Shang; Jingbo,9999,0,9999,0
1668126495965,CSE 293,035,119430,Stefan; Deian,9999,0,9999,0
1668126495965,CSE 293,036,119431,Su; Hao,9999,0,9999,0
1668126495965,CSE 293,037,119433,Swanson; Steven James,9999,0,9999,0
1668126495965,CSE 293,038,119435,Tullsen; Dean Michael,9999,0,9999,0
1668126495965,CSE 293,039,119483,Voelker; Geoffrey M.,9999,0,9999,0
1668126495965,CSE 293,040,119537,Zhao; Jishen,9999,0,9999,0
1668126495965,CSE 293,041,119538,Zhou; Yuan-Yuan,9999,0,9999,0
1668126495965,CSE 293,042,119539,Gao; Sicun,9999,0,9999,0
1668126495965,CSE 293,043,119540,Weibel; Nadir,9999,0,9999,0
1668126495965,CSE 293,044,119541,Gupta; Rajesh K.,9999,0,9999,0
1668126495965,CSE 293,045,126410,Vaccaro; Kristen Marie,9999,0,9999,0
1668126495965,CSE 293,046,126411,Klemke; Richard,9999,0,9999,0
1668126496392,CSE 294,A00,102459,Voelker; Geoffrey M.,0,0,0,0
1668126496392,CSE 294,B00,111322,Orailoglu; Alex,0,0,0,0
1668126496822,DSE 201,A00,096914,Deutsch; Alin Bernard,30,0,30,0
1668126497258,DSE 210,A00,096915,Dasgupta; Sanjoy,30,0,30,0
1668126497682,DSE 260A,A00,096916,Altintas De Callaf; Ilkay,30,0,30,0
1668126498149,ECE 200,001,103586,Antipa; Nicholas A,9999,0,9999,0
1668126498149,ECE 200,002,103587,Atanasov; Nikolay A.,9999,0,9999,0
1668126498149,ECE 200,003,103588,Bharadia; Dinesh,9999,0,9999,0
1668126498149,ECE 200,004,103589,Cheng; Chung Kuan,9999,0,9999,0
1668126498149,ECE 200,005,103590,Cosman; Pamela C.,9999,0,9999,0
1668126498149,ECE 200,006,103591,Dayeh; Shadi Ahmad,9999,0,9999,0
1668126498149,ECE 200,007,103592,Fainman; Yeshaiahu,9999,0,9999,0
1668126498149,ECE 200,008,103593,Ford; Joseph Earl,9999,0,9999,0
1668126498149,ECE 200,009,103594,Franceschetti; Massimo,9999,0,9999,0
1668126498149,ECE 200,010,103595,Fullerton; Eric E,9999,0,9999,0
1668126498149,ECE 200,011,103596,Galton; Ian A,9999,0,9999,0
1668126498149,ECE 200,012,103597,Gilja; Vikash,9999,0,9999,0
1668126498149,ECE 200,013,103598,Hall; Drew A.,9999,0,9999,0
1668126498149,ECE 200,014,103599,Hsueh; Tzu-Chien,9999,0,9999,0
1668126498149,ECE 200,015,103600,Javidi; Tara,9999,0,9999,0
1668126498149,ECE 200,016,103601,Kahng; Andrew Byun,9999,0,9999,0
1668126498149,ECE 200,017,103602,Kim; Young-Han,9999,0,9999,0
1668126498149,ECE 200,018,103603,Koushanfar; Farinaz,9999,0,9999,0
1668126498149,ECE 200,019,103604,Kuzum; Duygu,9999,0,9999,0
1668126498149,ECE 200,020,103605,Le; Hanh-Phuc,9999,0,9999,0
1668126498149,ECE 200,021,103606,Lin; Bill,9999,0,9999,0
1668126498149,ECE 200,022,103607,Liu; Zhaowei,9998,0,9999,1
1668126498149,ECE 200,023,103608,Lo; Yu-Hwa,9999,0,9999,0
1668126498149,ECE 200,024,103609,Lomakin; Vitaliy,9999,0,9999,0
1668126498149,ECE 200,025,103610,Mercier; Patrick Philip,9999,0,9999,0
1668126498149,ECE 200,026,103611,Meyer; Florian,9999,0,9999,0
1668126498149,ECE 200,027,103612,Milstein; Laurence B.,9999,0,9999,0
1668126498149,ECE 200,028,103613,Mir Arabbaygi; Siavash,9999,0,9999,0
1668126498149,ECE 200,029,103614,Mookherjea; Shayan,9999,0,9999,0
1668126498149,ECE 200,030,103615,Morris; Karcher William,9999,0,9999,0
1668126498149,ECE 200,031,103616,Ng; Tse Nga,9999,0,9999,0
1668126498149,ECE 200,032,103617,Nguyen; Truong Quang,9999,0,9999,0
1668126498149,ECE 200,033,103618,Nomura; Kenji,9999,0,9999,0
1668126498149,ECE 200,034,103619,Orlitsky; Alon,9999,0,9999,0
1668126498149,ECE 200,035,103620,Pal; Piya,9999,0,9999,0
1668126498149,ECE 200,036,103621,Papen; George C.,9999,0,9999,0
1668126498149,ECE 200,037,103622,Radic; Stojan,9999,0,9999,0
1668126498149,ECE 200,038,103623,Rao; Bhaskar D.,9999,0,9999,0
1668126498149,ECE 200,039,103624,Rao; Ramesh R,9999,0,9999,0
1668126498149,ECE 200,040,103625,Rebeiz; Gabriel,9999,0,9999,0
1668126498149,ECE 200,041,103626,Sanford; John R,9999,0,9999,0
1668126498149,ECE 200,042,103627,Siegel; Paul H.,9999,0,9999,0
1668126498149,ECE 200,043,103628,Sievenpiper; Daniel F.,9999,0,9999,0
1668126498149,ECE 200,044,103629,Sworder; David D.,9999,0,9999,0
1668126498149,ECE 200,045,103630,Taur; Yuan,9999,0,9999,0
1668126498149,ECE 200,046,103631,Touri; Behrouz,9999,0,9999,0
1668126498149,ECE 200,047,103632,Trivedi; Mohan M.,9999,0,9999,0
1668126498149,ECE 200,048,103633,Vasconcelos; Nuno,9999,0,9999,0
1668126498149,ECE 200,049,103634,Wang; Xiaolong,9999,0,9999,0
1668126498149,ECE 200,050,103635,Xie; Pengtao,9999,0,9999,0
1668126498149,ECE 200,051,103636,Yip; Michael,9999,0,9999,0
1668126498149,ECE 200,052,103637,Zeger; Kenneth A.,999,0,999,0
1668126498149,ECE 200,053,103638,Zhang; Xinyu,9999,0,9999,0
1668126498149,ECE 200,054,103639,Turakhia; Yatish Girish,9999,0,9999,0
1668126498149,ECE 200,055,103640,Kang; Mingu,9999,0,9999,0
1668126498149,ECE 200,056,103641,Shi; Yuanyuan,9999,0,9999,0
1668126498149,ECE 200,057,103642,Wang; Edward Jay,9999,0,9999,0
1668126498149,ECE 200,058,103643,Zheng; Yang,9999,0,9999,0
1668126498577,ECE 202,A00,103644,Kuzum; Duygu,0,0,0,0
1668126499004,ECE 212BN,A00,103646,Ng; Tse Nga,0,0,0,0
1668126499426,ECE 221,A00,111493,Staff,0,0,0,0
1668126499857,ECE 222B,A00,103647,Lomakin; Vitaliy,0,0,0,0
1668126500282,ECE 230B,A00,103648,Taur; Yuan,0,0,0,0
1668126500706,ECE 238B,A00,103649,Garay; Javier,0,0,0,0
1668126501145,ECE 240B,A00,112900,Fainman; Yeshaiahu,0,0,0,0
1668126501582,ECE 247A,A00,103650,Jokerst; Jesse Vincent,0,0,0,0
1668126502009,ECE 247B,A00,103651,Wang; Joseph,0,0,0,0
1668126502434,ECE 250,A00,103652,Siegel; Paul H.,0,0,0,0
1668126502858,ECE 251A,A00,103654,Rao; Bhaskar D.,0,0,0,0
1668126503287,ECE 257B,A00,103655,Bharadia; Dinesh,0,0,0,0
1668126503711,ECE 258A,A00,103656,Milstein; Laurence B.,0,0,0,0
1668126504152,ECE 260B,A00,103658,Kang; Mingu,0,0,0,0
1668126504673,ECE 264A,A00,103659,Galton; Ian A,0,0,0,0
1668126505126,ECE 265A,A00,103661,Gudem; Prasad S.S.,0,0,0,0
1668126505566,ECE 265D,A00,103662,Gudem; Prasad S.S.,0,0,0,0
1668126506003,ECE 268,A00,103663,Koushanfar; Farinaz,0,0,0,0
1668126506429,ECE 269,A01,103665,Pal; Piya,0,0,0,0
1668126506853,ECE 271B,A00,103666,Vasconcelos; Manuela,0,0,0,0
1668126507281,ECE 276A,A00,103667,Atanasov; Nikolay A.,0,0,0,0
1668126507702,ECE 277,A00,103668,An; Cheolhong,0,0,0,0
1668126508125,ECE 279,A00,117947,Hall; Drew A.,0,0,0,0
1668126508972,ECE 283,A00,103670,Hsueh; Tzu-Chien,0,0,0,0
1668126509395,ECE 284,A00,103671,Turakhia; Yatish Girish,0,0,0,0
1668126509832,ECE 285,A00,103672,Zheng; Yang,0,0,0,0
1668126509832,ECE 285,B00,103673,Sworder; David D.,0,0,0,0
1668126510257,ECE 287,A00,103676,Javidi; Tara,0,0,0,0
1668126510680,MATH 200B,A00,098023,Salehi Golsefidy; Alireza,12,0,15,3
1668126511108,MATH 202B,A00,098024,Rhoades; Brendon Patrick,9,0,15,6
1668126511541,MATH 203B,A00,098025,Oprea; Dragos N.,10,0,15,5
1668126511972,MATH 204B,A00,098026,Sorensen; Claus M,13,0,15,2
1668126512403,MATH 208,A00,098027,Izadi; Elham,7,0,10,3
1668126512826,MATH 209,A00,098028,Pollack; Aaron,10,0,10,0
1668126513253,MATH 211A,A00,112919,Rogalski; Daniel,9,0,10,1
1668126513684,MATH 211B,A00,112920,Seward; Brandon M.,9,0,10,1
1668126514106,MATH 218,A00,098029,Li; Bo,10,0,10,0
1668126514535,MATH 220B,A00,098030,Novak; Jonathan I,11,0,15,4
1668126514967,MATH 221A,A00,098031,Ebenfelt; Peter F,13,0,15,2
1668126515391,MATH 231B,A00,098032,Zlatos; Andrej,12,0,15,3
1668126515815,MATH 240B,A00,098033,Ni; Lei,9,0,15,6
1668126516239,MATH 243,A00,098034,Jekel; David Andrew,10,0,10,0
1668126516663,MATH 245A,A00,098035,Nie; Jiawang,0,0,15,16
1668126517093,MATH 248,A00,098036,Bejenaru; Ioan,10,0,10,0
1668126517518,MATH 250B,A00,098037,Spolaor; Luca,14,0,15,1
1668126517944,MATH 258,A00,098038,Ni; Lei,10,0,10,0
1668126518384,MATH 264B,A00,098041,Rhoades; Brendon Patrick,9,0,15,6
1668126518810,MATH 268,A00,098042,Buss; Samuel R,10,0,10,0
1668126519245,MATH 269,A00,098043,Rhoades; Brendon Patrick,10,0,10,0
1668126519671,MATH 270B,A00,098044,Li; Bo,10,0,15,5
1668126520094,MATH 272B,A00,098045,Holst; Michael J,13,0,15,2
1668126520532,MATH 273A,A00,098046,Tian; Xiaochuan,10,0,15,5
1668126520969,MATH 275,A01,098048,Tian; Xiaochuan,6,0,10,4
1668126521395,MATH 278A,A00,098049,Holst; Michael J,8,0,10,2
1668126521825,MATH 278B,A00,098050,Cloninger; Alexander,10,0,10,0
1668126522249,MATH 278C,A00,098051,Nie; Jiawang,7,0,10,3
1668126522674,MATH 280B,A00,098052,Zheng; Tianyi,10,0,15,5
1668126523097,MATH 281B,A00,098053,Bradic; Jelena,2,0,15,13
1668126523527,MATH 282B,A00,098054,Arias-Castro; Ery,0,0,15,15
1668126523948,MATH 285,A00,098055,Fitzsimmons; Patrick J,0,0,15,17
1668126524374,MATH 287B,A00,098056,Arias-Castro; Ery,3,0,15,12
1668126524799,MATH 288,A00,098057,Agarwal; Pooja,9,0,10,1
1668126524799,MATH 288,B00,098058,Zhang; Danna,8,0,10,2
1668126524799,MATH 288,C00,098059,Williams; Ruth J,10,0,10,0
1668126525247,MATH 290B,A00,098060,Roberts; Justin Deritter,13,0,15,2
1668126525670,MATH 292,A00,098061,Belmont; Eva Kinoshita,10,0,10,0
1668126526092,MATH 295,A00,098062,Suk; Andrew Hoon,48,0,50,2
1668126526517,MATH 296,A00,098063,Novak; Jonathan I,20,0,20,0
1668126526953,MATH 297,001,098064,Gamst; Anthony Collins,9997,0,9999,2
1668127032223,COGS 205,A00,101395,Chiba; Andrea,19,0,20,1
1668127032647,COGS 210B,001,101404,Greene; Deanna Jacquelyn,9998,0,9999,1
1668127032647,COGS 210B,002,101417,Xia; Haijun,9999,0,9999,0
1668127032647,COGS 210B,003,101422,Nitz; Douglas A.,9999,0,9999,0
1668127032647,COGS 210B,004,101423,Hollan; James D.,9998,0,9999,1
1668127032647,COGS 210B,005,101424,Deak; Gedeon O.,9998,0,9999,1
1668127032647,COGS 210B,006,101425,Rossano; Federico,9999,0,9999,0
1668127033073,COGS 211B,A00,101427,Coulson; Seana M,9996,0,9999,3
1668127033506,COGS 220,A00,101428,Hollan; James D.,0,0,25,25
1668127033940,COGS 229,A00,101429,Dow; Steven P,18,0,25,7
1668127034368,COGS 230,A00,101430,Klemmer; Scott R,12,0,17,5
1668127034791,COGS 234,A00,101431,Xia; Haijun,3,0,25,22
1668127035219,COGS 260,A00,101432,Kiyonaga; Anastasia,20,0,25,5
1668127035219,COGS 260,B00,101433,Kirsh; David Joel,16,0,25,9
1668127035640,CSE 202,A00,102371,Impagliazzo; Russell,0,0,0,0
1668127036069,CSE 203B,A01,102373,Cheng; Chung Kuan,0,0,0,0
1668127036497,CSE 208,A00,102374,Micciancio; Daniele,0,0,0,0
1668127036922,CSE 209A,A00,112895,Impagliazzo; Russell,0,0,15,15
1668127037345,CSE 209B,A00,108005,Bellare; Mihir,0,0,0,0
1668127037770,CSE 210,A00,113163,Coblenz; Michael J,0,0,0,0
1668127038195,CSE 219,A00,106111,Dow; Steven P,0,0,20,20
1668127038620,CSE 221,A00,102376,Voelker; Geoffrey M.,0,0,0,0
1668127039043,CSE 224,A01,102378,Porter; George M,0,0,0,0
1668127039466,CSE 229A,A00,102379,Savage; Stefan,0,0,0,0
1668127039902,CSE 229C,A00,102380,Munyaka; Imani N. S.,0,0,0,0
1668127040332,CSE 232B,A00,102382,Deutsch; Alin Bernard,0,0,0,0
1668127040755,CSE 234,A01,112904,Kumar; Arun Kumar,0,0,0,0
1668127041185,CSE 237A,A00,102383,Rosing; Tajana Simunic,0,0,0,0
1668127041609,CSE 239A,A00,102384,Deutsch; Alin Bernard,0,0,0,0
1668127042039,CSE 239B,A00,102385,Polikarpova; Nadezhda,0,0,0,0
1668127042462,CSE 240A,A00,102386,Pannuto; Patrick William,0,0,0,0
1668127042900,CSE 240B,A00,102387,Zhao; Jishen,0,0,0,0
1668127043330,CSE 241A,A00,106406,Kang; Mingu,0,0,0,0
1668127043757,CSE 249B,A00,102388,Kahng; Andrew Byun,0,0,8,8
1668127044193,CSE 251B,A01,102392,Cottrell; Garrison W,0,0,0,0
1668127044193,CSE 251B,A02,102393,Cottrell; Garrison W,0,0,0,0
1668127044622,CSE 252B,A00,102394,Ochoa; Benjamin Lawrence,0,0,0,0
1668127045070,CSE 257,A01,102396,Gao; Sicun,0,0,0,0
1668127045498,CSE 272,A00,102397,Li; Tzumao,0,0,0,0
1668127045921,CSE 274,A00,111323,Chern; Albert Ren-Haur,0,0,0,0
1668127046345,CSE 282,A00,102398,Pevzner; Pavel Arkadjevich,0,0,0,0
1668127046772,CSE 284,A00,114175,Gymrek; Melissa Ann,0,0,0,0
1668127047197,CSE 290,A00,102399,Chandraker; Manmohan Krishna,0,0,0,0
1668127047197,CSE 290,B00,102400,Vaccaro; Kristen Marie,0,0,25,25
1668127047197,CSE 290,C00,102414,Pannuto; Patrick William,0,0,25,25
1668127047197,CSE 290,D00,102427,Pevzner; Pavel Arkadjevich,0,0,0,0
1668127047197,CSE 290,E00,102429,Zhao; Jishen,0,0,0,0
1668127047197,CSE 290,F00,102436,Tullsen; Dean Michael,0,0,0,0
1668127047197,CSE 290,G00,102440,Christensen; Henrik I,0,0,20,20
1668127047621,CSE 291,A00,102443,Su; Hao,0,0,0,0
1668127047621,CSE 291,B00,102448,Polikarpova; Nadezhda,0,0,0,0
1668127047621,CSE 291,C00,102453,Vaccaro; Kristen Marie,0,0,0,0
1668127047621,CSE 291,D00,111343,Savage; Stefan,0,0,0,0
1668127047621,CSE 291,E00,116474,Claffy; Kimberly Claire,0,0,0,0
1668127047621,CSE 291,F00,116479,Pasquale; Joseph,0,0,0,0
1668127048050,CSE 293,001,119111,Bafna; Vineet,9999,0,9999,0
1668127048050,CSE 293,002,119118,Bellare; Mihir,9999,0,9999,0
1668127048050,CSE 293,003,119122,Berg-Kirkpatrick; Taylor D,9999,0,9999,0
1668127048050,CSE 293,004,119135,Christensen; Henrik I,9999,0,9999,0
1668127048050,CSE 293,005,119142,Cottrell; Garrison W,9999,0,9999,0
1668127048050,CSE 293,006,119146,Deutsch; Alin Bernard,9999,0,9999,0
1668127048050,CSE 293,007,119159,Esmaeilzadeh; Hadi,9999,0,9999,0
1668127048050,CSE 293,008,119166,Freund; Yoav,9999,0,9999,0
1668127048050,CSE 293,009,119170,Griswold; William G.,9999,0,9999,0
1668127048050,CSE 293,010,119183,Gymrek; Melissa Ann,9999,0,9999,0
1668127048050,CSE 293,011,119190,Heninger; Nadia A,9999,0,9999,0
1668127048050,CSE 293,012,119230,Impagliazzo; Russell,9999,0,9999,0
1668127048050,CSE 293,013,119232,Jhala; Ranjit,9999,0,9999,0
1668127048050,CSE 293,014,119233,Kahng; Andrew Byun,9999,0,9999,0
1668127048050,CSE 293,015,119298,Kane; Daniel Mertz,9999,0,9999,0
1668127048050,CSE 293,016,119299,Kriegman; David J,9999,0,9999,0
1668127048050,CSE 293,017,119300,Kumar; Arun Kumar,9999,0,9999,0
1668127048050,CSE 293,018,119301,Lerner; Sorin,9999,0,9999,0
1668127048050,CSE 293,019,119302,Lovett; Shachar,9999,0,9999,0
1668127048050,CSE 293,020,119303,McAuley; Julian John,9999,0,9999,0
1668127048050,CSE 293,021,119304,Micciancio; Daniele,9999,0,9999,0
1668127048050,CSE 293,022,119367,Orailoglu; Alex,9999,0,9999,0
1668127048050,CSE 293,023,119382,Paturi; Ramamohan,9999,0,9999,0
1668127048050,CSE 293,024,119404,Polikarpova; Nadezhda,9999,0,9999,0
1668127048050,CSE 293,025,119406,Politz; Joseph Gibbs,9999,0,9999,0
1668127048050,CSE 293,026,119411,Porter; George M,9999,0,9999,0
1668127048050,CSE 293,027,119414,Porter; Leonard Emerson,9999,0,9999,0
1668127048050,CSE 293,028,119416,Ramamoorthi; Ravi,9999,0,9999,0
1668127048050,CSE 293,029,119417,Sahoo; Debashis,9999,0,9999,0
1668127048050,CSE 293,030,119420,Saul; Lawrence,9999,0,9999,0
1668127048050,CSE 293,031,119421,Savage; Stefan,9999,0,9999,0
1668127048050,CSE 293,032,119425,Schulze; Jurgen P.,9999,0,9999,0
1668127048050,CSE 293,033,119426,Snoeren; Alex C.,9999,0,9999,0
1668127048050,CSE 293,034,119428,Shang; Jingbo,9999,0,9999,0
1668127048050,CSE 293,035,119430,Stefan; Deian,9999,0,9999,0
1668127048050,CSE 293,036,119431,Su; Hao,9999,0,9999,0
1668127048050,CSE 293,037,119433,Swanson; Steven James,9999,0,9999,0
1668127048050,CSE 293,038,119435,Tullsen; Dean Michael,9999,0,9999,0
1668127048050,CSE 293,039,119483,Voelker; Geoffrey M.,9999,0,9999,0
1668127048050,CSE 293,040,119537,Zhao; Jishen,9999,0,9999,0
1668127048050,CSE 293,041,119538,Zhou; Yuan-Yuan,9999,0,9999,0
1668127048050,CSE 293,042,119539,Gao; Sicun,9999,0,9999,0
1668127048050,CSE 293,043,119540,Weibel; Nadir,9999,0,9999,0
1668127048050,CSE 293,044,119541,Gupta; Rajesh K.,9999,0,9999,0
1668127048050,CSE 293,045,126410,Vaccaro; Kristen Marie,9999,0,9999,0
1668127048050,CSE 293,046,126411,Klemke; Richard,9999,0,9999,0
1668127048480,CSE 294,A00,102459,Voelker; Geoffrey M.,0,0,0,0
1668127048480,CSE 294,B00,111322,Orailoglu; Alex,0,0,0,0
1668127048917,DSE 201,A00,096914,Deutsch; Alin Bernard,30,0,30,0
1668127049352,DSE 210,A00,096915,Dasgupta; Sanjoy,30,0,30,0
1668127049777,DSE 260A,A00,096916,Altintas De Callaf; Ilkay,30,0,30,0
1668127050230,ECE 200,001,103586,Antipa; Nicholas A,9999,0,9999,0
1668127050230,ECE 200,002,103587,Atanasov; Nikolay A.,9999,0,9999,0
1668127050230,ECE 200,003,103588,Bharadia; Dinesh,9999,0,9999,0
1668127050230,ECE 200,004,103589,Cheng; Chung Kuan,9999,0,9999,0
1668127050230,ECE 200,005,103590,Cosman; Pamela C.,9999,0,9999,0
1668127050230,ECE 200,006,103591,Dayeh; Shadi Ahmad,9999,0,9999,0
1668127050230,ECE 200,007,103592,Fainman; Yeshaiahu,9999,0,9999,0
1668127050230,ECE 200,008,103593,Ford; Joseph Earl,9999,0,9999,0
1668127050230,ECE 200,009,103594,Franceschetti; Massimo,9999,0,9999,0
1668127050230,ECE 200,010,103595,Fullerton; Eric E,9999,0,9999,0
1668127050230,ECE 200,011,103596,Galton; Ian A,9999,0,9999,0
1668127050230,ECE 200,012,103597,Gilja; Vikash,9999,0,9999,0
1668127050230,ECE 200,013,103598,Hall; Drew A.,9999,0,9999,0
1668127050230,ECE 200,014,103599,Hsueh; Tzu-Chien,9999,0,9999,0
1668127050230,ECE 200,015,103600,Javidi; Tara,9999,0,9999,0
1668127050230,ECE 200,016,103601,Kahng; Andrew Byun,9999,0,9999,0
1668127050230,ECE 200,017,103602,Kim; Young-Han,9999,0,9999,0
1668127050230,ECE 200,018,103603,Koushanfar; Farinaz,9999,0,9999,0
1668127050230,ECE 200,019,103604,Kuzum; Duygu,9999,0,9999,0
1668127050230,ECE 200,020,103605,Le; Hanh-Phuc,9999,0,9999,0
1668127050230,ECE 200,021,103606,Lin; Bill,9999,0,9999,0
1668127050230,ECE 200,022,103607,Liu; Zhaowei,9998,0,9999,1
1668127050230,ECE 200,023,103608,Lo; Yu-Hwa,9999,0,9999,0
1668127050230,ECE 200,024,103609,Lomakin; Vitaliy,9999,0,9999,0
1668127050230,ECE 200,025,103610,Mercier; Patrick Philip,9999,0,9999,0
1668127050230,ECE 200,026,103611,Meyer; Florian,9999,0,9999,0
1668127050230,ECE 200,027,103612,Milstein; Laurence B.,9999,0,9999,0
1668127050230,ECE 200,028,103613,Mir Arabbaygi; Siavash,9999,0,9999,0
1668127050230,ECE 200,029,103614,Mookherjea; Shayan,9999,0,9999,0
1668127050230,ECE 200,030,103615,Morris; Karcher William,9999,0,9999,0
1668127050230,ECE 200,031,103616,Ng; Tse Nga,9999,0,9999,0
1668127050230,ECE 200,032,103617,Nguyen; Truong Quang,9999,0,9999,0
1668127050230,ECE 200,033,103618,Nomura; Kenji,9999,0,9999,0
1668127050230,ECE 200,034,103619,Orlitsky; Alon,9999,0,9999,0
1668127050230,ECE 200,035,103620,Pal; Piya,9999,0,9999,0
1668127050230,ECE 200,036,103621,Papen; George C.,9999,0,9999,0
1668127050230,ECE 200,037,103622,Radic; Stojan,9999,0,9999,0
1668127050230,ECE 200,038,103623,Rao; Bhaskar D.,9999,0,9999,0
1668127050230,ECE 200,039,103624,Rao; Ramesh R,9999,0,9999,0
1668127050230,ECE 200,040,103625,Rebeiz; Gabriel,9999,0,9999,0
1668127050230,ECE 200,041,103626,Sanford; John R,9999,0,9999,0
1668127050230,ECE 200,042,103627,Siegel; Paul H.,9999,0,9999,0
1668127050230,ECE 200,043,103628,Sievenpiper; Daniel F.,9999,0,9999,0
1668127050230,ECE 200,044,103629,Sworder; David D.,9999,0,9999,0
1668127050230,ECE 200,045,103630,Taur; Yuan,9999,0,9999,0
1668127050230,ECE 200,046,103631,Touri; Behrouz,9999,0,9999,0
1668127050230,ECE 200,047,103632,Trivedi; Mohan M.,9999,0,9999,0
1668127050230,ECE 200,048,103633,Vasconcelos; Nuno,9999,0,9999,0
1668127050230,ECE 200,049,103634,Wang; Xiaolong,9999,0,9999,0
1668127050230,ECE 200,050,103635,Xie; Pengtao,9999,0,9999,0
1668127050230,ECE 200,051,103636,Yip; Michael,9999,0,9999,0
1668127050230,ECE 200,052,103637,Zeger; Kenneth A.,999,0,999,0
1668127050230,ECE 200,053,103638,Zhang; Xinyu,9999,0,9999,0
1668127050230,ECE 200,054,103639,Turakhia; Yatish Girish,9999,0,9999,0
1668127050230,ECE 200,055,103640,Kang; Mingu,9999,0,9999,0
1668127050230,ECE 200,056,103641,Shi; Yuanyuan,9999,0,9999,0
1668127050230,ECE 200,057,103642,Wang; Edward Jay,9999,0,9999,0
1668127050230,ECE 200,058,103643,Zheng; Yang,9999,0,9999,0
1668127050660,ECE 202,A00,103644,Kuzum; Duygu,0,0,0,0
1668127051084,ECE 212BN,A00,103646,Ng; Tse Nga,0,0,0,0
1668127051514,ECE 221,A00,111493,Staff,0,0,0,0
1668127051937,ECE 222B,A00,103647,Lomakin; Vitaliy,0,0,0,0
1668127052359,ECE 230B,A00,103648,Taur; Yuan,0,0,0,0
1668127052783,ECE 238B,A00,103649,Garay; Javier,0,0,0,0
1668127053214,ECE 240B,A00,112900,Fainman; Yeshaiahu,0,0,0,0
1668127053636,ECE 247A,A00,103650,Jokerst; Jesse Vincent,0,0,0,0
1668127054060,ECE 247B,A00,103651,Wang; Joseph,0,0,0,0
1668127054492,ECE 250,A00,103652,Siegel; Paul H.,0,0,0,0
1668127054921,ECE 251A,A00,103654,Rao; Bhaskar D.,0,0,0,0
1668127055355,ECE 257B,A00,103655,Bharadia; Dinesh,0,0,0,0
1668127055783,ECE 258A,A00,103656,Milstein; Laurence B.,0,0,0,0
1668127056210,ECE 260B,A00,103658,Kang; Mingu,0,0,0,0
1668127056632,ECE 264A,A00,103659,Galton; Ian A,0,0,0,0
1668127057056,ECE 265A,A00,103661,Gudem; Prasad S.S.,0,0,0,0
1668127057485,ECE 265D,A00,103662,Gudem; Prasad S.S.,0,0,0,0
1668127057909,ECE 268,A00,103663,Koushanfar; Farinaz,0,0,0,0
1668127058332,ECE 269,A01,103665,Pal; Piya,0,0,0,0
1668127058765,ECE 271B,A00,103666,Vasconcelos; Manuela,0,0,0,0
1668127059187,ECE 276A,A00,103667,Atanasov; Nikolay A.,0,0,0,0
1668127059615,ECE 277,A00,103668,An; Cheolhong,0,0,0,0
1668127060036,ECE 279,A00,117947,Hall; Drew A.,0,0,0,0
1668127060902,ECE 283,A00,103670,Hsueh; Tzu-Chien,0,0,0,0
1668127061327,ECE 284,A00,103671,Turakhia; Yatish Girish,0,0,0,0
1668127061762,ECE 285,A00,103672,Zheng; Yang,0,0,0,0
1668127061762,ECE 285,B00,103673,Sworder; David D.,0,0,0,0
1668127062197,ECE 287,A00,103676,Javidi; Tara,0,0,0,0
1668127062622,MATH 200B,A00,098023,Salehi Golsefidy; Alireza,12,0,15,3
1668127063049,MATH 202B,A00,098024,Rhoades; Brendon Patrick,9,0,15,6
1668127063473,MATH 203B,A00,098025,Oprea; Dragos N.,10,0,15,5
1668127063898,MATH 204B,A00,098026,Sorensen; Claus M,13,0,15,2
1668127064322,MATH 208,A00,098027,Izadi; Elham,7,0,10,3
1668127064750,MATH 209,A00,098028,Pollack; Aaron,10,0,10,0
1668127065178,MATH 211A,A00,112919,Rogalski; Daniel,9,0,10,1
1668127065609,MATH 211B,A00,112920,Seward; Brandon M.,9,0,10,1
1668127066032,MATH 218,A00,098029,Li; Bo,10,0,10,0
1668127066473,MATH 220B,A00,098030,Novak; Jonathan I,11,0,15,4
1668127066906,MATH 221A,A00,098031,Ebenfelt; Peter F,13,0,15,2
1668127067339,MATH 231B,A00,098032,Zlatos; Andrej,12,0,15,3
1668127067767,MATH 240B,A00,098033,Ni; Lei,9,0,15,6
1668127068219,MATH 243,A00,098034,Jekel; David Andrew,10,0,10,0
1668127068642,MATH 245A,A00,098035,Nie; Jiawang,0,0,15,16
1668127069067,MATH 248,A00,098036,Bejenaru; Ioan,10,0,10,0
1668127069507,MATH 250B,A00,098037,Spolaor; Luca,14,0,15,1
1668127069934,MATH 258,A00,098038,Ni; Lei,10,0,10,0
1668127070361,MATH 264B,A00,098041,Rhoades; Brendon Patrick,9,0,15,6
1668127070801,MATH 268,A00,098042,Buss; Samuel R,10,0,10,0
1668127071223,MATH 269,A00,098043,Rhoades; Brendon Patrick,10,0,10,0
1668127071645,MATH 270B,A00,098044,Li; Bo,10,0,15,5
1668127072068,MATH 272B,A00,098045,Holst; Michael J,13,0,15,2
1668127072507,MATH 273A,A00,098046,Tian; Xiaochuan,10,0,15,5
1668127072930,MATH 275,A01,098048,Tian; Xiaochuan,6,0,10,4
1668127073458,MATH 278A,A00,098049,Holst; Michael J,8,0,10,2
1668127073882,MATH 278B,A00,098050,Cloninger; Alexander,10,0,10,0
1668127074304,MATH 278C,A00,098051,Nie; Jiawang,7,0,10,3
1668127074727,MATH 280B,A00,098052,Zheng; Tianyi,10,0,15,5
1668127075160,MATH 281B,A00,098053,Bradic; Jelena,2,0,15,13
1668127075583,MATH 282B,A00,098054,Arias-Castro; Ery,0,0,15,15
1668127076019,MATH 285,A00,098055,Fitzsimmons; Patrick J,0,0,15,17
1668127076450,MATH 287B,A00,098056,Arias-Castro; Ery,3,0,15,12
1668127076873,MATH 288,A00,098057,Agarwal; Pooja,9,0,10,1
1668127076873,MATH 288,B00,098058,Zhang; Danna,8,0,10,2
1668127076873,MATH 288,C00,098059,Williams; Ruth J,10,0,10,0
1668127077296,MATH 290B,A00,098060,Roberts; Justin Deritter,13,0,15,2
1668127077720,MATH 292,A00,098061,Belmont; Eva Kinoshita,10,0,10,0
1668127078152,MATH 295,A00,098062,Suk; Andrew Hoon,48,0,50,2
1668127078574,MATH 296,A00,098063,Novak; Jonathan I,20,0,20,0
1668127078999,MATH 297,001,098064,Gamst; Anthony Collins,9997,0,9999,2
1668127593767,COGS 205,A00,101395,Chiba; Andrea,19,0,20,1
1668127594201,COGS 210B,001,101404,Greene; Deanna Jacquelyn,9998,0,9999,1
1668127594201,COGS 210B,002,101417,Xia; Haijun,9999,0,9999,0
1668127594201,COGS 210B,003,101422,Nitz; Douglas A.,9999,0,9999,0
1668127594201,COGS 210B,004,101423,Hollan; James D.,9998,0,9999,1
1668127594201,COGS 210B,005,101424,Deak; Gedeon O.,9998,0,9999,1
1668127594201,COGS 210B,006,101425,Rossano; Federico,9999,0,9999,0
1668127594625,COGS 211B,A00,101427,Coulson; Seana M,9996,0,9999,3
1668127595048,COGS 220,A00,101428,Hollan; James D.,0,0,25,25
1668127595476,COGS 229,A00,101429,Dow; Steven P,18,0,25,7
1668127595904,COGS 230,A00,101430,Klemmer; Scott R,12,0,17,5
1668127596337,COGS 234,A00,101431,Xia; Haijun,3,0,25,22
1668127596772,COGS 260,A00,101432,Kiyonaga; Anastasia,20,0,25,5
1668127596772,COGS 260,B00,101433,Kirsh; David Joel,16,0,25,9
1668127597194,CSE 202,A00,102371,Impagliazzo; Russell,0,0,0,0
1668127597622,CSE 203B,A01,102373,Cheng; Chung Kuan,0,0,0,0
1668127598061,CSE 208,A00,102374,Micciancio; Daniele,0,0,0,0
1668127598485,CSE 209A,A00,112895,Impagliazzo; Russell,0,0,15,15
1668127598915,CSE 209B,A00,108005,Bellare; Mihir,0,0,0,0
1668127599346,CSE 210,A00,113163,Coblenz; Michael J,0,0,0,0
1668127599769,CSE 219,A00,106111,Dow; Steven P,0,0,20,20
1668127600202,CSE 221,A00,102376,Voelker; Geoffrey M.,0,0,0,0
1668127600645,CSE 224,A01,102378,Porter; George M,0,0,0,0
1668127601072,CSE 229A,A00,102379,Savage; Stefan,0,0,0,0
1668127601495,CSE 229C,A00,102380,Munyaka; Imani N. S.,0,0,0,0
1668127601921,CSE 232B,A00,102382,Deutsch; Alin Bernard,0,0,0,0
1668127602356,CSE 234,A01,112904,Kumar; Arun Kumar,0,0,0,0
1668127602779,CSE 237A,A00,102383,Rosing; Tajana Simunic,0,0,0,0
1668127603202,CSE 239A,A00,102384,Deutsch; Alin Bernard,0,0,0,0
1668127603626,CSE 239B,A00,102385,Polikarpova; Nadezhda,0,0,0,0
1668127604054,CSE 240A,A00,102386,Pannuto; Patrick William,0,0,0,0
1668127604485,CSE 240B,A00,102387,Zhao; Jishen,0,0,0,0
1668127604913,CSE 241A,A00,106406,Kang; Mingu,0,0,0,0
1668127605353,CSE 249B,A00,102388,Kahng; Andrew Byun,0,0,8,8
1668127605781,CSE 251B,A01,102392,Cottrell; Garrison W,0,0,0,0
1668127605781,CSE 251B,A02,102393,Cottrell; Garrison W,0,0,0,0
1668127606204,CSE 252B,A00,102394,Ochoa; Benjamin Lawrence,0,0,0,0
1668127606643,CSE 257,A01,102396,Gao; Sicun,0,0,0,0
1668127607067,CSE 272,A00,102397,Li; Tzumao,0,0,0,0
1668127607504,CSE 274,A00,111323,Chern; Albert Ren-Haur,0,0,0,0
1668127607937,CSE 282,A00,102398,Pevzner; Pavel Arkadjevich,0,0,0,0
1668127608440,CSE 284,A00,114175,Gymrek; Melissa Ann,0,0,0,0
1668127608864,CSE 290,A00,102399,Chandraker; Manmohan Krishna,0,0,0,0
1668127608864,CSE 290,B00,102400,Vaccaro; Kristen Marie,0,0,25,25
1668127608864,CSE 290,C00,102414,Pannuto; Patrick William,0,0,25,25
1668127608864,CSE 290,D00,102427,Pevzner; Pavel Arkadjevich,0,0,0,0
1668127608864,CSE 290,E00,102429,Zhao; Jishen,0,0,0,0
1668127608864,CSE 290,F00,102436,Tullsen; Dean Michael,0,0,0,0
1668127608864,CSE 290,G00,102440,Christensen; Henrik I,0,0,20,20
1668127609303,CSE 291,A00,102443,Su; Hao,0,0,0,0
1668127609303,CSE 291,B00,102448,Polikarpova; Nadezhda,0,0,0,0
1668127609303,CSE 291,C00,102453,Vaccaro; Kristen Marie,0,0,0,0
1668127609303,CSE 291,D00,111343,Savage; Stefan,0,0,0,0
1668127609303,CSE 291,E00,116474,Claffy; Kimberly Claire,0,0,0,0
1668127609303,CSE 291,F00,116479,Pasquale; Joseph,0,0,0,0
1668127609768,CSE 293,001,119111,Bafna; Vineet,9999,0,9999,0
1668127609768,CSE 293,002,119118,Bellare; Mihir,9999,0,9999,0
1668127609768,CSE 293,003,119122,Berg-Kirkpatrick; Taylor D,9999,0,9999,0
1668127609768,CSE 293,004,119135,Christensen; Henrik I,9999,0,9999,0
1668127609768,CSE 293,005,119142,Cottrell; Garrison W,9999,0,9999,0
1668127609768,CSE 293,006,119146,Deutsch; Alin Bernard,9999,0,9999,0
1668127609768,CSE 293,007,119159,Esmaeilzadeh; Hadi,9999,0,9999,0
1668127609768,CSE 293,008,119166,Freund; Yoav,9999,0,9999,0
1668127609768,CSE 293,009,119170,Griswold; William G.,9999,0,9999,0
1668127609768,CSE 293,010,119183,Gymrek; Melissa Ann,9999,0,9999,0
1668127609768,CSE 293,011,119190,Heninger; Nadia A,9999,0,9999,0
1668127609768,CSE 293,012,119230,Impagliazzo; Russell,9999,0,9999,0
1668127609768,CSE 293,013,119232,Jhala; Ranjit,9999,0,9999,0
1668127609768,CSE 293,014,119233,Kahng; Andrew Byun,9999,0,9999,0
1668127609768,CSE 293,015,119298,Kane; Daniel Mertz,9999,0,9999,0
1668127609768,CSE 293,016,119299,Kriegman; David J,9999,0,9999,0
1668127609768,CSE 293,017,119300,Kumar; Arun Kumar,9999,0,9999,0
1668127609768,CSE 293,018,119301,Lerner; Sorin,9999,0,9999,0
1668127609768,CSE 293,019,119302,Lovett; Shachar,9999,0,9999,0
1668127609768,CSE 293,020,119303,McAuley; Julian John,9999,0,9999,0
1668127609768,CSE 293,021,119304,Micciancio; Daniele,9999,0,9999,0
1668127609768,CSE 293,022,119367,Orailoglu; Alex,9999,0,9999,0
1668127609768,CSE 293,023,119382,Paturi; Ramamohan,9999,0,9999,0
1668127609768,CSE 293,024,119404,Polikarpova; Nadezhda,9999,0,9999,0
1668127609768,CSE 293,025,119406,Politz; Joseph Gibbs,9999,0,9999,0
1668127609768,CSE 293,026,119411,Porter; George M,9999,0,9999,0
1668127609768,CSE 293,027,119414,Porter; Leonard Emerson,9999,0,9999,0
1668127609768,CSE 293,028,119416,Ramamoorthi; Ravi,9999,0,9999,0
1668127609768,CSE 293,029,119417,Sahoo; Debashis,9999,0,9999,0
1668127609768,CSE 293,030,119420,Saul; Lawrence,9999,0,9999,0
1668127609768,CSE 293,031,119421,Savage; Stefan,9999,0,9999,0
1668127609768,CSE 293,032,119425,Schulze; Jurgen P.,9999,0,9999,0
1668127609768,CSE 293,033,119426,Snoeren; Alex C.,9999,0,9999,0
1668127609768,CSE 293,034,119428,Shang; Jingbo,9999,0,9999,0
1668127609768,CSE 293,035,119430,Stefan; Deian,9999,0,9999,0
1668127609768,CSE 293,036,119431,Su; Hao,9999,0,9999,0
1668127609768,CSE 293,037,119433,Swanson; Steven James,9999,0,9999,0
1668127609768,CSE 293,038,119435,Tullsen; Dean Michael,9999,0,9999,0
1668127609768,CSE 293,039,119483,Voelker; Geoffrey M.,9999,0,9999,0
1668127609768,CSE 293,040,119537,Zhao; Jishen,9999,0,9999,0
1668127609768,CSE 293,041,119538,Zhou; Yuan-Yuan,9999,0,9999,0
1668127609768,CSE 293,042,119539,Gao; Sicun,9999,0,9999,0
1668127609768,CSE 293,043,119540,Weibel; Nadir,9999,0,9999,0
1668127609768,CSE 293,044,119541,Gupta; Rajesh K.,9999,0,9999,0
1668127609768,CSE 293,045,126410,Vaccaro; Kristen Marie,9999,0,9999,0
1668127609768,CSE 293,046,126411,Klemke; Richard,9999,0,9999,0
1668127610196,CSE 294,A00,102459,Voelker; Geoffrey M.,0,0,0,0
1668127610196,CSE 294,B00,111322,Orailoglu; Alex,0,0,0,0
1668127610621,DSE 201,A00,096914,Deutsch; Alin Bernard,30,0,30,0
1668127611046,DSE 210,A00,096915,Dasgupta; Sanjoy,30,0,30,0
1668127611472,DSE 260A,A00,096916,Altintas De Callaf; Ilkay,30,0,30,0
1668127611911,ECE 200,001,103586,Antipa; Nicholas A,9999,0,9999,0
1668127611911,ECE 200,002,103587,Atanasov; Nikolay A.,9999,0,9999,0
1668127611911,ECE 200,003,103588,Bharadia; Dinesh,9999,0,9999,0
1668127611911,ECE 200,004,103589,Cheng; Chung Kuan,9999,0,9999,0
1668127611911,ECE 200,005,103590,Cosman; Pamela C.,9999,0,9999,0
1668127611911,ECE 200,006,103591,Dayeh; Shadi Ahmad,9999,0,9999,0
1668127611911,ECE 200,007,103592,Fainman; Yeshaiahu,9999,0,9999,0
1668127611911,ECE 200,008,103593,Ford; Joseph Earl,9999,0,9999,0
1668127611911,ECE 200,009,103594,Franceschetti; Massimo,9999,0,9999,0
1668127611911,ECE 200,010,103595,Fullerton; Eric E,9999,0,9999,0
1668127611911,ECE 200,011,103596,Galton; Ian A,9999,0,9999,0
1668127611911,ECE 200,012,103597,Gilja; Vikash,9999,0,9999,0
1668127611911,ECE 200,013,103598,Hall; Drew A.,9999,0,9999,0
1668127611911,ECE 200,014,103599,Hsueh; Tzu-Chien,9999,0,9999,0
1668127611911,ECE 200,015,103600,Javidi; Tara,9999,0,9999,0
1668127611911,ECE 200,016,103601,Kahng; Andrew Byun,9999,0,9999,0
1668127611911,ECE 200,017,103602,Kim; Young-Han,9999,0,9999,0
1668127611911,ECE 200,018,103603,Koushanfar; Farinaz,9999,0,9999,0
1668127611911,ECE 200,019,103604,Kuzum; Duygu,9999,0,9999,0
1668127611911,ECE 200,020,103605,Le; Hanh-Phuc,9999,0,9999,0
1668127611911,ECE 200,021,103606,Lin; Bill,9999,0,9999,0
1668127611911,ECE 200,022,103607,Liu; Zhaowei,9998,0,9999,1
1668127611911,ECE 200,023,103608,Lo; Yu-Hwa,9999,0,9999,0
1668127611911,ECE 200,024,103609,Lomakin; Vitaliy,9999,0,9999,0
1668127611911,ECE 200,025,103610,Mercier; Patrick Philip,9999,0,9999,0
1668127611911,ECE 200,026,103611,Meyer; Florian,9999,0,9999,0
1668127611911,ECE 200,027,103612,Milstein; Laurence B.,9999,0,9999,0
1668127611911,ECE 200,028,103613,Mir Arabbaygi; Siavash,9999,0,9999,0
1668127611911,ECE 200,029,103614,Mookherjea; Shayan,9999,0,9999,0
1668127611911,ECE 200,030,103615,Morris; Karcher William,9999,0,9999,0
1668127611911,ECE 200,031,103616,Ng; Tse Nga,9999,0,9999,0
1668127611911,ECE 200,032,103617,Nguyen; Truong Quang,9999,0,9999,0
1668127611911,ECE 200,033,103618,Nomura; Kenji,9999,0,9999,0
1668127611911,ECE 200,034,103619,Orlitsky; Alon,9999,0,9999,0
1668127611911,ECE 200,035,103620,Pal; Piya,9999,0,9999,0
1668127611911,ECE 200,036,103621,Papen; George C.,9999,0,9999,0
1668127611911,ECE 200,037,103622,Radic; Stojan,9999,0,9999,0
1668127611911,ECE 200,038,103623,Rao; Bhaskar D.,9999,0,9999,0
1668127611911,ECE 200,039,103624,Rao; Ramesh R,9999,0,9999,0
1668127611911,ECE 200,040,103625,Rebeiz; Gabriel,9999,0,9999,0
1668127611911,ECE 200,041,103626,Sanford; John R,9999,0,9999,0
1668127611911,ECE 200,042,103627,Siegel; Paul H.,9999,0,9999,0
1668127611911,ECE 200,043,103628,Sievenpiper; Daniel F.,9999,0,9999,0
1668127611911,ECE 200,044,103629,Sworder; David D.,9999,0,9999,0
1668127611911,ECE 200,045,103630,Taur; Yuan,9999,0,9999,0
1668127611911,ECE 200,046,103631,Touri; Behrouz,9999,0,9999,0
1668127611911,ECE 200,047,103632,Trivedi; Mohan M.,9999,0,9999,0
1668127611911,ECE 200,048,103633,Vasconcelos; Nuno,9999,0,9999,0
1668127611911,ECE 200,049,103634,Wang; Xiaolong,9999,0,9999,0
1668127611911,ECE 200,050,103635,Xie; Pengtao,9999,0,9999,0
1668127611911,ECE 200,051,103636,Yip; Michael,9999,0,9999,0
1668127611911,ECE 200,052,103637,Zeger; Kenneth A.,999,0,999,0
1668127611911,ECE 200,053,103638,Zhang; Xinyu,9999,0,9999,0
1668127611911,ECE 200,054,103639,Turakhia; Yatish Girish,9999,0,9999,0
1668127611911,ECE 200,055,103640,Kang; Mingu,9999,0,9999,0
1668127611911,ECE 200,056,103641,Shi; Yuanyuan,9999,0,9999,0
1668127611911,ECE 200,057,103642,Wang; Edward Jay,9999,0,9999,0
1668127611911,ECE 200,058,103643,Zheng; Yang,9999,0,9999,0
1668127612351,ECE 202,A00,103644,Kuzum; Duygu,0,0,0,0
1668127612785,ECE 212BN,A00,103646,Ng; Tse Nga,0,0,0,0
1668127613215,ECE 221,A00,111493,Staff,0,0,0,0
1668127613646,ECE 222B,A00,103647,Lomakin; Vitaliy,0,0,0,0
1668127614073,ECE 230B,A00,103648,Taur; Yuan,0,0,0,0
1668127614499,ECE 238B,A00,103649,Garay; Javier,0,0,0,0
1668127614930,ECE 240B,A00,112900,Fainman; Yeshaiahu,0,0,0,0
1668127615353,ECE 247A,A00,103650,Jokerst; Jesse Vincent,0,0,0,0
1668127615777,ECE 247B,A00,103651,Wang; Joseph,0,0,0,0
1668127616201,ECE 250,A00,103652,Siegel; Paul H.,0,0,0,0
1668127616624,ECE 251A,A00,103654,Rao; Bhaskar D.,0,0,0,0
1668127617050,ECE 257B,A00,103655,Bharadia; Dinesh,0,0,0,0
1668127617485,ECE 258A,A00,103656,Milstein; Laurence B.,0,0,0,0
1668127617908,ECE 260B,A00,103658,Kang; Mingu,0,0,0,0
1668127618334,ECE 264A,A00,103659,Galton; Ian A,0,0,0,0
1668127618757,ECE 265A,A00,103661,Gudem; Prasad S.S.,0,0,0,0
1668127619185,ECE 265D,A00,103662,Gudem; Prasad S.S.,0,0,0,0
1668127619608,ECE 268,A00,103663,Koushanfar; Farinaz,0,0,0,0
1668127620033,ECE 269,A01,103665,Pal; Piya,0,0,0,0
1668127620460,ECE 271B,A00,103666,Vasconcelos; Manuela,0,0,0,0
1668127620884,ECE 276A,A00,103667,Atanasov; Nikolay A.,0,0,0,0
1668127621312,ECE 277,A00,103668,An; Cheolhong,0,0,0,0
1668127621734,ECE 279,A00,117947,Hall; Drew A.,0,0,0,0
1668127622583,ECE 283,A00,103670,Hsueh; Tzu-Chien,0,0,0,0
1668127623007,ECE 284,A00,103671,Turakhia; Yatish Girish,0,0,0,0
1668127623448,ECE 285,A00,103672,Zheng; Yang,0,0,0,0
1668127623448,ECE 285,B00,103673,Sworder; David D.,0,0,0,0
1668127623884,ECE 287,A00,103676,Javidi; Tara,0,0,0,0
1668127624320,MATH 200B,A00,098023,Salehi Golsefidy; Alireza,12,0,15,3
1668127624742,MATH 202B,A00,098024,Rhoades; Brendon Patrick,9,0,15,6
1668127625167,MATH 203B,A00,098025,Oprea; Dragos N.,10,0,15,5
1668127625595,MATH 204B,A00,098026,Sorensen; Claus M,13,0,15,2
1668127626019,MATH 208,A00,098027,Izadi; Elham,7,0,10,3
1668127626455,MATH 209,A00,098028,Pollack; Aaron,10,0,10,0
1668127626877,MATH 211A,A00,112919,Rogalski; Daniel,9,0,10,1
1668127627300,MATH 211B,A00,112920,Seward; Brandon M.,9,0,10,1
1668127627724,MATH 218,A00,098029,Li; Bo,10,0,10,0
1668127628149,MATH 220B,A00,098030,Novak; Jonathan I,11,0,15,4
1668127628586,MATH 221A,A00,098031,Ebenfelt; Peter F,13,0,15,2
1668127629009,MATH 231B,A00,098032,Zlatos; Andrej,12,0,15,3
1668127629434,MATH 240B,A00,098033,Ni; Lei,9,0,15,6
1668127629858,MATH 243,A00,098034,Jekel; David Andrew,10,0,10,0
1668127630299,MATH 245A,A00,098035,Nie; Jiawang,0,0,15,16
1668127630733,MATH 248,A00,098036,Bejenaru; Ioan,10,0,10,0
1668127631167,MATH 250B,A00,098037,Spolaor; Luca,14,0,15,1
1668127631592,MATH 258,A00,098038,Ni; Lei,10,0,10,0
1668127632026,MATH 264B,A00,098041,Rhoades; Brendon Patrick,9,0,15,6
1668127632458,MATH 268,A00,098042,Buss; Samuel R,10,0,10,0
1668127632887,MATH 269,A00,098043,Rhoades; Brendon Patrick,10,0,10,0
1668127633330,MATH 270B,A00,098044,Li; Bo,10,0,15,5
1668127633752,MATH 272B,A00,098045,Holst; Michael J,13,0,15,2
1668127634184,MATH 273A,A00,098046,Tian; Xiaochuan,10,0,15,5
1668127634617,MATH 275,A01,098048,Tian; Xiaochuan,6,0,10,4
1668127635038,MATH 278A,A00,098049,Holst; Michael J,8,0,10,2
1668127635467,MATH 278B,A00,098050,Cloninger; Alexander,10,0,10,0
1668127635896,MATH 278C,A00,098051,Nie; Jiawang,7,0,10,3
1668127636323,MATH 280B,A00,098052,Zheng; Tianyi,10,0,15,5
1668127636751,MATH 281B,A00,098053,Bradic; Jelena,2,0,15,13
1668127637178,MATH 282B,A00,098054,Arias-Castro; Ery,0,0,15,15
1668127637613,MATH 285,A00,098055,Fitzsimmons; Patrick J,0,0,15,17
1668127638036,MATH 287B,A00,098056,Arias-Castro; Ery,3,0,15,12
1668127638466,MATH 288,A00,098057,Agarwal; Pooja,9,0,10,1
1668127638466,MATH 288,B00,098058,Zhang; Danna,8,0,10,2
1668127638466,MATH 288,C00,098059,Williams; Ruth J,10,0,10,0
1668127638894,MATH 290B,A00,098060,Roberts; Justin Deritter,13,0,15,2
1668127639317,MATH 292,A00,098061,Belmont; Eva Kinoshita,10,0,10,0
1668127639739,MATH 295,A00,098062,Suk; Andrew Hoon,48,0,50,2
1668127640162,MATH 296,A00,098063,Novak; Jonathan I,20,0,20,0
1668127640585,MATH 297,001,098064,Gamst; Anthony Collins,9997,0,9999,2
1668128144427,COGS 205,A00,101395,Chiba; Andrea,19,0,20,1
1668128144850,COGS 210B,001,101404,Greene; Deanna Jacquelyn,9998,0,9999,1
1668128144850,COGS 210B,002,101417,Xia; Haijun,9999,0,9999,0
1668128144850,COGS 210B,003,101422,Nitz; Douglas A.,9999,0,9999,0
1668128144850,COGS 210B,004,101423,Hollan; James D.,9998,0,9999,1
1668128144850,COGS 210B,005,101424,Deak; Gedeon O.,9998,0,9999,1
1668128144850,COGS 210B,006,101425,Rossano; Federico,9999,0,9999,0
1668128145276,COGS 211B,A00,101427,Coulson; Seana M,9996,0,9999,3
1668128145706,COGS 220,A00,101428,Hollan; James D.,0,0,25,25
1668128146132,COGS 229,A00,101429,Dow; Steven P,18,0,25,7
1668128146557,COGS 230,A00,101430,Klemmer; Scott R,12,0,17,5
1668128146979,COGS 234,A00,101431,Xia; Haijun,3,0,25,22
1668128147402,COGS 260,A00,101432,Kiyonaga; Anastasia,20,0,25,5
1668128147402,COGS 260,B00,101433,Kirsh; David Joel,16,0,25,9
1668128147825,CSE 202,A00,102371,Impagliazzo; Russell,0,0,0,0
1668128148249,CSE 203B,A01,102373,Cheng; Chung Kuan,0,0,0,0
1668128148673,CSE 208,A00,102374,Micciancio; Daniele,0,0,0,0
1668128149103,CSE 209A,A00,112895,Impagliazzo; Russell,0,0,15,15
1668128149525,CSE 209B,A00,108005,Bellare; Mihir,0,0,0,0
1668128149949,CSE 210,A00,113163,Coblenz; Michael J,0,0,0,0
1668128150391,CSE 219,A00,106111,Dow; Steven P,0,0,20,20
1668128150818,CSE 221,A00,102376,Voelker; Geoffrey M.,0,0,0,0
1668128151254,CSE 224,A01,102378,Porter; George M,0,0,0,0
1668128151686,CSE 229A,A00,102379,Savage; Stefan,0,0,0,0
1668128152110,CSE 229C,A00,102380,Munyaka; Imani N. S.,0,0,0,0
1668128152535,CSE 232B,A00,102382,Deutsch; Alin Bernard,0,0,0,0
1668128152964,CSE 234,A01,112904,Kumar; Arun Kumar,0,0,0,0
1668128153388,CSE 237A,A00,102383,Rosing; Tajana Simunic,0,0,0,0
1668128153819,CSE 239A,A00,102384,Deutsch; Alin Bernard,0,0,0,0
1668128154240,CSE 239B,A00,102385,Polikarpova; Nadezhda,0,0,0,0
1668128154663,CSE 240A,A00,102386,Pannuto; Patrick William,0,0,0,0
1668128155088,CSE 240B,A00,102387,Zhao; Jishen,0,0,0,0
1668128155525,CSE 241A,A00,106406,Kang; Mingu,0,0,0,0
1668128155950,CSE 249B,A00,102388,Kahng; Andrew Byun,0,0,8,8
1668128156379,CSE 251B,A01,102392,Cottrell; Garrison W,0,0,0,0
1668128156379,CSE 251B,A02,102393,Cottrell; Garrison W,0,0,0,0
1668128156829,CSE 252B,A00,102394,Ochoa; Benjamin Lawrence,0,0,0,0
1668128157251,CSE 257,A01,102396,Gao; Sicun,0,0,0,0
1668128157679,CSE 272,A00,102397,Li; Tzumao,0,0,0,0
1668128158102,CSE 274,A00,111323,Chern; Albert Ren-Haur,0,0,0,0
1668128158527,CSE 282,A00,102398,Pevzner; Pavel Arkadjevich,0,0,0,0
1668128158949,CSE 284,A00,114175,Gymrek; Melissa Ann,0,0,0,0
1668128159374,CSE 290,A00,102399,Chandraker; Manmohan Krishna,0,0,0,0
1668128159374,CSE 290,B00,102400,Vaccaro; Kristen Marie,0,0,25,25
1668128159374,CSE 290,C00,102414,Pannuto; Patrick William,0,0,25,25
1668128159374,CSE 290,D00,102427,Pevzner; Pavel Arkadjevich,0,0,0,0
1668128159374,CSE 290,E00,102429,Zhao; Jishen,0,0,0,0
1668128159374,CSE 290,F00,102436,Tullsen; Dean Michael,0,0,0,0
1668128159374,CSE 290,G00,102440,Christensen; Henrik I,0,0,20,20
1668128159796,CSE 291,A00,102443,Su; Hao,0,0,0,0
1668128159796,CSE 291,B00,102448,Polikarpova; Nadezhda,0,0,0,0
1668128159796,CSE 291,C00,102453,Vaccaro; Kristen Marie,0,0,0,0
1668128159796,CSE 291,D00,111343,Savage; Stefan,0,0,0,0
1668128159796,CSE 291,E00,116474,Claffy; Kimberly Claire,0,0,0,0
1668128159796,CSE 291,F00,116479,Pasquale; Joseph,0,0,0,0
1668128160223,CSE 293,001,119111,Bafna; Vineet,9999,0,9999,0
1668128160223,CSE 293,002,119118,Bellare; Mihir,9999,0,9999,0
1668128160223,CSE 293,003,119122,Berg-Kirkpatrick; Taylor D,9999,0,9999,0
1668128160223,CSE 293,004,119135,Christensen; Henrik I,9999,0,9999,0
1668128160223,CSE 293,005,119142,Cottrell; Garrison W,9999,0,9999,0
1668128160223,CSE 293,006,119146,Deutsch; Alin Bernard,9999,0,9999,0
1668128160223,CSE 293,007,119159,Esmaeilzadeh; Hadi,9999,0,9999,0
1668128160223,CSE 293,008,119166,Freund; Yoav,9999,0,9999,0
1668128160223,CSE 293,009,119170,Griswold; William G.,9999,0,9999,0
1668128160223,CSE 293,010,119183,Gymrek; Melissa Ann,9999,0,9999,0
1668128160223,CSE 293,011,119190,Heninger; Nadia A,9999,0,9999,0
1668128160223,CSE 293,012,119230,Impagliazzo; Russell,9999,0,9999,0
1668128160223,CSE 293,013,119232,Jhala; Ranjit,9999,0,9999,0
1668128160223,CSE 293,014,119233,Kahng; Andrew Byun,9999,0,9999,0
1668128160223,CSE 293,015,119298,Kane; Daniel Mertz,9999,0,9999,0
1668128160223,CSE 293,016,119299,Kriegman; David J,9999,0,9999,0
1668128160223,CSE 293,017,119300,Kumar; Arun Kumar,9999,0,9999,0
1668128160223,CSE 293,018,119301,Lerner; Sorin,9999,0,9999,0
1668128160223,CSE 293,019,119302,Lovett; Shachar,9999,0,9999,0
1668128160223,CSE 293,020,119303,McAuley; Julian John,9999,0,9999,0
1668128160223,CSE 293,021,119304,Micciancio; Daniele,9999,0,9999,0
1668128160223,CSE 293,022,119367,Orailoglu; Alex,9999,0,9999,0
1668128160223,CSE 293,023,119382,Paturi; Ramamohan,9999,0,9999,0
1668128160223,CSE 293,024,119404,Polikarpova; Nadezhda,9999,0,9999,0
1668128160223,CSE 293,025,119406,Politz; Joseph Gibbs,9999,0,9999,0
1668128160223,CSE 293,026,119411,Porter; George M,9999,0,9999,0
1668128160223,CSE 293,027,119414,Porter; Leonard Emerson,9999,0,9999,0
1668128160223,CSE 293,028,119416,Ramamoorthi; Ravi,9999,0,9999,0
1668128160223,CSE 293,029,119417,Sahoo; Debashis,9999,0,9999,0
1668128160223,CSE 293,030,119420,Saul; Lawrence,9999,0,9999,0
1668128160223,CSE 293,031,119421,Savage; Stefan,9999,0,9999,0
1668128160223,CSE 293,032,119425,Schulze; Jurgen P.,9999,0,9999,0
1668128160223,CSE 293,033,119426,Snoeren; Alex C.,9999,0,9999,0
1668128160223,CSE 293,034,119428,Shang; Jingbo,9999,0,9999,0
1668128160223,CSE 293,035,119430,Stefan; Deian,9999,0,9999,0
1668128160223,CSE 293,036,119431,Su; Hao,9999,0,9999,0
1668128160223,CSE 293,037,119433,Swanson; Steven James,9999,0,9999,0
1668128160223,CSE 293,038,119435,Tullsen; Dean Michael,9999,0,9999,0
1668128160223,CSE 293,039,119483,Voelker; Geoffrey M.,9999,0,9999,0
1668128160223,CSE 293,040,119537,Zhao; Jishen,9999,0,9999,0
1668128160223,CSE 293,041,119538,Zhou; Yuan-Yuan,9999,0,9999,0
1668128160223,CSE 293,042,119539,Gao; Sicun,9999,0,9999,0
1668128160223,CSE 293,043,119540,Weibel; Nadir,9999,0,9999,0
1668128160223,CSE 293,044,119541,Gupta; Rajesh K.,9999,0,9999,0
1668128160223,CSE 293,045,126410,Vaccaro; Kristen Marie,9999,0,9999,0
1668128160223,CSE 293,046,126411,Klemke; Richard,9999,0,9999,0
1668128160655,CSE 294,A00,102459,Voelker; Geoffrey M.,0,0,0,0
1668128160655,CSE 294,B00,111322,Orailoglu; Alex,0,0,0,0
1668128161077,DSE 201,A00,096914,Deutsch; Alin Bernard,30,0,30,0
1668128161502,DSE 210,A00,096915,Dasgupta; Sanjoy,30,0,30,0
1668128161927,DSE 260A,A00,096916,Altintas De Callaf; Ilkay,30,0,30,0
1668128162375,ECE 200,001,103586,Antipa; Nicholas A,9999,0,9999,0
1668128162375,ECE 200,002,103587,Atanasov; Nikolay A.,9999,0,9999,0
1668128162375,ECE 200,003,103588,Bharadia; Dinesh,9999,0,9999,0
1668128162375,ECE 200,004,103589,Cheng; Chung Kuan,9999,0,9999,0
1668128162375,ECE 200,005,103590,Cosman; Pamela C.,9999,0,9999,0
1668128162375,ECE 200,006,103591,Dayeh; Shadi Ahmad,9999,0,9999,0
1668128162375,ECE 200,007,103592,Fainman; Yeshaiahu,9999,0,9999,0
1668128162375,ECE 200,008,103593,Ford; Joseph Earl,9999,0,9999,0
1668128162375,ECE 200,009,103594,Franceschetti; Massimo,9999,0,9999,0
1668128162375,ECE 200,010,103595,Fullerton; Eric E,9999,0,9999,0
1668128162375,ECE 200,011,103596,Galton; Ian A,9999,0,9999,0
1668128162375,ECE 200,012,103597,Gilja; Vikash,9999,0,9999,0
1668128162375,ECE 200,013,103598,Hall; Drew A.,9999,0,9999,0
1668128162375,ECE 200,014,103599,Hsueh; Tzu-Chien,9999,0,9999,0
1668128162375,ECE 200,015,103600,Javidi; Tara,9999,0,9999,0
1668128162375,ECE 200,016,103601,Kahng; Andrew Byun,9999,0,9999,0
1668128162375,ECE 200,017,103602,Kim; Young-Han,9999,0,9999,0
1668128162375,ECE 200,018,103603,Koushanfar; Farinaz,9999,0,9999,0
1668128162375,ECE 200,019,103604,Kuzum; Duygu,9999,0,9999,0
1668128162375,ECE 200,020,103605,Le; Hanh-Phuc,9999,0,9999,0
1668128162375,ECE 200,021,103606,Lin; Bill,9999,0,9999,0
1668128162375,ECE 200,022,103607,Liu; Zhaowei,9998,0,9999,1
1668128162375,ECE 200,023,103608,Lo; Yu-Hwa,9999,0,9999,0
1668128162375,ECE 200,024,103609,Lomakin; Vitaliy,9999,0,9999,0
1668128162375,ECE 200,025,103610,Mercier; Patrick Philip,9999,0,9999,0
1668128162375,ECE 200,026,103611,Meyer; Florian,9999,0,9999,0
1668128162375,ECE 200,027,103612,Milstein; Laurence B.,9999,0,9999,0
1668128162375,ECE 200,028,103613,Mir Arabbaygi; Siavash,9999,0,9999,0
1668128162375,ECE 200,029,103614,Mookherjea; Shayan,9999,0,9999,0
1668128162375,ECE 200,030,103615,Morris; Karcher William,9999,0,9999,0
1668128162375,ECE 200,031,103616,Ng; Tse Nga,9999,0,9999,0
1668128162375,ECE 200,032,103617,Nguyen; Truong Quang,9999,0,9999,0
1668128162375,ECE 200,033,103618,Nomura; Kenji,9999,0,9999,0
1668128162375,ECE 200,034,103619,Orlitsky; Alon,9999,0,9999,0
1668128162375,ECE 200,035,103620,Pal; Piya,9999,0,9999,0
1668128162375,ECE 200,036,103621,Papen; George C.,9999,0,9999,0
1668128162375,ECE 200,037,103622,Radic; Stojan,9999,0,9999,0
1668128162375,ECE 200,038,103623,Rao; Bhaskar D.,9999,0,9999,0
1668128162375,ECE 200,039,103624,Rao; Ramesh R,9999,0,9999,0
1668128162375,ECE 200,040,103625,Rebeiz; Gabriel,9999,0,9999,0
1668128162375,ECE 200,041,103626,Sanford; John R,9999,0,9999,0
1668128162375,ECE 200,042,103627,Siegel; Paul H.,9999,0,9999,0
1668128162375,ECE 200,043,103628,Sievenpiper; Daniel F.,9999,0,9999,0
1668128162375,ECE 200,044,103629,Sworder; David D.,9999,0,9999,0
1668128162375,ECE 200,045,103630,Taur; Yuan,9999,0,9999,0
1668128162375,ECE 200,046,103631,Touri; Behrouz,9999,0,9999,0
1668128162375,ECE 200,047,103632,Trivedi; Mohan M.,9999,0,9999,0
1668128162375,ECE 200,048,103633,Vasconcelos; Nuno,9999,0,9999,0
1668128162375,ECE 200,049,103634,Wang; Xiaolong,9999,0,9999,0
1668128162375,ECE 200,050,103635,Xie; Pengtao,9999,0,9999,0
1668128162375,ECE 200,051,103636,Yip; Michael,9999,0,9999,0
1668128162375,ECE 200,052,103637,Zeger; Kenneth A.,999,0,999,0
1668128162375,ECE 200,053,103638,Zhang; Xinyu,9999,0,9999,0
1668128162375,ECE 200,054,103639,Turakhia; Yatish Girish,9999,0,9999,0
1668128162375,ECE 200,055,103640,Kang; Mingu,9999,0,9999,0
1668128162375,ECE 200,056,103641,Shi; Yuanyuan,9999,0,9999,0
1668128162375,ECE 200,057,103642,Wang; Edward Jay,9999,0,9999,0
1668128162375,ECE 200,058,103643,Zheng; Yang,9999,0,9999,0
1668128162799,ECE 202,A00,103644,Kuzum; Duygu,0,0,0,0
1668128163222,ECE 212BN,A00,103646,Ng; Tse Nga,0,0,0,0
1668128163649,ECE 221,A00,111493,Staff,0,0,0,0
1668128164074,ECE 222B,A00,103647,Lomakin; Vitaliy,0,0,0,0
1668128164497,ECE 230B,A00,103648,Taur; Yuan,0,0,0,0
1668128164922,ECE 238B,A00,103649,Garay; Javier,0,0,0,0
1668128165349,ECE 240B,A00,112900,Fainman; Yeshaiahu,0,0,0,0
1668128165780,ECE 247A,A00,103650,Jokerst; Jesse Vincent,0,0,0,0
1668128166205,ECE 247B,A00,103651,Wang; Joseph,0,0,0,0
1668128166635,ECE 250,A00,103652,Siegel; Paul H.,0,0,0,0
1668128167071,ECE 251A,A00,103654,Rao; Bhaskar D.,0,0,0,0
1668128167495,ECE 257B,A00,103655,Bharadia; Dinesh,0,0,0,0
1668128167925,ECE 258A,A00,103656,Milstein; Laurence B.,0,0,0,0
1668128168348,ECE 260B,A00,103658,Kang; Mingu,0,0,0,0
1668128168777,ECE 264A,A00,103659,Galton; Ian A,0,0,0,0
1668128169206,ECE 265A,A00,103661,Gudem; Prasad S.S.,0,0,0,0
1668128169633,ECE 265D,A00,103662,Gudem; Prasad S.S.,0,0,0,0
1668128170075,ECE 268,A00,103663,Koushanfar; Farinaz,0,0,0,0
1668128170501,ECE 269,A01,103665,Pal; Piya,0,0,0,0
1668128170926,ECE 271B,A00,103666,Vasconcelos; Manuela,0,0,0,0
1668128171350,ECE 276A,A00,103667,Atanasov; Nikolay A.,0,0,0,0
1668128171803,ECE 277,A00,103668,An; Cheolhong,0,0,0,0
1668128172229,ECE 279,A00,117947,Hall; Drew A.,0,0,0,0
1668128173081,ECE 283,A00,103670,Hsueh; Tzu-Chien,0,0,0,0
1668128173506,ECE 284,A00,103671,Turakhia; Yatish Girish,0,0,0,0
1668128173936,ECE 285,A00,103672,Zheng; Yang,0,0,0,0
1668128173936,ECE 285,B00,103673,Sworder; David D.,0,0,0,0
1668128174358,ECE 287,A00,103676,Javidi; Tara,0,0,0,0
1668128174792,MATH 200B,A00,098023,Salehi Golsefidy; Alireza,12,0,15,3
1668128175219,MATH 202B,A00,098024,Rhoades; Brendon Patrick,9,0,15,6
1668128175741,MATH 203B,A00,098025,Oprea; Dragos N.,10,0,15,5
1668128176168,MATH 204B,A00,098026,Sorensen; Claus M,13,0,15,2
1668128176596,MATH 208,A00,098027,Izadi; Elham,7,0,10,3
1668128177019,MATH 209,A00,098028,Pollack; Aaron,10,0,10,0
1668128177482,MATH 211A,A00,112919,Rogalski; Daniel,9,0,10,1
1668128177919,MATH 211B,A00,112920,Seward; Brandon M.,9,0,10,1
1668128178342,MATH 218,A00,098029,Li; Bo,10,0,10,0
1668128178767,MATH 220B,A00,098030,Novak; Jonathan I,11,0,15,4
1668128179191,MATH 221A,A00,098031,Ebenfelt; Peter F,13,0,15,2
1668128179626,MATH 231B,A00,098032,Zlatos; Andrej,12,0,15,3
1668128180051,MATH 240B,A00,098033,Ni; Lei,9,0,15,6
1668128180478,MATH 243,A00,098034,Jekel; David Andrew,10,0,10,0
1668128180908,MATH 245A,A00,098035,Nie; Jiawang,0,0,15,16
1668128181335,MATH 248,A00,098036,Bejenaru; Ioan,10,0,10,0
1668128181770,MATH 250B,A00,098037,Spolaor; Luca,14,0,15,1
1668128182195,MATH 258,A00,098038,Ni; Lei,10,0,10,0
1668128182618,MATH 264B,A00,098041,Rhoades; Brendon Patrick,9,0,15,6
1668128183048,MATH 268,A00,098042,Buss; Samuel R,10,0,10,0
1668128183471,MATH 269,A00,098043,Rhoades; Brendon Patrick,10,0,10,0
1668128183894,MATH 270B,A00,098044,Li; Bo,10,0,15,5
1668128184334,MATH 272B,A00,098045,Holst; Michael J,13,0,15,2
1668128184764,MATH 273A,A00,098046,Tian; Xiaochuan,10,0,15,5
1668128185193,MATH 275,A01,098048,Tian; Xiaochuan,6,0,10,4
1668128185635,MATH 278A,A00,098049,Holst; Michael J,8,0,10,2
1668128186059,MATH 278B,A00,098050,Cloninger; Alexander,10,0,10,0
1668128186499,MATH 278C,A00,098051,Nie; Jiawang,7,0,10,3
1668128186926,MATH 280B,A00,098052,Zheng; Tianyi,10,0,15,5
1668128187349,MATH 281B,A00,098053,Bradic; Jelena,2,0,15,13
1668128187774,MATH 282B,A00,098054,Arias-Castro; Ery,0,0,15,15
1668128188201,MATH 285,A00,098055,Fitzsimmons; Patrick J,0,0,15,17
1668128188632,MATH 287B,A00,098056,Arias-Castro; Ery,3,0,15,12
1668128189060,MATH 288,A00,098057,Agarwal; Pooja,9,0,10,1
1668128189060,MATH 288,B00,098058,Zhang; Danna,8,0,10,2
1668128189060,MATH 288,C00,098059,Williams; Ruth J,10,0,10,0
1668128189484,MATH 290B,A00,098060,Roberts; Justin Deritter,13,0,15,2
1668128189913,MATH 292,A00,098061,Belmont; Eva Kinoshita,10,0,10,0
1668128190337,MATH 295,A00,098062,Suk; Andrew Hoon,48,0,50,2
1668128190762,MATH 296,A00,098063,Novak; Jonathan I,20,0,20,0
1668128191189,MATH 297,001,098064,Gamst; Anthony Collins,9997,0,9999,2
1668128695426,COGS 205,A00,101395,Chiba; Andrea,19,0,20,1
1668128695852,COGS 210B,001,101404,Greene; Deanna Jacquelyn,9998,0,9999,1
1668128695852,COGS 210B,002,101417,Xia; Haijun,9999,0,9999,0
1668128695852,COGS 210B,003,101422,Nitz; Douglas A.,9999,0,9999,0
1668128695852,COGS 210B,004,101423,Hollan; James D.,9998,0,9999,1
1668128695852,COGS 210B,005,101424,Deak; Gedeon O.,9998,0,9999,1
1668128695852,COGS 210B,006,101425,Rossano; Federico,9999,0,9999,0
1668128696285,COGS 211B,A00,101427,Coulson; Seana M,9996,0,9999,3
1668128696714,COGS 220,A00,101428,Hollan; James D.,0,0,25,25
1668128697145,COGS 229,A00,101429,Dow; Steven P,18,0,25,7
1668128697577,COGS 230,A00,101430,Klemmer; Scott R,12,0,17,5
1668128698013,COGS 234,A00,101431,Xia; Haijun,3,0,25,22
1668128698437,COGS 260,A00,101432,Kiyonaga; Anastasia,20,0,25,5
1668128698437,COGS 260,B00,101433,Kirsh; David Joel,16,0,25,9
1668128698874,CSE 202,A00,102371,Impagliazzo; Russell,0,0,0,0
1668128699296,CSE 203B,A01,102373,Cheng; Chung Kuan,0,0,0,0
1668128699719,CSE 208,A00,102374,Micciancio; Daniele,0,0,0,0
1668128700230,CSE 209A,A00,112895,Impagliazzo; Russell,0,0,15,15
1668128700654,CSE 209B,A00,108005,Bellare; Mihir,0,0,0,0
1668128701092,CSE 210,A00,113163,Coblenz; Michael J,0,0,0,0
1668128701651,CSE 219,A00,106111,Dow; Steven P,0,0,20,20
1668128702078,CSE 221,A00,102376,Voelker; Geoffrey M.,0,0,0,0
1668128702512,CSE 224,A01,102378,Porter; George M,0,0,0,0
1668128702941,CSE 229A,A00,102379,Savage; Stefan,0,0,0,0
1668128703375,CSE 229C,A00,102380,Munyaka; Imani N. S.,0,0,0,0
1668128703802,CSE 232B,A00,102382,Deutsch; Alin Bernard,0,0,0,0
1668128704232,CSE 234,A01,112904,Kumar; Arun Kumar,0,0,0,0
1668128704660,CSE 237A,A00,102383,Rosing; Tajana Simunic,0,0,0,0
1668128705087,CSE 239A,A00,102384,Deutsch; Alin Bernard,0,0,0,0
1668128705537,CSE 239B,A00,102385,Polikarpova; Nadezhda,0,0,0,0
1668128705965,CSE 240A,A00,102386,Pannuto; Patrick William,0,0,0,0
1668128706389,CSE 240B,A00,102387,Zhao; Jishen,0,0,0,0
1668128706816,CSE 241A,A00,106406,Kang; Mingu,0,0,0,0
1668128707247,CSE 249B,A00,102388,Kahng; Andrew Byun,0,0,8,8
1668128707676,CSE 251B,A01,102392,Cottrell; Garrison W,0,0,0,0
1668128707676,CSE 251B,A02,102393,Cottrell; Garrison W,0,0,0,0
1668128708116,CSE 252B,A00,102394,Ochoa; Benjamin Lawrence,0,0,0,0
1668128708541,CSE 257,A01,102396,Gao; Sicun,0,0,0,0
1668128708971,CSE 272,A00,102397,Li; Tzumao,0,0,0,0
1668128709393,CSE 274,A00,111323,Chern; Albert Ren-Haur,0,0,0,0
1668128709824,CSE 282,A00,102398,Pevzner; Pavel Arkadjevich,0,0,0,0
1668128710250,CSE 284,A00,114175,Gymrek; Melissa Ann,0,0,0,0
1668128710675,CSE 290,A00,102399,Chandraker; Manmohan Krishna,0,0,0,0
1668128710675,CSE 290,B00,102400,Vaccaro; Kristen Marie,0,0,25,25
1668128710675,CSE 290,C00,102414,Pannuto; Patrick William,0,0,25,25
1668128710675,CSE 290,D00,102427,Pevzner; Pavel Arkadjevich,0,0,0,0
1668128710675,CSE 290,E00,102429,Zhao; Jishen,0,0,0,0
1668128710675,CSE 290,F00,102436,Tullsen; Dean Michael,0,0,0,0
1668128710675,CSE 290,G00,102440,Christensen; Henrik I,0,0,20,20
1668128711109,CSE 291,A00,102443,Su; Hao,0,0,0,0
1668128711109,CSE 291,B00,102448,Polikarpova; Nadezhda,0,0,0,0
1668128711109,CSE 291,C00,102453,Vaccaro; Kristen Marie,0,0,0,0
1668128711109,CSE 291,D00,111343,Savage; Stefan,0,0,0,0
1668128711109,CSE 291,E00,116474,Claffy; Kimberly Claire,0,0,0,0
1668128711109,CSE 291,F00,116479,Pasquale; Joseph,0,0,0,0
1668128711536,CSE 293,001,119111,Bafna; Vineet,9999,0,9999,0
1668128711536,CSE 293,002,119118,Bellare; Mihir,9999,0,9999,0
1668128711536,CSE 293,003,119122,Berg-Kirkpatrick; Taylor D,9999,0,9999,0
1668128711536,CSE 293,004,119135,Christensen; Henrik I,9999,0,9999,0
1668128711536,CSE 293,005,119142,Cottrell; Garrison W,9999,0,9999,0
1668128711536,CSE 293,006,119146,Deutsch; Alin Bernard,9999,0,9999,0
1668128711536,CSE 293,007,119159,Esmaeilzadeh; Hadi,9999,0,9999,0
1668128711536,CSE 293,008,119166,Freund; Yoav,9999,0,9999,0
1668128711536,CSE 293,009,119170,Griswold; William G.,9999,0,9999,0
1668128711536,CSE 293,010,119183,Gymrek; Melissa Ann,9999,0,9999,0
1668128711536,CSE 293,011,119190,Heninger; Nadia A,9999,0,9999,0
1668128711536,CSE 293,012,119230,Impagliazzo; Russell,9999,0,9999,0
1668128711536,CSE 293,013,119232,Jhala; Ranjit,9999,0,9999,0
1668128711536,CSE 293,014,119233,Kahng; Andrew Byun,9999,0,9999,0
1668128711536,CSE 293,015,119298,Kane; Daniel Mertz,9999,0,9999,0
1668128711536,CSE 293,016,119299,Kriegman; David J,9999,0,9999,0
1668128711536,CSE 293,017,119300,Kumar; Arun Kumar,9999,0,9999,0
1668128711536,CSE 293,018,119301,Lerner; Sorin,9999,0,9999,0
1668128711536,CSE 293,019,119302,Lovett; Shachar,9999,0,9999,0
1668128711536,CSE 293,020,119303,McAuley; Julian John,9999,0,9999,0
1668128711536,CSE 293,021,119304,Micciancio; Daniele,9999,0,9999,0
1668128711536,CSE 293,022,119367,Orailoglu; Alex,9999,0,9999,0
1668128711536,CSE 293,023,119382,Paturi; Ramamohan,9999,0,9999,0
1668128711536,CSE 293,024,119404,Polikarpova; Nadezhda,9999,0,9999,0
1668128711536,CSE 293,025,119406,Politz; Joseph Gibbs,9999,0,9999,0
1668128711536,CSE 293,026,119411,Porter; George M,9999,0,9999,0
1668128711536,CSE 293,027,119414,Porter; Leonard Emerson,9999,0,9999,0
1668128711536,CSE 293,028,119416,Ramamoorthi; Ravi,9999,0,9999,0
1668128711536,CSE 293,029,119417,Sahoo; Debashis,9999,0,9999,0
1668128711536,CSE 293,030,119420,Saul; Lawrence,9999,0,9999,0
1668128711536,CSE 293,031,119421,Savage; Stefan,9999,0,9999,0
1668128711536,CSE 293,032,119425,Schulze; Jurgen P.,9999,0,9999,0
1668128711536,CSE 293,033,119426,Snoeren; Alex C.,9999,0,9999,0
1668128711536,CSE 293,034,119428,Shang; Jingbo,9999,0,9999,0
1668128711536,CSE 293,035,119430,Stefan; Deian,9999,0,9999,0
1668128711536,CSE 293,036,119431,Su; Hao,9999,0,9999,0
1668128711536,CSE 293,037,119433,Swanson; Steven James,9999,0,9999,0
1668128711536,CSE 293,038,119435,Tullsen; Dean Michael,9999,0,9999,0
1668128711536,CSE 293,039,119483,Voelker; Geoffrey M.,9999,0,9999,0
1668128711536,CSE 293,040,119537,Zhao; Jishen,9999,0,9999,0
1668128711536,CSE 293,041,119538,Zhou; Yuan-Yuan,9999,0,9999,0
1668128711536,CSE 293,042,119539,Gao; Sicun,9999,0,9999,0
1668128711536,CSE 293,043,119540,Weibel; Nadir,9999,0,9999,0
1668128711536,CSE 293,044,119541,Gupta; Rajesh K.,9999,0,9999,0
1668128711536,CSE 293,045,126410,Vaccaro; Kristen Marie,9999,0,9999,0
1668128711536,CSE 293,046,126411,Klemke; Richard,9999,0,9999,0
1668128711966,CSE 294,A00,102459,Voelker; Geoffrey M.,0,0,0,0
1668128711966,CSE 294,B00,111322,Orailoglu; Alex,0,0,0,0
1668128712390,DSE 201,A00,096914,Deutsch; Alin Bernard,30,0,30,0
1668128712813,DSE 210,A00,096915,Dasgupta; Sanjoy,30,0,30,0
1668128713239,DSE 260A,A00,096916,Altintas De Callaf; Ilkay,30,0,30,0
1668128713673,ECE 200,001,103586,Antipa; Nicholas A,9999,0,9999,0
1668128713673,ECE 200,002,103587,Atanasov; Nikolay A.,9999,0,9999,0
1668128713673,ECE 200,003,103588,Bharadia; Dinesh,9999,0,9999,0
1668128713673,ECE 200,004,103589,Cheng; Chung Kuan,9999,0,9999,0
1668128713673,ECE 200,005,103590,Cosman; Pamela C.,9999,0,9999,0
1668128713673,ECE 200,006,103591,Dayeh; Shadi Ahmad,9999,0,9999,0
1668128713673,ECE 200,007,103592,Fainman; Yeshaiahu,9999,0,9999,0
1668128713673,ECE 200,008,103593,Ford; Joseph Earl,9999,0,9999,0
1668128713673,ECE 200,009,103594,Franceschetti; Massimo,9999,0,9999,0
1668128713673,ECE 200,010,103595,Fullerton; Eric E,9999,0,9999,0
1668128713673,ECE 200,011,103596,Galton; Ian A,9999,0,9999,0
1668128713673,ECE 200,012,103597,Gilja; Vikash,9999,0,9999,0
1668128713673,ECE 200,013,103598,Hall; Drew A.,9999,0,9999,0
1668128713673,ECE 200,014,103599,Hsueh; Tzu-Chien,9999,0,9999,0
1668128713673,ECE 200,015,103600,Javidi; Tara,9999,0,9999,0
1668128713673,ECE 200,016,103601,Kahng; Andrew Byun,9999,0,9999,0
1668128713673,ECE 200,017,103602,Kim; Young-Han,9999,0,9999,0
1668128713673,ECE 200,018,103603,Koushanfar; Farinaz,9999,0,9999,0
1668128713673,ECE 200,019,103604,Kuzum; Duygu,9999,0,9999,0
1668128713673,ECE 200,020,103605,Le; Hanh-Phuc,9999,0,9999,0
1668128713673,ECE 200,021,103606,Lin; Bill,9999,0,9999,0
1668128713673,ECE 200,022,103607,Liu; Zhaowei,9998,0,9999,1
1668128713673,ECE 200,023,103608,Lo; Yu-Hwa,9999,0,9999,0
1668128713673,ECE 200,024,103609,Lomakin; Vitaliy,9999,0,9999,0
1668128713673,ECE 200,025,103610,Mercier; Patrick Philip,9999,0,9999,0
1668128713673,ECE 200,026,103611,Meyer; Florian,9999,0,9999,0
1668128713673,ECE 200,027,103612,Milstein; Laurence B.,9999,0,9999,0
1668128713673,ECE 200,028,103613,Mir Arabbaygi; Siavash,9999,0,9999,0
1668128713673,ECE 200,029,103614,Mookherjea; Shayan,9999,0,9999,0
1668128713673,ECE 200,030,103615,Morris; Karcher William,9999,0,9999,0
1668128713673,ECE 200,031,103616,Ng; Tse Nga,9999,0,9999,0
1668128713673,ECE 200,032,103617,Nguyen; Truong Quang,9999,0,9999,0
1668128713673,ECE 200,033,103618,Nomura; Kenji,9999,0,9999,0
1668128713673,ECE 200,034,103619,Orlitsky; Alon,9999,0,9999,0
1668128713673,ECE 200,035,103620,Pal; Piya,9999,0,9999,0
1668128713673,ECE 200,036,103621,Papen; George C.,9999,0,9999,0
1668128713673,ECE 200,037,103622,Radic; Stojan,9999,0,9999,0
1668128713673,ECE 200,038,103623,Rao; Bhaskar D.,9999,0,9999,0
1668128713673,ECE 200,039,103624,Rao; Ramesh R,9999,0,9999,0
1668128713673,ECE 200,040,103625,Rebeiz; Gabriel,9999,0,9999,0
1668128713673,ECE 200,041,103626,Sanford; John R,9999,0,9999,0
1668128713673,ECE 200,042,103627,Siegel; Paul H.,9999,0,9999,0
1668128713673,ECE 200,043,103628,Sievenpiper; Daniel F.,9999,0,9999,0
1668128713673,ECE 200,044,103629,Sworder; David D.,9999,0,9999,0
1668128713673,ECE 200,045,103630,Taur; Yuan,9999,0,9999,0
1668128713673,ECE 200,046,103631,Touri; Behrouz,9999,0,9999,0
1668128713673,ECE 200,047,103632,Trivedi; Mohan M.,9999,0,9999,0
1668128713673,ECE 200,048,103633,Vasconcelos; Nuno,9999,0,9999,0
1668128713673,ECE 200,049,103634,Wang; Xiaolong,9999,0,9999,0
1668128713673,ECE 200,050,103635,Xie; Pengtao,9999,0,9999,0
1668128713673,ECE 200,051,103636,Yip; Michael,9999,0,9999,0
1668128713673,ECE 200,052,103637,Zeger; Kenneth A.,999,0,999,0
1668128713673,ECE 200,053,103638,Zhang; Xinyu,9999,0,9999,0
1668128713673,ECE 200,054,103639,Turakhia; Yatish Girish,9999,0,9999,0
1668128713673,ECE 200,055,103640,Kang; Mingu,9999,0,9999,0
1668128713673,ECE 200,056,103641,Shi; Yuanyuan,9999,0,9999,0
1668128713673,ECE 200,057,103642,Wang; Edward Jay,9999,0,9999,0
1668128713673,ECE 200,058,103643,Zheng; Yang,9999,0,9999,0
1668128714120,ECE 202,A00,103644,Kuzum; Duygu,0,0,0,0
1668128714549,ECE 212BN,A00,103646,Ng; Tse Nga,0,0,0,0
1668128714971,ECE 221,A00,111493,Staff,0,0,0,0
1668128715406,ECE 222B,A00,103647,Lomakin; Vitaliy,0,0,0,0
1668128715829,ECE 230B,A00,103648,Taur; Yuan,0,0,0,0
1668128716259,ECE 238B,A00,103649,Garay; Javier,0,0,0,0
1668128716681,ECE 240B,A00,112900,Fainman; Yeshaiahu,0,0,0,0
1668128717104,ECE 247A,A00,103650,Jokerst; Jesse Vincent,0,0,0,0
1668128717528,ECE 247B,A00,103651,Wang; Joseph,0,0,0,0
1668128717958,ECE 250,A00,103652,Siegel; Paul H.,0,0,0,0
1668128718383,ECE 251A,A00,103654,Rao; Bhaskar D.,0,0,0,0
1668128718807,ECE 257B,A00,103655,Bharadia; Dinesh,0,0,0,0
1668128719239,ECE 258A,A00,103656,Milstein; Laurence B.,0,0,0,0
1668128719666,ECE 260B,A00,103658,Kang; Mingu,0,0,0,0
1668128720095,ECE 264A,A00,103659,Galton; Ian A,0,0,0,0
1668128720517,ECE 265A,A00,103661,Gudem; Prasad S.S.,0,0,0,0
1668128720944,ECE 265D,A00,103662,Gudem; Prasad S.S.,0,0,0,0
1668128721378,ECE 268,A00,103663,Koushanfar; Farinaz,0,0,0,0
1668128721804,ECE 269,A01,103665,Pal; Piya,0,0,0,0
1668128722234,ECE 271B,A00,103666,Vasconcelos; Manuela,0,0,0,0
1668128722662,ECE 276A,A00,103667,Atanasov; Nikolay A.,0,0,0,0
1668128723085,ECE 277,A00,103668,An; Cheolhong,0,0,0,0
1668128723510,ECE 279,A00,117947,Hall; Drew A.,0,0,0,0
1668128724369,ECE 283,A00,103670,Hsueh; Tzu-Chien,0,0,0,0
1668128724795,ECE 284,A00,103671,Turakhia; Yatish Girish,0,0,0,0
1668128725223,ECE 285,A00,103672,Zheng; Yang,0,0,0,0
1668128725223,ECE 285,B00,103673,Sworder; David D.,0,0,0,0
1668128725655,ECE 287,A00,103676,Javidi; Tara,0,0,0,0
1668128726087,MATH 200B,A00,098023,Salehi Golsefidy; Alireza,12,0,15,3
1668128726509,MATH 202B,A00,098024,Rhoades; Brendon Patrick,9,0,15,6
1668128726956,MATH 203B,A00,098025,Oprea; Dragos N.,10,0,15,5
1668128727383,MATH 204B,A00,098026,Sorensen; Claus M,13,0,15,2
1668128727808,MATH 208,A00,098027,Izadi; Elham,7,0,10,3
1668128728247,MATH 209,A00,098028,Pollack; Aaron,10,0,10,0
1668128728678,MATH 211A,A00,112919,Rogalski; Daniel,9,0,10,1
1668128729103,MATH 211B,A00,112920,Seward; Brandon M.,9,0,10,1
1668128729526,MATH 218,A00,098029,Li; Bo,10,0,10,0
1668128729954,MATH 220B,A00,098030,Novak; Jonathan I,11,0,15,4
1668128730379,MATH 221A,A00,098031,Ebenfelt; Peter F,13,0,15,2
1668128730802,MATH 231B,A00,098032,Zlatos; Andrej,12,0,15,3
1668128731230,MATH 240B,A00,098033,Ni; Lei,9,0,15,6
1668128731659,MATH 243,A00,098034,Jekel; David Andrew,10,0,10,0
1668128732099,MATH 245A,A00,098035,Nie; Jiawang,0,0,15,16
1668128732523,MATH 248,A00,098036,Bejenaru; Ioan,10,0,10,0
1668128732950,MATH 250B,A00,098037,Spolaor; Luca,14,0,15,1
1668128733376,MATH 258,A00,098038,Ni; Lei,10,0,10,0
1668128733802,MATH 264B,A00,098041,Rhoades; Brendon Patrick,9,0,15,6
1668128734228,MATH 268,A00,098042,Buss; Samuel R,10,0,10,0
1668128734653,MATH 269,A00,098043,Rhoades; Brendon Patrick,10,0,10,0
1668128735081,MATH 270B,A00,098044,Li; Bo,10,0,15,5
1668128735508,MATH 272B,A00,098045,Holst; Michael J,13,0,15,2
1668128735940,MATH 273A,A00,098046,Tian; Xiaochuan,10,0,15,5
1668128736364,MATH 275,A01,098048,Tian; Xiaochuan,6,0,10,4
1668128736788,MATH 278A,A00,098049,Holst; Michael J,8,0,10,2
1668128737231,MATH 278B,A00,098050,Cloninger; Alexander,10,0,10,0
1668128737665,MATH 278C,A00,098051,Nie; Jiawang,7,0,10,3
1668128738089,MATH 280B,A00,098052,Zheng; Tianyi,10,0,15,5
1668128738532,MATH 281B,A00,098053,Bradic; Jelena,2,0,15,13
1668128738961,MATH 282B,A00,098054,Arias-Castro; Ery,0,0,15,15
1668128739389,MATH 285,A00,098055,Fitzsimmons; Patrick J,0,0,15,17
1668128739811,MATH 287B,A00,098056,Arias-Castro; Ery,3,0,15,12
1668128740235,MATH 288,A00,098057,Agarwal; Pooja,9,0,10,1
1668128740235,MATH 288,B00,098058,Zhang; Danna,8,0,10,2
1668128740235,MATH 288,C00,098059,Williams; Ruth J,10,0,10,0
1668128740657,MATH 290B,A00,098060,Roberts; Justin Deritter,13,0,15,2
1668128741091,MATH 292,A00,098061,Belmont; Eva Kinoshita,10,0,10,0
1668128741514,MATH 295,A00,098062,Suk; Andrew Hoon,48,0,50,2
1668128741938,MATH 296,A00,098063,Novak; Jonathan I,20,0,20,0
1668128742377,MATH 297,001,098064,Gamst; Anthony Collins,9997,0,9999,2
1668129245476,COGS 205,A00,101395,Chiba; Andrea,19,0,20,1
1668129245901,COGS 210B,001,101404,Greene; Deanna Jacquelyn,9998,0,9999,1
1668129245901,COGS 210B,002,101417,Xia; Haijun,9999,0,9999,0
1668129245901,COGS 210B,003,101422,Nitz; Douglas A.,9999,0,9999,0
1668129245901,COGS 210B,004,101423,Hollan; James D.,9998,0,9999,1
1668129245901,COGS 210B,005,101424,Deak; Gedeon O.,9998,0,9999,1
1668129245901,COGS 210B,006,101425,Rossano; Federico,9999,0,9999,0
1668129246336,COGS 211B,A00,101427,Coulson; Seana M,9996,0,9999,3
1668129246763,COGS 220,A00,101428,Hollan; James D.,0,0,25,25
1668129247198,COGS 229,A00,101429,Dow; Steven P,18,0,25,7
1668129247624,COGS 230,A00,101430,Klemmer; Scott R,12,0,17,5
1668129248062,COGS 234,A00,101431,Xia; Haijun,3,0,25,22
1668129248503,COGS 260,A00,101432,Kiyonaga; Anastasia,20,0,25,5
1668129248503,COGS 260,B00,101433,Kirsh; David Joel,16,0,25,9
1668129248928,CSE 202,A00,102371,Impagliazzo; Russell,0,0,0,0
1668129249352,CSE 203B,A01,102373,Cheng; Chung Kuan,0,0,0,0
1668129249789,CSE 208,A00,102374,Micciancio; Daniele,0,0,0,0
1668129250224,CSE 209A,A00,112895,Impagliazzo; Russell,0,0,15,15
1668129250645,CSE 209B,A00,108005,Bellare; Mihir,0,0,0,0
1668129251078,CSE 210,A00,113163,Coblenz; Michael J,0,0,0,0
1668129251505,CSE 219,A00,106111,Dow; Steven P,0,0,20,20
1668129251935,CSE 221,A00,102376,Voelker; Geoffrey M.,0,0,0,0
1668129252362,CSE 224,A01,102378,Porter; George M,0,0,0,0
1668129252796,CSE 229A,A00,102379,Savage; Stefan,0,0,0,0
1668129253223,CSE 229C,A00,102380,Munyaka; Imani N. S.,0,0,0,0
1668129253653,CSE 232B,A00,102382,Deutsch; Alin Bernard,0,0,0,0
1668129254076,CSE 234,A01,112904,Kumar; Arun Kumar,0,0,0,0
1668129254498,CSE 237A,A00,102383,Rosing; Tajana Simunic,0,0,0,0
1668129254922,CSE 239A,A00,102384,Deutsch; Alin Bernard,0,0,0,0
1668129255354,CSE 239B,A00,102385,Polikarpova; Nadezhda,0,0,0,0
1668129255789,CSE 240A,A00,102386,Pannuto; Patrick William,0,0,0,0
1668129256219,CSE 240B,A00,102387,Zhao; Jishen,0,0,0,0
1668129256650,CSE 241A,A00,106406,Kang; Mingu,0,0,0,0
1668129257088,CSE 249B,A00,102388,Kahng; Andrew Byun,0,0,8,8
1668129257521,CSE 251B,A01,102392,Cottrell; Garrison W,0,0,0,0
1668129257521,CSE 251B,A02,102393,Cottrell; Garrison W,0,0,0,0
1668129257954,CSE 252B,A00,102394,Ochoa; Benjamin Lawrence,0,0,0,0
1668129258389,CSE 257,A01,102396,Gao; Sicun,0,0,0,0
1668129258817,CSE 272,A00,102397,Li; Tzumao,0,0,0,0
1668129259249,CSE 274,A00,111323,Chern; Albert Ren-Haur,0,0,0,0
1668129259676,CSE 282,A00,102398,Pevzner; Pavel Arkadjevich,0,0,0,0
1668129260110,CSE 284,A00,114175,Gymrek; Melissa Ann,0,0,0,0
1668129260540,CSE 290,A00,102399,Chandraker; Manmohan Krishna,0,0,0,0
1668129260540,CSE 290,B00,102400,Vaccaro; Kristen Marie,0,0,25,25
1668129260540,CSE 290,C00,102414,Pannuto; Patrick William,0,0,25,25
1668129260540,CSE 290,D00,102427,Pevzner; Pavel Arkadjevich,0,0,0,0
1668129260540,CSE 290,E00,102429,Zhao; Jishen,0,0,0,0
1668129260540,CSE 290,F00,102436,Tullsen; Dean Michael,0,0,0,0
1668129260540,CSE 290,G00,102440,Christensen; Henrik I,0,0,20,20
1668129260979,CSE 291,A00,102443,Su; Hao,0,0,0,0
1668129260979,CSE 291,B00,102448,Polikarpova; Nadezhda,0,0,0,0
1668129260979,CSE 291,C00,102453,Vaccaro; Kristen Marie,0,0,0,0
1668129260979,CSE 291,D00,111343,Savage; Stefan,0,0,0,0
1668129260979,CSE 291,E00,116474,Claffy; Kimberly Claire,0,0,0,0
1668129260979,CSE 291,F00,116479,Pasquale; Joseph,0,0,0,0
1668129261414,CSE 293,001,119111,Bafna; Vineet,9999,0,9999,0
1668129261414,CSE 293,002,119118,Bellare; Mihir,9999,0,9999,0
1668129261414,CSE 293,003,119122,Berg-Kirkpatrick; Taylor D,9999,0,9999,0
1668129261414,CSE 293,004,119135,Christensen; Henrik I,9999,0,9999,0
1668129261414,CSE 293,005,119142,Cottrell; Garrison W,9999,0,9999,0
1668129261414,CSE 293,006,119146,Deutsch; Alin Bernard,9999,0,9999,0
1668129261414,CSE 293,007,119159,Esmaeilzadeh; Hadi,9999,0,9999,0
1668129261414,CSE 293,008,119166,Freund; Yoav,9999,0,9999,0
1668129261414,CSE 293,009,119170,Griswold; William G.,9999,0,9999,0
1668129261414,CSE 293,010,119183,Gymrek; Melissa Ann,9999,0,9999,0
1668129261414,CSE 293,011,119190,Heninger; Nadia A,9999,0,9999,0
1668129261414,CSE 293,012,119230,Impagliazzo; Russell,9999,0,9999,0
1668129261414,CSE 293,013,119232,Jhala; Ranjit,9999,0,9999,0
1668129261414,CSE 293,014,119233,Kahng; Andrew Byun,9999,0,9999,0
1668129261414,CSE 293,015,119298,Kane; Daniel Mertz,9999,0,9999,0
1668129261414,CSE 293,016,119299,Kriegman; David J,9999,0,9999,0
1668129261414,CSE 293,017,119300,Kumar; Arun Kumar,9999,0,9999,0
1668129261414,CSE 293,018,119301,Lerner; Sorin,9999,0,9999,0
1668129261414,CSE 293,019,119302,Lovett; Shachar,9999,0,9999,0
1668129261414,CSE 293,020,119303,McAuley; Julian John,9999,0,9999,0
1668129261414,CSE 293,021,119304,Micciancio; Daniele,9999,0,9999,0
1668129261414,CSE 293,022,119367,Orailoglu; Alex,9999,0,9999,0
1668129261414,CSE 293,023,119382,Paturi; Ramamohan,9999,0,9999,0
1668129261414,CSE 293,024,119404,Polikarpova; Nadezhda,9999,0,9999,0
1668129261414,CSE 293,025,119406,Politz; Joseph Gibbs,9999,0,9999,0
1668129261414,CSE 293,026,119411,Porter; George M,9999,0,9999,0
1668129261414,CSE 293,027,119414,Porter; Leonard Emerson,9999,0,9999,0
1668129261414,CSE 293,028,119416,Ramamoorthi; Ravi,9999,0,9999,0
1668129261414,CSE 293,029,119417,Sahoo; Debashis,9999,0,9999,0
1668129261414,CSE 293,030,119420,Saul; Lawrence,9999,0,9999,0
1668129261414,CSE 293,031,119421,Savage; Stefan,9999,0,9999,0
1668129261414,CSE 293,032,119425,Schulze; Jurgen P.,9999,0,9999,0
1668129261414,CSE 293,033,119426,Snoeren; Alex C.,9999,0,9999,0
1668129261414,CSE 293,034,119428,Shang; Jingbo,9999,0,9999,0
1668129261414,CSE 293,035,119430,Stefan; Deian,9999,0,9999,0
1668129261414,CSE 293,036,119431,Su; Hao,9999,0,9999,0
1668129261414,CSE 293,037,119433,Swanson; Steven James,9999,0,9999,0
1668129261414,CSE 293,038,119435,Tullsen; Dean Michael,9999,0,9999,0
1668129261414,CSE 293,039,119483,Voelker; Geoffrey M.,9999,0,9999,0
1668129261414,CSE 293,040,119537,Zhao; Jishen,9999,0,9999,0
1668129261414,CSE 293,041,119538,Zhou; Yuan-Yuan,9999,0,9999,0
1668129261414,CSE 293,042,119539,Gao; Sicun,9999,0,9999,0
1668129261414,CSE 293,043,119540,Weibel; Nadir,9999,0,9999,0
1668129261414,CSE 293,044,119541,Gupta; Rajesh K.,9999,0,9999,0
1668129261414,CSE 293,045,126410,Vaccaro; Kristen Marie,9999,0,9999,0
1668129261414,CSE 293,046,126411,Klemke; Richard,9999,0,9999,0
1668129261840,CSE 294,A00,102459,Voelker; Geoffrey M.,0,0,0,0
1668129261840,CSE 294,B00,111322,Orailoglu; Alex,0,0,0,0
1668129262262,DSE 201,A00,096914,Deutsch; Alin Bernard,30,0,30,0
1668129262694,DSE 210,A00,096915,Dasgupta; Sanjoy,30,0,30,0
1668129263125,DSE 260A,A00,096916,Altintas De Callaf; Ilkay,30,0,30,0
1668129263559,ECE 200,001,103586,Antipa; Nicholas A,9999,0,9999,0
1668129263559,ECE 200,002,103587,Atanasov; Nikolay A.,9999,0,9999,0
1668129263559,ECE 200,003,103588,Bharadia; Dinesh,9999,0,9999,0
1668129263559,ECE 200,004,103589,Cheng; Chung Kuan,9999,0,9999,0
1668129263559,ECE 200,005,103590,Cosman; Pamela C.,9999,0,9999,0
1668129263559,ECE 200,006,103591,Dayeh; Shadi Ahmad,9999,0,9999,0
1668129263559,ECE 200,007,103592,Fainman; Yeshaiahu,9999,0,9999,0
1668129263559,ECE 200,008,103593,Ford; Joseph Earl,9999,0,9999,0
1668129263559,ECE 200,009,103594,Franceschetti; Massimo,9999,0,9999,0
1668129263559,ECE 200,010,103595,Fullerton; Eric E,9999,0,9999,0
1668129263559,ECE 200,011,103596,Galton; Ian A,9999,0,9999,0
1668129263559,ECE 200,012,103597,Gilja; Vikash,9999,0,9999,0
1668129263559,ECE 200,013,103598,Hall; Drew A.,9999,0,9999,0
1668129263559,ECE 200,014,103599,Hsueh; Tzu-Chien,9999,0,9999,0
1668129263559,ECE 200,015,103600,Javidi; Tara,9999,0,9999,0
1668129263559,ECE 200,016,103601,Kahng; Andrew Byun,9999,0,9999,0
1668129263559,ECE 200,017,103602,Kim; Young-Han,9999,0,9999,0
1668129263559,ECE 200,018,103603,Koushanfar; Farinaz,9999,0,9999,0
1668129263559,ECE 200,019,103604,Kuzum; Duygu,9999,0,9999,0
1668129263559,ECE 200,020,103605,Le; Hanh-Phuc,9999,0,9999,0
1668129263559,ECE 200,021,103606,Lin; Bill,9999,0,9999,0
1668129263559,ECE 200,022,103607,Liu; Zhaowei,9998,0,9999,1
1668129263559,ECE 200,023,103608,Lo; Yu-Hwa,9999,0,9999,0
1668129263559,ECE 200,024,103609,Lomakin; Vitaliy,9999,0,9999,0
1668129263559,ECE 200,025,103610,Mercier; Patrick Philip,9999,0,9999,0
1668129263559,ECE 200,026,103611,Meyer; Florian,9999,0,9999,0
1668129263559,ECE 200,027,103612,Milstein; Laurence B.,9999,0,9999,0
1668129263559,ECE 200,028,103613,Mir Arabbaygi; Siavash,9999,0,9999,0
1668129263559,ECE 200,029,103614,Mookherjea; Shayan,9999,0,9999,0
1668129263559,ECE 200,030,103615,Morris; Karcher William,9999,0,9999,0
1668129263559,ECE 200,031,103616,Ng; Tse Nga,9999,0,9999,0
1668129263559,ECE 200,032,103617,Nguyen; Truong Quang,9999,0,9999,0
1668129263559,ECE 200,033,103618,Nomura; Kenji,9999,0,9999,0
1668129263559,ECE 200,034,103619,Orlitsky; Alon,9999,0,9999,0
1668129263559,ECE 200,035,103620,Pal; Piya,9999,0,9999,0
1668129263559,ECE 200,036,103621,Papen; George C.,9999,0,9999,0
1668129263559,ECE 200,037,103622,Radic; Stojan,9999,0,9999,0
1668129263559,ECE 200,038,103623,Rao; Bhaskar D.,9999,0,9999,0
1668129263559,ECE 200,039,103624,Rao; Ramesh R,9999,0,9999,0
1668129263559,ECE 200,040,103625,Rebeiz; Gabriel,9999,0,9999,0
1668129263559,ECE 200,041,103626,Sanford; John R,9999,0,9999,0
1668129263559,ECE 200,042,103627,Siegel; Paul H.,9999,0,9999,0
1668129263559,ECE 200,043,103628,Sievenpiper; Daniel F.,9999,0,9999,0
1668129263559,ECE 200,044,103629,Sworder; David D.,9999,0,9999,0
1668129263559,ECE 200,045,103630,Taur; Yuan,9999,0,9999,0
1668129263559,ECE 200,046,103631,Touri; Behrouz,9999,0,9999,0
1668129263559,ECE 200,047,103632,Trivedi; Mohan M.,9999,0,9999,0
1668129263559,ECE 200,048,103633,Vasconcelos; Nuno,9999,0,9999,0
1668129263559,ECE 200,049,103634,Wang; Xiaolong,9999,0,9999,0
1668129263559,ECE 200,050,103635,Xie; Pengtao,9999,0,9999,0
1668129263559,ECE 200,051,103636,Yip; Michael,9999,0,9999,0
1668129263559,ECE 200,052,103637,Zeger; Kenneth A.,999,0,999,0
1668129263559,ECE 200,053,103638,Zhang; Xinyu,9999,0,9999,0
1668129263559,ECE 200,054,103639,Turakhia; Yatish Girish,9999,0,9999,0
1668129263559,ECE 200,055,103640,Kang; Mingu,9999,0,9999,0
1668129263559,ECE 200,056,103641,Shi; Yuanyuan,9999,0,9999,0
1668129263559,ECE 200,057,103642,Wang; Edward Jay,9999,0,9999,0
1668129263559,ECE 200,058,103643,Zheng; Yang,9999,0,9999,0
1668129263984,ECE 202,A00,103644,Kuzum; Duygu,0,0,0,0
1668129264414,ECE 212BN,A00,103646,Ng; Tse Nga,0,0,0,0
1668129264839,ECE 221,A00,111493,Staff,0,0,0,0
1668129265276,ECE 222B,A00,103647,Lomakin; Vitaliy,0,0,0,0
1668129265720,ECE 230B,A00,103648,Taur; Yuan,0,0,0,0
1668129266161,ECE 238B,A00,103649,Garay; Javier,0,0,0,0
1668129266591,ECE 240B,A00,112900,Fainman; Yeshaiahu,0,0,0,0
1668129267126,ECE 247A,A00,103650,Jokerst; Jesse Vincent,0,0,0,0
1668129267554,ECE 247B,A00,103651,Wang; Joseph,0,0,0,0
1668129267978,ECE 250,A00,103652,Siegel; Paul H.,0,0,0,0
1668129268406,ECE 251A,A00,103654,Rao; Bhaskar D.,0,0,0,0
1668129268841,ECE 257B,A00,103655,Bharadia; Dinesh,0,0,0,0
1668129269267,ECE 258A,A00,103656,Milstein; Laurence B.,0,0,0,0
1668129269695,ECE 260B,A00,103658,Kang; Mingu,0,0,0,0
1668129270116,ECE 264A,A00,103659,Galton; Ian A,0,0,0,0
1668129270551,ECE 265A,A00,103661,Gudem; Prasad S.S.,0,0,0,0
1668129270982,ECE 265D,A00,103662,Gudem; Prasad S.S.,0,0,0,0
1668129271421,ECE 268,A00,103663,Koushanfar; Farinaz,0,0,0,0
1668129271849,ECE 269,A01,103665,Pal; Piya,0,0,0,0
1668129272280,ECE 271B,A00,103666,Vasconcelos; Manuela,0,0,0,0
1668129272705,ECE 276A,A00,103667,Atanasov; Nikolay A.,0,0,0,0
1668129273136,ECE 277,A00,103668,An; Cheolhong,0,0,0,0
1668129273570,ECE 279,A00,117947,Hall; Drew A.,0,0,0,0
1668129274419,ECE 283,A00,103670,Hsueh; Tzu-Chien,0,0,0,0
1668129274858,ECE 284,A00,103671,Turakhia; Yatish Girish,0,0,0,0
1668129275298,ECE 285,A00,103672,Zheng; Yang,0,0,0,0
1668129275298,ECE 285,B00,103673,Sworder; David D.,0,0,0,0
1668129275729,ECE 287,A00,103676,Javidi; Tara,0,0,0,0
1668129276168,MATH 200B,A00,098023,Salehi Golsefidy; Alireza,12,0,15,3
1668129276602,MATH 202B,A00,098024,Rhoades; Brendon Patrick,9,0,15,6
1668129277027,MATH 203B,A00,098025,Oprea; Dragos N.,10,0,15,5
1668129277458,MATH 204B,A00,098026,Sorensen; Claus M,13,0,15,2
1668129277888,MATH 208,A00,098027,Izadi; Elham,7,0,10,3
1668129278319,MATH 209,A00,098028,Pollack; Aaron,10,0,10,0
1668129278742,MATH 211A,A00,112919,Rogalski; Daniel,9,0,10,1
1668129279179,MATH 211B,A00,112920,Seward; Brandon M.,9,0,10,1
1668129279602,MATH 218,A00,098029,Li; Bo,10,0,10,0
1668129280027,MATH 220B,A00,098030,Novak; Jonathan I,11,0,15,4
1668129280462,MATH 221A,A00,098031,Ebenfelt; Peter F,13,0,15,2
1668129280899,MATH 231B,A00,098032,Zlatos; Andrej,12,0,15,3
1668129281321,MATH 240B,A00,098033,Ni; Lei,9,0,15,6
1668129281757,MATH 243,A00,098034,Jekel; David Andrew,10,0,10,0
1668129282179,MATH 245A,A00,098035,Nie; Jiawang,0,0,15,16
1668129282600,MATH 248,A00,098036,Bejenaru; Ioan,10,0,10,0
1668129283024,MATH 250B,A00,098037,Spolaor; Luca,14,0,15,1
1668129283459,MATH 258,A00,098038,Ni; Lei,10,0,10,0
1668129283890,MATH 264B,A00,098041,Rhoades; Brendon Patrick,9,0,15,6
1668129284317,MATH 268,A00,098042,Buss; Samuel R,10,0,10,0
1668129284740,MATH 269,A00,098043,Rhoades; Brendon Patrick,10,0,10,0
1668129285166,MATH 270B,A00,098044,Li; Bo,10,0,15,5
1668129285595,MATH 272B,A00,098045,Holst; Michael J,13,0,15,2
1668129286025,MATH 273A,A00,098046,Tian; Xiaochuan,10,0,15,5
1668129286451,MATH 275,A01,098048,Tian; Xiaochuan,6,0,10,4
1668129286878,MATH 278A,A00,098049,Holst; Michael J,8,0,10,2
1668129287318,MATH 278B,A00,098050,Cloninger; Alexander,10,0,10,0
1668129287752,MATH 278C,A00,098051,Nie; Jiawang,7,0,10,3
1668129288192,MATH 280B,A00,098052,Zheng; Tianyi,10,0,15,5
1668129288614,MATH 281B,A00,098053,Bradic; Jelena,2,0,15,13
1668129289047,MATH 282B,A00,098054,Arias-Castro; Ery,0,0,15,15
1668129289471,MATH 285,A00,098055,Fitzsimmons; Patrick J,0,0,15,17
1668129289899,MATH 287B,A00,098056,Arias-Castro; Ery,3,0,15,12
1668129290334,MATH 288,A00,098057,Agarwal; Pooja,9,0,10,1
1668129290334,MATH 288,B00,098058,Zhang; Danna,8,0,10,2
1668129290334,MATH 288,C00,098059,Williams; Ruth J,10,0,10,0
1668129290756,MATH 290B,A00,098060,Roberts; Justin Deritter,13,0,15,2
1668129291180,MATH 292,A00,098061,Belmont; Eva Kinoshita,10,0,10,0
1668129291602,MATH 295,A00,098062,Suk; Andrew Hoon,48,0,50,2
1668129292025,MATH 296,A00,098063,Novak; Jonathan I,20,0,20,0
1668129292448,MATH 297,001,098064,Gamst; Anthony Collins,9997,0,9999,2
1668129795779,COGS 205,A00,101395,Chiba; Andrea,19,0,20,1
1668129796206,COGS 210B,001,101404,Greene; Deanna Jacquelyn,9998,0,9999,1
1668129796206,COGS 210B,002,101417,Xia; Haijun,9999,0,9999,0
1668129796206,COGS 210B,003,101422,Nitz; Douglas A.,9999,0,9999,0
1668129796206,COGS 210B,004,101423,Hollan; James D.,9998,0,9999,1
1668129796206,COGS 210B,005,101424,Deak; Gedeon O.,9998,0,9999,1
1668129796206,COGS 210B,006,101425,Rossano; Federico,9999,0,9999,0
1668129796642,COGS 211B,A00,101427,Coulson; Seana M,9996,0,9999,3
1668129797065,COGS 220,A00,101428,Hollan; James D.,0,0,25,25
1668129797489,COGS 229,A00,101429,Dow; Steven P,18,0,25,7
1668129797912,COGS 230,A00,101430,Klemmer; Scott R,12,0,17,5
1668129798336,COGS 234,A00,101431,Xia; Haijun,3,0,25,22
1668129798761,COGS 260,A00,101432,Kiyonaga; Anastasia,20,0,25,5
1668129798761,COGS 260,B00,101433,Kirsh; David Joel,16,0,25,9
1668129799185,CSE 202,A00,102371,Impagliazzo; Russell,0,0,0,0
1668129799609,CSE 203B,A01,102373,Cheng; Chung Kuan,0,0,0,0
1668129800037,CSE 208,A00,102374,Micciancio; Daniele,0,0,0,0
1668129800463,CSE 209A,A00,112895,Impagliazzo; Russell,0,0,15,15
1668129800898,CSE 209B,A00,108005,Bellare; Mihir,0,0,0,0
1668129801323,CSE 210,A00,113163,Coblenz; Michael J,0,0,0,0
1668129801755,CSE 219,A00,106111,Dow; Steven P,0,0,20,20
1668129802180,CSE 221,A00,102376,Voelker; Geoffrey M.,0,0,0,0
1668129802606,CSE 224,A01,102378,Porter; George M,0,0,0,0
1668129803029,CSE 229A,A00,102379,Savage; Stefan,0,0,0,0
1668129803453,CSE 229C,A00,102380,Munyaka; Imani N. S.,0,0,0,0
1668129803877,CSE 232B,A00,102382,Deutsch; Alin Bernard,0,0,0,0
1668129804308,CSE 234,A01,112904,Kumar; Arun Kumar,0,0,0,0
1668129804731,CSE 237A,A00,102383,Rosing; Tajana Simunic,0,0,0,0
1668129805154,CSE 239A,A00,102384,Deutsch; Alin Bernard,0,0,0,0
1668129805586,CSE 239B,A00,102385,Polikarpova; Nadezhda,0,0,0,0
1668129806016,CSE 240A,A00,102386,Pannuto; Patrick William,0,0,0,0
1668129806446,CSE 240B,A00,102387,Zhao; Jishen,0,0,0,0
1668129806872,CSE 241A,A00,106406,Kang; Mingu,0,0,0,0
1668129807298,CSE 249B,A00,102388,Kahng; Andrew Byun,0,0,8,8
1668129807721,CSE 251B,A01,102392,Cottrell; Garrison W,0,0,0,0
1668129807721,CSE 251B,A02,102393,Cottrell; Garrison W,0,0,0,0
1668129808144,CSE 252B,A00,102394,Ochoa; Benjamin Lawrence,0,0,0,0
1668129808571,CSE 257,A01,102396,Gao; Sicun,0,0,0,0
1668129809000,CSE 272,A00,102397,Li; Tzumao,0,0,0,0
1668129809435,CSE 274,A00,111323,Chern; Albert Ren-Haur,0,0,0,0
1668129809859,CSE 282,A00,102398,Pevzner; Pavel Arkadjevich,0,0,0,0
1668129810300,CSE 284,A00,114175,Gymrek; Melissa Ann,0,0,0,0
1668129810722,CSE 290,A00,102399,Chandraker; Manmohan Krishna,0,0,0,0
1668129810722,CSE 290,B00,102400,Vaccaro; Kristen Marie,0,0,25,25
1668129810722,CSE 290,C00,102414,Pannuto; Patrick William,0,0,25,25
1668129810722,CSE 290,D00,102427,Pevzner; Pavel Arkadjevich,0,0,0,0
1668129810722,CSE 290,E00,102429,Zhao; Jishen,0,0,0,0
1668129810722,CSE 290,F00,102436,Tullsen; Dean Michael,0,0,0,0
1668129810722,CSE 290,G00,102440,Christensen; Henrik I,0,0,20,20
1668129811151,CSE 291,A00,102443,Su; Hao,0,0,0,0
1668129811151,CSE 291,B00,102448,Polikarpova; Nadezhda,0,0,0,0
1668129811151,CSE 291,C00,102453,Vaccaro; Kristen Marie,0,0,0,0
1668129811151,CSE 291,D00,111343,Savage; Stefan,0,0,0,0
1668129811151,CSE 291,E00,116474,Claffy; Kimberly Claire,0,0,0,0
1668129811151,CSE 291,F00,116479,Pasquale; Joseph,0,0,0,0
1668129811583,CSE 293,001,119111,Bafna; Vineet,9999,0,9999,0
1668129811583,CSE 293,002,119118,Bellare; Mihir,9999,0,9999,0
1668129811583,CSE 293,003,119122,Berg-Kirkpatrick; Taylor D,9999,0,9999,0
1668129811583,CSE 293,004,119135,Christensen; Henrik I,9999,0,9999,0
1668129811583,CSE 293,005,119142,Cottrell; Garrison W,9999,0,9999,0
1668129811583,CSE 293,006,119146,Deutsch; Alin Bernard,9999,0,9999,0
1668129811583,CSE 293,007,119159,Esmaeilzadeh; Hadi,9999,0,9999,0
1668129811583,CSE 293,008,119166,Freund; Yoav,9999,0,9999,0
1668129811583,CSE 293,009,119170,Griswold; William G.,9999,0,9999,0
1668129811583,CSE 293,010,119183,Gymrek; Melissa Ann,9999,0,9999,0
1668129811583,CSE 293,011,119190,Heninger; Nadia A,9999,0,9999,0
1668129811583,CSE 293,012,119230,Impagliazzo; Russell,9999,0,9999,0
1668129811583,CSE 293,013,119232,Jhala; Ranjit,9999,0,9999,0
1668129811583,CSE 293,014,119233,Kahng; Andrew Byun,9999,0,9999,0
1668129811583,CSE 293,015,119298,Kane; Daniel Mertz,9999,0,9999,0
1668129811583,CSE 293,016,119299,Kriegman; David J,9999,0,9999,0
1668129811583,CSE 293,017,119300,Kumar; Arun Kumar,9999,0,9999,0
1668129811583,CSE 293,018,119301,Lerner; Sorin,9999,0,9999,0
1668129811583,CSE 293,019,119302,Lovett; Shachar,9999,0,9999,0
1668129811583,CSE 293,020,119303,McAuley; Julian John,9999,0,9999,0
1668129811583,CSE 293,021,119304,Micciancio; Daniele,9999,0,9999,0
1668129811583,CSE 293,022,119367,Orailoglu; Alex,9999,0,9999,0
1668129811583,CSE 293,023,119382,Paturi; Ramamohan,9999,0,9999,0
1668129811583,CSE 293,024,119404,Polikarpova; Nadezhda,9999,0,9999,0
1668129811583,CSE 293,025,119406,Politz; Joseph Gibbs,9999,0,9999,0
1668129811583,CSE 293,026,119411,Porter; George M,9999,0,9999,0
1668129811583,CSE 293,027,119414,Porter; Leonard Emerson,9999,0,9999,0
1668129811583,CSE 293,028,119416,Ramamoorthi; Ravi,9999,0,9999,0
1668129811583,CSE 293,029,119417,Sahoo; Debashis,9999,0,9999,0
1668129811583,CSE 293,030,119420,Saul; Lawrence,9999,0,9999,0
1668129811583,CSE 293,031,119421,Savage; Stefan,9999,0,9999,0
1668129811583,CSE 293,032,119425,Schulze; Jurgen P.,9999,0,9999,0
1668129811583,CSE 293,033,119426,Snoeren; Alex C.,9999,0,9999,0
1668129811583,CSE 293,034,119428,Shang; Jingbo,9999,0,9999,0
1668129811583,CSE 293,035,119430,Stefan; Deian,9999,0,9999,0
1668129811583,CSE 293,036,119431,Su; Hao,9999,0,9999,0
1668129811583,CSE 293,037,119433,Swanson; Steven James,9999,0,9999,0
1668129811583,CSE 293,038,119435,Tullsen; Dean Michael,9999,0,9999,0
1668129811583,CSE 293,039,119483,Voelker; Geoffrey M.,9999,0,9999,0
1668129811583,CSE 293,040,119537,Zhao; Jishen,9999,0,9999,0
1668129811583,CSE 293,041,119538,Zhou; Yuan-Yuan,9999,0,9999,0
1668129811583,CSE 293,042,119539,Gao; Sicun,9999,0,9999,0
1668129811583,CSE 293,043,119540,Weibel; Nadir,9999,0,9999,0
1668129811583,CSE 293,044,119541,Gupta; Rajesh K.,9999,0,9999,0
1668129811583,CSE 293,045,126410,Vaccaro; Kristen Marie,9999,0,9999,0
1668129811583,CSE 293,046,126411,Klemke; Richard,9999,0,9999,0
1668129812007,CSE 294,A00,102459,Voelker; Geoffrey M.,0,0,0,0
1668129812007,CSE 294,B00,111322,Orailoglu; Alex,0,0,0,0
1668129812438,DSE 201,A00,096914,Deutsch; Alin Bernard,30,0,30,0
1668129812872,DSE 210,A00,096915,Dasgupta; Sanjoy,30,0,30,0
1668129813298,DSE 260A,A00,096916,Altintas De Callaf; Ilkay,30,0,30,0
1668129813738,ECE 200,001,103586,Antipa; Nicholas A,9999,0,9999,0
1668129813738,ECE 200,002,103587,Atanasov; Nikolay A.,9999,0,9999,0
1668129813738,ECE 200,003,103588,Bharadia; Dinesh,9999,0,9999,0
1668129813738,ECE 200,004,103589,Cheng; Chung Kuan,9999,0,9999,0
1668129813738,ECE 200,005,103590,Cosman; Pamela C.,9999,0,9999,0
1668129813738,ECE 200,006,103591,Dayeh; Shadi Ahmad,9999,0,9999,0
1668129813738,ECE 200,007,103592,Fainman; Yeshaiahu,9999,0,9999,0
1668129813738,ECE 200,008,103593,Ford; Joseph Earl,9999,0,9999,0
1668129813738,ECE 200,009,103594,Franceschetti; Massimo,9999,0,9999,0
1668129813738,ECE 200,010,103595,Fullerton; Eric E,9999,0,9999,0
1668129813738,ECE 200,011,103596,Galton; Ian A,9999,0,9999,0
1668129813738,ECE 200,012,103597,Gilja; Vikash,9999,0,9999,0
1668129813738,ECE 200,013,103598,Hall; Drew A.,9999,0,9999,0
1668129813738,ECE 200,014,103599,Hsueh; Tzu-Chien,9999,0,9999,0
1668129813738,ECE 200,015,103600,Javidi; Tara,9999,0,9999,0
1668129813738,ECE 200,016,103601,Kahng; Andrew Byun,9999,0,9999,0
1668129813738,ECE 200,017,103602,Kim; Young-Han,9999,0,9999,0
1668129813738,ECE 200,018,103603,Koushanfar; Farinaz,9999,0,9999,0
1668129813738,ECE 200,019,103604,Kuzum; Duygu,9999,0,9999,0
1668129813738,ECE 200,020,103605,Le; Hanh-Phuc,9999,0,9999,0
1668129813738,ECE 200,021,103606,Lin; Bill,9999,0,9999,0
1668129813738,ECE 200,022,103607,Liu; Zhaowei,9998,0,9999,1
1668129813738,ECE 200,023,103608,Lo; Yu-Hwa,9999,0,9999,0
1668129813738,ECE 200,024,103609,Lomakin; Vitaliy,9999,0,9999,0
1668129813738,ECE 200,025,103610,Mercier; Patrick Philip,9999,0,9999,0
1668129813738,ECE 200,026,103611,Meyer; Florian,9999,0,9999,0
1668129813738,ECE 200,027,103612,Milstein; Laurence B.,9999,0,9999,0
1668129813738,ECE 200,028,103613,Mir Arabbaygi; Siavash,9999,0,9999,0
1668129813738,ECE 200,029,103614,Mookherjea; Shayan,9999,0,9999,0
1668129813738,ECE 200,030,103615,Morris; Karcher William,9999,0,9999,0
1668129813738,ECE 200,031,103616,Ng; Tse Nga,9999,0,9999,0
1668129813738,ECE 200,032,103617,Nguyen; Truong Quang,9999,0,9999,0
1668129813738,ECE 200,033,103618,Nomura; Kenji,9999,0,9999,0
1668129813738,ECE 200,034,103619,Orlitsky; Alon,9999,0,9999,0
1668129813738,ECE 200,035,103620,Pal; Piya,9999,0,9999,0
1668129813738,ECE 200,036,103621,Papen; George C.,9999,0,9999,0
1668129813738,ECE 200,037,103622,Radic; Stojan,9999,0,9999,0
1668129813738,ECE 200,038,103623,Rao; Bhaskar D.,9999,0,9999,0
1668129813738,ECE 200,039,103624,Rao; Ramesh R,9999,0,9999,0
1668129813738,ECE 200,040,103625,Rebeiz; Gabriel,9999,0,9999,0
1668129813738,ECE 200,041,103626,Sanford; John R,9999,0,9999,0
1668129813738,ECE 200,042,103627,Siegel; Paul H.,9999,0,9999,0
1668129813738,ECE 200,043,103628,Sievenpiper; Daniel F.,9999,0,9999,0
1668129813738,ECE 200,044,103629,Sworder; David D.,9999,0,9999,0
1668129813738,ECE 200,045,103630,Taur; Yuan,9999,0,9999,0
1668129813738,ECE 200,046,103631,Touri; Behrouz,9999,0,9999,0
1668129813738,ECE 200,047,103632,Trivedi; Mohan M.,9999,0,9999,0
1668129813738,ECE 200,048,103633,Vasconcelos; Nuno,9999,0,9999,0
1668129813738,ECE 200,049,103634,Wang; Xiaolong,9999,0,9999,0
1668129813738,ECE 200,050,103635,Xie; Pengtao,9999,0,9999,0
1668129813738,ECE 200,051,103636,Yip; Michael,9999,0,9999,0
1668129813738,ECE 200,052,103637,Zeger; Kenneth A.,999,0,999,0
1668129813738,ECE 200,053,103638,Zhang; Xinyu,9999,0,9999,0
1668129813738,ECE 200,054,103639,Turakhia; Yatish Girish,9999,0,9999,0
1668129813738,ECE 200,055,103640,Kang; Mingu,9999,0,9999,0
1668129813738,ECE 200,056,103641,Shi; Yuanyuan,9999,0,9999,0
1668129813738,ECE 200,057,103642,Wang; Edward Jay,9999,0,9999,0
1668129813738,ECE 200,058,103643,Zheng; Yang,9999,0,9999,0
1668129814178,ECE 202,A00,103644,Kuzum; Duygu,0,0,0,0
1668129814601,ECE 212BN,A00,103646,Ng; Tse Nga,0,0,0,0
1668129815028,ECE 221,A00,111493,Staff,0,0,0,0
1668129815453,ECE 222B,A00,103647,Lomakin; Vitaliy,0,0,0,0
1668129815876,ECE 230B,A00,103648,Taur; Yuan,0,0,0,0
1668129816300,ECE 238B,A00,103649,Garay; Javier,0,0,0,0
1668129816725,ECE 240B,A00,112900,Fainman; Yeshaiahu,0,0,0,0
1668129817156,ECE 247A,A00,103650,Jokerst; Jesse Vincent,0,0,0,0
1668129817582,ECE 247B,A00,103651,Wang; Joseph,0,0,0,0
1668129818011,ECE 250,A00,103652,Siegel; Paul H.,0,0,0,0
1668129818450,ECE 251A,A00,103654,Rao; Bhaskar D.,0,0,0,0
1668129818883,ECE 257B,A00,103655,Bharadia; Dinesh,0,0,0,0
1668129819318,ECE 258A,A00,103656,Milstein; Laurence B.,0,0,0,0
1668129819745,ECE 260B,A00,103658,Kang; Mingu,0,0,0,0
1668129820187,ECE 264A,A00,103659,Galton; Ian A,0,0,0,0
1668129820611,ECE 265A,A00,103661,Gudem; Prasad S.S.,0,0,0,0
1668129821037,ECE 265D,A00,103662,Gudem; Prasad S.S.,0,0,0,0
1668129821468,ECE 268,A00,103663,Koushanfar; Farinaz,0,0,0,0
1668129821894,ECE 269,A01,103665,Pal; Piya,0,0,0,0
1668129822319,ECE 271B,A00,103666,Vasconcelos; Manuela,0,0,0,0
1668129822742,ECE 276A,A00,103667,Atanasov; Nikolay A.,0,0,0,0
1668129823172,ECE 277,A00,103668,An; Cheolhong,0,0,0,0
1668129823602,ECE 279,A00,117947,Hall; Drew A.,0,0,0,0
1668129824456,ECE 283,A00,103670,Hsueh; Tzu-Chien,0,0,0,0
1668129824881,ECE 284,A00,103671,Turakhia; Yatish Girish,0,0,0,0
1668129825308,ECE 285,A00,103672,Zheng; Yang,0,0,0,0
1668129825308,ECE 285,B00,103673,Sworder; David D.,0,0,0,0
1668129825728,ECE 287,A00,103676,Javidi; Tara,0,0,0,0
1668129826153,MATH 200B,A00,098023,Salehi Golsefidy; Alireza,12,0,15,3
1668129826578,MATH 202B,A00,098024,Rhoades; Brendon Patrick,9,0,15,6
1668129827007,MATH 203B,A00,098025,Oprea; Dragos N.,10,0,15,5
1668129827433,MATH 204B,A00,098026,Sorensen; Claus M,13,0,15,2
1668129827859,MATH 208,A00,098027,Izadi; Elham,7,0,10,3
1668129828286,MATH 209,A00,098028,Pollack; Aaron,10,0,10,0
1668129828716,MATH 211A,A00,112919,Rogalski; Daniel,9,0,10,1
1668129829140,MATH 211B,A00,112920,Seward; Brandon M.,9,0,10,1
1668129829563,MATH 218,A00,098029,Li; Bo,10,0,10,0
1668129829985,MATH 220B,A00,098030,Novak; Jonathan I,11,0,15,4
1668129830410,MATH 221A,A00,098031,Ebenfelt; Peter F,13,0,15,2
1668129830836,MATH 231B,A00,098032,Zlatos; Andrej,12,0,15,3
1668129831268,MATH 240B,A00,098033,Ni; Lei,9,0,15,6
1668129831691,MATH 243,A00,098034,Jekel; David Andrew,10,0,10,0
1668129832121,MATH 245A,A00,098035,Nie; Jiawang,0,0,15,16
1668129832550,MATH 248,A00,098036,Bejenaru; Ioan,10,0,10,0
1668129832975,MATH 250B,A00,098037,Spolaor; Luca,14,0,15,1
1668129833413,MATH 258,A00,098038,Ni; Lei,10,0,10,0
1668129833910,MATH 264B,A00,098041,Rhoades; Brendon Patrick,9,0,15,6
1668129834338,MATH 268,A00,098042,Buss; Samuel R,10,0,10,0
1668129834758,MATH 269,A00,098043,Rhoades; Brendon Patrick,10,0,10,0
1668129835184,MATH 270B,A00,098044,Li; Bo,10,0,15,5
1668129835618,MATH 272B,A00,098045,Holst; Michael J,13,0,15,2
1668129836041,MATH 273A,A00,098046,Tian; Xiaochuan,10,0,15,5
1668129836467,MATH 275,A01,098048,Tian; Xiaochuan,6,0,10,4
1668129836891,MATH 278A,A00,098049,Holst; Michael J,8,0,10,2
1668129837319,MATH 278B,A00,098050,Cloninger; Alexander,10,0,10,0
1668129837742,MATH 278C,A00,098051,Nie; Jiawang,7,0,10,3
1668129838172,MATH 280B,A00,098052,Zheng; Tianyi,10,0,15,5
1668129838594,MATH 281B,A00,098053,Bradic; Jelena,2,0,15,13
1668129839027,MATH 282B,A00,098054,Arias-Castro; Ery,0,0,15,15
1668129839449,MATH 285,A00,098055,Fitzsimmons; Patrick J,0,0,15,17
1668129839884,MATH 287B,A00,098056,Arias-Castro; Ery,3,0,15,12
1668129840307,MATH 288,A00,098057,Agarwal; Pooja,9,0,10,1
1668129840307,MATH 288,B00,098058,Zhang; Danna,8,0,10,2
1668129840307,MATH 288,C00,098059,Williams; Ruth J,10,0,10,0
1668129840736,MATH 290B,A00,098060,Roberts; Justin Deritter,13,0,15,2
1668129841160,MATH 292,A00,098061,Belmont; Eva Kinoshita,10,0,10,0
1668129841589,MATH 295,A00,098062,Suk; Andrew Hoon,48,0,50,2
1668129842016,MATH 296,A00,098063,Novak; Jonathan I,20,0,20,0
1668129842446,MATH 297,001,098064,Gamst; Anthony Collins,9997,0,9999,2
1668130359724,COGS 205,A00,101395,Chiba; Andrea,19,0,20,1
1668130360147,COGS 210B,001,101404,Greene; Deanna Jacquelyn,9998,0,9999,1
1668130360147,COGS 210B,002,101417,Xia; Haijun,9999,0,9999,0
1668130360147,COGS 210B,003,101422,Nitz; Douglas A.,9999,0,9999,0
1668130360147,COGS 210B,004,101423,Hollan; James D.,9998,0,9999,1
1668130360147,COGS 210B,005,101424,Deak; Gedeon O.,9998,0,9999,1
1668130360147,COGS 210B,006,101425,Rossano; Federico,9999,0,9999,0
1668130360572,COGS 211B,A00,101427,Coulson; Seana M,9996,0,9999,3
1668130361006,COGS 220,A00,101428,Hollan; James D.,0,0,25,25
1668130361430,COGS 229,A00,101429,Dow; Steven P,18,0,25,7
1668130361855,COGS 230,A00,101430,Klemmer; Scott R,12,0,17,5
1668130362291,COGS 234,A00,101431,Xia; Haijun,3,0,25,22
1668130362723,COGS 260,A00,101432,Kiyonaga; Anastasia,20,0,25,5
1668130362723,COGS 260,B00,101433,Kirsh; David Joel,16,0,25,9
1668130363148,CSE 202,A00,102371,Impagliazzo; Russell,0,0,0,0
1668130363572,CSE 203B,A01,102373,Cheng; Chung Kuan,0,0,0,0
1668130364008,CSE 208,A00,102374,Micciancio; Daniele,0,0,0,0
1668130364434,CSE 209A,A00,112895,Impagliazzo; Russell,0,0,15,15
1668130364871,CSE 209B,A00,108005,Bellare; Mihir,0,0,0,0
1668130365303,CSE 210,A00,113163,Coblenz; Michael J,0,0,0,0
1668130365730,CSE 219,A00,106111,Dow; Steven P,0,0,20,20
1668130366168,CSE 221,A00,102376,Voelker; Geoffrey M.,0,0,0,0
1668130366593,CSE 224,A01,102378,Porter; George M,0,0,0,0
1668130367018,CSE 229A,A00,102379,Savage; Stefan,0,0,0,0
1668130367441,CSE 229C,A00,102380,Munyaka; Imani N. S.,0,0,0,0
1668130367863,CSE 232B,A00,102382,Deutsch; Alin Bernard,0,0,0,0
1668130368287,CSE 234,A01,112904,Kumar; Arun Kumar,0,0,0,0
1668130368718,CSE 237A,A00,102383,Rosing; Tajana Simunic,0,0,0,0
1668130369142,CSE 239A,A00,102384,Deutsch; Alin Bernard,0,0,0,0
1668130369566,CSE 239B,A00,102385,Polikarpova; Nadezhda,0,0,0,0
1668130369988,CSE 240A,A00,102386,Pannuto; Patrick William,0,0,0,0
1668130370422,CSE 240B,A00,102387,Zhao; Jishen,0,0,0,0
1668130370853,CSE 241A,A00,106406,Kang; Mingu,0,0,0,0
1668130371348,CSE 249B,A00,102388,Kahng; Andrew Byun,0,0,8,8
1668130371780,CSE 251B,A01,102392,Cottrell; Garrison W,0,0,0,0
1668130371780,CSE 251B,A02,102393,Cottrell; Garrison W,0,0,0,0
1668130372215,CSE 252B,A00,102394,Ochoa; Benjamin Lawrence,0,0,0,0
1668130372637,CSE 257,A01,102396,Gao; Sicun,0,0,0,0
1668130373060,CSE 272,A00,102397,Li; Tzumao,0,0,0,0
1668130373499,CSE 274,A00,111323,Chern; Albert Ren-Haur,0,0,0,0
1668130373921,CSE 282,A00,102398,Pevzner; Pavel Arkadjevich,0,0,0,0
1668130374346,CSE 284,A00,114175,Gymrek; Melissa Ann,0,0,0,0
1668130374770,CSE 290,A00,102399,Chandraker; Manmohan Krishna,0,0,0,0
1668130374770,CSE 290,B00,102400,Vaccaro; Kristen Marie,0,0,25,25
1668130374770,CSE 290,C00,102414,Pannuto; Patrick William,0,0,25,25
1668130374770,CSE 290,D00,102427,Pevzner; Pavel Arkadjevich,0,0,0,0
1668130374770,CSE 290,E00,102429,Zhao; Jishen,0,0,0,0
1668130374770,CSE 290,F00,102436,Tullsen; Dean Michael,0,0,0,0
1668130374770,CSE 290,G00,102440,Christensen; Henrik I,0,0,20,20
1668130375203,CSE 291,A00,102443,Su; Hao,0,0,0,0
1668130375203,CSE 291,B00,102448,Polikarpova; Nadezhda,0,0,0,0
1668130375203,CSE 291,C00,102453,Vaccaro; Kristen Marie,0,0,0,0
1668130375203,CSE 291,D00,111343,Savage; Stefan,0,0,0,0
1668130375203,CSE 291,E00,116474,Claffy; Kimberly Claire,0,0,0,0
1668130375203,CSE 291,F00,116479,Pasquale; Joseph,0,0,0,0
1668130375645,CSE 293,001,119111,Bafna; Vineet,9999,0,9999,0
1668130375645,CSE 293,002,119118,Bellare; Mihir,9999,0,9999,0
1668130375645,CSE 293,003,119122,Berg-Kirkpatrick; Taylor D,9999,0,9999,0
1668130375645,CSE 293,004,119135,Christensen; Henrik I,9999,0,9999,0
1668130375645,CSE 293,005,119142,Cottrell; Garrison W,9999,0,9999,0
1668130375645,CSE 293,006,119146,Deutsch; Alin Bernard,9999,0,9999,0
1668130375645,CSE 293,007,119159,Esmaeilzadeh; Hadi,9999,0,9999,0
1668130375645,CSE 293,008,119166,Freund; Yoav,9999,0,9999,0
1668130375645,CSE 293,009,119170,Griswold; William G.,9999,0,9999,0
1668130375645,CSE 293,010,119183,Gymrek; Melissa Ann,9999,0,9999,0
1668130375645,CSE 293,011,119190,Heninger; Nadia A,9999,0,9999,0
1668130375645,CSE 293,012,119230,Impagliazzo; Russell,9999,0,9999,0
1668130375645,CSE 293,013,119232,Jhala; Ranjit,9999,0,9999,0
1668130375645,CSE 293,014,119233,Kahng; Andrew Byun,9999,0,9999,0
1668130375645,CSE 293,015,119298,Kane; Daniel Mertz,9999,0,9999,0
1668130375645,CSE 293,016,119299,Kriegman; David J,9999,0,9999,0
1668130375645,CSE 293,017,119300,Kumar; Arun Kumar,9999,0,9999,0
1668130375645,CSE 293,018,119301,Lerner; Sorin,9999,0,9999,0
1668130375645,CSE 293,019,119302,Lovett; Shachar,9999,0,9999,0
1668130375645,CSE 293,020,119303,McAuley; Julian John,9999,0,9999,0
1668130375645,CSE 293,021,119304,Micciancio; Daniele,9999,0,9999,0
1668130375645,CSE 293,022,119367,Orailoglu; Alex,9999,0,9999,0
1668130375645,CSE 293,023,119382,Paturi; Ramamohan,9999,0,9999,0
1668130375645,CSE 293,024,119404,Polikarpova; Nadezhda,9999,0,9999,0
1668130375645,CSE 293,025,119406,Politz; Joseph Gibbs,9999,0,9999,0
1668130375645,CSE 293,026,119411,Porter; George M,9999,0,9999,0
1668130375645,CSE 293,027,119414,Porter; Leonard Emerson,9999,0,9999,0
1668130375645,CSE 293,028,119416,Ramamoorthi; Ravi,9999,0,9999,0
1668130375645,CSE 293,029,119417,Sahoo; Debashis,9999,0,9999,0
1668130375645,CSE 293,030,119420,Saul; Lawrence,9999,0,9999,0
1668130375645,CSE 293,031,119421,Savage; Stefan,9999,0,9999,0
1668130375645,CSE 293,032,119425,Schulze; Jurgen P.,9999,0,9999,0
1668130375645,CSE 293,033,119426,Snoeren; Alex C.,9999,0,9999,0
1668130375645,CSE 293,034,119428,Shang; Jingbo,9999,0,9999,0
1668130375645,CSE 293,035,119430,Stefan; Deian,9999,0,9999,0
1668130375645,CSE 293,036,119431,Su; Hao,9999,0,9999,0
1668130375645,CSE 293,037,119433,Swanson; Steven James,9999,0,9999,0
1668130375645,CSE 293,038,119435,Tullsen; Dean Michael,9999,0,9999,0
1668130375645,CSE 293,039,119483,Voelker; Geoffrey M.,9999,0,9999,0
1668130375645,CSE 293,040,119537,Zhao; Jishen,9999,0,9999,0
1668130375645,CSE 293,041,119538,Zhou; Yuan-Yuan,9999,0,9999,0
1668130375645,CSE 293,042,119539,Gao; Sicun,9999,0,9999,0
1668130375645,CSE 293,043,119540,Weibel; Nadir,9999,0,9999,0
1668130375645,CSE 293,044,119541,Gupta; Rajesh K.,9999,0,9999,0
1668130375645,CSE 293,045,126410,Vaccaro; Kristen Marie,9999,0,9999,0
1668130375645,CSE 293,046,126411,Klemke; Richard,9999,0,9999,0
1668130376070,CSE 294,A00,102459,Voelker; Geoffrey M.,0,0,0,0
1668130376070,CSE 294,B00,111322,Orailoglu; Alex,0,0,0,0
1668130376494,DSE 201,A00,096914,Deutsch; Alin Bernard,30,0,30,0
1668130376925,DSE 210,A00,096915,Dasgupta; Sanjoy,30,0,30,0
1668130377348,DSE 260A,A00,096916,Altintas De Callaf; Ilkay,30,0,30,0
1668130377788,ECE 200,001,103586,Antipa; Nicholas A,9999,0,9999,0
1668130377788,ECE 200,002,103587,Atanasov; Nikolay A.,9999,0,9999,0
1668130377788,ECE 200,003,103588,Bharadia; Dinesh,9999,0,9999,0
1668130377788,ECE 200,004,103589,Cheng; Chung Kuan,9999,0,9999,0
1668130377788,ECE 200,005,103590,Cosman; Pamela C.,9999,0,9999,0
1668130377788,ECE 200,006,103591,Dayeh; Shadi Ahmad,9999,0,9999,0
1668130377788,ECE 200,007,103592,Fainman; Yeshaiahu,9999,0,9999,0
1668130377788,ECE 200,008,103593,Ford; Joseph Earl,9999,0,9999,0
1668130377788,ECE 200,009,103594,Franceschetti; Massimo,9999,0,9999,0
1668130377788,ECE 200,010,103595,Fullerton; Eric E,9999,0,9999,0
1668130377788,ECE 200,011,103596,Galton; Ian A,9999,0,9999,0
1668130377788,ECE 200,012,103597,Gilja; Vikash,9999,0,9999,0
1668130377788,ECE 200,013,103598,Hall; Drew A.,9999,0,9999,0
1668130377788,ECE 200,014,103599,Hsueh; Tzu-Chien,9999,0,9999,0
1668130377788,ECE 200,015,103600,Javidi; Tara,9999,0,9999,0
1668130377788,ECE 200,016,103601,Kahng; Andrew Byun,9999,0,9999,0
1668130377788,ECE 200,017,103602,Kim; Young-Han,9999,0,9999,0
1668130377788,ECE 200,018,103603,Koushanfar; Farinaz,9999,0,9999,0
1668130377788,ECE 200,019,103604,Kuzum; Duygu,9999,0,9999,0
1668130377788,ECE 200,020,103605,Le; Hanh-Phuc,9999,0,9999,0
1668130377788,ECE 200,021,103606,Lin; Bill,9999,0,9999,0
1668130377788,ECE 200,022,103607,Liu; Zhaowei,9998,0,9999,1
1668130377788,ECE 200,023,103608,Lo; Yu-Hwa,9999,0,9999,0
1668130377788,ECE 200,024,103609,Lomakin; Vitaliy,9999,0,9999,0
1668130377788,ECE 200,025,103610,Mercier; Patrick Philip,9999,0,9999,0
1668130377788,ECE 200,026,103611,Meyer; Florian,9999,0,9999,0
1668130377788,ECE 200,027,103612,Milstein; Laurence B.,9999,0,9999,0
1668130377788,ECE 200,028,103613,Mir Arabbaygi; Siavash,9999,0,9999,0
1668130377788,ECE 200,029,103614,Mookherjea; Shayan,9999,0,9999,0
1668130377788,ECE 200,030,103615,Morris; Karcher William,9999,0,9999,0
1668130377788,ECE 200,031,103616,Ng; Tse Nga,9999,0,9999,0
1668130377788,ECE 200,032,103617,Nguyen; Truong Quang,9999,0,9999,0
1668130377788,ECE 200,033,103618,Nomura; Kenji,9999,0,9999,0
1668130377788,ECE 200,034,103619,Orlitsky; Alon,9999,0,9999,0
1668130377788,ECE 200,035,103620,Pal; Piya,9999,0,9999,0
1668130377788,ECE 200,036,103621,Papen; George C.,9999,0,9999,0
1668130377788,ECE 200,037,103622,Radic; Stojan,9999,0,9999,0
1668130377788,ECE 200,038,103623,Rao; Bhaskar D.,9999,0,9999,0
1668130377788,ECE 200,039,103624,Rao; Ramesh R,9999,0,9999,0
1668130377788,ECE 200,040,103625,Rebeiz; Gabriel,9999,0,9999,0
1668130377788,ECE 200,041,103626,Sanford; John R,9999,0,9999,0
1668130377788,ECE 200,042,103627,Siegel; Paul H.,9999,0,9999,0
1668130377788,ECE 200,043,103628,Sievenpiper; Daniel F.,9999,0,9999,0
1668130377788,ECE 200,044,103629,Sworder; David D.,9999,0,9999,0
1668130377788,ECE 200,045,103630,Taur; Yuan,9999,0,9999,0
1668130377788,ECE 200,046,103631,Touri; Behrouz,9999,0,9999,0
1668130377788,ECE 200,047,103632,Trivedi; Mohan M.,9999,0,9999,0
1668130377788,ECE 200,048,103633,Vasconcelos; Nuno,9999,0,9999,0
1668130377788,ECE 200,049,103634,Wang; Xiaolong,9999,0,9999,0
1668130377788,ECE 200,050,103635,Xie; Pengtao,9999,0,9999,0
1668130377788,ECE 200,051,103636,Yip; Michael,9999,0,9999,0
1668130377788,ECE 200,052,103637,Zeger; Kenneth A.,999,0,999,0
1668130377788,ECE 200,053,103638,Zhang; Xinyu,9999,0,9999,0
1668130377788,ECE 200,054,103639,Turakhia; Yatish Girish,9999,0,9999,0
1668130377788,ECE 200,055,103640,Kang; Mingu,9999,0,9999,0
1668130377788,ECE 200,056,103641,Shi; Yuanyuan,9999,0,9999,0
1668130377788,ECE 200,057,103642,Wang; Edward Jay,9999,0,9999,0
1668130377788,ECE 200,058,103643,Zheng; Yang,9999,0,9999,0
1668130378222,ECE 202,A00,103644,Kuzum; Duygu,0,0,0,0
1668130378654,ECE 212BN,A00,103646,Ng; Tse Nga,0,0,0,0
1668130379079,ECE 221,A00,111493,Staff,0,0,0,0
1668130379500,ECE 222B,A00,103647,Lomakin; Vitaliy,0,0,0,0
1668130379924,ECE 230B,A00,103648,Taur; Yuan,0,0,0,0
1668130380368,ECE 238B,A00,103649,Garay; Javier,0,0,0,0
1668130380793,ECE 240B,A00,112900,Fainman; Yeshaiahu,0,0,0,0
1668130381217,ECE 247A,A00,103650,Jokerst; Jesse Vincent,0,0,0,0
1668130381639,ECE 247B,A00,103651,Wang; Joseph,0,0,0,0
1668130382062,ECE 250,A00,103652,Siegel; Paul H.,0,0,0,0
1668130382484,ECE 251A,A00,103654,Rao; Bhaskar D.,0,0,0,0
1668130382927,ECE 257B,A00,103655,Bharadia; Dinesh,0,0,0,0
1668130383354,ECE 258A,A00,103656,Milstein; Laurence B.,0,0,0,0
1668130383778,ECE 260B,A00,103658,Kang; Mingu,0,0,0,0
1668130384201,ECE 264A,A00,103659,Galton; Ian A,0,0,0,0
1668130384631,ECE 265A,A00,103661,Gudem; Prasad S.S.,0,0,0,0
1668130385055,ECE 265D,A00,103662,Gudem; Prasad S.S.,0,0,0,0
1668130385487,ECE 268,A00,103663,Koushanfar; Farinaz,0,0,0,0
1668130385912,ECE 269,A01,103665,Pal; Piya,0,0,0,0
1668130386344,ECE 271B,A00,103666,Vasconcelos; Manuela,0,0,0,0
1668130386771,ECE 276A,A00,103667,Atanasov; Nikolay A.,0,0,0,0
1668130387212,ECE 277,A00,103668,An; Cheolhong,0,0,0,0
1668130387635,ECE 279,A00,117947,Hall; Drew A.,0,0,0,0
1668130388498,ECE 283,A00,103670,Hsueh; Tzu-Chien,0,0,0,0
1668130388921,ECE 284,A00,103671,Turakhia; Yatish Girish,0,0,0,0
1668130389346,ECE 285,A00,103672,Zheng; Yang,0,0,0,0
1668130389346,ECE 285,B00,103673,Sworder; David D.,0,0,0,0
1668130389772,ECE 287,A00,103676,Javidi; Tara,0,0,0,0
1668130390199,MATH 200B,A00,098023,Salehi Golsefidy; Alireza,12,0,15,3
1668130390624,MATH 202B,A00,098024,Rhoades; Brendon Patrick,9,0,15,6
1668130391059,MATH 203B,A00,098025,Oprea; Dragos N.,10,0,15,5
1668130391482,MATH 204B,A00,098026,Sorensen; Claus M,13,0,15,2
1668130391910,MATH 208,A00,098027,Izadi; Elham,7,0,10,3
1668130392341,MATH 209,A00,098028,Pollack; Aaron,10,0,10,0
1668130392767,MATH 211A,A00,112919,Rogalski; Daniel,9,0,10,1
1668130393200,MATH 211B,A00,112920,Seward; Brandon M.,9,0,10,1
1668130393626,MATH 218,A00,098029,Li; Bo,10,0,10,0
1668130394050,MATH 220B,A00,098030,Novak; Jonathan I,11,0,15,4
1668130394481,MATH 221A,A00,098031,Ebenfelt; Peter F,13,0,15,2
1668130394909,MATH 231B,A00,098032,Zlatos; Andrej,12,0,15,3
1668130395359,MATH 240B,A00,098033,Ni; Lei,9,0,15,6
1668130395810,MATH 243,A00,098034,Jekel; David Andrew,10,0,10,0
1668130396242,MATH 245A,A00,098035,Nie; Jiawang,0,0,15,16
1668130396665,MATH 248,A00,098036,Bejenaru; Ioan,10,0,10,0
1668130397108,MATH 250B,A00,098037,Spolaor; Luca,14,0,15,1
1668130397533,MATH 258,A00,098038,Ni; Lei,10,0,10,0
1668130397968,MATH 264B,A00,098041,Rhoades; Brendon Patrick,9,0,15,6
1668130398391,MATH 268,A00,098042,Buss; Samuel R,10,0,10,0
1668130398823,MATH 269,A00,098043,Rhoades; Brendon Patrick,10,0,10,0
1668130399266,MATH 270B,A00,098044,Li; Bo,10,0,15,5
1668130399703,MATH 272B,A00,098045,Holst; Michael J,13,0,15,2
1668130400126,MATH 273A,A00,098046,Tian; Xiaochuan,10,0,15,5
1668130400551,MATH 275,A01,098048,Tian; Xiaochuan,6,0,10,4
1668130400983,MATH 278A,A00,098049,Holst; Michael J,8,0,10,2
1668130401425,MATH 278B,A00,098050,Cloninger; Alexander,10,0,10,0
1668130401854,MATH 278C,A00,098051,Nie; Jiawang,7,0,10,3
1668130402277,MATH 280B,A00,098052,Zheng; Tianyi,10,0,15,5
1668130402700,MATH 281B,A00,098053,Bradic; Jelena,2,0,15,13
1668130403123,MATH 282B,A00,098054,Arias-Castro; Ery,0,0,15,15
1668130403560,MATH 285,A00,098055,Fitzsimmons; Patrick J,0,0,15,17
1668130403988,MATH 287B,A00,098056,Arias-Castro; Ery,3,0,15,12
1668130404415,MATH 288,A00,098057,Agarwal; Pooja,9,0,10,1
1668130404415,MATH 288,B00,098058,Zhang; Danna,8,0,10,2
1668130404415,MATH 288,C00,098059,Williams; Ruth J,10,0,10,0
1668130404841,MATH 290B,A00,098060,Roberts; Justin Deritter,13,0,15,2
1668130405272,MATH 292,A00,098061,Belmont; Eva Kinoshita,10,0,10,0
1668130405694,MATH 295,A00,098062,Suk; Andrew Hoon,48,0,50,2
1668130406119,MATH 296,A00,098063,Novak; Jonathan I,20,0,20,0
1668130406544,MATH 297,001,098064,Gamst; Anthony Collins,9997,0,9999,2
1668130909824,COGS 205,A00,101395,Chiba; Andrea,19,0,20,1
1668130910256,COGS 210B,001,101404,Greene; Deanna Jacquelyn,9998,0,9999,1
1668130910256,COGS 210B,002,101417,Xia; Haijun,9999,0,9999,0
1668130910256,COGS 210B,003,101422,Nitz; Douglas A.,9999,0,9999,0
1668130910256,COGS 210B,004,101423,Hollan; James D.,9998,0,9999,1
1668130910256,COGS 210B,005,101424,Deak; Gedeon O.,9998,0,9999,1
1668130910256,COGS 210B,006,101425,Rossano; Federico,9999,0,9999,0
1668130910681,COGS 211B,A00,101427,Coulson; Seana M,9996,0,9999,3
1668130911104,COGS 220,A00,101428,Hollan; James D.,0,0,25,25
1668130911527,COGS 229,A00,101429,Dow; Steven P,18,0,25,7
1668130911950,COGS 230,A00,101430,Klemmer; Scott R,12,0,17,5
1668130912372,COGS 234,A00,101431,Xia; Haijun,3,0,25,22
1668130912796,COGS 260,A00,101432,Kiyonaga; Anastasia,20,0,25,5
1668130912796,COGS 260,B00,101433,Kirsh; David Joel,16,0,25,9
1668130913224,CSE 202,A00,102371,Impagliazzo; Russell,0,0,0,0
1668130913657,CSE 203B,A01,102373,Cheng; Chung Kuan,0,0,0,0
1668130914082,CSE 208,A00,102374,Micciancio; Daniele,0,0,0,0
1668130914506,CSE 209A,A00,112895,Impagliazzo; Russell,0,0,15,15
1668130914958,CSE 209B,A00,108005,Bellare; Mihir,0,0,0,0
1668130915381,CSE 210,A00,113163,Coblenz; Michael J,0,0,0,0
1668130915803,CSE 219,A00,106111,Dow; Steven P,0,0,20,20
1668130916226,CSE 221,A00,102376,Voelker; Geoffrey M.,0,0,0,0
1668130916648,CSE 224,A01,102378,Porter; George M,0,0,0,0
1668130917071,CSE 229A,A00,102379,Savage; Stefan,0,0,0,0
1668130917495,CSE 229C,A00,102380,Munyaka; Imani N. S.,0,0,0,0
1668130917921,CSE 232B,A00,102382,Deutsch; Alin Bernard,0,0,0,0
1668130918350,CSE 234,A01,112904,Kumar; Arun Kumar,0,0,0,0
1668130918780,CSE 237A,A00,102383,Rosing; Tajana Simunic,0,0,0,0
1668130919209,CSE 239A,A00,102384,Deutsch; Alin Bernard,0,0,0,0
1668130919634,CSE 239B,A00,102385,Polikarpova; Nadezhda,0,0,0,0
1668130920062,CSE 240A,A00,102386,Pannuto; Patrick William,0,0,0,0
1668130920486,CSE 240B,A00,102387,Zhao; Jishen,0,0,0,0
1668130920908,CSE 241A,A00,106406,Kang; Mingu,0,0,0,0
1668130921334,CSE 249B,A00,102388,Kahng; Andrew Byun,0,0,8,8
1668130921762,CSE 251B,A01,102392,Cottrell; Garrison W,0,0,0,0
1668130921762,CSE 251B,A02,102393,Cottrell; Garrison W,0,0,0,0
1668130922185,CSE 252B,A00,102394,Ochoa; Benjamin Lawrence,0,0,0,0
1668130922624,CSE 257,A01,102396,Gao; Sicun,0,0,0,0
1668130923049,CSE 272,A00,102397,Li; Tzumao,0,0,0,0
1668130923480,CSE 274,A00,111323,Chern; Albert Ren-Haur,0,0,0,0
1668130923907,CSE 282,A00,102398,Pevzner; Pavel Arkadjevich,0,0,0,0
1668130924337,CSE 284,A00,114175,Gymrek; Melissa Ann,0,0,0,0
1668130924770,CSE 290,A00,102399,Chandraker; Manmohan Krishna,0,0,0,0
1668130924770,CSE 290,B00,102400,Vaccaro; Kristen Marie,0,0,25,25
1668130924770,CSE 290,C00,102414,Pannuto; Patrick William,0,0,25,25
1668130924770,CSE 290,D00,102427,Pevzner; Pavel Arkadjevich,0,0,0,0
1668130924770,CSE 290,E00,102429,Zhao; Jishen,0,0,0,0
1668130924770,CSE 290,F00,102436,Tullsen; Dean Michael,0,0,0,0
1668130924770,CSE 290,G00,102440,Christensen; Henrik I,0,0,20,20
1668130925195,CSE 291,A00,102443,Su; Hao,0,0,0,0
1668130925195,CSE 291,B00,102448,Polikarpova; Nadezhda,0,0,0,0
1668130925195,CSE 291,C00,102453,Vaccaro; Kristen Marie,0,0,0,0
1668130925195,CSE 291,D00,111343,Savage; Stefan,0,0,0,0
1668130925195,CSE 291,E00,116474,Claffy; Kimberly Claire,0,0,0,0
1668130925195,CSE 291,F00,116479,Pasquale; Joseph,0,0,0,0
1668130925658,CSE 293,001,119111,Bafna; Vineet,9999,0,9999,0
1668130925658,CSE 293,002,119118,Bellare; Mihir,9999,0,9999,0
1668130925658,CSE 293,003,119122,Berg-Kirkpatrick; Taylor D,9999,0,9999,0
1668130925658,CSE 293,004,119135,Christensen; Henrik I,9999,0,9999,0
1668130925658,CSE 293,005,119142,Cottrell; Garrison W,9999,0,9999,0
1668130925658,CSE 293,006,119146,Deutsch; Alin Bernard,9999,0,9999,0
1668130925658,CSE 293,007,119159,Esmaeilzadeh; Hadi,9999,0,9999,0
1668130925658,CSE 293,008,119166,Freund; Yoav,9999,0,9999,0
1668130925658,CSE 293,009,119170,Griswold; William G.,9999,0,9999,0
1668130925658,CSE 293,010,119183,Gymrek; Melissa Ann,9999,0,9999,0
1668130925658,CSE 293,011,119190,Heninger; Nadia A,9999,0,9999,0
1668130925658,CSE 293,012,119230,Impagliazzo; Russell,9999,0,9999,0
1668130925658,CSE 293,013,119232,Jhala; Ranjit,9999,0,9999,0
1668130925658,CSE 293,014,119233,Kahng; Andrew Byun,9999,0,9999,0
1668130925658,CSE 293,015,119298,Kane; Daniel Mertz,9999,0,9999,0
1668130925658,CSE 293,016,119299,Kriegman; David J,9999,0,9999,0
1668130925658,CSE 293,017,119300,Kumar; Arun Kumar,9999,0,9999,0
1668130925658,CSE 293,018,119301,Lerner; Sorin,9999,0,9999,0
1668130925658,CSE 293,019,119302,Lovett; Shachar,9999,0,9999,0
1668130925658,CSE 293,020,119303,McAuley; Julian John,9999,0,9999,0
1668130925658,CSE 293,021,119304,Micciancio; Daniele,9999,0,9999,0
1668130925658,CSE 293,022,119367,Orailoglu; Alex,9999,0,9999,0
1668130925658,CSE 293,023,119382,Paturi; Ramamohan,9999,0,9999,0
1668130925658,CSE 293,024,119404,Polikarpova; Nadezhda,9999,0,9999,0
1668130925658,CSE 293,025,119406,Politz; Joseph Gibbs,9999,0,9999,0
1668130925658,CSE 293,026,119411,Porter; George M,9999,0,9999,0
1668130925658,CSE 293,027,119414,Porter; Leonard Emerson,9999,0,9999,0
1668130925658,CSE 293,028,119416,Ramamoorthi; Ravi,9999,0,9999,0
1668130925658,CSE 293,029,119417,Sahoo; Debashis,9999,0,9999,0
1668130925658,CSE 293,030,119420,Saul; Lawrence,9999,0,9999,0
1668130925658,CSE 293,031,119421,Savage; Stefan,9999,0,9999,0
1668130925658,CSE 293,032,119425,Schulze; Jurgen P.,9999,0,9999,0
1668130925658,CSE 293,033,119426,Snoeren; Alex C.,9999,0,9999,0
1668130925658,CSE 293,034,119428,Shang; Jingbo,9999,0,9999,0
1668130925658,CSE 293,035,119430,Stefan; Deian,9999,0,9999,0
1668130925658,CSE 293,036,119431,Su; Hao,9999,0,9999,0
1668130925658,CSE 293,037,119433,Swanson; Steven James,9999,0,9999,0
1668130925658,CSE 293,038,119435,Tullsen; Dean Michael,9999,0,9999,0
1668130925658,CSE 293,039,119483,Voelker; Geoffrey M.,9999,0,9999,0
1668130925658,CSE 293,040,119537,Zhao; Jishen,9999,0,9999,0
1668130925658,CSE 293,041,119538,Zhou; Yuan-Yuan,9999,0,9999,0
1668130925658,CSE 293,042,119539,Gao; Sicun,9999,0,9999,0
1668130925658,CSE 293,043,119540,Weibel; Nadir,9999,0,9999,0
1668130925658,CSE 293,044,119541,Gupta; Rajesh K.,9999,0,9999,0
1668130925658,CSE 293,045,126410,Vaccaro; Kristen Marie,9999,0,9999,0
1668130925658,CSE 293,046,126411,Klemke; Richard,9999,0,9999,0
1668130926093,CSE 294,A00,102459,Voelker; Geoffrey M.,0,0,0,0
1668130926093,CSE 294,B00,111322,Orailoglu; Alex,0,0,0,0
1668130926520,DSE 201,A00,096914,Deutsch; Alin Bernard,30,0,30,0
1668130926949,DSE 210,A00,096915,Dasgupta; Sanjoy,30,0,30,0
1668130927371,DSE 260A,A00,096916,Altintas De Callaf; Ilkay,30,0,30,0
1668130927823,ECE 200,001,103586,Antipa; Nicholas A,9999,0,9999,0
1668130927823,ECE 200,002,103587,Atanasov; Nikolay A.,9999,0,9999,0
1668130927823,ECE 200,003,103588,Bharadia; Dinesh,9999,0,9999,0
1668130927823,ECE 200,004,103589,Cheng; Chung Kuan,9999,0,9999,0
1668130927823,ECE 200,005,103590,Cosman; Pamela C.,9999,0,9999,0
1668130927823,ECE 200,006,103591,Dayeh; Shadi Ahmad,9999,0,9999,0
1668130927823,ECE 200,007,103592,Fainman; Yeshaiahu,9999,0,9999,0
1668130927823,ECE 200,008,103593,Ford; Joseph Earl,9999,0,9999,0
1668130927823,ECE 200,009,103594,Franceschetti; Massimo,9999,0,9999,0
1668130927823,ECE 200,010,103595,Fullerton; Eric E,9999,0,9999,0
1668130927823,ECE 200,011,103596,Galton; Ian A,9999,0,9999,0
1668130927823,ECE 200,012,103597,Gilja; Vikash,9999,0,9999,0
1668130927823,ECE 200,013,103598,Hall; Drew A.,9999,0,9999,0
1668130927823,ECE 200,014,103599,Hsueh; Tzu-Chien,9999,0,9999,0
1668130927823,ECE 200,015,103600,Javidi; Tara,9999,0,9999,0
1668130927823,ECE 200,016,103601,Kahng; Andrew Byun,9999,0,9999,0
1668130927823,ECE 200,017,103602,Kim; Young-Han,9999,0,9999,0
1668130927823,ECE 200,018,103603,Koushanfar; Farinaz,9999,0,9999,0
1668130927823,ECE 200,019,103604,Kuzum; Duygu,9999,0,9999,0
1668130927823,ECE 200,020,103605,Le; Hanh-Phuc,9999,0,9999,0
1668130927823,ECE 200,021,103606,Lin; Bill,9999,0,9999,0
1668130927823,ECE 200,022,103607,Liu; Zhaowei,9998,0,9999,1
1668130927823,ECE 200,023,103608,Lo; Yu-Hwa,9999,0,9999,0
1668130927823,ECE 200,024,103609,Lomakin; Vitaliy,9999,0,9999,0
1668130927823,ECE 200,025,103610,Mercier; Patrick Philip,9999,0,9999,0
1668130927823,ECE 200,026,103611,Meyer; Florian,9999,0,9999,0
1668130927823,ECE 200,027,103612,Milstein; Laurence B.,9999,0,9999,0
1668130927823,ECE 200,028,103613,Mir Arabbaygi; Siavash,9999,0,9999,0
1668130927823,ECE 200,029,103614,Mookherjea; Shayan,9999,0,9999,0
1668130927823,ECE 200,030,103615,Morris; Karcher William,9999,0,9999,0
1668130927823,ECE 200,031,103616,Ng; Tse Nga,9999,0,9999,0
1668130927823,ECE 200,032,103617,Nguyen; Truong Quang,9999,0,9999,0
1668130927823,ECE 200,033,103618,Nomura; Kenji,9999,0,9999,0
1668130927823,ECE 200,034,103619,Orlitsky; Alon,9999,0,9999,0
1668130927823,ECE 200,035,103620,Pal; Piya,9999,0,9999,0
1668130927823,ECE 200,036,103621,Papen; George C.,9999,0,9999,0
1668130927823,ECE 200,037,103622,Radic; Stojan,9999,0,9999,0
1668130927823,ECE 200,038,103623,Rao; Bhaskar D.,9999,0,9999,0
1668130927823,ECE 200,039,103624,Rao; Ramesh R,9999,0,9999,0
1668130927823,ECE 200,040,103625,Rebeiz; Gabriel,9999,0,9999,0
1668130927823,ECE 200,041,103626,Sanford; John R,9999,0,9999,0
1668130927823,ECE 200,042,103627,Siegel; Paul H.,9999,0,9999,0
1668130927823,ECE 200,043,103628,Sievenpiper; Daniel F.,9999,0,9999,0
1668130927823,ECE 200,044,103629,Sworder; David D.,9999,0,9999,0
1668130927823,ECE 200,045,103630,Taur; Yuan,9999,0,9999,0
1668130927823,ECE 200,046,103631,Touri; Behrouz,9999,0,9999,0
1668130927823,ECE 200,047,103632,Trivedi; Mohan M.,9999,0,9999,0
1668130927823,ECE 200,048,103633,Vasconcelos; Nuno,9999,0,9999,0
1668130927823,ECE 200,049,103634,Wang; Xiaolong,9999,0,9999,0
1668130927823,ECE 200,050,103635,Xie; Pengtao,9999,0,9999,0
1668130927823,ECE 200,051,103636,Yip; Michael,9999,0,9999,0
1668130927823,ECE 200,052,103637,Zeger; Kenneth A.,999,0,999,0
1668130927823,ECE 200,053,103638,Zhang; Xinyu,9999,0,9999,0
1668130927823,ECE 200,054,103639,Turakhia; Yatish Girish,9999,0,9999,0
1668130927823,ECE 200,055,103640,Kang; Mingu,9999,0,9999,0
1668130927823,ECE 200,056,103641,Shi; Yuanyuan,9999,0,9999,0
1668130927823,ECE 200,057,103642,Wang; Edward Jay,9999,0,9999,0
1668130927823,ECE 200,058,103643,Zheng; Yang,9999,0,9999,0
1668130928249,ECE 202,A00,103644,Kuzum; Duygu,0,0,0,0
1668130928681,ECE 212BN,A00,103646,Ng; Tse Nga,0,0,0,0
1668130929107,ECE 221,A00,111493,Staff,0,0,0,0
1668130929531,ECE 222B,A00,103647,Lomakin; Vitaliy,0,0,0,0
1668130929965,ECE 230B,A00,103648,Taur; Yuan,0,0,0,0
1668130930392,ECE 238B,A00,103649,Garay; Javier,0,0,0,0
1668130930817,ECE 240B,A00,112900,Fainman; Yeshaiahu,0,0,0,0
1668130931241,ECE 247A,A00,103650,Jokerst; Jesse Vincent,0,0,0,0
1668130931664,ECE 247B,A00,103651,Wang; Joseph,0,0,0,0
1668130932098,ECE 250,A00,103652,Siegel; Paul H.,0,0,0,0
1668130932539,ECE 251A,A00,103654,Rao; Bhaskar D.,0,0,0,0
1668130932964,ECE 257B,A00,103655,Bharadia; Dinesh,0,0,0,0
1668130933394,ECE 258A,A00,103656,Milstein; Laurence B.,0,0,0,0
1668130933821,ECE 260B,A00,103658,Kang; Mingu,0,0,0,0
1668130934260,ECE 264A,A00,103659,Galton; Ian A,0,0,0,0
1668130934693,ECE 265A,A00,103661,Gudem; Prasad S.S.,0,0,0,0
1668130935124,ECE 265D,A00,103662,Gudem; Prasad S.S.,0,0,0,0
1668130935549,ECE 268,A00,103663,Koushanfar; Farinaz,0,0,0,0
1668130935988,ECE 269,A01,103665,Pal; Piya,0,0,0,0
1668130936414,ECE 271B,A00,103666,Vasconcelos; Manuela,0,0,0,0
1668130936843,ECE 276A,A00,103667,Atanasov; Nikolay A.,0,0,0,0
1668130937266,ECE 277,A00,103668,An; Cheolhong,0,0,0,0
1668130937691,ECE 279,A00,117947,Hall; Drew A.,0,0,0,0
1668130938640,ECE 283,A00,103670,Hsueh; Tzu-Chien,0,0,0,0
1668130939067,ECE 284,A00,103671,Turakhia; Yatish Girish,0,0,0,0
1668130939491,ECE 285,A00,103672,Zheng; Yang,0,0,0,0
1668130939491,ECE 285,B00,103673,Sworder; David D.,0,0,0,0
1668130939915,ECE 287,A00,103676,Javidi; Tara,0,0,0,0
1668130940346,MATH 200B,A00,098023,Salehi Golsefidy; Alireza,12,0,15,3
1668130940775,MATH 202B,A00,098024,Rhoades; Brendon Patrick,9,0,15,6
1668130941201,MATH 203B,A00,098025,Oprea; Dragos N.,10,0,15,5
1668130941633,MATH 204B,A00,098026,Sorensen; Claus M,13,0,15,2
1668130942062,MATH 208,A00,098027,Izadi; Elham,7,0,10,3
1668130942491,MATH 209,A00,098028,Pollack; Aaron,10,0,10,0
1668130942924,MATH 211A,A00,112919,Rogalski; Daniel,9,0,10,1
1668130943346,MATH 211B,A00,112920,Seward; Brandon M.,9,0,10,1
1668130943773,MATH 218,A00,098029,Li; Bo,10,0,10,0
1668130944203,MATH 220B,A00,098030,Novak; Jonathan I,11,0,15,4
1668130944627,MATH 221A,A00,098031,Ebenfelt; Peter F,13,0,15,2
1668130945062,MATH 231B,A00,098032,Zlatos; Andrej,12,0,15,3
1668130945487,MATH 240B,A00,098033,Ni; Lei,9,0,15,6
1668130945914,MATH 243,A00,098034,Jekel; David Andrew,10,0,10,0
1668130946338,MATH 245A,A00,098035,Nie; Jiawang,0,0,15,16
1668130946779,MATH 248,A00,098036,Bejenaru; Ioan,10,0,10,0
1668130947216,MATH 250B,A00,098037,Spolaor; Luca,14,0,15,1
1668130947638,MATH 258,A00,098038,Ni; Lei,10,0,10,0
1668130948069,MATH 264B,A00,098041,Rhoades; Brendon Patrick,9,0,15,6
1668130948501,MATH 268,A00,098042,Buss; Samuel R,10,0,10,0
1668130948927,MATH 269,A00,098043,Rhoades; Brendon Patrick,10,0,10,0
1668130949348,MATH 270B,A00,098044,Li; Bo,10,0,15,5
1668130949775,MATH 272B,A00,098045,Holst; Michael J,13,0,15,2
1668130950212,MATH 273A,A00,098046,Tian; Xiaochuan,10,0,15,5
1668130950642,MATH 275,A01,098048,Tian; Xiaochuan,6,0,10,4
1668130951064,MATH 278A,A00,098049,Holst; Michael J,8,0,10,2
1668130951488,MATH 278B,A00,098050,Cloninger; Alexander,10,0,10,0
1668130951911,MATH 278C,A00,098051,Nie; Jiawang,7,0,10,3
1668130952335,MATH 280B,A00,098052,Zheng; Tianyi,10,0,15,5
1668130952765,MATH 281B,A00,098053,Bradic; Jelena,2,0,15,13
1668130953191,MATH 282B,A00,098054,Arias-Castro; Ery,0,0,15,15
1668130953619,MATH 285,A00,098055,Fitzsimmons; Patrick J,0,0,15,17
1668130954043,MATH 287B,A00,098056,Arias-Castro; Ery,2,0,15,13
1668130954466,MATH 288,A00,098057,Agarwal; Pooja,9,0,10,1
1668130954466,MATH 288,B00,098058,Zhang; Danna,8,0,10,2
1668130954466,MATH 288,C00,098059,Williams; Ruth J,10,0,10,0
1668130954901,MATH 290B,A00,098060,Roberts; Justin Deritter,13,0,15,2
1668130955323,MATH 292,A00,098061,Belmont; Eva Kinoshita,10,0,10,0
1668130955751,MATH 295,A00,098062,Suk; Andrew Hoon,48,0,50,2
1668130956180,MATH 296,A00,098063,Novak; Jonathan I,20,0,20,0
1668130956609,MATH 297,001,098064,Gamst; Anthony Collins,9997,0,9999,2
1668131460206,COGS 205,A00,101395,Chiba; Andrea,19,0,20,1
1668131460631,COGS 210B,001,101404,Greene; Deanna Jacquelyn,9998,0,9999,1
1668131460631,COGS 210B,002,101417,Xia; Haijun,9999,0,9999,0
1668131460631,COGS 210B,003,101422,Nitz; Douglas A.,9999,0,9999,0
1668131460631,COGS 210B,004,101423,Hollan; James D.,9998,0,9999,1
1668131460631,COGS 210B,005,101424,Deak; Gedeon O.,9998,0,9999,1
1668131460631,COGS 210B,006,101425,Rossano; Federico,9999,0,9999,0
1668131461064,COGS 211B,A00,101427,Coulson; Seana M,9996,0,9999,3
1668131461496,COGS 220,A00,101428,Hollan; James D.,0,0,25,25
1668131462032,COGS 229,A00,101429,Dow; Steven P,18,0,25,7
1668131462456,COGS 230,A00,101430,Klemmer; Scott R,12,0,17,5
1668131462881,COGS 234,A00,101431,Xia; Haijun,3,0,25,22
1668131463307,COGS 260,A00,101432,Kiyonaga; Anastasia,20,0,25,5
1668131463307,COGS 260,B00,101433,Kirsh; David Joel,16,0,25,9
1668131463751,CSE 202,A00,102371,Impagliazzo; Russell,0,0,0,0
1668131464192,CSE 203B,A01,102373,Cheng; Chung Kuan,0,0,0,0
1668131464646,CSE 208,A00,102374,Micciancio; Daniele,0,0,0,0
1668131465078,CSE 209A,A00,112895,Impagliazzo; Russell,0,0,15,15
1668131465517,CSE 209B,A00,108005,Bellare; Mihir,0,0,0,0
1668131465941,CSE 210,A00,113163,Coblenz; Michael J,0,0,0,0
1668131466364,CSE 219,A00,106111,Dow; Steven P,0,0,20,20
1668131466896,CSE 221,A00,102376,Voelker; Geoffrey M.,0,0,0,0
1668131467327,CSE 224,A01,102378,Porter; George M,0,0,0,0
1668131467752,CSE 229A,A00,102379,Savage; Stefan,0,0,0,0
1668131468177,CSE 229C,A00,102380,Munyaka; Imani N. S.,0,0,0,0
1668131468601,CSE 232B,A00,102382,Deutsch; Alin Bernard,0,0,0,0
1668131469025,CSE 234,A01,112904,Kumar; Arun Kumar,0,0,0,0
1668131469456,CSE 237A,A00,102383,Rosing; Tajana Simunic,0,0,0,0
1668131469878,CSE 239A,A00,102384,Deutsch; Alin Bernard,0,0,0,0
1668131470301,CSE 239B,A00,102385,Polikarpova; Nadezhda,0,0,0,0
1668131470744,CSE 240A,A00,102386,Pannuto; Patrick William,0,0,0,0
1668131471182,CSE 240B,A00,102387,Zhao; Jishen,0,0,0,0
1668131471605,CSE 241A,A00,106406,Kang; Mingu,0,0,0,0
1668131472031,CSE 249B,A00,102388,Kahng; Andrew Byun,0,0,8,8
1668131472531,CSE 251B,A01,102392,Cottrell; Garrison W,0,0,0,0
1668131472531,CSE 251B,A02,102393,Cottrell; Garrison W,0,0,0,0
1668131472967,CSE 252B,A00,102394,Ochoa; Benjamin Lawrence,0,0,0,0
1668131473392,CSE 257,A01,102396,Gao; Sicun,0,0,0,0
1668131473817,CSE 272,A00,102397,Li; Tzumao,0,0,0,0
1668131474248,CSE 274,A00,111323,Chern; Albert Ren-Haur,0,0,0,0
1668131474686,CSE 282,A00,102398,Pevzner; Pavel Arkadjevich,0,0,0,0
1668131475109,CSE 284,A00,114175,Gymrek; Melissa Ann,0,0,0,0
1668131475549,CSE 290,A00,102399,Chandraker; Manmohan Krishna,0,0,0,0
1668131475549,CSE 290,B00,102400,Vaccaro; Kristen Marie,0,0,25,25
1668131475549,CSE 290,C00,102414,Pannuto; Patrick William,0,0,25,25
1668131475549,CSE 290,D00,102427,Pevzner; Pavel Arkadjevich,0,0,0,0
1668131475549,CSE 290,E00,102429,Zhao; Jishen,0,0,0,0
1668131475549,CSE 290,F00,102436,Tullsen; Dean Michael,0,0,0,0
1668131475549,CSE 290,G00,102440,Christensen; Henrik I,0,0,20,20
1668131475982,CSE 291,A00,102443,Su; Hao,0,0,0,0
1668131475982,CSE 291,B00,102448,Polikarpova; Nadezhda,0,0,0,0
1668131475982,CSE 291,C00,102453,Vaccaro; Kristen Marie,0,0,0,0
1668131475982,CSE 291,D00,111343,Savage; Stefan,0,0,0,0
1668131475982,CSE 291,E00,116474,Claffy; Kimberly Claire,0,0,0,0
1668131475982,CSE 291,F00,116479,Pasquale; Joseph,0,0,0,0
1668131476413,CSE 293,001,119111,Bafna; Vineet,9999,0,9999,0
1668131476413,CSE 293,002,119118,Bellare; Mihir,9999,0,9999,0
1668131476413,CSE 293,003,119122,Berg-Kirkpatrick; Taylor D,9999,0,9999,0
1668131476413,CSE 293,004,119135,Christensen; Henrik I,9999,0,9999,0
1668131476413,CSE 293,005,119142,Cottrell; Garrison W,9999,0,9999,0
1668131476413,CSE 293,006,119146,Deutsch; Alin Bernard,9999,0,9999,0
1668131476413,CSE 293,007,119159,Esmaeilzadeh; Hadi,9999,0,9999,0
1668131476413,CSE 293,008,119166,Freund; Yoav,9999,0,9999,0
1668131476413,CSE 293,009,119170,Griswold; William G.,9999,0,9999,0
1668131476413,CSE 293,010,119183,Gymrek; Melissa Ann,9999,0,9999,0
1668131476413,CSE 293,011,119190,Heninger; Nadia A,9999,0,9999,0
1668131476413,CSE 293,012,119230,Impagliazzo; Russell,9999,0,9999,0
1668131476413,CSE 293,013,119232,Jhala; Ranjit,9999,0,9999,0
1668131476413,CSE 293,014,119233,Kahng; Andrew Byun,9999,0,9999,0
1668131476413,CSE 293,015,119298,Kane; Daniel Mertz,9999,0,9999,0
1668131476413,CSE 293,016,119299,Kriegman; David J,9999,0,9999,0
1668131476413,CSE 293,017,119300,Kumar; Arun Kumar,9999,0,9999,0
1668131476413,CSE 293,018,119301,Lerner; Sorin,9999,0,9999,0
1668131476413,CSE 293,019,119302,Lovett; Shachar,9999,0,9999,0
1668131476413,CSE 293,020,119303,McAuley; Julian John,9999,0,9999,0
1668131476413,CSE 293,021,119304,Micciancio; Daniele,9999,0,9999,0
1668131476413,CSE 293,022,119367,Orailoglu; Alex,9999,0,9999,0
1668131476413,CSE 293,023,119382,Paturi; Ramamohan,9999,0,9999,0
1668131476413,CSE 293,024,119404,Polikarpova; Nadezhda,9999,0,9999,0
1668131476413,CSE 293,025,119406,Politz; Joseph Gibbs,9999,0,9999,0
1668131476413,CSE 293,026,119411,Porter; George M,9999,0,9999,0
1668131476413,CSE 293,027,119414,Porter; Leonard Emerson,9999,0,9999,0
1668131476413,CSE 293,028,119416,Ramamoorthi; Ravi,9999,0,9999,0
1668131476413,CSE 293,029,119417,Sahoo; Debashis,9999,0,9999,0
1668131476413,CSE 293,030,119420,Saul; Lawrence,9999,0,9999,0
1668131476413,CSE 293,031,119421,Savage; Stefan,9999,0,9999,0
1668131476413,CSE 293,032,119425,Schulze; Jurgen P.,9999,0,9999,0
1668131476413,CSE 293,033,119426,Snoeren; Alex C.,9999,0,9999,0
1668131476413,CSE 293,034,119428,Shang; Jingbo,9999,0,9999,0
1668131476413,CSE 293,035,119430,Stefan; Deian,9999,0,9999,0
1668131476413,CSE 293,036,119431,Su; Hao,9999,0,9999,0
1668131476413,CSE 293,037,119433,Swanson; Steven James,9999,0,9999,0
1668131476413,CSE 293,038,119435,Tullsen; Dean Michael,9999,0,9999,0
1668131476413,CSE 293,039,119483,Voelker; Geoffrey M.,9999,0,9999,0
1668131476413,CSE 293,040,119537,Zhao; Jishen,9999,0,9999,0
1668131476413,CSE 293,041,119538,Zhou; Yuan-Yuan,9999,0,9999,0
1668131476413,CSE 293,042,119539,Gao; Sicun,9999,0,9999,0
1668131476413,CSE 293,043,119540,Weibel; Nadir,9999,0,9999,0
1668131476413,CSE 293,044,119541,Gupta; Rajesh K.,9999,0,9999,0
1668131476413,CSE 293,045,126410,Vaccaro; Kristen Marie,9999,0,9999,0
1668131476413,CSE 293,046,126411,Klemke; Richard,9999,0,9999,0
1668131476839,CSE 294,A00,102459,Voelker; Geoffrey M.,0,0,0,0
1668131476839,CSE 294,B00,111322,Orailoglu; Alex,0,0,0,0
1668131477262,DSE 201,A00,096914,Deutsch; Alin Bernard,30,0,30,0
1668131477685,DSE 210,A00,096915,Dasgupta; Sanjoy,30,0,30,0
1668131478109,DSE 260A,A00,096916,Altintas De Callaf; Ilkay,30,0,30,0
1668131478538,ECE 200,001,103586,Antipa; Nicholas A,9999,0,9999,0
1668131478538,ECE 200,002,103587,Atanasov; Nikolay A.,9999,0,9999,0
1668131478538,ECE 200,003,103588,Bharadia; Dinesh,9999,0,9999,0
1668131478538,ECE 200,004,103589,Cheng; Chung Kuan,9999,0,9999,0
1668131478538,ECE 200,005,103590,Cosman; Pamela C.,9999,0,9999,0
1668131478538,ECE 200,006,103591,Dayeh; Shadi Ahmad,9999,0,9999,0
1668131478538,ECE 200,007,103592,Fainman; Yeshaiahu,9999,0,9999,0
1668131478538,ECE 200,008,103593,Ford; Joseph Earl,9999,0,9999,0
1668131478538,ECE 200,009,103594,Franceschetti; Massimo,9999,0,9999,0
1668131478538,ECE 200,010,103595,Fullerton; Eric E,9999,0,9999,0
1668131478538,ECE 200,011,103596,Galton; Ian A,9999,0,9999,0
1668131478538,ECE 200,012,103597,Gilja; Vikash,9999,0,9999,0
1668131478538,ECE 200,013,103598,Hall; Drew A.,9999,0,9999,0
1668131478538,ECE 200,014,103599,Hsueh; Tzu-Chien,9999,0,9999,0
1668131478538,ECE 200,015,103600,Javidi; Tara,9999,0,9999,0
1668131478538,ECE 200,016,103601,Kahng; Andrew Byun,9999,0,9999,0
1668131478538,ECE 200,017,103602,Kim; Young-Han,9999,0,9999,0
1668131478538,ECE 200,018,103603,Koushanfar; Farinaz,9999,0,9999,0
1668131478538,ECE 200,019,103604,Kuzum; Duygu,9999,0,9999,0
1668131478538,ECE 200,020,103605,Le; Hanh-Phuc,9999,0,9999,0
1668131478538,ECE 200,021,103606,Lin; Bill,9999,0,9999,0
1668131478538,ECE 200,022,103607,Liu; Zhaowei,9998,0,9999,1
1668131478538,ECE 200,023,103608,Lo; Yu-Hwa,9999,0,9999,0
1668131478538,ECE 200,024,103609,Lomakin; Vitaliy,9999,0,9999,0
1668131478538,ECE 200,025,103610,Mercier; Patrick Philip,9999,0,9999,0
1668131478538,ECE 200,026,103611,Meyer; Florian,9999,0,9999,0
1668131478538,ECE 200,027,103612,Milstein; Laurence B.,9999,0,9999,0
1668131478538,ECE 200,028,103613,Mir Arabbaygi; Siavash,9999,0,9999,0
1668131478538,ECE 200,029,103614,Mookherjea; Shayan,9999,0,9999,0
1668131478538,ECE 200,030,103615,Morris; Karcher William,9999,0,9999,0
1668131478538,ECE 200,031,103616,Ng; Tse Nga,9999,0,9999,0
1668131478538,ECE 200,032,103617,Nguyen; Truong Quang,9999,0,9999,0
1668131478538,ECE 200,033,103618,Nomura; Kenji,9999,0,9999,0
1668131478538,ECE 200,034,103619,Orlitsky; Alon,9999,0,9999,0
1668131478538,ECE 200,035,103620,Pal; Piya,9999,0,9999,0
1668131478538,ECE 200,036,103621,Papen; George C.,9999,0,9999,0
1668131478538,ECE 200,037,103622,Radic; Stojan,9999,0,9999,0
1668131478538,ECE 200,038,103623,Rao; Bhaskar D.,9999,0,9999,0
1668131478538,ECE 200,039,103624,Rao; Ramesh R,9999,0,9999,0
1668131478538,ECE 200,040,103625,Rebeiz; Gabriel,9999,0,9999,0
1668131478538,ECE 200,041,103626,Sanford; John R,9999,0,9999,0
1668131478538,ECE 200,042,103627,Siegel; Paul H.,9999,0,9999,0
1668131478538,ECE 200,043,103628,Sievenpiper; Daniel F.,9999,0,9999,0
1668131478538,ECE 200,044,103629,Sworder; David D.,9999,0,9999,0
1668131478538,ECE 200,045,103630,Taur; Yuan,9999,0,9999,0
1668131478538,ECE 200,046,103631,Touri; Behrouz,9999,0,9999,0
1668131478538,ECE 200,047,103632,Trivedi; Mohan M.,9999,0,9999,0
1668131478538,ECE 200,048,103633,Vasconcelos; Nuno,9999,0,9999,0
1668131478538,ECE 200,049,103634,Wang; Xiaolong,9999,0,9999,0
1668131478538,ECE 200,050,103635,Xie; Pengtao,9999,0,9999,0
1668131478538,ECE 200,051,103636,Yip; Michael,9999,0,9999,0
1668131478538,ECE 200,052,103637,Zeger; Kenneth A.,999,0,999,0
1668131478538,ECE 200,053,103638,Zhang; Xinyu,9999,0,9999,0
1668131478538,ECE 200,054,103639,Turakhia; Yatish Girish,9999,0,9999,0
1668131478538,ECE 200,055,103640,Kang; Mingu,9999,0,9999,0
1668131478538,ECE 200,056,103641,Shi; Yuanyuan,9999,0,9999,0
1668131478538,ECE 200,057,103642,Wang; Edward Jay,9999,0,9999,0
1668131478538,ECE 200,058,103643,Zheng; Yang,9999,0,9999,0
1668131478970,ECE 202,A00,103644,Kuzum; Duygu,0,0,0,0
1668131479393,ECE 212BN,A00,103646,Ng; Tse Nga,0,0,0,0
1668131479822,ECE 221,A00,111493,Staff,0,0,0,0
1668131480260,ECE 222B,A00,103647,Lomakin; Vitaliy,0,0,0,0
1668131480687,ECE 230B,A00,103648,Taur; Yuan,0,0,0,0
1668131481112,ECE 238B,A00,103649,Garay; Javier,0,0,0,0
1668131481534,ECE 240B,A00,112900,Fainman; Yeshaiahu,0,0,0,0
1668131481957,ECE 247A,A00,103650,Jokerst; Jesse Vincent,0,0,0,0
1668131482383,ECE 247B,A00,103651,Wang; Joseph,0,0,0,0
1668131482814,ECE 250,A00,103652,Siegel; Paul H.,0,0,0,0
1668131483238,ECE 251A,A00,103654,Rao; Bhaskar D.,0,0,0,0
1668131483677,ECE 257B,A00,103655,Bharadia; Dinesh,0,0,0,0
1668131484114,ECE 258A,A00,103656,Milstein; Laurence B.,0,0,0,0
1668131484537,ECE 260B,A00,103658,Kang; Mingu,0,0,0,0
1668131484958,ECE 264A,A00,103659,Galton; Ian A,0,0,0,0
1668131485388,ECE 265A,A00,103661,Gudem; Prasad S.S.,0,0,0,0
1668131485816,ECE 265D,A00,103662,Gudem; Prasad S.S.,0,0,0,0
1668131486246,ECE 268,A00,103663,Koushanfar; Farinaz,0,0,0,0
1668131486677,ECE 269,A01,103665,Pal; Piya,0,0,0,0
1668131487105,ECE 271B,A00,103666,Vasconcelos; Manuela,0,0,0,0
1668131487526,ECE 276A,A00,103667,Atanasov; Nikolay A.,0,0,0,0
1668131487967,ECE 277,A00,103668,An; Cheolhong,0,0,0,0
1668131488389,ECE 279,A00,117947,Hall; Drew A.,0,0,0,0
1668131489246,ECE 283,A00,103670,Hsueh; Tzu-Chien,0,0,0,0
1668131489680,ECE 284,A00,103671,Turakhia; Yatish Girish,0,0,0,0
1668131490105,ECE 285,A00,103672,Zheng; Yang,0,0,0,0
1668131490105,ECE 285,B00,103673,Sworder; David D.,0,0,0,0
1668131490527,ECE 287,A00,103676,Javidi; Tara,0,0,0,0
1668131490958,MATH 200B,A00,098023,Salehi Golsefidy; Alireza,12,0,15,3
1668131491380,MATH 202B,A00,098024,Rhoades; Brendon Patrick,9,0,15,6
1668131491806,MATH 203B,A00,098025,Oprea; Dragos N.,10,0,15,5
1668131492228,MATH 204B,A00,098026,Sorensen; Claus M,13,0,15,2
1668131492656,MATH 208,A00,098027,Izadi; Elham,7,0,10,3
1668131493080,MATH 209,A00,098028,Pollack; Aaron,10,0,10,0
1668131493502,MATH 211A,A00,112919,Rogalski; Daniel,9,0,10,1
1668131493935,MATH 211B,A00,112920,Seward; Brandon M.,9,0,10,1
1668131494358,MATH 218,A00,098029,Li; Bo,10,0,10,0
1668131494788,MATH 220B,A00,098030,Novak; Jonathan I,11,0,15,4
1668131495218,MATH 221A,A00,098031,Ebenfelt; Peter F,13,0,15,2
1668131495642,MATH 231B,A00,098032,Zlatos; Andrej,12,0,15,3
1668131496069,MATH 240B,A00,098033,Ni; Lei,9,0,15,6
1668131496490,MATH 243,A00,098034,Jekel; David Andrew,10,0,10,0
1668131496917,MATH 245A,A00,098035,Nie; Jiawang,0,0,15,16
1668131497353,MATH 248,A00,098036,Bejenaru; Ioan,10,0,10,0
1668131497785,MATH 250B,A00,098037,Spolaor; Luca,14,0,15,1
1668131498207,MATH 258,A00,098038,Ni; Lei,10,0,10,0
1668131498635,MATH 264B,A00,098041,Rhoades; Brendon Patrick,9,0,15,6
1668131499057,MATH 268,A00,098042,Buss; Samuel R,10,0,10,0
1668131499495,MATH 269,A00,098043,Rhoades; Brendon Patrick,10,0,10,0
1668131499927,MATH 270B,A00,098044,Li; Bo,10,0,15,5
1668131500364,MATH 272B,A00,098045,Holst; Michael J,13,0,15,2
1668131500790,MATH 273A,A00,098046,Tian; Xiaochuan,10,0,15,5
1668131501213,MATH 275,A01,098048,Tian; Xiaochuan,6,0,10,4
1668131501637,MATH 278A,A00,098049,Holst; Michael J,8,0,10,2
1668131502074,MATH 278B,A00,098050,Cloninger; Alexander,10,0,10,0
1668131502512,MATH 278C,A00,098051,Nie; Jiawang,7,0,10,3
1668131502936,MATH 280B,A00,098052,Zheng; Tianyi,10,0,15,5
1668131503363,MATH 281B,A00,098053,Bradic; Jelena,2,0,15,13
1668131503792,MATH 282B,A00,098054,Arias-Castro; Ery,0,0,15,15
1668131504221,MATH 285,A00,098055,Fitzsimmons; Patrick J,0,0,15,17
1668131504645,MATH 287B,A00,098056,Arias-Castro; Ery,2,0,15,13
1668131505071,MATH 288,A00,098057,Agarwal; Pooja,9,0,10,1
1668131505071,MATH 288,B00,098058,Zhang; Danna,8,0,10,2
1668131505071,MATH 288,C00,098059,Williams; Ruth J,10,0,10,0
1668131505567,MATH 290B,A00,098060,Roberts; Justin Deritter,13,0,15,2
1668131505992,MATH 292,A00,098061,Belmont; Eva Kinoshita,10,0,10,0
1668131506417,MATH 295,A00,098062,Suk; Andrew Hoon,48,0,50,2
1668131506841,MATH 296,A00,098063,Novak; Jonathan I,20,0,20,0
1668131507266,MATH 297,001,098064,Gamst; Anthony Collins,9997,0,9999,2
1668132010964,COGS 205,A00,101395,Chiba; Andrea,19,0,20,1
1668132011387,COGS 210B,001,101404,Greene; Deanna Jacquelyn,9998,0,9999,1
1668132011387,COGS 210B,002,101417,Xia; Haijun,9999,0,9999,0
1668132011387,COGS 210B,003,101422,Nitz; Douglas A.,9999,0,9999,0
1668132011387,COGS 210B,004,101423,Hollan; James D.,9998,0,9999,1
1668132011387,COGS 210B,005,101424,Deak; Gedeon O.,9998,0,9999,1
1668132011387,COGS 210B,006,101425,Rossano; Federico,9999,0,9999,0
1668132011812,COGS 211B,A00,101427,Coulson; Seana M,9996,0,9999,3
1668132012581,COGS 220,A00,101428,Hollan; James D.,0,0,25,25
1668132013009,COGS 229,A00,101429,Dow; Steven P,18,0,25,7
1668132014494,COGS 230,A00,101430,Klemmer; Scott R,12,0,17,5
1668132014922,COGS 234,A00,101431,Xia; Haijun,3,0,25,22
1668132015345,COGS 260,A00,101432,Kiyonaga; Anastasia,20,0,25,5
1668132015345,COGS 260,B00,101433,Kirsh; David Joel,16,0,25,9
1668132015776,CSE 202,A00,102371,Impagliazzo; Russell,0,0,0,0
1668132016266,CSE 203B,A01,102373,Cheng; Chung Kuan,0,0,0,0
1668132016691,CSE 208,A00,102374,Micciancio; Daniele,0,0,0,0
1668132017198,CSE 209A,A00,112895,Impagliazzo; Russell,0,0,15,15
1668132017634,CSE 209B,A00,108005,Bellare; Mihir,0,0,0,0
1668132018062,CSE 210,A00,113163,Coblenz; Michael J,0,0,0,0
1668132018518,CSE 219,A00,106111,Dow; Steven P,0,0,20,20
1668132018942,CSE 221,A00,102376,Voelker; Geoffrey M.,0,0,0,0
1668132019372,CSE 224,A01,102378,Porter; George M,0,0,0,0
1668132019800,CSE 229A,A00,102379,Savage; Stefan,0,0,0,0
1668132020225,CSE 229C,A00,102380,Munyaka; Imani N. S.,0,0,0,0
1668132020650,CSE 232B,A00,102382,Deutsch; Alin Bernard,0,0,0,0
1668132021085,CSE 234,A01,112904,Kumar; Arun Kumar,0,0,0,0
1668132021528,CSE 237A,A00,102383,Rosing; Tajana Simunic,0,0,0,0
1668132021987,CSE 239A,A00,102384,Deutsch; Alin Bernard,0,0,0,0
1668132022417,CSE 239B,A00,102385,Polikarpova; Nadezhda,0,0,0,0
1668132022860,CSE 240A,A00,102386,Pannuto; Patrick William,0,0,0,0
1668132023283,CSE 240B,A00,102387,Zhao; Jishen,0,0,0,0
1668132023722,CSE 241A,A00,106406,Kang; Mingu,0,0,0,0
1668132024152,CSE 249B,A00,102388,Kahng; Andrew Byun,0,0,8,8
1668132024578,CSE 251B,A01,102392,Cottrell; Garrison W,0,0,0,0
1668132024578,CSE 251B,A02,102393,Cottrell; Garrison W,0,0,0,0
1668132025004,CSE 252B,A00,102394,Ochoa; Benjamin Lawrence,0,0,0,0
1668132025771,CSE 257,A01,102396,Gao; Sicun,0,0,0,0
1668132026202,CSE 272,A00,102397,Li; Tzumao,0,0,0,0
1668132026624,CSE 274,A00,111323,Chern; Albert Ren-Haur,0,0,0,0
1668132027050,CSE 282,A00,102398,Pevzner; Pavel Arkadjevich,0,0,0,0
1668132027477,CSE 284,A00,114175,Gymrek; Melissa Ann,0,0,0,0
1668132027901,CSE 290,A00,102399,Chandraker; Manmohan Krishna,0,0,0,0
1668132027901,CSE 290,B00,102400,Vaccaro; Kristen Marie,0,0,25,25
1668132027901,CSE 290,C00,102414,Pannuto; Patrick William,0,0,25,25
1668132027901,CSE 290,D00,102427,Pevzner; Pavel Arkadjevich,0,0,0,0
1668132027901,CSE 290,E00,102429,Zhao; Jishen,0,0,0,0
1668132027901,CSE 290,F00,102436,Tullsen; Dean Michael,0,0,0,0
1668132027901,CSE 290,G00,102440,Christensen; Henrik I,0,0,20,20
1668132028329,CSE 291,A00,102443,Su; Hao,0,0,0,0
1668132028329,CSE 291,B00,102448,Polikarpova; Nadezhda,0,0,0,0
1668132028329,CSE 291,C00,102453,Vaccaro; Kristen Marie,0,0,0,0
1668132028329,CSE 291,D00,111343,Savage; Stefan,0,0,0,0
1668132028329,CSE 291,E00,116474,Claffy; Kimberly Claire,0,0,0,0
1668132028329,CSE 291,F00,116479,Pasquale; Joseph,0,0,0,0
1668132028767,CSE 293,001,119111,Bafna; Vineet,9999,0,9999,0
1668132028767,CSE 293,002,119118,Bellare; Mihir,9999,0,9999,0
1668132028767,CSE 293,003,119122,Berg-Kirkpatrick; Taylor D,9999,0,9999,0
1668132028767,CSE 293,004,119135,Christensen; Henrik I,9999,0,9999,0
1668132028767,CSE 293,005,119142,Cottrell; Garrison W,9999,0,9999,0
1668132028767,CSE 293,006,119146,Deutsch; Alin Bernard,9999,0,9999,0
1668132028767,CSE 293,007,119159,Esmaeilzadeh; Hadi,9999,0,9999,0
1668132028767,CSE 293,008,119166,Freund; Yoav,9999,0,9999,0
1668132028767,CSE 293,009,119170,Griswold; William G.,9999,0,9999,0
1668132028767,CSE 293,010,119183,Gymrek; Melissa Ann,9999,0,9999,0
1668132028767,CSE 293,011,119190,Heninger; Nadia A,9999,0,9999,0
1668132028767,CSE 293,012,119230,Impagliazzo; Russell,9999,0,9999,0
1668132028767,CSE 293,013,119232,Jhala; Ranjit,9999,0,9999,0
1668132028767,CSE 293,014,119233,Kahng; Andrew Byun,9999,0,9999,0
1668132028767,CSE 293,015,119298,Kane; Daniel Mertz,9999,0,9999,0
1668132028767,CSE 293,016,119299,Kriegman; David J,9999,0,9999,0
1668132028767,CSE 293,017,119300,Kumar; Arun Kumar,9999,0,9999,0
1668132028767,CSE 293,018,119301,Lerner; Sorin,9999,0,9999,0
1668132028767,CSE 293,019,119302,Lovett; Shachar,9999,0,9999,0
1668132028767,CSE 293,020,119303,McAuley; Julian John,9999,0,9999,0
1668132028767,CSE 293,021,119304,Micciancio; Daniele,9999,0,9999,0
1668132028767,CSE 293,022,119367,Orailoglu; Alex,9999,0,9999,0
1668132028767,CSE 293,023,119382,Paturi; Ramamohan,9999,0,9999,0
1668132028767,CSE 293,024,119404,Polikarpova; Nadezhda,9999,0,9999,0
1668132028767,CSE 293,025,119406,Politz; Joseph Gibbs,9999,0,9999,0
1668132028767,CSE 293,026,119411,Porter; George M,9999,0,9999,0
1668132028767,CSE 293,027,119414,Porter; Leonard Emerson,9999,0,9999,0
1668132028767,CSE 293,028,119416,Ramamoorthi; Ravi,9999,0,9999,0
1668132028767,CSE 293,029,119417,Sahoo; Debashis,9999,0,9999,0
1668132028767,CSE 293,030,119420,Saul; Lawrence,9999,0,9999,0
1668132028767,CSE 293,031,119421,Savage; Stefan,9999,0,9999,0
1668132028767,CSE 293,032,119425,Schulze; Jurgen P.,9999,0,9999,0
1668132028767,CSE 293,033,119426,Snoeren; Alex C.,9999,0,9999,0
1668132028767,CSE 293,034,119428,Shang; Jingbo,9999,0,9999,0
1668132028767,CSE 293,035,119430,Stefan; Deian,9999,0,9999,0
1668132028767,CSE 293,036,119431,Su; Hao,9999,0,9999,0
1668132028767,CSE 293,037,119433,Swanson; Steven James,9999,0,9999,0
1668132028767,CSE 293,038,119435,Tullsen; Dean Michael,9999,0,9999,0
1668132028767,CSE 293,039,119483,Voelker; Geoffrey M.,9999,0,9999,0
1668132028767,CSE 293,040,119537,Zhao; Jishen,9999,0,9999,0
1668132028767,CSE 293,041,119538,Zhou; Yuan-Yuan,9999,0,9999,0
1668132028767,CSE 293,042,119539,Gao; Sicun,9999,0,9999,0
1668132028767,CSE 293,043,119540,Weibel; Nadir,9999,0,9999,0
1668132028767,CSE 293,044,119541,Gupta; Rajesh K.,9999,0,9999,0
1668132028767,CSE 293,045,126410,Vaccaro; Kristen Marie,9999,0,9999,0
1668132028767,CSE 293,046,126411,Klemke; Richard,9999,0,9999,0
1668132029229,CSE 294,A00,102459,Voelker; Geoffrey M.,0,0,0,0
1668132029229,CSE 294,B00,111322,Orailoglu; Alex,0,0,0,0
1668132029658,DSE 201,A00,096914,Deutsch; Alin Bernard,30,0,30,0
1668132030083,DSE 210,A00,096915,Dasgupta; Sanjoy,30,0,30,0
1668132030508,DSE 260A,A00,096916,Altintas De Callaf; Ilkay,30,0,30,0
1668132031005,ECE 200,001,103586,Antipa; Nicholas A,9999,0,9999,0
1668132031005,ECE 200,002,103587,Atanasov; Nikolay A.,9999,0,9999,0
1668132031005,ECE 200,003,103588,Bharadia; Dinesh,9999,0,9999,0
1668132031005,ECE 200,004,103589,Cheng; Chung Kuan,9999,0,9999,0
1668132031005,ECE 200,005,103590,Cosman; Pamela C.,9999,0,9999,0
1668132031005,ECE 200,006,103591,Dayeh; Shadi Ahmad,9999,0,9999,0
1668132031005,ECE 200,007,103592,Fainman; Yeshaiahu,9999,0,9999,0
1668132031005,ECE 200,008,103593,Ford; Joseph Earl,9999,0,9999,0
1668132031005,ECE 200,009,103594,Franceschetti; Massimo,9999,0,9999,0
1668132031005,ECE 200,010,103595,Fullerton; Eric E,9999,0,9999,0
1668132031005,ECE 200,011,103596,Galton; Ian A,9999,0,9999,0
1668132031005,ECE 200,012,103597,Gilja; Vikash,9999,0,9999,0
1668132031005,ECE 200,013,103598,Hall; Drew A.,9999,0,9999,0
1668132031005,ECE 200,014,103599,Hsueh; Tzu-Chien,9999,0,9999,0
1668132031005,ECE 200,015,103600,Javidi; Tara,9999,0,9999,0
1668132031005,ECE 200,016,103601,Kahng; Andrew Byun,9999,0,9999,0
1668132031005,ECE 200,017,103602,Kim; Young-Han,9999,0,9999,0
1668132031005,ECE 200,018,103603,Koushanfar; Farinaz,9999,0,9999,0
1668132031005,ECE 200,019,103604,Kuzum; Duygu,9999,0,9999,0
1668132031005,ECE 200,020,103605,Le; Hanh-Phuc,9999,0,9999,0
1668132031005,ECE 200,021,103606,Lin; Bill,9999,0,9999,0
1668132031005,ECE 200,022,103607,Liu; Zhaowei,9998,0,9999,1
1668132031005,ECE 200,023,103608,Lo; Yu-Hwa,9999,0,9999,0
1668132031005,ECE 200,024,103609,Lomakin; Vitaliy,9999,0,9999,0
1668132031005,ECE 200,025,103610,Mercier; Patrick Philip,9999,0,9999,0
1668132031005,ECE 200,026,103611,Meyer; Florian,9999,0,9999,0
1668132031005,ECE 200,027,103612,Milstein; Laurence B.,9999,0,9999,0
1668132031005,ECE 200,028,103613,Mir Arabbaygi; Siavash,9999,0,9999,0
1668132031005,ECE 200,029,103614,Mookherjea; Shayan,9999,0,9999,0
1668132031005,ECE 200,030,103615,Morris; Karcher William,9999,0,9999,0
1668132031005,ECE 200,031,103616,Ng; Tse Nga,9999,0,9999,0
1668132031005,ECE 200,032,103617,Nguyen; Truong Quang,9999,0,9999,0
1668132031005,ECE 200,033,103618,Nomura; Kenji,9999,0,9999,0
1668132031005,ECE 200,034,103619,Orlitsky; Alon,9999,0,9999,0
1668132031005,ECE 200,035,103620,Pal; Piya,9999,0,9999,0
1668132031005,ECE 200,036,103621,Papen; George C.,9999,0,9999,0
1668132031005,ECE 200,037,103622,Radic; Stojan,9999,0,9999,0
1668132031005,ECE 200,038,103623,Rao; Bhaskar D.,9999,0,9999,0
1668132031005,ECE 200,039,103624,Rao; Ramesh R,9999,0,9999,0
1668132031005,ECE 200,040,103625,Rebeiz; Gabriel,9999,0,9999,0
1668132031005,ECE 200,041,103626,Sanford; John R,9999,0,9999,0
1668132031005,ECE 200,042,103627,Siegel; Paul H.,9999,0,9999,0
1668132031005,ECE 200,043,103628,Sievenpiper; Daniel F.,9999,0,9999,0
1668132031005,ECE 200,044,103629,Sworder; David D.,9999,0,9999,0
1668132031005,ECE 200,045,103630,Taur; Yuan,9999,0,9999,0
1668132031005,ECE 200,046,103631,Touri; Behrouz,9999,0,9999,0
1668132031005,ECE 200,047,103632,Trivedi; Mohan M.,9999,0,9999,0
1668132031005,ECE 200,048,103633,Vasconcelos; Nuno,9999,0,9999,0
1668132031005,ECE 200,049,103634,Wang; Xiaolong,9999,0,9999,0
1668132031005,ECE 200,050,103635,Xie; Pengtao,9999,0,9999,0
1668132031005,ECE 200,051,103636,Yip; Michael,9999,0,9999,0
1668132031005,ECE 200,052,103637,Zeger; Kenneth A.,999,0,999,0
1668132031005,ECE 200,053,103638,Zhang; Xinyu,9999,0,9999,0
1668132031005,ECE 200,054,103639,Turakhia; Yatish Girish,9999,0,9999,0
1668132031005,ECE 200,055,103640,Kang; Mingu,9999,0,9999,0
1668132031005,ECE 200,056,103641,Shi; Yuanyuan,9999,0,9999,0
1668132031005,ECE 200,057,103642,Wang; Edward Jay,9999,0,9999,0
1668132031005,ECE 200,058,103643,Zheng; Yang,9999,0,9999,0
1668132031529,ECE 202,A00,103644,Kuzum; Duygu,0,0,0,0
1668132031979,ECE 212BN,A00,103646,Ng; Tse Nga,0,0,0,0
1668132032418,ECE 221,A00,111493,Staff,0,0,0,0
1668132032847,ECE 222B,A00,103647,Lomakin; Vitaliy,0,0,0,0
1668132033275,ECE 230B,A00,103648,Taur; Yuan,0,0,0,0
1668132033701,ECE 238B,A00,103649,Garay; Javier,0,0,0,0
1668132034143,ECE 240B,A00,112900,Fainman; Yeshaiahu,0,0,0,0
1668132034587,ECE 247A,A00,103650,Jokerst; Jesse Vincent,0,0,0,0
1668132035013,ECE 247B,A00,103651,Wang; Joseph,0,0,0,0
1668132035436,ECE 250,A00,103652,Siegel; Paul H.,0,0,0,0
1668132035872,ECE 251A,A00,103654,Rao; Bhaskar D.,0,0,0,0
1668132036302,ECE 257B,A00,103655,Bharadia; Dinesh,0,0,0,0
1668132036727,ECE 258A,A00,103656,Milstein; Laurence B.,0,0,0,0
1668132037149,ECE 260B,A00,103658,Kang; Mingu,0,0,0,0
1668132037580,ECE 264A,A00,103659,Galton; Ian A,0,0,0,0
1668132038011,ECE 265A,A00,103661,Gudem; Prasad S.S.,0,0,0,0
1668132038439,ECE 265D,A00,103662,Gudem; Prasad S.S.,0,0,0,0
1668132038866,ECE 268,A00,103663,Koushanfar; Farinaz,0,0,0,0
1668132039292,ECE 269,A01,103665,Pal; Piya,0,0,0,0
1668132039722,ECE 271B,A00,103666,Vasconcelos; Manuela,0,0,0,0
1668132040150,ECE 276A,A00,103667,Atanasov; Nikolay A.,0,0,0,0
1668132040587,ECE 277,A00,103668,An; Cheolhong,0,0,0,0
1668132041017,ECE 279,A00,117947,Hall; Drew A.,0,0,0,0
1668132041874,ECE 283,A00,103670,Hsueh; Tzu-Chien,0,0,0,0
1668132042296,ECE 284,A00,103671,Turakhia; Yatish Girish,0,0,0,0
1668132042720,ECE 285,A00,103672,Zheng; Yang,0,0,0,0
1668132042720,ECE 285,B00,103673,Sworder; David D.,0,0,0,0
1668132043145,ECE 287,A00,103676,Javidi; Tara,0,0,0,0
1668132043578,MATH 200B,A00,098023,Salehi Golsefidy; Alireza,12,0,15,3
1668132044013,MATH 202B,A00,098024,Rhoades; Brendon Patrick,9,0,15,6
1668132044441,MATH 203B,A00,098025,Oprea; Dragos N.,10,0,15,5
1668132044866,MATH 204B,A00,098026,Sorensen; Claus M,13,0,15,2
1668132045296,MATH 208,A00,098027,Izadi; Elham,7,0,10,3
1668132045717,MATH 209,A00,098028,Pollack; Aaron,10,0,10,0
1668132046159,MATH 211A,A00,112919,Rogalski; Daniel,9,0,10,1
1668132046582,MATH 211B,A00,112920,Seward; Brandon M.,9,0,10,1
1668132047007,MATH 218,A00,098029,Li; Bo,10,0,10,0
1668132047434,MATH 220B,A00,098030,Novak; Jonathan I,11,0,15,4
1668132047872,MATH 221A,A00,098031,Ebenfelt; Peter F,13,0,15,2
1668132048297,MATH 231B,A00,098032,Zlatos; Andrej,12,0,15,3
1668132048720,MATH 240B,A00,098033,Ni; Lei,9,0,15,6
1668132049145,MATH 243,A00,098034,Jekel; David Andrew,10,0,10,0
1668132049576,MATH 245A,A00,098035,Nie; Jiawang,0,0,15,16
1668132050006,MATH 248,A00,098036,Bejenaru; Ioan,10,0,10,0
1668132050432,MATH 250B,A00,098037,Spolaor; Luca,14,0,15,1
1668132050868,MATH 258,A00,098038,Ni; Lei,10,0,10,0
1668132051292,MATH 264B,A00,098041,Rhoades; Brendon Patrick,9,0,15,6
1668132051721,MATH 268,A00,098042,Buss; Samuel R,10,0,10,0
1668132052144,MATH 269,A00,098043,Rhoades; Brendon Patrick,10,0,10,0
1668132052572,MATH 270B,A00,098044,Li; Bo,10,0,15,5
1668132052995,MATH 272B,A00,098045,Holst; Michael J,13,0,15,2
1668132053430,MATH 273A,A00,098046,Tian; Xiaochuan,10,0,15,5
1668132053863,MATH 275,A01,098048,Tian; Xiaochuan,6,0,10,4
1668132054293,MATH 278A,A00,098049,Holst; Michael J,8,0,10,2
1668132054718,MATH 278B,A00,098050,Cloninger; Alexander,10,0,10,0
1668132055141,MATH 278C,A00,098051,Nie; Jiawang,7,0,10,3
1668132055567,MATH 280B,A00,098052,Zheng; Tianyi,10,0,15,5
1668132055991,MATH 281B,A00,098053,Bradic; Jelena,2,0,15,13
1668132056417,MATH 282B,A00,098054,Arias-Castro; Ery,0,0,15,15
1668132056844,MATH 285,A00,098055,Fitzsimmons; Patrick J,0,0,15,17
1668132057274,MATH 287B,A00,098056,Arias-Castro; Ery,2,0,15,13
1668132057698,MATH 288,A00,098057,Agarwal; Pooja,9,0,10,1
1668132057698,MATH 288,B00,098058,Zhang; Danna,8,0,10,2
1668132057698,MATH 288,C00,098059,Williams; Ruth J,10,0,10,0
1668132058127,MATH 290B,A00,098060,Roberts; Justin Deritter,13,0,15,2
1668132058550,MATH 292,A00,098061,Belmont; Eva Kinoshita,10,0,10,0
1668132058976,MATH 295,A00,098062,Suk; Andrew Hoon,48,0,50,2
1668132059406,MATH 296,A00,098063,Novak; Jonathan I,20,0,20,0
1668132059839,MATH 297,001,098064,Gamst; Anthony Collins,9997,0,9999,2
1668132562978,COGS 205,A00,101395,Chiba; Andrea,19,0,20,1
1668132563410,COGS 210B,001,101404,Greene; Deanna Jacquelyn,9998,0,9999,1
1668132563410,COGS 210B,002,101417,Xia; Haijun,9999,0,9999,0
1668132563410,COGS 210B,003,101422,Nitz; Douglas A.,9999,0,9999,0
1668132563410,COGS 210B,004,101423,Hollan; James D.,9998,0,9999,1
1668132563410,COGS 210B,005,101424,Deak; Gedeon O.,9998,0,9999,1
1668132563410,COGS 210B,006,101425,Rossano; Federico,9999,0,9999,0
1668132563832,COGS 211B,A00,101427,Coulson; Seana M,9996,0,9999,3
1668132564257,COGS 220,A00,101428,Hollan; James D.,0,0,25,25
1668132564679,COGS 229,A00,101429,Dow; Steven P,18,0,25,7
1668132565107,COGS 230,A00,101430,Klemmer; Scott R,12,0,17,5
1668132565530,COGS 234,A00,101431,Xia; Haijun,3,0,25,22
1668132565956,COGS 260,A00,101432,Kiyonaga; Anastasia,20,0,25,5
1668132565956,COGS 260,B00,101433,Kirsh; David Joel,16,0,25,9
1668132566389,CSE 202,A00,102371,Impagliazzo; Russell,0,0,0,0
1668132566832,CSE 203B,A01,102373,Cheng; Chung Kuan,0,0,0,0
1668132567266,CSE 208,A00,102374,Micciancio; Daniele,0,0,0,0
1668132567691,CSE 209A,A00,112895,Impagliazzo; Russell,0,0,15,15
1668132568128,CSE 209B,A00,108005,Bellare; Mihir,0,0,0,0
1668132568550,CSE 210,A00,113163,Coblenz; Michael J,0,0,0,0
1668132568979,CSE 219,A00,106111,Dow; Steven P,0,0,20,20
1668132569414,CSE 221,A00,102376,Voelker; Geoffrey M.,0,0,0,0
1668132569842,CSE 224,A01,102378,Porter; George M,0,0,0,0
1668132570272,CSE 229A,A00,102379,Savage; Stefan,0,0,0,0
1668132570711,CSE 229C,A00,102380,Munyaka; Imani N. S.,0,0,0,0
1668132571147,CSE 232B,A00,102382,Deutsch; Alin Bernard,0,0,0,0
1668132571581,CSE 234,A01,112904,Kumar; Arun Kumar,0,0,0,0
1668132572015,CSE 237A,A00,102383,Rosing; Tajana Simunic,0,0,0,0
1668132572438,CSE 239A,A00,102384,Deutsch; Alin Bernard,0,0,0,0
1668132572872,CSE 239B,A00,102385,Polikarpova; Nadezhda,0,0,0,0
1668132573296,CSE 240A,A00,102386,Pannuto; Patrick William,0,0,0,0
1668132573719,CSE 240B,A00,102387,Zhao; Jishen,0,0,0,0
1668132574159,CSE 241A,A00,106406,Kang; Mingu,0,0,0,0
1668132574586,CSE 249B,A00,102388,Kahng; Andrew Byun,0,0,8,8
1668132575014,CSE 251B,A01,102392,Cottrell; Garrison W,0,0,0,0
1668132575014,CSE 251B,A02,102393,Cottrell; Garrison W,0,0,0,0
1668132575446,CSE 252B,A00,102394,Ochoa; Benjamin Lawrence,0,0,0,0
1668132575889,CSE 257,A01,102396,Gao; Sicun,0,0,0,0
1668132576323,CSE 272,A00,102397,Li; Tzumao,0,0,0,0
1668132576751,CSE 274,A00,111323,Chern; Albert Ren-Haur,0,0,0,0
1668132577175,CSE 282,A00,102398,Pevzner; Pavel Arkadjevich,0,0,0,0
1668132577602,CSE 284,A00,114175,Gymrek; Melissa Ann,0,0,0,0
1668132578043,CSE 290,A00,102399,Chandraker; Manmohan Krishna,0,0,0,0
1668132578043,CSE 290,B00,102400,Vaccaro; Kristen Marie,0,0,25,25
1668132578043,CSE 290,C00,102414,Pannuto; Patrick William,0,0,25,25
1668132578043,CSE 290,D00,102427,Pevzner; Pavel Arkadjevich,0,0,0,0
1668132578043,CSE 290,E00,102429,Zhao; Jishen,0,0,0,0
1668132578043,CSE 290,F00,102436,Tullsen; Dean Michael,0,0,0,0
1668132578043,CSE 290,G00,102440,Christensen; Henrik I,0,0,20,20
1668132578467,CSE 291,A00,102443,Su; Hao,0,0,0,0
1668132578467,CSE 291,B00,102448,Polikarpova; Nadezhda,0,0,0,0
1668132578467,CSE 291,C00,102453,Vaccaro; Kristen Marie,0,0,0,0
1668132578467,CSE 291,D00,111343,Savage; Stefan,0,0,0,0
1668132578467,CSE 291,E00,116474,Claffy; Kimberly Claire,0,0,0,0
1668132578467,CSE 291,F00,116479,Pasquale; Joseph,0,0,0,0
1668132578914,CSE 293,001,119111,Bafna; Vineet,9999,0,9999,0
1668132578914,CSE 293,002,119118,Bellare; Mihir,9999,0,9999,0
1668132578914,CSE 293,003,119122,Berg-Kirkpatrick; Taylor D,9999,0,9999,0
1668132578914,CSE 293,004,119135,Christensen; Henrik I,9999,0,9999,0
1668132578914,CSE 293,005,119142,Cottrell; Garrison W,9999,0,9999,0
1668132578914,CSE 293,006,119146,Deutsch; Alin Bernard,9999,0,9999,0
1668132578914,CSE 293,007,119159,Esmaeilzadeh; Hadi,9999,0,9999,0
1668132578914,CSE 293,008,119166,Freund; Yoav,9999,0,9999,0
1668132578914,CSE 293,009,119170,Griswold; William G.,9999,0,9999,0
1668132578914,CSE 293,010,119183,Gymrek; Melissa Ann,9999,0,9999,0
1668132578914,CSE 293,011,119190,Heninger; Nadia A,9999,0,9999,0
1668132578914,CSE 293,012,119230,Impagliazzo; Russell,9999,0,9999,0
1668132578914,CSE 293,013,119232,Jhala; Ranjit,9999,0,9999,0
1668132578914,CSE 293,014,119233,Kahng; Andrew Byun,9999,0,9999,0
1668132578914,CSE 293,015,119298,Kane; Daniel Mertz,9999,0,9999,0
1668132578914,CSE 293,016,119299,Kriegman; David J,9999,0,9999,0
1668132578914,CSE 293,017,119300,Kumar; Arun Kumar,9999,0,9999,0
1668132578914,CSE 293,018,119301,Lerner; Sorin,9999,0,9999,0
1668132578914,CSE 293,019,119302,Lovett; Shachar,9999,0,9999,0
1668132578914,CSE 293,020,119303,McAuley; Julian John,9999,0,9999,0
1668132578914,CSE 293,021,119304,Micciancio; Daniele,9999,0,9999,0
1668132578914,CSE 293,022,119367,Orailoglu; Alex,9999,0,9999,0
1668132578914,CSE 293,023,119382,Paturi; Ramamohan,9999,0,9999,0
1668132578914,CSE 293,024,119404,Polikarpova; Nadezhda,9999,0,9999,0
1668132578914,CSE 293,025,119406,Politz; Joseph Gibbs,9999,0,9999,0
1668132578914,CSE 293,026,119411,Porter; George M,9999,0,9999,0
1668132578914,CSE 293,027,119414,Porter; Leonard Emerson,9999,0,9999,0
1668132578914,CSE 293,028,119416,Ramamoorthi; Ravi,9999,0,9999,0
1668132578914,CSE 293,029,119417,Sahoo; Debashis,9999,0,9999,0
1668132578914,CSE 293,030,119420,Saul; Lawrence,9999,0,9999,0
1668132578914,CSE 293,031,119421,Savage; Stefan,9999,0,9999,0
1668132578914,CSE 293,032,119425,Schulze; Jurgen P.,9999,0,9999,0
1668132578914,CSE 293,033,119426,Snoeren; Alex C.,9999,0,9999,0
1668132578914,CSE 293,034,119428,Shang; Jingbo,9999,0,9999,0
1668132578914,CSE 293,035,119430,Stefan; Deian,9999,0,9999,0
1668132578914,CSE 293,036,119431,Su; Hao,9999,0,9999,0
1668132578914,CSE 293,037,119433,Swanson; Steven James,9999,0,9999,0
1668132578914,CSE 293,038,119435,Tullsen; Dean Michael,9999,0,9999,0
1668132578914,CSE 293,039,119483,Voelker; Geoffrey M.,9999,0,9999,0
1668132578914,CSE 293,040,119537,Zhao; Jishen,9999,0,9999,0
1668132578914,CSE 293,041,119538,Zhou; Yuan-Yuan,9999,0,9999,0
1668132578914,CSE 293,042,119539,Gao; Sicun,9999,0,9999,0
1668132578914,CSE 293,043,119540,Weibel; Nadir,9999,0,9999,0
1668132578914,CSE 293,044,119541,Gupta; Rajesh K.,9999,0,9999,0
1668132578914,CSE 293,045,126410,Vaccaro; Kristen Marie,9999,0,9999,0
1668132578914,CSE 293,046,126411,Klemke; Richard,9999,0,9999,0
1668132579339,CSE 294,A00,102459,Voelker; Geoffrey M.,0,0,0,0
1668132579339,CSE 294,B00,111322,Orailoglu; Alex,0,0,0,0
1668132579771,DSE 201,A00,096914,Deutsch; Alin Bernard,30,0,30,0
1668132580202,DSE 210,A00,096915,Dasgupta; Sanjoy,30,0,30,0
1668132580626,DSE 260A,A00,096916,Altintas De Callaf; Ilkay,30,0,30,0
1668132581101,ECE 200,001,103586,Antipa; Nicholas A,9999,0,9999,0
1668132581101,ECE 200,002,103587,Atanasov; Nikolay A.,9999,0,9999,0
1668132581101,ECE 200,003,103588,Bharadia; Dinesh,9999,0,9999,0
1668132581101,ECE 200,004,103589,Cheng; Chung Kuan,9999,0,9999,0
1668132581101,ECE 200,005,103590,Cosman; Pamela C.,9999,0,9999,0
1668132581101,ECE 200,006,103591,Dayeh; Shadi Ahmad,9999,0,9999,0
1668132581101,ECE 200,007,103592,Fainman; Yeshaiahu,9999,0,9999,0
1668132581101,ECE 200,008,103593,Ford; Joseph Earl,9999,0,9999,0
1668132581101,ECE 200,009,103594,Franceschetti; Massimo,9999,0,9999,0
1668132581101,ECE 200,010,103595,Fullerton; Eric E,9999,0,9999,0
1668132581101,ECE 200,011,103596,Galton; Ian A,9999,0,9999,0
1668132581101,ECE 200,012,103597,Gilja; Vikash,9999,0,9999,0
1668132581101,ECE 200,013,103598,Hall; Drew A.,9999,0,9999,0
1668132581101,ECE 200,014,103599,Hsueh; Tzu-Chien,9999,0,9999,0
1668132581101,ECE 200,015,103600,Javidi; Tara,9999,0,9999,0
1668132581101,ECE 200,016,103601,Kahng; Andrew Byun,9999,0,9999,0
1668132581101,ECE 200,017,103602,Kim; Young-Han,9999,0,9999,0
1668132581101,ECE 200,018,103603,Koushanfar; Farinaz,9999,0,9999,0
1668132581101,ECE 200,019,103604,Kuzum; Duygu,9999,0,9999,0
1668132581101,ECE 200,020,103605,Le; Hanh-Phuc,9999,0,9999,0
1668132581101,ECE 200,021,103606,Lin; Bill,9999,0,9999,0
1668132581101,ECE 200,022,103607,Liu; Zhaowei,9998,0,9999,1
1668132581101,ECE 200,023,103608,Lo; Yu-Hwa,9999,0,9999,0
1668132581101,ECE 200,024,103609,Lomakin; Vitaliy,9999,0,9999,0
1668132581101,ECE 200,025,103610,Mercier; Patrick Philip,9999,0,9999,0
1668132581101,ECE 200,026,103611,Meyer; Florian,9999,0,9999,0
1668132581101,ECE 200,027,103612,Milstein; Laurence B.,9999,0,9999,0
1668132581101,ECE 200,028,103613,Mir Arabbaygi; Siavash,9999,0,9999,0
1668132581101,ECE 200,029,103614,Mookherjea; Shayan,9999,0,9999,0
1668132581101,ECE 200,030,103615,Morris; Karcher William,9999,0,9999,0
1668132581101,ECE 200,031,103616,Ng; Tse Nga,9999,0,9999,0
1668132581101,ECE 200,032,103617,Nguyen; Truong Quang,9999,0,9999,0
1668132581101,ECE 200,033,103618,Nomura; Kenji,9999,0,9999,0
1668132581101,ECE 200,034,103619,Orlitsky; Alon,9999,0,9999,0
1668132581101,ECE 200,035,103620,Pal; Piya,9999,0,9999,0
1668132581101,ECE 200,036,103621,Papen; George C.,9999,0,9999,0
1668132581101,ECE 200,037,103622,Radic; Stojan,9999,0,9999,0
1668132581101,ECE 200,038,103623,Rao; Bhaskar D.,9999,0,9999,0
1668132581101,ECE 200,039,103624,Rao; Ramesh R,9999,0,9999,0
1668132581101,ECE 200,040,103625,Rebeiz; Gabriel,9999,0,9999,0
1668132581101,ECE 200,041,103626,Sanford; John R,9999,0,9999,0
1668132581101,ECE 200,042,103627,Siegel; Paul H.,9999,0,9999,0
1668132581101,ECE 200,043,103628,Sievenpiper; Daniel F.,9999,0,9999,0
1668132581101,ECE 200,044,103629,Sworder; David D.,9999,0,9999,0
1668132581101,ECE 200,045,103630,Taur; Yuan,9999,0,9999,0
1668132581101,ECE 200,046,103631,Touri; Behrouz,9999,0,9999,0
1668132581101,ECE 200,047,103632,Trivedi; Mohan M.,9999,0,9999,0
1668132581101,ECE 200,048,103633,Vasconcelos; Nuno,9999,0,9999,0
1668132581101,ECE 200,049,103634,Wang; Xiaolong,9999,0,9999,0
1668132581101,ECE 200,050,103635,Xie; Pengtao,9999,0,9999,0
1668132581101,ECE 200,051,103636,Yip; Michael,9999,0,9999,0
1668132581101,ECE 200,052,103637,Zeger; Kenneth A.,999,0,999,0
1668132581101,ECE 200,053,103638,Zhang; Xinyu,9999,0,9999,0
1668132581101,ECE 200,054,103639,Turakhia; Yatish Girish,9999,0,9999,0
1668132581101,ECE 200,055,103640,Kang; Mingu,9999,0,9999,0
1668132581101,ECE 200,056,103641,Shi; Yuanyuan,9999,0,9999,0
1668132581101,ECE 200,057,103642,Wang; Edward Jay,9999,0,9999,0
1668132581101,ECE 200,058,103643,Zheng; Yang,9999,0,9999,0
1668132581528,ECE 202,A00,103644,Kuzum; Duygu,0,0,0,0
1668132581961,ECE 212BN,A00,103646,Ng; Tse Nga,0,0,0,0
1668132582383,ECE 221,A00,111493,Staff,0,0,0,0
1668132582815,ECE 222B,A00,103647,Lomakin; Vitaliy,0,0,0,0
1668132583242,ECE 230B,A00,103648,Taur; Yuan,0,0,0,0
1668132583697,ECE 238B,A00,103649,Garay; Javier,0,0,0,0
1668132584136,ECE 240B,A00,112900,Fainman; Yeshaiahu,0,0,0,0
1668132584560,ECE 247A,A00,103650,Jokerst; Jesse Vincent,0,0,0,0
1668132584995,ECE 247B,A00,103651,Wang; Joseph,0,0,0,0
1668132585438,ECE 250,A00,103652,Siegel; Paul H.,0,0,0,0
1668132585880,ECE 251A,A00,103654,Rao; Bhaskar D.,0,0,0,0
1668132586318,ECE 257B,A00,103655,Bharadia; Dinesh,0,0,0,0
1668132586745,ECE 258A,A00,103656,Milstein; Laurence B.,0,0,0,0
1668132587171,ECE 260B,A00,103658,Kang; Mingu,0,0,0,0
1668132587611,ECE 264A,A00,103659,Galton; Ian A,0,0,0,0
1668132588040,ECE 265A,A00,103661,Gudem; Prasad S.S.,0,0,0,0
1668132588466,ECE 265D,A00,103662,Gudem; Prasad S.S.,0,0,0,0
1668132588897,ECE 268,A00,103663,Koushanfar; Farinaz,0,0,0,0
1668132589334,ECE 269,A01,103665,Pal; Piya,0,0,0,0
1668132589776,ECE 271B,A00,103666,Vasconcelos; Manuela,0,0,0,0
1668132590216,ECE 276A,A00,103667,Atanasov; Nikolay A.,0,0,0,0
1668132590640,ECE 277,A00,103668,An; Cheolhong,0,0,0,0
1668132591092,ECE 279,A00,117947,Hall; Drew A.,0,0,0,0
1668132591965,ECE 283,A00,103670,Hsueh; Tzu-Chien,0,0,0,0
1668132592402,ECE 284,A00,103671,Turakhia; Yatish Girish,0,0,0,0
1668132592826,ECE 285,A00,103672,Zheng; Yang,0,0,0,0
1668132592826,ECE 285,B00,103673,Sworder; David D.,0,0,0,0
1668132593254,ECE 287,A00,103676,Javidi; Tara,0,0,0,0
1668132593685,MATH 200B,A00,098023,Salehi Golsefidy; Alireza,12,0,15,3
1668132594111,MATH 202B,A00,098024,Rhoades; Brendon Patrick,9,0,15,6
1668132594552,MATH 203B,A00,098025,Oprea; Dragos N.,10,0,15,5
1668132594988,MATH 204B,A00,098026,Sorensen; Claus M,13,0,15,2
1668132595410,MATH 208,A00,098027,Izadi; Elham,7,0,10,3
1668132595848,MATH 209,A00,098028,Pollack; Aaron,10,0,10,0
1668132596275,MATH 211A,A00,112919,Rogalski; Daniel,9,0,10,1
1668132596710,MATH 211B,A00,112920,Seward; Brandon M.,9,0,10,1
1668132597157,MATH 218,A00,098029,Li; Bo,10,0,10,0
1668132597587,MATH 220B,A00,098030,Novak; Jonathan I,11,0,15,4
1668132598016,MATH 221A,A00,098031,Ebenfelt; Peter F,13,0,15,2
1668132598542,MATH 231B,A00,098032,Zlatos; Andrej,12,0,15,3
1668132598984,MATH 240B,A00,098033,Ni; Lei,9,0,15,6
1668132599418,MATH 243,A00,098034,Jekel; David Andrew,10,0,10,0
1668132599854,MATH 245A,A00,098035,Nie; Jiawang,0,0,15,16
1668132601624,MATH 248,A00,098036,Bejenaru; Ioan,10,0,10,0
1668132602085,MATH 250B,A00,098037,Spolaor; Luca,14,0,15,1
1668132602565,MATH 258,A00,098038,Ni; Lei,10,0,10,0
1668132603011,MATH 264B,A00,098041,Rhoades; Brendon Patrick,9,0,15,6
1668132603434,MATH 268,A00,098042,Buss; Samuel R,10,0,10,0
1668132603871,MATH 269,A00,098043,Rhoades; Brendon Patrick,10,0,10,0
1668132604303,MATH 270B,A00,098044,Li; Bo,10,0,15,5
1668132604747,MATH 272B,A00,098045,Holst; Michael J,13,0,15,2
1668132605173,MATH 273A,A00,098046,Tian; Xiaochuan,10,0,15,5
1668132605618,MATH 275,A01,098048,Tian; Xiaochuan,6,0,10,4
1668132606069,MATH 278A,A00,098049,Holst; Michael J,8,0,10,2
1668132606511,MATH 278B,A00,098050,Cloninger; Alexander,10,0,10,0
1668132606934,MATH 278C,A00,098051,Nie; Jiawang,7,0,10,3
1668132607363,MATH 280B,A00,098052,Zheng; Tianyi,10,0,15,5
1668132607786,MATH 281B,A00,098053,Bradic; Jelena,2,0,15,13
1668132608210,MATH 282B,A00,098054,Arias-Castro; Ery,0,0,15,15
1668132608645,MATH 285,A00,098055,Fitzsimmons; Patrick J,0,0,15,17
1668132609073,MATH 287B,A00,098056,Arias-Castro; Ery,2,0,15,13
1668132609562,MATH 288,A00,098057,Agarwal; Pooja,9,0,10,1
1668132609562,MATH 288,B00,098058,Zhang; Danna,8,0,10,2
1668132609562,MATH 288,C00,098059,Williams; Ruth J,10,0,10,0
1668132609991,MATH 290B,A00,098060,Roberts; Justin Deritter,13,0,15,2
1668132610427,MATH 292,A00,098061,Belmont; Eva Kinoshita,10,0,10,0
1668132610875,MATH 295,A00,098062,Suk; Andrew Hoon,48,0,50,2
1668132611313,MATH 296,A00,098063,Novak; Jonathan I,20,0,20,0
1668132611741,MATH 297,001,098064,Gamst; Anthony Collins,9997,0,9999,2
1668133127957,COGS 205,A00,101395,Chiba; Andrea,19,0,20,1
1668133128388,COGS 210B,001,101404,Greene; Deanna Jacquelyn,9998,0,9999,1
1668133128388,COGS 210B,002,101417,Xia; Haijun,9999,0,9999,0
1668133128388,COGS 210B,003,101422,Nitz; Douglas A.,9999,0,9999,0
1668133128388,COGS 210B,004,101423,Hollan; James D.,9998,0,9999,1
1668133128388,COGS 210B,005,101424,Deak; Gedeon O.,9998,0,9999,1
1668133128388,COGS 210B,006,101425,Rossano; Federico,9999,0,9999,0
1668133128817,COGS 211B,A00,101427,Coulson; Seana M,9996,0,9999,3
1668133129239,COGS 220,A00,101428,Hollan; James D.,0,0,25,25
1668133129664,COGS 229,A00,101429,Dow; Steven P,18,0,25,7
1668133130088,COGS 230,A00,101430,Klemmer; Scott R,12,0,17,5
1668133130509,COGS 234,A00,101431,Xia; Haijun,3,0,25,22
1668133130954,COGS 260,A00,101432,Kiyonaga; Anastasia,20,0,25,5
1668133130954,COGS 260,B00,101433,Kirsh; David Joel,16,0,25,9
1668133131403,CSE 202,A00,102371,Impagliazzo; Russell,0,0,0,0
1668133131838,CSE 203B,A01,102373,Cheng; Chung Kuan,0,0,0,0
1668133132264,CSE 208,A00,102374,Micciancio; Daniele,0,0,0,0
1668133132695,CSE 209A,A00,112895,Impagliazzo; Russell,0,0,15,15
1668133133117,CSE 209B,A00,108005,Bellare; Mihir,0,0,0,0
1668133133553,CSE 210,A00,113163,Coblenz; Michael J,0,0,0,0
1668133133977,CSE 219,A00,106111,Dow; Steven P,0,0,20,20
1668133134407,CSE 221,A00,102376,Voelker; Geoffrey M.,0,0,0,0
1668133134833,CSE 224,A01,102378,Porter; George M,0,0,0,0
1668133135257,CSE 229A,A00,102379,Savage; Stefan,0,0,0,0
1668133135688,CSE 229C,A00,102380,Munyaka; Imani N. S.,0,0,0,0
1668133136113,CSE 232B,A00,102382,Deutsch; Alin Bernard,0,0,0,0
1668133136634,CSE 234,A01,112904,Kumar; Arun Kumar,0,0,0,0
1668133137058,CSE 237A,A00,102383,Rosing; Tajana Simunic,0,0,0,0
1668133137483,CSE 239A,A00,102384,Deutsch; Alin Bernard,0,0,0,0
1668133137919,CSE 239B,A00,102385,Polikarpova; Nadezhda,0,0,0,0
1668133138343,CSE 240A,A00,102386,Pannuto; Patrick William,0,0,0,0
1668133138767,CSE 240B,A00,102387,Zhao; Jishen,0,0,0,0
1668133139196,CSE 241A,A00,106406,Kang; Mingu,0,0,0,0
1668133139627,CSE 249B,A00,102388,Kahng; Andrew Byun,0,0,8,8
1668133140069,CSE 251B,A01,102392,Cottrell; Garrison W,0,0,0,0
1668133140069,CSE 251B,A02,102393,Cottrell; Garrison W,0,0,0,0
1668133140496,CSE 252B,A00,102394,Ochoa; Benjamin Lawrence,0,0,0,0
1668133140920,CSE 257,A01,102396,Gao; Sicun,0,0,0,0
1668133141364,CSE 272,A00,102397,Li; Tzumao,0,0,0,0
1668133141792,CSE 274,A00,111323,Chern; Albert Ren-Haur,0,0,0,0
1668133142219,CSE 282,A00,102398,Pevzner; Pavel Arkadjevich,0,0,0,0
1668133142657,CSE 284,A00,114175,Gymrek; Melissa Ann,0,0,0,0
1668133143083,CSE 290,A00,102399,Chandraker; Manmohan Krishna,0,0,0,0
1668133143083,CSE 290,B00,102400,Vaccaro; Kristen Marie,0,0,25,25
1668133143083,CSE 290,C00,102414,Pannuto; Patrick William,0,0,25,25
1668133143083,CSE 290,D00,102427,Pevzner; Pavel Arkadjevich,0,0,0,0
1668133143083,CSE 290,E00,102429,Zhao; Jishen,0,0,0,0
1668133143083,CSE 290,F00,102436,Tullsen; Dean Michael,0,0,0,0
1668133143083,CSE 290,G00,102440,Christensen; Henrik I,0,0,20,20
1668133143512,CSE 291,A00,102443,Su; Hao,0,0,0,0
1668133143512,CSE 291,B00,102448,Polikarpova; Nadezhda,0,0,0,0
1668133143512,CSE 291,C00,102453,Vaccaro; Kristen Marie,0,0,0,0
1668133143512,CSE 291,D00,111343,Savage; Stefan,0,0,0,0
1668133143512,CSE 291,E00,116474,Claffy; Kimberly Claire,0,0,0,0
1668133143512,CSE 291,F00,116479,Pasquale; Joseph,0,0,0,0
1668133143978,CSE 293,001,119111,Bafna; Vineet,9999,0,9999,0
1668133143978,CSE 293,002,119118,Bellare; Mihir,9999,0,9999,0
1668133143978,CSE 293,003,119122,Berg-Kirkpatrick; Taylor D,9999,0,9999,0
1668133143978,CSE 293,004,119135,Christensen; Henrik I,9999,0,9999,0
1668133143978,CSE 293,005,119142,Cottrell; Garrison W,9999,0,9999,0
1668133143978,CSE 293,006,119146,Deutsch; Alin Bernard,9999,0,9999,0
1668133143978,CSE 293,007,119159,Esmaeilzadeh; Hadi,9999,0,9999,0
1668133143978,CSE 293,008,119166,Freund; Yoav,9999,0,9999,0
1668133143978,CSE 293,009,119170,Griswold; William G.,9999,0,9999,0
1668133143978,CSE 293,010,119183,Gymrek; Melissa Ann,9999,0,9999,0
1668133143978,CSE 293,011,119190,Heninger; Nadia A,9999,0,9999,0
1668133143978,CSE 293,012,119230,Impagliazzo; Russell,9999,0,9999,0
1668133143978,CSE 293,013,119232,Jhala; Ranjit,9999,0,9999,0
1668133143978,CSE 293,014,119233,Kahng; Andrew Byun,9999,0,9999,0
1668133143978,CSE 293,015,119298,Kane; Daniel Mertz,9999,0,9999,0
1668133143978,CSE 293,016,119299,Kriegman; David J,9999,0,9999,0
1668133143978,CSE 293,017,119300,Kumar; Arun Kumar,9999,0,9999,0
1668133143978,CSE 293,018,119301,Lerner; Sorin,9999,0,9999,0
1668133143978,CSE 293,019,119302,Lovett; Shachar,9999,0,9999,0
1668133143978,CSE 293,020,119303,McAuley; Julian John,9999,0,9999,0
1668133143978,CSE 293,021,119304,Micciancio; Daniele,9999,0,9999,0
1668133143978,CSE 293,022,119367,Orailoglu; Alex,9999,0,9999,0
1668133143978,CSE 293,023,119382,Paturi; Ramamohan,9999,0,9999,0
1668133143978,CSE 293,024,119404,Polikarpova; Nadezhda,9999,0,9999,0
1668133143978,CSE 293,025,119406,Politz; Joseph Gibbs,9999,0,9999,0
1668133143978,CSE 293,026,119411,Porter; George M,9999,0,9999,0
1668133143978,CSE 293,027,119414,Porter; Leonard Emerson,9999,0,9999,0
1668133143978,CSE 293,028,119416,Ramamoorthi; Ravi,9999,0,9999,0
1668133143978,CSE 293,029,119417,Sahoo; Debashis,9999,0,9999,0
1668133143978,CSE 293,030,119420,Saul; Lawrence,9999,0,9999,0
1668133143978,CSE 293,031,119421,Savage; Stefan,9999,0,9999,0
1668133143978,CSE 293,032,119425,Schulze; Jurgen P.,9999,0,9999,0
1668133143978,CSE 293,033,119426,Snoeren; Alex C.,9999,0,9999,0
1668133143978,CSE 293,034,119428,Shang; Jingbo,9999,0,9999,0
1668133143978,CSE 293,035,119430,Stefan; Deian,9999,0,9999,0
1668133143978,CSE 293,036,119431,Su; Hao,9999,0,9999,0
1668133143978,CSE 293,037,119433,Swanson; Steven James,9999,0,9999,0
1668133143978,CSE 293,038,119435,Tullsen; Dean Michael,9999,0,9999,0
1668133143978,CSE 293,039,119483,Voelker; Geoffrey M.,9999,0,9999,0
1668133143978,CSE 293,040,119537,Zhao; Jishen,9999,0,9999,0
1668133143978,CSE 293,041,119538,Zhou; Yuan-Yuan,9999,0,9999,0
1668133143978,CSE 293,042,119539,Gao; Sicun,9999,0,9999,0
1668133143978,CSE 293,043,119540,Weibel; Nadir,9999,0,9999,0
1668133143978,CSE 293,044,119541,Gupta; Rajesh K.,9999,0,9999,0
1668133143978,CSE 293,045,126410,Vaccaro; Kristen Marie,9999,0,9999,0
1668133143978,CSE 293,046,126411,Klemke; Richard,9999,0,9999,0
1668133144411,CSE 294,A00,102459,Voelker; Geoffrey M.,0,0,0,0
1668133144411,CSE 294,B00,111322,Orailoglu; Alex,0,0,0,0
1668133144834,DSE 201,A00,096914,Deutsch; Alin Bernard,30,0,30,0
1668133145259,DSE 210,A00,096915,Dasgupta; Sanjoy,30,0,30,0
1668133145686,DSE 260A,A00,096916,Altintas De Callaf; Ilkay,30,0,30,0
1668133146131,ECE 200,001,103586,Antipa; Nicholas A,9999,0,9999,0
1668133146131,ECE 200,002,103587,Atanasov; Nikolay A.,9999,0,9999,0
1668133146131,ECE 200,003,103588,Bharadia; Dinesh,9999,0,9999,0
1668133146131,ECE 200,004,103589,Cheng; Chung Kuan,9999,0,9999,0
1668133146131,ECE 200,005,103590,Cosman; Pamela C.,9999,0,9999,0
1668133146131,ECE 200,006,103591,Dayeh; Shadi Ahmad,9999,0,9999,0
1668133146131,ECE 200,007,103592,Fainman; Yeshaiahu,9999,0,9999,0
1668133146131,ECE 200,008,103593,Ford; Joseph Earl,9999,0,9999,0
1668133146131,ECE 200,009,103594,Franceschetti; Massimo,9999,0,9999,0
1668133146131,ECE 200,010,103595,Fullerton; Eric E,9999,0,9999,0
1668133146131,ECE 200,011,103596,Galton; Ian A,9999,0,9999,0
1668133146131,ECE 200,012,103597,Gilja; Vikash,9999,0,9999,0
1668133146131,ECE 200,013,103598,Hall; Drew A.,9999,0,9999,0
1668133146131,ECE 200,014,103599,Hsueh; Tzu-Chien,9999,0,9999,0
1668133146131,ECE 200,015,103600,Javidi; Tara,9999,0,9999,0
1668133146131,ECE 200,016,103601,Kahng; Andrew Byun,9999,0,9999,0
1668133146131,ECE 200,017,103602,Kim; Young-Han,9999,0,9999,0
1668133146131,ECE 200,018,103603,Koushanfar; Farinaz,9999,0,9999,0
1668133146131,ECE 200,019,103604,Kuzum; Duygu,9999,0,9999,0
1668133146131,ECE 200,020,103605,Le; Hanh-Phuc,9999,0,9999,0
1668133146131,ECE 200,021,103606,Lin; Bill,9999,0,9999,0
1668133146131,ECE 200,022,103607,Liu; Zhaowei,9998,0,9999,1
1668133146131,ECE 200,023,103608,Lo; Yu-Hwa,9999,0,9999,0
1668133146131,ECE 200,024,103609,Lomakin; Vitaliy,9999,0,9999,0
1668133146131,ECE 200,025,103610,Mercier; Patrick Philip,9999,0,9999,0
1668133146131,ECE 200,026,103611,Meyer; Florian,9999,0,9999,0
1668133146131,ECE 200,027,103612,Milstein; Laurence B.,9999,0,9999,0
1668133146131,ECE 200,028,103613,Mir Arabbaygi; Siavash,9999,0,9999,0
1668133146131,ECE 200,029,103614,Mookherjea; Shayan,9999,0,9999,0
1668133146131,ECE 200,030,103615,Morris; Karcher William,9999,0,9999,0
1668133146131,ECE 200,031,103616,Ng; Tse Nga,9999,0,9999,0
1668133146131,ECE 200,032,103617,Nguyen; Truong Quang,9999,0,9999,0
1668133146131,ECE 200,033,103618,Nomura; Kenji,9999,0,9999,0
1668133146131,ECE 200,034,103619,Orlitsky; Alon,9999,0,9999,0
1668133146131,ECE 200,035,103620,Pal; Piya,9999,0,9999,0
1668133146131,ECE 200,036,103621,Papen; George C.,9999,0,9999,0
1668133146131,ECE 200,037,103622,Radic; Stojan,9999,0,9999,0
1668133146131,ECE 200,038,103623,Rao; Bhaskar D.,9999,0,9999,0
1668133146131,ECE 200,039,103624,Rao; Ramesh R,9999,0,9999,0
1668133146131,ECE 200,040,103625,Rebeiz; Gabriel,9999,0,9999,0
1668133146131,ECE 200,041,103626,Sanford; John R,9999,0,9999,0
1668133146131,ECE 200,042,103627,Siegel; Paul H.,9999,0,9999,0
1668133146131,ECE 200,043,103628,Sievenpiper; Daniel F.,9999,0,9999,0
1668133146131,ECE 200,044,103629,Sworder; David D.,9999,0,9999,0
1668133146131,ECE 200,045,103630,Taur; Yuan,9999,0,9999,0
1668133146131,ECE 200,046,103631,Touri; Behrouz,9999,0,9999,0
1668133146131,ECE 200,047,103632,Trivedi; Mohan M.,9999,0,9999,0
1668133146131,ECE 200,048,103633,Vasconcelos; Nuno,9999,0,9999,0
1668133146131,ECE 200,049,103634,Wang; Xiaolong,9999,0,9999,0
1668133146131,ECE 200,050,103635,Xie; Pengtao,9999,0,9999,0
1668133146131,ECE 200,051,103636,Yip; Michael,9999,0,9999,0
1668133146131,ECE 200,052,103637,Zeger; Kenneth A.,999,0,999,0
1668133146131,ECE 200,053,103638,Zhang; Xinyu,9999,0,9999,0
1668133146131,ECE 200,054,103639,Turakhia; Yatish Girish,9999,0,9999,0
1668133146131,ECE 200,055,103640,Kang; Mingu,9999,0,9999,0
1668133146131,ECE 200,056,103641,Shi; Yuanyuan,9999,0,9999,0
1668133146131,ECE 200,057,103642,Wang; Edward Jay,9999,0,9999,0
1668133146131,ECE 200,058,103643,Zheng; Yang,9999,0,9999,0
1668133146558,ECE 202,A00,103644,Kuzum; Duygu,0,0,0,0
1668133147014,ECE 212BN,A00,103646,Ng; Tse Nga,0,0,0,0
1668133147437,ECE 221,A00,111493,Staff,0,0,0,0
1668133147865,ECE 222B,A00,103647,Lomakin; Vitaliy,0,0,0,0
1668133148300,ECE 230B,A00,103648,Taur; Yuan,0,0,0,0
1668133148724,ECE 238B,A00,103649,Garay; Javier,0,0,0,0
1668133149161,ECE 240B,A00,112900,Fainman; Yeshaiahu,0,0,0,0
1668133149596,ECE 247A,A00,103650,Jokerst; Jesse Vincent,0,0,0,0
1668133150024,ECE 247B,A00,103651,Wang; Joseph,0,0,0,0
1668133150448,ECE 250,A00,103652,Siegel; Paul H.,0,0,0,0
1668133150875,ECE 251A,A00,103654,Rao; Bhaskar D.,0,0,0,0
1668133151308,ECE 257B,A00,103655,Bharadia; Dinesh,0,0,0,0
1668133151738,ECE 258A,A00,103656,Milstein; Laurence B.,0,0,0,0
1668133152163,ECE 260B,A00,103658,Kang; Mingu,0,0,0,0
1668133152597,ECE 264A,A00,103659,Galton; Ian A,0,0,0,0
1668133153032,ECE 265A,A00,103661,Gudem; Prasad S.S.,0,0,0,0
1668133153457,ECE 265D,A00,103662,Gudem; Prasad S.S.,0,0,0,0
1668133153893,ECE 268,A00,103663,Koushanfar; Farinaz,0,0,0,0
1668133154315,ECE 269,A01,103665,Pal; Piya,0,0,0,0
1668133154741,ECE 271B,A00,103666,Vasconcelos; Manuela,0,0,0,0
1668133155172,ECE 276A,A00,103667,Atanasov; Nikolay A.,0,0,0,0
1668133155594,ECE 277,A00,103668,An; Cheolhong,0,0,0,0
1668133156018,ECE 279,A00,117947,Hall; Drew A.,0,0,0,0
1668133156887,ECE 283,A00,103670,Hsueh; Tzu-Chien,0,0,0,0
1668133157312,ECE 284,A00,103671,Turakhia; Yatish Girish,0,0,0,0
1668133157738,ECE 285,A00,103672,Zheng; Yang,0,0,0,0
1668133157738,ECE 285,B00,103673,Sworder; David D.,0,0,0,0
1668133158162,ECE 287,A00,103676,Javidi; Tara,0,0,0,0
1668133158586,MATH 200B,A00,098023,Salehi Golsefidy; Alireza,12,0,15,3
1668133159021,MATH 202B,A00,098024,Rhoades; Brendon Patrick,9,0,15,6
1668133159447,MATH 203B,A00,098025,Oprea; Dragos N.,10,0,15,5
1668133159873,MATH 204B,A00,098026,Sorensen; Claus M,13,0,15,2
1668133160295,MATH 208,A00,098027,Izadi; Elham,7,0,10,3
1668133160833,MATH 209,A00,098028,Pollack; Aaron,10,0,10,0
1668133161270,MATH 211A,A00,112919,Rogalski; Daniel,9,0,10,1
1668133161691,MATH 211B,A00,112920,Seward; Brandon M.,9,0,10,1
1668133162113,MATH 218,A00,098029,Li; Bo,10,0,10,0
1668133162541,MATH 220B,A00,098030,Novak; Jonathan I,11,0,15,4
1668133162966,MATH 221A,A00,098031,Ebenfelt; Peter F,13,0,15,2
1668133163392,MATH 231B,A00,098032,Zlatos; Andrej,12,0,15,3
1668133163821,MATH 240B,A00,098033,Ni; Lei,9,0,15,6
1668133164253,MATH 243,A00,098034,Jekel; David Andrew,10,0,10,0
1668133164690,MATH 245A,A00,098035,Nie; Jiawang,0,0,15,16
1668133165116,MATH 248,A00,098036,Bejenaru; Ioan,10,0,10,0
1668133165547,MATH 250B,A00,098037,Spolaor; Luca,14,0,15,1
1668133165970,MATH 258,A00,098038,Ni; Lei,10,0,10,0
1668133166396,MATH 264B,A00,098041,Rhoades; Brendon Patrick,9,0,15,6
1668133166825,MATH 268,A00,098042,Buss; Samuel R,10,0,10,0
1668133167256,MATH 269,A00,098043,Rhoades; Brendon Patrick,10,0,10,0
1668133167680,MATH 270B,A00,098044,Li; Bo,10,0,15,5
1668133168120,MATH 272B,A00,098045,Holst; Michael J,13,0,15,2
1668133168558,MATH 273A,A00,098046,Tian; Xiaochuan,10,0,15,5
1668133168995,MATH 275,A01,098048,Tian; Xiaochuan,6,0,10,4
1668133169428,MATH 278A,A00,098049,Holst; Michael J,8,0,10,2
1668133169862,MATH 278B,A00,098050,Cloninger; Alexander,10,0,10,0
1668133170289,MATH 278C,A00,098051,Nie; Jiawang,7,0,10,3
1668133170712,MATH 280B,A00,098052,Zheng; Tianyi,10,0,15,5
1668133171144,MATH 281B,A00,098053,Bradic; Jelena,2,0,15,13
1668133171566,MATH 282B,A00,098054,Arias-Castro; Ery,0,0,15,15
1668133171997,MATH 285,A00,098055,Fitzsimmons; Patrick J,0,0,15,17
1668133172419,MATH 287B,A00,098056,Arias-Castro; Ery,2,0,15,13
1668133172844,MATH 288,A00,098057,Agarwal; Pooja,9,0,10,1
1668133172844,MATH 288,B00,098058,Zhang; Danna,8,0,10,2
1668133172844,MATH 288,C00,098059,Williams; Ruth J,10,0,10,0
1668133173272,MATH 290B,A00,098060,Roberts; Justin Deritter,13,0,15,2
1668133173697,MATH 292,A00,098061,Belmont; Eva Kinoshita,10,0,10,0
1668133174125,MATH 295,A00,098062,Suk; Andrew Hoon,48,0,50,2
1668133174564,MATH 296,A00,098063,Novak; Jonathan I,20,0,20,0
1668133174988,MATH 297,001,098064,Gamst; Anthony Collins,9997,0,9999,2
1668133680289,COGS 205,A00,101395,Chiba; Andrea,19,0,20,1
1668133680715,COGS 210B,001,101404,Greene; Deanna Jacquelyn,9998,0,9999,1
1668133680715,COGS 210B,002,101417,Xia; Haijun,9999,0,9999,0
1668133680715,COGS 210B,003,101422,Nitz; Douglas A.,9999,0,9999,0
1668133680715,COGS 210B,004,101423,Hollan; James D.,9998,0,9999,1
1668133680715,COGS 210B,005,101424,Deak; Gedeon O.,9998,0,9999,1
1668133680715,COGS 210B,006,101425,Rossano; Federico,9999,0,9999,0
1668133681141,COGS 211B,A00,101427,Coulson; Seana M,9996,0,9999,3
1668133681563,COGS 220,A00,101428,Hollan; James D.,0,0,25,25
1668133681988,COGS 229,A00,101429,Dow; Steven P,18,0,25,7
1668133682416,COGS 230,A00,101430,Klemmer; Scott R,12,0,17,5
1668133682839,COGS 234,A00,101431,Xia; Haijun,3,0,25,22
1668133683267,COGS 260,A00,101432,Kiyonaga; Anastasia,20,0,25,5
1668133683267,COGS 260,B00,101433,Kirsh; David Joel,16,0,25,9
1668133683689,CSE 202,A00,102371,Impagliazzo; Russell,0,0,0,0
1668133684129,CSE 203B,A01,102373,Cheng; Chung Kuan,0,0,0,0
1668133684569,CSE 208,A00,102374,Micciancio; Daniele,0,0,0,0
1668133685008,CSE 209A,A00,112895,Impagliazzo; Russell,0,0,15,15
1668133685434,CSE 209B,A00,108005,Bellare; Mihir,0,0,0,0
1668133685863,CSE 210,A00,113163,Coblenz; Michael J,0,0,0,0
1668133686295,CSE 219,A00,106111,Dow; Steven P,0,0,20,20
1668133686729,CSE 221,A00,102376,Voelker; Geoffrey M.,0,0,0,0
1668133687166,CSE 224,A01,102378,Porter; George M,0,0,0,0
1668133687589,CSE 229A,A00,102379,Savage; Stefan,0,0,0,0
1668133688028,CSE 229C,A00,102380,Munyaka; Imani N. S.,0,0,0,0
1668133688470,CSE 232B,A00,102382,Deutsch; Alin Bernard,0,0,0,0
1668133688893,CSE 234,A01,112904,Kumar; Arun Kumar,0,0,0,0
1668133689316,CSE 237A,A00,102383,Rosing; Tajana Simunic,0,0,0,0
1668133689757,CSE 239A,A00,102384,Deutsch; Alin Bernard,0,0,0,0
1668133690202,CSE 239B,A00,102385,Polikarpova; Nadezhda,0,0,0,0
1668133690643,CSE 240A,A00,102386,Pannuto; Patrick William,0,0,0,0
1668133691067,CSE 240B,A00,102387,Zhao; Jishen,0,0,0,0
1668133691508,CSE 241A,A00,106406,Kang; Mingu,0,0,0,0
1668133691932,CSE 249B,A00,102388,Kahng; Andrew Byun,0,0,8,8
1668133692363,CSE 251B,A01,102392,Cottrell; Garrison W,0,0,0,0
1668133692363,CSE 251B,A02,102393,Cottrell; Garrison W,0,0,0,0
1668133692797,CSE 252B,A00,102394,Ochoa; Benjamin Lawrence,0,0,0,0
1668133693219,CSE 257,A01,102396,Gao; Sicun,0,0,0,0
1668133693651,CSE 272,A00,102397,Li; Tzumao,0,0,0,0
1668133694076,CSE 274,A00,111323,Chern; Albert Ren-Haur,0,0,0,0
1668133694523,CSE 282,A00,102398,Pevzner; Pavel Arkadjevich,0,0,0,0
1668133694959,CSE 284,A00,114175,Gymrek; Melissa Ann,0,0,0,0
1668133695391,CSE 290,A00,102399,Chandraker; Manmohan Krishna,0,0,0,0
1668133695391,CSE 290,B00,102400,Vaccaro; Kristen Marie,0,0,25,25
1668133695391,CSE 290,C00,102414,Pannuto; Patrick William,0,0,25,25
1668133695391,CSE 290,D00,102427,Pevzner; Pavel Arkadjevich,0,0,0,0
1668133695391,CSE 290,E00,102429,Zhao; Jishen,0,0,0,0
1668133695391,CSE 290,F00,102436,Tullsen; Dean Michael,0,0,0,0
1668133695391,CSE 290,G00,102440,Christensen; Henrik I,0,0,20,20
1668133695830,CSE 291,A00,102443,Su; Hao,0,0,0,0
1668133695830,CSE 291,B00,102448,Polikarpova; Nadezhda,0,0,0,0
1668133695830,CSE 291,C00,102453,Vaccaro; Kristen Marie,0,0,0,0
1668133695830,CSE 291,D00,111343,Savage; Stefan,0,0,0,0
1668133695830,CSE 291,E00,116474,Claffy; Kimberly Claire,0,0,0,0
1668133695830,CSE 291,F00,116479,Pasquale; Joseph,0,0,0,0
1668133696302,CSE 293,001,119111,Bafna; Vineet,9999,0,9999,0
1668133696302,CSE 293,002,119118,Bellare; Mihir,9999,0,9999,0
1668133696302,CSE 293,003,119122,Berg-Kirkpatrick; Taylor D,9999,0,9999,0
1668133696302,CSE 293,004,119135,Christensen; Henrik I,9999,0,9999,0
1668133696302,CSE 293,005,119142,Cottrell; Garrison W,9999,0,9999,0
1668133696302,CSE 293,006,119146,Deutsch; Alin Bernard,9999,0,9999,0
1668133696302,CSE 293,007,119159,Esmaeilzadeh; Hadi,9999,0,9999,0
1668133696302,CSE 293,008,119166,Freund; Yoav,9999,0,9999,0
1668133696302,CSE 293,009,119170,Griswold; William G.,9999,0,9999,0
1668133696302,CSE 293,010,119183,Gymrek; Melissa Ann,9999,0,9999,0
1668133696302,CSE 293,011,119190,Heninger; Nadia A,9999,0,9999,0
1668133696302,CSE 293,012,119230,Impagliazzo; Russell,9999,0,9999,0
1668133696302,CSE 293,013,119232,Jhala; Ranjit,9999,0,9999,0
1668133696302,CSE 293,014,119233,Kahng; Andrew Byun,9999,0,9999,0
1668133696302,CSE 293,015,119298,Kane; Daniel Mertz,9999,0,9999,0
1668133696302,CSE 293,016,119299,Kriegman; David J,9999,0,9999,0
1668133696302,CSE 293,017,119300,Kumar; Arun Kumar,9999,0,9999,0
1668133696302,CSE 293,018,119301,Lerner; Sorin,9999,0,9999,0
1668133696302,CSE 293,019,119302,Lovett; Shachar,9999,0,9999,0
1668133696302,CSE 293,020,119303,McAuley; Julian John,9999,0,9999,0
1668133696302,CSE 293,021,119304,Micciancio; Daniele,9999,0,9999,0
1668133696302,CSE 293,022,119367,Orailoglu; Alex,9999,0,9999,0
1668133696302,CSE 293,023,119382,Paturi; Ramamohan,9999,0,9999,0
1668133696302,CSE 293,024,119404,Polikarpova; Nadezhda,9999,0,9999,0
1668133696302,CSE 293,025,119406,Politz; Joseph Gibbs,9999,0,9999,0
1668133696302,CSE 293,026,119411,Porter; George M,9999,0,9999,0
1668133696302,CSE 293,027,119414,Porter; Leonard Emerson,9999,0,9999,0
1668133696302,CSE 293,028,119416,Ramamoorthi; Ravi,9999,0,9999,0
1668133696302,CSE 293,029,119417,Sahoo; Debashis,9999,0,9999,0
1668133696302,CSE 293,030,119420,Saul; Lawrence,9999,0,9999,0
1668133696302,CSE 293,031,119421,Savage; Stefan,9999,0,9999,0
1668133696302,CSE 293,032,119425,Schulze; Jurgen P.,9999,0,9999,0
1668133696302,CSE 293,033,119426,Snoeren; Alex C.,9999,0,9999,0
1668133696302,CSE 293,034,119428,Shang; Jingbo,9999,0,9999,0
1668133696302,CSE 293,035,119430,Stefan; Deian,9999,0,9999,0
1668133696302,CSE 293,036,119431,Su; Hao,9999,0,9999,0
1668133696302,CSE 293,037,119433,Swanson; Steven James,9999,0,9999,0
1668133696302,CSE 293,038,119435,Tullsen; Dean Michael,9999,0,9999,0
1668133696302,CSE 293,039,119483,Voelker; Geoffrey M.,9999,0,9999,0
1668133696302,CSE 293,040,119537,Zhao; Jishen,9999,0,9999,0
1668133696302,CSE 293,041,119538,Zhou; Yuan-Yuan,9999,0,9999,0
1668133696302,CSE 293,042,119539,Gao; Sicun,9999,0,9999,0
1668133696302,CSE 293,043,119540,Weibel; Nadir,9999,0,9999,0
1668133696302,CSE 293,044,119541,Gupta; Rajesh K.,9999,0,9999,0
1668133696302,CSE 293,045,126410,Vaccaro; Kristen Marie,9999,0,9999,0
1668133696302,CSE 293,046,126411,Klemke; Richard,9999,0,9999,0
1668133696724,CSE 294,A00,102459,Voelker; Geoffrey M.,0,0,0,0
1668133696724,CSE 294,B00,111322,Orailoglu; Alex,0,0,0,0
1668133697156,DSE 201,A00,096914,Deutsch; Alin Bernard,30,0,30,0
1668133697582,DSE 210,A00,096915,Dasgupta; Sanjoy,30,0,30,0
1668133698005,DSE 260A,A00,096916,Altintas De Callaf; Ilkay,30,0,30,0
1668133698451,ECE 200,001,103586,Antipa; Nicholas A,9999,0,9999,0
1668133698451,ECE 200,002,103587,Atanasov; Nikolay A.,9999,0,9999,0
1668133698451,ECE 200,003,103588,Bharadia; Dinesh,9999,0,9999,0
1668133698451,ECE 200,004,103589,Cheng; Chung Kuan,9999,0,9999,0
1668133698451,ECE 200,005,103590,Cosman; Pamela C.,9999,0,9999,0
1668133698451,ECE 200,006,103591,Dayeh; Shadi Ahmad,9999,0,9999,0
1668133698451,ECE 200,007,103592,Fainman; Yeshaiahu,9999,0,9999,0
1668133698451,ECE 200,008,103593,Ford; Joseph Earl,9999,0,9999,0
1668133698451,ECE 200,009,103594,Franceschetti; Massimo,9999,0,9999,0
1668133698451,ECE 200,010,103595,Fullerton; Eric E,9999,0,9999,0
1668133698451,ECE 200,011,103596,Galton; Ian A,9999,0,9999,0
1668133698451,ECE 200,012,103597,Gilja; Vikash,9999,0,9999,0
1668133698451,ECE 200,013,103598,Hall; Drew A.,9999,0,9999,0
1668133698451,ECE 200,014,103599,Hsueh; Tzu-Chien,9999,0,9999,0
1668133698451,ECE 200,015,103600,Javidi; Tara,9999,0,9999,0
1668133698451,ECE 200,016,103601,Kahng; Andrew Byun,9999,0,9999,0
1668133698451,ECE 200,017,103602,Kim; Young-Han,9999,0,9999,0
1668133698451,ECE 200,018,103603,Koushanfar; Farinaz,9999,0,9999,0
1668133698451,ECE 200,019,103604,Kuzum; Duygu,9999,0,9999,0
1668133698451,ECE 200,020,103605,Le; Hanh-Phuc,9999,0,9999,0
1668133698451,ECE 200,021,103606,Lin; Bill,9999,0,9999,0
1668133698451,ECE 200,022,103607,Liu; Zhaowei,9998,0,9999,1
1668133698451,ECE 200,023,103608,Lo; Yu-Hwa,9999,0,9999,0
1668133698451,ECE 200,024,103609,Lomakin; Vitaliy,9999,0,9999,0
1668133698451,ECE 200,025,103610,Mercier; Patrick Philip,9999,0,9999,0
1668133698451,ECE 200,026,103611,Meyer; Florian,9999,0,9999,0
1668133698451,ECE 200,027,103612,Milstein; Laurence B.,9999,0,9999,0
1668133698451,ECE 200,028,103613,Mir Arabbaygi; Siavash,9999,0,9999,0
1668133698451,ECE 200,029,103614,Mookherjea; Shayan,9999,0,9999,0
1668133698451,ECE 200,030,103615,Morris; Karcher William,9999,0,9999,0
1668133698451,ECE 200,031,103616,Ng; Tse Nga,9999,0,9999,0
1668133698451,ECE 200,032,103617,Nguyen; Truong Quang,9999,0,9999,0
1668133698451,ECE 200,033,103618,Nomura; Kenji,9999,0,9999,0
1668133698451,ECE 200,034,103619,Orlitsky; Alon,9999,0,9999,0
1668133698451,ECE 200,035,103620,Pal; Piya,9999,0,9999,0
1668133698451,ECE 200,036,103621,Papen; George C.,9999,0,9999,0
1668133698451,ECE 200,037,103622,Radic; Stojan,9999,0,9999,0
1668133698451,ECE 200,038,103623,Rao; Bhaskar D.,9999,0,9999,0
1668133698451,ECE 200,039,103624,Rao; Ramesh R,9999,0,9999,0
1668133698451,ECE 200,040,103625,Rebeiz; Gabriel,9999,0,9999,0
1668133698451,ECE 200,041,103626,Sanford; John R,9999,0,9999,0
1668133698451,ECE 200,042,103627,Siegel; Paul H.,9999,0,9999,0
1668133698451,ECE 200,043,103628,Sievenpiper; Daniel F.,9999,0,9999,0
1668133698451,ECE 200,044,103629,Sworder; David D.,9999,0,9999,0
1668133698451,ECE 200,045,103630,Taur; Yuan,9999,0,9999,0
1668133698451,ECE 200,046,103631,Touri; Behrouz,9999,0,9999,0
1668133698451,ECE 200,047,103632,Trivedi; Mohan M.,9999,0,9999,0
1668133698451,ECE 200,048,103633,Vasconcelos; Nuno,9999,0,9999,0
1668133698451,ECE 200,049,103634,Wang; Xiaolong,9999,0,9999,0
1668133698451,ECE 200,050,103635,Xie; Pengtao,9999,0,9999,0
1668133698451,ECE 200,051,103636,Yip; Michael,9999,0,9999,0
1668133698451,ECE 200,052,103637,Zeger; Kenneth A.,999,0,999,0
1668133698451,ECE 200,053,103638,Zhang; Xinyu,9999,0,9999,0
1668133698451,ECE 200,054,103639,Turakhia; Yatish Girish,9999,0,9999,0
1668133698451,ECE 200,055,103640,Kang; Mingu,9999,0,9999,0
1668133698451,ECE 200,056,103641,Shi; Yuanyuan,9999,0,9999,0
1668133698451,ECE 200,057,103642,Wang; Edward Jay,9999,0,9999,0
1668133698451,ECE 200,058,103643,Zheng; Yang,9999,0,9999,0
1668133698877,ECE 202,A00,103644,Kuzum; Duygu,0,0,0,0
1668133699305,ECE 212BN,A00,103646,Ng; Tse Nga,0,0,0,0
1668133699732,ECE 221,A00,111493,Staff,0,0,0,0
1668133700159,ECE 222B,A00,103647,Lomakin; Vitaliy,0,0,0,0
1668133700596,ECE 230B,A00,103648,Taur; Yuan,0,0,0,0
1668133701019,ECE 238B,A00,103649,Garay; Javier,0,0,0,0
1668133701445,ECE 240B,A00,112900,Fainman; Yeshaiahu,0,0,0,0
1668133701871,ECE 247A,A00,103650,Jokerst; Jesse Vincent,0,0,0,0
1668133702309,ECE 247B,A00,103651,Wang; Joseph,0,0,0,0
1668133702731,ECE 250,A00,103652,Siegel; Paul H.,0,0,0,0
1668133703155,ECE 251A,A00,103654,Rao; Bhaskar D.,0,0,0,0
1668133703579,ECE 257B,A00,103655,Bharadia; Dinesh,0,0,0,0
1668133704012,ECE 258A,A00,103656,Milstein; Laurence B.,0,0,0,0
1668133704472,ECE 260B,A00,103658,Kang; Mingu,0,0,0,0
1668133704900,ECE 264A,A00,103659,Galton; Ian A,0,0,0,0
1668133705337,ECE 265A,A00,103661,Gudem; Prasad S.S.,0,0,0,0
1668133705856,ECE 265D,A00,103662,Gudem; Prasad S.S.,0,0,0,0
1668133706280,ECE 268,A00,103663,Koushanfar; Farinaz,0,0,0,0
1668133706710,ECE 269,A01,103665,Pal; Piya,0,0,0,0
1668133707135,ECE 271B,A00,103666,Vasconcelos; Manuela,0,0,0,0
1668133707561,ECE 276A,A00,103667,Atanasov; Nikolay A.,0,0,0,0
1668133707995,ECE 277,A00,103668,An; Cheolhong,0,0,0,0
1668133708420,ECE 279,A00,117947,Hall; Drew A.,0,0,0,0
1668133709279,ECE 283,A00,103670,Hsueh; Tzu-Chien,0,0,0,0
1668133709711,ECE 284,A00,103671,Turakhia; Yatish Girish,0,0,0,0
1668133710148,ECE 285,A00,103672,Zheng; Yang,0,0,0,0
1668133710148,ECE 285,B00,103673,Sworder; David D.,0,0,0,0
1668133710576,ECE 287,A00,103676,Javidi; Tara,0,0,0,0
1668133711002,MATH 200B,A00,098023,Salehi Golsefidy; Alireza,12,0,15,3
1668133711426,MATH 202B,A00,098024,Rhoades; Brendon Patrick,9,0,15,6
1668133711850,MATH 203B,A00,098025,Oprea; Dragos N.,10,0,15,5
1668133712277,MATH 204B,A00,098026,Sorensen; Claus M,13,0,15,2
1668133712710,MATH 208,A00,098027,Izadi; Elham,7,0,10,3
1668133713135,MATH 209,A00,098028,Pollack; Aaron,10,0,10,0
1668133713560,MATH 211A,A00,112919,Rogalski; Daniel,9,0,10,1
1668133713989,MATH 211B,A00,112920,Seward; Brandon M.,9,0,10,1
1668133714413,MATH 218,A00,098029,Li; Bo,10,0,10,0
1668133714846,MATH 220B,A00,098030,Novak; Jonathan I,11,0,15,4
1668133715274,MATH 221A,A00,098031,Ebenfelt; Peter F,13,0,15,2
1668133715704,MATH 231B,A00,098032,Zlatos; Andrej,12,0,15,3
1668133716134,MATH 240B,A00,098033,Ni; Lei,9,0,15,6
1668133716561,MATH 243,A00,098034,Jekel; David Andrew,10,0,10,0
1668133716991,MATH 245A,A00,098035,Nie; Jiawang,0,0,15,16
1668133717432,MATH 248,A00,098036,Bejenaru; Ioan,10,0,10,0
1668133717866,MATH 250B,A00,098037,Spolaor; Luca,14,0,15,1
1668133718292,MATH 258,A00,098038,Ni; Lei,10,0,10,0
1668133718722,MATH 264B,A00,098041,Rhoades; Brendon Patrick,9,0,15,6
1668133719161,MATH 268,A00,098042,Buss; Samuel R,10,0,10,0
1668133719590,MATH 269,A00,098043,Rhoades; Brendon Patrick,10,0,10,0
1668133720015,MATH 270B,A00,098044,Li; Bo,10,0,15,5
1668133720439,MATH 272B,A00,098045,Holst; Michael J,13,0,15,2
1668133720868,MATH 273A,A00,098046,Tian; Xiaochuan,10,0,15,5
1668133721305,MATH 275,A01,098048,Tian; Xiaochuan,6,0,10,4
1668133721732,MATH 278A,A00,098049,Holst; Michael J,8,0,10,2
1668133722163,MATH 278B,A00,098050,Cloninger; Alexander,10,0,10,0
1668133722585,MATH 278C,A00,098051,Nie; Jiawang,7,0,10,3
1668133723027,MATH 280B,A00,098052,Zheng; Tianyi,10,0,15,5
1668133723454,MATH 281B,A00,098053,Bradic; Jelena,2,0,15,13
1668133723883,MATH 282B,A00,098054,Arias-Castro; Ery,0,0,15,15
1668133724318,MATH 285,A00,098055,Fitzsimmons; Patrick J,0,0,15,17
1668133724752,MATH 287B,A00,098056,Arias-Castro; Ery,2,0,15,13
1668133725176,MATH 288,A00,098057,Agarwal; Pooja,9,0,10,1
1668133725176,MATH 288,B00,098058,Zhang; Danna,8,0,10,2
1668133725176,MATH 288,C00,098059,Williams; Ruth J,10,0,10,0
1668133725600,MATH 290B,A00,098060,Roberts; Justin Deritter,13,0,15,2
1668133726024,MATH 292,A00,098061,Belmont; Eva Kinoshita,10,0,10,0
1668133726457,MATH 295,A00,098062,Suk; Andrew Hoon,48,0,50,2
1668133726883,MATH 296,A00,098063,Novak; Jonathan I,20,0,20,0
1668133727310,MATH 297,001,098064,Gamst; Anthony Collins,9997,0,9999,2
1668134232215,COGS 205,A00,101395,Chiba; Andrea,19,0,20,1
1668134232637,COGS 210B,001,101404,Greene; Deanna Jacquelyn,9998,0,9999,1
1668134232637,COGS 210B,002,101417,Xia; Haijun,9999,0,9999,0
1668134232637,COGS 210B,003,101422,Nitz; Douglas A.,9999,0,9999,0
1668134232637,COGS 210B,004,101423,Hollan; James D.,9998,0,9999,1
1668134232637,COGS 210B,005,101424,Deak; Gedeon O.,9998,0,9999,1
1668134232637,COGS 210B,006,101425,Rossano; Federico,9999,0,9999,0
1668134233064,COGS 211B,A00,101427,Coulson; Seana M,9996,0,9999,3
1668134233488,COGS 220,A00,101428,Hollan; James D.,0,0,25,25
1668134233911,COGS 229,A00,101429,Dow; Steven P,18,0,25,7
1668134234344,COGS 230,A00,101430,Klemmer; Scott R,12,0,17,5
1668134234778,COGS 234,A00,101431,Xia; Haijun,3,0,25,22
1668134235209,COGS 260,A00,101432,Kiyonaga; Anastasia,20,0,25,5
1668134235209,COGS 260,B00,101433,Kirsh; David Joel,16,0,25,9
1668134235635,CSE 202,A00,102371,Impagliazzo; Russell,0,0,0,0
1668134236058,CSE 203B,A01,102373,Cheng; Chung Kuan,0,0,0,0
1668134236481,CSE 208,A00,102374,Micciancio; Daniele,0,0,0,0
1668134236913,CSE 209A,A00,112895,Impagliazzo; Russell,0,0,15,15
1668134237348,CSE 209B,A00,108005,Bellare; Mihir,0,0,0,0
1668134237782,CSE 210,A00,113163,Coblenz; Michael J,0,0,0,0
1668134238207,CSE 219,A00,106111,Dow; Steven P,0,0,20,20
1668134238637,CSE 221,A00,102376,Voelker; Geoffrey M.,0,0,0,0
1668134239061,CSE 224,A01,102378,Porter; George M,0,0,0,0
1668134239488,CSE 229A,A00,102379,Savage; Stefan,0,0,0,0
1668134239915,CSE 229C,A00,102380,Munyaka; Imani N. S.,0,0,0,0
1668134240341,CSE 232B,A00,102382,Deutsch; Alin Bernard,0,0,0,0
1668134240769,CSE 234,A01,112904,Kumar; Arun Kumar,0,0,0,0
1668134241197,CSE 237A,A00,102383,Rosing; Tajana Simunic,0,0,0,0
1668134241622,CSE 239A,A00,102384,Deutsch; Alin Bernard,0,0,0,0
1668134242046,CSE 239B,A00,102385,Polikarpova; Nadezhda,0,0,0,0
1668134242472,CSE 240A,A00,102386,Pannuto; Patrick William,0,0,0,0
1668134242898,CSE 240B,A00,102387,Zhao; Jishen,0,0,0,0
1668134243322,CSE 241A,A00,106406,Kang; Mingu,0,0,0,0
1668134243754,CSE 249B,A00,102388,Kahng; Andrew Byun,0,0,8,8
1668134244178,CSE 251B,A01,102392,Cottrell; Garrison W,0,0,0,0
1668134244178,CSE 251B,A02,102393,Cottrell; Garrison W,0,0,0,0
1668134244618,CSE 252B,A00,102394,Ochoa; Benjamin Lawrence,0,0,0,0
1668134245045,CSE 257,A01,102396,Gao; Sicun,0,0,0,0
1668134245468,CSE 272,A00,102397,Li; Tzumao,0,0,0,0
1668134245894,CSE 274,A00,111323,Chern; Albert Ren-Haur,0,0,0,0
1668134246318,CSE 282,A00,102398,Pevzner; Pavel Arkadjevich,0,0,0,0
1668134246746,CSE 284,A00,114175,Gymrek; Melissa Ann,0,0,0,0
1668134247170,CSE 290,A00,102399,Chandraker; Manmohan Krishna,0,0,0,0
1668134247170,CSE 290,B00,102400,Vaccaro; Kristen Marie,0,0,25,25
1668134247170,CSE 290,C00,102414,Pannuto; Patrick William,0,0,25,25
1668134247170,CSE 290,D00,102427,Pevzner; Pavel Arkadjevich,0,0,0,0
1668134247170,CSE 290,E00,102429,Zhao; Jishen,0,0,0,0
1668134247170,CSE 290,F00,102436,Tullsen; Dean Michael,0,0,0,0
1668134247170,CSE 290,G00,102440,Christensen; Henrik I,0,0,20,20
1668134247600,CSE 291,A00,102443,Su; Hao,0,0,0,0
1668134247600,CSE 291,B00,102448,Polikarpova; Nadezhda,0,0,0,0
1668134247600,CSE 291,C00,102453,Vaccaro; Kristen Marie,0,0,0,0
1668134247600,CSE 291,D00,111343,Savage; Stefan,0,0,0,0
1668134247600,CSE 291,E00,116474,Claffy; Kimberly Claire,0,0,0,0
1668134247600,CSE 291,F00,116479,Pasquale; Joseph,0,0,0,0
1668134248046,CSE 293,001,119111,Bafna; Vineet,9999,0,9999,0
1668134248046,CSE 293,002,119118,Bellare; Mihir,9999,0,9999,0
1668134248046,CSE 293,003,119122,Berg-Kirkpatrick; Taylor D,9999,0,9999,0
1668134248046,CSE 293,004,119135,Christensen; Henrik I,9999,0,9999,0
1668134248046,CSE 293,005,119142,Cottrell; Garrison W,9999,0,9999,0
1668134248046,CSE 293,006,119146,Deutsch; Alin Bernard,9999,0,9999,0
1668134248046,CSE 293,007,119159,Esmaeilzadeh; Hadi,9999,0,9999,0
1668134248046,CSE 293,008,119166,Freund; Yoav,9999,0,9999,0
1668134248046,CSE 293,009,119170,Griswold; William G.,9999,0,9999,0
1668134248046,CSE 293,010,119183,Gymrek; Melissa Ann,9999,0,9999,0
1668134248046,CSE 293,011,119190,Heninger; Nadia A,9999,0,9999,0
1668134248046,CSE 293,012,119230,Impagliazzo; Russell,9999,0,9999,0
1668134248046,CSE 293,013,119232,Jhala; Ranjit,9999,0,9999,0
1668134248046,CSE 293,014,119233,Kahng; Andrew Byun,9999,0,9999,0
1668134248046,CSE 293,015,119298,Kane; Daniel Mertz,9999,0,9999,0
1668134248046,CSE 293,016,119299,Kriegman; David J,9999,0,9999,0
1668134248046,CSE 293,017,119300,Kumar; Arun Kumar,9999,0,9999,0
1668134248046,CSE 293,018,119301,Lerner; Sorin,9999,0,9999,0
1668134248046,CSE 293,019,119302,Lovett; Shachar,9999,0,9999,0
1668134248046,CSE 293,020,119303,McAuley; Julian John,9999,0,9999,0
1668134248046,CSE 293,021,119304,Micciancio; Daniele,9999,0,9999,0
1668134248046,CSE 293,022,119367,Orailoglu; Alex,9999,0,9999,0
1668134248046,CSE 293,023,119382,Paturi; Ramamohan,9999,0,9999,0
1668134248046,CSE 293,024,119404,Polikarpova; Nadezhda,9999,0,9999,0
1668134248046,CSE 293,025,119406,Politz; Joseph Gibbs,9999,0,9999,0
1668134248046,CSE 293,026,119411,Porter; George M,9999,0,9999,0
1668134248046,CSE 293,027,119414,Porter; Leonard Emerson,9999,0,9999,0
1668134248046,CSE 293,028,119416,Ramamoorthi; Ravi,9999,0,9999,0
1668134248046,CSE 293,029,119417,Sahoo; Debashis,9999,0,9999,0
1668134248046,CSE 293,030,119420,Saul; Lawrence,9999,0,9999,0
1668134248046,CSE 293,031,119421,Savage; Stefan,9999,0,9999,0
1668134248046,CSE 293,032,119425,Schulze; Jurgen P.,9999,0,9999,0
1668134248046,CSE 293,033,119426,Snoeren; Alex C.,9999,0,9999,0
1668134248046,CSE 293,034,119428,Shang; Jingbo,9999,0,9999,0
1668134248046,CSE 293,035,119430,Stefan; Deian,9999,0,9999,0
1668134248046,CSE 293,036,119431,Su; Hao,9999,0,9999,0
1668134248046,CSE 293,037,119433,Swanson; Steven James,9999,0,9999,0
1668134248046,CSE 293,038,119435,Tullsen; Dean Michael,9999,0,9999,0
1668134248046,CSE 293,039,119483,Voelker; Geoffrey M.,9999,0,9999,0
1668134248046,CSE 293,040,119537,Zhao; Jishen,9999,0,9999,0
1668134248046,CSE 293,041,119538,Zhou; Yuan-Yuan,9999,0,9999,0
1668134248046,CSE 293,042,119539,Gao; Sicun,9999,0,9999,0
1668134248046,CSE 293,043,119540,Weibel; Nadir,9999,0,9999,0
1668134248046,CSE 293,044,119541,Gupta; Rajesh K.,9999,0,9999,0
1668134248046,CSE 293,045,126410,Vaccaro; Kristen Marie,9999,0,9999,0
1668134248046,CSE 293,046,126411,Klemke; Richard,9999,0,9999,0
1668134248482,CSE 294,A00,102459,Voelker; Geoffrey M.,0,0,0,0
1668134248482,CSE 294,B00,111322,Orailoglu; Alex,0,0,0,0
1668134248914,DSE 201,A00,096914,Deutsch; Alin Bernard,30,0,30,0
1668134249341,DSE 210,A00,096915,Dasgupta; Sanjoy,30,0,30,0
1668134249769,DSE 260A,A00,096916,Altintas De Callaf; Ilkay,30,0,30,0
1668134250261,ECE 200,001,103586,Antipa; Nicholas A,9999,0,9999,0
1668134250261,ECE 200,002,103587,Atanasov; Nikolay A.,9999,0,9999,0
1668134250261,ECE 200,003,103588,Bharadia; Dinesh,9999,0,9999,0
1668134250261,ECE 200,004,103589,Cheng; Chung Kuan,9999,0,9999,0
1668134250261,ECE 200,005,103590,Cosman; Pamela C.,9999,0,9999,0
1668134250261,ECE 200,006,103591,Dayeh; Shadi Ahmad,9999,0,9999,0
1668134250261,ECE 200,007,103592,Fainman; Yeshaiahu,9999,0,9999,0
1668134250261,ECE 200,008,103593,Ford; Joseph Earl,9999,0,9999,0
1668134250261,ECE 200,009,103594,Franceschetti; Massimo,9999,0,9999,0
1668134250261,ECE 200,010,103595,Fullerton; Eric E,9999,0,9999,0
1668134250261,ECE 200,011,103596,Galton; Ian A,9999,0,9999,0
1668134250261,ECE 200,012,103597,Gilja; Vikash,9999,0,9999,0
1668134250261,ECE 200,013,103598,Hall; Drew A.,9999,0,9999,0
1668134250261,ECE 200,014,103599,Hsueh; Tzu-Chien,9999,0,9999,0
1668134250261,ECE 200,015,103600,Javidi; Tara,9999,0,9999,0
1668134250261,ECE 200,016,103601,Kahng; Andrew Byun,9999,0,9999,0
1668134250261,ECE 200,017,103602,Kim; Young-Han,9999,0,9999,0
1668134250261,ECE 200,018,103603,Koushanfar; Farinaz,9999,0,9999,0
1668134250261,ECE 200,019,103604,Kuzum; Duygu,9999,0,9999,0
1668134250261,ECE 200,020,103605,Le; Hanh-Phuc,9999,0,9999,0
1668134250261,ECE 200,021,103606,Lin; Bill,9999,0,9999,0
1668134250261,ECE 200,022,103607,Liu; Zhaowei,9998,0,9999,1
1668134250261,ECE 200,023,103608,Lo; Yu-Hwa,9999,0,9999,0
1668134250261,ECE 200,024,103609,Lomakin; Vitaliy,9999,0,9999,0
1668134250261,ECE 200,025,103610,Mercier; Patrick Philip,9999,0,9999,0
1668134250261,ECE 200,026,103611,Meyer; Florian,9999,0,9999,0
1668134250261,ECE 200,027,103612,Milstein; Laurence B.,9999,0,9999,0
1668134250261,ECE 200,028,103613,Mir Arabbaygi; Siavash,9999,0,9999,0
1668134250261,ECE 200,029,103614,Mookherjea; Shayan,9999,0,9999,0
1668134250261,ECE 200,030,103615,Morris; Karcher William,9999,0,9999,0
1668134250261,ECE 200,031,103616,Ng; Tse Nga,9999,0,9999,0
1668134250261,ECE 200,032,103617,Nguyen; Truong Quang,9999,0,9999,0
1668134250261,ECE 200,033,103618,Nomura; Kenji,9999,0,9999,0
1668134250261,ECE 200,034,103619,Orlitsky; Alon,9999,0,9999,0
1668134250261,ECE 200,035,103620,Pal; Piya,9999,0,9999,0
1668134250261,ECE 200,036,103621,Papen; George C.,9999,0,9999,0
1668134250261,ECE 200,037,103622,Radic; Stojan,9999,0,9999,0
1668134250261,ECE 200,038,103623,Rao; Bhaskar D.,9999,0,9999,0
1668134250261,ECE 200,039,103624,Rao; Ramesh R,9999,0,9999,0
1668134250261,ECE 200,040,103625,Rebeiz; Gabriel,9999,0,9999,0
1668134250261,ECE 200,041,103626,Sanford; John R,9999,0,9999,0
1668134250261,ECE 200,042,103627,Siegel; Paul H.,9999,0,9999,0
1668134250261,ECE 200,043,103628,Sievenpiper; Daniel F.,9999,0,9999,0
1668134250261,ECE 200,044,103629,Sworder; David D.,9999,0,9999,0
1668134250261,ECE 200,045,103630,Taur; Yuan,9999,0,9999,0
1668134250261,ECE 200,046,103631,Touri; Behrouz,9999,0,9999,0
1668134250261,ECE 200,047,103632,Trivedi; Mohan M.,9999,0,9999,0
1668134250261,ECE 200,048,103633,Vasconcelos; Nuno,9999,0,9999,0
1668134250261,ECE 200,049,103634,Wang; Xiaolong,9999,0,9999,0
1668134250261,ECE 200,050,103635,Xie; Pengtao,9999,0,9999,0
1668134250261,ECE 200,051,103636,Yip; Michael,9999,0,9999,0
1668134250261,ECE 200,052,103637,Zeger; Kenneth A.,999,0,999,0
1668134250261,ECE 200,053,103638,Zhang; Xinyu,9999,0,9999,0
1668134250261,ECE 200,054,103639,Turakhia; Yatish Girish,9999,0,9999,0
1668134250261,ECE 200,055,103640,Kang; Mingu,9999,0,9999,0
1668134250261,ECE 200,056,103641,Shi; Yuanyuan,9999,0,9999,0
1668134250261,ECE 200,057,103642,Wang; Edward Jay,9999,0,9999,0
1668134250261,ECE 200,058,103643,Zheng; Yang,9999,0,9999,0
1668134250687,ECE 202,A00,103644,Kuzum; Duygu,0,0,0,0
1668134251112,ECE 212BN,A00,103646,Ng; Tse Nga,0,0,0,0
1668134251547,ECE 221,A00,111493,Staff,0,0,0,0
1668134251982,ECE 222B,A00,103647,Lomakin; Vitaliy,0,0,0,0
1668134252413,ECE 230B,A00,103648,Taur; Yuan,0,0,0,0
1668134252836,ECE 238B,A00,103649,Garay; Javier,0,0,0,0
1668134253270,ECE 240B,A00,112900,Fainman; Yeshaiahu,0,0,0,0
1668134253693,ECE 247A,A00,103650,Jokerst; Jesse Vincent,0,0,0,0
1668134254118,ECE 247B,A00,103651,Wang; Joseph,0,0,0,0
1668134254542,ECE 250,A00,103652,Siegel; Paul H.,0,0,0,0
1668134254970,ECE 251A,A00,103654,Rao; Bhaskar D.,0,0,0,0
1668134255395,ECE 257B,A00,103655,Bharadia; Dinesh,0,0,0,0
1668134255820,ECE 258A,A00,103656,Milstein; Laurence B.,0,0,0,0
1668134256250,ECE 260B,A00,103658,Kang; Mingu,0,0,0,0
1668134256677,ECE 264A,A00,103659,Galton; Ian A,0,0,0,0
1668134257101,ECE 265A,A00,103661,Gudem; Prasad S.S.,0,0,0,0
1668134257537,ECE 265D,A00,103662,Gudem; Prasad S.S.,0,0,0,0
1668134257960,ECE 268,A00,103663,Koushanfar; Farinaz,0,0,0,0
1668134258382,ECE 269,A01,103665,Pal; Piya,0,0,0,0
1668134258806,ECE 271B,A00,103666,Vasconcelos; Manuela,0,0,0,0
1668134259242,ECE 276A,A00,103667,Atanasov; Nikolay A.,0,0,0,0
1668134259666,ECE 277,A00,103668,An; Cheolhong,0,0,0,0
1668134260091,ECE 279,A00,117947,Hall; Drew A.,0,0,0,0
1668134260955,ECE 283,A00,103670,Hsueh; Tzu-Chien,0,0,0,0
1668134261379,ECE 284,A00,103671,Turakhia; Yatish Girish,0,0,0,0
1668134261818,ECE 285,A00,103672,Zheng; Yang,0,0,0,0
1668134261818,ECE 285,B00,103673,Sworder; David D.,0,0,0,0
1668134262249,ECE 287,A00,103676,Javidi; Tara,0,0,0,0
1668134262673,MATH 200B,A00,098023,Salehi Golsefidy; Alireza,12,0,15,3
1668134263100,MATH 202B,A00,098024,Rhoades; Brendon Patrick,9,0,15,6
1668134263537,MATH 203B,A00,098025,Oprea; Dragos N.,10,0,15,5
1668134263960,MATH 204B,A00,098026,Sorensen; Claus M,13,0,15,2
1668134264391,MATH 208,A00,098027,Izadi; Elham,7,0,10,3
1668134264817,MATH 209,A00,098028,Pollack; Aaron,10,0,10,0
1668134265247,MATH 211A,A00,112919,Rogalski; Daniel,9,0,10,1
1668134265676,MATH 211B,A00,112920,Seward; Brandon M.,9,0,10,1
1668134266099,MATH 218,A00,098029,Li; Bo,10,0,10,0
1668134266523,MATH 220B,A00,098030,Novak; Jonathan I,11,0,15,4
1668134266952,MATH 221A,A00,098031,Ebenfelt; Peter F,13,0,15,2
1668134267385,MATH 231B,A00,098032,Zlatos; Andrej,12,0,15,3
1668134267814,MATH 240B,A00,098033,Ni; Lei,9,0,15,6
1668134268238,MATH 243,A00,098034,Jekel; David Andrew,10,0,10,0
1668134268664,MATH 245A,A00,098035,Nie; Jiawang,0,0,15,16
1668134269093,MATH 248,A00,098036,Bejenaru; Ioan,10,0,10,0
1668134269525,MATH 250B,A00,098037,Spolaor; Luca,14,0,15,1
1668134269949,MATH 258,A00,098038,Ni; Lei,10,0,10,0
1668134270387,MATH 264B,A00,098041,Rhoades; Brendon Patrick,9,0,15,6
1668134270820,MATH 268,A00,098042,Buss; Samuel R,10,0,10,0
1668134271245,MATH 269,A00,098043,Rhoades; Brendon Patrick,10,0,10,0
1668134271670,MATH 270B,A00,098044,Li; Bo,10,0,15,5
1668134272102,MATH 272B,A00,098045,Holst; Michael J,13,0,15,2
1668134272536,MATH 273A,A00,098046,Tian; Xiaochuan,10,0,15,5
1668134272962,MATH 275,A01,098048,Tian; Xiaochuan,6,0,10,4
1668134273388,MATH 278A,A00,098049,Holst; Michael J,8,0,10,2
1668134273812,MATH 278B,A00,098050,Cloninger; Alexander,10,0,10,0
1668134274338,MATH 278C,A00,098051,Nie; Jiawang,7,0,10,3
1668134274775,MATH 280B,A00,098052,Zheng; Tianyi,10,0,15,5
1668134275201,MATH 281B,A00,098053,Bradic; Jelena,2,0,15,13
1668134275625,MATH 282B,A00,098054,Arias-Castro; Ery,0,0,15,15
1668134276048,MATH 285,A00,098055,Fitzsimmons; Patrick J,0,0,15,17
1668134276473,MATH 287B,A00,098056,Arias-Castro; Ery,2,0,15,13
1668134276910,MATH 288,A00,098057,Agarwal; Pooja,9,0,10,1
1668134276910,MATH 288,B00,098058,Zhang; Danna,8,0,10,2
1668134276910,MATH 288,C00,098059,Williams; Ruth J,10,0,10,0
1668134277336,MATH 290B,A00,098060,Roberts; Justin Deritter,13,0,15,2
1668134277763,MATH 292,A00,098061,Belmont; Eva Kinoshita,10,0,10,0
1668134278210,MATH 295,A00,098062,Suk; Andrew Hoon,48,0,50,2
1668134278643,MATH 296,A00,098063,Novak; Jonathan I,20,0,20,0
1668134279068,MATH 297,001,098064,Gamst; Anthony Collins,9997,0,9999,2
1668134782977,COGS 205,A00,101395,Chiba; Andrea,19,0,20,1
1668134783416,COGS 210B,001,101404,Greene; Deanna Jacquelyn,9998,0,9999,1
1668134783416,COGS 210B,002,101417,Xia; Haijun,9999,0,9999,0
1668134783416,COGS 210B,003,101422,Nitz; Douglas A.,9999,0,9999,0
1668134783416,COGS 210B,004,101423,Hollan; James D.,9998,0,9999,1
1668134783416,COGS 210B,005,101424,Deak; Gedeon O.,9998,0,9999,1
1668134783416,COGS 210B,006,101425,Rossano; Federico,9999,0,9999,0
1668134783847,COGS 211B,A00,101427,Coulson; Seana M,9996,0,9999,3
1668134784271,COGS 220,A00,101428,Hollan; James D.,0,0,25,25
1668134784694,COGS 229,A00,101429,Dow; Steven P,18,0,25,7
1668134785131,COGS 230,A00,101430,Klemmer; Scott R,12,0,17,5
1668134785554,COGS 234,A00,101431,Xia; Haijun,3,0,25,22
1668134785982,COGS 260,A00,101432,Kiyonaga; Anastasia,20,0,25,5
1668134785982,COGS 260,B00,101433,Kirsh; David Joel,16,0,25,9
1668134786411,CSE 202,A00,102371,Impagliazzo; Russell,0,0,0,0
1668134786840,CSE 203B,A01,102373,Cheng; Chung Kuan,0,0,0,0
1668134787263,CSE 208,A00,102374,Micciancio; Daniele,0,0,0,0
1668134787689,CSE 209A,A00,112895,Impagliazzo; Russell,0,0,15,15
1668134788115,CSE 209B,A00,108005,Bellare; Mihir,0,0,0,0
1668134788537,CSE 210,A00,113163,Coblenz; Michael J,0,0,0,0
1668134788961,CSE 219,A00,106111,Dow; Steven P,0,0,20,20
1668134789388,CSE 221,A00,102376,Voelker; Geoffrey M.,0,0,0,0
1668134789821,CSE 224,A01,102378,Porter; George M,0,0,0,0
1668134790245,CSE 229A,A00,102379,Savage; Stefan,0,0,0,0
1668134790668,CSE 229C,A00,102380,Munyaka; Imani N. S.,0,0,0,0
1668134791092,CSE 232B,A00,102382,Deutsch; Alin Bernard,0,0,0,0
1668134791520,CSE 234,A01,112904,Kumar; Arun Kumar,0,0,0,0
1668134791947,CSE 237A,A00,102383,Rosing; Tajana Simunic,0,0,0,0
1668134792374,CSE 239A,A00,102384,Deutsch; Alin Bernard,0,0,0,0
1668134792798,CSE 239B,A00,102385,Polikarpova; Nadezhda,0,0,0,0
1668134793222,CSE 240A,A00,102386,Pannuto; Patrick William,0,0,0,0
1668134793654,CSE 240B,A00,102387,Zhao; Jishen,0,0,0,0
1668134794084,CSE 241A,A00,106406,Kang; Mingu,0,0,0,0
1668134794514,CSE 249B,A00,102388,Kahng; Andrew Byun,0,0,8,8
1668134794946,CSE 251B,A01,102392,Cottrell; Garrison W,0,0,0,0
1668134794946,CSE 251B,A02,102393,Cottrell; Garrison W,0,0,0,0
1668134795381,CSE 252B,A00,102394,Ochoa; Benjamin Lawrence,0,0,0,0
1668134795807,CSE 257,A01,102396,Gao; Sicun,0,0,0,0
1668134796230,CSE 272,A00,102397,Li; Tzumao,0,0,0,0
1668134796658,CSE 274,A00,111323,Chern; Albert Ren-Haur,0,0,0,0
1668134797093,CSE 282,A00,102398,Pevzner; Pavel Arkadjevich,0,0,0,0
1668134797524,CSE 284,A00,114175,Gymrek; Melissa Ann,0,0,0,0
1668134797949,CSE 290,A00,102399,Chandraker; Manmohan Krishna,0,0,0,0
1668134797949,CSE 290,B00,102400,Vaccaro; Kristen Marie,0,0,25,25
1668134797949,CSE 290,C00,102414,Pannuto; Patrick William,0,0,25,25
1668134797949,CSE 290,D00,102427,Pevzner; Pavel Arkadjevich,0,0,0,0
1668134797949,CSE 290,E00,102429,Zhao; Jishen,0,0,0,0
1668134797949,CSE 290,F00,102436,Tullsen; Dean Michael,0,0,0,0
1668134797949,CSE 290,G00,102440,Christensen; Henrik I,0,0,20,20
1668134798454,CSE 291,A00,102443,Su; Hao,0,0,0,0
1668134798454,CSE 291,B00,102448,Polikarpova; Nadezhda,0,0,0,0
1668134798454,CSE 291,C00,102453,Vaccaro; Kristen Marie,0,0,0,0
1668134798454,CSE 291,D00,111343,Savage; Stefan,0,0,0,0
1668134798454,CSE 291,E00,116474,Claffy; Kimberly Claire,0,0,0,0
1668134798454,CSE 291,F00,116479,Pasquale; Joseph,0,0,0,0
1668134798904,CSE 293,001,119111,Bafna; Vineet,9999,0,9999,0
1668134798904,CSE 293,002,119118,Bellare; Mihir,9999,0,9999,0
1668134798904,CSE 293,003,119122,Berg-Kirkpatrick; Taylor D,9999,0,9999,0
1668134798904,CSE 293,004,119135,Christensen; Henrik I,9999,0,9999,0
1668134798904,CSE 293,005,119142,Cottrell; Garrison W,9999,0,9999,0
1668134798904,CSE 293,006,119146,Deutsch; Alin Bernard,9999,0,9999,0
1668134798904,CSE 293,007,119159,Esmaeilzadeh; Hadi,9999,0,9999,0
1668134798904,CSE 293,008,119166,Freund; Yoav,9999,0,9999,0
1668134798904,CSE 293,009,119170,Griswold; William G.,9999,0,9999,0
1668134798904,CSE 293,010,119183,Gymrek; Melissa Ann,9999,0,9999,0
1668134798904,CSE 293,011,119190,Heninger; Nadia A,9999,0,9999,0
1668134798904,CSE 293,012,119230,Impagliazzo; Russell,9999,0,9999,0
1668134798904,CSE 293,013,119232,Jhala; Ranjit,9999,0,9999,0
1668134798904,CSE 293,014,119233,Kahng; Andrew Byun,9999,0,9999,0
1668134798904,CSE 293,015,119298,Kane; Daniel Mertz,9999,0,9999,0
1668134798904,CSE 293,016,119299,Kriegman; David J,9999,0,9999,0
1668134798904,CSE 293,017,119300,Kumar; Arun Kumar,9999,0,9999,0
1668134798904,CSE 293,018,119301,Lerner; Sorin,9999,0,9999,0
1668134798904,CSE 293,019,119302,Lovett; Shachar,9999,0,9999,0
1668134798904,CSE 293,020,119303,McAuley; Julian John,9999,0,9999,0
1668134798904,CSE 293,021,119304,Micciancio; Daniele,9999,0,9999,0
1668134798904,CSE 293,022,119367,Orailoglu; Alex,9999,0,9999,0
1668134798904,CSE 293,023,119382,Paturi; Ramamohan,9999,0,9999,0
1668134798904,CSE 293,024,119404,Polikarpova; Nadezhda,9999,0,9999,0
1668134798904,CSE 293,025,119406,Politz; Joseph Gibbs,9999,0,9999,0
1668134798904,CSE 293,026,119411,Porter; George M,9999,0,9999,0
1668134798904,CSE 293,027,119414,Porter; Leonard Emerson,9999,0,9999,0
1668134798904,CSE 293,028,119416,Ramamoorthi; Ravi,9999,0,9999,0
1668134798904,CSE 293,029,119417,Sahoo; Debashis,9999,0,9999,0
1668134798904,CSE 293,030,119420,Saul; Lawrence,9999,0,9999,0
1668134798904,CSE 293,031,119421,Savage; Stefan,9999,0,9999,0
1668134798904,CSE 293,032,119425,Schulze; Jurgen P.,9999,0,9999,0
1668134798904,CSE 293,033,119426,Snoeren; Alex C.,9999,0,9999,0
1668134798904,CSE 293,034,119428,Shang; Jingbo,9999,0,9999,0
1668134798904,CSE 293,035,119430,Stefan; Deian,9999,0,9999,0
1668134798904,CSE 293,036,119431,Su; Hao,9999,0,9999,0
1668134798904,CSE 293,037,119433,Swanson; Steven James,9999,0,9999,0
1668134798904,CSE 293,038,119435,Tullsen; Dean Michael,9999,0,9999,0
1668134798904,CSE 293,039,119483,Voelker; Geoffrey M.,9999,0,9999,0
1668134798904,CSE 293,040,119537,Zhao; Jishen,9999,0,9999,0
1668134798904,CSE 293,041,119538,Zhou; Yuan-Yuan,9999,0,9999,0
1668134798904,CSE 293,042,119539,Gao; Sicun,9999,0,9999,0
1668134798904,CSE 293,043,119540,Weibel; Nadir,9999,0,9999,0
1668134798904,CSE 293,044,119541,Gupta; Rajesh K.,9999,0,9999,0
1668134798904,CSE 293,045,126410,Vaccaro; Kristen Marie,9999,0,9999,0
1668134798904,CSE 293,046,126411,Klemke; Richard,9999,0,9999,0
1668134799330,CSE 294,A00,102459,Voelker; Geoffrey M.,0,0,0,0
1668134799330,CSE 294,B00,111322,Orailoglu; Alex,0,0,0,0
1668134799754,DSE 201,A00,096914,Deutsch; Alin Bernard,30,0,30,0
1668134800178,DSE 210,A00,096915,Dasgupta; Sanjoy,30,0,30,0
1668134800614,DSE 260A,A00,096916,Altintas De Callaf; Ilkay,30,0,30,0
1668134801075,ECE 200,001,103586,Antipa; Nicholas A,9999,0,9999,0
1668134801075,ECE 200,002,103587,Atanasov; Nikolay A.,9999,0,9999,0
1668134801075,ECE 200,003,103588,Bharadia; Dinesh,9999,0,9999,0
1668134801075,ECE 200,004,103589,Cheng; Chung Kuan,9999,0,9999,0
1668134801075,ECE 200,005,103590,Cosman; Pamela C.,9999,0,9999,0
1668134801075,ECE 200,006,103591,Dayeh; Shadi Ahmad,9999,0,9999,0
1668134801075,ECE 200,007,103592,Fainman; Yeshaiahu,9999,0,9999,0
1668134801075,ECE 200,008,103593,Ford; Joseph Earl,9999,0,9999,0
1668134801075,ECE 200,009,103594,Franceschetti; Massimo,9999,0,9999,0
1668134801075,ECE 200,010,103595,Fullerton; Eric E,9999,0,9999,0
1668134801075,ECE 200,011,103596,Galton; Ian A,9999,0,9999,0
1668134801075,ECE 200,012,103597,Gilja; Vikash,9999,0,9999,0
1668134801075,ECE 200,013,103598,Hall; Drew A.,9999,0,9999,0
1668134801075,ECE 200,014,103599,Hsueh; Tzu-Chien,9999,0,9999,0
1668134801075,ECE 200,015,103600,Javidi; Tara,9999,0,9999,0
1668134801075,ECE 200,016,103601,Kahng; Andrew Byun,9999,0,9999,0
1668134801075,ECE 200,017,103602,Kim; Young-Han,9999,0,9999,0
1668134801075,ECE 200,018,103603,Koushanfar; Farinaz,9999,0,9999,0
1668134801075,ECE 200,019,103604,Kuzum; Duygu,9999,0,9999,0
1668134801075,ECE 200,020,103605,Le; Hanh-Phuc,9999,0,9999,0
1668134801075,ECE 200,021,103606,Lin; Bill,9999,0,9999,0
1668134801075,ECE 200,022,103607,Liu; Zhaowei,9998,0,9999,1
1668134801075,ECE 200,023,103608,Lo; Yu-Hwa,9999,0,9999,0
1668134801075,ECE 200,024,103609,Lomakin; Vitaliy,9999,0,9999,0
1668134801075,ECE 200,025,103610,Mercier; Patrick Philip,9999,0,9999,0
1668134801075,ECE 200,026,103611,Meyer; Florian,9999,0,9999,0
1668134801075,ECE 200,027,103612,Milstein; Laurence B.,9999,0,9999,0
1668134801075,ECE 200,028,103613,Mir Arabbaygi; Siavash,9999,0,9999,0
1668134801075,ECE 200,029,103614,Mookherjea; Shayan,9999,0,9999,0
1668134801075,ECE 200,030,103615,Morris; Karcher William,9999,0,9999,0
1668134801075,ECE 200,031,103616,Ng; Tse Nga,9999,0,9999,0
1668134801075,ECE 200,032,103617,Nguyen; Truong Quang,9999,0,9999,0
1668134801075,ECE 200,033,103618,Nomura; Kenji,9999,0,9999,0
1668134801075,ECE 200,034,103619,Orlitsky; Alon,9999,0,9999,0
1668134801075,ECE 200,035,103620,Pal; Piya,9999,0,9999,0
1668134801075,ECE 200,036,103621,Papen; George C.,9999,0,9999,0
1668134801075,ECE 200,037,103622,Radic; Stojan,9999,0,9999,0
1668134801075,ECE 200,038,103623,Rao; Bhaskar D.,9999,0,9999,0
1668134801075,ECE 200,039,103624,Rao; Ramesh R,9999,0,9999,0
1668134801075,ECE 200,040,103625,Rebeiz; Gabriel,9999,0,9999,0
1668134801075,ECE 200,041,103626,Sanford; John R,9999,0,9999,0
1668134801075,ECE 200,042,103627,Siegel; Paul H.,9999,0,9999,0
1668134801075,ECE 200,043,103628,Sievenpiper; Daniel F.,9999,0,9999,0
1668134801075,ECE 200,044,103629,Sworder; David D.,9999,0,9999,0
1668134801075,ECE 200,045,103630,Taur; Yuan,9999,0,9999,0
1668134801075,ECE 200,046,103631,Touri; Behrouz,9999,0,9999,0
1668134801075,ECE 200,047,103632,Trivedi; Mohan M.,9999,0,9999,0
1668134801075,ECE 200,048,103633,Vasconcelos; Nuno,9999,0,9999,0
1668134801075,ECE 200,049,103634,Wang; Xiaolong,9999,0,9999,0
1668134801075,ECE 200,050,103635,Xie; Pengtao,9999,0,9999,0
1668134801075,ECE 200,051,103636,Yip; Michael,9999,0,9999,0
1668134801075,ECE 200,052,103637,Zeger; Kenneth A.,999,0,999,0
1668134801075,ECE 200,053,103638,Zhang; Xinyu,9999,0,9999,0
1668134801075,ECE 200,054,103639,Turakhia; Yatish Girish,9999,0,9999,0
1668134801075,ECE 200,055,103640,Kang; Mingu,9999,0,9999,0
1668134801075,ECE 200,056,103641,Shi; Yuanyuan,9999,0,9999,0
1668134801075,ECE 200,057,103642,Wang; Edward Jay,9999,0,9999,0
1668134801075,ECE 200,058,103643,Zheng; Yang,9999,0,9999,0
1668134801528,ECE 202,A00,103644,Kuzum; Duygu,0,0,0,0
1668134801955,ECE 212BN,A00,103646,Ng; Tse Nga,0,0,0,0
1668134802381,ECE 221,A00,111493,Staff,0,0,0,0
1668134802804,ECE 222B,A00,103647,Lomakin; Vitaliy,0,0,0,0
1668134803242,ECE 230B,A00,103648,Taur; Yuan,0,0,0,0
1668134803667,ECE 238B,A00,103649,Garay; Javier,0,0,0,0
1668134804093,ECE 240B,A00,112900,Fainman; Yeshaiahu,0,0,0,0
1668134804519,ECE 247A,A00,103650,Jokerst; Jesse Vincent,0,0,0,0
1668134804943,ECE 247B,A00,103651,Wang; Joseph,0,0,0,0
1668134805371,ECE 250,A00,103652,Siegel; Paul H.,0,0,0,0
1668134805797,ECE 251A,A00,103654,Rao; Bhaskar D.,0,0,0,0
1668134806231,ECE 257B,A00,103655,Bharadia; Dinesh,0,0,0,0
1668134806666,ECE 258A,A00,103656,Milstein; Laurence B.,0,0,0,0
1668134807089,ECE 260B,A00,103658,Kang; Mingu,0,0,0,0
1668134807517,ECE 264A,A00,103659,Galton; Ian A,0,0,0,0
1668134807942,ECE 265A,A00,103661,Gudem; Prasad S.S.,0,0,0,0
1668134808378,ECE 265D,A00,103662,Gudem; Prasad S.S.,0,0,0,0
1668134808803,ECE 268,A00,103663,Koushanfar; Farinaz,0,0,0,0
1668134809239,ECE 269,A01,103665,Pal; Piya,0,0,0,0
1668134809666,ECE 271B,A00,103666,Vasconcelos; Manuela,0,0,0,0
1668134810088,ECE 276A,A00,103667,Atanasov; Nikolay A.,0,0,0,0
1668134810517,ECE 277,A00,103668,An; Cheolhong,0,0,0,0
1668134810952,ECE 279,A00,117947,Hall; Drew A.,0,0,0,0
1668134811810,ECE 283,A00,103670,Hsueh; Tzu-Chien,0,0,0,0
1668134812234,ECE 284,A00,103671,Turakhia; Yatish Girish,0,0,0,0
1668134812663,ECE 285,A00,103672,Zheng; Yang,0,0,0,0
1668134812663,ECE 285,B00,103673,Sworder; David D.,0,0,0,0
1668134813095,ECE 287,A00,103676,Javidi; Tara,0,0,0,0
1668134813520,MATH 200B,A00,098023,Salehi Golsefidy; Alireza,12,0,15,3
1668134813944,MATH 202B,A00,098024,Rhoades; Brendon Patrick,9,0,15,6
1668134814368,MATH 203B,A00,098025,Oprea; Dragos N.,10,0,15,5
1668134814797,MATH 204B,A00,098026,Sorensen; Claus M,13,0,15,2
1668134815221,MATH 208,A00,098027,Izadi; Elham,7,0,10,3
1668134815647,MATH 209,A00,098028,Pollack; Aaron,10,0,10,0
1668134816083,MATH 211A,A00,112919,Rogalski; Daniel,9,0,10,1
1668134816524,MATH 211B,A00,112920,Seward; Brandon M.,9,0,10,1
1668134816947,MATH 218,A00,098029,Li; Bo,10,0,10,0
1668134817371,MATH 220B,A00,098030,Novak; Jonathan I,11,0,15,4
1668134817830,MATH 221A,A00,098031,Ebenfelt; Peter F,13,0,15,2
1668134818253,MATH 231B,A00,098032,Zlatos; Andrej,12,0,15,3
1668134818682,MATH 240B,A00,098033,Ni; Lei,9,0,15,6
1668134819113,MATH 243,A00,098034,Jekel; David Andrew,10,0,10,0
1668134819539,MATH 245A,A00,098035,Nie; Jiawang,0,0,15,16
1668134819966,MATH 248,A00,098036,Bejenaru; Ioan,10,0,10,0
1668134820390,MATH 250B,A00,098037,Spolaor; Luca,14,0,15,1
1668134820811,MATH 258,A00,098038,Ni; Lei,10,0,10,0
1668134821249,MATH 264B,A00,098041,Rhoades; Brendon Patrick,9,0,15,6
1668134821686,MATH 268,A00,098042,Buss; Samuel R,10,0,10,0
1668134822113,MATH 269,A00,098043,Rhoades; Brendon Patrick,10,0,10,0
1668134822545,MATH 270B,A00,098044,Li; Bo,10,0,15,5
1668134822990,MATH 272B,A00,098045,Holst; Michael J,13,0,15,2
1668134823418,MATH 273A,A00,098046,Tian; Xiaochuan,10,0,15,5
1668134823852,MATH 275,A01,098048,Tian; Xiaochuan,6,0,10,4
1668134824279,MATH 278A,A00,098049,Holst; Michael J,8,0,10,2
1668134824703,MATH 278B,A00,098050,Cloninger; Alexander,10,0,10,0
1668134825127,MATH 278C,A00,098051,Nie; Jiawang,7,0,10,3
1668134825555,MATH 280B,A00,098052,Zheng; Tianyi,10,0,15,5
1668134825981,MATH 281B,A00,098053,Bradic; Jelena,2,0,15,13
1668134826407,MATH 282B,A00,098054,Arias-Castro; Ery,0,0,15,15
1668134826831,MATH 285,A00,098055,Fitzsimmons; Patrick J,0,0,15,17
1668134827265,MATH 287B,A00,098056,Arias-Castro; Ery,2,0,15,13
1668134827691,MATH 288,A00,098057,Agarwal; Pooja,9,0,10,1
1668134827691,MATH 288,B00,098058,Zhang; Danna,8,0,10,2
1668134827691,MATH 288,C00,098059,Williams; Ruth J,10,0,10,0
1668134828122,MATH 290B,A00,098060,Roberts; Justin Deritter,13,0,15,2
1668134828548,MATH 292,A00,098061,Belmont; Eva Kinoshita,10,0,10,0
1668134828976,MATH 295,A00,098062,Suk; Andrew Hoon,48,0,50,2
1668134829403,MATH 296,A00,098063,Novak; Jonathan I,20,0,20,0
1668134829828,MATH 297,001,098064,Gamst; Anthony Collins,9997,0,9999,2
1668135333739,COGS 205,A00,101395,Chiba; Andrea,19,0,20,1
1668135334174,COGS 210B,001,101404,Greene; Deanna Jacquelyn,9998,0,9999,1
1668135334174,COGS 210B,002,101417,Xia; Haijun,9999,0,9999,0
1668135334174,COGS 210B,003,101422,Nitz; Douglas A.,9999,0,9999,0
1668135334174,COGS 210B,004,101423,Hollan; James D.,9998,0,9999,1
1668135334174,COGS 210B,005,101424,Deak; Gedeon O.,9998,0,9999,1
1668135334174,COGS 210B,006,101425,Rossano; Federico,9999,0,9999,0
1668135334599,COGS 211B,A00,101427,Coulson; Seana M,9996,0,9999,3
1668135335023,COGS 220,A00,101428,Hollan; James D.,0,0,25,25
1668135335452,COGS 229,A00,101429,Dow; Steven P,18,0,25,7
1668135335875,COGS 230,A00,101430,Klemmer; Scott R,12,0,17,5
1668135336298,COGS 234,A00,101431,Xia; Haijun,3,0,25,22
1668135336727,COGS 260,A00,101432,Kiyonaga; Anastasia,20,0,25,5
1668135336727,COGS 260,B00,101433,Kirsh; David Joel,16,0,25,9
1668135337157,CSE 202,A00,102371,Impagliazzo; Russell,0,0,0,0
1668135337585,CSE 203B,A01,102373,Cheng; Chung Kuan,0,0,0,0
1668135338012,CSE 208,A00,102374,Micciancio; Daniele,0,0,0,0
1668135338450,CSE 209A,A00,112895,Impagliazzo; Russell,0,0,15,15
1668135338941,CSE 209B,A00,108005,Bellare; Mihir,0,0,0,0
1668135339365,CSE 210,A00,113163,Coblenz; Michael J,0,0,0,0
1668135339788,CSE 219,A00,106111,Dow; Steven P,0,0,20,20
1668135340215,CSE 221,A00,102376,Voelker; Geoffrey M.,0,0,0,0
1668135340651,CSE 224,A01,102378,Porter; George M,0,0,0,0
1668135341078,CSE 229A,A00,102379,Savage; Stefan,0,0,0,0
1668135341505,CSE 229C,A00,102380,Munyaka; Imani N. S.,0,0,0,0
1668135341929,CSE 232B,A00,102382,Deutsch; Alin Bernard,0,0,0,0
1668135342353,CSE 234,A01,112904,Kumar; Arun Kumar,0,0,0,0
1668135342782,CSE 237A,A00,102383,Rosing; Tajana Simunic,0,0,0,0
1668135343214,CSE 239A,A00,102384,Deutsch; Alin Bernard,0,0,0,0
1668135343654,CSE 239B,A00,102385,Polikarpova; Nadezhda,0,0,0,0
1668135344084,CSE 240A,A00,102386,Pannuto; Patrick William,0,0,0,0
1668135344509,CSE 240B,A00,102387,Zhao; Jishen,0,0,0,0
1668135344935,CSE 241A,A00,106406,Kang; Mingu,0,0,0,0
1668135345360,CSE 249B,A00,102388,Kahng; Andrew Byun,0,0,8,8
1668135345783,CSE 251B,A01,102392,Cottrell; Garrison W,0,0,0,0
1668135345783,CSE 251B,A02,102393,Cottrell; Garrison W,0,0,0,0
1668135346221,CSE 252B,A00,102394,Ochoa; Benjamin Lawrence,0,0,0,0
1668135346651,CSE 257,A01,102396,Gao; Sicun,0,0,0,0
1668135347075,CSE 272,A00,102397,Li; Tzumao,0,0,0,0
1668135347502,CSE 274,A00,111323,Chern; Albert Ren-Haur,0,0,0,0
1668135347928,CSE 282,A00,102398,Pevzner; Pavel Arkadjevich,0,0,0,0
1668135348352,CSE 284,A00,114175,Gymrek; Melissa Ann,0,0,0,0
1668135348775,CSE 290,A00,102399,Chandraker; Manmohan Krishna,0,0,0,0
1668135348775,CSE 290,B00,102400,Vaccaro; Kristen Marie,0,0,25,25
1668135348775,CSE 290,C00,102414,Pannuto; Patrick William,0,0,25,25
1668135348775,CSE 290,D00,102427,Pevzner; Pavel Arkadjevich,0,0,0,0
1668135348775,CSE 290,E00,102429,Zhao; Jishen,0,0,0,0
1668135348775,CSE 290,F00,102436,Tullsen; Dean Michael,0,0,0,0
1668135348775,CSE 290,G00,102440,Christensen; Henrik I,0,0,20,20
1668135349200,CSE 291,A00,102443,Su; Hao,0,0,0,0
1668135349200,CSE 291,B00,102448,Polikarpova; Nadezhda,0,0,0,0
1668135349200,CSE 291,C00,102453,Vaccaro; Kristen Marie,0,0,0,0
1668135349200,CSE 291,D00,111343,Savage; Stefan,0,0,0,0
1668135349200,CSE 291,E00,116474,Claffy; Kimberly Claire,0,0,0,0
1668135349200,CSE 291,F00,116479,Pasquale; Joseph,0,0,0,0
1668135349697,CSE 293,001,119111,Bafna; Vineet,9999,0,9999,0
1668135349697,CSE 293,002,119118,Bellare; Mihir,9999,0,9999,0
1668135349697,CSE 293,003,119122,Berg-Kirkpatrick; Taylor D,9999,0,9999,0
1668135349697,CSE 293,004,119135,Christensen; Henrik I,9999,0,9999,0
1668135349697,CSE 293,005,119142,Cottrell; Garrison W,9999,0,9999,0
1668135349697,CSE 293,006,119146,Deutsch; Alin Bernard,9999,0,9999,0
1668135349697,CSE 293,007,119159,Esmaeilzadeh; Hadi,9999,0,9999,0
1668135349697,CSE 293,008,119166,Freund; Yoav,9999,0,9999,0
1668135349697,CSE 293,009,119170,Griswold; William G.,9999,0,9999,0
1668135349697,CSE 293,010,119183,Gymrek; Melissa Ann,9999,0,9999,0
1668135349697,CSE 293,011,119190,Heninger; Nadia A,9999,0,9999,0
1668135349697,CSE 293,012,119230,Impagliazzo; Russell,9999,0,9999,0
1668135349697,CSE 293,013,119232,Jhala; Ranjit,9999,0,9999,0
1668135349697,CSE 293,014,119233,Kahng; Andrew Byun,9999,0,9999,0
1668135349697,CSE 293,015,119298,Kane; Daniel Mertz,9999,0,9999,0
1668135349697,CSE 293,016,119299,Kriegman; David J,9999,0,9999,0
1668135349697,CSE 293,017,119300,Kumar; Arun Kumar,9999,0,9999,0
1668135349697,CSE 293,018,119301,Lerner; Sorin,9999,0,9999,0
1668135349697,CSE 293,019,119302,Lovett; Shachar,9999,0,9999,0
1668135349697,CSE 293,020,119303,McAuley; Julian John,9999,0,9999,0
1668135349697,CSE 293,021,119304,Micciancio; Daniele,9999,0,9999,0
1668135349697,CSE 293,022,119367,Orailoglu; Alex,9999,0,9999,0
1668135349697,CSE 293,023,119382,Paturi; Ramamohan,9999,0,9999,0
1668135349697,CSE 293,024,119404,Polikarpova; Nadezhda,9999,0,9999,0
1668135349697,CSE 293,025,119406,Politz; Joseph Gibbs,9999,0,9999,0
1668135349697,CSE 293,026,119411,Porter; George M,9999,0,9999,0
1668135349697,CSE 293,027,119414,Porter; Leonard Emerson,9999,0,9999,0
1668135349697,CSE 293,028,119416,Ramamoorthi; Ravi,9999,0,9999,0
1668135349697,CSE 293,029,119417,Sahoo; Debashis,9999,0,9999,0
1668135349697,CSE 293,030,119420,Saul; Lawrence,9999,0,9999,0
1668135349697,CSE 293,031,119421,Savage; Stefan,9999,0,9999,0
1668135349697,CSE 293,032,119425,Schulze; Jurgen P.,9999,0,9999,0
1668135349697,CSE 293,033,119426,Snoeren; Alex C.,9999,0,9999,0
1668135349697,CSE 293,034,119428,Shang; Jingbo,9999,0,9999,0
1668135349697,CSE 293,035,119430,Stefan; Deian,9999,0,9999,0
1668135349697,CSE 293,036,119431,Su; Hao,9999,0,9999,0
1668135349697,CSE 293,037,119433,Swanson; Steven James,9999,0,9999,0
1668135349697,CSE 293,038,119435,Tullsen; Dean Michael,9999,0,9999,0
1668135349697,CSE 293,039,119483,Voelker; Geoffrey M.,9999,0,9999,0
1668135349697,CSE 293,040,119537,Zhao; Jishen,9999,0,9999,0
1668135349697,CSE 293,041,119538,Zhou; Yuan-Yuan,9999,0,9999,0
1668135349697,CSE 293,042,119539,Gao; Sicun,9999,0,9999,0
1668135349697,CSE 293,043,119540,Weibel; Nadir,9999,0,9999,0
1668135349697,CSE 293,044,119541,Gupta; Rajesh K.,9999,0,9999,0
1668135349697,CSE 293,045,126410,Vaccaro; Kristen Marie,9999,0,9999,0
1668135349697,CSE 293,046,126411,Klemke; Richard,9999,0,9999,0
1668135350122,CSE 294,A00,102459,Voelker; Geoffrey M.,0,0,0,0
1668135350122,CSE 294,B00,111322,Orailoglu; Alex,0,0,0,0
1668135350548,DSE 201,A00,096914,Deutsch; Alin Bernard,30,0,30,0
1668135350975,DSE 210,A00,096915,Dasgupta; Sanjoy,30,0,30,0
1668135351398,DSE 260A,A00,096916,Altintas De Callaf; Ilkay,30,0,30,0
1668135351868,ECE 200,001,103586,Antipa; Nicholas A,9999,0,9999,0
1668135351868,ECE 200,002,103587,Atanasov; Nikolay A.,9999,0,9999,0
1668135351868,ECE 200,003,103588,Bharadia; Dinesh,9999,0,9999,0
1668135351868,ECE 200,004,103589,Cheng; Chung Kuan,9999,0,9999,0
1668135351868,ECE 200,005,103590,Cosman; Pamela C.,9999,0,9999,0
1668135351868,ECE 200,006,103591,Dayeh; Shadi Ahmad,9999,0,9999,0
1668135351868,ECE 200,007,103592,Fainman; Yeshaiahu,9999,0,9999,0
1668135351868,ECE 200,008,103593,Ford; Joseph Earl,9999,0,9999,0
1668135351868,ECE 200,009,103594,Franceschetti; Massimo,9999,0,9999,0
1668135351868,ECE 200,010,103595,Fullerton; Eric E,9999,0,9999,0
1668135351868,ECE 200,011,103596,Galton; Ian A,9999,0,9999,0
1668135351868,ECE 200,012,103597,Gilja; Vikash,9999,0,9999,0
1668135351868,ECE 200,013,103598,Hall; Drew A.,9999,0,9999,0
1668135351868,ECE 200,014,103599,Hsueh; Tzu-Chien,9999,0,9999,0
1668135351868,ECE 200,015,103600,Javidi; Tara,9999,0,9999,0
1668135351868,ECE 200,016,103601,Kahng; Andrew Byun,9999,0,9999,0
1668135351868,ECE 200,017,103602,Kim; Young-Han,9999,0,9999,0
1668135351868,ECE 200,018,103603,Koushanfar; Farinaz,9999,0,9999,0
1668135351868,ECE 200,019,103604,Kuzum; Duygu,9999,0,9999,0
1668135351868,ECE 200,020,103605,Le; Hanh-Phuc,9999,0,9999,0
1668135351868,ECE 200,021,103606,Lin; Bill,9999,0,9999,0
1668135351868,ECE 200,022,103607,Liu; Zhaowei,9998,0,9999,1
1668135351868,ECE 200,023,103608,Lo; Yu-Hwa,9999,0,9999,0
1668135351868,ECE 200,024,103609,Lomakin; Vitaliy,9999,0,9999,0
1668135351868,ECE 200,025,103610,Mercier; Patrick Philip,9999,0,9999,0
1668135351868,ECE 200,026,103611,Meyer; Florian,9999,0,9999,0
1668135351868,ECE 200,027,103612,Milstein; Laurence B.,9999,0,9999,0
1668135351868,ECE 200,028,103613,Mir Arabbaygi; Siavash,9999,0,9999,0
1668135351868,ECE 200,029,103614,Mookherjea; Shayan,9999,0,9999,0
1668135351868,ECE 200,030,103615,Morris; Karcher William,9999,0,9999,0
1668135351868,ECE 200,031,103616,Ng; Tse Nga,9999,0,9999,0
1668135351868,ECE 200,032,103617,Nguyen; Truong Quang,9999,0,9999,0
1668135351868,ECE 200,033,103618,Nomura; Kenji,9999,0,9999,0
1668135351868,ECE 200,034,103619,Orlitsky; Alon,9999,0,9999,0
1668135351868,ECE 200,035,103620,Pal; Piya,9999,0,9999,0
1668135351868,ECE 200,036,103621,Papen; George C.,9999,0,9999,0
1668135351868,ECE 200,037,103622,Radic; Stojan,9999,0,9999,0
1668135351868,ECE 200,038,103623,Rao; Bhaskar D.,9999,0,9999,0
1668135351868,ECE 200,039,103624,Rao; Ramesh R,9999,0,9999,0
1668135351868,ECE 200,040,103625,Rebeiz; Gabriel,9999,0,9999,0
1668135351868,ECE 200,041,103626,Sanford; John R,9999,0,9999,0
1668135351868,ECE 200,042,103627,Siegel; Paul H.,9999,0,9999,0
1668135351868,ECE 200,043,103628,Sievenpiper; Daniel F.,9999,0,9999,0
1668135351868,ECE 200,044,103629,Sworder; David D.,9999,0,9999,0
1668135351868,ECE 200,045,103630,Taur; Yuan,9999,0,9999,0
1668135351868,ECE 200,046,103631,Touri; Behrouz,9999,0,9999,0
1668135351868,ECE 200,047,103632,Trivedi; Mohan M.,9999,0,9999,0
1668135351868,ECE 200,048,103633,Vasconcelos; Nuno,9999,0,9999,0
1668135351868,ECE 200,049,103634,Wang; Xiaolong,9999,0,9999,0
1668135351868,ECE 200,050,103635,Xie; Pengtao,9999,0,9999,0
1668135351868,ECE 200,051,103636,Yip; Michael,9999,0,9999,0
1668135351868,ECE 200,052,103637,Zeger; Kenneth A.,999,0,999,0
1668135351868,ECE 200,053,103638,Zhang; Xinyu,9999,0,9999,0
1668135351868,ECE 200,054,103639,Turakhia; Yatish Girish,9999,0,9999,0
1668135351868,ECE 200,055,103640,Kang; Mingu,9999,0,9999,0
1668135351868,ECE 200,056,103641,Shi; Yuanyuan,9999,0,9999,0
1668135351868,ECE 200,057,103642,Wang; Edward Jay,9999,0,9999,0
1668135351868,ECE 200,058,103643,Zheng; Yang,9999,0,9999,0
1668135352294,ECE 202,A00,103644,Kuzum; Duygu,0,0,0,0
1668135352721,ECE 212BN,A00,103646,Ng; Tse Nga,0,0,0,0
1668135353148,ECE 221,A00,111493,Staff,0,0,0,0
1668135353595,ECE 222B,A00,103647,Lomakin; Vitaliy,0,0,0,0
1668135354022,ECE 230B,A00,103648,Taur; Yuan,0,0,0,0
1668135354454,ECE 238B,A00,103649,Garay; Javier,0,0,0,0
1668135354880,ECE 240B,A00,112900,Fainman; Yeshaiahu,0,0,0,0
1668135355307,ECE 247A,A00,103650,Jokerst; Jesse Vincent,0,0,0,0
1668135355735,ECE 247B,A00,103651,Wang; Joseph,0,0,0,0
1668135356163,ECE 250,A00,103652,Siegel; Paul H.,0,0,0,0
1668135356586,ECE 251A,A00,103654,Rao; Bhaskar D.,0,0,0,0
1668135357017,ECE 257B,A00,103655,Bharadia; Dinesh,0,0,0,0
1668135357443,ECE 258A,A00,103656,Milstein; Laurence B.,0,0,0,0
1668135357867,ECE 260B,A00,103658,Kang; Mingu,0,0,0,0
1668135358300,ECE 264A,A00,103659,Galton; Ian A,0,0,0,0
1668135358722,ECE 265A,A00,103661,Gudem; Prasad S.S.,0,0,0,0
1668135359151,ECE 265D,A00,103662,Gudem; Prasad S.S.,0,0,0,0
1668135359588,ECE 268,A00,103663,Koushanfar; Farinaz,0,0,0,0
1668135360029,ECE 269,A01,103665,Pal; Piya,0,0,0,0
1668135360453,ECE 271B,A00,103666,Vasconcelos; Manuela,0,0,0,0
1668135360877,ECE 276A,A00,103667,Atanasov; Nikolay A.,0,0,0,0
1668135361301,ECE 277,A00,103668,An; Cheolhong,0,0,0,0
1668135361728,ECE 279,A00,117947,Hall; Drew A.,0,0,0,0
1668135362576,ECE 283,A00,103670,Hsueh; Tzu-Chien,0,0,0,0
1668135363001,ECE 284,A00,103671,Turakhia; Yatish Girish,0,0,0,0
1668135363438,ECE 285,A00,103672,Zheng; Yang,0,0,0,0
1668135363438,ECE 285,B00,103673,Sworder; David D.,0,0,0,0
1668135363864,ECE 287,A00,103676,Javidi; Tara,0,0,0,0
1668135364290,MATH 200B,A00,098023,Salehi Golsefidy; Alireza,12,0,15,3
1668135364715,MATH 202B,A00,098024,Rhoades; Brendon Patrick,9,0,15,6
1668135365142,MATH 203B,A00,098025,Oprea; Dragos N.,10,0,15,5
1668135365568,MATH 204B,A00,098026,Sorensen; Claus M,13,0,15,2
1668135366104,MATH 208,A00,098027,Izadi; Elham,7,0,10,3
1668135366529,MATH 209,A00,098028,Pollack; Aaron,10,0,10,0
1668135366952,MATH 211A,A00,112919,Rogalski; Daniel,9,0,10,1
1668135367377,MATH 211B,A00,112920,Seward; Brandon M.,9,0,10,1
1668135367813,MATH 218,A00,098029,Li; Bo,10,0,10,0
1668135368238,MATH 220B,A00,098030,Novak; Jonathan I,11,0,15,4
1668135368660,MATH 221A,A00,098031,Ebenfelt; Peter F,13,0,15,2
1668135369092,MATH 231B,A00,098032,Zlatos; Andrej,12,0,15,3
1668135369529,MATH 240B,A00,098033,Ni; Lei,9,0,15,6
1668135369953,MATH 243,A00,098034,Jekel; David Andrew,10,0,10,0
1668135370377,MATH 245A,A00,098035,Nie; Jiawang,0,0,15,16
1668135370800,MATH 248,A00,098036,Bejenaru; Ioan,10,0,10,0
1668135371229,MATH 250B,A00,098037,Spolaor; Luca,14,0,15,1
1668135371654,MATH 258,A00,098038,Ni; Lei,10,0,10,0
1668135372085,MATH 264B,A00,098041,Rhoades; Brendon Patrick,9,0,15,6
1668135372514,MATH 268,A00,098042,Buss; Samuel R,10,0,10,0
1668135372942,MATH 269,A00,098043,Rhoades; Brendon Patrick,10,0,10,0
1668135373369,MATH 270B,A00,098044,Li; Bo,10,0,15,5
1668135373795,MATH 272B,A00,098045,Holst; Michael J,13,0,15,2
1668135374220,MATH 273A,A00,098046,Tian; Xiaochuan,10,0,15,5
1668135374647,MATH 275,A01,098048,Tian; Xiaochuan,6,0,10,4
1668135375074,MATH 278A,A00,098049,Holst; Michael J,8,0,10,2
1668135375501,MATH 278B,A00,098050,Cloninger; Alexander,10,0,10,0
1668135375928,MATH 278C,A00,098051,Nie; Jiawang,7,0,10,3
1668135376373,MATH 280B,A00,098052,Zheng; Tianyi,10,0,15,5
1668135376796,MATH 281B,A00,098053,Bradic; Jelena,2,0,15,13
1668135377222,MATH 282B,A00,098054,Arias-Castro; Ery,0,0,15,15
1668135377649,MATH 285,A00,098055,Fitzsimmons; Patrick J,0,0,15,17
1668135378072,MATH 287B,A00,098056,Arias-Castro; Ery,2,0,15,13
1668135378500,MATH 288,A00,098057,Agarwal; Pooja,9,0,10,1
1668135378500,MATH 288,B00,098058,Zhang; Danna,8,0,10,2
1668135378500,MATH 288,C00,098059,Williams; Ruth J,10,0,10,0
1668135378925,MATH 290B,A00,098060,Roberts; Justin Deritter,13,0,15,2
1668135379349,MATH 292,A00,098061,Belmont; Eva Kinoshita,10,0,10,0
1668135379774,MATH 295,A00,098062,Suk; Andrew Hoon,48,0,50,2
1668135380204,MATH 296,A00,098063,Novak; Jonathan I,20,0,20,0
1668135380633,MATH 297,001,098064,Gamst; Anthony Collins,9997,0,9999,2
1668135895781,COGS 205,A00,101395,Chiba; Andrea,19,0,20,1
1668135896214,COGS 210B,001,101404,Greene; Deanna Jacquelyn,9998,0,9999,1
1668135896214,COGS 210B,002,101417,Xia; Haijun,9999,0,9999,0
1668135896214,COGS 210B,003,101422,Nitz; Douglas A.,9999,0,9999,0
1668135896214,COGS 210B,004,101423,Hollan; James D.,9998,0,9999,1
1668135896214,COGS 210B,005,101424,Deak; Gedeon O.,9998,0,9999,1
1668135896214,COGS 210B,006,101425,Rossano; Federico,9999,0,9999,0
1668135896640,COGS 211B,A00,101427,Coulson; Seana M,9996,0,9999,3
1668135897065,COGS 220,A00,101428,Hollan; James D.,0,0,25,25
1668135897492,COGS 229,A00,101429,Dow; Steven P,18,0,25,7
1668135897920,COGS 230,A00,101430,Klemmer; Scott R,12,0,17,5
1668135898344,COGS 234,A00,101431,Xia; Haijun,3,0,25,22
1668135898778,COGS 260,A00,101432,Kiyonaga; Anastasia,20,0,25,5
1668135898778,COGS 260,B00,101433,Kirsh; David Joel,16,0,25,9
1668135899202,CSE 202,A00,102371,Impagliazzo; Russell,0,0,0,0
1668135899630,CSE 203B,A01,102373,Cheng; Chung Kuan,0,0,0,0
1668135900056,CSE 208,A00,102374,Micciancio; Daniele,0,0,0,0
1668135900495,CSE 209A,A00,112895,Impagliazzo; Russell,0,0,15,15
1668135900924,CSE 209B,A00,108005,Bellare; Mihir,0,0,0,0
1668135901458,CSE 210,A00,113163,Coblenz; Michael J,0,0,0,0
1668135901887,CSE 219,A00,106111,Dow; Steven P,0,0,20,20
1668135902319,CSE 221,A00,102376,Voelker; Geoffrey M.,0,0,0,0
1668135902744,CSE 224,A01,102378,Porter; George M,0,0,0,0
1668135903168,CSE 229A,A00,102379,Savage; Stefan,0,0,0,0
1668135903594,CSE 229C,A00,102380,Munyaka; Imani N. S.,0,0,0,0
1668135904034,CSE 232B,A00,102382,Deutsch; Alin Bernard,0,0,0,0
1668135904465,CSE 234,A01,112904,Kumar; Arun Kumar,0,0,0,0
1668135904894,CSE 237A,A00,102383,Rosing; Tajana Simunic,0,0,0,0
1668135905319,CSE 239A,A00,102384,Deutsch; Alin Bernard,0,0,0,0
1668135905757,CSE 239B,A00,102385,Polikarpova; Nadezhda,0,0,0,0
1668135906187,CSE 240A,A00,102386,Pannuto; Patrick William,0,0,0,0
1668135906609,CSE 240B,A00,102387,Zhao; Jishen,0,0,0,0
1668135907032,CSE 241A,A00,106406,Kang; Mingu,0,0,0,0
1668135907456,CSE 249B,A00,102388,Kahng; Andrew Byun,0,0,8,8
1668135907890,CSE 251B,A01,102392,Cottrell; Garrison W,0,0,0,0
1668135907890,CSE 251B,A02,102393,Cottrell; Garrison W,0,0,0,0
1668135908315,CSE 252B,A00,102394,Ochoa; Benjamin Lawrence,0,0,0,0
1668135908751,CSE 257,A01,102396,Gao; Sicun,0,0,0,0
1668135909190,CSE 272,A00,102397,Li; Tzumao,0,0,0,0
1668135909618,CSE 274,A00,111323,Chern; Albert Ren-Haur,0,0,0,0
1668135910045,CSE 282,A00,102398,Pevzner; Pavel Arkadjevich,0,0,0,0
1668135910471,CSE 284,A00,114175,Gymrek; Melissa Ann,0,0,0,0
1668135910899,CSE 290,A00,102399,Chandraker; Manmohan Krishna,0,0,0,0
1668135910899,CSE 290,B00,102400,Vaccaro; Kristen Marie,0,0,25,25
1668135910899,CSE 290,C00,102414,Pannuto; Patrick William,0,0,25,25
1668135910899,CSE 290,D00,102427,Pevzner; Pavel Arkadjevich,0,0,0,0
1668135910899,CSE 290,E00,102429,Zhao; Jishen,0,0,0,0
1668135910899,CSE 290,F00,102436,Tullsen; Dean Michael,0,0,0,0
1668135910899,CSE 290,G00,102440,Christensen; Henrik I,0,0,20,20
1668135911332,CSE 291,A00,102443,Su; Hao,0,0,0,0
1668135911332,CSE 291,B00,102448,Polikarpova; Nadezhda,0,0,0,0
1668135911332,CSE 291,C00,102453,Vaccaro; Kristen Marie,0,0,0,0
1668135911332,CSE 291,D00,111343,Savage; Stefan,0,0,0,0
1668135911332,CSE 291,E00,116474,Claffy; Kimberly Claire,0,0,0,0
1668135911332,CSE 291,F00,116479,Pasquale; Joseph,0,0,0,0
1668135911771,CSE 293,001,119111,Bafna; Vineet,9999,0,9999,0
1668135911771,CSE 293,002,119118,Bellare; Mihir,9999,0,9999,0
1668135911771,CSE 293,003,119122,Berg-Kirkpatrick; Taylor D,9999,0,9999,0
1668135911771,CSE 293,004,119135,Christensen; Henrik I,9999,0,9999,0
1668135911771,CSE 293,005,119142,Cottrell; Garrison W,9999,0,9999,0
1668135911771,CSE 293,006,119146,Deutsch; Alin Bernard,9999,0,9999,0
1668135911771,CSE 293,007,119159,Esmaeilzadeh; Hadi,9999,0,9999,0
1668135911771,CSE 293,008,119166,Freund; Yoav,9999,0,9999,0
1668135911771,CSE 293,009,119170,Griswold; William G.,9999,0,9999,0
1668135911771,CSE 293,010,119183,Gymrek; Melissa Ann,9999,0,9999,0
1668135911771,CSE 293,011,119190,Heninger; Nadia A,9999,0,9999,0
1668135911771,CSE 293,012,119230,Impagliazzo; Russell,9999,0,9999,0
1668135911771,CSE 293,013,119232,Jhala; Ranjit,9999,0,9999,0
1668135911771,CSE 293,014,119233,Kahng; Andrew Byun,9999,0,9999,0
1668135911771,CSE 293,015,119298,Kane; Daniel Mertz,9999,0,9999,0
1668135911771,CSE 293,016,119299,Kriegman; David J,9999,0,9999,0
1668135911771,CSE 293,017,119300,Kumar; Arun Kumar,9999,0,9999,0
1668135911771,CSE 293,018,119301,Lerner; Sorin,9999,0,9999,0
1668135911771,CSE 293,019,119302,Lovett; Shachar,9999,0,9999,0
1668135911771,CSE 293,020,119303,McAuley; Julian John,9999,0,9999,0
1668135911771,CSE 293,021,119304,Micciancio; Daniele,9999,0,9999,0
1668135911771,CSE 293,022,119367,Orailoglu; Alex,9999,0,9999,0
1668135911771,CSE 293,023,119382,Paturi; Ramamohan,9999,0,9999,0
1668135911771,CSE 293,024,119404,Polikarpova; Nadezhda,9999,0,9999,0
1668135911771,CSE 293,025,119406,Politz; Joseph Gibbs,9999,0,9999,0
1668135911771,CSE 293,026,119411,Porter; George M,9999,0,9999,0
1668135911771,CSE 293,027,119414,Porter; Leonard Emerson,9999,0,9999,0
1668135911771,CSE 293,028,119416,Ramamoorthi; Ravi,9999,0,9999,0
1668135911771,CSE 293,029,119417,Sahoo; Debashis,9999,0,9999,0
1668135911771,CSE 293,030,119420,Saul; Lawrence,9999,0,9999,0
1668135911771,CSE 293,031,119421,Savage; Stefan,9999,0,9999,0
1668135911771,CSE 293,032,119425,Schulze; Jurgen P.,9999,0,9999,0
1668135911771,CSE 293,033,119426,Snoeren; Alex C.,9999,0,9999,0
1668135911771,CSE 293,034,119428,Shang; Jingbo,9999,0,9999,0
1668135911771,CSE 293,035,119430,Stefan; Deian,9999,0,9999,0
1668135911771,CSE 293,036,119431,Su; Hao,9999,0,9999,0
1668135911771,CSE 293,037,119433,Swanson; Steven James,9999,0,9999,0
1668135911771,CSE 293,038,119435,Tullsen; Dean Michael,9999,0,9999,0
1668135911771,CSE 293,039,119483,Voelker; Geoffrey M.,9999,0,9999,0
1668135911771,CSE 293,040,119537,Zhao; Jishen,9999,0,9999,0
1668135911771,CSE 293,041,119538,Zhou; Yuan-Yuan,9999,0,9999,0
1668135911771,CSE 293,042,119539,Gao; Sicun,9999,0,9999,0
1668135911771,CSE 293,043,119540,Weibel; Nadir,9999,0,9999,0
1668135911771,CSE 293,044,119541,Gupta; Rajesh K.,9999,0,9999,0
1668135911771,CSE 293,045,126410,Vaccaro; Kristen Marie,9999,0,9999,0
1668135911771,CSE 293,046,126411,Klemke; Richard,9999,0,9999,0
1668135912198,CSE 294,A00,102459,Voelker; Geoffrey M.,0,0,0,0
1668135912198,CSE 294,B00,111322,Orailoglu; Alex,0,0,0,0
1668135912629,DSE 201,A00,096914,Deutsch; Alin Bernard,30,0,30,0
1668135913059,DSE 210,A00,096915,Dasgupta; Sanjoy,30,0,30,0
1668135913484,DSE 260A,A00,096916,Altintas De Callaf; Ilkay,30,0,30,0
1668135913959,ECE 200,001,103586,Antipa; Nicholas A,9999,0,9999,0
1668135913959,ECE 200,002,103587,Atanasov; Nikolay A.,9999,0,9999,0
1668135913959,ECE 200,003,103588,Bharadia; Dinesh,9999,0,9999,0
1668135913959,ECE 200,004,103589,Cheng; Chung Kuan,9999,0,9999,0
1668135913959,ECE 200,005,103590,Cosman; Pamela C.,9999,0,9999,0
1668135913959,ECE 200,006,103591,Dayeh; Shadi Ahmad,9999,0,9999,0
1668135913959,ECE 200,007,103592,Fainman; Yeshaiahu,9999,0,9999,0
1668135913959,ECE 200,008,103593,Ford; Joseph Earl,9999,0,9999,0
1668135913959,ECE 200,009,103594,Franceschetti; Massimo,9999,0,9999,0
1668135913959,ECE 200,010,103595,Fullerton; Eric E,9999,0,9999,0
1668135913959,ECE 200,011,103596,Galton; Ian A,9999,0,9999,0
1668135913959,ECE 200,012,103597,Gilja; Vikash,9999,0,9999,0
1668135913959,ECE 200,013,103598,Hall; Drew A.,9999,0,9999,0
1668135913959,ECE 200,014,103599,Hsueh; Tzu-Chien,9999,0,9999,0
1668135913959,ECE 200,015,103600,Javidi; Tara,9999,0,9999,0
1668135913959,ECE 200,016,103601,Kahng; Andrew Byun,9999,0,9999,0
1668135913959,ECE 200,017,103602,Kim; Young-Han,9999,0,9999,0
1668135913959,ECE 200,018,103603,Koushanfar; Farinaz,9999,0,9999,0
1668135913959,ECE 200,019,103604,Kuzum; Duygu,9999,0,9999,0
1668135913959,ECE 200,020,103605,Le; Hanh-Phuc,9999,0,9999,0
1668135913959,ECE 200,021,103606,Lin; Bill,9999,0,9999,0
1668135913959,ECE 200,022,103607,Liu; Zhaowei,9998,0,9999,1
1668135913959,ECE 200,023,103608,Lo; Yu-Hwa,9999,0,9999,0
1668135913959,ECE 200,024,103609,Lomakin; Vitaliy,9999,0,9999,0
1668135913959,ECE 200,025,103610,Mercier; Patrick Philip,9999,0,9999,0
1668135913959,ECE 200,026,103611,Meyer; Florian,9999,0,9999,0
1668135913959,ECE 200,027,103612,Milstein; Laurence B.,9999,0,9999,0
1668135913959,ECE 200,028,103613,Mir Arabbaygi; Siavash,9999,0,9999,0
1668135913959,ECE 200,029,103614,Mookherjea; Shayan,9999,0,9999,0
1668135913959,ECE 200,030,103615,Morris; Karcher William,9999,0,9999,0
1668135913959,ECE 200,031,103616,Ng; Tse Nga,9999,0,9999,0
1668135913959,ECE 200,032,103617,Nguyen; Truong Quang,9999,0,9999,0
1668135913959,ECE 200,033,103618,Nomura; Kenji,9999,0,9999,0
1668135913959,ECE 200,034,103619,Orlitsky; Alon,9999,0,9999,0
1668135913959,ECE 200,035,103620,Pal; Piya,9999,0,9999,0
1668135913959,ECE 200,036,103621,Papen; George C.,9999,0,9999,0
1668135913959,ECE 200,037,103622,Radic; Stojan,9999,0,9999,0
1668135913959,ECE 200,038,103623,Rao; Bhaskar D.,9999,0,9999,0
1668135913959,ECE 200,039,103624,Rao; Ramesh R,9999,0,9999,0
1668135913959,ECE 200,040,103625,Rebeiz; Gabriel,9999,0,9999,0
1668135913959,ECE 200,041,103626,Sanford; John R,9999,0,9999,0
1668135913959,ECE 200,042,103627,Siegel; Paul H.,9999,0,9999,0
1668135913959,ECE 200,043,103628,Sievenpiper; Daniel F.,9999,0,9999,0
1668135913959,ECE 200,044,103629,Sworder; David D.,9999,0,9999,0
1668135913959,ECE 200,045,103630,Taur; Yuan,9999,0,9999,0
1668135913959,ECE 200,046,103631,Touri; Behrouz,9999,0,9999,0
1668135913959,ECE 200,047,103632,Trivedi; Mohan M.,9999,0,9999,0
1668135913959,ECE 200,048,103633,Vasconcelos; Nuno,9999,0,9999,0
1668135913959,ECE 200,049,103634,Wang; Xiaolong,9999,0,9999,0
1668135913959,ECE 200,050,103635,Xie; Pengtao,9999,0,9999,0
1668135913959,ECE 200,051,103636,Yip; Michael,9999,0,9999,0
1668135913959,ECE 200,052,103637,Zeger; Kenneth A.,999,0,999,0
1668135913959,ECE 200,053,103638,Zhang; Xinyu,9999,0,9999,0
1668135913959,ECE 200,054,103639,Turakhia; Yatish Girish,9999,0,9999,0
1668135913959,ECE 200,055,103640,Kang; Mingu,9999,0,9999,0
1668135913959,ECE 200,056,103641,Shi; Yuanyuan,9999,0,9999,0
1668135913959,ECE 200,057,103642,Wang; Edward Jay,9999,0,9999,0
1668135913959,ECE 200,058,103643,Zheng; Yang,9999,0,9999,0
1668135914392,ECE 202,A00,103644,Kuzum; Duygu,0,0,0,0
1668135914819,ECE 212BN,A00,103646,Ng; Tse Nga,0,0,0,0
1668135915242,ECE 221,A00,111493,Staff,0,0,0,0
1668135915668,ECE 222B,A00,103647,Lomakin; Vitaliy,0,0,0,0
1668135916092,ECE 230B,A00,103648,Taur; Yuan,0,0,0,0
1668135916521,ECE 238B,A00,103649,Garay; Javier,0,0,0,0
1668135916950,ECE 240B,A00,112900,Fainman; Yeshaiahu,0,0,0,0
1668135917377,ECE 247A,A00,103650,Jokerst; Jesse Vincent,0,0,0,0
1668135917814,ECE 247B,A00,103651,Wang; Joseph,0,0,0,0
1668135918246,ECE 250,A00,103652,Siegel; Paul H.,0,0,0,0
1668135918669,ECE 251A,A00,103654,Rao; Bhaskar D.,0,0,0,0
1668135919093,ECE 257B,A00,103655,Bharadia; Dinesh,0,0,0,0
1668135919526,ECE 258A,A00,103656,Milstein; Laurence B.,0,0,0,0
1668135919956,ECE 260B,A00,103658,Kang; Mingu,0,0,0,0
1668135920392,ECE 264A,A00,103659,Galton; Ian A,0,0,0,0
1668135920824,ECE 265A,A00,103661,Gudem; Prasad S.S.,0,0,0,0
1668135921262,ECE 265D,A00,103662,Gudem; Prasad S.S.,0,0,0,0
1668135921687,ECE 268,A00,103663,Koushanfar; Farinaz,0,0,0,0
1668135922116,ECE 269,A01,103665,Pal; Piya,0,0,0,0
1668135922543,ECE 271B,A00,103666,Vasconcelos; Manuela,0,0,0,0
1668135922970,ECE 276A,A00,103667,Atanasov; Nikolay A.,0,0,0,0
1668135923398,ECE 277,A00,103668,An; Cheolhong,0,0,0,0
1668135923821,ECE 279,A00,117947,Hall; Drew A.,0,0,0,0
1668135924666,ECE 283,A00,103670,Hsueh; Tzu-Chien,0,0,0,0
1668135925089,ECE 284,A00,103671,Turakhia; Yatish Girish,0,0,0,0
1668135925518,ECE 285,A00,103672,Zheng; Yang,0,0,0,0
1668135925518,ECE 285,B00,103673,Sworder; David D.,0,0,0,0
1668135925947,ECE 287,A00,103676,Javidi; Tara,0,0,0,0
1668135926370,MATH 200B,A00,098023,Salehi Golsefidy; Alireza,12,0,15,3
1668135926798,MATH 202B,A00,098024,Rhoades; Brendon Patrick,9,0,15,6
1668135927224,MATH 203B,A00,098025,Oprea; Dragos N.,10,0,15,5
1668135927648,MATH 204B,A00,098026,Sorensen; Claus M,13,0,15,2
1668135928078,MATH 208,A00,098027,Izadi; Elham,7,0,10,3
1668135928504,MATH 209,A00,098028,Pollack; Aaron,10,0,10,0
1668135928928,MATH 211A,A00,112919,Rogalski; Daniel,9,0,10,1
1668135929370,MATH 211B,A00,112920,Seward; Brandon M.,9,0,10,1
1668135929802,MATH 218,A00,098029,Li; Bo,10,0,10,0
1668135930235,MATH 220B,A00,098030,Novak; Jonathan I,11,0,15,4
1668135930659,MATH 221A,A00,098031,Ebenfelt; Peter F,13,0,15,2
1668135931084,MATH 231B,A00,098032,Zlatos; Andrej,12,0,15,3
1668135931509,MATH 240B,A00,098033,Ni; Lei,9,0,15,6
1668135931935,MATH 243,A00,098034,Jekel; David Andrew,10,0,10,0
1668135932359,MATH 245A,A00,098035,Nie; Jiawang,0,0,15,16
1668135932793,MATH 248,A00,098036,Bejenaru; Ioan,10,0,10,0
1668135933217,MATH 250B,A00,098037,Spolaor; Luca,14,0,15,1
1668135933642,MATH 258,A00,098038,Ni; Lei,10,0,10,0
1668135934066,MATH 264B,A00,098041,Rhoades; Brendon Patrick,9,0,15,6
1668135934501,MATH 268,A00,098042,Buss; Samuel R,10,0,10,0
1668135934923,MATH 269,A00,098043,Rhoades; Brendon Patrick,10,0,10,0
1668135935363,MATH 270B,A00,098044,Li; Bo,10,0,15,5
1668135935790,MATH 272B,A00,098045,Holst; Michael J,13,0,15,2
1668135936224,MATH 273A,A00,098046,Tian; Xiaochuan,10,0,15,5
1668135936665,MATH 275,A01,098048,Tian; Xiaochuan,6,0,10,4
1668135937096,MATH 278A,A00,098049,Holst; Michael J,8,0,10,2
1668135937519,MATH 278B,A00,098050,Cloninger; Alexander,10,0,10,0
1668135937947,MATH 278C,A00,098051,Nie; Jiawang,7,0,10,3
1668135938380,MATH 280B,A00,098052,Zheng; Tianyi,10,0,15,5
1668135938807,MATH 281B,A00,098053,Bradic; Jelena,2,0,15,13
1668135939232,MATH 282B,A00,098054,Arias-Castro; Ery,0,0,15,15
1668135939655,MATH 285,A00,098055,Fitzsimmons; Patrick J,0,0,15,17
1668135940084,MATH 287B,A00,098056,Arias-Castro; Ery,2,0,15,13
1668135940515,MATH 288,A00,098057,Agarwal; Pooja,9,0,10,1
1668135940515,MATH 288,B00,098058,Zhang; Danna,8,0,10,2
1668135940515,MATH 288,C00,098059,Williams; Ruth J,10,0,10,0
1668135940939,MATH 290B,A00,098060,Roberts; Justin Deritter,13,0,15,2
1668135941365,MATH 292,A00,098061,Belmont; Eva Kinoshita,10,0,10,0
1668135941788,MATH 295,A00,098062,Suk; Andrew Hoon,48,0,50,2
1668135942211,MATH 296,A00,098063,Novak; Jonathan I,20,0,20,0
1668135942638,MATH 297,001,098064,Gamst; Anthony Collins,9997,0,9999,2
1668136446937,COGS 205,A00,101395,Chiba; Andrea,19,0,20,1
1668136447373,COGS 210B,001,101404,Greene; Deanna Jacquelyn,9998,0,9999,1
1668136447373,COGS 210B,002,101417,Xia; Haijun,9999,0,9999,0
1668136447373,COGS 210B,003,101422,Nitz; Douglas A.,9999,0,9999,0
1668136447373,COGS 210B,004,101423,Hollan; James D.,9998,0,9999,1
1668136447373,COGS 210B,005,101424,Deak; Gedeon O.,9998,0,9999,1
1668136447373,COGS 210B,006,101425,Rossano; Federico,9999,0,9999,0
1668136447812,COGS 211B,A00,101427,Coulson; Seana M,9996,0,9999,3
1668136448238,COGS 220,A00,101428,Hollan; James D.,0,0,25,25
1668136448678,COGS 229,A00,101429,Dow; Steven P,18,0,25,7
1668136449103,COGS 230,A00,101430,Klemmer; Scott R,12,0,17,5
1668136449529,COGS 234,A00,101431,Xia; Haijun,3,0,25,22
1668136449961,COGS 260,A00,101432,Kiyonaga; Anastasia,20,0,25,5
1668136449961,COGS 260,B00,101433,Kirsh; David Joel,16,0,25,9
1668136450385,CSE 202,A00,102371,Impagliazzo; Russell,0,0,0,0
1668136450809,CSE 203B,A01,102373,Cheng; Chung Kuan,0,0,0,0
1668136451238,CSE 208,A00,102374,Micciancio; Daniele,0,0,0,0
1668136451679,CSE 209A,A00,112895,Impagliazzo; Russell,0,0,15,15
1668136452103,CSE 209B,A00,108005,Bellare; Mihir,0,0,0,0
1668136452549,CSE 210,A00,113163,Coblenz; Michael J,0,0,0,0
1668136452981,CSE 219,A00,106111,Dow; Steven P,0,0,20,20
1668136453409,CSE 221,A00,102376,Voelker; Geoffrey M.,0,0,0,0
1668136453846,CSE 224,A01,102378,Porter; George M,0,0,0,0
1668136454290,CSE 229A,A00,102379,Savage; Stefan,0,0,0,0
1668136454724,CSE 229C,A00,102380,Munyaka; Imani N. S.,0,0,0,0
1668136455146,CSE 232B,A00,102382,Deutsch; Alin Bernard,0,0,0,0
1668136455584,CSE 234,A01,112904,Kumar; Arun Kumar,0,0,0,0
1668136456006,CSE 237A,A00,102383,Rosing; Tajana Simunic,0,0,0,0
1668136456444,CSE 239A,A00,102384,Deutsch; Alin Bernard,0,0,0,0
1668136456868,CSE 239B,A00,102385,Polikarpova; Nadezhda,0,0,0,0
1668136457298,CSE 240A,A00,102386,Pannuto; Patrick William,0,0,0,0
1668136457724,CSE 240B,A00,102387,Zhao; Jishen,0,0,0,0
1668136458158,CSE 241A,A00,106406,Kang; Mingu,0,0,0,0
1668136458586,CSE 249B,A00,102388,Kahng; Andrew Byun,0,0,8,8
1668136459008,CSE 251B,A01,102392,Cottrell; Garrison W,0,0,0,0
1668136459008,CSE 251B,A02,102393,Cottrell; Garrison W,0,0,0,0
1668136459431,CSE 252B,A00,102394,Ochoa; Benjamin Lawrence,0,0,0,0
1668136459864,CSE 257,A01,102396,Gao; Sicun,0,0,0,0
1668136460311,CSE 272,A00,102397,Li; Tzumao,0,0,0,0
1668136460740,CSE 274,A00,111323,Chern; Albert Ren-Haur,0,0,0,0
1668136461164,CSE 282,A00,102398,Pevzner; Pavel Arkadjevich,0,0,0,0
1668136461604,CSE 284,A00,114175,Gymrek; Melissa Ann,0,0,0,0
1668136462031,CSE 290,A00,102399,Chandraker; Manmohan Krishna,0,0,0,0
1668136462031,CSE 290,B00,102400,Vaccaro; Kristen Marie,0,0,25,25
1668136462031,CSE 290,C00,102414,Pannuto; Patrick William,0,0,25,25
1668136462031,CSE 290,D00,102427,Pevzner; Pavel Arkadjevich,0,0,0,0
1668136462031,CSE 290,E00,102429,Zhao; Jishen,0,0,0,0
1668136462031,CSE 290,F00,102436,Tullsen; Dean Michael,0,0,0,0
1668136462031,CSE 290,G00,102440,Christensen; Henrik I,0,0,20,20
1668136462456,CSE 291,A00,102443,Su; Hao,0,0,0,0
1668136462456,CSE 291,B00,102448,Polikarpova; Nadezhda,0,0,0,0
1668136462456,CSE 291,C00,102453,Vaccaro; Kristen Marie,0,0,0,0
1668136462456,CSE 291,D00,111343,Savage; Stefan,0,0,0,0
1668136462456,CSE 291,E00,116474,Claffy; Kimberly Claire,0,0,0,0
1668136462456,CSE 291,F00,116479,Pasquale; Joseph,0,0,0,0
1668136462894,CSE 293,001,119111,Bafna; Vineet,9999,0,9999,0
1668136462894,CSE 293,002,119118,Bellare; Mihir,9999,0,9999,0
1668136462894,CSE 293,003,119122,Berg-Kirkpatrick; Taylor D,9999,0,9999,0
1668136462894,CSE 293,004,119135,Christensen; Henrik I,9999,0,9999,0
1668136462894,CSE 293,005,119142,Cottrell; Garrison W,9999,0,9999,0
1668136462894,CSE 293,006,119146,Deutsch; Alin Bernard,9999,0,9999,0
1668136462894,CSE 293,007,119159,Esmaeilzadeh; Hadi,9999,0,9999,0
1668136462894,CSE 293,008,119166,Freund; Yoav,9999,0,9999,0
1668136462894,CSE 293,009,119170,Griswold; William G.,9999,0,9999,0
1668136462894,CSE 293,010,119183,Gymrek; Melissa Ann,9999,0,9999,0
1668136462894,CSE 293,011,119190,Heninger; Nadia A,9999,0,9999,0
1668136462894,CSE 293,012,119230,Impagliazzo; Russell,9999,0,9999,0
1668136462894,CSE 293,013,119232,Jhala; Ranjit,9999,0,9999,0
1668136462894,CSE 293,014,119233,Kahng; Andrew Byun,9999,0,9999,0
1668136462894,CSE 293,015,119298,Kane; Daniel Mertz,9999,0,9999,0
1668136462894,CSE 293,016,119299,Kriegman; David J,9999,0,9999,0
1668136462894,CSE 293,017,119300,Kumar; Arun Kumar,9999,0,9999,0
1668136462894,CSE 293,018,119301,Lerner; Sorin,9999,0,9999,0
1668136462894,CSE 293,019,119302,Lovett; Shachar,9999,0,9999,0
1668136462894,CSE 293,020,119303,McAuley; Julian John,9999,0,9999,0
1668136462894,CSE 293,021,119304,Micciancio; Daniele,9999,0,9999,0
1668136462894,CSE 293,022,119367,Orailoglu; Alex,9999,0,9999,0
1668136462894,CSE 293,023,119382,Paturi; Ramamohan,9999,0,9999,0
1668136462894,CSE 293,024,119404,Polikarpova; Nadezhda,9999,0,9999,0
1668136462894,CSE 293,025,119406,Politz; Joseph Gibbs,9999,0,9999,0
1668136462894,CSE 293,026,119411,Porter; George M,9999,0,9999,0
1668136462894,CSE 293,027,119414,Porter; Leonard Emerson,9999,0,9999,0
1668136462894,CSE 293,028,119416,Ramamoorthi; Ravi,9999,0,9999,0
1668136462894,CSE 293,029,119417,Sahoo; Debashis,9999,0,9999,0
1668136462894,CSE 293,030,119420,Saul; Lawrence,9999,0,9999,0
1668136462894,CSE 293,031,119421,Savage; Stefan,9999,0,9999,0
1668136462894,CSE 293,032,119425,Schulze; Jurgen P.,9999,0,9999,0
1668136462894,CSE 293,033,119426,Snoeren; Alex C.,9999,0,9999,0
1668136462894,CSE 293,034,119428,Shang; Jingbo,9999,0,9999,0
1668136462894,CSE 293,035,119430,Stefan; Deian,9999,0,9999,0
1668136462894,CSE 293,036,119431,Su; Hao,9999,0,9999,0
1668136462894,CSE 293,037,119433,Swanson; Steven James,9999,0,9999,0
1668136462894,CSE 293,038,119435,Tullsen; Dean Michael,9999,0,9999,0
1668136462894,CSE 293,039,119483,Voelker; Geoffrey M.,9999,0,9999,0
1668136462894,CSE 293,040,119537,Zhao; Jishen,9999,0,9999,0
1668136462894,CSE 293,041,119538,Zhou; Yuan-Yuan,9999,0,9999,0
1668136462894,CSE 293,042,119539,Gao; Sicun,9999,0,9999,0
1668136462894,CSE 293,043,119540,Weibel; Nadir,9999,0,9999,0
1668136462894,CSE 293,044,119541,Gupta; Rajesh K.,9999,0,9999,0
1668136462894,CSE 293,045,126410,Vaccaro; Kristen Marie,9999,0,9999,0
1668136462894,CSE 293,046,126411,Klemke; Richard,9999,0,9999,0
1668136463322,CSE 294,A00,102459,Voelker; Geoffrey M.,0,0,0,0
1668136463322,CSE 294,B00,111322,Orailoglu; Alex,0,0,0,0
1668136463749,DSE 201,A00,096914,Deutsch; Alin Bernard,30,0,30,0
1668136464173,DSE 210,A00,096915,Dasgupta; Sanjoy,30,0,30,0
1668136464603,DSE 260A,A00,096916,Altintas De Callaf; Ilkay,30,0,30,0
1668136465048,ECE 200,001,103586,Antipa; Nicholas A,9999,0,9999,0
1668136465048,ECE 200,002,103587,Atanasov; Nikolay A.,9999,0,9999,0
1668136465048,ECE 200,003,103588,Bharadia; Dinesh,9999,0,9999,0
1668136465048,ECE 200,004,103589,Cheng; Chung Kuan,9999,0,9999,0
1668136465048,ECE 200,005,103590,Cosman; Pamela C.,9999,0,9999,0
1668136465048,ECE 200,006,103591,Dayeh; Shadi Ahmad,9999,0,9999,0
1668136465048,ECE 200,007,103592,Fainman; Yeshaiahu,9999,0,9999,0
1668136465048,ECE 200,008,103593,Ford; Joseph Earl,9999,0,9999,0
1668136465048,ECE 200,009,103594,Franceschetti; Massimo,9999,0,9999,0
1668136465048,ECE 200,010,103595,Fullerton; Eric E,9999,0,9999,0
1668136465048,ECE 200,011,103596,Galton; Ian A,9999,0,9999,0
1668136465048,ECE 200,012,103597,Gilja; Vikash,9999,0,9999,0
1668136465048,ECE 200,013,103598,Hall; Drew A.,9999,0,9999,0
1668136465048,ECE 200,014,103599,Hsueh; Tzu-Chien,9999,0,9999,0
1668136465048,ECE 200,015,103600,Javidi; Tara,9999,0,9999,0
1668136465048,ECE 200,016,103601,Kahng; Andrew Byun,9999,0,9999,0
1668136465048,ECE 200,017,103602,Kim; Young-Han,9999,0,9999,0
1668136465048,ECE 200,018,103603,Koushanfar; Farinaz,9999,0,9999,0
1668136465048,ECE 200,019,103604,Kuzum; Duygu,9999,0,9999,0
1668136465048,ECE 200,020,103605,Le; Hanh-Phuc,9999,0,9999,0
1668136465048,ECE 200,021,103606,Lin; Bill,9999,0,9999,0
1668136465048,ECE 200,022,103607,Liu; Zhaowei,9998,0,9999,1
1668136465048,ECE 200,023,103608,Lo; Yu-Hwa,9999,0,9999,0
1668136465048,ECE 200,024,103609,Lomakin; Vitaliy,9999,0,9999,0
1668136465048,ECE 200,025,103610,Mercier; Patrick Philip,9999,0,9999,0
1668136465048,ECE 200,026,103611,Meyer; Florian,9999,0,9999,0
1668136465048,ECE 200,027,103612,Milstein; Laurence B.,9999,0,9999,0
1668136465048,ECE 200,028,103613,Mir Arabbaygi; Siavash,9999,0,9999,0
1668136465048,ECE 200,029,103614,Mookherjea; Shayan,9999,0,9999,0
1668136465048,ECE 200,030,103615,Morris; Karcher William,9999,0,9999,0
1668136465048,ECE 200,031,103616,Ng; Tse Nga,9999,0,9999,0
1668136465048,ECE 200,032,103617,Nguyen; Truong Quang,9999,0,9999,0
1668136465048,ECE 200,033,103618,Nomura; Kenji,9999,0,9999,0
1668136465048,ECE 200,034,103619,Orlitsky; Alon,9999,0,9999,0
1668136465048,ECE 200,035,103620,Pal; Piya,9999,0,9999,0
1668136465048,ECE 200,036,103621,Papen; George C.,9999,0,9999,0
1668136465048,ECE 200,037,103622,Radic; Stojan,9999,0,9999,0
1668136465048,ECE 200,038,103623,Rao; Bhaskar D.,9999,0,9999,0
1668136465048,ECE 200,039,103624,Rao; Ramesh R,9999,0,9999,0
1668136465048,ECE 200,040,103625,Rebeiz; Gabriel,9999,0,9999,0
1668136465048,ECE 200,041,103626,Sanford; John R,9999,0,9999,0
1668136465048,ECE 200,042,103627,Siegel; Paul H.,9999,0,9999,0
1668136465048,ECE 200,043,103628,Sievenpiper; Daniel F.,9999,0,9999,0
1668136465048,ECE 200,044,103629,Sworder; David D.,9999,0,9999,0
1668136465048,ECE 200,045,103630,Taur; Yuan,9999,0,9999,0
1668136465048,ECE 200,046,103631,Touri; Behrouz,9999,0,9999,0
1668136465048,ECE 200,047,103632,Trivedi; Mohan M.,9999,0,9999,0
1668136465048,ECE 200,048,103633,Vasconcelos; Nuno,9999,0,9999,0
1668136465048,ECE 200,049,103634,Wang; Xiaolong,9999,0,9999,0
1668136465048,ECE 200,050,103635,Xie; Pengtao,9999,0,9999,0
1668136465048,ECE 200,051,103636,Yip; Michael,9999,0,9999,0
1668136465048,ECE 200,052,103637,Zeger; Kenneth A.,999,0,999,0
1668136465048,ECE 200,053,103638,Zhang; Xinyu,9999,0,9999,0
1668136465048,ECE 200,054,103639,Turakhia; Yatish Girish,9999,0,9999,0
1668136465048,ECE 200,055,103640,Kang; Mingu,9999,0,9999,0
1668136465048,ECE 200,056,103641,Shi; Yuanyuan,9999,0,9999,0
1668136465048,ECE 200,057,103642,Wang; Edward Jay,9999,0,9999,0
1668136465048,ECE 200,058,103643,Zheng; Yang,9999,0,9999,0
1668136465473,ECE 202,A00,103644,Kuzum; Duygu,0,0,0,0
1668136465894,ECE 212BN,A00,103646,Ng; Tse Nga,0,0,0,0
1668136466324,ECE 221,A00,111493,Staff,0,0,0,0
1668136466750,ECE 222B,A00,103647,Lomakin; Vitaliy,0,0,0,0
1668136467180,ECE 230B,A00,103648,Taur; Yuan,0,0,0,0
1668136467607,ECE 238B,A00,103649,Garay; Javier,0,0,0,0
1668136468046,ECE 240B,A00,112900,Fainman; Yeshaiahu,0,0,0,0
1668136468471,ECE 247A,A00,103650,Jokerst; Jesse Vincent,0,0,0,0
1668136468897,ECE 247B,A00,103651,Wang; Joseph,0,0,0,0
1668136469413,ECE 250,A00,103652,Siegel; Paul H.,0,0,0,0
1668136469845,ECE 251A,A00,103654,Rao; Bhaskar D.,0,0,0,0
1668136470270,ECE 257B,A00,103655,Bharadia; Dinesh,0,0,0,0
1668136470701,ECE 258A,A00,103656,Milstein; Laurence B.,0,0,0,0
1668136471131,ECE 260B,A00,103658,Kang; Mingu,0,0,0,0
1668136471558,ECE 264A,A00,103659,Galton; Ian A,0,0,0,0
1668136471990,ECE 265A,A00,103661,Gudem; Prasad S.S.,0,0,0,0
1668136472415,ECE 265D,A00,103662,Gudem; Prasad S.S.,0,0,0,0
1668136472839,ECE 268,A00,103663,Koushanfar; Farinaz,0,0,0,0
1668136473273,ECE 269,A01,103665,Pal; Piya,0,0,0,0
1668136473707,ECE 271B,A00,103666,Vasconcelos; Manuela,0,0,0,0
1668136474132,ECE 276A,A00,103667,Atanasov; Nikolay A.,0,0,0,0
1668136474566,ECE 277,A00,103668,An; Cheolhong,0,0,0,0
1668136474990,ECE 279,A00,117947,Hall; Drew A.,0,0,0,0
1668136475852,ECE 283,A00,103670,Hsueh; Tzu-Chien,0,0,0,0
1668136476282,ECE 284,A00,103671,Turakhia; Yatish Girish,0,0,0,0
1668136476708,ECE 285,A00,103672,Zheng; Yang,0,0,0,0
1668136476708,ECE 285,B00,103673,Sworder; David D.,0,0,0,0
1668136477142,ECE 287,A00,103676,Javidi; Tara,0,0,0,0
1668136477566,MATH 200B,A00,098023,Salehi Golsefidy; Alireza,12,0,15,3
1668136477990,MATH 202B,A00,098024,Rhoades; Brendon Patrick,9,0,15,6
1668136478418,MATH 203B,A00,098025,Oprea; Dragos N.,10,0,15,5
1668136478841,MATH 204B,A00,098026,Sorensen; Claus M,13,0,15,2
1668136479270,MATH 208,A00,098027,Izadi; Elham,7,0,10,3
1668136479695,MATH 209,A00,098028,Pollack; Aaron,10,0,10,0
1668136480118,MATH 211A,A00,112919,Rogalski; Daniel,9,0,10,1
1668136480555,MATH 211B,A00,112920,Seward; Brandon M.,9,0,10,1
1668136480981,MATH 218,A00,098029,Li; Bo,10,0,10,0
1668136481404,MATH 220B,A00,098030,Novak; Jonathan I,11,0,15,4
1668136481839,MATH 221A,A00,098031,Ebenfelt; Peter F,13,0,15,2
1668136482268,MATH 231B,A00,098032,Zlatos; Andrej,12,0,15,3
1668136482696,MATH 240B,A00,098033,Ni; Lei,9,0,15,6
1668136483118,MATH 243,A00,098034,Jekel; David Andrew,10,0,10,0
1668136483542,MATH 245A,A00,098035,Nie; Jiawang,0,0,15,16
1668136483968,MATH 248,A00,098036,Bejenaru; Ioan,10,0,10,0
1668136484396,MATH 250B,A00,098037,Spolaor; Luca,14,0,15,1
1668136484821,MATH 258,A00,098038,Ni; Lei,10,0,10,0
1668136485418,MATH 264B,A00,098041,Rhoades; Brendon Patrick,9,0,15,6
1668136485850,MATH 268,A00,098042,Buss; Samuel R,10,0,10,0
1668136486289,MATH 269,A00,098043,Rhoades; Brendon Patrick,10,0,10,0
1668136486720,MATH 270B,A00,098044,Li; Bo,10,0,15,5
1668136487166,MATH 272B,A00,098045,Holst; Michael J,13,0,15,2
1668136487595,MATH 273A,A00,098046,Tian; Xiaochuan,10,0,15,5
1668136488029,MATH 275,A01,098048,Tian; Xiaochuan,6,0,10,4
1668136488455,MATH 278A,A00,098049,Holst; Michael J,8,0,10,2
1668136488882,MATH 278B,A00,098050,Cloninger; Alexander,10,0,10,0
1668136489309,MATH 278C,A00,098051,Nie; Jiawang,7,0,10,3
1668136489746,MATH 280B,A00,098052,Zheng; Tianyi,10,0,15,5
1668136490171,MATH 281B,A00,098053,Bradic; Jelena,2,0,15,13
1668136490598,MATH 282B,A00,098054,Arias-Castro; Ery,0,0,15,15
1668136491022,MATH 285,A00,098055,Fitzsimmons; Patrick J,0,0,15,17
1668136491444,MATH 287B,A00,098056,Arias-Castro; Ery,2,0,15,13
1668136491868,MATH 288,A00,098057,Agarwal; Pooja,9,0,10,1
1668136491868,MATH 288,B00,098058,Zhang; Danna,8,0,10,2
1668136491868,MATH 288,C00,098059,Williams; Ruth J,10,0,10,0
1668136492304,MATH 290B,A00,098060,Roberts; Justin Deritter,13,0,15,2
1668136492727,MATH 292,A00,098061,Belmont; Eva Kinoshita,10,0,10,0
1668136493163,MATH 295,A00,098062,Suk; Andrew Hoon,48,0,50,2
1668136493587,MATH 296,A00,098063,Novak; Jonathan I,20,0,20,0
1668136494015,MATH 297,001,098064,Gamst; Anthony Collins,9997,0,9999,2
1668136997502,COGS 205,A00,101395,Chiba; Andrea,19,0,20,1
1668136997930,COGS 210B,001,101404,Greene; Deanna Jacquelyn,9998,0,9999,1
1668136997930,COGS 210B,002,101417,Xia; Haijun,9999,0,9999,0
1668136997930,COGS 210B,003,101422,Nitz; Douglas A.,9999,0,9999,0
1668136997930,COGS 210B,004,101423,Hollan; James D.,9998,0,9999,1
1668136997930,COGS 210B,005,101424,Deak; Gedeon O.,9998,0,9999,1
1668136997930,COGS 210B,006,101425,Rossano; Federico,9999,0,9999,0
1668136998354,COGS 211B,A00,101427,Coulson; Seana M,9996,0,9999,3
1668136998777,COGS 220,A00,101428,Hollan; James D.,0,0,25,25
1668136999199,COGS 229,A00,101429,Dow; Steven P,18,0,25,7
1668136999624,COGS 230,A00,101430,Klemmer; Scott R,12,0,17,5
1668137000057,COGS 234,A00,101431,Xia; Haijun,3,0,25,22
1668137000486,COGS 260,A00,101432,Kiyonaga; Anastasia,20,0,25,5
1668137000486,COGS 260,B00,101433,Kirsh; David Joel,16,0,25,9
1668137000939,CSE 202,A00,102371,Impagliazzo; Russell,0,0,0,0
1668137001374,CSE 203B,A01,102373,Cheng; Chung Kuan,0,0,0,0
1668137001805,CSE 208,A00,102374,Micciancio; Daniele,0,0,0,0
1668137002242,CSE 209A,A00,112895,Impagliazzo; Russell,0,0,15,15
1668137002665,CSE 209B,A00,108005,Bellare; Mihir,0,0,0,0
1668137003090,CSE 210,A00,113163,Coblenz; Michael J,0,0,0,0
1668137003513,CSE 219,A00,106111,Dow; Steven P,0,0,20,20
1668137003939,CSE 221,A00,102376,Voelker; Geoffrey M.,0,0,0,0
1668137004377,CSE 224,A01,102378,Porter; George M,0,0,0,0
1668137004802,CSE 229A,A00,102379,Savage; Stefan,0,0,0,0
1668137005228,CSE 229C,A00,102380,Munyaka; Imani N. S.,0,0,0,0
1668137005652,CSE 232B,A00,102382,Deutsch; Alin Bernard,0,0,0,0
1668137006091,CSE 234,A01,112904,Kumar; Arun Kumar,0,0,0,0
1668137006526,CSE 237A,A00,102383,Rosing; Tajana Simunic,0,0,0,0
1668137006956,CSE 239A,A00,102384,Deutsch; Alin Bernard,0,0,0,0
1668137007382,CSE 239B,A00,102385,Polikarpova; Nadezhda,0,0,0,0
1668137007805,CSE 240A,A00,102386,Pannuto; Patrick William,0,0,0,0
1668137008230,CSE 240B,A00,102387,Zhao; Jishen,0,0,0,0
1668137008654,CSE 241A,A00,106406,Kang; Mingu,0,0,0,0
1668137009084,CSE 249B,A00,102388,Kahng; Andrew Byun,0,0,8,8
1668137009511,CSE 251B,A01,102392,Cottrell; Garrison W,0,0,0,0
1668137009511,CSE 251B,A02,102393,Cottrell; Garrison W,0,0,0,0
1668137009935,CSE 252B,A00,102394,Ochoa; Benjamin Lawrence,0,0,0,0
1668137010362,CSE 257,A01,102396,Gao; Sicun,0,0,0,0
1668137010786,CSE 272,A00,102397,Li; Tzumao,0,0,0,0
1668137011209,CSE 274,A00,111323,Chern; Albert Ren-Haur,0,0,0,0
1668137011636,CSE 282,A00,102398,Pevzner; Pavel Arkadjevich,0,0,0,0
1668137012062,CSE 284,A00,114175,Gymrek; Melissa Ann,0,0,0,0
1668137012498,CSE 290,A00,102399,Chandraker; Manmohan Krishna,0,0,0,0
1668137012498,CSE 290,B00,102400,Vaccaro; Kristen Marie,0,0,25,25
1668137012498,CSE 290,C00,102414,Pannuto; Patrick William,0,0,25,25
1668137012498,CSE 290,D00,102427,Pevzner; Pavel Arkadjevich,0,0,0,0
1668137012498,CSE 290,E00,102429,Zhao; Jishen,0,0,0,0
1668137012498,CSE 290,F00,102436,Tullsen; Dean Michael,0,0,0,0
1668137012498,CSE 290,G00,102440,Christensen; Henrik I,0,0,20,20
1668137012929,CSE 291,A00,102443,Su; Hao,0,0,0,0
1668137012929,CSE 291,B00,102448,Polikarpova; Nadezhda,0,0,0,0
1668137012929,CSE 291,C00,102453,Vaccaro; Kristen Marie,0,0,0,0
1668137012929,CSE 291,D00,111343,Savage; Stefan,0,0,0,0
1668137012929,CSE 291,E00,116474,Claffy; Kimberly Claire,0,0,0,0
1668137012929,CSE 291,F00,116479,Pasquale; Joseph,0,0,0,0
1668137013368,CSE 293,001,119111,Bafna; Vineet,9999,0,9999,0
1668137013368,CSE 293,002,119118,Bellare; Mihir,9999,0,9999,0
1668137013368,CSE 293,003,119122,Berg-Kirkpatrick; Taylor D,9999,0,9999,0
1668137013368,CSE 293,004,119135,Christensen; Henrik I,9999,0,9999,0
1668137013368,CSE 293,005,119142,Cottrell; Garrison W,9999,0,9999,0
1668137013368,CSE 293,006,119146,Deutsch; Alin Bernard,9999,0,9999,0
1668137013368,CSE 293,007,119159,Esmaeilzadeh; Hadi,9999,0,9999,0
1668137013368,CSE 293,008,119166,Freund; Yoav,9999,0,9999,0
1668137013368,CSE 293,009,119170,Griswold; William G.,9999,0,9999,0
1668137013368,CSE 293,010,119183,Gymrek; Melissa Ann,9999,0,9999,0
1668137013368,CSE 293,011,119190,Heninger; Nadia A,9999,0,9999,0
1668137013368,CSE 293,012,119230,Impagliazzo; Russell,9999,0,9999,0
1668137013368,CSE 293,013,119232,Jhala; Ranjit,9999,0,9999,0
1668137013368,CSE 293,014,119233,Kahng; Andrew Byun,9999,0,9999,0
1668137013368,CSE 293,015,119298,Kane; Daniel Mertz,9999,0,9999,0
1668137013368,CSE 293,016,119299,Kriegman; David J,9999,0,9999,0
1668137013368,CSE 293,017,119300,Kumar; Arun Kumar,9999,0,9999,0
1668137013368,CSE 293,018,119301,Lerner; Sorin,9999,0,9999,0
1668137013368,CSE 293,019,119302,Lovett; Shachar,9999,0,9999,0
1668137013368,CSE 293,020,119303,McAuley; Julian John,9999,0,9999,0
1668137013368,CSE 293,021,119304,Micciancio; Daniele,9999,0,9999,0
1668137013368,CSE 293,022,119367,Orailoglu; Alex,9999,0,9999,0
1668137013368,CSE 293,023,119382,Paturi; Ramamohan,9999,0,9999,0
1668137013368,CSE 293,024,119404,Polikarpova; Nadezhda,9999,0,9999,0
1668137013368,CSE 293,025,119406,Politz; Joseph Gibbs,9999,0,9999,0
1668137013368,CSE 293,026,119411,Porter; George M,9999,0,9999,0
1668137013368,CSE 293,027,119414,Porter; Leonard Emerson,9999,0,9999,0
1668137013368,CSE 293,028,119416,Ramamoorthi; Ravi,9999,0,9999,0
1668137013368,CSE 293,029,119417,Sahoo; Debashis,9999,0,9999,0
1668137013368,CSE 293,030,119420,Saul; Lawrence,9999,0,9999,0
1668137013368,CSE 293,031,119421,Savage; Stefan,9999,0,9999,0
1668137013368,CSE 293,032,119425,Schulze; Jurgen P.,9999,0,9999,0
1668137013368,CSE 293,033,119426,Snoeren; Alex C.,9999,0,9999,0
1668137013368,CSE 293,034,119428,Shang; Jingbo,9999,0,9999,0
1668137013368,CSE 293,035,119430,Stefan; Deian,9999,0,9999,0
1668137013368,CSE 293,036,119431,Su; Hao,9999,0,9999,0
1668137013368,CSE 293,037,119433,Swanson; Steven James,9999,0,9999,0
1668137013368,CSE 293,038,119435,Tullsen; Dean Michael,9999,0,9999,0
1668137013368,CSE 293,039,119483,Voelker; Geoffrey M.,9999,0,9999,0
1668137013368,CSE 293,040,119537,Zhao; Jishen,9999,0,9999,0
1668137013368,CSE 293,041,119538,Zhou; Yuan-Yuan,9999,0,9999,0
1668137013368,CSE 293,042,119539,Gao; Sicun,9999,0,9999,0
1668137013368,CSE 293,043,119540,Weibel; Nadir,9999,0,9999,0
1668137013368,CSE 293,044,119541,Gupta; Rajesh K.,9999,0,9999,0
1668137013368,CSE 293,045,126410,Vaccaro; Kristen Marie,9999,0,9999,0
1668137013368,CSE 293,046,126411,Klemke; Richard,9999,0,9999,0
1668137013797,CSE 294,A00,102459,Voelker; Geoffrey M.,0,0,0,0
1668137013797,CSE 294,B00,111322,Orailoglu; Alex,0,0,0,0
1668137014222,DSE 201,A00,096914,Deutsch; Alin Bernard,30,0,30,0
1668137014647,DSE 210,A00,096915,Dasgupta; Sanjoy,30,0,30,0
1668137015070,DSE 260A,A00,096916,Altintas De Callaf; Ilkay,30,0,30,0
1668137015550,ECE 200,001,103586,Antipa; Nicholas A,9999,0,9999,0
1668137015550,ECE 200,002,103587,Atanasov; Nikolay A.,9999,0,9999,0
1668137015550,ECE 200,003,103588,Bharadia; Dinesh,9999,0,9999,0
1668137015550,ECE 200,004,103589,Cheng; Chung Kuan,9999,0,9999,0
1668137015550,ECE 200,005,103590,Cosman; Pamela C.,9999,0,9999,0
1668137015550,ECE 200,006,103591,Dayeh; Shadi Ahmad,9999,0,9999,0
1668137015550,ECE 200,007,103592,Fainman; Yeshaiahu,9999,0,9999,0
1668137015550,ECE 200,008,103593,Ford; Joseph Earl,9999,0,9999,0
1668137015550,ECE 200,009,103594,Franceschetti; Massimo,9999,0,9999,0
1668137015550,ECE 200,010,103595,Fullerton; Eric E,9999,0,9999,0
1668137015550,ECE 200,011,103596,Galton; Ian A,9999,0,9999,0
1668137015550,ECE 200,012,103597,Gilja; Vikash,9999,0,9999,0
1668137015550,ECE 200,013,103598,Hall; Drew A.,9999,0,9999,0
1668137015550,ECE 200,014,103599,Hsueh; Tzu-Chien,9999,0,9999,0
1668137015550,ECE 200,015,103600,Javidi; Tara,9999,0,9999,0
1668137015550,ECE 200,016,103601,Kahng; Andrew Byun,9999,0,9999,0
1668137015550,ECE 200,017,103602,Kim; Young-Han,9999,0,9999,0
1668137015550,ECE 200,018,103603,Koushanfar; Farinaz,9999,0,9999,0
1668137015550,ECE 200,019,103604,Kuzum; Duygu,9999,0,9999,0
1668137015550,ECE 200,020,103605,Le; Hanh-Phuc,9999,0,9999,0
1668137015550,ECE 200,021,103606,Lin; Bill,9999,0,9999,0
1668137015550,ECE 200,022,103607,Liu; Zhaowei,9998,0,9999,1
1668137015550,ECE 200,023,103608,Lo; Yu-Hwa,9999,0,9999,0
1668137015550,ECE 200,024,103609,Lomakin; Vitaliy,9999,0,9999,0
1668137015550,ECE 200,025,103610,Mercier; Patrick Philip,9999,0,9999,0
1668137015550,ECE 200,026,103611,Meyer; Florian,9999,0,9999,0
1668137015550,ECE 200,027,103612,Milstein; Laurence B.,9999,0,9999,0
1668137015550,ECE 200,028,103613,Mir Arabbaygi; Siavash,9999,0,9999,0
1668137015550,ECE 200,029,103614,Mookherjea; Shayan,9999,0,9999,0
1668137015550,ECE 200,030,103615,Morris; Karcher William,9999,0,9999,0
1668137015550,ECE 200,031,103616,Ng; Tse Nga,9999,0,9999,0
1668137015550,ECE 200,032,103617,Nguyen; Truong Quang,9999,0,9999,0
1668137015550,ECE 200,033,103618,Nomura; Kenji,9999,0,9999,0
1668137015550,ECE 200,034,103619,Orlitsky; Alon,9999,0,9999,0
1668137015550,ECE 200,035,103620,Pal; Piya,9999,0,9999,0
1668137015550,ECE 200,036,103621,Papen; George C.,9999,0,9999,0
1668137015550,ECE 200,037,103622,Radic; Stojan,9999,0,9999,0
1668137015550,ECE 200,038,103623,Rao; Bhaskar D.,9999,0,9999,0
1668137015550,ECE 200,039,103624,Rao; Ramesh R,9999,0,9999,0
1668137015550,ECE 200,040,103625,Rebeiz; Gabriel,9999,0,9999,0
1668137015550,ECE 200,041,103626,Sanford; John R,9999,0,9999,0
1668137015550,ECE 200,042,103627,Siegel; Paul H.,9999,0,9999,0
1668137015550,ECE 200,043,103628,Sievenpiper; Daniel F.,9999,0,9999,0
1668137015550,ECE 200,044,103629,Sworder; David D.,9999,0,9999,0
1668137015550,ECE 200,045,103630,Taur; Yuan,9999,0,9999,0
1668137015550,ECE 200,046,103631,Touri; Behrouz,9999,0,9999,0
1668137015550,ECE 200,047,103632,Trivedi; Mohan M.,9999,0,9999,0
1668137015550,ECE 200,048,103633,Vasconcelos; Nuno,9999,0,9999,0
1668137015550,ECE 200,049,103634,Wang; Xiaolong,9999,0,9999,0
1668137015550,ECE 200,050,103635,Xie; Pengtao,9999,0,9999,0
1668137015550,ECE 200,051,103636,Yip; Michael,9999,0,9999,0
1668137015550,ECE 200,052,103637,Zeger; Kenneth A.,999,0,999,0
1668137015550,ECE 200,053,103638,Zhang; Xinyu,9999,0,9999,0
1668137015550,ECE 200,054,103639,Turakhia; Yatish Girish,9999,0,9999,0
1668137015550,ECE 200,055,103640,Kang; Mingu,9999,0,9999,0
1668137015550,ECE 200,056,103641,Shi; Yuanyuan,9999,0,9999,0
1668137015550,ECE 200,057,103642,Wang; Edward Jay,9999,0,9999,0
1668137015550,ECE 200,058,103643,Zheng; Yang,9999,0,9999,0
1668137015974,ECE 202,A00,103644,Kuzum; Duygu,0,0,0,0
1668137016401,ECE 212BN,A00,103646,Ng; Tse Nga,0,0,0,0
1668137016924,ECE 221,A00,111493,Staff,0,0,0,0
1668137017353,ECE 222B,A00,103647,Lomakin; Vitaliy,0,0,0,0
1668137017777,ECE 230B,A00,103648,Taur; Yuan,0,0,0,0
1668137018205,ECE 238B,A00,103649,Garay; Javier,0,0,0,0
1668137018632,ECE 240B,A00,112900,Fainman; Yeshaiahu,0,0,0,0
1668137019059,ECE 247A,A00,103650,Jokerst; Jesse Vincent,0,0,0,0
1668137019483,ECE 247B,A00,103651,Wang; Joseph,0,0,0,0
1668137019906,ECE 250,A00,103652,Siegel; Paul H.,0,0,0,0
1668137020332,ECE 251A,A00,103654,Rao; Bhaskar D.,0,0,0,0
1668137020761,ECE 257B,A00,103655,Bharadia; Dinesh,0,0,0,0
1668137021186,ECE 258A,A00,103656,Milstein; Laurence B.,0,0,0,0
1668137021609,ECE 260B,A00,103658,Kang; Mingu,0,0,0,0
1668137022030,ECE 264A,A00,103659,Galton; Ian A,0,0,0,0
1668137022462,ECE 265A,A00,103661,Gudem; Prasad S.S.,0,0,0,0
1668137022886,ECE 265D,A00,103662,Gudem; Prasad S.S.,0,0,0,0
1668137023313,ECE 268,A00,103663,Koushanfar; Farinaz,0,0,0,0
1668137023735,ECE 269,A01,103665,Pal; Piya,0,0,0,0
1668137024160,ECE 271B,A00,103666,Vasconcelos; Manuela,0,0,0,0
1668137024590,ECE 276A,A00,103667,Atanasov; Nikolay A.,0,0,0,0
1668137025019,ECE 277,A00,103668,An; Cheolhong,0,0,0,0
1668137025462,ECE 279,A00,117947,Hall; Drew A.,0,0,0,0
1668137026331,ECE 283,A00,103670,Hsueh; Tzu-Chien,0,0,0,0
1668137026757,ECE 284,A00,103671,Turakhia; Yatish Girish,0,0,0,0
1668137027191,ECE 285,A00,103672,Zheng; Yang,0,0,0,0
1668137027191,ECE 285,B00,103673,Sworder; David D.,0,0,0,0
1668137027620,ECE 287,A00,103676,Javidi; Tara,0,0,0,0
1668137028053,MATH 200B,A00,098023,Salehi Golsefidy; Alireza,12,0,15,3
1668137028478,MATH 202B,A00,098024,Rhoades; Brendon Patrick,9,0,15,6
1668137028921,MATH 203B,A00,098025,Oprea; Dragos N.,10,0,15,5
1668137029353,MATH 204B,A00,098026,Sorensen; Claus M,13,0,15,2
1668137029779,MATH 208,A00,098027,Izadi; Elham,7,0,10,3
1668137030209,MATH 209,A00,098028,Pollack; Aaron,10,0,10,0
1668137030634,MATH 211A,A00,112919,Rogalski; Daniel,9,0,10,1
1668137031060,MATH 211B,A00,112920,Seward; Brandon M.,9,0,10,1
1668137031489,MATH 218,A00,098029,Li; Bo,10,0,10,0
1668137031912,MATH 220B,A00,098030,Novak; Jonathan I,11,0,15,4
1668137032348,MATH 221A,A00,098031,Ebenfelt; Peter F,13,0,15,2
1668137032777,MATH 231B,A00,098032,Zlatos; Andrej,12,0,15,3
1668137033206,MATH 240B,A00,098033,Ni; Lei,9,0,15,6
1668137033628,MATH 243,A00,098034,Jekel; David Andrew,10,0,10,0
1668137034059,MATH 245A,A00,098035,Nie; Jiawang,0,0,15,16
1668137034483,MATH 248,A00,098036,Bejenaru; Ioan,10,0,10,0
1668137034910,MATH 250B,A00,098037,Spolaor; Luca,14,0,15,1
1668137035331,MATH 258,A00,098038,Ni; Lei,10,0,10,0
1668137035763,MATH 264B,A00,098041,Rhoades; Brendon Patrick,9,0,15,6
1668137036194,MATH 268,A00,098042,Buss; Samuel R,10,0,10,0
1668137036713,MATH 269,A00,098043,Rhoades; Brendon Patrick,10,0,10,0
1668137037141,MATH 270B,A00,098044,Li; Bo,10,0,15,5
1668137037572,MATH 272B,A00,098045,Holst; Michael J,13,0,15,2
1668137038007,MATH 273A,A00,098046,Tian; Xiaochuan,10,0,15,5
1668137038431,MATH 275,A01,098048,Tian; Xiaochuan,6,0,10,4
1668137038859,MATH 278A,A00,098049,Holst; Michael J,8,0,10,2
1668137039283,MATH 278B,A00,098050,Cloninger; Alexander,10,0,10,0
1668137039717,MATH 278C,A00,098051,Nie; Jiawang,7,0,10,3
1668137040145,MATH 280B,A00,098052,Zheng; Tianyi,10,0,15,5
1668137040573,MATH 281B,A00,098053,Bradic; Jelena,2,0,15,13
1668137041000,MATH 282B,A00,098054,Arias-Castro; Ery,0,0,15,15
1668137041431,MATH 285,A00,098055,Fitzsimmons; Patrick J,0,0,15,17
1668137041860,MATH 287B,A00,098056,Arias-Castro; Ery,2,0,15,13
1668137042303,MATH 288,A00,098057,Agarwal; Pooja,9,0,10,1
1668137042303,MATH 288,B00,098058,Zhang; Danna,8,0,10,2
1668137042303,MATH 288,C00,098059,Williams; Ruth J,10,0,10,0
1668137042730,MATH 290B,A00,098060,Roberts; Justin Deritter,13,0,15,2
1668137043157,MATH 292,A00,098061,Belmont; Eva Kinoshita,10,0,10,0
1668137043581,MATH 295,A00,098062,Suk; Andrew Hoon,48,0,50,2
1668137044005,MATH 296,A00,098063,Novak; Jonathan I,20,0,20,0
1668137044440,MATH 297,001,098064,Gamst; Anthony Collins,9997,0,9999,2
1668137548233,COGS 205,A00,101395,Chiba; Andrea,19,0,20,1
1668137548667,COGS 210B,001,101404,Greene; Deanna Jacquelyn,9998,0,9999,1
1668137548667,COGS 210B,002,101417,Xia; Haijun,9999,0,9999,0
1668137548667,COGS 210B,003,101422,Nitz; Douglas A.,9999,0,9999,0
1668137548667,COGS 210B,004,101423,Hollan; James D.,9998,0,9999,1
1668137548667,COGS 210B,005,101424,Deak; Gedeon O.,9998,0,9999,1
1668137548667,COGS 210B,006,101425,Rossano; Federico,9999,0,9999,0
1668137549288,COGS 211B,A00,101427,Coulson; Seana M,9996,0,9999,3
1668137549713,COGS 220,A00,101428,Hollan; James D.,0,0,25,25
1668137550147,COGS 229,A00,101429,Dow; Steven P,18,0,25,7
1668137550574,COGS 230,A00,101430,Klemmer; Scott R,12,0,17,5
1668137550999,COGS 234,A00,101431,Xia; Haijun,3,0,25,22
1668137551432,COGS 260,A00,101432,Kiyonaga; Anastasia,20,0,25,5
1668137551432,COGS 260,B00,101433,Kirsh; David Joel,16,0,25,9
1668137551858,CSE 202,A00,102371,Impagliazzo; Russell,0,0,0,0
1668137552287,CSE 203B,A01,102373,Cheng; Chung Kuan,0,0,0,0
1668137552712,CSE 208,A00,102374,Micciancio; Daniele,0,0,0,0
1668137553147,CSE 209A,A00,112895,Impagliazzo; Russell,0,0,15,15
1668137553583,CSE 209B,A00,108005,Bellare; Mihir,0,0,0,0
1668137554005,CSE 210,A00,113163,Coblenz; Michael J,0,0,0,0
1668137554434,CSE 219,A00,106111,Dow; Steven P,0,0,20,20
1668137554858,CSE 221,A00,102376,Voelker; Geoffrey M.,0,0,0,0
1668137555284,CSE 224,A01,102378,Porter; George M,0,0,0,0
1668137555707,CSE 229A,A00,102379,Savage; Stefan,0,0,0,0
1668137556132,CSE 229C,A00,102380,Munyaka; Imani N. S.,0,0,0,0
1668137556556,CSE 232B,A00,102382,Deutsch; Alin Bernard,0,0,0,0
1668137556978,CSE 234,A01,112904,Kumar; Arun Kumar,0,0,0,0
1668137557411,CSE 237A,A00,102383,Rosing; Tajana Simunic,0,0,0,0
1668137557838,CSE 239A,A00,102384,Deutsch; Alin Bernard,0,0,0,0
1668137558267,CSE 239B,A00,102385,Polikarpova; Nadezhda,0,0,0,0
1668137558690,CSE 240A,A00,102386,Pannuto; Patrick William,0,0,0,0
1668137559115,CSE 240B,A00,102387,Zhao; Jishen,0,0,0,0
1668137559544,CSE 241A,A00,106406,Kang; Mingu,0,0,0,0
1668137559976,CSE 249B,A00,102388,Kahng; Andrew Byun,0,0,8,8
1668137560401,CSE 251B,A01,102392,Cottrell; Garrison W,0,0,0,0
1668137560401,CSE 251B,A02,102393,Cottrell; Garrison W,0,0,0,0
1668137560915,CSE 252B,A00,102394,Ochoa; Benjamin Lawrence,0,0,0,0
1668137561343,CSE 257,A01,102396,Gao; Sicun,0,0,0,0
1668137561782,CSE 272,A00,102397,Li; Tzumao,0,0,0,0
1668137562228,CSE 274,A00,111323,Chern; Albert Ren-Haur,0,0,0,0
1668137562661,CSE 282,A00,102398,Pevzner; Pavel Arkadjevich,0,0,0,0
1668137563084,CSE 284,A00,114175,Gymrek; Melissa Ann,0,0,0,0
1668137563515,CSE 290,A00,102399,Chandraker; Manmohan Krishna,0,0,0,0
1668137563515,CSE 290,B00,102400,Vaccaro; Kristen Marie,0,0,25,25
1668137563515,CSE 290,C00,102414,Pannuto; Patrick William,0,0,25,25
1668137563515,CSE 290,D00,102427,Pevzner; Pavel Arkadjevich,0,0,0,0
1668137563515,CSE 290,E00,102429,Zhao; Jishen,0,0,0,0
1668137563515,CSE 290,F00,102436,Tullsen; Dean Michael,0,0,0,0
1668137563515,CSE 290,G00,102440,Christensen; Henrik I,0,0,20,20
1668137563951,CSE 291,A00,102443,Su; Hao,0,0,0,0
1668137563951,CSE 291,B00,102448,Polikarpova; Nadezhda,0,0,0,0
1668137563951,CSE 291,C00,102453,Vaccaro; Kristen Marie,0,0,0,0
1668137563951,CSE 291,D00,111343,Savage; Stefan,0,0,0,0
1668137563951,CSE 291,E00,116474,Claffy; Kimberly Claire,0,0,0,0
1668137563951,CSE 291,F00,116479,Pasquale; Joseph,0,0,0,0
1668137564424,CSE 293,001,119111,Bafna; Vineet,9999,0,9999,0
1668137564424,CSE 293,002,119118,Bellare; Mihir,9999,0,9999,0
1668137564424,CSE 293,003,119122,Berg-Kirkpatrick; Taylor D,9999,0,9999,0
1668137564424,CSE 293,004,119135,Christensen; Henrik I,9999,0,9999,0
1668137564424,CSE 293,005,119142,Cottrell; Garrison W,9999,0,9999,0
1668137564424,CSE 293,006,119146,Deutsch; Alin Bernard,9999,0,9999,0
1668137564424,CSE 293,007,119159,Esmaeilzadeh; Hadi,9999,0,9999,0
1668137564424,CSE 293,008,119166,Freund; Yoav,9999,0,9999,0
1668137564424,CSE 293,009,119170,Griswold; William G.,9999,0,9999,0
1668137564424,CSE 293,010,119183,Gymrek; Melissa Ann,9999,0,9999,0
1668137564424,CSE 293,011,119190,Heninger; Nadia A,9999,0,9999,0
1668137564424,CSE 293,012,119230,Impagliazzo; Russell,9999,0,9999,0
1668137564424,CSE 293,013,119232,Jhala; Ranjit,9999,0,9999,0
1668137564424,CSE 293,014,119233,Kahng; Andrew Byun,9999,0,9999,0
1668137564424,CSE 293,015,119298,Kane; Daniel Mertz,9999,0,9999,0
1668137564424,CSE 293,016,119299,Kriegman; David J,9999,0,9999,0
1668137564424,CSE 293,017,119300,Kumar; Arun Kumar,9999,0,9999,0
1668137564424,CSE 293,018,119301,Lerner; Sorin,9999,0,9999,0
1668137564424,CSE 293,019,119302,Lovett; Shachar,9999,0,9999,0
1668137564424,CSE 293,020,119303,McAuley; Julian John,9999,0,9999,0
1668137564424,CSE 293,021,119304,Micciancio; Daniele,9999,0,9999,0
1668137564424,CSE 293,022,119367,Orailoglu; Alex,9999,0,9999,0
1668137564424,CSE 293,023,119382,Paturi; Ramamohan,9999,0,9999,0
1668137564424,CSE 293,024,119404,Polikarpova; Nadezhda,9999,0,9999,0
1668137564424,CSE 293,025,119406,Politz; Joseph Gibbs,9999,0,9999,0
1668137564424,CSE 293,026,119411,Porter; George M,9999,0,9999,0
1668137564424,CSE 293,027,119414,Porter; Leonard Emerson,9999,0,9999,0
1668137564424,CSE 293,028,119416,Ramamoorthi; Ravi,9999,0,9999,0
1668137564424,CSE 293,029,119417,Sahoo; Debashis,9999,0,9999,0
1668137564424,CSE 293,030,119420,Saul; Lawrence,9999,0,9999,0
1668137564424,CSE 293,031,119421,Savage; Stefan,9999,0,9999,0
1668137564424,CSE 293,032,119425,Schulze; Jurgen P.,9999,0,9999,0
1668137564424,CSE 293,033,119426,Snoeren; Alex C.,9999,0,9999,0
1668137564424,CSE 293,034,119428,Shang; Jingbo,9999,0,9999,0
1668137564424,CSE 293,035,119430,Stefan; Deian,9999,0,9999,0
1668137564424,CSE 293,036,119431,Su; Hao,9999,0,9999,0
1668137564424,CSE 293,037,119433,Swanson; Steven James,9999,0,9999,0
1668137564424,CSE 293,038,119435,Tullsen; Dean Michael,9999,0,9999,0
1668137564424,CSE 293,039,119483,Voelker; Geoffrey M.,9999,0,9999,0
1668137564424,CSE 293,040,119537,Zhao; Jishen,9999,0,9999,0
1668137564424,CSE 293,041,119538,Zhou; Yuan-Yuan,9999,0,9999,0
1668137564424,CSE 293,042,119539,Gao; Sicun,9999,0,9999,0
1668137564424,CSE 293,043,119540,Weibel; Nadir,9999,0,9999,0
1668137564424,CSE 293,044,119541,Gupta; Rajesh K.,9999,0,9999,0
1668137564424,CSE 293,045,126410,Vaccaro; Kristen Marie,9999,0,9999,0
1668137564424,CSE 293,046,126411,Klemke; Richard,9999,0,9999,0
1668137564853,CSE 294,A00,102459,Voelker; Geoffrey M.,0,0,0,0
1668137564853,CSE 294,B00,111322,Orailoglu; Alex,0,0,0,0
1668137565278,DSE 201,A00,096914,Deutsch; Alin Bernard,30,0,30,0
1668137565700,DSE 210,A00,096915,Dasgupta; Sanjoy,30,0,30,0
1668137566127,DSE 260A,A00,096916,Altintas De Callaf; Ilkay,30,0,30,0
1668137566577,ECE 200,001,103586,Antipa; Nicholas A,9999,0,9999,0
1668137566577,ECE 200,002,103587,Atanasov; Nikolay A.,9999,0,9999,0
1668137566577,ECE 200,003,103588,Bharadia; Dinesh,9999,0,9999,0
1668137566577,ECE 200,004,103589,Cheng; Chung Kuan,9999,0,9999,0
1668137566577,ECE 200,005,103590,Cosman; Pamela C.,9999,0,9999,0
1668137566577,ECE 200,006,103591,Dayeh; Shadi Ahmad,9999,0,9999,0
1668137566577,ECE 200,007,103592,Fainman; Yeshaiahu,9999,0,9999,0
1668137566577,ECE 200,008,103593,Ford; Joseph Earl,9999,0,9999,0
1668137566577,ECE 200,009,103594,Franceschetti; Massimo,9999,0,9999,0
1668137566577,ECE 200,010,103595,Fullerton; Eric E,9999,0,9999,0
1668137566577,ECE 200,011,103596,Galton; Ian A,9999,0,9999,0
1668137566577,ECE 200,012,103597,Gilja; Vikash,9999,0,9999,0
1668137566577,ECE 200,013,103598,Hall; Drew A.,9999,0,9999,0
1668137566577,ECE 200,014,103599,Hsueh; Tzu-Chien,9999,0,9999,0
1668137566577,ECE 200,015,103600,Javidi; Tara,9999,0,9999,0
1668137566577,ECE 200,016,103601,Kahng; Andrew Byun,9999,0,9999,0
1668137566577,ECE 200,017,103602,Kim; Young-Han,9999,0,9999,0
1668137566577,ECE 200,018,103603,Koushanfar; Farinaz,9999,0,9999,0
1668137566577,ECE 200,019,103604,Kuzum; Duygu,9999,0,9999,0
1668137566577,ECE 200,020,103605,Le; Hanh-Phuc,9999,0,9999,0
1668137566577,ECE 200,021,103606,Lin; Bill,9999,0,9999,0
1668137566577,ECE 200,022,103607,Liu; Zhaowei,9998,0,9999,1
1668137566577,ECE 200,023,103608,Lo; Yu-Hwa,9999,0,9999,0
1668137566577,ECE 200,024,103609,Lomakin; Vitaliy,9999,0,9999,0
1668137566577,ECE 200,025,103610,Mercier; Patrick Philip,9999,0,9999,0
1668137566577,ECE 200,026,103611,Meyer; Florian,9999,0,9999,0
1668137566577,ECE 200,027,103612,Milstein; Laurence B.,9999,0,9999,0
1668137566577,ECE 200,028,103613,Mir Arabbaygi; Siavash,9999,0,9999,0
1668137566577,ECE 200,029,103614,Mookherjea; Shayan,9999,0,9999,0
1668137566577,ECE 200,030,103615,Morris; Karcher William,9999,0,9999,0
1668137566577,ECE 200,031,103616,Ng; Tse Nga,9999,0,9999,0
1668137566577,ECE 200,032,103617,Nguyen; Truong Quang,9999,0,9999,0
1668137566577,ECE 200,033,103618,Nomura; Kenji,9999,0,9999,0
1668137566577,ECE 200,034,103619,Orlitsky; Alon,9999,0,9999,0
1668137566577,ECE 200,035,103620,Pal; Piya,9999,0,9999,0
1668137566577,ECE 200,036,103621,Papen; George C.,9999,0,9999,0
1668137566577,ECE 200,037,103622,Radic; Stojan,9999,0,9999,0
1668137566577,ECE 200,038,103623,Rao; Bhaskar D.,9999,0,9999,0
1668137566577,ECE 200,039,103624,Rao; Ramesh R,9999,0,9999,0
1668137566577,ECE 200,040,103625,Rebeiz; Gabriel,9999,0,9999,0
1668137566577,ECE 200,041,103626,Sanford; John R,9999,0,9999,0
1668137566577,ECE 200,042,103627,Siegel; Paul H.,9999,0,9999,0
1668137566577,ECE 200,043,103628,Sievenpiper; Daniel F.,9999,0,9999,0
1668137566577,ECE 200,044,103629,Sworder; David D.,9999,0,9999,0
1668137566577,ECE 200,045,103630,Taur; Yuan,9999,0,9999,0
1668137566577,ECE 200,046,103631,Touri; Behrouz,9999,0,9999,0
1668137566577,ECE 200,047,103632,Trivedi; Mohan M.,9999,0,9999,0
1668137566577,ECE 200,048,103633,Vasconcelos; Nuno,9999,0,9999,0
1668137566577,ECE 200,049,103634,Wang; Xiaolong,9999,0,9999,0
1668137566577,ECE 200,050,103635,Xie; Pengtao,9999,0,9999,0
1668137566577,ECE 200,051,103636,Yip; Michael,9999,0,9999,0
1668137566577,ECE 200,052,103637,Zeger; Kenneth A.,999,0,999,0
1668137566577,ECE 200,053,103638,Zhang; Xinyu,9999,0,9999,0
1668137566577,ECE 200,054,103639,Turakhia; Yatish Girish,9999,0,9999,0
1668137566577,ECE 200,055,103640,Kang; Mingu,9999,0,9999,0
1668137566577,ECE 200,056,103641,Shi; Yuanyuan,9999,0,9999,0
1668137566577,ECE 200,057,103642,Wang; Edward Jay,9999,0,9999,0
1668137566577,ECE 200,058,103643,Zheng; Yang,9999,0,9999,0
1668137567001,ECE 202,A00,103644,Kuzum; Duygu,0,0,0,0
1668137567427,ECE 212BN,A00,103646,Ng; Tse Nga,0,0,0,0
1668137567856,ECE 221,A00,111493,Staff,0,0,0,0
1668137568281,ECE 222B,A00,103647,Lomakin; Vitaliy,0,0,0,0
1668137568711,ECE 230B,A00,103648,Taur; Yuan,0,0,0,0
1668137569138,ECE 238B,A00,103649,Garay; Javier,0,0,0,0
1668137569563,ECE 240B,A00,112900,Fainman; Yeshaiahu,0,0,0,0
1668137569990,ECE 247A,A00,103650,Jokerst; Jesse Vincent,0,0,0,0
1668137570434,ECE 247B,A00,103651,Wang; Joseph,0,0,0,0
1668137570863,ECE 250,A00,103652,Siegel; Paul H.,0,0,0,0
1668137571294,ECE 251A,A00,103654,Rao; Bhaskar D.,0,0,0,0
1668137571717,ECE 257B,A00,103655,Bharadia; Dinesh,0,0,0,0
1668137572142,ECE 258A,A00,103656,Milstein; Laurence B.,0,0,0,0
1668137572573,ECE 260B,A00,103658,Kang; Mingu,0,0,0,0
1668137573006,ECE 264A,A00,103659,Galton; Ian A,0,0,0,0
1668137573430,ECE 265A,A00,103661,Gudem; Prasad S.S.,0,0,0,0
1668137573853,ECE 265D,A00,103662,Gudem; Prasad S.S.,0,0,0,0
1668137574282,ECE 268,A00,103663,Koushanfar; Farinaz,0,0,0,0
1668137574706,ECE 269,A01,103665,Pal; Piya,0,0,0,0
1668137575135,ECE 271B,A00,103666,Vasconcelos; Manuela,0,0,0,0
1668137575563,ECE 276A,A00,103667,Atanasov; Nikolay A.,0,0,0,0
1668137575988,ECE 277,A00,103668,An; Cheolhong,0,0,0,0
1668137576415,ECE 279,A00,117947,Hall; Drew A.,0,0,0,0
1668137577265,ECE 283,A00,103670,Hsueh; Tzu-Chien,0,0,0,0
1668137577688,ECE 284,A00,103671,Turakhia; Yatish Girish,0,0,0,0
1668137578119,ECE 285,A00,103672,Zheng; Yang,0,0,0,0
1668137578119,ECE 285,B00,103673,Sworder; David D.,0,0,0,0
1668137578543,ECE 287,A00,103676,Javidi; Tara,0,0,0,0
1668137578968,MATH 200B,A00,098023,Salehi Golsefidy; Alireza,12,0,15,3
1668137579395,MATH 202B,A00,098024,Rhoades; Brendon Patrick,9,0,15,6
1668137579822,MATH 203B,A00,098025,Oprea; Dragos N.,10,0,15,5
1668137580259,MATH 204B,A00,098026,Sorensen; Claus M,13,0,15,2
1668137580803,MATH 208,A00,098027,Izadi; Elham,7,0,10,3
1668137581228,MATH 209,A00,098028,Pollack; Aaron,10,0,10,0
1668137581654,MATH 211A,A00,112919,Rogalski; Daniel,9,0,10,1
1668137582085,MATH 211B,A00,112920,Seward; Brandon M.,9,0,10,1
1668137582522,MATH 218,A00,098029,Li; Bo,10,0,10,0
1668137582950,MATH 220B,A00,098030,Novak; Jonathan I,11,0,15,4
1668137583374,MATH 221A,A00,098031,Ebenfelt; Peter F,13,0,15,2
1668137583798,MATH 231B,A00,098032,Zlatos; Andrej,12,0,15,3
1668137584226,MATH 240B,A00,098033,Ni; Lei,9,0,15,6
1668137584649,MATH 243,A00,098034,Jekel; David Andrew,10,0,10,0
1668137585076,MATH 245A,A00,098035,Nie; Jiawang,0,0,15,16
1668137585503,MATH 248,A00,098036,Bejenaru; Ioan,10,0,10,0
1668137585934,MATH 250B,A00,098037,Spolaor; Luca,14,0,15,1
1668137586363,MATH 258,A00,098038,Ni; Lei,10,0,10,0
1668137586787,MATH 264B,A00,098041,Rhoades; Brendon Patrick,9,0,15,6
1668137587210,MATH 268,A00,098042,Buss; Samuel R,10,0,10,0
1668137587645,MATH 269,A00,098043,Rhoades; Brendon Patrick,10,0,10,0
1668137588075,MATH 270B,A00,098044,Li; Bo,10,0,15,5
1668137588504,MATH 272B,A00,098045,Holst; Michael J,13,0,15,2
1668137588930,MATH 273A,A00,098046,Tian; Xiaochuan,10,0,15,5
1668137589363,MATH 275,A01,098048,Tian; Xiaochuan,6,0,10,4
1668137589786,MATH 278A,A00,098049,Holst; Michael J,8,0,10,2
1668137590216,MATH 278B,A00,098050,Cloninger; Alexander,10,0,10,0
1668137590651,MATH 278C,A00,098051,Nie; Jiawang,7,0,10,3
1668137591087,MATH 280B,A00,098052,Zheng; Tianyi,10,0,15,5
1668137591518,MATH 281B,A00,098053,Bradic; Jelena,2,0,15,13
1668137591959,MATH 282B,A00,098054,Arias-Castro; Ery,0,0,15,15
1668137592405,MATH 285,A00,098055,Fitzsimmons; Patrick J,0,0,15,17
1668137592828,MATH 287B,A00,098056,Arias-Castro; Ery,2,0,15,13
1668137593251,MATH 288,A00,098057,Agarwal; Pooja,9,0,10,1
1668137593251,MATH 288,B00,098058,Zhang; Danna,8,0,10,2
1668137593251,MATH 288,C00,098059,Williams; Ruth J,10,0,10,0
1668137593687,MATH 290B,A00,098060,Roberts; Justin Deritter,13,0,15,2
1668137594114,MATH 292,A00,098061,Belmont; Eva Kinoshita,10,0,10,0
1668137594546,MATH 295,A00,098062,Suk; Andrew Hoon,48,0,50,2
1668137594970,MATH 296,A00,098063,Novak; Jonathan I,20,0,20,0
1668137595404,MATH 297,001,098064,Gamst; Anthony Collins,9997,0,9999,2
1668138098424,COGS 205,A00,101395,Chiba; Andrea,19,0,20,1
1668138098849,COGS 210B,001,101404,Greene; Deanna Jacquelyn,9998,0,9999,1
1668138098849,COGS 210B,002,101417,Xia; Haijun,9999,0,9999,0
1668138098849,COGS 210B,003,101422,Nitz; Douglas A.,9999,0,9999,0
1668138098849,COGS 210B,004,101423,Hollan; James D.,9998,0,9999,1
1668138098849,COGS 210B,005,101424,Deak; Gedeon O.,9998,0,9999,1
1668138098849,COGS 210B,006,101425,Rossano; Federico,9999,0,9999,0
1668138099277,COGS 211B,A00,101427,Coulson; Seana M,9996,0,9999,3
1668138099700,COGS 220,A00,101428,Hollan; James D.,0,0,25,25
1668138100130,COGS 229,A00,101429,Dow; Steven P,18,0,25,7
1668138100555,COGS 230,A00,101430,Klemmer; Scott R,12,0,17,5
1668138100980,COGS 234,A00,101431,Xia; Haijun,3,0,25,22
1668138101412,COGS 260,A00,101432,Kiyonaga; Anastasia,20,0,25,5
1668138101412,COGS 260,B00,101433,Kirsh; David Joel,16,0,25,9
1668138101835,CSE 202,A00,102371,Impagliazzo; Russell,0,0,0,0
1668138102274,CSE 203B,A01,102373,Cheng; Chung Kuan,0,0,0,0
1668138102700,CSE 208,A00,102374,Micciancio; Daniele,0,0,0,0
1668138103125,CSE 209A,A00,112895,Impagliazzo; Russell,0,0,15,15
1668138103551,CSE 209B,A00,108005,Bellare; Mihir,0,0,0,0
1668138103974,CSE 210,A00,113163,Coblenz; Michael J,0,0,0,0
1668138104397,CSE 219,A00,106111,Dow; Steven P,0,0,20,20
1668138104822,CSE 221,A00,102376,Voelker; Geoffrey M.,0,0,0,0
1668138105246,CSE 224,A01,102378,Porter; George M,0,0,0,0
1668138105669,CSE 229A,A00,102379,Savage; Stefan,0,0,0,0
1668138106095,CSE 229C,A00,102380,Munyaka; Imani N. S.,0,0,0,0
1668138106533,CSE 232B,A00,102382,Deutsch; Alin Bernard,0,0,0,0
1668138106962,CSE 234,A01,112904,Kumar; Arun Kumar,0,0,0,0
1668138107387,CSE 237A,A00,102383,Rosing; Tajana Simunic,0,0,0,0
1668138107811,CSE 239A,A00,102384,Deutsch; Alin Bernard,0,0,0,0
1668138108253,CSE 239B,A00,102385,Polikarpova; Nadezhda,0,0,0,0
1668138108677,CSE 240A,A00,102386,Pannuto; Patrick William,0,0,0,0
1668138109100,CSE 240B,A00,102387,Zhao; Jishen,0,0,0,0
1668138109525,CSE 241A,A00,106406,Kang; Mingu,0,0,0,0
1668138109950,CSE 249B,A00,102388,Kahng; Andrew Byun,0,0,8,8
1668138110378,CSE 251B,A01,102392,Cottrell; Garrison W,0,0,0,0
1668138110378,CSE 251B,A02,102393,Cottrell; Garrison W,0,0,0,0
1668138110810,CSE 252B,A00,102394,Ochoa; Benjamin Lawrence,0,0,0,0
1668138111234,CSE 257,A01,102396,Gao; Sicun,0,0,0,0
1668138111658,CSE 272,A00,102397,Li; Tzumao,0,0,0,0
1668138112086,CSE 274,A00,111323,Chern; Albert Ren-Haur,0,0,0,0
1668138112512,CSE 282,A00,102398,Pevzner; Pavel Arkadjevich,0,0,0,0
1668138112937,CSE 284,A00,114175,Gymrek; Melissa Ann,0,0,0,0
1668138113365,CSE 290,A00,102399,Chandraker; Manmohan Krishna,0,0,0,0
1668138113365,CSE 290,B00,102400,Vaccaro; Kristen Marie,0,0,25,25
1668138113365,CSE 290,C00,102414,Pannuto; Patrick William,0,0,25,25
1668138113365,CSE 290,D00,102427,Pevzner; Pavel Arkadjevich,0,0,0,0
1668138113365,CSE 290,E00,102429,Zhao; Jishen,0,0,0,0
1668138113365,CSE 290,F00,102436,Tullsen; Dean Michael,0,0,0,0
1668138113365,CSE 290,G00,102440,Christensen; Henrik I,0,0,20,20
1668138113790,CSE 291,A00,102443,Su; Hao,0,0,0,0
1668138113790,CSE 291,B00,102448,Polikarpova; Nadezhda,0,0,0,0
1668138113790,CSE 291,C00,102453,Vaccaro; Kristen Marie,0,0,0,0
1668138113790,CSE 291,D00,111343,Savage; Stefan,0,0,0,0
1668138113790,CSE 291,E00,116474,Claffy; Kimberly Claire,0,0,0,0
1668138113790,CSE 291,F00,116479,Pasquale; Joseph,0,0,0,0
1668138114226,CSE 293,001,119111,Bafna; Vineet,9999,0,9999,0
1668138114226,CSE 293,002,119118,Bellare; Mihir,9999,0,9999,0
1668138114226,CSE 293,003,119122,Berg-Kirkpatrick; Taylor D,9999,0,9999,0
1668138114226,CSE 293,004,119135,Christensen; Henrik I,9999,0,9999,0
1668138114226,CSE 293,005,119142,Cottrell; Garrison W,9999,0,9999,0
1668138114226,CSE 293,006,119146,Deutsch; Alin Bernard,9999,0,9999,0
1668138114226,CSE 293,007,119159,Esmaeilzadeh; Hadi,9999,0,9999,0
1668138114226,CSE 293,008,119166,Freund; Yoav,9999,0,9999,0
1668138114226,CSE 293,009,119170,Griswold; William G.,9999,0,9999,0
1668138114226,CSE 293,010,119183,Gymrek; Melissa Ann,9999,0,9999,0
1668138114226,CSE 293,011,119190,Heninger; Nadia A,9999,0,9999,0
1668138114226,CSE 293,012,119230,Impagliazzo; Russell,9999,0,9999,0
1668138114226,CSE 293,013,119232,Jhala; Ranjit,9999,0,9999,0
1668138114226,CSE 293,014,119233,Kahng; Andrew Byun,9999,0,9999,0
1668138114226,CSE 293,015,119298,Kane; Daniel Mertz,9999,0,9999,0
1668138114226,CSE 293,016,119299,Kriegman; David J,9999,0,9999,0
1668138114226,CSE 293,017,119300,Kumar; Arun Kumar,9999,0,9999,0
1668138114226,CSE 293,018,119301,Lerner; Sorin,9999,0,9999,0
1668138114226,CSE 293,019,119302,Lovett; Shachar,9999,0,9999,0
1668138114226,CSE 293,020,119303,McAuley; Julian John,9999,0,9999,0
1668138114226,CSE 293,021,119304,Micciancio; Daniele,9999,0,9999,0
1668138114226,CSE 293,022,119367,Orailoglu; Alex,9999,0,9999,0
1668138114226,CSE 293,023,119382,Paturi; Ramamohan,9999,0,9999,0
1668138114226,CSE 293,024,119404,Polikarpova; Nadezhda,9999,0,9999,0
1668138114226,CSE 293,025,119406,Politz; Joseph Gibbs,9999,0,9999,0
1668138114226,CSE 293,026,119411,Porter; George M,9999,0,9999,0
1668138114226,CSE 293,027,119414,Porter; Leonard Emerson,9999,0,9999,0
1668138114226,CSE 293,028,119416,Ramamoorthi; Ravi,9999,0,9999,0
1668138114226,CSE 293,029,119417,Sahoo; Debashis,9999,0,9999,0
1668138114226,CSE 293,030,119420,Saul; Lawrence,9999,0,9999,0
1668138114226,CSE 293,031,119421,Savage; Stefan,9999,0,9999,0
1668138114226,CSE 293,032,119425,Schulze; Jurgen P.,9999,0,9999,0
1668138114226,CSE 293,033,119426,Snoeren; Alex C.,9999,0,9999,0
1668138114226,CSE 293,034,119428,Shang; Jingbo,9999,0,9999,0
1668138114226,CSE 293,035,119430,Stefan; Deian,9999,0,9999,0
1668138114226,CSE 293,036,119431,Su; Hao,9999,0,9999,0
1668138114226,CSE 293,037,119433,Swanson; Steven James,9999,0,9999,0
1668138114226,CSE 293,038,119435,Tullsen; Dean Michael,9999,0,9999,0
1668138114226,CSE 293,039,119483,Voelker; Geoffrey M.,9999,0,9999,0
1668138114226,CSE 293,040,119537,Zhao; Jishen,9999,0,9999,0
1668138114226,CSE 293,041,119538,Zhou; Yuan-Yuan,9999,0,9999,0
1668138114226,CSE 293,042,119539,Gao; Sicun,9999,0,9999,0
1668138114226,CSE 293,043,119540,Weibel; Nadir,9999,0,9999,0
1668138114226,CSE 293,044,119541,Gupta; Rajesh K.,9999,0,9999,0
1668138114226,CSE 293,045,126410,Vaccaro; Kristen Marie,9999,0,9999,0
1668138114226,CSE 293,046,126411,Klemke; Richard,9999,0,9999,0
1668138114652,CSE 294,A00,102459,Voelker; Geoffrey M.,0,0,0,0
1668138114652,CSE 294,B00,111322,Orailoglu; Alex,0,0,0,0
1668138115078,DSE 201,A00,096914,Deutsch; Alin Bernard,30,0,30,0
1668138115504,DSE 210,A00,096915,Dasgupta; Sanjoy,30,0,30,0
1668138115930,DSE 260A,A00,096916,Altintas De Callaf; Ilkay,30,0,30,0
1668138116384,ECE 200,001,103586,Antipa; Nicholas A,9999,0,9999,0
1668138116384,ECE 200,002,103587,Atanasov; Nikolay A.,9999,0,9999,0
1668138116384,ECE 200,003,103588,Bharadia; Dinesh,9999,0,9999,0
1668138116384,ECE 200,004,103589,Cheng; Chung Kuan,9999,0,9999,0
1668138116384,ECE 200,005,103590,Cosman; Pamela C.,9999,0,9999,0
1668138116384,ECE 200,006,103591,Dayeh; Shadi Ahmad,9999,0,9999,0
1668138116384,ECE 200,007,103592,Fainman; Yeshaiahu,9999,0,9999,0
1668138116384,ECE 200,008,103593,Ford; Joseph Earl,9999,0,9999,0
1668138116384,ECE 200,009,103594,Franceschetti; Massimo,9999,0,9999,0
1668138116384,ECE 200,010,103595,Fullerton; Eric E,9999,0,9999,0
1668138116384,ECE 200,011,103596,Galton; Ian A,9999,0,9999,0
1668138116384,ECE 200,012,103597,Gilja; Vikash,9999,0,9999,0
1668138116384,ECE 200,013,103598,Hall; Drew A.,9999,0,9999,0
1668138116384,ECE 200,014,103599,Hsueh; Tzu-Chien,9999,0,9999,0
1668138116384,ECE 200,015,103600,Javidi; Tara,9999,0,9999,0
1668138116384,ECE 200,016,103601,Kahng; Andrew Byun,9999,0,9999,0
1668138116384,ECE 200,017,103602,Kim; Young-Han,9999,0,9999,0
1668138116384,ECE 200,018,103603,Koushanfar; Farinaz,9999,0,9999,0
1668138116384,ECE 200,019,103604,Kuzum; Duygu,9999,0,9999,0
1668138116384,ECE 200,020,103605,Le; Hanh-Phuc,9999,0,9999,0
1668138116384,ECE 200,021,103606,Lin; Bill,9999,0,9999,0
1668138116384,ECE 200,022,103607,Liu; Zhaowei,9998,0,9999,1
1668138116384,ECE 200,023,103608,Lo; Yu-Hwa,9999,0,9999,0
1668138116384,ECE 200,024,103609,Lomakin; Vitaliy,9999,0,9999,0
1668138116384,ECE 200,025,103610,Mercier; Patrick Philip,9999,0,9999,0
1668138116384,ECE 200,026,103611,Meyer; Florian,9999,0,9999,0
1668138116384,ECE 200,027,103612,Milstein; Laurence B.,9999,0,9999,0
1668138116384,ECE 200,028,103613,Mir Arabbaygi; Siavash,9999,0,9999,0
1668138116384,ECE 200,029,103614,Mookherjea; Shayan,9999,0,9999,0
1668138116384,ECE 200,030,103615,Morris; Karcher William,9999,0,9999,0
1668138116384,ECE 200,031,103616,Ng; Tse Nga,9999,0,9999,0
1668138116384,ECE 200,032,103617,Nguyen; Truong Quang,9999,0,9999,0
1668138116384,ECE 200,033,103618,Nomura; Kenji,9999,0,9999,0
1668138116384,ECE 200,034,103619,Orlitsky; Alon,9999,0,9999,0
1668138116384,ECE 200,035,103620,Pal; Piya,9999,0,9999,0
1668138116384,ECE 200,036,103621,Papen; George C.,9999,0,9999,0
1668138116384,ECE 200,037,103622,Radic; Stojan,9999,0,9999,0
1668138116384,ECE 200,038,103623,Rao; Bhaskar D.,9999,0,9999,0
1668138116384,ECE 200,039,103624,Rao; Ramesh R,9999,0,9999,0
1668138116384,ECE 200,040,103625,Rebeiz; Gabriel,9999,0,9999,0
1668138116384,ECE 200,041,103626,Sanford; John R,9999,0,9999,0
1668138116384,ECE 200,042,103627,Siegel; Paul H.,9999,0,9999,0
1668138116384,ECE 200,043,103628,Sievenpiper; Daniel F.,9999,0,9999,0
1668138116384,ECE 200,044,103629,Sworder; David D.,9999,0,9999,0
1668138116384,ECE 200,045,103630,Taur; Yuan,9999,0,9999,0
1668138116384,ECE 200,046,103631,Touri; Behrouz,9999,0,9999,0
1668138116384,ECE 200,047,103632,Trivedi; Mohan M.,9999,0,9999,0
1668138116384,ECE 200,048,103633,Vasconcelos; Nuno,9999,0,9999,0
1668138116384,ECE 200,049,103634,Wang; Xiaolong,9999,0,9999,0
1668138116384,ECE 200,050,103635,Xie; Pengtao,9999,0,9999,0
1668138116384,ECE 200,051,103636,Yip; Michael,9999,0,9999,0
1668138116384,ECE 200,052,103637,Zeger; Kenneth A.,999,0,999,0
1668138116384,ECE 200,053,103638,Zhang; Xinyu,9999,0,9999,0
1668138116384,ECE 200,054,103639,Turakhia; Yatish Girish,9999,0,9999,0
1668138116384,ECE 200,055,103640,Kang; Mingu,9999,0,9999,0
1668138116384,ECE 200,056,103641,Shi; Yuanyuan,9999,0,9999,0
1668138116384,ECE 200,057,103642,Wang; Edward Jay,9999,0,9999,0
1668138116384,ECE 200,058,103643,Zheng; Yang,9999,0,9999,0
1668138116807,ECE 202,A00,103644,Kuzum; Duygu,0,0,0,0
1668138117244,ECE 212BN,A00,103646,Ng; Tse Nga,0,0,0,0
1668138117668,ECE 221,A00,111493,Staff,0,0,0,0
1668138118099,ECE 222B,A00,103647,Lomakin; Vitaliy,0,0,0,0
1668138118541,ECE 230B,A00,103648,Taur; Yuan,0,0,0,0
1668138118972,ECE 238B,A00,103649,Garay; Javier,0,0,0,0
1668138119406,ECE 240B,A00,112900,Fainman; Yeshaiahu,0,0,0,0
1668138119830,ECE 247A,A00,103650,Jokerst; Jesse Vincent,0,0,0,0
1668138120260,ECE 247B,A00,103651,Wang; Joseph,0,0,0,0
1668138120695,ECE 250,A00,103652,Siegel; Paul H.,0,0,0,0
1668138121124,ECE 251A,A00,103654,Rao; Bhaskar D.,0,0,0,0
1668138121549,ECE 257B,A00,103655,Bharadia; Dinesh,0,0,0,0
1668138121975,ECE 258A,A00,103656,Milstein; Laurence B.,0,0,0,0
1668138122402,ECE 260B,A00,103658,Kang; Mingu,0,0,0,0
1668138122825,ECE 264A,A00,103659,Galton; Ian A,0,0,0,0
1668138123252,ECE 265A,A00,103661,Gudem; Prasad S.S.,0,0,0,0
1668138123678,ECE 265D,A00,103662,Gudem; Prasad S.S.,0,0,0,0
1668138124113,ECE 268,A00,103663,Koushanfar; Farinaz,0,0,0,0
1668138124547,ECE 269,A01,103665,Pal; Piya,0,0,0,0
1668138124979,ECE 271B,A00,103666,Vasconcelos; Manuela,0,0,0,0
1668138125409,ECE 276A,A00,103667,Atanasov; Nikolay A.,0,0,0,0
1668138125840,ECE 277,A00,103668,An; Cheolhong,0,0,0,0
1668138126265,ECE 279,A00,117947,Hall; Drew A.,0,0,0,0
1668138127112,ECE 283,A00,103670,Hsueh; Tzu-Chien,0,0,0,0
1668138127637,ECE 284,A00,103671,Turakhia; Yatish Girish,0,0,0,0
1668138128064,ECE 285,A00,103672,Zheng; Yang,0,0,0,0
1668138128064,ECE 285,B00,103673,Sworder; David D.,0,0,0,0
1668138128492,ECE 287,A00,103676,Javidi; Tara,0,0,0,0
1668138128930,MATH 200B,A00,098023,Salehi Golsefidy; Alireza,12,0,15,3
1668138129362,MATH 202B,A00,098024,Rhoades; Brendon Patrick,9,0,15,6
1668138129803,MATH 203B,A00,098025,Oprea; Dragos N.,10,0,15,5
1668138130238,MATH 204B,A00,098026,Sorensen; Claus M,13,0,15,2
1668138130662,MATH 208,A00,098027,Izadi; Elham,7,0,10,3
1668138131085,MATH 209,A00,098028,Pollack; Aaron,10,0,10,0
1668138131509,MATH 211A,A00,112919,Rogalski; Daniel,9,0,10,1
1668138131931,MATH 211B,A00,112920,Seward; Brandon M.,9,0,10,1
1668138132358,MATH 218,A00,098029,Li; Bo,10,0,10,0
1668138132791,MATH 220B,A00,098030,Novak; Jonathan I,11,0,15,4
1668138133225,MATH 221A,A00,098031,Ebenfelt; Peter F,13,0,15,2
1668138133647,MATH 231B,A00,098032,Zlatos; Andrej,12,0,15,3
1668138134070,MATH 240B,A00,098033,Ni; Lei,9,0,15,6
1668138134506,MATH 243,A00,098034,Jekel; David Andrew,10,0,10,0
1668138134948,MATH 245A,A00,098035,Nie; Jiawang,0,0,15,16
1668138135400,MATH 248,A00,098036,Bejenaru; Ioan,10,0,10,0
1668138135825,MATH 250B,A00,098037,Spolaor; Luca,14,0,15,1
1668138136260,MATH 258,A00,098038,Ni; Lei,10,0,10,0
1668138136685,MATH 264B,A00,098041,Rhoades; Brendon Patrick,9,0,15,6
1668138137126,MATH 268,A00,098042,Buss; Samuel R,10,0,10,0
1668138137550,MATH 269,A00,098043,Rhoades; Brendon Patrick,10,0,10,0
1668138137977,MATH 270B,A00,098044,Li; Bo,10,0,15,5
1668138138407,MATH 272B,A00,098045,Holst; Michael J,13,0,15,2
1668138138831,MATH 273A,A00,098046,Tian; Xiaochuan,10,0,15,5
1668138139273,MATH 275,A01,098048,Tian; Xiaochuan,6,0,10,4
1668138139710,MATH 278A,A00,098049,Holst; Michael J,8,0,10,2
1668138140137,MATH 278B,A00,098050,Cloninger; Alexander,10,0,10,0
1668138140571,MATH 278C,A00,098051,Nie; Jiawang,7,0,10,3
1668138141000,MATH 280B,A00,098052,Zheng; Tianyi,10,0,15,5
1668138141423,MATH 281B,A00,098053,Bradic; Jelena,2,0,15,13
1668138141849,MATH 282B,A00,098054,Arias-Castro; Ery,0,0,15,15
1668138142275,MATH 285,A00,098055,Fitzsimmons; Patrick J,0,0,15,17
1668138142703,MATH 287B,A00,098056,Arias-Castro; Ery,2,0,15,13
1668138143131,MATH 288,A00,098057,Agarwal; Pooja,9,0,10,1
1668138143131,MATH 288,B00,098058,Zhang; Danna,8,0,10,2
1668138143131,MATH 288,C00,098059,Williams; Ruth J,10,0,10,0
1668138143556,MATH 290B,A00,098060,Roberts; Justin Deritter,13,0,15,2
1668138143978,MATH 292,A00,098061,Belmont; Eva Kinoshita,10,0,10,0
1668138144419,MATH 295,A00,098062,Suk; Andrew Hoon,48,0,50,2
1668138144867,MATH 296,A00,098063,Novak; Jonathan I,20,0,20,0
1668138145295,MATH 297,001,098064,Gamst; Anthony Collins,9997,0,9999,2
1668138662429,COGS 205,A00,101395,Chiba; Andrea,19,0,20,1
1668138662866,COGS 210B,001,101404,Greene; Deanna Jacquelyn,9998,0,9999,1
1668138662866,COGS 210B,002,101417,Xia; Haijun,9999,0,9999,0
1668138662866,COGS 210B,003,101422,Nitz; Douglas A.,9999,0,9999,0
1668138662866,COGS 210B,004,101423,Hollan; James D.,9998,0,9999,1
1668138662866,COGS 210B,005,101424,Deak; Gedeon O.,9998,0,9999,1
1668138662866,COGS 210B,006,101425,Rossano; Federico,9999,0,9999,0
1668138663290,COGS 211B,A00,101427,Coulson; Seana M,9996,0,9999,3
1668138663713,COGS 220,A00,101428,Hollan; James D.,0,0,25,25
1668138664143,COGS 229,A00,101429,Dow; Steven P,18,0,25,7
1668138664571,COGS 230,A00,101430,Klemmer; Scott R,12,0,17,5
1668138665101,COGS 234,A00,101431,Xia; Haijun,3,0,25,22
1668138665524,COGS 260,A00,101432,Kiyonaga; Anastasia,20,0,25,5
1668138665524,COGS 260,B00,101433,Kirsh; David Joel,16,0,25,9
1668138665970,CSE 202,A00,102371,Impagliazzo; Russell,0,0,0,0
1668138666402,CSE 203B,A01,102373,Cheng; Chung Kuan,0,0,0,0
1668138666827,CSE 208,A00,102374,Micciancio; Daniele,0,0,0,0
1668138667283,CSE 209A,A00,112895,Impagliazzo; Russell,0,0,15,15
1668138667710,CSE 209B,A00,108005,Bellare; Mihir,0,0,0,0
1668138668133,CSE 210,A00,113163,Coblenz; Michael J,0,0,0,0
1668138668554,CSE 219,A00,106111,Dow; Steven P,0,0,20,20
1668138668986,CSE 221,A00,102376,Voelker; Geoffrey M.,0,0,0,0
1668138669412,CSE 224,A01,102378,Porter; George M,0,0,0,0
1668138669836,CSE 229A,A00,102379,Savage; Stefan,0,0,0,0
1668138670285,CSE 229C,A00,102380,Munyaka; Imani N. S.,0,0,0,0
1668138670711,CSE 232B,A00,102382,Deutsch; Alin Bernard,0,0,0,0
1668138671144,CSE 234,A01,112904,Kumar; Arun Kumar,0,0,0,0
1668138671577,CSE 237A,A00,102383,Rosing; Tajana Simunic,0,0,0,0
1668138672004,CSE 239A,A00,102384,Deutsch; Alin Bernard,0,0,0,0
1668138672433,CSE 239B,A00,102385,Polikarpova; Nadezhda,0,0,0,0
1668138672862,CSE 240A,A00,102386,Pannuto; Patrick William,0,0,0,0
1668138673296,CSE 240B,A00,102387,Zhao; Jishen,0,0,0,0
1668138673724,CSE 241A,A00,106406,Kang; Mingu,0,0,0,0
1668138674153,CSE 249B,A00,102388,Kahng; Andrew Byun,0,0,8,8
1668138674594,CSE 251B,A01,102392,Cottrell; Garrison W,0,0,0,0
1668138674594,CSE 251B,A02,102393,Cottrell; Garrison W,0,0,0,0
1668138675022,CSE 252B,A00,102394,Ochoa; Benjamin Lawrence,0,0,0,0
1668138675451,CSE 257,A01,102396,Gao; Sicun,0,0,0,0
1668138676032,CSE 272,A00,102397,Li; Tzumao,0,0,0,0
1668138676458,CSE 274,A00,111323,Chern; Albert Ren-Haur,0,0,0,0
1668138676883,CSE 282,A00,102398,Pevzner; Pavel Arkadjevich,0,0,0,0
1668138677315,CSE 284,A00,114175,Gymrek; Melissa Ann,0,0,0,0
1668138677744,CSE 290,A00,102399,Chandraker; Manmohan Krishna,0,0,0,0
1668138677744,CSE 290,B00,102400,Vaccaro; Kristen Marie,0,0,25,25
1668138677744,CSE 290,C00,102414,Pannuto; Patrick William,0,0,25,25
1668138677744,CSE 290,D00,102427,Pevzner; Pavel Arkadjevich,0,0,0,0
1668138677744,CSE 290,E00,102429,Zhao; Jishen,0,0,0,0
1668138677744,CSE 290,F00,102436,Tullsen; Dean Michael,0,0,0,0
1668138677744,CSE 290,G00,102440,Christensen; Henrik I,0,0,20,20
1668138678170,CSE 291,A00,102443,Su; Hao,0,0,0,0
1668138678170,CSE 291,B00,102448,Polikarpova; Nadezhda,0,0,0,0
1668138678170,CSE 291,C00,102453,Vaccaro; Kristen Marie,0,0,0,0
1668138678170,CSE 291,D00,111343,Savage; Stefan,0,0,0,0
1668138678170,CSE 291,E00,116474,Claffy; Kimberly Claire,0,0,0,0
1668138678170,CSE 291,F00,116479,Pasquale; Joseph,0,0,0,0
1668138678629,CSE 293,001,119111,Bafna; Vineet,9999,0,9999,0
1668138678629,CSE 293,002,119118,Bellare; Mihir,9999,0,9999,0
1668138678629,CSE 293,003,119122,Berg-Kirkpatrick; Taylor D,9999,0,9999,0
1668138678629,CSE 293,004,119135,Christensen; Henrik I,9999,0,9999,0
1668138678629,CSE 293,005,119142,Cottrell; Garrison W,9999,0,9999,0
1668138678629,CSE 293,006,119146,Deutsch; Alin Bernard,9999,0,9999,0
1668138678629,CSE 293,007,119159,Esmaeilzadeh; Hadi,9999,0,9999,0
1668138678629,CSE 293,008,119166,Freund; Yoav,9999,0,9999,0
1668138678629,CSE 293,009,119170,Griswold; William G.,9999,0,9999,0
1668138678629,CSE 293,010,119183,Gymrek; Melissa Ann,9999,0,9999,0
1668138678629,CSE 293,011,119190,Heninger; Nadia A,9999,0,9999,0
1668138678629,CSE 293,012,119230,Impagliazzo; Russell,9999,0,9999,0
1668138678629,CSE 293,013,119232,Jhala; Ranjit,9999,0,9999,0
1668138678629,CSE 293,014,119233,Kahng; Andrew Byun,9999,0,9999,0
1668138678629,CSE 293,015,119298,Kane; Daniel Mertz,9999,0,9999,0
1668138678629,CSE 293,016,119299,Kriegman; David J,9999,0,9999,0
1668138678629,CSE 293,017,119300,Kumar; Arun Kumar,9999,0,9999,0
1668138678629,CSE 293,018,119301,Lerner; Sorin,9999,0,9999,0
1668138678629,CSE 293,019,119302,Lovett; Shachar,9999,0,9999,0
1668138678629,CSE 293,020,119303,McAuley; Julian John,9999,0,9999,0
1668138678629,CSE 293,021,119304,Micciancio; Daniele,9999,0,9999,0
1668138678629,CSE 293,022,119367,Orailoglu; Alex,9999,0,9999,0
1668138678629,CSE 293,023,119382,Paturi; Ramamohan,9999,0,9999,0
1668138678629,CSE 293,024,119404,Polikarpova; Nadezhda,9999,0,9999,0
1668138678629,CSE 293,025,119406,Politz; Joseph Gibbs,9999,0,9999,0
1668138678629,CSE 293,026,119411,Porter; George M,9999,0,9999,0
1668138678629,CSE 293,027,119414,Porter; Leonard Emerson,9999,0,9999,0
1668138678629,CSE 293,028,119416,Ramamoorthi; Ravi,9999,0,9999,0
1668138678629,CSE 293,029,119417,Sahoo; Debashis,9999,0,9999,0
1668138678629,CSE 293,030,119420,Saul; Lawrence,9999,0,9999,0
1668138678629,CSE 293,031,119421,Savage; Stefan,9999,0,9999,0
1668138678629,CSE 293,032,119425,Schulze; Jurgen P.,9999,0,9999,0
1668138678629,CSE 293,033,119426,Snoeren; Alex C.,9999,0,9999,0
1668138678629,CSE 293,034,119428,Shang; Jingbo,9999,0,9999,0
1668138678629,CSE 293,035,119430,Stefan; Deian,9999,0,9999,0
1668138678629,CSE 293,036,119431,Su; Hao,9999,0,9999,0
1668138678629,CSE 293,037,119433,Swanson; Steven James,9999,0,9999,0
1668138678629,CSE 293,038,119435,Tullsen; Dean Michael,9999,0,9999,0
1668138678629,CSE 293,039,119483,Voelker; Geoffrey M.,9999,0,9999,0
1668138678629,CSE 293,040,119537,Zhao; Jishen,9999,0,9999,0
1668138678629,CSE 293,041,119538,Zhou; Yuan-Yuan,9999,0,9999,0
1668138678629,CSE 293,042,119539,Gao; Sicun,9999,0,9999,0
1668138678629,CSE 293,043,119540,Weibel; Nadir,9999,0,9999,0
1668138678629,CSE 293,044,119541,Gupta; Rajesh K.,9999,0,9999,0
1668138678629,CSE 293,045,126410,Vaccaro; Kristen Marie,9999,0,9999,0
1668138678629,CSE 293,046,126411,Klemke; Richard,9999,0,9999,0
1668138679057,CSE 294,A00,102459,Voelker; Geoffrey M.,0,0,0,0
1668138679057,CSE 294,B00,111322,Orailoglu; Alex,0,0,0,0
1668138679481,DSE 201,A00,096914,Deutsch; Alin Bernard,30,0,30,0
1668138679904,DSE 210,A00,096915,Dasgupta; Sanjoy,30,0,30,0
1668138680330,DSE 260A,A00,096916,Altintas De Callaf; Ilkay,30,0,30,0
1668138680857,ECE 200,001,103586,Antipa; Nicholas A,9999,0,9999,0
1668138680857,ECE 200,002,103587,Atanasov; Nikolay A.,9999,0,9999,0
1668138680857,ECE 200,003,103588,Bharadia; Dinesh,9999,0,9999,0
1668138680857,ECE 200,004,103589,Cheng; Chung Kuan,9999,0,9999,0
1668138680857,ECE 200,005,103590,Cosman; Pamela C.,9999,0,9999,0
1668138680857,ECE 200,006,103591,Dayeh; Shadi Ahmad,9999,0,9999,0
1668138680857,ECE 200,007,103592,Fainman; Yeshaiahu,9999,0,9999,0
1668138680857,ECE 200,008,103593,Ford; Joseph Earl,9999,0,9999,0
1668138680857,ECE 200,009,103594,Franceschetti; Massimo,9999,0,9999,0
1668138680857,ECE 200,010,103595,Fullerton; Eric E,9999,0,9999,0
1668138680857,ECE 200,011,103596,Galton; Ian A,9999,0,9999,0
1668138680857,ECE 200,012,103597,Gilja; Vikash,9999,0,9999,0
1668138680857,ECE 200,013,103598,Hall; Drew A.,9999,0,9999,0
1668138680857,ECE 200,014,103599,Hsueh; Tzu-Chien,9999,0,9999,0
1668138680857,ECE 200,015,103600,Javidi; Tara,9999,0,9999,0
1668138680857,ECE 200,016,103601,Kahng; Andrew Byun,9999,0,9999,0
1668138680857,ECE 200,017,103602,Kim; Young-Han,9999,0,9999,0
1668138680857,ECE 200,018,103603,Koushanfar; Farinaz,9999,0,9999,0
1668138680857,ECE 200,019,103604,Kuzum; Duygu,9999,0,9999,0
1668138680857,ECE 200,020,103605,Le; Hanh-Phuc,9999,0,9999,0
1668138680857,ECE 200,021,103606,Lin; Bill,9999,0,9999,0
1668138680857,ECE 200,022,103607,Liu; Zhaowei,9998,0,9999,1
1668138680857,ECE 200,023,103608,Lo; Yu-Hwa,9999,0,9999,0
1668138680857,ECE 200,024,103609,Lomakin; Vitaliy,9999,0,9999,0
1668138680857,ECE 200,025,103610,Mercier; Patrick Philip,9999,0,9999,0
1668138680857,ECE 200,026,103611,Meyer; Florian,9999,0,9999,0
1668138680857,ECE 200,027,103612,Milstein; Laurence B.,9999,0,9999,0
1668138680857,ECE 200,028,103613,Mir Arabbaygi; Siavash,9999,0,9999,0
1668138680857,ECE 200,029,103614,Mookherjea; Shayan,9999,0,9999,0
1668138680857,ECE 200,030,103615,Morris; Karcher William,9999,0,9999,0
1668138680857,ECE 200,031,103616,Ng; Tse Nga,9999,0,9999,0
1668138680857,ECE 200,032,103617,Nguyen; Truong Quang,9999,0,9999,0
1668138680857,ECE 200,033,103618,Nomura; Kenji,9999,0,9999,0
1668138680857,ECE 200,034,103619,Orlitsky; Alon,9999,0,9999,0
1668138680857,ECE 200,035,103620,Pal; Piya,9999,0,9999,0
1668138680857,ECE 200,036,103621,Papen; George C.,9999,0,9999,0
1668138680857,ECE 200,037,103622,Radic; Stojan,9999,0,9999,0
1668138680857,ECE 200,038,103623,Rao; Bhaskar D.,9999,0,9999,0
1668138680857,ECE 200,039,103624,Rao; Ramesh R,9999,0,9999,0
1668138680857,ECE 200,040,103625,Rebeiz; Gabriel,9999,0,9999,0
1668138680857,ECE 200,041,103626,Sanford; John R,9999,0,9999,0
1668138680857,ECE 200,042,103627,Siegel; Paul H.,9999,0,9999,0
1668138680857,ECE 200,043,103628,Sievenpiper; Daniel F.,9999,0,9999,0
1668138680857,ECE 200,044,103629,Sworder; David D.,9999,0,9999,0
1668138680857,ECE 200,045,103630,Taur; Yuan,9999,0,9999,0
1668138680857,ECE 200,046,103631,Touri; Behrouz,9999,0,9999,0
1668138680857,ECE 200,047,103632,Trivedi; Mohan M.,9999,0,9999,0
1668138680857,ECE 200,048,103633,Vasconcelos; Nuno,9999,0,9999,0
1668138680857,ECE 200,049,103634,Wang; Xiaolong,9999,0,9999,0
1668138680857,ECE 200,050,103635,Xie; Pengtao,9999,0,9999,0
1668138680857,ECE 200,051,103636,Yip; Michael,9999,0,9999,0
1668138680857,ECE 200,052,103637,Zeger; Kenneth A.,999,0,999,0
1668138680857,ECE 200,053,103638,Zhang; Xinyu,9999,0,9999,0
1668138680857,ECE 200,054,103639,Turakhia; Yatish Girish,9999,0,9999,0
1668138680857,ECE 200,055,103640,Kang; Mingu,9999,0,9999,0
1668138680857,ECE 200,056,103641,Shi; Yuanyuan,9999,0,9999,0
1668138680857,ECE 200,057,103642,Wang; Edward Jay,9999,0,9999,0
1668138680857,ECE 200,058,103643,Zheng; Yang,9999,0,9999,0
1668138681291,ECE 202,A00,103644,Kuzum; Duygu,0,0,0,0
1668138681723,ECE 212BN,A00,103646,Ng; Tse Nga,0,0,0,0
1668138682146,ECE 221,A00,111493,Staff,0,0,0,0
1668138682568,ECE 222B,A00,103647,Lomakin; Vitaliy,0,0,0,0
1668138682993,ECE 230B,A00,103648,Taur; Yuan,0,0,0,0
1668138683429,ECE 238B,A00,103649,Garay; Javier,0,0,0,0
1668138683873,ECE 240B,A00,112900,Fainman; Yeshaiahu,0,0,0,0
1668138684295,ECE 247A,A00,103650,Jokerst; Jesse Vincent,0,0,0,0
1668138684717,ECE 247B,A00,103651,Wang; Joseph,0,0,0,0
1668138685154,ECE 250,A00,103652,Siegel; Paul H.,0,0,0,0
1668138685583,ECE 251A,A00,103654,Rao; Bhaskar D.,0,0,0,0
1668138686008,ECE 257B,A00,103655,Bharadia; Dinesh,0,0,0,0
1668138686431,ECE 258A,A00,103656,Milstein; Laurence B.,0,0,0,0
1668138686861,ECE 260B,A00,103658,Kang; Mingu,0,0,0,0
1668138687295,ECE 264A,A00,103659,Galton; Ian A,0,0,0,0
1668138687744,ECE 265A,A00,103661,Gudem; Prasad S.S.,0,0,0,0
1668138688173,ECE 265D,A00,103662,Gudem; Prasad S.S.,0,0,0,0
1668138688610,ECE 268,A00,103663,Koushanfar; Farinaz,0,0,0,0
1668138689035,ECE 269,A01,103665,Pal; Piya,0,0,0,0
1668138689481,ECE 271B,A00,103666,Vasconcelos; Manuela,0,0,0,0
1668138689914,ECE 276A,A00,103667,Atanasov; Nikolay A.,0,0,0,0
1668138690341,ECE 277,A00,103668,An; Cheolhong,0,0,0,0
1668138690763,ECE 279,A00,117947,Hall; Drew A.,0,0,0,0
1668138691613,ECE 283,A00,103670,Hsueh; Tzu-Chien,0,0,0,0
1668138692037,ECE 284,A00,103671,Turakhia; Yatish Girish,0,0,0,0
1668138692464,ECE 285,A00,103672,Zheng; Yang,0,0,0,0
1668138692464,ECE 285,B00,103673,Sworder; David D.,0,0,0,0
1668138692890,ECE 287,A00,103676,Javidi; Tara,0,0,0,0
1668138693315,MATH 200B,A00,098023,Salehi Golsefidy; Alireza,12,0,15,3
1668138693747,MATH 202B,A00,098024,Rhoades; Brendon Patrick,9,0,15,6
1668138694171,MATH 203B,A00,098025,Oprea; Dragos N.,10,0,15,5
1668138694599,MATH 204B,A00,098026,Sorensen; Claus M,13,0,15,2
1668138695041,MATH 208,A00,098027,Izadi; Elham,7,0,10,3
1668138695471,MATH 209,A00,098028,Pollack; Aaron,10,0,10,0
1668138695910,MATH 211A,A00,112919,Rogalski; Daniel,9,0,10,1
1668138696350,MATH 211B,A00,112920,Seward; Brandon M.,9,0,10,1
1668138696773,MATH 218,A00,098029,Li; Bo,10,0,10,0
1668138697208,MATH 220B,A00,098030,Novak; Jonathan I,11,0,15,4
1668138697640,MATH 221A,A00,098031,Ebenfelt; Peter F,13,0,15,2
1668138698065,MATH 231B,A00,098032,Zlatos; Andrej,12,0,15,3
1668138698490,MATH 240B,A00,098033,Ni; Lei,9,0,15,6
1668138698914,MATH 243,A00,098034,Jekel; David Andrew,10,0,10,0
1668138699345,MATH 245A,A00,098035,Nie; Jiawang,0,0,15,16
1668138699772,MATH 248,A00,098036,Bejenaru; Ioan,10,0,10,0
1668138700198,MATH 250B,A00,098037,Spolaor; Luca,14,0,15,1
1668138700633,MATH 258,A00,098038,Ni; Lei,10,0,10,0
1668138701057,MATH 264B,A00,098041,Rhoades; Brendon Patrick,9,0,15,6
1668138701499,MATH 268,A00,098042,Buss; Samuel R,10,0,10,0
1668138701922,MATH 269,A00,098043,Rhoades; Brendon Patrick,10,0,10,0
1668138702349,MATH 270B,A00,098044,Li; Bo,10,0,15,5
1668138702783,MATH 272B,A00,098045,Holst; Michael J,13,0,15,2
1668138703230,MATH 273A,A00,098046,Tian; Xiaochuan,10,0,15,5
1668138703658,MATH 275,A01,098048,Tian; Xiaochuan,6,0,10,4
1668138704093,MATH 278A,A00,098049,Holst; Michael J,8,0,10,2
1668138704516,MATH 278B,A00,098050,Cloninger; Alexander,10,0,10,0
1668138704942,MATH 278C,A00,098051,Nie; Jiawang,7,0,10,3
1668138705375,MATH 280B,A00,098052,Zheng; Tianyi,10,0,15,5
1668138705797,MATH 281B,A00,098053,Bradic; Jelena,2,0,15,13
1668138706220,MATH 282B,A00,098054,Arias-Castro; Ery,0,0,15,15
1668138706649,MATH 285,A00,098055,Fitzsimmons; Patrick J,0,0,15,17
1668138707073,MATH 287B,A00,098056,Arias-Castro; Ery,2,0,15,13
1668138707502,MATH 288,A00,098057,Agarwal; Pooja,9,0,10,1
1668138707502,MATH 288,B00,098058,Zhang; Danna,8,0,10,2
1668138707502,MATH 288,C00,098059,Williams; Ruth J,10,0,10,0
1668138707931,MATH 290B,A00,098060,Roberts; Justin Deritter,13,0,15,2
1668138708358,MATH 292,A00,098061,Belmont; Eva Kinoshita,10,0,10,0
1668138708858,MATH 295,A00,098062,Suk; Andrew Hoon,48,0,50,2
1668138709279,MATH 296,A00,098063,Novak; Jonathan I,20,0,20,0
1668138709711,MATH 297,001,098064,Gamst; Anthony Collins,9997,0,9999,2
1668139214818,COGS 205,A00,101395,Chiba; Andrea,19,0,20,1
1668139215256,COGS 210B,001,101404,Greene; Deanna Jacquelyn,9998,0,9999,1
1668139215256,COGS 210B,002,101417,Xia; Haijun,9999,0,9999,0
1668139215256,COGS 210B,003,101422,Nitz; Douglas A.,9999,0,9999,0
1668139215256,COGS 210B,004,101423,Hollan; James D.,9998,0,9999,1
1668139215256,COGS 210B,005,101424,Deak; Gedeon O.,9998,0,9999,1
1668139215256,COGS 210B,006,101425,Rossano; Federico,9999,0,9999,0
1668139215677,COGS 211B,A00,101427,Coulson; Seana M,9996,0,9999,3
1668139216108,COGS 220,A00,101428,Hollan; James D.,0,0,25,25
1668139216545,COGS 229,A00,101429,Dow; Steven P,18,0,25,7
1668139216981,COGS 230,A00,101430,Klemmer; Scott R,12,0,17,5
1668139217403,COGS 234,A00,101431,Xia; Haijun,3,0,25,22
1668139217830,COGS 260,A00,101432,Kiyonaga; Anastasia,20,0,25,5
1668139217830,COGS 260,B00,101433,Kirsh; David Joel,16,0,25,9
1668139218263,CSE 202,A00,102371,Impagliazzo; Russell,0,0,0,0
1668139218723,CSE 203B,A01,102373,Cheng; Chung Kuan,0,0,0,0
1668139219155,CSE 208,A00,102374,Micciancio; Daniele,0,0,0,0
1668139219588,CSE 209A,A00,112895,Impagliazzo; Russell,0,0,15,15
1668139220011,CSE 209B,A00,108005,Bellare; Mihir,0,0,0,0
1668139220433,CSE 210,A00,113163,Coblenz; Michael J,0,0,0,0
1668139220861,CSE 219,A00,106111,Dow; Steven P,0,0,20,20
1668139221288,CSE 221,A00,102376,Voelker; Geoffrey M.,0,0,0,0
1668139221709,CSE 224,A01,102378,Porter; George M,0,0,0,0
1668139222142,CSE 229A,A00,102379,Savage; Stefan,0,0,0,0
1668139222564,CSE 229C,A00,102380,Munyaka; Imani N. S.,0,0,0,0
1668139222988,CSE 232B,A00,102382,Deutsch; Alin Bernard,0,0,0,0
1668139223415,CSE 234,A01,112904,Kumar; Arun Kumar,0,0,0,0
1668139224043,CSE 237A,A00,102383,Rosing; Tajana Simunic,0,0,0,0
1668139224487,CSE 239A,A00,102384,Deutsch; Alin Bernard,0,0,0,0
1668139224910,CSE 239B,A00,102385,Polikarpova; Nadezhda,0,0,0,0
1668139225345,CSE 240A,A00,102386,Pannuto; Patrick William,0,0,0,0
1668139225782,CSE 240B,A00,102387,Zhao; Jishen,0,0,0,0
1668139226205,CSE 241A,A00,106406,Kang; Mingu,0,0,0,0
1668139226680,CSE 249B,A00,102388,Kahng; Andrew Byun,0,0,8,8
1668139227114,CSE 251B,A01,102392,Cottrell; Garrison W,0,0,0,0
1668139227114,CSE 251B,A02,102393,Cottrell; Garrison W,0,0,0,0
1668139227538,CSE 252B,A00,102394,Ochoa; Benjamin Lawrence,0,0,0,0
1668139227967,CSE 257,A01,102396,Gao; Sicun,0,0,0,0
1668139228391,CSE 272,A00,102397,Li; Tzumao,0,0,0,0
1668139228815,CSE 274,A00,111323,Chern; Albert Ren-Haur,0,0,0,0
1668139229237,CSE 282,A00,102398,Pevzner; Pavel Arkadjevich,0,0,0,0
1668139229661,CSE 284,A00,114175,Gymrek; Melissa Ann,0,0,0,0
1668139230085,CSE 290,A00,102399,Chandraker; Manmohan Krishna,0,0,0,0
1668139230085,CSE 290,B00,102400,Vaccaro; Kristen Marie,0,0,25,25
1668139230085,CSE 290,C00,102414,Pannuto; Patrick William,0,0,25,25
1668139230085,CSE 290,D00,102427,Pevzner; Pavel Arkadjevich,0,0,0,0
1668139230085,CSE 290,E00,102429,Zhao; Jishen,0,0,0,0
1668139230085,CSE 290,F00,102436,Tullsen; Dean Michael,0,0,0,0
1668139230085,CSE 290,G00,102440,Christensen; Henrik I,0,0,20,20
1668139230511,CSE 291,A00,102443,Su; Hao,0,0,0,0
1668139230511,CSE 291,B00,102448,Polikarpova; Nadezhda,0,0,0,0
1668139230511,CSE 291,C00,102453,Vaccaro; Kristen Marie,0,0,0,0
1668139230511,CSE 291,D00,111343,Savage; Stefan,0,0,0,0
1668139230511,CSE 291,E00,116474,Claffy; Kimberly Claire,0,0,0,0
1668139230511,CSE 291,F00,116479,Pasquale; Joseph,0,0,0,0
1668139230966,CSE 293,001,119111,Bafna; Vineet,9999,0,9999,0
1668139230966,CSE 293,002,119118,Bellare; Mihir,9999,0,9999,0
1668139230966,CSE 293,003,119122,Berg-Kirkpatrick; Taylor D,9999,0,9999,0
1668139230966,CSE 293,004,119135,Christensen; Henrik I,9999,0,9999,0
1668139230966,CSE 293,005,119142,Cottrell; Garrison W,9999,0,9999,0
1668139230966,CSE 293,006,119146,Deutsch; Alin Bernard,9999,0,9999,0
1668139230966,CSE 293,007,119159,Esmaeilzadeh; Hadi,9999,0,9999,0
1668139230966,CSE 293,008,119166,Freund; Yoav,9999,0,9999,0
1668139230966,CSE 293,009,119170,Griswold; William G.,9999,0,9999,0
1668139230966,CSE 293,010,119183,Gymrek; Melissa Ann,9999,0,9999,0
1668139230966,CSE 293,011,119190,Heninger; Nadia A,9999,0,9999,0
1668139230966,CSE 293,012,119230,Impagliazzo; Russell,9999,0,9999,0
1668139230966,CSE 293,013,119232,Jhala; Ranjit,9999,0,9999,0
1668139230966,CSE 293,014,119233,Kahng; Andrew Byun,9999,0,9999,0
1668139230966,CSE 293,015,119298,Kane; Daniel Mertz,9999,0,9999,0
1668139230966,CSE 293,016,119299,Kriegman; David J,9999,0,9999,0
1668139230966,CSE 293,017,119300,Kumar; Arun Kumar,9999,0,9999,0
1668139230966,CSE 293,018,119301,Lerner; Sorin,9999,0,9999,0
1668139230966,CSE 293,019,119302,Lovett; Shachar,9999,0,9999,0
1668139230966,CSE 293,020,119303,McAuley; Julian John,9999,0,9999,0
1668139230966,CSE 293,021,119304,Micciancio; Daniele,9999,0,9999,0
1668139230966,CSE 293,022,119367,Orailoglu; Alex,9999,0,9999,0
1668139230966,CSE 293,023,119382,Paturi; Ramamohan,9999,0,9999,0
1668139230966,CSE 293,024,119404,Polikarpova; Nadezhda,9999,0,9999,0
1668139230966,CSE 293,025,119406,Politz; Joseph Gibbs,9999,0,9999,0
1668139230966,CSE 293,026,119411,Porter; George M,9999,0,9999,0
1668139230966,CSE 293,027,119414,Porter; Leonard Emerson,9999,0,9999,0
1668139230966,CSE 293,028,119416,Ramamoorthi; Ravi,9999,0,9999,0
1668139230966,CSE 293,029,119417,Sahoo; Debashis,9999,0,9999,0
1668139230966,CSE 293,030,119420,Saul; Lawrence,9999,0,9999,0
1668139230966,CSE 293,031,119421,Savage; Stefan,9999,0,9999,0
1668139230966,CSE 293,032,119425,Schulze; Jurgen P.,9999,0,9999,0
1668139230966,CSE 293,033,119426,Snoeren; Alex C.,9999,0,9999,0
1668139230966,CSE 293,034,119428,Shang; Jingbo,9999,0,9999,0
1668139230966,CSE 293,035,119430,Stefan; Deian,9999,0,9999,0
1668139230966,CSE 293,036,119431,Su; Hao,9999,0,9999,0
1668139230966,CSE 293,037,119433,Swanson; Steven James,9999,0,9999,0
1668139230966,CSE 293,038,119435,Tullsen; Dean Michael,9999,0,9999,0
1668139230966,CSE 293,039,119483,Voelker; Geoffrey M.,9999,0,9999,0
1668139230966,CSE 293,040,119537,Zhao; Jishen,9999,0,9999,0
1668139230966,CSE 293,041,119538,Zhou; Yuan-Yuan,9999,0,9999,0
1668139230966,CSE 293,042,119539,Gao; Sicun,9999,0,9999,0
1668139230966,CSE 293,043,119540,Weibel; Nadir,9999,0,9999,0
1668139230966,CSE 293,044,119541,Gupta; Rajesh K.,9999,0,9999,0
1668139230966,CSE 293,045,126410,Vaccaro; Kristen Marie,9999,0,9999,0
1668139230966,CSE 293,046,126411,Klemke; Richard,9999,0,9999,0
1668139231391,CSE 294,A00,102459,Voelker; Geoffrey M.,0,0,0,0
1668139231391,CSE 294,B00,111322,Orailoglu; Alex,0,0,0,0
1668139231818,DSE 201,A00,096914,Deutsch; Alin Bernard,30,0,30,0
1668139232242,DSE 210,A00,096915,Dasgupta; Sanjoy,30,0,30,0
1668139232664,DSE 260A,A00,096916,Altintas De Callaf; Ilkay,30,0,30,0
1668139233095,ECE 200,001,103586,Antipa; Nicholas A,9999,0,9999,0
1668139233095,ECE 200,002,103587,Atanasov; Nikolay A.,9999,0,9999,0
1668139233095,ECE 200,003,103588,Bharadia; Dinesh,9999,0,9999,0
1668139233095,ECE 200,004,103589,Cheng; Chung Kuan,9999,0,9999,0
1668139233095,ECE 200,005,103590,Cosman; Pamela C.,9999,0,9999,0
1668139233095,ECE 200,006,103591,Dayeh; Shadi Ahmad,9999,0,9999,0
1668139233095,ECE 200,007,103592,Fainman; Yeshaiahu,9999,0,9999,0
1668139233095,ECE 200,008,103593,Ford; Joseph Earl,9999,0,9999,0
1668139233095,ECE 200,009,103594,Franceschetti; Massimo,9999,0,9999,0
1668139233095,ECE 200,010,103595,Fullerton; Eric E,9999,0,9999,0
1668139233095,ECE 200,011,103596,Galton; Ian A,9999,0,9999,0
1668139233095,ECE 200,012,103597,Gilja; Vikash,9999,0,9999,0
1668139233095,ECE 200,013,103598,Hall; Drew A.,9999,0,9999,0
1668139233095,ECE 200,014,103599,Hsueh; Tzu-Chien,9999,0,9999,0
1668139233095,ECE 200,015,103600,Javidi; Tara,9999,0,9999,0
1668139233095,ECE 200,016,103601,Kahng; Andrew Byun,9999,0,9999,0
1668139233095,ECE 200,017,103602,Kim; Young-Han,9999,0,9999,0
1668139233095,ECE 200,018,103603,Koushanfar; Farinaz,9999,0,9999,0
1668139233095,ECE 200,019,103604,Kuzum; Duygu,9999,0,9999,0
1668139233095,ECE 200,020,103605,Le; Hanh-Phuc,9999,0,9999,0
1668139233095,ECE 200,021,103606,Lin; Bill,9999,0,9999,0
1668139233095,ECE 200,022,103607,Liu; Zhaowei,9998,0,9999,1
1668139233095,ECE 200,023,103608,Lo; Yu-Hwa,9999,0,9999,0
1668139233095,ECE 200,024,103609,Lomakin; Vitaliy,9999,0,9999,0
1668139233095,ECE 200,025,103610,Mercier; Patrick Philip,9999,0,9999,0
1668139233095,ECE 200,026,103611,Meyer; Florian,9999,0,9999,0
1668139233095,ECE 200,027,103612,Milstein; Laurence B.,9999,0,9999,0
1668139233095,ECE 200,028,103613,Mir Arabbaygi; Siavash,9999,0,9999,0
1668139233095,ECE 200,029,103614,Mookherjea; Shayan,9999,0,9999,0
1668139233095,ECE 200,030,103615,Morris; Karcher William,9999,0,9999,0
1668139233095,ECE 200,031,103616,Ng; Tse Nga,9999,0,9999,0
1668139233095,ECE 200,032,103617,Nguyen; Truong Quang,9999,0,9999,0
1668139233095,ECE 200,033,103618,Nomura; Kenji,9999,0,9999,0
1668139233095,ECE 200,034,103619,Orlitsky; Alon,9999,0,9999,0
1668139233095,ECE 200,035,103620,Pal; Piya,9999,0,9999,0
1668139233095,ECE 200,036,103621,Papen; George C.,9999,0,9999,0
1668139233095,ECE 200,037,103622,Radic; Stojan,9999,0,9999,0
1668139233095,ECE 200,038,103623,Rao; Bhaskar D.,9999,0,9999,0
1668139233095,ECE 200,039,103624,Rao; Ramesh R,9999,0,9999,0
1668139233095,ECE 200,040,103625,Rebeiz; Gabriel,9999,0,9999,0
1668139233095,ECE 200,041,103626,Sanford; John R,9999,0,9999,0
1668139233095,ECE 200,042,103627,Siegel; Paul H.,9999,0,9999,0
1668139233095,ECE 200,043,103628,Sievenpiper; Daniel F.,9999,0,9999,0
1668139233095,ECE 200,044,103629,Sworder; David D.,9999,0,9999,0
1668139233095,ECE 200,045,103630,Taur; Yuan,9999,0,9999,0
1668139233095,ECE 200,046,103631,Touri; Behrouz,9999,0,9999,0
1668139233095,ECE 200,047,103632,Trivedi; Mohan M.,9999,0,9999,0
1668139233095,ECE 200,048,103633,Vasconcelos; Nuno,9999,0,9999,0
1668139233095,ECE 200,049,103634,Wang; Xiaolong,9999,0,9999,0
1668139233095,ECE 200,050,103635,Xie; Pengtao,9999,0,9999,0
1668139233095,ECE 200,051,103636,Yip; Michael,9999,0,9999,0
1668139233095,ECE 200,052,103637,Zeger; Kenneth A.,999,0,999,0
1668139233095,ECE 200,053,103638,Zhang; Xinyu,9999,0,9999,0
1668139233095,ECE 200,054,103639,Turakhia; Yatish Girish,9999,0,9999,0
1668139233095,ECE 200,055,103640,Kang; Mingu,9999,0,9999,0
1668139233095,ECE 200,056,103641,Shi; Yuanyuan,9999,0,9999,0
1668139233095,ECE 200,057,103642,Wang; Edward Jay,9999,0,9999,0
1668139233095,ECE 200,058,103643,Zheng; Yang,9999,0,9999,0
1668139233520,ECE 202,A00,103644,Kuzum; Duygu,0,0,0,0
1668139233946,ECE 212BN,A00,103646,Ng; Tse Nga,0,0,0,0
1668139234457,ECE 221,A00,111493,Staff,0,0,0,0
1668139234879,ECE 222B,A00,103647,Lomakin; Vitaliy,0,0,0,0
1668139235317,ECE 230B,A00,103648,Taur; Yuan,0,0,0,0
1668139235747,ECE 238B,A00,103649,Garay; Javier,0,0,0,0
1668139236195,ECE 240B,A00,112900,Fainman; Yeshaiahu,0,0,0,0
1668139236626,ECE 247A,A00,103650,Jokerst; Jesse Vincent,0,0,0,0
1668139237050,ECE 247B,A00,103651,Wang; Joseph,0,0,0,0
1668139237473,ECE 250,A00,103652,Siegel; Paul H.,0,0,0,0
1668139237909,ECE 251A,A00,103654,Rao; Bhaskar D.,0,0,0,0
1668139238336,ECE 257B,A00,103655,Bharadia; Dinesh,0,0,0,0
1668139238759,ECE 258A,A00,103656,Milstein; Laurence B.,0,0,0,0
1668139239184,ECE 260B,A00,103658,Kang; Mingu,0,0,0,0
1668139239613,ECE 264A,A00,103659,Galton; Ian A,0,0,0,0
1668139240036,ECE 265A,A00,103661,Gudem; Prasad S.S.,0,0,0,0
1668139240463,ECE 265D,A00,103662,Gudem; Prasad S.S.,0,0,0,0
1668139240890,ECE 268,A00,103663,Koushanfar; Farinaz,0,0,0,0
1668139241312,ECE 269,A01,103665,Pal; Piya,0,0,0,0
1668139241734,ECE 271B,A00,103666,Vasconcelos; Manuela,0,0,0,0
1668139242167,ECE 276A,A00,103667,Atanasov; Nikolay A.,0,0,0,0
1668139242590,ECE 277,A00,103668,An; Cheolhong,0,0,0,0
1668139243013,ECE 279,A00,117947,Hall; Drew A.,0,0,0,0
1668139243869,ECE 283,A00,103670,Hsueh; Tzu-Chien,0,0,0,0
1668139244294,ECE 284,A00,103671,Turakhia; Yatish Girish,0,0,0,0
1668139244717,ECE 285,A00,103672,Zheng; Yang,0,0,0,0
1668139244717,ECE 285,B00,103673,Sworder; David D.,0,0,0,0
1668139245140,ECE 287,A00,103676,Javidi; Tara,0,0,0,0
1668139245566,MATH 200B,A00,098023,Salehi Golsefidy; Alireza,12,0,15,3
1668139246001,MATH 202B,A00,098024,Rhoades; Brendon Patrick,9,0,15,6
1668139246429,MATH 203B,A00,098025,Oprea; Dragos N.,10,0,15,5
1668139246858,MATH 204B,A00,098026,Sorensen; Claus M,13,0,15,2
1668139247278,MATH 208,A00,098027,Izadi; Elham,7,0,10,3
1668139247704,MATH 209,A00,098028,Pollack; Aaron,10,0,10,0
1668139248129,MATH 211A,A00,112919,Rogalski; Daniel,9,0,10,1
1668139248556,MATH 211B,A00,112920,Seward; Brandon M.,9,0,10,1
1668139248991,MATH 218,A00,098029,Li; Bo,10,0,10,0
1668139249417,MATH 220B,A00,098030,Novak; Jonathan I,11,0,15,4
1668139249845,MATH 221A,A00,098031,Ebenfelt; Peter F,13,0,15,2
1668139250269,MATH 231B,A00,098032,Zlatos; Andrej,12,0,15,3
1668139250702,MATH 240B,A00,098033,Ni; Lei,9,0,15,6
1668139251128,MATH 243,A00,098034,Jekel; David Andrew,10,0,10,0
1668139251569,MATH 245A,A00,098035,Nie; Jiawang,0,0,15,16
1668139251994,MATH 248,A00,098036,Bejenaru; Ioan,10,0,10,0
1668139252435,MATH 250B,A00,098037,Spolaor; Luca,14,0,15,1
1668139252859,MATH 258,A00,098038,Ni; Lei,10,0,10,0
1668139253284,MATH 264B,A00,098041,Rhoades; Brendon Patrick,9,0,15,6
1668139253715,MATH 268,A00,098042,Buss; Samuel R,10,0,10,0
1668139254138,MATH 269,A00,098043,Rhoades; Brendon Patrick,10,0,10,0
1668139254578,MATH 270B,A00,098044,Li; Bo,10,0,15,5
1668139255008,MATH 272B,A00,098045,Holst; Michael J,13,0,15,2
1668139255430,MATH 273A,A00,098046,Tian; Xiaochuan,10,0,15,5
1668139255854,MATH 275,A01,098048,Tian; Xiaochuan,6,0,10,4
1668139256278,MATH 278A,A00,098049,Holst; Michael J,8,0,10,2
1668139256701,MATH 278B,A00,098050,Cloninger; Alexander,10,0,10,0
1668139257131,MATH 278C,A00,098051,Nie; Jiawang,7,0,10,3
1668139257554,MATH 280B,A00,098052,Zheng; Tianyi,10,0,15,5
1668139257978,MATH 281B,A00,098053,Bradic; Jelena,2,0,15,13
1668139258402,MATH 282B,A00,098054,Arias-Castro; Ery,0,0,15,15
1668139258828,MATH 285,A00,098055,Fitzsimmons; Patrick J,0,0,15,17
1668139259252,MATH 287B,A00,098056,Arias-Castro; Ery,2,0,15,13
1668139259677,MATH 288,A00,098057,Agarwal; Pooja,9,0,10,1
1668139259677,MATH 288,B00,098058,Zhang; Danna,8,0,10,2
1668139259677,MATH 288,C00,098059,Williams; Ruth J,10,0,10,0
1668139260103,MATH 290B,A00,098060,Roberts; Justin Deritter,13,0,15,2
1668139260538,MATH 292,A00,098061,Belmont; Eva Kinoshita,10,0,10,0
1668139260981,MATH 295,A00,098062,Suk; Andrew Hoon,48,0,50,2
1668139261402,MATH 296,A00,098063,Novak; Jonathan I,20,0,20,0
1668139261836,MATH 297,001,098064,Gamst; Anthony Collins,9997,0,9999,2
1668139762527,COGS 205,A00,101395,Chiba; Andrea,19,0,20,1
1668139762950,COGS 210B,001,101404,Greene; Deanna Jacquelyn,9998,0,9999,1
1668139762950,COGS 210B,002,101417,Xia; Haijun,9999,0,9999,0
1668139762950,COGS 210B,003,101422,Nitz; Douglas A.,9999,0,9999,0
1668139762950,COGS 210B,004,101423,Hollan; James D.,9998,0,9999,1
1668139762950,COGS 210B,005,101424,Deak; Gedeon O.,9998,0,9999,1
1668139762950,COGS 210B,006,101425,Rossano; Federico,9999,0,9999,0
1668139763372,COGS 211B,A00,101427,Coulson; Seana M,9996,0,9999,3
1668139763797,COGS 220,A00,101428,Hollan; James D.,0,0,25,25
1668139764219,COGS 229,A00,101429,Dow; Steven P,18,0,25,7
1668139764648,COGS 230,A00,101430,Klemmer; Scott R,12,0,17,5
1668139765071,COGS 234,A00,101431,Xia; Haijun,3,0,25,22
1668139765497,COGS 260,A00,101432,Kiyonaga; Anastasia,20,0,25,5
1668139765497,COGS 260,B00,101433,Kirsh; David Joel,16,0,25,9
1668139765922,CSE 202,A00,102371,Impagliazzo; Russell,0,0,0,0
1668139766346,CSE 203B,A01,102373,Cheng; Chung Kuan,0,0,0,0
1668139766771,CSE 208,A00,102374,Micciancio; Daniele,0,0,0,0
1668139767199,CSE 209A,A00,112895,Impagliazzo; Russell,0,0,15,15
1668139767624,CSE 209B,A00,108005,Bellare; Mihir,0,0,0,0
1668139768049,CSE 210,A00,113163,Coblenz; Michael J,0,0,0,0
1668139768474,CSE 219,A00,106111,Dow; Steven P,0,0,20,20
1668139768899,CSE 221,A00,102376,Voelker; Geoffrey M.,0,0,0,0
1668139769331,CSE 224,A01,102378,Porter; George M,0,0,0,0
1668139769759,CSE 229A,A00,102379,Savage; Stefan,0,0,0,0
1668139770186,CSE 229C,A00,102380,Munyaka; Imani N. S.,0,0,0,0
1668139770611,CSE 232B,A00,102382,Deutsch; Alin Bernard,0,0,0,0
1668139771034,CSE 234,A01,112904,Kumar; Arun Kumar,0,0,0,0
1668139771457,CSE 237A,A00,102383,Rosing; Tajana Simunic,0,0,0,0
1668139771880,CSE 239A,A00,102384,Deutsch; Alin Bernard,0,0,0,0
1668139772303,CSE 239B,A00,102385,Polikarpova; Nadezhda,0,0,0,0
1668139772730,CSE 240A,A00,102386,Pannuto; Patrick William,0,0,0,0
1668139773152,CSE 240B,A00,102387,Zhao; Jishen,0,0,0,0
1668139773579,CSE 241A,A00,106406,Kang; Mingu,0,0,0,0
1668139774017,CSE 249B,A00,102388,Kahng; Andrew Byun,0,0,8,8
1668139774450,CSE 251B,A01,102392,Cottrell; Garrison W,0,0,0,0
1668139774450,CSE 251B,A02,102393,Cottrell; Garrison W,0,0,0,0
1668139774877,CSE 252B,A00,102394,Ochoa; Benjamin Lawrence,0,0,0,0
1668139775301,CSE 257,A01,102396,Gao; Sicun,0,0,0,0
1668139775732,CSE 272,A00,102397,Li; Tzumao,0,0,0,0
1668139776161,CSE 274,A00,111323,Chern; Albert Ren-Haur,0,0,0,0
1668139776583,CSE 282,A00,102398,Pevzner; Pavel Arkadjevich,0,0,0,0
1668139777026,CSE 284,A00,114175,Gymrek; Melissa Ann,0,0,0,0
1668139777450,CSE 290,A00,102399,Chandraker; Manmohan Krishna,0,0,0,0
1668139777450,CSE 290,B00,102400,Vaccaro; Kristen Marie,0,0,25,25
1668139777450,CSE 290,C00,102414,Pannuto; Patrick William,0,0,25,25
1668139777450,CSE 290,D00,102427,Pevzner; Pavel Arkadjevich,0,0,0,0
1668139777450,CSE 290,E00,102429,Zhao; Jishen,0,0,0,0
1668139777450,CSE 290,F00,102436,Tullsen; Dean Michael,0,0,0,0
1668139777450,CSE 290,G00,102440,Christensen; Henrik I,0,0,20,20
1668139777880,CSE 291,A00,102443,Su; Hao,0,0,0,0
1668139777880,CSE 291,B00,102448,Polikarpova; Nadezhda,0,0,0,0
1668139777880,CSE 291,C00,102453,Vaccaro; Kristen Marie,0,0,0,0
1668139777880,CSE 291,D00,111343,Savage; Stefan,0,0,0,0
1668139777880,CSE 291,E00,116474,Claffy; Kimberly Claire,0,0,0,0
1668139777880,CSE 291,F00,116479,Pasquale; Joseph,0,0,0,0
1668139778330,CSE 293,001,119111,Bafna; Vineet,9999,0,9999,0
1668139778330,CSE 293,002,119118,Bellare; Mihir,9999,0,9999,0
1668139778330,CSE 293,003,119122,Berg-Kirkpatrick; Taylor D,9999,0,9999,0
1668139778330,CSE 293,004,119135,Christensen; Henrik I,9999,0,9999,0
1668139778330,CSE 293,005,119142,Cottrell; Garrison W,9999,0,9999,0
1668139778330,CSE 293,006,119146,Deutsch; Alin Bernard,9999,0,9999,0
1668139778330,CSE 293,007,119159,Esmaeilzadeh; Hadi,9999,0,9999,0
1668139778330,CSE 293,008,119166,Freund; Yoav,9999,0,9999,0
1668139778330,CSE 293,009,119170,Griswold; William G.,9999,0,9999,0
1668139778330,CSE 293,010,119183,Gymrek; Melissa Ann,9999,0,9999,0
1668139778330,CSE 293,011,119190,Heninger; Nadia A,9999,0,9999,0
1668139778330,CSE 293,012,119230,Impagliazzo; Russell,9999,0,9999,0
1668139778330,CSE 293,013,119232,Jhala; Ranjit,9999,0,9999,0
1668139778330,CSE 293,014,119233,Kahng; Andrew Byun,9999,0,9999,0
1668139778330,CSE 293,015,119298,Kane; Daniel Mertz,9999,0,9999,0
1668139778330,CSE 293,016,119299,Kriegman; David J,9999,0,9999,0
1668139778330,CSE 293,017,119300,Kumar; Arun Kumar,9999,0,9999,0
1668139778330,CSE 293,018,119301,Lerner; Sorin,9999,0,9999,0
1668139778330,CSE 293,019,119302,Lovett; Shachar,9999,0,9999,0
1668139778330,CSE 293,020,119303,McAuley; Julian John,9999,0,9999,0
1668139778330,CSE 293,021,119304,Micciancio; Daniele,9999,0,9999,0
1668139778330,CSE 293,022,119367,Orailoglu; Alex,9999,0,9999,0
1668139778330,CSE 293,023,119382,Paturi; Ramamohan,9999,0,9999,0
1668139778330,CSE 293,024,119404,Polikarpova; Nadezhda,9999,0,9999,0
1668139778330,CSE 293,025,119406,Politz; Joseph Gibbs,9999,0,9999,0
1668139778330,CSE 293,026,119411,Porter; George M,9999,0,9999,0
1668139778330,CSE 293,027,119414,Porter; Leonard Emerson,9999,0,9999,0
1668139778330,CSE 293,028,119416,Ramamoorthi; Ravi,9999,0,9999,0
1668139778330,CSE 293,029,119417,Sahoo; Debashis,9999,0,9999,0
1668139778330,CSE 293,030,119420,Saul; Lawrence,9999,0,9999,0
1668139778330,CSE 293,031,119421,Savage; Stefan,9999,0,9999,0
1668139778330,CSE 293,032,119425,Schulze; Jurgen P.,9999,0,9999,0
1668139778330,CSE 293,033,119426,Snoeren; Alex C.,9999,0,9999,0
1668139778330,CSE 293,034,119428,Shang; Jingbo,9999,0,9999,0
1668139778330,CSE 293,035,119430,Stefan; Deian,9999,0,9999,0
1668139778330,CSE 293,036,119431,Su; Hao,9999,0,9999,0
1668139778330,CSE 293,037,119433,Swanson; Steven James,9999,0,9999,0
1668139778330,CSE 293,038,119435,Tullsen; Dean Michael,9999,0,9999,0
1668139778330,CSE 293,039,119483,Voelker; Geoffrey M.,9999,0,9999,0
1668139778330,CSE 293,040,119537,Zhao; Jishen,9999,0,9999,0
1668139778330,CSE 293,041,119538,Zhou; Yuan-Yuan,9999,0,9999,0
1668139778330,CSE 293,042,119539,Gao; Sicun,9999,0,9999,0
1668139778330,CSE 293,043,119540,Weibel; Nadir,9999,0,9999,0
1668139778330,CSE 293,044,119541,Gupta; Rajesh K.,9999,0,9999,0
1668139778330,CSE 293,045,126410,Vaccaro; Kristen Marie,9999,0,9999,0
1668139778330,CSE 293,046,126411,Klemke; Richard,9999,0,9999,0
1668139778758,CSE 294,A00,102459,Voelker; Geoffrey M.,0,0,0,0
1668139778758,CSE 294,B00,111322,Orailoglu; Alex,0,0,0,0
1668139779184,DSE 201,A00,096914,Deutsch; Alin Bernard,30,0,30,0
1668139779605,DSE 210,A00,096915,Dasgupta; Sanjoy,30,0,30,0
1668139780032,DSE 260A,A00,096916,Altintas De Callaf; Ilkay,30,0,30,0
1668139780463,ECE 200,001,103586,Antipa; Nicholas A,9999,0,9999,0
1668139780463,ECE 200,002,103587,Atanasov; Nikolay A.,9999,0,9999,0
1668139780463,ECE 200,003,103588,Bharadia; Dinesh,9999,0,9999,0
1668139780463,ECE 200,004,103589,Cheng; Chung Kuan,9999,0,9999,0
1668139780463,ECE 200,005,103590,Cosman; Pamela C.,9999,0,9999,0
1668139780463,ECE 200,006,103591,Dayeh; Shadi Ahmad,9999,0,9999,0
1668139780463,ECE 200,007,103592,Fainman; Yeshaiahu,9999,0,9999,0
1668139780463,ECE 200,008,103593,Ford; Joseph Earl,9999,0,9999,0
1668139780463,ECE 200,009,103594,Franceschetti; Massimo,9999,0,9999,0
1668139780463,ECE 200,010,103595,Fullerton; Eric E,9999,0,9999,0
1668139780463,ECE 200,011,103596,Galton; Ian A,9999,0,9999,0
1668139780463,ECE 200,012,103597,Gilja; Vikash,9999,0,9999,0
1668139780463,ECE 200,013,103598,Hall; Drew A.,9999,0,9999,0
1668139780463,ECE 200,014,103599,Hsueh; Tzu-Chien,9999,0,9999,0
1668139780463,ECE 200,015,103600,Javidi; Tara,9999,0,9999,0
1668139780463,ECE 200,016,103601,Kahng; Andrew Byun,9999,0,9999,0
1668139780463,ECE 200,017,103602,Kim; Young-Han,9999,0,9999,0
1668139780463,ECE 200,018,103603,Koushanfar; Farinaz,9999,0,9999,0
1668139780463,ECE 200,019,103604,Kuzum; Duygu,9999,0,9999,0
1668139780463,ECE 200,020,103605,Le; Hanh-Phuc,9999,0,9999,0
1668139780463,ECE 200,021,103606,Lin; Bill,9999,0,9999,0
1668139780463,ECE 200,022,103607,Liu; Zhaowei,9998,0,9999,1
1668139780463,ECE 200,023,103608,Lo; Yu-Hwa,9999,0,9999,0
1668139780463,ECE 200,024,103609,Lomakin; Vitaliy,9999,0,9999,0
1668139780463,ECE 200,025,103610,Mercier; Patrick Philip,9999,0,9999,0
1668139780463,ECE 200,026,103611,Meyer; Florian,9999,0,9999,0
1668139780463,ECE 200,027,103612,Milstein; Laurence B.,9999,0,9999,0
1668139780463,ECE 200,028,103613,Mir Arabbaygi; Siavash,9999,0,9999,0
1668139780463,ECE 200,029,103614,Mookherjea; Shayan,9999,0,9999,0
1668139780463,ECE 200,030,103615,Morris; Karcher William,9999,0,9999,0
1668139780463,ECE 200,031,103616,Ng; Tse Nga,9999,0,9999,0
1668139780463,ECE 200,032,103617,Nguyen; Truong Quang,9999,0,9999,0
1668139780463,ECE 200,033,103618,Nomura; Kenji,9999,0,9999,0
1668139780463,ECE 200,034,103619,Orlitsky; Alon,9999,0,9999,0
1668139780463,ECE 200,035,103620,Pal; Piya,9999,0,9999,0
1668139780463,ECE 200,036,103621,Papen; George C.,9999,0,9999,0
1668139780463,ECE 200,037,103622,Radic; Stojan,9999,0,9999,0
1668139780463,ECE 200,038,103623,Rao; Bhaskar D.,9999,0,9999,0
1668139780463,ECE 200,039,103624,Rao; Ramesh R,9999,0,9999,0
1668139780463,ECE 200,040,103625,Rebeiz; Gabriel,9999,0,9999,0
1668139780463,ECE 200,041,103626,Sanford; John R,9999,0,9999,0
1668139780463,ECE 200,042,103627,Siegel; Paul H.,9999,0,9999,0
1668139780463,ECE 200,043,103628,Sievenpiper; Daniel F.,9999,0,9999,0
1668139780463,ECE 200,044,103629,Sworder; David D.,9999,0,9999,0
1668139780463,ECE 200,045,103630,Taur; Yuan,9999,0,9999,0
1668139780463,ECE 200,046,103631,Touri; Behrouz,9999,0,9999,0
1668139780463,ECE 200,047,103632,Trivedi; Mohan M.,9999,0,9999,0
1668139780463,ECE 200,048,103633,Vasconcelos; Nuno,9999,0,9999,0
1668139780463,ECE 200,049,103634,Wang; Xiaolong,9999,0,9999,0
1668139780463,ECE 200,050,103635,Xie; Pengtao,9999,0,9999,0
1668139780463,ECE 200,051,103636,Yip; Michael,9999,0,9999,0
1668139780463,ECE 200,052,103637,Zeger; Kenneth A.,999,0,999,0
1668139780463,ECE 200,053,103638,Zhang; Xinyu,9999,0,9999,0
1668139780463,ECE 200,054,103639,Turakhia; Yatish Girish,9999,0,9999,0
1668139780463,ECE 200,055,103640,Kang; Mingu,9999,0,9999,0
1668139780463,ECE 200,056,103641,Shi; Yuanyuan,9999,0,9999,0
1668139780463,ECE 200,057,103642,Wang; Edward Jay,9999,0,9999,0
1668139780463,ECE 200,058,103643,Zheng; Yang,9999,0,9999,0
1668139780894,ECE 202,A00,103644,Kuzum; Duygu,0,0,0,0
1668139781323,ECE 212BN,A00,103646,Ng; Tse Nga,0,0,0,0
1668139781747,ECE 221,A00,111493,Staff,0,0,0,0
1668139782171,ECE 222B,A00,103647,Lomakin; Vitaliy,0,0,0,0
1668139782595,ECE 230B,A00,103648,Taur; Yuan,0,0,0,0
1668139783024,ECE 238B,A00,103649,Garay; Javier,0,0,0,0
1668139783456,ECE 240B,A00,112900,Fainman; Yeshaiahu,0,0,0,0
1668139783879,ECE 247A,A00,103650,Jokerst; Jesse Vincent,0,0,0,0
1668139784305,ECE 247B,A00,103651,Wang; Joseph,0,0,0,0
1668139784727,ECE 250,A00,103652,Siegel; Paul H.,0,0,0,0
1668139785153,ECE 251A,A00,103654,Rao; Bhaskar D.,0,0,0,0
1668139785580,ECE 257B,A00,103655,Bharadia; Dinesh,0,0,0,0
1668139786005,ECE 258A,A00,103656,Milstein; Laurence B.,0,0,0,0
1668139786427,ECE 260B,A00,103658,Kang; Mingu,0,0,0,0
1668139786850,ECE 264A,A00,103659,Galton; Ian A,0,0,0,0
1668139787278,ECE 265A,A00,103661,Gudem; Prasad S.S.,0,0,0,0
1668139787703,ECE 265D,A00,103662,Gudem; Prasad S.S.,0,0,0,0
1668139788127,ECE 268,A00,103663,Koushanfar; Farinaz,0,0,0,0
1668139788552,ECE 269,A01,103665,Pal; Piya,0,0,0,0
1668139788978,ECE 271B,A00,103666,Vasconcelos; Manuela,0,0,0,0
1668139789401,ECE 276A,A00,103667,Atanasov; Nikolay A.,0,0,0,0
1668139789829,ECE 277,A00,103668,An; Cheolhong,0,0,0,0
1668139790258,ECE 279,A00,117947,Hall; Drew A.,0,0,0,0
1668139791116,ECE 283,A00,103670,Hsueh; Tzu-Chien,0,0,0,0
1668139791540,ECE 284,A00,103671,Turakhia; Yatish Girish,0,0,0,0
1668139791963,ECE 285,A00,103672,Zheng; Yang,0,0,0,0
1668139791963,ECE 285,B00,103673,Sworder; David D.,0,0,0,0
1668139792394,ECE 287,A00,103676,Javidi; Tara,0,0,0,0
1668139792818,MATH 200B,A00,098023,Salehi Golsefidy; Alireza,12,0,15,3
1668139793242,MATH 202B,A00,098024,Rhoades; Brendon Patrick,9,0,15,6
1668139793670,MATH 203B,A00,098025,Oprea; Dragos N.,10,0,15,5
1668139794104,MATH 204B,A00,098026,Sorensen; Claus M,13,0,15,2
1668139794526,MATH 208,A00,098027,Izadi; Elham,7,0,10,3
1668139794964,MATH 209,A00,098028,Pollack; Aaron,10,0,10,0
1668139795420,MATH 211A,A00,112919,Rogalski; Daniel,9,0,10,1
1668139795842,MATH 211B,A00,112920,Seward; Brandon M.,9,0,10,1
1668139796273,MATH 218,A00,098029,Li; Bo,10,0,10,0
1668139796697,MATH 220B,A00,098030,Novak; Jonathan I,11,0,15,4
1668139797123,MATH 221A,A00,098031,Ebenfelt; Peter F,13,0,15,2
1668139797551,MATH 231B,A00,098032,Zlatos; Andrej,12,0,15,3
1668139797977,MATH 240B,A00,098033,Ni; Lei,9,0,15,6
1668139798491,MATH 243,A00,098034,Jekel; David Andrew,10,0,10,0
1668139798918,MATH 245A,A00,098035,Nie; Jiawang,0,0,15,16
1668139799340,MATH 248,A00,098036,Bejenaru; Ioan,10,0,10,0
1668139799767,MATH 250B,A00,098037,Spolaor; Luca,14,0,15,1
1668139801139,MATH 258,A00,098038,Ni; Lei,10,0,10,0
1668139801564,MATH 264B,A00,098041,Rhoades; Brendon Patrick,9,0,15,6
1668139801995,MATH 268,A00,098042,Buss; Samuel R,10,0,10,0
1668139802418,MATH 269,A00,098043,Rhoades; Brendon Patrick,10,0,10,0
1668139802843,MATH 270B,A00,098044,Li; Bo,10,0,15,5
1668139803270,MATH 272B,A00,098045,Holst; Michael J,13,0,15,2
1668139803697,MATH 273A,A00,098046,Tian; Xiaochuan,10,0,15,5
1668139804123,MATH 275,A01,098048,Tian; Xiaochuan,6,0,10,4
1668139804546,MATH 278A,A00,098049,Holst; Michael J,8,0,10,2
1668139804983,MATH 278B,A00,098050,Cloninger; Alexander,10,0,10,0
1668139805410,MATH 278C,A00,098051,Nie; Jiawang,7,0,10,3
1668139805832,MATH 280B,A00,098052,Zheng; Tianyi,10,0,15,5
1668139806257,MATH 281B,A00,098053,Bradic; Jelena,2,0,15,13
1668139806682,MATH 282B,A00,098054,Arias-Castro; Ery,0,0,15,15
1668139807106,MATH 285,A00,098055,Fitzsimmons; Patrick J,0,0,15,17
1668139807533,MATH 287B,A00,098056,Arias-Castro; Ery,2,0,15,13
1668139807956,MATH 288,A00,098057,Agarwal; Pooja,9,0,10,1
1668139807956,MATH 288,B00,098058,Zhang; Danna,8,0,10,2
1668139807956,MATH 288,C00,098059,Williams; Ruth J,10,0,10,0
1668139808385,MATH 290B,A00,098060,Roberts; Justin Deritter,13,0,15,2
1668139808809,MATH 292,A00,098061,Belmont; Eva Kinoshita,10,0,10,0
1668139809234,MATH 295,A00,098062,Suk; Andrew Hoon,48,0,50,2
1668139809656,MATH 296,A00,098063,Novak; Jonathan I,20,0,20,0
1668139810095,MATH 297,001,098064,Gamst; Anthony Collins,9997,0,9999,2
1668140311758,COGS 205,A00,101395,Chiba; Andrea,19,0,20,1
1668140312185,COGS 210B,001,101404,Greene; Deanna Jacquelyn,9998,0,9999,1
1668140312185,COGS 210B,002,101417,Xia; Haijun,9999,0,9999,0
1668140312185,COGS 210B,003,101422,Nitz; Douglas A.,9999,0,9999,0
1668140312185,COGS 210B,004,101423,Hollan; James D.,9998,0,9999,1
1668140312185,COGS 210B,005,101424,Deak; Gedeon O.,9998,0,9999,1
1668140312185,COGS 210B,006,101425,Rossano; Federico,9999,0,9999,0
1668140312609,COGS 211B,A00,101427,Coulson; Seana M,9996,0,9999,3
1668140313039,COGS 220,A00,101428,Hollan; James D.,0,0,25,25
1668140313461,COGS 229,A00,101429,Dow; Steven P,18,0,25,7
1668140313889,COGS 230,A00,101430,Klemmer; Scott R,12,0,17,5
1668140314319,COGS 234,A00,101431,Xia; Haijun,3,0,25,22
1668140314753,COGS 260,A00,101432,Kiyonaga; Anastasia,20,0,25,5
1668140314753,COGS 260,B00,101433,Kirsh; David Joel,16,0,25,9
1668140315176,CSE 202,A00,102371,Impagliazzo; Russell,0,0,0,0
1668140315606,CSE 203B,A01,102373,Cheng; Chung Kuan,0,0,0,0
1668140316029,CSE 208,A00,102374,Micciancio; Daniele,0,0,0,0
1668140316453,CSE 209A,A00,112895,Impagliazzo; Russell,0,0,15,15
1668140316879,CSE 209B,A00,108005,Bellare; Mihir,0,0,0,0
1668140317304,CSE 210,A00,113163,Coblenz; Michael J,0,0,0,0
1668140317727,CSE 219,A00,106111,Dow; Steven P,0,0,20,20
1668140318153,CSE 221,A00,102376,Voelker; Geoffrey M.,0,0,0,0
1668140318580,CSE 224,A01,102378,Porter; George M,0,0,0,0
1668140319006,CSE 229A,A00,102379,Savage; Stefan,0,0,0,0
1668140319434,CSE 229C,A00,102380,Munyaka; Imani N. S.,0,0,0,0
1668140319857,CSE 232B,A00,102382,Deutsch; Alin Bernard,0,0,0,0
1668140320281,CSE 234,A01,112904,Kumar; Arun Kumar,0,0,0,0
1668140320707,CSE 237A,A00,102383,Rosing; Tajana Simunic,0,0,0,0
1668140321236,CSE 239A,A00,102384,Deutsch; Alin Bernard,0,0,0,0
1668140321670,CSE 239B,A00,102385,Polikarpova; Nadezhda,0,0,0,0
1668140322137,CSE 240A,A00,102386,Pannuto; Patrick William,0,0,0,0
1668140322560,CSE 240B,A00,102387,Zhao; Jishen,0,0,0,0
1668140322989,CSE 241A,A00,106406,Kang; Mingu,0,0,0,0
1668140323411,CSE 249B,A00,102388,Kahng; Andrew Byun,0,0,8,8
1668140323837,CSE 251B,A01,102392,Cottrell; Garrison W,0,0,0,0
1668140323837,CSE 251B,A02,102393,Cottrell; Garrison W,0,0,0,0
1668140324262,CSE 252B,A00,102394,Ochoa; Benjamin Lawrence,0,0,0,0
1668140324695,CSE 257,A01,102396,Gao; Sicun,0,0,0,0
1668140325120,CSE 272,A00,102397,Li; Tzumao,0,0,0,0
1668140325541,CSE 274,A00,111323,Chern; Albert Ren-Haur,0,0,0,0
1668140325967,CSE 282,A00,102398,Pevzner; Pavel Arkadjevich,0,0,0,0
1668140326391,CSE 284,A00,114175,Gymrek; Melissa Ann,0,0,0,0
1668140326817,CSE 290,A00,102399,Chandraker; Manmohan Krishna,0,0,0,0
1668140326817,CSE 290,B00,102400,Vaccaro; Kristen Marie,0,0,25,25
1668140326817,CSE 290,C00,102414,Pannuto; Patrick William,0,0,25,25
1668140326817,CSE 290,D00,102427,Pevzner; Pavel Arkadjevich,0,0,0,0
1668140326817,CSE 290,E00,102429,Zhao; Jishen,0,0,0,0
1668140326817,CSE 290,F00,102436,Tullsen; Dean Michael,0,0,0,0
1668140326817,CSE 290,G00,102440,Christensen; Henrik I,0,0,20,20
1668140327245,CSE 291,A00,102443,Su; Hao,0,0,0,0
1668140327245,CSE 291,B00,102448,Polikarpova; Nadezhda,0,0,0,0
1668140327245,CSE 291,C00,102453,Vaccaro; Kristen Marie,0,0,0,0
1668140327245,CSE 291,D00,111343,Savage; Stefan,0,0,0,0
1668140327245,CSE 291,E00,116474,Claffy; Kimberly Claire,0,0,0,0
1668140327245,CSE 291,F00,116479,Pasquale; Joseph,0,0,0,0
1668140327701,CSE 293,001,119111,Bafna; Vineet,9999,0,9999,0
1668140327701,CSE 293,002,119118,Bellare; Mihir,9999,0,9999,0
1668140327701,CSE 293,003,119122,Berg-Kirkpatrick; Taylor D,9999,0,9999,0
1668140327701,CSE 293,004,119135,Christensen; Henrik I,9999,0,9999,0
1668140327701,CSE 293,005,119142,Cottrell; Garrison W,9999,0,9999,0
1668140327701,CSE 293,006,119146,Deutsch; Alin Bernard,9999,0,9999,0
1668140327701,CSE 293,007,119159,Esmaeilzadeh; Hadi,9999,0,9999,0
1668140327701,CSE 293,008,119166,Freund; Yoav,9999,0,9999,0
1668140327701,CSE 293,009,119170,Griswold; William G.,9999,0,9999,0
1668140327701,CSE 293,010,119183,Gymrek; Melissa Ann,9999,0,9999,0
1668140327701,CSE 293,011,119190,Heninger; Nadia A,9999,0,9999,0
1668140327701,CSE 293,012,119230,Impagliazzo; Russell,9999,0,9999,0
1668140327701,CSE 293,013,119232,Jhala; Ranjit,9999,0,9999,0
1668140327701,CSE 293,014,119233,Kahng; Andrew Byun,9999,0,9999,0
1668140327701,CSE 293,015,119298,Kane; Daniel Mertz,9999,0,9999,0
1668140327701,CSE 293,016,119299,Kriegman; David J,9999,0,9999,0
1668140327701,CSE 293,017,119300,Kumar; Arun Kumar,9999,0,9999,0
1668140327701,CSE 293,018,119301,Lerner; Sorin,9999,0,9999,0
1668140327701,CSE 293,019,119302,Lovett; Shachar,9999,0,9999,0
1668140327701,CSE 293,020,119303,McAuley; Julian John,9999,0,9999,0
1668140327701,CSE 293,021,119304,Micciancio; Daniele,9999,0,9999,0
1668140327701,CSE 293,022,119367,Orailoglu; Alex,9999,0,9999,0
1668140327701,CSE 293,023,119382,Paturi; Ramamohan,9999,0,9999,0
1668140327701,CSE 293,024,119404,Polikarpova; Nadezhda,9999,0,9999,0
1668140327701,CSE 293,025,119406,Politz; Joseph Gibbs,9999,0,9999,0
1668140327701,CSE 293,026,119411,Porter; George M,9999,0,9999,0
1668140327701,CSE 293,027,119414,Porter; Leonard Emerson,9999,0,9999,0
1668140327701,CSE 293,028,119416,Ramamoorthi; Ravi,9999,0,9999,0
1668140327701,CSE 293,029,119417,Sahoo; Debashis,9999,0,9999,0
1668140327701,CSE 293,030,119420,Saul; Lawrence,9999,0,9999,0
1668140327701,CSE 293,031,119421,Savage; Stefan,9999,0,9999,0
1668140327701,CSE 293,032,119425,Schulze; Jurgen P.,9999,0,9999,0
1668140327701,CSE 293,033,119426,Snoeren; Alex C.,9999,0,9999,0
1668140327701,CSE 293,034,119428,Shang; Jingbo,9999,0,9999,0
1668140327701,CSE 293,035,119430,Stefan; Deian,9999,0,9999,0
1668140327701,CSE 293,036,119431,Su; Hao,9999,0,9999,0
1668140327701,CSE 293,037,119433,Swanson; Steven James,9999,0,9999,0
1668140327701,CSE 293,038,119435,Tullsen; Dean Michael,9999,0,9999,0
1668140327701,CSE 293,039,119483,Voelker; Geoffrey M.,9999,0,9999,0
1668140327701,CSE 293,040,119537,Zhao; Jishen,9999,0,9999,0
1668140327701,CSE 293,041,119538,Zhou; Yuan-Yuan,9999,0,9999,0
1668140327701,CSE 293,042,119539,Gao; Sicun,9999,0,9999,0
1668140327701,CSE 293,043,119540,Weibel; Nadir,9999,0,9999,0
1668140327701,CSE 293,044,119541,Gupta; Rajesh K.,9999,0,9999,0
1668140327701,CSE 293,045,126410,Vaccaro; Kristen Marie,9999,0,9999,0
1668140327701,CSE 293,046,126411,Klemke; Richard,9999,0,9999,0
1668140328142,CSE 294,A00,102459,Voelker; Geoffrey M.,0,0,0,0
1668140328142,CSE 294,B00,111322,Orailoglu; Alex,0,0,0,0
1668140328565,DSE 201,A00,096914,Deutsch; Alin Bernard,30,0,30,0
1668140328999,DSE 210,A00,096915,Dasgupta; Sanjoy,30,0,30,0
1668140329422,DSE 260A,A00,096916,Altintas De Callaf; Ilkay,30,0,30,0
1668140329850,ECE 200,001,103586,Antipa; Nicholas A,9999,0,9999,0
1668140329850,ECE 200,002,103587,Atanasov; Nikolay A.,9999,0,9999,0
1668140329850,ECE 200,003,103588,Bharadia; Dinesh,9999,0,9999,0
1668140329850,ECE 200,004,103589,Cheng; Chung Kuan,9999,0,9999,0
1668140329850,ECE 200,005,103590,Cosman; Pamela C.,9999,0,9999,0
1668140329850,ECE 200,006,103591,Dayeh; Shadi Ahmad,9999,0,9999,0
1668140329850,ECE 200,007,103592,Fainman; Yeshaiahu,9999,0,9999,0
1668140329850,ECE 200,008,103593,Ford; Joseph Earl,9999,0,9999,0
1668140329850,ECE 200,009,103594,Franceschetti; Massimo,9999,0,9999,0
1668140329850,ECE 200,010,103595,Fullerton; Eric E,9999,0,9999,0
1668140329850,ECE 200,011,103596,Galton; Ian A,9999,0,9999,0
1668140329850,ECE 200,012,103597,Gilja; Vikash,9999,0,9999,0
1668140329850,ECE 200,013,103598,Hall; Drew A.,9999,0,9999,0
1668140329850,ECE 200,014,103599,Hsueh; Tzu-Chien,9999,0,9999,0
1668140329850,ECE 200,015,103600,Javidi; Tara,9999,0,9999,0
1668140329850,ECE 200,016,103601,Kahng; Andrew Byun,9999,0,9999,0
1668140329850,ECE 200,017,103602,Kim; Young-Han,9999,0,9999,0
1668140329850,ECE 200,018,103603,Koushanfar; Farinaz,9999,0,9999,0
1668140329850,ECE 200,019,103604,Kuzum; Duygu,9999,0,9999,0
1668140329850,ECE 200,020,103605,Le; Hanh-Phuc,9999,0,9999,0
1668140329850,ECE 200,021,103606,Lin; Bill,9999,0,9999,0
1668140329850,ECE 200,022,103607,Liu; Zhaowei,9998,0,9999,1
1668140329850,ECE 200,023,103608,Lo; Yu-Hwa,9999,0,9999,0
1668140329850,ECE 200,024,103609,Lomakin; Vitaliy,9999,0,9999,0
1668140329850,ECE 200,025,103610,Mercier; Patrick Philip,9999,0,9999,0
1668140329850,ECE 200,026,103611,Meyer; Florian,9999,0,9999,0
1668140329850,ECE 200,027,103612,Milstein; Laurence B.,9999,0,9999,0
1668140329850,ECE 200,028,103613,Mir Arabbaygi; Siavash,9999,0,9999,0
1668140329850,ECE 200,029,103614,Mookherjea; Shayan,9999,0,9999,0
1668140329850,ECE 200,030,103615,Morris; Karcher William,9999,0,9999,0
1668140329850,ECE 200,031,103616,Ng; Tse Nga,9999,0,9999,0
1668140329850,ECE 200,032,103617,Nguyen; Truong Quang,9999,0,9999,0
1668140329850,ECE 200,033,103618,Nomura; Kenji,9999,0,9999,0
1668140329850,ECE 200,034,103619,Orlitsky; Alon,9999,0,9999,0
1668140329850,ECE 200,035,103620,Pal; Piya,9999,0,9999,0
1668140329850,ECE 200,036,103621,Papen; George C.,9999,0,9999,0
1668140329850,ECE 200,037,103622,Radic; Stojan,9999,0,9999,0
1668140329850,ECE 200,038,103623,Rao; Bhaskar D.,9999,0,9999,0
1668140329850,ECE 200,039,103624,Rao; Ramesh R,9999,0,9999,0
1668140329850,ECE 200,040,103625,Rebeiz; Gabriel,9999,0,9999,0
1668140329850,ECE 200,041,103626,Sanford; John R,9999,0,9999,0
1668140329850,ECE 200,042,103627,Siegel; Paul H.,9999,0,9999,0
1668140329850,ECE 200,043,103628,Sievenpiper; Daniel F.,9999,0,9999,0
1668140329850,ECE 200,044,103629,Sworder; David D.,9999,0,9999,0
1668140329850,ECE 200,045,103630,Taur; Yuan,9999,0,9999,0
1668140329850,ECE 200,046,103631,Touri; Behrouz,9999,0,9999,0
1668140329850,ECE 200,047,103632,Trivedi; Mohan M.,9999,0,9999,0
1668140329850,ECE 200,048,103633,Vasconcelos; Nuno,9999,0,9999,0
1668140329850,ECE 200,049,103634,Wang; Xiaolong,9999,0,9999,0
1668140329850,ECE 200,050,103635,Xie; Pengtao,9999,0,9999,0
1668140329850,ECE 200,051,103636,Yip; Michael,9999,0,9999,0
1668140329850,ECE 200,052,103637,Zeger; Kenneth A.,999,0,999,0
1668140329850,ECE 200,053,103638,Zhang; Xinyu,9999,0,9999,0
1668140329850,ECE 200,054,103639,Turakhia; Yatish Girish,9999,0,9999,0
1668140329850,ECE 200,055,103640,Kang; Mingu,9999,0,9999,0
1668140329850,ECE 200,056,103641,Shi; Yuanyuan,9999,0,9999,0
1668140329850,ECE 200,057,103642,Wang; Edward Jay,9999,0,9999,0
1668140329850,ECE 200,058,103643,Zheng; Yang,9999,0,9999,0
1668140330275,ECE 202,A00,103644,Kuzum; Duygu,0,0,0,0
1668140330703,ECE 212BN,A00,103646,Ng; Tse Nga,0,0,0,0
1668140331126,ECE 221,A00,111493,Staff,0,0,0,0
1668140331550,ECE 222B,A00,103647,Lomakin; Vitaliy,0,0,0,0
1668140331978,ECE 230B,A00,103648,Taur; Yuan,0,0,0,0
1668140332403,ECE 238B,A00,103649,Garay; Javier,0,0,0,0
1668140332827,ECE 240B,A00,112900,Fainman; Yeshaiahu,0,0,0,0
1668140333250,ECE 247A,A00,103650,Jokerst; Jesse Vincent,0,0,0,0
1668140333687,ECE 247B,A00,103651,Wang; Joseph,0,0,0,0
1668140334119,ECE 250,A00,103652,Siegel; Paul H.,0,0,0,0
1668140334543,ECE 251A,A00,103654,Rao; Bhaskar D.,0,0,0,0
1668140334967,ECE 257B,A00,103655,Bharadia; Dinesh,0,0,0,0
1668140335391,ECE 258A,A00,103656,Milstein; Laurence B.,0,0,0,0
1668140335814,ECE 260B,A00,103658,Kang; Mingu,0,0,0,0
1668140336240,ECE 264A,A00,103659,Galton; Ian A,0,0,0,0
1668140336667,ECE 265A,A00,103661,Gudem; Prasad S.S.,0,0,0,0
1668140337091,ECE 265D,A00,103662,Gudem; Prasad S.S.,0,0,0,0
1668140337514,ECE 268,A00,103663,Koushanfar; Farinaz,0,0,0,0
1668140337949,ECE 269,A01,103665,Pal; Piya,0,0,0,0
1668140338386,ECE 271B,A00,103666,Vasconcelos; Manuela,0,0,0,0
1668140338810,ECE 276A,A00,103667,Atanasov; Nikolay A.,0,0,0,0
1668140339234,ECE 277,A00,103668,An; Cheolhong,0,0,0,0
1668140339666,ECE 279,A00,117947,Hall; Drew A.,0,0,0,0
1668140340520,ECE 283,A00,103670,Hsueh; Tzu-Chien,0,0,0,0
1668140340944,ECE 284,A00,103671,Turakhia; Yatish Girish,0,0,0,0
1668140341376,ECE 285,A00,103672,Zheng; Yang,0,0,0,0
1668140341376,ECE 285,B00,103673,Sworder; David D.,0,0,0,0
1668140341810,ECE 287,A00,103676,Javidi; Tara,0,0,0,0
1668140342235,MATH 200B,A00,098023,Salehi Golsefidy; Alireza,12,0,15,3
1668140342658,MATH 202B,A00,098024,Rhoades; Brendon Patrick,9,0,15,6
1668140343085,MATH 203B,A00,098025,Oprea; Dragos N.,10,0,15,5
1668140343508,MATH 204B,A00,098026,Sorensen; Claus M,13,0,15,2
1668140343935,MATH 208,A00,098027,Izadi; Elham,7,0,10,3
1668140344359,MATH 209,A00,098028,Pollack; Aaron,10,0,10,0
1668140344788,MATH 211A,A00,112919,Rogalski; Daniel,9,0,10,1
1668140345221,MATH 211B,A00,112920,Seward; Brandon M.,9,0,10,1
1668140345647,MATH 218,A00,098029,Li; Bo,10,0,10,0
1668140346073,MATH 220B,A00,098030,Novak; Jonathan I,11,0,15,4
1668140346494,MATH 221A,A00,098031,Ebenfelt; Peter F,13,0,15,2
1668140346925,MATH 231B,A00,098032,Zlatos; Andrej,12,0,15,3
1668140347347,MATH 240B,A00,098033,Ni; Lei,9,0,15,6
1668140347773,MATH 243,A00,098034,Jekel; David Andrew,10,0,10,0
1668140348209,MATH 245A,A00,098035,Nie; Jiawang,0,0,15,16
1668140348639,MATH 248,A00,098036,Bejenaru; Ioan,10,0,10,0
1668140349063,MATH 250B,A00,098037,Spolaor; Luca,14,0,15,1
1668140349516,MATH 258,A00,098038,Ni; Lei,10,0,10,0
1668140349944,MATH 264B,A00,098041,Rhoades; Brendon Patrick,9,0,15,6
1668140350384,MATH 268,A00,098042,Buss; Samuel R,10,0,10,0
1668140350819,MATH 269,A00,098043,Rhoades; Brendon Patrick,10,0,10,0
1668140351245,MATH 270B,A00,098044,Li; Bo,10,0,15,5
1668140351674,MATH 272B,A00,098045,Holst; Michael J,13,0,15,2
1668140352097,MATH 273A,A00,098046,Tian; Xiaochuan,10,0,15,5
1668140352525,MATH 275,A01,098048,Tian; Xiaochuan,6,0,10,4
1668140352949,MATH 278A,A00,098049,Holst; Michael J,8,0,10,2
1668140353375,MATH 278B,A00,098050,Cloninger; Alexander,10,0,10,0
1668140353800,MATH 278C,A00,098051,Nie; Jiawang,7,0,10,3
1668140354230,MATH 280B,A00,098052,Zheng; Tianyi,10,0,15,5
1668140354655,MATH 281B,A00,098053,Bradic; Jelena,2,0,15,13
1668140355081,MATH 282B,A00,098054,Arias-Castro; Ery,0,0,15,15
1668140355517,MATH 285,A00,098055,Fitzsimmons; Patrick J,0,0,15,17
1668140355954,MATH 287B,A00,098056,Arias-Castro; Ery,2,0,15,13
1668140356387,MATH 288,A00,098057,Agarwal; Pooja,9,0,10,1
1668140356387,MATH 288,B00,098058,Zhang; Danna,8,0,10,2
1668140356387,MATH 288,C00,098059,Williams; Ruth J,10,0,10,0
1668140356811,MATH 290B,A00,098060,Roberts; Justin Deritter,13,0,15,2
1668140357255,MATH 292,A00,098061,Belmont; Eva Kinoshita,10,0,10,0
1668140357678,MATH 295,A00,098062,Suk; Andrew Hoon,48,0,50,2
1668140358102,MATH 296,A00,098063,Novak; Jonathan I,20,0,20,0
1668140358538,MATH 297,001,098064,Gamst; Anthony Collins,9997,0,9999,2
1668140864843,COGS 205,A00,101395,Chiba; Andrea,19,0,20,1
1668140865268,COGS 210B,001,101404,Greene; Deanna Jacquelyn,9998,0,9999,1
1668140865268,COGS 210B,002,101417,Xia; Haijun,9999,0,9999,0
1668140865268,COGS 210B,003,101422,Nitz; Douglas A.,9999,0,9999,0
1668140865268,COGS 210B,004,101423,Hollan; James D.,9998,0,9999,1
1668140865268,COGS 210B,005,101424,Deak; Gedeon O.,9998,0,9999,1
1668140865268,COGS 210B,006,101425,Rossano; Federico,9999,0,9999,0
1668140865692,COGS 211B,A00,101427,Coulson; Seana M,9996,0,9999,3
1668140866149,COGS 220,A00,101428,Hollan; James D.,0,0,25,25
1668140866586,COGS 229,A00,101429,Dow; Steven P,18,0,25,7
1668140867012,COGS 230,A00,101430,Klemmer; Scott R,12,0,17,5
1668140867453,COGS 234,A00,101431,Xia; Haijun,3,0,25,22
1668140867876,COGS 260,A00,101432,Kiyonaga; Anastasia,20,0,25,5
1668140867876,COGS 260,B00,101433,Kirsh; David Joel,16,0,25,9
1668140868298,CSE 202,A00,102371,Impagliazzo; Russell,0,0,0,0
1668140868745,CSE 203B,A01,102373,Cheng; Chung Kuan,0,0,0,0
1668140869174,CSE 208,A00,102374,Micciancio; Daniele,0,0,0,0
1668140869598,CSE 209A,A00,112895,Impagliazzo; Russell,0,0,15,15
1668140870034,CSE 209B,A00,108005,Bellare; Mihir,0,0,0,0
1668140870461,CSE 210,A00,113163,Coblenz; Michael J,0,0,0,0
1668140870884,CSE 219,A00,106111,Dow; Steven P,0,0,20,20
1668140871310,CSE 221,A00,102376,Voelker; Geoffrey M.,0,0,0,0
1668140871767,CSE 224,A01,102378,Porter; George M,0,0,0,0
1668140872189,CSE 229A,A00,102379,Savage; Stefan,0,0,0,0
1668140872614,CSE 229C,A00,102380,Munyaka; Imani N. S.,0,0,0,0
1668140873041,CSE 232B,A00,102382,Deutsch; Alin Bernard,0,0,0,0
1668140873466,CSE 234,A01,112904,Kumar; Arun Kumar,0,0,0,0
1668140873890,CSE 237A,A00,102383,Rosing; Tajana Simunic,0,0,0,0
1668140874319,CSE 239A,A00,102384,Deutsch; Alin Bernard,0,0,0,0
1668140874765,CSE 239B,A00,102385,Polikarpova; Nadezhda,0,0,0,0
1668140875188,CSE 240A,A00,102386,Pannuto; Patrick William,0,0,0,0
1668140875613,CSE 240B,A00,102387,Zhao; Jishen,0,0,0,0
1668140876035,CSE 241A,A00,106406,Kang; Mingu,0,0,0,0
1668140876467,CSE 249B,A00,102388,Kahng; Andrew Byun,0,0,8,8
1668140876891,CSE 251B,A01,102392,Cottrell; Garrison W,0,0,0,0
1668140876891,CSE 251B,A02,102393,Cottrell; Garrison W,0,0,0,0
1668140877324,CSE 252B,A00,102394,Ochoa; Benjamin Lawrence,0,0,0,0
1668140877747,CSE 257,A01,102396,Gao; Sicun,0,0,0,0
1668140878171,CSE 272,A00,102397,Li; Tzumao,0,0,0,0
1668140878595,CSE 274,A00,111323,Chern; Albert Ren-Haur,0,0,0,0
1668140879018,CSE 282,A00,102398,Pevzner; Pavel Arkadjevich,0,0,0,0
1668140879440,CSE 284,A00,114175,Gymrek; Melissa Ann,0,0,0,0
1668140879864,CSE 290,A00,102399,Chandraker; Manmohan Krishna,0,0,0,0
1668140879864,CSE 290,B00,102400,Vaccaro; Kristen Marie,0,0,25,25
1668140879864,CSE 290,C00,102414,Pannuto; Patrick William,0,0,25,25
1668140879864,CSE 290,D00,102427,Pevzner; Pavel Arkadjevich,0,0,0,0
1668140879864,CSE 290,E00,102429,Zhao; Jishen,0,0,0,0
1668140879864,CSE 290,F00,102436,Tullsen; Dean Michael,0,0,0,0
1668140879864,CSE 290,G00,102440,Christensen; Henrik I,0,0,20,20
1668140880288,CSE 291,A00,102443,Su; Hao,0,0,0,0
1668140880288,CSE 291,B00,102448,Polikarpova; Nadezhda,0,0,0,0
1668140880288,CSE 291,C00,102453,Vaccaro; Kristen Marie,0,0,0,0
1668140880288,CSE 291,D00,111343,Savage; Stefan,0,0,0,0
1668140880288,CSE 291,E00,116474,Claffy; Kimberly Claire,0,0,0,0
1668140880288,CSE 291,F00,116479,Pasquale; Joseph,0,0,0,0
1668140880747,CSE 293,001,119111,Bafna; Vineet,9999,0,9999,0
1668140880747,CSE 293,002,119118,Bellare; Mihir,9999,0,9999,0
1668140880747,CSE 293,003,119122,Berg-Kirkpatrick; Taylor D,9999,0,9999,0
1668140880747,CSE 293,004,119135,Christensen; Henrik I,9999,0,9999,0
1668140880747,CSE 293,005,119142,Cottrell; Garrison W,9999,0,9999,0
1668140880747,CSE 293,006,119146,Deutsch; Alin Bernard,9999,0,9999,0
1668140880747,CSE 293,007,119159,Esmaeilzadeh; Hadi,9999,0,9999,0
1668140880747,CSE 293,008,119166,Freund; Yoav,9999,0,9999,0
1668140880747,CSE 293,009,119170,Griswold; William G.,9999,0,9999,0
1668140880747,CSE 293,010,119183,Gymrek; Melissa Ann,9999,0,9999,0
1668140880747,CSE 293,011,119190,Heninger; Nadia A,9999,0,9999,0
1668140880747,CSE 293,012,119230,Impagliazzo; Russell,9999,0,9999,0
1668140880747,CSE 293,013,119232,Jhala; Ranjit,9999,0,9999,0
1668140880747,CSE 293,014,119233,Kahng; Andrew Byun,9999,0,9999,0
1668140880747,CSE 293,015,119298,Kane; Daniel Mertz,9999,0,9999,0
1668140880747,CSE 293,016,119299,Kriegman; David J,9999,0,9999,0
1668140880747,CSE 293,017,119300,Kumar; Arun Kumar,9999,0,9999,0
1668140880747,CSE 293,018,119301,Lerner; Sorin,9999,0,9999,0
1668140880747,CSE 293,019,119302,Lovett; Shachar,9999,0,9999,0
1668140880747,CSE 293,020,119303,McAuley; Julian John,9999,0,9999,0
1668140880747,CSE 293,021,119304,Micciancio; Daniele,9999,0,9999,0
1668140880747,CSE 293,022,119367,Orailoglu; Alex,9999,0,9999,0
1668140880747,CSE 293,023,119382,Paturi; Ramamohan,9999,0,9999,0
1668140880747,CSE 293,024,119404,Polikarpova; Nadezhda,9999,0,9999,0
1668140880747,CSE 293,025,119406,Politz; Joseph Gibbs,9999,0,9999,0
1668140880747,CSE 293,026,119411,Porter; George M,9999,0,9999,0
1668140880747,CSE 293,027,119414,Porter; Leonard Emerson,9999,0,9999,0
1668140880747,CSE 293,028,119416,Ramamoorthi; Ravi,9999,0,9999,0
1668140880747,CSE 293,029,119417,Sahoo; Debashis,9999,0,9999,0
1668140880747,CSE 293,030,119420,Saul; Lawrence,9999,0,9999,0
1668140880747,CSE 293,031,119421,Savage; Stefan,9999,0,9999,0
1668140880747,CSE 293,032,119425,Schulze; Jurgen P.,9999,0,9999,0
1668140880747,CSE 293,033,119426,Snoeren; Alex C.,9999,0,9999,0
1668140880747,CSE 293,034,119428,Shang; Jingbo,9999,0,9999,0
1668140880747,CSE 293,035,119430,Stefan; Deian,9999,0,9999,0
1668140880747,CSE 293,036,119431,Su; Hao,9999,0,9999,0
1668140880747,CSE 293,037,119433,Swanson; Steven James,9999,0,9999,0
1668140880747,CSE 293,038,119435,Tullsen; Dean Michael,9999,0,9999,0
1668140880747,CSE 293,039,119483,Voelker; Geoffrey M.,9999,0,9999,0
1668140880747,CSE 293,040,119537,Zhao; Jishen,9999,0,9999,0
1668140880747,CSE 293,041,119538,Zhou; Yuan-Yuan,9999,0,9999,0
1668140880747,CSE 293,042,119539,Gao; Sicun,9999,0,9999,0
1668140880747,CSE 293,043,119540,Weibel; Nadir,9999,0,9999,0
1668140880747,CSE 293,044,119541,Gupta; Rajesh K.,9999,0,9999,0
1668140880747,CSE 293,045,126410,Vaccaro; Kristen Marie,9999,0,9999,0
1668140880747,CSE 293,046,126411,Klemke; Richard,9999,0,9999,0
1668140881193,CSE 294,A00,102459,Voelker; Geoffrey M.,0,0,0,0
1668140881193,CSE 294,B00,111322,Orailoglu; Alex,0,0,0,0
1668140881641,DSE 201,A00,096914,Deutsch; Alin Bernard,30,0,30,0
1668140882068,DSE 210,A00,096915,Dasgupta; Sanjoy,30,0,30,0
1668140882513,DSE 260A,A00,096916,Altintas De Callaf; Ilkay,30,0,30,0
1668140882948,ECE 200,001,103586,Antipa; Nicholas A,9999,0,9999,0
1668140882948,ECE 200,002,103587,Atanasov; Nikolay A.,9999,0,9999,0
1668140882948,ECE 200,003,103588,Bharadia; Dinesh,9999,0,9999,0
1668140882948,ECE 200,004,103589,Cheng; Chung Kuan,9999,0,9999,0
1668140882948,ECE 200,005,103590,Cosman; Pamela C.,9999,0,9999,0
1668140882948,ECE 200,006,103591,Dayeh; Shadi Ahmad,9999,0,9999,0
1668140882948,ECE 200,007,103592,Fainman; Yeshaiahu,9999,0,9999,0
1668140882948,ECE 200,008,103593,Ford; Joseph Earl,9999,0,9999,0
1668140882948,ECE 200,009,103594,Franceschetti; Massimo,9999,0,9999,0
1668140882948,ECE 200,010,103595,Fullerton; Eric E,9999,0,9999,0
1668140882948,ECE 200,011,103596,Galton; Ian A,9999,0,9999,0
1668140882948,ECE 200,012,103597,Gilja; Vikash,9999,0,9999,0
1668140882948,ECE 200,013,103598,Hall; Drew A.,9999,0,9999,0
1668140882948,ECE 200,014,103599,Hsueh; Tzu-Chien,9999,0,9999,0
1668140882948,ECE 200,015,103600,Javidi; Tara,9999,0,9999,0
1668140882948,ECE 200,016,103601,Kahng; Andrew Byun,9999,0,9999,0
1668140882948,ECE 200,017,103602,Kim; Young-Han,9999,0,9999,0
1668140882948,ECE 200,018,103603,Koushanfar; Farinaz,9999,0,9999,0
1668140882948,ECE 200,019,103604,Kuzum; Duygu,9999,0,9999,0
1668140882948,ECE 200,020,103605,Le; Hanh-Phuc,9999,0,9999,0
1668140882948,ECE 200,021,103606,Lin; Bill,9999,0,9999,0
1668140882948,ECE 200,022,103607,Liu; Zhaowei,9998,0,9999,1
1668140882948,ECE 200,023,103608,Lo; Yu-Hwa,9999,0,9999,0
1668140882948,ECE 200,024,103609,Lomakin; Vitaliy,9999,0,9999,0
1668140882948,ECE 200,025,103610,Mercier; Patrick Philip,9999,0,9999,0
1668140882948,ECE 200,026,103611,Meyer; Florian,9999,0,9999,0
1668140882948,ECE 200,027,103612,Milstein; Laurence B.,9999,0,9999,0
1668140882948,ECE 200,028,103613,Mir Arabbaygi; Siavash,9999,0,9999,0
1668140882948,ECE 200,029,103614,Mookherjea; Shayan,9999,0,9999,0
1668140882948,ECE 200,030,103615,Morris; Karcher William,9999,0,9999,0
1668140882948,ECE 200,031,103616,Ng; Tse Nga,9999,0,9999,0
1668140882948,ECE 200,032,103617,Nguyen; Truong Quang,9999,0,9999,0
1668140882948,ECE 200,033,103618,Nomura; Kenji,9999,0,9999,0
1668140882948,ECE 200,034,103619,Orlitsky; Alon,9999,0,9999,0
1668140882948,ECE 200,035,103620,Pal; Piya,9999,0,9999,0
1668140882948,ECE 200,036,103621,Papen; George C.,9999,0,9999,0
1668140882948,ECE 200,037,103622,Radic; Stojan,9999,0,9999,0
1668140882948,ECE 200,038,103623,Rao; Bhaskar D.,9999,0,9999,0
1668140882948,ECE 200,039,103624,Rao; Ramesh R,9999,0,9999,0
1668140882948,ECE 200,040,103625,Rebeiz; Gabriel,9999,0,9999,0
1668140882948,ECE 200,041,103626,Sanford; John R,9999,0,9999,0
1668140882948,ECE 200,042,103627,Siegel; Paul H.,9999,0,9999,0
1668140882948,ECE 200,043,103628,Sievenpiper; Daniel F.,9999,0,9999,0
1668140882948,ECE 200,044,103629,Sworder; David D.,9999,0,9999,0
1668140882948,ECE 200,045,103630,Taur; Yuan,9999,0,9999,0
1668140882948,ECE 200,046,103631,Touri; Behrouz,9999,0,9999,0
1668140882948,ECE 200,047,103632,Trivedi; Mohan M.,9999,0,9999,0
1668140882948,ECE 200,048,103633,Vasconcelos; Nuno,9999,0,9999,0
1668140882948,ECE 200,049,103634,Wang; Xiaolong,9999,0,9999,0
1668140882948,ECE 200,050,103635,Xie; Pengtao,9999,0,9999,0
1668140882948,ECE 200,051,103636,Yip; Michael,9999,0,9999,0
1668140882948,ECE 200,052,103637,Zeger; Kenneth A.,999,0,999,0
1668140882948,ECE 200,053,103638,Zhang; Xinyu,9999,0,9999,0
1668140882948,ECE 200,054,103639,Turakhia; Yatish Girish,9999,0,9999,0
1668140882948,ECE 200,055,103640,Kang; Mingu,9999,0,9999,0
1668140882948,ECE 200,056,103641,Shi; Yuanyuan,9999,0,9999,0
1668140882948,ECE 200,057,103642,Wang; Edward Jay,9999,0,9999,0
1668140882948,ECE 200,058,103643,Zheng; Yang,9999,0,9999,0
1668140883381,ECE 202,A00,103644,Kuzum; Duygu,0,0,0,0
1668140883805,ECE 212BN,A00,103646,Ng; Tse Nga,0,0,0,0
1668140884227,ECE 221,A00,111493,Staff,0,0,0,0
1668140884652,ECE 222B,A00,103647,Lomakin; Vitaliy,0,0,0,0
1668140885075,ECE 230B,A00,103648,Taur; Yuan,0,0,0,0
1668140885499,ECE 238B,A00,103649,Garay; Javier,0,0,0,0
1668140885924,ECE 240B,A00,112900,Fainman; Yeshaiahu,0,0,0,0
1668140886356,ECE 247A,A00,103650,Jokerst; Jesse Vincent,0,0,0,0
1668140886778,ECE 247B,A00,103651,Wang; Joseph,0,0,0,0
1668140887202,ECE 250,A00,103652,Siegel; Paul H.,0,0,0,0
1668140887627,ECE 251A,A00,103654,Rao; Bhaskar D.,0,0,0,0
1668140888089,ECE 257B,A00,103655,Bharadia; Dinesh,0,0,0,0
1668140888523,ECE 258A,A00,103656,Milstein; Laurence B.,0,0,0,0
1668140888958,ECE 260B,A00,103658,Kang; Mingu,0,0,0,0
1668140889393,ECE 264A,A00,103659,Galton; Ian A,0,0,0,0
1668140889822,ECE 265A,A00,103661,Gudem; Prasad S.S.,0,0,0,0
1668140890262,ECE 265D,A00,103662,Gudem; Prasad S.S.,0,0,0,0
1668140890690,ECE 268,A00,103663,Koushanfar; Farinaz,0,0,0,0
1668140891270,ECE 269,A01,103665,Pal; Piya,0,0,0,0
1668140891732,ECE 271B,A00,103666,Vasconcelos; Manuela,0,0,0,0
1668140892157,ECE 276A,A00,103667,Atanasov; Nikolay A.,0,0,0,0
1668140892597,ECE 277,A00,103668,An; Cheolhong,0,0,0,0
1668140893021,ECE 279,A00,117947,Hall; Drew A.,0,0,0,0
1668140893887,ECE 283,A00,103670,Hsueh; Tzu-Chien,0,0,0,0
1668140894333,ECE 284,A00,103671,Turakhia; Yatish Girish,0,0,0,0
1668140894771,ECE 285,A00,103672,Zheng; Yang,0,0,0,0
1668140894771,ECE 285,B00,103673,Sworder; David D.,0,0,0,0
1668140895200,ECE 287,A00,103676,Javidi; Tara,0,0,0,0
1668140895625,MATH 200B,A00,098023,Salehi Golsefidy; Alireza,12,0,15,3
1668140896061,MATH 202B,A00,098024,Rhoades; Brendon Patrick,9,0,15,6
1668140896497,MATH 203B,A00,098025,Oprea; Dragos N.,10,0,15,5
1668140896919,MATH 204B,A00,098026,Sorensen; Claus M,13,0,15,2
1668140897376,MATH 208,A00,098027,Izadi; Elham,7,0,10,3
1668140897810,MATH 209,A00,098028,Pollack; Aaron,10,0,10,0
1668140898235,MATH 211A,A00,112919,Rogalski; Daniel,9,0,10,1
1668140898677,MATH 211B,A00,112920,Seward; Brandon M.,9,0,10,1
1668140899111,MATH 218,A00,098029,Li; Bo,10,0,10,0
1668140899537,MATH 220B,A00,098030,Novak; Jonathan I,11,0,15,4
1668140899983,MATH 221A,A00,098031,Ebenfelt; Peter F,13,0,15,2
1668140900419,MATH 231B,A00,098032,Zlatos; Andrej,12,0,15,3
1668140901004,MATH 240B,A00,098033,Ni; Lei,9,0,15,6
1668140901430,MATH 243,A00,098034,Jekel; David Andrew,10,0,10,0
1668140901853,MATH 245A,A00,098035,Nie; Jiawang,0,0,15,16
1668140902283,MATH 248,A00,098036,Bejenaru; Ioan,10,0,10,0
1668140902729,MATH 250B,A00,098037,Spolaor; Luca,14,0,15,1
1668140903153,MATH 258,A00,098038,Ni; Lei,10,0,10,0
1668140903588,MATH 264B,A00,098041,Rhoades; Brendon Patrick,9,0,15,6
1668140904022,MATH 268,A00,098042,Buss; Samuel R,10,0,10,0
1668140904446,MATH 269,A00,098043,Rhoades; Brendon Patrick,10,0,10,0
1668140904870,MATH 270B,A00,098044,Li; Bo,10,0,15,5
1668140905315,MATH 272B,A00,098045,Holst; Michael J,13,0,15,2
1668140905752,MATH 273A,A00,098046,Tian; Xiaochuan,10,0,15,5
1668140906179,MATH 275,A01,098048,Tian; Xiaochuan,6,0,10,4
1668140906613,MATH 278A,A00,098049,Holst; Michael J,8,0,10,2
1668140907037,MATH 278B,A00,098050,Cloninger; Alexander,10,0,10,0
1668140907462,MATH 278C,A00,098051,Nie; Jiawang,7,0,10,3
1668140907897,MATH 280B,A00,098052,Zheng; Tianyi,10,0,15,5
1668140908330,MATH 281B,A00,098053,Bradic; Jelena,2,0,15,13
1668140908770,MATH 282B,A00,098054,Arias-Castro; Ery,0,0,15,15
1668140909194,MATH 285,A00,098055,Fitzsimmons; Patrick J,0,0,15,17
1668140909621,MATH 287B,A00,098056,Arias-Castro; Ery,2,0,15,13
1668140910046,MATH 288,A00,098057,Agarwal; Pooja,9,0,10,1
1668140910046,MATH 288,B00,098058,Zhang; Danna,8,0,10,2
1668140910046,MATH 288,C00,098059,Williams; Ruth J,10,0,10,0
1668140910489,MATH 290B,A00,098060,Roberts; Justin Deritter,13,0,15,2
1668140910914,MATH 292,A00,098061,Belmont; Eva Kinoshita,10,0,10,0
1668140911341,MATH 295,A00,098062,Suk; Andrew Hoon,48,0,50,2
1668140911765,MATH 296,A00,098063,Novak; Jonathan I,20,0,20,0
1668140912188,MATH 297,001,098064,Gamst; Anthony Collins,9997,0,9999,2
1668141430211,COGS 205,A00,101395,Chiba; Andrea,19,0,20,1
1668141430639,COGS 210B,001,101404,Greene; Deanna Jacquelyn,9998,0,9999,1
1668141430639,COGS 210B,002,101417,Xia; Haijun,9999,0,9999,0
1668141430639,COGS 210B,003,101422,Nitz; Douglas A.,9999,0,9999,0
1668141430639,COGS 210B,004,101423,Hollan; James D.,9998,0,9999,1
1668141430639,COGS 210B,005,101424,Deak; Gedeon O.,9998,0,9999,1
1668141430639,COGS 210B,006,101425,Rossano; Federico,9999,0,9999,0
1668141431064,COGS 211B,A00,101427,Coulson; Seana M,9996,0,9999,3
1668141431488,COGS 220,A00,101428,Hollan; James D.,0,0,25,25
1668141431911,COGS 229,A00,101429,Dow; Steven P,18,0,25,7
1668141432343,COGS 230,A00,101430,Klemmer; Scott R,12,0,17,5
1668141432778,COGS 234,A00,101431,Xia; Haijun,3,0,25,22
1668141433202,COGS 260,A00,101432,Kiyonaga; Anastasia,20,0,25,5
1668141433202,COGS 260,B00,101433,Kirsh; David Joel,16,0,25,9
1668141433633,CSE 202,A00,102371,Impagliazzo; Russell,0,0,0,0
1668141434060,CSE 203B,A01,102373,Cheng; Chung Kuan,0,0,0,0
1668141434483,CSE 208,A00,102374,Micciancio; Daniele,0,0,0,0
1668141434907,CSE 209A,A00,112895,Impagliazzo; Russell,0,0,15,15
1668141435330,CSE 209B,A00,108005,Bellare; Mihir,0,0,0,0
1668141435751,CSE 210,A00,113163,Coblenz; Michael J,0,0,0,0
1668141436178,CSE 219,A00,106111,Dow; Steven P,0,0,20,20
1668141436601,CSE 221,A00,102376,Voelker; Geoffrey M.,0,0,0,0
1668141437026,CSE 224,A01,102378,Porter; George M,0,0,0,0
1668141437475,CSE 229A,A00,102379,Savage; Stefan,0,0,0,0
1668141437900,CSE 229C,A00,102380,Munyaka; Imani N. S.,0,0,0,0
1668141438333,CSE 232B,A00,102382,Deutsch; Alin Bernard,0,0,0,0
1668141438759,CSE 234,A01,112904,Kumar; Arun Kumar,0,0,0,0
1668141439195,CSE 237A,A00,102383,Rosing; Tajana Simunic,0,0,0,0
1668141439631,CSE 239A,A00,102384,Deutsch; Alin Bernard,0,0,0,0
1668141440068,CSE 239B,A00,102385,Polikarpova; Nadezhda,0,0,0,0
1668141440490,CSE 240A,A00,102386,Pannuto; Patrick William,0,0,0,0
1668141440916,CSE 240B,A00,102387,Zhao; Jishen,0,0,0,0
1668141441347,CSE 241A,A00,106406,Kang; Mingu,0,0,0,0
1668141441788,CSE 249B,A00,102388,Kahng; Andrew Byun,0,0,8,8
1668141442224,CSE 251B,A01,102392,Cottrell; Garrison W,0,0,0,0
1668141442224,CSE 251B,A02,102393,Cottrell; Garrison W,0,0,0,0
1668141442653,CSE 252B,A00,102394,Ochoa; Benjamin Lawrence,0,0,0,0
1668141443079,CSE 257,A01,102396,Gao; Sicun,0,0,0,0
1668141443502,CSE 272,A00,102397,Li; Tzumao,0,0,0,0
1668141443924,CSE 274,A00,111323,Chern; Albert Ren-Haur,0,0,0,0
1668141444370,CSE 282,A00,102398,Pevzner; Pavel Arkadjevich,0,0,0,0
1668141444823,CSE 284,A00,114175,Gymrek; Melissa Ann,0,0,0,0
1668141445253,CSE 290,A00,102399,Chandraker; Manmohan Krishna,0,0,0,0
1668141445253,CSE 290,B00,102400,Vaccaro; Kristen Marie,0,0,25,25
1668141445253,CSE 290,C00,102414,Pannuto; Patrick William,0,0,25,25
1668141445253,CSE 290,D00,102427,Pevzner; Pavel Arkadjevich,0,0,0,0
1668141445253,CSE 290,E00,102429,Zhao; Jishen,0,0,0,0
1668141445253,CSE 290,F00,102436,Tullsen; Dean Michael,0,0,0,0
1668141445253,CSE 290,G00,102440,Christensen; Henrik I,0,0,20,20
1668141445676,CSE 291,A00,102443,Su; Hao,0,0,0,0
1668141445676,CSE 291,B00,102448,Polikarpova; Nadezhda,0,0,0,0
1668141445676,CSE 291,C00,102453,Vaccaro; Kristen Marie,0,0,0,0
1668141445676,CSE 291,D00,111343,Savage; Stefan,0,0,0,0
1668141445676,CSE 291,E00,116474,Claffy; Kimberly Claire,0,0,0,0
1668141445676,CSE 291,F00,116479,Pasquale; Joseph,0,0,0,0
1668141446102,CSE 293,001,119111,Bafna; Vineet,9999,0,9999,0
1668141446102,CSE 293,002,119118,Bellare; Mihir,9999,0,9999,0
1668141446102,CSE 293,003,119122,Berg-Kirkpatrick; Taylor D,9999,0,9999,0
1668141446102,CSE 293,004,119135,Christensen; Henrik I,9999,0,9999,0
1668141446102,CSE 293,005,119142,Cottrell; Garrison W,9999,0,9999,0
1668141446102,CSE 293,006,119146,Deutsch; Alin Bernard,9999,0,9999,0
1668141446102,CSE 293,007,119159,Esmaeilzadeh; Hadi,9999,0,9999,0
1668141446102,CSE 293,008,119166,Freund; Yoav,9999,0,9999,0
1668141446102,CSE 293,009,119170,Griswold; William G.,9999,0,9999,0
1668141446102,CSE 293,010,119183,Gymrek; Melissa Ann,9999,0,9999,0
1668141446102,CSE 293,011,119190,Heninger; Nadia A,9999,0,9999,0
1668141446102,CSE 293,012,119230,Impagliazzo; Russell,9999,0,9999,0
1668141446102,CSE 293,013,119232,Jhala; Ranjit,9999,0,9999,0
1668141446102,CSE 293,014,119233,Kahng; Andrew Byun,9999,0,9999,0
1668141446102,CSE 293,015,119298,Kane; Daniel Mertz,9999,0,9999,0
1668141446102,CSE 293,016,119299,Kriegman; David J,9999,0,9999,0
1668141446102,CSE 293,017,119300,Kumar; Arun Kumar,9999,0,9999,0
1668141446102,CSE 293,018,119301,Lerner; Sorin,9999,0,9999,0
1668141446102,CSE 293,019,119302,Lovett; Shachar,9999,0,9999,0
1668141446102,CSE 293,020,119303,McAuley; Julian John,9999,0,9999,0
1668141446102,CSE 293,021,119304,Micciancio; Daniele,9999,0,9999,0
1668141446102,CSE 293,022,119367,Orailoglu; Alex,9999,0,9999,0
1668141446102,CSE 293,023,119382,Paturi; Ramamohan,9999,0,9999,0
1668141446102,CSE 293,024,119404,Polikarpova; Nadezhda,9999,0,9999,0
1668141446102,CSE 293,025,119406,Politz; Joseph Gibbs,9999,0,9999,0
1668141446102,CSE 293,026,119411,Porter; George M,9999,0,9999,0
1668141446102,CSE 293,027,119414,Porter; Leonard Emerson,9999,0,9999,0
1668141446102,CSE 293,028,119416,Ramamoorthi; Ravi,9999,0,9999,0
1668141446102,CSE 293,029,119417,Sahoo; Debashis,9999,0,9999,0
1668141446102,CSE 293,030,119420,Saul; Lawrence,9999,0,9999,0
1668141446102,CSE 293,031,119421,Savage; Stefan,9999,0,9999,0
1668141446102,CSE 293,032,119425,Schulze; Jurgen P.,9999,0,9999,0
1668141446102,CSE 293,033,119426,Snoeren; Alex C.,9999,0,9999,0
1668141446102,CSE 293,034,119428,Shang; Jingbo,9999,0,9999,0
1668141446102,CSE 293,035,119430,Stefan; Deian,9999,0,9999,0
1668141446102,CSE 293,036,119431,Su; Hao,9999,0,9999,0
1668141446102,CSE 293,037,119433,Swanson; Steven James,9999,0,9999,0
1668141446102,CSE 293,038,119435,Tullsen; Dean Michael,9999,0,9999,0
1668141446102,CSE 293,039,119483,Voelker; Geoffrey M.,9999,0,9999,0
1668141446102,CSE 293,040,119537,Zhao; Jishen,9999,0,9999,0
1668141446102,CSE 293,041,119538,Zhou; Yuan-Yuan,9999,0,9999,0
1668141446102,CSE 293,042,119539,Gao; Sicun,9999,0,9999,0
1668141446102,CSE 293,043,119540,Weibel; Nadir,9999,0,9999,0
1668141446102,CSE 293,044,119541,Gupta; Rajesh K.,9999,0,9999,0
1668141446102,CSE 293,045,126410,Vaccaro; Kristen Marie,9999,0,9999,0
1668141446102,CSE 293,046,126411,Klemke; Richard,9999,0,9999,0
1668141446528,CSE 294,A00,102459,Voelker; Geoffrey M.,0,0,0,0
1668141446528,CSE 294,B00,111322,Orailoglu; Alex,0,0,0,0
1668141446976,DSE 201,A00,096914,Deutsch; Alin Bernard,30,0,30,0
1668141447415,DSE 210,A00,096915,Dasgupta; Sanjoy,30,0,30,0
1668141447854,DSE 260A,A00,096916,Altintas De Callaf; Ilkay,30,0,30,0
1668141448283,ECE 200,001,103586,Antipa; Nicholas A,9999,0,9999,0
1668141448283,ECE 200,002,103587,Atanasov; Nikolay A.,9999,0,9999,0
1668141448283,ECE 200,003,103588,Bharadia; Dinesh,9999,0,9999,0
1668141448283,ECE 200,004,103589,Cheng; Chung Kuan,9999,0,9999,0
1668141448283,ECE 200,005,103590,Cosman; Pamela C.,9999,0,9999,0
1668141448283,ECE 200,006,103591,Dayeh; Shadi Ahmad,9999,0,9999,0
1668141448283,ECE 200,007,103592,Fainman; Yeshaiahu,9999,0,9999,0
1668141448283,ECE 200,008,103593,Ford; Joseph Earl,9999,0,9999,0
1668141448283,ECE 200,009,103594,Franceschetti; Massimo,9999,0,9999,0
1668141448283,ECE 200,010,103595,Fullerton; Eric E,9999,0,9999,0
1668141448283,ECE 200,011,103596,Galton; Ian A,9999,0,9999,0
1668141448283,ECE 200,012,103597,Gilja; Vikash,9999,0,9999,0
1668141448283,ECE 200,013,103598,Hall; Drew A.,9999,0,9999,0
1668141448283,ECE 200,014,103599,Hsueh; Tzu-Chien,9999,0,9999,0
1668141448283,ECE 200,015,103600,Javidi; Tara,9999,0,9999,0
1668141448283,ECE 200,016,103601,Kahng; Andrew Byun,9999,0,9999,0
1668141448283,ECE 200,017,103602,Kim; Young-Han,9999,0,9999,0
1668141448283,ECE 200,018,103603,Koushanfar; Farinaz,9999,0,9999,0
1668141448283,ECE 200,019,103604,Kuzum; Duygu,9999,0,9999,0
1668141448283,ECE 200,020,103605,Le; Hanh-Phuc,9999,0,9999,0
1668141448283,ECE 200,021,103606,Lin; Bill,9999,0,9999,0
1668141448283,ECE 200,022,103607,Liu; Zhaowei,9998,0,9999,1
1668141448283,ECE 200,023,103608,Lo; Yu-Hwa,9999,0,9999,0
1668141448283,ECE 200,024,103609,Lomakin; Vitaliy,9999,0,9999,0
1668141448283,ECE 200,025,103610,Mercier; Patrick Philip,9999,0,9999,0
1668141448283,ECE 200,026,103611,Meyer; Florian,9999,0,9999,0
1668141448283,ECE 200,027,103612,Milstein; Laurence B.,9999,0,9999,0
1668141448283,ECE 200,028,103613,Mir Arabbaygi; Siavash,9999,0,9999,0
1668141448283,ECE 200,029,103614,Mookherjea; Shayan,9999,0,9999,0
1668141448283,ECE 200,030,103615,Morris; Karcher William,9999,0,9999,0
1668141448283,ECE 200,031,103616,Ng; Tse Nga,9999,0,9999,0
1668141448283,ECE 200,032,103617,Nguyen; Truong Quang,9999,0,9999,0
1668141448283,ECE 200,033,103618,Nomura; Kenji,9999,0,9999,0
1668141448283,ECE 200,034,103619,Orlitsky; Alon,9999,0,9999,0
1668141448283,ECE 200,035,103620,Pal; Piya,9999,0,9999,0
1668141448283,ECE 200,036,103621,Papen; George C.,9999,0,9999,0
1668141448283,ECE 200,037,103622,Radic; Stojan,9999,0,9999,0
1668141448283,ECE 200,038,103623,Rao; Bhaskar D.,9999,0,9999,0
1668141448283,ECE 200,039,103624,Rao; Ramesh R,9999,0,9999,0
1668141448283,ECE 200,040,103625,Rebeiz; Gabriel,9999,0,9999,0
1668141448283,ECE 200,041,103626,Sanford; John R,9999,0,9999,0
1668141448283,ECE 200,042,103627,Siegel; Paul H.,9999,0,9999,0
1668141448283,ECE 200,043,103628,Sievenpiper; Daniel F.,9999,0,9999,0
1668141448283,ECE 200,044,103629,Sworder; David D.,9999,0,9999,0
1668141448283,ECE 200,045,103630,Taur; Yuan,9999,0,9999,0
1668141448283,ECE 200,046,103631,Touri; Behrouz,9999,0,9999,0
1668141448283,ECE 200,047,103632,Trivedi; Mohan M.,9999,0,9999,0
1668141448283,ECE 200,048,103633,Vasconcelos; Nuno,9999,0,9999,0
1668141448283,ECE 200,049,103634,Wang; Xiaolong,9999,0,9999,0
1668141448283,ECE 200,050,103635,Xie; Pengtao,9999,0,9999,0
1668141448283,ECE 200,051,103636,Yip; Michael,9999,0,9999,0
1668141448283,ECE 200,052,103637,Zeger; Kenneth A.,999,0,999,0
1668141448283,ECE 200,053,103638,Zhang; Xinyu,9999,0,9999,0
1668141448283,ECE 200,054,103639,Turakhia; Yatish Girish,9999,0,9999,0
1668141448283,ECE 200,055,103640,Kang; Mingu,9999,0,9999,0
1668141448283,ECE 200,056,103641,Shi; Yuanyuan,9999,0,9999,0
1668141448283,ECE 200,057,103642,Wang; Edward Jay,9999,0,9999,0
1668141448283,ECE 200,058,103643,Zheng; Yang,9999,0,9999,0
1668141448713,ECE 202,A00,103644,Kuzum; Duygu,0,0,0,0
1668141449149,ECE 212BN,A00,103646,Ng; Tse Nga,0,0,0,0
1668141449575,ECE 221,A00,111493,Staff,0,0,0,0
1668141450001,ECE 222B,A00,103647,Lomakin; Vitaliy,0,0,0,0
1668141450440,ECE 230B,A00,103648,Taur; Yuan,0,0,0,0
1668141450882,ECE 238B,A00,103649,Garay; Javier,0,0,0,0
1668141451306,ECE 240B,A00,112900,Fainman; Yeshaiahu,0,0,0,0
1668141451737,ECE 247A,A00,103650,Jokerst; Jesse Vincent,0,0,0,0
1668141452161,ECE 247B,A00,103651,Wang; Joseph,0,0,0,0
1668141452602,ECE 250,A00,103652,Siegel; Paul H.,0,0,0,0
1668141453054,ECE 251A,A00,103654,Rao; Bhaskar D.,0,0,0,0
1668141453476,ECE 257B,A00,103655,Bharadia; Dinesh,0,0,0,0
1668141453898,ECE 258A,A00,103656,Milstein; Laurence B.,0,0,0,0
1668141454323,ECE 260B,A00,103658,Kang; Mingu,0,0,0,0
1668141454757,ECE 264A,A00,103659,Galton; Ian A,0,0,0,0
1668141455190,ECE 265A,A00,103661,Gudem; Prasad S.S.,0,0,0,0
1668141455616,ECE 265D,A00,103662,Gudem; Prasad S.S.,0,0,0,0
1668141456053,ECE 268,A00,103663,Koushanfar; Farinaz,0,0,0,0
1668141456478,ECE 269,A01,103665,Pal; Piya,0,0,0,0
1668141456907,ECE 271B,A00,103666,Vasconcelos; Manuela,0,0,0,0
1668141457343,ECE 276A,A00,103667,Atanasov; Nikolay A.,0,0,0,0
1668141457775,ECE 277,A00,103668,An; Cheolhong,0,0,0,0
1668141458201,ECE 279,A00,117947,Hall; Drew A.,0,0,0,0
1668141459070,ECE 283,A00,103670,Hsueh; Tzu-Chien,0,0,0,0
1668141459506,ECE 284,A00,103671,Turakhia; Yatish Girish,0,0,0,0
1668141459943,ECE 285,A00,103672,Zheng; Yang,0,0,0,0
1668141459943,ECE 285,B00,103673,Sworder; David D.,0,0,0,0
1668141460379,ECE 287,A00,103676,Javidi; Tara,0,0,0,0
1668141460820,MATH 200B,A00,098023,Salehi Golsefidy; Alireza,12,0,15,3
1668141461254,MATH 202B,A00,098024,Rhoades; Brendon Patrick,9,0,15,6
1668141461678,MATH 203B,A00,098025,Oprea; Dragos N.,10,0,15,5
1668141462111,MATH 204B,A00,098026,Sorensen; Claus M,13,0,15,2
1668141462542,MATH 208,A00,098027,Izadi; Elham,7,0,10,3
1668141462977,MATH 209,A00,098028,Pollack; Aaron,10,0,10,0
1668141463401,MATH 211A,A00,112919,Rogalski; Daniel,9,0,10,1
1668141463825,MATH 211B,A00,112920,Seward; Brandon M.,9,0,10,1
1668141464247,MATH 218,A00,098029,Li; Bo,10,0,10,0
1668141464678,MATH 220B,A00,098030,Novak; Jonathan I,11,0,15,4
1668141465114,MATH 221A,A00,098031,Ebenfelt; Peter F,13,0,15,2
1668141465557,MATH 231B,A00,098032,Zlatos; Andrej,12,0,15,3
1668141465983,MATH 240B,A00,098033,Ni; Lei,9,0,15,6
1668141466414,MATH 243,A00,098034,Jekel; David Andrew,10,0,10,0
1668141466838,MATH 245A,A00,098035,Nie; Jiawang,0,0,15,16
1668141467274,MATH 248,A00,098036,Bejenaru; Ioan,10,0,10,0
1668141467707,MATH 250B,A00,098037,Spolaor; Luca,14,0,15,1
1668141468133,MATH 258,A00,098038,Ni; Lei,10,0,10,0
1668141468555,MATH 264B,A00,098041,Rhoades; Brendon Patrick,9,0,15,6
1668141468985,MATH 268,A00,098042,Buss; Samuel R,10,0,10,0
1668141469410,MATH 269,A00,098043,Rhoades; Brendon Patrick,10,0,10,0
1668141469846,MATH 270B,A00,098044,Li; Bo,10,0,15,5
1668141470268,MATH 272B,A00,098045,Holst; Michael J,13,0,15,2
1668141470692,MATH 273A,A00,098046,Tian; Xiaochuan,10,0,15,5
1668141471127,MATH 275,A01,098048,Tian; Xiaochuan,6,0,10,4
1668141471550,MATH 278A,A00,098049,Holst; Michael J,8,0,10,2
1668141471989,MATH 278B,A00,098050,Cloninger; Alexander,10,0,10,0
1668141472423,MATH 278C,A00,098051,Nie; Jiawang,7,0,10,3
1668141472848,MATH 280B,A00,098052,Zheng; Tianyi,10,0,15,5
1668141473379,MATH 281B,A00,098053,Bradic; Jelena,2,0,15,13
1668141473821,MATH 282B,A00,098054,Arias-Castro; Ery,0,0,15,15
1668141474252,MATH 285,A00,098055,Fitzsimmons; Patrick J,0,0,15,17
1668141474674,MATH 287B,A00,098056,Arias-Castro; Ery,2,0,15,13
1668141475098,MATH 288,A00,098057,Agarwal; Pooja,9,0,10,1
1668141475098,MATH 288,B00,098058,Zhang; Danna,8,0,10,2
1668141475098,MATH 288,C00,098059,Williams; Ruth J,10,0,10,0
1668141475523,MATH 290B,A00,098060,Roberts; Justin Deritter,13,0,15,2
1668141475961,MATH 292,A00,098061,Belmont; Eva Kinoshita,10,0,10,0
1668141476391,MATH 295,A00,098062,Suk; Andrew Hoon,48,0,50,2
1668141476817,MATH 296,A00,098063,Novak; Jonathan I,20,0,20,0
1668141477241,MATH 297,001,098064,Gamst; Anthony Collins,9997,0,9999,2
1668141984980,COGS 205,A00,101395,Chiba; Andrea,19,0,20,1
1668141985404,COGS 210B,001,101404,Greene; Deanna Jacquelyn,9998,0,9999,1
1668141985404,COGS 210B,002,101417,Xia; Haijun,9999,0,9999,0
1668141985404,COGS 210B,003,101422,Nitz; Douglas A.,9999,0,9999,0
1668141985404,COGS 210B,004,101423,Hollan; James D.,9998,0,9999,1
1668141985404,COGS 210B,005,101424,Deak; Gedeon O.,9998,0,9999,1
1668141985404,COGS 210B,006,101425,Rossano; Federico,9999,0,9999,0
1668141985844,COGS 211B,A00,101427,Coulson; Seana M,9996,0,9999,3
1668141986294,COGS 220,A00,101428,Hollan; James D.,0,0,25,25
1668141986729,COGS 229,A00,101429,Dow; Steven P,18,0,25,7
1668141987156,COGS 230,A00,101430,Klemmer; Scott R,12,0,17,5
1668141987579,COGS 234,A00,101431,Xia; Haijun,3,0,25,22
1668141988030,COGS 260,A00,101432,Kiyonaga; Anastasia,20,0,25,5
1668141988030,COGS 260,B00,101433,Kirsh; David Joel,16,0,25,9
1668141988480,CSE 202,A00,102371,Impagliazzo; Russell,0,0,0,0
1668141988915,CSE 203B,A01,102373,Cheng; Chung Kuan,0,0,0,0
1668141989340,CSE 208,A00,102374,Micciancio; Daniele,0,0,0,0
1668141989767,CSE 209A,A00,112895,Impagliazzo; Russell,0,0,15,15
1668141990199,CSE 209B,A00,108005,Bellare; Mihir,0,0,0,0
1668141990622,CSE 210,A00,113163,Coblenz; Michael J,0,0,0,0
1668141991043,CSE 219,A00,106111,Dow; Steven P,0,0,20,20
1668141991475,CSE 221,A00,102376,Voelker; Geoffrey M.,0,0,0,0
1668141991898,CSE 224,A01,102378,Porter; George M,0,0,0,0
1668141992327,CSE 229A,A00,102379,Savage; Stefan,0,0,0,0
1668141992764,CSE 229C,A00,102380,Munyaka; Imani N. S.,0,0,0,0
1668141993190,CSE 232B,A00,102382,Deutsch; Alin Bernard,0,0,0,0
1668141993630,CSE 234,A01,112904,Kumar; Arun Kumar,0,0,0,0
1668141994052,CSE 237A,A00,102383,Rosing; Tajana Simunic,0,0,0,0
1668141994475,CSE 239A,A00,102384,Deutsch; Alin Bernard,0,0,0,0
1668141995055,CSE 239B,A00,102385,Polikarpova; Nadezhda,0,0,0,0
1668141995479,CSE 240A,A00,102386,Pannuto; Patrick William,0,0,0,0
1668141995912,CSE 240B,A00,102387,Zhao; Jishen,0,0,0,0
1668141996334,CSE 241A,A00,106406,Kang; Mingu,0,0,0,0
1668141996765,CSE 249B,A00,102388,Kahng; Andrew Byun,0,0,8,8
1668141997200,CSE 251B,A01,102392,Cottrell; Garrison W,0,0,0,0
1668141997200,CSE 251B,A02,102393,Cottrell; Garrison W,0,0,0,0
1668141997647,CSE 252B,A00,102394,Ochoa; Benjamin Lawrence,0,0,0,0
1668141998080,CSE 257,A01,102396,Gao; Sicun,0,0,0,0
1668141998503,CSE 272,A00,102397,Li; Tzumao,0,0,0,0
1668141998927,CSE 274,A00,111323,Chern; Albert Ren-Haur,0,0,0,0
1668141999351,CSE 282,A00,102398,Pevzner; Pavel Arkadjevich,0,0,0,0
1668141999782,CSE 284,A00,114175,Gymrek; Melissa Ann,0,0,0,0
1668142000206,CSE 290,A00,102399,Chandraker; Manmohan Krishna,0,0,0,0
1668142000206,CSE 290,B00,102400,Vaccaro; Kristen Marie,0,0,25,25
1668142000206,CSE 290,C00,102414,Pannuto; Patrick William,0,0,25,25
1668142000206,CSE 290,D00,102427,Pevzner; Pavel Arkadjevich,0,0,0,0
1668142000206,CSE 290,E00,102429,Zhao; Jishen,0,0,0,0
1668142000206,CSE 290,F00,102436,Tullsen; Dean Michael,0,0,0,0
1668142000206,CSE 290,G00,102440,Christensen; Henrik I,0,0,20,20
1668142000645,CSE 291,A00,102443,Su; Hao,0,0,0,0
1668142000645,CSE 291,B00,102448,Polikarpova; Nadezhda,0,0,0,0
1668142000645,CSE 291,C00,102453,Vaccaro; Kristen Marie,0,0,0,0
1668142000645,CSE 291,D00,111343,Savage; Stefan,0,0,0,0
1668142000645,CSE 291,E00,116474,Claffy; Kimberly Claire,0,0,0,0
1668142000645,CSE 291,F00,116479,Pasquale; Joseph,0,0,0,0
1668142001079,CSE 293,001,119111,Bafna; Vineet,9999,0,9999,0
1668142001079,CSE 293,002,119118,Bellare; Mihir,9999,0,9999,0
1668142001079,CSE 293,003,119122,Berg-Kirkpatrick; Taylor D,9999,0,9999,0
1668142001079,CSE 293,004,119135,Christensen; Henrik I,9999,0,9999,0
1668142001079,CSE 293,005,119142,Cottrell; Garrison W,9999,0,9999,0
1668142001079,CSE 293,006,119146,Deutsch; Alin Bernard,9999,0,9999,0
1668142001079,CSE 293,007,119159,Esmaeilzadeh; Hadi,9999,0,9999,0
1668142001079,CSE 293,008,119166,Freund; Yoav,9999,0,9999,0
1668142001079,CSE 293,009,119170,Griswold; William G.,9999,0,9999,0
1668142001079,CSE 293,010,119183,Gymrek; Melissa Ann,9999,0,9999,0
1668142001079,CSE 293,011,119190,Heninger; Nadia A,9999,0,9999,0
1668142001079,CSE 293,012,119230,Impagliazzo; Russell,9999,0,9999,0
1668142001079,CSE 293,013,119232,Jhala; Ranjit,9999,0,9999,0
1668142001079,CSE 293,014,119233,Kahng; Andrew Byun,9999,0,9999,0
1668142001079,CSE 293,015,119298,Kane; Daniel Mertz,9999,0,9999,0
1668142001079,CSE 293,016,119299,Kriegman; David J,9999,0,9999,0
1668142001079,CSE 293,017,119300,Kumar; Arun Kumar,9999,0,9999,0
1668142001079,CSE 293,018,119301,Lerner; Sorin,9999,0,9999,0
1668142001079,CSE 293,019,119302,Lovett; Shachar,9999,0,9999,0
1668142001079,CSE 293,020,119303,McAuley; Julian John,9999,0,9999,0
1668142001079,CSE 293,021,119304,Micciancio; Daniele,9999,0,9999,0
1668142001079,CSE 293,022,119367,Orailoglu; Alex,9999,0,9999,0
1668142001079,CSE 293,023,119382,Paturi; Ramamohan,9999,0,9999,0
1668142001079,CSE 293,024,119404,Polikarpova; Nadezhda,9999,0,9999,0
1668142001079,CSE 293,025,119406,Politz; Joseph Gibbs,9999,0,9999,0
1668142001079,CSE 293,026,119411,Porter; George M,9999,0,9999,0
1668142001079,CSE 293,027,119414,Porter; Leonard Emerson,9999,0,9999,0
1668142001079,CSE 293,028,119416,Ramamoorthi; Ravi,9999,0,9999,0
1668142001079,CSE 293,029,119417,Sahoo; Debashis,9999,0,9999,0
1668142001079,CSE 293,030,119420,Saul; Lawrence,9999,0,9999,0
1668142001079,CSE 293,031,119421,Savage; Stefan,9999,0,9999,0
1668142001079,CSE 293,032,119425,Schulze; Jurgen P.,9999,0,9999,0
1668142001079,CSE 293,033,119426,Snoeren; Alex C.,9999,0,9999,0
1668142001079,CSE 293,034,119428,Shang; Jingbo,9999,0,9999,0
1668142001079,CSE 293,035,119430,Stefan; Deian,9999,0,9999,0
1668142001079,CSE 293,036,119431,Su; Hao,9999,0,9999,0
1668142001079,CSE 293,037,119433,Swanson; Steven James,9999,0,9999,0
1668142001079,CSE 293,038,119435,Tullsen; Dean Michael,9999,0,9999,0
1668142001079,CSE 293,039,119483,Voelker; Geoffrey M.,9999,0,9999,0
1668142001079,CSE 293,040,119537,Zhao; Jishen,9999,0,9999,0
1668142001079,CSE 293,041,119538,Zhou; Yuan-Yuan,9999,0,9999,0
1668142001079,CSE 293,042,119539,Gao; Sicun,9999,0,9999,0
1668142001079,CSE 293,043,119540,Weibel; Nadir,9999,0,9999,0
1668142001079,CSE 293,044,119541,Gupta; Rajesh K.,9999,0,9999,0
1668142001079,CSE 293,045,126410,Vaccaro; Kristen Marie,9999,0,9999,0
1668142001079,CSE 293,046,126411,Klemke; Richard,9999,0,9999,0
1668142001615,CSE 294,A00,102459,Voelker; Geoffrey M.,0,0,0,0
1668142001615,CSE 294,B00,111322,Orailoglu; Alex,0,0,0,0
1668142002039,DSE 201,A00,096914,Deutsch; Alin Bernard,30,0,30,0
1668142002462,DSE 210,A00,096915,Dasgupta; Sanjoy,30,0,30,0
1668142002898,DSE 260A,A00,096916,Altintas De Callaf; Ilkay,30,0,30,0
1668142003354,ECE 200,001,103586,Antipa; Nicholas A,9999,0,9999,0
1668142003354,ECE 200,002,103587,Atanasov; Nikolay A.,9999,0,9999,0
1668142003354,ECE 200,003,103588,Bharadia; Dinesh,9999,0,9999,0
1668142003354,ECE 200,004,103589,Cheng; Chung Kuan,9999,0,9999,0
1668142003354,ECE 200,005,103590,Cosman; Pamela C.,9999,0,9999,0
1668142003354,ECE 200,006,103591,Dayeh; Shadi Ahmad,9999,0,9999,0
1668142003354,ECE 200,007,103592,Fainman; Yeshaiahu,9999,0,9999,0
1668142003354,ECE 200,008,103593,Ford; Joseph Earl,9999,0,9999,0
1668142003354,ECE 200,009,103594,Franceschetti; Massimo,9999,0,9999,0
1668142003354,ECE 200,010,103595,Fullerton; Eric E,9999,0,9999,0
1668142003354,ECE 200,011,103596,Galton; Ian A,9999,0,9999,0
1668142003354,ECE 200,012,103597,Gilja; Vikash,9999,0,9999,0
1668142003354,ECE 200,013,103598,Hall; Drew A.,9999,0,9999,0
1668142003354,ECE 200,014,103599,Hsueh; Tzu-Chien,9999,0,9999,0
1668142003354,ECE 200,015,103600,Javidi; Tara,9999,0,9999,0
1668142003354,ECE 200,016,103601,Kahng; Andrew Byun,9999,0,9999,0
1668142003354,ECE 200,017,103602,Kim; Young-Han,9999,0,9999,0
1668142003354,ECE 200,018,103603,Koushanfar; Farinaz,9999,0,9999,0
1668142003354,ECE 200,019,103604,Kuzum; Duygu,9999,0,9999,0
1668142003354,ECE 200,020,103605,Le; Hanh-Phuc,9999,0,9999,0
1668142003354,ECE 200,021,103606,Lin; Bill,9999,0,9999,0
1668142003354,ECE 200,022,103607,Liu; Zhaowei,9998,0,9999,1
1668142003354,ECE 200,023,103608,Lo; Yu-Hwa,9999,0,9999,0
1668142003354,ECE 200,024,103609,Lomakin; Vitaliy,9999,0,9999,0
1668142003354,ECE 200,025,103610,Mercier; Patrick Philip,9999,0,9999,0
1668142003354,ECE 200,026,103611,Meyer; Florian,9999,0,9999,0
1668142003354,ECE 200,027,103612,Milstein; Laurence B.,9999,0,9999,0
1668142003354,ECE 200,028,103613,Mir Arabbaygi; Siavash,9999,0,9999,0
1668142003354,ECE 200,029,103614,Mookherjea; Shayan,9999,0,9999,0
1668142003354,ECE 200,030,103615,Morris; Karcher William,9999,0,9999,0
1668142003354,ECE 200,031,103616,Ng; Tse Nga,9999,0,9999,0
1668142003354,ECE 200,032,103617,Nguyen; Truong Quang,9999,0,9999,0
1668142003354,ECE 200,033,103618,Nomura; Kenji,9999,0,9999,0
1668142003354,ECE 200,034,103619,Orlitsky; Alon,9999,0,9999,0
1668142003354,ECE 200,035,103620,Pal; Piya,9999,0,9999,0
1668142003354,ECE 200,036,103621,Papen; George C.,9999,0,9999,0
1668142003354,ECE 200,037,103622,Radic; Stojan,9999,0,9999,0
1668142003354,ECE 200,038,103623,Rao; Bhaskar D.,9999,0,9999,0
1668142003354,ECE 200,039,103624,Rao; Ramesh R,9999,0,9999,0
1668142003354,ECE 200,040,103625,Rebeiz; Gabriel,9999,0,9999,0
1668142003354,ECE 200,041,103626,Sanford; John R,9999,0,9999,0
1668142003354,ECE 200,042,103627,Siegel; Paul H.,9999,0,9999,0
1668142003354,ECE 200,043,103628,Sievenpiper; Daniel F.,9999,0,9999,0
1668142003354,ECE 200,044,103629,Sworder; David D.,9999,0,9999,0
1668142003354,ECE 200,045,103630,Taur; Yuan,9999,0,9999,0
1668142003354,ECE 200,046,103631,Touri; Behrouz,9999,0,9999,0
1668142003354,ECE 200,047,103632,Trivedi; Mohan M.,9999,0,9999,0
1668142003354,ECE 200,048,103633,Vasconcelos; Nuno,9999,0,9999,0
1668142003354,ECE 200,049,103634,Wang; Xiaolong,9999,0,9999,0
1668142003354,ECE 200,050,103635,Xie; Pengtao,9999,0,9999,0
1668142003354,ECE 200,051,103636,Yip; Michael,9999,0,9999,0
1668142003354,ECE 200,052,103637,Zeger; Kenneth A.,999,0,999,0
1668142003354,ECE 200,053,103638,Zhang; Xinyu,9999,0,9999,0
1668142003354,ECE 200,054,103639,Turakhia; Yatish Girish,9999,0,9999,0
1668142003354,ECE 200,055,103640,Kang; Mingu,9999,0,9999,0
1668142003354,ECE 200,056,103641,Shi; Yuanyuan,9999,0,9999,0
1668142003354,ECE 200,057,103642,Wang; Edward Jay,9999,0,9999,0
1668142003354,ECE 200,058,103643,Zheng; Yang,9999,0,9999,0
1668142003790,ECE 202,A00,103644,Kuzum; Duygu,0,0,0,0
1668142004227,ECE 212BN,A00,103646,Ng; Tse Nga,0,0,0,0
1668142004669,ECE 221,A00,111493,Staff,0,0,0,0
1668142005092,ECE 222B,A00,103647,Lomakin; Vitaliy,0,0,0,0
1668142005523,ECE 230B,A00,103648,Taur; Yuan,0,0,0,0
1668142005953,ECE 238B,A00,103649,Garay; Javier,0,0,0,0
1668142006376,ECE 240B,A00,112900,Fainman; Yeshaiahu,0,0,0,0
1668142006818,ECE 247A,A00,103650,Jokerst; Jesse Vincent,0,0,0,0
1668142007240,ECE 247B,A00,103651,Wang; Joseph,0,0,0,0
1668142007671,ECE 250,A00,103652,Siegel; Paul H.,0,0,0,0
1668142008105,ECE 251A,A00,103654,Rao; Bhaskar D.,0,0,0,0
1668142008537,ECE 257B,A00,103655,Bharadia; Dinesh,0,0,0,0
1668142008959,ECE 258A,A00,103656,Milstein; Laurence B.,0,0,0,0
1668142009385,ECE 260B,A00,103658,Kang; Mingu,0,0,0,0
1668142009825,ECE 264A,A00,103659,Galton; Ian A,0,0,0,0
1668142010247,ECE 265A,A00,103661,Gudem; Prasad S.S.,0,0,0,0
1668142010689,ECE 265D,A00,103662,Gudem; Prasad S.S.,0,0,0,0
1668142011137,ECE 268,A00,103663,Koushanfar; Farinaz,0,0,0,0
1668142011575,ECE 269,A01,103665,Pal; Piya,0,0,0,0
1668142011999,ECE 271B,A00,103666,Vasconcelos; Manuela,0,0,0,0
1668142012427,ECE 276A,A00,103667,Atanasov; Nikolay A.,0,0,0,0
1668142012885,ECE 277,A00,103668,An; Cheolhong,0,0,0,0
1668142013317,ECE 279,A00,117947,Hall; Drew A.,0,0,0,0
1668142014181,ECE 283,A00,103670,Hsueh; Tzu-Chien,0,0,0,0
1668142014602,ECE 284,A00,103671,Turakhia; Yatish Girish,0,0,0,0
1668142015034,ECE 285,A00,103672,Zheng; Yang,0,0,0,0
1668142015034,ECE 285,B00,103673,Sworder; David D.,0,0,0,0
1668142015462,ECE 287,A00,103676,Javidi; Tara,0,0,0,0
1668142015886,MATH 200B,A00,098023,Salehi Golsefidy; Alireza,12,0,15,3
1668142016308,MATH 202B,A00,098024,Rhoades; Brendon Patrick,9,0,15,6
1668142016737,MATH 203B,A00,098025,Oprea; Dragos N.,10,0,15,5
1668142017183,MATH 204B,A00,098026,Sorensen; Claus M,13,0,15,2
1668142017606,MATH 208,A00,098027,Izadi; Elham,7,0,10,3
1668142018041,MATH 209,A00,098028,Pollack; Aaron,10,0,10,0
1668142018466,MATH 211A,A00,112919,Rogalski; Daniel,9,0,10,1
1668142018888,MATH 211B,A00,112920,Seward; Brandon M.,9,0,10,1
1668142019313,MATH 218,A00,098029,Li; Bo,10,0,10,0
1668142019735,MATH 220B,A00,098030,Novak; Jonathan I,11,0,15,4
1668142020161,MATH 221A,A00,098031,Ebenfelt; Peter F,13,0,15,2
1668142020614,MATH 231B,A00,098032,Zlatos; Andrej,12,0,15,3
1668142021043,MATH 240B,A00,098033,Ni; Lei,9,0,15,6
1668142021469,MATH 243,A00,098034,Jekel; David Andrew,10,0,10,0
1668142021898,MATH 245A,A00,098035,Nie; Jiawang,0,0,15,16
1668142022323,MATH 248,A00,098036,Bejenaru; Ioan,10,0,10,0
1668142022749,MATH 250B,A00,098037,Spolaor; Luca,14,0,15,1
1668142023191,MATH 258,A00,098038,Ni; Lei,10,0,10,0
1668142023617,MATH 264B,A00,098041,Rhoades; Brendon Patrick,9,0,15,6
1668142024062,MATH 268,A00,098042,Buss; Samuel R,10,0,10,0
1668142024496,MATH 269,A00,098043,Rhoades; Brendon Patrick,10,0,10,0
1668142024934,MATH 270B,A00,098044,Li; Bo,10,0,15,5
1668142025365,MATH 272B,A00,098045,Holst; Michael J,13,0,15,2
1668142025793,MATH 273A,A00,098046,Tian; Xiaochuan,10,0,15,5
1668142026237,MATH 275,A01,098048,Tian; Xiaochuan,6,0,10,4
1668142026674,MATH 278A,A00,098049,Holst; Michael J,8,0,10,2
1668142027120,MATH 278B,A00,098050,Cloninger; Alexander,10,0,10,0
1668142027553,MATH 278C,A00,098051,Nie; Jiawang,7,0,10,3
1668142027976,MATH 280B,A00,098052,Zheng; Tianyi,10,0,15,5
1668142028410,MATH 281B,A00,098053,Bradic; Jelena,2,0,15,13
1668142028838,MATH 282B,A00,098054,Arias-Castro; Ery,0,0,15,15
1668142029291,MATH 285,A00,098055,Fitzsimmons; Patrick J,0,0,15,17
1668142029734,MATH 287B,A00,098056,Arias-Castro; Ery,2,0,15,13
1668142030163,MATH 288,A00,098057,Agarwal; Pooja,9,0,10,1
1668142030163,MATH 288,B00,098058,Zhang; Danna,8,0,10,2
1668142030163,MATH 288,C00,098059,Williams; Ruth J,10,0,10,0
1668142030586,MATH 290B,A00,098060,Roberts; Justin Deritter,13,0,15,2
1668142031032,MATH 292,A00,098061,Belmont; Eva Kinoshita,10,0,10,0
1668142031462,MATH 295,A00,098062,Suk; Andrew Hoon,48,0,50,2
1668142031886,MATH 296,A00,098063,Novak; Jonathan I,20,0,20,0
1668142032330,MATH 297,001,098064,Gamst; Anthony Collins,9997,0,9999,2
1668142539264,COGS 205,A00,101395,Chiba; Andrea,19,0,20,1
1668142539698,COGS 210B,001,101404,Greene; Deanna Jacquelyn,9998,0,9999,1
1668142539698,COGS 210B,002,101417,Xia; Haijun,9999,0,9999,0
1668142539698,COGS 210B,003,101422,Nitz; Douglas A.,9999,0,9999,0
1668142539698,COGS 210B,004,101423,Hollan; James D.,9998,0,9999,1
1668142539698,COGS 210B,005,101424,Deak; Gedeon O.,9998,0,9999,1
1668142539698,COGS 210B,006,101425,Rossano; Federico,9999,0,9999,0
1668142540122,COGS 211B,A00,101427,Coulson; Seana M,9996,0,9999,3
1668142540562,COGS 220,A00,101428,Hollan; James D.,0,0,25,25
1668142540987,COGS 229,A00,101429,Dow; Steven P,18,0,25,7
1668142541409,COGS 230,A00,101430,Klemmer; Scott R,12,0,17,5
1668142541850,COGS 234,A00,101431,Xia; Haijun,3,0,25,22
1668142542285,COGS 260,A00,101432,Kiyonaga; Anastasia,20,0,25,5
1668142542285,COGS 260,B00,101433,Kirsh; David Joel,16,0,25,9
1668142542719,CSE 202,A00,102371,Impagliazzo; Russell,0,0,0,0
1668142543166,CSE 203B,A01,102373,Cheng; Chung Kuan,0,0,0,0
1668142543596,CSE 208,A00,102374,Micciancio; Daniele,0,0,0,0
1668142544022,CSE 209A,A00,112895,Impagliazzo; Russell,0,0,15,15
1668142544472,CSE 209B,A00,108005,Bellare; Mihir,0,0,0,0
1668142544905,CSE 210,A00,113163,Coblenz; Michael J,0,0,0,0
1668142545328,CSE 219,A00,106111,Dow; Steven P,0,0,20,20
1668142545750,CSE 221,A00,102376,Voelker; Geoffrey M.,0,0,0,0
1668142546174,CSE 224,A01,102378,Porter; George M,0,0,0,0
1668142546604,CSE 229A,A00,102379,Savage; Stefan,0,0,0,0
1668142547046,CSE 229C,A00,102380,Munyaka; Imani N. S.,0,0,0,0
1668142547472,CSE 232B,A00,102382,Deutsch; Alin Bernard,0,0,0,0
1668142547896,CSE 234,A01,112904,Kumar; Arun Kumar,0,0,0,0
1668142548329,CSE 237A,A00,102383,Rosing; Tajana Simunic,0,0,0,0
1668142548772,CSE 239A,A00,102384,Deutsch; Alin Bernard,0,0,0,0
1668142549200,CSE 239B,A00,102385,Polikarpova; Nadezhda,0,0,0,0
1668142549636,CSE 240A,A00,102386,Pannuto; Patrick William,0,0,0,0
1668142550062,CSE 240B,A00,102387,Zhao; Jishen,0,0,0,0
1668142550500,CSE 241A,A00,106406,Kang; Mingu,0,0,0,0
1668142550924,CSE 249B,A00,102388,Kahng; Andrew Byun,0,0,8,8
1668142551346,CSE 251B,A01,102392,Cottrell; Garrison W,0,0,0,0
1668142551346,CSE 251B,A02,102393,Cottrell; Garrison W,0,0,0,0
1668142551780,CSE 252B,A00,102394,Ochoa; Benjamin Lawrence,0,0,0,0
1668142552203,CSE 257,A01,102396,Gao; Sicun,0,0,0,0
1668142552626,CSE 272,A00,102397,Li; Tzumao,0,0,0,0
1668142553051,CSE 274,A00,111323,Chern; Albert Ren-Haur,0,0,0,0
1668142553490,CSE 282,A00,102398,Pevzner; Pavel Arkadjevich,0,0,0,0
1668142553913,CSE 284,A00,114175,Gymrek; Melissa Ann,0,0,0,0
1668142554368,CSE 290,A00,102399,Chandraker; Manmohan Krishna,0,0,0,0
1668142554368,CSE 290,B00,102400,Vaccaro; Kristen Marie,0,0,25,25
1668142554368,CSE 290,C00,102414,Pannuto; Patrick William,0,0,25,25
1668142554368,CSE 290,D00,102427,Pevzner; Pavel Arkadjevich,0,0,0,0
1668142554368,CSE 290,E00,102429,Zhao; Jishen,0,0,0,0
1668142554368,CSE 290,F00,102436,Tullsen; Dean Michael,0,0,0,0
1668142554368,CSE 290,G00,102440,Christensen; Henrik I,0,0,20,20
1668142554805,CSE 291,A00,102443,Su; Hao,0,0,0,0
1668142554805,CSE 291,B00,102448,Polikarpova; Nadezhda,0,0,0,0
1668142554805,CSE 291,C00,102453,Vaccaro; Kristen Marie,0,0,0,0
1668142554805,CSE 291,D00,111343,Savage; Stefan,0,0,0,0
1668142554805,CSE 291,E00,116474,Claffy; Kimberly Claire,0,0,0,0
1668142554805,CSE 291,F00,116479,Pasquale; Joseph,0,0,0,0
1668142555234,CSE 293,001,119111,Bafna; Vineet,9999,0,9999,0
1668142555234,CSE 293,002,119118,Bellare; Mihir,9999,0,9999,0
1668142555234,CSE 293,003,119122,Berg-Kirkpatrick; Taylor D,9999,0,9999,0
1668142555234,CSE 293,004,119135,Christensen; Henrik I,9999,0,9999,0
1668142555234,CSE 293,005,119142,Cottrell; Garrison W,9999,0,9999,0
1668142555234,CSE 293,006,119146,Deutsch; Alin Bernard,9999,0,9999,0
1668142555234,CSE 293,007,119159,Esmaeilzadeh; Hadi,9999,0,9999,0
1668142555234,CSE 293,008,119166,Freund; Yoav,9999,0,9999,0
1668142555234,CSE 293,009,119170,Griswold; William G.,9999,0,9999,0
1668142555234,CSE 293,010,119183,Gymrek; Melissa Ann,9999,0,9999,0
1668142555234,CSE 293,011,119190,Heninger; Nadia A,9999,0,9999,0
1668142555234,CSE 293,012,119230,Impagliazzo; Russell,9999,0,9999,0
1668142555234,CSE 293,013,119232,Jhala; Ranjit,9999,0,9999,0
1668142555234,CSE 293,014,119233,Kahng; Andrew Byun,9999,0,9999,0
1668142555234,CSE 293,015,119298,Kane; Daniel Mertz,9999,0,9999,0
1668142555234,CSE 293,016,119299,Kriegman; David J,9999,0,9999,0
1668142555234,CSE 293,017,119300,Kumar; Arun Kumar,9999,0,9999,0
1668142555234,CSE 293,018,119301,Lerner; Sorin,9999,0,9999,0
1668142555234,CSE 293,019,119302,Lovett; Shachar,9999,0,9999,0
1668142555234,CSE 293,020,119303,McAuley; Julian John,9999,0,9999,0
1668142555234,CSE 293,021,119304,Micciancio; Daniele,9999,0,9999,0
1668142555234,CSE 293,022,119367,Orailoglu; Alex,9999,0,9999,0
1668142555234,CSE 293,023,119382,Paturi; Ramamohan,9999,0,9999,0
1668142555234,CSE 293,024,119404,Polikarpova; Nadezhda,9999,0,9999,0
1668142555234,CSE 293,025,119406,Politz; Joseph Gibbs,9999,0,9999,0
1668142555234,CSE 293,026,119411,Porter; George M,9999,0,9999,0
1668142555234,CSE 293,027,119414,Porter; Leonard Emerson,9999,0,9999,0
1668142555234,CSE 293,028,119416,Ramamoorthi; Ravi,9999,0,9999,0
1668142555234,CSE 293,029,119417,Sahoo; Debashis,9999,0,9999,0
1668142555234,CSE 293,030,119420,Saul; Lawrence,9999,0,9999,0
1668142555234,CSE 293,031,119421,Savage; Stefan,9999,0,9999,0
1668142555234,CSE 293,032,119425,Schulze; Jurgen P.,9999,0,9999,0
1668142555234,CSE 293,033,119426,Snoeren; Alex C.,9999,0,9999,0
1668142555234,CSE 293,034,119428,Shang; Jingbo,9999,0,9999,0
1668142555234,CSE 293,035,119430,Stefan; Deian,9999,0,9999,0
1668142555234,CSE 293,036,119431,Su; Hao,9999,0,9999,0
1668142555234,CSE 293,037,119433,Swanson; Steven James,9999,0,9999,0
1668142555234,CSE 293,038,119435,Tullsen; Dean Michael,9999,0,9999,0
1668142555234,CSE 293,039,119483,Voelker; Geoffrey M.,9999,0,9999,0
1668142555234,CSE 293,040,119537,Zhao; Jishen,9999,0,9999,0
1668142555234,CSE 293,041,119538,Zhou; Yuan-Yuan,9999,0,9999,0
1668142555234,CSE 293,042,119539,Gao; Sicun,9999,0,9999,0
1668142555234,CSE 293,043,119540,Weibel; Nadir,9999,0,9999,0
1668142555234,CSE 293,044,119541,Gupta; Rajesh K.,9999,0,9999,0
1668142555234,CSE 293,045,126410,Vaccaro; Kristen Marie,9999,0,9999,0
1668142555234,CSE 293,046,126411,Klemke; Richard,9999,0,9999,0
1668142555660,CSE 294,A00,102459,Voelker; Geoffrey M.,0,0,0,0
1668142555660,CSE 294,B00,111322,Orailoglu; Alex,0,0,0,0
1668142556114,DSE 201,A00,096914,Deutsch; Alin Bernard,30,0,30,0
1668142556547,DSE 210,A00,096915,Dasgupta; Sanjoy,30,0,30,0
1668142556976,DSE 260A,A00,096916,Altintas De Callaf; Ilkay,30,0,30,0
1668142557417,ECE 200,001,103586,Antipa; Nicholas A,9999,0,9999,0
1668142557417,ECE 200,002,103587,Atanasov; Nikolay A.,9999,0,9999,0
1668142557417,ECE 200,003,103588,Bharadia; Dinesh,9999,0,9999,0
1668142557417,ECE 200,004,103589,Cheng; Chung Kuan,9999,0,9999,0
1668142557417,ECE 200,005,103590,Cosman; Pamela C.,9999,0,9999,0
1668142557417,ECE 200,006,103591,Dayeh; Shadi Ahmad,9999,0,9999,0
1668142557417,ECE 200,007,103592,Fainman; Yeshaiahu,9999,0,9999,0
1668142557417,ECE 200,008,103593,Ford; Joseph Earl,9999,0,9999,0
1668142557417,ECE 200,009,103594,Franceschetti; Massimo,9999,0,9999,0
1668142557417,ECE 200,010,103595,Fullerton; Eric E,9999,0,9999,0
1668142557417,ECE 200,011,103596,Galton; Ian A,9999,0,9999,0
1668142557417,ECE 200,012,103597,Gilja; Vikash,9999,0,9999,0
1668142557417,ECE 200,013,103598,Hall; Drew A.,9999,0,9999,0
1668142557417,ECE 200,014,103599,Hsueh; Tzu-Chien,9999,0,9999,0
1668142557417,ECE 200,015,103600,Javidi; Tara,9999,0,9999,0
1668142557417,ECE 200,016,103601,Kahng; Andrew Byun,9999,0,9999,0
1668142557417,ECE 200,017,103602,Kim; Young-Han,9999,0,9999,0
1668142557417,ECE 200,018,103603,Koushanfar; Farinaz,9999,0,9999,0
1668142557417,ECE 200,019,103604,Kuzum; Duygu,9999,0,9999,0
1668142557417,ECE 200,020,103605,Le; Hanh-Phuc,9999,0,9999,0
1668142557417,ECE 200,021,103606,Lin; Bill,9999,0,9999,0
1668142557417,ECE 200,022,103607,Liu; Zhaowei,9998,0,9999,1
1668142557417,ECE 200,023,103608,Lo; Yu-Hwa,9999,0,9999,0
1668142557417,ECE 200,024,103609,Lomakin; Vitaliy,9999,0,9999,0
1668142557417,ECE 200,025,103610,Mercier; Patrick Philip,9999,0,9999,0
1668142557417,ECE 200,026,103611,Meyer; Florian,9999,0,9999,0
1668142557417,ECE 200,027,103612,Milstein; Laurence B.,9999,0,9999,0
1668142557417,ECE 200,028,103613,Mir Arabbaygi; Siavash,9999,0,9999,0
1668142557417,ECE 200,029,103614,Mookherjea; Shayan,9999,0,9999,0
1668142557417,ECE 200,030,103615,Morris; Karcher William,9999,0,9999,0
1668142557417,ECE 200,031,103616,Ng; Tse Nga,9999,0,9999,0
1668142557417,ECE 200,032,103617,Nguyen; Truong Quang,9999,0,9999,0
1668142557417,ECE 200,033,103618,Nomura; Kenji,9999,0,9999,0
1668142557417,ECE 200,034,103619,Orlitsky; Alon,9999,0,9999,0
1668142557417,ECE 200,035,103620,Pal; Piya,9999,0,9999,0
1668142557417,ECE 200,036,103621,Papen; George C.,9999,0,9999,0
1668142557417,ECE 200,037,103622,Radic; Stojan,9999,0,9999,0
1668142557417,ECE 200,038,103623,Rao; Bhaskar D.,9999,0,9999,0
1668142557417,ECE 200,039,103624,Rao; Ramesh R,9999,0,9999,0
1668142557417,ECE 200,040,103625,Rebeiz; Gabriel,9999,0,9999,0
1668142557417,ECE 200,041,103626,Sanford; John R,9999,0,9999,0
1668142557417,ECE 200,042,103627,Siegel; Paul H.,9999,0,9999,0
1668142557417,ECE 200,043,103628,Sievenpiper; Daniel F.,9999,0,9999,0
1668142557417,ECE 200,044,103629,Sworder; David D.,9999,0,9999,0
1668142557417,ECE 200,045,103630,Taur; Yuan,9999,0,9999,0
1668142557417,ECE 200,046,103631,Touri; Behrouz,9999,0,9999,0
1668142557417,ECE 200,047,103632,Trivedi; Mohan M.,9999,0,9999,0
1668142557417,ECE 200,048,103633,Vasconcelos; Nuno,9999,0,9999,0
1668142557417,ECE 200,049,103634,Wang; Xiaolong,9999,0,9999,0
1668142557417,ECE 200,050,103635,Xie; Pengtao,9999,0,9999,0
1668142557417,ECE 200,051,103636,Yip; Michael,9999,0,9999,0
1668142557417,ECE 200,052,103637,Zeger; Kenneth A.,999,0,999,0
1668142557417,ECE 200,053,103638,Zhang; Xinyu,9999,0,9999,0
1668142557417,ECE 200,054,103639,Turakhia; Yatish Girish,9999,0,9999,0
1668142557417,ECE 200,055,103640,Kang; Mingu,9999,0,9999,0
1668142557417,ECE 200,056,103641,Shi; Yuanyuan,9999,0,9999,0
1668142557417,ECE 200,057,103642,Wang; Edward Jay,9999,0,9999,0
1668142557417,ECE 200,058,103643,Zheng; Yang,9999,0,9999,0
1668142557842,ECE 202,A00,103644,Kuzum; Duygu,0,0,0,0
1668142558276,ECE 212BN,A00,103646,Ng; Tse Nga,0,0,0,0
1668142558715,ECE 221,A00,111493,Staff,0,0,0,0
1668142559156,ECE 222B,A00,103647,Lomakin; Vitaliy,0,0,0,0
1668142559578,ECE 230B,A00,103648,Taur; Yuan,0,0,0,0
1668142560006,ECE 238B,A00,103649,Garay; Javier,0,0,0,0
1668142560437,ECE 240B,A00,112900,Fainman; Yeshaiahu,0,0,0,0
1668142560873,ECE 247A,A00,103650,Jokerst; Jesse Vincent,0,0,0,0
1668142561318,ECE 247B,A00,103651,Wang; Joseph,0,0,0,0
1668142561765,ECE 250,A00,103652,Siegel; Paul H.,0,0,0,0
1668142562195,ECE 251A,A00,103654,Rao; Bhaskar D.,0,0,0,0
1668142562619,ECE 257B,A00,103655,Bharadia; Dinesh,0,0,0,0
1668142563054,ECE 258A,A00,103656,Milstein; Laurence B.,0,0,0,0
1668142563480,ECE 260B,A00,103658,Kang; Mingu,0,0,0,0
1668142563930,ECE 264A,A00,103659,Galton; Ian A,0,0,0,0
1668142564365,ECE 265A,A00,103661,Gudem; Prasad S.S.,0,0,0,0
1668142564787,ECE 265D,A00,103662,Gudem; Prasad S.S.,0,0,0,0
1668142565214,ECE 268,A00,103663,Koushanfar; Farinaz,0,0,0,0
1668142565644,ECE 269,A01,103665,Pal; Piya,0,0,0,0
1668142566068,ECE 271B,A00,103666,Vasconcelos; Manuela,0,0,0,0
1668142566490,ECE 276A,A00,103667,Atanasov; Nikolay A.,0,0,0,0
1668142566922,ECE 277,A00,103668,An; Cheolhong,0,0,0,0
1668142567350,ECE 279,A00,117947,Hall; Drew A.,0,0,0,0
1668142568206,ECE 283,A00,103670,Hsueh; Tzu-Chien,0,0,0,0
1668142568644,ECE 284,A00,103671,Turakhia; Yatish Girish,0,0,0,0
1668142569079,ECE 285,A00,103672,Zheng; Yang,0,0,0,0
1668142569079,ECE 285,B00,103673,Sworder; David D.,0,0,0,0
1668142569514,ECE 287,A00,103676,Javidi; Tara,0,0,0,0
1668142569952,MATH 200B,A00,098023,Salehi Golsefidy; Alireza,12,0,15,3
1668142570386,MATH 202B,A00,098024,Rhoades; Brendon Patrick,9,0,15,6
1668142570816,MATH 203B,A00,098025,Oprea; Dragos N.,10,0,15,5
1668142571248,MATH 204B,A00,098026,Sorensen; Claus M,13,0,15,2
1668142571699,MATH 208,A00,098027,Izadi; Elham,7,0,10,3
1668142572126,MATH 209,A00,098028,Pollack; Aaron,10,0,10,0
1668142572682,MATH 211A,A00,112919,Rogalski; Daniel,9,0,10,1
1668142573121,MATH 211B,A00,112920,Seward; Brandon M.,9,0,10,1
1668142573545,MATH 218,A00,098029,Li; Bo,10,0,10,0
1668142573971,MATH 220B,A00,098030,Novak; Jonathan I,11,0,15,4
1668142574411,MATH 221A,A00,098031,Ebenfelt; Peter F,13,0,15,2
1668142574845,MATH 231B,A00,098032,Zlatos; Andrej,12,0,15,3
1668142575301,MATH 240B,A00,098033,Ni; Lei,9,0,15,6
1668142575725,MATH 243,A00,098034,Jekel; David Andrew,10,0,10,0
1668142576154,MATH 245A,A00,098035,Nie; Jiawang,0,0,15,16
1668142576589,MATH 248,A00,098036,Bejenaru; Ioan,10,0,10,0
1668142577013,MATH 250B,A00,098037,Spolaor; Luca,14,0,15,1
1668142577466,MATH 258,A00,098038,Ni; Lei,10,0,10,0
1668142577912,MATH 264B,A00,098041,Rhoades; Brendon Patrick,9,0,15,6
1668142578369,MATH 268,A00,098042,Buss; Samuel R,10,0,10,0
1668142578806,MATH 269,A00,098043,Rhoades; Brendon Patrick,10,0,10,0
1668142579235,MATH 270B,A00,098044,Li; Bo,10,0,15,5
1668142579659,MATH 272B,A00,098045,Holst; Michael J,13,0,15,2
1668142580095,MATH 273A,A00,098046,Tian; Xiaochuan,10,0,15,5
1668142580526,MATH 275,A01,098048,Tian; Xiaochuan,6,0,10,4
1668142580962,MATH 278A,A00,098049,Holst; Michael J,8,0,10,2
1668142581385,MATH 278B,A00,098050,Cloninger; Alexander,10,0,10,0
1668142581833,MATH 278C,A00,098051,Nie; Jiawang,7,0,10,3
1668142582268,MATH 280B,A00,098052,Zheng; Tianyi,10,0,15,5
1668142582692,MATH 281B,A00,098053,Bradic; Jelena,2,0,15,13
1668142583116,MATH 282B,A00,098054,Arias-Castro; Ery,0,0,15,15
1668142583547,MATH 285,A00,098055,Fitzsimmons; Patrick J,0,0,15,17
1668142583973,MATH 287B,A00,098056,Arias-Castro; Ery,2,0,15,13
1668142584400,MATH 288,A00,098057,Agarwal; Pooja,9,0,10,1
1668142584400,MATH 288,B00,098058,Zhang; Danna,8,0,10,2
1668142584400,MATH 288,C00,098059,Williams; Ruth J,10,0,10,0
1668142584824,MATH 290B,A00,098060,Roberts; Justin Deritter,13,0,15,2
1668142585248,MATH 292,A00,098061,Belmont; Eva Kinoshita,10,0,10,0
1668142585690,MATH 295,A00,098062,Suk; Andrew Hoon,48,0,50,2
1668142586122,MATH 296,A00,098063,Novak; Jonathan I,20,0,20,0
1668142586546,MATH 297,001,098064,Gamst; Anthony Collins,9997,0,9999,2
1668143093720,COGS 205,A00,101395,Chiba; Andrea,19,0,20,1
1668143094145,COGS 210B,001,101404,Greene; Deanna Jacquelyn,9998,0,9999,1
1668143094145,COGS 210B,002,101417,Xia; Haijun,9999,0,9999,0
1668143094145,COGS 210B,003,101422,Nitz; Douglas A.,9999,0,9999,0
1668143094145,COGS 210B,004,101423,Hollan; James D.,9998,0,9999,1
1668143094145,COGS 210B,005,101424,Deak; Gedeon O.,9998,0,9999,1
1668143094145,COGS 210B,006,101425,Rossano; Federico,9999,0,9999,0
1668143094583,COGS 211B,A00,101427,Coulson; Seana M,9996,0,9999,3
1668143095017,COGS 220,A00,101428,Hollan; James D.,0,0,25,25
1668143095446,COGS 229,A00,101429,Dow; Steven P,18,0,25,7
1668143095881,COGS 230,A00,101430,Klemmer; Scott R,12,0,17,5
1668143096319,COGS 234,A00,101431,Xia; Haijun,3,0,25,22
1668143096766,COGS 260,A00,101432,Kiyonaga; Anastasia,20,0,25,5
1668143096766,COGS 260,B00,101433,Kirsh; David Joel,16,0,25,9
1668143097210,CSE 202,A00,102371,Impagliazzo; Russell,0,0,0,0
1668143097659,CSE 203B,A01,102373,Cheng; Chung Kuan,0,0,0,0
1668143098084,CSE 208,A00,102374,Micciancio; Daniele,0,0,0,0
1668143098507,CSE 209A,A00,112895,Impagliazzo; Russell,0,0,15,15
1668143098936,CSE 209B,A00,108005,Bellare; Mihir,0,0,0,0
1668143099365,CSE 210,A00,113163,Coblenz; Michael J,0,0,0,0
1668143099801,CSE 219,A00,106111,Dow; Steven P,0,0,20,20
1668143100356,CSE 221,A00,102376,Voelker; Geoffrey M.,0,0,0,0
1668143100801,CSE 224,A01,102378,Porter; George M,0,0,0,0
1668143101226,CSE 229A,A00,102379,Savage; Stefan,0,0,0,0
1668143101651,CSE 229C,A00,102380,Munyaka; Imani N. S.,0,0,0,0
1668143102074,CSE 232B,A00,102382,Deutsch; Alin Bernard,0,0,0,0
1668143102508,CSE 234,A01,112904,Kumar; Arun Kumar,0,0,0,0
1668143102949,CSE 237A,A00,102383,Rosing; Tajana Simunic,0,0,0,0
1668143103372,CSE 239A,A00,102384,Deutsch; Alin Bernard,0,0,0,0
1668143103796,CSE 239B,A00,102385,Polikarpova; Nadezhda,0,0,0,0
1668143104222,CSE 240A,A00,102386,Pannuto; Patrick William,0,0,0,0
1668143104658,CSE 240B,A00,102387,Zhao; Jishen,0,0,0,0
1668143105094,CSE 241A,A00,106406,Kang; Mingu,0,0,0,0
1668143105530,CSE 249B,A00,102388,Kahng; Andrew Byun,0,0,8,8
1668143105978,CSE 251B,A01,102392,Cottrell; Garrison W,0,0,0,0
1668143105978,CSE 251B,A02,102393,Cottrell; Garrison W,0,0,0,0
1668143106404,CSE 252B,A00,102394,Ochoa; Benjamin Lawrence,0,0,0,0
1668143106836,CSE 257,A01,102396,Gao; Sicun,0,0,0,0
1668143107286,CSE 272,A00,102397,Li; Tzumao,0,0,0,0
1668143107727,CSE 274,A00,111323,Chern; Albert Ren-Haur,0,0,0,0
1668143108168,CSE 282,A00,102398,Pevzner; Pavel Arkadjevich,0,0,0,0
1668143108592,CSE 284,A00,114175,Gymrek; Melissa Ann,0,0,0,0
1668143109037,CSE 290,A00,102399,Chandraker; Manmohan Krishna,0,0,0,0
1668143109037,CSE 290,B00,102400,Vaccaro; Kristen Marie,0,0,25,25
1668143109037,CSE 290,C00,102414,Pannuto; Patrick William,0,0,25,25
1668143109037,CSE 290,D00,102427,Pevzner; Pavel Arkadjevich,0,0,0,0
1668143109037,CSE 290,E00,102429,Zhao; Jishen,0,0,0,0
1668143109037,CSE 290,F00,102436,Tullsen; Dean Michael,0,0,0,0
1668143109037,CSE 290,G00,102440,Christensen; Henrik I,0,0,20,20
1668143109479,CSE 291,A00,102443,Su; Hao,0,0,0,0
1668143109479,CSE 291,B00,102448,Polikarpova; Nadezhda,0,0,0,0
1668143109479,CSE 291,C00,102453,Vaccaro; Kristen Marie,0,0,0,0
1668143109479,CSE 291,D00,111343,Savage; Stefan,0,0,0,0
1668143109479,CSE 291,E00,116474,Claffy; Kimberly Claire,0,0,0,0
1668143109479,CSE 291,F00,116479,Pasquale; Joseph,0,0,0,0
1668143109936,CSE 293,001,119111,Bafna; Vineet,9999,0,9999,0
1668143109936,CSE 293,002,119118,Bellare; Mihir,9999,0,9999,0
1668143109936,CSE 293,003,119122,Berg-Kirkpatrick; Taylor D,9999,0,9999,0
1668143109936,CSE 293,004,119135,Christensen; Henrik I,9999,0,9999,0
1668143109936,CSE 293,005,119142,Cottrell; Garrison W,9999,0,9999,0
1668143109936,CSE 293,006,119146,Deutsch; Alin Bernard,9999,0,9999,0
1668143109936,CSE 293,007,119159,Esmaeilzadeh; Hadi,9999,0,9999,0
1668143109936,CSE 293,008,119166,Freund; Yoav,9999,0,9999,0
1668143109936,CSE 293,009,119170,Griswold; William G.,9999,0,9999,0
1668143109936,CSE 293,010,119183,Gymrek; Melissa Ann,9999,0,9999,0
1668143109936,CSE 293,011,119190,Heninger; Nadia A,9999,0,9999,0
1668143109936,CSE 293,012,119230,Impagliazzo; Russell,9999,0,9999,0
1668143109936,CSE 293,013,119232,Jhala; Ranjit,9999,0,9999,0
1668143109936,CSE 293,014,119233,Kahng; Andrew Byun,9999,0,9999,0
1668143109936,CSE 293,015,119298,Kane; Daniel Mertz,9999,0,9999,0
1668143109936,CSE 293,016,119299,Kriegman; David J,9999,0,9999,0
1668143109936,CSE 293,017,119300,Kumar; Arun Kumar,9999,0,9999,0
1668143109936,CSE 293,018,119301,Lerner; Sorin,9999,0,9999,0
1668143109936,CSE 293,019,119302,Lovett; Shachar,9999,0,9999,0
1668143109936,CSE 293,020,119303,McAuley; Julian John,9999,0,9999,0
1668143109936,CSE 293,021,119304,Micciancio; Daniele,9999,0,9999,0
1668143109936,CSE 293,022,119367,Orailoglu; Alex,9999,0,9999,0
1668143109936,CSE 293,023,119382,Paturi; Ramamohan,9999,0,9999,0
1668143109936,CSE 293,024,119404,Polikarpova; Nadezhda,9999,0,9999,0
1668143109936,CSE 293,025,119406,Politz; Joseph Gibbs,9999,0,9999,0
1668143109936,CSE 293,026,119411,Porter; George M,9999,0,9999,0
1668143109936,CSE 293,027,119414,Porter; Leonard Emerson,9999,0,9999,0
1668143109936,CSE 293,028,119416,Ramamoorthi; Ravi,9999,0,9999,0
1668143109936,CSE 293,029,119417,Sahoo; Debashis,9999,0,9999,0
1668143109936,CSE 293,030,119420,Saul; Lawrence,9999,0,9999,0
1668143109936,CSE 293,031,119421,Savage; Stefan,9999,0,9999,0
1668143109936,CSE 293,032,119425,Schulze; Jurgen P.,9999,0,9999,0
1668143109936,CSE 293,033,119426,Snoeren; Alex C.,9999,0,9999,0
1668143109936,CSE 293,034,119428,Shang; Jingbo,9999,0,9999,0
1668143109936,CSE 293,035,119430,Stefan; Deian,9999,0,9999,0
1668143109936,CSE 293,036,119431,Su; Hao,9999,0,9999,0
1668143109936,CSE 293,037,119433,Swanson; Steven James,9999,0,9999,0
1668143109936,CSE 293,038,119435,Tullsen; Dean Michael,9999,0,9999,0
1668143109936,CSE 293,039,119483,Voelker; Geoffrey M.,9999,0,9999,0
1668143109936,CSE 293,040,119537,Zhao; Jishen,9999,0,9999,0
1668143109936,CSE 293,041,119538,Zhou; Yuan-Yuan,9999,0,9999,0
1668143109936,CSE 293,042,119539,Gao; Sicun,9999,0,9999,0
1668143109936,CSE 293,043,119540,Weibel; Nadir,9999,0,9999,0
1668143109936,CSE 293,044,119541,Gupta; Rajesh K.,9999,0,9999,0
1668143109936,CSE 293,045,126410,Vaccaro; Kristen Marie,9999,0,9999,0
1668143109936,CSE 293,046,126411,Klemke; Richard,9999,0,9999,0
1668143110361,CSE 294,A00,102459,Voelker; Geoffrey M.,0,0,0,0
1668143110361,CSE 294,B00,111322,Orailoglu; Alex,0,0,0,0
1668143110790,DSE 201,A00,096914,Deutsch; Alin Bernard,30,0,30,0
1668143111226,DSE 210,A00,096915,Dasgupta; Sanjoy,30,0,30,0
1668143111650,DSE 260A,A00,096916,Altintas De Callaf; Ilkay,30,0,30,0
1668143112163,ECE 200,001,103586,Antipa; Nicholas A,9999,0,9999,0
1668143112163,ECE 200,002,103587,Atanasov; Nikolay A.,9999,0,9999,0
1668143112163,ECE 200,003,103588,Bharadia; Dinesh,9999,0,9999,0
1668143112163,ECE 200,004,103589,Cheng; Chung Kuan,9999,0,9999,0
1668143112163,ECE 200,005,103590,Cosman; Pamela C.,9999,0,9999,0
1668143112163,ECE 200,006,103591,Dayeh; Shadi Ahmad,9999,0,9999,0
1668143112163,ECE 200,007,103592,Fainman; Yeshaiahu,9999,0,9999,0
1668143112163,ECE 200,008,103593,Ford; Joseph Earl,9999,0,9999,0
1668143112163,ECE 200,009,103594,Franceschetti; Massimo,9999,0,9999,0
1668143112163,ECE 200,010,103595,Fullerton; Eric E,9999,0,9999,0
1668143112163,ECE 200,011,103596,Galton; Ian A,9999,0,9999,0
1668143112163,ECE 200,012,103597,Gilja; Vikash,9999,0,9999,0
1668143112163,ECE 200,013,103598,Hall; Drew A.,9999,0,9999,0
1668143112163,ECE 200,014,103599,Hsueh; Tzu-Chien,9999,0,9999,0
1668143112163,ECE 200,015,103600,Javidi; Tara,9999,0,9999,0
1668143112163,ECE 200,016,103601,Kahng; Andrew Byun,9999,0,9999,0
1668143112163,ECE 200,017,103602,Kim; Young-Han,9999,0,9999,0
1668143112163,ECE 200,018,103603,Koushanfar; Farinaz,9999,0,9999,0
1668143112163,ECE 200,019,103604,Kuzum; Duygu,9999,0,9999,0
1668143112163,ECE 200,020,103605,Le; Hanh-Phuc,9999,0,9999,0
1668143112163,ECE 200,021,103606,Lin; Bill,9999,0,9999,0
1668143112163,ECE 200,022,103607,Liu; Zhaowei,9998,0,9999,1
1668143112163,ECE 200,023,103608,Lo; Yu-Hwa,9999,0,9999,0
1668143112163,ECE 200,024,103609,Lomakin; Vitaliy,9999,0,9999,0
1668143112163,ECE 200,025,103610,Mercier; Patrick Philip,9999,0,9999,0
1668143112163,ECE 200,026,103611,Meyer; Florian,9999,0,9999,0
1668143112163,ECE 200,027,103612,Milstein; Laurence B.,9999,0,9999,0
1668143112163,ECE 200,028,103613,Mir Arabbaygi; Siavash,9999,0,9999,0
1668143112163,ECE 200,029,103614,Mookherjea; Shayan,9999,0,9999,0
1668143112163,ECE 200,030,103615,Morris; Karcher William,9999,0,9999,0
1668143112163,ECE 200,031,103616,Ng; Tse Nga,9999,0,9999,0
1668143112163,ECE 200,032,103617,Nguyen; Truong Quang,9999,0,9999,0
1668143112163,ECE 200,033,103618,Nomura; Kenji,9999,0,9999,0
1668143112163,ECE 200,034,103619,Orlitsky; Alon,9999,0,9999,0
1668143112163,ECE 200,035,103620,Pal; Piya,9999,0,9999,0
1668143112163,ECE 200,036,103621,Papen; George C.,9999,0,9999,0
1668143112163,ECE 200,037,103622,Radic; Stojan,9999,0,9999,0
1668143112163,ECE 200,038,103623,Rao; Bhaskar D.,9999,0,9999,0
1668143112163,ECE 200,039,103624,Rao; Ramesh R,9999,0,9999,0
1668143112163,ECE 200,040,103625,Rebeiz; Gabriel,9999,0,9999,0
1668143112163,ECE 200,041,103626,Sanford; John R,9999,0,9999,0
1668143112163,ECE 200,042,103627,Siegel; Paul H.,9999,0,9999,0
1668143112163,ECE 200,043,103628,Sievenpiper; Daniel F.,9999,0,9999,0
1668143112163,ECE 200,044,103629,Sworder; David D.,9999,0,9999,0
1668143112163,ECE 200,045,103630,Taur; Yuan,9999,0,9999,0
1668143112163,ECE 200,046,103631,Touri; Behrouz,9999,0,9999,0
1668143112163,ECE 200,047,103632,Trivedi; Mohan M.,9999,0,9999,0
1668143112163,ECE 200,048,103633,Vasconcelos; Nuno,9999,0,9999,0
1668143112163,ECE 200,049,103634,Wang; Xiaolong,9999,0,9999,0
1668143112163,ECE 200,050,103635,Xie; Pengtao,9999,0,9999,0
1668143112163,ECE 200,051,103636,Yip; Michael,9999,0,9999,0
1668143112163,ECE 200,052,103637,Zeger; Kenneth A.,999,0,999,0
1668143112163,ECE 200,053,103638,Zhang; Xinyu,9999,0,9999,0
1668143112163,ECE 200,054,103639,Turakhia; Yatish Girish,9999,0,9999,0
1668143112163,ECE 200,055,103640,Kang; Mingu,9999,0,9999,0
1668143112163,ECE 200,056,103641,Shi; Yuanyuan,9999,0,9999,0
1668143112163,ECE 200,057,103642,Wang; Edward Jay,9999,0,9999,0
1668143112163,ECE 200,058,103643,Zheng; Yang,9999,0,9999,0
1668143112608,ECE 202,A00,103644,Kuzum; Duygu,0,0,0,0
1668143113043,ECE 212BN,A00,103646,Ng; Tse Nga,0,0,0,0
1668143113465,ECE 221,A00,111493,Staff,0,0,0,0
1668143113899,ECE 222B,A00,103647,Lomakin; Vitaliy,0,0,0,0
1668143114338,ECE 230B,A00,103648,Taur; Yuan,0,0,0,0
1668143114783,ECE 238B,A00,103649,Garay; Javier,0,0,0,0
1668143115206,ECE 240B,A00,112900,Fainman; Yeshaiahu,0,0,0,0
1668143115629,ECE 247A,A00,103650,Jokerst; Jesse Vincent,0,0,0,0
1668143116064,ECE 247B,A00,103651,Wang; Joseph,0,0,0,0
1668143116517,ECE 250,A00,103652,Siegel; Paul H.,0,0,0,0
1668143116955,ECE 251A,A00,103654,Rao; Bhaskar D.,0,0,0,0
1668143117379,ECE 257B,A00,103655,Bharadia; Dinesh,0,0,0,0
1668143117809,ECE 258A,A00,103656,Milstein; Laurence B.,0,0,0,0
1668143118233,ECE 260B,A00,103658,Kang; Mingu,0,0,0,0
1668143118658,ECE 264A,A00,103659,Galton; Ian A,0,0,0,0
1668143119087,ECE 265A,A00,103661,Gudem; Prasad S.S.,0,0,0,0
1668143119535,ECE 265D,A00,103662,Gudem; Prasad S.S.,0,0,0,0
1668143119966,ECE 268,A00,103663,Koushanfar; Farinaz,0,0,0,0
1668143120400,ECE 269,A01,103665,Pal; Piya,0,0,0,0
1668143120821,ECE 271B,A00,103666,Vasconcelos; Manuela,0,0,0,0
1668143121249,ECE 276A,A00,103667,Atanasov; Nikolay A.,0,0,0,0
1668143121688,ECE 277,A00,103668,An; Cheolhong,0,0,0,0
1668143122116,ECE 279,A00,117947,Hall; Drew A.,0,0,0,0
1668143122962,ECE 283,A00,103670,Hsueh; Tzu-Chien,0,0,0,0
1668143123399,ECE 284,A00,103671,Turakhia; Yatish Girish,0,0,0,0
1668143123827,ECE 285,A00,103672,Zheng; Yang,0,0,0,0
1668143123827,ECE 285,B00,103673,Sworder; David D.,0,0,0,0
1668143124276,ECE 287,A00,103676,Javidi; Tara,0,0,0,0
1668143124733,MATH 200B,A00,098023,Salehi Golsefidy; Alireza,12,0,15,3
1668143125157,MATH 202B,A00,098024,Rhoades; Brendon Patrick,9,0,15,6
1668143125584,MATH 203B,A00,098025,Oprea; Dragos N.,10,0,15,5
1668143126012,MATH 204B,A00,098026,Sorensen; Claus M,13,0,15,2
1668143126439,MATH 208,A00,098027,Izadi; Elham,7,0,10,3
1668143126868,MATH 209,A00,098028,Pollack; Aaron,10,0,10,0
1668143127307,MATH 211A,A00,112919,Rogalski; Daniel,9,0,10,1
1668143127731,MATH 211B,A00,112920,Seward; Brandon M.,9,0,10,1
1668143128153,MATH 218,A00,098029,Li; Bo,10,0,10,0
1668143128578,MATH 220B,A00,098030,Novak; Jonathan I,11,0,15,4
1668143129033,MATH 221A,A00,098031,Ebenfelt; Peter F,13,0,15,2
1668143129468,MATH 231B,A00,098032,Zlatos; Andrej,12,0,15,3
1668143129930,MATH 240B,A00,098033,Ni; Lei,9,0,15,6
1668143130353,MATH 243,A00,098034,Jekel; David Andrew,10,0,10,0
1668143130776,MATH 245A,A00,098035,Nie; Jiawang,0,0,15,16
1668143131201,MATH 248,A00,098036,Bejenaru; Ioan,10,0,10,0
1668143131634,MATH 250B,A00,098037,Spolaor; Luca,14,0,15,1
1668143132069,MATH 258,A00,098038,Ni; Lei,10,0,10,0
1668143132498,MATH 264B,A00,098041,Rhoades; Brendon Patrick,9,0,15,6
1668143132922,MATH 268,A00,098042,Buss; Samuel R,10,0,10,0
1668143133343,MATH 269,A00,098043,Rhoades; Brendon Patrick,10,0,10,0
1668143133767,MATH 270B,A00,098044,Li; Bo,10,0,15,5
1668143134198,MATH 272B,A00,098045,Holst; Michael J,13,0,15,2
1668143134644,MATH 273A,A00,098046,Tian; Xiaochuan,10,0,15,5
1668143135079,MATH 275,A01,098048,Tian; Xiaochuan,6,0,10,4
1668143135521,MATH 278A,A00,098049,Holst; Michael J,8,0,10,2
1668143135944,MATH 278B,A00,098050,Cloninger; Alexander,10,0,10,0
1668143136375,MATH 278C,A00,098051,Nie; Jiawang,7,0,10,3
1668143136798,MATH 280B,A00,098052,Zheng; Tianyi,10,0,15,5
1668143137235,MATH 281B,A00,098053,Bradic; Jelena,2,0,15,13
1668143137660,MATH 282B,A00,098054,Arias-Castro; Ery,0,0,15,15
1668143138084,MATH 285,A00,098055,Fitzsimmons; Patrick J,0,0,15,17
1668143138511,MATH 287B,A00,098056,Arias-Castro; Ery,2,0,15,13
1668143138937,MATH 288,A00,098057,Agarwal; Pooja,9,0,10,1
1668143138937,MATH 288,B00,098058,Zhang; Danna,8,0,10,2
1668143138937,MATH 288,C00,098059,Williams; Ruth J,10,0,10,0
1668143139360,MATH 290B,A00,098060,Roberts; Justin Deritter,13,0,15,2
1668143139798,MATH 292,A00,098061,Belmont; Eva Kinoshita,10,0,10,0
1668143140221,MATH 295,A00,098062,Suk; Andrew Hoon,48,0,50,2
1668143140643,MATH 296,A00,098063,Novak; Jonathan I,20,0,20,0
1668143141076,MATH 297,001,098064,Gamst; Anthony Collins,9997,0,9999,2
1668143646979,COGS 205,A00,101395,Chiba; Andrea,19,0,20,1
1668143647411,COGS 210B,001,101404,Greene; Deanna Jacquelyn,9998,0,9999,1
1668143647411,COGS 210B,002,101417,Xia; Haijun,9999,0,9999,0
1668143647411,COGS 210B,003,101422,Nitz; Douglas A.,9999,0,9999,0
1668143647411,COGS 210B,004,101423,Hollan; James D.,9998,0,9999,1
1668143647411,COGS 210B,005,101424,Deak; Gedeon O.,9998,0,9999,1
1668143647411,COGS 210B,006,101425,Rossano; Federico,9999,0,9999,0
1668143647847,COGS 211B,A00,101427,Coulson; Seana M,9996,0,9999,3
1668143648286,COGS 220,A00,101428,Hollan; James D.,0,0,25,25
1668143648710,COGS 229,A00,101429,Dow; Steven P,18,0,25,7
1668143649137,COGS 230,A00,101430,Klemmer; Scott R,12,0,17,5
1668143649583,COGS 234,A00,101431,Xia; Haijun,3,0,25,22
1668143650006,COGS 260,A00,101432,Kiyonaga; Anastasia,20,0,25,5
1668143650006,COGS 260,B00,101433,Kirsh; David Joel,16,0,25,9
1668143650429,CSE 202,A00,102371,Impagliazzo; Russell,0,0,0,0
1668143650856,CSE 203B,A01,102373,Cheng; Chung Kuan,0,0,0,0
1668143651280,CSE 208,A00,102374,Micciancio; Daniele,0,0,0,0
1668143651712,CSE 209A,A00,112895,Impagliazzo; Russell,0,0,15,15
1668143652135,CSE 209B,A00,108005,Bellare; Mihir,0,0,0,0
1668143652576,CSE 210,A00,113163,Coblenz; Michael J,0,0,0,0
1668143653018,CSE 219,A00,106111,Dow; Steven P,0,0,20,20
1668143653441,CSE 221,A00,102376,Voelker; Geoffrey M.,0,0,0,0
1668143653876,CSE 224,A01,102378,Porter; George M,0,0,0,0
1668143654312,CSE 229A,A00,102379,Savage; Stefan,0,0,0,0
1668143654757,CSE 229C,A00,102380,Munyaka; Imani N. S.,0,0,0,0
1668143655193,CSE 232B,A00,102382,Deutsch; Alin Bernard,0,0,0,0
1668143655643,CSE 234,A01,112904,Kumar; Arun Kumar,0,0,0,0
1668143656064,CSE 237A,A00,102383,Rosing; Tajana Simunic,0,0,0,0
1668143656498,CSE 239A,A00,102384,Deutsch; Alin Bernard,0,0,0,0
1668143656929,CSE 239B,A00,102385,Polikarpova; Nadezhda,0,0,0,0
1668143657356,CSE 240A,A00,102386,Pannuto; Patrick William,0,0,0,0
1668143657779,CSE 240B,A00,102387,Zhao; Jishen,0,0,0,0
1668143658204,CSE 241A,A00,106406,Kang; Mingu,0,0,0,0
1668143658636,CSE 249B,A00,102388,Kahng; Andrew Byun,0,0,8,8
1668143659064,CSE 251B,A01,102392,Cottrell; Garrison W,0,0,0,0
1668143659064,CSE 251B,A02,102393,Cottrell; Garrison W,0,0,0,0
1668143659488,CSE 252B,A00,102394,Ochoa; Benjamin Lawrence,0,0,0,0
1668143659923,CSE 257,A01,102396,Gao; Sicun,0,0,0,0
1668143660361,CSE 272,A00,102397,Li; Tzumao,0,0,0,0
1668143660810,CSE 274,A00,111323,Chern; Albert Ren-Haur,0,0,0,0
1668143661248,CSE 282,A00,102398,Pevzner; Pavel Arkadjevich,0,0,0,0
1668143661670,CSE 284,A00,114175,Gymrek; Melissa Ann,0,0,0,0
1668143662118,CSE 290,A00,102399,Chandraker; Manmohan Krishna,0,0,0,0
1668143662118,CSE 290,B00,102400,Vaccaro; Kristen Marie,0,0,25,25
1668143662118,CSE 290,C00,102414,Pannuto; Patrick William,0,0,25,25
1668143662118,CSE 290,D00,102427,Pevzner; Pavel Arkadjevich,0,0,0,0
1668143662118,CSE 290,E00,102429,Zhao; Jishen,0,0,0,0
1668143662118,CSE 290,F00,102436,Tullsen; Dean Michael,0,0,0,0
1668143662118,CSE 290,G00,102440,Christensen; Henrik I,0,0,20,20
1668143662546,CSE 291,A00,102443,Su; Hao,0,0,0,0
1668143662546,CSE 291,B00,102448,Polikarpova; Nadezhda,0,0,0,0
1668143662546,CSE 291,C00,102453,Vaccaro; Kristen Marie,0,0,0,0
1668143662546,CSE 291,D00,111343,Savage; Stefan,0,0,0,0
1668143662546,CSE 291,E00,116474,Claffy; Kimberly Claire,0,0,0,0
1668143662546,CSE 291,F00,116479,Pasquale; Joseph,0,0,0,0
1668143663006,CSE 293,001,119111,Bafna; Vineet,9999,0,9999,0
1668143663006,CSE 293,002,119118,Bellare; Mihir,9999,0,9999,0
1668143663006,CSE 293,003,119122,Berg-Kirkpatrick; Taylor D,9999,0,9999,0
1668143663006,CSE 293,004,119135,Christensen; Henrik I,9999,0,9999,0
1668143663006,CSE 293,005,119142,Cottrell; Garrison W,9999,0,9999,0
1668143663006,CSE 293,006,119146,Deutsch; Alin Bernard,9999,0,9999,0
1668143663006,CSE 293,007,119159,Esmaeilzadeh; Hadi,9999,0,9999,0
1668143663006,CSE 293,008,119166,Freund; Yoav,9999,0,9999,0
1668143663006,CSE 293,009,119170,Griswold; William G.,9999,0,9999,0
1668143663006,CSE 293,010,119183,Gymrek; Melissa Ann,9999,0,9999,0
1668143663006,CSE 293,011,119190,Heninger; Nadia A,9999,0,9999,0
1668143663006,CSE 293,012,119230,Impagliazzo; Russell,9999,0,9999,0
1668143663006,CSE 293,013,119232,Jhala; Ranjit,9999,0,9999,0
1668143663006,CSE 293,014,119233,Kahng; Andrew Byun,9999,0,9999,0
1668143663006,CSE 293,015,119298,Kane; Daniel Mertz,9999,0,9999,0
1668143663006,CSE 293,016,119299,Kriegman; David J,9999,0,9999,0
1668143663006,CSE 293,017,119300,Kumar; Arun Kumar,9999,0,9999,0
1668143663006,CSE 293,018,119301,Lerner; Sorin,9999,0,9999,0
1668143663006,CSE 293,019,119302,Lovett; Shachar,9999,0,9999,0
1668143663006,CSE 293,020,119303,McAuley; Julian John,9999,0,9999,0
1668143663006,CSE 293,021,119304,Micciancio; Daniele,9999,0,9999,0
1668143663006,CSE 293,022,119367,Orailoglu; Alex,9999,0,9999,0
1668143663006,CSE 293,023,119382,Paturi; Ramamohan,9999,0,9999,0
1668143663006,CSE 293,024,119404,Polikarpova; Nadezhda,9999,0,9999,0
1668143663006,CSE 293,025,119406,Politz; Joseph Gibbs,9999,0,9999,0
1668143663006,CSE 293,026,119411,Porter; George M,9999,0,9999,0
1668143663006,CSE 293,027,119414,Porter; Leonard Emerson,9999,0,9999,0
1668143663006,CSE 293,028,119416,Ramamoorthi; Ravi,9999,0,9999,0
1668143663006,CSE 293,029,119417,Sahoo; Debashis,9999,0,9999,0
1668143663006,CSE 293,030,119420,Saul; Lawrence,9999,0,9999,0
1668143663006,CSE 293,031,119421,Savage; Stefan,9999,0,9999,0
1668143663006,CSE 293,032,119425,Schulze; Jurgen P.,9999,0,9999,0
1668143663006,CSE 293,033,119426,Snoeren; Alex C.,9999,0,9999,0
1668143663006,CSE 293,034,119428,Shang; Jingbo,9999,0,9999,0
1668143663006,CSE 293,035,119430,Stefan; Deian,9999,0,9999,0
1668143663006,CSE 293,036,119431,Su; Hao,9999,0,9999,0
1668143663006,CSE 293,037,119433,Swanson; Steven James,9999,0,9999,0
1668143663006,CSE 293,038,119435,Tullsen; Dean Michael,9999,0,9999,0
1668143663006,CSE 293,039,119483,Voelker; Geoffrey M.,9999,0,9999,0
1668143663006,CSE 293,040,119537,Zhao; Jishen,9999,0,9999,0
1668143663006,CSE 293,041,119538,Zhou; Yuan-Yuan,9999,0,9999,0
1668143663006,CSE 293,042,119539,Gao; Sicun,9999,0,9999,0
1668143663006,CSE 293,043,119540,Weibel; Nadir,9999,0,9999,0
1668143663006,CSE 293,044,119541,Gupta; Rajesh K.,9999,0,9999,0
1668143663006,CSE 293,045,126410,Vaccaro; Kristen Marie,9999,0,9999,0
1668143663006,CSE 293,046,126411,Klemke; Richard,9999,0,9999,0
1668143663440,CSE 294,A00,102459,Voelker; Geoffrey M.,0,0,0,0
1668143663440,CSE 294,B00,111322,Orailoglu; Alex,0,0,0,0
1668143663880,DSE 201,A00,096914,Deutsch; Alin Bernard,30,0,30,0
1668143664314,DSE 210,A00,096915,Dasgupta; Sanjoy,30,0,30,0
1668143664740,DSE 260A,A00,096916,Altintas De Callaf; Ilkay,30,0,30,0
1668143665202,ECE 200,001,103586,Antipa; Nicholas A,9999,0,9999,0
1668143665202,ECE 200,002,103587,Atanasov; Nikolay A.,9999,0,9999,0
1668143665202,ECE 200,003,103588,Bharadia; Dinesh,9999,0,9999,0
1668143665202,ECE 200,004,103589,Cheng; Chung Kuan,9999,0,9999,0
1668143665202,ECE 200,005,103590,Cosman; Pamela C.,9999,0,9999,0
1668143665202,ECE 200,006,103591,Dayeh; Shadi Ahmad,9999,0,9999,0
1668143665202,ECE 200,007,103592,Fainman; Yeshaiahu,9999,0,9999,0
1668143665202,ECE 200,008,103593,Ford; Joseph Earl,9999,0,9999,0
1668143665202,ECE 200,009,103594,Franceschetti; Massimo,9999,0,9999,0
1668143665202,ECE 200,010,103595,Fullerton; Eric E,9999,0,9999,0
1668143665202,ECE 200,011,103596,Galton; Ian A,9999,0,9999,0
1668143665202,ECE 200,012,103597,Gilja; Vikash,9999,0,9999,0
1668143665202,ECE 200,013,103598,Hall; Drew A.,9999,0,9999,0
1668143665202,ECE 200,014,103599,Hsueh; Tzu-Chien,9999,0,9999,0
1668143665202,ECE 200,015,103600,Javidi; Tara,9999,0,9999,0
1668143665202,ECE 200,016,103601,Kahng; Andrew Byun,9999,0,9999,0
1668143665202,ECE 200,017,103602,Kim; Young-Han,9999,0,9999,0
1668143665202,ECE 200,018,103603,Koushanfar; Farinaz,9999,0,9999,0
1668143665202,ECE 200,019,103604,Kuzum; Duygu,9999,0,9999,0
1668143665202,ECE 200,020,103605,Le; Hanh-Phuc,9999,0,9999,0
1668143665202,ECE 200,021,103606,Lin; Bill,9999,0,9999,0
1668143665202,ECE 200,022,103607,Liu; Zhaowei,9998,0,9999,1
1668143665202,ECE 200,023,103608,Lo; Yu-Hwa,9999,0,9999,0
1668143665202,ECE 200,024,103609,Lomakin; Vitaliy,9999,0,9999,0
1668143665202,ECE 200,025,103610,Mercier; Patrick Philip,9999,0,9999,0
1668143665202,ECE 200,026,103611,Meyer; Florian,9999,0,9999,0
1668143665202,ECE 200,027,103612,Milstein; Laurence B.,9999,0,9999,0
1668143665202,ECE 200,028,103613,Mir Arabbaygi; Siavash,9999,0,9999,0
1668143665202,ECE 200,029,103614,Mookherjea; Shayan,9999,0,9999,0
1668143665202,ECE 200,030,103615,Morris; Karcher William,9999,0,9999,0
1668143665202,ECE 200,031,103616,Ng; Tse Nga,9999,0,9999,0
1668143665202,ECE 200,032,103617,Nguyen; Truong Quang,9999,0,9999,0
1668143665202,ECE 200,033,103618,Nomura; Kenji,9999,0,9999,0
1668143665202,ECE 200,034,103619,Orlitsky; Alon,9999,0,9999,0
1668143665202,ECE 200,035,103620,Pal; Piya,9999,0,9999,0
1668143665202,ECE 200,036,103621,Papen; George C.,9999,0,9999,0
1668143665202,ECE 200,037,103622,Radic; Stojan,9999,0,9999,0
1668143665202,ECE 200,038,103623,Rao; Bhaskar D.,9999,0,9999,0
1668143665202,ECE 200,039,103624,Rao; Ramesh R,9999,0,9999,0
1668143665202,ECE 200,040,103625,Rebeiz; Gabriel,9999,0,9999,0
1668143665202,ECE 200,041,103626,Sanford; John R,9999,0,9999,0
1668143665202,ECE 200,042,103627,Siegel; Paul H.,9999,0,9999,0
1668143665202,ECE 200,043,103628,Sievenpiper; Daniel F.,9999,0,9999,0
1668143665202,ECE 200,044,103629,Sworder; David D.,9999,0,9999,0
1668143665202,ECE 200,045,103630,Taur; Yuan,9999,0,9999,0
1668143665202,ECE 200,046,103631,Touri; Behrouz,9999,0,9999,0
1668143665202,ECE 200,047,103632,Trivedi; Mohan M.,9999,0,9999,0
1668143665202,ECE 200,048,103633,Vasconcelos; Nuno,9999,0,9999,0
1668143665202,ECE 200,049,103634,Wang; Xiaolong,9999,0,9999,0
1668143665202,ECE 200,050,103635,Xie; Pengtao,9999,0,9999,0
1668143665202,ECE 200,051,103636,Yip; Michael,9999,0,9999,0
1668143665202,ECE 200,052,103637,Zeger; Kenneth A.,999,0,999,0
1668143665202,ECE 200,053,103638,Zhang; Xinyu,9999,0,9999,0
1668143665202,ECE 200,054,103639,Turakhia; Yatish Girish,9999,0,9999,0
1668143665202,ECE 200,055,103640,Kang; Mingu,9999,0,9999,0
1668143665202,ECE 200,056,103641,Shi; Yuanyuan,9999,0,9999,0
1668143665202,ECE 200,057,103642,Wang; Edward Jay,9999,0,9999,0
1668143665202,ECE 200,058,103643,Zheng; Yang,9999,0,9999,0
1668143665655,ECE 202,A00,103644,Kuzum; Duygu,0,0,0,0
1668143666084,ECE 212BN,A00,103646,Ng; Tse Nga,0,0,0,0
1668143666506,ECE 221,A00,111493,Staff,0,0,0,0
1668143666932,ECE 222B,A00,103647,Lomakin; Vitaliy,0,0,0,0
1668143667363,ECE 230B,A00,103648,Taur; Yuan,0,0,0,0
1668143667789,ECE 238B,A00,103649,Garay; Javier,0,0,0,0
1668143668224,ECE 240B,A00,112900,Fainman; Yeshaiahu,0,0,0,0
1668143668647,ECE 247A,A00,103650,Jokerst; Jesse Vincent,0,0,0,0
1668143669075,ECE 247B,A00,103651,Wang; Joseph,0,0,0,0
1668143669505,ECE 250,A00,103652,Siegel; Paul H.,0,0,0,0
1668143669933,ECE 251A,A00,103654,Rao; Bhaskar D.,0,0,0,0
1668143670432,ECE 257B,A00,103655,Bharadia; Dinesh,0,0,0,0
1668143670866,ECE 258A,A00,103656,Milstein; Laurence B.,0,0,0,0
1668143671309,ECE 260B,A00,103658,Kang; Mingu,0,0,0,0
1668143671743,ECE 264A,A00,103659,Galton; Ian A,0,0,0,0
1668143672169,ECE 265A,A00,103661,Gudem; Prasad S.S.,0,0,0,0
1668143672592,ECE 265D,A00,103662,Gudem; Prasad S.S.,0,0,0,0
1668143673027,ECE 268,A00,103663,Koushanfar; Farinaz,0,0,0,0
1668143673464,ECE 269,A01,103665,Pal; Piya,0,0,0,0
1668143673895,ECE 271B,A00,103666,Vasconcelos; Manuela,0,0,0,0
1668143674350,ECE 276A,A00,103667,Atanasov; Nikolay A.,0,0,0,0
1668143674786,ECE 277,A00,103668,An; Cheolhong,0,0,0,0
1668143675243,ECE 279,A00,117947,Hall; Drew A.,0,0,0,0
1668143676089,ECE 283,A00,103670,Hsueh; Tzu-Chien,0,0,0,0
1668143676530,ECE 284,A00,103671,Turakhia; Yatish Girish,0,0,0,0
1668143676979,ECE 285,A00,103672,Zheng; Yang,0,0,0,0
1668143676979,ECE 285,B00,103673,Sworder; David D.,0,0,0,0
1668143677404,ECE 287,A00,103676,Javidi; Tara,0,0,0,0
1668143677830,MATH 200B,A00,098023,Salehi Golsefidy; Alireza,12,0,15,3
1668143678279,MATH 202B,A00,098024,Rhoades; Brendon Patrick,9,0,15,6
1668143678719,MATH 203B,A00,098025,Oprea; Dragos N.,10,0,15,5
1668143679144,MATH 204B,A00,098026,Sorensen; Claus M,13,0,15,2
1668143679587,MATH 208,A00,098027,Izadi; Elham,7,0,10,3
1668143680010,MATH 209,A00,098028,Pollack; Aaron,10,0,10,0
1668143680435,MATH 211A,A00,112919,Rogalski; Daniel,9,0,10,1
1668143680862,MATH 211B,A00,112920,Seward; Brandon M.,9,0,10,1
1668143681298,MATH 218,A00,098029,Li; Bo,10,0,10,0
1668143681722,MATH 220B,A00,098030,Novak; Jonathan I,11,0,15,4
1668143682167,MATH 221A,A00,098031,Ebenfelt; Peter F,13,0,15,2
1668143682589,MATH 231B,A00,098032,Zlatos; Andrej,12,0,15,3
1668143683016,MATH 240B,A00,098033,Ni; Lei,9,0,15,6
1668143683450,MATH 243,A00,098034,Jekel; David Andrew,10,0,10,0
1668143683874,MATH 245A,A00,098035,Nie; Jiawang,0,0,15,16
1668143684297,MATH 248,A00,098036,Bejenaru; Ioan,10,0,10,0
1668143684722,MATH 250B,A00,098037,Spolaor; Luca,14,0,15,1
1668143685144,MATH 258,A00,098038,Ni; Lei,10,0,10,0
1668143685566,MATH 264B,A00,098041,Rhoades; Brendon Patrick,9,0,15,6
1668143686028,MATH 268,A00,098042,Buss; Samuel R,10,0,10,0
1668143686453,MATH 269,A00,098043,Rhoades; Brendon Patrick,10,0,10,0
1668143686876,MATH 270B,A00,098044,Li; Bo,10,0,15,5
1668143687302,MATH 272B,A00,098045,Holst; Michael J,13,0,15,2
1668143687733,MATH 273A,A00,098046,Tian; Xiaochuan,10,0,15,5
1668143688189,MATH 275,A01,098048,Tian; Xiaochuan,6,0,10,4
1668143688617,MATH 278A,A00,098049,Holst; Michael J,8,0,10,2
1668143689049,MATH 278B,A00,098050,Cloninger; Alexander,10,0,10,0
1668143689474,MATH 278C,A00,098051,Nie; Jiawang,7,0,10,3
1668143689900,MATH 280B,A00,098052,Zheng; Tianyi,10,0,15,5
1668143690328,MATH 281B,A00,098053,Bradic; Jelena,2,0,15,13
1668143690755,MATH 282B,A00,098054,Arias-Castro; Ery,0,0,15,15
1668143691181,MATH 285,A00,098055,Fitzsimmons; Patrick J,0,0,15,17
1668143691604,MATH 287B,A00,098056,Arias-Castro; Ery,2,0,15,13
1668143692031,MATH 288,A00,098057,Agarwal; Pooja,9,0,10,1
1668143692031,MATH 288,B00,098058,Zhang; Danna,8,0,10,2
1668143692031,MATH 288,C00,098059,Williams; Ruth J,10,0,10,0
1668143692479,MATH 290B,A00,098060,Roberts; Justin Deritter,13,0,15,2
1668143692908,MATH 292,A00,098061,Belmont; Eva Kinoshita,10,0,10,0
1668143693335,MATH 295,A00,098062,Suk; Andrew Hoon,48,0,50,2
1668143693781,MATH 296,A00,098063,Novak; Jonathan I,20,0,20,0
1668143694207,MATH 297,001,098064,Gamst; Anthony Collins,9997,0,9999,2
1668144210973,COGS 205,A00,101395,Chiba; Andrea,19,0,20,1
1668144211424,COGS 210B,001,101404,Greene; Deanna Jacquelyn,9998,0,9999,1
1668144211424,COGS 210B,002,101417,Xia; Haijun,9999,0,9999,0
1668144211424,COGS 210B,003,101422,Nitz; Douglas A.,9999,0,9999,0
1668144211424,COGS 210B,004,101423,Hollan; James D.,9998,0,9999,1
1668144211424,COGS 210B,005,101424,Deak; Gedeon O.,9998,0,9999,1
1668144211424,COGS 210B,006,101425,Rossano; Federico,9999,0,9999,0
1668144211880,COGS 211B,A00,101427,Coulson; Seana M,9996,0,9999,3
1668144212302,COGS 220,A00,101428,Hollan; James D.,0,0,25,25
1668144212731,COGS 229,A00,101429,Dow; Steven P,18,0,25,7
1668144213184,COGS 230,A00,101430,Klemmer; Scott R,12,0,17,5
1668144213606,COGS 234,A00,101431,Xia; Haijun,3,0,25,22
1668144214042,COGS 260,A00,101432,Kiyonaga; Anastasia,20,0,25,5
1668144214042,COGS 260,B00,101433,Kirsh; David Joel,16,0,25,9
1668144214469,CSE 202,A00,102371,Impagliazzo; Russell,0,0,0,0
1668144214894,CSE 203B,A01,102373,Cheng; Chung Kuan,0,0,0,0
1668144215323,CSE 208,A00,102374,Micciancio; Daniele,0,0,0,0
1668144215748,CSE 209A,A00,112895,Impagliazzo; Russell,0,0,15,15
1668144216205,CSE 209B,A00,108005,Bellare; Mihir,0,0,0,0
1668144216641,CSE 210,A00,113163,Coblenz; Michael J,0,0,0,0
1668144217066,CSE 219,A00,106111,Dow; Steven P,0,0,20,20
1668144217502,CSE 221,A00,102376,Voelker; Geoffrey M.,0,0,0,0
1668144217927,CSE 224,A01,102378,Porter; George M,0,0,0,0
1668144218353,CSE 229A,A00,102379,Savage; Stefan,0,0,0,0
1668144218782,CSE 229C,A00,102380,Munyaka; Imani N. S.,0,0,0,0
1668144219205,CSE 232B,A00,102382,Deutsch; Alin Bernard,0,0,0,0
1668144219630,CSE 234,A01,112904,Kumar; Arun Kumar,0,0,0,0
1668144220054,CSE 237A,A00,102383,Rosing; Tajana Simunic,0,0,0,0
1668144220482,CSE 239A,A00,102384,Deutsch; Alin Bernard,0,0,0,0
1668144220906,CSE 239B,A00,102385,Polikarpova; Nadezhda,0,0,0,0
1668144221346,CSE 240A,A00,102386,Pannuto; Patrick William,0,0,0,0
1668144221769,CSE 240B,A00,102387,Zhao; Jishen,0,0,0,0
1668144222194,CSE 241A,A00,106406,Kang; Mingu,0,0,0,0
1668144222615,CSE 249B,A00,102388,Kahng; Andrew Byun,0,0,8,8
1668144223059,CSE 251B,A01,102392,Cottrell; Garrison W,0,0,0,0
1668144223059,CSE 251B,A02,102393,Cottrell; Garrison W,0,0,0,0
1668144223505,CSE 252B,A00,102394,Ochoa; Benjamin Lawrence,0,0,0,0
1668144223941,CSE 257,A01,102396,Gao; Sicun,0,0,0,0
1668144224370,CSE 272,A00,102397,Li; Tzumao,0,0,0,0
1668144224810,CSE 274,A00,111323,Chern; Albert Ren-Haur,0,0,0,0
1668144225235,CSE 282,A00,102398,Pevzner; Pavel Arkadjevich,0,0,0,0
1668144225683,CSE 284,A00,114175,Gymrek; Melissa Ann,0,0,0,0
1668144226120,CSE 290,A00,102399,Chandraker; Manmohan Krishna,0,0,0,0
1668144226120,CSE 290,B00,102400,Vaccaro; Kristen Marie,0,0,25,25
1668144226120,CSE 290,C00,102414,Pannuto; Patrick William,0,0,25,25
1668144226120,CSE 290,D00,102427,Pevzner; Pavel Arkadjevich,0,0,0,0
1668144226120,CSE 290,E00,102429,Zhao; Jishen,0,0,0,0
1668144226120,CSE 290,F00,102436,Tullsen; Dean Michael,0,0,0,0
1668144226120,CSE 290,G00,102440,Christensen; Henrik I,0,0,20,20
1668144226572,CSE 291,A00,102443,Su; Hao,0,0,0,0
1668144226572,CSE 291,B00,102448,Polikarpova; Nadezhda,0,0,0,0
1668144226572,CSE 291,C00,102453,Vaccaro; Kristen Marie,0,0,0,0
1668144226572,CSE 291,D00,111343,Savage; Stefan,0,0,0,0
1668144226572,CSE 291,E00,116474,Claffy; Kimberly Claire,0,0,0,0
1668144226572,CSE 291,F00,116479,Pasquale; Joseph,0,0,0,0
1668144227005,CSE 293,001,119111,Bafna; Vineet,9999,0,9999,0
1668144227005,CSE 293,002,119118,Bellare; Mihir,9999,0,9999,0
1668144227005,CSE 293,003,119122,Berg-Kirkpatrick; Taylor D,9999,0,9999,0
1668144227005,CSE 293,004,119135,Christensen; Henrik I,9999,0,9999,0
1668144227005,CSE 293,005,119142,Cottrell; Garrison W,9999,0,9999,0
1668144227005,CSE 293,006,119146,Deutsch; Alin Bernard,9999,0,9999,0
1668144227005,CSE 293,007,119159,Esmaeilzadeh; Hadi,9999,0,9999,0
1668144227005,CSE 293,008,119166,Freund; Yoav,9999,0,9999,0
1668144227005,CSE 293,009,119170,Griswold; William G.,9999,0,9999,0
1668144227005,CSE 293,010,119183,Gymrek; Melissa Ann,9999,0,9999,0
1668144227005,CSE 293,011,119190,Heninger; Nadia A,9999,0,9999,0
1668144227005,CSE 293,012,119230,Impagliazzo; Russell,9999,0,9999,0
1668144227005,CSE 293,013,119232,Jhala; Ranjit,9999,0,9999,0
1668144227005,CSE 293,014,119233,Kahng; Andrew Byun,9999,0,9999,0
1668144227005,CSE 293,015,119298,Kane; Daniel Mertz,9999,0,9999,0
1668144227005,CSE 293,016,119299,Kriegman; David J,9999,0,9999,0
1668144227005,CSE 293,017,119300,Kumar; Arun Kumar,9999,0,9999,0
1668144227005,CSE 293,018,119301,Lerner; Sorin,9999,0,9999,0
1668144227005,CSE 293,019,119302,Lovett; Shachar,9999,0,9999,0
1668144227005,CSE 293,020,119303,McAuley; Julian John,9999,0,9999,0
1668144227005,CSE 293,021,119304,Micciancio; Daniele,9999,0,9999,0
1668144227005,CSE 293,022,119367,Orailoglu; Alex,9999,0,9999,0
1668144227005,CSE 293,023,119382,Paturi; Ramamohan,9999,0,9999,0
1668144227005,CSE 293,024,119404,Polikarpova; Nadezhda,9999,0,9999,0
1668144227005,CSE 293,025,119406,Politz; Joseph Gibbs,9999,0,9999,0
1668144227005,CSE 293,026,119411,Porter; George M,9999,0,9999,0
1668144227005,CSE 293,027,119414,Porter; Leonard Emerson,9999,0,9999,0
1668144227005,CSE 293,028,119416,Ramamoorthi; Ravi,9999,0,9999,0
1668144227005,CSE 293,029,119417,Sahoo; Debashis,9999,0,9999,0
1668144227005,CSE 293,030,119420,Saul; Lawrence,9999,0,9999,0
1668144227005,CSE 293,031,119421,Savage; Stefan,9999,0,9999,0
1668144227005,CSE 293,032,119425,Schulze; Jurgen P.,9999,0,9999,0
1668144227005,CSE 293,033,119426,Snoeren; Alex C.,9999,0,9999,0
1668144227005,CSE 293,034,119428,Shang; Jingbo,9999,0,9999,0
1668144227005,CSE 293,035,119430,Stefan; Deian,9999,0,9999,0
1668144227005,CSE 293,036,119431,Su; Hao,9999,0,9999,0
1668144227005,CSE 293,037,119433,Swanson; Steven James,9999,0,9999,0
1668144227005,CSE 293,038,119435,Tullsen; Dean Michael,9999,0,9999,0
1668144227005,CSE 293,039,119483,Voelker; Geoffrey M.,9999,0,9999,0
1668144227005,CSE 293,040,119537,Zhao; Jishen,9999,0,9999,0
1668144227005,CSE 293,041,119538,Zhou; Yuan-Yuan,9999,0,9999,0
1668144227005,CSE 293,042,119539,Gao; Sicun,9999,0,9999,0
1668144227005,CSE 293,043,119540,Weibel; Nadir,9999,0,9999,0
1668144227005,CSE 293,044,119541,Gupta; Rajesh K.,9999,0,9999,0
1668144227005,CSE 293,045,126410,Vaccaro; Kristen Marie,9999,0,9999,0
1668144227005,CSE 293,046,126411,Klemke; Richard,9999,0,9999,0
1668144227437,CSE 294,A00,102459,Voelker; Geoffrey M.,0,0,0,0
1668144227437,CSE 294,B00,111322,Orailoglu; Alex,0,0,0,0
1668144227865,DSE 201,A00,096914,Deutsch; Alin Bernard,30,0,30,0
1668144228298,DSE 210,A00,096915,Dasgupta; Sanjoy,30,0,30,0
1668144228738,DSE 260A,A00,096916,Altintas De Callaf; Ilkay,30,0,30,0
1668144229168,ECE 200,001,103586,Antipa; Nicholas A,9999,0,9999,0
1668144229168,ECE 200,002,103587,Atanasov; Nikolay A.,9999,0,9999,0
1668144229168,ECE 200,003,103588,Bharadia; Dinesh,9999,0,9999,0
1668144229168,ECE 200,004,103589,Cheng; Chung Kuan,9999,0,9999,0
1668144229168,ECE 200,005,103590,Cosman; Pamela C.,9999,0,9999,0
1668144229168,ECE 200,006,103591,Dayeh; Shadi Ahmad,9999,0,9999,0
1668144229168,ECE 200,007,103592,Fainman; Yeshaiahu,9999,0,9999,0
1668144229168,ECE 200,008,103593,Ford; Joseph Earl,9999,0,9999,0
1668144229168,ECE 200,009,103594,Franceschetti; Massimo,9999,0,9999,0
1668144229168,ECE 200,010,103595,Fullerton; Eric E,9999,0,9999,0
1668144229168,ECE 200,011,103596,Galton; Ian A,9999,0,9999,0
1668144229168,ECE 200,012,103597,Gilja; Vikash,9999,0,9999,0
1668144229168,ECE 200,013,103598,Hall; Drew A.,9999,0,9999,0
1668144229168,ECE 200,014,103599,Hsueh; Tzu-Chien,9999,0,9999,0
1668144229168,ECE 200,015,103600,Javidi; Tara,9999,0,9999,0
1668144229168,ECE 200,016,103601,Kahng; Andrew Byun,9999,0,9999,0
1668144229168,ECE 200,017,103602,Kim; Young-Han,9999,0,9999,0
1668144229168,ECE 200,018,103603,Koushanfar; Farinaz,9999,0,9999,0
1668144229168,ECE 200,019,103604,Kuzum; Duygu,9999,0,9999,0
1668144229168,ECE 200,020,103605,Le; Hanh-Phuc,9999,0,9999,0
1668144229168,ECE 200,021,103606,Lin; Bill,9999,0,9999,0
1668144229168,ECE 200,022,103607,Liu; Zhaowei,9998,0,9999,1
1668144229168,ECE 200,023,103608,Lo; Yu-Hwa,9999,0,9999,0
1668144229168,ECE 200,024,103609,Lomakin; Vitaliy,9999,0,9999,0
1668144229168,ECE 200,025,103610,Mercier; Patrick Philip,9999,0,9999,0
1668144229168,ECE 200,026,103611,Meyer; Florian,9999,0,9999,0
1668144229168,ECE 200,027,103612,Milstein; Laurence B.,9999,0,9999,0
1668144229168,ECE 200,028,103613,Mir Arabbaygi; Siavash,9999,0,9999,0
1668144229168,ECE 200,029,103614,Mookherjea; Shayan,9999,0,9999,0
1668144229168,ECE 200,030,103615,Morris; Karcher William,9999,0,9999,0
1668144229168,ECE 200,031,103616,Ng; Tse Nga,9999,0,9999,0
1668144229168,ECE 200,032,103617,Nguyen; Truong Quang,9999,0,9999,0
1668144229168,ECE 200,033,103618,Nomura; Kenji,9999,0,9999,0
1668144229168,ECE 200,034,103619,Orlitsky; Alon,9999,0,9999,0
1668144229168,ECE 200,035,103620,Pal; Piya,9999,0,9999,0
1668144229168,ECE 200,036,103621,Papen; George C.,9999,0,9999,0
1668144229168,ECE 200,037,103622,Radic; Stojan,9999,0,9999,0
1668144229168,ECE 200,038,103623,Rao; Bhaskar D.,9999,0,9999,0
1668144229168,ECE 200,039,103624,Rao; Ramesh R,9999,0,9999,0
1668144229168,ECE 200,040,103625,Rebeiz; Gabriel,9999,0,9999,0
1668144229168,ECE 200,041,103626,Sanford; John R,9999,0,9999,0
1668144229168,ECE 200,042,103627,Siegel; Paul H.,9999,0,9999,0
1668144229168,ECE 200,043,103628,Sievenpiper; Daniel F.,9999,0,9999,0
1668144229168,ECE 200,044,103629,Sworder; David D.,9999,0,9999,0
1668144229168,ECE 200,045,103630,Taur; Yuan,9999,0,9999,0
1668144229168,ECE 200,046,103631,Touri; Behrouz,9999,0,9999,0
1668144229168,ECE 200,047,103632,Trivedi; Mohan M.,9999,0,9999,0
1668144229168,ECE 200,048,103633,Vasconcelos; Nuno,9999,0,9999,0
1668144229168,ECE 200,049,103634,Wang; Xiaolong,9999,0,9999,0
1668144229168,ECE 200,050,103635,Xie; Pengtao,9999,0,9999,0
1668144229168,ECE 200,051,103636,Yip; Michael,9999,0,9999,0
1668144229168,ECE 200,052,103637,Zeger; Kenneth A.,999,0,999,0
1668144229168,ECE 200,053,103638,Zhang; Xinyu,9999,0,9999,0
1668144229168,ECE 200,054,103639,Turakhia; Yatish Girish,9999,0,9999,0
1668144229168,ECE 200,055,103640,Kang; Mingu,9999,0,9999,0
1668144229168,ECE 200,056,103641,Shi; Yuanyuan,9999,0,9999,0
1668144229168,ECE 200,057,103642,Wang; Edward Jay,9999,0,9999,0
1668144229168,ECE 200,058,103643,Zheng; Yang,9999,0,9999,0
1668144229591,ECE 202,A00,103644,Kuzum; Duygu,0,0,0,0
1668144230031,ECE 212BN,A00,103646,Ng; Tse Nga,0,0,0,0
1668144230465,ECE 221,A00,111493,Staff,0,0,0,0
1668144230909,ECE 222B,A00,103647,Lomakin; Vitaliy,0,0,0,0
1668144231347,ECE 230B,A00,103648,Taur; Yuan,0,0,0,0
1668144231800,ECE 238B,A00,103649,Garay; Javier,0,0,0,0
1668144232229,ECE 240B,A00,112900,Fainman; Yeshaiahu,0,0,0,0
1668144232656,ECE 247A,A00,103650,Jokerst; Jesse Vincent,0,0,0,0
1668144233103,ECE 247B,A00,103651,Wang; Joseph,0,0,0,0
1668144233553,ECE 250,A00,103652,Siegel; Paul H.,0,0,0,0
1668144233977,ECE 251A,A00,103654,Rao; Bhaskar D.,0,0,0,0
1668144234414,ECE 257B,A00,103655,Bharadia; Dinesh,0,0,0,0
1668144234843,ECE 258A,A00,103656,Milstein; Laurence B.,0,0,0,0
1668144235265,ECE 260B,A00,103658,Kang; Mingu,0,0,0,0
1668144235727,ECE 264A,A00,103659,Galton; Ian A,0,0,0,0
1668144236151,ECE 265A,A00,103661,Gudem; Prasad S.S.,0,0,0,0
1668144236576,ECE 265D,A00,103662,Gudem; Prasad S.S.,0,0,0,0
1668144236998,ECE 268,A00,103663,Koushanfar; Farinaz,0,0,0,0
1668144237433,ECE 269,A01,103665,Pal; Piya,0,0,0,0
1668144237867,ECE 271B,A00,103666,Vasconcelos; Manuela,0,0,0,0
1668144238293,ECE 276A,A00,103667,Atanasov; Nikolay A.,0,0,0,0
1668144238728,ECE 277,A00,103668,An; Cheolhong,0,0,0,0
1668144239154,ECE 279,A00,117947,Hall; Drew A.,0,0,0,0
1668144240010,ECE 283,A00,103670,Hsueh; Tzu-Chien,0,0,0,0
1668144240433,ECE 284,A00,103671,Turakhia; Yatish Girish,0,0,0,0
1668144240855,ECE 285,A00,103672,Zheng; Yang,0,0,0,0
1668144240855,ECE 285,B00,103673,Sworder; David D.,0,0,0,0
1668144241304,ECE 287,A00,103676,Javidi; Tara,0,0,0,0
1668144241728,MATH 200B,A00,098023,Salehi Golsefidy; Alireza,12,0,15,3
1668144242164,MATH 202B,A00,098024,Rhoades; Brendon Patrick,9,0,15,6
1668144242604,MATH 203B,A00,098025,Oprea; Dragos N.,10,0,15,5
1668144243030,MATH 204B,A00,098026,Sorensen; Claus M,13,0,15,2
1668144243452,MATH 208,A00,098027,Izadi; Elham,7,0,10,3
1668144243878,MATH 209,A00,098028,Pollack; Aaron,10,0,10,0
1668144244305,MATH 211A,A00,112919,Rogalski; Daniel,9,0,10,1
1668144244730,MATH 211B,A00,112920,Seward; Brandon M.,9,0,10,1
1668144245170,MATH 218,A00,098029,Li; Bo,10,0,10,0
1668144245595,MATH 220B,A00,098030,Novak; Jonathan I,11,0,15,4
1668144246021,MATH 221A,A00,098031,Ebenfelt; Peter F,13,0,15,2
1668144246466,MATH 231B,A00,098032,Zlatos; Andrej,12,0,15,3
1668144246912,MATH 240B,A00,098033,Ni; Lei,9,0,15,6
1668144247345,MATH 243,A00,098034,Jekel; David Andrew,10,0,10,0
1668144247773,MATH 245A,A00,098035,Nie; Jiawang,0,0,15,16
1668144248199,MATH 248,A00,098036,Bejenaru; Ioan,10,0,10,0
1668144248625,MATH 250B,A00,098037,Spolaor; Luca,14,0,15,1
1668144249057,MATH 258,A00,098038,Ni; Lei,10,0,10,0
1668144249480,MATH 264B,A00,098041,Rhoades; Brendon Patrick,9,0,15,6
1668144249906,MATH 268,A00,098042,Buss; Samuel R,10,0,10,0
1668144250348,MATH 269,A00,098043,Rhoades; Brendon Patrick,10,0,10,0
1668144250775,MATH 270B,A00,098044,Li; Bo,10,0,15,5
1668144251287,MATH 272B,A00,098045,Holst; Michael J,13,0,15,2
1668144251716,MATH 273A,A00,098046,Tian; Xiaochuan,10,0,15,5
1668144252143,MATH 275,A01,098048,Tian; Xiaochuan,6,0,10,4
1668144252585,MATH 278A,A00,098049,Holst; Michael J,8,0,10,2
1668144253009,MATH 278B,A00,098050,Cloninger; Alexander,10,0,10,0
1668144253437,MATH 278C,A00,098051,Nie; Jiawang,7,0,10,3
1668144253872,MATH 280B,A00,098052,Zheng; Tianyi,10,0,15,5
1668144254317,MATH 281B,A00,098053,Bradic; Jelena,2,0,15,13
1668144254765,MATH 282B,A00,098054,Arias-Castro; Ery,0,0,15,15
1668144255188,MATH 285,A00,098055,Fitzsimmons; Patrick J,0,0,15,17
1668144255621,MATH 287B,A00,098056,Arias-Castro; Ery,2,0,15,13
1668144256063,MATH 288,A00,098057,Agarwal; Pooja,9,0,10,1
1668144256063,MATH 288,B00,098058,Zhang; Danna,8,0,10,2
1668144256063,MATH 288,C00,098059,Williams; Ruth J,10,0,10,0
1668144256488,MATH 290B,A00,098060,Roberts; Justin Deritter,13,0,15,2
1668144256922,MATH 292,A00,098061,Belmont; Eva Kinoshita,10,0,10,0
1668144257348,MATH 295,A00,098062,Suk; Andrew Hoon,48,0,50,2
1668144257776,MATH 296,A00,098063,Novak; Jonathan I,20,0,20,0
1668144258199,MATH 297,001,098064,Gamst; Anthony Collins,9997,0,9999,2
1668144764367,COGS 205,A00,101395,Chiba; Andrea,19,0,20,1
1668144764792,COGS 210B,001,101404,Greene; Deanna Jacquelyn,9998,0,9999,1
1668144764792,COGS 210B,002,101417,Xia; Haijun,9999,0,9999,0
1668144764792,COGS 210B,003,101422,Nitz; Douglas A.,9999,0,9999,0
1668144764792,COGS 210B,004,101423,Hollan; James D.,9998,0,9999,1
1668144764792,COGS 210B,005,101424,Deak; Gedeon O.,9998,0,9999,1
1668144764792,COGS 210B,006,101425,Rossano; Federico,9999,0,9999,0
1668144765242,COGS 211B,A00,101427,Coulson; Seana M,9996,0,9999,3
1668144765696,COGS 220,A00,101428,Hollan; James D.,0,0,25,25
1668144766154,COGS 229,A00,101429,Dow; Steven P,18,0,25,7
1668144766580,COGS 230,A00,101430,Klemmer; Scott R,12,0,17,5
1668144767011,COGS 234,A00,101431,Xia; Haijun,3,0,25,22
1668144767449,COGS 260,A00,101432,Kiyonaga; Anastasia,20,0,25,5
1668144767449,COGS 260,B00,101433,Kirsh; David Joel,16,0,25,9
1668144767871,CSE 202,A00,102371,Impagliazzo; Russell,0,0,0,0
1668144768319,CSE 203B,A01,102373,Cheng; Chung Kuan,0,0,0,0
1668144768753,CSE 208,A00,102374,Micciancio; Daniele,0,0,0,0
1668144769177,CSE 209A,A00,112895,Impagliazzo; Russell,0,0,15,15
1668144769619,CSE 209B,A00,108005,Bellare; Mihir,0,0,0,0
1668144770045,CSE 210,A00,113163,Coblenz; Michael J,0,0,0,0
1668144770467,CSE 219,A00,106111,Dow; Steven P,0,0,20,20
1668144770891,CSE 221,A00,102376,Voelker; Geoffrey M.,0,0,0,0
1668144771315,CSE 224,A01,102378,Porter; George M,0,0,0,0
1668144771739,CSE 229A,A00,102379,Savage; Stefan,0,0,0,0
1668144772175,CSE 229C,A00,102380,Munyaka; Imani N. S.,0,0,0,0
1668144772606,CSE 232B,A00,102382,Deutsch; Alin Bernard,0,0,0,0
1668144773035,CSE 234,A01,112904,Kumar; Arun Kumar,0,0,0,0
1668144773465,CSE 237A,A00,102383,Rosing; Tajana Simunic,0,0,0,0
1668144773905,CSE 239A,A00,102384,Deutsch; Alin Bernard,0,0,0,0
1668144774326,CSE 239B,A00,102385,Polikarpova; Nadezhda,0,0,0,0
1668144774775,CSE 240A,A00,102386,Pannuto; Patrick William,0,0,0,0
1668144775217,CSE 240B,A00,102387,Zhao; Jishen,0,0,0,0
1668144775651,CSE 241A,A00,106406,Kang; Mingu,0,0,0,0
1668144776075,CSE 249B,A00,102388,Kahng; Andrew Byun,0,0,8,8
1668144776514,CSE 251B,A01,102392,Cottrell; Garrison W,0,0,0,0
1668144776514,CSE 251B,A02,102393,Cottrell; Garrison W,0,0,0,0
1668144776942,CSE 252B,A00,102394,Ochoa; Benjamin Lawrence,0,0,0,0
1668144777384,CSE 257,A01,102396,Gao; Sicun,0,0,0,0
1668144777933,CSE 272,A00,102397,Li; Tzumao,0,0,0,0
1668144778374,CSE 274,A00,111323,Chern; Albert Ren-Haur,0,0,0,0
1668144778821,CSE 282,A00,102398,Pevzner; Pavel Arkadjevich,0,0,0,0
1668144779245,CSE 284,A00,114175,Gymrek; Melissa Ann,0,0,0,0
1668144779667,CSE 290,A00,102399,Chandraker; Manmohan Krishna,0,0,0,0
1668144779667,CSE 290,B00,102400,Vaccaro; Kristen Marie,0,0,25,25
1668144779667,CSE 290,C00,102414,Pannuto; Patrick William,0,0,25,25
1668144779667,CSE 290,D00,102427,Pevzner; Pavel Arkadjevich,0,0,0,0
1668144779667,CSE 290,E00,102429,Zhao; Jishen,0,0,0,0
1668144779667,CSE 290,F00,102436,Tullsen; Dean Michael,0,0,0,0
1668144779667,CSE 290,G00,102440,Christensen; Henrik I,0,0,20,20
1668144780097,CSE 291,A00,102443,Su; Hao,0,0,0,0
1668144780097,CSE 291,B00,102448,Polikarpova; Nadezhda,0,0,0,0
1668144780097,CSE 291,C00,102453,Vaccaro; Kristen Marie,0,0,0,0
1668144780097,CSE 291,D00,111343,Savage; Stefan,0,0,0,0
1668144780097,CSE 291,E00,116474,Claffy; Kimberly Claire,0,0,0,0
1668144780097,CSE 291,F00,116479,Pasquale; Joseph,0,0,0,0
1668144780551,CSE 293,001,119111,Bafna; Vineet,9999,0,9999,0
1668144780551,CSE 293,002,119118,Bellare; Mihir,9999,0,9999,0
1668144780551,CSE 293,003,119122,Berg-Kirkpatrick; Taylor D,9999,0,9999,0
1668144780551,CSE 293,004,119135,Christensen; Henrik I,9999,0,9999,0
1668144780551,CSE 293,005,119142,Cottrell; Garrison W,9999,0,9999,0
1668144780551,CSE 293,006,119146,Deutsch; Alin Bernard,9999,0,9999,0
1668144780551,CSE 293,007,119159,Esmaeilzadeh; Hadi,9999,0,9999,0
1668144780551,CSE 293,008,119166,Freund; Yoav,9999,0,9999,0
1668144780551,CSE 293,009,119170,Griswold; William G.,9999,0,9999,0
1668144780551,CSE 293,010,119183,Gymrek; Melissa Ann,9999,0,9999,0
1668144780551,CSE 293,011,119190,Heninger; Nadia A,9999,0,9999,0
1668144780551,CSE 293,012,119230,Impagliazzo; Russell,9999,0,9999,0
1668144780551,CSE 293,013,119232,Jhala; Ranjit,9999,0,9999,0
1668144780551,CSE 293,014,119233,Kahng; Andrew Byun,9999,0,9999,0
1668144780551,CSE 293,015,119298,Kane; Daniel Mertz,9999,0,9999,0
1668144780551,CSE 293,016,119299,Kriegman; David J,9999,0,9999,0
1668144780551,CSE 293,017,119300,Kumar; Arun Kumar,9999,0,9999,0
1668144780551,CSE 293,018,119301,Lerner; Sorin,9999,0,9999,0
1668144780551,CSE 293,019,119302,Lovett; Shachar,9999,0,9999,0
1668144780551,CSE 293,020,119303,McAuley; Julian John,9999,0,9999,0
1668144780551,CSE 293,021,119304,Micciancio; Daniele,9999,0,9999,0
1668144780551,CSE 293,022,119367,Orailoglu; Alex,9999,0,9999,0
1668144780551,CSE 293,023,119382,Paturi; Ramamohan,9999,0,9999,0
1668144780551,CSE 293,024,119404,Polikarpova; Nadezhda,9999,0,9999,0
1668144780551,CSE 293,025,119406,Politz; Joseph Gibbs,9999,0,9999,0
1668144780551,CSE 293,026,119411,Porter; George M,9999,0,9999,0
1668144780551,CSE 293,027,119414,Porter; Leonard Emerson,9999,0,9999,0
1668144780551,CSE 293,028,119416,Ramamoorthi; Ravi,9999,0,9999,0
1668144780551,CSE 293,029,119417,Sahoo; Debashis,9999,0,9999,0
1668144780551,CSE 293,030,119420,Saul; Lawrence,9999,0,9999,0
1668144780551,CSE 293,031,119421,Savage; Stefan,9999,0,9999,0
1668144780551,CSE 293,032,119425,Schulze; Jurgen P.,9999,0,9999,0
1668144780551,CSE 293,033,119426,Snoeren; Alex C.,9999,0,9999,0
1668144780551,CSE 293,034,119428,Shang; Jingbo,9999,0,9999,0
1668144780551,CSE 293,035,119430,Stefan; Deian,9999,0,9999,0
1668144780551,CSE 293,036,119431,Su; Hao,9999,0,9999,0
1668144780551,CSE 293,037,119433,Swanson; Steven James,9999,0,9999,0
1668144780551,CSE 293,038,119435,Tullsen; Dean Michael,9999,0,9999,0
1668144780551,CSE 293,039,119483,Voelker; Geoffrey M.,9999,0,9999,0
1668144780551,CSE 293,040,119537,Zhao; Jishen,9999,0,9999,0
1668144780551,CSE 293,041,119538,Zhou; Yuan-Yuan,9999,0,9999,0
1668144780551,CSE 293,042,119539,Gao; Sicun,9999,0,9999,0
1668144780551,CSE 293,043,119540,Weibel; Nadir,9999,0,9999,0
1668144780551,CSE 293,044,119541,Gupta; Rajesh K.,9999,0,9999,0
1668144780551,CSE 293,045,126410,Vaccaro; Kristen Marie,9999,0,9999,0
1668144780551,CSE 293,046,126411,Klemke; Richard,9999,0,9999,0
1668144780979,CSE 294,A00,102459,Voelker; Geoffrey M.,0,0,0,0
1668144780979,CSE 294,B00,111322,Orailoglu; Alex,0,0,0,0
1668144781411,DSE 201,A00,096914,Deutsch; Alin Bernard,30,0,30,0
1668144781854,DSE 210,A00,096915,Dasgupta; Sanjoy,30,0,30,0
1668144782280,DSE 260A,A00,096916,Altintas De Callaf; Ilkay,30,0,30,0
1668144782728,ECE 200,001,103586,Antipa; Nicholas A,9999,0,9999,0
1668144782728,ECE 200,002,103587,Atanasov; Nikolay A.,9999,0,9999,0
1668144782728,ECE 200,003,103588,Bharadia; Dinesh,9999,0,9999,0
1668144782728,ECE 200,004,103589,Cheng; Chung Kuan,9999,0,9999,0
1668144782728,ECE 200,005,103590,Cosman; Pamela C.,9999,0,9999,0
1668144782728,ECE 200,006,103591,Dayeh; Shadi Ahmad,9999,0,9999,0
1668144782728,ECE 200,007,103592,Fainman; Yeshaiahu,9999,0,9999,0
1668144782728,ECE 200,008,103593,Ford; Joseph Earl,9999,0,9999,0
1668144782728,ECE 200,009,103594,Franceschetti; Massimo,9999,0,9999,0
1668144782728,ECE 200,010,103595,Fullerton; Eric E,9999,0,9999,0
1668144782728,ECE 200,011,103596,Galton; Ian A,9999,0,9999,0
1668144782728,ECE 200,012,103597,Gilja; Vikash,9999,0,9999,0
1668144782728,ECE 200,013,103598,Hall; Drew A.,9999,0,9999,0
1668144782728,ECE 200,014,103599,Hsueh; Tzu-Chien,9999,0,9999,0
1668144782728,ECE 200,015,103600,Javidi; Tara,9999,0,9999,0
1668144782728,ECE 200,016,103601,Kahng; Andrew Byun,9999,0,9999,0
1668144782728,ECE 200,017,103602,Kim; Young-Han,9999,0,9999,0
1668144782728,ECE 200,018,103603,Koushanfar; Farinaz,9999,0,9999,0
1668144782728,ECE 200,019,103604,Kuzum; Duygu,9999,0,9999,0
1668144782728,ECE 200,020,103605,Le; Hanh-Phuc,9999,0,9999,0
1668144782728,ECE 200,021,103606,Lin; Bill,9999,0,9999,0
1668144782728,ECE 200,022,103607,Liu; Zhaowei,9998,0,9999,1
1668144782728,ECE 200,023,103608,Lo; Yu-Hwa,9999,0,9999,0
1668144782728,ECE 200,024,103609,Lomakin; Vitaliy,9999,0,9999,0
1668144782728,ECE 200,025,103610,Mercier; Patrick Philip,9999,0,9999,0
1668144782728,ECE 200,026,103611,Meyer; Florian,9999,0,9999,0
1668144782728,ECE 200,027,103612,Milstein; Laurence B.,9999,0,9999,0
1668144782728,ECE 200,028,103613,Mir Arabbaygi; Siavash,9999,0,9999,0
1668144782728,ECE 200,029,103614,Mookherjea; Shayan,9999,0,9999,0
1668144782728,ECE 200,030,103615,Morris; Karcher William,9999,0,9999,0
1668144782728,ECE 200,031,103616,Ng; Tse Nga,9999,0,9999,0
1668144782728,ECE 200,032,103617,Nguyen; Truong Quang,9999,0,9999,0
1668144782728,ECE 200,033,103618,Nomura; Kenji,9999,0,9999,0
1668144782728,ECE 200,034,103619,Orlitsky; Alon,9999,0,9999,0
1668144782728,ECE 200,035,103620,Pal; Piya,9999,0,9999,0
1668144782728,ECE 200,036,103621,Papen; George C.,9999,0,9999,0
1668144782728,ECE 200,037,103622,Radic; Stojan,9999,0,9999,0
1668144782728,ECE 200,038,103623,Rao; Bhaskar D.,9999,0,9999,0
1668144782728,ECE 200,039,103624,Rao; Ramesh R,9999,0,9999,0
1668144782728,ECE 200,040,103625,Rebeiz; Gabriel,9999,0,9999,0
1668144782728,ECE 200,041,103626,Sanford; John R,9999,0,9999,0
1668144782728,ECE 200,042,103627,Siegel; Paul H.,9999,0,9999,0
1668144782728,ECE 200,043,103628,Sievenpiper; Daniel F.,9999,0,9999,0
1668144782728,ECE 200,044,103629,Sworder; David D.,9999,0,9999,0
1668144782728,ECE 200,045,103630,Taur; Yuan,9999,0,9999,0
1668144782728,ECE 200,046,103631,Touri; Behrouz,9999,0,9999,0
1668144782728,ECE 200,047,103632,Trivedi; Mohan M.,9999,0,9999,0
1668144782728,ECE 200,048,103633,Vasconcelos; Nuno,9999,0,9999,0
1668144782728,ECE 200,049,103634,Wang; Xiaolong,9999,0,9999,0
1668144782728,ECE 200,050,103635,Xie; Pengtao,9999,0,9999,0
1668144782728,ECE 200,051,103636,Yip; Michael,9999,0,9999,0
1668144782728,ECE 200,052,103637,Zeger; Kenneth A.,999,0,999,0
1668144782728,ECE 200,053,103638,Zhang; Xinyu,9999,0,9999,0
1668144782728,ECE 200,054,103639,Turakhia; Yatish Girish,9999,0,9999,0
1668144782728,ECE 200,055,103640,Kang; Mingu,9999,0,9999,0
1668144782728,ECE 200,056,103641,Shi; Yuanyuan,9999,0,9999,0
1668144782728,ECE 200,057,103642,Wang; Edward Jay,9999,0,9999,0
1668144782728,ECE 200,058,103643,Zheng; Yang,9999,0,9999,0
1668144783158,ECE 202,A00,103644,Kuzum; Duygu,0,0,0,0
1668144783603,ECE 212BN,A00,103646,Ng; Tse Nga,0,0,0,0
1668144784056,ECE 221,A00,111493,Staff,0,0,0,0
1668144784479,ECE 222B,A00,103647,Lomakin; Vitaliy,0,0,0,0
1668144784903,ECE 230B,A00,103648,Taur; Yuan,0,0,0,0
1668144785329,ECE 238B,A00,103649,Garay; Javier,0,0,0,0
1668144785754,ECE 240B,A00,112900,Fainman; Yeshaiahu,0,0,0,0
1668144786180,ECE 247A,A00,103650,Jokerst; Jesse Vincent,0,0,0,0
1668144786622,ECE 247B,A00,103651,Wang; Joseph,0,0,0,0
1668144787059,ECE 250,A00,103652,Siegel; Paul H.,0,0,0,0
1668144787495,ECE 251A,A00,103654,Rao; Bhaskar D.,0,0,0,0
1668144787919,ECE 257B,A00,103655,Bharadia; Dinesh,0,0,0,0
1668144788342,ECE 258A,A00,103656,Milstein; Laurence B.,0,0,0,0
1668144788766,ECE 260B,A00,103658,Kang; Mingu,0,0,0,0
1668144789189,ECE 264A,A00,103659,Galton; Ian A,0,0,0,0
1668144789621,ECE 265A,A00,103661,Gudem; Prasad S.S.,0,0,0,0
1668144790054,ECE 265D,A00,103662,Gudem; Prasad S.S.,0,0,0,0
1668144790481,ECE 268,A00,103663,Koushanfar; Farinaz,0,0,0,0
1668144790910,ECE 269,A01,103665,Pal; Piya,0,0,0,0
1668144791333,ECE 271B,A00,103666,Vasconcelos; Manuela,0,0,0,0
1668144791762,ECE 276A,A00,103667,Atanasov; Nikolay A.,0,0,0,0
1668144792185,ECE 277,A00,103668,An; Cheolhong,0,0,0,0
1668144792612,ECE 279,A00,117947,Hall; Drew A.,0,0,0,0
1668144793488,ECE 283,A00,103670,Hsueh; Tzu-Chien,0,0,0,0
1668144793919,ECE 284,A00,103671,Turakhia; Yatish Girish,0,0,0,0
1668144794343,ECE 285,A00,103672,Zheng; Yang,0,0,0,0
1668144794343,ECE 285,B00,103673,Sworder; David D.,0,0,0,0
1668144794767,ECE 287,A00,103676,Javidi; Tara,0,0,0,0
1668144795195,MATH 200B,A00,098023,Salehi Golsefidy; Alireza,12,0,15,3
1668144795616,MATH 202B,A00,098024,Rhoades; Brendon Patrick,9,0,15,6
1668144796053,MATH 203B,A00,098025,Oprea; Dragos N.,10,0,15,5
1668144796489,MATH 204B,A00,098026,Sorensen; Claus M,13,0,15,2
1668144796915,MATH 208,A00,098027,Izadi; Elham,7,0,10,3
1668144797338,MATH 209,A00,098028,Pollack; Aaron,10,0,10,0
1668144797769,MATH 211A,A00,112919,Rogalski; Daniel,9,0,10,1
1668144798204,MATH 211B,A00,112920,Seward; Brandon M.,9,0,10,1
1668144798626,MATH 218,A00,098029,Li; Bo,10,0,10,0
1668144799074,MATH 220B,A00,098030,Novak; Jonathan I,11,0,15,4
1668144799500,MATH 221A,A00,098031,Ebenfelt; Peter F,13,0,15,2
1668144799935,MATH 231B,A00,098032,Zlatos; Andrej,12,0,15,3
1668144800359,MATH 240B,A00,098033,Ni; Lei,9,0,15,6
1668144800811,MATH 243,A00,098034,Jekel; David Andrew,10,0,10,0
1668144801246,MATH 245A,A00,098035,Nie; Jiawang,0,0,15,16
1668144801694,MATH 248,A00,098036,Bejenaru; Ioan,10,0,10,0
1668144802120,MATH 250B,A00,098037,Spolaor; Luca,14,0,15,1
1668144802551,MATH 258,A00,098038,Ni; Lei,10,0,10,0
1668144802975,MATH 264B,A00,098041,Rhoades; Brendon Patrick,9,0,15,6
1668144803414,MATH 268,A00,098042,Buss; Samuel R,10,0,10,0
1668144803838,MATH 269,A00,098043,Rhoades; Brendon Patrick,10,0,10,0
1668144804278,MATH 270B,A00,098044,Li; Bo,10,0,15,5
1668144804728,MATH 272B,A00,098045,Holst; Michael J,13,0,15,2
1668144805179,MATH 273A,A00,098046,Tian; Xiaochuan,10,0,15,5
1668144805602,MATH 275,A01,098048,Tian; Xiaochuan,6,0,10,4
1668144806025,MATH 278A,A00,098049,Holst; Michael J,8,0,10,2
1668144806478,MATH 278B,A00,098050,Cloninger; Alexander,10,0,10,0
1668144806905,MATH 278C,A00,098051,Nie; Jiawang,7,0,10,3
1668144807355,MATH 280B,A00,098052,Zheng; Tianyi,10,0,15,5
1668144807780,MATH 281B,A00,098053,Bradic; Jelena,2,0,15,13
1668144808203,MATH 282B,A00,098054,Arias-Castro; Ery,0,0,15,15
1668144808636,MATH 285,A00,098055,Fitzsimmons; Patrick J,0,0,15,17
1668144809057,MATH 287B,A00,098056,Arias-Castro; Ery,2,0,15,13
1668144809479,MATH 288,A00,098057,Agarwal; Pooja,9,0,10,1
1668144809479,MATH 288,B00,098058,Zhang; Danna,8,0,10,2
1668144809479,MATH 288,C00,098059,Williams; Ruth J,10,0,10,0
1668144809916,MATH 290B,A00,098060,Roberts; Justin Deritter,13,0,15,2
1668144810354,MATH 292,A00,098061,Belmont; Eva Kinoshita,10,0,10,0
1668144810788,MATH 295,A00,098062,Suk; Andrew Hoon,48,0,50,2
1668144811213,MATH 296,A00,098063,Novak; Jonathan I,20,0,20,0
1668144811634,MATH 297,001,098064,Gamst; Anthony Collins,9997,0,9999,2
1668145317774,COGS 205,A00,101395,Chiba; Andrea,19,0,20,1
1668145318201,COGS 210B,001,101404,Greene; Deanna Jacquelyn,9998,0,9999,1
1668145318201,COGS 210B,002,101417,Xia; Haijun,9999,0,9999,0
1668145318201,COGS 210B,003,101422,Nitz; Douglas A.,9999,0,9999,0
1668145318201,COGS 210B,004,101423,Hollan; James D.,9998,0,9999,1
1668145318201,COGS 210B,005,101424,Deak; Gedeon O.,9998,0,9999,1
1668145318201,COGS 210B,006,101425,Rossano; Federico,9999,0,9999,0
1668145318627,COGS 211B,A00,101427,Coulson; Seana M,9996,0,9999,3
1668145319056,COGS 220,A00,101428,Hollan; James D.,0,0,25,25
1668145319483,COGS 229,A00,101429,Dow; Steven P,18,0,25,7
1668145320027,COGS 230,A00,101430,Klemmer; Scott R,12,0,17,5
1668145320457,COGS 234,A00,101431,Xia; Haijun,3,0,25,22
1668145320899,COGS 260,A00,101432,Kiyonaga; Anastasia,20,0,25,5
1668145320899,COGS 260,B00,101433,Kirsh; David Joel,16,0,25,9
1668145321325,CSE 202,A00,102371,Impagliazzo; Russell,0,0,0,0
1668145321751,CSE 203B,A01,102373,Cheng; Chung Kuan,0,0,0,0
1668145322193,CSE 208,A00,102374,Micciancio; Daniele,0,0,0,0
1668145322614,CSE 209A,A00,112895,Impagliazzo; Russell,0,0,15,15
1668145323039,CSE 209B,A00,108005,Bellare; Mihir,0,0,0,0
1668145323472,CSE 210,A00,113163,Coblenz; Michael J,0,0,0,0
1668145323907,CSE 219,A00,106111,Dow; Steven P,0,0,20,20
1668145324332,CSE 221,A00,102376,Voelker; Geoffrey M.,0,0,0,0
1668145324760,CSE 224,A01,102378,Porter; George M,0,0,0,0
1668145325207,CSE 229A,A00,102379,Savage; Stefan,0,0,0,0
1668145325639,CSE 229C,A00,102380,Munyaka; Imani N. S.,0,0,0,0
1668145326100,CSE 232B,A00,102382,Deutsch; Alin Bernard,0,0,0,0
1668145326524,CSE 234,A01,112904,Kumar; Arun Kumar,0,0,0,0
1668145326976,CSE 237A,A00,102383,Rosing; Tajana Simunic,0,0,0,0
1668145327402,CSE 239A,A00,102384,Deutsch; Alin Bernard,0,0,0,0
1668145327824,CSE 239B,A00,102385,Polikarpova; Nadezhda,0,0,0,0
1668145328256,CSE 240A,A00,102386,Pannuto; Patrick William,0,0,0,0
1668145328697,CSE 240B,A00,102387,Zhao; Jishen,0,0,0,0
1668145329119,CSE 241A,A00,106406,Kang; Mingu,0,0,0,0
1668145329540,CSE 249B,A00,102388,Kahng; Andrew Byun,0,0,8,8
1668145329964,CSE 251B,A01,102392,Cottrell; Garrison W,0,0,0,0
1668145329964,CSE 251B,A02,102393,Cottrell; Garrison W,0,0,0,0
1668145330388,CSE 252B,A00,102394,Ochoa; Benjamin Lawrence,0,0,0,0
1668145330828,CSE 257,A01,102396,Gao; Sicun,0,0,0,0
1668145331279,CSE 272,A00,102397,Li; Tzumao,0,0,0,0
1668145331712,CSE 274,A00,111323,Chern; Albert Ren-Haur,0,0,0,0
1668145332141,CSE 282,A00,102398,Pevzner; Pavel Arkadjevich,0,0,0,0
1668145332586,CSE 284,A00,114175,Gymrek; Melissa Ann,0,0,0,0
1668145333011,CSE 290,A00,102399,Chandraker; Manmohan Krishna,0,0,0,0
1668145333011,CSE 290,B00,102400,Vaccaro; Kristen Marie,0,0,25,25
1668145333011,CSE 290,C00,102414,Pannuto; Patrick William,0,0,25,25
1668145333011,CSE 290,D00,102427,Pevzner; Pavel Arkadjevich,0,0,0,0
1668145333011,CSE 290,E00,102429,Zhao; Jishen,0,0,0,0
1668145333011,CSE 290,F00,102436,Tullsen; Dean Michael,0,0,0,0
1668145333011,CSE 290,G00,102440,Christensen; Henrik I,0,0,20,20
1668145333447,CSE 291,A00,102443,Su; Hao,0,0,0,0
1668145333447,CSE 291,B00,102448,Polikarpova; Nadezhda,0,0,0,0
1668145333447,CSE 291,C00,102453,Vaccaro; Kristen Marie,0,0,0,0
1668145333447,CSE 291,D00,111343,Savage; Stefan,0,0,0,0
1668145333447,CSE 291,E00,116474,Claffy; Kimberly Claire,0,0,0,0
1668145333447,CSE 291,F00,116479,Pasquale; Joseph,0,0,0,0
1668145333881,CSE 293,001,119111,Bafna; Vineet,9999,0,9999,0
1668145333881,CSE 293,002,119118,Bellare; Mihir,9999,0,9999,0
1668145333881,CSE 293,003,119122,Berg-Kirkpatrick; Taylor D,9999,0,9999,0
1668145333881,CSE 293,004,119135,Christensen; Henrik I,9999,0,9999,0
1668145333881,CSE 293,005,119142,Cottrell; Garrison W,9999,0,9999,0
1668145333881,CSE 293,006,119146,Deutsch; Alin Bernard,9999,0,9999,0
1668145333881,CSE 293,007,119159,Esmaeilzadeh; Hadi,9999,0,9999,0
1668145333881,CSE 293,008,119166,Freund; Yoav,9999,0,9999,0
1668145333881,CSE 293,009,119170,Griswold; William G.,9999,0,9999,0
1668145333881,CSE 293,010,119183,Gymrek; Melissa Ann,9999,0,9999,0
1668145333881,CSE 293,011,119190,Heninger; Nadia A,9999,0,9999,0
1668145333881,CSE 293,012,119230,Impagliazzo; Russell,9999,0,9999,0
1668145333881,CSE 293,013,119232,Jhala; Ranjit,9999,0,9999,0
1668145333881,CSE 293,014,119233,Kahng; Andrew Byun,9999,0,9999,0
1668145333881,CSE 293,015,119298,Kane; Daniel Mertz,9999,0,9999,0
1668145333881,CSE 293,016,119299,Kriegman; David J,9999,0,9999,0
1668145333881,CSE 293,017,119300,Kumar; Arun Kumar,9999,0,9999,0
1668145333881,CSE 293,018,119301,Lerner; Sorin,9999,0,9999,0
1668145333881,CSE 293,019,119302,Lovett; Shachar,9999,0,9999,0
1668145333881,CSE 293,020,119303,McAuley; Julian John,9999,0,9999,0
1668145333881,CSE 293,021,119304,Micciancio; Daniele,9999,0,9999,0
1668145333881,CSE 293,022,119367,Orailoglu; Alex,9999,0,9999,0
1668145333881,CSE 293,023,119382,Paturi; Ramamohan,9999,0,9999,0
1668145333881,CSE 293,024,119404,Polikarpova; Nadezhda,9999,0,9999,0
1668145333881,CSE 293,025,119406,Politz; Joseph Gibbs,9999,0,9999,0
1668145333881,CSE 293,026,119411,Porter; George M,9999,0,9999,0
1668145333881,CSE 293,027,119414,Porter; Leonard Emerson,9999,0,9999,0
1668145333881,CSE 293,028,119416,Ramamoorthi; Ravi,9999,0,9999,0
1668145333881,CSE 293,029,119417,Sahoo; Debashis,9999,0,9999,0
1668145333881,CSE 293,030,119420,Saul; Lawrence,9999,0,9999,0
1668145333881,CSE 293,031,119421,Savage; Stefan,9999,0,9999,0
1668145333881,CSE 293,032,119425,Schulze; Jurgen P.,9999,0,9999,0
1668145333881,CSE 293,033,119426,Snoeren; Alex C.,9999,0,9999,0
1668145333881,CSE 293,034,119428,Shang; Jingbo,9999,0,9999,0
1668145333881,CSE 293,035,119430,Stefan; Deian,9999,0,9999,0
1668145333881,CSE 293,036,119431,Su; Hao,9999,0,9999,0
1668145333881,CSE 293,037,119433,Swanson; Steven James,9999,0,9999,0
1668145333881,CSE 293,038,119435,Tullsen; Dean Michael,9999,0,9999,0
1668145333881,CSE 293,039,119483,Voelker; Geoffrey M.,9999,0,9999,0
1668145333881,CSE 293,040,119537,Zhao; Jishen,9999,0,9999,0
1668145333881,CSE 293,041,119538,Zhou; Yuan-Yuan,9999,0,9999,0
1668145333881,CSE 293,042,119539,Gao; Sicun,9999,0,9999,0
1668145333881,CSE 293,043,119540,Weibel; Nadir,9999,0,9999,0
1668145333881,CSE 293,044,119541,Gupta; Rajesh K.,9999,0,9999,0
1668145333881,CSE 293,045,126410,Vaccaro; Kristen Marie,9999,0,9999,0
1668145333881,CSE 293,046,126411,Klemke; Richard,9999,0,9999,0
1668145334317,CSE 294,A00,102459,Voelker; Geoffrey M.,0,0,0,0
1668145334317,CSE 294,B00,111322,Orailoglu; Alex,0,0,0,0
1668145334743,DSE 201,A00,096914,Deutsch; Alin Bernard,30,0,30,0
1668145335185,DSE 210,A00,096915,Dasgupta; Sanjoy,30,0,30,0
1668145335620,DSE 260A,A00,096916,Altintas De Callaf; Ilkay,30,0,30,0
1668145336060,ECE 200,001,103586,Antipa; Nicholas A,9999,0,9999,0
1668145336060,ECE 200,002,103587,Atanasov; Nikolay A.,9999,0,9999,0
1668145336060,ECE 200,003,103588,Bharadia; Dinesh,9999,0,9999,0
1668145336060,ECE 200,004,103589,Cheng; Chung Kuan,9999,0,9999,0
1668145336060,ECE 200,005,103590,Cosman; Pamela C.,9999,0,9999,0
1668145336060,ECE 200,006,103591,Dayeh; Shadi Ahmad,9999,0,9999,0
1668145336060,ECE 200,007,103592,Fainman; Yeshaiahu,9999,0,9999,0
1668145336060,ECE 200,008,103593,Ford; Joseph Earl,9999,0,9999,0
1668145336060,ECE 200,009,103594,Franceschetti; Massimo,9999,0,9999,0
1668145336060,ECE 200,010,103595,Fullerton; Eric E,9999,0,9999,0
1668145336060,ECE 200,011,103596,Galton; Ian A,9999,0,9999,0
1668145336060,ECE 200,012,103597,Gilja; Vikash,9999,0,9999,0
1668145336060,ECE 200,013,103598,Hall; Drew A.,9999,0,9999,0
1668145336060,ECE 200,014,103599,Hsueh; Tzu-Chien,9999,0,9999,0
1668145336060,ECE 200,015,103600,Javidi; Tara,9999,0,9999,0
1668145336060,ECE 200,016,103601,Kahng; Andrew Byun,9999,0,9999,0
1668145336060,ECE 200,017,103602,Kim; Young-Han,9999,0,9999,0
1668145336060,ECE 200,018,103603,Koushanfar; Farinaz,9999,0,9999,0
1668145336060,ECE 200,019,103604,Kuzum; Duygu,9999,0,9999,0
1668145336060,ECE 200,020,103605,Le; Hanh-Phuc,9999,0,9999,0
1668145336060,ECE 200,021,103606,Lin; Bill,9999,0,9999,0
1668145336060,ECE 200,022,103607,Liu; Zhaowei,9998,0,9999,1
1668145336060,ECE 200,023,103608,Lo; Yu-Hwa,9999,0,9999,0
1668145336060,ECE 200,024,103609,Lomakin; Vitaliy,9999,0,9999,0
1668145336060,ECE 200,025,103610,Mercier; Patrick Philip,9999,0,9999,0
1668145336060,ECE 200,026,103611,Meyer; Florian,9999,0,9999,0
1668145336060,ECE 200,027,103612,Milstein; Laurence B.,9999,0,9999,0
1668145336060,ECE 200,028,103613,Mir Arabbaygi; Siavash,9999,0,9999,0
1668145336060,ECE 200,029,103614,Mookherjea; Shayan,9999,0,9999,0
1668145336060,ECE 200,030,103615,Morris; Karcher William,9999,0,9999,0
1668145336060,ECE 200,031,103616,Ng; Tse Nga,9999,0,9999,0
1668145336060,ECE 200,032,103617,Nguyen; Truong Quang,9999,0,9999,0
1668145336060,ECE 200,033,103618,Nomura; Kenji,9999,0,9999,0
1668145336060,ECE 200,034,103619,Orlitsky; Alon,9999,0,9999,0
1668145336060,ECE 200,035,103620,Pal; Piya,9999,0,9999,0
1668145336060,ECE 200,036,103621,Papen; George C.,9999,0,9999,0
1668145336060,ECE 200,037,103622,Radic; Stojan,9999,0,9999,0
1668145336060,ECE 200,038,103623,Rao; Bhaskar D.,9999,0,9999,0
1668145336060,ECE 200,039,103624,Rao; Ramesh R,9999,0,9999,0
1668145336060,ECE 200,040,103625,Rebeiz; Gabriel,9999,0,9999,0
1668145336060,ECE 200,041,103626,Sanford; John R,9999,0,9999,0
1668145336060,ECE 200,042,103627,Siegel; Paul H.,9999,0,9999,0
1668145336060,ECE 200,043,103628,Sievenpiper; Daniel F.,9999,0,9999,0
1668145336060,ECE 200,044,103629,Sworder; David D.,9999,0,9999,0
1668145336060,ECE 200,045,103630,Taur; Yuan,9999,0,9999,0
1668145336060,ECE 200,046,103631,Touri; Behrouz,9999,0,9999,0
1668145336060,ECE 200,047,103632,Trivedi; Mohan M.,9999,0,9999,0
1668145336060,ECE 200,048,103633,Vasconcelos; Nuno,9999,0,9999,0
1668145336060,ECE 200,049,103634,Wang; Xiaolong,9999,0,9999,0
1668145336060,ECE 200,050,103635,Xie; Pengtao,9999,0,9999,0
1668145336060,ECE 200,051,103636,Yip; Michael,9999,0,9999,0
1668145336060,ECE 200,052,103637,Zeger; Kenneth A.,999,0,999,0
1668145336060,ECE 200,053,103638,Zhang; Xinyu,9999,0,9999,0
1668145336060,ECE 200,054,103639,Turakhia; Yatish Girish,9999,0,9999,0
1668145336060,ECE 200,055,103640,Kang; Mingu,9999,0,9999,0
1668145336060,ECE 200,056,103641,Shi; Yuanyuan,9999,0,9999,0
1668145336060,ECE 200,057,103642,Wang; Edward Jay,9999,0,9999,0
1668145336060,ECE 200,058,103643,Zheng; Yang,9999,0,9999,0
1668145336487,ECE 202,A00,103644,Kuzum; Duygu,0,0,0,0
1668145336918,ECE 212BN,A00,103646,Ng; Tse Nga,0,0,0,0
1668145337349,ECE 221,A00,111493,Staff,0,0,0,0
1668145337774,ECE 222B,A00,103647,Lomakin; Vitaliy,0,0,0,0
1668145338222,ECE 230B,A00,103648,Taur; Yuan,0,0,0,0
1668145338665,ECE 238B,A00,103649,Garay; Javier,0,0,0,0
1668145339107,ECE 240B,A00,112900,Fainman; Yeshaiahu,0,0,0,0
1668145339533,ECE 247A,A00,103650,Jokerst; Jesse Vincent,0,0,0,0
1668145339965,ECE 247B,A00,103651,Wang; Joseph,0,0,0,0
1668145340399,ECE 250,A00,103652,Siegel; Paul H.,0,0,0,0
1668145340840,ECE 251A,A00,103654,Rao; Bhaskar D.,0,0,0,0
1668145341283,ECE 257B,A00,103655,Bharadia; Dinesh,0,0,0,0
1668145341722,ECE 258A,A00,103656,Milstein; Laurence B.,0,0,0,0
1668145342146,ECE 260B,A00,103658,Kang; Mingu,0,0,0,0
1668145342584,ECE 264A,A00,103659,Galton; Ian A,0,0,0,0
1668145343008,ECE 265A,A00,103661,Gudem; Prasad S.S.,0,0,0,0
1668145343442,ECE 265D,A00,103662,Gudem; Prasad S.S.,0,0,0,0
1668145343888,ECE 268,A00,103663,Koushanfar; Farinaz,0,0,0,0
1668145344327,ECE 269,A01,103665,Pal; Piya,0,0,0,0
1668145344767,ECE 271B,A00,103666,Vasconcelos; Manuela,0,0,0,0
1668145345191,ECE 276A,A00,103667,Atanasov; Nikolay A.,0,0,0,0
1668145345634,ECE 277,A00,103668,An; Cheolhong,0,0,0,0
1668145346069,ECE 279,A00,117947,Hall; Drew A.,0,0,0,0
1668145346963,ECE 283,A00,103670,Hsueh; Tzu-Chien,0,0,0,0
1668145347389,ECE 284,A00,103671,Turakhia; Yatish Girish,0,0,0,0
1668145347817,ECE 285,A00,103672,Zheng; Yang,0,0,0,0
1668145347817,ECE 285,B00,103673,Sworder; David D.,0,0,0,0
1668145348333,ECE 287,A00,103676,Javidi; Tara,0,0,0,0
1668145348770,MATH 200B,A00,098023,Salehi Golsefidy; Alireza,12,0,15,3
1668145349201,MATH 202B,A00,098024,Rhoades; Brendon Patrick,9,0,15,6
1668145349625,MATH 203B,A00,098025,Oprea; Dragos N.,10,0,15,5
1668145350059,MATH 204B,A00,098026,Sorensen; Claus M,13,0,15,2
1668145350509,MATH 208,A00,098027,Izadi; Elham,7,0,10,3
1668145350945,MATH 209,A00,098028,Pollack; Aaron,10,0,10,0
1668145351371,MATH 211A,A00,112919,Rogalski; Daniel,9,0,10,1
1668145351799,MATH 211B,A00,112920,Seward; Brandon M.,9,0,10,1
1668145352236,MATH 218,A00,098029,Li; Bo,10,0,10,0
1668145352659,MATH 220B,A00,098030,Novak; Jonathan I,11,0,15,4
1668145353087,MATH 221A,A00,098031,Ebenfelt; Peter F,13,0,15,2
1668145353518,MATH 231B,A00,098032,Zlatos; Andrej,12,0,15,3
1668145353957,MATH 240B,A00,098033,Ni; Lei,9,0,15,6
1668145354406,MATH 243,A00,098034,Jekel; David Andrew,10,0,10,0
1668145354847,MATH 245A,A00,098035,Nie; Jiawang,0,0,15,16
1668145355290,MATH 248,A00,098036,Bejenaru; Ioan,10,0,10,0
1668145355730,MATH 250B,A00,098037,Spolaor; Luca,14,0,15,1
1668145356165,MATH 258,A00,098038,Ni; Lei,10,0,10,0
1668145356596,MATH 264B,A00,098041,Rhoades; Brendon Patrick,9,0,15,6
1668145357048,MATH 268,A00,098042,Buss; Samuel R,10,0,10,0
1668145357489,MATH 269,A00,098043,Rhoades; Brendon Patrick,10,0,10,0
1668145357918,MATH 270B,A00,098044,Li; Bo,10,0,15,5
1668145358362,MATH 272B,A00,098045,Holst; Michael J,13,0,15,2
1668145358800,MATH 273A,A00,098046,Tian; Xiaochuan,10,0,15,5
1668145359236,MATH 275,A01,098048,Tian; Xiaochuan,6,0,10,4
1668145359671,MATH 278A,A00,098049,Holst; Michael J,8,0,10,2
1668145360111,MATH 278B,A00,098050,Cloninger; Alexander,10,0,10,0
1668145360534,MATH 278C,A00,098051,Nie; Jiawang,7,0,10,3
1668145360970,MATH 280B,A00,098052,Zheng; Tianyi,10,0,15,5
1668145361407,MATH 281B,A00,098053,Bradic; Jelena,2,0,15,13
1668145361830,MATH 282B,A00,098054,Arias-Castro; Ery,0,0,15,15
1668145362266,MATH 285,A00,098055,Fitzsimmons; Patrick J,0,0,15,17
1668145362689,MATH 287B,A00,098056,Arias-Castro; Ery,2,0,15,13
1668145363115,MATH 288,A00,098057,Agarwal; Pooja,9,0,10,1
1668145363115,MATH 288,B00,098058,Zhang; Danna,8,0,10,2
1668145363115,MATH 288,C00,098059,Williams; Ruth J,10,0,10,0
1668145363548,MATH 290B,A00,098060,Roberts; Justin Deritter,13,0,15,2
1668145363998,MATH 292,A00,098061,Belmont; Eva Kinoshita,10,0,10,0
1668145364420,MATH 295,A00,098062,Suk; Andrew Hoon,48,0,50,2
1668145364859,MATH 296,A00,098063,Novak; Jonathan I,20,0,20,0
1668145365283,MATH 297,001,098064,Gamst; Anthony Collins,9997,0,9999,2
1668145871434,COGS 205,A00,101395,Chiba; Andrea,19,0,20,1
1668145871865,COGS 210B,001,101404,Greene; Deanna Jacquelyn,9998,0,9999,1
1668145871865,COGS 210B,002,101417,Xia; Haijun,9999,0,9999,0
1668145871865,COGS 210B,003,101422,Nitz; Douglas A.,9999,0,9999,0
1668145871865,COGS 210B,004,101423,Hollan; James D.,9998,0,9999,1
1668145871865,COGS 210B,005,101424,Deak; Gedeon O.,9998,0,9999,1
1668145871865,COGS 210B,006,101425,Rossano; Federico,9999,0,9999,0
1668145872289,COGS 211B,A00,101427,Coulson; Seana M,9996,0,9999,3
1668145872713,COGS 220,A00,101428,Hollan; James D.,0,0,25,25
1668145873139,COGS 229,A00,101429,Dow; Steven P,18,0,25,7
1668145873567,COGS 230,A00,101430,Klemmer; Scott R,12,0,17,5
1668145873991,COGS 234,A00,101431,Xia; Haijun,3,0,25,22
1668145874414,COGS 260,A00,101432,Kiyonaga; Anastasia,20,0,25,5
1668145874414,COGS 260,B00,101433,Kirsh; David Joel,16,0,25,9
1668145874942,CSE 202,A00,102371,Impagliazzo; Russell,0,0,0,0
1668145875379,CSE 203B,A01,102373,Cheng; Chung Kuan,0,0,0,0
1668145875800,CSE 208,A00,102374,Micciancio; Daniele,0,0,0,0
1668145876224,CSE 209A,A00,112895,Impagliazzo; Russell,0,0,15,15
1668145876651,CSE 209B,A00,108005,Bellare; Mihir,0,0,0,0
1668145877075,CSE 210,A00,113163,Coblenz; Michael J,0,0,0,0
1668145877513,CSE 219,A00,106111,Dow; Steven P,0,0,20,20
1668145877937,CSE 221,A00,102376,Voelker; Geoffrey M.,0,0,0,0
1668145878361,CSE 224,A01,102378,Porter; George M,0,0,0,0
1668145878786,CSE 229A,A00,102379,Savage; Stefan,0,0,0,0
1668145879218,CSE 229C,A00,102380,Munyaka; Imani N. S.,0,0,0,0
1668145879643,CSE 232B,A00,102382,Deutsch; Alin Bernard,0,0,0,0
1668145880078,CSE 234,A01,112904,Kumar; Arun Kumar,0,0,0,0
1668145880507,CSE 237A,A00,102383,Rosing; Tajana Simunic,0,0,0,0
1668145880931,CSE 239A,A00,102384,Deutsch; Alin Bernard,0,0,0,0
1668145881358,CSE 239B,A00,102385,Polikarpova; Nadezhda,0,0,0,0
1668145881784,CSE 240A,A00,102386,Pannuto; Patrick William,0,0,0,0
1668145882209,CSE 240B,A00,102387,Zhao; Jishen,0,0,0,0
1668145882642,CSE 241A,A00,106406,Kang; Mingu,0,0,0,0
1668145883073,CSE 249B,A00,102388,Kahng; Andrew Byun,0,0,8,8
1668145883495,CSE 251B,A01,102392,Cottrell; Garrison W,0,0,0,0
1668145883495,CSE 251B,A02,102393,Cottrell; Garrison W,0,0,0,0
1668145883930,CSE 252B,A00,102394,Ochoa; Benjamin Lawrence,0,0,0,0
1668145884359,CSE 257,A01,102396,Gao; Sicun,0,0,0,0
1668145884781,CSE 272,A00,102397,Li; Tzumao,0,0,0,0
1668145885206,CSE 274,A00,111323,Chern; Albert Ren-Haur,0,0,0,0
1668145885627,CSE 282,A00,102398,Pevzner; Pavel Arkadjevich,0,0,0,0
1668145886057,CSE 284,A00,114175,Gymrek; Melissa Ann,0,0,0,0
1668145886491,CSE 290,A00,102399,Chandraker; Manmohan Krishna,0,0,0,0
1668145886491,CSE 290,B00,102400,Vaccaro; Kristen Marie,0,0,25,25
1668145886491,CSE 290,C00,102414,Pannuto; Patrick William,0,0,25,25
1668145886491,CSE 290,D00,102427,Pevzner; Pavel Arkadjevich,0,0,0,0
1668145886491,CSE 290,E00,102429,Zhao; Jishen,0,0,0,0
1668145886491,CSE 290,F00,102436,Tullsen; Dean Michael,0,0,0,0
1668145886491,CSE 290,G00,102440,Christensen; Henrik I,0,0,20,20
1668145886921,CSE 291,A00,102443,Su; Hao,0,0,0,0
1668145886921,CSE 291,B00,102448,Polikarpova; Nadezhda,0,0,0,0
1668145886921,CSE 291,C00,102453,Vaccaro; Kristen Marie,0,0,0,0
1668145886921,CSE 291,D00,111343,Savage; Stefan,0,0,0,0
1668145886921,CSE 291,E00,116474,Claffy; Kimberly Claire,0,0,0,0
1668145886921,CSE 291,F00,116479,Pasquale; Joseph,0,0,0,0
1668145887391,CSE 293,001,119111,Bafna; Vineet,9999,0,9999,0
1668145887391,CSE 293,002,119118,Bellare; Mihir,9999,0,9999,0
1668145887391,CSE 293,003,119122,Berg-Kirkpatrick; Taylor D,9999,0,9999,0
1668145887391,CSE 293,004,119135,Christensen; Henrik I,9999,0,9999,0
1668145887391,CSE 293,005,119142,Cottrell; Garrison W,9999,0,9999,0
1668145887391,CSE 293,006,119146,Deutsch; Alin Bernard,9999,0,9999,0
1668145887391,CSE 293,007,119159,Esmaeilzadeh; Hadi,9999,0,9999,0
1668145887391,CSE 293,008,119166,Freund; Yoav,9999,0,9999,0
1668145887391,CSE 293,009,119170,Griswold; William G.,9999,0,9999,0
1668145887391,CSE 293,010,119183,Gymrek; Melissa Ann,9999,0,9999,0
1668145887391,CSE 293,011,119190,Heninger; Nadia A,9999,0,9999,0
1668145887391,CSE 293,012,119230,Impagliazzo; Russell,9999,0,9999,0
1668145887391,CSE 293,013,119232,Jhala; Ranjit,9999,0,9999,0
1668145887391,CSE 293,014,119233,Kahng; Andrew Byun,9999,0,9999,0
1668145887391,CSE 293,015,119298,Kane; Daniel Mertz,9999,0,9999,0
1668145887391,CSE 293,016,119299,Kriegman; David J,9999,0,9999,0
1668145887391,CSE 293,017,119300,Kumar; Arun Kumar,9999,0,9999,0
1668145887391,CSE 293,018,119301,Lerner; Sorin,9999,0,9999,0
1668145887391,CSE 293,019,119302,Lovett; Shachar,9999,0,9999,0
1668145887391,CSE 293,020,119303,McAuley; Julian John,9999,0,9999,0
1668145887391,CSE 293,021,119304,Micciancio; Daniele,9999,0,9999,0
1668145887391,CSE 293,022,119367,Orailoglu; Alex,9999,0,9999,0
1668145887391,CSE 293,023,119382,Paturi; Ramamohan,9999,0,9999,0
1668145887391,CSE 293,024,119404,Polikarpova; Nadezhda,9999,0,9999,0
1668145887391,CSE 293,025,119406,Politz; Joseph Gibbs,9999,0,9999,0
1668145887391,CSE 293,026,119411,Porter; George M,9999,0,9999,0
1668145887391,CSE 293,027,119414,Porter; Leonard Emerson,9999,0,9999,0
1668145887391,CSE 293,028,119416,Ramamoorthi; Ravi,9999,0,9999,0
1668145887391,CSE 293,029,119417,Sahoo; Debashis,9999,0,9999,0
1668145887391,CSE 293,030,119420,Saul; Lawrence,9999,0,9999,0
1668145887391,CSE 293,031,119421,Savage; Stefan,9999,0,9999,0
1668145887391,CSE 293,032,119425,Schulze; Jurgen P.,9999,0,9999,0
1668145887391,CSE 293,033,119426,Snoeren; Alex C.,9999,0,9999,0
1668145887391,CSE 293,034,119428,Shang; Jingbo,9999,0,9999,0
1668145887391,CSE 293,035,119430,Stefan; Deian,9999,0,9999,0
1668145887391,CSE 293,036,119431,Su; Hao,9999,0,9999,0
1668145887391,CSE 293,037,119433,Swanson; Steven James,9999,0,9999,0
1668145887391,CSE 293,038,119435,Tullsen; Dean Michael,9999,0,9999,0
1668145887391,CSE 293,039,119483,Voelker; Geoffrey M.,9999,0,9999,0
1668145887391,CSE 293,040,119537,Zhao; Jishen,9999,0,9999,0
1668145887391,CSE 293,041,119538,Zhou; Yuan-Yuan,9999,0,9999,0
1668145887391,CSE 293,042,119539,Gao; Sicun,9999,0,9999,0
1668145887391,CSE 293,043,119540,Weibel; Nadir,9999,0,9999,0
1668145887391,CSE 293,044,119541,Gupta; Rajesh K.,9999,0,9999,0
1668145887391,CSE 293,045,126410,Vaccaro; Kristen Marie,9999,0,9999,0
1668145887391,CSE 293,046,126411,Klemke; Richard,9999,0,9999,0
1668145887816,CSE 294,A00,102459,Voelker; Geoffrey M.,0,0,0,0
1668145887816,CSE 294,B00,111322,Orailoglu; Alex,0,0,0,0
1668145888253,DSE 201,A00,096914,Deutsch; Alin Bernard,30,0,30,0
1668145888682,DSE 210,A00,096915,Dasgupta; Sanjoy,30,0,30,0
1668145889105,DSE 260A,A00,096916,Altintas De Callaf; Ilkay,30,0,30,0
1668145889535,ECE 200,001,103586,Antipa; Nicholas A,9999,0,9999,0
1668145889535,ECE 200,002,103587,Atanasov; Nikolay A.,9999,0,9999,0
1668145889535,ECE 200,003,103588,Bharadia; Dinesh,9999,0,9999,0
1668145889535,ECE 200,004,103589,Cheng; Chung Kuan,9999,0,9999,0
1668145889535,ECE 200,005,103590,Cosman; Pamela C.,9999,0,9999,0
1668145889535,ECE 200,006,103591,Dayeh; Shadi Ahmad,9999,0,9999,0
1668145889535,ECE 200,007,103592,Fainman; Yeshaiahu,9999,0,9999,0
1668145889535,ECE 200,008,103593,Ford; Joseph Earl,9999,0,9999,0
1668145889535,ECE 200,009,103594,Franceschetti; Massimo,9999,0,9999,0
1668145889535,ECE 200,010,103595,Fullerton; Eric E,9999,0,9999,0
1668145889535,ECE 200,011,103596,Galton; Ian A,9999,0,9999,0
1668145889535,ECE 200,012,103597,Gilja; Vikash,9999,0,9999,0
1668145889535,ECE 200,013,103598,Hall; Drew A.,9999,0,9999,0
1668145889535,ECE 200,014,103599,Hsueh; Tzu-Chien,9999,0,9999,0
1668145889535,ECE 200,015,103600,Javidi; Tara,9999,0,9999,0
1668145889535,ECE 200,016,103601,Kahng; Andrew Byun,9999,0,9999,0
1668145889535,ECE 200,017,103602,Kim; Young-Han,9999,0,9999,0
1668145889535,ECE 200,018,103603,Koushanfar; Farinaz,9999,0,9999,0
1668145889535,ECE 200,019,103604,Kuzum; Duygu,9999,0,9999,0
1668145889535,ECE 200,020,103605,Le; Hanh-Phuc,9999,0,9999,0
1668145889535,ECE 200,021,103606,Lin; Bill,9999,0,9999,0
1668145889535,ECE 200,022,103607,Liu; Zhaowei,9998,0,9999,1
1668145889535,ECE 200,023,103608,Lo; Yu-Hwa,9999,0,9999,0
1668145889535,ECE 200,024,103609,Lomakin; Vitaliy,9999,0,9999,0
1668145889535,ECE 200,025,103610,Mercier; Patrick Philip,9999,0,9999,0
1668145889535,ECE 200,026,103611,Meyer; Florian,9999,0,9999,0
1668145889535,ECE 200,027,103612,Milstein; Laurence B.,9999,0,9999,0
1668145889535,ECE 200,028,103613,Mir Arabbaygi; Siavash,9999,0,9999,0
1668145889535,ECE 200,029,103614,Mookherjea; Shayan,9999,0,9999,0
1668145889535,ECE 200,030,103615,Morris; Karcher William,9999,0,9999,0
1668145889535,ECE 200,031,103616,Ng; Tse Nga,9999,0,9999,0
1668145889535,ECE 200,032,103617,Nguyen; Truong Quang,9999,0,9999,0
1668145889535,ECE 200,033,103618,Nomura; Kenji,9999,0,9999,0
1668145889535,ECE 200,034,103619,Orlitsky; Alon,9999,0,9999,0
1668145889535,ECE 200,035,103620,Pal; Piya,9999,0,9999,0
1668145889535,ECE 200,036,103621,Papen; George C.,9999,0,9999,0
1668145889535,ECE 200,037,103622,Radic; Stojan,9999,0,9999,0
1668145889535,ECE 200,038,103623,Rao; Bhaskar D.,9999,0,9999,0
1668145889535,ECE 200,039,103624,Rao; Ramesh R,9999,0,9999,0
1668145889535,ECE 200,040,103625,Rebeiz; Gabriel,9999,0,9999,0
1668145889535,ECE 200,041,103626,Sanford; John R,9999,0,9999,0
1668145889535,ECE 200,042,103627,Siegel; Paul H.,9999,0,9999,0
1668145889535,ECE 200,043,103628,Sievenpiper; Daniel F.,9999,0,9999,0
1668145889535,ECE 200,044,103629,Sworder; David D.,9999,0,9999,0
1668145889535,ECE 200,045,103630,Taur; Yuan,9999,0,9999,0
1668145889535,ECE 200,046,103631,Touri; Behrouz,9999,0,9999,0
1668145889535,ECE 200,047,103632,Trivedi; Mohan M.,9999,0,9999,0
1668145889535,ECE 200,048,103633,Vasconcelos; Nuno,9999,0,9999,0
1668145889535,ECE 200,049,103634,Wang; Xiaolong,9999,0,9999,0
1668145889535,ECE 200,050,103635,Xie; Pengtao,9999,0,9999,0
1668145889535,ECE 200,051,103636,Yip; Michael,9999,0,9999,0
1668145889535,ECE 200,052,103637,Zeger; Kenneth A.,999,0,999,0
1668145889535,ECE 200,053,103638,Zhang; Xinyu,9999,0,9999,0
1668145889535,ECE 200,054,103639,Turakhia; Yatish Girish,9999,0,9999,0
1668145889535,ECE 200,055,103640,Kang; Mingu,9999,0,9999,0
1668145889535,ECE 200,056,103641,Shi; Yuanyuan,9999,0,9999,0
1668145889535,ECE 200,057,103642,Wang; Edward Jay,9999,0,9999,0
1668145889535,ECE 200,058,103643,Zheng; Yang,9999,0,9999,0
1668145889962,ECE 202,A00,103644,Kuzum; Duygu,0,0,0,0
1668145890399,ECE 212BN,A00,103646,Ng; Tse Nga,0,0,0,0
1668145890823,ECE 221,A00,111493,Staff,0,0,0,0
1668145891248,ECE 222B,A00,103647,Lomakin; Vitaliy,0,0,0,0
1668145891678,ECE 230B,A00,103648,Taur; Yuan,0,0,0,0
1668145892106,ECE 238B,A00,103649,Garay; Javier,0,0,0,0
1668145892529,ECE 240B,A00,112900,Fainman; Yeshaiahu,0,0,0,0
1668145892954,ECE 247A,A00,103650,Jokerst; Jesse Vincent,0,0,0,0
1668145893376,ECE 247B,A00,103651,Wang; Joseph,0,0,0,0
1668145893801,ECE 250,A00,103652,Siegel; Paul H.,0,0,0,0
1668145894226,ECE 251A,A00,103654,Rao; Bhaskar D.,0,0,0,0
1668145894651,ECE 257B,A00,103655,Bharadia; Dinesh,0,0,0,0
1668145895075,ECE 258A,A00,103656,Milstein; Laurence B.,0,0,0,0
1668145895503,ECE 260B,A00,103658,Kang; Mingu,0,0,0,0
1668145895928,ECE 264A,A00,103659,Galton; Ian A,0,0,0,0
1668145896351,ECE 265A,A00,103661,Gudem; Prasad S.S.,0,0,0,0
1668145896780,ECE 265D,A00,103662,Gudem; Prasad S.S.,0,0,0,0
1668145897203,ECE 268,A00,103663,Koushanfar; Farinaz,0,0,0,0
1668145897629,ECE 269,A01,103665,Pal; Piya,0,0,0,0
1668145898051,ECE 271B,A00,103666,Vasconcelos; Manuela,0,0,0,0
1668145898479,ECE 276A,A00,103667,Atanasov; Nikolay A.,0,0,0,0
1668145898901,ECE 277,A00,103668,An; Cheolhong,0,0,0,0
1668145899331,ECE 279,A00,117947,Hall; Drew A.,0,0,0,0
1668145900195,ECE 283,A00,103670,Hsueh; Tzu-Chien,0,0,0,0
1668145900618,ECE 284,A00,103671,Turakhia; Yatish Girish,0,0,0,0
1668145901061,ECE 285,A00,103672,Zheng; Yang,0,0,0,0
1668145901061,ECE 285,B00,103673,Sworder; David D.,0,0,0,0
1668145901484,ECE 287,A00,103676,Javidi; Tara,0,0,0,0
1668145901912,MATH 200B,A00,098023,Salehi Golsefidy; Alireza,12,0,15,3
1668145902337,MATH 202B,A00,098024,Rhoades; Brendon Patrick,9,0,15,6
1668145902767,MATH 203B,A00,098025,Oprea; Dragos N.,10,0,15,5
1668145903197,MATH 204B,A00,098026,Sorensen; Claus M,13,0,15,2
1668145903650,MATH 208,A00,098027,Izadi; Elham,7,0,10,3
1668145904085,MATH 209,A00,098028,Pollack; Aaron,10,0,10,0
1668145904514,MATH 211A,A00,112919,Rogalski; Daniel,9,0,10,1
1668145904940,MATH 211B,A00,112920,Seward; Brandon M.,9,0,10,1
1668145905362,MATH 218,A00,098029,Li; Bo,10,0,10,0
1668145905792,MATH 220B,A00,098030,Novak; Jonathan I,11,0,15,4
1668145906216,MATH 221A,A00,098031,Ebenfelt; Peter F,13,0,15,2
1668145906643,MATH 231B,A00,098032,Zlatos; Andrej,12,0,15,3
1668145907066,MATH 240B,A00,098033,Ni; Lei,9,0,15,6
1668145907493,MATH 243,A00,098034,Jekel; David Andrew,10,0,10,0
1668145907923,MATH 245A,A00,098035,Nie; Jiawang,0,0,15,16
1668145908348,MATH 248,A00,098036,Bejenaru; Ioan,10,0,10,0
1668145908774,MATH 250B,A00,098037,Spolaor; Luca,14,0,15,1
1668145909197,MATH 258,A00,098038,Ni; Lei,10,0,10,0
1668145909635,MATH 264B,A00,098041,Rhoades; Brendon Patrick,9,0,15,6
1668145910060,MATH 268,A00,098042,Buss; Samuel R,10,0,10,0
1668145910482,MATH 269,A00,098043,Rhoades; Brendon Patrick,10,0,10,0
1668145910907,MATH 270B,A00,098044,Li; Bo,10,0,15,5
1668145911332,MATH 272B,A00,098045,Holst; Michael J,13,0,15,2
1668145911754,MATH 273A,A00,098046,Tian; Xiaochuan,10,0,15,5
1668145912178,MATH 275,A01,098048,Tian; Xiaochuan,6,0,10,4
1668145912609,MATH 278A,A00,098049,Holst; Michael J,8,0,10,2
1668145913030,MATH 278B,A00,098050,Cloninger; Alexander,10,0,10,0
1668145913454,MATH 278C,A00,098051,Nie; Jiawang,7,0,10,3
1668145913881,MATH 280B,A00,098052,Zheng; Tianyi,10,0,15,5
1668145914310,MATH 281B,A00,098053,Bradic; Jelena,2,0,15,13
1668145914737,MATH 282B,A00,098054,Arias-Castro; Ery,0,0,15,15
1668145915161,MATH 285,A00,098055,Fitzsimmons; Patrick J,0,0,15,17
1668145915586,MATH 287B,A00,098056,Arias-Castro; Ery,2,0,15,13
1668145916018,MATH 288,A00,098057,Agarwal; Pooja,9,0,10,1
1668145916018,MATH 288,B00,098058,Zhang; Danna,8,0,10,2
1668145916018,MATH 288,C00,098059,Williams; Ruth J,10,0,10,0
1668145916439,MATH 290B,A00,098060,Roberts; Justin Deritter,13,0,15,2
1668145916865,MATH 292,A00,098061,Belmont; Eva Kinoshita,10,0,10,0
1668145917297,MATH 295,A00,098062,Suk; Andrew Hoon,48,0,50,2
1668145917719,MATH 296,A00,098063,Novak; Jonathan I,20,0,20,0
1668145918247,MATH 297,001,098064,Gamst; Anthony Collins,9997,0,9999,2
1668146420985,COGS 205,A00,101395,Chiba; Andrea,19,0,20,1
1668146421420,COGS 210B,001,101404,Greene; Deanna Jacquelyn,9998,0,9999,1
1668146421420,COGS 210B,002,101417,Xia; Haijun,9999,0,9999,0
1668146421420,COGS 210B,003,101422,Nitz; Douglas A.,9999,0,9999,0
1668146421420,COGS 210B,004,101423,Hollan; James D.,9998,0,9999,1
1668146421420,COGS 210B,005,101424,Deak; Gedeon O.,9998,0,9999,1
1668146421420,COGS 210B,006,101425,Rossano; Federico,9999,0,9999,0
1668146421848,COGS 211B,A00,101427,Coulson; Seana M,9996,0,9999,3
1668146422272,COGS 220,A00,101428,Hollan; James D.,0,0,25,25
1668146422696,COGS 229,A00,101429,Dow; Steven P,18,0,25,7
1668146423123,COGS 230,A00,101430,Klemmer; Scott R,12,0,17,5
1668146423575,COGS 234,A00,101431,Xia; Haijun,3,0,25,22
1668146424001,COGS 260,A00,101432,Kiyonaga; Anastasia,20,0,25,5
1668146424001,COGS 260,B00,101433,Kirsh; David Joel,16,0,25,9
1668146424428,CSE 202,A00,102371,Impagliazzo; Russell,0,0,0,0
1668146424858,CSE 203B,A01,102373,Cheng; Chung Kuan,0,0,0,0
1668146425280,CSE 208,A00,102374,Micciancio; Daniele,0,0,0,0
1668146425703,CSE 209A,A00,112895,Impagliazzo; Russell,0,0,15,15
1668146426128,CSE 209B,A00,108005,Bellare; Mihir,0,0,0,0
1668146426583,CSE 210,A00,113163,Coblenz; Michael J,0,0,0,0
1668146427025,CSE 219,A00,106111,Dow; Steven P,0,0,20,20
1668146427456,CSE 221,A00,102376,Voelker; Geoffrey M.,0,0,0,0
1668146427886,CSE 224,A01,102378,Porter; George M,0,0,0,0
1668146428313,CSE 229A,A00,102379,Savage; Stefan,0,0,0,0
1668146428740,CSE 229C,A00,102380,Munyaka; Imani N. S.,0,0,0,0
1668146429186,CSE 232B,A00,102382,Deutsch; Alin Bernard,0,0,0,0
1668146429623,CSE 234,A01,112904,Kumar; Arun Kumar,0,0,0,0
1668146430046,CSE 237A,A00,102383,Rosing; Tajana Simunic,0,0,0,0
1668146430469,CSE 239A,A00,102384,Deutsch; Alin Bernard,0,0,0,0
1668146430896,CSE 239B,A00,102385,Polikarpova; Nadezhda,0,0,0,0
1668146431318,CSE 240A,A00,102386,Pannuto; Patrick William,0,0,0,0
1668146431747,CSE 240B,A00,102387,Zhao; Jishen,0,0,0,0
1668146432170,CSE 241A,A00,106406,Kang; Mingu,0,0,0,0
1668146432594,CSE 249B,A00,102388,Kahng; Andrew Byun,0,0,8,8
1668146433026,CSE 251B,A01,102392,Cottrell; Garrison W,0,0,0,0
1668146433026,CSE 251B,A02,102393,Cottrell; Garrison W,0,0,0,0
1668146433449,CSE 252B,A00,102394,Ochoa; Benjamin Lawrence,0,0,0,0
1668146433874,CSE 257,A01,102396,Gao; Sicun,0,0,0,0
1668146434297,CSE 272,A00,102397,Li; Tzumao,0,0,0,0
1668146434718,CSE 274,A00,111323,Chern; Albert Ren-Haur,0,0,0,0
1668146435145,CSE 282,A00,102398,Pevzner; Pavel Arkadjevich,0,0,0,0
1668146435580,CSE 284,A00,114175,Gymrek; Melissa Ann,0,0,0,0
1668146436007,CSE 290,A00,102399,Chandraker; Manmohan Krishna,0,0,0,0
1668146436007,CSE 290,B00,102400,Vaccaro; Kristen Marie,0,0,25,25
1668146436007,CSE 290,C00,102414,Pannuto; Patrick William,0,0,25,25
1668146436007,CSE 290,D00,102427,Pevzner; Pavel Arkadjevich,0,0,0,0
1668146436007,CSE 290,E00,102429,Zhao; Jishen,0,0,0,0
1668146436007,CSE 290,F00,102436,Tullsen; Dean Michael,0,0,0,0
1668146436007,CSE 290,G00,102440,Christensen; Henrik I,0,0,20,20
1668146436441,CSE 291,A00,102443,Su; Hao,0,0,0,0
1668146436441,CSE 291,B00,102448,Polikarpova; Nadezhda,0,0,0,0
1668146436441,CSE 291,C00,102453,Vaccaro; Kristen Marie,0,0,0,0
1668146436441,CSE 291,D00,111343,Savage; Stefan,0,0,0,0
1668146436441,CSE 291,E00,116474,Claffy; Kimberly Claire,0,0,0,0
1668146436441,CSE 291,F00,116479,Pasquale; Joseph,0,0,0,0
1668146436867,CSE 293,001,119111,Bafna; Vineet,9999,0,9999,0
1668146436867,CSE 293,002,119118,Bellare; Mihir,9999,0,9999,0
1668146436867,CSE 293,003,119122,Berg-Kirkpatrick; Taylor D,9999,0,9999,0
1668146436867,CSE 293,004,119135,Christensen; Henrik I,9999,0,9999,0
1668146436867,CSE 293,005,119142,Cottrell; Garrison W,9999,0,9999,0
1668146436867,CSE 293,006,119146,Deutsch; Alin Bernard,9999,0,9999,0
1668146436867,CSE 293,007,119159,Esmaeilzadeh; Hadi,9999,0,9999,0
1668146436867,CSE 293,008,119166,Freund; Yoav,9999,0,9999,0
1668146436867,CSE 293,009,119170,Griswold; William G.,9999,0,9999,0
1668146436867,CSE 293,010,119183,Gymrek; Melissa Ann,9999,0,9999,0
1668146436867,CSE 293,011,119190,Heninger; Nadia A,9999,0,9999,0
1668146436867,CSE 293,012,119230,Impagliazzo; Russell,9999,0,9999,0
1668146436867,CSE 293,013,119232,Jhala; Ranjit,9999,0,9999,0
1668146436867,CSE 293,014,119233,Kahng; Andrew Byun,9999,0,9999,0
1668146436867,CSE 293,015,119298,Kane; Daniel Mertz,9999,0,9999,0
1668146436867,CSE 293,016,119299,Kriegman; David J,9999,0,9999,0
1668146436867,CSE 293,017,119300,Kumar; Arun Kumar,9999,0,9999,0
1668146436867,CSE 293,018,119301,Lerner; Sorin,9999,0,9999,0
1668146436867,CSE 293,019,119302,Lovett; Shachar,9999,0,9999,0
1668146436867,CSE 293,020,119303,McAuley; Julian John,9999,0,9999,0
1668146436867,CSE 293,021,119304,Micciancio; Daniele,9999,0,9999,0
1668146436867,CSE 293,022,119367,Orailoglu; Alex,9999,0,9999,0
1668146436867,CSE 293,023,119382,Paturi; Ramamohan,9999,0,9999,0
1668146436867,CSE 293,024,119404,Polikarpova; Nadezhda,9999,0,9999,0
1668146436867,CSE 293,025,119406,Politz; Joseph Gibbs,9999,0,9999,0
1668146436867,CSE 293,026,119411,Porter; George M,9999,0,9999,0
1668146436867,CSE 293,027,119414,Porter; Leonard Emerson,9999,0,9999,0
1668146436867,CSE 293,028,119416,Ramamoorthi; Ravi,9999,0,9999,0
1668146436867,CSE 293,029,119417,Sahoo; Debashis,9999,0,9999,0
1668146436867,CSE 293,030,119420,Saul; Lawrence,9999,0,9999,0
1668146436867,CSE 293,031,119421,Savage; Stefan,9999,0,9999,0
1668146436867,CSE 293,032,119425,Schulze; Jurgen P.,9999,0,9999,0
1668146436867,CSE 293,033,119426,Snoeren; Alex C.,9999,0,9999,0
1668146436867,CSE 293,034,119428,Shang; Jingbo,9999,0,9999,0
1668146436867,CSE 293,035,119430,Stefan; Deian,9999,0,9999,0
1668146436867,CSE 293,036,119431,Su; Hao,9999,0,9999,0
1668146436867,CSE 293,037,119433,Swanson; Steven James,9999,0,9999,0
1668146436867,CSE 293,038,119435,Tullsen; Dean Michael,9999,0,9999,0
1668146436867,CSE 293,039,119483,Voelker; Geoffrey M.,9999,0,9999,0
1668146436867,CSE 293,040,119537,Zhao; Jishen,9999,0,9999,0
1668146436867,CSE 293,041,119538,Zhou; Yuan-Yuan,9999,0,9999,0
1668146436867,CSE 293,042,119539,Gao; Sicun,9999,0,9999,0
1668146436867,CSE 293,043,119540,Weibel; Nadir,9999,0,9999,0
1668146436867,CSE 293,044,119541,Gupta; Rajesh K.,9999,0,9999,0
1668146436867,CSE 293,045,126410,Vaccaro; Kristen Marie,9999,0,9999,0
1668146436867,CSE 293,046,126411,Klemke; Richard,9999,0,9999,0
1668146437292,CSE 294,A00,102459,Voelker; Geoffrey M.,0,0,0,0
1668146437292,CSE 294,B00,111322,Orailoglu; Alex,0,0,0,0
1668146437718,DSE 201,A00,096914,Deutsch; Alin Bernard,30,0,30,0
1668146438142,DSE 210,A00,096915,Dasgupta; Sanjoy,30,0,30,0
1668146438576,DSE 260A,A00,096916,Altintas De Callaf; Ilkay,30,0,30,0
1668146439018,ECE 200,001,103586,Antipa; Nicholas A,9999,0,9999,0
1668146439018,ECE 200,002,103587,Atanasov; Nikolay A.,9999,0,9999,0
1668146439018,ECE 200,003,103588,Bharadia; Dinesh,9999,0,9999,0
1668146439018,ECE 200,004,103589,Cheng; Chung Kuan,9999,0,9999,0
1668146439018,ECE 200,005,103590,Cosman; Pamela C.,9999,0,9999,0
1668146439018,ECE 200,006,103591,Dayeh; Shadi Ahmad,9999,0,9999,0
1668146439018,ECE 200,007,103592,Fainman; Yeshaiahu,9999,0,9999,0
1668146439018,ECE 200,008,103593,Ford; Joseph Earl,9999,0,9999,0
1668146439018,ECE 200,009,103594,Franceschetti; Massimo,9999,0,9999,0
1668146439018,ECE 200,010,103595,Fullerton; Eric E,9999,0,9999,0
1668146439018,ECE 200,011,103596,Galton; Ian A,9999,0,9999,0
1668146439018,ECE 200,012,103597,Gilja; Vikash,9999,0,9999,0
1668146439018,ECE 200,013,103598,Hall; Drew A.,9999,0,9999,0
1668146439018,ECE 200,014,103599,Hsueh; Tzu-Chien,9999,0,9999,0
1668146439018,ECE 200,015,103600,Javidi; Tara,9999,0,9999,0
1668146439018,ECE 200,016,103601,Kahng; Andrew Byun,9999,0,9999,0
1668146439018,ECE 200,017,103602,Kim; Young-Han,9999,0,9999,0
1668146439018,ECE 200,018,103603,Koushanfar; Farinaz,9999,0,9999,0
1668146439018,ECE 200,019,103604,Kuzum; Duygu,9999,0,9999,0
1668146439018,ECE 200,020,103605,Le; Hanh-Phuc,9999,0,9999,0
1668146439018,ECE 200,021,103606,Lin; Bill,9999,0,9999,0
1668146439018,ECE 200,022,103607,Liu; Zhaowei,9998,0,9999,1
1668146439018,ECE 200,023,103608,Lo; Yu-Hwa,9999,0,9999,0
1668146439018,ECE 200,024,103609,Lomakin; Vitaliy,9999,0,9999,0
1668146439018,ECE 200,025,103610,Mercier; Patrick Philip,9999,0,9999,0
1668146439018,ECE 200,026,103611,Meyer; Florian,9999,0,9999,0
1668146439018,ECE 200,027,103612,Milstein; Laurence B.,9999,0,9999,0
1668146439018,ECE 200,028,103613,Mir Arabbaygi; Siavash,9999,0,9999,0
1668146439018,ECE 200,029,103614,Mookherjea; Shayan,9999,0,9999,0
1668146439018,ECE 200,030,103615,Morris; Karcher William,9999,0,9999,0
1668146439018,ECE 200,031,103616,Ng; Tse Nga,9999,0,9999,0
1668146439018,ECE 200,032,103617,Nguyen; Truong Quang,9999,0,9999,0
1668146439018,ECE 200,033,103618,Nomura; Kenji,9999,0,9999,0
1668146439018,ECE 200,034,103619,Orlitsky; Alon,9999,0,9999,0
1668146439018,ECE 200,035,103620,Pal; Piya,9999,0,9999,0
1668146439018,ECE 200,036,103621,Papen; George C.,9999,0,9999,0
1668146439018,ECE 200,037,103622,Radic; Stojan,9999,0,9999,0
1668146439018,ECE 200,038,103623,Rao; Bhaskar D.,9999,0,9999,0
1668146439018,ECE 200,039,103624,Rao; Ramesh R,9999,0,9999,0
1668146439018,ECE 200,040,103625,Rebeiz; Gabriel,9999,0,9999,0
1668146439018,ECE 200,041,103626,Sanford; John R,9999,0,9999,0
1668146439018,ECE 200,042,103627,Siegel; Paul H.,9999,0,9999,0
1668146439018,ECE 200,043,103628,Sievenpiper; Daniel F.,9999,0,9999,0
1668146439018,ECE 200,044,103629,Sworder; David D.,9999,0,9999,0
1668146439018,ECE 200,045,103630,Taur; Yuan,9999,0,9999,0
1668146439018,ECE 200,046,103631,Touri; Behrouz,9999,0,9999,0
1668146439018,ECE 200,047,103632,Trivedi; Mohan M.,9999,0,9999,0
1668146439018,ECE 200,048,103633,Vasconcelos; Nuno,9999,0,9999,0
1668146439018,ECE 200,049,103634,Wang; Xiaolong,9999,0,9999,0
1668146439018,ECE 200,050,103635,Xie; Pengtao,9999,0,9999,0
1668146439018,ECE 200,051,103636,Yip; Michael,9999,0,9999,0
1668146439018,ECE 200,052,103637,Zeger; Kenneth A.,999,0,999,0
1668146439018,ECE 200,053,103638,Zhang; Xinyu,9999,0,9999,0
1668146439018,ECE 200,054,103639,Turakhia; Yatish Girish,9999,0,9999,0
1668146439018,ECE 200,055,103640,Kang; Mingu,9999,0,9999,0
1668146439018,ECE 200,056,103641,Shi; Yuanyuan,9999,0,9999,0
1668146439018,ECE 200,057,103642,Wang; Edward Jay,9999,0,9999,0
1668146439018,ECE 200,058,103643,Zheng; Yang,9999,0,9999,0
1668146439443,ECE 202,A00,103644,Kuzum; Duygu,0,0,0,0
1668146439869,ECE 212BN,A00,103646,Ng; Tse Nga,0,0,0,0
1668146440297,ECE 221,A00,111493,Staff,0,0,0,0
1668146440720,ECE 222B,A00,103647,Lomakin; Vitaliy,0,0,0,0
1668146441237,ECE 230B,A00,103648,Taur; Yuan,0,0,0,0
1668146441670,ECE 238B,A00,103649,Garay; Javier,0,0,0,0
1668146442107,ECE 240B,A00,112900,Fainman; Yeshaiahu,0,0,0,0
1668146442540,ECE 247A,A00,103650,Jokerst; Jesse Vincent,0,0,0,0
1668146442965,ECE 247B,A00,103651,Wang; Joseph,0,0,0,0
1668146443391,ECE 250,A00,103652,Siegel; Paul H.,0,0,0,0
1668146443814,ECE 251A,A00,103654,Rao; Bhaskar D.,0,0,0,0
1668146444252,ECE 257B,A00,103655,Bharadia; Dinesh,0,0,0,0
1668146444691,ECE 258A,A00,103656,Milstein; Laurence B.,0,0,0,0
1668146445113,ECE 260B,A00,103658,Kang; Mingu,0,0,0,0
1668146445548,ECE 264A,A00,103659,Galton; Ian A,0,0,0,0
1668146445972,ECE 265A,A00,103661,Gudem; Prasad S.S.,0,0,0,0
1668146446400,ECE 265D,A00,103662,Gudem; Prasad S.S.,0,0,0,0
1668146446833,ECE 268,A00,103663,Koushanfar; Farinaz,0,0,0,0
1668146447261,ECE 269,A01,103665,Pal; Piya,0,0,0,0
1668146447720,ECE 271B,A00,103666,Vasconcelos; Manuela,0,0,0,0
1668146448166,ECE 276A,A00,103667,Atanasov; Nikolay A.,0,0,0,0
1668146448592,ECE 277,A00,103668,An; Cheolhong,0,0,0,0
1668146449027,ECE 279,A00,117947,Hall; Drew A.,0,0,0,0
1668146449884,ECE 283,A00,103670,Hsueh; Tzu-Chien,0,0,0,0
1668146450321,ECE 284,A00,103671,Turakhia; Yatish Girish,0,0,0,0
1668146450758,ECE 285,A00,103672,Zheng; Yang,0,0,0,0
1668146450758,ECE 285,B00,103673,Sworder; David D.,0,0,0,0
1668146451187,ECE 287,A00,103676,Javidi; Tara,0,0,0,0
1668146451617,MATH 200B,A00,098023,Salehi Golsefidy; Alireza,12,0,15,3
1668146452051,MATH 202B,A00,098024,Rhoades; Brendon Patrick,9,0,15,6
1668146452486,MATH 203B,A00,098025,Oprea; Dragos N.,10,0,15,5
1668146452909,MATH 204B,A00,098026,Sorensen; Claus M,13,0,15,2
1668146453333,MATH 208,A00,098027,Izadi; Elham,7,0,10,3
1668146453770,MATH 209,A00,098028,Pollack; Aaron,10,0,10,0
1668146454196,MATH 211A,A00,112919,Rogalski; Daniel,9,0,10,1
1668146454617,MATH 211B,A00,112920,Seward; Brandon M.,9,0,10,1
1668146455040,MATH 218,A00,098029,Li; Bo,10,0,10,0
1668146455464,MATH 220B,A00,098030,Novak; Jonathan I,11,0,15,4
1668146455897,MATH 221A,A00,098031,Ebenfelt; Peter F,13,0,15,2
1668146456325,MATH 231B,A00,098032,Zlatos; Andrej,12,0,15,3
1668146456750,MATH 240B,A00,098033,Ni; Lei,9,0,15,6
1668146457197,MATH 243,A00,098034,Jekel; David Andrew,10,0,10,0
1668146457624,MATH 245A,A00,098035,Nie; Jiawang,0,0,15,16
1668146458064,MATH 248,A00,098036,Bejenaru; Ioan,10,0,10,0
1668146458486,MATH 250B,A00,098037,Spolaor; Luca,14,0,15,1
1668146458911,MATH 258,A00,098038,Ni; Lei,10,0,10,0
1668146459335,MATH 264B,A00,098041,Rhoades; Brendon Patrick,9,0,15,6
1668146459759,MATH 268,A00,098042,Buss; Samuel R,10,0,10,0
1668146460191,MATH 269,A00,098043,Rhoades; Brendon Patrick,10,0,10,0
1668146460613,MATH 270B,A00,098044,Li; Bo,10,0,15,5
1668146461045,MATH 272B,A00,098045,Holst; Michael J,13,0,15,2
1668146461480,MATH 273A,A00,098046,Tian; Xiaochuan,10,0,15,5
1668146461963,MATH 275,A01,098048,Tian; Xiaochuan,6,0,10,4
1668146462390,MATH 278A,A00,098049,Holst; Michael J,8,0,10,2
1668146462814,MATH 278B,A00,098050,Cloninger; Alexander,10,0,10,0
1668146463237,MATH 278C,A00,098051,Nie; Jiawang,7,0,10,3
1668146463659,MATH 280B,A00,098052,Zheng; Tianyi,10,0,15,5
1668146464083,MATH 281B,A00,098053,Bradic; Jelena,2,0,15,13
1668146464509,MATH 282B,A00,098054,Arias-Castro; Ery,0,0,15,15
1668146464932,MATH 285,A00,098055,Fitzsimmons; Patrick J,0,0,15,17
1668146465375,MATH 287B,A00,098056,Arias-Castro; Ery,2,0,15,13
1668146465806,MATH 288,A00,098057,Agarwal; Pooja,9,0,10,1
1668146465806,MATH 288,B00,098058,Zhang; Danna,8,0,10,2
1668146465806,MATH 288,C00,098059,Williams; Ruth J,10,0,10,0
1668146466228,MATH 290B,A00,098060,Roberts; Justin Deritter,13,0,15,2
1668146466650,MATH 292,A00,098061,Belmont; Eva Kinoshita,10,0,10,0
1668146467077,MATH 295,A00,098062,Suk; Andrew Hoon,48,0,50,2
1668146467505,MATH 296,A00,098063,Novak; Jonathan I,20,0,20,0
1668146467929,MATH 297,001,098064,Gamst; Anthony Collins,9997,0,9999,2
1668146981977,COGS 205,A00,101395,Chiba; Andrea,19,0,20,1
1668146982401,COGS 210B,001,101404,Greene; Deanna Jacquelyn,9998,0,9999,1
1668146982401,COGS 210B,002,101417,Xia; Haijun,9999,0,9999,0
1668146982401,COGS 210B,003,101422,Nitz; Douglas A.,9999,0,9999,0
1668146982401,COGS 210B,004,101423,Hollan; James D.,9998,0,9999,1
1668146982401,COGS 210B,005,101424,Deak; Gedeon O.,9998,0,9999,1
1668146982401,COGS 210B,006,101425,Rossano; Federico,9999,0,9999,0
1668146982825,COGS 211B,A00,101427,Coulson; Seana M,9996,0,9999,3
1668146983265,COGS 220,A00,101428,Hollan; James D.,0,0,25,25
1668146983688,COGS 229,A00,101429,Dow; Steven P,18,0,25,7
1668146984114,COGS 230,A00,101430,Klemmer; Scott R,12,0,17,5
1668146984541,COGS 234,A00,101431,Xia; Haijun,3,0,25,22
1668146984972,COGS 260,A00,101432,Kiyonaga; Anastasia,20,0,25,5
1668146984972,COGS 260,B00,101433,Kirsh; David Joel,16,0,25,9
1668146985419,CSE 202,A00,102371,Impagliazzo; Russell,0,0,0,0
1668146985856,CSE 203B,A01,102373,Cheng; Chung Kuan,0,0,0,0
1668146986283,CSE 208,A00,102374,Micciancio; Daniele,0,0,0,0
1668146986708,CSE 209A,A00,112895,Impagliazzo; Russell,0,0,15,15
1668146987132,CSE 209B,A00,108005,Bellare; Mihir,0,0,0,0
1668146987559,CSE 210,A00,113163,Coblenz; Michael J,0,0,0,0
1668146987988,CSE 219,A00,106111,Dow; Steven P,0,0,20,20
1668146988440,CSE 221,A00,102376,Voelker; Geoffrey M.,0,0,0,0
1668146988866,CSE 224,A01,102378,Porter; George M,0,0,0,0
1668146989288,CSE 229A,A00,102379,Savage; Stefan,0,0,0,0
1668146989713,CSE 229C,A00,102380,Munyaka; Imani N. S.,0,0,0,0
1668146990137,CSE 232B,A00,102382,Deutsch; Alin Bernard,0,0,0,0
1668146990575,CSE 234,A01,112904,Kumar; Arun Kumar,0,0,0,0
1668146991025,CSE 237A,A00,102383,Rosing; Tajana Simunic,0,0,0,0
1668146991447,CSE 239A,A00,102384,Deutsch; Alin Bernard,0,0,0,0
1668146991871,CSE 239B,A00,102385,Polikarpova; Nadezhda,0,0,0,0
1668146992300,CSE 240A,A00,102386,Pannuto; Patrick William,0,0,0,0
1668146992722,CSE 240B,A00,102387,Zhao; Jishen,0,0,0,0
1668146993147,CSE 241A,A00,106406,Kang; Mingu,0,0,0,0
1668146993571,CSE 249B,A00,102388,Kahng; Andrew Byun,0,0,8,8
1668146994000,CSE 251B,A01,102392,Cottrell; Garrison W,0,0,0,0
1668146994000,CSE 251B,A02,102393,Cottrell; Garrison W,0,0,0,0
1668146994440,CSE 252B,A00,102394,Ochoa; Benjamin Lawrence,0,0,0,0
1668146994872,CSE 257,A01,102396,Gao; Sicun,0,0,0,0
1668146995301,CSE 272,A00,102397,Li; Tzumao,0,0,0,0
1668146995732,CSE 274,A00,111323,Chern; Albert Ren-Haur,0,0,0,0
1668146996170,CSE 282,A00,102398,Pevzner; Pavel Arkadjevich,0,0,0,0
1668146996593,CSE 284,A00,114175,Gymrek; Melissa Ann,0,0,0,0
1668146997021,CSE 290,A00,102399,Chandraker; Manmohan Krishna,0,0,0,0
1668146997021,CSE 290,B00,102400,Vaccaro; Kristen Marie,0,0,25,25
1668146997021,CSE 290,C00,102414,Pannuto; Patrick William,0,0,25,25
1668146997021,CSE 290,D00,102427,Pevzner; Pavel Arkadjevich,0,0,0,0
1668146997021,CSE 290,E00,102429,Zhao; Jishen,0,0,0,0
1668146997021,CSE 290,F00,102436,Tullsen; Dean Michael,0,0,0,0
1668146997021,CSE 290,G00,102440,Christensen; Henrik I,0,0,20,20
1668146997443,CSE 291,A00,102443,Su; Hao,0,0,0,0
1668146997443,CSE 291,B00,102448,Polikarpova; Nadezhda,0,0,0,0
1668146997443,CSE 291,C00,102453,Vaccaro; Kristen Marie,0,0,0,0
1668146997443,CSE 291,D00,111343,Savage; Stefan,0,0,0,0
1668146997443,CSE 291,E00,116474,Claffy; Kimberly Claire,0,0,0,0
1668146997443,CSE 291,F00,116479,Pasquale; Joseph,0,0,0,0
1668146997895,CSE 293,001,119111,Bafna; Vineet,9999,0,9999,0
1668146997895,CSE 293,002,119118,Bellare; Mihir,9999,0,9999,0
1668146997895,CSE 293,003,119122,Berg-Kirkpatrick; Taylor D,9999,0,9999,0
1668146997895,CSE 293,004,119135,Christensen; Henrik I,9999,0,9999,0
1668146997895,CSE 293,005,119142,Cottrell; Garrison W,9999,0,9999,0
1668146997895,CSE 293,006,119146,Deutsch; Alin Bernard,9999,0,9999,0
1668146997895,CSE 293,007,119159,Esmaeilzadeh; Hadi,9999,0,9999,0
1668146997895,CSE 293,008,119166,Freund; Yoav,9999,0,9999,0
1668146997895,CSE 293,009,119170,Griswold; William G.,9999,0,9999,0
1668146997895,CSE 293,010,119183,Gymrek; Melissa Ann,9999,0,9999,0
1668146997895,CSE 293,011,119190,Heninger; Nadia A,9999,0,9999,0
1668146997895,CSE 293,012,119230,Impagliazzo; Russell,9999,0,9999,0
1668146997895,CSE 293,013,119232,Jhala; Ranjit,9999,0,9999,0
1668146997895,CSE 293,014,119233,Kahng; Andrew Byun,9999,0,9999,0
1668146997895,CSE 293,015,119298,Kane; Daniel Mertz,9999,0,9999,0
1668146997895,CSE 293,016,119299,Kriegman; David J,9999,0,9999,0
1668146997895,CSE 293,017,119300,Kumar; Arun Kumar,9999,0,9999,0
1668146997895,CSE 293,018,119301,Lerner; Sorin,9999,0,9999,0
1668146997895,CSE 293,019,119302,Lovett; Shachar,9999,0,9999,0
1668146997895,CSE 293,020,119303,McAuley; Julian John,9999,0,9999,0
1668146997895,CSE 293,021,119304,Micciancio; Daniele,9999,0,9999,0
1668146997895,CSE 293,022,119367,Orailoglu; Alex,9999,0,9999,0
1668146997895,CSE 293,023,119382,Paturi; Ramamohan,9999,0,9999,0
1668146997895,CSE 293,024,119404,Polikarpova; Nadezhda,9999,0,9999,0
1668146997895,CSE 293,025,119406,Politz; Joseph Gibbs,9999,0,9999,0
1668146997895,CSE 293,026,119411,Porter; George M,9999,0,9999,0
1668146997895,CSE 293,027,119414,Porter; Leonard Emerson,9999,0,9999,0
1668146997895,CSE 293,028,119416,Ramamoorthi; Ravi,9999,0,9999,0
1668146997895,CSE 293,029,119417,Sahoo; Debashis,9999,0,9999,0
1668146997895,CSE 293,030,119420,Saul; Lawrence,9999,0,9999,0
1668146997895,CSE 293,031,119421,Savage; Stefan,9999,0,9999,0
1668146997895,CSE 293,032,119425,Schulze; Jurgen P.,9999,0,9999,0
1668146997895,CSE 293,033,119426,Snoeren; Alex C.,9999,0,9999,0
1668146997895,CSE 293,034,119428,Shang; Jingbo,9999,0,9999,0
1668146997895,CSE 293,035,119430,Stefan; Deian,9999,0,9999,0
1668146997895,CSE 293,036,119431,Su; Hao,9999,0,9999,0
1668146997895,CSE 293,037,119433,Swanson; Steven James,9999,0,9999,0
1668146997895,CSE 293,038,119435,Tullsen; Dean Michael,9999,0,9999,0
1668146997895,CSE 293,039,119483,Voelker; Geoffrey M.,9999,0,9999,0
1668146997895,CSE 293,040,119537,Zhao; Jishen,9999,0,9999,0
1668146997895,CSE 293,041,119538,Zhou; Yuan-Yuan,9999,0,9999,0
1668146997895,CSE 293,042,119539,Gao; Sicun,9999,0,9999,0
1668146997895,CSE 293,043,119540,Weibel; Nadir,9999,0,9999,0
1668146997895,CSE 293,044,119541,Gupta; Rajesh K.,9999,0,9999,0
1668146997895,CSE 293,045,126410,Vaccaro; Kristen Marie,9999,0,9999,0
1668146997895,CSE 293,046,126411,Klemke; Richard,9999,0,9999,0
1668146998316,CSE 294,A00,102459,Voelker; Geoffrey M.,0,0,0,0
1668146998316,CSE 294,B00,111322,Orailoglu; Alex,0,0,0,0
1668146998743,DSE 201,A00,096914,Deutsch; Alin Bernard,30,0,30,0
1668146999169,DSE 210,A00,096915,Dasgupta; Sanjoy,30,0,30,0
1668146999593,DSE 260A,A00,096916,Altintas De Callaf; Ilkay,30,0,30,0
1668147000043,ECE 200,001,103586,Antipa; Nicholas A,9999,0,9999,0
1668147000043,ECE 200,002,103587,Atanasov; Nikolay A.,9999,0,9999,0
1668147000043,ECE 200,003,103588,Bharadia; Dinesh,9999,0,9999,0
1668147000043,ECE 200,004,103589,Cheng; Chung Kuan,9999,0,9999,0
1668147000043,ECE 200,005,103590,Cosman; Pamela C.,9999,0,9999,0
1668147000043,ECE 200,006,103591,Dayeh; Shadi Ahmad,9999,0,9999,0
1668147000043,ECE 200,007,103592,Fainman; Yeshaiahu,9999,0,9999,0
1668147000043,ECE 200,008,103593,Ford; Joseph Earl,9999,0,9999,0
1668147000043,ECE 200,009,103594,Franceschetti; Massimo,9999,0,9999,0
1668147000043,ECE 200,010,103595,Fullerton; Eric E,9999,0,9999,0
1668147000043,ECE 200,011,103596,Galton; Ian A,9999,0,9999,0
1668147000043,ECE 200,012,103597,Gilja; Vikash,9999,0,9999,0
1668147000043,ECE 200,013,103598,Hall; Drew A.,9999,0,9999,0
1668147000043,ECE 200,014,103599,Hsueh; Tzu-Chien,9999,0,9999,0
1668147000043,ECE 200,015,103600,Javidi; Tara,9999,0,9999,0
1668147000043,ECE 200,016,103601,Kahng; Andrew Byun,9999,0,9999,0
1668147000043,ECE 200,017,103602,Kim; Young-Han,9999,0,9999,0
1668147000043,ECE 200,018,103603,Koushanfar; Farinaz,9999,0,9999,0
1668147000043,ECE 200,019,103604,Kuzum; Duygu,9999,0,9999,0
1668147000043,ECE 200,020,103605,Le; Hanh-Phuc,9999,0,9999,0
1668147000043,ECE 200,021,103606,Lin; Bill,9999,0,9999,0
1668147000043,ECE 200,022,103607,Liu; Zhaowei,9998,0,9999,1
1668147000043,ECE 200,023,103608,Lo; Yu-Hwa,9999,0,9999,0
1668147000043,ECE 200,024,103609,Lomakin; Vitaliy,9999,0,9999,0
1668147000043,ECE 200,025,103610,Mercier; Patrick Philip,9999,0,9999,0
1668147000043,ECE 200,026,103611,Meyer; Florian,9999,0,9999,0
1668147000043,ECE 200,027,103612,Milstein; Laurence B.,9999,0,9999,0
1668147000043,ECE 200,028,103613,Mir Arabbaygi; Siavash,9999,0,9999,0
1668147000043,ECE 200,029,103614,Mookherjea; Shayan,9999,0,9999,0
1668147000043,ECE 200,030,103615,Morris; Karcher William,9999,0,9999,0
1668147000043,ECE 200,031,103616,Ng; Tse Nga,9999,0,9999,0
1668147000043,ECE 200,032,103617,Nguyen; Truong Quang,9999,0,9999,0
1668147000043,ECE 200,033,103618,Nomura; Kenji,9999,0,9999,0
1668147000043,ECE 200,034,103619,Orlitsky; Alon,9999,0,9999,0
1668147000043,ECE 200,035,103620,Pal; Piya,9999,0,9999,0
1668147000043,ECE 200,036,103621,Papen; George C.,9999,0,9999,0
1668147000043,ECE 200,037,103622,Radic; Stojan,9999,0,9999,0
1668147000043,ECE 200,038,103623,Rao; Bhaskar D.,9999,0,9999,0
1668147000043,ECE 200,039,103624,Rao; Ramesh R,9999,0,9999,0
1668147000043,ECE 200,040,103625,Rebeiz; Gabriel,9999,0,9999,0
1668147000043,ECE 200,041,103626,Sanford; John R,9999,0,9999,0
1668147000043,ECE 200,042,103627,Siegel; Paul H.,9999,0,9999,0
1668147000043,ECE 200,043,103628,Sievenpiper; Daniel F.,9999,0,9999,0
1668147000043,ECE 200,044,103629,Sworder; David D.,9999,0,9999,0
1668147000043,ECE 200,045,103630,Taur; Yuan,9999,0,9999,0
1668147000043,ECE 200,046,103631,Touri; Behrouz,9999,0,9999,0
1668147000043,ECE 200,047,103632,Trivedi; Mohan M.,9999,0,9999,0
1668147000043,ECE 200,048,103633,Vasconcelos; Nuno,9999,0,9999,0
1668147000043,ECE 200,049,103634,Wang; Xiaolong,9999,0,9999,0
1668147000043,ECE 200,050,103635,Xie; Pengtao,9999,0,9999,0
1668147000043,ECE 200,051,103636,Yip; Michael,9999,0,9999,0
1668147000043,ECE 200,052,103637,Zeger; Kenneth A.,999,0,999,0
1668147000043,ECE 200,053,103638,Zhang; Xinyu,9999,0,9999,0
1668147000043,ECE 200,054,103639,Turakhia; Yatish Girish,9999,0,9999,0
1668147000043,ECE 200,055,103640,Kang; Mingu,9999,0,9999,0
1668147000043,ECE 200,056,103641,Shi; Yuanyuan,9999,0,9999,0
1668147000043,ECE 200,057,103642,Wang; Edward Jay,9999,0,9999,0
1668147000043,ECE 200,058,103643,Zheng; Yang,9999,0,9999,0
1668147000477,ECE 202,A00,103644,Kuzum; Duygu,0,0,0,0
1668147000903,ECE 212BN,A00,103646,Ng; Tse Nga,0,0,0,0
1668147001328,ECE 221,A00,111493,Staff,0,0,0,0
1668147001763,ECE 222B,A00,103647,Lomakin; Vitaliy,0,0,0,0
1668147002200,ECE 230B,A00,103648,Taur; Yuan,0,0,0,0
1668147002638,ECE 238B,A00,103649,Garay; Javier,0,0,0,0
1668147003075,ECE 240B,A00,112900,Fainman; Yeshaiahu,0,0,0,0
1668147003498,ECE 247A,A00,103650,Jokerst; Jesse Vincent,0,0,0,0
1668147003922,ECE 247B,A00,103651,Wang; Joseph,0,0,0,0
1668147004356,ECE 250,A00,103652,Siegel; Paul H.,0,0,0,0
1668147004779,ECE 251A,A00,103654,Rao; Bhaskar D.,0,0,0,0
1668147005207,ECE 257B,A00,103655,Bharadia; Dinesh,0,0,0,0
1668147005631,ECE 258A,A00,103656,Milstein; Laurence B.,0,0,0,0
1668147006056,ECE 260B,A00,103658,Kang; Mingu,0,0,0,0
1668147006483,ECE 264A,A00,103659,Galton; Ian A,0,0,0,0
1668147006907,ECE 265A,A00,103661,Gudem; Prasad S.S.,0,0,0,0
1668147007353,ECE 265D,A00,103662,Gudem; Prasad S.S.,0,0,0,0
1668147007780,ECE 268,A00,103663,Koushanfar; Farinaz,0,0,0,0
1668147008203,ECE 269,A01,103665,Pal; Piya,0,0,0,0
1668147008627,ECE 271B,A00,103666,Vasconcelos; Manuela,0,0,0,0
1668147009062,ECE 276A,A00,103667,Atanasov; Nikolay A.,0,0,0,0
1668147009487,ECE 277,A00,103668,An; Cheolhong,0,0,0,0
1668147009922,ECE 279,A00,117947,Hall; Drew A.,0,0,0,0
1668147010783,ECE 283,A00,103670,Hsueh; Tzu-Chien,0,0,0,0
1668147011210,ECE 284,A00,103671,Turakhia; Yatish Girish,0,0,0,0
1668147011639,ECE 285,A00,103672,Zheng; Yang,0,0,0,0
1668147011639,ECE 285,B00,103673,Sworder; David D.,0,0,0,0
1668147012061,ECE 287,A00,103676,Javidi; Tara,0,0,0,0
1668147012491,MATH 200B,A00,098023,Salehi Golsefidy; Alireza,12,0,15,3
1668147012913,MATH 202B,A00,098024,Rhoades; Brendon Patrick,9,0,15,6
1668147013336,MATH 203B,A00,098025,Oprea; Dragos N.,10,0,15,5
1668147013787,MATH 204B,A00,098026,Sorensen; Claus M,13,0,15,2
1668147014208,MATH 208,A00,098027,Izadi; Elham,7,0,10,3
1668147014631,MATH 209,A00,098028,Pollack; Aaron,10,0,10,0
1668147015062,MATH 211A,A00,112919,Rogalski; Daniel,9,0,10,1
1668147015489,MATH 211B,A00,112920,Seward; Brandon M.,9,0,10,1
1668147015912,MATH 218,A00,098029,Li; Bo,10,0,10,0
1668147016335,MATH 220B,A00,098030,Novak; Jonathan I,11,0,15,4
1668147016773,MATH 221A,A00,098031,Ebenfelt; Peter F,13,0,15,2
1668147017197,MATH 231B,A00,098032,Zlatos; Andrej,12,0,15,3
1668147017621,MATH 240B,A00,098033,Ni; Lei,9,0,15,6
1668147018045,MATH 243,A00,098034,Jekel; David Andrew,10,0,10,0
1668147018468,MATH 245A,A00,098035,Nie; Jiawang,0,0,15,16
1668147019010,MATH 248,A00,098036,Bejenaru; Ioan,10,0,10,0
1668147019438,MATH 250B,A00,098037,Spolaor; Luca,14,0,15,1
1668147019873,MATH 258,A00,098038,Ni; Lei,10,0,10,0
1668147020301,MATH 264B,A00,098041,Rhoades; Brendon Patrick,9,0,15,6
1668147020725,MATH 268,A00,098042,Buss; Samuel R,10,0,10,0
1668147021146,MATH 269,A00,098043,Rhoades; Brendon Patrick,10,0,10,0
1668147021568,MATH 270B,A00,098044,Li; Bo,10,0,15,5
1668147022001,MATH 272B,A00,098045,Holst; Michael J,13,0,15,2
1668147022428,MATH 273A,A00,098046,Tian; Xiaochuan,10,0,15,5
1668147022853,MATH 275,A01,098048,Tian; Xiaochuan,6,0,10,4
1668147023287,MATH 278A,A00,098049,Holst; Michael J,8,0,10,2
1668147023710,MATH 278B,A00,098050,Cloninger; Alexander,10,0,10,0
1668147024134,MATH 278C,A00,098051,Nie; Jiawang,7,0,10,3
1668147024564,MATH 280B,A00,098052,Zheng; Tianyi,10,0,15,5
1668147024992,MATH 281B,A00,098053,Bradic; Jelena,2,0,15,13
1668147025420,MATH 282B,A00,098054,Arias-Castro; Ery,0,0,15,15
1668147025850,MATH 285,A00,098055,Fitzsimmons; Patrick J,0,0,15,17
1668147026273,MATH 287B,A00,098056,Arias-Castro; Ery,2,0,15,13
1668147026698,MATH 288,A00,098057,Agarwal; Pooja,9,0,10,1
1668147026698,MATH 288,B00,098058,Zhang; Danna,8,0,10,2
1668147026698,MATH 288,C00,098059,Williams; Ruth J,10,0,10,0
1668147027123,MATH 290B,A00,098060,Roberts; Justin Deritter,13,0,15,2
1668147027556,MATH 292,A00,098061,Belmont; Eva Kinoshita,10,0,10,0
1668147027981,MATH 295,A00,098062,Suk; Andrew Hoon,48,0,50,2
1668147028413,MATH 296,A00,098063,Novak; Jonathan I,20,0,20,0
1668147028848,MATH 297,001,098064,Gamst; Anthony Collins,9997,0,9999,2
1668147531816,COGS 205,A00,101395,Chiba; Andrea,19,0,20,1
1668147532239,COGS 210B,001,101404,Greene; Deanna Jacquelyn,9998,0,9999,1
1668147532239,COGS 210B,002,101417,Xia; Haijun,9999,0,9999,0
1668147532239,COGS 210B,003,101422,Nitz; Douglas A.,9999,0,9999,0
1668147532239,COGS 210B,004,101423,Hollan; James D.,9998,0,9999,1
1668147532239,COGS 210B,005,101424,Deak; Gedeon O.,9998,0,9999,1
1668147532239,COGS 210B,006,101425,Rossano; Federico,9999,0,9999,0
1668147532662,COGS 211B,A00,101427,Coulson; Seana M,9996,0,9999,3
1668147533086,COGS 220,A00,101428,Hollan; James D.,0,0,25,25
1668147533512,COGS 229,A00,101429,Dow; Steven P,18,0,25,7
1668147533937,COGS 230,A00,101430,Klemmer; Scott R,12,0,17,5
1668147534364,COGS 234,A00,101431,Xia; Haijun,3,0,25,22
1668147534810,COGS 260,A00,101432,Kiyonaga; Anastasia,20,0,25,5
1668147534810,COGS 260,B00,101433,Kirsh; David Joel,16,0,25,9
1668147535234,CSE 202,A00,102371,Impagliazzo; Russell,0,0,0,0
1668147535656,CSE 203B,A01,102373,Cheng; Chung Kuan,0,0,0,0
1668147536093,CSE 208,A00,102374,Micciancio; Daniele,0,0,0,0
1668147536524,CSE 209A,A00,112895,Impagliazzo; Russell,0,0,15,15
1668147536954,CSE 209B,A00,108005,Bellare; Mihir,0,0,0,0
1668147537378,CSE 210,A00,113163,Coblenz; Michael J,0,0,0,0
1668147537813,CSE 219,A00,106111,Dow; Steven P,0,0,20,20
1668147538238,CSE 221,A00,102376,Voelker; Geoffrey M.,0,0,0,0
1668147538664,CSE 224,A01,102378,Porter; George M,0,0,0,0
1668147539089,CSE 229A,A00,102379,Savage; Stefan,0,0,0,0
1668147539511,CSE 229C,A00,102380,Munyaka; Imani N. S.,0,0,0,0
1668147539937,CSE 232B,A00,102382,Deutsch; Alin Bernard,0,0,0,0
1668147540362,CSE 234,A01,112904,Kumar; Arun Kumar,0,0,0,0
1668147540786,CSE 237A,A00,102383,Rosing; Tajana Simunic,0,0,0,0
1668147541217,CSE 239A,A00,102384,Deutsch; Alin Bernard,0,0,0,0
1668147541641,CSE 239B,A00,102385,Polikarpova; Nadezhda,0,0,0,0
1668147542163,CSE 240A,A00,102386,Pannuto; Patrick William,0,0,0,0
1668147542603,CSE 240B,A00,102387,Zhao; Jishen,0,0,0,0
1668147543042,CSE 241A,A00,106406,Kang; Mingu,0,0,0,0
1668147543465,CSE 249B,A00,102388,Kahng; Andrew Byun,0,0,8,8
1668147543890,CSE 251B,A01,102392,Cottrell; Garrison W,0,0,0,0
1668147543890,CSE 251B,A02,102393,Cottrell; Garrison W,0,0,0,0
1668147544314,CSE 252B,A00,102394,Ochoa; Benjamin Lawrence,0,0,0,0
1668147544738,CSE 257,A01,102396,Gao; Sicun,0,0,0,0
1668147545162,CSE 272,A00,102397,Li; Tzumao,0,0,0,0
1668147545585,CSE 274,A00,111323,Chern; Albert Ren-Haur,0,0,0,0
1668147546010,CSE 282,A00,102398,Pevzner; Pavel Arkadjevich,0,0,0,0
1668147546434,CSE 284,A00,114175,Gymrek; Melissa Ann,0,0,0,0
1668147546864,CSE 290,A00,102399,Chandraker; Manmohan Krishna,0,0,0,0
1668147546864,CSE 290,B00,102400,Vaccaro; Kristen Marie,0,0,25,25
1668147546864,CSE 290,C00,102414,Pannuto; Patrick William,0,0,25,25
1668147546864,CSE 290,D00,102427,Pevzner; Pavel Arkadjevich,0,0,0,0
1668147546864,CSE 290,E00,102429,Zhao; Jishen,0,0,0,0
1668147546864,CSE 290,F00,102436,Tullsen; Dean Michael,0,0,0,0
1668147546864,CSE 290,G00,102440,Christensen; Henrik I,0,0,20,20
1668147547314,CSE 291,A00,102443,Su; Hao,0,0,0,0
1668147547314,CSE 291,B00,102448,Polikarpova; Nadezhda,0,0,0,0
1668147547314,CSE 291,C00,102453,Vaccaro; Kristen Marie,0,0,0,0
1668147547314,CSE 291,D00,111343,Savage; Stefan,0,0,0,0
1668147547314,CSE 291,E00,116474,Claffy; Kimberly Claire,0,0,0,0
1668147547314,CSE 291,F00,116479,Pasquale; Joseph,0,0,0,0
1668147547772,CSE 293,001,119111,Bafna; Vineet,9999,0,9999,0
1668147547772,CSE 293,002,119118,Bellare; Mihir,9999,0,9999,0
1668147547772,CSE 293,003,119122,Berg-Kirkpatrick; Taylor D,9999,0,9999,0
1668147547772,CSE 293,004,119135,Christensen; Henrik I,9999,0,9999,0
1668147547772,CSE 293,005,119142,Cottrell; Garrison W,9999,0,9999,0
1668147547772,CSE 293,006,119146,Deutsch; Alin Bernard,9999,0,9999,0
1668147547772,CSE 293,007,119159,Esmaeilzadeh; Hadi,9999,0,9999,0
1668147547772,CSE 293,008,119166,Freund; Yoav,9999,0,9999,0
1668147547772,CSE 293,009,119170,Griswold; William G.,9999,0,9999,0
1668147547772,CSE 293,010,119183,Gymrek; Melissa Ann,9999,0,9999,0
1668147547772,CSE 293,011,119190,Heninger; Nadia A,9999,0,9999,0
1668147547772,CSE 293,012,119230,Impagliazzo; Russell,9999,0,9999,0
1668147547772,CSE 293,013,119232,Jhala; Ranjit,9999,0,9999,0
1668147547772,CSE 293,014,119233,Kahng; Andrew Byun,9999,0,9999,0
1668147547772,CSE 293,015,119298,Kane; Daniel Mertz,9999,0,9999,0
1668147547772,CSE 293,016,119299,Kriegman; David J,9999,0,9999,0
1668147547772,CSE 293,017,119300,Kumar; Arun Kumar,9999,0,9999,0
1668147547772,CSE 293,018,119301,Lerner; Sorin,9999,0,9999,0
1668147547772,CSE 293,019,119302,Lovett; Shachar,9999,0,9999,0
1668147547772,CSE 293,020,119303,McAuley; Julian John,9999,0,9999,0
1668147547772,CSE 293,021,119304,Micciancio; Daniele,9999,0,9999,0
1668147547772,CSE 293,022,119367,Orailoglu; Alex,9999,0,9999,0
1668147547772,CSE 293,023,119382,Paturi; Ramamohan,9999,0,9999,0
1668147547772,CSE 293,024,119404,Polikarpova; Nadezhda,9999,0,9999,0
1668147547772,CSE 293,025,119406,Politz; Joseph Gibbs,9999,0,9999,0
1668147547772,CSE 293,026,119411,Porter; George M,9999,0,9999,0
1668147547772,CSE 293,027,119414,Porter; Leonard Emerson,9999,0,9999,0
1668147547772,CSE 293,028,119416,Ramamoorthi; Ravi,9999,0,9999,0
1668147547772,CSE 293,029,119417,Sahoo; Debashis,9999,0,9999,0
1668147547772,CSE 293,030,119420,Saul; Lawrence,9999,0,9999,0
1668147547772,CSE 293,031,119421,Savage; Stefan,9999,0,9999,0
1668147547772,CSE 293,032,119425,Schulze; Jurgen P.,9999,0,9999,0
1668147547772,CSE 293,033,119426,Snoeren; Alex C.,9999,0,9999,0
1668147547772,CSE 293,034,119428,Shang; Jingbo,9999,0,9999,0
1668147547772,CSE 293,035,119430,Stefan; Deian,9999,0,9999,0
1668147547772,CSE 293,036,119431,Su; Hao,9999,0,9999,0
1668147547772,CSE 293,037,119433,Swanson; Steven James,9999,0,9999,0
1668147547772,CSE 293,038,119435,Tullsen; Dean Michael,9999,0,9999,0
1668147547772,CSE 293,039,119483,Voelker; Geoffrey M.,9999,0,9999,0
1668147547772,CSE 293,040,119537,Zhao; Jishen,9999,0,9999,0
1668147547772,CSE 293,041,119538,Zhou; Yuan-Yuan,9999,0,9999,0
1668147547772,CSE 293,042,119539,Gao; Sicun,9999,0,9999,0
1668147547772,CSE 293,043,119540,Weibel; Nadir,9999,0,9999,0
1668147547772,CSE 293,044,119541,Gupta; Rajesh K.,9999,0,9999,0
1668147547772,CSE 293,045,126410,Vaccaro; Kristen Marie,9999,0,9999,0
1668147547772,CSE 293,046,126411,Klemke; Richard,9999,0,9999,0
1668147548199,CSE 294,A00,102459,Voelker; Geoffrey M.,0,0,0,0
1668147548199,CSE 294,B00,111322,Orailoglu; Alex,0,0,0,0
1668147548626,DSE 201,A00,096914,Deutsch; Alin Bernard,30,0,30,0
1668147549056,DSE 210,A00,096915,Dasgupta; Sanjoy,30,0,30,0
1668147549480,DSE 260A,A00,096916,Altintas De Callaf; Ilkay,30,0,30,0
1668147549939,ECE 200,001,103586,Antipa; Nicholas A,9999,0,9999,0
1668147549939,ECE 200,002,103587,Atanasov; Nikolay A.,9999,0,9999,0
1668147549939,ECE 200,003,103588,Bharadia; Dinesh,9999,0,9999,0
1668147549939,ECE 200,004,103589,Cheng; Chung Kuan,9999,0,9999,0
1668147549939,ECE 200,005,103590,Cosman; Pamela C.,9999,0,9999,0
1668147549939,ECE 200,006,103591,Dayeh; Shadi Ahmad,9999,0,9999,0
1668147549939,ECE 200,007,103592,Fainman; Yeshaiahu,9999,0,9999,0
1668147549939,ECE 200,008,103593,Ford; Joseph Earl,9999,0,9999,0
1668147549939,ECE 200,009,103594,Franceschetti; Massimo,9999,0,9999,0
1668147549939,ECE 200,010,103595,Fullerton; Eric E,9999,0,9999,0
1668147549939,ECE 200,011,103596,Galton; Ian A,9999,0,9999,0
1668147549939,ECE 200,012,103597,Gilja; Vikash,9999,0,9999,0
1668147549939,ECE 200,013,103598,Hall; Drew A.,9999,0,9999,0
1668147549939,ECE 200,014,103599,Hsueh; Tzu-Chien,9999,0,9999,0
1668147549939,ECE 200,015,103600,Javidi; Tara,9999,0,9999,0
1668147549939,ECE 200,016,103601,Kahng; Andrew Byun,9999,0,9999,0
1668147549939,ECE 200,017,103602,Kim; Young-Han,9999,0,9999,0
1668147549939,ECE 200,018,103603,Koushanfar; Farinaz,9999,0,9999,0
1668147549939,ECE 200,019,103604,Kuzum; Duygu,9999,0,9999,0
1668147549939,ECE 200,020,103605,Le; Hanh-Phuc,9999,0,9999,0
1668147549939,ECE 200,021,103606,Lin; Bill,9999,0,9999,0
1668147549939,ECE 200,022,103607,Liu; Zhaowei,9998,0,9999,1
1668147549939,ECE 200,023,103608,Lo; Yu-Hwa,9999,0,9999,0
1668147549939,ECE 200,024,103609,Lomakin; Vitaliy,9999,0,9999,0
1668147549939,ECE 200,025,103610,Mercier; Patrick Philip,9999,0,9999,0
1668147549939,ECE 200,026,103611,Meyer; Florian,9999,0,9999,0
1668147549939,ECE 200,027,103612,Milstein; Laurence B.,9999,0,9999,0
1668147549939,ECE 200,028,103613,Mir Arabbaygi; Siavash,9999,0,9999,0
1668147549939,ECE 200,029,103614,Mookherjea; Shayan,9999,0,9999,0
1668147549939,ECE 200,030,103615,Morris; Karcher William,9999,0,9999,0
1668147549939,ECE 200,031,103616,Ng; Tse Nga,9999,0,9999,0
1668147549939,ECE 200,032,103617,Nguyen; Truong Quang,9999,0,9999,0
1668147549939,ECE 200,033,103618,Nomura; Kenji,9999,0,9999,0
1668147549939,ECE 200,034,103619,Orlitsky; Alon,9999,0,9999,0
1668147549939,ECE 200,035,103620,Pal; Piya,9999,0,9999,0
1668147549939,ECE 200,036,103621,Papen; George C.,9999,0,9999,0
1668147549939,ECE 200,037,103622,Radic; Stojan,9999,0,9999,0
1668147549939,ECE 200,038,103623,Rao; Bhaskar D.,9999,0,9999,0
1668147549939,ECE 200,039,103624,Rao; Ramesh R,9999,0,9999,0
1668147549939,ECE 200,040,103625,Rebeiz; Gabriel,9999,0,9999,0
1668147549939,ECE 200,041,103626,Sanford; John R,9999,0,9999,0
1668147549939,ECE 200,042,103627,Siegel; Paul H.,9999,0,9999,0
1668147549939,ECE 200,043,103628,Sievenpiper; Daniel F.,9999,0,9999,0
1668147549939,ECE 200,044,103629,Sworder; David D.,9999,0,9999,0
1668147549939,ECE 200,045,103630,Taur; Yuan,9999,0,9999,0
1668147549939,ECE 200,046,103631,Touri; Behrouz,9999,0,9999,0
1668147549939,ECE 200,047,103632,Trivedi; Mohan M.,9999,0,9999,0
1668147549939,ECE 200,048,103633,Vasconcelos; Nuno,9999,0,9999,0
1668147549939,ECE 200,049,103634,Wang; Xiaolong,9999,0,9999,0
1668147549939,ECE 200,050,103635,Xie; Pengtao,9999,0,9999,0
1668147549939,ECE 200,051,103636,Yip; Michael,9999,0,9999,0
1668147549939,ECE 200,052,103637,Zeger; Kenneth A.,999,0,999,0
1668147549939,ECE 200,053,103638,Zhang; Xinyu,9999,0,9999,0
1668147549939,ECE 200,054,103639,Turakhia; Yatish Girish,9999,0,9999,0
1668147549939,ECE 200,055,103640,Kang; Mingu,9999,0,9999,0
1668147549939,ECE 200,056,103641,Shi; Yuanyuan,9999,0,9999,0
1668147549939,ECE 200,057,103642,Wang; Edward Jay,9999,0,9999,0
1668147549939,ECE 200,058,103643,Zheng; Yang,9999,0,9999,0
1668147550363,ECE 202,A00,103644,Kuzum; Duygu,0,0,0,0
1668147550787,ECE 212BN,A00,103646,Ng; Tse Nga,0,0,0,0
1668147551209,ECE 221,A00,111493,Staff,0,0,0,0
1668147551633,ECE 222B,A00,103647,Lomakin; Vitaliy,0,0,0,0
1668147552057,ECE 230B,A00,103648,Taur; Yuan,0,0,0,0
1668147552481,ECE 238B,A00,103649,Garay; Javier,0,0,0,0
1668147552905,ECE 240B,A00,112900,Fainman; Yeshaiahu,0,0,0,0
1668147553329,ECE 247A,A00,103650,Jokerst; Jesse Vincent,0,0,0,0
1668147553752,ECE 247B,A00,103651,Wang; Joseph,0,0,0,0
1668147554174,ECE 250,A00,103652,Siegel; Paul H.,0,0,0,0
1668147554598,ECE 251A,A00,103654,Rao; Bhaskar D.,0,0,0,0
1668147555024,ECE 257B,A00,103655,Bharadia; Dinesh,0,0,0,0
1668147555450,ECE 258A,A00,103656,Milstein; Laurence B.,0,0,0,0
1668147555882,ECE 260B,A00,103658,Kang; Mingu,0,0,0,0
1668147556306,ECE 264A,A00,103659,Galton; Ian A,0,0,0,0
1668147556732,ECE 265A,A00,103661,Gudem; Prasad S.S.,0,0,0,0
1668147557154,ECE 265D,A00,103662,Gudem; Prasad S.S.,0,0,0,0
1668147557580,ECE 268,A00,103663,Koushanfar; Farinaz,0,0,0,0
1668147558007,ECE 269,A01,103665,Pal; Piya,0,0,0,0
1668147558430,ECE 271B,A00,103666,Vasconcelos; Manuela,0,0,0,0
1668147558855,ECE 276A,A00,103667,Atanasov; Nikolay A.,0,0,0,0
1668147559282,ECE 277,A00,103668,An; Cheolhong,0,0,0,0
1668147559706,ECE 279,A00,117947,Hall; Drew A.,0,0,0,0
1668147560575,ECE 283,A00,103670,Hsueh; Tzu-Chien,0,0,0,0
1668147560997,ECE 284,A00,103671,Turakhia; Yatish Girish,0,0,0,0
1668147561420,ECE 285,A00,103672,Zheng; Yang,0,0,0,0
1668147561420,ECE 285,B00,103673,Sworder; David D.,0,0,0,0
1668147561846,ECE 287,A00,103676,Javidi; Tara,0,0,0,0
1668147562279,MATH 200B,A00,098023,Salehi Golsefidy; Alireza,12,0,15,3
1668147562704,MATH 202B,A00,098024,Rhoades; Brendon Patrick,9,0,15,6
1668147563129,MATH 203B,A00,098025,Oprea; Dragos N.,10,0,15,5
1668147563556,MATH 204B,A00,098026,Sorensen; Claus M,13,0,15,2
1668147563983,MATH 208,A00,098027,Izadi; Elham,7,0,10,3
1668147564406,MATH 209,A00,098028,Pollack; Aaron,10,0,10,0
1668147564831,MATH 211A,A00,112919,Rogalski; Daniel,9,0,10,1
1668147565255,MATH 211B,A00,112920,Seward; Brandon M.,9,0,10,1
1668147565685,MATH 218,A00,098029,Li; Bo,10,0,10,0
1668147566108,MATH 220B,A00,098030,Novak; Jonathan I,11,0,15,4
1668147566532,MATH 221A,A00,098031,Ebenfelt; Peter F,13,0,15,2
1668147566957,MATH 231B,A00,098032,Zlatos; Andrej,12,0,15,3
1668147567385,MATH 240B,A00,098033,Ni; Lei,9,0,15,6
1668147567815,MATH 243,A00,098034,Jekel; David Andrew,10,0,10,0
1668147568239,MATH 245A,A00,098035,Nie; Jiawang,0,0,15,16
1668147568661,MATH 248,A00,098036,Bejenaru; Ioan,10,0,10,0
1668147569087,MATH 250B,A00,098037,Spolaor; Luca,14,0,15,1
1668147569524,MATH 258,A00,098038,Ni; Lei,10,0,10,0
1668147569947,MATH 264B,A00,098041,Rhoades; Brendon Patrick,9,0,15,6
1668147570373,MATH 268,A00,098042,Buss; Samuel R,10,0,10,0
1668147570798,MATH 269,A00,098043,Rhoades; Brendon Patrick,10,0,10,0
1668147571221,MATH 270B,A00,098044,Li; Bo,10,0,15,5
1668147571645,MATH 272B,A00,098045,Holst; Michael J,13,0,15,2
1668147572071,MATH 273A,A00,098046,Tian; Xiaochuan,10,0,15,5
1668147572495,MATH 275,A01,098048,Tian; Xiaochuan,6,0,10,4
1668147572929,MATH 278A,A00,098049,Holst; Michael J,8,0,10,2
1668147573352,MATH 278B,A00,098050,Cloninger; Alexander,10,0,10,0
1668147573774,MATH 278C,A00,098051,Nie; Jiawang,7,0,10,3
1668147574200,MATH 280B,A00,098052,Zheng; Tianyi,10,0,15,5
1668147574625,MATH 281B,A00,098053,Bradic; Jelena,2,0,15,13
1668147575057,MATH 282B,A00,098054,Arias-Castro; Ery,0,0,15,15
1668147575481,MATH 285,A00,098055,Fitzsimmons; Patrick J,0,0,15,17
1668147575904,MATH 287B,A00,098056,Arias-Castro; Ery,2,0,15,13
1668147576328,MATH 288,A00,098057,Agarwal; Pooja,9,0,10,1
1668147576328,MATH 288,B00,098058,Zhang; Danna,8,0,10,2
1668147576328,MATH 288,C00,098059,Williams; Ruth J,10,0,10,0
1668147576753,MATH 290B,A00,098060,Roberts; Justin Deritter,13,0,15,2
1668147577175,MATH 292,A00,098061,Belmont; Eva Kinoshita,10,0,10,0
1668147577597,MATH 295,A00,098062,Suk; Andrew Hoon,48,0,50,2
1668147578028,MATH 296,A00,098063,Novak; Jonathan I,20,0,20,0
1668147578464,MATH 297,001,098064,Gamst; Anthony Collins,9997,0,9999,2
1668148077530,COGS 205,A00,101395,Chiba; Andrea,19,0,20,1
1668148077955,COGS 210B,001,101404,Greene; Deanna Jacquelyn,9998,0,9999,1
1668148077955,COGS 210B,002,101417,Xia; Haijun,9999,0,9999,0
1668148077955,COGS 210B,003,101422,Nitz; Douglas A.,9999,0,9999,0
1668148077955,COGS 210B,004,101423,Hollan; James D.,9998,0,9999,1
1668148077955,COGS 210B,005,101424,Deak; Gedeon O.,9998,0,9999,1
1668148077955,COGS 210B,006,101425,Rossano; Federico,9999,0,9999,0
1668148078381,COGS 211B,A00,101427,Coulson; Seana M,9996,0,9999,3
1668148078807,COGS 220,A00,101428,Hollan; James D.,0,0,25,25
1668148079230,COGS 229,A00,101429,Dow; Steven P,18,0,25,7
1668148079653,COGS 230,A00,101430,Klemmer; Scott R,12,0,17,5
1668148080080,COGS 234,A00,101431,Xia; Haijun,3,0,25,22
1668148080510,COGS 260,A00,101432,Kiyonaga; Anastasia,20,0,25,5
1668148080510,COGS 260,B00,101433,Kirsh; David Joel,16,0,25,9
1668148080934,CSE 202,A00,102371,Impagliazzo; Russell,0,0,0,0
1668148081369,CSE 203B,A01,102373,Cheng; Chung Kuan,0,0,0,0
1668148081792,CSE 208,A00,102374,Micciancio; Daniele,0,0,0,0
1668148082216,CSE 209A,A00,112895,Impagliazzo; Russell,0,0,15,15
1668148082642,CSE 209B,A00,108005,Bellare; Mihir,0,0,0,0
1668148083066,CSE 210,A00,113163,Coblenz; Michael J,0,0,0,0
1668148083498,CSE 219,A00,106111,Dow; Steven P,0,0,20,20
1668148083922,CSE 221,A00,102376,Voelker; Geoffrey M.,0,0,0,0
1668148084346,CSE 224,A01,102378,Porter; George M,0,0,0,0
1668148084771,CSE 229A,A00,102379,Savage; Stefan,0,0,0,0
1668148085197,CSE 229C,A00,102380,Munyaka; Imani N. S.,0,0,0,0
1668148085620,CSE 232B,A00,102382,Deutsch; Alin Bernard,0,0,0,0
1668148086043,CSE 234,A01,112904,Kumar; Arun Kumar,0,0,0,0
1668148086467,CSE 237A,A00,102383,Rosing; Tajana Simunic,0,0,0,0
1668148086890,CSE 239A,A00,102384,Deutsch; Alin Bernard,0,0,0,0
1668148087314,CSE 239B,A00,102385,Polikarpova; Nadezhda,0,0,0,0
1668148087739,CSE 240A,A00,102386,Pannuto; Patrick William,0,0,0,0
1668148088161,CSE 240B,A00,102387,Zhao; Jishen,0,0,0,0
1668148088583,CSE 241A,A00,106406,Kang; Mingu,0,0,0,0
1668148089009,CSE 249B,A00,102388,Kahng; Andrew Byun,0,0,8,8
1668148089437,CSE 251B,A01,102392,Cottrell; Garrison W,0,0,0,0
1668148089437,CSE 251B,A02,102393,Cottrell; Garrison W,0,0,0,0
1668148089860,CSE 252B,A00,102394,Ochoa; Benjamin Lawrence,0,0,0,0
1668148090282,CSE 257,A01,102396,Gao; Sicun,0,0,0,0
1668148090707,CSE 272,A00,102397,Li; Tzumao,0,0,0,0
1668148091134,CSE 274,A00,111323,Chern; Albert Ren-Haur,0,0,0,0
1668148091556,CSE 282,A00,102398,Pevzner; Pavel Arkadjevich,0,0,0,0
1668148091987,CSE 284,A00,114175,Gymrek; Melissa Ann,0,0,0,0
1668148092414,CSE 290,A00,102399,Chandraker; Manmohan Krishna,0,0,0,0
1668148092414,CSE 290,B00,102400,Vaccaro; Kristen Marie,0,0,25,25
1668148092414,CSE 290,C00,102414,Pannuto; Patrick William,0,0,25,25
1668148092414,CSE 290,D00,102427,Pevzner; Pavel Arkadjevich,0,0,0,0
1668148092414,CSE 290,E00,102429,Zhao; Jishen,0,0,0,0
1668148092414,CSE 290,F00,102436,Tullsen; Dean Michael,0,0,0,0
1668148092414,CSE 290,G00,102440,Christensen; Henrik I,0,0,20,20
1668148092843,CSE 291,A00,102443,Su; Hao,0,0,0,0
1668148092843,CSE 291,B00,102448,Polikarpova; Nadezhda,0,0,0,0
1668148092843,CSE 291,C00,102453,Vaccaro; Kristen Marie,0,0,0,0
1668148092843,CSE 291,D00,111343,Savage; Stefan,0,0,0,0
1668148092843,CSE 291,E00,116474,Claffy; Kimberly Claire,0,0,0,0
1668148092843,CSE 291,F00,116479,Pasquale; Joseph,0,0,0,0
1668148093281,CSE 293,001,119111,Bafna; Vineet,9999,0,9999,0
1668148093281,CSE 293,002,119118,Bellare; Mihir,9999,0,9999,0
1668148093281,CSE 293,003,119122,Berg-Kirkpatrick; Taylor D,9999,0,9999,0
1668148093281,CSE 293,004,119135,Christensen; Henrik I,9999,0,9999,0
1668148093281,CSE 293,005,119142,Cottrell; Garrison W,9999,0,9999,0
1668148093281,CSE 293,006,119146,Deutsch; Alin Bernard,9999,0,9999,0
1668148093281,CSE 293,007,119159,Esmaeilzadeh; Hadi,9999,0,9999,0
1668148093281,CSE 293,008,119166,Freund; Yoav,9999,0,9999,0
1668148093281,CSE 293,009,119170,Griswold; William G.,9999,0,9999,0
1668148093281,CSE 293,010,119183,Gymrek; Melissa Ann,9999,0,9999,0
1668148093281,CSE 293,011,119190,Heninger; Nadia A,9999,0,9999,0
1668148093281,CSE 293,012,119230,Impagliazzo; Russell,9999,0,9999,0
1668148093281,CSE 293,013,119232,Jhala; Ranjit,9999,0,9999,0
1668148093281,CSE 293,014,119233,Kahng; Andrew Byun,9999,0,9999,0
1668148093281,CSE 293,015,119298,Kane; Daniel Mertz,9999,0,9999,0
1668148093281,CSE 293,016,119299,Kriegman; David J,9999,0,9999,0
1668148093281,CSE 293,017,119300,Kumar; Arun Kumar,9999,0,9999,0
1668148093281,CSE 293,018,119301,Lerner; Sorin,9999,0,9999,0
1668148093281,CSE 293,019,119302,Lovett; Shachar,9999,0,9999,0
1668148093281,CSE 293,020,119303,McAuley; Julian John,9999,0,9999,0
1668148093281,CSE 293,021,119304,Micciancio; Daniele,9999,0,9999,0
1668148093281,CSE 293,022,119367,Orailoglu; Alex,9999,0,9999,0
1668148093281,CSE 293,023,119382,Paturi; Ramamohan,9999,0,9999,0
1668148093281,CSE 293,024,119404,Polikarpova; Nadezhda,9999,0,9999,0
1668148093281,CSE 293,025,119406,Politz; Joseph Gibbs,9999,0,9999,0
1668148093281,CSE 293,026,119411,Porter; George M,9999,0,9999,0
1668148093281,CSE 293,027,119414,Porter; Leonard Emerson,9999,0,9999,0
1668148093281,CSE 293,028,119416,Ramamoorthi; Ravi,9999,0,9999,0
1668148093281,CSE 293,029,119417,Sahoo; Debashis,9999,0,9999,0
1668148093281,CSE 293,030,119420,Saul; Lawrence,9999,0,9999,0
1668148093281,CSE 293,031,119421,Savage; Stefan,9999,0,9999,0
1668148093281,CSE 293,032,119425,Schulze; Jurgen P.,9999,0,9999,0
1668148093281,CSE 293,033,119426,Snoeren; Alex C.,9999,0,9999,0
1668148093281,CSE 293,034,119428,Shang; Jingbo,9999,0,9999,0
1668148093281,CSE 293,035,119430,Stefan; Deian,9999,0,9999,0
1668148093281,CSE 293,036,119431,Su; Hao,9999,0,9999,0
1668148093281,CSE 293,037,119433,Swanson; Steven James,9999,0,9999,0
1668148093281,CSE 293,038,119435,Tullsen; Dean Michael,9999,0,9999,0
1668148093281,CSE 293,039,119483,Voelker; Geoffrey M.,9999,0,9999,0
1668148093281,CSE 293,040,119537,Zhao; Jishen,9999,0,9999,0
1668148093281,CSE 293,041,119538,Zhou; Yuan-Yuan,9999,0,9999,0
1668148093281,CSE 293,042,119539,Gao; Sicun,9999,0,9999,0
1668148093281,CSE 293,043,119540,Weibel; Nadir,9999,0,9999,0
1668148093281,CSE 293,044,119541,Gupta; Rajesh K.,9999,0,9999,0
1668148093281,CSE 293,045,126410,Vaccaro; Kristen Marie,9999,0,9999,0
1668148093281,CSE 293,046,126411,Klemke; Richard,9999,0,9999,0
1668148093706,CSE 294,A00,102459,Voelker; Geoffrey M.,0,0,0,0
1668148093706,CSE 294,B00,111322,Orailoglu; Alex,0,0,0,0
1668148094129,DSE 201,A00,096914,Deutsch; Alin Bernard,30,0,30,0
1668148094554,DSE 210,A00,096915,Dasgupta; Sanjoy,30,0,30,0
1668148094979,DSE 260A,A00,096916,Altintas De Callaf; Ilkay,30,0,30,0
1668148095413,ECE 200,001,103586,Antipa; Nicholas A,9999,0,9999,0
1668148095413,ECE 200,002,103587,Atanasov; Nikolay A.,9999,0,9999,0
1668148095413,ECE 200,003,103588,Bharadia; Dinesh,9999,0,9999,0
1668148095413,ECE 200,004,103589,Cheng; Chung Kuan,9999,0,9999,0
1668148095413,ECE 200,005,103590,Cosman; Pamela C.,9999,0,9999,0
1668148095413,ECE 200,006,103591,Dayeh; Shadi Ahmad,9999,0,9999,0
1668148095413,ECE 200,007,103592,Fainman; Yeshaiahu,9999,0,9999,0
1668148095413,ECE 200,008,103593,Ford; Joseph Earl,9999,0,9999,0
1668148095413,ECE 200,009,103594,Franceschetti; Massimo,9999,0,9999,0
1668148095413,ECE 200,010,103595,Fullerton; Eric E,9999,0,9999,0
1668148095413,ECE 200,011,103596,Galton; Ian A,9999,0,9999,0
1668148095413,ECE 200,012,103597,Gilja; Vikash,9999,0,9999,0
1668148095413,ECE 200,013,103598,Hall; Drew A.,9999,0,9999,0
1668148095413,ECE 200,014,103599,Hsueh; Tzu-Chien,9999,0,9999,0
1668148095413,ECE 200,015,103600,Javidi; Tara,9999,0,9999,0
1668148095413,ECE 200,016,103601,Kahng; Andrew Byun,9999,0,9999,0
1668148095413,ECE 200,017,103602,Kim; Young-Han,9999,0,9999,0
1668148095413,ECE 200,018,103603,Koushanfar; Farinaz,9999,0,9999,0
1668148095413,ECE 200,019,103604,Kuzum; Duygu,9999,0,9999,0
1668148095413,ECE 200,020,103605,Le; Hanh-Phuc,9999,0,9999,0
1668148095413,ECE 200,021,103606,Lin; Bill,9999,0,9999,0
1668148095413,ECE 200,022,103607,Liu; Zhaowei,9998,0,9999,1
1668148095413,ECE 200,023,103608,Lo; Yu-Hwa,9999,0,9999,0
1668148095413,ECE 200,024,103609,Lomakin; Vitaliy,9999,0,9999,0
1668148095413,ECE 200,025,103610,Mercier; Patrick Philip,9999,0,9999,0
1668148095413,ECE 200,026,103611,Meyer; Florian,9999,0,9999,0
1668148095413,ECE 200,027,103612,Milstein; Laurence B.,9999,0,9999,0
1668148095413,ECE 200,028,103613,Mir Arabbaygi; Siavash,9999,0,9999,0
1668148095413,ECE 200,029,103614,Mookherjea; Shayan,9999,0,9999,0
1668148095413,ECE 200,030,103615,Morris; Karcher William,9999,0,9999,0
1668148095413,ECE 200,031,103616,Ng; Tse Nga,9999,0,9999,0
1668148095413,ECE 200,032,103617,Nguyen; Truong Quang,9999,0,9999,0
1668148095413,ECE 200,033,103618,Nomura; Kenji,9999,0,9999,0
1668148095413,ECE 200,034,103619,Orlitsky; Alon,9999,0,9999,0
1668148095413,ECE 200,035,103620,Pal; Piya,9999,0,9999,0
1668148095413,ECE 200,036,103621,Papen; George C.,9999,0,9999,0
1668148095413,ECE 200,037,103622,Radic; Stojan,9999,0,9999,0
1668148095413,ECE 200,038,103623,Rao; Bhaskar D.,9999,0,9999,0
1668148095413,ECE 200,039,103624,Rao; Ramesh R,9999,0,9999,0
1668148095413,ECE 200,040,103625,Rebeiz; Gabriel,9999,0,9999,0
1668148095413,ECE 200,041,103626,Sanford; John R,9999,0,9999,0
1668148095413,ECE 200,042,103627,Siegel; Paul H.,9999,0,9999,0
1668148095413,ECE 200,043,103628,Sievenpiper; Daniel F.,9999,0,9999,0
1668148095413,ECE 200,044,103629,Sworder; David D.,9999,0,9999,0
1668148095413,ECE 200,045,103630,Taur; Yuan,9999,0,9999,0
1668148095413,ECE 200,046,103631,Touri; Behrouz,9999,0,9999,0
1668148095413,ECE 200,047,103632,Trivedi; Mohan M.,9999,0,9999,0
1668148095413,ECE 200,048,103633,Vasconcelos; Nuno,9999,0,9999,0
1668148095413,ECE 200,049,103634,Wang; Xiaolong,9999,0,9999,0
1668148095413,ECE 200,050,103635,Xie; Pengtao,9999,0,9999,0
1668148095413,ECE 200,051,103636,Yip; Michael,9999,0,9999,0
1668148095413,ECE 200,052,103637,Zeger; Kenneth A.,999,0,999,0
1668148095413,ECE 200,053,103638,Zhang; Xinyu,9999,0,9999,0
1668148095413,ECE 200,054,103639,Turakhia; Yatish Girish,9999,0,9999,0
1668148095413,ECE 200,055,103640,Kang; Mingu,9999,0,9999,0
1668148095413,ECE 200,056,103641,Shi; Yuanyuan,9999,0,9999,0
1668148095413,ECE 200,057,103642,Wang; Edward Jay,9999,0,9999,0
1668148095413,ECE 200,058,103643,Zheng; Yang,9999,0,9999,0
1668148095836,ECE 202,A00,103644,Kuzum; Duygu,0,0,0,0
1668148096261,ECE 212BN,A00,103646,Ng; Tse Nga,0,0,0,0
1668148096683,ECE 221,A00,111493,Staff,0,0,0,0
1668148097110,ECE 222B,A00,103647,Lomakin; Vitaliy,0,0,0,0
1668148097532,ECE 230B,A00,103648,Taur; Yuan,0,0,0,0
1668148097955,ECE 238B,A00,103649,Garay; Javier,0,0,0,0
1668148098385,ECE 240B,A00,112900,Fainman; Yeshaiahu,0,0,0,0
1668148098810,ECE 247A,A00,103650,Jokerst; Jesse Vincent,0,0,0,0
1668148099236,ECE 247B,A00,103651,Wang; Joseph,0,0,0,0
1668148099667,ECE 250,A00,103652,Siegel; Paul H.,0,0,0,0
1668148100093,ECE 251A,A00,103654,Rao; Bhaskar D.,0,0,0,0
1668148100514,ECE 257B,A00,103655,Bharadia; Dinesh,0,0,0,0
1668148100938,ECE 258A,A00,103656,Milstein; Laurence B.,0,0,0,0
1668148101362,ECE 260B,A00,103658,Kang; Mingu,0,0,0,0
1668148101786,ECE 264A,A00,103659,Galton; Ian A,0,0,0,0
1668148102209,ECE 265A,A00,103661,Gudem; Prasad S.S.,0,0,0,0
1668148102632,ECE 265D,A00,103662,Gudem; Prasad S.S.,0,0,0,0
1668148103059,ECE 268,A00,103663,Koushanfar; Farinaz,0,0,0,0
1668148103486,ECE 269,A01,103665,Pal; Piya,0,0,0,0
1668148103912,ECE 271B,A00,103666,Vasconcelos; Manuela,0,0,0,0
1668148104412,ECE 276A,A00,103667,Atanasov; Nikolay A.,0,0,0,0
1668148104837,ECE 277,A00,103668,An; Cheolhong,0,0,0,0
1668148105263,ECE 279,A00,117947,Hall; Drew A.,0,0,0,0
1668148106112,ECE 283,A00,103670,Hsueh; Tzu-Chien,0,0,0,0
1668148106539,ECE 284,A00,103671,Turakhia; Yatish Girish,0,0,0,0
1668148106963,ECE 285,A00,103672,Zheng; Yang,0,0,0,0
1668148106963,ECE 285,B00,103673,Sworder; David D.,0,0,0,0
1668148107386,ECE 287,A00,103676,Javidi; Tara,0,0,0,0
1668148107810,MATH 200B,A00,098023,Salehi Golsefidy; Alireza,12,0,15,3
1668148108233,MATH 202B,A00,098024,Rhoades; Brendon Patrick,9,0,15,6
1668148108656,MATH 203B,A00,098025,Oprea; Dragos N.,10,0,15,5
1668148109081,MATH 204B,A00,098026,Sorensen; Claus M,13,0,15,2
1668148109504,MATH 208,A00,098027,Izadi; Elham,7,0,10,3
1668148109933,MATH 209,A00,098028,Pollack; Aaron,10,0,10,0
1668148110358,MATH 211A,A00,112919,Rogalski; Daniel,9,0,10,1
1668148110781,MATH 211B,A00,112920,Seward; Brandon M.,9,0,10,1
1668148111205,MATH 218,A00,098029,Li; Bo,10,0,10,0
1668148111634,MATH 220B,A00,098030,Novak; Jonathan I,11,0,15,4
1668148112062,MATH 221A,A00,098031,Ebenfelt; Peter F,13,0,15,2
1668148112486,MATH 231B,A00,098032,Zlatos; Andrej,12,0,15,3
1668148112909,MATH 240B,A00,098033,Ni; Lei,9,0,15,6
1668148113333,MATH 243,A00,098034,Jekel; David Andrew,10,0,10,0
1668148113758,MATH 245A,A00,098035,Nie; Jiawang,0,0,15,16
1668148114178,MATH 248,A00,098036,Bejenaru; Ioan,10,0,10,0
1668148114607,MATH 250B,A00,098037,Spolaor; Luca,14,0,15,1
1668148115029,MATH 258,A00,098038,Ni; Lei,10,0,10,0
1668148115451,MATH 264B,A00,098041,Rhoades; Brendon Patrick,9,0,15,6
1668148115876,MATH 268,A00,098042,Buss; Samuel R,10,0,10,0
1668148116300,MATH 269,A00,098043,Rhoades; Brendon Patrick,10,0,10,0
1668148116727,MATH 270B,A00,098044,Li; Bo,10,0,15,5
1668148117155,MATH 272B,A00,098045,Holst; Michael J,13,0,15,2
1668148117581,MATH 273A,A00,098046,Tian; Xiaochuan,10,0,15,5
1668148118008,MATH 275,A01,098048,Tian; Xiaochuan,6,0,10,4
1668148118430,MATH 278A,A00,098049,Holst; Michael J,8,0,10,2
1668148118859,MATH 278B,A00,098050,Cloninger; Alexander,10,0,10,0
1668148119282,MATH 278C,A00,098051,Nie; Jiawang,7,0,10,3
1668148119703,MATH 280B,A00,098052,Zheng; Tianyi,10,0,15,5
1668148120133,MATH 281B,A00,098053,Bradic; Jelena,2,0,15,13
1668148120561,MATH 282B,A00,098054,Arias-Castro; Ery,0,0,15,15
1668148120985,MATH 285,A00,098055,Fitzsimmons; Patrick J,0,0,15,17
1668148121410,MATH 287B,A00,098056,Arias-Castro; Ery,2,0,15,13
1668148121834,MATH 288,A00,098057,Agarwal; Pooja,9,0,10,1
1668148121834,MATH 288,B00,098058,Zhang; Danna,8,0,10,2
1668148121834,MATH 288,C00,098059,Williams; Ruth J,10,0,10,0
1668148122260,MATH 290B,A00,098060,Roberts; Justin Deritter,13,0,15,2
1668148122689,MATH 292,A00,098061,Belmont; Eva Kinoshita,10,0,10,0
1668148123113,MATH 295,A00,098062,Suk; Andrew Hoon,48,0,50,2
1668148123536,MATH 296,A00,098063,Novak; Jonathan I,20,0,20,0
1668148123960,MATH 297,001,098064,Gamst; Anthony Collins,9997,0,9999,2
1668148623152,COGS 205,A00,101395,Chiba; Andrea,19,0,20,1
1668148623656,COGS 210B,001,101404,Greene; Deanna Jacquelyn,9998,0,9999,1
1668148623656,COGS 210B,002,101417,Xia; Haijun,9999,0,9999,0
1668148623656,COGS 210B,003,101422,Nitz; Douglas A.,9999,0,9999,0
1668148623656,COGS 210B,004,101423,Hollan; James D.,9998,0,9999,1
1668148623656,COGS 210B,005,101424,Deak; Gedeon O.,9998,0,9999,1
1668148623656,COGS 210B,006,101425,Rossano; Federico,9999,0,9999,0
1668148624081,COGS 211B,A00,101427,Coulson; Seana M,9996,0,9999,3
1668148624512,COGS 220,A00,101428,Hollan; James D.,0,0,25,25
1668148624936,COGS 229,A00,101429,Dow; Steven P,18,0,25,7
1668148625362,COGS 230,A00,101430,Klemmer; Scott R,12,0,17,5
1668148625785,COGS 234,A00,101431,Xia; Haijun,3,0,25,22
1668148626209,COGS 260,A00,101432,Kiyonaga; Anastasia,20,0,25,5
1668148626209,COGS 260,B00,101433,Kirsh; David Joel,16,0,25,9
1668148626634,CSE 202,A00,102371,Impagliazzo; Russell,0,0,0,0
1668148627057,CSE 203B,A01,102373,Cheng; Chung Kuan,0,0,0,0
1668148627485,CSE 208,A00,102374,Micciancio; Daniele,0,0,0,0
1668148627909,CSE 209A,A00,112895,Impagliazzo; Russell,0,0,15,15
1668148628331,CSE 209B,A00,108005,Bellare; Mihir,0,0,0,0
1668148628757,CSE 210,A00,113163,Coblenz; Michael J,0,0,0,0
1668148629179,CSE 219,A00,106111,Dow; Steven P,0,0,20,20
1668148629601,CSE 221,A00,102376,Voelker; Geoffrey M.,0,0,0,0
1668148630023,CSE 224,A01,102378,Porter; George M,0,0,0,0
1668148630447,CSE 229A,A00,102379,Savage; Stefan,0,0,0,0
1668148630874,CSE 229C,A00,102380,Munyaka; Imani N. S.,0,0,0,0
1668148631297,CSE 232B,A00,102382,Deutsch; Alin Bernard,0,0,0,0
1668148631724,CSE 234,A01,112904,Kumar; Arun Kumar,0,0,0,0
1668148632151,CSE 237A,A00,102383,Rosing; Tajana Simunic,0,0,0,0
1668148632587,CSE 239A,A00,102384,Deutsch; Alin Bernard,0,0,0,0
1668148633009,CSE 239B,A00,102385,Polikarpova; Nadezhda,0,0,0,0
1668148633432,CSE 240A,A00,102386,Pannuto; Patrick William,0,0,0,0
1668148633856,CSE 240B,A00,102387,Zhao; Jishen,0,0,0,0
1668148634279,CSE 241A,A00,106406,Kang; Mingu,0,0,0,0
1668148634702,CSE 249B,A00,102388,Kahng; Andrew Byun,0,0,8,8
1668148635127,CSE 251B,A01,102392,Cottrell; Garrison W,0,0,0,0
1668148635127,CSE 251B,A02,102393,Cottrell; Garrison W,0,0,0,0
1668148635551,CSE 252B,A00,102394,Ochoa; Benjamin Lawrence,0,0,0,0
1668148635976,CSE 257,A01,102396,Gao; Sicun,0,0,0,0
1668148636405,CSE 272,A00,102397,Li; Tzumao,0,0,0,0
1668148636830,CSE 274,A00,111323,Chern; Albert Ren-Haur,0,0,0,0
1668148637262,CSE 282,A00,102398,Pevzner; Pavel Arkadjevich,0,0,0,0
1668148637687,CSE 284,A00,114175,Gymrek; Melissa Ann,0,0,0,0
1668148638111,CSE 290,A00,102399,Chandraker; Manmohan Krishna,0,0,0,0
1668148638111,CSE 290,B00,102400,Vaccaro; Kristen Marie,0,0,25,25
1668148638111,CSE 290,C00,102414,Pannuto; Patrick William,0,0,25,25
1668148638111,CSE 290,D00,102427,Pevzner; Pavel Arkadjevich,0,0,0,0
1668148638111,CSE 290,E00,102429,Zhao; Jishen,0,0,0,0
1668148638111,CSE 290,F00,102436,Tullsen; Dean Michael,0,0,0,0
1668148638111,CSE 290,G00,102440,Christensen; Henrik I,0,0,20,20
1668148638536,CSE 291,A00,102443,Su; Hao,0,0,0,0
1668148638536,CSE 291,B00,102448,Polikarpova; Nadezhda,0,0,0,0
1668148638536,CSE 291,C00,102453,Vaccaro; Kristen Marie,0,0,0,0
1668148638536,CSE 291,D00,111343,Savage; Stefan,0,0,0,0
1668148638536,CSE 291,E00,116474,Claffy; Kimberly Claire,0,0,0,0
1668148638536,CSE 291,F00,116479,Pasquale; Joseph,0,0,0,0
1668148638969,CSE 293,001,119111,Bafna; Vineet,9999,0,9999,0
1668148638969,CSE 293,002,119118,Bellare; Mihir,9999,0,9999,0
1668148638969,CSE 293,003,119122,Berg-Kirkpatrick; Taylor D,9999,0,9999,0
1668148638969,CSE 293,004,119135,Christensen; Henrik I,9999,0,9999,0
1668148638969,CSE 293,005,119142,Cottrell; Garrison W,9999,0,9999,0
1668148638969,CSE 293,006,119146,Deutsch; Alin Bernard,9999,0,9999,0
1668148638969,CSE 293,007,119159,Esmaeilzadeh; Hadi,9999,0,9999,0
1668148638969,CSE 293,008,119166,Freund; Yoav,9999,0,9999,0
1668148638969,CSE 293,009,119170,Griswold; William G.,9999,0,9999,0
1668148638969,CSE 293,010,119183,Gymrek; Melissa Ann,9999,0,9999,0
1668148638969,CSE 293,011,119190,Heninger; Nadia A,9999,0,9999,0
1668148638969,CSE 293,012,119230,Impagliazzo; Russell,9999,0,9999,0
1668148638969,CSE 293,013,119232,Jhala; Ranjit,9999,0,9999,0
1668148638969,CSE 293,014,119233,Kahng; Andrew Byun,9999,0,9999,0
1668148638969,CSE 293,015,119298,Kane; Daniel Mertz,9999,0,9999,0
1668148638969,CSE 293,016,119299,Kriegman; David J,9999,0,9999,0
1668148638969,CSE 293,017,119300,Kumar; Arun Kumar,9999,0,9999,0
1668148638969,CSE 293,018,119301,Lerner; Sorin,9999,0,9999,0
1668148638969,CSE 293,019,119302,Lovett; Shachar,9999,0,9999,0
1668148638969,CSE 293,020,119303,McAuley; Julian John,9999,0,9999,0
1668148638969,CSE 293,021,119304,Micciancio; Daniele,9999,0,9999,0
1668148638969,CSE 293,022,119367,Orailoglu; Alex,9999,0,9999,0
1668148638969,CSE 293,023,119382,Paturi; Ramamohan,9999,0,9999,0
1668148638969,CSE 293,024,119404,Polikarpova; Nadezhda,9999,0,9999,0
1668148638969,CSE 293,025,119406,Politz; Joseph Gibbs,9999,0,9999,0
1668148638969,CSE 293,026,119411,Porter; George M,9999,0,9999,0
1668148638969,CSE 293,027,119414,Porter; Leonard Emerson,9999,0,9999,0
1668148638969,CSE 293,028,119416,Ramamoorthi; Ravi,9999,0,9999,0
1668148638969,CSE 293,029,119417,Sahoo; Debashis,9999,0,9999,0
1668148638969,CSE 293,030,119420,Saul; Lawrence,9999,0,9999,0
1668148638969,CSE 293,031,119421,Savage; Stefan,9999,0,9999,0
1668148638969,CSE 293,032,119425,Schulze; Jurgen P.,9999,0,9999,0
1668148638969,CSE 293,033,119426,Snoeren; Alex C.,9999,0,9999,0
1668148638969,CSE 293,034,119428,Shang; Jingbo,9999,0,9999,0
1668148638969,CSE 293,035,119430,Stefan; Deian,9999,0,9999,0
1668148638969,CSE 293,036,119431,Su; Hao,9999,0,9999,0
1668148638969,CSE 293,037,119433,Swanson; Steven James,9999,0,9999,0
1668148638969,CSE 293,038,119435,Tullsen; Dean Michael,9999,0,9999,0
1668148638969,CSE 293,039,119483,Voelker; Geoffrey M.,9999,0,9999,0
1668148638969,CSE 293,040,119537,Zhao; Jishen,9999,0,9999,0
1668148638969,CSE 293,041,119538,Zhou; Yuan-Yuan,9999,0,9999,0
1668148638969,CSE 293,042,119539,Gao; Sicun,9999,0,9999,0
1668148638969,CSE 293,043,119540,Weibel; Nadir,9999,0,9999,0
1668148638969,CSE 293,044,119541,Gupta; Rajesh K.,9999,0,9999,0
1668148638969,CSE 293,045,126410,Vaccaro; Kristen Marie,9999,0,9999,0
1668148638969,CSE 293,046,126411,Klemke; Richard,9999,0,9999,0
1668148639400,CSE 294,A00,102459,Voelker; Geoffrey M.,0,0,0,0
1668148639400,CSE 294,B00,111322,Orailoglu; Alex,0,0,0,0
1668148639825,DSE 201,A00,096914,Deutsch; Alin Bernard,30,0,30,0
1668148640252,DSE 210,A00,096915,Dasgupta; Sanjoy,30,0,30,0
1668148640677,DSE 260A,A00,096916,Altintas De Callaf; Ilkay,30,0,30,0
1668148641110,ECE 200,001,103586,Antipa; Nicholas A,9999,0,9999,0
1668148641110,ECE 200,002,103587,Atanasov; Nikolay A.,9999,0,9999,0
1668148641110,ECE 200,003,103588,Bharadia; Dinesh,9999,0,9999,0
1668148641110,ECE 200,004,103589,Cheng; Chung Kuan,9999,0,9999,0
1668148641110,ECE 200,005,103590,Cosman; Pamela C.,9999,0,9999,0
1668148641110,ECE 200,006,103591,Dayeh; Shadi Ahmad,9999,0,9999,0
1668148641110,ECE 200,007,103592,Fainman; Yeshaiahu,9999,0,9999,0
1668148641110,ECE 200,008,103593,Ford; Joseph Earl,9999,0,9999,0
1668148641110,ECE 200,009,103594,Franceschetti; Massimo,9999,0,9999,0
1668148641110,ECE 200,010,103595,Fullerton; Eric E,9999,0,9999,0
1668148641110,ECE 200,011,103596,Galton; Ian A,9999,0,9999,0
1668148641110,ECE 200,012,103597,Gilja; Vikash,9999,0,9999,0
1668148641110,ECE 200,013,103598,Hall; Drew A.,9999,0,9999,0
1668148641110,ECE 200,014,103599,Hsueh; Tzu-Chien,9999,0,9999,0
1668148641110,ECE 200,015,103600,Javidi; Tara,9999,0,9999,0
1668148641110,ECE 200,016,103601,Kahng; Andrew Byun,9999,0,9999,0
1668148641110,ECE 200,017,103602,Kim; Young-Han,9999,0,9999,0
1668148641110,ECE 200,018,103603,Koushanfar; Farinaz,9999,0,9999,0
1668148641110,ECE 200,019,103604,Kuzum; Duygu,9999,0,9999,0
1668148641110,ECE 200,020,103605,Le; Hanh-Phuc,9999,0,9999,0
1668148641110,ECE 200,021,103606,Lin; Bill,9999,0,9999,0
1668148641110,ECE 200,022,103607,Liu; Zhaowei,9998,0,9999,1
1668148641110,ECE 200,023,103608,Lo; Yu-Hwa,9999,0,9999,0
1668148641110,ECE 200,024,103609,Lomakin; Vitaliy,9999,0,9999,0
1668148641110,ECE 200,025,103610,Mercier; Patrick Philip,9999,0,9999,0
1668148641110,ECE 200,026,103611,Meyer; Florian,9999,0,9999,0
1668148641110,ECE 200,027,103612,Milstein; Laurence B.,9999,0,9999,0
1668148641110,ECE 200,028,103613,Mir Arabbaygi; Siavash,9999,0,9999,0
1668148641110,ECE 200,029,103614,Mookherjea; Shayan,9999,0,9999,0
1668148641110,ECE 200,030,103615,Morris; Karcher William,9999,0,9999,0
1668148641110,ECE 200,031,103616,Ng; Tse Nga,9999,0,9999,0
1668148641110,ECE 200,032,103617,Nguyen; Truong Quang,9999,0,9999,0
1668148641110,ECE 200,033,103618,Nomura; Kenji,9999,0,9999,0
1668148641110,ECE 200,034,103619,Orlitsky; Alon,9999,0,9999,0
1668148641110,ECE 200,035,103620,Pal; Piya,9999,0,9999,0
1668148641110,ECE 200,036,103621,Papen; George C.,9999,0,9999,0
1668148641110,ECE 200,037,103622,Radic; Stojan,9999,0,9999,0
1668148641110,ECE 200,038,103623,Rao; Bhaskar D.,9999,0,9999,0
1668148641110,ECE 200,039,103624,Rao; Ramesh R,9999,0,9999,0
1668148641110,ECE 200,040,103625,Rebeiz; Gabriel,9999,0,9999,0
1668148641110,ECE 200,041,103626,Sanford; John R,9999,0,9999,0
1668148641110,ECE 200,042,103627,Siegel; Paul H.,9999,0,9999,0
1668148641110,ECE 200,043,103628,Sievenpiper; Daniel F.,9999,0,9999,0
1668148641110,ECE 200,044,103629,Sworder; David D.,9999,0,9999,0
1668148641110,ECE 200,045,103630,Taur; Yuan,9999,0,9999,0
1668148641110,ECE 200,046,103631,Touri; Behrouz,9999,0,9999,0
1668148641110,ECE 200,047,103632,Trivedi; Mohan M.,9999,0,9999,0
1668148641110,ECE 200,048,103633,Vasconcelos; Nuno,9999,0,9999,0
1668148641110,ECE 200,049,103634,Wang; Xiaolong,9999,0,9999,0
1668148641110,ECE 200,050,103635,Xie; Pengtao,9999,0,9999,0
1668148641110,ECE 200,051,103636,Yip; Michael,9999,0,9999,0
1668148641110,ECE 200,052,103637,Zeger; Kenneth A.,999,0,999,0
1668148641110,ECE 200,053,103638,Zhang; Xinyu,9999,0,9999,0
1668148641110,ECE 200,054,103639,Turakhia; Yatish Girish,9999,0,9999,0
1668148641110,ECE 200,055,103640,Kang; Mingu,9999,0,9999,0
1668148641110,ECE 200,056,103641,Shi; Yuanyuan,9999,0,9999,0
1668148641110,ECE 200,057,103642,Wang; Edward Jay,9999,0,9999,0
1668148641110,ECE 200,058,103643,Zheng; Yang,9999,0,9999,0
1668148641533,ECE 202,A00,103644,Kuzum; Duygu,0,0,0,0
1668148641956,ECE 212BN,A00,103646,Ng; Tse Nga,0,0,0,0
1668148642379,ECE 221,A00,111493,Staff,0,0,0,0
1668148642802,ECE 222B,A00,103647,Lomakin; Vitaliy,0,0,0,0
1668148643244,ECE 230B,A00,103648,Taur; Yuan,0,0,0,0
1668148643665,ECE 238B,A00,103649,Garay; Javier,0,0,0,0
1668148644089,ECE 240B,A00,112900,Fainman; Yeshaiahu,0,0,0,0
1668148644522,ECE 247A,A00,103650,Jokerst; Jesse Vincent,0,0,0,0
1668148644948,ECE 247B,A00,103651,Wang; Joseph,0,0,0,0
1668148645373,ECE 250,A00,103652,Siegel; Paul H.,0,0,0,0
1668148645798,ECE 251A,A00,103654,Rao; Bhaskar D.,0,0,0,0
1668148646227,ECE 257B,A00,103655,Bharadia; Dinesh,0,0,0,0
1668148646649,ECE 258A,A00,103656,Milstein; Laurence B.,0,0,0,0
1668148647077,ECE 260B,A00,103658,Kang; Mingu,0,0,0,0
1668148647500,ECE 264A,A00,103659,Galton; Ian A,0,0,0,0
1668148647935,ECE 265A,A00,103661,Gudem; Prasad S.S.,0,0,0,0
1668148648376,ECE 265D,A00,103662,Gudem; Prasad S.S.,0,0,0,0
1668148648800,ECE 268,A00,103663,Koushanfar; Farinaz,0,0,0,0
1668148649232,ECE 269,A01,103665,Pal; Piya,0,0,0,0
1668148649665,ECE 271B,A00,103666,Vasconcelos; Manuela,0,0,0,0
1668148650088,ECE 276A,A00,103667,Atanasov; Nikolay A.,0,0,0,0
1668148650512,ECE 277,A00,103668,An; Cheolhong,0,0,0,0
1668148650937,ECE 279,A00,117947,Hall; Drew A.,0,0,0,0
1668148651786,ECE 283,A00,103670,Hsueh; Tzu-Chien,0,0,0,0
1668148652212,ECE 284,A00,103671,Turakhia; Yatish Girish,0,0,0,0
1668148652641,ECE 285,A00,103672,Zheng; Yang,0,0,0,0
1668148652641,ECE 285,B00,103673,Sworder; David D.,0,0,0,0
1668148653063,ECE 287,A00,103676,Javidi; Tara,0,0,0,0
1668148653486,MATH 200B,A00,098023,Salehi Golsefidy; Alireza,12,0,15,3
1668148653911,MATH 202B,A00,098024,Rhoades; Brendon Patrick,9,0,15,6
1668148654335,MATH 203B,A00,098025,Oprea; Dragos N.,10,0,15,5
1668148654761,MATH 204B,A00,098026,Sorensen; Claus M,13,0,15,2
1668148655189,MATH 208,A00,098027,Izadi; Elham,7,0,10,3
1668148655615,MATH 209,A00,098028,Pollack; Aaron,10,0,10,0
1668148656047,MATH 211A,A00,112919,Rogalski; Daniel,9,0,10,1
1668148656472,MATH 211B,A00,112920,Seward; Brandon M.,9,0,10,1
1668148656893,MATH 218,A00,098029,Li; Bo,10,0,10,0
1668148657317,MATH 220B,A00,098030,Novak; Jonathan I,11,0,15,4
1668148657754,MATH 221A,A00,098031,Ebenfelt; Peter F,13,0,15,2
1668148658177,MATH 231B,A00,098032,Zlatos; Andrej,12,0,15,3
1668148658600,MATH 240B,A00,098033,Ni; Lei,9,0,15,6
1668148659021,MATH 243,A00,098034,Jekel; David Andrew,10,0,10,0
1668148659446,MATH 245A,A00,098035,Nie; Jiawang,0,0,15,16
1668148659868,MATH 248,A00,098036,Bejenaru; Ioan,10,0,10,0
1668148660293,MATH 250B,A00,098037,Spolaor; Luca,14,0,15,1
1668148660717,MATH 258,A00,098038,Ni; Lei,10,0,10,0
1668148661146,MATH 264B,A00,098041,Rhoades; Brendon Patrick,9,0,15,6
1668148661580,MATH 268,A00,098042,Buss; Samuel R,10,0,10,0
1668148662003,MATH 269,A00,098043,Rhoades; Brendon Patrick,10,0,10,0
1668148662428,MATH 270B,A00,098044,Li; Bo,10,0,15,5
1668148662853,MATH 272B,A00,098045,Holst; Michael J,13,0,15,2
1668148663278,MATH 273A,A00,098046,Tian; Xiaochuan,10,0,15,5
1668148663701,MATH 275,A01,098048,Tian; Xiaochuan,6,0,10,4
1668148664127,MATH 278A,A00,098049,Holst; Michael J,8,0,10,2
1668148664558,MATH 278B,A00,098050,Cloninger; Alexander,10,0,10,0
1668148664984,MATH 278C,A00,098051,Nie; Jiawang,7,0,10,3
1668148665407,MATH 280B,A00,098052,Zheng; Tianyi,10,0,15,5
1668148665831,MATH 281B,A00,098053,Bradic; Jelena,2,0,15,13
1668148666258,MATH 282B,A00,098054,Arias-Castro; Ery,0,0,15,15
1668148666772,MATH 285,A00,098055,Fitzsimmons; Patrick J,0,0,15,17
1668148667195,MATH 287B,A00,098056,Arias-Castro; Ery,2,0,15,13
1668148667618,MATH 288,A00,098057,Agarwal; Pooja,9,0,10,1
1668148667618,MATH 288,B00,098058,Zhang; Danna,8,0,10,2
1668148667618,MATH 288,C00,098059,Williams; Ruth J,10,0,10,0
1668148668043,MATH 290B,A00,098060,Roberts; Justin Deritter,13,0,15,2
1668148668472,MATH 292,A00,098061,Belmont; Eva Kinoshita,10,0,10,0
1668148668910,MATH 295,A00,098062,Suk; Andrew Hoon,48,0,50,2
1668148669337,MATH 296,A00,098063,Novak; Jonathan I,20,0,20,0
1668148669762,MATH 297,001,098064,Gamst; Anthony Collins,9997,0,9999,2
1668149168522,COGS 205,A00,101395,Chiba; Andrea,19,0,20,1
1668149168949,COGS 210B,001,101404,Greene; Deanna Jacquelyn,9998,0,9999,1
1668149168949,COGS 210B,002,101417,Xia; Haijun,9999,0,9999,0
1668149168949,COGS 210B,003,101422,Nitz; Douglas A.,9999,0,9999,0
1668149168949,COGS 210B,004,101423,Hollan; James D.,9998,0,9999,1
1668149168949,COGS 210B,005,101424,Deak; Gedeon O.,9998,0,9999,1
1668149168949,COGS 210B,006,101425,Rossano; Federico,9999,0,9999,0
1668149169381,COGS 211B,A00,101427,Coulson; Seana M,9996,0,9999,3
1668149169802,COGS 220,A00,101428,Hollan; James D.,0,0,25,25
1668149170224,COGS 229,A00,101429,Dow; Steven P,18,0,25,7
1668149170648,COGS 230,A00,101430,Klemmer; Scott R,12,0,17,5
1668149171074,COGS 234,A00,101431,Xia; Haijun,3,0,25,22
1668149171500,COGS 260,A00,101432,Kiyonaga; Anastasia,20,0,25,5
1668149171500,COGS 260,B00,101433,Kirsh; David Joel,16,0,25,9
1668149171924,CSE 202,A00,102371,Impagliazzo; Russell,0,0,0,0
1668149172348,CSE 203B,A01,102373,Cheng; Chung Kuan,0,0,0,0
1668149172771,CSE 208,A00,102374,Micciancio; Daniele,0,0,0,0
1668149173195,CSE 209A,A00,112895,Impagliazzo; Russell,0,0,15,15
1668149173621,CSE 209B,A00,108005,Bellare; Mihir,0,0,0,0
1668149174045,CSE 210,A00,113163,Coblenz; Michael J,0,0,0,0
1668149174470,CSE 219,A00,106111,Dow; Steven P,0,0,20,20
1668149174894,CSE 221,A00,102376,Voelker; Geoffrey M.,0,0,0,0
1668149175319,CSE 224,A01,102378,Porter; George M,0,0,0,0
1668149175752,CSE 229A,A00,102379,Savage; Stefan,0,0,0,0
1668149176174,CSE 229C,A00,102380,Munyaka; Imani N. S.,0,0,0,0
1668149176596,CSE 232B,A00,102382,Deutsch; Alin Bernard,0,0,0,0
1668149177034,CSE 234,A01,112904,Kumar; Arun Kumar,0,0,0,0
1668149177458,CSE 237A,A00,102383,Rosing; Tajana Simunic,0,0,0,0
1668149177883,CSE 239A,A00,102384,Deutsch; Alin Bernard,0,0,0,0
1668149178306,CSE 239B,A00,102385,Polikarpova; Nadezhda,0,0,0,0
1668149178731,CSE 240A,A00,102386,Pannuto; Patrick William,0,0,0,0
1668149179157,CSE 240B,A00,102387,Zhao; Jishen,0,0,0,0
1668149179582,CSE 241A,A00,106406,Kang; Mingu,0,0,0,0
1668149180012,CSE 249B,A00,102388,Kahng; Andrew Byun,0,0,8,8
1668149180435,CSE 251B,A01,102392,Cottrell; Garrison W,0,0,0,0
1668149180435,CSE 251B,A02,102393,Cottrell; Garrison W,0,0,0,0
1668149180864,CSE 252B,A00,102394,Ochoa; Benjamin Lawrence,0,0,0,0
1668149181289,CSE 257,A01,102396,Gao; Sicun,0,0,0,0
1668149181714,CSE 272,A00,102397,Li; Tzumao,0,0,0,0
1668149182137,CSE 274,A00,111323,Chern; Albert Ren-Haur,0,0,0,0
1668149182564,CSE 282,A00,102398,Pevzner; Pavel Arkadjevich,0,0,0,0
1668149182986,CSE 284,A00,114175,Gymrek; Melissa Ann,0,0,0,0
1668149183412,CSE 290,A00,102399,Chandraker; Manmohan Krishna,0,0,0,0
1668149183412,CSE 290,B00,102400,Vaccaro; Kristen Marie,0,0,25,25
1668149183412,CSE 290,C00,102414,Pannuto; Patrick William,0,0,25,25
1668149183412,CSE 290,D00,102427,Pevzner; Pavel Arkadjevich,0,0,0,0
1668149183412,CSE 290,E00,102429,Zhao; Jishen,0,0,0,0
1668149183412,CSE 290,F00,102436,Tullsen; Dean Michael,0,0,0,0
1668149183412,CSE 290,G00,102440,Christensen; Henrik I,0,0,20,20
1668149183847,CSE 291,A00,102443,Su; Hao,0,0,0,0
1668149183847,CSE 291,B00,102448,Polikarpova; Nadezhda,0,0,0,0
1668149183847,CSE 291,C00,102453,Vaccaro; Kristen Marie,0,0,0,0
1668149183847,CSE 291,D00,111343,Savage; Stefan,0,0,0,0
1668149183847,CSE 291,E00,116474,Claffy; Kimberly Claire,0,0,0,0
1668149183847,CSE 291,F00,116479,Pasquale; Joseph,0,0,0,0
1668149184274,CSE 293,001,119111,Bafna; Vineet,9999,0,9999,0
1668149184274,CSE 293,002,119118,Bellare; Mihir,9999,0,9999,0
1668149184274,CSE 293,003,119122,Berg-Kirkpatrick; Taylor D,9999,0,9999,0
1668149184274,CSE 293,004,119135,Christensen; Henrik I,9999,0,9999,0
1668149184274,CSE 293,005,119142,Cottrell; Garrison W,9999,0,9999,0
1668149184274,CSE 293,006,119146,Deutsch; Alin Bernard,9999,0,9999,0
1668149184274,CSE 293,007,119159,Esmaeilzadeh; Hadi,9999,0,9999,0
1668149184274,CSE 293,008,119166,Freund; Yoav,9999,0,9999,0
1668149184274,CSE 293,009,119170,Griswold; William G.,9999,0,9999,0
1668149184274,CSE 293,010,119183,Gymrek; Melissa Ann,9999,0,9999,0
1668149184274,CSE 293,011,119190,Heninger; Nadia A,9999,0,9999,0
1668149184274,CSE 293,012,119230,Impagliazzo; Russell,9999,0,9999,0
1668149184274,CSE 293,013,119232,Jhala; Ranjit,9999,0,9999,0
1668149184274,CSE 293,014,119233,Kahng; Andrew Byun,9999,0,9999,0
1668149184274,CSE 293,015,119298,Kane; Daniel Mertz,9999,0,9999,0
1668149184274,CSE 293,016,119299,Kriegman; David J,9999,0,9999,0
1668149184274,CSE 293,017,119300,Kumar; Arun Kumar,9999,0,9999,0
1668149184274,CSE 293,018,119301,Lerner; Sorin,9999,0,9999,0
1668149184274,CSE 293,019,119302,Lovett; Shachar,9999,0,9999,0
1668149184274,CSE 293,020,119303,McAuley; Julian John,9999,0,9999,0
1668149184274,CSE 293,021,119304,Micciancio; Daniele,9999,0,9999,0
1668149184274,CSE 293,022,119367,Orailoglu; Alex,9999,0,9999,0
1668149184274,CSE 293,023,119382,Paturi; Ramamohan,9999,0,9999,0
1668149184274,CSE 293,024,119404,Polikarpova; Nadezhda,9999,0,9999,0
1668149184274,CSE 293,025,119406,Politz; Joseph Gibbs,9999,0,9999,0
1668149184274,CSE 293,026,119411,Porter; George M,9999,0,9999,0
1668149184274,CSE 293,027,119414,Porter; Leonard Emerson,9999,0,9999,0
1668149184274,CSE 293,028,119416,Ramamoorthi; Ravi,9999,0,9999,0
1668149184274,CSE 293,029,119417,Sahoo; Debashis,9999,0,9999,0
1668149184274,CSE 293,030,119420,Saul; Lawrence,9999,0,9999,0
1668149184274,CSE 293,031,119421,Savage; Stefan,9999,0,9999,0
1668149184274,CSE 293,032,119425,Schulze; Jurgen P.,9999,0,9999,0
1668149184274,CSE 293,033,119426,Snoeren; Alex C.,9999,0,9999,0
1668149184274,CSE 293,034,119428,Shang; Jingbo,9999,0,9999,0
1668149184274,CSE 293,035,119430,Stefan; Deian,9999,0,9999,0
1668149184274,CSE 293,036,119431,Su; Hao,9999,0,9999,0
1668149184274,CSE 293,037,119433,Swanson; Steven James,9999,0,9999,0
1668149184274,CSE 293,038,119435,Tullsen; Dean Michael,9999,0,9999,0
1668149184274,CSE 293,039,119483,Voelker; Geoffrey M.,9999,0,9999,0
1668149184274,CSE 293,040,119537,Zhao; Jishen,9999,0,9999,0
1668149184274,CSE 293,041,119538,Zhou; Yuan-Yuan,9999,0,9999,0
1668149184274,CSE 293,042,119539,Gao; Sicun,9999,0,9999,0
1668149184274,CSE 293,043,119540,Weibel; Nadir,9999,0,9999,0
1668149184274,CSE 293,044,119541,Gupta; Rajesh K.,9999,0,9999,0
1668149184274,CSE 293,045,126410,Vaccaro; Kristen Marie,9999,0,9999,0
1668149184274,CSE 293,046,126411,Klemke; Richard,9999,0,9999,0
1668149184696,CSE 294,A00,102459,Voelker; Geoffrey M.,0,0,0,0
1668149184696,CSE 294,B00,111322,Orailoglu; Alex,0,0,0,0
1668149185121,DSE 201,A00,096914,Deutsch; Alin Bernard,30,0,30,0
1668149185634,DSE 210,A00,096915,Dasgupta; Sanjoy,30,0,30,0
1668149186060,DSE 260A,A00,096916,Altintas De Callaf; Ilkay,30,0,30,0
1668149186507,ECE 200,001,103586,Antipa; Nicholas A,9999,0,9999,0
1668149186507,ECE 200,002,103587,Atanasov; Nikolay A.,9999,0,9999,0
1668149186507,ECE 200,003,103588,Bharadia; Dinesh,9999,0,9999,0
1668149186507,ECE 200,004,103589,Cheng; Chung Kuan,9999,0,9999,0
1668149186507,ECE 200,005,103590,Cosman; Pamela C.,9999,0,9999,0
1668149186507,ECE 200,006,103591,Dayeh; Shadi Ahmad,9999,0,9999,0
1668149186507,ECE 200,007,103592,Fainman; Yeshaiahu,9999,0,9999,0
1668149186507,ECE 200,008,103593,Ford; Joseph Earl,9999,0,9999,0
1668149186507,ECE 200,009,103594,Franceschetti; Massimo,9999,0,9999,0
1668149186507,ECE 200,010,103595,Fullerton; Eric E,9999,0,9999,0
1668149186507,ECE 200,011,103596,Galton; Ian A,9999,0,9999,0
1668149186507,ECE 200,012,103597,Gilja; Vikash,9999,0,9999,0
1668149186507,ECE 200,013,103598,Hall; Drew A.,9999,0,9999,0
1668149186507,ECE 200,014,103599,Hsueh; Tzu-Chien,9999,0,9999,0
1668149186507,ECE 200,015,103600,Javidi; Tara,9999,0,9999,0
1668149186507,ECE 200,016,103601,Kahng; Andrew Byun,9999,0,9999,0
1668149186507,ECE 200,017,103602,Kim; Young-Han,9999,0,9999,0
1668149186507,ECE 200,018,103603,Koushanfar; Farinaz,9999,0,9999,0
1668149186507,ECE 200,019,103604,Kuzum; Duygu,9999,0,9999,0
1668149186507,ECE 200,020,103605,Le; Hanh-Phuc,9999,0,9999,0
1668149186507,ECE 200,021,103606,Lin; Bill,9999,0,9999,0
1668149186507,ECE 200,022,103607,Liu; Zhaowei,9998,0,9999,1
1668149186507,ECE 200,023,103608,Lo; Yu-Hwa,9999,0,9999,0
1668149186507,ECE 200,024,103609,Lomakin; Vitaliy,9999,0,9999,0
1668149186507,ECE 200,025,103610,Mercier; Patrick Philip,9999,0,9999,0
1668149186507,ECE 200,026,103611,Meyer; Florian,9999,0,9999,0
1668149186507,ECE 200,027,103612,Milstein; Laurence B.,9999,0,9999,0
1668149186507,ECE 200,028,103613,Mir Arabbaygi; Siavash,9999,0,9999,0
1668149186507,ECE 200,029,103614,Mookherjea; Shayan,9999,0,9999,0
1668149186507,ECE 200,030,103615,Morris; Karcher William,9999,0,9999,0
1668149186507,ECE 200,031,103616,Ng; Tse Nga,9999,0,9999,0
1668149186507,ECE 200,032,103617,Nguyen; Truong Quang,9999,0,9999,0
1668149186507,ECE 200,033,103618,Nomura; Kenji,9999,0,9999,0
1668149186507,ECE 200,034,103619,Orlitsky; Alon,9999,0,9999,0
1668149186507,ECE 200,035,103620,Pal; Piya,9999,0,9999,0
1668149186507,ECE 200,036,103621,Papen; George C.,9999,0,9999,0
1668149186507,ECE 200,037,103622,Radic; Stojan,9999,0,9999,0
1668149186507,ECE 200,038,103623,Rao; Bhaskar D.,9999,0,9999,0
1668149186507,ECE 200,039,103624,Rao; Ramesh R,9999,0,9999,0
1668149186507,ECE 200,040,103625,Rebeiz; Gabriel,9999,0,9999,0
1668149186507,ECE 200,041,103626,Sanford; John R,9999,0,9999,0
1668149186507,ECE 200,042,103627,Siegel; Paul H.,9999,0,9999,0
1668149186507,ECE 200,043,103628,Sievenpiper; Daniel F.,9999,0,9999,0
1668149186507,ECE 200,044,103629,Sworder; David D.,9999,0,9999,0
1668149186507,ECE 200,045,103630,Taur; Yuan,9999,0,9999,0
1668149186507,ECE 200,046,103631,Touri; Behrouz,9999,0,9999,0
1668149186507,ECE 200,047,103632,Trivedi; Mohan M.,9999,0,9999,0
1668149186507,ECE 200,048,103633,Vasconcelos; Nuno,9999,0,9999,0
1668149186507,ECE 200,049,103634,Wang; Xiaolong,9999,0,9999,0
1668149186507,ECE 200,050,103635,Xie; Pengtao,9999,0,9999,0
1668149186507,ECE 200,051,103636,Yip; Michael,9999,0,9999,0
1668149186507,ECE 200,052,103637,Zeger; Kenneth A.,999,0,999,0
1668149186507,ECE 200,053,103638,Zhang; Xinyu,9999,0,9999,0
1668149186507,ECE 200,054,103639,Turakhia; Yatish Girish,9999,0,9999,0
1668149186507,ECE 200,055,103640,Kang; Mingu,9999,0,9999,0
1668149186507,ECE 200,056,103641,Shi; Yuanyuan,9999,0,9999,0
1668149186507,ECE 200,057,103642,Wang; Edward Jay,9999,0,9999,0
1668149186507,ECE 200,058,103643,Zheng; Yang,9999,0,9999,0
1668149186932,ECE 202,A00,103644,Kuzum; Duygu,0,0,0,0
1668149187354,ECE 212BN,A00,103646,Ng; Tse Nga,0,0,0,0
1668149187776,ECE 221,A00,111493,Staff,0,0,0,0
1668149188200,ECE 222B,A00,103647,Lomakin; Vitaliy,0,0,0,0
1668149188636,ECE 230B,A00,103648,Taur; Yuan,0,0,0,0
1668149189061,ECE 238B,A00,103649,Garay; Javier,0,0,0,0
1668149189490,ECE 240B,A00,112900,Fainman; Yeshaiahu,0,0,0,0
1668149189916,ECE 247A,A00,103650,Jokerst; Jesse Vincent,0,0,0,0
1668149190340,ECE 247B,A00,103651,Wang; Joseph,0,0,0,0
1668149190764,ECE 250,A00,103652,Siegel; Paul H.,0,0,0,0
1668149191188,ECE 251A,A00,103654,Rao; Bhaskar D.,0,0,0,0
1668149191613,ECE 257B,A00,103655,Bharadia; Dinesh,0,0,0,0
1668149192038,ECE 258A,A00,103656,Milstein; Laurence B.,0,0,0,0
1668149192464,ECE 260B,A00,103658,Kang; Mingu,0,0,0,0
1668149192888,ECE 264A,A00,103659,Galton; Ian A,0,0,0,0
1668149193312,ECE 265A,A00,103661,Gudem; Prasad S.S.,0,0,0,0
1668149193745,ECE 265D,A00,103662,Gudem; Prasad S.S.,0,0,0,0
1668149194170,ECE 268,A00,103663,Koushanfar; Farinaz,0,0,0,0
1668149194591,ECE 269,A01,103665,Pal; Piya,0,0,0,0
1668149195014,ECE 271B,A00,103666,Vasconcelos; Manuela,0,0,0,0
1668149195438,ECE 276A,A00,103667,Atanasov; Nikolay A.,0,0,0,0
1668149195861,ECE 277,A00,103668,An; Cheolhong,0,0,0,0
1668149196286,ECE 279,A00,117947,Hall; Drew A.,0,0,0,0
1668149197139,ECE 283,A00,103670,Hsueh; Tzu-Chien,0,0,0,0
1668149197569,ECE 284,A00,103671,Turakhia; Yatish Girish,0,0,0,0
1668149197994,ECE 285,A00,103672,Zheng; Yang,0,0,0,0
1668149197994,ECE 285,B00,103673,Sworder; David D.,0,0,0,0
1668149198417,ECE 287,A00,103676,Javidi; Tara,0,0,0,0
1668149198839,MATH 200B,A00,098023,Salehi Golsefidy; Alireza,12,0,15,3
1668149199263,MATH 202B,A00,098024,Rhoades; Brendon Patrick,9,0,15,6
1668149199685,MATH 203B,A00,098025,Oprea; Dragos N.,10,0,15,5
1668149200107,MATH 204B,A00,098026,Sorensen; Claus M,13,0,15,2
1668149200532,MATH 208,A00,098027,Izadi; Elham,7,0,10,3
1668149200958,MATH 209,A00,098028,Pollack; Aaron,10,0,10,0
1668149201384,MATH 211A,A00,112919,Rogalski; Daniel,9,0,10,1
1668149201809,MATH 211B,A00,112920,Seward; Brandon M.,9,0,10,1
1668149202231,MATH 218,A00,098029,Li; Bo,10,0,10,0
1668149202656,MATH 220B,A00,098030,Novak; Jonathan I,11,0,15,4
1668149203080,MATH 221A,A00,098031,Ebenfelt; Peter F,13,0,15,2
1668149203504,MATH 231B,A00,098032,Zlatos; Andrej,12,0,15,3
1668149203928,MATH 240B,A00,098033,Ni; Lei,9,0,15,6
1668149204349,MATH 243,A00,098034,Jekel; David Andrew,10,0,10,0
1668149204774,MATH 245A,A00,098035,Nie; Jiawang,0,0,15,16
1668149205197,MATH 248,A00,098036,Bejenaru; Ioan,10,0,10,0
1668149205626,MATH 250B,A00,098037,Spolaor; Luca,14,0,15,1
1668149206051,MATH 258,A00,098038,Ni; Lei,10,0,10,0
1668149206476,MATH 264B,A00,098041,Rhoades; Brendon Patrick,9,0,15,6
1668149206901,MATH 268,A00,098042,Buss; Samuel R,10,0,10,0
1668149207324,MATH 269,A00,098043,Rhoades; Brendon Patrick,10,0,10,0
1668149207756,MATH 270B,A00,098044,Li; Bo,10,0,15,5
1668149208180,MATH 272B,A00,098045,Holst; Michael J,13,0,15,2
1668149208602,MATH 273A,A00,098046,Tian; Xiaochuan,10,0,15,5
1668149209029,MATH 275,A01,098048,Tian; Xiaochuan,6,0,10,4
1668149209454,MATH 278A,A00,098049,Holst; Michael J,8,0,10,2
1668149209878,MATH 278B,A00,098050,Cloninger; Alexander,10,0,10,0
1668149210300,MATH 278C,A00,098051,Nie; Jiawang,7,0,10,3
1668149210721,MATH 280B,A00,098052,Zheng; Tianyi,10,0,15,5
1668149211144,MATH 281B,A00,098053,Bradic; Jelena,2,0,15,13
1668149211569,MATH 282B,A00,098054,Arias-Castro; Ery,0,0,15,15
1668149211993,MATH 285,A00,098055,Fitzsimmons; Patrick J,0,0,15,17
1668149212419,MATH 287B,A00,098056,Arias-Castro; Ery,2,0,15,13
1668149212841,MATH 288,A00,098057,Agarwal; Pooja,9,0,10,1
1668149212841,MATH 288,B00,098058,Zhang; Danna,8,0,10,2
1668149212841,MATH 288,C00,098059,Williams; Ruth J,10,0,10,0
1668149213268,MATH 290B,A00,098060,Roberts; Justin Deritter,13,0,15,2
1668149213692,MATH 292,A00,098061,Belmont; Eva Kinoshita,10,0,10,0
1668149214118,MATH 295,A00,098062,Suk; Andrew Hoon,48,0,50,2
1668149214541,MATH 296,A00,098063,Novak; Jonathan I,20,0,20,0
1668149214965,MATH 297,001,098064,Gamst; Anthony Collins,9997,0,9999,2
1668149714159,COGS 205,A00,101395,Chiba; Andrea,19,0,20,1
1668149714586,COGS 210B,001,101404,Greene; Deanna Jacquelyn,9998,0,9999,1
1668149714586,COGS 210B,002,101417,Xia; Haijun,9999,0,9999,0
1668149714586,COGS 210B,003,101422,Nitz; Douglas A.,9999,0,9999,0
1668149714586,COGS 210B,004,101423,Hollan; James D.,9998,0,9999,1
1668149714586,COGS 210B,005,101424,Deak; Gedeon O.,9998,0,9999,1
1668149714586,COGS 210B,006,101425,Rossano; Federico,9999,0,9999,0
1668149715009,COGS 211B,A00,101427,Coulson; Seana M,9996,0,9999,3
1668149715432,COGS 220,A00,101428,Hollan; James D.,0,0,25,25
1668149715857,COGS 229,A00,101429,Dow; Steven P,18,0,25,7
1668149716286,COGS 230,A00,101430,Klemmer; Scott R,12,0,17,5
1668149716713,COGS 234,A00,101431,Xia; Haijun,3,0,25,22
1668149717135,COGS 260,A00,101432,Kiyonaga; Anastasia,20,0,25,5
1668149717135,COGS 260,B00,101433,Kirsh; David Joel,16,0,25,9
1668149717559,CSE 202,A00,102371,Impagliazzo; Russell,0,0,0,0
1668149717985,CSE 203B,A01,102373,Cheng; Chung Kuan,0,0,0,0
1668149718416,CSE 208,A00,102374,Micciancio; Daniele,0,0,0,0
1668149718847,CSE 209A,A00,112895,Impagliazzo; Russell,0,0,15,15
1668149719273,CSE 209B,A00,108005,Bellare; Mihir,0,0,0,0
1668149719712,CSE 210,A00,113163,Coblenz; Michael J,0,0,0,0
1668149720136,CSE 219,A00,106111,Dow; Steven P,0,0,20,20
1668149720559,CSE 221,A00,102376,Voelker; Geoffrey M.,0,0,0,0
1668149720982,CSE 224,A01,102378,Porter; George M,0,0,0,0
1668149721408,CSE 229A,A00,102379,Savage; Stefan,0,0,0,0
1668149721831,CSE 229C,A00,102380,Munyaka; Imani N. S.,0,0,0,0
1668149722261,CSE 232B,A00,102382,Deutsch; Alin Bernard,0,0,0,0
1668149722687,CSE 234,A01,112904,Kumar; Arun Kumar,0,0,0,0
1668149723110,CSE 237A,A00,102383,Rosing; Tajana Simunic,0,0,0,0
1668149723544,CSE 239A,A00,102384,Deutsch; Alin Bernard,0,0,0,0
1668149723966,CSE 239B,A00,102385,Polikarpova; Nadezhda,0,0,0,0
1668149724390,CSE 240A,A00,102386,Pannuto; Patrick William,0,0,0,0
1668149724813,CSE 240B,A00,102387,Zhao; Jishen,0,0,0,0
1668149725243,CSE 241A,A00,106406,Kang; Mingu,0,0,0,0
1668149725667,CSE 249B,A00,102388,Kahng; Andrew Byun,0,0,8,8
1668149726100,CSE 251B,A01,102392,Cottrell; Garrison W,0,0,0,0
1668149726100,CSE 251B,A02,102393,Cottrell; Garrison W,0,0,0,0
1668149726523,CSE 252B,A00,102394,Ochoa; Benjamin Lawrence,0,0,0,0
1668149726949,CSE 257,A01,102396,Gao; Sicun,0,0,0,0
1668149727375,CSE 272,A00,102397,Li; Tzumao,0,0,0,0
1668149727798,CSE 274,A00,111323,Chern; Albert Ren-Haur,0,0,0,0
1668149728221,CSE 282,A00,102398,Pevzner; Pavel Arkadjevich,0,0,0,0
1668149728650,CSE 284,A00,114175,Gymrek; Melissa Ann,0,0,0,0
1668149729074,CSE 290,A00,102399,Chandraker; Manmohan Krishna,0,0,0,0
1668149729074,CSE 290,B00,102400,Vaccaro; Kristen Marie,0,0,25,25
1668149729074,CSE 290,C00,102414,Pannuto; Patrick William,0,0,25,25
1668149729074,CSE 290,D00,102427,Pevzner; Pavel Arkadjevich,0,0,0,0
1668149729074,CSE 290,E00,102429,Zhao; Jishen,0,0,0,0
1668149729074,CSE 290,F00,102436,Tullsen; Dean Michael,0,0,0,0
1668149729074,CSE 290,G00,102440,Christensen; Henrik I,0,0,20,20
1668149729512,CSE 291,A00,102443,Su; Hao,0,0,0,0
1668149729512,CSE 291,B00,102448,Polikarpova; Nadezhda,0,0,0,0
1668149729512,CSE 291,C00,102453,Vaccaro; Kristen Marie,0,0,0,0
1668149729512,CSE 291,D00,111343,Savage; Stefan,0,0,0,0
1668149729512,CSE 291,E00,116474,Claffy; Kimberly Claire,0,0,0,0
1668149729512,CSE 291,F00,116479,Pasquale; Joseph,0,0,0,0
1668149729938,CSE 293,001,119111,Bafna; Vineet,9999,0,9999,0
1668149729938,CSE 293,002,119118,Bellare; Mihir,9999,0,9999,0
1668149729938,CSE 293,003,119122,Berg-Kirkpatrick; Taylor D,9999,0,9999,0
1668149729938,CSE 293,004,119135,Christensen; Henrik I,9999,0,9999,0
1668149729938,CSE 293,005,119142,Cottrell; Garrison W,9999,0,9999,0
1668149729938,CSE 293,006,119146,Deutsch; Alin Bernard,9999,0,9999,0
1668149729938,CSE 293,007,119159,Esmaeilzadeh; Hadi,9999,0,9999,0
1668149729938,CSE 293,008,119166,Freund; Yoav,9999,0,9999,0
1668149729938,CSE 293,009,119170,Griswold; William G.,9999,0,9999,0
1668149729938,CSE 293,010,119183,Gymrek; Melissa Ann,9999,0,9999,0
1668149729938,CSE 293,011,119190,Heninger; Nadia A,9999,0,9999,0
1668149729938,CSE 293,012,119230,Impagliazzo; Russell,9999,0,9999,0
1668149729938,CSE 293,013,119232,Jhala; Ranjit,9999,0,9999,0
1668149729938,CSE 293,014,119233,Kahng; Andrew Byun,9999,0,9999,0
1668149729938,CSE 293,015,119298,Kane; Daniel Mertz,9999,0,9999,0
1668149729938,CSE 293,016,119299,Kriegman; David J,9999,0,9999,0
1668149729938,CSE 293,017,119300,Kumar; Arun Kumar,9999,0,9999,0
1668149729938,CSE 293,018,119301,Lerner; Sorin,9999,0,9999,0
1668149729938,CSE 293,019,119302,Lovett; Shachar,9999,0,9999,0
1668149729938,CSE 293,020,119303,McAuley; Julian John,9999,0,9999,0
1668149729938,CSE 293,021,119304,Micciancio; Daniele,9999,0,9999,0
1668149729938,CSE 293,022,119367,Orailoglu; Alex,9999,0,9999,0
1668149729938,CSE 293,023,119382,Paturi; Ramamohan,9999,0,9999,0
1668149729938,CSE 293,024,119404,Polikarpova; Nadezhda,9999,0,9999,0
1668149729938,CSE 293,025,119406,Politz; Joseph Gibbs,9999,0,9999,0
1668149729938,CSE 293,026,119411,Porter; George M,9999,0,9999,0
1668149729938,CSE 293,027,119414,Porter; Leonard Emerson,9999,0,9999,0
1668149729938,CSE 293,028,119416,Ramamoorthi; Ravi,9999,0,9999,0
1668149729938,CSE 293,029,119417,Sahoo; Debashis,9999,0,9999,0
1668149729938,CSE 293,030,119420,Saul; Lawrence,9999,0,9999,0
1668149729938,CSE 293,031,119421,Savage; Stefan,9999,0,9999,0
1668149729938,CSE 293,032,119425,Schulze; Jurgen P.,9999,0,9999,0
1668149729938,CSE 293,033,119426,Snoeren; Alex C.,9999,0,9999,0
1668149729938,CSE 293,034,119428,Shang; Jingbo,9999,0,9999,0
1668149729938,CSE 293,035,119430,Stefan; Deian,9999,0,9999,0
1668149729938,CSE 293,036,119431,Su; Hao,9999,0,9999,0
1668149729938,CSE 293,037,119433,Swanson; Steven James,9999,0,9999,0
1668149729938,CSE 293,038,119435,Tullsen; Dean Michael,9999,0,9999,0
1668149729938,CSE 293,039,119483,Voelker; Geoffrey M.,9999,0,9999,0
1668149729938,CSE 293,040,119537,Zhao; Jishen,9999,0,9999,0
1668149729938,CSE 293,041,119538,Zhou; Yuan-Yuan,9999,0,9999,0
1668149729938,CSE 293,042,119539,Gao; Sicun,9999,0,9999,0
1668149729938,CSE 293,043,119540,Weibel; Nadir,9999,0,9999,0
1668149729938,CSE 293,044,119541,Gupta; Rajesh K.,9999,0,9999,0
1668149729938,CSE 293,045,126410,Vaccaro; Kristen Marie,9999,0,9999,0
1668149729938,CSE 293,046,126411,Klemke; Richard,9999,0,9999,0
1668149730369,CSE 294,A00,102459,Voelker; Geoffrey M.,0,0,0,0
1668149730369,CSE 294,B00,111322,Orailoglu; Alex,0,0,0,0
1668149730792,DSE 201,A00,096914,Deutsch; Alin Bernard,30,0,30,0
1668149731218,DSE 210,A00,096915,Dasgupta; Sanjoy,30,0,30,0
1668149731642,DSE 260A,A00,096916,Altintas De Callaf; Ilkay,30,0,30,0
1668149732068,ECE 200,001,103586,Antipa; Nicholas A,9999,0,9999,0
1668149732068,ECE 200,002,103587,Atanasov; Nikolay A.,9999,0,9999,0
1668149732068,ECE 200,003,103588,Bharadia; Dinesh,9999,0,9999,0
1668149732068,ECE 200,004,103589,Cheng; Chung Kuan,9999,0,9999,0
1668149732068,ECE 200,005,103590,Cosman; Pamela C.,9999,0,9999,0
1668149732068,ECE 200,006,103591,Dayeh; Shadi Ahmad,9999,0,9999,0
1668149732068,ECE 200,007,103592,Fainman; Yeshaiahu,9999,0,9999,0
1668149732068,ECE 200,008,103593,Ford; Joseph Earl,9999,0,9999,0
1668149732068,ECE 200,009,103594,Franceschetti; Massimo,9999,0,9999,0
1668149732068,ECE 200,010,103595,Fullerton; Eric E,9999,0,9999,0
1668149732068,ECE 200,011,103596,Galton; Ian A,9999,0,9999,0
1668149732068,ECE 200,012,103597,Gilja; Vikash,9999,0,9999,0
1668149732068,ECE 200,013,103598,Hall; Drew A.,9999,0,9999,0
1668149732068,ECE 200,014,103599,Hsueh; Tzu-Chien,9999,0,9999,0
1668149732068,ECE 200,015,103600,Javidi; Tara,9999,0,9999,0
1668149732068,ECE 200,016,103601,Kahng; Andrew Byun,9999,0,9999,0
1668149732068,ECE 200,017,103602,Kim; Young-Han,9999,0,9999,0
1668149732068,ECE 200,018,103603,Koushanfar; Farinaz,9999,0,9999,0
1668149732068,ECE 200,019,103604,Kuzum; Duygu,9999,0,9999,0
1668149732068,ECE 200,020,103605,Le; Hanh-Phuc,9999,0,9999,0
1668149732068,ECE 200,021,103606,Lin; Bill,9999,0,9999,0
1668149732068,ECE 200,022,103607,Liu; Zhaowei,9998,0,9999,1
1668149732068,ECE 200,023,103608,Lo; Yu-Hwa,9999,0,9999,0
1668149732068,ECE 200,024,103609,Lomakin; Vitaliy,9999,0,9999,0
1668149732068,ECE 200,025,103610,Mercier; Patrick Philip,9999,0,9999,0
1668149732068,ECE 200,026,103611,Meyer; Florian,9999,0,9999,0
1668149732068,ECE 200,027,103612,Milstein; Laurence B.,9999,0,9999,0
1668149732068,ECE 200,028,103613,Mir Arabbaygi; Siavash,9999,0,9999,0
1668149732068,ECE 200,029,103614,Mookherjea; Shayan,9999,0,9999,0
1668149732068,ECE 200,030,103615,Morris; Karcher William,9999,0,9999,0
1668149732068,ECE 200,031,103616,Ng; Tse Nga,9999,0,9999,0
1668149732068,ECE 200,032,103617,Nguyen; Truong Quang,9999,0,9999,0
1668149732068,ECE 200,033,103618,Nomura; Kenji,9999,0,9999,0
1668149732068,ECE 200,034,103619,Orlitsky; Alon,9999,0,9999,0
1668149732068,ECE 200,035,103620,Pal; Piya,9999,0,9999,0
1668149732068,ECE 200,036,103621,Papen; George C.,9999,0,9999,0
1668149732068,ECE 200,037,103622,Radic; Stojan,9999,0,9999,0
1668149732068,ECE 200,038,103623,Rao; Bhaskar D.,9999,0,9999,0
1668149732068,ECE 200,039,103624,Rao; Ramesh R,9999,0,9999,0
1668149732068,ECE 200,040,103625,Rebeiz; Gabriel,9999,0,9999,0
1668149732068,ECE 200,041,103626,Sanford; John R,9999,0,9999,0
1668149732068,ECE 200,042,103627,Siegel; Paul H.,9999,0,9999,0
1668149732068,ECE 200,043,103628,Sievenpiper; Daniel F.,9999,0,9999,0
1668149732068,ECE 200,044,103629,Sworder; David D.,9999,0,9999,0
1668149732068,ECE 200,045,103630,Taur; Yuan,9999,0,9999,0
1668149732068,ECE 200,046,103631,Touri; Behrouz,9999,0,9999,0
1668149732068,ECE 200,047,103632,Trivedi; Mohan M.,9999,0,9999,0
1668149732068,ECE 200,048,103633,Vasconcelos; Nuno,9999,0,9999,0
1668149732068,ECE 200,049,103634,Wang; Xiaolong,9999,0,9999,0
1668149732068,ECE 200,050,103635,Xie; Pengtao,9999,0,9999,0
1668149732068,ECE 200,051,103636,Yip; Michael,9999,0,9999,0
1668149732068,ECE 200,052,103637,Zeger; Kenneth A.,999,0,999,0
1668149732068,ECE 200,053,103638,Zhang; Xinyu,9999,0,9999,0
1668149732068,ECE 200,054,103639,Turakhia; Yatish Girish,9999,0,9999,0
1668149732068,ECE 200,055,103640,Kang; Mingu,9999,0,9999,0
1668149732068,ECE 200,056,103641,Shi; Yuanyuan,9999,0,9999,0
1668149732068,ECE 200,057,103642,Wang; Edward Jay,9999,0,9999,0
1668149732068,ECE 200,058,103643,Zheng; Yang,9999,0,9999,0
1668149732490,ECE 202,A00,103644,Kuzum; Duygu,0,0,0,0
1668149732917,ECE 212BN,A00,103646,Ng; Tse Nga,0,0,0,0
1668149733350,ECE 221,A00,111493,Staff,0,0,0,0
1668149733772,ECE 222B,A00,103647,Lomakin; Vitaliy,0,0,0,0
1668149734201,ECE 230B,A00,103648,Taur; Yuan,0,0,0,0
1668149734623,ECE 238B,A00,103649,Garay; Javier,0,0,0,0
1668149735045,ECE 240B,A00,112900,Fainman; Yeshaiahu,0,0,0,0
1668149735468,ECE 247A,A00,103650,Jokerst; Jesse Vincent,0,0,0,0
1668149735892,ECE 247B,A00,103651,Wang; Joseph,0,0,0,0
1668149736315,ECE 250,A00,103652,Siegel; Paul H.,0,0,0,0
1668149736747,ECE 251A,A00,103654,Rao; Bhaskar D.,0,0,0,0
1668149737171,ECE 257B,A00,103655,Bharadia; Dinesh,0,0,0,0
1668149737596,ECE 258A,A00,103656,Milstein; Laurence B.,0,0,0,0
1668149738021,ECE 260B,A00,103658,Kang; Mingu,0,0,0,0
1668149738442,ECE 264A,A00,103659,Galton; Ian A,0,0,0,0
1668149738865,ECE 265A,A00,103661,Gudem; Prasad S.S.,0,0,0,0
1668149739290,ECE 265D,A00,103662,Gudem; Prasad S.S.,0,0,0,0
1668149739714,ECE 268,A00,103663,Koushanfar; Farinaz,0,0,0,0
1668149740136,ECE 269,A01,103665,Pal; Piya,0,0,0,0
1668149740561,ECE 271B,A00,103666,Vasconcelos; Manuela,0,0,0,0
1668149740987,ECE 276A,A00,103667,Atanasov; Nikolay A.,0,0,0,0
1668149741412,ECE 277,A00,103668,An; Cheolhong,0,0,0,0
1668149741837,ECE 279,A00,117947,Hall; Drew A.,0,0,0,0
1668149742685,ECE 283,A00,103670,Hsueh; Tzu-Chien,0,0,0,0
1668149743118,ECE 284,A00,103671,Turakhia; Yatish Girish,0,0,0,0
1668149743548,ECE 285,A00,103672,Zheng; Yang,0,0,0,0
1668149743548,ECE 285,B00,103673,Sworder; David D.,0,0,0,0
1668149743975,ECE 287,A00,103676,Javidi; Tara,0,0,0,0
1668149744402,MATH 200B,A00,098023,Salehi Golsefidy; Alireza,12,0,15,3
1668149744829,MATH 202B,A00,098024,Rhoades; Brendon Patrick,9,0,15,6
1668149745259,MATH 203B,A00,098025,Oprea; Dragos N.,10,0,15,5
1668149745682,MATH 204B,A00,098026,Sorensen; Claus M,13,0,15,2
1668149746114,MATH 208,A00,098027,Izadi; Elham,7,0,10,3
1668149746540,MATH 209,A00,098028,Pollack; Aaron,10,0,10,0
1668149746966,MATH 211A,A00,112919,Rogalski; Daniel,9,0,10,1
1668149747392,MATH 211B,A00,112920,Seward; Brandon M.,9,0,10,1
1668149747907,MATH 218,A00,098029,Li; Bo,10,0,10,0
1668149748331,MATH 220B,A00,098030,Novak; Jonathan I,11,0,15,4
1668149748778,MATH 221A,A00,098031,Ebenfelt; Peter F,13,0,15,2
1668149749200,MATH 231B,A00,098032,Zlatos; Andrej,12,0,15,3
1668149749626,MATH 240B,A00,098033,Ni; Lei,9,0,15,6
1668149750050,MATH 243,A00,098034,Jekel; David Andrew,10,0,10,0
1668149750475,MATH 245A,A00,098035,Nie; Jiawang,0,0,15,16
1668149750903,MATH 248,A00,098036,Bejenaru; Ioan,10,0,10,0
1668149751331,MATH 250B,A00,098037,Spolaor; Luca,14,0,15,1
1668149751754,MATH 258,A00,098038,Ni; Lei,10,0,10,0
1668149752181,MATH 264B,A00,098041,Rhoades; Brendon Patrick,9,0,15,6
1668149752612,MATH 268,A00,098042,Buss; Samuel R,10,0,10,0
1668149753037,MATH 269,A00,098043,Rhoades; Brendon Patrick,10,0,10,0
1668149753459,MATH 270B,A00,098044,Li; Bo,10,0,15,5
1668149753887,MATH 272B,A00,098045,Holst; Michael J,13,0,15,2
1668149754309,MATH 273A,A00,098046,Tian; Xiaochuan,10,0,15,5
1668149754735,MATH 275,A01,098048,Tian; Xiaochuan,6,0,10,4
1668149755160,MATH 278A,A00,098049,Holst; Michael J,8,0,10,2
1668149755584,MATH 278B,A00,098050,Cloninger; Alexander,10,0,10,0
1668149756009,MATH 278C,A00,098051,Nie; Jiawang,7,0,10,3
1668149756433,MATH 280B,A00,098052,Zheng; Tianyi,10,0,15,5
1668149756857,MATH 281B,A00,098053,Bradic; Jelena,2,0,15,13
1668149757287,MATH 282B,A00,098054,Arias-Castro; Ery,0,0,15,15
1668149757710,MATH 285,A00,098055,Fitzsimmons; Patrick J,0,0,15,17
1668149758132,MATH 287B,A00,098056,Arias-Castro; Ery,2,0,15,13
1668149758558,MATH 288,A00,098057,Agarwal; Pooja,9,0,10,1
1668149758558,MATH 288,B00,098058,Zhang; Danna,8,0,10,2
1668149758558,MATH 288,C00,098059,Williams; Ruth J,10,0,10,0
1668149758985,MATH 290B,A00,098060,Roberts; Justin Deritter,13,0,15,2
1668149759409,MATH 292,A00,098061,Belmont; Eva Kinoshita,10,0,10,0
1668149759834,MATH 295,A00,098062,Suk; Andrew Hoon,48,0,50,2
1668149760258,MATH 296,A00,098063,Novak; Jonathan I,20,0,20,0
1668149760680,MATH 297,001,098064,Gamst; Anthony Collins,9997,0,9999,2
1668150260554,COGS 205,A00,101395,Chiba; Andrea,19,0,20,1
1668150260982,COGS 210B,001,101404,Greene; Deanna Jacquelyn,9998,0,9999,1
1668150260982,COGS 210B,002,101417,Xia; Haijun,9999,0,9999,0
1668150260982,COGS 210B,003,101422,Nitz; Douglas A.,9999,0,9999,0
1668150260982,COGS 210B,004,101423,Hollan; James D.,9998,0,9999,1
1668150260982,COGS 210B,005,101424,Deak; Gedeon O.,9998,0,9999,1
1668150260982,COGS 210B,006,101425,Rossano; Federico,9999,0,9999,0
1668150261408,COGS 211B,A00,101427,Coulson; Seana M,9996,0,9999,3
1668150261841,COGS 220,A00,101428,Hollan; James D.,0,0,25,25
1668150262268,COGS 229,A00,101429,Dow; Steven P,18,0,25,7
1668150262695,COGS 230,A00,101430,Klemmer; Scott R,12,0,17,5
1668150263122,COGS 234,A00,101431,Xia; Haijun,3,0,25,22
1668150263544,COGS 260,A00,101432,Kiyonaga; Anastasia,20,0,25,5
1668150263544,COGS 260,B00,101433,Kirsh; David Joel,16,0,25,9
1668150263969,CSE 202,A00,102371,Impagliazzo; Russell,0,0,0,0
1668150264398,CSE 203B,A01,102373,Cheng; Chung Kuan,0,0,0,0
1668150264823,CSE 208,A00,102374,Micciancio; Daniele,0,0,0,0
1668150265247,CSE 209A,A00,112895,Impagliazzo; Russell,0,0,15,15
1668150265673,CSE 209B,A00,108005,Bellare; Mihir,0,0,0,0
1668150266099,CSE 210,A00,113163,Coblenz; Michael J,0,0,0,0
1668150266522,CSE 219,A00,106111,Dow; Steven P,0,0,20,20
1668150266949,CSE 221,A00,102376,Voelker; Geoffrey M.,0,0,0,0
1668150267377,CSE 224,A01,102378,Porter; George M,0,0,0,0
1668150267892,CSE 229A,A00,102379,Savage; Stefan,0,0,0,0
1668150268330,CSE 229C,A00,102380,Munyaka; Imani N. S.,0,0,0,0
1668150268755,CSE 232B,A00,102382,Deutsch; Alin Bernard,0,0,0,0
1668150269179,CSE 234,A01,112904,Kumar; Arun Kumar,0,0,0,0
1668150269605,CSE 237A,A00,102383,Rosing; Tajana Simunic,0,0,0,0
1668150270029,CSE 239A,A00,102384,Deutsch; Alin Bernard,0,0,0,0
1668150270453,CSE 239B,A00,102385,Polikarpova; Nadezhda,0,0,0,0
1668150270876,CSE 240A,A00,102386,Pannuto; Patrick William,0,0,0,0
1668150271301,CSE 240B,A00,102387,Zhao; Jishen,0,0,0,0
1668150271723,CSE 241A,A00,106406,Kang; Mingu,0,0,0,0
1668150272154,CSE 249B,A00,102388,Kahng; Andrew Byun,0,0,8,8
1668150272578,CSE 251B,A01,102392,Cottrell; Garrison W,0,0,0,0
1668150272578,CSE 251B,A02,102393,Cottrell; Garrison W,0,0,0,0
1668150273002,CSE 252B,A00,102394,Ochoa; Benjamin Lawrence,0,0,0,0
1668150273425,CSE 257,A01,102396,Gao; Sicun,0,0,0,0
1668150273847,CSE 272,A00,102397,Li; Tzumao,0,0,0,0
1668150274270,CSE 274,A00,111323,Chern; Albert Ren-Haur,0,0,0,0
1668150274697,CSE 282,A00,102398,Pevzner; Pavel Arkadjevich,0,0,0,0
1668150275119,CSE 284,A00,114175,Gymrek; Melissa Ann,0,0,0,0
1668150275546,CSE 290,A00,102399,Chandraker; Manmohan Krishna,0,0,0,0
1668150275546,CSE 290,B00,102400,Vaccaro; Kristen Marie,0,0,25,25
1668150275546,CSE 290,C00,102414,Pannuto; Patrick William,0,0,25,25
1668150275546,CSE 290,D00,102427,Pevzner; Pavel Arkadjevich,0,0,0,0
1668150275546,CSE 290,E00,102429,Zhao; Jishen,0,0,0,0
1668150275546,CSE 290,F00,102436,Tullsen; Dean Michael,0,0,0,0
1668150275546,CSE 290,G00,102440,Christensen; Henrik I,0,0,20,20
1668150275970,CSE 291,A00,102443,Su; Hao,0,0,0,0
1668150275970,CSE 291,B00,102448,Polikarpova; Nadezhda,0,0,0,0
1668150275970,CSE 291,C00,102453,Vaccaro; Kristen Marie,0,0,0,0
1668150275970,CSE 291,D00,111343,Savage; Stefan,0,0,0,0
1668150275970,CSE 291,E00,116474,Claffy; Kimberly Claire,0,0,0,0
1668150275970,CSE 291,F00,116479,Pasquale; Joseph,0,0,0,0
1668150276415,CSE 293,001,119111,Bafna; Vineet,9999,0,9999,0
1668150276415,CSE 293,002,119118,Bellare; Mihir,9999,0,9999,0
1668150276415,CSE 293,003,119122,Berg-Kirkpatrick; Taylor D,9999,0,9999,0
1668150276415,CSE 293,004,119135,Christensen; Henrik I,9999,0,9999,0
1668150276415,CSE 293,005,119142,Cottrell; Garrison W,9999,0,9999,0
1668150276415,CSE 293,006,119146,Deutsch; Alin Bernard,9999,0,9999,0
1668150276415,CSE 293,007,119159,Esmaeilzadeh; Hadi,9999,0,9999,0
1668150276415,CSE 293,008,119166,Freund; Yoav,9999,0,9999,0
1668150276415,CSE 293,009,119170,Griswold; William G.,9999,0,9999,0
1668150276415,CSE 293,010,119183,Gymrek; Melissa Ann,9999,0,9999,0
1668150276415,CSE 293,011,119190,Heninger; Nadia A,9999,0,9999,0
1668150276415,CSE 293,012,119230,Impagliazzo; Russell,9999,0,9999,0
1668150276415,CSE 293,013,119232,Jhala; Ranjit,9999,0,9999,0
1668150276415,CSE 293,014,119233,Kahng; Andrew Byun,9999,0,9999,0
1668150276415,CSE 293,015,119298,Kane; Daniel Mertz,9999,0,9999,0
1668150276415,CSE 293,016,119299,Kriegman; David J,9999,0,9999,0
1668150276415,CSE 293,017,119300,Kumar; Arun Kumar,9999,0,9999,0
1668150276415,CSE 293,018,119301,Lerner; Sorin,9999,0,9999,0
1668150276415,CSE 293,019,119302,Lovett; Shachar,9999,0,9999,0
1668150276415,CSE 293,020,119303,McAuley; Julian John,9999,0,9999,0
1668150276415,CSE 293,021,119304,Micciancio; Daniele,9999,0,9999,0
1668150276415,CSE 293,022,119367,Orailoglu; Alex,9999,0,9999,0
1668150276415,CSE 293,023,119382,Paturi; Ramamohan,9999,0,9999,0
1668150276415,CSE 293,024,119404,Polikarpova; Nadezhda,9999,0,9999,0
1668150276415,CSE 293,025,119406,Politz; Joseph Gibbs,9999,0,9999,0
1668150276415,CSE 293,026,119411,Porter; George M,9999,0,9999,0
1668150276415,CSE 293,027,119414,Porter; Leonard Emerson,9999,0,9999,0
1668150276415,CSE 293,028,119416,Ramamoorthi; Ravi,9999,0,9999,0
1668150276415,CSE 293,029,119417,Sahoo; Debashis,9999,0,9999,0
1668150276415,CSE 293,030,119420,Saul; Lawrence,9999,0,9999,0
1668150276415,CSE 293,031,119421,Savage; Stefan,9999,0,9999,0
1668150276415,CSE 293,032,119425,Schulze; Jurgen P.,9999,0,9999,0
1668150276415,CSE 293,033,119426,Snoeren; Alex C.,9999,0,9999,0
1668150276415,CSE 293,034,119428,Shang; Jingbo,9999,0,9999,0
1668150276415,CSE 293,035,119430,Stefan; Deian,9999,0,9999,0
1668150276415,CSE 293,036,119431,Su; Hao,9999,0,9999,0
1668150276415,CSE 293,037,119433,Swanson; Steven James,9999,0,9999,0
1668150276415,CSE 293,038,119435,Tullsen; Dean Michael,9999,0,9999,0
1668150276415,CSE 293,039,119483,Voelker; Geoffrey M.,9999,0,9999,0
1668150276415,CSE 293,040,119537,Zhao; Jishen,9999,0,9999,0
1668150276415,CSE 293,041,119538,Zhou; Yuan-Yuan,9999,0,9999,0
1668150276415,CSE 293,042,119539,Gao; Sicun,9999,0,9999,0
1668150276415,CSE 293,043,119540,Weibel; Nadir,9999,0,9999,0
1668150276415,CSE 293,044,119541,Gupta; Rajesh K.,9999,0,9999,0
1668150276415,CSE 293,045,126410,Vaccaro; Kristen Marie,9999,0,9999,0
1668150276415,CSE 293,046,126411,Klemke; Richard,9999,0,9999,0
1668150276839,CSE 294,A00,102459,Voelker; Geoffrey M.,0,0,0,0
1668150276839,CSE 294,B00,111322,Orailoglu; Alex,0,0,0,0
1668150277263,DSE 201,A00,096914,Deutsch; Alin Bernard,30,0,30,0
1668150277687,DSE 210,A00,096915,Dasgupta; Sanjoy,30,0,30,0
1668150278118,DSE 260A,A00,096916,Altintas De Callaf; Ilkay,30,0,30,0
1668150278586,ECE 200,001,103586,Antipa; Nicholas A,9999,0,9999,0
1668150278586,ECE 200,002,103587,Atanasov; Nikolay A.,9999,0,9999,0
1668150278586,ECE 200,003,103588,Bharadia; Dinesh,9999,0,9999,0
1668150278586,ECE 200,004,103589,Cheng; Chung Kuan,9999,0,9999,0
1668150278586,ECE 200,005,103590,Cosman; Pamela C.,9999,0,9999,0
1668150278586,ECE 200,006,103591,Dayeh; Shadi Ahmad,9999,0,9999,0
1668150278586,ECE 200,007,103592,Fainman; Yeshaiahu,9999,0,9999,0
1668150278586,ECE 200,008,103593,Ford; Joseph Earl,9999,0,9999,0
1668150278586,ECE 200,009,103594,Franceschetti; Massimo,9999,0,9999,0
1668150278586,ECE 200,010,103595,Fullerton; Eric E,9999,0,9999,0
1668150278586,ECE 200,011,103596,Galton; Ian A,9999,0,9999,0
1668150278586,ECE 200,012,103597,Gilja; Vikash,9999,0,9999,0
1668150278586,ECE 200,013,103598,Hall; Drew A.,9999,0,9999,0
1668150278586,ECE 200,014,103599,Hsueh; Tzu-Chien,9999,0,9999,0
1668150278586,ECE 200,015,103600,Javidi; Tara,9999,0,9999,0
1668150278586,ECE 200,016,103601,Kahng; Andrew Byun,9999,0,9999,0
1668150278586,ECE 200,017,103602,Kim; Young-Han,9999,0,9999,0
1668150278586,ECE 200,018,103603,Koushanfar; Farinaz,9999,0,9999,0
1668150278586,ECE 200,019,103604,Kuzum; Duygu,9999,0,9999,0
1668150278586,ECE 200,020,103605,Le; Hanh-Phuc,9999,0,9999,0
1668150278586,ECE 200,021,103606,Lin; Bill,9999,0,9999,0
1668150278586,ECE 200,022,103607,Liu; Zhaowei,9998,0,9999,1
1668150278586,ECE 200,023,103608,Lo; Yu-Hwa,9999,0,9999,0
1668150278586,ECE 200,024,103609,Lomakin; Vitaliy,9999,0,9999,0
1668150278586,ECE 200,025,103610,Mercier; Patrick Philip,9999,0,9999,0
1668150278586,ECE 200,026,103611,Meyer; Florian,9999,0,9999,0
1668150278586,ECE 200,027,103612,Milstein; Laurence B.,9999,0,9999,0
1668150278586,ECE 200,028,103613,Mir Arabbaygi; Siavash,9999,0,9999,0
1668150278586,ECE 200,029,103614,Mookherjea; Shayan,9999,0,9999,0
1668150278586,ECE 200,030,103615,Morris; Karcher William,9999,0,9999,0
1668150278586,ECE 200,031,103616,Ng; Tse Nga,9999,0,9999,0
1668150278586,ECE 200,032,103617,Nguyen; Truong Quang,9999,0,9999,0
1668150278586,ECE 200,033,103618,Nomura; Kenji,9999,0,9999,0
1668150278586,ECE 200,034,103619,Orlitsky; Alon,9999,0,9999,0
1668150278586,ECE 200,035,103620,Pal; Piya,9999,0,9999,0
1668150278586,ECE 200,036,103621,Papen; George C.,9999,0,9999,0
1668150278586,ECE 200,037,103622,Radic; Stojan,9999,0,9999,0
1668150278586,ECE 200,038,103623,Rao; Bhaskar D.,9999,0,9999,0
1668150278586,ECE 200,039,103624,Rao; Ramesh R,9999,0,9999,0
1668150278586,ECE 200,040,103625,Rebeiz; Gabriel,9999,0,9999,0
1668150278586,ECE 200,041,103626,Sanford; John R,9999,0,9999,0
1668150278586,ECE 200,042,103627,Siegel; Paul H.,9999,0,9999,0
1668150278586,ECE 200,043,103628,Sievenpiper; Daniel F.,9999,0,9999,0
1668150278586,ECE 200,044,103629,Sworder; David D.,9999,0,9999,0
1668150278586,ECE 200,045,103630,Taur; Yuan,9999,0,9999,0
1668150278586,ECE 200,046,103631,Touri; Behrouz,9999,0,9999,0
1668150278586,ECE 200,047,103632,Trivedi; Mohan M.,9999,0,9999,0
1668150278586,ECE 200,048,103633,Vasconcelos; Nuno,9999,0,9999,0
1668150278586,ECE 200,049,103634,Wang; Xiaolong,9999,0,9999,0
1668150278586,ECE 200,050,103635,Xie; Pengtao,9999,0,9999,0
1668150278586,ECE 200,051,103636,Yip; Michael,9999,0,9999,0
1668150278586,ECE 200,052,103637,Zeger; Kenneth A.,999,0,999,0
1668150278586,ECE 200,053,103638,Zhang; Xinyu,9999,0,9999,0
1668150278586,ECE 200,054,103639,Turakhia; Yatish Girish,9999,0,9999,0
1668150278586,ECE 200,055,103640,Kang; Mingu,9999,0,9999,0
1668150278586,ECE 200,056,103641,Shi; Yuanyuan,9999,0,9999,0
1668150278586,ECE 200,057,103642,Wang; Edward Jay,9999,0,9999,0
1668150278586,ECE 200,058,103643,Zheng; Yang,9999,0,9999,0
1668150279013,ECE 202,A00,103644,Kuzum; Duygu,0,0,0,0
1668150279444,ECE 212BN,A00,103646,Ng; Tse Nga,0,0,0,0
1668150279868,ECE 221,A00,111493,Staff,0,0,0,0
1668150280294,ECE 222B,A00,103647,Lomakin; Vitaliy,0,0,0,0
1668150280719,ECE 230B,A00,103648,Taur; Yuan,0,0,0,0
1668150281148,ECE 238B,A00,103649,Garay; Javier,0,0,0,0
1668150281575,ECE 240B,A00,112900,Fainman; Yeshaiahu,0,0,0,0
1668150281999,ECE 247A,A00,103650,Jokerst; Jesse Vincent,0,0,0,0
1668150282424,ECE 247B,A00,103651,Wang; Joseph,0,0,0,0
1668150282856,ECE 250,A00,103652,Siegel; Paul H.,0,0,0,0
1668150283278,ECE 251A,A00,103654,Rao; Bhaskar D.,0,0,0,0
1668150283703,ECE 257B,A00,103655,Bharadia; Dinesh,0,0,0,0
1668150284130,ECE 258A,A00,103656,Milstein; Laurence B.,0,0,0,0
1668150284561,ECE 260B,A00,103658,Kang; Mingu,0,0,0,0
1668150284988,ECE 264A,A00,103659,Galton; Ian A,0,0,0,0
1668150285411,ECE 265A,A00,103661,Gudem; Prasad S.S.,0,0,0,0
1668150285835,ECE 265D,A00,103662,Gudem; Prasad S.S.,0,0,0,0
1668150286260,ECE 268,A00,103663,Koushanfar; Farinaz,0,0,0,0
1668150286684,ECE 269,A01,103665,Pal; Piya,0,0,0,0
1668150287111,ECE 271B,A00,103666,Vasconcelos; Manuela,0,0,0,0
1668150287540,ECE 276A,A00,103667,Atanasov; Nikolay A.,0,0,0,0
1668150287966,ECE 277,A00,103668,An; Cheolhong,0,0,0,0
1668150288388,ECE 279,A00,117947,Hall; Drew A.,0,0,0,0
1668150289254,ECE 283,A00,103670,Hsueh; Tzu-Chien,0,0,0,0
1668150289678,ECE 284,A00,103671,Turakhia; Yatish Girish,0,0,0,0
1668150290106,ECE 285,A00,103672,Zheng; Yang,0,0,0,0
1668150290106,ECE 285,B00,103673,Sworder; David D.,0,0,0,0
1668150290532,ECE 287,A00,103676,Javidi; Tara,0,0,0,0
1668150290967,MATH 200B,A00,098023,Salehi Golsefidy; Alireza,12,0,15,3
1668150291399,MATH 202B,A00,098024,Rhoades; Brendon Patrick,9,0,15,6
1668150291828,MATH 203B,A00,098025,Oprea; Dragos N.,10,0,15,5
1668150292250,MATH 204B,A00,098026,Sorensen; Claus M,13,0,15,2
1668150292676,MATH 208,A00,098027,Izadi; Elham,7,0,10,3
1668150293098,MATH 209,A00,098028,Pollack; Aaron,10,0,10,0
1668150293525,MATH 211A,A00,112919,Rogalski; Daniel,9,0,10,1
1668150293951,MATH 211B,A00,112920,Seward; Brandon M.,9,0,10,1
1668150294376,MATH 218,A00,098029,Li; Bo,10,0,10,0
1668150294804,MATH 220B,A00,098030,Novak; Jonathan I,11,0,15,4
1668150295232,MATH 221A,A00,098031,Ebenfelt; Peter F,13,0,15,2
1668150295658,MATH 231B,A00,098032,Zlatos; Andrej,12,0,15,3
1668150296086,MATH 240B,A00,098033,Ni; Lei,9,0,15,6
1668150296509,MATH 243,A00,098034,Jekel; David Andrew,10,0,10,0
1668150296933,MATH 245A,A00,098035,Nie; Jiawang,0,0,15,16
1668150297358,MATH 248,A00,098036,Bejenaru; Ioan,10,0,10,0
1668150297781,MATH 250B,A00,098037,Spolaor; Luca,14,0,15,1
1668150298216,MATH 258,A00,098038,Ni; Lei,10,0,10,0
1668150298642,MATH 264B,A00,098041,Rhoades; Brendon Patrick,9,0,15,6
1668150299065,MATH 268,A00,098042,Buss; Samuel R,10,0,10,0
1668150299488,MATH 269,A00,098043,Rhoades; Brendon Patrick,10,0,10,0
1668150299914,MATH 270B,A00,098044,Li; Bo,10,0,15,5
1668150300339,MATH 272B,A00,098045,Holst; Michael J,13,0,15,2
1668150300765,MATH 273A,A00,098046,Tian; Xiaochuan,10,0,15,5
1668150301193,MATH 275,A01,098048,Tian; Xiaochuan,6,0,10,4
1668150301619,MATH 278A,A00,098049,Holst; Michael J,8,0,10,2
1668150302042,MATH 278B,A00,098050,Cloninger; Alexander,10,0,10,0
1668150302469,MATH 278C,A00,098051,Nie; Jiawang,7,0,10,3
1668150302893,MATH 280B,A00,098052,Zheng; Tianyi,10,0,15,5
1668150303317,MATH 281B,A00,098053,Bradic; Jelena,2,0,15,13
1668150303741,MATH 282B,A00,098054,Arias-Castro; Ery,0,0,15,15
1668150304166,MATH 285,A00,098055,Fitzsimmons; Patrick J,0,0,15,17
1668150304590,MATH 287B,A00,098056,Arias-Castro; Ery,2,0,15,13
1668150305019,MATH 288,A00,098057,Agarwal; Pooja,9,0,10,1
1668150305019,MATH 288,B00,098058,Zhang; Danna,8,0,10,2
1668150305019,MATH 288,C00,098059,Williams; Ruth J,10,0,10,0
1668150305447,MATH 290B,A00,098060,Roberts; Justin Deritter,13,0,15,2
1668150305879,MATH 292,A00,098061,Belmont; Eva Kinoshita,10,0,10,0
1668150306303,MATH 295,A00,098062,Suk; Andrew Hoon,48,0,50,2
1668150306732,MATH 296,A00,098063,Novak; Jonathan I,20,0,20,0
1668150307156,MATH 297,001,098064,Gamst; Anthony Collins,9997,0,9999,2
1668150816854,COGS 205,A00,101395,Chiba; Andrea,19,0,20,1
1668150817279,COGS 210B,001,101404,Greene; Deanna Jacquelyn,9998,0,9999,1
1668150817279,COGS 210B,002,101417,Xia; Haijun,9999,0,9999,0
1668150817279,COGS 210B,003,101422,Nitz; Douglas A.,9999,0,9999,0
1668150817279,COGS 210B,004,101423,Hollan; James D.,9998,0,9999,1
1668150817279,COGS 210B,005,101424,Deak; Gedeon O.,9998,0,9999,1
1668150817279,COGS 210B,006,101425,Rossano; Federico,9999,0,9999,0
1668150817712,COGS 211B,A00,101427,Coulson; Seana M,9996,0,9999,3
1668150818143,COGS 220,A00,101428,Hollan; James D.,0,0,25,25
1668150818572,COGS 229,A00,101429,Dow; Steven P,18,0,25,7
1668150818998,COGS 230,A00,101430,Klemmer; Scott R,12,0,17,5
1668150819421,COGS 234,A00,101431,Xia; Haijun,3,0,25,22
1668150819848,COGS 260,A00,101432,Kiyonaga; Anastasia,20,0,25,5
1668150819848,COGS 260,B00,101433,Kirsh; David Joel,16,0,25,9
1668150820275,CSE 202,A00,102371,Impagliazzo; Russell,0,0,0,0
1668150820699,CSE 203B,A01,102373,Cheng; Chung Kuan,0,0,0,0
1668150821122,CSE 208,A00,102374,Micciancio; Daniele,0,0,0,0
1668150821555,CSE 209A,A00,112895,Impagliazzo; Russell,0,0,15,15
1668150821987,CSE 209B,A00,108005,Bellare; Mihir,0,0,0,0
1668150822415,CSE 210,A00,113163,Coblenz; Michael J,0,0,0,0
1668150822837,CSE 219,A00,106111,Dow; Steven P,0,0,20,20
1668150823262,CSE 221,A00,102376,Voelker; Geoffrey M.,0,0,0,0
1668150823687,CSE 224,A01,102378,Porter; George M,0,0,0,0
1668150824110,CSE 229A,A00,102379,Savage; Stefan,0,0,0,0
1668150824534,CSE 229C,A00,102380,Munyaka; Imani N. S.,0,0,0,0
1668150824961,CSE 232B,A00,102382,Deutsch; Alin Bernard,0,0,0,0
1668150825384,CSE 234,A01,112904,Kumar; Arun Kumar,0,0,0,0
1668150825809,CSE 237A,A00,102383,Rosing; Tajana Simunic,0,0,0,0
1668150826232,CSE 239A,A00,102384,Deutsch; Alin Bernard,0,0,0,0
1668150826656,CSE 239B,A00,102385,Polikarpova; Nadezhda,0,0,0,0
1668150827081,CSE 240A,A00,102386,Pannuto; Patrick William,0,0,0,0
1668150827506,CSE 240B,A00,102387,Zhao; Jishen,0,0,0,0
1668150827930,CSE 241A,A00,106406,Kang; Mingu,0,0,0,0
1668150828356,CSE 249B,A00,102388,Kahng; Andrew Byun,0,0,8,8
1668150828779,CSE 251B,A01,102392,Cottrell; Garrison W,0,0,0,0
1668150828779,CSE 251B,A02,102393,Cottrell; Garrison W,0,0,0,0
1668150829202,CSE 252B,A00,102394,Ochoa; Benjamin Lawrence,0,0,0,0
1668150829626,CSE 257,A01,102396,Gao; Sicun,0,0,0,0
1668150830052,CSE 272,A00,102397,Li; Tzumao,0,0,0,0
1668150830477,CSE 274,A00,111323,Chern; Albert Ren-Haur,0,0,0,0
1668150830900,CSE 282,A00,102398,Pevzner; Pavel Arkadjevich,0,0,0,0
1668150831327,CSE 284,A00,114175,Gymrek; Melissa Ann,0,0,0,0
1668150831751,CSE 290,A00,102399,Chandraker; Manmohan Krishna,0,0,0,0
1668150831751,CSE 290,B00,102400,Vaccaro; Kristen Marie,0,0,25,25
1668150831751,CSE 290,C00,102414,Pannuto; Patrick William,0,0,25,25
1668150831751,CSE 290,D00,102427,Pevzner; Pavel Arkadjevich,0,0,0,0
1668150831751,CSE 290,E00,102429,Zhao; Jishen,0,0,0,0
1668150831751,CSE 290,F00,102436,Tullsen; Dean Michael,0,0,0,0
1668150831751,CSE 290,G00,102440,Christensen; Henrik I,0,0,20,20
1668150832180,CSE 291,A00,102443,Su; Hao,0,0,0,0
1668150832180,CSE 291,B00,102448,Polikarpova; Nadezhda,0,0,0,0
1668150832180,CSE 291,C00,102453,Vaccaro; Kristen Marie,0,0,0,0
1668150832180,CSE 291,D00,111343,Savage; Stefan,0,0,0,0
1668150832180,CSE 291,E00,116474,Claffy; Kimberly Claire,0,0,0,0
1668150832180,CSE 291,F00,116479,Pasquale; Joseph,0,0,0,0
1668150832608,CSE 293,001,119111,Bafna; Vineet,9999,0,9999,0
1668150832608,CSE 293,002,119118,Bellare; Mihir,9999,0,9999,0
1668150832608,CSE 293,003,119122,Berg-Kirkpatrick; Taylor D,9999,0,9999,0
1668150832608,CSE 293,004,119135,Christensen; Henrik I,9999,0,9999,0
1668150832608,CSE 293,005,119142,Cottrell; Garrison W,9999,0,9999,0
1668150832608,CSE 293,006,119146,Deutsch; Alin Bernard,9999,0,9999,0
1668150832608,CSE 293,007,119159,Esmaeilzadeh; Hadi,9999,0,9999,0
1668150832608,CSE 293,008,119166,Freund; Yoav,9999,0,9999,0
1668150832608,CSE 293,009,119170,Griswold; William G.,9999,0,9999,0
1668150832608,CSE 293,010,119183,Gymrek; Melissa Ann,9999,0,9999,0
1668150832608,CSE 293,011,119190,Heninger; Nadia A,9999,0,9999,0
1668150832608,CSE 293,012,119230,Impagliazzo; Russell,9999,0,9999,0
1668150832608,CSE 293,013,119232,Jhala; Ranjit,9999,0,9999,0
1668150832608,CSE 293,014,119233,Kahng; Andrew Byun,9999,0,9999,0
1668150832608,CSE 293,015,119298,Kane; Daniel Mertz,9999,0,9999,0
1668150832608,CSE 293,016,119299,Kriegman; David J,9999,0,9999,0
1668150832608,CSE 293,017,119300,Kumar; Arun Kumar,9999,0,9999,0
1668150832608,CSE 293,018,119301,Lerner; Sorin,9999,0,9999,0
1668150832608,CSE 293,019,119302,Lovett; Shachar,9999,0,9999,0
1668150832608,CSE 293,020,119303,McAuley; Julian John,9999,0,9999,0
1668150832608,CSE 293,021,119304,Micciancio; Daniele,9999,0,9999,0
1668150832608,CSE 293,022,119367,Orailoglu; Alex,9999,0,9999,0
1668150832608,CSE 293,023,119382,Paturi; Ramamohan,9999,0,9999,0
1668150832608,CSE 293,024,119404,Polikarpova; Nadezhda,9999,0,9999,0
1668150832608,CSE 293,025,119406,Politz; Joseph Gibbs,9999,0,9999,0
1668150832608,CSE 293,026,119411,Porter; George M,9999,0,9999,0
1668150832608,CSE 293,027,119414,Porter; Leonard Emerson,9999,0,9999,0
1668150832608,CSE 293,028,119416,Ramamoorthi; Ravi,9999,0,9999,0
1668150832608,CSE 293,029,119417,Sahoo; Debashis,9999,0,9999,0
1668150832608,CSE 293,030,119420,Saul; Lawrence,9999,0,9999,0
1668150832608,CSE 293,031,119421,Savage; Stefan,9999,0,9999,0
1668150832608,CSE 293,032,119425,Schulze; Jurgen P.,9999,0,9999,0
1668150832608,CSE 293,033,119426,Snoeren; Alex C.,9999,0,9999,0
1668150832608,CSE 293,034,119428,Shang; Jingbo,9999,0,9999,0
1668150832608,CSE 293,035,119430,Stefan; Deian,9999,0,9999,0
1668150832608,CSE 293,036,119431,Su; Hao,9999,0,9999,0
1668150832608,CSE 293,037,119433,Swanson; Steven James,9999,0,9999,0
1668150832608,CSE 293,038,119435,Tullsen; Dean Michael,9999,0,9999,0
1668150832608,CSE 293,039,119483,Voelker; Geoffrey M.,9999,0,9999,0
1668150832608,CSE 293,040,119537,Zhao; Jishen,9999,0,9999,0
1668150832608,CSE 293,041,119538,Zhou; Yuan-Yuan,9999,0,9999,0
1668150832608,CSE 293,042,119539,Gao; Sicun,9999,0,9999,0
1668150832608,CSE 293,043,119540,Weibel; Nadir,9999,0,9999,0
1668150832608,CSE 293,044,119541,Gupta; Rajesh K.,9999,0,9999,0
1668150832608,CSE 293,045,126410,Vaccaro; Kristen Marie,9999,0,9999,0
1668150832608,CSE 293,046,126411,Klemke; Richard,9999,0,9999,0
1668150833034,CSE 294,A00,102459,Voelker; Geoffrey M.,0,0,0,0
1668150833034,CSE 294,B00,111322,Orailoglu; Alex,0,0,0,0
1668150833462,DSE 201,A00,096914,Deutsch; Alin Bernard,30,0,30,0
1668150833895,DSE 210,A00,096915,Dasgupta; Sanjoy,30,0,30,0
1668150834320,DSE 260A,A00,096916,Altintas De Callaf; Ilkay,30,0,30,0
1668150834765,ECE 200,001,103586,Antipa; Nicholas A,9999,0,9999,0
1668150834765,ECE 200,002,103587,Atanasov; Nikolay A.,9999,0,9999,0
1668150834765,ECE 200,003,103588,Bharadia; Dinesh,9999,0,9999,0
1668150834765,ECE 200,004,103589,Cheng; Chung Kuan,9999,0,9999,0
1668150834765,ECE 200,005,103590,Cosman; Pamela C.,9999,0,9999,0
1668150834765,ECE 200,006,103591,Dayeh; Shadi Ahmad,9999,0,9999,0
1668150834765,ECE 200,007,103592,Fainman; Yeshaiahu,9999,0,9999,0
1668150834765,ECE 200,008,103593,Ford; Joseph Earl,9999,0,9999,0
1668150834765,ECE 200,009,103594,Franceschetti; Massimo,9999,0,9999,0
1668150834765,ECE 200,010,103595,Fullerton; Eric E,9999,0,9999,0
1668150834765,ECE 200,011,103596,Galton; Ian A,9999,0,9999,0
1668150834765,ECE 200,012,103597,Gilja; Vikash,9999,0,9999,0
1668150834765,ECE 200,013,103598,Hall; Drew A.,9999,0,9999,0
1668150834765,ECE 200,014,103599,Hsueh; Tzu-Chien,9999,0,9999,0
1668150834765,ECE 200,015,103600,Javidi; Tara,9999,0,9999,0
1668150834765,ECE 200,016,103601,Kahng; Andrew Byun,9999,0,9999,0
1668150834765,ECE 200,017,103602,Kim; Young-Han,9999,0,9999,0
1668150834765,ECE 200,018,103603,Koushanfar; Farinaz,9999,0,9999,0
1668150834765,ECE 200,019,103604,Kuzum; Duygu,9999,0,9999,0
1668150834765,ECE 200,020,103605,Le; Hanh-Phuc,9999,0,9999,0
1668150834765,ECE 200,021,103606,Lin; Bill,9999,0,9999,0
1668150834765,ECE 200,022,103607,Liu; Zhaowei,9998,0,9999,1
1668150834765,ECE 200,023,103608,Lo; Yu-Hwa,9999,0,9999,0
1668150834765,ECE 200,024,103609,Lomakin; Vitaliy,9999,0,9999,0
1668150834765,ECE 200,025,103610,Mercier; Patrick Philip,9999,0,9999,0
1668150834765,ECE 200,026,103611,Meyer; Florian,9999,0,9999,0
1668150834765,ECE 200,027,103612,Milstein; Laurence B.,9999,0,9999,0
1668150834765,ECE 200,028,103613,Mir Arabbaygi; Siavash,9999,0,9999,0
1668150834765,ECE 200,029,103614,Mookherjea; Shayan,9999,0,9999,0
1668150834765,ECE 200,030,103615,Morris; Karcher William,9999,0,9999,0
1668150834765,ECE 200,031,103616,Ng; Tse Nga,9999,0,9999,0
1668150834765,ECE 200,032,103617,Nguyen; Truong Quang,9999,0,9999,0
1668150834765,ECE 200,033,103618,Nomura; Kenji,9999,0,9999,0
1668150834765,ECE 200,034,103619,Orlitsky; Alon,9999,0,9999,0
1668150834765,ECE 200,035,103620,Pal; Piya,9999,0,9999,0
1668150834765,ECE 200,036,103621,Papen; George C.,9999,0,9999,0
1668150834765,ECE 200,037,103622,Radic; Stojan,9999,0,9999,0
1668150834765,ECE 200,038,103623,Rao; Bhaskar D.,9999,0,9999,0
1668150834765,ECE 200,039,103624,Rao; Ramesh R,9999,0,9999,0
1668150834765,ECE 200,040,103625,Rebeiz; Gabriel,9999,0,9999,0
1668150834765,ECE 200,041,103626,Sanford; John R,9999,0,9999,0
1668150834765,ECE 200,042,103627,Siegel; Paul H.,9999,0,9999,0
1668150834765,ECE 200,043,103628,Sievenpiper; Daniel F.,9999,0,9999,0
1668150834765,ECE 200,044,103629,Sworder; David D.,9999,0,9999,0
1668150834765,ECE 200,045,103630,Taur; Yuan,9999,0,9999,0
1668150834765,ECE 200,046,103631,Touri; Behrouz,9999,0,9999,0
1668150834765,ECE 200,047,103632,Trivedi; Mohan M.,9999,0,9999,0
1668150834765,ECE 200,048,103633,Vasconcelos; Nuno,9999,0,9999,0
1668150834765,ECE 200,049,103634,Wang; Xiaolong,9999,0,9999,0
1668150834765,ECE 200,050,103635,Xie; Pengtao,9999,0,9999,0
1668150834765,ECE 200,051,103636,Yip; Michael,9999,0,9999,0
1668150834765,ECE 200,052,103637,Zeger; Kenneth A.,999,0,999,0
1668150834765,ECE 200,053,103638,Zhang; Xinyu,9999,0,9999,0
1668150834765,ECE 200,054,103639,Turakhia; Yatish Girish,9999,0,9999,0
1668150834765,ECE 200,055,103640,Kang; Mingu,9999,0,9999,0
1668150834765,ECE 200,056,103641,Shi; Yuanyuan,9999,0,9999,0
1668150834765,ECE 200,057,103642,Wang; Edward Jay,9999,0,9999,0
1668150834765,ECE 200,058,103643,Zheng; Yang,9999,0,9999,0
1668150835189,ECE 202,A00,103644,Kuzum; Duygu,0,0,0,0
1668150835614,ECE 212BN,A00,103646,Ng; Tse Nga,0,0,0,0
1668150836043,ECE 221,A00,111493,Staff,0,0,0,0
1668150836481,ECE 222B,A00,103647,Lomakin; Vitaliy,0,0,0,0
1668150836930,ECE 230B,A00,103648,Taur; Yuan,0,0,0,0
1668150837355,ECE 238B,A00,103649,Garay; Javier,0,0,0,0
1668150837778,ECE 240B,A00,112900,Fainman; Yeshaiahu,0,0,0,0
1668150838210,ECE 247A,A00,103650,Jokerst; Jesse Vincent,0,0,0,0
1668150838639,ECE 247B,A00,103651,Wang; Joseph,0,0,0,0
1668150839066,ECE 250,A00,103652,Siegel; Paul H.,0,0,0,0
1668150839493,ECE 251A,A00,103654,Rao; Bhaskar D.,0,0,0,0
1668150839918,ECE 257B,A00,103655,Bharadia; Dinesh,0,0,0,0
1668150840347,ECE 258A,A00,103656,Milstein; Laurence B.,0,0,0,0
1668150840864,ECE 260B,A00,103658,Kang; Mingu,0,0,0,0
1668150841289,ECE 264A,A00,103659,Galton; Ian A,0,0,0,0
1668150841714,ECE 265A,A00,103661,Gudem; Prasad S.S.,0,0,0,0
1668150842137,ECE 265D,A00,103662,Gudem; Prasad S.S.,0,0,0,0
1668150842561,ECE 268,A00,103663,Koushanfar; Farinaz,0,0,0,0
1668150842984,ECE 269,A01,103665,Pal; Piya,0,0,0,0
1668150843409,ECE 271B,A00,103666,Vasconcelos; Manuela,0,0,0,0
1668150843848,ECE 276A,A00,103667,Atanasov; Nikolay A.,0,0,0,0
1668150844272,ECE 277,A00,103668,An; Cheolhong,0,0,0,0
1668150844708,ECE 279,A00,117947,Hall; Drew A.,0,0,0,0
1668150845554,ECE 283,A00,103670,Hsueh; Tzu-Chien,0,0,0,0
1668150845986,ECE 284,A00,103671,Turakhia; Yatish Girish,0,0,0,0
1668150846415,ECE 285,A00,103672,Zheng; Yang,0,0,0,0
1668150846415,ECE 285,B00,103673,Sworder; David D.,0,0,0,0
1668150846848,ECE 287,A00,103676,Javidi; Tara,0,0,0,0
1668150847275,MATH 200B,A00,098023,Salehi Golsefidy; Alireza,12,0,15,3
1668150847701,MATH 202B,A00,098024,Rhoades; Brendon Patrick,9,0,15,6
1668150848124,MATH 203B,A00,098025,Oprea; Dragos N.,10,0,15,5
1668150848555,MATH 204B,A00,098026,Sorensen; Claus M,13,0,15,2
1668150848980,MATH 208,A00,098027,Izadi; Elham,7,0,10,3
1668150849405,MATH 209,A00,098028,Pollack; Aaron,10,0,10,0
1668150849829,MATH 211A,A00,112919,Rogalski; Daniel,9,0,10,1
1668150850253,MATH 211B,A00,112920,Seward; Brandon M.,9,0,10,1
1668150850677,MATH 218,A00,098029,Li; Bo,10,0,10,0
1668150851103,MATH 220B,A00,098030,Novak; Jonathan I,11,0,15,4
1668150851536,MATH 221A,A00,098031,Ebenfelt; Peter F,13,0,15,2
1668150851962,MATH 231B,A00,098032,Zlatos; Andrej,12,0,15,3
1668150852401,MATH 240B,A00,098033,Ni; Lei,9,0,15,6
1668150852825,MATH 243,A00,098034,Jekel; David Andrew,10,0,10,0
1668150853248,MATH 245A,A00,098035,Nie; Jiawang,0,0,15,16
1668150853671,MATH 248,A00,098036,Bejenaru; Ioan,10,0,10,0
1668150854097,MATH 250B,A00,098037,Spolaor; Luca,14,0,15,1
1668150854521,MATH 258,A00,098038,Ni; Lei,10,0,10,0
1668150854944,MATH 264B,A00,098041,Rhoades; Brendon Patrick,9,0,15,6
1668150855371,MATH 268,A00,098042,Buss; Samuel R,10,0,10,0
1668150855794,MATH 269,A00,098043,Rhoades; Brendon Patrick,10,0,10,0
1668150856218,MATH 270B,A00,098044,Li; Bo,10,0,15,5
1668150856645,MATH 272B,A00,098045,Holst; Michael J,13,0,15,2
1668150857071,MATH 273A,A00,098046,Tian; Xiaochuan,10,0,15,5
1668150857498,MATH 275,A01,098048,Tian; Xiaochuan,6,0,10,4
1668150857922,MATH 278A,A00,098049,Holst; Michael J,8,0,10,2
1668150858350,MATH 278B,A00,098050,Cloninger; Alexander,10,0,10,0
1668150858776,MATH 278C,A00,098051,Nie; Jiawang,7,0,10,3
1668150859201,MATH 280B,A00,098052,Zheng; Tianyi,10,0,15,5
1668150859629,MATH 281B,A00,098053,Bradic; Jelena,2,0,15,13
1668150860051,MATH 282B,A00,098054,Arias-Castro; Ery,0,0,15,15
1668150860476,MATH 285,A00,098055,Fitzsimmons; Patrick J,0,0,15,17
1668150860904,MATH 287B,A00,098056,Arias-Castro; Ery,2,0,15,13
1668150861329,MATH 288,A00,098057,Agarwal; Pooja,9,0,10,1
1668150861329,MATH 288,B00,098058,Zhang; Danna,8,0,10,2
1668150861329,MATH 288,C00,098059,Williams; Ruth J,10,0,10,0
1668150861754,MATH 290B,A00,098060,Roberts; Justin Deritter,13,0,15,2
1668150862177,MATH 292,A00,098061,Belmont; Eva Kinoshita,10,0,10,0
1668150862599,MATH 295,A00,098062,Suk; Andrew Hoon,48,0,50,2
1668150863026,MATH 296,A00,098063,Novak; Jonathan I,20,0,20,0
1668150863450,MATH 297,001,098064,Gamst; Anthony Collins,9997,0,9999,2
1668151362829,COGS 205,A00,101395,Chiba; Andrea,19,0,20,1
1668151363252,COGS 210B,001,101404,Greene; Deanna Jacquelyn,9998,0,9999,1
1668151363252,COGS 210B,002,101417,Xia; Haijun,9999,0,9999,0
1668151363252,COGS 210B,003,101422,Nitz; Douglas A.,9999,0,9999,0
1668151363252,COGS 210B,004,101423,Hollan; James D.,9998,0,9999,1
1668151363252,COGS 210B,005,101424,Deak; Gedeon O.,9998,0,9999,1
1668151363252,COGS 210B,006,101425,Rossano; Federico,9999,0,9999,0
1668151363680,COGS 211B,A00,101427,Coulson; Seana M,9996,0,9999,3
1668151364103,COGS 220,A00,101428,Hollan; James D.,0,0,25,25
1668151364526,COGS 229,A00,101429,Dow; Steven P,18,0,25,7
1668151364948,COGS 230,A00,101430,Klemmer; Scott R,12,0,17,5
1668151365382,COGS 234,A00,101431,Xia; Haijun,3,0,25,22
1668151365814,COGS 260,A00,101432,Kiyonaga; Anastasia,20,0,25,5
1668151365814,COGS 260,B00,101433,Kirsh; David Joel,16,0,25,9
1668151366241,CSE 202,A00,102371,Impagliazzo; Russell,0,0,0,0
1668151366665,CSE 203B,A01,102373,Cheng; Chung Kuan,0,0,0,0
1668151367087,CSE 208,A00,102374,Micciancio; Daniele,0,0,0,0
1668151367512,CSE 209A,A00,112895,Impagliazzo; Russell,0,0,15,15
1668151367938,CSE 209B,A00,108005,Bellare; Mihir,0,0,0,0
1668151368377,CSE 210,A00,113163,Coblenz; Michael J,0,0,0,0
1668151368800,CSE 219,A00,106111,Dow; Steven P,0,0,20,20
1668151369232,CSE 221,A00,102376,Voelker; Geoffrey M.,0,0,0,0
1668151369661,CSE 224,A01,102378,Porter; George M,0,0,0,0
1668151370088,CSE 229A,A00,102379,Savage; Stefan,0,0,0,0
1668151370512,CSE 229C,A00,102380,Munyaka; Imani N. S.,0,0,0,0
1668151370936,CSE 232B,A00,102382,Deutsch; Alin Bernard,0,0,0,0
1668151371361,CSE 234,A01,112904,Kumar; Arun Kumar,0,0,0,0
1668151371790,CSE 237A,A00,102383,Rosing; Tajana Simunic,0,0,0,0
1668151372214,CSE 239A,A00,102384,Deutsch; Alin Bernard,0,0,0,0
1668151372638,CSE 239B,A00,102385,Polikarpova; Nadezhda,0,0,0,0
1668151373065,CSE 240A,A00,102386,Pannuto; Patrick William,0,0,0,0
1668151373489,CSE 240B,A00,102387,Zhao; Jishen,0,0,0,0
1668151373913,CSE 241A,A00,106406,Kang; Mingu,0,0,0,0
1668151374337,CSE 249B,A00,102388,Kahng; Andrew Byun,0,0,8,8
1668151374776,CSE 251B,A01,102392,Cottrell; Garrison W,0,0,0,0
1668151374776,CSE 251B,A02,102393,Cottrell; Garrison W,0,0,0,0
1668151375212,CSE 252B,A00,102394,Ochoa; Benjamin Lawrence,0,0,0,0
1668151375636,CSE 257,A01,102396,Gao; Sicun,0,0,0,0
1668151376062,CSE 272,A00,102397,Li; Tzumao,0,0,0,0
1668151376486,CSE 274,A00,111323,Chern; Albert Ren-Haur,0,0,0,0
1668151376909,CSE 282,A00,102398,Pevzner; Pavel Arkadjevich,0,0,0,0
1668151377339,CSE 284,A00,114175,Gymrek; Melissa Ann,0,0,0,0
1668151377787,CSE 290,A00,102399,Chandraker; Manmohan Krishna,0,0,0,0
1668151377787,CSE 290,B00,102400,Vaccaro; Kristen Marie,0,0,25,25
1668151377787,CSE 290,C00,102414,Pannuto; Patrick William,0,0,25,25
1668151377787,CSE 290,D00,102427,Pevzner; Pavel Arkadjevich,0,0,0,0
1668151377787,CSE 290,E00,102429,Zhao; Jishen,0,0,0,0
1668151377787,CSE 290,F00,102436,Tullsen; Dean Michael,0,0,0,0
1668151377787,CSE 290,G00,102440,Christensen; Henrik I,0,0,20,20
1668151378215,CSE 291,A00,102443,Su; Hao,0,0,0,0
1668151378215,CSE 291,B00,102448,Polikarpova; Nadezhda,0,0,0,0
1668151378215,CSE 291,C00,102453,Vaccaro; Kristen Marie,0,0,0,0
1668151378215,CSE 291,D00,111343,Savage; Stefan,0,0,0,0
1668151378215,CSE 291,E00,116474,Claffy; Kimberly Claire,0,0,0,0
1668151378215,CSE 291,F00,116479,Pasquale; Joseph,0,0,0,0
1668151378642,CSE 293,001,119111,Bafna; Vineet,9999,0,9999,0
1668151378642,CSE 293,002,119118,Bellare; Mihir,9999,0,9999,0
1668151378642,CSE 293,003,119122,Berg-Kirkpatrick; Taylor D,9999,0,9999,0
1668151378642,CSE 293,004,119135,Christensen; Henrik I,9999,0,9999,0
1668151378642,CSE 293,005,119142,Cottrell; Garrison W,9999,0,9999,0
1668151378642,CSE 293,006,119146,Deutsch; Alin Bernard,9999,0,9999,0
1668151378642,CSE 293,007,119159,Esmaeilzadeh; Hadi,9999,0,9999,0
1668151378642,CSE 293,008,119166,Freund; Yoav,9999,0,9999,0
1668151378642,CSE 293,009,119170,Griswold; William G.,9999,0,9999,0
1668151378642,CSE 293,010,119183,Gymrek; Melissa Ann,9999,0,9999,0
1668151378642,CSE 293,011,119190,Heninger; Nadia A,9999,0,9999,0
1668151378642,CSE 293,012,119230,Impagliazzo; Russell,9999,0,9999,0
1668151378642,CSE 293,013,119232,Jhala; Ranjit,9999,0,9999,0
1668151378642,CSE 293,014,119233,Kahng; Andrew Byun,9999,0,9999,0
1668151378642,CSE 293,015,119298,Kane; Daniel Mertz,9999,0,9999,0
1668151378642,CSE 293,016,119299,Kriegman; David J,9999,0,9999,0
1668151378642,CSE 293,017,119300,Kumar; Arun Kumar,9999,0,9999,0
1668151378642,CSE 293,018,119301,Lerner; Sorin,9999,0,9999,0
1668151378642,CSE 293,019,119302,Lovett; Shachar,9999,0,9999,0
1668151378642,CSE 293,020,119303,McAuley; Julian John,9999,0,9999,0
1668151378642,CSE 293,021,119304,Micciancio; Daniele,9999,0,9999,0
1668151378642,CSE 293,022,119367,Orailoglu; Alex,9999,0,9999,0
1668151378642,CSE 293,023,119382,Paturi; Ramamohan,9999,0,9999,0
1668151378642,CSE 293,024,119404,Polikarpova; Nadezhda,9999,0,9999,0
1668151378642,CSE 293,025,119406,Politz; Joseph Gibbs,9999,0,9999,0
1668151378642,CSE 293,026,119411,Porter; George M,9999,0,9999,0
1668151378642,CSE 293,027,119414,Porter; Leonard Emerson,9999,0,9999,0
1668151378642,CSE 293,028,119416,Ramamoorthi; Ravi,9999,0,9999,0
1668151378642,CSE 293,029,119417,Sahoo; Debashis,9999,0,9999,0
1668151378642,CSE 293,030,119420,Saul; Lawrence,9999,0,9999,0
1668151378642,CSE 293,031,119421,Savage; Stefan,9999,0,9999,0
1668151378642,CSE 293,032,119425,Schulze; Jurgen P.,9999,0,9999,0
1668151378642,CSE 293,033,119426,Snoeren; Alex C.,9999,0,9999,0
1668151378642,CSE 293,034,119428,Shang; Jingbo,9999,0,9999,0
1668151378642,CSE 293,035,119430,Stefan; Deian,9999,0,9999,0
1668151378642,CSE 293,036,119431,Su; Hao,9999,0,9999,0
1668151378642,CSE 293,037,119433,Swanson; Steven James,9999,0,9999,0
1668151378642,CSE 293,038,119435,Tullsen; Dean Michael,9999,0,9999,0
1668151378642,CSE 293,039,119483,Voelker; Geoffrey M.,9999,0,9999,0
1668151378642,CSE 293,040,119537,Zhao; Jishen,9999,0,9999,0
1668151378642,CSE 293,041,119538,Zhou; Yuan-Yuan,9999,0,9999,0
1668151378642,CSE 293,042,119539,Gao; Sicun,9999,0,9999,0
1668151378642,CSE 293,043,119540,Weibel; Nadir,9999,0,9999,0
1668151378642,CSE 293,044,119541,Gupta; Rajesh K.,9999,0,9999,0
1668151378642,CSE 293,045,126410,Vaccaro; Kristen Marie,9999,0,9999,0
1668151378642,CSE 293,046,126411,Klemke; Richard,9999,0,9999,0
1668151379066,CSE 294,A00,102459,Voelker; Geoffrey M.,0,0,0,0
1668151379066,CSE 294,B00,111322,Orailoglu; Alex,0,0,0,0
1668151379490,DSE 201,A00,096914,Deutsch; Alin Bernard,30,0,30,0
1668151379913,DSE 210,A00,096915,Dasgupta; Sanjoy,30,0,30,0
1668151380348,DSE 260A,A00,096916,Altintas De Callaf; Ilkay,30,0,30,0
1668151380786,ECE 200,001,103586,Antipa; Nicholas A,9999,0,9999,0
1668151380786,ECE 200,002,103587,Atanasov; Nikolay A.,9999,0,9999,0
1668151380786,ECE 200,003,103588,Bharadia; Dinesh,9999,0,9999,0
1668151380786,ECE 200,004,103589,Cheng; Chung Kuan,9999,0,9999,0
1668151380786,ECE 200,005,103590,Cosman; Pamela C.,9999,0,9999,0
1668151380786,ECE 200,006,103591,Dayeh; Shadi Ahmad,9999,0,9999,0
1668151380786,ECE 200,007,103592,Fainman; Yeshaiahu,9999,0,9999,0
1668151380786,ECE 200,008,103593,Ford; Joseph Earl,9999,0,9999,0
1668151380786,ECE 200,009,103594,Franceschetti; Massimo,9999,0,9999,0
1668151380786,ECE 200,010,103595,Fullerton; Eric E,9999,0,9999,0
1668151380786,ECE 200,011,103596,Galton; Ian A,9999,0,9999,0
1668151380786,ECE 200,012,103597,Gilja; Vikash,9999,0,9999,0
1668151380786,ECE 200,013,103598,Hall; Drew A.,9999,0,9999,0
1668151380786,ECE 200,014,103599,Hsueh; Tzu-Chien,9999,0,9999,0
1668151380786,ECE 200,015,103600,Javidi; Tara,9999,0,9999,0
1668151380786,ECE 200,016,103601,Kahng; Andrew Byun,9999,0,9999,0
1668151380786,ECE 200,017,103602,Kim; Young-Han,9999,0,9999,0
1668151380786,ECE 200,018,103603,Koushanfar; Farinaz,9999,0,9999,0
1668151380786,ECE 200,019,103604,Kuzum; Duygu,9999,0,9999,0
1668151380786,ECE 200,020,103605,Le; Hanh-Phuc,9999,0,9999,0
1668151380786,ECE 200,021,103606,Lin; Bill,9999,0,9999,0
1668151380786,ECE 200,022,103607,Liu; Zhaowei,9998,0,9999,1
1668151380786,ECE 200,023,103608,Lo; Yu-Hwa,9999,0,9999,0
1668151380786,ECE 200,024,103609,Lomakin; Vitaliy,9999,0,9999,0
1668151380786,ECE 200,025,103610,Mercier; Patrick Philip,9999,0,9999,0
1668151380786,ECE 200,026,103611,Meyer; Florian,9999,0,9999,0
1668151380786,ECE 200,027,103612,Milstein; Laurence B.,9999,0,9999,0
1668151380786,ECE 200,028,103613,Mir Arabbaygi; Siavash,9999,0,9999,0
1668151380786,ECE 200,029,103614,Mookherjea; Shayan,9999,0,9999,0
1668151380786,ECE 200,030,103615,Morris; Karcher William,9999,0,9999,0
1668151380786,ECE 200,031,103616,Ng; Tse Nga,9999,0,9999,0
1668151380786,ECE 200,032,103617,Nguyen; Truong Quang,9999,0,9999,0
1668151380786,ECE 200,033,103618,Nomura; Kenji,9999,0,9999,0
1668151380786,ECE 200,034,103619,Orlitsky; Alon,9999,0,9999,0
1668151380786,ECE 200,035,103620,Pal; Piya,9999,0,9999,0
1668151380786,ECE 200,036,103621,Papen; George C.,9999,0,9999,0
1668151380786,ECE 200,037,103622,Radic; Stojan,9999,0,9999,0
1668151380786,ECE 200,038,103623,Rao; Bhaskar D.,9999,0,9999,0
1668151380786,ECE 200,039,103624,Rao; Ramesh R,9999,0,9999,0
1668151380786,ECE 200,040,103625,Rebeiz; Gabriel,9999,0,9999,0
1668151380786,ECE 200,041,103626,Sanford; John R,9999,0,9999,0
1668151380786,ECE 200,042,103627,Siegel; Paul H.,9999,0,9999,0
1668151380786,ECE 200,043,103628,Sievenpiper; Daniel F.,9999,0,9999,0
1668151380786,ECE 200,044,103629,Sworder; David D.,9999,0,9999,0
1668151380786,ECE 200,045,103630,Taur; Yuan,9999,0,9999,0
1668151380786,ECE 200,046,103631,Touri; Behrouz,9999,0,9999,0
1668151380786,ECE 200,047,103632,Trivedi; Mohan M.,9999,0,9999,0
1668151380786,ECE 200,048,103633,Vasconcelos; Nuno,9999,0,9999,0
1668151380786,ECE 200,049,103634,Wang; Xiaolong,9999,0,9999,0
1668151380786,ECE 200,050,103635,Xie; Pengtao,9999,0,9999,0
1668151380786,ECE 200,051,103636,Yip; Michael,9999,0,9999,0
1668151380786,ECE 200,052,103637,Zeger; Kenneth A.,999,0,999,0
1668151380786,ECE 200,053,103638,Zhang; Xinyu,9999,0,9999,0
1668151380786,ECE 200,054,103639,Turakhia; Yatish Girish,9999,0,9999,0
1668151380786,ECE 200,055,103640,Kang; Mingu,9999,0,9999,0
1668151380786,ECE 200,056,103641,Shi; Yuanyuan,9999,0,9999,0
1668151380786,ECE 200,057,103642,Wang; Edward Jay,9999,0,9999,0
1668151380786,ECE 200,058,103643,Zheng; Yang,9999,0,9999,0
1668151381211,ECE 202,A00,103644,Kuzum; Duygu,0,0,0,0
1668151381638,ECE 212BN,A00,103646,Ng; Tse Nga,0,0,0,0
1668151382062,ECE 221,A00,111493,Staff,0,0,0,0
1668151382487,ECE 222B,A00,103647,Lomakin; Vitaliy,0,0,0,0
1668151382908,ECE 230B,A00,103648,Taur; Yuan,0,0,0,0
1668151383335,ECE 238B,A00,103649,Garay; Javier,0,0,0,0
1668151383763,ECE 240B,A00,112900,Fainman; Yeshaiahu,0,0,0,0
1668151384187,ECE 247A,A00,103650,Jokerst; Jesse Vincent,0,0,0,0
1668151384610,ECE 247B,A00,103651,Wang; Joseph,0,0,0,0
1668151385036,ECE 250,A00,103652,Siegel; Paul H.,0,0,0,0
1668151385460,ECE 251A,A00,103654,Rao; Bhaskar D.,0,0,0,0
1668151385882,ECE 257B,A00,103655,Bharadia; Dinesh,0,0,0,0
1668151386317,ECE 258A,A00,103656,Milstein; Laurence B.,0,0,0,0
1668151386742,ECE 260B,A00,103658,Kang; Mingu,0,0,0,0
1668151387167,ECE 264A,A00,103659,Galton; Ian A,0,0,0,0
1668151387603,ECE 265A,A00,103661,Gudem; Prasad S.S.,0,0,0,0
1668151388026,ECE 265D,A00,103662,Gudem; Prasad S.S.,0,0,0,0
1668151388454,ECE 268,A00,103663,Koushanfar; Farinaz,0,0,0,0
1668151388880,ECE 269,A01,103665,Pal; Piya,0,0,0,0
1668151389304,ECE 271B,A00,103666,Vasconcelos; Manuela,0,0,0,0
1668151389728,ECE 276A,A00,103667,Atanasov; Nikolay A.,0,0,0,0
1668151390153,ECE 277,A00,103668,An; Cheolhong,0,0,0,0
1668151390577,ECE 279,A00,117947,Hall; Drew A.,0,0,0,0
1668151391427,ECE 283,A00,103670,Hsueh; Tzu-Chien,0,0,0,0
1668151391855,ECE 284,A00,103671,Turakhia; Yatish Girish,0,0,0,0
1668151392278,ECE 285,A00,103672,Zheng; Yang,0,0,0,0
1668151392278,ECE 285,B00,103673,Sworder; David D.,0,0,0,0
1668151392706,ECE 287,A00,103676,Javidi; Tara,0,0,0,0
1668151393133,MATH 200B,A00,098023,Salehi Golsefidy; Alireza,12,0,15,3
1668151393557,MATH 202B,A00,098024,Rhoades; Brendon Patrick,9,0,15,6
1668151393980,MATH 203B,A00,098025,Oprea; Dragos N.,10,0,15,5
1668151394404,MATH 204B,A00,098026,Sorensen; Claus M,13,0,15,2
1668151394829,MATH 208,A00,098027,Izadi; Elham,7,0,10,3
1668151395251,MATH 209,A00,098028,Pollack; Aaron,10,0,10,0
1668151395675,MATH 211A,A00,112919,Rogalski; Daniel,9,0,10,1
1668151396101,MATH 211B,A00,112920,Seward; Brandon M.,9,0,10,1
1668151396535,MATH 218,A00,098029,Li; Bo,10,0,10,0
1668151396962,MATH 220B,A00,098030,Novak; Jonathan I,11,0,15,4
1668151397386,MATH 221A,A00,098031,Ebenfelt; Peter F,13,0,15,2
1668151397815,MATH 231B,A00,098032,Zlatos; Andrej,12,0,15,3
1668151398243,MATH 240B,A00,098033,Ni; Lei,9,0,15,6
1668151398665,MATH 243,A00,098034,Jekel; David Andrew,10,0,10,0
1668151399113,MATH 245A,A00,098035,Nie; Jiawang,0,0,15,16
1668151399536,MATH 248,A00,098036,Bejenaru; Ioan,10,0,10,0
1668151399960,MATH 250B,A00,098037,Spolaor; Luca,14,0,15,1
1668151400388,MATH 258,A00,098038,Ni; Lei,10,0,10,0
1668151400820,MATH 264B,A00,098041,Rhoades; Brendon Patrick,9,0,15,6
1668151401243,MATH 268,A00,098042,Buss; Samuel R,10,0,10,0
1668151401671,MATH 269,A00,098043,Rhoades; Brendon Patrick,10,0,10,0
1668151402096,MATH 270B,A00,098044,Li; Bo,10,0,15,5
1668151402522,MATH 272B,A00,098045,Holst; Michael J,13,0,15,2
1668151402944,MATH 273A,A00,098046,Tian; Xiaochuan,10,0,15,5
1668151403442,MATH 275,A01,098048,Tian; Xiaochuan,6,0,10,4
1668151403871,MATH 278A,A00,098049,Holst; Michael J,8,0,10,2
1668151404298,MATH 278B,A00,098050,Cloninger; Alexander,10,0,10,0
1668151404723,MATH 278C,A00,098051,Nie; Jiawang,7,0,10,3
1668151405150,MATH 280B,A00,098052,Zheng; Tianyi,10,0,15,5
1668151405574,MATH 281B,A00,098053,Bradic; Jelena,2,0,15,13
1668151406014,MATH 282B,A00,098054,Arias-Castro; Ery,0,0,15,15
1668151406437,MATH 285,A00,098055,Fitzsimmons; Patrick J,0,0,15,17
1668151406865,MATH 287B,A00,098056,Arias-Castro; Ery,2,0,15,13
1668151407289,MATH 288,A00,098057,Agarwal; Pooja,9,0,10,1
1668151407289,MATH 288,B00,098058,Zhang; Danna,8,0,10,2
1668151407289,MATH 288,C00,098059,Williams; Ruth J,10,0,10,0
1668151407710,MATH 290B,A00,098060,Roberts; Justin Deritter,13,0,15,2
1668151408148,MATH 292,A00,098061,Belmont; Eva Kinoshita,10,0,10,0
1668151408572,MATH 295,A00,098062,Suk; Andrew Hoon,48,0,50,2
1668151409009,MATH 296,A00,098063,Novak; Jonathan I,20,0,20,0
1668151409432,MATH 297,001,098064,Gamst; Anthony Collins,9997,0,9999,2
1668151909204,COGS 205,A00,101395,Chiba; Andrea,19,0,20,1
1668151909628,COGS 210B,001,101404,Greene; Deanna Jacquelyn,9998,0,9999,1
1668151909628,COGS 210B,002,101417,Xia; Haijun,9999,0,9999,0
1668151909628,COGS 210B,003,101422,Nitz; Douglas A.,9999,0,9999,0
1668151909628,COGS 210B,004,101423,Hollan; James D.,9998,0,9999,1
1668151909628,COGS 210B,005,101424,Deak; Gedeon O.,9998,0,9999,1
1668151909628,COGS 210B,006,101425,Rossano; Federico,9999,0,9999,0
1668151910053,COGS 211B,A00,101427,Coulson; Seana M,9996,0,9999,3
1668151910476,COGS 220,A00,101428,Hollan; James D.,0,0,25,25
1668151910900,COGS 229,A00,101429,Dow; Steven P,18,0,25,7
1668151911327,COGS 230,A00,101430,Klemmer; Scott R,12,0,17,5
1668151911751,COGS 234,A00,101431,Xia; Haijun,3,0,25,22
1668151912182,COGS 260,A00,101432,Kiyonaga; Anastasia,20,0,25,5
1668151912182,COGS 260,B00,101433,Kirsh; David Joel,16,0,25,9
1668151912611,CSE 202,A00,102371,Impagliazzo; Russell,0,0,0,0
1668151913035,CSE 203B,A01,102373,Cheng; Chung Kuan,0,0,0,0
1668151913458,CSE 208,A00,102374,Micciancio; Daniele,0,0,0,0
1668151913881,CSE 209A,A00,112895,Impagliazzo; Russell,0,0,15,15
1668151914306,CSE 209B,A00,108005,Bellare; Mihir,0,0,0,0
1668151914730,CSE 210,A00,113163,Coblenz; Michael J,0,0,0,0
1668151915154,CSE 219,A00,106111,Dow; Steven P,0,0,20,20
1668151915579,CSE 221,A00,102376,Voelker; Geoffrey M.,0,0,0,0
1668151916004,CSE 224,A01,102378,Porter; George M,0,0,0,0
1668151916431,CSE 229A,A00,102379,Savage; Stefan,0,0,0,0
1668151916854,CSE 229C,A00,102380,Munyaka; Imani N. S.,0,0,0,0
1668151917278,CSE 232B,A00,102382,Deutsch; Alin Bernard,0,0,0,0
1668151917702,CSE 234,A01,112904,Kumar; Arun Kumar,0,0,0,0
1668151918125,CSE 237A,A00,102383,Rosing; Tajana Simunic,0,0,0,0
1668151918550,CSE 239A,A00,102384,Deutsch; Alin Bernard,0,0,0,0
1668151918978,CSE 239B,A00,102385,Polikarpova; Nadezhda,0,0,0,0
1668151919406,CSE 240A,A00,102386,Pannuto; Patrick William,0,0,0,0
1668151919841,CSE 240B,A00,102387,Zhao; Jishen,0,0,0,0
1668151920267,CSE 241A,A00,106406,Kang; Mingu,0,0,0,0
1668151920690,CSE 249B,A00,102388,Kahng; Andrew Byun,0,0,8,8
1668151921115,CSE 251B,A01,102392,Cottrell; Garrison W,0,0,0,0
1668151921115,CSE 251B,A02,102393,Cottrell; Garrison W,0,0,0,0
1668151921538,CSE 252B,A00,102394,Ochoa; Benjamin Lawrence,0,0,0,0
1668151921969,CSE 257,A01,102396,Gao; Sicun,0,0,0,0
1668151922393,CSE 272,A00,102397,Li; Tzumao,0,0,0,0
1668151922819,CSE 274,A00,111323,Chern; Albert Ren-Haur,0,0,0,0
1668151923320,CSE 282,A00,102398,Pevzner; Pavel Arkadjevich,0,0,0,0
1668151923746,CSE 284,A00,114175,Gymrek; Melissa Ann,0,0,0,0
1668151924177,CSE 290,A00,102399,Chandraker; Manmohan Krishna,0,0,0,0
1668151924177,CSE 290,B00,102400,Vaccaro; Kristen Marie,0,0,25,25
1668151924177,CSE 290,C00,102414,Pannuto; Patrick William,0,0,25,25
1668151924177,CSE 290,D00,102427,Pevzner; Pavel Arkadjevich,0,0,0,0
1668151924177,CSE 290,E00,102429,Zhao; Jishen,0,0,0,0
1668151924177,CSE 290,F00,102436,Tullsen; Dean Michael,0,0,0,0
1668151924177,CSE 290,G00,102440,Christensen; Henrik I,0,0,20,20
1668151924603,CSE 291,A00,102443,Su; Hao,0,0,0,0
1668151924603,CSE 291,B00,102448,Polikarpova; Nadezhda,0,0,0,0
1668151924603,CSE 291,C00,102453,Vaccaro; Kristen Marie,0,0,0,0
1668151924603,CSE 291,D00,111343,Savage; Stefan,0,0,0,0
1668151924603,CSE 291,E00,116474,Claffy; Kimberly Claire,0,0,0,0
1668151924603,CSE 291,F00,116479,Pasquale; Joseph,0,0,0,0
1668151925041,CSE 293,001,119111,Bafna; Vineet,9999,0,9999,0
1668151925041,CSE 293,002,119118,Bellare; Mihir,9999,0,9999,0
1668151925041,CSE 293,003,119122,Berg-Kirkpatrick; Taylor D,9999,0,9999,0
1668151925041,CSE 293,004,119135,Christensen; Henrik I,9999,0,9999,0
1668151925041,CSE 293,005,119142,Cottrell; Garrison W,9999,0,9999,0
1668151925041,CSE 293,006,119146,Deutsch; Alin Bernard,9999,0,9999,0
1668151925041,CSE 293,007,119159,Esmaeilzadeh; Hadi,9999,0,9999,0
1668151925041,CSE 293,008,119166,Freund; Yoav,9999,0,9999,0
1668151925041,CSE 293,009,119170,Griswold; William G.,9999,0,9999,0
1668151925041,CSE 293,010,119183,Gymrek; Melissa Ann,9999,0,9999,0
1668151925041,CSE 293,011,119190,Heninger; Nadia A,9999,0,9999,0
1668151925041,CSE 293,012,119230,Impagliazzo; Russell,9999,0,9999,0
1668151925041,CSE 293,013,119232,Jhala; Ranjit,9999,0,9999,0
1668151925041,CSE 293,014,119233,Kahng; Andrew Byun,9999,0,9999,0
1668151925041,CSE 293,015,119298,Kane; Daniel Mertz,9999,0,9999,0
1668151925041,CSE 293,016,119299,Kriegman; David J,9999,0,9999,0
1668151925041,CSE 293,017,119300,Kumar; Arun Kumar,9999,0,9999,0
1668151925041,CSE 293,018,119301,Lerner; Sorin,9999,0,9999,0
1668151925041,CSE 293,019,119302,Lovett; Shachar,9999,0,9999,0
1668151925041,CSE 293,020,119303,McAuley; Julian John,9999,0,9999,0
1668151925041,CSE 293,021,119304,Micciancio; Daniele,9999,0,9999,0
1668151925041,CSE 293,022,119367,Orailoglu; Alex,9999,0,9999,0
1668151925041,CSE 293,023,119382,Paturi; Ramamohan,9999,0,9999,0
1668151925041,CSE 293,024,119404,Polikarpova; Nadezhda,9999,0,9999,0
1668151925041,CSE 293,025,119406,Politz; Joseph Gibbs,9999,0,9999,0
1668151925041,CSE 293,026,119411,Porter; George M,9999,0,9999,0
1668151925041,CSE 293,027,119414,Porter; Leonard Emerson,9999,0,9999,0
1668151925041,CSE 293,028,119416,Ramamoorthi; Ravi,9999,0,9999,0
1668151925041,CSE 293,029,119417,Sahoo; Debashis,9999,0,9999,0
1668151925041,CSE 293,030,119420,Saul; Lawrence,9999,0,9999,0
1668151925041,CSE 293,031,119421,Savage; Stefan,9999,0,9999,0
1668151925041,CSE 293,032,119425,Schulze; Jurgen P.,9999,0,9999,0
1668151925041,CSE 293,033,119426,Snoeren; Alex C.,9999,0,9999,0
1668151925041,CSE 293,034,119428,Shang; Jingbo,9999,0,9999,0
1668151925041,CSE 293,035,119430,Stefan; Deian,9999,0,9999,0
1668151925041,CSE 293,036,119431,Su; Hao,9999,0,9999,0
1668151925041,CSE 293,037,119433,Swanson; Steven James,9999,0,9999,0
1668151925041,CSE 293,038,119435,Tullsen; Dean Michael,9999,0,9999,0
1668151925041,CSE 293,039,119483,Voelker; Geoffrey M.,9999,0,9999,0
1668151925041,CSE 293,040,119537,Zhao; Jishen,9999,0,9999,0
1668151925041,CSE 293,041,119538,Zhou; Yuan-Yuan,9999,0,9999,0
1668151925041,CSE 293,042,119539,Gao; Sicun,9999,0,9999,0
1668151925041,CSE 293,043,119540,Weibel; Nadir,9999,0,9999,0
1668151925041,CSE 293,044,119541,Gupta; Rajesh K.,9999,0,9999,0
1668151925041,CSE 293,045,126410,Vaccaro; Kristen Marie,9999,0,9999,0
1668151925041,CSE 293,046,126411,Klemke; Richard,9999,0,9999,0
1668151925469,CSE 294,A00,102459,Voelker; Geoffrey M.,0,0,0,0
1668151925469,CSE 294,B00,111322,Orailoglu; Alex,0,0,0,0
1668151925894,DSE 201,A00,096914,Deutsch; Alin Bernard,30,0,30,0
1668151926330,DSE 210,A00,096915,Dasgupta; Sanjoy,30,0,30,0
1668151926756,DSE 260A,A00,096916,Altintas De Callaf; Ilkay,30,0,30,0
1668151927185,ECE 200,001,103586,Antipa; Nicholas A,9999,0,9999,0
1668151927185,ECE 200,002,103587,Atanasov; Nikolay A.,9999,0,9999,0
1668151927185,ECE 200,003,103588,Bharadia; Dinesh,9999,0,9999,0
1668151927185,ECE 200,004,103589,Cheng; Chung Kuan,9999,0,9999,0
1668151927185,ECE 200,005,103590,Cosman; Pamela C.,9999,0,9999,0
1668151927185,ECE 200,006,103591,Dayeh; Shadi Ahmad,9999,0,9999,0
1668151927185,ECE 200,007,103592,Fainman; Yeshaiahu,9999,0,9999,0
1668151927185,ECE 200,008,103593,Ford; Joseph Earl,9999,0,9999,0
1668151927185,ECE 200,009,103594,Franceschetti; Massimo,9999,0,9999,0
1668151927185,ECE 200,010,103595,Fullerton; Eric E,9999,0,9999,0
1668151927185,ECE 200,011,103596,Galton; Ian A,9999,0,9999,0
1668151927185,ECE 200,012,103597,Gilja; Vikash,9999,0,9999,0
1668151927185,ECE 200,013,103598,Hall; Drew A.,9999,0,9999,0
1668151927185,ECE 200,014,103599,Hsueh; Tzu-Chien,9999,0,9999,0
1668151927185,ECE 200,015,103600,Javidi; Tara,9999,0,9999,0
1668151927185,ECE 200,016,103601,Kahng; Andrew Byun,9999,0,9999,0
1668151927185,ECE 200,017,103602,Kim; Young-Han,9999,0,9999,0
1668151927185,ECE 200,018,103603,Koushanfar; Farinaz,9999,0,9999,0
1668151927185,ECE 200,019,103604,Kuzum; Duygu,9999,0,9999,0
1668151927185,ECE 200,020,103605,Le; Hanh-Phuc,9999,0,9999,0
1668151927185,ECE 200,021,103606,Lin; Bill,9999,0,9999,0
1668151927185,ECE 200,022,103607,Liu; Zhaowei,9998,0,9999,1
1668151927185,ECE 200,023,103608,Lo; Yu-Hwa,9999,0,9999,0
1668151927185,ECE 200,024,103609,Lomakin; Vitaliy,9999,0,9999,0
1668151927185,ECE 200,025,103610,Mercier; Patrick Philip,9999,0,9999,0
1668151927185,ECE 200,026,103611,Meyer; Florian,9999,0,9999,0
1668151927185,ECE 200,027,103612,Milstein; Laurence B.,9999,0,9999,0
1668151927185,ECE 200,028,103613,Mir Arabbaygi; Siavash,9999,0,9999,0
1668151927185,ECE 200,029,103614,Mookherjea; Shayan,9999,0,9999,0
1668151927185,ECE 200,030,103615,Morris; Karcher William,9999,0,9999,0
1668151927185,ECE 200,031,103616,Ng; Tse Nga,9999,0,9999,0
1668151927185,ECE 200,032,103617,Nguyen; Truong Quang,9999,0,9999,0
1668151927185,ECE 200,033,103618,Nomura; Kenji,9999,0,9999,0
1668151927185,ECE 200,034,103619,Orlitsky; Alon,9999,0,9999,0
1668151927185,ECE 200,035,103620,Pal; Piya,9999,0,9999,0
1668151927185,ECE 200,036,103621,Papen; George C.,9999,0,9999,0
1668151927185,ECE 200,037,103622,Radic; Stojan,9999,0,9999,0
1668151927185,ECE 200,038,103623,Rao; Bhaskar D.,9999,0,9999,0
1668151927185,ECE 200,039,103624,Rao; Ramesh R,9999,0,9999,0
1668151927185,ECE 200,040,103625,Rebeiz; Gabriel,9999,0,9999,0
1668151927185,ECE 200,041,103626,Sanford; John R,9999,0,9999,0
1668151927185,ECE 200,042,103627,Siegel; Paul H.,9999,0,9999,0
1668151927185,ECE 200,043,103628,Sievenpiper; Daniel F.,9999,0,9999,0
1668151927185,ECE 200,044,103629,Sworder; David D.,9999,0,9999,0
1668151927185,ECE 200,045,103630,Taur; Yuan,9999,0,9999,0
1668151927185,ECE 200,046,103631,Touri; Behrouz,9999,0,9999,0
1668151927185,ECE 200,047,103632,Trivedi; Mohan M.,9999,0,9999,0
1668151927185,ECE 200,048,103633,Vasconcelos; Nuno,9999,0,9999,0
1668151927185,ECE 200,049,103634,Wang; Xiaolong,9999,0,9999,0
1668151927185,ECE 200,050,103635,Xie; Pengtao,9999,0,9999,0
1668151927185,ECE 200,051,103636,Yip; Michael,9999,0,9999,0
1668151927185,ECE 200,052,103637,Zeger; Kenneth A.,999,0,999,0
1668151927185,ECE 200,053,103638,Zhang; Xinyu,9999,0,9999,0
1668151927185,ECE 200,054,103639,Turakhia; Yatish Girish,9999,0,9999,0
1668151927185,ECE 200,055,103640,Kang; Mingu,9999,0,9999,0
1668151927185,ECE 200,056,103641,Shi; Yuanyuan,9999,0,9999,0
1668151927185,ECE 200,057,103642,Wang; Edward Jay,9999,0,9999,0
1668151927185,ECE 200,058,103643,Zheng; Yang,9999,0,9999,0
1668151927620,ECE 202,A00,103644,Kuzum; Duygu,0,0,0,0
1668151928052,ECE 212BN,A00,103646,Ng; Tse Nga,0,0,0,0
1668151928476,ECE 221,A00,111493,Staff,0,0,0,0
1668151928907,ECE 222B,A00,103647,Lomakin; Vitaliy,0,0,0,0
1668151929330,ECE 230B,A00,103648,Taur; Yuan,0,0,0,0
1668151929752,ECE 238B,A00,103649,Garay; Javier,0,0,0,0
1668151930177,ECE 240B,A00,112900,Fainman; Yeshaiahu,0,0,0,0
1668151930599,ECE 247A,A00,103650,Jokerst; Jesse Vincent,0,0,0,0
1668151931031,ECE 247B,A00,103651,Wang; Joseph,0,0,0,0
1668151931455,ECE 250,A00,103652,Siegel; Paul H.,0,0,0,0
1668151931881,ECE 251A,A00,103654,Rao; Bhaskar D.,0,0,0,0
1668151932305,ECE 257B,A00,103655,Bharadia; Dinesh,0,0,0,0
1668151932731,ECE 258A,A00,103656,Milstein; Laurence B.,0,0,0,0
1668151933153,ECE 260B,A00,103658,Kang; Mingu,0,0,0,0
1668151933577,ECE 264A,A00,103659,Galton; Ian A,0,0,0,0
1668151933999,ECE 265A,A00,103661,Gudem; Prasad S.S.,0,0,0,0
1668151934423,ECE 265D,A00,103662,Gudem; Prasad S.S.,0,0,0,0
1668151934846,ECE 268,A00,103663,Koushanfar; Farinaz,0,0,0,0
1668151935273,ECE 269,A01,103665,Pal; Piya,0,0,0,0
1668151935697,ECE 271B,A00,103666,Vasconcelos; Manuela,0,0,0,0
1668151936120,ECE 276A,A00,103667,Atanasov; Nikolay A.,0,0,0,0
1668151936545,ECE 277,A00,103668,An; Cheolhong,0,0,0,0
1668151936967,ECE 279,A00,117947,Hall; Drew A.,0,0,0,0
1668151937814,ECE 283,A00,103670,Hsueh; Tzu-Chien,0,0,0,0
1668151938241,ECE 284,A00,103671,Turakhia; Yatish Girish,0,0,0,0
1668151938665,ECE 285,A00,103672,Zheng; Yang,0,0,0,0
1668151938665,ECE 285,B00,103673,Sworder; David D.,0,0,0,0
1668151939089,ECE 287,A00,103676,Javidi; Tara,0,0,0,0
1668151939513,MATH 200B,A00,098023,Salehi Golsefidy; Alireza,12,0,15,3
1668151939938,MATH 202B,A00,098024,Rhoades; Brendon Patrick,9,0,15,6
1668151940360,MATH 203B,A00,098025,Oprea; Dragos N.,10,0,15,5
1668151940788,MATH 204B,A00,098026,Sorensen; Claus M,13,0,15,2
1668151941213,MATH 208,A00,098027,Izadi; Elham,7,0,10,3
1668151941637,MATH 209,A00,098028,Pollack; Aaron,10,0,10,0
1668151942067,MATH 211A,A00,112919,Rogalski; Daniel,9,0,10,1
1668151942493,MATH 211B,A00,112920,Seward; Brandon M.,9,0,10,1
1668151942918,MATH 218,A00,098029,Li; Bo,10,0,10,0
1668151943344,MATH 220B,A00,098030,Novak; Jonathan I,11,0,15,4
1668151943768,MATH 221A,A00,098031,Ebenfelt; Peter F,13,0,15,2
1668151944192,MATH 231B,A00,098032,Zlatos; Andrej,12,0,15,3
1668151944615,MATH 240B,A00,098033,Ni; Lei,9,0,15,6
1668151945041,MATH 243,A00,098034,Jekel; David Andrew,10,0,10,0
1668151945465,MATH 245A,A00,098035,Nie; Jiawang,0,0,15,16
1668151945898,MATH 248,A00,098036,Bejenaru; Ioan,10,0,10,0
1668151946321,MATH 250B,A00,098037,Spolaor; Luca,14,0,15,1
1668151946747,MATH 258,A00,098038,Ni; Lei,10,0,10,0
1668151947169,MATH 264B,A00,098041,Rhoades; Brendon Patrick,9,0,15,6
1668151947615,MATH 268,A00,098042,Buss; Samuel R,10,0,10,0
1668151948042,MATH 269,A00,098043,Rhoades; Brendon Patrick,10,0,10,0
1668151948468,MATH 270B,A00,098044,Li; Bo,10,0,15,5
1668151948893,MATH 272B,A00,098045,Holst; Michael J,13,0,15,2
1668151949322,MATH 273A,A00,098046,Tian; Xiaochuan,10,0,15,5
1668151949751,MATH 275,A01,098048,Tian; Xiaochuan,6,0,10,4
1668151950176,MATH 278A,A00,098049,Holst; Michael J,8,0,10,2
1668151950600,MATH 278B,A00,098050,Cloninger; Alexander,10,0,10,0
1668151951024,MATH 278C,A00,098051,Nie; Jiawang,7,0,10,3
1668151951449,MATH 280B,A00,098052,Zheng; Tianyi,10,0,15,5
1668151951871,MATH 281B,A00,098053,Bradic; Jelena,2,0,15,13
1668151952293,MATH 282B,A00,098054,Arias-Castro; Ery,0,0,15,15
1668151952716,MATH 285,A00,098055,Fitzsimmons; Patrick J,0,0,15,17
1668151953141,MATH 287B,A00,098056,Arias-Castro; Ery,2,0,15,13
1668151953564,MATH 288,A00,098057,Agarwal; Pooja,9,0,10,1
1668151953564,MATH 288,B00,098058,Zhang; Danna,8,0,10,2
1668151953564,MATH 288,C00,098059,Williams; Ruth J,10,0,10,0
1668151953988,MATH 290B,A00,098060,Roberts; Justin Deritter,13,0,15,2
1668151954411,MATH 292,A00,098061,Belmont; Eva Kinoshita,10,0,10,0
1668151954841,MATH 295,A00,098062,Suk; Andrew Hoon,48,0,50,2
1668151955268,MATH 296,A00,098063,Novak; Jonathan I,20,0,20,0
1668151955695,MATH 297,001,098064,Gamst; Anthony Collins,9997,0,9999,2
1668152454958,COGS 205,A00,101395,Chiba; Andrea,19,0,20,1
1668152455383,COGS 210B,001,101404,Greene; Deanna Jacquelyn,9998,0,9999,1
1668152455383,COGS 210B,002,101417,Xia; Haijun,9999,0,9999,0
1668152455383,COGS 210B,003,101422,Nitz; Douglas A.,9999,0,9999,0
1668152455383,COGS 210B,004,101423,Hollan; James D.,9998,0,9999,1
1668152455383,COGS 210B,005,101424,Deak; Gedeon O.,9998,0,9999,1
1668152455383,COGS 210B,006,101425,Rossano; Federico,9999,0,9999,0
1668152455808,COGS 211B,A00,101427,Coulson; Seana M,9996,0,9999,3
1668152456235,COGS 220,A00,101428,Hollan; James D.,0,0,25,25
1668152456659,COGS 229,A00,101429,Dow; Steven P,18,0,25,7
1668152457082,COGS 230,A00,101430,Klemmer; Scott R,12,0,17,5
1668152457503,COGS 234,A00,101431,Xia; Haijun,3,0,25,22
1668152457927,COGS 260,A00,101432,Kiyonaga; Anastasia,20,0,25,5
1668152457927,COGS 260,B00,101433,Kirsh; David Joel,16,0,25,9
1668152458350,CSE 202,A00,102371,Impagliazzo; Russell,0,0,0,0
1668152458775,CSE 203B,A01,102373,Cheng; Chung Kuan,0,0,0,0
1668152459199,CSE 208,A00,102374,Micciancio; Daniele,0,0,0,0
1668152459621,CSE 209A,A00,112895,Impagliazzo; Russell,0,0,15,15
1668152460052,CSE 209B,A00,108005,Bellare; Mihir,0,0,0,0
1668152460477,CSE 210,A00,113163,Coblenz; Michael J,0,0,0,0
1668152460904,CSE 219,A00,106111,Dow; Steven P,0,0,20,20
1668152461328,CSE 221,A00,102376,Voelker; Geoffrey M.,0,0,0,0
1668152461750,CSE 224,A01,102378,Porter; George M,0,0,0,0
1668152462183,CSE 229A,A00,102379,Savage; Stefan,0,0,0,0
1668152462607,CSE 229C,A00,102380,Munyaka; Imani N. S.,0,0,0,0
1668152463031,CSE 232B,A00,102382,Deutsch; Alin Bernard,0,0,0,0
1668152463453,CSE 234,A01,112904,Kumar; Arun Kumar,0,0,0,0
1668152463875,CSE 237A,A00,102383,Rosing; Tajana Simunic,0,0,0,0
1668152464299,CSE 239A,A00,102384,Deutsch; Alin Bernard,0,0,0,0
1668152464724,CSE 239B,A00,102385,Polikarpova; Nadezhda,0,0,0,0
1668152465152,CSE 240A,A00,102386,Pannuto; Patrick William,0,0,0,0
1668152465579,CSE 240B,A00,102387,Zhao; Jishen,0,0,0,0
1668152466014,CSE 241A,A00,106406,Kang; Mingu,0,0,0,0
1668152466438,CSE 249B,A00,102388,Kahng; Andrew Byun,0,0,8,8
1668152466862,CSE 251B,A01,102392,Cottrell; Garrison W,0,0,0,0
1668152466862,CSE 251B,A02,102393,Cottrell; Garrison W,0,0,0,0
1668152467285,CSE 252B,A00,102394,Ochoa; Benjamin Lawrence,0,0,0,0
1668152467709,CSE 257,A01,102396,Gao; Sicun,0,0,0,0
1668152468132,CSE 272,A00,102397,Li; Tzumao,0,0,0,0
1668152468554,CSE 274,A00,111323,Chern; Albert Ren-Haur,0,0,0,0
1668152468985,CSE 282,A00,102398,Pevzner; Pavel Arkadjevich,0,0,0,0
1668152469408,CSE 284,A00,114175,Gymrek; Melissa Ann,0,0,0,0
1668152469834,CSE 290,A00,102399,Chandraker; Manmohan Krishna,0,0,0,0
1668152469834,CSE 290,B00,102400,Vaccaro; Kristen Marie,0,0,25,25
1668152469834,CSE 290,C00,102414,Pannuto; Patrick William,0,0,25,25
1668152469834,CSE 290,D00,102427,Pevzner; Pavel Arkadjevich,0,0,0,0
1668152469834,CSE 290,E00,102429,Zhao; Jishen,0,0,0,0
1668152469834,CSE 290,F00,102436,Tullsen; Dean Michael,0,0,0,0
1668152469834,CSE 290,G00,102440,Christensen; Henrik I,0,0,20,20
1668152470259,CSE 291,A00,102443,Su; Hao,0,0,0,0
1668152470259,CSE 291,B00,102448,Polikarpova; Nadezhda,0,0,0,0
1668152470259,CSE 291,C00,102453,Vaccaro; Kristen Marie,0,0,0,0
1668152470259,CSE 291,D00,111343,Savage; Stefan,0,0,0,0
1668152470259,CSE 291,E00,116474,Claffy; Kimberly Claire,0,0,0,0
1668152470259,CSE 291,F00,116479,Pasquale; Joseph,0,0,0,0
1668152470692,CSE 293,001,119111,Bafna; Vineet,9999,0,9999,0
1668152470692,CSE 293,002,119118,Bellare; Mihir,9999,0,9999,0
1668152470692,CSE 293,003,119122,Berg-Kirkpatrick; Taylor D,9999,0,9999,0
1668152470692,CSE 293,004,119135,Christensen; Henrik I,9999,0,9999,0
1668152470692,CSE 293,005,119142,Cottrell; Garrison W,9999,0,9999,0
1668152470692,CSE 293,006,119146,Deutsch; Alin Bernard,9999,0,9999,0
1668152470692,CSE 293,007,119159,Esmaeilzadeh; Hadi,9999,0,9999,0
1668152470692,CSE 293,008,119166,Freund; Yoav,9999,0,9999,0
1668152470692,CSE 293,009,119170,Griswold; William G.,9999,0,9999,0
1668152470692,CSE 293,010,119183,Gymrek; Melissa Ann,9999,0,9999,0
1668152470692,CSE 293,011,119190,Heninger; Nadia A,9999,0,9999,0
1668152470692,CSE 293,012,119230,Impagliazzo; Russell,9999,0,9999,0
1668152470692,CSE 293,013,119232,Jhala; Ranjit,9999,0,9999,0
1668152470692,CSE 293,014,119233,Kahng; Andrew Byun,9999,0,9999,0
1668152470692,CSE 293,015,119298,Kane; Daniel Mertz,9999,0,9999,0
1668152470692,CSE 293,016,119299,Kriegman; David J,9999,0,9999,0
1668152470692,CSE 293,017,119300,Kumar; Arun Kumar,9999,0,9999,0
1668152470692,CSE 293,018,119301,Lerner; Sorin,9999,0,9999,0
1668152470692,CSE 293,019,119302,Lovett; Shachar,9999,0,9999,0
1668152470692,CSE 293,020,119303,McAuley; Julian John,9999,0,9999,0
1668152470692,CSE 293,021,119304,Micciancio; Daniele,9999,0,9999,0
1668152470692,CSE 293,022,119367,Orailoglu; Alex,9999,0,9999,0
1668152470692,CSE 293,023,119382,Paturi; Ramamohan,9999,0,9999,0
1668152470692,CSE 293,024,119404,Polikarpova; Nadezhda,9999,0,9999,0
1668152470692,CSE 293,025,119406,Politz; Joseph Gibbs,9999,0,9999,0
1668152470692,CSE 293,026,119411,Porter; George M,9999,0,9999,0
1668152470692,CSE 293,027,119414,Porter; Leonard Emerson,9999,0,9999,0
1668152470692,CSE 293,028,119416,Ramamoorthi; Ravi,9999,0,9999,0
1668152470692,CSE 293,029,119417,Sahoo; Debashis,9999,0,9999,0
1668152470692,CSE 293,030,119420,Saul; Lawrence,9999,0,9999,0
1668152470692,CSE 293,031,119421,Savage; Stefan,9999,0,9999,0
1668152470692,CSE 293,032,119425,Schulze; Jurgen P.,9999,0,9999,0
1668152470692,CSE 293,033,119426,Snoeren; Alex C.,9999,0,9999,0
1668152470692,CSE 293,034,119428,Shang; Jingbo,9999,0,9999,0
1668152470692,CSE 293,035,119430,Stefan; Deian,9999,0,9999,0
1668152470692,CSE 293,036,119431,Su; Hao,9999,0,9999,0
1668152470692,CSE 293,037,119433,Swanson; Steven James,9999,0,9999,0
1668152470692,CSE 293,038,119435,Tullsen; Dean Michael,9999,0,9999,0
1668152470692,CSE 293,039,119483,Voelker; Geoffrey M.,9999,0,9999,0
1668152470692,CSE 293,040,119537,Zhao; Jishen,9999,0,9999,0
1668152470692,CSE 293,041,119538,Zhou; Yuan-Yuan,9999,0,9999,0
1668152470692,CSE 293,042,119539,Gao; Sicun,9999,0,9999,0
1668152470692,CSE 293,043,119540,Weibel; Nadir,9999,0,9999,0
1668152470692,CSE 293,044,119541,Gupta; Rajesh K.,9999,0,9999,0
1668152470692,CSE 293,045,126410,Vaccaro; Kristen Marie,9999,0,9999,0
1668152470692,CSE 293,046,126411,Klemke; Richard,9999,0,9999,0
1668152471121,CSE 294,A00,102459,Voelker; Geoffrey M.,0,0,0,0
1668152471121,CSE 294,B00,111322,Orailoglu; Alex,0,0,0,0
1668152471543,DSE 201,A00,096914,Deutsch; Alin Bernard,30,0,30,0
1668152471967,DSE 210,A00,096915,Dasgupta; Sanjoy,30,0,30,0
1668152472401,DSE 260A,A00,096916,Altintas De Callaf; Ilkay,30,0,30,0
1668152472837,ECE 200,001,103586,Antipa; Nicholas A,9999,0,9999,0
1668152472837,ECE 200,002,103587,Atanasov; Nikolay A.,9999,0,9999,0
1668152472837,ECE 200,003,103588,Bharadia; Dinesh,9999,0,9999,0
1668152472837,ECE 200,004,103589,Cheng; Chung Kuan,9999,0,9999,0
1668152472837,ECE 200,005,103590,Cosman; Pamela C.,9999,0,9999,0
1668152472837,ECE 200,006,103591,Dayeh; Shadi Ahmad,9999,0,9999,0
1668152472837,ECE 200,007,103592,Fainman; Yeshaiahu,9999,0,9999,0
1668152472837,ECE 200,008,103593,Ford; Joseph Earl,9999,0,9999,0
1668152472837,ECE 200,009,103594,Franceschetti; Massimo,9999,0,9999,0
1668152472837,ECE 200,010,103595,Fullerton; Eric E,9999,0,9999,0
1668152472837,ECE 200,011,103596,Galton; Ian A,9999,0,9999,0
1668152472837,ECE 200,012,103597,Gilja; Vikash,9999,0,9999,0
1668152472837,ECE 200,013,103598,Hall; Drew A.,9999,0,9999,0
1668152472837,ECE 200,014,103599,Hsueh; Tzu-Chien,9999,0,9999,0
1668152472837,ECE 200,015,103600,Javidi; Tara,9999,0,9999,0
1668152472837,ECE 200,016,103601,Kahng; Andrew Byun,9999,0,9999,0
1668152472837,ECE 200,017,103602,Kim; Young-Han,9999,0,9999,0
1668152472837,ECE 200,018,103603,Koushanfar; Farinaz,9999,0,9999,0
1668152472837,ECE 200,019,103604,Kuzum; Duygu,9999,0,9999,0
1668152472837,ECE 200,020,103605,Le; Hanh-Phuc,9999,0,9999,0
1668152472837,ECE 200,021,103606,Lin; Bill,9999,0,9999,0
1668152472837,ECE 200,022,103607,Liu; Zhaowei,9998,0,9999,1
1668152472837,ECE 200,023,103608,Lo; Yu-Hwa,9999,0,9999,0
1668152472837,ECE 200,024,103609,Lomakin; Vitaliy,9999,0,9999,0
1668152472837,ECE 200,025,103610,Mercier; Patrick Philip,9999,0,9999,0
1668152472837,ECE 200,026,103611,Meyer; Florian,9999,0,9999,0
1668152472837,ECE 200,027,103612,Milstein; Laurence B.,9999,0,9999,0
1668152472837,ECE 200,028,103613,Mir Arabbaygi; Siavash,9999,0,9999,0
1668152472837,ECE 200,029,103614,Mookherjea; Shayan,9999,0,9999,0
1668152472837,ECE 200,030,103615,Morris; Karcher William,9999,0,9999,0
1668152472837,ECE 200,031,103616,Ng; Tse Nga,9999,0,9999,0
1668152472837,ECE 200,032,103617,Nguyen; Truong Quang,9999,0,9999,0
1668152472837,ECE 200,033,103618,Nomura; Kenji,9999,0,9999,0
1668152472837,ECE 200,034,103619,Orlitsky; Alon,9999,0,9999,0
1668152472837,ECE 200,035,103620,Pal; Piya,9999,0,9999,0
1668152472837,ECE 200,036,103621,Papen; George C.,9999,0,9999,0
1668152472837,ECE 200,037,103622,Radic; Stojan,9999,0,9999,0
1668152472837,ECE 200,038,103623,Rao; Bhaskar D.,9999,0,9999,0
1668152472837,ECE 200,039,103624,Rao; Ramesh R,9999,0,9999,0
1668152472837,ECE 200,040,103625,Rebeiz; Gabriel,9999,0,9999,0
1668152472837,ECE 200,041,103626,Sanford; John R,9999,0,9999,0
1668152472837,ECE 200,042,103627,Siegel; Paul H.,9999,0,9999,0
1668152472837,ECE 200,043,103628,Sievenpiper; Daniel F.,9999,0,9999,0
1668152472837,ECE 200,044,103629,Sworder; David D.,9999,0,9999,0
1668152472837,ECE 200,045,103630,Taur; Yuan,9999,0,9999,0
1668152472837,ECE 200,046,103631,Touri; Behrouz,9999,0,9999,0
1668152472837,ECE 200,047,103632,Trivedi; Mohan M.,9999,0,9999,0
1668152472837,ECE 200,048,103633,Vasconcelos; Nuno,9999,0,9999,0
1668152472837,ECE 200,049,103634,Wang; Xiaolong,9999,0,9999,0
1668152472837,ECE 200,050,103635,Xie; Pengtao,9999,0,9999,0
1668152472837,ECE 200,051,103636,Yip; Michael,9999,0,9999,0
1668152472837,ECE 200,052,103637,Zeger; Kenneth A.,999,0,999,0
1668152472837,ECE 200,053,103638,Zhang; Xinyu,9999,0,9999,0
1668152472837,ECE 200,054,103639,Turakhia; Yatish Girish,9999,0,9999,0
1668152472837,ECE 200,055,103640,Kang; Mingu,9999,0,9999,0
1668152472837,ECE 200,056,103641,Shi; Yuanyuan,9999,0,9999,0
1668152472837,ECE 200,057,103642,Wang; Edward Jay,9999,0,9999,0
1668152472837,ECE 200,058,103643,Zheng; Yang,9999,0,9999,0
1668152473262,ECE 202,A00,103644,Kuzum; Duygu,0,0,0,0
1668152473685,ECE 212BN,A00,103646,Ng; Tse Nga,0,0,0,0
1668152474111,ECE 221,A00,111493,Staff,0,0,0,0
1668152474535,ECE 222B,A00,103647,Lomakin; Vitaliy,0,0,0,0
1668152474960,ECE 230B,A00,103648,Taur; Yuan,0,0,0,0
1668152475385,ECE 238B,A00,103649,Garay; Javier,0,0,0,0
1668152475806,ECE 240B,A00,112900,Fainman; Yeshaiahu,0,0,0,0
1668152476235,ECE 247A,A00,103650,Jokerst; Jesse Vincent,0,0,0,0
1668152476658,ECE 247B,A00,103651,Wang; Joseph,0,0,0,0
1668152477088,ECE 250,A00,103652,Siegel; Paul H.,0,0,0,0
1668152477513,ECE 251A,A00,103654,Rao; Bhaskar D.,0,0,0,0
1668152477939,ECE 257B,A00,103655,Bharadia; Dinesh,0,0,0,0
1668152478363,ECE 258A,A00,103656,Milstein; Laurence B.,0,0,0,0
1668152478785,ECE 260B,A00,103658,Kang; Mingu,0,0,0,0
1668152479210,ECE 264A,A00,103659,Galton; Ian A,0,0,0,0
1668152479633,ECE 265A,A00,103661,Gudem; Prasad S.S.,0,0,0,0
1668152480058,ECE 265D,A00,103662,Gudem; Prasad S.S.,0,0,0,0
1668152480483,ECE 268,A00,103663,Koushanfar; Farinaz,0,0,0,0
1668152480912,ECE 269,A01,103665,Pal; Piya,0,0,0,0
1668152481338,ECE 271B,A00,103666,Vasconcelos; Manuela,0,0,0,0
1668152481762,ECE 276A,A00,103667,Atanasov; Nikolay A.,0,0,0,0
1668152482186,ECE 277,A00,103668,An; Cheolhong,0,0,0,0
1668152482610,ECE 279,A00,117947,Hall; Drew A.,0,0,0,0
1668152483458,ECE 283,A00,103670,Hsueh; Tzu-Chien,0,0,0,0
1668152483896,ECE 284,A00,103671,Turakhia; Yatish Girish,0,0,0,0
1668152484322,ECE 285,A00,103672,Zheng; Yang,0,0,0,0
1668152484322,ECE 285,B00,103673,Sworder; David D.,0,0,0,0
1668152484748,ECE 287,A00,103676,Javidi; Tara,0,0,0,0
1668152485175,MATH 200B,A00,098023,Salehi Golsefidy; Alireza,12,0,15,3
1668152485699,MATH 202B,A00,098024,Rhoades; Brendon Patrick,9,0,15,6
1668152486130,MATH 203B,A00,098025,Oprea; Dragos N.,10,0,15,5
1668152486554,MATH 204B,A00,098026,Sorensen; Claus M,13,0,15,2
1668152486981,MATH 208,A00,098027,Izadi; Elham,7,0,10,3
1668152487405,MATH 209,A00,098028,Pollack; Aaron,10,0,10,0
1668152487832,MATH 211A,A00,112919,Rogalski; Daniel,9,0,10,1
1668152488263,MATH 211B,A00,112920,Seward; Brandon M.,9,0,10,1
1668152488695,MATH 218,A00,098029,Li; Bo,10,0,10,0
1668152489118,MATH 220B,A00,098030,Novak; Jonathan I,11,0,15,4
1668152489542,MATH 221A,A00,098031,Ebenfelt; Peter F,13,0,15,2
1668152489965,MATH 231B,A00,098032,Zlatos; Andrej,12,0,15,3
1668152490390,MATH 240B,A00,098033,Ni; Lei,9,0,15,6
1668152490814,MATH 243,A00,098034,Jekel; David Andrew,10,0,10,0
1668152491238,MATH 245A,A00,098035,Nie; Jiawang,0,0,15,16
1668152491660,MATH 248,A00,098036,Bejenaru; Ioan,10,0,10,0
1668152492089,MATH 250B,A00,098037,Spolaor; Luca,14,0,15,1
1668152492511,MATH 258,A00,098038,Ni; Lei,10,0,10,0
1668152492935,MATH 264B,A00,098041,Rhoades; Brendon Patrick,9,0,15,6
1668152493360,MATH 268,A00,098042,Buss; Samuel R,10,0,10,0
1668152493788,MATH 269,A00,098043,Rhoades; Brendon Patrick,10,0,10,0
1668152494211,MATH 270B,A00,098044,Li; Bo,10,0,15,5
1668152494638,MATH 272B,A00,098045,Holst; Michael J,13,0,15,2
1668152495063,MATH 273A,A00,098046,Tian; Xiaochuan,10,0,15,5
1668152495492,MATH 275,A01,098048,Tian; Xiaochuan,6,0,10,4
1668152495930,MATH 278A,A00,098049,Holst; Michael J,8,0,10,2
1668152496353,MATH 278B,A00,098050,Cloninger; Alexander,10,0,10,0
1668152496779,MATH 278C,A00,098051,Nie; Jiawang,7,0,10,3
1668152497201,MATH 280B,A00,098052,Zheng; Tianyi,10,0,15,5
1668152497634,MATH 281B,A00,098053,Bradic; Jelena,2,0,15,13
1668152498060,MATH 282B,A00,098054,Arias-Castro; Ery,0,0,15,15
1668152498485,MATH 285,A00,098055,Fitzsimmons; Patrick J,0,0,15,17
1668152498907,MATH 287B,A00,098056,Arias-Castro; Ery,2,0,15,13
1668152499331,MATH 288,A00,098057,Agarwal; Pooja,9,0,10,1
1668152499331,MATH 288,B00,098058,Zhang; Danna,8,0,10,2
1668152499331,MATH 288,C00,098059,Williams; Ruth J,10,0,10,0
1668152499755,MATH 290B,A00,098060,Roberts; Justin Deritter,13,0,15,2
1668152500181,MATH 292,A00,098061,Belmont; Eva Kinoshita,10,0,10,0
1668152500603,MATH 295,A00,098062,Suk; Andrew Hoon,48,0,50,2
1668152501026,MATH 296,A00,098063,Novak; Jonathan I,20,0,20,0
1668152501450,MATH 297,001,098064,Gamst; Anthony Collins,9997,0,9999,2
1668153000122,COGS 205,A00,101395,Chiba; Andrea,19,0,20,1
1668153000551,COGS 210B,001,101404,Greene; Deanna Jacquelyn,9998,0,9999,1
1668153000551,COGS 210B,002,101417,Xia; Haijun,9999,0,9999,0
1668153000551,COGS 210B,003,101422,Nitz; Douglas A.,9999,0,9999,0
1668153000551,COGS 210B,004,101423,Hollan; James D.,9998,0,9999,1
1668153000551,COGS 210B,005,101424,Deak; Gedeon O.,9998,0,9999,1
1668153000551,COGS 210B,006,101425,Rossano; Federico,9999,0,9999,0
1668153000973,COGS 211B,A00,101427,Coulson; Seana M,9996,0,9999,3
1668153001397,COGS 220,A00,101428,Hollan; James D.,0,0,25,25
1668153001823,COGS 229,A00,101429,Dow; Steven P,18,0,25,7
1668153002252,COGS 230,A00,101430,Klemmer; Scott R,12,0,17,5
1668153002676,COGS 234,A00,101431,Xia; Haijun,3,0,25,22
1668153003099,COGS 260,A00,101432,Kiyonaga; Anastasia,20,0,25,5
1668153003099,COGS 260,B00,101433,Kirsh; David Joel,16,0,25,9
1668153003523,CSE 202,A00,102371,Impagliazzo; Russell,0,0,0,0
1668153003948,CSE 203B,A01,102373,Cheng; Chung Kuan,0,0,0,0
1668153004466,CSE 208,A00,102374,Micciancio; Daniele,0,0,0,0
1668153004889,CSE 209A,A00,112895,Impagliazzo; Russell,0,0,15,15
1668153005313,CSE 209B,A00,108005,Bellare; Mihir,0,0,0,0
1668153005739,CSE 210,A00,113163,Coblenz; Michael J,0,0,0,0
1668153006163,CSE 219,A00,106111,Dow; Steven P,0,0,20,20
1668153006587,CSE 221,A00,102376,Voelker; Geoffrey M.,0,0,0,0
1668153007016,CSE 224,A01,102378,Porter; George M,0,0,0,0
1668153007449,CSE 229A,A00,102379,Savage; Stefan,0,0,0,0
1668153007871,CSE 229C,A00,102380,Munyaka; Imani N. S.,0,0,0,0
1668153008297,CSE 232B,A00,102382,Deutsch; Alin Bernard,0,0,0,0
1668153008723,CSE 234,A01,112904,Kumar; Arun Kumar,0,0,0,0
1668153009147,CSE 237A,A00,102383,Rosing; Tajana Simunic,0,0,0,0
1668153009573,CSE 239A,A00,102384,Deutsch; Alin Bernard,0,0,0,0
1668153010000,CSE 239B,A00,102385,Polikarpova; Nadezhda,0,0,0,0
1668153010426,CSE 240A,A00,102386,Pannuto; Patrick William,0,0,0,0
1668153010853,CSE 240B,A00,102387,Zhao; Jishen,0,0,0,0
1668153011277,CSE 241A,A00,106406,Kang; Mingu,0,0,0,0
1668153011709,CSE 249B,A00,102388,Kahng; Andrew Byun,0,0,8,8
1668153012131,CSE 251B,A01,102392,Cottrell; Garrison W,0,0,0,0
1668153012131,CSE 251B,A02,102393,Cottrell; Garrison W,0,0,0,0
1668153012554,CSE 252B,A00,102394,Ochoa; Benjamin Lawrence,0,0,0,0
1668153012981,CSE 257,A01,102396,Gao; Sicun,0,0,0,0
1668153013405,CSE 272,A00,102397,Li; Tzumao,0,0,0,0
1668153013832,CSE 274,A00,111323,Chern; Albert Ren-Haur,0,0,0,0
1668153014255,CSE 282,A00,102398,Pevzner; Pavel Arkadjevich,0,0,0,0
1668153014682,CSE 284,A00,114175,Gymrek; Melissa Ann,0,0,0,0
1668153015105,CSE 290,A00,102399,Chandraker; Manmohan Krishna,0,0,0,0
1668153015105,CSE 290,B00,102400,Vaccaro; Kristen Marie,0,0,25,25
1668153015105,CSE 290,C00,102414,Pannuto; Patrick William,0,0,25,25
1668153015105,CSE 290,D00,102427,Pevzner; Pavel Arkadjevich,0,0,0,0
1668153015105,CSE 290,E00,102429,Zhao; Jishen,0,0,0,0
1668153015105,CSE 290,F00,102436,Tullsen; Dean Michael,0,0,0,0
1668153015105,CSE 290,G00,102440,Christensen; Henrik I,0,0,20,20
1668153015531,CSE 291,A00,102443,Su; Hao,0,0,0,0
1668153015531,CSE 291,B00,102448,Polikarpova; Nadezhda,0,0,0,0
1668153015531,CSE 291,C00,102453,Vaccaro; Kristen Marie,0,0,0,0
1668153015531,CSE 291,D00,111343,Savage; Stefan,0,0,0,0
1668153015531,CSE 291,E00,116474,Claffy; Kimberly Claire,0,0,0,0
1668153015531,CSE 291,F00,116479,Pasquale; Joseph,0,0,0,0
1668153015957,CSE 293,001,119111,Bafna; Vineet,9999,0,9999,0
1668153015957,CSE 293,002,119118,Bellare; Mihir,9999,0,9999,0
1668153015957,CSE 293,003,119122,Berg-Kirkpatrick; Taylor D,9999,0,9999,0
1668153015957,CSE 293,004,119135,Christensen; Henrik I,9999,0,9999,0
1668153015957,CSE 293,005,119142,Cottrell; Garrison W,9999,0,9999,0
1668153015957,CSE 293,006,119146,Deutsch; Alin Bernard,9999,0,9999,0
1668153015957,CSE 293,007,119159,Esmaeilzadeh; Hadi,9999,0,9999,0
1668153015957,CSE 293,008,119166,Freund; Yoav,9999,0,9999,0
1668153015957,CSE 293,009,119170,Griswold; William G.,9999,0,9999,0
1668153015957,CSE 293,010,119183,Gymrek; Melissa Ann,9999,0,9999,0
1668153015957,CSE 293,011,119190,Heninger; Nadia A,9999,0,9999,0
1668153015957,CSE 293,012,119230,Impagliazzo; Russell,9999,0,9999,0
1668153015957,CSE 293,013,119232,Jhala; Ranjit,9999,0,9999,0
1668153015957,CSE 293,014,119233,Kahng; Andrew Byun,9999,0,9999,0
1668153015957,CSE 293,015,119298,Kane; Daniel Mertz,9999,0,9999,0
1668153015957,CSE 293,016,119299,Kriegman; David J,9999,0,9999,0
1668153015957,CSE 293,017,119300,Kumar; Arun Kumar,9999,0,9999,0
1668153015957,CSE 293,018,119301,Lerner; Sorin,9999,0,9999,0
1668153015957,CSE 293,019,119302,Lovett; Shachar,9999,0,9999,0
1668153015957,CSE 293,020,119303,McAuley; Julian John,9999,0,9999,0
1668153015957,CSE 293,021,119304,Micciancio; Daniele,9999,0,9999,0
1668153015957,CSE 293,022,119367,Orailoglu; Alex,9999,0,9999,0
1668153015957,CSE 293,023,119382,Paturi; Ramamohan,9999,0,9999,0
1668153015957,CSE 293,024,119404,Polikarpova; Nadezhda,9999,0,9999,0
1668153015957,CSE 293,025,119406,Politz; Joseph Gibbs,9999,0,9999,0
1668153015957,CSE 293,026,119411,Porter; George M,9999,0,9999,0
1668153015957,CSE 293,027,119414,Porter; Leonard Emerson,9999,0,9999,0
1668153015957,CSE 293,028,119416,Ramamoorthi; Ravi,9999,0,9999,0
1668153015957,CSE 293,029,119417,Sahoo; Debashis,9999,0,9999,0
1668153015957,CSE 293,030,119420,Saul; Lawrence,9999,0,9999,0
1668153015957,CSE 293,031,119421,Savage; Stefan,9999,0,9999,0
1668153015957,CSE 293,032,119425,Schulze; Jurgen P.,9999,0,9999,0
1668153015957,CSE 293,033,119426,Snoeren; Alex C.,9999,0,9999,0
1668153015957,CSE 293,034,119428,Shang; Jingbo,9999,0,9999,0
1668153015957,CSE 293,035,119430,Stefan; Deian,9999,0,9999,0
1668153015957,CSE 293,036,119431,Su; Hao,9999,0,9999,0
1668153015957,CSE 293,037,119433,Swanson; Steven James,9999,0,9999,0
1668153015957,CSE 293,038,119435,Tullsen; Dean Michael,9999,0,9999,0
1668153015957,CSE 293,039,119483,Voelker; Geoffrey M.,9999,0,9999,0
1668153015957,CSE 293,040,119537,Zhao; Jishen,9999,0,9999,0
1668153015957,CSE 293,041,119538,Zhou; Yuan-Yuan,9999,0,9999,0
1668153015957,CSE 293,042,119539,Gao; Sicun,9999,0,9999,0
1668153015957,CSE 293,043,119540,Weibel; Nadir,9999,0,9999,0
1668153015957,CSE 293,044,119541,Gupta; Rajesh K.,9999,0,9999,0
1668153015957,CSE 293,045,126410,Vaccaro; Kristen Marie,9999,0,9999,0
1668153015957,CSE 293,046,126411,Klemke; Richard,9999,0,9999,0
1668153016383,CSE 294,A00,102459,Voelker; Geoffrey M.,0,0,0,0
1668153016383,CSE 294,B00,111322,Orailoglu; Alex,0,0,0,0
1668153016806,DSE 201,A00,096914,Deutsch; Alin Bernard,30,0,30,0
1668153017231,DSE 210,A00,096915,Dasgupta; Sanjoy,30,0,30,0
1668153017657,DSE 260A,A00,096916,Altintas De Callaf; Ilkay,30,0,30,0
1668153018093,ECE 200,001,103586,Antipa; Nicholas A,9999,0,9999,0
1668153018093,ECE 200,002,103587,Atanasov; Nikolay A.,9999,0,9999,0
1668153018093,ECE 200,003,103588,Bharadia; Dinesh,9999,0,9999,0
1668153018093,ECE 200,004,103589,Cheng; Chung Kuan,9999,0,9999,0
1668153018093,ECE 200,005,103590,Cosman; Pamela C.,9999,0,9999,0
1668153018093,ECE 200,006,103591,Dayeh; Shadi Ahmad,9999,0,9999,0
1668153018093,ECE 200,007,103592,Fainman; Yeshaiahu,9999,0,9999,0
1668153018093,ECE 200,008,103593,Ford; Joseph Earl,9999,0,9999,0
1668153018093,ECE 200,009,103594,Franceschetti; Massimo,9999,0,9999,0
1668153018093,ECE 200,010,103595,Fullerton; Eric E,9999,0,9999,0
1668153018093,ECE 200,011,103596,Galton; Ian A,9999,0,9999,0
1668153018093,ECE 200,012,103597,Gilja; Vikash,9999,0,9999,0
1668153018093,ECE 200,013,103598,Hall; Drew A.,9999,0,9999,0
1668153018093,ECE 200,014,103599,Hsueh; Tzu-Chien,9999,0,9999,0
1668153018093,ECE 200,015,103600,Javidi; Tara,9999,0,9999,0
1668153018093,ECE 200,016,103601,Kahng; Andrew Byun,9999,0,9999,0
1668153018093,ECE 200,017,103602,Kim; Young-Han,9999,0,9999,0
1668153018093,ECE 200,018,103603,Koushanfar; Farinaz,9999,0,9999,0
1668153018093,ECE 200,019,103604,Kuzum; Duygu,9999,0,9999,0
1668153018093,ECE 200,020,103605,Le; Hanh-Phuc,9999,0,9999,0
1668153018093,ECE 200,021,103606,Lin; Bill,9999,0,9999,0
1668153018093,ECE 200,022,103607,Liu; Zhaowei,9998,0,9999,1
1668153018093,ECE 200,023,103608,Lo; Yu-Hwa,9999,0,9999,0
1668153018093,ECE 200,024,103609,Lomakin; Vitaliy,9999,0,9999,0
1668153018093,ECE 200,025,103610,Mercier; Patrick Philip,9999,0,9999,0
1668153018093,ECE 200,026,103611,Meyer; Florian,9999,0,9999,0
1668153018093,ECE 200,027,103612,Milstein; Laurence B.,9999,0,9999,0
1668153018093,ECE 200,028,103613,Mir Arabbaygi; Siavash,9999,0,9999,0
1668153018093,ECE 200,029,103614,Mookherjea; Shayan,9999,0,9999,0
1668153018093,ECE 200,030,103615,Morris; Karcher William,9999,0,9999,0
1668153018093,ECE 200,031,103616,Ng; Tse Nga,9999,0,9999,0
1668153018093,ECE 200,032,103617,Nguyen; Truong Quang,9999,0,9999,0
1668153018093,ECE 200,033,103618,Nomura; Kenji,9999,0,9999,0
1668153018093,ECE 200,034,103619,Orlitsky; Alon,9999,0,9999,0
1668153018093,ECE 200,035,103620,Pal; Piya,9999,0,9999,0
1668153018093,ECE 200,036,103621,Papen; George C.,9999,0,9999,0
1668153018093,ECE 200,037,103622,Radic; Stojan,9999,0,9999,0
1668153018093,ECE 200,038,103623,Rao; Bhaskar D.,9999,0,9999,0
1668153018093,ECE 200,039,103624,Rao; Ramesh R,9999,0,9999,0
1668153018093,ECE 200,040,103625,Rebeiz; Gabriel,9999,0,9999,0
1668153018093,ECE 200,041,103626,Sanford; John R,9999,0,9999,0
1668153018093,ECE 200,042,103627,Siegel; Paul H.,9999,0,9999,0
1668153018093,ECE 200,043,103628,Sievenpiper; Daniel F.,9999,0,9999,0
1668153018093,ECE 200,044,103629,Sworder; David D.,9999,0,9999,0
1668153018093,ECE 200,045,103630,Taur; Yuan,9999,0,9999,0
1668153018093,ECE 200,046,103631,Touri; Behrouz,9999,0,9999,0
1668153018093,ECE 200,047,103632,Trivedi; Mohan M.,9999,0,9999,0
1668153018093,ECE 200,048,103633,Vasconcelos; Nuno,9999,0,9999,0
1668153018093,ECE 200,049,103634,Wang; Xiaolong,9999,0,9999,0
1668153018093,ECE 200,050,103635,Xie; Pengtao,9999,0,9999,0
1668153018093,ECE 200,051,103636,Yip; Michael,9999,0,9999,0
1668153018093,ECE 200,052,103637,Zeger; Kenneth A.,999,0,999,0
1668153018093,ECE 200,053,103638,Zhang; Xinyu,9999,0,9999,0
1668153018093,ECE 200,054,103639,Turakhia; Yatish Girish,9999,0,9999,0
1668153018093,ECE 200,055,103640,Kang; Mingu,9999,0,9999,0
1668153018093,ECE 200,056,103641,Shi; Yuanyuan,9999,0,9999,0
1668153018093,ECE 200,057,103642,Wang; Edward Jay,9999,0,9999,0
1668153018093,ECE 200,058,103643,Zheng; Yang,9999,0,9999,0
1668153018516,ECE 202,A00,103644,Kuzum; Duygu,0,0,0,0
1668153018937,ECE 212BN,A00,103646,Ng; Tse Nga,0,0,0,0
1668153019364,ECE 221,A00,111493,Staff,0,0,0,0
1668153019788,ECE 222B,A00,103647,Lomakin; Vitaliy,0,0,0,0
1668153020216,ECE 230B,A00,103648,Taur; Yuan,0,0,0,0
1668153020641,ECE 238B,A00,103649,Garay; Javier,0,0,0,0
1668153021069,ECE 240B,A00,112900,Fainman; Yeshaiahu,0,0,0,0
1668153021495,ECE 247A,A00,103650,Jokerst; Jesse Vincent,0,0,0,0
1668153021924,ECE 247B,A00,103651,Wang; Joseph,0,0,0,0
1668153022346,ECE 250,A00,103652,Siegel; Paul H.,0,0,0,0
1668153022769,ECE 251A,A00,103654,Rao; Bhaskar D.,0,0,0,0
1668153023192,ECE 257B,A00,103655,Bharadia; Dinesh,0,0,0,0
1668153023617,ECE 258A,A00,103656,Milstein; Laurence B.,0,0,0,0
1668153024042,ECE 260B,A00,103658,Kang; Mingu,0,0,0,0
1668153024465,ECE 264A,A00,103659,Galton; Ian A,0,0,0,0
1668153024889,ECE 265A,A00,103661,Gudem; Prasad S.S.,0,0,0,0
1668153025317,ECE 265D,A00,103662,Gudem; Prasad S.S.,0,0,0,0
1668153025740,ECE 268,A00,103663,Koushanfar; Farinaz,0,0,0,0
1668153026164,ECE 269,A01,103665,Pal; Piya,0,0,0,0
1668153026588,ECE 271B,A00,103666,Vasconcelos; Manuela,0,0,0,0
1668153027015,ECE 276A,A00,103667,Atanasov; Nikolay A.,0,0,0,0
1668153027440,ECE 277,A00,103668,An; Cheolhong,0,0,0,0
1668153027862,ECE 279,A00,117947,Hall; Drew A.,0,0,0,0
1668153028714,ECE 283,A00,103670,Hsueh; Tzu-Chien,0,0,0,0
1668153029142,ECE 284,A00,103671,Turakhia; Yatish Girish,0,0,0,0
1668153029569,ECE 285,A00,103672,Zheng; Yang,0,0,0,0
1668153029569,ECE 285,B00,103673,Sworder; David D.,0,0,0,0
1668153029995,ECE 287,A00,103676,Javidi; Tara,0,0,0,0
1668153030418,MATH 200B,A00,098023,Salehi Golsefidy; Alireza,12,0,15,3
1668153030841,MATH 202B,A00,098024,Rhoades; Brendon Patrick,9,0,15,6
1668153031266,MATH 203B,A00,098025,Oprea; Dragos N.,10,0,15,5
1668153031690,MATH 204B,A00,098026,Sorensen; Claus M,13,0,15,2
1668153032118,MATH 208,A00,098027,Izadi; Elham,7,0,10,3
1668153032544,MATH 209,A00,098028,Pollack; Aaron,10,0,10,0
1668153032968,MATH 211A,A00,112919,Rogalski; Daniel,9,0,10,1
1668153033391,MATH 211B,A00,112920,Seward; Brandon M.,9,0,10,1
1668153033815,MATH 218,A00,098029,Li; Bo,10,0,10,0
1668153034241,MATH 220B,A00,098030,Novak; Jonathan I,11,0,15,4
1668153034668,MATH 221A,A00,098031,Ebenfelt; Peter F,13,0,15,2
1668153035095,MATH 231B,A00,098032,Zlatos; Andrej,12,0,15,3
1668153035522,MATH 240B,A00,098033,Ni; Lei,9,0,15,6
1668153035946,MATH 243,A00,098034,Jekel; David Andrew,10,0,10,0
1668153036372,MATH 245A,A00,098035,Nie; Jiawang,0,0,15,16
1668153036796,MATH 248,A00,098036,Bejenaru; Ioan,10,0,10,0
1668153037219,MATH 250B,A00,098037,Spolaor; Luca,14,0,15,1
1668153037643,MATH 258,A00,098038,Ni; Lei,10,0,10,0
1668153038067,MATH 264B,A00,098041,Rhoades; Brendon Patrick,9,0,15,6
1668153038491,MATH 268,A00,098042,Buss; Samuel R,10,0,10,0
1668153038914,MATH 269,A00,098043,Rhoades; Brendon Patrick,10,0,10,0
1668153039338,MATH 270B,A00,098044,Li; Bo,10,0,15,5
1668153039763,MATH 272B,A00,098045,Holst; Michael J,13,0,15,2
1668153040187,MATH 273A,A00,098046,Tian; Xiaochuan,10,0,15,5
1668153040615,MATH 275,A01,098048,Tian; Xiaochuan,6,0,10,4
1668153041039,MATH 278A,A00,098049,Holst; Michael J,8,0,10,2
1668153041462,MATH 278B,A00,098050,Cloninger; Alexander,10,0,10,0
1668153041889,MATH 278C,A00,098051,Nie; Jiawang,7,0,10,3
1668153042315,MATH 280B,A00,098052,Zheng; Tianyi,10,0,15,5
1668153042738,MATH 281B,A00,098053,Bradic; Jelena,2,0,15,13
1668153043165,MATH 282B,A00,098054,Arias-Castro; Ery,0,0,15,15
1668153043597,MATH 285,A00,098055,Fitzsimmons; Patrick J,0,0,15,17
1668153044019,MATH 287B,A00,098056,Arias-Castro; Ery,2,0,15,13
1668153044443,MATH 288,A00,098057,Agarwal; Pooja,9,0,10,1
1668153044443,MATH 288,B00,098058,Zhang; Danna,8,0,10,2
1668153044443,MATH 288,C00,098059,Williams; Ruth J,10,0,10,0
1668153044870,MATH 290B,A00,098060,Roberts; Justin Deritter,13,0,15,2
1668153045297,MATH 292,A00,098061,Belmont; Eva Kinoshita,10,0,10,0
1668153045718,MATH 295,A00,098062,Suk; Andrew Hoon,48,0,50,2
1668153046141,MATH 296,A00,098063,Novak; Jonathan I,20,0,20,0
1668153046570,MATH 297,001,098064,Gamst; Anthony Collins,9997,0,9999,2
1668153545141,COGS 205,A00,101395,Chiba; Andrea,19,0,20,1
1668153545568,COGS 210B,001,101404,Greene; Deanna Jacquelyn,9998,0,9999,1
1668153545568,COGS 210B,002,101417,Xia; Haijun,9999,0,9999,0
1668153545568,COGS 210B,003,101422,Nitz; Douglas A.,9999,0,9999,0
1668153545568,COGS 210B,004,101423,Hollan; James D.,9998,0,9999,1
1668153545568,COGS 210B,005,101424,Deak; Gedeon O.,9998,0,9999,1
1668153545568,COGS 210B,006,101425,Rossano; Federico,9999,0,9999,0
1668153545991,COGS 211B,A00,101427,Coulson; Seana M,9996,0,9999,3
1668153546415,COGS 220,A00,101428,Hollan; James D.,0,0,25,25
1668153546843,COGS 229,A00,101429,Dow; Steven P,18,0,25,7
1668153547267,COGS 230,A00,101430,Klemmer; Scott R,12,0,17,5
1668153547689,COGS 234,A00,101431,Xia; Haijun,3,0,25,22
1668153548116,COGS 260,A00,101432,Kiyonaga; Anastasia,20,0,25,5
1668153548116,COGS 260,B00,101433,Kirsh; David Joel,16,0,25,9
1668153548540,CSE 202,A00,102371,Impagliazzo; Russell,0,0,0,0
1668153548962,CSE 203B,A01,102373,Cheng; Chung Kuan,0,0,0,0
1668153549386,CSE 208,A00,102374,Micciancio; Daniele,0,0,0,0
1668153549811,CSE 209A,A00,112895,Impagliazzo; Russell,0,0,15,15
1668153550237,CSE 209B,A00,108005,Bellare; Mihir,0,0,0,0
1668153550662,CSE 210,A00,113163,Coblenz; Michael J,0,0,0,0
1668153551087,CSE 219,A00,106111,Dow; Steven P,0,0,20,20
1668153551512,CSE 221,A00,102376,Voelker; Geoffrey M.,0,0,0,0
1668153551937,CSE 224,A01,102378,Porter; George M,0,0,0,0
1668153552362,CSE 229A,A00,102379,Savage; Stefan,0,0,0,0
1668153552794,CSE 229C,A00,102380,Munyaka; Imani N. S.,0,0,0,0
1668153553220,CSE 232B,A00,102382,Deutsch; Alin Bernard,0,0,0,0
1668153553647,CSE 234,A01,112904,Kumar; Arun Kumar,0,0,0,0
1668153554069,CSE 237A,A00,102383,Rosing; Tajana Simunic,0,0,0,0
1668153554501,CSE 239A,A00,102384,Deutsch; Alin Bernard,0,0,0,0
1668153554926,CSE 239B,A00,102385,Polikarpova; Nadezhda,0,0,0,0
1668153555350,CSE 240A,A00,102386,Pannuto; Patrick William,0,0,0,0
1668153555779,CSE 240B,A00,102387,Zhao; Jishen,0,0,0,0
1668153556205,CSE 241A,A00,106406,Kang; Mingu,0,0,0,0
1668153556630,CSE 249B,A00,102388,Kahng; Andrew Byun,0,0,8,8
1668153557058,CSE 251B,A01,102392,Cottrell; Garrison W,0,0,0,0
1668153557058,CSE 251B,A02,102393,Cottrell; Garrison W,0,0,0,0
1668153557482,CSE 252B,A00,102394,Ochoa; Benjamin Lawrence,0,0,0,0
1668153557914,CSE 257,A01,102396,Gao; Sicun,0,0,0,0
1668153558339,CSE 272,A00,102397,Li; Tzumao,0,0,0,0
1668153558769,CSE 274,A00,111323,Chern; Albert Ren-Haur,0,0,0,0
1668153559192,CSE 282,A00,102398,Pevzner; Pavel Arkadjevich,0,0,0,0
1668153559614,CSE 284,A00,114175,Gymrek; Melissa Ann,0,0,0,0
1668153560040,CSE 290,A00,102399,Chandraker; Manmohan Krishna,0,0,0,0
1668153560040,CSE 290,B00,102400,Vaccaro; Kristen Marie,0,0,25,25
1668153560040,CSE 290,C00,102414,Pannuto; Patrick William,0,0,25,25
1668153560040,CSE 290,D00,102427,Pevzner; Pavel Arkadjevich,0,0,0,0
1668153560040,CSE 290,E00,102429,Zhao; Jishen,0,0,0,0
1668153560040,CSE 290,F00,102436,Tullsen; Dean Michael,0,0,0,0
1668153560040,CSE 290,G00,102440,Christensen; Henrik I,0,0,20,20
1668153560478,CSE 291,A00,102443,Su; Hao,0,0,0,0
1668153560478,CSE 291,B00,102448,Polikarpova; Nadezhda,0,0,0,0
1668153560478,CSE 291,C00,102453,Vaccaro; Kristen Marie,0,0,0,0
1668153560478,CSE 291,D00,111343,Savage; Stefan,0,0,0,0
1668153560478,CSE 291,E00,116474,Claffy; Kimberly Claire,0,0,0,0
1668153560478,CSE 291,F00,116479,Pasquale; Joseph,0,0,0,0
1668153560912,CSE 293,001,119111,Bafna; Vineet,9999,0,9999,0
1668153560912,CSE 293,002,119118,Bellare; Mihir,9999,0,9999,0
1668153560912,CSE 293,003,119122,Berg-Kirkpatrick; Taylor D,9999,0,9999,0
1668153560912,CSE 293,004,119135,Christensen; Henrik I,9999,0,9999,0
1668153560912,CSE 293,005,119142,Cottrell; Garrison W,9999,0,9999,0
1668153560912,CSE 293,006,119146,Deutsch; Alin Bernard,9999,0,9999,0
1668153560912,CSE 293,007,119159,Esmaeilzadeh; Hadi,9999,0,9999,0
1668153560912,CSE 293,008,119166,Freund; Yoav,9999,0,9999,0
1668153560912,CSE 293,009,119170,Griswold; William G.,9999,0,9999,0
1668153560912,CSE 293,010,119183,Gymrek; Melissa Ann,9999,0,9999,0
1668153560912,CSE 293,011,119190,Heninger; Nadia A,9999,0,9999,0
1668153560912,CSE 293,012,119230,Impagliazzo; Russell,9999,0,9999,0
1668153560912,CSE 293,013,119232,Jhala; Ranjit,9999,0,9999,0
1668153560912,CSE 293,014,119233,Kahng; Andrew Byun,9999,0,9999,0
1668153560912,CSE 293,015,119298,Kane; Daniel Mertz,9999,0,9999,0
1668153560912,CSE 293,016,119299,Kriegman; David J,9999,0,9999,0
1668153560912,CSE 293,017,119300,Kumar; Arun Kumar,9999,0,9999,0
1668153560912,CSE 293,018,119301,Lerner; Sorin,9999,0,9999,0
1668153560912,CSE 293,019,119302,Lovett; Shachar,9999,0,9999,0
1668153560912,CSE 293,020,119303,McAuley; Julian John,9999,0,9999,0
1668153560912,CSE 293,021,119304,Micciancio; Daniele,9999,0,9999,0
1668153560912,CSE 293,022,119367,Orailoglu; Alex,9999,0,9999,0
1668153560912,CSE 293,023,119382,Paturi; Ramamohan,9999,0,9999,0
1668153560912,CSE 293,024,119404,Polikarpova; Nadezhda,9999,0,9999,0
1668153560912,CSE 293,025,119406,Politz; Joseph Gibbs,9999,0,9999,0
1668153560912,CSE 293,026,119411,Porter; George M,9999,0,9999,0
1668153560912,CSE 293,027,119414,Porter; Leonard Emerson,9999,0,9999,0
1668153560912,CSE 293,028,119416,Ramamoorthi; Ravi,9999,0,9999,0
1668153560912,CSE 293,029,119417,Sahoo; Debashis,9999,0,9999,0
1668153560912,CSE 293,030,119420,Saul; Lawrence,9999,0,9999,0
1668153560912,CSE 293,031,119421,Savage; Stefan,9999,0,9999,0
1668153560912,CSE 293,032,119425,Schulze; Jurgen P.,9999,0,9999,0
1668153560912,CSE 293,033,119426,Snoeren; Alex C.,9999,0,9999,0
1668153560912,CSE 293,034,119428,Shang; Jingbo,9999,0,9999,0
1668153560912,CSE 293,035,119430,Stefan; Deian,9999,0,9999,0
1668153560912,CSE 293,036,119431,Su; Hao,9999,0,9999,0
1668153560912,CSE 293,037,119433,Swanson; Steven James,9999,0,9999,0
1668153560912,CSE 293,038,119435,Tullsen; Dean Michael,9999,0,9999,0
1668153560912,CSE 293,039,119483,Voelker; Geoffrey M.,9999,0,9999,0
1668153560912,CSE 293,040,119537,Zhao; Jishen,9999,0,9999,0
1668153560912,CSE 293,041,119538,Zhou; Yuan-Yuan,9999,0,9999,0
1668153560912,CSE 293,042,119539,Gao; Sicun,9999,0,9999,0
1668153560912,CSE 293,043,119540,Weibel; Nadir,9999,0,9999,0
1668153560912,CSE 293,044,119541,Gupta; Rajesh K.,9999,0,9999,0
1668153560912,CSE 293,045,126410,Vaccaro; Kristen Marie,9999,0,9999,0
1668153560912,CSE 293,046,126411,Klemke; Richard,9999,0,9999,0
1668153561337,CSE 294,A00,102459,Voelker; Geoffrey M.,0,0,0,0
1668153561337,CSE 294,B00,111322,Orailoglu; Alex,0,0,0,0
1668153561760,DSE 201,A00,096914,Deutsch; Alin Bernard,30,0,30,0
1668153562183,DSE 210,A00,096915,Dasgupta; Sanjoy,30,0,30,0
1668153562606,DSE 260A,A00,096916,Altintas De Callaf; Ilkay,30,0,30,0
1668153563048,ECE 200,001,103586,Antipa; Nicholas A,9999,0,9999,0
1668153563048,ECE 200,002,103587,Atanasov; Nikolay A.,9999,0,9999,0
1668153563048,ECE 200,003,103588,Bharadia; Dinesh,9999,0,9999,0
1668153563048,ECE 200,004,103589,Cheng; Chung Kuan,9999,0,9999,0
1668153563048,ECE 200,005,103590,Cosman; Pamela C.,9999,0,9999,0
1668153563048,ECE 200,006,103591,Dayeh; Shadi Ahmad,9999,0,9999,0
1668153563048,ECE 200,007,103592,Fainman; Yeshaiahu,9999,0,9999,0
1668153563048,ECE 200,008,103593,Ford; Joseph Earl,9999,0,9999,0
1668153563048,ECE 200,009,103594,Franceschetti; Massimo,9999,0,9999,0
1668153563048,ECE 200,010,103595,Fullerton; Eric E,9999,0,9999,0
1668153563048,ECE 200,011,103596,Galton; Ian A,9999,0,9999,0
1668153563048,ECE 200,012,103597,Gilja; Vikash,9999,0,9999,0
1668153563048,ECE 200,013,103598,Hall; Drew A.,9999,0,9999,0
1668153563048,ECE 200,014,103599,Hsueh; Tzu-Chien,9999,0,9999,0
1668153563048,ECE 200,015,103600,Javidi; Tara,9999,0,9999,0
1668153563048,ECE 200,016,103601,Kahng; Andrew Byun,9999,0,9999,0
1668153563048,ECE 200,017,103602,Kim; Young-Han,9999,0,9999,0
1668153563048,ECE 200,018,103603,Koushanfar; Farinaz,9999,0,9999,0
1668153563048,ECE 200,019,103604,Kuzum; Duygu,9999,0,9999,0
1668153563048,ECE 200,020,103605,Le; Hanh-Phuc,9999,0,9999,0
1668153563048,ECE 200,021,103606,Lin; Bill,9999,0,9999,0
1668153563048,ECE 200,022,103607,Liu; Zhaowei,9998,0,9999,1
1668153563048,ECE 200,023,103608,Lo; Yu-Hwa,9999,0,9999,0
1668153563048,ECE 200,024,103609,Lomakin; Vitaliy,9999,0,9999,0
1668153563048,ECE 200,025,103610,Mercier; Patrick Philip,9999,0,9999,0
1668153563048,ECE 200,026,103611,Meyer; Florian,9999,0,9999,0
1668153563048,ECE 200,027,103612,Milstein; Laurence B.,9999,0,9999,0
1668153563048,ECE 200,028,103613,Mir Arabbaygi; Siavash,9999,0,9999,0
1668153563048,ECE 200,029,103614,Mookherjea; Shayan,9999,0,9999,0
1668153563048,ECE 200,030,103615,Morris; Karcher William,9999,0,9999,0
1668153563048,ECE 200,031,103616,Ng; Tse Nga,9999,0,9999,0
1668153563048,ECE 200,032,103617,Nguyen; Truong Quang,9999,0,9999,0
1668153563048,ECE 200,033,103618,Nomura; Kenji,9999,0,9999,0
1668153563048,ECE 200,034,103619,Orlitsky; Alon,9999,0,9999,0
1668153563048,ECE 200,035,103620,Pal; Piya,9999,0,9999,0
1668153563048,ECE 200,036,103621,Papen; George C.,9999,0,9999,0
1668153563048,ECE 200,037,103622,Radic; Stojan,9999,0,9999,0
1668153563048,ECE 200,038,103623,Rao; Bhaskar D.,9999,0,9999,0
1668153563048,ECE 200,039,103624,Rao; Ramesh R,9999,0,9999,0
1668153563048,ECE 200,040,103625,Rebeiz; Gabriel,9999,0,9999,0
1668153563048,ECE 200,041,103626,Sanford; John R,9999,0,9999,0
1668153563048,ECE 200,042,103627,Siegel; Paul H.,9999,0,9999,0
1668153563048,ECE 200,043,103628,Sievenpiper; Daniel F.,9999,0,9999,0
1668153563048,ECE 200,044,103629,Sworder; David D.,9999,0,9999,0
1668153563048,ECE 200,045,103630,Taur; Yuan,9999,0,9999,0
1668153563048,ECE 200,046,103631,Touri; Behrouz,9999,0,9999,0
1668153563048,ECE 200,047,103632,Trivedi; Mohan M.,9999,0,9999,0
1668153563048,ECE 200,048,103633,Vasconcelos; Nuno,9999,0,9999,0
1668153563048,ECE 200,049,103634,Wang; Xiaolong,9999,0,9999,0
1668153563048,ECE 200,050,103635,Xie; Pengtao,9999,0,9999,0
1668153563048,ECE 200,051,103636,Yip; Michael,9999,0,9999,0
1668153563048,ECE 200,052,103637,Zeger; Kenneth A.,999,0,999,0
1668153563048,ECE 200,053,103638,Zhang; Xinyu,9999,0,9999,0
1668153563048,ECE 200,054,103639,Turakhia; Yatish Girish,9999,0,9999,0
1668153563048,ECE 200,055,103640,Kang; Mingu,9999,0,9999,0
1668153563048,ECE 200,056,103641,Shi; Yuanyuan,9999,0,9999,0
1668153563048,ECE 200,057,103642,Wang; Edward Jay,9999,0,9999,0
1668153563048,ECE 200,058,103643,Zheng; Yang,9999,0,9999,0
1668153563474,ECE 202,A00,103644,Kuzum; Duygu,0,0,0,0
1668153563900,ECE 212BN,A00,103646,Ng; Tse Nga,0,0,0,0
1668153564323,ECE 221,A00,111493,Staff,0,0,0,0
1668153564749,ECE 222B,A00,103647,Lomakin; Vitaliy,0,0,0,0
1668153565173,ECE 230B,A00,103648,Taur; Yuan,0,0,0,0
1668153565597,ECE 238B,A00,103649,Garay; Javier,0,0,0,0
1668153566097,ECE 240B,A00,112900,Fainman; Yeshaiahu,0,0,0,0
1668153566520,ECE 247A,A00,103650,Jokerst; Jesse Vincent,0,0,0,0
1668153566941,ECE 247B,A00,103651,Wang; Joseph,0,0,0,0
1668153567366,ECE 250,A00,103652,Siegel; Paul H.,0,0,0,0
1668153567787,ECE 251A,A00,103654,Rao; Bhaskar D.,0,0,0,0
1668153568212,ECE 257B,A00,103655,Bharadia; Dinesh,0,0,0,0
1668153568634,ECE 258A,A00,103656,Milstein; Laurence B.,0,0,0,0
1668153569059,ECE 260B,A00,103658,Kang; Mingu,0,0,0,0
1668153569486,ECE 264A,A00,103659,Galton; Ian A,0,0,0,0
1668153569910,ECE 265A,A00,103661,Gudem; Prasad S.S.,0,0,0,0
1668153570333,ECE 265D,A00,103662,Gudem; Prasad S.S.,0,0,0,0
1668153570759,ECE 268,A00,103663,Koushanfar; Farinaz,0,0,0,0
1668153571184,ECE 269,A01,103665,Pal; Piya,0,0,0,0
1668153571616,ECE 271B,A00,103666,Vasconcelos; Manuela,0,0,0,0
1668153572043,ECE 276A,A00,103667,Atanasov; Nikolay A.,0,0,0,0
1668153572467,ECE 277,A00,103668,An; Cheolhong,0,0,0,0
1668153572890,ECE 279,A00,117947,Hall; Drew A.,0,0,0,0
1668153573742,ECE 283,A00,103670,Hsueh; Tzu-Chien,0,0,0,0
1668153574166,ECE 284,A00,103671,Turakhia; Yatish Girish,0,0,0,0
1668153574591,ECE 285,A00,103672,Zheng; Yang,0,0,0,0
1668153574591,ECE 285,B00,103673,Sworder; David D.,0,0,0,0
1668153575018,ECE 287,A00,103676,Javidi; Tara,0,0,0,0
1668153575441,MATH 200B,A00,098023,Salehi Golsefidy; Alireza,12,0,15,3
1668153575868,MATH 202B,A00,098024,Rhoades; Brendon Patrick,9,0,15,6
1668153576302,MATH 203B,A00,098025,Oprea; Dragos N.,10,0,15,5
1668153576728,MATH 204B,A00,098026,Sorensen; Claus M,13,0,15,2
1668153577150,MATH 208,A00,098027,Izadi; Elham,7,0,10,3
1668153577573,MATH 209,A00,098028,Pollack; Aaron,10,0,10,0
1668153577996,MATH 211A,A00,112919,Rogalski; Daniel,9,0,10,1
1668153578422,MATH 211B,A00,112920,Seward; Brandon M.,9,0,10,1
1668153578847,MATH 218,A00,098029,Li; Bo,10,0,10,0
1668153579269,MATH 220B,A00,098030,Novak; Jonathan I,11,0,15,4
1668153579693,MATH 221A,A00,098031,Ebenfelt; Peter F,13,0,15,2
1668153580119,MATH 231B,A00,098032,Zlatos; Andrej,12,0,15,3
1668153580543,MATH 240B,A00,098033,Ni; Lei,9,0,15,6
1668153580969,MATH 243,A00,098034,Jekel; David Andrew,10,0,10,0
1668153581398,MATH 245A,A00,098035,Nie; Jiawang,0,0,15,16
1668153581823,MATH 248,A00,098036,Bejenaru; Ioan,10,0,10,0
1668153582246,MATH 250B,A00,098037,Spolaor; Luca,14,0,15,1
1668153582669,MATH 258,A00,098038,Ni; Lei,10,0,10,0
1668153583092,MATH 264B,A00,098041,Rhoades; Brendon Patrick,9,0,15,6
1668153583523,MATH 268,A00,098042,Buss; Samuel R,10,0,10,0
1668153583949,MATH 269,A00,098043,Rhoades; Brendon Patrick,10,0,10,0
1668153584381,MATH 270B,A00,098044,Li; Bo,10,0,15,5
1668153584887,MATH 272B,A00,098045,Holst; Michael J,13,0,15,2
1668153585309,MATH 273A,A00,098046,Tian; Xiaochuan,10,0,15,5
1668153585734,MATH 275,A01,098048,Tian; Xiaochuan,6,0,10,4
1668153586157,MATH 278A,A00,098049,Holst; Michael J,8,0,10,2
1668153586584,MATH 278B,A00,098050,Cloninger; Alexander,10,0,10,0
1668153587009,MATH 278C,A00,098051,Nie; Jiawang,7,0,10,3
1668153587442,MATH 280B,A00,098052,Zheng; Tianyi,10,0,15,5
1668153587865,MATH 281B,A00,098053,Bradic; Jelena,2,0,15,13
1668153588291,MATH 282B,A00,098054,Arias-Castro; Ery,0,0,15,15
1668153588714,MATH 285,A00,098055,Fitzsimmons; Patrick J,0,0,15,17
1668153589141,MATH 287B,A00,098056,Arias-Castro; Ery,2,0,15,13
1668153589567,MATH 288,A00,098057,Agarwal; Pooja,9,0,10,1
1668153589567,MATH 288,B00,098058,Zhang; Danna,8,0,10,2
1668153589567,MATH 288,C00,098059,Williams; Ruth J,10,0,10,0
1668153589991,MATH 290B,A00,098060,Roberts; Justin Deritter,13,0,15,2
1668153590415,MATH 292,A00,098061,Belmont; Eva Kinoshita,10,0,10,0
1668153590845,MATH 295,A00,098062,Suk; Andrew Hoon,48,0,50,2
1668153591268,MATH 296,A00,098063,Novak; Jonathan I,20,0,20,0
1668153591692,MATH 297,001,098064,Gamst; Anthony Collins,9997,0,9999,2
1668154091841,COGS 205,A00,101395,Chiba; Andrea,19,0,20,1
1668154092272,COGS 210B,001,101404,Greene; Deanna Jacquelyn,9998,0,9999,1
1668154092272,COGS 210B,002,101417,Xia; Haijun,9999,0,9999,0
1668154092272,COGS 210B,003,101422,Nitz; Douglas A.,9999,0,9999,0
1668154092272,COGS 210B,004,101423,Hollan; James D.,9998,0,9999,1
1668154092272,COGS 210B,005,101424,Deak; Gedeon O.,9998,0,9999,1
1668154092272,COGS 210B,006,101425,Rossano; Federico,9999,0,9999,0
1668154092696,COGS 211B,A00,101427,Coulson; Seana M,9996,0,9999,3
1668154093122,COGS 220,A00,101428,Hollan; James D.,0,0,25,25
1668154093547,COGS 229,A00,101429,Dow; Steven P,18,0,25,7
1668154093972,COGS 230,A00,101430,Klemmer; Scott R,12,0,17,5
1668154094395,COGS 234,A00,101431,Xia; Haijun,3,0,25,22
1668154094825,COGS 260,A00,101432,Kiyonaga; Anastasia,20,0,25,5
1668154094825,COGS 260,B00,101433,Kirsh; David Joel,16,0,25,9
1668154095253,CSE 202,A00,102371,Impagliazzo; Russell,0,0,0,0
1668154095675,CSE 203B,A01,102373,Cheng; Chung Kuan,0,0,0,0
1668154096099,CSE 208,A00,102374,Micciancio; Daniele,0,0,0,0
1668154096522,CSE 209A,A00,112895,Impagliazzo; Russell,0,0,15,15
1668154096945,CSE 209B,A00,108005,Bellare; Mihir,0,0,0,0
1668154097370,CSE 210,A00,113163,Coblenz; Michael J,0,0,0,0
1668154097797,CSE 219,A00,106111,Dow; Steven P,0,0,20,20
1668154098219,CSE 221,A00,102376,Voelker; Geoffrey M.,0,0,0,0
1668154098646,CSE 224,A01,102378,Porter; George M,0,0,0,0
1668154099076,CSE 229A,A00,102379,Savage; Stefan,0,0,0,0
1668154099507,CSE 229C,A00,102380,Munyaka; Imani N. S.,0,0,0,0
1668154099937,CSE 232B,A00,102382,Deutsch; Alin Bernard,0,0,0,0
1668154100369,CSE 234,A01,112904,Kumar; Arun Kumar,0,0,0,0
1668154100793,CSE 237A,A00,102383,Rosing; Tajana Simunic,0,0,0,0
1668154101217,CSE 239A,A00,102384,Deutsch; Alin Bernard,0,0,0,0
1668154101641,CSE 239B,A00,102385,Polikarpova; Nadezhda,0,0,0,0
1668154102066,CSE 240A,A00,102386,Pannuto; Patrick William,0,0,0,0
1668154102490,CSE 240B,A00,102387,Zhao; Jishen,0,0,0,0
1668154102917,CSE 241A,A00,106406,Kang; Mingu,0,0,0,0
1668154103346,CSE 249B,A00,102388,Kahng; Andrew Byun,0,0,8,8
1668154103771,CSE 251B,A01,102392,Cottrell; Garrison W,0,0,0,0
1668154103771,CSE 251B,A02,102393,Cottrell; Garrison W,0,0,0,0
1668154104204,CSE 252B,A00,102394,Ochoa; Benjamin Lawrence,0,0,0,0
1668154104626,CSE 257,A01,102396,Gao; Sicun,0,0,0,0
1668154105053,CSE 272,A00,102397,Li; Tzumao,0,0,0,0
1668154105475,CSE 274,A00,111323,Chern; Albert Ren-Haur,0,0,0,0
1668154105900,CSE 282,A00,102398,Pevzner; Pavel Arkadjevich,0,0,0,0
1668154106328,CSE 284,A00,114175,Gymrek; Melissa Ann,0,0,0,0
1668154106753,CSE 290,A00,102399,Chandraker; Manmohan Krishna,0,0,0,0
1668154106753,CSE 290,B00,102400,Vaccaro; Kristen Marie,0,0,25,25
1668154106753,CSE 290,C00,102414,Pannuto; Patrick William,0,0,25,25
1668154106753,CSE 290,D00,102427,Pevzner; Pavel Arkadjevich,0,0,0,0
1668154106753,CSE 290,E00,102429,Zhao; Jishen,0,0,0,0
1668154106753,CSE 290,F00,102436,Tullsen; Dean Michael,0,0,0,0
1668154106753,CSE 290,G00,102440,Christensen; Henrik I,0,0,20,20
1668154107181,CSE 291,A00,102443,Su; Hao,0,0,0,0
1668154107181,CSE 291,B00,102448,Polikarpova; Nadezhda,0,0,0,0
1668154107181,CSE 291,C00,102453,Vaccaro; Kristen Marie,0,0,0,0
1668154107181,CSE 291,D00,111343,Savage; Stefan,0,0,0,0
1668154107181,CSE 291,E00,116474,Claffy; Kimberly Claire,0,0,0,0
1668154107181,CSE 291,F00,116479,Pasquale; Joseph,0,0,0,0
1668154107618,CSE 293,001,119111,Bafna; Vineet,9999,0,9999,0
1668154107618,CSE 293,002,119118,Bellare; Mihir,9999,0,9999,0
1668154107618,CSE 293,003,119122,Berg-Kirkpatrick; Taylor D,9999,0,9999,0
1668154107618,CSE 293,004,119135,Christensen; Henrik I,9999,0,9999,0
1668154107618,CSE 293,005,119142,Cottrell; Garrison W,9999,0,9999,0
1668154107618,CSE 293,006,119146,Deutsch; Alin Bernard,9999,0,9999,0
1668154107618,CSE 293,007,119159,Esmaeilzadeh; Hadi,9999,0,9999,0
1668154107618,CSE 293,008,119166,Freund; Yoav,9999,0,9999,0
1668154107618,CSE 293,009,119170,Griswold; William G.,9999,0,9999,0
1668154107618,CSE 293,010,119183,Gymrek; Melissa Ann,9999,0,9999,0
1668154107618,CSE 293,011,119190,Heninger; Nadia A,9999,0,9999,0
1668154107618,CSE 293,012,119230,Impagliazzo; Russell,9999,0,9999,0
1668154107618,CSE 293,013,119232,Jhala; Ranjit,9999,0,9999,0
1668154107618,CSE 293,014,119233,Kahng; Andrew Byun,9999,0,9999,0
1668154107618,CSE 293,015,119298,Kane; Daniel Mertz,9999,0,9999,0
1668154107618,CSE 293,016,119299,Kriegman; David J,9999,0,9999,0
1668154107618,CSE 293,017,119300,Kumar; Arun Kumar,9999,0,9999,0
1668154107618,CSE 293,018,119301,Lerner; Sorin,9999,0,9999,0
1668154107618,CSE 293,019,119302,Lovett; Shachar,9999,0,9999,0
1668154107618,CSE 293,020,119303,McAuley; Julian John,9999,0,9999,0
1668154107618,CSE 293,021,119304,Micciancio; Daniele,9999,0,9999,0
1668154107618,CSE 293,022,119367,Orailoglu; Alex,9999,0,9999,0
1668154107618,CSE 293,023,119382,Paturi; Ramamohan,9999,0,9999,0
1668154107618,CSE 293,024,119404,Polikarpova; Nadezhda,9999,0,9999,0
1668154107618,CSE 293,025,119406,Politz; Joseph Gibbs,9999,0,9999,0
1668154107618,CSE 293,026,119411,Porter; George M,9999,0,9999,0
1668154107618,CSE 293,027,119414,Porter; Leonard Emerson,9999,0,9999,0
1668154107618,CSE 293,028,119416,Ramamoorthi; Ravi,9999,0,9999,0
1668154107618,CSE 293,029,119417,Sahoo; Debashis,9999,0,9999,0
1668154107618,CSE 293,030,119420,Saul; Lawrence,9999,0,9999,0
1668154107618,CSE 293,031,119421,Savage; Stefan,9999,0,9999,0
1668154107618,CSE 293,032,119425,Schulze; Jurgen P.,9999,0,9999,0
1668154107618,CSE 293,033,119426,Snoeren; Alex C.,9999,0,9999,0
1668154107618,CSE 293,034,119428,Shang; Jingbo,9999,0,9999,0
1668154107618,CSE 293,035,119430,Stefan; Deian,9999,0,9999,0
1668154107618,CSE 293,036,119431,Su; Hao,9999,0,9999,0
1668154107618,CSE 293,037,119433,Swanson; Steven James,9999,0,9999,0
1668154107618,CSE 293,038,119435,Tullsen; Dean Michael,9999,0,9999,0
1668154107618,CSE 293,039,119483,Voelker; Geoffrey M.,9999,0,9999,0
1668154107618,CSE 293,040,119537,Zhao; Jishen,9999,0,9999,0
1668154107618,CSE 293,041,119538,Zhou; Yuan-Yuan,9999,0,9999,0
1668154107618,CSE 293,042,119539,Gao; Sicun,9999,0,9999,0
1668154107618,CSE 293,043,119540,Weibel; Nadir,9999,0,9999,0
1668154107618,CSE 293,044,119541,Gupta; Rajesh K.,9999,0,9999,0
1668154107618,CSE 293,045,126410,Vaccaro; Kristen Marie,9999,0,9999,0
1668154107618,CSE 293,046,126411,Klemke; Richard,9999,0,9999,0
1668154108042,CSE 294,A00,102459,Voelker; Geoffrey M.,0,0,0,0
1668154108042,CSE 294,B00,111322,Orailoglu; Alex,0,0,0,0
1668154108473,DSE 201,A00,096914,Deutsch; Alin Bernard,30,0,30,0
1668154108898,DSE 210,A00,096915,Dasgupta; Sanjoy,30,0,30,0
1668154109329,DSE 260A,A00,096916,Altintas De Callaf; Ilkay,30,0,30,0
1668154109758,ECE 200,001,103586,Antipa; Nicholas A,9999,0,9999,0
1668154109758,ECE 200,002,103587,Atanasov; Nikolay A.,9999,0,9999,0
1668154109758,ECE 200,003,103588,Bharadia; Dinesh,9999,0,9999,0
1668154109758,ECE 200,004,103589,Cheng; Chung Kuan,9999,0,9999,0
1668154109758,ECE 200,005,103590,Cosman; Pamela C.,9999,0,9999,0
1668154109758,ECE 200,006,103591,Dayeh; Shadi Ahmad,9999,0,9999,0
1668154109758,ECE 200,007,103592,Fainman; Yeshaiahu,9999,0,9999,0
1668154109758,ECE 200,008,103593,Ford; Joseph Earl,9999,0,9999,0
1668154109758,ECE 200,009,103594,Franceschetti; Massimo,9999,0,9999,0
1668154109758,ECE 200,010,103595,Fullerton; Eric E,9999,0,9999,0
1668154109758,ECE 200,011,103596,Galton; Ian A,9999,0,9999,0
1668154109758,ECE 200,012,103597,Gilja; Vikash,9999,0,9999,0
1668154109758,ECE 200,013,103598,Hall; Drew A.,9999,0,9999,0
1668154109758,ECE 200,014,103599,Hsueh; Tzu-Chien,9999,0,9999,0
1668154109758,ECE 200,015,103600,Javidi; Tara,9999,0,9999,0
1668154109758,ECE 200,016,103601,Kahng; Andrew Byun,9999,0,9999,0
1668154109758,ECE 200,017,103602,Kim; Young-Han,9999,0,9999,0
1668154109758,ECE 200,018,103603,Koushanfar; Farinaz,9999,0,9999,0
1668154109758,ECE 200,019,103604,Kuzum; Duygu,9999,0,9999,0
1668154109758,ECE 200,020,103605,Le; Hanh-Phuc,9999,0,9999,0
1668154109758,ECE 200,021,103606,Lin; Bill,9999,0,9999,0
1668154109758,ECE 200,022,103607,Liu; Zhaowei,9998,0,9999,1
1668154109758,ECE 200,023,103608,Lo; Yu-Hwa,9999,0,9999,0
1668154109758,ECE 200,024,103609,Lomakin; Vitaliy,9999,0,9999,0
1668154109758,ECE 200,025,103610,Mercier; Patrick Philip,9999,0,9999,0
1668154109758,ECE 200,026,103611,Meyer; Florian,9999,0,9999,0
1668154109758,ECE 200,027,103612,Milstein; Laurence B.,9999,0,9999,0
1668154109758,ECE 200,028,103613,Mir Arabbaygi; Siavash,9999,0,9999,0
1668154109758,ECE 200,029,103614,Mookherjea; Shayan,9999,0,9999,0
1668154109758,ECE 200,030,103615,Morris; Karcher William,9999,0,9999,0
1668154109758,ECE 200,031,103616,Ng; Tse Nga,9999,0,9999,0
1668154109758,ECE 200,032,103617,Nguyen; Truong Quang,9999,0,9999,0
1668154109758,ECE 200,033,103618,Nomura; Kenji,9999,0,9999,0
1668154109758,ECE 200,034,103619,Orlitsky; Alon,9999,0,9999,0
1668154109758,ECE 200,035,103620,Pal; Piya,9999,0,9999,0
1668154109758,ECE 200,036,103621,Papen; George C.,9999,0,9999,0
1668154109758,ECE 200,037,103622,Radic; Stojan,9999,0,9999,0
1668154109758,ECE 200,038,103623,Rao; Bhaskar D.,9999,0,9999,0
1668154109758,ECE 200,039,103624,Rao; Ramesh R,9999,0,9999,0
1668154109758,ECE 200,040,103625,Rebeiz; Gabriel,9999,0,9999,0
1668154109758,ECE 200,041,103626,Sanford; John R,9999,0,9999,0
1668154109758,ECE 200,042,103627,Siegel; Paul H.,9999,0,9999,0
1668154109758,ECE 200,043,103628,Sievenpiper; Daniel F.,9999,0,9999,0
1668154109758,ECE 200,044,103629,Sworder; David D.,9999,0,9999,0
1668154109758,ECE 200,045,103630,Taur; Yuan,9999,0,9999,0
1668154109758,ECE 200,046,103631,Touri; Behrouz,9999,0,9999,0
1668154109758,ECE 200,047,103632,Trivedi; Mohan M.,9999,0,9999,0
1668154109758,ECE 200,048,103633,Vasconcelos; Nuno,9999,0,9999,0
1668154109758,ECE 200,049,103634,Wang; Xiaolong,9999,0,9999,0
1668154109758,ECE 200,050,103635,Xie; Pengtao,9999,0,9999,0
1668154109758,ECE 200,051,103636,Yip; Michael,9999,0,9999,0
1668154109758,ECE 200,052,103637,Zeger; Kenneth A.,999,0,999,0
1668154109758,ECE 200,053,103638,Zhang; Xinyu,9999,0,9999,0
1668154109758,ECE 200,054,103639,Turakhia; Yatish Girish,9999,0,9999,0
1668154109758,ECE 200,055,103640,Kang; Mingu,9999,0,9999,0
1668154109758,ECE 200,056,103641,Shi; Yuanyuan,9999,0,9999,0
1668154109758,ECE 200,057,103642,Wang; Edward Jay,9999,0,9999,0
1668154109758,ECE 200,058,103643,Zheng; Yang,9999,0,9999,0
1668154110181,ECE 202,A00,103644,Kuzum; Duygu,0,0,0,0
1668154110605,ECE 212BN,A00,103646,Ng; Tse Nga,0,0,0,0
1668154111048,ECE 221,A00,111493,Staff,0,0,0,0
1668154111472,ECE 222B,A00,103647,Lomakin; Vitaliy,0,0,0,0
1668154111907,ECE 230B,A00,103648,Taur; Yuan,0,0,0,0
1668154112332,ECE 238B,A00,103649,Garay; Javier,0,0,0,0
1668154112761,ECE 240B,A00,112900,Fainman; Yeshaiahu,0,0,0,0
1668154113185,ECE 247A,A00,103650,Jokerst; Jesse Vincent,0,0,0,0
1668154113617,ECE 247B,A00,103651,Wang; Joseph,0,0,0,0
1668154114045,ECE 250,A00,103652,Siegel; Paul H.,0,0,0,0
1668154114473,ECE 251A,A00,103654,Rao; Bhaskar D.,0,0,0,0
1668154114901,ECE 257B,A00,103655,Bharadia; Dinesh,0,0,0,0
1668154115324,ECE 258A,A00,103656,Milstein; Laurence B.,0,0,0,0
1668154115755,ECE 260B,A00,103658,Kang; Mingu,0,0,0,0
1668154116190,ECE 264A,A00,103659,Galton; Ian A,0,0,0,0
1668154116618,ECE 265A,A00,103661,Gudem; Prasad S.S.,0,0,0,0
1668154117051,ECE 265D,A00,103662,Gudem; Prasad S.S.,0,0,0,0
1668154117473,ECE 268,A00,103663,Koushanfar; Farinaz,0,0,0,0
1668154117897,ECE 269,A01,103665,Pal; Piya,0,0,0,0
1668154118326,ECE 271B,A00,103666,Vasconcelos; Manuela,0,0,0,0
1668154118751,ECE 276A,A00,103667,Atanasov; Nikolay A.,0,0,0,0
1668154119178,ECE 277,A00,103668,An; Cheolhong,0,0,0,0
1668154119603,ECE 279,A00,117947,Hall; Drew A.,0,0,0,0
1668154120451,ECE 283,A00,103670,Hsueh; Tzu-Chien,0,0,0,0
1668154120886,ECE 284,A00,103671,Turakhia; Yatish Girish,0,0,0,0
1668154121308,ECE 285,A00,103672,Zheng; Yang,0,0,0,0
1668154121308,ECE 285,B00,103673,Sworder; David D.,0,0,0,0
1668154121733,ECE 287,A00,103676,Javidi; Tara,0,0,0,0
1668154122160,MATH 200B,A00,098023,Salehi Golsefidy; Alireza,12,0,15,3
1668154122583,MATH 202B,A00,098024,Rhoades; Brendon Patrick,9,0,15,6
1668154123012,MATH 203B,A00,098025,Oprea; Dragos N.,10,0,15,5
1668154123438,MATH 204B,A00,098026,Sorensen; Claus M,13,0,15,2
1668154123863,MATH 208,A00,098027,Izadi; Elham,7,0,10,3
1668154124288,MATH 209,A00,098028,Pollack; Aaron,10,0,10,0
1668154124713,MATH 211A,A00,112919,Rogalski; Daniel,9,0,10,1
1668154125138,MATH 211B,A00,112920,Seward; Brandon M.,9,0,10,1
1668154125561,MATH 218,A00,098029,Li; Bo,10,0,10,0
1668154125986,MATH 220B,A00,098030,Novak; Jonathan I,11,0,15,4
1668154126409,MATH 221A,A00,098031,Ebenfelt; Peter F,13,0,15,2
1668154126834,MATH 231B,A00,098032,Zlatos; Andrej,12,0,15,3
1668154127261,MATH 240B,A00,098033,Ni; Lei,9,0,15,6
1668154127686,MATH 243,A00,098034,Jekel; David Andrew,10,0,10,0
1668154128112,MATH 245A,A00,098035,Nie; Jiawang,0,0,15,16
1668154128537,MATH 248,A00,098036,Bejenaru; Ioan,10,0,10,0
1668154128975,MATH 250B,A00,098037,Spolaor; Luca,14,0,15,1
1668154129471,MATH 258,A00,098038,Ni; Lei,10,0,10,0
1668154129894,MATH 264B,A00,098041,Rhoades; Brendon Patrick,9,0,15,6
1668154130328,MATH 268,A00,098042,Buss; Samuel R,10,0,10,0
1668154130751,MATH 269,A00,098043,Rhoades; Brendon Patrick,10,0,10,0
1668154131175,MATH 270B,A00,098044,Li; Bo,10,0,15,5
1668154131602,MATH 272B,A00,098045,Holst; Michael J,13,0,15,2
1668154132027,MATH 273A,A00,098046,Tian; Xiaochuan,10,0,15,5
1668154132456,MATH 275,A01,098048,Tian; Xiaochuan,6,0,10,4
1668154132881,MATH 278A,A00,098049,Holst; Michael J,8,0,10,2
1668154133314,MATH 278B,A00,098050,Cloninger; Alexander,10,0,10,0
1668154133745,MATH 278C,A00,098051,Nie; Jiawang,7,0,10,3
1668154134167,MATH 280B,A00,098052,Zheng; Tianyi,10,0,15,5
1668154134591,MATH 281B,A00,098053,Bradic; Jelena,2,0,15,13
1668154135018,MATH 282B,A00,098054,Arias-Castro; Ery,0,0,15,15
1668154135443,MATH 285,A00,098055,Fitzsimmons; Patrick J,0,0,15,17
1668154135866,MATH 287B,A00,098056,Arias-Castro; Ery,2,0,15,13
1668154136294,MATH 288,A00,098057,Agarwal; Pooja,9,0,10,1
1668154136294,MATH 288,B00,098058,Zhang; Danna,8,0,10,2
1668154136294,MATH 288,C00,098059,Williams; Ruth J,10,0,10,0
1668154136718,MATH 290B,A00,098060,Roberts; Justin Deritter,13,0,15,2
1668154137145,MATH 292,A00,098061,Belmont; Eva Kinoshita,10,0,10,0
1668154137568,MATH 295,A00,098062,Suk; Andrew Hoon,48,0,50,2
1668154137991,MATH 296,A00,098063,Novak; Jonathan I,20,0,20,0
1668154138413,MATH 297,001,098064,Gamst; Anthony Collins,9997,0,9999,2
1668154643384,COGS 205,A00,101395,Chiba; Andrea,19,0,20,1
1668154643814,COGS 210B,001,101404,Greene; Deanna Jacquelyn,9998,0,9999,1
1668154643814,COGS 210B,002,101417,Xia; Haijun,9999,0,9999,0
1668154643814,COGS 210B,003,101422,Nitz; Douglas A.,9999,0,9999,0
1668154643814,COGS 210B,004,101423,Hollan; James D.,9998,0,9999,1
1668154643814,COGS 210B,005,101424,Deak; Gedeon O.,9998,0,9999,1
1668154643814,COGS 210B,006,101425,Rossano; Federico,9999,0,9999,0
1668154644243,COGS 211B,A00,101427,Coulson; Seana M,9996,0,9999,3
1668154644671,COGS 220,A00,101428,Hollan; James D.,0,0,25,25
1668154645095,COGS 229,A00,101429,Dow; Steven P,18,0,25,7
1668154645519,COGS 230,A00,101430,Klemmer; Scott R,12,0,17,5
1668154645950,COGS 234,A00,101431,Xia; Haijun,3,0,25,22
1668154646381,COGS 260,A00,101432,Kiyonaga; Anastasia,20,0,25,5
1668154646381,COGS 260,B00,101433,Kirsh; David Joel,16,0,25,9
1668154646830,CSE 202,A00,102371,Impagliazzo; Russell,0,0,0,0
1668154647259,CSE 203B,A01,102373,Cheng; Chung Kuan,0,0,0,0
1668154647689,CSE 208,A00,102374,Micciancio; Daniele,0,0,0,0
1668154648117,CSE 209A,A00,112895,Impagliazzo; Russell,0,0,15,15
1668154648548,CSE 209B,A00,108005,Bellare; Mihir,0,0,0,0
1668154648973,CSE 210,A00,113163,Coblenz; Michael J,0,0,0,0
1668154649398,CSE 219,A00,106111,Dow; Steven P,0,0,20,20
1668154649828,CSE 221,A00,102376,Voelker; Geoffrey M.,0,0,0,0
1668154650262,CSE 224,A01,102378,Porter; George M,0,0,0,0
1668154650687,CSE 229A,A00,102379,Savage; Stefan,0,0,0,0
1668154651121,CSE 229C,A00,102380,Munyaka; Imani N. S.,0,0,0,0
1668154651544,CSE 232B,A00,102382,Deutsch; Alin Bernard,0,0,0,0
1668154651968,CSE 234,A01,112904,Kumar; Arun Kumar,0,0,0,0
1668154652391,CSE 237A,A00,102383,Rosing; Tajana Simunic,0,0,0,0
1668154652820,CSE 239A,A00,102384,Deutsch; Alin Bernard,0,0,0,0
1668154653247,CSE 239B,A00,102385,Polikarpova; Nadezhda,0,0,0,0
1668154653676,CSE 240A,A00,102386,Pannuto; Patrick William,0,0,0,0
1668154654104,CSE 240B,A00,102387,Zhao; Jishen,0,0,0,0
1668154654622,CSE 241A,A00,106406,Kang; Mingu,0,0,0,0
1668154655053,CSE 249B,A00,102388,Kahng; Andrew Byun,0,0,8,8
1668154655478,CSE 251B,A01,102392,Cottrell; Garrison W,0,0,0,0
1668154655478,CSE 251B,A02,102393,Cottrell; Garrison W,0,0,0,0
1668154655908,CSE 252B,A00,102394,Ochoa; Benjamin Lawrence,0,0,0,0
1668154656331,CSE 257,A01,102396,Gao; Sicun,0,0,0,0
1668154656756,CSE 272,A00,102397,Li; Tzumao,0,0,0,0
1668154657179,CSE 274,A00,111323,Chern; Albert Ren-Haur,0,0,0,0
1668154657610,CSE 282,A00,102398,Pevzner; Pavel Arkadjevich,0,0,0,0
1668154658047,CSE 284,A00,114175,Gymrek; Melissa Ann,0,0,0,0
1668154658478,CSE 290,A00,102399,Chandraker; Manmohan Krishna,0,0,0,0
1668154658478,CSE 290,B00,102400,Vaccaro; Kristen Marie,0,0,25,25
1668154658478,CSE 290,C00,102414,Pannuto; Patrick William,0,0,25,25
1668154658478,CSE 290,D00,102427,Pevzner; Pavel Arkadjevich,0,0,0,0
1668154658478,CSE 290,E00,102429,Zhao; Jishen,0,0,0,0
1668154658478,CSE 290,F00,102436,Tullsen; Dean Michael,0,0,0,0
1668154658478,CSE 290,G00,102440,Christensen; Henrik I,0,0,20,20
1668154658906,CSE 291,A00,102443,Su; Hao,0,0,0,0
1668154658906,CSE 291,B00,102448,Polikarpova; Nadezhda,0,0,0,0
1668154658906,CSE 291,C00,102453,Vaccaro; Kristen Marie,0,0,0,0
1668154658906,CSE 291,D00,111343,Savage; Stefan,0,0,0,0
1668154658906,CSE 291,E00,116474,Claffy; Kimberly Claire,0,0,0,0
1668154658906,CSE 291,F00,116479,Pasquale; Joseph,0,0,0,0
1668154659388,CSE 293,001,119111,Bafna; Vineet,9999,0,9999,0
1668154659388,CSE 293,002,119118,Bellare; Mihir,9999,0,9999,0
1668154659388,CSE 293,003,119122,Berg-Kirkpatrick; Taylor D,9999,0,9999,0
1668154659388,CSE 293,004,119135,Christensen; Henrik I,9999,0,9999,0
1668154659388,CSE 293,005,119142,Cottrell; Garrison W,9999,0,9999,0
1668154659388,CSE 293,006,119146,Deutsch; Alin Bernard,9999,0,9999,0
1668154659388,CSE 293,007,119159,Esmaeilzadeh; Hadi,9999,0,9999,0
1668154659388,CSE 293,008,119166,Freund; Yoav,9999,0,9999,0
1668154659388,CSE 293,009,119170,Griswold; William G.,9999,0,9999,0
1668154659388,CSE 293,010,119183,Gymrek; Melissa Ann,9999,0,9999,0
1668154659388,CSE 293,011,119190,Heninger; Nadia A,9999,0,9999,0
1668154659388,CSE 293,012,119230,Impagliazzo; Russell,9999,0,9999,0
1668154659388,CSE 293,013,119232,Jhala; Ranjit,9999,0,9999,0
1668154659388,CSE 293,014,119233,Kahng; Andrew Byun,9999,0,9999,0
1668154659388,CSE 293,015,119298,Kane; Daniel Mertz,9999,0,9999,0
1668154659388,CSE 293,016,119299,Kriegman; David J,9999,0,9999,0
1668154659388,CSE 293,017,119300,Kumar; Arun Kumar,9999,0,9999,0
1668154659388,CSE 293,018,119301,Lerner; Sorin,9999,0,9999,0
1668154659388,CSE 293,019,119302,Lovett; Shachar,9999,0,9999,0
1668154659388,CSE 293,020,119303,McAuley; Julian John,9999,0,9999,0
1668154659388,CSE 293,021,119304,Micciancio; Daniele,9999,0,9999,0
1668154659388,CSE 293,022,119367,Orailoglu; Alex,9999,0,9999,0
1668154659388,CSE 293,023,119382,Paturi; Ramamohan,9999,0,9999,0
1668154659388,CSE 293,024,119404,Polikarpova; Nadezhda,9999,0,9999,0
1668154659388,CSE 293,025,119406,Politz; Joseph Gibbs,9999,0,9999,0
1668154659388,CSE 293,026,119411,Porter; George M,9999,0,9999,0
1668154659388,CSE 293,027,119414,Porter; Leonard Emerson,9999,0,9999,0
1668154659388,CSE 293,028,119416,Ramamoorthi; Ravi,9999,0,9999,0
1668154659388,CSE 293,029,119417,Sahoo; Debashis,9999,0,9999,0
1668154659388,CSE 293,030,119420,Saul; Lawrence,9999,0,9999,0
1668154659388,CSE 293,031,119421,Savage; Stefan,9999,0,9999,0
1668154659388,CSE 293,032,119425,Schulze; Jurgen P.,9999,0,9999,0
1668154659388,CSE 293,033,119426,Snoeren; Alex C.,9999,0,9999,0
1668154659388,CSE 293,034,119428,Shang; Jingbo,9999,0,9999,0
1668154659388,CSE 293,035,119430,Stefan; Deian,9999,0,9999,0
1668154659388,CSE 293,036,119431,Su; Hao,9999,0,9999,0
1668154659388,CSE 293,037,119433,Swanson; Steven James,9999,0,9999,0
1668154659388,CSE 293,038,119435,Tullsen; Dean Michael,9999,0,9999,0
1668154659388,CSE 293,039,119483,Voelker; Geoffrey M.,9999,0,9999,0
1668154659388,CSE 293,040,119537,Zhao; Jishen,9999,0,9999,0
1668154659388,CSE 293,041,119538,Zhou; Yuan-Yuan,9999,0,9999,0
1668154659388,CSE 293,042,119539,Gao; Sicun,9999,0,9999,0
1668154659388,CSE 293,043,119540,Weibel; Nadir,9999,0,9999,0
1668154659388,CSE 293,044,119541,Gupta; Rajesh K.,9999,0,9999,0
1668154659388,CSE 293,045,126410,Vaccaro; Kristen Marie,9999,0,9999,0
1668154659388,CSE 293,046,126411,Klemke; Richard,9999,0,9999,0
1668154659810,CSE 294,A00,102459,Voelker; Geoffrey M.,0,0,0,0
1668154659810,CSE 294,B00,111322,Orailoglu; Alex,0,0,0,0
1668154660235,DSE 201,A00,096914,Deutsch; Alin Bernard,30,0,30,0
1668154660665,DSE 210,A00,096915,Dasgupta; Sanjoy,30,0,30,0
1668154661089,DSE 260A,A00,096916,Altintas De Callaf; Ilkay,30,0,30,0
1668154661540,ECE 200,001,103586,Antipa; Nicholas A,9999,0,9999,0
1668154661540,ECE 200,002,103587,Atanasov; Nikolay A.,9999,0,9999,0
1668154661540,ECE 200,003,103588,Bharadia; Dinesh,9999,0,9999,0
1668154661540,ECE 200,004,103589,Cheng; Chung Kuan,9999,0,9999,0
1668154661540,ECE 200,005,103590,Cosman; Pamela C.,9999,0,9999,0
1668154661540,ECE 200,006,103591,Dayeh; Shadi Ahmad,9999,0,9999,0
1668154661540,ECE 200,007,103592,Fainman; Yeshaiahu,9999,0,9999,0
1668154661540,ECE 200,008,103593,Ford; Joseph Earl,9999,0,9999,0
1668154661540,ECE 200,009,103594,Franceschetti; Massimo,9999,0,9999,0
1668154661540,ECE 200,010,103595,Fullerton; Eric E,9999,0,9999,0
1668154661540,ECE 200,011,103596,Galton; Ian A,9999,0,9999,0
1668154661540,ECE 200,012,103597,Gilja; Vikash,9999,0,9999,0
1668154661540,ECE 200,013,103598,Hall; Drew A.,9999,0,9999,0
1668154661540,ECE 200,014,103599,Hsueh; Tzu-Chien,9999,0,9999,0
1668154661540,ECE 200,015,103600,Javidi; Tara,9999,0,9999,0
1668154661540,ECE 200,016,103601,Kahng; Andrew Byun,9999,0,9999,0
1668154661540,ECE 200,017,103602,Kim; Young-Han,9999,0,9999,0
1668154661540,ECE 200,018,103603,Koushanfar; Farinaz,9999,0,9999,0
1668154661540,ECE 200,019,103604,Kuzum; Duygu,9999,0,9999,0
1668154661540,ECE 200,020,103605,Le; Hanh-Phuc,9999,0,9999,0
1668154661540,ECE 200,021,103606,Lin; Bill,9999,0,9999,0
1668154661540,ECE 200,022,103607,Liu; Zhaowei,9998,0,9999,1
1668154661540,ECE 200,023,103608,Lo; Yu-Hwa,9999,0,9999,0
1668154661540,ECE 200,024,103609,Lomakin; Vitaliy,9999,0,9999,0
1668154661540,ECE 200,025,103610,Mercier; Patrick Philip,9999,0,9999,0
1668154661540,ECE 200,026,103611,Meyer; Florian,9999,0,9999,0
1668154661540,ECE 200,027,103612,Milstein; Laurence B.,9999,0,9999,0
1668154661540,ECE 200,028,103613,Mir Arabbaygi; Siavash,9999,0,9999,0
1668154661540,ECE 200,029,103614,Mookherjea; Shayan,9999,0,9999,0
1668154661540,ECE 200,030,103615,Morris; Karcher William,9999,0,9999,0
1668154661540,ECE 200,031,103616,Ng; Tse Nga,9999,0,9999,0
1668154661540,ECE 200,032,103617,Nguyen; Truong Quang,9999,0,9999,0
1668154661540,ECE 200,033,103618,Nomura; Kenji,9999,0,9999,0
1668154661540,ECE 200,034,103619,Orlitsky; Alon,9999,0,9999,0
1668154661540,ECE 200,035,103620,Pal; Piya,9999,0,9999,0
1668154661540,ECE 200,036,103621,Papen; George C.,9999,0,9999,0
1668154661540,ECE 200,037,103622,Radic; Stojan,9999,0,9999,0
1668154661540,ECE 200,038,103623,Rao; Bhaskar D.,9999,0,9999,0
1668154661540,ECE 200,039,103624,Rao; Ramesh R,9999,0,9999,0
1668154661540,ECE 200,040,103625,Rebeiz; Gabriel,9999,0,9999,0
1668154661540,ECE 200,041,103626,Sanford; John R,9999,0,9999,0
1668154661540,ECE 200,042,103627,Siegel; Paul H.,9999,0,9999,0
1668154661540,ECE 200,043,103628,Sievenpiper; Daniel F.,9999,0,9999,0
1668154661540,ECE 200,044,103629,Sworder; David D.,9999,0,9999,0
1668154661540,ECE 200,045,103630,Taur; Yuan,9999,0,9999,0
1668154661540,ECE 200,046,103631,Touri; Behrouz,9999,0,9999,0
1668154661540,ECE 200,047,103632,Trivedi; Mohan M.,9999,0,9999,0
1668154661540,ECE 200,048,103633,Vasconcelos; Nuno,9999,0,9999,0
1668154661540,ECE 200,049,103634,Wang; Xiaolong,9999,0,9999,0
1668154661540,ECE 200,050,103635,Xie; Pengtao,9999,0,9999,0
1668154661540,ECE 200,051,103636,Yip; Michael,9999,0,9999,0
1668154661540,ECE 200,052,103637,Zeger; Kenneth A.,999,0,999,0
1668154661540,ECE 200,053,103638,Zhang; Xinyu,9999,0,9999,0
1668154661540,ECE 200,054,103639,Turakhia; Yatish Girish,9999,0,9999,0
1668154661540,ECE 200,055,103640,Kang; Mingu,9999,0,9999,0
1668154661540,ECE 200,056,103641,Shi; Yuanyuan,9999,0,9999,0
1668154661540,ECE 200,057,103642,Wang; Edward Jay,9999,0,9999,0
1668154661540,ECE 200,058,103643,Zheng; Yang,9999,0,9999,0
1668154661965,ECE 202,A00,103644,Kuzum; Duygu,0,0,0,0
1668154662389,ECE 212BN,A00,103646,Ng; Tse Nga,0,0,0,0
1668154662817,ECE 221,A00,111493,Staff,0,0,0,0
1668154663245,ECE 222B,A00,103647,Lomakin; Vitaliy,0,0,0,0
1668154663674,ECE 230B,A00,103648,Taur; Yuan,0,0,0,0
1668154664105,ECE 238B,A00,103649,Garay; Javier,0,0,0,0
1668154664528,ECE 240B,A00,112900,Fainman; Yeshaiahu,0,0,0,0
1668154664967,ECE 247A,A00,103650,Jokerst; Jesse Vincent,0,0,0,0
1668154665391,ECE 247B,A00,103651,Wang; Joseph,0,0,0,0
1668154665820,ECE 250,A00,103652,Siegel; Paul H.,0,0,0,0
1668154666246,ECE 251A,A00,103654,Rao; Bhaskar D.,0,0,0,0
1668154666670,ECE 257B,A00,103655,Bharadia; Dinesh,0,0,0,0
1668154667095,ECE 258A,A00,103656,Milstein; Laurence B.,0,0,0,0
1668154667521,ECE 260B,A00,103658,Kang; Mingu,0,0,0,0
1668154667952,ECE 264A,A00,103659,Galton; Ian A,0,0,0,0
1668154668383,ECE 265A,A00,103661,Gudem; Prasad S.S.,0,0,0,0
1668154668811,ECE 265D,A00,103662,Gudem; Prasad S.S.,0,0,0,0
1668154669238,ECE 268,A00,103663,Koushanfar; Farinaz,0,0,0,0
1668154669672,ECE 269,A01,103665,Pal; Piya,0,0,0,0
1668154670101,ECE 271B,A00,103666,Vasconcelos; Manuela,0,0,0,0
1668154670525,ECE 276A,A00,103667,Atanasov; Nikolay A.,0,0,0,0
1668154670950,ECE 277,A00,103668,An; Cheolhong,0,0,0,0
1668154671375,ECE 279,A00,117947,Hall; Drew A.,0,0,0,0
1668154672232,ECE 283,A00,103670,Hsueh; Tzu-Chien,0,0,0,0
1668154672656,ECE 284,A00,103671,Turakhia; Yatish Girish,0,0,0,0
1668154673081,ECE 285,A00,103672,Zheng; Yang,0,0,0,0
1668154673081,ECE 285,B00,103673,Sworder; David D.,0,0,0,0
1668154673506,ECE 287,A00,103676,Javidi; Tara,0,0,0,0
1668154673934,MATH 200B,A00,098023,Salehi Golsefidy; Alireza,12,0,15,3
1668154674362,MATH 202B,A00,098024,Rhoades; Brendon Patrick,9,0,15,6
1668154674789,MATH 203B,A00,098025,Oprea; Dragos N.,10,0,15,5
1668154675215,MATH 204B,A00,098026,Sorensen; Claus M,13,0,15,2
1668154675645,MATH 208,A00,098027,Izadi; Elham,7,0,10,3
1668154676069,MATH 209,A00,098028,Pollack; Aaron,10,0,10,0
1668154676496,MATH 211A,A00,112919,Rogalski; Daniel,9,0,10,1
1668154676920,MATH 211B,A00,112920,Seward; Brandon M.,9,0,10,1
1668154677351,MATH 218,A00,098029,Li; Bo,10,0,10,0
1668154677778,MATH 220B,A00,098030,Novak; Jonathan I,11,0,15,4
1668154678210,MATH 221A,A00,098031,Ebenfelt; Peter F,13,0,15,2
1668154678635,MATH 231B,A00,098032,Zlatos; Andrej,12,0,15,3
1668154679057,MATH 240B,A00,098033,Ni; Lei,9,0,15,6
1668154679482,MATH 243,A00,098034,Jekel; David Andrew,10,0,10,0
1668154679907,MATH 245A,A00,098035,Nie; Jiawang,0,0,15,16
1668154680330,MATH 248,A00,098036,Bejenaru; Ioan,10,0,10,0
1668154680755,MATH 250B,A00,098037,Spolaor; Luca,14,0,15,1
1668154681179,MATH 258,A00,098038,Ni; Lei,10,0,10,0
1668154681608,MATH 264B,A00,098041,Rhoades; Brendon Patrick,9,0,15,6
1668154682032,MATH 268,A00,098042,Buss; Samuel R,10,0,10,0
1668154682456,MATH 269,A00,098043,Rhoades; Brendon Patrick,10,0,10,0
1668154682886,MATH 270B,A00,098044,Li; Bo,10,0,15,5
1668154683316,MATH 272B,A00,098045,Holst; Michael J,13,0,15,2
1668154683746,MATH 273A,A00,098046,Tian; Xiaochuan,10,0,15,5
1668154684174,MATH 275,A01,098048,Tian; Xiaochuan,6,0,10,4
1668154684604,MATH 278A,A00,098049,Holst; Michael J,8,0,10,2
1668154685033,MATH 278B,A00,098050,Cloninger; Alexander,10,0,10,0
1668154685463,MATH 278C,A00,098051,Nie; Jiawang,7,0,10,3
1668154685893,MATH 280B,A00,098052,Zheng; Tianyi,10,0,15,5
1668154686325,MATH 281B,A00,098053,Bradic; Jelena,2,0,15,13
1668154686750,MATH 282B,A00,098054,Arias-Castro; Ery,0,0,15,15
1668154687175,MATH 285,A00,098055,Fitzsimmons; Patrick J,0,0,15,17
1668154687601,MATH 287B,A00,098056,Arias-Castro; Ery,2,0,15,13
1668154688024,MATH 288,A00,098057,Agarwal; Pooja,9,0,10,1
1668154688024,MATH 288,B00,098058,Zhang; Danna,8,0,10,2
1668154688024,MATH 288,C00,098059,Williams; Ruth J,10,0,10,0
1668154688458,MATH 290B,A00,098060,Roberts; Justin Deritter,13,0,15,2
1668154688892,MATH 292,A00,098061,Belmont; Eva Kinoshita,10,0,10,0
1668154689324,MATH 295,A00,098062,Suk; Andrew Hoon,48,0,50,2
1668154689749,MATH 296,A00,098063,Novak; Jonathan I,20,0,20,0
1668154690193,MATH 297,001,098064,Gamst; Anthony Collins,9997,0,9999,2
1668155191247,COGS 205,A00,101395,Chiba; Andrea,19,0,20,1
1668155191683,COGS 210B,001,101404,Greene; Deanna Jacquelyn,9998,0,9999,1
1668155191683,COGS 210B,002,101417,Xia; Haijun,9999,0,9999,0
1668155191683,COGS 210B,003,101422,Nitz; Douglas A.,9999,0,9999,0
1668155191683,COGS 210B,004,101423,Hollan; James D.,9998,0,9999,1
1668155191683,COGS 210B,005,101424,Deak; Gedeon O.,9998,0,9999,1
1668155191683,COGS 210B,006,101425,Rossano; Federico,9999,0,9999,0
1668155192108,COGS 211B,A00,101427,Coulson; Seana M,9996,0,9999,3
1668155192535,COGS 220,A00,101428,Hollan; James D.,0,0,25,25
1668155192965,COGS 229,A00,101429,Dow; Steven P,18,0,25,7
1668155193394,COGS 230,A00,101430,Klemmer; Scott R,12,0,17,5
1668155193816,COGS 234,A00,101431,Xia; Haijun,3,0,25,22
1668155194240,COGS 260,A00,101432,Kiyonaga; Anastasia,20,0,25,5
1668155194240,COGS 260,B00,101433,Kirsh; David Joel,16,0,25,9
1668155194672,CSE 202,A00,102371,Impagliazzo; Russell,0,0,0,0
1668155195099,CSE 203B,A01,102373,Cheng; Chung Kuan,0,0,0,0
1668155195526,CSE 208,A00,102374,Micciancio; Daniele,0,0,0,0
1668155195953,CSE 209A,A00,112895,Impagliazzo; Russell,0,0,15,15
1668155196379,CSE 209B,A00,108005,Bellare; Mihir,0,0,0,0
1668155196804,CSE 210,A00,113163,Coblenz; Michael J,0,0,0,0
1668155197244,CSE 219,A00,106111,Dow; Steven P,0,0,20,20
1668155197670,CSE 221,A00,102376,Voelker; Geoffrey M.,0,0,0,0
1668155198112,CSE 224,A01,102378,Porter; George M,0,0,0,0
1668155198544,CSE 229A,A00,102379,Savage; Stefan,0,0,0,0
1668155198971,CSE 229C,A00,102380,Munyaka; Imani N. S.,0,0,0,0
1668155199399,CSE 232B,A00,102382,Deutsch; Alin Bernard,0,0,0,0
1668155199824,CSE 234,A01,112904,Kumar; Arun Kumar,0,0,0,0
1668155200260,CSE 237A,A00,102383,Rosing; Tajana Simunic,0,0,0,0
1668155200690,CSE 239A,A00,102384,Deutsch; Alin Bernard,0,0,0,0
1668155201116,CSE 239B,A00,102385,Polikarpova; Nadezhda,0,0,0,0
1668155201543,CSE 240A,A00,102386,Pannuto; Patrick William,0,0,0,0
1668155201968,CSE 240B,A00,102387,Zhao; Jishen,0,0,0,0
1668155202393,CSE 241A,A00,106406,Kang; Mingu,0,0,0,0
1668155202817,CSE 249B,A00,102388,Kahng; Andrew Byun,0,0,8,8
1668155203244,CSE 251B,A01,102392,Cottrell; Garrison W,0,0,0,0
1668155203244,CSE 251B,A02,102393,Cottrell; Garrison W,0,0,0,0
1668155203669,CSE 252B,A00,102394,Ochoa; Benjamin Lawrence,0,0,0,0
1668155204094,CSE 257,A01,102396,Gao; Sicun,0,0,0,0
1668155204518,CSE 272,A00,102397,Li; Tzumao,0,0,0,0
1668155204945,CSE 274,A00,111323,Chern; Albert Ren-Haur,0,0,0,0
1668155205369,CSE 282,A00,102398,Pevzner; Pavel Arkadjevich,0,0,0,0
1668155205796,CSE 284,A00,114175,Gymrek; Melissa Ann,0,0,0,0
1668155206220,CSE 290,A00,102399,Chandraker; Manmohan Krishna,0,0,0,0
1668155206220,CSE 290,B00,102400,Vaccaro; Kristen Marie,0,0,25,25
1668155206220,CSE 290,C00,102414,Pannuto; Patrick William,0,0,25,25
1668155206220,CSE 290,D00,102427,Pevzner; Pavel Arkadjevich,0,0,0,0
1668155206220,CSE 290,E00,102429,Zhao; Jishen,0,0,0,0
1668155206220,CSE 290,F00,102436,Tullsen; Dean Michael,0,0,0,0
1668155206220,CSE 290,G00,102440,Christensen; Henrik I,0,0,20,20
1668155206645,CSE 291,A00,102443,Su; Hao,0,0,0,0
1668155206645,CSE 291,B00,102448,Polikarpova; Nadezhda,0,0,0,0
1668155206645,CSE 291,C00,102453,Vaccaro; Kristen Marie,0,0,0,0
1668155206645,CSE 291,D00,111343,Savage; Stefan,0,0,0,0
1668155206645,CSE 291,E00,116474,Claffy; Kimberly Claire,0,0,0,0
1668155206645,CSE 291,F00,116479,Pasquale; Joseph,0,0,0,0
1668155207111,CSE 293,001,119111,Bafna; Vineet,9999,0,9999,0
1668155207111,CSE 293,002,119118,Bellare; Mihir,9999,0,9999,0
1668155207111,CSE 293,003,119122,Berg-Kirkpatrick; Taylor D,9999,0,9999,0
1668155207111,CSE 293,004,119135,Christensen; Henrik I,9999,0,9999,0
1668155207111,CSE 293,005,119142,Cottrell; Garrison W,9999,0,9999,0
1668155207111,CSE 293,006,119146,Deutsch; Alin Bernard,9999,0,9999,0
1668155207111,CSE 293,007,119159,Esmaeilzadeh; Hadi,9999,0,9999,0
1668155207111,CSE 293,008,119166,Freund; Yoav,9999,0,9999,0
1668155207111,CSE 293,009,119170,Griswold; William G.,9999,0,9999,0
1668155207111,CSE 293,010,119183,Gymrek; Melissa Ann,9999,0,9999,0
1668155207111,CSE 293,011,119190,Heninger; Nadia A,9999,0,9999,0
1668155207111,CSE 293,012,119230,Impagliazzo; Russell,9999,0,9999,0
1668155207111,CSE 293,013,119232,Jhala; Ranjit,9999,0,9999,0
1668155207111,CSE 293,014,119233,Kahng; Andrew Byun,9999,0,9999,0
1668155207111,CSE 293,015,119298,Kane; Daniel Mertz,9999,0,9999,0
1668155207111,CSE 293,016,119299,Kriegman; David J,9999,0,9999,0
1668155207111,CSE 293,017,119300,Kumar; Arun Kumar,9999,0,9999,0
1668155207111,CSE 293,018,119301,Lerner; Sorin,9999,0,9999,0
1668155207111,CSE 293,019,119302,Lovett; Shachar,9999,0,9999,0
1668155207111,CSE 293,020,119303,McAuley; Julian John,9999,0,9999,0
1668155207111,CSE 293,021,119304,Micciancio; Daniele,9999,0,9999,0
1668155207111,CSE 293,022,119367,Orailoglu; Alex,9999,0,9999,0
1668155207111,CSE 293,023,119382,Paturi; Ramamohan,9999,0,9999,0
1668155207111,CSE 293,024,119404,Polikarpova; Nadezhda,9999,0,9999,0
1668155207111,CSE 293,025,119406,Politz; Joseph Gibbs,9999,0,9999,0
1668155207111,CSE 293,026,119411,Porter; George M,9999,0,9999,0
1668155207111,CSE 293,027,119414,Porter; Leonard Emerson,9999,0,9999,0
1668155207111,CSE 293,028,119416,Ramamoorthi; Ravi,9999,0,9999,0
1668155207111,CSE 293,029,119417,Sahoo; Debashis,9999,0,9999,0
1668155207111,CSE 293,030,119420,Saul; Lawrence,9999,0,9999,0
1668155207111,CSE 293,031,119421,Savage; Stefan,9999,0,9999,0
1668155207111,CSE 293,032,119425,Schulze; Jurgen P.,9999,0,9999,0
1668155207111,CSE 293,033,119426,Snoeren; Alex C.,9999,0,9999,0
1668155207111,CSE 293,034,119428,Shang; Jingbo,9999,0,9999,0
1668155207111,CSE 293,035,119430,Stefan; Deian,9999,0,9999,0
1668155207111,CSE 293,036,119431,Su; Hao,9999,0,9999,0
1668155207111,CSE 293,037,119433,Swanson; Steven James,9999,0,9999,0
1668155207111,CSE 293,038,119435,Tullsen; Dean Michael,9999,0,9999,0
1668155207111,CSE 293,039,119483,Voelker; Geoffrey M.,9999,0,9999,0
1668155207111,CSE 293,040,119537,Zhao; Jishen,9999,0,9999,0
1668155207111,CSE 293,041,119538,Zhou; Yuan-Yuan,9999,0,9999,0
1668155207111,CSE 293,042,119539,Gao; Sicun,9999,0,9999,0
1668155207111,CSE 293,043,119540,Weibel; Nadir,9999,0,9999,0
1668155207111,CSE 293,044,119541,Gupta; Rajesh K.,9999,0,9999,0
1668155207111,CSE 293,045,126410,Vaccaro; Kristen Marie,9999,0,9999,0
1668155207111,CSE 293,046,126411,Klemke; Richard,9999,0,9999,0
1668155207534,CSE 294,A00,102459,Voelker; Geoffrey M.,0,0,0,0
1668155207534,CSE 294,B00,111322,Orailoglu; Alex,0,0,0,0
1668155207961,DSE 201,A00,096914,Deutsch; Alin Bernard,30,0,30,0
1668155208386,DSE 210,A00,096915,Dasgupta; Sanjoy,30,0,30,0
1668155208814,DSE 260A,A00,096916,Altintas De Callaf; Ilkay,30,0,30,0
1668155209260,ECE 200,001,103586,Antipa; Nicholas A,9999,0,9999,0
1668155209260,ECE 200,002,103587,Atanasov; Nikolay A.,9999,0,9999,0
1668155209260,ECE 200,003,103588,Bharadia; Dinesh,9999,0,9999,0
1668155209260,ECE 200,004,103589,Cheng; Chung Kuan,9999,0,9999,0
1668155209260,ECE 200,005,103590,Cosman; Pamela C.,9999,0,9999,0
1668155209260,ECE 200,006,103591,Dayeh; Shadi Ahmad,9999,0,9999,0
1668155209260,ECE 200,007,103592,Fainman; Yeshaiahu,9999,0,9999,0
1668155209260,ECE 200,008,103593,Ford; Joseph Earl,9999,0,9999,0
1668155209260,ECE 200,009,103594,Franceschetti; Massimo,9999,0,9999,0
1668155209260,ECE 200,010,103595,Fullerton; Eric E,9999,0,9999,0
1668155209260,ECE 200,011,103596,Galton; Ian A,9999,0,9999,0
1668155209260,ECE 200,012,103597,Gilja; Vikash,9999,0,9999,0
1668155209260,ECE 200,013,103598,Hall; Drew A.,9999,0,9999,0
1668155209260,ECE 200,014,103599,Hsueh; Tzu-Chien,9999,0,9999,0
1668155209260,ECE 200,015,103600,Javidi; Tara,9999,0,9999,0
1668155209260,ECE 200,016,103601,Kahng; Andrew Byun,9999,0,9999,0
1668155209260,ECE 200,017,103602,Kim; Young-Han,9999,0,9999,0
1668155209260,ECE 200,018,103603,Koushanfar; Farinaz,9999,0,9999,0
1668155209260,ECE 200,019,103604,Kuzum; Duygu,9999,0,9999,0
1668155209260,ECE 200,020,103605,Le; Hanh-Phuc,9999,0,9999,0
1668155209260,ECE 200,021,103606,Lin; Bill,9999,0,9999,0
1668155209260,ECE 200,022,103607,Liu; Zhaowei,9998,0,9999,1
1668155209260,ECE 200,023,103608,Lo; Yu-Hwa,9999,0,9999,0
1668155209260,ECE 200,024,103609,Lomakin; Vitaliy,9999,0,9999,0
1668155209260,ECE 200,025,103610,Mercier; Patrick Philip,9999,0,9999,0
1668155209260,ECE 200,026,103611,Meyer; Florian,9999,0,9999,0
1668155209260,ECE 200,027,103612,Milstein; Laurence B.,9999,0,9999,0
1668155209260,ECE 200,028,103613,Mir Arabbaygi; Siavash,9999,0,9999,0
1668155209260,ECE 200,029,103614,Mookherjea; Shayan,9999,0,9999,0
1668155209260,ECE 200,030,103615,Morris; Karcher William,9999,0,9999,0
1668155209260,ECE 200,031,103616,Ng; Tse Nga,9999,0,9999,0
1668155209260,ECE 200,032,103617,Nguyen; Truong Quang,9999,0,9999,0
1668155209260,ECE 200,033,103618,Nomura; Kenji,9999,0,9999,0
1668155209260,ECE 200,034,103619,Orlitsky; Alon,9999,0,9999,0
1668155209260,ECE 200,035,103620,Pal; Piya,9999,0,9999,0
1668155209260,ECE 200,036,103621,Papen; George C.,9999,0,9999,0
1668155209260,ECE 200,037,103622,Radic; Stojan,9999,0,9999,0
1668155209260,ECE 200,038,103623,Rao; Bhaskar D.,9999,0,9999,0
1668155209260,ECE 200,039,103624,Rao; Ramesh R,9999,0,9999,0
1668155209260,ECE 200,040,103625,Rebeiz; Gabriel,9999,0,9999,0
1668155209260,ECE 200,041,103626,Sanford; John R,9999,0,9999,0
1668155209260,ECE 200,042,103627,Siegel; Paul H.,9999,0,9999,0
1668155209260,ECE 200,043,103628,Sievenpiper; Daniel F.,9999,0,9999,0
1668155209260,ECE 200,044,103629,Sworder; David D.,9999,0,9999,0
1668155209260,ECE 200,045,103630,Taur; Yuan,9999,0,9999,0
1668155209260,ECE 200,046,103631,Touri; Behrouz,9999,0,9999,0
1668155209260,ECE 200,047,103632,Trivedi; Mohan M.,9999,0,9999,0
1668155209260,ECE 200,048,103633,Vasconcelos; Nuno,9999,0,9999,0
1668155209260,ECE 200,049,103634,Wang; Xiaolong,9999,0,9999,0
1668155209260,ECE 200,050,103635,Xie; Pengtao,9999,0,9999,0
1668155209260,ECE 200,051,103636,Yip; Michael,9999,0,9999,0
1668155209260,ECE 200,052,103637,Zeger; Kenneth A.,999,0,999,0
1668155209260,ECE 200,053,103638,Zhang; Xinyu,9999,0,9999,0
1668155209260,ECE 200,054,103639,Turakhia; Yatish Girish,9999,0,9999,0
1668155209260,ECE 200,055,103640,Kang; Mingu,9999,0,9999,0
1668155209260,ECE 200,056,103641,Shi; Yuanyuan,9999,0,9999,0
1668155209260,ECE 200,057,103642,Wang; Edward Jay,9999,0,9999,0
1668155209260,ECE 200,058,103643,Zheng; Yang,9999,0,9999,0
1668155209688,ECE 202,A00,103644,Kuzum; Duygu,0,0,0,0
1668155210116,ECE 212BN,A00,103646,Ng; Tse Nga,0,0,0,0
1668155210548,ECE 221,A00,111493,Staff,0,0,0,0
1668155210971,ECE 222B,A00,103647,Lomakin; Vitaliy,0,0,0,0
1668155211398,ECE 230B,A00,103648,Taur; Yuan,0,0,0,0
1668155211820,ECE 238B,A00,103649,Garay; Javier,0,0,0,0
1668155212261,ECE 240B,A00,112900,Fainman; Yeshaiahu,0,0,0,0
1668155212684,ECE 247A,A00,103650,Jokerst; Jesse Vincent,0,0,0,0
1668155213117,ECE 247B,A00,103651,Wang; Joseph,0,0,0,0
1668155213539,ECE 250,A00,103652,Siegel; Paul H.,0,0,0,0
1668155213964,ECE 251A,A00,103654,Rao; Bhaskar D.,0,0,0,0
1668155214388,ECE 257B,A00,103655,Bharadia; Dinesh,0,0,0,0
1668155214809,ECE 258A,A00,103656,Milstein; Laurence B.,0,0,0,0
1668155215233,ECE 260B,A00,103658,Kang; Mingu,0,0,0,0
1668155215657,ECE 264A,A00,103659,Galton; Ian A,0,0,0,0
1668155216082,ECE 265A,A00,103661,Gudem; Prasad S.S.,0,0,0,0
1668155216506,ECE 265D,A00,103662,Gudem; Prasad S.S.,0,0,0,0
1668155216932,ECE 268,A00,103663,Koushanfar; Farinaz,0,0,0,0
1668155217354,ECE 269,A01,103665,Pal; Piya,0,0,0,0
1668155217785,ECE 271B,A00,103666,Vasconcelos; Manuela,0,0,0,0
1668155218208,ECE 276A,A00,103667,Atanasov; Nikolay A.,0,0,0,0
1668155218633,ECE 277,A00,103668,An; Cheolhong,0,0,0,0
1668155219135,ECE 279,A00,117947,Hall; Drew A.,0,0,0,0
1668155219986,ECE 283,A00,103670,Hsueh; Tzu-Chien,0,0,0,0
1668155220415,ECE 284,A00,103671,Turakhia; Yatish Girish,0,0,0,0
1668155220837,ECE 285,A00,103672,Zheng; Yang,0,0,0,0
1668155220837,ECE 285,B00,103673,Sworder; David D.,0,0,0,0
1668155221262,ECE 287,A00,103676,Javidi; Tara,0,0,0,0
1668155221693,MATH 200B,A00,098023,Salehi Golsefidy; Alireza,12,0,15,3
1668155222117,MATH 202B,A00,098024,Rhoades; Brendon Patrick,9,0,15,6
1668155222542,MATH 203B,A00,098025,Oprea; Dragos N.,10,0,15,5
1668155222966,MATH 204B,A00,098026,Sorensen; Claus M,13,0,15,2
1668155223392,MATH 208,A00,098027,Izadi; Elham,7,0,10,3
1668155223815,MATH 209,A00,098028,Pollack; Aaron,10,0,10,0
1668155224238,MATH 211A,A00,112919,Rogalski; Daniel,9,0,10,1
1668155224662,MATH 211B,A00,112920,Seward; Brandon M.,9,0,10,1
1668155225086,MATH 218,A00,098029,Li; Bo,10,0,10,0
1668155225513,MATH 220B,A00,098030,Novak; Jonathan I,11,0,15,4
1668155225938,MATH 221A,A00,098031,Ebenfelt; Peter F,13,0,15,2
1668155226362,MATH 231B,A00,098032,Zlatos; Andrej,12,0,15,3
1668155226786,MATH 240B,A00,098033,Ni; Lei,9,0,15,6
1668155227213,MATH 243,A00,098034,Jekel; David Andrew,10,0,10,0
1668155227637,MATH 245A,A00,098035,Nie; Jiawang,0,0,15,16
1668155228063,MATH 248,A00,098036,Bejenaru; Ioan,10,0,10,0
1668155228487,MATH 250B,A00,098037,Spolaor; Luca,14,0,15,1
1668155228910,MATH 258,A00,098038,Ni; Lei,10,0,10,0
1668155229337,MATH 264B,A00,098041,Rhoades; Brendon Patrick,9,0,15,6
1668155229762,MATH 268,A00,098042,Buss; Samuel R,10,0,10,0
1668155230192,MATH 269,A00,098043,Rhoades; Brendon Patrick,10,0,10,0
1668155230617,MATH 270B,A00,098044,Li; Bo,10,0,15,5
1668155231041,MATH 272B,A00,098045,Holst; Michael J,13,0,15,2
1668155231467,MATH 273A,A00,098046,Tian; Xiaochuan,10,0,15,5
1668155231894,MATH 275,A01,098048,Tian; Xiaochuan,6,0,10,4
1668155232397,MATH 278A,A00,098049,Holst; Michael J,8,0,10,2
1668155232821,MATH 278B,A00,098050,Cloninger; Alexander,10,0,10,0
1668155233245,MATH 278C,A00,098051,Nie; Jiawang,7,0,10,3
1668155233668,MATH 280B,A00,098052,Zheng; Tianyi,10,0,15,5
1668155234091,MATH 281B,A00,098053,Bradic; Jelena,2,0,15,13
1668155234515,MATH 282B,A00,098054,Arias-Castro; Ery,0,0,15,15
1668155234939,MATH 285,A00,098055,Fitzsimmons; Patrick J,0,0,15,17
1668155235365,MATH 287B,A00,098056,Arias-Castro; Ery,2,0,15,13
1668155235792,MATH 288,A00,098057,Agarwal; Pooja,9,0,10,1
1668155235792,MATH 288,B00,098058,Zhang; Danna,8,0,10,2
1668155235792,MATH 288,C00,098059,Williams; Ruth J,10,0,10,0
1668155236220,MATH 290B,A00,098060,Roberts; Justin Deritter,13,0,15,2
1668155236651,MATH 292,A00,098061,Belmont; Eva Kinoshita,10,0,10,0
1668155237074,MATH 295,A00,098062,Suk; Andrew Hoon,48,0,50,2
1668155237497,MATH 296,A00,098063,Novak; Jonathan I,20,0,20,0
1668155237924,MATH 297,001,098064,Gamst; Anthony Collins,9997,0,9999,2
1668155749804,COGS 205,A00,101395,Chiba; Andrea,19,0,20,1
1668155750235,COGS 210B,001,101404,Greene; Deanna Jacquelyn,9998,0,9999,1
1668155750235,COGS 210B,002,101417,Xia; Haijun,9999,0,9999,0
1668155750235,COGS 210B,003,101422,Nitz; Douglas A.,9999,0,9999,0
1668155750235,COGS 210B,004,101423,Hollan; James D.,9998,0,9999,1
1668155750235,COGS 210B,005,101424,Deak; Gedeon O.,9998,0,9999,1
1668155750235,COGS 210B,006,101425,Rossano; Federico,9999,0,9999,0
1668155750658,COGS 211B,A00,101427,Coulson; Seana M,9996,0,9999,3
1668155751178,COGS 220,A00,101428,Hollan; James D.,0,0,25,25
1668155751604,COGS 229,A00,101429,Dow; Steven P,18,0,25,7
1668155752028,COGS 230,A00,101430,Klemmer; Scott R,12,0,17,5
1668155752454,COGS 234,A00,101431,Xia; Haijun,3,0,25,22
1668155752883,COGS 260,A00,101432,Kiyonaga; Anastasia,20,0,25,5
1668155752883,COGS 260,B00,101433,Kirsh; David Joel,16,0,25,9
1668155753311,CSE 202,A00,102371,Impagliazzo; Russell,0,0,0,0
1668155753737,CSE 203B,A01,102373,Cheng; Chung Kuan,0,0,0,0
1668155754168,CSE 208,A00,102374,Micciancio; Daniele,0,0,0,0
1668155754590,CSE 209A,A00,112895,Impagliazzo; Russell,0,0,15,15
1668155755021,CSE 209B,A00,108005,Bellare; Mihir,0,0,0,0
1668155755452,CSE 210,A00,113163,Coblenz; Michael J,0,0,0,0
1668155755877,CSE 219,A00,106111,Dow; Steven P,0,0,20,20
1668155756312,CSE 221,A00,102376,Voelker; Geoffrey M.,0,0,0,0
1668155756738,CSE 224,A01,102378,Porter; George M,0,0,0,0
1668155757162,CSE 229A,A00,102379,Savage; Stefan,0,0,0,0
1668155757630,CSE 229C,A00,102380,Munyaka; Imani N. S.,0,0,0,0
1668155758058,CSE 232B,A00,102382,Deutsch; Alin Bernard,0,0,0,0
1668155758482,CSE 234,A01,112904,Kumar; Arun Kumar,0,0,0,0
1668155758919,CSE 237A,A00,102383,Rosing; Tajana Simunic,0,0,0,0
1668155759344,CSE 239A,A00,102384,Deutsch; Alin Bernard,0,0,0,0
1668155759769,CSE 239B,A00,102385,Polikarpova; Nadezhda,0,0,0,0
1668155760199,CSE 240A,A00,102386,Pannuto; Patrick William,0,0,0,0
1668155760626,CSE 240B,A00,102387,Zhao; Jishen,0,0,0,0
1668155761061,CSE 241A,A00,106406,Kang; Mingu,0,0,0,0
1668155761488,CSE 249B,A00,102388,Kahng; Andrew Byun,0,0,8,8
1668155761913,CSE 251B,A01,102392,Cottrell; Garrison W,0,0,0,0
1668155761913,CSE 251B,A02,102393,Cottrell; Garrison W,0,0,0,0
1668155762347,CSE 252B,A00,102394,Ochoa; Benjamin Lawrence,0,0,0,0
1668155762774,CSE 257,A01,102396,Gao; Sicun,0,0,0,0
1668155763198,CSE 272,A00,102397,Li; Tzumao,0,0,0,0
1668155763623,CSE 274,A00,111323,Chern; Albert Ren-Haur,0,0,0,0
1668155764050,CSE 282,A00,102398,Pevzner; Pavel Arkadjevich,0,0,0,0
1668155764555,CSE 284,A00,114175,Gymrek; Melissa Ann,0,0,0,0
1668155764983,CSE 290,A00,102399,Chandraker; Manmohan Krishna,0,0,0,0
1668155764983,CSE 290,B00,102400,Vaccaro; Kristen Marie,0,0,25,25
1668155764983,CSE 290,C00,102414,Pannuto; Patrick William,0,0,25,25
1668155764983,CSE 290,D00,102427,Pevzner; Pavel Arkadjevich,0,0,0,0
1668155764983,CSE 290,E00,102429,Zhao; Jishen,0,0,0,0
1668155764983,CSE 290,F00,102436,Tullsen; Dean Michael,0,0,0,0
1668155764983,CSE 290,G00,102440,Christensen; Henrik I,0,0,20,20
1668155765418,CSE 291,A00,102443,Su; Hao,0,0,0,0
1668155765418,CSE 291,B00,102448,Polikarpova; Nadezhda,0,0,0,0
1668155765418,CSE 291,C00,102453,Vaccaro; Kristen Marie,0,0,0,0
1668155765418,CSE 291,D00,111343,Savage; Stefan,0,0,0,0
1668155765418,CSE 291,E00,116474,Claffy; Kimberly Claire,0,0,0,0
1668155765418,CSE 291,F00,116479,Pasquale; Joseph,0,0,0,0
1668155765861,CSE 293,001,119111,Bafna; Vineet,9999,0,9999,0
1668155765861,CSE 293,002,119118,Bellare; Mihir,9999,0,9999,0
1668155765861,CSE 293,003,119122,Berg-Kirkpatrick; Taylor D,9999,0,9999,0
1668155765861,CSE 293,004,119135,Christensen; Henrik I,9999,0,9999,0
1668155765861,CSE 293,005,119142,Cottrell; Garrison W,9999,0,9999,0
1668155765861,CSE 293,006,119146,Deutsch; Alin Bernard,9999,0,9999,0
1668155765861,CSE 293,007,119159,Esmaeilzadeh; Hadi,9999,0,9999,0
1668155765861,CSE 293,008,119166,Freund; Yoav,9999,0,9999,0
1668155765861,CSE 293,009,119170,Griswold; William G.,9999,0,9999,0
1668155765861,CSE 293,010,119183,Gymrek; Melissa Ann,9999,0,9999,0
1668155765861,CSE 293,011,119190,Heninger; Nadia A,9999,0,9999,0
1668155765861,CSE 293,012,119230,Impagliazzo; Russell,9999,0,9999,0
1668155765861,CSE 293,013,119232,Jhala; Ranjit,9999,0,9999,0
1668155765861,CSE 293,014,119233,Kahng; Andrew Byun,9999,0,9999,0
1668155765861,CSE 293,015,119298,Kane; Daniel Mertz,9999,0,9999,0
1668155765861,CSE 293,016,119299,Kriegman; David J,9999,0,9999,0
1668155765861,CSE 293,017,119300,Kumar; Arun Kumar,9999,0,9999,0
1668155765861,CSE 293,018,119301,Lerner; Sorin,9999,0,9999,0
1668155765861,CSE 293,019,119302,Lovett; Shachar,9999,0,9999,0
1668155765861,CSE 293,020,119303,McAuley; Julian John,9999,0,9999,0
1668155765861,CSE 293,021,119304,Micciancio; Daniele,9999,0,9999,0
1668155765861,CSE 293,022,119367,Orailoglu; Alex,9999,0,9999,0
1668155765861,CSE 293,023,119382,Paturi; Ramamohan,9999,0,9999,0
1668155765861,CSE 293,024,119404,Polikarpova; Nadezhda,9999,0,9999,0
1668155765861,CSE 293,025,119406,Politz; Joseph Gibbs,9999,0,9999,0
1668155765861,CSE 293,026,119411,Porter; George M,9999,0,9999,0
1668155765861,CSE 293,027,119414,Porter; Leonard Emerson,9999,0,9999,0
1668155765861,CSE 293,028,119416,Ramamoorthi; Ravi,9999,0,9999,0
1668155765861,CSE 293,029,119417,Sahoo; Debashis,9999,0,9999,0
1668155765861,CSE 293,030,119420,Saul; Lawrence,9999,0,9999,0
1668155765861,CSE 293,031,119421,Savage; Stefan,9999,0,9999,0
1668155765861,CSE 293,032,119425,Schulze; Jurgen P.,9999,0,9999,0
1668155765861,CSE 293,033,119426,Snoeren; Alex C.,9999,0,9999,0
1668155765861,CSE 293,034,119428,Shang; Jingbo,9999,0,9999,0
1668155765861,CSE 293,035,119430,Stefan; Deian,9999,0,9999,0
1668155765861,CSE 293,036,119431,Su; Hao,9999,0,9999,0
1668155765861,CSE 293,037,119433,Swanson; Steven James,9999,0,9999,0
1668155765861,CSE 293,038,119435,Tullsen; Dean Michael,9999,0,9999,0
1668155765861,CSE 293,039,119483,Voelker; Geoffrey M.,9999,0,9999,0
1668155765861,CSE 293,040,119537,Zhao; Jishen,9999,0,9999,0
1668155765861,CSE 293,041,119538,Zhou; Yuan-Yuan,9999,0,9999,0
1668155765861,CSE 293,042,119539,Gao; Sicun,9999,0,9999,0
1668155765861,CSE 293,043,119540,Weibel; Nadir,9999,0,9999,0
1668155765861,CSE 293,044,119541,Gupta; Rajesh K.,9999,0,9999,0
1668155765861,CSE 293,045,126410,Vaccaro; Kristen Marie,9999,0,9999,0
1668155765861,CSE 293,046,126411,Klemke; Richard,9999,0,9999,0
1668155766287,CSE 294,A00,102459,Voelker; Geoffrey M.,0,0,0,0
1668155766287,CSE 294,B00,111322,Orailoglu; Alex,0,0,0,0
1668155766713,DSE 201,A00,096914,Deutsch; Alin Bernard,30,0,30,0
1668155767138,DSE 210,A00,096915,Dasgupta; Sanjoy,30,0,30,0
1668155767566,DSE 260A,A00,096916,Altintas De Callaf; Ilkay,30,0,30,0
1668155768024,ECE 200,001,103586,Antipa; Nicholas A,9999,0,9999,0
1668155768024,ECE 200,002,103587,Atanasov; Nikolay A.,9999,0,9999,0
1668155768024,ECE 200,003,103588,Bharadia; Dinesh,9999,0,9999,0
1668155768024,ECE 200,004,103589,Cheng; Chung Kuan,9999,0,9999,0
1668155768024,ECE 200,005,103590,Cosman; Pamela C.,9999,0,9999,0
1668155768024,ECE 200,006,103591,Dayeh; Shadi Ahmad,9999,0,9999,0
1668155768024,ECE 200,007,103592,Fainman; Yeshaiahu,9999,0,9999,0
1668155768024,ECE 200,008,103593,Ford; Joseph Earl,9999,0,9999,0
1668155768024,ECE 200,009,103594,Franceschetti; Massimo,9999,0,9999,0
1668155768024,ECE 200,010,103595,Fullerton; Eric E,9999,0,9999,0
1668155768024,ECE 200,011,103596,Galton; Ian A,9999,0,9999,0
1668155768024,ECE 200,012,103597,Gilja; Vikash,9999,0,9999,0
1668155768024,ECE 200,013,103598,Hall; Drew A.,9999,0,9999,0
1668155768024,ECE 200,014,103599,Hsueh; Tzu-Chien,9999,0,9999,0
1668155768024,ECE 200,015,103600,Javidi; Tara,9999,0,9999,0
1668155768024,ECE 200,016,103601,Kahng; Andrew Byun,9999,0,9999,0
1668155768024,ECE 200,017,103602,Kim; Young-Han,9999,0,9999,0
1668155768024,ECE 200,018,103603,Koushanfar; Farinaz,9999,0,9999,0
1668155768024,ECE 200,019,103604,Kuzum; Duygu,9999,0,9999,0
1668155768024,ECE 200,020,103605,Le; Hanh-Phuc,9999,0,9999,0
1668155768024,ECE 200,021,103606,Lin; Bill,9999,0,9999,0
1668155768024,ECE 200,022,103607,Liu; Zhaowei,9998,0,9999,1
1668155768024,ECE 200,023,103608,Lo; Yu-Hwa,9999,0,9999,0
1668155768024,ECE 200,024,103609,Lomakin; Vitaliy,9999,0,9999,0
1668155768024,ECE 200,025,103610,Mercier; Patrick Philip,9999,0,9999,0
1668155768024,ECE 200,026,103611,Meyer; Florian,9999,0,9999,0
1668155768024,ECE 200,027,103612,Milstein; Laurence B.,9999,0,9999,0
1668155768024,ECE 200,028,103613,Mir Arabbaygi; Siavash,9999,0,9999,0
1668155768024,ECE 200,029,103614,Mookherjea; Shayan,9999,0,9999,0
1668155768024,ECE 200,030,103615,Morris; Karcher William,9999,0,9999,0
1668155768024,ECE 200,031,103616,Ng; Tse Nga,9999,0,9999,0
1668155768024,ECE 200,032,103617,Nguyen; Truong Quang,9999,0,9999,0
1668155768024,ECE 200,033,103618,Nomura; Kenji,9999,0,9999,0
1668155768024,ECE 200,034,103619,Orlitsky; Alon,9999,0,9999,0
1668155768024,ECE 200,035,103620,Pal; Piya,9999,0,9999,0
1668155768024,ECE 200,036,103621,Papen; George C.,9999,0,9999,0
1668155768024,ECE 200,037,103622,Radic; Stojan,9999,0,9999,0
1668155768024,ECE 200,038,103623,Rao; Bhaskar D.,9999,0,9999,0
1668155768024,ECE 200,039,103624,Rao; Ramesh R,9999,0,9999,0
1668155768024,ECE 200,040,103625,Rebeiz; Gabriel,9999,0,9999,0
1668155768024,ECE 200,041,103626,Sanford; John R,9999,0,9999,0
1668155768024,ECE 200,042,103627,Siegel; Paul H.,9999,0,9999,0
1668155768024,ECE 200,043,103628,Sievenpiper; Daniel F.,9999,0,9999,0
1668155768024,ECE 200,044,103629,Sworder; David D.,9999,0,9999,0
1668155768024,ECE 200,045,103630,Taur; Yuan,9999,0,9999,0
1668155768024,ECE 200,046,103631,Touri; Behrouz,9999,0,9999,0
1668155768024,ECE 200,047,103632,Trivedi; Mohan M.,9999,0,9999,0
1668155768024,ECE 200,048,103633,Vasconcelos; Nuno,9999,0,9999,0
1668155768024,ECE 200,049,103634,Wang; Xiaolong,9999,0,9999,0
1668155768024,ECE 200,050,103635,Xie; Pengtao,9999,0,9999,0
1668155768024,ECE 200,051,103636,Yip; Michael,9999,0,9999,0
1668155768024,ECE 200,052,103637,Zeger; Kenneth A.,999,0,999,0
1668155768024,ECE 200,053,103638,Zhang; Xinyu,9999,0,9999,0
1668155768024,ECE 200,054,103639,Turakhia; Yatish Girish,9999,0,9999,0
1668155768024,ECE 200,055,103640,Kang; Mingu,9999,0,9999,0
1668155768024,ECE 200,056,103641,Shi; Yuanyuan,9999,0,9999,0
1668155768024,ECE 200,057,103642,Wang; Edward Jay,9999,0,9999,0
1668155768024,ECE 200,058,103643,Zheng; Yang,9999,0,9999,0
1668155768452,ECE 202,A00,103644,Kuzum; Duygu,0,0,0,0
1668155768878,ECE 212BN,A00,103646,Ng; Tse Nga,0,0,0,0
1668155769301,ECE 221,A00,111493,Staff,0,0,0,0
1668155769726,ECE 222B,A00,103647,Lomakin; Vitaliy,0,0,0,0
1668155770154,ECE 230B,A00,103648,Taur; Yuan,0,0,0,0
1668155770582,ECE 238B,A00,103649,Garay; Javier,0,0,0,0
1668155771006,ECE 240B,A00,112900,Fainman; Yeshaiahu,0,0,0,0
1668155771439,ECE 247A,A00,103650,Jokerst; Jesse Vincent,0,0,0,0
1668155771864,ECE 247B,A00,103651,Wang; Joseph,0,0,0,0
1668155772291,ECE 250,A00,103652,Siegel; Paul H.,0,0,0,0
1668155772721,ECE 251A,A00,103654,Rao; Bhaskar D.,0,0,0,0
1668155773145,ECE 257B,A00,103655,Bharadia; Dinesh,0,0,0,0
1668155773570,ECE 258A,A00,103656,Milstein; Laurence B.,0,0,0,0
1668155773995,ECE 260B,A00,103658,Kang; Mingu,0,0,0,0
1668155774422,ECE 264A,A00,103659,Galton; Ian A,0,0,0,0
1668155774845,ECE 265A,A00,103661,Gudem; Prasad S.S.,0,0,0,0
1668155775268,ECE 265D,A00,103662,Gudem; Prasad S.S.,0,0,0,0
1668155775695,ECE 268,A00,103663,Koushanfar; Farinaz,0,0,0,0
1668155776121,ECE 269,A01,103665,Pal; Piya,0,0,0,0
1668155776545,ECE 271B,A00,103666,Vasconcelos; Manuela,0,0,0,0
1668155776976,ECE 276A,A00,103667,Atanasov; Nikolay A.,0,0,0,0
1668155777400,ECE 277,A00,103668,An; Cheolhong,0,0,0,0
1668155777826,ECE 279,A00,117947,Hall; Drew A.,0,0,0,0
1668155778680,ECE 283,A00,103670,Hsueh; Tzu-Chien,0,0,0,0
1668155779106,ECE 284,A00,103671,Turakhia; Yatish Girish,0,0,0,0
1668155779532,ECE 285,A00,103672,Zheng; Yang,0,0,0,0
1668155779532,ECE 285,B00,103673,Sworder; David D.,0,0,0,0
1668155779958,ECE 287,A00,103676,Javidi; Tara,0,0,0,0
1668155780387,MATH 200B,A00,098023,Salehi Golsefidy; Alireza,12,0,15,3
1668155780815,MATH 202B,A00,098024,Rhoades; Brendon Patrick,9,0,15,6
1668155781254,MATH 203B,A00,098025,Oprea; Dragos N.,10,0,15,5
1668155781682,MATH 204B,A00,098026,Sorensen; Claus M,13,0,15,2
1668155782105,MATH 208,A00,098027,Izadi; Elham,7,0,10,3
1668155782530,MATH 209,A00,098028,Pollack; Aaron,10,0,10,0
1668155782953,MATH 211A,A00,112919,Rogalski; Daniel,9,0,10,1
1668155783379,MATH 211B,A00,112920,Seward; Brandon M.,9,0,10,1
1668155783803,MATH 218,A00,098029,Li; Bo,10,0,10,0
1668155784236,MATH 220B,A00,098030,Novak; Jonathan I,11,0,15,4
1668155784660,MATH 221A,A00,098031,Ebenfelt; Peter F,13,0,15,2
1668155785084,MATH 231B,A00,098032,Zlatos; Andrej,12,0,15,3
1668155785519,MATH 240B,A00,098033,Ni; Lei,9,0,15,6
1668155785950,MATH 243,A00,098034,Jekel; David Andrew,10,0,10,0
1668155786392,MATH 245A,A00,098035,Nie; Jiawang,0,0,15,16
1668155786823,MATH 248,A00,098036,Bejenaru; Ioan,10,0,10,0
1668155787252,MATH 250B,A00,098037,Spolaor; Luca,14,0,15,1
1668155787682,MATH 258,A00,098038,Ni; Lei,10,0,10,0
1668155788108,MATH 264B,A00,098041,Rhoades; Brendon Patrick,9,0,15,6
1668155788532,MATH 268,A00,098042,Buss; Samuel R,10,0,10,0
1668155788955,MATH 269,A00,098043,Rhoades; Brendon Patrick,10,0,10,0
1668155789380,MATH 270B,A00,098044,Li; Bo,10,0,15,5
1668155789805,MATH 272B,A00,098045,Holst; Michael J,13,0,15,2
1668155790236,MATH 273A,A00,098046,Tian; Xiaochuan,10,0,15,5
1668155790661,MATH 275,A01,098048,Tian; Xiaochuan,6,0,10,4
1668155791090,MATH 278A,A00,098049,Holst; Michael J,8,0,10,2
1668155791514,MATH 278B,A00,098050,Cloninger; Alexander,10,0,10,0
1668155791942,MATH 278C,A00,098051,Nie; Jiawang,7,0,10,3
1668155792366,MATH 280B,A00,098052,Zheng; Tianyi,10,0,15,5
1668155792795,MATH 281B,A00,098053,Bradic; Jelena,2,0,15,13
1668155793221,MATH 282B,A00,098054,Arias-Castro; Ery,0,0,15,15
1668155793646,MATH 285,A00,098055,Fitzsimmons; Patrick J,0,0,15,17
1668155794070,MATH 287B,A00,098056,Arias-Castro; Ery,2,0,15,13
1668155794595,MATH 288,A00,098057,Agarwal; Pooja,9,0,10,1
1668155794595,MATH 288,B00,098058,Zhang; Danna,8,0,10,2
1668155794595,MATH 288,C00,098059,Williams; Ruth J,10,0,10,0
1668155795024,MATH 290B,A00,098060,Roberts; Justin Deritter,13,0,15,2
1668155795470,MATH 292,A00,098061,Belmont; Eva Kinoshita,10,0,10,0
1668155795899,MATH 295,A00,098062,Suk; Andrew Hoon,48,0,50,2
1668155796322,MATH 296,A00,098063,Novak; Jonathan I,20,0,20,0
1668155796746,MATH 297,001,098064,Gamst; Anthony Collins,9997,0,9999,2
1668156299492,COGS 205,A00,101395,Chiba; Andrea,19,0,20,1
1668156299924,COGS 210B,001,101404,Greene; Deanna Jacquelyn,9998,0,9999,1
1668156299924,COGS 210B,002,101417,Xia; Haijun,9999,0,9999,0
1668156299924,COGS 210B,003,101422,Nitz; Douglas A.,9999,0,9999,0
1668156299924,COGS 210B,004,101423,Hollan; James D.,9998,0,9999,1
1668156299924,COGS 210B,005,101424,Deak; Gedeon O.,9998,0,9999,1
1668156299924,COGS 210B,006,101425,Rossano; Federico,9999,0,9999,0
1668156300352,COGS 211B,A00,101427,Coulson; Seana M,9996,0,9999,3
1668156300774,COGS 220,A00,101428,Hollan; James D.,0,0,25,25
1668156301201,COGS 229,A00,101429,Dow; Steven P,18,0,25,7
1668156301624,COGS 230,A00,101430,Klemmer; Scott R,12,0,17,5
1668156302047,COGS 234,A00,101431,Xia; Haijun,3,0,25,22
1668156302488,COGS 260,A00,101432,Kiyonaga; Anastasia,20,0,25,5
1668156302488,COGS 260,B00,101433,Kirsh; David Joel,16,0,25,9
1668156302919,CSE 202,A00,102371,Impagliazzo; Russell,0,0,0,0
1668156303348,CSE 203B,A01,102373,Cheng; Chung Kuan,0,0,0,0
1668156303775,CSE 208,A00,102374,Micciancio; Daniele,0,0,0,0
1668156304202,CSE 209A,A00,112895,Impagliazzo; Russell,0,0,15,15
1668156304627,CSE 209B,A00,108005,Bellare; Mihir,0,0,0,0
1668156305051,CSE 210,A00,113163,Coblenz; Michael J,0,0,0,0
1668156305474,CSE 219,A00,106111,Dow; Steven P,0,0,20,20
1668156305898,CSE 221,A00,102376,Voelker; Geoffrey M.,0,0,0,0
1668156306328,CSE 224,A01,102378,Porter; George M,0,0,0,0
1668156306754,CSE 229A,A00,102379,Savage; Stefan,0,0,0,0
1668156307188,CSE 229C,A00,102380,Munyaka; Imani N. S.,0,0,0,0
1668156307622,CSE 232B,A00,102382,Deutsch; Alin Bernard,0,0,0,0
1668156308054,CSE 234,A01,112904,Kumar; Arun Kumar,0,0,0,0
1668156308479,CSE 237A,A00,102383,Rosing; Tajana Simunic,0,0,0,0
1668156308908,CSE 239A,A00,102384,Deutsch; Alin Bernard,0,0,0,0
1668156309332,CSE 239B,A00,102385,Polikarpova; Nadezhda,0,0,0,0
1668156309755,CSE 240A,A00,102386,Pannuto; Patrick William,0,0,0,0
1668156310181,CSE 240B,A00,102387,Zhao; Jishen,0,0,0,0
1668156310607,CSE 241A,A00,106406,Kang; Mingu,0,0,0,0
1668156311034,CSE 249B,A00,102388,Kahng; Andrew Byun,0,0,8,8
1668156311461,CSE 251B,A01,102392,Cottrell; Garrison W,0,0,0,0
1668156311461,CSE 251B,A02,102393,Cottrell; Garrison W,0,0,0,0
1668156311889,CSE 252B,A00,102394,Ochoa; Benjamin Lawrence,0,0,0,0
1668156312314,CSE 257,A01,102396,Gao; Sicun,0,0,0,0
1668156312739,CSE 272,A00,102397,Li; Tzumao,0,0,0,0
1668156313165,CSE 274,A00,111323,Chern; Albert Ren-Haur,0,0,0,0
1668156313590,CSE 282,A00,102398,Pevzner; Pavel Arkadjevich,0,0,0,0
1668156314017,CSE 284,A00,114175,Gymrek; Melissa Ann,0,0,0,0
1668156314443,CSE 290,A00,102399,Chandraker; Manmohan Krishna,0,0,0,0
1668156314443,CSE 290,B00,102400,Vaccaro; Kristen Marie,0,0,25,25
1668156314443,CSE 290,C00,102414,Pannuto; Patrick William,0,0,25,25
1668156314443,CSE 290,D00,102427,Pevzner; Pavel Arkadjevich,0,0,0,0
1668156314443,CSE 290,E00,102429,Zhao; Jishen,0,0,0,0
1668156314443,CSE 290,F00,102436,Tullsen; Dean Michael,0,0,0,0
1668156314443,CSE 290,G00,102440,Christensen; Henrik I,0,0,20,20
1668156314869,CSE 291,A00,102443,Su; Hao,0,0,0,0
1668156314869,CSE 291,B00,102448,Polikarpova; Nadezhda,0,0,0,0
1668156314869,CSE 291,C00,102453,Vaccaro; Kristen Marie,0,0,0,0
1668156314869,CSE 291,D00,111343,Savage; Stefan,0,0,0,0
1668156314869,CSE 291,E00,116474,Claffy; Kimberly Claire,0,0,0,0
1668156314869,CSE 291,F00,116479,Pasquale; Joseph,0,0,0,0
1668156315335,CSE 293,001,119111,Bafna; Vineet,9999,0,9999,0
1668156315335,CSE 293,002,119118,Bellare; Mihir,9999,0,9999,0
1668156315335,CSE 293,003,119122,Berg-Kirkpatrick; Taylor D,9999,0,9999,0
1668156315335,CSE 293,004,119135,Christensen; Henrik I,9999,0,9999,0
1668156315335,CSE 293,005,119142,Cottrell; Garrison W,9999,0,9999,0
1668156315335,CSE 293,006,119146,Deutsch; Alin Bernard,9999,0,9999,0
1668156315335,CSE 293,007,119159,Esmaeilzadeh; Hadi,9999,0,9999,0
1668156315335,CSE 293,008,119166,Freund; Yoav,9999,0,9999,0
1668156315335,CSE 293,009,119170,Griswold; William G.,9999,0,9999,0
1668156315335,CSE 293,010,119183,Gymrek; Melissa Ann,9999,0,9999,0
1668156315335,CSE 293,011,119190,Heninger; Nadia A,9999,0,9999,0
1668156315335,CSE 293,012,119230,Impagliazzo; Russell,9999,0,9999,0
1668156315335,CSE 293,013,119232,Jhala; Ranjit,9999,0,9999,0
1668156315335,CSE 293,014,119233,Kahng; Andrew Byun,9999,0,9999,0
1668156315335,CSE 293,015,119298,Kane; Daniel Mertz,9999,0,9999,0
1668156315335,CSE 293,016,119299,Kriegman; David J,9999,0,9999,0
1668156315335,CSE 293,017,119300,Kumar; Arun Kumar,9999,0,9999,0
1668156315335,CSE 293,018,119301,Lerner; Sorin,9999,0,9999,0
1668156315335,CSE 293,019,119302,Lovett; Shachar,9999,0,9999,0
1668156315335,CSE 293,020,119303,McAuley; Julian John,9999,0,9999,0
1668156315335,CSE 293,021,119304,Micciancio; Daniele,9999,0,9999,0
1668156315335,CSE 293,022,119367,Orailoglu; Alex,9999,0,9999,0
1668156315335,CSE 293,023,119382,Paturi; Ramamohan,9999,0,9999,0
1668156315335,CSE 293,024,119404,Polikarpova; Nadezhda,9999,0,9999,0
1668156315335,CSE 293,025,119406,Politz; Joseph Gibbs,9999,0,9999,0
1668156315335,CSE 293,026,119411,Porter; George M,9999,0,9999,0
1668156315335,CSE 293,027,119414,Porter; Leonard Emerson,9999,0,9999,0
1668156315335,CSE 293,028,119416,Ramamoorthi; Ravi,9999,0,9999,0
1668156315335,CSE 293,029,119417,Sahoo; Debashis,9999,0,9999,0
1668156315335,CSE 293,030,119420,Saul; Lawrence,9999,0,9999,0
1668156315335,CSE 293,031,119421,Savage; Stefan,9999,0,9999,0
1668156315335,CSE 293,032,119425,Schulze; Jurgen P.,9999,0,9999,0
1668156315335,CSE 293,033,119426,Snoeren; Alex C.,9999,0,9999,0
1668156315335,CSE 293,034,119428,Shang; Jingbo,9999,0,9999,0
1668156315335,CSE 293,035,119430,Stefan; Deian,9999,0,9999,0
1668156315335,CSE 293,036,119431,Su; Hao,9999,0,9999,0
1668156315335,CSE 293,037,119433,Swanson; Steven James,9999,0,9999,0
1668156315335,CSE 293,038,119435,Tullsen; Dean Michael,9999,0,9999,0
1668156315335,CSE 293,039,119483,Voelker; Geoffrey M.,9999,0,9999,0
1668156315335,CSE 293,040,119537,Zhao; Jishen,9999,0,9999,0
1668156315335,CSE 293,041,119538,Zhou; Yuan-Yuan,9999,0,9999,0
1668156315335,CSE 293,042,119539,Gao; Sicun,9999,0,9999,0
1668156315335,CSE 293,043,119540,Weibel; Nadir,9999,0,9999,0
1668156315335,CSE 293,044,119541,Gupta; Rajesh K.,9999,0,9999,0
1668156315335,CSE 293,045,126410,Vaccaro; Kristen Marie,9999,0,9999,0
1668156315335,CSE 293,046,126411,Klemke; Richard,9999,0,9999,0
1668156315758,CSE 294,A00,102459,Voelker; Geoffrey M.,0,0,0,0
1668156315758,CSE 294,B00,111322,Orailoglu; Alex,0,0,0,0
1668156316186,DSE 201,A00,096914,Deutsch; Alin Bernard,30,0,30,0
1668156316614,DSE 210,A00,096915,Dasgupta; Sanjoy,30,0,30,0
1668156317050,DSE 260A,A00,096916,Altintas De Callaf; Ilkay,30,0,30,0
1668156317622,ECE 200,001,103586,Antipa; Nicholas A,9999,0,9999,0
1668156317622,ECE 200,002,103587,Atanasov; Nikolay A.,9999,0,9999,0
1668156317622,ECE 200,003,103588,Bharadia; Dinesh,9999,0,9999,0
1668156317622,ECE 200,004,103589,Cheng; Chung Kuan,9999,0,9999,0
1668156317622,ECE 200,005,103590,Cosman; Pamela C.,9999,0,9999,0
1668156317622,ECE 200,006,103591,Dayeh; Shadi Ahmad,9999,0,9999,0
1668156317622,ECE 200,007,103592,Fainman; Yeshaiahu,9999,0,9999,0
1668156317622,ECE 200,008,103593,Ford; Joseph Earl,9999,0,9999,0
1668156317622,ECE 200,009,103594,Franceschetti; Massimo,9999,0,9999,0
1668156317622,ECE 200,010,103595,Fullerton; Eric E,9999,0,9999,0
1668156317622,ECE 200,011,103596,Galton; Ian A,9999,0,9999,0
1668156317622,ECE 200,012,103597,Gilja; Vikash,9999,0,9999,0
1668156317622,ECE 200,013,103598,Hall; Drew A.,9999,0,9999,0
1668156317622,ECE 200,014,103599,Hsueh; Tzu-Chien,9999,0,9999,0
1668156317622,ECE 200,015,103600,Javidi; Tara,9999,0,9999,0
1668156317622,ECE 200,016,103601,Kahng; Andrew Byun,9999,0,9999,0
1668156317622,ECE 200,017,103602,Kim; Young-Han,9999,0,9999,0
1668156317622,ECE 200,018,103603,Koushanfar; Farinaz,9999,0,9999,0
1668156317622,ECE 200,019,103604,Kuzum; Duygu,9999,0,9999,0
1668156317622,ECE 200,020,103605,Le; Hanh-Phuc,9999,0,9999,0
1668156317622,ECE 200,021,103606,Lin; Bill,9999,0,9999,0
1668156317622,ECE 200,022,103607,Liu; Zhaowei,9998,0,9999,1
1668156317622,ECE 200,023,103608,Lo; Yu-Hwa,9999,0,9999,0
1668156317622,ECE 200,024,103609,Lomakin; Vitaliy,9999,0,9999,0
1668156317622,ECE 200,025,103610,Mercier; Patrick Philip,9999,0,9999,0
1668156317622,ECE 200,026,103611,Meyer; Florian,9999,0,9999,0
1668156317622,ECE 200,027,103612,Milstein; Laurence B.,9999,0,9999,0
1668156317622,ECE 200,028,103613,Mir Arabbaygi; Siavash,9999,0,9999,0
1668156317622,ECE 200,029,103614,Mookherjea; Shayan,9999,0,9999,0
1668156317622,ECE 200,030,103615,Morris; Karcher William,9999,0,9999,0
1668156317622,ECE 200,031,103616,Ng; Tse Nga,9999,0,9999,0
1668156317622,ECE 200,032,103617,Nguyen; Truong Quang,9999,0,9999,0
1668156317622,ECE 200,033,103618,Nomura; Kenji,9999,0,9999,0
1668156317622,ECE 200,034,103619,Orlitsky; Alon,9999,0,9999,0
1668156317622,ECE 200,035,103620,Pal; Piya,9999,0,9999,0
1668156317622,ECE 200,036,103621,Papen; George C.,9999,0,9999,0
1668156317622,ECE 200,037,103622,Radic; Stojan,9999,0,9999,0
1668156317622,ECE 200,038,103623,Rao; Bhaskar D.,9999,0,9999,0
1668156317622,ECE 200,039,103624,Rao; Ramesh R,9999,0,9999,0
1668156317622,ECE 200,040,103625,Rebeiz; Gabriel,9999,0,9999,0
1668156317622,ECE 200,041,103626,Sanford; John R,9999,0,9999,0
1668156317622,ECE 200,042,103627,Siegel; Paul H.,9999,0,9999,0
1668156317622,ECE 200,043,103628,Sievenpiper; Daniel F.,9999,0,9999,0
1668156317622,ECE 200,044,103629,Sworder; David D.,9999,0,9999,0
1668156317622,ECE 200,045,103630,Taur; Yuan,9999,0,9999,0
1668156317622,ECE 200,046,103631,Touri; Behrouz,9999,0,9999,0
1668156317622,ECE 200,047,103632,Trivedi; Mohan M.,9999,0,9999,0
1668156317622,ECE 200,048,103633,Vasconcelos; Nuno,9999,0,9999,0
1668156317622,ECE 200,049,103634,Wang; Xiaolong,9999,0,9999,0
1668156317622,ECE 200,050,103635,Xie; Pengtao,9999,0,9999,0
1668156317622,ECE 200,051,103636,Yip; Michael,9999,0,9999,0
1668156317622,ECE 200,052,103637,Zeger; Kenneth A.,999,0,999,0
1668156317622,ECE 200,053,103638,Zhang; Xinyu,9999,0,9999,0
1668156317622,ECE 200,054,103639,Turakhia; Yatish Girish,9999,0,9999,0
1668156317622,ECE 200,055,103640,Kang; Mingu,9999,0,9999,0
1668156317622,ECE 200,056,103641,Shi; Yuanyuan,9999,0,9999,0
1668156317622,ECE 200,057,103642,Wang; Edward Jay,9999,0,9999,0
1668156317622,ECE 200,058,103643,Zheng; Yang,9999,0,9999,0
1668156318046,ECE 202,A00,103644,Kuzum; Duygu,0,0,0,0
1668156318469,ECE 212BN,A00,103646,Ng; Tse Nga,0,0,0,0
1668156318894,ECE 221,A00,111493,Staff,0,0,0,0
1668156319322,ECE 222B,A00,103647,Lomakin; Vitaliy,0,0,0,0
1668156319753,ECE 230B,A00,103648,Taur; Yuan,0,0,0,0
1668156320181,ECE 238B,A00,103649,Garay; Javier,0,0,0,0
1668156320616,ECE 240B,A00,112900,Fainman; Yeshaiahu,0,0,0,0
1668156321047,ECE 247A,A00,103650,Jokerst; Jesse Vincent,0,0,0,0
1668156321471,ECE 247B,A00,103651,Wang; Joseph,0,0,0,0
1668156321897,ECE 250,A00,103652,Siegel; Paul H.,0,0,0,0
1668156322325,ECE 251A,A00,103654,Rao; Bhaskar D.,0,0,0,0
1668156322754,ECE 257B,A00,103655,Bharadia; Dinesh,0,0,0,0
1668156323178,ECE 258A,A00,103656,Milstein; Laurence B.,0,0,0,0
1668156323607,ECE 260B,A00,103658,Kang; Mingu,0,0,0,0
1668156324039,ECE 264A,A00,103659,Galton; Ian A,0,0,0,0
1668156324464,ECE 265A,A00,103661,Gudem; Prasad S.S.,0,0,0,0
1668156324889,ECE 265D,A00,103662,Gudem; Prasad S.S.,0,0,0,0
1668156325315,ECE 268,A00,103663,Koushanfar; Farinaz,0,0,0,0
1668156325740,ECE 269,A01,103665,Pal; Piya,0,0,0,0
1668156326164,ECE 271B,A00,103666,Vasconcelos; Manuela,0,0,0,0
1668156326590,ECE 276A,A00,103667,Atanasov; Nikolay A.,0,0,0,0
1668156327021,ECE 277,A00,103668,An; Cheolhong,0,0,0,0
1668156327446,ECE 279,A00,117947,Hall; Drew A.,0,0,0,0
1668156328298,ECE 283,A00,103670,Hsueh; Tzu-Chien,0,0,0,0
1668156328727,ECE 284,A00,103671,Turakhia; Yatish Girish,0,0,0,0
1668156329150,ECE 285,A00,103672,Zheng; Yang,0,0,0,0
1668156329150,ECE 285,B00,103673,Sworder; David D.,0,0,0,0
1668156329577,ECE 287,A00,103676,Javidi; Tara,0,0,0,0
1668156330022,MATH 200B,A00,098023,Salehi Golsefidy; Alireza,12,0,15,3
1668156330453,MATH 202B,A00,098024,Rhoades; Brendon Patrick,9,0,15,6
1668156330880,MATH 203B,A00,098025,Oprea; Dragos N.,10,0,15,5
1668156331306,MATH 204B,A00,098026,Sorensen; Claus M,13,0,15,2
1668156331731,MATH 208,A00,098027,Izadi; Elham,7,0,10,3
1668156332155,MATH 209,A00,098028,Pollack; Aaron,10,0,10,0
1668156332579,MATH 211A,A00,112919,Rogalski; Daniel,9,0,10,1
1668156333009,MATH 211B,A00,112920,Seward; Brandon M.,9,0,10,1
1668156333437,MATH 218,A00,098029,Li; Bo,10,0,10,0
1668156333865,MATH 220B,A00,098030,Novak; Jonathan I,11,0,15,4
1668156334290,MATH 221A,A00,098031,Ebenfelt; Peter F,13,0,15,2
1668156334719,MATH 231B,A00,098032,Zlatos; Andrej,12,0,15,3
1668156335146,MATH 240B,A00,098033,Ni; Lei,9,0,15,6
1668156335569,MATH 243,A00,098034,Jekel; David Andrew,10,0,10,0
1668156335994,MATH 245A,A00,098035,Nie; Jiawang,0,0,15,16
1668156336417,MATH 248,A00,098036,Bejenaru; Ioan,10,0,10,0
1668156336842,MATH 250B,A00,098037,Spolaor; Luca,14,0,15,1
1668156337265,MATH 258,A00,098038,Ni; Lei,10,0,10,0
1668156337689,MATH 264B,A00,098041,Rhoades; Brendon Patrick,9,0,15,6
1668156338115,MATH 268,A00,098042,Buss; Samuel R,10,0,10,0
1668156338545,MATH 269,A00,098043,Rhoades; Brendon Patrick,10,0,10,0
1668156338973,MATH 270B,A00,098044,Li; Bo,10,0,15,5
1668156339407,MATH 272B,A00,098045,Holst; Michael J,13,0,15,2
1668156339836,MATH 273A,A00,098046,Tian; Xiaochuan,10,0,15,5
1668156340265,MATH 275,A01,098048,Tian; Xiaochuan,6,0,10,4
1668156340688,MATH 278A,A00,098049,Holst; Michael J,8,0,10,2
1668156341111,MATH 278B,A00,098050,Cloninger; Alexander,10,0,10,0
1668156341541,MATH 278C,A00,098051,Nie; Jiawang,7,0,10,3
1668156341970,MATH 280B,A00,098052,Zheng; Tianyi,10,0,15,5
1668156342393,MATH 281B,A00,098053,Bradic; Jelena,2,0,15,13
1668156342821,MATH 282B,A00,098054,Arias-Castro; Ery,0,0,15,15
1668156343249,MATH 285,A00,098055,Fitzsimmons; Patrick J,0,0,15,17
1668156343677,MATH 287B,A00,098056,Arias-Castro; Ery,2,0,15,13
1668156344103,MATH 288,A00,098057,Agarwal; Pooja,9,0,10,1
1668156344103,MATH 288,B00,098058,Zhang; Danna,8,0,10,2
1668156344103,MATH 288,C00,098059,Williams; Ruth J,10,0,10,0
1668156344534,MATH 290B,A00,098060,Roberts; Justin Deritter,13,0,15,2
1668156344957,MATH 292,A00,098061,Belmont; Eva Kinoshita,10,0,10,0
1668156345382,MATH 295,A00,098062,Suk; Andrew Hoon,48,0,50,2
1668156345804,MATH 296,A00,098063,Novak; Jonathan I,20,0,20,0
1668156346233,MATH 297,001,098064,Gamst; Anthony Collins,9997,0,9999,2
1668156847044,COGS 205,A00,101395,Chiba; Andrea,19,0,20,1
1668156847472,COGS 210B,001,101404,Greene; Deanna Jacquelyn,9998,0,9999,1
1668156847472,COGS 210B,002,101417,Xia; Haijun,9999,0,9999,0
1668156847472,COGS 210B,003,101422,Nitz; Douglas A.,9999,0,9999,0
1668156847472,COGS 210B,004,101423,Hollan; James D.,9998,0,9999,1
1668156847472,COGS 210B,005,101424,Deak; Gedeon O.,9998,0,9999,1
1668156847472,COGS 210B,006,101425,Rossano; Federico,9999,0,9999,0
1668156847895,COGS 211B,A00,101427,Coulson; Seana M,9996,0,9999,3
1668156848318,COGS 220,A00,101428,Hollan; James D.,0,0,25,25
1668156848742,COGS 229,A00,101429,Dow; Steven P,18,0,25,7
1668156849172,COGS 230,A00,101430,Klemmer; Scott R,12,0,17,5
1668156849596,COGS 234,A00,101431,Xia; Haijun,3,0,25,22
1668156850022,COGS 260,A00,101432,Kiyonaga; Anastasia,20,0,25,5
1668156850022,COGS 260,B00,101433,Kirsh; David Joel,16,0,25,9
1668156850473,CSE 202,A00,102371,Impagliazzo; Russell,0,0,0,0
1668156850902,CSE 203B,A01,102373,Cheng; Chung Kuan,0,0,0,0
1668156851326,CSE 208,A00,102374,Micciancio; Daniele,0,0,0,0
1668156851752,CSE 209A,A00,112895,Impagliazzo; Russell,0,0,15,15
1668156852182,CSE 209B,A00,108005,Bellare; Mihir,0,0,0,0
1668156852611,CSE 210,A00,113163,Coblenz; Michael J,0,0,0,0
1668156853037,CSE 219,A00,106111,Dow; Steven P,0,0,20,20
1668156853465,CSE 221,A00,102376,Voelker; Geoffrey M.,0,0,0,0
1668156853893,CSE 224,A01,102378,Porter; George M,0,0,0,0
1668156854321,CSE 229A,A00,102379,Savage; Stefan,0,0,0,0
1668156854744,CSE 229C,A00,102380,Munyaka; Imani N. S.,0,0,0,0
1668156855171,CSE 232B,A00,102382,Deutsch; Alin Bernard,0,0,0,0
1668156855594,CSE 234,A01,112904,Kumar; Arun Kumar,0,0,0,0
1668156856016,CSE 237A,A00,102383,Rosing; Tajana Simunic,0,0,0,0
1668156856441,CSE 239A,A00,102384,Deutsch; Alin Bernard,0,0,0,0
1668156856867,CSE 239B,A00,102385,Polikarpova; Nadezhda,0,0,0,0
1668156857293,CSE 240A,A00,102386,Pannuto; Patrick William,0,0,0,0
1668156857718,CSE 240B,A00,102387,Zhao; Jishen,0,0,0,0
1668156858142,CSE 241A,A00,106406,Kang; Mingu,0,0,0,0
1668156858565,CSE 249B,A00,102388,Kahng; Andrew Byun,0,0,8,8
1668156858992,CSE 251B,A01,102392,Cottrell; Garrison W,0,0,0,0
1668156858992,CSE 251B,A02,102393,Cottrell; Garrison W,0,0,0,0
1668156859418,CSE 252B,A00,102394,Ochoa; Benjamin Lawrence,0,0,0,0
1668156859846,CSE 257,A01,102396,Gao; Sicun,0,0,0,0
1668156860271,CSE 272,A00,102397,Li; Tzumao,0,0,0,0
1668156860699,CSE 274,A00,111323,Chern; Albert Ren-Haur,0,0,0,0
1668156861125,CSE 282,A00,102398,Pevzner; Pavel Arkadjevich,0,0,0,0
1668156861549,CSE 284,A00,114175,Gymrek; Melissa Ann,0,0,0,0
1668156861979,CSE 290,A00,102399,Chandraker; Manmohan Krishna,0,0,0,0
1668156861979,CSE 290,B00,102400,Vaccaro; Kristen Marie,0,0,25,25
1668156861979,CSE 290,C00,102414,Pannuto; Patrick William,0,0,25,25
1668156861979,CSE 290,D00,102427,Pevzner; Pavel Arkadjevich,0,0,0,0
1668156861979,CSE 290,E00,102429,Zhao; Jishen,0,0,0,0
1668156861979,CSE 290,F00,102436,Tullsen; Dean Michael,0,0,0,0
1668156861979,CSE 290,G00,102440,Christensen; Henrik I,0,0,20,20
1668156862429,CSE 291,A00,102443,Su; Hao,0,0,0,0
1668156862429,CSE 291,B00,102448,Polikarpova; Nadezhda,0,0,0,0
1668156862429,CSE 291,C00,102453,Vaccaro; Kristen Marie,0,0,0,0
1668156862429,CSE 291,D00,111343,Savage; Stefan,0,0,0,0
1668156862429,CSE 291,E00,116474,Claffy; Kimberly Claire,0,0,0,0
1668156862429,CSE 291,F00,116479,Pasquale; Joseph,0,0,0,0
1668156862896,CSE 293,001,119111,Bafna; Vineet,9999,0,9999,0
1668156862896,CSE 293,002,119118,Bellare; Mihir,9999,0,9999,0
1668156862896,CSE 293,003,119122,Berg-Kirkpatrick; Taylor D,9999,0,9999,0
1668156862896,CSE 293,004,119135,Christensen; Henrik I,9999,0,9999,0
1668156862896,CSE 293,005,119142,Cottrell; Garrison W,9999,0,9999,0
1668156862896,CSE 293,006,119146,Deutsch; Alin Bernard,9999,0,9999,0
1668156862896,CSE 293,007,119159,Esmaeilzadeh; Hadi,9999,0,9999,0
1668156862896,CSE 293,008,119166,Freund; Yoav,9999,0,9999,0
1668156862896,CSE 293,009,119170,Griswold; William G.,9999,0,9999,0
1668156862896,CSE 293,010,119183,Gymrek; Melissa Ann,9999,0,9999,0
1668156862896,CSE 293,011,119190,Heninger; Nadia A,9999,0,9999,0
1668156862896,CSE 293,012,119230,Impagliazzo; Russell,9999,0,9999,0
1668156862896,CSE 293,013,119232,Jhala; Ranjit,9999,0,9999,0
1668156862896,CSE 293,014,119233,Kahng; Andrew Byun,9999,0,9999,0
1668156862896,CSE 293,015,119298,Kane; Daniel Mertz,9999,0,9999,0
1668156862896,CSE 293,016,119299,Kriegman; David J,9999,0,9999,0
1668156862896,CSE 293,017,119300,Kumar; Arun Kumar,9999,0,9999,0
1668156862896,CSE 293,018,119301,Lerner; Sorin,9999,0,9999,0
1668156862896,CSE 293,019,119302,Lovett; Shachar,9999,0,9999,0
1668156862896,CSE 293,020,119303,McAuley; Julian John,9999,0,9999,0
1668156862896,CSE 293,021,119304,Micciancio; Daniele,9999,0,9999,0
1668156862896,CSE 293,022,119367,Orailoglu; Alex,9999,0,9999,0
1668156862896,CSE 293,023,119382,Paturi; Ramamohan,9999,0,9999,0
1668156862896,CSE 293,024,119404,Polikarpova; Nadezhda,9999,0,9999,0
1668156862896,CSE 293,025,119406,Politz; Joseph Gibbs,9999,0,9999,0
1668156862896,CSE 293,026,119411,Porter; George M,9999,0,9999,0
1668156862896,CSE 293,027,119414,Porter; Leonard Emerson,9999,0,9999,0
1668156862896,CSE 293,028,119416,Ramamoorthi; Ravi,9999,0,9999,0
1668156862896,CSE 293,029,119417,Sahoo; Debashis,9999,0,9999,0
1668156862896,CSE 293,030,119420,Saul; Lawrence,9999,0,9999,0
1668156862896,CSE 293,031,119421,Savage; Stefan,9999,0,9999,0
1668156862896,CSE 293,032,119425,Schulze; Jurgen P.,9999,0,9999,0
1668156862896,CSE 293,033,119426,Snoeren; Alex C.,9999,0,9999,0
1668156862896,CSE 293,034,119428,Shang; Jingbo,9999,0,9999,0
1668156862896,CSE 293,035,119430,Stefan; Deian,9999,0,9999,0
1668156862896,CSE 293,036,119431,Su; Hao,9999,0,9999,0
1668156862896,CSE 293,037,119433,Swanson; Steven James,9999,0,9999,0
1668156862896,CSE 293,038,119435,Tullsen; Dean Michael,9999,0,9999,0
1668156862896,CSE 293,039,119483,Voelker; Geoffrey M.,9999,0,9999,0
1668156862896,CSE 293,040,119537,Zhao; Jishen,9999,0,9999,0
1668156862896,CSE 293,041,119538,Zhou; Yuan-Yuan,9999,0,9999,0
1668156862896,CSE 293,042,119539,Gao; Sicun,9999,0,9999,0
1668156862896,CSE 293,043,119540,Weibel; Nadir,9999,0,9999,0
1668156862896,CSE 293,044,119541,Gupta; Rajesh K.,9999,0,9999,0
1668156862896,CSE 293,045,126410,Vaccaro; Kristen Marie,9999,0,9999,0
1668156862896,CSE 293,046,126411,Klemke; Richard,9999,0,9999,0
1668156863319,CSE 294,A00,102459,Voelker; Geoffrey M.,0,0,0,0
1668156863319,CSE 294,B00,111322,Orailoglu; Alex,0,0,0,0
1668156863748,DSE 201,A00,096914,Deutsch; Alin Bernard,30,0,30,0
1668156864175,DSE 210,A00,096915,Dasgupta; Sanjoy,30,0,30,0
1668156864601,DSE 260A,A00,096916,Altintas De Callaf; Ilkay,30,0,30,0
1668156865106,ECE 200,001,103586,Antipa; Nicholas A,9999,0,9999,0
1668156865106,ECE 200,002,103587,Atanasov; Nikolay A.,9999,0,9999,0
1668156865106,ECE 200,003,103588,Bharadia; Dinesh,9999,0,9999,0
1668156865106,ECE 200,004,103589,Cheng; Chung Kuan,9999,0,9999,0
1668156865106,ECE 200,005,103590,Cosman; Pamela C.,9999,0,9999,0
1668156865106,ECE 200,006,103591,Dayeh; Shadi Ahmad,9999,0,9999,0
1668156865106,ECE 200,007,103592,Fainman; Yeshaiahu,9999,0,9999,0
1668156865106,ECE 200,008,103593,Ford; Joseph Earl,9999,0,9999,0
1668156865106,ECE 200,009,103594,Franceschetti; Massimo,9999,0,9999,0
1668156865106,ECE 200,010,103595,Fullerton; Eric E,9999,0,9999,0
1668156865106,ECE 200,011,103596,Galton; Ian A,9999,0,9999,0
1668156865106,ECE 200,012,103597,Gilja; Vikash,9999,0,9999,0
1668156865106,ECE 200,013,103598,Hall; Drew A.,9999,0,9999,0
1668156865106,ECE 200,014,103599,Hsueh; Tzu-Chien,9999,0,9999,0
1668156865106,ECE 200,015,103600,Javidi; Tara,9999,0,9999,0
1668156865106,ECE 200,016,103601,Kahng; Andrew Byun,9999,0,9999,0
1668156865106,ECE 200,017,103602,Kim; Young-Han,9999,0,9999,0
1668156865106,ECE 200,018,103603,Koushanfar; Farinaz,9999,0,9999,0
1668156865106,ECE 200,019,103604,Kuzum; Duygu,9999,0,9999,0
1668156865106,ECE 200,020,103605,Le; Hanh-Phuc,9999,0,9999,0
1668156865106,ECE 200,021,103606,Lin; Bill,9999,0,9999,0
1668156865106,ECE 200,022,103607,Liu; Zhaowei,9998,0,9999,1
1668156865106,ECE 200,023,103608,Lo; Yu-Hwa,9999,0,9999,0
1668156865106,ECE 200,024,103609,Lomakin; Vitaliy,9999,0,9999,0
1668156865106,ECE 200,025,103610,Mercier; Patrick Philip,9999,0,9999,0
1668156865106,ECE 200,026,103611,Meyer; Florian,9999,0,9999,0
1668156865106,ECE 200,027,103612,Milstein; Laurence B.,9999,0,9999,0
1668156865106,ECE 200,028,103613,Mir Arabbaygi; Siavash,9999,0,9999,0
1668156865106,ECE 200,029,103614,Mookherjea; Shayan,9999,0,9999,0
1668156865106,ECE 200,030,103615,Morris; Karcher William,9999,0,9999,0
1668156865106,ECE 200,031,103616,Ng; Tse Nga,9999,0,9999,0
1668156865106,ECE 200,032,103617,Nguyen; Truong Quang,9999,0,9999,0
1668156865106,ECE 200,033,103618,Nomura; Kenji,9999,0,9999,0
1668156865106,ECE 200,034,103619,Orlitsky; Alon,9999,0,9999,0
1668156865106,ECE 200,035,103620,Pal; Piya,9999,0,9999,0
1668156865106,ECE 200,036,103621,Papen; George C.,9999,0,9999,0
1668156865106,ECE 200,037,103622,Radic; Stojan,9999,0,9999,0
1668156865106,ECE 200,038,103623,Rao; Bhaskar D.,9999,0,9999,0
1668156865106,ECE 200,039,103624,Rao; Ramesh R,9999,0,9999,0
1668156865106,ECE 200,040,103625,Rebeiz; Gabriel,9999,0,9999,0
1668156865106,ECE 200,041,103626,Sanford; John R,9999,0,9999,0
1668156865106,ECE 200,042,103627,Siegel; Paul H.,9999,0,9999,0
1668156865106,ECE 200,043,103628,Sievenpiper; Daniel F.,9999,0,9999,0
1668156865106,ECE 200,044,103629,Sworder; David D.,9999,0,9999,0
1668156865106,ECE 200,045,103630,Taur; Yuan,9999,0,9999,0
1668156865106,ECE 200,046,103631,Touri; Behrouz,9999,0,9999,0
1668156865106,ECE 200,047,103632,Trivedi; Mohan M.,9999,0,9999,0
1668156865106,ECE 200,048,103633,Vasconcelos; Nuno,9999,0,9999,0
1668156865106,ECE 200,049,103634,Wang; Xiaolong,9999,0,9999,0
1668156865106,ECE 200,050,103635,Xie; Pengtao,9999,0,9999,0
1668156865106,ECE 200,051,103636,Yip; Michael,9999,0,9999,0
1668156865106,ECE 200,052,103637,Zeger; Kenneth A.,999,0,999,0
1668156865106,ECE 200,053,103638,Zhang; Xinyu,9999,0,9999,0
1668156865106,ECE 200,054,103639,Turakhia; Yatish Girish,9999,0,9999,0
1668156865106,ECE 200,055,103640,Kang; Mingu,9999,0,9999,0
1668156865106,ECE 200,056,103641,Shi; Yuanyuan,9999,0,9999,0
1668156865106,ECE 200,057,103642,Wang; Edward Jay,9999,0,9999,0
1668156865106,ECE 200,058,103643,Zheng; Yang,9999,0,9999,0
1668156865535,ECE 202,A00,103644,Kuzum; Duygu,0,0,0,0
1668156865958,ECE 212BN,A00,103646,Ng; Tse Nga,0,0,0,0
1668156866394,ECE 221,A00,111493,Staff,0,0,0,0
1668156866816,ECE 222B,A00,103647,Lomakin; Vitaliy,0,0,0,0
1668156867244,ECE 230B,A00,103648,Taur; Yuan,0,0,0,0
1668156867678,ECE 238B,A00,103649,Garay; Javier,0,0,0,0
1668156868113,ECE 240B,A00,112900,Fainman; Yeshaiahu,0,0,0,0
1668156868537,ECE 247A,A00,103650,Jokerst; Jesse Vincent,0,0,0,0
1668156868960,ECE 247B,A00,103651,Wang; Joseph,0,0,0,0
1668156869382,ECE 250,A00,103652,Siegel; Paul H.,0,0,0,0
1668156869806,ECE 251A,A00,103654,Rao; Bhaskar D.,0,0,0,0
1668156870230,ECE 257B,A00,103655,Bharadia; Dinesh,0,0,0,0
1668156870653,ECE 258A,A00,103656,Milstein; Laurence B.,0,0,0,0
1668156871078,ECE 260B,A00,103658,Kang; Mingu,0,0,0,0
1668156871509,ECE 264A,A00,103659,Galton; Ian A,0,0,0,0
1668156871940,ECE 265A,A00,103661,Gudem; Prasad S.S.,0,0,0,0
1668156872367,ECE 265D,A00,103662,Gudem; Prasad S.S.,0,0,0,0
1668156872796,ECE 268,A00,103663,Koushanfar; Farinaz,0,0,0,0
1668156873225,ECE 269,A01,103665,Pal; Piya,0,0,0,0
1668156873649,ECE 271B,A00,103666,Vasconcelos; Manuela,0,0,0,0
1668156874077,ECE 276A,A00,103667,Atanasov; Nikolay A.,0,0,0,0
1668156874500,ECE 277,A00,103668,An; Cheolhong,0,0,0,0
1668156874927,ECE 279,A00,117947,Hall; Drew A.,0,0,0,0
1668156875778,ECE 283,A00,103670,Hsueh; Tzu-Chien,0,0,0,0
1668156876201,ECE 284,A00,103671,Turakhia; Yatish Girish,0,0,0,0
1668156876624,ECE 285,A00,103672,Zheng; Yang,0,0,0,0
1668156876624,ECE 285,B00,103673,Sworder; David D.,0,0,0,0
1668156877050,ECE 287,A00,103676,Javidi; Tara,0,0,0,0
1668156877475,MATH 200B,A00,098023,Salehi Golsefidy; Alireza,12,0,15,3
1668156877909,MATH 202B,A00,098024,Rhoades; Brendon Patrick,9,0,15,6
1668156878369,MATH 203B,A00,098025,Oprea; Dragos N.,10,0,15,5
1668156878796,MATH 204B,A00,098026,Sorensen; Claus M,13,0,15,2
1668156879222,MATH 208,A00,098027,Izadi; Elham,7,0,10,3
1668156879643,MATH 209,A00,098028,Pollack; Aaron,10,0,10,0
1668156880068,MATH 211A,A00,112919,Rogalski; Daniel,9,0,10,1
1668156880491,MATH 211B,A00,112920,Seward; Brandon M.,9,0,10,1
1668156880919,MATH 218,A00,098029,Li; Bo,10,0,10,0
1668156881345,MATH 220B,A00,098030,Novak; Jonathan I,11,0,15,4
1668156881851,MATH 221A,A00,098031,Ebenfelt; Peter F,13,0,15,2
1668156882288,MATH 231B,A00,098032,Zlatos; Andrej,12,0,15,3
1668156882716,MATH 240B,A00,098033,Ni; Lei,9,0,15,6
1668156883141,MATH 243,A00,098034,Jekel; David Andrew,10,0,10,0
1668156883565,MATH 245A,A00,098035,Nie; Jiawang,0,0,15,16
1668156883990,MATH 248,A00,098036,Bejenaru; Ioan,10,0,10,0
1668156884429,MATH 250B,A00,098037,Spolaor; Luca,14,0,15,1
1668156884852,MATH 258,A00,098038,Ni; Lei,10,0,10,0
1668156885281,MATH 264B,A00,098041,Rhoades; Brendon Patrick,9,0,15,6
1668156885703,MATH 268,A00,098042,Buss; Samuel R,10,0,10,0
1668156886125,MATH 269,A00,098043,Rhoades; Brendon Patrick,10,0,10,0
1668156886554,MATH 270B,A00,098044,Li; Bo,10,0,15,5
1668156886983,MATH 272B,A00,098045,Holst; Michael J,13,0,15,2
1668156887424,MATH 273A,A00,098046,Tian; Xiaochuan,10,0,15,5
1668156887852,MATH 275,A01,098048,Tian; Xiaochuan,6,0,10,4
1668156888280,MATH 278A,A00,098049,Holst; Michael J,8,0,10,2
1668156888711,MATH 278B,A00,098050,Cloninger; Alexander,10,0,10,0
1668156889149,MATH 278C,A00,098051,Nie; Jiawang,7,0,10,3
1668156889573,MATH 280B,A00,098052,Zheng; Tianyi,10,0,15,5
1668156890002,MATH 281B,A00,098053,Bradic; Jelena,2,0,15,13
1668156890432,MATH 282B,A00,098054,Arias-Castro; Ery,0,0,15,15
1668156890855,MATH 285,A00,098055,Fitzsimmons; Patrick J,0,0,15,17
1668156891283,MATH 287B,A00,098056,Arias-Castro; Ery,2,0,15,13
1668156891716,MATH 288,A00,098057,Agarwal; Pooja,9,0,10,1
1668156891716,MATH 288,B00,098058,Zhang; Danna,8,0,10,2
1668156891716,MATH 288,C00,098059,Williams; Ruth J,10,0,10,0
1668156892154,MATH 290B,A00,098060,Roberts; Justin Deritter,13,0,15,2
1668156892580,MATH 292,A00,098061,Belmont; Eva Kinoshita,10,0,10,0
1668156893004,MATH 295,A00,098062,Suk; Andrew Hoon,48,0,50,2
1668156893430,MATH 296,A00,098063,Novak; Jonathan I,20,0,20,0
1668156893854,MATH 297,001,098064,Gamst; Anthony Collins,9997,0,9999,2
1668157394223,COGS 205,A00,101395,Chiba; Andrea,19,0,20,1
1668157394651,COGS 210B,001,101404,Greene; Deanna Jacquelyn,9998,0,9999,1
1668157394651,COGS 210B,002,101417,Xia; Haijun,9999,0,9999,0
1668157394651,COGS 210B,003,101422,Nitz; Douglas A.,9999,0,9999,0
1668157394651,COGS 210B,004,101423,Hollan; James D.,9998,0,9999,1
1668157394651,COGS 210B,005,101424,Deak; Gedeon O.,9998,0,9999,1
1668157394651,COGS 210B,006,101425,Rossano; Federico,9999,0,9999,0
1668157395079,COGS 211B,A00,101427,Coulson; Seana M,9996,0,9999,3
1668157395501,COGS 220,A00,101428,Hollan; James D.,0,0,25,25
1668157395925,COGS 229,A00,101429,Dow; Steven P,18,0,25,7
1668157396351,COGS 230,A00,101430,Klemmer; Scott R,12,0,17,5
1668157396778,COGS 234,A00,101431,Xia; Haijun,3,0,25,22
1668157397207,COGS 260,A00,101432,Kiyonaga; Anastasia,20,0,25,5
1668157397207,COGS 260,B00,101433,Kirsh; David Joel,16,0,25,9
1668157397632,CSE 202,A00,102371,Impagliazzo; Russell,0,0,0,0
1668157398070,CSE 203B,A01,102373,Cheng; Chung Kuan,0,0,0,0
1668157398505,CSE 208,A00,102374,Micciancio; Daniele,0,0,0,0
1668157398929,CSE 209A,A00,112895,Impagliazzo; Russell,0,0,15,15
1668157399353,CSE 209B,A00,108005,Bellare; Mihir,0,0,0,0
1668157399781,CSE 210,A00,113163,Coblenz; Michael J,0,0,0,0
1668157400207,CSE 219,A00,106111,Dow; Steven P,0,0,20,20
1668157400635,CSE 221,A00,102376,Voelker; Geoffrey M.,0,0,0,0
1668157401071,CSE 224,A01,102378,Porter; George M,0,0,0,0
1668157401496,CSE 229A,A00,102379,Savage; Stefan,0,0,0,0
1668157401923,CSE 229C,A00,102380,Munyaka; Imani N. S.,0,0,0,0
1668157402424,CSE 232B,A00,102382,Deutsch; Alin Bernard,0,0,0,0
1668157402847,CSE 234,A01,112904,Kumar; Arun Kumar,0,0,0,0
1668157403284,CSE 237A,A00,102383,Rosing; Tajana Simunic,0,0,0,0
1668157403708,CSE 239A,A00,102384,Deutsch; Alin Bernard,0,0,0,0
1668157404135,CSE 239B,A00,102385,Polikarpova; Nadezhda,0,0,0,0
1668157404563,CSE 240A,A00,102386,Pannuto; Patrick William,0,0,0,0
1668157404990,CSE 240B,A00,102387,Zhao; Jishen,0,0,0,0
1668157405417,CSE 241A,A00,106406,Kang; Mingu,0,0,0,0
1668157405852,CSE 249B,A00,102388,Kahng; Andrew Byun,0,0,8,8
1668157406278,CSE 251B,A01,102392,Cottrell; Garrison W,0,0,0,0
1668157406278,CSE 251B,A02,102393,Cottrell; Garrison W,0,0,0,0
1668157406703,CSE 252B,A00,102394,Ochoa; Benjamin Lawrence,0,0,0,0
1668157407129,CSE 257,A01,102396,Gao; Sicun,0,0,0,0
1668157407553,CSE 272,A00,102397,Li; Tzumao,0,0,0,0
1668157407983,CSE 274,A00,111323,Chern; Albert Ren-Haur,0,0,0,0
1668157408406,CSE 282,A00,102398,Pevzner; Pavel Arkadjevich,0,0,0,0
1668157408835,CSE 284,A00,114175,Gymrek; Melissa Ann,0,0,0,0
1668157409263,CSE 290,A00,102399,Chandraker; Manmohan Krishna,0,0,0,0
1668157409263,CSE 290,B00,102400,Vaccaro; Kristen Marie,0,0,25,25
1668157409263,CSE 290,C00,102414,Pannuto; Patrick William,0,0,25,25
1668157409263,CSE 290,D00,102427,Pevzner; Pavel Arkadjevich,0,0,0,0
1668157409263,CSE 290,E00,102429,Zhao; Jishen,0,0,0,0
1668157409263,CSE 290,F00,102436,Tullsen; Dean Michael,0,0,0,0
1668157409263,CSE 290,G00,102440,Christensen; Henrik I,0,0,20,20
1668157409691,CSE 291,A00,102443,Su; Hao,0,0,0,0
1668157409691,CSE 291,B00,102448,Polikarpova; Nadezhda,0,0,0,0
1668157409691,CSE 291,C00,102453,Vaccaro; Kristen Marie,0,0,0,0
1668157409691,CSE 291,D00,111343,Savage; Stefan,0,0,0,0
1668157409691,CSE 291,E00,116474,Claffy; Kimberly Claire,0,0,0,0
1668157409691,CSE 291,F00,116479,Pasquale; Joseph,0,0,0,0
1668157410133,CSE 293,001,119111,Bafna; Vineet,9999,0,9999,0
1668157410133,CSE 293,002,119118,Bellare; Mihir,9999,0,9999,0
1668157410133,CSE 293,003,119122,Berg-Kirkpatrick; Taylor D,9999,0,9999,0
1668157410133,CSE 293,004,119135,Christensen; Henrik I,9999,0,9999,0
1668157410133,CSE 293,005,119142,Cottrell; Garrison W,9999,0,9999,0
1668157410133,CSE 293,006,119146,Deutsch; Alin Bernard,9999,0,9999,0
1668157410133,CSE 293,007,119159,Esmaeilzadeh; Hadi,9999,0,9999,0
1668157410133,CSE 293,008,119166,Freund; Yoav,9999,0,9999,0
1668157410133,CSE 293,009,119170,Griswold; William G.,9999,0,9999,0
1668157410133,CSE 293,010,119183,Gymrek; Melissa Ann,9999,0,9999,0
1668157410133,CSE 293,011,119190,Heninger; Nadia A,9999,0,9999,0
1668157410133,CSE 293,012,119230,Impagliazzo; Russell,9999,0,9999,0
1668157410133,CSE 293,013,119232,Jhala; Ranjit,9999,0,9999,0
1668157410133,CSE 293,014,119233,Kahng; Andrew Byun,9999,0,9999,0
1668157410133,CSE 293,015,119298,Kane; Daniel Mertz,9999,0,9999,0
1668157410133,CSE 293,016,119299,Kriegman; David J,9999,0,9999,0
1668157410133,CSE 293,017,119300,Kumar; Arun Kumar,9999,0,9999,0
1668157410133,CSE 293,018,119301,Lerner; Sorin,9999,0,9999,0
1668157410133,CSE 293,019,119302,Lovett; Shachar,9999,0,9999,0
1668157410133,CSE 293,020,119303,McAuley; Julian John,9999,0,9999,0
1668157410133,CSE 293,021,119304,Micciancio; Daniele,9999,0,9999,0
1668157410133,CSE 293,022,119367,Orailoglu; Alex,9999,0,9999,0
1668157410133,CSE 293,023,119382,Paturi; Ramamohan,9999,0,9999,0
1668157410133,CSE 293,024,119404,Polikarpova; Nadezhda,9999,0,9999,0
1668157410133,CSE 293,025,119406,Politz; Joseph Gibbs,9999,0,9999,0
1668157410133,CSE 293,026,119411,Porter; George M,9999,0,9999,0
1668157410133,CSE 293,027,119414,Porter; Leonard Emerson,9999,0,9999,0
1668157410133,CSE 293,028,119416,Ramamoorthi; Ravi,9999,0,9999,0
1668157410133,CSE 293,029,119417,Sahoo; Debashis,9999,0,9999,0
1668157410133,CSE 293,030,119420,Saul; Lawrence,9999,0,9999,0
1668157410133,CSE 293,031,119421,Savage; Stefan,9999,0,9999,0
1668157410133,CSE 293,032,119425,Schulze; Jurgen P.,9999,0,9999,0
1668157410133,CSE 293,033,119426,Snoeren; Alex C.,9999,0,9999,0
1668157410133,CSE 293,034,119428,Shang; Jingbo,9999,0,9999,0
1668157410133,CSE 293,035,119430,Stefan; Deian,9999,0,9999,0
1668157410133,CSE 293,036,119431,Su; Hao,9999,0,9999,0
1668157410133,CSE 293,037,119433,Swanson; Steven James,9999,0,9999,0
1668157410133,CSE 293,038,119435,Tullsen; Dean Michael,9999,0,9999,0
1668157410133,CSE 293,039,119483,Voelker; Geoffrey M.,9999,0,9999,0
1668157410133,CSE 293,040,119537,Zhao; Jishen,9999,0,9999,0
1668157410133,CSE 293,041,119538,Zhou; Yuan-Yuan,9999,0,9999,0
1668157410133,CSE 293,042,119539,Gao; Sicun,9999,0,9999,0
1668157410133,CSE 293,043,119540,Weibel; Nadir,9999,0,9999,0
1668157410133,CSE 293,044,119541,Gupta; Rajesh K.,9999,0,9999,0
1668157410133,CSE 293,045,126410,Vaccaro; Kristen Marie,9999,0,9999,0
1668157410133,CSE 293,046,126411,Klemke; Richard,9999,0,9999,0
1668157410559,CSE 294,A00,102459,Voelker; Geoffrey M.,0,0,0,0
1668157410559,CSE 294,B00,111322,Orailoglu; Alex,0,0,0,0
1668157410987,DSE 201,A00,096914,Deutsch; Alin Bernard,30,0,30,0
1668157411411,DSE 210,A00,096915,Dasgupta; Sanjoy,30,0,30,0
1668157411834,DSE 260A,A00,096916,Altintas De Callaf; Ilkay,30,0,30,0
1668157412323,ECE 200,001,103586,Antipa; Nicholas A,9999,0,9999,0
1668157412323,ECE 200,002,103587,Atanasov; Nikolay A.,9999,0,9999,0
1668157412323,ECE 200,003,103588,Bharadia; Dinesh,9999,0,9999,0
1668157412323,ECE 200,004,103589,Cheng; Chung Kuan,9999,0,9999,0
1668157412323,ECE 200,005,103590,Cosman; Pamela C.,9999,0,9999,0
1668157412323,ECE 200,006,103591,Dayeh; Shadi Ahmad,9999,0,9999,0
1668157412323,ECE 200,007,103592,Fainman; Yeshaiahu,9999,0,9999,0
1668157412323,ECE 200,008,103593,Ford; Joseph Earl,9999,0,9999,0
1668157412323,ECE 200,009,103594,Franceschetti; Massimo,9999,0,9999,0
1668157412323,ECE 200,010,103595,Fullerton; Eric E,9999,0,9999,0
1668157412323,ECE 200,011,103596,Galton; Ian A,9999,0,9999,0
1668157412323,ECE 200,012,103597,Gilja; Vikash,9999,0,9999,0
1668157412323,ECE 200,013,103598,Hall; Drew A.,9999,0,9999,0
1668157412323,ECE 200,014,103599,Hsueh; Tzu-Chien,9999,0,9999,0
1668157412323,ECE 200,015,103600,Javidi; Tara,9999,0,9999,0
1668157412323,ECE 200,016,103601,Kahng; Andrew Byun,9999,0,9999,0
1668157412323,ECE 200,017,103602,Kim; Young-Han,9999,0,9999,0
1668157412323,ECE 200,018,103603,Koushanfar; Farinaz,9999,0,9999,0
1668157412323,ECE 200,019,103604,Kuzum; Duygu,9999,0,9999,0
1668157412323,ECE 200,020,103605,Le; Hanh-Phuc,9999,0,9999,0
1668157412323,ECE 200,021,103606,Lin; Bill,9999,0,9999,0
1668157412323,ECE 200,022,103607,Liu; Zhaowei,9998,0,9999,1
1668157412323,ECE 200,023,103608,Lo; Yu-Hwa,9999,0,9999,0
1668157412323,ECE 200,024,103609,Lomakin; Vitaliy,9999,0,9999,0
1668157412323,ECE 200,025,103610,Mercier; Patrick Philip,9999,0,9999,0
1668157412323,ECE 200,026,103611,Meyer; Florian,9999,0,9999,0
1668157412323,ECE 200,027,103612,Milstein; Laurence B.,9999,0,9999,0
1668157412323,ECE 200,028,103613,Mir Arabbaygi; Siavash,9999,0,9999,0
1668157412323,ECE 200,029,103614,Mookherjea; Shayan,9999,0,9999,0
1668157412323,ECE 200,030,103615,Morris; Karcher William,9999,0,9999,0
1668157412323,ECE 200,031,103616,Ng; Tse Nga,9999,0,9999,0
1668157412323,ECE 200,032,103617,Nguyen; Truong Quang,9999,0,9999,0
1668157412323,ECE 200,033,103618,Nomura; Kenji,9999,0,9999,0
1668157412323,ECE 200,034,103619,Orlitsky; Alon,9999,0,9999,0
1668157412323,ECE 200,035,103620,Pal; Piya,9999,0,9999,0
1668157412323,ECE 200,036,103621,Papen; George C.,9999,0,9999,0
1668157412323,ECE 200,037,103622,Radic; Stojan,9999,0,9999,0
1668157412323,ECE 200,038,103623,Rao; Bhaskar D.,9999,0,9999,0
1668157412323,ECE 200,039,103624,Rao; Ramesh R,9999,0,9999,0
1668157412323,ECE 200,040,103625,Rebeiz; Gabriel,9999,0,9999,0
1668157412323,ECE 200,041,103626,Sanford; John R,9999,0,9999,0
1668157412323,ECE 200,042,103627,Siegel; Paul H.,9999,0,9999,0
1668157412323,ECE 200,043,103628,Sievenpiper; Daniel F.,9999,0,9999,0
1668157412323,ECE 200,044,103629,Sworder; David D.,9999,0,9999,0
1668157412323,ECE 200,045,103630,Taur; Yuan,9999,0,9999,0
1668157412323,ECE 200,046,103631,Touri; Behrouz,9999,0,9999,0
1668157412323,ECE 200,047,103632,Trivedi; Mohan M.,9999,0,9999,0
1668157412323,ECE 200,048,103633,Vasconcelos; Nuno,9999,0,9999,0
1668157412323,ECE 200,049,103634,Wang; Xiaolong,9999,0,9999,0
1668157412323,ECE 200,050,103635,Xie; Pengtao,9999,0,9999,0
1668157412323,ECE 200,051,103636,Yip; Michael,9999,0,9999,0
1668157412323,ECE 200,052,103637,Zeger; Kenneth A.,999,0,999,0
1668157412323,ECE 200,053,103638,Zhang; Xinyu,9999,0,9999,0
1668157412323,ECE 200,054,103639,Turakhia; Yatish Girish,9999,0,9999,0
1668157412323,ECE 200,055,103640,Kang; Mingu,9999,0,9999,0
1668157412323,ECE 200,056,103641,Shi; Yuanyuan,9999,0,9999,0
1668157412323,ECE 200,057,103642,Wang; Edward Jay,9999,0,9999,0
1668157412323,ECE 200,058,103643,Zheng; Yang,9999,0,9999,0
1668157412753,ECE 202,A00,103644,Kuzum; Duygu,0,0,0,0
1668157413177,ECE 212BN,A00,103646,Ng; Tse Nga,0,0,0,0
1668157413605,ECE 221,A00,111493,Staff,0,0,0,0
1668157414027,ECE 222B,A00,103647,Lomakin; Vitaliy,0,0,0,0
1668157414454,ECE 230B,A00,103648,Taur; Yuan,0,0,0,0
1668157414887,ECE 238B,A00,103649,Garay; Javier,0,0,0,0
1668157415310,ECE 240B,A00,112900,Fainman; Yeshaiahu,0,0,0,0
1668157415734,ECE 247A,A00,103650,Jokerst; Jesse Vincent,0,0,0,0
1668157416163,ECE 247B,A00,103651,Wang; Joseph,0,0,0,0
1668157416589,ECE 250,A00,103652,Siegel; Paul H.,0,0,0,0
1668157417014,ECE 251A,A00,103654,Rao; Bhaskar D.,0,0,0,0
1668157417443,ECE 257B,A00,103655,Bharadia; Dinesh,0,0,0,0
1668157417865,ECE 258A,A00,103656,Milstein; Laurence B.,0,0,0,0
1668157418292,ECE 260B,A00,103658,Kang; Mingu,0,0,0,0
1668157418751,ECE 264A,A00,103659,Galton; Ian A,0,0,0,0
1668157419182,ECE 265A,A00,103661,Gudem; Prasad S.S.,0,0,0,0
1668157419607,ECE 265D,A00,103662,Gudem; Prasad S.S.,0,0,0,0
1668157420034,ECE 268,A00,103663,Koushanfar; Farinaz,0,0,0,0
1668157420461,ECE 269,A01,103665,Pal; Piya,0,0,0,0
1668157420890,ECE 271B,A00,103666,Vasconcelos; Manuela,0,0,0,0
1668157421315,ECE 276A,A00,103667,Atanasov; Nikolay A.,0,0,0,0
1668157421739,ECE 277,A00,103668,An; Cheolhong,0,0,0,0
1668157422163,ECE 279,A00,117947,Hall; Drew A.,0,0,0,0
1668157423015,ECE 283,A00,103670,Hsueh; Tzu-Chien,0,0,0,0
1668157423440,ECE 284,A00,103671,Turakhia; Yatish Girish,0,0,0,0
1668157423865,ECE 285,A00,103672,Zheng; Yang,0,0,0,0
1668157423865,ECE 285,B00,103673,Sworder; David D.,0,0,0,0
1668157424292,ECE 287,A00,103676,Javidi; Tara,0,0,0,0
1668157424717,MATH 200B,A00,098023,Salehi Golsefidy; Alireza,12,0,15,3
1668157425146,MATH 202B,A00,098024,Rhoades; Brendon Patrick,9,0,15,6
1668157425572,MATH 203B,A00,098025,Oprea; Dragos N.,10,0,15,5
1668157425997,MATH 204B,A00,098026,Sorensen; Claus M,13,0,15,2
1668157426422,MATH 208,A00,098027,Izadi; Elham,7,0,10,3
1668157426846,MATH 209,A00,098028,Pollack; Aaron,10,0,10,0
1668157427272,MATH 211A,A00,112919,Rogalski; Daniel,9,0,10,1
1668157427699,MATH 211B,A00,112920,Seward; Brandon M.,9,0,10,1
1668157428125,MATH 218,A00,098029,Li; Bo,10,0,10,0
1668157428550,MATH 220B,A00,098030,Novak; Jonathan I,11,0,15,4
1668157428978,MATH 221A,A00,098031,Ebenfelt; Peter F,13,0,15,2
1668157429404,MATH 231B,A00,098032,Zlatos; Andrej,12,0,15,3
1668157429837,MATH 240B,A00,098033,Ni; Lei,9,0,15,6
1668157430263,MATH 243,A00,098034,Jekel; David Andrew,10,0,10,0
1668157430690,MATH 245A,A00,098035,Nie; Jiawang,0,0,15,16
1668157431116,MATH 248,A00,098036,Bejenaru; Ioan,10,0,10,0
1668157431543,MATH 250B,A00,098037,Spolaor; Luca,14,0,15,1
1668157431967,MATH 258,A00,098038,Ni; Lei,10,0,10,0
1668157432395,MATH 264B,A00,098041,Rhoades; Brendon Patrick,9,0,15,6
1668157432819,MATH 268,A00,098042,Buss; Samuel R,10,0,10,0
1668157433249,MATH 269,A00,098043,Rhoades; Brendon Patrick,10,0,10,0
1668157433677,MATH 270B,A00,098044,Li; Bo,10,0,15,5
1668157434103,MATH 272B,A00,098045,Holst; Michael J,13,0,15,2
1668157434530,MATH 273A,A00,098046,Tian; Xiaochuan,10,0,15,5
1668157434955,MATH 275,A01,098048,Tian; Xiaochuan,6,0,10,4
1668157435383,MATH 278A,A00,098049,Holst; Michael J,8,0,10,2
1668157435809,MATH 278B,A00,098050,Cloninger; Alexander,10,0,10,0
1668157436234,MATH 278C,A00,098051,Nie; Jiawang,7,0,10,3
1668157436660,MATH 280B,A00,098052,Zheng; Tianyi,10,0,15,5
1668157437086,MATH 281B,A00,098053,Bradic; Jelena,2,0,15,13
1668157437509,MATH 282B,A00,098054,Arias-Castro; Ery,0,0,15,15
1668157437935,MATH 285,A00,098055,Fitzsimmons; Patrick J,0,0,15,17
1668157438362,MATH 287B,A00,098056,Arias-Castro; Ery,2,0,15,13
1668157438789,MATH 288,A00,098057,Agarwal; Pooja,9,0,10,1
1668157438789,MATH 288,B00,098058,Zhang; Danna,8,0,10,2
1668157438789,MATH 288,C00,098059,Williams; Ruth J,10,0,10,0
1668157439214,MATH 290B,A00,098060,Roberts; Justin Deritter,13,0,15,2
1668157439640,MATH 292,A00,098061,Belmont; Eva Kinoshita,10,0,10,0
1668157440064,MATH 295,A00,098062,Suk; Andrew Hoon,48,0,50,2
1668157440489,MATH 296,A00,098063,Novak; Jonathan I,20,0,20,0
1668157440923,MATH 297,001,098064,Gamst; Anthony Collins,9997,0,9999,2
1668157941645,COGS 205,A00,101395,Chiba; Andrea,19,0,20,1
1668157942081,COGS 210B,001,101404,Greene; Deanna Jacquelyn,9998,0,9999,1
1668157942081,COGS 210B,002,101417,Xia; Haijun,9999,0,9999,0
1668157942081,COGS 210B,003,101422,Nitz; Douglas A.,9999,0,9999,0
1668157942081,COGS 210B,004,101423,Hollan; James D.,9998,0,9999,1
1668157942081,COGS 210B,005,101424,Deak; Gedeon O.,9998,0,9999,1
1668157942081,COGS 210B,006,101425,Rossano; Federico,9999,0,9999,0
1668157942509,COGS 211B,A00,101427,Coulson; Seana M,9996,0,9999,3
1668157942937,COGS 220,A00,101428,Hollan; James D.,0,0,25,25
1668157943366,COGS 229,A00,101429,Dow; Steven P,18,0,25,7
1668157943792,COGS 230,A00,101430,Klemmer; Scott R,12,0,17,5
1668157944223,COGS 234,A00,101431,Xia; Haijun,3,0,25,22
1668157944649,COGS 260,A00,101432,Kiyonaga; Anastasia,20,0,25,5
1668157944649,COGS 260,B00,101433,Kirsh; David Joel,16,0,25,9
1668157945075,CSE 202,A00,102371,Impagliazzo; Russell,0,0,0,0
1668157945501,CSE 203B,A01,102373,Cheng; Chung Kuan,0,0,0,0
1668157945926,CSE 208,A00,102374,Micciancio; Daniele,0,0,0,0
1668157946352,CSE 209A,A00,112895,Impagliazzo; Russell,0,0,15,15
1668157946780,CSE 209B,A00,108005,Bellare; Mihir,0,0,0,0
1668157947206,CSE 210,A00,113163,Coblenz; Michael J,0,0,0,0
1668157947637,CSE 219,A00,106111,Dow; Steven P,0,0,20,20
1668157948061,CSE 221,A00,102376,Voelker; Geoffrey M.,0,0,0,0
1668157948485,CSE 224,A01,102378,Porter; George M,0,0,0,0
1668157948915,CSE 229A,A00,102379,Savage; Stefan,0,0,0,0
1668157949343,CSE 229C,A00,102380,Munyaka; Imani N. S.,0,0,0,0
1668157949766,CSE 232B,A00,102382,Deutsch; Alin Bernard,0,0,0,0
1668157950191,CSE 234,A01,112904,Kumar; Arun Kumar,0,0,0,0
1668157950615,CSE 237A,A00,102383,Rosing; Tajana Simunic,0,0,0,0
1668157951041,CSE 239A,A00,102384,Deutsch; Alin Bernard,0,0,0,0
1668157951468,CSE 239B,A00,102385,Polikarpova; Nadezhda,0,0,0,0
1668157951896,CSE 240A,A00,102386,Pannuto; Patrick William,0,0,0,0
1668157952322,CSE 240B,A00,102387,Zhao; Jishen,0,0,0,0
1668157952753,CSE 241A,A00,106406,Kang; Mingu,0,0,0,0
1668157953181,CSE 249B,A00,102388,Kahng; Andrew Byun,0,0,8,8
1668157953606,CSE 251B,A01,102392,Cottrell; Garrison W,0,0,0,0
1668157953606,CSE 251B,A02,102393,Cottrell; Garrison W,0,0,0,0
1668157954037,CSE 252B,A00,102394,Ochoa; Benjamin Lawrence,0,0,0,0
1668157954461,CSE 257,A01,102396,Gao; Sicun,0,0,0,0
1668157954885,CSE 272,A00,102397,Li; Tzumao,0,0,0,0
1668157955315,CSE 274,A00,111323,Chern; Albert Ren-Haur,0,0,0,0
1668157955739,CSE 282,A00,102398,Pevzner; Pavel Arkadjevich,0,0,0,0
1668157956169,CSE 284,A00,114175,Gymrek; Melissa Ann,0,0,0,0
1668157956602,CSE 290,A00,102399,Chandraker; Manmohan Krishna,0,0,0,0
1668157956602,CSE 290,B00,102400,Vaccaro; Kristen Marie,0,0,25,25
1668157956602,CSE 290,C00,102414,Pannuto; Patrick William,0,0,25,25
1668157956602,CSE 290,D00,102427,Pevzner; Pavel Arkadjevich,0,0,0,0
1668157956602,CSE 290,E00,102429,Zhao; Jishen,0,0,0,0
1668157956602,CSE 290,F00,102436,Tullsen; Dean Michael,0,0,0,0
1668157956602,CSE 290,G00,102440,Christensen; Henrik I,0,0,20,20
1668157957033,CSE 291,A00,102443,Su; Hao,0,0,0,0
1668157957033,CSE 291,B00,102448,Polikarpova; Nadezhda,0,0,0,0
1668157957033,CSE 291,C00,102453,Vaccaro; Kristen Marie,0,0,0,0
1668157957033,CSE 291,D00,111343,Savage; Stefan,0,0,0,0
1668157957033,CSE 291,E00,116474,Claffy; Kimberly Claire,0,0,0,0
1668157957033,CSE 291,F00,116479,Pasquale; Joseph,0,0,0,0
1668157957481,CSE 293,001,119111,Bafna; Vineet,9999,0,9999,0
1668157957481,CSE 293,002,119118,Bellare; Mihir,9999,0,9999,0
1668157957481,CSE 293,003,119122,Berg-Kirkpatrick; Taylor D,9999,0,9999,0
1668157957481,CSE 293,004,119135,Christensen; Henrik I,9999,0,9999,0
1668157957481,CSE 293,005,119142,Cottrell; Garrison W,9999,0,9999,0
1668157957481,CSE 293,006,119146,Deutsch; Alin Bernard,9999,0,9999,0
1668157957481,CSE 293,007,119159,Esmaeilzadeh; Hadi,9999,0,9999,0
1668157957481,CSE 293,008,119166,Freund; Yoav,9999,0,9999,0
1668157957481,CSE 293,009,119170,Griswold; William G.,9999,0,9999,0
1668157957481,CSE 293,010,119183,Gymrek; Melissa Ann,9999,0,9999,0
1668157957481,CSE 293,011,119190,Heninger; Nadia A,9999,0,9999,0
1668157957481,CSE 293,012,119230,Impagliazzo; Russell,9999,0,9999,0
1668157957481,CSE 293,013,119232,Jhala; Ranjit,9999,0,9999,0
1668157957481,CSE 293,014,119233,Kahng; Andrew Byun,9999,0,9999,0
1668157957481,CSE 293,015,119298,Kane; Daniel Mertz,9999,0,9999,0
1668157957481,CSE 293,016,119299,Kriegman; David J,9999,0,9999,0
1668157957481,CSE 293,017,119300,Kumar; Arun Kumar,9999,0,9999,0
1668157957481,CSE 293,018,119301,Lerner; Sorin,9999,0,9999,0
1668157957481,CSE 293,019,119302,Lovett; Shachar,9999,0,9999,0
1668157957481,CSE 293,020,119303,McAuley; Julian John,9999,0,9999,0
1668157957481,CSE 293,021,119304,Micciancio; Daniele,9999,0,9999,0
1668157957481,CSE 293,022,119367,Orailoglu; Alex,9999,0,9999,0
1668157957481,CSE 293,023,119382,Paturi; Ramamohan,9999,0,9999,0
1668157957481,CSE 293,024,119404,Polikarpova; Nadezhda,9999,0,9999,0
1668157957481,CSE 293,025,119406,Politz; Joseph Gibbs,9999,0,9999,0
1668157957481,CSE 293,026,119411,Porter; George M,9999,0,9999,0
1668157957481,CSE 293,027,119414,Porter; Leonard Emerson,9999,0,9999,0
1668157957481,CSE 293,028,119416,Ramamoorthi; Ravi,9999,0,9999,0
1668157957481,CSE 293,029,119417,Sahoo; Debashis,9999,0,9999,0
1668157957481,CSE 293,030,119420,Saul; Lawrence,9999,0,9999,0
1668157957481,CSE 293,031,119421,Savage; Stefan,9999,0,9999,0
1668157957481,CSE 293,032,119425,Schulze; Jurgen P.,9999,0,9999,0
1668157957481,CSE 293,033,119426,Snoeren; Alex C.,9999,0,9999,0
1668157957481,CSE 293,034,119428,Shang; Jingbo,9999,0,9999,0
1668157957481,CSE 293,035,119430,Stefan; Deian,9999,0,9999,0
1668157957481,CSE 293,036,119431,Su; Hao,9999,0,9999,0
1668157957481,CSE 293,037,119433,Swanson; Steven James,9999,0,9999,0
1668157957481,CSE 293,038,119435,Tullsen; Dean Michael,9999,0,9999,0
1668157957481,CSE 293,039,119483,Voelker; Geoffrey M.,9999,0,9999,0
1668157957481,CSE 293,040,119537,Zhao; Jishen,9999,0,9999,0
1668157957481,CSE 293,041,119538,Zhou; Yuan-Yuan,9999,0,9999,0
1668157957481,CSE 293,042,119539,Gao; Sicun,9999,0,9999,0
1668157957481,CSE 293,043,119540,Weibel; Nadir,9999,0,9999,0
1668157957481,CSE 293,044,119541,Gupta; Rajesh K.,9999,0,9999,0
1668157957481,CSE 293,045,126410,Vaccaro; Kristen Marie,9999,0,9999,0
1668157957481,CSE 293,046,126411,Klemke; Richard,9999,0,9999,0
1668157957910,CSE 294,A00,102459,Voelker; Geoffrey M.,0,0,0,0
1668157957910,CSE 294,B00,111322,Orailoglu; Alex,0,0,0,0
1668157958336,DSE 201,A00,096914,Deutsch; Alin Bernard,30,0,30,0
1668157958759,DSE 210,A00,096915,Dasgupta; Sanjoy,30,0,30,0
1668157959183,DSE 260A,A00,096916,Altintas De Callaf; Ilkay,30,0,30,0
1668157959642,ECE 200,001,103586,Antipa; Nicholas A,9999,0,9999,0
1668157959642,ECE 200,002,103587,Atanasov; Nikolay A.,9999,0,9999,0
1668157959642,ECE 200,003,103588,Bharadia; Dinesh,9999,0,9999,0
1668157959642,ECE 200,004,103589,Cheng; Chung Kuan,9999,0,9999,0
1668157959642,ECE 200,005,103590,Cosman; Pamela C.,9999,0,9999,0
1668157959642,ECE 200,006,103591,Dayeh; Shadi Ahmad,9999,0,9999,0
1668157959642,ECE 200,007,103592,Fainman; Yeshaiahu,9999,0,9999,0
1668157959642,ECE 200,008,103593,Ford; Joseph Earl,9999,0,9999,0
1668157959642,ECE 200,009,103594,Franceschetti; Massimo,9999,0,9999,0
1668157959642,ECE 200,010,103595,Fullerton; Eric E,9999,0,9999,0
1668157959642,ECE 200,011,103596,Galton; Ian A,9999,0,9999,0
1668157959642,ECE 200,012,103597,Gilja; Vikash,9999,0,9999,0
1668157959642,ECE 200,013,103598,Hall; Drew A.,9999,0,9999,0
1668157959642,ECE 200,014,103599,Hsueh; Tzu-Chien,9999,0,9999,0
1668157959642,ECE 200,015,103600,Javidi; Tara,9999,0,9999,0
1668157959642,ECE 200,016,103601,Kahng; Andrew Byun,9999,0,9999,0
1668157959642,ECE 200,017,103602,Kim; Young-Han,9999,0,9999,0
1668157959642,ECE 200,018,103603,Koushanfar; Farinaz,9999,0,9999,0
1668157959642,ECE 200,019,103604,Kuzum; Duygu,9999,0,9999,0
1668157959642,ECE 200,020,103605,Le; Hanh-Phuc,9999,0,9999,0
1668157959642,ECE 200,021,103606,Lin; Bill,9999,0,9999,0
1668157959642,ECE 200,022,103607,Liu; Zhaowei,9998,0,9999,1
1668157959642,ECE 200,023,103608,Lo; Yu-Hwa,9999,0,9999,0
1668157959642,ECE 200,024,103609,Lomakin; Vitaliy,9999,0,9999,0
1668157959642,ECE 200,025,103610,Mercier; Patrick Philip,9999,0,9999,0
1668157959642,ECE 200,026,103611,Meyer; Florian,9999,0,9999,0
1668157959642,ECE 200,027,103612,Milstein; Laurence B.,9999,0,9999,0
1668157959642,ECE 200,028,103613,Mir Arabbaygi; Siavash,9999,0,9999,0
1668157959642,ECE 200,029,103614,Mookherjea; Shayan,9999,0,9999,0
1668157959642,ECE 200,030,103615,Morris; Karcher William,9999,0,9999,0
1668157959642,ECE 200,031,103616,Ng; Tse Nga,9999,0,9999,0
1668157959642,ECE 200,032,103617,Nguyen; Truong Quang,9999,0,9999,0
1668157959642,ECE 200,033,103618,Nomura; Kenji,9999,0,9999,0
1668157959642,ECE 200,034,103619,Orlitsky; Alon,9999,0,9999,0
1668157959642,ECE 200,035,103620,Pal; Piya,9999,0,9999,0
1668157959642,ECE 200,036,103621,Papen; George C.,9999,0,9999,0
1668157959642,ECE 200,037,103622,Radic; Stojan,9999,0,9999,0
1668157959642,ECE 200,038,103623,Rao; Bhaskar D.,9999,0,9999,0
1668157959642,ECE 200,039,103624,Rao; Ramesh R,9999,0,9999,0
1668157959642,ECE 200,040,103625,Rebeiz; Gabriel,9999,0,9999,0
1668157959642,ECE 200,041,103626,Sanford; John R,9999,0,9999,0
1668157959642,ECE 200,042,103627,Siegel; Paul H.,9999,0,9999,0
1668157959642,ECE 200,043,103628,Sievenpiper; Daniel F.,9999,0,9999,0
1668157959642,ECE 200,044,103629,Sworder; David D.,9999,0,9999,0
1668157959642,ECE 200,045,103630,Taur; Yuan,9999,0,9999,0
1668157959642,ECE 200,046,103631,Touri; Behrouz,9999,0,9999,0
1668157959642,ECE 200,047,103632,Trivedi; Mohan M.,9999,0,9999,0
1668157959642,ECE 200,048,103633,Vasconcelos; Nuno,9999,0,9999,0
1668157959642,ECE 200,049,103634,Wang; Xiaolong,9999,0,9999,0
1668157959642,ECE 200,050,103635,Xie; Pengtao,9999,0,9999,0
1668157959642,ECE 200,051,103636,Yip; Michael,9999,0,9999,0
1668157959642,ECE 200,052,103637,Zeger; Kenneth A.,999,0,999,0
1668157959642,ECE 200,053,103638,Zhang; Xinyu,9999,0,9999,0
1668157959642,ECE 200,054,103639,Turakhia; Yatish Girish,9999,0,9999,0
1668157959642,ECE 200,055,103640,Kang; Mingu,9999,0,9999,0
1668157959642,ECE 200,056,103641,Shi; Yuanyuan,9999,0,9999,0
1668157959642,ECE 200,057,103642,Wang; Edward Jay,9999,0,9999,0
1668157959642,ECE 200,058,103643,Zheng; Yang,9999,0,9999,0
1668157960072,ECE 202,A00,103644,Kuzum; Duygu,0,0,0,0
1668157960495,ECE 212BN,A00,103646,Ng; Tse Nga,0,0,0,0
1668157960923,ECE 221,A00,111493,Staff,0,0,0,0
1668157961347,ECE 222B,A00,103647,Lomakin; Vitaliy,0,0,0,0
1668157961775,ECE 230B,A00,103648,Taur; Yuan,0,0,0,0
1668157962199,ECE 238B,A00,103649,Garay; Javier,0,0,0,0
1668157962624,ECE 240B,A00,112900,Fainman; Yeshaiahu,0,0,0,0
1668157963052,ECE 247A,A00,103650,Jokerst; Jesse Vincent,0,0,0,0
1668157963480,ECE 247B,A00,103651,Wang; Joseph,0,0,0,0
1668157963909,ECE 250,A00,103652,Siegel; Paul H.,0,0,0,0
1668157964338,ECE 251A,A00,103654,Rao; Bhaskar D.,0,0,0,0
1668157964763,ECE 257B,A00,103655,Bharadia; Dinesh,0,0,0,0
1668157965188,ECE 258A,A00,103656,Milstein; Laurence B.,0,0,0,0
1668157965612,ECE 260B,A00,103658,Kang; Mingu,0,0,0,0
1668157966040,ECE 264A,A00,103659,Galton; Ian A,0,0,0,0
1668157966537,ECE 265A,A00,103661,Gudem; Prasad S.S.,0,0,0,0
1668157966960,ECE 265D,A00,103662,Gudem; Prasad S.S.,0,0,0,0
1668157967387,ECE 268,A00,103663,Koushanfar; Farinaz,0,0,0,0
1668157967816,ECE 269,A01,103665,Pal; Piya,0,0,0,0
1668157968240,ECE 271B,A00,103666,Vasconcelos; Manuela,0,0,0,0
1668157968665,ECE 276A,A00,103667,Atanasov; Nikolay A.,0,0,0,0
1668157969106,ECE 277,A00,103668,An; Cheolhong,0,0,0,0
1668157969531,ECE 279,A00,117947,Hall; Drew A.,0,0,0,0
1668157970387,ECE 283,A00,103670,Hsueh; Tzu-Chien,0,0,0,0
1668157970814,ECE 284,A00,103671,Turakhia; Yatish Girish,0,0,0,0
1668157971238,ECE 285,A00,103672,Zheng; Yang,0,0,0,0
1668157971238,ECE 285,B00,103673,Sworder; David D.,0,0,0,0
1668157971662,ECE 287,A00,103676,Javidi; Tara,0,0,0,0
1668157972086,MATH 200B,A00,098023,Salehi Golsefidy; Alireza,12,0,15,3
1668157972510,MATH 202B,A00,098024,Rhoades; Brendon Patrick,9,0,15,6
1668157972939,MATH 203B,A00,098025,Oprea; Dragos N.,10,0,15,5
1668157973365,MATH 204B,A00,098026,Sorensen; Claus M,13,0,15,2
1668157973790,MATH 208,A00,098027,Izadi; Elham,7,0,10,3
1668157974218,MATH 209,A00,098028,Pollack; Aaron,10,0,10,0
1668157974641,MATH 211A,A00,112919,Rogalski; Daniel,9,0,10,1
1668157975065,MATH 211B,A00,112920,Seward; Brandon M.,9,0,10,1
1668157975490,MATH 218,A00,098029,Li; Bo,10,0,10,0
1668157975914,MATH 220B,A00,098030,Novak; Jonathan I,11,0,15,4
1668157976340,MATH 221A,A00,098031,Ebenfelt; Peter F,13,0,15,2
1668157976766,MATH 231B,A00,098032,Zlatos; Andrej,12,0,15,3
1668157977192,MATH 240B,A00,098033,Ni; Lei,9,0,15,6
1668157977619,MATH 243,A00,098034,Jekel; David Andrew,10,0,10,0
1668157978045,MATH 245A,A00,098035,Nie; Jiawang,0,0,15,16
1668157978471,MATH 248,A00,098036,Bejenaru; Ioan,10,0,10,0
1668157978897,MATH 250B,A00,098037,Spolaor; Luca,14,0,15,1
1668157979321,MATH 258,A00,098038,Ni; Lei,10,0,10,0
1668157979750,MATH 264B,A00,098041,Rhoades; Brendon Patrick,9,0,15,6
1668157980186,MATH 268,A00,098042,Buss; Samuel R,10,0,10,0
1668157980613,MATH 269,A00,098043,Rhoades; Brendon Patrick,10,0,10,0
1668157981041,MATH 270B,A00,098044,Li; Bo,10,0,15,5
1668157981465,MATH 272B,A00,098045,Holst; Michael J,13,0,15,2
1668157981890,MATH 273A,A00,098046,Tian; Xiaochuan,10,0,15,5
1668157982314,MATH 275,A01,098048,Tian; Xiaochuan,6,0,10,4
1668157982739,MATH 278A,A00,098049,Holst; Michael J,8,0,10,2
1668157983163,MATH 278B,A00,098050,Cloninger; Alexander,10,0,10,0
1668157983590,MATH 278C,A00,098051,Nie; Jiawang,7,0,10,3
1668157984016,MATH 280B,A00,098052,Zheng; Tianyi,10,0,15,5
1668157984444,MATH 281B,A00,098053,Bradic; Jelena,2,0,15,13
1668157984869,MATH 282B,A00,098054,Arias-Castro; Ery,0,0,15,15
1668157985298,MATH 285,A00,098055,Fitzsimmons; Patrick J,0,0,15,17
1668157985726,MATH 287B,A00,098056,Arias-Castro; Ery,2,0,15,13
1668157986157,MATH 288,A00,098057,Agarwal; Pooja,9,0,10,1
1668157986157,MATH 288,B00,098058,Zhang; Danna,8,0,10,2
1668157986157,MATH 288,C00,098059,Williams; Ruth J,10,0,10,0
1668157986580,MATH 290B,A00,098060,Roberts; Justin Deritter,13,0,15,2
1668157987005,MATH 292,A00,098061,Belmont; Eva Kinoshita,10,0,10,0
1668157987434,MATH 295,A00,098062,Suk; Andrew Hoon,48,0,50,2
1668157987857,MATH 296,A00,098063,Novak; Jonathan I,20,0,20,0
1668157988284,MATH 297,001,098064,Gamst; Anthony Collins,9997,0,9999,2
1668158488440,COGS 205,A00,101395,Chiba; Andrea,19,0,20,1
1668158488872,COGS 210B,001,101404,Greene; Deanna Jacquelyn,9998,0,9999,1
1668158488872,COGS 210B,002,101417,Xia; Haijun,9999,0,9999,0
1668158488872,COGS 210B,003,101422,Nitz; Douglas A.,9999,0,9999,0
1668158488872,COGS 210B,004,101423,Hollan; James D.,9998,0,9999,1
1668158488872,COGS 210B,005,101424,Deak; Gedeon O.,9998,0,9999,1
1668158488872,COGS 210B,006,101425,Rossano; Federico,9999,0,9999,0
1668158489297,COGS 211B,A00,101427,Coulson; Seana M,9996,0,9999,3
1668158489723,COGS 220,A00,101428,Hollan; James D.,0,0,25,25
1668158490149,COGS 229,A00,101429,Dow; Steven P,18,0,25,7
1668158490573,COGS 230,A00,101430,Klemmer; Scott R,12,0,17,5
1668158490995,COGS 234,A00,101431,Xia; Haijun,3,0,25,22
1668158491422,COGS 260,A00,101432,Kiyonaga; Anastasia,20,0,25,5
1668158491422,COGS 260,B00,101433,Kirsh; David Joel,16,0,25,9
1668158491848,CSE 202,A00,102371,Impagliazzo; Russell,0,0,0,0
1668158492281,CSE 203B,A01,102373,Cheng; Chung Kuan,0,0,0,0
1668158492710,CSE 208,A00,102374,Micciancio; Daniele,0,0,0,0
1668158493135,CSE 209A,A00,112895,Impagliazzo; Russell,0,0,15,15
1668158493563,CSE 209B,A00,108005,Bellare; Mihir,0,0,0,0
1668158493990,CSE 210,A00,113163,Coblenz; Michael J,0,0,0,0
1668158494413,CSE 219,A00,106111,Dow; Steven P,0,0,20,20
1668158494839,CSE 221,A00,102376,Voelker; Geoffrey M.,0,0,0,0
1668158495268,CSE 224,A01,102378,Porter; George M,0,0,0,0
1668158495698,CSE 229A,A00,102379,Savage; Stefan,0,0,0,0
1668158496123,CSE 229C,A00,102380,Munyaka; Imani N. S.,0,0,0,0
1668158496550,CSE 232B,A00,102382,Deutsch; Alin Bernard,0,0,0,0
1668158496981,CSE 234,A01,112904,Kumar; Arun Kumar,0,0,0,0
1668158497407,CSE 237A,A00,102383,Rosing; Tajana Simunic,0,0,0,0
1668158497832,CSE 239A,A00,102384,Deutsch; Alin Bernard,0,0,0,0
1668158498261,CSE 239B,A00,102385,Polikarpova; Nadezhda,0,0,0,0
1668158498690,CSE 240A,A00,102386,Pannuto; Patrick William,0,0,0,0
1668158499115,CSE 240B,A00,102387,Zhao; Jishen,0,0,0,0
1668158499541,CSE 241A,A00,106406,Kang; Mingu,0,0,0,0
1668158499971,CSE 249B,A00,102388,Kahng; Andrew Byun,0,0,8,8
1668158500402,CSE 251B,A01,102392,Cottrell; Garrison W,0,0,0,0
1668158500402,CSE 251B,A02,102393,Cottrell; Garrison W,0,0,0,0
1668158500824,CSE 252B,A00,102394,Ochoa; Benjamin Lawrence,0,0,0,0
1668158501248,CSE 257,A01,102396,Gao; Sicun,0,0,0,0
1668158501674,CSE 272,A00,102397,Li; Tzumao,0,0,0,0
1668158502100,CSE 274,A00,111323,Chern; Albert Ren-Haur,0,0,0,0
1668158502528,CSE 282,A00,102398,Pevzner; Pavel Arkadjevich,0,0,0,0
1668158502953,CSE 284,A00,114175,Gymrek; Melissa Ann,0,0,0,0
1668158503381,CSE 290,A00,102399,Chandraker; Manmohan Krishna,0,0,0,0
1668158503381,CSE 290,B00,102400,Vaccaro; Kristen Marie,0,0,25,25
1668158503381,CSE 290,C00,102414,Pannuto; Patrick William,0,0,25,25
1668158503381,CSE 290,D00,102427,Pevzner; Pavel Arkadjevich,0,0,0,0
1668158503381,CSE 290,E00,102429,Zhao; Jishen,0,0,0,0
1668158503381,CSE 290,F00,102436,Tullsen; Dean Michael,0,0,0,0
1668158503381,CSE 290,G00,102440,Christensen; Henrik I,0,0,20,20
1668158503810,CSE 291,A00,102443,Su; Hao,0,0,0,0
1668158503810,CSE 291,B00,102448,Polikarpova; Nadezhda,0,0,0,0
1668158503810,CSE 291,C00,102453,Vaccaro; Kristen Marie,0,0,0,0
1668158503810,CSE 291,D00,111343,Savage; Stefan,0,0,0,0
1668158503810,CSE 291,E00,116474,Claffy; Kimberly Claire,0,0,0,0
1668158503810,CSE 291,F00,116479,Pasquale; Joseph,0,0,0,0
1668158504257,CSE 293,001,119111,Bafna; Vineet,9999,0,9999,0
1668158504257,CSE 293,002,119118,Bellare; Mihir,9999,0,9999,0
1668158504257,CSE 293,003,119122,Berg-Kirkpatrick; Taylor D,9999,0,9999,0
1668158504257,CSE 293,004,119135,Christensen; Henrik I,9999,0,9999,0
1668158504257,CSE 293,005,119142,Cottrell; Garrison W,9999,0,9999,0
1668158504257,CSE 293,006,119146,Deutsch; Alin Bernard,9999,0,9999,0
1668158504257,CSE 293,007,119159,Esmaeilzadeh; Hadi,9999,0,9999,0
1668158504257,CSE 293,008,119166,Freund; Yoav,9999,0,9999,0
1668158504257,CSE 293,009,119170,Griswold; William G.,9999,0,9999,0
1668158504257,CSE 293,010,119183,Gymrek; Melissa Ann,9999,0,9999,0
1668158504257,CSE 293,011,119190,Heninger; Nadia A,9999,0,9999,0
1668158504257,CSE 293,012,119230,Impagliazzo; Russell,9999,0,9999,0
1668158504257,CSE 293,013,119232,Jhala; Ranjit,9999,0,9999,0
1668158504257,CSE 293,014,119233,Kahng; Andrew Byun,9999,0,9999,0
1668158504257,CSE 293,015,119298,Kane; Daniel Mertz,9999,0,9999,0
1668158504257,CSE 293,016,119299,Kriegman; David J,9999,0,9999,0
1668158504257,CSE 293,017,119300,Kumar; Arun Kumar,9999,0,9999,0
1668158504257,CSE 293,018,119301,Lerner; Sorin,9999,0,9999,0
1668158504257,CSE 293,019,119302,Lovett; Shachar,9999,0,9999,0
1668158504257,CSE 293,020,119303,McAuley; Julian John,9999,0,9999,0
1668158504257,CSE 293,021,119304,Micciancio; Daniele,9999,0,9999,0
1668158504257,CSE 293,022,119367,Orailoglu; Alex,9999,0,9999,0
1668158504257,CSE 293,023,119382,Paturi; Ramamohan,9999,0,9999,0
1668158504257,CSE 293,024,119404,Polikarpova; Nadezhda,9999,0,9999,0
1668158504257,CSE 293,025,119406,Politz; Joseph Gibbs,9999,0,9999,0
1668158504257,CSE 293,026,119411,Porter; George M,9999,0,9999,0
1668158504257,CSE 293,027,119414,Porter; Leonard Emerson,9999,0,9999,0
1668158504257,CSE 293,028,119416,Ramamoorthi; Ravi,9999,0,9999,0
1668158504257,CSE 293,029,119417,Sahoo; Debashis,9999,0,9999,0
1668158504257,CSE 293,030,119420,Saul; Lawrence,9999,0,9999,0
1668158504257,CSE 293,031,119421,Savage; Stefan,9999,0,9999,0
1668158504257,CSE 293,032,119425,Schulze; Jurgen P.,9999,0,9999,0
1668158504257,CSE 293,033,119426,Snoeren; Alex C.,9999,0,9999,0
1668158504257,CSE 293,034,119428,Shang; Jingbo,9999,0,9999,0
1668158504257,CSE 293,035,119430,Stefan; Deian,9999,0,9999,0
1668158504257,CSE 293,036,119431,Su; Hao,9999,0,9999,0
1668158504257,CSE 293,037,119433,Swanson; Steven James,9999,0,9999,0
1668158504257,CSE 293,038,119435,Tullsen; Dean Michael,9999,0,9999,0
1668158504257,CSE 293,039,119483,Voelker; Geoffrey M.,9999,0,9999,0
1668158504257,CSE 293,040,119537,Zhao; Jishen,9999,0,9999,0
1668158504257,CSE 293,041,119538,Zhou; Yuan-Yuan,9999,0,9999,0
1668158504257,CSE 293,042,119539,Gao; Sicun,9999,0,9999,0
1668158504257,CSE 293,043,119540,Weibel; Nadir,9999,0,9999,0
1668158504257,CSE 293,044,119541,Gupta; Rajesh K.,9999,0,9999,0
1668158504257,CSE 293,045,126410,Vaccaro; Kristen Marie,9999,0,9999,0
1668158504257,CSE 293,046,126411,Klemke; Richard,9999,0,9999,0
1668158504681,CSE 294,A00,102459,Voelker; Geoffrey M.,0,0,0,0
1668158504681,CSE 294,B00,111322,Orailoglu; Alex,0,0,0,0
1668158505110,DSE 201,A00,096914,Deutsch; Alin Bernard,30,0,30,0
1668158505534,DSE 210,A00,096915,Dasgupta; Sanjoy,30,0,30,0
1668158505959,DSE 260A,A00,096916,Altintas De Callaf; Ilkay,30,0,30,0
1668158506450,ECE 200,001,103586,Antipa; Nicholas A,9999,0,9999,0
1668158506450,ECE 200,002,103587,Atanasov; Nikolay A.,9999,0,9999,0
1668158506450,ECE 200,003,103588,Bharadia; Dinesh,9999,0,9999,0
1668158506450,ECE 200,004,103589,Cheng; Chung Kuan,9999,0,9999,0
1668158506450,ECE 200,005,103590,Cosman; Pamela C.,9999,0,9999,0
1668158506450,ECE 200,006,103591,Dayeh; Shadi Ahmad,9999,0,9999,0
1668158506450,ECE 200,007,103592,Fainman; Yeshaiahu,9999,0,9999,0
1668158506450,ECE 200,008,103593,Ford; Joseph Earl,9999,0,9999,0
1668158506450,ECE 200,009,103594,Franceschetti; Massimo,9999,0,9999,0
1668158506450,ECE 200,010,103595,Fullerton; Eric E,9999,0,9999,0
1668158506450,ECE 200,011,103596,Galton; Ian A,9999,0,9999,0
1668158506450,ECE 200,012,103597,Gilja; Vikash,9999,0,9999,0
1668158506450,ECE 200,013,103598,Hall; Drew A.,9999,0,9999,0
1668158506450,ECE 200,014,103599,Hsueh; Tzu-Chien,9999,0,9999,0
1668158506450,ECE 200,015,103600,Javidi; Tara,9999,0,9999,0
1668158506450,ECE 200,016,103601,Kahng; Andrew Byun,9999,0,9999,0
1668158506450,ECE 200,017,103602,Kim; Young-Han,9999,0,9999,0
1668158506450,ECE 200,018,103603,Koushanfar; Farinaz,9999,0,9999,0
1668158506450,ECE 200,019,103604,Kuzum; Duygu,9999,0,9999,0
1668158506450,ECE 200,020,103605,Le; Hanh-Phuc,9999,0,9999,0
1668158506450,ECE 200,021,103606,Lin; Bill,9999,0,9999,0
1668158506450,ECE 200,022,103607,Liu; Zhaowei,9998,0,9999,1
1668158506450,ECE 200,023,103608,Lo; Yu-Hwa,9999,0,9999,0
1668158506450,ECE 200,024,103609,Lomakin; Vitaliy,9999,0,9999,0
1668158506450,ECE 200,025,103610,Mercier; Patrick Philip,9999,0,9999,0
1668158506450,ECE 200,026,103611,Meyer; Florian,9999,0,9999,0
1668158506450,ECE 200,027,103612,Milstein; Laurence B.,9999,0,9999,0
1668158506450,ECE 200,028,103613,Mir Arabbaygi; Siavash,9999,0,9999,0
1668158506450,ECE 200,029,103614,Mookherjea; Shayan,9999,0,9999,0
1668158506450,ECE 200,030,103615,Morris; Karcher William,9999,0,9999,0
1668158506450,ECE 200,031,103616,Ng; Tse Nga,9999,0,9999,0
1668158506450,ECE 200,032,103617,Nguyen; Truong Quang,9999,0,9999,0
1668158506450,ECE 200,033,103618,Nomura; Kenji,9999,0,9999,0
1668158506450,ECE 200,034,103619,Orlitsky; Alon,9999,0,9999,0
1668158506450,ECE 200,035,103620,Pal; Piya,9999,0,9999,0
1668158506450,ECE 200,036,103621,Papen; George C.,9999,0,9999,0
1668158506450,ECE 200,037,103622,Radic; Stojan,9999,0,9999,0
1668158506450,ECE 200,038,103623,Rao; Bhaskar D.,9999,0,9999,0
1668158506450,ECE 200,039,103624,Rao; Ramesh R,9999,0,9999,0
1668158506450,ECE 200,040,103625,Rebeiz; Gabriel,9999,0,9999,0
1668158506450,ECE 200,041,103626,Sanford; John R,9999,0,9999,0
1668158506450,ECE 200,042,103627,Siegel; Paul H.,9999,0,9999,0
1668158506450,ECE 200,043,103628,Sievenpiper; Daniel F.,9999,0,9999,0
1668158506450,ECE 200,044,103629,Sworder; David D.,9999,0,9999,0
1668158506450,ECE 200,045,103630,Taur; Yuan,9999,0,9999,0
1668158506450,ECE 200,046,103631,Touri; Behrouz,9999,0,9999,0
1668158506450,ECE 200,047,103632,Trivedi; Mohan M.,9999,0,9999,0
1668158506450,ECE 200,048,103633,Vasconcelos; Nuno,9999,0,9999,0
1668158506450,ECE 200,049,103634,Wang; Xiaolong,9999,0,9999,0
1668158506450,ECE 200,050,103635,Xie; Pengtao,9999,0,9999,0
1668158506450,ECE 200,051,103636,Yip; Michael,9999,0,9999,0
1668158506450,ECE 200,052,103637,Zeger; Kenneth A.,999,0,999,0
1668158506450,ECE 200,053,103638,Zhang; Xinyu,9999,0,9999,0
1668158506450,ECE 200,054,103639,Turakhia; Yatish Girish,9999,0,9999,0
1668158506450,ECE 200,055,103640,Kang; Mingu,9999,0,9999,0
1668158506450,ECE 200,056,103641,Shi; Yuanyuan,9999,0,9999,0
1668158506450,ECE 200,057,103642,Wang; Edward Jay,9999,0,9999,0
1668158506450,ECE 200,058,103643,Zheng; Yang,9999,0,9999,0
1668158506877,ECE 202,A00,103644,Kuzum; Duygu,0,0,0,0
1668158507301,ECE 212BN,A00,103646,Ng; Tse Nga,0,0,0,0
1668158507728,ECE 221,A00,111493,Staff,0,0,0,0
1668158508154,ECE 222B,A00,103647,Lomakin; Vitaliy,0,0,0,0
1668158508577,ECE 230B,A00,103648,Taur; Yuan,0,0,0,0
1668158509008,ECE 238B,A00,103649,Garay; Javier,0,0,0,0
1668158509432,ECE 240B,A00,112900,Fainman; Yeshaiahu,0,0,0,0
1668158509858,ECE 247A,A00,103650,Jokerst; Jesse Vincent,0,0,0,0
1668158510281,ECE 247B,A00,103651,Wang; Joseph,0,0,0,0
1668158510710,ECE 250,A00,103652,Siegel; Paul H.,0,0,0,0
1668158511135,ECE 251A,A00,103654,Rao; Bhaskar D.,0,0,0,0
1668158511558,ECE 257B,A00,103655,Bharadia; Dinesh,0,0,0,0
1668158511983,ECE 258A,A00,103656,Milstein; Laurence B.,0,0,0,0
1668158512408,ECE 260B,A00,103658,Kang; Mingu,0,0,0,0
1668158512834,ECE 264A,A00,103659,Galton; Ian A,0,0,0,0
1668158513257,ECE 265A,A00,103661,Gudem; Prasad S.S.,0,0,0,0
1668158513680,ECE 265D,A00,103662,Gudem; Prasad S.S.,0,0,0,0
1668158514111,ECE 268,A00,103663,Koushanfar; Farinaz,0,0,0,0
1668158514536,ECE 269,A01,103665,Pal; Piya,0,0,0,0
1668158514965,ECE 271B,A00,103666,Vasconcelos; Manuela,0,0,0,0
1668158515388,ECE 276A,A00,103667,Atanasov; Nikolay A.,0,0,0,0
1668158515813,ECE 277,A00,103668,An; Cheolhong,0,0,0,0
1668158516239,ECE 279,A00,117947,Hall; Drew A.,0,0,0,0
1668158517090,ECE 283,A00,103670,Hsueh; Tzu-Chien,0,0,0,0
1668158517518,ECE 284,A00,103671,Turakhia; Yatish Girish,0,0,0,0
1668158517944,ECE 285,A00,103672,Zheng; Yang,0,0,0,0
1668158517944,ECE 285,B00,103673,Sworder; David D.,0,0,0,0
1668158518368,ECE 287,A00,103676,Javidi; Tara,0,0,0,0
1668158518794,MATH 200B,A00,098023,Salehi Golsefidy; Alireza,12,0,15,3
1668158519223,MATH 202B,A00,098024,Rhoades; Brendon Patrick,9,0,15,6
1668158519647,MATH 203B,A00,098025,Oprea; Dragos N.,10,0,15,5
1668158520072,MATH 204B,A00,098026,Sorensen; Claus M,13,0,15,2
1668158520496,MATH 208,A00,098027,Izadi; Elham,7,0,10,3
1668158520922,MATH 209,A00,098028,Pollack; Aaron,10,0,10,0
1668158521345,MATH 211A,A00,112919,Rogalski; Daniel,9,0,10,1
1668158521775,MATH 211B,A00,112920,Seward; Brandon M.,9,0,10,1
1668158522206,MATH 218,A00,098029,Li; Bo,10,0,10,0
1668158522630,MATH 220B,A00,098030,Novak; Jonathan I,11,0,15,4
1668158523058,MATH 221A,A00,098031,Ebenfelt; Peter F,13,0,15,2
1668158523482,MATH 231B,A00,098032,Zlatos; Andrej,12,0,15,3
1668158523913,MATH 240B,A00,098033,Ni; Lei,9,0,15,6
1668158524344,MATH 243,A00,098034,Jekel; David Andrew,10,0,10,0
1668158524774,MATH 245A,A00,098035,Nie; Jiawang,0,0,15,16
1668158525198,MATH 248,A00,098036,Bejenaru; Ioan,10,0,10,0
1668158525628,MATH 250B,A00,098037,Spolaor; Luca,14,0,15,1
1668158526056,MATH 258,A00,098038,Ni; Lei,10,0,10,0
1668158526479,MATH 264B,A00,098041,Rhoades; Brendon Patrick,9,0,15,6
1668158526905,MATH 268,A00,098042,Buss; Samuel R,10,0,10,0
1668158527333,MATH 269,A00,098043,Rhoades; Brendon Patrick,10,0,10,0
1668158527758,MATH 270B,A00,098044,Li; Bo,10,0,15,5
1668158528188,MATH 272B,A00,098045,Holst; Michael J,13,0,15,2
1668158528612,MATH 273A,A00,098046,Tian; Xiaochuan,10,0,15,5
1668158529039,MATH 275,A01,098048,Tian; Xiaochuan,6,0,10,4
1668158529477,MATH 278A,A00,098049,Holst; Michael J,8,0,10,2
1668158529994,MATH 278B,A00,098050,Cloninger; Alexander,10,0,10,0
1668158530418,MATH 278C,A00,098051,Nie; Jiawang,7,0,10,3
1668158530842,MATH 280B,A00,098052,Zheng; Tianyi,10,0,15,5
1668158531269,MATH 281B,A00,098053,Bradic; Jelena,2,0,15,13
1668158531697,MATH 282B,A00,098054,Arias-Castro; Ery,0,0,15,15
1668158532122,MATH 285,A00,098055,Fitzsimmons; Patrick J,0,0,15,17
1668158532544,MATH 287B,A00,098056,Arias-Castro; Ery,2,0,15,13
1668158532978,MATH 288,A00,098057,Agarwal; Pooja,9,0,10,1
1668158532978,MATH 288,B00,098058,Zhang; Danna,8,0,10,2
1668158532978,MATH 288,C00,098059,Williams; Ruth J,10,0,10,0
1668158533412,MATH 290B,A00,098060,Roberts; Justin Deritter,13,0,15,2
1668158533838,MATH 292,A00,098061,Belmont; Eva Kinoshita,10,0,10,0
1668158534266,MATH 295,A00,098062,Suk; Andrew Hoon,48,0,50,2
1668158534689,MATH 296,A00,098063,Novak; Jonathan I,20,0,20,0
1668158535114,MATH 297,001,098064,Gamst; Anthony Collins,9997,0,9999,2
1668159036381,COGS 205,A00,101395,Chiba; Andrea,19,0,20,1
1668159036807,COGS 210B,001,101404,Greene; Deanna Jacquelyn,9998,0,9999,1
1668159036807,COGS 210B,002,101417,Xia; Haijun,9999,0,9999,0
1668159036807,COGS 210B,003,101422,Nitz; Douglas A.,9999,0,9999,0
1668159036807,COGS 210B,004,101423,Hollan; James D.,9998,0,9999,1
1668159036807,COGS 210B,005,101424,Deak; Gedeon O.,9998,0,9999,1
1668159036807,COGS 210B,006,101425,Rossano; Federico,9999,0,9999,0
1668159037234,COGS 211B,A00,101427,Coulson; Seana M,9996,0,9999,3
1668159037661,COGS 220,A00,101428,Hollan; James D.,0,0,25,25
1668159038084,COGS 229,A00,101429,Dow; Steven P,18,0,25,7
1668159038507,COGS 230,A00,101430,Klemmer; Scott R,12,0,17,5
1668159038935,COGS 234,A00,101431,Xia; Haijun,3,0,25,22
1668159039359,COGS 260,A00,101432,Kiyonaga; Anastasia,20,0,25,5
1668159039359,COGS 260,B00,101433,Kirsh; David Joel,16,0,25,9
1668159039787,CSE 202,A00,102371,Impagliazzo; Russell,0,0,0,0
1668159040219,CSE 203B,A01,102373,Cheng; Chung Kuan,0,0,0,0
1668159040646,CSE 208,A00,102374,Micciancio; Daniele,0,0,0,0
1668159041072,CSE 209A,A00,112895,Impagliazzo; Russell,0,0,15,15
1668159041500,CSE 209B,A00,108005,Bellare; Mihir,0,0,0,0
1668159041923,CSE 210,A00,113163,Coblenz; Michael J,0,0,0,0
1668159042354,CSE 219,A00,106111,Dow; Steven P,0,0,20,20
1668159042779,CSE 221,A00,102376,Voelker; Geoffrey M.,0,0,0,0
1668159043205,CSE 224,A01,102378,Porter; George M,0,0,0,0
1668159043630,CSE 229A,A00,102379,Savage; Stefan,0,0,0,0
1668159044054,CSE 229C,A00,102380,Munyaka; Imani N. S.,0,0,0,0
1668159044480,CSE 232B,A00,102382,Deutsch; Alin Bernard,0,0,0,0
1668159044909,CSE 234,A01,112904,Kumar; Arun Kumar,0,0,0,0
1668159045337,CSE 237A,A00,102383,Rosing; Tajana Simunic,0,0,0,0
1668159045763,CSE 239A,A00,102384,Deutsch; Alin Bernard,0,0,0,0
1668159046186,CSE 239B,A00,102385,Polikarpova; Nadezhda,0,0,0,0
1668159046614,CSE 240A,A00,102386,Pannuto; Patrick William,0,0,0,0
1668159047040,CSE 240B,A00,102387,Zhao; Jishen,0,0,0,0
1668159047464,CSE 241A,A00,106406,Kang; Mingu,0,0,0,0
1668159047887,CSE 249B,A00,102388,Kahng; Andrew Byun,0,0,8,8
1668159048313,CSE 251B,A01,102392,Cottrell; Garrison W,0,0,0,0
1668159048313,CSE 251B,A02,102393,Cottrell; Garrison W,0,0,0,0
1668159048740,CSE 252B,A00,102394,Ochoa; Benjamin Lawrence,0,0,0,0
1668159049165,CSE 257,A01,102396,Gao; Sicun,0,0,0,0
1668159049590,CSE 272,A00,102397,Li; Tzumao,0,0,0,0
1668159050014,CSE 274,A00,111323,Chern; Albert Ren-Haur,0,0,0,0
1668159050440,CSE 282,A00,102398,Pevzner; Pavel Arkadjevich,0,0,0,0
1668159050869,CSE 284,A00,114175,Gymrek; Melissa Ann,0,0,0,0
1668159051394,CSE 290,A00,102399,Chandraker; Manmohan Krishna,0,0,0,0
1668159051394,CSE 290,B00,102400,Vaccaro; Kristen Marie,0,0,25,25
1668159051394,CSE 290,C00,102414,Pannuto; Patrick William,0,0,25,25
1668159051394,CSE 290,D00,102427,Pevzner; Pavel Arkadjevich,0,0,0,0
1668159051394,CSE 290,E00,102429,Zhao; Jishen,0,0,0,0
1668159051394,CSE 290,F00,102436,Tullsen; Dean Michael,0,0,0,0
1668159051394,CSE 290,G00,102440,Christensen; Henrik I,0,0,20,20
1668159051818,CSE 291,A00,102443,Su; Hao,0,0,0,0
1668159051818,CSE 291,B00,102448,Polikarpova; Nadezhda,0,0,0,0
1668159051818,CSE 291,C00,102453,Vaccaro; Kristen Marie,0,0,0,0
1668159051818,CSE 291,D00,111343,Savage; Stefan,0,0,0,0
1668159051818,CSE 291,E00,116474,Claffy; Kimberly Claire,0,0,0,0
1668159051818,CSE 291,F00,116479,Pasquale; Joseph,0,0,0,0
1668159052254,CSE 293,001,119111,Bafna; Vineet,9999,0,9999,0
1668159052254,CSE 293,002,119118,Bellare; Mihir,9999,0,9999,0
1668159052254,CSE 293,003,119122,Berg-Kirkpatrick; Taylor D,9999,0,9999,0
1668159052254,CSE 293,004,119135,Christensen; Henrik I,9999,0,9999,0
1668159052254,CSE 293,005,119142,Cottrell; Garrison W,9999,0,9999,0
1668159052254,CSE 293,006,119146,Deutsch; Alin Bernard,9999,0,9999,0
1668159052254,CSE 293,007,119159,Esmaeilzadeh; Hadi,9999,0,9999,0
1668159052254,CSE 293,008,119166,Freund; Yoav,9999,0,9999,0
1668159052254,CSE 293,009,119170,Griswold; William G.,9999,0,9999,0
1668159052254,CSE 293,010,119183,Gymrek; Melissa Ann,9999,0,9999,0
1668159052254,CSE 293,011,119190,Heninger; Nadia A,9999,0,9999,0
1668159052254,CSE 293,012,119230,Impagliazzo; Russell,9999,0,9999,0
1668159052254,CSE 293,013,119232,Jhala; Ranjit,9999,0,9999,0
1668159052254,CSE 293,014,119233,Kahng; Andrew Byun,9999,0,9999,0
1668159052254,CSE 293,015,119298,Kane; Daniel Mertz,9999,0,9999,0
1668159052254,CSE 293,016,119299,Kriegman; David J,9999,0,9999,0
1668159052254,CSE 293,017,119300,Kumar; Arun Kumar,9999,0,9999,0
1668159052254,CSE 293,018,119301,Lerner; Sorin,9999,0,9999,0
1668159052254,CSE 293,019,119302,Lovett; Shachar,9999,0,9999,0
1668159052254,CSE 293,020,119303,McAuley; Julian John,9999,0,9999,0
1668159052254,CSE 293,021,119304,Micciancio; Daniele,9999,0,9999,0
1668159052254,CSE 293,022,119367,Orailoglu; Alex,9999,0,9999,0
1668159052254,CSE 293,023,119382,Paturi; Ramamohan,9999,0,9999,0
1668159052254,CSE 293,024,119404,Polikarpova; Nadezhda,9999,0,9999,0
1668159052254,CSE 293,025,119406,Politz; Joseph Gibbs,9999,0,9999,0
1668159052254,CSE 293,026,119411,Porter; George M,9999,0,9999,0
1668159052254,CSE 293,027,119414,Porter; Leonard Emerson,9999,0,9999,0
1668159052254,CSE 293,028,119416,Ramamoorthi; Ravi,9999,0,9999,0
1668159052254,CSE 293,029,119417,Sahoo; Debashis,9999,0,9999,0
1668159052254,CSE 293,030,119420,Saul; Lawrence,9999,0,9999,0
1668159052254,CSE 293,031,119421,Savage; Stefan,9999,0,9999,0
1668159052254,CSE 293,032,119425,Schulze; Jurgen P.,9999,0,9999,0
1668159052254,CSE 293,033,119426,Snoeren; Alex C.,9999,0,9999,0
1668159052254,CSE 293,034,119428,Shang; Jingbo,9999,0,9999,0
1668159052254,CSE 293,035,119430,Stefan; Deian,9999,0,9999,0
1668159052254,CSE 293,036,119431,Su; Hao,9999,0,9999,0
1668159052254,CSE 293,037,119433,Swanson; Steven James,9999,0,9999,0
1668159052254,CSE 293,038,119435,Tullsen; Dean Michael,9999,0,9999,0
1668159052254,CSE 293,039,119483,Voelker; Geoffrey M.,9999,0,9999,0
1668159052254,CSE 293,040,119537,Zhao; Jishen,9999,0,9999,0
1668159052254,CSE 293,041,119538,Zhou; Yuan-Yuan,9999,0,9999,0
1668159052254,CSE 293,042,119539,Gao; Sicun,9999,0,9999,0
1668159052254,CSE 293,043,119540,Weibel; Nadir,9999,0,9999,0
1668159052254,CSE 293,044,119541,Gupta; Rajesh K.,9999,0,9999,0
1668159052254,CSE 293,045,126410,Vaccaro; Kristen Marie,9999,0,9999,0
1668159052254,CSE 293,046,126411,Klemke; Richard,9999,0,9999,0
1668159052678,CSE 294,A00,102459,Voelker; Geoffrey M.,0,0,0,0
1668159052678,CSE 294,B00,111322,Orailoglu; Alex,0,0,0,0
1668159053102,DSE 201,A00,096914,Deutsch; Alin Bernard,30,0,30,0
1668159053528,DSE 210,A00,096915,Dasgupta; Sanjoy,30,0,30,0
1668159053952,DSE 260A,A00,096916,Altintas De Callaf; Ilkay,30,0,30,0
1668159054389,ECE 200,001,103586,Antipa; Nicholas A,9999,0,9999,0
1668159054389,ECE 200,002,103587,Atanasov; Nikolay A.,9999,0,9999,0
1668159054389,ECE 200,003,103588,Bharadia; Dinesh,9999,0,9999,0
1668159054389,ECE 200,004,103589,Cheng; Chung Kuan,9999,0,9999,0
1668159054389,ECE 200,005,103590,Cosman; Pamela C.,9999,0,9999,0
1668159054389,ECE 200,006,103591,Dayeh; Shadi Ahmad,9999,0,9999,0
1668159054389,ECE 200,007,103592,Fainman; Yeshaiahu,9999,0,9999,0
1668159054389,ECE 200,008,103593,Ford; Joseph Earl,9999,0,9999,0
1668159054389,ECE 200,009,103594,Franceschetti; Massimo,9999,0,9999,0
1668159054389,ECE 200,010,103595,Fullerton; Eric E,9999,0,9999,0
1668159054389,ECE 200,011,103596,Galton; Ian A,9999,0,9999,0
1668159054389,ECE 200,012,103597,Gilja; Vikash,9999,0,9999,0
1668159054389,ECE 200,013,103598,Hall; Drew A.,9999,0,9999,0
1668159054389,ECE 200,014,103599,Hsueh; Tzu-Chien,9999,0,9999,0
1668159054389,ECE 200,015,103600,Javidi; Tara,9999,0,9999,0
1668159054389,ECE 200,016,103601,Kahng; Andrew Byun,9999,0,9999,0
1668159054389,ECE 200,017,103602,Kim; Young-Han,9999,0,9999,0
1668159054389,ECE 200,018,103603,Koushanfar; Farinaz,9999,0,9999,0
1668159054389,ECE 200,019,103604,Kuzum; Duygu,9999,0,9999,0
1668159054389,ECE 200,020,103605,Le; Hanh-Phuc,9999,0,9999,0
1668159054389,ECE 200,021,103606,Lin; Bill,9999,0,9999,0
1668159054389,ECE 200,022,103607,Liu; Zhaowei,9998,0,9999,1
1668159054389,ECE 200,023,103608,Lo; Yu-Hwa,9999,0,9999,0
1668159054389,ECE 200,024,103609,Lomakin; Vitaliy,9999,0,9999,0
1668159054389,ECE 200,025,103610,Mercier; Patrick Philip,9999,0,9999,0
1668159054389,ECE 200,026,103611,Meyer; Florian,9999,0,9999,0
1668159054389,ECE 200,027,103612,Milstein; Laurence B.,9999,0,9999,0
1668159054389,ECE 200,028,103613,Mir Arabbaygi; Siavash,9999,0,9999,0
1668159054389,ECE 200,029,103614,Mookherjea; Shayan,9999,0,9999,0
1668159054389,ECE 200,030,103615,Morris; Karcher William,9999,0,9999,0
1668159054389,ECE 200,031,103616,Ng; Tse Nga,9999,0,9999,0
1668159054389,ECE 200,032,103617,Nguyen; Truong Quang,9999,0,9999,0
1668159054389,ECE 200,033,103618,Nomura; Kenji,9999,0,9999,0
1668159054389,ECE 200,034,103619,Orlitsky; Alon,9999,0,9999,0
1668159054389,ECE 200,035,103620,Pal; Piya,9999,0,9999,0
1668159054389,ECE 200,036,103621,Papen; George C.,9999,0,9999,0
1668159054389,ECE 200,037,103622,Radic; Stojan,9999,0,9999,0
1668159054389,ECE 200,038,103623,Rao; Bhaskar D.,9999,0,9999,0
1668159054389,ECE 200,039,103624,Rao; Ramesh R,9999,0,9999,0
1668159054389,ECE 200,040,103625,Rebeiz; Gabriel,9999,0,9999,0
1668159054389,ECE 200,041,103626,Sanford; John R,9999,0,9999,0
1668159054389,ECE 200,042,103627,Siegel; Paul H.,9999,0,9999,0
1668159054389,ECE 200,043,103628,Sievenpiper; Daniel F.,9999,0,9999,0
1668159054389,ECE 200,044,103629,Sworder; David D.,9999,0,9999,0
1668159054389,ECE 200,045,103630,Taur; Yuan,9999,0,9999,0
1668159054389,ECE 200,046,103631,Touri; Behrouz,9999,0,9999,0
1668159054389,ECE 200,047,103632,Trivedi; Mohan M.,9999,0,9999,0
1668159054389,ECE 200,048,103633,Vasconcelos; Nuno,9999,0,9999,0
1668159054389,ECE 200,049,103634,Wang; Xiaolong,9999,0,9999,0
1668159054389,ECE 200,050,103635,Xie; Pengtao,9999,0,9999,0
1668159054389,ECE 200,051,103636,Yip; Michael,9999,0,9999,0
1668159054389,ECE 200,052,103637,Zeger; Kenneth A.,999,0,999,0
1668159054389,ECE 200,053,103638,Zhang; Xinyu,9999,0,9999,0
1668159054389,ECE 200,054,103639,Turakhia; Yatish Girish,9999,0,9999,0
1668159054389,ECE 200,055,103640,Kang; Mingu,9999,0,9999,0
1668159054389,ECE 200,056,103641,Shi; Yuanyuan,9999,0,9999,0
1668159054389,ECE 200,057,103642,Wang; Edward Jay,9999,0,9999,0
1668159054389,ECE 200,058,103643,Zheng; Yang,9999,0,9999,0
1668159054814,ECE 202,A00,103644,Kuzum; Duygu,0,0,0,0
1668159055244,ECE 212BN,A00,103646,Ng; Tse Nga,0,0,0,0
1668159055668,ECE 221,A00,111493,Staff,0,0,0,0
1668159056093,ECE 222B,A00,103647,Lomakin; Vitaliy,0,0,0,0
1668159056524,ECE 230B,A00,103648,Taur; Yuan,0,0,0,0
1668159056951,ECE 238B,A00,103649,Garay; Javier,0,0,0,0
1668159057376,ECE 240B,A00,112900,Fainman; Yeshaiahu,0,0,0,0
1668159057805,ECE 247A,A00,103650,Jokerst; Jesse Vincent,0,0,0,0
1668159058229,ECE 247B,A00,103651,Wang; Joseph,0,0,0,0
1668159058654,ECE 250,A00,103652,Siegel; Paul H.,0,0,0,0
1668159059083,ECE 251A,A00,103654,Rao; Bhaskar D.,0,0,0,0
1668159059508,ECE 257B,A00,103655,Bharadia; Dinesh,0,0,0,0
1668159059932,ECE 258A,A00,103656,Milstein; Laurence B.,0,0,0,0
1668159060364,ECE 260B,A00,103658,Kang; Mingu,0,0,0,0
1668159060793,ECE 264A,A00,103659,Galton; Ian A,0,0,0,0
1668159061219,ECE 265A,A00,103661,Gudem; Prasad S.S.,0,0,0,0
1668159061642,ECE 265D,A00,103662,Gudem; Prasad S.S.,0,0,0,0
1668159062070,ECE 268,A00,103663,Koushanfar; Farinaz,0,0,0,0
1668159062494,ECE 269,A01,103665,Pal; Piya,0,0,0,0
1668159062920,ECE 271B,A00,103666,Vasconcelos; Manuela,0,0,0,0
1668159063347,ECE 276A,A00,103667,Atanasov; Nikolay A.,0,0,0,0
1668159063772,ECE 277,A00,103668,An; Cheolhong,0,0,0,0
1668159064201,ECE 279,A00,117947,Hall; Drew A.,0,0,0,0
1668159065061,ECE 283,A00,103670,Hsueh; Tzu-Chien,0,0,0,0
1668159065485,ECE 284,A00,103671,Turakhia; Yatish Girish,0,0,0,0
1668159065912,ECE 285,A00,103672,Zheng; Yang,0,0,0,0
1668159065912,ECE 285,B00,103673,Sworder; David D.,0,0,0,0
1668159066336,ECE 287,A00,103676,Javidi; Tara,0,0,0,0
1668159066760,MATH 200B,A00,098023,Salehi Golsefidy; Alireza,12,0,15,3
1668159067186,MATH 202B,A00,098024,Rhoades; Brendon Patrick,9,0,15,6
1668159067648,MATH 203B,A00,098025,Oprea; Dragos N.,10,0,15,5
1668159068073,MATH 204B,A00,098026,Sorensen; Claus M,13,0,15,2
1668159068498,MATH 208,A00,098027,Izadi; Elham,7,0,10,3
1668159068925,MATH 209,A00,098028,Pollack; Aaron,10,0,10,0
1668159069351,MATH 211A,A00,112919,Rogalski; Daniel,9,0,10,1
1668159069780,MATH 211B,A00,112920,Seward; Brandon M.,9,0,10,1
1668159070202,MATH 218,A00,098029,Li; Bo,10,0,10,0
1668159070629,MATH 220B,A00,098030,Novak; Jonathan I,11,0,15,4
1668159071057,MATH 221A,A00,098031,Ebenfelt; Peter F,13,0,15,2
1668159071485,MATH 231B,A00,098032,Zlatos; Andrej,12,0,15,3
1668159071912,MATH 240B,A00,098033,Ni; Lei,9,0,15,6
1668159072335,MATH 243,A00,098034,Jekel; David Andrew,10,0,10,0
1668159072764,MATH 245A,A00,098035,Nie; Jiawang,0,0,15,16
1668159073196,MATH 248,A00,098036,Bejenaru; Ioan,10,0,10,0
1668159073622,MATH 250B,A00,098037,Spolaor; Luca,14,0,15,1
1668159074046,MATH 258,A00,098038,Ni; Lei,10,0,10,0
1668159074474,MATH 264B,A00,098041,Rhoades; Brendon Patrick,9,0,15,6
1668159074898,MATH 268,A00,098042,Buss; Samuel R,10,0,10,0
1668159075322,MATH 269,A00,098043,Rhoades; Brendon Patrick,10,0,10,0
1668159075749,MATH 270B,A00,098044,Li; Bo,10,0,15,5
1668159076178,MATH 272B,A00,098045,Holst; Michael J,13,0,15,2
1668159076602,MATH 273A,A00,098046,Tian; Xiaochuan,10,0,15,5
1668159077026,MATH 275,A01,098048,Tian; Xiaochuan,6,0,10,4
1668159077455,MATH 278A,A00,098049,Holst; Michael J,8,0,10,2
1668159077882,MATH 278B,A00,098050,Cloninger; Alexander,10,0,10,0
1668159078304,MATH 278C,A00,098051,Nie; Jiawang,7,0,10,3
1668159078733,MATH 280B,A00,098052,Zheng; Tianyi,10,0,15,5
1668159079159,MATH 281B,A00,098053,Bradic; Jelena,2,0,15,13
1668159079584,MATH 282B,A00,098054,Arias-Castro; Ery,0,0,15,15
1668159080010,MATH 285,A00,098055,Fitzsimmons; Patrick J,0,0,15,17
1668159080438,MATH 287B,A00,098056,Arias-Castro; Ery,2,0,15,13
1668159080869,MATH 288,A00,098057,Agarwal; Pooja,9,0,10,1
1668159080869,MATH 288,B00,098058,Zhang; Danna,8,0,10,2
1668159080869,MATH 288,C00,098059,Williams; Ruth J,10,0,10,0
1668159081293,MATH 290B,A00,098060,Roberts; Justin Deritter,13,0,15,2
1668159081723,MATH 292,A00,098061,Belmont; Eva Kinoshita,10,0,10,0
1668159082149,MATH 295,A00,098062,Suk; Andrew Hoon,48,0,50,2
1668159082573,MATH 296,A00,098063,Novak; Jonathan I,20,0,20,0
1668159082997,MATH 297,001,098064,Gamst; Anthony Collins,9997,0,9999,2
1668159583526,COGS 205,A00,101395,Chiba; Andrea,19,0,20,1
1668159583952,COGS 210B,001,101404,Greene; Deanna Jacquelyn,9998,0,9999,1
1668159583952,COGS 210B,002,101417,Xia; Haijun,9999,0,9999,0
1668159583952,COGS 210B,003,101422,Nitz; Douglas A.,9999,0,9999,0
1668159583952,COGS 210B,004,101423,Hollan; James D.,9998,0,9999,1
1668159583952,COGS 210B,005,101424,Deak; Gedeon O.,9998,0,9999,1
1668159583952,COGS 210B,006,101425,Rossano; Federico,9999,0,9999,0
1668159584377,COGS 211B,A00,101427,Coulson; Seana M,9996,0,9999,3
1668159584803,COGS 220,A00,101428,Hollan; James D.,0,0,25,25
1668159585227,COGS 229,A00,101429,Dow; Steven P,18,0,25,7
1668159585649,COGS 230,A00,101430,Klemmer; Scott R,12,0,17,5
1668159586080,COGS 234,A00,101431,Xia; Haijun,3,0,25,22
1668159586520,COGS 260,A00,101432,Kiyonaga; Anastasia,20,0,25,5
1668159586520,COGS 260,B00,101433,Kirsh; David Joel,16,0,25,9
1668159586947,CSE 202,A00,102371,Impagliazzo; Russell,0,0,0,0
1668159587372,CSE 203B,A01,102373,Cheng; Chung Kuan,0,0,0,0
1668159587796,CSE 208,A00,102374,Micciancio; Daniele,0,0,0,0
1668159588220,CSE 209A,A00,112895,Impagliazzo; Russell,0,0,15,15
1668159588647,CSE 209B,A00,108005,Bellare; Mihir,0,0,0,0
1668159589080,CSE 210,A00,113163,Coblenz; Michael J,0,0,0,0
1668159589503,CSE 219,A00,106111,Dow; Steven P,0,0,20,20
1668159589927,CSE 221,A00,102376,Voelker; Geoffrey M.,0,0,0,0
1668159590358,CSE 224,A01,102378,Porter; George M,0,0,0,0
1668159590782,CSE 229A,A00,102379,Savage; Stefan,0,0,0,0
1668159591206,CSE 229C,A00,102380,Munyaka; Imani N. S.,0,0,0,0
1668159591629,CSE 232B,A00,102382,Deutsch; Alin Bernard,0,0,0,0
1668159592052,CSE 234,A01,112904,Kumar; Arun Kumar,0,0,0,0
1668159592480,CSE 237A,A00,102383,Rosing; Tajana Simunic,0,0,0,0
1668159592905,CSE 239A,A00,102384,Deutsch; Alin Bernard,0,0,0,0
1668159593334,CSE 239B,A00,102385,Polikarpova; Nadezhda,0,0,0,0
1668159593758,CSE 240A,A00,102386,Pannuto; Patrick William,0,0,0,0
1668159594186,CSE 240B,A00,102387,Zhao; Jishen,0,0,0,0
1668159594622,CSE 241A,A00,106406,Kang; Mingu,0,0,0,0
1668159595049,CSE 249B,A00,102388,Kahng; Andrew Byun,0,0,8,8
1668159595473,CSE 251B,A01,102392,Cottrell; Garrison W,0,0,0,0
1668159595473,CSE 251B,A02,102393,Cottrell; Garrison W,0,0,0,0
1668159595898,CSE 252B,A00,102394,Ochoa; Benjamin Lawrence,0,0,0,0
1668159596329,CSE 257,A01,102396,Gao; Sicun,0,0,0,0
1668159596753,CSE 272,A00,102397,Li; Tzumao,0,0,0,0
1668159597178,CSE 274,A00,111323,Chern; Albert Ren-Haur,0,0,0,0
1668159597602,CSE 282,A00,102398,Pevzner; Pavel Arkadjevich,0,0,0,0
1668159598028,CSE 284,A00,114175,Gymrek; Melissa Ann,0,0,0,0
1668159598455,CSE 290,A00,102399,Chandraker; Manmohan Krishna,0,0,0,0
1668159598455,CSE 290,B00,102400,Vaccaro; Kristen Marie,0,0,25,25
1668159598455,CSE 290,C00,102414,Pannuto; Patrick William,0,0,25,25
1668159598455,CSE 290,D00,102427,Pevzner; Pavel Arkadjevich,0,0,0,0
1668159598455,CSE 290,E00,102429,Zhao; Jishen,0,0,0,0
1668159598455,CSE 290,F00,102436,Tullsen; Dean Michael,0,0,0,0
1668159598455,CSE 290,G00,102440,Christensen; Henrik I,0,0,20,20
1668159598892,CSE 291,A00,102443,Su; Hao,0,0,0,0
1668159598892,CSE 291,B00,102448,Polikarpova; Nadezhda,0,0,0,0
1668159598892,CSE 291,C00,102453,Vaccaro; Kristen Marie,0,0,0,0
1668159598892,CSE 291,D00,111343,Savage; Stefan,0,0,0,0
1668159598892,CSE 291,E00,116474,Claffy; Kimberly Claire,0,0,0,0
1668159598892,CSE 291,F00,116479,Pasquale; Joseph,0,0,0,0
1668159599338,CSE 293,001,119111,Bafna; Vineet,9999,0,9999,0
1668159599338,CSE 293,002,119118,Bellare; Mihir,9999,0,9999,0
1668159599338,CSE 293,003,119122,Berg-Kirkpatrick; Taylor D,9999,0,9999,0
1668159599338,CSE 293,004,119135,Christensen; Henrik I,9999,0,9999,0
1668159599338,CSE 293,005,119142,Cottrell; Garrison W,9999,0,9999,0
1668159599338,CSE 293,006,119146,Deutsch; Alin Bernard,9999,0,9999,0
1668159599338,CSE 293,007,119159,Esmaeilzadeh; Hadi,9999,0,9999,0
1668159599338,CSE 293,008,119166,Freund; Yoav,9999,0,9999,0
1668159599338,CSE 293,009,119170,Griswold; William G.,9999,0,9999,0
1668159599338,CSE 293,010,119183,Gymrek; Melissa Ann,9999,0,9999,0
1668159599338,CSE 293,011,119190,Heninger; Nadia A,9999,0,9999,0
1668159599338,CSE 293,012,119230,Impagliazzo; Russell,9999,0,9999,0
1668159599338,CSE 293,013,119232,Jhala; Ranjit,9999,0,9999,0
1668159599338,CSE 293,014,119233,Kahng; Andrew Byun,9999,0,9999,0
1668159599338,CSE 293,015,119298,Kane; Daniel Mertz,9999,0,9999,0
1668159599338,CSE 293,016,119299,Kriegman; David J,9999,0,9999,0
1668159599338,CSE 293,017,119300,Kumar; Arun Kumar,9999,0,9999,0
1668159599338,CSE 293,018,119301,Lerner; Sorin,9999,0,9999,0
1668159599338,CSE 293,019,119302,Lovett; Shachar,9999,0,9999,0
1668159599338,CSE 293,020,119303,McAuley; Julian John,9999,0,9999,0
1668159599338,CSE 293,021,119304,Micciancio; Daniele,9999,0,9999,0
1668159599338,CSE 293,022,119367,Orailoglu; Alex,9999,0,9999,0
1668159599338,CSE 293,023,119382,Paturi; Ramamohan,9999,0,9999,0
1668159599338,CSE 293,024,119404,Polikarpova; Nadezhda,9999,0,9999,0
1668159599338,CSE 293,025,119406,Politz; Joseph Gibbs,9999,0,9999,0
1668159599338,CSE 293,026,119411,Porter; George M,9999,0,9999,0
1668159599338,CSE 293,027,119414,Porter; Leonard Emerson,9999,0,9999,0
1668159599338,CSE 293,028,119416,Ramamoorthi; Ravi,9999,0,9999,0
1668159599338,CSE 293,029,119417,Sahoo; Debashis,9999,0,9999,0
1668159599338,CSE 293,030,119420,Saul; Lawrence,9999,0,9999,0
1668159599338,CSE 293,031,119421,Savage; Stefan,9999,0,9999,0
1668159599338,CSE 293,032,119425,Schulze; Jurgen P.,9999,0,9999,0
1668159599338,CSE 293,033,119426,Snoeren; Alex C.,9999,0,9999,0
1668159599338,CSE 293,034,119428,Shang; Jingbo,9999,0,9999,0
1668159599338,CSE 293,035,119430,Stefan; Deian,9999,0,9999,0
1668159599338,CSE 293,036,119431,Su; Hao,9999,0,9999,0
1668159599338,CSE 293,037,119433,Swanson; Steven James,9999,0,9999,0
1668159599338,CSE 293,038,119435,Tullsen; Dean Michael,9999,0,9999,0
1668159599338,CSE 293,039,119483,Voelker; Geoffrey M.,9999,0,9999,0
1668159599338,CSE 293,040,119537,Zhao; Jishen,9999,0,9999,0
1668159599338,CSE 293,041,119538,Zhou; Yuan-Yuan,9999,0,9999,0
1668159599338,CSE 293,042,119539,Gao; Sicun,9999,0,9999,0
1668159599338,CSE 293,043,119540,Weibel; Nadir,9999,0,9999,0
1668159599338,CSE 293,044,119541,Gupta; Rajesh K.,9999,0,9999,0
1668159599338,CSE 293,045,126410,Vaccaro; Kristen Marie,9999,0,9999,0
1668159599338,CSE 293,046,126411,Klemke; Richard,9999,0,9999,0
1668159599761,CSE 294,A00,102459,Voelker; Geoffrey M.,0,0,0,0
1668159599761,CSE 294,B00,111322,Orailoglu; Alex,0,0,0,0
1668159600187,DSE 201,A00,096914,Deutsch; Alin Bernard,30,0,30,0
1668159600612,DSE 210,A00,096915,Dasgupta; Sanjoy,30,0,30,0
1668159601042,DSE 260A,A00,096916,Altintas De Callaf; Ilkay,30,0,30,0
1668159601563,ECE 200,001,103586,Antipa; Nicholas A,9999,0,9999,0
1668159601563,ECE 200,002,103587,Atanasov; Nikolay A.,9999,0,9999,0
1668159601563,ECE 200,003,103588,Bharadia; Dinesh,9999,0,9999,0
1668159601563,ECE 200,004,103589,Cheng; Chung Kuan,9999,0,9999,0
1668159601563,ECE 200,005,103590,Cosman; Pamela C.,9999,0,9999,0
1668159601563,ECE 200,006,103591,Dayeh; Shadi Ahmad,9999,0,9999,0
1668159601563,ECE 200,007,103592,Fainman; Yeshaiahu,9999,0,9999,0
1668159601563,ECE 200,008,103593,Ford; Joseph Earl,9999,0,9999,0
1668159601563,ECE 200,009,103594,Franceschetti; Massimo,9999,0,9999,0
1668159601563,ECE 200,010,103595,Fullerton; Eric E,9999,0,9999,0
1668159601563,ECE 200,011,103596,Galton; Ian A,9999,0,9999,0
1668159601563,ECE 200,012,103597,Gilja; Vikash,9999,0,9999,0
1668159601563,ECE 200,013,103598,Hall; Drew A.,9999,0,9999,0
1668159601563,ECE 200,014,103599,Hsueh; Tzu-Chien,9999,0,9999,0
1668159601563,ECE 200,015,103600,Javidi; Tara,9999,0,9999,0
1668159601563,ECE 200,016,103601,Kahng; Andrew Byun,9999,0,9999,0
1668159601563,ECE 200,017,103602,Kim; Young-Han,9999,0,9999,0
1668159601563,ECE 200,018,103603,Koushanfar; Farinaz,9999,0,9999,0
1668159601563,ECE 200,019,103604,Kuzum; Duygu,9999,0,9999,0
1668159601563,ECE 200,020,103605,Le; Hanh-Phuc,9999,0,9999,0
1668159601563,ECE 200,021,103606,Lin; Bill,9999,0,9999,0
1668159601563,ECE 200,022,103607,Liu; Zhaowei,9998,0,9999,1
1668159601563,ECE 200,023,103608,Lo; Yu-Hwa,9999,0,9999,0
1668159601563,ECE 200,024,103609,Lomakin; Vitaliy,9999,0,9999,0
1668159601563,ECE 200,025,103610,Mercier; Patrick Philip,9999,0,9999,0
1668159601563,ECE 200,026,103611,Meyer; Florian,9999,0,9999,0
1668159601563,ECE 200,027,103612,Milstein; Laurence B.,9999,0,9999,0
1668159601563,ECE 200,028,103613,Mir Arabbaygi; Siavash,9999,0,9999,0
1668159601563,ECE 200,029,103614,Mookherjea; Shayan,9999,0,9999,0
1668159601563,ECE 200,030,103615,Morris; Karcher William,9999,0,9999,0
1668159601563,ECE 200,031,103616,Ng; Tse Nga,9999,0,9999,0
1668159601563,ECE 200,032,103617,Nguyen; Truong Quang,9999,0,9999,0
1668159601563,ECE 200,033,103618,Nomura; Kenji,9999,0,9999,0
1668159601563,ECE 200,034,103619,Orlitsky; Alon,9999,0,9999,0
1668159601563,ECE 200,035,103620,Pal; Piya,9999,0,9999,0
1668159601563,ECE 200,036,103621,Papen; George C.,9999,0,9999,0
1668159601563,ECE 200,037,103622,Radic; Stojan,9999,0,9999,0
1668159601563,ECE 200,038,103623,Rao; Bhaskar D.,9999,0,9999,0
1668159601563,ECE 200,039,103624,Rao; Ramesh R,9999,0,9999,0
1668159601563,ECE 200,040,103625,Rebeiz; Gabriel,9999,0,9999,0
1668159601563,ECE 200,041,103626,Sanford; John R,9999,0,9999,0
1668159601563,ECE 200,042,103627,Siegel; Paul H.,9999,0,9999,0
1668159601563,ECE 200,043,103628,Sievenpiper; Daniel F.,9999,0,9999,0
1668159601563,ECE 200,044,103629,Sworder; David D.,9999,0,9999,0
1668159601563,ECE 200,045,103630,Taur; Yuan,9999,0,9999,0
1668159601563,ECE 200,046,103631,Touri; Behrouz,9999,0,9999,0
1668159601563,ECE 200,047,103632,Trivedi; Mohan M.,9999,0,9999,0
1668159601563,ECE 200,048,103633,Vasconcelos; Nuno,9999,0,9999,0
1668159601563,ECE 200,049,103634,Wang; Xiaolong,9999,0,9999,0
1668159601563,ECE 200,050,103635,Xie; Pengtao,9999,0,9999,0
1668159601563,ECE 200,051,103636,Yip; Michael,9999,0,9999,0
1668159601563,ECE 200,052,103637,Zeger; Kenneth A.,999,0,999,0
1668159601563,ECE 200,053,103638,Zhang; Xinyu,9999,0,9999,0
1668159601563,ECE 200,054,103639,Turakhia; Yatish Girish,9999,0,9999,0
1668159601563,ECE 200,055,103640,Kang; Mingu,9999,0,9999,0
1668159601563,ECE 200,056,103641,Shi; Yuanyuan,9999,0,9999,0
1668159601563,ECE 200,057,103642,Wang; Edward Jay,9999,0,9999,0
1668159601563,ECE 200,058,103643,Zheng; Yang,9999,0,9999,0
1668159601989,ECE 202,A00,103644,Kuzum; Duygu,0,0,0,0
1668159602414,ECE 212BN,A00,103646,Ng; Tse Nga,0,0,0,0
1668159602839,ECE 221,A00,111493,Staff,0,0,0,0
1668159603264,ECE 222B,A00,103647,Lomakin; Vitaliy,0,0,0,0
1668159603693,ECE 230B,A00,103648,Taur; Yuan,0,0,0,0
1668159604117,ECE 238B,A00,103649,Garay; Javier,0,0,0,0
1668159604543,ECE 240B,A00,112900,Fainman; Yeshaiahu,0,0,0,0
1668159604969,ECE 247A,A00,103650,Jokerst; Jesse Vincent,0,0,0,0
1668159605397,ECE 247B,A00,103651,Wang; Joseph,0,0,0,0
1668159605825,ECE 250,A00,103652,Siegel; Paul H.,0,0,0,0
1668159606250,ECE 251A,A00,103654,Rao; Bhaskar D.,0,0,0,0
1668159606673,ECE 257B,A00,103655,Bharadia; Dinesh,0,0,0,0
1668159607097,ECE 258A,A00,103656,Milstein; Laurence B.,0,0,0,0
1668159607532,ECE 260B,A00,103658,Kang; Mingu,0,0,0,0
1668159607961,ECE 264A,A00,103659,Galton; Ian A,0,0,0,0
1668159608386,ECE 265A,A00,103661,Gudem; Prasad S.S.,0,0,0,0
1668159608810,ECE 265D,A00,103662,Gudem; Prasad S.S.,0,0,0,0
1668159609232,ECE 268,A00,103663,Koushanfar; Farinaz,0,0,0,0
1668159609661,ECE 269,A01,103665,Pal; Piya,0,0,0,0
1668159610092,ECE 271B,A00,103666,Vasconcelos; Manuela,0,0,0,0
1668159610519,ECE 276A,A00,103667,Atanasov; Nikolay A.,0,0,0,0
1668159610942,ECE 277,A00,103668,An; Cheolhong,0,0,0,0
1668159611378,ECE 279,A00,117947,Hall; Drew A.,0,0,0,0
1668159612230,ECE 283,A00,103670,Hsueh; Tzu-Chien,0,0,0,0
1668159612658,ECE 284,A00,103671,Turakhia; Yatish Girish,0,0,0,0
1668159613085,ECE 285,A00,103672,Zheng; Yang,0,0,0,0
1668159613085,ECE 285,B00,103673,Sworder; David D.,0,0,0,0
1668159613509,ECE 287,A00,103676,Javidi; Tara,0,0,0,0
1668159613935,MATH 200B,A00,098023,Salehi Golsefidy; Alireza,12,0,15,3
1668159614366,MATH 202B,A00,098024,Rhoades; Brendon Patrick,9,0,15,6
1668159614792,MATH 203B,A00,098025,Oprea; Dragos N.,10,0,15,5
1668159615307,MATH 204B,A00,098026,Sorensen; Claus M,13,0,15,2
1668159615731,MATH 208,A00,098027,Izadi; Elham,7,0,10,3
1668159616154,MATH 209,A00,098028,Pollack; Aaron,10,0,10,0
1668159616590,MATH 211A,A00,112919,Rogalski; Daniel,9,0,10,1
1668159617019,MATH 211B,A00,112920,Seward; Brandon M.,9,0,10,1
1668159617452,MATH 218,A00,098029,Li; Bo,10,0,10,0
1668159617879,MATH 220B,A00,098030,Novak; Jonathan I,11,0,15,4
1668159618305,MATH 221A,A00,098031,Ebenfelt; Peter F,13,0,15,2
1668159618735,MATH 231B,A00,098032,Zlatos; Andrej,12,0,15,3
1668159619161,MATH 240B,A00,098033,Ni; Lei,9,0,15,6
1668159619588,MATH 243,A00,098034,Jekel; David Andrew,10,0,10,0
1668159620018,MATH 245A,A00,098035,Nie; Jiawang,0,0,15,16
1668159620446,MATH 248,A00,098036,Bejenaru; Ioan,10,0,10,0
1668159620872,MATH 250B,A00,098037,Spolaor; Luca,14,0,15,1
1668159621297,MATH 258,A00,098038,Ni; Lei,10,0,10,0
1668159621722,MATH 264B,A00,098041,Rhoades; Brendon Patrick,9,0,15,6
1668159622146,MATH 268,A00,098042,Buss; Samuel R,10,0,10,0
1668159622570,MATH 269,A00,098043,Rhoades; Brendon Patrick,10,0,10,0
1668159622999,MATH 270B,A00,098044,Li; Bo,10,0,15,5
1668159623430,MATH 272B,A00,098045,Holst; Michael J,13,0,15,2
1668159623861,MATH 273A,A00,098046,Tian; Xiaochuan,10,0,15,5
1668159624290,MATH 275,A01,098048,Tian; Xiaochuan,6,0,10,4
1668159624716,MATH 278A,A00,098049,Holst; Michael J,8,0,10,2
1668159625141,MATH 278B,A00,098050,Cloninger; Alexander,10,0,10,0
1668159625568,MATH 278C,A00,098051,Nie; Jiawang,7,0,10,3
1668159625990,MATH 280B,A00,098052,Zheng; Tianyi,10,0,15,5
1668159626415,MATH 281B,A00,098053,Bradic; Jelena,2,0,15,13
1668159626848,MATH 282B,A00,098054,Arias-Castro; Ery,0,0,15,15
1668159627272,MATH 285,A00,098055,Fitzsimmons; Patrick J,0,0,15,17
1668159627699,MATH 287B,A00,098056,Arias-Castro; Ery,2,0,15,13
1668159628128,MATH 288,A00,098057,Agarwal; Pooja,9,0,10,1
1668159628128,MATH 288,B00,098058,Zhang; Danna,8,0,10,2
1668159628128,MATH 288,C00,098059,Williams; Ruth J,10,0,10,0
1668159628553,MATH 290B,A00,098060,Roberts; Justin Deritter,13,0,15,2
1668159628977,MATH 292,A00,098061,Belmont; Eva Kinoshita,10,0,10,0
1668159629402,MATH 295,A00,098062,Suk; Andrew Hoon,48,0,50,2
1668159629826,MATH 296,A00,098063,Novak; Jonathan I,20,0,20,0
1668159630254,MATH 297,001,098064,Gamst; Anthony Collins,9997,0,9999,2
1668160130798,COGS 205,A00,101395,Chiba; Andrea,19,0,20,1
1668160131243,COGS 210B,001,101404,Greene; Deanna Jacquelyn,9998,0,9999,1
1668160131243,COGS 210B,002,101417,Xia; Haijun,9999,0,9999,0
1668160131243,COGS 210B,003,101422,Nitz; Douglas A.,9999,0,9999,0
1668160131243,COGS 210B,004,101423,Hollan; James D.,9998,0,9999,1
1668160131243,COGS 210B,005,101424,Deak; Gedeon O.,9998,0,9999,1
1668160131243,COGS 210B,006,101425,Rossano; Federico,9999,0,9999,0
1668160131667,COGS 211B,A00,101427,Coulson; Seana M,9996,0,9999,3
1668160132090,COGS 220,A00,101428,Hollan; James D.,0,0,25,25
1668160132515,COGS 229,A00,101429,Dow; Steven P,18,0,25,7
1668160132944,COGS 230,A00,101430,Klemmer; Scott R,12,0,17,5
1668160133369,COGS 234,A00,101431,Xia; Haijun,3,0,25,22
1668160133798,COGS 260,A00,101432,Kiyonaga; Anastasia,20,0,25,5
1668160133798,COGS 260,B00,101433,Kirsh; David Joel,16,0,25,9
1668160134227,CSE 202,A00,102371,Impagliazzo; Russell,0,0,0,0
1668160134658,CSE 203B,A01,102373,Cheng; Chung Kuan,0,0,0,0
1668160135087,CSE 208,A00,102374,Micciancio; Daniele,0,0,0,0
1668160135512,CSE 209A,A00,112895,Impagliazzo; Russell,0,0,15,15
1668160136014,CSE 209B,A00,108005,Bellare; Mihir,0,0,0,0
1668160136441,CSE 210,A00,113163,Coblenz; Michael J,0,0,0,0
1668160136870,CSE 219,A00,106111,Dow; Steven P,0,0,20,20
1668160137297,CSE 221,A00,102376,Voelker; Geoffrey M.,0,0,0,0
1668160137723,CSE 224,A01,102378,Porter; George M,0,0,0,0
1668160138147,CSE 229A,A00,102379,Savage; Stefan,0,0,0,0
1668160138571,CSE 229C,A00,102380,Munyaka; Imani N. S.,0,0,0,0
1668160139003,CSE 232B,A00,102382,Deutsch; Alin Bernard,0,0,0,0
1668160139428,CSE 234,A01,112904,Kumar; Arun Kumar,0,0,0,0
1668160139859,CSE 237A,A00,102383,Rosing; Tajana Simunic,0,0,0,0
1668160140282,CSE 239A,A00,102384,Deutsch; Alin Bernard,0,0,0,0
1668160140707,CSE 239B,A00,102385,Polikarpova; Nadezhda,0,0,0,0
1668160141132,CSE 240A,A00,102386,Pannuto; Patrick William,0,0,0,0
1668160141560,CSE 240B,A00,102387,Zhao; Jishen,0,0,0,0
1668160141985,CSE 241A,A00,106406,Kang; Mingu,0,0,0,0
1668160142409,CSE 249B,A00,102388,Kahng; Andrew Byun,0,0,8,8
1668160142834,CSE 251B,A01,102392,Cottrell; Garrison W,0,0,0,0
1668160142834,CSE 251B,A02,102393,Cottrell; Garrison W,0,0,0,0
1668160143263,CSE 252B,A00,102394,Ochoa; Benjamin Lawrence,0,0,0,0
1668160143687,CSE 257,A01,102396,Gao; Sicun,0,0,0,0
1668160144116,CSE 272,A00,102397,Li; Tzumao,0,0,0,0
1668160144541,CSE 274,A00,111323,Chern; Albert Ren-Haur,0,0,0,0
1668160144965,CSE 282,A00,102398,Pevzner; Pavel Arkadjevich,0,0,0,0
1668160145395,CSE 284,A00,114175,Gymrek; Melissa Ann,0,0,0,0
1668160145821,CSE 290,A00,102399,Chandraker; Manmohan Krishna,0,0,0,0
1668160145821,CSE 290,B00,102400,Vaccaro; Kristen Marie,0,0,25,25
1668160145821,CSE 290,C00,102414,Pannuto; Patrick William,0,0,25,25
1668160145821,CSE 290,D00,102427,Pevzner; Pavel Arkadjevich,0,0,0,0
1668160145821,CSE 290,E00,102429,Zhao; Jishen,0,0,0,0
1668160145821,CSE 290,F00,102436,Tullsen; Dean Michael,0,0,0,0
1668160145821,CSE 290,G00,102440,Christensen; Henrik I,0,0,20,20
1668160146255,CSE 291,A00,102443,Su; Hao,0,0,0,0
1668160146255,CSE 291,B00,102448,Polikarpova; Nadezhda,0,0,0,0
1668160146255,CSE 291,C00,102453,Vaccaro; Kristen Marie,0,0,0,0
1668160146255,CSE 291,D00,111343,Savage; Stefan,0,0,0,0
1668160146255,CSE 291,E00,116474,Claffy; Kimberly Claire,0,0,0,0
1668160146255,CSE 291,F00,116479,Pasquale; Joseph,0,0,0,0
1668160146719,CSE 293,001,119111,Bafna; Vineet,9999,0,9999,0
1668160146719,CSE 293,002,119118,Bellare; Mihir,9999,0,9999,0
1668160146719,CSE 293,003,119122,Berg-Kirkpatrick; Taylor D,9999,0,9999,0
1668160146719,CSE 293,004,119135,Christensen; Henrik I,9999,0,9999,0
1668160146719,CSE 293,005,119142,Cottrell; Garrison W,9999,0,9999,0
1668160146719,CSE 293,006,119146,Deutsch; Alin Bernard,9999,0,9999,0
1668160146719,CSE 293,007,119159,Esmaeilzadeh; Hadi,9999,0,9999,0
1668160146719,CSE 293,008,119166,Freund; Yoav,9999,0,9999,0
1668160146719,CSE 293,009,119170,Griswold; William G.,9999,0,9999,0
1668160146719,CSE 293,010,119183,Gymrek; Melissa Ann,9999,0,9999,0
1668160146719,CSE 293,011,119190,Heninger; Nadia A,9999,0,9999,0
1668160146719,CSE 293,012,119230,Impagliazzo; Russell,9999,0,9999,0
1668160146719,CSE 293,013,119232,Jhala; Ranjit,9999,0,9999,0
1668160146719,CSE 293,014,119233,Kahng; Andrew Byun,9999,0,9999,0
1668160146719,CSE 293,015,119298,Kane; Daniel Mertz,9999,0,9999,0
1668160146719,CSE 293,016,119299,Kriegman; David J,9999,0,9999,0
1668160146719,CSE 293,017,119300,Kumar; Arun Kumar,9999,0,9999,0
1668160146719,CSE 293,018,119301,Lerner; Sorin,9999,0,9999,0
1668160146719,CSE 293,019,119302,Lovett; Shachar,9999,0,9999,0
1668160146719,CSE 293,020,119303,McAuley; Julian John,9999,0,9999,0
1668160146719,CSE 293,021,119304,Micciancio; Daniele,9999,0,9999,0
1668160146719,CSE 293,022,119367,Orailoglu; Alex,9999,0,9999,0
1668160146719,CSE 293,023,119382,Paturi; Ramamohan,9999,0,9999,0
1668160146719,CSE 293,024,119404,Polikarpova; Nadezhda,9999,0,9999,0
1668160146719,CSE 293,025,119406,Politz; Joseph Gibbs,9999,0,9999,0
1668160146719,CSE 293,026,119411,Porter; George M,9999,0,9999,0
1668160146719,CSE 293,027,119414,Porter; Leonard Emerson,9999,0,9999,0
1668160146719,CSE 293,028,119416,Ramamoorthi; Ravi,9999,0,9999,0
1668160146719,CSE 293,029,119417,Sahoo; Debashis,9999,0,9999,0
1668160146719,CSE 293,030,119420,Saul; Lawrence,9999,0,9999,0
1668160146719,CSE 293,031,119421,Savage; Stefan,9999,0,9999,0
1668160146719,CSE 293,032,119425,Schulze; Jurgen P.,9999,0,9999,0
1668160146719,CSE 293,033,119426,Snoeren; Alex C.,9999,0,9999,0
1668160146719,CSE 293,034,119428,Shang; Jingbo,9999,0,9999,0
1668160146719,CSE 293,035,119430,Stefan; Deian,9999,0,9999,0
1668160146719,CSE 293,036,119431,Su; Hao,9999,0,9999,0
1668160146719,CSE 293,037,119433,Swanson; Steven James,9999,0,9999,0
1668160146719,CSE 293,038,119435,Tullsen; Dean Michael,9999,0,9999,0
1668160146719,CSE 293,039,119483,Voelker; Geoffrey M.,9999,0,9999,0
1668160146719,CSE 293,040,119537,Zhao; Jishen,9999,0,9999,0
1668160146719,CSE 293,041,119538,Zhou; Yuan-Yuan,9999,0,9999,0
1668160146719,CSE 293,042,119539,Gao; Sicun,9999,0,9999,0
1668160146719,CSE 293,043,119540,Weibel; Nadir,9999,0,9999,0
1668160146719,CSE 293,044,119541,Gupta; Rajesh K.,9999,0,9999,0
1668160146719,CSE 293,045,126410,Vaccaro; Kristen Marie,9999,0,9999,0
1668160146719,CSE 293,046,126411,Klemke; Richard,9999,0,9999,0
1668160147145,CSE 294,A00,102459,Voelker; Geoffrey M.,0,0,0,0
1668160147145,CSE 294,B00,111322,Orailoglu; Alex,0,0,0,0
1668160147574,DSE 201,A00,096914,Deutsch; Alin Bernard,30,0,30,0
1668160148002,DSE 210,A00,096915,Dasgupta; Sanjoy,30,0,30,0
1668160148431,DSE 260A,A00,096916,Altintas De Callaf; Ilkay,30,0,30,0
1668160148906,ECE 200,001,103586,Antipa; Nicholas A,9999,0,9999,0
1668160148906,ECE 200,002,103587,Atanasov; Nikolay A.,9999,0,9999,0
1668160148906,ECE 200,003,103588,Bharadia; Dinesh,9999,0,9999,0
1668160148906,ECE 200,004,103589,Cheng; Chung Kuan,9999,0,9999,0
1668160148906,ECE 200,005,103590,Cosman; Pamela C.,9999,0,9999,0
1668160148906,ECE 200,006,103591,Dayeh; Shadi Ahmad,9999,0,9999,0
1668160148906,ECE 200,007,103592,Fainman; Yeshaiahu,9999,0,9999,0
1668160148906,ECE 200,008,103593,Ford; Joseph Earl,9999,0,9999,0
1668160148906,ECE 200,009,103594,Franceschetti; Massimo,9999,0,9999,0
1668160148906,ECE 200,010,103595,Fullerton; Eric E,9999,0,9999,0
1668160148906,ECE 200,011,103596,Galton; Ian A,9999,0,9999,0
1668160148906,ECE 200,012,103597,Gilja; Vikash,9999,0,9999,0
1668160148906,ECE 200,013,103598,Hall; Drew A.,9999,0,9999,0
1668160148906,ECE 200,014,103599,Hsueh; Tzu-Chien,9999,0,9999,0
1668160148906,ECE 200,015,103600,Javidi; Tara,9999,0,9999,0
1668160148906,ECE 200,016,103601,Kahng; Andrew Byun,9999,0,9999,0
1668160148906,ECE 200,017,103602,Kim; Young-Han,9999,0,9999,0
1668160148906,ECE 200,018,103603,Koushanfar; Farinaz,9999,0,9999,0
1668160148906,ECE 200,019,103604,Kuzum; Duygu,9999,0,9999,0
1668160148906,ECE 200,020,103605,Le; Hanh-Phuc,9999,0,9999,0
1668160148906,ECE 200,021,103606,Lin; Bill,9999,0,9999,0
1668160148906,ECE 200,022,103607,Liu; Zhaowei,9998,0,9999,1
1668160148906,ECE 200,023,103608,Lo; Yu-Hwa,9999,0,9999,0
1668160148906,ECE 200,024,103609,Lomakin; Vitaliy,9999,0,9999,0
1668160148906,ECE 200,025,103610,Mercier; Patrick Philip,9999,0,9999,0
1668160148906,ECE 200,026,103611,Meyer; Florian,9999,0,9999,0
1668160148906,ECE 200,027,103612,Milstein; Laurence B.,9999,0,9999,0
1668160148906,ECE 200,028,103613,Mir Arabbaygi; Siavash,9999,0,9999,0
1668160148906,ECE 200,029,103614,Mookherjea; Shayan,9999,0,9999,0
1668160148906,ECE 200,030,103615,Morris; Karcher William,9999,0,9999,0
1668160148906,ECE 200,031,103616,Ng; Tse Nga,9999,0,9999,0
1668160148906,ECE 200,032,103617,Nguyen; Truong Quang,9999,0,9999,0
1668160148906,ECE 200,033,103618,Nomura; Kenji,9999,0,9999,0
1668160148906,ECE 200,034,103619,Orlitsky; Alon,9999,0,9999,0
1668160148906,ECE 200,035,103620,Pal; Piya,9999,0,9999,0
1668160148906,ECE 200,036,103621,Papen; George C.,9999,0,9999,0
1668160148906,ECE 200,037,103622,Radic; Stojan,9999,0,9999,0
1668160148906,ECE 200,038,103623,Rao; Bhaskar D.,9999,0,9999,0
1668160148906,ECE 200,039,103624,Rao; Ramesh R,9999,0,9999,0
1668160148906,ECE 200,040,103625,Rebeiz; Gabriel,9999,0,9999,0
1668160148906,ECE 200,041,103626,Sanford; John R,9999,0,9999,0
1668160148906,ECE 200,042,103627,Siegel; Paul H.,9999,0,9999,0
1668160148906,ECE 200,043,103628,Sievenpiper; Daniel F.,9999,0,9999,0
1668160148906,ECE 200,044,103629,Sworder; David D.,9999,0,9999,0
1668160148906,ECE 200,045,103630,Taur; Yuan,9999,0,9999,0
1668160148906,ECE 200,046,103631,Touri; Behrouz,9999,0,9999,0
1668160148906,ECE 200,047,103632,Trivedi; Mohan M.,9999,0,9999,0
1668160148906,ECE 200,048,103633,Vasconcelos; Nuno,9999,0,9999,0
1668160148906,ECE 200,049,103634,Wang; Xiaolong,9999,0,9999,0
1668160148906,ECE 200,050,103635,Xie; Pengtao,9999,0,9999,0
1668160148906,ECE 200,051,103636,Yip; Michael,9999,0,9999,0
1668160148906,ECE 200,052,103637,Zeger; Kenneth A.,999,0,999,0
1668160148906,ECE 200,053,103638,Zhang; Xinyu,9999,0,9999,0
1668160148906,ECE 200,054,103639,Turakhia; Yatish Girish,9999,0,9999,0
1668160148906,ECE 200,055,103640,Kang; Mingu,9999,0,9999,0
1668160148906,ECE 200,056,103641,Shi; Yuanyuan,9999,0,9999,0
1668160148906,ECE 200,057,103642,Wang; Edward Jay,9999,0,9999,0
1668160148906,ECE 200,058,103643,Zheng; Yang,9999,0,9999,0
1668160149336,ECE 202,A00,103644,Kuzum; Duygu,0,0,0,0
1668160149761,ECE 212BN,A00,103646,Ng; Tse Nga,0,0,0,0
1668160150185,ECE 221,A00,111493,Staff,0,0,0,0
1668160150609,ECE 222B,A00,103647,Lomakin; Vitaliy,0,0,0,0
1668160151041,ECE 230B,A00,103648,Taur; Yuan,0,0,0,0
1668160151468,ECE 238B,A00,103649,Garay; Javier,0,0,0,0
1668160151893,ECE 240B,A00,112900,Fainman; Yeshaiahu,0,0,0,0
1668160152317,ECE 247A,A00,103650,Jokerst; Jesse Vincent,0,0,0,0
1668160152746,ECE 247B,A00,103651,Wang; Joseph,0,0,0,0
1668160153170,ECE 250,A00,103652,Siegel; Paul H.,0,0,0,0
1668160153596,ECE 251A,A00,103654,Rao; Bhaskar D.,0,0,0,0
1668160154028,ECE 257B,A00,103655,Bharadia; Dinesh,0,0,0,0
1668160154457,ECE 258A,A00,103656,Milstein; Laurence B.,0,0,0,0
1668160154884,ECE 260B,A00,103658,Kang; Mingu,0,0,0,0
1668160155309,ECE 264A,A00,103659,Galton; Ian A,0,0,0,0
1668160155733,ECE 265A,A00,103661,Gudem; Prasad S.S.,0,0,0,0
1668160156157,ECE 265D,A00,103662,Gudem; Prasad S.S.,0,0,0,0
1668160156580,ECE 268,A00,103663,Koushanfar; Farinaz,0,0,0,0
1668160157004,ECE 269,A01,103665,Pal; Piya,0,0,0,0
1668160157445,ECE 271B,A00,103666,Vasconcelos; Manuela,0,0,0,0
1668160157868,ECE 276A,A00,103667,Atanasov; Nikolay A.,0,0,0,0
1668160158293,ECE 277,A00,103668,An; Cheolhong,0,0,0,0
1668160158721,ECE 279,A00,117947,Hall; Drew A.,0,0,0,0
1668160159576,ECE 283,A00,103670,Hsueh; Tzu-Chien,0,0,0,0
1668160160004,ECE 284,A00,103671,Turakhia; Yatish Girish,0,0,0,0
1668160160432,ECE 285,A00,103672,Zheng; Yang,0,0,0,0
1668160160432,ECE 285,B00,103673,Sworder; David D.,0,0,0,0
1668160160856,ECE 287,A00,103676,Javidi; Tara,0,0,0,0
1668160161287,MATH 200B,A00,098023,Salehi Golsefidy; Alireza,12,0,15,3
1668160161711,MATH 202B,A00,098024,Rhoades; Brendon Patrick,9,0,15,6
1668160162136,MATH 203B,A00,098025,Oprea; Dragos N.,10,0,15,5
1668160162560,MATH 204B,A00,098026,Sorensen; Claus M,13,0,15,2
1668160162983,MATH 208,A00,098027,Izadi; Elham,7,0,10,3
1668160163410,MATH 209,A00,098028,Pollack; Aaron,10,0,10,0
1668160163835,MATH 211A,A00,112919,Rogalski; Daniel,9,0,10,1
1668160164263,MATH 211B,A00,112920,Seward; Brandon M.,9,0,10,1
1668160164692,MATH 218,A00,098029,Li; Bo,10,0,10,0
1668160165117,MATH 220B,A00,098030,Novak; Jonathan I,11,0,15,4
1668160165542,MATH 221A,A00,098031,Ebenfelt; Peter F,13,0,15,2
1668160165966,MATH 231B,A00,098032,Zlatos; Andrej,12,0,15,3
1668160166390,MATH 240B,A00,098033,Ni; Lei,9,0,15,6
1668160166819,MATH 243,A00,098034,Jekel; David Andrew,10,0,10,0
1668160167245,MATH 245A,A00,098035,Nie; Jiawang,0,0,15,16
1668160167673,MATH 248,A00,098036,Bejenaru; Ioan,10,0,10,0
1668160168096,MATH 250B,A00,098037,Spolaor; Luca,14,0,15,1
1668160168521,MATH 258,A00,098038,Ni; Lei,10,0,10,0
1668160168943,MATH 264B,A00,098041,Rhoades; Brendon Patrick,9,0,15,6
1668160169366,MATH 268,A00,098042,Buss; Samuel R,10,0,10,0
1668160169789,MATH 269,A00,098043,Rhoades; Brendon Patrick,10,0,10,0
1668160170213,MATH 270B,A00,098044,Li; Bo,10,0,15,5
1668160170637,MATH 272B,A00,098045,Holst; Michael J,13,0,15,2
1668160171064,MATH 273A,A00,098046,Tian; Xiaochuan,10,0,15,5
1668160171488,MATH 275,A01,098048,Tian; Xiaochuan,6,0,10,4
1668160171911,MATH 278A,A00,098049,Holst; Michael J,8,0,10,2
1668160172340,MATH 278B,A00,098050,Cloninger; Alexander,10,0,10,0
1668160172777,MATH 278C,A00,098051,Nie; Jiawang,7,0,10,3
1668160173204,MATH 280B,A00,098052,Zheng; Tianyi,10,0,15,5
1668160173626,MATH 281B,A00,098053,Bradic; Jelena,2,0,15,13
1668160174052,MATH 282B,A00,098054,Arias-Castro; Ery,0,0,15,15
1668160174476,MATH 285,A00,098055,Fitzsimmons; Patrick J,0,0,15,17
1668160174905,MATH 287B,A00,098056,Arias-Castro; Ery,2,0,15,13
1668160175336,MATH 288,A00,098057,Agarwal; Pooja,9,0,10,1
1668160175336,MATH 288,B00,098058,Zhang; Danna,8,0,10,2
1668160175336,MATH 288,C00,098059,Williams; Ruth J,10,0,10,0
1668160175764,MATH 290B,A00,098060,Roberts; Justin Deritter,13,0,15,2
1668160176191,MATH 292,A00,098061,Belmont; Eva Kinoshita,10,0,10,0
1668160176617,MATH 295,A00,098062,Suk; Andrew Hoon,48,0,50,2
1668160177041,MATH 296,A00,098063,Novak; Jonathan I,20,0,20,0
1668160177467,MATH 297,001,098064,Gamst; Anthony Collins,9997,0,9999,2
1668160677700,COGS 205,A00,101395,Chiba; Andrea,19,0,20,1
1668160678128,COGS 210B,001,101404,Greene; Deanna Jacquelyn,9998,0,9999,1
1668160678128,COGS 210B,002,101417,Xia; Haijun,9999,0,9999,0
1668160678128,COGS 210B,003,101422,Nitz; Douglas A.,9999,0,9999,0
1668160678128,COGS 210B,004,101423,Hollan; James D.,9998,0,9999,1
1668160678128,COGS 210B,005,101424,Deak; Gedeon O.,9998,0,9999,1
1668160678128,COGS 210B,006,101425,Rossano; Federico,9999,0,9999,0
1668160678550,COGS 211B,A00,101427,Coulson; Seana M,9996,0,9999,3
1668160678975,COGS 220,A00,101428,Hollan; James D.,0,0,25,25
1668160679398,COGS 229,A00,101429,Dow; Steven P,18,0,25,7
1668160679827,COGS 230,A00,101430,Klemmer; Scott R,12,0,17,5
1668160680251,COGS 234,A00,101431,Xia; Haijun,3,0,25,22
1668160680678,COGS 260,A00,101432,Kiyonaga; Anastasia,20,0,25,5
1668160680678,COGS 260,B00,101433,Kirsh; David Joel,16,0,25,9
1668160681105,CSE 202,A00,102371,Impagliazzo; Russell,0,0,0,0
1668160681530,CSE 203B,A01,102373,Cheng; Chung Kuan,0,0,0,0
1668160681958,CSE 208,A00,102374,Micciancio; Daniele,0,0,0,0
1668160682383,CSE 209A,A00,112895,Impagliazzo; Russell,0,0,15,15
1668160682806,CSE 209B,A00,108005,Bellare; Mihir,0,0,0,0
1668160683230,CSE 210,A00,113163,Coblenz; Michael J,0,0,0,0
1668160683654,CSE 219,A00,106111,Dow; Steven P,0,0,20,20
1668160684076,CSE 221,A00,102376,Voelker; Geoffrey M.,0,0,0,0
1668160684504,CSE 224,A01,102378,Porter; George M,0,0,0,0
1668160684931,CSE 229A,A00,102379,Savage; Stefan,0,0,0,0
1668160685354,CSE 229C,A00,102380,Munyaka; Imani N. S.,0,0,0,0
1668160685779,CSE 232B,A00,102382,Deutsch; Alin Bernard,0,0,0,0
1668160686210,CSE 234,A01,112904,Kumar; Arun Kumar,0,0,0,0
1668160686634,CSE 237A,A00,102383,Rosing; Tajana Simunic,0,0,0,0
1668160687061,CSE 239A,A00,102384,Deutsch; Alin Bernard,0,0,0,0
1668160687491,CSE 239B,A00,102385,Polikarpova; Nadezhda,0,0,0,0
1668160687917,CSE 240A,A00,102386,Pannuto; Patrick William,0,0,0,0
1668160688340,CSE 240B,A00,102387,Zhao; Jishen,0,0,0,0
1668160688765,CSE 241A,A00,106406,Kang; Mingu,0,0,0,0
1668160689188,CSE 249B,A00,102388,Kahng; Andrew Byun,0,0,8,8
1668160689611,CSE 251B,A01,102392,Cottrell; Garrison W,0,0,0,0
1668160689611,CSE 251B,A02,102393,Cottrell; Garrison W,0,0,0,0
1668160690037,CSE 252B,A00,102394,Ochoa; Benjamin Lawrence,0,0,0,0
1668160690460,CSE 257,A01,102396,Gao; Sicun,0,0,0,0
1668160690889,CSE 272,A00,102397,Li; Tzumao,0,0,0,0
1668160691316,CSE 274,A00,111323,Chern; Albert Ren-Haur,0,0,0,0
1668160691739,CSE 282,A00,102398,Pevzner; Pavel Arkadjevich,0,0,0,0
1668160692169,CSE 284,A00,114175,Gymrek; Melissa Ann,0,0,0,0
1668160692598,CSE 290,A00,102399,Chandraker; Manmohan Krishna,0,0,0,0
1668160692598,CSE 290,B00,102400,Vaccaro; Kristen Marie,0,0,25,25
1668160692598,CSE 290,C00,102414,Pannuto; Patrick William,0,0,25,25
1668160692598,CSE 290,D00,102427,Pevzner; Pavel Arkadjevich,0,0,0,0
1668160692598,CSE 290,E00,102429,Zhao; Jishen,0,0,0,0
1668160692598,CSE 290,F00,102436,Tullsen; Dean Michael,0,0,0,0
1668160692598,CSE 290,G00,102440,Christensen; Henrik I,0,0,20,20
1668160693022,CSE 291,A00,102443,Su; Hao,0,0,0,0
1668160693022,CSE 291,B00,102448,Polikarpova; Nadezhda,0,0,0,0
1668160693022,CSE 291,C00,102453,Vaccaro; Kristen Marie,0,0,0,0
1668160693022,CSE 291,D00,111343,Savage; Stefan,0,0,0,0
1668160693022,CSE 291,E00,116474,Claffy; Kimberly Claire,0,0,0,0
1668160693022,CSE 291,F00,116479,Pasquale; Joseph,0,0,0,0
1668160693472,CSE 293,001,119111,Bafna; Vineet,9999,0,9999,0
1668160693472,CSE 293,002,119118,Bellare; Mihir,9999,0,9999,0
1668160693472,CSE 293,003,119122,Berg-Kirkpatrick; Taylor D,9999,0,9999,0
1668160693472,CSE 293,004,119135,Christensen; Henrik I,9999,0,9999,0
1668160693472,CSE 293,005,119142,Cottrell; Garrison W,9999,0,9999,0
1668160693472,CSE 293,006,119146,Deutsch; Alin Bernard,9999,0,9999,0
1668160693472,CSE 293,007,119159,Esmaeilzadeh; Hadi,9999,0,9999,0
1668160693472,CSE 293,008,119166,Freund; Yoav,9999,0,9999,0
1668160693472,CSE 293,009,119170,Griswold; William G.,9999,0,9999,0
1668160693472,CSE 293,010,119183,Gymrek; Melissa Ann,9999,0,9999,0
1668160693472,CSE 293,011,119190,Heninger; Nadia A,9999,0,9999,0
1668160693472,CSE 293,012,119230,Impagliazzo; Russell,9999,0,9999,0
1668160693472,CSE 293,013,119232,Jhala; Ranjit,9999,0,9999,0
1668160693472,CSE 293,014,119233,Kahng; Andrew Byun,9999,0,9999,0
1668160693472,CSE 293,015,119298,Kane; Daniel Mertz,9999,0,9999,0
1668160693472,CSE 293,016,119299,Kriegman; David J,9999,0,9999,0
1668160693472,CSE 293,017,119300,Kumar; Arun Kumar,9999,0,9999,0
1668160693472,CSE 293,018,119301,Lerner; Sorin,9999,0,9999,0
1668160693472,CSE 293,019,119302,Lovett; Shachar,9999,0,9999,0
1668160693472,CSE 293,020,119303,McAuley; Julian John,9999,0,9999,0
1668160693472,CSE 293,021,119304,Micciancio; Daniele,9999,0,9999,0
1668160693472,CSE 293,022,119367,Orailoglu; Alex,9999,0,9999,0
1668160693472,CSE 293,023,119382,Paturi; Ramamohan,9999,0,9999,0
1668160693472,CSE 293,024,119404,Polikarpova; Nadezhda,9999,0,9999,0
1668160693472,CSE 293,025,119406,Politz; Joseph Gibbs,9999,0,9999,0
1668160693472,CSE 293,026,119411,Porter; George M,9999,0,9999,0
1668160693472,CSE 293,027,119414,Porter; Leonard Emerson,9999,0,9999,0
1668160693472,CSE 293,028,119416,Ramamoorthi; Ravi,9999,0,9999,0
1668160693472,CSE 293,029,119417,Sahoo; Debashis,9999,0,9999,0
1668160693472,CSE 293,030,119420,Saul; Lawrence,9999,0,9999,0
1668160693472,CSE 293,031,119421,Savage; Stefan,9999,0,9999,0
1668160693472,CSE 293,032,119425,Schulze; Jurgen P.,9999,0,9999,0
1668160693472,CSE 293,033,119426,Snoeren; Alex C.,9999,0,9999,0
1668160693472,CSE 293,034,119428,Shang; Jingbo,9999,0,9999,0
1668160693472,CSE 293,035,119430,Stefan; Deian,9999,0,9999,0
1668160693472,CSE 293,036,119431,Su; Hao,9999,0,9999,0
1668160693472,CSE 293,037,119433,Swanson; Steven James,9999,0,9999,0
1668160693472,CSE 293,038,119435,Tullsen; Dean Michael,9999,0,9999,0
1668160693472,CSE 293,039,119483,Voelker; Geoffrey M.,9999,0,9999,0
1668160693472,CSE 293,040,119537,Zhao; Jishen,9999,0,9999,0
1668160693472,CSE 293,041,119538,Zhou; Yuan-Yuan,9999,0,9999,0
1668160693472,CSE 293,042,119539,Gao; Sicun,9999,0,9999,0
1668160693472,CSE 293,043,119540,Weibel; Nadir,9999,0,9999,0
1668160693472,CSE 293,044,119541,Gupta; Rajesh K.,9999,0,9999,0
1668160693472,CSE 293,045,126410,Vaccaro; Kristen Marie,9999,0,9999,0
1668160693472,CSE 293,046,126411,Klemke; Richard,9999,0,9999,0
1668160693899,CSE 294,A00,102459,Voelker; Geoffrey M.,0,0,0,0
1668160693899,CSE 294,B00,111322,Orailoglu; Alex,0,0,0,0
1668160694324,DSE 201,A00,096914,Deutsch; Alin Bernard,30,0,30,0
1668160694752,DSE 210,A00,096915,Dasgupta; Sanjoy,30,0,30,0
1668160695176,DSE 260A,A00,096916,Altintas De Callaf; Ilkay,30,0,30,0
1668160695612,ECE 200,001,103586,Antipa; Nicholas A,9999,0,9999,0
1668160695612,ECE 200,002,103587,Atanasov; Nikolay A.,9999,0,9999,0
1668160695612,ECE 200,003,103588,Bharadia; Dinesh,9999,0,9999,0
1668160695612,ECE 200,004,103589,Cheng; Chung Kuan,9999,0,9999,0
1668160695612,ECE 200,005,103590,Cosman; Pamela C.,9999,0,9999,0
1668160695612,ECE 200,006,103591,Dayeh; Shadi Ahmad,9999,0,9999,0
1668160695612,ECE 200,007,103592,Fainman; Yeshaiahu,9999,0,9999,0
1668160695612,ECE 200,008,103593,Ford; Joseph Earl,9999,0,9999,0
1668160695612,ECE 200,009,103594,Franceschetti; Massimo,9999,0,9999,0
1668160695612,ECE 200,010,103595,Fullerton; Eric E,9999,0,9999,0
1668160695612,ECE 200,011,103596,Galton; Ian A,9999,0,9999,0
1668160695612,ECE 200,012,103597,Gilja; Vikash,9999,0,9999,0
1668160695612,ECE 200,013,103598,Hall; Drew A.,9999,0,9999,0
1668160695612,ECE 200,014,103599,Hsueh; Tzu-Chien,9999,0,9999,0
1668160695612,ECE 200,015,103600,Javidi; Tara,9999,0,9999,0
1668160695612,ECE 200,016,103601,Kahng; Andrew Byun,9999,0,9999,0
1668160695612,ECE 200,017,103602,Kim; Young-Han,9999,0,9999,0
1668160695612,ECE 200,018,103603,Koushanfar; Farinaz,9999,0,9999,0
1668160695612,ECE 200,019,103604,Kuzum; Duygu,9999,0,9999,0
1668160695612,ECE 200,020,103605,Le; Hanh-Phuc,9999,0,9999,0
1668160695612,ECE 200,021,103606,Lin; Bill,9999,0,9999,0
1668160695612,ECE 200,022,103607,Liu; Zhaowei,9998,0,9999,1
1668160695612,ECE 200,023,103608,Lo; Yu-Hwa,9999,0,9999,0
1668160695612,ECE 200,024,103609,Lomakin; Vitaliy,9999,0,9999,0
1668160695612,ECE 200,025,103610,Mercier; Patrick Philip,9999,0,9999,0
1668160695612,ECE 200,026,103611,Meyer; Florian,9999,0,9999,0
1668160695612,ECE 200,027,103612,Milstein; Laurence B.,9999,0,9999,0
1668160695612,ECE 200,028,103613,Mir Arabbaygi; Siavash,9999,0,9999,0
1668160695612,ECE 200,029,103614,Mookherjea; Shayan,9999,0,9999,0
1668160695612,ECE 200,030,103615,Morris; Karcher William,9999,0,9999,0
1668160695612,ECE 200,031,103616,Ng; Tse Nga,9999,0,9999,0
1668160695612,ECE 200,032,103617,Nguyen; Truong Quang,9999,0,9999,0
1668160695612,ECE 200,033,103618,Nomura; Kenji,9999,0,9999,0
1668160695612,ECE 200,034,103619,Orlitsky; Alon,9999,0,9999,0
1668160695612,ECE 200,035,103620,Pal; Piya,9999,0,9999,0
1668160695612,ECE 200,036,103621,Papen; George C.,9999,0,9999,0
1668160695612,ECE 200,037,103622,Radic; Stojan,9999,0,9999,0
1668160695612,ECE 200,038,103623,Rao; Bhaskar D.,9999,0,9999,0
1668160695612,ECE 200,039,103624,Rao; Ramesh R,9999,0,9999,0
1668160695612,ECE 200,040,103625,Rebeiz; Gabriel,9999,0,9999,0
1668160695612,ECE 200,041,103626,Sanford; John R,9999,0,9999,0
1668160695612,ECE 200,042,103627,Siegel; Paul H.,9999,0,9999,0
1668160695612,ECE 200,043,103628,Sievenpiper; Daniel F.,9999,0,9999,0
1668160695612,ECE 200,044,103629,Sworder; David D.,9999,0,9999,0
1668160695612,ECE 200,045,103630,Taur; Yuan,9999,0,9999,0
1668160695612,ECE 200,046,103631,Touri; Behrouz,9999,0,9999,0
1668160695612,ECE 200,047,103632,Trivedi; Mohan M.,9999,0,9999,0
1668160695612,ECE 200,048,103633,Vasconcelos; Nuno,9999,0,9999,0
1668160695612,ECE 200,049,103634,Wang; Xiaolong,9999,0,9999,0
1668160695612,ECE 200,050,103635,Xie; Pengtao,9999,0,9999,0
1668160695612,ECE 200,051,103636,Yip; Michael,9999,0,9999,0
1668160695612,ECE 200,052,103637,Zeger; Kenneth A.,999,0,999,0
1668160695612,ECE 200,053,103638,Zhang; Xinyu,9999,0,9999,0
1668160695612,ECE 200,054,103639,Turakhia; Yatish Girish,9999,0,9999,0
1668160695612,ECE 200,055,103640,Kang; Mingu,9999,0,9999,0
1668160695612,ECE 200,056,103641,Shi; Yuanyuan,9999,0,9999,0
1668160695612,ECE 200,057,103642,Wang; Edward Jay,9999,0,9999,0
1668160695612,ECE 200,058,103643,Zheng; Yang,9999,0,9999,0
1668160696039,ECE 202,A00,103644,Kuzum; Duygu,0,0,0,0
1668160696464,ECE 212BN,A00,103646,Ng; Tse Nga,0,0,0,0
1668160696888,ECE 221,A00,111493,Staff,0,0,0,0
1668160697310,ECE 222B,A00,103647,Lomakin; Vitaliy,0,0,0,0
1668160697735,ECE 230B,A00,103648,Taur; Yuan,0,0,0,0
1668160698163,ECE 238B,A00,103649,Garay; Javier,0,0,0,0
1668160698590,ECE 240B,A00,112900,Fainman; Yeshaiahu,0,0,0,0
1668160699014,ECE 247A,A00,103650,Jokerst; Jesse Vincent,0,0,0,0
1668160699531,ECE 247B,A00,103651,Wang; Joseph,0,0,0,0
1668160699963,ECE 250,A00,103652,Siegel; Paul H.,0,0,0,0
1668160700388,ECE 251A,A00,103654,Rao; Bhaskar D.,0,0,0,0
1668160700812,ECE 257B,A00,103655,Bharadia; Dinesh,0,0,0,0
1668160701239,ECE 258A,A00,103656,Milstein; Laurence B.,0,0,0,0
1668160701667,ECE 260B,A00,103658,Kang; Mingu,0,0,0,0
1668160702092,ECE 264A,A00,103659,Galton; Ian A,0,0,0,0
1668160702518,ECE 265A,A00,103661,Gudem; Prasad S.S.,0,0,0,0
1668160702946,ECE 265D,A00,103662,Gudem; Prasad S.S.,0,0,0,0
1668160703372,ECE 268,A00,103663,Koushanfar; Farinaz,0,0,0,0
1668160703796,ECE 269,A01,103665,Pal; Piya,0,0,0,0
1668160704219,ECE 271B,A00,103666,Vasconcelos; Manuela,0,0,0,0
1668160704641,ECE 276A,A00,103667,Atanasov; Nikolay A.,0,0,0,0
1668160705067,ECE 277,A00,103668,An; Cheolhong,0,0,0,0
1668160705490,ECE 279,A00,117947,Hall; Drew A.,0,0,0,0
1668160706341,ECE 283,A00,103670,Hsueh; Tzu-Chien,0,0,0,0
1668160706766,ECE 284,A00,103671,Turakhia; Yatish Girish,0,0,0,0
1668160707191,ECE 285,A00,103672,Zheng; Yang,0,0,0,0
1668160707191,ECE 285,B00,103673,Sworder; David D.,0,0,0,0
1668160707618,ECE 287,A00,103676,Javidi; Tara,0,0,0,0
1668160708041,MATH 200B,A00,098023,Salehi Golsefidy; Alireza,12,0,15,3
1668160708471,MATH 202B,A00,098024,Rhoades; Brendon Patrick,9,0,15,6
1668160708896,MATH 203B,A00,098025,Oprea; Dragos N.,10,0,15,5
1668160709324,MATH 204B,A00,098026,Sorensen; Claus M,13,0,15,2
1668160709753,MATH 208,A00,098027,Izadi; Elham,7,0,10,3
1668160710180,MATH 209,A00,098028,Pollack; Aaron,10,0,10,0
1668160710607,MATH 211A,A00,112919,Rogalski; Daniel,9,0,10,1
1668160711034,MATH 211B,A00,112920,Seward; Brandon M.,9,0,10,1
1668160711457,MATH 218,A00,098029,Li; Bo,10,0,10,0
1668160711885,MATH 220B,A00,098030,Novak; Jonathan I,11,0,15,4
1668160712309,MATH 221A,A00,098031,Ebenfelt; Peter F,13,0,15,2
1668160712732,MATH 231B,A00,098032,Zlatos; Andrej,12,0,15,3
1668160713154,MATH 240B,A00,098033,Ni; Lei,9,0,15,6
1668160713579,MATH 243,A00,098034,Jekel; David Andrew,10,0,10,0
1668160714009,MATH 245A,A00,098035,Nie; Jiawang,0,0,15,16
1668160714435,MATH 248,A00,098036,Bejenaru; Ioan,10,0,10,0
1668160714858,MATH 250B,A00,098037,Spolaor; Luca,14,0,15,1
1668160715283,MATH 258,A00,098038,Ni; Lei,10,0,10,0
1668160715706,MATH 264B,A00,098041,Rhoades; Brendon Patrick,9,0,15,6
1668160716130,MATH 268,A00,098042,Buss; Samuel R,10,0,10,0
1668160716553,MATH 269,A00,098043,Rhoades; Brendon Patrick,10,0,10,0
1668160716977,MATH 270B,A00,098044,Li; Bo,10,0,15,5
1668160717407,MATH 272B,A00,098045,Holst; Michael J,13,0,15,2
1668160717832,MATH 273A,A00,098046,Tian; Xiaochuan,10,0,15,5
1668160718257,MATH 275,A01,098048,Tian; Xiaochuan,6,0,10,4
1668160718682,MATH 278A,A00,098049,Holst; Michael J,8,0,10,2
1668160719110,MATH 278B,A00,098050,Cloninger; Alexander,10,0,10,0
1668160719535,MATH 278C,A00,098051,Nie; Jiawang,7,0,10,3
1668160719959,MATH 280B,A00,098052,Zheng; Tianyi,10,0,15,5
1668160720385,MATH 281B,A00,098053,Bradic; Jelena,2,0,15,13
1668160720809,MATH 282B,A00,098054,Arias-Castro; Ery,0,0,15,15
1668160721234,MATH 285,A00,098055,Fitzsimmons; Patrick J,0,0,15,17
1668160721659,MATH 287B,A00,098056,Arias-Castro; Ery,2,0,15,13
1668160722083,MATH 288,A00,098057,Agarwal; Pooja,9,0,10,1
1668160722083,MATH 288,B00,098058,Zhang; Danna,8,0,10,2
1668160722083,MATH 288,C00,098059,Williams; Ruth J,10,0,10,0
1668160722505,MATH 290B,A00,098060,Roberts; Justin Deritter,13,0,15,2
1668160722933,MATH 292,A00,098061,Belmont; Eva Kinoshita,10,0,10,0
1668160723356,MATH 295,A00,098062,Suk; Andrew Hoon,48,0,50,2
1668160723780,MATH 296,A00,098063,Novak; Jonathan I,20,0,20,0
1668160724203,MATH 297,001,098064,Gamst; Anthony Collins,9997,0,9999,2
1668161224111,COGS 205,A00,101395,Chiba; Andrea,19,0,20,1
1668161224542,COGS 210B,001,101404,Greene; Deanna Jacquelyn,9998,0,9999,1
1668161224542,COGS 210B,002,101417,Xia; Haijun,9999,0,9999,0
1668161224542,COGS 210B,003,101422,Nitz; Douglas A.,9999,0,9999,0
1668161224542,COGS 210B,004,101423,Hollan; James D.,9998,0,9999,1
1668161224542,COGS 210B,005,101424,Deak; Gedeon O.,9998,0,9999,1
1668161224542,COGS 210B,006,101425,Rossano; Federico,9999,0,9999,0
1668161224968,COGS 211B,A00,101427,Coulson; Seana M,9996,0,9999,3
1668161225393,COGS 220,A00,101428,Hollan; James D.,0,0,25,25
1668161225819,COGS 229,A00,101429,Dow; Steven P,18,0,25,7
1668161226241,COGS 230,A00,101430,Klemmer; Scott R,12,0,17,5
1668161226664,COGS 234,A00,101431,Xia; Haijun,3,0,25,22
1668161227087,COGS 260,A00,101432,Kiyonaga; Anastasia,20,0,25,5
1668161227087,COGS 260,B00,101433,Kirsh; David Joel,16,0,25,9
1668161227515,CSE 202,A00,102371,Impagliazzo; Russell,0,0,0,0
1668161227943,CSE 203B,A01,102373,Cheng; Chung Kuan,0,0,0,0
1668161228371,CSE 208,A00,102374,Micciancio; Daniele,0,0,0,0
1668161228794,CSE 209A,A00,112895,Impagliazzo; Russell,0,0,15,15
1668161229216,CSE 209B,A00,108005,Bellare; Mihir,0,0,0,0
1668161229640,CSE 210,A00,113163,Coblenz; Michael J,0,0,0,0
1668161230069,CSE 219,A00,106111,Dow; Steven P,0,0,20,20
1668161230494,CSE 221,A00,102376,Voelker; Geoffrey M.,0,0,0,0
1668161230917,CSE 224,A01,102378,Porter; George M,0,0,0,0
1668161231339,CSE 229A,A00,102379,Savage; Stefan,0,0,0,0
1668161231761,CSE 229C,A00,102380,Munyaka; Imani N. S.,0,0,0,0
1668161232187,CSE 232B,A00,102382,Deutsch; Alin Bernard,0,0,0,0
1668161232614,CSE 234,A01,112904,Kumar; Arun Kumar,0,0,0,0
1668161233040,CSE 237A,A00,102383,Rosing; Tajana Simunic,0,0,0,0
1668161233464,CSE 239A,A00,102384,Deutsch; Alin Bernard,0,0,0,0
1668161233888,CSE 239B,A00,102385,Polikarpova; Nadezhda,0,0,0,0
1668161234312,CSE 240A,A00,102386,Pannuto; Patrick William,0,0,0,0
1668161234736,CSE 240B,A00,102387,Zhao; Jishen,0,0,0,0
1668161235161,CSE 241A,A00,106406,Kang; Mingu,0,0,0,0
1668161235584,CSE 249B,A00,102388,Kahng; Andrew Byun,0,0,8,8
1668161236008,CSE 251B,A01,102392,Cottrell; Garrison W,0,0,0,0
1668161236008,CSE 251B,A02,102393,Cottrell; Garrison W,0,0,0,0
1668161236435,CSE 252B,A00,102394,Ochoa; Benjamin Lawrence,0,0,0,0
1668161236862,CSE 257,A01,102396,Gao; Sicun,0,0,0,0
1668161237285,CSE 272,A00,102397,Li; Tzumao,0,0,0,0
1668161237715,CSE 274,A00,111323,Chern; Albert Ren-Haur,0,0,0,0
1668161238137,CSE 282,A00,102398,Pevzner; Pavel Arkadjevich,0,0,0,0
1668161238566,CSE 284,A00,114175,Gymrek; Melissa Ann,0,0,0,0
1668161238990,CSE 290,A00,102399,Chandraker; Manmohan Krishna,0,0,0,0
1668161238990,CSE 290,B00,102400,Vaccaro; Kristen Marie,0,0,25,25
1668161238990,CSE 290,C00,102414,Pannuto; Patrick William,0,0,25,25
1668161238990,CSE 290,D00,102427,Pevzner; Pavel Arkadjevich,0,0,0,0
1668161238990,CSE 290,E00,102429,Zhao; Jishen,0,0,0,0
1668161238990,CSE 290,F00,102436,Tullsen; Dean Michael,0,0,0,0
1668161238990,CSE 290,G00,102440,Christensen; Henrik I,0,0,20,20
1668161239416,CSE 291,A00,102443,Su; Hao,0,0,0,0
1668161239416,CSE 291,B00,102448,Polikarpova; Nadezhda,0,0,0,0
1668161239416,CSE 291,C00,102453,Vaccaro; Kristen Marie,0,0,0,0
1668161239416,CSE 291,D00,111343,Savage; Stefan,0,0,0,0
1668161239416,CSE 291,E00,116474,Claffy; Kimberly Claire,0,0,0,0
1668161239416,CSE 291,F00,116479,Pasquale; Joseph,0,0,0,0
1668161239855,CSE 293,001,119111,Bafna; Vineet,9999,0,9999,0
1668161239855,CSE 293,002,119118,Bellare; Mihir,9999,0,9999,0
1668161239855,CSE 293,003,119122,Berg-Kirkpatrick; Taylor D,9999,0,9999,0
1668161239855,CSE 293,004,119135,Christensen; Henrik I,9999,0,9999,0
1668161239855,CSE 293,005,119142,Cottrell; Garrison W,9999,0,9999,0
1668161239855,CSE 293,006,119146,Deutsch; Alin Bernard,9999,0,9999,0
1668161239855,CSE 293,007,119159,Esmaeilzadeh; Hadi,9999,0,9999,0
1668161239855,CSE 293,008,119166,Freund; Yoav,9999,0,9999,0
1668161239855,CSE 293,009,119170,Griswold; William G.,9999,0,9999,0
1668161239855,CSE 293,010,119183,Gymrek; Melissa Ann,9999,0,9999,0
1668161239855,CSE 293,011,119190,Heninger; Nadia A,9999,0,9999,0
1668161239855,CSE 293,012,119230,Impagliazzo; Russell,9999,0,9999,0
1668161239855,CSE 293,013,119232,Jhala; Ranjit,9999,0,9999,0
1668161239855,CSE 293,014,119233,Kahng; Andrew Byun,9999,0,9999,0
1668161239855,CSE 293,015,119298,Kane; Daniel Mertz,9999,0,9999,0
1668161239855,CSE 293,016,119299,Kriegman; David J,9999,0,9999,0
1668161239855,CSE 293,017,119300,Kumar; Arun Kumar,9999,0,9999,0
1668161239855,CSE 293,018,119301,Lerner; Sorin,9999,0,9999,0
1668161239855,CSE 293,019,119302,Lovett; Shachar,9999,0,9999,0
1668161239855,CSE 293,020,119303,McAuley; Julian John,9999,0,9999,0
1668161239855,CSE 293,021,119304,Micciancio; Daniele,9999,0,9999,0
1668161239855,CSE 293,022,119367,Orailoglu; Alex,9999,0,9999,0
1668161239855,CSE 293,023,119382,Paturi; Ramamohan,9999,0,9999,0
1668161239855,CSE 293,024,119404,Polikarpova; Nadezhda,9999,0,9999,0
1668161239855,CSE 293,025,119406,Politz; Joseph Gibbs,9999,0,9999,0
1668161239855,CSE 293,026,119411,Porter; George M,9999,0,9999,0
1668161239855,CSE 293,027,119414,Porter; Leonard Emerson,9999,0,9999,0
1668161239855,CSE 293,028,119416,Ramamoorthi; Ravi,9999,0,9999,0
1668161239855,CSE 293,029,119417,Sahoo; Debashis,9999,0,9999,0
1668161239855,CSE 293,030,119420,Saul; Lawrence,9999,0,9999,0
1668161239855,CSE 293,031,119421,Savage; Stefan,9999,0,9999,0
1668161239855,CSE 293,032,119425,Schulze; Jurgen P.,9999,0,9999,0
1668161239855,CSE 293,033,119426,Snoeren; Alex C.,9999,0,9999,0
1668161239855,CSE 293,034,119428,Shang; Jingbo,9999,0,9999,0
1668161239855,CSE 293,035,119430,Stefan; Deian,9999,0,9999,0
1668161239855,CSE 293,036,119431,Su; Hao,9999,0,9999,0
1668161239855,CSE 293,037,119433,Swanson; Steven James,9999,0,9999,0
1668161239855,CSE 293,038,119435,Tullsen; Dean Michael,9999,0,9999,0
1668161239855,CSE 293,039,119483,Voelker; Geoffrey M.,9999,0,9999,0
1668161239855,CSE 293,040,119537,Zhao; Jishen,9999,0,9999,0
1668161239855,CSE 293,041,119538,Zhou; Yuan-Yuan,9999,0,9999,0
1668161239855,CSE 293,042,119539,Gao; Sicun,9999,0,9999,0
1668161239855,CSE 293,043,119540,Weibel; Nadir,9999,0,9999,0
1668161239855,CSE 293,044,119541,Gupta; Rajesh K.,9999,0,9999,0
1668161239855,CSE 293,045,126410,Vaccaro; Kristen Marie,9999,0,9999,0
1668161239855,CSE 293,046,126411,Klemke; Richard,9999,0,9999,0
1668161240282,CSE 294,A00,102459,Voelker; Geoffrey M.,0,0,0,0
1668161240282,CSE 294,B00,111322,Orailoglu; Alex,0,0,0,0
1668161240709,DSE 201,A00,096914,Deutsch; Alin Bernard,30,0,30,0
1668161241134,DSE 210,A00,096915,Dasgupta; Sanjoy,30,0,30,0
1668161241563,DSE 260A,A00,096916,Altintas De Callaf; Ilkay,30,0,30,0
1668161242010,ECE 200,001,103586,Antipa; Nicholas A,9999,0,9999,0
1668161242010,ECE 200,002,103587,Atanasov; Nikolay A.,9999,0,9999,0
1668161242010,ECE 200,003,103588,Bharadia; Dinesh,9999,0,9999,0
1668161242010,ECE 200,004,103589,Cheng; Chung Kuan,9999,0,9999,0
1668161242010,ECE 200,005,103590,Cosman; Pamela C.,9999,0,9999,0
1668161242010,ECE 200,006,103591,Dayeh; Shadi Ahmad,9999,0,9999,0
1668161242010,ECE 200,007,103592,Fainman; Yeshaiahu,9999,0,9999,0
1668161242010,ECE 200,008,103593,Ford; Joseph Earl,9999,0,9999,0
1668161242010,ECE 200,009,103594,Franceschetti; Massimo,9999,0,9999,0
1668161242010,ECE 200,010,103595,Fullerton; Eric E,9999,0,9999,0
1668161242010,ECE 200,011,103596,Galton; Ian A,9999,0,9999,0
1668161242010,ECE 200,012,103597,Gilja; Vikash,9999,0,9999,0
1668161242010,ECE 200,013,103598,Hall; Drew A.,9999,0,9999,0
1668161242010,ECE 200,014,103599,Hsueh; Tzu-Chien,9999,0,9999,0
1668161242010,ECE 200,015,103600,Javidi; Tara,9999,0,9999,0
1668161242010,ECE 200,016,103601,Kahng; Andrew Byun,9999,0,9999,0
1668161242010,ECE 200,017,103602,Kim; Young-Han,9999,0,9999,0
1668161242010,ECE 200,018,103603,Koushanfar; Farinaz,9999,0,9999,0
1668161242010,ECE 200,019,103604,Kuzum; Duygu,9999,0,9999,0
1668161242010,ECE 200,020,103605,Le; Hanh-Phuc,9999,0,9999,0
1668161242010,ECE 200,021,103606,Lin; Bill,9999,0,9999,0
1668161242010,ECE 200,022,103607,Liu; Zhaowei,9998,0,9999,1
1668161242010,ECE 200,023,103608,Lo; Yu-Hwa,9999,0,9999,0
1668161242010,ECE 200,024,103609,Lomakin; Vitaliy,9999,0,9999,0
1668161242010,ECE 200,025,103610,Mercier; Patrick Philip,9999,0,9999,0
1668161242010,ECE 200,026,103611,Meyer; Florian,9999,0,9999,0
1668161242010,ECE 200,027,103612,Milstein; Laurence B.,9999,0,9999,0
1668161242010,ECE 200,028,103613,Mir Arabbaygi; Siavash,9999,0,9999,0
1668161242010,ECE 200,029,103614,Mookherjea; Shayan,9999,0,9999,0
1668161242010,ECE 200,030,103615,Morris; Karcher William,9999,0,9999,0
1668161242010,ECE 200,031,103616,Ng; Tse Nga,9999,0,9999,0
1668161242010,ECE 200,032,103617,Nguyen; Truong Quang,9999,0,9999,0
1668161242010,ECE 200,033,103618,Nomura; Kenji,9999,0,9999,0
1668161242010,ECE 200,034,103619,Orlitsky; Alon,9999,0,9999,0
1668161242010,ECE 200,035,103620,Pal; Piya,9999,0,9999,0
1668161242010,ECE 200,036,103621,Papen; George C.,9999,0,9999,0
1668161242010,ECE 200,037,103622,Radic; Stojan,9999,0,9999,0
1668161242010,ECE 200,038,103623,Rao; Bhaskar D.,9999,0,9999,0
1668161242010,ECE 200,039,103624,Rao; Ramesh R,9999,0,9999,0
1668161242010,ECE 200,040,103625,Rebeiz; Gabriel,9999,0,9999,0
1668161242010,ECE 200,041,103626,Sanford; John R,9999,0,9999,0
1668161242010,ECE 200,042,103627,Siegel; Paul H.,9999,0,9999,0
1668161242010,ECE 200,043,103628,Sievenpiper; Daniel F.,9999,0,9999,0
1668161242010,ECE 200,044,103629,Sworder; David D.,9999,0,9999,0
1668161242010,ECE 200,045,103630,Taur; Yuan,9999,0,9999,0
1668161242010,ECE 200,046,103631,Touri; Behrouz,9999,0,9999,0
1668161242010,ECE 200,047,103632,Trivedi; Mohan M.,9999,0,9999,0
1668161242010,ECE 200,048,103633,Vasconcelos; Nuno,9999,0,9999,0
1668161242010,ECE 200,049,103634,Wang; Xiaolong,9999,0,9999,0
1668161242010,ECE 200,050,103635,Xie; Pengtao,9999,0,9999,0
1668161242010,ECE 200,051,103636,Yip; Michael,9999,0,9999,0
1668161242010,ECE 200,052,103637,Zeger; Kenneth A.,999,0,999,0
1668161242010,ECE 200,053,103638,Zhang; Xinyu,9999,0,9999,0
1668161242010,ECE 200,054,103639,Turakhia; Yatish Girish,9999,0,9999,0
1668161242010,ECE 200,055,103640,Kang; Mingu,9999,0,9999,0
1668161242010,ECE 200,056,103641,Shi; Yuanyuan,9999,0,9999,0
1668161242010,ECE 200,057,103642,Wang; Edward Jay,9999,0,9999,0
1668161242010,ECE 200,058,103643,Zheng; Yang,9999,0,9999,0
1668161242434,ECE 202,A00,103644,Kuzum; Duygu,0,0,0,0
1668161242858,ECE 212BN,A00,103646,Ng; Tse Nga,0,0,0,0
1668161243283,ECE 221,A00,111493,Staff,0,0,0,0
1668161243706,ECE 222B,A00,103647,Lomakin; Vitaliy,0,0,0,0
1668161244128,ECE 230B,A00,103648,Taur; Yuan,0,0,0,0
1668161244554,ECE 238B,A00,103649,Garay; Javier,0,0,0,0
1668161244980,ECE 240B,A00,112900,Fainman; Yeshaiahu,0,0,0,0
1668161245406,ECE 247A,A00,103650,Jokerst; Jesse Vincent,0,0,0,0
1668161245830,ECE 247B,A00,103651,Wang; Joseph,0,0,0,0
1668161246255,ECE 250,A00,103652,Siegel; Paul H.,0,0,0,0
1668161246677,ECE 251A,A00,103654,Rao; Bhaskar D.,0,0,0,0
1668161247099,ECE 257B,A00,103655,Bharadia; Dinesh,0,0,0,0
1668161247523,ECE 258A,A00,103656,Milstein; Laurence B.,0,0,0,0
1668161247948,ECE 260B,A00,103658,Kang; Mingu,0,0,0,0
1668161248372,ECE 264A,A00,103659,Galton; Ian A,0,0,0,0
1668161248795,ECE 265A,A00,103661,Gudem; Prasad S.S.,0,0,0,0
1668161249218,ECE 265D,A00,103662,Gudem; Prasad S.S.,0,0,0,0
1668161249644,ECE 268,A00,103663,Koushanfar; Farinaz,0,0,0,0
1668161250067,ECE 269,A01,103665,Pal; Piya,0,0,0,0
1668161250490,ECE 271B,A00,103666,Vasconcelos; Manuela,0,0,0,0
1668161250911,ECE 276A,A00,103667,Atanasov; Nikolay A.,0,0,0,0
1668161251337,ECE 277,A00,103668,An; Cheolhong,0,0,0,0
1668161251760,ECE 279,A00,117947,Hall; Drew A.,0,0,0,0
1668161252608,ECE 283,A00,103670,Hsueh; Tzu-Chien,0,0,0,0
1668161253031,ECE 284,A00,103671,Turakhia; Yatish Girish,0,0,0,0
1668161253454,ECE 285,A00,103672,Zheng; Yang,0,0,0,0
1668161253454,ECE 285,B00,103673,Sworder; David D.,0,0,0,0
1668161253878,ECE 287,A00,103676,Javidi; Tara,0,0,0,0
1668161254304,MATH 200B,A00,098023,Salehi Golsefidy; Alireza,12,0,15,3
1668161254730,MATH 202B,A00,098024,Rhoades; Brendon Patrick,9,0,15,6
1668161255165,MATH 203B,A00,098025,Oprea; Dragos N.,10,0,15,5
1668161255589,MATH 204B,A00,098026,Sorensen; Claus M,13,0,15,2
1668161256012,MATH 208,A00,098027,Izadi; Elham,7,0,10,3
1668161256439,MATH 209,A00,098028,Pollack; Aaron,10,0,10,0
1668161256863,MATH 211A,A00,112919,Rogalski; Daniel,9,0,10,1
1668161257287,MATH 211B,A00,112920,Seward; Brandon M.,9,0,10,1
1668161257712,MATH 218,A00,098029,Li; Bo,10,0,10,0
1668161258139,MATH 220B,A00,098030,Novak; Jonathan I,11,0,15,4
1668161258568,MATH 221A,A00,098031,Ebenfelt; Peter F,13,0,15,2
1668161258994,MATH 231B,A00,098032,Zlatos; Andrej,12,0,15,3
1668161259419,MATH 240B,A00,098033,Ni; Lei,9,0,15,6
1668161259843,MATH 243,A00,098034,Jekel; David Andrew,10,0,10,0
1668161260266,MATH 245A,A00,098035,Nie; Jiawang,0,0,15,16
1668161260691,MATH 248,A00,098036,Bejenaru; Ioan,10,0,10,0
1668161261115,MATH 250B,A00,098037,Spolaor; Luca,14,0,15,1
1668161261540,MATH 258,A00,098038,Ni; Lei,10,0,10,0
1668161261964,MATH 264B,A00,098041,Rhoades; Brendon Patrick,9,0,15,6
1668161262489,MATH 268,A00,098042,Buss; Samuel R,10,0,10,0
1668161262913,MATH 269,A00,098043,Rhoades; Brendon Patrick,10,0,10,0
1668161263339,MATH 270B,A00,098044,Li; Bo,10,0,15,5
1668161263767,MATH 272B,A00,098045,Holst; Michael J,13,0,15,2
1668161264190,MATH 273A,A00,098046,Tian; Xiaochuan,10,0,15,5
1668161264614,MATH 275,A01,098048,Tian; Xiaochuan,6,0,10,4
1668161265039,MATH 278A,A00,098049,Holst; Michael J,8,0,10,2
1668161265466,MATH 278B,A00,098050,Cloninger; Alexander,10,0,10,0
1668161265889,MATH 278C,A00,098051,Nie; Jiawang,7,0,10,3
1668161266314,MATH 280B,A00,098052,Zheng; Tianyi,10,0,15,5
1668161266741,MATH 281B,A00,098053,Bradic; Jelena,2,0,15,13
1668161267166,MATH 282B,A00,098054,Arias-Castro; Ery,0,0,15,15
1668161267592,MATH 285,A00,098055,Fitzsimmons; Patrick J,0,0,15,17
1668161268015,MATH 287B,A00,098056,Arias-Castro; Ery,2,0,15,13
1668161268439,MATH 288,A00,098057,Agarwal; Pooja,9,0,10,1
1668161268439,MATH 288,B00,098058,Zhang; Danna,8,0,10,2
1668161268439,MATH 288,C00,098059,Williams; Ruth J,10,0,10,0
1668161268866,MATH 290B,A00,098060,Roberts; Justin Deritter,13,0,15,2
1668161269294,MATH 292,A00,098061,Belmont; Eva Kinoshita,10,0,10,0
1668161269717,MATH 295,A00,098062,Suk; Andrew Hoon,48,0,50,2
1668161270141,MATH 296,A00,098063,Novak; Jonathan I,20,0,20,0
1668161270568,MATH 297,001,098064,Gamst; Anthony Collins,9997,0,9999,2
1668161768936,COGS 205,A00,101395,Chiba; Andrea,19,0,20,1
1668161769359,COGS 210B,001,101404,Greene; Deanna Jacquelyn,9998,0,9999,1
1668161769359,COGS 210B,002,101417,Xia; Haijun,9999,0,9999,0
1668161769359,COGS 210B,003,101422,Nitz; Douglas A.,9999,0,9999,0
1668161769359,COGS 210B,004,101423,Hollan; James D.,9998,0,9999,1
1668161769359,COGS 210B,005,101424,Deak; Gedeon O.,9998,0,9999,1
1668161769359,COGS 210B,006,101425,Rossano; Federico,9999,0,9999,0
1668161769781,COGS 211B,A00,101427,Coulson; Seana M,9996,0,9999,3
1668161770207,COGS 220,A00,101428,Hollan; James D.,0,0,25,25
1668161770643,COGS 229,A00,101429,Dow; Steven P,18,0,25,7
1668161771076,COGS 230,A00,101430,Klemmer; Scott R,12,0,17,5
1668161771501,COGS 234,A00,101431,Xia; Haijun,3,0,25,22
1668161771930,COGS 260,A00,101432,Kiyonaga; Anastasia,20,0,25,5
1668161771930,COGS 260,B00,101433,Kirsh; David Joel,16,0,25,9
1668161772355,CSE 202,A00,102371,Impagliazzo; Russell,0,0,0,0
1668161772781,CSE 203B,A01,102373,Cheng; Chung Kuan,0,0,0,0
1668161773209,CSE 208,A00,102374,Micciancio; Daniele,0,0,0,0
1668161773630,CSE 209A,A00,112895,Impagliazzo; Russell,0,0,15,15
1668161774053,CSE 209B,A00,108005,Bellare; Mihir,0,0,0,0
1668161774479,CSE 210,A00,113163,Coblenz; Michael J,0,0,0,0
1668161774903,CSE 219,A00,106111,Dow; Steven P,0,0,20,20
1668161775325,CSE 221,A00,102376,Voelker; Geoffrey M.,0,0,0,0
1668161775750,CSE 224,A01,102378,Porter; George M,0,0,0,0
1668161776175,CSE 229A,A00,102379,Savage; Stefan,0,0,0,0
1668161776599,CSE 229C,A00,102380,Munyaka; Imani N. S.,0,0,0,0
1668161777022,CSE 232B,A00,102382,Deutsch; Alin Bernard,0,0,0,0
1668161777447,CSE 234,A01,112904,Kumar; Arun Kumar,0,0,0,0
1668161777873,CSE 237A,A00,102383,Rosing; Tajana Simunic,0,0,0,0
1668161778295,CSE 239A,A00,102384,Deutsch; Alin Bernard,0,0,0,0
1668161778721,CSE 239B,A00,102385,Polikarpova; Nadezhda,0,0,0,0
1668161779147,CSE 240A,A00,102386,Pannuto; Patrick William,0,0,0,0
1668161779573,CSE 240B,A00,102387,Zhao; Jishen,0,0,0,0
1668161779999,CSE 241A,A00,106406,Kang; Mingu,0,0,0,0
1668161780423,CSE 249B,A00,102388,Kahng; Andrew Byun,0,0,8,8
1668161780942,CSE 251B,A01,102392,Cottrell; Garrison W,0,0,0,0
1668161780942,CSE 251B,A02,102393,Cottrell; Garrison W,0,0,0,0
1668161781367,CSE 252B,A00,102394,Ochoa; Benjamin Lawrence,0,0,0,0
1668161781789,CSE 257,A01,102396,Gao; Sicun,0,0,0,0
1668161782215,CSE 272,A00,102397,Li; Tzumao,0,0,0,0
1668161782642,CSE 274,A00,111323,Chern; Albert Ren-Haur,0,0,0,0
1668161783065,CSE 282,A00,102398,Pevzner; Pavel Arkadjevich,0,0,0,0
1668161783490,CSE 284,A00,114175,Gymrek; Melissa Ann,0,0,0,0
1668161783922,CSE 290,A00,102399,Chandraker; Manmohan Krishna,0,0,0,0
1668161783922,CSE 290,B00,102400,Vaccaro; Kristen Marie,0,0,25,25
1668161783922,CSE 290,C00,102414,Pannuto; Patrick William,0,0,25,25
1668161783922,CSE 290,D00,102427,Pevzner; Pavel Arkadjevich,0,0,0,0
1668161783922,CSE 290,E00,102429,Zhao; Jishen,0,0,0,0
1668161783922,CSE 290,F00,102436,Tullsen; Dean Michael,0,0,0,0
1668161783922,CSE 290,G00,102440,Christensen; Henrik I,0,0,20,20
1668161784351,CSE 291,A00,102443,Su; Hao,0,0,0,0
1668161784351,CSE 291,B00,102448,Polikarpova; Nadezhda,0,0,0,0
1668161784351,CSE 291,C00,102453,Vaccaro; Kristen Marie,0,0,0,0
1668161784351,CSE 291,D00,111343,Savage; Stefan,0,0,0,0
1668161784351,CSE 291,E00,116474,Claffy; Kimberly Claire,0,0,0,0
1668161784351,CSE 291,F00,116479,Pasquale; Joseph,0,0,0,0
1668161784791,CSE 293,001,119111,Bafna; Vineet,9999,0,9999,0
1668161784791,CSE 293,002,119118,Bellare; Mihir,9999,0,9999,0
1668161784791,CSE 293,003,119122,Berg-Kirkpatrick; Taylor D,9999,0,9999,0
1668161784791,CSE 293,004,119135,Christensen; Henrik I,9999,0,9999,0
1668161784791,CSE 293,005,119142,Cottrell; Garrison W,9999,0,9999,0
1668161784791,CSE 293,006,119146,Deutsch; Alin Bernard,9999,0,9999,0
1668161784791,CSE 293,007,119159,Esmaeilzadeh; Hadi,9999,0,9999,0
1668161784791,CSE 293,008,119166,Freund; Yoav,9999,0,9999,0
1668161784791,CSE 293,009,119170,Griswold; William G.,9999,0,9999,0
1668161784791,CSE 293,010,119183,Gymrek; Melissa Ann,9999,0,9999,0
1668161784791,CSE 293,011,119190,Heninger; Nadia A,9999,0,9999,0
1668161784791,CSE 293,012,119230,Impagliazzo; Russell,9999,0,9999,0
1668161784791,CSE 293,013,119232,Jhala; Ranjit,9999,0,9999,0
1668161784791,CSE 293,014,119233,Kahng; Andrew Byun,9999,0,9999,0
1668161784791,CSE 293,015,119298,Kane; Daniel Mertz,9999,0,9999,0
1668161784791,CSE 293,016,119299,Kriegman; David J,9999,0,9999,0
1668161784791,CSE 293,017,119300,Kumar; Arun Kumar,9999,0,9999,0
1668161784791,CSE 293,018,119301,Lerner; Sorin,9999,0,9999,0
1668161784791,CSE 293,019,119302,Lovett; Shachar,9999,0,9999,0
1668161784791,CSE 293,020,119303,McAuley; Julian John,9999,0,9999,0
1668161784791,CSE 293,021,119304,Micciancio; Daniele,9999,0,9999,0
1668161784791,CSE 293,022,119367,Orailoglu; Alex,9999,0,9999,0
1668161784791,CSE 293,023,119382,Paturi; Ramamohan,9999,0,9999,0
1668161784791,CSE 293,024,119404,Polikarpova; Nadezhda,9999,0,9999,0
1668161784791,CSE 293,025,119406,Politz; Joseph Gibbs,9999,0,9999,0
1668161784791,CSE 293,026,119411,Porter; George M,9999,0,9999,0
1668161784791,CSE 293,027,119414,Porter; Leonard Emerson,9999,0,9999,0
1668161784791,CSE 293,028,119416,Ramamoorthi; Ravi,9999,0,9999,0
1668161784791,CSE 293,029,119417,Sahoo; Debashis,9999,0,9999,0
1668161784791,CSE 293,030,119420,Saul; Lawrence,9999,0,9999,0
1668161784791,CSE 293,031,119421,Savage; Stefan,9999,0,9999,0
1668161784791,CSE 293,032,119425,Schulze; Jurgen P.,9999,0,9999,0
1668161784791,CSE 293,033,119426,Snoeren; Alex C.,9999,0,9999,0
1668161784791,CSE 293,034,119428,Shang; Jingbo,9999,0,9999,0
1668161784791,CSE 293,035,119430,Stefan; Deian,9999,0,9999,0
1668161784791,CSE 293,036,119431,Su; Hao,9999,0,9999,0
1668161784791,CSE 293,037,119433,Swanson; Steven James,9999,0,9999,0
1668161784791,CSE 293,038,119435,Tullsen; Dean Michael,9999,0,9999,0
1668161784791,CSE 293,039,119483,Voelker; Geoffrey M.,9999,0,9999,0
1668161784791,CSE 293,040,119537,Zhao; Jishen,9999,0,9999,0
1668161784791,CSE 293,041,119538,Zhou; Yuan-Yuan,9999,0,9999,0
1668161784791,CSE 293,042,119539,Gao; Sicun,9999,0,9999,0
1668161784791,CSE 293,043,119540,Weibel; Nadir,9999,0,9999,0
1668161784791,CSE 293,044,119541,Gupta; Rajesh K.,9999,0,9999,0
1668161784791,CSE 293,045,126410,Vaccaro; Kristen Marie,9999,0,9999,0
1668161784791,CSE 293,046,126411,Klemke; Richard,9999,0,9999,0
1668161785215,CSE 294,A00,102459,Voelker; Geoffrey M.,0,0,0,0
1668161785215,CSE 294,B00,111322,Orailoglu; Alex,0,0,0,0
1668161785641,DSE 201,A00,096914,Deutsch; Alin Bernard,30,0,30,0
1668161786065,DSE 210,A00,096915,Dasgupta; Sanjoy,30,0,30,0
1668161786488,DSE 260A,A00,096916,Altintas De Callaf; Ilkay,30,0,30,0
1668161786920,ECE 200,001,103586,Antipa; Nicholas A,9999,0,9999,0
1668161786920,ECE 200,002,103587,Atanasov; Nikolay A.,9999,0,9999,0
1668161786920,ECE 200,003,103588,Bharadia; Dinesh,9999,0,9999,0
1668161786920,ECE 200,004,103589,Cheng; Chung Kuan,9999,0,9999,0
1668161786920,ECE 200,005,103590,Cosman; Pamela C.,9999,0,9999,0
1668161786920,ECE 200,006,103591,Dayeh; Shadi Ahmad,9999,0,9999,0
1668161786920,ECE 200,007,103592,Fainman; Yeshaiahu,9999,0,9999,0
1668161786920,ECE 200,008,103593,Ford; Joseph Earl,9999,0,9999,0
1668161786920,ECE 200,009,103594,Franceschetti; Massimo,9999,0,9999,0
1668161786920,ECE 200,010,103595,Fullerton; Eric E,9999,0,9999,0
1668161786920,ECE 200,011,103596,Galton; Ian A,9999,0,9999,0
1668161786920,ECE 200,012,103597,Gilja; Vikash,9999,0,9999,0
1668161786920,ECE 200,013,103598,Hall; Drew A.,9999,0,9999,0
1668161786920,ECE 200,014,103599,Hsueh; Tzu-Chien,9999,0,9999,0
1668161786920,ECE 200,015,103600,Javidi; Tara,9999,0,9999,0
1668161786920,ECE 200,016,103601,Kahng; Andrew Byun,9999,0,9999,0
1668161786920,ECE 200,017,103602,Kim; Young-Han,9999,0,9999,0
1668161786920,ECE 200,018,103603,Koushanfar; Farinaz,9999,0,9999,0
1668161786920,ECE 200,019,103604,Kuzum; Duygu,9999,0,9999,0
1668161786920,ECE 200,020,103605,Le; Hanh-Phuc,9999,0,9999,0
1668161786920,ECE 200,021,103606,Lin; Bill,9999,0,9999,0
1668161786920,ECE 200,022,103607,Liu; Zhaowei,9998,0,9999,1
1668161786920,ECE 200,023,103608,Lo; Yu-Hwa,9999,0,9999,0
1668161786920,ECE 200,024,103609,Lomakin; Vitaliy,9999,0,9999,0
1668161786920,ECE 200,025,103610,Mercier; Patrick Philip,9999,0,9999,0
1668161786920,ECE 200,026,103611,Meyer; Florian,9999,0,9999,0
1668161786920,ECE 200,027,103612,Milstein; Laurence B.,9999,0,9999,0
1668161786920,ECE 200,028,103613,Mir Arabbaygi; Siavash,9999,0,9999,0
1668161786920,ECE 200,029,103614,Mookherjea; Shayan,9999,0,9999,0
1668161786920,ECE 200,030,103615,Morris; Karcher William,9999,0,9999,0
1668161786920,ECE 200,031,103616,Ng; Tse Nga,9999,0,9999,0
1668161786920,ECE 200,032,103617,Nguyen; Truong Quang,9999,0,9999,0
1668161786920,ECE 200,033,103618,Nomura; Kenji,9999,0,9999,0
1668161786920,ECE 200,034,103619,Orlitsky; Alon,9999,0,9999,0
1668161786920,ECE 200,035,103620,Pal; Piya,9999,0,9999,0
1668161786920,ECE 200,036,103621,Papen; George C.,9999,0,9999,0
1668161786920,ECE 200,037,103622,Radic; Stojan,9999,0,9999,0
1668161786920,ECE 200,038,103623,Rao; Bhaskar D.,9999,0,9999,0
1668161786920,ECE 200,039,103624,Rao; Ramesh R,9999,0,9999,0
1668161786920,ECE 200,040,103625,Rebeiz; Gabriel,9999,0,9999,0
1668161786920,ECE 200,041,103626,Sanford; John R,9999,0,9999,0
1668161786920,ECE 200,042,103627,Siegel; Paul H.,9999,0,9999,0
1668161786920,ECE 200,043,103628,Sievenpiper; Daniel F.,9999,0,9999,0
1668161786920,ECE 200,044,103629,Sworder; David D.,9999,0,9999,0
1668161786920,ECE 200,045,103630,Taur; Yuan,9999,0,9999,0
1668161786920,ECE 200,046,103631,Touri; Behrouz,9999,0,9999,0
1668161786920,ECE 200,047,103632,Trivedi; Mohan M.,9999,0,9999,0
1668161786920,ECE 200,048,103633,Vasconcelos; Nuno,9999,0,9999,0
1668161786920,ECE 200,049,103634,Wang; Xiaolong,9999,0,9999,0
1668161786920,ECE 200,050,103635,Xie; Pengtao,9999,0,9999,0
1668161786920,ECE 200,051,103636,Yip; Michael,9999,0,9999,0
1668161786920,ECE 200,052,103637,Zeger; Kenneth A.,999,0,999,0
1668161786920,ECE 200,053,103638,Zhang; Xinyu,9999,0,9999,0
1668161786920,ECE 200,054,103639,Turakhia; Yatish Girish,9999,0,9999,0
1668161786920,ECE 200,055,103640,Kang; Mingu,9999,0,9999,0
1668161786920,ECE 200,056,103641,Shi; Yuanyuan,9999,0,9999,0
1668161786920,ECE 200,057,103642,Wang; Edward Jay,9999,0,9999,0
1668161786920,ECE 200,058,103643,Zheng; Yang,9999,0,9999,0
1668161787352,ECE 202,A00,103644,Kuzum; Duygu,0,0,0,0
1668161787780,ECE 212BN,A00,103646,Ng; Tse Nga,0,0,0,0
1668161788204,ECE 221,A00,111493,Staff,0,0,0,0
1668161788627,ECE 222B,A00,103647,Lomakin; Vitaliy,0,0,0,0
1668161789050,ECE 230B,A00,103648,Taur; Yuan,0,0,0,0
1668161789474,ECE 238B,A00,103649,Garay; Javier,0,0,0,0
1668161789896,ECE 240B,A00,112900,Fainman; Yeshaiahu,0,0,0,0
1668161790323,ECE 247A,A00,103650,Jokerst; Jesse Vincent,0,0,0,0
1668161790752,ECE 247B,A00,103651,Wang; Joseph,0,0,0,0
1668161791176,ECE 250,A00,103652,Siegel; Paul H.,0,0,0,0
1668161791599,ECE 251A,A00,103654,Rao; Bhaskar D.,0,0,0,0
1668161792022,ECE 257B,A00,103655,Bharadia; Dinesh,0,0,0,0
1668161792446,ECE 258A,A00,103656,Milstein; Laurence B.,0,0,0,0
1668161792868,ECE 260B,A00,103658,Kang; Mingu,0,0,0,0
1668161793294,ECE 264A,A00,103659,Galton; Ian A,0,0,0,0
1668161793720,ECE 265A,A00,103661,Gudem; Prasad S.S.,0,0,0,0
1668161794141,ECE 265D,A00,103662,Gudem; Prasad S.S.,0,0,0,0
1668161794567,ECE 268,A00,103663,Koushanfar; Farinaz,0,0,0,0
1668161794989,ECE 269,A01,103665,Pal; Piya,0,0,0,0
1668161795415,ECE 271B,A00,103666,Vasconcelos; Manuela,0,0,0,0
1668161795841,ECE 276A,A00,103667,Atanasov; Nikolay A.,0,0,0,0
1668161796271,ECE 277,A00,103668,An; Cheolhong,0,0,0,0
1668161796699,ECE 279,A00,117947,Hall; Drew A.,0,0,0,0
1668161797546,ECE 283,A00,103670,Hsueh; Tzu-Chien,0,0,0,0
1668161797974,ECE 284,A00,103671,Turakhia; Yatish Girish,0,0,0,0
1668161798405,ECE 285,A00,103672,Zheng; Yang,0,0,0,0
1668161798405,ECE 285,B00,103673,Sworder; David D.,0,0,0,0
1668161798831,ECE 287,A00,103676,Javidi; Tara,0,0,0,0
1668161799254,MATH 200B,A00,098023,Salehi Golsefidy; Alireza,12,0,15,3
1668161799678,MATH 202B,A00,098024,Rhoades; Brendon Patrick,9,0,15,6
1668161800104,MATH 203B,A00,098025,Oprea; Dragos N.,10,0,15,5
1668161800528,MATH 204B,A00,098026,Sorensen; Claus M,13,0,15,2
1668161800952,MATH 208,A00,098027,Izadi; Elham,7,0,10,3
1668161801379,MATH 209,A00,098028,Pollack; Aaron,10,0,10,0
1668161801805,MATH 211A,A00,112919,Rogalski; Daniel,9,0,10,1
1668161802228,MATH 211B,A00,112920,Seward; Brandon M.,9,0,10,1
1668161802653,MATH 218,A00,098029,Li; Bo,10,0,10,0
1668161803092,MATH 220B,A00,098030,Novak; Jonathan I,11,0,15,4
1668161803521,MATH 221A,A00,098031,Ebenfelt; Peter F,13,0,15,2
1668161803947,MATH 231B,A00,098032,Zlatos; Andrej,12,0,15,3
1668161804373,MATH 240B,A00,098033,Ni; Lei,9,0,15,6
1668161804797,MATH 243,A00,098034,Jekel; David Andrew,10,0,10,0
1668161805225,MATH 245A,A00,098035,Nie; Jiawang,0,0,15,16
1668161805653,MATH 248,A00,098036,Bejenaru; Ioan,10,0,10,0
1668161806076,MATH 250B,A00,098037,Spolaor; Luca,14,0,15,1
1668161806502,MATH 258,A00,098038,Ni; Lei,10,0,10,0
1668161806929,MATH 264B,A00,098041,Rhoades; Brendon Patrick,9,0,15,6
1668161807351,MATH 268,A00,098042,Buss; Samuel R,10,0,10,0
1668161807775,MATH 269,A00,098043,Rhoades; Brendon Patrick,10,0,10,0
1668161808197,MATH 270B,A00,098044,Li; Bo,10,0,15,5
1668161808621,MATH 272B,A00,098045,Holst; Michael J,13,0,15,2
1668161809048,MATH 273A,A00,098046,Tian; Xiaochuan,10,0,15,5
1668161809474,MATH 275,A01,098048,Tian; Xiaochuan,6,0,10,4
1668161809901,MATH 278A,A00,098049,Holst; Michael J,8,0,10,2
1668161810328,MATH 278B,A00,098050,Cloninger; Alexander,10,0,10,0
1668161810752,MATH 278C,A00,098051,Nie; Jiawang,7,0,10,3
1668161811179,MATH 280B,A00,098052,Zheng; Tianyi,10,0,15,5
1668161811603,MATH 281B,A00,098053,Bradic; Jelena,2,0,15,13
1668161812030,MATH 282B,A00,098054,Arias-Castro; Ery,0,0,15,15
1668161812453,MATH 285,A00,098055,Fitzsimmons; Patrick J,0,0,15,17
1668161812880,MATH 287B,A00,098056,Arias-Castro; Ery,2,0,15,13
1668161813305,MATH 288,A00,098057,Agarwal; Pooja,9,0,10,1
1668161813305,MATH 288,B00,098058,Zhang; Danna,8,0,10,2
1668161813305,MATH 288,C00,098059,Williams; Ruth J,10,0,10,0
1668161813732,MATH 290B,A00,098060,Roberts; Justin Deritter,13,0,15,2
1668161814155,MATH 292,A00,098061,Belmont; Eva Kinoshita,10,0,10,0
1668161814579,MATH 295,A00,098062,Suk; Andrew Hoon,48,0,50,2
1668161815002,MATH 296,A00,098063,Novak; Jonathan I,20,0,20,0
1668161815424,MATH 297,001,098064,Gamst; Anthony Collins,9997,0,9999,2
1668162313719,COGS 205,A00,101395,Chiba; Andrea,19,0,20,1
1668162314147,COGS 210B,001,101404,Greene; Deanna Jacquelyn,9998,0,9999,1
1668162314147,COGS 210B,002,101417,Xia; Haijun,9999,0,9999,0
1668162314147,COGS 210B,003,101422,Nitz; Douglas A.,9999,0,9999,0
1668162314147,COGS 210B,004,101423,Hollan; James D.,9998,0,9999,1
1668162314147,COGS 210B,005,101424,Deak; Gedeon O.,9998,0,9999,1
1668162314147,COGS 210B,006,101425,Rossano; Federico,9999,0,9999,0
1668162314572,COGS 211B,A00,101427,Coulson; Seana M,9996,0,9999,3
1668162314997,COGS 220,A00,101428,Hollan; James D.,0,0,25,25
1668162315423,COGS 229,A00,101429,Dow; Steven P,18,0,25,7
1668162315845,COGS 230,A00,101430,Klemmer; Scott R,12,0,17,5
1668162316269,COGS 234,A00,101431,Xia; Haijun,3,0,25,22
1668162316696,COGS 260,A00,101432,Kiyonaga; Anastasia,20,0,25,5
1668162316696,COGS 260,B00,101433,Kirsh; David Joel,16,0,25,9
1668162317123,CSE 202,A00,102371,Impagliazzo; Russell,0,0,0,0
1668162317546,CSE 203B,A01,102373,Cheng; Chung Kuan,0,0,0,0
1668162317970,CSE 208,A00,102374,Micciancio; Daniele,0,0,0,0
1668162318393,CSE 209A,A00,112895,Impagliazzo; Russell,0,0,15,15
1668162318818,CSE 209B,A00,108005,Bellare; Mihir,0,0,0,0
1668162319243,CSE 210,A00,113163,Coblenz; Michael J,0,0,0,0
1668162319668,CSE 219,A00,106111,Dow; Steven P,0,0,20,20
1668162320091,CSE 221,A00,102376,Voelker; Geoffrey M.,0,0,0,0
1668162320516,CSE 224,A01,102378,Porter; George M,0,0,0,0
1668162320939,CSE 229A,A00,102379,Savage; Stefan,0,0,0,0
1668162321366,CSE 229C,A00,102380,Munyaka; Imani N. S.,0,0,0,0
1668162321791,CSE 232B,A00,102382,Deutsch; Alin Bernard,0,0,0,0
1668162322214,CSE 234,A01,112904,Kumar; Arun Kumar,0,0,0,0
1668162322637,CSE 237A,A00,102383,Rosing; Tajana Simunic,0,0,0,0
1668162323061,CSE 239A,A00,102384,Deutsch; Alin Bernard,0,0,0,0
1668162323486,CSE 239B,A00,102385,Polikarpova; Nadezhda,0,0,0,0
1668162323909,CSE 240A,A00,102386,Pannuto; Patrick William,0,0,0,0
1668162324333,CSE 240B,A00,102387,Zhao; Jishen,0,0,0,0
1668162324759,CSE 241A,A00,106406,Kang; Mingu,0,0,0,0
1668162325182,CSE 249B,A00,102388,Kahng; Andrew Byun,0,0,8,8
1668162325610,CSE 251B,A01,102392,Cottrell; Garrison W,0,0,0,0
1668162325610,CSE 251B,A02,102393,Cottrell; Garrison W,0,0,0,0
1668162326035,CSE 252B,A00,102394,Ochoa; Benjamin Lawrence,0,0,0,0
1668162326459,CSE 257,A01,102396,Gao; Sicun,0,0,0,0
1668162326886,CSE 272,A00,102397,Li; Tzumao,0,0,0,0
1668162327311,CSE 274,A00,111323,Chern; Albert Ren-Haur,0,0,0,0
1668162327737,CSE 282,A00,102398,Pevzner; Pavel Arkadjevich,0,0,0,0
1668162328160,CSE 284,A00,114175,Gymrek; Melissa Ann,0,0,0,0
1668162328587,CSE 290,A00,102399,Chandraker; Manmohan Krishna,0,0,0,0
1668162328587,CSE 290,B00,102400,Vaccaro; Kristen Marie,0,0,25,25
1668162328587,CSE 290,C00,102414,Pannuto; Patrick William,0,0,25,25
1668162328587,CSE 290,D00,102427,Pevzner; Pavel Arkadjevich,0,0,0,0
1668162328587,CSE 290,E00,102429,Zhao; Jishen,0,0,0,0
1668162328587,CSE 290,F00,102436,Tullsen; Dean Michael,0,0,0,0
1668162328587,CSE 290,G00,102440,Christensen; Henrik I,0,0,20,20
1668162329015,CSE 291,A00,102443,Su; Hao,0,0,0,0
1668162329015,CSE 291,B00,102448,Polikarpova; Nadezhda,0,0,0,0
1668162329015,CSE 291,C00,102453,Vaccaro; Kristen Marie,0,0,0,0
1668162329015,CSE 291,D00,111343,Savage; Stefan,0,0,0,0
1668162329015,CSE 291,E00,116474,Claffy; Kimberly Claire,0,0,0,0
1668162329015,CSE 291,F00,116479,Pasquale; Joseph,0,0,0,0
1668162329443,CSE 293,001,119111,Bafna; Vineet,9999,0,9999,0
1668162329443,CSE 293,002,119118,Bellare; Mihir,9999,0,9999,0
1668162329443,CSE 293,003,119122,Berg-Kirkpatrick; Taylor D,9999,0,9999,0
1668162329443,CSE 293,004,119135,Christensen; Henrik I,9999,0,9999,0
1668162329443,CSE 293,005,119142,Cottrell; Garrison W,9999,0,9999,0
1668162329443,CSE 293,006,119146,Deutsch; Alin Bernard,9999,0,9999,0
1668162329443,CSE 293,007,119159,Esmaeilzadeh; Hadi,9999,0,9999,0
1668162329443,CSE 293,008,119166,Freund; Yoav,9999,0,9999,0
1668162329443,CSE 293,009,119170,Griswold; William G.,9999,0,9999,0
1668162329443,CSE 293,010,119183,Gymrek; Melissa Ann,9999,0,9999,0
1668162329443,CSE 293,011,119190,Heninger; Nadia A,9999,0,9999,0
1668162329443,CSE 293,012,119230,Impagliazzo; Russell,9999,0,9999,0
1668162329443,CSE 293,013,119232,Jhala; Ranjit,9999,0,9999,0
1668162329443,CSE 293,014,119233,Kahng; Andrew Byun,9999,0,9999,0
1668162329443,CSE 293,015,119298,Kane; Daniel Mertz,9999,0,9999,0
1668162329443,CSE 293,016,119299,Kriegman; David J,9999,0,9999,0
1668162329443,CSE 293,017,119300,Kumar; Arun Kumar,9999,0,9999,0
1668162329443,CSE 293,018,119301,Lerner; Sorin,9999,0,9999,0
1668162329443,CSE 293,019,119302,Lovett; Shachar,9999,0,9999,0
1668162329443,CSE 293,020,119303,McAuley; Julian John,9999,0,9999,0
1668162329443,CSE 293,021,119304,Micciancio; Daniele,9999,0,9999,0
1668162329443,CSE 293,022,119367,Orailoglu; Alex,9999,0,9999,0
1668162329443,CSE 293,023,119382,Paturi; Ramamohan,9999,0,9999,0
1668162329443,CSE 293,024,119404,Polikarpova; Nadezhda,9999,0,9999,0
1668162329443,CSE 293,025,119406,Politz; Joseph Gibbs,9999,0,9999,0
1668162329443,CSE 293,026,119411,Porter; George M,9999,0,9999,0
1668162329443,CSE 293,027,119414,Porter; Leonard Emerson,9999,0,9999,0
1668162329443,CSE 293,028,119416,Ramamoorthi; Ravi,9999,0,9999,0
1668162329443,CSE 293,029,119417,Sahoo; Debashis,9999,0,9999,0
1668162329443,CSE 293,030,119420,Saul; Lawrence,9999,0,9999,0
1668162329443,CSE 293,031,119421,Savage; Stefan,9999,0,9999,0
1668162329443,CSE 293,032,119425,Schulze; Jurgen P.,9999,0,9999,0
1668162329443,CSE 293,033,119426,Snoeren; Alex C.,9999,0,9999,0
1668162329443,CSE 293,034,119428,Shang; Jingbo,9999,0,9999,0
1668162329443,CSE 293,035,119430,Stefan; Deian,9999,0,9999,0
1668162329443,CSE 293,036,119431,Su; Hao,9999,0,9999,0
1668162329443,CSE 293,037,119433,Swanson; Steven James,9999,0,9999,0
1668162329443,CSE 293,038,119435,Tullsen; Dean Michael,9999,0,9999,0
1668162329443,CSE 293,039,119483,Voelker; Geoffrey M.,9999,0,9999,0
1668162329443,CSE 293,040,119537,Zhao; Jishen,9999,0,9999,0
1668162329443,CSE 293,041,119538,Zhou; Yuan-Yuan,9999,0,9999,0
1668162329443,CSE 293,042,119539,Gao; Sicun,9999,0,9999,0
1668162329443,CSE 293,043,119540,Weibel; Nadir,9999,0,9999,0
1668162329443,CSE 293,044,119541,Gupta; Rajesh K.,9999,0,9999,0
1668162329443,CSE 293,045,126410,Vaccaro; Kristen Marie,9999,0,9999,0
1668162329443,CSE 293,046,126411,Klemke; Richard,9999,0,9999,0
1668162329867,CSE 294,A00,102459,Voelker; Geoffrey M.,0,0,0,0
1668162329867,CSE 294,B00,111322,Orailoglu; Alex,0,0,0,0
1668162330289,DSE 201,A00,096914,Deutsch; Alin Bernard,30,0,30,0
1668162330711,DSE 210,A00,096915,Dasgupta; Sanjoy,30,0,30,0
1668162331135,DSE 260A,A00,096916,Altintas De Callaf; Ilkay,30,0,30,0
1668162331567,ECE 200,001,103586,Antipa; Nicholas A,9999,0,9999,0
1668162331567,ECE 200,002,103587,Atanasov; Nikolay A.,9999,0,9999,0
1668162331567,ECE 200,003,103588,Bharadia; Dinesh,9999,0,9999,0
1668162331567,ECE 200,004,103589,Cheng; Chung Kuan,9999,0,9999,0
1668162331567,ECE 200,005,103590,Cosman; Pamela C.,9999,0,9999,0
1668162331567,ECE 200,006,103591,Dayeh; Shadi Ahmad,9999,0,9999,0
1668162331567,ECE 200,007,103592,Fainman; Yeshaiahu,9999,0,9999,0
1668162331567,ECE 200,008,103593,Ford; Joseph Earl,9999,0,9999,0
1668162331567,ECE 200,009,103594,Franceschetti; Massimo,9999,0,9999,0
1668162331567,ECE 200,010,103595,Fullerton; Eric E,9999,0,9999,0
1668162331567,ECE 200,011,103596,Galton; Ian A,9999,0,9999,0
1668162331567,ECE 200,012,103597,Gilja; Vikash,9999,0,9999,0
1668162331567,ECE 200,013,103598,Hall; Drew A.,9999,0,9999,0
1668162331567,ECE 200,014,103599,Hsueh; Tzu-Chien,9999,0,9999,0
1668162331567,ECE 200,015,103600,Javidi; Tara,9999,0,9999,0
1668162331567,ECE 200,016,103601,Kahng; Andrew Byun,9999,0,9999,0
1668162331567,ECE 200,017,103602,Kim; Young-Han,9999,0,9999,0
1668162331567,ECE 200,018,103603,Koushanfar; Farinaz,9999,0,9999,0
1668162331567,ECE 200,019,103604,Kuzum; Duygu,9999,0,9999,0
1668162331567,ECE 200,020,103605,Le; Hanh-Phuc,9999,0,9999,0
1668162331567,ECE 200,021,103606,Lin; Bill,9999,0,9999,0
1668162331567,ECE 200,022,103607,Liu; Zhaowei,9998,0,9999,1
1668162331567,ECE 200,023,103608,Lo; Yu-Hwa,9999,0,9999,0
1668162331567,ECE 200,024,103609,Lomakin; Vitaliy,9999,0,9999,0
1668162331567,ECE 200,025,103610,Mercier; Patrick Philip,9999,0,9999,0
1668162331567,ECE 200,026,103611,Meyer; Florian,9999,0,9999,0
1668162331567,ECE 200,027,103612,Milstein; Laurence B.,9999,0,9999,0
1668162331567,ECE 200,028,103613,Mir Arabbaygi; Siavash,9999,0,9999,0
1668162331567,ECE 200,029,103614,Mookherjea; Shayan,9999,0,9999,0
1668162331567,ECE 200,030,103615,Morris; Karcher William,9999,0,9999,0
1668162331567,ECE 200,031,103616,Ng; Tse Nga,9999,0,9999,0
1668162331567,ECE 200,032,103617,Nguyen; Truong Quang,9999,0,9999,0
1668162331567,ECE 200,033,103618,Nomura; Kenji,9999,0,9999,0
1668162331567,ECE 200,034,103619,Orlitsky; Alon,9999,0,9999,0
1668162331567,ECE 200,035,103620,Pal; Piya,9999,0,9999,0
1668162331567,ECE 200,036,103621,Papen; George C.,9999,0,9999,0
1668162331567,ECE 200,037,103622,Radic; Stojan,9999,0,9999,0
1668162331567,ECE 200,038,103623,Rao; Bhaskar D.,9999,0,9999,0
1668162331567,ECE 200,039,103624,Rao; Ramesh R,9999,0,9999,0
1668162331567,ECE 200,040,103625,Rebeiz; Gabriel,9999,0,9999,0
1668162331567,ECE 200,041,103626,Sanford; John R,9999,0,9999,0
1668162331567,ECE 200,042,103627,Siegel; Paul H.,9999,0,9999,0
1668162331567,ECE 200,043,103628,Sievenpiper; Daniel F.,9999,0,9999,0
1668162331567,ECE 200,044,103629,Sworder; David D.,9999,0,9999,0
1668162331567,ECE 200,045,103630,Taur; Yuan,9999,0,9999,0
1668162331567,ECE 200,046,103631,Touri; Behrouz,9999,0,9999,0
1668162331567,ECE 200,047,103632,Trivedi; Mohan M.,9999,0,9999,0
1668162331567,ECE 200,048,103633,Vasconcelos; Nuno,9999,0,9999,0
1668162331567,ECE 200,049,103634,Wang; Xiaolong,9999,0,9999,0
1668162331567,ECE 200,050,103635,Xie; Pengtao,9999,0,9999,0
1668162331567,ECE 200,051,103636,Yip; Michael,9999,0,9999,0
1668162331567,ECE 200,052,103637,Zeger; Kenneth A.,999,0,999,0
1668162331567,ECE 200,053,103638,Zhang; Xinyu,9999,0,9999,0
1668162331567,ECE 200,054,103639,Turakhia; Yatish Girish,9999,0,9999,0
1668162331567,ECE 200,055,103640,Kang; Mingu,9999,0,9999,0
1668162331567,ECE 200,056,103641,Shi; Yuanyuan,9999,0,9999,0
1668162331567,ECE 200,057,103642,Wang; Edward Jay,9999,0,9999,0
1668162331567,ECE 200,058,103643,Zheng; Yang,9999,0,9999,0
1668162332001,ECE 202,A00,103644,Kuzum; Duygu,0,0,0,0
1668162332427,ECE 212BN,A00,103646,Ng; Tse Nga,0,0,0,0
1668162332852,ECE 221,A00,111493,Staff,0,0,0,0
1668162333279,ECE 222B,A00,103647,Lomakin; Vitaliy,0,0,0,0
1668162333701,ECE 230B,A00,103648,Taur; Yuan,0,0,0,0
1668162334127,ECE 238B,A00,103649,Garay; Javier,0,0,0,0
1668162334551,ECE 240B,A00,112900,Fainman; Yeshaiahu,0,0,0,0
1668162334975,ECE 247A,A00,103650,Jokerst; Jesse Vincent,0,0,0,0
1668162335404,ECE 247B,A00,103651,Wang; Joseph,0,0,0,0
1668162335830,ECE 250,A00,103652,Siegel; Paul H.,0,0,0,0
1668162336254,ECE 251A,A00,103654,Rao; Bhaskar D.,0,0,0,0
1668162336679,ECE 257B,A00,103655,Bharadia; Dinesh,0,0,0,0
1668162337105,ECE 258A,A00,103656,Milstein; Laurence B.,0,0,0,0
1668162337529,ECE 260B,A00,103658,Kang; Mingu,0,0,0,0
1668162337962,ECE 264A,A00,103659,Galton; Ian A,0,0,0,0
1668162338383,ECE 265A,A00,103661,Gudem; Prasad S.S.,0,0,0,0
1668162338805,ECE 265D,A00,103662,Gudem; Prasad S.S.,0,0,0,0
1668162339229,ECE 268,A00,103663,Koushanfar; Farinaz,0,0,0,0
1668162339654,ECE 269,A01,103665,Pal; Piya,0,0,0,0
1668162340078,ECE 271B,A00,103666,Vasconcelos; Manuela,0,0,0,0
1668162340499,ECE 276A,A00,103667,Atanasov; Nikolay A.,0,0,0,0
1668162340925,ECE 277,A00,103668,An; Cheolhong,0,0,0,0
1668162341347,ECE 279,A00,117947,Hall; Drew A.,0,0,0,0
1668162342271,ECE 283,A00,103670,Hsueh; Tzu-Chien,0,0,0,0
1668162342695,ECE 284,A00,103671,Turakhia; Yatish Girish,0,0,0,0
1668162343118,ECE 285,A00,103672,Zheng; Yang,0,0,0,0
1668162343118,ECE 285,B00,103673,Sworder; David D.,0,0,0,0
1668162343541,ECE 287,A00,103676,Javidi; Tara,0,0,0,0
1668162343964,MATH 200B,A00,098023,Salehi Golsefidy; Alireza,12,0,15,3
1668162344387,MATH 202B,A00,098024,Rhoades; Brendon Patrick,9,0,15,6
1668162344809,MATH 203B,A00,098025,Oprea; Dragos N.,10,0,15,5
1668162345237,MATH 204B,A00,098026,Sorensen; Claus M,13,0,15,2
1668162345660,MATH 208,A00,098027,Izadi; Elham,7,0,10,3
1668162346081,MATH 209,A00,098028,Pollack; Aaron,10,0,10,0
1668162346508,MATH 211A,A00,112919,Rogalski; Daniel,9,0,10,1
1668162346932,MATH 211B,A00,112920,Seward; Brandon M.,9,0,10,1
1668162347357,MATH 218,A00,098029,Li; Bo,10,0,10,0
1668162347784,MATH 220B,A00,098030,Novak; Jonathan I,11,0,15,4
1668162348211,MATH 221A,A00,098031,Ebenfelt; Peter F,13,0,15,2
1668162348635,MATH 231B,A00,098032,Zlatos; Andrej,12,0,15,3
1668162349058,MATH 240B,A00,098033,Ni; Lei,9,0,15,6
1668162349484,MATH 243,A00,098034,Jekel; David Andrew,10,0,10,0
1668162349909,MATH 245A,A00,098035,Nie; Jiawang,0,0,15,16
1668162350335,MATH 248,A00,098036,Bejenaru; Ioan,10,0,10,0
1668162350760,MATH 250B,A00,098037,Spolaor; Luca,14,0,15,1
1668162351185,MATH 258,A00,098038,Ni; Lei,10,0,10,0
1668162351607,MATH 264B,A00,098041,Rhoades; Brendon Patrick,9,0,15,6
1668162352030,MATH 268,A00,098042,Buss; Samuel R,10,0,10,0
1668162352455,MATH 269,A00,098043,Rhoades; Brendon Patrick,10,0,10,0
1668162352879,MATH 270B,A00,098044,Li; Bo,10,0,15,5
1668162353303,MATH 272B,A00,098045,Holst; Michael J,13,0,15,2
1668162353726,MATH 273A,A00,098046,Tian; Xiaochuan,10,0,15,5
1668162354154,MATH 275,A01,098048,Tian; Xiaochuan,6,0,10,4
1668162354577,MATH 278A,A00,098049,Holst; Michael J,8,0,10,2
1668162355001,MATH 278B,A00,098050,Cloninger; Alexander,10,0,10,0
1668162355425,MATH 278C,A00,098051,Nie; Jiawang,7,0,10,3
1668162355852,MATH 280B,A00,098052,Zheng; Tianyi,10,0,15,5
1668162356275,MATH 281B,A00,098053,Bradic; Jelena,2,0,15,13
1668162356721,MATH 282B,A00,098054,Arias-Castro; Ery,0,0,15,15
1668162357166,MATH 285,A00,098055,Fitzsimmons; Patrick J,0,0,15,17
1668162357591,MATH 287B,A00,098056,Arias-Castro; Ery,2,0,15,13
1668162358017,MATH 288,A00,098057,Agarwal; Pooja,9,0,10,1
1668162358017,MATH 288,B00,098058,Zhang; Danna,8,0,10,2
1668162358017,MATH 288,C00,098059,Williams; Ruth J,10,0,10,0
1668162358443,MATH 290B,A00,098060,Roberts; Justin Deritter,13,0,15,2
1668162358866,MATH 292,A00,098061,Belmont; Eva Kinoshita,10,0,10,0
1668162359291,MATH 295,A00,098062,Suk; Andrew Hoon,48,0,50,2
1668162359714,MATH 296,A00,098063,Novak; Jonathan I,20,0,20,0
1668162360139,MATH 297,001,098064,Gamst; Anthony Collins,9997,0,9999,2
1668162858147,COGS 205,A00,101395,Chiba; Andrea,19,0,20,1
1668162858571,COGS 210B,001,101404,Greene; Deanna Jacquelyn,9998,0,9999,1
1668162858571,COGS 210B,002,101417,Xia; Haijun,9999,0,9999,0
1668162858571,COGS 210B,003,101422,Nitz; Douglas A.,9999,0,9999,0
1668162858571,COGS 210B,004,101423,Hollan; James D.,9998,0,9999,1
1668162858571,COGS 210B,005,101424,Deak; Gedeon O.,9998,0,9999,1
1668162858571,COGS 210B,006,101425,Rossano; Federico,9999,0,9999,0
1668162859001,COGS 211B,A00,101427,Coulson; Seana M,9996,0,9999,3
1668162859426,COGS 220,A00,101428,Hollan; James D.,0,0,25,25
1668162859849,COGS 229,A00,101429,Dow; Steven P,18,0,25,7
1668162860351,COGS 230,A00,101430,Klemmer; Scott R,12,0,17,5
1668162860775,COGS 234,A00,101431,Xia; Haijun,3,0,25,22
1668162861198,COGS 260,A00,101432,Kiyonaga; Anastasia,20,0,25,5
1668162861198,COGS 260,B00,101433,Kirsh; David Joel,16,0,25,9
1668162861624,CSE 202,A00,102371,Impagliazzo; Russell,0,0,0,0
1668162862046,CSE 203B,A01,102373,Cheng; Chung Kuan,0,0,0,0
1668162862469,CSE 208,A00,102374,Micciancio; Daniele,0,0,0,0
1668162862893,CSE 209A,A00,112895,Impagliazzo; Russell,0,0,15,15
1668162863325,CSE 209B,A00,108005,Bellare; Mihir,0,0,0,0
1668162863749,CSE 210,A00,113163,Coblenz; Michael J,0,0,0,0
1668162864171,CSE 219,A00,106111,Dow; Steven P,0,0,20,20
1668162864597,CSE 221,A00,102376,Voelker; Geoffrey M.,0,0,0,0
1668162865020,CSE 224,A01,102378,Porter; George M,0,0,0,0
1668162865447,CSE 229A,A00,102379,Savage; Stefan,0,0,0,0
1668162865874,CSE 229C,A00,102380,Munyaka; Imani N. S.,0,0,0,0
1668162866297,CSE 232B,A00,102382,Deutsch; Alin Bernard,0,0,0,0
1668162866718,CSE 234,A01,112904,Kumar; Arun Kumar,0,0,0,0
1668162867145,CSE 237A,A00,102383,Rosing; Tajana Simunic,0,0,0,0
1668162867569,CSE 239A,A00,102384,Deutsch; Alin Bernard,0,0,0,0
1668162867996,CSE 239B,A00,102385,Polikarpova; Nadezhda,0,0,0,0
1668162868421,CSE 240A,A00,102386,Pannuto; Patrick William,0,0,0,0
1668162868844,CSE 240B,A00,102387,Zhao; Jishen,0,0,0,0
1668162869271,CSE 241A,A00,106406,Kang; Mingu,0,0,0,0
1668162869693,CSE 249B,A00,102388,Kahng; Andrew Byun,0,0,8,8
1668162870119,CSE 251B,A01,102392,Cottrell; Garrison W,0,0,0,0
1668162870119,CSE 251B,A02,102393,Cottrell; Garrison W,0,0,0,0
1668162870544,CSE 252B,A00,102394,Ochoa; Benjamin Lawrence,0,0,0,0
1668162870969,CSE 257,A01,102396,Gao; Sicun,0,0,0,0
1668162871392,CSE 272,A00,102397,Li; Tzumao,0,0,0,0
1668162871819,CSE 274,A00,111323,Chern; Albert Ren-Haur,0,0,0,0
1668162872244,CSE 282,A00,102398,Pevzner; Pavel Arkadjevich,0,0,0,0
1668162872666,CSE 284,A00,114175,Gymrek; Melissa Ann,0,0,0,0
1668162873091,CSE 290,A00,102399,Chandraker; Manmohan Krishna,0,0,0,0
1668162873091,CSE 290,B00,102400,Vaccaro; Kristen Marie,0,0,25,25
1668162873091,CSE 290,C00,102414,Pannuto; Patrick William,0,0,25,25
1668162873091,CSE 290,D00,102427,Pevzner; Pavel Arkadjevich,0,0,0,0
1668162873091,CSE 290,E00,102429,Zhao; Jishen,0,0,0,0
1668162873091,CSE 290,F00,102436,Tullsen; Dean Michael,0,0,0,0
1668162873091,CSE 290,G00,102440,Christensen; Henrik I,0,0,20,20
1668162873516,CSE 291,A00,102443,Su; Hao,0,0,0,0
1668162873516,CSE 291,B00,102448,Polikarpova; Nadezhda,0,0,0,0
1668162873516,CSE 291,C00,102453,Vaccaro; Kristen Marie,0,0,0,0
1668162873516,CSE 291,D00,111343,Savage; Stefan,0,0,0,0
1668162873516,CSE 291,E00,116474,Claffy; Kimberly Claire,0,0,0,0
1668162873516,CSE 291,F00,116479,Pasquale; Joseph,0,0,0,0
1668162873948,CSE 293,001,119111,Bafna; Vineet,9999,0,9999,0
1668162873948,CSE 293,002,119118,Bellare; Mihir,9999,0,9999,0
1668162873948,CSE 293,003,119122,Berg-Kirkpatrick; Taylor D,9999,0,9999,0
1668162873948,CSE 293,004,119135,Christensen; Henrik I,9999,0,9999,0
1668162873948,CSE 293,005,119142,Cottrell; Garrison W,9999,0,9999,0
1668162873948,CSE 293,006,119146,Deutsch; Alin Bernard,9999,0,9999,0
1668162873948,CSE 293,007,119159,Esmaeilzadeh; Hadi,9999,0,9999,0
1668162873948,CSE 293,008,119166,Freund; Yoav,9999,0,9999,0
1668162873948,CSE 293,009,119170,Griswold; William G.,9999,0,9999,0
1668162873948,CSE 293,010,119183,Gymrek; Melissa Ann,9999,0,9999,0
1668162873948,CSE 293,011,119190,Heninger; Nadia A,9999,0,9999,0
1668162873948,CSE 293,012,119230,Impagliazzo; Russell,9999,0,9999,0
1668162873948,CSE 293,013,119232,Jhala; Ranjit,9999,0,9999,0
1668162873948,CSE 293,014,119233,Kahng; Andrew Byun,9999,0,9999,0
1668162873948,CSE 293,015,119298,Kane; Daniel Mertz,9999,0,9999,0
1668162873948,CSE 293,016,119299,Kriegman; David J,9999,0,9999,0
1668162873948,CSE 293,017,119300,Kumar; Arun Kumar,9999,0,9999,0
1668162873948,CSE 293,018,119301,Lerner; Sorin,9999,0,9999,0
1668162873948,CSE 293,019,119302,Lovett; Shachar,9999,0,9999,0
1668162873948,CSE 293,020,119303,McAuley; Julian John,9999,0,9999,0
1668162873948,CSE 293,021,119304,Micciancio; Daniele,9999,0,9999,0
1668162873948,CSE 293,022,119367,Orailoglu; Alex,9999,0,9999,0
1668162873948,CSE 293,023,119382,Paturi; Ramamohan,9999,0,9999,0
1668162873948,CSE 293,024,119404,Polikarpova; Nadezhda,9999,0,9999,0
1668162873948,CSE 293,025,119406,Politz; Joseph Gibbs,9999,0,9999,0
1668162873948,CSE 293,026,119411,Porter; George M,9999,0,9999,0
1668162873948,CSE 293,027,119414,Porter; Leonard Emerson,9999,0,9999,0
1668162873948,CSE 293,028,119416,Ramamoorthi; Ravi,9999,0,9999,0
1668162873948,CSE 293,029,119417,Sahoo; Debashis,9999,0,9999,0
1668162873948,CSE 293,030,119420,Saul; Lawrence,9999,0,9999,0
1668162873948,CSE 293,031,119421,Savage; Stefan,9999,0,9999,0
1668162873948,CSE 293,032,119425,Schulze; Jurgen P.,9999,0,9999,0
1668162873948,CSE 293,033,119426,Snoeren; Alex C.,9999,0,9999,0
1668162873948,CSE 293,034,119428,Shang; Jingbo,9999,0,9999,0
1668162873948,CSE 293,035,119430,Stefan; Deian,9999,0,9999,0
1668162873948,CSE 293,036,119431,Su; Hao,9999,0,9999,0
1668162873948,CSE 293,037,119433,Swanson; Steven James,9999,0,9999,0
1668162873948,CSE 293,038,119435,Tullsen; Dean Michael,9999,0,9999,0
1668162873948,CSE 293,039,119483,Voelker; Geoffrey M.,9999,0,9999,0
1668162873948,CSE 293,040,119537,Zhao; Jishen,9999,0,9999,0
1668162873948,CSE 293,041,119538,Zhou; Yuan-Yuan,9999,0,9999,0
1668162873948,CSE 293,042,119539,Gao; Sicun,9999,0,9999,0
1668162873948,CSE 293,043,119540,Weibel; Nadir,9999,0,9999,0
1668162873948,CSE 293,044,119541,Gupta; Rajesh K.,9999,0,9999,0
1668162873948,CSE 293,045,126410,Vaccaro; Kristen Marie,9999,0,9999,0
1668162873948,CSE 293,046,126411,Klemke; Richard,9999,0,9999,0
1668162874371,CSE 294,A00,102459,Voelker; Geoffrey M.,0,0,0,0
1668162874371,CSE 294,B00,111322,Orailoglu; Alex,0,0,0,0
1668162874794,DSE 201,A00,096914,Deutsch; Alin Bernard,30,0,30,0
1668162875219,DSE 210,A00,096915,Dasgupta; Sanjoy,30,0,30,0
1668162875642,DSE 260A,A00,096916,Altintas De Callaf; Ilkay,30,0,30,0
1668162876073,ECE 200,001,103586,Antipa; Nicholas A,9999,0,9999,0
1668162876073,ECE 200,002,103587,Atanasov; Nikolay A.,9999,0,9999,0
1668162876073,ECE 200,003,103588,Bharadia; Dinesh,9999,0,9999,0
1668162876073,ECE 200,004,103589,Cheng; Chung Kuan,9999,0,9999,0
1668162876073,ECE 200,005,103590,Cosman; Pamela C.,9999,0,9999,0
1668162876073,ECE 200,006,103591,Dayeh; Shadi Ahmad,9999,0,9999,0
1668162876073,ECE 200,007,103592,Fainman; Yeshaiahu,9999,0,9999,0
1668162876073,ECE 200,008,103593,Ford; Joseph Earl,9999,0,9999,0
1668162876073,ECE 200,009,103594,Franceschetti; Massimo,9999,0,9999,0
1668162876073,ECE 200,010,103595,Fullerton; Eric E,9999,0,9999,0
1668162876073,ECE 200,011,103596,Galton; Ian A,9999,0,9999,0
1668162876073,ECE 200,012,103597,Gilja; Vikash,9999,0,9999,0
1668162876073,ECE 200,013,103598,Hall; Drew A.,9999,0,9999,0
1668162876073,ECE 200,014,103599,Hsueh; Tzu-Chien,9999,0,9999,0
1668162876073,ECE 200,015,103600,Javidi; Tara,9999,0,9999,0
1668162876073,ECE 200,016,103601,Kahng; Andrew Byun,9999,0,9999,0
1668162876073,ECE 200,017,103602,Kim; Young-Han,9999,0,9999,0
1668162876073,ECE 200,018,103603,Koushanfar; Farinaz,9999,0,9999,0
1668162876073,ECE 200,019,103604,Kuzum; Duygu,9999,0,9999,0
1668162876073,ECE 200,020,103605,Le; Hanh-Phuc,9999,0,9999,0
1668162876073,ECE 200,021,103606,Lin; Bill,9999,0,9999,0
1668162876073,ECE 200,022,103607,Liu; Zhaowei,9998,0,9999,1
1668162876073,ECE 200,023,103608,Lo; Yu-Hwa,9999,0,9999,0
1668162876073,ECE 200,024,103609,Lomakin; Vitaliy,9999,0,9999,0
1668162876073,ECE 200,025,103610,Mercier; Patrick Philip,9999,0,9999,0
1668162876073,ECE 200,026,103611,Meyer; Florian,9999,0,9999,0
1668162876073,ECE 200,027,103612,Milstein; Laurence B.,9999,0,9999,0
1668162876073,ECE 200,028,103613,Mir Arabbaygi; Siavash,9999,0,9999,0
1668162876073,ECE 200,029,103614,Mookherjea; Shayan,9999,0,9999,0
1668162876073,ECE 200,030,103615,Morris; Karcher William,9999,0,9999,0
1668162876073,ECE 200,031,103616,Ng; Tse Nga,9999,0,9999,0
1668162876073,ECE 200,032,103617,Nguyen; Truong Quang,9999,0,9999,0
1668162876073,ECE 200,033,103618,Nomura; Kenji,9999,0,9999,0
1668162876073,ECE 200,034,103619,Orlitsky; Alon,9999,0,9999,0
1668162876073,ECE 200,035,103620,Pal; Piya,9999,0,9999,0
1668162876073,ECE 200,036,103621,Papen; George C.,9999,0,9999,0
1668162876073,ECE 200,037,103622,Radic; Stojan,9999,0,9999,0
1668162876073,ECE 200,038,103623,Rao; Bhaskar D.,9999,0,9999,0
1668162876073,ECE 200,039,103624,Rao; Ramesh R,9999,0,9999,0
1668162876073,ECE 200,040,103625,Rebeiz; Gabriel,9999,0,9999,0
1668162876073,ECE 200,041,103626,Sanford; John R,9999,0,9999,0
1668162876073,ECE 200,042,103627,Siegel; Paul H.,9999,0,9999,0
1668162876073,ECE 200,043,103628,Sievenpiper; Daniel F.,9999,0,9999,0
1668162876073,ECE 200,044,103629,Sworder; David D.,9999,0,9999,0
1668162876073,ECE 200,045,103630,Taur; Yuan,9999,0,9999,0
1668162876073,ECE 200,046,103631,Touri; Behrouz,9999,0,9999,0
1668162876073,ECE 200,047,103632,Trivedi; Mohan M.,9999,0,9999,0
1668162876073,ECE 200,048,103633,Vasconcelos; Nuno,9999,0,9999,0
1668162876073,ECE 200,049,103634,Wang; Xiaolong,9999,0,9999,0
1668162876073,ECE 200,050,103635,Xie; Pengtao,9999,0,9999,0
1668162876073,ECE 200,051,103636,Yip; Michael,9999,0,9999,0
1668162876073,ECE 200,052,103637,Zeger; Kenneth A.,999,0,999,0
1668162876073,ECE 200,053,103638,Zhang; Xinyu,9999,0,9999,0
1668162876073,ECE 200,054,103639,Turakhia; Yatish Girish,9999,0,9999,0
1668162876073,ECE 200,055,103640,Kang; Mingu,9999,0,9999,0
1668162876073,ECE 200,056,103641,Shi; Yuanyuan,9999,0,9999,0
1668162876073,ECE 200,057,103642,Wang; Edward Jay,9999,0,9999,0
1668162876073,ECE 200,058,103643,Zheng; Yang,9999,0,9999,0
1668162876498,ECE 202,A00,103644,Kuzum; Duygu,0,0,0,0
1668162876924,ECE 212BN,A00,103646,Ng; Tse Nga,0,0,0,0
1668162877347,ECE 221,A00,111493,Staff,0,0,0,0
1668162877770,ECE 222B,A00,103647,Lomakin; Vitaliy,0,0,0,0
1668162878197,ECE 230B,A00,103648,Taur; Yuan,0,0,0,0
1668162878620,ECE 238B,A00,103649,Garay; Javier,0,0,0,0
1668162879047,ECE 240B,A00,112900,Fainman; Yeshaiahu,0,0,0,0
1668162879470,ECE 247A,A00,103650,Jokerst; Jesse Vincent,0,0,0,0
1668162879895,ECE 247B,A00,103651,Wang; Joseph,0,0,0,0
1668162880320,ECE 250,A00,103652,Siegel; Paul H.,0,0,0,0
1668162880744,ECE 251A,A00,103654,Rao; Bhaskar D.,0,0,0,0
1668162881169,ECE 257B,A00,103655,Bharadia; Dinesh,0,0,0,0
1668162881595,ECE 258A,A00,103656,Milstein; Laurence B.,0,0,0,0
1668162882023,ECE 260B,A00,103658,Kang; Mingu,0,0,0,0
1668162882450,ECE 264A,A00,103659,Galton; Ian A,0,0,0,0
1668162882873,ECE 265A,A00,103661,Gudem; Prasad S.S.,0,0,0,0
1668162883295,ECE 265D,A00,103662,Gudem; Prasad S.S.,0,0,0,0
1668162883719,ECE 268,A00,103663,Koushanfar; Farinaz,0,0,0,0
1668162884145,ECE 269,A01,103665,Pal; Piya,0,0,0,0
1668162884574,ECE 271B,A00,103666,Vasconcelos; Manuela,0,0,0,0
1668162884997,ECE 276A,A00,103667,Atanasov; Nikolay A.,0,0,0,0
1668162885429,ECE 277,A00,103668,An; Cheolhong,0,0,0,0
1668162885854,ECE 279,A00,117947,Hall; Drew A.,0,0,0,0
1668162886703,ECE 283,A00,103670,Hsueh; Tzu-Chien,0,0,0,0
1668162887131,ECE 284,A00,103671,Turakhia; Yatish Girish,0,0,0,0
1668162887556,ECE 285,A00,103672,Zheng; Yang,0,0,0,0
1668162887556,ECE 285,B00,103673,Sworder; David D.,0,0,0,0
1668162887982,ECE 287,A00,103676,Javidi; Tara,0,0,0,0
1668162888406,MATH 200B,A00,098023,Salehi Golsefidy; Alireza,12,0,15,3
1668162888832,MATH 202B,A00,098024,Rhoades; Brendon Patrick,9,0,15,6
1668162889265,MATH 203B,A00,098025,Oprea; Dragos N.,10,0,15,5
1668162889690,MATH 204B,A00,098026,Sorensen; Claus M,13,0,15,2
1668162890111,MATH 208,A00,098027,Izadi; Elham,7,0,10,3
1668162890534,MATH 209,A00,098028,Pollack; Aaron,10,0,10,0
1668162890958,MATH 211A,A00,112919,Rogalski; Daniel,9,0,10,1
1668162891383,MATH 211B,A00,112920,Seward; Brandon M.,9,0,10,1
1668162891807,MATH 218,A00,098029,Li; Bo,10,0,10,0
1668162892231,MATH 220B,A00,098030,Novak; Jonathan I,11,0,15,4
1668162892658,MATH 221A,A00,098031,Ebenfelt; Peter F,13,0,15,2
1668162893085,MATH 231B,A00,098032,Zlatos; Andrej,12,0,15,3
1668162893506,MATH 240B,A00,098033,Ni; Lei,9,0,15,6
1668162893931,MATH 243,A00,098034,Jekel; David Andrew,10,0,10,0
1668162894354,MATH 245A,A00,098035,Nie; Jiawang,0,0,15,16
1668162894787,MATH 248,A00,098036,Bejenaru; Ioan,10,0,10,0
1668162895214,MATH 250B,A00,098037,Spolaor; Luca,14,0,15,1
1668162895639,MATH 258,A00,098038,Ni; Lei,10,0,10,0
1668162896064,MATH 264B,A00,098041,Rhoades; Brendon Patrick,9,0,15,6
1668162896489,MATH 268,A00,098042,Buss; Samuel R,10,0,10,0
1668162896912,MATH 269,A00,098043,Rhoades; Brendon Patrick,10,0,10,0
1668162897360,MATH 270B,A00,098044,Li; Bo,10,0,15,5
1668162897799,MATH 272B,A00,098045,Holst; Michael J,13,0,15,2
1668162898222,MATH 273A,A00,098046,Tian; Xiaochuan,10,0,15,5
1668162898647,MATH 275,A01,098048,Tian; Xiaochuan,6,0,10,4
1668162899070,MATH 278A,A00,098049,Holst; Michael J,8,0,10,2
1668162899497,MATH 278B,A00,098050,Cloninger; Alexander,10,0,10,0
1668162899920,MATH 278C,A00,098051,Nie; Jiawang,7,0,10,3
1668162900348,MATH 280B,A00,098052,Zheng; Tianyi,10,0,15,5
1668162900769,MATH 281B,A00,098053,Bradic; Jelena,2,0,15,13
1668162901191,MATH 282B,A00,098054,Arias-Castro; Ery,0,0,15,15
1668162901618,MATH 285,A00,098055,Fitzsimmons; Patrick J,0,0,15,17
1668162902045,MATH 287B,A00,098056,Arias-Castro; Ery,2,0,15,13
1668162902471,MATH 288,A00,098057,Agarwal; Pooja,9,0,10,1
1668162902471,MATH 288,B00,098058,Zhang; Danna,8,0,10,2
1668162902471,MATH 288,C00,098059,Williams; Ruth J,10,0,10,0
1668162902896,MATH 290B,A00,098060,Roberts; Justin Deritter,13,0,15,2
1668162903410,MATH 292,A00,098061,Belmont; Eva Kinoshita,10,0,10,0
1668162903836,MATH 295,A00,098062,Suk; Andrew Hoon,48,0,50,2
1668162904259,MATH 296,A00,098063,Novak; Jonathan I,20,0,20,0
1668162904685,MATH 297,001,098064,Gamst; Anthony Collins,9997,0,9999,2
1668163402963,COGS 205,A00,101395,Chiba; Andrea,19,0,20,1
1668163403396,COGS 210B,001,101404,Greene; Deanna Jacquelyn,9998,0,9999,1
1668163403396,COGS 210B,002,101417,Xia; Haijun,9999,0,9999,0
1668163403396,COGS 210B,003,101422,Nitz; Douglas A.,9999,0,9999,0
1668163403396,COGS 210B,004,101423,Hollan; James D.,9998,0,9999,1
1668163403396,COGS 210B,005,101424,Deak; Gedeon O.,9998,0,9999,1
1668163403396,COGS 210B,006,101425,Rossano; Federico,9999,0,9999,0
1668163403821,COGS 211B,A00,101427,Coulson; Seana M,9996,0,9999,3
1668163404249,COGS 220,A00,101428,Hollan; James D.,0,0,25,25
1668163404671,COGS 229,A00,101429,Dow; Steven P,18,0,25,7
1668163405095,COGS 230,A00,101430,Klemmer; Scott R,12,0,17,5
1668163405519,COGS 234,A00,101431,Xia; Haijun,3,0,25,22
1668163405942,COGS 260,A00,101432,Kiyonaga; Anastasia,20,0,25,5
1668163405942,COGS 260,B00,101433,Kirsh; David Joel,16,0,25,9
1668163406367,CSE 202,A00,102371,Impagliazzo; Russell,0,0,0,0
1668163406793,CSE 203B,A01,102373,Cheng; Chung Kuan,0,0,0,0
1668163407216,CSE 208,A00,102374,Micciancio; Daniele,0,0,0,0
1668163407638,CSE 209A,A00,112895,Impagliazzo; Russell,0,0,15,15
1668163408062,CSE 209B,A00,108005,Bellare; Mihir,0,0,0,0
1668163408488,CSE 210,A00,113163,Coblenz; Michael J,0,0,0,0
1668163408912,CSE 219,A00,106111,Dow; Steven P,0,0,20,20
1668163409338,CSE 221,A00,102376,Voelker; Geoffrey M.,0,0,0,0
1668163409763,CSE 224,A01,102378,Porter; George M,0,0,0,0
1668163410189,CSE 229A,A00,102379,Savage; Stefan,0,0,0,0
1668163410612,CSE 229C,A00,102380,Munyaka; Imani N. S.,0,0,0,0
1668163411034,CSE 232B,A00,102382,Deutsch; Alin Bernard,0,0,0,0
1668163411461,CSE 234,A01,112904,Kumar; Arun Kumar,0,0,0,0
1668163411886,CSE 237A,A00,102383,Rosing; Tajana Simunic,0,0,0,0
1668163412308,CSE 239A,A00,102384,Deutsch; Alin Bernard,0,0,0,0
1668163412733,CSE 239B,A00,102385,Polikarpova; Nadezhda,0,0,0,0
1668163413156,CSE 240A,A00,102386,Pannuto; Patrick William,0,0,0,0
1668163413589,CSE 240B,A00,102387,Zhao; Jishen,0,0,0,0
1668163414013,CSE 241A,A00,106406,Kang; Mingu,0,0,0,0
1668163414439,CSE 249B,A00,102388,Kahng; Andrew Byun,0,0,8,8
1668163414867,CSE 251B,A01,102392,Cottrell; Garrison W,0,0,0,0
1668163414867,CSE 251B,A02,102393,Cottrell; Garrison W,0,0,0,0
1668163415290,CSE 252B,A00,102394,Ochoa; Benjamin Lawrence,0,0,0,0
1668163415714,CSE 257,A01,102396,Gao; Sicun,0,0,0,0
1668163416143,CSE 272,A00,102397,Li; Tzumao,0,0,0,0
1668163416566,CSE 274,A00,111323,Chern; Albert Ren-Haur,0,0,0,0
1668163416989,CSE 282,A00,102398,Pevzner; Pavel Arkadjevich,0,0,0,0
1668163417411,CSE 284,A00,114175,Gymrek; Melissa Ann,0,0,0,0
1668163417836,CSE 290,A00,102399,Chandraker; Manmohan Krishna,0,0,0,0
1668163417836,CSE 290,B00,102400,Vaccaro; Kristen Marie,0,0,25,25
1668163417836,CSE 290,C00,102414,Pannuto; Patrick William,0,0,25,25
1668163417836,CSE 290,D00,102427,Pevzner; Pavel Arkadjevich,0,0,0,0
1668163417836,CSE 290,E00,102429,Zhao; Jishen,0,0,0,0
1668163417836,CSE 290,F00,102436,Tullsen; Dean Michael,0,0,0,0
1668163417836,CSE 290,G00,102440,Christensen; Henrik I,0,0,20,20
1668163418267,CSE 291,A00,102443,Su; Hao,0,0,0,0
1668163418267,CSE 291,B00,102448,Polikarpova; Nadezhda,0,0,0,0
1668163418267,CSE 291,C00,102453,Vaccaro; Kristen Marie,0,0,0,0
1668163418267,CSE 291,D00,111343,Savage; Stefan,0,0,0,0
1668163418267,CSE 291,E00,116474,Claffy; Kimberly Claire,0,0,0,0
1668163418267,CSE 291,F00,116479,Pasquale; Joseph,0,0,0,0
1668163418697,CSE 293,001,119111,Bafna; Vineet,9999,0,9999,0
1668163418697,CSE 293,002,119118,Bellare; Mihir,9999,0,9999,0
1668163418697,CSE 293,003,119122,Berg-Kirkpatrick; Taylor D,9999,0,9999,0
1668163418697,CSE 293,004,119135,Christensen; Henrik I,9999,0,9999,0
1668163418697,CSE 293,005,119142,Cottrell; Garrison W,9999,0,9999,0
1668163418697,CSE 293,006,119146,Deutsch; Alin Bernard,9999,0,9999,0
1668163418697,CSE 293,007,119159,Esmaeilzadeh; Hadi,9999,0,9999,0
1668163418697,CSE 293,008,119166,Freund; Yoav,9999,0,9999,0
1668163418697,CSE 293,009,119170,Griswold; William G.,9999,0,9999,0
1668163418697,CSE 293,010,119183,Gymrek; Melissa Ann,9999,0,9999,0
1668163418697,CSE 293,011,119190,Heninger; Nadia A,9999,0,9999,0
1668163418697,CSE 293,012,119230,Impagliazzo; Russell,9999,0,9999,0
1668163418697,CSE 293,013,119232,Jhala; Ranjit,9999,0,9999,0
1668163418697,CSE 293,014,119233,Kahng; Andrew Byun,9999,0,9999,0
1668163418697,CSE 293,015,119298,Kane; Daniel Mertz,9999,0,9999,0
1668163418697,CSE 293,016,119299,Kriegman; David J,9999,0,9999,0
1668163418697,CSE 293,017,119300,Kumar; Arun Kumar,9999,0,9999,0
1668163418697,CSE 293,018,119301,Lerner; Sorin,9999,0,9999,0
1668163418697,CSE 293,019,119302,Lovett; Shachar,9999,0,9999,0
1668163418697,CSE 293,020,119303,McAuley; Julian John,9999,0,9999,0
1668163418697,CSE 293,021,119304,Micciancio; Daniele,9999,0,9999,0
1668163418697,CSE 293,022,119367,Orailoglu; Alex,9999,0,9999,0
1668163418697,CSE 293,023,119382,Paturi; Ramamohan,9999,0,9999,0
1668163418697,CSE 293,024,119404,Polikarpova; Nadezhda,9999,0,9999,0
1668163418697,CSE 293,025,119406,Politz; Joseph Gibbs,9999,0,9999,0
1668163418697,CSE 293,026,119411,Porter; George M,9999,0,9999,0
1668163418697,CSE 293,027,119414,Porter; Leonard Emerson,9999,0,9999,0
1668163418697,CSE 293,028,119416,Ramamoorthi; Ravi,9999,0,9999,0
1668163418697,CSE 293,029,119417,Sahoo; Debashis,9999,0,9999,0
1668163418697,CSE 293,030,119420,Saul; Lawrence,9999,0,9999,0
1668163418697,CSE 293,031,119421,Savage; Stefan,9999,0,9999,0
1668163418697,CSE 293,032,119425,Schulze; Jurgen P.,9999,0,9999,0
1668163418697,CSE 293,033,119426,Snoeren; Alex C.,9999,0,9999,0
1668163418697,CSE 293,034,119428,Shang; Jingbo,9999,0,9999,0
1668163418697,CSE 293,035,119430,Stefan; Deian,9999,0,9999,0
1668163418697,CSE 293,036,119431,Su; Hao,9999,0,9999,0
1668163418697,CSE 293,037,119433,Swanson; Steven James,9999,0,9999,0
1668163418697,CSE 293,038,119435,Tullsen; Dean Michael,9999,0,9999,0
1668163418697,CSE 293,039,119483,Voelker; Geoffrey M.,9999,0,9999,0
1668163418697,CSE 293,040,119537,Zhao; Jishen,9999,0,9999,0
1668163418697,CSE 293,041,119538,Zhou; Yuan-Yuan,9999,0,9999,0
1668163418697,CSE 293,042,119539,Gao; Sicun,9999,0,9999,0
1668163418697,CSE 293,043,119540,Weibel; Nadir,9999,0,9999,0
1668163418697,CSE 293,044,119541,Gupta; Rajesh K.,9999,0,9999,0
1668163418697,CSE 293,045,126410,Vaccaro; Kristen Marie,9999,0,9999,0
1668163418697,CSE 293,046,126411,Klemke; Richard,9999,0,9999,0
1668163419234,CSE 294,A00,102459,Voelker; Geoffrey M.,0,0,0,0
1668163419234,CSE 294,B00,111322,Orailoglu; Alex,0,0,0,0
1668163419659,DSE 201,A00,096914,Deutsch; Alin Bernard,30,0,30,0
1668163420082,DSE 210,A00,096915,Dasgupta; Sanjoy,30,0,30,0
1668163420505,DSE 260A,A00,096916,Altintas De Callaf; Ilkay,30,0,30,0
1668163420947,ECE 200,001,103586,Antipa; Nicholas A,9999,0,9999,0
1668163420947,ECE 200,002,103587,Atanasov; Nikolay A.,9999,0,9999,0
1668163420947,ECE 200,003,103588,Bharadia; Dinesh,9999,0,9999,0
1668163420947,ECE 200,004,103589,Cheng; Chung Kuan,9999,0,9999,0
1668163420947,ECE 200,005,103590,Cosman; Pamela C.,9999,0,9999,0
1668163420947,ECE 200,006,103591,Dayeh; Shadi Ahmad,9999,0,9999,0
1668163420947,ECE 200,007,103592,Fainman; Yeshaiahu,9999,0,9999,0
1668163420947,ECE 200,008,103593,Ford; Joseph Earl,9999,0,9999,0
1668163420947,ECE 200,009,103594,Franceschetti; Massimo,9999,0,9999,0
1668163420947,ECE 200,010,103595,Fullerton; Eric E,9999,0,9999,0
1668163420947,ECE 200,011,103596,Galton; Ian A,9999,0,9999,0
1668163420947,ECE 200,012,103597,Gilja; Vikash,9999,0,9999,0
1668163420947,ECE 200,013,103598,Hall; Drew A.,9999,0,9999,0
1668163420947,ECE 200,014,103599,Hsueh; Tzu-Chien,9999,0,9999,0
1668163420947,ECE 200,015,103600,Javidi; Tara,9999,0,9999,0
1668163420947,ECE 200,016,103601,Kahng; Andrew Byun,9999,0,9999,0
1668163420947,ECE 200,017,103602,Kim; Young-Han,9999,0,9999,0
1668163420947,ECE 200,018,103603,Koushanfar; Farinaz,9999,0,9999,0
1668163420947,ECE 200,019,103604,Kuzum; Duygu,9999,0,9999,0
1668163420947,ECE 200,020,103605,Le; Hanh-Phuc,9999,0,9999,0
1668163420947,ECE 200,021,103606,Lin; Bill,9999,0,9999,0
1668163420947,ECE 200,022,103607,Liu; Zhaowei,9998,0,9999,1
1668163420947,ECE 200,023,103608,Lo; Yu-Hwa,9999,0,9999,0
1668163420947,ECE 200,024,103609,Lomakin; Vitaliy,9999,0,9999,0
1668163420947,ECE 200,025,103610,Mercier; Patrick Philip,9999,0,9999,0
1668163420947,ECE 200,026,103611,Meyer; Florian,9999,0,9999,0
1668163420947,ECE 200,027,103612,Milstein; Laurence B.,9999,0,9999,0
1668163420947,ECE 200,028,103613,Mir Arabbaygi; Siavash,9999,0,9999,0
1668163420947,ECE 200,029,103614,Mookherjea; Shayan,9999,0,9999,0
1668163420947,ECE 200,030,103615,Morris; Karcher William,9999,0,9999,0
1668163420947,ECE 200,031,103616,Ng; Tse Nga,9999,0,9999,0
1668163420947,ECE 200,032,103617,Nguyen; Truong Quang,9999,0,9999,0
1668163420947,ECE 200,033,103618,Nomura; Kenji,9999,0,9999,0
1668163420947,ECE 200,034,103619,Orlitsky; Alon,9999,0,9999,0
1668163420947,ECE 200,035,103620,Pal; Piya,9999,0,9999,0
1668163420947,ECE 200,036,103621,Papen; George C.,9999,0,9999,0
1668163420947,ECE 200,037,103622,Radic; Stojan,9999,0,9999,0
1668163420947,ECE 200,038,103623,Rao; Bhaskar D.,9999,0,9999,0
1668163420947,ECE 200,039,103624,Rao; Ramesh R,9999,0,9999,0
1668163420947,ECE 200,040,103625,Rebeiz; Gabriel,9999,0,9999,0
1668163420947,ECE 200,041,103626,Sanford; John R,9999,0,9999,0
1668163420947,ECE 200,042,103627,Siegel; Paul H.,9999,0,9999,0
1668163420947,ECE 200,043,103628,Sievenpiper; Daniel F.,9999,0,9999,0
1668163420947,ECE 200,044,103629,Sworder; David D.,9999,0,9999,0
1668163420947,ECE 200,045,103630,Taur; Yuan,9999,0,9999,0
1668163420947,ECE 200,046,103631,Touri; Behrouz,9999,0,9999,0
1668163420947,ECE 200,047,103632,Trivedi; Mohan M.,9999,0,9999,0
1668163420947,ECE 200,048,103633,Vasconcelos; Nuno,9999,0,9999,0
1668163420947,ECE 200,049,103634,Wang; Xiaolong,9999,0,9999,0
1668163420947,ECE 200,050,103635,Xie; Pengtao,9999,0,9999,0
1668163420947,ECE 200,051,103636,Yip; Michael,9999,0,9999,0
1668163420947,ECE 200,052,103637,Zeger; Kenneth A.,999,0,999,0
1668163420947,ECE 200,053,103638,Zhang; Xinyu,9999,0,9999,0
1668163420947,ECE 200,054,103639,Turakhia; Yatish Girish,9999,0,9999,0
1668163420947,ECE 200,055,103640,Kang; Mingu,9999,0,9999,0
1668163420947,ECE 200,056,103641,Shi; Yuanyuan,9999,0,9999,0
1668163420947,ECE 200,057,103642,Wang; Edward Jay,9999,0,9999,0
1668163420947,ECE 200,058,103643,Zheng; Yang,9999,0,9999,0
1668163421373,ECE 202,A00,103644,Kuzum; Duygu,0,0,0,0
1668163421887,ECE 212BN,A00,103646,Ng; Tse Nga,0,0,0,0
1668163422313,ECE 221,A00,111493,Staff,0,0,0,0
1668163422738,ECE 222B,A00,103647,Lomakin; Vitaliy,0,0,0,0
1668163423161,ECE 230B,A00,103648,Taur; Yuan,0,0,0,0
1668163423584,ECE 238B,A00,103649,Garay; Javier,0,0,0,0
1668163424015,ECE 240B,A00,112900,Fainman; Yeshaiahu,0,0,0,0
1668163424441,ECE 247A,A00,103650,Jokerst; Jesse Vincent,0,0,0,0
1668163424865,ECE 247B,A00,103651,Wang; Joseph,0,0,0,0
1668163425288,ECE 250,A00,103652,Siegel; Paul H.,0,0,0,0
1668163425713,ECE 251A,A00,103654,Rao; Bhaskar D.,0,0,0,0
1668163426137,ECE 257B,A00,103655,Bharadia; Dinesh,0,0,0,0
1668163426561,ECE 258A,A00,103656,Milstein; Laurence B.,0,0,0,0
1668163426985,ECE 260B,A00,103658,Kang; Mingu,0,0,0,0
1668163427419,ECE 264A,A00,103659,Galton; Ian A,0,0,0,0
1668163427843,ECE 265A,A00,103661,Gudem; Prasad S.S.,0,0,0,0
1668163428268,ECE 265D,A00,103662,Gudem; Prasad S.S.,0,0,0,0
1668163428694,ECE 268,A00,103663,Koushanfar; Farinaz,0,0,0,0
1668163429116,ECE 269,A01,103665,Pal; Piya,0,0,0,0
1668163429543,ECE 271B,A00,103666,Vasconcelos; Manuela,0,0,0,0
1668163429970,ECE 276A,A00,103667,Atanasov; Nikolay A.,0,0,0,0
1668163430393,ECE 277,A00,103668,An; Cheolhong,0,0,0,0
1668163430828,ECE 279,A00,117947,Hall; Drew A.,0,0,0,0
1668163431681,ECE 283,A00,103670,Hsueh; Tzu-Chien,0,0,0,0
1668163432112,ECE 284,A00,103671,Turakhia; Yatish Girish,0,0,0,0
1668163432537,ECE 285,A00,103672,Zheng; Yang,0,0,0,0
1668163432537,ECE 285,B00,103673,Sworder; David D.,0,0,0,0
1668163432964,ECE 287,A00,103676,Javidi; Tara,0,0,0,0
1668163433388,MATH 200B,A00,098023,Salehi Golsefidy; Alireza,12,0,15,3
1668163433811,MATH 202B,A00,098024,Rhoades; Brendon Patrick,9,0,15,6
1668163434235,MATH 203B,A00,098025,Oprea; Dragos N.,10,0,15,5
1668163434661,MATH 204B,A00,098026,Sorensen; Claus M,13,0,15,2
1668163435083,MATH 208,A00,098027,Izadi; Elham,7,0,10,3
1668163435516,MATH 209,A00,098028,Pollack; Aaron,10,0,10,0
1668163435941,MATH 211A,A00,112919,Rogalski; Daniel,9,0,10,1
1668163436365,MATH 211B,A00,112920,Seward; Brandon M.,9,0,10,1
1668163436790,MATH 218,A00,098029,Li; Bo,10,0,10,0
1668163437213,MATH 220B,A00,098030,Novak; Jonathan I,11,0,15,4
1668163437635,MATH 221A,A00,098031,Ebenfelt; Peter F,13,0,15,2
1668163438061,MATH 231B,A00,098032,Zlatos; Andrej,12,0,15,3
1668163438485,MATH 240B,A00,098033,Ni; Lei,9,0,15,6
1668163438909,MATH 243,A00,098034,Jekel; David Andrew,10,0,10,0
1668163439335,MATH 245A,A00,098035,Nie; Jiawang,0,0,15,16
1668163439759,MATH 248,A00,098036,Bejenaru; Ioan,10,0,10,0
1668163440188,MATH 250B,A00,098037,Spolaor; Luca,14,0,15,1
1668163440616,MATH 258,A00,098038,Ni; Lei,10,0,10,0
1668163441049,MATH 264B,A00,098041,Rhoades; Brendon Patrick,9,0,15,6
1668163441471,MATH 268,A00,098042,Buss; Samuel R,10,0,10,0
1668163441894,MATH 269,A00,098043,Rhoades; Brendon Patrick,10,0,10,0
1668163442318,MATH 270B,A00,098044,Li; Bo,10,0,15,5
1668163442741,MATH 272B,A00,098045,Holst; Michael J,13,0,15,2
1668163443165,MATH 273A,A00,098046,Tian; Xiaochuan,10,0,15,5
1668163443586,MATH 275,A01,098048,Tian; Xiaochuan,6,0,10,4
1668163444012,MATH 278A,A00,098049,Holst; Michael J,8,0,10,2
1668163444437,MATH 278B,A00,098050,Cloninger; Alexander,10,0,10,0
1668163444861,MATH 278C,A00,098051,Nie; Jiawang,7,0,10,3
1668163445285,MATH 280B,A00,098052,Zheng; Tianyi,10,0,15,5
1668163445708,MATH 281B,A00,098053,Bradic; Jelena,2,0,15,13
1668163446131,MATH 282B,A00,098054,Arias-Castro; Ery,0,0,15,15
1668163446553,MATH 285,A00,098055,Fitzsimmons; Patrick J,0,0,15,17
1668163446982,MATH 287B,A00,098056,Arias-Castro; Ery,2,0,15,13
1668163447407,MATH 288,A00,098057,Agarwal; Pooja,9,0,10,1
1668163447407,MATH 288,B00,098058,Zhang; Danna,8,0,10,2
1668163447407,MATH 288,C00,098059,Williams; Ruth J,10,0,10,0
1668163447831,MATH 290B,A00,098060,Roberts; Justin Deritter,13,0,15,2
1668163448264,MATH 292,A00,098061,Belmont; Eva Kinoshita,10,0,10,0
1668163448691,MATH 295,A00,098062,Suk; Andrew Hoon,48,0,50,2
1668163449116,MATH 296,A00,098063,Novak; Jonathan I,20,0,20,0
1668163449541,MATH 297,001,098064,Gamst; Anthony Collins,9997,0,9999,2
1668163947830,COGS 205,A00,101395,Chiba; Andrea,19,0,20,1
1668163948258,COGS 210B,001,101404,Greene; Deanna Jacquelyn,9998,0,9999,1
1668163948258,COGS 210B,002,101417,Xia; Haijun,9999,0,9999,0
1668163948258,COGS 210B,003,101422,Nitz; Douglas A.,9999,0,9999,0
1668163948258,COGS 210B,004,101423,Hollan; James D.,9998,0,9999,1
1668163948258,COGS 210B,005,101424,Deak; Gedeon O.,9998,0,9999,1
1668163948258,COGS 210B,006,101425,Rossano; Federico,9999,0,9999,0
1668163948683,COGS 211B,A00,101427,Coulson; Seana M,9996,0,9999,3
1668163949110,COGS 220,A00,101428,Hollan; James D.,0,0,25,25
1668163949535,COGS 229,A00,101429,Dow; Steven P,18,0,25,7
1668163949959,COGS 230,A00,101430,Klemmer; Scott R,12,0,17,5
1668163950383,COGS 234,A00,101431,Xia; Haijun,3,0,25,22
1668163950821,COGS 260,A00,101432,Kiyonaga; Anastasia,20,0,25,5
1668163950821,COGS 260,B00,101433,Kirsh; David Joel,16,0,25,9
1668163951244,CSE 202,A00,102371,Impagliazzo; Russell,0,0,0,0
1668163951668,CSE 203B,A01,102373,Cheng; Chung Kuan,0,0,0,0
1668163952092,CSE 208,A00,102374,Micciancio; Daniele,0,0,0,0
1668163952519,CSE 209A,A00,112895,Impagliazzo; Russell,0,0,15,15
1668163952941,CSE 209B,A00,108005,Bellare; Mihir,0,0,0,0
1668163953364,CSE 210,A00,113163,Coblenz; Michael J,0,0,0,0
1668163953791,CSE 219,A00,106111,Dow; Steven P,0,0,20,20
1668163954217,CSE 221,A00,102376,Voelker; Geoffrey M.,0,0,0,0
1668163954642,CSE 224,A01,102378,Porter; George M,0,0,0,0
1668163955066,CSE 229A,A00,102379,Savage; Stefan,0,0,0,0
1668163955488,CSE 229C,A00,102380,Munyaka; Imani N. S.,0,0,0,0
1668163955916,CSE 232B,A00,102382,Deutsch; Alin Bernard,0,0,0,0
1668163956343,CSE 234,A01,112904,Kumar; Arun Kumar,0,0,0,0
1668163956769,CSE 237A,A00,102383,Rosing; Tajana Simunic,0,0,0,0
1668163957192,CSE 239A,A00,102384,Deutsch; Alin Bernard,0,0,0,0
1668163957619,CSE 239B,A00,102385,Polikarpova; Nadezhda,0,0,0,0
1668163958041,CSE 240A,A00,102386,Pannuto; Patrick William,0,0,0,0
1668163958463,CSE 240B,A00,102387,Zhao; Jishen,0,0,0,0
1668163958887,CSE 241A,A00,106406,Kang; Mingu,0,0,0,0
1668163959311,CSE 249B,A00,102388,Kahng; Andrew Byun,0,0,8,8
1668163959735,CSE 251B,A01,102392,Cottrell; Garrison W,0,0,0,0
1668163959735,CSE 251B,A02,102393,Cottrell; Garrison W,0,0,0,0
1668163960158,CSE 252B,A00,102394,Ochoa; Benjamin Lawrence,0,0,0,0
1668163960582,CSE 257,A01,102396,Gao; Sicun,0,0,0,0
1668163961007,CSE 272,A00,102397,Li; Tzumao,0,0,0,0
1668163961431,CSE 274,A00,111323,Chern; Albert Ren-Haur,0,0,0,0
1668163961855,CSE 282,A00,102398,Pevzner; Pavel Arkadjevich,0,0,0,0
1668163962281,CSE 284,A00,114175,Gymrek; Melissa Ann,0,0,0,0
1668163962720,CSE 290,A00,102399,Chandraker; Manmohan Krishna,0,0,0,0
1668163962720,CSE 290,B00,102400,Vaccaro; Kristen Marie,0,0,25,25
1668163962720,CSE 290,C00,102414,Pannuto; Patrick William,0,0,25,25
1668163962720,CSE 290,D00,102427,Pevzner; Pavel Arkadjevich,0,0,0,0
1668163962720,CSE 290,E00,102429,Zhao; Jishen,0,0,0,0
1668163962720,CSE 290,F00,102436,Tullsen; Dean Michael,0,0,0,0
1668163962720,CSE 290,G00,102440,Christensen; Henrik I,0,0,20,20
1668163963142,CSE 291,A00,102443,Su; Hao,0,0,0,0
1668163963142,CSE 291,B00,102448,Polikarpova; Nadezhda,0,0,0,0
1668163963142,CSE 291,C00,102453,Vaccaro; Kristen Marie,0,0,0,0
1668163963142,CSE 291,D00,111343,Savage; Stefan,0,0,0,0
1668163963142,CSE 291,E00,116474,Claffy; Kimberly Claire,0,0,0,0
1668163963142,CSE 291,F00,116479,Pasquale; Joseph,0,0,0,0
1668163963585,CSE 293,001,119111,Bafna; Vineet,9999,0,9999,0
1668163963585,CSE 293,002,119118,Bellare; Mihir,9999,0,9999,0
1668163963585,CSE 293,003,119122,Berg-Kirkpatrick; Taylor D,9999,0,9999,0
1668163963585,CSE 293,004,119135,Christensen; Henrik I,9999,0,9999,0
1668163963585,CSE 293,005,119142,Cottrell; Garrison W,9999,0,9999,0
1668163963585,CSE 293,006,119146,Deutsch; Alin Bernard,9999,0,9999,0
1668163963585,CSE 293,007,119159,Esmaeilzadeh; Hadi,9999,0,9999,0
1668163963585,CSE 293,008,119166,Freund; Yoav,9999,0,9999,0
1668163963585,CSE 293,009,119170,Griswold; William G.,9999,0,9999,0
1668163963585,CSE 293,010,119183,Gymrek; Melissa Ann,9999,0,9999,0
1668163963585,CSE 293,011,119190,Heninger; Nadia A,9999,0,9999,0
1668163963585,CSE 293,012,119230,Impagliazzo; Russell,9999,0,9999,0
1668163963585,CSE 293,013,119232,Jhala; Ranjit,9999,0,9999,0
1668163963585,CSE 293,014,119233,Kahng; Andrew Byun,9999,0,9999,0
1668163963585,CSE 293,015,119298,Kane; Daniel Mertz,9999,0,9999,0
1668163963585,CSE 293,016,119299,Kriegman; David J,9999,0,9999,0
1668163963585,CSE 293,017,119300,Kumar; Arun Kumar,9999,0,9999,0
1668163963585,CSE 293,018,119301,Lerner; Sorin,9999,0,9999,0
1668163963585,CSE 293,019,119302,Lovett; Shachar,9999,0,9999,0
1668163963585,CSE 293,020,119303,McAuley; Julian John,9999,0,9999,0
1668163963585,CSE 293,021,119304,Micciancio; Daniele,9999,0,9999,0
1668163963585,CSE 293,022,119367,Orailoglu; Alex,9999,0,9999,0
1668163963585,CSE 293,023,119382,Paturi; Ramamohan,9999,0,9999,0
1668163963585,CSE 293,024,119404,Polikarpova; Nadezhda,9999,0,9999,0
1668163963585,CSE 293,025,119406,Politz; Joseph Gibbs,9999,0,9999,0
1668163963585,CSE 293,026,119411,Porter; George M,9999,0,9999,0
1668163963585,CSE 293,027,119414,Porter; Leonard Emerson,9999,0,9999,0
1668163963585,CSE 293,028,119416,Ramamoorthi; Ravi,9999,0,9999,0
1668163963585,CSE 293,029,119417,Sahoo; Debashis,9999,0,9999,0
1668163963585,CSE 293,030,119420,Saul; Lawrence,9999,0,9999,0
1668163963585,CSE 293,031,119421,Savage; Stefan,9999,0,9999,0
1668163963585,CSE 293,032,119425,Schulze; Jurgen P.,9999,0,9999,0
1668163963585,CSE 293,033,119426,Snoeren; Alex C.,9999,0,9999,0
1668163963585,CSE 293,034,119428,Shang; Jingbo,9999,0,9999,0
1668163963585,CSE 293,035,119430,Stefan; Deian,9999,0,9999,0
1668163963585,CSE 293,036,119431,Su; Hao,9999,0,9999,0
1668163963585,CSE 293,037,119433,Swanson; Steven James,9999,0,9999,0
1668163963585,CSE 293,038,119435,Tullsen; Dean Michael,9999,0,9999,0
1668163963585,CSE 293,039,119483,Voelker; Geoffrey M.,9999,0,9999,0
1668163963585,CSE 293,040,119537,Zhao; Jishen,9999,0,9999,0
1668163963585,CSE 293,041,119538,Zhou; Yuan-Yuan,9999,0,9999,0
1668163963585,CSE 293,042,119539,Gao; Sicun,9999,0,9999,0
1668163963585,CSE 293,043,119540,Weibel; Nadir,9999,0,9999,0
1668163963585,CSE 293,044,119541,Gupta; Rajesh K.,9999,0,9999,0
1668163963585,CSE 293,045,126410,Vaccaro; Kristen Marie,9999,0,9999,0
1668163963585,CSE 293,046,126411,Klemke; Richard,9999,0,9999,0
1668163964009,CSE 294,A00,102459,Voelker; Geoffrey M.,0,0,0,0
1668163964009,CSE 294,B00,111322,Orailoglu; Alex,0,0,0,0
1668163964434,DSE 201,A00,096914,Deutsch; Alin Bernard,30,0,30,0
1668163964860,DSE 210,A00,096915,Dasgupta; Sanjoy,30,0,30,0
1668163965284,DSE 260A,A00,096916,Altintas De Callaf; Ilkay,30,0,30,0
1668163965709,ECE 200,001,103586,Antipa; Nicholas A,9999,0,9999,0
1668163965709,ECE 200,002,103587,Atanasov; Nikolay A.,9999,0,9999,0
1668163965709,ECE 200,003,103588,Bharadia; Dinesh,9999,0,9999,0
1668163965709,ECE 200,004,103589,Cheng; Chung Kuan,9999,0,9999,0
1668163965709,ECE 200,005,103590,Cosman; Pamela C.,9999,0,9999,0
1668163965709,ECE 200,006,103591,Dayeh; Shadi Ahmad,9999,0,9999,0
1668163965709,ECE 200,007,103592,Fainman; Yeshaiahu,9999,0,9999,0
1668163965709,ECE 200,008,103593,Ford; Joseph Earl,9999,0,9999,0
1668163965709,ECE 200,009,103594,Franceschetti; Massimo,9999,0,9999,0
1668163965709,ECE 200,010,103595,Fullerton; Eric E,9999,0,9999,0
1668163965709,ECE 200,011,103596,Galton; Ian A,9999,0,9999,0
1668163965709,ECE 200,012,103597,Gilja; Vikash,9999,0,9999,0
1668163965709,ECE 200,013,103598,Hall; Drew A.,9999,0,9999,0
1668163965709,ECE 200,014,103599,Hsueh; Tzu-Chien,9999,0,9999,0
1668163965709,ECE 200,015,103600,Javidi; Tara,9999,0,9999,0
1668163965709,ECE 200,016,103601,Kahng; Andrew Byun,9999,0,9999,0
1668163965709,ECE 200,017,103602,Kim; Young-Han,9999,0,9999,0
1668163965709,ECE 200,018,103603,Koushanfar; Farinaz,9999,0,9999,0
1668163965709,ECE 200,019,103604,Kuzum; Duygu,9999,0,9999,0
1668163965709,ECE 200,020,103605,Le; Hanh-Phuc,9999,0,9999,0
1668163965709,ECE 200,021,103606,Lin; Bill,9999,0,9999,0
1668163965709,ECE 200,022,103607,Liu; Zhaowei,9998,0,9999,1
1668163965709,ECE 200,023,103608,Lo; Yu-Hwa,9999,0,9999,0
1668163965709,ECE 200,024,103609,Lomakin; Vitaliy,9999,0,9999,0
1668163965709,ECE 200,025,103610,Mercier; Patrick Philip,9999,0,9999,0
1668163965709,ECE 200,026,103611,Meyer; Florian,9999,0,9999,0
1668163965709,ECE 200,027,103612,Milstein; Laurence B.,9999,0,9999,0
1668163965709,ECE 200,028,103613,Mir Arabbaygi; Siavash,9999,0,9999,0
1668163965709,ECE 200,029,103614,Mookherjea; Shayan,9999,0,9999,0
1668163965709,ECE 200,030,103615,Morris; Karcher William,9999,0,9999,0
1668163965709,ECE 200,031,103616,Ng; Tse Nga,9999,0,9999,0
1668163965709,ECE 200,032,103617,Nguyen; Truong Quang,9999,0,9999,0
1668163965709,ECE 200,033,103618,Nomura; Kenji,9999,0,9999,0
1668163965709,ECE 200,034,103619,Orlitsky; Alon,9999,0,9999,0
1668163965709,ECE 200,035,103620,Pal; Piya,9999,0,9999,0
1668163965709,ECE 200,036,103621,Papen; George C.,9999,0,9999,0
1668163965709,ECE 200,037,103622,Radic; Stojan,9999,0,9999,0
1668163965709,ECE 200,038,103623,Rao; Bhaskar D.,9999,0,9999,0
1668163965709,ECE 200,039,103624,Rao; Ramesh R,9999,0,9999,0
1668163965709,ECE 200,040,103625,Rebeiz; Gabriel,9999,0,9999,0
1668163965709,ECE 200,041,103626,Sanford; John R,9999,0,9999,0
1668163965709,ECE 200,042,103627,Siegel; Paul H.,9999,0,9999,0
1668163965709,ECE 200,043,103628,Sievenpiper; Daniel F.,9999,0,9999,0
1668163965709,ECE 200,044,103629,Sworder; David D.,9999,0,9999,0
1668163965709,ECE 200,045,103630,Taur; Yuan,9999,0,9999,0
1668163965709,ECE 200,046,103631,Touri; Behrouz,9999,0,9999,0
1668163965709,ECE 200,047,103632,Trivedi; Mohan M.,9999,0,9999,0
1668163965709,ECE 200,048,103633,Vasconcelos; Nuno,9999,0,9999,0
1668163965709,ECE 200,049,103634,Wang; Xiaolong,9999,0,9999,0
1668163965709,ECE 200,050,103635,Xie; Pengtao,9999,0,9999,0
1668163965709,ECE 200,051,103636,Yip; Michael,9999,0,9999,0
1668163965709,ECE 200,052,103637,Zeger; Kenneth A.,999,0,999,0
1668163965709,ECE 200,053,103638,Zhang; Xinyu,9999,0,9999,0
1668163965709,ECE 200,054,103639,Turakhia; Yatish Girish,9999,0,9999,0
1668163965709,ECE 200,055,103640,Kang; Mingu,9999,0,9999,0
1668163965709,ECE 200,056,103641,Shi; Yuanyuan,9999,0,9999,0
1668163965709,ECE 200,057,103642,Wang; Edward Jay,9999,0,9999,0
1668163965709,ECE 200,058,103643,Zheng; Yang,9999,0,9999,0
1668163966136,ECE 202,A00,103644,Kuzum; Duygu,0,0,0,0
1668163966559,ECE 212BN,A00,103646,Ng; Tse Nga,0,0,0,0
1668163966981,ECE 221,A00,111493,Staff,0,0,0,0
1668163967404,ECE 222B,A00,103647,Lomakin; Vitaliy,0,0,0,0
1668163967830,ECE 230B,A00,103648,Taur; Yuan,0,0,0,0
1668163968253,ECE 238B,A00,103649,Garay; Javier,0,0,0,0
1668163968675,ECE 240B,A00,112900,Fainman; Yeshaiahu,0,0,0,0
1668163969101,ECE 247A,A00,103650,Jokerst; Jesse Vincent,0,0,0,0
1668163969526,ECE 247B,A00,103651,Wang; Joseph,0,0,0,0
1668163969952,ECE 250,A00,103652,Siegel; Paul H.,0,0,0,0
1668163970377,ECE 251A,A00,103654,Rao; Bhaskar D.,0,0,0,0
1668163970801,ECE 257B,A00,103655,Bharadia; Dinesh,0,0,0,0
1668163971227,ECE 258A,A00,103656,Milstein; Laurence B.,0,0,0,0
1668163971651,ECE 260B,A00,103658,Kang; Mingu,0,0,0,0
1668163972078,ECE 264A,A00,103659,Galton; Ian A,0,0,0,0
1668163972501,ECE 265A,A00,103661,Gudem; Prasad S.S.,0,0,0,0
1668163972928,ECE 265D,A00,103662,Gudem; Prasad S.S.,0,0,0,0
1668163973355,ECE 268,A00,103663,Koushanfar; Farinaz,0,0,0,0
1668163973782,ECE 269,A01,103665,Pal; Piya,0,0,0,0
1668163974205,ECE 271B,A00,103666,Vasconcelos; Manuela,0,0,0,0
1668163974628,ECE 276A,A00,103667,Atanasov; Nikolay A.,0,0,0,0
1668163975051,ECE 277,A00,103668,An; Cheolhong,0,0,0,0
1668163975477,ECE 279,A00,117947,Hall; Drew A.,0,0,0,0
1668163976323,ECE 283,A00,103670,Hsueh; Tzu-Chien,0,0,0,0
1668163976748,ECE 284,A00,103671,Turakhia; Yatish Girish,0,0,0,0
1668163977172,ECE 285,A00,103672,Zheng; Yang,0,0,0,0
1668163977172,ECE 285,B00,103673,Sworder; David D.,0,0,0,0
1668163977596,ECE 287,A00,103676,Javidi; Tara,0,0,0,0
1668163978024,MATH 200B,A00,098023,Salehi Golsefidy; Alireza,12,0,15,3
1668163978447,MATH 202B,A00,098024,Rhoades; Brendon Patrick,9,0,15,6
1668163978874,MATH 203B,A00,098025,Oprea; Dragos N.,10,0,15,5
1668163979298,MATH 204B,A00,098026,Sorensen; Claus M,13,0,15,2
1668163979723,MATH 208,A00,098027,Izadi; Elham,7,0,10,3
1668163980146,MATH 209,A00,098028,Pollack; Aaron,10,0,10,0
1668163980567,MATH 211A,A00,112919,Rogalski; Daniel,9,0,10,1
1668163980994,MATH 211B,A00,112920,Seward; Brandon M.,9,0,10,1
1668163981418,MATH 218,A00,098029,Li; Bo,10,0,10,0
1668163981843,MATH 220B,A00,098030,Novak; Jonathan I,11,0,15,4
1668163982267,MATH 221A,A00,098031,Ebenfelt; Peter F,13,0,15,2
1668163982707,MATH 231B,A00,098032,Zlatos; Andrej,12,0,15,3
1668163983225,MATH 240B,A00,098033,Ni; Lei,9,0,15,6
1668163983649,MATH 243,A00,098034,Jekel; David Andrew,10,0,10,0
1668163984074,MATH 245A,A00,098035,Nie; Jiawang,0,0,15,16
1668163984499,MATH 248,A00,098036,Bejenaru; Ioan,10,0,10,0
1668163984926,MATH 250B,A00,098037,Spolaor; Luca,14,0,15,1
1668163985349,MATH 258,A00,098038,Ni; Lei,10,0,10,0
1668163985772,MATH 264B,A00,098041,Rhoades; Brendon Patrick,9,0,15,6
1668163986198,MATH 268,A00,098042,Buss; Samuel R,10,0,10,0
1668163986623,MATH 269,A00,098043,Rhoades; Brendon Patrick,10,0,10,0
1668163987046,MATH 270B,A00,098044,Li; Bo,10,0,15,5
1668163987473,MATH 272B,A00,098045,Holst; Michael J,13,0,15,2
1668163987908,MATH 273A,A00,098046,Tian; Xiaochuan,10,0,15,5
1668163988333,MATH 275,A01,098048,Tian; Xiaochuan,6,0,10,4
1668163988756,MATH 278A,A00,098049,Holst; Michael J,8,0,10,2
1668163989182,MATH 278B,A00,098050,Cloninger; Alexander,10,0,10,0
1668163989603,MATH 278C,A00,098051,Nie; Jiawang,7,0,10,3
1668163990027,MATH 280B,A00,098052,Zheng; Tianyi,10,0,15,5
1668163990452,MATH 281B,A00,098053,Bradic; Jelena,2,0,15,13
1668163990875,MATH 282B,A00,098054,Arias-Castro; Ery,0,0,15,15
1668163991298,MATH 285,A00,098055,Fitzsimmons; Patrick J,0,0,15,17
1668163991722,MATH 287B,A00,098056,Arias-Castro; Ery,2,0,15,13
1668163992146,MATH 288,A00,098057,Agarwal; Pooja,9,0,10,1
1668163992146,MATH 288,B00,098058,Zhang; Danna,8,0,10,2
1668163992146,MATH 288,C00,098059,Williams; Ruth J,10,0,10,0
1668163992574,MATH 290B,A00,098060,Roberts; Justin Deritter,13,0,15,2
1668163993000,MATH 292,A00,098061,Belmont; Eva Kinoshita,10,0,10,0
1668163993428,MATH 295,A00,098062,Suk; Andrew Hoon,48,0,50,2
1668163993853,MATH 296,A00,098063,Novak; Jonathan I,20,0,20,0
1668163994277,MATH 297,001,098064,Gamst; Anthony Collins,9997,0,9999,2
1668164492677,COGS 205,A00,101395,Chiba; Andrea,19,0,20,1
1668164493102,COGS 210B,001,101404,Greene; Deanna Jacquelyn,9998,0,9999,1
1668164493102,COGS 210B,002,101417,Xia; Haijun,9999,0,9999,0
1668164493102,COGS 210B,003,101422,Nitz; Douglas A.,9999,0,9999,0
1668164493102,COGS 210B,004,101423,Hollan; James D.,9998,0,9999,1
1668164493102,COGS 210B,005,101424,Deak; Gedeon O.,9998,0,9999,1
1668164493102,COGS 210B,006,101425,Rossano; Federico,9999,0,9999,0
1668164493526,COGS 211B,A00,101427,Coulson; Seana M,9996,0,9999,3
1668164493950,COGS 220,A00,101428,Hollan; James D.,0,0,25,25
1668164494377,COGS 229,A00,101429,Dow; Steven P,18,0,25,7
1668164494802,COGS 230,A00,101430,Klemmer; Scott R,12,0,17,5
1668164495225,COGS 234,A00,101431,Xia; Haijun,3,0,25,22
1668164495648,COGS 260,A00,101432,Kiyonaga; Anastasia,20,0,25,5
1668164495648,COGS 260,B00,101433,Kirsh; David Joel,16,0,25,9
1668164496076,CSE 202,A00,102371,Impagliazzo; Russell,0,0,0,0
1668164496502,CSE 203B,A01,102373,Cheng; Chung Kuan,0,0,0,0
1668164496927,CSE 208,A00,102374,Micciancio; Daniele,0,0,0,0
1668164497351,CSE 209A,A00,112895,Impagliazzo; Russell,0,0,15,15
1668164497773,CSE 209B,A00,108005,Bellare; Mihir,0,0,0,0
1668164498200,CSE 210,A00,113163,Coblenz; Michael J,0,0,0,0
1668164498624,CSE 219,A00,106111,Dow; Steven P,0,0,20,20
1668164499051,CSE 221,A00,102376,Voelker; Geoffrey M.,0,0,0,0
1668164499476,CSE 224,A01,102378,Porter; George M,0,0,0,0
1668164499903,CSE 229A,A00,102379,Savage; Stefan,0,0,0,0
1668164500327,CSE 229C,A00,102380,Munyaka; Imani N. S.,0,0,0,0
1668164500753,CSE 232B,A00,102382,Deutsch; Alin Bernard,0,0,0,0
1668164501177,CSE 234,A01,112904,Kumar; Arun Kumar,0,0,0,0
1668164501695,CSE 237A,A00,102383,Rosing; Tajana Simunic,0,0,0,0
1668164502121,CSE 239A,A00,102384,Deutsch; Alin Bernard,0,0,0,0
1668164502545,CSE 239B,A00,102385,Polikarpova; Nadezhda,0,0,0,0
1668164502968,CSE 240A,A00,102386,Pannuto; Patrick William,0,0,0,0
1668164503395,CSE 240B,A00,102387,Zhao; Jishen,0,0,0,0
1668164503822,CSE 241A,A00,106406,Kang; Mingu,0,0,0,0
1668164504246,CSE 249B,A00,102388,Kahng; Andrew Byun,0,0,8,8
1668164504669,CSE 251B,A01,102392,Cottrell; Garrison W,0,0,0,0
1668164504669,CSE 251B,A02,102393,Cottrell; Garrison W,0,0,0,0
1668164505092,CSE 252B,A00,102394,Ochoa; Benjamin Lawrence,0,0,0,0
1668164505513,CSE 257,A01,102396,Gao; Sicun,0,0,0,0
1668164505936,CSE 272,A00,102397,Li; Tzumao,0,0,0,0
1668164506370,CSE 274,A00,111323,Chern; Albert Ren-Haur,0,0,0,0
1668164506797,CSE 282,A00,102398,Pevzner; Pavel Arkadjevich,0,0,0,0
1668164507219,CSE 284,A00,114175,Gymrek; Melissa Ann,0,0,0,0
1668164507652,CSE 290,A00,102399,Chandraker; Manmohan Krishna,0,0,0,0
1668164507652,CSE 290,B00,102400,Vaccaro; Kristen Marie,0,0,25,25
1668164507652,CSE 290,C00,102414,Pannuto; Patrick William,0,0,25,25
1668164507652,CSE 290,D00,102427,Pevzner; Pavel Arkadjevich,0,0,0,0
1668164507652,CSE 290,E00,102429,Zhao; Jishen,0,0,0,0
1668164507652,CSE 290,F00,102436,Tullsen; Dean Michael,0,0,0,0
1668164507652,CSE 290,G00,102440,Christensen; Henrik I,0,0,20,20
1668164508084,CSE 291,A00,102443,Su; Hao,0,0,0,0
1668164508084,CSE 291,B00,102448,Polikarpova; Nadezhda,0,0,0,0
1668164508084,CSE 291,C00,102453,Vaccaro; Kristen Marie,0,0,0,0
1668164508084,CSE 291,D00,111343,Savage; Stefan,0,0,0,0
1668164508084,CSE 291,E00,116474,Claffy; Kimberly Claire,0,0,0,0
1668164508084,CSE 291,F00,116479,Pasquale; Joseph,0,0,0,0
1668164508509,CSE 293,001,119111,Bafna; Vineet,9999,0,9999,0
1668164508509,CSE 293,002,119118,Bellare; Mihir,9999,0,9999,0
1668164508509,CSE 293,003,119122,Berg-Kirkpatrick; Taylor D,9999,0,9999,0
1668164508509,CSE 293,004,119135,Christensen; Henrik I,9999,0,9999,0
1668164508509,CSE 293,005,119142,Cottrell; Garrison W,9999,0,9999,0
1668164508509,CSE 293,006,119146,Deutsch; Alin Bernard,9999,0,9999,0
1668164508509,CSE 293,007,119159,Esmaeilzadeh; Hadi,9999,0,9999,0
1668164508509,CSE 293,008,119166,Freund; Yoav,9999,0,9999,0
1668164508509,CSE 293,009,119170,Griswold; William G.,9999,0,9999,0
1668164508509,CSE 293,010,119183,Gymrek; Melissa Ann,9999,0,9999,0
1668164508509,CSE 293,011,119190,Heninger; Nadia A,9999,0,9999,0
1668164508509,CSE 293,012,119230,Impagliazzo; Russell,9999,0,9999,0
1668164508509,CSE 293,013,119232,Jhala; Ranjit,9999,0,9999,0
1668164508509,CSE 293,014,119233,Kahng; Andrew Byun,9999,0,9999,0
1668164508509,CSE 293,015,119298,Kane; Daniel Mertz,9999,0,9999,0
1668164508509,CSE 293,016,119299,Kriegman; David J,9999,0,9999,0
1668164508509,CSE 293,017,119300,Kumar; Arun Kumar,9999,0,9999,0
1668164508509,CSE 293,018,119301,Lerner; Sorin,9999,0,9999,0
1668164508509,CSE 293,019,119302,Lovett; Shachar,9999,0,9999,0
1668164508509,CSE 293,020,119303,McAuley; Julian John,9999,0,9999,0
1668164508509,CSE 293,021,119304,Micciancio; Daniele,9999,0,9999,0
1668164508509,CSE 293,022,119367,Orailoglu; Alex,9999,0,9999,0
1668164508509,CSE 293,023,119382,Paturi; Ramamohan,9999,0,9999,0
1668164508509,CSE 293,024,119404,Polikarpova; Nadezhda,9999,0,9999,0
1668164508509,CSE 293,025,119406,Politz; Joseph Gibbs,9999,0,9999,0
1668164508509,CSE 293,026,119411,Porter; George M,9999,0,9999,0
1668164508509,CSE 293,027,119414,Porter; Leonard Emerson,9999,0,9999,0
1668164508509,CSE 293,028,119416,Ramamoorthi; Ravi,9999,0,9999,0
1668164508509,CSE 293,029,119417,Sahoo; Debashis,9999,0,9999,0
1668164508509,CSE 293,030,119420,Saul; Lawrence,9999,0,9999,0
1668164508509,CSE 293,031,119421,Savage; Stefan,9999,0,9999,0
1668164508509,CSE 293,032,119425,Schulze; Jurgen P.,9999,0,9999,0
1668164508509,CSE 293,033,119426,Snoeren; Alex C.,9999,0,9999,0
1668164508509,CSE 293,034,119428,Shang; Jingbo,9999,0,9999,0
1668164508509,CSE 293,035,119430,Stefan; Deian,9999,0,9999,0
1668164508509,CSE 293,036,119431,Su; Hao,9999,0,9999,0
1668164508509,CSE 293,037,119433,Swanson; Steven James,9999,0,9999,0
1668164508509,CSE 293,038,119435,Tullsen; Dean Michael,9999,0,9999,0
1668164508509,CSE 293,039,119483,Voelker; Geoffrey M.,9999,0,9999,0
1668164508509,CSE 293,040,119537,Zhao; Jishen,9999,0,9999,0
1668164508509,CSE 293,041,119538,Zhou; Yuan-Yuan,9999,0,9999,0
1668164508509,CSE 293,042,119539,Gao; Sicun,9999,0,9999,0
1668164508509,CSE 293,043,119540,Weibel; Nadir,9999,0,9999,0
1668164508509,CSE 293,044,119541,Gupta; Rajesh K.,9999,0,9999,0
1668164508509,CSE 293,045,126410,Vaccaro; Kristen Marie,9999,0,9999,0
1668164508509,CSE 293,046,126411,Klemke; Richard,9999,0,9999,0
1668164508935,CSE 294,A00,102459,Voelker; Geoffrey M.,0,0,0,0
1668164508935,CSE 294,B00,111322,Orailoglu; Alex,0,0,0,0
1668164509361,DSE 201,A00,096914,Deutsch; Alin Bernard,30,0,30,0
1668164509786,DSE 210,A00,096915,Dasgupta; Sanjoy,30,0,30,0
1668164510211,DSE 260A,A00,096916,Altintas De Callaf; Ilkay,30,0,30,0
1668164510640,ECE 200,001,103586,Antipa; Nicholas A,9999,0,9999,0
1668164510640,ECE 200,002,103587,Atanasov; Nikolay A.,9999,0,9999,0
1668164510640,ECE 200,003,103588,Bharadia; Dinesh,9999,0,9999,0
1668164510640,ECE 200,004,103589,Cheng; Chung Kuan,9999,0,9999,0
1668164510640,ECE 200,005,103590,Cosman; Pamela C.,9999,0,9999,0
1668164510640,ECE 200,006,103591,Dayeh; Shadi Ahmad,9999,0,9999,0
1668164510640,ECE 200,007,103592,Fainman; Yeshaiahu,9999,0,9999,0
1668164510640,ECE 200,008,103593,Ford; Joseph Earl,9999,0,9999,0
1668164510640,ECE 200,009,103594,Franceschetti; Massimo,9999,0,9999,0
1668164510640,ECE 200,010,103595,Fullerton; Eric E,9999,0,9999,0
1668164510640,ECE 200,011,103596,Galton; Ian A,9999,0,9999,0
1668164510640,ECE 200,012,103597,Gilja; Vikash,9999,0,9999,0
1668164510640,ECE 200,013,103598,Hall; Drew A.,9999,0,9999,0
1668164510640,ECE 200,014,103599,Hsueh; Tzu-Chien,9999,0,9999,0
1668164510640,ECE 200,015,103600,Javidi; Tara,9999,0,9999,0
1668164510640,ECE 200,016,103601,Kahng; Andrew Byun,9999,0,9999,0
1668164510640,ECE 200,017,103602,Kim; Young-Han,9999,0,9999,0
1668164510640,ECE 200,018,103603,Koushanfar; Farinaz,9999,0,9999,0
1668164510640,ECE 200,019,103604,Kuzum; Duygu,9999,0,9999,0
1668164510640,ECE 200,020,103605,Le; Hanh-Phuc,9999,0,9999,0
1668164510640,ECE 200,021,103606,Lin; Bill,9999,0,9999,0
1668164510640,ECE 200,022,103607,Liu; Zhaowei,9998,0,9999,1
1668164510640,ECE 200,023,103608,Lo; Yu-Hwa,9999,0,9999,0
1668164510640,ECE 200,024,103609,Lomakin; Vitaliy,9999,0,9999,0
1668164510640,ECE 200,025,103610,Mercier; Patrick Philip,9999,0,9999,0
1668164510640,ECE 200,026,103611,Meyer; Florian,9999,0,9999,0
1668164510640,ECE 200,027,103612,Milstein; Laurence B.,9999,0,9999,0
1668164510640,ECE 200,028,103613,Mir Arabbaygi; Siavash,9999,0,9999,0
1668164510640,ECE 200,029,103614,Mookherjea; Shayan,9999,0,9999,0
1668164510640,ECE 200,030,103615,Morris; Karcher William,9999,0,9999,0
1668164510640,ECE 200,031,103616,Ng; Tse Nga,9999,0,9999,0
1668164510640,ECE 200,032,103617,Nguyen; Truong Quang,9999,0,9999,0
1668164510640,ECE 200,033,103618,Nomura; Kenji,9999,0,9999,0
1668164510640,ECE 200,034,103619,Orlitsky; Alon,9999,0,9999,0
1668164510640,ECE 200,035,103620,Pal; Piya,9999,0,9999,0
1668164510640,ECE 200,036,103621,Papen; George C.,9999,0,9999,0
1668164510640,ECE 200,037,103622,Radic; Stojan,9999,0,9999,0
1668164510640,ECE 200,038,103623,Rao; Bhaskar D.,9999,0,9999,0
1668164510640,ECE 200,039,103624,Rao; Ramesh R,9999,0,9999,0
1668164510640,ECE 200,040,103625,Rebeiz; Gabriel,9999,0,9999,0
1668164510640,ECE 200,041,103626,Sanford; John R,9999,0,9999,0
1668164510640,ECE 200,042,103627,Siegel; Paul H.,9999,0,9999,0
1668164510640,ECE 200,043,103628,Sievenpiper; Daniel F.,9999,0,9999,0
1668164510640,ECE 200,044,103629,Sworder; David D.,9999,0,9999,0
1668164510640,ECE 200,045,103630,Taur; Yuan,9999,0,9999,0
1668164510640,ECE 200,046,103631,Touri; Behrouz,9999,0,9999,0
1668164510640,ECE 200,047,103632,Trivedi; Mohan M.,9999,0,9999,0
1668164510640,ECE 200,048,103633,Vasconcelos; Nuno,9999,0,9999,0
1668164510640,ECE 200,049,103634,Wang; Xiaolong,9999,0,9999,0
1668164510640,ECE 200,050,103635,Xie; Pengtao,9999,0,9999,0
1668164510640,ECE 200,051,103636,Yip; Michael,9999,0,9999,0
1668164510640,ECE 200,052,103637,Zeger; Kenneth A.,999,0,999,0
1668164510640,ECE 200,053,103638,Zhang; Xinyu,9999,0,9999,0
1668164510640,ECE 200,054,103639,Turakhia; Yatish Girish,9999,0,9999,0
1668164510640,ECE 200,055,103640,Kang; Mingu,9999,0,9999,0
1668164510640,ECE 200,056,103641,Shi; Yuanyuan,9999,0,9999,0
1668164510640,ECE 200,057,103642,Wang; Edward Jay,9999,0,9999,0
1668164510640,ECE 200,058,103643,Zheng; Yang,9999,0,9999,0
1668164511065,ECE 202,A00,103644,Kuzum; Duygu,0,0,0,0
1668164511487,ECE 212BN,A00,103646,Ng; Tse Nga,0,0,0,0
1668164511910,ECE 221,A00,111493,Staff,0,0,0,0
1668164512334,ECE 222B,A00,103647,Lomakin; Vitaliy,0,0,0,0
1668164512757,ECE 230B,A00,103648,Taur; Yuan,0,0,0,0
1668164513183,ECE 238B,A00,103649,Garay; Javier,0,0,0,0
1668164513608,ECE 240B,A00,112900,Fainman; Yeshaiahu,0,0,0,0
1668164514041,ECE 247A,A00,103650,Jokerst; Jesse Vincent,0,0,0,0
1668164514465,ECE 247B,A00,103651,Wang; Joseph,0,0,0,0
1668164514889,ECE 250,A00,103652,Siegel; Paul H.,0,0,0,0
1668164515314,ECE 251A,A00,103654,Rao; Bhaskar D.,0,0,0,0
1668164515737,ECE 257B,A00,103655,Bharadia; Dinesh,0,0,0,0
1668164516163,ECE 258A,A00,103656,Milstein; Laurence B.,0,0,0,0
1668164516587,ECE 260B,A00,103658,Kang; Mingu,0,0,0,0
1668164517012,ECE 264A,A00,103659,Galton; Ian A,0,0,0,0
1668164517436,ECE 265A,A00,103661,Gudem; Prasad S.S.,0,0,0,0
1668164517859,ECE 265D,A00,103662,Gudem; Prasad S.S.,0,0,0,0
1668164518291,ECE 268,A00,103663,Koushanfar; Farinaz,0,0,0,0
1668164518715,ECE 269,A01,103665,Pal; Piya,0,0,0,0
1668164519139,ECE 271B,A00,103666,Vasconcelos; Manuela,0,0,0,0
1668164519567,ECE 276A,A00,103667,Atanasov; Nikolay A.,0,0,0,0
1668164519994,ECE 277,A00,103668,An; Cheolhong,0,0,0,0
1668164520420,ECE 279,A00,117947,Hall; Drew A.,0,0,0,0
1668164521268,ECE 283,A00,103670,Hsueh; Tzu-Chien,0,0,0,0
1668164521703,ECE 284,A00,103671,Turakhia; Yatish Girish,0,0,0,0
1668164522127,ECE 285,A00,103672,Zheng; Yang,0,0,0,0
1668164522127,ECE 285,B00,103673,Sworder; David D.,0,0,0,0
1668164522550,ECE 287,A00,103676,Javidi; Tara,0,0,0,0
1668164522975,MATH 200B,A00,098023,Salehi Golsefidy; Alireza,12,0,15,3
1668164523401,MATH 202B,A00,098024,Rhoades; Brendon Patrick,9,0,15,6
1668164523824,MATH 203B,A00,098025,Oprea; Dragos N.,10,0,15,5
1668164524247,MATH 204B,A00,098026,Sorensen; Claus M,13,0,15,2
1668164524671,MATH 208,A00,098027,Izadi; Elham,7,0,10,3
1668164525095,MATH 209,A00,098028,Pollack; Aaron,10,0,10,0
1668164525521,MATH 211A,A00,112919,Rogalski; Daniel,9,0,10,1
1668164525943,MATH 211B,A00,112920,Seward; Brandon M.,9,0,10,1
1668164526367,MATH 218,A00,098029,Li; Bo,10,0,10,0
1668164526791,MATH 220B,A00,098030,Novak; Jonathan I,11,0,15,4
1668164527214,MATH 221A,A00,098031,Ebenfelt; Peter F,13,0,15,2
1668164527643,MATH 231B,A00,098032,Zlatos; Andrej,12,0,15,3
1668164528068,MATH 240B,A00,098033,Ni; Lei,9,0,15,6
1668164528490,MATH 243,A00,098034,Jekel; David Andrew,10,0,10,0
1668164528919,MATH 245A,A00,098035,Nie; Jiawang,0,0,15,16
1668164529341,MATH 248,A00,098036,Bejenaru; Ioan,10,0,10,0
1668164529763,MATH 250B,A00,098037,Spolaor; Luca,14,0,15,1
1668164530186,MATH 258,A00,098038,Ni; Lei,10,0,10,0
1668164530614,MATH 264B,A00,098041,Rhoades; Brendon Patrick,9,0,15,6
1668164531036,MATH 268,A00,098042,Buss; Samuel R,10,0,10,0
1668164531464,MATH 269,A00,098043,Rhoades; Brendon Patrick,10,0,10,0
1668164531889,MATH 270B,A00,098044,Li; Bo,10,0,15,5
1668164532312,MATH 272B,A00,098045,Holst; Michael J,13,0,15,2
1668164532744,MATH 273A,A00,098046,Tian; Xiaochuan,10,0,15,5
1668164533167,MATH 275,A01,098048,Tian; Xiaochuan,6,0,10,4
1668164533591,MATH 278A,A00,098049,Holst; Michael J,8,0,10,2
1668164534015,MATH 278B,A00,098050,Cloninger; Alexander,10,0,10,0
1668164534440,MATH 278C,A00,098051,Nie; Jiawang,7,0,10,3
1668164534869,MATH 280B,A00,098052,Zheng; Tianyi,10,0,15,5
1668164535293,MATH 281B,A00,098053,Bradic; Jelena,2,0,15,13
1668164535720,MATH 282B,A00,098054,Arias-Castro; Ery,0,0,15,15
1668164536149,MATH 285,A00,098055,Fitzsimmons; Patrick J,0,0,15,17
1668164536573,MATH 287B,A00,098056,Arias-Castro; Ery,2,0,15,13
1668164536998,MATH 288,A00,098057,Agarwal; Pooja,9,0,10,1
1668164536998,MATH 288,B00,098058,Zhang; Danna,8,0,10,2
1668164536998,MATH 288,C00,098059,Williams; Ruth J,10,0,10,0
1668164537421,MATH 290B,A00,098060,Roberts; Justin Deritter,13,0,15,2
1668164537844,MATH 292,A00,098061,Belmont; Eva Kinoshita,10,0,10,0
1668164538279,MATH 295,A00,098062,Suk; Andrew Hoon,48,0,50,2
1668164538703,MATH 296,A00,098063,Novak; Jonathan I,20,0,20,0
1668164539128,MATH 297,001,098064,Gamst; Anthony Collins,9997,0,9999,2
1668165038048,COGS 205,A00,101395,Chiba; Andrea,19,0,20,1
1668165038473,COGS 210B,001,101404,Greene; Deanna Jacquelyn,9998,0,9999,1
1668165038473,COGS 210B,002,101417,Xia; Haijun,9999,0,9999,0
1668165038473,COGS 210B,003,101422,Nitz; Douglas A.,9999,0,9999,0
1668165038473,COGS 210B,004,101423,Hollan; James D.,9998,0,9999,1
1668165038473,COGS 210B,005,101424,Deak; Gedeon O.,9998,0,9999,1
1668165038473,COGS 210B,006,101425,Rossano; Federico,9999,0,9999,0
1668165038899,COGS 211B,A00,101427,Coulson; Seana M,9996,0,9999,3
1668165039322,COGS 220,A00,101428,Hollan; James D.,0,0,25,25
1668165039748,COGS 229,A00,101429,Dow; Steven P,18,0,25,7
1668165040179,COGS 230,A00,101430,Klemmer; Scott R,12,0,17,5
1668165040605,COGS 234,A00,101431,Xia; Haijun,3,0,25,22
1668165041036,COGS 260,A00,101432,Kiyonaga; Anastasia,20,0,25,5
1668165041036,COGS 260,B00,101433,Kirsh; David Joel,16,0,25,9
1668165041461,CSE 202,A00,102371,Impagliazzo; Russell,0,0,0,0
1668165041887,CSE 203B,A01,102373,Cheng; Chung Kuan,0,0,0,0
1668165042313,CSE 208,A00,102374,Micciancio; Daniele,0,0,0,0
1668165042736,CSE 209A,A00,112895,Impagliazzo; Russell,0,0,15,15
1668165043159,CSE 209B,A00,108005,Bellare; Mihir,0,0,0,0
1668165043583,CSE 210,A00,113163,Coblenz; Michael J,0,0,0,0
1668165044008,CSE 219,A00,106111,Dow; Steven P,0,0,20,20
1668165044434,CSE 221,A00,102376,Voelker; Geoffrey M.,0,0,0,0
1668165044860,CSE 224,A01,102378,Porter; George M,0,0,0,0
1668165045286,CSE 229A,A00,102379,Savage; Stefan,0,0,0,0
1668165045708,CSE 229C,A00,102380,Munyaka; Imani N. S.,0,0,0,0
1668165046134,CSE 232B,A00,102382,Deutsch; Alin Bernard,0,0,0,0
1668165046557,CSE 234,A01,112904,Kumar; Arun Kumar,0,0,0,0
1668165046989,CSE 237A,A00,102383,Rosing; Tajana Simunic,0,0,0,0
1668165047412,CSE 239A,A00,102384,Deutsch; Alin Bernard,0,0,0,0
1668165047835,CSE 239B,A00,102385,Polikarpova; Nadezhda,0,0,0,0
1668165048259,CSE 240A,A00,102386,Pannuto; Patrick William,0,0,0,0
1668165048684,CSE 240B,A00,102387,Zhao; Jishen,0,0,0,0
1668165049108,CSE 241A,A00,106406,Kang; Mingu,0,0,0,0
1668165049532,CSE 249B,A00,102388,Kahng; Andrew Byun,0,0,8,8
1668165049960,CSE 251B,A01,102392,Cottrell; Garrison W,0,0,0,0
1668165049960,CSE 251B,A02,102393,Cottrell; Garrison W,0,0,0,0
1668165050383,CSE 252B,A00,102394,Ochoa; Benjamin Lawrence,0,0,0,0
1668165050819,CSE 257,A01,102396,Gao; Sicun,0,0,0,0
1668165051245,CSE 272,A00,102397,Li; Tzumao,0,0,0,0
1668165051670,CSE 274,A00,111323,Chern; Albert Ren-Haur,0,0,0,0
1668165052094,CSE 282,A00,102398,Pevzner; Pavel Arkadjevich,0,0,0,0
1668165052524,CSE 284,A00,114175,Gymrek; Melissa Ann,0,0,0,0
1668165052947,CSE 290,A00,102399,Chandraker; Manmohan Krishna,0,0,0,0
1668165052947,CSE 290,B00,102400,Vaccaro; Kristen Marie,0,0,25,25
1668165052947,CSE 290,C00,102414,Pannuto; Patrick William,0,0,25,25
1668165052947,CSE 290,D00,102427,Pevzner; Pavel Arkadjevich,0,0,0,0
1668165052947,CSE 290,E00,102429,Zhao; Jishen,0,0,0,0
1668165052947,CSE 290,F00,102436,Tullsen; Dean Michael,0,0,0,0
1668165052947,CSE 290,G00,102440,Christensen; Henrik I,0,0,20,20
1668165053371,CSE 291,A00,102443,Su; Hao,0,0,0,0
1668165053371,CSE 291,B00,102448,Polikarpova; Nadezhda,0,0,0,0
1668165053371,CSE 291,C00,102453,Vaccaro; Kristen Marie,0,0,0,0
1668165053371,CSE 291,D00,111343,Savage; Stefan,0,0,0,0
1668165053371,CSE 291,E00,116474,Claffy; Kimberly Claire,0,0,0,0
1668165053371,CSE 291,F00,116479,Pasquale; Joseph,0,0,0,0
1668165053799,CSE 293,001,119111,Bafna; Vineet,9999,0,9999,0
1668165053799,CSE 293,002,119118,Bellare; Mihir,9999,0,9999,0
1668165053799,CSE 293,003,119122,Berg-Kirkpatrick; Taylor D,9999,0,9999,0
1668165053799,CSE 293,004,119135,Christensen; Henrik I,9999,0,9999,0
1668165053799,CSE 293,005,119142,Cottrell; Garrison W,9999,0,9999,0
1668165053799,CSE 293,006,119146,Deutsch; Alin Bernard,9999,0,9999,0
1668165053799,CSE 293,007,119159,Esmaeilzadeh; Hadi,9999,0,9999,0
1668165053799,CSE 293,008,119166,Freund; Yoav,9999,0,9999,0
1668165053799,CSE 293,009,119170,Griswold; William G.,9999,0,9999,0
1668165053799,CSE 293,010,119183,Gymrek; Melissa Ann,9999,0,9999,0
1668165053799,CSE 293,011,119190,Heninger; Nadia A,9999,0,9999,0
1668165053799,CSE 293,012,119230,Impagliazzo; Russell,9999,0,9999,0
1668165053799,CSE 293,013,119232,Jhala; Ranjit,9999,0,9999,0
1668165053799,CSE 293,014,119233,Kahng; Andrew Byun,9999,0,9999,0
1668165053799,CSE 293,015,119298,Kane; Daniel Mertz,9999,0,9999,0
1668165053799,CSE 293,016,119299,Kriegman; David J,9999,0,9999,0
1668165053799,CSE 293,017,119300,Kumar; Arun Kumar,9999,0,9999,0
1668165053799,CSE 293,018,119301,Lerner; Sorin,9999,0,9999,0
1668165053799,CSE 293,019,119302,Lovett; Shachar,9999,0,9999,0
1668165053799,CSE 293,020,119303,McAuley; Julian John,9999,0,9999,0
1668165053799,CSE 293,021,119304,Micciancio; Daniele,9999,0,9999,0
1668165053799,CSE 293,022,119367,Orailoglu; Alex,9999,0,9999,0
1668165053799,CSE 293,023,119382,Paturi; Ramamohan,9999,0,9999,0
1668165053799,CSE 293,024,119404,Polikarpova; Nadezhda,9999,0,9999,0
1668165053799,CSE 293,025,119406,Politz; Joseph Gibbs,9999,0,9999,0
1668165053799,CSE 293,026,119411,Porter; George M,9999,0,9999,0
1668165053799,CSE 293,027,119414,Porter; Leonard Emerson,9999,0,9999,0
1668165053799,CSE 293,028,119416,Ramamoorthi; Ravi,9999,0,9999,0
1668165053799,CSE 293,029,119417,Sahoo; Debashis,9999,0,9999,0
1668165053799,CSE 293,030,119420,Saul; Lawrence,9999,0,9999,0
1668165053799,CSE 293,031,119421,Savage; Stefan,9999,0,9999,0
1668165053799,CSE 293,032,119425,Schulze; Jurgen P.,9999,0,9999,0
1668165053799,CSE 293,033,119426,Snoeren; Alex C.,9999,0,9999,0
1668165053799,CSE 293,034,119428,Shang; Jingbo,9999,0,9999,0
1668165053799,CSE 293,035,119430,Stefan; Deian,9999,0,9999,0
1668165053799,CSE 293,036,119431,Su; Hao,9999,0,9999,0
1668165053799,CSE 293,037,119433,Swanson; Steven James,9999,0,9999,0
1668165053799,CSE 293,038,119435,Tullsen; Dean Michael,9999,0,9999,0
1668165053799,CSE 293,039,119483,Voelker; Geoffrey M.,9999,0,9999,0
1668165053799,CSE 293,040,119537,Zhao; Jishen,9999,0,9999,0
1668165053799,CSE 293,041,119538,Zhou; Yuan-Yuan,9999,0,9999,0
1668165053799,CSE 293,042,119539,Gao; Sicun,9999,0,9999,0
1668165053799,CSE 293,043,119540,Weibel; Nadir,9999,0,9999,0
1668165053799,CSE 293,044,119541,Gupta; Rajesh K.,9999,0,9999,0
1668165053799,CSE 293,045,126410,Vaccaro; Kristen Marie,9999,0,9999,0
1668165053799,CSE 293,046,126411,Klemke; Richard,9999,0,9999,0
1668165054226,CSE 294,A00,102459,Voelker; Geoffrey M.,0,0,0,0
1668165054226,CSE 294,B00,111322,Orailoglu; Alex,0,0,0,0
1668165054651,DSE 201,A00,096914,Deutsch; Alin Bernard,30,0,30,0
1668165055076,DSE 210,A00,096915,Dasgupta; Sanjoy,30,0,30,0
1668165055503,DSE 260A,A00,096916,Altintas De Callaf; Ilkay,30,0,30,0
1668165055940,ECE 200,001,103586,Antipa; Nicholas A,9999,0,9999,0
1668165055940,ECE 200,002,103587,Atanasov; Nikolay A.,9999,0,9999,0
1668165055940,ECE 200,003,103588,Bharadia; Dinesh,9999,0,9999,0
1668165055940,ECE 200,004,103589,Cheng; Chung Kuan,9999,0,9999,0
1668165055940,ECE 200,005,103590,Cosman; Pamela C.,9999,0,9999,0
1668165055940,ECE 200,006,103591,Dayeh; Shadi Ahmad,9999,0,9999,0
1668165055940,ECE 200,007,103592,Fainman; Yeshaiahu,9999,0,9999,0
1668165055940,ECE 200,008,103593,Ford; Joseph Earl,9999,0,9999,0
1668165055940,ECE 200,009,103594,Franceschetti; Massimo,9999,0,9999,0
1668165055940,ECE 200,010,103595,Fullerton; Eric E,9999,0,9999,0
1668165055940,ECE 200,011,103596,Galton; Ian A,9999,0,9999,0
1668165055940,ECE 200,012,103597,Gilja; Vikash,9999,0,9999,0
1668165055940,ECE 200,013,103598,Hall; Drew A.,9999,0,9999,0
1668165055940,ECE 200,014,103599,Hsueh; Tzu-Chien,9999,0,9999,0
1668165055940,ECE 200,015,103600,Javidi; Tara,9999,0,9999,0
1668165055940,ECE 200,016,103601,Kahng; Andrew Byun,9999,0,9999,0
1668165055940,ECE 200,017,103602,Kim; Young-Han,9999,0,9999,0
1668165055940,ECE 200,018,103603,Koushanfar; Farinaz,9999,0,9999,0
1668165055940,ECE 200,019,103604,Kuzum; Duygu,9999,0,9999,0
1668165055940,ECE 200,020,103605,Le; Hanh-Phuc,9999,0,9999,0
1668165055940,ECE 200,021,103606,Lin; Bill,9999,0,9999,0
1668165055940,ECE 200,022,103607,Liu; Zhaowei,9998,0,9999,1
1668165055940,ECE 200,023,103608,Lo; Yu-Hwa,9999,0,9999,0
1668165055940,ECE 200,024,103609,Lomakin; Vitaliy,9999,0,9999,0
1668165055940,ECE 200,025,103610,Mercier; Patrick Philip,9999,0,9999,0
1668165055940,ECE 200,026,103611,Meyer; Florian,9999,0,9999,0
1668165055940,ECE 200,027,103612,Milstein; Laurence B.,9999,0,9999,0
1668165055940,ECE 200,028,103613,Mir Arabbaygi; Siavash,9999,0,9999,0
1668165055940,ECE 200,029,103614,Mookherjea; Shayan,9999,0,9999,0
1668165055940,ECE 200,030,103615,Morris; Karcher William,9999,0,9999,0
1668165055940,ECE 200,031,103616,Ng; Tse Nga,9999,0,9999,0
1668165055940,ECE 200,032,103617,Nguyen; Truong Quang,9999,0,9999,0
1668165055940,ECE 200,033,103618,Nomura; Kenji,9999,0,9999,0
1668165055940,ECE 200,034,103619,Orlitsky; Alon,9999,0,9999,0
1668165055940,ECE 200,035,103620,Pal; Piya,9999,0,9999,0
1668165055940,ECE 200,036,103621,Papen; George C.,9999,0,9999,0
1668165055940,ECE 200,037,103622,Radic; Stojan,9999,0,9999,0
1668165055940,ECE 200,038,103623,Rao; Bhaskar D.,9999,0,9999,0
1668165055940,ECE 200,039,103624,Rao; Ramesh R,9999,0,9999,0
1668165055940,ECE 200,040,103625,Rebeiz; Gabriel,9999,0,9999,0
1668165055940,ECE 200,041,103626,Sanford; John R,9999,0,9999,0
1668165055940,ECE 200,042,103627,Siegel; Paul H.,9999,0,9999,0
1668165055940,ECE 200,043,103628,Sievenpiper; Daniel F.,9999,0,9999,0
1668165055940,ECE 200,044,103629,Sworder; David D.,9999,0,9999,0
1668165055940,ECE 200,045,103630,Taur; Yuan,9999,0,9999,0
1668165055940,ECE 200,046,103631,Touri; Behrouz,9999,0,9999,0
1668165055940,ECE 200,047,103632,Trivedi; Mohan M.,9999,0,9999,0
1668165055940,ECE 200,048,103633,Vasconcelos; Nuno,9999,0,9999,0
1668165055940,ECE 200,049,103634,Wang; Xiaolong,9999,0,9999,0
1668165055940,ECE 200,050,103635,Xie; Pengtao,9999,0,9999,0
1668165055940,ECE 200,051,103636,Yip; Michael,9999,0,9999,0
1668165055940,ECE 200,052,103637,Zeger; Kenneth A.,999,0,999,0
1668165055940,ECE 200,053,103638,Zhang; Xinyu,9999,0,9999,0
1668165055940,ECE 200,054,103639,Turakhia; Yatish Girish,9999,0,9999,0
1668165055940,ECE 200,055,103640,Kang; Mingu,9999,0,9999,0
1668165055940,ECE 200,056,103641,Shi; Yuanyuan,9999,0,9999,0
1668165055940,ECE 200,057,103642,Wang; Edward Jay,9999,0,9999,0
1668165055940,ECE 200,058,103643,Zheng; Yang,9999,0,9999,0
1668165056367,ECE 202,A00,103644,Kuzum; Duygu,0,0,0,0
1668165056790,ECE 212BN,A00,103646,Ng; Tse Nga,0,0,0,0
1668165057215,ECE 221,A00,111493,Staff,0,0,0,0
1668165057639,ECE 222B,A00,103647,Lomakin; Vitaliy,0,0,0,0
1668165058063,ECE 230B,A00,103648,Taur; Yuan,0,0,0,0
1668165058489,ECE 238B,A00,103649,Garay; Javier,0,0,0,0
1668165058912,ECE 240B,A00,112900,Fainman; Yeshaiahu,0,0,0,0
1668165059339,ECE 247A,A00,103650,Jokerst; Jesse Vincent,0,0,0,0
1668165059763,ECE 247B,A00,103651,Wang; Joseph,0,0,0,0
1668165060187,ECE 250,A00,103652,Siegel; Paul H.,0,0,0,0
1668165060613,ECE 251A,A00,103654,Rao; Bhaskar D.,0,0,0,0
1668165061035,ECE 257B,A00,103655,Bharadia; Dinesh,0,0,0,0
1668165061459,ECE 258A,A00,103656,Milstein; Laurence B.,0,0,0,0
1668165061885,ECE 260B,A00,103658,Kang; Mingu,0,0,0,0
1668165062310,ECE 264A,A00,103659,Galton; Ian A,0,0,0,0
1668165062735,ECE 265A,A00,103661,Gudem; Prasad S.S.,0,0,0,0
1668165063159,ECE 265D,A00,103662,Gudem; Prasad S.S.,0,0,0,0
1668165063655,ECE 268,A00,103663,Koushanfar; Farinaz,0,0,0,0
1668165064083,ECE 269,A01,103665,Pal; Piya,0,0,0,0
1668165064527,ECE 271B,A00,103666,Vasconcelos; Manuela,0,0,0,0
1668165064951,ECE 276A,A00,103667,Atanasov; Nikolay A.,0,0,0,0
1668165065376,ECE 277,A00,103668,An; Cheolhong,0,0,0,0
1668165065800,ECE 279,A00,117947,Hall; Drew A.,0,0,0,0
1668165066650,ECE 283,A00,103670,Hsueh; Tzu-Chien,0,0,0,0
1668165067075,ECE 284,A00,103671,Turakhia; Yatish Girish,0,0,0,0
1668165067497,ECE 285,A00,103672,Zheng; Yang,0,0,0,0
1668165067497,ECE 285,B00,103673,Sworder; David D.,0,0,0,0
1668165067921,ECE 287,A00,103676,Javidi; Tara,0,0,0,0
1668165068348,MATH 200B,A00,098023,Salehi Golsefidy; Alireza,12,0,15,3
1668165068777,MATH 202B,A00,098024,Rhoades; Brendon Patrick,9,0,15,6
1668165069200,MATH 203B,A00,098025,Oprea; Dragos N.,10,0,15,5
1668165069626,MATH 204B,A00,098026,Sorensen; Claus M,13,0,15,2
1668165070049,MATH 208,A00,098027,Izadi; Elham,7,0,10,3
1668165070474,MATH 209,A00,098028,Pollack; Aaron,10,0,10,0
1668165070899,MATH 211A,A00,112919,Rogalski; Daniel,9,0,10,1
1668165071324,MATH 211B,A00,112920,Seward; Brandon M.,9,0,10,1
1668165071751,MATH 218,A00,098029,Li; Bo,10,0,10,0
1668165072174,MATH 220B,A00,098030,Novak; Jonathan I,11,0,15,4
1668165072598,MATH 221A,A00,098031,Ebenfelt; Peter F,13,0,15,2
1668165073025,MATH 231B,A00,098032,Zlatos; Andrej,12,0,15,3
1668165073459,MATH 240B,A00,098033,Ni; Lei,9,0,15,6
1668165073886,MATH 243,A00,098034,Jekel; David Andrew,10,0,10,0
1668165074309,MATH 245A,A00,098035,Nie; Jiawang,0,0,15,16
1668165074745,MATH 248,A00,098036,Bejenaru; Ioan,10,0,10,0
1668165075171,MATH 250B,A00,098037,Spolaor; Luca,14,0,15,1
1668165075594,MATH 258,A00,098038,Ni; Lei,10,0,10,0
1668165076022,MATH 264B,A00,098041,Rhoades; Brendon Patrick,9,0,15,6
1668165076445,MATH 268,A00,098042,Buss; Samuel R,10,0,10,0
1668165076871,MATH 269,A00,098043,Rhoades; Brendon Patrick,10,0,10,0
1668165077294,MATH 270B,A00,098044,Li; Bo,10,0,15,5
1668165077719,MATH 272B,A00,098045,Holst; Michael J,13,0,15,2
1668165078142,MATH 273A,A00,098046,Tian; Xiaochuan,10,0,15,5
1668165078568,MATH 275,A01,098048,Tian; Xiaochuan,6,0,10,4
1668165078990,MATH 278A,A00,098049,Holst; Michael J,8,0,10,2
1668165079414,MATH 278B,A00,098050,Cloninger; Alexander,10,0,10,0
1668165079838,MATH 278C,A00,098051,Nie; Jiawang,7,0,10,3
1668165080262,MATH 280B,A00,098052,Zheng; Tianyi,10,0,15,5
1668165080685,MATH 281B,A00,098053,Bradic; Jelena,2,0,15,13
1668165081111,MATH 282B,A00,098054,Arias-Castro; Ery,0,0,15,15
1668165081533,MATH 285,A00,098055,Fitzsimmons; Patrick J,0,0,15,17
1668165081958,MATH 287B,A00,098056,Arias-Castro; Ery,2,0,15,13
1668165082383,MATH 288,A00,098057,Agarwal; Pooja,9,0,10,1
1668165082383,MATH 288,B00,098058,Zhang; Danna,8,0,10,2
1668165082383,MATH 288,C00,098059,Williams; Ruth J,10,0,10,0
1668165082804,MATH 290B,A00,098060,Roberts; Justin Deritter,13,0,15,2
1668165083231,MATH 292,A00,098061,Belmont; Eva Kinoshita,10,0,10,0
1668165083657,MATH 295,A00,098062,Suk; Andrew Hoon,48,0,50,2
1668165084084,MATH 296,A00,098063,Novak; Jonathan I,20,0,20,0
1668165084510,MATH 297,001,098064,Gamst; Anthony Collins,9997,0,9999,2
1668165583024,COGS 205,A00,101395,Chiba; Andrea,19,0,20,1
1668165583450,COGS 210B,001,101404,Greene; Deanna Jacquelyn,9998,0,9999,1
1668165583450,COGS 210B,002,101417,Xia; Haijun,9999,0,9999,0
1668165583450,COGS 210B,003,101422,Nitz; Douglas A.,9999,0,9999,0
1668165583450,COGS 210B,004,101423,Hollan; James D.,9998,0,9999,1
1668165583450,COGS 210B,005,101424,Deak; Gedeon O.,9998,0,9999,1
1668165583450,COGS 210B,006,101425,Rossano; Federico,9999,0,9999,0
1668165583877,COGS 211B,A00,101427,Coulson; Seana M,9996,0,9999,3
1668165584301,COGS 220,A00,101428,Hollan; James D.,0,0,25,25
1668165584728,COGS 229,A00,101429,Dow; Steven P,18,0,25,7
1668165585154,COGS 230,A00,101430,Klemmer; Scott R,12,0,17,5
1668165585577,COGS 234,A00,101431,Xia; Haijun,3,0,25,22
1668165586001,COGS 260,A00,101432,Kiyonaga; Anastasia,20,0,25,5
1668165586001,COGS 260,B00,101433,Kirsh; David Joel,16,0,25,9
1668165586429,CSE 202,A00,102371,Impagliazzo; Russell,0,0,0,0
1668165586851,CSE 203B,A01,102373,Cheng; Chung Kuan,0,0,0,0
1668165587283,CSE 208,A00,102374,Micciancio; Daniele,0,0,0,0
1668165587712,CSE 209A,A00,112895,Impagliazzo; Russell,0,0,15,15
1668165588142,CSE 209B,A00,108005,Bellare; Mihir,0,0,0,0
1668165588570,CSE 210,A00,113163,Coblenz; Michael J,0,0,0,0
1668165588993,CSE 219,A00,106111,Dow; Steven P,0,0,20,20
1668165589415,CSE 221,A00,102376,Voelker; Geoffrey M.,0,0,0,0
1668165589844,CSE 224,A01,102378,Porter; George M,0,0,0,0
1668165590269,CSE 229A,A00,102379,Savage; Stefan,0,0,0,0
1668165590694,CSE 229C,A00,102380,Munyaka; Imani N. S.,0,0,0,0
1668165591121,CSE 232B,A00,102382,Deutsch; Alin Bernard,0,0,0,0
1668165591546,CSE 234,A01,112904,Kumar; Arun Kumar,0,0,0,0
1668165591972,CSE 237A,A00,102383,Rosing; Tajana Simunic,0,0,0,0
1668165592395,CSE 239A,A00,102384,Deutsch; Alin Bernard,0,0,0,0
1668165592820,CSE 239B,A00,102385,Polikarpova; Nadezhda,0,0,0,0
1668165593249,CSE 240A,A00,102386,Pannuto; Patrick William,0,0,0,0
1668165593680,CSE 240B,A00,102387,Zhao; Jishen,0,0,0,0
1668165594107,CSE 241A,A00,106406,Kang; Mingu,0,0,0,0
1668165594533,CSE 249B,A00,102388,Kahng; Andrew Byun,0,0,8,8
1668165594957,CSE 251B,A01,102392,Cottrell; Garrison W,0,0,0,0
1668165594957,CSE 251B,A02,102393,Cottrell; Garrison W,0,0,0,0
1668165595380,CSE 252B,A00,102394,Ochoa; Benjamin Lawrence,0,0,0,0
1668165595807,CSE 257,A01,102396,Gao; Sicun,0,0,0,0
1668165596230,CSE 272,A00,102397,Li; Tzumao,0,0,0,0
1668165596657,CSE 274,A00,111323,Chern; Albert Ren-Haur,0,0,0,0
1668165597083,CSE 282,A00,102398,Pevzner; Pavel Arkadjevich,0,0,0,0
1668165597512,CSE 284,A00,114175,Gymrek; Melissa Ann,0,0,0,0
1668165597937,CSE 290,A00,102399,Chandraker; Manmohan Krishna,0,0,0,0
1668165597937,CSE 290,B00,102400,Vaccaro; Kristen Marie,0,0,25,25
1668165597937,CSE 290,C00,102414,Pannuto; Patrick William,0,0,25,25
1668165597937,CSE 290,D00,102427,Pevzner; Pavel Arkadjevich,0,0,0,0
1668165597937,CSE 290,E00,102429,Zhao; Jishen,0,0,0,0
1668165597937,CSE 290,F00,102436,Tullsen; Dean Michael,0,0,0,0
1668165597937,CSE 290,G00,102440,Christensen; Henrik I,0,0,20,20
1668165598363,CSE 291,A00,102443,Su; Hao,0,0,0,0
1668165598363,CSE 291,B00,102448,Polikarpova; Nadezhda,0,0,0,0
1668165598363,CSE 291,C00,102453,Vaccaro; Kristen Marie,0,0,0,0
1668165598363,CSE 291,D00,111343,Savage; Stefan,0,0,0,0
1668165598363,CSE 291,E00,116474,Claffy; Kimberly Claire,0,0,0,0
1668165598363,CSE 291,F00,116479,Pasquale; Joseph,0,0,0,0
1668165598789,CSE 293,001,119111,Bafna; Vineet,9999,0,9999,0
1668165598789,CSE 293,002,119118,Bellare; Mihir,9999,0,9999,0
1668165598789,CSE 293,003,119122,Berg-Kirkpatrick; Taylor D,9999,0,9999,0
1668165598789,CSE 293,004,119135,Christensen; Henrik I,9999,0,9999,0
1668165598789,CSE 293,005,119142,Cottrell; Garrison W,9999,0,9999,0
1668165598789,CSE 293,006,119146,Deutsch; Alin Bernard,9999,0,9999,0
1668165598789,CSE 293,007,119159,Esmaeilzadeh; Hadi,9999,0,9999,0
1668165598789,CSE 293,008,119166,Freund; Yoav,9999,0,9999,0
1668165598789,CSE 293,009,119170,Griswold; William G.,9999,0,9999,0
1668165598789,CSE 293,010,119183,Gymrek; Melissa Ann,9999,0,9999,0
1668165598789,CSE 293,011,119190,Heninger; Nadia A,9999,0,9999,0
1668165598789,CSE 293,012,119230,Impagliazzo; Russell,9999,0,9999,0
1668165598789,CSE 293,013,119232,Jhala; Ranjit,9999,0,9999,0
1668165598789,CSE 293,014,119233,Kahng; Andrew Byun,9999,0,9999,0
1668165598789,CSE 293,015,119298,Kane; Daniel Mertz,9999,0,9999,0
1668165598789,CSE 293,016,119299,Kriegman; David J,9999,0,9999,0
1668165598789,CSE 293,017,119300,Kumar; Arun Kumar,9999,0,9999,0
1668165598789,CSE 293,018,119301,Lerner; Sorin,9999,0,9999,0
1668165598789,CSE 293,019,119302,Lovett; Shachar,9999,0,9999,0
1668165598789,CSE 293,020,119303,McAuley; Julian John,9999,0,9999,0
1668165598789,CSE 293,021,119304,Micciancio; Daniele,9999,0,9999,0
1668165598789,CSE 293,022,119367,Orailoglu; Alex,9999,0,9999,0
1668165598789,CSE 293,023,119382,Paturi; Ramamohan,9999,0,9999,0
1668165598789,CSE 293,024,119404,Polikarpova; Nadezhda,9999,0,9999,0
1668165598789,CSE 293,025,119406,Politz; Joseph Gibbs,9999,0,9999,0
1668165598789,CSE 293,026,119411,Porter; George M,9999,0,9999,0
1668165598789,CSE 293,027,119414,Porter; Leonard Emerson,9999,0,9999,0
1668165598789,CSE 293,028,119416,Ramamoorthi; Ravi,9999,0,9999,0
1668165598789,CSE 293,029,119417,Sahoo; Debashis,9999,0,9999,0
1668165598789,CSE 293,030,119420,Saul; Lawrence,9999,0,9999,0
1668165598789,CSE 293,031,119421,Savage; Stefan,9999,0,9999,0
1668165598789,CSE 293,032,119425,Schulze; Jurgen P.,9999,0,9999,0
1668165598789,CSE 293,033,119426,Snoeren; Alex C.,9999,0,9999,0
1668165598789,CSE 293,034,119428,Shang; Jingbo,9999,0,9999,0
1668165598789,CSE 293,035,119430,Stefan; Deian,9999,0,9999,0
1668165598789,CSE 293,036,119431,Su; Hao,9999,0,9999,0
1668165598789,CSE 293,037,119433,Swanson; Steven James,9999,0,9999,0
1668165598789,CSE 293,038,119435,Tullsen; Dean Michael,9999,0,9999,0
1668165598789,CSE 293,039,119483,Voelker; Geoffrey M.,9999,0,9999,0
1668165598789,CSE 293,040,119537,Zhao; Jishen,9999,0,9999,0
1668165598789,CSE 293,041,119538,Zhou; Yuan-Yuan,9999,0,9999,0
1668165598789,CSE 293,042,119539,Gao; Sicun,9999,0,9999,0
1668165598789,CSE 293,043,119540,Weibel; Nadir,9999,0,9999,0
1668165598789,CSE 293,044,119541,Gupta; Rajesh K.,9999,0,9999,0
1668165598789,CSE 293,045,126410,Vaccaro; Kristen Marie,9999,0,9999,0
1668165598789,CSE 293,046,126411,Klemke; Richard,9999,0,9999,0
1668165599219,CSE 294,A00,102459,Voelker; Geoffrey M.,0,0,0,0
1668165599219,CSE 294,B00,111322,Orailoglu; Alex,0,0,0,0
1668165599644,DSE 201,A00,096914,Deutsch; Alin Bernard,30,0,30,0
1668165600069,DSE 210,A00,096915,Dasgupta; Sanjoy,30,0,30,0
1668165600499,DSE 260A,A00,096916,Altintas De Callaf; Ilkay,30,0,30,0
1668165600927,ECE 200,001,103586,Antipa; Nicholas A,9999,0,9999,0
1668165600927,ECE 200,002,103587,Atanasov; Nikolay A.,9999,0,9999,0
1668165600927,ECE 200,003,103588,Bharadia; Dinesh,9999,0,9999,0
1668165600927,ECE 200,004,103589,Cheng; Chung Kuan,9999,0,9999,0
1668165600927,ECE 200,005,103590,Cosman; Pamela C.,9999,0,9999,0
1668165600927,ECE 200,006,103591,Dayeh; Shadi Ahmad,9999,0,9999,0
1668165600927,ECE 200,007,103592,Fainman; Yeshaiahu,9999,0,9999,0
1668165600927,ECE 200,008,103593,Ford; Joseph Earl,9999,0,9999,0
1668165600927,ECE 200,009,103594,Franceschetti; Massimo,9999,0,9999,0
1668165600927,ECE 200,010,103595,Fullerton; Eric E,9999,0,9999,0
1668165600927,ECE 200,011,103596,Galton; Ian A,9999,0,9999,0
1668165600927,ECE 200,012,103597,Gilja; Vikash,9999,0,9999,0
1668165600927,ECE 200,013,103598,Hall; Drew A.,9999,0,9999,0
1668165600927,ECE 200,014,103599,Hsueh; Tzu-Chien,9999,0,9999,0
1668165600927,ECE 200,015,103600,Javidi; Tara,9999,0,9999,0
1668165600927,ECE 200,016,103601,Kahng; Andrew Byun,9999,0,9999,0
1668165600927,ECE 200,017,103602,Kim; Young-Han,9999,0,9999,0
1668165600927,ECE 200,018,103603,Koushanfar; Farinaz,9999,0,9999,0
1668165600927,ECE 200,019,103604,Kuzum; Duygu,9999,0,9999,0
1668165600927,ECE 200,020,103605,Le; Hanh-Phuc,9999,0,9999,0
1668165600927,ECE 200,021,103606,Lin; Bill,9999,0,9999,0
1668165600927,ECE 200,022,103607,Liu; Zhaowei,9998,0,9999,1
1668165600927,ECE 200,023,103608,Lo; Yu-Hwa,9999,0,9999,0
1668165600927,ECE 200,024,103609,Lomakin; Vitaliy,9999,0,9999,0
1668165600927,ECE 200,025,103610,Mercier; Patrick Philip,9999,0,9999,0
1668165600927,ECE 200,026,103611,Meyer; Florian,9999,0,9999,0
1668165600927,ECE 200,027,103612,Milstein; Laurence B.,9999,0,9999,0
1668165600927,ECE 200,028,103613,Mir Arabbaygi; Siavash,9999,0,9999,0
1668165600927,ECE 200,029,103614,Mookherjea; Shayan,9999,0,9999,0
1668165600927,ECE 200,030,103615,Morris; Karcher William,9999,0,9999,0
1668165600927,ECE 200,031,103616,Ng; Tse Nga,9999,0,9999,0
1668165600927,ECE 200,032,103617,Nguyen; Truong Quang,9999,0,9999,0
1668165600927,ECE 200,033,103618,Nomura; Kenji,9999,0,9999,0
1668165600927,ECE 200,034,103619,Orlitsky; Alon,9999,0,9999,0
1668165600927,ECE 200,035,103620,Pal; Piya,9999,0,9999,0
1668165600927,ECE 200,036,103621,Papen; George C.,9999,0,9999,0
1668165600927,ECE 200,037,103622,Radic; Stojan,9999,0,9999,0
1668165600927,ECE 200,038,103623,Rao; Bhaskar D.,9999,0,9999,0
1668165600927,ECE 200,039,103624,Rao; Ramesh R,9999,0,9999,0
1668165600927,ECE 200,040,103625,Rebeiz; Gabriel,9999,0,9999,0
1668165600927,ECE 200,041,103626,Sanford; John R,9999,0,9999,0
1668165600927,ECE 200,042,103627,Siegel; Paul H.,9999,0,9999,0
1668165600927,ECE 200,043,103628,Sievenpiper; Daniel F.,9999,0,9999,0
1668165600927,ECE 200,044,103629,Sworder; David D.,9999,0,9999,0
1668165600927,ECE 200,045,103630,Taur; Yuan,9999,0,9999,0
1668165600927,ECE 200,046,103631,Touri; Behrouz,9999,0,9999,0
1668165600927,ECE 200,047,103632,Trivedi; Mohan M.,9999,0,9999,0
1668165600927,ECE 200,048,103633,Vasconcelos; Nuno,9999,0,9999,0
1668165600927,ECE 200,049,103634,Wang; Xiaolong,9999,0,9999,0
1668165600927,ECE 200,050,103635,Xie; Pengtao,9999,0,9999,0
1668165600927,ECE 200,051,103636,Yip; Michael,9999,0,9999,0
1668165600927,ECE 200,052,103637,Zeger; Kenneth A.,999,0,999,0
1668165600927,ECE 200,053,103638,Zhang; Xinyu,9999,0,9999,0
1668165600927,ECE 200,054,103639,Turakhia; Yatish Girish,9999,0,9999,0
1668165600927,ECE 200,055,103640,Kang; Mingu,9999,0,9999,0
1668165600927,ECE 200,056,103641,Shi; Yuanyuan,9999,0,9999,0
1668165600927,ECE 200,057,103642,Wang; Edward Jay,9999,0,9999,0
1668165600927,ECE 200,058,103643,Zheng; Yang,9999,0,9999,0
1668165601352,ECE 202,A00,103644,Kuzum; Duygu,0,0,0,0
1668165601776,ECE 212BN,A00,103646,Ng; Tse Nga,0,0,0,0
1668165602201,ECE 221,A00,111493,Staff,0,0,0,0
1668165602624,ECE 222B,A00,103647,Lomakin; Vitaliy,0,0,0,0
1668165603051,ECE 230B,A00,103648,Taur; Yuan,0,0,0,0
1668165603474,ECE 238B,A00,103649,Garay; Javier,0,0,0,0
1668165603904,ECE 240B,A00,112900,Fainman; Yeshaiahu,0,0,0,0
1668165604334,ECE 247A,A00,103650,Jokerst; Jesse Vincent,0,0,0,0
1668165604758,ECE 247B,A00,103651,Wang; Joseph,0,0,0,0
1668165605182,ECE 250,A00,103652,Siegel; Paul H.,0,0,0,0
1668165605613,ECE 251A,A00,103654,Rao; Bhaskar D.,0,0,0,0
1668165606040,ECE 257B,A00,103655,Bharadia; Dinesh,0,0,0,0
1668165606465,ECE 258A,A00,103656,Milstein; Laurence B.,0,0,0,0
1668165606893,ECE 260B,A00,103658,Kang; Mingu,0,0,0,0
1668165607318,ECE 264A,A00,103659,Galton; Ian A,0,0,0,0
1668165607740,ECE 265A,A00,103661,Gudem; Prasad S.S.,0,0,0,0
1668165608168,ECE 265D,A00,103662,Gudem; Prasad S.S.,0,0,0,0
1668165608596,ECE 268,A00,103663,Koushanfar; Farinaz,0,0,0,0
1668165609022,ECE 269,A01,103665,Pal; Piya,0,0,0,0
1668165609448,ECE 271B,A00,103666,Vasconcelos; Manuela,0,0,0,0
1668165609876,ECE 276A,A00,103667,Atanasov; Nikolay A.,0,0,0,0
1668165610308,ECE 277,A00,103668,An; Cheolhong,0,0,0,0
1668165610734,ECE 279,A00,117947,Hall; Drew A.,0,0,0,0
1668165611584,ECE 283,A00,103670,Hsueh; Tzu-Chien,0,0,0,0
1668165612009,ECE 284,A00,103671,Turakhia; Yatish Girish,0,0,0,0
1668165612433,ECE 285,A00,103672,Zheng; Yang,0,0,0,0
1668165612433,ECE 285,B00,103673,Sworder; David D.,0,0,0,0
1668165612860,ECE 287,A00,103676,Javidi; Tara,0,0,0,0
1668165613287,MATH 200B,A00,098023,Salehi Golsefidy; Alireza,12,0,15,3
1668165613714,MATH 202B,A00,098024,Rhoades; Brendon Patrick,9,0,15,6
1668165614138,MATH 203B,A00,098025,Oprea; Dragos N.,10,0,15,5
1668165614565,MATH 204B,A00,098026,Sorensen; Claus M,13,0,15,2
1668165614996,MATH 208,A00,098027,Izadi; Elham,7,0,10,3
1668165615418,MATH 209,A00,098028,Pollack; Aaron,10,0,10,0
1668165615844,MATH 211A,A00,112919,Rogalski; Daniel,9,0,10,1
1668165616268,MATH 211B,A00,112920,Seward; Brandon M.,9,0,10,1
1668165616691,MATH 218,A00,098029,Li; Bo,10,0,10,0
1668165617116,MATH 220B,A00,098030,Novak; Jonathan I,11,0,15,4
1668165617544,MATH 221A,A00,098031,Ebenfelt; Peter F,13,0,15,2
1668165617969,MATH 231B,A00,098032,Zlatos; Andrej,12,0,15,3
1668165618393,MATH 240B,A00,098033,Ni; Lei,9,0,15,6
1668165618819,MATH 243,A00,098034,Jekel; David Andrew,10,0,10,0
1668165619242,MATH 245A,A00,098035,Nie; Jiawang,0,0,15,16
1668165619669,MATH 248,A00,098036,Bejenaru; Ioan,10,0,10,0
1668165620097,MATH 250B,A00,098037,Spolaor; Luca,14,0,15,1
1668165620520,MATH 258,A00,098038,Ni; Lei,10,0,10,0
1668165620961,MATH 264B,A00,098041,Rhoades; Brendon Patrick,9,0,15,6
1668165621394,MATH 268,A00,098042,Buss; Samuel R,10,0,10,0
1668165621818,MATH 269,A00,098043,Rhoades; Brendon Patrick,10,0,10,0
1668165622251,MATH 270B,A00,098044,Li; Bo,10,0,15,5
1668165622681,MATH 272B,A00,098045,Holst; Michael J,13,0,15,2
1668165623114,MATH 273A,A00,098046,Tian; Xiaochuan,10,0,15,5
1668165623540,MATH 275,A01,098048,Tian; Xiaochuan,6,0,10,4
1668165623963,MATH 278A,A00,098049,Holst; Michael J,8,0,10,2
1668165624387,MATH 278B,A00,098050,Cloninger; Alexander,10,0,10,0
1668165624811,MATH 278C,A00,098051,Nie; Jiawang,7,0,10,3
1668165625332,MATH 280B,A00,098052,Zheng; Tianyi,10,0,15,5
1668165625755,MATH 281B,A00,098053,Bradic; Jelena,2,0,15,13
1668165626178,MATH 282B,A00,098054,Arias-Castro; Ery,0,0,15,15
1668165626605,MATH 285,A00,098055,Fitzsimmons; Patrick J,0,0,15,17
1668165627029,MATH 287B,A00,098056,Arias-Castro; Ery,2,0,15,13
1668165627451,MATH 288,A00,098057,Agarwal; Pooja,9,0,10,1
1668165627451,MATH 288,B00,098058,Zhang; Danna,8,0,10,2
1668165627451,MATH 288,C00,098059,Williams; Ruth J,10,0,10,0
1668165627875,MATH 290B,A00,098060,Roberts; Justin Deritter,13,0,15,2
1668165628299,MATH 292,A00,098061,Belmont; Eva Kinoshita,10,0,10,0
1668165628726,MATH 295,A00,098062,Suk; Andrew Hoon,48,0,50,2
1668165629151,MATH 296,A00,098063,Novak; Jonathan I,20,0,20,0
1668165629584,MATH 297,001,098064,Gamst; Anthony Collins,9997,0,9999,2
1668166127934,COGS 205,A00,101395,Chiba; Andrea,19,0,20,1
1668166128357,COGS 210B,001,101404,Greene; Deanna Jacquelyn,9998,0,9999,1
1668166128357,COGS 210B,002,101417,Xia; Haijun,9999,0,9999,0
1668166128357,COGS 210B,003,101422,Nitz; Douglas A.,9999,0,9999,0
1668166128357,COGS 210B,004,101423,Hollan; James D.,9998,0,9999,1
1668166128357,COGS 210B,005,101424,Deak; Gedeon O.,9998,0,9999,1
1668166128357,COGS 210B,006,101425,Rossano; Federico,9999,0,9999,0
1668166128782,COGS 211B,A00,101427,Coulson; Seana M,9996,0,9999,3
1668166129206,COGS 220,A00,101428,Hollan; James D.,0,0,25,25
1668166129633,COGS 229,A00,101429,Dow; Steven P,18,0,25,7
1668166130056,COGS 230,A00,101430,Klemmer; Scott R,12,0,17,5
1668166130479,COGS 234,A00,101431,Xia; Haijun,3,0,25,22
1668166130902,COGS 260,A00,101432,Kiyonaga; Anastasia,20,0,25,5
1668166130902,COGS 260,B00,101433,Kirsh; David Joel,16,0,25,9
1668166131328,CSE 202,A00,102371,Impagliazzo; Russell,0,0,0,0
1668166131753,CSE 203B,A01,102373,Cheng; Chung Kuan,0,0,0,0
1668166132179,CSE 208,A00,102374,Micciancio; Daniele,0,0,0,0
1668166132603,CSE 209A,A00,112895,Impagliazzo; Russell,0,0,15,15
1668166133033,CSE 209B,A00,108005,Bellare; Mihir,0,0,0,0
1668166133458,CSE 210,A00,113163,Coblenz; Michael J,0,0,0,0
1668166133881,CSE 219,A00,106111,Dow; Steven P,0,0,20,20
1668166134305,CSE 221,A00,102376,Voelker; Geoffrey M.,0,0,0,0
1668166134731,CSE 224,A01,102378,Porter; George M,0,0,0,0
1668166135155,CSE 229A,A00,102379,Savage; Stefan,0,0,0,0
1668166135580,CSE 229C,A00,102380,Munyaka; Imani N. S.,0,0,0,0
1668166136005,CSE 232B,A00,102382,Deutsch; Alin Bernard,0,0,0,0
1668166136428,CSE 234,A01,112904,Kumar; Arun Kumar,0,0,0,0
1668166136850,CSE 237A,A00,102383,Rosing; Tajana Simunic,0,0,0,0
1668166137276,CSE 239A,A00,102384,Deutsch; Alin Bernard,0,0,0,0
1668166137700,CSE 239B,A00,102385,Polikarpova; Nadezhda,0,0,0,0
1668166138123,CSE 240A,A00,102386,Pannuto; Patrick William,0,0,0,0
1668166138546,CSE 240B,A00,102387,Zhao; Jishen,0,0,0,0
1668166138970,CSE 241A,A00,106406,Kang; Mingu,0,0,0,0
1668166139395,CSE 249B,A00,102388,Kahng; Andrew Byun,0,0,8,8
1668166139819,CSE 251B,A01,102392,Cottrell; Garrison W,0,0,0,0
1668166139819,CSE 251B,A02,102393,Cottrell; Garrison W,0,0,0,0
1668166140250,CSE 252B,A00,102394,Ochoa; Benjamin Lawrence,0,0,0,0
1668166140673,CSE 257,A01,102396,Gao; Sicun,0,0,0,0
1668166141095,CSE 272,A00,102397,Li; Tzumao,0,0,0,0
1668166141520,CSE 274,A00,111323,Chern; Albert Ren-Haur,0,0,0,0
1668166141946,CSE 282,A00,102398,Pevzner; Pavel Arkadjevich,0,0,0,0
1668166142371,CSE 284,A00,114175,Gymrek; Melissa Ann,0,0,0,0
1668166142795,CSE 290,A00,102399,Chandraker; Manmohan Krishna,0,0,0,0
1668166142795,CSE 290,B00,102400,Vaccaro; Kristen Marie,0,0,25,25
1668166142795,CSE 290,C00,102414,Pannuto; Patrick William,0,0,25,25
1668166142795,CSE 290,D00,102427,Pevzner; Pavel Arkadjevich,0,0,0,0
1668166142795,CSE 290,E00,102429,Zhao; Jishen,0,0,0,0
1668166142795,CSE 290,F00,102436,Tullsen; Dean Michael,0,0,0,0
1668166142795,CSE 290,G00,102440,Christensen; Henrik I,0,0,20,20
1668166143219,CSE 291,A00,102443,Su; Hao,0,0,0,0
1668166143219,CSE 291,B00,102448,Polikarpova; Nadezhda,0,0,0,0
1668166143219,CSE 291,C00,102453,Vaccaro; Kristen Marie,0,0,0,0
1668166143219,CSE 291,D00,111343,Savage; Stefan,0,0,0,0
1668166143219,CSE 291,E00,116474,Claffy; Kimberly Claire,0,0,0,0
1668166143219,CSE 291,F00,116479,Pasquale; Joseph,0,0,0,0
1668166143759,CSE 293,001,119111,Bafna; Vineet,9999,0,9999,0
1668166143759,CSE 293,002,119118,Bellare; Mihir,9999,0,9999,0
1668166143759,CSE 293,003,119122,Berg-Kirkpatrick; Taylor D,9999,0,9999,0
1668166143759,CSE 293,004,119135,Christensen; Henrik I,9999,0,9999,0
1668166143759,CSE 293,005,119142,Cottrell; Garrison W,9999,0,9999,0
1668166143759,CSE 293,006,119146,Deutsch; Alin Bernard,9999,0,9999,0
1668166143759,CSE 293,007,119159,Esmaeilzadeh; Hadi,9999,0,9999,0
1668166143759,CSE 293,008,119166,Freund; Yoav,9999,0,9999,0
1668166143759,CSE 293,009,119170,Griswold; William G.,9999,0,9999,0
1668166143759,CSE 293,010,119183,Gymrek; Melissa Ann,9999,0,9999,0
1668166143759,CSE 293,011,119190,Heninger; Nadia A,9999,0,9999,0
1668166143759,CSE 293,012,119230,Impagliazzo; Russell,9999,0,9999,0
1668166143759,CSE 293,013,119232,Jhala; Ranjit,9999,0,9999,0
1668166143759,CSE 293,014,119233,Kahng; Andrew Byun,9999,0,9999,0
1668166143759,CSE 293,015,119298,Kane; Daniel Mertz,9999,0,9999,0
1668166143759,CSE 293,016,119299,Kriegman; David J,9999,0,9999,0
1668166143759,CSE 293,017,119300,Kumar; Arun Kumar,9999,0,9999,0
1668166143759,CSE 293,018,119301,Lerner; Sorin,9999,0,9999,0
1668166143759,CSE 293,019,119302,Lovett; Shachar,9999,0,9999,0
1668166143759,CSE 293,020,119303,McAuley; Julian John,9999,0,9999,0
1668166143759,CSE 293,021,119304,Micciancio; Daniele,9999,0,9999,0
1668166143759,CSE 293,022,119367,Orailoglu; Alex,9999,0,9999,0
1668166143759,CSE 293,023,119382,Paturi; Ramamohan,9999,0,9999,0
1668166143759,CSE 293,024,119404,Polikarpova; Nadezhda,9999,0,9999,0
1668166143759,CSE 293,025,119406,Politz; Joseph Gibbs,9999,0,9999,0
1668166143759,CSE 293,026,119411,Porter; George M,9999,0,9999,0
1668166143759,CSE 293,027,119414,Porter; Leonard Emerson,9999,0,9999,0
1668166143759,CSE 293,028,119416,Ramamoorthi; Ravi,9999,0,9999,0
1668166143759,CSE 293,029,119417,Sahoo; Debashis,9999,0,9999,0
1668166143759,CSE 293,030,119420,Saul; Lawrence,9999,0,9999,0
1668166143759,CSE 293,031,119421,Savage; Stefan,9999,0,9999,0
1668166143759,CSE 293,032,119425,Schulze; Jurgen P.,9999,0,9999,0
1668166143759,CSE 293,033,119426,Snoeren; Alex C.,9999,0,9999,0
1668166143759,CSE 293,034,119428,Shang; Jingbo,9999,0,9999,0
1668166143759,CSE 293,035,119430,Stefan; Deian,9999,0,9999,0
1668166143759,CSE 293,036,119431,Su; Hao,9999,0,9999,0
1668166143759,CSE 293,037,119433,Swanson; Steven James,9999,0,9999,0
1668166143759,CSE 293,038,119435,Tullsen; Dean Michael,9999,0,9999,0
1668166143759,CSE 293,039,119483,Voelker; Geoffrey M.,9999,0,9999,0
1668166143759,CSE 293,040,119537,Zhao; Jishen,9999,0,9999,0
1668166143759,CSE 293,041,119538,Zhou; Yuan-Yuan,9999,0,9999,0
1668166143759,CSE 293,042,119539,Gao; Sicun,9999,0,9999,0
1668166143759,CSE 293,043,119540,Weibel; Nadir,9999,0,9999,0
1668166143759,CSE 293,044,119541,Gupta; Rajesh K.,9999,0,9999,0
1668166143759,CSE 293,045,126410,Vaccaro; Kristen Marie,9999,0,9999,0
1668166143759,CSE 293,046,126411,Klemke; Richard,9999,0,9999,0
1668166144182,CSE 294,A00,102459,Voelker; Geoffrey M.,0,0,0,0
1668166144182,CSE 294,B00,111322,Orailoglu; Alex,0,0,0,0
1668166144609,DSE 201,A00,096914,Deutsch; Alin Bernard,30,0,30,0
1668166145034,DSE 210,A00,096915,Dasgupta; Sanjoy,30,0,30,0
1668166145459,DSE 260A,A00,096916,Altintas De Callaf; Ilkay,30,0,30,0
1668166145895,ECE 200,001,103586,Antipa; Nicholas A,9999,0,9999,0
1668166145895,ECE 200,002,103587,Atanasov; Nikolay A.,9999,0,9999,0
1668166145895,ECE 200,003,103588,Bharadia; Dinesh,9999,0,9999,0
1668166145895,ECE 200,004,103589,Cheng; Chung Kuan,9999,0,9999,0
1668166145895,ECE 200,005,103590,Cosman; Pamela C.,9999,0,9999,0
1668166145895,ECE 200,006,103591,Dayeh; Shadi Ahmad,9999,0,9999,0
1668166145895,ECE 200,007,103592,Fainman; Yeshaiahu,9999,0,9999,0
1668166145895,ECE 200,008,103593,Ford; Joseph Earl,9999,0,9999,0
1668166145895,ECE 200,009,103594,Franceschetti; Massimo,9999,0,9999,0
1668166145895,ECE 200,010,103595,Fullerton; Eric E,9999,0,9999,0
1668166145895,ECE 200,011,103596,Galton; Ian A,9999,0,9999,0
1668166145895,ECE 200,012,103597,Gilja; Vikash,9999,0,9999,0
1668166145895,ECE 200,013,103598,Hall; Drew A.,9999,0,9999,0
1668166145895,ECE 200,014,103599,Hsueh; Tzu-Chien,9999,0,9999,0
1668166145895,ECE 200,015,103600,Javidi; Tara,9999,0,9999,0
1668166145895,ECE 200,016,103601,Kahng; Andrew Byun,9999,0,9999,0
1668166145895,ECE 200,017,103602,Kim; Young-Han,9999,0,9999,0
1668166145895,ECE 200,018,103603,Koushanfar; Farinaz,9999,0,9999,0
1668166145895,ECE 200,019,103604,Kuzum; Duygu,9999,0,9999,0
1668166145895,ECE 200,020,103605,Le; Hanh-Phuc,9999,0,9999,0
1668166145895,ECE 200,021,103606,Lin; Bill,9999,0,9999,0
1668166145895,ECE 200,022,103607,Liu; Zhaowei,9998,0,9999,1
1668166145895,ECE 200,023,103608,Lo; Yu-Hwa,9999,0,9999,0
1668166145895,ECE 200,024,103609,Lomakin; Vitaliy,9999,0,9999,0
1668166145895,ECE 200,025,103610,Mercier; Patrick Philip,9999,0,9999,0
1668166145895,ECE 200,026,103611,Meyer; Florian,9999,0,9999,0
1668166145895,ECE 200,027,103612,Milstein; Laurence B.,9999,0,9999,0
1668166145895,ECE 200,028,103613,Mir Arabbaygi; Siavash,9999,0,9999,0
1668166145895,ECE 200,029,103614,Mookherjea; Shayan,9999,0,9999,0
1668166145895,ECE 200,030,103615,Morris; Karcher William,9999,0,9999,0
1668166145895,ECE 200,031,103616,Ng; Tse Nga,9999,0,9999,0
1668166145895,ECE 200,032,103617,Nguyen; Truong Quang,9999,0,9999,0
1668166145895,ECE 200,033,103618,Nomura; Kenji,9999,0,9999,0
1668166145895,ECE 200,034,103619,Orlitsky; Alon,9999,0,9999,0
1668166145895,ECE 200,035,103620,Pal; Piya,9999,0,9999,0
1668166145895,ECE 200,036,103621,Papen; George C.,9999,0,9999,0
1668166145895,ECE 200,037,103622,Radic; Stojan,9999,0,9999,0
1668166145895,ECE 200,038,103623,Rao; Bhaskar D.,9999,0,9999,0
1668166145895,ECE 200,039,103624,Rao; Ramesh R,9999,0,9999,0
1668166145895,ECE 200,040,103625,Rebeiz; Gabriel,9999,0,9999,0
1668166145895,ECE 200,041,103626,Sanford; John R,9999,0,9999,0
1668166145895,ECE 200,042,103627,Siegel; Paul H.,9999,0,9999,0
1668166145895,ECE 200,043,103628,Sievenpiper; Daniel F.,9999,0,9999,0
1668166145895,ECE 200,044,103629,Sworder; David D.,9999,0,9999,0
1668166145895,ECE 200,045,103630,Taur; Yuan,9999,0,9999,0
1668166145895,ECE 200,046,103631,Touri; Behrouz,9999,0,9999,0
1668166145895,ECE 200,047,103632,Trivedi; Mohan M.,9999,0,9999,0
1668166145895,ECE 200,048,103633,Vasconcelos; Nuno,9999,0,9999,0
1668166145895,ECE 200,049,103634,Wang; Xiaolong,9999,0,9999,0
1668166145895,ECE 200,050,103635,Xie; Pengtao,9999,0,9999,0
1668166145895,ECE 200,051,103636,Yip; Michael,9999,0,9999,0
1668166145895,ECE 200,052,103637,Zeger; Kenneth A.,999,0,999,0
1668166145895,ECE 200,053,103638,Zhang; Xinyu,9999,0,9999,0
1668166145895,ECE 200,054,103639,Turakhia; Yatish Girish,9999,0,9999,0
1668166145895,ECE 200,055,103640,Kang; Mingu,9999,0,9999,0
1668166145895,ECE 200,056,103641,Shi; Yuanyuan,9999,0,9999,0
1668166145895,ECE 200,057,103642,Wang; Edward Jay,9999,0,9999,0
1668166145895,ECE 200,058,103643,Zheng; Yang,9999,0,9999,0
1668166146321,ECE 202,A00,103644,Kuzum; Duygu,0,0,0,0
1668166146746,ECE 212BN,A00,103646,Ng; Tse Nga,0,0,0,0
1668166147174,ECE 221,A00,111493,Staff,0,0,0,0
1668166147599,ECE 222B,A00,103647,Lomakin; Vitaliy,0,0,0,0
1668166148022,ECE 230B,A00,103648,Taur; Yuan,0,0,0,0
1668166148450,ECE 238B,A00,103649,Garay; Javier,0,0,0,0
1668166148875,ECE 240B,A00,112900,Fainman; Yeshaiahu,0,0,0,0
1668166149302,ECE 247A,A00,103650,Jokerst; Jesse Vincent,0,0,0,0
1668166149726,ECE 247B,A00,103651,Wang; Joseph,0,0,0,0
1668166150153,ECE 250,A00,103652,Siegel; Paul H.,0,0,0,0
1668166150580,ECE 251A,A00,103654,Rao; Bhaskar D.,0,0,0,0
1668166151009,ECE 257B,A00,103655,Bharadia; Dinesh,0,0,0,0
1668166151433,ECE 258A,A00,103656,Milstein; Laurence B.,0,0,0,0
1668166151858,ECE 260B,A00,103658,Kang; Mingu,0,0,0,0
1668166152281,ECE 264A,A00,103659,Galton; Ian A,0,0,0,0
1668166152707,ECE 265A,A00,103661,Gudem; Prasad S.S.,0,0,0,0
1668166153131,ECE 265D,A00,103662,Gudem; Prasad S.S.,0,0,0,0
1668166153558,ECE 268,A00,103663,Koushanfar; Farinaz,0,0,0,0
1668166153986,ECE 269,A01,103665,Pal; Piya,0,0,0,0
1668166154408,ECE 271B,A00,103666,Vasconcelos; Manuela,0,0,0,0
1668166154833,ECE 276A,A00,103667,Atanasov; Nikolay A.,0,0,0,0
1668166155257,ECE 277,A00,103668,An; Cheolhong,0,0,0,0
1668166155678,ECE 279,A00,117947,Hall; Drew A.,0,0,0,0
1668166156526,ECE 283,A00,103670,Hsueh; Tzu-Chien,0,0,0,0
1668166156949,ECE 284,A00,103671,Turakhia; Yatish Girish,0,0,0,0
1668166157378,ECE 285,A00,103672,Zheng; Yang,0,0,0,0
1668166157378,ECE 285,B00,103673,Sworder; David D.,0,0,0,0
1668166157805,ECE 287,A00,103676,Javidi; Tara,0,0,0,0
1668166158228,MATH 200B,A00,098023,Salehi Golsefidy; Alireza,12,0,15,3
1668166158653,MATH 202B,A00,098024,Rhoades; Brendon Patrick,9,0,15,6
1668166159079,MATH 203B,A00,098025,Oprea; Dragos N.,10,0,15,5
1668166159503,MATH 204B,A00,098026,Sorensen; Claus M,13,0,15,2
1668166159927,MATH 208,A00,098027,Izadi; Elham,7,0,10,3
1668166160352,MATH 209,A00,098028,Pollack; Aaron,10,0,10,0
1668166160783,MATH 211A,A00,112919,Rogalski; Daniel,9,0,10,1
1668166161209,MATH 211B,A00,112920,Seward; Brandon M.,9,0,10,1
1668166161634,MATH 218,A00,098029,Li; Bo,10,0,10,0
1668166162056,MATH 220B,A00,098030,Novak; Jonathan I,11,0,15,4
1668166162479,MATH 221A,A00,098031,Ebenfelt; Peter F,13,0,15,2
1668166162906,MATH 231B,A00,098032,Zlatos; Andrej,12,0,15,3
1668166163331,MATH 240B,A00,098033,Ni; Lei,9,0,15,6
1668166163755,MATH 243,A00,098034,Jekel; David Andrew,10,0,10,0
1668166164183,MATH 245A,A00,098035,Nie; Jiawang,0,0,15,16
1668166164606,MATH 248,A00,098036,Bejenaru; Ioan,10,0,10,0
1668166165029,MATH 250B,A00,098037,Spolaor; Luca,14,0,15,1
1668166165460,MATH 258,A00,098038,Ni; Lei,10,0,10,0
1668166165886,MATH 264B,A00,098041,Rhoades; Brendon Patrick,9,0,15,6
1668166166311,MATH 268,A00,098042,Buss; Samuel R,10,0,10,0
1668166166736,MATH 269,A00,098043,Rhoades; Brendon Patrick,10,0,10,0
1668166167162,MATH 270B,A00,098044,Li; Bo,10,0,15,5
1668166167586,MATH 272B,A00,098045,Holst; Michael J,13,0,15,2
1668166168011,MATH 273A,A00,098046,Tian; Xiaochuan,10,0,15,5
1668166168440,MATH 275,A01,098048,Tian; Xiaochuan,6,0,10,4
1668166168871,MATH 278A,A00,098049,Holst; Michael J,8,0,10,2
1668166169295,MATH 278B,A00,098050,Cloninger; Alexander,10,0,10,0
1668166169719,MATH 278C,A00,098051,Nie; Jiawang,7,0,10,3
1668166170144,MATH 280B,A00,098052,Zheng; Tianyi,10,0,15,5
1668166170567,MATH 281B,A00,098053,Bradic; Jelena,2,0,15,13
1668166170989,MATH 282B,A00,098054,Arias-Castro; Ery,0,0,15,15
1668166171416,MATH 285,A00,098055,Fitzsimmons; Patrick J,0,0,15,17
1668166171841,MATH 287B,A00,098056,Arias-Castro; Ery,2,0,15,13
1668166172266,MATH 288,A00,098057,Agarwal; Pooja,9,0,10,1
1668166172266,MATH 288,B00,098058,Zhang; Danna,8,0,10,2
1668166172266,MATH 288,C00,098059,Williams; Ruth J,10,0,10,0
1668166172688,MATH 290B,A00,098060,Roberts; Justin Deritter,13,0,15,2
1668166173112,MATH 292,A00,098061,Belmont; Eva Kinoshita,10,0,10,0
1668166173538,MATH 295,A00,098062,Suk; Andrew Hoon,48,0,50,2
1668166173961,MATH 296,A00,098063,Novak; Jonathan I,20,0,20,0
1668166174386,MATH 297,001,098064,Gamst; Anthony Collins,9997,0,9999,2
1668166673798,COGS 205,A00,101395,Chiba; Andrea,19,0,20,1
1668166674231,COGS 210B,001,101404,Greene; Deanna Jacquelyn,9998,0,9999,1
1668166674231,COGS 210B,002,101417,Xia; Haijun,9999,0,9999,0
1668166674231,COGS 210B,003,101422,Nitz; Douglas A.,9999,0,9999,0
1668166674231,COGS 210B,004,101423,Hollan; James D.,9998,0,9999,1
1668166674231,COGS 210B,005,101424,Deak; Gedeon O.,9998,0,9999,1
1668166674231,COGS 210B,006,101425,Rossano; Federico,9999,0,9999,0
1668166674657,COGS 211B,A00,101427,Coulson; Seana M,9996,0,9999,3
1668166675082,COGS 220,A00,101428,Hollan; James D.,0,0,25,25
1668166675507,COGS 229,A00,101429,Dow; Steven P,18,0,25,7
1668166675933,COGS 230,A00,101430,Klemmer; Scott R,12,0,17,5
1668166676361,COGS 234,A00,101431,Xia; Haijun,3,0,25,22
1668166676786,COGS 260,A00,101432,Kiyonaga; Anastasia,20,0,25,5
1668166676786,COGS 260,B00,101433,Kirsh; David Joel,16,0,25,9
1668166677218,CSE 202,A00,102371,Impagliazzo; Russell,0,0,0,0
1668166677644,CSE 203B,A01,102373,Cheng; Chung Kuan,0,0,0,0
1668166678068,CSE 208,A00,102374,Micciancio; Daniele,0,0,0,0
1668166678492,CSE 209A,A00,112895,Impagliazzo; Russell,0,0,15,15
1668166678916,CSE 209B,A00,108005,Bellare; Mihir,0,0,0,0
1668166679347,CSE 210,A00,113163,Coblenz; Michael J,0,0,0,0
1668166679783,CSE 219,A00,106111,Dow; Steven P,0,0,20,20
1668166680211,CSE 221,A00,102376,Voelker; Geoffrey M.,0,0,0,0
1668166680649,CSE 224,A01,102378,Porter; George M,0,0,0,0
1668166681077,CSE 229A,A00,102379,Savage; Stefan,0,0,0,0
1668166681503,CSE 229C,A00,102380,Munyaka; Imani N. S.,0,0,0,0
1668166681927,CSE 232B,A00,102382,Deutsch; Alin Bernard,0,0,0,0
1668166682355,CSE 234,A01,112904,Kumar; Arun Kumar,0,0,0,0
1668166682795,CSE 237A,A00,102383,Rosing; Tajana Simunic,0,0,0,0
1668166683219,CSE 239A,A00,102384,Deutsch; Alin Bernard,0,0,0,0
1668166683642,CSE 239B,A00,102385,Polikarpova; Nadezhda,0,0,0,0
1668166684076,CSE 240A,A00,102386,Pannuto; Patrick William,0,0,0,0
1668166684514,CSE 240B,A00,102387,Zhao; Jishen,0,0,0,0
1668166684942,CSE 241A,A00,106406,Kang; Mingu,0,0,0,0
1668166685366,CSE 249B,A00,102388,Kahng; Andrew Byun,0,0,8,8
1668166685793,CSE 251B,A01,102392,Cottrell; Garrison W,0,0,0,0
1668166685793,CSE 251B,A02,102393,Cottrell; Garrison W,0,0,0,0
1668166686221,CSE 252B,A00,102394,Ochoa; Benjamin Lawrence,0,0,0,0
1668166686645,CSE 257,A01,102396,Gao; Sicun,0,0,0,0
1668166687073,CSE 272,A00,102397,Li; Tzumao,0,0,0,0
1668166687498,CSE 274,A00,111323,Chern; Albert Ren-Haur,0,0,0,0
1668166687924,CSE 282,A00,102398,Pevzner; Pavel Arkadjevich,0,0,0,0
1668166688349,CSE 284,A00,114175,Gymrek; Melissa Ann,0,0,0,0
1668166688778,CSE 290,A00,102399,Chandraker; Manmohan Krishna,0,0,0,0
1668166688778,CSE 290,B00,102400,Vaccaro; Kristen Marie,0,0,25,25
1668166688778,CSE 290,C00,102414,Pannuto; Patrick William,0,0,25,25
1668166688778,CSE 290,D00,102427,Pevzner; Pavel Arkadjevich,0,0,0,0
1668166688778,CSE 290,E00,102429,Zhao; Jishen,0,0,0,0
1668166688778,CSE 290,F00,102436,Tullsen; Dean Michael,0,0,0,0
1668166688778,CSE 290,G00,102440,Christensen; Henrik I,0,0,20,20
1668166689209,CSE 291,A00,102443,Su; Hao,0,0,0,0
1668166689209,CSE 291,B00,102448,Polikarpova; Nadezhda,0,0,0,0
1668166689209,CSE 291,C00,102453,Vaccaro; Kristen Marie,0,0,0,0
1668166689209,CSE 291,D00,111343,Savage; Stefan,0,0,0,0
1668166689209,CSE 291,E00,116474,Claffy; Kimberly Claire,0,0,0,0
1668166689209,CSE 291,F00,116479,Pasquale; Joseph,0,0,0,0
1668166689690,CSE 293,001,119111,Bafna; Vineet,9999,0,9999,0
1668166689690,CSE 293,002,119118,Bellare; Mihir,9999,0,9999,0
1668166689690,CSE 293,003,119122,Berg-Kirkpatrick; Taylor D,9999,0,9999,0
1668166689690,CSE 293,004,119135,Christensen; Henrik I,9999,0,9999,0
1668166689690,CSE 293,005,119142,Cottrell; Garrison W,9999,0,9999,0
1668166689690,CSE 293,006,119146,Deutsch; Alin Bernard,9999,0,9999,0
1668166689690,CSE 293,007,119159,Esmaeilzadeh; Hadi,9999,0,9999,0
1668166689690,CSE 293,008,119166,Freund; Yoav,9999,0,9999,0
1668166689690,CSE 293,009,119170,Griswold; William G.,9999,0,9999,0
1668166689690,CSE 293,010,119183,Gymrek; Melissa Ann,9999,0,9999,0
1668166689690,CSE 293,011,119190,Heninger; Nadia A,9999,0,9999,0
1668166689690,CSE 293,012,119230,Impagliazzo; Russell,9999,0,9999,0
1668166689690,CSE 293,013,119232,Jhala; Ranjit,9999,0,9999,0
1668166689690,CSE 293,014,119233,Kahng; Andrew Byun,9999,0,9999,0
1668166689690,CSE 293,015,119298,Kane; Daniel Mertz,9999,0,9999,0
1668166689690,CSE 293,016,119299,Kriegman; David J,9999,0,9999,0
1668166689690,CSE 293,017,119300,Kumar; Arun Kumar,9999,0,9999,0
1668166689690,CSE 293,018,119301,Lerner; Sorin,9999,0,9999,0
1668166689690,CSE 293,019,119302,Lovett; Shachar,9999,0,9999,0
1668166689690,CSE 293,020,119303,McAuley; Julian John,9999,0,9999,0
1668166689690,CSE 293,021,119304,Micciancio; Daniele,9999,0,9999,0
1668166689690,CSE 293,022,119367,Orailoglu; Alex,9999,0,9999,0
1668166689690,CSE 293,023,119382,Paturi; Ramamohan,9999,0,9999,0
1668166689690,CSE 293,024,119404,Polikarpova; Nadezhda,9999,0,9999,0
1668166689690,CSE 293,025,119406,Politz; Joseph Gibbs,9999,0,9999,0
1668166689690,CSE 293,026,119411,Porter; George M,9999,0,9999,0
1668166689690,CSE 293,027,119414,Porter; Leonard Emerson,9999,0,9999,0
1668166689690,CSE 293,028,119416,Ramamoorthi; Ravi,9999,0,9999,0
1668166689690,CSE 293,029,119417,Sahoo; Debashis,9999,0,9999,0
1668166689690,CSE 293,030,119420,Saul; Lawrence,9999,0,9999,0
1668166689690,CSE 293,031,119421,Savage; Stefan,9999,0,9999,0
1668166689690,CSE 293,032,119425,Schulze; Jurgen P.,9999,0,9999,0
1668166689690,CSE 293,033,119426,Snoeren; Alex C.,9999,0,9999,0
1668166689690,CSE 293,034,119428,Shang; Jingbo,9999,0,9999,0
1668166689690,CSE 293,035,119430,Stefan; Deian,9999,0,9999,0
1668166689690,CSE 293,036,119431,Su; Hao,9999,0,9999,0
1668166689690,CSE 293,037,119433,Swanson; Steven James,9999,0,9999,0
1668166689690,CSE 293,038,119435,Tullsen; Dean Michael,9999,0,9999,0
1668166689690,CSE 293,039,119483,Voelker; Geoffrey M.,9999,0,9999,0
1668166689690,CSE 293,040,119537,Zhao; Jishen,9999,0,9999,0
1668166689690,CSE 293,041,119538,Zhou; Yuan-Yuan,9999,0,9999,0
1668166689690,CSE 293,042,119539,Gao; Sicun,9999,0,9999,0
1668166689690,CSE 293,043,119540,Weibel; Nadir,9999,0,9999,0
1668166689690,CSE 293,044,119541,Gupta; Rajesh K.,9999,0,9999,0
1668166689690,CSE 293,045,126410,Vaccaro; Kristen Marie,9999,0,9999,0
1668166689690,CSE 293,046,126411,Klemke; Richard,9999,0,9999,0
1668166690116,CSE 294,A00,102459,Voelker; Geoffrey M.,0,0,0,0
1668166690116,CSE 294,B00,111322,Orailoglu; Alex,0,0,0,0
1668166690539,DSE 201,A00,096914,Deutsch; Alin Bernard,30,0,30,0
1668166690964,DSE 210,A00,096915,Dasgupta; Sanjoy,30,0,30,0
1668166691389,DSE 260A,A00,096916,Altintas De Callaf; Ilkay,30,0,30,0
1668166691836,ECE 200,001,103586,Antipa; Nicholas A,9999,0,9999,0
1668166691836,ECE 200,002,103587,Atanasov; Nikolay A.,9999,0,9999,0
1668166691836,ECE 200,003,103588,Bharadia; Dinesh,9999,0,9999,0
1668166691836,ECE 200,004,103589,Cheng; Chung Kuan,9999,0,9999,0
1668166691836,ECE 200,005,103590,Cosman; Pamela C.,9999,0,9999,0
1668166691836,ECE 200,006,103591,Dayeh; Shadi Ahmad,9999,0,9999,0
1668166691836,ECE 200,007,103592,Fainman; Yeshaiahu,9999,0,9999,0
1668166691836,ECE 200,008,103593,Ford; Joseph Earl,9999,0,9999,0
1668166691836,ECE 200,009,103594,Franceschetti; Massimo,9999,0,9999,0
1668166691836,ECE 200,010,103595,Fullerton; Eric E,9999,0,9999,0
1668166691836,ECE 200,011,103596,Galton; Ian A,9999,0,9999,0
1668166691836,ECE 200,012,103597,Gilja; Vikash,9999,0,9999,0
1668166691836,ECE 200,013,103598,Hall; Drew A.,9999,0,9999,0
1668166691836,ECE 200,014,103599,Hsueh; Tzu-Chien,9999,0,9999,0
1668166691836,ECE 200,015,103600,Javidi; Tara,9999,0,9999,0
1668166691836,ECE 200,016,103601,Kahng; Andrew Byun,9999,0,9999,0
1668166691836,ECE 200,017,103602,Kim; Young-Han,9999,0,9999,0
1668166691836,ECE 200,018,103603,Koushanfar; Farinaz,9999,0,9999,0
1668166691836,ECE 200,019,103604,Kuzum; Duygu,9999,0,9999,0
1668166691836,ECE 200,020,103605,Le; Hanh-Phuc,9999,0,9999,0
1668166691836,ECE 200,021,103606,Lin; Bill,9999,0,9999,0
1668166691836,ECE 200,022,103607,Liu; Zhaowei,9998,0,9999,1
1668166691836,ECE 200,023,103608,Lo; Yu-Hwa,9999,0,9999,0
1668166691836,ECE 200,024,103609,Lomakin; Vitaliy,9999,0,9999,0
1668166691836,ECE 200,025,103610,Mercier; Patrick Philip,9999,0,9999,0
1668166691836,ECE 200,026,103611,Meyer; Florian,9999,0,9999,0
1668166691836,ECE 200,027,103612,Milstein; Laurence B.,9999,0,9999,0
1668166691836,ECE 200,028,103613,Mir Arabbaygi; Siavash,9999,0,9999,0
1668166691836,ECE 200,029,103614,Mookherjea; Shayan,9999,0,9999,0
1668166691836,ECE 200,030,103615,Morris; Karcher William,9999,0,9999,0
1668166691836,ECE 200,031,103616,Ng; Tse Nga,9999,0,9999,0
1668166691836,ECE 200,032,103617,Nguyen; Truong Quang,9999,0,9999,0
1668166691836,ECE 200,033,103618,Nomura; Kenji,9999,0,9999,0
1668166691836,ECE 200,034,103619,Orlitsky; Alon,9999,0,9999,0
1668166691836,ECE 200,035,103620,Pal; Piya,9999,0,9999,0
1668166691836,ECE 200,036,103621,Papen; George C.,9999,0,9999,0
1668166691836,ECE 200,037,103622,Radic; Stojan,9999,0,9999,0
1668166691836,ECE 200,038,103623,Rao; Bhaskar D.,9999,0,9999,0
1668166691836,ECE 200,039,103624,Rao; Ramesh R,9999,0,9999,0
1668166691836,ECE 200,040,103625,Rebeiz; Gabriel,9999,0,9999,0
1668166691836,ECE 200,041,103626,Sanford; John R,9999,0,9999,0
1668166691836,ECE 200,042,103627,Siegel; Paul H.,9999,0,9999,0
1668166691836,ECE 200,043,103628,Sievenpiper; Daniel F.,9999,0,9999,0
1668166691836,ECE 200,044,103629,Sworder; David D.,9999,0,9999,0
1668166691836,ECE 200,045,103630,Taur; Yuan,9999,0,9999,0
1668166691836,ECE 200,046,103631,Touri; Behrouz,9999,0,9999,0
1668166691836,ECE 200,047,103632,Trivedi; Mohan M.,9999,0,9999,0
1668166691836,ECE 200,048,103633,Vasconcelos; Nuno,9999,0,9999,0
1668166691836,ECE 200,049,103634,Wang; Xiaolong,9999,0,9999,0
1668166691836,ECE 200,050,103635,Xie; Pengtao,9999,0,9999,0
1668166691836,ECE 200,051,103636,Yip; Michael,9999,0,9999,0
1668166691836,ECE 200,052,103637,Zeger; Kenneth A.,999,0,999,0
1668166691836,ECE 200,053,103638,Zhang; Xinyu,9999,0,9999,0
1668166691836,ECE 200,054,103639,Turakhia; Yatish Girish,9999,0,9999,0
1668166691836,ECE 200,055,103640,Kang; Mingu,9999,0,9999,0
1668166691836,ECE 200,056,103641,Shi; Yuanyuan,9999,0,9999,0
1668166691836,ECE 200,057,103642,Wang; Edward Jay,9999,0,9999,0
1668166691836,ECE 200,058,103643,Zheng; Yang,9999,0,9999,0
1668166692264,ECE 202,A00,103644,Kuzum; Duygu,0,0,0,0
1668166692687,ECE 212BN,A00,103646,Ng; Tse Nga,0,0,0,0
1668166693114,ECE 221,A00,111493,Staff,0,0,0,0
1668166693539,ECE 222B,A00,103647,Lomakin; Vitaliy,0,0,0,0
1668166693964,ECE 230B,A00,103648,Taur; Yuan,0,0,0,0
1668166694389,ECE 238B,A00,103649,Garay; Javier,0,0,0,0
1668166694817,ECE 240B,A00,112900,Fainman; Yeshaiahu,0,0,0,0
1668166695247,ECE 247A,A00,103650,Jokerst; Jesse Vincent,0,0,0,0
1668166695669,ECE 247B,A00,103651,Wang; Joseph,0,0,0,0
1668166696129,ECE 250,A00,103652,Siegel; Paul H.,0,0,0,0
1668166696554,ECE 251A,A00,103654,Rao; Bhaskar D.,0,0,0,0
1668166696977,ECE 257B,A00,103655,Bharadia; Dinesh,0,0,0,0
1668166697402,ECE 258A,A00,103656,Milstein; Laurence B.,0,0,0,0
1668166697827,ECE 260B,A00,103658,Kang; Mingu,0,0,0,0
1668166698253,ECE 264A,A00,103659,Galton; Ian A,0,0,0,0
1668166698681,ECE 265A,A00,103661,Gudem; Prasad S.S.,0,0,0,0
1668166699103,ECE 265D,A00,103662,Gudem; Prasad S.S.,0,0,0,0
1668166699528,ECE 268,A00,103663,Koushanfar; Farinaz,0,0,0,0
1668166699953,ECE 269,A01,103665,Pal; Piya,0,0,0,0
1668166700382,ECE 271B,A00,103666,Vasconcelos; Manuela,0,0,0,0
1668166700810,ECE 276A,A00,103667,Atanasov; Nikolay A.,0,0,0,0
1668166701239,ECE 277,A00,103668,An; Cheolhong,0,0,0,0
1668166701663,ECE 279,A00,117947,Hall; Drew A.,0,0,0,0
1668166702514,ECE 283,A00,103670,Hsueh; Tzu-Chien,0,0,0,0
1668166702938,ECE 284,A00,103671,Turakhia; Yatish Girish,0,0,0,0
1668166703367,ECE 285,A00,103672,Zheng; Yang,0,0,0,0
1668166703367,ECE 285,B00,103673,Sworder; David D.,0,0,0,0
1668166703794,ECE 287,A00,103676,Javidi; Tara,0,0,0,0
1668166704219,MATH 200B,A00,098023,Salehi Golsefidy; Alireza,12,0,15,3
1668166704641,MATH 202B,A00,098024,Rhoades; Brendon Patrick,9,0,15,6
1668166705066,MATH 203B,A00,098025,Oprea; Dragos N.,10,0,15,5
1668166705491,MATH 204B,A00,098026,Sorensen; Claus M,13,0,15,2
1668166705916,MATH 208,A00,098027,Izadi; Elham,7,0,10,3
1668166706427,MATH 209,A00,098028,Pollack; Aaron,10,0,10,0
1668166706852,MATH 211A,A00,112919,Rogalski; Daniel,9,0,10,1
1668166707276,MATH 211B,A00,112920,Seward; Brandon M.,9,0,10,1
1668166707703,MATH 218,A00,098029,Li; Bo,10,0,10,0
1668166708140,MATH 220B,A00,098030,Novak; Jonathan I,11,0,15,4
1668166708564,MATH 221A,A00,098031,Ebenfelt; Peter F,13,0,15,2
1668166708986,MATH 231B,A00,098032,Zlatos; Andrej,12,0,15,3
1668166709412,MATH 240B,A00,098033,Ni; Lei,9,0,15,6
1668166709836,MATH 243,A00,098034,Jekel; David Andrew,10,0,10,0
1668166710267,MATH 245A,A00,098035,Nie; Jiawang,0,0,15,16
1668166710691,MATH 248,A00,098036,Bejenaru; Ioan,10,0,10,0
1668166711120,MATH 250B,A00,098037,Spolaor; Luca,14,0,15,1
1668166711545,MATH 258,A00,098038,Ni; Lei,10,0,10,0
1668166711975,MATH 264B,A00,098041,Rhoades; Brendon Patrick,9,0,15,6
1668166712400,MATH 268,A00,098042,Buss; Samuel R,10,0,10,0
1668166712824,MATH 269,A00,098043,Rhoades; Brendon Patrick,10,0,10,0
1668166713248,MATH 270B,A00,098044,Li; Bo,10,0,15,5
1668166713676,MATH 272B,A00,098045,Holst; Michael J,13,0,15,2
1668166714106,MATH 273A,A00,098046,Tian; Xiaochuan,10,0,15,5
1668166714530,MATH 275,A01,098048,Tian; Xiaochuan,6,0,10,4
1668166714953,MATH 278A,A00,098049,Holst; Michael J,8,0,10,2
1668166715382,MATH 278B,A00,098050,Cloninger; Alexander,10,0,10,0
1668166715808,MATH 278C,A00,098051,Nie; Jiawang,7,0,10,3
1668166716231,MATH 280B,A00,098052,Zheng; Tianyi,10,0,15,5
1668166716655,MATH 281B,A00,098053,Bradic; Jelena,2,0,15,13
1668166717079,MATH 282B,A00,098054,Arias-Castro; Ery,0,0,15,15
1668166717503,MATH 285,A00,098055,Fitzsimmons; Patrick J,0,0,15,17
1668166717933,MATH 287B,A00,098056,Arias-Castro; Ery,2,0,15,13
1668166718358,MATH 288,A00,098057,Agarwal; Pooja,9,0,10,1
1668166718358,MATH 288,B00,098058,Zhang; Danna,8,0,10,2
1668166718358,MATH 288,C00,098059,Williams; Ruth J,10,0,10,0
1668166718791,MATH 290B,A00,098060,Roberts; Justin Deritter,13,0,15,2
1668166719214,MATH 292,A00,098061,Belmont; Eva Kinoshita,10,0,10,0
1668166719638,MATH 295,A00,098062,Suk; Andrew Hoon,48,0,50,2
1668166720061,MATH 296,A00,098063,Novak; Jonathan I,20,0,20,0
1668166720485,MATH 297,001,098064,Gamst; Anthony Collins,9997,0,9999,2
1668167221359,COGS 205,A00,101395,Chiba; Andrea,19,0,20,1
1668167221794,COGS 210B,001,101404,Greene; Deanna Jacquelyn,9998,0,9999,1
1668167221794,COGS 210B,002,101417,Xia; Haijun,9999,0,9999,0
1668167221794,COGS 210B,003,101422,Nitz; Douglas A.,9999,0,9999,0
1668167221794,COGS 210B,004,101423,Hollan; James D.,9998,0,9999,1
1668167221794,COGS 210B,005,101424,Deak; Gedeon O.,9998,0,9999,1
1668167221794,COGS 210B,006,101425,Rossano; Federico,9999,0,9999,0
1668167222220,COGS 211B,A00,101427,Coulson; Seana M,9996,0,9999,3
1668167222644,COGS 220,A00,101428,Hollan; James D.,0,0,25,25
1668167223070,COGS 229,A00,101429,Dow; Steven P,18,0,25,7
1668167223493,COGS 230,A00,101430,Klemmer; Scott R,12,0,17,5
1668167223919,COGS 234,A00,101431,Xia; Haijun,3,0,25,22
1668167224346,COGS 260,A00,101432,Kiyonaga; Anastasia,20,0,25,5
1668167224346,COGS 260,B00,101433,Kirsh; David Joel,16,0,25,9
1668167224779,CSE 202,A00,102371,Impagliazzo; Russell,0,0,0,0
1668167225207,CSE 203B,A01,102373,Cheng; Chung Kuan,0,0,0,0
1668167225638,CSE 208,A00,102374,Micciancio; Daniele,0,0,0,0
1668167226067,CSE 209A,A00,112895,Impagliazzo; Russell,0,0,15,15
1668167226491,CSE 209B,A00,108005,Bellare; Mihir,0,0,0,0
1668167226917,CSE 210,A00,113163,Coblenz; Michael J,0,0,0,0
1668167227418,CSE 219,A00,106111,Dow; Steven P,0,0,20,20
1668167227844,CSE 221,A00,102376,Voelker; Geoffrey M.,0,0,0,0
1668167228272,CSE 224,A01,102378,Porter; George M,0,0,0,0
1668167228699,CSE 229A,A00,102379,Savage; Stefan,0,0,0,0
1668167229126,CSE 229C,A00,102380,Munyaka; Imani N. S.,0,0,0,0
1668167229549,CSE 232B,A00,102382,Deutsch; Alin Bernard,0,0,0,0
1668167229977,CSE 234,A01,112904,Kumar; Arun Kumar,0,0,0,0
1668167230400,CSE 237A,A00,102383,Rosing; Tajana Simunic,0,0,0,0
1668167230827,CSE 239A,A00,102384,Deutsch; Alin Bernard,0,0,0,0
1668167231253,CSE 239B,A00,102385,Polikarpova; Nadezhda,0,0,0,0
1668167231691,CSE 240A,A00,102386,Pannuto; Patrick William,0,0,0,0
1668167232116,CSE 240B,A00,102387,Zhao; Jishen,0,0,0,0
1668167232546,CSE 241A,A00,106406,Kang; Mingu,0,0,0,0
1668167232972,CSE 249B,A00,102388,Kahng; Andrew Byun,0,0,8,8
1668167233403,CSE 251B,A01,102392,Cottrell; Garrison W,0,0,0,0
1668167233403,CSE 251B,A02,102393,Cottrell; Garrison W,0,0,0,0
1668167233830,CSE 252B,A00,102394,Ochoa; Benjamin Lawrence,0,0,0,0
1668167234255,CSE 257,A01,102396,Gao; Sicun,0,0,0,0
1668167234684,CSE 272,A00,102397,Li; Tzumao,0,0,0,0
1668167235109,CSE 274,A00,111323,Chern; Albert Ren-Haur,0,0,0,0
1668167235534,CSE 282,A00,102398,Pevzner; Pavel Arkadjevich,0,0,0,0
1668167235958,CSE 284,A00,114175,Gymrek; Melissa Ann,0,0,0,0
1668167236385,CSE 290,A00,102399,Chandraker; Manmohan Krishna,0,0,0,0
1668167236385,CSE 290,B00,102400,Vaccaro; Kristen Marie,0,0,25,25
1668167236385,CSE 290,C00,102414,Pannuto; Patrick William,0,0,25,25
1668167236385,CSE 290,D00,102427,Pevzner; Pavel Arkadjevich,0,0,0,0
1668167236385,CSE 290,E00,102429,Zhao; Jishen,0,0,0,0
1668167236385,CSE 290,F00,102436,Tullsen; Dean Michael,0,0,0,0
1668167236385,CSE 290,G00,102440,Christensen; Henrik I,0,0,20,20
1668167236816,CSE 291,A00,102443,Su; Hao,0,0,0,0
1668167236816,CSE 291,B00,102448,Polikarpova; Nadezhda,0,0,0,0
1668167236816,CSE 291,C00,102453,Vaccaro; Kristen Marie,0,0,0,0
1668167236816,CSE 291,D00,111343,Savage; Stefan,0,0,0,0
1668167236816,CSE 291,E00,116474,Claffy; Kimberly Claire,0,0,0,0
1668167236816,CSE 291,F00,116479,Pasquale; Joseph,0,0,0,0
1668167237273,CSE 293,001,119111,Bafna; Vineet,9999,0,9999,0
1668167237273,CSE 293,002,119118,Bellare; Mihir,9999,0,9999,0
1668167237273,CSE 293,003,119122,Berg-Kirkpatrick; Taylor D,9999,0,9999,0
1668167237273,CSE 293,004,119135,Christensen; Henrik I,9999,0,9999,0
1668167237273,CSE 293,005,119142,Cottrell; Garrison W,9999,0,9999,0
1668167237273,CSE 293,006,119146,Deutsch; Alin Bernard,9999,0,9999,0
1668167237273,CSE 293,007,119159,Esmaeilzadeh; Hadi,9999,0,9999,0
1668167237273,CSE 293,008,119166,Freund; Yoav,9999,0,9999,0
1668167237273,CSE 293,009,119170,Griswold; William G.,9999,0,9999,0
1668167237273,CSE 293,010,119183,Gymrek; Melissa Ann,9999,0,9999,0
1668167237273,CSE 293,011,119190,Heninger; Nadia A,9999,0,9999,0
1668167237273,CSE 293,012,119230,Impagliazzo; Russell,9999,0,9999,0
1668167237273,CSE 293,013,119232,Jhala; Ranjit,9999,0,9999,0
1668167237273,CSE 293,014,119233,Kahng; Andrew Byun,9999,0,9999,0
1668167237273,CSE 293,015,119298,Kane; Daniel Mertz,9999,0,9999,0
1668167237273,CSE 293,016,119299,Kriegman; David J,9999,0,9999,0
1668167237273,CSE 293,017,119300,Kumar; Arun Kumar,9999,0,9999,0
1668167237273,CSE 293,018,119301,Lerner; Sorin,9999,0,9999,0
1668167237273,CSE 293,019,119302,Lovett; Shachar,9999,0,9999,0
1668167237273,CSE 293,020,119303,McAuley; Julian John,9999,0,9999,0
1668167237273,CSE 293,021,119304,Micciancio; Daniele,9999,0,9999,0
1668167237273,CSE 293,022,119367,Orailoglu; Alex,9999,0,9999,0
1668167237273,CSE 293,023,119382,Paturi; Ramamohan,9999,0,9999,0
1668167237273,CSE 293,024,119404,Polikarpova; Nadezhda,9999,0,9999,0
1668167237273,CSE 293,025,119406,Politz; Joseph Gibbs,9999,0,9999,0
1668167237273,CSE 293,026,119411,Porter; George M,9999,0,9999,0
1668167237273,CSE 293,027,119414,Porter; Leonard Emerson,9999,0,9999,0
1668167237273,CSE 293,028,119416,Ramamoorthi; Ravi,9999,0,9999,0
1668167237273,CSE 293,029,119417,Sahoo; Debashis,9999,0,9999,0
1668167237273,CSE 293,030,119420,Saul; Lawrence,9999,0,9999,0
1668167237273,CSE 293,031,119421,Savage; Stefan,9999,0,9999,0
1668167237273,CSE 293,032,119425,Schulze; Jurgen P.,9999,0,9999,0
1668167237273,CSE 293,033,119426,Snoeren; Alex C.,9999,0,9999,0
1668167237273,CSE 293,034,119428,Shang; Jingbo,9999,0,9999,0
1668167237273,CSE 293,035,119430,Stefan; Deian,9999,0,9999,0
1668167237273,CSE 293,036,119431,Su; Hao,9999,0,9999,0
1668167237273,CSE 293,037,119433,Swanson; Steven James,9999,0,9999,0
1668167237273,CSE 293,038,119435,Tullsen; Dean Michael,9999,0,9999,0
1668167237273,CSE 293,039,119483,Voelker; Geoffrey M.,9999,0,9999,0
1668167237273,CSE 293,040,119537,Zhao; Jishen,9999,0,9999,0
1668167237273,CSE 293,041,119538,Zhou; Yuan-Yuan,9999,0,9999,0
1668167237273,CSE 293,042,119539,Gao; Sicun,9999,0,9999,0
1668167237273,CSE 293,043,119540,Weibel; Nadir,9999,0,9999,0
1668167237273,CSE 293,044,119541,Gupta; Rajesh K.,9999,0,9999,0
1668167237273,CSE 293,045,126410,Vaccaro; Kristen Marie,9999,0,9999,0
1668167237273,CSE 293,046,126411,Klemke; Richard,9999,0,9999,0
1668167237699,CSE 294,A00,102459,Voelker; Geoffrey M.,0,0,0,0
1668167237699,CSE 294,B00,111322,Orailoglu; Alex,0,0,0,0
1668167238127,DSE 201,A00,096914,Deutsch; Alin Bernard,30,0,30,0
1668167238550,DSE 210,A00,096915,Dasgupta; Sanjoy,30,0,30,0
1668167238981,DSE 260A,A00,096916,Altintas De Callaf; Ilkay,30,0,30,0
1668167239449,ECE 200,001,103586,Antipa; Nicholas A,9999,0,9999,0
1668167239449,ECE 200,002,103587,Atanasov; Nikolay A.,9999,0,9999,0
1668167239449,ECE 200,003,103588,Bharadia; Dinesh,9999,0,9999,0
1668167239449,ECE 200,004,103589,Cheng; Chung Kuan,9999,0,9999,0
1668167239449,ECE 200,005,103590,Cosman; Pamela C.,9999,0,9999,0
1668167239449,ECE 200,006,103591,Dayeh; Shadi Ahmad,9999,0,9999,0
1668167239449,ECE 200,007,103592,Fainman; Yeshaiahu,9999,0,9999,0
1668167239449,ECE 200,008,103593,Ford; Joseph Earl,9999,0,9999,0
1668167239449,ECE 200,009,103594,Franceschetti; Massimo,9999,0,9999,0
1668167239449,ECE 200,010,103595,Fullerton; Eric E,9999,0,9999,0
1668167239449,ECE 200,011,103596,Galton; Ian A,9999,0,9999,0
1668167239449,ECE 200,012,103597,Gilja; Vikash,9999,0,9999,0
1668167239449,ECE 200,013,103598,Hall; Drew A.,9999,0,9999,0
1668167239449,ECE 200,014,103599,Hsueh; Tzu-Chien,9999,0,9999,0
1668167239449,ECE 200,015,103600,Javidi; Tara,9999,0,9999,0
1668167239449,ECE 200,016,103601,Kahng; Andrew Byun,9999,0,9999,0
1668167239449,ECE 200,017,103602,Kim; Young-Han,9999,0,9999,0
1668167239449,ECE 200,018,103603,Koushanfar; Farinaz,9999,0,9999,0
1668167239449,ECE 200,019,103604,Kuzum; Duygu,9999,0,9999,0
1668167239449,ECE 200,020,103605,Le; Hanh-Phuc,9999,0,9999,0
1668167239449,ECE 200,021,103606,Lin; Bill,9999,0,9999,0
1668167239449,ECE 200,022,103607,Liu; Zhaowei,9998,0,9999,1
1668167239449,ECE 200,023,103608,Lo; Yu-Hwa,9999,0,9999,0
1668167239449,ECE 200,024,103609,Lomakin; Vitaliy,9999,0,9999,0
1668167239449,ECE 200,025,103610,Mercier; Patrick Philip,9999,0,9999,0
1668167239449,ECE 200,026,103611,Meyer; Florian,9999,0,9999,0
1668167239449,ECE 200,027,103612,Milstein; Laurence B.,9999,0,9999,0
1668167239449,ECE 200,028,103613,Mir Arabbaygi; Siavash,9999,0,9999,0
1668167239449,ECE 200,029,103614,Mookherjea; Shayan,9999,0,9999,0
1668167239449,ECE 200,030,103615,Morris; Karcher William,9999,0,9999,0
1668167239449,ECE 200,031,103616,Ng; Tse Nga,9999,0,9999,0
1668167239449,ECE 200,032,103617,Nguyen; Truong Quang,9999,0,9999,0
1668167239449,ECE 200,033,103618,Nomura; Kenji,9999,0,9999,0
1668167239449,ECE 200,034,103619,Orlitsky; Alon,9999,0,9999,0
1668167239449,ECE 200,035,103620,Pal; Piya,9999,0,9999,0
1668167239449,ECE 200,036,103621,Papen; George C.,9999,0,9999,0
1668167239449,ECE 200,037,103622,Radic; Stojan,9999,0,9999,0
1668167239449,ECE 200,038,103623,Rao; Bhaskar D.,9999,0,9999,0
1668167239449,ECE 200,039,103624,Rao; Ramesh R,9999,0,9999,0
1668167239449,ECE 200,040,103625,Rebeiz; Gabriel,9999,0,9999,0
1668167239449,ECE 200,041,103626,Sanford; John R,9999,0,9999,0
1668167239449,ECE 200,042,103627,Siegel; Paul H.,9999,0,9999,0
1668167239449,ECE 200,043,103628,Sievenpiper; Daniel F.,9999,0,9999,0
1668167239449,ECE 200,044,103629,Sworder; David D.,9999,0,9999,0
1668167239449,ECE 200,045,103630,Taur; Yuan,9999,0,9999,0
1668167239449,ECE 200,046,103631,Touri; Behrouz,9999,0,9999,0
1668167239449,ECE 200,047,103632,Trivedi; Mohan M.,9999,0,9999,0
1668167239449,ECE 200,048,103633,Vasconcelos; Nuno,9999,0,9999,0
1668167239449,ECE 200,049,103634,Wang; Xiaolong,9999,0,9999,0
1668167239449,ECE 200,050,103635,Xie; Pengtao,9999,0,9999,0
1668167239449,ECE 200,051,103636,Yip; Michael,9999,0,9999,0
1668167239449,ECE 200,052,103637,Zeger; Kenneth A.,999,0,999,0
1668167239449,ECE 200,053,103638,Zhang; Xinyu,9999,0,9999,0
1668167239449,ECE 200,054,103639,Turakhia; Yatish Girish,9999,0,9999,0
1668167239449,ECE 200,055,103640,Kang; Mingu,9999,0,9999,0
1668167239449,ECE 200,056,103641,Shi; Yuanyuan,9999,0,9999,0
1668167239449,ECE 200,057,103642,Wang; Edward Jay,9999,0,9999,0
1668167239449,ECE 200,058,103643,Zheng; Yang,9999,0,9999,0
1668167239876,ECE 202,A00,103644,Kuzum; Duygu,0,0,0,0
1668167240301,ECE 212BN,A00,103646,Ng; Tse Nga,0,0,0,0
1668167240725,ECE 221,A00,111493,Staff,0,0,0,0
1668167241149,ECE 222B,A00,103647,Lomakin; Vitaliy,0,0,0,0
1668167241573,ECE 230B,A00,103648,Taur; Yuan,0,0,0,0
1668167242007,ECE 238B,A00,103649,Garay; Javier,0,0,0,0
1668167242430,ECE 240B,A00,112900,Fainman; Yeshaiahu,0,0,0,0
1668167242866,ECE 247A,A00,103650,Jokerst; Jesse Vincent,0,0,0,0
1668167243289,ECE 247B,A00,103651,Wang; Joseph,0,0,0,0
1668167243719,ECE 250,A00,103652,Siegel; Paul H.,0,0,0,0
1668167244145,ECE 251A,A00,103654,Rao; Bhaskar D.,0,0,0,0
1668167244570,ECE 257B,A00,103655,Bharadia; Dinesh,0,0,0,0
1668167244995,ECE 258A,A00,103656,Milstein; Laurence B.,0,0,0,0
1668167245422,ECE 260B,A00,103658,Kang; Mingu,0,0,0,0
1668167245847,ECE 264A,A00,103659,Galton; Ian A,0,0,0,0
1668167246281,ECE 265A,A00,103661,Gudem; Prasad S.S.,0,0,0,0
1668167246704,ECE 265D,A00,103662,Gudem; Prasad S.S.,0,0,0,0
1668167247128,ECE 268,A00,103663,Koushanfar; Farinaz,0,0,0,0
1668167247553,ECE 269,A01,103665,Pal; Piya,0,0,0,0
1668167247983,ECE 271B,A00,103666,Vasconcelos; Manuela,0,0,0,0
1668167248409,ECE 276A,A00,103667,Atanasov; Nikolay A.,0,0,0,0
1668167248833,ECE 277,A00,103668,An; Cheolhong,0,0,0,0
1668167249259,ECE 279,A00,117947,Hall; Drew A.,0,0,0,0
1668167250113,ECE 283,A00,103670,Hsueh; Tzu-Chien,0,0,0,0
1668167250543,ECE 284,A00,103671,Turakhia; Yatish Girish,0,0,0,0
1668167250966,ECE 285,A00,103672,Zheng; Yang,0,0,0,0
1668167250966,ECE 285,B00,103673,Sworder; David D.,0,0,0,0
1668167251391,ECE 287,A00,103676,Javidi; Tara,0,0,0,0
1668167251816,MATH 200B,A00,098023,Salehi Golsefidy; Alireza,12,0,15,3
1668167252256,MATH 202B,A00,098024,Rhoades; Brendon Patrick,9,0,15,6
1668167252689,MATH 203B,A00,098025,Oprea; Dragos N.,10,0,15,5
1668167253123,MATH 204B,A00,098026,Sorensen; Claus M,13,0,15,2
1668167253547,MATH 208,A00,098027,Izadi; Elham,7,0,10,3
1668167253972,MATH 209,A00,098028,Pollack; Aaron,10,0,10,0
1668167254397,MATH 211A,A00,112919,Rogalski; Daniel,9,0,10,1
1668167254824,MATH 211B,A00,112920,Seward; Brandon M.,9,0,10,1
1668167255252,MATH 218,A00,098029,Li; Bo,10,0,10,0
1668167255680,MATH 220B,A00,098030,Novak; Jonathan I,11,0,15,4
1668167256103,MATH 221A,A00,098031,Ebenfelt; Peter F,13,0,15,2
1668167256528,MATH 231B,A00,098032,Zlatos; Andrej,12,0,15,3
1668167256954,MATH 240B,A00,098033,Ni; Lei,9,0,15,6
1668167257379,MATH 243,A00,098034,Jekel; David Andrew,10,0,10,0
1668167257805,MATH 245A,A00,098035,Nie; Jiawang,0,0,15,16
1668167258229,MATH 248,A00,098036,Bejenaru; Ioan,10,0,10,0
1668167258654,MATH 250B,A00,098037,Spolaor; Luca,14,0,15,1
1668167259078,MATH 258,A00,098038,Ni; Lei,10,0,10,0
1668167259506,MATH 264B,A00,098041,Rhoades; Brendon Patrick,9,0,15,6
1668167259929,MATH 268,A00,098042,Buss; Samuel R,10,0,10,0
1668167260354,MATH 269,A00,098043,Rhoades; Brendon Patrick,10,0,10,0
1668167260780,MATH 270B,A00,098044,Li; Bo,10,0,15,5
1668167261206,MATH 272B,A00,098045,Holst; Michael J,13,0,15,2
1668167261631,MATH 273A,A00,098046,Tian; Xiaochuan,10,0,15,5
1668167262056,MATH 275,A01,098048,Tian; Xiaochuan,6,0,10,4
1668167262487,MATH 278A,A00,098049,Holst; Michael J,8,0,10,2
1668167262911,MATH 278B,A00,098050,Cloninger; Alexander,10,0,10,0
1668167263338,MATH 278C,A00,098051,Nie; Jiawang,7,0,10,3
1668167263769,MATH 280B,A00,098052,Zheng; Tianyi,10,0,15,5
1668167264205,MATH 281B,A00,098053,Bradic; Jelena,2,0,15,13
1668167264630,MATH 282B,A00,098054,Arias-Castro; Ery,0,0,15,15
1668167265054,MATH 285,A00,098055,Fitzsimmons; Patrick J,0,0,15,17
1668167265481,MATH 287B,A00,098056,Arias-Castro; Ery,2,0,15,13
1668167265909,MATH 288,A00,098057,Agarwal; Pooja,9,0,10,1
1668167265909,MATH 288,B00,098058,Zhang; Danna,8,0,10,2
1668167265909,MATH 288,C00,098059,Williams; Ruth J,10,0,10,0
1668167266339,MATH 290B,A00,098060,Roberts; Justin Deritter,13,0,15,2
1668167266777,MATH 292,A00,098061,Belmont; Eva Kinoshita,10,0,10,0
1668167267207,MATH 295,A00,098062,Suk; Andrew Hoon,48,0,50,2
1668167267632,MATH 296,A00,098063,Novak; Jonathan I,20,0,20,0
1668167268056,MATH 297,001,098064,Gamst; Anthony Collins,9997,0,9999,2
1668167773798,COGS 205,A00,101395,Chiba; Andrea,19,0,20,1
1668167774227,COGS 210B,001,101404,Greene; Deanna Jacquelyn,9998,0,9999,1
1668167774227,COGS 210B,002,101417,Xia; Haijun,9999,0,9999,0
1668167774227,COGS 210B,003,101422,Nitz; Douglas A.,9999,0,9999,0
1668167774227,COGS 210B,004,101423,Hollan; James D.,9998,0,9999,1
1668167774227,COGS 210B,005,101424,Deak; Gedeon O.,9998,0,9999,1
1668167774227,COGS 210B,006,101425,Rossano; Federico,9999,0,9999,0
1668167774657,COGS 211B,A00,101427,Coulson; Seana M,9996,0,9999,3
1668167775085,COGS 220,A00,101428,Hollan; James D.,0,0,25,25
1668167775513,COGS 229,A00,101429,Dow; Steven P,18,0,25,7
1668167775940,COGS 230,A00,101430,Klemmer; Scott R,12,0,17,5
1668167776368,COGS 234,A00,101431,Xia; Haijun,3,0,25,22
1668167776799,COGS 260,A00,101432,Kiyonaga; Anastasia,20,0,25,5
1668167776799,COGS 260,B00,101433,Kirsh; David Joel,16,0,25,9
1668167777232,CSE 202,A00,102371,Impagliazzo; Russell,0,0,0,0
1668167777659,CSE 203B,A01,102373,Cheng; Chung Kuan,0,0,0,0
1668167778087,CSE 208,A00,102374,Micciancio; Daniele,0,0,0,0
1668167778516,CSE 209A,A00,112895,Impagliazzo; Russell,0,0,15,15
1668167778942,CSE 209B,A00,108005,Bellare; Mihir,0,0,0,0
1668167779374,CSE 210,A00,113163,Coblenz; Michael J,0,0,0,0
1668167779800,CSE 219,A00,106111,Dow; Steven P,0,0,20,20
1668167780232,CSE 221,A00,102376,Voelker; Geoffrey M.,0,0,0,0
1668167780663,CSE 224,A01,102378,Porter; George M,0,0,0,0
1668167781100,CSE 229A,A00,102379,Savage; Stefan,0,0,0,0
1668167781524,CSE 229C,A00,102380,Munyaka; Imani N. S.,0,0,0,0
1668167781957,CSE 232B,A00,102382,Deutsch; Alin Bernard,0,0,0,0
1668167782387,CSE 234,A01,112904,Kumar; Arun Kumar,0,0,0,0
1668167782810,CSE 237A,A00,102383,Rosing; Tajana Simunic,0,0,0,0
1668167783238,CSE 239A,A00,102384,Deutsch; Alin Bernard,0,0,0,0
1668167783666,CSE 239B,A00,102385,Polikarpova; Nadezhda,0,0,0,0
1668167784092,CSE 240A,A00,102386,Pannuto; Patrick William,0,0,0,0
1668167784523,CSE 240B,A00,102387,Zhao; Jishen,0,0,0,0
1668167784955,CSE 241A,A00,106406,Kang; Mingu,0,0,0,0
1668167785384,CSE 249B,A00,102388,Kahng; Andrew Byun,0,0,8,8
1668167785812,CSE 251B,A01,102392,Cottrell; Garrison W,0,0,0,0
1668167785812,CSE 251B,A02,102393,Cottrell; Garrison W,0,0,0,0
1668167786245,CSE 252B,A00,102394,Ochoa; Benjamin Lawrence,0,0,0,0
1668167786674,CSE 257,A01,102396,Gao; Sicun,0,0,0,0
1668167787101,CSE 272,A00,102397,Li; Tzumao,0,0,0,0
1668167787526,CSE 274,A00,111323,Chern; Albert Ren-Haur,0,0,0,0
1668167787954,CSE 282,A00,102398,Pevzner; Pavel Arkadjevich,0,0,0,0
1668167788383,CSE 284,A00,114175,Gymrek; Melissa Ann,0,0,0,0
1668167788813,CSE 290,A00,102399,Chandraker; Manmohan Krishna,0,0,0,0
1668167788813,CSE 290,B00,102400,Vaccaro; Kristen Marie,0,0,25,25
1668167788813,CSE 290,C00,102414,Pannuto; Patrick William,0,0,25,25
1668167788813,CSE 290,D00,102427,Pevzner; Pavel Arkadjevich,0,0,0,0
1668167788813,CSE 290,E00,102429,Zhao; Jishen,0,0,0,0
1668167788813,CSE 290,F00,102436,Tullsen; Dean Michael,0,0,0,0
1668167788813,CSE 290,G00,102440,Christensen; Henrik I,0,0,20,20
1668167789250,CSE 291,A00,102443,Su; Hao,0,0,0,0
1668167789250,CSE 291,B00,102448,Polikarpova; Nadezhda,0,0,0,0
1668167789250,CSE 291,C00,102453,Vaccaro; Kristen Marie,0,0,0,0
1668167789250,CSE 291,D00,111343,Savage; Stefan,0,0,0,0
1668167789250,CSE 291,E00,116474,Claffy; Kimberly Claire,0,0,0,0
1668167789250,CSE 291,F00,116479,Pasquale; Joseph,0,0,0,0
1668167789717,CSE 293,001,119111,Bafna; Vineet,9999,0,9999,0
1668167789717,CSE 293,002,119118,Bellare; Mihir,9999,0,9999,0
1668167789717,CSE 293,003,119122,Berg-Kirkpatrick; Taylor D,9999,0,9999,0
1668167789717,CSE 293,004,119135,Christensen; Henrik I,9999,0,9999,0
1668167789717,CSE 293,005,119142,Cottrell; Garrison W,9999,0,9999,0
1668167789717,CSE 293,006,119146,Deutsch; Alin Bernard,9999,0,9999,0
1668167789717,CSE 293,007,119159,Esmaeilzadeh; Hadi,9999,0,9999,0
1668167789717,CSE 293,008,119166,Freund; Yoav,9999,0,9999,0
1668167789717,CSE 293,009,119170,Griswold; William G.,9999,0,9999,0
1668167789717,CSE 293,010,119183,Gymrek; Melissa Ann,9999,0,9999,0
1668167789717,CSE 293,011,119190,Heninger; Nadia A,9999,0,9999,0
1668167789717,CSE 293,012,119230,Impagliazzo; Russell,9999,0,9999,0
1668167789717,CSE 293,013,119232,Jhala; Ranjit,9999,0,9999,0
1668167789717,CSE 293,014,119233,Kahng; Andrew Byun,9999,0,9999,0
1668167789717,CSE 293,015,119298,Kane; Daniel Mertz,9999,0,9999,0
1668167789717,CSE 293,016,119299,Kriegman; David J,9999,0,9999,0
1668167789717,CSE 293,017,119300,Kumar; Arun Kumar,9999,0,9999,0
1668167789717,CSE 293,018,119301,Lerner; Sorin,9999,0,9999,0
1668167789717,CSE 293,019,119302,Lovett; Shachar,9999,0,9999,0
1668167789717,CSE 293,020,119303,McAuley; Julian John,9999,0,9999,0
1668167789717,CSE 293,021,119304,Micciancio; Daniele,9999,0,9999,0
1668167789717,CSE 293,022,119367,Orailoglu; Alex,9999,0,9999,0
1668167789717,CSE 293,023,119382,Paturi; Ramamohan,9999,0,9999,0
1668167789717,CSE 293,024,119404,Polikarpova; Nadezhda,9999,0,9999,0
1668167789717,CSE 293,025,119406,Politz; Joseph Gibbs,9999,0,9999,0
1668167789717,CSE 293,026,119411,Porter; George M,9999,0,9999,0
1668167789717,CSE 293,027,119414,Porter; Leonard Emerson,9999,0,9999,0
1668167789717,CSE 293,028,119416,Ramamoorthi; Ravi,9999,0,9999,0
1668167789717,CSE 293,029,119417,Sahoo; Debashis,9999,0,9999,0
1668167789717,CSE 293,030,119420,Saul; Lawrence,9999,0,9999,0
1668167789717,CSE 293,031,119421,Savage; Stefan,9999,0,9999,0
1668167789717,CSE 293,032,119425,Schulze; Jurgen P.,9999,0,9999,0
1668167789717,CSE 293,033,119426,Snoeren; Alex C.,9999,0,9999,0
1668167789717,CSE 293,034,119428,Shang; Jingbo,9999,0,9999,0
1668167789717,CSE 293,035,119430,Stefan; Deian,9999,0,9999,0
1668167789717,CSE 293,036,119431,Su; Hao,9999,0,9999,0
1668167789717,CSE 293,037,119433,Swanson; Steven James,9999,0,9999,0
1668167789717,CSE 293,038,119435,Tullsen; Dean Michael,9999,0,9999,0
1668167789717,CSE 293,039,119483,Voelker; Geoffrey M.,9999,0,9999,0
1668167789717,CSE 293,040,119537,Zhao; Jishen,9999,0,9999,0
1668167789717,CSE 293,041,119538,Zhou; Yuan-Yuan,9999,0,9999,0
1668167789717,CSE 293,042,119539,Gao; Sicun,9999,0,9999,0
1668167789717,CSE 293,043,119540,Weibel; Nadir,9999,0,9999,0
1668167789717,CSE 293,044,119541,Gupta; Rajesh K.,9999,0,9999,0
1668167789717,CSE 293,045,126410,Vaccaro; Kristen Marie,9999,0,9999,0
1668167789717,CSE 293,046,126411,Klemke; Richard,9999,0,9999,0
1668167790145,CSE 294,A00,102459,Voelker; Geoffrey M.,0,0,0,0
1668167790145,CSE 294,B00,111322,Orailoglu; Alex,0,0,0,0
1668167790576,DSE 201,A00,096914,Deutsch; Alin Bernard,30,0,30,0
1668167791000,DSE 210,A00,096915,Dasgupta; Sanjoy,30,0,30,0
1668167791430,DSE 260A,A00,096916,Altintas De Callaf; Ilkay,30,0,30,0
1668167791887,ECE 200,001,103586,Antipa; Nicholas A,9999,0,9999,0
1668167791887,ECE 200,002,103587,Atanasov; Nikolay A.,9999,0,9999,0
1668167791887,ECE 200,003,103588,Bharadia; Dinesh,9999,0,9999,0
1668167791887,ECE 200,004,103589,Cheng; Chung Kuan,9999,0,9999,0
1668167791887,ECE 200,005,103590,Cosman; Pamela C.,9999,0,9999,0
1668167791887,ECE 200,006,103591,Dayeh; Shadi Ahmad,9999,0,9999,0
1668167791887,ECE 200,007,103592,Fainman; Yeshaiahu,9999,0,9999,0
1668167791887,ECE 200,008,103593,Ford; Joseph Earl,9999,0,9999,0
1668167791887,ECE 200,009,103594,Franceschetti; Massimo,9999,0,9999,0
1668167791887,ECE 200,010,103595,Fullerton; Eric E,9999,0,9999,0
1668167791887,ECE 200,011,103596,Galton; Ian A,9999,0,9999,0
1668167791887,ECE 200,012,103597,Gilja; Vikash,9999,0,9999,0
1668167791887,ECE 200,013,103598,Hall; Drew A.,9999,0,9999,0
1668167791887,ECE 200,014,103599,Hsueh; Tzu-Chien,9999,0,9999,0
1668167791887,ECE 200,015,103600,Javidi; Tara,9999,0,9999,0
1668167791887,ECE 200,016,103601,Kahng; Andrew Byun,9999,0,9999,0
1668167791887,ECE 200,017,103602,Kim; Young-Han,9999,0,9999,0
1668167791887,ECE 200,018,103603,Koushanfar; Farinaz,9999,0,9999,0
1668167791887,ECE 200,019,103604,Kuzum; Duygu,9999,0,9999,0
1668167791887,ECE 200,020,103605,Le; Hanh-Phuc,9999,0,9999,0
1668167791887,ECE 200,021,103606,Lin; Bill,9999,0,9999,0
1668167791887,ECE 200,022,103607,Liu; Zhaowei,9998,0,9999,1
1668167791887,ECE 200,023,103608,Lo; Yu-Hwa,9999,0,9999,0
1668167791887,ECE 200,024,103609,Lomakin; Vitaliy,9999,0,9999,0
1668167791887,ECE 200,025,103610,Mercier; Patrick Philip,9999,0,9999,0
1668167791887,ECE 200,026,103611,Meyer; Florian,9999,0,9999,0
1668167791887,ECE 200,027,103612,Milstein; Laurence B.,9999,0,9999,0
1668167791887,ECE 200,028,103613,Mir Arabbaygi; Siavash,9999,0,9999,0
1668167791887,ECE 200,029,103614,Mookherjea; Shayan,9999,0,9999,0
1668167791887,ECE 200,030,103615,Morris; Karcher William,9999,0,9999,0
1668167791887,ECE 200,031,103616,Ng; Tse Nga,9999,0,9999,0
1668167791887,ECE 200,032,103617,Nguyen; Truong Quang,9999,0,9999,0
1668167791887,ECE 200,033,103618,Nomura; Kenji,9999,0,9999,0
1668167791887,ECE 200,034,103619,Orlitsky; Alon,9999,0,9999,0
1668167791887,ECE 200,035,103620,Pal; Piya,9999,0,9999,0
1668167791887,ECE 200,036,103621,Papen; George C.,9999,0,9999,0
1668167791887,ECE 200,037,103622,Radic; Stojan,9999,0,9999,0
1668167791887,ECE 200,038,103623,Rao; Bhaskar D.,9999,0,9999,0
1668167791887,ECE 200,039,103624,Rao; Ramesh R,9999,0,9999,0
1668167791887,ECE 200,040,103625,Rebeiz; Gabriel,9999,0,9999,0
1668167791887,ECE 200,041,103626,Sanford; John R,9999,0,9999,0
1668167791887,ECE 200,042,103627,Siegel; Paul H.,9999,0,9999,0
1668167791887,ECE 200,043,103628,Sievenpiper; Daniel F.,9999,0,9999,0
1668167791887,ECE 200,044,103629,Sworder; David D.,9999,0,9999,0
1668167791887,ECE 200,045,103630,Taur; Yuan,9999,0,9999,0
1668167791887,ECE 200,046,103631,Touri; Behrouz,9999,0,9999,0
1668167791887,ECE 200,047,103632,Trivedi; Mohan M.,9999,0,9999,0
1668167791887,ECE 200,048,103633,Vasconcelos; Nuno,9999,0,9999,0
1668167791887,ECE 200,049,103634,Wang; Xiaolong,9999,0,9999,0
1668167791887,ECE 200,050,103635,Xie; Pengtao,9999,0,9999,0
1668167791887,ECE 200,051,103636,Yip; Michael,9999,0,9999,0
1668167791887,ECE 200,052,103637,Zeger; Kenneth A.,999,0,999,0
1668167791887,ECE 200,053,103638,Zhang; Xinyu,9999,0,9999,0
1668167791887,ECE 200,054,103639,Turakhia; Yatish Girish,9999,0,9999,0
1668167791887,ECE 200,055,103640,Kang; Mingu,9999,0,9999,0
1668167791887,ECE 200,056,103641,Shi; Yuanyuan,9999,0,9999,0
1668167791887,ECE 200,057,103642,Wang; Edward Jay,9999,0,9999,0
1668167791887,ECE 200,058,103643,Zheng; Yang,9999,0,9999,0
1668167792312,ECE 202,A00,103644,Kuzum; Duygu,0,0,0,0
1668167792734,ECE 212BN,A00,103646,Ng; Tse Nga,0,0,0,0
1668167793164,ECE 221,A00,111493,Staff,0,0,0,0
1668167793595,ECE 222B,A00,103647,Lomakin; Vitaliy,0,0,0,0
1668167794026,ECE 230B,A00,103648,Taur; Yuan,0,0,0,0
1668167794454,ECE 238B,A00,103649,Garay; Javier,0,0,0,0
1668167794894,ECE 240B,A00,112900,Fainman; Yeshaiahu,0,0,0,0
1668167795322,ECE 247A,A00,103650,Jokerst; Jesse Vincent,0,0,0,0
1668167795748,ECE 247B,A00,103651,Wang; Joseph,0,0,0,0
1668167796183,ECE 250,A00,103652,Siegel; Paul H.,0,0,0,0
1668167796703,ECE 251A,A00,103654,Rao; Bhaskar D.,0,0,0,0
1668167797129,ECE 257B,A00,103655,Bharadia; Dinesh,0,0,0,0
1668167797553,ECE 258A,A00,103656,Milstein; Laurence B.,0,0,0,0
1668167797976,ECE 260B,A00,103658,Kang; Mingu,0,0,0,0
1668167798405,ECE 264A,A00,103659,Galton; Ian A,0,0,0,0
1668167798831,ECE 265A,A00,103661,Gudem; Prasad S.S.,0,0,0,0
1668167799257,ECE 265D,A00,103662,Gudem; Prasad S.S.,0,0,0,0
1668167799682,ECE 268,A00,103663,Koushanfar; Farinaz,0,0,0,0
1668167800109,ECE 269,A01,103665,Pal; Piya,0,0,0,0
1668167800536,ECE 271B,A00,103666,Vasconcelos; Manuela,0,0,0,0
1668167800965,ECE 276A,A00,103667,Atanasov; Nikolay A.,0,0,0,0
1668167801395,ECE 277,A00,103668,An; Cheolhong,0,0,0,0
1668167801820,ECE 279,A00,117947,Hall; Drew A.,0,0,0,0
1668167802669,ECE 283,A00,103670,Hsueh; Tzu-Chien,0,0,0,0
1668167803095,ECE 284,A00,103671,Turakhia; Yatish Girish,0,0,0,0
1668167803520,ECE 285,A00,103672,Zheng; Yang,0,0,0,0
1668167803520,ECE 285,B00,103673,Sworder; David D.,0,0,0,0
1668167803949,ECE 287,A00,103676,Javidi; Tara,0,0,0,0
1668167804385,MATH 200B,A00,098023,Salehi Golsefidy; Alireza,12,0,15,3
1668167804820,MATH 202B,A00,098024,Rhoades; Brendon Patrick,9,0,15,6
1668167805252,MATH 203B,A00,098025,Oprea; Dragos N.,10,0,15,5
1668167805675,MATH 204B,A00,098026,Sorensen; Claus M,13,0,15,2
1668167806108,MATH 208,A00,098027,Izadi; Elham,7,0,10,3
1668167806534,MATH 209,A00,098028,Pollack; Aaron,10,0,10,0
1668167806959,MATH 211A,A00,112919,Rogalski; Daniel,9,0,10,1
1668167807382,MATH 211B,A00,112920,Seward; Brandon M.,9,0,10,1
1668167807810,MATH 218,A00,098029,Li; Bo,10,0,10,0
1668167808238,MATH 220B,A00,098030,Novak; Jonathan I,11,0,15,4
1668167808665,MATH 221A,A00,098031,Ebenfelt; Peter F,13,0,15,2
1668167809094,MATH 231B,A00,098032,Zlatos; Andrej,12,0,15,3
1668167809517,MATH 240B,A00,098033,Ni; Lei,9,0,15,6
1668167809942,MATH 243,A00,098034,Jekel; David Andrew,10,0,10,0
1668167810368,MATH 245A,A00,098035,Nie; Jiawang,0,0,15,16
1668167810793,MATH 248,A00,098036,Bejenaru; Ioan,10,0,10,0
1668167811220,MATH 250B,A00,098037,Spolaor; Luca,14,0,15,1
1668167811643,MATH 258,A00,098038,Ni; Lei,10,0,10,0
1668167812069,MATH 264B,A00,098041,Rhoades; Brendon Patrick,9,0,15,6
1668167812495,MATH 268,A00,098042,Buss; Samuel R,10,0,10,0
1668167812925,MATH 269,A00,098043,Rhoades; Brendon Patrick,10,0,10,0
1668167813356,MATH 270B,A00,098044,Li; Bo,10,0,15,5
1668167813783,MATH 272B,A00,098045,Holst; Michael J,13,0,15,2
1668167814209,MATH 273A,A00,098046,Tian; Xiaochuan,10,0,15,5
1668167814639,MATH 275,A01,098048,Tian; Xiaochuan,6,0,10,4
1668167815063,MATH 278A,A00,098049,Holst; Michael J,8,0,10,2
1668167815487,MATH 278B,A00,098050,Cloninger; Alexander,10,0,10,0
1668167815915,MATH 278C,A00,098051,Nie; Jiawang,7,0,10,3
1668167816340,MATH 280B,A00,098052,Zheng; Tianyi,10,0,15,5
1668167816776,MATH 281B,A00,098053,Bradic; Jelena,2,0,15,13
1668167817200,MATH 282B,A00,098054,Arias-Castro; Ery,0,0,15,15
1668167817626,MATH 285,A00,098055,Fitzsimmons; Patrick J,0,0,15,17
1668167818051,MATH 287B,A00,098056,Arias-Castro; Ery,2,0,15,13
1668167818486,MATH 288,A00,098057,Agarwal; Pooja,9,0,10,1
1668167818486,MATH 288,B00,098058,Zhang; Danna,8,0,10,2
1668167818486,MATH 288,C00,098059,Williams; Ruth J,10,0,10,0
1668167818913,MATH 290B,A00,098060,Roberts; Justin Deritter,13,0,15,2
1668167819337,MATH 292,A00,098061,Belmont; Eva Kinoshita,10,0,10,0
1668167819762,MATH 295,A00,098062,Suk; Andrew Hoon,48,0,50,2
1668167820186,MATH 296,A00,098063,Novak; Jonathan I,20,0,20,0
1668167820614,MATH 297,001,098064,Gamst; Anthony Collins,9997,0,9999,2
1668168322671,COGS 205,A00,101395,Chiba; Andrea,19,0,20,1
1668168323101,COGS 210B,001,101404,Greene; Deanna Jacquelyn,9998,0,9999,1
1668168323101,COGS 210B,002,101417,Xia; Haijun,9999,0,9999,0
1668168323101,COGS 210B,003,101422,Nitz; Douglas A.,9999,0,9999,0
1668168323101,COGS 210B,004,101423,Hollan; James D.,9998,0,9999,1
1668168323101,COGS 210B,005,101424,Deak; Gedeon O.,9998,0,9999,1
1668168323101,COGS 210B,006,101425,Rossano; Federico,9999,0,9999,0
1668168323529,COGS 211B,A00,101427,Coulson; Seana M,9996,0,9999,3
1668168323951,COGS 220,A00,101428,Hollan; James D.,0,0,25,25
1668168324374,COGS 229,A00,101429,Dow; Steven P,18,0,25,7
1668168324800,COGS 230,A00,101430,Klemmer; Scott R,12,0,17,5
1668168325226,COGS 234,A00,101431,Xia; Haijun,3,0,25,22
1668168325650,COGS 260,A00,101432,Kiyonaga; Anastasia,20,0,25,5
1668168325650,COGS 260,B00,101433,Kirsh; David Joel,16,0,25,9
1668168326098,CSE 202,A00,102371,Impagliazzo; Russell,0,0,0,0
1668168326527,CSE 203B,A01,102373,Cheng; Chung Kuan,0,0,0,0
1668168326953,CSE 208,A00,102374,Micciancio; Daniele,0,0,0,0
1668168327379,CSE 209A,A00,112895,Impagliazzo; Russell,0,0,15,15
1668168327802,CSE 209B,A00,108005,Bellare; Mihir,0,0,0,0
1668168328242,CSE 210,A00,113163,Coblenz; Michael J,0,0,0,0
1668168328669,CSE 219,A00,106111,Dow; Steven P,0,0,20,20
1668168329094,CSE 221,A00,102376,Voelker; Geoffrey M.,0,0,0,0
1668168329527,CSE 224,A01,102378,Porter; George M,0,0,0,0
1668168329954,CSE 229A,A00,102379,Savage; Stefan,0,0,0,0
1668168330378,CSE 229C,A00,102380,Munyaka; Imani N. S.,0,0,0,0
1668168330814,CSE 232B,A00,102382,Deutsch; Alin Bernard,0,0,0,0
1668168331238,CSE 234,A01,112904,Kumar; Arun Kumar,0,0,0,0
1668168331662,CSE 237A,A00,102383,Rosing; Tajana Simunic,0,0,0,0
1668168332093,CSE 239A,A00,102384,Deutsch; Alin Bernard,0,0,0,0
1668168332517,CSE 239B,A00,102385,Polikarpova; Nadezhda,0,0,0,0
1668168332944,CSE 240A,A00,102386,Pannuto; Patrick William,0,0,0,0
1668168333376,CSE 240B,A00,102387,Zhao; Jishen,0,0,0,0
1668168333801,CSE 241A,A00,106406,Kang; Mingu,0,0,0,0
1668168334239,CSE 249B,A00,102388,Kahng; Andrew Byun,0,0,8,8
1668168334679,CSE 251B,A01,102392,Cottrell; Garrison W,0,0,0,0
1668168334679,CSE 251B,A02,102393,Cottrell; Garrison W,0,0,0,0
1668168335104,CSE 252B,A00,102394,Ochoa; Benjamin Lawrence,0,0,0,0
1668168335529,CSE 257,A01,102396,Gao; Sicun,0,0,0,0
1668168335954,CSE 272,A00,102397,Li; Tzumao,0,0,0,0
1668168336381,CSE 274,A00,111323,Chern; Albert Ren-Haur,0,0,0,0
1668168336807,CSE 282,A00,102398,Pevzner; Pavel Arkadjevich,0,0,0,0
1668168337250,CSE 284,A00,114175,Gymrek; Melissa Ann,0,0,0,0
1668168337677,CSE 290,A00,102399,Chandraker; Manmohan Krishna,0,0,0,0
1668168337677,CSE 290,B00,102400,Vaccaro; Kristen Marie,0,0,25,25
1668168337677,CSE 290,C00,102414,Pannuto; Patrick William,0,0,25,25
1668168337677,CSE 290,D00,102427,Pevzner; Pavel Arkadjevich,0,0,0,0
1668168337677,CSE 290,E00,102429,Zhao; Jishen,0,0,0,0
1668168337677,CSE 290,F00,102436,Tullsen; Dean Michael,0,0,0,0
1668168337677,CSE 290,G00,102440,Christensen; Henrik I,0,0,20,20
1668168338120,CSE 291,A00,102443,Su; Hao,0,0,0,0
1668168338120,CSE 291,B00,102448,Polikarpova; Nadezhda,0,0,0,0
1668168338120,CSE 291,C00,102453,Vaccaro; Kristen Marie,0,0,0,0
1668168338120,CSE 291,D00,111343,Savage; Stefan,0,0,0,0
1668168338120,CSE 291,E00,116474,Claffy; Kimberly Claire,0,0,0,0
1668168338120,CSE 291,F00,116479,Pasquale; Joseph,0,0,0,0
1668168338557,CSE 293,001,119111,Bafna; Vineet,9999,0,9999,0
1668168338557,CSE 293,002,119118,Bellare; Mihir,9999,0,9999,0
1668168338557,CSE 293,003,119122,Berg-Kirkpatrick; Taylor D,9999,0,9999,0
1668168338557,CSE 293,004,119135,Christensen; Henrik I,9999,0,9999,0
1668168338557,CSE 293,005,119142,Cottrell; Garrison W,9999,0,9999,0
1668168338557,CSE 293,006,119146,Deutsch; Alin Bernard,9999,0,9999,0
1668168338557,CSE 293,007,119159,Esmaeilzadeh; Hadi,9999,0,9999,0
1668168338557,CSE 293,008,119166,Freund; Yoav,9999,0,9999,0
1668168338557,CSE 293,009,119170,Griswold; William G.,9999,0,9999,0
1668168338557,CSE 293,010,119183,Gymrek; Melissa Ann,9999,0,9999,0
1668168338557,CSE 293,011,119190,Heninger; Nadia A,9999,0,9999,0
1668168338557,CSE 293,012,119230,Impagliazzo; Russell,9999,0,9999,0
1668168338557,CSE 293,013,119232,Jhala; Ranjit,9999,0,9999,0
1668168338557,CSE 293,014,119233,Kahng; Andrew Byun,9999,0,9999,0
1668168338557,CSE 293,015,119298,Kane; Daniel Mertz,9999,0,9999,0
1668168338557,CSE 293,016,119299,Kriegman; David J,9999,0,9999,0
1668168338557,CSE 293,017,119300,Kumar; Arun Kumar,9999,0,9999,0
1668168338557,CSE 293,018,119301,Lerner; Sorin,9999,0,9999,0
1668168338557,CSE 293,019,119302,Lovett; Shachar,9999,0,9999,0
1668168338557,CSE 293,020,119303,McAuley; Julian John,9999,0,9999,0
1668168338557,CSE 293,021,119304,Micciancio; Daniele,9999,0,9999,0
1668168338557,CSE 293,022,119367,Orailoglu; Alex,9999,0,9999,0
1668168338557,CSE 293,023,119382,Paturi; Ramamohan,9999,0,9999,0
1668168338557,CSE 293,024,119404,Polikarpova; Nadezhda,9999,0,9999,0
1668168338557,CSE 293,025,119406,Politz; Joseph Gibbs,9999,0,9999,0
1668168338557,CSE 293,026,119411,Porter; George M,9999,0,9999,0
1668168338557,CSE 293,027,119414,Porter; Leonard Emerson,9999,0,9999,0
1668168338557,CSE 293,028,119416,Ramamoorthi; Ravi,9999,0,9999,0
1668168338557,CSE 293,029,119417,Sahoo; Debashis,9999,0,9999,0
1668168338557,CSE 293,030,119420,Saul; Lawrence,9999,0,9999,0
1668168338557,CSE 293,031,119421,Savage; Stefan,9999,0,9999,0
1668168338557,CSE 293,032,119425,Schulze; Jurgen P.,9999,0,9999,0
1668168338557,CSE 293,033,119426,Snoeren; Alex C.,9999,0,9999,0
1668168338557,CSE 293,034,119428,Shang; Jingbo,9999,0,9999,0
1668168338557,CSE 293,035,119430,Stefan; Deian,9999,0,9999,0
1668168338557,CSE 293,036,119431,Su; Hao,9999,0,9999,0
1668168338557,CSE 293,037,119433,Swanson; Steven James,9999,0,9999,0
1668168338557,CSE 293,038,119435,Tullsen; Dean Michael,9999,0,9999,0
1668168338557,CSE 293,039,119483,Voelker; Geoffrey M.,9999,0,9999,0
1668168338557,CSE 293,040,119537,Zhao; Jishen,9999,0,9999,0
1668168338557,CSE 293,041,119538,Zhou; Yuan-Yuan,9999,0,9999,0
1668168338557,CSE 293,042,119539,Gao; Sicun,9999,0,9999,0
1668168338557,CSE 293,043,119540,Weibel; Nadir,9999,0,9999,0
1668168338557,CSE 293,044,119541,Gupta; Rajesh K.,9999,0,9999,0
1668168338557,CSE 293,045,126410,Vaccaro; Kristen Marie,9999,0,9999,0
1668168338557,CSE 293,046,126411,Klemke; Richard,9999,0,9999,0
1668168338982,CSE 294,A00,102459,Voelker; Geoffrey M.,0,0,0,0
1668168338982,CSE 294,B00,111322,Orailoglu; Alex,0,0,0,0
1668168339415,DSE 201,A00,096914,Deutsch; Alin Bernard,30,0,30,0
1668168339839,DSE 210,A00,096915,Dasgupta; Sanjoy,30,0,30,0
1668168340269,DSE 260A,A00,096916,Altintas De Callaf; Ilkay,30,0,30,0
1668168340740,ECE 200,001,103586,Antipa; Nicholas A,9999,0,9999,0
1668168340740,ECE 200,002,103587,Atanasov; Nikolay A.,9999,0,9999,0
1668168340740,ECE 200,003,103588,Bharadia; Dinesh,9999,0,9999,0
1668168340740,ECE 200,004,103589,Cheng; Chung Kuan,9999,0,9999,0
1668168340740,ECE 200,005,103590,Cosman; Pamela C.,9999,0,9999,0
1668168340740,ECE 200,006,103591,Dayeh; Shadi Ahmad,9999,0,9999,0
1668168340740,ECE 200,007,103592,Fainman; Yeshaiahu,9999,0,9999,0
1668168340740,ECE 200,008,103593,Ford; Joseph Earl,9999,0,9999,0
1668168340740,ECE 200,009,103594,Franceschetti; Massimo,9999,0,9999,0
1668168340740,ECE 200,010,103595,Fullerton; Eric E,9999,0,9999,0
1668168340740,ECE 200,011,103596,Galton; Ian A,9999,0,9999,0
1668168340740,ECE 200,012,103597,Gilja; Vikash,9999,0,9999,0
1668168340740,ECE 200,013,103598,Hall; Drew A.,9999,0,9999,0
1668168340740,ECE 200,014,103599,Hsueh; Tzu-Chien,9999,0,9999,0
1668168340740,ECE 200,015,103600,Javidi; Tara,9999,0,9999,0
1668168340740,ECE 200,016,103601,Kahng; Andrew Byun,9999,0,9999,0
1668168340740,ECE 200,017,103602,Kim; Young-Han,9999,0,9999,0
1668168340740,ECE 200,018,103603,Koushanfar; Farinaz,9999,0,9999,0
1668168340740,ECE 200,019,103604,Kuzum; Duygu,9999,0,9999,0
1668168340740,ECE 200,020,103605,Le; Hanh-Phuc,9999,0,9999,0
1668168340740,ECE 200,021,103606,Lin; Bill,9999,0,9999,0
1668168340740,ECE 200,022,103607,Liu; Zhaowei,9998,0,9999,1
1668168340740,ECE 200,023,103608,Lo; Yu-Hwa,9999,0,9999,0
1668168340740,ECE 200,024,103609,Lomakin; Vitaliy,9999,0,9999,0
1668168340740,ECE 200,025,103610,Mercier; Patrick Philip,9999,0,9999,0
1668168340740,ECE 200,026,103611,Meyer; Florian,9999,0,9999,0
1668168340740,ECE 200,027,103612,Milstein; Laurence B.,9999,0,9999,0
1668168340740,ECE 200,028,103613,Mir Arabbaygi; Siavash,9999,0,9999,0
1668168340740,ECE 200,029,103614,Mookherjea; Shayan,9999,0,9999,0
1668168340740,ECE 200,030,103615,Morris; Karcher William,9999,0,9999,0
1668168340740,ECE 200,031,103616,Ng; Tse Nga,9999,0,9999,0
1668168340740,ECE 200,032,103617,Nguyen; Truong Quang,9999,0,9999,0
1668168340740,ECE 200,033,103618,Nomura; Kenji,9999,0,9999,0
1668168340740,ECE 200,034,103619,Orlitsky; Alon,9999,0,9999,0
1668168340740,ECE 200,035,103620,Pal; Piya,9999,0,9999,0
1668168340740,ECE 200,036,103621,Papen; George C.,9999,0,9999,0
1668168340740,ECE 200,037,103622,Radic; Stojan,9999,0,9999,0
1668168340740,ECE 200,038,103623,Rao; Bhaskar D.,9999,0,9999,0
1668168340740,ECE 200,039,103624,Rao; Ramesh R,9999,0,9999,0
1668168340740,ECE 200,040,103625,Rebeiz; Gabriel,9999,0,9999,0
1668168340740,ECE 200,041,103626,Sanford; John R,9999,0,9999,0
1668168340740,ECE 200,042,103627,Siegel; Paul H.,9999,0,9999,0
1668168340740,ECE 200,043,103628,Sievenpiper; Daniel F.,9999,0,9999,0
1668168340740,ECE 200,044,103629,Sworder; David D.,9999,0,9999,0
1668168340740,ECE 200,045,103630,Taur; Yuan,9999,0,9999,0
1668168340740,ECE 200,046,103631,Touri; Behrouz,9999,0,9999,0
1668168340740,ECE 200,047,103632,Trivedi; Mohan M.,9999,0,9999,0
1668168340740,ECE 200,048,103633,Vasconcelos; Nuno,9999,0,9999,0
1668168340740,ECE 200,049,103634,Wang; Xiaolong,9999,0,9999,0
1668168340740,ECE 200,050,103635,Xie; Pengtao,9999,0,9999,0
1668168340740,ECE 200,051,103636,Yip; Michael,9999,0,9999,0
1668168340740,ECE 200,052,103637,Zeger; Kenneth A.,999,0,999,0
1668168340740,ECE 200,053,103638,Zhang; Xinyu,9999,0,9999,0
1668168340740,ECE 200,054,103639,Turakhia; Yatish Girish,9999,0,9999,0
1668168340740,ECE 200,055,103640,Kang; Mingu,9999,0,9999,0
1668168340740,ECE 200,056,103641,Shi; Yuanyuan,9999,0,9999,0
1668168340740,ECE 200,057,103642,Wang; Edward Jay,9999,0,9999,0
1668168340740,ECE 200,058,103643,Zheng; Yang,9999,0,9999,0
1668168341177,ECE 202,A00,103644,Kuzum; Duygu,0,0,0,0
1668168341602,ECE 212BN,A00,103646,Ng; Tse Nga,0,0,0,0
1668168342028,ECE 221,A00,111493,Staff,0,0,0,0
1668168342468,ECE 222B,A00,103647,Lomakin; Vitaliy,0,0,0,0
1668168342904,ECE 230B,A00,103648,Taur; Yuan,0,0,0,0
1668168343357,ECE 238B,A00,103649,Garay; Javier,0,0,0,0
1668168343781,ECE 240B,A00,112900,Fainman; Yeshaiahu,0,0,0,0
1668168344226,ECE 247A,A00,103650,Jokerst; Jesse Vincent,0,0,0,0
1668168344658,ECE 247B,A00,103651,Wang; Joseph,0,0,0,0
1668168345089,ECE 250,A00,103652,Siegel; Paul H.,0,0,0,0
1668168345511,ECE 251A,A00,103654,Rao; Bhaskar D.,0,0,0,0
1668168348084,ECE 257B,A00,103655,Bharadia; Dinesh,0,0,0,0
1668168351837,ECE 258A,A00,103656,Milstein; Laurence B.,0,0,0,0
1668168355596,ECE 260B,A00,103658,Kang; Mingu,0,0,0,0
1668168356020,ECE 264A,A00,103659,Galton; Ian A,0,0,0,0
1668168356451,ECE 265A,A00,103661,Gudem; Prasad S.S.,0,0,0,0
1668168356878,ECE 265D,A00,103662,Gudem; Prasad S.S.,0,0,0,0
1668168357301,ECE 268,A00,103663,Koushanfar; Farinaz,0,0,0,0
1668168357735,ECE 269,A01,103665,Pal; Piya,0,0,0,0
1668168358170,ECE 271B,A00,103666,Vasconcelos; Manuela,0,0,0,0
1668168358594,ECE 276A,A00,103667,Atanasov; Nikolay A.,0,0,0,0
1668168359021,ECE 277,A00,103668,An; Cheolhong,0,0,0,0
1668168359446,ECE 279,A00,117947,Hall; Drew A.,0,0,0,0
1668168360310,ECE 283,A00,103670,Hsueh; Tzu-Chien,0,0,0,0
1668168360734,ECE 284,A00,103671,Turakhia; Yatish Girish,0,0,0,0
1668168361173,ECE 285,A00,103672,Zheng; Yang,0,0,0,0
1668168361173,ECE 285,B00,103673,Sworder; David D.,0,0,0,0
1668168361607,ECE 287,A00,103676,Javidi; Tara,0,0,0,0
1668168362045,MATH 200B,A00,098023,Salehi Golsefidy; Alireza,12,0,15,3
1668168362472,MATH 202B,A00,098024,Rhoades; Brendon Patrick,9,0,15,6
1668168362908,MATH 203B,A00,098025,Oprea; Dragos N.,10,0,15,5
1668168363336,MATH 204B,A00,098026,Sorensen; Claus M,13,0,15,2
1668168363760,MATH 208,A00,098027,Izadi; Elham,7,0,10,3
1668168364186,MATH 209,A00,098028,Pollack; Aaron,10,0,10,0
1668168364609,MATH 211A,A00,112919,Rogalski; Daniel,9,0,10,1
1668168365033,MATH 211B,A00,112920,Seward; Brandon M.,9,0,10,1
1668168365458,MATH 218,A00,098029,Li; Bo,10,0,10,0
1668168365882,MATH 220B,A00,098030,Novak; Jonathan I,11,0,15,4
1668168366312,MATH 221A,A00,098031,Ebenfelt; Peter F,13,0,15,2
1668168366738,MATH 231B,A00,098032,Zlatos; Andrej,12,0,15,3
1668168367163,MATH 240B,A00,098033,Ni; Lei,9,0,15,6
1668168367601,MATH 243,A00,098034,Jekel; David Andrew,10,0,10,0
1668168368037,MATH 245A,A00,098035,Nie; Jiawang,0,0,15,16
1668168368460,MATH 248,A00,098036,Bejenaru; Ioan,10,0,10,0
1668168368885,MATH 250B,A00,098037,Spolaor; Luca,14,0,15,1
1668168369309,MATH 258,A00,098038,Ni; Lei,10,0,10,0
1668168369742,MATH 264B,A00,098041,Rhoades; Brendon Patrick,9,0,15,6
1668168370175,MATH 268,A00,098042,Buss; Samuel R,10,0,10,0
1668168370601,MATH 269,A00,098043,Rhoades; Brendon Patrick,10,0,10,0
1668168371109,MATH 270B,A00,098044,Li; Bo,10,0,15,5
1668168371546,MATH 272B,A00,098045,Holst; Michael J,13,0,15,2
1668168371984,MATH 273A,A00,098046,Tian; Xiaochuan,10,0,15,5
1668168372416,MATH 275,A01,098048,Tian; Xiaochuan,6,0,10,4
1668168372846,MATH 278A,A00,098049,Holst; Michael J,8,0,10,2
1668168373270,MATH 278B,A00,098050,Cloninger; Alexander,10,0,10,0
1668168373704,MATH 278C,A00,098051,Nie; Jiawang,7,0,10,3
1668168374132,MATH 280B,A00,098052,Zheng; Tianyi,10,0,15,5
1668168374565,MATH 281B,A00,098053,Bradic; Jelena,2,0,15,13
1668168374993,MATH 282B,A00,098054,Arias-Castro; Ery,0,0,15,15
1668168375419,MATH 285,A00,098055,Fitzsimmons; Patrick J,0,0,15,17
1668168375843,MATH 287B,A00,098056,Arias-Castro; Ery,2,0,15,13
1668168376269,MATH 288,A00,098057,Agarwal; Pooja,9,0,10,1
1668168376269,MATH 288,B00,098058,Zhang; Danna,8,0,10,2
1668168376269,MATH 288,C00,098059,Williams; Ruth J,10,0,10,0
1668168376701,MATH 290B,A00,098060,Roberts; Justin Deritter,13,0,15,2
1668168377139,MATH 292,A00,098061,Belmont; Eva Kinoshita,10,0,10,0
1668168377564,MATH 295,A00,098062,Suk; Andrew Hoon,48,0,50,2
1668168377987,MATH 296,A00,098063,Novak; Jonathan I,20,0,20,0
1668168378412,MATH 297,001,098064,Gamst; Anthony Collins,9997,0,9999,2
