time,subj_course_id,sec_code,sec_id,prof,available,waitlist,total,enrolled_ct
1667996932315,COGS 205,A00,101395,Chiba; Andrea,19,0,20,1
1667996932748,COGS 210B,001,101404,Greene; Deanna Jacquelyn,9998,0,9999,1
1667996932748,COGS 210B,002,101417,Xia; Haijun,9999,0,9999,0
1667996932748,COGS 210B,003,101422,Nitz; Douglas A.,9999,0,9999,0
1667996932748,COGS 210B,004,101423,Hollan; James D.,9998,0,9999,1
1667996932748,COGS 210B,005,101424,Deak; Gedeon O.,9999,0,9999,0
1667996932748,COGS 210B,006,101425,Rossano; Federico,9999,0,9999,0
1667996933188,COGS 211B,A00,101427,Coulson; Seana M,9997,0,9999,2
1667996933616,COGS 220,A00,101428,Hollan; James D.,0,0,25,25
1667996934041,COGS 229,A00,101429,Dow; Steven P,18,0,25,7
1667996934464,COGS 230,A00,101430,Klemmer; Scott R,13,0,17,4
1667996934892,COGS 234,A00,101431,Xia; Haijun,7,0,25,18
1667996935324,COGS 260,A00,101432,Kiyonaga; Anastasia,20,0,25,5
1667996935324,COGS 260,B00,101433,Kirsh; David Joel,16,0,25,9
1667996935752,CSE 202,A00,102371,Impagliazzo; Russell,0,0,0,0
1667996936178,CSE 203B,A01,102373,Cheng; Chung Kuan,0,0,0,0
1667996936609,CSE 208,A00,102374,Micciancio; Daniele,0,0,0,0
1667996937036,CSE 209A,A00,112895,Impagliazzo; Russell,0,0,15,15
1667996937462,CSE 209B,A00,108005,Bellare; Mihir,0,0,0,0
1667996937900,CSE 210,A00,113163,Coblenz; Michael J,0,0,0,0
1667996938333,CSE 219,A00,106111,Dow; Steven P,0,0,20,20
1667996938762,CSE 221,A00,102376,Voelker; Geoffrey M.,0,0,0,0
1667996939190,CSE 224,A01,102378,Porter; George M,0,0,0,0
1667996939620,CSE 229A,A00,102379,Savage; Stefan,0,0,0,0
1667996940044,CSE 229C,A00,102380,Munyaka; Imani N. S.,0,0,0,0
1667996940473,CSE 232B,A00,102382,Deutsch; Alin Bernard,0,0,0,0
1667996940898,CSE 234,A01,112904,Kumar; Arun Kumar,0,0,0,0
1667996941331,CSE 237A,A00,102383,Rosing; Tajana Simunic,0,0,0,0
1667996941762,CSE 239A,A00,102384,Deutsch; Alin Bernard,0,0,0,0
1667996942190,CSE 239B,A00,102385,Polikarpova; Nadezhda,0,0,0,0
1667996942618,CSE 240A,A00,102386,Pannuto; Patrick William,0,0,0,0
1667996943048,CSE 240B,A00,102387,Zhao; Jishen,0,0,0,0
1667996943484,CSE 241A,A00,106406,Kang; Mingu,0,0,0,0
1667996943911,CSE 249B,A00,102388,Kahng; Andrew Byun,0,0,8,8
1667996944340,CSE 251B,A01,102392,Cottrell; Garrison W,0,0,0,0
1667996944340,CSE 251B,A02,102393,Cottrell; Garrison W,0,0,0,0
1667996944768,CSE 252B,A00,102394,Ochoa; Benjamin Lawrence,0,0,0,0
1667996945198,CSE 257,A01,102396,Gao; Sicun,0,0,0,0
1667996945626,CSE 272,A00,102397,Li; Tzumao,0,0,0,0
1667996946051,CSE 274,A00,111323,Chern; Albert Ren-Haur,0,0,0,0
1667996946478,CSE 282,A00,102398,Pevzner; Pavel Arkadjevich,0,0,0,0
1667996946902,CSE 284,A00,114175,Gymrek; Melissa Ann,0,0,0,0
1667996947340,CSE 290,A00,102399,Chandraker; Manmohan Krishna,0,0,0,0
1667996947340,CSE 290,B00,102400,Vaccaro; Kristen Marie,0,0,25,25
1667996947340,CSE 290,C00,102414,Pannuto; Patrick William,0,0,25,25
1667996947340,CSE 290,D00,102427,Pevzner; Pavel Arkadjevich,0,0,0,0
1667996947340,CSE 290,E00,102429,Zhao; Jishen,0,0,0,0
1667996947340,CSE 290,F00,102436,Tullsen; Dean Michael,0,0,0,0
1667996947340,CSE 290,G00,102440,Christensen; Henrik I,0,0,20,20
1667996947778,CSE 291,A00,102443,Su; Hao,0,0,0,0
1667996947778,CSE 291,B00,102448,Polikarpova; Nadezhda,0,0,0,0
1667996947778,CSE 291,C00,102453,Vaccaro; Kristen Marie,0,0,0,0
1667996947778,CSE 291,D00,111343,Savage; Stefan,0,0,0,0
1667996947778,CSE 291,E00,116474,Claffy; Kimberly Claire,0,0,0,0
1667996947778,CSE 291,F00,116479,Pasquale; Joseph,0,0,0,0
1667996948226,CSE 293,001,119111,Bafna; Vineet,9999,0,9999,0
1667996948226,CSE 293,002,119118,Bellare; Mihir,9999,0,9999,0
1667996948226,CSE 293,003,119122,Berg-Kirkpatrick; Taylor D,9999,0,9999,0
1667996948226,CSE 293,004,119135,Christensen; Henrik I,9999,0,9999,0
1667996948226,CSE 293,005,119142,Cottrell; Garrison W,9999,0,9999,0
1667996948226,CSE 293,006,119146,Deutsch; Alin Bernard,9999,0,9999,0
1667996948226,CSE 293,007,119159,Esmaeilzadeh; Hadi,9999,0,9999,0
1667996948226,CSE 293,008,119166,Freund; Yoav,9999,0,9999,0
1667996948226,CSE 293,009,119170,Griswold; William G.,9999,0,9999,0
1667996948226,CSE 293,010,119183,Gymrek; Melissa Ann,9999,0,9999,0
1667996948226,CSE 293,011,119190,Heninger; Nadia A,9999,0,9999,0
1667996948226,CSE 293,012,119230,Impagliazzo; Russell,9999,0,9999,0
1667996948226,CSE 293,013,119232,Jhala; Ranjit,9999,0,9999,0
1667996948226,CSE 293,014,119233,Kahng; Andrew Byun,9999,0,9999,0
1667996948226,CSE 293,015,119298,Kane; Daniel Mertz,9999,0,9999,0
1667996948226,CSE 293,016,119299,Kriegman; David J,9999,0,9999,0
1667996948226,CSE 293,017,119300,Kumar; Arun Kumar,9999,0,9999,0
1667996948226,CSE 293,018,119301,Lerner; Sorin,9999,0,9999,0
1667996948226,CSE 293,019,119302,Lovett; Shachar,9999,0,9999,0
1667996948226,CSE 293,020,119303,McAuley; Julian John,9999,0,9999,0
1667996948226,CSE 293,021,119304,Micciancio; Daniele,9999,0,9999,0
1667996948226,CSE 293,022,119367,Orailoglu; Alex,9999,0,9999,0
1667996948226,CSE 293,023,119382,Paturi; Ramamohan,9999,0,9999,0
1667996948226,CSE 293,024,119404,Polikarpova; Nadezhda,9999,0,9999,0
1667996948226,CSE 293,025,119406,Politz; Joseph Gibbs,9999,0,9999,0
1667996948226,CSE 293,026,119411,Porter; George M,9999,0,9999,0
1667996948226,CSE 293,027,119414,Porter; Leonard Emerson,9999,0,9999,0
1667996948226,CSE 293,028,119416,Ramamoorthi; Ravi,9999,0,9999,0
1667996948226,CSE 293,029,119417,Sahoo; Debashis,9999,0,9999,0
1667996948226,CSE 293,030,119420,Saul; Lawrence,9999,0,9999,0
1667996948226,CSE 293,031,119421,Savage; Stefan,9999,0,9999,0
1667996948226,CSE 293,032,119425,Schulze; Jurgen P.,9999,0,9999,0
1667996948226,CSE 293,033,119426,Snoeren; Alex C.,9999,0,9999,0
1667996948226,CSE 293,034,119428,Shang; Jingbo,9999,0,9999,0
1667996948226,CSE 293,035,119430,Stefan; Deian,9999,0,9999,0
1667996948226,CSE 293,036,119431,Su; Hao,9999,0,9999,0
1667996948226,CSE 293,037,119433,Swanson; Steven James,9999,0,9999,0
1667996948226,CSE 293,038,119435,Tullsen; Dean Michael,9999,0,9999,0
1667996948226,CSE 293,039,119483,Voelker; Geoffrey M.,9999,0,9999,0
1667996948226,CSE 293,040,119537,Zhao; Jishen,9999,0,9999,0
1667996948226,CSE 293,041,119538,Zhou; Yuan-Yuan,9999,0,9999,0
1667996948226,CSE 293,042,119539,Gao; Sicun,9999,0,9999,0
1667996948226,CSE 293,043,119540,Weibel; Nadir,9999,0,9999,0
1667996948226,CSE 293,044,119541,Gupta; Rajesh K.,9999,0,9999,0
1667996948226,CSE 293,045,126410,Vaccaro; Kristen Marie,9999,0,9999,0
1667996948226,CSE 293,046,126411,Klemke; Richard,9999,0,9999,0
1667996948656,CSE 294,A00,102459,Voelker; Geoffrey M.,0,0,0,0
1667996948656,CSE 294,B00,111322,Orailoglu; Alex,0,0,0,0
1667996949087,DSE 201,A00,096914,Deutsch; Alin Bernard,30,0,30,0
1667996949513,DSE 210,A00,096915,Dasgupta; Sanjoy,30,0,30,0
1667996949939,DSE 260A,A00,096916,Altintas De Callaf; Ilkay,30,0,30,0
1667996950435,ECE 200,001,103586,Antipa; Nicholas A,9999,0,9999,0
1667996950435,ECE 200,002,103587,Atanasov; Nikolay A.,9999,0,9999,0
1667996950435,ECE 200,003,103588,Bharadia; Dinesh,9999,0,9999,0
1667996950435,ECE 200,004,103589,Cheng; Chung Kuan,9999,0,9999,0
1667996950435,ECE 200,005,103590,Cosman; Pamela C.,9999,0,9999,0
1667996950435,ECE 200,006,103591,Dayeh; Shadi Ahmad,9999,0,9999,0
1667996950435,ECE 200,007,103592,Fainman; Yeshaiahu,9999,0,9999,0
1667996950435,ECE 200,008,103593,Ford; Joseph Earl,9999,0,9999,0
1667996950435,ECE 200,009,103594,Franceschetti; Massimo,9999,0,9999,0
1667996950435,ECE 200,010,103595,Fullerton; Eric E,9999,0,9999,0
1667996950435,ECE 200,011,103596,Galton; Ian A,9999,0,9999,0
1667996950435,ECE 200,012,103597,Gilja; Vikash,9999,0,9999,0
1667996950435,ECE 200,013,103598,Hall; Drew A.,9999,0,9999,0
1667996950435,ECE 200,014,103599,Hsueh; Tzu-Chien,9999,0,9999,0
1667996950435,ECE 200,015,103600,Javidi; Tara,9999,0,9999,0
1667996950435,ECE 200,016,103601,Kahng; Andrew Byun,9999,0,9999,0
1667996950435,ECE 200,017,103602,Kim; Young-Han,9999,0,9999,0
1667996950435,ECE 200,018,103603,Koushanfar; Farinaz,9999,0,9999,0
1667996950435,ECE 200,019,103604,Kuzum; Duygu,9999,0,9999,0
1667996950435,ECE 200,020,103605,Le; Hanh-Phuc,9999,0,9999,0
1667996950435,ECE 200,021,103606,Lin; Bill,9999,0,9999,0
1667996950435,ECE 200,022,103607,Liu; Zhaowei,9998,0,9999,1
1667996950435,ECE 200,023,103608,Lo; Yu-Hwa,9999,0,9999,0
1667996950435,ECE 200,024,103609,Lomakin; Vitaliy,9999,0,9999,0
1667996950435,ECE 200,025,103610,Mercier; Patrick Philip,9999,0,9999,0
1667996950435,ECE 200,026,103611,Meyer; Florian,9999,0,9999,0
1667996950435,ECE 200,027,103612,Milstein; Laurence B.,9999,0,9999,0
1667996950435,ECE 200,028,103613,Mir Arabbaygi; Siavash,9999,0,9999,0
1667996950435,ECE 200,029,103614,Mookherjea; Shayan,9999,0,9999,0
1667996950435,ECE 200,030,103615,Morris; Karcher William,9999,0,9999,0
1667996950435,ECE 200,031,103616,Ng; Tse Nga,9999,0,9999,0
1667996950435,ECE 200,032,103617,Nguyen; Truong Quang,9999,0,9999,0
1667996950435,ECE 200,033,103618,Nomura; Kenji,9999,0,9999,0
1667996950435,ECE 200,034,103619,Orlitsky; Alon,9999,0,9999,0
1667996950435,ECE 200,035,103620,Pal; Piya,9999,0,9999,0
1667996950435,ECE 200,036,103621,Papen; George C.,9999,0,9999,0
1667996950435,ECE 200,037,103622,Radic; Stojan,9999,0,9999,0
1667996950435,ECE 200,038,103623,Rao; Bhaskar D.,9999,0,9999,0
1667996950435,ECE 200,039,103624,Rao; Ramesh R,9999,0,9999,0
1667996950435,ECE 200,040,103625,Rebeiz; Gabriel,9999,0,9999,0
1667996950435,ECE 200,041,103626,Sanford; John R,9999,0,9999,0
1667996950435,ECE 200,042,103627,Siegel; Paul H.,9999,0,9999,0
1667996950435,ECE 200,043,103628,Sievenpiper; Daniel F.,9999,0,9999,0
1667996950435,ECE 200,044,103629,Sworder; David D.,9999,0,9999,0
1667996950435,ECE 200,045,103630,Taur; Yuan,9999,0,9999,0
1667996950435,ECE 200,046,103631,Touri; Behrouz,9999,0,9999,0
1667996950435,ECE 200,047,103632,Trivedi; Mohan M.,9999,0,9999,0
1667996950435,ECE 200,048,103633,Vasconcelos; Nuno,9999,0,9999,0
1667996950435,ECE 200,049,103634,Wang; Xiaolong,9999,0,9999,0
1667996950435,ECE 200,050,103635,Xie; Pengtao,9999,0,9999,0
1667996950435,ECE 200,051,103636,Yip; Michael,9999,0,9999,0
1667996950435,ECE 200,052,103637,Zeger; Kenneth A.,999,0,999,0
1667996950435,ECE 200,053,103638,Zhang; Xinyu,9999,0,9999,0
1667996950435,ECE 200,054,103639,Turakhia; Yatish Girish,9999,0,9999,0
1667996950435,ECE 200,055,103640,Kang; Mingu,9999,0,9999,0
1667996950435,ECE 200,056,103641,Shi; Yuanyuan,9999,0,9999,0
1667996950435,ECE 200,057,103642,Wang; Edward Jay,9999,0,9999,0
1667996950435,ECE 200,058,103643,Zheng; Yang,9999,0,9999,0
1667996950866,ECE 202,A00,103644,Kuzum; Duygu,0,0,0,0
1667996951297,ECE 212BN,A00,103646,Ng; Tse Nga,0,0,0,0
1667996951805,ECE 221,A00,111493,Staff,0,0,0,0
1667996952235,ECE 222B,A00,103647,Lomakin; Vitaliy,0,0,0,0
1667996952663,ECE 230B,A00,103648,Taur; Yuan,0,0,0,0
1667996953092,ECE 238B,A00,103649,Garay; Javier,0,0,0,0
1667996953523,ECE 240B,A00,112900,Fainman; Yeshaiahu,0,0,0,0
1667996953955,ECE 247A,A00,103650,Jokerst; Jesse Vincent,0,0,0,0
1667996954382,ECE 247B,A00,103651,Wang; Joseph,0,0,0,0
1667996954810,ECE 250,A00,103652,Siegel; Paul H.,0,0,0,0
1667996955237,ECE 251A,A00,103654,Rao; Bhaskar D.,0,0,0,0
1667996955664,ECE 257B,A00,103655,Bharadia; Dinesh,0,0,0,0
1667996956094,ECE 258A,A00,103656,Milstein; Laurence B.,0,0,0,0
1667996956523,ECE 260B,A00,103658,Kang; Mingu,0,0,0,0
1667996956951,ECE 264A,A00,103659,Galton; Ian A,0,0,0,0
1667996957378,ECE 265A,A00,103661,Gudem; Prasad S.S.,0,0,0,0
1667996957809,ECE 265D,A00,103662,Gudem; Prasad S.S.,0,0,0,0
1667996958236,ECE 268,A00,103663,Koushanfar; Farinaz,0,0,0,0
1667996958668,ECE 269,A01,103665,Pal; Piya,0,0,0,0
1667996959093,ECE 271B,A00,103666,Vasconcelos; Manuela,0,0,0,0
1667996959519,ECE 276A,A00,103667,Atanasov; Nikolay A.,0,0,0,0
1667996959955,ECE 277,A00,103668,An; Cheolhong,0,0,0,0
1667996960381,ECE 279,A00,117947,Hall; Drew A.,0,0,0,0
1667996961232,ECE 283,A00,103670,Hsueh; Tzu-Chien,0,0,0,0
1667996961658,ECE 284,A00,103671,Turakhia; Yatish Girish,0,0,0,0
1667996962088,ECE 285,A00,103672,Zheng; Yang,0,0,0,0
1667996962088,ECE 285,B00,103673,Sworder; David D.,0,0,0,0
1667996962515,ECE 287,A00,103676,Javidi; Tara,0,0,0,0
1667996962947,MATH 200B,A00,098023,Salehi Golsefidy; Alireza,14,0,15,1
1667996963390,MATH 202B,A00,098024,Rhoades; Brendon Patrick,12,0,15,3
1667996963836,MATH 203B,A00,098025,Oprea; Dragos N.,12,0,15,3
1667996964261,MATH 204B,A00,098026,Sorensen; Claus M,14,0,15,1
1667996964687,MATH 208,A00,098027,Izadi; Elham,7,0,10,3
1667996965116,MATH 209,A00,098028,Pollack; Aaron,10,0,10,0
1667996965541,MATH 211A,A00,112919,Rogalski; Daniel,9,0,10,1
1667996965971,MATH 211B,A00,112920,Seward; Brandon M.,9,0,10,1
1667996966398,MATH 218,A00,098029,Li; Bo,10,0,10,0
1667996966835,MATH 220B,A00,098030,Novak; Jonathan I,13,0,15,2
1667996967262,MATH 221A,A00,098031,Ebenfelt; Peter F,13,0,15,2
1667996967687,MATH 231B,A00,098032,Zlatos; Andrej,12,0,15,3
1667996968116,MATH 240B,A00,098033,Ni; Lei,10,0,15,5
1667996968545,MATH 243,A00,098034,Jekel; David Andrew,10,0,10,0
1667996968972,MATH 245A,A00,098035,Nie; Jiawang,0,0,15,16
1667996969397,MATH 248,A00,098036,Bejenaru; Ioan,10,0,10,0
1667996969821,MATH 250B,A00,098037,Spolaor; Luca,14,0,15,1
1667996970254,MATH 258,A00,098038,Ni; Lei,10,0,10,0
1667996970683,MATH 264B,A00,098041,Rhoades; Brendon Patrick,11,0,15,4
1667996971110,MATH 268,A00,098042,Buss; Samuel R,10,0,10,0
1667996971537,MATH 269,A00,098043,Rhoades; Brendon Patrick,10,0,10,0
1667996971963,MATH 270B,A00,098044,Li; Bo,11,0,15,4
1667996972389,MATH 272B,A00,098045,Holst; Michael J,13,0,15,2
1667996972816,MATH 273A,A00,098046,Tian; Xiaochuan,12,0,15,3
1667996973248,MATH 275,A01,098048,Tian; Xiaochuan,6,0,10,4
1667996973685,MATH 278A,A00,098049,Holst; Michael J,8,0,10,2
1667996974129,MATH 278B,A00,098050,Cloninger; Alexander,10,0,10,0
1667996974555,MATH 278C,A00,098051,Nie; Jiawang,8,0,10,2
1667996974986,MATH 280B,A00,098052,Zheng; Tianyi,11,0,15,4
1667996975414,MATH 281B,A00,098053,Bradic; Jelena,4,0,15,11
1667996975840,MATH 282B,A00,098054,Arias-Castro; Ery,2,0,15,13
1667996976274,MATH 285,A00,098055,Fitzsimmons; Patrick J,0,0,15,17
1667996976699,MATH 287B,A00,098056,Arias-Castro; Ery,5,0,15,10
1667996977131,MATH 288,A00,098057,Agarwal; Pooja,9,0,10,1
1667996977131,MATH 288,B00,098058,Zhang; Danna,9,0,10,1
1667996977131,MATH 288,C00,098059,Williams; Ruth J,10,0,10,0
1667996977556,MATH 290B,A00,098060,Roberts; Justin Deritter,14,0,15,1
1667996977986,MATH 292,A00,098061,Belmont; Eva Kinoshita,10,0,10,0
1667996978411,MATH 295,A00,098062,Suk; Andrew Hoon,48,0,50,2
1667996978839,MATH 296,A00,098063,Novak; Jonathan I,20,0,20,0
1667996979263,MATH 297,001,098064,Gamst; Anthony Collins,9997,0,9999,2
1667997482399,COGS 205,A00,101395,Chiba; Andrea,19,0,20,1
1667997482831,COGS 210B,001,101404,Greene; Deanna Jacquelyn,9998,0,9999,1
1667997482831,COGS 210B,002,101417,Xia; Haijun,9999,0,9999,0
1667997482831,COGS 210B,003,101422,Nitz; Douglas A.,9999,0,9999,0
1667997482831,COGS 210B,004,101423,Hollan; James D.,9998,0,9999,1
1667997482831,COGS 210B,005,101424,Deak; Gedeon O.,9999,0,9999,0
1667997482831,COGS 210B,006,101425,Rossano; Federico,9999,0,9999,0
1667997483256,COGS 211B,A00,101427,Coulson; Seana M,9997,0,9999,2
1667997483684,COGS 220,A00,101428,Hollan; James D.,0,0,25,25
1667997484110,COGS 229,A00,101429,Dow; Steven P,18,0,25,7
1667997484536,COGS 230,A00,101430,Klemmer; Scott R,13,0,17,4
1667997484963,COGS 234,A00,101431,Xia; Haijun,7,0,25,18
1667997485393,COGS 260,A00,101432,Kiyonaga; Anastasia,20,0,25,5
1667997485393,COGS 260,B00,101433,Kirsh; David Joel,16,0,25,9
1667997485821,CSE 202,A00,102371,Impagliazzo; Russell,0,0,0,0
1667997486252,CSE 203B,A01,102373,Cheng; Chung Kuan,0,0,0,0
1667997486679,CSE 208,A00,102374,Micciancio; Daniele,0,0,0,0
1667997487103,CSE 209A,A00,112895,Impagliazzo; Russell,0,0,15,15
1667997487531,CSE 209B,A00,108005,Bellare; Mihir,0,0,0,0
1667997487958,CSE 210,A00,113163,Coblenz; Michael J,0,0,0,0
1667997488387,CSE 219,A00,106111,Dow; Steven P,0,0,20,20
1667997488814,CSE 221,A00,102376,Voelker; Geoffrey M.,0,0,0,0
1667997489240,CSE 224,A01,102378,Porter; George M,0,0,0,0
1667997489666,CSE 229A,A00,102379,Savage; Stefan,0,0,0,0
1667997490091,CSE 229C,A00,102380,Munyaka; Imani N. S.,0,0,0,0
1667997490514,CSE 232B,A00,102382,Deutsch; Alin Bernard,0,0,0,0
1667997490939,CSE 234,A01,112904,Kumar; Arun Kumar,0,0,0,0
1667997491366,CSE 237A,A00,102383,Rosing; Tajana Simunic,0,0,0,0
1667997491794,CSE 239A,A00,102384,Deutsch; Alin Bernard,0,0,0,0
1667997492223,CSE 239B,A00,102385,Polikarpova; Nadezhda,0,0,0,0
1667997492649,CSE 240A,A00,102386,Pannuto; Patrick William,0,0,0,0
1667997493079,CSE 240B,A00,102387,Zhao; Jishen,0,0,0,0
1667997493506,CSE 241A,A00,106406,Kang; Mingu,0,0,0,0
1667997493933,CSE 249B,A00,102388,Kahng; Andrew Byun,0,0,8,8
1667997494359,CSE 251B,A01,102392,Cottrell; Garrison W,0,0,0,0
1667997494359,CSE 251B,A02,102393,Cottrell; Garrison W,0,0,0,0
1667997494785,CSE 252B,A00,102394,Ochoa; Benjamin Lawrence,0,0,0,0
1667997495214,CSE 257,A01,102396,Gao; Sicun,0,0,0,0
1667997495639,CSE 272,A00,102397,Li; Tzumao,0,0,0,0
1667997496068,CSE 274,A00,111323,Chern; Albert Ren-Haur,0,0,0,0
1667997496494,CSE 282,A00,102398,Pevzner; Pavel Arkadjevich,0,0,0,0
1667997496921,CSE 284,A00,114175,Gymrek; Melissa Ann,0,0,0,0
1667997497358,CSE 290,A00,102399,Chandraker; Manmohan Krishna,0,0,0,0
1667997497358,CSE 290,B00,102400,Vaccaro; Kristen Marie,0,0,25,25
1667997497358,CSE 290,C00,102414,Pannuto; Patrick William,0,0,25,25
1667997497358,CSE 290,D00,102427,Pevzner; Pavel Arkadjevich,0,0,0,0
1667997497358,CSE 290,E00,102429,Zhao; Jishen,0,0,0,0
1667997497358,CSE 290,F00,102436,Tullsen; Dean Michael,0,0,0,0
1667997497358,CSE 290,G00,102440,Christensen; Henrik I,0,0,20,20
1667997497787,CSE 291,A00,102443,Su; Hao,0,0,0,0
1667997497787,CSE 291,B00,102448,Polikarpova; Nadezhda,0,0,0,0
1667997497787,CSE 291,C00,102453,Vaccaro; Kristen Marie,0,0,0,0
1667997497787,CSE 291,D00,111343,Savage; Stefan,0,0,0,0
1667997497787,CSE 291,E00,116474,Claffy; Kimberly Claire,0,0,0,0
1667997497787,CSE 291,F00,116479,Pasquale; Joseph,0,0,0,0
1667997498249,CSE 293,001,119111,Bafna; Vineet,9999,0,9999,0
1667997498249,CSE 293,002,119118,Bellare; Mihir,9999,0,9999,0
1667997498249,CSE 293,003,119122,Berg-Kirkpatrick; Taylor D,9999,0,9999,0
1667997498249,CSE 293,004,119135,Christensen; Henrik I,9999,0,9999,0
1667997498249,CSE 293,005,119142,Cottrell; Garrison W,9999,0,9999,0
1667997498249,CSE 293,006,119146,Deutsch; Alin Bernard,9999,0,9999,0
1667997498249,CSE 293,007,119159,Esmaeilzadeh; Hadi,9999,0,9999,0
1667997498249,CSE 293,008,119166,Freund; Yoav,9999,0,9999,0
1667997498249,CSE 293,009,119170,Griswold; William G.,9999,0,9999,0
1667997498249,CSE 293,010,119183,Gymrek; Melissa Ann,9999,0,9999,0
1667997498249,CSE 293,011,119190,Heninger; Nadia A,9999,0,9999,0
1667997498249,CSE 293,012,119230,Impagliazzo; Russell,9999,0,9999,0
1667997498249,CSE 293,013,119232,Jhala; Ranjit,9999,0,9999,0
1667997498249,CSE 293,014,119233,Kahng; Andrew Byun,9999,0,9999,0
1667997498249,CSE 293,015,119298,Kane; Daniel Mertz,9999,0,9999,0
1667997498249,CSE 293,016,119299,Kriegman; David J,9999,0,9999,0
1667997498249,CSE 293,017,119300,Kumar; Arun Kumar,9999,0,9999,0
1667997498249,CSE 293,018,119301,Lerner; Sorin,9999,0,9999,0
1667997498249,CSE 293,019,119302,Lovett; Shachar,9999,0,9999,0
1667997498249,CSE 293,020,119303,McAuley; Julian John,9999,0,9999,0
1667997498249,CSE 293,021,119304,Micciancio; Daniele,9999,0,9999,0
1667997498249,CSE 293,022,119367,Orailoglu; Alex,9999,0,9999,0
1667997498249,CSE 293,023,119382,Paturi; Ramamohan,9999,0,9999,0
1667997498249,CSE 293,024,119404,Polikarpova; Nadezhda,9999,0,9999,0
1667997498249,CSE 293,025,119406,Politz; Joseph Gibbs,9999,0,9999,0
1667997498249,CSE 293,026,119411,Porter; George M,9999,0,9999,0
1667997498249,CSE 293,027,119414,Porter; Leonard Emerson,9999,0,9999,0
1667997498249,CSE 293,028,119416,Ramamoorthi; Ravi,9999,0,9999,0
1667997498249,CSE 293,029,119417,Sahoo; Debashis,9999,0,9999,0
1667997498249,CSE 293,030,119420,Saul; Lawrence,9999,0,9999,0
1667997498249,CSE 293,031,119421,Savage; Stefan,9999,0,9999,0
1667997498249,CSE 293,032,119425,Schulze; Jurgen P.,9999,0,9999,0
1667997498249,CSE 293,033,119426,Snoeren; Alex C.,9999,0,9999,0
1667997498249,CSE 293,034,119428,Shang; Jingbo,9999,0,9999,0
1667997498249,CSE 293,035,119430,Stefan; Deian,9999,0,9999,0
1667997498249,CSE 293,036,119431,Su; Hao,9999,0,9999,0
1667997498249,CSE 293,037,119433,Swanson; Steven James,9999,0,9999,0
1667997498249,CSE 293,038,119435,Tullsen; Dean Michael,9999,0,9999,0
1667997498249,CSE 293,039,119483,Voelker; Geoffrey M.,9999,0,9999,0
1667997498249,CSE 293,040,119537,Zhao; Jishen,9999,0,9999,0
1667997498249,CSE 293,041,119538,Zhou; Yuan-Yuan,9999,0,9999,0
1667997498249,CSE 293,042,119539,Gao; Sicun,9999,0,9999,0
1667997498249,CSE 293,043,119540,Weibel; Nadir,9999,0,9999,0
1667997498249,CSE 293,044,119541,Gupta; Rajesh K.,9999,0,9999,0
1667997498249,CSE 293,045,126410,Vaccaro; Kristen Marie,9999,0,9999,0
1667997498249,CSE 293,046,126411,Klemke; Richard,9999,0,9999,0
1667997498676,CSE 294,A00,102459,Voelker; Geoffrey M.,0,0,0,0
1667997498676,CSE 294,B00,111322,Orailoglu; Alex,0,0,0,0
1667997499104,DSE 201,A00,096914,Deutsch; Alin Bernard,30,0,30,0
1667997499532,DSE 210,A00,096915,Dasgupta; Sanjoy,30,0,30,0
1667997499957,DSE 260A,A00,096916,Altintas De Callaf; Ilkay,30,0,30,0
1667997500417,ECE 200,001,103586,Antipa; Nicholas A,9999,0,9999,0
1667997500417,ECE 200,002,103587,Atanasov; Nikolay A.,9999,0,9999,0
1667997500417,ECE 200,003,103588,Bharadia; Dinesh,9999,0,9999,0
1667997500417,ECE 200,004,103589,Cheng; Chung Kuan,9999,0,9999,0
1667997500417,ECE 200,005,103590,Cosman; Pamela C.,9999,0,9999,0
1667997500417,ECE 200,006,103591,Dayeh; Shadi Ahmad,9999,0,9999,0
1667997500417,ECE 200,007,103592,Fainman; Yeshaiahu,9999,0,9999,0
1667997500417,ECE 200,008,103593,Ford; Joseph Earl,9999,0,9999,0
1667997500417,ECE 200,009,103594,Franceschetti; Massimo,9999,0,9999,0
1667997500417,ECE 200,010,103595,Fullerton; Eric E,9999,0,9999,0
1667997500417,ECE 200,011,103596,Galton; Ian A,9999,0,9999,0
1667997500417,ECE 200,012,103597,Gilja; Vikash,9999,0,9999,0
1667997500417,ECE 200,013,103598,Hall; Drew A.,9999,0,9999,0
1667997500417,ECE 200,014,103599,Hsueh; Tzu-Chien,9999,0,9999,0
1667997500417,ECE 200,015,103600,Javidi; Tara,9999,0,9999,0
1667997500417,ECE 200,016,103601,Kahng; Andrew Byun,9999,0,9999,0
1667997500417,ECE 200,017,103602,Kim; Young-Han,9999,0,9999,0
1667997500417,ECE 200,018,103603,Koushanfar; Farinaz,9999,0,9999,0
1667997500417,ECE 200,019,103604,Kuzum; Duygu,9999,0,9999,0
1667997500417,ECE 200,020,103605,Le; Hanh-Phuc,9999,0,9999,0
1667997500417,ECE 200,021,103606,Lin; Bill,9999,0,9999,0
1667997500417,ECE 200,022,103607,Liu; Zhaowei,9998,0,9999,1
1667997500417,ECE 200,023,103608,Lo; Yu-Hwa,9999,0,9999,0
1667997500417,ECE 200,024,103609,Lomakin; Vitaliy,9999,0,9999,0
1667997500417,ECE 200,025,103610,Mercier; Patrick Philip,9999,0,9999,0
1667997500417,ECE 200,026,103611,Meyer; Florian,9999,0,9999,0
1667997500417,ECE 200,027,103612,Milstein; Laurence B.,9999,0,9999,0
1667997500417,ECE 200,028,103613,Mir Arabbaygi; Siavash,9999,0,9999,0
1667997500417,ECE 200,029,103614,Mookherjea; Shayan,9999,0,9999,0
1667997500417,ECE 200,030,103615,Morris; Karcher William,9999,0,9999,0
1667997500417,ECE 200,031,103616,Ng; Tse Nga,9999,0,9999,0
1667997500417,ECE 200,032,103617,Nguyen; Truong Quang,9999,0,9999,0
1667997500417,ECE 200,033,103618,Nomura; Kenji,9999,0,9999,0
1667997500417,ECE 200,034,103619,Orlitsky; Alon,9999,0,9999,0
1667997500417,ECE 200,035,103620,Pal; Piya,9999,0,9999,0
1667997500417,ECE 200,036,103621,Papen; George C.,9999,0,9999,0
1667997500417,ECE 200,037,103622,Radic; Stojan,9999,0,9999,0
1667997500417,ECE 200,038,103623,Rao; Bhaskar D.,9999,0,9999,0
1667997500417,ECE 200,039,103624,Rao; Ramesh R,9999,0,9999,0
1667997500417,ECE 200,040,103625,Rebeiz; Gabriel,9999,0,9999,0
1667997500417,ECE 200,041,103626,Sanford; John R,9999,0,9999,0
1667997500417,ECE 200,042,103627,Siegel; Paul H.,9999,0,9999,0
1667997500417,ECE 200,043,103628,Sievenpiper; Daniel F.,9999,0,9999,0
1667997500417,ECE 200,044,103629,Sworder; David D.,9999,0,9999,0
1667997500417,ECE 200,045,103630,Taur; Yuan,9999,0,9999,0
1667997500417,ECE 200,046,103631,Touri; Behrouz,9999,0,9999,0
1667997500417,ECE 200,047,103632,Trivedi; Mohan M.,9999,0,9999,0
1667997500417,ECE 200,048,103633,Vasconcelos; Nuno,9999,0,9999,0
1667997500417,ECE 200,049,103634,Wang; Xiaolong,9999,0,9999,0
1667997500417,ECE 200,050,103635,Xie; Pengtao,9999,0,9999,0
1667997500417,ECE 200,051,103636,Yip; Michael,9999,0,9999,0
1667997500417,ECE 200,052,103637,Zeger; Kenneth A.,999,0,999,0
1667997500417,ECE 200,053,103638,Zhang; Xinyu,9999,0,9999,0
1667997500417,ECE 200,054,103639,Turakhia; Yatish Girish,9999,0,9999,0
1667997500417,ECE 200,055,103640,Kang; Mingu,9999,0,9999,0
1667997500417,ECE 200,056,103641,Shi; Yuanyuan,9999,0,9999,0
1667997500417,ECE 200,057,103642,Wang; Edward Jay,9999,0,9999,0
1667997500417,ECE 200,058,103643,Zheng; Yang,9999,0,9999,0
1667997500841,ECE 202,A00,103644,Kuzum; Duygu,0,0,0,0
1667997501271,ECE 212BN,A00,103646,Ng; Tse Nga,0,0,0,0
1667997501695,ECE 221,A00,111493,Staff,0,0,0,0
1667997502123,ECE 222B,A00,103647,Lomakin; Vitaliy,0,0,0,0
1667997502551,ECE 230B,A00,103648,Taur; Yuan,0,0,0,0
1667997502979,ECE 238B,A00,103649,Garay; Javier,0,0,0,0
1667997503406,ECE 240B,A00,112900,Fainman; Yeshaiahu,0,0,0,0
1667997503839,ECE 247A,A00,103650,Jokerst; Jesse Vincent,0,0,0,0
1667997504267,ECE 247B,A00,103651,Wang; Joseph,0,0,0,0
1667997504697,ECE 250,A00,103652,Siegel; Paul H.,0,0,0,0
1667997505128,ECE 251A,A00,103654,Rao; Bhaskar D.,0,0,0,0
1667997505554,ECE 257B,A00,103655,Bharadia; Dinesh,0,0,0,0
1667997505981,ECE 258A,A00,103656,Milstein; Laurence B.,0,0,0,0
1667997506407,ECE 260B,A00,103658,Kang; Mingu,0,0,0,0
1667997506838,ECE 264A,A00,103659,Galton; Ian A,0,0,0,0
1667997507267,ECE 265A,A00,103661,Gudem; Prasad S.S.,0,0,0,0
1667997507691,ECE 265D,A00,103662,Gudem; Prasad S.S.,0,0,0,0
1667997508119,ECE 268,A00,103663,Koushanfar; Farinaz,0,0,0,0
1667997508553,ECE 269,A01,103665,Pal; Piya,0,0,0,0
1667997508982,ECE 271B,A00,103666,Vasconcelos; Manuela,0,0,0,0
1667997509410,ECE 276A,A00,103667,Atanasov; Nikolay A.,0,0,0,0
1667997509835,ECE 277,A00,103668,An; Cheolhong,0,0,0,0
1667997510262,ECE 279,A00,117947,Hall; Drew A.,0,0,0,0
1667997511113,ECE 283,A00,103670,Hsueh; Tzu-Chien,0,0,0,0
1667997511536,ECE 284,A00,103671,Turakhia; Yatish Girish,0,0,0,0
1667997511965,ECE 285,A00,103672,Zheng; Yang,0,0,0,0
1667997511965,ECE 285,B00,103673,Sworder; David D.,0,0,0,0
1667997512389,ECE 287,A00,103676,Javidi; Tara,0,0,0,0
1667997512815,MATH 200B,A00,098023,Salehi Golsefidy; Alireza,14,0,15,1
1667997513241,MATH 202B,A00,098024,Rhoades; Brendon Patrick,12,0,15,3
1667997513665,MATH 203B,A00,098025,Oprea; Dragos N.,12,0,15,3
1667997514094,MATH 204B,A00,098026,Sorensen; Claus M,14,0,15,1
1667997514517,MATH 208,A00,098027,Izadi; Elham,7,0,10,3
1667997514943,MATH 209,A00,098028,Pollack; Aaron,10,0,10,0
1667997515375,MATH 211A,A00,112919,Rogalski; Daniel,9,0,10,1
1667997515800,MATH 211B,A00,112920,Seward; Brandon M.,9,0,10,1
1667997516225,MATH 218,A00,098029,Li; Bo,10,0,10,0
1667997516649,MATH 220B,A00,098030,Novak; Jonathan I,13,0,15,2
1667997517076,MATH 221A,A00,098031,Ebenfelt; Peter F,13,0,15,2
1667997517501,MATH 231B,A00,098032,Zlatos; Andrej,12,0,15,3
1667997517927,MATH 240B,A00,098033,Ni; Lei,10,0,15,5
1667997518430,MATH 243,A00,098034,Jekel; David Andrew,10,0,10,0
1667997518860,MATH 245A,A00,098035,Nie; Jiawang,0,0,15,16
1667997519287,MATH 248,A00,098036,Bejenaru; Ioan,10,0,10,0
1667997519716,MATH 250B,A00,098037,Spolaor; Luca,14,0,15,1
1667997520141,MATH 258,A00,098038,Ni; Lei,10,0,10,0
1667997520571,MATH 264B,A00,098041,Rhoades; Brendon Patrick,11,0,15,4
1667997520996,MATH 268,A00,098042,Buss; Samuel R,10,0,10,0
1667997521423,MATH 269,A00,098043,Rhoades; Brendon Patrick,10,0,10,0
1667997521849,MATH 270B,A00,098044,Li; Bo,11,0,15,4
1667997522273,MATH 272B,A00,098045,Holst; Michael J,13,0,15,2
1667997522699,MATH 273A,A00,098046,Tian; Xiaochuan,12,0,15,3
1667997523130,MATH 275,A01,098048,Tian; Xiaochuan,6,0,10,4
1667997523558,MATH 278A,A00,098049,Holst; Michael J,8,0,10,2
1667997523983,MATH 278B,A00,098050,Cloninger; Alexander,10,0,10,0
1667997524410,MATH 278C,A00,098051,Nie; Jiawang,8,0,10,2
1667997524835,MATH 280B,A00,098052,Zheng; Tianyi,11,0,15,4
1667997525262,MATH 281B,A00,098053,Bradic; Jelena,4,0,15,11
1667997525688,MATH 282B,A00,098054,Arias-Castro; Ery,2,0,15,13
1667997526117,MATH 285,A00,098055,Fitzsimmons; Patrick J,0,0,15,17
1667997526543,MATH 287B,A00,098056,Arias-Castro; Ery,5,0,15,10
1667997526974,MATH 288,A00,098057,Agarwal; Pooja,9,0,10,1
1667997526974,MATH 288,B00,098058,Zhang; Danna,9,0,10,1
1667997526974,MATH 288,C00,098059,Williams; Ruth J,10,0,10,0
1667997527403,MATH 290B,A00,098060,Roberts; Justin Deritter,14,0,15,1
1667997527829,MATH 292,A00,098061,Belmont; Eva Kinoshita,10,0,10,0
1667997528256,MATH 295,A00,098062,Suk; Andrew Hoon,48,0,50,2
1667997528682,MATH 296,A00,098063,Novak; Jonathan I,20,0,20,0
1667997529110,MATH 297,001,098064,Gamst; Anthony Collins,9997,0,9999,2
1667998031066,COGS 205,A00,101395,Chiba; Andrea,19,0,20,1
1667998031493,COGS 210B,001,101404,Greene; Deanna Jacquelyn,9998,0,9999,1
1667998031493,COGS 210B,002,101417,Xia; Haijun,9999,0,9999,0
1667998031493,COGS 210B,003,101422,Nitz; Douglas A.,9999,0,9999,0
1667998031493,COGS 210B,004,101423,Hollan; James D.,9998,0,9999,1
1667998031493,COGS 210B,005,101424,Deak; Gedeon O.,9999,0,9999,0
1667998031493,COGS 210B,006,101425,Rossano; Federico,9999,0,9999,0
1667998031921,COGS 211B,A00,101427,Coulson; Seana M,9997,0,9999,2
1667998032352,COGS 220,A00,101428,Hollan; James D.,0,0,25,25
1667998032781,COGS 229,A00,101429,Dow; Steven P,18,0,25,7
1667998033205,COGS 230,A00,101430,Klemmer; Scott R,13,0,17,4
1667998033632,COGS 234,A00,101431,Xia; Haijun,7,0,25,18
1667998034062,COGS 260,A00,101432,Kiyonaga; Anastasia,20,0,25,5
1667998034062,COGS 260,B00,101433,Kirsh; David Joel,16,0,25,9
1667998034497,CSE 202,A00,102371,Impagliazzo; Russell,0,0,0,0
1667998034924,CSE 203B,A01,102373,Cheng; Chung Kuan,0,0,0,0
1667998035355,CSE 208,A00,102374,Micciancio; Daniele,0,0,0,0
1667998035780,CSE 209A,A00,112895,Impagliazzo; Russell,0,0,15,15
1667998036205,CSE 209B,A00,108005,Bellare; Mihir,0,0,0,0
1667998036638,CSE 210,A00,113163,Coblenz; Michael J,0,0,0,0
1667998037068,CSE 219,A00,106111,Dow; Steven P,0,0,20,20
1667998037498,CSE 221,A00,102376,Voelker; Geoffrey M.,0,0,0,0
1667998037928,CSE 224,A01,102378,Porter; George M,0,0,0,0
1667998038356,CSE 229A,A00,102379,Savage; Stefan,0,0,0,0
1667998038780,CSE 229C,A00,102380,Munyaka; Imani N. S.,0,0,0,0
1667998039206,CSE 232B,A00,102382,Deutsch; Alin Bernard,0,0,0,0
1667998039632,CSE 234,A01,112904,Kumar; Arun Kumar,0,0,0,0
1667998040057,CSE 237A,A00,102383,Rosing; Tajana Simunic,0,0,0,0
1667998040573,CSE 239A,A00,102384,Deutsch; Alin Bernard,0,0,0,0
1667998040998,CSE 239B,A00,102385,Polikarpova; Nadezhda,0,0,0,0
1667998041424,CSE 240A,A00,102386,Pannuto; Patrick William,0,0,0,0
1667998041854,CSE 240B,A00,102387,Zhao; Jishen,0,0,0,0
1667998042285,CSE 241A,A00,106406,Kang; Mingu,0,0,0,0
1667998042709,CSE 249B,A00,102388,Kahng; Andrew Byun,0,0,8,8
1667998043141,CSE 251B,A01,102392,Cottrell; Garrison W,0,0,0,0
1667998043141,CSE 251B,A02,102393,Cottrell; Garrison W,0,0,0,0
1667998043566,CSE 252B,A00,102394,Ochoa; Benjamin Lawrence,0,0,0,0
1667998043991,CSE 257,A01,102396,Gao; Sicun,0,0,0,0
1667998044416,CSE 272,A00,102397,Li; Tzumao,0,0,0,0
1667998044843,CSE 274,A00,111323,Chern; Albert Ren-Haur,0,0,0,0
1667998045268,CSE 282,A00,102398,Pevzner; Pavel Arkadjevich,0,0,0,0
1667998045697,CSE 284,A00,114175,Gymrek; Melissa Ann,0,0,0,0
1667998046130,CSE 290,A00,102399,Chandraker; Manmohan Krishna,0,0,0,0
1667998046130,CSE 290,B00,102400,Vaccaro; Kristen Marie,0,0,25,25
1667998046130,CSE 290,C00,102414,Pannuto; Patrick William,0,0,25,25
1667998046130,CSE 290,D00,102427,Pevzner; Pavel Arkadjevich,0,0,0,0
1667998046130,CSE 290,E00,102429,Zhao; Jishen,0,0,0,0
1667998046130,CSE 290,F00,102436,Tullsen; Dean Michael,0,0,0,0
1667998046130,CSE 290,G00,102440,Christensen; Henrik I,0,0,20,20
1667998046559,CSE 291,A00,102443,Su; Hao,0,0,0,0
1667998046559,CSE 291,B00,102448,Polikarpova; Nadezhda,0,0,0,0
1667998046559,CSE 291,C00,102453,Vaccaro; Kristen Marie,0,0,0,0
1667998046559,CSE 291,D00,111343,Savage; Stefan,0,0,0,0
1667998046559,CSE 291,E00,116474,Claffy; Kimberly Claire,0,0,0,0
1667998046559,CSE 291,F00,116479,Pasquale; Joseph,0,0,0,0
1667998047000,CSE 293,001,119111,Bafna; Vineet,9999,0,9999,0
1667998047000,CSE 293,002,119118,Bellare; Mihir,9999,0,9999,0
1667998047000,CSE 293,003,119122,Berg-Kirkpatrick; Taylor D,9999,0,9999,0
1667998047000,CSE 293,004,119135,Christensen; Henrik I,9999,0,9999,0
1667998047000,CSE 293,005,119142,Cottrell; Garrison W,9999,0,9999,0
1667998047000,CSE 293,006,119146,Deutsch; Alin Bernard,9999,0,9999,0
1667998047000,CSE 293,007,119159,Esmaeilzadeh; Hadi,9999,0,9999,0
1667998047000,CSE 293,008,119166,Freund; Yoav,9999,0,9999,0
1667998047000,CSE 293,009,119170,Griswold; William G.,9999,0,9999,0
1667998047000,CSE 293,010,119183,Gymrek; Melissa Ann,9999,0,9999,0
1667998047000,CSE 293,011,119190,Heninger; Nadia A,9999,0,9999,0
1667998047000,CSE 293,012,119230,Impagliazzo; Russell,9999,0,9999,0
1667998047000,CSE 293,013,119232,Jhala; Ranjit,9999,0,9999,0
1667998047000,CSE 293,014,119233,Kahng; Andrew Byun,9999,0,9999,0
1667998047000,CSE 293,015,119298,Kane; Daniel Mertz,9999,0,9999,0
1667998047000,CSE 293,016,119299,Kriegman; David J,9999,0,9999,0
1667998047000,CSE 293,017,119300,Kumar; Arun Kumar,9999,0,9999,0
1667998047000,CSE 293,018,119301,Lerner; Sorin,9999,0,9999,0
1667998047000,CSE 293,019,119302,Lovett; Shachar,9999,0,9999,0
1667998047000,CSE 293,020,119303,McAuley; Julian John,9999,0,9999,0
1667998047000,CSE 293,021,119304,Micciancio; Daniele,9999,0,9999,0
1667998047000,CSE 293,022,119367,Orailoglu; Alex,9999,0,9999,0
1667998047000,CSE 293,023,119382,Paturi; Ramamohan,9999,0,9999,0
1667998047000,CSE 293,024,119404,Polikarpova; Nadezhda,9999,0,9999,0
1667998047000,CSE 293,025,119406,Politz; Joseph Gibbs,9999,0,9999,0
1667998047000,CSE 293,026,119411,Porter; George M,9999,0,9999,0
1667998047000,CSE 293,027,119414,Porter; Leonard Emerson,9999,0,9999,0
1667998047000,CSE 293,028,119416,Ramamoorthi; Ravi,9999,0,9999,0
1667998047000,CSE 293,029,119417,Sahoo; Debashis,9999,0,9999,0
1667998047000,CSE 293,030,119420,Saul; Lawrence,9999,0,9999,0
1667998047000,CSE 293,031,119421,Savage; Stefan,9999,0,9999,0
1667998047000,CSE 293,032,119425,Schulze; Jurgen P.,9999,0,9999,0
1667998047000,CSE 293,033,119426,Snoeren; Alex C.,9999,0,9999,0
1667998047000,CSE 293,034,119428,Shang; Jingbo,9999,0,9999,0
1667998047000,CSE 293,035,119430,Stefan; Deian,9999,0,9999,0
1667998047000,CSE 293,036,119431,Su; Hao,9999,0,9999,0
1667998047000,CSE 293,037,119433,Swanson; Steven James,9999,0,9999,0
1667998047000,CSE 293,038,119435,Tullsen; Dean Michael,9999,0,9999,0
1667998047000,CSE 293,039,119483,Voelker; Geoffrey M.,9999,0,9999,0
1667998047000,CSE 293,040,119537,Zhao; Jishen,9999,0,9999,0
1667998047000,CSE 293,041,119538,Zhou; Yuan-Yuan,9999,0,9999,0
1667998047000,CSE 293,042,119539,Gao; Sicun,9999,0,9999,0
1667998047000,CSE 293,043,119540,Weibel; Nadir,9999,0,9999,0
1667998047000,CSE 293,044,119541,Gupta; Rajesh K.,9999,0,9999,0
1667998047000,CSE 293,045,126410,Vaccaro; Kristen Marie,9999,0,9999,0
1667998047000,CSE 293,046,126411,Klemke; Richard,9999,0,9999,0
1667998047432,CSE 294,A00,102459,Voelker; Geoffrey M.,0,0,0,0
1667998047432,CSE 294,B00,111322,Orailoglu; Alex,0,0,0,0
1667998047859,DSE 201,A00,096914,Deutsch; Alin Bernard,30,0,30,0
1667998048286,DSE 210,A00,096915,Dasgupta; Sanjoy,30,0,30,0
1667998048716,DSE 260A,A00,096916,Altintas De Callaf; Ilkay,30,0,30,0
1667998049170,ECE 200,001,103586,Antipa; Nicholas A,9999,0,9999,0
1667998049170,ECE 200,002,103587,Atanasov; Nikolay A.,9999,0,9999,0
1667998049170,ECE 200,003,103588,Bharadia; Dinesh,9999,0,9999,0
1667998049170,ECE 200,004,103589,Cheng; Chung Kuan,9999,0,9999,0
1667998049170,ECE 200,005,103590,Cosman; Pamela C.,9999,0,9999,0
1667998049170,ECE 200,006,103591,Dayeh; Shadi Ahmad,9999,0,9999,0
1667998049170,ECE 200,007,103592,Fainman; Yeshaiahu,9999,0,9999,0
1667998049170,ECE 200,008,103593,Ford; Joseph Earl,9999,0,9999,0
1667998049170,ECE 200,009,103594,Franceschetti; Massimo,9999,0,9999,0
1667998049170,ECE 200,010,103595,Fullerton; Eric E,9999,0,9999,0
1667998049170,ECE 200,011,103596,Galton; Ian A,9999,0,9999,0
1667998049170,ECE 200,012,103597,Gilja; Vikash,9999,0,9999,0
1667998049170,ECE 200,013,103598,Hall; Drew A.,9999,0,9999,0
1667998049170,ECE 200,014,103599,Hsueh; Tzu-Chien,9999,0,9999,0
1667998049170,ECE 200,015,103600,Javidi; Tara,9999,0,9999,0
1667998049170,ECE 200,016,103601,Kahng; Andrew Byun,9999,0,9999,0
1667998049170,ECE 200,017,103602,Kim; Young-Han,9999,0,9999,0
1667998049170,ECE 200,018,103603,Koushanfar; Farinaz,9999,0,9999,0
1667998049170,ECE 200,019,103604,Kuzum; Duygu,9999,0,9999,0
1667998049170,ECE 200,020,103605,Le; Hanh-Phuc,9999,0,9999,0
1667998049170,ECE 200,021,103606,Lin; Bill,9999,0,9999,0
1667998049170,ECE 200,022,103607,Liu; Zhaowei,9998,0,9999,1
1667998049170,ECE 200,023,103608,Lo; Yu-Hwa,9999,0,9999,0
1667998049170,ECE 200,024,103609,Lomakin; Vitaliy,9999,0,9999,0
1667998049170,ECE 200,025,103610,Mercier; Patrick Philip,9999,0,9999,0
1667998049170,ECE 200,026,103611,Meyer; Florian,9999,0,9999,0
1667998049170,ECE 200,027,103612,Milstein; Laurence B.,9999,0,9999,0
1667998049170,ECE 200,028,103613,Mir Arabbaygi; Siavash,9999,0,9999,0
1667998049170,ECE 200,029,103614,Mookherjea; Shayan,9999,0,9999,0
1667998049170,ECE 200,030,103615,Morris; Karcher William,9999,0,9999,0
1667998049170,ECE 200,031,103616,Ng; Tse Nga,9999,0,9999,0
1667998049170,ECE 200,032,103617,Nguyen; Truong Quang,9999,0,9999,0
1667998049170,ECE 200,033,103618,Nomura; Kenji,9999,0,9999,0
1667998049170,ECE 200,034,103619,Orlitsky; Alon,9999,0,9999,0
1667998049170,ECE 200,035,103620,Pal; Piya,9999,0,9999,0
1667998049170,ECE 200,036,103621,Papen; George C.,9999,0,9999,0
1667998049170,ECE 200,037,103622,Radic; Stojan,9999,0,9999,0
1667998049170,ECE 200,038,103623,Rao; Bhaskar D.,9999,0,9999,0
1667998049170,ECE 200,039,103624,Rao; Ramesh R,9999,0,9999,0
1667998049170,ECE 200,040,103625,Rebeiz; Gabriel,9999,0,9999,0
1667998049170,ECE 200,041,103626,Sanford; John R,9999,0,9999,0
1667998049170,ECE 200,042,103627,Siegel; Paul H.,9999,0,9999,0
1667998049170,ECE 200,043,103628,Sievenpiper; Daniel F.,9999,0,9999,0
1667998049170,ECE 200,044,103629,Sworder; David D.,9999,0,9999,0
1667998049170,ECE 200,045,103630,Taur; Yuan,9999,0,9999,0
1667998049170,ECE 200,046,103631,Touri; Behrouz,9999,0,9999,0
1667998049170,ECE 200,047,103632,Trivedi; Mohan M.,9999,0,9999,0
1667998049170,ECE 200,048,103633,Vasconcelos; Nuno,9999,0,9999,0
1667998049170,ECE 200,049,103634,Wang; Xiaolong,9999,0,9999,0
1667998049170,ECE 200,050,103635,Xie; Pengtao,9999,0,9999,0
1667998049170,ECE 200,051,103636,Yip; Michael,9999,0,9999,0
1667998049170,ECE 200,052,103637,Zeger; Kenneth A.,999,0,999,0
1667998049170,ECE 200,053,103638,Zhang; Xinyu,9999,0,9999,0
1667998049170,ECE 200,054,103639,Turakhia; Yatish Girish,9999,0,9999,0
1667998049170,ECE 200,055,103640,Kang; Mingu,9999,0,9999,0
1667998049170,ECE 200,056,103641,Shi; Yuanyuan,9999,0,9999,0
1667998049170,ECE 200,057,103642,Wang; Edward Jay,9999,0,9999,0
1667998049170,ECE 200,058,103643,Zheng; Yang,9999,0,9999,0
1667998049602,ECE 202,A00,103644,Kuzum; Duygu,0,0,0,0
1667998050027,ECE 212BN,A00,103646,Ng; Tse Nga,0,0,0,0
1667998050456,ECE 221,A00,111493,Staff,0,0,0,0
1667998050883,ECE 222B,A00,103647,Lomakin; Vitaliy,0,0,0,0
1667998051309,ECE 230B,A00,103648,Taur; Yuan,0,0,0,0
1667998051739,ECE 238B,A00,103649,Garay; Javier,0,0,0,0
1667998052164,ECE 240B,A00,112900,Fainman; Yeshaiahu,0,0,0,0
1667998052594,ECE 247A,A00,103650,Jokerst; Jesse Vincent,0,0,0,0
1667998053018,ECE 247B,A00,103651,Wang; Joseph,0,0,0,0
1667998053447,ECE 250,A00,103652,Siegel; Paul H.,0,0,0,0
1667998053872,ECE 251A,A00,103654,Rao; Bhaskar D.,0,0,0,0
1667998054300,ECE 257B,A00,103655,Bharadia; Dinesh,0,0,0,0
1667998054730,ECE 258A,A00,103656,Milstein; Laurence B.,0,0,0,0
1667998055155,ECE 260B,A00,103658,Kang; Mingu,0,0,0,0
1667998055579,ECE 264A,A00,103659,Galton; Ian A,0,0,0,0
1667998056007,ECE 265A,A00,103661,Gudem; Prasad S.S.,0,0,0,0
1667998056430,ECE 265D,A00,103662,Gudem; Prasad S.S.,0,0,0,0
1667998056858,ECE 268,A00,103663,Koushanfar; Farinaz,0,0,0,0
1667998057283,ECE 269,A01,103665,Pal; Piya,0,0,0,0
1667998057708,ECE 271B,A00,103666,Vasconcelos; Manuela,0,0,0,0
1667998058136,ECE 276A,A00,103667,Atanasov; Nikolay A.,0,0,0,0
1667998058565,ECE 277,A00,103668,An; Cheolhong,0,0,0,0
1667998058992,ECE 279,A00,117947,Hall; Drew A.,0,0,0,0
1667998059843,ECE 283,A00,103670,Hsueh; Tzu-Chien,0,0,0,0
1667998060270,ECE 284,A00,103671,Turakhia; Yatish Girish,0,0,0,0
1667998060697,ECE 285,A00,103672,Zheng; Yang,0,0,0,0
1667998060697,ECE 285,B00,103673,Sworder; David D.,0,0,0,0
1667998061123,ECE 287,A00,103676,Javidi; Tara,0,0,0,0
1667998061547,MATH 200B,A00,098023,Salehi Golsefidy; Alireza,14,0,15,1
1667998061976,MATH 202B,A00,098024,Rhoades; Brendon Patrick,12,0,15,3
1667998062401,MATH 203B,A00,098025,Oprea; Dragos N.,12,0,15,3
1667998062834,MATH 204B,A00,098026,Sorensen; Claus M,14,0,15,1
1667998063265,MATH 208,A00,098027,Izadi; Elham,7,0,10,3
1667998063690,MATH 209,A00,098028,Pollack; Aaron,10,0,10,0
1667998064116,MATH 211A,A00,112919,Rogalski; Daniel,9,0,10,1
1667998064540,MATH 211B,A00,112920,Seward; Brandon M.,9,0,10,1
1667998064967,MATH 218,A00,098029,Li; Bo,10,0,10,0
1667998065390,MATH 220B,A00,098030,Novak; Jonathan I,13,0,15,2
1667998065819,MATH 221A,A00,098031,Ebenfelt; Peter F,13,0,15,2
1667998066250,MATH 231B,A00,098032,Zlatos; Andrej,12,0,15,3
1667998066675,MATH 240B,A00,098033,Ni; Lei,10,0,15,5
1667998067101,MATH 243,A00,098034,Jekel; David Andrew,10,0,10,0
1667998067531,MATH 245A,A00,098035,Nie; Jiawang,0,0,15,16
1667998067958,MATH 248,A00,098036,Bejenaru; Ioan,10,0,10,0
1667998068381,MATH 250B,A00,098037,Spolaor; Luca,14,0,15,1
1667998068810,MATH 258,A00,098038,Ni; Lei,10,0,10,0
1667998069238,MATH 264B,A00,098041,Rhoades; Brendon Patrick,11,0,15,4
1667998069669,MATH 268,A00,098042,Buss; Samuel R,10,0,10,0
1667998070095,MATH 269,A00,098043,Rhoades; Brendon Patrick,10,0,10,0
1667998070529,MATH 270B,A00,098044,Li; Bo,11,0,15,4
1667998070959,MATH 272B,A00,098045,Holst; Michael J,13,0,15,2
1667998071399,MATH 273A,A00,098046,Tian; Xiaochuan,12,0,15,3
1667998071825,MATH 275,A01,098048,Tian; Xiaochuan,6,0,10,4
1667998072251,MATH 278A,A00,098049,Holst; Michael J,8,0,10,2
1667998072676,MATH 278B,A00,098050,Cloninger; Alexander,10,0,10,0
1667998073100,MATH 278C,A00,098051,Nie; Jiawang,8,0,10,2
1667998073526,MATH 280B,A00,098052,Zheng; Tianyi,11,0,15,4
1667998073952,MATH 281B,A00,098053,Bradic; Jelena,4,0,15,11
1667998074375,MATH 282B,A00,098054,Arias-Castro; Ery,2,0,15,13
1667998074805,MATH 285,A00,098055,Fitzsimmons; Patrick J,0,0,15,17
1667998075232,MATH 287B,A00,098056,Arias-Castro; Ery,5,0,15,10
1667998075659,MATH 288,A00,098057,Agarwal; Pooja,9,0,10,1
1667998075659,MATH 288,B00,098058,Zhang; Danna,9,0,10,1
1667998075659,MATH 288,C00,098059,Williams; Ruth J,10,0,10,0
1667998076084,MATH 290B,A00,098060,Roberts; Justin Deritter,14,0,15,1
1667998076510,MATH 292,A00,098061,Belmont; Eva Kinoshita,10,0,10,0
1667998076934,MATH 295,A00,098062,Suk; Andrew Hoon,48,0,50,2
1667998077361,MATH 296,A00,098063,Novak; Jonathan I,20,0,20,0
1667998077793,MATH 297,001,098064,Gamst; Anthony Collins,9997,0,9999,2
1667998577902,COGS 205,A00,101395,Chiba; Andrea,19,0,20,1
1667998578327,COGS 210B,001,101404,Greene; Deanna Jacquelyn,9998,0,9999,1
1667998578327,COGS 210B,002,101417,Xia; Haijun,9999,0,9999,0
1667998578327,COGS 210B,003,101422,Nitz; Douglas A.,9999,0,9999,0
1667998578327,COGS 210B,004,101423,Hollan; James D.,9998,0,9999,1
1667998578327,COGS 210B,005,101424,Deak; Gedeon O.,9999,0,9999,0
1667998578327,COGS 210B,006,101425,Rossano; Federico,9999,0,9999,0
1667998578750,COGS 211B,A00,101427,Coulson; Seana M,9997,0,9999,2
1667998579175,COGS 220,A00,101428,Hollan; James D.,0,0,25,25
1667998579605,COGS 229,A00,101429,Dow; Steven P,18,0,25,7
1667998580040,COGS 230,A00,101430,Klemmer; Scott R,13,0,17,4
1667998580465,COGS 234,A00,101431,Xia; Haijun,7,0,25,18
1667998580891,COGS 260,A00,101432,Kiyonaga; Anastasia,20,0,25,5
1667998580891,COGS 260,B00,101433,Kirsh; David Joel,16,0,25,9
1667998581316,CSE 202,A00,102371,Impagliazzo; Russell,0,0,0,0
1667998581741,CSE 203B,A01,102373,Cheng; Chung Kuan,0,0,0,0
1667998582165,CSE 208,A00,102374,Micciancio; Daniele,0,0,0,0
1667998582593,CSE 209A,A00,112895,Impagliazzo; Russell,0,0,15,15
1667998583018,CSE 209B,A00,108005,Bellare; Mihir,0,0,0,0
1667998583451,CSE 210,A00,113163,Coblenz; Michael J,0,0,0,0
1667998583876,CSE 219,A00,106111,Dow; Steven P,0,0,20,20
1667998584299,CSE 221,A00,102376,Voelker; Geoffrey M.,0,0,0,0
1667998584722,CSE 224,A01,102378,Porter; George M,0,0,0,0
1667998585148,CSE 229A,A00,102379,Savage; Stefan,0,0,0,0
1667998585571,CSE 229C,A00,102380,Munyaka; Imani N. S.,0,0,0,0
1667998585996,CSE 232B,A00,102382,Deutsch; Alin Bernard,0,0,0,0
1667998586423,CSE 234,A01,112904,Kumar; Arun Kumar,0,0,0,0
1667998586850,CSE 237A,A00,102383,Rosing; Tajana Simunic,0,0,0,0
1667998587273,CSE 239A,A00,102384,Deutsch; Alin Bernard,0,0,0,0
1667998587695,CSE 239B,A00,102385,Polikarpova; Nadezhda,0,0,0,0
1667998588120,CSE 240A,A00,102386,Pannuto; Patrick William,0,0,0,0
1667998588545,CSE 240B,A00,102387,Zhao; Jishen,0,0,0,0
1667998588975,CSE 241A,A00,106406,Kang; Mingu,0,0,0,0
1667998589406,CSE 249B,A00,102388,Kahng; Andrew Byun,0,0,8,8
1667998589831,CSE 251B,A01,102392,Cottrell; Garrison W,0,0,0,0
1667998589831,CSE 251B,A02,102393,Cottrell; Garrison W,0,0,0,0
1667998590257,CSE 252B,A00,102394,Ochoa; Benjamin Lawrence,0,0,0,0
1667998590682,CSE 257,A01,102396,Gao; Sicun,0,0,0,0
1667998591107,CSE 272,A00,102397,Li; Tzumao,0,0,0,0
1667998591533,CSE 274,A00,111323,Chern; Albert Ren-Haur,0,0,0,0
1667998591956,CSE 282,A00,102398,Pevzner; Pavel Arkadjevich,0,0,0,0
1667998592381,CSE 284,A00,114175,Gymrek; Melissa Ann,0,0,0,0
1667998592809,CSE 290,A00,102399,Chandraker; Manmohan Krishna,0,0,0,0
1667998592809,CSE 290,B00,102400,Vaccaro; Kristen Marie,0,0,25,25
1667998592809,CSE 290,C00,102414,Pannuto; Patrick William,0,0,25,25
1667998592809,CSE 290,D00,102427,Pevzner; Pavel Arkadjevich,0,0,0,0
1667998592809,CSE 290,E00,102429,Zhao; Jishen,0,0,0,0
1667998592809,CSE 290,F00,102436,Tullsen; Dean Michael,0,0,0,0
1667998592809,CSE 290,G00,102440,Christensen; Henrik I,0,0,20,20
1667998593239,CSE 291,A00,102443,Su; Hao,0,0,0,0
1667998593239,CSE 291,B00,102448,Polikarpova; Nadezhda,0,0,0,0
1667998593239,CSE 291,C00,102453,Vaccaro; Kristen Marie,0,0,0,0
1667998593239,CSE 291,D00,111343,Savage; Stefan,0,0,0,0
1667998593239,CSE 291,E00,116474,Claffy; Kimberly Claire,0,0,0,0
1667998593239,CSE 291,F00,116479,Pasquale; Joseph,0,0,0,0
1667998593680,CSE 293,001,119111,Bafna; Vineet,9999,0,9999,0
1667998593680,CSE 293,002,119118,Bellare; Mihir,9999,0,9999,0
1667998593680,CSE 293,003,119122,Berg-Kirkpatrick; Taylor D,9999,0,9999,0
1667998593680,CSE 293,004,119135,Christensen; Henrik I,9999,0,9999,0
1667998593680,CSE 293,005,119142,Cottrell; Garrison W,9999,0,9999,0
1667998593680,CSE 293,006,119146,Deutsch; Alin Bernard,9999,0,9999,0
1667998593680,CSE 293,007,119159,Esmaeilzadeh; Hadi,9999,0,9999,0
1667998593680,CSE 293,008,119166,Freund; Yoav,9999,0,9999,0
1667998593680,CSE 293,009,119170,Griswold; William G.,9999,0,9999,0
1667998593680,CSE 293,010,119183,Gymrek; Melissa Ann,9999,0,9999,0
1667998593680,CSE 293,011,119190,Heninger; Nadia A,9999,0,9999,0
1667998593680,CSE 293,012,119230,Impagliazzo; Russell,9999,0,9999,0
1667998593680,CSE 293,013,119232,Jhala; Ranjit,9999,0,9999,0
1667998593680,CSE 293,014,119233,Kahng; Andrew Byun,9999,0,9999,0
1667998593680,CSE 293,015,119298,Kane; Daniel Mertz,9999,0,9999,0
1667998593680,CSE 293,016,119299,Kriegman; David J,9999,0,9999,0
1667998593680,CSE 293,017,119300,Kumar; Arun Kumar,9999,0,9999,0
1667998593680,CSE 293,018,119301,Lerner; Sorin,9999,0,9999,0
1667998593680,CSE 293,019,119302,Lovett; Shachar,9999,0,9999,0
1667998593680,CSE 293,020,119303,McAuley; Julian John,9999,0,9999,0
1667998593680,CSE 293,021,119304,Micciancio; Daniele,9999,0,9999,0
1667998593680,CSE 293,022,119367,Orailoglu; Alex,9999,0,9999,0
1667998593680,CSE 293,023,119382,Paturi; Ramamohan,9999,0,9999,0
1667998593680,CSE 293,024,119404,Polikarpova; Nadezhda,9999,0,9999,0
1667998593680,CSE 293,025,119406,Politz; Joseph Gibbs,9999,0,9999,0
1667998593680,CSE 293,026,119411,Porter; George M,9999,0,9999,0
1667998593680,CSE 293,027,119414,Porter; Leonard Emerson,9999,0,9999,0
1667998593680,CSE 293,028,119416,Ramamoorthi; Ravi,9999,0,9999,0
1667998593680,CSE 293,029,119417,Sahoo; Debashis,9999,0,9999,0
1667998593680,CSE 293,030,119420,Saul; Lawrence,9999,0,9999,0
1667998593680,CSE 293,031,119421,Savage; Stefan,9999,0,9999,0
1667998593680,CSE 293,032,119425,Schulze; Jurgen P.,9999,0,9999,0
1667998593680,CSE 293,033,119426,Snoeren; Alex C.,9999,0,9999,0
1667998593680,CSE 293,034,119428,Shang; Jingbo,9999,0,9999,0
1667998593680,CSE 293,035,119430,Stefan; Deian,9999,0,9999,0
1667998593680,CSE 293,036,119431,Su; Hao,9999,0,9999,0
1667998593680,CSE 293,037,119433,Swanson; Steven James,9999,0,9999,0
1667998593680,CSE 293,038,119435,Tullsen; Dean Michael,9999,0,9999,0
1667998593680,CSE 293,039,119483,Voelker; Geoffrey M.,9999,0,9999,0
1667998593680,CSE 293,040,119537,Zhao; Jishen,9999,0,9999,0
1667998593680,CSE 293,041,119538,Zhou; Yuan-Yuan,9999,0,9999,0
1667998593680,CSE 293,042,119539,Gao; Sicun,9999,0,9999,0
1667998593680,CSE 293,043,119540,Weibel; Nadir,9999,0,9999,0
1667998593680,CSE 293,044,119541,Gupta; Rajesh K.,9999,0,9999,0
1667998593680,CSE 293,045,126410,Vaccaro; Kristen Marie,9999,0,9999,0
1667998593680,CSE 293,046,126411,Klemke; Richard,9999,0,9999,0
1667998594106,CSE 294,A00,102459,Voelker; Geoffrey M.,0,0,0,0
1667998594106,CSE 294,B00,111322,Orailoglu; Alex,0,0,0,0
1667998594534,DSE 201,A00,096914,Deutsch; Alin Bernard,30,0,30,0
1667998594958,DSE 210,A00,096915,Dasgupta; Sanjoy,30,0,30,0
1667998595380,DSE 260A,A00,096916,Altintas De Callaf; Ilkay,30,0,30,0
1667998595820,ECE 200,001,103586,Antipa; Nicholas A,9999,0,9999,0
1667998595820,ECE 200,002,103587,Atanasov; Nikolay A.,9999,0,9999,0
1667998595820,ECE 200,003,103588,Bharadia; Dinesh,9999,0,9999,0
1667998595820,ECE 200,004,103589,Cheng; Chung Kuan,9999,0,9999,0
1667998595820,ECE 200,005,103590,Cosman; Pamela C.,9999,0,9999,0
1667998595820,ECE 200,006,103591,Dayeh; Shadi Ahmad,9999,0,9999,0
1667998595820,ECE 200,007,103592,Fainman; Yeshaiahu,9999,0,9999,0
1667998595820,ECE 200,008,103593,Ford; Joseph Earl,9999,0,9999,0
1667998595820,ECE 200,009,103594,Franceschetti; Massimo,9999,0,9999,0
1667998595820,ECE 200,010,103595,Fullerton; Eric E,9999,0,9999,0
1667998595820,ECE 200,011,103596,Galton; Ian A,9999,0,9999,0
1667998595820,ECE 200,012,103597,Gilja; Vikash,9999,0,9999,0
1667998595820,ECE 200,013,103598,Hall; Drew A.,9999,0,9999,0
1667998595820,ECE 200,014,103599,Hsueh; Tzu-Chien,9999,0,9999,0
1667998595820,ECE 200,015,103600,Javidi; Tara,9999,0,9999,0
1667998595820,ECE 200,016,103601,Kahng; Andrew Byun,9999,0,9999,0
1667998595820,ECE 200,017,103602,Kim; Young-Han,9999,0,9999,0
1667998595820,ECE 200,018,103603,Koushanfar; Farinaz,9999,0,9999,0
1667998595820,ECE 200,019,103604,Kuzum; Duygu,9999,0,9999,0
1667998595820,ECE 200,020,103605,Le; Hanh-Phuc,9999,0,9999,0
1667998595820,ECE 200,021,103606,Lin; Bill,9999,0,9999,0
1667998595820,ECE 200,022,103607,Liu; Zhaowei,9998,0,9999,1
1667998595820,ECE 200,023,103608,Lo; Yu-Hwa,9999,0,9999,0
1667998595820,ECE 200,024,103609,Lomakin; Vitaliy,9999,0,9999,0
1667998595820,ECE 200,025,103610,Mercier; Patrick Philip,9999,0,9999,0
1667998595820,ECE 200,026,103611,Meyer; Florian,9999,0,9999,0
1667998595820,ECE 200,027,103612,Milstein; Laurence B.,9999,0,9999,0
1667998595820,ECE 200,028,103613,Mir Arabbaygi; Siavash,9999,0,9999,0
1667998595820,ECE 200,029,103614,Mookherjea; Shayan,9999,0,9999,0
1667998595820,ECE 200,030,103615,Morris; Karcher William,9999,0,9999,0
1667998595820,ECE 200,031,103616,Ng; Tse Nga,9999,0,9999,0
1667998595820,ECE 200,032,103617,Nguyen; Truong Quang,9999,0,9999,0
1667998595820,ECE 200,033,103618,Nomura; Kenji,9999,0,9999,0
1667998595820,ECE 200,034,103619,Orlitsky; Alon,9999,0,9999,0
1667998595820,ECE 200,035,103620,Pal; Piya,9999,0,9999,0
1667998595820,ECE 200,036,103621,Papen; George C.,9999,0,9999,0
1667998595820,ECE 200,037,103622,Radic; Stojan,9999,0,9999,0
1667998595820,ECE 200,038,103623,Rao; Bhaskar D.,9999,0,9999,0
1667998595820,ECE 200,039,103624,Rao; Ramesh R,9999,0,9999,0
1667998595820,ECE 200,040,103625,Rebeiz; Gabriel,9999,0,9999,0
1667998595820,ECE 200,041,103626,Sanford; John R,9999,0,9999,0
1667998595820,ECE 200,042,103627,Siegel; Paul H.,9999,0,9999,0
1667998595820,ECE 200,043,103628,Sievenpiper; Daniel F.,9999,0,9999,0
1667998595820,ECE 200,044,103629,Sworder; David D.,9999,0,9999,0
1667998595820,ECE 200,045,103630,Taur; Yuan,9999,0,9999,0
1667998595820,ECE 200,046,103631,Touri; Behrouz,9999,0,9999,0
1667998595820,ECE 200,047,103632,Trivedi; Mohan M.,9999,0,9999,0
1667998595820,ECE 200,048,103633,Vasconcelos; Nuno,9999,0,9999,0
1667998595820,ECE 200,049,103634,Wang; Xiaolong,9999,0,9999,0
1667998595820,ECE 200,050,103635,Xie; Pengtao,9999,0,9999,0
1667998595820,ECE 200,051,103636,Yip; Michael,9999,0,9999,0
1667998595820,ECE 200,052,103637,Zeger; Kenneth A.,999,0,999,0
1667998595820,ECE 200,053,103638,Zhang; Xinyu,9999,0,9999,0
1667998595820,ECE 200,054,103639,Turakhia; Yatish Girish,9999,0,9999,0
1667998595820,ECE 200,055,103640,Kang; Mingu,9999,0,9999,0
1667998595820,ECE 200,056,103641,Shi; Yuanyuan,9999,0,9999,0
1667998595820,ECE 200,057,103642,Wang; Edward Jay,9999,0,9999,0
1667998595820,ECE 200,058,103643,Zheng; Yang,9999,0,9999,0
1667998596245,ECE 202,A00,103644,Kuzum; Duygu,0,0,0,0
1667998596668,ECE 212BN,A00,103646,Ng; Tse Nga,0,0,0,0
1667998597092,ECE 221,A00,111493,Staff,0,0,0,0
1667998597518,ECE 222B,A00,103647,Lomakin; Vitaliy,0,0,0,0
1667998597945,ECE 230B,A00,103648,Taur; Yuan,0,0,0,0
1667998598370,ECE 238B,A00,103649,Garay; Javier,0,0,0,0
1667998598795,ECE 240B,A00,112900,Fainman; Yeshaiahu,0,0,0,0
1667998599221,ECE 247A,A00,103650,Jokerst; Jesse Vincent,0,0,0,0
1667998599647,ECE 247B,A00,103651,Wang; Joseph,0,0,0,0
1667998600070,ECE 250,A00,103652,Siegel; Paul H.,0,0,0,0
1667998600494,ECE 251A,A00,103654,Rao; Bhaskar D.,0,0,0,0
1667998600922,ECE 257B,A00,103655,Bharadia; Dinesh,0,0,0,0
1667998601345,ECE 258A,A00,103656,Milstein; Laurence B.,0,0,0,0
1667998601773,ECE 260B,A00,103658,Kang; Mingu,0,0,0,0
1667998602196,ECE 264A,A00,103659,Galton; Ian A,0,0,0,0
1667998602619,ECE 265A,A00,103661,Gudem; Prasad S.S.,0,0,0,0
1667998603048,ECE 265D,A00,103662,Gudem; Prasad S.S.,0,0,0,0
1667998603476,ECE 268,A00,103663,Koushanfar; Farinaz,0,0,0,0
1667998603997,ECE 269,A01,103665,Pal; Piya,0,0,0,0
1667998604421,ECE 271B,A00,103666,Vasconcelos; Manuela,0,0,0,0
1667998604847,ECE 276A,A00,103667,Atanasov; Nikolay A.,0,0,0,0
1667998605273,ECE 277,A00,103668,An; Cheolhong,0,0,0,0
1667998605699,ECE 279,A00,117947,Hall; Drew A.,0,0,0,0
1667998606548,ECE 283,A00,103670,Hsueh; Tzu-Chien,0,0,0,0
1667998606969,ECE 284,A00,103671,Turakhia; Yatish Girish,0,0,0,0
1667998607397,ECE 285,A00,103672,Zheng; Yang,0,0,0,0
1667998607397,ECE 285,B00,103673,Sworder; David D.,0,0,0,0
1667998607822,ECE 287,A00,103676,Javidi; Tara,0,0,0,0
1667998608247,MATH 200B,A00,098023,Salehi Golsefidy; Alireza,14,0,15,1
1667998608675,MATH 202B,A00,098024,Rhoades; Brendon Patrick,12,0,15,3
1667998609098,MATH 203B,A00,098025,Oprea; Dragos N.,12,0,15,3
1667998609524,MATH 204B,A00,098026,Sorensen; Claus M,14,0,15,1
1667998609948,MATH 208,A00,098027,Izadi; Elham,7,0,10,3
1667998610373,MATH 209,A00,098028,Pollack; Aaron,10,0,10,0
1667998610808,MATH 211A,A00,112919,Rogalski; Daniel,9,0,10,1
1667998611234,MATH 211B,A00,112920,Seward; Brandon M.,9,0,10,1
1667998611658,MATH 218,A00,098029,Li; Bo,10,0,10,0
1667998612081,MATH 220B,A00,098030,Novak; Jonathan I,13,0,15,2
1667998612506,MATH 221A,A00,098031,Ebenfelt; Peter F,13,0,15,2
1667998612929,MATH 231B,A00,098032,Zlatos; Andrej,12,0,15,3
1667998613352,MATH 240B,A00,098033,Ni; Lei,10,0,15,5
1667998613777,MATH 243,A00,098034,Jekel; David Andrew,10,0,10,0
1667998614205,MATH 245A,A00,098035,Nie; Jiawang,0,0,15,16
1667998614629,MATH 248,A00,098036,Bejenaru; Ioan,10,0,10,0
1667998615055,MATH 250B,A00,098037,Spolaor; Luca,14,0,15,1
1667998615479,MATH 258,A00,098038,Ni; Lei,10,0,10,0
1667998615902,MATH 264B,A00,098041,Rhoades; Brendon Patrick,11,0,15,4
1667998616327,MATH 268,A00,098042,Buss; Samuel R,10,0,10,0
1667998616749,MATH 269,A00,098043,Rhoades; Brendon Patrick,10,0,10,0
1667998617177,MATH 270B,A00,098044,Li; Bo,11,0,15,4
1667998617603,MATH 272B,A00,098045,Holst; Michael J,13,0,15,2
1667998618029,MATH 273A,A00,098046,Tian; Xiaochuan,12,0,15,3
1667998618458,MATH 275,A01,098048,Tian; Xiaochuan,6,0,10,4
1667998618881,MATH 278A,A00,098049,Holst; Michael J,8,0,10,2
1667998619305,MATH 278B,A00,098050,Cloninger; Alexander,10,0,10,0
1667998619728,MATH 278C,A00,098051,Nie; Jiawang,8,0,10,2
1667998620153,MATH 280B,A00,098052,Zheng; Tianyi,11,0,15,4
1667998620579,MATH 281B,A00,098053,Bradic; Jelena,4,0,15,11
1667998621002,MATH 282B,A00,098054,Arias-Castro; Ery,2,0,15,13
1667998621426,MATH 285,A00,098055,Fitzsimmons; Patrick J,0,0,15,17
1667998621851,MATH 287B,A00,098056,Arias-Castro; Ery,5,0,15,10
1667998622277,MATH 288,A00,098057,Agarwal; Pooja,9,0,10,1
1667998622277,MATH 288,B00,098058,Zhang; Danna,9,0,10,1
1667998622277,MATH 288,C00,098059,Williams; Ruth J,10,0,10,0
1667998622701,MATH 290B,A00,098060,Roberts; Justin Deritter,14,0,15,1
1667998623124,MATH 292,A00,098061,Belmont; Eva Kinoshita,10,0,10,0
1667998623548,MATH 295,A00,098062,Suk; Andrew Hoon,48,0,50,2
1667998623989,MATH 296,A00,098063,Novak; Jonathan I,20,0,20,0
1667998624413,MATH 297,001,098064,Gamst; Anthony Collins,9997,0,9999,2
1667999123698,COGS 205,A00,101395,Chiba; Andrea,19,0,20,1
1667999124121,COGS 210B,001,101404,Greene; Deanna Jacquelyn,9998,0,9999,1
1667999124121,COGS 210B,002,101417,Xia; Haijun,9999,0,9999,0
1667999124121,COGS 210B,003,101422,Nitz; Douglas A.,9999,0,9999,0
1667999124121,COGS 210B,004,101423,Hollan; James D.,9998,0,9999,1
1667999124121,COGS 210B,005,101424,Deak; Gedeon O.,9999,0,9999,0
1667999124121,COGS 210B,006,101425,Rossano; Federico,9999,0,9999,0
1667999124542,COGS 211B,A00,101427,Coulson; Seana M,9997,0,9999,2
1667999124966,COGS 220,A00,101428,Hollan; James D.,0,0,25,25
1667999125392,COGS 229,A00,101429,Dow; Steven P,18,0,25,7
1667999125818,COGS 230,A00,101430,Klemmer; Scott R,13,0,17,4
1667999126247,COGS 234,A00,101431,Xia; Haijun,7,0,25,18
1667999126672,COGS 260,A00,101432,Kiyonaga; Anastasia,20,0,25,5
1667999126672,COGS 260,B00,101433,Kirsh; David Joel,16,0,25,9
1667999127095,CSE 202,A00,102371,Impagliazzo; Russell,0,0,0,0
1667999127521,CSE 203B,A01,102373,Cheng; Chung Kuan,0,0,0,0
1667999127944,CSE 208,A00,102374,Micciancio; Daniele,0,0,0,0
1667999128370,CSE 209A,A00,112895,Impagliazzo; Russell,0,0,15,15
1667999128797,CSE 209B,A00,108005,Bellare; Mihir,0,0,0,0
1667999129220,CSE 210,A00,113163,Coblenz; Michael J,0,0,0,0
1667999129643,CSE 219,A00,106111,Dow; Steven P,0,0,20,20
1667999130069,CSE 221,A00,102376,Voelker; Geoffrey M.,0,0,0,0
1667999130492,CSE 224,A01,102378,Porter; George M,0,0,0,0
1667999130915,CSE 229A,A00,102379,Savage; Stefan,0,0,0,0
1667999131340,CSE 229C,A00,102380,Munyaka; Imani N. S.,0,0,0,0
1667999131763,CSE 232B,A00,102382,Deutsch; Alin Bernard,0,0,0,0
1667999132188,CSE 234,A01,112904,Kumar; Arun Kumar,0,0,0,0
1667999132612,CSE 237A,A00,102383,Rosing; Tajana Simunic,0,0,0,0
1667999133035,CSE 239A,A00,102384,Deutsch; Alin Bernard,0,0,0,0
1667999133460,CSE 239B,A00,102385,Polikarpova; Nadezhda,0,0,0,0
1667999133890,CSE 240A,A00,102386,Pannuto; Patrick William,0,0,0,0
1667999134315,CSE 240B,A00,102387,Zhao; Jishen,0,0,0,0
1667999134743,CSE 241A,A00,106406,Kang; Mingu,0,0,0,0
1667999135169,CSE 249B,A00,102388,Kahng; Andrew Byun,0,0,8,8
1667999135593,CSE 251B,A01,102392,Cottrell; Garrison W,0,0,0,0
1667999135593,CSE 251B,A02,102393,Cottrell; Garrison W,0,0,0,0
1667999136018,CSE 252B,A00,102394,Ochoa; Benjamin Lawrence,0,0,0,0
1667999136440,CSE 257,A01,102396,Gao; Sicun,0,0,0,0
1667999136863,CSE 272,A00,102397,Li; Tzumao,0,0,0,0
1667999137288,CSE 274,A00,111323,Chern; Albert Ren-Haur,0,0,0,0
1667999137711,CSE 282,A00,102398,Pevzner; Pavel Arkadjevich,0,0,0,0
1667999138136,CSE 284,A00,114175,Gymrek; Melissa Ann,0,0,0,0
1667999138560,CSE 290,A00,102399,Chandraker; Manmohan Krishna,0,0,0,0
1667999138560,CSE 290,B00,102400,Vaccaro; Kristen Marie,0,0,25,25
1667999138560,CSE 290,C00,102414,Pannuto; Patrick William,0,0,25,25
1667999138560,CSE 290,D00,102427,Pevzner; Pavel Arkadjevich,0,0,0,0
1667999138560,CSE 290,E00,102429,Zhao; Jishen,0,0,0,0
1667999138560,CSE 290,F00,102436,Tullsen; Dean Michael,0,0,0,0
1667999138560,CSE 290,G00,102440,Christensen; Henrik I,0,0,20,20
1667999138983,CSE 291,A00,102443,Su; Hao,0,0,0,0
1667999138983,CSE 291,B00,102448,Polikarpova; Nadezhda,0,0,0,0
1667999138983,CSE 291,C00,102453,Vaccaro; Kristen Marie,0,0,0,0
1667999138983,CSE 291,D00,111343,Savage; Stefan,0,0,0,0
1667999138983,CSE 291,E00,116474,Claffy; Kimberly Claire,0,0,0,0
1667999138983,CSE 291,F00,116479,Pasquale; Joseph,0,0,0,0
1667999139422,CSE 293,001,119111,Bafna; Vineet,9999,0,9999,0
1667999139422,CSE 293,002,119118,Bellare; Mihir,9999,0,9999,0
1667999139422,CSE 293,003,119122,Berg-Kirkpatrick; Taylor D,9999,0,9999,0
1667999139422,CSE 293,004,119135,Christensen; Henrik I,9999,0,9999,0
1667999139422,CSE 293,005,119142,Cottrell; Garrison W,9999,0,9999,0
1667999139422,CSE 293,006,119146,Deutsch; Alin Bernard,9999,0,9999,0
1667999139422,CSE 293,007,119159,Esmaeilzadeh; Hadi,9999,0,9999,0
1667999139422,CSE 293,008,119166,Freund; Yoav,9999,0,9999,0
1667999139422,CSE 293,009,119170,Griswold; William G.,9999,0,9999,0
1667999139422,CSE 293,010,119183,Gymrek; Melissa Ann,9999,0,9999,0
1667999139422,CSE 293,011,119190,Heninger; Nadia A,9999,0,9999,0
1667999139422,CSE 293,012,119230,Impagliazzo; Russell,9999,0,9999,0
1667999139422,CSE 293,013,119232,Jhala; Ranjit,9999,0,9999,0
1667999139422,CSE 293,014,119233,Kahng; Andrew Byun,9999,0,9999,0
1667999139422,CSE 293,015,119298,Kane; Daniel Mertz,9999,0,9999,0
1667999139422,CSE 293,016,119299,Kriegman; David J,9999,0,9999,0
1667999139422,CSE 293,017,119300,Kumar; Arun Kumar,9999,0,9999,0
1667999139422,CSE 293,018,119301,Lerner; Sorin,9999,0,9999,0
1667999139422,CSE 293,019,119302,Lovett; Shachar,9999,0,9999,0
1667999139422,CSE 293,020,119303,McAuley; Julian John,9999,0,9999,0
1667999139422,CSE 293,021,119304,Micciancio; Daniele,9999,0,9999,0
1667999139422,CSE 293,022,119367,Orailoglu; Alex,9999,0,9999,0
1667999139422,CSE 293,023,119382,Paturi; Ramamohan,9999,0,9999,0
1667999139422,CSE 293,024,119404,Polikarpova; Nadezhda,9999,0,9999,0
1667999139422,CSE 293,025,119406,Politz; Joseph Gibbs,9999,0,9999,0
1667999139422,CSE 293,026,119411,Porter; George M,9999,0,9999,0
1667999139422,CSE 293,027,119414,Porter; Leonard Emerson,9999,0,9999,0
1667999139422,CSE 293,028,119416,Ramamoorthi; Ravi,9999,0,9999,0
1667999139422,CSE 293,029,119417,Sahoo; Debashis,9999,0,9999,0
1667999139422,CSE 293,030,119420,Saul; Lawrence,9999,0,9999,0
1667999139422,CSE 293,031,119421,Savage; Stefan,9999,0,9999,0
1667999139422,CSE 293,032,119425,Schulze; Jurgen P.,9999,0,9999,0
1667999139422,CSE 293,033,119426,Snoeren; Alex C.,9999,0,9999,0
1667999139422,CSE 293,034,119428,Shang; Jingbo,9999,0,9999,0
1667999139422,CSE 293,035,119430,Stefan; Deian,9999,0,9999,0
1667999139422,CSE 293,036,119431,Su; Hao,9999,0,9999,0
1667999139422,CSE 293,037,119433,Swanson; Steven James,9999,0,9999,0
1667999139422,CSE 293,038,119435,Tullsen; Dean Michael,9999,0,9999,0
1667999139422,CSE 293,039,119483,Voelker; Geoffrey M.,9999,0,9999,0
1667999139422,CSE 293,040,119537,Zhao; Jishen,9999,0,9999,0
1667999139422,CSE 293,041,119538,Zhou; Yuan-Yuan,9999,0,9999,0
1667999139422,CSE 293,042,119539,Gao; Sicun,9999,0,9999,0
1667999139422,CSE 293,043,119540,Weibel; Nadir,9999,0,9999,0
1667999139422,CSE 293,044,119541,Gupta; Rajesh K.,9999,0,9999,0
1667999139422,CSE 293,045,126410,Vaccaro; Kristen Marie,9999,0,9999,0
1667999139422,CSE 293,046,126411,Klemke; Richard,9999,0,9999,0
1667999139845,CSE 294,A00,102459,Voelker; Geoffrey M.,0,0,0,0
1667999139845,CSE 294,B00,111322,Orailoglu; Alex,0,0,0,0
1667999140270,DSE 201,A00,096914,Deutsch; Alin Bernard,30,0,30,0
1667999140693,DSE 210,A00,096915,Dasgupta; Sanjoy,30,0,30,0
1667999141116,DSE 260A,A00,096916,Altintas De Callaf; Ilkay,30,0,30,0
1667999141547,ECE 200,001,103586,Antipa; Nicholas A,9999,0,9999,0
1667999141547,ECE 200,002,103587,Atanasov; Nikolay A.,9999,0,9999,0
1667999141547,ECE 200,003,103588,Bharadia; Dinesh,9999,0,9999,0
1667999141547,ECE 200,004,103589,Cheng; Chung Kuan,9999,0,9999,0
1667999141547,ECE 200,005,103590,Cosman; Pamela C.,9999,0,9999,0
1667999141547,ECE 200,006,103591,Dayeh; Shadi Ahmad,9999,0,9999,0
1667999141547,ECE 200,007,103592,Fainman; Yeshaiahu,9999,0,9999,0
1667999141547,ECE 200,008,103593,Ford; Joseph Earl,9999,0,9999,0
1667999141547,ECE 200,009,103594,Franceschetti; Massimo,9999,0,9999,0
1667999141547,ECE 200,010,103595,Fullerton; Eric E,9999,0,9999,0
1667999141547,ECE 200,011,103596,Galton; Ian A,9999,0,9999,0
1667999141547,ECE 200,012,103597,Gilja; Vikash,9999,0,9999,0
1667999141547,ECE 200,013,103598,Hall; Drew A.,9999,0,9999,0
1667999141547,ECE 200,014,103599,Hsueh; Tzu-Chien,9999,0,9999,0
1667999141547,ECE 200,015,103600,Javidi; Tara,9999,0,9999,0
1667999141547,ECE 200,016,103601,Kahng; Andrew Byun,9999,0,9999,0
1667999141547,ECE 200,017,103602,Kim; Young-Han,9999,0,9999,0
1667999141547,ECE 200,018,103603,Koushanfar; Farinaz,9999,0,9999,0
1667999141547,ECE 200,019,103604,Kuzum; Duygu,9999,0,9999,0
1667999141547,ECE 200,020,103605,Le; Hanh-Phuc,9999,0,9999,0
1667999141547,ECE 200,021,103606,Lin; Bill,9999,0,9999,0
1667999141547,ECE 200,022,103607,Liu; Zhaowei,9998,0,9999,1
1667999141547,ECE 200,023,103608,Lo; Yu-Hwa,9999,0,9999,0
1667999141547,ECE 200,024,103609,Lomakin; Vitaliy,9999,0,9999,0
1667999141547,ECE 200,025,103610,Mercier; Patrick Philip,9999,0,9999,0
1667999141547,ECE 200,026,103611,Meyer; Florian,9999,0,9999,0
1667999141547,ECE 200,027,103612,Milstein; Laurence B.,9999,0,9999,0
1667999141547,ECE 200,028,103613,Mir Arabbaygi; Siavash,9999,0,9999,0
1667999141547,ECE 200,029,103614,Mookherjea; Shayan,9999,0,9999,0
1667999141547,ECE 200,030,103615,Morris; Karcher William,9999,0,9999,0
1667999141547,ECE 200,031,103616,Ng; Tse Nga,9999,0,9999,0
1667999141547,ECE 200,032,103617,Nguyen; Truong Quang,9999,0,9999,0
1667999141547,ECE 200,033,103618,Nomura; Kenji,9999,0,9999,0
1667999141547,ECE 200,034,103619,Orlitsky; Alon,9999,0,9999,0
1667999141547,ECE 200,035,103620,Pal; Piya,9999,0,9999,0
1667999141547,ECE 200,036,103621,Papen; George C.,9999,0,9999,0
1667999141547,ECE 200,037,103622,Radic; Stojan,9999,0,9999,0
1667999141547,ECE 200,038,103623,Rao; Bhaskar D.,9999,0,9999,0
1667999141547,ECE 200,039,103624,Rao; Ramesh R,9999,0,9999,0
1667999141547,ECE 200,040,103625,Rebeiz; Gabriel,9999,0,9999,0
1667999141547,ECE 200,041,103626,Sanford; John R,9999,0,9999,0
1667999141547,ECE 200,042,103627,Siegel; Paul H.,9999,0,9999,0
1667999141547,ECE 200,043,103628,Sievenpiper; Daniel F.,9999,0,9999,0
1667999141547,ECE 200,044,103629,Sworder; David D.,9999,0,9999,0
1667999141547,ECE 200,045,103630,Taur; Yuan,9999,0,9999,0
1667999141547,ECE 200,046,103631,Touri; Behrouz,9999,0,9999,0
1667999141547,ECE 200,047,103632,Trivedi; Mohan M.,9999,0,9999,0
1667999141547,ECE 200,048,103633,Vasconcelos; Nuno,9999,0,9999,0
1667999141547,ECE 200,049,103634,Wang; Xiaolong,9999,0,9999,0
1667999141547,ECE 200,050,103635,Xie; Pengtao,9999,0,9999,0
1667999141547,ECE 200,051,103636,Yip; Michael,9999,0,9999,0
1667999141547,ECE 200,052,103637,Zeger; Kenneth A.,999,0,999,0
1667999141547,ECE 200,053,103638,Zhang; Xinyu,9999,0,9999,0
1667999141547,ECE 200,054,103639,Turakhia; Yatish Girish,9999,0,9999,0
1667999141547,ECE 200,055,103640,Kang; Mingu,9999,0,9999,0
1667999141547,ECE 200,056,103641,Shi; Yuanyuan,9999,0,9999,0
1667999141547,ECE 200,057,103642,Wang; Edward Jay,9999,0,9999,0
1667999141547,ECE 200,058,103643,Zheng; Yang,9999,0,9999,0
1667999141970,ECE 202,A00,103644,Kuzum; Duygu,0,0,0,0
1667999142393,ECE 212BN,A00,103646,Ng; Tse Nga,0,0,0,0
1667999142816,ECE 221,A00,111493,Staff,0,0,0,0
1667999143239,ECE 222B,A00,103647,Lomakin; Vitaliy,0,0,0,0
1667999143666,ECE 230B,A00,103648,Taur; Yuan,0,0,0,0
1667999144092,ECE 238B,A00,103649,Garay; Javier,0,0,0,0
1667999144517,ECE 240B,A00,112900,Fainman; Yeshaiahu,0,0,0,0
1667999144945,ECE 247A,A00,103650,Jokerst; Jesse Vincent,0,0,0,0
1667999145369,ECE 247B,A00,103651,Wang; Joseph,0,0,0,0
1667999145793,ECE 250,A00,103652,Siegel; Paul H.,0,0,0,0
1667999146218,ECE 251A,A00,103654,Rao; Bhaskar D.,0,0,0,0
1667999146650,ECE 257B,A00,103655,Bharadia; Dinesh,0,0,0,0
1667999147076,ECE 258A,A00,103656,Milstein; Laurence B.,0,0,0,0
1667999147498,ECE 260B,A00,103658,Kang; Mingu,0,0,0,0
1667999147928,ECE 264A,A00,103659,Galton; Ian A,0,0,0,0
1667999148352,ECE 265A,A00,103661,Gudem; Prasad S.S.,0,0,0,0
1667999148778,ECE 265D,A00,103662,Gudem; Prasad S.S.,0,0,0,0
1667999149201,ECE 268,A00,103663,Koushanfar; Farinaz,0,0,0,0
1667999149624,ECE 269,A01,103665,Pal; Piya,0,0,0,0
1667999150050,ECE 271B,A00,103666,Vasconcelos; Manuela,0,0,0,0
1667999150474,ECE 276A,A00,103667,Atanasov; Nikolay A.,0,0,0,0
1667999150903,ECE 277,A00,103668,An; Cheolhong,0,0,0,0
1667999151333,ECE 279,A00,117947,Hall; Drew A.,0,0,0,0
1667999152182,ECE 283,A00,103670,Hsueh; Tzu-Chien,0,0,0,0
1667999152611,ECE 284,A00,103671,Turakhia; Yatish Girish,0,0,0,0
1667999153035,ECE 285,A00,103672,Zheng; Yang,0,0,0,0
1667999153035,ECE 285,B00,103673,Sworder; David D.,0,0,0,0
1667999153457,ECE 287,A00,103676,Javidi; Tara,0,0,0,0
1667999153880,MATH 200B,A00,098023,Salehi Golsefidy; Alireza,14,0,15,1
1667999154305,MATH 202B,A00,098024,Rhoades; Brendon Patrick,12,0,15,3
1667999154730,MATH 203B,A00,098025,Oprea; Dragos N.,12,0,15,3
1667999155153,MATH 204B,A00,098026,Sorensen; Claus M,14,0,15,1
1667999155577,MATH 208,A00,098027,Izadi; Elham,7,0,10,3
1667999156005,MATH 209,A00,098028,Pollack; Aaron,10,0,10,0
1667999156430,MATH 211A,A00,112919,Rogalski; Daniel,9,0,10,1
1667999156865,MATH 211B,A00,112920,Seward; Brandon M.,9,0,10,1
1667999157291,MATH 218,A00,098029,Li; Bo,10,0,10,0
1667999157713,MATH 220B,A00,098030,Novak; Jonathan I,13,0,15,2
1667999158141,MATH 221A,A00,098031,Ebenfelt; Peter F,13,0,15,2
1667999158568,MATH 231B,A00,098032,Zlatos; Andrej,12,0,15,3
1667999158998,MATH 240B,A00,098033,Ni; Lei,10,0,15,5
1667999159425,MATH 243,A00,098034,Jekel; David Andrew,10,0,10,0
1667999159851,MATH 245A,A00,098035,Nie; Jiawang,0,0,15,16
1667999160275,MATH 248,A00,098036,Bejenaru; Ioan,10,0,10,0
1667999160699,MATH 250B,A00,098037,Spolaor; Luca,14,0,15,1
1667999161124,MATH 258,A00,098038,Ni; Lei,10,0,10,0
1667999161553,MATH 264B,A00,098041,Rhoades; Brendon Patrick,11,0,15,4
1667999161976,MATH 268,A00,098042,Buss; Samuel R,10,0,10,0
1667999162406,MATH 269,A00,098043,Rhoades; Brendon Patrick,10,0,10,0
1667999162828,MATH 270B,A00,098044,Li; Bo,11,0,15,4
1667999163254,MATH 272B,A00,098045,Holst; Michael J,13,0,15,2
1667999163686,MATH 273A,A00,098046,Tian; Xiaochuan,12,0,15,3
1667999164110,MATH 275,A01,098048,Tian; Xiaochuan,6,0,10,4
1667999164532,MATH 278A,A00,098049,Holst; Michael J,8,0,10,2
1667999164955,MATH 278B,A00,098050,Cloninger; Alexander,10,0,10,0
1667999165378,MATH 278C,A00,098051,Nie; Jiawang,8,0,10,2
1667999165803,MATH 280B,A00,098052,Zheng; Tianyi,11,0,15,4
1667999166327,MATH 281B,A00,098053,Bradic; Jelena,4,0,15,11
1667999166753,MATH 282B,A00,098054,Arias-Castro; Ery,2,0,15,13
1667999167184,MATH 285,A00,098055,Fitzsimmons; Patrick J,0,0,15,17
1667999167607,MATH 287B,A00,098056,Arias-Castro; Ery,5,0,15,10
1667999168030,MATH 288,A00,098057,Agarwal; Pooja,9,0,10,1
1667999168030,MATH 288,B00,098058,Zhang; Danna,9,0,10,1
1667999168030,MATH 288,C00,098059,Williams; Ruth J,10,0,10,0
1667999168453,MATH 290B,A00,098060,Roberts; Justin Deritter,14,0,15,1
1667999168881,MATH 292,A00,098061,Belmont; Eva Kinoshita,10,0,10,0
1667999169315,MATH 295,A00,098062,Suk; Andrew Hoon,48,0,50,2
1667999169740,MATH 296,A00,098063,Novak; Jonathan I,20,0,20,0
1667999170166,MATH 297,001,098064,Gamst; Anthony Collins,9997,0,9999,2
1667999668940,COGS 205,A00,101395,Chiba; Andrea,19,0,20,1
1667999669366,COGS 210B,001,101404,Greene; Deanna Jacquelyn,9998,0,9999,1
1667999669366,COGS 210B,002,101417,Xia; Haijun,9999,0,9999,0
1667999669366,COGS 210B,003,101422,Nitz; Douglas A.,9999,0,9999,0
1667999669366,COGS 210B,004,101423,Hollan; James D.,9998,0,9999,1
1667999669366,COGS 210B,005,101424,Deak; Gedeon O.,9999,0,9999,0
1667999669366,COGS 210B,006,101425,Rossano; Federico,9999,0,9999,0
1667999669792,COGS 211B,A00,101427,Coulson; Seana M,9997,0,9999,2
1667999670224,COGS 220,A00,101428,Hollan; James D.,0,0,25,25
1667999670653,COGS 229,A00,101429,Dow; Steven P,18,0,25,7
1667999671077,COGS 230,A00,101430,Klemmer; Scott R,13,0,17,4
1667999671498,COGS 234,A00,101431,Xia; Haijun,7,0,25,18
1667999671921,COGS 260,A00,101432,Kiyonaga; Anastasia,20,0,25,5
1667999671921,COGS 260,B00,101433,Kirsh; David Joel,16,0,25,9
1667999672344,CSE 202,A00,102371,Impagliazzo; Russell,0,0,0,0
1667999672768,CSE 203B,A01,102373,Cheng; Chung Kuan,0,0,0,0
1667999673192,CSE 208,A00,102374,Micciancio; Daniele,0,0,0,0
1667999673614,CSE 209A,A00,112895,Impagliazzo; Russell,0,0,15,15
1667999674042,CSE 209B,A00,108005,Bellare; Mihir,0,0,0,0
1667999674467,CSE 210,A00,113163,Coblenz; Michael J,0,0,0,0
1667999674894,CSE 219,A00,106111,Dow; Steven P,0,0,20,20
1667999675317,CSE 221,A00,102376,Voelker; Geoffrey M.,0,0,0,0
1667999675741,CSE 224,A01,102378,Porter; George M,0,0,0,0
1667999676165,CSE 229A,A00,102379,Savage; Stefan,0,0,0,0
1667999676589,CSE 229C,A00,102380,Munyaka; Imani N. S.,0,0,0,0
1667999677012,CSE 232B,A00,102382,Deutsch; Alin Bernard,0,0,0,0
1667999677436,CSE 234,A01,112904,Kumar; Arun Kumar,0,0,0,0
1667999677863,CSE 237A,A00,102383,Rosing; Tajana Simunic,0,0,0,0
1667999678288,CSE 239A,A00,102384,Deutsch; Alin Bernard,0,0,0,0
1667999678713,CSE 239B,A00,102385,Polikarpova; Nadezhda,0,0,0,0
1667999679137,CSE 240A,A00,102386,Pannuto; Patrick William,0,0,0,0
1667999679567,CSE 240B,A00,102387,Zhao; Jishen,0,0,0,0
1667999679992,CSE 241A,A00,106406,Kang; Mingu,0,0,0,0
1667999680414,CSE 249B,A00,102388,Kahng; Andrew Byun,0,0,8,8
1667999680843,CSE 251B,A01,102392,Cottrell; Garrison W,0,0,0,0
1667999680843,CSE 251B,A02,102393,Cottrell; Garrison W,0,0,0,0
1667999681269,CSE 252B,A00,102394,Ochoa; Benjamin Lawrence,0,0,0,0
1667999681691,CSE 257,A01,102396,Gao; Sicun,0,0,0,0
1667999682116,CSE 272,A00,102397,Li; Tzumao,0,0,0,0
1667999682549,CSE 274,A00,111323,Chern; Albert Ren-Haur,0,0,0,0
1667999682979,CSE 282,A00,102398,Pevzner; Pavel Arkadjevich,0,0,0,0
1667999683402,CSE 284,A00,114175,Gymrek; Melissa Ann,0,0,0,0
1667999683829,CSE 290,A00,102399,Chandraker; Manmohan Krishna,0,0,0,0
1667999683829,CSE 290,B00,102400,Vaccaro; Kristen Marie,0,0,25,25
1667999683829,CSE 290,C00,102414,Pannuto; Patrick William,0,0,25,25
1667999683829,CSE 290,D00,102427,Pevzner; Pavel Arkadjevich,0,0,0,0
1667999683829,CSE 290,E00,102429,Zhao; Jishen,0,0,0,0
1667999683829,CSE 290,F00,102436,Tullsen; Dean Michael,0,0,0,0
1667999683829,CSE 290,G00,102440,Christensen; Henrik I,0,0,20,20
1667999684254,CSE 291,A00,102443,Su; Hao,0,0,0,0
1667999684254,CSE 291,B00,102448,Polikarpova; Nadezhda,0,0,0,0
1667999684254,CSE 291,C00,102453,Vaccaro; Kristen Marie,0,0,0,0
1667999684254,CSE 291,D00,111343,Savage; Stefan,0,0,0,0
1667999684254,CSE 291,E00,116474,Claffy; Kimberly Claire,0,0,0,0
1667999684254,CSE 291,F00,116479,Pasquale; Joseph,0,0,0,0
1667999684691,CSE 293,001,119111,Bafna; Vineet,9999,0,9999,0
1667999684691,CSE 293,002,119118,Bellare; Mihir,9999,0,9999,0
1667999684691,CSE 293,003,119122,Berg-Kirkpatrick; Taylor D,9999,0,9999,0
1667999684691,CSE 293,004,119135,Christensen; Henrik I,9999,0,9999,0
1667999684691,CSE 293,005,119142,Cottrell; Garrison W,9999,0,9999,0
1667999684691,CSE 293,006,119146,Deutsch; Alin Bernard,9999,0,9999,0
1667999684691,CSE 293,007,119159,Esmaeilzadeh; Hadi,9999,0,9999,0
1667999684691,CSE 293,008,119166,Freund; Yoav,9999,0,9999,0
1667999684691,CSE 293,009,119170,Griswold; William G.,9999,0,9999,0
1667999684691,CSE 293,010,119183,Gymrek; Melissa Ann,9999,0,9999,0
1667999684691,CSE 293,011,119190,Heninger; Nadia A,9999,0,9999,0
1667999684691,CSE 293,012,119230,Impagliazzo; Russell,9999,0,9999,0
1667999684691,CSE 293,013,119232,Jhala; Ranjit,9999,0,9999,0
1667999684691,CSE 293,014,119233,Kahng; Andrew Byun,9999,0,9999,0
1667999684691,CSE 293,015,119298,Kane; Daniel Mertz,9999,0,9999,0
1667999684691,CSE 293,016,119299,Kriegman; David J,9999,0,9999,0
1667999684691,CSE 293,017,119300,Kumar; Arun Kumar,9999,0,9999,0
1667999684691,CSE 293,018,119301,Lerner; Sorin,9999,0,9999,0
1667999684691,CSE 293,019,119302,Lovett; Shachar,9999,0,9999,0
1667999684691,CSE 293,020,119303,McAuley; Julian John,9999,0,9999,0
1667999684691,CSE 293,021,119304,Micciancio; Daniele,9999,0,9999,0
1667999684691,CSE 293,022,119367,Orailoglu; Alex,9999,0,9999,0
1667999684691,CSE 293,023,119382,Paturi; Ramamohan,9999,0,9999,0
1667999684691,CSE 293,024,119404,Polikarpova; Nadezhda,9999,0,9999,0
1667999684691,CSE 293,025,119406,Politz; Joseph Gibbs,9999,0,9999,0
1667999684691,CSE 293,026,119411,Porter; George M,9999,0,9999,0
1667999684691,CSE 293,027,119414,Porter; Leonard Emerson,9999,0,9999,0
1667999684691,CSE 293,028,119416,Ramamoorthi; Ravi,9999,0,9999,0
1667999684691,CSE 293,029,119417,Sahoo; Debashis,9999,0,9999,0
1667999684691,CSE 293,030,119420,Saul; Lawrence,9999,0,9999,0
1667999684691,CSE 293,031,119421,Savage; Stefan,9999,0,9999,0
1667999684691,CSE 293,032,119425,Schulze; Jurgen P.,9999,0,9999,0
1667999684691,CSE 293,033,119426,Snoeren; Alex C.,9999,0,9999,0
1667999684691,CSE 293,034,119428,Shang; Jingbo,9999,0,9999,0
1667999684691,CSE 293,035,119430,Stefan; Deian,9999,0,9999,0
1667999684691,CSE 293,036,119431,Su; Hao,9999,0,9999,0
1667999684691,CSE 293,037,119433,Swanson; Steven James,9999,0,9999,0
1667999684691,CSE 293,038,119435,Tullsen; Dean Michael,9999,0,9999,0
1667999684691,CSE 293,039,119483,Voelker; Geoffrey M.,9999,0,9999,0
1667999684691,CSE 293,040,119537,Zhao; Jishen,9999,0,9999,0
1667999684691,CSE 293,041,119538,Zhou; Yuan-Yuan,9999,0,9999,0
1667999684691,CSE 293,042,119539,Gao; Sicun,9999,0,9999,0
1667999684691,CSE 293,043,119540,Weibel; Nadir,9999,0,9999,0
1667999684691,CSE 293,044,119541,Gupta; Rajesh K.,9999,0,9999,0
1667999684691,CSE 293,045,126410,Vaccaro; Kristen Marie,9999,0,9999,0
1667999684691,CSE 293,046,126411,Klemke; Richard,9999,0,9999,0
1667999685207,CSE 294,A00,102459,Voelker; Geoffrey M.,0,0,0,0
1667999685207,CSE 294,B00,111322,Orailoglu; Alex,0,0,0,0
1667999685633,DSE 201,A00,096914,Deutsch; Alin Bernard,30,0,30,0
1667999686060,DSE 210,A00,096915,Dasgupta; Sanjoy,30,0,30,0
1667999686484,DSE 260A,A00,096916,Altintas De Callaf; Ilkay,30,0,30,0
1667999686928,ECE 200,001,103586,Antipa; Nicholas A,9999,0,9999,0
1667999686928,ECE 200,002,103587,Atanasov; Nikolay A.,9999,0,9999,0
1667999686928,ECE 200,003,103588,Bharadia; Dinesh,9999,0,9999,0
1667999686928,ECE 200,004,103589,Cheng; Chung Kuan,9999,0,9999,0
1667999686928,ECE 200,005,103590,Cosman; Pamela C.,9999,0,9999,0
1667999686928,ECE 200,006,103591,Dayeh; Shadi Ahmad,9999,0,9999,0
1667999686928,ECE 200,007,103592,Fainman; Yeshaiahu,9999,0,9999,0
1667999686928,ECE 200,008,103593,Ford; Joseph Earl,9999,0,9999,0
1667999686928,ECE 200,009,103594,Franceschetti; Massimo,9999,0,9999,0
1667999686928,ECE 200,010,103595,Fullerton; Eric E,9999,0,9999,0
1667999686928,ECE 200,011,103596,Galton; Ian A,9999,0,9999,0
1667999686928,ECE 200,012,103597,Gilja; Vikash,9999,0,9999,0
1667999686928,ECE 200,013,103598,Hall; Drew A.,9999,0,9999,0
1667999686928,ECE 200,014,103599,Hsueh; Tzu-Chien,9999,0,9999,0
1667999686928,ECE 200,015,103600,Javidi; Tara,9999,0,9999,0
1667999686928,ECE 200,016,103601,Kahng; Andrew Byun,9999,0,9999,0
1667999686928,ECE 200,017,103602,Kim; Young-Han,9999,0,9999,0
1667999686928,ECE 200,018,103603,Koushanfar; Farinaz,9999,0,9999,0
1667999686928,ECE 200,019,103604,Kuzum; Duygu,9999,0,9999,0
1667999686928,ECE 200,020,103605,Le; Hanh-Phuc,9999,0,9999,0
1667999686928,ECE 200,021,103606,Lin; Bill,9999,0,9999,0
1667999686928,ECE 200,022,103607,Liu; Zhaowei,9998,0,9999,1
1667999686928,ECE 200,023,103608,Lo; Yu-Hwa,9999,0,9999,0
1667999686928,ECE 200,024,103609,Lomakin; Vitaliy,9999,0,9999,0
1667999686928,ECE 200,025,103610,Mercier; Patrick Philip,9999,0,9999,0
1667999686928,ECE 200,026,103611,Meyer; Florian,9999,0,9999,0
1667999686928,ECE 200,027,103612,Milstein; Laurence B.,9999,0,9999,0
1667999686928,ECE 200,028,103613,Mir Arabbaygi; Siavash,9999,0,9999,0
1667999686928,ECE 200,029,103614,Mookherjea; Shayan,9999,0,9999,0
1667999686928,ECE 200,030,103615,Morris; Karcher William,9999,0,9999,0
1667999686928,ECE 200,031,103616,Ng; Tse Nga,9999,0,9999,0
1667999686928,ECE 200,032,103617,Nguyen; Truong Quang,9999,0,9999,0
1667999686928,ECE 200,033,103618,Nomura; Kenji,9999,0,9999,0
1667999686928,ECE 200,034,103619,Orlitsky; Alon,9999,0,9999,0
1667999686928,ECE 200,035,103620,Pal; Piya,9999,0,9999,0
1667999686928,ECE 200,036,103621,Papen; George C.,9999,0,9999,0
1667999686928,ECE 200,037,103622,Radic; Stojan,9999,0,9999,0
1667999686928,ECE 200,038,103623,Rao; Bhaskar D.,9999,0,9999,0
1667999686928,ECE 200,039,103624,Rao; Ramesh R,9999,0,9999,0
1667999686928,ECE 200,040,103625,Rebeiz; Gabriel,9999,0,9999,0
1667999686928,ECE 200,041,103626,Sanford; John R,9999,0,9999,0
1667999686928,ECE 200,042,103627,Siegel; Paul H.,9999,0,9999,0
1667999686928,ECE 200,043,103628,Sievenpiper; Daniel F.,9999,0,9999,0
1667999686928,ECE 200,044,103629,Sworder; David D.,9999,0,9999,0
1667999686928,ECE 200,045,103630,Taur; Yuan,9999,0,9999,0
1667999686928,ECE 200,046,103631,Touri; Behrouz,9999,0,9999,0
1667999686928,ECE 200,047,103632,Trivedi; Mohan M.,9999,0,9999,0
1667999686928,ECE 200,048,103633,Vasconcelos; Nuno,9999,0,9999,0
1667999686928,ECE 200,049,103634,Wang; Xiaolong,9999,0,9999,0
1667999686928,ECE 200,050,103635,Xie; Pengtao,9999,0,9999,0
1667999686928,ECE 200,051,103636,Yip; Michael,9999,0,9999,0
1667999686928,ECE 200,052,103637,Zeger; Kenneth A.,999,0,999,0
1667999686928,ECE 200,053,103638,Zhang; Xinyu,9999,0,9999,0
1667999686928,ECE 200,054,103639,Turakhia; Yatish Girish,9999,0,9999,0
1667999686928,ECE 200,055,103640,Kang; Mingu,9999,0,9999,0
1667999686928,ECE 200,056,103641,Shi; Yuanyuan,9999,0,9999,0
1667999686928,ECE 200,057,103642,Wang; Edward Jay,9999,0,9999,0
1667999686928,ECE 200,058,103643,Zheng; Yang,9999,0,9999,0
1667999687353,ECE 202,A00,103644,Kuzum; Duygu,0,0,0,0
1667999687780,ECE 212BN,A00,103646,Ng; Tse Nga,0,0,0,0
1667999688205,ECE 221,A00,111493,Staff,0,0,0,0
1667999688631,ECE 222B,A00,103647,Lomakin; Vitaliy,0,0,0,0
1667999689062,ECE 230B,A00,103648,Taur; Yuan,0,0,0,0
1667999689489,ECE 238B,A00,103649,Garay; Javier,0,0,0,0
1667999689913,ECE 240B,A00,112900,Fainman; Yeshaiahu,0,0,0,0
1667999690344,ECE 247A,A00,103650,Jokerst; Jesse Vincent,0,0,0,0
1667999690767,ECE 247B,A00,103651,Wang; Joseph,0,0,0,0
1667999691193,ECE 250,A00,103652,Siegel; Paul H.,0,0,0,0
1667999691618,ECE 251A,A00,103654,Rao; Bhaskar D.,0,0,0,0
1667999692041,ECE 257B,A00,103655,Bharadia; Dinesh,0,0,0,0
1667999692466,ECE 258A,A00,103656,Milstein; Laurence B.,0,0,0,0
1667999692893,ECE 260B,A00,103658,Kang; Mingu,0,0,0,0
1667999693319,ECE 264A,A00,103659,Galton; Ian A,0,0,0,0
1667999693746,ECE 265A,A00,103661,Gudem; Prasad S.S.,0,0,0,0
1667999694172,ECE 265D,A00,103662,Gudem; Prasad S.S.,0,0,0,0
1667999694596,ECE 268,A00,103663,Koushanfar; Farinaz,0,0,0,0
1667999695019,ECE 269,A01,103665,Pal; Piya,0,0,0,0
1667999695444,ECE 271B,A00,103666,Vasconcelos; Manuela,0,0,0,0
1667999695870,ECE 276A,A00,103667,Atanasov; Nikolay A.,0,0,0,0
1667999696293,ECE 277,A00,103668,An; Cheolhong,0,0,0,0
1667999696718,ECE 279,A00,117947,Hall; Drew A.,0,0,0,0
1667999697563,ECE 283,A00,103670,Hsueh; Tzu-Chien,0,0,0,0
1667999697990,ECE 284,A00,103671,Turakhia; Yatish Girish,0,0,0,0
1667999698413,ECE 285,A00,103672,Zheng; Yang,0,0,0,0
1667999698413,ECE 285,B00,103673,Sworder; David D.,0,0,0,0
1667999698839,ECE 287,A00,103676,Javidi; Tara,0,0,0,0
1667999699261,MATH 200B,A00,098023,Salehi Golsefidy; Alireza,14,0,15,1
1667999699685,MATH 202B,A00,098024,Rhoades; Brendon Patrick,12,0,15,3
1667999700114,MATH 203B,A00,098025,Oprea; Dragos N.,12,0,15,3
1667999700536,MATH 204B,A00,098026,Sorensen; Claus M,14,0,15,1
1667999700963,MATH 208,A00,098027,Izadi; Elham,7,0,10,3
1667999701387,MATH 209,A00,098028,Pollack; Aaron,10,0,10,0
1667999701809,MATH 211A,A00,112919,Rogalski; Daniel,9,0,10,1
1667999702233,MATH 211B,A00,112920,Seward; Brandon M.,9,0,10,1
1667999702656,MATH 218,A00,098029,Li; Bo,10,0,10,0
1667999703083,MATH 220B,A00,098030,Novak; Jonathan I,13,0,15,2
1667999703513,MATH 221A,A00,098031,Ebenfelt; Peter F,13,0,15,2
1667999703942,MATH 231B,A00,098032,Zlatos; Andrej,12,0,15,3
1667999704436,MATH 240B,A00,098033,Ni; Lei,10,0,15,5
1667999704859,MATH 243,A00,098034,Jekel; David Andrew,10,0,10,0
1667999705283,MATH 245A,A00,098035,Nie; Jiawang,0,0,15,16
1667999705708,MATH 248,A00,098036,Bejenaru; Ioan,10,0,10,0
1667999706132,MATH 250B,A00,098037,Spolaor; Luca,14,0,15,1
1667999706557,MATH 258,A00,098038,Ni; Lei,10,0,10,0
1667999706981,MATH 264B,A00,098041,Rhoades; Brendon Patrick,11,0,15,4
1667999707409,MATH 268,A00,098042,Buss; Samuel R,10,0,10,0
1667999707831,MATH 269,A00,098043,Rhoades; Brendon Patrick,10,0,10,0
1667999708254,MATH 270B,A00,098044,Li; Bo,11,0,15,4
1667999708677,MATH 272B,A00,098045,Holst; Michael J,13,0,15,2
1667999709109,MATH 273A,A00,098046,Tian; Xiaochuan,12,0,15,3
1667999709537,MATH 275,A01,098048,Tian; Xiaochuan,6,0,10,4
1667999709964,MATH 278A,A00,098049,Holst; Michael J,8,0,10,2
1667999710387,MATH 278B,A00,098050,Cloninger; Alexander,10,0,10,0
1667999710813,MATH 278C,A00,098051,Nie; Jiawang,8,0,10,2
1667999711237,MATH 280B,A00,098052,Zheng; Tianyi,11,0,15,4
1667999711665,MATH 281B,A00,098053,Bradic; Jelena,4,0,15,11
1667999712088,MATH 282B,A00,098054,Arias-Castro; Ery,2,0,15,13
1667999712514,MATH 285,A00,098055,Fitzsimmons; Patrick J,0,0,15,17
1667999712941,MATH 287B,A00,098056,Arias-Castro; Ery,5,0,15,10
1667999713365,MATH 288,A00,098057,Agarwal; Pooja,9,0,10,1
1667999713365,MATH 288,B00,098058,Zhang; Danna,9,0,10,1
1667999713365,MATH 288,C00,098059,Williams; Ruth J,10,0,10,0
1667999713789,MATH 290B,A00,098060,Roberts; Justin Deritter,14,0,15,1
1667999714213,MATH 292,A00,098061,Belmont; Eva Kinoshita,10,0,10,0
1667999714640,MATH 295,A00,098062,Suk; Andrew Hoon,48,0,50,2
1667999715066,MATH 296,A00,098063,Novak; Jonathan I,20,0,20,0
1667999715488,MATH 297,001,098064,Gamst; Anthony Collins,9997,0,9999,2
1668000214245,COGS 205,A00,101395,Chiba; Andrea,19,0,20,1
1668000214669,COGS 210B,001,101404,Greene; Deanna Jacquelyn,9998,0,9999,1
1668000214669,COGS 210B,002,101417,Xia; Haijun,9999,0,9999,0
1668000214669,COGS 210B,003,101422,Nitz; Douglas A.,9999,0,9999,0
1668000214669,COGS 210B,004,101423,Hollan; James D.,9998,0,9999,1
1668000214669,COGS 210B,005,101424,Deak; Gedeon O.,9999,0,9999,0
1668000214669,COGS 210B,006,101425,Rossano; Federico,9999,0,9999,0
1668000215093,COGS 211B,A00,101427,Coulson; Seana M,9997,0,9999,2
1668000215517,COGS 220,A00,101428,Hollan; James D.,0,0,25,25
1668000215942,COGS 229,A00,101429,Dow; Steven P,18,0,25,7
1668000216365,COGS 230,A00,101430,Klemmer; Scott R,13,0,17,4
1668000216790,COGS 234,A00,101431,Xia; Haijun,7,0,25,18
1668000217216,COGS 260,A00,101432,Kiyonaga; Anastasia,20,0,25,5
1668000217216,COGS 260,B00,101433,Kirsh; David Joel,16,0,25,9
1668000217638,CSE 202,A00,102371,Impagliazzo; Russell,0,0,0,0
1668000218063,CSE 203B,A01,102373,Cheng; Chung Kuan,0,0,0,0
1668000218486,CSE 208,A00,102374,Micciancio; Daniele,0,0,0,0
1668000218912,CSE 209A,A00,112895,Impagliazzo; Russell,0,0,15,15
1668000219337,CSE 209B,A00,108005,Bellare; Mihir,0,0,0,0
1668000219765,CSE 210,A00,113163,Coblenz; Michael J,0,0,0,0
1668000220189,CSE 219,A00,106111,Dow; Steven P,0,0,20,20
1668000220616,CSE 221,A00,102376,Voelker; Geoffrey M.,0,0,0,0
1668000221042,CSE 224,A01,102378,Porter; George M,0,0,0,0
1668000221465,CSE 229A,A00,102379,Savage; Stefan,0,0,0,0
1668000221888,CSE 229C,A00,102380,Munyaka; Imani N. S.,0,0,0,0
1668000222316,CSE 232B,A00,102382,Deutsch; Alin Bernard,0,0,0,0
1668000222739,CSE 234,A01,112904,Kumar; Arun Kumar,0,0,0,0
1668000223165,CSE 237A,A00,102383,Rosing; Tajana Simunic,0,0,0,0
1668000223589,CSE 239A,A00,102384,Deutsch; Alin Bernard,0,0,0,0
1668000224011,CSE 239B,A00,102385,Polikarpova; Nadezhda,0,0,0,0
1668000224433,CSE 240A,A00,102386,Pannuto; Patrick William,0,0,0,0
1668000224858,CSE 240B,A00,102387,Zhao; Jishen,0,0,0,0
1668000225280,CSE 241A,A00,106406,Kang; Mingu,0,0,0,0
1668000225702,CSE 249B,A00,102388,Kahng; Andrew Byun,0,0,8,8
1668000226128,CSE 251B,A01,102392,Cottrell; Garrison W,0,0,0,0
1668000226128,CSE 251B,A02,102393,Cottrell; Garrison W,0,0,0,0
1668000226551,CSE 252B,A00,102394,Ochoa; Benjamin Lawrence,0,0,0,0
1668000226977,CSE 257,A01,102396,Gao; Sicun,0,0,0,0
1668000227400,CSE 272,A00,102397,Li; Tzumao,0,0,0,0
1668000227827,CSE 274,A00,111323,Chern; Albert Ren-Haur,0,0,0,0
1668000228250,CSE 282,A00,102398,Pevzner; Pavel Arkadjevich,0,0,0,0
1668000228673,CSE 284,A00,114175,Gymrek; Melissa Ann,0,0,0,0
1668000229095,CSE 290,A00,102399,Chandraker; Manmohan Krishna,0,0,0,0
1668000229095,CSE 290,B00,102400,Vaccaro; Kristen Marie,0,0,25,25
1668000229095,CSE 290,C00,102414,Pannuto; Patrick William,0,0,25,25
1668000229095,CSE 290,D00,102427,Pevzner; Pavel Arkadjevich,0,0,0,0
1668000229095,CSE 290,E00,102429,Zhao; Jishen,0,0,0,0
1668000229095,CSE 290,F00,102436,Tullsen; Dean Michael,0,0,0,0
1668000229095,CSE 290,G00,102440,Christensen; Henrik I,0,0,20,20
1668000229521,CSE 291,A00,102443,Su; Hao,0,0,0,0
1668000229521,CSE 291,B00,102448,Polikarpova; Nadezhda,0,0,0,0
1668000229521,CSE 291,C00,102453,Vaccaro; Kristen Marie,0,0,0,0
1668000229521,CSE 291,D00,111343,Savage; Stefan,0,0,0,0
1668000229521,CSE 291,E00,116474,Claffy; Kimberly Claire,0,0,0,0
1668000229521,CSE 291,F00,116479,Pasquale; Joseph,0,0,0,0
1668000229945,CSE 293,001,119111,Bafna; Vineet,9999,0,9999,0
1668000229945,CSE 293,002,119118,Bellare; Mihir,9999,0,9999,0
1668000229945,CSE 293,003,119122,Berg-Kirkpatrick; Taylor D,9999,0,9999,0
1668000229945,CSE 293,004,119135,Christensen; Henrik I,9999,0,9999,0
1668000229945,CSE 293,005,119142,Cottrell; Garrison W,9999,0,9999,0
1668000229945,CSE 293,006,119146,Deutsch; Alin Bernard,9999,0,9999,0
1668000229945,CSE 293,007,119159,Esmaeilzadeh; Hadi,9999,0,9999,0
1668000229945,CSE 293,008,119166,Freund; Yoav,9999,0,9999,0
1668000229945,CSE 293,009,119170,Griswold; William G.,9999,0,9999,0
1668000229945,CSE 293,010,119183,Gymrek; Melissa Ann,9999,0,9999,0
1668000229945,CSE 293,011,119190,Heninger; Nadia A,9999,0,9999,0
1668000229945,CSE 293,012,119230,Impagliazzo; Russell,9999,0,9999,0
1668000229945,CSE 293,013,119232,Jhala; Ranjit,9999,0,9999,0
1668000229945,CSE 293,014,119233,Kahng; Andrew Byun,9999,0,9999,0
1668000229945,CSE 293,015,119298,Kane; Daniel Mertz,9999,0,9999,0
1668000229945,CSE 293,016,119299,Kriegman; David J,9999,0,9999,0
1668000229945,CSE 293,017,119300,Kumar; Arun Kumar,9999,0,9999,0
1668000229945,CSE 293,018,119301,Lerner; Sorin,9999,0,9999,0
1668000229945,CSE 293,019,119302,Lovett; Shachar,9999,0,9999,0
1668000229945,CSE 293,020,119303,McAuley; Julian John,9999,0,9999,0
1668000229945,CSE 293,021,119304,Micciancio; Daniele,9999,0,9999,0
1668000229945,CSE 293,022,119367,Orailoglu; Alex,9999,0,9999,0
1668000229945,CSE 293,023,119382,Paturi; Ramamohan,9999,0,9999,0
1668000229945,CSE 293,024,119404,Polikarpova; Nadezhda,9999,0,9999,0
1668000229945,CSE 293,025,119406,Politz; Joseph Gibbs,9999,0,9999,0
1668000229945,CSE 293,026,119411,Porter; George M,9999,0,9999,0
1668000229945,CSE 293,027,119414,Porter; Leonard Emerson,9999,0,9999,0
1668000229945,CSE 293,028,119416,Ramamoorthi; Ravi,9999,0,9999,0
1668000229945,CSE 293,029,119417,Sahoo; Debashis,9999,0,9999,0
1668000229945,CSE 293,030,119420,Saul; Lawrence,9999,0,9999,0
1668000229945,CSE 293,031,119421,Savage; Stefan,9999,0,9999,0
1668000229945,CSE 293,032,119425,Schulze; Jurgen P.,9999,0,9999,0
1668000229945,CSE 293,033,119426,Snoeren; Alex C.,9999,0,9999,0
1668000229945,CSE 293,034,119428,Shang; Jingbo,9999,0,9999,0
1668000229945,CSE 293,035,119430,Stefan; Deian,9999,0,9999,0
1668000229945,CSE 293,036,119431,Su; Hao,9999,0,9999,0
1668000229945,CSE 293,037,119433,Swanson; Steven James,9999,0,9999,0
1668000229945,CSE 293,038,119435,Tullsen; Dean Michael,9999,0,9999,0
1668000229945,CSE 293,039,119483,Voelker; Geoffrey M.,9999,0,9999,0
1668000229945,CSE 293,040,119537,Zhao; Jishen,9999,0,9999,0
1668000229945,CSE 293,041,119538,Zhou; Yuan-Yuan,9999,0,9999,0
1668000229945,CSE 293,042,119539,Gao; Sicun,9999,0,9999,0
1668000229945,CSE 293,043,119540,Weibel; Nadir,9999,0,9999,0
1668000229945,CSE 293,044,119541,Gupta; Rajesh K.,9999,0,9999,0
1668000229945,CSE 293,045,126410,Vaccaro; Kristen Marie,9999,0,9999,0
1668000229945,CSE 293,046,126411,Klemke; Richard,9999,0,9999,0
1668000230373,CSE 294,A00,102459,Voelker; Geoffrey M.,0,0,0,0
1668000230373,CSE 294,B00,111322,Orailoglu; Alex,0,0,0,0
1668000230801,DSE 201,A00,096914,Deutsch; Alin Bernard,30,0,30,0
1668000231226,DSE 210,A00,096915,Dasgupta; Sanjoy,30,0,30,0
1668000231651,DSE 260A,A00,096916,Altintas De Callaf; Ilkay,30,0,30,0
1668000232080,ECE 200,001,103586,Antipa; Nicholas A,9999,0,9999,0
1668000232080,ECE 200,002,103587,Atanasov; Nikolay A.,9999,0,9999,0
1668000232080,ECE 200,003,103588,Bharadia; Dinesh,9999,0,9999,0
1668000232080,ECE 200,004,103589,Cheng; Chung Kuan,9999,0,9999,0
1668000232080,ECE 200,005,103590,Cosman; Pamela C.,9999,0,9999,0
1668000232080,ECE 200,006,103591,Dayeh; Shadi Ahmad,9999,0,9999,0
1668000232080,ECE 200,007,103592,Fainman; Yeshaiahu,9999,0,9999,0
1668000232080,ECE 200,008,103593,Ford; Joseph Earl,9999,0,9999,0
1668000232080,ECE 200,009,103594,Franceschetti; Massimo,9999,0,9999,0
1668000232080,ECE 200,010,103595,Fullerton; Eric E,9999,0,9999,0
1668000232080,ECE 200,011,103596,Galton; Ian A,9999,0,9999,0
1668000232080,ECE 200,012,103597,Gilja; Vikash,9999,0,9999,0
1668000232080,ECE 200,013,103598,Hall; Drew A.,9999,0,9999,0
1668000232080,ECE 200,014,103599,Hsueh; Tzu-Chien,9999,0,9999,0
1668000232080,ECE 200,015,103600,Javidi; Tara,9999,0,9999,0
1668000232080,ECE 200,016,103601,Kahng; Andrew Byun,9999,0,9999,0
1668000232080,ECE 200,017,103602,Kim; Young-Han,9999,0,9999,0
1668000232080,ECE 200,018,103603,Koushanfar; Farinaz,9999,0,9999,0
1668000232080,ECE 200,019,103604,Kuzum; Duygu,9999,0,9999,0
1668000232080,ECE 200,020,103605,Le; Hanh-Phuc,9999,0,9999,0
1668000232080,ECE 200,021,103606,Lin; Bill,9999,0,9999,0
1668000232080,ECE 200,022,103607,Liu; Zhaowei,9998,0,9999,1
1668000232080,ECE 200,023,103608,Lo; Yu-Hwa,9999,0,9999,0
1668000232080,ECE 200,024,103609,Lomakin; Vitaliy,9999,0,9999,0
1668000232080,ECE 200,025,103610,Mercier; Patrick Philip,9999,0,9999,0
1668000232080,ECE 200,026,103611,Meyer; Florian,9999,0,9999,0
1668000232080,ECE 200,027,103612,Milstein; Laurence B.,9999,0,9999,0
1668000232080,ECE 200,028,103613,Mir Arabbaygi; Siavash,9999,0,9999,0
1668000232080,ECE 200,029,103614,Mookherjea; Shayan,9999,0,9999,0
1668000232080,ECE 200,030,103615,Morris; Karcher William,9999,0,9999,0
1668000232080,ECE 200,031,103616,Ng; Tse Nga,9999,0,9999,0
1668000232080,ECE 200,032,103617,Nguyen; Truong Quang,9999,0,9999,0
1668000232080,ECE 200,033,103618,Nomura; Kenji,9999,0,9999,0
1668000232080,ECE 200,034,103619,Orlitsky; Alon,9999,0,9999,0
1668000232080,ECE 200,035,103620,Pal; Piya,9999,0,9999,0
1668000232080,ECE 200,036,103621,Papen; George C.,9999,0,9999,0
1668000232080,ECE 200,037,103622,Radic; Stojan,9999,0,9999,0
1668000232080,ECE 200,038,103623,Rao; Bhaskar D.,9999,0,9999,0
1668000232080,ECE 200,039,103624,Rao; Ramesh R,9999,0,9999,0
1668000232080,ECE 200,040,103625,Rebeiz; Gabriel,9999,0,9999,0
1668000232080,ECE 200,041,103626,Sanford; John R,9999,0,9999,0
1668000232080,ECE 200,042,103627,Siegel; Paul H.,9999,0,9999,0
1668000232080,ECE 200,043,103628,Sievenpiper; Daniel F.,9999,0,9999,0
1668000232080,ECE 200,044,103629,Sworder; David D.,9999,0,9999,0
1668000232080,ECE 200,045,103630,Taur; Yuan,9999,0,9999,0
1668000232080,ECE 200,046,103631,Touri; Behrouz,9999,0,9999,0
1668000232080,ECE 200,047,103632,Trivedi; Mohan M.,9999,0,9999,0
1668000232080,ECE 200,048,103633,Vasconcelos; Nuno,9999,0,9999,0
1668000232080,ECE 200,049,103634,Wang; Xiaolong,9999,0,9999,0
1668000232080,ECE 200,050,103635,Xie; Pengtao,9999,0,9999,0
1668000232080,ECE 200,051,103636,Yip; Michael,9999,0,9999,0
1668000232080,ECE 200,052,103637,Zeger; Kenneth A.,999,0,999,0
1668000232080,ECE 200,053,103638,Zhang; Xinyu,9999,0,9999,0
1668000232080,ECE 200,054,103639,Turakhia; Yatish Girish,9999,0,9999,0
1668000232080,ECE 200,055,103640,Kang; Mingu,9999,0,9999,0
1668000232080,ECE 200,056,103641,Shi; Yuanyuan,9999,0,9999,0
1668000232080,ECE 200,057,103642,Wang; Edward Jay,9999,0,9999,0
1668000232080,ECE 200,058,103643,Zheng; Yang,9999,0,9999,0
1668000232504,ECE 202,A00,103644,Kuzum; Duygu,0,0,0,0
1668000232930,ECE 212BN,A00,103646,Ng; Tse Nga,0,0,0,0
1668000233357,ECE 221,A00,111493,Staff,0,0,0,0
1668000233785,ECE 222B,A00,103647,Lomakin; Vitaliy,0,0,0,0
1668000234215,ECE 230B,A00,103648,Taur; Yuan,0,0,0,0
1668000234640,ECE 238B,A00,103649,Garay; Javier,0,0,0,0
1668000235066,ECE 240B,A00,112900,Fainman; Yeshaiahu,0,0,0,0
1668000235490,ECE 247A,A00,103650,Jokerst; Jesse Vincent,0,0,0,0
1668000235914,ECE 247B,A00,103651,Wang; Joseph,0,0,0,0
1668000236337,ECE 250,A00,103652,Siegel; Paul H.,0,0,0,0
1668000236762,ECE 251A,A00,103654,Rao; Bhaskar D.,0,0,0,0
1668000237193,ECE 257B,A00,103655,Bharadia; Dinesh,0,0,0,0
1668000237617,ECE 258A,A00,103656,Milstein; Laurence B.,0,0,0,0
1668000238041,ECE 260B,A00,103658,Kang; Mingu,0,0,0,0
1668000238478,ECE 264A,A00,103659,Galton; Ian A,0,0,0,0
1668000238909,ECE 265A,A00,103661,Gudem; Prasad S.S.,0,0,0,0
1668000239333,ECE 265D,A00,103662,Gudem; Prasad S.S.,0,0,0,0
1668000239757,ECE 268,A00,103663,Koushanfar; Farinaz,0,0,0,0
1668000240182,ECE 269,A01,103665,Pal; Piya,0,0,0,0
1668000240605,ECE 271B,A00,103666,Vasconcelos; Manuela,0,0,0,0
1668000241033,ECE 276A,A00,103667,Atanasov; Nikolay A.,0,0,0,0
1668000241457,ECE 277,A00,103668,An; Cheolhong,0,0,0,0
1668000241886,ECE 279,A00,117947,Hall; Drew A.,0,0,0,0
1668000242745,ECE 283,A00,103670,Hsueh; Tzu-Chien,0,0,0,0
1668000243173,ECE 284,A00,103671,Turakhia; Yatish Girish,0,0,0,0
1668000243597,ECE 285,A00,103672,Zheng; Yang,0,0,0,0
1668000243597,ECE 285,B00,103673,Sworder; David D.,0,0,0,0
1668000244024,ECE 287,A00,103676,Javidi; Tara,0,0,0,0
1668000244450,MATH 200B,A00,098023,Salehi Golsefidy; Alireza,14,0,15,1
1668000244878,MATH 202B,A00,098024,Rhoades; Brendon Patrick,12,0,15,3
1668000245302,MATH 203B,A00,098025,Oprea; Dragos N.,12,0,15,3
1668000245725,MATH 204B,A00,098026,Sorensen; Claus M,14,0,15,1
1668000246149,MATH 208,A00,098027,Izadi; Elham,7,0,10,3
1668000246576,MATH 209,A00,098028,Pollack; Aaron,10,0,10,0
1668000247084,MATH 211A,A00,112919,Rogalski; Daniel,9,0,10,1
1668000247511,MATH 211B,A00,112920,Seward; Brandon M.,9,0,10,1
1668000247935,MATH 218,A00,098029,Li; Bo,10,0,10,0
1668000248362,MATH 220B,A00,098030,Novak; Jonathan I,13,0,15,2
1668000248787,MATH 221A,A00,098031,Ebenfelt; Peter F,13,0,15,2
1668000249212,MATH 231B,A00,098032,Zlatos; Andrej,12,0,15,3
1668000249638,MATH 240B,A00,098033,Ni; Lei,10,0,15,5
1668000250067,MATH 243,A00,098034,Jekel; David Andrew,10,0,10,0
1668000250489,MATH 245A,A00,098035,Nie; Jiawang,0,0,15,16
1668000250915,MATH 248,A00,098036,Bejenaru; Ioan,10,0,10,0
1668000251339,MATH 250B,A00,098037,Spolaor; Luca,14,0,15,1
1668000251765,MATH 258,A00,098038,Ni; Lei,10,0,10,0
1668000252191,MATH 264B,A00,098041,Rhoades; Brendon Patrick,11,0,15,4
1668000252612,MATH 268,A00,098042,Buss; Samuel R,10,0,10,0
1668000253038,MATH 269,A00,098043,Rhoades; Brendon Patrick,10,0,10,0
1668000253461,MATH 270B,A00,098044,Li; Bo,11,0,15,4
1668000253886,MATH 272B,A00,098045,Holst; Michael J,13,0,15,2
1668000254311,MATH 273A,A00,098046,Tian; Xiaochuan,12,0,15,3
1668000254758,MATH 275,A01,098048,Tian; Xiaochuan,6,0,10,4
1668000255184,MATH 278A,A00,098049,Holst; Michael J,8,0,10,2
1668000255607,MATH 278B,A00,098050,Cloninger; Alexander,10,0,10,0
1668000256030,MATH 278C,A00,098051,Nie; Jiawang,8,0,10,2
1668000256455,MATH 280B,A00,098052,Zheng; Tianyi,11,0,15,4
1668000256882,MATH 281B,A00,098053,Bradic; Jelena,4,0,15,11
1668000257307,MATH 282B,A00,098054,Arias-Castro; Ery,2,0,15,13
1668000257731,MATH 285,A00,098055,Fitzsimmons; Patrick J,0,0,15,17
1668000258154,MATH 287B,A00,098056,Arias-Castro; Ery,5,0,15,10
1668000258578,MATH 288,A00,098057,Agarwal; Pooja,9,0,10,1
1668000258578,MATH 288,B00,098058,Zhang; Danna,9,0,10,1
1668000258578,MATH 288,C00,098059,Williams; Ruth J,10,0,10,0
1668000259004,MATH 290B,A00,098060,Roberts; Justin Deritter,14,0,15,1
1668000259428,MATH 292,A00,098061,Belmont; Eva Kinoshita,10,0,10,0
1668000259857,MATH 295,A00,098062,Suk; Andrew Hoon,48,0,50,2
1668000260289,MATH 296,A00,098063,Novak; Jonathan I,20,0,20,0
1668000260713,MATH 297,001,098064,Gamst; Anthony Collins,9997,0,9999,2
1668000762083,COGS 205,A00,101395,Chiba; Andrea,19,0,20,1
1668000762514,COGS 210B,001,101404,Greene; Deanna Jacquelyn,9998,0,9999,1
1668000762514,COGS 210B,002,101417,Xia; Haijun,9999,0,9999,0
1668000762514,COGS 210B,003,101422,Nitz; Douglas A.,9999,0,9999,0
1668000762514,COGS 210B,004,101423,Hollan; James D.,9998,0,9999,1
1668000762514,COGS 210B,005,101424,Deak; Gedeon O.,9999,0,9999,0
1668000762514,COGS 210B,006,101425,Rossano; Federico,9999,0,9999,0
1668000762941,COGS 211B,A00,101427,Coulson; Seana M,9997,0,9999,2
1668000763370,COGS 220,A00,101428,Hollan; James D.,0,0,25,25
1668000763796,COGS 229,A00,101429,Dow; Steven P,18,0,25,7
1668000764227,COGS 230,A00,101430,Klemmer; Scott R,13,0,17,4
1668000764650,COGS 234,A00,101431,Xia; Haijun,7,0,25,18
1668000765075,COGS 260,A00,101432,Kiyonaga; Anastasia,20,0,25,5
1668000765075,COGS 260,B00,101433,Kirsh; David Joel,16,0,25,9
1668000765497,CSE 202,A00,102371,Impagliazzo; Russell,0,0,0,0
1668000765929,CSE 203B,A01,102373,Cheng; Chung Kuan,0,0,0,0
1668000766355,CSE 208,A00,102374,Micciancio; Daniele,0,0,0,0
1668000766783,CSE 209A,A00,112895,Impagliazzo; Russell,0,0,15,15
1668000767208,CSE 209B,A00,108005,Bellare; Mihir,0,0,0,0
1668000767633,CSE 210,A00,113163,Coblenz; Michael J,0,0,0,0
1668000768058,CSE 219,A00,106111,Dow; Steven P,0,0,20,20
1668000768554,CSE 221,A00,102376,Voelker; Geoffrey M.,0,0,0,0
1668000768993,CSE 224,A01,102378,Porter; George M,0,0,0,0
1668000769421,CSE 229A,A00,102379,Savage; Stefan,0,0,0,0
1668000769851,CSE 229C,A00,102380,Munyaka; Imani N. S.,0,0,0,0
1668000770290,CSE 232B,A00,102382,Deutsch; Alin Bernard,0,0,0,0
1668000770719,CSE 234,A01,112904,Kumar; Arun Kumar,0,0,0,0
1668000771147,CSE 237A,A00,102383,Rosing; Tajana Simunic,0,0,0,0
1668000771582,CSE 239A,A00,102384,Deutsch; Alin Bernard,0,0,0,0
1668000772008,CSE 239B,A00,102385,Polikarpova; Nadezhda,0,0,0,0
1668000772431,CSE 240A,A00,102386,Pannuto; Patrick William,0,0,0,0
1668000772858,CSE 240B,A00,102387,Zhao; Jishen,0,0,0,0
1668000773285,CSE 241A,A00,106406,Kang; Mingu,0,0,0,0
1668000773721,CSE 249B,A00,102388,Kahng; Andrew Byun,0,0,8,8
1668000774147,CSE 251B,A01,102392,Cottrell; Garrison W,0,0,0,0
1668000774147,CSE 251B,A02,102393,Cottrell; Garrison W,0,0,0,0
1668000774574,CSE 252B,A00,102394,Ochoa; Benjamin Lawrence,0,0,0,0
1668000774998,CSE 257,A01,102396,Gao; Sicun,0,0,0,0
1668000775426,CSE 272,A00,102397,Li; Tzumao,0,0,0,0
1668000775850,CSE 274,A00,111323,Chern; Albert Ren-Haur,0,0,0,0
1668000776273,CSE 282,A00,102398,Pevzner; Pavel Arkadjevich,0,0,0,0
1668000776696,CSE 284,A00,114175,Gymrek; Melissa Ann,0,0,0,0
1668000777121,CSE 290,A00,102399,Chandraker; Manmohan Krishna,0,0,0,0
1668000777121,CSE 290,B00,102400,Vaccaro; Kristen Marie,0,0,25,25
1668000777121,CSE 290,C00,102414,Pannuto; Patrick William,0,0,25,25
1668000777121,CSE 290,D00,102427,Pevzner; Pavel Arkadjevich,0,0,0,0
1668000777121,CSE 290,E00,102429,Zhao; Jishen,0,0,0,0
1668000777121,CSE 290,F00,102436,Tullsen; Dean Michael,0,0,0,0
1668000777121,CSE 290,G00,102440,Christensen; Henrik I,0,0,20,20
1668000777550,CSE 291,A00,102443,Su; Hao,0,0,0,0
1668000777550,CSE 291,B00,102448,Polikarpova; Nadezhda,0,0,0,0
1668000777550,CSE 291,C00,102453,Vaccaro; Kristen Marie,0,0,0,0
1668000777550,CSE 291,D00,111343,Savage; Stefan,0,0,0,0
1668000777550,CSE 291,E00,116474,Claffy; Kimberly Claire,0,0,0,0
1668000777550,CSE 291,F00,116479,Pasquale; Joseph,0,0,0,0
1668000777987,CSE 293,001,119111,Bafna; Vineet,9999,0,9999,0
1668000777987,CSE 293,002,119118,Bellare; Mihir,9999,0,9999,0
1668000777987,CSE 293,003,119122,Berg-Kirkpatrick; Taylor D,9999,0,9999,0
1668000777987,CSE 293,004,119135,Christensen; Henrik I,9999,0,9999,0
1668000777987,CSE 293,005,119142,Cottrell; Garrison W,9999,0,9999,0
1668000777987,CSE 293,006,119146,Deutsch; Alin Bernard,9999,0,9999,0
1668000777987,CSE 293,007,119159,Esmaeilzadeh; Hadi,9999,0,9999,0
1668000777987,CSE 293,008,119166,Freund; Yoav,9999,0,9999,0
1668000777987,CSE 293,009,119170,Griswold; William G.,9999,0,9999,0
1668000777987,CSE 293,010,119183,Gymrek; Melissa Ann,9999,0,9999,0
1668000777987,CSE 293,011,119190,Heninger; Nadia A,9999,0,9999,0
1668000777987,CSE 293,012,119230,Impagliazzo; Russell,9999,0,9999,0
1668000777987,CSE 293,013,119232,Jhala; Ranjit,9999,0,9999,0
1668000777987,CSE 293,014,119233,Kahng; Andrew Byun,9999,0,9999,0
1668000777987,CSE 293,015,119298,Kane; Daniel Mertz,9999,0,9999,0
1668000777987,CSE 293,016,119299,Kriegman; David J,9999,0,9999,0
1668000777987,CSE 293,017,119300,Kumar; Arun Kumar,9999,0,9999,0
1668000777987,CSE 293,018,119301,Lerner; Sorin,9999,0,9999,0
1668000777987,CSE 293,019,119302,Lovett; Shachar,9999,0,9999,0
1668000777987,CSE 293,020,119303,McAuley; Julian John,9999,0,9999,0
1668000777987,CSE 293,021,119304,Micciancio; Daniele,9999,0,9999,0
1668000777987,CSE 293,022,119367,Orailoglu; Alex,9999,0,9999,0
1668000777987,CSE 293,023,119382,Paturi; Ramamohan,9999,0,9999,0
1668000777987,CSE 293,024,119404,Polikarpova; Nadezhda,9999,0,9999,0
1668000777987,CSE 293,025,119406,Politz; Joseph Gibbs,9999,0,9999,0
1668000777987,CSE 293,026,119411,Porter; George M,9999,0,9999,0
1668000777987,CSE 293,027,119414,Porter; Leonard Emerson,9999,0,9999,0
1668000777987,CSE 293,028,119416,Ramamoorthi; Ravi,9999,0,9999,0
1668000777987,CSE 293,029,119417,Sahoo; Debashis,9999,0,9999,0
1668000777987,CSE 293,030,119420,Saul; Lawrence,9999,0,9999,0
1668000777987,CSE 293,031,119421,Savage; Stefan,9999,0,9999,0
1668000777987,CSE 293,032,119425,Schulze; Jurgen P.,9999,0,9999,0
1668000777987,CSE 293,033,119426,Snoeren; Alex C.,9999,0,9999,0
1668000777987,CSE 293,034,119428,Shang; Jingbo,9999,0,9999,0
1668000777987,CSE 293,035,119430,Stefan; Deian,9999,0,9999,0
1668000777987,CSE 293,036,119431,Su; Hao,9999,0,9999,0
1668000777987,CSE 293,037,119433,Swanson; Steven James,9999,0,9999,0
1668000777987,CSE 293,038,119435,Tullsen; Dean Michael,9999,0,9999,0
1668000777987,CSE 293,039,119483,Voelker; Geoffrey M.,9999,0,9999,0
1668000777987,CSE 293,040,119537,Zhao; Jishen,9999,0,9999,0
1668000777987,CSE 293,041,119538,Zhou; Yuan-Yuan,9999,0,9999,0
1668000777987,CSE 293,042,119539,Gao; Sicun,9999,0,9999,0
1668000777987,CSE 293,043,119540,Weibel; Nadir,9999,0,9999,0
1668000777987,CSE 293,044,119541,Gupta; Rajesh K.,9999,0,9999,0
1668000777987,CSE 293,045,126410,Vaccaro; Kristen Marie,9999,0,9999,0
1668000777987,CSE 293,046,126411,Klemke; Richard,9999,0,9999,0
1668000778411,CSE 294,A00,102459,Voelker; Geoffrey M.,0,0,0,0
1668000778411,CSE 294,B00,111322,Orailoglu; Alex,0,0,0,0
1668000778838,DSE 201,A00,096914,Deutsch; Alin Bernard,30,0,30,0
1668000779267,DSE 210,A00,096915,Dasgupta; Sanjoy,30,0,30,0
1668000779697,DSE 260A,A00,096916,Altintas De Callaf; Ilkay,30,0,30,0
1668000780142,ECE 200,001,103586,Antipa; Nicholas A,9999,0,9999,0
1668000780142,ECE 200,002,103587,Atanasov; Nikolay A.,9999,0,9999,0
1668000780142,ECE 200,003,103588,Bharadia; Dinesh,9999,0,9999,0
1668000780142,ECE 200,004,103589,Cheng; Chung Kuan,9999,0,9999,0
1668000780142,ECE 200,005,103590,Cosman; Pamela C.,9999,0,9999,0
1668000780142,ECE 200,006,103591,Dayeh; Shadi Ahmad,9999,0,9999,0
1668000780142,ECE 200,007,103592,Fainman; Yeshaiahu,9999,0,9999,0
1668000780142,ECE 200,008,103593,Ford; Joseph Earl,9999,0,9999,0
1668000780142,ECE 200,009,103594,Franceschetti; Massimo,9999,0,9999,0
1668000780142,ECE 200,010,103595,Fullerton; Eric E,9999,0,9999,0
1668000780142,ECE 200,011,103596,Galton; Ian A,9999,0,9999,0
1668000780142,ECE 200,012,103597,Gilja; Vikash,9999,0,9999,0
1668000780142,ECE 200,013,103598,Hall; Drew A.,9999,0,9999,0
1668000780142,ECE 200,014,103599,Hsueh; Tzu-Chien,9999,0,9999,0
1668000780142,ECE 200,015,103600,Javidi; Tara,9999,0,9999,0
1668000780142,ECE 200,016,103601,Kahng; Andrew Byun,9999,0,9999,0
1668000780142,ECE 200,017,103602,Kim; Young-Han,9999,0,9999,0
1668000780142,ECE 200,018,103603,Koushanfar; Farinaz,9999,0,9999,0
1668000780142,ECE 200,019,103604,Kuzum; Duygu,9999,0,9999,0
1668000780142,ECE 200,020,103605,Le; Hanh-Phuc,9999,0,9999,0
1668000780142,ECE 200,021,103606,Lin; Bill,9999,0,9999,0
1668000780142,ECE 200,022,103607,Liu; Zhaowei,9998,0,9999,1
1668000780142,ECE 200,023,103608,Lo; Yu-Hwa,9999,0,9999,0
1668000780142,ECE 200,024,103609,Lomakin; Vitaliy,9999,0,9999,0
1668000780142,ECE 200,025,103610,Mercier; Patrick Philip,9999,0,9999,0
1668000780142,ECE 200,026,103611,Meyer; Florian,9999,0,9999,0
1668000780142,ECE 200,027,103612,Milstein; Laurence B.,9999,0,9999,0
1668000780142,ECE 200,028,103613,Mir Arabbaygi; Siavash,9999,0,9999,0
1668000780142,ECE 200,029,103614,Mookherjea; Shayan,9999,0,9999,0
1668000780142,ECE 200,030,103615,Morris; Karcher William,9999,0,9999,0
1668000780142,ECE 200,031,103616,Ng; Tse Nga,9999,0,9999,0
1668000780142,ECE 200,032,103617,Nguyen; Truong Quang,9999,0,9999,0
1668000780142,ECE 200,033,103618,Nomura; Kenji,9999,0,9999,0
1668000780142,ECE 200,034,103619,Orlitsky; Alon,9999,0,9999,0
1668000780142,ECE 200,035,103620,Pal; Piya,9999,0,9999,0
1668000780142,ECE 200,036,103621,Papen; George C.,9999,0,9999,0
1668000780142,ECE 200,037,103622,Radic; Stojan,9999,0,9999,0
1668000780142,ECE 200,038,103623,Rao; Bhaskar D.,9999,0,9999,0
1668000780142,ECE 200,039,103624,Rao; Ramesh R,9999,0,9999,0
1668000780142,ECE 200,040,103625,Rebeiz; Gabriel,9999,0,9999,0
1668000780142,ECE 200,041,103626,Sanford; John R,9999,0,9999,0
1668000780142,ECE 200,042,103627,Siegel; Paul H.,9999,0,9999,0
1668000780142,ECE 200,043,103628,Sievenpiper; Daniel F.,9999,0,9999,0
1668000780142,ECE 200,044,103629,Sworder; David D.,9999,0,9999,0
1668000780142,ECE 200,045,103630,Taur; Yuan,9999,0,9999,0
1668000780142,ECE 200,046,103631,Touri; Behrouz,9999,0,9999,0
1668000780142,ECE 200,047,103632,Trivedi; Mohan M.,9999,0,9999,0
1668000780142,ECE 200,048,103633,Vasconcelos; Nuno,9999,0,9999,0
1668000780142,ECE 200,049,103634,Wang; Xiaolong,9999,0,9999,0
1668000780142,ECE 200,050,103635,Xie; Pengtao,9999,0,9999,0
1668000780142,ECE 200,051,103636,Yip; Michael,9999,0,9999,0
1668000780142,ECE 200,052,103637,Zeger; Kenneth A.,999,0,999,0
1668000780142,ECE 200,053,103638,Zhang; Xinyu,9999,0,9999,0
1668000780142,ECE 200,054,103639,Turakhia; Yatish Girish,9999,0,9999,0
1668000780142,ECE 200,055,103640,Kang; Mingu,9999,0,9999,0
1668000780142,ECE 200,056,103641,Shi; Yuanyuan,9999,0,9999,0
1668000780142,ECE 200,057,103642,Wang; Edward Jay,9999,0,9999,0
1668000780142,ECE 200,058,103643,Zheng; Yang,9999,0,9999,0
1668000780566,ECE 202,A00,103644,Kuzum; Duygu,0,0,0,0
1668000780996,ECE 212BN,A00,103646,Ng; Tse Nga,0,0,0,0
1668000781431,ECE 221,A00,111493,Staff,0,0,0,0
1668000781863,ECE 222B,A00,103647,Lomakin; Vitaliy,0,0,0,0
1668000782293,ECE 230B,A00,103648,Taur; Yuan,0,0,0,0
1668000782716,ECE 238B,A00,103649,Garay; Javier,0,0,0,0
1668000783157,ECE 240B,A00,112900,Fainman; Yeshaiahu,0,0,0,0
1668000783586,ECE 247A,A00,103650,Jokerst; Jesse Vincent,0,0,0,0
1668000784012,ECE 247B,A00,103651,Wang; Joseph,0,0,0,0
1668000784443,ECE 250,A00,103652,Siegel; Paul H.,0,0,0,0
1668000784872,ECE 251A,A00,103654,Rao; Bhaskar D.,0,0,0,0
1668000785298,ECE 257B,A00,103655,Bharadia; Dinesh,0,0,0,0
1668000785721,ECE 258A,A00,103656,Milstein; Laurence B.,0,0,0,0
1668000786145,ECE 260B,A00,103658,Kang; Mingu,0,0,0,0
1668000786570,ECE 264A,A00,103659,Galton; Ian A,0,0,0,0
1668000786995,ECE 265A,A00,103661,Gudem; Prasad S.S.,0,0,0,0
1668000787421,ECE 265D,A00,103662,Gudem; Prasad S.S.,0,0,0,0
1668000787848,ECE 268,A00,103663,Koushanfar; Farinaz,0,0,0,0
1668000788273,ECE 269,A01,103665,Pal; Piya,0,0,0,0
1668000788701,ECE 271B,A00,103666,Vasconcelos; Manuela,0,0,0,0
1668000789128,ECE 276A,A00,103667,Atanasov; Nikolay A.,0,0,0,0
1668000789554,ECE 277,A00,103668,An; Cheolhong,0,0,0,0
1668000789985,ECE 279,A00,117947,Hall; Drew A.,0,0,0,0
1668000790837,ECE 283,A00,103670,Hsueh; Tzu-Chien,0,0,0,0
1668000791268,ECE 284,A00,103671,Turakhia; Yatish Girish,0,0,0,0
1668000791694,ECE 285,A00,103672,Zheng; Yang,0,0,0,0
1668000791694,ECE 285,B00,103673,Sworder; David D.,0,0,0,0
1668000792118,ECE 287,A00,103676,Javidi; Tara,0,0,0,0
1668000792547,MATH 200B,A00,098023,Salehi Golsefidy; Alireza,14,0,15,1
1668000792977,MATH 202B,A00,098024,Rhoades; Brendon Patrick,12,0,15,3
1668000793404,MATH 203B,A00,098025,Oprea; Dragos N.,12,0,15,3
1668000793829,MATH 204B,A00,098026,Sorensen; Claus M,14,0,15,1
1668000794254,MATH 208,A00,098027,Izadi; Elham,7,0,10,3
1668000794680,MATH 209,A00,098028,Pollack; Aaron,10,0,10,0
1668000795108,MATH 211A,A00,112919,Rogalski; Daniel,9,0,10,1
1668000795533,MATH 211B,A00,112920,Seward; Brandon M.,9,0,10,1
1668000795957,MATH 218,A00,098029,Li; Bo,10,0,10,0
1668000796381,MATH 220B,A00,098030,Novak; Jonathan I,13,0,15,2
1668000796805,MATH 221A,A00,098031,Ebenfelt; Peter F,13,0,15,2
1668000797234,MATH 231B,A00,098032,Zlatos; Andrej,12,0,15,3
1668000797661,MATH 240B,A00,098033,Ni; Lei,10,0,15,5
1668000798087,MATH 243,A00,098034,Jekel; David Andrew,10,0,10,0
1668000798515,MATH 245A,A00,098035,Nie; Jiawang,0,0,15,16
1668000798938,MATH 248,A00,098036,Bejenaru; Ioan,10,0,10,0
1668000799367,MATH 250B,A00,098037,Spolaor; Luca,14,0,15,1
1668000799790,MATH 258,A00,098038,Ni; Lei,10,0,10,0
1668000800215,MATH 264B,A00,098041,Rhoades; Brendon Patrick,11,0,15,4
1668000800642,MATH 268,A00,098042,Buss; Samuel R,10,0,10,0
1668000801071,MATH 269,A00,098043,Rhoades; Brendon Patrick,10,0,10,0
1668000801496,MATH 270B,A00,098044,Li; Bo,11,0,15,4
1668000801917,MATH 272B,A00,098045,Holst; Michael J,13,0,15,2
1668000802347,MATH 273A,A00,098046,Tian; Xiaochuan,12,0,15,3
1668000802774,MATH 275,A01,098048,Tian; Xiaochuan,6,0,10,4
1668000803199,MATH 278A,A00,098049,Holst; Michael J,8,0,10,2
1668000803623,MATH 278B,A00,098050,Cloninger; Alexander,10,0,10,0
1668000804050,MATH 278C,A00,098051,Nie; Jiawang,8,0,10,2
1668000804477,MATH 280B,A00,098052,Zheng; Tianyi,11,0,15,4
1668000804900,MATH 281B,A00,098053,Bradic; Jelena,4,0,15,11
1668000805325,MATH 282B,A00,098054,Arias-Castro; Ery,2,0,15,13
1668000805749,MATH 285,A00,098055,Fitzsimmons; Patrick J,0,0,15,17
1668000806177,MATH 287B,A00,098056,Arias-Castro; Ery,5,0,15,10
1668000806608,MATH 288,A00,098057,Agarwal; Pooja,9,0,10,1
1668000806608,MATH 288,B00,098058,Zhang; Danna,9,0,10,1
1668000806608,MATH 288,C00,098059,Williams; Ruth J,10,0,10,0
1668000807035,MATH 290B,A00,098060,Roberts; Justin Deritter,14,0,15,1
1668000807459,MATH 292,A00,098061,Belmont; Eva Kinoshita,10,0,10,0
1668000807886,MATH 295,A00,098062,Suk; Andrew Hoon,48,0,50,2
1668000808314,MATH 296,A00,098063,Novak; Jonathan I,20,0,20,0
1668000808737,MATH 297,001,098064,Gamst; Anthony Collins,9997,0,9999,2
1668001310113,COGS 205,A00,101395,Chiba; Andrea,19,0,20,1
1668001310540,COGS 210B,001,101404,Greene; Deanna Jacquelyn,9998,0,9999,1
1668001310540,COGS 210B,002,101417,Xia; Haijun,9999,0,9999,0
1668001310540,COGS 210B,003,101422,Nitz; Douglas A.,9999,0,9999,0
1668001310540,COGS 210B,004,101423,Hollan; James D.,9998,0,9999,1
1668001310540,COGS 210B,005,101424,Deak; Gedeon O.,9999,0,9999,0
1668001310540,COGS 210B,006,101425,Rossano; Federico,9999,0,9999,0
1668001310971,COGS 211B,A00,101427,Coulson; Seana M,9997,0,9999,2
1668001311394,COGS 220,A00,101428,Hollan; James D.,0,0,25,25
1668001311818,COGS 229,A00,101429,Dow; Steven P,18,0,25,7
1668001312244,COGS 230,A00,101430,Klemmer; Scott R,13,0,17,4
1668001312668,COGS 234,A00,101431,Xia; Haijun,7,0,25,18
1668001313092,COGS 260,A00,101432,Kiyonaga; Anastasia,20,0,25,5
1668001313092,COGS 260,B00,101433,Kirsh; David Joel,16,0,25,9
1668001313518,CSE 202,A00,102371,Impagliazzo; Russell,0,0,0,0
1668001313944,CSE 203B,A01,102373,Cheng; Chung Kuan,0,0,0,0
1668001314368,CSE 208,A00,102374,Micciancio; Daniele,0,0,0,0
1668001314791,CSE 209A,A00,112895,Impagliazzo; Russell,0,0,15,15
1668001315218,CSE 209B,A00,108005,Bellare; Mihir,0,0,0,0
1668001315644,CSE 210,A00,113163,Coblenz; Michael J,0,0,0,0
1668001316069,CSE 219,A00,106111,Dow; Steven P,0,0,20,20
1668001316494,CSE 221,A00,102376,Voelker; Geoffrey M.,0,0,0,0
1668001316920,CSE 224,A01,102378,Porter; George M,0,0,0,0
1668001317345,CSE 229A,A00,102379,Savage; Stefan,0,0,0,0
1668001317770,CSE 229C,A00,102380,Munyaka; Imani N. S.,0,0,0,0
1668001318194,CSE 232B,A00,102382,Deutsch; Alin Bernard,0,0,0,0
1668001318617,CSE 234,A01,112904,Kumar; Arun Kumar,0,0,0,0
1668001319043,CSE 237A,A00,102383,Rosing; Tajana Simunic,0,0,0,0
1668001319468,CSE 239A,A00,102384,Deutsch; Alin Bernard,0,0,0,0
1668001319892,CSE 239B,A00,102385,Polikarpova; Nadezhda,0,0,0,0
1668001320317,CSE 240A,A00,102386,Pannuto; Patrick William,0,0,0,0
1668001320744,CSE 240B,A00,102387,Zhao; Jishen,0,0,0,0
1668001321172,CSE 241A,A00,106406,Kang; Mingu,0,0,0,0
1668001321597,CSE 249B,A00,102388,Kahng; Andrew Byun,0,0,8,8
1668001322029,CSE 251B,A01,102392,Cottrell; Garrison W,0,0,0,0
1668001322029,CSE 251B,A02,102393,Cottrell; Garrison W,0,0,0,0
1668001322458,CSE 252B,A00,102394,Ochoa; Benjamin Lawrence,0,0,0,0
1668001322883,CSE 257,A01,102396,Gao; Sicun,0,0,0,0
1668001323310,CSE 272,A00,102397,Li; Tzumao,0,0,0,0
1668001323742,CSE 274,A00,111323,Chern; Albert Ren-Haur,0,0,0,0
1668001324166,CSE 282,A00,102398,Pevzner; Pavel Arkadjevich,0,0,0,0
1668001324591,CSE 284,A00,114175,Gymrek; Melissa Ann,0,0,0,0
1668001325015,CSE 290,A00,102399,Chandraker; Manmohan Krishna,0,0,0,0
1668001325015,CSE 290,B00,102400,Vaccaro; Kristen Marie,0,0,25,25
1668001325015,CSE 290,C00,102414,Pannuto; Patrick William,0,0,25,25
1668001325015,CSE 290,D00,102427,Pevzner; Pavel Arkadjevich,0,0,0,0
1668001325015,CSE 290,E00,102429,Zhao; Jishen,0,0,0,0
1668001325015,CSE 290,F00,102436,Tullsen; Dean Michael,0,0,0,0
1668001325015,CSE 290,G00,102440,Christensen; Henrik I,0,0,20,20
1668001325446,CSE 291,A00,102443,Su; Hao,0,0,0,0
1668001325446,CSE 291,B00,102448,Polikarpova; Nadezhda,0,0,0,0
1668001325446,CSE 291,C00,102453,Vaccaro; Kristen Marie,0,0,0,0
1668001325446,CSE 291,D00,111343,Savage; Stefan,0,0,0,0
1668001325446,CSE 291,E00,116474,Claffy; Kimberly Claire,0,0,0,0
1668001325446,CSE 291,F00,116479,Pasquale; Joseph,0,0,0,0
1668001325879,CSE 293,001,119111,Bafna; Vineet,9999,0,9999,0
1668001325879,CSE 293,002,119118,Bellare; Mihir,9999,0,9999,0
1668001325879,CSE 293,003,119122,Berg-Kirkpatrick; Taylor D,9999,0,9999,0
1668001325879,CSE 293,004,119135,Christensen; Henrik I,9999,0,9999,0
1668001325879,CSE 293,005,119142,Cottrell; Garrison W,9999,0,9999,0
1668001325879,CSE 293,006,119146,Deutsch; Alin Bernard,9999,0,9999,0
1668001325879,CSE 293,007,119159,Esmaeilzadeh; Hadi,9999,0,9999,0
1668001325879,CSE 293,008,119166,Freund; Yoav,9999,0,9999,0
1668001325879,CSE 293,009,119170,Griswold; William G.,9999,0,9999,0
1668001325879,CSE 293,010,119183,Gymrek; Melissa Ann,9999,0,9999,0
1668001325879,CSE 293,011,119190,Heninger; Nadia A,9999,0,9999,0
1668001325879,CSE 293,012,119230,Impagliazzo; Russell,9999,0,9999,0
1668001325879,CSE 293,013,119232,Jhala; Ranjit,9999,0,9999,0
1668001325879,CSE 293,014,119233,Kahng; Andrew Byun,9999,0,9999,0
1668001325879,CSE 293,015,119298,Kane; Daniel Mertz,9999,0,9999,0
1668001325879,CSE 293,016,119299,Kriegman; David J,9999,0,9999,0
1668001325879,CSE 293,017,119300,Kumar; Arun Kumar,9999,0,9999,0
1668001325879,CSE 293,018,119301,Lerner; Sorin,9999,0,9999,0
1668001325879,CSE 293,019,119302,Lovett; Shachar,9999,0,9999,0
1668001325879,CSE 293,020,119303,McAuley; Julian John,9999,0,9999,0
1668001325879,CSE 293,021,119304,Micciancio; Daniele,9999,0,9999,0
1668001325879,CSE 293,022,119367,Orailoglu; Alex,9999,0,9999,0
1668001325879,CSE 293,023,119382,Paturi; Ramamohan,9999,0,9999,0
1668001325879,CSE 293,024,119404,Polikarpova; Nadezhda,9999,0,9999,0
1668001325879,CSE 293,025,119406,Politz; Joseph Gibbs,9999,0,9999,0
1668001325879,CSE 293,026,119411,Porter; George M,9999,0,9999,0
1668001325879,CSE 293,027,119414,Porter; Leonard Emerson,9999,0,9999,0
1668001325879,CSE 293,028,119416,Ramamoorthi; Ravi,9999,0,9999,0
1668001325879,CSE 293,029,119417,Sahoo; Debashis,9999,0,9999,0
1668001325879,CSE 293,030,119420,Saul; Lawrence,9999,0,9999,0
1668001325879,CSE 293,031,119421,Savage; Stefan,9999,0,9999,0
1668001325879,CSE 293,032,119425,Schulze; Jurgen P.,9999,0,9999,0
1668001325879,CSE 293,033,119426,Snoeren; Alex C.,9999,0,9999,0
1668001325879,CSE 293,034,119428,Shang; Jingbo,9999,0,9999,0
1668001325879,CSE 293,035,119430,Stefan; Deian,9999,0,9999,0
1668001325879,CSE 293,036,119431,Su; Hao,9999,0,9999,0
1668001325879,CSE 293,037,119433,Swanson; Steven James,9999,0,9999,0
1668001325879,CSE 293,038,119435,Tullsen; Dean Michael,9999,0,9999,0
1668001325879,CSE 293,039,119483,Voelker; Geoffrey M.,9999,0,9999,0
1668001325879,CSE 293,040,119537,Zhao; Jishen,9999,0,9999,0
1668001325879,CSE 293,041,119538,Zhou; Yuan-Yuan,9999,0,9999,0
1668001325879,CSE 293,042,119539,Gao; Sicun,9999,0,9999,0
1668001325879,CSE 293,043,119540,Weibel; Nadir,9999,0,9999,0
1668001325879,CSE 293,044,119541,Gupta; Rajesh K.,9999,0,9999,0
1668001325879,CSE 293,045,126410,Vaccaro; Kristen Marie,9999,0,9999,0
1668001325879,CSE 293,046,126411,Klemke; Richard,9999,0,9999,0
1668001326319,CSE 294,A00,102459,Voelker; Geoffrey M.,0,0,0,0
1668001326319,CSE 294,B00,111322,Orailoglu; Alex,0,0,0,0
1668001326749,DSE 201,A00,096914,Deutsch; Alin Bernard,30,0,30,0
1668001327174,DSE 210,A00,096915,Dasgupta; Sanjoy,30,0,30,0
1668001327608,DSE 260A,A00,096916,Altintas De Callaf; Ilkay,30,0,30,0
1668001328052,ECE 200,001,103586,Antipa; Nicholas A,9999,0,9999,0
1668001328052,ECE 200,002,103587,Atanasov; Nikolay A.,9999,0,9999,0
1668001328052,ECE 200,003,103588,Bharadia; Dinesh,9999,0,9999,0
1668001328052,ECE 200,004,103589,Cheng; Chung Kuan,9999,0,9999,0
1668001328052,ECE 200,005,103590,Cosman; Pamela C.,9999,0,9999,0
1668001328052,ECE 200,006,103591,Dayeh; Shadi Ahmad,9999,0,9999,0
1668001328052,ECE 200,007,103592,Fainman; Yeshaiahu,9999,0,9999,0
1668001328052,ECE 200,008,103593,Ford; Joseph Earl,9999,0,9999,0
1668001328052,ECE 200,009,103594,Franceschetti; Massimo,9999,0,9999,0
1668001328052,ECE 200,010,103595,Fullerton; Eric E,9999,0,9999,0
1668001328052,ECE 200,011,103596,Galton; Ian A,9999,0,9999,0
1668001328052,ECE 200,012,103597,Gilja; Vikash,9999,0,9999,0
1668001328052,ECE 200,013,103598,Hall; Drew A.,9999,0,9999,0
1668001328052,ECE 200,014,103599,Hsueh; Tzu-Chien,9999,0,9999,0
1668001328052,ECE 200,015,103600,Javidi; Tara,9999,0,9999,0
1668001328052,ECE 200,016,103601,Kahng; Andrew Byun,9999,0,9999,0
1668001328052,ECE 200,017,103602,Kim; Young-Han,9999,0,9999,0
1668001328052,ECE 200,018,103603,Koushanfar; Farinaz,9999,0,9999,0
1668001328052,ECE 200,019,103604,Kuzum; Duygu,9999,0,9999,0
1668001328052,ECE 200,020,103605,Le; Hanh-Phuc,9999,0,9999,0
1668001328052,ECE 200,021,103606,Lin; Bill,9999,0,9999,0
1668001328052,ECE 200,022,103607,Liu; Zhaowei,9998,0,9999,1
1668001328052,ECE 200,023,103608,Lo; Yu-Hwa,9999,0,9999,0
1668001328052,ECE 200,024,103609,Lomakin; Vitaliy,9999,0,9999,0
1668001328052,ECE 200,025,103610,Mercier; Patrick Philip,9999,0,9999,0
1668001328052,ECE 200,026,103611,Meyer; Florian,9999,0,9999,0
1668001328052,ECE 200,027,103612,Milstein; Laurence B.,9999,0,9999,0
1668001328052,ECE 200,028,103613,Mir Arabbaygi; Siavash,9999,0,9999,0
1668001328052,ECE 200,029,103614,Mookherjea; Shayan,9999,0,9999,0
1668001328052,ECE 200,030,103615,Morris; Karcher William,9999,0,9999,0
1668001328052,ECE 200,031,103616,Ng; Tse Nga,9999,0,9999,0
1668001328052,ECE 200,032,103617,Nguyen; Truong Quang,9999,0,9999,0
1668001328052,ECE 200,033,103618,Nomura; Kenji,9999,0,9999,0
1668001328052,ECE 200,034,103619,Orlitsky; Alon,9999,0,9999,0
1668001328052,ECE 200,035,103620,Pal; Piya,9999,0,9999,0
1668001328052,ECE 200,036,103621,Papen; George C.,9999,0,9999,0
1668001328052,ECE 200,037,103622,Radic; Stojan,9999,0,9999,0
1668001328052,ECE 200,038,103623,Rao; Bhaskar D.,9999,0,9999,0
1668001328052,ECE 200,039,103624,Rao; Ramesh R,9999,0,9999,0
1668001328052,ECE 200,040,103625,Rebeiz; Gabriel,9999,0,9999,0
1668001328052,ECE 200,041,103626,Sanford; John R,9999,0,9999,0
1668001328052,ECE 200,042,103627,Siegel; Paul H.,9999,0,9999,0
1668001328052,ECE 200,043,103628,Sievenpiper; Daniel F.,9999,0,9999,0
1668001328052,ECE 200,044,103629,Sworder; David D.,9999,0,9999,0
1668001328052,ECE 200,045,103630,Taur; Yuan,9999,0,9999,0
1668001328052,ECE 200,046,103631,Touri; Behrouz,9999,0,9999,0
1668001328052,ECE 200,047,103632,Trivedi; Mohan M.,9999,0,9999,0
1668001328052,ECE 200,048,103633,Vasconcelos; Nuno,9999,0,9999,0
1668001328052,ECE 200,049,103634,Wang; Xiaolong,9999,0,9999,0
1668001328052,ECE 200,050,103635,Xie; Pengtao,9999,0,9999,0
1668001328052,ECE 200,051,103636,Yip; Michael,9999,0,9999,0
1668001328052,ECE 200,052,103637,Zeger; Kenneth A.,999,0,999,0
1668001328052,ECE 200,053,103638,Zhang; Xinyu,9999,0,9999,0
1668001328052,ECE 200,054,103639,Turakhia; Yatish Girish,9999,0,9999,0
1668001328052,ECE 200,055,103640,Kang; Mingu,9999,0,9999,0
1668001328052,ECE 200,056,103641,Shi; Yuanyuan,9999,0,9999,0
1668001328052,ECE 200,057,103642,Wang; Edward Jay,9999,0,9999,0
1668001328052,ECE 200,058,103643,Zheng; Yang,9999,0,9999,0
1668001328476,ECE 202,A00,103644,Kuzum; Duygu,0,0,0,0
1668001328901,ECE 212BN,A00,103646,Ng; Tse Nga,0,0,0,0
1668001329329,ECE 221,A00,111493,Staff,0,0,0,0
1668001329754,ECE 222B,A00,103647,Lomakin; Vitaliy,0,0,0,0
1668001330177,ECE 230B,A00,103648,Taur; Yuan,0,0,0,0
1668001330603,ECE 238B,A00,103649,Garay; Javier,0,0,0,0
1668001331030,ECE 240B,A00,112900,Fainman; Yeshaiahu,0,0,0,0
1668001331454,ECE 247A,A00,103650,Jokerst; Jesse Vincent,0,0,0,0
1668001331878,ECE 247B,A00,103651,Wang; Joseph,0,0,0,0
1668001332306,ECE 250,A00,103652,Siegel; Paul H.,0,0,0,0
1668001332734,ECE 251A,A00,103654,Rao; Bhaskar D.,0,0,0,0
1668001333274,ECE 257B,A00,103655,Bharadia; Dinesh,0,0,0,0
1668001333699,ECE 258A,A00,103656,Milstein; Laurence B.,0,0,0,0
1668001334126,ECE 260B,A00,103658,Kang; Mingu,0,0,0,0
1668001334562,ECE 264A,A00,103659,Galton; Ian A,0,0,0,0
1668001334992,ECE 265A,A00,103661,Gudem; Prasad S.S.,0,0,0,0
1668001335415,ECE 265D,A00,103662,Gudem; Prasad S.S.,0,0,0,0
1668001335845,ECE 268,A00,103663,Koushanfar; Farinaz,0,0,0,0
1668001336272,ECE 269,A01,103665,Pal; Piya,0,0,0,0
1668001336699,ECE 271B,A00,103666,Vasconcelos; Manuela,0,0,0,0
1668001337123,ECE 276A,A00,103667,Atanasov; Nikolay A.,0,0,0,0
1668001337549,ECE 277,A00,103668,An; Cheolhong,0,0,0,0
1668001337973,ECE 279,A00,117947,Hall; Drew A.,0,0,0,0
1668001338822,ECE 283,A00,103670,Hsueh; Tzu-Chien,0,0,0,0
1668001339644,ECE 284,A00,103671,Turakhia; Yatish Girish,0,0,0,0
1668001340069,ECE 285,A00,103672,Zheng; Yang,0,0,0,0
1668001340069,ECE 285,B00,103673,Sworder; David D.,0,0,0,0
1668001340494,ECE 287,A00,103676,Javidi; Tara,0,0,0,0
1668001340928,MATH 200B,A00,098023,Salehi Golsefidy; Alireza,14,0,15,1
1668001341359,MATH 202B,A00,098024,Rhoades; Brendon Patrick,12,0,15,3
1668001341785,MATH 203B,A00,098025,Oprea; Dragos N.,12,0,15,3
1668001342213,MATH 204B,A00,098026,Sorensen; Claus M,14,0,15,1
1668001342638,MATH 208,A00,098027,Izadi; Elham,7,0,10,3
1668001343139,MATH 209,A00,098028,Pollack; Aaron,10,0,10,0
1668001343565,MATH 211A,A00,112919,Rogalski; Daniel,9,0,10,1
1668001343989,MATH 211B,A00,112920,Seward; Brandon M.,9,0,10,1
1668001344417,MATH 218,A00,098029,Li; Bo,10,0,10,0
1668001344843,MATH 220B,A00,098030,Novak; Jonathan I,13,0,15,2
1668001345272,MATH 221A,A00,098031,Ebenfelt; Peter F,13,0,15,2
1668001345698,MATH 231B,A00,098032,Zlatos; Andrej,12,0,15,3
1668001346122,MATH 240B,A00,098033,Ni; Lei,10,0,15,5
1668001346553,MATH 243,A00,098034,Jekel; David Andrew,10,0,10,0
1668001346978,MATH 245A,A00,098035,Nie; Jiawang,0,0,15,16
1668001347406,MATH 248,A00,098036,Bejenaru; Ioan,10,0,10,0
1668001347832,MATH 250B,A00,098037,Spolaor; Luca,14,0,15,1
1668001348259,MATH 258,A00,098038,Ni; Lei,10,0,10,0
1668001348686,MATH 264B,A00,098041,Rhoades; Brendon Patrick,11,0,15,4
1668001349111,MATH 268,A00,098042,Buss; Samuel R,10,0,10,0
1668001349537,MATH 269,A00,098043,Rhoades; Brendon Patrick,10,0,10,0
1668001349965,MATH 270B,A00,098044,Li; Bo,11,0,15,4
1668001350390,MATH 272B,A00,098045,Holst; Michael J,13,0,15,2
1668001350813,MATH 273A,A00,098046,Tian; Xiaochuan,12,0,15,3
1668001351236,MATH 275,A01,098048,Tian; Xiaochuan,6,0,10,4
1668001351662,MATH 278A,A00,098049,Holst; Michael J,8,0,10,2
1668001352086,MATH 278B,A00,098050,Cloninger; Alexander,10,0,10,0
1668001352519,MATH 278C,A00,098051,Nie; Jiawang,8,0,10,2
1668001352949,MATH 280B,A00,098052,Zheng; Tianyi,11,0,15,4
1668001353372,MATH 281B,A00,098053,Bradic; Jelena,4,0,15,11
1668001353800,MATH 282B,A00,098054,Arias-Castro; Ery,2,0,15,13
1668001354232,MATH 285,A00,098055,Fitzsimmons; Patrick J,0,0,15,17
1668001354658,MATH 287B,A00,098056,Arias-Castro; Ery,5,0,15,10
1668001355089,MATH 288,A00,098057,Agarwal; Pooja,9,0,10,1
1668001355089,MATH 288,B00,098058,Zhang; Danna,9,0,10,1
1668001355089,MATH 288,C00,098059,Williams; Ruth J,10,0,10,0
1668001355517,MATH 290B,A00,098060,Roberts; Justin Deritter,14,0,15,1
1668001355945,MATH 292,A00,098061,Belmont; Eva Kinoshita,10,0,10,0
1668001356369,MATH 295,A00,098062,Suk; Andrew Hoon,48,0,50,2
1668001356805,MATH 296,A00,098063,Novak; Jonathan I,20,0,20,0
1668001357231,MATH 297,001,098064,Gamst; Anthony Collins,9997,0,9999,2
1668001859388,COGS 205,A00,101395,Chiba; Andrea,19,0,20,1
1668001859828,COGS 210B,001,101404,Greene; Deanna Jacquelyn,9998,0,9999,1
1668001859828,COGS 210B,002,101417,Xia; Haijun,9999,0,9999,0
1668001859828,COGS 210B,003,101422,Nitz; Douglas A.,9999,0,9999,0
1668001859828,COGS 210B,004,101423,Hollan; James D.,9998,0,9999,1
1668001859828,COGS 210B,005,101424,Deak; Gedeon O.,9999,0,9999,0
1668001859828,COGS 210B,006,101425,Rossano; Federico,9999,0,9999,0
1668001860255,COGS 211B,A00,101427,Coulson; Seana M,9997,0,9999,2
1668001860678,COGS 220,A00,101428,Hollan; James D.,0,0,25,25
1668001861107,COGS 229,A00,101429,Dow; Steven P,18,0,25,7
1668001861545,COGS 230,A00,101430,Klemmer; Scott R,13,0,17,4
1668001861975,COGS 234,A00,101431,Xia; Haijun,7,0,25,18
1668001862407,COGS 260,A00,101432,Kiyonaga; Anastasia,20,0,25,5
1668001862407,COGS 260,B00,101433,Kirsh; David Joel,16,0,25,9
1668001862849,CSE 202,A00,102371,Impagliazzo; Russell,0,0,0,0
1668001863284,CSE 203B,A01,102373,Cheng; Chung Kuan,0,0,0,0
1668001863708,CSE 208,A00,102374,Micciancio; Daniele,0,0,0,0
1668001864135,CSE 209A,A00,112895,Impagliazzo; Russell,0,0,15,15
1668001864564,CSE 209B,A00,108005,Bellare; Mihir,0,0,0,0
1668001864995,CSE 210,A00,113163,Coblenz; Michael J,0,0,0,0
1668001865420,CSE 219,A00,106111,Dow; Steven P,0,0,20,20
1668001865846,CSE 221,A00,102376,Voelker; Geoffrey M.,0,0,0,0
1668001866278,CSE 224,A01,102378,Porter; George M,0,0,0,0
1668001866703,CSE 229A,A00,102379,Savage; Stefan,0,0,0,0
1668001867128,CSE 229C,A00,102380,Munyaka; Imani N. S.,0,0,0,0
1668001867559,CSE 232B,A00,102382,Deutsch; Alin Bernard,0,0,0,0
1668001867986,CSE 234,A01,112904,Kumar; Arun Kumar,0,0,0,0
1668001868420,CSE 237A,A00,102383,Rosing; Tajana Simunic,0,0,0,0
1668001868844,CSE 239A,A00,102384,Deutsch; Alin Bernard,0,0,0,0
1668001869267,CSE 239B,A00,102385,Polikarpova; Nadezhda,0,0,0,0
1668001869694,CSE 240A,A00,102386,Pannuto; Patrick William,0,0,0,0
1668001870117,CSE 240B,A00,102387,Zhao; Jishen,0,0,0,0
1668001870558,CSE 241A,A00,106406,Kang; Mingu,0,0,0,0
1668001870985,CSE 249B,A00,102388,Kahng; Andrew Byun,0,0,8,8
1668001871409,CSE 251B,A01,102392,Cottrell; Garrison W,0,0,0,0
1668001871409,CSE 251B,A02,102393,Cottrell; Garrison W,0,0,0,0
1668001871837,CSE 252B,A00,102394,Ochoa; Benjamin Lawrence,0,0,0,0
1668001872266,CSE 257,A01,102396,Gao; Sicun,0,0,0,0
1668001872691,CSE 272,A00,102397,Li; Tzumao,0,0,0,0
1668001873121,CSE 274,A00,111323,Chern; Albert Ren-Haur,0,0,0,0
1668001873546,CSE 282,A00,102398,Pevzner; Pavel Arkadjevich,0,0,0,0
1668001873977,CSE 284,A00,114175,Gymrek; Melissa Ann,0,0,0,0
1668001874410,CSE 290,A00,102399,Chandraker; Manmohan Krishna,0,0,0,0
1668001874410,CSE 290,B00,102400,Vaccaro; Kristen Marie,0,0,25,25
1668001874410,CSE 290,C00,102414,Pannuto; Patrick William,0,0,25,25
1668001874410,CSE 290,D00,102427,Pevzner; Pavel Arkadjevich,0,0,0,0
1668001874410,CSE 290,E00,102429,Zhao; Jishen,0,0,0,0
1668001874410,CSE 290,F00,102436,Tullsen; Dean Michael,0,0,0,0
1668001874410,CSE 290,G00,102440,Christensen; Henrik I,0,0,20,20
1668001874858,CSE 291,A00,102443,Su; Hao,0,0,0,0
1668001874858,CSE 291,B00,102448,Polikarpova; Nadezhda,0,0,0,0
1668001874858,CSE 291,C00,102453,Vaccaro; Kristen Marie,0,0,0,0
1668001874858,CSE 291,D00,111343,Savage; Stefan,0,0,0,0
1668001874858,CSE 291,E00,116474,Claffy; Kimberly Claire,0,0,0,0
1668001874858,CSE 291,F00,116479,Pasquale; Joseph,0,0,0,0
1668001875315,CSE 293,001,119111,Bafna; Vineet,9999,0,9999,0
1668001875315,CSE 293,002,119118,Bellare; Mihir,9999,0,9999,0
1668001875315,CSE 293,003,119122,Berg-Kirkpatrick; Taylor D,9999,0,9999,0
1668001875315,CSE 293,004,119135,Christensen; Henrik I,9999,0,9999,0
1668001875315,CSE 293,005,119142,Cottrell; Garrison W,9999,0,9999,0
1668001875315,CSE 293,006,119146,Deutsch; Alin Bernard,9999,0,9999,0
1668001875315,CSE 293,007,119159,Esmaeilzadeh; Hadi,9999,0,9999,0
1668001875315,CSE 293,008,119166,Freund; Yoav,9999,0,9999,0
1668001875315,CSE 293,009,119170,Griswold; William G.,9999,0,9999,0
1668001875315,CSE 293,010,119183,Gymrek; Melissa Ann,9999,0,9999,0
1668001875315,CSE 293,011,119190,Heninger; Nadia A,9999,0,9999,0
1668001875315,CSE 293,012,119230,Impagliazzo; Russell,9999,0,9999,0
1668001875315,CSE 293,013,119232,Jhala; Ranjit,9999,0,9999,0
1668001875315,CSE 293,014,119233,Kahng; Andrew Byun,9999,0,9999,0
1668001875315,CSE 293,015,119298,Kane; Daniel Mertz,9999,0,9999,0
1668001875315,CSE 293,016,119299,Kriegman; David J,9999,0,9999,0
1668001875315,CSE 293,017,119300,Kumar; Arun Kumar,9999,0,9999,0
1668001875315,CSE 293,018,119301,Lerner; Sorin,9999,0,9999,0
1668001875315,CSE 293,019,119302,Lovett; Shachar,9999,0,9999,0
1668001875315,CSE 293,020,119303,McAuley; Julian John,9999,0,9999,0
1668001875315,CSE 293,021,119304,Micciancio; Daniele,9999,0,9999,0
1668001875315,CSE 293,022,119367,Orailoglu; Alex,9999,0,9999,0
1668001875315,CSE 293,023,119382,Paturi; Ramamohan,9999,0,9999,0
1668001875315,CSE 293,024,119404,Polikarpova; Nadezhda,9999,0,9999,0
1668001875315,CSE 293,025,119406,Politz; Joseph Gibbs,9999,0,9999,0
1668001875315,CSE 293,026,119411,Porter; George M,9999,0,9999,0
1668001875315,CSE 293,027,119414,Porter; Leonard Emerson,9999,0,9999,0
1668001875315,CSE 293,028,119416,Ramamoorthi; Ravi,9999,0,9999,0
1668001875315,CSE 293,029,119417,Sahoo; Debashis,9999,0,9999,0
1668001875315,CSE 293,030,119420,Saul; Lawrence,9999,0,9999,0
1668001875315,CSE 293,031,119421,Savage; Stefan,9999,0,9999,0
1668001875315,CSE 293,032,119425,Schulze; Jurgen P.,9999,0,9999,0
1668001875315,CSE 293,033,119426,Snoeren; Alex C.,9999,0,9999,0
1668001875315,CSE 293,034,119428,Shang; Jingbo,9999,0,9999,0
1668001875315,CSE 293,035,119430,Stefan; Deian,9999,0,9999,0
1668001875315,CSE 293,036,119431,Su; Hao,9999,0,9999,0
1668001875315,CSE 293,037,119433,Swanson; Steven James,9999,0,9999,0
1668001875315,CSE 293,038,119435,Tullsen; Dean Michael,9999,0,9999,0
1668001875315,CSE 293,039,119483,Voelker; Geoffrey M.,9999,0,9999,0
1668001875315,CSE 293,040,119537,Zhao; Jishen,9999,0,9999,0
1668001875315,CSE 293,041,119538,Zhou; Yuan-Yuan,9999,0,9999,0
1668001875315,CSE 293,042,119539,Gao; Sicun,9999,0,9999,0
1668001875315,CSE 293,043,119540,Weibel; Nadir,9999,0,9999,0
1668001875315,CSE 293,044,119541,Gupta; Rajesh K.,9999,0,9999,0
1668001875315,CSE 293,045,126410,Vaccaro; Kristen Marie,9999,0,9999,0
1668001875315,CSE 293,046,126411,Klemke; Richard,9999,0,9999,0
1668001875742,CSE 294,A00,102459,Voelker; Geoffrey M.,0,0,0,0
1668001875742,CSE 294,B00,111322,Orailoglu; Alex,0,0,0,0
1668001876172,DSE 201,A00,096914,Deutsch; Alin Bernard,30,0,30,0
1668001876600,DSE 210,A00,096915,Dasgupta; Sanjoy,30,0,30,0
1668001877027,DSE 260A,A00,096916,Altintas De Callaf; Ilkay,30,0,30,0
1668001877478,ECE 200,001,103586,Antipa; Nicholas A,9999,0,9999,0
1668001877478,ECE 200,002,103587,Atanasov; Nikolay A.,9999,0,9999,0
1668001877478,ECE 200,003,103588,Bharadia; Dinesh,9999,0,9999,0
1668001877478,ECE 200,004,103589,Cheng; Chung Kuan,9999,0,9999,0
1668001877478,ECE 200,005,103590,Cosman; Pamela C.,9999,0,9999,0
1668001877478,ECE 200,006,103591,Dayeh; Shadi Ahmad,9999,0,9999,0
1668001877478,ECE 200,007,103592,Fainman; Yeshaiahu,9999,0,9999,0
1668001877478,ECE 200,008,103593,Ford; Joseph Earl,9999,0,9999,0
1668001877478,ECE 200,009,103594,Franceschetti; Massimo,9999,0,9999,0
1668001877478,ECE 200,010,103595,Fullerton; Eric E,9999,0,9999,0
1668001877478,ECE 200,011,103596,Galton; Ian A,9999,0,9999,0
1668001877478,ECE 200,012,103597,Gilja; Vikash,9999,0,9999,0
1668001877478,ECE 200,013,103598,Hall; Drew A.,9999,0,9999,0
1668001877478,ECE 200,014,103599,Hsueh; Tzu-Chien,9999,0,9999,0
1668001877478,ECE 200,015,103600,Javidi; Tara,9999,0,9999,0
1668001877478,ECE 200,016,103601,Kahng; Andrew Byun,9999,0,9999,0
1668001877478,ECE 200,017,103602,Kim; Young-Han,9999,0,9999,0
1668001877478,ECE 200,018,103603,Koushanfar; Farinaz,9999,0,9999,0
1668001877478,ECE 200,019,103604,Kuzum; Duygu,9999,0,9999,0
1668001877478,ECE 200,020,103605,Le; Hanh-Phuc,9999,0,9999,0
1668001877478,ECE 200,021,103606,Lin; Bill,9999,0,9999,0
1668001877478,ECE 200,022,103607,Liu; Zhaowei,9998,0,9999,1
1668001877478,ECE 200,023,103608,Lo; Yu-Hwa,9999,0,9999,0
1668001877478,ECE 200,024,103609,Lomakin; Vitaliy,9999,0,9999,0
1668001877478,ECE 200,025,103610,Mercier; Patrick Philip,9999,0,9999,0
1668001877478,ECE 200,026,103611,Meyer; Florian,9999,0,9999,0
1668001877478,ECE 200,027,103612,Milstein; Laurence B.,9999,0,9999,0
1668001877478,ECE 200,028,103613,Mir Arabbaygi; Siavash,9999,0,9999,0
1668001877478,ECE 200,029,103614,Mookherjea; Shayan,9999,0,9999,0
1668001877478,ECE 200,030,103615,Morris; Karcher William,9999,0,9999,0
1668001877478,ECE 200,031,103616,Ng; Tse Nga,9999,0,9999,0
1668001877478,ECE 200,032,103617,Nguyen; Truong Quang,9999,0,9999,0
1668001877478,ECE 200,033,103618,Nomura; Kenji,9999,0,9999,0
1668001877478,ECE 200,034,103619,Orlitsky; Alon,9999,0,9999,0
1668001877478,ECE 200,035,103620,Pal; Piya,9999,0,9999,0
1668001877478,ECE 200,036,103621,Papen; George C.,9999,0,9999,0
1668001877478,ECE 200,037,103622,Radic; Stojan,9999,0,9999,0
1668001877478,ECE 200,038,103623,Rao; Bhaskar D.,9999,0,9999,0
1668001877478,ECE 200,039,103624,Rao; Ramesh R,9999,0,9999,0
1668001877478,ECE 200,040,103625,Rebeiz; Gabriel,9999,0,9999,0
1668001877478,ECE 200,041,103626,Sanford; John R,9999,0,9999,0
1668001877478,ECE 200,042,103627,Siegel; Paul H.,9999,0,9999,0
1668001877478,ECE 200,043,103628,Sievenpiper; Daniel F.,9999,0,9999,0
1668001877478,ECE 200,044,103629,Sworder; David D.,9999,0,9999,0
1668001877478,ECE 200,045,103630,Taur; Yuan,9999,0,9999,0
1668001877478,ECE 200,046,103631,Touri; Behrouz,9999,0,9999,0
1668001877478,ECE 200,047,103632,Trivedi; Mohan M.,9999,0,9999,0
1668001877478,ECE 200,048,103633,Vasconcelos; Nuno,9999,0,9999,0
1668001877478,ECE 200,049,103634,Wang; Xiaolong,9999,0,9999,0
1668001877478,ECE 200,050,103635,Xie; Pengtao,9999,0,9999,0
1668001877478,ECE 200,051,103636,Yip; Michael,9999,0,9999,0
1668001877478,ECE 200,052,103637,Zeger; Kenneth A.,999,0,999,0
1668001877478,ECE 200,053,103638,Zhang; Xinyu,9999,0,9999,0
1668001877478,ECE 200,054,103639,Turakhia; Yatish Girish,9999,0,9999,0
1668001877478,ECE 200,055,103640,Kang; Mingu,9999,0,9999,0
1668001877478,ECE 200,056,103641,Shi; Yuanyuan,9999,0,9999,0
1668001877478,ECE 200,057,103642,Wang; Edward Jay,9999,0,9999,0
1668001877478,ECE 200,058,103643,Zheng; Yang,9999,0,9999,0
1668001877907,ECE 202,A00,103644,Kuzum; Duygu,0,0,0,0
1668001878336,ECE 212BN,A00,103646,Ng; Tse Nga,0,0,0,0
1668001878762,ECE 221,A00,111493,Staff,0,0,0,0
1668001879187,ECE 222B,A00,103647,Lomakin; Vitaliy,0,0,0,0
1668001879614,ECE 230B,A00,103648,Taur; Yuan,0,0,0,0
1668001880040,ECE 238B,A00,103649,Garay; Javier,0,0,0,0
1668001880465,ECE 240B,A00,112900,Fainman; Yeshaiahu,0,0,0,0
1668001880892,ECE 247A,A00,103650,Jokerst; Jesse Vincent,0,0,0,0
1668001881321,ECE 247B,A00,103651,Wang; Joseph,0,0,0,0
1668001881746,ECE 250,A00,103652,Siegel; Paul H.,0,0,0,0
1668001882170,ECE 251A,A00,103654,Rao; Bhaskar D.,0,0,0,0
1668001882609,ECE 257B,A00,103655,Bharadia; Dinesh,0,0,0,0
1668001883032,ECE 258A,A00,103656,Milstein; Laurence B.,0,0,0,0
1668001883467,ECE 260B,A00,103658,Kang; Mingu,0,0,0,0
1668001883894,ECE 264A,A00,103659,Galton; Ian A,0,0,0,0
1668001884322,ECE 265A,A00,103661,Gudem; Prasad S.S.,0,0,0,0
1668001884758,ECE 265D,A00,103662,Gudem; Prasad S.S.,0,0,0,0
1668001885198,ECE 268,A00,103663,Koushanfar; Farinaz,0,0,0,0
1668001885621,ECE 269,A01,103665,Pal; Piya,0,0,0,0
1668001886053,ECE 271B,A00,103666,Vasconcelos; Manuela,0,0,0,0
1668001886492,ECE 276A,A00,103667,Atanasov; Nikolay A.,0,0,0,0
1668001886927,ECE 277,A00,103668,An; Cheolhong,0,0,0,0
1668001887354,ECE 279,A00,117947,Hall; Drew A.,0,0,0,0
1668001888203,ECE 283,A00,103670,Hsueh; Tzu-Chien,0,0,0,0
1668001888629,ECE 284,A00,103671,Turakhia; Yatish Girish,0,0,0,0
1668001889055,ECE 285,A00,103672,Zheng; Yang,0,0,0,0
1668001889055,ECE 285,B00,103673,Sworder; David D.,0,0,0,0
1668001889481,ECE 287,A00,103676,Javidi; Tara,0,0,0,0
1668001889905,MATH 200B,A00,098023,Salehi Golsefidy; Alireza,14,0,15,1
1668001890333,MATH 202B,A00,098024,Rhoades; Brendon Patrick,12,0,15,3
1668001890769,MATH 203B,A00,098025,Oprea; Dragos N.,12,0,15,3
1668001891192,MATH 204B,A00,098026,Sorensen; Claus M,14,0,15,1
1668001891621,MATH 208,A00,098027,Izadi; Elham,7,0,10,3
1668001892045,MATH 209,A00,098028,Pollack; Aaron,10,0,10,0
1668001892477,MATH 211A,A00,112919,Rogalski; Daniel,9,0,10,1
1668001892901,MATH 211B,A00,112920,Seward; Brandon M.,9,0,10,1
1668001893325,MATH 218,A00,098029,Li; Bo,10,0,10,0
1668001893754,MATH 220B,A00,098030,Novak; Jonathan I,13,0,15,2
1668001894182,MATH 221A,A00,098031,Ebenfelt; Peter F,13,0,15,2
1668001894627,MATH 231B,A00,098032,Zlatos; Andrej,12,0,15,3
1668001895052,MATH 240B,A00,098033,Ni; Lei,10,0,15,5
1668001895477,MATH 243,A00,098034,Jekel; David Andrew,10,0,10,0
1668001895903,MATH 245A,A00,098035,Nie; Jiawang,0,0,15,16
1668001896327,MATH 248,A00,098036,Bejenaru; Ioan,10,0,10,0
1668001896756,MATH 250B,A00,098037,Spolaor; Luca,14,0,15,1
1668001897180,MATH 258,A00,098038,Ni; Lei,10,0,10,0
1668001897611,MATH 264B,A00,098041,Rhoades; Brendon Patrick,11,0,15,4
1668001898046,MATH 268,A00,098042,Buss; Samuel R,10,0,10,0
1668001898485,MATH 269,A00,098043,Rhoades; Brendon Patrick,10,0,10,0
1668001898913,MATH 270B,A00,098044,Li; Bo,11,0,15,4
1668001899432,MATH 272B,A00,098045,Holst; Michael J,13,0,15,2
1668001899856,MATH 273A,A00,098046,Tian; Xiaochuan,12,0,15,3
1668001900283,MATH 275,A01,098048,Tian; Xiaochuan,6,0,10,4
1668001900709,MATH 278A,A00,098049,Holst; Michael J,8,0,10,2
1668001901136,MATH 278B,A00,098050,Cloninger; Alexander,10,0,10,0
1668001901573,MATH 278C,A00,098051,Nie; Jiawang,8,0,10,2
1668001902003,MATH 280B,A00,098052,Zheng; Tianyi,11,0,15,4
1668001902430,MATH 281B,A00,098053,Bradic; Jelena,4,0,15,11
1668001902855,MATH 282B,A00,098054,Arias-Castro; Ery,2,0,15,13
1668001903285,MATH 285,A00,098055,Fitzsimmons; Patrick J,0,0,15,17
1668001903709,MATH 287B,A00,098056,Arias-Castro; Ery,5,0,15,10
1668001904147,MATH 288,A00,098057,Agarwal; Pooja,9,0,10,1
1668001904147,MATH 288,B00,098058,Zhang; Danna,9,0,10,1
1668001904147,MATH 288,C00,098059,Williams; Ruth J,10,0,10,0
1668001904583,MATH 290B,A00,098060,Roberts; Justin Deritter,14,0,15,1
1668001905013,MATH 292,A00,098061,Belmont; Eva Kinoshita,10,0,10,0
1668001905448,MATH 295,A00,098062,Suk; Andrew Hoon,48,0,50,2
1668001905872,MATH 296,A00,098063,Novak; Jonathan I,20,0,20,0
1668001906301,MATH 297,001,098064,Gamst; Anthony Collins,9997,0,9999,2
1668002408778,COGS 205,A00,101395,Chiba; Andrea,19,0,20,1
1668002409214,COGS 210B,001,101404,Greene; Deanna Jacquelyn,9998,0,9999,1
1668002409214,COGS 210B,002,101417,Xia; Haijun,9999,0,9999,0
1668002409214,COGS 210B,003,101422,Nitz; Douglas A.,9999,0,9999,0
1668002409214,COGS 210B,004,101423,Hollan; James D.,9998,0,9999,1
1668002409214,COGS 210B,005,101424,Deak; Gedeon O.,9999,0,9999,0
1668002409214,COGS 210B,006,101425,Rossano; Federico,9999,0,9999,0
1668002409638,COGS 211B,A00,101427,Coulson; Seana M,9997,0,9999,2
1668002410068,COGS 220,A00,101428,Hollan; James D.,0,0,25,25
1668002410502,COGS 229,A00,101429,Dow; Steven P,18,0,25,7
1668002410933,COGS 230,A00,101430,Klemmer; Scott R,13,0,17,4
1668002411376,COGS 234,A00,101431,Xia; Haijun,7,0,25,18
1668002411813,COGS 260,A00,101432,Kiyonaga; Anastasia,20,0,25,5
1668002411813,COGS 260,B00,101433,Kirsh; David Joel,16,0,25,9
1668002412239,CSE 202,A00,102371,Impagliazzo; Russell,0,0,0,0
1668002412682,CSE 203B,A01,102373,Cheng; Chung Kuan,0,0,0,0
1668002413107,CSE 208,A00,102374,Micciancio; Daniele,0,0,0,0
1668002413537,CSE 209A,A00,112895,Impagliazzo; Russell,0,0,15,15
1668002413961,CSE 209B,A00,108005,Bellare; Mihir,0,0,0,0
1668002414396,CSE 210,A00,113163,Coblenz; Michael J,0,0,0,0
1668002414842,CSE 219,A00,106111,Dow; Steven P,0,0,20,20
1668002415273,CSE 221,A00,102376,Voelker; Geoffrey M.,0,0,0,0
1668002415697,CSE 224,A01,102378,Porter; George M,0,0,0,0
1668002416126,CSE 229A,A00,102379,Savage; Stefan,0,0,0,0
1668002416567,CSE 229C,A00,102380,Munyaka; Imani N. S.,0,0,0,0
1668002417000,CSE 232B,A00,102382,Deutsch; Alin Bernard,0,0,0,0
1668002417426,CSE 234,A01,112904,Kumar; Arun Kumar,0,0,0,0
1668002417853,CSE 237A,A00,102383,Rosing; Tajana Simunic,0,0,0,0
1668002418286,CSE 239A,A00,102384,Deutsch; Alin Bernard,0,0,0,0
1668002418714,CSE 239B,A00,102385,Polikarpova; Nadezhda,0,0,0,0
1668002419157,CSE 240A,A00,102386,Pannuto; Patrick William,0,0,0,0
1668002419582,CSE 240B,A00,102387,Zhao; Jishen,0,0,0,0
1668002420007,CSE 241A,A00,106406,Kang; Mingu,0,0,0,0
1668002420436,CSE 249B,A00,102388,Kahng; Andrew Byun,0,0,8,8
1668002420868,CSE 251B,A01,102392,Cottrell; Garrison W,0,0,0,0
1668002420868,CSE 251B,A02,102393,Cottrell; Garrison W,0,0,0,0
1668002421296,CSE 252B,A00,102394,Ochoa; Benjamin Lawrence,0,0,0,0
1668002421723,CSE 257,A01,102396,Gao; Sicun,0,0,0,0
1668002422231,CSE 272,A00,102397,Li; Tzumao,0,0,0,0
1668002422661,CSE 274,A00,111323,Chern; Albert Ren-Haur,0,0,0,0
1668002423092,CSE 282,A00,102398,Pevzner; Pavel Arkadjevich,0,0,0,0
1668002423524,CSE 284,A00,114175,Gymrek; Melissa Ann,0,0,0,0
1668002423957,CSE 290,A00,102399,Chandraker; Manmohan Krishna,0,0,0,0
1668002423957,CSE 290,B00,102400,Vaccaro; Kristen Marie,0,0,25,25
1668002423957,CSE 290,C00,102414,Pannuto; Patrick William,0,0,25,25
1668002423957,CSE 290,D00,102427,Pevzner; Pavel Arkadjevich,0,0,0,0
1668002423957,CSE 290,E00,102429,Zhao; Jishen,0,0,0,0
1668002423957,CSE 290,F00,102436,Tullsen; Dean Michael,0,0,0,0
1668002423957,CSE 290,G00,102440,Christensen; Henrik I,0,0,20,20
1668002424405,CSE 291,A00,102443,Su; Hao,0,0,0,0
1668002424405,CSE 291,B00,102448,Polikarpova; Nadezhda,0,0,0,0
1668002424405,CSE 291,C00,102453,Vaccaro; Kristen Marie,0,0,0,0
1668002424405,CSE 291,D00,111343,Savage; Stefan,0,0,0,0
1668002424405,CSE 291,E00,116474,Claffy; Kimberly Claire,0,0,0,0
1668002424405,CSE 291,F00,116479,Pasquale; Joseph,0,0,0,0
1668002424890,CSE 293,001,119111,Bafna; Vineet,9999,0,9999,0
1668002424890,CSE 293,002,119118,Bellare; Mihir,9999,0,9999,0
1668002424890,CSE 293,003,119122,Berg-Kirkpatrick; Taylor D,9999,0,9999,0
1668002424890,CSE 293,004,119135,Christensen; Henrik I,9999,0,9999,0
1668002424890,CSE 293,005,119142,Cottrell; Garrison W,9999,0,9999,0
1668002424890,CSE 293,006,119146,Deutsch; Alin Bernard,9999,0,9999,0
1668002424890,CSE 293,007,119159,Esmaeilzadeh; Hadi,9999,0,9999,0
1668002424890,CSE 293,008,119166,Freund; Yoav,9999,0,9999,0
1668002424890,CSE 293,009,119170,Griswold; William G.,9999,0,9999,0
1668002424890,CSE 293,010,119183,Gymrek; Melissa Ann,9999,0,9999,0
1668002424890,CSE 293,011,119190,Heninger; Nadia A,9999,0,9999,0
1668002424890,CSE 293,012,119230,Impagliazzo; Russell,9999,0,9999,0
1668002424890,CSE 293,013,119232,Jhala; Ranjit,9999,0,9999,0
1668002424890,CSE 293,014,119233,Kahng; Andrew Byun,9999,0,9999,0
1668002424890,CSE 293,015,119298,Kane; Daniel Mertz,9999,0,9999,0
1668002424890,CSE 293,016,119299,Kriegman; David J,9999,0,9999,0
1668002424890,CSE 293,017,119300,Kumar; Arun Kumar,9999,0,9999,0
1668002424890,CSE 293,018,119301,Lerner; Sorin,9999,0,9999,0
1668002424890,CSE 293,019,119302,Lovett; Shachar,9999,0,9999,0
1668002424890,CSE 293,020,119303,McAuley; Julian John,9999,0,9999,0
1668002424890,CSE 293,021,119304,Micciancio; Daniele,9999,0,9999,0
1668002424890,CSE 293,022,119367,Orailoglu; Alex,9999,0,9999,0
1668002424890,CSE 293,023,119382,Paturi; Ramamohan,9999,0,9999,0
1668002424890,CSE 293,024,119404,Polikarpova; Nadezhda,9999,0,9999,0
1668002424890,CSE 293,025,119406,Politz; Joseph Gibbs,9999,0,9999,0
1668002424890,CSE 293,026,119411,Porter; George M,9999,0,9999,0
1668002424890,CSE 293,027,119414,Porter; Leonard Emerson,9999,0,9999,0
1668002424890,CSE 293,028,119416,Ramamoorthi; Ravi,9999,0,9999,0
1668002424890,CSE 293,029,119417,Sahoo; Debashis,9999,0,9999,0
1668002424890,CSE 293,030,119420,Saul; Lawrence,9999,0,9999,0
1668002424890,CSE 293,031,119421,Savage; Stefan,9999,0,9999,0
1668002424890,CSE 293,032,119425,Schulze; Jurgen P.,9999,0,9999,0
1668002424890,CSE 293,033,119426,Snoeren; Alex C.,9999,0,9999,0
1668002424890,CSE 293,034,119428,Shang; Jingbo,9999,0,9999,0
1668002424890,CSE 293,035,119430,Stefan; Deian,9999,0,9999,0
1668002424890,CSE 293,036,119431,Su; Hao,9999,0,9999,0
1668002424890,CSE 293,037,119433,Swanson; Steven James,9999,0,9999,0
1668002424890,CSE 293,038,119435,Tullsen; Dean Michael,9999,0,9999,0
1668002424890,CSE 293,039,119483,Voelker; Geoffrey M.,9999,0,9999,0
1668002424890,CSE 293,040,119537,Zhao; Jishen,9999,0,9999,0
1668002424890,CSE 293,041,119538,Zhou; Yuan-Yuan,9999,0,9999,0
1668002424890,CSE 293,042,119539,Gao; Sicun,9999,0,9999,0
1668002424890,CSE 293,043,119540,Weibel; Nadir,9999,0,9999,0
1668002424890,CSE 293,044,119541,Gupta; Rajesh K.,9999,0,9999,0
1668002424890,CSE 293,045,126410,Vaccaro; Kristen Marie,9999,0,9999,0
1668002424890,CSE 293,046,126411,Klemke; Richard,9999,0,9999,0
1668002425321,CSE 294,A00,102459,Voelker; Geoffrey M.,0,0,0,0
1668002425321,CSE 294,B00,111322,Orailoglu; Alex,0,0,0,0
1668002425745,DSE 201,A00,096914,Deutsch; Alin Bernard,30,0,30,0
1668002426182,DSE 210,A00,096915,Dasgupta; Sanjoy,30,0,30,0
1668002426609,DSE 260A,A00,096916,Altintas De Callaf; Ilkay,30,0,30,0
1668002427053,ECE 200,001,103586,Antipa; Nicholas A,9999,0,9999,0
1668002427053,ECE 200,002,103587,Atanasov; Nikolay A.,9999,0,9999,0
1668002427053,ECE 200,003,103588,Bharadia; Dinesh,9999,0,9999,0
1668002427053,ECE 200,004,103589,Cheng; Chung Kuan,9999,0,9999,0
1668002427053,ECE 200,005,103590,Cosman; Pamela C.,9999,0,9999,0
1668002427053,ECE 200,006,103591,Dayeh; Shadi Ahmad,9999,0,9999,0
1668002427053,ECE 200,007,103592,Fainman; Yeshaiahu,9999,0,9999,0
1668002427053,ECE 200,008,103593,Ford; Joseph Earl,9999,0,9999,0
1668002427053,ECE 200,009,103594,Franceschetti; Massimo,9999,0,9999,0
1668002427053,ECE 200,010,103595,Fullerton; Eric E,9999,0,9999,0
1668002427053,ECE 200,011,103596,Galton; Ian A,9999,0,9999,0
1668002427053,ECE 200,012,103597,Gilja; Vikash,9999,0,9999,0
1668002427053,ECE 200,013,103598,Hall; Drew A.,9999,0,9999,0
1668002427053,ECE 200,014,103599,Hsueh; Tzu-Chien,9999,0,9999,0
1668002427053,ECE 200,015,103600,Javidi; Tara,9999,0,9999,0
1668002427053,ECE 200,016,103601,Kahng; Andrew Byun,9999,0,9999,0
1668002427053,ECE 200,017,103602,Kim; Young-Han,9999,0,9999,0
1668002427053,ECE 200,018,103603,Koushanfar; Farinaz,9999,0,9999,0
1668002427053,ECE 200,019,103604,Kuzum; Duygu,9999,0,9999,0
1668002427053,ECE 200,020,103605,Le; Hanh-Phuc,9999,0,9999,0
1668002427053,ECE 200,021,103606,Lin; Bill,9999,0,9999,0
1668002427053,ECE 200,022,103607,Liu; Zhaowei,9998,0,9999,1
1668002427053,ECE 200,023,103608,Lo; Yu-Hwa,9999,0,9999,0
1668002427053,ECE 200,024,103609,Lomakin; Vitaliy,9999,0,9999,0
1668002427053,ECE 200,025,103610,Mercier; Patrick Philip,9999,0,9999,0
1668002427053,ECE 200,026,103611,Meyer; Florian,9999,0,9999,0
1668002427053,ECE 200,027,103612,Milstein; Laurence B.,9999,0,9999,0
1668002427053,ECE 200,028,103613,Mir Arabbaygi; Siavash,9999,0,9999,0
1668002427053,ECE 200,029,103614,Mookherjea; Shayan,9999,0,9999,0
1668002427053,ECE 200,030,103615,Morris; Karcher William,9999,0,9999,0
1668002427053,ECE 200,031,103616,Ng; Tse Nga,9999,0,9999,0
1668002427053,ECE 200,032,103617,Nguyen; Truong Quang,9999,0,9999,0
1668002427053,ECE 200,033,103618,Nomura; Kenji,9999,0,9999,0
1668002427053,ECE 200,034,103619,Orlitsky; Alon,9999,0,9999,0
1668002427053,ECE 200,035,103620,Pal; Piya,9999,0,9999,0
1668002427053,ECE 200,036,103621,Papen; George C.,9999,0,9999,0
1668002427053,ECE 200,037,103622,Radic; Stojan,9999,0,9999,0
1668002427053,ECE 200,038,103623,Rao; Bhaskar D.,9999,0,9999,0
1668002427053,ECE 200,039,103624,Rao; Ramesh R,9999,0,9999,0
1668002427053,ECE 200,040,103625,Rebeiz; Gabriel,9999,0,9999,0
1668002427053,ECE 200,041,103626,Sanford; John R,9999,0,9999,0
1668002427053,ECE 200,042,103627,Siegel; Paul H.,9999,0,9999,0
1668002427053,ECE 200,043,103628,Sievenpiper; Daniel F.,9999,0,9999,0
1668002427053,ECE 200,044,103629,Sworder; David D.,9999,0,9999,0
1668002427053,ECE 200,045,103630,Taur; Yuan,9999,0,9999,0
1668002427053,ECE 200,046,103631,Touri; Behrouz,9999,0,9999,0
1668002427053,ECE 200,047,103632,Trivedi; Mohan M.,9999,0,9999,0
1668002427053,ECE 200,048,103633,Vasconcelos; Nuno,9999,0,9999,0
1668002427053,ECE 200,049,103634,Wang; Xiaolong,9999,0,9999,0
1668002427053,ECE 200,050,103635,Xie; Pengtao,9999,0,9999,0
1668002427053,ECE 200,051,103636,Yip; Michael,9999,0,9999,0
1668002427053,ECE 200,052,103637,Zeger; Kenneth A.,999,0,999,0
1668002427053,ECE 200,053,103638,Zhang; Xinyu,9999,0,9999,0
1668002427053,ECE 200,054,103639,Turakhia; Yatish Girish,9999,0,9999,0
1668002427053,ECE 200,055,103640,Kang; Mingu,9999,0,9999,0
1668002427053,ECE 200,056,103641,Shi; Yuanyuan,9999,0,9999,0
1668002427053,ECE 200,057,103642,Wang; Edward Jay,9999,0,9999,0
1668002427053,ECE 200,058,103643,Zheng; Yang,9999,0,9999,0
1668002427482,ECE 202,A00,103644,Kuzum; Duygu,0,0,0,0
1668002427913,ECE 212BN,A00,103646,Ng; Tse Nga,0,0,0,0
1668002428367,ECE 221,A00,111493,Staff,0,0,0,0
1668002428804,ECE 222B,A00,103647,Lomakin; Vitaliy,0,0,0,0
1668002429231,ECE 230B,A00,103648,Taur; Yuan,0,0,0,0
1668002429668,ECE 238B,A00,103649,Garay; Javier,0,0,0,0
1668002430103,ECE 240B,A00,112900,Fainman; Yeshaiahu,0,0,0,0
1668002430534,ECE 247A,A00,103650,Jokerst; Jesse Vincent,0,0,0,0
1668002430961,ECE 247B,A00,103651,Wang; Joseph,0,0,0,0
1668002431403,ECE 250,A00,103652,Siegel; Paul H.,0,0,0,0
1668002431838,ECE 251A,A00,103654,Rao; Bhaskar D.,0,0,0,0
1668002432267,ECE 257B,A00,103655,Bharadia; Dinesh,0,0,0,0
1668002432698,ECE 258A,A00,103656,Milstein; Laurence B.,0,0,0,0
1668002433131,ECE 260B,A00,103658,Kang; Mingu,0,0,0,0
1668002433556,ECE 264A,A00,103659,Galton; Ian A,0,0,0,0
1668002433983,ECE 265A,A00,103661,Gudem; Prasad S.S.,0,0,0,0
1668002434416,ECE 265D,A00,103662,Gudem; Prasad S.S.,0,0,0,0
1668002434840,ECE 268,A00,103663,Koushanfar; Farinaz,0,0,0,0
1668002435265,ECE 269,A01,103665,Pal; Piya,0,0,0,0
1668002435694,ECE 271B,A00,103666,Vasconcelos; Manuela,0,0,0,0
1668002436135,ECE 276A,A00,103667,Atanasov; Nikolay A.,0,0,0,0
1668002436560,ECE 277,A00,103668,An; Cheolhong,0,0,0,0
1668002436984,ECE 279,A00,117947,Hall; Drew A.,0,0,0,0
1668002437837,ECE 283,A00,103670,Hsueh; Tzu-Chien,0,0,0,0
1668002438277,ECE 284,A00,103671,Turakhia; Yatish Girish,0,0,0,0
1668002438702,ECE 285,A00,103672,Zheng; Yang,0,0,0,0
1668002438702,ECE 285,B00,103673,Sworder; David D.,0,0,0,0
1668002439132,ECE 287,A00,103676,Javidi; Tara,0,0,0,0
1668002439563,MATH 200B,A00,098023,Salehi Golsefidy; Alireza,14,0,15,1
1668002439987,MATH 202B,A00,098024,Rhoades; Brendon Patrick,12,0,15,3
1668002440419,MATH 203B,A00,098025,Oprea; Dragos N.,12,0,15,3
1668002440845,MATH 204B,A00,098026,Sorensen; Claus M,14,0,15,1
1668002441298,MATH 208,A00,098027,Izadi; Elham,7,0,10,3
1668002441733,MATH 209,A00,098028,Pollack; Aaron,10,0,10,0
1668002442164,MATH 211A,A00,112919,Rogalski; Daniel,9,0,10,1
1668002442600,MATH 211B,A00,112920,Seward; Brandon M.,9,0,10,1
1668002443023,MATH 218,A00,098029,Li; Bo,10,0,10,0
1668002443450,MATH 220B,A00,098030,Novak; Jonathan I,13,0,15,2
1668002443875,MATH 221A,A00,098031,Ebenfelt; Peter F,13,0,15,2
1668002444301,MATH 231B,A00,098032,Zlatos; Andrej,12,0,15,3
1668002444726,MATH 240B,A00,098033,Ni; Lei,10,0,15,5
1668002445154,MATH 243,A00,098034,Jekel; David Andrew,10,0,10,0
1668002445576,MATH 245A,A00,098035,Nie; Jiawang,0,0,15,16
1668002446004,MATH 248,A00,098036,Bejenaru; Ioan,10,0,10,0
1668002446435,MATH 250B,A00,098037,Spolaor; Luca,14,0,15,1
1668002446864,MATH 258,A00,098038,Ni; Lei,10,0,10,0
1668002447288,MATH 264B,A00,098041,Rhoades; Brendon Patrick,11,0,15,4
1668002447713,MATH 268,A00,098042,Buss; Samuel R,10,0,10,0
1668002448136,MATH 269,A00,098043,Rhoades; Brendon Patrick,10,0,10,0
1668002448567,MATH 270B,A00,098044,Li; Bo,11,0,15,4
1668002448998,MATH 272B,A00,098045,Holst; Michael J,13,0,15,2
1668002449421,MATH 273A,A00,098046,Tian; Xiaochuan,12,0,15,3
1668002449849,MATH 275,A01,098048,Tian; Xiaochuan,6,0,10,4
1668002450277,MATH 278A,A00,098049,Holst; Michael J,8,0,10,2
1668002450702,MATH 278B,A00,098050,Cloninger; Alexander,10,0,10,0
1668002451126,MATH 278C,A00,098051,Nie; Jiawang,8,0,10,2
1668002451555,MATH 280B,A00,098052,Zheng; Tianyi,11,0,15,4
1668002451979,MATH 281B,A00,098053,Bradic; Jelena,4,0,15,11
1668002452410,MATH 282B,A00,098054,Arias-Castro; Ery,2,0,15,13
1668002452837,MATH 285,A00,098055,Fitzsimmons; Patrick J,0,0,15,17
1668002453273,MATH 287B,A00,098056,Arias-Castro; Ery,5,0,15,10
1668002453701,MATH 288,A00,098057,Agarwal; Pooja,9,0,10,1
1668002453701,MATH 288,B00,098058,Zhang; Danna,9,0,10,1
1668002453701,MATH 288,C00,098059,Williams; Ruth J,10,0,10,0
1668002454132,MATH 290B,A00,098060,Roberts; Justin Deritter,14,0,15,1
1668002454556,MATH 292,A00,098061,Belmont; Eva Kinoshita,10,0,10,0
1668002454984,MATH 295,A00,098062,Suk; Andrew Hoon,48,0,50,2
1668002455411,MATH 296,A00,098063,Novak; Jonathan I,20,0,20,0
1668002455837,MATH 297,001,098064,Gamst; Anthony Collins,9997,0,9999,2
1668002958565,COGS 205,A00,101395,Chiba; Andrea,19,0,20,1
1668002958996,COGS 210B,001,101404,Greene; Deanna Jacquelyn,9998,0,9999,1
1668002958996,COGS 210B,002,101417,Xia; Haijun,9999,0,9999,0
1668002958996,COGS 210B,003,101422,Nitz; Douglas A.,9999,0,9999,0
1668002958996,COGS 210B,004,101423,Hollan; James D.,9998,0,9999,1
1668002958996,COGS 210B,005,101424,Deak; Gedeon O.,9999,0,9999,0
1668002958996,COGS 210B,006,101425,Rossano; Federico,9999,0,9999,0
1668002959431,COGS 211B,A00,101427,Coulson; Seana M,9997,0,9999,2
1668002959854,COGS 220,A00,101428,Hollan; James D.,0,0,25,25
1668002960283,COGS 229,A00,101429,Dow; Steven P,18,0,25,7
1668002960711,COGS 230,A00,101430,Klemmer; Scott R,13,0,17,4
1668002961148,COGS 234,A00,101431,Xia; Haijun,7,0,25,18
1668002961575,COGS 260,A00,101432,Kiyonaga; Anastasia,20,0,25,5
1668002961575,COGS 260,B00,101433,Kirsh; David Joel,16,0,25,9
1668002962009,CSE 202,A00,102371,Impagliazzo; Russell,0,0,0,0
1668002962433,CSE 203B,A01,102373,Cheng; Chung Kuan,0,0,0,0
1668002962870,CSE 208,A00,102374,Micciancio; Daniele,0,0,0,0
1668002963306,CSE 209A,A00,112895,Impagliazzo; Russell,0,0,15,15
1668002963739,CSE 209B,A00,108005,Bellare; Mihir,0,0,0,0
1668002964167,CSE 210,A00,113163,Coblenz; Michael J,0,0,0,0
1668002964597,CSE 219,A00,106111,Dow; Steven P,0,0,20,20
1668002965034,CSE 221,A00,102376,Voelker; Geoffrey M.,0,0,0,0
1668002965470,CSE 224,A01,102378,Porter; George M,0,0,0,0
1668002965893,CSE 229A,A00,102379,Savage; Stefan,0,0,0,0
1668002966321,CSE 229C,A00,102380,Munyaka; Imani N. S.,0,0,0,0
1668002966756,CSE 232B,A00,102382,Deutsch; Alin Bernard,0,0,0,0
1668002967180,CSE 234,A01,112904,Kumar; Arun Kumar,0,0,0,0
1668002967624,CSE 237A,A00,102383,Rosing; Tajana Simunic,0,0,0,0
1668002968046,CSE 239A,A00,102384,Deutsch; Alin Bernard,0,0,0,0
1668002968477,CSE 239B,A00,102385,Polikarpova; Nadezhda,0,0,0,0
1668002968900,CSE 240A,A00,102386,Pannuto; Patrick William,0,0,0,0
1668002969338,CSE 240B,A00,102387,Zhao; Jishen,0,0,0,0
1668002969764,CSE 241A,A00,106406,Kang; Mingu,0,0,0,0
1668002970191,CSE 249B,A00,102388,Kahng; Andrew Byun,0,0,8,8
1668002970624,CSE 251B,A01,102392,Cottrell; Garrison W,0,0,0,0
1668002970624,CSE 251B,A02,102393,Cottrell; Garrison W,0,0,0,0
1668002971055,CSE 252B,A00,102394,Ochoa; Benjamin Lawrence,0,0,0,0
1668002971497,CSE 257,A01,102396,Gao; Sicun,0,0,0,0
1668002971920,CSE 272,A00,102397,Li; Tzumao,0,0,0,0
1668002972349,CSE 274,A00,111323,Chern; Albert Ren-Haur,0,0,0,0
1668002972773,CSE 282,A00,102398,Pevzner; Pavel Arkadjevich,0,0,0,0
1668002973206,CSE 284,A00,114175,Gymrek; Melissa Ann,0,0,0,0
1668002973631,CSE 290,A00,102399,Chandraker; Manmohan Krishna,0,0,0,0
1668002973631,CSE 290,B00,102400,Vaccaro; Kristen Marie,0,0,25,25
1668002973631,CSE 290,C00,102414,Pannuto; Patrick William,0,0,25,25
1668002973631,CSE 290,D00,102427,Pevzner; Pavel Arkadjevich,0,0,0,0
1668002973631,CSE 290,E00,102429,Zhao; Jishen,0,0,0,0
1668002973631,CSE 290,F00,102436,Tullsen; Dean Michael,0,0,0,0
1668002973631,CSE 290,G00,102440,Christensen; Henrik I,0,0,20,20
1668002974063,CSE 291,A00,102443,Su; Hao,0,0,0,0
1668002974063,CSE 291,B00,102448,Polikarpova; Nadezhda,0,0,0,0
1668002974063,CSE 291,C00,102453,Vaccaro; Kristen Marie,0,0,0,0
1668002974063,CSE 291,D00,111343,Savage; Stefan,0,0,0,0
1668002974063,CSE 291,E00,116474,Claffy; Kimberly Claire,0,0,0,0
1668002974063,CSE 291,F00,116479,Pasquale; Joseph,0,0,0,0
1668002974499,CSE 293,001,119111,Bafna; Vineet,9999,0,9999,0
1668002974499,CSE 293,002,119118,Bellare; Mihir,9999,0,9999,0
1668002974499,CSE 293,003,119122,Berg-Kirkpatrick; Taylor D,9999,0,9999,0
1668002974499,CSE 293,004,119135,Christensen; Henrik I,9999,0,9999,0
1668002974499,CSE 293,005,119142,Cottrell; Garrison W,9999,0,9999,0
1668002974499,CSE 293,006,119146,Deutsch; Alin Bernard,9999,0,9999,0
1668002974499,CSE 293,007,119159,Esmaeilzadeh; Hadi,9999,0,9999,0
1668002974499,CSE 293,008,119166,Freund; Yoav,9999,0,9999,0
1668002974499,CSE 293,009,119170,Griswold; William G.,9999,0,9999,0
1668002974499,CSE 293,010,119183,Gymrek; Melissa Ann,9999,0,9999,0
1668002974499,CSE 293,011,119190,Heninger; Nadia A,9999,0,9999,0
1668002974499,CSE 293,012,119230,Impagliazzo; Russell,9999,0,9999,0
1668002974499,CSE 293,013,119232,Jhala; Ranjit,9999,0,9999,0
1668002974499,CSE 293,014,119233,Kahng; Andrew Byun,9999,0,9999,0
1668002974499,CSE 293,015,119298,Kane; Daniel Mertz,9999,0,9999,0
1668002974499,CSE 293,016,119299,Kriegman; David J,9999,0,9999,0
1668002974499,CSE 293,017,119300,Kumar; Arun Kumar,9999,0,9999,0
1668002974499,CSE 293,018,119301,Lerner; Sorin,9999,0,9999,0
1668002974499,CSE 293,019,119302,Lovett; Shachar,9999,0,9999,0
1668002974499,CSE 293,020,119303,McAuley; Julian John,9999,0,9999,0
1668002974499,CSE 293,021,119304,Micciancio; Daniele,9999,0,9999,0
1668002974499,CSE 293,022,119367,Orailoglu; Alex,9999,0,9999,0
1668002974499,CSE 293,023,119382,Paturi; Ramamohan,9999,0,9999,0
1668002974499,CSE 293,024,119404,Polikarpova; Nadezhda,9999,0,9999,0
1668002974499,CSE 293,025,119406,Politz; Joseph Gibbs,9999,0,9999,0
1668002974499,CSE 293,026,119411,Porter; George M,9999,0,9999,0
1668002974499,CSE 293,027,119414,Porter; Leonard Emerson,9999,0,9999,0
1668002974499,CSE 293,028,119416,Ramamoorthi; Ravi,9999,0,9999,0
1668002974499,CSE 293,029,119417,Sahoo; Debashis,9999,0,9999,0
1668002974499,CSE 293,030,119420,Saul; Lawrence,9999,0,9999,0
1668002974499,CSE 293,031,119421,Savage; Stefan,9999,0,9999,0
1668002974499,CSE 293,032,119425,Schulze; Jurgen P.,9999,0,9999,0
1668002974499,CSE 293,033,119426,Snoeren; Alex C.,9999,0,9999,0
1668002974499,CSE 293,034,119428,Shang; Jingbo,9999,0,9999,0
1668002974499,CSE 293,035,119430,Stefan; Deian,9999,0,9999,0
1668002974499,CSE 293,036,119431,Su; Hao,9999,0,9999,0
1668002974499,CSE 293,037,119433,Swanson; Steven James,9999,0,9999,0
1668002974499,CSE 293,038,119435,Tullsen; Dean Michael,9999,0,9999,0
1668002974499,CSE 293,039,119483,Voelker; Geoffrey M.,9999,0,9999,0
1668002974499,CSE 293,040,119537,Zhao; Jishen,9999,0,9999,0
1668002974499,CSE 293,041,119538,Zhou; Yuan-Yuan,9999,0,9999,0
1668002974499,CSE 293,042,119539,Gao; Sicun,9999,0,9999,0
1668002974499,CSE 293,043,119540,Weibel; Nadir,9999,0,9999,0
1668002974499,CSE 293,044,119541,Gupta; Rajesh K.,9999,0,9999,0
1668002974499,CSE 293,045,126410,Vaccaro; Kristen Marie,9999,0,9999,0
1668002974499,CSE 293,046,126411,Klemke; Richard,9999,0,9999,0
1668002974922,CSE 294,A00,102459,Voelker; Geoffrey M.,0,0,0,0
1668002974922,CSE 294,B00,111322,Orailoglu; Alex,0,0,0,0
1668002975352,DSE 201,A00,096914,Deutsch; Alin Bernard,30,0,30,0
1668002975779,DSE 210,A00,096915,Dasgupta; Sanjoy,30,0,30,0
1668002976205,DSE 260A,A00,096916,Altintas De Callaf; Ilkay,30,0,30,0
1668002976649,ECE 200,001,103586,Antipa; Nicholas A,9999,0,9999,0
1668002976649,ECE 200,002,103587,Atanasov; Nikolay A.,9999,0,9999,0
1668002976649,ECE 200,003,103588,Bharadia; Dinesh,9999,0,9999,0
1668002976649,ECE 200,004,103589,Cheng; Chung Kuan,9999,0,9999,0
1668002976649,ECE 200,005,103590,Cosman; Pamela C.,9999,0,9999,0
1668002976649,ECE 200,006,103591,Dayeh; Shadi Ahmad,9999,0,9999,0
1668002976649,ECE 200,007,103592,Fainman; Yeshaiahu,9999,0,9999,0
1668002976649,ECE 200,008,103593,Ford; Joseph Earl,9999,0,9999,0
1668002976649,ECE 200,009,103594,Franceschetti; Massimo,9999,0,9999,0
1668002976649,ECE 200,010,103595,Fullerton; Eric E,9999,0,9999,0
1668002976649,ECE 200,011,103596,Galton; Ian A,9999,0,9999,0
1668002976649,ECE 200,012,103597,Gilja; Vikash,9999,0,9999,0
1668002976649,ECE 200,013,103598,Hall; Drew A.,9999,0,9999,0
1668002976649,ECE 200,014,103599,Hsueh; Tzu-Chien,9999,0,9999,0
1668002976649,ECE 200,015,103600,Javidi; Tara,9999,0,9999,0
1668002976649,ECE 200,016,103601,Kahng; Andrew Byun,9999,0,9999,0
1668002976649,ECE 200,017,103602,Kim; Young-Han,9999,0,9999,0
1668002976649,ECE 200,018,103603,Koushanfar; Farinaz,9999,0,9999,0
1668002976649,ECE 200,019,103604,Kuzum; Duygu,9999,0,9999,0
1668002976649,ECE 200,020,103605,Le; Hanh-Phuc,9999,0,9999,0
1668002976649,ECE 200,021,103606,Lin; Bill,9999,0,9999,0
1668002976649,ECE 200,022,103607,Liu; Zhaowei,9998,0,9999,1
1668002976649,ECE 200,023,103608,Lo; Yu-Hwa,9999,0,9999,0
1668002976649,ECE 200,024,103609,Lomakin; Vitaliy,9999,0,9999,0
1668002976649,ECE 200,025,103610,Mercier; Patrick Philip,9999,0,9999,0
1668002976649,ECE 200,026,103611,Meyer; Florian,9999,0,9999,0
1668002976649,ECE 200,027,103612,Milstein; Laurence B.,9999,0,9999,0
1668002976649,ECE 200,028,103613,Mir Arabbaygi; Siavash,9999,0,9999,0
1668002976649,ECE 200,029,103614,Mookherjea; Shayan,9999,0,9999,0
1668002976649,ECE 200,030,103615,Morris; Karcher William,9999,0,9999,0
1668002976649,ECE 200,031,103616,Ng; Tse Nga,9999,0,9999,0
1668002976649,ECE 200,032,103617,Nguyen; Truong Quang,9999,0,9999,0
1668002976649,ECE 200,033,103618,Nomura; Kenji,9999,0,9999,0
1668002976649,ECE 200,034,103619,Orlitsky; Alon,9999,0,9999,0
1668002976649,ECE 200,035,103620,Pal; Piya,9999,0,9999,0
1668002976649,ECE 200,036,103621,Papen; George C.,9999,0,9999,0
1668002976649,ECE 200,037,103622,Radic; Stojan,9999,0,9999,0
1668002976649,ECE 200,038,103623,Rao; Bhaskar D.,9999,0,9999,0
1668002976649,ECE 200,039,103624,Rao; Ramesh R,9999,0,9999,0
1668002976649,ECE 200,040,103625,Rebeiz; Gabriel,9999,0,9999,0
1668002976649,ECE 200,041,103626,Sanford; John R,9999,0,9999,0
1668002976649,ECE 200,042,103627,Siegel; Paul H.,9999,0,9999,0
1668002976649,ECE 200,043,103628,Sievenpiper; Daniel F.,9999,0,9999,0
1668002976649,ECE 200,044,103629,Sworder; David D.,9999,0,9999,0
1668002976649,ECE 200,045,103630,Taur; Yuan,9999,0,9999,0
1668002976649,ECE 200,046,103631,Touri; Behrouz,9999,0,9999,0
1668002976649,ECE 200,047,103632,Trivedi; Mohan M.,9999,0,9999,0
1668002976649,ECE 200,048,103633,Vasconcelos; Nuno,9999,0,9999,0
1668002976649,ECE 200,049,103634,Wang; Xiaolong,9999,0,9999,0
1668002976649,ECE 200,050,103635,Xie; Pengtao,9999,0,9999,0
1668002976649,ECE 200,051,103636,Yip; Michael,9999,0,9999,0
1668002976649,ECE 200,052,103637,Zeger; Kenneth A.,999,0,999,0
1668002976649,ECE 200,053,103638,Zhang; Xinyu,9999,0,9999,0
1668002976649,ECE 200,054,103639,Turakhia; Yatish Girish,9999,0,9999,0
1668002976649,ECE 200,055,103640,Kang; Mingu,9999,0,9999,0
1668002976649,ECE 200,056,103641,Shi; Yuanyuan,9999,0,9999,0
1668002976649,ECE 200,057,103642,Wang; Edward Jay,9999,0,9999,0
1668002976649,ECE 200,058,103643,Zheng; Yang,9999,0,9999,0
1668002977076,ECE 202,A00,103644,Kuzum; Duygu,0,0,0,0
1668002977502,ECE 212BN,A00,103646,Ng; Tse Nga,0,0,0,0
1668002977932,ECE 221,A00,111493,Staff,0,0,0,0
1668002978357,ECE 222B,A00,103647,Lomakin; Vitaliy,0,0,0,0
1668002978782,ECE 230B,A00,103648,Taur; Yuan,0,0,0,0
1668002979219,ECE 238B,A00,103649,Garay; Javier,0,0,0,0
1668002979655,ECE 240B,A00,112900,Fainman; Yeshaiahu,0,0,0,0
1668002980088,ECE 247A,A00,103650,Jokerst; Jesse Vincent,0,0,0,0
1668002980521,ECE 247B,A00,103651,Wang; Joseph,0,0,0,0
1668002980967,ECE 250,A00,103652,Siegel; Paul H.,0,0,0,0
1668002981395,ECE 251A,A00,103654,Rao; Bhaskar D.,0,0,0,0
1668002981825,ECE 257B,A00,103655,Bharadia; Dinesh,0,0,0,0
1668002982251,ECE 258A,A00,103656,Milstein; Laurence B.,0,0,0,0
1668002982687,ECE 260B,A00,103658,Kang; Mingu,0,0,0,0
1668002983111,ECE 264A,A00,103659,Galton; Ian A,0,0,0,0
1668002983536,ECE 265A,A00,103661,Gudem; Prasad S.S.,0,0,0,0
1668002983962,ECE 265D,A00,103662,Gudem; Prasad S.S.,0,0,0,0
1668002984390,ECE 268,A00,103663,Koushanfar; Farinaz,0,0,0,0
1668002984818,ECE 269,A01,103665,Pal; Piya,0,0,0,0
1668002985248,ECE 271B,A00,103666,Vasconcelos; Manuela,0,0,0,0
1668002985669,ECE 276A,A00,103667,Atanasov; Nikolay A.,0,0,0,0
1668002986102,ECE 277,A00,103668,An; Cheolhong,0,0,0,0
1668002986549,ECE 279,A00,117947,Hall; Drew A.,0,0,0,0
1668002987416,ECE 283,A00,103670,Hsueh; Tzu-Chien,0,0,0,0
1668002987849,ECE 284,A00,103671,Turakhia; Yatish Girish,0,0,0,0
1668002988278,ECE 285,A00,103672,Zheng; Yang,0,0,0,0
1668002988278,ECE 285,B00,103673,Sworder; David D.,0,0,0,0
1668002988802,ECE 287,A00,103676,Javidi; Tara,0,0,0,0
1668002989239,MATH 200B,A00,098023,Salehi Golsefidy; Alireza,14,0,15,1
1668002989666,MATH 202B,A00,098024,Rhoades; Brendon Patrick,12,0,15,3
1668002990101,MATH 203B,A00,098025,Oprea; Dragos N.,12,0,15,3
1668002990536,MATH 204B,A00,098026,Sorensen; Claus M,14,0,15,1
1668002990962,MATH 208,A00,098027,Izadi; Elham,7,0,10,3
1668002991385,MATH 209,A00,098028,Pollack; Aaron,10,0,10,0
1668002991819,MATH 211A,A00,112919,Rogalski; Daniel,9,0,10,1
1668002992245,MATH 211B,A00,112920,Seward; Brandon M.,9,0,10,1
1668002992669,MATH 218,A00,098029,Li; Bo,10,0,10,0
1668002993094,MATH 220B,A00,098030,Novak; Jonathan I,13,0,15,2
1668002993521,MATH 221A,A00,098031,Ebenfelt; Peter F,13,0,15,2
1668002993944,MATH 231B,A00,098032,Zlatos; Andrej,12,0,15,3
1668002994373,MATH 240B,A00,098033,Ni; Lei,10,0,15,5
1668002994798,MATH 243,A00,098034,Jekel; David Andrew,10,0,10,0
1668002995230,MATH 245A,A00,098035,Nie; Jiawang,0,0,15,16
1668002995663,MATH 248,A00,098036,Bejenaru; Ioan,10,0,10,0
1668002996091,MATH 250B,A00,098037,Spolaor; Luca,14,0,15,1
1668002996517,MATH 258,A00,098038,Ni; Lei,10,0,10,0
1668002996941,MATH 264B,A00,098041,Rhoades; Brendon Patrick,11,0,15,4
1668002997378,MATH 268,A00,098042,Buss; Samuel R,10,0,10,0
1668002997802,MATH 269,A00,098043,Rhoades; Brendon Patrick,10,0,10,0
1668002998226,MATH 270B,A00,098044,Li; Bo,11,0,15,4
1668002998652,MATH 272B,A00,098045,Holst; Michael J,13,0,15,2
1668002999081,MATH 273A,A00,098046,Tian; Xiaochuan,12,0,15,3
1668002999505,MATH 275,A01,098048,Tian; Xiaochuan,6,0,10,4
1668002999939,MATH 278A,A00,098049,Holst; Michael J,8,0,10,2
1668003000366,MATH 278B,A00,098050,Cloninger; Alexander,10,0,10,0
1668003000790,MATH 278C,A00,098051,Nie; Jiawang,8,0,10,2
1668003001217,MATH 280B,A00,098052,Zheng; Tianyi,11,0,15,4
1668003001646,MATH 281B,A00,098053,Bradic; Jelena,4,0,15,11
1668003002070,MATH 282B,A00,098054,Arias-Castro; Ery,2,0,15,13
1668003002499,MATH 285,A00,098055,Fitzsimmons; Patrick J,0,0,15,17
1668003002931,MATH 287B,A00,098056,Arias-Castro; Ery,5,0,15,10
1668003003357,MATH 288,A00,098057,Agarwal; Pooja,9,0,10,1
1668003003357,MATH 288,B00,098058,Zhang; Danna,9,0,10,1
1668003003357,MATH 288,C00,098059,Williams; Ruth J,10,0,10,0
1668003003783,MATH 290B,A00,098060,Roberts; Justin Deritter,14,0,15,1
1668003004216,MATH 292,A00,098061,Belmont; Eva Kinoshita,10,0,10,0
1668003004642,MATH 295,A00,098062,Suk; Andrew Hoon,48,0,50,2
1668003005067,MATH 296,A00,098063,Novak; Jonathan I,20,0,20,0
1668003005498,MATH 297,001,098064,Gamst; Anthony Collins,9997,0,9999,2
1668003506515,COGS 205,A00,101395,Chiba; Andrea,19,0,20,1
1668003506943,COGS 210B,001,101404,Greene; Deanna Jacquelyn,9998,0,9999,1
1668003506943,COGS 210B,002,101417,Xia; Haijun,9999,0,9999,0
1668003506943,COGS 210B,003,101422,Nitz; Douglas A.,9999,0,9999,0
1668003506943,COGS 210B,004,101423,Hollan; James D.,9998,0,9999,1
1668003506943,COGS 210B,005,101424,Deak; Gedeon O.,9999,0,9999,0
1668003506943,COGS 210B,006,101425,Rossano; Federico,9999,0,9999,0
1668003507367,COGS 211B,A00,101427,Coulson; Seana M,9997,0,9999,2
1668003507790,COGS 220,A00,101428,Hollan; James D.,0,0,25,25
1668003508226,COGS 229,A00,101429,Dow; Steven P,18,0,25,7
1668003508649,COGS 230,A00,101430,Klemmer; Scott R,13,0,17,4
1668003509081,COGS 234,A00,101431,Xia; Haijun,7,0,25,18
1668003509507,COGS 260,A00,101432,Kiyonaga; Anastasia,20,0,25,5
1668003509507,COGS 260,B00,101433,Kirsh; David Joel,16,0,25,9
1668003510042,CSE 202,A00,102371,Impagliazzo; Russell,0,0,0,0
1668003510469,CSE 203B,A01,102373,Cheng; Chung Kuan,0,0,0,0
1668003510891,CSE 208,A00,102374,Micciancio; Daniele,0,0,0,0
1668003511314,CSE 209A,A00,112895,Impagliazzo; Russell,0,0,15,15
1668003511736,CSE 209B,A00,108005,Bellare; Mihir,0,0,0,0
1668003512164,CSE 210,A00,113163,Coblenz; Michael J,0,0,0,0
1668003512590,CSE 219,A00,106111,Dow; Steven P,0,0,20,20
1668003513018,CSE 221,A00,102376,Voelker; Geoffrey M.,0,0,0,0
1668003513454,CSE 224,A01,102378,Porter; George M,0,0,0,0
1668003513892,CSE 229A,A00,102379,Savage; Stefan,0,0,0,0
1668003514324,CSE 229C,A00,102380,Munyaka; Imani N. S.,0,0,0,0
1668003514751,CSE 232B,A00,102382,Deutsch; Alin Bernard,0,0,0,0
1668003515183,CSE 234,A01,112904,Kumar; Arun Kumar,0,0,0,0
1668003515605,CSE 237A,A00,102383,Rosing; Tajana Simunic,0,0,0,0
1668003516031,CSE 239A,A00,102384,Deutsch; Alin Bernard,0,0,0,0
1668003516454,CSE 239B,A00,102385,Polikarpova; Nadezhda,0,0,0,0
1668003516879,CSE 240A,A00,102386,Pannuto; Patrick William,0,0,0,0
1668003517309,CSE 240B,A00,102387,Zhao; Jishen,0,0,0,0
1668003517734,CSE 241A,A00,106406,Kang; Mingu,0,0,0,0
1668003518158,CSE 249B,A00,102388,Kahng; Andrew Byun,0,0,8,8
1668003518582,CSE 251B,A01,102392,Cottrell; Garrison W,0,0,0,0
1668003518582,CSE 251B,A02,102393,Cottrell; Garrison W,0,0,0,0
1668003519008,CSE 252B,A00,102394,Ochoa; Benjamin Lawrence,0,0,0,0
1668003519434,CSE 257,A01,102396,Gao; Sicun,0,0,0,0
1668003519859,CSE 272,A00,102397,Li; Tzumao,0,0,0,0
1668003520285,CSE 274,A00,111323,Chern; Albert Ren-Haur,0,0,0,0
1668003520712,CSE 282,A00,102398,Pevzner; Pavel Arkadjevich,0,0,0,0
1668003521135,CSE 284,A00,114175,Gymrek; Melissa Ann,0,0,0,0
1668003521567,CSE 290,A00,102399,Chandraker; Manmohan Krishna,0,0,0,0
1668003521567,CSE 290,B00,102400,Vaccaro; Kristen Marie,0,0,25,25
1668003521567,CSE 290,C00,102414,Pannuto; Patrick William,0,0,25,25
1668003521567,CSE 290,D00,102427,Pevzner; Pavel Arkadjevich,0,0,0,0
1668003521567,CSE 290,E00,102429,Zhao; Jishen,0,0,0,0
1668003521567,CSE 290,F00,102436,Tullsen; Dean Michael,0,0,0,0
1668003521567,CSE 290,G00,102440,Christensen; Henrik I,0,0,20,20
1668003521995,CSE 291,A00,102443,Su; Hao,0,0,0,0
1668003521995,CSE 291,B00,102448,Polikarpova; Nadezhda,0,0,0,0
1668003521995,CSE 291,C00,102453,Vaccaro; Kristen Marie,0,0,0,0
1668003521995,CSE 291,D00,111343,Savage; Stefan,0,0,0,0
1668003521995,CSE 291,E00,116474,Claffy; Kimberly Claire,0,0,0,0
1668003521995,CSE 291,F00,116479,Pasquale; Joseph,0,0,0,0
1668003522433,CSE 293,001,119111,Bafna; Vineet,9999,0,9999,0
1668003522433,CSE 293,002,119118,Bellare; Mihir,9999,0,9999,0
1668003522433,CSE 293,003,119122,Berg-Kirkpatrick; Taylor D,9999,0,9999,0
1668003522433,CSE 293,004,119135,Christensen; Henrik I,9999,0,9999,0
1668003522433,CSE 293,005,119142,Cottrell; Garrison W,9999,0,9999,0
1668003522433,CSE 293,006,119146,Deutsch; Alin Bernard,9999,0,9999,0
1668003522433,CSE 293,007,119159,Esmaeilzadeh; Hadi,9999,0,9999,0
1668003522433,CSE 293,008,119166,Freund; Yoav,9999,0,9999,0
1668003522433,CSE 293,009,119170,Griswold; William G.,9999,0,9999,0
1668003522433,CSE 293,010,119183,Gymrek; Melissa Ann,9999,0,9999,0
1668003522433,CSE 293,011,119190,Heninger; Nadia A,9999,0,9999,0
1668003522433,CSE 293,012,119230,Impagliazzo; Russell,9999,0,9999,0
1668003522433,CSE 293,013,119232,Jhala; Ranjit,9999,0,9999,0
1668003522433,CSE 293,014,119233,Kahng; Andrew Byun,9999,0,9999,0
1668003522433,CSE 293,015,119298,Kane; Daniel Mertz,9999,0,9999,0
1668003522433,CSE 293,016,119299,Kriegman; David J,9999,0,9999,0
1668003522433,CSE 293,017,119300,Kumar; Arun Kumar,9999,0,9999,0
1668003522433,CSE 293,018,119301,Lerner; Sorin,9999,0,9999,0
1668003522433,CSE 293,019,119302,Lovett; Shachar,9999,0,9999,0
1668003522433,CSE 293,020,119303,McAuley; Julian John,9999,0,9999,0
1668003522433,CSE 293,021,119304,Micciancio; Daniele,9999,0,9999,0
1668003522433,CSE 293,022,119367,Orailoglu; Alex,9999,0,9999,0
1668003522433,CSE 293,023,119382,Paturi; Ramamohan,9999,0,9999,0
1668003522433,CSE 293,024,119404,Polikarpova; Nadezhda,9999,0,9999,0
1668003522433,CSE 293,025,119406,Politz; Joseph Gibbs,9999,0,9999,0
1668003522433,CSE 293,026,119411,Porter; George M,9999,0,9999,0
1668003522433,CSE 293,027,119414,Porter; Leonard Emerson,9999,0,9999,0
1668003522433,CSE 293,028,119416,Ramamoorthi; Ravi,9999,0,9999,0
1668003522433,CSE 293,029,119417,Sahoo; Debashis,9999,0,9999,0
1668003522433,CSE 293,030,119420,Saul; Lawrence,9999,0,9999,0
1668003522433,CSE 293,031,119421,Savage; Stefan,9999,0,9999,0
1668003522433,CSE 293,032,119425,Schulze; Jurgen P.,9999,0,9999,0
1668003522433,CSE 293,033,119426,Snoeren; Alex C.,9999,0,9999,0
1668003522433,CSE 293,034,119428,Shang; Jingbo,9999,0,9999,0
1668003522433,CSE 293,035,119430,Stefan; Deian,9999,0,9999,0
1668003522433,CSE 293,036,119431,Su; Hao,9999,0,9999,0
1668003522433,CSE 293,037,119433,Swanson; Steven James,9999,0,9999,0
1668003522433,CSE 293,038,119435,Tullsen; Dean Michael,9999,0,9999,0
1668003522433,CSE 293,039,119483,Voelker; Geoffrey M.,9999,0,9999,0
1668003522433,CSE 293,040,119537,Zhao; Jishen,9999,0,9999,0
1668003522433,CSE 293,041,119538,Zhou; Yuan-Yuan,9999,0,9999,0
1668003522433,CSE 293,042,119539,Gao; Sicun,9999,0,9999,0
1668003522433,CSE 293,043,119540,Weibel; Nadir,9999,0,9999,0
1668003522433,CSE 293,044,119541,Gupta; Rajesh K.,9999,0,9999,0
1668003522433,CSE 293,045,126410,Vaccaro; Kristen Marie,9999,0,9999,0
1668003522433,CSE 293,046,126411,Klemke; Richard,9999,0,9999,0
1668003522857,CSE 294,A00,102459,Voelker; Geoffrey M.,0,0,0,0
1668003522857,CSE 294,B00,111322,Orailoglu; Alex,0,0,0,0
1668003523298,DSE 201,A00,096914,Deutsch; Alin Bernard,30,0,30,0
1668003523725,DSE 210,A00,096915,Dasgupta; Sanjoy,30,0,30,0
1668003524160,DSE 260A,A00,096916,Altintas De Callaf; Ilkay,30,0,30,0
1668003524589,ECE 200,001,103586,Antipa; Nicholas A,9999,0,9999,0
1668003524589,ECE 200,002,103587,Atanasov; Nikolay A.,9999,0,9999,0
1668003524589,ECE 200,003,103588,Bharadia; Dinesh,9999,0,9999,0
1668003524589,ECE 200,004,103589,Cheng; Chung Kuan,9999,0,9999,0
1668003524589,ECE 200,005,103590,Cosman; Pamela C.,9999,0,9999,0
1668003524589,ECE 200,006,103591,Dayeh; Shadi Ahmad,9999,0,9999,0
1668003524589,ECE 200,007,103592,Fainman; Yeshaiahu,9999,0,9999,0
1668003524589,ECE 200,008,103593,Ford; Joseph Earl,9999,0,9999,0
1668003524589,ECE 200,009,103594,Franceschetti; Massimo,9999,0,9999,0
1668003524589,ECE 200,010,103595,Fullerton; Eric E,9999,0,9999,0
1668003524589,ECE 200,011,103596,Galton; Ian A,9999,0,9999,0
1668003524589,ECE 200,012,103597,Gilja; Vikash,9999,0,9999,0
1668003524589,ECE 200,013,103598,Hall; Drew A.,9999,0,9999,0
1668003524589,ECE 200,014,103599,Hsueh; Tzu-Chien,9999,0,9999,0
1668003524589,ECE 200,015,103600,Javidi; Tara,9999,0,9999,0
1668003524589,ECE 200,016,103601,Kahng; Andrew Byun,9999,0,9999,0
1668003524589,ECE 200,017,103602,Kim; Young-Han,9999,0,9999,0
1668003524589,ECE 200,018,103603,Koushanfar; Farinaz,9999,0,9999,0
1668003524589,ECE 200,019,103604,Kuzum; Duygu,9999,0,9999,0
1668003524589,ECE 200,020,103605,Le; Hanh-Phuc,9999,0,9999,0
1668003524589,ECE 200,021,103606,Lin; Bill,9999,0,9999,0
1668003524589,ECE 200,022,103607,Liu; Zhaowei,9998,0,9999,1
1668003524589,ECE 200,023,103608,Lo; Yu-Hwa,9999,0,9999,0
1668003524589,ECE 200,024,103609,Lomakin; Vitaliy,9999,0,9999,0
1668003524589,ECE 200,025,103610,Mercier; Patrick Philip,9999,0,9999,0
1668003524589,ECE 200,026,103611,Meyer; Florian,9999,0,9999,0
1668003524589,ECE 200,027,103612,Milstein; Laurence B.,9999,0,9999,0
1668003524589,ECE 200,028,103613,Mir Arabbaygi; Siavash,9999,0,9999,0
1668003524589,ECE 200,029,103614,Mookherjea; Shayan,9999,0,9999,0
1668003524589,ECE 200,030,103615,Morris; Karcher William,9999,0,9999,0
1668003524589,ECE 200,031,103616,Ng; Tse Nga,9999,0,9999,0
1668003524589,ECE 200,032,103617,Nguyen; Truong Quang,9999,0,9999,0
1668003524589,ECE 200,033,103618,Nomura; Kenji,9999,0,9999,0
1668003524589,ECE 200,034,103619,Orlitsky; Alon,9999,0,9999,0
1668003524589,ECE 200,035,103620,Pal; Piya,9999,0,9999,0
1668003524589,ECE 200,036,103621,Papen; George C.,9999,0,9999,0
1668003524589,ECE 200,037,103622,Radic; Stojan,9999,0,9999,0
1668003524589,ECE 200,038,103623,Rao; Bhaskar D.,9999,0,9999,0
1668003524589,ECE 200,039,103624,Rao; Ramesh R,9999,0,9999,0
1668003524589,ECE 200,040,103625,Rebeiz; Gabriel,9999,0,9999,0
1668003524589,ECE 200,041,103626,Sanford; John R,9999,0,9999,0
1668003524589,ECE 200,042,103627,Siegel; Paul H.,9999,0,9999,0
1668003524589,ECE 200,043,103628,Sievenpiper; Daniel F.,9999,0,9999,0
1668003524589,ECE 200,044,103629,Sworder; David D.,9999,0,9999,0
1668003524589,ECE 200,045,103630,Taur; Yuan,9999,0,9999,0
1668003524589,ECE 200,046,103631,Touri; Behrouz,9999,0,9999,0
1668003524589,ECE 200,047,103632,Trivedi; Mohan M.,9999,0,9999,0
1668003524589,ECE 200,048,103633,Vasconcelos; Nuno,9999,0,9999,0
1668003524589,ECE 200,049,103634,Wang; Xiaolong,9999,0,9999,0
1668003524589,ECE 200,050,103635,Xie; Pengtao,9999,0,9999,0
1668003524589,ECE 200,051,103636,Yip; Michael,9999,0,9999,0
1668003524589,ECE 200,052,103637,Zeger; Kenneth A.,999,0,999,0
1668003524589,ECE 200,053,103638,Zhang; Xinyu,9999,0,9999,0
1668003524589,ECE 200,054,103639,Turakhia; Yatish Girish,9999,0,9999,0
1668003524589,ECE 200,055,103640,Kang; Mingu,9999,0,9999,0
1668003524589,ECE 200,056,103641,Shi; Yuanyuan,9999,0,9999,0
1668003524589,ECE 200,057,103642,Wang; Edward Jay,9999,0,9999,0
1668003524589,ECE 200,058,103643,Zheng; Yang,9999,0,9999,0
1668003525013,ECE 202,A00,103644,Kuzum; Duygu,0,0,0,0
1668003525438,ECE 212BN,A00,103646,Ng; Tse Nga,0,0,0,0
1668003525867,ECE 221,A00,111493,Staff,0,0,0,0
1668003526293,ECE 222B,A00,103647,Lomakin; Vitaliy,0,0,0,0
1668003526728,ECE 230B,A00,103648,Taur; Yuan,0,0,0,0
1668003527154,ECE 238B,A00,103649,Garay; Javier,0,0,0,0
1668003527576,ECE 240B,A00,112900,Fainman; Yeshaiahu,0,0,0,0
1668003527999,ECE 247A,A00,103650,Jokerst; Jesse Vincent,0,0,0,0
1668003528424,ECE 247B,A00,103651,Wang; Joseph,0,0,0,0
1668003528848,ECE 250,A00,103652,Siegel; Paul H.,0,0,0,0
1668003529272,ECE 251A,A00,103654,Rao; Bhaskar D.,0,0,0,0
1668003529699,ECE 257B,A00,103655,Bharadia; Dinesh,0,0,0,0
1668003530124,ECE 258A,A00,103656,Milstein; Laurence B.,0,0,0,0
1668003530551,ECE 260B,A00,103658,Kang; Mingu,0,0,0,0
1668003530984,ECE 264A,A00,103659,Galton; Ian A,0,0,0,0
1668003531408,ECE 265A,A00,103661,Gudem; Prasad S.S.,0,0,0,0
1668003531834,ECE 265D,A00,103662,Gudem; Prasad S.S.,0,0,0,0
1668003532260,ECE 268,A00,103663,Koushanfar; Farinaz,0,0,0,0
1668003532693,ECE 269,A01,103665,Pal; Piya,0,0,0,0
1668003533117,ECE 271B,A00,103666,Vasconcelos; Manuela,0,0,0,0
1668003533556,ECE 276A,A00,103667,Atanasov; Nikolay A.,0,0,0,0
1668003533988,ECE 277,A00,103668,An; Cheolhong,0,0,0,0
1668003534412,ECE 279,A00,117947,Hall; Drew A.,0,0,0,0
1668003535258,ECE 283,A00,103670,Hsueh; Tzu-Chien,0,0,0,0
1668003535684,ECE 284,A00,103671,Turakhia; Yatish Girish,0,0,0,0
1668003536118,ECE 285,A00,103672,Zheng; Yang,0,0,0,0
1668003536118,ECE 285,B00,103673,Sworder; David D.,0,0,0,0
1668003536542,ECE 287,A00,103676,Javidi; Tara,0,0,0,0
1668003536967,MATH 200B,A00,098023,Salehi Golsefidy; Alireza,14,0,15,1
1668003537392,MATH 202B,A00,098024,Rhoades; Brendon Patrick,12,0,15,3
1668003537818,MATH 203B,A00,098025,Oprea; Dragos N.,12,0,15,3
1668003538244,MATH 204B,A00,098026,Sorensen; Claus M,14,0,15,1
1668003538673,MATH 208,A00,098027,Izadi; Elham,7,0,10,3
1668003539105,MATH 209,A00,098028,Pollack; Aaron,10,0,10,0
1668003539530,MATH 211A,A00,112919,Rogalski; Daniel,9,0,10,1
1668003539953,MATH 211B,A00,112920,Seward; Brandon M.,9,0,10,1
1668003540378,MATH 218,A00,098029,Li; Bo,10,0,10,0
1668003540800,MATH 220B,A00,098030,Novak; Jonathan I,13,0,15,2
1668003541228,MATH 221A,A00,098031,Ebenfelt; Peter F,13,0,15,2
1668003541658,MATH 231B,A00,098032,Zlatos; Andrej,12,0,15,3
1668003542085,MATH 240B,A00,098033,Ni; Lei,10,0,15,5
1668003542507,MATH 243,A00,098034,Jekel; David Andrew,10,0,10,0
1668003542930,MATH 245A,A00,098035,Nie; Jiawang,0,0,15,16
1668003543353,MATH 248,A00,098036,Bejenaru; Ioan,10,0,10,0
1668003543779,MATH 250B,A00,098037,Spolaor; Luca,14,0,15,1
1668003544205,MATH 258,A00,098038,Ni; Lei,10,0,10,0
1668003544630,MATH 264B,A00,098041,Rhoades; Brendon Patrick,11,0,15,4
1668003545054,MATH 268,A00,098042,Buss; Samuel R,10,0,10,0
1668003545486,MATH 269,A00,098043,Rhoades; Brendon Patrick,10,0,10,0
1668003545911,MATH 270B,A00,098044,Li; Bo,11,0,15,4
1668003546335,MATH 272B,A00,098045,Holst; Michael J,13,0,15,2
1668003546760,MATH 273A,A00,098046,Tian; Xiaochuan,12,0,15,3
1668003547191,MATH 275,A01,098048,Tian; Xiaochuan,6,0,10,4
1668003547618,MATH 278A,A00,098049,Holst; Michael J,8,0,10,2
1668003548044,MATH 278B,A00,098050,Cloninger; Alexander,10,0,10,0
1668003548467,MATH 278C,A00,098051,Nie; Jiawang,8,0,10,2
1668003548891,MATH 280B,A00,098052,Zheng; Tianyi,11,0,15,4
1668003549330,MATH 281B,A00,098053,Bradic; Jelena,4,0,15,11
1668003549762,MATH 282B,A00,098054,Arias-Castro; Ery,2,0,15,13
1668003550185,MATH 285,A00,098055,Fitzsimmons; Patrick J,0,0,15,17
1668003550629,MATH 287B,A00,098056,Arias-Castro; Ery,5,0,15,10
1668003551055,MATH 288,A00,098057,Agarwal; Pooja,9,0,10,1
1668003551055,MATH 288,B00,098058,Zhang; Danna,9,0,10,1
1668003551055,MATH 288,C00,098059,Williams; Ruth J,10,0,10,0
1668003551488,MATH 290B,A00,098060,Roberts; Justin Deritter,14,0,15,1
1668003551917,MATH 292,A00,098061,Belmont; Eva Kinoshita,10,0,10,0
1668003552342,MATH 295,A00,098062,Suk; Andrew Hoon,48,0,50,2
1668003552765,MATH 296,A00,098063,Novak; Jonathan I,20,0,20,0
1668003553278,MATH 297,001,098064,Gamst; Anthony Collins,9997,0,9999,2
1668004053776,COGS 205,A00,101395,Chiba; Andrea,19,0,20,1
1668004054201,COGS 210B,001,101404,Greene; Deanna Jacquelyn,9998,0,9999,1
1668004054201,COGS 210B,002,101417,Xia; Haijun,9999,0,9999,0
1668004054201,COGS 210B,003,101422,Nitz; Douglas A.,9999,0,9999,0
1668004054201,COGS 210B,004,101423,Hollan; James D.,9998,0,9999,1
1668004054201,COGS 210B,005,101424,Deak; Gedeon O.,9999,0,9999,0
1668004054201,COGS 210B,006,101425,Rossano; Federico,9999,0,9999,0
1668004054626,COGS 211B,A00,101427,Coulson; Seana M,9997,0,9999,2
1668004055049,COGS 220,A00,101428,Hollan; James D.,0,0,25,25
1668004055477,COGS 229,A00,101429,Dow; Steven P,18,0,25,7
1668004055901,COGS 230,A00,101430,Klemmer; Scott R,13,0,17,4
1668004056327,COGS 234,A00,101431,Xia; Haijun,7,0,25,18
1668004056754,COGS 260,A00,101432,Kiyonaga; Anastasia,20,0,25,5
1668004056754,COGS 260,B00,101433,Kirsh; David Joel,16,0,25,9
1668004057178,CSE 202,A00,102371,Impagliazzo; Russell,0,0,0,0
1668004057604,CSE 203B,A01,102373,Cheng; Chung Kuan,0,0,0,0
1668004058030,CSE 208,A00,102374,Micciancio; Daniele,0,0,0,0
1668004058451,CSE 209A,A00,112895,Impagliazzo; Russell,0,0,15,15
1668004058875,CSE 209B,A00,108005,Bellare; Mihir,0,0,0,0
1668004059300,CSE 210,A00,113163,Coblenz; Michael J,0,0,0,0
1668004059723,CSE 219,A00,106111,Dow; Steven P,0,0,20,20
1668004060149,CSE 221,A00,102376,Voelker; Geoffrey M.,0,0,0,0
1668004060575,CSE 224,A01,102378,Porter; George M,0,0,0,0
1668004061009,CSE 229A,A00,102379,Savage; Stefan,0,0,0,0
1668004061432,CSE 229C,A00,102380,Munyaka; Imani N. S.,0,0,0,0
1668004061855,CSE 232B,A00,102382,Deutsch; Alin Bernard,0,0,0,0
1668004062281,CSE 234,A01,112904,Kumar; Arun Kumar,0,0,0,0
1668004062703,CSE 237A,A00,102383,Rosing; Tajana Simunic,0,0,0,0
1668004063127,CSE 239A,A00,102384,Deutsch; Alin Bernard,0,0,0,0
1668004063559,CSE 239B,A00,102385,Polikarpova; Nadezhda,0,0,0,0
1668004063985,CSE 240A,A00,102386,Pannuto; Patrick William,0,0,0,0
1668004064412,CSE 240B,A00,102387,Zhao; Jishen,0,0,0,0
1668004064842,CSE 241A,A00,106406,Kang; Mingu,0,0,0,0
1668004065267,CSE 249B,A00,102388,Kahng; Andrew Byun,0,0,8,8
1668004065689,CSE 251B,A01,102392,Cottrell; Garrison W,0,0,0,0
1668004065689,CSE 251B,A02,102393,Cottrell; Garrison W,0,0,0,0
1668004066116,CSE 252B,A00,102394,Ochoa; Benjamin Lawrence,0,0,0,0
1668004066540,CSE 257,A01,102396,Gao; Sicun,0,0,0,0
1668004066964,CSE 272,A00,102397,Li; Tzumao,0,0,0,0
1668004067387,CSE 274,A00,111323,Chern; Albert Ren-Haur,0,0,0,0
1668004067816,CSE 282,A00,102398,Pevzner; Pavel Arkadjevich,0,0,0,0
1668004068244,CSE 284,A00,114175,Gymrek; Melissa Ann,0,0,0,0
1668004068672,CSE 290,A00,102399,Chandraker; Manmohan Krishna,0,0,0,0
1668004068672,CSE 290,B00,102400,Vaccaro; Kristen Marie,0,0,25,25
1668004068672,CSE 290,C00,102414,Pannuto; Patrick William,0,0,25,25
1668004068672,CSE 290,D00,102427,Pevzner; Pavel Arkadjevich,0,0,0,0
1668004068672,CSE 290,E00,102429,Zhao; Jishen,0,0,0,0
1668004068672,CSE 290,F00,102436,Tullsen; Dean Michael,0,0,0,0
1668004068672,CSE 290,G00,102440,Christensen; Henrik I,0,0,20,20
1668004069101,CSE 291,A00,102443,Su; Hao,0,0,0,0
1668004069101,CSE 291,B00,102448,Polikarpova; Nadezhda,0,0,0,0
1668004069101,CSE 291,C00,102453,Vaccaro; Kristen Marie,0,0,0,0
1668004069101,CSE 291,D00,111343,Savage; Stefan,0,0,0,0
1668004069101,CSE 291,E00,116474,Claffy; Kimberly Claire,0,0,0,0
1668004069101,CSE 291,F00,116479,Pasquale; Joseph,0,0,0,0
1668004069532,CSE 293,001,119111,Bafna; Vineet,9999,0,9999,0
1668004069532,CSE 293,002,119118,Bellare; Mihir,9999,0,9999,0
1668004069532,CSE 293,003,119122,Berg-Kirkpatrick; Taylor D,9999,0,9999,0
1668004069532,CSE 293,004,119135,Christensen; Henrik I,9999,0,9999,0
1668004069532,CSE 293,005,119142,Cottrell; Garrison W,9999,0,9999,0
1668004069532,CSE 293,006,119146,Deutsch; Alin Bernard,9999,0,9999,0
1668004069532,CSE 293,007,119159,Esmaeilzadeh; Hadi,9999,0,9999,0
1668004069532,CSE 293,008,119166,Freund; Yoav,9999,0,9999,0
1668004069532,CSE 293,009,119170,Griswold; William G.,9999,0,9999,0
1668004069532,CSE 293,010,119183,Gymrek; Melissa Ann,9999,0,9999,0
1668004069532,CSE 293,011,119190,Heninger; Nadia A,9999,0,9999,0
1668004069532,CSE 293,012,119230,Impagliazzo; Russell,9999,0,9999,0
1668004069532,CSE 293,013,119232,Jhala; Ranjit,9999,0,9999,0
1668004069532,CSE 293,014,119233,Kahng; Andrew Byun,9999,0,9999,0
1668004069532,CSE 293,015,119298,Kane; Daniel Mertz,9999,0,9999,0
1668004069532,CSE 293,016,119299,Kriegman; David J,9999,0,9999,0
1668004069532,CSE 293,017,119300,Kumar; Arun Kumar,9999,0,9999,0
1668004069532,CSE 293,018,119301,Lerner; Sorin,9999,0,9999,0
1668004069532,CSE 293,019,119302,Lovett; Shachar,9999,0,9999,0
1668004069532,CSE 293,020,119303,McAuley; Julian John,9999,0,9999,0
1668004069532,CSE 293,021,119304,Micciancio; Daniele,9999,0,9999,0
1668004069532,CSE 293,022,119367,Orailoglu; Alex,9999,0,9999,0
1668004069532,CSE 293,023,119382,Paturi; Ramamohan,9999,0,9999,0
1668004069532,CSE 293,024,119404,Polikarpova; Nadezhda,9999,0,9999,0
1668004069532,CSE 293,025,119406,Politz; Joseph Gibbs,9999,0,9999,0
1668004069532,CSE 293,026,119411,Porter; George M,9999,0,9999,0
1668004069532,CSE 293,027,119414,Porter; Leonard Emerson,9999,0,9999,0
1668004069532,CSE 293,028,119416,Ramamoorthi; Ravi,9999,0,9999,0
1668004069532,CSE 293,029,119417,Sahoo; Debashis,9999,0,9999,0
1668004069532,CSE 293,030,119420,Saul; Lawrence,9999,0,9999,0
1668004069532,CSE 293,031,119421,Savage; Stefan,9999,0,9999,0
1668004069532,CSE 293,032,119425,Schulze; Jurgen P.,9999,0,9999,0
1668004069532,CSE 293,033,119426,Snoeren; Alex C.,9999,0,9999,0
1668004069532,CSE 293,034,119428,Shang; Jingbo,9999,0,9999,0
1668004069532,CSE 293,035,119430,Stefan; Deian,9999,0,9999,0
1668004069532,CSE 293,036,119431,Su; Hao,9999,0,9999,0
1668004069532,CSE 293,037,119433,Swanson; Steven James,9999,0,9999,0
1668004069532,CSE 293,038,119435,Tullsen; Dean Michael,9999,0,9999,0
1668004069532,CSE 293,039,119483,Voelker; Geoffrey M.,9999,0,9999,0
1668004069532,CSE 293,040,119537,Zhao; Jishen,9999,0,9999,0
1668004069532,CSE 293,041,119538,Zhou; Yuan-Yuan,9999,0,9999,0
1668004069532,CSE 293,042,119539,Gao; Sicun,9999,0,9999,0
1668004069532,CSE 293,043,119540,Weibel; Nadir,9999,0,9999,0
1668004069532,CSE 293,044,119541,Gupta; Rajesh K.,9999,0,9999,0
1668004069532,CSE 293,045,126410,Vaccaro; Kristen Marie,9999,0,9999,0
1668004069532,CSE 293,046,126411,Klemke; Richard,9999,0,9999,0
1668004069957,CSE 294,A00,102459,Voelker; Geoffrey M.,0,0,0,0
1668004069957,CSE 294,B00,111322,Orailoglu; Alex,0,0,0,0
1668004070384,DSE 201,A00,096914,Deutsch; Alin Bernard,30,0,30,0
1668004070808,DSE 210,A00,096915,Dasgupta; Sanjoy,30,0,30,0
1668004071232,DSE 260A,A00,096916,Altintas De Callaf; Ilkay,30,0,30,0
1668004071699,ECE 200,001,103586,Antipa; Nicholas A,9999,0,9999,0
1668004071699,ECE 200,002,103587,Atanasov; Nikolay A.,9999,0,9999,0
1668004071699,ECE 200,003,103588,Bharadia; Dinesh,9999,0,9999,0
1668004071699,ECE 200,004,103589,Cheng; Chung Kuan,9999,0,9999,0
1668004071699,ECE 200,005,103590,Cosman; Pamela C.,9999,0,9999,0
1668004071699,ECE 200,006,103591,Dayeh; Shadi Ahmad,9999,0,9999,0
1668004071699,ECE 200,007,103592,Fainman; Yeshaiahu,9999,0,9999,0
1668004071699,ECE 200,008,103593,Ford; Joseph Earl,9999,0,9999,0
1668004071699,ECE 200,009,103594,Franceschetti; Massimo,9999,0,9999,0
1668004071699,ECE 200,010,103595,Fullerton; Eric E,9999,0,9999,0
1668004071699,ECE 200,011,103596,Galton; Ian A,9999,0,9999,0
1668004071699,ECE 200,012,103597,Gilja; Vikash,9999,0,9999,0
1668004071699,ECE 200,013,103598,Hall; Drew A.,9999,0,9999,0
1668004071699,ECE 200,014,103599,Hsueh; Tzu-Chien,9999,0,9999,0
1668004071699,ECE 200,015,103600,Javidi; Tara,9999,0,9999,0
1668004071699,ECE 200,016,103601,Kahng; Andrew Byun,9999,0,9999,0
1668004071699,ECE 200,017,103602,Kim; Young-Han,9999,0,9999,0
1668004071699,ECE 200,018,103603,Koushanfar; Farinaz,9999,0,9999,0
1668004071699,ECE 200,019,103604,Kuzum; Duygu,9999,0,9999,0
1668004071699,ECE 200,020,103605,Le; Hanh-Phuc,9999,0,9999,0
1668004071699,ECE 200,021,103606,Lin; Bill,9999,0,9999,0
1668004071699,ECE 200,022,103607,Liu; Zhaowei,9998,0,9999,1
1668004071699,ECE 200,023,103608,Lo; Yu-Hwa,9999,0,9999,0
1668004071699,ECE 200,024,103609,Lomakin; Vitaliy,9999,0,9999,0
1668004071699,ECE 200,025,103610,Mercier; Patrick Philip,9999,0,9999,0
1668004071699,ECE 200,026,103611,Meyer; Florian,9999,0,9999,0
1668004071699,ECE 200,027,103612,Milstein; Laurence B.,9999,0,9999,0
1668004071699,ECE 200,028,103613,Mir Arabbaygi; Siavash,9999,0,9999,0
1668004071699,ECE 200,029,103614,Mookherjea; Shayan,9999,0,9999,0
1668004071699,ECE 200,030,103615,Morris; Karcher William,9999,0,9999,0
1668004071699,ECE 200,031,103616,Ng; Tse Nga,9999,0,9999,0
1668004071699,ECE 200,032,103617,Nguyen; Truong Quang,9999,0,9999,0
1668004071699,ECE 200,033,103618,Nomura; Kenji,9999,0,9999,0
1668004071699,ECE 200,034,103619,Orlitsky; Alon,9999,0,9999,0
1668004071699,ECE 200,035,103620,Pal; Piya,9999,0,9999,0
1668004071699,ECE 200,036,103621,Papen; George C.,9999,0,9999,0
1668004071699,ECE 200,037,103622,Radic; Stojan,9999,0,9999,0
1668004071699,ECE 200,038,103623,Rao; Bhaskar D.,9999,0,9999,0
1668004071699,ECE 200,039,103624,Rao; Ramesh R,9999,0,9999,0
1668004071699,ECE 200,040,103625,Rebeiz; Gabriel,9999,0,9999,0
1668004071699,ECE 200,041,103626,Sanford; John R,9999,0,9999,0
1668004071699,ECE 200,042,103627,Siegel; Paul H.,9999,0,9999,0
1668004071699,ECE 200,043,103628,Sievenpiper; Daniel F.,9999,0,9999,0
1668004071699,ECE 200,044,103629,Sworder; David D.,9999,0,9999,0
1668004071699,ECE 200,045,103630,Taur; Yuan,9999,0,9999,0
1668004071699,ECE 200,046,103631,Touri; Behrouz,9999,0,9999,0
1668004071699,ECE 200,047,103632,Trivedi; Mohan M.,9999,0,9999,0
1668004071699,ECE 200,048,103633,Vasconcelos; Nuno,9999,0,9999,0
1668004071699,ECE 200,049,103634,Wang; Xiaolong,9999,0,9999,0
1668004071699,ECE 200,050,103635,Xie; Pengtao,9999,0,9999,0
1668004071699,ECE 200,051,103636,Yip; Michael,9999,0,9999,0
1668004071699,ECE 200,052,103637,Zeger; Kenneth A.,999,0,999,0
1668004071699,ECE 200,053,103638,Zhang; Xinyu,9999,0,9999,0
1668004071699,ECE 200,054,103639,Turakhia; Yatish Girish,9999,0,9999,0
1668004071699,ECE 200,055,103640,Kang; Mingu,9999,0,9999,0
1668004071699,ECE 200,056,103641,Shi; Yuanyuan,9999,0,9999,0
1668004071699,ECE 200,057,103642,Wang; Edward Jay,9999,0,9999,0
1668004071699,ECE 200,058,103643,Zheng; Yang,9999,0,9999,0
1668004072128,ECE 202,A00,103644,Kuzum; Duygu,0,0,0,0
1668004072564,ECE 212BN,A00,103646,Ng; Tse Nga,0,0,0,0
1668004072988,ECE 221,A00,111493,Staff,0,0,0,0
1668004073413,ECE 222B,A00,103647,Lomakin; Vitaliy,0,0,0,0
1668004073912,ECE 230B,A00,103648,Taur; Yuan,0,0,0,0
1668004074350,ECE 238B,A00,103649,Garay; Javier,0,0,0,0
1668004074773,ECE 240B,A00,112900,Fainman; Yeshaiahu,0,0,0,0
1668004075203,ECE 247A,A00,103650,Jokerst; Jesse Vincent,0,0,0,0
1668004075633,ECE 247B,A00,103651,Wang; Joseph,0,0,0,0
1668004076056,ECE 250,A00,103652,Siegel; Paul H.,0,0,0,0
1668004076479,ECE 251A,A00,103654,Rao; Bhaskar D.,0,0,0,0
1668004076904,ECE 257B,A00,103655,Bharadia; Dinesh,0,0,0,0
1668004077328,ECE 258A,A00,103656,Milstein; Laurence B.,0,0,0,0
1668004077765,ECE 260B,A00,103658,Kang; Mingu,0,0,0,0
1668004078188,ECE 264A,A00,103659,Galton; Ian A,0,0,0,0
1668004078611,ECE 265A,A00,103661,Gudem; Prasad S.S.,0,0,0,0
1668004079051,ECE 265D,A00,103662,Gudem; Prasad S.S.,0,0,0,0
1668004079474,ECE 268,A00,103663,Koushanfar; Farinaz,0,0,0,0
1668004079915,ECE 269,A01,103665,Pal; Piya,0,0,0,0
1668004080345,ECE 271B,A00,103666,Vasconcelos; Manuela,0,0,0,0
1668004080780,ECE 276A,A00,103667,Atanasov; Nikolay A.,0,0,0,0
1668004081204,ECE 277,A00,103668,An; Cheolhong,0,0,0,0
1668004081632,ECE 279,A00,117947,Hall; Drew A.,0,0,0,0
1668004082495,ECE 283,A00,103670,Hsueh; Tzu-Chien,0,0,0,0
1668004082920,ECE 284,A00,103671,Turakhia; Yatish Girish,0,0,0,0
1668004083346,ECE 285,A00,103672,Zheng; Yang,0,0,0,0
1668004083346,ECE 285,B00,103673,Sworder; David D.,0,0,0,0
1668004083773,ECE 287,A00,103676,Javidi; Tara,0,0,0,0
1668004084196,MATH 200B,A00,098023,Salehi Golsefidy; Alireza,14,0,15,1
1668004084622,MATH 202B,A00,098024,Rhoades; Brendon Patrick,12,0,15,3
1668004085055,MATH 203B,A00,098025,Oprea; Dragos N.,12,0,15,3
1668004085479,MATH 204B,A00,098026,Sorensen; Claus M,14,0,15,1
1668004085903,MATH 208,A00,098027,Izadi; Elham,7,0,10,3
1668004086328,MATH 209,A00,098028,Pollack; Aaron,10,0,10,0
1668004086752,MATH 211A,A00,112919,Rogalski; Daniel,9,0,10,1
1668004087179,MATH 211B,A00,112920,Seward; Brandon M.,9,0,10,1
1668004087603,MATH 218,A00,098029,Li; Bo,10,0,10,0
1668004088029,MATH 220B,A00,098030,Novak; Jonathan I,13,0,15,2
1668004088454,MATH 221A,A00,098031,Ebenfelt; Peter F,13,0,15,2
1668004088875,MATH 231B,A00,098032,Zlatos; Andrej,12,0,15,3
1668004089307,MATH 240B,A00,098033,Ni; Lei,10,0,15,5
1668004089733,MATH 243,A00,098034,Jekel; David Andrew,10,0,10,0
1668004090161,MATH 245A,A00,098035,Nie; Jiawang,0,0,15,16
1668004090583,MATH 248,A00,098036,Bejenaru; Ioan,10,0,10,0
1668004091009,MATH 250B,A00,098037,Spolaor; Luca,14,0,15,1
1668004091433,MATH 258,A00,098038,Ni; Lei,10,0,10,0
1668004091860,MATH 264B,A00,098041,Rhoades; Brendon Patrick,11,0,15,4
1668004092286,MATH 268,A00,098042,Buss; Samuel R,10,0,10,0
1668004092711,MATH 269,A00,098043,Rhoades; Brendon Patrick,10,0,10,0
1668004093135,MATH 270B,A00,098044,Li; Bo,11,0,15,4
1668004093561,MATH 272B,A00,098045,Holst; Michael J,13,0,15,2
1668004093984,MATH 273A,A00,098046,Tian; Xiaochuan,12,0,15,3
1668004094412,MATH 275,A01,098048,Tian; Xiaochuan,6,0,10,4
1668004094837,MATH 278A,A00,098049,Holst; Michael J,8,0,10,2
1668004095261,MATH 278B,A00,098050,Cloninger; Alexander,10,0,10,0
1668004095684,MATH 278C,A00,098051,Nie; Jiawang,8,0,10,2
1668004096111,MATH 280B,A00,098052,Zheng; Tianyi,11,0,15,4
1668004096538,MATH 281B,A00,098053,Bradic; Jelena,4,0,15,11
1668004096964,MATH 282B,A00,098054,Arias-Castro; Ery,2,0,15,13
1668004097393,MATH 285,A00,098055,Fitzsimmons; Patrick J,0,0,15,17
1668004097819,MATH 287B,A00,098056,Arias-Castro; Ery,5,0,15,10
1668004098244,MATH 288,A00,098057,Agarwal; Pooja,9,0,10,1
1668004098244,MATH 288,B00,098058,Zhang; Danna,9,0,10,1
1668004098244,MATH 288,C00,098059,Williams; Ruth J,10,0,10,0
1668004098671,MATH 290B,A00,098060,Roberts; Justin Deritter,14,0,15,1
1668004099097,MATH 292,A00,098061,Belmont; Eva Kinoshita,10,0,10,0
1668004099528,MATH 295,A00,098062,Suk; Andrew Hoon,48,0,50,2
1668004099952,MATH 296,A00,098063,Novak; Jonathan I,20,0,20,0
1668004100377,MATH 297,001,098064,Gamst; Anthony Collins,9997,0,9999,2
1668004600992,COGS 205,A00,101395,Chiba; Andrea,19,0,20,1
1668004601421,COGS 210B,001,101404,Greene; Deanna Jacquelyn,9998,0,9999,1
1668004601421,COGS 210B,002,101417,Xia; Haijun,9999,0,9999,0
1668004601421,COGS 210B,003,101422,Nitz; Douglas A.,9999,0,9999,0
1668004601421,COGS 210B,004,101423,Hollan; James D.,9998,0,9999,1
1668004601421,COGS 210B,005,101424,Deak; Gedeon O.,9999,0,9999,0
1668004601421,COGS 210B,006,101425,Rossano; Federico,9999,0,9999,0
1668004601846,COGS 211B,A00,101427,Coulson; Seana M,9997,0,9999,2
1668004602270,COGS 220,A00,101428,Hollan; James D.,0,0,25,25
1668004602697,COGS 229,A00,101429,Dow; Steven P,18,0,25,7
1668004603123,COGS 230,A00,101430,Klemmer; Scott R,13,0,17,4
1668004603547,COGS 234,A00,101431,Xia; Haijun,7,0,25,18
1668004603974,COGS 260,A00,101432,Kiyonaga; Anastasia,20,0,25,5
1668004603974,COGS 260,B00,101433,Kirsh; David Joel,16,0,25,9
1668004604397,CSE 202,A00,102371,Impagliazzo; Russell,0,0,0,0
1668004604821,CSE 203B,A01,102373,Cheng; Chung Kuan,0,0,0,0
1668004605246,CSE 208,A00,102374,Micciancio; Daniele,0,0,0,0
1668004605669,CSE 209A,A00,112895,Impagliazzo; Russell,0,0,15,15
1668004606096,CSE 209B,A00,108005,Bellare; Mihir,0,0,0,0
1668004606529,CSE 210,A00,113163,Coblenz; Michael J,0,0,0,0
1668004606957,CSE 219,A00,106111,Dow; Steven P,0,0,20,20
1668004607380,CSE 221,A00,102376,Voelker; Geoffrey M.,0,0,0,0
1668004607804,CSE 224,A01,102378,Porter; George M,0,0,0,0
1668004608231,CSE 229A,A00,102379,Savage; Stefan,0,0,0,0
1668004608655,CSE 229C,A00,102380,Munyaka; Imani N. S.,0,0,0,0
1668004609080,CSE 232B,A00,102382,Deutsch; Alin Bernard,0,0,0,0
1668004609507,CSE 234,A01,112904,Kumar; Arun Kumar,0,0,0,0
1668004609934,CSE 237A,A00,102383,Rosing; Tajana Simunic,0,0,0,0
1668004610360,CSE 239A,A00,102384,Deutsch; Alin Bernard,0,0,0,0
1668004610784,CSE 239B,A00,102385,Polikarpova; Nadezhda,0,0,0,0
1668004611214,CSE 240A,A00,102386,Pannuto; Patrick William,0,0,0,0
1668004611642,CSE 240B,A00,102387,Zhao; Jishen,0,0,0,0
1668004612068,CSE 241A,A00,106406,Kang; Mingu,0,0,0,0
1668004612492,CSE 249B,A00,102388,Kahng; Andrew Byun,0,0,8,8
1668004612915,CSE 251B,A01,102392,Cottrell; Garrison W,0,0,0,0
1668004612915,CSE 251B,A02,102393,Cottrell; Garrison W,0,0,0,0
1668004613347,CSE 252B,A00,102394,Ochoa; Benjamin Lawrence,0,0,0,0
1668004613776,CSE 257,A01,102396,Gao; Sicun,0,0,0,0
1668004614202,CSE 272,A00,102397,Li; Tzumao,0,0,0,0
1668004614630,CSE 274,A00,111323,Chern; Albert Ren-Haur,0,0,0,0
1668004615055,CSE 282,A00,102398,Pevzner; Pavel Arkadjevich,0,0,0,0
1668004615478,CSE 284,A00,114175,Gymrek; Melissa Ann,0,0,0,0
1668004615904,CSE 290,A00,102399,Chandraker; Manmohan Krishna,0,0,0,0
1668004615904,CSE 290,B00,102400,Vaccaro; Kristen Marie,0,0,25,25
1668004615904,CSE 290,C00,102414,Pannuto; Patrick William,0,0,25,25
1668004615904,CSE 290,D00,102427,Pevzner; Pavel Arkadjevich,0,0,0,0
1668004615904,CSE 290,E00,102429,Zhao; Jishen,0,0,0,0
1668004615904,CSE 290,F00,102436,Tullsen; Dean Michael,0,0,0,0
1668004615904,CSE 290,G00,102440,Christensen; Henrik I,0,0,20,20
1668004616330,CSE 291,A00,102443,Su; Hao,0,0,0,0
1668004616330,CSE 291,B00,102448,Polikarpova; Nadezhda,0,0,0,0
1668004616330,CSE 291,C00,102453,Vaccaro; Kristen Marie,0,0,0,0
1668004616330,CSE 291,D00,111343,Savage; Stefan,0,0,0,0
1668004616330,CSE 291,E00,116474,Claffy; Kimberly Claire,0,0,0,0
1668004616330,CSE 291,F00,116479,Pasquale; Joseph,0,0,0,0
1668004616794,CSE 293,001,119111,Bafna; Vineet,9999,0,9999,0
1668004616794,CSE 293,002,119118,Bellare; Mihir,9999,0,9999,0
1668004616794,CSE 293,003,119122,Berg-Kirkpatrick; Taylor D,9999,0,9999,0
1668004616794,CSE 293,004,119135,Christensen; Henrik I,9999,0,9999,0
1668004616794,CSE 293,005,119142,Cottrell; Garrison W,9999,0,9999,0
1668004616794,CSE 293,006,119146,Deutsch; Alin Bernard,9999,0,9999,0
1668004616794,CSE 293,007,119159,Esmaeilzadeh; Hadi,9999,0,9999,0
1668004616794,CSE 293,008,119166,Freund; Yoav,9999,0,9999,0
1668004616794,CSE 293,009,119170,Griswold; William G.,9999,0,9999,0
1668004616794,CSE 293,010,119183,Gymrek; Melissa Ann,9999,0,9999,0
1668004616794,CSE 293,011,119190,Heninger; Nadia A,9999,0,9999,0
1668004616794,CSE 293,012,119230,Impagliazzo; Russell,9999,0,9999,0
1668004616794,CSE 293,013,119232,Jhala; Ranjit,9999,0,9999,0
1668004616794,CSE 293,014,119233,Kahng; Andrew Byun,9999,0,9999,0
1668004616794,CSE 293,015,119298,Kane; Daniel Mertz,9999,0,9999,0
1668004616794,CSE 293,016,119299,Kriegman; David J,9999,0,9999,0
1668004616794,CSE 293,017,119300,Kumar; Arun Kumar,9999,0,9999,0
1668004616794,CSE 293,018,119301,Lerner; Sorin,9999,0,9999,0
1668004616794,CSE 293,019,119302,Lovett; Shachar,9999,0,9999,0
1668004616794,CSE 293,020,119303,McAuley; Julian John,9999,0,9999,0
1668004616794,CSE 293,021,119304,Micciancio; Daniele,9999,0,9999,0
1668004616794,CSE 293,022,119367,Orailoglu; Alex,9999,0,9999,0
1668004616794,CSE 293,023,119382,Paturi; Ramamohan,9999,0,9999,0
1668004616794,CSE 293,024,119404,Polikarpova; Nadezhda,9999,0,9999,0
1668004616794,CSE 293,025,119406,Politz; Joseph Gibbs,9999,0,9999,0
1668004616794,CSE 293,026,119411,Porter; George M,9999,0,9999,0
1668004616794,CSE 293,027,119414,Porter; Leonard Emerson,9999,0,9999,0
1668004616794,CSE 293,028,119416,Ramamoorthi; Ravi,9999,0,9999,0
1668004616794,CSE 293,029,119417,Sahoo; Debashis,9999,0,9999,0
1668004616794,CSE 293,030,119420,Saul; Lawrence,9999,0,9999,0
1668004616794,CSE 293,031,119421,Savage; Stefan,9999,0,9999,0
1668004616794,CSE 293,032,119425,Schulze; Jurgen P.,9999,0,9999,0
1668004616794,CSE 293,033,119426,Snoeren; Alex C.,9999,0,9999,0
1668004616794,CSE 293,034,119428,Shang; Jingbo,9999,0,9999,0
1668004616794,CSE 293,035,119430,Stefan; Deian,9999,0,9999,0
1668004616794,CSE 293,036,119431,Su; Hao,9999,0,9999,0
1668004616794,CSE 293,037,119433,Swanson; Steven James,9999,0,9999,0
1668004616794,CSE 293,038,119435,Tullsen; Dean Michael,9999,0,9999,0
1668004616794,CSE 293,039,119483,Voelker; Geoffrey M.,9999,0,9999,0
1668004616794,CSE 293,040,119537,Zhao; Jishen,9999,0,9999,0
1668004616794,CSE 293,041,119538,Zhou; Yuan-Yuan,9999,0,9999,0
1668004616794,CSE 293,042,119539,Gao; Sicun,9999,0,9999,0
1668004616794,CSE 293,043,119540,Weibel; Nadir,9999,0,9999,0
1668004616794,CSE 293,044,119541,Gupta; Rajesh K.,9999,0,9999,0
1668004616794,CSE 293,045,126410,Vaccaro; Kristen Marie,9999,0,9999,0
1668004616794,CSE 293,046,126411,Klemke; Richard,9999,0,9999,0
1668004617219,CSE 294,A00,102459,Voelker; Geoffrey M.,0,0,0,0
1668004617219,CSE 294,B00,111322,Orailoglu; Alex,0,0,0,0
1668004617642,DSE 201,A00,096914,Deutsch; Alin Bernard,30,0,30,0
1668004618064,DSE 210,A00,096915,Dasgupta; Sanjoy,30,0,30,0
1668004618486,DSE 260A,A00,096916,Altintas De Callaf; Ilkay,30,0,30,0
1668004618926,ECE 200,001,103586,Antipa; Nicholas A,9999,0,9999,0
1668004618926,ECE 200,002,103587,Atanasov; Nikolay A.,9999,0,9999,0
1668004618926,ECE 200,003,103588,Bharadia; Dinesh,9999,0,9999,0
1668004618926,ECE 200,004,103589,Cheng; Chung Kuan,9999,0,9999,0
1668004618926,ECE 200,005,103590,Cosman; Pamela C.,9999,0,9999,0
1668004618926,ECE 200,006,103591,Dayeh; Shadi Ahmad,9999,0,9999,0
1668004618926,ECE 200,007,103592,Fainman; Yeshaiahu,9999,0,9999,0
1668004618926,ECE 200,008,103593,Ford; Joseph Earl,9999,0,9999,0
1668004618926,ECE 200,009,103594,Franceschetti; Massimo,9999,0,9999,0
1668004618926,ECE 200,010,103595,Fullerton; Eric E,9999,0,9999,0
1668004618926,ECE 200,011,103596,Galton; Ian A,9999,0,9999,0
1668004618926,ECE 200,012,103597,Gilja; Vikash,9999,0,9999,0
1668004618926,ECE 200,013,103598,Hall; Drew A.,9999,0,9999,0
1668004618926,ECE 200,014,103599,Hsueh; Tzu-Chien,9999,0,9999,0
1668004618926,ECE 200,015,103600,Javidi; Tara,9999,0,9999,0
1668004618926,ECE 200,016,103601,Kahng; Andrew Byun,9999,0,9999,0
1668004618926,ECE 200,017,103602,Kim; Young-Han,9999,0,9999,0
1668004618926,ECE 200,018,103603,Koushanfar; Farinaz,9999,0,9999,0
1668004618926,ECE 200,019,103604,Kuzum; Duygu,9999,0,9999,0
1668004618926,ECE 200,020,103605,Le; Hanh-Phuc,9999,0,9999,0
1668004618926,ECE 200,021,103606,Lin; Bill,9999,0,9999,0
1668004618926,ECE 200,022,103607,Liu; Zhaowei,9998,0,9999,1
1668004618926,ECE 200,023,103608,Lo; Yu-Hwa,9999,0,9999,0
1668004618926,ECE 200,024,103609,Lomakin; Vitaliy,9999,0,9999,0
1668004618926,ECE 200,025,103610,Mercier; Patrick Philip,9999,0,9999,0
1668004618926,ECE 200,026,103611,Meyer; Florian,9999,0,9999,0
1668004618926,ECE 200,027,103612,Milstein; Laurence B.,9999,0,9999,0
1668004618926,ECE 200,028,103613,Mir Arabbaygi; Siavash,9999,0,9999,0
1668004618926,ECE 200,029,103614,Mookherjea; Shayan,9999,0,9999,0
1668004618926,ECE 200,030,103615,Morris; Karcher William,9999,0,9999,0
1668004618926,ECE 200,031,103616,Ng; Tse Nga,9999,0,9999,0
1668004618926,ECE 200,032,103617,Nguyen; Truong Quang,9999,0,9999,0
1668004618926,ECE 200,033,103618,Nomura; Kenji,9999,0,9999,0
1668004618926,ECE 200,034,103619,Orlitsky; Alon,9999,0,9999,0
1668004618926,ECE 200,035,103620,Pal; Piya,9999,0,9999,0
1668004618926,ECE 200,036,103621,Papen; George C.,9999,0,9999,0
1668004618926,ECE 200,037,103622,Radic; Stojan,9999,0,9999,0
1668004618926,ECE 200,038,103623,Rao; Bhaskar D.,9999,0,9999,0
1668004618926,ECE 200,039,103624,Rao; Ramesh R,9999,0,9999,0
1668004618926,ECE 200,040,103625,Rebeiz; Gabriel,9999,0,9999,0
1668004618926,ECE 200,041,103626,Sanford; John R,9999,0,9999,0
1668004618926,ECE 200,042,103627,Siegel; Paul H.,9999,0,9999,0
1668004618926,ECE 200,043,103628,Sievenpiper; Daniel F.,9999,0,9999,0
1668004618926,ECE 200,044,103629,Sworder; David D.,9999,0,9999,0
1668004618926,ECE 200,045,103630,Taur; Yuan,9999,0,9999,0
1668004618926,ECE 200,046,103631,Touri; Behrouz,9999,0,9999,0
1668004618926,ECE 200,047,103632,Trivedi; Mohan M.,9999,0,9999,0
1668004618926,ECE 200,048,103633,Vasconcelos; Nuno,9999,0,9999,0
1668004618926,ECE 200,049,103634,Wang; Xiaolong,9999,0,9999,0
1668004618926,ECE 200,050,103635,Xie; Pengtao,9999,0,9999,0
1668004618926,ECE 200,051,103636,Yip; Michael,9999,0,9999,0
1668004618926,ECE 200,052,103637,Zeger; Kenneth A.,999,0,999,0
1668004618926,ECE 200,053,103638,Zhang; Xinyu,9999,0,9999,0
1668004618926,ECE 200,054,103639,Turakhia; Yatish Girish,9999,0,9999,0
1668004618926,ECE 200,055,103640,Kang; Mingu,9999,0,9999,0
1668004618926,ECE 200,056,103641,Shi; Yuanyuan,9999,0,9999,0
1668004618926,ECE 200,057,103642,Wang; Edward Jay,9999,0,9999,0
1668004618926,ECE 200,058,103643,Zheng; Yang,9999,0,9999,0
1668004619353,ECE 202,A00,103644,Kuzum; Duygu,0,0,0,0
1668004619776,ECE 212BN,A00,103646,Ng; Tse Nga,0,0,0,0
1668004620201,ECE 221,A00,111493,Staff,0,0,0,0
1668004620624,ECE 222B,A00,103647,Lomakin; Vitaliy,0,0,0,0
1668004621054,ECE 230B,A00,103648,Taur; Yuan,0,0,0,0
1668004621479,ECE 238B,A00,103649,Garay; Javier,0,0,0,0
1668004621903,ECE 240B,A00,112900,Fainman; Yeshaiahu,0,0,0,0
1668004622328,ECE 247A,A00,103650,Jokerst; Jesse Vincent,0,0,0,0
1668004622755,ECE 247B,A00,103651,Wang; Joseph,0,0,0,0
1668004623179,ECE 250,A00,103652,Siegel; Paul H.,0,0,0,0
1668004623604,ECE 251A,A00,103654,Rao; Bhaskar D.,0,0,0,0
1668004624029,ECE 257B,A00,103655,Bharadia; Dinesh,0,0,0,0
1668004624456,ECE 258A,A00,103656,Milstein; Laurence B.,0,0,0,0
1668004624885,ECE 260B,A00,103658,Kang; Mingu,0,0,0,0
1668004625310,ECE 264A,A00,103659,Galton; Ian A,0,0,0,0
1668004625736,ECE 265A,A00,103661,Gudem; Prasad S.S.,0,0,0,0
1668004626159,ECE 265D,A00,103662,Gudem; Prasad S.S.,0,0,0,0
1668004626583,ECE 268,A00,103663,Koushanfar; Farinaz,0,0,0,0
1668004627009,ECE 269,A01,103665,Pal; Piya,0,0,0,0
1668004627431,ECE 271B,A00,103666,Vasconcelos; Manuela,0,0,0,0
1668004627865,ECE 276A,A00,103667,Atanasov; Nikolay A.,0,0,0,0
1668004628288,ECE 277,A00,103668,An; Cheolhong,0,0,0,0
1668004628711,ECE 279,A00,117947,Hall; Drew A.,0,0,0,0
1668004629581,ECE 283,A00,103670,Hsueh; Tzu-Chien,0,0,0,0
1668004630019,ECE 284,A00,103671,Turakhia; Yatish Girish,0,0,0,0
1668004630442,ECE 285,A00,103672,Zheng; Yang,0,0,0,0
1668004630442,ECE 285,B00,103673,Sworder; David D.,0,0,0,0
1668004630872,ECE 287,A00,103676,Javidi; Tara,0,0,0,0
1668004631308,MATH 200B,A00,098023,Salehi Golsefidy; Alireza,14,0,15,1
1668004631730,MATH 202B,A00,098024,Rhoades; Brendon Patrick,12,0,15,3
1668004632155,MATH 203B,A00,098025,Oprea; Dragos N.,12,0,15,3
1668004632589,MATH 204B,A00,098026,Sorensen; Claus M,14,0,15,1
1668004633014,MATH 208,A00,098027,Izadi; Elham,7,0,10,3
1668004633436,MATH 209,A00,098028,Pollack; Aaron,10,0,10,0
1668004633860,MATH 211A,A00,112919,Rogalski; Daniel,9,0,10,1
1668004634286,MATH 211B,A00,112920,Seward; Brandon M.,9,0,10,1
1668004634717,MATH 218,A00,098029,Li; Bo,10,0,10,0
1668004635141,MATH 220B,A00,098030,Novak; Jonathan I,13,0,15,2
1668004635580,MATH 221A,A00,098031,Ebenfelt; Peter F,13,0,15,2
1668004636015,MATH 231B,A00,098032,Zlatos; Andrej,12,0,15,3
1668004636453,MATH 240B,A00,098033,Ni; Lei,10,0,15,5
1668004636887,MATH 243,A00,098034,Jekel; David Andrew,10,0,10,0
1668004637320,MATH 245A,A00,098035,Nie; Jiawang,0,0,15,16
1668004637852,MATH 248,A00,098036,Bejenaru; Ioan,10,0,10,0
1668004638284,MATH 250B,A00,098037,Spolaor; Luca,14,0,15,1
1668004638710,MATH 258,A00,098038,Ni; Lei,10,0,10,0
1668004639135,MATH 264B,A00,098041,Rhoades; Brendon Patrick,11,0,15,4
1668004639560,MATH 268,A00,098042,Buss; Samuel R,10,0,10,0
1668004639985,MATH 269,A00,098043,Rhoades; Brendon Patrick,10,0,10,0
1668004640409,MATH 270B,A00,098044,Li; Bo,11,0,15,4
1668004640835,MATH 272B,A00,098045,Holst; Michael J,13,0,15,2
1668004641257,MATH 273A,A00,098046,Tian; Xiaochuan,12,0,15,3
1668004641683,MATH 275,A01,098048,Tian; Xiaochuan,6,0,10,4
1668004642110,MATH 278A,A00,098049,Holst; Michael J,8,0,10,2
1668004642535,MATH 278B,A00,098050,Cloninger; Alexander,10,0,10,0
1668004642957,MATH 278C,A00,098051,Nie; Jiawang,8,0,10,2
1668004643385,MATH 280B,A00,098052,Zheng; Tianyi,11,0,15,4
1668004643806,MATH 281B,A00,098053,Bradic; Jelena,4,0,15,11
1668004644228,MATH 282B,A00,098054,Arias-Castro; Ery,2,0,15,13
1668004644654,MATH 285,A00,098055,Fitzsimmons; Patrick J,0,0,15,17
1668004645079,MATH 287B,A00,098056,Arias-Castro; Ery,5,0,15,10
1668004645508,MATH 288,A00,098057,Agarwal; Pooja,9,0,10,1
1668004645508,MATH 288,B00,098058,Zhang; Danna,9,0,10,1
1668004645508,MATH 288,C00,098059,Williams; Ruth J,10,0,10,0
1668004645933,MATH 290B,A00,098060,Roberts; Justin Deritter,14,0,15,1
1668004646358,MATH 292,A00,098061,Belmont; Eva Kinoshita,10,0,10,0
1668004646783,MATH 295,A00,098062,Suk; Andrew Hoon,48,0,50,2
1668004647206,MATH 296,A00,098063,Novak; Jonathan I,20,0,20,0
1668004647627,MATH 297,001,098064,Gamst; Anthony Collins,9997,0,9999,2
1668005147924,COGS 205,A00,101395,Chiba; Andrea,19,0,20,1
1668005148349,COGS 210B,001,101404,Greene; Deanna Jacquelyn,9998,0,9999,1
1668005148349,COGS 210B,002,101417,Xia; Haijun,9999,0,9999,0
1668005148349,COGS 210B,003,101422,Nitz; Douglas A.,9999,0,9999,0
1668005148349,COGS 210B,004,101423,Hollan; James D.,9998,0,9999,1
1668005148349,COGS 210B,005,101424,Deak; Gedeon O.,9999,0,9999,0
1668005148349,COGS 210B,006,101425,Rossano; Federico,9999,0,9999,0
1668005148774,COGS 211B,A00,101427,Coulson; Seana M,9997,0,9999,2
1668005149205,COGS 220,A00,101428,Hollan; James D.,0,0,25,25
1668005149628,COGS 229,A00,101429,Dow; Steven P,18,0,25,7
1668005150054,COGS 230,A00,101430,Klemmer; Scott R,13,0,17,4
1668005150476,COGS 234,A00,101431,Xia; Haijun,7,0,25,18
1668005150901,COGS 260,A00,101432,Kiyonaga; Anastasia,20,0,25,5
1668005150901,COGS 260,B00,101433,Kirsh; David Joel,16,0,25,9
1668005151325,CSE 202,A00,102371,Impagliazzo; Russell,0,0,0,0
1668005151746,CSE 203B,A01,102373,Cheng; Chung Kuan,0,0,0,0
1668005152170,CSE 208,A00,102374,Micciancio; Daniele,0,0,0,0
1668005152597,CSE 209A,A00,112895,Impagliazzo; Russell,0,0,15,15
1668005153023,CSE 209B,A00,108005,Bellare; Mihir,0,0,0,0
1668005153463,CSE 210,A00,113163,Coblenz; Michael J,0,0,0,0
1668005153891,CSE 219,A00,106111,Dow; Steven P,0,0,20,20
1668005154318,CSE 221,A00,102376,Voelker; Geoffrey M.,0,0,0,0
1668005154745,CSE 224,A01,102378,Porter; George M,0,0,0,0
1668005155167,CSE 229A,A00,102379,Savage; Stefan,0,0,0,0
1668005155592,CSE 229C,A00,102380,Munyaka; Imani N. S.,0,0,0,0
1668005156032,CSE 232B,A00,102382,Deutsch; Alin Bernard,0,0,0,0
1668005156460,CSE 234,A01,112904,Kumar; Arun Kumar,0,0,0,0
1668005156884,CSE 237A,A00,102383,Rosing; Tajana Simunic,0,0,0,0
1668005157310,CSE 239A,A00,102384,Deutsch; Alin Bernard,0,0,0,0
1668005157738,CSE 239B,A00,102385,Polikarpova; Nadezhda,0,0,0,0
1668005158251,CSE 240A,A00,102386,Pannuto; Patrick William,0,0,0,0
1668005158675,CSE 240B,A00,102387,Zhao; Jishen,0,0,0,0
1668005159098,CSE 241A,A00,106406,Kang; Mingu,0,0,0,0
1668005159523,CSE 249B,A00,102388,Kahng; Andrew Byun,0,0,8,8
1668005159952,CSE 251B,A01,102392,Cottrell; Garrison W,0,0,0,0
1668005159952,CSE 251B,A02,102393,Cottrell; Garrison W,0,0,0,0
1668005160379,CSE 252B,A00,102394,Ochoa; Benjamin Lawrence,0,0,0,0
1668005160801,CSE 257,A01,102396,Gao; Sicun,0,0,0,0
1668005161224,CSE 272,A00,102397,Li; Tzumao,0,0,0,0
1668005161646,CSE 274,A00,111323,Chern; Albert Ren-Haur,0,0,0,0
1668005162073,CSE 282,A00,102398,Pevzner; Pavel Arkadjevich,0,0,0,0
1668005162498,CSE 284,A00,114175,Gymrek; Melissa Ann,0,0,0,0
1668005162922,CSE 290,A00,102399,Chandraker; Manmohan Krishna,0,0,0,0
1668005162922,CSE 290,B00,102400,Vaccaro; Kristen Marie,0,0,25,25
1668005162922,CSE 290,C00,102414,Pannuto; Patrick William,0,0,25,25
1668005162922,CSE 290,D00,102427,Pevzner; Pavel Arkadjevich,0,0,0,0
1668005162922,CSE 290,E00,102429,Zhao; Jishen,0,0,0,0
1668005162922,CSE 290,F00,102436,Tullsen; Dean Michael,0,0,0,0
1668005162922,CSE 290,G00,102440,Christensen; Henrik I,0,0,20,20
1668005163352,CSE 291,A00,102443,Su; Hao,0,0,0,0
1668005163352,CSE 291,B00,102448,Polikarpova; Nadezhda,0,0,0,0
1668005163352,CSE 291,C00,102453,Vaccaro; Kristen Marie,0,0,0,0
1668005163352,CSE 291,D00,111343,Savage; Stefan,0,0,0,0
1668005163352,CSE 291,E00,116474,Claffy; Kimberly Claire,0,0,0,0
1668005163352,CSE 291,F00,116479,Pasquale; Joseph,0,0,0,0
1668005163779,CSE 293,001,119111,Bafna; Vineet,9999,0,9999,0
1668005163779,CSE 293,002,119118,Bellare; Mihir,9999,0,9999,0
1668005163779,CSE 293,003,119122,Berg-Kirkpatrick; Taylor D,9999,0,9999,0
1668005163779,CSE 293,004,119135,Christensen; Henrik I,9999,0,9999,0
1668005163779,CSE 293,005,119142,Cottrell; Garrison W,9999,0,9999,0
1668005163779,CSE 293,006,119146,Deutsch; Alin Bernard,9999,0,9999,0
1668005163779,CSE 293,007,119159,Esmaeilzadeh; Hadi,9999,0,9999,0
1668005163779,CSE 293,008,119166,Freund; Yoav,9999,0,9999,0
1668005163779,CSE 293,009,119170,Griswold; William G.,9999,0,9999,0
1668005163779,CSE 293,010,119183,Gymrek; Melissa Ann,9999,0,9999,0
1668005163779,CSE 293,011,119190,Heninger; Nadia A,9999,0,9999,0
1668005163779,CSE 293,012,119230,Impagliazzo; Russell,9999,0,9999,0
1668005163779,CSE 293,013,119232,Jhala; Ranjit,9999,0,9999,0
1668005163779,CSE 293,014,119233,Kahng; Andrew Byun,9999,0,9999,0
1668005163779,CSE 293,015,119298,Kane; Daniel Mertz,9999,0,9999,0
1668005163779,CSE 293,016,119299,Kriegman; David J,9999,0,9999,0
1668005163779,CSE 293,017,119300,Kumar; Arun Kumar,9999,0,9999,0
1668005163779,CSE 293,018,119301,Lerner; Sorin,9999,0,9999,0
1668005163779,CSE 293,019,119302,Lovett; Shachar,9999,0,9999,0
1668005163779,CSE 293,020,119303,McAuley; Julian John,9999,0,9999,0
1668005163779,CSE 293,021,119304,Micciancio; Daniele,9999,0,9999,0
1668005163779,CSE 293,022,119367,Orailoglu; Alex,9999,0,9999,0
1668005163779,CSE 293,023,119382,Paturi; Ramamohan,9999,0,9999,0
1668005163779,CSE 293,024,119404,Polikarpova; Nadezhda,9999,0,9999,0
1668005163779,CSE 293,025,119406,Politz; Joseph Gibbs,9999,0,9999,0
1668005163779,CSE 293,026,119411,Porter; George M,9999,0,9999,0
1668005163779,CSE 293,027,119414,Porter; Leonard Emerson,9999,0,9999,0
1668005163779,CSE 293,028,119416,Ramamoorthi; Ravi,9999,0,9999,0
1668005163779,CSE 293,029,119417,Sahoo; Debashis,9999,0,9999,0
1668005163779,CSE 293,030,119420,Saul; Lawrence,9999,0,9999,0
1668005163779,CSE 293,031,119421,Savage; Stefan,9999,0,9999,0
1668005163779,CSE 293,032,119425,Schulze; Jurgen P.,9999,0,9999,0
1668005163779,CSE 293,033,119426,Snoeren; Alex C.,9999,0,9999,0
1668005163779,CSE 293,034,119428,Shang; Jingbo,9999,0,9999,0
1668005163779,CSE 293,035,119430,Stefan; Deian,9999,0,9999,0
1668005163779,CSE 293,036,119431,Su; Hao,9999,0,9999,0
1668005163779,CSE 293,037,119433,Swanson; Steven James,9999,0,9999,0
1668005163779,CSE 293,038,119435,Tullsen; Dean Michael,9999,0,9999,0
1668005163779,CSE 293,039,119483,Voelker; Geoffrey M.,9999,0,9999,0
1668005163779,CSE 293,040,119537,Zhao; Jishen,9999,0,9999,0
1668005163779,CSE 293,041,119538,Zhou; Yuan-Yuan,9999,0,9999,0
1668005163779,CSE 293,042,119539,Gao; Sicun,9999,0,9999,0
1668005163779,CSE 293,043,119540,Weibel; Nadir,9999,0,9999,0
1668005163779,CSE 293,044,119541,Gupta; Rajesh K.,9999,0,9999,0
1668005163779,CSE 293,045,126410,Vaccaro; Kristen Marie,9999,0,9999,0
1668005163779,CSE 293,046,126411,Klemke; Richard,9999,0,9999,0
1668005164206,CSE 294,A00,102459,Voelker; Geoffrey M.,0,0,0,0
1668005164206,CSE 294,B00,111322,Orailoglu; Alex,0,0,0,0
1668005164635,DSE 201,A00,096914,Deutsch; Alin Bernard,30,0,30,0
1668005165059,DSE 210,A00,096915,Dasgupta; Sanjoy,30,0,30,0
1668005165486,DSE 260A,A00,096916,Altintas De Callaf; Ilkay,30,0,30,0
1668005165922,ECE 200,001,103586,Antipa; Nicholas A,9999,0,9999,0
1668005165922,ECE 200,002,103587,Atanasov; Nikolay A.,9999,0,9999,0
1668005165922,ECE 200,003,103588,Bharadia; Dinesh,9999,0,9999,0
1668005165922,ECE 200,004,103589,Cheng; Chung Kuan,9999,0,9999,0
1668005165922,ECE 200,005,103590,Cosman; Pamela C.,9999,0,9999,0
1668005165922,ECE 200,006,103591,Dayeh; Shadi Ahmad,9999,0,9999,0
1668005165922,ECE 200,007,103592,Fainman; Yeshaiahu,9999,0,9999,0
1668005165922,ECE 200,008,103593,Ford; Joseph Earl,9999,0,9999,0
1668005165922,ECE 200,009,103594,Franceschetti; Massimo,9999,0,9999,0
1668005165922,ECE 200,010,103595,Fullerton; Eric E,9999,0,9999,0
1668005165922,ECE 200,011,103596,Galton; Ian A,9999,0,9999,0
1668005165922,ECE 200,012,103597,Gilja; Vikash,9999,0,9999,0
1668005165922,ECE 200,013,103598,Hall; Drew A.,9999,0,9999,0
1668005165922,ECE 200,014,103599,Hsueh; Tzu-Chien,9999,0,9999,0
1668005165922,ECE 200,015,103600,Javidi; Tara,9999,0,9999,0
1668005165922,ECE 200,016,103601,Kahng; Andrew Byun,9999,0,9999,0
1668005165922,ECE 200,017,103602,Kim; Young-Han,9999,0,9999,0
1668005165922,ECE 200,018,103603,Koushanfar; Farinaz,9999,0,9999,0
1668005165922,ECE 200,019,103604,Kuzum; Duygu,9999,0,9999,0
1668005165922,ECE 200,020,103605,Le; Hanh-Phuc,9999,0,9999,0
1668005165922,ECE 200,021,103606,Lin; Bill,9999,0,9999,0
1668005165922,ECE 200,022,103607,Liu; Zhaowei,9998,0,9999,1
1668005165922,ECE 200,023,103608,Lo; Yu-Hwa,9999,0,9999,0
1668005165922,ECE 200,024,103609,Lomakin; Vitaliy,9999,0,9999,0
1668005165922,ECE 200,025,103610,Mercier; Patrick Philip,9999,0,9999,0
1668005165922,ECE 200,026,103611,Meyer; Florian,9999,0,9999,0
1668005165922,ECE 200,027,103612,Milstein; Laurence B.,9999,0,9999,0
1668005165922,ECE 200,028,103613,Mir Arabbaygi; Siavash,9999,0,9999,0
1668005165922,ECE 200,029,103614,Mookherjea; Shayan,9999,0,9999,0
1668005165922,ECE 200,030,103615,Morris; Karcher William,9999,0,9999,0
1668005165922,ECE 200,031,103616,Ng; Tse Nga,9999,0,9999,0
1668005165922,ECE 200,032,103617,Nguyen; Truong Quang,9999,0,9999,0
1668005165922,ECE 200,033,103618,Nomura; Kenji,9999,0,9999,0
1668005165922,ECE 200,034,103619,Orlitsky; Alon,9999,0,9999,0
1668005165922,ECE 200,035,103620,Pal; Piya,9999,0,9999,0
1668005165922,ECE 200,036,103621,Papen; George C.,9999,0,9999,0
1668005165922,ECE 200,037,103622,Radic; Stojan,9999,0,9999,0
1668005165922,ECE 200,038,103623,Rao; Bhaskar D.,9999,0,9999,0
1668005165922,ECE 200,039,103624,Rao; Ramesh R,9999,0,9999,0
1668005165922,ECE 200,040,103625,Rebeiz; Gabriel,9999,0,9999,0
1668005165922,ECE 200,041,103626,Sanford; John R,9999,0,9999,0
1668005165922,ECE 200,042,103627,Siegel; Paul H.,9999,0,9999,0
1668005165922,ECE 200,043,103628,Sievenpiper; Daniel F.,9999,0,9999,0
1668005165922,ECE 200,044,103629,Sworder; David D.,9999,0,9999,0
1668005165922,ECE 200,045,103630,Taur; Yuan,9999,0,9999,0
1668005165922,ECE 200,046,103631,Touri; Behrouz,9999,0,9999,0
1668005165922,ECE 200,047,103632,Trivedi; Mohan M.,9999,0,9999,0
1668005165922,ECE 200,048,103633,Vasconcelos; Nuno,9999,0,9999,0
1668005165922,ECE 200,049,103634,Wang; Xiaolong,9999,0,9999,0
1668005165922,ECE 200,050,103635,Xie; Pengtao,9999,0,9999,0
1668005165922,ECE 200,051,103636,Yip; Michael,9999,0,9999,0
1668005165922,ECE 200,052,103637,Zeger; Kenneth A.,999,0,999,0
1668005165922,ECE 200,053,103638,Zhang; Xinyu,9999,0,9999,0
1668005165922,ECE 200,054,103639,Turakhia; Yatish Girish,9999,0,9999,0
1668005165922,ECE 200,055,103640,Kang; Mingu,9999,0,9999,0
1668005165922,ECE 200,056,103641,Shi; Yuanyuan,9999,0,9999,0
1668005165922,ECE 200,057,103642,Wang; Edward Jay,9999,0,9999,0
1668005165922,ECE 200,058,103643,Zheng; Yang,9999,0,9999,0
1668005166351,ECE 202,A00,103644,Kuzum; Duygu,0,0,0,0
1668005166778,ECE 212BN,A00,103646,Ng; Tse Nga,0,0,0,0
1668005167206,ECE 221,A00,111493,Staff,0,0,0,0
1668005167653,ECE 222B,A00,103647,Lomakin; Vitaliy,0,0,0,0
1668005168077,ECE 230B,A00,103648,Taur; Yuan,0,0,0,0
1668005168498,ECE 238B,A00,103649,Garay; Javier,0,0,0,0
1668005168921,ECE 240B,A00,112900,Fainman; Yeshaiahu,0,0,0,0
1668005169349,ECE 247A,A00,103650,Jokerst; Jesse Vincent,0,0,0,0
1668005169771,ECE 247B,A00,103651,Wang; Joseph,0,0,0,0
1668005170197,ECE 250,A00,103652,Siegel; Paul H.,0,0,0,0
1668005170621,ECE 251A,A00,103654,Rao; Bhaskar D.,0,0,0,0
1668005171044,ECE 257B,A00,103655,Bharadia; Dinesh,0,0,0,0
1668005171466,ECE 258A,A00,103656,Milstein; Laurence B.,0,0,0,0
1668005171906,ECE 260B,A00,103658,Kang; Mingu,0,0,0,0
1668005172332,ECE 264A,A00,103659,Galton; Ian A,0,0,0,0
1668005172755,ECE 265A,A00,103661,Gudem; Prasad S.S.,0,0,0,0
1668005173177,ECE 265D,A00,103662,Gudem; Prasad S.S.,0,0,0,0
1668005173616,ECE 268,A00,103663,Koushanfar; Farinaz,0,0,0,0
1668005174045,ECE 269,A01,103665,Pal; Piya,0,0,0,0
1668005174468,ECE 271B,A00,103666,Vasconcelos; Manuela,0,0,0,0
1668005174903,ECE 276A,A00,103667,Atanasov; Nikolay A.,0,0,0,0
1668005175326,ECE 277,A00,103668,An; Cheolhong,0,0,0,0
1668005175747,ECE 279,A00,117947,Hall; Drew A.,0,0,0,0
1668005176595,ECE 283,A00,103670,Hsueh; Tzu-Chien,0,0,0,0
1668005177021,ECE 284,A00,103671,Turakhia; Yatish Girish,0,0,0,0
1668005177444,ECE 285,A00,103672,Zheng; Yang,0,0,0,0
1668005177444,ECE 285,B00,103673,Sworder; David D.,0,0,0,0
1668005177869,ECE 287,A00,103676,Javidi; Tara,0,0,0,0
1668005178294,MATH 200B,A00,098023,Salehi Golsefidy; Alireza,14,0,15,1
1668005178715,MATH 202B,A00,098024,Rhoades; Brendon Patrick,12,0,15,3
1668005179142,MATH 203B,A00,098025,Oprea; Dragos N.,12,0,15,3
1668005179567,MATH 204B,A00,098026,Sorensen; Claus M,14,0,15,1
1668005179989,MATH 208,A00,098027,Izadi; Elham,7,0,10,3
1668005180413,MATH 209,A00,098028,Pollack; Aaron,10,0,10,0
1668005180841,MATH 211A,A00,112919,Rogalski; Daniel,9,0,10,1
1668005181273,MATH 211B,A00,112920,Seward; Brandon M.,9,0,10,1
1668005181710,MATH 218,A00,098029,Li; Bo,10,0,10,0
1668005182145,MATH 220B,A00,098030,Novak; Jonathan I,13,0,15,2
1668005182576,MATH 221A,A00,098031,Ebenfelt; Peter F,13,0,15,2
1668005183000,MATH 231B,A00,098032,Zlatos; Andrej,12,0,15,3
1668005183426,MATH 240B,A00,098033,Ni; Lei,10,0,15,5
1668005183848,MATH 243,A00,098034,Jekel; David Andrew,10,0,10,0
1668005184275,MATH 245A,A00,098035,Nie; Jiawang,0,0,15,16
1668005184697,MATH 248,A00,098036,Bejenaru; Ioan,10,0,10,0
1668005185121,MATH 250B,A00,098037,Spolaor; Luca,14,0,15,1
1668005185543,MATH 258,A00,098038,Ni; Lei,10,0,10,0
1668005185976,MATH 264B,A00,098041,Rhoades; Brendon Patrick,11,0,15,4
1668005186403,MATH 268,A00,098042,Buss; Samuel R,10,0,10,0
1668005186828,MATH 269,A00,098043,Rhoades; Brendon Patrick,10,0,10,0
1668005187250,MATH 270B,A00,098044,Li; Bo,11,0,15,4
1668005187677,MATH 272B,A00,098045,Holst; Michael J,13,0,15,2
1668005188099,MATH 273A,A00,098046,Tian; Xiaochuan,12,0,15,3
1668005188538,MATH 275,A01,098048,Tian; Xiaochuan,6,0,10,4
1668005188971,MATH 278A,A00,098049,Holst; Michael J,8,0,10,2
1668005189406,MATH 278B,A00,098050,Cloninger; Alexander,10,0,10,0
1668005189839,MATH 278C,A00,098051,Nie; Jiawang,8,0,10,2
1668005190274,MATH 280B,A00,098052,Zheng; Tianyi,11,0,15,4
1668005190710,MATH 281B,A00,098053,Bradic; Jelena,4,0,15,11
1668005191145,MATH 282B,A00,098054,Arias-Castro; Ery,2,0,15,13
1668005191581,MATH 285,A00,098055,Fitzsimmons; Patrick J,0,0,15,17
1668005192017,MATH 287B,A00,098056,Arias-Castro; Ery,5,0,15,10
1668005192439,MATH 288,A00,098057,Agarwal; Pooja,9,0,10,1
1668005192439,MATH 288,B00,098058,Zhang; Danna,9,0,10,1
1668005192439,MATH 288,C00,098059,Williams; Ruth J,10,0,10,0
1668005192877,MATH 290B,A00,098060,Roberts; Justin Deritter,14,0,15,1
1668005193300,MATH 292,A00,098061,Belmont; Eva Kinoshita,10,0,10,0
1668005193725,MATH 295,A00,098062,Suk; Andrew Hoon,48,0,50,2
1668005194146,MATH 296,A00,098063,Novak; Jonathan I,20,0,20,0
1668005194569,MATH 297,001,098064,Gamst; Anthony Collins,9997,0,9999,2
1668005694405,COGS 205,A00,101395,Chiba; Andrea,19,0,20,1
1668005694831,COGS 210B,001,101404,Greene; Deanna Jacquelyn,9998,0,9999,1
1668005694831,COGS 210B,002,101417,Xia; Haijun,9999,0,9999,0
1668005694831,COGS 210B,003,101422,Nitz; Douglas A.,9999,0,9999,0
1668005694831,COGS 210B,004,101423,Hollan; James D.,9998,0,9999,1
1668005694831,COGS 210B,005,101424,Deak; Gedeon O.,9999,0,9999,0
1668005694831,COGS 210B,006,101425,Rossano; Federico,9999,0,9999,0
1668005695255,COGS 211B,A00,101427,Coulson; Seana M,9997,0,9999,2
1668005695680,COGS 220,A00,101428,Hollan; James D.,0,0,25,25
1668005696116,COGS 229,A00,101429,Dow; Steven P,18,0,25,7
1668005696545,COGS 230,A00,101430,Klemmer; Scott R,13,0,17,4
1668005696970,COGS 234,A00,101431,Xia; Haijun,7,0,25,18
1668005697403,COGS 260,A00,101432,Kiyonaga; Anastasia,20,0,25,5
1668005697403,COGS 260,B00,101433,Kirsh; David Joel,16,0,25,9
1668005697830,CSE 202,A00,102371,Impagliazzo; Russell,0,0,0,0
1668005698253,CSE 203B,A01,102373,Cheng; Chung Kuan,0,0,0,0
1668005698675,CSE 208,A00,102374,Micciancio; Daniele,0,0,0,0
1668005699101,CSE 209A,A00,112895,Impagliazzo; Russell,0,0,15,15
1668005699523,CSE 209B,A00,108005,Bellare; Mihir,0,0,0,0
1668005699950,CSE 210,A00,113163,Coblenz; Michael J,0,0,0,0
1668005700373,CSE 219,A00,106111,Dow; Steven P,0,0,20,20
1668005700795,CSE 221,A00,102376,Voelker; Geoffrey M.,0,0,0,0
1668005701219,CSE 224,A01,102378,Porter; George M,0,0,0,0
1668005701642,CSE 229A,A00,102379,Savage; Stefan,0,0,0,0
1668005702065,CSE 229C,A00,102380,Munyaka; Imani N. S.,0,0,0,0
1668005702490,CSE 232B,A00,102382,Deutsch; Alin Bernard,0,0,0,0
1668005702919,CSE 234,A01,112904,Kumar; Arun Kumar,0,0,0,0
1668005703347,CSE 237A,A00,102383,Rosing; Tajana Simunic,0,0,0,0
1668005703770,CSE 239A,A00,102384,Deutsch; Alin Bernard,0,0,0,0
1668005704194,CSE 239B,A00,102385,Polikarpova; Nadezhda,0,0,0,0
1668005704632,CSE 240A,A00,102386,Pannuto; Patrick William,0,0,0,0
1668005705058,CSE 240B,A00,102387,Zhao; Jishen,0,0,0,0
1668005705484,CSE 241A,A00,106406,Kang; Mingu,0,0,0,0
1668005705909,CSE 249B,A00,102388,Kahng; Andrew Byun,0,0,8,8
1668005706332,CSE 251B,A01,102392,Cottrell; Garrison W,0,0,0,0
1668005706332,CSE 251B,A02,102393,Cottrell; Garrison W,0,0,0,0
1668005706761,CSE 252B,A00,102394,Ochoa; Benjamin Lawrence,0,0,0,0
1668005707193,CSE 257,A01,102396,Gao; Sicun,0,0,0,0
1668005707619,CSE 272,A00,102397,Li; Tzumao,0,0,0,0
1668005708043,CSE 274,A00,111323,Chern; Albert Ren-Haur,0,0,0,0
1668005708467,CSE 282,A00,102398,Pevzner; Pavel Arkadjevich,0,0,0,0
1668005708893,CSE 284,A00,114175,Gymrek; Melissa Ann,0,0,0,0
1668005709316,CSE 290,A00,102399,Chandraker; Manmohan Krishna,0,0,0,0
1668005709316,CSE 290,B00,102400,Vaccaro; Kristen Marie,0,0,25,25
1668005709316,CSE 290,C00,102414,Pannuto; Patrick William,0,0,25,25
1668005709316,CSE 290,D00,102427,Pevzner; Pavel Arkadjevich,0,0,0,0
1668005709316,CSE 290,E00,102429,Zhao; Jishen,0,0,0,0
1668005709316,CSE 290,F00,102436,Tullsen; Dean Michael,0,0,0,0
1668005709316,CSE 290,G00,102440,Christensen; Henrik I,0,0,20,20
1668005709740,CSE 291,A00,102443,Su; Hao,0,0,0,0
1668005709740,CSE 291,B00,102448,Polikarpova; Nadezhda,0,0,0,0
1668005709740,CSE 291,C00,102453,Vaccaro; Kristen Marie,0,0,0,0
1668005709740,CSE 291,D00,111343,Savage; Stefan,0,0,0,0
1668005709740,CSE 291,E00,116474,Claffy; Kimberly Claire,0,0,0,0
1668005709740,CSE 291,F00,116479,Pasquale; Joseph,0,0,0,0
1668005710176,CSE 293,001,119111,Bafna; Vineet,9999,0,9999,0
1668005710176,CSE 293,002,119118,Bellare; Mihir,9999,0,9999,0
1668005710176,CSE 293,003,119122,Berg-Kirkpatrick; Taylor D,9999,0,9999,0
1668005710176,CSE 293,004,119135,Christensen; Henrik I,9999,0,9999,0
1668005710176,CSE 293,005,119142,Cottrell; Garrison W,9999,0,9999,0
1668005710176,CSE 293,006,119146,Deutsch; Alin Bernard,9999,0,9999,0
1668005710176,CSE 293,007,119159,Esmaeilzadeh; Hadi,9999,0,9999,0
1668005710176,CSE 293,008,119166,Freund; Yoav,9999,0,9999,0
1668005710176,CSE 293,009,119170,Griswold; William G.,9999,0,9999,0
1668005710176,CSE 293,010,119183,Gymrek; Melissa Ann,9999,0,9999,0
1668005710176,CSE 293,011,119190,Heninger; Nadia A,9999,0,9999,0
1668005710176,CSE 293,012,119230,Impagliazzo; Russell,9999,0,9999,0
1668005710176,CSE 293,013,119232,Jhala; Ranjit,9999,0,9999,0
1668005710176,CSE 293,014,119233,Kahng; Andrew Byun,9999,0,9999,0
1668005710176,CSE 293,015,119298,Kane; Daniel Mertz,9999,0,9999,0
1668005710176,CSE 293,016,119299,Kriegman; David J,9999,0,9999,0
1668005710176,CSE 293,017,119300,Kumar; Arun Kumar,9999,0,9999,0
1668005710176,CSE 293,018,119301,Lerner; Sorin,9999,0,9999,0
1668005710176,CSE 293,019,119302,Lovett; Shachar,9999,0,9999,0
1668005710176,CSE 293,020,119303,McAuley; Julian John,9999,0,9999,0
1668005710176,CSE 293,021,119304,Micciancio; Daniele,9999,0,9999,0
1668005710176,CSE 293,022,119367,Orailoglu; Alex,9999,0,9999,0
1668005710176,CSE 293,023,119382,Paturi; Ramamohan,9999,0,9999,0
1668005710176,CSE 293,024,119404,Polikarpova; Nadezhda,9999,0,9999,0
1668005710176,CSE 293,025,119406,Politz; Joseph Gibbs,9999,0,9999,0
1668005710176,CSE 293,026,119411,Porter; George M,9999,0,9999,0
1668005710176,CSE 293,027,119414,Porter; Leonard Emerson,9999,0,9999,0
1668005710176,CSE 293,028,119416,Ramamoorthi; Ravi,9999,0,9999,0
1668005710176,CSE 293,029,119417,Sahoo; Debashis,9999,0,9999,0
1668005710176,CSE 293,030,119420,Saul; Lawrence,9999,0,9999,0
1668005710176,CSE 293,031,119421,Savage; Stefan,9999,0,9999,0
1668005710176,CSE 293,032,119425,Schulze; Jurgen P.,9999,0,9999,0
1668005710176,CSE 293,033,119426,Snoeren; Alex C.,9999,0,9999,0
1668005710176,CSE 293,034,119428,Shang; Jingbo,9999,0,9999,0
1668005710176,CSE 293,035,119430,Stefan; Deian,9999,0,9999,0
1668005710176,CSE 293,036,119431,Su; Hao,9999,0,9999,0
1668005710176,CSE 293,037,119433,Swanson; Steven James,9999,0,9999,0
1668005710176,CSE 293,038,119435,Tullsen; Dean Michael,9999,0,9999,0
1668005710176,CSE 293,039,119483,Voelker; Geoffrey M.,9999,0,9999,0
1668005710176,CSE 293,040,119537,Zhao; Jishen,9999,0,9999,0
1668005710176,CSE 293,041,119538,Zhou; Yuan-Yuan,9999,0,9999,0
1668005710176,CSE 293,042,119539,Gao; Sicun,9999,0,9999,0
1668005710176,CSE 293,043,119540,Weibel; Nadir,9999,0,9999,0
1668005710176,CSE 293,044,119541,Gupta; Rajesh K.,9999,0,9999,0
1668005710176,CSE 293,045,126410,Vaccaro; Kristen Marie,9999,0,9999,0
1668005710176,CSE 293,046,126411,Klemke; Richard,9999,0,9999,0
1668005710606,CSE 294,A00,102459,Voelker; Geoffrey M.,0,0,0,0
1668005710606,CSE 294,B00,111322,Orailoglu; Alex,0,0,0,0
1668005711043,DSE 201,A00,096914,Deutsch; Alin Bernard,30,0,30,0
1668005711474,DSE 210,A00,096915,Dasgupta; Sanjoy,30,0,30,0
1668005711902,DSE 260A,A00,096916,Altintas De Callaf; Ilkay,30,0,30,0
1668005712369,ECE 200,001,103586,Antipa; Nicholas A,9999,0,9999,0
1668005712369,ECE 200,002,103587,Atanasov; Nikolay A.,9999,0,9999,0
1668005712369,ECE 200,003,103588,Bharadia; Dinesh,9999,0,9999,0
1668005712369,ECE 200,004,103589,Cheng; Chung Kuan,9999,0,9999,0
1668005712369,ECE 200,005,103590,Cosman; Pamela C.,9999,0,9999,0
1668005712369,ECE 200,006,103591,Dayeh; Shadi Ahmad,9999,0,9999,0
1668005712369,ECE 200,007,103592,Fainman; Yeshaiahu,9999,0,9999,0
1668005712369,ECE 200,008,103593,Ford; Joseph Earl,9999,0,9999,0
1668005712369,ECE 200,009,103594,Franceschetti; Massimo,9999,0,9999,0
1668005712369,ECE 200,010,103595,Fullerton; Eric E,9999,0,9999,0
1668005712369,ECE 200,011,103596,Galton; Ian A,9999,0,9999,0
1668005712369,ECE 200,012,103597,Gilja; Vikash,9999,0,9999,0
1668005712369,ECE 200,013,103598,Hall; Drew A.,9999,0,9999,0
1668005712369,ECE 200,014,103599,Hsueh; Tzu-Chien,9999,0,9999,0
1668005712369,ECE 200,015,103600,Javidi; Tara,9999,0,9999,0
1668005712369,ECE 200,016,103601,Kahng; Andrew Byun,9999,0,9999,0
1668005712369,ECE 200,017,103602,Kim; Young-Han,9999,0,9999,0
1668005712369,ECE 200,018,103603,Koushanfar; Farinaz,9999,0,9999,0
1668005712369,ECE 200,019,103604,Kuzum; Duygu,9999,0,9999,0
1668005712369,ECE 200,020,103605,Le; Hanh-Phuc,9999,0,9999,0
1668005712369,ECE 200,021,103606,Lin; Bill,9999,0,9999,0
1668005712369,ECE 200,022,103607,Liu; Zhaowei,9998,0,9999,1
1668005712369,ECE 200,023,103608,Lo; Yu-Hwa,9999,0,9999,0
1668005712369,ECE 200,024,103609,Lomakin; Vitaliy,9999,0,9999,0
1668005712369,ECE 200,025,103610,Mercier; Patrick Philip,9999,0,9999,0
1668005712369,ECE 200,026,103611,Meyer; Florian,9999,0,9999,0
1668005712369,ECE 200,027,103612,Milstein; Laurence B.,9999,0,9999,0
1668005712369,ECE 200,028,103613,Mir Arabbaygi; Siavash,9999,0,9999,0
1668005712369,ECE 200,029,103614,Mookherjea; Shayan,9999,0,9999,0
1668005712369,ECE 200,030,103615,Morris; Karcher William,9999,0,9999,0
1668005712369,ECE 200,031,103616,Ng; Tse Nga,9999,0,9999,0
1668005712369,ECE 200,032,103617,Nguyen; Truong Quang,9999,0,9999,0
1668005712369,ECE 200,033,103618,Nomura; Kenji,9999,0,9999,0
1668005712369,ECE 200,034,103619,Orlitsky; Alon,9999,0,9999,0
1668005712369,ECE 200,035,103620,Pal; Piya,9999,0,9999,0
1668005712369,ECE 200,036,103621,Papen; George C.,9999,0,9999,0
1668005712369,ECE 200,037,103622,Radic; Stojan,9999,0,9999,0
1668005712369,ECE 200,038,103623,Rao; Bhaskar D.,9999,0,9999,0
1668005712369,ECE 200,039,103624,Rao; Ramesh R,9999,0,9999,0
1668005712369,ECE 200,040,103625,Rebeiz; Gabriel,9999,0,9999,0
1668005712369,ECE 200,041,103626,Sanford; John R,9999,0,9999,0
1668005712369,ECE 200,042,103627,Siegel; Paul H.,9999,0,9999,0
1668005712369,ECE 200,043,103628,Sievenpiper; Daniel F.,9999,0,9999,0
1668005712369,ECE 200,044,103629,Sworder; David D.,9999,0,9999,0
1668005712369,ECE 200,045,103630,Taur; Yuan,9999,0,9999,0
1668005712369,ECE 200,046,103631,Touri; Behrouz,9999,0,9999,0
1668005712369,ECE 200,047,103632,Trivedi; Mohan M.,9999,0,9999,0
1668005712369,ECE 200,048,103633,Vasconcelos; Nuno,9999,0,9999,0
1668005712369,ECE 200,049,103634,Wang; Xiaolong,9999,0,9999,0
1668005712369,ECE 200,050,103635,Xie; Pengtao,9999,0,9999,0
1668005712369,ECE 200,051,103636,Yip; Michael,9999,0,9999,0
1668005712369,ECE 200,052,103637,Zeger; Kenneth A.,999,0,999,0
1668005712369,ECE 200,053,103638,Zhang; Xinyu,9999,0,9999,0
1668005712369,ECE 200,054,103639,Turakhia; Yatish Girish,9999,0,9999,0
1668005712369,ECE 200,055,103640,Kang; Mingu,9999,0,9999,0
1668005712369,ECE 200,056,103641,Shi; Yuanyuan,9999,0,9999,0
1668005712369,ECE 200,057,103642,Wang; Edward Jay,9999,0,9999,0
1668005712369,ECE 200,058,103643,Zheng; Yang,9999,0,9999,0
1668005712791,ECE 202,A00,103644,Kuzum; Duygu,0,0,0,0
1668005713214,ECE 212BN,A00,103646,Ng; Tse Nga,0,0,0,0
1668005713641,ECE 221,A00,111493,Staff,0,0,0,0
1668005714065,ECE 222B,A00,103647,Lomakin; Vitaliy,0,0,0,0
1668005714492,ECE 230B,A00,103648,Taur; Yuan,0,0,0,0
1668005714916,ECE 238B,A00,103649,Garay; Javier,0,0,0,0
1668005715341,ECE 240B,A00,112900,Fainman; Yeshaiahu,0,0,0,0
1668005715762,ECE 247A,A00,103650,Jokerst; Jesse Vincent,0,0,0,0
1668005716185,ECE 247B,A00,103651,Wang; Joseph,0,0,0,0
1668005716608,ECE 250,A00,103652,Siegel; Paul H.,0,0,0,0
1668005717034,ECE 251A,A00,103654,Rao; Bhaskar D.,0,0,0,0
1668005717462,ECE 257B,A00,103655,Bharadia; Dinesh,0,0,0,0
1668005717886,ECE 258A,A00,103656,Milstein; Laurence B.,0,0,0,0
1668005718313,ECE 260B,A00,103658,Kang; Mingu,0,0,0,0
1668005718738,ECE 264A,A00,103659,Galton; Ian A,0,0,0,0
1668005719163,ECE 265A,A00,103661,Gudem; Prasad S.S.,0,0,0,0
1668005719586,ECE 265D,A00,103662,Gudem; Prasad S.S.,0,0,0,0
1668005720009,ECE 268,A00,103663,Koushanfar; Farinaz,0,0,0,0
1668005720441,ECE 269,A01,103665,Pal; Piya,0,0,0,0
1668005720869,ECE 271B,A00,103666,Vasconcelos; Manuela,0,0,0,0
1668005721501,ECE 276A,A00,103667,Atanasov; Nikolay A.,0,0,0,0
1668005721925,ECE 277,A00,103668,An; Cheolhong,0,0,0,0
1668005722347,ECE 279,A00,117947,Hall; Drew A.,0,0,0,0
1668005723200,ECE 283,A00,103670,Hsueh; Tzu-Chien,0,0,0,0
1668005723634,ECE 284,A00,103671,Turakhia; Yatish Girish,0,0,0,0
1668005724059,ECE 285,A00,103672,Zheng; Yang,0,0,0,0
1668005724059,ECE 285,B00,103673,Sworder; David D.,0,0,0,0
1668005724482,ECE 287,A00,103676,Javidi; Tara,0,0,0,0
1668005724908,MATH 200B,A00,098023,Salehi Golsefidy; Alireza,14,0,15,1
1668005725331,MATH 202B,A00,098024,Rhoades; Brendon Patrick,12,0,15,3
1668005725755,MATH 203B,A00,098025,Oprea; Dragos N.,12,0,15,3
1668005726180,MATH 204B,A00,098026,Sorensen; Claus M,14,0,15,1
1668005726605,MATH 208,A00,098027,Izadi; Elham,7,0,10,3
1668005727043,MATH 209,A00,098028,Pollack; Aaron,10,0,10,0
1668005727475,MATH 211A,A00,112919,Rogalski; Daniel,9,0,10,1
1668005727900,MATH 211B,A00,112920,Seward; Brandon M.,9,0,10,1
1668005728323,MATH 218,A00,098029,Li; Bo,10,0,10,0
1668005728749,MATH 220B,A00,098030,Novak; Jonathan I,13,0,15,2
1668005729172,MATH 221A,A00,098031,Ebenfelt; Peter F,13,0,15,2
1668005729594,MATH 231B,A00,098032,Zlatos; Andrej,12,0,15,3
1668005730029,MATH 240B,A00,098033,Ni; Lei,10,0,15,5
1668005730452,MATH 243,A00,098034,Jekel; David Andrew,10,0,10,0
1668005730877,MATH 245A,A00,098035,Nie; Jiawang,0,0,15,16
1668005731300,MATH 248,A00,098036,Bejenaru; Ioan,10,0,10,0
1668005731726,MATH 250B,A00,098037,Spolaor; Luca,14,0,15,1
1668005732152,MATH 258,A00,098038,Ni; Lei,10,0,10,0
1668005732575,MATH 264B,A00,098041,Rhoades; Brendon Patrick,11,0,15,4
1668005733001,MATH 268,A00,098042,Buss; Samuel R,10,0,10,0
1668005733428,MATH 269,A00,098043,Rhoades; Brendon Patrick,10,0,10,0
1668005733852,MATH 270B,A00,098044,Li; Bo,11,0,15,4
1668005734293,MATH 272B,A00,098045,Holst; Michael J,13,0,15,2
1668005734723,MATH 273A,A00,098046,Tian; Xiaochuan,12,0,15,3
1668005735148,MATH 275,A01,098048,Tian; Xiaochuan,6,0,10,4
1668005735573,MATH 278A,A00,098049,Holst; Michael J,8,0,10,2
1668005736002,MATH 278B,A00,098050,Cloninger; Alexander,10,0,10,0
1668005736428,MATH 278C,A00,098051,Nie; Jiawang,8,0,10,2
1668005736850,MATH 280B,A00,098052,Zheng; Tianyi,11,0,15,4
1668005737275,MATH 281B,A00,098053,Bradic; Jelena,4,0,15,11
1668005737701,MATH 282B,A00,098054,Arias-Castro; Ery,2,0,15,13
1668005738124,MATH 285,A00,098055,Fitzsimmons; Patrick J,0,0,15,17
1668005738552,MATH 287B,A00,098056,Arias-Castro; Ery,5,0,15,10
1668005738976,MATH 288,A00,098057,Agarwal; Pooja,9,0,10,1
1668005738976,MATH 288,B00,098058,Zhang; Danna,9,0,10,1
1668005738976,MATH 288,C00,098059,Williams; Ruth J,10,0,10,0
1668005739400,MATH 290B,A00,098060,Roberts; Justin Deritter,14,0,15,1
1668005739821,MATH 292,A00,098061,Belmont; Eva Kinoshita,10,0,10,0
1668005740244,MATH 295,A00,098062,Suk; Andrew Hoon,48,0,50,2
1668005740667,MATH 296,A00,098063,Novak; Jonathan I,20,0,20,0
1668005741096,MATH 297,001,098064,Gamst; Anthony Collins,9997,0,9999,2
1668006247464,COGS 205,A00,101395,Chiba; Andrea,19,0,20,1
1668006247982,COGS 210B,001,101404,Greene; Deanna Jacquelyn,9998,0,9999,1
1668006247982,COGS 210B,002,101417,Xia; Haijun,9999,0,9999,0
1668006247982,COGS 210B,003,101422,Nitz; Douglas A.,9999,0,9999,0
1668006247982,COGS 210B,004,101423,Hollan; James D.,9998,0,9999,1
1668006247982,COGS 210B,005,101424,Deak; Gedeon O.,9999,0,9999,0
1668006247982,COGS 210B,006,101425,Rossano; Federico,9999,0,9999,0
1668006248403,COGS 211B,A00,101427,Coulson; Seana M,9997,0,9999,2
1668006248828,COGS 220,A00,101428,Hollan; James D.,0,0,25,25
1668006249254,COGS 229,A00,101429,Dow; Steven P,18,0,25,7
1668006249675,COGS 230,A00,101430,Klemmer; Scott R,13,0,17,4
1668006250106,COGS 234,A00,101431,Xia; Haijun,7,0,25,18
1668006250546,COGS 260,A00,101432,Kiyonaga; Anastasia,20,0,25,5
1668006250546,COGS 260,B00,101433,Kirsh; David Joel,16,0,25,9
1668006250970,CSE 202,A00,102371,Impagliazzo; Russell,0,0,0,0
1668006251410,CSE 203B,A01,102373,Cheng; Chung Kuan,0,0,0,0
1668006251831,CSE 208,A00,102374,Micciancio; Daniele,0,0,0,0
1668006252267,CSE 209A,A00,112895,Impagliazzo; Russell,0,0,15,15
1668006252690,CSE 209B,A00,108005,Bellare; Mihir,0,0,0,0
1668006253125,CSE 210,A00,113163,Coblenz; Michael J,0,0,0,0
1668006253546,CSE 219,A00,106111,Dow; Steven P,0,0,20,20
1668006253970,CSE 221,A00,102376,Voelker; Geoffrey M.,0,0,0,0
1668006254392,CSE 224,A01,102378,Porter; George M,0,0,0,0
1668006254816,CSE 229A,A00,102379,Savage; Stefan,0,0,0,0
1668006255240,CSE 229C,A00,102380,Munyaka; Imani N. S.,0,0,0,0
1668006255664,CSE 232B,A00,102382,Deutsch; Alin Bernard,0,0,0,0
1668006256094,CSE 234,A01,112904,Kumar; Arun Kumar,0,0,0,0
1668006256517,CSE 237A,A00,102383,Rosing; Tajana Simunic,0,0,0,0
1668006256941,CSE 239A,A00,102384,Deutsch; Alin Bernard,0,0,0,0
1668006257367,CSE 239B,A00,102385,Polikarpova; Nadezhda,0,0,0,0
1668006257794,CSE 240A,A00,102386,Pannuto; Patrick William,0,0,0,0
1668006258229,CSE 240B,A00,102387,Zhao; Jishen,0,0,0,0
1668006258653,CSE 241A,A00,106406,Kang; Mingu,0,0,0,0
1668006259086,CSE 249B,A00,102388,Kahng; Andrew Byun,0,0,8,8
1668006259513,CSE 251B,A01,102392,Cottrell; Garrison W,0,0,0,0
1668006259513,CSE 251B,A02,102393,Cottrell; Garrison W,0,0,0,0
1668006259941,CSE 252B,A00,102394,Ochoa; Benjamin Lawrence,0,0,0,0
1668006260364,CSE 257,A01,102396,Gao; Sicun,0,0,0,0
1668006260790,CSE 272,A00,102397,Li; Tzumao,0,0,0,0
1668006261218,CSE 274,A00,111323,Chern; Albert Ren-Haur,0,0,0,0
1668006261720,CSE 282,A00,102398,Pevzner; Pavel Arkadjevich,0,0,0,0
1668006262151,CSE 284,A00,114175,Gymrek; Melissa Ann,0,0,0,0
1668006262582,CSE 290,A00,102399,Chandraker; Manmohan Krishna,0,0,0,0
1668006262582,CSE 290,B00,102400,Vaccaro; Kristen Marie,0,0,25,25
1668006262582,CSE 290,C00,102414,Pannuto; Patrick William,0,0,25,25
1668006262582,CSE 290,D00,102427,Pevzner; Pavel Arkadjevich,0,0,0,0
1668006262582,CSE 290,E00,102429,Zhao; Jishen,0,0,0,0
1668006262582,CSE 290,F00,102436,Tullsen; Dean Michael,0,0,0,0
1668006262582,CSE 290,G00,102440,Christensen; Henrik I,0,0,20,20
1668006263025,CSE 291,A00,102443,Su; Hao,0,0,0,0
1668006263025,CSE 291,B00,102448,Polikarpova; Nadezhda,0,0,0,0
1668006263025,CSE 291,C00,102453,Vaccaro; Kristen Marie,0,0,0,0
1668006263025,CSE 291,D00,111343,Savage; Stefan,0,0,0,0
1668006263025,CSE 291,E00,116474,Claffy; Kimberly Claire,0,0,0,0
1668006263025,CSE 291,F00,116479,Pasquale; Joseph,0,0,0,0
1668006263457,CSE 293,001,119111,Bafna; Vineet,9999,0,9999,0
1668006263457,CSE 293,002,119118,Bellare; Mihir,9999,0,9999,0
1668006263457,CSE 293,003,119122,Berg-Kirkpatrick; Taylor D,9999,0,9999,0
1668006263457,CSE 293,004,119135,Christensen; Henrik I,9999,0,9999,0
1668006263457,CSE 293,005,119142,Cottrell; Garrison W,9999,0,9999,0
1668006263457,CSE 293,006,119146,Deutsch; Alin Bernard,9999,0,9999,0
1668006263457,CSE 293,007,119159,Esmaeilzadeh; Hadi,9999,0,9999,0
1668006263457,CSE 293,008,119166,Freund; Yoav,9999,0,9999,0
1668006263457,CSE 293,009,119170,Griswold; William G.,9999,0,9999,0
1668006263457,CSE 293,010,119183,Gymrek; Melissa Ann,9999,0,9999,0
1668006263457,CSE 293,011,119190,Heninger; Nadia A,9999,0,9999,0
1668006263457,CSE 293,012,119230,Impagliazzo; Russell,9999,0,9999,0
1668006263457,CSE 293,013,119232,Jhala; Ranjit,9999,0,9999,0
1668006263457,CSE 293,014,119233,Kahng; Andrew Byun,9999,0,9999,0
1668006263457,CSE 293,015,119298,Kane; Daniel Mertz,9999,0,9999,0
1668006263457,CSE 293,016,119299,Kriegman; David J,9999,0,9999,0
1668006263457,CSE 293,017,119300,Kumar; Arun Kumar,9999,0,9999,0
1668006263457,CSE 293,018,119301,Lerner; Sorin,9999,0,9999,0
1668006263457,CSE 293,019,119302,Lovett; Shachar,9999,0,9999,0
1668006263457,CSE 293,020,119303,McAuley; Julian John,9999,0,9999,0
1668006263457,CSE 293,021,119304,Micciancio; Daniele,9999,0,9999,0
1668006263457,CSE 293,022,119367,Orailoglu; Alex,9999,0,9999,0
1668006263457,CSE 293,023,119382,Paturi; Ramamohan,9999,0,9999,0
1668006263457,CSE 293,024,119404,Polikarpova; Nadezhda,9999,0,9999,0
1668006263457,CSE 293,025,119406,Politz; Joseph Gibbs,9999,0,9999,0
1668006263457,CSE 293,026,119411,Porter; George M,9999,0,9999,0
1668006263457,CSE 293,027,119414,Porter; Leonard Emerson,9999,0,9999,0
1668006263457,CSE 293,028,119416,Ramamoorthi; Ravi,9999,0,9999,0
1668006263457,CSE 293,029,119417,Sahoo; Debashis,9999,0,9999,0
1668006263457,CSE 293,030,119420,Saul; Lawrence,9999,0,9999,0
1668006263457,CSE 293,031,119421,Savage; Stefan,9999,0,9999,0
1668006263457,CSE 293,032,119425,Schulze; Jurgen P.,9999,0,9999,0
1668006263457,CSE 293,033,119426,Snoeren; Alex C.,9999,0,9999,0
1668006263457,CSE 293,034,119428,Shang; Jingbo,9999,0,9999,0
1668006263457,CSE 293,035,119430,Stefan; Deian,9999,0,9999,0
1668006263457,CSE 293,036,119431,Su; Hao,9999,0,9999,0
1668006263457,CSE 293,037,119433,Swanson; Steven James,9999,0,9999,0
1668006263457,CSE 293,038,119435,Tullsen; Dean Michael,9999,0,9999,0
1668006263457,CSE 293,039,119483,Voelker; Geoffrey M.,9999,0,9999,0
1668006263457,CSE 293,040,119537,Zhao; Jishen,9999,0,9999,0
1668006263457,CSE 293,041,119538,Zhou; Yuan-Yuan,9999,0,9999,0
1668006263457,CSE 293,042,119539,Gao; Sicun,9999,0,9999,0
1668006263457,CSE 293,043,119540,Weibel; Nadir,9999,0,9999,0
1668006263457,CSE 293,044,119541,Gupta; Rajesh K.,9999,0,9999,0
1668006263457,CSE 293,045,126410,Vaccaro; Kristen Marie,9999,0,9999,0
1668006263457,CSE 293,046,126411,Klemke; Richard,9999,0,9999,0
1668006263882,CSE 294,A00,102459,Voelker; Geoffrey M.,0,0,0,0
1668006263882,CSE 294,B00,111322,Orailoglu; Alex,0,0,0,0
1668006264308,DSE 201,A00,096914,Deutsch; Alin Bernard,30,0,30,0
1668006264738,DSE 210,A00,096915,Dasgupta; Sanjoy,30,0,30,0
1668006265160,DSE 260A,A00,096916,Altintas De Callaf; Ilkay,30,0,30,0
1668006265601,ECE 200,001,103586,Antipa; Nicholas A,9999,0,9999,0
1668006265601,ECE 200,002,103587,Atanasov; Nikolay A.,9999,0,9999,0
1668006265601,ECE 200,003,103588,Bharadia; Dinesh,9999,0,9999,0
1668006265601,ECE 200,004,103589,Cheng; Chung Kuan,9999,0,9999,0
1668006265601,ECE 200,005,103590,Cosman; Pamela C.,9999,0,9999,0
1668006265601,ECE 200,006,103591,Dayeh; Shadi Ahmad,9999,0,9999,0
1668006265601,ECE 200,007,103592,Fainman; Yeshaiahu,9999,0,9999,0
1668006265601,ECE 200,008,103593,Ford; Joseph Earl,9999,0,9999,0
1668006265601,ECE 200,009,103594,Franceschetti; Massimo,9999,0,9999,0
1668006265601,ECE 200,010,103595,Fullerton; Eric E,9999,0,9999,0
1668006265601,ECE 200,011,103596,Galton; Ian A,9999,0,9999,0
1668006265601,ECE 200,012,103597,Gilja; Vikash,9999,0,9999,0
1668006265601,ECE 200,013,103598,Hall; Drew A.,9999,0,9999,0
1668006265601,ECE 200,014,103599,Hsueh; Tzu-Chien,9999,0,9999,0
1668006265601,ECE 200,015,103600,Javidi; Tara,9999,0,9999,0
1668006265601,ECE 200,016,103601,Kahng; Andrew Byun,9999,0,9999,0
1668006265601,ECE 200,017,103602,Kim; Young-Han,9999,0,9999,0
1668006265601,ECE 200,018,103603,Koushanfar; Farinaz,9999,0,9999,0
1668006265601,ECE 200,019,103604,Kuzum; Duygu,9999,0,9999,0
1668006265601,ECE 200,020,103605,Le; Hanh-Phuc,9999,0,9999,0
1668006265601,ECE 200,021,103606,Lin; Bill,9999,0,9999,0
1668006265601,ECE 200,022,103607,Liu; Zhaowei,9998,0,9999,1
1668006265601,ECE 200,023,103608,Lo; Yu-Hwa,9999,0,9999,0
1668006265601,ECE 200,024,103609,Lomakin; Vitaliy,9999,0,9999,0
1668006265601,ECE 200,025,103610,Mercier; Patrick Philip,9999,0,9999,0
1668006265601,ECE 200,026,103611,Meyer; Florian,9999,0,9999,0
1668006265601,ECE 200,027,103612,Milstein; Laurence B.,9999,0,9999,0
1668006265601,ECE 200,028,103613,Mir Arabbaygi; Siavash,9999,0,9999,0
1668006265601,ECE 200,029,103614,Mookherjea; Shayan,9999,0,9999,0
1668006265601,ECE 200,030,103615,Morris; Karcher William,9999,0,9999,0
1668006265601,ECE 200,031,103616,Ng; Tse Nga,9999,0,9999,0
1668006265601,ECE 200,032,103617,Nguyen; Truong Quang,9999,0,9999,0
1668006265601,ECE 200,033,103618,Nomura; Kenji,9999,0,9999,0
1668006265601,ECE 200,034,103619,Orlitsky; Alon,9999,0,9999,0
1668006265601,ECE 200,035,103620,Pal; Piya,9999,0,9999,0
1668006265601,ECE 200,036,103621,Papen; George C.,9999,0,9999,0
1668006265601,ECE 200,037,103622,Radic; Stojan,9999,0,9999,0
1668006265601,ECE 200,038,103623,Rao; Bhaskar D.,9999,0,9999,0
1668006265601,ECE 200,039,103624,Rao; Ramesh R,9999,0,9999,0
1668006265601,ECE 200,040,103625,Rebeiz; Gabriel,9999,0,9999,0
1668006265601,ECE 200,041,103626,Sanford; John R,9999,0,9999,0
1668006265601,ECE 200,042,103627,Siegel; Paul H.,9999,0,9999,0
1668006265601,ECE 200,043,103628,Sievenpiper; Daniel F.,9999,0,9999,0
1668006265601,ECE 200,044,103629,Sworder; David D.,9999,0,9999,0
1668006265601,ECE 200,045,103630,Taur; Yuan,9999,0,9999,0
1668006265601,ECE 200,046,103631,Touri; Behrouz,9999,0,9999,0
1668006265601,ECE 200,047,103632,Trivedi; Mohan M.,9999,0,9999,0
1668006265601,ECE 200,048,103633,Vasconcelos; Nuno,9999,0,9999,0
1668006265601,ECE 200,049,103634,Wang; Xiaolong,9999,0,9999,0
1668006265601,ECE 200,050,103635,Xie; Pengtao,9999,0,9999,0
1668006265601,ECE 200,051,103636,Yip; Michael,9999,0,9999,0
1668006265601,ECE 200,052,103637,Zeger; Kenneth A.,999,0,999,0
1668006265601,ECE 200,053,103638,Zhang; Xinyu,9999,0,9999,0
1668006265601,ECE 200,054,103639,Turakhia; Yatish Girish,9999,0,9999,0
1668006265601,ECE 200,055,103640,Kang; Mingu,9999,0,9999,0
1668006265601,ECE 200,056,103641,Shi; Yuanyuan,9999,0,9999,0
1668006265601,ECE 200,057,103642,Wang; Edward Jay,9999,0,9999,0
1668006265601,ECE 200,058,103643,Zheng; Yang,9999,0,9999,0
1668006266028,ECE 202,A00,103644,Kuzum; Duygu,0,0,0,0
1668006266449,ECE 212BN,A00,103646,Ng; Tse Nga,0,0,0,0
1668006266876,ECE 221,A00,111493,Staff,0,0,0,0
1668006267299,ECE 222B,A00,103647,Lomakin; Vitaliy,0,0,0,0
1668006267723,ECE 230B,A00,103648,Taur; Yuan,0,0,0,0
1668006268147,ECE 238B,A00,103649,Garay; Javier,0,0,0,0
1668006268576,ECE 240B,A00,112900,Fainman; Yeshaiahu,0,0,0,0
1668006268998,ECE 247A,A00,103650,Jokerst; Jesse Vincent,0,0,0,0
1668006269421,ECE 247B,A00,103651,Wang; Joseph,0,0,0,0
1668006269855,ECE 250,A00,103652,Siegel; Paul H.,0,0,0,0
1668006270279,ECE 251A,A00,103654,Rao; Bhaskar D.,0,0,0,0
1668006270704,ECE 257B,A00,103655,Bharadia; Dinesh,0,0,0,0
1668006271131,ECE 258A,A00,103656,Milstein; Laurence B.,0,0,0,0
1668006271554,ECE 260B,A00,103658,Kang; Mingu,0,0,0,0
1668006271988,ECE 264A,A00,103659,Galton; Ian A,0,0,0,0
1668006272413,ECE 265A,A00,103661,Gudem; Prasad S.S.,0,0,0,0
1668006272837,ECE 265D,A00,103662,Gudem; Prasad S.S.,0,0,0,0
1668006273259,ECE 268,A00,103663,Koushanfar; Farinaz,0,0,0,0
1668006273686,ECE 269,A01,103665,Pal; Piya,0,0,0,0
1668006274118,ECE 271B,A00,103666,Vasconcelos; Manuela,0,0,0,0
1668006274544,ECE 276A,A00,103667,Atanasov; Nikolay A.,0,0,0,0
1668006274968,ECE 277,A00,103668,An; Cheolhong,0,0,0,0
1668006275468,ECE 279,A00,117947,Hall; Drew A.,0,0,0,0
1668006276317,ECE 283,A00,103670,Hsueh; Tzu-Chien,0,0,0,0
1668006276743,ECE 284,A00,103671,Turakhia; Yatish Girish,0,0,0,0
1668006277170,ECE 285,A00,103672,Zheng; Yang,0,0,0,0
1668006277170,ECE 285,B00,103673,Sworder; David D.,0,0,0,0
1668006277598,ECE 287,A00,103676,Javidi; Tara,0,0,0,0
1668006278021,MATH 200B,A00,098023,Salehi Golsefidy; Alireza,14,0,15,1
1668006278444,MATH 202B,A00,098024,Rhoades; Brendon Patrick,12,0,15,3
1668006278869,MATH 203B,A00,098025,Oprea; Dragos N.,12,0,15,3
1668006279295,MATH 204B,A00,098026,Sorensen; Claus M,14,0,15,1
1668006279718,MATH 208,A00,098027,Izadi; Elham,7,0,10,3
1668006280156,MATH 209,A00,098028,Pollack; Aaron,10,0,10,0
1668006280591,MATH 211A,A00,112919,Rogalski; Daniel,9,0,10,1
1668006281016,MATH 211B,A00,112920,Seward; Brandon M.,9,0,10,1
1668006281437,MATH 218,A00,098029,Li; Bo,10,0,10,0
1668006281873,MATH 220B,A00,098030,Novak; Jonathan I,13,0,15,2
1668006282299,MATH 221A,A00,098031,Ebenfelt; Peter F,13,0,15,2
1668006282720,MATH 231B,A00,098032,Zlatos; Andrej,12,0,15,3
1668006283145,MATH 240B,A00,098033,Ni; Lei,10,0,15,5
1668006283573,MATH 243,A00,098034,Jekel; David Andrew,10,0,10,0
1668006283997,MATH 245A,A00,098035,Nie; Jiawang,0,0,15,16
1668006284425,MATH 248,A00,098036,Bejenaru; Ioan,10,0,10,0
1668006284850,MATH 250B,A00,098037,Spolaor; Luca,14,0,15,1
1668006285272,MATH 258,A00,098038,Ni; Lei,10,0,10,0
1668006285696,MATH 264B,A00,098041,Rhoades; Brendon Patrick,11,0,15,4
1668006286119,MATH 268,A00,098042,Buss; Samuel R,10,0,10,0
1668006286545,MATH 269,A00,098043,Rhoades; Brendon Patrick,10,0,10,0
1668006286966,MATH 270B,A00,098044,Li; Bo,11,0,15,4
1668006287390,MATH 272B,A00,098045,Holst; Michael J,13,0,15,2
1668006287813,MATH 273A,A00,098046,Tian; Xiaochuan,12,0,15,3
1668006288239,MATH 275,A01,098048,Tian; Xiaochuan,6,0,10,4
1668006288663,MATH 278A,A00,098049,Holst; Michael J,8,0,10,2
1668006289088,MATH 278B,A00,098050,Cloninger; Alexander,10,0,10,0
1668006289513,MATH 278C,A00,098051,Nie; Jiawang,8,0,10,2
1668006289936,MATH 280B,A00,098052,Zheng; Tianyi,11,0,15,4
1668006290359,MATH 281B,A00,098053,Bradic; Jelena,4,0,15,11
1668006290789,MATH 282B,A00,098054,Arias-Castro; Ery,2,0,15,13
1668006291298,MATH 285,A00,098055,Fitzsimmons; Patrick J,0,0,15,17
1668006291720,MATH 287B,A00,098056,Arias-Castro; Ery,5,0,15,10
1668006292145,MATH 288,A00,098057,Agarwal; Pooja,9,0,10,1
1668006292145,MATH 288,B00,098058,Zhang; Danna,9,0,10,1
1668006292145,MATH 288,C00,098059,Williams; Ruth J,10,0,10,0
1668006292570,MATH 290B,A00,098060,Roberts; Justin Deritter,14,0,15,1
1668006292996,MATH 292,A00,098061,Belmont; Eva Kinoshita,10,0,10,0
1668006293418,MATH 295,A00,098062,Suk; Andrew Hoon,48,0,50,2
1668006293840,MATH 296,A00,098063,Novak; Jonathan I,20,0,20,0
1668006294264,MATH 297,001,098064,Gamst; Anthony Collins,9997,0,9999,2
1668006795159,COGS 205,A00,101395,Chiba; Andrea,19,0,20,1
1668006795590,COGS 210B,001,101404,Greene; Deanna Jacquelyn,9998,0,9999,1
1668006795590,COGS 210B,002,101417,Xia; Haijun,9999,0,9999,0
1668006795590,COGS 210B,003,101422,Nitz; Douglas A.,9999,0,9999,0
1668006795590,COGS 210B,004,101423,Hollan; James D.,9998,0,9999,1
1668006795590,COGS 210B,005,101424,Deak; Gedeon O.,9999,0,9999,0
1668006795590,COGS 210B,006,101425,Rossano; Federico,9999,0,9999,0
1668006796018,COGS 211B,A00,101427,Coulson; Seana M,9997,0,9999,2
1668006796451,COGS 220,A00,101428,Hollan; James D.,0,0,25,25
1668006796878,COGS 229,A00,101429,Dow; Steven P,18,0,25,7
1668006797302,COGS 230,A00,101430,Klemmer; Scott R,13,0,17,4
1668006797726,COGS 234,A00,101431,Xia; Haijun,7,0,25,18
1668006798149,COGS 260,A00,101432,Kiyonaga; Anastasia,20,0,25,5
1668006798149,COGS 260,B00,101433,Kirsh; David Joel,16,0,25,9
1668006798571,CSE 202,A00,102371,Impagliazzo; Russell,0,0,0,0
1668006799003,CSE 203B,A01,102373,Cheng; Chung Kuan,0,0,0,0
1668006799434,CSE 208,A00,102374,Micciancio; Daniele,0,0,0,0
1668006799858,CSE 209A,A00,112895,Impagliazzo; Russell,0,0,15,15
1668006800294,CSE 209B,A00,108005,Bellare; Mihir,0,0,0,0
1668006800718,CSE 210,A00,113163,Coblenz; Michael J,0,0,0,0
1668006801143,CSE 219,A00,106111,Dow; Steven P,0,0,20,20
1668006801569,CSE 221,A00,102376,Voelker; Geoffrey M.,0,0,0,0
1668006802006,CSE 224,A01,102378,Porter; George M,0,0,0,0
1668006802428,CSE 229A,A00,102379,Savage; Stefan,0,0,0,0
1668006802858,CSE 229C,A00,102380,Munyaka; Imani N. S.,0,0,0,0
1668006803283,CSE 232B,A00,102382,Deutsch; Alin Bernard,0,0,0,0
1668006803706,CSE 234,A01,112904,Kumar; Arun Kumar,0,0,0,0
1668006804133,CSE 237A,A00,102383,Rosing; Tajana Simunic,0,0,0,0
1668006804556,CSE 239A,A00,102384,Deutsch; Alin Bernard,0,0,0,0
1668006804979,CSE 239B,A00,102385,Polikarpova; Nadezhda,0,0,0,0
1668006805404,CSE 240A,A00,102386,Pannuto; Patrick William,0,0,0,0
1668006805827,CSE 240B,A00,102387,Zhao; Jishen,0,0,0,0
1668006806265,CSE 241A,A00,106406,Kang; Mingu,0,0,0,0
1668006806686,CSE 249B,A00,102388,Kahng; Andrew Byun,0,0,8,8
1668006807130,CSE 251B,A01,102392,Cottrell; Garrison W,0,0,0,0
1668006807130,CSE 251B,A02,102393,Cottrell; Garrison W,0,0,0,0
1668006807555,CSE 252B,A00,102394,Ochoa; Benjamin Lawrence,0,0,0,0
1668006807983,CSE 257,A01,102396,Gao; Sicun,0,0,0,0
1668006808405,CSE 272,A00,102397,Li; Tzumao,0,0,0,0
1668006808839,CSE 274,A00,111323,Chern; Albert Ren-Haur,0,0,0,0
1668006809261,CSE 282,A00,102398,Pevzner; Pavel Arkadjevich,0,0,0,0
1668006809694,CSE 284,A00,114175,Gymrek; Melissa Ann,0,0,0,0
1668006810124,CSE 290,A00,102399,Chandraker; Manmohan Krishna,0,0,0,0
1668006810124,CSE 290,B00,102400,Vaccaro; Kristen Marie,0,0,25,25
1668006810124,CSE 290,C00,102414,Pannuto; Patrick William,0,0,25,25
1668006810124,CSE 290,D00,102427,Pevzner; Pavel Arkadjevich,0,0,0,0
1668006810124,CSE 290,E00,102429,Zhao; Jishen,0,0,0,0
1668006810124,CSE 290,F00,102436,Tullsen; Dean Michael,0,0,0,0
1668006810124,CSE 290,G00,102440,Christensen; Henrik I,0,0,20,20
1668006810546,CSE 291,A00,102443,Su; Hao,0,0,0,0
1668006810546,CSE 291,B00,102448,Polikarpova; Nadezhda,0,0,0,0
1668006810546,CSE 291,C00,102453,Vaccaro; Kristen Marie,0,0,0,0
1668006810546,CSE 291,D00,111343,Savage; Stefan,0,0,0,0
1668006810546,CSE 291,E00,116474,Claffy; Kimberly Claire,0,0,0,0
1668006810546,CSE 291,F00,116479,Pasquale; Joseph,0,0,0,0
1668006810984,CSE 293,001,119111,Bafna; Vineet,9999,0,9999,0
1668006810984,CSE 293,002,119118,Bellare; Mihir,9999,0,9999,0
1668006810984,CSE 293,003,119122,Berg-Kirkpatrick; Taylor D,9999,0,9999,0
1668006810984,CSE 293,004,119135,Christensen; Henrik I,9999,0,9999,0
1668006810984,CSE 293,005,119142,Cottrell; Garrison W,9999,0,9999,0
1668006810984,CSE 293,006,119146,Deutsch; Alin Bernard,9999,0,9999,0
1668006810984,CSE 293,007,119159,Esmaeilzadeh; Hadi,9999,0,9999,0
1668006810984,CSE 293,008,119166,Freund; Yoav,9999,0,9999,0
1668006810984,CSE 293,009,119170,Griswold; William G.,9999,0,9999,0
1668006810984,CSE 293,010,119183,Gymrek; Melissa Ann,9999,0,9999,0
1668006810984,CSE 293,011,119190,Heninger; Nadia A,9999,0,9999,0
1668006810984,CSE 293,012,119230,Impagliazzo; Russell,9999,0,9999,0
1668006810984,CSE 293,013,119232,Jhala; Ranjit,9999,0,9999,0
1668006810984,CSE 293,014,119233,Kahng; Andrew Byun,9999,0,9999,0
1668006810984,CSE 293,015,119298,Kane; Daniel Mertz,9999,0,9999,0
1668006810984,CSE 293,016,119299,Kriegman; David J,9999,0,9999,0
1668006810984,CSE 293,017,119300,Kumar; Arun Kumar,9999,0,9999,0
1668006810984,CSE 293,018,119301,Lerner; Sorin,9999,0,9999,0
1668006810984,CSE 293,019,119302,Lovett; Shachar,9999,0,9999,0
1668006810984,CSE 293,020,119303,McAuley; Julian John,9999,0,9999,0
1668006810984,CSE 293,021,119304,Micciancio; Daniele,9999,0,9999,0
1668006810984,CSE 293,022,119367,Orailoglu; Alex,9999,0,9999,0
1668006810984,CSE 293,023,119382,Paturi; Ramamohan,9999,0,9999,0
1668006810984,CSE 293,024,119404,Polikarpova; Nadezhda,9999,0,9999,0
1668006810984,CSE 293,025,119406,Politz; Joseph Gibbs,9999,0,9999,0
1668006810984,CSE 293,026,119411,Porter; George M,9999,0,9999,0
1668006810984,CSE 293,027,119414,Porter; Leonard Emerson,9999,0,9999,0
1668006810984,CSE 293,028,119416,Ramamoorthi; Ravi,9999,0,9999,0
1668006810984,CSE 293,029,119417,Sahoo; Debashis,9999,0,9999,0
1668006810984,CSE 293,030,119420,Saul; Lawrence,9999,0,9999,0
1668006810984,CSE 293,031,119421,Savage; Stefan,9999,0,9999,0
1668006810984,CSE 293,032,119425,Schulze; Jurgen P.,9999,0,9999,0
1668006810984,CSE 293,033,119426,Snoeren; Alex C.,9999,0,9999,0
1668006810984,CSE 293,034,119428,Shang; Jingbo,9999,0,9999,0
1668006810984,CSE 293,035,119430,Stefan; Deian,9999,0,9999,0
1668006810984,CSE 293,036,119431,Su; Hao,9999,0,9999,0
1668006810984,CSE 293,037,119433,Swanson; Steven James,9999,0,9999,0
1668006810984,CSE 293,038,119435,Tullsen; Dean Michael,9999,0,9999,0
1668006810984,CSE 293,039,119483,Voelker; Geoffrey M.,9999,0,9999,0
1668006810984,CSE 293,040,119537,Zhao; Jishen,9999,0,9999,0
1668006810984,CSE 293,041,119538,Zhou; Yuan-Yuan,9999,0,9999,0
1668006810984,CSE 293,042,119539,Gao; Sicun,9999,0,9999,0
1668006810984,CSE 293,043,119540,Weibel; Nadir,9999,0,9999,0
1668006810984,CSE 293,044,119541,Gupta; Rajesh K.,9999,0,9999,0
1668006810984,CSE 293,045,126410,Vaccaro; Kristen Marie,9999,0,9999,0
1668006810984,CSE 293,046,126411,Klemke; Richard,9999,0,9999,0
1668006811405,CSE 294,A00,102459,Voelker; Geoffrey M.,0,0,0,0
1668006811405,CSE 294,B00,111322,Orailoglu; Alex,0,0,0,0
1668006811833,DSE 201,A00,096914,Deutsch; Alin Bernard,30,0,30,0
1668006812334,DSE 210,A00,096915,Dasgupta; Sanjoy,30,0,30,0
1668006812756,DSE 260A,A00,096916,Altintas De Callaf; Ilkay,30,0,30,0
1668006813220,ECE 200,001,103586,Antipa; Nicholas A,9999,0,9999,0
1668006813220,ECE 200,002,103587,Atanasov; Nikolay A.,9999,0,9999,0
1668006813220,ECE 200,003,103588,Bharadia; Dinesh,9999,0,9999,0
1668006813220,ECE 200,004,103589,Cheng; Chung Kuan,9999,0,9999,0
1668006813220,ECE 200,005,103590,Cosman; Pamela C.,9999,0,9999,0
1668006813220,ECE 200,006,103591,Dayeh; Shadi Ahmad,9999,0,9999,0
1668006813220,ECE 200,007,103592,Fainman; Yeshaiahu,9999,0,9999,0
1668006813220,ECE 200,008,103593,Ford; Joseph Earl,9999,0,9999,0
1668006813220,ECE 200,009,103594,Franceschetti; Massimo,9999,0,9999,0
1668006813220,ECE 200,010,103595,Fullerton; Eric E,9999,0,9999,0
1668006813220,ECE 200,011,103596,Galton; Ian A,9999,0,9999,0
1668006813220,ECE 200,012,103597,Gilja; Vikash,9999,0,9999,0
1668006813220,ECE 200,013,103598,Hall; Drew A.,9999,0,9999,0
1668006813220,ECE 200,014,103599,Hsueh; Tzu-Chien,9999,0,9999,0
1668006813220,ECE 200,015,103600,Javidi; Tara,9999,0,9999,0
1668006813220,ECE 200,016,103601,Kahng; Andrew Byun,9999,0,9999,0
1668006813220,ECE 200,017,103602,Kim; Young-Han,9999,0,9999,0
1668006813220,ECE 200,018,103603,Koushanfar; Farinaz,9999,0,9999,0
1668006813220,ECE 200,019,103604,Kuzum; Duygu,9999,0,9999,0
1668006813220,ECE 200,020,103605,Le; Hanh-Phuc,9999,0,9999,0
1668006813220,ECE 200,021,103606,Lin; Bill,9999,0,9999,0
1668006813220,ECE 200,022,103607,Liu; Zhaowei,9998,0,9999,1
1668006813220,ECE 200,023,103608,Lo; Yu-Hwa,9999,0,9999,0
1668006813220,ECE 200,024,103609,Lomakin; Vitaliy,9999,0,9999,0
1668006813220,ECE 200,025,103610,Mercier; Patrick Philip,9999,0,9999,0
1668006813220,ECE 200,026,103611,Meyer; Florian,9999,0,9999,0
1668006813220,ECE 200,027,103612,Milstein; Laurence B.,9999,0,9999,0
1668006813220,ECE 200,028,103613,Mir Arabbaygi; Siavash,9999,0,9999,0
1668006813220,ECE 200,029,103614,Mookherjea; Shayan,9999,0,9999,0
1668006813220,ECE 200,030,103615,Morris; Karcher William,9999,0,9999,0
1668006813220,ECE 200,031,103616,Ng; Tse Nga,9999,0,9999,0
1668006813220,ECE 200,032,103617,Nguyen; Truong Quang,9999,0,9999,0
1668006813220,ECE 200,033,103618,Nomura; Kenji,9999,0,9999,0
1668006813220,ECE 200,034,103619,Orlitsky; Alon,9999,0,9999,0
1668006813220,ECE 200,035,103620,Pal; Piya,9999,0,9999,0
1668006813220,ECE 200,036,103621,Papen; George C.,9999,0,9999,0
1668006813220,ECE 200,037,103622,Radic; Stojan,9999,0,9999,0
1668006813220,ECE 200,038,103623,Rao; Bhaskar D.,9999,0,9999,0
1668006813220,ECE 200,039,103624,Rao; Ramesh R,9999,0,9999,0
1668006813220,ECE 200,040,103625,Rebeiz; Gabriel,9999,0,9999,0
1668006813220,ECE 200,041,103626,Sanford; John R,9999,0,9999,0
1668006813220,ECE 200,042,103627,Siegel; Paul H.,9999,0,9999,0
1668006813220,ECE 200,043,103628,Sievenpiper; Daniel F.,9999,0,9999,0
1668006813220,ECE 200,044,103629,Sworder; David D.,9999,0,9999,0
1668006813220,ECE 200,045,103630,Taur; Yuan,9999,0,9999,0
1668006813220,ECE 200,046,103631,Touri; Behrouz,9999,0,9999,0
1668006813220,ECE 200,047,103632,Trivedi; Mohan M.,9999,0,9999,0
1668006813220,ECE 200,048,103633,Vasconcelos; Nuno,9999,0,9999,0
1668006813220,ECE 200,049,103634,Wang; Xiaolong,9999,0,9999,0
1668006813220,ECE 200,050,103635,Xie; Pengtao,9999,0,9999,0
1668006813220,ECE 200,051,103636,Yip; Michael,9999,0,9999,0
1668006813220,ECE 200,052,103637,Zeger; Kenneth A.,999,0,999,0
1668006813220,ECE 200,053,103638,Zhang; Xinyu,9999,0,9999,0
1668006813220,ECE 200,054,103639,Turakhia; Yatish Girish,9999,0,9999,0
1668006813220,ECE 200,055,103640,Kang; Mingu,9999,0,9999,0
1668006813220,ECE 200,056,103641,Shi; Yuanyuan,9999,0,9999,0
1668006813220,ECE 200,057,103642,Wang; Edward Jay,9999,0,9999,0
1668006813220,ECE 200,058,103643,Zheng; Yang,9999,0,9999,0
1668006813648,ECE 202,A00,103644,Kuzum; Duygu,0,0,0,0
1668006814070,ECE 212BN,A00,103646,Ng; Tse Nga,0,0,0,0
1668006814503,ECE 221,A00,111493,Staff,0,0,0,0
1668006814926,ECE 222B,A00,103647,Lomakin; Vitaliy,0,0,0,0
1668006815356,ECE 230B,A00,103648,Taur; Yuan,0,0,0,0
1668006815783,ECE 238B,A00,103649,Garay; Javier,0,0,0,0
1668006816207,ECE 240B,A00,112900,Fainman; Yeshaiahu,0,0,0,0
1668006816633,ECE 247A,A00,103650,Jokerst; Jesse Vincent,0,0,0,0
1668006817058,ECE 247B,A00,103651,Wang; Joseph,0,0,0,0
1668006817480,ECE 250,A00,103652,Siegel; Paul H.,0,0,0,0
1668006817901,ECE 251A,A00,103654,Rao; Bhaskar D.,0,0,0,0
1668006818325,ECE 257B,A00,103655,Bharadia; Dinesh,0,0,0,0
1668006818751,ECE 258A,A00,103656,Milstein; Laurence B.,0,0,0,0
1668006819193,ECE 260B,A00,103658,Kang; Mingu,0,0,0,0
1668006819616,ECE 264A,A00,103659,Galton; Ian A,0,0,0,0
1668006820041,ECE 265A,A00,103661,Gudem; Prasad S.S.,0,0,0,0
1668006820463,ECE 265D,A00,103662,Gudem; Prasad S.S.,0,0,0,0
1668006820900,ECE 268,A00,103663,Koushanfar; Farinaz,0,0,0,0
1668006821324,ECE 269,A01,103665,Pal; Piya,0,0,0,0
1668006821749,ECE 271B,A00,103666,Vasconcelos; Manuela,0,0,0,0
1668006822197,ECE 276A,A00,103667,Atanasov; Nikolay A.,0,0,0,0
1668006822620,ECE 277,A00,103668,An; Cheolhong,0,0,0,0
1668006823044,ECE 279,A00,117947,Hall; Drew A.,0,0,0,0
1668006823919,ECE 283,A00,103670,Hsueh; Tzu-Chien,0,0,0,0
1668006824343,ECE 284,A00,103671,Turakhia; Yatish Girish,0,0,0,0
1668006824771,ECE 285,A00,103672,Zheng; Yang,0,0,0,0
1668006824771,ECE 285,B00,103673,Sworder; David D.,0,0,0,0
1668006825197,ECE 287,A00,103676,Javidi; Tara,0,0,0,0
1668006825618,MATH 200B,A00,098023,Salehi Golsefidy; Alireza,14,0,15,1
1668006826043,MATH 202B,A00,098024,Rhoades; Brendon Patrick,12,0,15,3
1668006826477,MATH 203B,A00,098025,Oprea; Dragos N.,12,0,15,3
1668006826900,MATH 204B,A00,098026,Sorensen; Claus M,14,0,15,1
1668006827340,MATH 208,A00,098027,Izadi; Elham,7,0,10,3
1668006827764,MATH 209,A00,098028,Pollack; Aaron,10,0,10,0
1668006828191,MATH 211A,A00,112919,Rogalski; Daniel,9,0,10,1
1668006828613,MATH 211B,A00,112920,Seward; Brandon M.,9,0,10,1
1668006829035,MATH 218,A00,098029,Li; Bo,10,0,10,0
1668006829463,MATH 220B,A00,098030,Novak; Jonathan I,13,0,15,2
1668006829885,MATH 221A,A00,098031,Ebenfelt; Peter F,13,0,15,2
1668006830309,MATH 231B,A00,098032,Zlatos; Andrej,12,0,15,3
1668006830732,MATH 240B,A00,098033,Ni; Lei,10,0,15,5
1668006831155,MATH 243,A00,098034,Jekel; David Andrew,10,0,10,0
1668006831581,MATH 245A,A00,098035,Nie; Jiawang,0,0,15,16
1668006832018,MATH 248,A00,098036,Bejenaru; Ioan,10,0,10,0
1668006832440,MATH 250B,A00,098037,Spolaor; Luca,14,0,15,1
1668006832864,MATH 258,A00,098038,Ni; Lei,10,0,10,0
1668006833290,MATH 264B,A00,098041,Rhoades; Brendon Patrick,11,0,15,4
1668006833725,MATH 268,A00,098042,Buss; Samuel R,10,0,10,0
1668006834160,MATH 269,A00,098043,Rhoades; Brendon Patrick,10,0,10,0
1668006834601,MATH 270B,A00,098044,Li; Bo,11,0,15,4
1668006835024,MATH 272B,A00,098045,Holst; Michael J,13,0,15,2
1668006835463,MATH 273A,A00,098046,Tian; Xiaochuan,12,0,15,3
1668006835886,MATH 275,A01,098048,Tian; Xiaochuan,6,0,10,4
1668006836309,MATH 278A,A00,098049,Holst; Michael J,8,0,10,2
1668006836730,MATH 278B,A00,098050,Cloninger; Alexander,10,0,10,0
1668006837156,MATH 278C,A00,098051,Nie; Jiawang,8,0,10,2
1668006837579,MATH 280B,A00,098052,Zheng; Tianyi,11,0,15,4
1668006838006,MATH 281B,A00,098053,Bradic; Jelena,4,0,15,11
1668006838428,MATH 282B,A00,098054,Arias-Castro; Ery,2,0,15,13
1668006838855,MATH 285,A00,098055,Fitzsimmons; Patrick J,0,0,15,17
1668006839294,MATH 287B,A00,098056,Arias-Castro; Ery,5,0,15,10
1668006839716,MATH 288,A00,098057,Agarwal; Pooja,9,0,10,1
1668006839716,MATH 288,B00,098058,Zhang; Danna,9,0,10,1
1668006839716,MATH 288,C00,098059,Williams; Ruth J,10,0,10,0
1668006840143,MATH 290B,A00,098060,Roberts; Justin Deritter,14,0,15,1
1668006840563,MATH 292,A00,098061,Belmont; Eva Kinoshita,10,0,10,0
1668006840988,MATH 295,A00,098062,Suk; Andrew Hoon,48,0,50,2
1668006841415,MATH 296,A00,098063,Novak; Jonathan I,20,0,20,0
1668006841837,MATH 297,001,098064,Gamst; Anthony Collins,9997,0,9999,2
1668007342837,COGS 205,A00,101395,Chiba; Andrea,19,0,20,1
1668007343265,COGS 210B,001,101404,Greene; Deanna Jacquelyn,9998,0,9999,1
1668007343265,COGS 210B,002,101417,Xia; Haijun,9999,0,9999,0
1668007343265,COGS 210B,003,101422,Nitz; Douglas A.,9999,0,9999,0
1668007343265,COGS 210B,004,101423,Hollan; James D.,9998,0,9999,1
1668007343265,COGS 210B,005,101424,Deak; Gedeon O.,9999,0,9999,0
1668007343265,COGS 210B,006,101425,Rossano; Federico,9999,0,9999,0
1668007343689,COGS 211B,A00,101427,Coulson; Seana M,9997,0,9999,2
1668007344123,COGS 220,A00,101428,Hollan; James D.,0,0,25,25
1668007344545,COGS 229,A00,101429,Dow; Steven P,18,0,25,7
1668007344968,COGS 230,A00,101430,Klemmer; Scott R,13,0,17,4
1668007345392,COGS 234,A00,101431,Xia; Haijun,7,0,25,18
1668007345813,COGS 260,A00,101432,Kiyonaga; Anastasia,20,0,25,5
1668007345813,COGS 260,B00,101433,Kirsh; David Joel,16,0,25,9
1668007346236,CSE 202,A00,102371,Impagliazzo; Russell,0,0,0,0
1668007346660,CSE 203B,A01,102373,Cheng; Chung Kuan,0,0,0,0
1668007347084,CSE 208,A00,102374,Micciancio; Daniele,0,0,0,0
1668007347510,CSE 209A,A00,112895,Impagliazzo; Russell,0,0,15,15
1668007347937,CSE 209B,A00,108005,Bellare; Mihir,0,0,0,0
1668007348360,CSE 210,A00,113163,Coblenz; Michael J,0,0,0,0
1668007348782,CSE 219,A00,106111,Dow; Steven P,0,0,20,20
1668007349207,CSE 221,A00,102376,Voelker; Geoffrey M.,0,0,0,0
1668007349637,CSE 224,A01,102378,Porter; George M,0,0,0,0
1668007350063,CSE 229A,A00,102379,Savage; Stefan,0,0,0,0
1668007350494,CSE 229C,A00,102380,Munyaka; Imani N. S.,0,0,0,0
1668007350915,CSE 232B,A00,102382,Deutsch; Alin Bernard,0,0,0,0
1668007351341,CSE 234,A01,112904,Kumar; Arun Kumar,0,0,0,0
1668007351765,CSE 237A,A00,102383,Rosing; Tajana Simunic,0,0,0,0
1668007352190,CSE 239A,A00,102384,Deutsch; Alin Bernard,0,0,0,0
1668007352626,CSE 239B,A00,102385,Polikarpova; Nadezhda,0,0,0,0
1668007353050,CSE 240A,A00,102386,Pannuto; Patrick William,0,0,0,0
1668007353477,CSE 240B,A00,102387,Zhao; Jishen,0,0,0,0
1668007353904,CSE 241A,A00,106406,Kang; Mingu,0,0,0,0
1668007354329,CSE 249B,A00,102388,Kahng; Andrew Byun,0,0,8,8
1668007354761,CSE 251B,A01,102392,Cottrell; Garrison W,0,0,0,0
1668007354761,CSE 251B,A02,102393,Cottrell; Garrison W,0,0,0,0
1668007355187,CSE 252B,A00,102394,Ochoa; Benjamin Lawrence,0,0,0,0
1668007355611,CSE 257,A01,102396,Gao; Sicun,0,0,0,0
1668007356037,CSE 272,A00,102397,Li; Tzumao,0,0,0,0
1668007356468,CSE 274,A00,111323,Chern; Albert Ren-Haur,0,0,0,0
1668007356891,CSE 282,A00,102398,Pevzner; Pavel Arkadjevich,0,0,0,0
1668007357319,CSE 284,A00,114175,Gymrek; Melissa Ann,0,0,0,0
1668007357742,CSE 290,A00,102399,Chandraker; Manmohan Krishna,0,0,0,0
1668007357742,CSE 290,B00,102400,Vaccaro; Kristen Marie,0,0,25,25
1668007357742,CSE 290,C00,102414,Pannuto; Patrick William,0,0,25,25
1668007357742,CSE 290,D00,102427,Pevzner; Pavel Arkadjevich,0,0,0,0
1668007357742,CSE 290,E00,102429,Zhao; Jishen,0,0,0,0
1668007357742,CSE 290,F00,102436,Tullsen; Dean Michael,0,0,0,0
1668007357742,CSE 290,G00,102440,Christensen; Henrik I,0,0,20,20
1668007358166,CSE 291,A00,102443,Su; Hao,0,0,0,0
1668007358166,CSE 291,B00,102448,Polikarpova; Nadezhda,0,0,0,0
1668007358166,CSE 291,C00,102453,Vaccaro; Kristen Marie,0,0,0,0
1668007358166,CSE 291,D00,111343,Savage; Stefan,0,0,0,0
1668007358166,CSE 291,E00,116474,Claffy; Kimberly Claire,0,0,0,0
1668007358166,CSE 291,F00,116479,Pasquale; Joseph,0,0,0,0
1668007358592,CSE 293,001,119111,Bafna; Vineet,9999,0,9999,0
1668007358592,CSE 293,002,119118,Bellare; Mihir,9999,0,9999,0
1668007358592,CSE 293,003,119122,Berg-Kirkpatrick; Taylor D,9999,0,9999,0
1668007358592,CSE 293,004,119135,Christensen; Henrik I,9999,0,9999,0
1668007358592,CSE 293,005,119142,Cottrell; Garrison W,9999,0,9999,0
1668007358592,CSE 293,006,119146,Deutsch; Alin Bernard,9999,0,9999,0
1668007358592,CSE 293,007,119159,Esmaeilzadeh; Hadi,9999,0,9999,0
1668007358592,CSE 293,008,119166,Freund; Yoav,9999,0,9999,0
1668007358592,CSE 293,009,119170,Griswold; William G.,9999,0,9999,0
1668007358592,CSE 293,010,119183,Gymrek; Melissa Ann,9999,0,9999,0
1668007358592,CSE 293,011,119190,Heninger; Nadia A,9999,0,9999,0
1668007358592,CSE 293,012,119230,Impagliazzo; Russell,9999,0,9999,0
1668007358592,CSE 293,013,119232,Jhala; Ranjit,9999,0,9999,0
1668007358592,CSE 293,014,119233,Kahng; Andrew Byun,9999,0,9999,0
1668007358592,CSE 293,015,119298,Kane; Daniel Mertz,9999,0,9999,0
1668007358592,CSE 293,016,119299,Kriegman; David J,9999,0,9999,0
1668007358592,CSE 293,017,119300,Kumar; Arun Kumar,9999,0,9999,0
1668007358592,CSE 293,018,119301,Lerner; Sorin,9999,0,9999,0
1668007358592,CSE 293,019,119302,Lovett; Shachar,9999,0,9999,0
1668007358592,CSE 293,020,119303,McAuley; Julian John,9999,0,9999,0
1668007358592,CSE 293,021,119304,Micciancio; Daniele,9999,0,9999,0
1668007358592,CSE 293,022,119367,Orailoglu; Alex,9999,0,9999,0
1668007358592,CSE 293,023,119382,Paturi; Ramamohan,9999,0,9999,0
1668007358592,CSE 293,024,119404,Polikarpova; Nadezhda,9999,0,9999,0
1668007358592,CSE 293,025,119406,Politz; Joseph Gibbs,9999,0,9999,0
1668007358592,CSE 293,026,119411,Porter; George M,9999,0,9999,0
1668007358592,CSE 293,027,119414,Porter; Leonard Emerson,9999,0,9999,0
1668007358592,CSE 293,028,119416,Ramamoorthi; Ravi,9999,0,9999,0
1668007358592,CSE 293,029,119417,Sahoo; Debashis,9999,0,9999,0
1668007358592,CSE 293,030,119420,Saul; Lawrence,9999,0,9999,0
1668007358592,CSE 293,031,119421,Savage; Stefan,9999,0,9999,0
1668007358592,CSE 293,032,119425,Schulze; Jurgen P.,9999,0,9999,0
1668007358592,CSE 293,033,119426,Snoeren; Alex C.,9999,0,9999,0
1668007358592,CSE 293,034,119428,Shang; Jingbo,9999,0,9999,0
1668007358592,CSE 293,035,119430,Stefan; Deian,9999,0,9999,0
1668007358592,CSE 293,036,119431,Su; Hao,9999,0,9999,0
1668007358592,CSE 293,037,119433,Swanson; Steven James,9999,0,9999,0
1668007358592,CSE 293,038,119435,Tullsen; Dean Michael,9999,0,9999,0
1668007358592,CSE 293,039,119483,Voelker; Geoffrey M.,9999,0,9999,0
1668007358592,CSE 293,040,119537,Zhao; Jishen,9999,0,9999,0
1668007358592,CSE 293,041,119538,Zhou; Yuan-Yuan,9999,0,9999,0
1668007358592,CSE 293,042,119539,Gao; Sicun,9999,0,9999,0
1668007358592,CSE 293,043,119540,Weibel; Nadir,9999,0,9999,0
1668007358592,CSE 293,044,119541,Gupta; Rajesh K.,9999,0,9999,0
1668007358592,CSE 293,045,126410,Vaccaro; Kristen Marie,9999,0,9999,0
1668007358592,CSE 293,046,126411,Klemke; Richard,9999,0,9999,0
1668007359025,CSE 294,A00,102459,Voelker; Geoffrey M.,0,0,0,0
1668007359025,CSE 294,B00,111322,Orailoglu; Alex,0,0,0,0
1668007359447,DSE 201,A00,096914,Deutsch; Alin Bernard,30,0,30,0
1668007359901,DSE 210,A00,096915,Dasgupta; Sanjoy,30,0,30,0
1668007360323,DSE 260A,A00,096916,Altintas De Callaf; Ilkay,30,0,30,0
1668007360787,ECE 200,001,103586,Antipa; Nicholas A,9999,0,9999,0
1668007360787,ECE 200,002,103587,Atanasov; Nikolay A.,9999,0,9999,0
1668007360787,ECE 200,003,103588,Bharadia; Dinesh,9999,0,9999,0
1668007360787,ECE 200,004,103589,Cheng; Chung Kuan,9999,0,9999,0
1668007360787,ECE 200,005,103590,Cosman; Pamela C.,9999,0,9999,0
1668007360787,ECE 200,006,103591,Dayeh; Shadi Ahmad,9999,0,9999,0
1668007360787,ECE 200,007,103592,Fainman; Yeshaiahu,9999,0,9999,0
1668007360787,ECE 200,008,103593,Ford; Joseph Earl,9999,0,9999,0
1668007360787,ECE 200,009,103594,Franceschetti; Massimo,9999,0,9999,0
1668007360787,ECE 200,010,103595,Fullerton; Eric E,9999,0,9999,0
1668007360787,ECE 200,011,103596,Galton; Ian A,9999,0,9999,0
1668007360787,ECE 200,012,103597,Gilja; Vikash,9999,0,9999,0
1668007360787,ECE 200,013,103598,Hall; Drew A.,9999,0,9999,0
1668007360787,ECE 200,014,103599,Hsueh; Tzu-Chien,9999,0,9999,0
1668007360787,ECE 200,015,103600,Javidi; Tara,9999,0,9999,0
1668007360787,ECE 200,016,103601,Kahng; Andrew Byun,9999,0,9999,0
1668007360787,ECE 200,017,103602,Kim; Young-Han,9999,0,9999,0
1668007360787,ECE 200,018,103603,Koushanfar; Farinaz,9999,0,9999,0
1668007360787,ECE 200,019,103604,Kuzum; Duygu,9999,0,9999,0
1668007360787,ECE 200,020,103605,Le; Hanh-Phuc,9999,0,9999,0
1668007360787,ECE 200,021,103606,Lin; Bill,9999,0,9999,0
1668007360787,ECE 200,022,103607,Liu; Zhaowei,9998,0,9999,1
1668007360787,ECE 200,023,103608,Lo; Yu-Hwa,9999,0,9999,0
1668007360787,ECE 200,024,103609,Lomakin; Vitaliy,9999,0,9999,0
1668007360787,ECE 200,025,103610,Mercier; Patrick Philip,9999,0,9999,0
1668007360787,ECE 200,026,103611,Meyer; Florian,9999,0,9999,0
1668007360787,ECE 200,027,103612,Milstein; Laurence B.,9999,0,9999,0
1668007360787,ECE 200,028,103613,Mir Arabbaygi; Siavash,9999,0,9999,0
1668007360787,ECE 200,029,103614,Mookherjea; Shayan,9999,0,9999,0
1668007360787,ECE 200,030,103615,Morris; Karcher William,9999,0,9999,0
1668007360787,ECE 200,031,103616,Ng; Tse Nga,9999,0,9999,0
1668007360787,ECE 200,032,103617,Nguyen; Truong Quang,9999,0,9999,0
1668007360787,ECE 200,033,103618,Nomura; Kenji,9999,0,9999,0
1668007360787,ECE 200,034,103619,Orlitsky; Alon,9999,0,9999,0
1668007360787,ECE 200,035,103620,Pal; Piya,9999,0,9999,0
1668007360787,ECE 200,036,103621,Papen; George C.,9999,0,9999,0
1668007360787,ECE 200,037,103622,Radic; Stojan,9999,0,9999,0
1668007360787,ECE 200,038,103623,Rao; Bhaskar D.,9999,0,9999,0
1668007360787,ECE 200,039,103624,Rao; Ramesh R,9999,0,9999,0
1668007360787,ECE 200,040,103625,Rebeiz; Gabriel,9999,0,9999,0
1668007360787,ECE 200,041,103626,Sanford; John R,9999,0,9999,0
1668007360787,ECE 200,042,103627,Siegel; Paul H.,9999,0,9999,0
1668007360787,ECE 200,043,103628,Sievenpiper; Daniel F.,9999,0,9999,0
1668007360787,ECE 200,044,103629,Sworder; David D.,9999,0,9999,0
1668007360787,ECE 200,045,103630,Taur; Yuan,9999,0,9999,0
1668007360787,ECE 200,046,103631,Touri; Behrouz,9999,0,9999,0
1668007360787,ECE 200,047,103632,Trivedi; Mohan M.,9999,0,9999,0
1668007360787,ECE 200,048,103633,Vasconcelos; Nuno,9999,0,9999,0
1668007360787,ECE 200,049,103634,Wang; Xiaolong,9999,0,9999,0
1668007360787,ECE 200,050,103635,Xie; Pengtao,9999,0,9999,0
1668007360787,ECE 200,051,103636,Yip; Michael,9999,0,9999,0
1668007360787,ECE 200,052,103637,Zeger; Kenneth A.,999,0,999,0
1668007360787,ECE 200,053,103638,Zhang; Xinyu,9999,0,9999,0
1668007360787,ECE 200,054,103639,Turakhia; Yatish Girish,9999,0,9999,0
1668007360787,ECE 200,055,103640,Kang; Mingu,9999,0,9999,0
1668007360787,ECE 200,056,103641,Shi; Yuanyuan,9999,0,9999,0
1668007360787,ECE 200,057,103642,Wang; Edward Jay,9999,0,9999,0
1668007360787,ECE 200,058,103643,Zheng; Yang,9999,0,9999,0
1668007361211,ECE 202,A00,103644,Kuzum; Duygu,0,0,0,0
1668007361633,ECE 212BN,A00,103646,Ng; Tse Nga,0,0,0,0
1668007362060,ECE 221,A00,111493,Staff,0,0,0,0
1668007362481,ECE 222B,A00,103647,Lomakin; Vitaliy,0,0,0,0
1668007362903,ECE 230B,A00,103648,Taur; Yuan,0,0,0,0
1668007363326,ECE 238B,A00,103649,Garay; Javier,0,0,0,0
1668007363749,ECE 240B,A00,112900,Fainman; Yeshaiahu,0,0,0,0
1668007364171,ECE 247A,A00,103650,Jokerst; Jesse Vincent,0,0,0,0
1668007364601,ECE 247B,A00,103651,Wang; Joseph,0,0,0,0
1668007365025,ECE 250,A00,103652,Siegel; Paul H.,0,0,0,0
1668007365447,ECE 251A,A00,103654,Rao; Bhaskar D.,0,0,0,0
1668007365873,ECE 257B,A00,103655,Bharadia; Dinesh,0,0,0,0
1668007366297,ECE 258A,A00,103656,Milstein; Laurence B.,0,0,0,0
1668007366731,ECE 260B,A00,103658,Kang; Mingu,0,0,0,0
1668007367156,ECE 264A,A00,103659,Galton; Ian A,0,0,0,0
1668007367594,ECE 265A,A00,103661,Gudem; Prasad S.S.,0,0,0,0
1668007368020,ECE 265D,A00,103662,Gudem; Prasad S.S.,0,0,0,0
1668007368443,ECE 268,A00,103663,Koushanfar; Farinaz,0,0,0,0
1668007368869,ECE 269,A01,103665,Pal; Piya,0,0,0,0
1668007369303,ECE 271B,A00,103666,Vasconcelos; Manuela,0,0,0,0
1668007369726,ECE 276A,A00,103667,Atanasov; Nikolay A.,0,0,0,0
1668007370161,ECE 277,A00,103668,An; Cheolhong,0,0,0,0
1668007370591,ECE 279,A00,117947,Hall; Drew A.,0,0,0,0
1668007371451,ECE 283,A00,103670,Hsueh; Tzu-Chien,0,0,0,0
1668007371879,ECE 284,A00,103671,Turakhia; Yatish Girish,0,0,0,0
1668007372306,ECE 285,A00,103672,Zheng; Yang,0,0,0,0
1668007372306,ECE 285,B00,103673,Sworder; David D.,0,0,0,0
1668007372736,ECE 287,A00,103676,Javidi; Tara,0,0,0,0
1668007373163,MATH 200B,A00,098023,Salehi Golsefidy; Alireza,14,0,15,1
1668007373587,MATH 202B,A00,098024,Rhoades; Brendon Patrick,12,0,15,3
1668007374012,MATH 203B,A00,098025,Oprea; Dragos N.,12,0,15,3
1668007374439,MATH 204B,A00,098026,Sorensen; Claus M,14,0,15,1
1668007374863,MATH 208,A00,098027,Izadi; Elham,7,0,10,3
1668007375284,MATH 209,A00,098028,Pollack; Aaron,10,0,10,0
1668007375725,MATH 211A,A00,112919,Rogalski; Daniel,9,0,10,1
1668007376150,MATH 211B,A00,112920,Seward; Brandon M.,9,0,10,1
1668007376666,MATH 218,A00,098029,Li; Bo,10,0,10,0
1668007377091,MATH 220B,A00,098030,Novak; Jonathan I,13,0,15,2
1668007377517,MATH 221A,A00,098031,Ebenfelt; Peter F,13,0,15,2
1668007377941,MATH 231B,A00,098032,Zlatos; Andrej,12,0,15,3
1668007378365,MATH 240B,A00,098033,Ni; Lei,10,0,15,5
1668007378792,MATH 243,A00,098034,Jekel; David Andrew,10,0,10,0
1668007379216,MATH 245A,A00,098035,Nie; Jiawang,0,0,15,16
1668007379648,MATH 248,A00,098036,Bejenaru; Ioan,10,0,10,0
1668007380077,MATH 250B,A00,098037,Spolaor; Luca,14,0,15,1
1668007380514,MATH 258,A00,098038,Ni; Lei,10,0,10,0
1668007380946,MATH 264B,A00,098041,Rhoades; Brendon Patrick,11,0,15,4
1668007381381,MATH 268,A00,098042,Buss; Samuel R,10,0,10,0
1668007381805,MATH 269,A00,098043,Rhoades; Brendon Patrick,10,0,10,0
1668007382243,MATH 270B,A00,098044,Li; Bo,11,0,15,4
1668007382669,MATH 272B,A00,098045,Holst; Michael J,13,0,15,2
1668007383095,MATH 273A,A00,098046,Tian; Xiaochuan,12,0,15,3
1668007383520,MATH 275,A01,098048,Tian; Xiaochuan,6,0,10,4
1668007383955,MATH 278A,A00,098049,Holst; Michael J,8,0,10,2
1668007384382,MATH 278B,A00,098050,Cloninger; Alexander,10,0,10,0
1668007384810,MATH 278C,A00,098051,Nie; Jiawang,8,0,10,2
1668007385234,MATH 280B,A00,098052,Zheng; Tianyi,11,0,15,4
1668007385656,MATH 281B,A00,098053,Bradic; Jelena,4,0,15,11
1668007386079,MATH 282B,A00,098054,Arias-Castro; Ery,2,0,15,13
1668007386507,MATH 285,A00,098055,Fitzsimmons; Patrick J,0,0,15,17
1668007386934,MATH 287B,A00,098056,Arias-Castro; Ery,5,0,15,10
1668007387361,MATH 288,A00,098057,Agarwal; Pooja,9,0,10,1
1668007387361,MATH 288,B00,098058,Zhang; Danna,9,0,10,1
1668007387361,MATH 288,C00,098059,Williams; Ruth J,10,0,10,0
1668007387784,MATH 290B,A00,098060,Roberts; Justin Deritter,14,0,15,1
1668007388208,MATH 292,A00,098061,Belmont; Eva Kinoshita,10,0,10,0
1668007388650,MATH 295,A00,098062,Suk; Andrew Hoon,48,0,50,2
1668007389073,MATH 296,A00,098063,Novak; Jonathan I,20,0,20,0
1668007389500,MATH 297,001,098064,Gamst; Anthony Collins,9997,0,9999,2
1668007891361,COGS 205,A00,101395,Chiba; Andrea,19,0,20,1
1668007891789,COGS 210B,001,101404,Greene; Deanna Jacquelyn,9998,0,9999,1
1668007891789,COGS 210B,002,101417,Xia; Haijun,9999,0,9999,0
1668007891789,COGS 210B,003,101422,Nitz; Douglas A.,9999,0,9999,0
1668007891789,COGS 210B,004,101423,Hollan; James D.,9998,0,9999,1
1668007891789,COGS 210B,005,101424,Deak; Gedeon O.,9999,0,9999,0
1668007891789,COGS 210B,006,101425,Rossano; Federico,9999,0,9999,0
1668007892219,COGS 211B,A00,101427,Coulson; Seana M,9997,0,9999,2
1668007892653,COGS 220,A00,101428,Hollan; James D.,0,0,25,25
1668007893089,COGS 229,A00,101429,Dow; Steven P,18,0,25,7
1668007893514,COGS 230,A00,101430,Klemmer; Scott R,13,0,17,4
1668007893939,COGS 234,A00,101431,Xia; Haijun,7,0,25,18
1668007894361,COGS 260,A00,101432,Kiyonaga; Anastasia,20,0,25,5
1668007894361,COGS 260,B00,101433,Kirsh; David Joel,16,0,25,9
1668007894788,CSE 202,A00,102371,Impagliazzo; Russell,0,0,0,0
1668007895221,CSE 203B,A01,102373,Cheng; Chung Kuan,0,0,0,0
1668007895642,CSE 208,A00,102374,Micciancio; Daniele,0,0,0,0
1668007896068,CSE 209A,A00,112895,Impagliazzo; Russell,0,0,15,15
1668007896490,CSE 209B,A00,108005,Bellare; Mihir,0,0,0,0
1668007896930,CSE 210,A00,113163,Coblenz; Michael J,0,0,0,0
1668007897356,CSE 219,A00,106111,Dow; Steven P,0,0,20,20
1668007897781,CSE 221,A00,102376,Voelker; Geoffrey M.,0,0,0,0
1668007898206,CSE 224,A01,102378,Porter; George M,0,0,0,0
1668007898752,CSE 229A,A00,102379,Savage; Stefan,0,0,0,0
1668007899179,CSE 229C,A00,102380,Munyaka; Imani N. S.,0,0,0,0
1668007899604,CSE 232B,A00,102382,Deutsch; Alin Bernard,0,0,0,0
1668007900034,CSE 234,A01,112904,Kumar; Arun Kumar,0,0,0,0
1668007900467,CSE 237A,A00,102383,Rosing; Tajana Simunic,0,0,0,0
1668007900890,CSE 239A,A00,102384,Deutsch; Alin Bernard,0,0,0,0
1668007901319,CSE 239B,A00,102385,Polikarpova; Nadezhda,0,0,0,0
1668007901742,CSE 240A,A00,102386,Pannuto; Patrick William,0,0,0,0
1668007902170,CSE 240B,A00,102387,Zhao; Jishen,0,0,0,0
1668007902592,CSE 241A,A00,106406,Kang; Mingu,0,0,0,0
1668007903016,CSE 249B,A00,102388,Kahng; Andrew Byun,0,0,8,8
1668007903438,CSE 251B,A01,102392,Cottrell; Garrison W,0,0,0,0
1668007903438,CSE 251B,A02,102393,Cottrell; Garrison W,0,0,0,0
1668007903862,CSE 252B,A00,102394,Ochoa; Benjamin Lawrence,0,0,0,0
1668007904291,CSE 257,A01,102396,Gao; Sicun,0,0,0,0
1668007904717,CSE 272,A00,102397,Li; Tzumao,0,0,0,0
1668007905143,CSE 274,A00,111323,Chern; Albert Ren-Haur,0,0,0,0
1668007905572,CSE 282,A00,102398,Pevzner; Pavel Arkadjevich,0,0,0,0
1668007906014,CSE 284,A00,114175,Gymrek; Melissa Ann,0,0,0,0
1668007906442,CSE 290,A00,102399,Chandraker; Manmohan Krishna,0,0,0,0
1668007906442,CSE 290,B00,102400,Vaccaro; Kristen Marie,0,0,25,25
1668007906442,CSE 290,C00,102414,Pannuto; Patrick William,0,0,25,25
1668007906442,CSE 290,D00,102427,Pevzner; Pavel Arkadjevich,0,0,0,0
1668007906442,CSE 290,E00,102429,Zhao; Jishen,0,0,0,0
1668007906442,CSE 290,F00,102436,Tullsen; Dean Michael,0,0,0,0
1668007906442,CSE 290,G00,102440,Christensen; Henrik I,0,0,20,20
1668007906867,CSE 291,A00,102443,Su; Hao,0,0,0,0
1668007906867,CSE 291,B00,102448,Polikarpova; Nadezhda,0,0,0,0
1668007906867,CSE 291,C00,102453,Vaccaro; Kristen Marie,0,0,0,0
1668007906867,CSE 291,D00,111343,Savage; Stefan,0,0,0,0
1668007906867,CSE 291,E00,116474,Claffy; Kimberly Claire,0,0,0,0
1668007906867,CSE 291,F00,116479,Pasquale; Joseph,0,0,0,0
1668007907297,CSE 293,001,119111,Bafna; Vineet,9999,0,9999,0
1668007907297,CSE 293,002,119118,Bellare; Mihir,9999,0,9999,0
1668007907297,CSE 293,003,119122,Berg-Kirkpatrick; Taylor D,9999,0,9999,0
1668007907297,CSE 293,004,119135,Christensen; Henrik I,9999,0,9999,0
1668007907297,CSE 293,005,119142,Cottrell; Garrison W,9999,0,9999,0
1668007907297,CSE 293,006,119146,Deutsch; Alin Bernard,9999,0,9999,0
1668007907297,CSE 293,007,119159,Esmaeilzadeh; Hadi,9999,0,9999,0
1668007907297,CSE 293,008,119166,Freund; Yoav,9999,0,9999,0
1668007907297,CSE 293,009,119170,Griswold; William G.,9999,0,9999,0
1668007907297,CSE 293,010,119183,Gymrek; Melissa Ann,9999,0,9999,0
1668007907297,CSE 293,011,119190,Heninger; Nadia A,9999,0,9999,0
1668007907297,CSE 293,012,119230,Impagliazzo; Russell,9999,0,9999,0
1668007907297,CSE 293,013,119232,Jhala; Ranjit,9999,0,9999,0
1668007907297,CSE 293,014,119233,Kahng; Andrew Byun,9999,0,9999,0
1668007907297,CSE 293,015,119298,Kane; Daniel Mertz,9999,0,9999,0
1668007907297,CSE 293,016,119299,Kriegman; David J,9999,0,9999,0
1668007907297,CSE 293,017,119300,Kumar; Arun Kumar,9999,0,9999,0
1668007907297,CSE 293,018,119301,Lerner; Sorin,9999,0,9999,0
1668007907297,CSE 293,019,119302,Lovett; Shachar,9999,0,9999,0
1668007907297,CSE 293,020,119303,McAuley; Julian John,9999,0,9999,0
1668007907297,CSE 293,021,119304,Micciancio; Daniele,9999,0,9999,0
1668007907297,CSE 293,022,119367,Orailoglu; Alex,9999,0,9999,0
1668007907297,CSE 293,023,119382,Paturi; Ramamohan,9999,0,9999,0
1668007907297,CSE 293,024,119404,Polikarpova; Nadezhda,9999,0,9999,0
1668007907297,CSE 293,025,119406,Politz; Joseph Gibbs,9999,0,9999,0
1668007907297,CSE 293,026,119411,Porter; George M,9999,0,9999,0
1668007907297,CSE 293,027,119414,Porter; Leonard Emerson,9999,0,9999,0
1668007907297,CSE 293,028,119416,Ramamoorthi; Ravi,9999,0,9999,0
1668007907297,CSE 293,029,119417,Sahoo; Debashis,9999,0,9999,0
1668007907297,CSE 293,030,119420,Saul; Lawrence,9999,0,9999,0
1668007907297,CSE 293,031,119421,Savage; Stefan,9999,0,9999,0
1668007907297,CSE 293,032,119425,Schulze; Jurgen P.,9999,0,9999,0
1668007907297,CSE 293,033,119426,Snoeren; Alex C.,9999,0,9999,0
1668007907297,CSE 293,034,119428,Shang; Jingbo,9999,0,9999,0
1668007907297,CSE 293,035,119430,Stefan; Deian,9999,0,9999,0
1668007907297,CSE 293,036,119431,Su; Hao,9999,0,9999,0
1668007907297,CSE 293,037,119433,Swanson; Steven James,9999,0,9999,0
1668007907297,CSE 293,038,119435,Tullsen; Dean Michael,9999,0,9999,0
1668007907297,CSE 293,039,119483,Voelker; Geoffrey M.,9999,0,9999,0
1668007907297,CSE 293,040,119537,Zhao; Jishen,9999,0,9999,0
1668007907297,CSE 293,041,119538,Zhou; Yuan-Yuan,9999,0,9999,0
1668007907297,CSE 293,042,119539,Gao; Sicun,9999,0,9999,0
1668007907297,CSE 293,043,119540,Weibel; Nadir,9999,0,9999,0
1668007907297,CSE 293,044,119541,Gupta; Rajesh K.,9999,0,9999,0
1668007907297,CSE 293,045,126410,Vaccaro; Kristen Marie,9999,0,9999,0
1668007907297,CSE 293,046,126411,Klemke; Richard,9999,0,9999,0
1668007907719,CSE 294,A00,102459,Voelker; Geoffrey M.,0,0,0,0
1668007907719,CSE 294,B00,111322,Orailoglu; Alex,0,0,0,0
1668007908165,DSE 201,A00,096914,Deutsch; Alin Bernard,30,0,30,0
1668007908597,DSE 210,A00,096915,Dasgupta; Sanjoy,30,0,30,0
1668007909026,DSE 260A,A00,096916,Altintas De Callaf; Ilkay,30,0,30,0
1668007909482,ECE 200,001,103586,Antipa; Nicholas A,9999,0,9999,0
1668007909482,ECE 200,002,103587,Atanasov; Nikolay A.,9999,0,9999,0
1668007909482,ECE 200,003,103588,Bharadia; Dinesh,9999,0,9999,0
1668007909482,ECE 200,004,103589,Cheng; Chung Kuan,9999,0,9999,0
1668007909482,ECE 200,005,103590,Cosman; Pamela C.,9999,0,9999,0
1668007909482,ECE 200,006,103591,Dayeh; Shadi Ahmad,9999,0,9999,0
1668007909482,ECE 200,007,103592,Fainman; Yeshaiahu,9999,0,9999,0
1668007909482,ECE 200,008,103593,Ford; Joseph Earl,9999,0,9999,0
1668007909482,ECE 200,009,103594,Franceschetti; Massimo,9999,0,9999,0
1668007909482,ECE 200,010,103595,Fullerton; Eric E,9999,0,9999,0
1668007909482,ECE 200,011,103596,Galton; Ian A,9999,0,9999,0
1668007909482,ECE 200,012,103597,Gilja; Vikash,9999,0,9999,0
1668007909482,ECE 200,013,103598,Hall; Drew A.,9999,0,9999,0
1668007909482,ECE 200,014,103599,Hsueh; Tzu-Chien,9999,0,9999,0
1668007909482,ECE 200,015,103600,Javidi; Tara,9999,0,9999,0
1668007909482,ECE 200,016,103601,Kahng; Andrew Byun,9999,0,9999,0
1668007909482,ECE 200,017,103602,Kim; Young-Han,9999,0,9999,0
1668007909482,ECE 200,018,103603,Koushanfar; Farinaz,9999,0,9999,0
1668007909482,ECE 200,019,103604,Kuzum; Duygu,9999,0,9999,0
1668007909482,ECE 200,020,103605,Le; Hanh-Phuc,9999,0,9999,0
1668007909482,ECE 200,021,103606,Lin; Bill,9999,0,9999,0
1668007909482,ECE 200,022,103607,Liu; Zhaowei,9998,0,9999,1
1668007909482,ECE 200,023,103608,Lo; Yu-Hwa,9999,0,9999,0
1668007909482,ECE 200,024,103609,Lomakin; Vitaliy,9999,0,9999,0
1668007909482,ECE 200,025,103610,Mercier; Patrick Philip,9999,0,9999,0
1668007909482,ECE 200,026,103611,Meyer; Florian,9999,0,9999,0
1668007909482,ECE 200,027,103612,Milstein; Laurence B.,9999,0,9999,0
1668007909482,ECE 200,028,103613,Mir Arabbaygi; Siavash,9999,0,9999,0
1668007909482,ECE 200,029,103614,Mookherjea; Shayan,9999,0,9999,0
1668007909482,ECE 200,030,103615,Morris; Karcher William,9999,0,9999,0
1668007909482,ECE 200,031,103616,Ng; Tse Nga,9999,0,9999,0
1668007909482,ECE 200,032,103617,Nguyen; Truong Quang,9999,0,9999,0
1668007909482,ECE 200,033,103618,Nomura; Kenji,9999,0,9999,0
1668007909482,ECE 200,034,103619,Orlitsky; Alon,9999,0,9999,0
1668007909482,ECE 200,035,103620,Pal; Piya,9999,0,9999,0
1668007909482,ECE 200,036,103621,Papen; George C.,9999,0,9999,0
1668007909482,ECE 200,037,103622,Radic; Stojan,9999,0,9999,0
1668007909482,ECE 200,038,103623,Rao; Bhaskar D.,9999,0,9999,0
1668007909482,ECE 200,039,103624,Rao; Ramesh R,9999,0,9999,0
1668007909482,ECE 200,040,103625,Rebeiz; Gabriel,9999,0,9999,0
1668007909482,ECE 200,041,103626,Sanford; John R,9999,0,9999,0
1668007909482,ECE 200,042,103627,Siegel; Paul H.,9999,0,9999,0
1668007909482,ECE 200,043,103628,Sievenpiper; Daniel F.,9999,0,9999,0
1668007909482,ECE 200,044,103629,Sworder; David D.,9999,0,9999,0
1668007909482,ECE 200,045,103630,Taur; Yuan,9999,0,9999,0
1668007909482,ECE 200,046,103631,Touri; Behrouz,9999,0,9999,0
1668007909482,ECE 200,047,103632,Trivedi; Mohan M.,9999,0,9999,0
1668007909482,ECE 200,048,103633,Vasconcelos; Nuno,9999,0,9999,0
1668007909482,ECE 200,049,103634,Wang; Xiaolong,9999,0,9999,0
1668007909482,ECE 200,050,103635,Xie; Pengtao,9999,0,9999,0
1668007909482,ECE 200,051,103636,Yip; Michael,9999,0,9999,0
1668007909482,ECE 200,052,103637,Zeger; Kenneth A.,999,0,999,0
1668007909482,ECE 200,053,103638,Zhang; Xinyu,9999,0,9999,0
1668007909482,ECE 200,054,103639,Turakhia; Yatish Girish,9999,0,9999,0
1668007909482,ECE 200,055,103640,Kang; Mingu,9999,0,9999,0
1668007909482,ECE 200,056,103641,Shi; Yuanyuan,9999,0,9999,0
1668007909482,ECE 200,057,103642,Wang; Edward Jay,9999,0,9999,0
1668007909482,ECE 200,058,103643,Zheng; Yang,9999,0,9999,0
1668007909905,ECE 202,A00,103644,Kuzum; Duygu,0,0,0,0
1668007910333,ECE 212BN,A00,103646,Ng; Tse Nga,0,0,0,0
1668007910755,ECE 221,A00,111493,Staff,0,0,0,0
1668007911186,ECE 222B,A00,103647,Lomakin; Vitaliy,0,0,0,0
1668007911614,ECE 230B,A00,103648,Taur; Yuan,0,0,0,0
1668007912041,ECE 238B,A00,103649,Garay; Javier,0,0,0,0
1668007912475,ECE 240B,A00,112900,Fainman; Yeshaiahu,0,0,0,0
1668007912899,ECE 247A,A00,103650,Jokerst; Jesse Vincent,0,0,0,0
1668007913323,ECE 247B,A00,103651,Wang; Joseph,0,0,0,0
1668007913768,ECE 250,A00,103652,Siegel; Paul H.,0,0,0,0
1668007914201,ECE 251A,A00,103654,Rao; Bhaskar D.,0,0,0,0
1668007914638,ECE 257B,A00,103655,Bharadia; Dinesh,0,0,0,0
1668007915061,ECE 258A,A00,103656,Milstein; Laurence B.,0,0,0,0
1668007915501,ECE 260B,A00,103658,Kang; Mingu,0,0,0,0
1668007915926,ECE 264A,A00,103659,Galton; Ian A,0,0,0,0
1668007916355,ECE 265A,A00,103661,Gudem; Prasad S.S.,0,0,0,0
1668007916783,ECE 265D,A00,103662,Gudem; Prasad S.S.,0,0,0,0
1668007917207,ECE 268,A00,103663,Koushanfar; Farinaz,0,0,0,0
1668007917632,ECE 269,A01,103665,Pal; Piya,0,0,0,0
1668007918070,ECE 271B,A00,103666,Vasconcelos; Manuela,0,0,0,0
1668007918508,ECE 276A,A00,103667,Atanasov; Nikolay A.,0,0,0,0
1668007918934,ECE 277,A00,103668,An; Cheolhong,0,0,0,0
1668007919361,ECE 279,A00,117947,Hall; Drew A.,0,0,0,0
1668007920218,ECE 283,A00,103670,Hsueh; Tzu-Chien,0,0,0,0
1668007920652,ECE 284,A00,103671,Turakhia; Yatish Girish,0,0,0,0
1668007921085,ECE 285,A00,103672,Zheng; Yang,0,0,0,0
1668007921085,ECE 285,B00,103673,Sworder; David D.,0,0,0,0
1668007921519,ECE 287,A00,103676,Javidi; Tara,0,0,0,0
1668007921944,MATH 200B,A00,098023,Salehi Golsefidy; Alireza,14,0,15,1
1668007922377,MATH 202B,A00,098024,Rhoades; Brendon Patrick,12,0,15,3
1668007922802,MATH 203B,A00,098025,Oprea; Dragos N.,12,0,15,3
1668007923239,MATH 204B,A00,098026,Sorensen; Claus M,14,0,15,1
1668007923664,MATH 208,A00,098027,Izadi; Elham,7,0,10,3
1668007924090,MATH 209,A00,098028,Pollack; Aaron,10,0,10,0
1668007924511,MATH 211A,A00,112919,Rogalski; Daniel,9,0,10,1
1668007924948,MATH 211B,A00,112920,Seward; Brandon M.,9,0,10,1
1668007925374,MATH 218,A00,098029,Li; Bo,10,0,10,0
1668007925798,MATH 220B,A00,098030,Novak; Jonathan I,13,0,15,2
1668007926225,MATH 221A,A00,098031,Ebenfelt; Peter F,13,0,15,2
1668007926646,MATH 231B,A00,098032,Zlatos; Andrej,12,0,15,3
1668007927081,MATH 240B,A00,098033,Ni; Lei,10,0,15,5
1668007927506,MATH 243,A00,098034,Jekel; David Andrew,10,0,10,0
1668007927930,MATH 245A,A00,098035,Nie; Jiawang,0,0,15,16
1668007928367,MATH 248,A00,098036,Bejenaru; Ioan,10,0,10,0
1668007928798,MATH 250B,A00,098037,Spolaor; Luca,14,0,15,1
1668007929228,MATH 258,A00,098038,Ni; Lei,10,0,10,0
1668007929652,MATH 264B,A00,098041,Rhoades; Brendon Patrick,11,0,15,4
1668007930076,MATH 268,A00,098042,Buss; Samuel R,10,0,10,0
1668007930501,MATH 269,A00,098043,Rhoades; Brendon Patrick,10,0,10,0
1668007930924,MATH 270B,A00,098044,Li; Bo,11,0,15,4
1668007931363,MATH 272B,A00,098045,Holst; Michael J,13,0,15,2
1668007931794,MATH 273A,A00,098046,Tian; Xiaochuan,12,0,15,3
1668007932220,MATH 275,A01,098048,Tian; Xiaochuan,6,0,10,4
1668007932651,MATH 278A,A00,098049,Holst; Michael J,8,0,10,2
1668007933077,MATH 278B,A00,098050,Cloninger; Alexander,10,0,10,0
1668007933502,MATH 278C,A00,098051,Nie; Jiawang,8,0,10,2
1668007933929,MATH 280B,A00,098052,Zheng; Tianyi,11,0,15,4
1668007934353,MATH 281B,A00,098053,Bradic; Jelena,4,0,15,11
1668007934777,MATH 282B,A00,098054,Arias-Castro; Ery,2,0,15,13
1668007935205,MATH 285,A00,098055,Fitzsimmons; Patrick J,0,0,15,17
1668007935628,MATH 287B,A00,098056,Arias-Castro; Ery,5,0,15,10
1668007936056,MATH 288,A00,098057,Agarwal; Pooja,9,0,10,1
1668007936056,MATH 288,B00,098058,Zhang; Danna,9,0,10,1
1668007936056,MATH 288,C00,098059,Williams; Ruth J,10,0,10,0
1668007936492,MATH 290B,A00,098060,Roberts; Justin Deritter,14,0,15,1
1668007936915,MATH 292,A00,098061,Belmont; Eva Kinoshita,10,0,10,0
1668007937341,MATH 295,A00,098062,Suk; Andrew Hoon,48,0,50,2
1668007937766,MATH 296,A00,098063,Novak; Jonathan I,20,0,20,0
1668007938190,MATH 297,001,098064,Gamst; Anthony Collins,9997,0,9999,2
1668008440383,COGS 205,A00,101395,Chiba; Andrea,19,0,20,1
1668008440813,COGS 210B,001,101404,Greene; Deanna Jacquelyn,9998,0,9999,1
1668008440813,COGS 210B,002,101417,Xia; Haijun,9999,0,9999,0
1668008440813,COGS 210B,003,101422,Nitz; Douglas A.,9999,0,9999,0
1668008440813,COGS 210B,004,101423,Hollan; James D.,9998,0,9999,1
1668008440813,COGS 210B,005,101424,Deak; Gedeon O.,9999,0,9999,0
1668008440813,COGS 210B,006,101425,Rossano; Federico,9999,0,9999,0
1668008441237,COGS 211B,A00,101427,Coulson; Seana M,9997,0,9999,2
1668008441664,COGS 220,A00,101428,Hollan; James D.,0,0,25,25
1668008442087,COGS 229,A00,101429,Dow; Steven P,18,0,25,7
1668008442528,COGS 230,A00,101430,Klemmer; Scott R,13,0,17,4
1668008442973,COGS 234,A00,101431,Xia; Haijun,7,0,25,18
1668008443400,COGS 260,A00,101432,Kiyonaga; Anastasia,20,0,25,5
1668008443400,COGS 260,B00,101433,Kirsh; David Joel,16,0,25,9
1668008443823,CSE 202,A00,102371,Impagliazzo; Russell,0,0,0,0
1668008444249,CSE 203B,A01,102373,Cheng; Chung Kuan,0,0,0,0
1668008444680,CSE 208,A00,102374,Micciancio; Daniele,0,0,0,0
1668008445105,CSE 209A,A00,112895,Impagliazzo; Russell,0,0,15,15
1668008445535,CSE 209B,A00,108005,Bellare; Mihir,0,0,0,0
1668008445961,CSE 210,A00,113163,Coblenz; Michael J,0,0,0,0
1668008446392,CSE 219,A00,106111,Dow; Steven P,0,0,20,20
1668008446817,CSE 221,A00,102376,Voelker; Geoffrey M.,0,0,0,0
1668008447241,CSE 224,A01,102378,Porter; George M,0,0,0,0
1668008447667,CSE 229A,A00,102379,Savage; Stefan,0,0,0,0
1668008448091,CSE 229C,A00,102380,Munyaka; Imani N. S.,0,0,0,0
1668008448523,CSE 232B,A00,102382,Deutsch; Alin Bernard,0,0,0,0
1668008448949,CSE 234,A01,112904,Kumar; Arun Kumar,0,0,0,0
1668008449373,CSE 237A,A00,102383,Rosing; Tajana Simunic,0,0,0,0
1668008449808,CSE 239A,A00,102384,Deutsch; Alin Bernard,0,0,0,0
1668008450235,CSE 239B,A00,102385,Polikarpova; Nadezhda,0,0,0,0
1668008450658,CSE 240A,A00,102386,Pannuto; Patrick William,0,0,0,0
1668008451081,CSE 240B,A00,102387,Zhao; Jishen,0,0,0,0
1668008451502,CSE 241A,A00,106406,Kang; Mingu,0,0,0,0
1668008451930,CSE 249B,A00,102388,Kahng; Andrew Byun,0,0,8,8
1668008452360,CSE 251B,A01,102392,Cottrell; Garrison W,0,0,0,0
1668008452360,CSE 251B,A02,102393,Cottrell; Garrison W,0,0,0,0
1668008452787,CSE 252B,A00,102394,Ochoa; Benjamin Lawrence,0,0,0,0
1668008453212,CSE 257,A01,102396,Gao; Sicun,0,0,0,0
1668008453646,CSE 272,A00,102397,Li; Tzumao,0,0,0,0
1668008454082,CSE 274,A00,111323,Chern; Albert Ren-Haur,0,0,0,0
1668008454504,CSE 282,A00,102398,Pevzner; Pavel Arkadjevich,0,0,0,0
1668008454925,CSE 284,A00,114175,Gymrek; Melissa Ann,0,0,0,0
1668008455349,CSE 290,A00,102399,Chandraker; Manmohan Krishna,0,0,0,0
1668008455349,CSE 290,B00,102400,Vaccaro; Kristen Marie,0,0,25,25
1668008455349,CSE 290,C00,102414,Pannuto; Patrick William,0,0,25,25
1668008455349,CSE 290,D00,102427,Pevzner; Pavel Arkadjevich,0,0,0,0
1668008455349,CSE 290,E00,102429,Zhao; Jishen,0,0,0,0
1668008455349,CSE 290,F00,102436,Tullsen; Dean Michael,0,0,0,0
1668008455349,CSE 290,G00,102440,Christensen; Henrik I,0,0,20,20
1668008455774,CSE 291,A00,102443,Su; Hao,0,0,0,0
1668008455774,CSE 291,B00,102448,Polikarpova; Nadezhda,0,0,0,0
1668008455774,CSE 291,C00,102453,Vaccaro; Kristen Marie,0,0,0,0
1668008455774,CSE 291,D00,111343,Savage; Stefan,0,0,0,0
1668008455774,CSE 291,E00,116474,Claffy; Kimberly Claire,0,0,0,0
1668008455774,CSE 291,F00,116479,Pasquale; Joseph,0,0,0,0
1668008456216,CSE 293,001,119111,Bafna; Vineet,9999,0,9999,0
1668008456216,CSE 293,002,119118,Bellare; Mihir,9999,0,9999,0
1668008456216,CSE 293,003,119122,Berg-Kirkpatrick; Taylor D,9999,0,9999,0
1668008456216,CSE 293,004,119135,Christensen; Henrik I,9999,0,9999,0
1668008456216,CSE 293,005,119142,Cottrell; Garrison W,9999,0,9999,0
1668008456216,CSE 293,006,119146,Deutsch; Alin Bernard,9999,0,9999,0
1668008456216,CSE 293,007,119159,Esmaeilzadeh; Hadi,9999,0,9999,0
1668008456216,CSE 293,008,119166,Freund; Yoav,9999,0,9999,0
1668008456216,CSE 293,009,119170,Griswold; William G.,9999,0,9999,0
1668008456216,CSE 293,010,119183,Gymrek; Melissa Ann,9999,0,9999,0
1668008456216,CSE 293,011,119190,Heninger; Nadia A,9999,0,9999,0
1668008456216,CSE 293,012,119230,Impagliazzo; Russell,9999,0,9999,0
1668008456216,CSE 293,013,119232,Jhala; Ranjit,9999,0,9999,0
1668008456216,CSE 293,014,119233,Kahng; Andrew Byun,9999,0,9999,0
1668008456216,CSE 293,015,119298,Kane; Daniel Mertz,9999,0,9999,0
1668008456216,CSE 293,016,119299,Kriegman; David J,9999,0,9999,0
1668008456216,CSE 293,017,119300,Kumar; Arun Kumar,9999,0,9999,0
1668008456216,CSE 293,018,119301,Lerner; Sorin,9999,0,9999,0
1668008456216,CSE 293,019,119302,Lovett; Shachar,9999,0,9999,0
1668008456216,CSE 293,020,119303,McAuley; Julian John,9999,0,9999,0
1668008456216,CSE 293,021,119304,Micciancio; Daniele,9999,0,9999,0
1668008456216,CSE 293,022,119367,Orailoglu; Alex,9999,0,9999,0
1668008456216,CSE 293,023,119382,Paturi; Ramamohan,9999,0,9999,0
1668008456216,CSE 293,024,119404,Polikarpova; Nadezhda,9999,0,9999,0
1668008456216,CSE 293,025,119406,Politz; Joseph Gibbs,9999,0,9999,0
1668008456216,CSE 293,026,119411,Porter; George M,9999,0,9999,0
1668008456216,CSE 293,027,119414,Porter; Leonard Emerson,9999,0,9999,0
1668008456216,CSE 293,028,119416,Ramamoorthi; Ravi,9999,0,9999,0
1668008456216,CSE 293,029,119417,Sahoo; Debashis,9999,0,9999,0
1668008456216,CSE 293,030,119420,Saul; Lawrence,9999,0,9999,0
1668008456216,CSE 293,031,119421,Savage; Stefan,9999,0,9999,0
1668008456216,CSE 293,032,119425,Schulze; Jurgen P.,9999,0,9999,0
1668008456216,CSE 293,033,119426,Snoeren; Alex C.,9999,0,9999,0
1668008456216,CSE 293,034,119428,Shang; Jingbo,9999,0,9999,0
1668008456216,CSE 293,035,119430,Stefan; Deian,9999,0,9999,0
1668008456216,CSE 293,036,119431,Su; Hao,9999,0,9999,0
1668008456216,CSE 293,037,119433,Swanson; Steven James,9999,0,9999,0
1668008456216,CSE 293,038,119435,Tullsen; Dean Michael,9999,0,9999,0
1668008456216,CSE 293,039,119483,Voelker; Geoffrey M.,9999,0,9999,0
1668008456216,CSE 293,040,119537,Zhao; Jishen,9999,0,9999,0
1668008456216,CSE 293,041,119538,Zhou; Yuan-Yuan,9999,0,9999,0
1668008456216,CSE 293,042,119539,Gao; Sicun,9999,0,9999,0
1668008456216,CSE 293,043,119540,Weibel; Nadir,9999,0,9999,0
1668008456216,CSE 293,044,119541,Gupta; Rajesh K.,9999,0,9999,0
1668008456216,CSE 293,045,126410,Vaccaro; Kristen Marie,9999,0,9999,0
1668008456216,CSE 293,046,126411,Klemke; Richard,9999,0,9999,0
1668008456650,CSE 294,A00,102459,Voelker; Geoffrey M.,0,0,0,0
1668008456650,CSE 294,B00,111322,Orailoglu; Alex,0,0,0,0
1668008457075,DSE 201,A00,096914,Deutsch; Alin Bernard,30,0,30,0
1668008457498,DSE 210,A00,096915,Dasgupta; Sanjoy,30,0,30,0
1668008457923,DSE 260A,A00,096916,Altintas De Callaf; Ilkay,30,0,30,0
1668008458400,ECE 200,001,103586,Antipa; Nicholas A,9999,0,9999,0
1668008458400,ECE 200,002,103587,Atanasov; Nikolay A.,9999,0,9999,0
1668008458400,ECE 200,003,103588,Bharadia; Dinesh,9999,0,9999,0
1668008458400,ECE 200,004,103589,Cheng; Chung Kuan,9999,0,9999,0
1668008458400,ECE 200,005,103590,Cosman; Pamela C.,9999,0,9999,0
1668008458400,ECE 200,006,103591,Dayeh; Shadi Ahmad,9999,0,9999,0
1668008458400,ECE 200,007,103592,Fainman; Yeshaiahu,9999,0,9999,0
1668008458400,ECE 200,008,103593,Ford; Joseph Earl,9999,0,9999,0
1668008458400,ECE 200,009,103594,Franceschetti; Massimo,9999,0,9999,0
1668008458400,ECE 200,010,103595,Fullerton; Eric E,9999,0,9999,0
1668008458400,ECE 200,011,103596,Galton; Ian A,9999,0,9999,0
1668008458400,ECE 200,012,103597,Gilja; Vikash,9999,0,9999,0
1668008458400,ECE 200,013,103598,Hall; Drew A.,9999,0,9999,0
1668008458400,ECE 200,014,103599,Hsueh; Tzu-Chien,9999,0,9999,0
1668008458400,ECE 200,015,103600,Javidi; Tara,9999,0,9999,0
1668008458400,ECE 200,016,103601,Kahng; Andrew Byun,9999,0,9999,0
1668008458400,ECE 200,017,103602,Kim; Young-Han,9999,0,9999,0
1668008458400,ECE 200,018,103603,Koushanfar; Farinaz,9999,0,9999,0
1668008458400,ECE 200,019,103604,Kuzum; Duygu,9999,0,9999,0
1668008458400,ECE 200,020,103605,Le; Hanh-Phuc,9999,0,9999,0
1668008458400,ECE 200,021,103606,Lin; Bill,9999,0,9999,0
1668008458400,ECE 200,022,103607,Liu; Zhaowei,9998,0,9999,1
1668008458400,ECE 200,023,103608,Lo; Yu-Hwa,9999,0,9999,0
1668008458400,ECE 200,024,103609,Lomakin; Vitaliy,9999,0,9999,0
1668008458400,ECE 200,025,103610,Mercier; Patrick Philip,9999,0,9999,0
1668008458400,ECE 200,026,103611,Meyer; Florian,9999,0,9999,0
1668008458400,ECE 200,027,103612,Milstein; Laurence B.,9999,0,9999,0
1668008458400,ECE 200,028,103613,Mir Arabbaygi; Siavash,9999,0,9999,0
1668008458400,ECE 200,029,103614,Mookherjea; Shayan,9999,0,9999,0
1668008458400,ECE 200,030,103615,Morris; Karcher William,9999,0,9999,0
1668008458400,ECE 200,031,103616,Ng; Tse Nga,9999,0,9999,0
1668008458400,ECE 200,032,103617,Nguyen; Truong Quang,9999,0,9999,0
1668008458400,ECE 200,033,103618,Nomura; Kenji,9999,0,9999,0
1668008458400,ECE 200,034,103619,Orlitsky; Alon,9999,0,9999,0
1668008458400,ECE 200,035,103620,Pal; Piya,9999,0,9999,0
1668008458400,ECE 200,036,103621,Papen; George C.,9999,0,9999,0
1668008458400,ECE 200,037,103622,Radic; Stojan,9999,0,9999,0
1668008458400,ECE 200,038,103623,Rao; Bhaskar D.,9999,0,9999,0
1668008458400,ECE 200,039,103624,Rao; Ramesh R,9999,0,9999,0
1668008458400,ECE 200,040,103625,Rebeiz; Gabriel,9999,0,9999,0
1668008458400,ECE 200,041,103626,Sanford; John R,9999,0,9999,0
1668008458400,ECE 200,042,103627,Siegel; Paul H.,9999,0,9999,0
1668008458400,ECE 200,043,103628,Sievenpiper; Daniel F.,9999,0,9999,0
1668008458400,ECE 200,044,103629,Sworder; David D.,9999,0,9999,0
1668008458400,ECE 200,045,103630,Taur; Yuan,9999,0,9999,0
1668008458400,ECE 200,046,103631,Touri; Behrouz,9999,0,9999,0
1668008458400,ECE 200,047,103632,Trivedi; Mohan M.,9999,0,9999,0
1668008458400,ECE 200,048,103633,Vasconcelos; Nuno,9999,0,9999,0
1668008458400,ECE 200,049,103634,Wang; Xiaolong,9999,0,9999,0
1668008458400,ECE 200,050,103635,Xie; Pengtao,9999,0,9999,0
1668008458400,ECE 200,051,103636,Yip; Michael,9999,0,9999,0
1668008458400,ECE 200,052,103637,Zeger; Kenneth A.,999,0,999,0
1668008458400,ECE 200,053,103638,Zhang; Xinyu,9999,0,9999,0
1668008458400,ECE 200,054,103639,Turakhia; Yatish Girish,9999,0,9999,0
1668008458400,ECE 200,055,103640,Kang; Mingu,9999,0,9999,0
1668008458400,ECE 200,056,103641,Shi; Yuanyuan,9999,0,9999,0
1668008458400,ECE 200,057,103642,Wang; Edward Jay,9999,0,9999,0
1668008458400,ECE 200,058,103643,Zheng; Yang,9999,0,9999,0
1668008458824,ECE 202,A00,103644,Kuzum; Duygu,0,0,0,0
1668008459249,ECE 212BN,A00,103646,Ng; Tse Nga,0,0,0,0
1668008459689,ECE 221,A00,111493,Staff,0,0,0,0
1668008460115,ECE 222B,A00,103647,Lomakin; Vitaliy,0,0,0,0
1668008460544,ECE 230B,A00,103648,Taur; Yuan,0,0,0,0
1668008460984,ECE 238B,A00,103649,Garay; Javier,0,0,0,0
1668008461409,ECE 240B,A00,112900,Fainman; Yeshaiahu,0,0,0,0
1668008461834,ECE 247A,A00,103650,Jokerst; Jesse Vincent,0,0,0,0
1668008462258,ECE 247B,A00,103651,Wang; Joseph,0,0,0,0
1668008462680,ECE 250,A00,103652,Siegel; Paul H.,0,0,0,0
1668008463105,ECE 251A,A00,103654,Rao; Bhaskar D.,0,0,0,0
1668008463545,ECE 257B,A00,103655,Bharadia; Dinesh,0,0,0,0
1668008463970,ECE 258A,A00,103656,Milstein; Laurence B.,0,0,0,0
1668008464476,ECE 260B,A00,103658,Kang; Mingu,0,0,0,0
1668008464913,ECE 264A,A00,103659,Galton; Ian A,0,0,0,0
1668008465351,ECE 265A,A00,103661,Gudem; Prasad S.S.,0,0,0,0
1668008465774,ECE 265D,A00,103662,Gudem; Prasad S.S.,0,0,0,0
1668008466197,ECE 268,A00,103663,Koushanfar; Farinaz,0,0,0,0
1668008466627,ECE 269,A01,103665,Pal; Piya,0,0,0,0
1668008467053,ECE 271B,A00,103666,Vasconcelos; Manuela,0,0,0,0
1668008467484,ECE 276A,A00,103667,Atanasov; Nikolay A.,0,0,0,0
1668008467909,ECE 277,A00,103668,An; Cheolhong,0,0,0,0
1668008468332,ECE 279,A00,117947,Hall; Drew A.,0,0,0,0
1668008469206,ECE 283,A00,103670,Hsueh; Tzu-Chien,0,0,0,0
1668008469631,ECE 284,A00,103671,Turakhia; Yatish Girish,0,0,0,0
1668008470072,ECE 285,A00,103672,Zheng; Yang,0,0,0,0
1668008470072,ECE 285,B00,103673,Sworder; David D.,0,0,0,0
1668008470507,ECE 287,A00,103676,Javidi; Tara,0,0,0,0
1668008470942,MATH 200B,A00,098023,Salehi Golsefidy; Alireza,14,0,15,1
1668008471382,MATH 202B,A00,098024,Rhoades; Brendon Patrick,12,0,15,3
1668008471805,MATH 203B,A00,098025,Oprea; Dragos N.,12,0,15,3
1668008472245,MATH 204B,A00,098026,Sorensen; Claus M,14,0,15,1
1668008472678,MATH 208,A00,098027,Izadi; Elham,7,0,10,3
1668008473103,MATH 209,A00,098028,Pollack; Aaron,10,0,10,0
1668008473525,MATH 211A,A00,112919,Rogalski; Daniel,9,0,10,1
1668008473954,MATH 211B,A00,112920,Seward; Brandon M.,9,0,10,1
1668008474387,MATH 218,A00,098029,Li; Bo,10,0,10,0
1668008474813,MATH 220B,A00,098030,Novak; Jonathan I,13,0,15,2
1668008475239,MATH 221A,A00,098031,Ebenfelt; Peter F,13,0,15,2
1668008475662,MATH 231B,A00,098032,Zlatos; Andrej,12,0,15,3
1668008476085,MATH 240B,A00,098033,Ni; Lei,10,0,15,5
1668008476511,MATH 243,A00,098034,Jekel; David Andrew,10,0,10,0
1668008476945,MATH 245A,A00,098035,Nie; Jiawang,0,0,15,16
1668008477383,MATH 248,A00,098036,Bejenaru; Ioan,10,0,10,0
1668008477808,MATH 250B,A00,098037,Spolaor; Luca,14,0,15,1
1668008478244,MATH 258,A00,098038,Ni; Lei,10,0,10,0
1668008478675,MATH 264B,A00,098041,Rhoades; Brendon Patrick,11,0,15,4
1668008479119,MATH 268,A00,098042,Buss; Samuel R,10,0,10,0
1668008479549,MATH 269,A00,098043,Rhoades; Brendon Patrick,10,0,10,0
1668008479977,MATH 270B,A00,098044,Li; Bo,11,0,15,4
1668008480399,MATH 272B,A00,098045,Holst; Michael J,13,0,15,2
1668008480831,MATH 273A,A00,098046,Tian; Xiaochuan,12,0,15,3
1668008481262,MATH 275,A01,098048,Tian; Xiaochuan,6,0,10,4
1668008481696,MATH 278A,A00,098049,Holst; Michael J,8,0,10,2
1668008482119,MATH 278B,A00,098050,Cloninger; Alexander,10,0,10,0
1668008482544,MATH 278C,A00,098051,Nie; Jiawang,8,0,10,2
1668008482966,MATH 280B,A00,098052,Zheng; Tianyi,11,0,15,4
1668008483404,MATH 281B,A00,098053,Bradic; Jelena,4,0,15,11
1668008483831,MATH 282B,A00,098054,Arias-Castro; Ery,2,0,15,13
1668008484269,MATH 285,A00,098055,Fitzsimmons; Patrick J,0,0,15,17
1668008484694,MATH 287B,A00,098056,Arias-Castro; Ery,5,0,15,10
1668008485120,MATH 288,A00,098057,Agarwal; Pooja,9,0,10,1
1668008485120,MATH 288,B00,098058,Zhang; Danna,9,0,10,1
1668008485120,MATH 288,C00,098059,Williams; Ruth J,10,0,10,0
1668008485549,MATH 290B,A00,098060,Roberts; Justin Deritter,14,0,15,1
1668008485972,MATH 292,A00,098061,Belmont; Eva Kinoshita,10,0,10,0
1668008486401,MATH 295,A00,098062,Suk; Andrew Hoon,48,0,50,2
1668008486825,MATH 296,A00,098063,Novak; Jonathan I,20,0,20,0
1668008487264,MATH 297,001,098064,Gamst; Anthony Collins,9997,0,9999,2
1668008988921,COGS 205,A00,101395,Chiba; Andrea,19,0,20,1
1668008989345,COGS 210B,001,101404,Greene; Deanna Jacquelyn,9998,0,9999,1
1668008989345,COGS 210B,002,101417,Xia; Haijun,9999,0,9999,0
1668008989345,COGS 210B,003,101422,Nitz; Douglas A.,9999,0,9999,0
1668008989345,COGS 210B,004,101423,Hollan; James D.,9998,0,9999,1
1668008989345,COGS 210B,005,101424,Deak; Gedeon O.,9999,0,9999,0
1668008989345,COGS 210B,006,101425,Rossano; Federico,9999,0,9999,0
1668008989770,COGS 211B,A00,101427,Coulson; Seana M,9997,0,9999,2
1668008990194,COGS 220,A00,101428,Hollan; James D.,0,0,25,25
1668008990619,COGS 229,A00,101429,Dow; Steven P,18,0,25,7
1668008991042,COGS 230,A00,101430,Klemmer; Scott R,13,0,17,4
1668008991467,COGS 234,A00,101431,Xia; Haijun,7,0,25,18
1668008991891,COGS 260,A00,101432,Kiyonaga; Anastasia,20,0,25,5
1668008991891,COGS 260,B00,101433,Kirsh; David Joel,16,0,25,9
1668008992312,CSE 202,A00,102371,Impagliazzo; Russell,0,0,0,0
1668008992746,CSE 203B,A01,102373,Cheng; Chung Kuan,0,0,0,0
1668008993171,CSE 208,A00,102374,Micciancio; Daniele,0,0,0,0
1668008993596,CSE 209A,A00,112895,Impagliazzo; Russell,0,0,15,15
1668008994019,CSE 209B,A00,108005,Bellare; Mihir,0,0,0,0
1668008994448,CSE 210,A00,113163,Coblenz; Michael J,0,0,0,0
1668008994870,CSE 219,A00,106111,Dow; Steven P,0,0,20,20
1668008995293,CSE 221,A00,102376,Voelker; Geoffrey M.,0,0,0,0
1668008995720,CSE 224,A01,102378,Porter; George M,0,0,0,0
1668008996143,CSE 229A,A00,102379,Savage; Stefan,0,0,0,0
1668008996576,CSE 229C,A00,102380,Munyaka; Imani N. S.,0,0,0,0
1668008997004,CSE 232B,A00,102382,Deutsch; Alin Bernard,0,0,0,0
1668008997427,CSE 234,A01,112904,Kumar; Arun Kumar,0,0,0,0
1668008997852,CSE 237A,A00,102383,Rosing; Tajana Simunic,0,0,0,0
1668008998275,CSE 239A,A00,102384,Deutsch; Alin Bernard,0,0,0,0
1668008998699,CSE 239B,A00,102385,Polikarpova; Nadezhda,0,0,0,0
1668008999132,CSE 240A,A00,102386,Pannuto; Patrick William,0,0,0,0
1668008999554,CSE 240B,A00,102387,Zhao; Jishen,0,0,0,0
1668008999982,CSE 241A,A00,106406,Kang; Mingu,0,0,0,0
1668009000410,CSE 249B,A00,102388,Kahng; Andrew Byun,0,0,8,8
1668009000836,CSE 251B,A01,102392,Cottrell; Garrison W,0,0,0,0
1668009000836,CSE 251B,A02,102393,Cottrell; Garrison W,0,0,0,0
1668009001267,CSE 252B,A00,102394,Ochoa; Benjamin Lawrence,0,0,0,0
1668009001696,CSE 257,A01,102396,Gao; Sicun,0,0,0,0
1668009002121,CSE 272,A00,102397,Li; Tzumao,0,0,0,0
1668009002555,CSE 274,A00,111323,Chern; Albert Ren-Haur,0,0,0,0
1668009002987,CSE 282,A00,102398,Pevzner; Pavel Arkadjevich,0,0,0,0
1668009003413,CSE 284,A00,114175,Gymrek; Melissa Ann,0,0,0,0
1668009003837,CSE 290,A00,102399,Chandraker; Manmohan Krishna,0,0,0,0
1668009003837,CSE 290,B00,102400,Vaccaro; Kristen Marie,0,0,25,25
1668009003837,CSE 290,C00,102414,Pannuto; Patrick William,0,0,25,25
1668009003837,CSE 290,D00,102427,Pevzner; Pavel Arkadjevich,0,0,0,0
1668009003837,CSE 290,E00,102429,Zhao; Jishen,0,0,0,0
1668009003837,CSE 290,F00,102436,Tullsen; Dean Michael,0,0,0,0
1668009003837,CSE 290,G00,102440,Christensen; Henrik I,0,0,20,20
1668009004269,CSE 291,A00,102443,Su; Hao,0,0,0,0
1668009004269,CSE 291,B00,102448,Polikarpova; Nadezhda,0,0,0,0
1668009004269,CSE 291,C00,102453,Vaccaro; Kristen Marie,0,0,0,0
1668009004269,CSE 291,D00,111343,Savage; Stefan,0,0,0,0
1668009004269,CSE 291,E00,116474,Claffy; Kimberly Claire,0,0,0,0
1668009004269,CSE 291,F00,116479,Pasquale; Joseph,0,0,0,0
1668009004724,CSE 293,001,119111,Bafna; Vineet,9999,0,9999,0
1668009004724,CSE 293,002,119118,Bellare; Mihir,9999,0,9999,0
1668009004724,CSE 293,003,119122,Berg-Kirkpatrick; Taylor D,9999,0,9999,0
1668009004724,CSE 293,004,119135,Christensen; Henrik I,9999,0,9999,0
1668009004724,CSE 293,005,119142,Cottrell; Garrison W,9999,0,9999,0
1668009004724,CSE 293,006,119146,Deutsch; Alin Bernard,9999,0,9999,0
1668009004724,CSE 293,007,119159,Esmaeilzadeh; Hadi,9999,0,9999,0
1668009004724,CSE 293,008,119166,Freund; Yoav,9999,0,9999,0
1668009004724,CSE 293,009,119170,Griswold; William G.,9999,0,9999,0
1668009004724,CSE 293,010,119183,Gymrek; Melissa Ann,9999,0,9999,0
1668009004724,CSE 293,011,119190,Heninger; Nadia A,9999,0,9999,0
1668009004724,CSE 293,012,119230,Impagliazzo; Russell,9999,0,9999,0
1668009004724,CSE 293,013,119232,Jhala; Ranjit,9999,0,9999,0
1668009004724,CSE 293,014,119233,Kahng; Andrew Byun,9999,0,9999,0
1668009004724,CSE 293,015,119298,Kane; Daniel Mertz,9999,0,9999,0
1668009004724,CSE 293,016,119299,Kriegman; David J,9999,0,9999,0
1668009004724,CSE 293,017,119300,Kumar; Arun Kumar,9999,0,9999,0
1668009004724,CSE 293,018,119301,Lerner; Sorin,9999,0,9999,0
1668009004724,CSE 293,019,119302,Lovett; Shachar,9999,0,9999,0
1668009004724,CSE 293,020,119303,McAuley; Julian John,9999,0,9999,0
1668009004724,CSE 293,021,119304,Micciancio; Daniele,9999,0,9999,0
1668009004724,CSE 293,022,119367,Orailoglu; Alex,9999,0,9999,0
1668009004724,CSE 293,023,119382,Paturi; Ramamohan,9999,0,9999,0
1668009004724,CSE 293,024,119404,Polikarpova; Nadezhda,9999,0,9999,0
1668009004724,CSE 293,025,119406,Politz; Joseph Gibbs,9999,0,9999,0
1668009004724,CSE 293,026,119411,Porter; George M,9999,0,9999,0
1668009004724,CSE 293,027,119414,Porter; Leonard Emerson,9999,0,9999,0
1668009004724,CSE 293,028,119416,Ramamoorthi; Ravi,9999,0,9999,0
1668009004724,CSE 293,029,119417,Sahoo; Debashis,9999,0,9999,0
1668009004724,CSE 293,030,119420,Saul; Lawrence,9999,0,9999,0
1668009004724,CSE 293,031,119421,Savage; Stefan,9999,0,9999,0
1668009004724,CSE 293,032,119425,Schulze; Jurgen P.,9999,0,9999,0
1668009004724,CSE 293,033,119426,Snoeren; Alex C.,9999,0,9999,0
1668009004724,CSE 293,034,119428,Shang; Jingbo,9999,0,9999,0
1668009004724,CSE 293,035,119430,Stefan; Deian,9999,0,9999,0
1668009004724,CSE 293,036,119431,Su; Hao,9999,0,9999,0
1668009004724,CSE 293,037,119433,Swanson; Steven James,9999,0,9999,0
1668009004724,CSE 293,038,119435,Tullsen; Dean Michael,9999,0,9999,0
1668009004724,CSE 293,039,119483,Voelker; Geoffrey M.,9999,0,9999,0
1668009004724,CSE 293,040,119537,Zhao; Jishen,9999,0,9999,0
1668009004724,CSE 293,041,119538,Zhou; Yuan-Yuan,9999,0,9999,0
1668009004724,CSE 293,042,119539,Gao; Sicun,9999,0,9999,0
1668009004724,CSE 293,043,119540,Weibel; Nadir,9999,0,9999,0
1668009004724,CSE 293,044,119541,Gupta; Rajesh K.,9999,0,9999,0
1668009004724,CSE 293,045,126410,Vaccaro; Kristen Marie,9999,0,9999,0
1668009004724,CSE 293,046,126411,Klemke; Richard,9999,0,9999,0
1668009005147,CSE 294,A00,102459,Voelker; Geoffrey M.,0,0,0,0
1668009005147,CSE 294,B00,111322,Orailoglu; Alex,0,0,0,0
1668009005570,DSE 201,A00,096914,Deutsch; Alin Bernard,30,0,30,0
1668009005997,DSE 210,A00,096915,Dasgupta; Sanjoy,30,0,30,0
1668009006433,DSE 260A,A00,096916,Altintas De Callaf; Ilkay,30,0,30,0
1668009006876,ECE 200,001,103586,Antipa; Nicholas A,9999,0,9999,0
1668009006876,ECE 200,002,103587,Atanasov; Nikolay A.,9999,0,9999,0
1668009006876,ECE 200,003,103588,Bharadia; Dinesh,9999,0,9999,0
1668009006876,ECE 200,004,103589,Cheng; Chung Kuan,9999,0,9999,0
1668009006876,ECE 200,005,103590,Cosman; Pamela C.,9999,0,9999,0
1668009006876,ECE 200,006,103591,Dayeh; Shadi Ahmad,9999,0,9999,0
1668009006876,ECE 200,007,103592,Fainman; Yeshaiahu,9999,0,9999,0
1668009006876,ECE 200,008,103593,Ford; Joseph Earl,9999,0,9999,0
1668009006876,ECE 200,009,103594,Franceschetti; Massimo,9999,0,9999,0
1668009006876,ECE 200,010,103595,Fullerton; Eric E,9999,0,9999,0
1668009006876,ECE 200,011,103596,Galton; Ian A,9999,0,9999,0
1668009006876,ECE 200,012,103597,Gilja; Vikash,9999,0,9999,0
1668009006876,ECE 200,013,103598,Hall; Drew A.,9999,0,9999,0
1668009006876,ECE 200,014,103599,Hsueh; Tzu-Chien,9999,0,9999,0
1668009006876,ECE 200,015,103600,Javidi; Tara,9999,0,9999,0
1668009006876,ECE 200,016,103601,Kahng; Andrew Byun,9999,0,9999,0
1668009006876,ECE 200,017,103602,Kim; Young-Han,9999,0,9999,0
1668009006876,ECE 200,018,103603,Koushanfar; Farinaz,9999,0,9999,0
1668009006876,ECE 200,019,103604,Kuzum; Duygu,9999,0,9999,0
1668009006876,ECE 200,020,103605,Le; Hanh-Phuc,9999,0,9999,0
1668009006876,ECE 200,021,103606,Lin; Bill,9999,0,9999,0
1668009006876,ECE 200,022,103607,Liu; Zhaowei,9998,0,9999,1
1668009006876,ECE 200,023,103608,Lo; Yu-Hwa,9999,0,9999,0
1668009006876,ECE 200,024,103609,Lomakin; Vitaliy,9999,0,9999,0
1668009006876,ECE 200,025,103610,Mercier; Patrick Philip,9999,0,9999,0
1668009006876,ECE 200,026,103611,Meyer; Florian,9999,0,9999,0
1668009006876,ECE 200,027,103612,Milstein; Laurence B.,9999,0,9999,0
1668009006876,ECE 200,028,103613,Mir Arabbaygi; Siavash,9999,0,9999,0
1668009006876,ECE 200,029,103614,Mookherjea; Shayan,9999,0,9999,0
1668009006876,ECE 200,030,103615,Morris; Karcher William,9999,0,9999,0
1668009006876,ECE 200,031,103616,Ng; Tse Nga,9999,0,9999,0
1668009006876,ECE 200,032,103617,Nguyen; Truong Quang,9999,0,9999,0
1668009006876,ECE 200,033,103618,Nomura; Kenji,9999,0,9999,0
1668009006876,ECE 200,034,103619,Orlitsky; Alon,9999,0,9999,0
1668009006876,ECE 200,035,103620,Pal; Piya,9999,0,9999,0
1668009006876,ECE 200,036,103621,Papen; George C.,9999,0,9999,0
1668009006876,ECE 200,037,103622,Radic; Stojan,9999,0,9999,0
1668009006876,ECE 200,038,103623,Rao; Bhaskar D.,9999,0,9999,0
1668009006876,ECE 200,039,103624,Rao; Ramesh R,9999,0,9999,0
1668009006876,ECE 200,040,103625,Rebeiz; Gabriel,9999,0,9999,0
1668009006876,ECE 200,041,103626,Sanford; John R,9999,0,9999,0
1668009006876,ECE 200,042,103627,Siegel; Paul H.,9999,0,9999,0
1668009006876,ECE 200,043,103628,Sievenpiper; Daniel F.,9999,0,9999,0
1668009006876,ECE 200,044,103629,Sworder; David D.,9999,0,9999,0
1668009006876,ECE 200,045,103630,Taur; Yuan,9999,0,9999,0
1668009006876,ECE 200,046,103631,Touri; Behrouz,9999,0,9999,0
1668009006876,ECE 200,047,103632,Trivedi; Mohan M.,9999,0,9999,0
1668009006876,ECE 200,048,103633,Vasconcelos; Nuno,9999,0,9999,0
1668009006876,ECE 200,049,103634,Wang; Xiaolong,9999,0,9999,0
1668009006876,ECE 200,050,103635,Xie; Pengtao,9999,0,9999,0
1668009006876,ECE 200,051,103636,Yip; Michael,9999,0,9999,0
1668009006876,ECE 200,052,103637,Zeger; Kenneth A.,999,0,999,0
1668009006876,ECE 200,053,103638,Zhang; Xinyu,9999,0,9999,0
1668009006876,ECE 200,054,103639,Turakhia; Yatish Girish,9999,0,9999,0
1668009006876,ECE 200,055,103640,Kang; Mingu,9999,0,9999,0
1668009006876,ECE 200,056,103641,Shi; Yuanyuan,9999,0,9999,0
1668009006876,ECE 200,057,103642,Wang; Edward Jay,9999,0,9999,0
1668009006876,ECE 200,058,103643,Zheng; Yang,9999,0,9999,0
1668009007305,ECE 202,A00,103644,Kuzum; Duygu,0,0,0,0
1668009007733,ECE 212BN,A00,103646,Ng; Tse Nga,0,0,0,0
1668009008161,ECE 221,A00,111493,Staff,0,0,0,0
1668009008605,ECE 222B,A00,103647,Lomakin; Vitaliy,0,0,0,0
1668009009029,ECE 230B,A00,103648,Taur; Yuan,0,0,0,0
1668009009453,ECE 238B,A00,103649,Garay; Javier,0,0,0,0
1668009009878,ECE 240B,A00,112900,Fainman; Yeshaiahu,0,0,0,0
1668009010305,ECE 247A,A00,103650,Jokerst; Jesse Vincent,0,0,0,0
1668009010736,ECE 247B,A00,103651,Wang; Joseph,0,0,0,0
1668009011167,ECE 250,A00,103652,Siegel; Paul H.,0,0,0,0
1668009011590,ECE 251A,A00,103654,Rao; Bhaskar D.,0,0,0,0
1668009012013,ECE 257B,A00,103655,Bharadia; Dinesh,0,0,0,0
1668009012439,ECE 258A,A00,103656,Milstein; Laurence B.,0,0,0,0
1668009012865,ECE 260B,A00,103658,Kang; Mingu,0,0,0,0
1668009013290,ECE 264A,A00,103659,Galton; Ian A,0,0,0,0
1668009013722,ECE 265A,A00,103661,Gudem; Prasad S.S.,0,0,0,0
1668009014146,ECE 265D,A00,103662,Gudem; Prasad S.S.,0,0,0,0
1668009014578,ECE 268,A00,103663,Koushanfar; Farinaz,0,0,0,0
1668009015003,ECE 269,A01,103665,Pal; Piya,0,0,0,0
1668009015440,ECE 271B,A00,103666,Vasconcelos; Manuela,0,0,0,0
1668009015868,ECE 276A,A00,103667,Atanasov; Nikolay A.,0,0,0,0
1668009016301,ECE 277,A00,103668,An; Cheolhong,0,0,0,0
1668009016729,ECE 279,A00,117947,Hall; Drew A.,0,0,0,0
1668009017583,ECE 283,A00,103670,Hsueh; Tzu-Chien,0,0,0,0
1668009018006,ECE 284,A00,103671,Turakhia; Yatish Girish,0,0,0,0
1668009018429,ECE 285,A00,103672,Zheng; Yang,0,0,0,0
1668009018429,ECE 285,B00,103673,Sworder; David D.,0,0,0,0
1668009018855,ECE 287,A00,103676,Javidi; Tara,0,0,0,0
1668009019278,MATH 200B,A00,098023,Salehi Golsefidy; Alireza,14,0,15,1
1668009019704,MATH 202B,A00,098024,Rhoades; Brendon Patrick,12,0,15,3
1668009020129,MATH 203B,A00,098025,Oprea; Dragos N.,12,0,15,3
1668009020565,MATH 204B,A00,098026,Sorensen; Claus M,14,0,15,1
1668009020999,MATH 208,A00,098027,Izadi; Elham,7,0,10,3
1668009021435,MATH 209,A00,098028,Pollack; Aaron,10,0,10,0
1668009021858,MATH 211A,A00,112919,Rogalski; Daniel,9,0,10,1
1668009022284,MATH 211B,A00,112920,Seward; Brandon M.,9,0,10,1
1668009022709,MATH 218,A00,098029,Li; Bo,10,0,10,0
1668009023136,MATH 220B,A00,098030,Novak; Jonathan I,13,0,15,2
1668009023582,MATH 221A,A00,098031,Ebenfelt; Peter F,13,0,15,2
1668009024004,MATH 231B,A00,098032,Zlatos; Andrej,12,0,15,3
1668009024439,MATH 240B,A00,098033,Ni; Lei,10,0,15,5
1668009024874,MATH 243,A00,098034,Jekel; David Andrew,10,0,10,0
1668009025305,MATH 245A,A00,098035,Nie; Jiawang,0,0,15,16
1668009025744,MATH 248,A00,098036,Bejenaru; Ioan,10,0,10,0
1668009026167,MATH 250B,A00,098037,Spolaor; Luca,14,0,15,1
1668009026592,MATH 258,A00,098038,Ni; Lei,10,0,10,0
1668009027015,MATH 264B,A00,098041,Rhoades; Brendon Patrick,11,0,15,4
1668009027439,MATH 268,A00,098042,Buss; Samuel R,10,0,10,0
1668009027871,MATH 269,A00,098043,Rhoades; Brendon Patrick,10,0,10,0
1668009028294,MATH 270B,A00,098044,Li; Bo,11,0,15,4
1668009028737,MATH 272B,A00,098045,Holst; Michael J,13,0,15,2
1668009029170,MATH 273A,A00,098046,Tian; Xiaochuan,12,0,15,3
1668009029691,MATH 275,A01,098048,Tian; Xiaochuan,6,0,10,4
1668009030125,MATH 278A,A00,098049,Holst; Michael J,8,0,10,2
1668009030550,MATH 278B,A00,098050,Cloninger; Alexander,10,0,10,0
1668009030973,MATH 278C,A00,098051,Nie; Jiawang,8,0,10,2
1668009031400,MATH 280B,A00,098052,Zheng; Tianyi,11,0,15,4
1668009031827,MATH 281B,A00,098053,Bradic; Jelena,4,0,15,11
1668009032263,MATH 282B,A00,098054,Arias-Castro; Ery,2,0,15,13
1668009032685,MATH 285,A00,098055,Fitzsimmons; Patrick J,0,0,15,17
1668009033117,MATH 287B,A00,098056,Arias-Castro; Ery,5,0,15,10
1668009033540,MATH 288,A00,098057,Agarwal; Pooja,9,0,10,1
1668009033540,MATH 288,B00,098058,Zhang; Danna,9,0,10,1
1668009033540,MATH 288,C00,098059,Williams; Ruth J,10,0,10,0
1668009033971,MATH 290B,A00,098060,Roberts; Justin Deritter,14,0,15,1
1668009034399,MATH 292,A00,098061,Belmont; Eva Kinoshita,10,0,10,0
1668009034837,MATH 295,A00,098062,Suk; Andrew Hoon,48,0,50,2
1668009035267,MATH 296,A00,098063,Novak; Jonathan I,20,0,20,0
1668009035706,MATH 297,001,098064,Gamst; Anthony Collins,9997,0,9999,2
1668009538014,COGS 205,A00,101395,Chiba; Andrea,19,0,20,1
1668009538437,COGS 210B,001,101404,Greene; Deanna Jacquelyn,9998,0,9999,1
1668009538437,COGS 210B,002,101417,Xia; Haijun,9999,0,9999,0
1668009538437,COGS 210B,003,101422,Nitz; Douglas A.,9999,0,9999,0
1668009538437,COGS 210B,004,101423,Hollan; James D.,9998,0,9999,1
1668009538437,COGS 210B,005,101424,Deak; Gedeon O.,9999,0,9999,0
1668009538437,COGS 210B,006,101425,Rossano; Federico,9999,0,9999,0
1668009538863,COGS 211B,A00,101427,Coulson; Seana M,9997,0,9999,2
1668009539286,COGS 220,A00,101428,Hollan; James D.,0,0,25,25
1668009539714,COGS 229,A00,101429,Dow; Steven P,18,0,25,7
1668009540138,COGS 230,A00,101430,Klemmer; Scott R,13,0,17,4
1668009540565,COGS 234,A00,101431,Xia; Haijun,7,0,25,18
1668009541004,COGS 260,A00,101432,Kiyonaga; Anastasia,20,0,25,5
1668009541004,COGS 260,B00,101433,Kirsh; David Joel,16,0,25,9
1668009541426,CSE 202,A00,102371,Impagliazzo; Russell,0,0,0,0
1668009541860,CSE 203B,A01,102373,Cheng; Chung Kuan,0,0,0,0
1668009542292,CSE 208,A00,102374,Micciancio; Daniele,0,0,0,0
1668009542717,CSE 209A,A00,112895,Impagliazzo; Russell,0,0,15,15
1668009543146,CSE 209B,A00,108005,Bellare; Mihir,0,0,0,0
1668009543574,CSE 210,A00,113163,Coblenz; Michael J,0,0,0,0
1668009544013,CSE 219,A00,106111,Dow; Steven P,0,0,20,20
1668009544437,CSE 221,A00,102376,Voelker; Geoffrey M.,0,0,0,0
1668009544863,CSE 224,A01,102378,Porter; George M,0,0,0,0
1668009545285,CSE 229A,A00,102379,Savage; Stefan,0,0,0,0
1668009545710,CSE 229C,A00,102380,Munyaka; Imani N. S.,0,0,0,0
1668009546138,CSE 232B,A00,102382,Deutsch; Alin Bernard,0,0,0,0
1668009546564,CSE 234,A01,112904,Kumar; Arun Kumar,0,0,0,0
1668009546988,CSE 237A,A00,102383,Rosing; Tajana Simunic,0,0,0,0
1668009547417,CSE 239A,A00,102384,Deutsch; Alin Bernard,0,0,0,0
1668009547845,CSE 239B,A00,102385,Polikarpova; Nadezhda,0,0,0,0
1668009548267,CSE 240A,A00,102386,Pannuto; Patrick William,0,0,0,0
1668009548692,CSE 240B,A00,102387,Zhao; Jishen,0,0,0,0
1668009549116,CSE 241A,A00,106406,Kang; Mingu,0,0,0,0
1668009549545,CSE 249B,A00,102388,Kahng; Andrew Byun,0,0,8,8
1668009549968,CSE 251B,A01,102392,Cottrell; Garrison W,0,0,0,0
1668009549968,CSE 251B,A02,102393,Cottrell; Garrison W,0,0,0,0
1668009550391,CSE 252B,A00,102394,Ochoa; Benjamin Lawrence,0,0,0,0
1668009550813,CSE 257,A01,102396,Gao; Sicun,0,0,0,0
1668009551242,CSE 272,A00,102397,Li; Tzumao,0,0,0,0
1668009551665,CSE 274,A00,111323,Chern; Albert Ren-Haur,0,0,0,0
1668009552166,CSE 282,A00,102398,Pevzner; Pavel Arkadjevich,0,0,0,0
1668009552610,CSE 284,A00,114175,Gymrek; Melissa Ann,0,0,0,0
1668009553034,CSE 290,A00,102399,Chandraker; Manmohan Krishna,0,0,0,0
1668009553034,CSE 290,B00,102400,Vaccaro; Kristen Marie,0,0,25,25
1668009553034,CSE 290,C00,102414,Pannuto; Patrick William,0,0,25,25
1668009553034,CSE 290,D00,102427,Pevzner; Pavel Arkadjevich,0,0,0,0
1668009553034,CSE 290,E00,102429,Zhao; Jishen,0,0,0,0
1668009553034,CSE 290,F00,102436,Tullsen; Dean Michael,0,0,0,0
1668009553034,CSE 290,G00,102440,Christensen; Henrik I,0,0,20,20
1668009553462,CSE 291,A00,102443,Su; Hao,0,0,0,0
1668009553462,CSE 291,B00,102448,Polikarpova; Nadezhda,0,0,0,0
1668009553462,CSE 291,C00,102453,Vaccaro; Kristen Marie,0,0,0,0
1668009553462,CSE 291,D00,111343,Savage; Stefan,0,0,0,0
1668009553462,CSE 291,E00,116474,Claffy; Kimberly Claire,0,0,0,0
1668009553462,CSE 291,F00,116479,Pasquale; Joseph,0,0,0,0
1668009553911,CSE 293,001,119111,Bafna; Vineet,9999,0,9999,0
1668009553911,CSE 293,002,119118,Bellare; Mihir,9999,0,9999,0
1668009553911,CSE 293,003,119122,Berg-Kirkpatrick; Taylor D,9999,0,9999,0
1668009553911,CSE 293,004,119135,Christensen; Henrik I,9999,0,9999,0
1668009553911,CSE 293,005,119142,Cottrell; Garrison W,9999,0,9999,0
1668009553911,CSE 293,006,119146,Deutsch; Alin Bernard,9999,0,9999,0
1668009553911,CSE 293,007,119159,Esmaeilzadeh; Hadi,9999,0,9999,0
1668009553911,CSE 293,008,119166,Freund; Yoav,9999,0,9999,0
1668009553911,CSE 293,009,119170,Griswold; William G.,9999,0,9999,0
1668009553911,CSE 293,010,119183,Gymrek; Melissa Ann,9999,0,9999,0
1668009553911,CSE 293,011,119190,Heninger; Nadia A,9999,0,9999,0
1668009553911,CSE 293,012,119230,Impagliazzo; Russell,9999,0,9999,0
1668009553911,CSE 293,013,119232,Jhala; Ranjit,9999,0,9999,0
1668009553911,CSE 293,014,119233,Kahng; Andrew Byun,9999,0,9999,0
1668009553911,CSE 293,015,119298,Kane; Daniel Mertz,9999,0,9999,0
1668009553911,CSE 293,016,119299,Kriegman; David J,9999,0,9999,0
1668009553911,CSE 293,017,119300,Kumar; Arun Kumar,9999,0,9999,0
1668009553911,CSE 293,018,119301,Lerner; Sorin,9999,0,9999,0
1668009553911,CSE 293,019,119302,Lovett; Shachar,9999,0,9999,0
1668009553911,CSE 293,020,119303,McAuley; Julian John,9999,0,9999,0
1668009553911,CSE 293,021,119304,Micciancio; Daniele,9999,0,9999,0
1668009553911,CSE 293,022,119367,Orailoglu; Alex,9999,0,9999,0
1668009553911,CSE 293,023,119382,Paturi; Ramamohan,9999,0,9999,0
1668009553911,CSE 293,024,119404,Polikarpova; Nadezhda,9999,0,9999,0
1668009553911,CSE 293,025,119406,Politz; Joseph Gibbs,9999,0,9999,0
1668009553911,CSE 293,026,119411,Porter; George M,9999,0,9999,0
1668009553911,CSE 293,027,119414,Porter; Leonard Emerson,9999,0,9999,0
1668009553911,CSE 293,028,119416,Ramamoorthi; Ravi,9999,0,9999,0
1668009553911,CSE 293,029,119417,Sahoo; Debashis,9999,0,9999,0
1668009553911,CSE 293,030,119420,Saul; Lawrence,9999,0,9999,0
1668009553911,CSE 293,031,119421,Savage; Stefan,9999,0,9999,0
1668009553911,CSE 293,032,119425,Schulze; Jurgen P.,9999,0,9999,0
1668009553911,CSE 293,033,119426,Snoeren; Alex C.,9999,0,9999,0
1668009553911,CSE 293,034,119428,Shang; Jingbo,9999,0,9999,0
1668009553911,CSE 293,035,119430,Stefan; Deian,9999,0,9999,0
1668009553911,CSE 293,036,119431,Su; Hao,9999,0,9999,0
1668009553911,CSE 293,037,119433,Swanson; Steven James,9999,0,9999,0
1668009553911,CSE 293,038,119435,Tullsen; Dean Michael,9999,0,9999,0
1668009553911,CSE 293,039,119483,Voelker; Geoffrey M.,9999,0,9999,0
1668009553911,CSE 293,040,119537,Zhao; Jishen,9999,0,9999,0
1668009553911,CSE 293,041,119538,Zhou; Yuan-Yuan,9999,0,9999,0
1668009553911,CSE 293,042,119539,Gao; Sicun,9999,0,9999,0
1668009553911,CSE 293,043,119540,Weibel; Nadir,9999,0,9999,0
1668009553911,CSE 293,044,119541,Gupta; Rajesh K.,9999,0,9999,0
1668009553911,CSE 293,045,126410,Vaccaro; Kristen Marie,9999,0,9999,0
1668009553911,CSE 293,046,126411,Klemke; Richard,9999,0,9999,0
1668009554345,CSE 294,A00,102459,Voelker; Geoffrey M.,0,0,0,0
1668009554345,CSE 294,B00,111322,Orailoglu; Alex,0,0,0,0
1668009554780,DSE 201,A00,096914,Deutsch; Alin Bernard,30,0,30,0
1668009555206,DSE 210,A00,096915,Dasgupta; Sanjoy,30,0,30,0
1668009555627,DSE 260A,A00,096916,Altintas De Callaf; Ilkay,30,0,30,0
1668009556064,ECE 200,001,103586,Antipa; Nicholas A,9999,0,9999,0
1668009556064,ECE 200,002,103587,Atanasov; Nikolay A.,9999,0,9999,0
1668009556064,ECE 200,003,103588,Bharadia; Dinesh,9999,0,9999,0
1668009556064,ECE 200,004,103589,Cheng; Chung Kuan,9999,0,9999,0
1668009556064,ECE 200,005,103590,Cosman; Pamela C.,9999,0,9999,0
1668009556064,ECE 200,006,103591,Dayeh; Shadi Ahmad,9999,0,9999,0
1668009556064,ECE 200,007,103592,Fainman; Yeshaiahu,9999,0,9999,0
1668009556064,ECE 200,008,103593,Ford; Joseph Earl,9999,0,9999,0
1668009556064,ECE 200,009,103594,Franceschetti; Massimo,9999,0,9999,0
1668009556064,ECE 200,010,103595,Fullerton; Eric E,9999,0,9999,0
1668009556064,ECE 200,011,103596,Galton; Ian A,9999,0,9999,0
1668009556064,ECE 200,012,103597,Gilja; Vikash,9999,0,9999,0
1668009556064,ECE 200,013,103598,Hall; Drew A.,9999,0,9999,0
1668009556064,ECE 200,014,103599,Hsueh; Tzu-Chien,9999,0,9999,0
1668009556064,ECE 200,015,103600,Javidi; Tara,9999,0,9999,0
1668009556064,ECE 200,016,103601,Kahng; Andrew Byun,9999,0,9999,0
1668009556064,ECE 200,017,103602,Kim; Young-Han,9999,0,9999,0
1668009556064,ECE 200,018,103603,Koushanfar; Farinaz,9999,0,9999,0
1668009556064,ECE 200,019,103604,Kuzum; Duygu,9999,0,9999,0
1668009556064,ECE 200,020,103605,Le; Hanh-Phuc,9999,0,9999,0
1668009556064,ECE 200,021,103606,Lin; Bill,9999,0,9999,0
1668009556064,ECE 200,022,103607,Liu; Zhaowei,9998,0,9999,1
1668009556064,ECE 200,023,103608,Lo; Yu-Hwa,9999,0,9999,0
1668009556064,ECE 200,024,103609,Lomakin; Vitaliy,9999,0,9999,0
1668009556064,ECE 200,025,103610,Mercier; Patrick Philip,9999,0,9999,0
1668009556064,ECE 200,026,103611,Meyer; Florian,9999,0,9999,0
1668009556064,ECE 200,027,103612,Milstein; Laurence B.,9999,0,9999,0
1668009556064,ECE 200,028,103613,Mir Arabbaygi; Siavash,9999,0,9999,0
1668009556064,ECE 200,029,103614,Mookherjea; Shayan,9999,0,9999,0
1668009556064,ECE 200,030,103615,Morris; Karcher William,9999,0,9999,0
1668009556064,ECE 200,031,103616,Ng; Tse Nga,9999,0,9999,0
1668009556064,ECE 200,032,103617,Nguyen; Truong Quang,9999,0,9999,0
1668009556064,ECE 200,033,103618,Nomura; Kenji,9999,0,9999,0
1668009556064,ECE 200,034,103619,Orlitsky; Alon,9999,0,9999,0
1668009556064,ECE 200,035,103620,Pal; Piya,9999,0,9999,0
1668009556064,ECE 200,036,103621,Papen; George C.,9999,0,9999,0
1668009556064,ECE 200,037,103622,Radic; Stojan,9999,0,9999,0
1668009556064,ECE 200,038,103623,Rao; Bhaskar D.,9999,0,9999,0
1668009556064,ECE 200,039,103624,Rao; Ramesh R,9999,0,9999,0
1668009556064,ECE 200,040,103625,Rebeiz; Gabriel,9999,0,9999,0
1668009556064,ECE 200,041,103626,Sanford; John R,9999,0,9999,0
1668009556064,ECE 200,042,103627,Siegel; Paul H.,9999,0,9999,0
1668009556064,ECE 200,043,103628,Sievenpiper; Daniel F.,9999,0,9999,0
1668009556064,ECE 200,044,103629,Sworder; David D.,9999,0,9999,0
1668009556064,ECE 200,045,103630,Taur; Yuan,9999,0,9999,0
1668009556064,ECE 200,046,103631,Touri; Behrouz,9999,0,9999,0
1668009556064,ECE 200,047,103632,Trivedi; Mohan M.,9999,0,9999,0
1668009556064,ECE 200,048,103633,Vasconcelos; Nuno,9999,0,9999,0
1668009556064,ECE 200,049,103634,Wang; Xiaolong,9999,0,9999,0
1668009556064,ECE 200,050,103635,Xie; Pengtao,9999,0,9999,0
1668009556064,ECE 200,051,103636,Yip; Michael,9999,0,9999,0
1668009556064,ECE 200,052,103637,Zeger; Kenneth A.,999,0,999,0
1668009556064,ECE 200,053,103638,Zhang; Xinyu,9999,0,9999,0
1668009556064,ECE 200,054,103639,Turakhia; Yatish Girish,9999,0,9999,0
1668009556064,ECE 200,055,103640,Kang; Mingu,9999,0,9999,0
1668009556064,ECE 200,056,103641,Shi; Yuanyuan,9999,0,9999,0
1668009556064,ECE 200,057,103642,Wang; Edward Jay,9999,0,9999,0
1668009556064,ECE 200,058,103643,Zheng; Yang,9999,0,9999,0
1668009556499,ECE 202,A00,103644,Kuzum; Duygu,0,0,0,0
1668009556936,ECE 212BN,A00,103646,Ng; Tse Nga,0,0,0,0
1668009557363,ECE 221,A00,111493,Staff,0,0,0,0
1668009557787,ECE 222B,A00,103647,Lomakin; Vitaliy,0,0,0,0
1668009558213,ECE 230B,A00,103648,Taur; Yuan,0,0,0,0
1668009558635,ECE 238B,A00,103649,Garay; Javier,0,0,0,0
1668009559061,ECE 240B,A00,112900,Fainman; Yeshaiahu,0,0,0,0
1668009559503,ECE 247A,A00,103650,Jokerst; Jesse Vincent,0,0,0,0
1668009559929,ECE 247B,A00,103651,Wang; Joseph,0,0,0,0
1668009560356,ECE 250,A00,103652,Siegel; Paul H.,0,0,0,0
1668009560790,ECE 251A,A00,103654,Rao; Bhaskar D.,0,0,0,0
1668009561228,ECE 257B,A00,103655,Bharadia; Dinesh,0,0,0,0
1668009561656,ECE 258A,A00,103656,Milstein; Laurence B.,0,0,0,0
1668009562081,ECE 260B,A00,103658,Kang; Mingu,0,0,0,0
1668009562507,ECE 264A,A00,103659,Galton; Ian A,0,0,0,0
1668009562939,ECE 265A,A00,103661,Gudem; Prasad S.S.,0,0,0,0
1668009563362,ECE 265D,A00,103662,Gudem; Prasad S.S.,0,0,0,0
1668009563799,ECE 268,A00,103663,Koushanfar; Farinaz,0,0,0,0
1668009564229,ECE 269,A01,103665,Pal; Piya,0,0,0,0
1668009564655,ECE 271B,A00,103666,Vasconcelos; Manuela,0,0,0,0
1668009565079,ECE 276A,A00,103667,Atanasov; Nikolay A.,0,0,0,0
1668009565506,ECE 277,A00,103668,An; Cheolhong,0,0,0,0
1668009565930,ECE 279,A00,117947,Hall; Drew A.,0,0,0,0
1668009566782,ECE 283,A00,103670,Hsueh; Tzu-Chien,0,0,0,0
1668009567210,ECE 284,A00,103671,Turakhia; Yatish Girish,0,0,0,0
1668009567632,ECE 285,A00,103672,Zheng; Yang,0,0,0,0
1668009567632,ECE 285,B00,103673,Sworder; David D.,0,0,0,0
1668009568074,ECE 287,A00,103676,Javidi; Tara,0,0,0,0
1668009568503,MATH 200B,A00,098023,Salehi Golsefidy; Alireza,14,0,15,1
1668009568939,MATH 202B,A00,098024,Rhoades; Brendon Patrick,12,0,15,3
1668009569367,MATH 203B,A00,098025,Oprea; Dragos N.,12,0,15,3
1668009569813,MATH 204B,A00,098026,Sorensen; Claus M,14,0,15,1
1668009570250,MATH 208,A00,098027,Izadi; Elham,7,0,10,3
1668009570684,MATH 209,A00,098028,Pollack; Aaron,10,0,10,0
1668009571110,MATH 211A,A00,112919,Rogalski; Daniel,9,0,10,1
1668009571534,MATH 211B,A00,112920,Seward; Brandon M.,9,0,10,1
1668009571957,MATH 218,A00,098029,Li; Bo,10,0,10,0
1668009572379,MATH 220B,A00,098030,Novak; Jonathan I,13,0,15,2
1668009572803,MATH 221A,A00,098031,Ebenfelt; Peter F,13,0,15,2
1668009573239,MATH 231B,A00,098032,Zlatos; Andrej,12,0,15,3
1668009573667,MATH 240B,A00,098033,Ni; Lei,10,0,15,5
1668009574103,MATH 243,A00,098034,Jekel; David Andrew,10,0,10,0
1668009574532,MATH 245A,A00,098035,Nie; Jiawang,0,0,15,16
1668009574981,MATH 248,A00,098036,Bejenaru; Ioan,10,0,10,0
1668009575406,MATH 250B,A00,098037,Spolaor; Luca,14,0,15,1
1668009575833,MATH 258,A00,098038,Ni; Lei,10,0,10,0
1668009576262,MATH 264B,A00,098041,Rhoades; Brendon Patrick,11,0,15,4
1668009576684,MATH 268,A00,098042,Buss; Samuel R,10,0,10,0
1668009577115,MATH 269,A00,098043,Rhoades; Brendon Patrick,10,0,10,0
1668009577550,MATH 270B,A00,098044,Li; Bo,11,0,15,4
1668009577972,MATH 272B,A00,098045,Holst; Michael J,13,0,15,2
1668009578398,MATH 273A,A00,098046,Tian; Xiaochuan,12,0,15,3
1668009578822,MATH 275,A01,098048,Tian; Xiaochuan,6,0,10,4
1668009579251,MATH 278A,A00,098049,Holst; Michael J,8,0,10,2
1668009579686,MATH 278B,A00,098050,Cloninger; Alexander,10,0,10,0
1668009580111,MATH 278C,A00,098051,Nie; Jiawang,8,0,10,2
1668009580539,MATH 280B,A00,098052,Zheng; Tianyi,11,0,15,4
1668009580974,MATH 281B,A00,098053,Bradic; Jelena,4,0,15,11
1668009581404,MATH 282B,A00,098054,Arias-Castro; Ery,2,0,15,13
1668009581830,MATH 285,A00,098055,Fitzsimmons; Patrick J,0,0,15,17
1668009582253,MATH 287B,A00,098056,Arias-Castro; Ery,5,0,15,10
1668009582686,MATH 288,A00,098057,Agarwal; Pooja,9,0,10,1
1668009582686,MATH 288,B00,098058,Zhang; Danna,9,0,10,1
1668009582686,MATH 288,C00,098059,Williams; Ruth J,10,0,10,0
1668009583115,MATH 290B,A00,098060,Roberts; Justin Deritter,14,0,15,1
1668009583539,MATH 292,A00,098061,Belmont; Eva Kinoshita,10,0,10,0
1668009583961,MATH 295,A00,098062,Suk; Andrew Hoon,48,0,50,2
1668009584385,MATH 296,A00,098063,Novak; Jonathan I,20,0,20,0
1668009584809,MATH 297,001,098064,Gamst; Anthony Collins,9997,0,9999,2
1668010087442,COGS 205,A00,101395,Chiba; Andrea,19,0,20,1
1668010087873,COGS 210B,001,101404,Greene; Deanna Jacquelyn,9998,0,9999,1
1668010087873,COGS 210B,002,101417,Xia; Haijun,9999,0,9999,0
1668010087873,COGS 210B,003,101422,Nitz; Douglas A.,9999,0,9999,0
1668010087873,COGS 210B,004,101423,Hollan; James D.,9998,0,9999,1
1668010087873,COGS 210B,005,101424,Deak; Gedeon O.,9999,0,9999,0
1668010087873,COGS 210B,006,101425,Rossano; Federico,9999,0,9999,0
1668010088300,COGS 211B,A00,101427,Coulson; Seana M,9997,0,9999,2
1668010088723,COGS 220,A00,101428,Hollan; James D.,0,0,25,25
1668010089148,COGS 229,A00,101429,Dow; Steven P,18,0,25,7
1668010089577,COGS 230,A00,101430,Klemmer; Scott R,13,0,17,4
1668010090003,COGS 234,A00,101431,Xia; Haijun,7,0,25,18
1668010090432,COGS 260,A00,101432,Kiyonaga; Anastasia,20,0,25,5
1668010090432,COGS 260,B00,101433,Kirsh; David Joel,16,0,25,9
1668010090869,CSE 202,A00,102371,Impagliazzo; Russell,0,0,0,0
1668010091293,CSE 203B,A01,102373,Cheng; Chung Kuan,0,0,0,0
1668010091722,CSE 208,A00,102374,Micciancio; Daniele,0,0,0,0
1668010092147,CSE 209A,A00,112895,Impagliazzo; Russell,0,0,15,15
1668010092579,CSE 209B,A00,108005,Bellare; Mihir,0,0,0,0
1668010093002,CSE 210,A00,113163,Coblenz; Michael J,0,0,0,0
1668010093426,CSE 219,A00,106111,Dow; Steven P,0,0,20,20
1668010093851,CSE 221,A00,102376,Voelker; Geoffrey M.,0,0,0,0
1668010094274,CSE 224,A01,102378,Porter; George M,0,0,0,0
1668010094711,CSE 229A,A00,102379,Savage; Stefan,0,0,0,0
1668010095145,CSE 229C,A00,102380,Munyaka; Imani N. S.,0,0,0,0
1668010095577,CSE 232B,A00,102382,Deutsch; Alin Bernard,0,0,0,0
1668010096004,CSE 234,A01,112904,Kumar; Arun Kumar,0,0,0,0
1668010096429,CSE 237A,A00,102383,Rosing; Tajana Simunic,0,0,0,0
1668010096861,CSE 239A,A00,102384,Deutsch; Alin Bernard,0,0,0,0
1668010097291,CSE 239B,A00,102385,Polikarpova; Nadezhda,0,0,0,0
1668010097717,CSE 240A,A00,102386,Pannuto; Patrick William,0,0,0,0
1668010098140,CSE 240B,A00,102387,Zhao; Jishen,0,0,0,0
1668010098561,CSE 241A,A00,106406,Kang; Mingu,0,0,0,0
1668010098989,CSE 249B,A00,102388,Kahng; Andrew Byun,0,0,8,8
1668010099415,CSE 251B,A01,102392,Cottrell; Garrison W,0,0,0,0
1668010099415,CSE 251B,A02,102393,Cottrell; Garrison W,0,0,0,0
1668010099842,CSE 252B,A00,102394,Ochoa; Benjamin Lawrence,0,0,0,0
1668010100268,CSE 257,A01,102396,Gao; Sicun,0,0,0,0
1668010100706,CSE 272,A00,102397,Li; Tzumao,0,0,0,0
1668010101129,CSE 274,A00,111323,Chern; Albert Ren-Haur,0,0,0,0
1668010101558,CSE 282,A00,102398,Pevzner; Pavel Arkadjevich,0,0,0,0
1668010101982,CSE 284,A00,114175,Gymrek; Melissa Ann,0,0,0,0
1668010102409,CSE 290,A00,102399,Chandraker; Manmohan Krishna,0,0,0,0
1668010102409,CSE 290,B00,102400,Vaccaro; Kristen Marie,0,0,25,25
1668010102409,CSE 290,C00,102414,Pannuto; Patrick William,0,0,25,25
1668010102409,CSE 290,D00,102427,Pevzner; Pavel Arkadjevich,0,0,0,0
1668010102409,CSE 290,E00,102429,Zhao; Jishen,0,0,0,0
1668010102409,CSE 290,F00,102436,Tullsen; Dean Michael,0,0,0,0
1668010102409,CSE 290,G00,102440,Christensen; Henrik I,0,0,20,20
1668010102834,CSE 291,A00,102443,Su; Hao,0,0,0,0
1668010102834,CSE 291,B00,102448,Polikarpova; Nadezhda,0,0,0,0
1668010102834,CSE 291,C00,102453,Vaccaro; Kristen Marie,0,0,0,0
1668010102834,CSE 291,D00,111343,Savage; Stefan,0,0,0,0
1668010102834,CSE 291,E00,116474,Claffy; Kimberly Claire,0,0,0,0
1668010102834,CSE 291,F00,116479,Pasquale; Joseph,0,0,0,0
1668010103261,CSE 293,001,119111,Bafna; Vineet,9999,0,9999,0
1668010103261,CSE 293,002,119118,Bellare; Mihir,9999,0,9999,0
1668010103261,CSE 293,003,119122,Berg-Kirkpatrick; Taylor D,9999,0,9999,0
1668010103261,CSE 293,004,119135,Christensen; Henrik I,9999,0,9999,0
1668010103261,CSE 293,005,119142,Cottrell; Garrison W,9999,0,9999,0
1668010103261,CSE 293,006,119146,Deutsch; Alin Bernard,9999,0,9999,0
1668010103261,CSE 293,007,119159,Esmaeilzadeh; Hadi,9999,0,9999,0
1668010103261,CSE 293,008,119166,Freund; Yoav,9999,0,9999,0
1668010103261,CSE 293,009,119170,Griswold; William G.,9999,0,9999,0
1668010103261,CSE 293,010,119183,Gymrek; Melissa Ann,9999,0,9999,0
1668010103261,CSE 293,011,119190,Heninger; Nadia A,9999,0,9999,0
1668010103261,CSE 293,012,119230,Impagliazzo; Russell,9999,0,9999,0
1668010103261,CSE 293,013,119232,Jhala; Ranjit,9999,0,9999,0
1668010103261,CSE 293,014,119233,Kahng; Andrew Byun,9999,0,9999,0
1668010103261,CSE 293,015,119298,Kane; Daniel Mertz,9999,0,9999,0
1668010103261,CSE 293,016,119299,Kriegman; David J,9999,0,9999,0
1668010103261,CSE 293,017,119300,Kumar; Arun Kumar,9999,0,9999,0
1668010103261,CSE 293,018,119301,Lerner; Sorin,9999,0,9999,0
1668010103261,CSE 293,019,119302,Lovett; Shachar,9999,0,9999,0
1668010103261,CSE 293,020,119303,McAuley; Julian John,9999,0,9999,0
1668010103261,CSE 293,021,119304,Micciancio; Daniele,9999,0,9999,0
1668010103261,CSE 293,022,119367,Orailoglu; Alex,9999,0,9999,0
1668010103261,CSE 293,023,119382,Paturi; Ramamohan,9999,0,9999,0
1668010103261,CSE 293,024,119404,Polikarpova; Nadezhda,9999,0,9999,0
1668010103261,CSE 293,025,119406,Politz; Joseph Gibbs,9999,0,9999,0
1668010103261,CSE 293,026,119411,Porter; George M,9999,0,9999,0
1668010103261,CSE 293,027,119414,Porter; Leonard Emerson,9999,0,9999,0
1668010103261,CSE 293,028,119416,Ramamoorthi; Ravi,9999,0,9999,0
1668010103261,CSE 293,029,119417,Sahoo; Debashis,9999,0,9999,0
1668010103261,CSE 293,030,119420,Saul; Lawrence,9999,0,9999,0
1668010103261,CSE 293,031,119421,Savage; Stefan,9999,0,9999,0
1668010103261,CSE 293,032,119425,Schulze; Jurgen P.,9999,0,9999,0
1668010103261,CSE 293,033,119426,Snoeren; Alex C.,9999,0,9999,0
1668010103261,CSE 293,034,119428,Shang; Jingbo,9999,0,9999,0
1668010103261,CSE 293,035,119430,Stefan; Deian,9999,0,9999,0
1668010103261,CSE 293,036,119431,Su; Hao,9999,0,9999,0
1668010103261,CSE 293,037,119433,Swanson; Steven James,9999,0,9999,0
1668010103261,CSE 293,038,119435,Tullsen; Dean Michael,9999,0,9999,0
1668010103261,CSE 293,039,119483,Voelker; Geoffrey M.,9999,0,9999,0
1668010103261,CSE 293,040,119537,Zhao; Jishen,9999,0,9999,0
1668010103261,CSE 293,041,119538,Zhou; Yuan-Yuan,9999,0,9999,0
1668010103261,CSE 293,042,119539,Gao; Sicun,9999,0,9999,0
1668010103261,CSE 293,043,119540,Weibel; Nadir,9999,0,9999,0
1668010103261,CSE 293,044,119541,Gupta; Rajesh K.,9999,0,9999,0
1668010103261,CSE 293,045,126410,Vaccaro; Kristen Marie,9999,0,9999,0
1668010103261,CSE 293,046,126411,Klemke; Richard,9999,0,9999,0
1668010103686,CSE 294,A00,102459,Voelker; Geoffrey M.,0,0,0,0
1668010103686,CSE 294,B00,111322,Orailoglu; Alex,0,0,0,0
1668010104124,DSE 201,A00,096914,Deutsch; Alin Bernard,30,0,30,0
1668010104550,DSE 210,A00,096915,Dasgupta; Sanjoy,30,0,30,0
1668010104980,DSE 260A,A00,096916,Altintas De Callaf; Ilkay,30,0,30,0
1668010105423,ECE 200,001,103586,Antipa; Nicholas A,9999,0,9999,0
1668010105423,ECE 200,002,103587,Atanasov; Nikolay A.,9999,0,9999,0
1668010105423,ECE 200,003,103588,Bharadia; Dinesh,9999,0,9999,0
1668010105423,ECE 200,004,103589,Cheng; Chung Kuan,9999,0,9999,0
1668010105423,ECE 200,005,103590,Cosman; Pamela C.,9999,0,9999,0
1668010105423,ECE 200,006,103591,Dayeh; Shadi Ahmad,9999,0,9999,0
1668010105423,ECE 200,007,103592,Fainman; Yeshaiahu,9999,0,9999,0
1668010105423,ECE 200,008,103593,Ford; Joseph Earl,9999,0,9999,0
1668010105423,ECE 200,009,103594,Franceschetti; Massimo,9999,0,9999,0
1668010105423,ECE 200,010,103595,Fullerton; Eric E,9999,0,9999,0
1668010105423,ECE 200,011,103596,Galton; Ian A,9999,0,9999,0
1668010105423,ECE 200,012,103597,Gilja; Vikash,9999,0,9999,0
1668010105423,ECE 200,013,103598,Hall; Drew A.,9999,0,9999,0
1668010105423,ECE 200,014,103599,Hsueh; Tzu-Chien,9999,0,9999,0
1668010105423,ECE 200,015,103600,Javidi; Tara,9999,0,9999,0
1668010105423,ECE 200,016,103601,Kahng; Andrew Byun,9999,0,9999,0
1668010105423,ECE 200,017,103602,Kim; Young-Han,9999,0,9999,0
1668010105423,ECE 200,018,103603,Koushanfar; Farinaz,9999,0,9999,0
1668010105423,ECE 200,019,103604,Kuzum; Duygu,9999,0,9999,0
1668010105423,ECE 200,020,103605,Le; Hanh-Phuc,9999,0,9999,0
1668010105423,ECE 200,021,103606,Lin; Bill,9999,0,9999,0
1668010105423,ECE 200,022,103607,Liu; Zhaowei,9998,0,9999,1
1668010105423,ECE 200,023,103608,Lo; Yu-Hwa,9999,0,9999,0
1668010105423,ECE 200,024,103609,Lomakin; Vitaliy,9999,0,9999,0
1668010105423,ECE 200,025,103610,Mercier; Patrick Philip,9999,0,9999,0
1668010105423,ECE 200,026,103611,Meyer; Florian,9999,0,9999,0
1668010105423,ECE 200,027,103612,Milstein; Laurence B.,9999,0,9999,0
1668010105423,ECE 200,028,103613,Mir Arabbaygi; Siavash,9999,0,9999,0
1668010105423,ECE 200,029,103614,Mookherjea; Shayan,9999,0,9999,0
1668010105423,ECE 200,030,103615,Morris; Karcher William,9999,0,9999,0
1668010105423,ECE 200,031,103616,Ng; Tse Nga,9999,0,9999,0
1668010105423,ECE 200,032,103617,Nguyen; Truong Quang,9999,0,9999,0
1668010105423,ECE 200,033,103618,Nomura; Kenji,9999,0,9999,0
1668010105423,ECE 200,034,103619,Orlitsky; Alon,9999,0,9999,0
1668010105423,ECE 200,035,103620,Pal; Piya,9999,0,9999,0
1668010105423,ECE 200,036,103621,Papen; George C.,9999,0,9999,0
1668010105423,ECE 200,037,103622,Radic; Stojan,9999,0,9999,0
1668010105423,ECE 200,038,103623,Rao; Bhaskar D.,9999,0,9999,0
1668010105423,ECE 200,039,103624,Rao; Ramesh R,9999,0,9999,0
1668010105423,ECE 200,040,103625,Rebeiz; Gabriel,9999,0,9999,0
1668010105423,ECE 200,041,103626,Sanford; John R,9999,0,9999,0
1668010105423,ECE 200,042,103627,Siegel; Paul H.,9999,0,9999,0
1668010105423,ECE 200,043,103628,Sievenpiper; Daniel F.,9999,0,9999,0
1668010105423,ECE 200,044,103629,Sworder; David D.,9999,0,9999,0
1668010105423,ECE 200,045,103630,Taur; Yuan,9999,0,9999,0
1668010105423,ECE 200,046,103631,Touri; Behrouz,9999,0,9999,0
1668010105423,ECE 200,047,103632,Trivedi; Mohan M.,9999,0,9999,0
1668010105423,ECE 200,048,103633,Vasconcelos; Nuno,9999,0,9999,0
1668010105423,ECE 200,049,103634,Wang; Xiaolong,9999,0,9999,0
1668010105423,ECE 200,050,103635,Xie; Pengtao,9999,0,9999,0
1668010105423,ECE 200,051,103636,Yip; Michael,9999,0,9999,0
1668010105423,ECE 200,052,103637,Zeger; Kenneth A.,999,0,999,0
1668010105423,ECE 200,053,103638,Zhang; Xinyu,9999,0,9999,0
1668010105423,ECE 200,054,103639,Turakhia; Yatish Girish,9999,0,9999,0
1668010105423,ECE 200,055,103640,Kang; Mingu,9999,0,9999,0
1668010105423,ECE 200,056,103641,Shi; Yuanyuan,9999,0,9999,0
1668010105423,ECE 200,057,103642,Wang; Edward Jay,9999,0,9999,0
1668010105423,ECE 200,058,103643,Zheng; Yang,9999,0,9999,0
1668010105859,ECE 202,A00,103644,Kuzum; Duygu,0,0,0,0
1668010106287,ECE 212BN,A00,103646,Ng; Tse Nga,0,0,0,0
1668010106711,ECE 221,A00,111493,Staff,0,0,0,0
1668010107135,ECE 222B,A00,103647,Lomakin; Vitaliy,0,0,0,0
1668010107561,ECE 230B,A00,103648,Taur; Yuan,0,0,0,0
1668010107984,ECE 238B,A00,103649,Garay; Javier,0,0,0,0
1668010108419,ECE 240B,A00,112900,Fainman; Yeshaiahu,0,0,0,0
1668010108843,ECE 247A,A00,103650,Jokerst; Jesse Vincent,0,0,0,0
1668010109266,ECE 247B,A00,103651,Wang; Joseph,0,0,0,0
1668010109697,ECE 250,A00,103652,Siegel; Paul H.,0,0,0,0
1668010110128,ECE 251A,A00,103654,Rao; Bhaskar D.,0,0,0,0
1668010110550,ECE 257B,A00,103655,Bharadia; Dinesh,0,0,0,0
1668010110972,ECE 258A,A00,103656,Milstein; Laurence B.,0,0,0,0
1668010111401,ECE 260B,A00,103658,Kang; Mingu,0,0,0,0
1668010111823,ECE 264A,A00,103659,Galton; Ian A,0,0,0,0
1668010112245,ECE 265A,A00,103661,Gudem; Prasad S.S.,0,0,0,0
1668010112669,ECE 265D,A00,103662,Gudem; Prasad S.S.,0,0,0,0
1668010113092,ECE 268,A00,103663,Koushanfar; Farinaz,0,0,0,0
1668010113523,ECE 269,A01,103665,Pal; Piya,0,0,0,0
1668010113949,ECE 271B,A00,103666,Vasconcelos; Manuela,0,0,0,0
1668010114390,ECE 276A,A00,103667,Atanasov; Nikolay A.,0,0,0,0
1668010114811,ECE 277,A00,103668,An; Cheolhong,0,0,0,0
1668010115237,ECE 279,A00,117947,Hall; Drew A.,0,0,0,0
1668010116084,ECE 283,A00,103670,Hsueh; Tzu-Chien,0,0,0,0
1668010116508,ECE 284,A00,103671,Turakhia; Yatish Girish,0,0,0,0
1668010116944,ECE 285,A00,103672,Zheng; Yang,0,0,0,0
1668010116944,ECE 285,B00,103673,Sworder; David D.,0,0,0,0
1668010117367,ECE 287,A00,103676,Javidi; Tara,0,0,0,0
1668010117793,MATH 200B,A00,098023,Salehi Golsefidy; Alireza,14,0,15,1
1668010118307,MATH 202B,A00,098024,Rhoades; Brendon Patrick,12,0,15,3
1668010118730,MATH 203B,A00,098025,Oprea; Dragos N.,12,0,15,3
1668010119153,MATH 204B,A00,098026,Sorensen; Claus M,14,0,15,1
1668010119579,MATH 208,A00,098027,Izadi; Elham,7,0,10,3
1668010120010,MATH 209,A00,098028,Pollack; Aaron,10,0,10,0
1668010120432,MATH 211A,A00,112919,Rogalski; Daniel,9,0,10,1
1668010120855,MATH 211B,A00,112920,Seward; Brandon M.,9,0,10,1
1668010121277,MATH 218,A00,098029,Li; Bo,10,0,10,0
1668010121702,MATH 220B,A00,098030,Novak; Jonathan I,13,0,15,2
1668010122127,MATH 221A,A00,098031,Ebenfelt; Peter F,13,0,15,2
1668010122552,MATH 231B,A00,098032,Zlatos; Andrej,12,0,15,3
1668010122983,MATH 240B,A00,098033,Ni; Lei,10,0,15,5
1668010123412,MATH 243,A00,098034,Jekel; David Andrew,10,0,10,0
1668010123834,MATH 245A,A00,098035,Nie; Jiawang,0,0,15,16
1668010124272,MATH 248,A00,098036,Bejenaru; Ioan,10,0,10,0
1668010124698,MATH 250B,A00,098037,Spolaor; Luca,14,0,15,1
1668010125128,MATH 258,A00,098038,Ni; Lei,10,0,10,0
1668010125557,MATH 264B,A00,098041,Rhoades; Brendon Patrick,11,0,15,4
1668010125985,MATH 268,A00,098042,Buss; Samuel R,10,0,10,0
1668010126406,MATH 269,A00,098043,Rhoades; Brendon Patrick,10,0,10,0
1668010126834,MATH 270B,A00,098044,Li; Bo,11,0,15,4
1668010127261,MATH 272B,A00,098045,Holst; Michael J,13,0,15,2
1668010127688,MATH 273A,A00,098046,Tian; Xiaochuan,12,0,15,3
1668010128109,MATH 275,A01,098048,Tian; Xiaochuan,6,0,10,4
1668010128536,MATH 278A,A00,098049,Holst; Michael J,8,0,10,2
1668010128960,MATH 278B,A00,098050,Cloninger; Alexander,10,0,10,0
1668010129381,MATH 278C,A00,098051,Nie; Jiawang,8,0,10,2
1668010129804,MATH 280B,A00,098052,Zheng; Tianyi,11,0,15,4
1668010130226,MATH 281B,A00,098053,Bradic; Jelena,4,0,15,11
1668010130660,MATH 282B,A00,098054,Arias-Castro; Ery,2,0,15,13
1668010131083,MATH 285,A00,098055,Fitzsimmons; Patrick J,0,0,15,17
1668010131517,MATH 287B,A00,098056,Arias-Castro; Ery,5,0,15,10
1668010131941,MATH 288,A00,098057,Agarwal; Pooja,9,0,10,1
1668010131941,MATH 288,B00,098058,Zhang; Danna,9,0,10,1
1668010131941,MATH 288,C00,098059,Williams; Ruth J,10,0,10,0
1668010132376,MATH 290B,A00,098060,Roberts; Justin Deritter,14,0,15,1
1668010132801,MATH 292,A00,098061,Belmont; Eva Kinoshita,10,0,10,0
1668010133229,MATH 295,A00,098062,Suk; Andrew Hoon,48,0,50,2
1668010133652,MATH 296,A00,098063,Novak; Jonathan I,20,0,20,0
1668010134075,MATH 297,001,098064,Gamst; Anthony Collins,9997,0,9999,2
1668010636117,COGS 205,A00,101395,Chiba; Andrea,19,0,20,1
1668010636541,COGS 210B,001,101404,Greene; Deanna Jacquelyn,9998,0,9999,1
1668010636541,COGS 210B,002,101417,Xia; Haijun,9999,0,9999,0
1668010636541,COGS 210B,003,101422,Nitz; Douglas A.,9999,0,9999,0
1668010636541,COGS 210B,004,101423,Hollan; James D.,9998,0,9999,1
1668010636541,COGS 210B,005,101424,Deak; Gedeon O.,9999,0,9999,0
1668010636541,COGS 210B,006,101425,Rossano; Federico,9999,0,9999,0
1668010636973,COGS 211B,A00,101427,Coulson; Seana M,9997,0,9999,2
1668010637401,COGS 220,A00,101428,Hollan; James D.,0,0,25,25
1668010637825,COGS 229,A00,101429,Dow; Steven P,18,0,25,7
1668010638255,COGS 230,A00,101430,Klemmer; Scott R,13,0,17,4
1668010638680,COGS 234,A00,101431,Xia; Haijun,7,0,25,18
1668010639111,COGS 260,A00,101432,Kiyonaga; Anastasia,20,0,25,5
1668010639111,COGS 260,B00,101433,Kirsh; David Joel,16,0,25,9
1668010639537,CSE 202,A00,102371,Impagliazzo; Russell,0,0,0,0
1668010639962,CSE 203B,A01,102373,Cheng; Chung Kuan,0,0,0,0
1668010640488,CSE 208,A00,102374,Micciancio; Daniele,0,0,0,0
1668010640923,CSE 209A,A00,112895,Impagliazzo; Russell,0,0,15,15
1668010641357,CSE 209B,A00,108005,Bellare; Mihir,0,0,0,0
1668010641788,CSE 210,A00,113163,Coblenz; Michael J,0,0,0,0
1668010642211,CSE 219,A00,106111,Dow; Steven P,0,0,20,20
1668010642634,CSE 221,A00,102376,Voelker; Geoffrey M.,0,0,0,0
1668010643057,CSE 224,A01,102378,Porter; George M,0,0,0,0
1668010643486,CSE 229A,A00,102379,Savage; Stefan,0,0,0,0
1668010643914,CSE 229C,A00,102380,Munyaka; Imani N. S.,0,0,0,0
1668010644346,CSE 232B,A00,102382,Deutsch; Alin Bernard,0,0,0,0
1668010644774,CSE 234,A01,112904,Kumar; Arun Kumar,0,0,0,0
1668010645198,CSE 237A,A00,102383,Rosing; Tajana Simunic,0,0,0,0
1668010645635,CSE 239A,A00,102384,Deutsch; Alin Bernard,0,0,0,0
1668010646066,CSE 239B,A00,102385,Polikarpova; Nadezhda,0,0,0,0
1668010646489,CSE 240A,A00,102386,Pannuto; Patrick William,0,0,0,0
1668010646912,CSE 240B,A00,102387,Zhao; Jishen,0,0,0,0
1668010647345,CSE 241A,A00,106406,Kang; Mingu,0,0,0,0
1668010647771,CSE 249B,A00,102388,Kahng; Andrew Byun,0,0,8,8
1668010648197,CSE 251B,A01,102392,Cottrell; Garrison W,0,0,0,0
1668010648197,CSE 251B,A02,102393,Cottrell; Garrison W,0,0,0,0
1668010648622,CSE 252B,A00,102394,Ochoa; Benjamin Lawrence,0,0,0,0
1668010649060,CSE 257,A01,102396,Gao; Sicun,0,0,0,0
1668010649483,CSE 272,A00,102397,Li; Tzumao,0,0,0,0
1668010649905,CSE 274,A00,111323,Chern; Albert Ren-Haur,0,0,0,0
1668010650343,CSE 282,A00,102398,Pevzner; Pavel Arkadjevich,0,0,0,0
1668010650769,CSE 284,A00,114175,Gymrek; Melissa Ann,0,0,0,0
1668010651193,CSE 290,A00,102399,Chandraker; Manmohan Krishna,0,0,0,0
1668010651193,CSE 290,B00,102400,Vaccaro; Kristen Marie,0,0,25,25
1668010651193,CSE 290,C00,102414,Pannuto; Patrick William,0,0,25,25
1668010651193,CSE 290,D00,102427,Pevzner; Pavel Arkadjevich,0,0,0,0
1668010651193,CSE 290,E00,102429,Zhao; Jishen,0,0,0,0
1668010651193,CSE 290,F00,102436,Tullsen; Dean Michael,0,0,0,0
1668010651193,CSE 290,G00,102440,Christensen; Henrik I,0,0,20,20
1668010651620,CSE 291,A00,102443,Su; Hao,0,0,0,0
1668010651620,CSE 291,B00,102448,Polikarpova; Nadezhda,0,0,0,0
1668010651620,CSE 291,C00,102453,Vaccaro; Kristen Marie,0,0,0,0
1668010651620,CSE 291,D00,111343,Savage; Stefan,0,0,0,0
1668010651620,CSE 291,E00,116474,Claffy; Kimberly Claire,0,0,0,0
1668010651620,CSE 291,F00,116479,Pasquale; Joseph,0,0,0,0
1668010652065,CSE 293,001,119111,Bafna; Vineet,9999,0,9999,0
1668010652065,CSE 293,002,119118,Bellare; Mihir,9999,0,9999,0
1668010652065,CSE 293,003,119122,Berg-Kirkpatrick; Taylor D,9999,0,9999,0
1668010652065,CSE 293,004,119135,Christensen; Henrik I,9999,0,9999,0
1668010652065,CSE 293,005,119142,Cottrell; Garrison W,9999,0,9999,0
1668010652065,CSE 293,006,119146,Deutsch; Alin Bernard,9999,0,9999,0
1668010652065,CSE 293,007,119159,Esmaeilzadeh; Hadi,9999,0,9999,0
1668010652065,CSE 293,008,119166,Freund; Yoav,9999,0,9999,0
1668010652065,CSE 293,009,119170,Griswold; William G.,9999,0,9999,0
1668010652065,CSE 293,010,119183,Gymrek; Melissa Ann,9999,0,9999,0
1668010652065,CSE 293,011,119190,Heninger; Nadia A,9999,0,9999,0
1668010652065,CSE 293,012,119230,Impagliazzo; Russell,9999,0,9999,0
1668010652065,CSE 293,013,119232,Jhala; Ranjit,9999,0,9999,0
1668010652065,CSE 293,014,119233,Kahng; Andrew Byun,9999,0,9999,0
1668010652065,CSE 293,015,119298,Kane; Daniel Mertz,9999,0,9999,0
1668010652065,CSE 293,016,119299,Kriegman; David J,9999,0,9999,0
1668010652065,CSE 293,017,119300,Kumar; Arun Kumar,9999,0,9999,0
1668010652065,CSE 293,018,119301,Lerner; Sorin,9999,0,9999,0
1668010652065,CSE 293,019,119302,Lovett; Shachar,9999,0,9999,0
1668010652065,CSE 293,020,119303,McAuley; Julian John,9999,0,9999,0
1668010652065,CSE 293,021,119304,Micciancio; Daniele,9999,0,9999,0
1668010652065,CSE 293,022,119367,Orailoglu; Alex,9999,0,9999,0
1668010652065,CSE 293,023,119382,Paturi; Ramamohan,9999,0,9999,0
1668010652065,CSE 293,024,119404,Polikarpova; Nadezhda,9999,0,9999,0
1668010652065,CSE 293,025,119406,Politz; Joseph Gibbs,9999,0,9999,0
1668010652065,CSE 293,026,119411,Porter; George M,9999,0,9999,0
1668010652065,CSE 293,027,119414,Porter; Leonard Emerson,9999,0,9999,0
1668010652065,CSE 293,028,119416,Ramamoorthi; Ravi,9999,0,9999,0
1668010652065,CSE 293,029,119417,Sahoo; Debashis,9999,0,9999,0
1668010652065,CSE 293,030,119420,Saul; Lawrence,9999,0,9999,0
1668010652065,CSE 293,031,119421,Savage; Stefan,9999,0,9999,0
1668010652065,CSE 293,032,119425,Schulze; Jurgen P.,9999,0,9999,0
1668010652065,CSE 293,033,119426,Snoeren; Alex C.,9999,0,9999,0
1668010652065,CSE 293,034,119428,Shang; Jingbo,9999,0,9999,0
1668010652065,CSE 293,035,119430,Stefan; Deian,9999,0,9999,0
1668010652065,CSE 293,036,119431,Su; Hao,9999,0,9999,0
1668010652065,CSE 293,037,119433,Swanson; Steven James,9999,0,9999,0
1668010652065,CSE 293,038,119435,Tullsen; Dean Michael,9999,0,9999,0
1668010652065,CSE 293,039,119483,Voelker; Geoffrey M.,9999,0,9999,0
1668010652065,CSE 293,040,119537,Zhao; Jishen,9999,0,9999,0
1668010652065,CSE 293,041,119538,Zhou; Yuan-Yuan,9999,0,9999,0
1668010652065,CSE 293,042,119539,Gao; Sicun,9999,0,9999,0
1668010652065,CSE 293,043,119540,Weibel; Nadir,9999,0,9999,0
1668010652065,CSE 293,044,119541,Gupta; Rajesh K.,9999,0,9999,0
1668010652065,CSE 293,045,126410,Vaccaro; Kristen Marie,9999,0,9999,0
1668010652065,CSE 293,046,126411,Klemke; Richard,9999,0,9999,0
1668010652486,CSE 294,A00,102459,Voelker; Geoffrey M.,0,0,0,0
1668010652486,CSE 294,B00,111322,Orailoglu; Alex,0,0,0,0
1668010652911,DSE 201,A00,096914,Deutsch; Alin Bernard,30,0,30,0
1668010653333,DSE 210,A00,096915,Dasgupta; Sanjoy,30,0,30,0
1668010653756,DSE 260A,A00,096916,Altintas De Callaf; Ilkay,30,0,30,0
1668010654221,ECE 200,001,103586,Antipa; Nicholas A,9999,0,9999,0
1668010654221,ECE 200,002,103587,Atanasov; Nikolay A.,9999,0,9999,0
1668010654221,ECE 200,003,103588,Bharadia; Dinesh,9999,0,9999,0
1668010654221,ECE 200,004,103589,Cheng; Chung Kuan,9999,0,9999,0
1668010654221,ECE 200,005,103590,Cosman; Pamela C.,9999,0,9999,0
1668010654221,ECE 200,006,103591,Dayeh; Shadi Ahmad,9999,0,9999,0
1668010654221,ECE 200,007,103592,Fainman; Yeshaiahu,9999,0,9999,0
1668010654221,ECE 200,008,103593,Ford; Joseph Earl,9999,0,9999,0
1668010654221,ECE 200,009,103594,Franceschetti; Massimo,9999,0,9999,0
1668010654221,ECE 200,010,103595,Fullerton; Eric E,9999,0,9999,0
1668010654221,ECE 200,011,103596,Galton; Ian A,9999,0,9999,0
1668010654221,ECE 200,012,103597,Gilja; Vikash,9999,0,9999,0
1668010654221,ECE 200,013,103598,Hall; Drew A.,9999,0,9999,0
1668010654221,ECE 200,014,103599,Hsueh; Tzu-Chien,9999,0,9999,0
1668010654221,ECE 200,015,103600,Javidi; Tara,9999,0,9999,0
1668010654221,ECE 200,016,103601,Kahng; Andrew Byun,9999,0,9999,0
1668010654221,ECE 200,017,103602,Kim; Young-Han,9999,0,9999,0
1668010654221,ECE 200,018,103603,Koushanfar; Farinaz,9999,0,9999,0
1668010654221,ECE 200,019,103604,Kuzum; Duygu,9999,0,9999,0
1668010654221,ECE 200,020,103605,Le; Hanh-Phuc,9999,0,9999,0
1668010654221,ECE 200,021,103606,Lin; Bill,9999,0,9999,0
1668010654221,ECE 200,022,103607,Liu; Zhaowei,9998,0,9999,1
1668010654221,ECE 200,023,103608,Lo; Yu-Hwa,9999,0,9999,0
1668010654221,ECE 200,024,103609,Lomakin; Vitaliy,9999,0,9999,0
1668010654221,ECE 200,025,103610,Mercier; Patrick Philip,9999,0,9999,0
1668010654221,ECE 200,026,103611,Meyer; Florian,9999,0,9999,0
1668010654221,ECE 200,027,103612,Milstein; Laurence B.,9999,0,9999,0
1668010654221,ECE 200,028,103613,Mir Arabbaygi; Siavash,9999,0,9999,0
1668010654221,ECE 200,029,103614,Mookherjea; Shayan,9999,0,9999,0
1668010654221,ECE 200,030,103615,Morris; Karcher William,9999,0,9999,0
1668010654221,ECE 200,031,103616,Ng; Tse Nga,9999,0,9999,0
1668010654221,ECE 200,032,103617,Nguyen; Truong Quang,9999,0,9999,0
1668010654221,ECE 200,033,103618,Nomura; Kenji,9999,0,9999,0
1668010654221,ECE 200,034,103619,Orlitsky; Alon,9999,0,9999,0
1668010654221,ECE 200,035,103620,Pal; Piya,9999,0,9999,0
1668010654221,ECE 200,036,103621,Papen; George C.,9999,0,9999,0
1668010654221,ECE 200,037,103622,Radic; Stojan,9999,0,9999,0
1668010654221,ECE 200,038,103623,Rao; Bhaskar D.,9999,0,9999,0
1668010654221,ECE 200,039,103624,Rao; Ramesh R,9999,0,9999,0
1668010654221,ECE 200,040,103625,Rebeiz; Gabriel,9999,0,9999,0
1668010654221,ECE 200,041,103626,Sanford; John R,9999,0,9999,0
1668010654221,ECE 200,042,103627,Siegel; Paul H.,9999,0,9999,0
1668010654221,ECE 200,043,103628,Sievenpiper; Daniel F.,9999,0,9999,0
1668010654221,ECE 200,044,103629,Sworder; David D.,9999,0,9999,0
1668010654221,ECE 200,045,103630,Taur; Yuan,9999,0,9999,0
1668010654221,ECE 200,046,103631,Touri; Behrouz,9999,0,9999,0
1668010654221,ECE 200,047,103632,Trivedi; Mohan M.,9999,0,9999,0
1668010654221,ECE 200,048,103633,Vasconcelos; Nuno,9999,0,9999,0
1668010654221,ECE 200,049,103634,Wang; Xiaolong,9999,0,9999,0
1668010654221,ECE 200,050,103635,Xie; Pengtao,9999,0,9999,0
1668010654221,ECE 200,051,103636,Yip; Michael,9999,0,9999,0
1668010654221,ECE 200,052,103637,Zeger; Kenneth A.,999,0,999,0
1668010654221,ECE 200,053,103638,Zhang; Xinyu,9999,0,9999,0
1668010654221,ECE 200,054,103639,Turakhia; Yatish Girish,9999,0,9999,0
1668010654221,ECE 200,055,103640,Kang; Mingu,9999,0,9999,0
1668010654221,ECE 200,056,103641,Shi; Yuanyuan,9999,0,9999,0
1668010654221,ECE 200,057,103642,Wang; Edward Jay,9999,0,9999,0
1668010654221,ECE 200,058,103643,Zheng; Yang,9999,0,9999,0
1668010654655,ECE 202,A00,103644,Kuzum; Duygu,0,0,0,0
1668010655090,ECE 212BN,A00,103646,Ng; Tse Nga,0,0,0,0
1668010655520,ECE 221,A00,111493,Staff,0,0,0,0
1668010655953,ECE 222B,A00,103647,Lomakin; Vitaliy,0,0,0,0
1668010656378,ECE 230B,A00,103648,Taur; Yuan,0,0,0,0
1668010656817,ECE 238B,A00,103649,Garay; Javier,0,0,0,0
1668010657240,ECE 240B,A00,112900,Fainman; Yeshaiahu,0,0,0,0
1668010657667,ECE 247A,A00,103650,Jokerst; Jesse Vincent,0,0,0,0
1668010658090,ECE 247B,A00,103651,Wang; Joseph,0,0,0,0
1668010658515,ECE 250,A00,103652,Siegel; Paul H.,0,0,0,0
1668010658944,ECE 251A,A00,103654,Rao; Bhaskar D.,0,0,0,0
1668010659374,ECE 257B,A00,103655,Bharadia; Dinesh,0,0,0,0
1668010659803,ECE 258A,A00,103656,Milstein; Laurence B.,0,0,0,0
1668010660233,ECE 260B,A00,103658,Kang; Mingu,0,0,0,0
1668010660663,ECE 264A,A00,103659,Galton; Ian A,0,0,0,0
1668010661089,ECE 265A,A00,103661,Gudem; Prasad S.S.,0,0,0,0
1668010661521,ECE 265D,A00,103662,Gudem; Prasad S.S.,0,0,0,0
1668010661947,ECE 268,A00,103663,Koushanfar; Farinaz,0,0,0,0
1668010662382,ECE 269,A01,103665,Pal; Piya,0,0,0,0
1668010662941,ECE 271B,A00,103666,Vasconcelos; Manuela,0,0,0,0
1668010663377,ECE 276A,A00,103667,Atanasov; Nikolay A.,0,0,0,0
1668010663804,ECE 277,A00,103668,An; Cheolhong,0,0,0,0
1668010664231,ECE 279,A00,117947,Hall; Drew A.,0,0,0,0
1668010665085,ECE 283,A00,103670,Hsueh; Tzu-Chien,0,0,0,0
1668010665513,ECE 284,A00,103671,Turakhia; Yatish Girish,0,0,0,0
1668010665936,ECE 285,A00,103672,Zheng; Yang,0,0,0,0
1668010665936,ECE 285,B00,103673,Sworder; David D.,0,0,0,0
1668010666378,ECE 287,A00,103676,Javidi; Tara,0,0,0,0
1668010666799,MATH 200B,A00,098023,Salehi Golsefidy; Alireza,14,0,15,1
1668010667223,MATH 202B,A00,098024,Rhoades; Brendon Patrick,12,0,15,3
1668010667644,MATH 203B,A00,098025,Oprea; Dragos N.,12,0,15,3
1668010668065,MATH 204B,A00,098026,Sorensen; Claus M,14,0,15,1
1668010668488,MATH 208,A00,098027,Izadi; Elham,7,0,10,3
1668010668910,MATH 209,A00,098028,Pollack; Aaron,10,0,10,0
1668010669361,MATH 211A,A00,112919,Rogalski; Daniel,9,0,10,1
1668010669794,MATH 211B,A00,112920,Seward; Brandon M.,9,0,10,1
1668010670229,MATH 218,A00,098029,Li; Bo,10,0,10,0
1668010670658,MATH 220B,A00,098030,Novak; Jonathan I,13,0,15,2
1668010671082,MATH 221A,A00,098031,Ebenfelt; Peter F,13,0,15,2
1668010671504,MATH 231B,A00,098032,Zlatos; Andrej,12,0,15,3
1668010671947,MATH 240B,A00,098033,Ni; Lei,10,0,15,5
1668010672369,MATH 243,A00,098034,Jekel; David Andrew,10,0,10,0
1668010672804,MATH 245A,A00,098035,Nie; Jiawang,0,0,15,16
1668010673233,MATH 248,A00,098036,Bejenaru; Ioan,10,0,10,0
1668010673677,MATH 250B,A00,098037,Spolaor; Luca,14,0,15,1
1668010674105,MATH 258,A00,098038,Ni; Lei,10,0,10,0
1668010674536,MATH 264B,A00,098041,Rhoades; Brendon Patrick,11,0,15,4
1668010674970,MATH 268,A00,098042,Buss; Samuel R,10,0,10,0
1668010675392,MATH 269,A00,098043,Rhoades; Brendon Patrick,10,0,10,0
1668010675821,MATH 270B,A00,098044,Li; Bo,11,0,15,4
1668010676253,MATH 272B,A00,098045,Holst; Michael J,13,0,15,2
1668010676682,MATH 273A,A00,098046,Tian; Xiaochuan,12,0,15,3
1668010677108,MATH 275,A01,098048,Tian; Xiaochuan,6,0,10,4
1668010677532,MATH 278A,A00,098049,Holst; Michael J,8,0,10,2
1668010677957,MATH 278B,A00,098050,Cloninger; Alexander,10,0,10,0
1668010678394,MATH 278C,A00,098051,Nie; Jiawang,8,0,10,2
1668010678819,MATH 280B,A00,098052,Zheng; Tianyi,11,0,15,4
1668010679241,MATH 281B,A00,098053,Bradic; Jelena,4,0,15,11
1668010679667,MATH 282B,A00,098054,Arias-Castro; Ery,2,0,15,13
1668010680107,MATH 285,A00,098055,Fitzsimmons; Patrick J,0,0,15,17
1668010680537,MATH 287B,A00,098056,Arias-Castro; Ery,5,0,15,10
1668010680959,MATH 288,A00,098057,Agarwal; Pooja,9,0,10,1
1668010680959,MATH 288,B00,098058,Zhang; Danna,9,0,10,1
1668010680959,MATH 288,C00,098059,Williams; Ruth J,10,0,10,0
1668010681381,MATH 290B,A00,098060,Roberts; Justin Deritter,14,0,15,1
1668010681807,MATH 292,A00,098061,Belmont; Eva Kinoshita,10,0,10,0
1668010682233,MATH 295,A00,098062,Suk; Andrew Hoon,48,0,50,2
1668010682657,MATH 296,A00,098063,Novak; Jonathan I,20,0,20,0
1668010683090,MATH 297,001,098064,Gamst; Anthony Collins,9997,0,9999,2
1668011186724,COGS 205,A00,101395,Chiba; Andrea,19,0,20,1
1668011187161,COGS 210B,001,101404,Greene; Deanna Jacquelyn,9998,0,9999,1
1668011187161,COGS 210B,002,101417,Xia; Haijun,9999,0,9999,0
1668011187161,COGS 210B,003,101422,Nitz; Douglas A.,9999,0,9999,0
1668011187161,COGS 210B,004,101423,Hollan; James D.,9998,0,9999,1
1668011187161,COGS 210B,005,101424,Deak; Gedeon O.,9999,0,9999,0
1668011187161,COGS 210B,006,101425,Rossano; Federico,9999,0,9999,0
1668011187593,COGS 211B,A00,101427,Coulson; Seana M,9997,0,9999,2
1668011188016,COGS 220,A00,101428,Hollan; James D.,0,0,25,25
1668011188440,COGS 229,A00,101429,Dow; Steven P,18,0,25,7
1668011188877,COGS 230,A00,101430,Klemmer; Scott R,13,0,17,4
1668011189301,COGS 234,A00,101431,Xia; Haijun,7,0,25,18
1668011189741,COGS 260,A00,101432,Kiyonaga; Anastasia,20,0,25,5
1668011189741,COGS 260,B00,101433,Kirsh; David Joel,16,0,25,9
1668011190177,CSE 202,A00,102371,Impagliazzo; Russell,0,0,0,0
1668011190602,CSE 203B,A01,102373,Cheng; Chung Kuan,0,0,0,0
1668011191025,CSE 208,A00,102374,Micciancio; Daniele,0,0,0,0
1668011191460,CSE 209A,A00,112895,Impagliazzo; Russell,0,0,15,15
1668011191884,CSE 209B,A00,108005,Bellare; Mihir,0,0,0,0
1668011192316,CSE 210,A00,113163,Coblenz; Michael J,0,0,0,0
1668011192740,CSE 219,A00,106111,Dow; Steven P,0,0,20,20
1668011193175,CSE 221,A00,102376,Voelker; Geoffrey M.,0,0,0,0
1668011193601,CSE 224,A01,102378,Porter; George M,0,0,0,0
1668011194028,CSE 229A,A00,102379,Savage; Stefan,0,0,0,0
1668011194465,CSE 229C,A00,102380,Munyaka; Imani N. S.,0,0,0,0
1668011194891,CSE 232B,A00,102382,Deutsch; Alin Bernard,0,0,0,0
1668011195318,CSE 234,A01,112904,Kumar; Arun Kumar,0,0,0,0
1668011195751,CSE 237A,A00,102383,Rosing; Tajana Simunic,0,0,0,0
1668011196182,CSE 239A,A00,102384,Deutsch; Alin Bernard,0,0,0,0
1668011196603,CSE 239B,A00,102385,Polikarpova; Nadezhda,0,0,0,0
1668011197043,CSE 240A,A00,102386,Pannuto; Patrick William,0,0,0,0
1668011197473,CSE 240B,A00,102387,Zhao; Jishen,0,0,0,0
1668011197902,CSE 241A,A00,106406,Kang; Mingu,0,0,0,0
1668011198327,CSE 249B,A00,102388,Kahng; Andrew Byun,0,0,8,8
1668011198752,CSE 251B,A01,102392,Cottrell; Garrison W,0,0,0,0
1668011198752,CSE 251B,A02,102393,Cottrell; Garrison W,0,0,0,0
1668011199178,CSE 252B,A00,102394,Ochoa; Benjamin Lawrence,0,0,0,0
1668011199607,CSE 257,A01,102396,Gao; Sicun,0,0,0,0
1668011200034,CSE 272,A00,102397,Li; Tzumao,0,0,0,0
1668011200458,CSE 274,A00,111323,Chern; Albert Ren-Haur,0,0,0,0
1668011200887,CSE 282,A00,102398,Pevzner; Pavel Arkadjevich,0,0,0,0
1668011201312,CSE 284,A00,114175,Gymrek; Melissa Ann,0,0,0,0
1668011201740,CSE 290,A00,102399,Chandraker; Manmohan Krishna,0,0,0,0
1668011201740,CSE 290,B00,102400,Vaccaro; Kristen Marie,0,0,25,25
1668011201740,CSE 290,C00,102414,Pannuto; Patrick William,0,0,25,25
1668011201740,CSE 290,D00,102427,Pevzner; Pavel Arkadjevich,0,0,0,0
1668011201740,CSE 290,E00,102429,Zhao; Jishen,0,0,0,0
1668011201740,CSE 290,F00,102436,Tullsen; Dean Michael,0,0,0,0
1668011201740,CSE 290,G00,102440,Christensen; Henrik I,0,0,20,20
1668011202168,CSE 291,A00,102443,Su; Hao,0,0,0,0
1668011202168,CSE 291,B00,102448,Polikarpova; Nadezhda,0,0,0,0
1668011202168,CSE 291,C00,102453,Vaccaro; Kristen Marie,0,0,0,0
1668011202168,CSE 291,D00,111343,Savage; Stefan,0,0,0,0
1668011202168,CSE 291,E00,116474,Claffy; Kimberly Claire,0,0,0,0
1668011202168,CSE 291,F00,116479,Pasquale; Joseph,0,0,0,0
1668011202609,CSE 293,001,119111,Bafna; Vineet,9999,0,9999,0
1668011202609,CSE 293,002,119118,Bellare; Mihir,9999,0,9999,0
1668011202609,CSE 293,003,119122,Berg-Kirkpatrick; Taylor D,9999,0,9999,0
1668011202609,CSE 293,004,119135,Christensen; Henrik I,9999,0,9999,0
1668011202609,CSE 293,005,119142,Cottrell; Garrison W,9999,0,9999,0
1668011202609,CSE 293,006,119146,Deutsch; Alin Bernard,9999,0,9999,0
1668011202609,CSE 293,007,119159,Esmaeilzadeh; Hadi,9999,0,9999,0
1668011202609,CSE 293,008,119166,Freund; Yoav,9999,0,9999,0
1668011202609,CSE 293,009,119170,Griswold; William G.,9999,0,9999,0
1668011202609,CSE 293,010,119183,Gymrek; Melissa Ann,9999,0,9999,0
1668011202609,CSE 293,011,119190,Heninger; Nadia A,9999,0,9999,0
1668011202609,CSE 293,012,119230,Impagliazzo; Russell,9999,0,9999,0
1668011202609,CSE 293,013,119232,Jhala; Ranjit,9999,0,9999,0
1668011202609,CSE 293,014,119233,Kahng; Andrew Byun,9999,0,9999,0
1668011202609,CSE 293,015,119298,Kane; Daniel Mertz,9999,0,9999,0
1668011202609,CSE 293,016,119299,Kriegman; David J,9999,0,9999,0
1668011202609,CSE 293,017,119300,Kumar; Arun Kumar,9999,0,9999,0
1668011202609,CSE 293,018,119301,Lerner; Sorin,9999,0,9999,0
1668011202609,CSE 293,019,119302,Lovett; Shachar,9999,0,9999,0
1668011202609,CSE 293,020,119303,McAuley; Julian John,9999,0,9999,0
1668011202609,CSE 293,021,119304,Micciancio; Daniele,9999,0,9999,0
1668011202609,CSE 293,022,119367,Orailoglu; Alex,9999,0,9999,0
1668011202609,CSE 293,023,119382,Paturi; Ramamohan,9999,0,9999,0
1668011202609,CSE 293,024,119404,Polikarpova; Nadezhda,9999,0,9999,0
1668011202609,CSE 293,025,119406,Politz; Joseph Gibbs,9999,0,9999,0
1668011202609,CSE 293,026,119411,Porter; George M,9999,0,9999,0
1668011202609,CSE 293,027,119414,Porter; Leonard Emerson,9999,0,9999,0
1668011202609,CSE 293,028,119416,Ramamoorthi; Ravi,9999,0,9999,0
1668011202609,CSE 293,029,119417,Sahoo; Debashis,9999,0,9999,0
1668011202609,CSE 293,030,119420,Saul; Lawrence,9999,0,9999,0
1668011202609,CSE 293,031,119421,Savage; Stefan,9999,0,9999,0
1668011202609,CSE 293,032,119425,Schulze; Jurgen P.,9999,0,9999,0
1668011202609,CSE 293,033,119426,Snoeren; Alex C.,9999,0,9999,0
1668011202609,CSE 293,034,119428,Shang; Jingbo,9999,0,9999,0
1668011202609,CSE 293,035,119430,Stefan; Deian,9999,0,9999,0
1668011202609,CSE 293,036,119431,Su; Hao,9999,0,9999,0
1668011202609,CSE 293,037,119433,Swanson; Steven James,9999,0,9999,0
1668011202609,CSE 293,038,119435,Tullsen; Dean Michael,9999,0,9999,0
1668011202609,CSE 293,039,119483,Voelker; Geoffrey M.,9999,0,9999,0
1668011202609,CSE 293,040,119537,Zhao; Jishen,9999,0,9999,0
1668011202609,CSE 293,041,119538,Zhou; Yuan-Yuan,9999,0,9999,0
1668011202609,CSE 293,042,119539,Gao; Sicun,9999,0,9999,0
1668011202609,CSE 293,043,119540,Weibel; Nadir,9999,0,9999,0
1668011202609,CSE 293,044,119541,Gupta; Rajesh K.,9999,0,9999,0
1668011202609,CSE 293,045,126410,Vaccaro; Kristen Marie,9999,0,9999,0
1668011202609,CSE 293,046,126411,Klemke; Richard,9999,0,9999,0
1668011203035,CSE 294,A00,102459,Voelker; Geoffrey M.,0,0,0,0
1668011203035,CSE 294,B00,111322,Orailoglu; Alex,0,0,0,0
1668011203459,DSE 201,A00,096914,Deutsch; Alin Bernard,30,0,30,0
1668011203899,DSE 210,A00,096915,Dasgupta; Sanjoy,30,0,30,0
1668011204327,DSE 260A,A00,096916,Altintas De Callaf; Ilkay,30,0,30,0
1668011204771,ECE 200,001,103586,Antipa; Nicholas A,9999,0,9999,0
1668011204771,ECE 200,002,103587,Atanasov; Nikolay A.,9999,0,9999,0
1668011204771,ECE 200,003,103588,Bharadia; Dinesh,9999,0,9999,0
1668011204771,ECE 200,004,103589,Cheng; Chung Kuan,9999,0,9999,0
1668011204771,ECE 200,005,103590,Cosman; Pamela C.,9999,0,9999,0
1668011204771,ECE 200,006,103591,Dayeh; Shadi Ahmad,9999,0,9999,0
1668011204771,ECE 200,007,103592,Fainman; Yeshaiahu,9999,0,9999,0
1668011204771,ECE 200,008,103593,Ford; Joseph Earl,9999,0,9999,0
1668011204771,ECE 200,009,103594,Franceschetti; Massimo,9999,0,9999,0
1668011204771,ECE 200,010,103595,Fullerton; Eric E,9999,0,9999,0
1668011204771,ECE 200,011,103596,Galton; Ian A,9999,0,9999,0
1668011204771,ECE 200,012,103597,Gilja; Vikash,9999,0,9999,0
1668011204771,ECE 200,013,103598,Hall; Drew A.,9999,0,9999,0
1668011204771,ECE 200,014,103599,Hsueh; Tzu-Chien,9999,0,9999,0
1668011204771,ECE 200,015,103600,Javidi; Tara,9999,0,9999,0
1668011204771,ECE 200,016,103601,Kahng; Andrew Byun,9999,0,9999,0
1668011204771,ECE 200,017,103602,Kim; Young-Han,9999,0,9999,0
1668011204771,ECE 200,018,103603,Koushanfar; Farinaz,9999,0,9999,0
1668011204771,ECE 200,019,103604,Kuzum; Duygu,9999,0,9999,0
1668011204771,ECE 200,020,103605,Le; Hanh-Phuc,9999,0,9999,0
1668011204771,ECE 200,021,103606,Lin; Bill,9999,0,9999,0
1668011204771,ECE 200,022,103607,Liu; Zhaowei,9998,0,9999,1
1668011204771,ECE 200,023,103608,Lo; Yu-Hwa,9999,0,9999,0
1668011204771,ECE 200,024,103609,Lomakin; Vitaliy,9999,0,9999,0
1668011204771,ECE 200,025,103610,Mercier; Patrick Philip,9999,0,9999,0
1668011204771,ECE 200,026,103611,Meyer; Florian,9999,0,9999,0
1668011204771,ECE 200,027,103612,Milstein; Laurence B.,9999,0,9999,0
1668011204771,ECE 200,028,103613,Mir Arabbaygi; Siavash,9999,0,9999,0
1668011204771,ECE 200,029,103614,Mookherjea; Shayan,9999,0,9999,0
1668011204771,ECE 200,030,103615,Morris; Karcher William,9999,0,9999,0
1668011204771,ECE 200,031,103616,Ng; Tse Nga,9999,0,9999,0
1668011204771,ECE 200,032,103617,Nguyen; Truong Quang,9999,0,9999,0
1668011204771,ECE 200,033,103618,Nomura; Kenji,9999,0,9999,0
1668011204771,ECE 200,034,103619,Orlitsky; Alon,9999,0,9999,0
1668011204771,ECE 200,035,103620,Pal; Piya,9999,0,9999,0
1668011204771,ECE 200,036,103621,Papen; George C.,9999,0,9999,0
1668011204771,ECE 200,037,103622,Radic; Stojan,9999,0,9999,0
1668011204771,ECE 200,038,103623,Rao; Bhaskar D.,9999,0,9999,0
1668011204771,ECE 200,039,103624,Rao; Ramesh R,9999,0,9999,0
1668011204771,ECE 200,040,103625,Rebeiz; Gabriel,9999,0,9999,0
1668011204771,ECE 200,041,103626,Sanford; John R,9999,0,9999,0
1668011204771,ECE 200,042,103627,Siegel; Paul H.,9999,0,9999,0
1668011204771,ECE 200,043,103628,Sievenpiper; Daniel F.,9999,0,9999,0
1668011204771,ECE 200,044,103629,Sworder; David D.,9999,0,9999,0
1668011204771,ECE 200,045,103630,Taur; Yuan,9999,0,9999,0
1668011204771,ECE 200,046,103631,Touri; Behrouz,9999,0,9999,0
1668011204771,ECE 200,047,103632,Trivedi; Mohan M.,9999,0,9999,0
1668011204771,ECE 200,048,103633,Vasconcelos; Nuno,9999,0,9999,0
1668011204771,ECE 200,049,103634,Wang; Xiaolong,9999,0,9999,0
1668011204771,ECE 200,050,103635,Xie; Pengtao,9999,0,9999,0
1668011204771,ECE 200,051,103636,Yip; Michael,9999,0,9999,0
1668011204771,ECE 200,052,103637,Zeger; Kenneth A.,999,0,999,0
1668011204771,ECE 200,053,103638,Zhang; Xinyu,9999,0,9999,0
1668011204771,ECE 200,054,103639,Turakhia; Yatish Girish,9999,0,9999,0
1668011204771,ECE 200,055,103640,Kang; Mingu,9999,0,9999,0
1668011204771,ECE 200,056,103641,Shi; Yuanyuan,9999,0,9999,0
1668011204771,ECE 200,057,103642,Wang; Edward Jay,9999,0,9999,0
1668011204771,ECE 200,058,103643,Zheng; Yang,9999,0,9999,0
1668011205225,ECE 202,A00,103644,Kuzum; Duygu,0,0,0,0
1668011205650,ECE 212BN,A00,103646,Ng; Tse Nga,0,0,0,0
1668011206074,ECE 221,A00,111493,Staff,0,0,0,0
1668011206499,ECE 222B,A00,103647,Lomakin; Vitaliy,0,0,0,0
1668011206921,ECE 230B,A00,103648,Taur; Yuan,0,0,0,0
1668011207367,ECE 238B,A00,103649,Garay; Javier,0,0,0,0
1668011207880,ECE 240B,A00,112900,Fainman; Yeshaiahu,0,0,0,0
1668011208303,ECE 247A,A00,103650,Jokerst; Jesse Vincent,0,0,0,0
1668011208741,ECE 247B,A00,103651,Wang; Joseph,0,0,0,0
1668011209172,ECE 250,A00,103652,Siegel; Paul H.,0,0,0,0
1668011209596,ECE 251A,A00,103654,Rao; Bhaskar D.,0,0,0,0
1668011210020,ECE 257B,A00,103655,Bharadia; Dinesh,0,0,0,0
1668011210444,ECE 258A,A00,103656,Milstein; Laurence B.,0,0,0,0
1668011210873,ECE 260B,A00,103658,Kang; Mingu,0,0,0,0
1668011211299,ECE 264A,A00,103659,Galton; Ian A,0,0,0,0
1668011211724,ECE 265A,A00,103661,Gudem; Prasad S.S.,0,0,0,0
1668011212147,ECE 265D,A00,103662,Gudem; Prasad S.S.,0,0,0,0
1668011212569,ECE 268,A00,103663,Koushanfar; Farinaz,0,0,0,0
1668011213005,ECE 269,A01,103665,Pal; Piya,0,0,0,0
1668011213434,ECE 271B,A00,103666,Vasconcelos; Manuela,0,0,0,0
1668011213859,ECE 276A,A00,103667,Atanasov; Nikolay A.,0,0,0,0
1668011214286,ECE 277,A00,103668,An; Cheolhong,0,0,0,0
1668011214712,ECE 279,A00,117947,Hall; Drew A.,0,0,0,0
1668011215582,ECE 283,A00,103670,Hsueh; Tzu-Chien,0,0,0,0
1668011216011,ECE 284,A00,103671,Turakhia; Yatish Girish,0,0,0,0
1668011216435,ECE 285,A00,103672,Zheng; Yang,0,0,0,0
1668011216435,ECE 285,B00,103673,Sworder; David D.,0,0,0,0
1668011216861,ECE 287,A00,103676,Javidi; Tara,0,0,0,0
1668011217293,MATH 200B,A00,098023,Salehi Golsefidy; Alireza,14,0,15,1
1668011217716,MATH 202B,A00,098024,Rhoades; Brendon Patrick,12,0,15,3
1668011218140,MATH 203B,A00,098025,Oprea; Dragos N.,12,0,15,3
1668011218567,MATH 204B,A00,098026,Sorensen; Claus M,14,0,15,1
1668011219006,MATH 208,A00,098027,Izadi; Elham,7,0,10,3
1668011219437,MATH 209,A00,098028,Pollack; Aaron,10,0,10,0
1668011219861,MATH 211A,A00,112919,Rogalski; Daniel,9,0,10,1
1668011220286,MATH 211B,A00,112920,Seward; Brandon M.,9,0,10,1
1668011220711,MATH 218,A00,098029,Li; Bo,10,0,10,0
1668011221144,MATH 220B,A00,098030,Novak; Jonathan I,13,0,15,2
1668011221599,MATH 221A,A00,098031,Ebenfelt; Peter F,13,0,15,2
1668011222036,MATH 231B,A00,098032,Zlatos; Andrej,12,0,15,3
1668011222463,MATH 240B,A00,098033,Ni; Lei,10,0,15,5
1668011222886,MATH 243,A00,098034,Jekel; David Andrew,10,0,10,0
1668011223313,MATH 245A,A00,098035,Nie; Jiawang,0,0,15,16
1668011223747,MATH 248,A00,098036,Bejenaru; Ioan,10,0,10,0
1668011224175,MATH 250B,A00,098037,Spolaor; Luca,14,0,15,1
1668011224601,MATH 258,A00,098038,Ni; Lei,10,0,10,0
1668011225035,MATH 264B,A00,098041,Rhoades; Brendon Patrick,11,0,15,4
1668011225460,MATH 268,A00,098042,Buss; Samuel R,10,0,10,0
1668011225884,MATH 269,A00,098043,Rhoades; Brendon Patrick,10,0,10,0
1668011226306,MATH 270B,A00,098044,Li; Bo,11,0,15,4
1668011226731,MATH 272B,A00,098045,Holst; Michael J,13,0,15,2
1668011227158,MATH 273A,A00,098046,Tian; Xiaochuan,12,0,15,3
1668011227601,MATH 275,A01,098048,Tian; Xiaochuan,6,0,10,4
1668011228032,MATH 278A,A00,098049,Holst; Michael J,8,0,10,2
1668011228458,MATH 278B,A00,098050,Cloninger; Alexander,10,0,10,0
1668011228880,MATH 278C,A00,098051,Nie; Jiawang,8,0,10,2
1668011229320,MATH 280B,A00,098052,Zheng; Tianyi,11,0,15,4
1668011229743,MATH 281B,A00,098053,Bradic; Jelena,4,0,15,11
1668011230183,MATH 282B,A00,098054,Arias-Castro; Ery,2,0,15,13
1668011230612,MATH 285,A00,098055,Fitzsimmons; Patrick J,0,0,15,17
1668011231035,MATH 287B,A00,098056,Arias-Castro; Ery,5,0,15,10
1668011231459,MATH 288,A00,098057,Agarwal; Pooja,9,0,10,1
1668011231459,MATH 288,B00,098058,Zhang; Danna,9,0,10,1
1668011231459,MATH 288,C00,098059,Williams; Ruth J,10,0,10,0
1668011231885,MATH 290B,A00,098060,Roberts; Justin Deritter,14,0,15,1
1668011232315,MATH 292,A00,098061,Belmont; Eva Kinoshita,10,0,10,0
1668011232752,MATH 295,A00,098062,Suk; Andrew Hoon,48,0,50,2
1668011233175,MATH 296,A00,098063,Novak; Jonathan I,20,0,20,0
1668011233597,MATH 297,001,098064,Gamst; Anthony Collins,9997,0,9999,2
1668011748389,COGS 205,A00,101395,Chiba; Andrea,19,0,20,1
1668011748812,COGS 210B,001,101404,Greene; Deanna Jacquelyn,9998,0,9999,1
1668011748812,COGS 210B,002,101417,Xia; Haijun,9999,0,9999,0
1668011748812,COGS 210B,003,101422,Nitz; Douglas A.,9999,0,9999,0
1668011748812,COGS 210B,004,101423,Hollan; James D.,9998,0,9999,1
1668011748812,COGS 210B,005,101424,Deak; Gedeon O.,9999,0,9999,0
1668011748812,COGS 210B,006,101425,Rossano; Federico,9999,0,9999,0
1668011749237,COGS 211B,A00,101427,Coulson; Seana M,9997,0,9999,2
1668011749670,COGS 220,A00,101428,Hollan; James D.,0,0,25,25
1668011750094,COGS 229,A00,101429,Dow; Steven P,18,0,25,7
1668011750521,COGS 230,A00,101430,Klemmer; Scott R,13,0,17,4
1668011750947,COGS 234,A00,101431,Xia; Haijun,7,0,25,18
1668011751376,COGS 260,A00,101432,Kiyonaga; Anastasia,20,0,25,5
1668011751376,COGS 260,B00,101433,Kirsh; David Joel,16,0,25,9
1668011751799,CSE 202,A00,102371,Impagliazzo; Russell,0,0,0,0
1668011752225,CSE 203B,A01,102373,Cheng; Chung Kuan,0,0,0,0
1668011752665,CSE 208,A00,102374,Micciancio; Daniele,0,0,0,0
1668011753089,CSE 209A,A00,112895,Impagliazzo; Russell,0,0,15,15
1668011753517,CSE 209B,A00,108005,Bellare; Mihir,0,0,0,0
1668011753941,CSE 210,A00,113163,Coblenz; Michael J,0,0,0,0
1668011754364,CSE 219,A00,106111,Dow; Steven P,0,0,20,20
1668011754787,CSE 221,A00,102376,Voelker; Geoffrey M.,0,0,0,0
1668011755215,CSE 224,A01,102378,Porter; George M,0,0,0,0
1668011755642,CSE 229A,A00,102379,Savage; Stefan,0,0,0,0
1668011756064,CSE 229C,A00,102380,Munyaka; Imani N. S.,0,0,0,0
1668011756510,CSE 232B,A00,102382,Deutsch; Alin Bernard,0,0,0,0
1668011756933,CSE 234,A01,112904,Kumar; Arun Kumar,0,0,0,0
1668011757359,CSE 237A,A00,102383,Rosing; Tajana Simunic,0,0,0,0
1668011757782,CSE 239A,A00,102384,Deutsch; Alin Bernard,0,0,0,0
1668011758205,CSE 239B,A00,102385,Polikarpova; Nadezhda,0,0,0,0
1668011758629,CSE 240A,A00,102386,Pannuto; Patrick William,0,0,0,0
1668011759055,CSE 240B,A00,102387,Zhao; Jishen,0,0,0,0
1668011759542,CSE 241A,A00,106406,Kang; Mingu,0,0,0,0
1668011759967,CSE 249B,A00,102388,Kahng; Andrew Byun,0,0,8,8
1668011760402,CSE 251B,A01,102392,Cottrell; Garrison W,0,0,0,0
1668011760402,CSE 251B,A02,102393,Cottrell; Garrison W,0,0,0,0
1668011760825,CSE 252B,A00,102394,Ochoa; Benjamin Lawrence,0,0,0,0
1668011761257,CSE 257,A01,102396,Gao; Sicun,0,0,0,0
1668011761714,CSE 272,A00,102397,Li; Tzumao,0,0,0,0
1668011762147,CSE 274,A00,111323,Chern; Albert Ren-Haur,0,0,0,0
1668011762575,CSE 282,A00,102398,Pevzner; Pavel Arkadjevich,0,0,0,0
1668011763008,CSE 284,A00,114175,Gymrek; Melissa Ann,0,0,0,0
1668011763435,CSE 290,A00,102399,Chandraker; Manmohan Krishna,0,0,0,0
1668011763435,CSE 290,B00,102400,Vaccaro; Kristen Marie,0,0,25,25
1668011763435,CSE 290,C00,102414,Pannuto; Patrick William,0,0,25,25
1668011763435,CSE 290,D00,102427,Pevzner; Pavel Arkadjevich,0,0,0,0
1668011763435,CSE 290,E00,102429,Zhao; Jishen,0,0,0,0
1668011763435,CSE 290,F00,102436,Tullsen; Dean Michael,0,0,0,0
1668011763435,CSE 290,G00,102440,Christensen; Henrik I,0,0,20,20
1668011763860,CSE 291,A00,102443,Su; Hao,0,0,0,0
1668011763860,CSE 291,B00,102448,Polikarpova; Nadezhda,0,0,0,0
1668011763860,CSE 291,C00,102453,Vaccaro; Kristen Marie,0,0,0,0
1668011763860,CSE 291,D00,111343,Savage; Stefan,0,0,0,0
1668011763860,CSE 291,E00,116474,Claffy; Kimberly Claire,0,0,0,0
1668011763860,CSE 291,F00,116479,Pasquale; Joseph,0,0,0,0
1668011764315,CSE 293,001,119111,Bafna; Vineet,9999,0,9999,0
1668011764315,CSE 293,002,119118,Bellare; Mihir,9999,0,9999,0
1668011764315,CSE 293,003,119122,Berg-Kirkpatrick; Taylor D,9999,0,9999,0
1668011764315,CSE 293,004,119135,Christensen; Henrik I,9999,0,9999,0
1668011764315,CSE 293,005,119142,Cottrell; Garrison W,9999,0,9999,0
1668011764315,CSE 293,006,119146,Deutsch; Alin Bernard,9999,0,9999,0
1668011764315,CSE 293,007,119159,Esmaeilzadeh; Hadi,9999,0,9999,0
1668011764315,CSE 293,008,119166,Freund; Yoav,9999,0,9999,0
1668011764315,CSE 293,009,119170,Griswold; William G.,9999,0,9999,0
1668011764315,CSE 293,010,119183,Gymrek; Melissa Ann,9999,0,9999,0
1668011764315,CSE 293,011,119190,Heninger; Nadia A,9999,0,9999,0
1668011764315,CSE 293,012,119230,Impagliazzo; Russell,9999,0,9999,0
1668011764315,CSE 293,013,119232,Jhala; Ranjit,9999,0,9999,0
1668011764315,CSE 293,014,119233,Kahng; Andrew Byun,9999,0,9999,0
1668011764315,CSE 293,015,119298,Kane; Daniel Mertz,9999,0,9999,0
1668011764315,CSE 293,016,119299,Kriegman; David J,9999,0,9999,0
1668011764315,CSE 293,017,119300,Kumar; Arun Kumar,9999,0,9999,0
1668011764315,CSE 293,018,119301,Lerner; Sorin,9999,0,9999,0
1668011764315,CSE 293,019,119302,Lovett; Shachar,9999,0,9999,0
1668011764315,CSE 293,020,119303,McAuley; Julian John,9999,0,9999,0
1668011764315,CSE 293,021,119304,Micciancio; Daniele,9999,0,9999,0
1668011764315,CSE 293,022,119367,Orailoglu; Alex,9999,0,9999,0
1668011764315,CSE 293,023,119382,Paturi; Ramamohan,9999,0,9999,0
1668011764315,CSE 293,024,119404,Polikarpova; Nadezhda,9999,0,9999,0
1668011764315,CSE 293,025,119406,Politz; Joseph Gibbs,9999,0,9999,0
1668011764315,CSE 293,026,119411,Porter; George M,9999,0,9999,0
1668011764315,CSE 293,027,119414,Porter; Leonard Emerson,9999,0,9999,0
1668011764315,CSE 293,028,119416,Ramamoorthi; Ravi,9999,0,9999,0
1668011764315,CSE 293,029,119417,Sahoo; Debashis,9999,0,9999,0
1668011764315,CSE 293,030,119420,Saul; Lawrence,9999,0,9999,0
1668011764315,CSE 293,031,119421,Savage; Stefan,9999,0,9999,0
1668011764315,CSE 293,032,119425,Schulze; Jurgen P.,9999,0,9999,0
1668011764315,CSE 293,033,119426,Snoeren; Alex C.,9999,0,9999,0
1668011764315,CSE 293,034,119428,Shang; Jingbo,9999,0,9999,0
1668011764315,CSE 293,035,119430,Stefan; Deian,9999,0,9999,0
1668011764315,CSE 293,036,119431,Su; Hao,9999,0,9999,0
1668011764315,CSE 293,037,119433,Swanson; Steven James,9999,0,9999,0
1668011764315,CSE 293,038,119435,Tullsen; Dean Michael,9999,0,9999,0
1668011764315,CSE 293,039,119483,Voelker; Geoffrey M.,9999,0,9999,0
1668011764315,CSE 293,040,119537,Zhao; Jishen,9999,0,9999,0
1668011764315,CSE 293,041,119538,Zhou; Yuan-Yuan,9999,0,9999,0
1668011764315,CSE 293,042,119539,Gao; Sicun,9999,0,9999,0
1668011764315,CSE 293,043,119540,Weibel; Nadir,9999,0,9999,0
1668011764315,CSE 293,044,119541,Gupta; Rajesh K.,9999,0,9999,0
1668011764315,CSE 293,045,126410,Vaccaro; Kristen Marie,9999,0,9999,0
1668011764315,CSE 293,046,126411,Klemke; Richard,9999,0,9999,0
1668011764742,CSE 294,A00,102459,Voelker; Geoffrey M.,0,0,0,0
1668011764742,CSE 294,B00,111322,Orailoglu; Alex,0,0,0,0
1668011765164,DSE 201,A00,096914,Deutsch; Alin Bernard,30,0,30,0
1668011765587,DSE 210,A00,096915,Dasgupta; Sanjoy,30,0,30,0
1668011766025,DSE 260A,A00,096916,Altintas De Callaf; Ilkay,30,0,30,0
1668011766481,ECE 200,001,103586,Antipa; Nicholas A,9999,0,9999,0
1668011766481,ECE 200,002,103587,Atanasov; Nikolay A.,9999,0,9999,0
1668011766481,ECE 200,003,103588,Bharadia; Dinesh,9999,0,9999,0
1668011766481,ECE 200,004,103589,Cheng; Chung Kuan,9999,0,9999,0
1668011766481,ECE 200,005,103590,Cosman; Pamela C.,9999,0,9999,0
1668011766481,ECE 200,006,103591,Dayeh; Shadi Ahmad,9999,0,9999,0
1668011766481,ECE 200,007,103592,Fainman; Yeshaiahu,9999,0,9999,0
1668011766481,ECE 200,008,103593,Ford; Joseph Earl,9999,0,9999,0
1668011766481,ECE 200,009,103594,Franceschetti; Massimo,9999,0,9999,0
1668011766481,ECE 200,010,103595,Fullerton; Eric E,9999,0,9999,0
1668011766481,ECE 200,011,103596,Galton; Ian A,9999,0,9999,0
1668011766481,ECE 200,012,103597,Gilja; Vikash,9999,0,9999,0
1668011766481,ECE 200,013,103598,Hall; Drew A.,9999,0,9999,0
1668011766481,ECE 200,014,103599,Hsueh; Tzu-Chien,9999,0,9999,0
1668011766481,ECE 200,015,103600,Javidi; Tara,9999,0,9999,0
1668011766481,ECE 200,016,103601,Kahng; Andrew Byun,9999,0,9999,0
1668011766481,ECE 200,017,103602,Kim; Young-Han,9999,0,9999,0
1668011766481,ECE 200,018,103603,Koushanfar; Farinaz,9999,0,9999,0
1668011766481,ECE 200,019,103604,Kuzum; Duygu,9999,0,9999,0
1668011766481,ECE 200,020,103605,Le; Hanh-Phuc,9999,0,9999,0
1668011766481,ECE 200,021,103606,Lin; Bill,9999,0,9999,0
1668011766481,ECE 200,022,103607,Liu; Zhaowei,9998,0,9999,1
1668011766481,ECE 200,023,103608,Lo; Yu-Hwa,9999,0,9999,0
1668011766481,ECE 200,024,103609,Lomakin; Vitaliy,9999,0,9999,0
1668011766481,ECE 200,025,103610,Mercier; Patrick Philip,9999,0,9999,0
1668011766481,ECE 200,026,103611,Meyer; Florian,9999,0,9999,0
1668011766481,ECE 200,027,103612,Milstein; Laurence B.,9999,0,9999,0
1668011766481,ECE 200,028,103613,Mir Arabbaygi; Siavash,9999,0,9999,0
1668011766481,ECE 200,029,103614,Mookherjea; Shayan,9999,0,9999,0
1668011766481,ECE 200,030,103615,Morris; Karcher William,9999,0,9999,0
1668011766481,ECE 200,031,103616,Ng; Tse Nga,9999,0,9999,0
1668011766481,ECE 200,032,103617,Nguyen; Truong Quang,9999,0,9999,0
1668011766481,ECE 200,033,103618,Nomura; Kenji,9999,0,9999,0
1668011766481,ECE 200,034,103619,Orlitsky; Alon,9999,0,9999,0
1668011766481,ECE 200,035,103620,Pal; Piya,9999,0,9999,0
1668011766481,ECE 200,036,103621,Papen; George C.,9999,0,9999,0
1668011766481,ECE 200,037,103622,Radic; Stojan,9999,0,9999,0
1668011766481,ECE 200,038,103623,Rao; Bhaskar D.,9999,0,9999,0
1668011766481,ECE 200,039,103624,Rao; Ramesh R,9999,0,9999,0
1668011766481,ECE 200,040,103625,Rebeiz; Gabriel,9999,0,9999,0
1668011766481,ECE 200,041,103626,Sanford; John R,9999,0,9999,0
1668011766481,ECE 200,042,103627,Siegel; Paul H.,9999,0,9999,0
1668011766481,ECE 200,043,103628,Sievenpiper; Daniel F.,9999,0,9999,0
1668011766481,ECE 200,044,103629,Sworder; David D.,9999,0,9999,0
1668011766481,ECE 200,045,103630,Taur; Yuan,9999,0,9999,0
1668011766481,ECE 200,046,103631,Touri; Behrouz,9999,0,9999,0
1668011766481,ECE 200,047,103632,Trivedi; Mohan M.,9999,0,9999,0
1668011766481,ECE 200,048,103633,Vasconcelos; Nuno,9999,0,9999,0
1668011766481,ECE 200,049,103634,Wang; Xiaolong,9999,0,9999,0
1668011766481,ECE 200,050,103635,Xie; Pengtao,9999,0,9999,0
1668011766481,ECE 200,051,103636,Yip; Michael,9999,0,9999,0
1668011766481,ECE 200,052,103637,Zeger; Kenneth A.,999,0,999,0
1668011766481,ECE 200,053,103638,Zhang; Xinyu,9999,0,9999,0
1668011766481,ECE 200,054,103639,Turakhia; Yatish Girish,9999,0,9999,0
1668011766481,ECE 200,055,103640,Kang; Mingu,9999,0,9999,0
1668011766481,ECE 200,056,103641,Shi; Yuanyuan,9999,0,9999,0
1668011766481,ECE 200,057,103642,Wang; Edward Jay,9999,0,9999,0
1668011766481,ECE 200,058,103643,Zheng; Yang,9999,0,9999,0
1668011766946,ECE 202,A00,103644,Kuzum; Duygu,0,0,0,0
1668011767370,ECE 212BN,A00,103646,Ng; Tse Nga,0,0,0,0
1668011767794,ECE 221,A00,111493,Staff,0,0,0,0
1668011768228,ECE 222B,A00,103647,Lomakin; Vitaliy,0,0,0,0
1668011768660,ECE 230B,A00,103648,Taur; Yuan,0,0,0,0
1668011769091,ECE 238B,A00,103649,Garay; Javier,0,0,0,0
1668011769517,ECE 240B,A00,112900,Fainman; Yeshaiahu,0,0,0,0
1668011769954,ECE 247A,A00,103650,Jokerst; Jesse Vincent,0,0,0,0
1668011770385,ECE 247B,A00,103651,Wang; Joseph,0,0,0,0
1668011770809,ECE 250,A00,103652,Siegel; Paul H.,0,0,0,0
1668011771233,ECE 251A,A00,103654,Rao; Bhaskar D.,0,0,0,0
1668011771667,ECE 257B,A00,103655,Bharadia; Dinesh,0,0,0,0
1668011772097,ECE 258A,A00,103656,Milstein; Laurence B.,0,0,0,0
1668011772525,ECE 260B,A00,103658,Kang; Mingu,0,0,0,0
1668011772960,ECE 264A,A00,103659,Galton; Ian A,0,0,0,0
1668011773395,ECE 265A,A00,103661,Gudem; Prasad S.S.,0,0,0,0
1668011773823,ECE 265D,A00,103662,Gudem; Prasad S.S.,0,0,0,0
1668011774266,ECE 268,A00,103663,Koushanfar; Farinaz,0,0,0,0
1668011774690,ECE 269,A01,103665,Pal; Piya,0,0,0,0
1668011775113,ECE 271B,A00,103666,Vasconcelos; Manuela,0,0,0,0
1668011775539,ECE 276A,A00,103667,Atanasov; Nikolay A.,0,0,0,0
1668011775963,ECE 277,A00,103668,An; Cheolhong,0,0,0,0
1668011776390,ECE 279,A00,117947,Hall; Drew A.,0,0,0,0
1668011777254,ECE 283,A00,103670,Hsueh; Tzu-Chien,0,0,0,0
1668011777691,ECE 284,A00,103671,Turakhia; Yatish Girish,0,0,0,0
1668011778113,ECE 285,A00,103672,Zheng; Yang,0,0,0,0
1668011778113,ECE 285,B00,103673,Sworder; David D.,0,0,0,0
1668011778536,ECE 287,A00,103676,Javidi; Tara,0,0,0,0
1668011778961,MATH 200B,A00,098023,Salehi Golsefidy; Alireza,14,0,15,1
1668011779386,MATH 202B,A00,098024,Rhoades; Brendon Patrick,12,0,15,3
1668011779814,MATH 203B,A00,098025,Oprea; Dragos N.,12,0,15,3
1668011780248,MATH 204B,A00,098026,Sorensen; Claus M,14,0,15,1
1668011780672,MATH 208,A00,098027,Izadi; Elham,7,0,10,3
1668011781111,MATH 209,A00,098028,Pollack; Aaron,10,0,10,0
1668011781533,MATH 211A,A00,112919,Rogalski; Daniel,9,0,10,1
1668011781962,MATH 211B,A00,112920,Seward; Brandon M.,9,0,10,1
1668011782389,MATH 218,A00,098029,Li; Bo,10,0,10,0
1668011782813,MATH 220B,A00,098030,Novak; Jonathan I,13,0,15,2
1668011783244,MATH 221A,A00,098031,Ebenfelt; Peter F,13,0,15,2
1668011783693,MATH 231B,A00,098032,Zlatos; Andrej,12,0,15,3
1668011784116,MATH 240B,A00,098033,Ni; Lei,10,0,15,5
1668011784540,MATH 243,A00,098034,Jekel; David Andrew,10,0,10,0
1668011784964,MATH 245A,A00,098035,Nie; Jiawang,0,0,15,16
1668011785386,MATH 248,A00,098036,Bejenaru; Ioan,10,0,10,0
1668011785812,MATH 250B,A00,098037,Spolaor; Luca,14,0,15,1
1668011786338,MATH 258,A00,098038,Ni; Lei,10,0,10,0
1668011786765,MATH 264B,A00,098041,Rhoades; Brendon Patrick,11,0,15,4
1668011787190,MATH 268,A00,098042,Buss; Samuel R,10,0,10,0
1668011787613,MATH 269,A00,098043,Rhoades; Brendon Patrick,10,0,10,0
1668011788037,MATH 270B,A00,098044,Li; Bo,11,0,15,4
1668011788461,MATH 272B,A00,098045,Holst; Michael J,13,0,15,2
1668011788884,MATH 273A,A00,098046,Tian; Xiaochuan,12,0,15,3
1668011789310,MATH 275,A01,098048,Tian; Xiaochuan,6,0,10,4
1668011789738,MATH 278A,A00,098049,Holst; Michael J,8,0,10,2
1668011790162,MATH 278B,A00,098050,Cloninger; Alexander,10,0,10,0
1668011790585,MATH 278C,A00,098051,Nie; Jiawang,8,0,10,2
1668011791008,MATH 280B,A00,098052,Zheng; Tianyi,11,0,15,4
1668011791459,MATH 281B,A00,098053,Bradic; Jelena,4,0,15,11
1668011791881,MATH 282B,A00,098054,Arias-Castro; Ery,2,0,15,13
1668011792308,MATH 285,A00,098055,Fitzsimmons; Patrick J,0,0,15,17
1668011792731,MATH 287B,A00,098056,Arias-Castro; Ery,5,0,15,10
1668011793154,MATH 288,A00,098057,Agarwal; Pooja,9,0,10,1
1668011793154,MATH 288,B00,098058,Zhang; Danna,9,0,10,1
1668011793154,MATH 288,C00,098059,Williams; Ruth J,10,0,10,0
1668011793579,MATH 290B,A00,098060,Roberts; Justin Deritter,14,0,15,1
1668011794005,MATH 292,A00,098061,Belmont; Eva Kinoshita,10,0,10,0
1668011794430,MATH 295,A00,098062,Suk; Andrew Hoon,48,0,50,2
1668011794857,MATH 296,A00,098063,Novak; Jonathan I,20,0,20,0
1668011795286,MATH 297,001,098064,Gamst; Anthony Collins,9997,0,9999,2
1668012298648,COGS 205,A00,101395,Chiba; Andrea,19,0,20,1
1668012299075,COGS 210B,001,101404,Greene; Deanna Jacquelyn,9998,0,9999,1
1668012299075,COGS 210B,002,101417,Xia; Haijun,9999,0,9999,0
1668012299075,COGS 210B,003,101422,Nitz; Douglas A.,9999,0,9999,0
1668012299075,COGS 210B,004,101423,Hollan; James D.,9998,0,9999,1
1668012299075,COGS 210B,005,101424,Deak; Gedeon O.,9999,0,9999,0
1668012299075,COGS 210B,006,101425,Rossano; Federico,9999,0,9999,0
1668012299501,COGS 211B,A00,101427,Coulson; Seana M,9997,0,9999,2
1668012299933,COGS 220,A00,101428,Hollan; James D.,0,0,25,25
1668012300368,COGS 229,A00,101429,Dow; Steven P,18,0,25,7
1668012300791,COGS 230,A00,101430,Klemmer; Scott R,13,0,17,4
1668012301219,COGS 234,A00,101431,Xia; Haijun,7,0,25,18
1668012301644,COGS 260,A00,101432,Kiyonaga; Anastasia,20,0,25,5
1668012301644,COGS 260,B00,101433,Kirsh; David Joel,16,0,25,9
1668012302066,CSE 202,A00,102371,Impagliazzo; Russell,0,0,0,0
1668012302496,CSE 203B,A01,102373,Cheng; Chung Kuan,0,0,0,0
1668012302929,CSE 208,A00,102374,Micciancio; Daniele,0,0,0,0
1668012303359,CSE 209A,A00,112895,Impagliazzo; Russell,0,0,15,15
1668012303796,CSE 209B,A00,108005,Bellare; Mihir,0,0,0,0
1668012304217,CSE 210,A00,113163,Coblenz; Michael J,0,0,0,0
1668012304642,CSE 219,A00,106111,Dow; Steven P,0,0,20,20
1668012305072,CSE 221,A00,102376,Voelker; Geoffrey M.,0,0,0,0
1668012305497,CSE 224,A01,102378,Porter; George M,0,0,0,0
1668012305922,CSE 229A,A00,102379,Savage; Stefan,0,0,0,0
1668012306344,CSE 229C,A00,102380,Munyaka; Imani N. S.,0,0,0,0
1668012306775,CSE 232B,A00,102382,Deutsch; Alin Bernard,0,0,0,0
1668012307203,CSE 234,A01,112904,Kumar; Arun Kumar,0,0,0,0
1668012307629,CSE 237A,A00,102383,Rosing; Tajana Simunic,0,0,0,0
1668012308053,CSE 239A,A00,102384,Deutsch; Alin Bernard,0,0,0,0
1668012308478,CSE 239B,A00,102385,Polikarpova; Nadezhda,0,0,0,0
1668012308902,CSE 240A,A00,102386,Pannuto; Patrick William,0,0,0,0
1668012309336,CSE 240B,A00,102387,Zhao; Jishen,0,0,0,0
1668012309874,CSE 241A,A00,106406,Kang; Mingu,0,0,0,0
1668012310312,CSE 249B,A00,102388,Kahng; Andrew Byun,0,0,8,8
1668012310736,CSE 251B,A01,102392,Cottrell; Garrison W,0,0,0,0
1668012310736,CSE 251B,A02,102393,Cottrell; Garrison W,0,0,0,0
1668012311159,CSE 252B,A00,102394,Ochoa; Benjamin Lawrence,0,0,0,0
1668012311585,CSE 257,A01,102396,Gao; Sicun,0,0,0,0
1668012312006,CSE 272,A00,102397,Li; Tzumao,0,0,0,0
1668012312433,CSE 274,A00,111323,Chern; Albert Ren-Haur,0,0,0,0
1668012312861,CSE 282,A00,102398,Pevzner; Pavel Arkadjevich,0,0,0,0
1668012313306,CSE 284,A00,114175,Gymrek; Melissa Ann,0,0,0,0
1668012313731,CSE 290,A00,102399,Chandraker; Manmohan Krishna,0,0,0,0
1668012313731,CSE 290,B00,102400,Vaccaro; Kristen Marie,0,0,25,25
1668012313731,CSE 290,C00,102414,Pannuto; Patrick William,0,0,25,25
1668012313731,CSE 290,D00,102427,Pevzner; Pavel Arkadjevich,0,0,0,0
1668012313731,CSE 290,E00,102429,Zhao; Jishen,0,0,0,0
1668012313731,CSE 290,F00,102436,Tullsen; Dean Michael,0,0,0,0
1668012313731,CSE 290,G00,102440,Christensen; Henrik I,0,0,20,20
1668012314156,CSE 291,A00,102443,Su; Hao,0,0,0,0
1668012314156,CSE 291,B00,102448,Polikarpova; Nadezhda,0,0,0,0
1668012314156,CSE 291,C00,102453,Vaccaro; Kristen Marie,0,0,0,0
1668012314156,CSE 291,D00,111343,Savage; Stefan,0,0,0,0
1668012314156,CSE 291,E00,116474,Claffy; Kimberly Claire,0,0,0,0
1668012314156,CSE 291,F00,116479,Pasquale; Joseph,0,0,0,0
1668012314588,CSE 293,001,119111,Bafna; Vineet,9999,0,9999,0
1668012314588,CSE 293,002,119118,Bellare; Mihir,9999,0,9999,0
1668012314588,CSE 293,003,119122,Berg-Kirkpatrick; Taylor D,9999,0,9999,0
1668012314588,CSE 293,004,119135,Christensen; Henrik I,9999,0,9999,0
1668012314588,CSE 293,005,119142,Cottrell; Garrison W,9999,0,9999,0
1668012314588,CSE 293,006,119146,Deutsch; Alin Bernard,9999,0,9999,0
1668012314588,CSE 293,007,119159,Esmaeilzadeh; Hadi,9999,0,9999,0
1668012314588,CSE 293,008,119166,Freund; Yoav,9999,0,9999,0
1668012314588,CSE 293,009,119170,Griswold; William G.,9999,0,9999,0
1668012314588,CSE 293,010,119183,Gymrek; Melissa Ann,9999,0,9999,0
1668012314588,CSE 293,011,119190,Heninger; Nadia A,9999,0,9999,0
1668012314588,CSE 293,012,119230,Impagliazzo; Russell,9999,0,9999,0
1668012314588,CSE 293,013,119232,Jhala; Ranjit,9999,0,9999,0
1668012314588,CSE 293,014,119233,Kahng; Andrew Byun,9999,0,9999,0
1668012314588,CSE 293,015,119298,Kane; Daniel Mertz,9999,0,9999,0
1668012314588,CSE 293,016,119299,Kriegman; David J,9999,0,9999,0
1668012314588,CSE 293,017,119300,Kumar; Arun Kumar,9999,0,9999,0
1668012314588,CSE 293,018,119301,Lerner; Sorin,9999,0,9999,0
1668012314588,CSE 293,019,119302,Lovett; Shachar,9999,0,9999,0
1668012314588,CSE 293,020,119303,McAuley; Julian John,9999,0,9999,0
1668012314588,CSE 293,021,119304,Micciancio; Daniele,9999,0,9999,0
1668012314588,CSE 293,022,119367,Orailoglu; Alex,9999,0,9999,0
1668012314588,CSE 293,023,119382,Paturi; Ramamohan,9999,0,9999,0
1668012314588,CSE 293,024,119404,Polikarpova; Nadezhda,9999,0,9999,0
1668012314588,CSE 293,025,119406,Politz; Joseph Gibbs,9999,0,9999,0
1668012314588,CSE 293,026,119411,Porter; George M,9999,0,9999,0
1668012314588,CSE 293,027,119414,Porter; Leonard Emerson,9999,0,9999,0
1668012314588,CSE 293,028,119416,Ramamoorthi; Ravi,9999,0,9999,0
1668012314588,CSE 293,029,119417,Sahoo; Debashis,9999,0,9999,0
1668012314588,CSE 293,030,119420,Saul; Lawrence,9999,0,9999,0
1668012314588,CSE 293,031,119421,Savage; Stefan,9999,0,9999,0
1668012314588,CSE 293,032,119425,Schulze; Jurgen P.,9999,0,9999,0
1668012314588,CSE 293,033,119426,Snoeren; Alex C.,9999,0,9999,0
1668012314588,CSE 293,034,119428,Shang; Jingbo,9999,0,9999,0
1668012314588,CSE 293,035,119430,Stefan; Deian,9999,0,9999,0
1668012314588,CSE 293,036,119431,Su; Hao,9999,0,9999,0
1668012314588,CSE 293,037,119433,Swanson; Steven James,9999,0,9999,0
1668012314588,CSE 293,038,119435,Tullsen; Dean Michael,9999,0,9999,0
1668012314588,CSE 293,039,119483,Voelker; Geoffrey M.,9999,0,9999,0
1668012314588,CSE 293,040,119537,Zhao; Jishen,9999,0,9999,0
1668012314588,CSE 293,041,119538,Zhou; Yuan-Yuan,9999,0,9999,0
1668012314588,CSE 293,042,119539,Gao; Sicun,9999,0,9999,0
1668012314588,CSE 293,043,119540,Weibel; Nadir,9999,0,9999,0
1668012314588,CSE 293,044,119541,Gupta; Rajesh K.,9999,0,9999,0
1668012314588,CSE 293,045,126410,Vaccaro; Kristen Marie,9999,0,9999,0
1668012314588,CSE 293,046,126411,Klemke; Richard,9999,0,9999,0
1668012315015,CSE 294,A00,102459,Voelker; Geoffrey M.,0,0,0,0
1668012315015,CSE 294,B00,111322,Orailoglu; Alex,0,0,0,0
1668012315442,DSE 201,A00,096914,Deutsch; Alin Bernard,30,0,30,0
1668012315866,DSE 210,A00,096915,Dasgupta; Sanjoy,30,0,30,0
1668012316291,DSE 260A,A00,096916,Altintas De Callaf; Ilkay,30,0,30,0
1668012316725,ECE 200,001,103586,Antipa; Nicholas A,9999,0,9999,0
1668012316725,ECE 200,002,103587,Atanasov; Nikolay A.,9999,0,9999,0
1668012316725,ECE 200,003,103588,Bharadia; Dinesh,9999,0,9999,0
1668012316725,ECE 200,004,103589,Cheng; Chung Kuan,9999,0,9999,0
1668012316725,ECE 200,005,103590,Cosman; Pamela C.,9999,0,9999,0
1668012316725,ECE 200,006,103591,Dayeh; Shadi Ahmad,9999,0,9999,0
1668012316725,ECE 200,007,103592,Fainman; Yeshaiahu,9999,0,9999,0
1668012316725,ECE 200,008,103593,Ford; Joseph Earl,9999,0,9999,0
1668012316725,ECE 200,009,103594,Franceschetti; Massimo,9999,0,9999,0
1668012316725,ECE 200,010,103595,Fullerton; Eric E,9999,0,9999,0
1668012316725,ECE 200,011,103596,Galton; Ian A,9999,0,9999,0
1668012316725,ECE 200,012,103597,Gilja; Vikash,9999,0,9999,0
1668012316725,ECE 200,013,103598,Hall; Drew A.,9999,0,9999,0
1668012316725,ECE 200,014,103599,Hsueh; Tzu-Chien,9999,0,9999,0
1668012316725,ECE 200,015,103600,Javidi; Tara,9999,0,9999,0
1668012316725,ECE 200,016,103601,Kahng; Andrew Byun,9999,0,9999,0
1668012316725,ECE 200,017,103602,Kim; Young-Han,9999,0,9999,0
1668012316725,ECE 200,018,103603,Koushanfar; Farinaz,9999,0,9999,0
1668012316725,ECE 200,019,103604,Kuzum; Duygu,9999,0,9999,0
1668012316725,ECE 200,020,103605,Le; Hanh-Phuc,9999,0,9999,0
1668012316725,ECE 200,021,103606,Lin; Bill,9999,0,9999,0
1668012316725,ECE 200,022,103607,Liu; Zhaowei,9998,0,9999,1
1668012316725,ECE 200,023,103608,Lo; Yu-Hwa,9999,0,9999,0
1668012316725,ECE 200,024,103609,Lomakin; Vitaliy,9999,0,9999,0
1668012316725,ECE 200,025,103610,Mercier; Patrick Philip,9999,0,9999,0
1668012316725,ECE 200,026,103611,Meyer; Florian,9999,0,9999,0
1668012316725,ECE 200,027,103612,Milstein; Laurence B.,9999,0,9999,0
1668012316725,ECE 200,028,103613,Mir Arabbaygi; Siavash,9999,0,9999,0
1668012316725,ECE 200,029,103614,Mookherjea; Shayan,9999,0,9999,0
1668012316725,ECE 200,030,103615,Morris; Karcher William,9999,0,9999,0
1668012316725,ECE 200,031,103616,Ng; Tse Nga,9999,0,9999,0
1668012316725,ECE 200,032,103617,Nguyen; Truong Quang,9999,0,9999,0
1668012316725,ECE 200,033,103618,Nomura; Kenji,9999,0,9999,0
1668012316725,ECE 200,034,103619,Orlitsky; Alon,9999,0,9999,0
1668012316725,ECE 200,035,103620,Pal; Piya,9999,0,9999,0
1668012316725,ECE 200,036,103621,Papen; George C.,9999,0,9999,0
1668012316725,ECE 200,037,103622,Radic; Stojan,9999,0,9999,0
1668012316725,ECE 200,038,103623,Rao; Bhaskar D.,9999,0,9999,0
1668012316725,ECE 200,039,103624,Rao; Ramesh R,9999,0,9999,0
1668012316725,ECE 200,040,103625,Rebeiz; Gabriel,9999,0,9999,0
1668012316725,ECE 200,041,103626,Sanford; John R,9999,0,9999,0
1668012316725,ECE 200,042,103627,Siegel; Paul H.,9999,0,9999,0
1668012316725,ECE 200,043,103628,Sievenpiper; Daniel F.,9999,0,9999,0
1668012316725,ECE 200,044,103629,Sworder; David D.,9999,0,9999,0
1668012316725,ECE 200,045,103630,Taur; Yuan,9999,0,9999,0
1668012316725,ECE 200,046,103631,Touri; Behrouz,9999,0,9999,0
1668012316725,ECE 200,047,103632,Trivedi; Mohan M.,9999,0,9999,0
1668012316725,ECE 200,048,103633,Vasconcelos; Nuno,9999,0,9999,0
1668012316725,ECE 200,049,103634,Wang; Xiaolong,9999,0,9999,0
1668012316725,ECE 200,050,103635,Xie; Pengtao,9999,0,9999,0
1668012316725,ECE 200,051,103636,Yip; Michael,9999,0,9999,0
1668012316725,ECE 200,052,103637,Zeger; Kenneth A.,999,0,999,0
1668012316725,ECE 200,053,103638,Zhang; Xinyu,9999,0,9999,0
1668012316725,ECE 200,054,103639,Turakhia; Yatish Girish,9999,0,9999,0
1668012316725,ECE 200,055,103640,Kang; Mingu,9999,0,9999,0
1668012316725,ECE 200,056,103641,Shi; Yuanyuan,9999,0,9999,0
1668012316725,ECE 200,057,103642,Wang; Edward Jay,9999,0,9999,0
1668012316725,ECE 200,058,103643,Zheng; Yang,9999,0,9999,0
1668012317147,ECE 202,A00,103644,Kuzum; Duygu,0,0,0,0
1668012317573,ECE 212BN,A00,103646,Ng; Tse Nga,0,0,0,0
1668012317998,ECE 221,A00,111493,Staff,0,0,0,0
1668012318446,ECE 222B,A00,103647,Lomakin; Vitaliy,0,0,0,0
1668012318886,ECE 230B,A00,103648,Taur; Yuan,0,0,0,0
1668012319324,ECE 238B,A00,103649,Garay; Javier,0,0,0,0
1668012319750,ECE 240B,A00,112900,Fainman; Yeshaiahu,0,0,0,0
1668012320192,ECE 247A,A00,103650,Jokerst; Jesse Vincent,0,0,0,0
1668012320623,ECE 247B,A00,103651,Wang; Joseph,0,0,0,0
1668012321061,ECE 250,A00,103652,Siegel; Paul H.,0,0,0,0
1668012321482,ECE 251A,A00,103654,Rao; Bhaskar D.,0,0,0,0
1668012321919,ECE 257B,A00,103655,Bharadia; Dinesh,0,0,0,0
1668012322353,ECE 258A,A00,103656,Milstein; Laurence B.,0,0,0,0
1668012322780,ECE 260B,A00,103658,Kang; Mingu,0,0,0,0
1668012323204,ECE 264A,A00,103659,Galton; Ian A,0,0,0,0
1668012323627,ECE 265A,A00,103661,Gudem; Prasad S.S.,0,0,0,0
1668012324054,ECE 265D,A00,103662,Gudem; Prasad S.S.,0,0,0,0
1668012324477,ECE 268,A00,103663,Koushanfar; Farinaz,0,0,0,0
1668012324903,ECE 269,A01,103665,Pal; Piya,0,0,0,0
1668012325340,ECE 271B,A00,103666,Vasconcelos; Manuela,0,0,0,0
1668012325762,ECE 276A,A00,103667,Atanasov; Nikolay A.,0,0,0,0
1668012326203,ECE 277,A00,103668,An; Cheolhong,0,0,0,0
1668012326626,ECE 279,A00,117947,Hall; Drew A.,0,0,0,0
1668012327485,ECE 283,A00,103670,Hsueh; Tzu-Chien,0,0,0,0
1668012327910,ECE 284,A00,103671,Turakhia; Yatish Girish,0,0,0,0
1668012328336,ECE 285,A00,103672,Zheng; Yang,0,0,0,0
1668012328336,ECE 285,B00,103673,Sworder; David D.,0,0,0,0
1668012328759,ECE 287,A00,103676,Javidi; Tara,0,0,0,0
1668012329196,MATH 200B,A00,098023,Salehi Golsefidy; Alireza,14,0,15,1
1668012329639,MATH 202B,A00,098024,Rhoades; Brendon Patrick,12,0,15,3
1668012330084,MATH 203B,A00,098025,Oprea; Dragos N.,12,0,15,3
1668012330507,MATH 204B,A00,098026,Sorensen; Claus M,14,0,15,1
1668012330936,MATH 208,A00,098027,Izadi; Elham,7,0,10,3
1668012331363,MATH 209,A00,098028,Pollack; Aaron,10,0,10,0
1668012331796,MATH 211A,A00,112919,Rogalski; Daniel,9,0,10,1
1668012332228,MATH 211B,A00,112920,Seward; Brandon M.,9,0,10,1
1668012332659,MATH 218,A00,098029,Li; Bo,10,0,10,0
1668012333084,MATH 220B,A00,098030,Novak; Jonathan I,13,0,15,2
1668012333519,MATH 221A,A00,098031,Ebenfelt; Peter F,13,0,15,2
1668012333955,MATH 231B,A00,098032,Zlatos; Andrej,12,0,15,3
1668012334377,MATH 240B,A00,098033,Ni; Lei,10,0,15,5
1668012334802,MATH 243,A00,098034,Jekel; David Andrew,10,0,10,0
1668012335225,MATH 245A,A00,098035,Nie; Jiawang,0,0,15,16
1668012335650,MATH 248,A00,098036,Bejenaru; Ioan,10,0,10,0
1668012336098,MATH 250B,A00,098037,Spolaor; Luca,14,0,15,1
1668012336526,MATH 258,A00,098038,Ni; Lei,10,0,10,0
1668012336949,MATH 264B,A00,098041,Rhoades; Brendon Patrick,11,0,15,4
1668012337383,MATH 268,A00,098042,Buss; Samuel R,10,0,10,0
1668012337806,MATH 269,A00,098043,Rhoades; Brendon Patrick,10,0,10,0
1668012338231,MATH 270B,A00,098044,Li; Bo,11,0,15,4
1668012338662,MATH 272B,A00,098045,Holst; Michael J,13,0,15,2
1668012339088,MATH 273A,A00,098046,Tian; Xiaochuan,12,0,15,3
1668012339521,MATH 275,A01,098048,Tian; Xiaochuan,6,0,10,4
1668012339949,MATH 278A,A00,098049,Holst; Michael J,8,0,10,2
1668012340375,MATH 278B,A00,098050,Cloninger; Alexander,10,0,10,0
1668012340799,MATH 278C,A00,098051,Nie; Jiawang,8,0,10,2
1668012341224,MATH 280B,A00,098052,Zheng; Tianyi,11,0,15,4
1668012341651,MATH 281B,A00,098053,Bradic; Jelena,4,0,15,11
1668012342075,MATH 282B,A00,098054,Arias-Castro; Ery,2,0,15,13
1668012342499,MATH 285,A00,098055,Fitzsimmons; Patrick J,0,0,15,17
1668012342938,MATH 287B,A00,098056,Arias-Castro; Ery,5,0,15,10
1668012343373,MATH 288,A00,098057,Agarwal; Pooja,9,0,10,1
1668012343373,MATH 288,B00,098058,Zhang; Danna,9,0,10,1
1668012343373,MATH 288,C00,098059,Williams; Ruth J,10,0,10,0
1668012343797,MATH 290B,A00,098060,Roberts; Justin Deritter,14,0,15,1
1668012344222,MATH 292,A00,098061,Belmont; Eva Kinoshita,10,0,10,0
1668012344646,MATH 295,A00,098062,Suk; Andrew Hoon,48,0,50,2
1668012345069,MATH 296,A00,098063,Novak; Jonathan I,20,0,20,0
1668012345506,MATH 297,001,098064,Gamst; Anthony Collins,9997,0,9999,2
1668012848754,COGS 205,A00,101395,Chiba; Andrea,19,0,20,1
1668012849183,COGS 210B,001,101404,Greene; Deanna Jacquelyn,9998,0,9999,1
1668012849183,COGS 210B,002,101417,Xia; Haijun,9999,0,9999,0
1668012849183,COGS 210B,003,101422,Nitz; Douglas A.,9999,0,9999,0
1668012849183,COGS 210B,004,101423,Hollan; James D.,9998,0,9999,1
1668012849183,COGS 210B,005,101424,Deak; Gedeon O.,9999,0,9999,0
1668012849183,COGS 210B,006,101425,Rossano; Federico,9999,0,9999,0
1668012849611,COGS 211B,A00,101427,Coulson; Seana M,9997,0,9999,2
1668012850036,COGS 220,A00,101428,Hollan; James D.,0,0,25,25
1668012850475,COGS 229,A00,101429,Dow; Steven P,18,0,25,7
1668012850916,COGS 230,A00,101430,Klemmer; Scott R,13,0,17,4
1668012851339,COGS 234,A00,101431,Xia; Haijun,7,0,25,18
1668012851768,COGS 260,A00,101432,Kiyonaga; Anastasia,20,0,25,5
1668012851768,COGS 260,B00,101433,Kirsh; David Joel,16,0,25,9
1668012852195,CSE 202,A00,102371,Impagliazzo; Russell,0,0,0,0
1668012852628,CSE 203B,A01,102373,Cheng; Chung Kuan,0,0,0,0
1668012853058,CSE 208,A00,102374,Micciancio; Daniele,0,0,0,0
1668012853491,CSE 209A,A00,112895,Impagliazzo; Russell,0,0,15,15
1668012853913,CSE 209B,A00,108005,Bellare; Mihir,0,0,0,0
1668012854349,CSE 210,A00,113163,Coblenz; Michael J,0,0,0,0
1668012854782,CSE 219,A00,106111,Dow; Steven P,0,0,20,20
1668012855210,CSE 221,A00,102376,Voelker; Geoffrey M.,0,0,0,0
1668012855633,CSE 224,A01,102378,Porter; George M,0,0,0,0
1668012856067,CSE 229A,A00,102379,Savage; Stefan,0,0,0,0
1668012856493,CSE 229C,A00,102380,Munyaka; Imani N. S.,0,0,0,0
1668012856921,CSE 232B,A00,102382,Deutsch; Alin Bernard,0,0,0,0
1668012857353,CSE 234,A01,112904,Kumar; Arun Kumar,0,0,0,0
1668012857778,CSE 237A,A00,102383,Rosing; Tajana Simunic,0,0,0,0
1668012858210,CSE 239A,A00,102384,Deutsch; Alin Bernard,0,0,0,0
1668012858632,CSE 239B,A00,102385,Polikarpova; Nadezhda,0,0,0,0
1668012859057,CSE 240A,A00,102386,Pannuto; Patrick William,0,0,0,0
1668012859490,CSE 240B,A00,102387,Zhao; Jishen,0,0,0,0
1668012859919,CSE 241A,A00,106406,Kang; Mingu,0,0,0,0
1668012860362,CSE 249B,A00,102388,Kahng; Andrew Byun,0,0,8,8
1668012860786,CSE 251B,A01,102392,Cottrell; Garrison W,0,0,0,0
1668012860786,CSE 251B,A02,102393,Cottrell; Garrison W,0,0,0,0
1668012861214,CSE 252B,A00,102394,Ochoa; Benjamin Lawrence,0,0,0,0
1668012861639,CSE 257,A01,102396,Gao; Sicun,0,0,0,0
1668012862080,CSE 272,A00,102397,Li; Tzumao,0,0,0,0
1668012862508,CSE 274,A00,111323,Chern; Albert Ren-Haur,0,0,0,0
1668012862936,CSE 282,A00,102398,Pevzner; Pavel Arkadjevich,0,0,0,0
1668012863362,CSE 284,A00,114175,Gymrek; Melissa Ann,0,0,0,0
1668012863788,CSE 290,A00,102399,Chandraker; Manmohan Krishna,0,0,0,0
1668012863788,CSE 290,B00,102400,Vaccaro; Kristen Marie,0,0,25,25
1668012863788,CSE 290,C00,102414,Pannuto; Patrick William,0,0,25,25
1668012863788,CSE 290,D00,102427,Pevzner; Pavel Arkadjevich,0,0,0,0
1668012863788,CSE 290,E00,102429,Zhao; Jishen,0,0,0,0
1668012863788,CSE 290,F00,102436,Tullsen; Dean Michael,0,0,0,0
1668012863788,CSE 290,G00,102440,Christensen; Henrik I,0,0,20,20
1668012864224,CSE 291,A00,102443,Su; Hao,0,0,0,0
1668012864224,CSE 291,B00,102448,Polikarpova; Nadezhda,0,0,0,0
1668012864224,CSE 291,C00,102453,Vaccaro; Kristen Marie,0,0,0,0
1668012864224,CSE 291,D00,111343,Savage; Stefan,0,0,0,0
1668012864224,CSE 291,E00,116474,Claffy; Kimberly Claire,0,0,0,0
1668012864224,CSE 291,F00,116479,Pasquale; Joseph,0,0,0,0
1668012864669,CSE 293,001,119111,Bafna; Vineet,9999,0,9999,0
1668012864669,CSE 293,002,119118,Bellare; Mihir,9999,0,9999,0
1668012864669,CSE 293,003,119122,Berg-Kirkpatrick; Taylor D,9999,0,9999,0
1668012864669,CSE 293,004,119135,Christensen; Henrik I,9999,0,9999,0
1668012864669,CSE 293,005,119142,Cottrell; Garrison W,9999,0,9999,0
1668012864669,CSE 293,006,119146,Deutsch; Alin Bernard,9999,0,9999,0
1668012864669,CSE 293,007,119159,Esmaeilzadeh; Hadi,9999,0,9999,0
1668012864669,CSE 293,008,119166,Freund; Yoav,9999,0,9999,0
1668012864669,CSE 293,009,119170,Griswold; William G.,9999,0,9999,0
1668012864669,CSE 293,010,119183,Gymrek; Melissa Ann,9999,0,9999,0
1668012864669,CSE 293,011,119190,Heninger; Nadia A,9999,0,9999,0
1668012864669,CSE 293,012,119230,Impagliazzo; Russell,9999,0,9999,0
1668012864669,CSE 293,013,119232,Jhala; Ranjit,9999,0,9999,0
1668012864669,CSE 293,014,119233,Kahng; Andrew Byun,9999,0,9999,0
1668012864669,CSE 293,015,119298,Kane; Daniel Mertz,9999,0,9999,0
1668012864669,CSE 293,016,119299,Kriegman; David J,9999,0,9999,0
1668012864669,CSE 293,017,119300,Kumar; Arun Kumar,9999,0,9999,0
1668012864669,CSE 293,018,119301,Lerner; Sorin,9999,0,9999,0
1668012864669,CSE 293,019,119302,Lovett; Shachar,9999,0,9999,0
1668012864669,CSE 293,020,119303,McAuley; Julian John,9999,0,9999,0
1668012864669,CSE 293,021,119304,Micciancio; Daniele,9999,0,9999,0
1668012864669,CSE 293,022,119367,Orailoglu; Alex,9999,0,9999,0
1668012864669,CSE 293,023,119382,Paturi; Ramamohan,9999,0,9999,0
1668012864669,CSE 293,024,119404,Polikarpova; Nadezhda,9999,0,9999,0
1668012864669,CSE 293,025,119406,Politz; Joseph Gibbs,9999,0,9999,0
1668012864669,CSE 293,026,119411,Porter; George M,9999,0,9999,0
1668012864669,CSE 293,027,119414,Porter; Leonard Emerson,9999,0,9999,0
1668012864669,CSE 293,028,119416,Ramamoorthi; Ravi,9999,0,9999,0
1668012864669,CSE 293,029,119417,Sahoo; Debashis,9999,0,9999,0
1668012864669,CSE 293,030,119420,Saul; Lawrence,9999,0,9999,0
1668012864669,CSE 293,031,119421,Savage; Stefan,9999,0,9999,0
1668012864669,CSE 293,032,119425,Schulze; Jurgen P.,9999,0,9999,0
1668012864669,CSE 293,033,119426,Snoeren; Alex C.,9999,0,9999,0
1668012864669,CSE 293,034,119428,Shang; Jingbo,9999,0,9999,0
1668012864669,CSE 293,035,119430,Stefan; Deian,9999,0,9999,0
1668012864669,CSE 293,036,119431,Su; Hao,9999,0,9999,0
1668012864669,CSE 293,037,119433,Swanson; Steven James,9999,0,9999,0
1668012864669,CSE 293,038,119435,Tullsen; Dean Michael,9999,0,9999,0
1668012864669,CSE 293,039,119483,Voelker; Geoffrey M.,9999,0,9999,0
1668012864669,CSE 293,040,119537,Zhao; Jishen,9999,0,9999,0
1668012864669,CSE 293,041,119538,Zhou; Yuan-Yuan,9999,0,9999,0
1668012864669,CSE 293,042,119539,Gao; Sicun,9999,0,9999,0
1668012864669,CSE 293,043,119540,Weibel; Nadir,9999,0,9999,0
1668012864669,CSE 293,044,119541,Gupta; Rajesh K.,9999,0,9999,0
1668012864669,CSE 293,045,126410,Vaccaro; Kristen Marie,9999,0,9999,0
1668012864669,CSE 293,046,126411,Klemke; Richard,9999,0,9999,0
1668012865096,CSE 294,A00,102459,Voelker; Geoffrey M.,0,0,0,0
1668012865096,CSE 294,B00,111322,Orailoglu; Alex,0,0,0,0
1668012865526,DSE 201,A00,096914,Deutsch; Alin Bernard,30,0,30,0
1668012865947,DSE 210,A00,096915,Dasgupta; Sanjoy,30,0,30,0
1668012866369,DSE 260A,A00,096916,Altintas De Callaf; Ilkay,30,0,30,0
1668012866798,ECE 200,001,103586,Antipa; Nicholas A,9999,0,9999,0
1668012866798,ECE 200,002,103587,Atanasov; Nikolay A.,9999,0,9999,0
1668012866798,ECE 200,003,103588,Bharadia; Dinesh,9999,0,9999,0
1668012866798,ECE 200,004,103589,Cheng; Chung Kuan,9999,0,9999,0
1668012866798,ECE 200,005,103590,Cosman; Pamela C.,9999,0,9999,0
1668012866798,ECE 200,006,103591,Dayeh; Shadi Ahmad,9999,0,9999,0
1668012866798,ECE 200,007,103592,Fainman; Yeshaiahu,9999,0,9999,0
1668012866798,ECE 200,008,103593,Ford; Joseph Earl,9999,0,9999,0
1668012866798,ECE 200,009,103594,Franceschetti; Massimo,9999,0,9999,0
1668012866798,ECE 200,010,103595,Fullerton; Eric E,9999,0,9999,0
1668012866798,ECE 200,011,103596,Galton; Ian A,9999,0,9999,0
1668012866798,ECE 200,012,103597,Gilja; Vikash,9999,0,9999,0
1668012866798,ECE 200,013,103598,Hall; Drew A.,9999,0,9999,0
1668012866798,ECE 200,014,103599,Hsueh; Tzu-Chien,9999,0,9999,0
1668012866798,ECE 200,015,103600,Javidi; Tara,9999,0,9999,0
1668012866798,ECE 200,016,103601,Kahng; Andrew Byun,9999,0,9999,0
1668012866798,ECE 200,017,103602,Kim; Young-Han,9999,0,9999,0
1668012866798,ECE 200,018,103603,Koushanfar; Farinaz,9999,0,9999,0
1668012866798,ECE 200,019,103604,Kuzum; Duygu,9999,0,9999,0
1668012866798,ECE 200,020,103605,Le; Hanh-Phuc,9999,0,9999,0
1668012866798,ECE 200,021,103606,Lin; Bill,9999,0,9999,0
1668012866798,ECE 200,022,103607,Liu; Zhaowei,9998,0,9999,1
1668012866798,ECE 200,023,103608,Lo; Yu-Hwa,9999,0,9999,0
1668012866798,ECE 200,024,103609,Lomakin; Vitaliy,9999,0,9999,0
1668012866798,ECE 200,025,103610,Mercier; Patrick Philip,9999,0,9999,0
1668012866798,ECE 200,026,103611,Meyer; Florian,9999,0,9999,0
1668012866798,ECE 200,027,103612,Milstein; Laurence B.,9999,0,9999,0
1668012866798,ECE 200,028,103613,Mir Arabbaygi; Siavash,9999,0,9999,0
1668012866798,ECE 200,029,103614,Mookherjea; Shayan,9999,0,9999,0
1668012866798,ECE 200,030,103615,Morris; Karcher William,9999,0,9999,0
1668012866798,ECE 200,031,103616,Ng; Tse Nga,9999,0,9999,0
1668012866798,ECE 200,032,103617,Nguyen; Truong Quang,9999,0,9999,0
1668012866798,ECE 200,033,103618,Nomura; Kenji,9999,0,9999,0
1668012866798,ECE 200,034,103619,Orlitsky; Alon,9999,0,9999,0
1668012866798,ECE 200,035,103620,Pal; Piya,9999,0,9999,0
1668012866798,ECE 200,036,103621,Papen; George C.,9999,0,9999,0
1668012866798,ECE 200,037,103622,Radic; Stojan,9999,0,9999,0
1668012866798,ECE 200,038,103623,Rao; Bhaskar D.,9999,0,9999,0
1668012866798,ECE 200,039,103624,Rao; Ramesh R,9999,0,9999,0
1668012866798,ECE 200,040,103625,Rebeiz; Gabriel,9999,0,9999,0
1668012866798,ECE 200,041,103626,Sanford; John R,9999,0,9999,0
1668012866798,ECE 200,042,103627,Siegel; Paul H.,9999,0,9999,0
1668012866798,ECE 200,043,103628,Sievenpiper; Daniel F.,9999,0,9999,0
1668012866798,ECE 200,044,103629,Sworder; David D.,9999,0,9999,0
1668012866798,ECE 200,045,103630,Taur; Yuan,9999,0,9999,0
1668012866798,ECE 200,046,103631,Touri; Behrouz,9999,0,9999,0
1668012866798,ECE 200,047,103632,Trivedi; Mohan M.,9999,0,9999,0
1668012866798,ECE 200,048,103633,Vasconcelos; Nuno,9999,0,9999,0
1668012866798,ECE 200,049,103634,Wang; Xiaolong,9999,0,9999,0
1668012866798,ECE 200,050,103635,Xie; Pengtao,9999,0,9999,0
1668012866798,ECE 200,051,103636,Yip; Michael,9999,0,9999,0
1668012866798,ECE 200,052,103637,Zeger; Kenneth A.,999,0,999,0
1668012866798,ECE 200,053,103638,Zhang; Xinyu,9999,0,9999,0
1668012866798,ECE 200,054,103639,Turakhia; Yatish Girish,9999,0,9999,0
1668012866798,ECE 200,055,103640,Kang; Mingu,9999,0,9999,0
1668012866798,ECE 200,056,103641,Shi; Yuanyuan,9999,0,9999,0
1668012866798,ECE 200,057,103642,Wang; Edward Jay,9999,0,9999,0
1668012866798,ECE 200,058,103643,Zheng; Yang,9999,0,9999,0
1668012867238,ECE 202,A00,103644,Kuzum; Duygu,0,0,0,0
1668012867668,ECE 212BN,A00,103646,Ng; Tse Nga,0,0,0,0
1668012868101,ECE 221,A00,111493,Staff,0,0,0,0
1668012868529,ECE 222B,A00,103647,Lomakin; Vitaliy,0,0,0,0
1668012868963,ECE 230B,A00,103648,Taur; Yuan,0,0,0,0
1668012869403,ECE 238B,A00,103649,Garay; Javier,0,0,0,0
1668012869826,ECE 240B,A00,112900,Fainman; Yeshaiahu,0,0,0,0
1668012870253,ECE 247A,A00,103650,Jokerst; Jesse Vincent,0,0,0,0
1668012870679,ECE 247B,A00,103651,Wang; Joseph,0,0,0,0
1668012871104,ECE 250,A00,103652,Siegel; Paul H.,0,0,0,0
1668012871527,ECE 251A,A00,103654,Rao; Bhaskar D.,0,0,0,0
1668012871959,ECE 257B,A00,103655,Bharadia; Dinesh,0,0,0,0
1668012872381,ECE 258A,A00,103656,Milstein; Laurence B.,0,0,0,0
1668012872812,ECE 260B,A00,103658,Kang; Mingu,0,0,0,0
1668012873242,ECE 264A,A00,103659,Galton; Ian A,0,0,0,0
1668012873676,ECE 265A,A00,103661,Gudem; Prasad S.S.,0,0,0,0
1668012874114,ECE 265D,A00,103662,Gudem; Prasad S.S.,0,0,0,0
1668012874548,ECE 268,A00,103663,Koushanfar; Farinaz,0,0,0,0
1668012874971,ECE 269,A01,103665,Pal; Piya,0,0,0,0
1668012875404,ECE 271B,A00,103666,Vasconcelos; Manuela,0,0,0,0
1668012875828,ECE 276A,A00,103667,Atanasov; Nikolay A.,0,0,0,0
1668012876250,ECE 277,A00,103668,An; Cheolhong,0,0,0,0
1668012876753,ECE 279,A00,117947,Hall; Drew A.,0,0,0,0
1668012877606,ECE 283,A00,103670,Hsueh; Tzu-Chien,0,0,0,0
1668012878032,ECE 284,A00,103671,Turakhia; Yatish Girish,0,0,0,0
1668012878455,ECE 285,A00,103672,Zheng; Yang,0,0,0,0
1668012878455,ECE 285,B00,103673,Sworder; David D.,0,0,0,0
1668012878879,ECE 287,A00,103676,Javidi; Tara,0,0,0,0
1668012879309,MATH 200B,A00,098023,Salehi Golsefidy; Alireza,14,0,15,1
1668012879744,MATH 202B,A00,098024,Rhoades; Brendon Patrick,12,0,15,3
1668012880173,MATH 203B,A00,098025,Oprea; Dragos N.,12,0,15,3
1668012880610,MATH 204B,A00,098026,Sorensen; Claus M,14,0,15,1
1668012881042,MATH 208,A00,098027,Izadi; Elham,7,0,10,3
1668012881481,MATH 209,A00,098028,Pollack; Aaron,10,0,10,0
1668012881932,MATH 211A,A00,112919,Rogalski; Daniel,9,0,10,1
1668012882354,MATH 211B,A00,112920,Seward; Brandon M.,9,0,10,1
1668012882782,MATH 218,A00,098029,Li; Bo,10,0,10,0
1668012883208,MATH 220B,A00,098030,Novak; Jonathan I,13,0,15,2
1668012883638,MATH 221A,A00,098031,Ebenfelt; Peter F,13,0,15,2
1668012884063,MATH 231B,A00,098032,Zlatos; Andrej,12,0,15,3
1668012884487,MATH 240B,A00,098033,Ni; Lei,10,0,15,5
1668012884922,MATH 243,A00,098034,Jekel; David Andrew,10,0,10,0
1668012885347,MATH 245A,A00,098035,Nie; Jiawang,0,0,15,16
1668012885774,MATH 248,A00,098036,Bejenaru; Ioan,10,0,10,0
1668012886207,MATH 250B,A00,098037,Spolaor; Luca,14,0,15,1
1668012886641,MATH 258,A00,098038,Ni; Lei,10,0,10,0
1668012887066,MATH 264B,A00,098041,Rhoades; Brendon Patrick,11,0,15,4
1668012887491,MATH 268,A00,098042,Buss; Samuel R,10,0,10,0
1668012887914,MATH 269,A00,098043,Rhoades; Brendon Patrick,10,0,10,0
1668012888335,MATH 270B,A00,098044,Li; Bo,11,0,15,4
1668012888762,MATH 272B,A00,098045,Holst; Michael J,13,0,15,2
1668012889195,MATH 273A,A00,098046,Tian; Xiaochuan,12,0,15,3
1668012889622,MATH 275,A01,098048,Tian; Xiaochuan,6,0,10,4
1668012890054,MATH 278A,A00,098049,Holst; Michael J,8,0,10,2
1668012890484,MATH 278B,A00,098050,Cloninger; Alexander,10,0,10,0
1668012890910,MATH 278C,A00,098051,Nie; Jiawang,8,0,10,2
1668012891333,MATH 280B,A00,098052,Zheng; Tianyi,11,0,15,4
1668012891764,MATH 281B,A00,098053,Bradic; Jelena,4,0,15,11
1668012892195,MATH 282B,A00,098054,Arias-Castro; Ery,2,0,15,13
1668012892618,MATH 285,A00,098055,Fitzsimmons; Patrick J,0,0,15,17
1668012893046,MATH 287B,A00,098056,Arias-Castro; Ery,5,0,15,10
1668012893481,MATH 288,A00,098057,Agarwal; Pooja,9,0,10,1
1668012893481,MATH 288,B00,098058,Zhang; Danna,9,0,10,1
1668012893481,MATH 288,C00,098059,Williams; Ruth J,10,0,10,0
1668012893905,MATH 290B,A00,098060,Roberts; Justin Deritter,14,0,15,1
1668012894334,MATH 292,A00,098061,Belmont; Eva Kinoshita,10,0,10,0
1668012894766,MATH 295,A00,098062,Suk; Andrew Hoon,48,0,50,2
1668012895201,MATH 296,A00,098063,Novak; Jonathan I,20,0,20,0
1668012895630,MATH 297,001,098064,Gamst; Anthony Collins,9997,0,9999,2
1668013399169,COGS 205,A00,101395,Chiba; Andrea,19,0,20,1
1668013399605,COGS 210B,001,101404,Greene; Deanna Jacquelyn,9998,0,9999,1
1668013399605,COGS 210B,002,101417,Xia; Haijun,9999,0,9999,0
1668013399605,COGS 210B,003,101422,Nitz; Douglas A.,9999,0,9999,0
1668013399605,COGS 210B,004,101423,Hollan; James D.,9998,0,9999,1
1668013399605,COGS 210B,005,101424,Deak; Gedeon O.,9999,0,9999,0
1668013399605,COGS 210B,006,101425,Rossano; Federico,9999,0,9999,0
1668013400036,COGS 211B,A00,101427,Coulson; Seana M,9997,0,9999,2
1668013400559,COGS 220,A00,101428,Hollan; James D.,0,0,25,25
1668013400983,COGS 229,A00,101429,Dow; Steven P,18,0,25,7
1668013401412,COGS 230,A00,101430,Klemmer; Scott R,13,0,17,4
1668013401838,COGS 234,A00,101431,Xia; Haijun,7,0,25,18
1668013402275,COGS 260,A00,101432,Kiyonaga; Anastasia,20,0,25,5
1668013402275,COGS 260,B00,101433,Kirsh; David Joel,16,0,25,9
1668013402698,CSE 202,A00,102371,Impagliazzo; Russell,0,0,0,0
1668013403134,CSE 203B,A01,102373,Cheng; Chung Kuan,0,0,0,0
1668013403576,CSE 208,A00,102374,Micciancio; Daniele,0,0,0,0
1668013404012,CSE 209A,A00,112895,Impagliazzo; Russell,0,0,15,15
1668013404436,CSE 209B,A00,108005,Bellare; Mihir,0,0,0,0
1668013404863,CSE 210,A00,113163,Coblenz; Michael J,0,0,0,0
1668013405287,CSE 219,A00,106111,Dow; Steven P,0,0,20,20
1668013405716,CSE 221,A00,102376,Voelker; Geoffrey M.,0,0,0,0
1668013406149,CSE 224,A01,102378,Porter; George M,0,0,0,0
1668013406576,CSE 229A,A00,102379,Savage; Stefan,0,0,0,0
1668013407004,CSE 229C,A00,102380,Munyaka; Imani N. S.,0,0,0,0
1668013407428,CSE 232B,A00,102382,Deutsch; Alin Bernard,0,0,0,0
1668013407853,CSE 234,A01,112904,Kumar; Arun Kumar,0,0,0,0
1668013408280,CSE 237A,A00,102383,Rosing; Tajana Simunic,0,0,0,0
1668013408702,CSE 239A,A00,102384,Deutsch; Alin Bernard,0,0,0,0
1668013409131,CSE 239B,A00,102385,Polikarpova; Nadezhda,0,0,0,0
1668013409558,CSE 240A,A00,102386,Pannuto; Patrick William,0,0,0,0
1668013409983,CSE 240B,A00,102387,Zhao; Jishen,0,0,0,0
1668013410422,CSE 241A,A00,106406,Kang; Mingu,0,0,0,0
1668013410849,CSE 249B,A00,102388,Kahng; Andrew Byun,0,0,8,8
1668013411289,CSE 251B,A01,102392,Cottrell; Garrison W,0,0,0,0
1668013411289,CSE 251B,A02,102393,Cottrell; Garrison W,0,0,0,0
1668013411724,CSE 252B,A00,102394,Ochoa; Benjamin Lawrence,0,0,0,0
1668013412161,CSE 257,A01,102396,Gao; Sicun,0,0,0,0
1668013412585,CSE 272,A00,102397,Li; Tzumao,0,0,0,0
1668013413015,CSE 274,A00,111323,Chern; Albert Ren-Haur,0,0,0,0
1668013413438,CSE 282,A00,102398,Pevzner; Pavel Arkadjevich,0,0,0,0
1668013413866,CSE 284,A00,114175,Gymrek; Melissa Ann,0,0,0,0
1668013414295,CSE 290,A00,102399,Chandraker; Manmohan Krishna,0,0,0,0
1668013414295,CSE 290,B00,102400,Vaccaro; Kristen Marie,0,0,25,25
1668013414295,CSE 290,C00,102414,Pannuto; Patrick William,0,0,25,25
1668013414295,CSE 290,D00,102427,Pevzner; Pavel Arkadjevich,0,0,0,0
1668013414295,CSE 290,E00,102429,Zhao; Jishen,0,0,0,0
1668013414295,CSE 290,F00,102436,Tullsen; Dean Michael,0,0,0,0
1668013414295,CSE 290,G00,102440,Christensen; Henrik I,0,0,20,20
1668013414743,CSE 291,A00,102443,Su; Hao,0,0,0,0
1668013414743,CSE 291,B00,102448,Polikarpova; Nadezhda,0,0,0,0
1668013414743,CSE 291,C00,102453,Vaccaro; Kristen Marie,0,0,0,0
1668013414743,CSE 291,D00,111343,Savage; Stefan,0,0,0,0
1668013414743,CSE 291,E00,116474,Claffy; Kimberly Claire,0,0,0,0
1668013414743,CSE 291,F00,116479,Pasquale; Joseph,0,0,0,0
1668013415193,CSE 293,001,119111,Bafna; Vineet,9999,0,9999,0
1668013415193,CSE 293,002,119118,Bellare; Mihir,9999,0,9999,0
1668013415193,CSE 293,003,119122,Berg-Kirkpatrick; Taylor D,9999,0,9999,0
1668013415193,CSE 293,004,119135,Christensen; Henrik I,9999,0,9999,0
1668013415193,CSE 293,005,119142,Cottrell; Garrison W,9999,0,9999,0
1668013415193,CSE 293,006,119146,Deutsch; Alin Bernard,9999,0,9999,0
1668013415193,CSE 293,007,119159,Esmaeilzadeh; Hadi,9999,0,9999,0
1668013415193,CSE 293,008,119166,Freund; Yoav,9999,0,9999,0
1668013415193,CSE 293,009,119170,Griswold; William G.,9999,0,9999,0
1668013415193,CSE 293,010,119183,Gymrek; Melissa Ann,9999,0,9999,0
1668013415193,CSE 293,011,119190,Heninger; Nadia A,9999,0,9999,0
1668013415193,CSE 293,012,119230,Impagliazzo; Russell,9999,0,9999,0
1668013415193,CSE 293,013,119232,Jhala; Ranjit,9999,0,9999,0
1668013415193,CSE 293,014,119233,Kahng; Andrew Byun,9999,0,9999,0
1668013415193,CSE 293,015,119298,Kane; Daniel Mertz,9999,0,9999,0
1668013415193,CSE 293,016,119299,Kriegman; David J,9999,0,9999,0
1668013415193,CSE 293,017,119300,Kumar; Arun Kumar,9999,0,9999,0
1668013415193,CSE 293,018,119301,Lerner; Sorin,9999,0,9999,0
1668013415193,CSE 293,019,119302,Lovett; Shachar,9999,0,9999,0
1668013415193,CSE 293,020,119303,McAuley; Julian John,9999,0,9999,0
1668013415193,CSE 293,021,119304,Micciancio; Daniele,9999,0,9999,0
1668013415193,CSE 293,022,119367,Orailoglu; Alex,9999,0,9999,0
1668013415193,CSE 293,023,119382,Paturi; Ramamohan,9999,0,9999,0
1668013415193,CSE 293,024,119404,Polikarpova; Nadezhda,9999,0,9999,0
1668013415193,CSE 293,025,119406,Politz; Joseph Gibbs,9999,0,9999,0
1668013415193,CSE 293,026,119411,Porter; George M,9999,0,9999,0
1668013415193,CSE 293,027,119414,Porter; Leonard Emerson,9999,0,9999,0
1668013415193,CSE 293,028,119416,Ramamoorthi; Ravi,9999,0,9999,0
1668013415193,CSE 293,029,119417,Sahoo; Debashis,9999,0,9999,0
1668013415193,CSE 293,030,119420,Saul; Lawrence,9999,0,9999,0
1668013415193,CSE 293,031,119421,Savage; Stefan,9999,0,9999,0
1668013415193,CSE 293,032,119425,Schulze; Jurgen P.,9999,0,9999,0
1668013415193,CSE 293,033,119426,Snoeren; Alex C.,9999,0,9999,0
1668013415193,CSE 293,034,119428,Shang; Jingbo,9999,0,9999,0
1668013415193,CSE 293,035,119430,Stefan; Deian,9999,0,9999,0
1668013415193,CSE 293,036,119431,Su; Hao,9999,0,9999,0
1668013415193,CSE 293,037,119433,Swanson; Steven James,9999,0,9999,0
1668013415193,CSE 293,038,119435,Tullsen; Dean Michael,9999,0,9999,0
1668013415193,CSE 293,039,119483,Voelker; Geoffrey M.,9999,0,9999,0
1668013415193,CSE 293,040,119537,Zhao; Jishen,9999,0,9999,0
1668013415193,CSE 293,041,119538,Zhou; Yuan-Yuan,9999,0,9999,0
1668013415193,CSE 293,042,119539,Gao; Sicun,9999,0,9999,0
1668013415193,CSE 293,043,119540,Weibel; Nadir,9999,0,9999,0
1668013415193,CSE 293,044,119541,Gupta; Rajesh K.,9999,0,9999,0
1668013415193,CSE 293,045,126410,Vaccaro; Kristen Marie,9999,0,9999,0
1668013415193,CSE 293,046,126411,Klemke; Richard,9999,0,9999,0
1668013415622,CSE 294,A00,102459,Voelker; Geoffrey M.,0,0,0,0
1668013415622,CSE 294,B00,111322,Orailoglu; Alex,0,0,0,0
1668013416045,DSE 201,A00,096914,Deutsch; Alin Bernard,30,0,30,0
1668013416473,DSE 210,A00,096915,Dasgupta; Sanjoy,30,0,30,0
1668013416895,DSE 260A,A00,096916,Altintas De Callaf; Ilkay,30,0,30,0
1668013417334,ECE 200,001,103586,Antipa; Nicholas A,9999,0,9999,0
1668013417334,ECE 200,002,103587,Atanasov; Nikolay A.,9999,0,9999,0
1668013417334,ECE 200,003,103588,Bharadia; Dinesh,9999,0,9999,0
1668013417334,ECE 200,004,103589,Cheng; Chung Kuan,9999,0,9999,0
1668013417334,ECE 200,005,103590,Cosman; Pamela C.,9999,0,9999,0
1668013417334,ECE 200,006,103591,Dayeh; Shadi Ahmad,9999,0,9999,0
1668013417334,ECE 200,007,103592,Fainman; Yeshaiahu,9999,0,9999,0
1668013417334,ECE 200,008,103593,Ford; Joseph Earl,9999,0,9999,0
1668013417334,ECE 200,009,103594,Franceschetti; Massimo,9999,0,9999,0
1668013417334,ECE 200,010,103595,Fullerton; Eric E,9999,0,9999,0
1668013417334,ECE 200,011,103596,Galton; Ian A,9999,0,9999,0
1668013417334,ECE 200,012,103597,Gilja; Vikash,9999,0,9999,0
1668013417334,ECE 200,013,103598,Hall; Drew A.,9999,0,9999,0
1668013417334,ECE 200,014,103599,Hsueh; Tzu-Chien,9999,0,9999,0
1668013417334,ECE 200,015,103600,Javidi; Tara,9999,0,9999,0
1668013417334,ECE 200,016,103601,Kahng; Andrew Byun,9999,0,9999,0
1668013417334,ECE 200,017,103602,Kim; Young-Han,9999,0,9999,0
1668013417334,ECE 200,018,103603,Koushanfar; Farinaz,9999,0,9999,0
1668013417334,ECE 200,019,103604,Kuzum; Duygu,9999,0,9999,0
1668013417334,ECE 200,020,103605,Le; Hanh-Phuc,9999,0,9999,0
1668013417334,ECE 200,021,103606,Lin; Bill,9999,0,9999,0
1668013417334,ECE 200,022,103607,Liu; Zhaowei,9998,0,9999,1
1668013417334,ECE 200,023,103608,Lo; Yu-Hwa,9999,0,9999,0
1668013417334,ECE 200,024,103609,Lomakin; Vitaliy,9999,0,9999,0
1668013417334,ECE 200,025,103610,Mercier; Patrick Philip,9999,0,9999,0
1668013417334,ECE 200,026,103611,Meyer; Florian,9999,0,9999,0
1668013417334,ECE 200,027,103612,Milstein; Laurence B.,9999,0,9999,0
1668013417334,ECE 200,028,103613,Mir Arabbaygi; Siavash,9999,0,9999,0
1668013417334,ECE 200,029,103614,Mookherjea; Shayan,9999,0,9999,0
1668013417334,ECE 200,030,103615,Morris; Karcher William,9999,0,9999,0
1668013417334,ECE 200,031,103616,Ng; Tse Nga,9999,0,9999,0
1668013417334,ECE 200,032,103617,Nguyen; Truong Quang,9999,0,9999,0
1668013417334,ECE 200,033,103618,Nomura; Kenji,9999,0,9999,0
1668013417334,ECE 200,034,103619,Orlitsky; Alon,9999,0,9999,0
1668013417334,ECE 200,035,103620,Pal; Piya,9999,0,9999,0
1668013417334,ECE 200,036,103621,Papen; George C.,9999,0,9999,0
1668013417334,ECE 200,037,103622,Radic; Stojan,9999,0,9999,0
1668013417334,ECE 200,038,103623,Rao; Bhaskar D.,9999,0,9999,0
1668013417334,ECE 200,039,103624,Rao; Ramesh R,9999,0,9999,0
1668013417334,ECE 200,040,103625,Rebeiz; Gabriel,9999,0,9999,0
1668013417334,ECE 200,041,103626,Sanford; John R,9999,0,9999,0
1668013417334,ECE 200,042,103627,Siegel; Paul H.,9999,0,9999,0
1668013417334,ECE 200,043,103628,Sievenpiper; Daniel F.,9999,0,9999,0
1668013417334,ECE 200,044,103629,Sworder; David D.,9999,0,9999,0
1668013417334,ECE 200,045,103630,Taur; Yuan,9999,0,9999,0
1668013417334,ECE 200,046,103631,Touri; Behrouz,9999,0,9999,0
1668013417334,ECE 200,047,103632,Trivedi; Mohan M.,9999,0,9999,0
1668013417334,ECE 200,048,103633,Vasconcelos; Nuno,9999,0,9999,0
1668013417334,ECE 200,049,103634,Wang; Xiaolong,9999,0,9999,0
1668013417334,ECE 200,050,103635,Xie; Pengtao,9999,0,9999,0
1668013417334,ECE 200,051,103636,Yip; Michael,9999,0,9999,0
1668013417334,ECE 200,052,103637,Zeger; Kenneth A.,999,0,999,0
1668013417334,ECE 200,053,103638,Zhang; Xinyu,9999,0,9999,0
1668013417334,ECE 200,054,103639,Turakhia; Yatish Girish,9999,0,9999,0
1668013417334,ECE 200,055,103640,Kang; Mingu,9999,0,9999,0
1668013417334,ECE 200,056,103641,Shi; Yuanyuan,9999,0,9999,0
1668013417334,ECE 200,057,103642,Wang; Edward Jay,9999,0,9999,0
1668013417334,ECE 200,058,103643,Zheng; Yang,9999,0,9999,0
1668013417768,ECE 202,A00,103644,Kuzum; Duygu,0,0,0,0
1668013418209,ECE 212BN,A00,103646,Ng; Tse Nga,0,0,0,0
1668013418633,ECE 221,A00,111493,Staff,0,0,0,0
1668013419061,ECE 222B,A00,103647,Lomakin; Vitaliy,0,0,0,0
1668013419482,ECE 230B,A00,103648,Taur; Yuan,0,0,0,0
1668013419923,ECE 238B,A00,103649,Garay; Javier,0,0,0,0
1668013420352,ECE 240B,A00,112900,Fainman; Yeshaiahu,0,0,0,0
1668013420889,ECE 247A,A00,103650,Jokerst; Jesse Vincent,0,0,0,0
1668013421316,ECE 247B,A00,103651,Wang; Joseph,0,0,0,0
1668013421742,ECE 250,A00,103652,Siegel; Paul H.,0,0,0,0
1668013422169,ECE 251A,A00,103654,Rao; Bhaskar D.,0,0,0,0
1668013422592,ECE 257B,A00,103655,Bharadia; Dinesh,0,0,0,0
1668013423020,ECE 258A,A00,103656,Milstein; Laurence B.,0,0,0,0
1668013423447,ECE 260B,A00,103658,Kang; Mingu,0,0,0,0
1668013423884,ECE 264A,A00,103659,Galton; Ian A,0,0,0,0
1668013424311,ECE 265A,A00,103661,Gudem; Prasad S.S.,0,0,0,0
1668013424750,ECE 265D,A00,103662,Gudem; Prasad S.S.,0,0,0,0
1668013425175,ECE 268,A00,103663,Koushanfar; Farinaz,0,0,0,0
1668013425610,ECE 269,A01,103665,Pal; Piya,0,0,0,0
1668013426040,ECE 271B,A00,103666,Vasconcelos; Manuela,0,0,0,0
1668013426463,ECE 276A,A00,103667,Atanasov; Nikolay A.,0,0,0,0
1668013426887,ECE 277,A00,103668,An; Cheolhong,0,0,0,0
1668013427317,ECE 279,A00,117947,Hall; Drew A.,0,0,0,0
1668013428166,ECE 283,A00,103670,Hsueh; Tzu-Chien,0,0,0,0
1668013428591,ECE 284,A00,103671,Turakhia; Yatish Girish,0,0,0,0
1668013429015,ECE 285,A00,103672,Zheng; Yang,0,0,0,0
1668013429015,ECE 285,B00,103673,Sworder; David D.,0,0,0,0
1668013429442,ECE 287,A00,103676,Javidi; Tara,0,0,0,0
1668013429875,MATH 200B,A00,098023,Salehi Golsefidy; Alireza,14,0,15,1
1668013430299,MATH 202B,A00,098024,Rhoades; Brendon Patrick,12,0,15,3
1668013430724,MATH 203B,A00,098025,Oprea; Dragos N.,12,0,15,3
1668013431151,MATH 204B,A00,098026,Sorensen; Claus M,14,0,15,1
1668013431579,MATH 208,A00,098027,Izadi; Elham,7,0,10,3
1668013432002,MATH 209,A00,098028,Pollack; Aaron,10,0,10,0
1668013432426,MATH 211A,A00,112919,Rogalski; Daniel,9,0,10,1
1668013432849,MATH 211B,A00,112920,Seward; Brandon M.,9,0,10,1
1668013433274,MATH 218,A00,098029,Li; Bo,10,0,10,0
1668013433699,MATH 220B,A00,098030,Novak; Jonathan I,13,0,15,2
1668013434135,MATH 221A,A00,098031,Ebenfelt; Peter F,13,0,15,2
1668013434563,MATH 231B,A00,098032,Zlatos; Andrej,12,0,15,3
1668013434988,MATH 240B,A00,098033,Ni; Lei,10,0,15,5
1668013435414,MATH 243,A00,098034,Jekel; David Andrew,10,0,10,0
1668013435844,MATH 245A,A00,098035,Nie; Jiawang,0,0,15,16
1668013436274,MATH 248,A00,098036,Bejenaru; Ioan,10,0,10,0
1668013436698,MATH 250B,A00,098037,Spolaor; Luca,14,0,15,1
1668013437122,MATH 258,A00,098038,Ni; Lei,10,0,10,0
1668013437545,MATH 264B,A00,098041,Rhoades; Brendon Patrick,11,0,15,4
1668013437971,MATH 268,A00,098042,Buss; Samuel R,10,0,10,0
1668013438394,MATH 269,A00,098043,Rhoades; Brendon Patrick,10,0,10,0
1668013438834,MATH 270B,A00,098044,Li; Bo,11,0,15,4
1668013439270,MATH 272B,A00,098045,Holst; Michael J,13,0,15,2
1668013439697,MATH 273A,A00,098046,Tian; Xiaochuan,12,0,15,3
1668013440122,MATH 275,A01,098048,Tian; Xiaochuan,6,0,10,4
1668013440554,MATH 278A,A00,098049,Holst; Michael J,8,0,10,2
1668013440979,MATH 278B,A00,098050,Cloninger; Alexander,10,0,10,0
1668013441410,MATH 278C,A00,098051,Nie; Jiawang,8,0,10,2
1668013441833,MATH 280B,A00,098052,Zheng; Tianyi,11,0,15,4
1668013442258,MATH 281B,A00,098053,Bradic; Jelena,4,0,15,11
1668013442683,MATH 282B,A00,098054,Arias-Castro; Ery,2,0,15,13
1668013443115,MATH 285,A00,098055,Fitzsimmons; Patrick J,0,0,15,17
1668013443540,MATH 287B,A00,098056,Arias-Castro; Ery,5,0,15,10
1668013444058,MATH 288,A00,098057,Agarwal; Pooja,9,0,10,1
1668013444058,MATH 288,B00,098058,Zhang; Danna,9,0,10,1
1668013444058,MATH 288,C00,098059,Williams; Ruth J,10,0,10,0
1668013444486,MATH 290B,A00,098060,Roberts; Justin Deritter,14,0,15,1
1668013444910,MATH 292,A00,098061,Belmont; Eva Kinoshita,10,0,10,0
1668013445337,MATH 295,A00,098062,Suk; Andrew Hoon,48,0,50,2
1668013445762,MATH 296,A00,098063,Novak; Jonathan I,20,0,20,0
1668013446191,MATH 297,001,098064,Gamst; Anthony Collins,9997,0,9999,2
1668013950413,COGS 205,A00,101395,Chiba; Andrea,19,0,20,1
1668013950836,COGS 210B,001,101404,Greene; Deanna Jacquelyn,9998,0,9999,1
1668013950836,COGS 210B,002,101417,Xia; Haijun,9999,0,9999,0
1668013950836,COGS 210B,003,101422,Nitz; Douglas A.,9999,0,9999,0
1668013950836,COGS 210B,004,101423,Hollan; James D.,9998,0,9999,1
1668013950836,COGS 210B,005,101424,Deak; Gedeon O.,9999,0,9999,0
1668013950836,COGS 210B,006,101425,Rossano; Federico,9999,0,9999,0
1668013951267,COGS 211B,A00,101427,Coulson; Seana M,9997,0,9999,2
1668013951703,COGS 220,A00,101428,Hollan; James D.,0,0,25,25
1668013952139,COGS 229,A00,101429,Dow; Steven P,18,0,25,7
1668013952574,COGS 230,A00,101430,Klemmer; Scott R,13,0,17,4
1668013953002,COGS 234,A00,101431,Xia; Haijun,7,0,25,18
1668013953445,COGS 260,A00,101432,Kiyonaga; Anastasia,20,0,25,5
1668013953445,COGS 260,B00,101433,Kirsh; David Joel,16,0,25,9
1668013953871,CSE 202,A00,102371,Impagliazzo; Russell,0,0,0,0
1668013954303,CSE 203B,A01,102373,Cheng; Chung Kuan,0,0,0,0
1668013954744,CSE 208,A00,102374,Micciancio; Daniele,0,0,0,0
1668013955181,CSE 209A,A00,112895,Impagliazzo; Russell,0,0,15,15
1668013955604,CSE 209B,A00,108005,Bellare; Mihir,0,0,0,0
1668013956032,CSE 210,A00,113163,Coblenz; Michael J,0,0,0,0
1668013956455,CSE 219,A00,106111,Dow; Steven P,0,0,20,20
1668013956878,CSE 221,A00,102376,Voelker; Geoffrey M.,0,0,0,0
1668013957313,CSE 224,A01,102378,Porter; George M,0,0,0,0
1668013957742,CSE 229A,A00,102379,Savage; Stefan,0,0,0,0
1668013958168,CSE 229C,A00,102380,Munyaka; Imani N. S.,0,0,0,0
1668013958592,CSE 232B,A00,102382,Deutsch; Alin Bernard,0,0,0,0
1668013959018,CSE 234,A01,112904,Kumar; Arun Kumar,0,0,0,0
1668013959465,CSE 237A,A00,102383,Rosing; Tajana Simunic,0,0,0,0
1668013959890,CSE 239A,A00,102384,Deutsch; Alin Bernard,0,0,0,0
1668013960329,CSE 239B,A00,102385,Polikarpova; Nadezhda,0,0,0,0
1668013960763,CSE 240A,A00,102386,Pannuto; Patrick William,0,0,0,0
1668013961185,CSE 240B,A00,102387,Zhao; Jishen,0,0,0,0
1668013961609,CSE 241A,A00,106406,Kang; Mingu,0,0,0,0
1668013962034,CSE 249B,A00,102388,Kahng; Andrew Byun,0,0,8,8
1668013962470,CSE 251B,A01,102392,Cottrell; Garrison W,0,0,0,0
1668013962470,CSE 251B,A02,102393,Cottrell; Garrison W,0,0,0,0
1668013962911,CSE 252B,A00,102394,Ochoa; Benjamin Lawrence,0,0,0,0
1668013963343,CSE 257,A01,102396,Gao; Sicun,0,0,0,0
1668013963765,CSE 272,A00,102397,Li; Tzumao,0,0,0,0
1668013964189,CSE 274,A00,111323,Chern; Albert Ren-Haur,0,0,0,0
1668013964615,CSE 282,A00,102398,Pevzner; Pavel Arkadjevich,0,0,0,0
1668013965038,CSE 284,A00,114175,Gymrek; Melissa Ann,0,0,0,0
1668013965461,CSE 290,A00,102399,Chandraker; Manmohan Krishna,0,0,0,0
1668013965461,CSE 290,B00,102400,Vaccaro; Kristen Marie,0,0,25,25
1668013965461,CSE 290,C00,102414,Pannuto; Patrick William,0,0,25,25
1668013965461,CSE 290,D00,102427,Pevzner; Pavel Arkadjevich,0,0,0,0
1668013965461,CSE 290,E00,102429,Zhao; Jishen,0,0,0,0
1668013965461,CSE 290,F00,102436,Tullsen; Dean Michael,0,0,0,0
1668013965461,CSE 290,G00,102440,Christensen; Henrik I,0,0,20,20
1668013965887,CSE 291,A00,102443,Su; Hao,0,0,0,0
1668013965887,CSE 291,B00,102448,Polikarpova; Nadezhda,0,0,0,0
1668013965887,CSE 291,C00,102453,Vaccaro; Kristen Marie,0,0,0,0
1668013965887,CSE 291,D00,111343,Savage; Stefan,0,0,0,0
1668013965887,CSE 291,E00,116474,Claffy; Kimberly Claire,0,0,0,0
1668013965887,CSE 291,F00,116479,Pasquale; Joseph,0,0,0,0
1668013966327,CSE 293,001,119111,Bafna; Vineet,9999,0,9999,0
1668013966327,CSE 293,002,119118,Bellare; Mihir,9999,0,9999,0
1668013966327,CSE 293,003,119122,Berg-Kirkpatrick; Taylor D,9999,0,9999,0
1668013966327,CSE 293,004,119135,Christensen; Henrik I,9999,0,9999,0
1668013966327,CSE 293,005,119142,Cottrell; Garrison W,9999,0,9999,0
1668013966327,CSE 293,006,119146,Deutsch; Alin Bernard,9999,0,9999,0
1668013966327,CSE 293,007,119159,Esmaeilzadeh; Hadi,9999,0,9999,0
1668013966327,CSE 293,008,119166,Freund; Yoav,9999,0,9999,0
1668013966327,CSE 293,009,119170,Griswold; William G.,9999,0,9999,0
1668013966327,CSE 293,010,119183,Gymrek; Melissa Ann,9999,0,9999,0
1668013966327,CSE 293,011,119190,Heninger; Nadia A,9999,0,9999,0
1668013966327,CSE 293,012,119230,Impagliazzo; Russell,9999,0,9999,0
1668013966327,CSE 293,013,119232,Jhala; Ranjit,9999,0,9999,0
1668013966327,CSE 293,014,119233,Kahng; Andrew Byun,9999,0,9999,0
1668013966327,CSE 293,015,119298,Kane; Daniel Mertz,9999,0,9999,0
1668013966327,CSE 293,016,119299,Kriegman; David J,9999,0,9999,0
1668013966327,CSE 293,017,119300,Kumar; Arun Kumar,9999,0,9999,0
1668013966327,CSE 293,018,119301,Lerner; Sorin,9999,0,9999,0
1668013966327,CSE 293,019,119302,Lovett; Shachar,9999,0,9999,0
1668013966327,CSE 293,020,119303,McAuley; Julian John,9999,0,9999,0
1668013966327,CSE 293,021,119304,Micciancio; Daniele,9999,0,9999,0
1668013966327,CSE 293,022,119367,Orailoglu; Alex,9999,0,9999,0
1668013966327,CSE 293,023,119382,Paturi; Ramamohan,9999,0,9999,0
1668013966327,CSE 293,024,119404,Polikarpova; Nadezhda,9999,0,9999,0
1668013966327,CSE 293,025,119406,Politz; Joseph Gibbs,9999,0,9999,0
1668013966327,CSE 293,026,119411,Porter; George M,9999,0,9999,0
1668013966327,CSE 293,027,119414,Porter; Leonard Emerson,9999,0,9999,0
1668013966327,CSE 293,028,119416,Ramamoorthi; Ravi,9999,0,9999,0
1668013966327,CSE 293,029,119417,Sahoo; Debashis,9999,0,9999,0
1668013966327,CSE 293,030,119420,Saul; Lawrence,9999,0,9999,0
1668013966327,CSE 293,031,119421,Savage; Stefan,9999,0,9999,0
1668013966327,CSE 293,032,119425,Schulze; Jurgen P.,9999,0,9999,0
1668013966327,CSE 293,033,119426,Snoeren; Alex C.,9999,0,9999,0
1668013966327,CSE 293,034,119428,Shang; Jingbo,9999,0,9999,0
1668013966327,CSE 293,035,119430,Stefan; Deian,9999,0,9999,0
1668013966327,CSE 293,036,119431,Su; Hao,9999,0,9999,0
1668013966327,CSE 293,037,119433,Swanson; Steven James,9999,0,9999,0
1668013966327,CSE 293,038,119435,Tullsen; Dean Michael,9999,0,9999,0
1668013966327,CSE 293,039,119483,Voelker; Geoffrey M.,9999,0,9999,0
1668013966327,CSE 293,040,119537,Zhao; Jishen,9999,0,9999,0
1668013966327,CSE 293,041,119538,Zhou; Yuan-Yuan,9999,0,9999,0
1668013966327,CSE 293,042,119539,Gao; Sicun,9999,0,9999,0
1668013966327,CSE 293,043,119540,Weibel; Nadir,9999,0,9999,0
1668013966327,CSE 293,044,119541,Gupta; Rajesh K.,9999,0,9999,0
1668013966327,CSE 293,045,126410,Vaccaro; Kristen Marie,9999,0,9999,0
1668013966327,CSE 293,046,126411,Klemke; Richard,9999,0,9999,0
1668013966750,CSE 294,A00,102459,Voelker; Geoffrey M.,0,0,0,0
1668013966750,CSE 294,B00,111322,Orailoglu; Alex,0,0,0,0
1668013967181,DSE 201,A00,096914,Deutsch; Alin Bernard,30,0,30,0
1668013967604,DSE 210,A00,096915,Dasgupta; Sanjoy,30,0,30,0
1668013968028,DSE 260A,A00,096916,Altintas De Callaf; Ilkay,30,0,30,0
1668013968565,ECE 200,001,103586,Antipa; Nicholas A,9999,0,9999,0
1668013968565,ECE 200,002,103587,Atanasov; Nikolay A.,9999,0,9999,0
1668013968565,ECE 200,003,103588,Bharadia; Dinesh,9999,0,9999,0
1668013968565,ECE 200,004,103589,Cheng; Chung Kuan,9999,0,9999,0
1668013968565,ECE 200,005,103590,Cosman; Pamela C.,9999,0,9999,0
1668013968565,ECE 200,006,103591,Dayeh; Shadi Ahmad,9999,0,9999,0
1668013968565,ECE 200,007,103592,Fainman; Yeshaiahu,9999,0,9999,0
1668013968565,ECE 200,008,103593,Ford; Joseph Earl,9999,0,9999,0
1668013968565,ECE 200,009,103594,Franceschetti; Massimo,9999,0,9999,0
1668013968565,ECE 200,010,103595,Fullerton; Eric E,9999,0,9999,0
1668013968565,ECE 200,011,103596,Galton; Ian A,9999,0,9999,0
1668013968565,ECE 200,012,103597,Gilja; Vikash,9999,0,9999,0
1668013968565,ECE 200,013,103598,Hall; Drew A.,9999,0,9999,0
1668013968565,ECE 200,014,103599,Hsueh; Tzu-Chien,9999,0,9999,0
1668013968565,ECE 200,015,103600,Javidi; Tara,9999,0,9999,0
1668013968565,ECE 200,016,103601,Kahng; Andrew Byun,9999,0,9999,0
1668013968565,ECE 200,017,103602,Kim; Young-Han,9999,0,9999,0
1668013968565,ECE 200,018,103603,Koushanfar; Farinaz,9999,0,9999,0
1668013968565,ECE 200,019,103604,Kuzum; Duygu,9999,0,9999,0
1668013968565,ECE 200,020,103605,Le; Hanh-Phuc,9999,0,9999,0
1668013968565,ECE 200,021,103606,Lin; Bill,9999,0,9999,0
1668013968565,ECE 200,022,103607,Liu; Zhaowei,9998,0,9999,1
1668013968565,ECE 200,023,103608,Lo; Yu-Hwa,9999,0,9999,0
1668013968565,ECE 200,024,103609,Lomakin; Vitaliy,9999,0,9999,0
1668013968565,ECE 200,025,103610,Mercier; Patrick Philip,9999,0,9999,0
1668013968565,ECE 200,026,103611,Meyer; Florian,9999,0,9999,0
1668013968565,ECE 200,027,103612,Milstein; Laurence B.,9999,0,9999,0
1668013968565,ECE 200,028,103613,Mir Arabbaygi; Siavash,9999,0,9999,0
1668013968565,ECE 200,029,103614,Mookherjea; Shayan,9999,0,9999,0
1668013968565,ECE 200,030,103615,Morris; Karcher William,9999,0,9999,0
1668013968565,ECE 200,031,103616,Ng; Tse Nga,9999,0,9999,0
1668013968565,ECE 200,032,103617,Nguyen; Truong Quang,9999,0,9999,0
1668013968565,ECE 200,033,103618,Nomura; Kenji,9999,0,9999,0
1668013968565,ECE 200,034,103619,Orlitsky; Alon,9999,0,9999,0
1668013968565,ECE 200,035,103620,Pal; Piya,9999,0,9999,0
1668013968565,ECE 200,036,103621,Papen; George C.,9999,0,9999,0
1668013968565,ECE 200,037,103622,Radic; Stojan,9999,0,9999,0
1668013968565,ECE 200,038,103623,Rao; Bhaskar D.,9999,0,9999,0
1668013968565,ECE 200,039,103624,Rao; Ramesh R,9999,0,9999,0
1668013968565,ECE 200,040,103625,Rebeiz; Gabriel,9999,0,9999,0
1668013968565,ECE 200,041,103626,Sanford; John R,9999,0,9999,0
1668013968565,ECE 200,042,103627,Siegel; Paul H.,9999,0,9999,0
1668013968565,ECE 200,043,103628,Sievenpiper; Daniel F.,9999,0,9999,0
1668013968565,ECE 200,044,103629,Sworder; David D.,9999,0,9999,0
1668013968565,ECE 200,045,103630,Taur; Yuan,9999,0,9999,0
1668013968565,ECE 200,046,103631,Touri; Behrouz,9999,0,9999,0
1668013968565,ECE 200,047,103632,Trivedi; Mohan M.,9999,0,9999,0
1668013968565,ECE 200,048,103633,Vasconcelos; Nuno,9999,0,9999,0
1668013968565,ECE 200,049,103634,Wang; Xiaolong,9999,0,9999,0
1668013968565,ECE 200,050,103635,Xie; Pengtao,9999,0,9999,0
1668013968565,ECE 200,051,103636,Yip; Michael,9999,0,9999,0
1668013968565,ECE 200,052,103637,Zeger; Kenneth A.,999,0,999,0
1668013968565,ECE 200,053,103638,Zhang; Xinyu,9999,0,9999,0
1668013968565,ECE 200,054,103639,Turakhia; Yatish Girish,9999,0,9999,0
1668013968565,ECE 200,055,103640,Kang; Mingu,9999,0,9999,0
1668013968565,ECE 200,056,103641,Shi; Yuanyuan,9999,0,9999,0
1668013968565,ECE 200,057,103642,Wang; Edward Jay,9999,0,9999,0
1668013968565,ECE 200,058,103643,Zheng; Yang,9999,0,9999,0
1668013968996,ECE 202,A00,103644,Kuzum; Duygu,0,0,0,0
1668013969421,ECE 212BN,A00,103646,Ng; Tse Nga,0,0,0,0
1668013969845,ECE 221,A00,111493,Staff,0,0,0,0
1668013970269,ECE 222B,A00,103647,Lomakin; Vitaliy,0,0,0,0
1668013970693,ECE 230B,A00,103648,Taur; Yuan,0,0,0,0
1668013971133,ECE 238B,A00,103649,Garay; Javier,0,0,0,0
1668013971557,ECE 240B,A00,112900,Fainman; Yeshaiahu,0,0,0,0
1668013971994,ECE 247A,A00,103650,Jokerst; Jesse Vincent,0,0,0,0
1668013972425,ECE 247B,A00,103651,Wang; Joseph,0,0,0,0
1668013972858,ECE 250,A00,103652,Siegel; Paul H.,0,0,0,0
1668013973285,ECE 251A,A00,103654,Rao; Bhaskar D.,0,0,0,0
1668013973711,ECE 257B,A00,103655,Bharadia; Dinesh,0,0,0,0
1668013974134,ECE 258A,A00,103656,Milstein; Laurence B.,0,0,0,0
1668013974560,ECE 260B,A00,103658,Kang; Mingu,0,0,0,0
1668013974990,ECE 264A,A00,103659,Galton; Ian A,0,0,0,0
1668013975419,ECE 265A,A00,103661,Gudem; Prasad S.S.,0,0,0,0
1668013975844,ECE 265D,A00,103662,Gudem; Prasad S.S.,0,0,0,0
1668013976272,ECE 268,A00,103663,Koushanfar; Farinaz,0,0,0,0
1668013976711,ECE 269,A01,103665,Pal; Piya,0,0,0,0
1668013977134,ECE 271B,A00,103666,Vasconcelos; Manuela,0,0,0,0
1668013977564,ECE 276A,A00,103667,Atanasov; Nikolay A.,0,0,0,0
1668013978005,ECE 277,A00,103668,An; Cheolhong,0,0,0,0
1668013978458,ECE 279,A00,117947,Hall; Drew A.,0,0,0,0
1668013979330,ECE 283,A00,103670,Hsueh; Tzu-Chien,0,0,0,0
1668013979774,ECE 284,A00,103671,Turakhia; Yatish Girish,0,0,0,0
1668013980199,ECE 285,A00,103672,Zheng; Yang,0,0,0,0
1668013980199,ECE 285,B00,103673,Sworder; David D.,0,0,0,0
1668013980622,ECE 287,A00,103676,Javidi; Tara,0,0,0,0
1668013981060,MATH 200B,A00,098023,Salehi Golsefidy; Alireza,14,0,15,1
1668013981485,MATH 202B,A00,098024,Rhoades; Brendon Patrick,11,0,15,4
1668013981910,MATH 203B,A00,098025,Oprea; Dragos N.,12,0,15,3
1668013982349,MATH 204B,A00,098026,Sorensen; Claus M,14,0,15,1
1668013982772,MATH 208,A00,098027,Izadi; Elham,7,0,10,3
1668013983206,MATH 209,A00,098028,Pollack; Aaron,10,0,10,0
1668013983636,MATH 211A,A00,112919,Rogalski; Daniel,9,0,10,1
1668013984062,MATH 211B,A00,112920,Seward; Brandon M.,9,0,10,1
1668013984483,MATH 218,A00,098029,Li; Bo,10,0,10,0
1668013984906,MATH 220B,A00,098030,Novak; Jonathan I,13,0,15,2
1668013985338,MATH 221A,A00,098031,Ebenfelt; Peter F,13,0,15,2
1668013985771,MATH 231B,A00,098032,Zlatos; Andrej,12,0,15,3
1668013986194,MATH 240B,A00,098033,Ni; Lei,10,0,15,5
1668013986619,MATH 243,A00,098034,Jekel; David Andrew,10,0,10,0
1668013987045,MATH 245A,A00,098035,Nie; Jiawang,0,0,15,16
1668013987472,MATH 248,A00,098036,Bejenaru; Ioan,10,0,10,0
1668013987894,MATH 250B,A00,098037,Spolaor; Luca,14,0,15,1
1668013988331,MATH 258,A00,098038,Ni; Lei,10,0,10,0
1668013988756,MATH 264B,A00,098041,Rhoades; Brendon Patrick,11,0,15,4
1668013989179,MATH 268,A00,098042,Buss; Samuel R,10,0,10,0
1668013989602,MATH 269,A00,098043,Rhoades; Brendon Patrick,10,0,10,0
1668013990024,MATH 270B,A00,098044,Li; Bo,11,0,15,4
1668013990448,MATH 272B,A00,098045,Holst; Michael J,13,0,15,2
1668013990881,MATH 273A,A00,098046,Tian; Xiaochuan,12,0,15,3
1668013991322,MATH 275,A01,098048,Tian; Xiaochuan,6,0,10,4
1668013991758,MATH 278A,A00,098049,Holst; Michael J,8,0,10,2
1668013992182,MATH 278B,A00,098050,Cloninger; Alexander,10,0,10,0
1668013992605,MATH 278C,A00,098051,Nie; Jiawang,8,0,10,2
1668013993029,MATH 280B,A00,098052,Zheng; Tianyi,11,0,15,4
1668013993459,MATH 281B,A00,098053,Bradic; Jelena,4,0,15,11
1668013993884,MATH 282B,A00,098054,Arias-Castro; Ery,2,0,15,13
1668013994311,MATH 285,A00,098055,Fitzsimmons; Patrick J,0,0,15,17
1668013994738,MATH 287B,A00,098056,Arias-Castro; Ery,5,0,15,10
1668013995161,MATH 288,A00,098057,Agarwal; Pooja,9,0,10,1
1668013995161,MATH 288,B00,098058,Zhang; Danna,9,0,10,1
1668013995161,MATH 288,C00,098059,Williams; Ruth J,10,0,10,0
1668013995592,MATH 290B,A00,098060,Roberts; Justin Deritter,14,0,15,1
1668013996023,MATH 292,A00,098061,Belmont; Eva Kinoshita,10,0,10,0
1668013996451,MATH 295,A00,098062,Suk; Andrew Hoon,48,0,50,2
1668013996887,MATH 296,A00,098063,Novak; Jonathan I,20,0,20,0
1668013997310,MATH 297,001,098064,Gamst; Anthony Collins,9997,0,9999,2
1668014501120,COGS 205,A00,101395,Chiba; Andrea,19,0,20,1
1668014501548,COGS 210B,001,101404,Greene; Deanna Jacquelyn,9998,0,9999,1
1668014501548,COGS 210B,002,101417,Xia; Haijun,9999,0,9999,0
1668014501548,COGS 210B,003,101422,Nitz; Douglas A.,9999,0,9999,0
1668014501548,COGS 210B,004,101423,Hollan; James D.,9998,0,9999,1
1668014501548,COGS 210B,005,101424,Deak; Gedeon O.,9999,0,9999,0
1668014501548,COGS 210B,006,101425,Rossano; Federico,9999,0,9999,0
1668014501972,COGS 211B,A00,101427,Coulson; Seana M,9997,0,9999,2
1668014502395,COGS 220,A00,101428,Hollan; James D.,0,0,25,25
1668014502821,COGS 229,A00,101429,Dow; Steven P,18,0,25,7
1668014503248,COGS 230,A00,101430,Klemmer; Scott R,13,0,17,4
1668014503674,COGS 234,A00,101431,Xia; Haijun,7,0,25,18
1668014504098,COGS 260,A00,101432,Kiyonaga; Anastasia,20,0,25,5
1668014504098,COGS 260,B00,101433,Kirsh; David Joel,16,0,25,9
1668014504521,CSE 202,A00,102371,Impagliazzo; Russell,0,0,0,0
1668014504948,CSE 203B,A01,102373,Cheng; Chung Kuan,0,0,0,0
1668014505372,CSE 208,A00,102374,Micciancio; Daniele,0,0,0,0
1668014505796,CSE 209A,A00,112895,Impagliazzo; Russell,0,0,15,15
1668014506218,CSE 209B,A00,108005,Bellare; Mihir,0,0,0,0
1668014506646,CSE 210,A00,113163,Coblenz; Michael J,0,0,0,0
1668014507069,CSE 219,A00,106111,Dow; Steven P,0,0,20,20
1668014507504,CSE 221,A00,102376,Voelker; Geoffrey M.,0,0,0,0
1668014507934,CSE 224,A01,102378,Porter; George M,0,0,0,0
1668014508362,CSE 229A,A00,102379,Savage; Stefan,0,0,0,0
1668014508786,CSE 229C,A00,102380,Munyaka; Imani N. S.,0,0,0,0
1668014509213,CSE 232B,A00,102382,Deutsch; Alin Bernard,0,0,0,0
1668014509647,CSE 234,A01,112904,Kumar; Arun Kumar,0,0,0,0
1668014510074,CSE 237A,A00,102383,Rosing; Tajana Simunic,0,0,0,0
1668014510499,CSE 239A,A00,102384,Deutsch; Alin Bernard,0,0,0,0
1668014510922,CSE 239B,A00,102385,Polikarpova; Nadezhda,0,0,0,0
1668014511352,CSE 240A,A00,102386,Pannuto; Patrick William,0,0,0,0
1668014511775,CSE 240B,A00,102387,Zhao; Jishen,0,0,0,0
1668014512199,CSE 241A,A00,106406,Kang; Mingu,0,0,0,0
1668014512624,CSE 249B,A00,102388,Kahng; Andrew Byun,0,0,8,8
1668014513054,CSE 251B,A01,102392,Cottrell; Garrison W,0,0,0,0
1668014513054,CSE 251B,A02,102393,Cottrell; Garrison W,0,0,0,0
1668014513489,CSE 252B,A00,102394,Ochoa; Benjamin Lawrence,0,0,0,0
1668014513914,CSE 257,A01,102396,Gao; Sicun,0,0,0,0
1668014514340,CSE 272,A00,102397,Li; Tzumao,0,0,0,0
1668014514782,CSE 274,A00,111323,Chern; Albert Ren-Haur,0,0,0,0
1668014515204,CSE 282,A00,102398,Pevzner; Pavel Arkadjevich,0,0,0,0
1668014515629,CSE 284,A00,114175,Gymrek; Melissa Ann,0,0,0,0
1668014516072,CSE 290,A00,102399,Chandraker; Manmohan Krishna,0,0,0,0
1668014516072,CSE 290,B00,102400,Vaccaro; Kristen Marie,0,0,25,25
1668014516072,CSE 290,C00,102414,Pannuto; Patrick William,0,0,25,25
1668014516072,CSE 290,D00,102427,Pevzner; Pavel Arkadjevich,0,0,0,0
1668014516072,CSE 290,E00,102429,Zhao; Jishen,0,0,0,0
1668014516072,CSE 290,F00,102436,Tullsen; Dean Michael,0,0,0,0
1668014516072,CSE 290,G00,102440,Christensen; Henrik I,0,0,20,20
1668014516508,CSE 291,A00,102443,Su; Hao,0,0,0,0
1668014516508,CSE 291,B00,102448,Polikarpova; Nadezhda,0,0,0,0
1668014516508,CSE 291,C00,102453,Vaccaro; Kristen Marie,0,0,0,0
1668014516508,CSE 291,D00,111343,Savage; Stefan,0,0,0,0
1668014516508,CSE 291,E00,116474,Claffy; Kimberly Claire,0,0,0,0
1668014516508,CSE 291,F00,116479,Pasquale; Joseph,0,0,0,0
1668014516970,CSE 293,001,119111,Bafna; Vineet,9999,0,9999,0
1668014516970,CSE 293,002,119118,Bellare; Mihir,9999,0,9999,0
1668014516970,CSE 293,003,119122,Berg-Kirkpatrick; Taylor D,9999,0,9999,0
1668014516970,CSE 293,004,119135,Christensen; Henrik I,9999,0,9999,0
1668014516970,CSE 293,005,119142,Cottrell; Garrison W,9999,0,9999,0
1668014516970,CSE 293,006,119146,Deutsch; Alin Bernard,9999,0,9999,0
1668014516970,CSE 293,007,119159,Esmaeilzadeh; Hadi,9999,0,9999,0
1668014516970,CSE 293,008,119166,Freund; Yoav,9999,0,9999,0
1668014516970,CSE 293,009,119170,Griswold; William G.,9999,0,9999,0
1668014516970,CSE 293,010,119183,Gymrek; Melissa Ann,9999,0,9999,0
1668014516970,CSE 293,011,119190,Heninger; Nadia A,9999,0,9999,0
1668014516970,CSE 293,012,119230,Impagliazzo; Russell,9999,0,9999,0
1668014516970,CSE 293,013,119232,Jhala; Ranjit,9999,0,9999,0
1668014516970,CSE 293,014,119233,Kahng; Andrew Byun,9999,0,9999,0
1668014516970,CSE 293,015,119298,Kane; Daniel Mertz,9999,0,9999,0
1668014516970,CSE 293,016,119299,Kriegman; David J,9999,0,9999,0
1668014516970,CSE 293,017,119300,Kumar; Arun Kumar,9999,0,9999,0
1668014516970,CSE 293,018,119301,Lerner; Sorin,9999,0,9999,0
1668014516970,CSE 293,019,119302,Lovett; Shachar,9999,0,9999,0
1668014516970,CSE 293,020,119303,McAuley; Julian John,9999,0,9999,0
1668014516970,CSE 293,021,119304,Micciancio; Daniele,9999,0,9999,0
1668014516970,CSE 293,022,119367,Orailoglu; Alex,9999,0,9999,0
1668014516970,CSE 293,023,119382,Paturi; Ramamohan,9999,0,9999,0
1668014516970,CSE 293,024,119404,Polikarpova; Nadezhda,9999,0,9999,0
1668014516970,CSE 293,025,119406,Politz; Joseph Gibbs,9999,0,9999,0
1668014516970,CSE 293,026,119411,Porter; George M,9999,0,9999,0
1668014516970,CSE 293,027,119414,Porter; Leonard Emerson,9999,0,9999,0
1668014516970,CSE 293,028,119416,Ramamoorthi; Ravi,9999,0,9999,0
1668014516970,CSE 293,029,119417,Sahoo; Debashis,9999,0,9999,0
1668014516970,CSE 293,030,119420,Saul; Lawrence,9999,0,9999,0
1668014516970,CSE 293,031,119421,Savage; Stefan,9999,0,9999,0
1668014516970,CSE 293,032,119425,Schulze; Jurgen P.,9999,0,9999,0
1668014516970,CSE 293,033,119426,Snoeren; Alex C.,9999,0,9999,0
1668014516970,CSE 293,034,119428,Shang; Jingbo,9999,0,9999,0
1668014516970,CSE 293,035,119430,Stefan; Deian,9999,0,9999,0
1668014516970,CSE 293,036,119431,Su; Hao,9999,0,9999,0
1668014516970,CSE 293,037,119433,Swanson; Steven James,9999,0,9999,0
1668014516970,CSE 293,038,119435,Tullsen; Dean Michael,9999,0,9999,0
1668014516970,CSE 293,039,119483,Voelker; Geoffrey M.,9999,0,9999,0
1668014516970,CSE 293,040,119537,Zhao; Jishen,9999,0,9999,0
1668014516970,CSE 293,041,119538,Zhou; Yuan-Yuan,9999,0,9999,0
1668014516970,CSE 293,042,119539,Gao; Sicun,9999,0,9999,0
1668014516970,CSE 293,043,119540,Weibel; Nadir,9999,0,9999,0
1668014516970,CSE 293,044,119541,Gupta; Rajesh K.,9999,0,9999,0
1668014516970,CSE 293,045,126410,Vaccaro; Kristen Marie,9999,0,9999,0
1668014516970,CSE 293,046,126411,Klemke; Richard,9999,0,9999,0
1668014517396,CSE 294,A00,102459,Voelker; Geoffrey M.,0,0,0,0
1668014517396,CSE 294,B00,111322,Orailoglu; Alex,0,0,0,0
1668014517828,DSE 201,A00,096914,Deutsch; Alin Bernard,30,0,30,0
1668014518257,DSE 210,A00,096915,Dasgupta; Sanjoy,30,0,30,0
1668014518684,DSE 260A,A00,096916,Altintas De Callaf; Ilkay,30,0,30,0
1668014519128,ECE 200,001,103586,Antipa; Nicholas A,9999,0,9999,0
1668014519128,ECE 200,002,103587,Atanasov; Nikolay A.,9999,0,9999,0
1668014519128,ECE 200,003,103588,Bharadia; Dinesh,9999,0,9999,0
1668014519128,ECE 200,004,103589,Cheng; Chung Kuan,9999,0,9999,0
1668014519128,ECE 200,005,103590,Cosman; Pamela C.,9999,0,9999,0
1668014519128,ECE 200,006,103591,Dayeh; Shadi Ahmad,9999,0,9999,0
1668014519128,ECE 200,007,103592,Fainman; Yeshaiahu,9999,0,9999,0
1668014519128,ECE 200,008,103593,Ford; Joseph Earl,9999,0,9999,0
1668014519128,ECE 200,009,103594,Franceschetti; Massimo,9999,0,9999,0
1668014519128,ECE 200,010,103595,Fullerton; Eric E,9999,0,9999,0
1668014519128,ECE 200,011,103596,Galton; Ian A,9999,0,9999,0
1668014519128,ECE 200,012,103597,Gilja; Vikash,9999,0,9999,0
1668014519128,ECE 200,013,103598,Hall; Drew A.,9999,0,9999,0
1668014519128,ECE 200,014,103599,Hsueh; Tzu-Chien,9999,0,9999,0
1668014519128,ECE 200,015,103600,Javidi; Tara,9999,0,9999,0
1668014519128,ECE 200,016,103601,Kahng; Andrew Byun,9999,0,9999,0
1668014519128,ECE 200,017,103602,Kim; Young-Han,9999,0,9999,0
1668014519128,ECE 200,018,103603,Koushanfar; Farinaz,9999,0,9999,0
1668014519128,ECE 200,019,103604,Kuzum; Duygu,9999,0,9999,0
1668014519128,ECE 200,020,103605,Le; Hanh-Phuc,9999,0,9999,0
1668014519128,ECE 200,021,103606,Lin; Bill,9999,0,9999,0
1668014519128,ECE 200,022,103607,Liu; Zhaowei,9998,0,9999,1
1668014519128,ECE 200,023,103608,Lo; Yu-Hwa,9999,0,9999,0
1668014519128,ECE 200,024,103609,Lomakin; Vitaliy,9999,0,9999,0
1668014519128,ECE 200,025,103610,Mercier; Patrick Philip,9999,0,9999,0
1668014519128,ECE 200,026,103611,Meyer; Florian,9999,0,9999,0
1668014519128,ECE 200,027,103612,Milstein; Laurence B.,9999,0,9999,0
1668014519128,ECE 200,028,103613,Mir Arabbaygi; Siavash,9999,0,9999,0
1668014519128,ECE 200,029,103614,Mookherjea; Shayan,9999,0,9999,0
1668014519128,ECE 200,030,103615,Morris; Karcher William,9999,0,9999,0
1668014519128,ECE 200,031,103616,Ng; Tse Nga,9999,0,9999,0
1668014519128,ECE 200,032,103617,Nguyen; Truong Quang,9999,0,9999,0
1668014519128,ECE 200,033,103618,Nomura; Kenji,9999,0,9999,0
1668014519128,ECE 200,034,103619,Orlitsky; Alon,9999,0,9999,0
1668014519128,ECE 200,035,103620,Pal; Piya,9999,0,9999,0
1668014519128,ECE 200,036,103621,Papen; George C.,9999,0,9999,0
1668014519128,ECE 200,037,103622,Radic; Stojan,9999,0,9999,0
1668014519128,ECE 200,038,103623,Rao; Bhaskar D.,9999,0,9999,0
1668014519128,ECE 200,039,103624,Rao; Ramesh R,9999,0,9999,0
1668014519128,ECE 200,040,103625,Rebeiz; Gabriel,9999,0,9999,0
1668014519128,ECE 200,041,103626,Sanford; John R,9999,0,9999,0
1668014519128,ECE 200,042,103627,Siegel; Paul H.,9999,0,9999,0
1668014519128,ECE 200,043,103628,Sievenpiper; Daniel F.,9999,0,9999,0
1668014519128,ECE 200,044,103629,Sworder; David D.,9999,0,9999,0
1668014519128,ECE 200,045,103630,Taur; Yuan,9999,0,9999,0
1668014519128,ECE 200,046,103631,Touri; Behrouz,9999,0,9999,0
1668014519128,ECE 200,047,103632,Trivedi; Mohan M.,9999,0,9999,0
1668014519128,ECE 200,048,103633,Vasconcelos; Nuno,9999,0,9999,0
1668014519128,ECE 200,049,103634,Wang; Xiaolong,9999,0,9999,0
1668014519128,ECE 200,050,103635,Xie; Pengtao,9999,0,9999,0
1668014519128,ECE 200,051,103636,Yip; Michael,9999,0,9999,0
1668014519128,ECE 200,052,103637,Zeger; Kenneth A.,999,0,999,0
1668014519128,ECE 200,053,103638,Zhang; Xinyu,9999,0,9999,0
1668014519128,ECE 200,054,103639,Turakhia; Yatish Girish,9999,0,9999,0
1668014519128,ECE 200,055,103640,Kang; Mingu,9999,0,9999,0
1668014519128,ECE 200,056,103641,Shi; Yuanyuan,9999,0,9999,0
1668014519128,ECE 200,057,103642,Wang; Edward Jay,9999,0,9999,0
1668014519128,ECE 200,058,103643,Zheng; Yang,9999,0,9999,0
1668014519561,ECE 202,A00,103644,Kuzum; Duygu,0,0,0,0
1668014520006,ECE 212BN,A00,103646,Ng; Tse Nga,0,0,0,0
1668014520432,ECE 221,A00,111493,Staff,0,0,0,0
1668014520855,ECE 222B,A00,103647,Lomakin; Vitaliy,0,0,0,0
1668014521280,ECE 230B,A00,103648,Taur; Yuan,0,0,0,0
1668014521716,ECE 238B,A00,103649,Garay; Javier,0,0,0,0
1668014522139,ECE 240B,A00,112900,Fainman; Yeshaiahu,0,0,0,0
1668014522565,ECE 247A,A00,103650,Jokerst; Jesse Vincent,0,0,0,0
1668014522995,ECE 247B,A00,103651,Wang; Joseph,0,0,0,0
1668014523425,ECE 250,A00,103652,Siegel; Paul H.,0,0,0,0
1668014523852,ECE 251A,A00,103654,Rao; Bhaskar D.,0,0,0,0
1668014524275,ECE 257B,A00,103655,Bharadia; Dinesh,0,0,0,0
1668014524700,ECE 258A,A00,103656,Milstein; Laurence B.,0,0,0,0
1668014525139,ECE 260B,A00,103658,Kang; Mingu,0,0,0,0
1668014525574,ECE 264A,A00,103659,Galton; Ian A,0,0,0,0
1668014526005,ECE 265A,A00,103661,Gudem; Prasad S.S.,0,0,0,0
1668014526427,ECE 265D,A00,103662,Gudem; Prasad S.S.,0,0,0,0
1668014526870,ECE 268,A00,103663,Koushanfar; Farinaz,0,0,0,0
1668014527309,ECE 269,A01,103665,Pal; Piya,0,0,0,0
1668014527735,ECE 271B,A00,103666,Vasconcelos; Manuela,0,0,0,0
1668014528163,ECE 276A,A00,103667,Atanasov; Nikolay A.,0,0,0,0
1668014528588,ECE 277,A00,103668,An; Cheolhong,0,0,0,0
1668014529012,ECE 279,A00,117947,Hall; Drew A.,0,0,0,0
1668014529870,ECE 283,A00,103670,Hsueh; Tzu-Chien,0,0,0,0
1668014530296,ECE 284,A00,103671,Turakhia; Yatish Girish,0,0,0,0
1668014530724,ECE 285,A00,103672,Zheng; Yang,0,0,0,0
1668014530724,ECE 285,B00,103673,Sworder; David D.,0,0,0,0
1668014531154,ECE 287,A00,103676,Javidi; Tara,0,0,0,0
1668014531581,MATH 200B,A00,098023,Salehi Golsefidy; Alireza,14,0,15,1
1668014532014,MATH 202B,A00,098024,Rhoades; Brendon Patrick,11,0,15,4
1668014532450,MATH 203B,A00,098025,Oprea; Dragos N.,12,0,15,3
1668014532877,MATH 204B,A00,098026,Sorensen; Claus M,14,0,15,1
1668014533304,MATH 208,A00,098027,Izadi; Elham,7,0,10,3
1668014533733,MATH 209,A00,098028,Pollack; Aaron,10,0,10,0
1668014534158,MATH 211A,A00,112919,Rogalski; Daniel,9,0,10,1
1668014534582,MATH 211B,A00,112920,Seward; Brandon M.,9,0,10,1
1668014535007,MATH 218,A00,098029,Li; Bo,10,0,10,0
1668014535439,MATH 220B,A00,098030,Novak; Jonathan I,13,0,15,2
1668014535958,MATH 221A,A00,098031,Ebenfelt; Peter F,13,0,15,2
1668014536397,MATH 231B,A00,098032,Zlatos; Andrej,12,0,15,3
1668014536821,MATH 240B,A00,098033,Ni; Lei,10,0,15,5
1668014537244,MATH 243,A00,098034,Jekel; David Andrew,10,0,10,0
1668014537683,MATH 245A,A00,098035,Nie; Jiawang,0,0,15,16
1668014538106,MATH 248,A00,098036,Bejenaru; Ioan,10,0,10,0
1668014538531,MATH 250B,A00,098037,Spolaor; Luca,14,0,15,1
1668014538962,MATH 258,A00,098038,Ni; Lei,10,0,10,0
1668014539388,MATH 264B,A00,098041,Rhoades; Brendon Patrick,11,0,15,4
1668014539810,MATH 268,A00,098042,Buss; Samuel R,10,0,10,0
1668014540247,MATH 269,A00,098043,Rhoades; Brendon Patrick,10,0,10,0
1668014540676,MATH 270B,A00,098044,Li; Bo,11,0,15,4
1668014541109,MATH 272B,A00,098045,Holst; Michael J,13,0,15,2
1668014541542,MATH 273A,A00,098046,Tian; Xiaochuan,12,0,15,3
1668014541976,MATH 275,A01,098048,Tian; Xiaochuan,6,0,10,4
1668014542403,MATH 278A,A00,098049,Holst; Michael J,8,0,10,2
1668014542828,MATH 278B,A00,098050,Cloninger; Alexander,10,0,10,0
1668014543251,MATH 278C,A00,098051,Nie; Jiawang,8,0,10,2
1668014543674,MATH 280B,A00,098052,Zheng; Tianyi,11,0,15,4
1668014544098,MATH 281B,A00,098053,Bradic; Jelena,4,0,15,11
1668014544521,MATH 282B,A00,098054,Arias-Castro; Ery,2,0,15,13
1668014544955,MATH 285,A00,098055,Fitzsimmons; Patrick J,0,0,15,17
1668014545383,MATH 287B,A00,098056,Arias-Castro; Ery,5,0,15,10
1668014545818,MATH 288,A00,098057,Agarwal; Pooja,9,0,10,1
1668014545818,MATH 288,B00,098058,Zhang; Danna,9,0,10,1
1668014545818,MATH 288,C00,098059,Williams; Ruth J,10,0,10,0
1668014546259,MATH 290B,A00,098060,Roberts; Justin Deritter,14,0,15,1
1668014546693,MATH 292,A00,098061,Belmont; Eva Kinoshita,10,0,10,0
1668014547122,MATH 295,A00,098062,Suk; Andrew Hoon,48,0,50,2
1668014547545,MATH 296,A00,098063,Novak; Jonathan I,20,0,20,0
1668014547981,MATH 297,001,098064,Gamst; Anthony Collins,9997,0,9999,2
1668015051995,COGS 205,A00,101395,Chiba; Andrea,19,0,20,1
1668015052420,COGS 210B,001,101404,Greene; Deanna Jacquelyn,9998,0,9999,1
1668015052420,COGS 210B,002,101417,Xia; Haijun,9999,0,9999,0
1668015052420,COGS 210B,003,101422,Nitz; Douglas A.,9999,0,9999,0
1668015052420,COGS 210B,004,101423,Hollan; James D.,9998,0,9999,1
1668015052420,COGS 210B,005,101424,Deak; Gedeon O.,9999,0,9999,0
1668015052420,COGS 210B,006,101425,Rossano; Federico,9999,0,9999,0
1668015052849,COGS 211B,A00,101427,Coulson; Seana M,9997,0,9999,2
1668015053279,COGS 220,A00,101428,Hollan; James D.,0,0,25,25
1668015053717,COGS 229,A00,101429,Dow; Steven P,18,0,25,7
1668015054144,COGS 230,A00,101430,Klemmer; Scott R,13,0,17,4
1668015054568,COGS 234,A00,101431,Xia; Haijun,7,0,25,18
1668015055002,COGS 260,A00,101432,Kiyonaga; Anastasia,20,0,25,5
1668015055002,COGS 260,B00,101433,Kirsh; David Joel,16,0,25,9
1668015055430,CSE 202,A00,102371,Impagliazzo; Russell,0,0,0,0
1668015055863,CSE 203B,A01,102373,Cheng; Chung Kuan,0,0,0,0
1668015056285,CSE 208,A00,102374,Micciancio; Daniele,0,0,0,0
1668015056714,CSE 209A,A00,112895,Impagliazzo; Russell,0,0,15,15
1668015057140,CSE 209B,A00,108005,Bellare; Mihir,0,0,0,0
1668015057566,CSE 210,A00,113163,Coblenz; Michael J,0,0,0,0
1668015057992,CSE 219,A00,106111,Dow; Steven P,0,0,20,20
1668015058426,CSE 221,A00,102376,Voelker; Geoffrey M.,0,0,0,0
1668015058849,CSE 224,A01,102378,Porter; George M,0,0,0,0
1668015059276,CSE 229A,A00,102379,Savage; Stefan,0,0,0,0
1668015059699,CSE 229C,A00,102380,Munyaka; Imani N. S.,0,0,0,0
1668015060250,CSE 232B,A00,102382,Deutsch; Alin Bernard,0,0,0,0
1668015060677,CSE 234,A01,112904,Kumar; Arun Kumar,0,0,0,0
1668015061106,CSE 237A,A00,102383,Rosing; Tajana Simunic,0,0,0,0
1668015061534,CSE 239A,A00,102384,Deutsch; Alin Bernard,0,0,0,0
1668015061961,CSE 239B,A00,102385,Polikarpova; Nadezhda,0,0,0,0
1668015062395,CSE 240A,A00,102386,Pannuto; Patrick William,0,0,0,0
1668015062823,CSE 240B,A00,102387,Zhao; Jishen,0,0,0,0
1668015063247,CSE 241A,A00,106406,Kang; Mingu,0,0,0,0
1668015063673,CSE 249B,A00,102388,Kahng; Andrew Byun,0,0,8,8
1668015064098,CSE 251B,A01,102392,Cottrell; Garrison W,0,0,0,0
1668015064098,CSE 251B,A02,102393,Cottrell; Garrison W,0,0,0,0
1668015064523,CSE 252B,A00,102394,Ochoa; Benjamin Lawrence,0,0,0,0
1668015064948,CSE 257,A01,102396,Gao; Sicun,0,0,0,0
1668015065375,CSE 272,A00,102397,Li; Tzumao,0,0,0,0
1668015065807,CSE 274,A00,111323,Chern; Albert Ren-Haur,0,0,0,0
1668015066234,CSE 282,A00,102398,Pevzner; Pavel Arkadjevich,0,0,0,0
1668015066673,CSE 284,A00,114175,Gymrek; Melissa Ann,0,0,0,0
1668015067097,CSE 290,A00,102399,Chandraker; Manmohan Krishna,0,0,0,0
1668015067097,CSE 290,B00,102400,Vaccaro; Kristen Marie,0,0,25,25
1668015067097,CSE 290,C00,102414,Pannuto; Patrick William,0,0,25,25
1668015067097,CSE 290,D00,102427,Pevzner; Pavel Arkadjevich,0,0,0,0
1668015067097,CSE 290,E00,102429,Zhao; Jishen,0,0,0,0
1668015067097,CSE 290,F00,102436,Tullsen; Dean Michael,0,0,0,0
1668015067097,CSE 290,G00,102440,Christensen; Henrik I,0,0,20,20
1668015067523,CSE 291,A00,102443,Su; Hao,0,0,0,0
1668015067523,CSE 291,B00,102448,Polikarpova; Nadezhda,0,0,0,0
1668015067523,CSE 291,C00,102453,Vaccaro; Kristen Marie,0,0,0,0
1668015067523,CSE 291,D00,111343,Savage; Stefan,0,0,0,0
1668015067523,CSE 291,E00,116474,Claffy; Kimberly Claire,0,0,0,0
1668015067523,CSE 291,F00,116479,Pasquale; Joseph,0,0,0,0
1668015067951,CSE 293,001,119111,Bafna; Vineet,9999,0,9999,0
1668015067951,CSE 293,002,119118,Bellare; Mihir,9999,0,9999,0
1668015067951,CSE 293,003,119122,Berg-Kirkpatrick; Taylor D,9999,0,9999,0
1668015067951,CSE 293,004,119135,Christensen; Henrik I,9999,0,9999,0
1668015067951,CSE 293,005,119142,Cottrell; Garrison W,9999,0,9999,0
1668015067951,CSE 293,006,119146,Deutsch; Alin Bernard,9999,0,9999,0
1668015067951,CSE 293,007,119159,Esmaeilzadeh; Hadi,9999,0,9999,0
1668015067951,CSE 293,008,119166,Freund; Yoav,9999,0,9999,0
1668015067951,CSE 293,009,119170,Griswold; William G.,9999,0,9999,0
1668015067951,CSE 293,010,119183,Gymrek; Melissa Ann,9999,0,9999,0
1668015067951,CSE 293,011,119190,Heninger; Nadia A,9999,0,9999,0
1668015067951,CSE 293,012,119230,Impagliazzo; Russell,9999,0,9999,0
1668015067951,CSE 293,013,119232,Jhala; Ranjit,9999,0,9999,0
1668015067951,CSE 293,014,119233,Kahng; Andrew Byun,9999,0,9999,0
1668015067951,CSE 293,015,119298,Kane; Daniel Mertz,9999,0,9999,0
1668015067951,CSE 293,016,119299,Kriegman; David J,9999,0,9999,0
1668015067951,CSE 293,017,119300,Kumar; Arun Kumar,9999,0,9999,0
1668015067951,CSE 293,018,119301,Lerner; Sorin,9999,0,9999,0
1668015067951,CSE 293,019,119302,Lovett; Shachar,9999,0,9999,0
1668015067951,CSE 293,020,119303,McAuley; Julian John,9999,0,9999,0
1668015067951,CSE 293,021,119304,Micciancio; Daniele,9999,0,9999,0
1668015067951,CSE 293,022,119367,Orailoglu; Alex,9999,0,9999,0
1668015067951,CSE 293,023,119382,Paturi; Ramamohan,9999,0,9999,0
1668015067951,CSE 293,024,119404,Polikarpova; Nadezhda,9999,0,9999,0
1668015067951,CSE 293,025,119406,Politz; Joseph Gibbs,9999,0,9999,0
1668015067951,CSE 293,026,119411,Porter; George M,9999,0,9999,0
1668015067951,CSE 293,027,119414,Porter; Leonard Emerson,9999,0,9999,0
1668015067951,CSE 293,028,119416,Ramamoorthi; Ravi,9999,0,9999,0
1668015067951,CSE 293,029,119417,Sahoo; Debashis,9999,0,9999,0
1668015067951,CSE 293,030,119420,Saul; Lawrence,9999,0,9999,0
1668015067951,CSE 293,031,119421,Savage; Stefan,9999,0,9999,0
1668015067951,CSE 293,032,119425,Schulze; Jurgen P.,9999,0,9999,0
1668015067951,CSE 293,033,119426,Snoeren; Alex C.,9999,0,9999,0
1668015067951,CSE 293,034,119428,Shang; Jingbo,9999,0,9999,0
1668015067951,CSE 293,035,119430,Stefan; Deian,9999,0,9999,0
1668015067951,CSE 293,036,119431,Su; Hao,9999,0,9999,0
1668015067951,CSE 293,037,119433,Swanson; Steven James,9999,0,9999,0
1668015067951,CSE 293,038,119435,Tullsen; Dean Michael,9999,0,9999,0
1668015067951,CSE 293,039,119483,Voelker; Geoffrey M.,9999,0,9999,0
1668015067951,CSE 293,040,119537,Zhao; Jishen,9999,0,9999,0
1668015067951,CSE 293,041,119538,Zhou; Yuan-Yuan,9999,0,9999,0
1668015067951,CSE 293,042,119539,Gao; Sicun,9999,0,9999,0
1668015067951,CSE 293,043,119540,Weibel; Nadir,9999,0,9999,0
1668015067951,CSE 293,044,119541,Gupta; Rajesh K.,9999,0,9999,0
1668015067951,CSE 293,045,126410,Vaccaro; Kristen Marie,9999,0,9999,0
1668015067951,CSE 293,046,126411,Klemke; Richard,9999,0,9999,0
1668015068379,CSE 294,A00,102459,Voelker; Geoffrey M.,0,0,0,0
1668015068379,CSE 294,B00,111322,Orailoglu; Alex,0,0,0,0
1668015068806,DSE 201,A00,096914,Deutsch; Alin Bernard,30,0,30,0
1668015069231,DSE 210,A00,096915,Dasgupta; Sanjoy,30,0,30,0
1668015069655,DSE 260A,A00,096916,Altintas De Callaf; Ilkay,30,0,30,0
1668015070098,ECE 200,001,103586,Antipa; Nicholas A,9999,0,9999,0
1668015070098,ECE 200,002,103587,Atanasov; Nikolay A.,9999,0,9999,0
1668015070098,ECE 200,003,103588,Bharadia; Dinesh,9999,0,9999,0
1668015070098,ECE 200,004,103589,Cheng; Chung Kuan,9999,0,9999,0
1668015070098,ECE 200,005,103590,Cosman; Pamela C.,9999,0,9999,0
1668015070098,ECE 200,006,103591,Dayeh; Shadi Ahmad,9999,0,9999,0
1668015070098,ECE 200,007,103592,Fainman; Yeshaiahu,9999,0,9999,0
1668015070098,ECE 200,008,103593,Ford; Joseph Earl,9999,0,9999,0
1668015070098,ECE 200,009,103594,Franceschetti; Massimo,9999,0,9999,0
1668015070098,ECE 200,010,103595,Fullerton; Eric E,9999,0,9999,0
1668015070098,ECE 200,011,103596,Galton; Ian A,9999,0,9999,0
1668015070098,ECE 200,012,103597,Gilja; Vikash,9999,0,9999,0
1668015070098,ECE 200,013,103598,Hall; Drew A.,9999,0,9999,0
1668015070098,ECE 200,014,103599,Hsueh; Tzu-Chien,9999,0,9999,0
1668015070098,ECE 200,015,103600,Javidi; Tara,9999,0,9999,0
1668015070098,ECE 200,016,103601,Kahng; Andrew Byun,9999,0,9999,0
1668015070098,ECE 200,017,103602,Kim; Young-Han,9999,0,9999,0
1668015070098,ECE 200,018,103603,Koushanfar; Farinaz,9999,0,9999,0
1668015070098,ECE 200,019,103604,Kuzum; Duygu,9999,0,9999,0
1668015070098,ECE 200,020,103605,Le; Hanh-Phuc,9999,0,9999,0
1668015070098,ECE 200,021,103606,Lin; Bill,9999,0,9999,0
1668015070098,ECE 200,022,103607,Liu; Zhaowei,9998,0,9999,1
1668015070098,ECE 200,023,103608,Lo; Yu-Hwa,9999,0,9999,0
1668015070098,ECE 200,024,103609,Lomakin; Vitaliy,9999,0,9999,0
1668015070098,ECE 200,025,103610,Mercier; Patrick Philip,9999,0,9999,0
1668015070098,ECE 200,026,103611,Meyer; Florian,9999,0,9999,0
1668015070098,ECE 200,027,103612,Milstein; Laurence B.,9999,0,9999,0
1668015070098,ECE 200,028,103613,Mir Arabbaygi; Siavash,9999,0,9999,0
1668015070098,ECE 200,029,103614,Mookherjea; Shayan,9999,0,9999,0
1668015070098,ECE 200,030,103615,Morris; Karcher William,9999,0,9999,0
1668015070098,ECE 200,031,103616,Ng; Tse Nga,9999,0,9999,0
1668015070098,ECE 200,032,103617,Nguyen; Truong Quang,9999,0,9999,0
1668015070098,ECE 200,033,103618,Nomura; Kenji,9999,0,9999,0
1668015070098,ECE 200,034,103619,Orlitsky; Alon,9999,0,9999,0
1668015070098,ECE 200,035,103620,Pal; Piya,9999,0,9999,0
1668015070098,ECE 200,036,103621,Papen; George C.,9999,0,9999,0
1668015070098,ECE 200,037,103622,Radic; Stojan,9999,0,9999,0
1668015070098,ECE 200,038,103623,Rao; Bhaskar D.,9999,0,9999,0
1668015070098,ECE 200,039,103624,Rao; Ramesh R,9999,0,9999,0
1668015070098,ECE 200,040,103625,Rebeiz; Gabriel,9999,0,9999,0
1668015070098,ECE 200,041,103626,Sanford; John R,9999,0,9999,0
1668015070098,ECE 200,042,103627,Siegel; Paul H.,9999,0,9999,0
1668015070098,ECE 200,043,103628,Sievenpiper; Daniel F.,9999,0,9999,0
1668015070098,ECE 200,044,103629,Sworder; David D.,9999,0,9999,0
1668015070098,ECE 200,045,103630,Taur; Yuan,9999,0,9999,0
1668015070098,ECE 200,046,103631,Touri; Behrouz,9999,0,9999,0
1668015070098,ECE 200,047,103632,Trivedi; Mohan M.,9999,0,9999,0
1668015070098,ECE 200,048,103633,Vasconcelos; Nuno,9999,0,9999,0
1668015070098,ECE 200,049,103634,Wang; Xiaolong,9999,0,9999,0
1668015070098,ECE 200,050,103635,Xie; Pengtao,9999,0,9999,0
1668015070098,ECE 200,051,103636,Yip; Michael,9999,0,9999,0
1668015070098,ECE 200,052,103637,Zeger; Kenneth A.,999,0,999,0
1668015070098,ECE 200,053,103638,Zhang; Xinyu,9999,0,9999,0
1668015070098,ECE 200,054,103639,Turakhia; Yatish Girish,9999,0,9999,0
1668015070098,ECE 200,055,103640,Kang; Mingu,9999,0,9999,0
1668015070098,ECE 200,056,103641,Shi; Yuanyuan,9999,0,9999,0
1668015070098,ECE 200,057,103642,Wang; Edward Jay,9999,0,9999,0
1668015070098,ECE 200,058,103643,Zheng; Yang,9999,0,9999,0
1668015070525,ECE 202,A00,103644,Kuzum; Duygu,0,0,0,0
1668015070956,ECE 212BN,A00,103646,Ng; Tse Nga,0,0,0,0
1668015071384,ECE 221,A00,111493,Staff,0,0,0,0
1668015071816,ECE 222B,A00,103647,Lomakin; Vitaliy,0,0,0,0
1668015072241,ECE 230B,A00,103648,Taur; Yuan,0,0,0,0
1668015072663,ECE 238B,A00,103649,Garay; Javier,0,0,0,0
1668015073091,ECE 240B,A00,112900,Fainman; Yeshaiahu,0,0,0,0
1668015073524,ECE 247A,A00,103650,Jokerst; Jesse Vincent,0,0,0,0
1668015073949,ECE 247B,A00,103651,Wang; Joseph,0,0,0,0
1668015074393,ECE 250,A00,103652,Siegel; Paul H.,0,0,0,0
1668015074847,ECE 251A,A00,103654,Rao; Bhaskar D.,0,0,0,0
1668015075292,ECE 257B,A00,103655,Bharadia; Dinesh,0,0,0,0
1668015075717,ECE 258A,A00,103656,Milstein; Laurence B.,0,0,0,0
1668015076145,ECE 260B,A00,103658,Kang; Mingu,0,0,0,0
1668015076570,ECE 264A,A00,103659,Galton; Ian A,0,0,0,0
1668015076994,ECE 265A,A00,103661,Gudem; Prasad S.S.,0,0,0,0
1668015077424,ECE 265D,A00,103662,Gudem; Prasad S.S.,0,0,0,0
1668015077849,ECE 268,A00,103663,Koushanfar; Farinaz,0,0,0,0
1668015078275,ECE 269,A01,103665,Pal; Piya,0,0,0,0
1668015078702,ECE 271B,A00,103666,Vasconcelos; Manuela,0,0,0,0
1668015079125,ECE 276A,A00,103667,Atanasov; Nikolay A.,0,0,0,0
1668015079559,ECE 277,A00,103668,An; Cheolhong,0,0,0,0
1668015079986,ECE 279,A00,117947,Hall; Drew A.,0,0,0,0
1668015080833,ECE 283,A00,103670,Hsueh; Tzu-Chien,0,0,0,0
1668015081259,ECE 284,A00,103671,Turakhia; Yatish Girish,0,0,0,0
1668015081692,ECE 285,A00,103672,Zheng; Yang,0,0,0,0
1668015081692,ECE 285,B00,103673,Sworder; David D.,0,0,0,0
1668015082129,ECE 287,A00,103676,Javidi; Tara,0,0,0,0
1668015082563,MATH 200B,A00,098023,Salehi Golsefidy; Alireza,14,0,15,1
1668015082989,MATH 202B,A00,098024,Rhoades; Brendon Patrick,11,0,15,4
1668015083414,MATH 203B,A00,098025,Oprea; Dragos N.,12,0,15,3
1668015083849,MATH 204B,A00,098026,Sorensen; Claus M,14,0,15,1
1668015084278,MATH 208,A00,098027,Izadi; Elham,7,0,10,3
1668015084701,MATH 209,A00,098028,Pollack; Aaron,10,0,10,0
1668015085132,MATH 211A,A00,112919,Rogalski; Daniel,9,0,10,1
1668015085567,MATH 211B,A00,112920,Seward; Brandon M.,9,0,10,1
1668015085993,MATH 218,A00,098029,Li; Bo,10,0,10,0
1668015086432,MATH 220B,A00,098030,Novak; Jonathan I,13,0,15,2
1668015086876,MATH 221A,A00,098031,Ebenfelt; Peter F,13,0,15,2
1668015087299,MATH 231B,A00,098032,Zlatos; Andrej,12,0,15,3
1668015087720,MATH 240B,A00,098033,Ni; Lei,10,0,15,5
1668015088146,MATH 243,A00,098034,Jekel; David Andrew,10,0,10,0
1668015088580,MATH 245A,A00,098035,Nie; Jiawang,0,0,15,16
1668015089012,MATH 248,A00,098036,Bejenaru; Ioan,10,0,10,0
1668015089446,MATH 250B,A00,098037,Spolaor; Luca,14,0,15,1
1668015089877,MATH 258,A00,098038,Ni; Lei,10,0,10,0
1668015090313,MATH 264B,A00,098041,Rhoades; Brendon Patrick,11,0,15,4
1668015090752,MATH 268,A00,098042,Buss; Samuel R,10,0,10,0
1668015091187,MATH 269,A00,098043,Rhoades; Brendon Patrick,10,0,10,0
1668015091617,MATH 270B,A00,098044,Li; Bo,11,0,15,4
1668015092039,MATH 272B,A00,098045,Holst; Michael J,13,0,15,2
1668015092471,MATH 273A,A00,098046,Tian; Xiaochuan,12,0,15,3
1668015092895,MATH 275,A01,098048,Tian; Xiaochuan,6,0,10,4
1668015093321,MATH 278A,A00,098049,Holst; Michael J,8,0,10,2
1668015093768,MATH 278B,A00,098050,Cloninger; Alexander,10,0,10,0
1668015094191,MATH 278C,A00,098051,Nie; Jiawang,8,0,10,2
1668015094618,MATH 280B,A00,098052,Zheng; Tianyi,11,0,15,4
1668015095054,MATH 281B,A00,098053,Bradic; Jelena,4,0,15,11
1668015095480,MATH 282B,A00,098054,Arias-Castro; Ery,2,0,15,13
1668015095906,MATH 285,A00,098055,Fitzsimmons; Patrick J,0,0,15,17
1668015096339,MATH 287B,A00,098056,Arias-Castro; Ery,5,0,15,10
1668015096765,MATH 288,A00,098057,Agarwal; Pooja,9,0,10,1
1668015096765,MATH 288,B00,098058,Zhang; Danna,9,0,10,1
1668015096765,MATH 288,C00,098059,Williams; Ruth J,10,0,10,0
1668015097199,MATH 290B,A00,098060,Roberts; Justin Deritter,14,0,15,1
1668015097627,MATH 292,A00,098061,Belmont; Eva Kinoshita,10,0,10,0
1668015098056,MATH 295,A00,098062,Suk; Andrew Hoon,48,0,50,2
1668015098488,MATH 296,A00,098063,Novak; Jonathan I,20,0,20,0
1668015098913,MATH 297,001,098064,Gamst; Anthony Collins,9997,0,9999,2
1668015614003,COGS 205,A00,101395,Chiba; Andrea,19,0,20,1
1668015614431,COGS 210B,001,101404,Greene; Deanna Jacquelyn,9998,0,9999,1
1668015614431,COGS 210B,002,101417,Xia; Haijun,9999,0,9999,0
1668015614431,COGS 210B,003,101422,Nitz; Douglas A.,9999,0,9999,0
1668015614431,COGS 210B,004,101423,Hollan; James D.,9998,0,9999,1
1668015614431,COGS 210B,005,101424,Deak; Gedeon O.,9999,0,9999,0
1668015614431,COGS 210B,006,101425,Rossano; Federico,9999,0,9999,0
1668015614862,COGS 211B,A00,101427,Coulson; Seana M,9997,0,9999,2
1668015615285,COGS 220,A00,101428,Hollan; James D.,0,0,25,25
1668015615709,COGS 229,A00,101429,Dow; Steven P,18,0,25,7
1668015616133,COGS 230,A00,101430,Klemmer; Scott R,13,0,17,4
1668015616557,COGS 234,A00,101431,Xia; Haijun,6,0,25,19
1668015616987,COGS 260,A00,101432,Kiyonaga; Anastasia,20,0,25,5
1668015616987,COGS 260,B00,101433,Kirsh; David Joel,16,0,25,9
1668015617420,CSE 202,A00,102371,Impagliazzo; Russell,0,0,0,0
1668015617844,CSE 203B,A01,102373,Cheng; Chung Kuan,0,0,0,0
1668015618270,CSE 208,A00,102374,Micciancio; Daniele,0,0,0,0
1668015618691,CSE 209A,A00,112895,Impagliazzo; Russell,0,0,15,15
1668015619115,CSE 209B,A00,108005,Bellare; Mihir,0,0,0,0
1668015619711,CSE 210,A00,113163,Coblenz; Michael J,0,0,0,0
1668015620136,CSE 219,A00,106111,Dow; Steven P,0,0,20,20
1668015620572,CSE 221,A00,102376,Voelker; Geoffrey M.,0,0,0,0
1668015620997,CSE 224,A01,102378,Porter; George M,0,0,0,0
1668015621431,CSE 229A,A00,102379,Savage; Stefan,0,0,0,0
1668015621855,CSE 229C,A00,102380,Munyaka; Imani N. S.,0,0,0,0
1668015622276,CSE 232B,A00,102382,Deutsch; Alin Bernard,0,0,0,0
1668015622707,CSE 234,A01,112904,Kumar; Arun Kumar,0,0,0,0
1668015623129,CSE 237A,A00,102383,Rosing; Tajana Simunic,0,0,0,0
1668015623562,CSE 239A,A00,102384,Deutsch; Alin Bernard,0,0,0,0
1668015624013,CSE 239B,A00,102385,Polikarpova; Nadezhda,0,0,0,0
1668015624437,CSE 240A,A00,102386,Pannuto; Patrick William,0,0,0,0
1668015624861,CSE 240B,A00,102387,Zhao; Jishen,0,0,0,0
1668015625289,CSE 241A,A00,106406,Kang; Mingu,0,0,0,0
1668015625712,CSE 249B,A00,102388,Kahng; Andrew Byun,0,0,8,8
1668015626137,CSE 251B,A01,102392,Cottrell; Garrison W,0,0,0,0
1668015626137,CSE 251B,A02,102393,Cottrell; Garrison W,0,0,0,0
1668015626563,CSE 252B,A00,102394,Ochoa; Benjamin Lawrence,0,0,0,0
1668015626991,CSE 257,A01,102396,Gao; Sicun,0,0,0,0
1668015627414,CSE 272,A00,102397,Li; Tzumao,0,0,0,0
1668015627848,CSE 274,A00,111323,Chern; Albert Ren-Haur,0,0,0,0
1668015628286,CSE 282,A00,102398,Pevzner; Pavel Arkadjevich,0,0,0,0
1668015628710,CSE 284,A00,114175,Gymrek; Melissa Ann,0,0,0,0
1668015629138,CSE 290,A00,102399,Chandraker; Manmohan Krishna,0,0,0,0
1668015629138,CSE 290,B00,102400,Vaccaro; Kristen Marie,0,0,25,25
1668015629138,CSE 290,C00,102414,Pannuto; Patrick William,0,0,25,25
1668015629138,CSE 290,D00,102427,Pevzner; Pavel Arkadjevich,0,0,0,0
1668015629138,CSE 290,E00,102429,Zhao; Jishen,0,0,0,0
1668015629138,CSE 290,F00,102436,Tullsen; Dean Michael,0,0,0,0
1668015629138,CSE 290,G00,102440,Christensen; Henrik I,0,0,20,20
1668015629568,CSE 291,A00,102443,Su; Hao,0,0,0,0
1668015629568,CSE 291,B00,102448,Polikarpova; Nadezhda,0,0,0,0
1668015629568,CSE 291,C00,102453,Vaccaro; Kristen Marie,0,0,0,0
1668015629568,CSE 291,D00,111343,Savage; Stefan,0,0,0,0
1668015629568,CSE 291,E00,116474,Claffy; Kimberly Claire,0,0,0,0
1668015629568,CSE 291,F00,116479,Pasquale; Joseph,0,0,0,0
1668015630000,CSE 293,001,119111,Bafna; Vineet,9999,0,9999,0
1668015630000,CSE 293,002,119118,Bellare; Mihir,9999,0,9999,0
1668015630000,CSE 293,003,119122,Berg-Kirkpatrick; Taylor D,9999,0,9999,0
1668015630000,CSE 293,004,119135,Christensen; Henrik I,9999,0,9999,0
1668015630000,CSE 293,005,119142,Cottrell; Garrison W,9999,0,9999,0
1668015630000,CSE 293,006,119146,Deutsch; Alin Bernard,9999,0,9999,0
1668015630000,CSE 293,007,119159,Esmaeilzadeh; Hadi,9999,0,9999,0
1668015630000,CSE 293,008,119166,Freund; Yoav,9999,0,9999,0
1668015630000,CSE 293,009,119170,Griswold; William G.,9999,0,9999,0
1668015630000,CSE 293,010,119183,Gymrek; Melissa Ann,9999,0,9999,0
1668015630000,CSE 293,011,119190,Heninger; Nadia A,9999,0,9999,0
1668015630000,CSE 293,012,119230,Impagliazzo; Russell,9999,0,9999,0
1668015630000,CSE 293,013,119232,Jhala; Ranjit,9999,0,9999,0
1668015630000,CSE 293,014,119233,Kahng; Andrew Byun,9999,0,9999,0
1668015630000,CSE 293,015,119298,Kane; Daniel Mertz,9999,0,9999,0
1668015630000,CSE 293,016,119299,Kriegman; David J,9999,0,9999,0
1668015630000,CSE 293,017,119300,Kumar; Arun Kumar,9999,0,9999,0
1668015630000,CSE 293,018,119301,Lerner; Sorin,9999,0,9999,0
1668015630000,CSE 293,019,119302,Lovett; Shachar,9999,0,9999,0
1668015630000,CSE 293,020,119303,McAuley; Julian John,9999,0,9999,0
1668015630000,CSE 293,021,119304,Micciancio; Daniele,9999,0,9999,0
1668015630000,CSE 293,022,119367,Orailoglu; Alex,9999,0,9999,0
1668015630000,CSE 293,023,119382,Paturi; Ramamohan,9999,0,9999,0
1668015630000,CSE 293,024,119404,Polikarpova; Nadezhda,9999,0,9999,0
1668015630000,CSE 293,025,119406,Politz; Joseph Gibbs,9999,0,9999,0
1668015630000,CSE 293,026,119411,Porter; George M,9999,0,9999,0
1668015630000,CSE 293,027,119414,Porter; Leonard Emerson,9999,0,9999,0
1668015630000,CSE 293,028,119416,Ramamoorthi; Ravi,9999,0,9999,0
1668015630000,CSE 293,029,119417,Sahoo; Debashis,9999,0,9999,0
1668015630000,CSE 293,030,119420,Saul; Lawrence,9999,0,9999,0
1668015630000,CSE 293,031,119421,Savage; Stefan,9999,0,9999,0
1668015630000,CSE 293,032,119425,Schulze; Jurgen P.,9999,0,9999,0
1668015630000,CSE 293,033,119426,Snoeren; Alex C.,9999,0,9999,0
1668015630000,CSE 293,034,119428,Shang; Jingbo,9999,0,9999,0
1668015630000,CSE 293,035,119430,Stefan; Deian,9999,0,9999,0
1668015630000,CSE 293,036,119431,Su; Hao,9999,0,9999,0
1668015630000,CSE 293,037,119433,Swanson; Steven James,9999,0,9999,0
1668015630000,CSE 293,038,119435,Tullsen; Dean Michael,9999,0,9999,0
1668015630000,CSE 293,039,119483,Voelker; Geoffrey M.,9999,0,9999,0
1668015630000,CSE 293,040,119537,Zhao; Jishen,9999,0,9999,0
1668015630000,CSE 293,041,119538,Zhou; Yuan-Yuan,9999,0,9999,0
1668015630000,CSE 293,042,119539,Gao; Sicun,9999,0,9999,0
1668015630000,CSE 293,043,119540,Weibel; Nadir,9999,0,9999,0
1668015630000,CSE 293,044,119541,Gupta; Rajesh K.,9999,0,9999,0
1668015630000,CSE 293,045,126410,Vaccaro; Kristen Marie,9999,0,9999,0
1668015630000,CSE 293,046,126411,Klemke; Richard,9999,0,9999,0
1668015630452,CSE 294,A00,102459,Voelker; Geoffrey M.,0,0,0,0
1668015630452,CSE 294,B00,111322,Orailoglu; Alex,0,0,0,0
1668015630892,DSE 201,A00,096914,Deutsch; Alin Bernard,30,0,30,0
1668015631316,DSE 210,A00,096915,Dasgupta; Sanjoy,30,0,30,0
1668015631740,DSE 260A,A00,096916,Altintas De Callaf; Ilkay,30,0,30,0
1668015632194,ECE 200,001,103586,Antipa; Nicholas A,9999,0,9999,0
1668015632194,ECE 200,002,103587,Atanasov; Nikolay A.,9999,0,9999,0
1668015632194,ECE 200,003,103588,Bharadia; Dinesh,9999,0,9999,0
1668015632194,ECE 200,004,103589,Cheng; Chung Kuan,9999,0,9999,0
1668015632194,ECE 200,005,103590,Cosman; Pamela C.,9999,0,9999,0
1668015632194,ECE 200,006,103591,Dayeh; Shadi Ahmad,9999,0,9999,0
1668015632194,ECE 200,007,103592,Fainman; Yeshaiahu,9999,0,9999,0
1668015632194,ECE 200,008,103593,Ford; Joseph Earl,9999,0,9999,0
1668015632194,ECE 200,009,103594,Franceschetti; Massimo,9999,0,9999,0
1668015632194,ECE 200,010,103595,Fullerton; Eric E,9999,0,9999,0
1668015632194,ECE 200,011,103596,Galton; Ian A,9999,0,9999,0
1668015632194,ECE 200,012,103597,Gilja; Vikash,9999,0,9999,0
1668015632194,ECE 200,013,103598,Hall; Drew A.,9999,0,9999,0
1668015632194,ECE 200,014,103599,Hsueh; Tzu-Chien,9999,0,9999,0
1668015632194,ECE 200,015,103600,Javidi; Tara,9999,0,9999,0
1668015632194,ECE 200,016,103601,Kahng; Andrew Byun,9999,0,9999,0
1668015632194,ECE 200,017,103602,Kim; Young-Han,9999,0,9999,0
1668015632194,ECE 200,018,103603,Koushanfar; Farinaz,9999,0,9999,0
1668015632194,ECE 200,019,103604,Kuzum; Duygu,9999,0,9999,0
1668015632194,ECE 200,020,103605,Le; Hanh-Phuc,9999,0,9999,0
1668015632194,ECE 200,021,103606,Lin; Bill,9999,0,9999,0
1668015632194,ECE 200,022,103607,Liu; Zhaowei,9998,0,9999,1
1668015632194,ECE 200,023,103608,Lo; Yu-Hwa,9999,0,9999,0
1668015632194,ECE 200,024,103609,Lomakin; Vitaliy,9999,0,9999,0
1668015632194,ECE 200,025,103610,Mercier; Patrick Philip,9999,0,9999,0
1668015632194,ECE 200,026,103611,Meyer; Florian,9999,0,9999,0
1668015632194,ECE 200,027,103612,Milstein; Laurence B.,9999,0,9999,0
1668015632194,ECE 200,028,103613,Mir Arabbaygi; Siavash,9999,0,9999,0
1668015632194,ECE 200,029,103614,Mookherjea; Shayan,9999,0,9999,0
1668015632194,ECE 200,030,103615,Morris; Karcher William,9999,0,9999,0
1668015632194,ECE 200,031,103616,Ng; Tse Nga,9999,0,9999,0
1668015632194,ECE 200,032,103617,Nguyen; Truong Quang,9999,0,9999,0
1668015632194,ECE 200,033,103618,Nomura; Kenji,9999,0,9999,0
1668015632194,ECE 200,034,103619,Orlitsky; Alon,9999,0,9999,0
1668015632194,ECE 200,035,103620,Pal; Piya,9999,0,9999,0
1668015632194,ECE 200,036,103621,Papen; George C.,9999,0,9999,0
1668015632194,ECE 200,037,103622,Radic; Stojan,9999,0,9999,0
1668015632194,ECE 200,038,103623,Rao; Bhaskar D.,9999,0,9999,0
1668015632194,ECE 200,039,103624,Rao; Ramesh R,9999,0,9999,0
1668015632194,ECE 200,040,103625,Rebeiz; Gabriel,9999,0,9999,0
1668015632194,ECE 200,041,103626,Sanford; John R,9999,0,9999,0
1668015632194,ECE 200,042,103627,Siegel; Paul H.,9999,0,9999,0
1668015632194,ECE 200,043,103628,Sievenpiper; Daniel F.,9999,0,9999,0
1668015632194,ECE 200,044,103629,Sworder; David D.,9999,0,9999,0
1668015632194,ECE 200,045,103630,Taur; Yuan,9999,0,9999,0
1668015632194,ECE 200,046,103631,Touri; Behrouz,9999,0,9999,0
1668015632194,ECE 200,047,103632,Trivedi; Mohan M.,9999,0,9999,0
1668015632194,ECE 200,048,103633,Vasconcelos; Nuno,9999,0,9999,0
1668015632194,ECE 200,049,103634,Wang; Xiaolong,9999,0,9999,0
1668015632194,ECE 200,050,103635,Xie; Pengtao,9999,0,9999,0
1668015632194,ECE 200,051,103636,Yip; Michael,9999,0,9999,0
1668015632194,ECE 200,052,103637,Zeger; Kenneth A.,999,0,999,0
1668015632194,ECE 200,053,103638,Zhang; Xinyu,9999,0,9999,0
1668015632194,ECE 200,054,103639,Turakhia; Yatish Girish,9999,0,9999,0
1668015632194,ECE 200,055,103640,Kang; Mingu,9999,0,9999,0
1668015632194,ECE 200,056,103641,Shi; Yuanyuan,9999,0,9999,0
1668015632194,ECE 200,057,103642,Wang; Edward Jay,9999,0,9999,0
1668015632194,ECE 200,058,103643,Zheng; Yang,9999,0,9999,0
1668015632621,ECE 202,A00,103644,Kuzum; Duygu,0,0,0,0
1668015633054,ECE 212BN,A00,103646,Ng; Tse Nga,0,0,0,0
1668015633487,ECE 221,A00,111493,Staff,0,0,0,0
1668015633933,ECE 222B,A00,103647,Lomakin; Vitaliy,0,0,0,0
1668015634359,ECE 230B,A00,103648,Taur; Yuan,0,0,0,0
1668015634791,ECE 238B,A00,103649,Garay; Javier,0,0,0,0
1668015635216,ECE 240B,A00,112900,Fainman; Yeshaiahu,0,0,0,0
1668015635646,ECE 247A,A00,103650,Jokerst; Jesse Vincent,0,0,0,0
1668015636089,ECE 247B,A00,103651,Wang; Joseph,0,0,0,0
1668015636512,ECE 250,A00,103652,Siegel; Paul H.,0,0,0,0
1668015636948,ECE 251A,A00,103654,Rao; Bhaskar D.,0,0,0,0
1668015637376,ECE 257B,A00,103655,Bharadia; Dinesh,0,0,0,0
1668015637799,ECE 258A,A00,103656,Milstein; Laurence B.,0,0,0,0
1668015638224,ECE 260B,A00,103658,Kang; Mingu,0,0,0,0
1668015638646,ECE 264A,A00,103659,Galton; Ian A,0,0,0,0
1668015639174,ECE 265A,A00,103661,Gudem; Prasad S.S.,0,0,0,0
1668015639601,ECE 265D,A00,103662,Gudem; Prasad S.S.,0,0,0,0
1668015640032,ECE 268,A00,103663,Koushanfar; Farinaz,0,0,0,0
1668015640455,ECE 269,A01,103665,Pal; Piya,0,0,0,0
1668015640880,ECE 271B,A00,103666,Vasconcelos; Manuela,0,0,0,0
1668015641305,ECE 276A,A00,103667,Atanasov; Nikolay A.,0,0,0,0
1668015641731,ECE 277,A00,103668,An; Cheolhong,0,0,0,0
1668015642154,ECE 279,A00,117947,Hall; Drew A.,0,0,0,0
1668015643024,ECE 283,A00,103670,Hsueh; Tzu-Chien,0,0,0,0
1668015643450,ECE 284,A00,103671,Turakhia; Yatish Girish,0,0,0,0
1668015643884,ECE 285,A00,103672,Zheng; Yang,0,0,0,0
1668015643884,ECE 285,B00,103673,Sworder; David D.,0,0,0,0
1668015644327,ECE 287,A00,103676,Javidi; Tara,0,0,0,0
1668015644759,MATH 200B,A00,098023,Salehi Golsefidy; Alireza,14,0,15,1
1668015645180,MATH 202B,A00,098024,Rhoades; Brendon Patrick,11,0,15,4
1668015645605,MATH 203B,A00,098025,Oprea; Dragos N.,12,0,15,3
1668015646032,MATH 204B,A00,098026,Sorensen; Claus M,14,0,15,1
1668015646459,MATH 208,A00,098027,Izadi; Elham,7,0,10,3
1668015646885,MATH 209,A00,098028,Pollack; Aaron,10,0,10,0
1668015647310,MATH 211A,A00,112919,Rogalski; Daniel,9,0,10,1
1668015647738,MATH 211B,A00,112920,Seward; Brandon M.,9,0,10,1
1668015648171,MATH 218,A00,098029,Li; Bo,10,0,10,0
1668015648618,MATH 220B,A00,098030,Novak; Jonathan I,13,0,15,2
1668015649054,MATH 221A,A00,098031,Ebenfelt; Peter F,13,0,15,2
1668015649479,MATH 231B,A00,098032,Zlatos; Andrej,12,0,15,3
1668015649901,MATH 240B,A00,098033,Ni; Lei,10,0,15,5
1668015650325,MATH 243,A00,098034,Jekel; David Andrew,10,0,10,0
1668015650759,MATH 245A,A00,098035,Nie; Jiawang,0,0,15,16
1668015651189,MATH 248,A00,098036,Bejenaru; Ioan,10,0,10,0
1668015651610,MATH 250B,A00,098037,Spolaor; Luca,14,0,15,1
1668015652050,MATH 258,A00,098038,Ni; Lei,10,0,10,0
1668015652477,MATH 264B,A00,098041,Rhoades; Brendon Patrick,11,0,15,4
1668015652901,MATH 268,A00,098042,Buss; Samuel R,10,0,10,0
1668015653324,MATH 269,A00,098043,Rhoades; Brendon Patrick,10,0,10,0
1668015653750,MATH 270B,A00,098044,Li; Bo,11,0,15,4
1668015654184,MATH 272B,A00,098045,Holst; Michael J,13,0,15,2
1668015654709,MATH 273A,A00,098046,Tian; Xiaochuan,12,0,15,3
1668015655135,MATH 275,A01,098048,Tian; Xiaochuan,6,0,10,4
1668015655563,MATH 278A,A00,098049,Holst; Michael J,8,0,10,2
1668015656000,MATH 278B,A00,098050,Cloninger; Alexander,10,0,10,0
1668015656427,MATH 278C,A00,098051,Nie; Jiawang,8,0,10,2
1668015656852,MATH 280B,A00,098052,Zheng; Tianyi,11,0,15,4
1668015657290,MATH 281B,A00,098053,Bradic; Jelena,4,0,15,11
1668015657714,MATH 282B,A00,098054,Arias-Castro; Ery,2,0,15,13
1668015658140,MATH 285,A00,098055,Fitzsimmons; Patrick J,0,0,15,17
1668015658570,MATH 287B,A00,098056,Arias-Castro; Ery,5,0,15,10
1668015659005,MATH 288,A00,098057,Agarwal; Pooja,9,0,10,1
1668015659005,MATH 288,B00,098058,Zhang; Danna,9,0,10,1
1668015659005,MATH 288,C00,098059,Williams; Ruth J,10,0,10,0
1668015659431,MATH 290B,A00,098060,Roberts; Justin Deritter,14,0,15,1
1668015659856,MATH 292,A00,098061,Belmont; Eva Kinoshita,10,0,10,0
1668015660285,MATH 295,A00,098062,Suk; Andrew Hoon,48,0,50,2
1668015660709,MATH 296,A00,098063,Novak; Jonathan I,20,0,20,0
1668015661132,MATH 297,001,098064,Gamst; Anthony Collins,9997,0,9999,2
1668016165777,COGS 205,A00,101395,Chiba; Andrea,19,0,20,1
1668016166203,COGS 210B,001,101404,Greene; Deanna Jacquelyn,9998,0,9999,1
1668016166203,COGS 210B,002,101417,Xia; Haijun,9999,0,9999,0
1668016166203,COGS 210B,003,101422,Nitz; Douglas A.,9999,0,9999,0
1668016166203,COGS 210B,004,101423,Hollan; James D.,9998,0,9999,1
1668016166203,COGS 210B,005,101424,Deak; Gedeon O.,9999,0,9999,0
1668016166203,COGS 210B,006,101425,Rossano; Federico,9999,0,9999,0
1668016166635,COGS 211B,A00,101427,Coulson; Seana M,9997,0,9999,2
1668016167073,COGS 220,A00,101428,Hollan; James D.,0,0,25,25
1668016167515,COGS 229,A00,101429,Dow; Steven P,18,0,25,7
1668016167950,COGS 230,A00,101430,Klemmer; Scott R,13,0,17,4
1668016168374,COGS 234,A00,101431,Xia; Haijun,6,0,25,19
1668016168808,COGS 260,A00,101432,Kiyonaga; Anastasia,20,0,25,5
1668016168808,COGS 260,B00,101433,Kirsh; David Joel,16,0,25,9
1668016169247,CSE 202,A00,102371,Impagliazzo; Russell,0,0,0,0
1668016169689,CSE 203B,A01,102373,Cheng; Chung Kuan,0,0,0,0
1668016170115,CSE 208,A00,102374,Micciancio; Daniele,0,0,0,0
1668016170550,CSE 209A,A00,112895,Impagliazzo; Russell,0,0,15,15
1668016170988,CSE 209B,A00,108005,Bellare; Mihir,0,0,0,0
1668016171424,CSE 210,A00,113163,Coblenz; Michael J,0,0,0,0
1668016171853,CSE 219,A00,106111,Dow; Steven P,0,0,20,20
1668016172357,CSE 221,A00,102376,Voelker; Geoffrey M.,0,0,0,0
1668016172801,CSE 224,A01,102378,Porter; George M,0,0,0,0
1668016173224,CSE 229A,A00,102379,Savage; Stefan,0,0,0,0
1668016173666,CSE 229C,A00,102380,Munyaka; Imani N. S.,0,0,0,0
1668016174095,CSE 232B,A00,102382,Deutsch; Alin Bernard,0,0,0,0
1668016174518,CSE 234,A01,112904,Kumar; Arun Kumar,0,0,0,0
1668016174943,CSE 237A,A00,102383,Rosing; Tajana Simunic,0,0,0,0
1668016175385,CSE 239A,A00,102384,Deutsch; Alin Bernard,0,0,0,0
1668016175816,CSE 239B,A00,102385,Polikarpova; Nadezhda,0,0,0,0
1668016176246,CSE 240A,A00,102386,Pannuto; Patrick William,0,0,0,0
1668016176682,CSE 240B,A00,102387,Zhao; Jishen,0,0,0,0
1668016177118,CSE 241A,A00,106406,Kang; Mingu,0,0,0,0
1668016177557,CSE 249B,A00,102388,Kahng; Andrew Byun,0,0,8,8
1668016178001,CSE 251B,A01,102392,Cottrell; Garrison W,0,0,0,0
1668016178001,CSE 251B,A02,102393,Cottrell; Garrison W,0,0,0,0
1668016178424,CSE 252B,A00,102394,Ochoa; Benjamin Lawrence,0,0,0,0
1668016178873,CSE 257,A01,102396,Gao; Sicun,0,0,0,0
1668016179310,CSE 272,A00,102397,Li; Tzumao,0,0,0,0
1668016179733,CSE 274,A00,111323,Chern; Albert Ren-Haur,0,0,0,0
1668016180156,CSE 282,A00,102398,Pevzner; Pavel Arkadjevich,0,0,0,0
1668016180592,CSE 284,A00,114175,Gymrek; Melissa Ann,0,0,0,0
1668016181020,CSE 290,A00,102399,Chandraker; Manmohan Krishna,0,0,0,0
1668016181020,CSE 290,B00,102400,Vaccaro; Kristen Marie,0,0,25,25
1668016181020,CSE 290,C00,102414,Pannuto; Patrick William,0,0,25,25
1668016181020,CSE 290,D00,102427,Pevzner; Pavel Arkadjevich,0,0,0,0
1668016181020,CSE 290,E00,102429,Zhao; Jishen,0,0,0,0
1668016181020,CSE 290,F00,102436,Tullsen; Dean Michael,0,0,0,0
1668016181020,CSE 290,G00,102440,Christensen; Henrik I,0,0,20,20
1668016181449,CSE 291,A00,102443,Su; Hao,0,0,0,0
1668016181449,CSE 291,B00,102448,Polikarpova; Nadezhda,0,0,0,0
1668016181449,CSE 291,C00,102453,Vaccaro; Kristen Marie,0,0,0,0
1668016181449,CSE 291,D00,111343,Savage; Stefan,0,0,0,0
1668016181449,CSE 291,E00,116474,Claffy; Kimberly Claire,0,0,0,0
1668016181449,CSE 291,F00,116479,Pasquale; Joseph,0,0,0,0
1668016181924,CSE 293,001,119111,Bafna; Vineet,9999,0,9999,0
1668016181924,CSE 293,002,119118,Bellare; Mihir,9999,0,9999,0
1668016181924,CSE 293,003,119122,Berg-Kirkpatrick; Taylor D,9999,0,9999,0
1668016181924,CSE 293,004,119135,Christensen; Henrik I,9999,0,9999,0
1668016181924,CSE 293,005,119142,Cottrell; Garrison W,9999,0,9999,0
1668016181924,CSE 293,006,119146,Deutsch; Alin Bernard,9999,0,9999,0
1668016181924,CSE 293,007,119159,Esmaeilzadeh; Hadi,9999,0,9999,0
1668016181924,CSE 293,008,119166,Freund; Yoav,9999,0,9999,0
1668016181924,CSE 293,009,119170,Griswold; William G.,9999,0,9999,0
1668016181924,CSE 293,010,119183,Gymrek; Melissa Ann,9999,0,9999,0
1668016181924,CSE 293,011,119190,Heninger; Nadia A,9999,0,9999,0
1668016181924,CSE 293,012,119230,Impagliazzo; Russell,9999,0,9999,0
1668016181924,CSE 293,013,119232,Jhala; Ranjit,9999,0,9999,0
1668016181924,CSE 293,014,119233,Kahng; Andrew Byun,9999,0,9999,0
1668016181924,CSE 293,015,119298,Kane; Daniel Mertz,9999,0,9999,0
1668016181924,CSE 293,016,119299,Kriegman; David J,9999,0,9999,0
1668016181924,CSE 293,017,119300,Kumar; Arun Kumar,9999,0,9999,0
1668016181924,CSE 293,018,119301,Lerner; Sorin,9999,0,9999,0
1668016181924,CSE 293,019,119302,Lovett; Shachar,9999,0,9999,0
1668016181924,CSE 293,020,119303,McAuley; Julian John,9999,0,9999,0
1668016181924,CSE 293,021,119304,Micciancio; Daniele,9999,0,9999,0
1668016181924,CSE 293,022,119367,Orailoglu; Alex,9999,0,9999,0
1668016181924,CSE 293,023,119382,Paturi; Ramamohan,9999,0,9999,0
1668016181924,CSE 293,024,119404,Polikarpova; Nadezhda,9999,0,9999,0
1668016181924,CSE 293,025,119406,Politz; Joseph Gibbs,9999,0,9999,0
1668016181924,CSE 293,026,119411,Porter; George M,9999,0,9999,0
1668016181924,CSE 293,027,119414,Porter; Leonard Emerson,9999,0,9999,0
1668016181924,CSE 293,028,119416,Ramamoorthi; Ravi,9999,0,9999,0
1668016181924,CSE 293,029,119417,Sahoo; Debashis,9999,0,9999,0
1668016181924,CSE 293,030,119420,Saul; Lawrence,9999,0,9999,0
1668016181924,CSE 293,031,119421,Savage; Stefan,9999,0,9999,0
1668016181924,CSE 293,032,119425,Schulze; Jurgen P.,9999,0,9999,0
1668016181924,CSE 293,033,119426,Snoeren; Alex C.,9999,0,9999,0
1668016181924,CSE 293,034,119428,Shang; Jingbo,9999,0,9999,0
1668016181924,CSE 293,035,119430,Stefan; Deian,9999,0,9999,0
1668016181924,CSE 293,036,119431,Su; Hao,9999,0,9999,0
1668016181924,CSE 293,037,119433,Swanson; Steven James,9999,0,9999,0
1668016181924,CSE 293,038,119435,Tullsen; Dean Michael,9999,0,9999,0
1668016181924,CSE 293,039,119483,Voelker; Geoffrey M.,9999,0,9999,0
1668016181924,CSE 293,040,119537,Zhao; Jishen,9999,0,9999,0
1668016181924,CSE 293,041,119538,Zhou; Yuan-Yuan,9999,0,9999,0
1668016181924,CSE 293,042,119539,Gao; Sicun,9999,0,9999,0
1668016181924,CSE 293,043,119540,Weibel; Nadir,9999,0,9999,0
1668016181924,CSE 293,044,119541,Gupta; Rajesh K.,9999,0,9999,0
1668016181924,CSE 293,045,126410,Vaccaro; Kristen Marie,9999,0,9999,0
1668016181924,CSE 293,046,126411,Klemke; Richard,9999,0,9999,0
1668016182347,CSE 294,A00,102459,Voelker; Geoffrey M.,0,0,0,0
1668016182347,CSE 294,B00,111322,Orailoglu; Alex,0,0,0,0
1668016182772,DSE 201,A00,096914,Deutsch; Alin Bernard,30,0,30,0
1668016183198,DSE 210,A00,096915,Dasgupta; Sanjoy,30,0,30,0
1668016183623,DSE 260A,A00,096916,Altintas De Callaf; Ilkay,30,0,30,0
1668016184052,ECE 200,001,103586,Antipa; Nicholas A,9999,0,9999,0
1668016184052,ECE 200,002,103587,Atanasov; Nikolay A.,9999,0,9999,0
1668016184052,ECE 200,003,103588,Bharadia; Dinesh,9999,0,9999,0
1668016184052,ECE 200,004,103589,Cheng; Chung Kuan,9999,0,9999,0
1668016184052,ECE 200,005,103590,Cosman; Pamela C.,9999,0,9999,0
1668016184052,ECE 200,006,103591,Dayeh; Shadi Ahmad,9999,0,9999,0
1668016184052,ECE 200,007,103592,Fainman; Yeshaiahu,9999,0,9999,0
1668016184052,ECE 200,008,103593,Ford; Joseph Earl,9999,0,9999,0
1668016184052,ECE 200,009,103594,Franceschetti; Massimo,9999,0,9999,0
1668016184052,ECE 200,010,103595,Fullerton; Eric E,9999,0,9999,0
1668016184052,ECE 200,011,103596,Galton; Ian A,9999,0,9999,0
1668016184052,ECE 200,012,103597,Gilja; Vikash,9999,0,9999,0
1668016184052,ECE 200,013,103598,Hall; Drew A.,9999,0,9999,0
1668016184052,ECE 200,014,103599,Hsueh; Tzu-Chien,9999,0,9999,0
1668016184052,ECE 200,015,103600,Javidi; Tara,9999,0,9999,0
1668016184052,ECE 200,016,103601,Kahng; Andrew Byun,9999,0,9999,0
1668016184052,ECE 200,017,103602,Kim; Young-Han,9999,0,9999,0
1668016184052,ECE 200,018,103603,Koushanfar; Farinaz,9999,0,9999,0
1668016184052,ECE 200,019,103604,Kuzum; Duygu,9999,0,9999,0
1668016184052,ECE 200,020,103605,Le; Hanh-Phuc,9999,0,9999,0
1668016184052,ECE 200,021,103606,Lin; Bill,9999,0,9999,0
1668016184052,ECE 200,022,103607,Liu; Zhaowei,9998,0,9999,1
1668016184052,ECE 200,023,103608,Lo; Yu-Hwa,9999,0,9999,0
1668016184052,ECE 200,024,103609,Lomakin; Vitaliy,9999,0,9999,0
1668016184052,ECE 200,025,103610,Mercier; Patrick Philip,9999,0,9999,0
1668016184052,ECE 200,026,103611,Meyer; Florian,9999,0,9999,0
1668016184052,ECE 200,027,103612,Milstein; Laurence B.,9999,0,9999,0
1668016184052,ECE 200,028,103613,Mir Arabbaygi; Siavash,9999,0,9999,0
1668016184052,ECE 200,029,103614,Mookherjea; Shayan,9999,0,9999,0
1668016184052,ECE 200,030,103615,Morris; Karcher William,9999,0,9999,0
1668016184052,ECE 200,031,103616,Ng; Tse Nga,9999,0,9999,0
1668016184052,ECE 200,032,103617,Nguyen; Truong Quang,9999,0,9999,0
1668016184052,ECE 200,033,103618,Nomura; Kenji,9999,0,9999,0
1668016184052,ECE 200,034,103619,Orlitsky; Alon,9999,0,9999,0
1668016184052,ECE 200,035,103620,Pal; Piya,9999,0,9999,0
1668016184052,ECE 200,036,103621,Papen; George C.,9999,0,9999,0
1668016184052,ECE 200,037,103622,Radic; Stojan,9999,0,9999,0
1668016184052,ECE 200,038,103623,Rao; Bhaskar D.,9999,0,9999,0
1668016184052,ECE 200,039,103624,Rao; Ramesh R,9999,0,9999,0
1668016184052,ECE 200,040,103625,Rebeiz; Gabriel,9999,0,9999,0
1668016184052,ECE 200,041,103626,Sanford; John R,9999,0,9999,0
1668016184052,ECE 200,042,103627,Siegel; Paul H.,9999,0,9999,0
1668016184052,ECE 200,043,103628,Sievenpiper; Daniel F.,9999,0,9999,0
1668016184052,ECE 200,044,103629,Sworder; David D.,9999,0,9999,0
1668016184052,ECE 200,045,103630,Taur; Yuan,9999,0,9999,0
1668016184052,ECE 200,046,103631,Touri; Behrouz,9999,0,9999,0
1668016184052,ECE 200,047,103632,Trivedi; Mohan M.,9999,0,9999,0
1668016184052,ECE 200,048,103633,Vasconcelos; Nuno,9999,0,9999,0
1668016184052,ECE 200,049,103634,Wang; Xiaolong,9999,0,9999,0
1668016184052,ECE 200,050,103635,Xie; Pengtao,9999,0,9999,0
1668016184052,ECE 200,051,103636,Yip; Michael,9999,0,9999,0
1668016184052,ECE 200,052,103637,Zeger; Kenneth A.,999,0,999,0
1668016184052,ECE 200,053,103638,Zhang; Xinyu,9999,0,9999,0
1668016184052,ECE 200,054,103639,Turakhia; Yatish Girish,9999,0,9999,0
1668016184052,ECE 200,055,103640,Kang; Mingu,9999,0,9999,0
1668016184052,ECE 200,056,103641,Shi; Yuanyuan,9999,0,9999,0
1668016184052,ECE 200,057,103642,Wang; Edward Jay,9999,0,9999,0
1668016184052,ECE 200,058,103643,Zheng; Yang,9999,0,9999,0
1668016184474,ECE 202,A00,103644,Kuzum; Duygu,0,0,0,0
1668016184897,ECE 212BN,A00,103646,Ng; Tse Nga,0,0,0,0
1668016185320,ECE 221,A00,111493,Staff,0,0,0,0
1668016185760,ECE 222B,A00,103647,Lomakin; Vitaliy,0,0,0,0
1668016186197,ECE 230B,A00,103648,Taur; Yuan,0,0,0,0
1668016186623,ECE 238B,A00,103649,Garay; Javier,0,0,0,0
1668016187047,ECE 240B,A00,112900,Fainman; Yeshaiahu,0,0,0,0
1668016187470,ECE 247A,A00,103650,Jokerst; Jesse Vincent,0,0,0,0
1668016187903,ECE 247B,A00,103651,Wang; Joseph,0,0,0,0
1668016188334,ECE 250,A00,103652,Siegel; Paul H.,0,0,0,0
1668016188765,ECE 251A,A00,103654,Rao; Bhaskar D.,0,0,0,0
1668016189197,ECE 257B,A00,103655,Bharadia; Dinesh,0,0,0,0
1668016189643,ECE 258A,A00,103656,Milstein; Laurence B.,0,0,0,0
1668016190066,ECE 260B,A00,103658,Kang; Mingu,0,0,0,0
1668016190497,ECE 264A,A00,103659,Galton; Ian A,0,0,0,0
1668016190932,ECE 265A,A00,103661,Gudem; Prasad S.S.,0,0,0,0
1668016191361,ECE 265D,A00,103662,Gudem; Prasad S.S.,0,0,0,0
1668016191785,ECE 268,A00,103663,Koushanfar; Farinaz,0,0,0,0
1668016192228,ECE 269,A01,103665,Pal; Piya,0,0,0,0
1668016192650,ECE 271B,A00,103666,Vasconcelos; Manuela,0,0,0,0
1668016193074,ECE 276A,A00,103667,Atanasov; Nikolay A.,0,0,0,0
1668016193514,ECE 277,A00,103668,An; Cheolhong,0,0,0,0
1668016193935,ECE 279,A00,117947,Hall; Drew A.,0,0,0,0
1668016194782,ECE 283,A00,103670,Hsueh; Tzu-Chien,0,0,0,0
1668016195215,ECE 284,A00,103671,Turakhia; Yatish Girish,0,0,0,0
1668016195644,ECE 285,A00,103672,Zheng; Yang,0,0,0,0
1668016195644,ECE 285,B00,103673,Sworder; David D.,0,0,0,0
1668016196080,ECE 287,A00,103676,Javidi; Tara,0,0,0,0
1668016196526,MATH 200B,A00,098023,Salehi Golsefidy; Alireza,14,0,15,1
1668016196968,MATH 202B,A00,098024,Rhoades; Brendon Patrick,11,0,15,4
1668016197394,MATH 203B,A00,098025,Oprea; Dragos N.,12,0,15,3
1668016197832,MATH 204B,A00,098026,Sorensen; Claus M,14,0,15,1
1668016198256,MATH 208,A00,098027,Izadi; Elham,7,0,10,3
1668016198704,MATH 209,A00,098028,Pollack; Aaron,10,0,10,0
1668016199130,MATH 211A,A00,112919,Rogalski; Daniel,9,0,10,1
1668016199561,MATH 211B,A00,112920,Seward; Brandon M.,9,0,10,1
1668016199997,MATH 218,A00,098029,Li; Bo,10,0,10,0
1668016200442,MATH 220B,A00,098030,Novak; Jonathan I,13,0,15,2
1668016200925,MATH 221A,A00,098031,Ebenfelt; Peter F,13,0,15,2
1668016201355,MATH 231B,A00,098032,Zlatos; Andrej,12,0,15,3
1668016201780,MATH 240B,A00,098033,Ni; Lei,10,0,15,5
1668016202224,MATH 243,A00,098034,Jekel; David Andrew,10,0,10,0
1668016202650,MATH 245A,A00,098035,Nie; Jiawang,0,0,15,16
1668016203082,MATH 248,A00,098036,Bejenaru; Ioan,10,0,10,0
1668016203518,MATH 250B,A00,098037,Spolaor; Luca,14,0,15,1
1668016203947,MATH 258,A00,098038,Ni; Lei,10,0,10,0
1668016204370,MATH 264B,A00,098041,Rhoades; Brendon Patrick,10,0,15,5
1668016204805,MATH 268,A00,098042,Buss; Samuel R,10,0,10,0
1668016205227,MATH 269,A00,098043,Rhoades; Brendon Patrick,10,0,10,0
1668016205649,MATH 270B,A00,098044,Li; Bo,11,0,15,4
1668016206074,MATH 272B,A00,098045,Holst; Michael J,13,0,15,2
1668016206502,MATH 273A,A00,098046,Tian; Xiaochuan,11,0,15,4
1668016206927,MATH 275,A01,098048,Tian; Xiaochuan,6,0,10,4
1668016207352,MATH 278A,A00,098049,Holst; Michael J,8,0,10,2
1668016207875,MATH 278B,A00,098050,Cloninger; Alexander,10,0,10,0
1668016208304,MATH 278C,A00,098051,Nie; Jiawang,8,0,10,2
1668016208737,MATH 280B,A00,098052,Zheng; Tianyi,11,0,15,4
1668016209161,MATH 281B,A00,098053,Bradic; Jelena,4,0,15,11
1668016209594,MATH 282B,A00,098054,Arias-Castro; Ery,2,0,15,13
1668016210023,MATH 285,A00,098055,Fitzsimmons; Patrick J,0,0,15,17
1668016210464,MATH 287B,A00,098056,Arias-Castro; Ery,5,0,15,10
1668016210892,MATH 288,A00,098057,Agarwal; Pooja,9,0,10,1
1668016210892,MATH 288,B00,098058,Zhang; Danna,9,0,10,1
1668016210892,MATH 288,C00,098059,Williams; Ruth J,10,0,10,0
1668016211325,MATH 290B,A00,098060,Roberts; Justin Deritter,14,0,15,1
1668016211749,MATH 292,A00,098061,Belmont; Eva Kinoshita,10,0,10,0
1668016212177,MATH 295,A00,098062,Suk; Andrew Hoon,48,0,50,2
1668016212609,MATH 296,A00,098063,Novak; Jonathan I,20,0,20,0
1668016213033,MATH 297,001,098064,Gamst; Anthony Collins,9997,0,9999,2
1668016717954,COGS 205,A00,101395,Chiba; Andrea,19,0,20,1
1668016718382,COGS 210B,001,101404,Greene; Deanna Jacquelyn,9998,0,9999,1
1668016718382,COGS 210B,002,101417,Xia; Haijun,9999,0,9999,0
1668016718382,COGS 210B,003,101422,Nitz; Douglas A.,9999,0,9999,0
1668016718382,COGS 210B,004,101423,Hollan; James D.,9998,0,9999,1
1668016718382,COGS 210B,005,101424,Deak; Gedeon O.,9999,0,9999,0
1668016718382,COGS 210B,006,101425,Rossano; Federico,9999,0,9999,0
1668016718809,COGS 211B,A00,101427,Coulson; Seana M,9997,0,9999,2
1668016719233,COGS 220,A00,101428,Hollan; James D.,0,0,25,25
1668016719670,COGS 229,A00,101429,Dow; Steven P,18,0,25,7
1668016720105,COGS 230,A00,101430,Klemmer; Scott R,13,0,17,4
1668016720532,COGS 234,A00,101431,Xia; Haijun,5,0,25,20
1668016720967,COGS 260,A00,101432,Kiyonaga; Anastasia,20,0,25,5
1668016720967,COGS 260,B00,101433,Kirsh; David Joel,16,0,25,9
1668016721395,CSE 202,A00,102371,Impagliazzo; Russell,0,0,0,0
1668016721822,CSE 203B,A01,102373,Cheng; Chung Kuan,0,0,0,0
1668016722249,CSE 208,A00,102374,Micciancio; Daniele,0,0,0,0
1668016722681,CSE 209A,A00,112895,Impagliazzo; Russell,0,0,15,15
1668016723111,CSE 209B,A00,108005,Bellare; Mihir,0,0,0,0
1668016723543,CSE 210,A00,113163,Coblenz; Michael J,0,0,0,0
1668016723968,CSE 219,A00,106111,Dow; Steven P,0,0,20,20
1668016724401,CSE 221,A00,102376,Voelker; Geoffrey M.,0,0,0,0
1668016724835,CSE 224,A01,102378,Porter; George M,0,0,0,0
1668016725261,CSE 229A,A00,102379,Savage; Stefan,0,0,0,0
1668016725693,CSE 229C,A00,102380,Munyaka; Imani N. S.,0,0,0,0
1668016726124,CSE 232B,A00,102382,Deutsch; Alin Bernard,0,0,0,0
1668016726556,CSE 234,A01,112904,Kumar; Arun Kumar,0,0,0,0
1668016726992,CSE 237A,A00,102383,Rosing; Tajana Simunic,0,0,0,0
1668016727417,CSE 239A,A00,102384,Deutsch; Alin Bernard,0,0,0,0
1668016727841,CSE 239B,A00,102385,Polikarpova; Nadezhda,0,0,0,0
1668016728265,CSE 240A,A00,102386,Pannuto; Patrick William,0,0,0,0
1668016728700,CSE 240B,A00,102387,Zhao; Jishen,0,0,0,0
1668016729126,CSE 241A,A00,106406,Kang; Mingu,0,0,0,0
1668016729548,CSE 249B,A00,102388,Kahng; Andrew Byun,0,0,8,8
1668016729974,CSE 251B,A01,102392,Cottrell; Garrison W,0,0,0,0
1668016729974,CSE 251B,A02,102393,Cottrell; Garrison W,0,0,0,0
1668016730412,CSE 252B,A00,102394,Ochoa; Benjamin Lawrence,0,0,0,0
1668016730839,CSE 257,A01,102396,Gao; Sicun,0,0,0,0
1668016731262,CSE 272,A00,102397,Li; Tzumao,0,0,0,0
1668016731705,CSE 274,A00,111323,Chern; Albert Ren-Haur,0,0,0,0
1668016732141,CSE 282,A00,102398,Pevzner; Pavel Arkadjevich,0,0,0,0
1668016732564,CSE 284,A00,114175,Gymrek; Melissa Ann,0,0,0,0
1668016733089,CSE 290,A00,102399,Chandraker; Manmohan Krishna,0,0,0,0
1668016733089,CSE 290,B00,102400,Vaccaro; Kristen Marie,0,0,25,25
1668016733089,CSE 290,C00,102414,Pannuto; Patrick William,0,0,25,25
1668016733089,CSE 290,D00,102427,Pevzner; Pavel Arkadjevich,0,0,0,0
1668016733089,CSE 290,E00,102429,Zhao; Jishen,0,0,0,0
1668016733089,CSE 290,F00,102436,Tullsen; Dean Michael,0,0,0,0
1668016733089,CSE 290,G00,102440,Christensen; Henrik I,0,0,20,20
1668016733523,CSE 291,A00,102443,Su; Hao,0,0,0,0
1668016733523,CSE 291,B00,102448,Polikarpova; Nadezhda,0,0,0,0
1668016733523,CSE 291,C00,102453,Vaccaro; Kristen Marie,0,0,0,0
1668016733523,CSE 291,D00,111343,Savage; Stefan,0,0,0,0
1668016733523,CSE 291,E00,116474,Claffy; Kimberly Claire,0,0,0,0
1668016733523,CSE 291,F00,116479,Pasquale; Joseph,0,0,0,0
1668016733959,CSE 293,001,119111,Bafna; Vineet,9999,0,9999,0
1668016733959,CSE 293,002,119118,Bellare; Mihir,9999,0,9999,0
1668016733959,CSE 293,003,119122,Berg-Kirkpatrick; Taylor D,9999,0,9999,0
1668016733959,CSE 293,004,119135,Christensen; Henrik I,9999,0,9999,0
1668016733959,CSE 293,005,119142,Cottrell; Garrison W,9999,0,9999,0
1668016733959,CSE 293,006,119146,Deutsch; Alin Bernard,9999,0,9999,0
1668016733959,CSE 293,007,119159,Esmaeilzadeh; Hadi,9999,0,9999,0
1668016733959,CSE 293,008,119166,Freund; Yoav,9999,0,9999,0
1668016733959,CSE 293,009,119170,Griswold; William G.,9999,0,9999,0
1668016733959,CSE 293,010,119183,Gymrek; Melissa Ann,9999,0,9999,0
1668016733959,CSE 293,011,119190,Heninger; Nadia A,9999,0,9999,0
1668016733959,CSE 293,012,119230,Impagliazzo; Russell,9999,0,9999,0
1668016733959,CSE 293,013,119232,Jhala; Ranjit,9999,0,9999,0
1668016733959,CSE 293,014,119233,Kahng; Andrew Byun,9999,0,9999,0
1668016733959,CSE 293,015,119298,Kane; Daniel Mertz,9999,0,9999,0
1668016733959,CSE 293,016,119299,Kriegman; David J,9999,0,9999,0
1668016733959,CSE 293,017,119300,Kumar; Arun Kumar,9999,0,9999,0
1668016733959,CSE 293,018,119301,Lerner; Sorin,9999,0,9999,0
1668016733959,CSE 293,019,119302,Lovett; Shachar,9999,0,9999,0
1668016733959,CSE 293,020,119303,McAuley; Julian John,9999,0,9999,0
1668016733959,CSE 293,021,119304,Micciancio; Daniele,9999,0,9999,0
1668016733959,CSE 293,022,119367,Orailoglu; Alex,9999,0,9999,0
1668016733959,CSE 293,023,119382,Paturi; Ramamohan,9999,0,9999,0
1668016733959,CSE 293,024,119404,Polikarpova; Nadezhda,9999,0,9999,0
1668016733959,CSE 293,025,119406,Politz; Joseph Gibbs,9999,0,9999,0
1668016733959,CSE 293,026,119411,Porter; George M,9999,0,9999,0
1668016733959,CSE 293,027,119414,Porter; Leonard Emerson,9999,0,9999,0
1668016733959,CSE 293,028,119416,Ramamoorthi; Ravi,9999,0,9999,0
1668016733959,CSE 293,029,119417,Sahoo; Debashis,9999,0,9999,0
1668016733959,CSE 293,030,119420,Saul; Lawrence,9999,0,9999,0
1668016733959,CSE 293,031,119421,Savage; Stefan,9999,0,9999,0
1668016733959,CSE 293,032,119425,Schulze; Jurgen P.,9999,0,9999,0
1668016733959,CSE 293,033,119426,Snoeren; Alex C.,9999,0,9999,0
1668016733959,CSE 293,034,119428,Shang; Jingbo,9999,0,9999,0
1668016733959,CSE 293,035,119430,Stefan; Deian,9999,0,9999,0
1668016733959,CSE 293,036,119431,Su; Hao,9999,0,9999,0
1668016733959,CSE 293,037,119433,Swanson; Steven James,9999,0,9999,0
1668016733959,CSE 293,038,119435,Tullsen; Dean Michael,9999,0,9999,0
1668016733959,CSE 293,039,119483,Voelker; Geoffrey M.,9999,0,9999,0
1668016733959,CSE 293,040,119537,Zhao; Jishen,9999,0,9999,0
1668016733959,CSE 293,041,119538,Zhou; Yuan-Yuan,9999,0,9999,0
1668016733959,CSE 293,042,119539,Gao; Sicun,9999,0,9999,0
1668016733959,CSE 293,043,119540,Weibel; Nadir,9999,0,9999,0
1668016733959,CSE 293,044,119541,Gupta; Rajesh K.,9999,0,9999,0
1668016733959,CSE 293,045,126410,Vaccaro; Kristen Marie,9999,0,9999,0
1668016733959,CSE 293,046,126411,Klemke; Richard,9999,0,9999,0
1668016734387,CSE 294,A00,102459,Voelker; Geoffrey M.,0,0,0,0
1668016734387,CSE 294,B00,111322,Orailoglu; Alex,0,0,0,0
1668016734824,DSE 201,A00,096914,Deutsch; Alin Bernard,30,0,30,0
1668016735246,DSE 210,A00,096915,Dasgupta; Sanjoy,30,0,30,0
1668016735681,DSE 260A,A00,096916,Altintas De Callaf; Ilkay,30,0,30,0
1668016736119,ECE 200,001,103586,Antipa; Nicholas A,9999,0,9999,0
1668016736119,ECE 200,002,103587,Atanasov; Nikolay A.,9999,0,9999,0
1668016736119,ECE 200,003,103588,Bharadia; Dinesh,9999,0,9999,0
1668016736119,ECE 200,004,103589,Cheng; Chung Kuan,9999,0,9999,0
1668016736119,ECE 200,005,103590,Cosman; Pamela C.,9999,0,9999,0
1668016736119,ECE 200,006,103591,Dayeh; Shadi Ahmad,9999,0,9999,0
1668016736119,ECE 200,007,103592,Fainman; Yeshaiahu,9999,0,9999,0
1668016736119,ECE 200,008,103593,Ford; Joseph Earl,9999,0,9999,0
1668016736119,ECE 200,009,103594,Franceschetti; Massimo,9999,0,9999,0
1668016736119,ECE 200,010,103595,Fullerton; Eric E,9999,0,9999,0
1668016736119,ECE 200,011,103596,Galton; Ian A,9999,0,9999,0
1668016736119,ECE 200,012,103597,Gilja; Vikash,9999,0,9999,0
1668016736119,ECE 200,013,103598,Hall; Drew A.,9999,0,9999,0
1668016736119,ECE 200,014,103599,Hsueh; Tzu-Chien,9999,0,9999,0
1668016736119,ECE 200,015,103600,Javidi; Tara,9999,0,9999,0
1668016736119,ECE 200,016,103601,Kahng; Andrew Byun,9999,0,9999,0
1668016736119,ECE 200,017,103602,Kim; Young-Han,9999,0,9999,0
1668016736119,ECE 200,018,103603,Koushanfar; Farinaz,9999,0,9999,0
1668016736119,ECE 200,019,103604,Kuzum; Duygu,9999,0,9999,0
1668016736119,ECE 200,020,103605,Le; Hanh-Phuc,9999,0,9999,0
1668016736119,ECE 200,021,103606,Lin; Bill,9999,0,9999,0
1668016736119,ECE 200,022,103607,Liu; Zhaowei,9998,0,9999,1
1668016736119,ECE 200,023,103608,Lo; Yu-Hwa,9999,0,9999,0
1668016736119,ECE 200,024,103609,Lomakin; Vitaliy,9999,0,9999,0
1668016736119,ECE 200,025,103610,Mercier; Patrick Philip,9999,0,9999,0
1668016736119,ECE 200,026,103611,Meyer; Florian,9999,0,9999,0
1668016736119,ECE 200,027,103612,Milstein; Laurence B.,9999,0,9999,0
1668016736119,ECE 200,028,103613,Mir Arabbaygi; Siavash,9999,0,9999,0
1668016736119,ECE 200,029,103614,Mookherjea; Shayan,9999,0,9999,0
1668016736119,ECE 200,030,103615,Morris; Karcher William,9999,0,9999,0
1668016736119,ECE 200,031,103616,Ng; Tse Nga,9999,0,9999,0
1668016736119,ECE 200,032,103617,Nguyen; Truong Quang,9999,0,9999,0
1668016736119,ECE 200,033,103618,Nomura; Kenji,9999,0,9999,0
1668016736119,ECE 200,034,103619,Orlitsky; Alon,9999,0,9999,0
1668016736119,ECE 200,035,103620,Pal; Piya,9999,0,9999,0
1668016736119,ECE 200,036,103621,Papen; George C.,9999,0,9999,0
1668016736119,ECE 200,037,103622,Radic; Stojan,9999,0,9999,0
1668016736119,ECE 200,038,103623,Rao; Bhaskar D.,9999,0,9999,0
1668016736119,ECE 200,039,103624,Rao; Ramesh R,9999,0,9999,0
1668016736119,ECE 200,040,103625,Rebeiz; Gabriel,9999,0,9999,0
1668016736119,ECE 200,041,103626,Sanford; John R,9999,0,9999,0
1668016736119,ECE 200,042,103627,Siegel; Paul H.,9999,0,9999,0
1668016736119,ECE 200,043,103628,Sievenpiper; Daniel F.,9999,0,9999,0
1668016736119,ECE 200,044,103629,Sworder; David D.,9999,0,9999,0
1668016736119,ECE 200,045,103630,Taur; Yuan,9999,0,9999,0
1668016736119,ECE 200,046,103631,Touri; Behrouz,9999,0,9999,0
1668016736119,ECE 200,047,103632,Trivedi; Mohan M.,9999,0,9999,0
1668016736119,ECE 200,048,103633,Vasconcelos; Nuno,9999,0,9999,0
1668016736119,ECE 200,049,103634,Wang; Xiaolong,9999,0,9999,0
1668016736119,ECE 200,050,103635,Xie; Pengtao,9999,0,9999,0
1668016736119,ECE 200,051,103636,Yip; Michael,9999,0,9999,0
1668016736119,ECE 200,052,103637,Zeger; Kenneth A.,999,0,999,0
1668016736119,ECE 200,053,103638,Zhang; Xinyu,9999,0,9999,0
1668016736119,ECE 200,054,103639,Turakhia; Yatish Girish,9999,0,9999,0
1668016736119,ECE 200,055,103640,Kang; Mingu,9999,0,9999,0
1668016736119,ECE 200,056,103641,Shi; Yuanyuan,9999,0,9999,0
1668016736119,ECE 200,057,103642,Wang; Edward Jay,9999,0,9999,0
1668016736119,ECE 200,058,103643,Zheng; Yang,9999,0,9999,0
1668016736554,ECE 202,A00,103644,Kuzum; Duygu,0,0,0,0
1668016736977,ECE 212BN,A00,103646,Ng; Tse Nga,0,0,0,0
1668016737409,ECE 221,A00,111493,Staff,0,0,0,0
1668016737850,ECE 222B,A00,103647,Lomakin; Vitaliy,0,0,0,0
1668016738284,ECE 230B,A00,103648,Taur; Yuan,0,0,0,0
1668016738728,ECE 238B,A00,103649,Garay; Javier,0,0,0,0
1668016739166,ECE 240B,A00,112900,Fainman; Yeshaiahu,0,0,0,0
1668016739606,ECE 247A,A00,103650,Jokerst; Jesse Vincent,0,0,0,0
1668016740033,ECE 247B,A00,103651,Wang; Joseph,0,0,0,0
1668016740455,ECE 250,A00,103652,Siegel; Paul H.,0,0,0,0
1668016740887,ECE 251A,A00,103654,Rao; Bhaskar D.,0,0,0,0
1668016741322,ECE 257B,A00,103655,Bharadia; Dinesh,0,0,0,0
1668016741752,ECE 258A,A00,103656,Milstein; Laurence B.,0,0,0,0
1668016742178,ECE 260B,A00,103658,Kang; Mingu,0,0,0,0
1668016742604,ECE 264A,A00,103659,Galton; Ian A,0,0,0,0
1668016743046,ECE 265A,A00,103661,Gudem; Prasad S.S.,0,0,0,0
1668016743472,ECE 265D,A00,103662,Gudem; Prasad S.S.,0,0,0,0
1668016743894,ECE 268,A00,103663,Koushanfar; Farinaz,0,0,0,0
1668016744319,ECE 269,A01,103665,Pal; Piya,0,0,0,0
1668016744745,ECE 271B,A00,103666,Vasconcelos; Manuela,0,0,0,0
1668016745169,ECE 276A,A00,103667,Atanasov; Nikolay A.,0,0,0,0
1668016745601,ECE 277,A00,103668,An; Cheolhong,0,0,0,0
1668016746028,ECE 279,A00,117947,Hall; Drew A.,0,0,0,0
1668016746897,ECE 283,A00,103670,Hsueh; Tzu-Chien,0,0,0,0
1668016747322,ECE 284,A00,103671,Turakhia; Yatish Girish,0,0,0,0
1668016747760,ECE 285,A00,103672,Zheng; Yang,0,0,0,0
1668016747760,ECE 285,B00,103673,Sworder; David D.,0,0,0,0
1668016748195,ECE 287,A00,103676,Javidi; Tara,0,0,0,0
1668016748625,MATH 200B,A00,098023,Salehi Golsefidy; Alireza,14,0,15,1
1668016749064,MATH 202B,A00,098024,Rhoades; Brendon Patrick,11,0,15,4
1668016749494,MATH 203B,A00,098025,Oprea; Dragos N.,12,0,15,3
1668016749919,MATH 204B,A00,098026,Sorensen; Claus M,14,0,15,1
1668016750350,MATH 208,A00,098027,Izadi; Elham,7,0,10,3
1668016750814,MATH 209,A00,098028,Pollack; Aaron,10,0,10,0
1668016751239,MATH 211A,A00,112919,Rogalski; Daniel,9,0,10,1
1668016751675,MATH 211B,A00,112920,Seward; Brandon M.,9,0,10,1
1668016752101,MATH 218,A00,098029,Li; Bo,10,0,10,0
1668016752523,MATH 220B,A00,098030,Novak; Jonathan I,13,0,15,2
1668016752955,MATH 221A,A00,098031,Ebenfelt; Peter F,13,0,15,2
1668016753381,MATH 231B,A00,098032,Zlatos; Andrej,12,0,15,3
1668016753804,MATH 240B,A00,098033,Ni; Lei,10,0,15,5
1668016754228,MATH 243,A00,098034,Jekel; David Andrew,10,0,10,0
1668016754667,MATH 245A,A00,098035,Nie; Jiawang,0,0,15,16
1668016755100,MATH 248,A00,098036,Bejenaru; Ioan,10,0,10,0
1668016755526,MATH 250B,A00,098037,Spolaor; Luca,14,0,15,1
1668016755960,MATH 258,A00,098038,Ni; Lei,10,0,10,0
1668016756384,MATH 264B,A00,098041,Rhoades; Brendon Patrick,10,0,15,5
1668016756807,MATH 268,A00,098042,Buss; Samuel R,10,0,10,0
1668016757235,MATH 269,A00,098043,Rhoades; Brendon Patrick,10,0,10,0
1668016757659,MATH 270B,A00,098044,Li; Bo,11,0,15,4
1668016758094,MATH 272B,A00,098045,Holst; Michael J,13,0,15,2
1668016758522,MATH 273A,A00,098046,Tian; Xiaochuan,11,0,15,4
1668016758946,MATH 275,A01,098048,Tian; Xiaochuan,6,0,10,4
1668016759383,MATH 278A,A00,098049,Holst; Michael J,8,0,10,2
1668016759811,MATH 278B,A00,098050,Cloninger; Alexander,10,0,10,0
1668016760240,MATH 278C,A00,098051,Nie; Jiawang,8,0,10,2
1668016760669,MATH 280B,A00,098052,Zheng; Tianyi,11,0,15,4
1668016761093,MATH 281B,A00,098053,Bradic; Jelena,4,0,15,11
1668016761525,MATH 282B,A00,098054,Arias-Castro; Ery,2,0,15,13
1668016761952,MATH 285,A00,098055,Fitzsimmons; Patrick J,0,0,15,17
1668016762380,MATH 287B,A00,098056,Arias-Castro; Ery,5,0,15,10
1668016762815,MATH 288,A00,098057,Agarwal; Pooja,9,0,10,1
1668016762815,MATH 288,B00,098058,Zhang; Danna,9,0,10,1
1668016762815,MATH 288,C00,098059,Williams; Ruth J,10,0,10,0
1668016763238,MATH 290B,A00,098060,Roberts; Justin Deritter,14,0,15,1
1668016763665,MATH 292,A00,098061,Belmont; Eva Kinoshita,10,0,10,0
1668016764090,MATH 295,A00,098062,Suk; Andrew Hoon,48,0,50,2
1668016764517,MATH 296,A00,098063,Novak; Jonathan I,20,0,20,0
1668016764957,MATH 297,001,098064,Gamst; Anthony Collins,9997,0,9999,2
1668017274204,COGS 205,A00,101395,Chiba; Andrea,19,0,20,1
1668017274639,COGS 210B,001,101404,Greene; Deanna Jacquelyn,9998,0,9999,1
1668017274639,COGS 210B,002,101417,Xia; Haijun,9999,0,9999,0
1668017274639,COGS 210B,003,101422,Nitz; Douglas A.,9999,0,9999,0
1668017274639,COGS 210B,004,101423,Hollan; James D.,9998,0,9999,1
1668017274639,COGS 210B,005,101424,Deak; Gedeon O.,9999,0,9999,0
1668017274639,COGS 210B,006,101425,Rossano; Federico,9999,0,9999,0
1668017275078,COGS 211B,A00,101427,Coulson; Seana M,9997,0,9999,2
1668017275505,COGS 220,A00,101428,Hollan; James D.,0,0,25,25
1668017275944,COGS 229,A00,101429,Dow; Steven P,18,0,25,7
1668017276380,COGS 230,A00,101430,Klemmer; Scott R,13,0,17,4
1668017276804,COGS 234,A00,101431,Xia; Haijun,5,0,25,20
1668017277242,COGS 260,A00,101432,Kiyonaga; Anastasia,20,0,25,5
1668017277242,COGS 260,B00,101433,Kirsh; David Joel,16,0,25,9
1668017277673,CSE 202,A00,102371,Impagliazzo; Russell,0,0,0,0
1668017278104,CSE 203B,A01,102373,Cheng; Chung Kuan,0,0,0,0
1668017278531,CSE 208,A00,102374,Micciancio; Daniele,0,0,0,0
1668017278969,CSE 209A,A00,112895,Impagliazzo; Russell,0,0,15,15
1668017279395,CSE 209B,A00,108005,Bellare; Mihir,0,0,0,0
1668017279830,CSE 210,A00,113163,Coblenz; Michael J,0,0,0,0
1668017280282,CSE 219,A00,106111,Dow; Steven P,0,0,20,20
1668017280722,CSE 221,A00,102376,Voelker; Geoffrey M.,0,0,0,0
1668017281160,CSE 224,A01,102378,Porter; George M,0,0,0,0
1668017281587,CSE 229A,A00,102379,Savage; Stefan,0,0,0,0
1668017282009,CSE 229C,A00,102380,Munyaka; Imani N. S.,0,0,0,0
1668017282448,CSE 232B,A00,102382,Deutsch; Alin Bernard,0,0,0,0
1668017283070,CSE 234,A01,112904,Kumar; Arun Kumar,0,0,0,0
1668017283493,CSE 237A,A00,102383,Rosing; Tajana Simunic,0,0,0,0
1668017283915,CSE 239A,A00,102384,Deutsch; Alin Bernard,0,0,0,0
1668017284347,CSE 239B,A00,102385,Polikarpova; Nadezhda,0,0,0,0
1668017284773,CSE 240A,A00,102386,Pannuto; Patrick William,0,0,0,0
1668017285208,CSE 240B,A00,102387,Zhao; Jishen,0,0,0,0
1668017285635,CSE 241A,A00,106406,Kang; Mingu,0,0,0,0
1668017286077,CSE 249B,A00,102388,Kahng; Andrew Byun,0,0,8,8
1668017286513,CSE 251B,A01,102392,Cottrell; Garrison W,0,0,0,0
1668017286513,CSE 251B,A02,102393,Cottrell; Garrison W,0,0,0,0
1668017286949,CSE 252B,A00,102394,Ochoa; Benjamin Lawrence,0,0,0,0
1668017287378,CSE 257,A01,102396,Gao; Sicun,0,0,0,0
1668017287801,CSE 272,A00,102397,Li; Tzumao,0,0,0,0
1668017288227,CSE 274,A00,111323,Chern; Albert Ren-Haur,0,0,0,0
1668017288650,CSE 282,A00,102398,Pevzner; Pavel Arkadjevich,0,0,0,0
1668017289073,CSE 284,A00,114175,Gymrek; Melissa Ann,0,0,0,0
1668017289513,CSE 290,A00,102399,Chandraker; Manmohan Krishna,0,0,0,0
1668017289513,CSE 290,B00,102400,Vaccaro; Kristen Marie,0,0,25,25
1668017289513,CSE 290,C00,102414,Pannuto; Patrick William,0,0,25,25
1668017289513,CSE 290,D00,102427,Pevzner; Pavel Arkadjevich,0,0,0,0
1668017289513,CSE 290,E00,102429,Zhao; Jishen,0,0,0,0
1668017289513,CSE 290,F00,102436,Tullsen; Dean Michael,0,0,0,0
1668017289513,CSE 290,G00,102440,Christensen; Henrik I,0,0,20,20
1668017289936,CSE 291,A00,102443,Su; Hao,0,0,0,0
1668017289936,CSE 291,B00,102448,Polikarpova; Nadezhda,0,0,0,0
1668017289936,CSE 291,C00,102453,Vaccaro; Kristen Marie,0,0,0,0
1668017289936,CSE 291,D00,111343,Savage; Stefan,0,0,0,0
1668017289936,CSE 291,E00,116474,Claffy; Kimberly Claire,0,0,0,0
1668017289936,CSE 291,F00,116479,Pasquale; Joseph,0,0,0,0
1668017290396,CSE 293,001,119111,Bafna; Vineet,9999,0,9999,0
1668017290396,CSE 293,002,119118,Bellare; Mihir,9999,0,9999,0
1668017290396,CSE 293,003,119122,Berg-Kirkpatrick; Taylor D,9999,0,9999,0
1668017290396,CSE 293,004,119135,Christensen; Henrik I,9999,0,9999,0
1668017290396,CSE 293,005,119142,Cottrell; Garrison W,9999,0,9999,0
1668017290396,CSE 293,006,119146,Deutsch; Alin Bernard,9999,0,9999,0
1668017290396,CSE 293,007,119159,Esmaeilzadeh; Hadi,9999,0,9999,0
1668017290396,CSE 293,008,119166,Freund; Yoav,9999,0,9999,0
1668017290396,CSE 293,009,119170,Griswold; William G.,9999,0,9999,0
1668017290396,CSE 293,010,119183,Gymrek; Melissa Ann,9999,0,9999,0
1668017290396,CSE 293,011,119190,Heninger; Nadia A,9999,0,9999,0
1668017290396,CSE 293,012,119230,Impagliazzo; Russell,9999,0,9999,0
1668017290396,CSE 293,013,119232,Jhala; Ranjit,9999,0,9999,0
1668017290396,CSE 293,014,119233,Kahng; Andrew Byun,9999,0,9999,0
1668017290396,CSE 293,015,119298,Kane; Daniel Mertz,9999,0,9999,0
1668017290396,CSE 293,016,119299,Kriegman; David J,9999,0,9999,0
1668017290396,CSE 293,017,119300,Kumar; Arun Kumar,9999,0,9999,0
1668017290396,CSE 293,018,119301,Lerner; Sorin,9999,0,9999,0
1668017290396,CSE 293,019,119302,Lovett; Shachar,9999,0,9999,0
1668017290396,CSE 293,020,119303,McAuley; Julian John,9999,0,9999,0
1668017290396,CSE 293,021,119304,Micciancio; Daniele,9999,0,9999,0
1668017290396,CSE 293,022,119367,Orailoglu; Alex,9999,0,9999,0
1668017290396,CSE 293,023,119382,Paturi; Ramamohan,9999,0,9999,0
1668017290396,CSE 293,024,119404,Polikarpova; Nadezhda,9999,0,9999,0
1668017290396,CSE 293,025,119406,Politz; Joseph Gibbs,9999,0,9999,0
1668017290396,CSE 293,026,119411,Porter; George M,9999,0,9999,0
1668017290396,CSE 293,027,119414,Porter; Leonard Emerson,9999,0,9999,0
1668017290396,CSE 293,028,119416,Ramamoorthi; Ravi,9999,0,9999,0
1668017290396,CSE 293,029,119417,Sahoo; Debashis,9999,0,9999,0
1668017290396,CSE 293,030,119420,Saul; Lawrence,9999,0,9999,0
1668017290396,CSE 293,031,119421,Savage; Stefan,9999,0,9999,0
1668017290396,CSE 293,032,119425,Schulze; Jurgen P.,9999,0,9999,0
1668017290396,CSE 293,033,119426,Snoeren; Alex C.,9999,0,9999,0
1668017290396,CSE 293,034,119428,Shang; Jingbo,9999,0,9999,0
1668017290396,CSE 293,035,119430,Stefan; Deian,9999,0,9999,0
1668017290396,CSE 293,036,119431,Su; Hao,9999,0,9999,0
1668017290396,CSE 293,037,119433,Swanson; Steven James,9999,0,9999,0
1668017290396,CSE 293,038,119435,Tullsen; Dean Michael,9999,0,9999,0
1668017290396,CSE 293,039,119483,Voelker; Geoffrey M.,9999,0,9999,0
1668017290396,CSE 293,040,119537,Zhao; Jishen,9999,0,9999,0
1668017290396,CSE 293,041,119538,Zhou; Yuan-Yuan,9999,0,9999,0
1668017290396,CSE 293,042,119539,Gao; Sicun,9999,0,9999,0
1668017290396,CSE 293,043,119540,Weibel; Nadir,9999,0,9999,0
1668017290396,CSE 293,044,119541,Gupta; Rajesh K.,9999,0,9999,0
1668017290396,CSE 293,045,126410,Vaccaro; Kristen Marie,9999,0,9999,0
1668017290396,CSE 293,046,126411,Klemke; Richard,9999,0,9999,0
1668017290839,CSE 294,A00,102459,Voelker; Geoffrey M.,0,0,0,0
1668017290839,CSE 294,B00,111322,Orailoglu; Alex,0,0,0,0
1668017291269,DSE 201,A00,096914,Deutsch; Alin Bernard,30,0,30,0
1668017291702,DSE 210,A00,096915,Dasgupta; Sanjoy,30,0,30,0
1668017292128,DSE 260A,A00,096916,Altintas De Callaf; Ilkay,30,0,30,0
1668017292562,ECE 200,001,103586,Antipa; Nicholas A,9999,0,9999,0
1668017292562,ECE 200,002,103587,Atanasov; Nikolay A.,9999,0,9999,0
1668017292562,ECE 200,003,103588,Bharadia; Dinesh,9999,0,9999,0
1668017292562,ECE 200,004,103589,Cheng; Chung Kuan,9999,0,9999,0
1668017292562,ECE 200,005,103590,Cosman; Pamela C.,9999,0,9999,0
1668017292562,ECE 200,006,103591,Dayeh; Shadi Ahmad,9999,0,9999,0
1668017292562,ECE 200,007,103592,Fainman; Yeshaiahu,9999,0,9999,0
1668017292562,ECE 200,008,103593,Ford; Joseph Earl,9999,0,9999,0
1668017292562,ECE 200,009,103594,Franceschetti; Massimo,9999,0,9999,0
1668017292562,ECE 200,010,103595,Fullerton; Eric E,9999,0,9999,0
1668017292562,ECE 200,011,103596,Galton; Ian A,9999,0,9999,0
1668017292562,ECE 200,012,103597,Gilja; Vikash,9999,0,9999,0
1668017292562,ECE 200,013,103598,Hall; Drew A.,9999,0,9999,0
1668017292562,ECE 200,014,103599,Hsueh; Tzu-Chien,9999,0,9999,0
1668017292562,ECE 200,015,103600,Javidi; Tara,9999,0,9999,0
1668017292562,ECE 200,016,103601,Kahng; Andrew Byun,9999,0,9999,0
1668017292562,ECE 200,017,103602,Kim; Young-Han,9999,0,9999,0
1668017292562,ECE 200,018,103603,Koushanfar; Farinaz,9999,0,9999,0
1668017292562,ECE 200,019,103604,Kuzum; Duygu,9999,0,9999,0
1668017292562,ECE 200,020,103605,Le; Hanh-Phuc,9999,0,9999,0
1668017292562,ECE 200,021,103606,Lin; Bill,9999,0,9999,0
1668017292562,ECE 200,022,103607,Liu; Zhaowei,9998,0,9999,1
1668017292562,ECE 200,023,103608,Lo; Yu-Hwa,9999,0,9999,0
1668017292562,ECE 200,024,103609,Lomakin; Vitaliy,9999,0,9999,0
1668017292562,ECE 200,025,103610,Mercier; Patrick Philip,9999,0,9999,0
1668017292562,ECE 200,026,103611,Meyer; Florian,9999,0,9999,0
1668017292562,ECE 200,027,103612,Milstein; Laurence B.,9999,0,9999,0
1668017292562,ECE 200,028,103613,Mir Arabbaygi; Siavash,9999,0,9999,0
1668017292562,ECE 200,029,103614,Mookherjea; Shayan,9999,0,9999,0
1668017292562,ECE 200,030,103615,Morris; Karcher William,9999,0,9999,0
1668017292562,ECE 200,031,103616,Ng; Tse Nga,9999,0,9999,0
1668017292562,ECE 200,032,103617,Nguyen; Truong Quang,9999,0,9999,0
1668017292562,ECE 200,033,103618,Nomura; Kenji,9999,0,9999,0
1668017292562,ECE 200,034,103619,Orlitsky; Alon,9999,0,9999,0
1668017292562,ECE 200,035,103620,Pal; Piya,9999,0,9999,0
1668017292562,ECE 200,036,103621,Papen; George C.,9999,0,9999,0
1668017292562,ECE 200,037,103622,Radic; Stojan,9999,0,9999,0
1668017292562,ECE 200,038,103623,Rao; Bhaskar D.,9999,0,9999,0
1668017292562,ECE 200,039,103624,Rao; Ramesh R,9999,0,9999,0
1668017292562,ECE 200,040,103625,Rebeiz; Gabriel,9999,0,9999,0
1668017292562,ECE 200,041,103626,Sanford; John R,9999,0,9999,0
1668017292562,ECE 200,042,103627,Siegel; Paul H.,9999,0,9999,0
1668017292562,ECE 200,043,103628,Sievenpiper; Daniel F.,9999,0,9999,0
1668017292562,ECE 200,044,103629,Sworder; David D.,9999,0,9999,0
1668017292562,ECE 200,045,103630,Taur; Yuan,9999,0,9999,0
1668017292562,ECE 200,046,103631,Touri; Behrouz,9999,0,9999,0
1668017292562,ECE 200,047,103632,Trivedi; Mohan M.,9999,0,9999,0
1668017292562,ECE 200,048,103633,Vasconcelos; Nuno,9999,0,9999,0
1668017292562,ECE 200,049,103634,Wang; Xiaolong,9999,0,9999,0
1668017292562,ECE 200,050,103635,Xie; Pengtao,9999,0,9999,0
1668017292562,ECE 200,051,103636,Yip; Michael,9999,0,9999,0
1668017292562,ECE 200,052,103637,Zeger; Kenneth A.,999,0,999,0
1668017292562,ECE 200,053,103638,Zhang; Xinyu,9999,0,9999,0
1668017292562,ECE 200,054,103639,Turakhia; Yatish Girish,9999,0,9999,0
1668017292562,ECE 200,055,103640,Kang; Mingu,9999,0,9999,0
1668017292562,ECE 200,056,103641,Shi; Yuanyuan,9999,0,9999,0
1668017292562,ECE 200,057,103642,Wang; Edward Jay,9999,0,9999,0
1668017292562,ECE 200,058,103643,Zheng; Yang,9999,0,9999,0
1668017293001,ECE 202,A00,103644,Kuzum; Duygu,0,0,0,0
1668017293424,ECE 212BN,A00,103646,Ng; Tse Nga,0,0,0,0
1668017293847,ECE 221,A00,111493,Staff,0,0,0,0
1668017294281,ECE 222B,A00,103647,Lomakin; Vitaliy,0,0,0,0
1668017294704,ECE 230B,A00,103648,Taur; Yuan,0,0,0,0
1668017295134,ECE 238B,A00,103649,Garay; Javier,0,0,0,0
1668017295556,ECE 240B,A00,112900,Fainman; Yeshaiahu,0,0,0,0
1668017295994,ECE 247A,A00,103650,Jokerst; Jesse Vincent,0,0,0,0
1668017296419,ECE 247B,A00,103651,Wang; Joseph,0,0,0,0
1668017296858,ECE 250,A00,103652,Siegel; Paul H.,0,0,0,0
1668017297286,ECE 251A,A00,103654,Rao; Bhaskar D.,0,0,0,0
1668017297721,ECE 257B,A00,103655,Bharadia; Dinesh,0,0,0,0
1668017298146,ECE 258A,A00,103656,Milstein; Laurence B.,0,0,0,0
1668017298571,ECE 260B,A00,103658,Kang; Mingu,0,0,0,0
1668017298996,ECE 264A,A00,103659,Galton; Ian A,0,0,0,0
1668017299421,ECE 265A,A00,103661,Gudem; Prasad S.S.,0,0,0,0
1668017299860,ECE 265D,A00,103662,Gudem; Prasad S.S.,0,0,0,0
1668017300285,ECE 268,A00,103663,Koushanfar; Farinaz,0,0,0,0
1668017300711,ECE 269,A01,103665,Pal; Piya,0,0,0,0
1668017301148,ECE 271B,A00,103666,Vasconcelos; Manuela,0,0,0,0
1668017301576,ECE 276A,A00,103667,Atanasov; Nikolay A.,0,0,0,0
1668017301998,ECE 277,A00,103668,An; Cheolhong,0,0,0,0
1668017302423,ECE 279,A00,117947,Hall; Drew A.,0,0,0,0
1668017303283,ECE 283,A00,103670,Hsueh; Tzu-Chien,0,0,0,0
1668017303706,ECE 284,A00,103671,Turakhia; Yatish Girish,0,0,0,0
1668017304157,ECE 285,A00,103672,Zheng; Yang,0,0,0,0
1668017304157,ECE 285,B00,103673,Sworder; David D.,0,0,0,0
1668017304590,ECE 287,A00,103676,Javidi; Tara,0,0,0,0
1668017305014,MATH 200B,A00,098023,Salehi Golsefidy; Alireza,14,0,15,1
1668017305448,MATH 202B,A00,098024,Rhoades; Brendon Patrick,11,0,15,4
1668017305891,MATH 203B,A00,098025,Oprea; Dragos N.,12,0,15,3
1668017306411,MATH 204B,A00,098026,Sorensen; Claus M,14,0,15,1
1668017306843,MATH 208,A00,098027,Izadi; Elham,7,0,10,3
1668017307273,MATH 209,A00,098028,Pollack; Aaron,10,0,10,0
1668017307714,MATH 211A,A00,112919,Rogalski; Daniel,9,0,10,1
1668017308140,MATH 211B,A00,112920,Seward; Brandon M.,9,0,10,1
1668017308562,MATH 218,A00,098029,Li; Bo,10,0,10,0
1668017308985,MATH 220B,A00,098030,Novak; Jonathan I,13,0,15,2
1668017309416,MATH 221A,A00,098031,Ebenfelt; Peter F,13,0,15,2
1668017309861,MATH 231B,A00,098032,Zlatos; Andrej,12,0,15,3
1668017310293,MATH 240B,A00,098033,Ni; Lei,10,0,15,5
1668017310723,MATH 243,A00,098034,Jekel; David Andrew,10,0,10,0
1668017311154,MATH 245A,A00,098035,Nie; Jiawang,0,0,15,16
1668017311575,MATH 248,A00,098036,Bejenaru; Ioan,10,0,10,0
1668017311999,MATH 250B,A00,098037,Spolaor; Luca,14,0,15,1
1668017312425,MATH 258,A00,098038,Ni; Lei,10,0,10,0
1668017312851,MATH 264B,A00,098041,Rhoades; Brendon Patrick,10,0,15,5
1668017313279,MATH 268,A00,098042,Buss; Samuel R,10,0,10,0
1668017313717,MATH 269,A00,098043,Rhoades; Brendon Patrick,10,0,10,0
1668017314145,MATH 270B,A00,098044,Li; Bo,11,0,15,4
1668017314578,MATH 272B,A00,098045,Holst; Michael J,13,0,15,2
1668017315007,MATH 273A,A00,098046,Tian; Xiaochuan,11,0,15,4
1668017315447,MATH 275,A01,098048,Tian; Xiaochuan,6,0,10,4
1668017315873,MATH 278A,A00,098049,Holst; Michael J,8,0,10,2
1668017316297,MATH 278B,A00,098050,Cloninger; Alexander,10,0,10,0
1668017316728,MATH 278C,A00,098051,Nie; Jiawang,8,0,10,2
1668017317154,MATH 280B,A00,098052,Zheng; Tianyi,11,0,15,4
1668017317697,MATH 281B,A00,098053,Bradic; Jelena,4,0,15,11
1668017318136,MATH 282B,A00,098054,Arias-Castro; Ery,2,0,15,13
1668017318572,MATH 285,A00,098055,Fitzsimmons; Patrick J,0,0,15,17
1668017319002,MATH 287B,A00,098056,Arias-Castro; Ery,5,0,15,10
1668017319430,MATH 288,A00,098057,Agarwal; Pooja,9,0,10,1
1668017319430,MATH 288,B00,098058,Zhang; Danna,9,0,10,1
1668017319430,MATH 288,C00,098059,Williams; Ruth J,10,0,10,0
1668017319855,MATH 290B,A00,098060,Roberts; Justin Deritter,14,0,15,1
1668017320310,MATH 292,A00,098061,Belmont; Eva Kinoshita,10,0,10,0
1668017320742,MATH 295,A00,098062,Suk; Andrew Hoon,48,0,50,2
1668017321179,MATH 296,A00,098063,Novak; Jonathan I,20,0,20,0
1668017321602,MATH 297,001,098064,Gamst; Anthony Collins,9997,0,9999,2
1668017827557,COGS 205,A00,101395,Chiba; Andrea,19,0,20,1
1668017827988,COGS 210B,001,101404,Greene; Deanna Jacquelyn,9998,0,9999,1
1668017827988,COGS 210B,002,101417,Xia; Haijun,9999,0,9999,0
1668017827988,COGS 210B,003,101422,Nitz; Douglas A.,9999,0,9999,0
1668017827988,COGS 210B,004,101423,Hollan; James D.,9998,0,9999,1
1668017827988,COGS 210B,005,101424,Deak; Gedeon O.,9999,0,9999,0
1668017827988,COGS 210B,006,101425,Rossano; Federico,9999,0,9999,0
1668017828415,COGS 211B,A00,101427,Coulson; Seana M,9997,0,9999,2
1668017828846,COGS 220,A00,101428,Hollan; James D.,0,0,25,25
1668017829272,COGS 229,A00,101429,Dow; Steven P,18,0,25,7
1668017829697,COGS 230,A00,101430,Klemmer; Scott R,13,0,17,4
1668017830133,COGS 234,A00,101431,Xia; Haijun,5,0,25,20
1668017830558,COGS 260,A00,101432,Kiyonaga; Anastasia,20,0,25,5
1668017830558,COGS 260,B00,101433,Kirsh; David Joel,16,0,25,9
1668017830990,CSE 202,A00,102371,Impagliazzo; Russell,0,0,0,0
1668017831417,CSE 203B,A01,102373,Cheng; Chung Kuan,0,0,0,0
1668017831840,CSE 208,A00,102374,Micciancio; Daniele,0,0,0,0
1668017832274,CSE 209A,A00,112895,Impagliazzo; Russell,0,0,15,15
1668017832794,CSE 209B,A00,108005,Bellare; Mihir,0,0,0,0
1668017833227,CSE 210,A00,113163,Coblenz; Michael J,0,0,0,0
1668017833657,CSE 219,A00,106111,Dow; Steven P,0,0,20,20
1668017834081,CSE 221,A00,102376,Voelker; Geoffrey M.,0,0,0,0
1668017834511,CSE 224,A01,102378,Porter; George M,0,0,0,0
1668017834956,CSE 229A,A00,102379,Savage; Stefan,0,0,0,0
1668017835381,CSE 229C,A00,102380,Munyaka; Imani N. S.,0,0,0,0
1668017835805,CSE 232B,A00,102382,Deutsch; Alin Bernard,0,0,0,0
1668017836229,CSE 234,A01,112904,Kumar; Arun Kumar,0,0,0,0
1668017836666,CSE 237A,A00,102383,Rosing; Tajana Simunic,0,0,0,0
1668017837088,CSE 239A,A00,102384,Deutsch; Alin Bernard,0,0,0,0
1668017837520,CSE 239B,A00,102385,Polikarpova; Nadezhda,0,0,0,0
1668017837948,CSE 240A,A00,102386,Pannuto; Patrick William,0,0,0,0
1668017838384,CSE 240B,A00,102387,Zhao; Jishen,0,0,0,0
1668017838819,CSE 241A,A00,106406,Kang; Mingu,0,0,0,0
1668017839249,CSE 249B,A00,102388,Kahng; Andrew Byun,0,0,8,8
1668017839681,CSE 251B,A01,102392,Cottrell; Garrison W,0,0,0,0
1668017839681,CSE 251B,A02,102393,Cottrell; Garrison W,0,0,0,0
1668017840119,CSE 252B,A00,102394,Ochoa; Benjamin Lawrence,0,0,0,0
1668017840546,CSE 257,A01,102396,Gao; Sicun,0,0,0,0
1668017840971,CSE 272,A00,102397,Li; Tzumao,0,0,0,0
1668017841394,CSE 274,A00,111323,Chern; Albert Ren-Haur,0,0,0,0
1668017841833,CSE 282,A00,102398,Pevzner; Pavel Arkadjevich,0,0,0,0
1668017842276,CSE 284,A00,114175,Gymrek; Melissa Ann,0,0,0,0
1668017842703,CSE 290,A00,102399,Chandraker; Manmohan Krishna,0,0,0,0
1668017842703,CSE 290,B00,102400,Vaccaro; Kristen Marie,0,0,25,25
1668017842703,CSE 290,C00,102414,Pannuto; Patrick William,0,0,25,25
1668017842703,CSE 290,D00,102427,Pevzner; Pavel Arkadjevich,0,0,0,0
1668017842703,CSE 290,E00,102429,Zhao; Jishen,0,0,0,0
1668017842703,CSE 290,F00,102436,Tullsen; Dean Michael,0,0,0,0
1668017842703,CSE 290,G00,102440,Christensen; Henrik I,0,0,20,20
1668017843129,CSE 291,A00,102443,Su; Hao,0,0,0,0
1668017843129,CSE 291,B00,102448,Polikarpova; Nadezhda,0,0,0,0
1668017843129,CSE 291,C00,102453,Vaccaro; Kristen Marie,0,0,0,0
1668017843129,CSE 291,D00,111343,Savage; Stefan,0,0,0,0
1668017843129,CSE 291,E00,116474,Claffy; Kimberly Claire,0,0,0,0
1668017843129,CSE 291,F00,116479,Pasquale; Joseph,0,0,0,0
1668017843571,CSE 293,001,119111,Bafna; Vineet,9999,0,9999,0
1668017843571,CSE 293,002,119118,Bellare; Mihir,9999,0,9999,0
1668017843571,CSE 293,003,119122,Berg-Kirkpatrick; Taylor D,9999,0,9999,0
1668017843571,CSE 293,004,119135,Christensen; Henrik I,9999,0,9999,0
1668017843571,CSE 293,005,119142,Cottrell; Garrison W,9999,0,9999,0
1668017843571,CSE 293,006,119146,Deutsch; Alin Bernard,9999,0,9999,0
1668017843571,CSE 293,007,119159,Esmaeilzadeh; Hadi,9999,0,9999,0
1668017843571,CSE 293,008,119166,Freund; Yoav,9999,0,9999,0
1668017843571,CSE 293,009,119170,Griswold; William G.,9999,0,9999,0
1668017843571,CSE 293,010,119183,Gymrek; Melissa Ann,9999,0,9999,0
1668017843571,CSE 293,011,119190,Heninger; Nadia A,9999,0,9999,0
1668017843571,CSE 293,012,119230,Impagliazzo; Russell,9999,0,9999,0
1668017843571,CSE 293,013,119232,Jhala; Ranjit,9999,0,9999,0
1668017843571,CSE 293,014,119233,Kahng; Andrew Byun,9999,0,9999,0
1668017843571,CSE 293,015,119298,Kane; Daniel Mertz,9999,0,9999,0
1668017843571,CSE 293,016,119299,Kriegman; David J,9999,0,9999,0
1668017843571,CSE 293,017,119300,Kumar; Arun Kumar,9999,0,9999,0
1668017843571,CSE 293,018,119301,Lerner; Sorin,9999,0,9999,0
1668017843571,CSE 293,019,119302,Lovett; Shachar,9999,0,9999,0
1668017843571,CSE 293,020,119303,McAuley; Julian John,9999,0,9999,0
1668017843571,CSE 293,021,119304,Micciancio; Daniele,9999,0,9999,0
1668017843571,CSE 293,022,119367,Orailoglu; Alex,9999,0,9999,0
1668017843571,CSE 293,023,119382,Paturi; Ramamohan,9999,0,9999,0
1668017843571,CSE 293,024,119404,Polikarpova; Nadezhda,9999,0,9999,0
1668017843571,CSE 293,025,119406,Politz; Joseph Gibbs,9999,0,9999,0
1668017843571,CSE 293,026,119411,Porter; George M,9999,0,9999,0
1668017843571,CSE 293,027,119414,Porter; Leonard Emerson,9999,0,9999,0
1668017843571,CSE 293,028,119416,Ramamoorthi; Ravi,9999,0,9999,0
1668017843571,CSE 293,029,119417,Sahoo; Debashis,9999,0,9999,0
1668017843571,CSE 293,030,119420,Saul; Lawrence,9999,0,9999,0
1668017843571,CSE 293,031,119421,Savage; Stefan,9999,0,9999,0
1668017843571,CSE 293,032,119425,Schulze; Jurgen P.,9999,0,9999,0
1668017843571,CSE 293,033,119426,Snoeren; Alex C.,9999,0,9999,0
1668017843571,CSE 293,034,119428,Shang; Jingbo,9999,0,9999,0
1668017843571,CSE 293,035,119430,Stefan; Deian,9999,0,9999,0
1668017843571,CSE 293,036,119431,Su; Hao,9999,0,9999,0
1668017843571,CSE 293,037,119433,Swanson; Steven James,9999,0,9999,0
1668017843571,CSE 293,038,119435,Tullsen; Dean Michael,9999,0,9999,0
1668017843571,CSE 293,039,119483,Voelker; Geoffrey M.,9999,0,9999,0
1668017843571,CSE 293,040,119537,Zhao; Jishen,9999,0,9999,0
1668017843571,CSE 293,041,119538,Zhou; Yuan-Yuan,9999,0,9999,0
1668017843571,CSE 293,042,119539,Gao; Sicun,9999,0,9999,0
1668017843571,CSE 293,043,119540,Weibel; Nadir,9999,0,9999,0
1668017843571,CSE 293,044,119541,Gupta; Rajesh K.,9999,0,9999,0
1668017843571,CSE 293,045,126410,Vaccaro; Kristen Marie,9999,0,9999,0
1668017843571,CSE 293,046,126411,Klemke; Richard,9999,0,9999,0
1668017843996,CSE 294,A00,102459,Voelker; Geoffrey M.,0,0,0,0
1668017843996,CSE 294,B00,111322,Orailoglu; Alex,0,0,0,0
1668017844444,DSE 201,A00,096914,Deutsch; Alin Bernard,30,0,30,0
1668017844869,DSE 210,A00,096915,Dasgupta; Sanjoy,30,0,30,0
1668017845294,DSE 260A,A00,096916,Altintas De Callaf; Ilkay,30,0,30,0
1668017845724,ECE 200,001,103586,Antipa; Nicholas A,9999,0,9999,0
1668017845724,ECE 200,002,103587,Atanasov; Nikolay A.,9999,0,9999,0
1668017845724,ECE 200,003,103588,Bharadia; Dinesh,9999,0,9999,0
1668017845724,ECE 200,004,103589,Cheng; Chung Kuan,9999,0,9999,0
1668017845724,ECE 200,005,103590,Cosman; Pamela C.,9999,0,9999,0
1668017845724,ECE 200,006,103591,Dayeh; Shadi Ahmad,9999,0,9999,0
1668017845724,ECE 200,007,103592,Fainman; Yeshaiahu,9999,0,9999,0
1668017845724,ECE 200,008,103593,Ford; Joseph Earl,9999,0,9999,0
1668017845724,ECE 200,009,103594,Franceschetti; Massimo,9999,0,9999,0
1668017845724,ECE 200,010,103595,Fullerton; Eric E,9999,0,9999,0
1668017845724,ECE 200,011,103596,Galton; Ian A,9999,0,9999,0
1668017845724,ECE 200,012,103597,Gilja; Vikash,9999,0,9999,0
1668017845724,ECE 200,013,103598,Hall; Drew A.,9999,0,9999,0
1668017845724,ECE 200,014,103599,Hsueh; Tzu-Chien,9999,0,9999,0
1668017845724,ECE 200,015,103600,Javidi; Tara,9999,0,9999,0
1668017845724,ECE 200,016,103601,Kahng; Andrew Byun,9999,0,9999,0
1668017845724,ECE 200,017,103602,Kim; Young-Han,9999,0,9999,0
1668017845724,ECE 200,018,103603,Koushanfar; Farinaz,9999,0,9999,0
1668017845724,ECE 200,019,103604,Kuzum; Duygu,9999,0,9999,0
1668017845724,ECE 200,020,103605,Le; Hanh-Phuc,9999,0,9999,0
1668017845724,ECE 200,021,103606,Lin; Bill,9999,0,9999,0
1668017845724,ECE 200,022,103607,Liu; Zhaowei,9998,0,9999,1
1668017845724,ECE 200,023,103608,Lo; Yu-Hwa,9999,0,9999,0
1668017845724,ECE 200,024,103609,Lomakin; Vitaliy,9999,0,9999,0
1668017845724,ECE 200,025,103610,Mercier; Patrick Philip,9999,0,9999,0
1668017845724,ECE 200,026,103611,Meyer; Florian,9999,0,9999,0
1668017845724,ECE 200,027,103612,Milstein; Laurence B.,9999,0,9999,0
1668017845724,ECE 200,028,103613,Mir Arabbaygi; Siavash,9999,0,9999,0
1668017845724,ECE 200,029,103614,Mookherjea; Shayan,9999,0,9999,0
1668017845724,ECE 200,030,103615,Morris; Karcher William,9999,0,9999,0
1668017845724,ECE 200,031,103616,Ng; Tse Nga,9999,0,9999,0
1668017845724,ECE 200,032,103617,Nguyen; Truong Quang,9999,0,9999,0
1668017845724,ECE 200,033,103618,Nomura; Kenji,9999,0,9999,0
1668017845724,ECE 200,034,103619,Orlitsky; Alon,9999,0,9999,0
1668017845724,ECE 200,035,103620,Pal; Piya,9999,0,9999,0
1668017845724,ECE 200,036,103621,Papen; George C.,9999,0,9999,0
1668017845724,ECE 200,037,103622,Radic; Stojan,9999,0,9999,0
1668017845724,ECE 200,038,103623,Rao; Bhaskar D.,9999,0,9999,0
1668017845724,ECE 200,039,103624,Rao; Ramesh R,9999,0,9999,0
1668017845724,ECE 200,040,103625,Rebeiz; Gabriel,9999,0,9999,0
1668017845724,ECE 200,041,103626,Sanford; John R,9999,0,9999,0
1668017845724,ECE 200,042,103627,Siegel; Paul H.,9999,0,9999,0
1668017845724,ECE 200,043,103628,Sievenpiper; Daniel F.,9999,0,9999,0
1668017845724,ECE 200,044,103629,Sworder; David D.,9999,0,9999,0
1668017845724,ECE 200,045,103630,Taur; Yuan,9999,0,9999,0
1668017845724,ECE 200,046,103631,Touri; Behrouz,9999,0,9999,0
1668017845724,ECE 200,047,103632,Trivedi; Mohan M.,9999,0,9999,0
1668017845724,ECE 200,048,103633,Vasconcelos; Nuno,9999,0,9999,0
1668017845724,ECE 200,049,103634,Wang; Xiaolong,9999,0,9999,0
1668017845724,ECE 200,050,103635,Xie; Pengtao,9999,0,9999,0
1668017845724,ECE 200,051,103636,Yip; Michael,9999,0,9999,0
1668017845724,ECE 200,052,103637,Zeger; Kenneth A.,999,0,999,0
1668017845724,ECE 200,053,103638,Zhang; Xinyu,9999,0,9999,0
1668017845724,ECE 200,054,103639,Turakhia; Yatish Girish,9999,0,9999,0
1668017845724,ECE 200,055,103640,Kang; Mingu,9999,0,9999,0
1668017845724,ECE 200,056,103641,Shi; Yuanyuan,9999,0,9999,0
1668017845724,ECE 200,057,103642,Wang; Edward Jay,9999,0,9999,0
1668017845724,ECE 200,058,103643,Zheng; Yang,9999,0,9999,0
1668017846151,ECE 202,A00,103644,Kuzum; Duygu,0,0,0,0
1668017846578,ECE 212BN,A00,103646,Ng; Tse Nga,0,0,0,0
1668017847003,ECE 221,A00,111493,Staff,0,0,0,0
1668017847430,ECE 222B,A00,103647,Lomakin; Vitaliy,0,0,0,0
1668017847857,ECE 230B,A00,103648,Taur; Yuan,0,0,0,0
1668017848284,ECE 238B,A00,103649,Garay; Javier,0,0,0,0
1668017848710,ECE 240B,A00,112900,Fainman; Yeshaiahu,0,0,0,0
1668017849135,ECE 247A,A00,103650,Jokerst; Jesse Vincent,0,0,0,0
1668017849574,ECE 247B,A00,103651,Wang; Joseph,0,0,0,0
1668017850022,ECE 250,A00,103652,Siegel; Paul H.,0,0,0,0
1668017850445,ECE 251A,A00,103654,Rao; Bhaskar D.,0,0,0,0
1668017850880,ECE 257B,A00,103655,Bharadia; Dinesh,0,0,0,0
1668017851307,ECE 258A,A00,103656,Milstein; Laurence B.,0,0,0,0
1668017851734,ECE 260B,A00,103658,Kang; Mingu,0,0,0,0
1668017852173,ECE 264A,A00,103659,Galton; Ian A,0,0,0,0
1668017852599,ECE 265A,A00,103661,Gudem; Prasad S.S.,0,0,0,0
1668017853042,ECE 265D,A00,103662,Gudem; Prasad S.S.,0,0,0,0
1668017853469,ECE 268,A00,103663,Koushanfar; Farinaz,0,0,0,0
1668017853894,ECE 269,A01,103665,Pal; Piya,0,0,0,0
1668017854317,ECE 271B,A00,103666,Vasconcelos; Manuela,0,0,0,0
1668017854742,ECE 276A,A00,103667,Atanasov; Nikolay A.,0,0,0,0
1668017855181,ECE 277,A00,103668,An; Cheolhong,0,0,0,0
1668017855604,ECE 279,A00,117947,Hall; Drew A.,0,0,0,0
1668017856461,ECE 283,A00,103670,Hsueh; Tzu-Chien,0,0,0,0
1668017856885,ECE 284,A00,103671,Turakhia; Yatish Girish,0,0,0,0
1668017857311,ECE 285,A00,103672,Zheng; Yang,0,0,0,0
1668017857311,ECE 285,B00,103673,Sworder; David D.,0,0,0,0
1668017857739,ECE 287,A00,103676,Javidi; Tara,0,0,0,0
1668017858164,MATH 200B,A00,098023,Salehi Golsefidy; Alireza,14,0,15,1
1668017858592,MATH 202B,A00,098024,Rhoades; Brendon Patrick,11,0,15,4
1668017859040,MATH 203B,A00,098025,Oprea; Dragos N.,12,0,15,3
1668017859461,MATH 204B,A00,098026,Sorensen; Claus M,14,0,15,1
1668017859890,MATH 208,A00,098027,Izadi; Elham,7,0,10,3
1668017860317,MATH 209,A00,098028,Pollack; Aaron,10,0,10,0
1668017860757,MATH 211A,A00,112919,Rogalski; Daniel,9,0,10,1
1668017861181,MATH 211B,A00,112920,Seward; Brandon M.,9,0,10,1
1668017861609,MATH 218,A00,098029,Li; Bo,10,0,10,0
1668017862036,MATH 220B,A00,098030,Novak; Jonathan I,13,0,15,2
1668017862466,MATH 221A,A00,098031,Ebenfelt; Peter F,13,0,15,2
1668017862892,MATH 231B,A00,098032,Zlatos; Andrej,12,0,15,3
1668017863315,MATH 240B,A00,098033,Ni; Lei,10,0,15,5
1668017863739,MATH 243,A00,098034,Jekel; David Andrew,10,0,10,0
1668017864168,MATH 245A,A00,098035,Nie; Jiawang,0,0,15,16
1668017864590,MATH 248,A00,098036,Bejenaru; Ioan,10,0,10,0
1668017865013,MATH 250B,A00,098037,Spolaor; Luca,14,0,15,1
1668017865437,MATH 258,A00,098038,Ni; Lei,10,0,10,0
1668017865861,MATH 264B,A00,098041,Rhoades; Brendon Patrick,10,0,15,5
1668017866295,MATH 268,A00,098042,Buss; Samuel R,10,0,10,0
1668017866721,MATH 269,A00,098043,Rhoades; Brendon Patrick,10,0,10,0
1668017867147,MATH 270B,A00,098044,Li; Bo,11,0,15,4
1668017867578,MATH 272B,A00,098045,Holst; Michael J,13,0,15,2
1668017868002,MATH 273A,A00,098046,Tian; Xiaochuan,11,0,15,4
1668017868427,MATH 275,A01,098048,Tian; Xiaochuan,6,0,10,4
1668017868851,MATH 278A,A00,098049,Holst; Michael J,8,0,10,2
1668017869272,MATH 278B,A00,098050,Cloninger; Alexander,10,0,10,0
1668017869695,MATH 278C,A00,098051,Nie; Jiawang,8,0,10,2
1668017870130,MATH 280B,A00,098052,Zheng; Tianyi,11,0,15,4
1668017870558,MATH 281B,A00,098053,Bradic; Jelena,4,0,15,11
1668017870988,MATH 282B,A00,098054,Arias-Castro; Ery,2,0,15,13
1668017871416,MATH 285,A00,098055,Fitzsimmons; Patrick J,0,0,15,17
1668017871840,MATH 287B,A00,098056,Arias-Castro; Ery,5,0,15,10
1668017872265,MATH 288,A00,098057,Agarwal; Pooja,9,0,10,1
1668017872265,MATH 288,B00,098058,Zhang; Danna,9,0,10,1
1668017872265,MATH 288,C00,098059,Williams; Ruth J,10,0,10,0
1668017872699,MATH 290B,A00,098060,Roberts; Justin Deritter,14,0,15,1
1668017873139,MATH 292,A00,098061,Belmont; Eva Kinoshita,10,0,10,0
1668017873576,MATH 295,A00,098062,Suk; Andrew Hoon,48,0,50,2
1668017874017,MATH 296,A00,098063,Novak; Jonathan I,20,0,20,0
1668017874441,MATH 297,001,098064,Gamst; Anthony Collins,9997,0,9999,2
1668018396086,COGS 205,A00,101395,Chiba; Andrea,19,0,20,1
1668018396516,COGS 210B,001,101404,Greene; Deanna Jacquelyn,9998,0,9999,1
1668018396516,COGS 210B,002,101417,Xia; Haijun,9999,0,9999,0
1668018396516,COGS 210B,003,101422,Nitz; Douglas A.,9999,0,9999,0
1668018396516,COGS 210B,004,101423,Hollan; James D.,9998,0,9999,1
1668018396516,COGS 210B,005,101424,Deak; Gedeon O.,9999,0,9999,0
1668018396516,COGS 210B,006,101425,Rossano; Federico,9999,0,9999,0
1668018396946,COGS 211B,A00,101427,Coulson; Seana M,9997,0,9999,2
1668018397371,COGS 220,A00,101428,Hollan; James D.,0,0,25,25
1668018397796,COGS 229,A00,101429,Dow; Steven P,18,0,25,7
1668018398221,COGS 230,A00,101430,Klemmer; Scott R,13,0,17,4
1668018398644,COGS 234,A00,101431,Xia; Haijun,5,0,25,20
1668018399074,COGS 260,A00,101432,Kiyonaga; Anastasia,20,0,25,5
1668018399074,COGS 260,B00,101433,Kirsh; David Joel,16,0,25,9
1668018399511,CSE 202,A00,102371,Impagliazzo; Russell,0,0,0,0
1668018399935,CSE 203B,A01,102373,Cheng; Chung Kuan,0,0,0,0
1668018400363,CSE 208,A00,102374,Micciancio; Daniele,0,0,0,0
1668018400792,CSE 209A,A00,112895,Impagliazzo; Russell,0,0,15,15
1668018401226,CSE 209B,A00,108005,Bellare; Mihir,0,0,0,0
1668018401652,CSE 210,A00,113163,Coblenz; Michael J,0,0,0,0
1668018402080,CSE 219,A00,106111,Dow; Steven P,0,0,20,20
1668018402515,CSE 221,A00,102376,Voelker; Geoffrey M.,0,0,0,0
1668018402939,CSE 224,A01,102378,Porter; George M,0,0,0,0
1668018403391,CSE 229A,A00,102379,Savage; Stefan,0,0,0,0
1668018403818,CSE 229C,A00,102380,Munyaka; Imani N. S.,0,0,0,0
1668018404243,CSE 232B,A00,102382,Deutsch; Alin Bernard,0,0,0,0
1668018404666,CSE 234,A01,112904,Kumar; Arun Kumar,0,0,0,0
1668018405089,CSE 237A,A00,102383,Rosing; Tajana Simunic,0,0,0,0
1668018405516,CSE 239A,A00,102384,Deutsch; Alin Bernard,0,0,0,0
1668018405948,CSE 239B,A00,102385,Polikarpova; Nadezhda,0,0,0,0
1668018406379,CSE 240A,A00,102386,Pannuto; Patrick William,0,0,0,0
1668018406821,CSE 240B,A00,102387,Zhao; Jishen,0,0,0,0
1668018407262,CSE 241A,A00,106406,Kang; Mingu,0,0,0,0
1668018407695,CSE 249B,A00,102388,Kahng; Andrew Byun,0,0,8,8
1668018408125,CSE 251B,A01,102392,Cottrell; Garrison W,0,0,0,0
1668018408125,CSE 251B,A02,102393,Cottrell; Garrison W,0,0,0,0
1668018408554,CSE 252B,A00,102394,Ochoa; Benjamin Lawrence,0,0,0,0
1668018408979,CSE 257,A01,102396,Gao; Sicun,0,0,0,0
1668018409410,CSE 272,A00,102397,Li; Tzumao,0,0,0,0
1668018409834,CSE 274,A00,111323,Chern; Albert Ren-Haur,0,0,0,0
1668018410266,CSE 282,A00,102398,Pevzner; Pavel Arkadjevich,0,0,0,0
1668018410703,CSE 284,A00,114175,Gymrek; Melissa Ann,0,0,0,0
1668018411129,CSE 290,A00,102399,Chandraker; Manmohan Krishna,0,0,0,0
1668018411129,CSE 290,B00,102400,Vaccaro; Kristen Marie,0,0,25,25
1668018411129,CSE 290,C00,102414,Pannuto; Patrick William,0,0,25,25
1668018411129,CSE 290,D00,102427,Pevzner; Pavel Arkadjevich,0,0,0,0
1668018411129,CSE 290,E00,102429,Zhao; Jishen,0,0,0,0
1668018411129,CSE 290,F00,102436,Tullsen; Dean Michael,0,0,0,0
1668018411129,CSE 290,G00,102440,Christensen; Henrik I,0,0,20,20
1668018411558,CSE 291,A00,102443,Su; Hao,0,0,0,0
1668018411558,CSE 291,B00,102448,Polikarpova; Nadezhda,0,0,0,0
1668018411558,CSE 291,C00,102453,Vaccaro; Kristen Marie,0,0,0,0
1668018411558,CSE 291,D00,111343,Savage; Stefan,0,0,0,0
1668018411558,CSE 291,E00,116474,Claffy; Kimberly Claire,0,0,0,0
1668018411558,CSE 291,F00,116479,Pasquale; Joseph,0,0,0,0
1668018411994,CSE 293,001,119111,Bafna; Vineet,9999,0,9999,0
1668018411994,CSE 293,002,119118,Bellare; Mihir,9999,0,9999,0
1668018411994,CSE 293,003,119122,Berg-Kirkpatrick; Taylor D,9999,0,9999,0
1668018411994,CSE 293,004,119135,Christensen; Henrik I,9999,0,9999,0
1668018411994,CSE 293,005,119142,Cottrell; Garrison W,9999,0,9999,0
1668018411994,CSE 293,006,119146,Deutsch; Alin Bernard,9999,0,9999,0
1668018411994,CSE 293,007,119159,Esmaeilzadeh; Hadi,9999,0,9999,0
1668018411994,CSE 293,008,119166,Freund; Yoav,9999,0,9999,0
1668018411994,CSE 293,009,119170,Griswold; William G.,9999,0,9999,0
1668018411994,CSE 293,010,119183,Gymrek; Melissa Ann,9999,0,9999,0
1668018411994,CSE 293,011,119190,Heninger; Nadia A,9999,0,9999,0
1668018411994,CSE 293,012,119230,Impagliazzo; Russell,9999,0,9999,0
1668018411994,CSE 293,013,119232,Jhala; Ranjit,9999,0,9999,0
1668018411994,CSE 293,014,119233,Kahng; Andrew Byun,9999,0,9999,0
1668018411994,CSE 293,015,119298,Kane; Daniel Mertz,9999,0,9999,0
1668018411994,CSE 293,016,119299,Kriegman; David J,9999,0,9999,0
1668018411994,CSE 293,017,119300,Kumar; Arun Kumar,9999,0,9999,0
1668018411994,CSE 293,018,119301,Lerner; Sorin,9999,0,9999,0
1668018411994,CSE 293,019,119302,Lovett; Shachar,9999,0,9999,0
1668018411994,CSE 293,020,119303,McAuley; Julian John,9999,0,9999,0
1668018411994,CSE 293,021,119304,Micciancio; Daniele,9999,0,9999,0
1668018411994,CSE 293,022,119367,Orailoglu; Alex,9999,0,9999,0
1668018411994,CSE 293,023,119382,Paturi; Ramamohan,9999,0,9999,0
1668018411994,CSE 293,024,119404,Polikarpova; Nadezhda,9999,0,9999,0
1668018411994,CSE 293,025,119406,Politz; Joseph Gibbs,9999,0,9999,0
1668018411994,CSE 293,026,119411,Porter; George M,9999,0,9999,0
1668018411994,CSE 293,027,119414,Porter; Leonard Emerson,9999,0,9999,0
1668018411994,CSE 293,028,119416,Ramamoorthi; Ravi,9999,0,9999,0
1668018411994,CSE 293,029,119417,Sahoo; Debashis,9999,0,9999,0
1668018411994,CSE 293,030,119420,Saul; Lawrence,9999,0,9999,0
1668018411994,CSE 293,031,119421,Savage; Stefan,9999,0,9999,0
1668018411994,CSE 293,032,119425,Schulze; Jurgen P.,9999,0,9999,0
1668018411994,CSE 293,033,119426,Snoeren; Alex C.,9999,0,9999,0
1668018411994,CSE 293,034,119428,Shang; Jingbo,9999,0,9999,0
1668018411994,CSE 293,035,119430,Stefan; Deian,9999,0,9999,0
1668018411994,CSE 293,036,119431,Su; Hao,9999,0,9999,0
1668018411994,CSE 293,037,119433,Swanson; Steven James,9999,0,9999,0
1668018411994,CSE 293,038,119435,Tullsen; Dean Michael,9999,0,9999,0
1668018411994,CSE 293,039,119483,Voelker; Geoffrey M.,9999,0,9999,0
1668018411994,CSE 293,040,119537,Zhao; Jishen,9999,0,9999,0
1668018411994,CSE 293,041,119538,Zhou; Yuan-Yuan,9999,0,9999,0
1668018411994,CSE 293,042,119539,Gao; Sicun,9999,0,9999,0
1668018411994,CSE 293,043,119540,Weibel; Nadir,9999,0,9999,0
1668018411994,CSE 293,044,119541,Gupta; Rajesh K.,9999,0,9999,0
1668018411994,CSE 293,045,126410,Vaccaro; Kristen Marie,9999,0,9999,0
1668018411994,CSE 293,046,126411,Klemke; Richard,9999,0,9999,0
1668018412421,CSE 294,A00,102459,Voelker; Geoffrey M.,0,0,0,0
1668018412421,CSE 294,B00,111322,Orailoglu; Alex,0,0,0,0
1668018412844,DSE 201,A00,096914,Deutsch; Alin Bernard,30,0,30,0
1668018413283,DSE 210,A00,096915,Dasgupta; Sanjoy,30,0,30,0
1668018413720,DSE 260A,A00,096916,Altintas De Callaf; Ilkay,30,0,30,0
1668018414157,ECE 200,001,103586,Antipa; Nicholas A,9999,0,9999,0
1668018414157,ECE 200,002,103587,Atanasov; Nikolay A.,9999,0,9999,0
1668018414157,ECE 200,003,103588,Bharadia; Dinesh,9999,0,9999,0
1668018414157,ECE 200,004,103589,Cheng; Chung Kuan,9999,0,9999,0
1668018414157,ECE 200,005,103590,Cosman; Pamela C.,9999,0,9999,0
1668018414157,ECE 200,006,103591,Dayeh; Shadi Ahmad,9999,0,9999,0
1668018414157,ECE 200,007,103592,Fainman; Yeshaiahu,9999,0,9999,0
1668018414157,ECE 200,008,103593,Ford; Joseph Earl,9999,0,9999,0
1668018414157,ECE 200,009,103594,Franceschetti; Massimo,9999,0,9999,0
1668018414157,ECE 200,010,103595,Fullerton; Eric E,9999,0,9999,0
1668018414157,ECE 200,011,103596,Galton; Ian A,9999,0,9999,0
1668018414157,ECE 200,012,103597,Gilja; Vikash,9999,0,9999,0
1668018414157,ECE 200,013,103598,Hall; Drew A.,9999,0,9999,0
1668018414157,ECE 200,014,103599,Hsueh; Tzu-Chien,9999,0,9999,0
1668018414157,ECE 200,015,103600,Javidi; Tara,9999,0,9999,0
1668018414157,ECE 200,016,103601,Kahng; Andrew Byun,9999,0,9999,0
1668018414157,ECE 200,017,103602,Kim; Young-Han,9999,0,9999,0
1668018414157,ECE 200,018,103603,Koushanfar; Farinaz,9999,0,9999,0
1668018414157,ECE 200,019,103604,Kuzum; Duygu,9999,0,9999,0
1668018414157,ECE 200,020,103605,Le; Hanh-Phuc,9999,0,9999,0
1668018414157,ECE 200,021,103606,Lin; Bill,9999,0,9999,0
1668018414157,ECE 200,022,103607,Liu; Zhaowei,9998,0,9999,1
1668018414157,ECE 200,023,103608,Lo; Yu-Hwa,9999,0,9999,0
1668018414157,ECE 200,024,103609,Lomakin; Vitaliy,9999,0,9999,0
1668018414157,ECE 200,025,103610,Mercier; Patrick Philip,9999,0,9999,0
1668018414157,ECE 200,026,103611,Meyer; Florian,9999,0,9999,0
1668018414157,ECE 200,027,103612,Milstein; Laurence B.,9999,0,9999,0
1668018414157,ECE 200,028,103613,Mir Arabbaygi; Siavash,9999,0,9999,0
1668018414157,ECE 200,029,103614,Mookherjea; Shayan,9999,0,9999,0
1668018414157,ECE 200,030,103615,Morris; Karcher William,9999,0,9999,0
1668018414157,ECE 200,031,103616,Ng; Tse Nga,9999,0,9999,0
1668018414157,ECE 200,032,103617,Nguyen; Truong Quang,9999,0,9999,0
1668018414157,ECE 200,033,103618,Nomura; Kenji,9999,0,9999,0
1668018414157,ECE 200,034,103619,Orlitsky; Alon,9999,0,9999,0
1668018414157,ECE 200,035,103620,Pal; Piya,9999,0,9999,0
1668018414157,ECE 200,036,103621,Papen; George C.,9999,0,9999,0
1668018414157,ECE 200,037,103622,Radic; Stojan,9999,0,9999,0
1668018414157,ECE 200,038,103623,Rao; Bhaskar D.,9999,0,9999,0
1668018414157,ECE 200,039,103624,Rao; Ramesh R,9999,0,9999,0
1668018414157,ECE 200,040,103625,Rebeiz; Gabriel,9999,0,9999,0
1668018414157,ECE 200,041,103626,Sanford; John R,9999,0,9999,0
1668018414157,ECE 200,042,103627,Siegel; Paul H.,9999,0,9999,0
1668018414157,ECE 200,043,103628,Sievenpiper; Daniel F.,9999,0,9999,0
1668018414157,ECE 200,044,103629,Sworder; David D.,9999,0,9999,0
1668018414157,ECE 200,045,103630,Taur; Yuan,9999,0,9999,0
1668018414157,ECE 200,046,103631,Touri; Behrouz,9999,0,9999,0
1668018414157,ECE 200,047,103632,Trivedi; Mohan M.,9999,0,9999,0
1668018414157,ECE 200,048,103633,Vasconcelos; Nuno,9999,0,9999,0
1668018414157,ECE 200,049,103634,Wang; Xiaolong,9999,0,9999,0
1668018414157,ECE 200,050,103635,Xie; Pengtao,9999,0,9999,0
1668018414157,ECE 200,051,103636,Yip; Michael,9999,0,9999,0
1668018414157,ECE 200,052,103637,Zeger; Kenneth A.,999,0,999,0
1668018414157,ECE 200,053,103638,Zhang; Xinyu,9999,0,9999,0
1668018414157,ECE 200,054,103639,Turakhia; Yatish Girish,9999,0,9999,0
1668018414157,ECE 200,055,103640,Kang; Mingu,9999,0,9999,0
1668018414157,ECE 200,056,103641,Shi; Yuanyuan,9999,0,9999,0
1668018414157,ECE 200,057,103642,Wang; Edward Jay,9999,0,9999,0
1668018414157,ECE 200,058,103643,Zheng; Yang,9999,0,9999,0
1668018414587,ECE 202,A00,103644,Kuzum; Duygu,0,0,0,0
1668018415012,ECE 212BN,A00,103646,Ng; Tse Nga,0,0,0,0
1668018415438,ECE 221,A00,111493,Staff,0,0,0,0
1668018415859,ECE 222B,A00,103647,Lomakin; Vitaliy,0,0,0,0
1668018416292,ECE 230B,A00,103648,Taur; Yuan,0,0,0,0
1668018416720,ECE 238B,A00,103649,Garay; Javier,0,0,0,0
1668018417159,ECE 240B,A00,112900,Fainman; Yeshaiahu,0,0,0,0
1668018417581,ECE 247A,A00,103650,Jokerst; Jesse Vincent,0,0,0,0
1668018418104,ECE 247B,A00,103651,Wang; Joseph,0,0,0,0
1668018418541,ECE 250,A00,103652,Siegel; Paul H.,0,0,0,0
1668018418980,ECE 251A,A00,103654,Rao; Bhaskar D.,0,0,0,0
1668018419423,ECE 257B,A00,103655,Bharadia; Dinesh,0,0,0,0
1668018419855,ECE 258A,A00,103656,Milstein; Laurence B.,0,0,0,0
1668018420280,ECE 260B,A00,103658,Kang; Mingu,0,0,0,0
1668018420711,ECE 264A,A00,103659,Galton; Ian A,0,0,0,0
1668018421137,ECE 265A,A00,103661,Gudem; Prasad S.S.,0,0,0,0
1668018421561,ECE 265D,A00,103662,Gudem; Prasad S.S.,0,0,0,0
1668018421988,ECE 268,A00,103663,Koushanfar; Farinaz,0,0,0,0
1668018422417,ECE 269,A01,103665,Pal; Piya,0,0,0,0
1668018422854,ECE 271B,A00,103666,Vasconcelos; Manuela,0,0,0,0
1668018423278,ECE 276A,A00,103667,Atanasov; Nikolay A.,0,0,0,0
1668018423704,ECE 277,A00,103668,An; Cheolhong,0,0,0,0
1668018424129,ECE 279,A00,117947,Hall; Drew A.,0,0,0,0
1668018424986,ECE 283,A00,103670,Hsueh; Tzu-Chien,0,0,0,0
1668018425430,ECE 284,A00,103671,Turakhia; Yatish Girish,0,0,0,0
1668018425863,ECE 285,A00,103672,Zheng; Yang,0,0,0,0
1668018425863,ECE 285,B00,103673,Sworder; David D.,0,0,0,0
1668018426307,ECE 287,A00,103676,Javidi; Tara,0,0,0,0
1668018426750,MATH 200B,A00,098023,Salehi Golsefidy; Alireza,14,0,15,1
1668018427175,MATH 202B,A00,098024,Rhoades; Brendon Patrick,11,0,15,4
1668018427613,MATH 203B,A00,098025,Oprea; Dragos N.,12,0,15,3
1668018428036,MATH 204B,A00,098026,Sorensen; Claus M,14,0,15,1
1668018428468,MATH 208,A00,098027,Izadi; Elham,7,0,10,3
1668018428905,MATH 209,A00,098028,Pollack; Aaron,10,0,10,0
1668018429336,MATH 211A,A00,112919,Rogalski; Daniel,9,0,10,1
1668018429758,MATH 211B,A00,112920,Seward; Brandon M.,9,0,10,1
1668018430197,MATH 218,A00,098029,Li; Bo,10,0,10,0
1668018430627,MATH 220B,A00,098030,Novak; Jonathan I,13,0,15,2
1668018431057,MATH 221A,A00,098031,Ebenfelt; Peter F,13,0,15,2
1668018431481,MATH 231B,A00,098032,Zlatos; Andrej,12,0,15,3
1668018431907,MATH 240B,A00,098033,Ni; Lei,10,0,15,5
1668018432332,MATH 243,A00,098034,Jekel; David Andrew,10,0,10,0
1668018432781,MATH 245A,A00,098035,Nie; Jiawang,0,0,15,16
1668018433214,MATH 248,A00,098036,Bejenaru; Ioan,10,0,10,0
1668018433644,MATH 250B,A00,098037,Spolaor; Luca,14,0,15,1
1668018434072,MATH 258,A00,098038,Ni; Lei,10,0,10,0
1668018434499,MATH 264B,A00,098041,Rhoades; Brendon Patrick,10,0,15,5
1668018434925,MATH 268,A00,098042,Buss; Samuel R,10,0,10,0
1668018435348,MATH 269,A00,098043,Rhoades; Brendon Patrick,10,0,10,0
1668018435770,MATH 270B,A00,098044,Li; Bo,11,0,15,4
1668018436192,MATH 272B,A00,098045,Holst; Michael J,13,0,15,2
1668018436620,MATH 273A,A00,098046,Tian; Xiaochuan,11,0,15,4
1668018437055,MATH 275,A01,098048,Tian; Xiaochuan,6,0,10,4
1668018437475,MATH 278A,A00,098049,Holst; Michael J,8,0,10,2
1668018437904,MATH 278B,A00,098050,Cloninger; Alexander,10,0,10,0
1668018438337,MATH 278C,A00,098051,Nie; Jiawang,8,0,10,2
1668018438761,MATH 280B,A00,098052,Zheng; Tianyi,11,0,15,4
1668018439193,MATH 281B,A00,098053,Bradic; Jelena,4,0,15,11
1668018439626,MATH 282B,A00,098054,Arias-Castro; Ery,2,0,15,13
1668018440051,MATH 285,A00,098055,Fitzsimmons; Patrick J,0,0,15,17
1668018440478,MATH 287B,A00,098056,Arias-Castro; Ery,5,0,15,10
1668018440911,MATH 288,A00,098057,Agarwal; Pooja,9,0,10,1
1668018440911,MATH 288,B00,098058,Zhang; Danna,9,0,10,1
1668018440911,MATH 288,C00,098059,Williams; Ruth J,10,0,10,0
1668018441337,MATH 290B,A00,098060,Roberts; Justin Deritter,14,0,15,1
1668018441759,MATH 292,A00,098061,Belmont; Eva Kinoshita,10,0,10,0
1668018442184,MATH 295,A00,098062,Suk; Andrew Hoon,48,0,50,2
1668018442619,MATH 296,A00,098063,Novak; Jonathan I,20,0,20,0
1668018443047,MATH 297,001,098064,Gamst; Anthony Collins,9997,0,9999,2
1668018950042,COGS 205,A00,101395,Chiba; Andrea,19,0,20,1
1668018950479,COGS 210B,001,101404,Greene; Deanna Jacquelyn,9998,0,9999,1
1668018950479,COGS 210B,002,101417,Xia; Haijun,9999,0,9999,0
1668018950479,COGS 210B,003,101422,Nitz; Douglas A.,9999,0,9999,0
1668018950479,COGS 210B,004,101423,Hollan; James D.,9998,0,9999,1
1668018950479,COGS 210B,005,101424,Deak; Gedeon O.,9999,0,9999,0
1668018950479,COGS 210B,006,101425,Rossano; Federico,9999,0,9999,0
1668018950906,COGS 211B,A00,101427,Coulson; Seana M,9997,0,9999,2
1668018951335,COGS 220,A00,101428,Hollan; James D.,0,0,25,25
1668018951757,COGS 229,A00,101429,Dow; Steven P,18,0,25,7
1668018952180,COGS 230,A00,101430,Klemmer; Scott R,13,0,17,4
1668018952604,COGS 234,A00,101431,Xia; Haijun,5,0,25,20
1668018953031,COGS 260,A00,101432,Kiyonaga; Anastasia,20,0,25,5
1668018953031,COGS 260,B00,101433,Kirsh; David Joel,16,0,25,9
1668018953467,CSE 202,A00,102371,Impagliazzo; Russell,0,0,0,0
1668018953894,CSE 203B,A01,102373,Cheng; Chung Kuan,0,0,0,0
1668018954339,CSE 208,A00,102374,Micciancio; Daniele,0,0,0,0
1668018954761,CSE 209A,A00,112895,Impagliazzo; Russell,0,0,15,15
1668018955211,CSE 209B,A00,108005,Bellare; Mihir,0,0,0,0
1668018955648,CSE 210,A00,113163,Coblenz; Michael J,0,0,0,0
1668018956075,CSE 219,A00,106111,Dow; Steven P,0,0,20,20
1668018956498,CSE 221,A00,102376,Voelker; Geoffrey M.,0,0,0,0
1668018956921,CSE 224,A01,102378,Porter; George M,0,0,0,0
1668018957355,CSE 229A,A00,102379,Savage; Stefan,0,0,0,0
1668018957787,CSE 229C,A00,102380,Munyaka; Imani N. S.,0,0,0,0
1668018958209,CSE 232B,A00,102382,Deutsch; Alin Bernard,0,0,0,0
1668018958645,CSE 234,A01,112904,Kumar; Arun Kumar,0,0,0,0
1668018959077,CSE 237A,A00,102383,Rosing; Tajana Simunic,0,0,0,0
1668018959501,CSE 239A,A00,102384,Deutsch; Alin Bernard,0,0,0,0
1668018959924,CSE 239B,A00,102385,Polikarpova; Nadezhda,0,0,0,0
1668018960359,CSE 240A,A00,102386,Pannuto; Patrick William,0,0,0,0
1668018960790,CSE 240B,A00,102387,Zhao; Jishen,0,0,0,0
1668018961213,CSE 241A,A00,106406,Kang; Mingu,0,0,0,0
1668018961652,CSE 249B,A00,102388,Kahng; Andrew Byun,0,0,8,8
1668018962081,CSE 251B,A01,102392,Cottrell; Garrison W,0,0,0,0
1668018962081,CSE 251B,A02,102393,Cottrell; Garrison W,0,0,0,0
1668018962508,CSE 252B,A00,102394,Ochoa; Benjamin Lawrence,0,0,0,0
1668018962935,CSE 257,A01,102396,Gao; Sicun,0,0,0,0
1668018963363,CSE 272,A00,102397,Li; Tzumao,0,0,0,0
1668018963796,CSE 274,A00,111323,Chern; Albert Ren-Haur,0,0,0,0
1668018964228,CSE 282,A00,102398,Pevzner; Pavel Arkadjevich,0,0,0,0
1668018964654,CSE 284,A00,114175,Gymrek; Melissa Ann,0,0,0,0
1668018965086,CSE 290,A00,102399,Chandraker; Manmohan Krishna,0,0,0,0
1668018965086,CSE 290,B00,102400,Vaccaro; Kristen Marie,0,0,25,25
1668018965086,CSE 290,C00,102414,Pannuto; Patrick William,0,0,25,25
1668018965086,CSE 290,D00,102427,Pevzner; Pavel Arkadjevich,0,0,0,0
1668018965086,CSE 290,E00,102429,Zhao; Jishen,0,0,0,0
1668018965086,CSE 290,F00,102436,Tullsen; Dean Michael,0,0,0,0
1668018965086,CSE 290,G00,102440,Christensen; Henrik I,0,0,20,20
1668018965518,CSE 291,A00,102443,Su; Hao,0,0,0,0
1668018965518,CSE 291,B00,102448,Polikarpova; Nadezhda,0,0,0,0
1668018965518,CSE 291,C00,102453,Vaccaro; Kristen Marie,0,0,0,0
1668018965518,CSE 291,D00,111343,Savage; Stefan,0,0,0,0
1668018965518,CSE 291,E00,116474,Claffy; Kimberly Claire,0,0,0,0
1668018965518,CSE 291,F00,116479,Pasquale; Joseph,0,0,0,0
1668018965947,CSE 293,001,119111,Bafna; Vineet,9999,0,9999,0
1668018965947,CSE 293,002,119118,Bellare; Mihir,9999,0,9999,0
1668018965947,CSE 293,003,119122,Berg-Kirkpatrick; Taylor D,9999,0,9999,0
1668018965947,CSE 293,004,119135,Christensen; Henrik I,9999,0,9999,0
1668018965947,CSE 293,005,119142,Cottrell; Garrison W,9999,0,9999,0
1668018965947,CSE 293,006,119146,Deutsch; Alin Bernard,9999,0,9999,0
1668018965947,CSE 293,007,119159,Esmaeilzadeh; Hadi,9999,0,9999,0
1668018965947,CSE 293,008,119166,Freund; Yoav,9999,0,9999,0
1668018965947,CSE 293,009,119170,Griswold; William G.,9999,0,9999,0
1668018965947,CSE 293,010,119183,Gymrek; Melissa Ann,9999,0,9999,0
1668018965947,CSE 293,011,119190,Heninger; Nadia A,9999,0,9999,0
1668018965947,CSE 293,012,119230,Impagliazzo; Russell,9999,0,9999,0
1668018965947,CSE 293,013,119232,Jhala; Ranjit,9999,0,9999,0
1668018965947,CSE 293,014,119233,Kahng; Andrew Byun,9999,0,9999,0
1668018965947,CSE 293,015,119298,Kane; Daniel Mertz,9999,0,9999,0
1668018965947,CSE 293,016,119299,Kriegman; David J,9999,0,9999,0
1668018965947,CSE 293,017,119300,Kumar; Arun Kumar,9999,0,9999,0
1668018965947,CSE 293,018,119301,Lerner; Sorin,9999,0,9999,0
1668018965947,CSE 293,019,119302,Lovett; Shachar,9999,0,9999,0
1668018965947,CSE 293,020,119303,McAuley; Julian John,9999,0,9999,0
1668018965947,CSE 293,021,119304,Micciancio; Daniele,9999,0,9999,0
1668018965947,CSE 293,022,119367,Orailoglu; Alex,9999,0,9999,0
1668018965947,CSE 293,023,119382,Paturi; Ramamohan,9999,0,9999,0
1668018965947,CSE 293,024,119404,Polikarpova; Nadezhda,9999,0,9999,0
1668018965947,CSE 293,025,119406,Politz; Joseph Gibbs,9999,0,9999,0
1668018965947,CSE 293,026,119411,Porter; George M,9999,0,9999,0
1668018965947,CSE 293,027,119414,Porter; Leonard Emerson,9999,0,9999,0
1668018965947,CSE 293,028,119416,Ramamoorthi; Ravi,9999,0,9999,0
1668018965947,CSE 293,029,119417,Sahoo; Debashis,9999,0,9999,0
1668018965947,CSE 293,030,119420,Saul; Lawrence,9999,0,9999,0
1668018965947,CSE 293,031,119421,Savage; Stefan,9999,0,9999,0
1668018965947,CSE 293,032,119425,Schulze; Jurgen P.,9999,0,9999,0
1668018965947,CSE 293,033,119426,Snoeren; Alex C.,9999,0,9999,0
1668018965947,CSE 293,034,119428,Shang; Jingbo,9999,0,9999,0
1668018965947,CSE 293,035,119430,Stefan; Deian,9999,0,9999,0
1668018965947,CSE 293,036,119431,Su; Hao,9999,0,9999,0
1668018965947,CSE 293,037,119433,Swanson; Steven James,9999,0,9999,0
1668018965947,CSE 293,038,119435,Tullsen; Dean Michael,9999,0,9999,0
1668018965947,CSE 293,039,119483,Voelker; Geoffrey M.,9999,0,9999,0
1668018965947,CSE 293,040,119537,Zhao; Jishen,9999,0,9999,0
1668018965947,CSE 293,041,119538,Zhou; Yuan-Yuan,9999,0,9999,0
1668018965947,CSE 293,042,119539,Gao; Sicun,9999,0,9999,0
1668018965947,CSE 293,043,119540,Weibel; Nadir,9999,0,9999,0
1668018965947,CSE 293,044,119541,Gupta; Rajesh K.,9999,0,9999,0
1668018965947,CSE 293,045,126410,Vaccaro; Kristen Marie,9999,0,9999,0
1668018965947,CSE 293,046,126411,Klemke; Richard,9999,0,9999,0
1668018966377,CSE 294,A00,102459,Voelker; Geoffrey M.,0,0,0,0
1668018966377,CSE 294,B00,111322,Orailoglu; Alex,0,0,0,0
1668018966816,DSE 201,A00,096914,Deutsch; Alin Bernard,30,0,30,0
1668018967252,DSE 210,A00,096915,Dasgupta; Sanjoy,30,0,30,0
1668018967681,DSE 260A,A00,096916,Altintas De Callaf; Ilkay,30,0,30,0
1668018968148,ECE 200,001,103586,Antipa; Nicholas A,9999,0,9999,0
1668018968148,ECE 200,002,103587,Atanasov; Nikolay A.,9999,0,9999,0
1668018968148,ECE 200,003,103588,Bharadia; Dinesh,9999,0,9999,0
1668018968148,ECE 200,004,103589,Cheng; Chung Kuan,9999,0,9999,0
1668018968148,ECE 200,005,103590,Cosman; Pamela C.,9999,0,9999,0
1668018968148,ECE 200,006,103591,Dayeh; Shadi Ahmad,9999,0,9999,0
1668018968148,ECE 200,007,103592,Fainman; Yeshaiahu,9999,0,9999,0
1668018968148,ECE 200,008,103593,Ford; Joseph Earl,9999,0,9999,0
1668018968148,ECE 200,009,103594,Franceschetti; Massimo,9999,0,9999,0
1668018968148,ECE 200,010,103595,Fullerton; Eric E,9999,0,9999,0
1668018968148,ECE 200,011,103596,Galton; Ian A,9999,0,9999,0
1668018968148,ECE 200,012,103597,Gilja; Vikash,9999,0,9999,0
1668018968148,ECE 200,013,103598,Hall; Drew A.,9999,0,9999,0
1668018968148,ECE 200,014,103599,Hsueh; Tzu-Chien,9999,0,9999,0
1668018968148,ECE 200,015,103600,Javidi; Tara,9999,0,9999,0
1668018968148,ECE 200,016,103601,Kahng; Andrew Byun,9999,0,9999,0
1668018968148,ECE 200,017,103602,Kim; Young-Han,9999,0,9999,0
1668018968148,ECE 200,018,103603,Koushanfar; Farinaz,9999,0,9999,0
1668018968148,ECE 200,019,103604,Kuzum; Duygu,9999,0,9999,0
1668018968148,ECE 200,020,103605,Le; Hanh-Phuc,9999,0,9999,0
1668018968148,ECE 200,021,103606,Lin; Bill,9999,0,9999,0
1668018968148,ECE 200,022,103607,Liu; Zhaowei,9998,0,9999,1
1668018968148,ECE 200,023,103608,Lo; Yu-Hwa,9999,0,9999,0
1668018968148,ECE 200,024,103609,Lomakin; Vitaliy,9999,0,9999,0
1668018968148,ECE 200,025,103610,Mercier; Patrick Philip,9999,0,9999,0
1668018968148,ECE 200,026,103611,Meyer; Florian,9999,0,9999,0
1668018968148,ECE 200,027,103612,Milstein; Laurence B.,9999,0,9999,0
1668018968148,ECE 200,028,103613,Mir Arabbaygi; Siavash,9999,0,9999,0
1668018968148,ECE 200,029,103614,Mookherjea; Shayan,9999,0,9999,0
1668018968148,ECE 200,030,103615,Morris; Karcher William,9999,0,9999,0
1668018968148,ECE 200,031,103616,Ng; Tse Nga,9999,0,9999,0
1668018968148,ECE 200,032,103617,Nguyen; Truong Quang,9999,0,9999,0
1668018968148,ECE 200,033,103618,Nomura; Kenji,9999,0,9999,0
1668018968148,ECE 200,034,103619,Orlitsky; Alon,9999,0,9999,0
1668018968148,ECE 200,035,103620,Pal; Piya,9999,0,9999,0
1668018968148,ECE 200,036,103621,Papen; George C.,9999,0,9999,0
1668018968148,ECE 200,037,103622,Radic; Stojan,9999,0,9999,0
1668018968148,ECE 200,038,103623,Rao; Bhaskar D.,9999,0,9999,0
1668018968148,ECE 200,039,103624,Rao; Ramesh R,9999,0,9999,0
1668018968148,ECE 200,040,103625,Rebeiz; Gabriel,9999,0,9999,0
1668018968148,ECE 200,041,103626,Sanford; John R,9999,0,9999,0
1668018968148,ECE 200,042,103627,Siegel; Paul H.,9999,0,9999,0
1668018968148,ECE 200,043,103628,Sievenpiper; Daniel F.,9999,0,9999,0
1668018968148,ECE 200,044,103629,Sworder; David D.,9999,0,9999,0
1668018968148,ECE 200,045,103630,Taur; Yuan,9999,0,9999,0
1668018968148,ECE 200,046,103631,Touri; Behrouz,9999,0,9999,0
1668018968148,ECE 200,047,103632,Trivedi; Mohan M.,9999,0,9999,0
1668018968148,ECE 200,048,103633,Vasconcelos; Nuno,9999,0,9999,0
1668018968148,ECE 200,049,103634,Wang; Xiaolong,9999,0,9999,0
1668018968148,ECE 200,050,103635,Xie; Pengtao,9999,0,9999,0
1668018968148,ECE 200,051,103636,Yip; Michael,9999,0,9999,0
1668018968148,ECE 200,052,103637,Zeger; Kenneth A.,999,0,999,0
1668018968148,ECE 200,053,103638,Zhang; Xinyu,9999,0,9999,0
1668018968148,ECE 200,054,103639,Turakhia; Yatish Girish,9999,0,9999,0
1668018968148,ECE 200,055,103640,Kang; Mingu,9999,0,9999,0
1668018968148,ECE 200,056,103641,Shi; Yuanyuan,9999,0,9999,0
1668018968148,ECE 200,057,103642,Wang; Edward Jay,9999,0,9999,0
1668018968148,ECE 200,058,103643,Zheng; Yang,9999,0,9999,0
1668018968571,ECE 202,A00,103644,Kuzum; Duygu,0,0,0,0
1668018968993,ECE 212BN,A00,103646,Ng; Tse Nga,0,0,0,0
1668018969416,ECE 221,A00,111493,Staff,0,0,0,0
1668018969846,ECE 222B,A00,103647,Lomakin; Vitaliy,0,0,0,0
1668018970287,ECE 230B,A00,103648,Taur; Yuan,0,0,0,0
1668018970737,ECE 238B,A00,103649,Garay; Javier,0,0,0,0
1668018971168,ECE 240B,A00,112900,Fainman; Yeshaiahu,0,0,0,0
1668018971593,ECE 247A,A00,103650,Jokerst; Jesse Vincent,0,0,0,0
1668018972018,ECE 247B,A00,103651,Wang; Joseph,0,0,0,0
1668018972447,ECE 250,A00,103652,Siegel; Paul H.,0,0,0,0
1668018972869,ECE 251A,A00,103654,Rao; Bhaskar D.,0,0,0,0
1668018973305,ECE 257B,A00,103655,Bharadia; Dinesh,0,0,0,0
1668018973746,ECE 258A,A00,103656,Milstein; Laurence B.,0,0,0,0
1668018974177,ECE 260B,A00,103658,Kang; Mingu,0,0,0,0
1668018974615,ECE 264A,A00,103659,Galton; Ian A,0,0,0,0
1668018975046,ECE 265A,A00,103661,Gudem; Prasad S.S.,0,0,0,0
1668018975475,ECE 265D,A00,103662,Gudem; Prasad S.S.,0,0,0,0
1668018975914,ECE 268,A00,103663,Koushanfar; Farinaz,0,0,0,0
1668018976347,ECE 269,A01,103665,Pal; Piya,0,0,0,0
1668018976782,ECE 271B,A00,103666,Vasconcelos; Manuela,0,0,0,0
1668018977209,ECE 276A,A00,103667,Atanasov; Nikolay A.,0,0,0,0
1668018977647,ECE 277,A00,103668,An; Cheolhong,0,0,0,0
1668018978072,ECE 279,A00,117947,Hall; Drew A.,0,0,0,0
1668018978964,ECE 283,A00,103670,Hsueh; Tzu-Chien,0,0,0,0
1668018979392,ECE 284,A00,103671,Turakhia; Yatish Girish,0,0,0,0
1668018979815,ECE 285,A00,103672,Zheng; Yang,0,0,0,0
1668018979815,ECE 285,B00,103673,Sworder; David D.,0,0,0,0
1668018980239,ECE 287,A00,103676,Javidi; Tara,0,0,0,0
1668018980665,MATH 200B,A00,098023,Salehi Golsefidy; Alireza,14,0,15,1
1668018981094,MATH 202B,A00,098024,Rhoades; Brendon Patrick,11,0,15,4
1668018981517,MATH 203B,A00,098025,Oprea; Dragos N.,12,0,15,3
1668018981950,MATH 204B,A00,098026,Sorensen; Claus M,14,0,15,1
1668018982389,MATH 208,A00,098027,Izadi; Elham,7,0,10,3
1668018982815,MATH 209,A00,098028,Pollack; Aaron,10,0,10,0
1668018983248,MATH 211A,A00,112919,Rogalski; Daniel,9,0,10,1
1668018983674,MATH 211B,A00,112920,Seward; Brandon M.,9,0,10,1
1668018984100,MATH 218,A00,098029,Li; Bo,10,0,10,0
1668018984522,MATH 220B,A00,098030,Novak; Jonathan I,13,0,15,2
1668018984945,MATH 221A,A00,098031,Ebenfelt; Peter F,13,0,15,2
1668018985370,MATH 231B,A00,098032,Zlatos; Andrej,12,0,15,3
1668018985806,MATH 240B,A00,098033,Ni; Lei,10,0,15,5
1668018986231,MATH 243,A00,098034,Jekel; David Andrew,10,0,10,0
1668018986674,MATH 245A,A00,098035,Nie; Jiawang,0,0,15,16
1668018987100,MATH 248,A00,098036,Bejenaru; Ioan,10,0,10,0
1668018987525,MATH 250B,A00,098037,Spolaor; Luca,14,0,15,1
1668018987954,MATH 258,A00,098038,Ni; Lei,10,0,10,0
1668018988385,MATH 264B,A00,098041,Rhoades; Brendon Patrick,10,0,15,5
1668018988909,MATH 268,A00,098042,Buss; Samuel R,10,0,10,0
1668018989340,MATH 269,A00,098043,Rhoades; Brendon Patrick,10,0,10,0
1668018989769,MATH 270B,A00,098044,Li; Bo,11,0,15,4
1668018990192,MATH 272B,A00,098045,Holst; Michael J,13,0,15,2
1668018990615,MATH 273A,A00,098046,Tian; Xiaochuan,11,0,15,4
1668018991045,MATH 275,A01,098048,Tian; Xiaochuan,6,0,10,4
1668018991470,MATH 278A,A00,098049,Holst; Michael J,8,0,10,2
1668018991895,MATH 278B,A00,098050,Cloninger; Alexander,10,0,10,0
1668018992321,MATH 278C,A00,098051,Nie; Jiawang,8,0,10,2
1668018992765,MATH 280B,A00,098052,Zheng; Tianyi,11,0,15,4
1668018993194,MATH 281B,A00,098053,Bradic; Jelena,4,0,15,11
1668018993618,MATH 282B,A00,098054,Arias-Castro; Ery,2,0,15,13
1668018994042,MATH 285,A00,098055,Fitzsimmons; Patrick J,0,0,15,17
1668018994469,MATH 287B,A00,098056,Arias-Castro; Ery,5,0,15,10
1668018994901,MATH 288,A00,098057,Agarwal; Pooja,9,0,10,1
1668018994901,MATH 288,B00,098058,Zhang; Danna,9,0,10,1
1668018994901,MATH 288,C00,098059,Williams; Ruth J,10,0,10,0
1668018995332,MATH 290B,A00,098060,Roberts; Justin Deritter,14,0,15,1
1668018995760,MATH 292,A00,098061,Belmont; Eva Kinoshita,10,0,10,0
1668018996193,MATH 295,A00,098062,Suk; Andrew Hoon,48,0,50,2
1668018996631,MATH 296,A00,098063,Novak; Jonathan I,20,0,20,0
1668018997075,MATH 297,001,098064,Gamst; Anthony Collins,9997,0,9999,2
1668019511970,COGS 205,A00,101395,Chiba; Andrea,19,0,20,1
1668019512394,COGS 210B,001,101404,Greene; Deanna Jacquelyn,9998,0,9999,1
1668019512394,COGS 210B,002,101417,Xia; Haijun,9999,0,9999,0
1668019512394,COGS 210B,003,101422,Nitz; Douglas A.,9999,0,9999,0
1668019512394,COGS 210B,004,101423,Hollan; James D.,9998,0,9999,1
1668019512394,COGS 210B,005,101424,Deak; Gedeon O.,9999,0,9999,0
1668019512394,COGS 210B,006,101425,Rossano; Federico,9999,0,9999,0
1668019512815,COGS 211B,A00,101427,Coulson; Seana M,9997,0,9999,2
1668019513240,COGS 220,A00,101428,Hollan; James D.,0,0,25,25
1668019513675,COGS 229,A00,101429,Dow; Steven P,18,0,25,7
1668019514099,COGS 230,A00,101430,Klemmer; Scott R,13,0,17,4
1668019514523,COGS 234,A00,101431,Xia; Haijun,5,0,25,20
1668019514949,COGS 260,A00,101432,Kiyonaga; Anastasia,20,0,25,5
1668019514949,COGS 260,B00,101433,Kirsh; David Joel,16,0,25,9
1668019515394,CSE 202,A00,102371,Impagliazzo; Russell,0,0,0,0
1668019515836,CSE 203B,A01,102373,Cheng; Chung Kuan,0,0,0,0
1668019516261,CSE 208,A00,102374,Micciancio; Daniele,0,0,0,0
1668019516691,CSE 209A,A00,112895,Impagliazzo; Russell,0,0,15,15
1668019517118,CSE 209B,A00,108005,Bellare; Mihir,0,0,0,0
1668019517547,CSE 210,A00,113163,Coblenz; Michael J,0,0,0,0
1668019517975,CSE 219,A00,106111,Dow; Steven P,0,0,20,20
1668019518402,CSE 221,A00,102376,Voelker; Geoffrey M.,0,0,0,0
1668019518832,CSE 224,A01,102378,Porter; George M,0,0,0,0
1668019519285,CSE 229A,A00,102379,Savage; Stefan,0,0,0,0
1668019519710,CSE 229C,A00,102380,Munyaka; Imani N. S.,0,0,0,0
1668019520145,CSE 232B,A00,102382,Deutsch; Alin Bernard,0,0,0,0
1668019520568,CSE 234,A01,112904,Kumar; Arun Kumar,0,0,0,0
1668019520995,CSE 237A,A00,102383,Rosing; Tajana Simunic,0,0,0,0
1668019521419,CSE 239A,A00,102384,Deutsch; Alin Bernard,0,0,0,0
1668019521857,CSE 239B,A00,102385,Polikarpova; Nadezhda,0,0,0,0
1668019522281,CSE 240A,A00,102386,Pannuto; Patrick William,0,0,0,0
1668019522716,CSE 240B,A00,102387,Zhao; Jishen,0,0,0,0
1668019523141,CSE 241A,A00,106406,Kang; Mingu,0,0,0,0
1668019523571,CSE 249B,A00,102388,Kahng; Andrew Byun,0,0,8,8
1668019524087,CSE 251B,A01,102392,Cottrell; Garrison W,0,0,0,0
1668019524087,CSE 251B,A02,102393,Cottrell; Garrison W,0,0,0,0
1668019524516,CSE 252B,A00,102394,Ochoa; Benjamin Lawrence,0,0,0,0
1668019524943,CSE 257,A01,102396,Gao; Sicun,0,0,0,0
1668019525374,CSE 272,A00,102397,Li; Tzumao,0,0,0,0
1668019525801,CSE 274,A00,111323,Chern; Albert Ren-Haur,0,0,0,0
1668019526228,CSE 282,A00,102398,Pevzner; Pavel Arkadjevich,0,0,0,0
1668019526664,CSE 284,A00,114175,Gymrek; Melissa Ann,0,0,0,0
1668019527093,CSE 290,A00,102399,Chandraker; Manmohan Krishna,0,0,0,0
1668019527093,CSE 290,B00,102400,Vaccaro; Kristen Marie,0,0,25,25
1668019527093,CSE 290,C00,102414,Pannuto; Patrick William,0,0,25,25
1668019527093,CSE 290,D00,102427,Pevzner; Pavel Arkadjevich,0,0,0,0
1668019527093,CSE 290,E00,102429,Zhao; Jishen,0,0,0,0
1668019527093,CSE 290,F00,102436,Tullsen; Dean Michael,0,0,0,0
1668019527093,CSE 290,G00,102440,Christensen; Henrik I,0,0,20,20
1668019527516,CSE 291,A00,102443,Su; Hao,0,0,0,0
1668019527516,CSE 291,B00,102448,Polikarpova; Nadezhda,0,0,0,0
1668019527516,CSE 291,C00,102453,Vaccaro; Kristen Marie,0,0,0,0
1668019527516,CSE 291,D00,111343,Savage; Stefan,0,0,0,0
1668019527516,CSE 291,E00,116474,Claffy; Kimberly Claire,0,0,0,0
1668019527516,CSE 291,F00,116479,Pasquale; Joseph,0,0,0,0
1668019527952,CSE 293,001,119111,Bafna; Vineet,9999,0,9999,0
1668019527952,CSE 293,002,119118,Bellare; Mihir,9999,0,9999,0
1668019527952,CSE 293,003,119122,Berg-Kirkpatrick; Taylor D,9999,0,9999,0
1668019527952,CSE 293,004,119135,Christensen; Henrik I,9999,0,9999,0
1668019527952,CSE 293,005,119142,Cottrell; Garrison W,9999,0,9999,0
1668019527952,CSE 293,006,119146,Deutsch; Alin Bernard,9999,0,9999,0
1668019527952,CSE 293,007,119159,Esmaeilzadeh; Hadi,9999,0,9999,0
1668019527952,CSE 293,008,119166,Freund; Yoav,9999,0,9999,0
1668019527952,CSE 293,009,119170,Griswold; William G.,9999,0,9999,0
1668019527952,CSE 293,010,119183,Gymrek; Melissa Ann,9999,0,9999,0
1668019527952,CSE 293,011,119190,Heninger; Nadia A,9999,0,9999,0
1668019527952,CSE 293,012,119230,Impagliazzo; Russell,9999,0,9999,0
1668019527952,CSE 293,013,119232,Jhala; Ranjit,9999,0,9999,0
1668019527952,CSE 293,014,119233,Kahng; Andrew Byun,9999,0,9999,0
1668019527952,CSE 293,015,119298,Kane; Daniel Mertz,9999,0,9999,0
1668019527952,CSE 293,016,119299,Kriegman; David J,9999,0,9999,0
1668019527952,CSE 293,017,119300,Kumar; Arun Kumar,9999,0,9999,0
1668019527952,CSE 293,018,119301,Lerner; Sorin,9999,0,9999,0
1668019527952,CSE 293,019,119302,Lovett; Shachar,9999,0,9999,0
1668019527952,CSE 293,020,119303,McAuley; Julian John,9999,0,9999,0
1668019527952,CSE 293,021,119304,Micciancio; Daniele,9999,0,9999,0
1668019527952,CSE 293,022,119367,Orailoglu; Alex,9999,0,9999,0
1668019527952,CSE 293,023,119382,Paturi; Ramamohan,9999,0,9999,0
1668019527952,CSE 293,024,119404,Polikarpova; Nadezhda,9999,0,9999,0
1668019527952,CSE 293,025,119406,Politz; Joseph Gibbs,9999,0,9999,0
1668019527952,CSE 293,026,119411,Porter; George M,9999,0,9999,0
1668019527952,CSE 293,027,119414,Porter; Leonard Emerson,9999,0,9999,0
1668019527952,CSE 293,028,119416,Ramamoorthi; Ravi,9999,0,9999,0
1668019527952,CSE 293,029,119417,Sahoo; Debashis,9999,0,9999,0
1668019527952,CSE 293,030,119420,Saul; Lawrence,9999,0,9999,0
1668019527952,CSE 293,031,119421,Savage; Stefan,9999,0,9999,0
1668019527952,CSE 293,032,119425,Schulze; Jurgen P.,9999,0,9999,0
1668019527952,CSE 293,033,119426,Snoeren; Alex C.,9999,0,9999,0
1668019527952,CSE 293,034,119428,Shang; Jingbo,9999,0,9999,0
1668019527952,CSE 293,035,119430,Stefan; Deian,9999,0,9999,0
1668019527952,CSE 293,036,119431,Su; Hao,9999,0,9999,0
1668019527952,CSE 293,037,119433,Swanson; Steven James,9999,0,9999,0
1668019527952,CSE 293,038,119435,Tullsen; Dean Michael,9999,0,9999,0
1668019527952,CSE 293,039,119483,Voelker; Geoffrey M.,9999,0,9999,0
1668019527952,CSE 293,040,119537,Zhao; Jishen,9999,0,9999,0
1668019527952,CSE 293,041,119538,Zhou; Yuan-Yuan,9999,0,9999,0
1668019527952,CSE 293,042,119539,Gao; Sicun,9999,0,9999,0
1668019527952,CSE 293,043,119540,Weibel; Nadir,9999,0,9999,0
1668019527952,CSE 293,044,119541,Gupta; Rajesh K.,9999,0,9999,0
1668019527952,CSE 293,045,126410,Vaccaro; Kristen Marie,9999,0,9999,0
1668019527952,CSE 293,046,126411,Klemke; Richard,9999,0,9999,0
1668019528379,CSE 294,A00,102459,Voelker; Geoffrey M.,0,0,0,0
1668019528379,CSE 294,B00,111322,Orailoglu; Alex,0,0,0,0
1668019528801,DSE 201,A00,096914,Deutsch; Alin Bernard,30,0,30,0
1668019529238,DSE 210,A00,096915,Dasgupta; Sanjoy,30,0,30,0
1668019529661,DSE 260A,A00,096916,Altintas De Callaf; Ilkay,30,0,30,0
1668019530090,ECE 200,001,103586,Antipa; Nicholas A,9999,0,9999,0
1668019530090,ECE 200,002,103587,Atanasov; Nikolay A.,9999,0,9999,0
1668019530090,ECE 200,003,103588,Bharadia; Dinesh,9999,0,9999,0
1668019530090,ECE 200,004,103589,Cheng; Chung Kuan,9999,0,9999,0
1668019530090,ECE 200,005,103590,Cosman; Pamela C.,9999,0,9999,0
1668019530090,ECE 200,006,103591,Dayeh; Shadi Ahmad,9999,0,9999,0
1668019530090,ECE 200,007,103592,Fainman; Yeshaiahu,9999,0,9999,0
1668019530090,ECE 200,008,103593,Ford; Joseph Earl,9999,0,9999,0
1668019530090,ECE 200,009,103594,Franceschetti; Massimo,9999,0,9999,0
1668019530090,ECE 200,010,103595,Fullerton; Eric E,9999,0,9999,0
1668019530090,ECE 200,011,103596,Galton; Ian A,9999,0,9999,0
1668019530090,ECE 200,012,103597,Gilja; Vikash,9999,0,9999,0
1668019530090,ECE 200,013,103598,Hall; Drew A.,9999,0,9999,0
1668019530090,ECE 200,014,103599,Hsueh; Tzu-Chien,9999,0,9999,0
1668019530090,ECE 200,015,103600,Javidi; Tara,9999,0,9999,0
1668019530090,ECE 200,016,103601,Kahng; Andrew Byun,9999,0,9999,0
1668019530090,ECE 200,017,103602,Kim; Young-Han,9999,0,9999,0
1668019530090,ECE 200,018,103603,Koushanfar; Farinaz,9999,0,9999,0
1668019530090,ECE 200,019,103604,Kuzum; Duygu,9999,0,9999,0
1668019530090,ECE 200,020,103605,Le; Hanh-Phuc,9999,0,9999,0
1668019530090,ECE 200,021,103606,Lin; Bill,9999,0,9999,0
1668019530090,ECE 200,022,103607,Liu; Zhaowei,9998,0,9999,1
1668019530090,ECE 200,023,103608,Lo; Yu-Hwa,9999,0,9999,0
1668019530090,ECE 200,024,103609,Lomakin; Vitaliy,9999,0,9999,0
1668019530090,ECE 200,025,103610,Mercier; Patrick Philip,9999,0,9999,0
1668019530090,ECE 200,026,103611,Meyer; Florian,9999,0,9999,0
1668019530090,ECE 200,027,103612,Milstein; Laurence B.,9999,0,9999,0
1668019530090,ECE 200,028,103613,Mir Arabbaygi; Siavash,9999,0,9999,0
1668019530090,ECE 200,029,103614,Mookherjea; Shayan,9999,0,9999,0
1668019530090,ECE 200,030,103615,Morris; Karcher William,9999,0,9999,0
1668019530090,ECE 200,031,103616,Ng; Tse Nga,9999,0,9999,0
1668019530090,ECE 200,032,103617,Nguyen; Truong Quang,9999,0,9999,0
1668019530090,ECE 200,033,103618,Nomura; Kenji,9999,0,9999,0
1668019530090,ECE 200,034,103619,Orlitsky; Alon,9999,0,9999,0
1668019530090,ECE 200,035,103620,Pal; Piya,9999,0,9999,0
1668019530090,ECE 200,036,103621,Papen; George C.,9999,0,9999,0
1668019530090,ECE 200,037,103622,Radic; Stojan,9999,0,9999,0
1668019530090,ECE 200,038,103623,Rao; Bhaskar D.,9999,0,9999,0
1668019530090,ECE 200,039,103624,Rao; Ramesh R,9999,0,9999,0
1668019530090,ECE 200,040,103625,Rebeiz; Gabriel,9999,0,9999,0
1668019530090,ECE 200,041,103626,Sanford; John R,9999,0,9999,0
1668019530090,ECE 200,042,103627,Siegel; Paul H.,9999,0,9999,0
1668019530090,ECE 200,043,103628,Sievenpiper; Daniel F.,9999,0,9999,0
1668019530090,ECE 200,044,103629,Sworder; David D.,9999,0,9999,0
1668019530090,ECE 200,045,103630,Taur; Yuan,9999,0,9999,0
1668019530090,ECE 200,046,103631,Touri; Behrouz,9999,0,9999,0
1668019530090,ECE 200,047,103632,Trivedi; Mohan M.,9999,0,9999,0
1668019530090,ECE 200,048,103633,Vasconcelos; Nuno,9999,0,9999,0
1668019530090,ECE 200,049,103634,Wang; Xiaolong,9999,0,9999,0
1668019530090,ECE 200,050,103635,Xie; Pengtao,9999,0,9999,0
1668019530090,ECE 200,051,103636,Yip; Michael,9999,0,9999,0
1668019530090,ECE 200,052,103637,Zeger; Kenneth A.,999,0,999,0
1668019530090,ECE 200,053,103638,Zhang; Xinyu,9999,0,9999,0
1668019530090,ECE 200,054,103639,Turakhia; Yatish Girish,9999,0,9999,0
1668019530090,ECE 200,055,103640,Kang; Mingu,9999,0,9999,0
1668019530090,ECE 200,056,103641,Shi; Yuanyuan,9999,0,9999,0
1668019530090,ECE 200,057,103642,Wang; Edward Jay,9999,0,9999,0
1668019530090,ECE 200,058,103643,Zheng; Yang,9999,0,9999,0
1668019530520,ECE 202,A00,103644,Kuzum; Duygu,0,0,0,0
1668019530954,ECE 212BN,A00,103646,Ng; Tse Nga,0,0,0,0
1668019531380,ECE 221,A00,111493,Staff,0,0,0,0
1668019531825,ECE 222B,A00,103647,Lomakin; Vitaliy,0,0,0,0
1668019532259,ECE 230B,A00,103648,Taur; Yuan,0,0,0,0
1668019532683,ECE 238B,A00,103649,Garay; Javier,0,0,0,0
1668019533116,ECE 240B,A00,112900,Fainman; Yeshaiahu,0,0,0,0
1668019533543,ECE 247A,A00,103650,Jokerst; Jesse Vincent,0,0,0,0
1668019533975,ECE 247B,A00,103651,Wang; Joseph,0,0,0,0
1668019534402,ECE 250,A00,103652,Siegel; Paul H.,0,0,0,0
1668019534824,ECE 251A,A00,103654,Rao; Bhaskar D.,0,0,0,0
1668019535246,ECE 257B,A00,103655,Bharadia; Dinesh,0,0,0,0
1668019535669,ECE 258A,A00,103656,Milstein; Laurence B.,0,0,0,0
1668019536107,ECE 260B,A00,103658,Kang; Mingu,0,0,0,0
1668019536538,ECE 264A,A00,103659,Galton; Ian A,0,0,0,0
1668019536973,ECE 265A,A00,103661,Gudem; Prasad S.S.,0,0,0,0
1668019537399,ECE 265D,A00,103662,Gudem; Prasad S.S.,0,0,0,0
1668019537832,ECE 268,A00,103663,Koushanfar; Farinaz,0,0,0,0
1668019538264,ECE 269,A01,103665,Pal; Piya,0,0,0,0
1668019538692,ECE 271B,A00,103666,Vasconcelos; Manuela,0,0,0,0
1668019539121,ECE 276A,A00,103667,Atanasov; Nikolay A.,0,0,0,0
1668019539542,ECE 277,A00,103668,An; Cheolhong,0,0,0,0
1668019540051,ECE 279,A00,117947,Hall; Drew A.,0,0,0,0
1668019540903,ECE 283,A00,103670,Hsueh; Tzu-Chien,0,0,0,0
1668019541338,ECE 284,A00,103671,Turakhia; Yatish Girish,0,0,0,0
1668019541778,ECE 285,A00,103672,Zheng; Yang,0,0,0,0
1668019541778,ECE 285,B00,103673,Sworder; David D.,0,0,0,0
1668019542202,ECE 287,A00,103676,Javidi; Tara,0,0,0,0
1668019542634,MATH 200B,A00,098023,Salehi Golsefidy; Alireza,14,0,15,1
1668019543055,MATH 202B,A00,098024,Rhoades; Brendon Patrick,11,0,15,4
1668019543486,MATH 203B,A00,098025,Oprea; Dragos N.,11,0,15,4
1668019543913,MATH 204B,A00,098026,Sorensen; Claus M,14,0,15,1
1668019544339,MATH 208,A00,098027,Izadi; Elham,7,0,10,3
1668019544765,MATH 209,A00,098028,Pollack; Aaron,10,0,10,0
1668019545200,MATH 211A,A00,112919,Rogalski; Daniel,9,0,10,1
1668019545630,MATH 211B,A00,112920,Seward; Brandon M.,9,0,10,1
1668019546074,MATH 218,A00,098029,Li; Bo,10,0,10,0
1668019546498,MATH 220B,A00,098030,Novak; Jonathan I,13,0,15,2
1668019546924,MATH 221A,A00,098031,Ebenfelt; Peter F,13,0,15,2
1668019547359,MATH 231B,A00,098032,Zlatos; Andrej,12,0,15,3
1668019547790,MATH 240B,A00,098033,Ni; Lei,9,0,15,6
1668019548231,MATH 243,A00,098034,Jekel; David Andrew,10,0,10,0
1668019548667,MATH 245A,A00,098035,Nie; Jiawang,0,0,15,16
1668019549095,MATH 248,A00,098036,Bejenaru; Ioan,10,0,10,0
1668019549521,MATH 250B,A00,098037,Spolaor; Luca,14,0,15,1
1668019549944,MATH 258,A00,098038,Ni; Lei,10,0,10,0
1668019550380,MATH 264B,A00,098041,Rhoades; Brendon Patrick,10,0,15,5
1668019550813,MATH 268,A00,098042,Buss; Samuel R,10,0,10,0
1668019551256,MATH 269,A00,098043,Rhoades; Brendon Patrick,10,0,10,0
1668019551698,MATH 270B,A00,098044,Li; Bo,11,0,15,4
1668019552127,MATH 272B,A00,098045,Holst; Michael J,13,0,15,2
1668019552565,MATH 273A,A00,098046,Tian; Xiaochuan,10,0,15,5
1668019552996,MATH 275,A01,098048,Tian; Xiaochuan,6,0,10,4
1668019553429,MATH 278A,A00,098049,Holst; Michael J,8,0,10,2
1668019553853,MATH 278B,A00,098050,Cloninger; Alexander,10,0,10,0
1668019554282,MATH 278C,A00,098051,Nie; Jiawang,8,0,10,2
1668019554707,MATH 280B,A00,098052,Zheng; Tianyi,11,0,15,4
1668019555134,MATH 281B,A00,098053,Bradic; Jelena,4,0,15,11
1668019555568,MATH 282B,A00,098054,Arias-Castro; Ery,2,0,15,13
1668019556000,MATH 285,A00,098055,Fitzsimmons; Patrick J,0,0,15,17
1668019556428,MATH 287B,A00,098056,Arias-Castro; Ery,5,0,15,10
1668019556860,MATH 288,A00,098057,Agarwal; Pooja,9,0,10,1
1668019556860,MATH 288,B00,098058,Zhang; Danna,9,0,10,1
1668019556860,MATH 288,C00,098059,Williams; Ruth J,10,0,10,0
1668019557285,MATH 290B,A00,098060,Roberts; Justin Deritter,13,0,15,2
1668019557729,MATH 292,A00,098061,Belmont; Eva Kinoshita,10,0,10,0
1668019558162,MATH 295,A00,098062,Suk; Andrew Hoon,48,0,50,2
1668019558592,MATH 296,A00,098063,Novak; Jonathan I,20,0,20,0
1668019559018,MATH 297,001,098064,Gamst; Anthony Collins,9997,0,9999,2
1668020065410,COGS 205,A00,101395,Chiba; Andrea,19,0,20,1
1668020065846,COGS 210B,001,101404,Greene; Deanna Jacquelyn,9998,0,9999,1
1668020065846,COGS 210B,002,101417,Xia; Haijun,9999,0,9999,0
1668020065846,COGS 210B,003,101422,Nitz; Douglas A.,9999,0,9999,0
1668020065846,COGS 210B,004,101423,Hollan; James D.,9998,0,9999,1
1668020065846,COGS 210B,005,101424,Deak; Gedeon O.,9999,0,9999,0
1668020065846,COGS 210B,006,101425,Rossano; Federico,9999,0,9999,0
1668020066280,COGS 211B,A00,101427,Coulson; Seana M,9997,0,9999,2
1668020066703,COGS 220,A00,101428,Hollan; James D.,0,0,25,25
1668020067133,COGS 229,A00,101429,Dow; Steven P,18,0,25,7
1668020067575,COGS 230,A00,101430,Klemmer; Scott R,13,0,17,4
1668020067997,COGS 234,A00,101431,Xia; Haijun,5,0,25,20
1668020068440,COGS 260,A00,101432,Kiyonaga; Anastasia,20,0,25,5
1668020068440,COGS 260,B00,101433,Kirsh; David Joel,16,0,25,9
1668020068861,CSE 202,A00,102371,Impagliazzo; Russell,0,0,0,0
1668020069285,CSE 203B,A01,102373,Cheng; Chung Kuan,0,0,0,0
1668020069708,CSE 208,A00,102374,Micciancio; Daniele,0,0,0,0
1668020070129,CSE 209A,A00,112895,Impagliazzo; Russell,0,0,15,15
1668020070556,CSE 209B,A00,108005,Bellare; Mihir,0,0,0,0
1668020070981,CSE 210,A00,113163,Coblenz; Michael J,0,0,0,0
1668020071410,CSE 219,A00,106111,Dow; Steven P,0,0,20,20
1668020071851,CSE 221,A00,102376,Voelker; Geoffrey M.,0,0,0,0
1668020072272,CSE 224,A01,102378,Porter; George M,0,0,0,0
1668020072695,CSE 229A,A00,102379,Savage; Stefan,0,0,0,0
1668020073118,CSE 229C,A00,102380,Munyaka; Imani N. S.,0,0,0,0
1668020073542,CSE 232B,A00,102382,Deutsch; Alin Bernard,0,0,0,0
1668020073968,CSE 234,A01,112904,Kumar; Arun Kumar,0,0,0,0
1668020074396,CSE 237A,A00,102383,Rosing; Tajana Simunic,0,0,0,0
1668020074831,CSE 239A,A00,102384,Deutsch; Alin Bernard,0,0,0,0
1668020075253,CSE 239B,A00,102385,Polikarpova; Nadezhda,0,0,0,0
1668020075674,CSE 240A,A00,102386,Pannuto; Patrick William,0,0,0,0
1668020076098,CSE 240B,A00,102387,Zhao; Jishen,0,0,0,0
1668020076530,CSE 241A,A00,106406,Kang; Mingu,0,0,0,0
1668020076972,CSE 249B,A00,102388,Kahng; Andrew Byun,0,0,8,8
1668020077414,CSE 251B,A01,102392,Cottrell; Garrison W,0,0,0,0
1668020077414,CSE 251B,A02,102393,Cottrell; Garrison W,0,0,0,0
1668020077842,CSE 252B,A00,102394,Ochoa; Benjamin Lawrence,0,0,0,0
1668020078265,CSE 257,A01,102396,Gao; Sicun,0,0,0,0
1668020078705,CSE 272,A00,102397,Li; Tzumao,0,0,0,0
1668020079127,CSE 274,A00,111323,Chern; Albert Ren-Haur,0,0,0,0
1668020079550,CSE 282,A00,102398,Pevzner; Pavel Arkadjevich,0,0,0,0
1668020079973,CSE 284,A00,114175,Gymrek; Melissa Ann,0,0,0,0
1668020080403,CSE 290,A00,102399,Chandraker; Manmohan Krishna,0,0,0,0
1668020080403,CSE 290,B00,102400,Vaccaro; Kristen Marie,0,0,25,25
1668020080403,CSE 290,C00,102414,Pannuto; Patrick William,0,0,25,25
1668020080403,CSE 290,D00,102427,Pevzner; Pavel Arkadjevich,0,0,0,0
1668020080403,CSE 290,E00,102429,Zhao; Jishen,0,0,0,0
1668020080403,CSE 290,F00,102436,Tullsen; Dean Michael,0,0,0,0
1668020080403,CSE 290,G00,102440,Christensen; Henrik I,0,0,20,20
1668020080828,CSE 291,A00,102443,Su; Hao,0,0,0,0
1668020080828,CSE 291,B00,102448,Polikarpova; Nadezhda,0,0,0,0
1668020080828,CSE 291,C00,102453,Vaccaro; Kristen Marie,0,0,0,0
1668020080828,CSE 291,D00,111343,Savage; Stefan,0,0,0,0
1668020080828,CSE 291,E00,116474,Claffy; Kimberly Claire,0,0,0,0
1668020080828,CSE 291,F00,116479,Pasquale; Joseph,0,0,0,0
1668020081262,CSE 293,001,119111,Bafna; Vineet,9999,0,9999,0
1668020081262,CSE 293,002,119118,Bellare; Mihir,9999,0,9999,0
1668020081262,CSE 293,003,119122,Berg-Kirkpatrick; Taylor D,9999,0,9999,0
1668020081262,CSE 293,004,119135,Christensen; Henrik I,9999,0,9999,0
1668020081262,CSE 293,005,119142,Cottrell; Garrison W,9999,0,9999,0
1668020081262,CSE 293,006,119146,Deutsch; Alin Bernard,9999,0,9999,0
1668020081262,CSE 293,007,119159,Esmaeilzadeh; Hadi,9999,0,9999,0
1668020081262,CSE 293,008,119166,Freund; Yoav,9999,0,9999,0
1668020081262,CSE 293,009,119170,Griswold; William G.,9999,0,9999,0
1668020081262,CSE 293,010,119183,Gymrek; Melissa Ann,9999,0,9999,0
1668020081262,CSE 293,011,119190,Heninger; Nadia A,9999,0,9999,0
1668020081262,CSE 293,012,119230,Impagliazzo; Russell,9999,0,9999,0
1668020081262,CSE 293,013,119232,Jhala; Ranjit,9999,0,9999,0
1668020081262,CSE 293,014,119233,Kahng; Andrew Byun,9999,0,9999,0
1668020081262,CSE 293,015,119298,Kane; Daniel Mertz,9999,0,9999,0
1668020081262,CSE 293,016,119299,Kriegman; David J,9999,0,9999,0
1668020081262,CSE 293,017,119300,Kumar; Arun Kumar,9999,0,9999,0
1668020081262,CSE 293,018,119301,Lerner; Sorin,9999,0,9999,0
1668020081262,CSE 293,019,119302,Lovett; Shachar,9999,0,9999,0
1668020081262,CSE 293,020,119303,McAuley; Julian John,9999,0,9999,0
1668020081262,CSE 293,021,119304,Micciancio; Daniele,9999,0,9999,0
1668020081262,CSE 293,022,119367,Orailoglu; Alex,9999,0,9999,0
1668020081262,CSE 293,023,119382,Paturi; Ramamohan,9999,0,9999,0
1668020081262,CSE 293,024,119404,Polikarpova; Nadezhda,9999,0,9999,0
1668020081262,CSE 293,025,119406,Politz; Joseph Gibbs,9999,0,9999,0
1668020081262,CSE 293,026,119411,Porter; George M,9999,0,9999,0
1668020081262,CSE 293,027,119414,Porter; Leonard Emerson,9999,0,9999,0
1668020081262,CSE 293,028,119416,Ramamoorthi; Ravi,9999,0,9999,0
1668020081262,CSE 293,029,119417,Sahoo; Debashis,9999,0,9999,0
1668020081262,CSE 293,030,119420,Saul; Lawrence,9999,0,9999,0
1668020081262,CSE 293,031,119421,Savage; Stefan,9999,0,9999,0
1668020081262,CSE 293,032,119425,Schulze; Jurgen P.,9999,0,9999,0
1668020081262,CSE 293,033,119426,Snoeren; Alex C.,9999,0,9999,0
1668020081262,CSE 293,034,119428,Shang; Jingbo,9999,0,9999,0
1668020081262,CSE 293,035,119430,Stefan; Deian,9999,0,9999,0
1668020081262,CSE 293,036,119431,Su; Hao,9999,0,9999,0
1668020081262,CSE 293,037,119433,Swanson; Steven James,9999,0,9999,0
1668020081262,CSE 293,038,119435,Tullsen; Dean Michael,9999,0,9999,0
1668020081262,CSE 293,039,119483,Voelker; Geoffrey M.,9999,0,9999,0
1668020081262,CSE 293,040,119537,Zhao; Jishen,9999,0,9999,0
1668020081262,CSE 293,041,119538,Zhou; Yuan-Yuan,9999,0,9999,0
1668020081262,CSE 293,042,119539,Gao; Sicun,9999,0,9999,0
1668020081262,CSE 293,043,119540,Weibel; Nadir,9999,0,9999,0
1668020081262,CSE 293,044,119541,Gupta; Rajesh K.,9999,0,9999,0
1668020081262,CSE 293,045,126410,Vaccaro; Kristen Marie,9999,0,9999,0
1668020081262,CSE 293,046,126411,Klemke; Richard,9999,0,9999,0
1668020081685,CSE 294,A00,102459,Voelker; Geoffrey M.,0,0,0,0
1668020081685,CSE 294,B00,111322,Orailoglu; Alex,0,0,0,0
1668020082111,DSE 201,A00,096914,Deutsch; Alin Bernard,30,0,30,0
1668020082549,DSE 210,A00,096915,Dasgupta; Sanjoy,30,0,30,0
1668020082989,DSE 260A,A00,096916,Altintas De Callaf; Ilkay,30,0,30,0
1668020083417,ECE 200,001,103586,Antipa; Nicholas A,9999,0,9999,0
1668020083417,ECE 200,002,103587,Atanasov; Nikolay A.,9999,0,9999,0
1668020083417,ECE 200,003,103588,Bharadia; Dinesh,9999,0,9999,0
1668020083417,ECE 200,004,103589,Cheng; Chung Kuan,9999,0,9999,0
1668020083417,ECE 200,005,103590,Cosman; Pamela C.,9999,0,9999,0
1668020083417,ECE 200,006,103591,Dayeh; Shadi Ahmad,9999,0,9999,0
1668020083417,ECE 200,007,103592,Fainman; Yeshaiahu,9999,0,9999,0
1668020083417,ECE 200,008,103593,Ford; Joseph Earl,9999,0,9999,0
1668020083417,ECE 200,009,103594,Franceschetti; Massimo,9999,0,9999,0
1668020083417,ECE 200,010,103595,Fullerton; Eric E,9999,0,9999,0
1668020083417,ECE 200,011,103596,Galton; Ian A,9999,0,9999,0
1668020083417,ECE 200,012,103597,Gilja; Vikash,9999,0,9999,0
1668020083417,ECE 200,013,103598,Hall; Drew A.,9999,0,9999,0
1668020083417,ECE 200,014,103599,Hsueh; Tzu-Chien,9999,0,9999,0
1668020083417,ECE 200,015,103600,Javidi; Tara,9999,0,9999,0
1668020083417,ECE 200,016,103601,Kahng; Andrew Byun,9999,0,9999,0
1668020083417,ECE 200,017,103602,Kim; Young-Han,9999,0,9999,0
1668020083417,ECE 200,018,103603,Koushanfar; Farinaz,9999,0,9999,0
1668020083417,ECE 200,019,103604,Kuzum; Duygu,9999,0,9999,0
1668020083417,ECE 200,020,103605,Le; Hanh-Phuc,9999,0,9999,0
1668020083417,ECE 200,021,103606,Lin; Bill,9999,0,9999,0
1668020083417,ECE 200,022,103607,Liu; Zhaowei,9998,0,9999,1
1668020083417,ECE 200,023,103608,Lo; Yu-Hwa,9999,0,9999,0
1668020083417,ECE 200,024,103609,Lomakin; Vitaliy,9999,0,9999,0
1668020083417,ECE 200,025,103610,Mercier; Patrick Philip,9999,0,9999,0
1668020083417,ECE 200,026,103611,Meyer; Florian,9999,0,9999,0
1668020083417,ECE 200,027,103612,Milstein; Laurence B.,9999,0,9999,0
1668020083417,ECE 200,028,103613,Mir Arabbaygi; Siavash,9999,0,9999,0
1668020083417,ECE 200,029,103614,Mookherjea; Shayan,9999,0,9999,0
1668020083417,ECE 200,030,103615,Morris; Karcher William,9999,0,9999,0
1668020083417,ECE 200,031,103616,Ng; Tse Nga,9999,0,9999,0
1668020083417,ECE 200,032,103617,Nguyen; Truong Quang,9999,0,9999,0
1668020083417,ECE 200,033,103618,Nomura; Kenji,9999,0,9999,0
1668020083417,ECE 200,034,103619,Orlitsky; Alon,9999,0,9999,0
1668020083417,ECE 200,035,103620,Pal; Piya,9999,0,9999,0
1668020083417,ECE 200,036,103621,Papen; George C.,9999,0,9999,0
1668020083417,ECE 200,037,103622,Radic; Stojan,9999,0,9999,0
1668020083417,ECE 200,038,103623,Rao; Bhaskar D.,9999,0,9999,0
1668020083417,ECE 200,039,103624,Rao; Ramesh R,9999,0,9999,0
1668020083417,ECE 200,040,103625,Rebeiz; Gabriel,9999,0,9999,0
1668020083417,ECE 200,041,103626,Sanford; John R,9999,0,9999,0
1668020083417,ECE 200,042,103627,Siegel; Paul H.,9999,0,9999,0
1668020083417,ECE 200,043,103628,Sievenpiper; Daniel F.,9999,0,9999,0
1668020083417,ECE 200,044,103629,Sworder; David D.,9999,0,9999,0
1668020083417,ECE 200,045,103630,Taur; Yuan,9999,0,9999,0
1668020083417,ECE 200,046,103631,Touri; Behrouz,9999,0,9999,0
1668020083417,ECE 200,047,103632,Trivedi; Mohan M.,9999,0,9999,0
1668020083417,ECE 200,048,103633,Vasconcelos; Nuno,9999,0,9999,0
1668020083417,ECE 200,049,103634,Wang; Xiaolong,9999,0,9999,0
1668020083417,ECE 200,050,103635,Xie; Pengtao,9999,0,9999,0
1668020083417,ECE 200,051,103636,Yip; Michael,9999,0,9999,0
1668020083417,ECE 200,052,103637,Zeger; Kenneth A.,999,0,999,0
1668020083417,ECE 200,053,103638,Zhang; Xinyu,9999,0,9999,0
1668020083417,ECE 200,054,103639,Turakhia; Yatish Girish,9999,0,9999,0
1668020083417,ECE 200,055,103640,Kang; Mingu,9999,0,9999,0
1668020083417,ECE 200,056,103641,Shi; Yuanyuan,9999,0,9999,0
1668020083417,ECE 200,057,103642,Wang; Edward Jay,9999,0,9999,0
1668020083417,ECE 200,058,103643,Zheng; Yang,9999,0,9999,0
1668020083843,ECE 202,A00,103644,Kuzum; Duygu,0,0,0,0
1668020084264,ECE 212BN,A00,103646,Ng; Tse Nga,0,0,0,0
1668020084687,ECE 221,A00,111493,Staff,0,0,0,0
1668020085140,ECE 222B,A00,103647,Lomakin; Vitaliy,0,0,0,0
1668020085570,ECE 230B,A00,103648,Taur; Yuan,0,0,0,0
1668020086002,ECE 238B,A00,103649,Garay; Javier,0,0,0,0
1668020086430,ECE 240B,A00,112900,Fainman; Yeshaiahu,0,0,0,0
1668020086866,ECE 247A,A00,103650,Jokerst; Jesse Vincent,0,0,0,0
1668020087289,ECE 247B,A00,103651,Wang; Joseph,0,0,0,0
1668020087714,ECE 250,A00,103652,Siegel; Paul H.,0,0,0,0
1668020088139,ECE 251A,A00,103654,Rao; Bhaskar D.,0,0,0,0
1668020088564,ECE 257B,A00,103655,Bharadia; Dinesh,0,0,0,0
1668020088989,ECE 258A,A00,103656,Milstein; Laurence B.,0,0,0,0
1668020089413,ECE 260B,A00,103658,Kang; Mingu,0,0,0,0
1668020089845,ECE 264A,A00,103659,Galton; Ian A,0,0,0,0
1668020090267,ECE 265A,A00,103661,Gudem; Prasad S.S.,0,0,0,0
1668020090689,ECE 265D,A00,103662,Gudem; Prasad S.S.,0,0,0,0
1668020091120,ECE 268,A00,103663,Koushanfar; Farinaz,0,0,0,0
1668020091544,ECE 269,A01,103665,Pal; Piya,0,0,0,0
1668020091969,ECE 271B,A00,103666,Vasconcelos; Manuela,0,0,0,0
1668020092393,ECE 276A,A00,103667,Atanasov; Nikolay A.,0,0,0,0
1668020092823,ECE 277,A00,103668,An; Cheolhong,0,0,0,0
1668020093264,ECE 279,A00,117947,Hall; Drew A.,0,0,0,0
1668020094231,ECE 283,A00,103670,Hsueh; Tzu-Chien,0,0,0,0
1668020094659,ECE 284,A00,103671,Turakhia; Yatish Girish,0,0,0,0
1668020095085,ECE 285,A00,103672,Zheng; Yang,0,0,0,0
1668020095085,ECE 285,B00,103673,Sworder; David D.,0,0,0,0
1668020095522,ECE 287,A00,103676,Javidi; Tara,0,0,0,0
1668020095960,MATH 200B,A00,098023,Salehi Golsefidy; Alireza,14,0,15,1
1668020096383,MATH 202B,A00,098024,Rhoades; Brendon Patrick,11,0,15,4
1668020096808,MATH 203B,A00,098025,Oprea; Dragos N.,11,0,15,4
1668020097240,MATH 204B,A00,098026,Sorensen; Claus M,14,0,15,1
1668020097671,MATH 208,A00,098027,Izadi; Elham,7,0,10,3
1668020098101,MATH 209,A00,098028,Pollack; Aaron,10,0,10,0
1668020098526,MATH 211A,A00,112919,Rogalski; Daniel,9,0,10,1
1668020098951,MATH 211B,A00,112920,Seward; Brandon M.,9,0,10,1
1668020099379,MATH 218,A00,098029,Li; Bo,10,0,10,0
1668020099802,MATH 220B,A00,098030,Novak; Jonathan I,13,0,15,2
1668020100227,MATH 221A,A00,098031,Ebenfelt; Peter F,13,0,15,2
1668020100663,MATH 231B,A00,098032,Zlatos; Andrej,12,0,15,3
1668020101093,MATH 240B,A00,098033,Ni; Lei,9,0,15,6
1668020101534,MATH 243,A00,098034,Jekel; David Andrew,10,0,10,0
1668020101962,MATH 245A,A00,098035,Nie; Jiawang,0,0,15,16
1668020102400,MATH 248,A00,098036,Bejenaru; Ioan,10,0,10,0
1668020102822,MATH 250B,A00,098037,Spolaor; Luca,14,0,15,1
1668020103254,MATH 258,A00,098038,Ni; Lei,10,0,10,0
1668020103676,MATH 264B,A00,098041,Rhoades; Brendon Patrick,10,0,15,5
1668020104101,MATH 268,A00,098042,Buss; Samuel R,10,0,10,0
1668020104529,MATH 269,A00,098043,Rhoades; Brendon Patrick,10,0,10,0
1668020104956,MATH 270B,A00,098044,Li; Bo,11,0,15,4
1668020105386,MATH 272B,A00,098045,Holst; Michael J,13,0,15,2
1668020105817,MATH 273A,A00,098046,Tian; Xiaochuan,10,0,15,5
1668020106245,MATH 275,A01,098048,Tian; Xiaochuan,6,0,10,4
1668020106684,MATH 278A,A00,098049,Holst; Michael J,8,0,10,2
1668020107108,MATH 278B,A00,098050,Cloninger; Alexander,10,0,10,0
1668020107530,MATH 278C,A00,098051,Nie; Jiawang,8,0,10,2
1668020107956,MATH 280B,A00,098052,Zheng; Tianyi,11,0,15,4
1668020108401,MATH 281B,A00,098053,Bradic; Jelena,4,0,15,11
1668020108832,MATH 282B,A00,098054,Arias-Castro; Ery,2,0,15,13
1668020109258,MATH 285,A00,098055,Fitzsimmons; Patrick J,0,0,15,17
1668020109682,MATH 287B,A00,098056,Arias-Castro; Ery,4,0,15,11
1668020110126,MATH 288,A00,098057,Agarwal; Pooja,9,0,10,1
1668020110126,MATH 288,B00,098058,Zhang; Danna,9,0,10,1
1668020110126,MATH 288,C00,098059,Williams; Ruth J,10,0,10,0
1668020110556,MATH 290B,A00,098060,Roberts; Justin Deritter,13,0,15,2
1668020110980,MATH 292,A00,098061,Belmont; Eva Kinoshita,10,0,10,0
1668020111415,MATH 295,A00,098062,Suk; Andrew Hoon,48,0,50,2
1668020111839,MATH 296,A00,098063,Novak; Jonathan I,20,0,20,0
1668020112264,MATH 297,001,098064,Gamst; Anthony Collins,9997,0,9999,2
1668020627074,COGS 205,A00,101395,Chiba; Andrea,19,0,20,1
1668020627497,COGS 210B,001,101404,Greene; Deanna Jacquelyn,9998,0,9999,1
1668020627497,COGS 210B,002,101417,Xia; Haijun,9999,0,9999,0
1668020627497,COGS 210B,003,101422,Nitz; Douglas A.,9999,0,9999,0
1668020627497,COGS 210B,004,101423,Hollan; James D.,9998,0,9999,1
1668020627497,COGS 210B,005,101424,Deak; Gedeon O.,9999,0,9999,0
1668020627497,COGS 210B,006,101425,Rossano; Federico,9999,0,9999,0
1668020627920,COGS 211B,A00,101427,Coulson; Seana M,9997,0,9999,2
1668020628345,COGS 220,A00,101428,Hollan; James D.,0,0,25,25
1668020628770,COGS 229,A00,101429,Dow; Steven P,18,0,25,7
1668020629300,COGS 230,A00,101430,Klemmer; Scott R,13,0,17,4
1668020629734,COGS 234,A00,101431,Xia; Haijun,5,0,25,20
1668020630171,COGS 260,A00,101432,Kiyonaga; Anastasia,20,0,25,5
1668020630171,COGS 260,B00,101433,Kirsh; David Joel,16,0,25,9
1668020630593,CSE 202,A00,102371,Impagliazzo; Russell,0,0,0,0
1668020631016,CSE 203B,A01,102373,Cheng; Chung Kuan,0,0,0,0
1668020631438,CSE 208,A00,102374,Micciancio; Daniele,0,0,0,0
1668020631862,CSE 209A,A00,112895,Impagliazzo; Russell,0,0,15,15
1668020632296,CSE 209B,A00,108005,Bellare; Mihir,0,0,0,0
1668020632723,CSE 210,A00,113163,Coblenz; Michael J,0,0,0,0
1668020633144,CSE 219,A00,106111,Dow; Steven P,0,0,20,20
1668020633582,CSE 221,A00,102376,Voelker; Geoffrey M.,0,0,0,0
1668020634015,CSE 224,A01,102378,Porter; George M,0,0,0,0
1668020634442,CSE 229A,A00,102379,Savage; Stefan,0,0,0,0
1668020634866,CSE 229C,A00,102380,Munyaka; Imani N. S.,0,0,0,0
1668020635298,CSE 232B,A00,102382,Deutsch; Alin Bernard,0,0,0,0
1668020635733,CSE 234,A01,112904,Kumar; Arun Kumar,0,0,0,0
1668020636161,CSE 237A,A00,102383,Rosing; Tajana Simunic,0,0,0,0
1668020636585,CSE 239A,A00,102384,Deutsch; Alin Bernard,0,0,0,0
1668020637019,CSE 239B,A00,102385,Polikarpova; Nadezhda,0,0,0,0
1668020637447,CSE 240A,A00,102386,Pannuto; Patrick William,0,0,0,0
1668020637871,CSE 240B,A00,102387,Zhao; Jishen,0,0,0,0
1668020638296,CSE 241A,A00,106406,Kang; Mingu,0,0,0,0
1668020638723,CSE 249B,A00,102388,Kahng; Andrew Byun,0,0,8,8
1668020639155,CSE 251B,A01,102392,Cottrell; Garrison W,0,0,0,0
1668020639155,CSE 251B,A02,102393,Cottrell; Garrison W,0,0,0,0
1668020639580,CSE 252B,A00,102394,Ochoa; Benjamin Lawrence,0,0,0,0
1668020640024,CSE 257,A01,102396,Gao; Sicun,0,0,0,0
1668020640453,CSE 272,A00,102397,Li; Tzumao,0,0,0,0
1668020640887,CSE 274,A00,111323,Chern; Albert Ren-Haur,0,0,0,0
1668020641322,CSE 282,A00,102398,Pevzner; Pavel Arkadjevich,0,0,0,0
1668020641756,CSE 284,A00,114175,Gymrek; Melissa Ann,0,0,0,0
1668020642186,CSE 290,A00,102399,Chandraker; Manmohan Krishna,0,0,0,0
1668020642186,CSE 290,B00,102400,Vaccaro; Kristen Marie,0,0,25,25
1668020642186,CSE 290,C00,102414,Pannuto; Patrick William,0,0,25,25
1668020642186,CSE 290,D00,102427,Pevzner; Pavel Arkadjevich,0,0,0,0
1668020642186,CSE 290,E00,102429,Zhao; Jishen,0,0,0,0
1668020642186,CSE 290,F00,102436,Tullsen; Dean Michael,0,0,0,0
1668020642186,CSE 290,G00,102440,Christensen; Henrik I,0,0,20,20
1668020642620,CSE 291,A00,102443,Su; Hao,0,0,0,0
1668020642620,CSE 291,B00,102448,Polikarpova; Nadezhda,0,0,0,0
1668020642620,CSE 291,C00,102453,Vaccaro; Kristen Marie,0,0,0,0
1668020642620,CSE 291,D00,111343,Savage; Stefan,0,0,0,0
1668020642620,CSE 291,E00,116474,Claffy; Kimberly Claire,0,0,0,0
1668020642620,CSE 291,F00,116479,Pasquale; Joseph,0,0,0,0
1668020643079,CSE 293,001,119111,Bafna; Vineet,9999,0,9999,0
1668020643079,CSE 293,002,119118,Bellare; Mihir,9999,0,9999,0
1668020643079,CSE 293,003,119122,Berg-Kirkpatrick; Taylor D,9999,0,9999,0
1668020643079,CSE 293,004,119135,Christensen; Henrik I,9999,0,9999,0
1668020643079,CSE 293,005,119142,Cottrell; Garrison W,9999,0,9999,0
1668020643079,CSE 293,006,119146,Deutsch; Alin Bernard,9999,0,9999,0
1668020643079,CSE 293,007,119159,Esmaeilzadeh; Hadi,9999,0,9999,0
1668020643079,CSE 293,008,119166,Freund; Yoav,9999,0,9999,0
1668020643079,CSE 293,009,119170,Griswold; William G.,9999,0,9999,0
1668020643079,CSE 293,010,119183,Gymrek; Melissa Ann,9999,0,9999,0
1668020643079,CSE 293,011,119190,Heninger; Nadia A,9999,0,9999,0
1668020643079,CSE 293,012,119230,Impagliazzo; Russell,9999,0,9999,0
1668020643079,CSE 293,013,119232,Jhala; Ranjit,9999,0,9999,0
1668020643079,CSE 293,014,119233,Kahng; Andrew Byun,9999,0,9999,0
1668020643079,CSE 293,015,119298,Kane; Daniel Mertz,9999,0,9999,0
1668020643079,CSE 293,016,119299,Kriegman; David J,9999,0,9999,0
1668020643079,CSE 293,017,119300,Kumar; Arun Kumar,9999,0,9999,0
1668020643079,CSE 293,018,119301,Lerner; Sorin,9999,0,9999,0
1668020643079,CSE 293,019,119302,Lovett; Shachar,9999,0,9999,0
1668020643079,CSE 293,020,119303,McAuley; Julian John,9999,0,9999,0
1668020643079,CSE 293,021,119304,Micciancio; Daniele,9999,0,9999,0
1668020643079,CSE 293,022,119367,Orailoglu; Alex,9999,0,9999,0
1668020643079,CSE 293,023,119382,Paturi; Ramamohan,9999,0,9999,0
1668020643079,CSE 293,024,119404,Polikarpova; Nadezhda,9999,0,9999,0
1668020643079,CSE 293,025,119406,Politz; Joseph Gibbs,9999,0,9999,0
1668020643079,CSE 293,026,119411,Porter; George M,9999,0,9999,0
1668020643079,CSE 293,027,119414,Porter; Leonard Emerson,9999,0,9999,0
1668020643079,CSE 293,028,119416,Ramamoorthi; Ravi,9999,0,9999,0
1668020643079,CSE 293,029,119417,Sahoo; Debashis,9999,0,9999,0
1668020643079,CSE 293,030,119420,Saul; Lawrence,9999,0,9999,0
1668020643079,CSE 293,031,119421,Savage; Stefan,9999,0,9999,0
1668020643079,CSE 293,032,119425,Schulze; Jurgen P.,9999,0,9999,0
1668020643079,CSE 293,033,119426,Snoeren; Alex C.,9999,0,9999,0
1668020643079,CSE 293,034,119428,Shang; Jingbo,9999,0,9999,0
1668020643079,CSE 293,035,119430,Stefan; Deian,9999,0,9999,0
1668020643079,CSE 293,036,119431,Su; Hao,9999,0,9999,0
1668020643079,CSE 293,037,119433,Swanson; Steven James,9999,0,9999,0
1668020643079,CSE 293,038,119435,Tullsen; Dean Michael,9999,0,9999,0
1668020643079,CSE 293,039,119483,Voelker; Geoffrey M.,9999,0,9999,0
1668020643079,CSE 293,040,119537,Zhao; Jishen,9999,0,9999,0
1668020643079,CSE 293,041,119538,Zhou; Yuan-Yuan,9999,0,9999,0
1668020643079,CSE 293,042,119539,Gao; Sicun,9999,0,9999,0
1668020643079,CSE 293,043,119540,Weibel; Nadir,9999,0,9999,0
1668020643079,CSE 293,044,119541,Gupta; Rajesh K.,9999,0,9999,0
1668020643079,CSE 293,045,126410,Vaccaro; Kristen Marie,9999,0,9999,0
1668020643079,CSE 293,046,126411,Klemke; Richard,9999,0,9999,0
1668020643507,CSE 294,A00,102459,Voelker; Geoffrey M.,0,0,0,0
1668020643507,CSE 294,B00,111322,Orailoglu; Alex,0,0,0,0
1668020643940,DSE 201,A00,096914,Deutsch; Alin Bernard,30,0,30,0
1668020644374,DSE 210,A00,096915,Dasgupta; Sanjoy,30,0,30,0
1668020644829,DSE 260A,A00,096916,Altintas De Callaf; Ilkay,30,0,30,0
1668020645287,ECE 200,001,103586,Antipa; Nicholas A,9999,0,9999,0
1668020645287,ECE 200,002,103587,Atanasov; Nikolay A.,9999,0,9999,0
1668020645287,ECE 200,003,103588,Bharadia; Dinesh,9999,0,9999,0
1668020645287,ECE 200,004,103589,Cheng; Chung Kuan,9999,0,9999,0
1668020645287,ECE 200,005,103590,Cosman; Pamela C.,9999,0,9999,0
1668020645287,ECE 200,006,103591,Dayeh; Shadi Ahmad,9999,0,9999,0
1668020645287,ECE 200,007,103592,Fainman; Yeshaiahu,9999,0,9999,0
1668020645287,ECE 200,008,103593,Ford; Joseph Earl,9999,0,9999,0
1668020645287,ECE 200,009,103594,Franceschetti; Massimo,9999,0,9999,0
1668020645287,ECE 200,010,103595,Fullerton; Eric E,9999,0,9999,0
1668020645287,ECE 200,011,103596,Galton; Ian A,9999,0,9999,0
1668020645287,ECE 200,012,103597,Gilja; Vikash,9999,0,9999,0
1668020645287,ECE 200,013,103598,Hall; Drew A.,9999,0,9999,0
1668020645287,ECE 200,014,103599,Hsueh; Tzu-Chien,9999,0,9999,0
1668020645287,ECE 200,015,103600,Javidi; Tara,9999,0,9999,0
1668020645287,ECE 200,016,103601,Kahng; Andrew Byun,9999,0,9999,0
1668020645287,ECE 200,017,103602,Kim; Young-Han,9999,0,9999,0
1668020645287,ECE 200,018,103603,Koushanfar; Farinaz,9999,0,9999,0
1668020645287,ECE 200,019,103604,Kuzum; Duygu,9999,0,9999,0
1668020645287,ECE 200,020,103605,Le; Hanh-Phuc,9999,0,9999,0
1668020645287,ECE 200,021,103606,Lin; Bill,9999,0,9999,0
1668020645287,ECE 200,022,103607,Liu; Zhaowei,9998,0,9999,1
1668020645287,ECE 200,023,103608,Lo; Yu-Hwa,9999,0,9999,0
1668020645287,ECE 200,024,103609,Lomakin; Vitaliy,9999,0,9999,0
1668020645287,ECE 200,025,103610,Mercier; Patrick Philip,9999,0,9999,0
1668020645287,ECE 200,026,103611,Meyer; Florian,9999,0,9999,0
1668020645287,ECE 200,027,103612,Milstein; Laurence B.,9999,0,9999,0
1668020645287,ECE 200,028,103613,Mir Arabbaygi; Siavash,9999,0,9999,0
1668020645287,ECE 200,029,103614,Mookherjea; Shayan,9999,0,9999,0
1668020645287,ECE 200,030,103615,Morris; Karcher William,9999,0,9999,0
1668020645287,ECE 200,031,103616,Ng; Tse Nga,9999,0,9999,0
1668020645287,ECE 200,032,103617,Nguyen; Truong Quang,9999,0,9999,0
1668020645287,ECE 200,033,103618,Nomura; Kenji,9999,0,9999,0
1668020645287,ECE 200,034,103619,Orlitsky; Alon,9999,0,9999,0
1668020645287,ECE 200,035,103620,Pal; Piya,9999,0,9999,0
1668020645287,ECE 200,036,103621,Papen; George C.,9999,0,9999,0
1668020645287,ECE 200,037,103622,Radic; Stojan,9999,0,9999,0
1668020645287,ECE 200,038,103623,Rao; Bhaskar D.,9999,0,9999,0
1668020645287,ECE 200,039,103624,Rao; Ramesh R,9999,0,9999,0
1668020645287,ECE 200,040,103625,Rebeiz; Gabriel,9999,0,9999,0
1668020645287,ECE 200,041,103626,Sanford; John R,9999,0,9999,0
1668020645287,ECE 200,042,103627,Siegel; Paul H.,9999,0,9999,0
1668020645287,ECE 200,043,103628,Sievenpiper; Daniel F.,9999,0,9999,0
1668020645287,ECE 200,044,103629,Sworder; David D.,9999,0,9999,0
1668020645287,ECE 200,045,103630,Taur; Yuan,9999,0,9999,0
1668020645287,ECE 200,046,103631,Touri; Behrouz,9999,0,9999,0
1668020645287,ECE 200,047,103632,Trivedi; Mohan M.,9999,0,9999,0
1668020645287,ECE 200,048,103633,Vasconcelos; Nuno,9999,0,9999,0
1668020645287,ECE 200,049,103634,Wang; Xiaolong,9999,0,9999,0
1668020645287,ECE 200,050,103635,Xie; Pengtao,9999,0,9999,0
1668020645287,ECE 200,051,103636,Yip; Michael,9999,0,9999,0
1668020645287,ECE 200,052,103637,Zeger; Kenneth A.,999,0,999,0
1668020645287,ECE 200,053,103638,Zhang; Xinyu,9999,0,9999,0
1668020645287,ECE 200,054,103639,Turakhia; Yatish Girish,9999,0,9999,0
1668020645287,ECE 200,055,103640,Kang; Mingu,9999,0,9999,0
1668020645287,ECE 200,056,103641,Shi; Yuanyuan,9999,0,9999,0
1668020645287,ECE 200,057,103642,Wang; Edward Jay,9999,0,9999,0
1668020645287,ECE 200,058,103643,Zheng; Yang,9999,0,9999,0
1668020645716,ECE 202,A00,103644,Kuzum; Duygu,0,0,0,0
1668020646140,ECE 212BN,A00,103646,Ng; Tse Nga,0,0,0,0
1668020646567,ECE 221,A00,111493,Staff,0,0,0,0
1668020646991,ECE 222B,A00,103647,Lomakin; Vitaliy,0,0,0,0
1668020647416,ECE 230B,A00,103648,Taur; Yuan,0,0,0,0
1668020647852,ECE 238B,A00,103649,Garay; Javier,0,0,0,0
1668020648276,ECE 240B,A00,112900,Fainman; Yeshaiahu,0,0,0,0
1668020648706,ECE 247A,A00,103650,Jokerst; Jesse Vincent,0,0,0,0
1668020649144,ECE 247B,A00,103651,Wang; Joseph,0,0,0,0
1668020649573,ECE 250,A00,103652,Siegel; Paul H.,0,0,0,0
1668020650002,ECE 251A,A00,103654,Rao; Bhaskar D.,0,0,0,0
1668020650431,ECE 257B,A00,103655,Bharadia; Dinesh,0,0,0,0
1668020650861,ECE 258A,A00,103656,Milstein; Laurence B.,0,0,0,0
1668020651297,ECE 260B,A00,103658,Kang; Mingu,0,0,0,0
1668020651719,ECE 264A,A00,103659,Galton; Ian A,0,0,0,0
1668020652147,ECE 265A,A00,103661,Gudem; Prasad S.S.,0,0,0,0
1668020652571,ECE 265D,A00,103662,Gudem; Prasad S.S.,0,0,0,0
1668020652993,ECE 268,A00,103663,Koushanfar; Farinaz,0,0,0,0
1668020653420,ECE 269,A01,103665,Pal; Piya,0,0,0,0
1668020653858,ECE 271B,A00,103666,Vasconcelos; Manuela,0,0,0,0
1668020654281,ECE 276A,A00,103667,Atanasov; Nikolay A.,0,0,0,0
1668020654704,ECE 277,A00,103668,An; Cheolhong,0,0,0,0
1668020655128,ECE 279,A00,117947,Hall; Drew A.,0,0,0,0
1668020655974,ECE 283,A00,103670,Hsueh; Tzu-Chien,0,0,0,0
1668020656403,ECE 284,A00,103671,Turakhia; Yatish Girish,0,0,0,0
1668020656835,ECE 285,A00,103672,Zheng; Yang,0,0,0,0
1668020656835,ECE 285,B00,103673,Sworder; David D.,0,0,0,0
1668020657260,ECE 287,A00,103676,Javidi; Tara,0,0,0,0
1668020657691,MATH 200B,A00,098023,Salehi Golsefidy; Alireza,14,0,15,1
1668020658127,MATH 202B,A00,098024,Rhoades; Brendon Patrick,11,0,15,4
1668020658563,MATH 203B,A00,098025,Oprea; Dragos N.,11,0,15,4
1668020658984,MATH 204B,A00,098026,Sorensen; Claus M,14,0,15,1
1668020659415,MATH 208,A00,098027,Izadi; Elham,7,0,10,3
1668020659856,MATH 209,A00,098028,Pollack; Aaron,10,0,10,0
1668020660285,MATH 211A,A00,112919,Rogalski; Daniel,9,0,10,1
1668020660718,MATH 211B,A00,112920,Seward; Brandon M.,9,0,10,1
1668020661146,MATH 218,A00,098029,Li; Bo,10,0,10,0
1668020661573,MATH 220B,A00,098030,Novak; Jonathan I,13,0,15,2
1668020662010,MATH 221A,A00,098031,Ebenfelt; Peter F,13,0,15,2
1668020662451,MATH 231B,A00,098032,Zlatos; Andrej,12,0,15,3
1668020662872,MATH 240B,A00,098033,Ni; Lei,9,0,15,6
1668020663297,MATH 243,A00,098034,Jekel; David Andrew,10,0,10,0
1668020663723,MATH 245A,A00,098035,Nie; Jiawang,0,0,15,16
1668020664158,MATH 248,A00,098036,Bejenaru; Ioan,10,0,10,0
1668020664586,MATH 250B,A00,098037,Spolaor; Luca,14,0,15,1
1668020665014,MATH 258,A00,098038,Ni; Lei,10,0,10,0
1668020665452,MATH 264B,A00,098041,Rhoades; Brendon Patrick,10,0,15,5
1668020665878,MATH 268,A00,098042,Buss; Samuel R,10,0,10,0
1668020666303,MATH 269,A00,098043,Rhoades; Brendon Patrick,10,0,10,0
1668020666735,MATH 270B,A00,098044,Li; Bo,11,0,15,4
1668020667158,MATH 272B,A00,098045,Holst; Michael J,13,0,15,2
1668020667585,MATH 273A,A00,098046,Tian; Xiaochuan,10,0,15,5
1668020668010,MATH 275,A01,098048,Tian; Xiaochuan,6,0,10,4
1668020668433,MATH 278A,A00,098049,Holst; Michael J,8,0,10,2
1668020668857,MATH 278B,A00,098050,Cloninger; Alexander,10,0,10,0
1668020669294,MATH 278C,A00,098051,Nie; Jiawang,8,0,10,2
1668020669730,MATH 280B,A00,098052,Zheng; Tianyi,11,0,15,4
1668020670156,MATH 281B,A00,098053,Bradic; Jelena,4,0,15,11
1668020670602,MATH 282B,A00,098054,Arias-Castro; Ery,2,0,15,13
1668020671027,MATH 285,A00,098055,Fitzsimmons; Patrick J,0,0,15,17
1668020671448,MATH 287B,A00,098056,Arias-Castro; Ery,4,0,15,11
1668020671870,MATH 288,A00,098057,Agarwal; Pooja,9,0,10,1
1668020671870,MATH 288,B00,098058,Zhang; Danna,9,0,10,1
1668020671870,MATH 288,C00,098059,Williams; Ruth J,10,0,10,0
1668020672294,MATH 290B,A00,098060,Roberts; Justin Deritter,13,0,15,2
1668020672819,MATH 292,A00,098061,Belmont; Eva Kinoshita,10,0,10,0
1668020673252,MATH 295,A00,098062,Suk; Andrew Hoon,48,0,50,2
1668020673684,MATH 296,A00,098063,Novak; Jonathan I,20,0,20,0
1668020674113,MATH 297,001,098064,Gamst; Anthony Collins,9997,0,9999,2
1668021178517,COGS 205,A00,101395,Chiba; Andrea,19,0,20,1
1668021178948,COGS 210B,001,101404,Greene; Deanna Jacquelyn,9998,0,9999,1
1668021178948,COGS 210B,002,101417,Xia; Haijun,9999,0,9999,0
1668021178948,COGS 210B,003,101422,Nitz; Douglas A.,9999,0,9999,0
1668021178948,COGS 210B,004,101423,Hollan; James D.,9998,0,9999,1
1668021178948,COGS 210B,005,101424,Deak; Gedeon O.,9999,0,9999,0
1668021178948,COGS 210B,006,101425,Rossano; Federico,9999,0,9999,0
1668021179371,COGS 211B,A00,101427,Coulson; Seana M,9997,0,9999,2
1668021179815,COGS 220,A00,101428,Hollan; James D.,0,0,25,25
1668021180243,COGS 229,A00,101429,Dow; Steven P,18,0,25,7
1668021180685,COGS 230,A00,101430,Klemmer; Scott R,13,0,17,4
1668021181113,COGS 234,A00,101431,Xia; Haijun,5,0,25,20
1668021181560,COGS 260,A00,101432,Kiyonaga; Anastasia,20,0,25,5
1668021181560,COGS 260,B00,101433,Kirsh; David Joel,16,0,25,9
1668021181987,CSE 202,A00,102371,Impagliazzo; Russell,0,0,0,0
1668021182422,CSE 203B,A01,102373,Cheng; Chung Kuan,0,0,0,0
1668021182856,CSE 208,A00,102374,Micciancio; Daniele,0,0,0,0
1668021183282,CSE 209A,A00,112895,Impagliazzo; Russell,0,0,15,15
1668021183707,CSE 209B,A00,108005,Bellare; Mihir,0,0,0,0
1668021184144,CSE 210,A00,113163,Coblenz; Michael J,0,0,0,0
1668021184573,CSE 219,A00,106111,Dow; Steven P,0,0,20,20
1668021184995,CSE 221,A00,102376,Voelker; Geoffrey M.,0,0,0,0
1668021185430,CSE 224,A01,102378,Porter; George M,0,0,0,0
1668021185863,CSE 229A,A00,102379,Savage; Stefan,0,0,0,0
1668021186298,CSE 229C,A00,102380,Munyaka; Imani N. S.,0,0,0,0
1668021186731,CSE 232B,A00,102382,Deutsch; Alin Bernard,0,0,0,0
1668021187165,CSE 234,A01,112904,Kumar; Arun Kumar,0,0,0,0
1668021187600,CSE 237A,A00,102383,Rosing; Tajana Simunic,0,0,0,0
1668021188025,CSE 239A,A00,102384,Deutsch; Alin Bernard,0,0,0,0
1668021188446,CSE 239B,A00,102385,Polikarpova; Nadezhda,0,0,0,0
1668021188870,CSE 240A,A00,102386,Pannuto; Patrick William,0,0,0,0
1668021189310,CSE 240B,A00,102387,Zhao; Jishen,0,0,0,0
1668021189736,CSE 241A,A00,106406,Kang; Mingu,0,0,0,0
1668021190179,CSE 249B,A00,102388,Kahng; Andrew Byun,0,0,8,8
1668021190606,CSE 251B,A01,102392,Cottrell; Garrison W,0,0,0,0
1668021190606,CSE 251B,A02,102393,Cottrell; Garrison W,0,0,0,0
1668021191028,CSE 252B,A00,102394,Ochoa; Benjamin Lawrence,0,0,0,0
1668021191454,CSE 257,A01,102396,Gao; Sicun,0,0,0,0
1668021191890,CSE 272,A00,102397,Li; Tzumao,0,0,0,0
1668021192313,CSE 274,A00,111323,Chern; Albert Ren-Haur,0,0,0,0
1668021192737,CSE 282,A00,102398,Pevzner; Pavel Arkadjevich,0,0,0,0
1668021193161,CSE 284,A00,114175,Gymrek; Melissa Ann,0,0,0,0
1668021193593,CSE 290,A00,102399,Chandraker; Manmohan Krishna,0,0,0,0
1668021193593,CSE 290,B00,102400,Vaccaro; Kristen Marie,0,0,25,25
1668021193593,CSE 290,C00,102414,Pannuto; Patrick William,0,0,25,25
1668021193593,CSE 290,D00,102427,Pevzner; Pavel Arkadjevich,0,0,0,0
1668021193593,CSE 290,E00,102429,Zhao; Jishen,0,0,0,0
1668021193593,CSE 290,F00,102436,Tullsen; Dean Michael,0,0,0,0
1668021193593,CSE 290,G00,102440,Christensen; Henrik I,0,0,20,20
1668021194020,CSE 291,A00,102443,Su; Hao,0,0,0,0
1668021194020,CSE 291,B00,102448,Polikarpova; Nadezhda,0,0,0,0
1668021194020,CSE 291,C00,102453,Vaccaro; Kristen Marie,0,0,0,0
1668021194020,CSE 291,D00,111343,Savage; Stefan,0,0,0,0
1668021194020,CSE 291,E00,116474,Claffy; Kimberly Claire,0,0,0,0
1668021194020,CSE 291,F00,116479,Pasquale; Joseph,0,0,0,0
1668021194458,CSE 293,001,119111,Bafna; Vineet,9999,0,9999,0
1668021194458,CSE 293,002,119118,Bellare; Mihir,9999,0,9999,0
1668021194458,CSE 293,003,119122,Berg-Kirkpatrick; Taylor D,9999,0,9999,0
1668021194458,CSE 293,004,119135,Christensen; Henrik I,9999,0,9999,0
1668021194458,CSE 293,005,119142,Cottrell; Garrison W,9999,0,9999,0
1668021194458,CSE 293,006,119146,Deutsch; Alin Bernard,9999,0,9999,0
1668021194458,CSE 293,007,119159,Esmaeilzadeh; Hadi,9999,0,9999,0
1668021194458,CSE 293,008,119166,Freund; Yoav,9999,0,9999,0
1668021194458,CSE 293,009,119170,Griswold; William G.,9999,0,9999,0
1668021194458,CSE 293,010,119183,Gymrek; Melissa Ann,9999,0,9999,0
1668021194458,CSE 293,011,119190,Heninger; Nadia A,9999,0,9999,0
1668021194458,CSE 293,012,119230,Impagliazzo; Russell,9999,0,9999,0
1668021194458,CSE 293,013,119232,Jhala; Ranjit,9999,0,9999,0
1668021194458,CSE 293,014,119233,Kahng; Andrew Byun,9999,0,9999,0
1668021194458,CSE 293,015,119298,Kane; Daniel Mertz,9999,0,9999,0
1668021194458,CSE 293,016,119299,Kriegman; David J,9999,0,9999,0
1668021194458,CSE 293,017,119300,Kumar; Arun Kumar,9999,0,9999,0
1668021194458,CSE 293,018,119301,Lerner; Sorin,9999,0,9999,0
1668021194458,CSE 293,019,119302,Lovett; Shachar,9999,0,9999,0
1668021194458,CSE 293,020,119303,McAuley; Julian John,9999,0,9999,0
1668021194458,CSE 293,021,119304,Micciancio; Daniele,9999,0,9999,0
1668021194458,CSE 293,022,119367,Orailoglu; Alex,9999,0,9999,0
1668021194458,CSE 293,023,119382,Paturi; Ramamohan,9999,0,9999,0
1668021194458,CSE 293,024,119404,Polikarpova; Nadezhda,9999,0,9999,0
1668021194458,CSE 293,025,119406,Politz; Joseph Gibbs,9999,0,9999,0
1668021194458,CSE 293,026,119411,Porter; George M,9999,0,9999,0
1668021194458,CSE 293,027,119414,Porter; Leonard Emerson,9999,0,9999,0
1668021194458,CSE 293,028,119416,Ramamoorthi; Ravi,9999,0,9999,0
1668021194458,CSE 293,029,119417,Sahoo; Debashis,9999,0,9999,0
1668021194458,CSE 293,030,119420,Saul; Lawrence,9999,0,9999,0
1668021194458,CSE 293,031,119421,Savage; Stefan,9999,0,9999,0
1668021194458,CSE 293,032,119425,Schulze; Jurgen P.,9999,0,9999,0
1668021194458,CSE 293,033,119426,Snoeren; Alex C.,9999,0,9999,0
1668021194458,CSE 293,034,119428,Shang; Jingbo,9999,0,9999,0
1668021194458,CSE 293,035,119430,Stefan; Deian,9999,0,9999,0
1668021194458,CSE 293,036,119431,Su; Hao,9999,0,9999,0
1668021194458,CSE 293,037,119433,Swanson; Steven James,9999,0,9999,0
1668021194458,CSE 293,038,119435,Tullsen; Dean Michael,9999,0,9999,0
1668021194458,CSE 293,039,119483,Voelker; Geoffrey M.,9999,0,9999,0
1668021194458,CSE 293,040,119537,Zhao; Jishen,9999,0,9999,0
1668021194458,CSE 293,041,119538,Zhou; Yuan-Yuan,9999,0,9999,0
1668021194458,CSE 293,042,119539,Gao; Sicun,9999,0,9999,0
1668021194458,CSE 293,043,119540,Weibel; Nadir,9999,0,9999,0
1668021194458,CSE 293,044,119541,Gupta; Rajesh K.,9999,0,9999,0
1668021194458,CSE 293,045,126410,Vaccaro; Kristen Marie,9999,0,9999,0
1668021194458,CSE 293,046,126411,Klemke; Richard,9999,0,9999,0
1668021194887,CSE 294,A00,102459,Voelker; Geoffrey M.,0,0,0,0
1668021194887,CSE 294,B00,111322,Orailoglu; Alex,0,0,0,0
1668021195319,DSE 201,A00,096914,Deutsch; Alin Bernard,30,0,30,0
1668021195743,DSE 210,A00,096915,Dasgupta; Sanjoy,30,0,30,0
1668021196182,DSE 260A,A00,096916,Altintas De Callaf; Ilkay,30,0,30,0
1668021196637,ECE 200,001,103586,Antipa; Nicholas A,9999,0,9999,0
1668021196637,ECE 200,002,103587,Atanasov; Nikolay A.,9999,0,9999,0
1668021196637,ECE 200,003,103588,Bharadia; Dinesh,9999,0,9999,0
1668021196637,ECE 200,004,103589,Cheng; Chung Kuan,9999,0,9999,0
1668021196637,ECE 200,005,103590,Cosman; Pamela C.,9999,0,9999,0
1668021196637,ECE 200,006,103591,Dayeh; Shadi Ahmad,9999,0,9999,0
1668021196637,ECE 200,007,103592,Fainman; Yeshaiahu,9999,0,9999,0
1668021196637,ECE 200,008,103593,Ford; Joseph Earl,9999,0,9999,0
1668021196637,ECE 200,009,103594,Franceschetti; Massimo,9999,0,9999,0
1668021196637,ECE 200,010,103595,Fullerton; Eric E,9999,0,9999,0
1668021196637,ECE 200,011,103596,Galton; Ian A,9999,0,9999,0
1668021196637,ECE 200,012,103597,Gilja; Vikash,9999,0,9999,0
1668021196637,ECE 200,013,103598,Hall; Drew A.,9999,0,9999,0
1668021196637,ECE 200,014,103599,Hsueh; Tzu-Chien,9999,0,9999,0
1668021196637,ECE 200,015,103600,Javidi; Tara,9999,0,9999,0
1668021196637,ECE 200,016,103601,Kahng; Andrew Byun,9999,0,9999,0
1668021196637,ECE 200,017,103602,Kim; Young-Han,9999,0,9999,0
1668021196637,ECE 200,018,103603,Koushanfar; Farinaz,9999,0,9999,0
1668021196637,ECE 200,019,103604,Kuzum; Duygu,9999,0,9999,0
1668021196637,ECE 200,020,103605,Le; Hanh-Phuc,9999,0,9999,0
1668021196637,ECE 200,021,103606,Lin; Bill,9999,0,9999,0
1668021196637,ECE 200,022,103607,Liu; Zhaowei,9998,0,9999,1
1668021196637,ECE 200,023,103608,Lo; Yu-Hwa,9999,0,9999,0
1668021196637,ECE 200,024,103609,Lomakin; Vitaliy,9999,0,9999,0
1668021196637,ECE 200,025,103610,Mercier; Patrick Philip,9999,0,9999,0
1668021196637,ECE 200,026,103611,Meyer; Florian,9999,0,9999,0
1668021196637,ECE 200,027,103612,Milstein; Laurence B.,9999,0,9999,0
1668021196637,ECE 200,028,103613,Mir Arabbaygi; Siavash,9999,0,9999,0
1668021196637,ECE 200,029,103614,Mookherjea; Shayan,9999,0,9999,0
1668021196637,ECE 200,030,103615,Morris; Karcher William,9999,0,9999,0
1668021196637,ECE 200,031,103616,Ng; Tse Nga,9999,0,9999,0
1668021196637,ECE 200,032,103617,Nguyen; Truong Quang,9999,0,9999,0
1668021196637,ECE 200,033,103618,Nomura; Kenji,9999,0,9999,0
1668021196637,ECE 200,034,103619,Orlitsky; Alon,9999,0,9999,0
1668021196637,ECE 200,035,103620,Pal; Piya,9999,0,9999,0
1668021196637,ECE 200,036,103621,Papen; George C.,9999,0,9999,0
1668021196637,ECE 200,037,103622,Radic; Stojan,9999,0,9999,0
1668021196637,ECE 200,038,103623,Rao; Bhaskar D.,9999,0,9999,0
1668021196637,ECE 200,039,103624,Rao; Ramesh R,9999,0,9999,0
1668021196637,ECE 200,040,103625,Rebeiz; Gabriel,9999,0,9999,0
1668021196637,ECE 200,041,103626,Sanford; John R,9999,0,9999,0
1668021196637,ECE 200,042,103627,Siegel; Paul H.,9999,0,9999,0
1668021196637,ECE 200,043,103628,Sievenpiper; Daniel F.,9999,0,9999,0
1668021196637,ECE 200,044,103629,Sworder; David D.,9999,0,9999,0
1668021196637,ECE 200,045,103630,Taur; Yuan,9999,0,9999,0
1668021196637,ECE 200,046,103631,Touri; Behrouz,9999,0,9999,0
1668021196637,ECE 200,047,103632,Trivedi; Mohan M.,9999,0,9999,0
1668021196637,ECE 200,048,103633,Vasconcelos; Nuno,9999,0,9999,0
1668021196637,ECE 200,049,103634,Wang; Xiaolong,9999,0,9999,0
1668021196637,ECE 200,050,103635,Xie; Pengtao,9999,0,9999,0
1668021196637,ECE 200,051,103636,Yip; Michael,9999,0,9999,0
1668021196637,ECE 200,052,103637,Zeger; Kenneth A.,999,0,999,0
1668021196637,ECE 200,053,103638,Zhang; Xinyu,9999,0,9999,0
1668021196637,ECE 200,054,103639,Turakhia; Yatish Girish,9999,0,9999,0
1668021196637,ECE 200,055,103640,Kang; Mingu,9999,0,9999,0
1668021196637,ECE 200,056,103641,Shi; Yuanyuan,9999,0,9999,0
1668021196637,ECE 200,057,103642,Wang; Edward Jay,9999,0,9999,0
1668021196637,ECE 200,058,103643,Zheng; Yang,9999,0,9999,0
1668021197067,ECE 202,A00,103644,Kuzum; Duygu,0,0,0,0
1668021197599,ECE 212BN,A00,103646,Ng; Tse Nga,0,0,0,0
1668021198033,ECE 221,A00,111493,Staff,0,0,0,0
1668021198456,ECE 222B,A00,103647,Lomakin; Vitaliy,0,0,0,0
1668021198899,ECE 230B,A00,103648,Taur; Yuan,0,0,0,0
1668021199334,ECE 238B,A00,103649,Garay; Javier,0,0,0,0
1668021199756,ECE 240B,A00,112900,Fainman; Yeshaiahu,0,0,0,0
1668021200179,ECE 247A,A00,103650,Jokerst; Jesse Vincent,0,0,0,0
1668021200604,ECE 247B,A00,103651,Wang; Joseph,0,0,0,0
1668021201044,ECE 250,A00,103652,Siegel; Paul H.,0,0,0,0
1668021201472,ECE 251A,A00,103654,Rao; Bhaskar D.,0,0,0,0
1668021201898,ECE 257B,A00,103655,Bharadia; Dinesh,0,0,0,0
1668021202324,ECE 258A,A00,103656,Milstein; Laurence B.,0,0,0,0
1668021202755,ECE 260B,A00,103658,Kang; Mingu,0,0,0,0
1668021203183,ECE 264A,A00,103659,Galton; Ian A,0,0,0,0
1668021203609,ECE 265A,A00,103661,Gudem; Prasad S.S.,0,0,0,0
1668021204032,ECE 265D,A00,103662,Gudem; Prasad S.S.,0,0,0,0
1668021204454,ECE 268,A00,103663,Koushanfar; Farinaz,0,0,0,0
1668021204897,ECE 269,A01,103665,Pal; Piya,0,0,0,0
1668021205326,ECE 271B,A00,103666,Vasconcelos; Manuela,0,0,0,0
1668021205755,ECE 276A,A00,103667,Atanasov; Nikolay A.,0,0,0,0
1668021206180,ECE 277,A00,103668,An; Cheolhong,0,0,0,0
1668021206614,ECE 279,A00,117947,Hall; Drew A.,0,0,0,0
1668021207486,ECE 283,A00,103670,Hsueh; Tzu-Chien,0,0,0,0
1668021207915,ECE 284,A00,103671,Turakhia; Yatish Girish,0,0,0,0
1668021208344,ECE 285,A00,103672,Zheng; Yang,0,0,0,0
1668021208344,ECE 285,B00,103673,Sworder; David D.,0,0,0,0
1668021208782,ECE 287,A00,103676,Javidi; Tara,0,0,0,0
1668021209206,MATH 200B,A00,098023,Salehi Golsefidy; Alireza,14,0,15,1
1668021209631,MATH 202B,A00,098024,Rhoades; Brendon Patrick,11,0,15,4
1668021210056,MATH 203B,A00,098025,Oprea; Dragos N.,11,0,15,4
1668021210485,MATH 204B,A00,098026,Sorensen; Claus M,14,0,15,1
1668021210914,MATH 208,A00,098027,Izadi; Elham,7,0,10,3
1668021211429,MATH 209,A00,098028,Pollack; Aaron,10,0,10,0
1668021211864,MATH 211A,A00,112919,Rogalski; Daniel,9,0,10,1
1668021212289,MATH 211B,A00,112920,Seward; Brandon M.,9,0,10,1
1668021212718,MATH 218,A00,098029,Li; Bo,10,0,10,0
1668021213146,MATH 220B,A00,098030,Novak; Jonathan I,13,0,15,2
1668021213577,MATH 221A,A00,098031,Ebenfelt; Peter F,13,0,15,2
1668021214015,MATH 231B,A00,098032,Zlatos; Andrej,12,0,15,3
1668021214455,MATH 240B,A00,098033,Ni; Lei,9,0,15,6
1668021214890,MATH 243,A00,098034,Jekel; David Andrew,10,0,10,0
1668021215322,MATH 245A,A00,098035,Nie; Jiawang,0,0,15,16
1668021215757,MATH 248,A00,098036,Bejenaru; Ioan,10,0,10,0
1668021216185,MATH 250B,A00,098037,Spolaor; Luca,14,0,15,1
1668021216611,MATH 258,A00,098038,Ni; Lei,10,0,10,0
1668021217044,MATH 264B,A00,098041,Rhoades; Brendon Patrick,10,0,15,5
1668021217467,MATH 268,A00,098042,Buss; Samuel R,10,0,10,0
1668021217892,MATH 269,A00,098043,Rhoades; Brendon Patrick,10,0,10,0
1668021218321,MATH 270B,A00,098044,Li; Bo,11,0,15,4
1668021218747,MATH 272B,A00,098045,Holst; Michael J,13,0,15,2
1668021219184,MATH 273A,A00,098046,Tian; Xiaochuan,10,0,15,5
1668021219606,MATH 275,A01,098048,Tian; Xiaochuan,6,0,10,4
1668021220032,MATH 278A,A00,098049,Holst; Michael J,8,0,10,2
1668021220454,MATH 278B,A00,098050,Cloninger; Alexander,10,0,10,0
1668021220879,MATH 278C,A00,098051,Nie; Jiawang,8,0,10,2
1668021221315,MATH 280B,A00,098052,Zheng; Tianyi,11,0,15,4
1668021221738,MATH 281B,A00,098053,Bradic; Jelena,4,0,15,11
1668021222165,MATH 282B,A00,098054,Arias-Castro; Ery,2,0,15,13
1668021222590,MATH 285,A00,098055,Fitzsimmons; Patrick J,0,0,15,17
1668021223015,MATH 287B,A00,098056,Arias-Castro; Ery,4,0,15,11
1668021223442,MATH 288,A00,098057,Agarwal; Pooja,9,0,10,1
1668021223442,MATH 288,B00,098058,Zhang; Danna,9,0,10,1
1668021223442,MATH 288,C00,098059,Williams; Ruth J,10,0,10,0
1668021223868,MATH 290B,A00,098060,Roberts; Justin Deritter,13,0,15,2
1668021224307,MATH 292,A00,098061,Belmont; Eva Kinoshita,10,0,10,0
1668021224756,MATH 295,A00,098062,Suk; Andrew Hoon,48,0,50,2
1668021225179,MATH 296,A00,098063,Novak; Jonathan I,20,0,20,0
1668021225607,MATH 297,001,098064,Gamst; Anthony Collins,9997,0,9999,2
1668021731475,COGS 205,A00,101395,Chiba; Andrea,19,0,20,1
1668021731906,COGS 210B,001,101404,Greene; Deanna Jacquelyn,9998,0,9999,1
1668021731906,COGS 210B,002,101417,Xia; Haijun,9999,0,9999,0
1668021731906,COGS 210B,003,101422,Nitz; Douglas A.,9999,0,9999,0
1668021731906,COGS 210B,004,101423,Hollan; James D.,9998,0,9999,1
1668021731906,COGS 210B,005,101424,Deak; Gedeon O.,9999,0,9999,0
1668021731906,COGS 210B,006,101425,Rossano; Federico,9999,0,9999,0
1668021732336,COGS 211B,A00,101427,Coulson; Seana M,9997,0,9999,2
1668021732778,COGS 220,A00,101428,Hollan; James D.,0,0,25,25
1668021733209,COGS 229,A00,101429,Dow; Steven P,18,0,25,7
1668021733639,COGS 230,A00,101430,Klemmer; Scott R,13,0,17,4
1668021734062,COGS 234,A00,101431,Xia; Haijun,5,0,25,20
1668021734489,COGS 260,A00,101432,Kiyonaga; Anastasia,20,0,25,5
1668021734489,COGS 260,B00,101433,Kirsh; David Joel,16,0,25,9
1668021734915,CSE 202,A00,102371,Impagliazzo; Russell,0,0,0,0
1668021735342,CSE 203B,A01,102373,Cheng; Chung Kuan,0,0,0,0
1668021735765,CSE 208,A00,102374,Micciancio; Daniele,0,0,0,0
1668021736195,CSE 209A,A00,112895,Impagliazzo; Russell,0,0,15,15
1668021736631,CSE 209B,A00,108005,Bellare; Mihir,0,0,0,0
1668021737055,CSE 210,A00,113163,Coblenz; Michael J,0,0,0,0
1668021737489,CSE 219,A00,106111,Dow; Steven P,0,0,20,20
1668021737912,CSE 221,A00,102376,Voelker; Geoffrey M.,0,0,0,0
1668021738346,CSE 224,A01,102378,Porter; George M,0,0,0,0
1668021738774,CSE 229A,A00,102379,Savage; Stefan,0,0,0,0
1668021739209,CSE 229C,A00,102380,Munyaka; Imani N. S.,0,0,0,0
1668021739633,CSE 232B,A00,102382,Deutsch; Alin Bernard,0,0,0,0
1668021740066,CSE 234,A01,112904,Kumar; Arun Kumar,0,0,0,0
1668021740491,CSE 237A,A00,102383,Rosing; Tajana Simunic,0,0,0,0
1668021740916,CSE 239A,A00,102384,Deutsch; Alin Bernard,0,0,0,0
1668021741347,CSE 239B,A00,102385,Polikarpova; Nadezhda,0,0,0,0
1668021741782,CSE 240A,A00,102386,Pannuto; Patrick William,0,0,0,0
1668021742217,CSE 240B,A00,102387,Zhao; Jishen,0,0,0,0
1668021742640,CSE 241A,A00,106406,Kang; Mingu,0,0,0,0
1668021743065,CSE 249B,A00,102388,Kahng; Andrew Byun,0,0,8,8
1668021743490,CSE 251B,A01,102392,Cottrell; Garrison W,0,0,0,0
1668021743490,CSE 251B,A02,102393,Cottrell; Garrison W,0,0,0,0
1668021743929,CSE 252B,A00,102394,Ochoa; Benjamin Lawrence,0,0,0,0
1668021744358,CSE 257,A01,102396,Gao; Sicun,0,0,0,0
1668021744790,CSE 272,A00,102397,Li; Tzumao,0,0,0,0
1668021745214,CSE 274,A00,111323,Chern; Albert Ren-Haur,0,0,0,0
1668021745639,CSE 282,A00,102398,Pevzner; Pavel Arkadjevich,0,0,0,0
1668021746067,CSE 284,A00,114175,Gymrek; Melissa Ann,0,0,0,0
1668021746498,CSE 290,A00,102399,Chandraker; Manmohan Krishna,0,0,0,0
1668021746498,CSE 290,B00,102400,Vaccaro; Kristen Marie,0,0,25,25
1668021746498,CSE 290,C00,102414,Pannuto; Patrick William,0,0,25,25
1668021746498,CSE 290,D00,102427,Pevzner; Pavel Arkadjevich,0,0,0,0
1668021746498,CSE 290,E00,102429,Zhao; Jishen,0,0,0,0
1668021746498,CSE 290,F00,102436,Tullsen; Dean Michael,0,0,0,0
1668021746498,CSE 290,G00,102440,Christensen; Henrik I,0,0,20,20
1668021746939,CSE 291,A00,102443,Su; Hao,0,0,0,0
1668021746939,CSE 291,B00,102448,Polikarpova; Nadezhda,0,0,0,0
1668021746939,CSE 291,C00,102453,Vaccaro; Kristen Marie,0,0,0,0
1668021746939,CSE 291,D00,111343,Savage; Stefan,0,0,0,0
1668021746939,CSE 291,E00,116474,Claffy; Kimberly Claire,0,0,0,0
1668021746939,CSE 291,F00,116479,Pasquale; Joseph,0,0,0,0
1668021747374,CSE 293,001,119111,Bafna; Vineet,9999,0,9999,0
1668021747374,CSE 293,002,119118,Bellare; Mihir,9999,0,9999,0
1668021747374,CSE 293,003,119122,Berg-Kirkpatrick; Taylor D,9999,0,9999,0
1668021747374,CSE 293,004,119135,Christensen; Henrik I,9999,0,9999,0
1668021747374,CSE 293,005,119142,Cottrell; Garrison W,9999,0,9999,0
1668021747374,CSE 293,006,119146,Deutsch; Alin Bernard,9999,0,9999,0
1668021747374,CSE 293,007,119159,Esmaeilzadeh; Hadi,9999,0,9999,0
1668021747374,CSE 293,008,119166,Freund; Yoav,9999,0,9999,0
1668021747374,CSE 293,009,119170,Griswold; William G.,9999,0,9999,0
1668021747374,CSE 293,010,119183,Gymrek; Melissa Ann,9999,0,9999,0
1668021747374,CSE 293,011,119190,Heninger; Nadia A,9999,0,9999,0
1668021747374,CSE 293,012,119230,Impagliazzo; Russell,9999,0,9999,0
1668021747374,CSE 293,013,119232,Jhala; Ranjit,9999,0,9999,0
1668021747374,CSE 293,014,119233,Kahng; Andrew Byun,9999,0,9999,0
1668021747374,CSE 293,015,119298,Kane; Daniel Mertz,9999,0,9999,0
1668021747374,CSE 293,016,119299,Kriegman; David J,9999,0,9999,0
1668021747374,CSE 293,017,119300,Kumar; Arun Kumar,9999,0,9999,0
1668021747374,CSE 293,018,119301,Lerner; Sorin,9999,0,9999,0
1668021747374,CSE 293,019,119302,Lovett; Shachar,9999,0,9999,0
1668021747374,CSE 293,020,119303,McAuley; Julian John,9999,0,9999,0
1668021747374,CSE 293,021,119304,Micciancio; Daniele,9999,0,9999,0
1668021747374,CSE 293,022,119367,Orailoglu; Alex,9999,0,9999,0
1668021747374,CSE 293,023,119382,Paturi; Ramamohan,9999,0,9999,0
1668021747374,CSE 293,024,119404,Polikarpova; Nadezhda,9999,0,9999,0
1668021747374,CSE 293,025,119406,Politz; Joseph Gibbs,9999,0,9999,0
1668021747374,CSE 293,026,119411,Porter; George M,9999,0,9999,0
1668021747374,CSE 293,027,119414,Porter; Leonard Emerson,9999,0,9999,0
1668021747374,CSE 293,028,119416,Ramamoorthi; Ravi,9999,0,9999,0
1668021747374,CSE 293,029,119417,Sahoo; Debashis,9999,0,9999,0
1668021747374,CSE 293,030,119420,Saul; Lawrence,9999,0,9999,0
1668021747374,CSE 293,031,119421,Savage; Stefan,9999,0,9999,0
1668021747374,CSE 293,032,119425,Schulze; Jurgen P.,9999,0,9999,0
1668021747374,CSE 293,033,119426,Snoeren; Alex C.,9999,0,9999,0
1668021747374,CSE 293,034,119428,Shang; Jingbo,9999,0,9999,0
1668021747374,CSE 293,035,119430,Stefan; Deian,9999,0,9999,0
1668021747374,CSE 293,036,119431,Su; Hao,9999,0,9999,0
1668021747374,CSE 293,037,119433,Swanson; Steven James,9999,0,9999,0
1668021747374,CSE 293,038,119435,Tullsen; Dean Michael,9999,0,9999,0
1668021747374,CSE 293,039,119483,Voelker; Geoffrey M.,9999,0,9999,0
1668021747374,CSE 293,040,119537,Zhao; Jishen,9999,0,9999,0
1668021747374,CSE 293,041,119538,Zhou; Yuan-Yuan,9999,0,9999,0
1668021747374,CSE 293,042,119539,Gao; Sicun,9999,0,9999,0
1668021747374,CSE 293,043,119540,Weibel; Nadir,9999,0,9999,0
1668021747374,CSE 293,044,119541,Gupta; Rajesh K.,9999,0,9999,0
1668021747374,CSE 293,045,126410,Vaccaro; Kristen Marie,9999,0,9999,0
1668021747374,CSE 293,046,126411,Klemke; Richard,9999,0,9999,0
1668021747797,CSE 294,A00,102459,Voelker; Geoffrey M.,0,0,0,0
1668021747797,CSE 294,B00,111322,Orailoglu; Alex,0,0,0,0
1668021748225,DSE 201,A00,096914,Deutsch; Alin Bernard,30,0,30,0
1668021748647,DSE 210,A00,096915,Dasgupta; Sanjoy,30,0,30,0
1668021749082,DSE 260A,A00,096916,Altintas De Callaf; Ilkay,30,0,30,0
1668021749537,ECE 200,001,103586,Antipa; Nicholas A,9999,0,9999,0
1668021749537,ECE 200,002,103587,Atanasov; Nikolay A.,9999,0,9999,0
1668021749537,ECE 200,003,103588,Bharadia; Dinesh,9999,0,9999,0
1668021749537,ECE 200,004,103589,Cheng; Chung Kuan,9999,0,9999,0
1668021749537,ECE 200,005,103590,Cosman; Pamela C.,9999,0,9999,0
1668021749537,ECE 200,006,103591,Dayeh; Shadi Ahmad,9999,0,9999,0
1668021749537,ECE 200,007,103592,Fainman; Yeshaiahu,9999,0,9999,0
1668021749537,ECE 200,008,103593,Ford; Joseph Earl,9999,0,9999,0
1668021749537,ECE 200,009,103594,Franceschetti; Massimo,9999,0,9999,0
1668021749537,ECE 200,010,103595,Fullerton; Eric E,9999,0,9999,0
1668021749537,ECE 200,011,103596,Galton; Ian A,9999,0,9999,0
1668021749537,ECE 200,012,103597,Gilja; Vikash,9999,0,9999,0
1668021749537,ECE 200,013,103598,Hall; Drew A.,9999,0,9999,0
1668021749537,ECE 200,014,103599,Hsueh; Tzu-Chien,9999,0,9999,0
1668021749537,ECE 200,015,103600,Javidi; Tara,9999,0,9999,0
1668021749537,ECE 200,016,103601,Kahng; Andrew Byun,9999,0,9999,0
1668021749537,ECE 200,017,103602,Kim; Young-Han,9999,0,9999,0
1668021749537,ECE 200,018,103603,Koushanfar; Farinaz,9999,0,9999,0
1668021749537,ECE 200,019,103604,Kuzum; Duygu,9999,0,9999,0
1668021749537,ECE 200,020,103605,Le; Hanh-Phuc,9999,0,9999,0
1668021749537,ECE 200,021,103606,Lin; Bill,9999,0,9999,0
1668021749537,ECE 200,022,103607,Liu; Zhaowei,9998,0,9999,1
1668021749537,ECE 200,023,103608,Lo; Yu-Hwa,9999,0,9999,0
1668021749537,ECE 200,024,103609,Lomakin; Vitaliy,9999,0,9999,0
1668021749537,ECE 200,025,103610,Mercier; Patrick Philip,9999,0,9999,0
1668021749537,ECE 200,026,103611,Meyer; Florian,9999,0,9999,0
1668021749537,ECE 200,027,103612,Milstein; Laurence B.,9999,0,9999,0
1668021749537,ECE 200,028,103613,Mir Arabbaygi; Siavash,9999,0,9999,0
1668021749537,ECE 200,029,103614,Mookherjea; Shayan,9999,0,9999,0
1668021749537,ECE 200,030,103615,Morris; Karcher William,9999,0,9999,0
1668021749537,ECE 200,031,103616,Ng; Tse Nga,9999,0,9999,0
1668021749537,ECE 200,032,103617,Nguyen; Truong Quang,9999,0,9999,0
1668021749537,ECE 200,033,103618,Nomura; Kenji,9999,0,9999,0
1668021749537,ECE 200,034,103619,Orlitsky; Alon,9999,0,9999,0
1668021749537,ECE 200,035,103620,Pal; Piya,9999,0,9999,0
1668021749537,ECE 200,036,103621,Papen; George C.,9999,0,9999,0
1668021749537,ECE 200,037,103622,Radic; Stojan,9999,0,9999,0
1668021749537,ECE 200,038,103623,Rao; Bhaskar D.,9999,0,9999,0
1668021749537,ECE 200,039,103624,Rao; Ramesh R,9999,0,9999,0
1668021749537,ECE 200,040,103625,Rebeiz; Gabriel,9999,0,9999,0
1668021749537,ECE 200,041,103626,Sanford; John R,9999,0,9999,0
1668021749537,ECE 200,042,103627,Siegel; Paul H.,9999,0,9999,0
1668021749537,ECE 200,043,103628,Sievenpiper; Daniel F.,9999,0,9999,0
1668021749537,ECE 200,044,103629,Sworder; David D.,9999,0,9999,0
1668021749537,ECE 200,045,103630,Taur; Yuan,9999,0,9999,0
1668021749537,ECE 200,046,103631,Touri; Behrouz,9999,0,9999,0
1668021749537,ECE 200,047,103632,Trivedi; Mohan M.,9999,0,9999,0
1668021749537,ECE 200,048,103633,Vasconcelos; Nuno,9999,0,9999,0
1668021749537,ECE 200,049,103634,Wang; Xiaolong,9999,0,9999,0
1668021749537,ECE 200,050,103635,Xie; Pengtao,9999,0,9999,0
1668021749537,ECE 200,051,103636,Yip; Michael,9999,0,9999,0
1668021749537,ECE 200,052,103637,Zeger; Kenneth A.,999,0,999,0
1668021749537,ECE 200,053,103638,Zhang; Xinyu,9999,0,9999,0
1668021749537,ECE 200,054,103639,Turakhia; Yatish Girish,9999,0,9999,0
1668021749537,ECE 200,055,103640,Kang; Mingu,9999,0,9999,0
1668021749537,ECE 200,056,103641,Shi; Yuanyuan,9999,0,9999,0
1668021749537,ECE 200,057,103642,Wang; Edward Jay,9999,0,9999,0
1668021749537,ECE 200,058,103643,Zheng; Yang,9999,0,9999,0
1668021749960,ECE 202,A00,103644,Kuzum; Duygu,0,0,0,0
1668021750404,ECE 212BN,A00,103646,Ng; Tse Nga,0,0,0,0
1668021750832,ECE 221,A00,111493,Staff,0,0,0,0
1668021751259,ECE 222B,A00,103647,Lomakin; Vitaliy,0,0,0,0
1668021751686,ECE 230B,A00,103648,Taur; Yuan,0,0,0,0
1668021752119,ECE 238B,A00,103649,Garay; Javier,0,0,0,0
1668021752543,ECE 240B,A00,112900,Fainman; Yeshaiahu,0,0,0,0
1668021752978,ECE 247A,A00,103650,Jokerst; Jesse Vincent,0,0,0,0
1668021753408,ECE 247B,A00,103651,Wang; Joseph,0,0,0,0
1668021753843,ECE 250,A00,103652,Siegel; Paul H.,0,0,0,0
1668021754268,ECE 251A,A00,103654,Rao; Bhaskar D.,0,0,0,0
1668021754694,ECE 257B,A00,103655,Bharadia; Dinesh,0,0,0,0
1668021755115,ECE 258A,A00,103656,Milstein; Laurence B.,0,0,0,0
1668021755560,ECE 260B,A00,103658,Kang; Mingu,0,0,0,0
1668021755986,ECE 264A,A00,103659,Galton; Ian A,0,0,0,0
1668021756411,ECE 265A,A00,103661,Gudem; Prasad S.S.,0,0,0,0
1668021756838,ECE 265D,A00,103662,Gudem; Prasad S.S.,0,0,0,0
1668021757268,ECE 268,A00,103663,Koushanfar; Farinaz,0,0,0,0
1668021757705,ECE 269,A01,103665,Pal; Piya,0,0,0,0
1668021758127,ECE 271B,A00,103666,Vasconcelos; Manuela,0,0,0,0
1668021758552,ECE 276A,A00,103667,Atanasov; Nikolay A.,0,0,0,0
1668021758982,ECE 277,A00,103668,An; Cheolhong,0,0,0,0
1668021759417,ECE 279,A00,117947,Hall; Drew A.,0,0,0,0
1668021760274,ECE 283,A00,103670,Hsueh; Tzu-Chien,0,0,0,0
1668021760699,ECE 284,A00,103671,Turakhia; Yatish Girish,0,0,0,0
1668021761132,ECE 285,A00,103672,Zheng; Yang,0,0,0,0
1668021761132,ECE 285,B00,103673,Sworder; David D.,0,0,0,0
1668021761557,ECE 287,A00,103676,Javidi; Tara,0,0,0,0
1668021761981,MATH 200B,A00,098023,Salehi Golsefidy; Alireza,14,0,15,1
1668021762406,MATH 202B,A00,098024,Rhoades; Brendon Patrick,11,0,15,4
1668021762841,MATH 203B,A00,098025,Oprea; Dragos N.,11,0,15,4
1668021763267,MATH 204B,A00,098026,Sorensen; Claus M,14,0,15,1
1668021763702,MATH 208,A00,098027,Izadi; Elham,7,0,10,3
1668021764135,MATH 209,A00,098028,Pollack; Aaron,10,0,10,0
1668021764563,MATH 211A,A00,112919,Rogalski; Daniel,9,0,10,1
1668021764988,MATH 211B,A00,112920,Seward; Brandon M.,9,0,10,1
1668021765411,MATH 218,A00,098029,Li; Bo,10,0,10,0
1668021765834,MATH 220B,A00,098030,Novak; Jonathan I,13,0,15,2
1668021766259,MATH 221A,A00,098031,Ebenfelt; Peter F,13,0,15,2
1668021766683,MATH 231B,A00,098032,Zlatos; Andrej,12,0,15,3
1668021767187,MATH 240B,A00,098033,Ni; Lei,9,0,15,6
1668021767640,MATH 243,A00,098034,Jekel; David Andrew,10,0,10,0
1668021768073,MATH 245A,A00,098035,Nie; Jiawang,0,0,15,16
1668021768498,MATH 248,A00,098036,Bejenaru; Ioan,10,0,10,0
1668021768920,MATH 250B,A00,098037,Spolaor; Luca,14,0,15,1
1668021769347,MATH 258,A00,098038,Ni; Lei,10,0,10,0
1668021769769,MATH 264B,A00,098041,Rhoades; Brendon Patrick,10,0,15,5
1668021770192,MATH 268,A00,098042,Buss; Samuel R,10,0,10,0
1668021770614,MATH 269,A00,098043,Rhoades; Brendon Patrick,10,0,10,0
1668021771039,MATH 270B,A00,098044,Li; Bo,11,0,15,4
1668021771461,MATH 272B,A00,098045,Holst; Michael J,13,0,15,2
1668021771890,MATH 273A,A00,098046,Tian; Xiaochuan,10,0,15,5
1668021772321,MATH 275,A01,098048,Tian; Xiaochuan,6,0,10,4
1668021772743,MATH 278A,A00,098049,Holst; Michael J,8,0,10,2
1668021773169,MATH 278B,A00,098050,Cloninger; Alexander,10,0,10,0
1668021773593,MATH 278C,A00,098051,Nie; Jiawang,8,0,10,2
1668021774020,MATH 280B,A00,098052,Zheng; Tianyi,11,0,15,4
1668021774442,MATH 281B,A00,098053,Bradic; Jelena,4,0,15,11
1668021774875,MATH 282B,A00,098054,Arias-Castro; Ery,2,0,15,13
1668021775301,MATH 285,A00,098055,Fitzsimmons; Patrick J,0,0,15,17
1668021775733,MATH 287B,A00,098056,Arias-Castro; Ery,4,0,15,11
1668021776171,MATH 288,A00,098057,Agarwal; Pooja,9,0,10,1
1668021776171,MATH 288,B00,098058,Zhang; Danna,9,0,10,1
1668021776171,MATH 288,C00,098059,Williams; Ruth J,10,0,10,0
1668021776596,MATH 290B,A00,098060,Roberts; Justin Deritter,13,0,15,2
1668021777035,MATH 292,A00,098061,Belmont; Eva Kinoshita,10,0,10,0
1668021777459,MATH 295,A00,098062,Suk; Andrew Hoon,48,0,50,2
1668021777883,MATH 296,A00,098063,Novak; Jonathan I,20,0,20,0
1668021778316,MATH 297,001,098064,Gamst; Anthony Collins,9997,0,9999,2
1668022285134,COGS 205,A00,101395,Chiba; Andrea,19,0,20,1
1668022285597,COGS 210B,001,101404,Greene; Deanna Jacquelyn,9998,0,9999,1
1668022285597,COGS 210B,002,101417,Xia; Haijun,9999,0,9999,0
1668022285597,COGS 210B,003,101422,Nitz; Douglas A.,9999,0,9999,0
1668022285597,COGS 210B,004,101423,Hollan; James D.,9998,0,9999,1
1668022285597,COGS 210B,005,101424,Deak; Gedeon O.,9999,0,9999,0
1668022285597,COGS 210B,006,101425,Rossano; Federico,9999,0,9999,0
1668022286032,COGS 211B,A00,101427,Coulson; Seana M,9997,0,9999,2
1668022286460,COGS 220,A00,101428,Hollan; James D.,0,0,25,25
1668022286881,COGS 229,A00,101429,Dow; Steven P,18,0,25,7
1668022287312,COGS 230,A00,101430,Klemmer; Scott R,13,0,17,4
1668022287739,COGS 234,A00,101431,Xia; Haijun,5,0,25,20
1668022288164,COGS 260,A00,101432,Kiyonaga; Anastasia,20,0,25,5
1668022288164,COGS 260,B00,101433,Kirsh; David Joel,16,0,25,9
1668022288598,CSE 202,A00,102371,Impagliazzo; Russell,0,0,0,0
1668022289026,CSE 203B,A01,102373,Cheng; Chung Kuan,0,0,0,0
1668022289457,CSE 208,A00,102374,Micciancio; Daniele,0,0,0,0
1668022289882,CSE 209A,A00,112895,Impagliazzo; Russell,0,0,15,15
1668022290306,CSE 209B,A00,108005,Bellare; Mihir,0,0,0,0
1668022290742,CSE 210,A00,113163,Coblenz; Michael J,0,0,0,0
1668022291163,CSE 219,A00,106111,Dow; Steven P,0,0,20,20
1668022291599,CSE 221,A00,102376,Voelker; Geoffrey M.,0,0,0,0
1668022292024,CSE 224,A01,102378,Porter; George M,0,0,0,0
1668022292447,CSE 229A,A00,102379,Savage; Stefan,0,0,0,0
1668022292880,CSE 229C,A00,102380,Munyaka; Imani N. S.,0,0,0,0
1668022293308,CSE 232B,A00,102382,Deutsch; Alin Bernard,0,0,0,0
1668022293744,CSE 234,A01,112904,Kumar; Arun Kumar,0,0,0,0
1668022294261,CSE 237A,A00,102383,Rosing; Tajana Simunic,0,0,0,0
1668022294689,CSE 239A,A00,102384,Deutsch; Alin Bernard,0,0,0,0
1668022295119,CSE 239B,A00,102385,Polikarpova; Nadezhda,0,0,0,0
1668022295551,CSE 240A,A00,102386,Pannuto; Patrick William,0,0,0,0
1668022295976,CSE 240B,A00,102387,Zhao; Jishen,0,0,0,0
1668022296399,CSE 241A,A00,106406,Kang; Mingu,0,0,0,0
1668022296827,CSE 249B,A00,102388,Kahng; Andrew Byun,0,0,8,8
1668022297253,CSE 251B,A01,102392,Cottrell; Garrison W,0,0,0,0
1668022297253,CSE 251B,A02,102393,Cottrell; Garrison W,0,0,0,0
1668022297677,CSE 252B,A00,102394,Ochoa; Benjamin Lawrence,0,0,0,0
1668022298104,CSE 257,A01,102396,Gao; Sicun,0,0,0,0
1668022298540,CSE 272,A00,102397,Li; Tzumao,0,0,0,0
1668022298969,CSE 274,A00,111323,Chern; Albert Ren-Haur,0,0,0,0
1668022299400,CSE 282,A00,102398,Pevzner; Pavel Arkadjevich,0,0,0,0
1668022299834,CSE 284,A00,114175,Gymrek; Melissa Ann,0,0,0,0
1668022300259,CSE 290,A00,102399,Chandraker; Manmohan Krishna,0,0,0,0
1668022300259,CSE 290,B00,102400,Vaccaro; Kristen Marie,0,0,25,25
1668022300259,CSE 290,C00,102414,Pannuto; Patrick William,0,0,25,25
1668022300259,CSE 290,D00,102427,Pevzner; Pavel Arkadjevich,0,0,0,0
1668022300259,CSE 290,E00,102429,Zhao; Jishen,0,0,0,0
1668022300259,CSE 290,F00,102436,Tullsen; Dean Michael,0,0,0,0
1668022300259,CSE 290,G00,102440,Christensen; Henrik I,0,0,20,20
1668022300683,CSE 291,A00,102443,Su; Hao,0,0,0,0
1668022300683,CSE 291,B00,102448,Polikarpova; Nadezhda,0,0,0,0
1668022300683,CSE 291,C00,102453,Vaccaro; Kristen Marie,0,0,0,0
1668022300683,CSE 291,D00,111343,Savage; Stefan,0,0,0,0
1668022300683,CSE 291,E00,116474,Claffy; Kimberly Claire,0,0,0,0
1668022300683,CSE 291,F00,116479,Pasquale; Joseph,0,0,0,0
1668022301141,CSE 293,001,119111,Bafna; Vineet,9999,0,9999,0
1668022301141,CSE 293,002,119118,Bellare; Mihir,9999,0,9999,0
1668022301141,CSE 293,003,119122,Berg-Kirkpatrick; Taylor D,9999,0,9999,0
1668022301141,CSE 293,004,119135,Christensen; Henrik I,9999,0,9999,0
1668022301141,CSE 293,005,119142,Cottrell; Garrison W,9999,0,9999,0
1668022301141,CSE 293,006,119146,Deutsch; Alin Bernard,9999,0,9999,0
1668022301141,CSE 293,007,119159,Esmaeilzadeh; Hadi,9999,0,9999,0
1668022301141,CSE 293,008,119166,Freund; Yoav,9999,0,9999,0
1668022301141,CSE 293,009,119170,Griswold; William G.,9999,0,9999,0
1668022301141,CSE 293,010,119183,Gymrek; Melissa Ann,9999,0,9999,0
1668022301141,CSE 293,011,119190,Heninger; Nadia A,9999,0,9999,0
1668022301141,CSE 293,012,119230,Impagliazzo; Russell,9999,0,9999,0
1668022301141,CSE 293,013,119232,Jhala; Ranjit,9999,0,9999,0
1668022301141,CSE 293,014,119233,Kahng; Andrew Byun,9999,0,9999,0
1668022301141,CSE 293,015,119298,Kane; Daniel Mertz,9999,0,9999,0
1668022301141,CSE 293,016,119299,Kriegman; David J,9999,0,9999,0
1668022301141,CSE 293,017,119300,Kumar; Arun Kumar,9999,0,9999,0
1668022301141,CSE 293,018,119301,Lerner; Sorin,9999,0,9999,0
1668022301141,CSE 293,019,119302,Lovett; Shachar,9999,0,9999,0
1668022301141,CSE 293,020,119303,McAuley; Julian John,9999,0,9999,0
1668022301141,CSE 293,021,119304,Micciancio; Daniele,9999,0,9999,0
1668022301141,CSE 293,022,119367,Orailoglu; Alex,9999,0,9999,0
1668022301141,CSE 293,023,119382,Paturi; Ramamohan,9999,0,9999,0
1668022301141,CSE 293,024,119404,Polikarpova; Nadezhda,9999,0,9999,0
1668022301141,CSE 293,025,119406,Politz; Joseph Gibbs,9999,0,9999,0
1668022301141,CSE 293,026,119411,Porter; George M,9999,0,9999,0
1668022301141,CSE 293,027,119414,Porter; Leonard Emerson,9999,0,9999,0
1668022301141,CSE 293,028,119416,Ramamoorthi; Ravi,9999,0,9999,0
1668022301141,CSE 293,029,119417,Sahoo; Debashis,9999,0,9999,0
1668022301141,CSE 293,030,119420,Saul; Lawrence,9999,0,9999,0
1668022301141,CSE 293,031,119421,Savage; Stefan,9999,0,9999,0
1668022301141,CSE 293,032,119425,Schulze; Jurgen P.,9999,0,9999,0
1668022301141,CSE 293,033,119426,Snoeren; Alex C.,9999,0,9999,0
1668022301141,CSE 293,034,119428,Shang; Jingbo,9999,0,9999,0
1668022301141,CSE 293,035,119430,Stefan; Deian,9999,0,9999,0
1668022301141,CSE 293,036,119431,Su; Hao,9999,0,9999,0
1668022301141,CSE 293,037,119433,Swanson; Steven James,9999,0,9999,0
1668022301141,CSE 293,038,119435,Tullsen; Dean Michael,9999,0,9999,0
1668022301141,CSE 293,039,119483,Voelker; Geoffrey M.,9999,0,9999,0
1668022301141,CSE 293,040,119537,Zhao; Jishen,9999,0,9999,0
1668022301141,CSE 293,041,119538,Zhou; Yuan-Yuan,9999,0,9999,0
1668022301141,CSE 293,042,119539,Gao; Sicun,9999,0,9999,0
1668022301141,CSE 293,043,119540,Weibel; Nadir,9999,0,9999,0
1668022301141,CSE 293,044,119541,Gupta; Rajesh K.,9999,0,9999,0
1668022301141,CSE 293,045,126410,Vaccaro; Kristen Marie,9999,0,9999,0
1668022301141,CSE 293,046,126411,Klemke; Richard,9999,0,9999,0
1668022301568,CSE 294,A00,102459,Voelker; Geoffrey M.,0,0,0,0
1668022301568,CSE 294,B00,111322,Orailoglu; Alex,0,0,0,0
1668022301990,DSE 201,A00,096914,Deutsch; Alin Bernard,30,0,30,0
1668022302415,DSE 210,A00,096915,Dasgupta; Sanjoy,30,0,30,0
1668022302839,DSE 260A,A00,096916,Altintas De Callaf; Ilkay,30,0,30,0
1668022303302,ECE 200,001,103586,Antipa; Nicholas A,9999,0,9999,0
1668022303302,ECE 200,002,103587,Atanasov; Nikolay A.,9999,0,9999,0
1668022303302,ECE 200,003,103588,Bharadia; Dinesh,9999,0,9999,0
1668022303302,ECE 200,004,103589,Cheng; Chung Kuan,9999,0,9999,0
1668022303302,ECE 200,005,103590,Cosman; Pamela C.,9999,0,9999,0
1668022303302,ECE 200,006,103591,Dayeh; Shadi Ahmad,9999,0,9999,0
1668022303302,ECE 200,007,103592,Fainman; Yeshaiahu,9999,0,9999,0
1668022303302,ECE 200,008,103593,Ford; Joseph Earl,9999,0,9999,0
1668022303302,ECE 200,009,103594,Franceschetti; Massimo,9999,0,9999,0
1668022303302,ECE 200,010,103595,Fullerton; Eric E,9999,0,9999,0
1668022303302,ECE 200,011,103596,Galton; Ian A,9999,0,9999,0
1668022303302,ECE 200,012,103597,Gilja; Vikash,9999,0,9999,0
1668022303302,ECE 200,013,103598,Hall; Drew A.,9999,0,9999,0
1668022303302,ECE 200,014,103599,Hsueh; Tzu-Chien,9999,0,9999,0
1668022303302,ECE 200,015,103600,Javidi; Tara,9999,0,9999,0
1668022303302,ECE 200,016,103601,Kahng; Andrew Byun,9999,0,9999,0
1668022303302,ECE 200,017,103602,Kim; Young-Han,9999,0,9999,0
1668022303302,ECE 200,018,103603,Koushanfar; Farinaz,9999,0,9999,0
1668022303302,ECE 200,019,103604,Kuzum; Duygu,9999,0,9999,0
1668022303302,ECE 200,020,103605,Le; Hanh-Phuc,9999,0,9999,0
1668022303302,ECE 200,021,103606,Lin; Bill,9999,0,9999,0
1668022303302,ECE 200,022,103607,Liu; Zhaowei,9998,0,9999,1
1668022303302,ECE 200,023,103608,Lo; Yu-Hwa,9999,0,9999,0
1668022303302,ECE 200,024,103609,Lomakin; Vitaliy,9999,0,9999,0
1668022303302,ECE 200,025,103610,Mercier; Patrick Philip,9999,0,9999,0
1668022303302,ECE 200,026,103611,Meyer; Florian,9999,0,9999,0
1668022303302,ECE 200,027,103612,Milstein; Laurence B.,9999,0,9999,0
1668022303302,ECE 200,028,103613,Mir Arabbaygi; Siavash,9999,0,9999,0
1668022303302,ECE 200,029,103614,Mookherjea; Shayan,9999,0,9999,0
1668022303302,ECE 200,030,103615,Morris; Karcher William,9999,0,9999,0
1668022303302,ECE 200,031,103616,Ng; Tse Nga,9999,0,9999,0
1668022303302,ECE 200,032,103617,Nguyen; Truong Quang,9999,0,9999,0
1668022303302,ECE 200,033,103618,Nomura; Kenji,9999,0,9999,0
1668022303302,ECE 200,034,103619,Orlitsky; Alon,9999,0,9999,0
1668022303302,ECE 200,035,103620,Pal; Piya,9999,0,9999,0
1668022303302,ECE 200,036,103621,Papen; George C.,9999,0,9999,0
1668022303302,ECE 200,037,103622,Radic; Stojan,9999,0,9999,0
1668022303302,ECE 200,038,103623,Rao; Bhaskar D.,9999,0,9999,0
1668022303302,ECE 200,039,103624,Rao; Ramesh R,9999,0,9999,0
1668022303302,ECE 200,040,103625,Rebeiz; Gabriel,9999,0,9999,0
1668022303302,ECE 200,041,103626,Sanford; John R,9999,0,9999,0
1668022303302,ECE 200,042,103627,Siegel; Paul H.,9999,0,9999,0
1668022303302,ECE 200,043,103628,Sievenpiper; Daniel F.,9999,0,9999,0
1668022303302,ECE 200,044,103629,Sworder; David D.,9999,0,9999,0
1668022303302,ECE 200,045,103630,Taur; Yuan,9999,0,9999,0
1668022303302,ECE 200,046,103631,Touri; Behrouz,9999,0,9999,0
1668022303302,ECE 200,047,103632,Trivedi; Mohan M.,9999,0,9999,0
1668022303302,ECE 200,048,103633,Vasconcelos; Nuno,9999,0,9999,0
1668022303302,ECE 200,049,103634,Wang; Xiaolong,9999,0,9999,0
1668022303302,ECE 200,050,103635,Xie; Pengtao,9999,0,9999,0
1668022303302,ECE 200,051,103636,Yip; Michael,9999,0,9999,0
1668022303302,ECE 200,052,103637,Zeger; Kenneth A.,999,0,999,0
1668022303302,ECE 200,053,103638,Zhang; Xinyu,9999,0,9999,0
1668022303302,ECE 200,054,103639,Turakhia; Yatish Girish,9999,0,9999,0
1668022303302,ECE 200,055,103640,Kang; Mingu,9999,0,9999,0
1668022303302,ECE 200,056,103641,Shi; Yuanyuan,9999,0,9999,0
1668022303302,ECE 200,057,103642,Wang; Edward Jay,9999,0,9999,0
1668022303302,ECE 200,058,103643,Zheng; Yang,9999,0,9999,0
1668022303739,ECE 202,A00,103644,Kuzum; Duygu,0,0,0,0
1668022304166,ECE 212BN,A00,103646,Ng; Tse Nga,0,0,0,0
1668022304592,ECE 221,A00,111493,Staff,0,0,0,0
1668022305031,ECE 222B,A00,103647,Lomakin; Vitaliy,0,0,0,0
1668022305454,ECE 230B,A00,103648,Taur; Yuan,0,0,0,0
1668022305877,ECE 238B,A00,103649,Garay; Javier,0,0,0,0
1668022306300,ECE 240B,A00,112900,Fainman; Yeshaiahu,0,0,0,0
1668022306723,ECE 247A,A00,103650,Jokerst; Jesse Vincent,0,0,0,0
1668022307157,ECE 247B,A00,103651,Wang; Joseph,0,0,0,0
1668022307588,ECE 250,A00,103652,Siegel; Paul H.,0,0,0,0
1668022308021,ECE 251A,A00,103654,Rao; Bhaskar D.,0,0,0,0
1668022308462,ECE 257B,A00,103655,Bharadia; Dinesh,0,0,0,0
1668022308892,ECE 258A,A00,103656,Milstein; Laurence B.,0,0,0,0
1668022309322,ECE 260B,A00,103658,Kang; Mingu,0,0,0,0
1668022309744,ECE 264A,A00,103659,Galton; Ian A,0,0,0,0
1668022310177,ECE 265A,A00,103661,Gudem; Prasad S.S.,0,0,0,0
1668022310608,ECE 265D,A00,103662,Gudem; Prasad S.S.,0,0,0,0
1668022311031,ECE 268,A00,103663,Koushanfar; Farinaz,0,0,0,0
1668022311464,ECE 269,A01,103665,Pal; Piya,0,0,0,0
1668022311886,ECE 271B,A00,103666,Vasconcelos; Manuela,0,0,0,0
1668022312308,ECE 276A,A00,103667,Atanasov; Nikolay A.,0,0,0,0
1668022312751,ECE 277,A00,103668,An; Cheolhong,0,0,0,0
1668022313184,ECE 279,A00,117947,Hall; Drew A.,0,0,0,0
1668022314032,ECE 283,A00,103670,Hsueh; Tzu-Chien,0,0,0,0
1668022314479,ECE 284,A00,103671,Turakhia; Yatish Girish,0,0,0,0
1668022314905,ECE 285,A00,103672,Zheng; Yang,0,0,0,0
1668022314905,ECE 285,B00,103673,Sworder; David D.,0,0,0,0
1668022315334,ECE 287,A00,103676,Javidi; Tara,0,0,0,0
1668022315761,MATH 200B,A00,098023,Salehi Golsefidy; Alireza,14,0,15,1
1668022316189,MATH 202B,A00,098024,Rhoades; Brendon Patrick,11,0,15,4
1668022316612,MATH 203B,A00,098025,Oprea; Dragos N.,11,0,15,4
1668022317048,MATH 204B,A00,098026,Sorensen; Claus M,14,0,15,1
1668022317482,MATH 208,A00,098027,Izadi; Elham,7,0,10,3
1668022317906,MATH 209,A00,098028,Pollack; Aaron,10,0,10,0
1668022318335,MATH 211A,A00,112919,Rogalski; Daniel,9,0,10,1
1668022318763,MATH 211B,A00,112920,Seward; Brandon M.,9,0,10,1
1668022319198,MATH 218,A00,098029,Li; Bo,10,0,10,0
1668022319629,MATH 220B,A00,098030,Novak; Jonathan I,13,0,15,2
1668022320054,MATH 221A,A00,098031,Ebenfelt; Peter F,13,0,15,2
1668022320484,MATH 231B,A00,098032,Zlatos; Andrej,12,0,15,3
1668022320908,MATH 240B,A00,098033,Ni; Lei,9,0,15,6
1668022321346,MATH 243,A00,098034,Jekel; David Andrew,10,0,10,0
1668022321772,MATH 245A,A00,098035,Nie; Jiawang,0,0,15,16
1668022322200,MATH 248,A00,098036,Bejenaru; Ioan,10,0,10,0
1668022322634,MATH 250B,A00,098037,Spolaor; Luca,14,0,15,1
1668022323056,MATH 258,A00,098038,Ni; Lei,10,0,10,0
1668022323498,MATH 264B,A00,098041,Rhoades; Brendon Patrick,10,0,15,5
1668022323929,MATH 268,A00,098042,Buss; Samuel R,10,0,10,0
1668022324353,MATH 269,A00,098043,Rhoades; Brendon Patrick,10,0,10,0
1668022324892,MATH 270B,A00,098044,Li; Bo,11,0,15,4
1668022325317,MATH 272B,A00,098045,Holst; Michael J,13,0,15,2
1668022325755,MATH 273A,A00,098046,Tian; Xiaochuan,10,0,15,5
1668022326194,MATH 275,A01,098048,Tian; Xiaochuan,6,0,10,4
1668022326624,MATH 278A,A00,098049,Holst; Michael J,8,0,10,2
1668022327055,MATH 278B,A00,098050,Cloninger; Alexander,10,0,10,0
1668022327484,MATH 278C,A00,098051,Nie; Jiawang,8,0,10,2
1668022327909,MATH 280B,A00,098052,Zheng; Tianyi,11,0,15,4
1668022328334,MATH 281B,A00,098053,Bradic; Jelena,4,0,15,11
1668022328759,MATH 282B,A00,098054,Arias-Castro; Ery,2,0,15,13
1668022329190,MATH 285,A00,098055,Fitzsimmons; Patrick J,0,0,15,17
1668022329618,MATH 287B,A00,098056,Arias-Castro; Ery,4,0,15,11
1668022330043,MATH 288,A00,098057,Agarwal; Pooja,9,0,10,1
1668022330043,MATH 288,B00,098058,Zhang; Danna,9,0,10,1
1668022330043,MATH 288,C00,098059,Williams; Ruth J,10,0,10,0
1668022330470,MATH 290B,A00,098060,Roberts; Justin Deritter,13,0,15,2
1668022330906,MATH 292,A00,098061,Belmont; Eva Kinoshita,10,0,10,0
1668022331331,MATH 295,A00,098062,Suk; Andrew Hoon,48,0,50,2
1668022331762,MATH 296,A00,098063,Novak; Jonathan I,20,0,20,0
1668022332185,MATH 297,001,098064,Gamst; Anthony Collins,9997,0,9999,2
1668022847603,COGS 205,A00,101395,Chiba; Andrea,19,0,20,1
1668022848038,COGS 210B,001,101404,Greene; Deanna Jacquelyn,9998,0,9999,1
1668022848038,COGS 210B,002,101417,Xia; Haijun,9999,0,9999,0
1668022848038,COGS 210B,003,101422,Nitz; Douglas A.,9999,0,9999,0
1668022848038,COGS 210B,004,101423,Hollan; James D.,9998,0,9999,1
1668022848038,COGS 210B,005,101424,Deak; Gedeon O.,9999,0,9999,0
1668022848038,COGS 210B,006,101425,Rossano; Federico,9999,0,9999,0
1668022848462,COGS 211B,A00,101427,Coulson; Seana M,9997,0,9999,2
1668022848884,COGS 220,A00,101428,Hollan; James D.,0,0,25,25
1668022849327,COGS 229,A00,101429,Dow; Steven P,18,0,25,7
1668022849751,COGS 230,A00,101430,Klemmer; Scott R,13,0,17,4
1668022850183,COGS 234,A00,101431,Xia; Haijun,5,0,25,20
1668022850610,COGS 260,A00,101432,Kiyonaga; Anastasia,20,0,25,5
1668022850610,COGS 260,B00,101433,Kirsh; David Joel,16,0,25,9
1668022851036,CSE 202,A00,102371,Impagliazzo; Russell,0,0,0,0
1668022851466,CSE 203B,A01,102373,Cheng; Chung Kuan,0,0,0,0
1668022851898,CSE 208,A00,102374,Micciancio; Daniele,0,0,0,0
1668022852340,CSE 209A,A00,112895,Impagliazzo; Russell,0,0,15,15
1668022852778,CSE 209B,A00,108005,Bellare; Mihir,0,0,0,0
1668022853201,CSE 210,A00,113163,Coblenz; Michael J,0,0,0,0
1668022853630,CSE 219,A00,106111,Dow; Steven P,0,0,20,20
1668022854060,CSE 221,A00,102376,Voelker; Geoffrey M.,0,0,0,0
1668022854504,CSE 224,A01,102378,Porter; George M,0,0,0,0
1668022854944,CSE 229A,A00,102379,Savage; Stefan,0,0,0,0
1668022855370,CSE 229C,A00,102380,Munyaka; Imani N. S.,0,0,0,0
1668022855868,CSE 232B,A00,102382,Deutsch; Alin Bernard,0,0,0,0
1668022856301,CSE 234,A01,112904,Kumar; Arun Kumar,0,0,0,0
1668022856732,CSE 237A,A00,102383,Rosing; Tajana Simunic,0,0,0,0
1668022857175,CSE 239A,A00,102384,Deutsch; Alin Bernard,0,0,0,0
1668022857600,CSE 239B,A00,102385,Polikarpova; Nadezhda,0,0,0,0
1668022858043,CSE 240A,A00,102386,Pannuto; Patrick William,0,0,0,0
1668022858473,CSE 240B,A00,102387,Zhao; Jishen,0,0,0,0
1668022858917,CSE 241A,A00,106406,Kang; Mingu,0,0,0,0
1668022859353,CSE 249B,A00,102388,Kahng; Andrew Byun,0,0,8,8
1668022859783,CSE 251B,A01,102392,Cottrell; Garrison W,0,0,0,0
1668022859783,CSE 251B,A02,102393,Cottrell; Garrison W,0,0,0,0
1668022860217,CSE 252B,A00,102394,Ochoa; Benjamin Lawrence,0,0,0,0
1668022860638,CSE 257,A01,102396,Gao; Sicun,0,0,0,0
1668022861063,CSE 272,A00,102397,Li; Tzumao,0,0,0,0
1668022861486,CSE 274,A00,111323,Chern; Albert Ren-Haur,0,0,0,0
1668022861927,CSE 282,A00,102398,Pevzner; Pavel Arkadjevich,0,0,0,0
1668022862361,CSE 284,A00,114175,Gymrek; Melissa Ann,0,0,0,0
1668022862783,CSE 290,A00,102399,Chandraker; Manmohan Krishna,0,0,0,0
1668022862783,CSE 290,B00,102400,Vaccaro; Kristen Marie,0,0,25,25
1668022862783,CSE 290,C00,102414,Pannuto; Patrick William,0,0,25,25
1668022862783,CSE 290,D00,102427,Pevzner; Pavel Arkadjevich,0,0,0,0
1668022862783,CSE 290,E00,102429,Zhao; Jishen,0,0,0,0
1668022862783,CSE 290,F00,102436,Tullsen; Dean Michael,0,0,0,0
1668022862783,CSE 290,G00,102440,Christensen; Henrik I,0,0,20,20
1668022863208,CSE 291,A00,102443,Su; Hao,0,0,0,0
1668022863208,CSE 291,B00,102448,Polikarpova; Nadezhda,0,0,0,0
1668022863208,CSE 291,C00,102453,Vaccaro; Kristen Marie,0,0,0,0
1668022863208,CSE 291,D00,111343,Savage; Stefan,0,0,0,0
1668022863208,CSE 291,E00,116474,Claffy; Kimberly Claire,0,0,0,0
1668022863208,CSE 291,F00,116479,Pasquale; Joseph,0,0,0,0
1668022863635,CSE 293,001,119111,Bafna; Vineet,9999,0,9999,0
1668022863635,CSE 293,002,119118,Bellare; Mihir,9999,0,9999,0
1668022863635,CSE 293,003,119122,Berg-Kirkpatrick; Taylor D,9999,0,9999,0
1668022863635,CSE 293,004,119135,Christensen; Henrik I,9999,0,9999,0
1668022863635,CSE 293,005,119142,Cottrell; Garrison W,9999,0,9999,0
1668022863635,CSE 293,006,119146,Deutsch; Alin Bernard,9999,0,9999,0
1668022863635,CSE 293,007,119159,Esmaeilzadeh; Hadi,9999,0,9999,0
1668022863635,CSE 293,008,119166,Freund; Yoav,9999,0,9999,0
1668022863635,CSE 293,009,119170,Griswold; William G.,9999,0,9999,0
1668022863635,CSE 293,010,119183,Gymrek; Melissa Ann,9999,0,9999,0
1668022863635,CSE 293,011,119190,Heninger; Nadia A,9999,0,9999,0
1668022863635,CSE 293,012,119230,Impagliazzo; Russell,9999,0,9999,0
1668022863635,CSE 293,013,119232,Jhala; Ranjit,9999,0,9999,0
1668022863635,CSE 293,014,119233,Kahng; Andrew Byun,9999,0,9999,0
1668022863635,CSE 293,015,119298,Kane; Daniel Mertz,9999,0,9999,0
1668022863635,CSE 293,016,119299,Kriegman; David J,9999,0,9999,0
1668022863635,CSE 293,017,119300,Kumar; Arun Kumar,9999,0,9999,0
1668022863635,CSE 293,018,119301,Lerner; Sorin,9999,0,9999,0
1668022863635,CSE 293,019,119302,Lovett; Shachar,9999,0,9999,0
1668022863635,CSE 293,020,119303,McAuley; Julian John,9999,0,9999,0
1668022863635,CSE 293,021,119304,Micciancio; Daniele,9999,0,9999,0
1668022863635,CSE 293,022,119367,Orailoglu; Alex,9999,0,9999,0
1668022863635,CSE 293,023,119382,Paturi; Ramamohan,9999,0,9999,0
1668022863635,CSE 293,024,119404,Polikarpova; Nadezhda,9999,0,9999,0
1668022863635,CSE 293,025,119406,Politz; Joseph Gibbs,9999,0,9999,0
1668022863635,CSE 293,026,119411,Porter; George M,9999,0,9999,0
1668022863635,CSE 293,027,119414,Porter; Leonard Emerson,9999,0,9999,0
1668022863635,CSE 293,028,119416,Ramamoorthi; Ravi,9999,0,9999,0
1668022863635,CSE 293,029,119417,Sahoo; Debashis,9999,0,9999,0
1668022863635,CSE 293,030,119420,Saul; Lawrence,9999,0,9999,0
1668022863635,CSE 293,031,119421,Savage; Stefan,9999,0,9999,0
1668022863635,CSE 293,032,119425,Schulze; Jurgen P.,9999,0,9999,0
1668022863635,CSE 293,033,119426,Snoeren; Alex C.,9999,0,9999,0
1668022863635,CSE 293,034,119428,Shang; Jingbo,9999,0,9999,0
1668022863635,CSE 293,035,119430,Stefan; Deian,9999,0,9999,0
1668022863635,CSE 293,036,119431,Su; Hao,9999,0,9999,0
1668022863635,CSE 293,037,119433,Swanson; Steven James,9999,0,9999,0
1668022863635,CSE 293,038,119435,Tullsen; Dean Michael,9999,0,9999,0
1668022863635,CSE 293,039,119483,Voelker; Geoffrey M.,9999,0,9999,0
1668022863635,CSE 293,040,119537,Zhao; Jishen,9999,0,9999,0
1668022863635,CSE 293,041,119538,Zhou; Yuan-Yuan,9999,0,9999,0
1668022863635,CSE 293,042,119539,Gao; Sicun,9999,0,9999,0
1668022863635,CSE 293,043,119540,Weibel; Nadir,9999,0,9999,0
1668022863635,CSE 293,044,119541,Gupta; Rajesh K.,9999,0,9999,0
1668022863635,CSE 293,045,126410,Vaccaro; Kristen Marie,9999,0,9999,0
1668022863635,CSE 293,046,126411,Klemke; Richard,9999,0,9999,0
1668022864062,CSE 294,A00,102459,Voelker; Geoffrey M.,0,0,0,0
1668022864062,CSE 294,B00,111322,Orailoglu; Alex,0,0,0,0
1668022864485,DSE 201,A00,096914,Deutsch; Alin Bernard,30,0,30,0
1668022864914,DSE 210,A00,096915,Dasgupta; Sanjoy,30,0,30,0
1668022865337,DSE 260A,A00,096916,Altintas De Callaf; Ilkay,30,0,30,0
1668022865809,ECE 200,001,103586,Antipa; Nicholas A,9999,0,9999,0
1668022865809,ECE 200,002,103587,Atanasov; Nikolay A.,9999,0,9999,0
1668022865809,ECE 200,003,103588,Bharadia; Dinesh,9999,0,9999,0
1668022865809,ECE 200,004,103589,Cheng; Chung Kuan,9999,0,9999,0
1668022865809,ECE 200,005,103590,Cosman; Pamela C.,9999,0,9999,0
1668022865809,ECE 200,006,103591,Dayeh; Shadi Ahmad,9999,0,9999,0
1668022865809,ECE 200,007,103592,Fainman; Yeshaiahu,9999,0,9999,0
1668022865809,ECE 200,008,103593,Ford; Joseph Earl,9999,0,9999,0
1668022865809,ECE 200,009,103594,Franceschetti; Massimo,9999,0,9999,0
1668022865809,ECE 200,010,103595,Fullerton; Eric E,9999,0,9999,0
1668022865809,ECE 200,011,103596,Galton; Ian A,9999,0,9999,0
1668022865809,ECE 200,012,103597,Gilja; Vikash,9999,0,9999,0
1668022865809,ECE 200,013,103598,Hall; Drew A.,9999,0,9999,0
1668022865809,ECE 200,014,103599,Hsueh; Tzu-Chien,9999,0,9999,0
1668022865809,ECE 200,015,103600,Javidi; Tara,9999,0,9999,0
1668022865809,ECE 200,016,103601,Kahng; Andrew Byun,9999,0,9999,0
1668022865809,ECE 200,017,103602,Kim; Young-Han,9999,0,9999,0
1668022865809,ECE 200,018,103603,Koushanfar; Farinaz,9999,0,9999,0
1668022865809,ECE 200,019,103604,Kuzum; Duygu,9999,0,9999,0
1668022865809,ECE 200,020,103605,Le; Hanh-Phuc,9999,0,9999,0
1668022865809,ECE 200,021,103606,Lin; Bill,9999,0,9999,0
1668022865809,ECE 200,022,103607,Liu; Zhaowei,9998,0,9999,1
1668022865809,ECE 200,023,103608,Lo; Yu-Hwa,9999,0,9999,0
1668022865809,ECE 200,024,103609,Lomakin; Vitaliy,9999,0,9999,0
1668022865809,ECE 200,025,103610,Mercier; Patrick Philip,9999,0,9999,0
1668022865809,ECE 200,026,103611,Meyer; Florian,9999,0,9999,0
1668022865809,ECE 200,027,103612,Milstein; Laurence B.,9999,0,9999,0
1668022865809,ECE 200,028,103613,Mir Arabbaygi; Siavash,9999,0,9999,0
1668022865809,ECE 200,029,103614,Mookherjea; Shayan,9999,0,9999,0
1668022865809,ECE 200,030,103615,Morris; Karcher William,9999,0,9999,0
1668022865809,ECE 200,031,103616,Ng; Tse Nga,9999,0,9999,0
1668022865809,ECE 200,032,103617,Nguyen; Truong Quang,9999,0,9999,0
1668022865809,ECE 200,033,103618,Nomura; Kenji,9999,0,9999,0
1668022865809,ECE 200,034,103619,Orlitsky; Alon,9999,0,9999,0
1668022865809,ECE 200,035,103620,Pal; Piya,9999,0,9999,0
1668022865809,ECE 200,036,103621,Papen; George C.,9999,0,9999,0
1668022865809,ECE 200,037,103622,Radic; Stojan,9999,0,9999,0
1668022865809,ECE 200,038,103623,Rao; Bhaskar D.,9999,0,9999,0
1668022865809,ECE 200,039,103624,Rao; Ramesh R,9999,0,9999,0
1668022865809,ECE 200,040,103625,Rebeiz; Gabriel,9999,0,9999,0
1668022865809,ECE 200,041,103626,Sanford; John R,9999,0,9999,0
1668022865809,ECE 200,042,103627,Siegel; Paul H.,9999,0,9999,0
1668022865809,ECE 200,043,103628,Sievenpiper; Daniel F.,9999,0,9999,0
1668022865809,ECE 200,044,103629,Sworder; David D.,9999,0,9999,0
1668022865809,ECE 200,045,103630,Taur; Yuan,9999,0,9999,0
1668022865809,ECE 200,046,103631,Touri; Behrouz,9999,0,9999,0
1668022865809,ECE 200,047,103632,Trivedi; Mohan M.,9999,0,9999,0
1668022865809,ECE 200,048,103633,Vasconcelos; Nuno,9999,0,9999,0
1668022865809,ECE 200,049,103634,Wang; Xiaolong,9999,0,9999,0
1668022865809,ECE 200,050,103635,Xie; Pengtao,9999,0,9999,0
1668022865809,ECE 200,051,103636,Yip; Michael,9999,0,9999,0
1668022865809,ECE 200,052,103637,Zeger; Kenneth A.,999,0,999,0
1668022865809,ECE 200,053,103638,Zhang; Xinyu,9999,0,9999,0
1668022865809,ECE 200,054,103639,Turakhia; Yatish Girish,9999,0,9999,0
1668022865809,ECE 200,055,103640,Kang; Mingu,9999,0,9999,0
1668022865809,ECE 200,056,103641,Shi; Yuanyuan,9999,0,9999,0
1668022865809,ECE 200,057,103642,Wang; Edward Jay,9999,0,9999,0
1668022865809,ECE 200,058,103643,Zheng; Yang,9999,0,9999,0
1668022866243,ECE 202,A00,103644,Kuzum; Duygu,0,0,0,0
1668022866678,ECE 212BN,A00,103646,Ng; Tse Nga,0,0,0,0
1668022867110,ECE 221,A00,111493,Staff,0,0,0,0
1668022867534,ECE 222B,A00,103647,Lomakin; Vitaliy,0,0,0,0
1668022867958,ECE 230B,A00,103648,Taur; Yuan,0,0,0,0
1668022868383,ECE 238B,A00,103649,Garay; Javier,0,0,0,0
1668022868817,ECE 240B,A00,112900,Fainman; Yeshaiahu,0,0,0,0
1668022869250,ECE 247A,A00,103650,Jokerst; Jesse Vincent,0,0,0,0
1668022869673,ECE 247B,A00,103651,Wang; Joseph,0,0,0,0
1668022870103,ECE 250,A00,103652,Siegel; Paul H.,0,0,0,0
1668022870547,ECE 251A,A00,103654,Rao; Bhaskar D.,0,0,0,0
1668022870974,ECE 257B,A00,103655,Bharadia; Dinesh,0,0,0,0
1668022871397,ECE 258A,A00,103656,Milstein; Laurence B.,0,0,0,0
1668022871828,ECE 260B,A00,103658,Kang; Mingu,0,0,0,0
1668022872263,ECE 264A,A00,103659,Galton; Ian A,0,0,0,0
1668022872687,ECE 265A,A00,103661,Gudem; Prasad S.S.,0,0,0,0
1668022873117,ECE 265D,A00,103662,Gudem; Prasad S.S.,0,0,0,0
1668022873645,ECE 268,A00,103663,Koushanfar; Farinaz,0,0,0,0
1668022874068,ECE 269,A01,103665,Pal; Piya,0,0,0,0
1668022874491,ECE 271B,A00,103666,Vasconcelos; Manuela,0,0,0,0
1668022874916,ECE 276A,A00,103667,Atanasov; Nikolay A.,0,0,0,0
1668022875489,ECE 277,A00,103668,An; Cheolhong,0,0,0,0
1668022875912,ECE 279,A00,117947,Hall; Drew A.,0,0,0,0
1668022876794,ECE 283,A00,103670,Hsueh; Tzu-Chien,0,0,0,0
1668022877222,ECE 284,A00,103671,Turakhia; Yatish Girish,0,0,0,0
1668022877650,ECE 285,A00,103672,Zheng; Yang,0,0,0,0
1668022877650,ECE 285,B00,103673,Sworder; David D.,0,0,0,0
1668022878074,ECE 287,A00,103676,Javidi; Tara,0,0,0,0
1668022878503,MATH 200B,A00,098023,Salehi Golsefidy; Alireza,14,0,15,1
1668022878930,MATH 202B,A00,098024,Rhoades; Brendon Patrick,11,0,15,4
1668022879366,MATH 203B,A00,098025,Oprea; Dragos N.,11,0,15,4
1668022879792,MATH 204B,A00,098026,Sorensen; Claus M,14,0,15,1
1668022880225,MATH 208,A00,098027,Izadi; Elham,7,0,10,3
1668022880649,MATH 209,A00,098028,Pollack; Aaron,10,0,10,0
1668022881073,MATH 211A,A00,112919,Rogalski; Daniel,9,0,10,1
1668022881496,MATH 211B,A00,112920,Seward; Brandon M.,9,0,10,1
1668022881921,MATH 218,A00,098029,Li; Bo,10,0,10,0
1668022882357,MATH 220B,A00,098030,Novak; Jonathan I,13,0,15,2
1668022882786,MATH 221A,A00,098031,Ebenfelt; Peter F,13,0,15,2
1668022883220,MATH 231B,A00,098032,Zlatos; Andrej,12,0,15,3
1668022883644,MATH 240B,A00,098033,Ni; Lei,9,0,15,6
1668022884069,MATH 243,A00,098034,Jekel; David Andrew,10,0,10,0
1668022884497,MATH 245A,A00,098035,Nie; Jiawang,0,0,15,16
1668022884920,MATH 248,A00,098036,Bejenaru; Ioan,10,0,10,0
1668022885346,MATH 250B,A00,098037,Spolaor; Luca,14,0,15,1
1668022885781,MATH 258,A00,098038,Ni; Lei,10,0,10,0
1668022886203,MATH 264B,A00,098041,Rhoades; Brendon Patrick,10,0,15,5
1668022886633,MATH 268,A00,098042,Buss; Samuel R,10,0,10,0
1668022887065,MATH 269,A00,098043,Rhoades; Brendon Patrick,10,0,10,0
1668022887486,MATH 270B,A00,098044,Li; Bo,11,0,15,4
1668022887911,MATH 272B,A00,098045,Holst; Michael J,13,0,15,2
1668022888335,MATH 273A,A00,098046,Tian; Xiaochuan,10,0,15,5
1668022888770,MATH 275,A01,098048,Tian; Xiaochuan,6,0,10,4
1668022889198,MATH 278A,A00,098049,Holst; Michael J,8,0,10,2
1668022889640,MATH 278B,A00,098050,Cloninger; Alexander,10,0,10,0
1668022890066,MATH 278C,A00,098051,Nie; Jiawang,8,0,10,2
1668022890490,MATH 280B,A00,098052,Zheng; Tianyi,11,0,15,4
1668022890914,MATH 281B,A00,098053,Bradic; Jelena,4,0,15,11
1668022891340,MATH 282B,A00,098054,Arias-Castro; Ery,2,0,15,13
1668022891767,MATH 285,A00,098055,Fitzsimmons; Patrick J,0,0,15,17
1668022892195,MATH 287B,A00,098056,Arias-Castro; Ery,4,0,15,11
1668022892633,MATH 288,A00,098057,Agarwal; Pooja,9,0,10,1
1668022892633,MATH 288,B00,098058,Zhang; Danna,9,0,10,1
1668022892633,MATH 288,C00,098059,Williams; Ruth J,10,0,10,0
1668022893056,MATH 290B,A00,098060,Roberts; Justin Deritter,13,0,15,2
1668022893481,MATH 292,A00,098061,Belmont; Eva Kinoshita,10,0,10,0
1668022893903,MATH 295,A00,098062,Suk; Andrew Hoon,48,0,50,2
1668022894334,MATH 296,A00,098063,Novak; Jonathan I,20,0,20,0
1668022894768,MATH 297,001,098064,Gamst; Anthony Collins,9997,0,9999,2
1668023401481,COGS 205,A00,101395,Chiba; Andrea,19,0,20,1
1668023401907,COGS 210B,001,101404,Greene; Deanna Jacquelyn,9998,0,9999,1
1668023401907,COGS 210B,002,101417,Xia; Haijun,9999,0,9999,0
1668023401907,COGS 210B,003,101422,Nitz; Douglas A.,9999,0,9999,0
1668023401907,COGS 210B,004,101423,Hollan; James D.,9998,0,9999,1
1668023401907,COGS 210B,005,101424,Deak; Gedeon O.,9999,0,9999,0
1668023401907,COGS 210B,006,101425,Rossano; Federico,9999,0,9999,0
1668023402330,COGS 211B,A00,101427,Coulson; Seana M,9997,0,9999,2
1668023402754,COGS 220,A00,101428,Hollan; James D.,0,0,25,25
1668023403194,COGS 229,A00,101429,Dow; Steven P,18,0,25,7
1668023403620,COGS 230,A00,101430,Klemmer; Scott R,13,0,17,4
1668023404064,COGS 234,A00,101431,Xia; Haijun,5,0,25,20
1668023404491,COGS 260,A00,101432,Kiyonaga; Anastasia,20,0,25,5
1668023404491,COGS 260,B00,101433,Kirsh; David Joel,16,0,25,9
1668023404999,CSE 202,A00,102371,Impagliazzo; Russell,0,0,0,0
1668023405423,CSE 203B,A01,102373,Cheng; Chung Kuan,0,0,0,0
1668023405854,CSE 208,A00,102374,Micciancio; Daniele,0,0,0,0
1668023406281,CSE 209A,A00,112895,Impagliazzo; Russell,0,0,15,15
1668023406706,CSE 209B,A00,108005,Bellare; Mihir,0,0,0,0
1668023407134,CSE 210,A00,113163,Coblenz; Michael J,0,0,0,0
1668023407585,CSE 219,A00,106111,Dow; Steven P,0,0,20,20
1668023408215,CSE 221,A00,102376,Voelker; Geoffrey M.,0,0,0,0
1668023408665,CSE 224,A01,102378,Porter; George M,0,0,0,0
1668023409097,CSE 229A,A00,102379,Savage; Stefan,0,0,0,0
1668023409534,CSE 229C,A00,102380,Munyaka; Imani N. S.,0,0,0,0
1668023409976,CSE 232B,A00,102382,Deutsch; Alin Bernard,0,0,0,0
1668023410412,CSE 234,A01,112904,Kumar; Arun Kumar,0,0,0,0
1668023410848,CSE 237A,A00,102383,Rosing; Tajana Simunic,0,0,0,0
1668023411290,CSE 239A,A00,102384,Deutsch; Alin Bernard,0,0,0,0
1668023411720,CSE 239B,A00,102385,Polikarpova; Nadezhda,0,0,0,0
1668023412152,CSE 240A,A00,102386,Pannuto; Patrick William,0,0,0,0
1668023412591,CSE 240B,A00,102387,Zhao; Jishen,0,0,0,0
1668023413020,CSE 241A,A00,106406,Kang; Mingu,0,0,0,0
1668023413470,CSE 249B,A00,102388,Kahng; Andrew Byun,0,0,8,8
1668023413898,CSE 251B,A01,102392,Cottrell; Garrison W,0,0,0,0
1668023413898,CSE 251B,A02,102393,Cottrell; Garrison W,0,0,0,0
1668023414333,CSE 252B,A00,102394,Ochoa; Benjamin Lawrence,0,0,0,0
1668023414761,CSE 257,A01,102396,Gao; Sicun,0,0,0,0
1668023415205,CSE 272,A00,102397,Li; Tzumao,0,0,0,0
1668023415635,CSE 274,A00,111323,Chern; Albert Ren-Haur,0,0,0,0
1668023416067,CSE 282,A00,102398,Pevzner; Pavel Arkadjevich,0,0,0,0
1668023416504,CSE 284,A00,114175,Gymrek; Melissa Ann,0,0,0,0
1668023416930,CSE 290,A00,102399,Chandraker; Manmohan Krishna,0,0,0,0
1668023416930,CSE 290,B00,102400,Vaccaro; Kristen Marie,0,0,25,25
1668023416930,CSE 290,C00,102414,Pannuto; Patrick William,0,0,25,25
1668023416930,CSE 290,D00,102427,Pevzner; Pavel Arkadjevich,0,0,0,0
1668023416930,CSE 290,E00,102429,Zhao; Jishen,0,0,0,0
1668023416930,CSE 290,F00,102436,Tullsen; Dean Michael,0,0,0,0
1668023416930,CSE 290,G00,102440,Christensen; Henrik I,0,0,20,20
1668023417366,CSE 291,A00,102443,Su; Hao,0,0,0,0
1668023417366,CSE 291,B00,102448,Polikarpova; Nadezhda,0,0,0,0
1668023417366,CSE 291,C00,102453,Vaccaro; Kristen Marie,0,0,0,0
1668023417366,CSE 291,D00,111343,Savage; Stefan,0,0,0,0
1668023417366,CSE 291,E00,116474,Claffy; Kimberly Claire,0,0,0,0
1668023417366,CSE 291,F00,116479,Pasquale; Joseph,0,0,0,0
1668023417839,CSE 293,001,119111,Bafna; Vineet,9999,0,9999,0
1668023417839,CSE 293,002,119118,Bellare; Mihir,9999,0,9999,0
1668023417839,CSE 293,003,119122,Berg-Kirkpatrick; Taylor D,9999,0,9999,0
1668023417839,CSE 293,004,119135,Christensen; Henrik I,9999,0,9999,0
1668023417839,CSE 293,005,119142,Cottrell; Garrison W,9999,0,9999,0
1668023417839,CSE 293,006,119146,Deutsch; Alin Bernard,9999,0,9999,0
1668023417839,CSE 293,007,119159,Esmaeilzadeh; Hadi,9999,0,9999,0
1668023417839,CSE 293,008,119166,Freund; Yoav,9999,0,9999,0
1668023417839,CSE 293,009,119170,Griswold; William G.,9999,0,9999,0
1668023417839,CSE 293,010,119183,Gymrek; Melissa Ann,9999,0,9999,0
1668023417839,CSE 293,011,119190,Heninger; Nadia A,9999,0,9999,0
1668023417839,CSE 293,012,119230,Impagliazzo; Russell,9999,0,9999,0
1668023417839,CSE 293,013,119232,Jhala; Ranjit,9999,0,9999,0
1668023417839,CSE 293,014,119233,Kahng; Andrew Byun,9999,0,9999,0
1668023417839,CSE 293,015,119298,Kane; Daniel Mertz,9999,0,9999,0
1668023417839,CSE 293,016,119299,Kriegman; David J,9999,0,9999,0
1668023417839,CSE 293,017,119300,Kumar; Arun Kumar,9999,0,9999,0
1668023417839,CSE 293,018,119301,Lerner; Sorin,9999,0,9999,0
1668023417839,CSE 293,019,119302,Lovett; Shachar,9999,0,9999,0
1668023417839,CSE 293,020,119303,McAuley; Julian John,9999,0,9999,0
1668023417839,CSE 293,021,119304,Micciancio; Daniele,9999,0,9999,0
1668023417839,CSE 293,022,119367,Orailoglu; Alex,9999,0,9999,0
1668023417839,CSE 293,023,119382,Paturi; Ramamohan,9999,0,9999,0
1668023417839,CSE 293,024,119404,Polikarpova; Nadezhda,9999,0,9999,0
1668023417839,CSE 293,025,119406,Politz; Joseph Gibbs,9999,0,9999,0
1668023417839,CSE 293,026,119411,Porter; George M,9999,0,9999,0
1668023417839,CSE 293,027,119414,Porter; Leonard Emerson,9999,0,9999,0
1668023417839,CSE 293,028,119416,Ramamoorthi; Ravi,9999,0,9999,0
1668023417839,CSE 293,029,119417,Sahoo; Debashis,9999,0,9999,0
1668023417839,CSE 293,030,119420,Saul; Lawrence,9999,0,9999,0
1668023417839,CSE 293,031,119421,Savage; Stefan,9999,0,9999,0
1668023417839,CSE 293,032,119425,Schulze; Jurgen P.,9999,0,9999,0
1668023417839,CSE 293,033,119426,Snoeren; Alex C.,9999,0,9999,0
1668023417839,CSE 293,034,119428,Shang; Jingbo,9999,0,9999,0
1668023417839,CSE 293,035,119430,Stefan; Deian,9999,0,9999,0
1668023417839,CSE 293,036,119431,Su; Hao,9999,0,9999,0
1668023417839,CSE 293,037,119433,Swanson; Steven James,9999,0,9999,0
1668023417839,CSE 293,038,119435,Tullsen; Dean Michael,9999,0,9999,0
1668023417839,CSE 293,039,119483,Voelker; Geoffrey M.,9999,0,9999,0
1668023417839,CSE 293,040,119537,Zhao; Jishen,9999,0,9999,0
1668023417839,CSE 293,041,119538,Zhou; Yuan-Yuan,9999,0,9999,0
1668023417839,CSE 293,042,119539,Gao; Sicun,9999,0,9999,0
1668023417839,CSE 293,043,119540,Weibel; Nadir,9999,0,9999,0
1668023417839,CSE 293,044,119541,Gupta; Rajesh K.,9999,0,9999,0
1668023417839,CSE 293,045,126410,Vaccaro; Kristen Marie,9999,0,9999,0
1668023417839,CSE 293,046,126411,Klemke; Richard,9999,0,9999,0
1668023418271,CSE 294,A00,102459,Voelker; Geoffrey M.,0,0,0,0
1668023418271,CSE 294,B00,111322,Orailoglu; Alex,0,0,0,0
1668023418700,DSE 201,A00,096914,Deutsch; Alin Bernard,30,0,30,0
1668023419126,DSE 210,A00,096915,Dasgupta; Sanjoy,30,0,30,0
1668023419549,DSE 260A,A00,096916,Altintas De Callaf; Ilkay,30,0,30,0
1668023420027,ECE 200,001,103586,Antipa; Nicholas A,9999,0,9999,0
1668023420027,ECE 200,002,103587,Atanasov; Nikolay A.,9999,0,9999,0
1668023420027,ECE 200,003,103588,Bharadia; Dinesh,9999,0,9999,0
1668023420027,ECE 200,004,103589,Cheng; Chung Kuan,9999,0,9999,0
1668023420027,ECE 200,005,103590,Cosman; Pamela C.,9999,0,9999,0
1668023420027,ECE 200,006,103591,Dayeh; Shadi Ahmad,9999,0,9999,0
1668023420027,ECE 200,007,103592,Fainman; Yeshaiahu,9999,0,9999,0
1668023420027,ECE 200,008,103593,Ford; Joseph Earl,9999,0,9999,0
1668023420027,ECE 200,009,103594,Franceschetti; Massimo,9999,0,9999,0
1668023420027,ECE 200,010,103595,Fullerton; Eric E,9999,0,9999,0
1668023420027,ECE 200,011,103596,Galton; Ian A,9999,0,9999,0
1668023420027,ECE 200,012,103597,Gilja; Vikash,9999,0,9999,0
1668023420027,ECE 200,013,103598,Hall; Drew A.,9999,0,9999,0
1668023420027,ECE 200,014,103599,Hsueh; Tzu-Chien,9999,0,9999,0
1668023420027,ECE 200,015,103600,Javidi; Tara,9999,0,9999,0
1668023420027,ECE 200,016,103601,Kahng; Andrew Byun,9999,0,9999,0
1668023420027,ECE 200,017,103602,Kim; Young-Han,9999,0,9999,0
1668023420027,ECE 200,018,103603,Koushanfar; Farinaz,9999,0,9999,0
1668023420027,ECE 200,019,103604,Kuzum; Duygu,9999,0,9999,0
1668023420027,ECE 200,020,103605,Le; Hanh-Phuc,9999,0,9999,0
1668023420027,ECE 200,021,103606,Lin; Bill,9999,0,9999,0
1668023420027,ECE 200,022,103607,Liu; Zhaowei,9998,0,9999,1
1668023420027,ECE 200,023,103608,Lo; Yu-Hwa,9999,0,9999,0
1668023420027,ECE 200,024,103609,Lomakin; Vitaliy,9999,0,9999,0
1668023420027,ECE 200,025,103610,Mercier; Patrick Philip,9999,0,9999,0
1668023420027,ECE 200,026,103611,Meyer; Florian,9999,0,9999,0
1668023420027,ECE 200,027,103612,Milstein; Laurence B.,9999,0,9999,0
1668023420027,ECE 200,028,103613,Mir Arabbaygi; Siavash,9999,0,9999,0
1668023420027,ECE 200,029,103614,Mookherjea; Shayan,9999,0,9999,0
1668023420027,ECE 200,030,103615,Morris; Karcher William,9999,0,9999,0
1668023420027,ECE 200,031,103616,Ng; Tse Nga,9999,0,9999,0
1668023420027,ECE 200,032,103617,Nguyen; Truong Quang,9999,0,9999,0
1668023420027,ECE 200,033,103618,Nomura; Kenji,9999,0,9999,0
1668023420027,ECE 200,034,103619,Orlitsky; Alon,9999,0,9999,0
1668023420027,ECE 200,035,103620,Pal; Piya,9999,0,9999,0
1668023420027,ECE 200,036,103621,Papen; George C.,9999,0,9999,0
1668023420027,ECE 200,037,103622,Radic; Stojan,9999,0,9999,0
1668023420027,ECE 200,038,103623,Rao; Bhaskar D.,9999,0,9999,0
1668023420027,ECE 200,039,103624,Rao; Ramesh R,9999,0,9999,0
1668023420027,ECE 200,040,103625,Rebeiz; Gabriel,9999,0,9999,0
1668023420027,ECE 200,041,103626,Sanford; John R,9999,0,9999,0
1668023420027,ECE 200,042,103627,Siegel; Paul H.,9999,0,9999,0
1668023420027,ECE 200,043,103628,Sievenpiper; Daniel F.,9999,0,9999,0
1668023420027,ECE 200,044,103629,Sworder; David D.,9999,0,9999,0
1668023420027,ECE 200,045,103630,Taur; Yuan,9999,0,9999,0
1668023420027,ECE 200,046,103631,Touri; Behrouz,9999,0,9999,0
1668023420027,ECE 200,047,103632,Trivedi; Mohan M.,9999,0,9999,0
1668023420027,ECE 200,048,103633,Vasconcelos; Nuno,9999,0,9999,0
1668023420027,ECE 200,049,103634,Wang; Xiaolong,9999,0,9999,0
1668023420027,ECE 200,050,103635,Xie; Pengtao,9999,0,9999,0
1668023420027,ECE 200,051,103636,Yip; Michael,9999,0,9999,0
1668023420027,ECE 200,052,103637,Zeger; Kenneth A.,999,0,999,0
1668023420027,ECE 200,053,103638,Zhang; Xinyu,9999,0,9999,0
1668023420027,ECE 200,054,103639,Turakhia; Yatish Girish,9999,0,9999,0
1668023420027,ECE 200,055,103640,Kang; Mingu,9999,0,9999,0
1668023420027,ECE 200,056,103641,Shi; Yuanyuan,9999,0,9999,0
1668023420027,ECE 200,057,103642,Wang; Edward Jay,9999,0,9999,0
1668023420027,ECE 200,058,103643,Zheng; Yang,9999,0,9999,0
1668023420479,ECE 202,A00,103644,Kuzum; Duygu,0,0,0,0
1668023420902,ECE 212BN,A00,103646,Ng; Tse Nga,0,0,0,0
1668023421331,ECE 221,A00,111493,Staff,0,0,0,0
1668023421753,ECE 222B,A00,103647,Lomakin; Vitaliy,0,0,0,0
1668023422177,ECE 230B,A00,103648,Taur; Yuan,0,0,0,0
1668023422605,ECE 238B,A00,103649,Garay; Javier,0,0,0,0
1668023423042,ECE 240B,A00,112900,Fainman; Yeshaiahu,0,0,0,0
1668023423467,ECE 247A,A00,103650,Jokerst; Jesse Vincent,0,0,0,0
1668023423895,ECE 247B,A00,103651,Wang; Joseph,0,0,0,0
1668023424336,ECE 250,A00,103652,Siegel; Paul H.,0,0,0,0
1668023424759,ECE 251A,A00,103654,Rao; Bhaskar D.,0,0,0,0
1668023425187,ECE 257B,A00,103655,Bharadia; Dinesh,0,0,0,0
1668023425610,ECE 258A,A00,103656,Milstein; Laurence B.,0,0,0,0
1668023426033,ECE 260B,A00,103658,Kang; Mingu,0,0,0,0
1668023426466,ECE 264A,A00,103659,Galton; Ian A,0,0,0,0
1668023426892,ECE 265A,A00,103661,Gudem; Prasad S.S.,0,0,0,0
1668023427333,ECE 265D,A00,103662,Gudem; Prasad S.S.,0,0,0,0
1668023427759,ECE 268,A00,103663,Koushanfar; Farinaz,0,0,0,0
1668023428182,ECE 269,A01,103665,Pal; Piya,0,0,0,0
1668023428610,ECE 271B,A00,103666,Vasconcelos; Manuela,0,0,0,0
1668023429043,ECE 276A,A00,103667,Atanasov; Nikolay A.,0,0,0,0
1668023429467,ECE 277,A00,103668,An; Cheolhong,0,0,0,0
1668023429893,ECE 279,A00,117947,Hall; Drew A.,0,0,0,0
1668023430749,ECE 283,A00,103670,Hsueh; Tzu-Chien,0,0,0,0
1668023431182,ECE 284,A00,103671,Turakhia; Yatish Girish,0,0,0,0
1668023431612,ECE 285,A00,103672,Zheng; Yang,0,0,0,0
1668023431612,ECE 285,B00,103673,Sworder; David D.,0,0,0,0
1668023432037,ECE 287,A00,103676,Javidi; Tara,0,0,0,0
1668023432469,MATH 200B,A00,098023,Salehi Golsefidy; Alireza,13,0,15,2
1668023432897,MATH 202B,A00,098024,Rhoades; Brendon Patrick,11,0,15,4
1668023433331,MATH 203B,A00,098025,Oprea; Dragos N.,11,0,15,4
1668023433760,MATH 204B,A00,098026,Sorensen; Claus M,14,0,15,1
1668023434195,MATH 208,A00,098027,Izadi; Elham,7,0,10,3
1668023434617,MATH 209,A00,098028,Pollack; Aaron,10,0,10,0
1668023435041,MATH 211A,A00,112919,Rogalski; Daniel,9,0,10,1
1668023435477,MATH 211B,A00,112920,Seward; Brandon M.,9,0,10,1
1668023435901,MATH 218,A00,098029,Li; Bo,10,0,10,0
1668023436336,MATH 220B,A00,098030,Novak; Jonathan I,13,0,15,2
1668023436761,MATH 221A,A00,098031,Ebenfelt; Peter F,13,0,15,2
1668023437194,MATH 231B,A00,098032,Zlatos; Andrej,12,0,15,3
1668023437630,MATH 240B,A00,098033,Ni; Lei,9,0,15,6
1668023438058,MATH 243,A00,098034,Jekel; David Andrew,10,0,10,0
1668023438481,MATH 245A,A00,098035,Nie; Jiawang,0,0,15,16
1668023438909,MATH 248,A00,098036,Bejenaru; Ioan,10,0,10,0
1668023439343,MATH 250B,A00,098037,Spolaor; Luca,14,0,15,1
1668023439782,MATH 258,A00,098038,Ni; Lei,10,0,10,0
1668023440211,MATH 264B,A00,098041,Rhoades; Brendon Patrick,10,0,15,5
1668023440649,MATH 268,A00,098042,Buss; Samuel R,10,0,10,0
1668023441079,MATH 269,A00,098043,Rhoades; Brendon Patrick,10,0,10,0
1668023441516,MATH 270B,A00,098044,Li; Bo,11,0,15,4
1668023441957,MATH 272B,A00,098045,Holst; Michael J,13,0,15,2
1668023442384,MATH 273A,A00,098046,Tian; Xiaochuan,10,0,15,5
1668023442810,MATH 275,A01,098048,Tian; Xiaochuan,6,0,10,4
1668023443234,MATH 278A,A00,098049,Holst; Michael J,8,0,10,2
1668023443658,MATH 278B,A00,098050,Cloninger; Alexander,10,0,10,0
1668023444082,MATH 278C,A00,098051,Nie; Jiawang,8,0,10,2
1668023444625,MATH 280B,A00,098052,Zheng; Tianyi,11,0,15,4
1668023445051,MATH 281B,A00,098053,Bradic; Jelena,4,0,15,11
1668023445479,MATH 282B,A00,098054,Arias-Castro; Ery,2,0,15,13
1668023445909,MATH 285,A00,098055,Fitzsimmons; Patrick J,0,0,15,17
1668023446339,MATH 287B,A00,098056,Arias-Castro; Ery,4,0,15,11
1668023446770,MATH 288,A00,098057,Agarwal; Pooja,9,0,10,1
1668023446770,MATH 288,B00,098058,Zhang; Danna,9,0,10,1
1668023446770,MATH 288,C00,098059,Williams; Ruth J,10,0,10,0
1668023447196,MATH 290B,A00,098060,Roberts; Justin Deritter,13,0,15,2
1668023447625,MATH 292,A00,098061,Belmont; Eva Kinoshita,10,0,10,0
1668023448056,MATH 295,A00,098062,Suk; Andrew Hoon,48,0,50,2
1668023448482,MATH 296,A00,098063,Novak; Jonathan I,20,0,20,0
1668023448914,MATH 297,001,098064,Gamst; Anthony Collins,9997,0,9999,2
1668023953321,COGS 205,A00,101395,Chiba; Andrea,19,0,20,1
1668023953761,COGS 210B,001,101404,Greene; Deanna Jacquelyn,9998,0,9999,1
1668023953761,COGS 210B,002,101417,Xia; Haijun,9999,0,9999,0
1668023953761,COGS 210B,003,101422,Nitz; Douglas A.,9999,0,9999,0
1668023953761,COGS 210B,004,101423,Hollan; James D.,9998,0,9999,1
1668023953761,COGS 210B,005,101424,Deak; Gedeon O.,9999,0,9999,0
1668023953761,COGS 210B,006,101425,Rossano; Federico,9999,0,9999,0
1668023954201,COGS 211B,A00,101427,Coulson; Seana M,9997,0,9999,2
1668023954629,COGS 220,A00,101428,Hollan; James D.,0,0,25,25
1668023955059,COGS 229,A00,101429,Dow; Steven P,18,0,25,7
1668023955483,COGS 230,A00,101430,Klemmer; Scott R,13,0,17,4
1668023955908,COGS 234,A00,101431,Xia; Haijun,5,0,25,20
1668023956335,COGS 260,A00,101432,Kiyonaga; Anastasia,20,0,25,5
1668023956335,COGS 260,B00,101433,Kirsh; David Joel,16,0,25,9
1668023956766,CSE 202,A00,102371,Impagliazzo; Russell,0,0,0,0
1668023957195,CSE 203B,A01,102373,Cheng; Chung Kuan,0,0,0,0
1668023957619,CSE 208,A00,102374,Micciancio; Daniele,0,0,0,0
1668023958058,CSE 209A,A00,112895,Impagliazzo; Russell,0,0,15,15
1668023958483,CSE 209B,A00,108005,Bellare; Mihir,0,0,0,0
1668023958914,CSE 210,A00,113163,Coblenz; Michael J,0,0,0,0
1668023959338,CSE 219,A00,106111,Dow; Steven P,0,0,20,20
1668023959766,CSE 221,A00,102376,Voelker; Geoffrey M.,0,0,0,0
1668023960188,CSE 224,A01,102378,Porter; George M,0,0,0,0
1668023960623,CSE 229A,A00,102379,Savage; Stefan,0,0,0,0
1668023961053,CSE 229C,A00,102380,Munyaka; Imani N. S.,0,0,0,0
1668023961478,CSE 232B,A00,102382,Deutsch; Alin Bernard,0,0,0,0
1668023961908,CSE 234,A01,112904,Kumar; Arun Kumar,0,0,0,0
1668023962343,CSE 237A,A00,102383,Rosing; Tajana Simunic,0,0,0,0
1668023962767,CSE 239A,A00,102384,Deutsch; Alin Bernard,0,0,0,0
1668023963197,CSE 239B,A00,102385,Polikarpova; Nadezhda,0,0,0,0
1668023963624,CSE 240A,A00,102386,Pannuto; Patrick William,0,0,0,0
1668023964046,CSE 240B,A00,102387,Zhao; Jishen,0,0,0,0
1668023964471,CSE 241A,A00,106406,Kang; Mingu,0,0,0,0
1668023964894,CSE 249B,A00,102388,Kahng; Andrew Byun,0,0,8,8
1668023965325,CSE 251B,A01,102392,Cottrell; Garrison W,0,0,0,0
1668023965325,CSE 251B,A02,102393,Cottrell; Garrison W,0,0,0,0
1668023965754,CSE 252B,A00,102394,Ochoa; Benjamin Lawrence,0,0,0,0
1668023966176,CSE 257,A01,102396,Gao; Sicun,0,0,0,0
1668023966602,CSE 272,A00,102397,Li; Tzumao,0,0,0,0
1668023967029,CSE 274,A00,111323,Chern; Albert Ren-Haur,0,0,0,0
1668023967454,CSE 282,A00,102398,Pevzner; Pavel Arkadjevich,0,0,0,0
1668023967879,CSE 284,A00,114175,Gymrek; Melissa Ann,0,0,0,0
1668023968313,CSE 290,A00,102399,Chandraker; Manmohan Krishna,0,0,0,0
1668023968313,CSE 290,B00,102400,Vaccaro; Kristen Marie,0,0,25,25
1668023968313,CSE 290,C00,102414,Pannuto; Patrick William,0,0,25,25
1668023968313,CSE 290,D00,102427,Pevzner; Pavel Arkadjevich,0,0,0,0
1668023968313,CSE 290,E00,102429,Zhao; Jishen,0,0,0,0
1668023968313,CSE 290,F00,102436,Tullsen; Dean Michael,0,0,0,0
1668023968313,CSE 290,G00,102440,Christensen; Henrik I,0,0,20,20
1668023968740,CSE 291,A00,102443,Su; Hao,0,0,0,0
1668023968740,CSE 291,B00,102448,Polikarpova; Nadezhda,0,0,0,0
1668023968740,CSE 291,C00,102453,Vaccaro; Kristen Marie,0,0,0,0
1668023968740,CSE 291,D00,111343,Savage; Stefan,0,0,0,0
1668023968740,CSE 291,E00,116474,Claffy; Kimberly Claire,0,0,0,0
1668023968740,CSE 291,F00,116479,Pasquale; Joseph,0,0,0,0
1668023969302,CSE 293,001,119111,Bafna; Vineet,9999,0,9999,0
1668023969302,CSE 293,002,119118,Bellare; Mihir,9999,0,9999,0
1668023969302,CSE 293,003,119122,Berg-Kirkpatrick; Taylor D,9999,0,9999,0
1668023969302,CSE 293,004,119135,Christensen; Henrik I,9999,0,9999,0
1668023969302,CSE 293,005,119142,Cottrell; Garrison W,9999,0,9999,0
1668023969302,CSE 293,006,119146,Deutsch; Alin Bernard,9999,0,9999,0
1668023969302,CSE 293,007,119159,Esmaeilzadeh; Hadi,9999,0,9999,0
1668023969302,CSE 293,008,119166,Freund; Yoav,9999,0,9999,0
1668023969302,CSE 293,009,119170,Griswold; William G.,9999,0,9999,0
1668023969302,CSE 293,010,119183,Gymrek; Melissa Ann,9999,0,9999,0
1668023969302,CSE 293,011,119190,Heninger; Nadia A,9999,0,9999,0
1668023969302,CSE 293,012,119230,Impagliazzo; Russell,9999,0,9999,0
1668023969302,CSE 293,013,119232,Jhala; Ranjit,9999,0,9999,0
1668023969302,CSE 293,014,119233,Kahng; Andrew Byun,9999,0,9999,0
1668023969302,CSE 293,015,119298,Kane; Daniel Mertz,9999,0,9999,0
1668023969302,CSE 293,016,119299,Kriegman; David J,9999,0,9999,0
1668023969302,CSE 293,017,119300,Kumar; Arun Kumar,9999,0,9999,0
1668023969302,CSE 293,018,119301,Lerner; Sorin,9999,0,9999,0
1668023969302,CSE 293,019,119302,Lovett; Shachar,9999,0,9999,0
1668023969302,CSE 293,020,119303,McAuley; Julian John,9999,0,9999,0
1668023969302,CSE 293,021,119304,Micciancio; Daniele,9999,0,9999,0
1668023969302,CSE 293,022,119367,Orailoglu; Alex,9999,0,9999,0
1668023969302,CSE 293,023,119382,Paturi; Ramamohan,9999,0,9999,0
1668023969302,CSE 293,024,119404,Polikarpova; Nadezhda,9999,0,9999,0
1668023969302,CSE 293,025,119406,Politz; Joseph Gibbs,9999,0,9999,0
1668023969302,CSE 293,026,119411,Porter; George M,9999,0,9999,0
1668023969302,CSE 293,027,119414,Porter; Leonard Emerson,9999,0,9999,0
1668023969302,CSE 293,028,119416,Ramamoorthi; Ravi,9999,0,9999,0
1668023969302,CSE 293,029,119417,Sahoo; Debashis,9999,0,9999,0
1668023969302,CSE 293,030,119420,Saul; Lawrence,9999,0,9999,0
1668023969302,CSE 293,031,119421,Savage; Stefan,9999,0,9999,0
1668023969302,CSE 293,032,119425,Schulze; Jurgen P.,9999,0,9999,0
1668023969302,CSE 293,033,119426,Snoeren; Alex C.,9999,0,9999,0
1668023969302,CSE 293,034,119428,Shang; Jingbo,9999,0,9999,0
1668023969302,CSE 293,035,119430,Stefan; Deian,9999,0,9999,0
1668023969302,CSE 293,036,119431,Su; Hao,9999,0,9999,0
1668023969302,CSE 293,037,119433,Swanson; Steven James,9999,0,9999,0
1668023969302,CSE 293,038,119435,Tullsen; Dean Michael,9999,0,9999,0
1668023969302,CSE 293,039,119483,Voelker; Geoffrey M.,9999,0,9999,0
1668023969302,CSE 293,040,119537,Zhao; Jishen,9999,0,9999,0
1668023969302,CSE 293,041,119538,Zhou; Yuan-Yuan,9999,0,9999,0
1668023969302,CSE 293,042,119539,Gao; Sicun,9999,0,9999,0
1668023969302,CSE 293,043,119540,Weibel; Nadir,9999,0,9999,0
1668023969302,CSE 293,044,119541,Gupta; Rajesh K.,9999,0,9999,0
1668023969302,CSE 293,045,126410,Vaccaro; Kristen Marie,9999,0,9999,0
1668023969302,CSE 293,046,126411,Klemke; Richard,9999,0,9999,0
1668023969728,CSE 294,A00,102459,Voelker; Geoffrey M.,0,0,0,0
1668023969728,CSE 294,B00,111322,Orailoglu; Alex,0,0,0,0
1668023970154,DSE 201,A00,096914,Deutsch; Alin Bernard,30,0,30,0
1668023970589,DSE 210,A00,096915,Dasgupta; Sanjoy,30,0,30,0
1668023971012,DSE 260A,A00,096916,Altintas De Callaf; Ilkay,30,0,30,0
1668023971462,ECE 200,001,103586,Antipa; Nicholas A,9999,0,9999,0
1668023971462,ECE 200,002,103587,Atanasov; Nikolay A.,9999,0,9999,0
1668023971462,ECE 200,003,103588,Bharadia; Dinesh,9999,0,9999,0
1668023971462,ECE 200,004,103589,Cheng; Chung Kuan,9999,0,9999,0
1668023971462,ECE 200,005,103590,Cosman; Pamela C.,9999,0,9999,0
1668023971462,ECE 200,006,103591,Dayeh; Shadi Ahmad,9999,0,9999,0
1668023971462,ECE 200,007,103592,Fainman; Yeshaiahu,9999,0,9999,0
1668023971462,ECE 200,008,103593,Ford; Joseph Earl,9999,0,9999,0
1668023971462,ECE 200,009,103594,Franceschetti; Massimo,9999,0,9999,0
1668023971462,ECE 200,010,103595,Fullerton; Eric E,9999,0,9999,0
1668023971462,ECE 200,011,103596,Galton; Ian A,9999,0,9999,0
1668023971462,ECE 200,012,103597,Gilja; Vikash,9999,0,9999,0
1668023971462,ECE 200,013,103598,Hall; Drew A.,9999,0,9999,0
1668023971462,ECE 200,014,103599,Hsueh; Tzu-Chien,9999,0,9999,0
1668023971462,ECE 200,015,103600,Javidi; Tara,9999,0,9999,0
1668023971462,ECE 200,016,103601,Kahng; Andrew Byun,9999,0,9999,0
1668023971462,ECE 200,017,103602,Kim; Young-Han,9999,0,9999,0
1668023971462,ECE 200,018,103603,Koushanfar; Farinaz,9999,0,9999,0
1668023971462,ECE 200,019,103604,Kuzum; Duygu,9999,0,9999,0
1668023971462,ECE 200,020,103605,Le; Hanh-Phuc,9999,0,9999,0
1668023971462,ECE 200,021,103606,Lin; Bill,9999,0,9999,0
1668023971462,ECE 200,022,103607,Liu; Zhaowei,9998,0,9999,1
1668023971462,ECE 200,023,103608,Lo; Yu-Hwa,9999,0,9999,0
1668023971462,ECE 200,024,103609,Lomakin; Vitaliy,9999,0,9999,0
1668023971462,ECE 200,025,103610,Mercier; Patrick Philip,9999,0,9999,0
1668023971462,ECE 200,026,103611,Meyer; Florian,9999,0,9999,0
1668023971462,ECE 200,027,103612,Milstein; Laurence B.,9999,0,9999,0
1668023971462,ECE 200,028,103613,Mir Arabbaygi; Siavash,9999,0,9999,0
1668023971462,ECE 200,029,103614,Mookherjea; Shayan,9999,0,9999,0
1668023971462,ECE 200,030,103615,Morris; Karcher William,9999,0,9999,0
1668023971462,ECE 200,031,103616,Ng; Tse Nga,9999,0,9999,0
1668023971462,ECE 200,032,103617,Nguyen; Truong Quang,9999,0,9999,0
1668023971462,ECE 200,033,103618,Nomura; Kenji,9999,0,9999,0
1668023971462,ECE 200,034,103619,Orlitsky; Alon,9999,0,9999,0
1668023971462,ECE 200,035,103620,Pal; Piya,9999,0,9999,0
1668023971462,ECE 200,036,103621,Papen; George C.,9999,0,9999,0
1668023971462,ECE 200,037,103622,Radic; Stojan,9999,0,9999,0
1668023971462,ECE 200,038,103623,Rao; Bhaskar D.,9999,0,9999,0
1668023971462,ECE 200,039,103624,Rao; Ramesh R,9999,0,9999,0
1668023971462,ECE 200,040,103625,Rebeiz; Gabriel,9999,0,9999,0
1668023971462,ECE 200,041,103626,Sanford; John R,9999,0,9999,0
1668023971462,ECE 200,042,103627,Siegel; Paul H.,9999,0,9999,0
1668023971462,ECE 200,043,103628,Sievenpiper; Daniel F.,9999,0,9999,0
1668023971462,ECE 200,044,103629,Sworder; David D.,9999,0,9999,0
1668023971462,ECE 200,045,103630,Taur; Yuan,9999,0,9999,0
1668023971462,ECE 200,046,103631,Touri; Behrouz,9999,0,9999,0
1668023971462,ECE 200,047,103632,Trivedi; Mohan M.,9999,0,9999,0
1668023971462,ECE 200,048,103633,Vasconcelos; Nuno,9999,0,9999,0
1668023971462,ECE 200,049,103634,Wang; Xiaolong,9999,0,9999,0
1668023971462,ECE 200,050,103635,Xie; Pengtao,9999,0,9999,0
1668023971462,ECE 200,051,103636,Yip; Michael,9999,0,9999,0
1668023971462,ECE 200,052,103637,Zeger; Kenneth A.,999,0,999,0
1668023971462,ECE 200,053,103638,Zhang; Xinyu,9999,0,9999,0
1668023971462,ECE 200,054,103639,Turakhia; Yatish Girish,9999,0,9999,0
1668023971462,ECE 200,055,103640,Kang; Mingu,9999,0,9999,0
1668023971462,ECE 200,056,103641,Shi; Yuanyuan,9999,0,9999,0
1668023971462,ECE 200,057,103642,Wang; Edward Jay,9999,0,9999,0
1668023971462,ECE 200,058,103643,Zheng; Yang,9999,0,9999,0
1668023971905,ECE 202,A00,103644,Kuzum; Duygu,0,0,0,0
1668023972331,ECE 212BN,A00,103646,Ng; Tse Nga,0,0,0,0
1668023972753,ECE 221,A00,111493,Staff,0,0,0,0
1668023973184,ECE 222B,A00,103647,Lomakin; Vitaliy,0,0,0,0
1668023973613,ECE 230B,A00,103648,Taur; Yuan,0,0,0,0
1668023974084,ECE 238B,A00,103649,Garay; Javier,0,0,0,0
1668023974513,ECE 240B,A00,112900,Fainman; Yeshaiahu,0,0,0,0
1668023974936,ECE 247A,A00,103650,Jokerst; Jesse Vincent,0,0,0,0
1668023975376,ECE 247B,A00,103651,Wang; Joseph,0,0,0,0
1668023975802,ECE 250,A00,103652,Siegel; Paul H.,0,0,0,0
1668023976229,ECE 251A,A00,103654,Rao; Bhaskar D.,0,0,0,0
1668023976667,ECE 257B,A00,103655,Bharadia; Dinesh,0,0,0,0
1668023977093,ECE 258A,A00,103656,Milstein; Laurence B.,0,0,0,0
1668023977518,ECE 260B,A00,103658,Kang; Mingu,0,0,0,0
1668023977958,ECE 264A,A00,103659,Galton; Ian A,0,0,0,0
1668023978379,ECE 265A,A00,103661,Gudem; Prasad S.S.,0,0,0,0
1668023978802,ECE 265D,A00,103662,Gudem; Prasad S.S.,0,0,0,0
1668023979229,ECE 268,A00,103663,Koushanfar; Farinaz,0,0,0,0
1668023979667,ECE 269,A01,103665,Pal; Piya,0,0,0,0
1668023980092,ECE 271B,A00,103666,Vasconcelos; Manuela,0,0,0,0
1668023980517,ECE 276A,A00,103667,Atanasov; Nikolay A.,0,0,0,0
1668023980957,ECE 277,A00,103668,An; Cheolhong,0,0,0,0
1668023981382,ECE 279,A00,117947,Hall; Drew A.,0,0,0,0
1668023982243,ECE 283,A00,103670,Hsueh; Tzu-Chien,0,0,0,0
1668023982677,ECE 284,A00,103671,Turakhia; Yatish Girish,0,0,0,0
1668023983106,ECE 285,A00,103672,Zheng; Yang,0,0,0,0
1668023983106,ECE 285,B00,103673,Sworder; David D.,0,0,0,0
1668023983550,ECE 287,A00,103676,Javidi; Tara,0,0,0,0
1668023983984,MATH 200B,A00,098023,Salehi Golsefidy; Alireza,13,0,15,2
1668023984418,MATH 202B,A00,098024,Rhoades; Brendon Patrick,11,0,15,4
1668023984852,MATH 203B,A00,098025,Oprea; Dragos N.,11,0,15,4
1668023985279,MATH 204B,A00,098026,Sorensen; Claus M,14,0,15,1
1668023985710,MATH 208,A00,098027,Izadi; Elham,7,0,10,3
1668023986136,MATH 209,A00,098028,Pollack; Aaron,10,0,10,0
1668023986559,MATH 211A,A00,112919,Rogalski; Daniel,9,0,10,1
1668023986990,MATH 211B,A00,112920,Seward; Brandon M.,9,0,10,1
1668023987425,MATH 218,A00,098029,Li; Bo,10,0,10,0
1668023987857,MATH 220B,A00,098030,Novak; Jonathan I,13,0,15,2
1668023988281,MATH 221A,A00,098031,Ebenfelt; Peter F,13,0,15,2
1668023988706,MATH 231B,A00,098032,Zlatos; Andrej,12,0,15,3
1668023989139,MATH 240B,A00,098033,Ni; Lei,9,0,15,6
1668023989562,MATH 243,A00,098034,Jekel; David Andrew,10,0,10,0
1668023989997,MATH 245A,A00,098035,Nie; Jiawang,0,0,15,16
1668023990434,MATH 248,A00,098036,Bejenaru; Ioan,10,0,10,0
1668023990858,MATH 250B,A00,098037,Spolaor; Luca,14,0,15,1
1668023991311,MATH 258,A00,098038,Ni; Lei,10,0,10,0
1668023991742,MATH 264B,A00,098041,Rhoades; Brendon Patrick,10,0,15,5
1668023992165,MATH 268,A00,098042,Buss; Samuel R,10,0,10,0
1668023992591,MATH 269,A00,098043,Rhoades; Brendon Patrick,10,0,10,0
1668023993026,MATH 270B,A00,098044,Li; Bo,11,0,15,4
1668023993456,MATH 272B,A00,098045,Holst; Michael J,13,0,15,2
1668023993893,MATH 273A,A00,098046,Tian; Xiaochuan,10,0,15,5
1668023994315,MATH 275,A01,098048,Tian; Xiaochuan,6,0,10,4
1668023994736,MATH 278A,A00,098049,Holst; Michael J,8,0,10,2
1668023995172,MATH 278B,A00,098050,Cloninger; Alexander,10,0,10,0
1668023995608,MATH 278C,A00,098051,Nie; Jiawang,8,0,10,2
1668023996042,MATH 280B,A00,098052,Zheng; Tianyi,11,0,15,4
1668023996482,MATH 281B,A00,098053,Bradic; Jelena,4,0,15,11
1668023996908,MATH 282B,A00,098054,Arias-Castro; Ery,2,0,15,13
1668023997336,MATH 285,A00,098055,Fitzsimmons; Patrick J,0,0,15,17
1668023997770,MATH 287B,A00,098056,Arias-Castro; Ery,4,0,15,11
1668023998192,MATH 288,A00,098057,Agarwal; Pooja,9,0,10,1
1668023998192,MATH 288,B00,098058,Zhang; Danna,9,0,10,1
1668023998192,MATH 288,C00,098059,Williams; Ruth J,10,0,10,0
1668023998616,MATH 290B,A00,098060,Roberts; Justin Deritter,13,0,15,2
1668023999055,MATH 292,A00,098061,Belmont; Eva Kinoshita,10,0,10,0
1668023999493,MATH 295,A00,098062,Suk; Andrew Hoon,48,0,50,2
1668023999924,MATH 296,A00,098063,Novak; Jonathan I,20,0,20,0
1668024000355,MATH 297,001,098064,Gamst; Anthony Collins,9997,0,9999,2
1668024508313,COGS 205,A00,101395,Chiba; Andrea,19,0,20,1
1668024508738,COGS 210B,001,101404,Greene; Deanna Jacquelyn,9998,0,9999,1
1668024508738,COGS 210B,002,101417,Xia; Haijun,9999,0,9999,0
1668024508738,COGS 210B,003,101422,Nitz; Douglas A.,9999,0,9999,0
1668024508738,COGS 210B,004,101423,Hollan; James D.,9998,0,9999,1
1668024508738,COGS 210B,005,101424,Deak; Gedeon O.,9999,0,9999,0
1668024508738,COGS 210B,006,101425,Rossano; Federico,9999,0,9999,0
1668024509167,COGS 211B,A00,101427,Coulson; Seana M,9997,0,9999,2
1668024509592,COGS 220,A00,101428,Hollan; James D.,0,0,25,25
1668024510025,COGS 229,A00,101429,Dow; Steven P,18,0,25,7
1668024510448,COGS 230,A00,101430,Klemmer; Scott R,13,0,17,4
1668024510881,COGS 234,A00,101431,Xia; Haijun,5,0,25,20
1668024511309,COGS 260,A00,101432,Kiyonaga; Anastasia,20,0,25,5
1668024511309,COGS 260,B00,101433,Kirsh; David Joel,16,0,25,9
1668024511751,CSE 202,A00,102371,Impagliazzo; Russell,0,0,0,0
1668024512172,CSE 203B,A01,102373,Cheng; Chung Kuan,0,0,0,0
1668024512596,CSE 208,A00,102374,Micciancio; Daniele,0,0,0,0
1668024513024,CSE 209A,A00,112895,Impagliazzo; Russell,0,0,15,15
1668024513450,CSE 209B,A00,108005,Bellare; Mihir,0,0,0,0
1668024513888,CSE 210,A00,113163,Coblenz; Michael J,0,0,0,0
1668024514313,CSE 219,A00,106111,Dow; Steven P,0,0,20,20
1668024514739,CSE 221,A00,102376,Voelker; Geoffrey M.,0,0,0,0
1668024515161,CSE 224,A01,102378,Porter; George M,0,0,0,0
1668024515587,CSE 229A,A00,102379,Savage; Stefan,0,0,0,0
1668024516013,CSE 229C,A00,102380,Munyaka; Imani N. S.,0,0,0,0
1668024516458,CSE 232B,A00,102382,Deutsch; Alin Bernard,0,0,0,0
1668024516883,CSE 234,A01,112904,Kumar; Arun Kumar,0,0,0,0
1668024517306,CSE 237A,A00,102383,Rosing; Tajana Simunic,0,0,0,0
1668024517736,CSE 239A,A00,102384,Deutsch; Alin Bernard,0,0,0,0
1668024518162,CSE 239B,A00,102385,Polikarpova; Nadezhda,0,0,0,0
1668024518593,CSE 240A,A00,102386,Pannuto; Patrick William,0,0,0,0
1668024519018,CSE 240B,A00,102387,Zhao; Jishen,0,0,0,0
1668024519457,CSE 241A,A00,106406,Kang; Mingu,0,0,0,0
1668024519887,CSE 249B,A00,102388,Kahng; Andrew Byun,0,0,8,8
1668024520319,CSE 251B,A01,102392,Cottrell; Garrison W,0,0,0,0
1668024520319,CSE 251B,A02,102393,Cottrell; Garrison W,0,0,0,0
1668024520750,CSE 252B,A00,102394,Ochoa; Benjamin Lawrence,0,0,0,0
1668024521173,CSE 257,A01,102396,Gao; Sicun,0,0,0,0
1668024521603,CSE 272,A00,102397,Li; Tzumao,0,0,0,0
1668024522028,CSE 274,A00,111323,Chern; Albert Ren-Haur,0,0,0,0
1668024522469,CSE 282,A00,102398,Pevzner; Pavel Arkadjevich,0,0,0,0
1668024522890,CSE 284,A00,114175,Gymrek; Melissa Ann,0,0,0,0
1668024523320,CSE 290,A00,102399,Chandraker; Manmohan Krishna,0,0,0,0
1668024523320,CSE 290,B00,102400,Vaccaro; Kristen Marie,0,0,25,25
1668024523320,CSE 290,C00,102414,Pannuto; Patrick William,0,0,25,25
1668024523320,CSE 290,D00,102427,Pevzner; Pavel Arkadjevich,0,0,0,0
1668024523320,CSE 290,E00,102429,Zhao; Jishen,0,0,0,0
1668024523320,CSE 290,F00,102436,Tullsen; Dean Michael,0,0,0,0
1668024523320,CSE 290,G00,102440,Christensen; Henrik I,0,0,20,20
1668024523757,CSE 291,A00,102443,Su; Hao,0,0,0,0
1668024523757,CSE 291,B00,102448,Polikarpova; Nadezhda,0,0,0,0
1668024523757,CSE 291,C00,102453,Vaccaro; Kristen Marie,0,0,0,0
1668024523757,CSE 291,D00,111343,Savage; Stefan,0,0,0,0
1668024523757,CSE 291,E00,116474,Claffy; Kimberly Claire,0,0,0,0
1668024523757,CSE 291,F00,116479,Pasquale; Joseph,0,0,0,0
1668024524187,CSE 293,001,119111,Bafna; Vineet,9999,0,9999,0
1668024524187,CSE 293,002,119118,Bellare; Mihir,9999,0,9999,0
1668024524187,CSE 293,003,119122,Berg-Kirkpatrick; Taylor D,9999,0,9999,0
1668024524187,CSE 293,004,119135,Christensen; Henrik I,9999,0,9999,0
1668024524187,CSE 293,005,119142,Cottrell; Garrison W,9999,0,9999,0
1668024524187,CSE 293,006,119146,Deutsch; Alin Bernard,9999,0,9999,0
1668024524187,CSE 293,007,119159,Esmaeilzadeh; Hadi,9999,0,9999,0
1668024524187,CSE 293,008,119166,Freund; Yoav,9999,0,9999,0
1668024524187,CSE 293,009,119170,Griswold; William G.,9999,0,9999,0
1668024524187,CSE 293,010,119183,Gymrek; Melissa Ann,9999,0,9999,0
1668024524187,CSE 293,011,119190,Heninger; Nadia A,9999,0,9999,0
1668024524187,CSE 293,012,119230,Impagliazzo; Russell,9999,0,9999,0
1668024524187,CSE 293,013,119232,Jhala; Ranjit,9999,0,9999,0
1668024524187,CSE 293,014,119233,Kahng; Andrew Byun,9999,0,9999,0
1668024524187,CSE 293,015,119298,Kane; Daniel Mertz,9999,0,9999,0
1668024524187,CSE 293,016,119299,Kriegman; David J,9999,0,9999,0
1668024524187,CSE 293,017,119300,Kumar; Arun Kumar,9999,0,9999,0
1668024524187,CSE 293,018,119301,Lerner; Sorin,9999,0,9999,0
1668024524187,CSE 293,019,119302,Lovett; Shachar,9999,0,9999,0
1668024524187,CSE 293,020,119303,McAuley; Julian John,9999,0,9999,0
1668024524187,CSE 293,021,119304,Micciancio; Daniele,9999,0,9999,0
1668024524187,CSE 293,022,119367,Orailoglu; Alex,9999,0,9999,0
1668024524187,CSE 293,023,119382,Paturi; Ramamohan,9999,0,9999,0
1668024524187,CSE 293,024,119404,Polikarpova; Nadezhda,9999,0,9999,0
1668024524187,CSE 293,025,119406,Politz; Joseph Gibbs,9999,0,9999,0
1668024524187,CSE 293,026,119411,Porter; George M,9999,0,9999,0
1668024524187,CSE 293,027,119414,Porter; Leonard Emerson,9999,0,9999,0
1668024524187,CSE 293,028,119416,Ramamoorthi; Ravi,9999,0,9999,0
1668024524187,CSE 293,029,119417,Sahoo; Debashis,9999,0,9999,0
1668024524187,CSE 293,030,119420,Saul; Lawrence,9999,0,9999,0
1668024524187,CSE 293,031,119421,Savage; Stefan,9999,0,9999,0
1668024524187,CSE 293,032,119425,Schulze; Jurgen P.,9999,0,9999,0
1668024524187,CSE 293,033,119426,Snoeren; Alex C.,9999,0,9999,0
1668024524187,CSE 293,034,119428,Shang; Jingbo,9999,0,9999,0
1668024524187,CSE 293,035,119430,Stefan; Deian,9999,0,9999,0
1668024524187,CSE 293,036,119431,Su; Hao,9999,0,9999,0
1668024524187,CSE 293,037,119433,Swanson; Steven James,9999,0,9999,0
1668024524187,CSE 293,038,119435,Tullsen; Dean Michael,9999,0,9999,0
1668024524187,CSE 293,039,119483,Voelker; Geoffrey M.,9999,0,9999,0
1668024524187,CSE 293,040,119537,Zhao; Jishen,9999,0,9999,0
1668024524187,CSE 293,041,119538,Zhou; Yuan-Yuan,9999,0,9999,0
1668024524187,CSE 293,042,119539,Gao; Sicun,9999,0,9999,0
1668024524187,CSE 293,043,119540,Weibel; Nadir,9999,0,9999,0
1668024524187,CSE 293,044,119541,Gupta; Rajesh K.,9999,0,9999,0
1668024524187,CSE 293,045,126410,Vaccaro; Kristen Marie,9999,0,9999,0
1668024524187,CSE 293,046,126411,Klemke; Richard,9999,0,9999,0
1668024524619,CSE 294,A00,102459,Voelker; Geoffrey M.,0,0,0,0
1668024524619,CSE 294,B00,111322,Orailoglu; Alex,0,0,0,0
1668024525047,DSE 201,A00,096914,Deutsch; Alin Bernard,30,0,30,0
1668024525489,DSE 210,A00,096915,Dasgupta; Sanjoy,30,0,30,0
1668024525916,DSE 260A,A00,096916,Altintas De Callaf; Ilkay,30,0,30,0
1668024526361,ECE 200,001,103586,Antipa; Nicholas A,9999,0,9999,0
1668024526361,ECE 200,002,103587,Atanasov; Nikolay A.,9999,0,9999,0
1668024526361,ECE 200,003,103588,Bharadia; Dinesh,9999,0,9999,0
1668024526361,ECE 200,004,103589,Cheng; Chung Kuan,9999,0,9999,0
1668024526361,ECE 200,005,103590,Cosman; Pamela C.,9999,0,9999,0
1668024526361,ECE 200,006,103591,Dayeh; Shadi Ahmad,9999,0,9999,0
1668024526361,ECE 200,007,103592,Fainman; Yeshaiahu,9999,0,9999,0
1668024526361,ECE 200,008,103593,Ford; Joseph Earl,9999,0,9999,0
1668024526361,ECE 200,009,103594,Franceschetti; Massimo,9999,0,9999,0
1668024526361,ECE 200,010,103595,Fullerton; Eric E,9999,0,9999,0
1668024526361,ECE 200,011,103596,Galton; Ian A,9999,0,9999,0
1668024526361,ECE 200,012,103597,Gilja; Vikash,9999,0,9999,0
1668024526361,ECE 200,013,103598,Hall; Drew A.,9999,0,9999,0
1668024526361,ECE 200,014,103599,Hsueh; Tzu-Chien,9999,0,9999,0
1668024526361,ECE 200,015,103600,Javidi; Tara,9999,0,9999,0
1668024526361,ECE 200,016,103601,Kahng; Andrew Byun,9999,0,9999,0
1668024526361,ECE 200,017,103602,Kim; Young-Han,9999,0,9999,0
1668024526361,ECE 200,018,103603,Koushanfar; Farinaz,9999,0,9999,0
1668024526361,ECE 200,019,103604,Kuzum; Duygu,9999,0,9999,0
1668024526361,ECE 200,020,103605,Le; Hanh-Phuc,9999,0,9999,0
1668024526361,ECE 200,021,103606,Lin; Bill,9999,0,9999,0
1668024526361,ECE 200,022,103607,Liu; Zhaowei,9998,0,9999,1
1668024526361,ECE 200,023,103608,Lo; Yu-Hwa,9999,0,9999,0
1668024526361,ECE 200,024,103609,Lomakin; Vitaliy,9999,0,9999,0
1668024526361,ECE 200,025,103610,Mercier; Patrick Philip,9999,0,9999,0
1668024526361,ECE 200,026,103611,Meyer; Florian,9999,0,9999,0
1668024526361,ECE 200,027,103612,Milstein; Laurence B.,9999,0,9999,0
1668024526361,ECE 200,028,103613,Mir Arabbaygi; Siavash,9999,0,9999,0
1668024526361,ECE 200,029,103614,Mookherjea; Shayan,9999,0,9999,0
1668024526361,ECE 200,030,103615,Morris; Karcher William,9999,0,9999,0
1668024526361,ECE 200,031,103616,Ng; Tse Nga,9999,0,9999,0
1668024526361,ECE 200,032,103617,Nguyen; Truong Quang,9999,0,9999,0
1668024526361,ECE 200,033,103618,Nomura; Kenji,9999,0,9999,0
1668024526361,ECE 200,034,103619,Orlitsky; Alon,9999,0,9999,0
1668024526361,ECE 200,035,103620,Pal; Piya,9999,0,9999,0
1668024526361,ECE 200,036,103621,Papen; George C.,9999,0,9999,0
1668024526361,ECE 200,037,103622,Radic; Stojan,9999,0,9999,0
1668024526361,ECE 200,038,103623,Rao; Bhaskar D.,9999,0,9999,0
1668024526361,ECE 200,039,103624,Rao; Ramesh R,9999,0,9999,0
1668024526361,ECE 200,040,103625,Rebeiz; Gabriel,9999,0,9999,0
1668024526361,ECE 200,041,103626,Sanford; John R,9999,0,9999,0
1668024526361,ECE 200,042,103627,Siegel; Paul H.,9999,0,9999,0
1668024526361,ECE 200,043,103628,Sievenpiper; Daniel F.,9999,0,9999,0
1668024526361,ECE 200,044,103629,Sworder; David D.,9999,0,9999,0
1668024526361,ECE 200,045,103630,Taur; Yuan,9999,0,9999,0
1668024526361,ECE 200,046,103631,Touri; Behrouz,9999,0,9999,0
1668024526361,ECE 200,047,103632,Trivedi; Mohan M.,9999,0,9999,0
1668024526361,ECE 200,048,103633,Vasconcelos; Nuno,9999,0,9999,0
1668024526361,ECE 200,049,103634,Wang; Xiaolong,9999,0,9999,0
1668024526361,ECE 200,050,103635,Xie; Pengtao,9999,0,9999,0
1668024526361,ECE 200,051,103636,Yip; Michael,9999,0,9999,0
1668024526361,ECE 200,052,103637,Zeger; Kenneth A.,999,0,999,0
1668024526361,ECE 200,053,103638,Zhang; Xinyu,9999,0,9999,0
1668024526361,ECE 200,054,103639,Turakhia; Yatish Girish,9999,0,9999,0
1668024526361,ECE 200,055,103640,Kang; Mingu,9999,0,9999,0
1668024526361,ECE 200,056,103641,Shi; Yuanyuan,9999,0,9999,0
1668024526361,ECE 200,057,103642,Wang; Edward Jay,9999,0,9999,0
1668024526361,ECE 200,058,103643,Zheng; Yang,9999,0,9999,0
1668024526803,ECE 202,A00,103644,Kuzum; Duygu,0,0,0,0
1668024527233,ECE 212BN,A00,103646,Ng; Tse Nga,0,0,0,0
1668024527657,ECE 221,A00,111493,Staff,0,0,0,0
1668024528084,ECE 222B,A00,103647,Lomakin; Vitaliy,0,0,0,0
1668024528519,ECE 230B,A00,103648,Taur; Yuan,0,0,0,0
1668024528947,ECE 238B,A00,103649,Garay; Javier,0,0,0,0
1668024529370,ECE 240B,A00,112900,Fainman; Yeshaiahu,0,0,0,0
1668024529797,ECE 247A,A00,103650,Jokerst; Jesse Vincent,0,0,0,0
1668024530219,ECE 247B,A00,103651,Wang; Joseph,0,0,0,0
1668024530643,ECE 250,A00,103652,Siegel; Paul H.,0,0,0,0
1668024531078,ECE 251A,A00,103654,Rao; Bhaskar D.,0,0,0,0
1668024531511,ECE 257B,A00,103655,Bharadia; Dinesh,0,0,0,0
1668024531947,ECE 258A,A00,103656,Milstein; Laurence B.,0,0,0,0
1668024532377,ECE 260B,A00,103658,Kang; Mingu,0,0,0,0
1668024532807,ECE 264A,A00,103659,Galton; Ian A,0,0,0,0
1668024533234,ECE 265A,A00,103661,Gudem; Prasad S.S.,0,0,0,0
1668024533659,ECE 265D,A00,103662,Gudem; Prasad S.S.,0,0,0,0
1668024534082,ECE 268,A00,103663,Koushanfar; Farinaz,0,0,0,0
1668024534593,ECE 269,A01,103665,Pal; Piya,0,0,0,0
1668024535023,ECE 271B,A00,103666,Vasconcelos; Manuela,0,0,0,0
1668024535445,ECE 276A,A00,103667,Atanasov; Nikolay A.,0,0,0,0
1668024535874,ECE 277,A00,103668,An; Cheolhong,0,0,0,0
1668024536299,ECE 279,A00,117947,Hall; Drew A.,0,0,0,0
1668024537171,ECE 283,A00,103670,Hsueh; Tzu-Chien,0,0,0,0
1668024537603,ECE 284,A00,103671,Turakhia; Yatish Girish,0,0,0,0
1668024538033,ECE 285,A00,103672,Zheng; Yang,0,0,0,0
1668024538033,ECE 285,B00,103673,Sworder; David D.,0,0,0,0
1668024538468,ECE 287,A00,103676,Javidi; Tara,0,0,0,0
1668024538895,MATH 200B,A00,098023,Salehi Golsefidy; Alireza,13,0,15,2
1668024539323,MATH 202B,A00,098024,Rhoades; Brendon Patrick,10,0,15,5
1668024539755,MATH 203B,A00,098025,Oprea; Dragos N.,11,0,15,4
1668024540178,MATH 204B,A00,098026,Sorensen; Claus M,14,0,15,1
1668024540606,MATH 208,A00,098027,Izadi; Elham,7,0,10,3
1668024541121,MATH 209,A00,098028,Pollack; Aaron,10,0,10,0
1668024541544,MATH 211A,A00,112919,Rogalski; Daniel,9,0,10,1
1668024541966,MATH 211B,A00,112920,Seward; Brandon M.,9,0,10,1
1668024542388,MATH 218,A00,098029,Li; Bo,10,0,10,0
1668024542817,MATH 220B,A00,098030,Novak; Jonathan I,13,0,15,2
1668024543245,MATH 221A,A00,098031,Ebenfelt; Peter F,13,0,15,2
1668024543674,MATH 231B,A00,098032,Zlatos; Andrej,12,0,15,3
1668024544103,MATH 240B,A00,098033,Ni; Lei,9,0,15,6
1668024544535,MATH 243,A00,098034,Jekel; David Andrew,10,0,10,0
1668024544971,MATH 245A,A00,098035,Nie; Jiawang,0,0,15,16
1668024545397,MATH 248,A00,098036,Bejenaru; Ioan,10,0,10,0
1668024545838,MATH 250B,A00,098037,Spolaor; Luca,14,0,15,1
1668024546270,MATH 258,A00,098038,Ni; Lei,10,0,10,0
1668024546692,MATH 264B,A00,098041,Rhoades; Brendon Patrick,10,0,15,5
1668024547119,MATH 268,A00,098042,Buss; Samuel R,10,0,10,0
1668024547546,MATH 269,A00,098043,Rhoades; Brendon Patrick,10,0,10,0
1668024547974,MATH 270B,A00,098044,Li; Bo,11,0,15,4
1668024548407,MATH 272B,A00,098045,Holst; Michael J,13,0,15,2
1668024548833,MATH 273A,A00,098046,Tian; Xiaochuan,10,0,15,5
1668024549269,MATH 275,A01,098048,Tian; Xiaochuan,6,0,10,4
1668024549692,MATH 278A,A00,098049,Holst; Michael J,8,0,10,2
1668024550116,MATH 278B,A00,098050,Cloninger; Alexander,10,0,10,0
1668024550543,MATH 278C,A00,098051,Nie; Jiawang,8,0,10,2
1668024550969,MATH 280B,A00,098052,Zheng; Tianyi,11,0,15,4
1668024551395,MATH 281B,A00,098053,Bradic; Jelena,4,0,15,11
1668024551824,MATH 282B,A00,098054,Arias-Castro; Ery,2,0,15,13
1668024552247,MATH 285,A00,098055,Fitzsimmons; Patrick J,0,0,15,17
1668024552672,MATH 287B,A00,098056,Arias-Castro; Ery,4,0,15,11
1668024553096,MATH 288,A00,098057,Agarwal; Pooja,9,0,10,1
1668024553096,MATH 288,B00,098058,Zhang; Danna,9,0,10,1
1668024553096,MATH 288,C00,098059,Williams; Ruth J,10,0,10,0
1668024553522,MATH 290B,A00,098060,Roberts; Justin Deritter,13,0,15,2
1668024553944,MATH 292,A00,098061,Belmont; Eva Kinoshita,10,0,10,0
1668024554387,MATH 295,A00,098062,Suk; Andrew Hoon,48,0,50,2
1668024554987,MATH 296,A00,098063,Novak; Jonathan I,20,0,20,0
1668024555414,MATH 297,001,098064,Gamst; Anthony Collins,9997,0,9999,2
1668025070755,COGS 205,A00,101395,Chiba; Andrea,19,0,20,1
1668025071183,COGS 210B,001,101404,Greene; Deanna Jacquelyn,9998,0,9999,1
1668025071183,COGS 210B,002,101417,Xia; Haijun,9999,0,9999,0
1668025071183,COGS 210B,003,101422,Nitz; Douglas A.,9999,0,9999,0
1668025071183,COGS 210B,004,101423,Hollan; James D.,9998,0,9999,1
1668025071183,COGS 210B,005,101424,Deak; Gedeon O.,9999,0,9999,0
1668025071183,COGS 210B,006,101425,Rossano; Federico,9999,0,9999,0
1668025071627,COGS 211B,A00,101427,Coulson; Seana M,9997,0,9999,2
1668025072061,COGS 220,A00,101428,Hollan; James D.,0,0,25,25
1668025072490,COGS 229,A00,101429,Dow; Steven P,18,0,25,7
1668025072914,COGS 230,A00,101430,Klemmer; Scott R,13,0,17,4
1668025073346,COGS 234,A00,101431,Xia; Haijun,5,0,25,20
1668025073772,COGS 260,A00,101432,Kiyonaga; Anastasia,20,0,25,5
1668025073772,COGS 260,B00,101433,Kirsh; David Joel,16,0,25,9
1668025074198,CSE 202,A00,102371,Impagliazzo; Russell,0,0,0,0
1668025074632,CSE 203B,A01,102373,Cheng; Chung Kuan,0,0,0,0
1668025075060,CSE 208,A00,102374,Micciancio; Daniele,0,0,0,0
1668025075484,CSE 209A,A00,112895,Impagliazzo; Russell,0,0,15,15
1668025075909,CSE 209B,A00,108005,Bellare; Mihir,0,0,0,0
1668025076336,CSE 210,A00,113163,Coblenz; Michael J,0,0,0,0
1668025076978,CSE 219,A00,106111,Dow; Steven P,0,0,20,20
1668025077410,CSE 221,A00,102376,Voelker; Geoffrey M.,0,0,0,0
1668025077842,CSE 224,A01,102378,Porter; George M,0,0,0,0
1668025078269,CSE 229A,A00,102379,Savage; Stefan,0,0,0,0
1668025078691,CSE 229C,A00,102380,Munyaka; Imani N. S.,0,0,0,0
1668025079126,CSE 232B,A00,102382,Deutsch; Alin Bernard,0,0,0,0
1668025079563,CSE 234,A01,112904,Kumar; Arun Kumar,0,0,0,0
1668025079987,CSE 237A,A00,102383,Rosing; Tajana Simunic,0,0,0,0
1668025080415,CSE 239A,A00,102384,Deutsch; Alin Bernard,0,0,0,0
1668025080849,CSE 239B,A00,102385,Polikarpova; Nadezhda,0,0,0,0
1668025081272,CSE 240A,A00,102386,Pannuto; Patrick William,0,0,0,0
1668025081701,CSE 240B,A00,102387,Zhao; Jishen,0,0,0,0
1668025082128,CSE 241A,A00,106406,Kang; Mingu,0,0,0,0
1668025082573,CSE 249B,A00,102388,Kahng; Andrew Byun,0,0,8,8
1668025082997,CSE 251B,A01,102392,Cottrell; Garrison W,0,0,0,0
1668025082997,CSE 251B,A02,102393,Cottrell; Garrison W,0,0,0,0
1668025083420,CSE 252B,A00,102394,Ochoa; Benjamin Lawrence,0,0,0,0
1668025083846,CSE 257,A01,102396,Gao; Sicun,0,0,0,0
1668025084281,CSE 272,A00,102397,Li; Tzumao,0,0,0,0
1668025084796,CSE 274,A00,111323,Chern; Albert Ren-Haur,0,0,0,0
1668025085221,CSE 282,A00,102398,Pevzner; Pavel Arkadjevich,0,0,0,0
1668025085667,CSE 284,A00,114175,Gymrek; Melissa Ann,0,0,0,0
1668025086100,CSE 290,A00,102399,Chandraker; Manmohan Krishna,0,0,0,0
1668025086100,CSE 290,B00,102400,Vaccaro; Kristen Marie,0,0,25,25
1668025086100,CSE 290,C00,102414,Pannuto; Patrick William,0,0,25,25
1668025086100,CSE 290,D00,102427,Pevzner; Pavel Arkadjevich,0,0,0,0
1668025086100,CSE 290,E00,102429,Zhao; Jishen,0,0,0,0
1668025086100,CSE 290,F00,102436,Tullsen; Dean Michael,0,0,0,0
1668025086100,CSE 290,G00,102440,Christensen; Henrik I,0,0,20,20
1668025086530,CSE 291,A00,102443,Su; Hao,0,0,0,0
1668025086530,CSE 291,B00,102448,Polikarpova; Nadezhda,0,0,0,0
1668025086530,CSE 291,C00,102453,Vaccaro; Kristen Marie,0,0,0,0
1668025086530,CSE 291,D00,111343,Savage; Stefan,0,0,0,0
1668025086530,CSE 291,E00,116474,Claffy; Kimberly Claire,0,0,0,0
1668025086530,CSE 291,F00,116479,Pasquale; Joseph,0,0,0,0
1668025086967,CSE 293,001,119111,Bafna; Vineet,9999,0,9999,0
1668025086967,CSE 293,002,119118,Bellare; Mihir,9999,0,9999,0
1668025086967,CSE 293,003,119122,Berg-Kirkpatrick; Taylor D,9999,0,9999,0
1668025086967,CSE 293,004,119135,Christensen; Henrik I,9999,0,9999,0
1668025086967,CSE 293,005,119142,Cottrell; Garrison W,9999,0,9999,0
1668025086967,CSE 293,006,119146,Deutsch; Alin Bernard,9999,0,9999,0
1668025086967,CSE 293,007,119159,Esmaeilzadeh; Hadi,9999,0,9999,0
1668025086967,CSE 293,008,119166,Freund; Yoav,9999,0,9999,0
1668025086967,CSE 293,009,119170,Griswold; William G.,9999,0,9999,0
1668025086967,CSE 293,010,119183,Gymrek; Melissa Ann,9999,0,9999,0
1668025086967,CSE 293,011,119190,Heninger; Nadia A,9999,0,9999,0
1668025086967,CSE 293,012,119230,Impagliazzo; Russell,9999,0,9999,0
1668025086967,CSE 293,013,119232,Jhala; Ranjit,9999,0,9999,0
1668025086967,CSE 293,014,119233,Kahng; Andrew Byun,9999,0,9999,0
1668025086967,CSE 293,015,119298,Kane; Daniel Mertz,9999,0,9999,0
1668025086967,CSE 293,016,119299,Kriegman; David J,9999,0,9999,0
1668025086967,CSE 293,017,119300,Kumar; Arun Kumar,9999,0,9999,0
1668025086967,CSE 293,018,119301,Lerner; Sorin,9999,0,9999,0
1668025086967,CSE 293,019,119302,Lovett; Shachar,9999,0,9999,0
1668025086967,CSE 293,020,119303,McAuley; Julian John,9999,0,9999,0
1668025086967,CSE 293,021,119304,Micciancio; Daniele,9999,0,9999,0
1668025086967,CSE 293,022,119367,Orailoglu; Alex,9999,0,9999,0
1668025086967,CSE 293,023,119382,Paturi; Ramamohan,9999,0,9999,0
1668025086967,CSE 293,024,119404,Polikarpova; Nadezhda,9999,0,9999,0
1668025086967,CSE 293,025,119406,Politz; Joseph Gibbs,9999,0,9999,0
1668025086967,CSE 293,026,119411,Porter; George M,9999,0,9999,0
1668025086967,CSE 293,027,119414,Porter; Leonard Emerson,9999,0,9999,0
1668025086967,CSE 293,028,119416,Ramamoorthi; Ravi,9999,0,9999,0
1668025086967,CSE 293,029,119417,Sahoo; Debashis,9999,0,9999,0
1668025086967,CSE 293,030,119420,Saul; Lawrence,9999,0,9999,0
1668025086967,CSE 293,031,119421,Savage; Stefan,9999,0,9999,0
1668025086967,CSE 293,032,119425,Schulze; Jurgen P.,9999,0,9999,0
1668025086967,CSE 293,033,119426,Snoeren; Alex C.,9999,0,9999,0
1668025086967,CSE 293,034,119428,Shang; Jingbo,9999,0,9999,0
1668025086967,CSE 293,035,119430,Stefan; Deian,9999,0,9999,0
1668025086967,CSE 293,036,119431,Su; Hao,9999,0,9999,0
1668025086967,CSE 293,037,119433,Swanson; Steven James,9999,0,9999,0
1668025086967,CSE 293,038,119435,Tullsen; Dean Michael,9999,0,9999,0
1668025086967,CSE 293,039,119483,Voelker; Geoffrey M.,9999,0,9999,0
1668025086967,CSE 293,040,119537,Zhao; Jishen,9999,0,9999,0
1668025086967,CSE 293,041,119538,Zhou; Yuan-Yuan,9999,0,9999,0
1668025086967,CSE 293,042,119539,Gao; Sicun,9999,0,9999,0
1668025086967,CSE 293,043,119540,Weibel; Nadir,9999,0,9999,0
1668025086967,CSE 293,044,119541,Gupta; Rajesh K.,9999,0,9999,0
1668025086967,CSE 293,045,126410,Vaccaro; Kristen Marie,9999,0,9999,0
1668025086967,CSE 293,046,126411,Klemke; Richard,9999,0,9999,0
1668025087402,CSE 294,A00,102459,Voelker; Geoffrey M.,0,0,0,0
1668025087402,CSE 294,B00,111322,Orailoglu; Alex,0,0,0,0
1668025087858,DSE 201,A00,096914,Deutsch; Alin Bernard,30,0,30,0
1668025088282,DSE 210,A00,096915,Dasgupta; Sanjoy,30,0,30,0
1668025088705,DSE 260A,A00,096916,Altintas De Callaf; Ilkay,30,0,30,0
1668025089140,ECE 200,001,103586,Antipa; Nicholas A,9999,0,9999,0
1668025089140,ECE 200,002,103587,Atanasov; Nikolay A.,9999,0,9999,0
1668025089140,ECE 200,003,103588,Bharadia; Dinesh,9999,0,9999,0
1668025089140,ECE 200,004,103589,Cheng; Chung Kuan,9999,0,9999,0
1668025089140,ECE 200,005,103590,Cosman; Pamela C.,9999,0,9999,0
1668025089140,ECE 200,006,103591,Dayeh; Shadi Ahmad,9999,0,9999,0
1668025089140,ECE 200,007,103592,Fainman; Yeshaiahu,9999,0,9999,0
1668025089140,ECE 200,008,103593,Ford; Joseph Earl,9999,0,9999,0
1668025089140,ECE 200,009,103594,Franceschetti; Massimo,9999,0,9999,0
1668025089140,ECE 200,010,103595,Fullerton; Eric E,9999,0,9999,0
1668025089140,ECE 200,011,103596,Galton; Ian A,9999,0,9999,0
1668025089140,ECE 200,012,103597,Gilja; Vikash,9999,0,9999,0
1668025089140,ECE 200,013,103598,Hall; Drew A.,9999,0,9999,0
1668025089140,ECE 200,014,103599,Hsueh; Tzu-Chien,9999,0,9999,0
1668025089140,ECE 200,015,103600,Javidi; Tara,9999,0,9999,0
1668025089140,ECE 200,016,103601,Kahng; Andrew Byun,9999,0,9999,0
1668025089140,ECE 200,017,103602,Kim; Young-Han,9999,0,9999,0
1668025089140,ECE 200,018,103603,Koushanfar; Farinaz,9999,0,9999,0
1668025089140,ECE 200,019,103604,Kuzum; Duygu,9999,0,9999,0
1668025089140,ECE 200,020,103605,Le; Hanh-Phuc,9999,0,9999,0
1668025089140,ECE 200,021,103606,Lin; Bill,9999,0,9999,0
1668025089140,ECE 200,022,103607,Liu; Zhaowei,9998,0,9999,1
1668025089140,ECE 200,023,103608,Lo; Yu-Hwa,9999,0,9999,0
1668025089140,ECE 200,024,103609,Lomakin; Vitaliy,9999,0,9999,0
1668025089140,ECE 200,025,103610,Mercier; Patrick Philip,9999,0,9999,0
1668025089140,ECE 200,026,103611,Meyer; Florian,9999,0,9999,0
1668025089140,ECE 200,027,103612,Milstein; Laurence B.,9999,0,9999,0
1668025089140,ECE 200,028,103613,Mir Arabbaygi; Siavash,9999,0,9999,0
1668025089140,ECE 200,029,103614,Mookherjea; Shayan,9999,0,9999,0
1668025089140,ECE 200,030,103615,Morris; Karcher William,9999,0,9999,0
1668025089140,ECE 200,031,103616,Ng; Tse Nga,9999,0,9999,0
1668025089140,ECE 200,032,103617,Nguyen; Truong Quang,9999,0,9999,0
1668025089140,ECE 200,033,103618,Nomura; Kenji,9999,0,9999,0
1668025089140,ECE 200,034,103619,Orlitsky; Alon,9999,0,9999,0
1668025089140,ECE 200,035,103620,Pal; Piya,9999,0,9999,0
1668025089140,ECE 200,036,103621,Papen; George C.,9999,0,9999,0
1668025089140,ECE 200,037,103622,Radic; Stojan,9999,0,9999,0
1668025089140,ECE 200,038,103623,Rao; Bhaskar D.,9999,0,9999,0
1668025089140,ECE 200,039,103624,Rao; Ramesh R,9999,0,9999,0
1668025089140,ECE 200,040,103625,Rebeiz; Gabriel,9999,0,9999,0
1668025089140,ECE 200,041,103626,Sanford; John R,9999,0,9999,0
1668025089140,ECE 200,042,103627,Siegel; Paul H.,9999,0,9999,0
1668025089140,ECE 200,043,103628,Sievenpiper; Daniel F.,9999,0,9999,0
1668025089140,ECE 200,044,103629,Sworder; David D.,9999,0,9999,0
1668025089140,ECE 200,045,103630,Taur; Yuan,9999,0,9999,0
1668025089140,ECE 200,046,103631,Touri; Behrouz,9999,0,9999,0
1668025089140,ECE 200,047,103632,Trivedi; Mohan M.,9999,0,9999,0
1668025089140,ECE 200,048,103633,Vasconcelos; Nuno,9999,0,9999,0
1668025089140,ECE 200,049,103634,Wang; Xiaolong,9999,0,9999,0
1668025089140,ECE 200,050,103635,Xie; Pengtao,9999,0,9999,0
1668025089140,ECE 200,051,103636,Yip; Michael,9999,0,9999,0
1668025089140,ECE 200,052,103637,Zeger; Kenneth A.,999,0,999,0
1668025089140,ECE 200,053,103638,Zhang; Xinyu,9999,0,9999,0
1668025089140,ECE 200,054,103639,Turakhia; Yatish Girish,9999,0,9999,0
1668025089140,ECE 200,055,103640,Kang; Mingu,9999,0,9999,0
1668025089140,ECE 200,056,103641,Shi; Yuanyuan,9999,0,9999,0
1668025089140,ECE 200,057,103642,Wang; Edward Jay,9999,0,9999,0
1668025089140,ECE 200,058,103643,Zheng; Yang,9999,0,9999,0
1668025089566,ECE 202,A00,103644,Kuzum; Duygu,0,0,0,0
1668025089989,ECE 212BN,A00,103646,Ng; Tse Nga,0,0,0,0
1668025090422,ECE 221,A00,111493,Staff,0,0,0,0
1668025090847,ECE 222B,A00,103647,Lomakin; Vitaliy,0,0,0,0
1668025091287,ECE 230B,A00,103648,Taur; Yuan,0,0,0,0
1668025091712,ECE 238B,A00,103649,Garay; Javier,0,0,0,0
1668025092146,ECE 240B,A00,112900,Fainman; Yeshaiahu,0,0,0,0
1668025092577,ECE 247A,A00,103650,Jokerst; Jesse Vincent,0,0,0,0
1668025093000,ECE 247B,A00,103651,Wang; Joseph,0,0,0,0
1668025093423,ECE 250,A00,103652,Siegel; Paul H.,0,0,0,0
1668025093855,ECE 251A,A00,103654,Rao; Bhaskar D.,0,0,0,0
1668025094279,ECE 257B,A00,103655,Bharadia; Dinesh,0,0,0,0
1668025094704,ECE 258A,A00,103656,Milstein; Laurence B.,0,0,0,0
1668025095137,ECE 260B,A00,103658,Kang; Mingu,0,0,0,0
1668025095564,ECE 264A,A00,103659,Galton; Ian A,0,0,0,0
1668025095992,ECE 265A,A00,103661,Gudem; Prasad S.S.,0,0,0,0
1668025096417,ECE 265D,A00,103662,Gudem; Prasad S.S.,0,0,0,0
1668025096843,ECE 268,A00,103663,Koushanfar; Farinaz,0,0,0,0
1668025097274,ECE 269,A01,103665,Pal; Piya,0,0,0,0
1668025097706,ECE 271B,A00,103666,Vasconcelos; Manuela,0,0,0,0
1668025098131,ECE 276A,A00,103667,Atanasov; Nikolay A.,0,0,0,0
1668025098561,ECE 277,A00,103668,An; Cheolhong,0,0,0,0
1668025098990,ECE 279,A00,117947,Hall; Drew A.,0,0,0,0
1668025099851,ECE 283,A00,103670,Hsueh; Tzu-Chien,0,0,0,0
1668025100284,ECE 284,A00,103671,Turakhia; Yatish Girish,0,0,0,0
1668025100718,ECE 285,A00,103672,Zheng; Yang,0,0,0,0
1668025100718,ECE 285,B00,103673,Sworder; David D.,0,0,0,0
1668025101143,ECE 287,A00,103676,Javidi; Tara,0,0,0,0
1668025101565,MATH 200B,A00,098023,Salehi Golsefidy; Alireza,13,0,15,2
1668025101998,MATH 202B,A00,098024,Rhoades; Brendon Patrick,10,0,15,5
1668025102421,MATH 203B,A00,098025,Oprea; Dragos N.,11,0,15,4
1668025102856,MATH 204B,A00,098026,Sorensen; Claus M,14,0,15,1
1668025103293,MATH 208,A00,098027,Izadi; Elham,7,0,10,3
1668025103717,MATH 209,A00,098028,Pollack; Aaron,10,0,10,0
1668025104147,MATH 211A,A00,112919,Rogalski; Daniel,9,0,10,1
1668025104571,MATH 211B,A00,112920,Seward; Brandon M.,9,0,10,1
1668025104997,MATH 218,A00,098029,Li; Bo,10,0,10,0
1668025105424,MATH 220B,A00,098030,Novak; Jonathan I,13,0,15,2
1668025105851,MATH 221A,A00,098031,Ebenfelt; Peter F,13,0,15,2
1668025106279,MATH 231B,A00,098032,Zlatos; Andrej,12,0,15,3
1668025106707,MATH 240B,A00,098033,Ni; Lei,9,0,15,6
1668025107142,MATH 243,A00,098034,Jekel; David Andrew,10,0,10,0
1668025107577,MATH 245A,A00,098035,Nie; Jiawang,0,0,15,16
1668025108006,MATH 248,A00,098036,Bejenaru; Ioan,10,0,10,0
1668025108429,MATH 250B,A00,098037,Spolaor; Luca,14,0,15,1
1668025108865,MATH 258,A00,098038,Ni; Lei,10,0,10,0
1668025109289,MATH 264B,A00,098041,Rhoades; Brendon Patrick,10,0,15,5
1668025109717,MATH 268,A00,098042,Buss; Samuel R,10,0,10,0
1668025110148,MATH 269,A00,098043,Rhoades; Brendon Patrick,10,0,10,0
1668025110583,MATH 270B,A00,098044,Li; Bo,11,0,15,4
1668025111020,MATH 272B,A00,098045,Holst; Michael J,13,0,15,2
1668025111444,MATH 273A,A00,098046,Tian; Xiaochuan,10,0,15,5
1668025111873,MATH 275,A01,098048,Tian; Xiaochuan,6,0,10,4
1668025112301,MATH 278A,A00,098049,Holst; Michael J,8,0,10,2
1668025112726,MATH 278B,A00,098050,Cloninger; Alexander,10,0,10,0
1668025113159,MATH 278C,A00,098051,Nie; Jiawang,8,0,10,2
1668025113583,MATH 280B,A00,098052,Zheng; Tianyi,11,0,15,4
1668025114014,MATH 281B,A00,098053,Bradic; Jelena,4,0,15,11
1668025114441,MATH 282B,A00,098054,Arias-Castro; Ery,2,0,15,13
1668025114871,MATH 285,A00,098055,Fitzsimmons; Patrick J,0,0,15,17
1668025115342,MATH 287B,A00,098056,Arias-Castro; Ery,4,0,15,11
1668025115767,MATH 288,A00,098057,Agarwal; Pooja,9,0,10,1
1668025115767,MATH 288,B00,098058,Zhang; Danna,9,0,10,1
1668025115767,MATH 288,C00,098059,Williams; Ruth J,10,0,10,0
1668025116193,MATH 290B,A00,098060,Roberts; Justin Deritter,13,0,15,2
1668025116620,MATH 292,A00,098061,Belmont; Eva Kinoshita,10,0,10,0
1668025117048,MATH 295,A00,098062,Suk; Andrew Hoon,48,0,50,2
1668025117483,MATH 296,A00,098063,Novak; Jonathan I,20,0,20,0
1668025117912,MATH 297,001,098064,Gamst; Anthony Collins,9997,0,9999,2
1668025622086,COGS 205,A00,101395,Chiba; Andrea,19,0,20,1
1668025622525,COGS 210B,001,101404,Greene; Deanna Jacquelyn,9998,0,9999,1
1668025622525,COGS 210B,002,101417,Xia; Haijun,9999,0,9999,0
1668025622525,COGS 210B,003,101422,Nitz; Douglas A.,9999,0,9999,0
1668025622525,COGS 210B,004,101423,Hollan; James D.,9998,0,9999,1
1668025622525,COGS 210B,005,101424,Deak; Gedeon O.,9999,0,9999,0
1668025622525,COGS 210B,006,101425,Rossano; Federico,9999,0,9999,0
1668025622948,COGS 211B,A00,101427,Coulson; Seana M,9997,0,9999,2
1668025623370,COGS 220,A00,101428,Hollan; James D.,0,0,25,25
1668025623797,COGS 229,A00,101429,Dow; Steven P,18,0,25,7
1668025624233,COGS 230,A00,101430,Klemmer; Scott R,13,0,17,4
1668025624685,COGS 234,A00,101431,Xia; Haijun,5,0,25,20
1668025625109,COGS 260,A00,101432,Kiyonaga; Anastasia,20,0,25,5
1668025625109,COGS 260,B00,101433,Kirsh; David Joel,16,0,25,9
1668025625533,CSE 202,A00,102371,Impagliazzo; Russell,0,0,0,0
1668025625975,CSE 203B,A01,102373,Cheng; Chung Kuan,0,0,0,0
1668025626405,CSE 208,A00,102374,Micciancio; Daniele,0,0,0,0
1668025626833,CSE 209A,A00,112895,Impagliazzo; Russell,0,0,15,15
1668025627259,CSE 209B,A00,108005,Bellare; Mihir,0,0,0,0
1668025627684,CSE 210,A00,113163,Coblenz; Michael J,0,0,0,0
1668025628108,CSE 219,A00,106111,Dow; Steven P,0,0,20,20
1668025628532,CSE 221,A00,102376,Voelker; Geoffrey M.,0,0,0,0
1668025628966,CSE 224,A01,102378,Porter; George M,0,0,0,0
1668025629408,CSE 229A,A00,102379,Savage; Stefan,0,0,0,0
1668025629831,CSE 229C,A00,102380,Munyaka; Imani N. S.,0,0,0,0
1668025630263,CSE 232B,A00,102382,Deutsch; Alin Bernard,0,0,0,0
1668025630687,CSE 234,A01,112904,Kumar; Arun Kumar,0,0,0,0
1668025631126,CSE 237A,A00,102383,Rosing; Tajana Simunic,0,0,0,0
1668025631553,CSE 239A,A00,102384,Deutsch; Alin Bernard,0,0,0,0
1668025631978,CSE 239B,A00,102385,Polikarpova; Nadezhda,0,0,0,0
1668025632402,CSE 240A,A00,102386,Pannuto; Patrick William,0,0,0,0
1668025632844,CSE 240B,A00,102387,Zhao; Jishen,0,0,0,0
1668025633269,CSE 241A,A00,106406,Kang; Mingu,0,0,0,0
1668025633694,CSE 249B,A00,102388,Kahng; Andrew Byun,0,0,8,8
1668025634117,CSE 251B,A01,102392,Cottrell; Garrison W,0,0,0,0
1668025634117,CSE 251B,A02,102393,Cottrell; Garrison W,0,0,0,0
1668025634547,CSE 252B,A00,102394,Ochoa; Benjamin Lawrence,0,0,0,0
1668025634971,CSE 257,A01,102396,Gao; Sicun,0,0,0,0
1668025635397,CSE 272,A00,102397,Li; Tzumao,0,0,0,0
1668025635833,CSE 274,A00,111323,Chern; Albert Ren-Haur,0,0,0,0
1668025636257,CSE 282,A00,102398,Pevzner; Pavel Arkadjevich,0,0,0,0
1668025636682,CSE 284,A00,114175,Gymrek; Melissa Ann,0,0,0,0
1668025637128,CSE 290,A00,102399,Chandraker; Manmohan Krishna,0,0,0,0
1668025637128,CSE 290,B00,102400,Vaccaro; Kristen Marie,0,0,25,25
1668025637128,CSE 290,C00,102414,Pannuto; Patrick William,0,0,25,25
1668025637128,CSE 290,D00,102427,Pevzner; Pavel Arkadjevich,0,0,0,0
1668025637128,CSE 290,E00,102429,Zhao; Jishen,0,0,0,0
1668025637128,CSE 290,F00,102436,Tullsen; Dean Michael,0,0,0,0
1668025637128,CSE 290,G00,102440,Christensen; Henrik I,0,0,20,20
1668025637555,CSE 291,A00,102443,Su; Hao,0,0,0,0
1668025637555,CSE 291,B00,102448,Polikarpova; Nadezhda,0,0,0,0
1668025637555,CSE 291,C00,102453,Vaccaro; Kristen Marie,0,0,0,0
1668025637555,CSE 291,D00,111343,Savage; Stefan,0,0,0,0
1668025637555,CSE 291,E00,116474,Claffy; Kimberly Claire,0,0,0,0
1668025637555,CSE 291,F00,116479,Pasquale; Joseph,0,0,0,0
1668025637996,CSE 293,001,119111,Bafna; Vineet,9999,0,9999,0
1668025637996,CSE 293,002,119118,Bellare; Mihir,9999,0,9999,0
1668025637996,CSE 293,003,119122,Berg-Kirkpatrick; Taylor D,9999,0,9999,0
1668025637996,CSE 293,004,119135,Christensen; Henrik I,9999,0,9999,0
1668025637996,CSE 293,005,119142,Cottrell; Garrison W,9999,0,9999,0
1668025637996,CSE 293,006,119146,Deutsch; Alin Bernard,9999,0,9999,0
1668025637996,CSE 293,007,119159,Esmaeilzadeh; Hadi,9999,0,9999,0
1668025637996,CSE 293,008,119166,Freund; Yoav,9999,0,9999,0
1668025637996,CSE 293,009,119170,Griswold; William G.,9999,0,9999,0
1668025637996,CSE 293,010,119183,Gymrek; Melissa Ann,9999,0,9999,0
1668025637996,CSE 293,011,119190,Heninger; Nadia A,9999,0,9999,0
1668025637996,CSE 293,012,119230,Impagliazzo; Russell,9999,0,9999,0
1668025637996,CSE 293,013,119232,Jhala; Ranjit,9999,0,9999,0
1668025637996,CSE 293,014,119233,Kahng; Andrew Byun,9999,0,9999,0
1668025637996,CSE 293,015,119298,Kane; Daniel Mertz,9999,0,9999,0
1668025637996,CSE 293,016,119299,Kriegman; David J,9999,0,9999,0
1668025637996,CSE 293,017,119300,Kumar; Arun Kumar,9999,0,9999,0
1668025637996,CSE 293,018,119301,Lerner; Sorin,9999,0,9999,0
1668025637996,CSE 293,019,119302,Lovett; Shachar,9999,0,9999,0
1668025637996,CSE 293,020,119303,McAuley; Julian John,9999,0,9999,0
1668025637996,CSE 293,021,119304,Micciancio; Daniele,9999,0,9999,0
1668025637996,CSE 293,022,119367,Orailoglu; Alex,9999,0,9999,0
1668025637996,CSE 293,023,119382,Paturi; Ramamohan,9999,0,9999,0
1668025637996,CSE 293,024,119404,Polikarpova; Nadezhda,9999,0,9999,0
1668025637996,CSE 293,025,119406,Politz; Joseph Gibbs,9999,0,9999,0
1668025637996,CSE 293,026,119411,Porter; George M,9999,0,9999,0
1668025637996,CSE 293,027,119414,Porter; Leonard Emerson,9999,0,9999,0
1668025637996,CSE 293,028,119416,Ramamoorthi; Ravi,9999,0,9999,0
1668025637996,CSE 293,029,119417,Sahoo; Debashis,9999,0,9999,0
1668025637996,CSE 293,030,119420,Saul; Lawrence,9999,0,9999,0
1668025637996,CSE 293,031,119421,Savage; Stefan,9999,0,9999,0
1668025637996,CSE 293,032,119425,Schulze; Jurgen P.,9999,0,9999,0
1668025637996,CSE 293,033,119426,Snoeren; Alex C.,9999,0,9999,0
1668025637996,CSE 293,034,119428,Shang; Jingbo,9999,0,9999,0
1668025637996,CSE 293,035,119430,Stefan; Deian,9999,0,9999,0
1668025637996,CSE 293,036,119431,Su; Hao,9999,0,9999,0
1668025637996,CSE 293,037,119433,Swanson; Steven James,9999,0,9999,0
1668025637996,CSE 293,038,119435,Tullsen; Dean Michael,9999,0,9999,0
1668025637996,CSE 293,039,119483,Voelker; Geoffrey M.,9999,0,9999,0
1668025637996,CSE 293,040,119537,Zhao; Jishen,9999,0,9999,0
1668025637996,CSE 293,041,119538,Zhou; Yuan-Yuan,9999,0,9999,0
1668025637996,CSE 293,042,119539,Gao; Sicun,9999,0,9999,0
1668025637996,CSE 293,043,119540,Weibel; Nadir,9999,0,9999,0
1668025637996,CSE 293,044,119541,Gupta; Rajesh K.,9999,0,9999,0
1668025637996,CSE 293,045,126410,Vaccaro; Kristen Marie,9999,0,9999,0
1668025637996,CSE 293,046,126411,Klemke; Richard,9999,0,9999,0
1668025638422,CSE 294,A00,102459,Voelker; Geoffrey M.,0,0,0,0
1668025638422,CSE 294,B00,111322,Orailoglu; Alex,0,0,0,0
1668025638851,DSE 201,A00,096914,Deutsch; Alin Bernard,30,0,30,0
1668025639274,DSE 210,A00,096915,Dasgupta; Sanjoy,30,0,30,0
1668025639706,DSE 260A,A00,096916,Altintas De Callaf; Ilkay,30,0,30,0
1668025640174,ECE 200,001,103586,Antipa; Nicholas A,9999,0,9999,0
1668025640174,ECE 200,002,103587,Atanasov; Nikolay A.,9999,0,9999,0
1668025640174,ECE 200,003,103588,Bharadia; Dinesh,9999,0,9999,0
1668025640174,ECE 200,004,103589,Cheng; Chung Kuan,9999,0,9999,0
1668025640174,ECE 200,005,103590,Cosman; Pamela C.,9999,0,9999,0
1668025640174,ECE 200,006,103591,Dayeh; Shadi Ahmad,9999,0,9999,0
1668025640174,ECE 200,007,103592,Fainman; Yeshaiahu,9999,0,9999,0
1668025640174,ECE 200,008,103593,Ford; Joseph Earl,9999,0,9999,0
1668025640174,ECE 200,009,103594,Franceschetti; Massimo,9999,0,9999,0
1668025640174,ECE 200,010,103595,Fullerton; Eric E,9999,0,9999,0
1668025640174,ECE 200,011,103596,Galton; Ian A,9999,0,9999,0
1668025640174,ECE 200,012,103597,Gilja; Vikash,9999,0,9999,0
1668025640174,ECE 200,013,103598,Hall; Drew A.,9999,0,9999,0
1668025640174,ECE 200,014,103599,Hsueh; Tzu-Chien,9999,0,9999,0
1668025640174,ECE 200,015,103600,Javidi; Tara,9999,0,9999,0
1668025640174,ECE 200,016,103601,Kahng; Andrew Byun,9999,0,9999,0
1668025640174,ECE 200,017,103602,Kim; Young-Han,9999,0,9999,0
1668025640174,ECE 200,018,103603,Koushanfar; Farinaz,9999,0,9999,0
1668025640174,ECE 200,019,103604,Kuzum; Duygu,9999,0,9999,0
1668025640174,ECE 200,020,103605,Le; Hanh-Phuc,9999,0,9999,0
1668025640174,ECE 200,021,103606,Lin; Bill,9999,0,9999,0
1668025640174,ECE 200,022,103607,Liu; Zhaowei,9998,0,9999,1
1668025640174,ECE 200,023,103608,Lo; Yu-Hwa,9999,0,9999,0
1668025640174,ECE 200,024,103609,Lomakin; Vitaliy,9999,0,9999,0
1668025640174,ECE 200,025,103610,Mercier; Patrick Philip,9999,0,9999,0
1668025640174,ECE 200,026,103611,Meyer; Florian,9999,0,9999,0
1668025640174,ECE 200,027,103612,Milstein; Laurence B.,9999,0,9999,0
1668025640174,ECE 200,028,103613,Mir Arabbaygi; Siavash,9999,0,9999,0
1668025640174,ECE 200,029,103614,Mookherjea; Shayan,9999,0,9999,0
1668025640174,ECE 200,030,103615,Morris; Karcher William,9999,0,9999,0
1668025640174,ECE 200,031,103616,Ng; Tse Nga,9999,0,9999,0
1668025640174,ECE 200,032,103617,Nguyen; Truong Quang,9999,0,9999,0
1668025640174,ECE 200,033,103618,Nomura; Kenji,9999,0,9999,0
1668025640174,ECE 200,034,103619,Orlitsky; Alon,9999,0,9999,0
1668025640174,ECE 200,035,103620,Pal; Piya,9999,0,9999,0
1668025640174,ECE 200,036,103621,Papen; George C.,9999,0,9999,0
1668025640174,ECE 200,037,103622,Radic; Stojan,9999,0,9999,0
1668025640174,ECE 200,038,103623,Rao; Bhaskar D.,9999,0,9999,0
1668025640174,ECE 200,039,103624,Rao; Ramesh R,9999,0,9999,0
1668025640174,ECE 200,040,103625,Rebeiz; Gabriel,9999,0,9999,0
1668025640174,ECE 200,041,103626,Sanford; John R,9999,0,9999,0
1668025640174,ECE 200,042,103627,Siegel; Paul H.,9999,0,9999,0
1668025640174,ECE 200,043,103628,Sievenpiper; Daniel F.,9999,0,9999,0
1668025640174,ECE 200,044,103629,Sworder; David D.,9999,0,9999,0
1668025640174,ECE 200,045,103630,Taur; Yuan,9999,0,9999,0
1668025640174,ECE 200,046,103631,Touri; Behrouz,9999,0,9999,0
1668025640174,ECE 200,047,103632,Trivedi; Mohan M.,9999,0,9999,0
1668025640174,ECE 200,048,103633,Vasconcelos; Nuno,9999,0,9999,0
1668025640174,ECE 200,049,103634,Wang; Xiaolong,9999,0,9999,0
1668025640174,ECE 200,050,103635,Xie; Pengtao,9999,0,9999,0
1668025640174,ECE 200,051,103636,Yip; Michael,9999,0,9999,0
1668025640174,ECE 200,052,103637,Zeger; Kenneth A.,999,0,999,0
1668025640174,ECE 200,053,103638,Zhang; Xinyu,9999,0,9999,0
1668025640174,ECE 200,054,103639,Turakhia; Yatish Girish,9999,0,9999,0
1668025640174,ECE 200,055,103640,Kang; Mingu,9999,0,9999,0
1668025640174,ECE 200,056,103641,Shi; Yuanyuan,9999,0,9999,0
1668025640174,ECE 200,057,103642,Wang; Edward Jay,9999,0,9999,0
1668025640174,ECE 200,058,103643,Zheng; Yang,9999,0,9999,0
1668025640598,ECE 202,A00,103644,Kuzum; Duygu,0,0,0,0
1668025641020,ECE 212BN,A00,103646,Ng; Tse Nga,0,0,0,0
1668025641448,ECE 221,A00,111493,Staff,0,0,0,0
1668025641873,ECE 222B,A00,103647,Lomakin; Vitaliy,0,0,0,0
1668025642303,ECE 230B,A00,103648,Taur; Yuan,0,0,0,0
1668025642743,ECE 238B,A00,103649,Garay; Javier,0,0,0,0
1668025643170,ECE 240B,A00,112900,Fainman; Yeshaiahu,0,0,0,0
1668025643598,ECE 247A,A00,103650,Jokerst; Jesse Vincent,0,0,0,0
1668025644021,ECE 247B,A00,103651,Wang; Joseph,0,0,0,0
1668025644471,ECE 250,A00,103652,Siegel; Paul H.,0,0,0,0
1668025644991,ECE 251A,A00,103654,Rao; Bhaskar D.,0,0,0,0
1668025645422,ECE 257B,A00,103655,Bharadia; Dinesh,0,0,0,0
1668025645847,ECE 258A,A00,103656,Milstein; Laurence B.,0,0,0,0
1668025646274,ECE 260B,A00,103658,Kang; Mingu,0,0,0,0
1668025646703,ECE 264A,A00,103659,Galton; Ian A,0,0,0,0
1668025647125,ECE 265A,A00,103661,Gudem; Prasad S.S.,0,0,0,0
1668025647547,ECE 265D,A00,103662,Gudem; Prasad S.S.,0,0,0,0
1668025647972,ECE 268,A00,103663,Koushanfar; Farinaz,0,0,0,0
1668025648401,ECE 269,A01,103665,Pal; Piya,0,0,0,0
1668025648835,ECE 271B,A00,103666,Vasconcelos; Manuela,0,0,0,0
1668025649258,ECE 276A,A00,103667,Atanasov; Nikolay A.,0,0,0,0
1668025649684,ECE 277,A00,103668,An; Cheolhong,0,0,0,0
1668025650111,ECE 279,A00,117947,Hall; Drew A.,0,0,0,0
1668025650959,ECE 283,A00,103670,Hsueh; Tzu-Chien,0,0,0,0
1668025651405,ECE 284,A00,103671,Turakhia; Yatish Girish,0,0,0,0
1668025651832,ECE 285,A00,103672,Zheng; Yang,0,0,0,0
1668025651832,ECE 285,B00,103673,Sworder; David D.,0,0,0,0
1668025652253,ECE 287,A00,103676,Javidi; Tara,0,0,0,0
1668025652680,MATH 200B,A00,098023,Salehi Golsefidy; Alireza,13,0,15,2
1668025653104,MATH 202B,A00,098024,Rhoades; Brendon Patrick,10,0,15,5
1668025653534,MATH 203B,A00,098025,Oprea; Dragos N.,11,0,15,4
1668025653967,MATH 204B,A00,098026,Sorensen; Claus M,14,0,15,1
1668025654395,MATH 208,A00,098027,Izadi; Elham,7,0,10,3
1668025654825,MATH 209,A00,098028,Pollack; Aaron,10,0,10,0
1668025655265,MATH 211A,A00,112919,Rogalski; Daniel,9,0,10,1
1668025655688,MATH 211B,A00,112920,Seward; Brandon M.,9,0,10,1
1668025656111,MATH 218,A00,098029,Li; Bo,10,0,10,0
1668025656541,MATH 220B,A00,098030,Novak; Jonathan I,13,0,15,2
1668025656970,MATH 221A,A00,098031,Ebenfelt; Peter F,13,0,15,2
1668025657395,MATH 231B,A00,098032,Zlatos; Andrej,12,0,15,3
1668025657831,MATH 240B,A00,098033,Ni; Lei,9,0,15,6
1668025658258,MATH 243,A00,098034,Jekel; David Andrew,10,0,10,0
1668025658685,MATH 245A,A00,098035,Nie; Jiawang,0,0,15,16
1668025659110,MATH 248,A00,098036,Bejenaru; Ioan,10,0,10,0
1668025659534,MATH 250B,A00,098037,Spolaor; Luca,14,0,15,1
1668025659967,MATH 258,A00,098038,Ni; Lei,10,0,10,0
1668025660404,MATH 264B,A00,098041,Rhoades; Brendon Patrick,10,0,15,5
1668025660831,MATH 268,A00,098042,Buss; Samuel R,10,0,10,0
1668025661257,MATH 269,A00,098043,Rhoades; Brendon Patrick,10,0,10,0
1668025661694,MATH 270B,A00,098044,Li; Bo,11,0,15,4
1668025662119,MATH 272B,A00,098045,Holst; Michael J,13,0,15,2
1668025662546,MATH 273A,A00,098046,Tian; Xiaochuan,10,0,15,5
1668025662978,MATH 275,A01,098048,Tian; Xiaochuan,6,0,10,4
1668025663413,MATH 278A,A00,098049,Holst; Michael J,8,0,10,2
1668025663839,MATH 278B,A00,098050,Cloninger; Alexander,10,0,10,0
1668025664266,MATH 278C,A00,098051,Nie; Jiawang,8,0,10,2
1668025664697,MATH 280B,A00,098052,Zheng; Tianyi,11,0,15,4
1668025665122,MATH 281B,A00,098053,Bradic; Jelena,4,0,15,11
1668025665546,MATH 282B,A00,098054,Arias-Castro; Ery,2,0,15,13
1668025665978,MATH 285,A00,098055,Fitzsimmons; Patrick J,0,0,15,17
1668025666404,MATH 287B,A00,098056,Arias-Castro; Ery,4,0,15,11
1668025666835,MATH 288,A00,098057,Agarwal; Pooja,9,0,10,1
1668025666835,MATH 288,B00,098058,Zhang; Danna,9,0,10,1
1668025666835,MATH 288,C00,098059,Williams; Ruth J,10,0,10,0
1668025667259,MATH 290B,A00,098060,Roberts; Justin Deritter,13,0,15,2
1668025667697,MATH 292,A00,098061,Belmont; Eva Kinoshita,10,0,10,0
1668025668143,MATH 295,A00,098062,Suk; Andrew Hoon,48,0,50,2
1668025668572,MATH 296,A00,098063,Novak; Jonathan I,20,0,20,0
1668025669001,MATH 297,001,098064,Gamst; Anthony Collins,9997,0,9999,2
1668026174037,COGS 205,A00,101395,Chiba; Andrea,19,0,20,1
1668026174467,COGS 210B,001,101404,Greene; Deanna Jacquelyn,9998,0,9999,1
1668026174467,COGS 210B,002,101417,Xia; Haijun,9999,0,9999,0
1668026174467,COGS 210B,003,101422,Nitz; Douglas A.,9999,0,9999,0
1668026174467,COGS 210B,004,101423,Hollan; James D.,9998,0,9999,1
1668026174467,COGS 210B,005,101424,Deak; Gedeon O.,9999,0,9999,0
1668026174467,COGS 210B,006,101425,Rossano; Federico,9999,0,9999,0
1668026174905,COGS 211B,A00,101427,Coulson; Seana M,9997,0,9999,2
1668026175346,COGS 220,A00,101428,Hollan; James D.,0,0,25,25
1668026175777,COGS 229,A00,101429,Dow; Steven P,18,0,25,7
1668026176201,COGS 230,A00,101430,Klemmer; Scott R,13,0,17,4
1668026176626,COGS 234,A00,101431,Xia; Haijun,5,0,25,20
1668026177063,COGS 260,A00,101432,Kiyonaga; Anastasia,20,0,25,5
1668026177063,COGS 260,B00,101433,Kirsh; David Joel,16,0,25,9
1668026177488,CSE 202,A00,102371,Impagliazzo; Russell,0,0,0,0
1668026177912,CSE 203B,A01,102373,Cheng; Chung Kuan,0,0,0,0
1668026178343,CSE 208,A00,102374,Micciancio; Daniele,0,0,0,0
1668026178782,CSE 209A,A00,112895,Impagliazzo; Russell,0,0,15,15
1668026179206,CSE 209B,A00,108005,Bellare; Mihir,0,0,0,0
1668026179630,CSE 210,A00,113163,Coblenz; Michael J,0,0,0,0
1668026180055,CSE 219,A00,106111,Dow; Steven P,0,0,20,20
1668026180485,CSE 221,A00,102376,Voelker; Geoffrey M.,0,0,0,0
1668026180919,CSE 224,A01,102378,Porter; George M,0,0,0,0
1668026181361,CSE 229A,A00,102379,Savage; Stefan,0,0,0,0
1668026181785,CSE 229C,A00,102380,Munyaka; Imani N. S.,0,0,0,0
1668026182207,CSE 232B,A00,102382,Deutsch; Alin Bernard,0,0,0,0
1668026182633,CSE 234,A01,112904,Kumar; Arun Kumar,0,0,0,0
1668026183064,CSE 237A,A00,102383,Rosing; Tajana Simunic,0,0,0,0
1668026183498,CSE 239A,A00,102384,Deutsch; Alin Bernard,0,0,0,0
1668026183924,CSE 239B,A00,102385,Polikarpova; Nadezhda,0,0,0,0
1668026184346,CSE 240A,A00,102386,Pannuto; Patrick William,0,0,0,0
1668026184783,CSE 240B,A00,102387,Zhao; Jishen,0,0,0,0
1668026185206,CSE 241A,A00,106406,Kang; Mingu,0,0,0,0
1668026185647,CSE 249B,A00,102388,Kahng; Andrew Byun,0,0,8,8
1668026186073,CSE 251B,A01,102392,Cottrell; Garrison W,0,0,0,0
1668026186073,CSE 251B,A02,102393,Cottrell; Garrison W,0,0,0,0
1668026186518,CSE 252B,A00,102394,Ochoa; Benjamin Lawrence,0,0,0,0
1668026186950,CSE 257,A01,102396,Gao; Sicun,0,0,0,0
1668026187391,CSE 272,A00,102397,Li; Tzumao,0,0,0,0
1668026187814,CSE 274,A00,111323,Chern; Albert Ren-Haur,0,0,0,0
1668026188240,CSE 282,A00,102398,Pevzner; Pavel Arkadjevich,0,0,0,0
1668026188668,CSE 284,A00,114175,Gymrek; Melissa Ann,0,0,0,0
1668026189096,CSE 290,A00,102399,Chandraker; Manmohan Krishna,0,0,0,0
1668026189096,CSE 290,B00,102400,Vaccaro; Kristen Marie,0,0,25,25
1668026189096,CSE 290,C00,102414,Pannuto; Patrick William,0,0,25,25
1668026189096,CSE 290,D00,102427,Pevzner; Pavel Arkadjevich,0,0,0,0
1668026189096,CSE 290,E00,102429,Zhao; Jishen,0,0,0,0
1668026189096,CSE 290,F00,102436,Tullsen; Dean Michael,0,0,0,0
1668026189096,CSE 290,G00,102440,Christensen; Henrik I,0,0,20,20
1668026189544,CSE 291,A00,102443,Su; Hao,0,0,0,0
1668026189544,CSE 291,B00,102448,Polikarpova; Nadezhda,0,0,0,0
1668026189544,CSE 291,C00,102453,Vaccaro; Kristen Marie,0,0,0,0
1668026189544,CSE 291,D00,111343,Savage; Stefan,0,0,0,0
1668026189544,CSE 291,E00,116474,Claffy; Kimberly Claire,0,0,0,0
1668026189544,CSE 291,F00,116479,Pasquale; Joseph,0,0,0,0
1668026189970,CSE 293,001,119111,Bafna; Vineet,9999,0,9999,0
1668026189970,CSE 293,002,119118,Bellare; Mihir,9999,0,9999,0
1668026189970,CSE 293,003,119122,Berg-Kirkpatrick; Taylor D,9999,0,9999,0
1668026189970,CSE 293,004,119135,Christensen; Henrik I,9999,0,9999,0
1668026189970,CSE 293,005,119142,Cottrell; Garrison W,9999,0,9999,0
1668026189970,CSE 293,006,119146,Deutsch; Alin Bernard,9999,0,9999,0
1668026189970,CSE 293,007,119159,Esmaeilzadeh; Hadi,9999,0,9999,0
1668026189970,CSE 293,008,119166,Freund; Yoav,9999,0,9999,0
1668026189970,CSE 293,009,119170,Griswold; William G.,9999,0,9999,0
1668026189970,CSE 293,010,119183,Gymrek; Melissa Ann,9999,0,9999,0
1668026189970,CSE 293,011,119190,Heninger; Nadia A,9999,0,9999,0
1668026189970,CSE 293,012,119230,Impagliazzo; Russell,9999,0,9999,0
1668026189970,CSE 293,013,119232,Jhala; Ranjit,9999,0,9999,0
1668026189970,CSE 293,014,119233,Kahng; Andrew Byun,9999,0,9999,0
1668026189970,CSE 293,015,119298,Kane; Daniel Mertz,9999,0,9999,0
1668026189970,CSE 293,016,119299,Kriegman; David J,9999,0,9999,0
1668026189970,CSE 293,017,119300,Kumar; Arun Kumar,9999,0,9999,0
1668026189970,CSE 293,018,119301,Lerner; Sorin,9999,0,9999,0
1668026189970,CSE 293,019,119302,Lovett; Shachar,9999,0,9999,0
1668026189970,CSE 293,020,119303,McAuley; Julian John,9999,0,9999,0
1668026189970,CSE 293,021,119304,Micciancio; Daniele,9999,0,9999,0
1668026189970,CSE 293,022,119367,Orailoglu; Alex,9999,0,9999,0
1668026189970,CSE 293,023,119382,Paturi; Ramamohan,9999,0,9999,0
1668026189970,CSE 293,024,119404,Polikarpova; Nadezhda,9999,0,9999,0
1668026189970,CSE 293,025,119406,Politz; Joseph Gibbs,9999,0,9999,0
1668026189970,CSE 293,026,119411,Porter; George M,9999,0,9999,0
1668026189970,CSE 293,027,119414,Porter; Leonard Emerson,9999,0,9999,0
1668026189970,CSE 293,028,119416,Ramamoorthi; Ravi,9999,0,9999,0
1668026189970,CSE 293,029,119417,Sahoo; Debashis,9999,0,9999,0
1668026189970,CSE 293,030,119420,Saul; Lawrence,9999,0,9999,0
1668026189970,CSE 293,031,119421,Savage; Stefan,9999,0,9999,0
1668026189970,CSE 293,032,119425,Schulze; Jurgen P.,9999,0,9999,0
1668026189970,CSE 293,033,119426,Snoeren; Alex C.,9999,0,9999,0
1668026189970,CSE 293,034,119428,Shang; Jingbo,9999,0,9999,0
1668026189970,CSE 293,035,119430,Stefan; Deian,9999,0,9999,0
1668026189970,CSE 293,036,119431,Su; Hao,9999,0,9999,0
1668026189970,CSE 293,037,119433,Swanson; Steven James,9999,0,9999,0
1668026189970,CSE 293,038,119435,Tullsen; Dean Michael,9999,0,9999,0
1668026189970,CSE 293,039,119483,Voelker; Geoffrey M.,9999,0,9999,0
1668026189970,CSE 293,040,119537,Zhao; Jishen,9999,0,9999,0
1668026189970,CSE 293,041,119538,Zhou; Yuan-Yuan,9999,0,9999,0
1668026189970,CSE 293,042,119539,Gao; Sicun,9999,0,9999,0
1668026189970,CSE 293,043,119540,Weibel; Nadir,9999,0,9999,0
1668026189970,CSE 293,044,119541,Gupta; Rajesh K.,9999,0,9999,0
1668026189970,CSE 293,045,126410,Vaccaro; Kristen Marie,9999,0,9999,0
1668026189970,CSE 293,046,126411,Klemke; Richard,9999,0,9999,0
1668026190395,CSE 294,A00,102459,Voelker; Geoffrey M.,0,0,0,0
1668026190395,CSE 294,B00,111322,Orailoglu; Alex,0,0,0,0
1668026190819,DSE 201,A00,096914,Deutsch; Alin Bernard,30,0,30,0
1668026191243,DSE 210,A00,096915,Dasgupta; Sanjoy,30,0,30,0
1668026191670,DSE 260A,A00,096916,Altintas De Callaf; Ilkay,30,0,30,0
1668026192123,ECE 200,001,103586,Antipa; Nicholas A,9999,0,9999,0
1668026192123,ECE 200,002,103587,Atanasov; Nikolay A.,9999,0,9999,0
1668026192123,ECE 200,003,103588,Bharadia; Dinesh,9999,0,9999,0
1668026192123,ECE 200,004,103589,Cheng; Chung Kuan,9999,0,9999,0
1668026192123,ECE 200,005,103590,Cosman; Pamela C.,9999,0,9999,0
1668026192123,ECE 200,006,103591,Dayeh; Shadi Ahmad,9999,0,9999,0
1668026192123,ECE 200,007,103592,Fainman; Yeshaiahu,9999,0,9999,0
1668026192123,ECE 200,008,103593,Ford; Joseph Earl,9999,0,9999,0
1668026192123,ECE 200,009,103594,Franceschetti; Massimo,9999,0,9999,0
1668026192123,ECE 200,010,103595,Fullerton; Eric E,9999,0,9999,0
1668026192123,ECE 200,011,103596,Galton; Ian A,9999,0,9999,0
1668026192123,ECE 200,012,103597,Gilja; Vikash,9999,0,9999,0
1668026192123,ECE 200,013,103598,Hall; Drew A.,9999,0,9999,0
1668026192123,ECE 200,014,103599,Hsueh; Tzu-Chien,9999,0,9999,0
1668026192123,ECE 200,015,103600,Javidi; Tara,9999,0,9999,0
1668026192123,ECE 200,016,103601,Kahng; Andrew Byun,9999,0,9999,0
1668026192123,ECE 200,017,103602,Kim; Young-Han,9999,0,9999,0
1668026192123,ECE 200,018,103603,Koushanfar; Farinaz,9999,0,9999,0
1668026192123,ECE 200,019,103604,Kuzum; Duygu,9999,0,9999,0
1668026192123,ECE 200,020,103605,Le; Hanh-Phuc,9999,0,9999,0
1668026192123,ECE 200,021,103606,Lin; Bill,9999,0,9999,0
1668026192123,ECE 200,022,103607,Liu; Zhaowei,9998,0,9999,1
1668026192123,ECE 200,023,103608,Lo; Yu-Hwa,9999,0,9999,0
1668026192123,ECE 200,024,103609,Lomakin; Vitaliy,9999,0,9999,0
1668026192123,ECE 200,025,103610,Mercier; Patrick Philip,9999,0,9999,0
1668026192123,ECE 200,026,103611,Meyer; Florian,9999,0,9999,0
1668026192123,ECE 200,027,103612,Milstein; Laurence B.,9999,0,9999,0
1668026192123,ECE 200,028,103613,Mir Arabbaygi; Siavash,9999,0,9999,0
1668026192123,ECE 200,029,103614,Mookherjea; Shayan,9999,0,9999,0
1668026192123,ECE 200,030,103615,Morris; Karcher William,9999,0,9999,0
1668026192123,ECE 200,031,103616,Ng; Tse Nga,9999,0,9999,0
1668026192123,ECE 200,032,103617,Nguyen; Truong Quang,9999,0,9999,0
1668026192123,ECE 200,033,103618,Nomura; Kenji,9999,0,9999,0
1668026192123,ECE 200,034,103619,Orlitsky; Alon,9999,0,9999,0
1668026192123,ECE 200,035,103620,Pal; Piya,9999,0,9999,0
1668026192123,ECE 200,036,103621,Papen; George C.,9999,0,9999,0
1668026192123,ECE 200,037,103622,Radic; Stojan,9999,0,9999,0
1668026192123,ECE 200,038,103623,Rao; Bhaskar D.,9999,0,9999,0
1668026192123,ECE 200,039,103624,Rao; Ramesh R,9999,0,9999,0
1668026192123,ECE 200,040,103625,Rebeiz; Gabriel,9999,0,9999,0
1668026192123,ECE 200,041,103626,Sanford; John R,9999,0,9999,0
1668026192123,ECE 200,042,103627,Siegel; Paul H.,9999,0,9999,0
1668026192123,ECE 200,043,103628,Sievenpiper; Daniel F.,9999,0,9999,0
1668026192123,ECE 200,044,103629,Sworder; David D.,9999,0,9999,0
1668026192123,ECE 200,045,103630,Taur; Yuan,9999,0,9999,0
1668026192123,ECE 200,046,103631,Touri; Behrouz,9999,0,9999,0
1668026192123,ECE 200,047,103632,Trivedi; Mohan M.,9999,0,9999,0
1668026192123,ECE 200,048,103633,Vasconcelos; Nuno,9999,0,9999,0
1668026192123,ECE 200,049,103634,Wang; Xiaolong,9999,0,9999,0
1668026192123,ECE 200,050,103635,Xie; Pengtao,9999,0,9999,0
1668026192123,ECE 200,051,103636,Yip; Michael,9999,0,9999,0
1668026192123,ECE 200,052,103637,Zeger; Kenneth A.,999,0,999,0
1668026192123,ECE 200,053,103638,Zhang; Xinyu,9999,0,9999,0
1668026192123,ECE 200,054,103639,Turakhia; Yatish Girish,9999,0,9999,0
1668026192123,ECE 200,055,103640,Kang; Mingu,9999,0,9999,0
1668026192123,ECE 200,056,103641,Shi; Yuanyuan,9999,0,9999,0
1668026192123,ECE 200,057,103642,Wang; Edward Jay,9999,0,9999,0
1668026192123,ECE 200,058,103643,Zheng; Yang,9999,0,9999,0
1668026192546,ECE 202,A00,103644,Kuzum; Duygu,0,0,0,0
1668026192974,ECE 212BN,A00,103646,Ng; Tse Nga,0,0,0,0
1668026193398,ECE 221,A00,111493,Staff,0,0,0,0
1668026193835,ECE 222B,A00,103647,Lomakin; Vitaliy,0,0,0,0
1668026194275,ECE 230B,A00,103648,Taur; Yuan,0,0,0,0
1668026194698,ECE 238B,A00,103649,Garay; Javier,0,0,0,0
1668026195125,ECE 240B,A00,112900,Fainman; Yeshaiahu,0,0,0,0
1668026195548,ECE 247A,A00,103650,Jokerst; Jesse Vincent,0,0,0,0
1668026195979,ECE 247B,A00,103651,Wang; Joseph,0,0,0,0
1668026196412,ECE 250,A00,103652,Siegel; Paul H.,0,0,0,0
1668026196859,ECE 251A,A00,103654,Rao; Bhaskar D.,0,0,0,0
1668026197293,ECE 257B,A00,103655,Bharadia; Dinesh,0,0,0,0
1668026197721,ECE 258A,A00,103656,Milstein; Laurence B.,0,0,0,0
1668026198151,ECE 260B,A00,103658,Kang; Mingu,0,0,0,0
1668026198580,ECE 264A,A00,103659,Galton; Ian A,0,0,0,0
1668026199016,ECE 265A,A00,103661,Gudem; Prasad S.S.,0,0,0,0
1668026199452,ECE 265D,A00,103662,Gudem; Prasad S.S.,0,0,0,0
1668026199892,ECE 268,A00,103663,Koushanfar; Farinaz,0,0,0,0
1668026200321,ECE 269,A01,103665,Pal; Piya,0,0,0,0
1668026200753,ECE 271B,A00,103666,Vasconcelos; Manuela,0,0,0,0
1668026201181,ECE 276A,A00,103667,Atanasov; Nikolay A.,0,0,0,0
1668026201614,ECE 277,A00,103668,An; Cheolhong,0,0,0,0
1668026202036,ECE 279,A00,117947,Hall; Drew A.,0,0,0,0
1668026202891,ECE 283,A00,103670,Hsueh; Tzu-Chien,0,0,0,0
1668026203323,ECE 284,A00,103671,Turakhia; Yatish Girish,0,0,0,0
1668026203749,ECE 285,A00,103672,Zheng; Yang,0,0,0,0
1668026203749,ECE 285,B00,103673,Sworder; David D.,0,0,0,0
1668026204182,ECE 287,A00,103676,Javidi; Tara,0,0,0,0
1668026204620,MATH 200B,A00,098023,Salehi Golsefidy; Alireza,13,0,15,2
1668026205059,MATH 202B,A00,098024,Rhoades; Brendon Patrick,10,0,15,5
1668026205481,MATH 203B,A00,098025,Oprea; Dragos N.,11,0,15,4
1668026205908,MATH 204B,A00,098026,Sorensen; Claus M,14,0,15,1
1668026206333,MATH 208,A00,098027,Izadi; Elham,7,0,10,3
1668026206758,MATH 209,A00,098028,Pollack; Aaron,10,0,10,0
1668026207197,MATH 211A,A00,112919,Rogalski; Daniel,9,0,10,1
1668026207627,MATH 211B,A00,112920,Seward; Brandon M.,9,0,10,1
1668026208059,MATH 218,A00,098029,Li; Bo,10,0,10,0
1668026208500,MATH 220B,A00,098030,Novak; Jonathan I,13,0,15,2
1668026208926,MATH 221A,A00,098031,Ebenfelt; Peter F,13,0,15,2
1668026209364,MATH 231B,A00,098032,Zlatos; Andrej,12,0,15,3
1668026209789,MATH 240B,A00,098033,Ni; Lei,9,0,15,6
1668026210212,MATH 243,A00,098034,Jekel; David Andrew,10,0,10,0
1668026210640,MATH 245A,A00,098035,Nie; Jiawang,0,0,15,16
1668026211063,MATH 248,A00,098036,Bejenaru; Ioan,10,0,10,0
1668026211499,MATH 250B,A00,098037,Spolaor; Luca,14,0,15,1
1668026211927,MATH 258,A00,098038,Ni; Lei,10,0,10,0
1668026212354,MATH 264B,A00,098041,Rhoades; Brendon Patrick,10,0,15,5
1668026212786,MATH 268,A00,098042,Buss; Samuel R,10,0,10,0
1668026213213,MATH 269,A00,098043,Rhoades; Brendon Patrick,10,0,10,0
1668026213729,MATH 270B,A00,098044,Li; Bo,11,0,15,4
1668026214161,MATH 272B,A00,098045,Holst; Michael J,13,0,15,2
1668026214584,MATH 273A,A00,098046,Tian; Xiaochuan,10,0,15,5
1668026215016,MATH 275,A01,098048,Tian; Xiaochuan,6,0,10,4
1668026215449,MATH 278A,A00,098049,Holst; Michael J,8,0,10,2
1668026215877,MATH 278B,A00,098050,Cloninger; Alexander,10,0,10,0
1668026216303,MATH 278C,A00,098051,Nie; Jiawang,8,0,10,2
1668026216738,MATH 280B,A00,098052,Zheng; Tianyi,11,0,15,4
1668026217169,MATH 281B,A00,098053,Bradic; Jelena,4,0,15,11
1668026217600,MATH 282B,A00,098054,Arias-Castro; Ery,2,0,15,13
1668026218024,MATH 285,A00,098055,Fitzsimmons; Patrick J,0,0,15,17
1668026218450,MATH 287B,A00,098056,Arias-Castro; Ery,4,0,15,11
1668026218892,MATH 288,A00,098057,Agarwal; Pooja,9,0,10,1
1668026218892,MATH 288,B00,098058,Zhang; Danna,9,0,10,1
1668026218892,MATH 288,C00,098059,Williams; Ruth J,10,0,10,0
1668026219326,MATH 290B,A00,098060,Roberts; Justin Deritter,13,0,15,2
1668026219750,MATH 292,A00,098061,Belmont; Eva Kinoshita,10,0,10,0
1668026220172,MATH 295,A00,098062,Suk; Andrew Hoon,48,0,50,2
1668026220596,MATH 296,A00,098063,Novak; Jonathan I,20,0,20,0
1668026221031,MATH 297,001,098064,Gamst; Anthony Collins,9997,0,9999,2
1668026725588,COGS 205,A00,101395,Chiba; Andrea,19,0,20,1
1668026726018,COGS 210B,001,101404,Greene; Deanna Jacquelyn,9998,0,9999,1
1668026726018,COGS 210B,002,101417,Xia; Haijun,9999,0,9999,0
1668026726018,COGS 210B,003,101422,Nitz; Douglas A.,9999,0,9999,0
1668026726018,COGS 210B,004,101423,Hollan; James D.,9998,0,9999,1
1668026726018,COGS 210B,005,101424,Deak; Gedeon O.,9999,0,9999,0
1668026726018,COGS 210B,006,101425,Rossano; Federico,9999,0,9999,0
1668026726439,COGS 211B,A00,101427,Coulson; Seana M,9997,0,9999,2
1668026726865,COGS 220,A00,101428,Hollan; James D.,0,0,25,25
1668026727296,COGS 229,A00,101429,Dow; Steven P,18,0,25,7
1668026727726,COGS 230,A00,101430,Klemmer; Scott R,13,0,17,4
1668026728150,COGS 234,A00,101431,Xia; Haijun,5,0,25,20
1668026728577,COGS 260,A00,101432,Kiyonaga; Anastasia,20,0,25,5
1668026728577,COGS 260,B00,101433,Kirsh; David Joel,16,0,25,9
1668026729004,CSE 202,A00,102371,Impagliazzo; Russell,0,0,0,0
1668026729438,CSE 203B,A01,102373,Cheng; Chung Kuan,0,0,0,0
1668026729861,CSE 208,A00,102374,Micciancio; Daniele,0,0,0,0
1668026730284,CSE 209A,A00,112895,Impagliazzo; Russell,0,0,15,15
1668026730721,CSE 209B,A00,108005,Bellare; Mihir,0,0,0,0
1668026731159,CSE 210,A00,113163,Coblenz; Michael J,0,0,0,0
1668026731583,CSE 219,A00,106111,Dow; Steven P,0,0,20,20
1668026732020,CSE 221,A00,102376,Voelker; Geoffrey M.,0,0,0,0
1668026732448,CSE 224,A01,102378,Porter; George M,0,0,0,0
1668026732885,CSE 229A,A00,102379,Savage; Stefan,0,0,0,0
1668026733313,CSE 229C,A00,102380,Munyaka; Imani N. S.,0,0,0,0
1668026733752,CSE 232B,A00,102382,Deutsch; Alin Bernard,0,0,0,0
1668026734178,CSE 234,A01,112904,Kumar; Arun Kumar,0,0,0,0
1668026734601,CSE 237A,A00,102383,Rosing; Tajana Simunic,0,0,0,0
1668026735039,CSE 239A,A00,102384,Deutsch; Alin Bernard,0,0,0,0
1668026735476,CSE 239B,A00,102385,Polikarpova; Nadezhda,0,0,0,0
1668026735904,CSE 240A,A00,102386,Pannuto; Patrick William,0,0,0,0
1668026736326,CSE 240B,A00,102387,Zhao; Jishen,0,0,0,0
1668026736752,CSE 241A,A00,106406,Kang; Mingu,0,0,0,0
1668026737174,CSE 249B,A00,102388,Kahng; Andrew Byun,0,0,8,8
1668026737603,CSE 251B,A01,102392,Cottrell; Garrison W,0,0,0,0
1668026737603,CSE 251B,A02,102393,Cottrell; Garrison W,0,0,0,0
1668026738030,CSE 252B,A00,102394,Ochoa; Benjamin Lawrence,0,0,0,0
1668026738544,CSE 257,A01,102396,Gao; Sicun,0,0,0,0
1668026738970,CSE 272,A00,102397,Li; Tzumao,0,0,0,0
1668026739401,CSE 274,A00,111323,Chern; Albert Ren-Haur,0,0,0,0
1668026739834,CSE 282,A00,102398,Pevzner; Pavel Arkadjevich,0,0,0,0
1668026740259,CSE 284,A00,114175,Gymrek; Melissa Ann,0,0,0,0
1668026740683,CSE 290,A00,102399,Chandraker; Manmohan Krishna,0,0,0,0
1668026740683,CSE 290,B00,102400,Vaccaro; Kristen Marie,0,0,25,25
1668026740683,CSE 290,C00,102414,Pannuto; Patrick William,0,0,25,25
1668026740683,CSE 290,D00,102427,Pevzner; Pavel Arkadjevich,0,0,0,0
1668026740683,CSE 290,E00,102429,Zhao; Jishen,0,0,0,0
1668026740683,CSE 290,F00,102436,Tullsen; Dean Michael,0,0,0,0
1668026740683,CSE 290,G00,102440,Christensen; Henrik I,0,0,20,20
1668026741121,CSE 291,A00,102443,Su; Hao,0,0,0,0
1668026741121,CSE 291,B00,102448,Polikarpova; Nadezhda,0,0,0,0
1668026741121,CSE 291,C00,102453,Vaccaro; Kristen Marie,0,0,0,0
1668026741121,CSE 291,D00,111343,Savage; Stefan,0,0,0,0
1668026741121,CSE 291,E00,116474,Claffy; Kimberly Claire,0,0,0,0
1668026741121,CSE 291,F00,116479,Pasquale; Joseph,0,0,0,0
1668026741550,CSE 293,001,119111,Bafna; Vineet,9999,0,9999,0
1668026741550,CSE 293,002,119118,Bellare; Mihir,9999,0,9999,0
1668026741550,CSE 293,003,119122,Berg-Kirkpatrick; Taylor D,9999,0,9999,0
1668026741550,CSE 293,004,119135,Christensen; Henrik I,9999,0,9999,0
1668026741550,CSE 293,005,119142,Cottrell; Garrison W,9999,0,9999,0
1668026741550,CSE 293,006,119146,Deutsch; Alin Bernard,9999,0,9999,0
1668026741550,CSE 293,007,119159,Esmaeilzadeh; Hadi,9999,0,9999,0
1668026741550,CSE 293,008,119166,Freund; Yoav,9999,0,9999,0
1668026741550,CSE 293,009,119170,Griswold; William G.,9999,0,9999,0
1668026741550,CSE 293,010,119183,Gymrek; Melissa Ann,9999,0,9999,0
1668026741550,CSE 293,011,119190,Heninger; Nadia A,9999,0,9999,0
1668026741550,CSE 293,012,119230,Impagliazzo; Russell,9999,0,9999,0
1668026741550,CSE 293,013,119232,Jhala; Ranjit,9999,0,9999,0
1668026741550,CSE 293,014,119233,Kahng; Andrew Byun,9999,0,9999,0
1668026741550,CSE 293,015,119298,Kane; Daniel Mertz,9999,0,9999,0
1668026741550,CSE 293,016,119299,Kriegman; David J,9999,0,9999,0
1668026741550,CSE 293,017,119300,Kumar; Arun Kumar,9999,0,9999,0
1668026741550,CSE 293,018,119301,Lerner; Sorin,9999,0,9999,0
1668026741550,CSE 293,019,119302,Lovett; Shachar,9999,0,9999,0
1668026741550,CSE 293,020,119303,McAuley; Julian John,9999,0,9999,0
1668026741550,CSE 293,021,119304,Micciancio; Daniele,9999,0,9999,0
1668026741550,CSE 293,022,119367,Orailoglu; Alex,9999,0,9999,0
1668026741550,CSE 293,023,119382,Paturi; Ramamohan,9999,0,9999,0
1668026741550,CSE 293,024,119404,Polikarpova; Nadezhda,9999,0,9999,0
1668026741550,CSE 293,025,119406,Politz; Joseph Gibbs,9999,0,9999,0
1668026741550,CSE 293,026,119411,Porter; George M,9999,0,9999,0
1668026741550,CSE 293,027,119414,Porter; Leonard Emerson,9999,0,9999,0
1668026741550,CSE 293,028,119416,Ramamoorthi; Ravi,9999,0,9999,0
1668026741550,CSE 293,029,119417,Sahoo; Debashis,9999,0,9999,0
1668026741550,CSE 293,030,119420,Saul; Lawrence,9999,0,9999,0
1668026741550,CSE 293,031,119421,Savage; Stefan,9999,0,9999,0
1668026741550,CSE 293,032,119425,Schulze; Jurgen P.,9999,0,9999,0
1668026741550,CSE 293,033,119426,Snoeren; Alex C.,9999,0,9999,0
1668026741550,CSE 293,034,119428,Shang; Jingbo,9999,0,9999,0
1668026741550,CSE 293,035,119430,Stefan; Deian,9999,0,9999,0
1668026741550,CSE 293,036,119431,Su; Hao,9999,0,9999,0
1668026741550,CSE 293,037,119433,Swanson; Steven James,9999,0,9999,0
1668026741550,CSE 293,038,119435,Tullsen; Dean Michael,9999,0,9999,0
1668026741550,CSE 293,039,119483,Voelker; Geoffrey M.,9999,0,9999,0
1668026741550,CSE 293,040,119537,Zhao; Jishen,9999,0,9999,0
1668026741550,CSE 293,041,119538,Zhou; Yuan-Yuan,9999,0,9999,0
1668026741550,CSE 293,042,119539,Gao; Sicun,9999,0,9999,0
1668026741550,CSE 293,043,119540,Weibel; Nadir,9999,0,9999,0
1668026741550,CSE 293,044,119541,Gupta; Rajesh K.,9999,0,9999,0
1668026741550,CSE 293,045,126410,Vaccaro; Kristen Marie,9999,0,9999,0
1668026741550,CSE 293,046,126411,Klemke; Richard,9999,0,9999,0
1668026741978,CSE 294,A00,102459,Voelker; Geoffrey M.,0,0,0,0
1668026741978,CSE 294,B00,111322,Orailoglu; Alex,0,0,0,0
1668026742400,DSE 201,A00,096914,Deutsch; Alin Bernard,30,0,30,0
1668026742826,DSE 210,A00,096915,Dasgupta; Sanjoy,30,0,30,0
1668026743250,DSE 260A,A00,096916,Altintas De Callaf; Ilkay,30,0,30,0
1668026743714,ECE 200,001,103586,Antipa; Nicholas A,9999,0,9999,0
1668026743714,ECE 200,002,103587,Atanasov; Nikolay A.,9999,0,9999,0
1668026743714,ECE 200,003,103588,Bharadia; Dinesh,9999,0,9999,0
1668026743714,ECE 200,004,103589,Cheng; Chung Kuan,9999,0,9999,0
1668026743714,ECE 200,005,103590,Cosman; Pamela C.,9999,0,9999,0
1668026743714,ECE 200,006,103591,Dayeh; Shadi Ahmad,9999,0,9999,0
1668026743714,ECE 200,007,103592,Fainman; Yeshaiahu,9999,0,9999,0
1668026743714,ECE 200,008,103593,Ford; Joseph Earl,9999,0,9999,0
1668026743714,ECE 200,009,103594,Franceschetti; Massimo,9999,0,9999,0
1668026743714,ECE 200,010,103595,Fullerton; Eric E,9999,0,9999,0
1668026743714,ECE 200,011,103596,Galton; Ian A,9999,0,9999,0
1668026743714,ECE 200,012,103597,Gilja; Vikash,9999,0,9999,0
1668026743714,ECE 200,013,103598,Hall; Drew A.,9999,0,9999,0
1668026743714,ECE 200,014,103599,Hsueh; Tzu-Chien,9999,0,9999,0
1668026743714,ECE 200,015,103600,Javidi; Tara,9999,0,9999,0
1668026743714,ECE 200,016,103601,Kahng; Andrew Byun,9999,0,9999,0
1668026743714,ECE 200,017,103602,Kim; Young-Han,9999,0,9999,0
1668026743714,ECE 200,018,103603,Koushanfar; Farinaz,9999,0,9999,0
1668026743714,ECE 200,019,103604,Kuzum; Duygu,9999,0,9999,0
1668026743714,ECE 200,020,103605,Le; Hanh-Phuc,9999,0,9999,0
1668026743714,ECE 200,021,103606,Lin; Bill,9999,0,9999,0
1668026743714,ECE 200,022,103607,Liu; Zhaowei,9998,0,9999,1
1668026743714,ECE 200,023,103608,Lo; Yu-Hwa,9999,0,9999,0
1668026743714,ECE 200,024,103609,Lomakin; Vitaliy,9999,0,9999,0
1668026743714,ECE 200,025,103610,Mercier; Patrick Philip,9999,0,9999,0
1668026743714,ECE 200,026,103611,Meyer; Florian,9999,0,9999,0
1668026743714,ECE 200,027,103612,Milstein; Laurence B.,9999,0,9999,0
1668026743714,ECE 200,028,103613,Mir Arabbaygi; Siavash,9999,0,9999,0
1668026743714,ECE 200,029,103614,Mookherjea; Shayan,9999,0,9999,0
1668026743714,ECE 200,030,103615,Morris; Karcher William,9999,0,9999,0
1668026743714,ECE 200,031,103616,Ng; Tse Nga,9999,0,9999,0
1668026743714,ECE 200,032,103617,Nguyen; Truong Quang,9999,0,9999,0
1668026743714,ECE 200,033,103618,Nomura; Kenji,9999,0,9999,0
1668026743714,ECE 200,034,103619,Orlitsky; Alon,9999,0,9999,0
1668026743714,ECE 200,035,103620,Pal; Piya,9999,0,9999,0
1668026743714,ECE 200,036,103621,Papen; George C.,9999,0,9999,0
1668026743714,ECE 200,037,103622,Radic; Stojan,9999,0,9999,0
1668026743714,ECE 200,038,103623,Rao; Bhaskar D.,9999,0,9999,0
1668026743714,ECE 200,039,103624,Rao; Ramesh R,9999,0,9999,0
1668026743714,ECE 200,040,103625,Rebeiz; Gabriel,9999,0,9999,0
1668026743714,ECE 200,041,103626,Sanford; John R,9999,0,9999,0
1668026743714,ECE 200,042,103627,Siegel; Paul H.,9999,0,9999,0
1668026743714,ECE 200,043,103628,Sievenpiper; Daniel F.,9999,0,9999,0
1668026743714,ECE 200,044,103629,Sworder; David D.,9999,0,9999,0
1668026743714,ECE 200,045,103630,Taur; Yuan,9999,0,9999,0
1668026743714,ECE 200,046,103631,Touri; Behrouz,9999,0,9999,0
1668026743714,ECE 200,047,103632,Trivedi; Mohan M.,9999,0,9999,0
1668026743714,ECE 200,048,103633,Vasconcelos; Nuno,9999,0,9999,0
1668026743714,ECE 200,049,103634,Wang; Xiaolong,9999,0,9999,0
1668026743714,ECE 200,050,103635,Xie; Pengtao,9999,0,9999,0
1668026743714,ECE 200,051,103636,Yip; Michael,9999,0,9999,0
1668026743714,ECE 200,052,103637,Zeger; Kenneth A.,999,0,999,0
1668026743714,ECE 200,053,103638,Zhang; Xinyu,9999,0,9999,0
1668026743714,ECE 200,054,103639,Turakhia; Yatish Girish,9999,0,9999,0
1668026743714,ECE 200,055,103640,Kang; Mingu,9999,0,9999,0
1668026743714,ECE 200,056,103641,Shi; Yuanyuan,9999,0,9999,0
1668026743714,ECE 200,057,103642,Wang; Edward Jay,9999,0,9999,0
1668026743714,ECE 200,058,103643,Zheng; Yang,9999,0,9999,0
1668026744138,ECE 202,A00,103644,Kuzum; Duygu,0,0,0,0
1668026744579,ECE 212BN,A00,103646,Ng; Tse Nga,0,0,0,0
1668026745005,ECE 221,A00,111493,Staff,0,0,0,0
1668026745427,ECE 222B,A00,103647,Lomakin; Vitaliy,0,0,0,0
1668026745858,ECE 230B,A00,103648,Taur; Yuan,0,0,0,0
1668026746288,ECE 238B,A00,103649,Garay; Javier,0,0,0,0
1668026746714,ECE 240B,A00,112900,Fainman; Yeshaiahu,0,0,0,0
1668026747137,ECE 247A,A00,103650,Jokerst; Jesse Vincent,0,0,0,0
1668026747562,ECE 247B,A00,103651,Wang; Joseph,0,0,0,0
1668026747992,ECE 250,A00,103652,Siegel; Paul H.,0,0,0,0
1668026748416,ECE 251A,A00,103654,Rao; Bhaskar D.,0,0,0,0
1668026748841,ECE 257B,A00,103655,Bharadia; Dinesh,0,0,0,0
1668026749267,ECE 258A,A00,103656,Milstein; Laurence B.,0,0,0,0
1668026749695,ECE 260B,A00,103658,Kang; Mingu,0,0,0,0
1668026750120,ECE 264A,A00,103659,Galton; Ian A,0,0,0,0
1668026750544,ECE 265A,A00,103661,Gudem; Prasad S.S.,0,0,0,0
1668026750967,ECE 265D,A00,103662,Gudem; Prasad S.S.,0,0,0,0
1668026751395,ECE 268,A00,103663,Koushanfar; Farinaz,0,0,0,0
1668026751823,ECE 269,A01,103665,Pal; Piya,0,0,0,0
1668026752247,ECE 271B,A00,103666,Vasconcelos; Manuela,0,0,0,0
1668026752683,ECE 276A,A00,103667,Atanasov; Nikolay A.,0,0,0,0
1668026753115,ECE 277,A00,103668,An; Cheolhong,0,0,0,0
1668026753540,ECE 279,A00,117947,Hall; Drew A.,0,0,0,0
1668026754400,ECE 283,A00,103670,Hsueh; Tzu-Chien,0,0,0,0
1668026754823,ECE 284,A00,103671,Turakhia; Yatish Girish,0,0,0,0
1668026755252,ECE 285,A00,103672,Zheng; Yang,0,0,0,0
1668026755252,ECE 285,B00,103673,Sworder; David D.,0,0,0,0
1668026755685,ECE 287,A00,103676,Javidi; Tara,0,0,0,0
1668026756113,MATH 200B,A00,098023,Salehi Golsefidy; Alireza,13,0,15,2
1668026756539,MATH 202B,A00,098024,Rhoades; Brendon Patrick,10,0,15,5
1668026756969,MATH 203B,A00,098025,Oprea; Dragos N.,11,0,15,4
1668026757406,MATH 204B,A00,098026,Sorensen; Claus M,14,0,15,1
1668026757831,MATH 208,A00,098027,Izadi; Elham,7,0,10,3
1668026758263,MATH 209,A00,098028,Pollack; Aaron,10,0,10,0
1668026758685,MATH 211A,A00,112919,Rogalski; Daniel,9,0,10,1
1668026759109,MATH 211B,A00,112920,Seward; Brandon M.,9,0,10,1
1668026759542,MATH 218,A00,098029,Li; Bo,10,0,10,0
1668026759968,MATH 220B,A00,098030,Novak; Jonathan I,13,0,15,2
1668026760394,MATH 221A,A00,098031,Ebenfelt; Peter F,13,0,15,2
1668026760818,MATH 231B,A00,098032,Zlatos; Andrej,12,0,15,3
1668026761254,MATH 240B,A00,098033,Ni; Lei,9,0,15,6
1668026761700,MATH 243,A00,098034,Jekel; David Andrew,10,0,10,0
1668026762134,MATH 245A,A00,098035,Nie; Jiawang,0,0,15,16
1668026762558,MATH 248,A00,098036,Bejenaru; Ioan,10,0,10,0
1668026762990,MATH 250B,A00,098037,Spolaor; Luca,14,0,15,1
1668026763413,MATH 258,A00,098038,Ni; Lei,10,0,10,0
1668026763854,MATH 264B,A00,098041,Rhoades; Brendon Patrick,10,0,15,5
1668026764276,MATH 268,A00,098042,Buss; Samuel R,10,0,10,0
1668026764712,MATH 269,A00,098043,Rhoades; Brendon Patrick,10,0,10,0
1668026765147,MATH 270B,A00,098044,Li; Bo,11,0,15,4
1668026765586,MATH 272B,A00,098045,Holst; Michael J,13,0,15,2
1668026766012,MATH 273A,A00,098046,Tian; Xiaochuan,10,0,15,5
1668026766437,MATH 275,A01,098048,Tian; Xiaochuan,6,0,10,4
1668026766871,MATH 278A,A00,098049,Holst; Michael J,8,0,10,2
1668026767297,MATH 278B,A00,098050,Cloninger; Alexander,10,0,10,0
1668026767725,MATH 278C,A00,098051,Nie; Jiawang,8,0,10,2
1668026768150,MATH 280B,A00,098052,Zheng; Tianyi,11,0,15,4
1668026768574,MATH 281B,A00,098053,Bradic; Jelena,4,0,15,11
1668026769013,MATH 282B,A00,098054,Arias-Castro; Ery,2,0,15,13
1668026769437,MATH 285,A00,098055,Fitzsimmons; Patrick J,0,0,15,17
1668026769864,MATH 287B,A00,098056,Arias-Castro; Ery,4,0,15,11
1668026770295,MATH 288,A00,098057,Agarwal; Pooja,9,0,10,1
1668026770295,MATH 288,B00,098058,Zhang; Danna,9,0,10,1
1668026770295,MATH 288,C00,098059,Williams; Ruth J,10,0,10,0
1668026770720,MATH 290B,A00,098060,Roberts; Justin Deritter,13,0,15,2
1668026771144,MATH 292,A00,098061,Belmont; Eva Kinoshita,10,0,10,0
1668026771566,MATH 295,A00,098062,Suk; Andrew Hoon,48,0,50,2
1668026771998,MATH 296,A00,098063,Novak; Jonathan I,20,0,20,0
1668026772423,MATH 297,001,098064,Gamst; Anthony Collins,9997,0,9999,2
1668027276521,COGS 205,A00,101395,Chiba; Andrea,19,0,20,1
1668027276950,COGS 210B,001,101404,Greene; Deanna Jacquelyn,9998,0,9999,1
1668027276950,COGS 210B,002,101417,Xia; Haijun,9999,0,9999,0
1668027276950,COGS 210B,003,101422,Nitz; Douglas A.,9999,0,9999,0
1668027276950,COGS 210B,004,101423,Hollan; James D.,9998,0,9999,1
1668027276950,COGS 210B,005,101424,Deak; Gedeon O.,9999,0,9999,0
1668027276950,COGS 210B,006,101425,Rossano; Federico,9999,0,9999,0
1668027277376,COGS 211B,A00,101427,Coulson; Seana M,9997,0,9999,2
1668027277819,COGS 220,A00,101428,Hollan; James D.,0,0,25,25
1668027278241,COGS 229,A00,101429,Dow; Steven P,18,0,25,7
1668027278672,COGS 230,A00,101430,Klemmer; Scott R,13,0,17,4
1668027279094,COGS 234,A00,101431,Xia; Haijun,5,0,25,20
1668027279521,COGS 260,A00,101432,Kiyonaga; Anastasia,20,0,25,5
1668027279521,COGS 260,B00,101433,Kirsh; David Joel,16,0,25,9
1668027279958,CSE 202,A00,102371,Impagliazzo; Russell,0,0,0,0
1668027280401,CSE 203B,A01,102373,Cheng; Chung Kuan,0,0,0,0
1668027280825,CSE 208,A00,102374,Micciancio; Daniele,0,0,0,0
1668027281253,CSE 209A,A00,112895,Impagliazzo; Russell,0,0,15,15
1668027281675,CSE 209B,A00,108005,Bellare; Mihir,0,0,0,0
1668027282114,CSE 210,A00,113163,Coblenz; Michael J,0,0,0,0
1668027282551,CSE 219,A00,106111,Dow; Steven P,0,0,20,20
1668027282977,CSE 221,A00,102376,Voelker; Geoffrey M.,0,0,0,0
1668027283405,CSE 224,A01,102378,Porter; George M,0,0,0,0
1668027283842,CSE 229A,A00,102379,Savage; Stefan,0,0,0,0
1668027284279,CSE 229C,A00,102380,Munyaka; Imani N. S.,0,0,0,0
1668027284705,CSE 232B,A00,102382,Deutsch; Alin Bernard,0,0,0,0
1668027285141,CSE 234,A01,112904,Kumar; Arun Kumar,0,0,0,0
1668027285562,CSE 237A,A00,102383,Rosing; Tajana Simunic,0,0,0,0
1668027285993,CSE 239A,A00,102384,Deutsch; Alin Bernard,0,0,0,0
1668027286418,CSE 239B,A00,102385,Polikarpova; Nadezhda,0,0,0,0
1668027286846,CSE 240A,A00,102386,Pannuto; Patrick William,0,0,0,0
1668027287273,CSE 240B,A00,102387,Zhao; Jishen,0,0,0,0
1668027287700,CSE 241A,A00,106406,Kang; Mingu,0,0,0,0
1668027288130,CSE 249B,A00,102388,Kahng; Andrew Byun,0,0,8,8
1668027288567,CSE 251B,A01,102392,Cottrell; Garrison W,0,0,0,0
1668027288567,CSE 251B,A02,102393,Cottrell; Garrison W,0,0,0,0
1668027289018,CSE 252B,A00,102394,Ochoa; Benjamin Lawrence,0,0,0,0
1668027289447,CSE 257,A01,102396,Gao; Sicun,0,0,0,0
1668027289871,CSE 272,A00,102397,Li; Tzumao,0,0,0,0
1668027290310,CSE 274,A00,111323,Chern; Albert Ren-Haur,0,0,0,0
1668027290733,CSE 282,A00,102398,Pevzner; Pavel Arkadjevich,0,0,0,0
1668027291164,CSE 284,A00,114175,Gymrek; Melissa Ann,0,0,0,0
1668027291595,CSE 290,A00,102399,Chandraker; Manmohan Krishna,0,0,0,0
1668027291595,CSE 290,B00,102400,Vaccaro; Kristen Marie,0,0,25,25
1668027291595,CSE 290,C00,102414,Pannuto; Patrick William,0,0,25,25
1668027291595,CSE 290,D00,102427,Pevzner; Pavel Arkadjevich,0,0,0,0
1668027291595,CSE 290,E00,102429,Zhao; Jishen,0,0,0,0
1668027291595,CSE 290,F00,102436,Tullsen; Dean Michael,0,0,0,0
1668027291595,CSE 290,G00,102440,Christensen; Henrik I,0,0,20,20
1668027292034,CSE 291,A00,102443,Su; Hao,0,0,0,0
1668027292034,CSE 291,B00,102448,Polikarpova; Nadezhda,0,0,0,0
1668027292034,CSE 291,C00,102453,Vaccaro; Kristen Marie,0,0,0,0
1668027292034,CSE 291,D00,111343,Savage; Stefan,0,0,0,0
1668027292034,CSE 291,E00,116474,Claffy; Kimberly Claire,0,0,0,0
1668027292034,CSE 291,F00,116479,Pasquale; Joseph,0,0,0,0
1668027292486,CSE 293,001,119111,Bafna; Vineet,9999,0,9999,0
1668027292486,CSE 293,002,119118,Bellare; Mihir,9999,0,9999,0
1668027292486,CSE 293,003,119122,Berg-Kirkpatrick; Taylor D,9999,0,9999,0
1668027292486,CSE 293,004,119135,Christensen; Henrik I,9999,0,9999,0
1668027292486,CSE 293,005,119142,Cottrell; Garrison W,9999,0,9999,0
1668027292486,CSE 293,006,119146,Deutsch; Alin Bernard,9999,0,9999,0
1668027292486,CSE 293,007,119159,Esmaeilzadeh; Hadi,9999,0,9999,0
1668027292486,CSE 293,008,119166,Freund; Yoav,9999,0,9999,0
1668027292486,CSE 293,009,119170,Griswold; William G.,9999,0,9999,0
1668027292486,CSE 293,010,119183,Gymrek; Melissa Ann,9999,0,9999,0
1668027292486,CSE 293,011,119190,Heninger; Nadia A,9999,0,9999,0
1668027292486,CSE 293,012,119230,Impagliazzo; Russell,9999,0,9999,0
1668027292486,CSE 293,013,119232,Jhala; Ranjit,9999,0,9999,0
1668027292486,CSE 293,014,119233,Kahng; Andrew Byun,9999,0,9999,0
1668027292486,CSE 293,015,119298,Kane; Daniel Mertz,9999,0,9999,0
1668027292486,CSE 293,016,119299,Kriegman; David J,9999,0,9999,0
1668027292486,CSE 293,017,119300,Kumar; Arun Kumar,9999,0,9999,0
1668027292486,CSE 293,018,119301,Lerner; Sorin,9999,0,9999,0
1668027292486,CSE 293,019,119302,Lovett; Shachar,9999,0,9999,0
1668027292486,CSE 293,020,119303,McAuley; Julian John,9999,0,9999,0
1668027292486,CSE 293,021,119304,Micciancio; Daniele,9999,0,9999,0
1668027292486,CSE 293,022,119367,Orailoglu; Alex,9999,0,9999,0
1668027292486,CSE 293,023,119382,Paturi; Ramamohan,9999,0,9999,0
1668027292486,CSE 293,024,119404,Polikarpova; Nadezhda,9999,0,9999,0
1668027292486,CSE 293,025,119406,Politz; Joseph Gibbs,9999,0,9999,0
1668027292486,CSE 293,026,119411,Porter; George M,9999,0,9999,0
1668027292486,CSE 293,027,119414,Porter; Leonard Emerson,9999,0,9999,0
1668027292486,CSE 293,028,119416,Ramamoorthi; Ravi,9999,0,9999,0
1668027292486,CSE 293,029,119417,Sahoo; Debashis,9999,0,9999,0
1668027292486,CSE 293,030,119420,Saul; Lawrence,9999,0,9999,0
1668027292486,CSE 293,031,119421,Savage; Stefan,9999,0,9999,0
1668027292486,CSE 293,032,119425,Schulze; Jurgen P.,9999,0,9999,0
1668027292486,CSE 293,033,119426,Snoeren; Alex C.,9999,0,9999,0
1668027292486,CSE 293,034,119428,Shang; Jingbo,9999,0,9999,0
1668027292486,CSE 293,035,119430,Stefan; Deian,9999,0,9999,0
1668027292486,CSE 293,036,119431,Su; Hao,9999,0,9999,0
1668027292486,CSE 293,037,119433,Swanson; Steven James,9999,0,9999,0
1668027292486,CSE 293,038,119435,Tullsen; Dean Michael,9999,0,9999,0
1668027292486,CSE 293,039,119483,Voelker; Geoffrey M.,9999,0,9999,0
1668027292486,CSE 293,040,119537,Zhao; Jishen,9999,0,9999,0
1668027292486,CSE 293,041,119538,Zhou; Yuan-Yuan,9999,0,9999,0
1668027292486,CSE 293,042,119539,Gao; Sicun,9999,0,9999,0
1668027292486,CSE 293,043,119540,Weibel; Nadir,9999,0,9999,0
1668027292486,CSE 293,044,119541,Gupta; Rajesh K.,9999,0,9999,0
1668027292486,CSE 293,045,126410,Vaccaro; Kristen Marie,9999,0,9999,0
1668027292486,CSE 293,046,126411,Klemke; Richard,9999,0,9999,0
1668027292921,CSE 294,A00,102459,Voelker; Geoffrey M.,0,0,0,0
1668027292921,CSE 294,B00,111322,Orailoglu; Alex,0,0,0,0
1668027293358,DSE 201,A00,096914,Deutsch; Alin Bernard,30,0,30,0
1668027293805,DSE 210,A00,096915,Dasgupta; Sanjoy,30,0,30,0
1668027294242,DSE 260A,A00,096916,Altintas De Callaf; Ilkay,30,0,30,0
1668027294766,ECE 200,001,103586,Antipa; Nicholas A,9999,0,9999,0
1668027294766,ECE 200,002,103587,Atanasov; Nikolay A.,9999,0,9999,0
1668027294766,ECE 200,003,103588,Bharadia; Dinesh,9999,0,9999,0
1668027294766,ECE 200,004,103589,Cheng; Chung Kuan,9999,0,9999,0
1668027294766,ECE 200,005,103590,Cosman; Pamela C.,9999,0,9999,0
1668027294766,ECE 200,006,103591,Dayeh; Shadi Ahmad,9999,0,9999,0
1668027294766,ECE 200,007,103592,Fainman; Yeshaiahu,9999,0,9999,0
1668027294766,ECE 200,008,103593,Ford; Joseph Earl,9999,0,9999,0
1668027294766,ECE 200,009,103594,Franceschetti; Massimo,9999,0,9999,0
1668027294766,ECE 200,010,103595,Fullerton; Eric E,9999,0,9999,0
1668027294766,ECE 200,011,103596,Galton; Ian A,9999,0,9999,0
1668027294766,ECE 200,012,103597,Gilja; Vikash,9999,0,9999,0
1668027294766,ECE 200,013,103598,Hall; Drew A.,9999,0,9999,0
1668027294766,ECE 200,014,103599,Hsueh; Tzu-Chien,9999,0,9999,0
1668027294766,ECE 200,015,103600,Javidi; Tara,9999,0,9999,0
1668027294766,ECE 200,016,103601,Kahng; Andrew Byun,9999,0,9999,0
1668027294766,ECE 200,017,103602,Kim; Young-Han,9999,0,9999,0
1668027294766,ECE 200,018,103603,Koushanfar; Farinaz,9999,0,9999,0
1668027294766,ECE 200,019,103604,Kuzum; Duygu,9999,0,9999,0
1668027294766,ECE 200,020,103605,Le; Hanh-Phuc,9999,0,9999,0
1668027294766,ECE 200,021,103606,Lin; Bill,9999,0,9999,0
1668027294766,ECE 200,022,103607,Liu; Zhaowei,9998,0,9999,1
1668027294766,ECE 200,023,103608,Lo; Yu-Hwa,9999,0,9999,0
1668027294766,ECE 200,024,103609,Lomakin; Vitaliy,9999,0,9999,0
1668027294766,ECE 200,025,103610,Mercier; Patrick Philip,9999,0,9999,0
1668027294766,ECE 200,026,103611,Meyer; Florian,9999,0,9999,0
1668027294766,ECE 200,027,103612,Milstein; Laurence B.,9999,0,9999,0
1668027294766,ECE 200,028,103613,Mir Arabbaygi; Siavash,9999,0,9999,0
1668027294766,ECE 200,029,103614,Mookherjea; Shayan,9999,0,9999,0
1668027294766,ECE 200,030,103615,Morris; Karcher William,9999,0,9999,0
1668027294766,ECE 200,031,103616,Ng; Tse Nga,9999,0,9999,0
1668027294766,ECE 200,032,103617,Nguyen; Truong Quang,9999,0,9999,0
1668027294766,ECE 200,033,103618,Nomura; Kenji,9999,0,9999,0
1668027294766,ECE 200,034,103619,Orlitsky; Alon,9999,0,9999,0
1668027294766,ECE 200,035,103620,Pal; Piya,9999,0,9999,0
1668027294766,ECE 200,036,103621,Papen; George C.,9999,0,9999,0
1668027294766,ECE 200,037,103622,Radic; Stojan,9999,0,9999,0
1668027294766,ECE 200,038,103623,Rao; Bhaskar D.,9999,0,9999,0
1668027294766,ECE 200,039,103624,Rao; Ramesh R,9999,0,9999,0
1668027294766,ECE 200,040,103625,Rebeiz; Gabriel,9999,0,9999,0
1668027294766,ECE 200,041,103626,Sanford; John R,9999,0,9999,0
1668027294766,ECE 200,042,103627,Siegel; Paul H.,9999,0,9999,0
1668027294766,ECE 200,043,103628,Sievenpiper; Daniel F.,9999,0,9999,0
1668027294766,ECE 200,044,103629,Sworder; David D.,9999,0,9999,0
1668027294766,ECE 200,045,103630,Taur; Yuan,9999,0,9999,0
1668027294766,ECE 200,046,103631,Touri; Behrouz,9999,0,9999,0
1668027294766,ECE 200,047,103632,Trivedi; Mohan M.,9999,0,9999,0
1668027294766,ECE 200,048,103633,Vasconcelos; Nuno,9999,0,9999,0
1668027294766,ECE 200,049,103634,Wang; Xiaolong,9999,0,9999,0
1668027294766,ECE 200,050,103635,Xie; Pengtao,9999,0,9999,0
1668027294766,ECE 200,051,103636,Yip; Michael,9999,0,9999,0
1668027294766,ECE 200,052,103637,Zeger; Kenneth A.,999,0,999,0
1668027294766,ECE 200,053,103638,Zhang; Xinyu,9999,0,9999,0
1668027294766,ECE 200,054,103639,Turakhia; Yatish Girish,9999,0,9999,0
1668027294766,ECE 200,055,103640,Kang; Mingu,9999,0,9999,0
1668027294766,ECE 200,056,103641,Shi; Yuanyuan,9999,0,9999,0
1668027294766,ECE 200,057,103642,Wang; Edward Jay,9999,0,9999,0
1668027294766,ECE 200,058,103643,Zheng; Yang,9999,0,9999,0
1668027295192,ECE 202,A00,103644,Kuzum; Duygu,0,0,0,0
1668027295621,ECE 212BN,A00,103646,Ng; Tse Nga,0,0,0,0
1668027296046,ECE 221,A00,111493,Staff,0,0,0,0
1668027296483,ECE 222B,A00,103647,Lomakin; Vitaliy,0,0,0,0
1668027296907,ECE 230B,A00,103648,Taur; Yuan,0,0,0,0
1668027297409,ECE 238B,A00,103649,Garay; Javier,0,0,0,0
1668027297834,ECE 240B,A00,112900,Fainman; Yeshaiahu,0,0,0,0
1668027298258,ECE 247A,A00,103650,Jokerst; Jesse Vincent,0,0,0,0
1668027298680,ECE 247B,A00,103651,Wang; Joseph,0,0,0,0
1668027299105,ECE 250,A00,103652,Siegel; Paul H.,0,0,0,0
1668027299542,ECE 251A,A00,103654,Rao; Bhaskar D.,0,0,0,0
1668027299966,ECE 257B,A00,103655,Bharadia; Dinesh,0,0,0,0
1668027300432,ECE 258A,A00,103656,Milstein; Laurence B.,0,0,0,0
1668027300863,ECE 260B,A00,103658,Kang; Mingu,0,0,0,0
1668027301304,ECE 264A,A00,103659,Galton; Ian A,0,0,0,0
1668027301801,ECE 265A,A00,103661,Gudem; Prasad S.S.,0,0,0,0
1668027302227,ECE 265D,A00,103662,Gudem; Prasad S.S.,0,0,0,0
1668027302653,ECE 268,A00,103663,Koushanfar; Farinaz,0,0,0,0
1668027303089,ECE 269,A01,103665,Pal; Piya,0,0,0,0
1668027303516,ECE 271B,A00,103666,Vasconcelos; Manuela,0,0,0,0
1668027303955,ECE 276A,A00,103667,Atanasov; Nikolay A.,0,0,0,0
1668027304382,ECE 277,A00,103668,An; Cheolhong,0,0,0,0
1668027304813,ECE 279,A00,117947,Hall; Drew A.,0,0,0,0
1668027305675,ECE 283,A00,103670,Hsueh; Tzu-Chien,0,0,0,0
1668027306107,ECE 284,A00,103671,Turakhia; Yatish Girish,0,0,0,0
1668027306623,ECE 285,A00,103672,Zheng; Yang,0,0,0,0
1668027306623,ECE 285,B00,103673,Sworder; David D.,0,0,0,0
1668027307047,ECE 287,A00,103676,Javidi; Tara,0,0,0,0
1668027307476,MATH 200B,A00,098023,Salehi Golsefidy; Alireza,13,0,15,2
1668027307913,MATH 202B,A00,098024,Rhoades; Brendon Patrick,10,0,15,5
1668027308355,MATH 203B,A00,098025,Oprea; Dragos N.,11,0,15,4
1668027308779,MATH 204B,A00,098026,Sorensen; Claus M,14,0,15,1
1668027309202,MATH 208,A00,098027,Izadi; Elham,7,0,10,3
1668027309628,MATH 209,A00,098028,Pollack; Aaron,10,0,10,0
1668027310054,MATH 211A,A00,112919,Rogalski; Daniel,9,0,10,1
1668027310486,MATH 211B,A00,112920,Seward; Brandon M.,9,0,10,1
1668027310922,MATH 218,A00,098029,Li; Bo,10,0,10,0
1668027311358,MATH 220B,A00,098030,Novak; Jonathan I,13,0,15,2
1668027311789,MATH 221A,A00,098031,Ebenfelt; Peter F,13,0,15,2
1668027312226,MATH 231B,A00,098032,Zlatos; Andrej,12,0,15,3
1668027312654,MATH 240B,A00,098033,Ni; Lei,9,0,15,6
1668027313078,MATH 243,A00,098034,Jekel; David Andrew,10,0,10,0
1668027313502,MATH 245A,A00,098035,Nie; Jiawang,0,0,15,16
1668027313931,MATH 248,A00,098036,Bejenaru; Ioan,10,0,10,0
1668027314353,MATH 250B,A00,098037,Spolaor; Luca,14,0,15,1
1668027314777,MATH 258,A00,098038,Ni; Lei,10,0,10,0
1668027315216,MATH 264B,A00,098041,Rhoades; Brendon Patrick,10,0,15,5
1668027315642,MATH 268,A00,098042,Buss; Samuel R,10,0,10,0
1668027316080,MATH 269,A00,098043,Rhoades; Brendon Patrick,10,0,10,0
1668027316510,MATH 270B,A00,098044,Li; Bo,11,0,15,4
1668027316932,MATH 272B,A00,098045,Holst; Michael J,13,0,15,2
1668027317354,MATH 273A,A00,098046,Tian; Xiaochuan,10,0,15,5
1668027317792,MATH 275,A01,098048,Tian; Xiaochuan,6,0,10,4
1668027318215,MATH 278A,A00,098049,Holst; Michael J,8,0,10,2
1668027318647,MATH 278B,A00,098050,Cloninger; Alexander,10,0,10,0
1668027319072,MATH 278C,A00,098051,Nie; Jiawang,8,0,10,2
1668027319515,MATH 280B,A00,098052,Zheng; Tianyi,11,0,15,4
1668027319946,MATH 281B,A00,098053,Bradic; Jelena,4,0,15,11
1668027320377,MATH 282B,A00,098054,Arias-Castro; Ery,2,0,15,13
1668027320807,MATH 285,A00,098055,Fitzsimmons; Patrick J,0,0,15,17
1668027321235,MATH 287B,A00,098056,Arias-Castro; Ery,4,0,15,11
1668027321668,MATH 288,A00,098057,Agarwal; Pooja,9,0,10,1
1668027321668,MATH 288,B00,098058,Zhang; Danna,9,0,10,1
1668027321668,MATH 288,C00,098059,Williams; Ruth J,10,0,10,0
1668027322092,MATH 290B,A00,098060,Roberts; Justin Deritter,13,0,15,2
1668027322515,MATH 292,A00,098061,Belmont; Eva Kinoshita,10,0,10,0
1668027322943,MATH 295,A00,098062,Suk; Andrew Hoon,48,0,50,2
1668027323373,MATH 296,A00,098063,Novak; Jonathan I,20,0,20,0
1668027323798,MATH 297,001,098064,Gamst; Anthony Collins,9997,0,9999,2
1668027839120,COGS 205,A00,101395,Chiba; Andrea,19,0,20,1
1668027839544,COGS 210B,001,101404,Greene; Deanna Jacquelyn,9998,0,9999,1
1668027839544,COGS 210B,002,101417,Xia; Haijun,9999,0,9999,0
1668027839544,COGS 210B,003,101422,Nitz; Douglas A.,9999,0,9999,0
1668027839544,COGS 210B,004,101423,Hollan; James D.,9998,0,9999,1
1668027839544,COGS 210B,005,101424,Deak; Gedeon O.,9999,0,9999,0
1668027839544,COGS 210B,006,101425,Rossano; Federico,9999,0,9999,0
1668027839972,COGS 211B,A00,101427,Coulson; Seana M,9997,0,9999,2
1668027840395,COGS 220,A00,101428,Hollan; James D.,0,0,25,25
1668027840818,COGS 229,A00,101429,Dow; Steven P,18,0,25,7
1668027841242,COGS 230,A00,101430,Klemmer; Scott R,13,0,17,4
1668027841663,COGS 234,A00,101431,Xia; Haijun,5,0,25,20
1668027842176,COGS 260,A00,101432,Kiyonaga; Anastasia,20,0,25,5
1668027842176,COGS 260,B00,101433,Kirsh; David Joel,16,0,25,9
1668027842610,CSE 202,A00,102371,Impagliazzo; Russell,0,0,0,0
1668027843049,CSE 203B,A01,102373,Cheng; Chung Kuan,0,0,0,0
1668027843473,CSE 208,A00,102374,Micciancio; Daniele,0,0,0,0
1668027843904,CSE 209A,A00,112895,Impagliazzo; Russell,0,0,15,15
1668027844350,CSE 209B,A00,108005,Bellare; Mihir,0,0,0,0
1668027844781,CSE 210,A00,113163,Coblenz; Michael J,0,0,0,0
1668027845205,CSE 219,A00,106111,Dow; Steven P,0,0,20,20
1668027845640,CSE 221,A00,102376,Voelker; Geoffrey M.,0,0,0,0
1668027846095,CSE 224,A01,102378,Porter; George M,0,0,0,0
1668027846524,CSE 229A,A00,102379,Savage; Stefan,0,0,0,0
1668027846958,CSE 229C,A00,102380,Munyaka; Imani N. S.,0,0,0,0
1668027847380,CSE 232B,A00,102382,Deutsch; Alin Bernard,0,0,0,0
1668027847805,CSE 234,A01,112904,Kumar; Arun Kumar,0,0,0,0
1668027848237,CSE 237A,A00,102383,Rosing; Tajana Simunic,0,0,0,0
1668027848671,CSE 239A,A00,102384,Deutsch; Alin Bernard,0,0,0,0
1668027849101,CSE 239B,A00,102385,Polikarpova; Nadezhda,0,0,0,0
1668027849534,CSE 240A,A00,102386,Pannuto; Patrick William,0,0,0,0
1668027849972,CSE 240B,A00,102387,Zhao; Jishen,0,0,0,0
1668027850463,CSE 241A,A00,106406,Kang; Mingu,0,0,0,0
1668027850888,CSE 249B,A00,102388,Kahng; Andrew Byun,0,0,8,8
1668027851318,CSE 251B,A01,102392,Cottrell; Garrison W,0,0,0,0
1668027851318,CSE 251B,A02,102393,Cottrell; Garrison W,0,0,0,0
1668027851747,CSE 252B,A00,102394,Ochoa; Benjamin Lawrence,0,0,0,0
1668027852194,CSE 257,A01,102396,Gao; Sicun,0,0,0,0
1668027852622,CSE 272,A00,102397,Li; Tzumao,0,0,0,0
1668027853049,CSE 274,A00,111323,Chern; Albert Ren-Haur,0,0,0,0
1668027853484,CSE 282,A00,102398,Pevzner; Pavel Arkadjevich,0,0,0,0
1668027853926,CSE 284,A00,114175,Gymrek; Melissa Ann,0,0,0,0
1668027854368,CSE 290,A00,102399,Chandraker; Manmohan Krishna,0,0,0,0
1668027854368,CSE 290,B00,102400,Vaccaro; Kristen Marie,0,0,25,25
1668027854368,CSE 290,C00,102414,Pannuto; Patrick William,0,0,25,25
1668027854368,CSE 290,D00,102427,Pevzner; Pavel Arkadjevich,0,0,0,0
1668027854368,CSE 290,E00,102429,Zhao; Jishen,0,0,0,0
1668027854368,CSE 290,F00,102436,Tullsen; Dean Michael,0,0,0,0
1668027854368,CSE 290,G00,102440,Christensen; Henrik I,0,0,20,20
1668027854798,CSE 291,A00,102443,Su; Hao,0,0,0,0
1668027854798,CSE 291,B00,102448,Polikarpova; Nadezhda,0,0,0,0
1668027854798,CSE 291,C00,102453,Vaccaro; Kristen Marie,0,0,0,0
1668027854798,CSE 291,D00,111343,Savage; Stefan,0,0,0,0
1668027854798,CSE 291,E00,116474,Claffy; Kimberly Claire,0,0,0,0
1668027854798,CSE 291,F00,116479,Pasquale; Joseph,0,0,0,0
1668027855224,CSE 293,001,119111,Bafna; Vineet,9999,0,9999,0
1668027855224,CSE 293,002,119118,Bellare; Mihir,9999,0,9999,0
1668027855224,CSE 293,003,119122,Berg-Kirkpatrick; Taylor D,9999,0,9999,0
1668027855224,CSE 293,004,119135,Christensen; Henrik I,9999,0,9999,0
1668027855224,CSE 293,005,119142,Cottrell; Garrison W,9999,0,9999,0
1668027855224,CSE 293,006,119146,Deutsch; Alin Bernard,9999,0,9999,0
1668027855224,CSE 293,007,119159,Esmaeilzadeh; Hadi,9999,0,9999,0
1668027855224,CSE 293,008,119166,Freund; Yoav,9999,0,9999,0
1668027855224,CSE 293,009,119170,Griswold; William G.,9999,0,9999,0
1668027855224,CSE 293,010,119183,Gymrek; Melissa Ann,9999,0,9999,0
1668027855224,CSE 293,011,119190,Heninger; Nadia A,9999,0,9999,0
1668027855224,CSE 293,012,119230,Impagliazzo; Russell,9999,0,9999,0
1668027855224,CSE 293,013,119232,Jhala; Ranjit,9999,0,9999,0
1668027855224,CSE 293,014,119233,Kahng; Andrew Byun,9999,0,9999,0
1668027855224,CSE 293,015,119298,Kane; Daniel Mertz,9999,0,9999,0
1668027855224,CSE 293,016,119299,Kriegman; David J,9999,0,9999,0
1668027855224,CSE 293,017,119300,Kumar; Arun Kumar,9999,0,9999,0
1668027855224,CSE 293,018,119301,Lerner; Sorin,9999,0,9999,0
1668027855224,CSE 293,019,119302,Lovett; Shachar,9999,0,9999,0
1668027855224,CSE 293,020,119303,McAuley; Julian John,9999,0,9999,0
1668027855224,CSE 293,021,119304,Micciancio; Daniele,9999,0,9999,0
1668027855224,CSE 293,022,119367,Orailoglu; Alex,9999,0,9999,0
1668027855224,CSE 293,023,119382,Paturi; Ramamohan,9999,0,9999,0
1668027855224,CSE 293,024,119404,Polikarpova; Nadezhda,9999,0,9999,0
1668027855224,CSE 293,025,119406,Politz; Joseph Gibbs,9999,0,9999,0
1668027855224,CSE 293,026,119411,Porter; George M,9999,0,9999,0
1668027855224,CSE 293,027,119414,Porter; Leonard Emerson,9999,0,9999,0
1668027855224,CSE 293,028,119416,Ramamoorthi; Ravi,9999,0,9999,0
1668027855224,CSE 293,029,119417,Sahoo; Debashis,9999,0,9999,0
1668027855224,CSE 293,030,119420,Saul; Lawrence,9999,0,9999,0
1668027855224,CSE 293,031,119421,Savage; Stefan,9999,0,9999,0
1668027855224,CSE 293,032,119425,Schulze; Jurgen P.,9999,0,9999,0
1668027855224,CSE 293,033,119426,Snoeren; Alex C.,9999,0,9999,0
1668027855224,CSE 293,034,119428,Shang; Jingbo,9999,0,9999,0
1668027855224,CSE 293,035,119430,Stefan; Deian,9999,0,9999,0
1668027855224,CSE 293,036,119431,Su; Hao,9999,0,9999,0
1668027855224,CSE 293,037,119433,Swanson; Steven James,9999,0,9999,0
1668027855224,CSE 293,038,119435,Tullsen; Dean Michael,9999,0,9999,0
1668027855224,CSE 293,039,119483,Voelker; Geoffrey M.,9999,0,9999,0
1668027855224,CSE 293,040,119537,Zhao; Jishen,9999,0,9999,0
1668027855224,CSE 293,041,119538,Zhou; Yuan-Yuan,9999,0,9999,0
1668027855224,CSE 293,042,119539,Gao; Sicun,9999,0,9999,0
1668027855224,CSE 293,043,119540,Weibel; Nadir,9999,0,9999,0
1668027855224,CSE 293,044,119541,Gupta; Rajesh K.,9999,0,9999,0
1668027855224,CSE 293,045,126410,Vaccaro; Kristen Marie,9999,0,9999,0
1668027855224,CSE 293,046,126411,Klemke; Richard,9999,0,9999,0
1668027855645,CSE 294,A00,102459,Voelker; Geoffrey M.,0,0,0,0
1668027855645,CSE 294,B00,111322,Orailoglu; Alex,0,0,0,0
1668027856077,DSE 201,A00,096914,Deutsch; Alin Bernard,30,0,30,0
1668027856509,DSE 210,A00,096915,Dasgupta; Sanjoy,30,0,30,0
1668027856937,DSE 260A,A00,096916,Altintas De Callaf; Ilkay,30,0,30,0
1668027857392,ECE 200,001,103586,Antipa; Nicholas A,9999,0,9999,0
1668027857392,ECE 200,002,103587,Atanasov; Nikolay A.,9999,0,9999,0
1668027857392,ECE 200,003,103588,Bharadia; Dinesh,9999,0,9999,0
1668027857392,ECE 200,004,103589,Cheng; Chung Kuan,9999,0,9999,0
1668027857392,ECE 200,005,103590,Cosman; Pamela C.,9999,0,9999,0
1668027857392,ECE 200,006,103591,Dayeh; Shadi Ahmad,9999,0,9999,0
1668027857392,ECE 200,007,103592,Fainman; Yeshaiahu,9999,0,9999,0
1668027857392,ECE 200,008,103593,Ford; Joseph Earl,9999,0,9999,0
1668027857392,ECE 200,009,103594,Franceschetti; Massimo,9999,0,9999,0
1668027857392,ECE 200,010,103595,Fullerton; Eric E,9999,0,9999,0
1668027857392,ECE 200,011,103596,Galton; Ian A,9999,0,9999,0
1668027857392,ECE 200,012,103597,Gilja; Vikash,9999,0,9999,0
1668027857392,ECE 200,013,103598,Hall; Drew A.,9999,0,9999,0
1668027857392,ECE 200,014,103599,Hsueh; Tzu-Chien,9999,0,9999,0
1668027857392,ECE 200,015,103600,Javidi; Tara,9999,0,9999,0
1668027857392,ECE 200,016,103601,Kahng; Andrew Byun,9999,0,9999,0
1668027857392,ECE 200,017,103602,Kim; Young-Han,9999,0,9999,0
1668027857392,ECE 200,018,103603,Koushanfar; Farinaz,9999,0,9999,0
1668027857392,ECE 200,019,103604,Kuzum; Duygu,9999,0,9999,0
1668027857392,ECE 200,020,103605,Le; Hanh-Phuc,9999,0,9999,0
1668027857392,ECE 200,021,103606,Lin; Bill,9999,0,9999,0
1668027857392,ECE 200,022,103607,Liu; Zhaowei,9998,0,9999,1
1668027857392,ECE 200,023,103608,Lo; Yu-Hwa,9999,0,9999,0
1668027857392,ECE 200,024,103609,Lomakin; Vitaliy,9999,0,9999,0
1668027857392,ECE 200,025,103610,Mercier; Patrick Philip,9999,0,9999,0
1668027857392,ECE 200,026,103611,Meyer; Florian,9999,0,9999,0
1668027857392,ECE 200,027,103612,Milstein; Laurence B.,9999,0,9999,0
1668027857392,ECE 200,028,103613,Mir Arabbaygi; Siavash,9999,0,9999,0
1668027857392,ECE 200,029,103614,Mookherjea; Shayan,9999,0,9999,0
1668027857392,ECE 200,030,103615,Morris; Karcher William,9999,0,9999,0
1668027857392,ECE 200,031,103616,Ng; Tse Nga,9999,0,9999,0
1668027857392,ECE 200,032,103617,Nguyen; Truong Quang,9999,0,9999,0
1668027857392,ECE 200,033,103618,Nomura; Kenji,9999,0,9999,0
1668027857392,ECE 200,034,103619,Orlitsky; Alon,9999,0,9999,0
1668027857392,ECE 200,035,103620,Pal; Piya,9999,0,9999,0
1668027857392,ECE 200,036,103621,Papen; George C.,9999,0,9999,0
1668027857392,ECE 200,037,103622,Radic; Stojan,9999,0,9999,0
1668027857392,ECE 200,038,103623,Rao; Bhaskar D.,9999,0,9999,0
1668027857392,ECE 200,039,103624,Rao; Ramesh R,9999,0,9999,0
1668027857392,ECE 200,040,103625,Rebeiz; Gabriel,9999,0,9999,0
1668027857392,ECE 200,041,103626,Sanford; John R,9999,0,9999,0
1668027857392,ECE 200,042,103627,Siegel; Paul H.,9999,0,9999,0
1668027857392,ECE 200,043,103628,Sievenpiper; Daniel F.,9999,0,9999,0
1668027857392,ECE 200,044,103629,Sworder; David D.,9999,0,9999,0
1668027857392,ECE 200,045,103630,Taur; Yuan,9999,0,9999,0
1668027857392,ECE 200,046,103631,Touri; Behrouz,9999,0,9999,0
1668027857392,ECE 200,047,103632,Trivedi; Mohan M.,9999,0,9999,0
1668027857392,ECE 200,048,103633,Vasconcelos; Nuno,9999,0,9999,0
1668027857392,ECE 200,049,103634,Wang; Xiaolong,9999,0,9999,0
1668027857392,ECE 200,050,103635,Xie; Pengtao,9999,0,9999,0
1668027857392,ECE 200,051,103636,Yip; Michael,9999,0,9999,0
1668027857392,ECE 200,052,103637,Zeger; Kenneth A.,999,0,999,0
1668027857392,ECE 200,053,103638,Zhang; Xinyu,9999,0,9999,0
1668027857392,ECE 200,054,103639,Turakhia; Yatish Girish,9999,0,9999,0
1668027857392,ECE 200,055,103640,Kang; Mingu,9999,0,9999,0
1668027857392,ECE 200,056,103641,Shi; Yuanyuan,9999,0,9999,0
1668027857392,ECE 200,057,103642,Wang; Edward Jay,9999,0,9999,0
1668027857392,ECE 200,058,103643,Zheng; Yang,9999,0,9999,0
1668027857822,ECE 202,A00,103644,Kuzum; Duygu,0,0,0,0
1668027858250,ECE 212BN,A00,103646,Ng; Tse Nga,0,0,0,0
1668027858672,ECE 221,A00,111493,Staff,0,0,0,0
1668027859096,ECE 222B,A00,103647,Lomakin; Vitaliy,0,0,0,0
1668027859532,ECE 230B,A00,103648,Taur; Yuan,0,0,0,0
1668027859957,ECE 238B,A00,103649,Garay; Javier,0,0,0,0
1668027860397,ECE 240B,A00,112900,Fainman; Yeshaiahu,0,0,0,0
1668027860826,ECE 247A,A00,103650,Jokerst; Jesse Vincent,0,0,0,0
1668027861255,ECE 247B,A00,103651,Wang; Joseph,0,0,0,0
1668027861684,ECE 250,A00,103652,Siegel; Paul H.,0,0,0,0
1668027862108,ECE 251A,A00,103654,Rao; Bhaskar D.,0,0,0,0
1668027862539,ECE 257B,A00,103655,Bharadia; Dinesh,0,0,0,0
1668027862964,ECE 258A,A00,103656,Milstein; Laurence B.,0,0,0,0
1668027863392,ECE 260B,A00,103658,Kang; Mingu,0,0,0,0
1668027863830,ECE 264A,A00,103659,Galton; Ian A,0,0,0,0
1668027864252,ECE 265A,A00,103661,Gudem; Prasad S.S.,0,0,0,0
1668027864677,ECE 265D,A00,103662,Gudem; Prasad S.S.,0,0,0,0
1668027865103,ECE 268,A00,103663,Koushanfar; Farinaz,0,0,0,0
1668027865540,ECE 269,A01,103665,Pal; Piya,0,0,0,0
1668027865969,ECE 271B,A00,103666,Vasconcelos; Manuela,0,0,0,0
1668027866394,ECE 276A,A00,103667,Atanasov; Nikolay A.,0,0,0,0
1668027866820,ECE 277,A00,103668,An; Cheolhong,0,0,0,0
1668027867244,ECE 279,A00,117947,Hall; Drew A.,0,0,0,0
1668027868102,ECE 283,A00,103670,Hsueh; Tzu-Chien,0,0,0,0
1668027868526,ECE 284,A00,103671,Turakhia; Yatish Girish,0,0,0,0
1668027868953,ECE 285,A00,103672,Zheng; Yang,0,0,0,0
1668027868953,ECE 285,B00,103673,Sworder; David D.,0,0,0,0
1668027869380,ECE 287,A00,103676,Javidi; Tara,0,0,0,0
1668027869803,MATH 200B,A00,098023,Salehi Golsefidy; Alireza,13,0,15,2
1668027870244,MATH 202B,A00,098024,Rhoades; Brendon Patrick,10,0,15,5
1668027870682,MATH 203B,A00,098025,Oprea; Dragos N.,11,0,15,4
1668027871118,MATH 204B,A00,098026,Sorensen; Claus M,14,0,15,1
1668027871541,MATH 208,A00,098027,Izadi; Elham,7,0,10,3
1668027871965,MATH 209,A00,098028,Pollack; Aaron,10,0,10,0
1668027872396,MATH 211A,A00,112919,Rogalski; Daniel,9,0,10,1
1668027872825,MATH 211B,A00,112920,Seward; Brandon M.,9,0,10,1
1668027873250,MATH 218,A00,098029,Li; Bo,10,0,10,0
1668027873678,MATH 220B,A00,098030,Novak; Jonathan I,13,0,15,2
1668027874100,MATH 221A,A00,098031,Ebenfelt; Peter F,13,0,15,2
1668027874524,MATH 231B,A00,098032,Zlatos; Andrej,12,0,15,3
1668027874948,MATH 240B,A00,098033,Ni; Lei,9,0,15,6
1668027875373,MATH 243,A00,098034,Jekel; David Andrew,10,0,10,0
1668027875795,MATH 245A,A00,098035,Nie; Jiawang,0,0,15,16
1668027876218,MATH 248,A00,098036,Bejenaru; Ioan,10,0,10,0
1668027876641,MATH 250B,A00,098037,Spolaor; Luca,14,0,15,1
1668027877063,MATH 258,A00,098038,Ni; Lei,10,0,10,0
1668027877502,MATH 264B,A00,098041,Rhoades; Brendon Patrick,10,0,15,5
1668027877933,MATH 268,A00,098042,Buss; Samuel R,10,0,10,0
1668027878359,MATH 269,A00,098043,Rhoades; Brendon Patrick,10,0,10,0
1668027878798,MATH 270B,A00,098044,Li; Bo,11,0,15,4
1668027879229,MATH 272B,A00,098045,Holst; Michael J,13,0,15,2
1668027879661,MATH 273A,A00,098046,Tian; Xiaochuan,10,0,15,5
1668027880084,MATH 275,A01,098048,Tian; Xiaochuan,6,0,10,4
1668027880510,MATH 278A,A00,098049,Holst; Michael J,8,0,10,2
1668027880939,MATH 278B,A00,098050,Cloninger; Alexander,10,0,10,0
1668027881363,MATH 278C,A00,098051,Nie; Jiawang,8,0,10,2
1668027881793,MATH 280B,A00,098052,Zheng; Tianyi,11,0,15,4
1668027882217,MATH 281B,A00,098053,Bradic; Jelena,4,0,15,11
1668027882648,MATH 282B,A00,098054,Arias-Castro; Ery,2,0,15,13
1668027883072,MATH 285,A00,098055,Fitzsimmons; Patrick J,0,0,15,17
1668027883494,MATH 287B,A00,098056,Arias-Castro; Ery,4,0,15,11
1668027883924,MATH 288,A00,098057,Agarwal; Pooja,9,0,10,1
1668027883924,MATH 288,B00,098058,Zhang; Danna,9,0,10,1
1668027883924,MATH 288,C00,098059,Williams; Ruth J,10,0,10,0
1668027884355,MATH 290B,A00,098060,Roberts; Justin Deritter,13,0,15,2
1668027884802,MATH 292,A00,098061,Belmont; Eva Kinoshita,10,0,10,0
1668027885231,MATH 295,A00,098062,Suk; Andrew Hoon,48,0,50,2
1668027885751,MATH 296,A00,098063,Novak; Jonathan I,20,0,20,0
1668027886173,MATH 297,001,098064,Gamst; Anthony Collins,9997,0,9999,2
1668028391807,COGS 205,A00,101395,Chiba; Andrea,19,0,20,1
1668028392235,COGS 210B,001,101404,Greene; Deanna Jacquelyn,9998,0,9999,1
1668028392235,COGS 210B,002,101417,Xia; Haijun,9999,0,9999,0
1668028392235,COGS 210B,003,101422,Nitz; Douglas A.,9999,0,9999,0
1668028392235,COGS 210B,004,101423,Hollan; James D.,9998,0,9999,1
1668028392235,COGS 210B,005,101424,Deak; Gedeon O.,9999,0,9999,0
1668028392235,COGS 210B,006,101425,Rossano; Federico,9999,0,9999,0
1668028392676,COGS 211B,A00,101427,Coulson; Seana M,9997,0,9999,2
1668028393100,COGS 220,A00,101428,Hollan; James D.,0,0,25,25
1668028393528,COGS 229,A00,101429,Dow; Steven P,18,0,25,7
1668028393968,COGS 230,A00,101430,Klemmer; Scott R,13,0,17,4
1668028394415,COGS 234,A00,101431,Xia; Haijun,5,0,25,20
1668028394842,COGS 260,A00,101432,Kiyonaga; Anastasia,20,0,25,5
1668028394842,COGS 260,B00,101433,Kirsh; David Joel,16,0,25,9
1668028395265,CSE 202,A00,102371,Impagliazzo; Russell,0,0,0,0
1668028395694,CSE 203B,A01,102373,Cheng; Chung Kuan,0,0,0,0
1668028396124,CSE 208,A00,102374,Micciancio; Daniele,0,0,0,0
1668028396549,CSE 209A,A00,112895,Impagliazzo; Russell,0,0,15,15
1668028396985,CSE 209B,A00,108005,Bellare; Mihir,0,0,0,0
1668028397413,CSE 210,A00,113163,Coblenz; Michael J,0,0,0,0
1668028397839,CSE 219,A00,106111,Dow; Steven P,0,0,20,20
1668028398276,CSE 221,A00,102376,Voelker; Geoffrey M.,0,0,0,0
1668028398704,CSE 224,A01,102378,Porter; George M,0,0,0,0
1668028399128,CSE 229A,A00,102379,Savage; Stefan,0,0,0,0
1668028399557,CSE 229C,A00,102380,Munyaka; Imani N. S.,0,0,0,0
1668028399990,CSE 232B,A00,102382,Deutsch; Alin Bernard,0,0,0,0
1668028400424,CSE 234,A01,112904,Kumar; Arun Kumar,0,0,0,0
1668028400848,CSE 237A,A00,102383,Rosing; Tajana Simunic,0,0,0,0
1668028401273,CSE 239A,A00,102384,Deutsch; Alin Bernard,0,0,0,0
1668028401703,CSE 239B,A00,102385,Polikarpova; Nadezhda,0,0,0,0
1668028402126,CSE 240A,A00,102386,Pannuto; Patrick William,0,0,0,0
1668028402549,CSE 240B,A00,102387,Zhao; Jishen,0,0,0,0
1668028402979,CSE 241A,A00,106406,Kang; Mingu,0,0,0,0
1668028403414,CSE 249B,A00,102388,Kahng; Andrew Byun,0,0,8,8
1668028403839,CSE 251B,A01,102392,Cottrell; Garrison W,0,0,0,0
1668028403839,CSE 251B,A02,102393,Cottrell; Garrison W,0,0,0,0
1668028404273,CSE 252B,A00,102394,Ochoa; Benjamin Lawrence,0,0,0,0
1668028404852,CSE 257,A01,102396,Gao; Sicun,0,0,0,0
1668028405276,CSE 272,A00,102397,Li; Tzumao,0,0,0,0
1668028405698,CSE 274,A00,111323,Chern; Albert Ren-Haur,0,0,0,0
1668028406124,CSE 282,A00,102398,Pevzner; Pavel Arkadjevich,0,0,0,0
1668028406554,CSE 284,A00,114175,Gymrek; Melissa Ann,0,0,0,0
1668028406994,CSE 290,A00,102399,Chandraker; Manmohan Krishna,0,0,0,0
1668028406994,CSE 290,B00,102400,Vaccaro; Kristen Marie,0,0,25,25
1668028406994,CSE 290,C00,102414,Pannuto; Patrick William,0,0,25,25
1668028406994,CSE 290,D00,102427,Pevzner; Pavel Arkadjevich,0,0,0,0
1668028406994,CSE 290,E00,102429,Zhao; Jishen,0,0,0,0
1668028406994,CSE 290,F00,102436,Tullsen; Dean Michael,0,0,0,0
1668028406994,CSE 290,G00,102440,Christensen; Henrik I,0,0,20,20
1668028407429,CSE 291,A00,102443,Su; Hao,0,0,0,0
1668028407429,CSE 291,B00,102448,Polikarpova; Nadezhda,0,0,0,0
1668028407429,CSE 291,C00,102453,Vaccaro; Kristen Marie,0,0,0,0
1668028407429,CSE 291,D00,111343,Savage; Stefan,0,0,0,0
1668028407429,CSE 291,E00,116474,Claffy; Kimberly Claire,0,0,0,0
1668028407429,CSE 291,F00,116479,Pasquale; Joseph,0,0,0,0
1668028407857,CSE 293,001,119111,Bafna; Vineet,9999,0,9999,0
1668028407857,CSE 293,002,119118,Bellare; Mihir,9999,0,9999,0
1668028407857,CSE 293,003,119122,Berg-Kirkpatrick; Taylor D,9999,0,9999,0
1668028407857,CSE 293,004,119135,Christensen; Henrik I,9999,0,9999,0
1668028407857,CSE 293,005,119142,Cottrell; Garrison W,9999,0,9999,0
1668028407857,CSE 293,006,119146,Deutsch; Alin Bernard,9999,0,9999,0
1668028407857,CSE 293,007,119159,Esmaeilzadeh; Hadi,9999,0,9999,0
1668028407857,CSE 293,008,119166,Freund; Yoav,9999,0,9999,0
1668028407857,CSE 293,009,119170,Griswold; William G.,9999,0,9999,0
1668028407857,CSE 293,010,119183,Gymrek; Melissa Ann,9999,0,9999,0
1668028407857,CSE 293,011,119190,Heninger; Nadia A,9999,0,9999,0
1668028407857,CSE 293,012,119230,Impagliazzo; Russell,9999,0,9999,0
1668028407857,CSE 293,013,119232,Jhala; Ranjit,9999,0,9999,0
1668028407857,CSE 293,014,119233,Kahng; Andrew Byun,9999,0,9999,0
1668028407857,CSE 293,015,119298,Kane; Daniel Mertz,9999,0,9999,0
1668028407857,CSE 293,016,119299,Kriegman; David J,9999,0,9999,0
1668028407857,CSE 293,017,119300,Kumar; Arun Kumar,9999,0,9999,0
1668028407857,CSE 293,018,119301,Lerner; Sorin,9999,0,9999,0
1668028407857,CSE 293,019,119302,Lovett; Shachar,9999,0,9999,0
1668028407857,CSE 293,020,119303,McAuley; Julian John,9999,0,9999,0
1668028407857,CSE 293,021,119304,Micciancio; Daniele,9999,0,9999,0
1668028407857,CSE 293,022,119367,Orailoglu; Alex,9999,0,9999,0
1668028407857,CSE 293,023,119382,Paturi; Ramamohan,9999,0,9999,0
1668028407857,CSE 293,024,119404,Polikarpova; Nadezhda,9999,0,9999,0
1668028407857,CSE 293,025,119406,Politz; Joseph Gibbs,9999,0,9999,0
1668028407857,CSE 293,026,119411,Porter; George M,9999,0,9999,0
1668028407857,CSE 293,027,119414,Porter; Leonard Emerson,9999,0,9999,0
1668028407857,CSE 293,028,119416,Ramamoorthi; Ravi,9999,0,9999,0
1668028407857,CSE 293,029,119417,Sahoo; Debashis,9999,0,9999,0
1668028407857,CSE 293,030,119420,Saul; Lawrence,9999,0,9999,0
1668028407857,CSE 293,031,119421,Savage; Stefan,9999,0,9999,0
1668028407857,CSE 293,032,119425,Schulze; Jurgen P.,9999,0,9999,0
1668028407857,CSE 293,033,119426,Snoeren; Alex C.,9999,0,9999,0
1668028407857,CSE 293,034,119428,Shang; Jingbo,9999,0,9999,0
1668028407857,CSE 293,035,119430,Stefan; Deian,9999,0,9999,0
1668028407857,CSE 293,036,119431,Su; Hao,9999,0,9999,0
1668028407857,CSE 293,037,119433,Swanson; Steven James,9999,0,9999,0
1668028407857,CSE 293,038,119435,Tullsen; Dean Michael,9999,0,9999,0
1668028407857,CSE 293,039,119483,Voelker; Geoffrey M.,9999,0,9999,0
1668028407857,CSE 293,040,119537,Zhao; Jishen,9999,0,9999,0
1668028407857,CSE 293,041,119538,Zhou; Yuan-Yuan,9999,0,9999,0
1668028407857,CSE 293,042,119539,Gao; Sicun,9999,0,9999,0
1668028407857,CSE 293,043,119540,Weibel; Nadir,9999,0,9999,0
1668028407857,CSE 293,044,119541,Gupta; Rajesh K.,9999,0,9999,0
1668028407857,CSE 293,045,126410,Vaccaro; Kristen Marie,9999,0,9999,0
1668028407857,CSE 293,046,126411,Klemke; Richard,9999,0,9999,0
1668028408279,CSE 294,A00,102459,Voelker; Geoffrey M.,0,0,0,0
1668028408279,CSE 294,B00,111322,Orailoglu; Alex,0,0,0,0
1668028408703,DSE 201,A00,096914,Deutsch; Alin Bernard,30,0,30,0
1668028409126,DSE 210,A00,096915,Dasgupta; Sanjoy,30,0,30,0
1668028409554,DSE 260A,A00,096916,Altintas De Callaf; Ilkay,30,0,30,0
1668028409985,ECE 200,001,103586,Antipa; Nicholas A,9999,0,9999,0
1668028409985,ECE 200,002,103587,Atanasov; Nikolay A.,9999,0,9999,0
1668028409985,ECE 200,003,103588,Bharadia; Dinesh,9999,0,9999,0
1668028409985,ECE 200,004,103589,Cheng; Chung Kuan,9999,0,9999,0
1668028409985,ECE 200,005,103590,Cosman; Pamela C.,9999,0,9999,0
1668028409985,ECE 200,006,103591,Dayeh; Shadi Ahmad,9999,0,9999,0
1668028409985,ECE 200,007,103592,Fainman; Yeshaiahu,9999,0,9999,0
1668028409985,ECE 200,008,103593,Ford; Joseph Earl,9999,0,9999,0
1668028409985,ECE 200,009,103594,Franceschetti; Massimo,9999,0,9999,0
1668028409985,ECE 200,010,103595,Fullerton; Eric E,9999,0,9999,0
1668028409985,ECE 200,011,103596,Galton; Ian A,9999,0,9999,0
1668028409985,ECE 200,012,103597,Gilja; Vikash,9999,0,9999,0
1668028409985,ECE 200,013,103598,Hall; Drew A.,9999,0,9999,0
1668028409985,ECE 200,014,103599,Hsueh; Tzu-Chien,9999,0,9999,0
1668028409985,ECE 200,015,103600,Javidi; Tara,9999,0,9999,0
1668028409985,ECE 200,016,103601,Kahng; Andrew Byun,9999,0,9999,0
1668028409985,ECE 200,017,103602,Kim; Young-Han,9999,0,9999,0
1668028409985,ECE 200,018,103603,Koushanfar; Farinaz,9999,0,9999,0
1668028409985,ECE 200,019,103604,Kuzum; Duygu,9999,0,9999,0
1668028409985,ECE 200,020,103605,Le; Hanh-Phuc,9999,0,9999,0
1668028409985,ECE 200,021,103606,Lin; Bill,9999,0,9999,0
1668028409985,ECE 200,022,103607,Liu; Zhaowei,9998,0,9999,1
1668028409985,ECE 200,023,103608,Lo; Yu-Hwa,9999,0,9999,0
1668028409985,ECE 200,024,103609,Lomakin; Vitaliy,9999,0,9999,0
1668028409985,ECE 200,025,103610,Mercier; Patrick Philip,9999,0,9999,0
1668028409985,ECE 200,026,103611,Meyer; Florian,9999,0,9999,0
1668028409985,ECE 200,027,103612,Milstein; Laurence B.,9999,0,9999,0
1668028409985,ECE 200,028,103613,Mir Arabbaygi; Siavash,9999,0,9999,0
1668028409985,ECE 200,029,103614,Mookherjea; Shayan,9999,0,9999,0
1668028409985,ECE 200,030,103615,Morris; Karcher William,9999,0,9999,0
1668028409985,ECE 200,031,103616,Ng; Tse Nga,9999,0,9999,0
1668028409985,ECE 200,032,103617,Nguyen; Truong Quang,9999,0,9999,0
1668028409985,ECE 200,033,103618,Nomura; Kenji,9999,0,9999,0
1668028409985,ECE 200,034,103619,Orlitsky; Alon,9999,0,9999,0
1668028409985,ECE 200,035,103620,Pal; Piya,9999,0,9999,0
1668028409985,ECE 200,036,103621,Papen; George C.,9999,0,9999,0
1668028409985,ECE 200,037,103622,Radic; Stojan,9999,0,9999,0
1668028409985,ECE 200,038,103623,Rao; Bhaskar D.,9999,0,9999,0
1668028409985,ECE 200,039,103624,Rao; Ramesh R,9999,0,9999,0
1668028409985,ECE 200,040,103625,Rebeiz; Gabriel,9999,0,9999,0
1668028409985,ECE 200,041,103626,Sanford; John R,9999,0,9999,0
1668028409985,ECE 200,042,103627,Siegel; Paul H.,9999,0,9999,0
1668028409985,ECE 200,043,103628,Sievenpiper; Daniel F.,9999,0,9999,0
1668028409985,ECE 200,044,103629,Sworder; David D.,9999,0,9999,0
1668028409985,ECE 200,045,103630,Taur; Yuan,9999,0,9999,0
1668028409985,ECE 200,046,103631,Touri; Behrouz,9999,0,9999,0
1668028409985,ECE 200,047,103632,Trivedi; Mohan M.,9999,0,9999,0
1668028409985,ECE 200,048,103633,Vasconcelos; Nuno,9999,0,9999,0
1668028409985,ECE 200,049,103634,Wang; Xiaolong,9999,0,9999,0
1668028409985,ECE 200,050,103635,Xie; Pengtao,9999,0,9999,0
1668028409985,ECE 200,051,103636,Yip; Michael,9999,0,9999,0
1668028409985,ECE 200,052,103637,Zeger; Kenneth A.,999,0,999,0
1668028409985,ECE 200,053,103638,Zhang; Xinyu,9999,0,9999,0
1668028409985,ECE 200,054,103639,Turakhia; Yatish Girish,9999,0,9999,0
1668028409985,ECE 200,055,103640,Kang; Mingu,9999,0,9999,0
1668028409985,ECE 200,056,103641,Shi; Yuanyuan,9999,0,9999,0
1668028409985,ECE 200,057,103642,Wang; Edward Jay,9999,0,9999,0
1668028409985,ECE 200,058,103643,Zheng; Yang,9999,0,9999,0
1668028410410,ECE 202,A00,103644,Kuzum; Duygu,0,0,0,0
1668028410842,ECE 212BN,A00,103646,Ng; Tse Nga,0,0,0,0
1668028411268,ECE 221,A00,111493,Staff,0,0,0,0
1668028411792,ECE 222B,A00,103647,Lomakin; Vitaliy,0,0,0,0
1668028412230,ECE 230B,A00,103648,Taur; Yuan,0,0,0,0
1668028412651,ECE 238B,A00,103649,Garay; Javier,0,0,0,0
1668028413090,ECE 240B,A00,112900,Fainman; Yeshaiahu,0,0,0,0
1668028413528,ECE 247A,A00,103650,Jokerst; Jesse Vincent,0,0,0,0
1668028413974,ECE 247B,A00,103651,Wang; Joseph,0,0,0,0
1668028414413,ECE 250,A00,103652,Siegel; Paul H.,0,0,0,0
1668028414842,ECE 251A,A00,103654,Rao; Bhaskar D.,0,0,0,0
1668028415276,ECE 257B,A00,103655,Bharadia; Dinesh,0,0,0,0
1668028415704,ECE 258A,A00,103656,Milstein; Laurence B.,0,0,0,0
1668028416139,ECE 260B,A00,103658,Kang; Mingu,0,0,0,0
1668028416568,ECE 264A,A00,103659,Galton; Ian A,0,0,0,0
1668028416999,ECE 265A,A00,103661,Gudem; Prasad S.S.,0,0,0,0
1668028417425,ECE 265D,A00,103662,Gudem; Prasad S.S.,0,0,0,0
1668028417863,ECE 268,A00,103663,Koushanfar; Farinaz,0,0,0,0
1668028418294,ECE 269,A01,103665,Pal; Piya,0,0,0,0
1668028418727,ECE 271B,A00,103666,Vasconcelos; Manuela,0,0,0,0
1668028419163,ECE 276A,A00,103667,Atanasov; Nikolay A.,0,0,0,0
1668028419593,ECE 277,A00,103668,An; Cheolhong,0,0,0,0
1668028420016,ECE 279,A00,117947,Hall; Drew A.,0,0,0,0
1668028420864,ECE 283,A00,103670,Hsueh; Tzu-Chien,0,0,0,0
1668028421288,ECE 284,A00,103671,Turakhia; Yatish Girish,0,0,0,0
1668028421713,ECE 285,A00,103672,Zheng; Yang,0,0,0,0
1668028421713,ECE 285,B00,103673,Sworder; David D.,0,0,0,0
1668028422143,ECE 287,A00,103676,Javidi; Tara,0,0,0,0
1668028422579,MATH 200B,A00,098023,Salehi Golsefidy; Alireza,13,0,15,2
1668028423017,MATH 202B,A00,098024,Rhoades; Brendon Patrick,10,0,15,5
1668028423446,MATH 203B,A00,098025,Oprea; Dragos N.,11,0,15,4
1668028423885,MATH 204B,A00,098026,Sorensen; Claus M,14,0,15,1
1668028424310,MATH 208,A00,098027,Izadi; Elham,7,0,10,3
1668028424755,MATH 209,A00,098028,Pollack; Aaron,10,0,10,0
1668028425191,MATH 211A,A00,112919,Rogalski; Daniel,9,0,10,1
1668028425629,MATH 211B,A00,112920,Seward; Brandon M.,9,0,10,1
1668028426062,MATH 218,A00,098029,Li; Bo,10,0,10,0
1668028426500,MATH 220B,A00,098030,Novak; Jonathan I,13,0,15,2
1668028426943,MATH 221A,A00,098031,Ebenfelt; Peter F,13,0,15,2
1668028427372,MATH 231B,A00,098032,Zlatos; Andrej,12,0,15,3
1668028427803,MATH 240B,A00,098033,Ni; Lei,9,0,15,6
1668028428226,MATH 243,A00,098034,Jekel; David Andrew,10,0,10,0
1668028428662,MATH 245A,A00,098035,Nie; Jiawang,0,0,15,16
1668028429105,MATH 248,A00,098036,Bejenaru; Ioan,10,0,10,0
1668028429534,MATH 250B,A00,098037,Spolaor; Luca,14,0,15,1
1668028429960,MATH 258,A00,098038,Ni; Lei,10,0,10,0
1668028430384,MATH 264B,A00,098041,Rhoades; Brendon Patrick,10,0,15,5
1668028430810,MATH 268,A00,098042,Buss; Samuel R,10,0,10,0
1668028431239,MATH 269,A00,098043,Rhoades; Brendon Patrick,10,0,10,0
1668028431663,MATH 270B,A00,098044,Li; Bo,11,0,15,4
1668028432097,MATH 272B,A00,098045,Holst; Michael J,13,0,15,2
1668028432541,MATH 273A,A00,098046,Tian; Xiaochuan,10,0,15,5
1668028432970,MATH 275,A01,098048,Tian; Xiaochuan,6,0,10,4
1668028433397,MATH 278A,A00,098049,Holst; Michael J,8,0,10,2
1668028433843,MATH 278B,A00,098050,Cloninger; Alexander,10,0,10,0
1668028434268,MATH 278C,A00,098051,Nie; Jiawang,8,0,10,2
1668028434713,MATH 280B,A00,098052,Zheng; Tianyi,11,0,15,4
1668028435148,MATH 281B,A00,098053,Bradic; Jelena,4,0,15,11
1668028435577,MATH 282B,A00,098054,Arias-Castro; Ery,2,0,15,13
1668028436001,MATH 285,A00,098055,Fitzsimmons; Patrick J,0,0,15,17
1668028436436,MATH 287B,A00,098056,Arias-Castro; Ery,4,0,15,11
1668028436873,MATH 288,A00,098057,Agarwal; Pooja,9,0,10,1
1668028436873,MATH 288,B00,098058,Zhang; Danna,9,0,10,1
1668028436873,MATH 288,C00,098059,Williams; Ruth J,10,0,10,0
1668028437367,MATH 290B,A00,098060,Roberts; Justin Deritter,13,0,15,2
1668028437799,MATH 292,A00,098061,Belmont; Eva Kinoshita,10,0,10,0
1668028438224,MATH 295,A00,098062,Suk; Andrew Hoon,48,0,50,2
1668028438653,MATH 296,A00,098063,Novak; Jonathan I,20,0,20,0
1668028439077,MATH 297,001,098064,Gamst; Anthony Collins,9997,0,9999,2
1668028944459,COGS 205,A00,101395,Chiba; Andrea,19,0,20,1
1668028944888,COGS 210B,001,101404,Greene; Deanna Jacquelyn,9998,0,9999,1
1668028944888,COGS 210B,002,101417,Xia; Haijun,9999,0,9999,0
1668028944888,COGS 210B,003,101422,Nitz; Douglas A.,9999,0,9999,0
1668028944888,COGS 210B,004,101423,Hollan; James D.,9998,0,9999,1
1668028944888,COGS 210B,005,101424,Deak; Gedeon O.,9999,0,9999,0
1668028944888,COGS 210B,006,101425,Rossano; Federico,9999,0,9999,0
1668028945312,COGS 211B,A00,101427,Coulson; Seana M,9997,0,9999,2
1668028945748,COGS 220,A00,101428,Hollan; James D.,0,0,25,25
1668028946183,COGS 229,A00,101429,Dow; Steven P,18,0,25,7
1668028946607,COGS 230,A00,101430,Klemmer; Scott R,13,0,17,4
1668028947034,COGS 234,A00,101431,Xia; Haijun,5,0,25,20
1668028947460,COGS 260,A00,101432,Kiyonaga; Anastasia,20,0,25,5
1668028947460,COGS 260,B00,101433,Kirsh; David Joel,16,0,25,9
1668028947895,CSE 202,A00,102371,Impagliazzo; Russell,0,0,0,0
1668028948337,CSE 203B,A01,102373,Cheng; Chung Kuan,0,0,0,0
1668028948771,CSE 208,A00,102374,Micciancio; Daniele,0,0,0,0
1668028949225,CSE 209A,A00,112895,Impagliazzo; Russell,0,0,15,15
1668028949656,CSE 209B,A00,108005,Bellare; Mihir,0,0,0,0
1668028950079,CSE 210,A00,113163,Coblenz; Michael J,0,0,0,0
1668028950506,CSE 219,A00,106111,Dow; Steven P,0,0,20,20
1668028950935,CSE 221,A00,102376,Voelker; Geoffrey M.,0,0,0,0
1668028951358,CSE 224,A01,102378,Porter; George M,0,0,0,0
1668028951783,CSE 229A,A00,102379,Savage; Stefan,0,0,0,0
1668028952209,CSE 229C,A00,102380,Munyaka; Imani N. S.,0,0,0,0
1668028952654,CSE 232B,A00,102382,Deutsch; Alin Bernard,0,0,0,0
1668028953088,CSE 234,A01,112904,Kumar; Arun Kumar,0,0,0,0
1668028953515,CSE 237A,A00,102383,Rosing; Tajana Simunic,0,0,0,0
1668028953938,CSE 239A,A00,102384,Deutsch; Alin Bernard,0,0,0,0
1668028954362,CSE 239B,A00,102385,Polikarpova; Nadezhda,0,0,0,0
1668028954794,CSE 240A,A00,102386,Pannuto; Patrick William,0,0,0,0
1668028955222,CSE 240B,A00,102387,Zhao; Jishen,0,0,0,0
1668028955666,CSE 241A,A00,106406,Kang; Mingu,0,0,0,0
1668028956099,CSE 249B,A00,102388,Kahng; Andrew Byun,0,0,8,8
1668028956523,CSE 251B,A01,102392,Cottrell; Garrison W,0,0,0,0
1668028956523,CSE 251B,A02,102393,Cottrell; Garrison W,0,0,0,0
1668028956960,CSE 252B,A00,102394,Ochoa; Benjamin Lawrence,0,0,0,0
1668028957383,CSE 257,A01,102396,Gao; Sicun,0,0,0,0
1668028957809,CSE 272,A00,102397,Li; Tzumao,0,0,0,0
1668028958250,CSE 274,A00,111323,Chern; Albert Ren-Haur,0,0,0,0
1668028958674,CSE 282,A00,102398,Pevzner; Pavel Arkadjevich,0,0,0,0
1668028959107,CSE 284,A00,114175,Gymrek; Melissa Ann,0,0,0,0
1668028959531,CSE 290,A00,102399,Chandraker; Manmohan Krishna,0,0,0,0
1668028959531,CSE 290,B00,102400,Vaccaro; Kristen Marie,0,0,25,25
1668028959531,CSE 290,C00,102414,Pannuto; Patrick William,0,0,25,25
1668028959531,CSE 290,D00,102427,Pevzner; Pavel Arkadjevich,0,0,0,0
1668028959531,CSE 290,E00,102429,Zhao; Jishen,0,0,0,0
1668028959531,CSE 290,F00,102436,Tullsen; Dean Michael,0,0,0,0
1668028959531,CSE 290,G00,102440,Christensen; Henrik I,0,0,20,20
1668028959961,CSE 291,A00,102443,Su; Hao,0,0,0,0
1668028959961,CSE 291,B00,102448,Polikarpova; Nadezhda,0,0,0,0
1668028959961,CSE 291,C00,102453,Vaccaro; Kristen Marie,0,0,0,0
1668028959961,CSE 291,D00,111343,Savage; Stefan,0,0,0,0
1668028959961,CSE 291,E00,116474,Claffy; Kimberly Claire,0,0,0,0
1668028959961,CSE 291,F00,116479,Pasquale; Joseph,0,0,0,0
1668028960393,CSE 293,001,119111,Bafna; Vineet,9999,0,9999,0
1668028960393,CSE 293,002,119118,Bellare; Mihir,9999,0,9999,0
1668028960393,CSE 293,003,119122,Berg-Kirkpatrick; Taylor D,9999,0,9999,0
1668028960393,CSE 293,004,119135,Christensen; Henrik I,9999,0,9999,0
1668028960393,CSE 293,005,119142,Cottrell; Garrison W,9999,0,9999,0
1668028960393,CSE 293,006,119146,Deutsch; Alin Bernard,9999,0,9999,0
1668028960393,CSE 293,007,119159,Esmaeilzadeh; Hadi,9999,0,9999,0
1668028960393,CSE 293,008,119166,Freund; Yoav,9999,0,9999,0
1668028960393,CSE 293,009,119170,Griswold; William G.,9999,0,9999,0
1668028960393,CSE 293,010,119183,Gymrek; Melissa Ann,9999,0,9999,0
1668028960393,CSE 293,011,119190,Heninger; Nadia A,9999,0,9999,0
1668028960393,CSE 293,012,119230,Impagliazzo; Russell,9999,0,9999,0
1668028960393,CSE 293,013,119232,Jhala; Ranjit,9999,0,9999,0
1668028960393,CSE 293,014,119233,Kahng; Andrew Byun,9999,0,9999,0
1668028960393,CSE 293,015,119298,Kane; Daniel Mertz,9999,0,9999,0
1668028960393,CSE 293,016,119299,Kriegman; David J,9999,0,9999,0
1668028960393,CSE 293,017,119300,Kumar; Arun Kumar,9999,0,9999,0
1668028960393,CSE 293,018,119301,Lerner; Sorin,9999,0,9999,0
1668028960393,CSE 293,019,119302,Lovett; Shachar,9999,0,9999,0
1668028960393,CSE 293,020,119303,McAuley; Julian John,9999,0,9999,0
1668028960393,CSE 293,021,119304,Micciancio; Daniele,9999,0,9999,0
1668028960393,CSE 293,022,119367,Orailoglu; Alex,9999,0,9999,0
1668028960393,CSE 293,023,119382,Paturi; Ramamohan,9999,0,9999,0
1668028960393,CSE 293,024,119404,Polikarpova; Nadezhda,9999,0,9999,0
1668028960393,CSE 293,025,119406,Politz; Joseph Gibbs,9999,0,9999,0
1668028960393,CSE 293,026,119411,Porter; George M,9999,0,9999,0
1668028960393,CSE 293,027,119414,Porter; Leonard Emerson,9999,0,9999,0
1668028960393,CSE 293,028,119416,Ramamoorthi; Ravi,9999,0,9999,0
1668028960393,CSE 293,029,119417,Sahoo; Debashis,9999,0,9999,0
1668028960393,CSE 293,030,119420,Saul; Lawrence,9999,0,9999,0
1668028960393,CSE 293,031,119421,Savage; Stefan,9999,0,9999,0
1668028960393,CSE 293,032,119425,Schulze; Jurgen P.,9999,0,9999,0
1668028960393,CSE 293,033,119426,Snoeren; Alex C.,9999,0,9999,0
1668028960393,CSE 293,034,119428,Shang; Jingbo,9999,0,9999,0
1668028960393,CSE 293,035,119430,Stefan; Deian,9999,0,9999,0
1668028960393,CSE 293,036,119431,Su; Hao,9999,0,9999,0
1668028960393,CSE 293,037,119433,Swanson; Steven James,9999,0,9999,0
1668028960393,CSE 293,038,119435,Tullsen; Dean Michael,9999,0,9999,0
1668028960393,CSE 293,039,119483,Voelker; Geoffrey M.,9999,0,9999,0
1668028960393,CSE 293,040,119537,Zhao; Jishen,9999,0,9999,0
1668028960393,CSE 293,041,119538,Zhou; Yuan-Yuan,9999,0,9999,0
1668028960393,CSE 293,042,119539,Gao; Sicun,9999,0,9999,0
1668028960393,CSE 293,043,119540,Weibel; Nadir,9999,0,9999,0
1668028960393,CSE 293,044,119541,Gupta; Rajesh K.,9999,0,9999,0
1668028960393,CSE 293,045,126410,Vaccaro; Kristen Marie,9999,0,9999,0
1668028960393,CSE 293,046,126411,Klemke; Richard,9999,0,9999,0
1668028960887,CSE 294,A00,102459,Voelker; Geoffrey M.,0,0,0,0
1668028960887,CSE 294,B00,111322,Orailoglu; Alex,0,0,0,0
1668028961319,DSE 201,A00,096914,Deutsch; Alin Bernard,30,0,30,0
1668028961752,DSE 210,A00,096915,Dasgupta; Sanjoy,30,0,30,0
1668028962175,DSE 260A,A00,096916,Altintas De Callaf; Ilkay,30,0,30,0
1668028962636,ECE 200,001,103586,Antipa; Nicholas A,9999,0,9999,0
1668028962636,ECE 200,002,103587,Atanasov; Nikolay A.,9999,0,9999,0
1668028962636,ECE 200,003,103588,Bharadia; Dinesh,9999,0,9999,0
1668028962636,ECE 200,004,103589,Cheng; Chung Kuan,9999,0,9999,0
1668028962636,ECE 200,005,103590,Cosman; Pamela C.,9999,0,9999,0
1668028962636,ECE 200,006,103591,Dayeh; Shadi Ahmad,9999,0,9999,0
1668028962636,ECE 200,007,103592,Fainman; Yeshaiahu,9999,0,9999,0
1668028962636,ECE 200,008,103593,Ford; Joseph Earl,9999,0,9999,0
1668028962636,ECE 200,009,103594,Franceschetti; Massimo,9999,0,9999,0
1668028962636,ECE 200,010,103595,Fullerton; Eric E,9999,0,9999,0
1668028962636,ECE 200,011,103596,Galton; Ian A,9999,0,9999,0
1668028962636,ECE 200,012,103597,Gilja; Vikash,9999,0,9999,0
1668028962636,ECE 200,013,103598,Hall; Drew A.,9999,0,9999,0
1668028962636,ECE 200,014,103599,Hsueh; Tzu-Chien,9999,0,9999,0
1668028962636,ECE 200,015,103600,Javidi; Tara,9999,0,9999,0
1668028962636,ECE 200,016,103601,Kahng; Andrew Byun,9999,0,9999,0
1668028962636,ECE 200,017,103602,Kim; Young-Han,9999,0,9999,0
1668028962636,ECE 200,018,103603,Koushanfar; Farinaz,9999,0,9999,0
1668028962636,ECE 200,019,103604,Kuzum; Duygu,9999,0,9999,0
1668028962636,ECE 200,020,103605,Le; Hanh-Phuc,9999,0,9999,0
1668028962636,ECE 200,021,103606,Lin; Bill,9999,0,9999,0
1668028962636,ECE 200,022,103607,Liu; Zhaowei,9998,0,9999,1
1668028962636,ECE 200,023,103608,Lo; Yu-Hwa,9999,0,9999,0
1668028962636,ECE 200,024,103609,Lomakin; Vitaliy,9999,0,9999,0
1668028962636,ECE 200,025,103610,Mercier; Patrick Philip,9999,0,9999,0
1668028962636,ECE 200,026,103611,Meyer; Florian,9999,0,9999,0
1668028962636,ECE 200,027,103612,Milstein; Laurence B.,9999,0,9999,0
1668028962636,ECE 200,028,103613,Mir Arabbaygi; Siavash,9999,0,9999,0
1668028962636,ECE 200,029,103614,Mookherjea; Shayan,9999,0,9999,0
1668028962636,ECE 200,030,103615,Morris; Karcher William,9999,0,9999,0
1668028962636,ECE 200,031,103616,Ng; Tse Nga,9999,0,9999,0
1668028962636,ECE 200,032,103617,Nguyen; Truong Quang,9999,0,9999,0
1668028962636,ECE 200,033,103618,Nomura; Kenji,9999,0,9999,0
1668028962636,ECE 200,034,103619,Orlitsky; Alon,9999,0,9999,0
1668028962636,ECE 200,035,103620,Pal; Piya,9999,0,9999,0
1668028962636,ECE 200,036,103621,Papen; George C.,9999,0,9999,0
1668028962636,ECE 200,037,103622,Radic; Stojan,9999,0,9999,0
1668028962636,ECE 200,038,103623,Rao; Bhaskar D.,9999,0,9999,0
1668028962636,ECE 200,039,103624,Rao; Ramesh R,9999,0,9999,0
1668028962636,ECE 200,040,103625,Rebeiz; Gabriel,9999,0,9999,0
1668028962636,ECE 200,041,103626,Sanford; John R,9999,0,9999,0
1668028962636,ECE 200,042,103627,Siegel; Paul H.,9999,0,9999,0
1668028962636,ECE 200,043,103628,Sievenpiper; Daniel F.,9999,0,9999,0
1668028962636,ECE 200,044,103629,Sworder; David D.,9999,0,9999,0
1668028962636,ECE 200,045,103630,Taur; Yuan,9999,0,9999,0
1668028962636,ECE 200,046,103631,Touri; Behrouz,9999,0,9999,0
1668028962636,ECE 200,047,103632,Trivedi; Mohan M.,9999,0,9999,0
1668028962636,ECE 200,048,103633,Vasconcelos; Nuno,9999,0,9999,0
1668028962636,ECE 200,049,103634,Wang; Xiaolong,9999,0,9999,0
1668028962636,ECE 200,050,103635,Xie; Pengtao,9999,0,9999,0
1668028962636,ECE 200,051,103636,Yip; Michael,9999,0,9999,0
1668028962636,ECE 200,052,103637,Zeger; Kenneth A.,999,0,999,0
1668028962636,ECE 200,053,103638,Zhang; Xinyu,9999,0,9999,0
1668028962636,ECE 200,054,103639,Turakhia; Yatish Girish,9999,0,9999,0
1668028962636,ECE 200,055,103640,Kang; Mingu,9999,0,9999,0
1668028962636,ECE 200,056,103641,Shi; Yuanyuan,9999,0,9999,0
1668028962636,ECE 200,057,103642,Wang; Edward Jay,9999,0,9999,0
1668028962636,ECE 200,058,103643,Zheng; Yang,9999,0,9999,0
1668028963063,ECE 202,A00,103644,Kuzum; Duygu,0,0,0,0
1668028963498,ECE 212BN,A00,103646,Ng; Tse Nga,0,0,0,0
1668028963923,ECE 221,A00,111493,Staff,0,0,0,0
1668028964352,ECE 222B,A00,103647,Lomakin; Vitaliy,0,0,0,0
1668028964775,ECE 230B,A00,103648,Taur; Yuan,0,0,0,0
1668028965212,ECE 238B,A00,103649,Garay; Javier,0,0,0,0
1668028965637,ECE 240B,A00,112900,Fainman; Yeshaiahu,0,0,0,0
1668028966062,ECE 247A,A00,103650,Jokerst; Jesse Vincent,0,0,0,0
1668028966486,ECE 247B,A00,103651,Wang; Joseph,0,0,0,0
1668028966917,ECE 250,A00,103652,Siegel; Paul H.,0,0,0,0
1668028967346,ECE 251A,A00,103654,Rao; Bhaskar D.,0,0,0,0
1668028967770,ECE 257B,A00,103655,Bharadia; Dinesh,0,0,0,0
1668028968200,ECE 258A,A00,103656,Milstein; Laurence B.,0,0,0,0
1668028968624,ECE 260B,A00,103658,Kang; Mingu,0,0,0,0
1668028969047,ECE 264A,A00,103659,Galton; Ian A,0,0,0,0
1668028969475,ECE 265A,A00,103661,Gudem; Prasad S.S.,0,0,0,0
1668028969899,ECE 265D,A00,103662,Gudem; Prasad S.S.,0,0,0,0
1668028970334,ECE 268,A00,103663,Koushanfar; Farinaz,0,0,0,0
1668028970765,ECE 269,A01,103665,Pal; Piya,0,0,0,0
1668028971199,ECE 271B,A00,103666,Vasconcelos; Manuela,0,0,0,0
1668028971623,ECE 276A,A00,103667,Atanasov; Nikolay A.,0,0,0,0
1668028972047,ECE 277,A00,103668,An; Cheolhong,0,0,0,0
1668028972470,ECE 279,A00,117947,Hall; Drew A.,0,0,0,0
1668028973328,ECE 283,A00,103670,Hsueh; Tzu-Chien,0,0,0,0
1668028973765,ECE 284,A00,103671,Turakhia; Yatish Girish,0,0,0,0
1668028974194,ECE 285,A00,103672,Zheng; Yang,0,0,0,0
1668028974194,ECE 285,B00,103673,Sworder; David D.,0,0,0,0
1668028974628,ECE 287,A00,103676,Javidi; Tara,0,0,0,0
1668028975060,MATH 200B,A00,098023,Salehi Golsefidy; Alireza,13,0,15,2
1668028975506,MATH 202B,A00,098024,Rhoades; Brendon Patrick,10,0,15,5
1668028975932,MATH 203B,A00,098025,Oprea; Dragos N.,11,0,15,4
1668028976358,MATH 204B,A00,098026,Sorensen; Claus M,14,0,15,1
1668028976790,MATH 208,A00,098027,Izadi; Elham,7,0,10,3
1668028977214,MATH 209,A00,098028,Pollack; Aaron,10,0,10,0
1668028977648,MATH 211A,A00,112919,Rogalski; Daniel,9,0,10,1
1668028978144,MATH 211B,A00,112920,Seward; Brandon M.,9,0,10,1
1668028978570,MATH 218,A00,098029,Li; Bo,10,0,10,0
1668028978998,MATH 220B,A00,098030,Novak; Jonathan I,13,0,15,2
1668028979421,MATH 221A,A00,098031,Ebenfelt; Peter F,13,0,15,2
1668028979846,MATH 231B,A00,098032,Zlatos; Andrej,12,0,15,3
1668028980290,MATH 240B,A00,098033,Ni; Lei,9,0,15,6
1668028980716,MATH 243,A00,098034,Jekel; David Andrew,10,0,10,0
1668028981258,MATH 245A,A00,098035,Nie; Jiawang,0,0,15,16
1668028981684,MATH 248,A00,098036,Bejenaru; Ioan,10,0,10,0
1668028982112,MATH 250B,A00,098037,Spolaor; Luca,14,0,15,1
1668028982547,MATH 258,A00,098038,Ni; Lei,10,0,10,0
1668028982983,MATH 264B,A00,098041,Rhoades; Brendon Patrick,10,0,15,5
1668028983405,MATH 268,A00,098042,Buss; Samuel R,10,0,10,0
1668028983829,MATH 269,A00,098043,Rhoades; Brendon Patrick,10,0,10,0
1668028984263,MATH 270B,A00,098044,Li; Bo,11,0,15,4
1668028984692,MATH 272B,A00,098045,Holst; Michael J,13,0,15,2
1668028985130,MATH 273A,A00,098046,Tian; Xiaochuan,10,0,15,5
1668028985558,MATH 275,A01,098048,Tian; Xiaochuan,6,0,10,4
1668028985998,MATH 278A,A00,098049,Holst; Michael J,8,0,10,2
1668028986423,MATH 278B,A00,098050,Cloninger; Alexander,10,0,10,0
1668028986853,MATH 278C,A00,098051,Nie; Jiawang,8,0,10,2
1668028987282,MATH 280B,A00,098052,Zheng; Tianyi,11,0,15,4
1668028987713,MATH 281B,A00,098053,Bradic; Jelena,3,0,15,12
1668028988135,MATH 282B,A00,098054,Arias-Castro; Ery,2,0,15,13
1668028988558,MATH 285,A00,098055,Fitzsimmons; Patrick J,0,0,15,17
1668028988980,MATH 287B,A00,098056,Arias-Castro; Ery,4,0,15,11
1668028989415,MATH 288,A00,098057,Agarwal; Pooja,9,0,10,1
1668028989415,MATH 288,B00,098058,Zhang; Danna,9,0,10,1
1668028989415,MATH 288,C00,098059,Williams; Ruth J,10,0,10,0
1668028989841,MATH 290B,A00,098060,Roberts; Justin Deritter,13,0,15,2
1668028990269,MATH 292,A00,098061,Belmont; Eva Kinoshita,10,0,10,0
1668028990702,MATH 295,A00,098062,Suk; Andrew Hoon,48,0,50,2
1668028991131,MATH 296,A00,098063,Novak; Jonathan I,20,0,20,0
1668028991571,MATH 297,001,098064,Gamst; Anthony Collins,9997,0,9999,2
1668029499696,COGS 205,A00,101395,Chiba; Andrea,19,0,20,1
1668029500120,COGS 210B,001,101404,Greene; Deanna Jacquelyn,9998,0,9999,1
1668029500120,COGS 210B,002,101417,Xia; Haijun,9999,0,9999,0
1668029500120,COGS 210B,003,101422,Nitz; Douglas A.,9999,0,9999,0
1668029500120,COGS 210B,004,101423,Hollan; James D.,9998,0,9999,1
1668029500120,COGS 210B,005,101424,Deak; Gedeon O.,9999,0,9999,0
1668029500120,COGS 210B,006,101425,Rossano; Federico,9999,0,9999,0
1668029500544,COGS 211B,A00,101427,Coulson; Seana M,9997,0,9999,2
1668029500973,COGS 220,A00,101428,Hollan; James D.,0,0,25,25
1668029501410,COGS 229,A00,101429,Dow; Steven P,18,0,25,7
1668029501837,COGS 230,A00,101430,Klemmer; Scott R,13,0,17,4
1668029502286,COGS 234,A00,101431,Xia; Haijun,5,0,25,20
1668029502714,COGS 260,A00,101432,Kiyonaga; Anastasia,20,0,25,5
1668029502714,COGS 260,B00,101433,Kirsh; David Joel,16,0,25,9
1668029503151,CSE 202,A00,102371,Impagliazzo; Russell,0,0,0,0
1668029503575,CSE 203B,A01,102373,Cheng; Chung Kuan,0,0,0,0
1668029504002,CSE 208,A00,102374,Micciancio; Daniele,0,0,0,0
1668029504429,CSE 209A,A00,112895,Impagliazzo; Russell,0,0,15,15
1668029504862,CSE 209B,A00,108005,Bellare; Mihir,0,0,0,0
1668029505298,CSE 210,A00,113163,Coblenz; Michael J,0,0,0,0
1668029505737,CSE 219,A00,106111,Dow; Steven P,0,0,20,20
1668029506181,CSE 221,A00,102376,Voelker; Geoffrey M.,0,0,0,0
1668029506605,CSE 224,A01,102378,Porter; George M,0,0,0,0
1668029507052,CSE 229A,A00,102379,Savage; Stefan,0,0,0,0
1668029507476,CSE 229C,A00,102380,Munyaka; Imani N. S.,0,0,0,0
1668029507920,CSE 232B,A00,102382,Deutsch; Alin Bernard,0,0,0,0
1668029508356,CSE 234,A01,112904,Kumar; Arun Kumar,0,0,0,0
1668029508781,CSE 237A,A00,102383,Rosing; Tajana Simunic,0,0,0,0
1668029509216,CSE 239A,A00,102384,Deutsch; Alin Bernard,0,0,0,0
1668029509741,CSE 239B,A00,102385,Polikarpova; Nadezhda,0,0,0,0
1668029510169,CSE 240A,A00,102386,Pannuto; Patrick William,0,0,0,0
1668029510599,CSE 240B,A00,102387,Zhao; Jishen,0,0,0,0
1668029511040,CSE 241A,A00,106406,Kang; Mingu,0,0,0,0
1668029511462,CSE 249B,A00,102388,Kahng; Andrew Byun,0,0,8,8
1668029511903,CSE 251B,A01,102392,Cottrell; Garrison W,0,0,0,0
1668029511903,CSE 251B,A02,102393,Cottrell; Garrison W,0,0,0,0
1668029512332,CSE 252B,A00,102394,Ochoa; Benjamin Lawrence,0,0,0,0
1668029512770,CSE 257,A01,102396,Gao; Sicun,0,0,0,0
1668029513195,CSE 272,A00,102397,Li; Tzumao,0,0,0,0
1668029513618,CSE 274,A00,111323,Chern; Albert Ren-Haur,0,0,0,0
1668029514043,CSE 282,A00,102398,Pevzner; Pavel Arkadjevich,0,0,0,0
1668029514471,CSE 284,A00,114175,Gymrek; Melissa Ann,0,0,0,0
1668029514906,CSE 290,A00,102399,Chandraker; Manmohan Krishna,0,0,0,0
1668029514906,CSE 290,B00,102400,Vaccaro; Kristen Marie,0,0,25,25
1668029514906,CSE 290,C00,102414,Pannuto; Patrick William,0,0,25,25
1668029514906,CSE 290,D00,102427,Pevzner; Pavel Arkadjevich,0,0,0,0
1668029514906,CSE 290,E00,102429,Zhao; Jishen,0,0,0,0
1668029514906,CSE 290,F00,102436,Tullsen; Dean Michael,0,0,0,0
1668029514906,CSE 290,G00,102440,Christensen; Henrik I,0,0,20,20
1668029515338,CSE 291,A00,102443,Su; Hao,0,0,0,0
1668029515338,CSE 291,B00,102448,Polikarpova; Nadezhda,0,0,0,0
1668029515338,CSE 291,C00,102453,Vaccaro; Kristen Marie,0,0,0,0
1668029515338,CSE 291,D00,111343,Savage; Stefan,0,0,0,0
1668029515338,CSE 291,E00,116474,Claffy; Kimberly Claire,0,0,0,0
1668029515338,CSE 291,F00,116479,Pasquale; Joseph,0,0,0,0
1668029515806,CSE 293,001,119111,Bafna; Vineet,9999,0,9999,0
1668029515806,CSE 293,002,119118,Bellare; Mihir,9999,0,9999,0
1668029515806,CSE 293,003,119122,Berg-Kirkpatrick; Taylor D,9999,0,9999,0
1668029515806,CSE 293,004,119135,Christensen; Henrik I,9999,0,9999,0
1668029515806,CSE 293,005,119142,Cottrell; Garrison W,9999,0,9999,0
1668029515806,CSE 293,006,119146,Deutsch; Alin Bernard,9999,0,9999,0
1668029515806,CSE 293,007,119159,Esmaeilzadeh; Hadi,9999,0,9999,0
1668029515806,CSE 293,008,119166,Freund; Yoav,9999,0,9999,0
1668029515806,CSE 293,009,119170,Griswold; William G.,9999,0,9999,0
1668029515806,CSE 293,010,119183,Gymrek; Melissa Ann,9999,0,9999,0
1668029515806,CSE 293,011,119190,Heninger; Nadia A,9999,0,9999,0
1668029515806,CSE 293,012,119230,Impagliazzo; Russell,9999,0,9999,0
1668029515806,CSE 293,013,119232,Jhala; Ranjit,9999,0,9999,0
1668029515806,CSE 293,014,119233,Kahng; Andrew Byun,9999,0,9999,0
1668029515806,CSE 293,015,119298,Kane; Daniel Mertz,9999,0,9999,0
1668029515806,CSE 293,016,119299,Kriegman; David J,9999,0,9999,0
1668029515806,CSE 293,017,119300,Kumar; Arun Kumar,9999,0,9999,0
1668029515806,CSE 293,018,119301,Lerner; Sorin,9999,0,9999,0
1668029515806,CSE 293,019,119302,Lovett; Shachar,9999,0,9999,0
1668029515806,CSE 293,020,119303,McAuley; Julian John,9999,0,9999,0
1668029515806,CSE 293,021,119304,Micciancio; Daniele,9999,0,9999,0
1668029515806,CSE 293,022,119367,Orailoglu; Alex,9999,0,9999,0
1668029515806,CSE 293,023,119382,Paturi; Ramamohan,9999,0,9999,0
1668029515806,CSE 293,024,119404,Polikarpova; Nadezhda,9999,0,9999,0
1668029515806,CSE 293,025,119406,Politz; Joseph Gibbs,9999,0,9999,0
1668029515806,CSE 293,026,119411,Porter; George M,9999,0,9999,0
1668029515806,CSE 293,027,119414,Porter; Leonard Emerson,9999,0,9999,0
1668029515806,CSE 293,028,119416,Ramamoorthi; Ravi,9999,0,9999,0
1668029515806,CSE 293,029,119417,Sahoo; Debashis,9999,0,9999,0
1668029515806,CSE 293,030,119420,Saul; Lawrence,9999,0,9999,0
1668029515806,CSE 293,031,119421,Savage; Stefan,9999,0,9999,0
1668029515806,CSE 293,032,119425,Schulze; Jurgen P.,9999,0,9999,0
1668029515806,CSE 293,033,119426,Snoeren; Alex C.,9999,0,9999,0
1668029515806,CSE 293,034,119428,Shang; Jingbo,9999,0,9999,0
1668029515806,CSE 293,035,119430,Stefan; Deian,9999,0,9999,0
1668029515806,CSE 293,036,119431,Su; Hao,9999,0,9999,0
1668029515806,CSE 293,037,119433,Swanson; Steven James,9999,0,9999,0
1668029515806,CSE 293,038,119435,Tullsen; Dean Michael,9999,0,9999,0
1668029515806,CSE 293,039,119483,Voelker; Geoffrey M.,9999,0,9999,0
1668029515806,CSE 293,040,119537,Zhao; Jishen,9999,0,9999,0
1668029515806,CSE 293,041,119538,Zhou; Yuan-Yuan,9999,0,9999,0
1668029515806,CSE 293,042,119539,Gao; Sicun,9999,0,9999,0
1668029515806,CSE 293,043,119540,Weibel; Nadir,9999,0,9999,0
1668029515806,CSE 293,044,119541,Gupta; Rajesh K.,9999,0,9999,0
1668029515806,CSE 293,045,126410,Vaccaro; Kristen Marie,9999,0,9999,0
1668029515806,CSE 293,046,126411,Klemke; Richard,9999,0,9999,0
1668029516242,CSE 294,A00,102459,Voelker; Geoffrey M.,0,0,0,0
1668029516242,CSE 294,B00,111322,Orailoglu; Alex,0,0,0,0
1668029516671,DSE 201,A00,096914,Deutsch; Alin Bernard,30,0,30,0
1668029517101,DSE 210,A00,096915,Dasgupta; Sanjoy,30,0,30,0
1668029517538,DSE 260A,A00,096916,Altintas De Callaf; Ilkay,30,0,30,0
1668029517966,ECE 200,001,103586,Antipa; Nicholas A,9999,0,9999,0
1668029517966,ECE 200,002,103587,Atanasov; Nikolay A.,9999,0,9999,0
1668029517966,ECE 200,003,103588,Bharadia; Dinesh,9999,0,9999,0
1668029517966,ECE 200,004,103589,Cheng; Chung Kuan,9999,0,9999,0
1668029517966,ECE 200,005,103590,Cosman; Pamela C.,9999,0,9999,0
1668029517966,ECE 200,006,103591,Dayeh; Shadi Ahmad,9999,0,9999,0
1668029517966,ECE 200,007,103592,Fainman; Yeshaiahu,9999,0,9999,0
1668029517966,ECE 200,008,103593,Ford; Joseph Earl,9999,0,9999,0
1668029517966,ECE 200,009,103594,Franceschetti; Massimo,9999,0,9999,0
1668029517966,ECE 200,010,103595,Fullerton; Eric E,9999,0,9999,0
1668029517966,ECE 200,011,103596,Galton; Ian A,9999,0,9999,0
1668029517966,ECE 200,012,103597,Gilja; Vikash,9999,0,9999,0
1668029517966,ECE 200,013,103598,Hall; Drew A.,9999,0,9999,0
1668029517966,ECE 200,014,103599,Hsueh; Tzu-Chien,9999,0,9999,0
1668029517966,ECE 200,015,103600,Javidi; Tara,9999,0,9999,0
1668029517966,ECE 200,016,103601,Kahng; Andrew Byun,9999,0,9999,0
1668029517966,ECE 200,017,103602,Kim; Young-Han,9999,0,9999,0
1668029517966,ECE 200,018,103603,Koushanfar; Farinaz,9999,0,9999,0
1668029517966,ECE 200,019,103604,Kuzum; Duygu,9999,0,9999,0
1668029517966,ECE 200,020,103605,Le; Hanh-Phuc,9999,0,9999,0
1668029517966,ECE 200,021,103606,Lin; Bill,9999,0,9999,0
1668029517966,ECE 200,022,103607,Liu; Zhaowei,9998,0,9999,1
1668029517966,ECE 200,023,103608,Lo; Yu-Hwa,9999,0,9999,0
1668029517966,ECE 200,024,103609,Lomakin; Vitaliy,9999,0,9999,0
1668029517966,ECE 200,025,103610,Mercier; Patrick Philip,9999,0,9999,0
1668029517966,ECE 200,026,103611,Meyer; Florian,9999,0,9999,0
1668029517966,ECE 200,027,103612,Milstein; Laurence B.,9999,0,9999,0
1668029517966,ECE 200,028,103613,Mir Arabbaygi; Siavash,9999,0,9999,0
1668029517966,ECE 200,029,103614,Mookherjea; Shayan,9999,0,9999,0
1668029517966,ECE 200,030,103615,Morris; Karcher William,9999,0,9999,0
1668029517966,ECE 200,031,103616,Ng; Tse Nga,9999,0,9999,0
1668029517966,ECE 200,032,103617,Nguyen; Truong Quang,9999,0,9999,0
1668029517966,ECE 200,033,103618,Nomura; Kenji,9999,0,9999,0
1668029517966,ECE 200,034,103619,Orlitsky; Alon,9999,0,9999,0
1668029517966,ECE 200,035,103620,Pal; Piya,9999,0,9999,0
1668029517966,ECE 200,036,103621,Papen; George C.,9999,0,9999,0
1668029517966,ECE 200,037,103622,Radic; Stojan,9999,0,9999,0
1668029517966,ECE 200,038,103623,Rao; Bhaskar D.,9999,0,9999,0
1668029517966,ECE 200,039,103624,Rao; Ramesh R,9999,0,9999,0
1668029517966,ECE 200,040,103625,Rebeiz; Gabriel,9999,0,9999,0
1668029517966,ECE 200,041,103626,Sanford; John R,9999,0,9999,0
1668029517966,ECE 200,042,103627,Siegel; Paul H.,9999,0,9999,0
1668029517966,ECE 200,043,103628,Sievenpiper; Daniel F.,9999,0,9999,0
1668029517966,ECE 200,044,103629,Sworder; David D.,9999,0,9999,0
1668029517966,ECE 200,045,103630,Taur; Yuan,9999,0,9999,0
1668029517966,ECE 200,046,103631,Touri; Behrouz,9999,0,9999,0
1668029517966,ECE 200,047,103632,Trivedi; Mohan M.,9999,0,9999,0
1668029517966,ECE 200,048,103633,Vasconcelos; Nuno,9999,0,9999,0
1668029517966,ECE 200,049,103634,Wang; Xiaolong,9999,0,9999,0
1668029517966,ECE 200,050,103635,Xie; Pengtao,9999,0,9999,0
1668029517966,ECE 200,051,103636,Yip; Michael,9999,0,9999,0
1668029517966,ECE 200,052,103637,Zeger; Kenneth A.,999,0,999,0
1668029517966,ECE 200,053,103638,Zhang; Xinyu,9999,0,9999,0
1668029517966,ECE 200,054,103639,Turakhia; Yatish Girish,9999,0,9999,0
1668029517966,ECE 200,055,103640,Kang; Mingu,9999,0,9999,0
1668029517966,ECE 200,056,103641,Shi; Yuanyuan,9999,0,9999,0
1668029517966,ECE 200,057,103642,Wang; Edward Jay,9999,0,9999,0
1668029517966,ECE 200,058,103643,Zheng; Yang,9999,0,9999,0
1668029518415,ECE 202,A00,103644,Kuzum; Duygu,0,0,0,0
1668029518845,ECE 212BN,A00,103646,Ng; Tse Nga,0,0,0,0
1668029519272,ECE 221,A00,111493,Staff,0,0,0,0
1668029519706,ECE 222B,A00,103647,Lomakin; Vitaliy,0,0,0,0
1668029520134,ECE 230B,A00,103648,Taur; Yuan,0,0,0,0
1668029520560,ECE 238B,A00,103649,Garay; Javier,0,0,0,0
1668029521007,ECE 240B,A00,112900,Fainman; Yeshaiahu,0,0,0,0
1668029521435,ECE 247A,A00,103650,Jokerst; Jesse Vincent,0,0,0,0
1668029521872,ECE 247B,A00,103651,Wang; Joseph,0,0,0,0
1668029522308,ECE 250,A00,103652,Siegel; Paul H.,0,0,0,0
1668029522742,ECE 251A,A00,103654,Rao; Bhaskar D.,0,0,0,0
1668029523170,ECE 257B,A00,103655,Bharadia; Dinesh,0,0,0,0
1668029523620,ECE 258A,A00,103656,Milstein; Laurence B.,0,0,0,0
1668029524050,ECE 260B,A00,103658,Kang; Mingu,0,0,0,0
1668029524492,ECE 264A,A00,103659,Galton; Ian A,0,0,0,0
1668029525040,ECE 265A,A00,103661,Gudem; Prasad S.S.,0,0,0,0
1668029525480,ECE 265D,A00,103662,Gudem; Prasad S.S.,0,0,0,0
1668029525920,ECE 268,A00,103663,Koushanfar; Farinaz,0,0,0,0
1668029526346,ECE 269,A01,103665,Pal; Piya,0,0,0,0
1668029526785,ECE 271B,A00,103666,Vasconcelos; Manuela,0,0,0,0
1668029527215,ECE 276A,A00,103667,Atanasov; Nikolay A.,0,0,0,0
1668029527656,ECE 277,A00,103668,An; Cheolhong,0,0,0,0
1668029528104,ECE 279,A00,117947,Hall; Drew A.,0,0,0,0
1668029528978,ECE 283,A00,103670,Hsueh; Tzu-Chien,0,0,0,0
1668029529406,ECE 284,A00,103671,Turakhia; Yatish Girish,0,0,0,0
1668029529838,ECE 285,A00,103672,Zheng; Yang,0,0,0,0
1668029529838,ECE 285,B00,103673,Sworder; David D.,0,0,0,0
1668029530283,ECE 287,A00,103676,Javidi; Tara,0,0,0,0
1668029530705,MATH 200B,A00,098023,Salehi Golsefidy; Alireza,13,0,15,2
1668029531133,MATH 202B,A00,098024,Rhoades; Brendon Patrick,10,0,15,5
1668029531557,MATH 203B,A00,098025,Oprea; Dragos N.,11,0,15,4
1668029531984,MATH 204B,A00,098026,Sorensen; Claus M,14,0,15,1
1668029532437,MATH 208,A00,098027,Izadi; Elham,7,0,10,3
1668029532872,MATH 209,A00,098028,Pollack; Aaron,10,0,10,0
1668029533302,MATH 211A,A00,112919,Rogalski; Daniel,9,0,10,1
1668029533727,MATH 211B,A00,112920,Seward; Brandon M.,9,0,10,1
1668029534179,MATH 218,A00,098029,Li; Bo,10,0,10,0
1668029534603,MATH 220B,A00,098030,Novak; Jonathan I,13,0,15,2
1668029535033,MATH 221A,A00,098031,Ebenfelt; Peter F,13,0,15,2
1668029535461,MATH 231B,A00,098032,Zlatos; Andrej,12,0,15,3
1668029535899,MATH 240B,A00,098033,Ni; Lei,9,0,15,6
1668029536324,MATH 243,A00,098034,Jekel; David Andrew,10,0,10,0
1668029536870,MATH 245A,A00,098035,Nie; Jiawang,0,0,15,16
1668029537309,MATH 248,A00,098036,Bejenaru; Ioan,10,0,10,0
1668029537731,MATH 250B,A00,098037,Spolaor; Luca,14,0,15,1
1668029538157,MATH 258,A00,098038,Ni; Lei,10,0,10,0
1668029538581,MATH 264B,A00,098041,Rhoades; Brendon Patrick,10,0,15,5
1668029539026,MATH 268,A00,098042,Buss; Samuel R,10,0,10,0
1668029539453,MATH 269,A00,098043,Rhoades; Brendon Patrick,10,0,10,0
1668029539876,MATH 270B,A00,098044,Li; Bo,11,0,15,4
1668029540309,MATH 272B,A00,098045,Holst; Michael J,13,0,15,2
1668029540751,MATH 273A,A00,098046,Tian; Xiaochuan,10,0,15,5
1668029541202,MATH 275,A01,098048,Tian; Xiaochuan,6,0,10,4
1668029541633,MATH 278A,A00,098049,Holst; Michael J,8,0,10,2
1668029542057,MATH 278B,A00,098050,Cloninger; Alexander,10,0,10,0
1668029542485,MATH 278C,A00,098051,Nie; Jiawang,8,0,10,2
1668029542929,MATH 280B,A00,098052,Zheng; Tianyi,11,0,15,4
1668029543365,MATH 281B,A00,098053,Bradic; Jelena,3,0,15,12
1668029543805,MATH 282B,A00,098054,Arias-Castro; Ery,2,0,15,13
1668029544247,MATH 285,A00,098055,Fitzsimmons; Patrick J,0,0,15,17
1668029544678,MATH 287B,A00,098056,Arias-Castro; Ery,4,0,15,11
1668029545103,MATH 288,A00,098057,Agarwal; Pooja,9,0,10,1
1668029545103,MATH 288,B00,098058,Zhang; Danna,9,0,10,1
1668029545103,MATH 288,C00,098059,Williams; Ruth J,10,0,10,0
1668029545527,MATH 290B,A00,098060,Roberts; Justin Deritter,13,0,15,2
1668029545952,MATH 292,A00,098061,Belmont; Eva Kinoshita,10,0,10,0
1668029546401,MATH 295,A00,098062,Suk; Andrew Hoon,48,0,50,2
1668029546843,MATH 296,A00,098063,Novak; Jonathan I,20,0,20,0
1668029547276,MATH 297,001,098064,Gamst; Anthony Collins,9997,0,9999,2
1668030063226,COGS 205,A00,101395,Chiba; Andrea,19,0,20,1
1668030063650,COGS 210B,001,101404,Greene; Deanna Jacquelyn,9998,0,9999,1
1668030063650,COGS 210B,002,101417,Xia; Haijun,9999,0,9999,0
1668030063650,COGS 210B,003,101422,Nitz; Douglas A.,9999,0,9999,0
1668030063650,COGS 210B,004,101423,Hollan; James D.,9998,0,9999,1
1668030063650,COGS 210B,005,101424,Deak; Gedeon O.,9999,0,9999,0
1668030063650,COGS 210B,006,101425,Rossano; Federico,9999,0,9999,0
1668030064082,COGS 211B,A00,101427,Coulson; Seana M,9997,0,9999,2
1668030064510,COGS 220,A00,101428,Hollan; James D.,0,0,25,25
1668030064962,COGS 229,A00,101429,Dow; Steven P,18,0,25,7
1668030065388,COGS 230,A00,101430,Klemmer; Scott R,13,0,17,4
1668030065821,COGS 234,A00,101431,Xia; Haijun,5,0,25,20
1668030066258,COGS 260,A00,101432,Kiyonaga; Anastasia,20,0,25,5
1668030066258,COGS 260,B00,101433,Kirsh; David Joel,16,0,25,9
1668030066690,CSE 202,A00,102371,Impagliazzo; Russell,0,0,0,0
1668030067112,CSE 203B,A01,102373,Cheng; Chung Kuan,0,0,0,0
1668030067546,CSE 208,A00,102374,Micciancio; Daniele,0,0,0,0
1668030067974,CSE 209A,A00,112895,Impagliazzo; Russell,0,0,15,15
1668030068406,CSE 209B,A00,108005,Bellare; Mihir,0,0,0,0
1668030068829,CSE 210,A00,113163,Coblenz; Michael J,0,0,0,0
1668030069250,CSE 219,A00,106111,Dow; Steven P,0,0,20,20
1668030069689,CSE 221,A00,102376,Voelker; Geoffrey M.,0,0,0,0
1668030070115,CSE 224,A01,102378,Porter; George M,0,0,0,0
1668030070544,CSE 229A,A00,102379,Savage; Stefan,0,0,0,0
1668030070972,CSE 229C,A00,102380,Munyaka; Imani N. S.,0,0,0,0
1668030071403,CSE 232B,A00,102382,Deutsch; Alin Bernard,0,0,0,0
1668030071831,CSE 234,A01,112904,Kumar; Arun Kumar,0,0,0,0
1668030072253,CSE 237A,A00,102383,Rosing; Tajana Simunic,0,0,0,0
1668030072679,CSE 239A,A00,102384,Deutsch; Alin Bernard,0,0,0,0
1668030073103,CSE 239B,A00,102385,Polikarpova; Nadezhda,0,0,0,0
1668030073542,CSE 240A,A00,102386,Pannuto; Patrick William,0,0,0,0
1668030073965,CSE 240B,A00,102387,Zhao; Jishen,0,0,0,0
1668030074390,CSE 241A,A00,106406,Kang; Mingu,0,0,0,0
1668030074813,CSE 249B,A00,102388,Kahng; Andrew Byun,0,0,8,8
1668030075239,CSE 251B,A01,102392,Cottrell; Garrison W,0,0,0,0
1668030075239,CSE 251B,A02,102393,Cottrell; Garrison W,0,0,0,0
1668030075664,CSE 252B,A00,102394,Ochoa; Benjamin Lawrence,0,0,0,0
1668030076095,CSE 257,A01,102396,Gao; Sicun,0,0,0,0
1668030076520,CSE 272,A00,102397,Li; Tzumao,0,0,0,0
1668030076943,CSE 274,A00,111323,Chern; Albert Ren-Haur,0,0,0,0
1668030077387,CSE 282,A00,102398,Pevzner; Pavel Arkadjevich,0,0,0,0
1668030077823,CSE 284,A00,114175,Gymrek; Melissa Ann,0,0,0,0
1668030078246,CSE 290,A00,102399,Chandraker; Manmohan Krishna,0,0,0,0
1668030078246,CSE 290,B00,102400,Vaccaro; Kristen Marie,0,0,25,25
1668030078246,CSE 290,C00,102414,Pannuto; Patrick William,0,0,25,25
1668030078246,CSE 290,D00,102427,Pevzner; Pavel Arkadjevich,0,0,0,0
1668030078246,CSE 290,E00,102429,Zhao; Jishen,0,0,0,0
1668030078246,CSE 290,F00,102436,Tullsen; Dean Michael,0,0,0,0
1668030078246,CSE 290,G00,102440,Christensen; Henrik I,0,0,20,20
1668030078669,CSE 291,A00,102443,Su; Hao,0,0,0,0
1668030078669,CSE 291,B00,102448,Polikarpova; Nadezhda,0,0,0,0
1668030078669,CSE 291,C00,102453,Vaccaro; Kristen Marie,0,0,0,0
1668030078669,CSE 291,D00,111343,Savage; Stefan,0,0,0,0
1668030078669,CSE 291,E00,116474,Claffy; Kimberly Claire,0,0,0,0
1668030078669,CSE 291,F00,116479,Pasquale; Joseph,0,0,0,0
1668030079110,CSE 293,001,119111,Bafna; Vineet,9999,0,9999,0
1668030079110,CSE 293,002,119118,Bellare; Mihir,9999,0,9999,0
1668030079110,CSE 293,003,119122,Berg-Kirkpatrick; Taylor D,9999,0,9999,0
1668030079110,CSE 293,004,119135,Christensen; Henrik I,9999,0,9999,0
1668030079110,CSE 293,005,119142,Cottrell; Garrison W,9999,0,9999,0
1668030079110,CSE 293,006,119146,Deutsch; Alin Bernard,9999,0,9999,0
1668030079110,CSE 293,007,119159,Esmaeilzadeh; Hadi,9999,0,9999,0
1668030079110,CSE 293,008,119166,Freund; Yoav,9999,0,9999,0
1668030079110,CSE 293,009,119170,Griswold; William G.,9999,0,9999,0
1668030079110,CSE 293,010,119183,Gymrek; Melissa Ann,9999,0,9999,0
1668030079110,CSE 293,011,119190,Heninger; Nadia A,9999,0,9999,0
1668030079110,CSE 293,012,119230,Impagliazzo; Russell,9999,0,9999,0
1668030079110,CSE 293,013,119232,Jhala; Ranjit,9999,0,9999,0
1668030079110,CSE 293,014,119233,Kahng; Andrew Byun,9999,0,9999,0
1668030079110,CSE 293,015,119298,Kane; Daniel Mertz,9999,0,9999,0
1668030079110,CSE 293,016,119299,Kriegman; David J,9999,0,9999,0
1668030079110,CSE 293,017,119300,Kumar; Arun Kumar,9999,0,9999,0
1668030079110,CSE 293,018,119301,Lerner; Sorin,9999,0,9999,0
1668030079110,CSE 293,019,119302,Lovett; Shachar,9999,0,9999,0
1668030079110,CSE 293,020,119303,McAuley; Julian John,9999,0,9999,0
1668030079110,CSE 293,021,119304,Micciancio; Daniele,9999,0,9999,0
1668030079110,CSE 293,022,119367,Orailoglu; Alex,9999,0,9999,0
1668030079110,CSE 293,023,119382,Paturi; Ramamohan,9999,0,9999,0
1668030079110,CSE 293,024,119404,Polikarpova; Nadezhda,9999,0,9999,0
1668030079110,CSE 293,025,119406,Politz; Joseph Gibbs,9999,0,9999,0
1668030079110,CSE 293,026,119411,Porter; George M,9999,0,9999,0
1668030079110,CSE 293,027,119414,Porter; Leonard Emerson,9999,0,9999,0
1668030079110,CSE 293,028,119416,Ramamoorthi; Ravi,9999,0,9999,0
1668030079110,CSE 293,029,119417,Sahoo; Debashis,9999,0,9999,0
1668030079110,CSE 293,030,119420,Saul; Lawrence,9999,0,9999,0
1668030079110,CSE 293,031,119421,Savage; Stefan,9999,0,9999,0
1668030079110,CSE 293,032,119425,Schulze; Jurgen P.,9999,0,9999,0
1668030079110,CSE 293,033,119426,Snoeren; Alex C.,9999,0,9999,0
1668030079110,CSE 293,034,119428,Shang; Jingbo,9999,0,9999,0
1668030079110,CSE 293,035,119430,Stefan; Deian,9999,0,9999,0
1668030079110,CSE 293,036,119431,Su; Hao,9999,0,9999,0
1668030079110,CSE 293,037,119433,Swanson; Steven James,9999,0,9999,0
1668030079110,CSE 293,038,119435,Tullsen; Dean Michael,9999,0,9999,0
1668030079110,CSE 293,039,119483,Voelker; Geoffrey M.,9999,0,9999,0
1668030079110,CSE 293,040,119537,Zhao; Jishen,9999,0,9999,0
1668030079110,CSE 293,041,119538,Zhou; Yuan-Yuan,9999,0,9999,0
1668030079110,CSE 293,042,119539,Gao; Sicun,9999,0,9999,0
1668030079110,CSE 293,043,119540,Weibel; Nadir,9999,0,9999,0
1668030079110,CSE 293,044,119541,Gupta; Rajesh K.,9999,0,9999,0
1668030079110,CSE 293,045,126410,Vaccaro; Kristen Marie,9999,0,9999,0
1668030079110,CSE 293,046,126411,Klemke; Richard,9999,0,9999,0
1668030079536,CSE 294,A00,102459,Voelker; Geoffrey M.,0,0,0,0
1668030079536,CSE 294,B00,111322,Orailoglu; Alex,0,0,0,0
1668030079961,DSE 201,A00,096914,Deutsch; Alin Bernard,30,0,30,0
1668030080391,DSE 210,A00,096915,Dasgupta; Sanjoy,30,0,30,0
1668030080814,DSE 260A,A00,096916,Altintas De Callaf; Ilkay,30,0,30,0
1668030081261,ECE 200,001,103586,Antipa; Nicholas A,9999,0,9999,0
1668030081261,ECE 200,002,103587,Atanasov; Nikolay A.,9999,0,9999,0
1668030081261,ECE 200,003,103588,Bharadia; Dinesh,9999,0,9999,0
1668030081261,ECE 200,004,103589,Cheng; Chung Kuan,9999,0,9999,0
1668030081261,ECE 200,005,103590,Cosman; Pamela C.,9999,0,9999,0
1668030081261,ECE 200,006,103591,Dayeh; Shadi Ahmad,9999,0,9999,0
1668030081261,ECE 200,007,103592,Fainman; Yeshaiahu,9999,0,9999,0
1668030081261,ECE 200,008,103593,Ford; Joseph Earl,9999,0,9999,0
1668030081261,ECE 200,009,103594,Franceschetti; Massimo,9999,0,9999,0
1668030081261,ECE 200,010,103595,Fullerton; Eric E,9999,0,9999,0
1668030081261,ECE 200,011,103596,Galton; Ian A,9999,0,9999,0
1668030081261,ECE 200,012,103597,Gilja; Vikash,9999,0,9999,0
1668030081261,ECE 200,013,103598,Hall; Drew A.,9999,0,9999,0
1668030081261,ECE 200,014,103599,Hsueh; Tzu-Chien,9999,0,9999,0
1668030081261,ECE 200,015,103600,Javidi; Tara,9999,0,9999,0
1668030081261,ECE 200,016,103601,Kahng; Andrew Byun,9999,0,9999,0
1668030081261,ECE 200,017,103602,Kim; Young-Han,9999,0,9999,0
1668030081261,ECE 200,018,103603,Koushanfar; Farinaz,9999,0,9999,0
1668030081261,ECE 200,019,103604,Kuzum; Duygu,9999,0,9999,0
1668030081261,ECE 200,020,103605,Le; Hanh-Phuc,9999,0,9999,0
1668030081261,ECE 200,021,103606,Lin; Bill,9999,0,9999,0
1668030081261,ECE 200,022,103607,Liu; Zhaowei,9998,0,9999,1
1668030081261,ECE 200,023,103608,Lo; Yu-Hwa,9999,0,9999,0
1668030081261,ECE 200,024,103609,Lomakin; Vitaliy,9999,0,9999,0
1668030081261,ECE 200,025,103610,Mercier; Patrick Philip,9999,0,9999,0
1668030081261,ECE 200,026,103611,Meyer; Florian,9999,0,9999,0
1668030081261,ECE 200,027,103612,Milstein; Laurence B.,9999,0,9999,0
1668030081261,ECE 200,028,103613,Mir Arabbaygi; Siavash,9999,0,9999,0
1668030081261,ECE 200,029,103614,Mookherjea; Shayan,9999,0,9999,0
1668030081261,ECE 200,030,103615,Morris; Karcher William,9999,0,9999,0
1668030081261,ECE 200,031,103616,Ng; Tse Nga,9999,0,9999,0
1668030081261,ECE 200,032,103617,Nguyen; Truong Quang,9999,0,9999,0
1668030081261,ECE 200,033,103618,Nomura; Kenji,9999,0,9999,0
1668030081261,ECE 200,034,103619,Orlitsky; Alon,9999,0,9999,0
1668030081261,ECE 200,035,103620,Pal; Piya,9999,0,9999,0
1668030081261,ECE 200,036,103621,Papen; George C.,9999,0,9999,0
1668030081261,ECE 200,037,103622,Radic; Stojan,9999,0,9999,0
1668030081261,ECE 200,038,103623,Rao; Bhaskar D.,9999,0,9999,0
1668030081261,ECE 200,039,103624,Rao; Ramesh R,9999,0,9999,0
1668030081261,ECE 200,040,103625,Rebeiz; Gabriel,9999,0,9999,0
1668030081261,ECE 200,041,103626,Sanford; John R,9999,0,9999,0
1668030081261,ECE 200,042,103627,Siegel; Paul H.,9999,0,9999,0
1668030081261,ECE 200,043,103628,Sievenpiper; Daniel F.,9999,0,9999,0
1668030081261,ECE 200,044,103629,Sworder; David D.,9999,0,9999,0
1668030081261,ECE 200,045,103630,Taur; Yuan,9999,0,9999,0
1668030081261,ECE 200,046,103631,Touri; Behrouz,9999,0,9999,0
1668030081261,ECE 200,047,103632,Trivedi; Mohan M.,9999,0,9999,0
1668030081261,ECE 200,048,103633,Vasconcelos; Nuno,9999,0,9999,0
1668030081261,ECE 200,049,103634,Wang; Xiaolong,9999,0,9999,0
1668030081261,ECE 200,050,103635,Xie; Pengtao,9999,0,9999,0
1668030081261,ECE 200,051,103636,Yip; Michael,9999,0,9999,0
1668030081261,ECE 200,052,103637,Zeger; Kenneth A.,999,0,999,0
1668030081261,ECE 200,053,103638,Zhang; Xinyu,9999,0,9999,0
1668030081261,ECE 200,054,103639,Turakhia; Yatish Girish,9999,0,9999,0
1668030081261,ECE 200,055,103640,Kang; Mingu,9999,0,9999,0
1668030081261,ECE 200,056,103641,Shi; Yuanyuan,9999,0,9999,0
1668030081261,ECE 200,057,103642,Wang; Edward Jay,9999,0,9999,0
1668030081261,ECE 200,058,103643,Zheng; Yang,9999,0,9999,0
1668030081702,ECE 202,A00,103644,Kuzum; Duygu,0,0,0,0
1668030082136,ECE 212BN,A00,103646,Ng; Tse Nga,0,0,0,0
1668030082568,ECE 221,A00,111493,Staff,0,0,0,0
1668030082996,ECE 222B,A00,103647,Lomakin; Vitaliy,0,0,0,0
1668030083423,ECE 230B,A00,103648,Taur; Yuan,0,0,0,0
1668030083846,ECE 238B,A00,103649,Garay; Javier,0,0,0,0
1668030084273,ECE 240B,A00,112900,Fainman; Yeshaiahu,0,0,0,0
1668030084710,ECE 247A,A00,103650,Jokerst; Jesse Vincent,0,0,0,0
1668030085144,ECE 247B,A00,103651,Wang; Joseph,0,0,0,0
1668030085569,ECE 250,A00,103652,Siegel; Paul H.,0,0,0,0
1668030085999,ECE 251A,A00,103654,Rao; Bhaskar D.,0,0,0,0
1668030086424,ECE 257B,A00,103655,Bharadia; Dinesh,0,0,0,0
1668030086845,ECE 258A,A00,103656,Milstein; Laurence B.,0,0,0,0
1668030087284,ECE 260B,A00,103658,Kang; Mingu,0,0,0,0
1668030087706,ECE 264A,A00,103659,Galton; Ian A,0,0,0,0
1668030088132,ECE 265A,A00,103661,Gudem; Prasad S.S.,0,0,0,0
1668030088558,ECE 265D,A00,103662,Gudem; Prasad S.S.,0,0,0,0
1668030088979,ECE 268,A00,103663,Koushanfar; Farinaz,0,0,0,0
1668030089405,ECE 269,A01,103665,Pal; Piya,0,0,0,0
1668030089913,ECE 271B,A00,103666,Vasconcelos; Manuela,0,0,0,0
1668030090358,ECE 276A,A00,103667,Atanasov; Nikolay A.,0,0,0,0
1668030090796,ECE 277,A00,103668,An; Cheolhong,0,0,0,0
1668030091226,ECE 279,A00,117947,Hall; Drew A.,0,0,0,0
1668030092086,ECE 283,A00,103670,Hsueh; Tzu-Chien,0,0,0,0
1668030092520,ECE 284,A00,103671,Turakhia; Yatish Girish,0,0,0,0
1668030092942,ECE 285,A00,103672,Zheng; Yang,0,0,0,0
1668030092942,ECE 285,B00,103673,Sworder; David D.,0,0,0,0
1668030093382,ECE 287,A00,103676,Javidi; Tara,0,0,0,0
1668030093812,MATH 200B,A00,098023,Salehi Golsefidy; Alireza,13,0,15,2
1668030094245,MATH 202B,A00,098024,Rhoades; Brendon Patrick,10,0,15,5
1668030094674,MATH 203B,A00,098025,Oprea; Dragos N.,11,0,15,4
1668030095098,MATH 204B,A00,098026,Sorensen; Claus M,14,0,15,1
1668030095521,MATH 208,A00,098027,Izadi; Elham,7,0,10,3
1668030095952,MATH 209,A00,098028,Pollack; Aaron,10,0,10,0
1668030096387,MATH 211A,A00,112919,Rogalski; Daniel,9,0,10,1
1668030096834,MATH 211B,A00,112920,Seward; Brandon M.,9,0,10,1
1668030097260,MATH 218,A00,098029,Li; Bo,10,0,10,0
1668030097692,MATH 220B,A00,098030,Novak; Jonathan I,13,0,15,2
1668030098118,MATH 221A,A00,098031,Ebenfelt; Peter F,13,0,15,2
1668030098555,MATH 231B,A00,098032,Zlatos; Andrej,12,0,15,3
1668030098979,MATH 240B,A00,098033,Ni; Lei,9,0,15,6
1668030099418,MATH 243,A00,098034,Jekel; David Andrew,10,0,10,0
1668030099865,MATH 245A,A00,098035,Nie; Jiawang,0,0,15,16
1668030100289,MATH 248,A00,098036,Bejenaru; Ioan,10,0,10,0
1668030100891,MATH 250B,A00,098037,Spolaor; Luca,14,0,15,1
1668030101321,MATH 258,A00,098038,Ni; Lei,10,0,10,0
1668030101751,MATH 264B,A00,098041,Rhoades; Brendon Patrick,10,0,15,5
1668030102184,MATH 268,A00,098042,Buss; Samuel R,10,0,10,0
1668030102610,MATH 269,A00,098043,Rhoades; Brendon Patrick,10,0,10,0
1668030103049,MATH 270B,A00,098044,Li; Bo,11,0,15,4
1668030103481,MATH 272B,A00,098045,Holst; Michael J,13,0,15,2
1668030103904,MATH 273A,A00,098046,Tian; Xiaochuan,10,0,15,5
1668030104328,MATH 275,A01,098048,Tian; Xiaochuan,6,0,10,4
1668030104755,MATH 278A,A00,098049,Holst; Michael J,8,0,10,2
1668030105182,MATH 278B,A00,098050,Cloninger; Alexander,10,0,10,0
1668030105613,MATH 278C,A00,098051,Nie; Jiawang,8,0,10,2
1668030106043,MATH 280B,A00,098052,Zheng; Tianyi,11,0,15,4
1668030106484,MATH 281B,A00,098053,Bradic; Jelena,3,0,15,12
1668030106927,MATH 282B,A00,098054,Arias-Castro; Ery,2,0,15,13
1668030107355,MATH 285,A00,098055,Fitzsimmons; Patrick J,0,0,15,17
1668030107785,MATH 287B,A00,098056,Arias-Castro; Ery,4,0,15,11
1668030108222,MATH 288,A00,098057,Agarwal; Pooja,9,0,10,1
1668030108222,MATH 288,B00,098058,Zhang; Danna,9,0,10,1
1668030108222,MATH 288,C00,098059,Williams; Ruth J,10,0,10,0
1668030108652,MATH 290B,A00,098060,Roberts; Justin Deritter,13,0,15,2
1668030109080,MATH 292,A00,098061,Belmont; Eva Kinoshita,10,0,10,0
1668030109503,MATH 295,A00,098062,Suk; Andrew Hoon,48,0,50,2
1668030109936,MATH 296,A00,098063,Novak; Jonathan I,20,0,20,0
1668030110358,MATH 297,001,098064,Gamst; Anthony Collins,9997,0,9999,2
1668030615537,COGS 205,A00,101395,Chiba; Andrea,19,0,20,1
1668030616062,COGS 210B,001,101404,Greene; Deanna Jacquelyn,9998,0,9999,1
1668030616062,COGS 210B,002,101417,Xia; Haijun,9999,0,9999,0
1668030616062,COGS 210B,003,101422,Nitz; Douglas A.,9999,0,9999,0
1668030616062,COGS 210B,004,101423,Hollan; James D.,9998,0,9999,1
1668030616062,COGS 210B,005,101424,Deak; Gedeon O.,9999,0,9999,0
1668030616062,COGS 210B,006,101425,Rossano; Federico,9999,0,9999,0
1668030616486,COGS 211B,A00,101427,Coulson; Seana M,9997,0,9999,2
1668030616916,COGS 220,A00,101428,Hollan; James D.,0,0,25,25
1668030617356,COGS 229,A00,101429,Dow; Steven P,18,0,25,7
1668030617789,COGS 230,A00,101430,Klemmer; Scott R,13,0,17,4
1668030618366,COGS 234,A00,101431,Xia; Haijun,5,0,25,20
1668030618787,COGS 260,A00,101432,Kiyonaga; Anastasia,20,0,25,5
1668030618787,COGS 260,B00,101433,Kirsh; David Joel,16,0,25,9
1668030619218,CSE 202,A00,102371,Impagliazzo; Russell,0,0,0,0
1668030619650,CSE 203B,A01,102373,Cheng; Chung Kuan,0,0,0,0
1668030620072,CSE 208,A00,102374,Micciancio; Daniele,0,0,0,0
1668030620495,CSE 209A,A00,112895,Impagliazzo; Russell,0,0,15,15
1668030620932,CSE 209B,A00,108005,Bellare; Mihir,0,0,0,0
1668030621376,CSE 210,A00,113163,Coblenz; Michael J,0,0,0,0
1668030621810,CSE 219,A00,106111,Dow; Steven P,0,0,20,20
1668030622255,CSE 221,A00,102376,Voelker; Geoffrey M.,0,0,0,0
1668030622680,CSE 224,A01,102378,Porter; George M,0,0,0,0
1668030623108,CSE 229A,A00,102379,Savage; Stefan,0,0,0,0
1668030623534,CSE 229C,A00,102380,Munyaka; Imani N. S.,0,0,0,0
1668030623968,CSE 232B,A00,102382,Deutsch; Alin Bernard,0,0,0,0
1668030624394,CSE 234,A01,112904,Kumar; Arun Kumar,0,0,0,0
1668030624818,CSE 237A,A00,102383,Rosing; Tajana Simunic,0,0,0,0
1668030625251,CSE 239A,A00,102384,Deutsch; Alin Bernard,0,0,0,0
1668030625686,CSE 239B,A00,102385,Polikarpova; Nadezhda,0,0,0,0
1668030626125,CSE 240A,A00,102386,Pannuto; Patrick William,0,0,0,0
1668030626553,CSE 240B,A00,102387,Zhao; Jishen,0,0,0,0
1668030626982,CSE 241A,A00,106406,Kang; Mingu,0,0,0,0
1668030627410,CSE 249B,A00,102388,Kahng; Andrew Byun,0,0,8,8
1668030627841,CSE 251B,A01,102392,Cottrell; Garrison W,0,0,0,0
1668030627841,CSE 251B,A02,102393,Cottrell; Garrison W,0,0,0,0
1668030628264,CSE 252B,A00,102394,Ochoa; Benjamin Lawrence,0,0,0,0
1668030628703,CSE 257,A01,102396,Gao; Sicun,0,0,0,0
1668030629135,CSE 272,A00,102397,Li; Tzumao,0,0,0,0
1668030629576,CSE 274,A00,111323,Chern; Albert Ren-Haur,0,0,0,0
1668030630014,CSE 282,A00,102398,Pevzner; Pavel Arkadjevich,0,0,0,0
1668030630443,CSE 284,A00,114175,Gymrek; Melissa Ann,0,0,0,0
1668030630866,CSE 290,A00,102399,Chandraker; Manmohan Krishna,0,0,0,0
1668030630866,CSE 290,B00,102400,Vaccaro; Kristen Marie,0,0,25,25
1668030630866,CSE 290,C00,102414,Pannuto; Patrick William,0,0,25,25
1668030630866,CSE 290,D00,102427,Pevzner; Pavel Arkadjevich,0,0,0,0
1668030630866,CSE 290,E00,102429,Zhao; Jishen,0,0,0,0
1668030630866,CSE 290,F00,102436,Tullsen; Dean Michael,0,0,0,0
1668030630866,CSE 290,G00,102440,Christensen; Henrik I,0,0,20,20
1668030631290,CSE 291,A00,102443,Su; Hao,0,0,0,0
1668030631290,CSE 291,B00,102448,Polikarpova; Nadezhda,0,0,0,0
1668030631290,CSE 291,C00,102453,Vaccaro; Kristen Marie,0,0,0,0
1668030631290,CSE 291,D00,111343,Savage; Stefan,0,0,0,0
1668030631290,CSE 291,E00,116474,Claffy; Kimberly Claire,0,0,0,0
1668030631290,CSE 291,F00,116479,Pasquale; Joseph,0,0,0,0
1668030631733,CSE 293,001,119111,Bafna; Vineet,9999,0,9999,0
1668030631733,CSE 293,002,119118,Bellare; Mihir,9999,0,9999,0
1668030631733,CSE 293,003,119122,Berg-Kirkpatrick; Taylor D,9999,0,9999,0
1668030631733,CSE 293,004,119135,Christensen; Henrik I,9999,0,9999,0
1668030631733,CSE 293,005,119142,Cottrell; Garrison W,9999,0,9999,0
1668030631733,CSE 293,006,119146,Deutsch; Alin Bernard,9999,0,9999,0
1668030631733,CSE 293,007,119159,Esmaeilzadeh; Hadi,9999,0,9999,0
1668030631733,CSE 293,008,119166,Freund; Yoav,9999,0,9999,0
1668030631733,CSE 293,009,119170,Griswold; William G.,9999,0,9999,0
1668030631733,CSE 293,010,119183,Gymrek; Melissa Ann,9999,0,9999,0
1668030631733,CSE 293,011,119190,Heninger; Nadia A,9999,0,9999,0
1668030631733,CSE 293,012,119230,Impagliazzo; Russell,9999,0,9999,0
1668030631733,CSE 293,013,119232,Jhala; Ranjit,9999,0,9999,0
1668030631733,CSE 293,014,119233,Kahng; Andrew Byun,9999,0,9999,0
1668030631733,CSE 293,015,119298,Kane; Daniel Mertz,9999,0,9999,0
1668030631733,CSE 293,016,119299,Kriegman; David J,9999,0,9999,0
1668030631733,CSE 293,017,119300,Kumar; Arun Kumar,9999,0,9999,0
1668030631733,CSE 293,018,119301,Lerner; Sorin,9999,0,9999,0
1668030631733,CSE 293,019,119302,Lovett; Shachar,9999,0,9999,0
1668030631733,CSE 293,020,119303,McAuley; Julian John,9999,0,9999,0
1668030631733,CSE 293,021,119304,Micciancio; Daniele,9999,0,9999,0
1668030631733,CSE 293,022,119367,Orailoglu; Alex,9999,0,9999,0
1668030631733,CSE 293,023,119382,Paturi; Ramamohan,9999,0,9999,0
1668030631733,CSE 293,024,119404,Polikarpova; Nadezhda,9999,0,9999,0
1668030631733,CSE 293,025,119406,Politz; Joseph Gibbs,9999,0,9999,0
1668030631733,CSE 293,026,119411,Porter; George M,9999,0,9999,0
1668030631733,CSE 293,027,119414,Porter; Leonard Emerson,9999,0,9999,0
1668030631733,CSE 293,028,119416,Ramamoorthi; Ravi,9999,0,9999,0
1668030631733,CSE 293,029,119417,Sahoo; Debashis,9999,0,9999,0
1668030631733,CSE 293,030,119420,Saul; Lawrence,9999,0,9999,0
1668030631733,CSE 293,031,119421,Savage; Stefan,9999,0,9999,0
1668030631733,CSE 293,032,119425,Schulze; Jurgen P.,9999,0,9999,0
1668030631733,CSE 293,033,119426,Snoeren; Alex C.,9999,0,9999,0
1668030631733,CSE 293,034,119428,Shang; Jingbo,9999,0,9999,0
1668030631733,CSE 293,035,119430,Stefan; Deian,9999,0,9999,0
1668030631733,CSE 293,036,119431,Su; Hao,9999,0,9999,0
1668030631733,CSE 293,037,119433,Swanson; Steven James,9999,0,9999,0
1668030631733,CSE 293,038,119435,Tullsen; Dean Michael,9999,0,9999,0
1668030631733,CSE 293,039,119483,Voelker; Geoffrey M.,9999,0,9999,0
1668030631733,CSE 293,040,119537,Zhao; Jishen,9999,0,9999,0
1668030631733,CSE 293,041,119538,Zhou; Yuan-Yuan,9999,0,9999,0
1668030631733,CSE 293,042,119539,Gao; Sicun,9999,0,9999,0
1668030631733,CSE 293,043,119540,Weibel; Nadir,9999,0,9999,0
1668030631733,CSE 293,044,119541,Gupta; Rajesh K.,9999,0,9999,0
1668030631733,CSE 293,045,126410,Vaccaro; Kristen Marie,9999,0,9999,0
1668030631733,CSE 293,046,126411,Klemke; Richard,9999,0,9999,0
1668030632160,CSE 294,A00,102459,Voelker; Geoffrey M.,0,0,0,0
1668030632160,CSE 294,B00,111322,Orailoglu; Alex,0,0,0,0
1668030632583,DSE 201,A00,096914,Deutsch; Alin Bernard,30,0,30,0
1668030633013,DSE 210,A00,096915,Dasgupta; Sanjoy,30,0,30,0
1668030633440,DSE 260A,A00,096916,Altintas De Callaf; Ilkay,30,0,30,0
1668030633879,ECE 200,001,103586,Antipa; Nicholas A,9999,0,9999,0
1668030633879,ECE 200,002,103587,Atanasov; Nikolay A.,9999,0,9999,0
1668030633879,ECE 200,003,103588,Bharadia; Dinesh,9999,0,9999,0
1668030633879,ECE 200,004,103589,Cheng; Chung Kuan,9999,0,9999,0
1668030633879,ECE 200,005,103590,Cosman; Pamela C.,9999,0,9999,0
1668030633879,ECE 200,006,103591,Dayeh; Shadi Ahmad,9999,0,9999,0
1668030633879,ECE 200,007,103592,Fainman; Yeshaiahu,9999,0,9999,0
1668030633879,ECE 200,008,103593,Ford; Joseph Earl,9999,0,9999,0
1668030633879,ECE 200,009,103594,Franceschetti; Massimo,9999,0,9999,0
1668030633879,ECE 200,010,103595,Fullerton; Eric E,9999,0,9999,0
1668030633879,ECE 200,011,103596,Galton; Ian A,9999,0,9999,0
1668030633879,ECE 200,012,103597,Gilja; Vikash,9999,0,9999,0
1668030633879,ECE 200,013,103598,Hall; Drew A.,9999,0,9999,0
1668030633879,ECE 200,014,103599,Hsueh; Tzu-Chien,9999,0,9999,0
1668030633879,ECE 200,015,103600,Javidi; Tara,9999,0,9999,0
1668030633879,ECE 200,016,103601,Kahng; Andrew Byun,9999,0,9999,0
1668030633879,ECE 200,017,103602,Kim; Young-Han,9999,0,9999,0
1668030633879,ECE 200,018,103603,Koushanfar; Farinaz,9999,0,9999,0
1668030633879,ECE 200,019,103604,Kuzum; Duygu,9999,0,9999,0
1668030633879,ECE 200,020,103605,Le; Hanh-Phuc,9999,0,9999,0
1668030633879,ECE 200,021,103606,Lin; Bill,9999,0,9999,0
1668030633879,ECE 200,022,103607,Liu; Zhaowei,9998,0,9999,1
1668030633879,ECE 200,023,103608,Lo; Yu-Hwa,9999,0,9999,0
1668030633879,ECE 200,024,103609,Lomakin; Vitaliy,9999,0,9999,0
1668030633879,ECE 200,025,103610,Mercier; Patrick Philip,9999,0,9999,0
1668030633879,ECE 200,026,103611,Meyer; Florian,9999,0,9999,0
1668030633879,ECE 200,027,103612,Milstein; Laurence B.,9999,0,9999,0
1668030633879,ECE 200,028,103613,Mir Arabbaygi; Siavash,9999,0,9999,0
1668030633879,ECE 200,029,103614,Mookherjea; Shayan,9999,0,9999,0
1668030633879,ECE 200,030,103615,Morris; Karcher William,9999,0,9999,0
1668030633879,ECE 200,031,103616,Ng; Tse Nga,9999,0,9999,0
1668030633879,ECE 200,032,103617,Nguyen; Truong Quang,9999,0,9999,0
1668030633879,ECE 200,033,103618,Nomura; Kenji,9999,0,9999,0
1668030633879,ECE 200,034,103619,Orlitsky; Alon,9999,0,9999,0
1668030633879,ECE 200,035,103620,Pal; Piya,9999,0,9999,0
1668030633879,ECE 200,036,103621,Papen; George C.,9999,0,9999,0
1668030633879,ECE 200,037,103622,Radic; Stojan,9999,0,9999,0
1668030633879,ECE 200,038,103623,Rao; Bhaskar D.,9999,0,9999,0
1668030633879,ECE 200,039,103624,Rao; Ramesh R,9999,0,9999,0
1668030633879,ECE 200,040,103625,Rebeiz; Gabriel,9999,0,9999,0
1668030633879,ECE 200,041,103626,Sanford; John R,9999,0,9999,0
1668030633879,ECE 200,042,103627,Siegel; Paul H.,9999,0,9999,0
1668030633879,ECE 200,043,103628,Sievenpiper; Daniel F.,9999,0,9999,0
1668030633879,ECE 200,044,103629,Sworder; David D.,9999,0,9999,0
1668030633879,ECE 200,045,103630,Taur; Yuan,9999,0,9999,0
1668030633879,ECE 200,046,103631,Touri; Behrouz,9999,0,9999,0
1668030633879,ECE 200,047,103632,Trivedi; Mohan M.,9999,0,9999,0
1668030633879,ECE 200,048,103633,Vasconcelos; Nuno,9999,0,9999,0
1668030633879,ECE 200,049,103634,Wang; Xiaolong,9999,0,9999,0
1668030633879,ECE 200,050,103635,Xie; Pengtao,9999,0,9999,0
1668030633879,ECE 200,051,103636,Yip; Michael,9999,0,9999,0
1668030633879,ECE 200,052,103637,Zeger; Kenneth A.,999,0,999,0
1668030633879,ECE 200,053,103638,Zhang; Xinyu,9999,0,9999,0
1668030633879,ECE 200,054,103639,Turakhia; Yatish Girish,9999,0,9999,0
1668030633879,ECE 200,055,103640,Kang; Mingu,9999,0,9999,0
1668030633879,ECE 200,056,103641,Shi; Yuanyuan,9999,0,9999,0
1668030633879,ECE 200,057,103642,Wang; Edward Jay,9999,0,9999,0
1668030633879,ECE 200,058,103643,Zheng; Yang,9999,0,9999,0
1668030634306,ECE 202,A00,103644,Kuzum; Duygu,0,0,0,0
1668030634738,ECE 212BN,A00,103646,Ng; Tse Nga,0,0,0,0
1668030635161,ECE 221,A00,111493,Staff,0,0,0,0
1668030635583,ECE 222B,A00,103647,Lomakin; Vitaliy,0,0,0,0
1668030636020,ECE 230B,A00,103648,Taur; Yuan,0,0,0,0
1668030636444,ECE 238B,A00,103649,Garay; Javier,0,0,0,0
1668030636866,ECE 240B,A00,112900,Fainman; Yeshaiahu,0,0,0,0
1668030637293,ECE 247A,A00,103650,Jokerst; Jesse Vincent,0,0,0,0
1668030637728,ECE 247B,A00,103651,Wang; Joseph,0,0,0,0
1668030638150,ECE 250,A00,103652,Siegel; Paul H.,0,0,0,0
1668030638574,ECE 251A,A00,103654,Rao; Bhaskar D.,0,0,0,0
1668030638997,ECE 257B,A00,103655,Bharadia; Dinesh,0,0,0,0
1668030639507,ECE 258A,A00,103656,Milstein; Laurence B.,0,0,0,0
1668030639947,ECE 260B,A00,103658,Kang; Mingu,0,0,0,0
1668030640380,ECE 264A,A00,103659,Galton; Ian A,0,0,0,0
1668030640822,ECE 265A,A00,103661,Gudem; Prasad S.S.,0,0,0,0
1668030641249,ECE 265D,A00,103662,Gudem; Prasad S.S.,0,0,0,0
1668030641673,ECE 268,A00,103663,Koushanfar; Farinaz,0,0,0,0
1668030642098,ECE 269,A01,103665,Pal; Piya,0,0,0,0
1668030642531,ECE 271B,A00,103666,Vasconcelos; Manuela,0,0,0,0
1668030642977,ECE 276A,A00,103667,Atanasov; Nikolay A.,0,0,0,0
1668030643400,ECE 277,A00,103668,An; Cheolhong,0,0,0,0
1668030643842,ECE 279,A00,117947,Hall; Drew A.,0,0,0,0
1668030644695,ECE 283,A00,103670,Hsueh; Tzu-Chien,0,0,0,0
1668030645135,ECE 284,A00,103671,Turakhia; Yatish Girish,0,0,0,0
1668030645564,ECE 285,A00,103672,Zheng; Yang,0,0,0,0
1668030645564,ECE 285,B00,103673,Sworder; David D.,0,0,0,0
1668030645992,ECE 287,A00,103676,Javidi; Tara,0,0,0,0
1668030646437,MATH 200B,A00,098023,Salehi Golsefidy; Alireza,13,0,15,2
1668030646877,MATH 202B,A00,098024,Rhoades; Brendon Patrick,10,0,15,5
1668030647303,MATH 203B,A00,098025,Oprea; Dragos N.,11,0,15,4
1668030647725,MATH 204B,A00,098026,Sorensen; Claus M,14,0,15,1
1668030648150,MATH 208,A00,098027,Izadi; Elham,7,0,10,3
1668030648582,MATH 209,A00,098028,Pollack; Aaron,10,0,10,0
1668030649004,MATH 211A,A00,112919,Rogalski; Daniel,9,0,10,1
1668030649437,MATH 211B,A00,112920,Seward; Brandon M.,9,0,10,1
1668030649868,MATH 218,A00,098029,Li; Bo,10,0,10,0
1668030650304,MATH 220B,A00,098030,Novak; Jonathan I,13,0,15,2
1668030650731,MATH 221A,A00,098031,Ebenfelt; Peter F,13,0,15,2
1668030651169,MATH 231B,A00,098032,Zlatos; Andrej,12,0,15,3
1668030651591,MATH 240B,A00,098033,Ni; Lei,9,0,15,6
1668030652015,MATH 243,A00,098034,Jekel; David Andrew,10,0,10,0
1668030652442,MATH 245A,A00,098035,Nie; Jiawang,0,0,15,16
1668030652870,MATH 248,A00,098036,Bejenaru; Ioan,10,0,10,0
1668030653297,MATH 250B,A00,098037,Spolaor; Luca,14,0,15,1
1668030653745,MATH 258,A00,098038,Ni; Lei,10,0,10,0
1668030654175,MATH 264B,A00,098041,Rhoades; Brendon Patrick,10,0,15,5
1668030654600,MATH 268,A00,098042,Buss; Samuel R,10,0,10,0
1668030655024,MATH 269,A00,098043,Rhoades; Brendon Patrick,10,0,10,0
1668030655453,MATH 270B,A00,098044,Li; Bo,11,0,15,4
1668030655896,MATH 272B,A00,098045,Holst; Michael J,13,0,15,2
1668030656326,MATH 273A,A00,098046,Tian; Xiaochuan,10,0,15,5
1668030656751,MATH 275,A01,098048,Tian; Xiaochuan,6,0,10,4
1668030657180,MATH 278A,A00,098049,Holst; Michael J,8,0,10,2
1668030657606,MATH 278B,A00,098050,Cloninger; Alexander,10,0,10,0
1668030658036,MATH 278C,A00,098051,Nie; Jiawang,8,0,10,2
1668030658460,MATH 280B,A00,098052,Zheng; Tianyi,11,0,15,4
1668030658891,MATH 281B,A00,098053,Bradic; Jelena,3,0,15,12
1668030659436,MATH 282B,A00,098054,Arias-Castro; Ery,2,0,15,13
1668030659860,MATH 285,A00,098055,Fitzsimmons; Patrick J,0,0,15,17
1668030660288,MATH 287B,A00,098056,Arias-Castro; Ery,4,0,15,11
1668030660728,MATH 288,A00,098057,Agarwal; Pooja,9,0,10,1
1668030660728,MATH 288,B00,098058,Zhang; Danna,9,0,10,1
1668030660728,MATH 288,C00,098059,Williams; Ruth J,10,0,10,0
1668030661156,MATH 290B,A00,098060,Roberts; Justin Deritter,13,0,15,2
1668030661579,MATH 292,A00,098061,Belmont; Eva Kinoshita,10,0,10,0
1668030662011,MATH 295,A00,098062,Suk; Andrew Hoon,48,0,50,2
1668030662460,MATH 296,A00,098063,Novak; Jonathan I,20,0,20,0
1668030662883,MATH 297,001,098064,Gamst; Anthony Collins,9997,0,9999,2
1668031167739,COGS 205,A00,101395,Chiba; Andrea,19,0,20,1
1668031168168,COGS 210B,001,101404,Greene; Deanna Jacquelyn,9998,0,9999,1
1668031168168,COGS 210B,002,101417,Xia; Haijun,9999,0,9999,0
1668031168168,COGS 210B,003,101422,Nitz; Douglas A.,9999,0,9999,0
1668031168168,COGS 210B,004,101423,Hollan; James D.,9998,0,9999,1
1668031168168,COGS 210B,005,101424,Deak; Gedeon O.,9999,0,9999,0
1668031168168,COGS 210B,006,101425,Rossano; Federico,9999,0,9999,0
1668031168595,COGS 211B,A00,101427,Coulson; Seana M,9997,0,9999,2
1668031169018,COGS 220,A00,101428,Hollan; James D.,0,0,25,25
1668031169454,COGS 229,A00,101429,Dow; Steven P,18,0,25,7
1668031169969,COGS 230,A00,101430,Klemmer; Scott R,13,0,17,4
1668031170394,COGS 234,A00,101431,Xia; Haijun,5,0,25,20
1668031170822,COGS 260,A00,101432,Kiyonaga; Anastasia,20,0,25,5
1668031170822,COGS 260,B00,101433,Kirsh; David Joel,16,0,25,9
1668031171243,CSE 202,A00,102371,Impagliazzo; Russell,0,0,0,0
1668031171672,CSE 203B,A01,102373,Cheng; Chung Kuan,0,0,0,0
1668031172098,CSE 208,A00,102374,Micciancio; Daniele,0,0,0,0
1668031172519,CSE 209A,A00,112895,Impagliazzo; Russell,0,0,15,15
1668031172944,CSE 209B,A00,108005,Bellare; Mihir,0,0,0,0
1668031173379,CSE 210,A00,113163,Coblenz; Michael J,0,0,0,0
1668031173801,CSE 219,A00,106111,Dow; Steven P,0,0,20,20
1668031174225,CSE 221,A00,102376,Voelker; Geoffrey M.,0,0,0,0
1668031174657,CSE 224,A01,102378,Porter; George M,0,0,0,0
1668031175098,CSE 229A,A00,102379,Savage; Stefan,0,0,0,0
1668031175527,CSE 229C,A00,102380,Munyaka; Imani N. S.,0,0,0,0
1668031175950,CSE 232B,A00,102382,Deutsch; Alin Bernard,0,0,0,0
1668031176374,CSE 234,A01,112904,Kumar; Arun Kumar,0,0,0,0
1668031176807,CSE 237A,A00,102383,Rosing; Tajana Simunic,0,0,0,0
1668031177239,CSE 239A,A00,102384,Deutsch; Alin Bernard,0,0,0,0
1668031177670,CSE 239B,A00,102385,Polikarpova; Nadezhda,0,0,0,0
1668031178095,CSE 240A,A00,102386,Pannuto; Patrick William,0,0,0,0
1668031178524,CSE 240B,A00,102387,Zhao; Jishen,0,0,0,0
1668031178962,CSE 241A,A00,106406,Kang; Mingu,0,0,0,0
1668031179428,CSE 249B,A00,102388,Kahng; Andrew Byun,0,0,8,8
1668031179865,CSE 251B,A01,102392,Cottrell; Garrison W,0,0,0,0
1668031179865,CSE 251B,A02,102393,Cottrell; Garrison W,0,0,0,0
1668031180291,CSE 252B,A00,102394,Ochoa; Benjamin Lawrence,0,0,0,0
1668031180716,CSE 257,A01,102396,Gao; Sicun,0,0,0,0
1668031181161,CSE 272,A00,102397,Li; Tzumao,0,0,0,0
1668031181599,CSE 274,A00,111323,Chern; Albert Ren-Haur,0,0,0,0
1668031182052,CSE 282,A00,102398,Pevzner; Pavel Arkadjevich,0,0,0,0
1668031182479,CSE 284,A00,114175,Gymrek; Melissa Ann,0,0,0,0
1668031182923,CSE 290,A00,102399,Chandraker; Manmohan Krishna,0,0,0,0
1668031182923,CSE 290,B00,102400,Vaccaro; Kristen Marie,0,0,25,25
1668031182923,CSE 290,C00,102414,Pannuto; Patrick William,0,0,25,25
1668031182923,CSE 290,D00,102427,Pevzner; Pavel Arkadjevich,0,0,0,0
1668031182923,CSE 290,E00,102429,Zhao; Jishen,0,0,0,0
1668031182923,CSE 290,F00,102436,Tullsen; Dean Michael,0,0,0,0
1668031182923,CSE 290,G00,102440,Christensen; Henrik I,0,0,20,20
1668031183347,CSE 291,A00,102443,Su; Hao,0,0,0,0
1668031183347,CSE 291,B00,102448,Polikarpova; Nadezhda,0,0,0,0
1668031183347,CSE 291,C00,102453,Vaccaro; Kristen Marie,0,0,0,0
1668031183347,CSE 291,D00,111343,Savage; Stefan,0,0,0,0
1668031183347,CSE 291,E00,116474,Claffy; Kimberly Claire,0,0,0,0
1668031183347,CSE 291,F00,116479,Pasquale; Joseph,0,0,0,0
1668031183779,CSE 293,001,119111,Bafna; Vineet,9999,0,9999,0
1668031183779,CSE 293,002,119118,Bellare; Mihir,9999,0,9999,0
1668031183779,CSE 293,003,119122,Berg-Kirkpatrick; Taylor D,9999,0,9999,0
1668031183779,CSE 293,004,119135,Christensen; Henrik I,9999,0,9999,0
1668031183779,CSE 293,005,119142,Cottrell; Garrison W,9999,0,9999,0
1668031183779,CSE 293,006,119146,Deutsch; Alin Bernard,9999,0,9999,0
1668031183779,CSE 293,007,119159,Esmaeilzadeh; Hadi,9999,0,9999,0
1668031183779,CSE 293,008,119166,Freund; Yoav,9999,0,9999,0
1668031183779,CSE 293,009,119170,Griswold; William G.,9999,0,9999,0
1668031183779,CSE 293,010,119183,Gymrek; Melissa Ann,9999,0,9999,0
1668031183779,CSE 293,011,119190,Heninger; Nadia A,9999,0,9999,0
1668031183779,CSE 293,012,119230,Impagliazzo; Russell,9999,0,9999,0
1668031183779,CSE 293,013,119232,Jhala; Ranjit,9999,0,9999,0
1668031183779,CSE 293,014,119233,Kahng; Andrew Byun,9999,0,9999,0
1668031183779,CSE 293,015,119298,Kane; Daniel Mertz,9999,0,9999,0
1668031183779,CSE 293,016,119299,Kriegman; David J,9999,0,9999,0
1668031183779,CSE 293,017,119300,Kumar; Arun Kumar,9999,0,9999,0
1668031183779,CSE 293,018,119301,Lerner; Sorin,9999,0,9999,0
1668031183779,CSE 293,019,119302,Lovett; Shachar,9999,0,9999,0
1668031183779,CSE 293,020,119303,McAuley; Julian John,9999,0,9999,0
1668031183779,CSE 293,021,119304,Micciancio; Daniele,9999,0,9999,0
1668031183779,CSE 293,022,119367,Orailoglu; Alex,9999,0,9999,0
1668031183779,CSE 293,023,119382,Paturi; Ramamohan,9999,0,9999,0
1668031183779,CSE 293,024,119404,Polikarpova; Nadezhda,9999,0,9999,0
1668031183779,CSE 293,025,119406,Politz; Joseph Gibbs,9999,0,9999,0
1668031183779,CSE 293,026,119411,Porter; George M,9999,0,9999,0
1668031183779,CSE 293,027,119414,Porter; Leonard Emerson,9999,0,9999,0
1668031183779,CSE 293,028,119416,Ramamoorthi; Ravi,9999,0,9999,0
1668031183779,CSE 293,029,119417,Sahoo; Debashis,9999,0,9999,0
1668031183779,CSE 293,030,119420,Saul; Lawrence,9999,0,9999,0
1668031183779,CSE 293,031,119421,Savage; Stefan,9999,0,9999,0
1668031183779,CSE 293,032,119425,Schulze; Jurgen P.,9999,0,9999,0
1668031183779,CSE 293,033,119426,Snoeren; Alex C.,9999,0,9999,0
1668031183779,CSE 293,034,119428,Shang; Jingbo,9999,0,9999,0
1668031183779,CSE 293,035,119430,Stefan; Deian,9999,0,9999,0
1668031183779,CSE 293,036,119431,Su; Hao,9999,0,9999,0
1668031183779,CSE 293,037,119433,Swanson; Steven James,9999,0,9999,0
1668031183779,CSE 293,038,119435,Tullsen; Dean Michael,9999,0,9999,0
1668031183779,CSE 293,039,119483,Voelker; Geoffrey M.,9999,0,9999,0
1668031183779,CSE 293,040,119537,Zhao; Jishen,9999,0,9999,0
1668031183779,CSE 293,041,119538,Zhou; Yuan-Yuan,9999,0,9999,0
1668031183779,CSE 293,042,119539,Gao; Sicun,9999,0,9999,0
1668031183779,CSE 293,043,119540,Weibel; Nadir,9999,0,9999,0
1668031183779,CSE 293,044,119541,Gupta; Rajesh K.,9999,0,9999,0
1668031183779,CSE 293,045,126410,Vaccaro; Kristen Marie,9999,0,9999,0
1668031183779,CSE 293,046,126411,Klemke; Richard,9999,0,9999,0
1668031184207,CSE 294,A00,102459,Voelker; Geoffrey M.,0,0,0,0
1668031184207,CSE 294,B00,111322,Orailoglu; Alex,0,0,0,0
1668031184750,DSE 201,A00,096914,Deutsch; Alin Bernard,30,0,30,0
1668031185185,DSE 210,A00,096915,Dasgupta; Sanjoy,30,0,30,0
1668031185617,DSE 260A,A00,096916,Altintas De Callaf; Ilkay,30,0,30,0
1668031186076,ECE 200,001,103586,Antipa; Nicholas A,9999,0,9999,0
1668031186076,ECE 200,002,103587,Atanasov; Nikolay A.,9999,0,9999,0
1668031186076,ECE 200,003,103588,Bharadia; Dinesh,9999,0,9999,0
1668031186076,ECE 200,004,103589,Cheng; Chung Kuan,9999,0,9999,0
1668031186076,ECE 200,005,103590,Cosman; Pamela C.,9999,0,9999,0
1668031186076,ECE 200,006,103591,Dayeh; Shadi Ahmad,9999,0,9999,0
1668031186076,ECE 200,007,103592,Fainman; Yeshaiahu,9999,0,9999,0
1668031186076,ECE 200,008,103593,Ford; Joseph Earl,9999,0,9999,0
1668031186076,ECE 200,009,103594,Franceschetti; Massimo,9999,0,9999,0
1668031186076,ECE 200,010,103595,Fullerton; Eric E,9999,0,9999,0
1668031186076,ECE 200,011,103596,Galton; Ian A,9999,0,9999,0
1668031186076,ECE 200,012,103597,Gilja; Vikash,9999,0,9999,0
1668031186076,ECE 200,013,103598,Hall; Drew A.,9999,0,9999,0
1668031186076,ECE 200,014,103599,Hsueh; Tzu-Chien,9999,0,9999,0
1668031186076,ECE 200,015,103600,Javidi; Tara,9999,0,9999,0
1668031186076,ECE 200,016,103601,Kahng; Andrew Byun,9999,0,9999,0
1668031186076,ECE 200,017,103602,Kim; Young-Han,9999,0,9999,0
1668031186076,ECE 200,018,103603,Koushanfar; Farinaz,9999,0,9999,0
1668031186076,ECE 200,019,103604,Kuzum; Duygu,9999,0,9999,0
1668031186076,ECE 200,020,103605,Le; Hanh-Phuc,9999,0,9999,0
1668031186076,ECE 200,021,103606,Lin; Bill,9999,0,9999,0
1668031186076,ECE 200,022,103607,Liu; Zhaowei,9998,0,9999,1
1668031186076,ECE 200,023,103608,Lo; Yu-Hwa,9999,0,9999,0
1668031186076,ECE 200,024,103609,Lomakin; Vitaliy,9999,0,9999,0
1668031186076,ECE 200,025,103610,Mercier; Patrick Philip,9999,0,9999,0
1668031186076,ECE 200,026,103611,Meyer; Florian,9999,0,9999,0
1668031186076,ECE 200,027,103612,Milstein; Laurence B.,9999,0,9999,0
1668031186076,ECE 200,028,103613,Mir Arabbaygi; Siavash,9999,0,9999,0
1668031186076,ECE 200,029,103614,Mookherjea; Shayan,9999,0,9999,0
1668031186076,ECE 200,030,103615,Morris; Karcher William,9999,0,9999,0
1668031186076,ECE 200,031,103616,Ng; Tse Nga,9999,0,9999,0
1668031186076,ECE 200,032,103617,Nguyen; Truong Quang,9999,0,9999,0
1668031186076,ECE 200,033,103618,Nomura; Kenji,9999,0,9999,0
1668031186076,ECE 200,034,103619,Orlitsky; Alon,9999,0,9999,0
1668031186076,ECE 200,035,103620,Pal; Piya,9999,0,9999,0
1668031186076,ECE 200,036,103621,Papen; George C.,9999,0,9999,0
1668031186076,ECE 200,037,103622,Radic; Stojan,9999,0,9999,0
1668031186076,ECE 200,038,103623,Rao; Bhaskar D.,9999,0,9999,0
1668031186076,ECE 200,039,103624,Rao; Ramesh R,9999,0,9999,0
1668031186076,ECE 200,040,103625,Rebeiz; Gabriel,9999,0,9999,0
1668031186076,ECE 200,041,103626,Sanford; John R,9999,0,9999,0
1668031186076,ECE 200,042,103627,Siegel; Paul H.,9999,0,9999,0
1668031186076,ECE 200,043,103628,Sievenpiper; Daniel F.,9999,0,9999,0
1668031186076,ECE 200,044,103629,Sworder; David D.,9999,0,9999,0
1668031186076,ECE 200,045,103630,Taur; Yuan,9999,0,9999,0
1668031186076,ECE 200,046,103631,Touri; Behrouz,9999,0,9999,0
1668031186076,ECE 200,047,103632,Trivedi; Mohan M.,9999,0,9999,0
1668031186076,ECE 200,048,103633,Vasconcelos; Nuno,9999,0,9999,0
1668031186076,ECE 200,049,103634,Wang; Xiaolong,9999,0,9999,0
1668031186076,ECE 200,050,103635,Xie; Pengtao,9999,0,9999,0
1668031186076,ECE 200,051,103636,Yip; Michael,9999,0,9999,0
1668031186076,ECE 200,052,103637,Zeger; Kenneth A.,999,0,999,0
1668031186076,ECE 200,053,103638,Zhang; Xinyu,9999,0,9999,0
1668031186076,ECE 200,054,103639,Turakhia; Yatish Girish,9999,0,9999,0
1668031186076,ECE 200,055,103640,Kang; Mingu,9999,0,9999,0
1668031186076,ECE 200,056,103641,Shi; Yuanyuan,9999,0,9999,0
1668031186076,ECE 200,057,103642,Wang; Edward Jay,9999,0,9999,0
1668031186076,ECE 200,058,103643,Zheng; Yang,9999,0,9999,0
1668031186508,ECE 202,A00,103644,Kuzum; Duygu,0,0,0,0
1668031186945,ECE 212BN,A00,103646,Ng; Tse Nga,0,0,0,0
1668031187368,ECE 221,A00,111493,Staff,0,0,0,0
1668031187789,ECE 222B,A00,103647,Lomakin; Vitaliy,0,0,0,0
1668031188223,ECE 230B,A00,103648,Taur; Yuan,0,0,0,0
1668031188647,ECE 238B,A00,103649,Garay; Javier,0,0,0,0
1668031189070,ECE 240B,A00,112900,Fainman; Yeshaiahu,0,0,0,0
1668031189501,ECE 247A,A00,103650,Jokerst; Jesse Vincent,0,0,0,0
1668031189925,ECE 247B,A00,103651,Wang; Joseph,0,0,0,0
1668031190352,ECE 250,A00,103652,Siegel; Paul H.,0,0,0,0
1668031190783,ECE 251A,A00,103654,Rao; Bhaskar D.,0,0,0,0
1668031191220,ECE 257B,A00,103655,Bharadia; Dinesh,0,0,0,0
1668031191648,ECE 258A,A00,103656,Milstein; Laurence B.,0,0,0,0
1668031192071,ECE 260B,A00,103658,Kang; Mingu,0,0,0,0
1668031192509,ECE 264A,A00,103659,Galton; Ian A,0,0,0,0
1668031192938,ECE 265A,A00,103661,Gudem; Prasad S.S.,0,0,0,0
1668031193362,ECE 265D,A00,103662,Gudem; Prasad S.S.,0,0,0,0
1668031193787,ECE 268,A00,103663,Koushanfar; Farinaz,0,0,0,0
1668031194211,ECE 269,A01,103665,Pal; Piya,0,0,0,0
1668031194635,ECE 271B,A00,103666,Vasconcelos; Manuela,0,0,0,0
1668031195059,ECE 276A,A00,103667,Atanasov; Nikolay A.,0,0,0,0
1668031195493,ECE 277,A00,103668,An; Cheolhong,0,0,0,0
1668031195931,ECE 279,A00,117947,Hall; Drew A.,0,0,0,0
1668031196790,ECE 283,A00,103670,Hsueh; Tzu-Chien,0,0,0,0
1668031197216,ECE 284,A00,103671,Turakhia; Yatish Girish,0,0,0,0
1668031197639,ECE 285,A00,103672,Zheng; Yang,0,0,0,0
1668031197639,ECE 285,B00,103673,Sworder; David D.,0,0,0,0
1668031198064,ECE 287,A00,103676,Javidi; Tara,0,0,0,0
1668031198504,MATH 200B,A00,098023,Salehi Golsefidy; Alireza,13,0,15,2
1668031198941,MATH 202B,A00,098024,Rhoades; Brendon Patrick,10,0,15,5
1668031199368,MATH 203B,A00,098025,Oprea; Dragos N.,11,0,15,4
1668031199809,MATH 204B,A00,098026,Sorensen; Claus M,14,0,15,1
1668031200253,MATH 208,A00,098027,Izadi; Elham,7,0,10,3
1668031200680,MATH 209,A00,098028,Pollack; Aaron,10,0,10,0
1668031201120,MATH 211A,A00,112919,Rogalski; Daniel,9,0,10,1
1668031201588,MATH 211B,A00,112920,Seward; Brandon M.,9,0,10,1
1668031202011,MATH 218,A00,098029,Li; Bo,10,0,10,0
1668031202458,MATH 220B,A00,098030,Novak; Jonathan I,13,0,15,2
1668031202888,MATH 221A,A00,098031,Ebenfelt; Peter F,13,0,15,2
1668031203311,MATH 231B,A00,098032,Zlatos; Andrej,12,0,15,3
1668031203760,MATH 240B,A00,098033,Ni; Lei,9,0,15,6
1668031204188,MATH 243,A00,098034,Jekel; David Andrew,10,0,10,0
1668031204611,MATH 245A,A00,098035,Nie; Jiawang,0,0,15,16
1668031205076,MATH 248,A00,098036,Bejenaru; Ioan,10,0,10,0
1668031205523,MATH 250B,A00,098037,Spolaor; Luca,14,0,15,1
1668031205959,MATH 258,A00,098038,Ni; Lei,10,0,10,0
1668031206406,MATH 264B,A00,098041,Rhoades; Brendon Patrick,10,0,15,5
1668031206832,MATH 268,A00,098042,Buss; Samuel R,10,0,10,0
1668031207263,MATH 269,A00,098043,Rhoades; Brendon Patrick,10,0,10,0
1668031207714,MATH 270B,A00,098044,Li; Bo,11,0,15,4
1668031208156,MATH 272B,A00,098045,Holst; Michael J,13,0,15,2
1668031208591,MATH 273A,A00,098046,Tian; Xiaochuan,10,0,15,5
1668031209019,MATH 275,A01,098048,Tian; Xiaochuan,6,0,10,4
1668031209443,MATH 278A,A00,098049,Holst; Michael J,8,0,10,2
1668031209869,MATH 278B,A00,098050,Cloninger; Alexander,10,0,10,0
1668031210298,MATH 278C,A00,098051,Nie; Jiawang,8,0,10,2
1668031210743,MATH 280B,A00,098052,Zheng; Tianyi,11,0,15,4
1668031211198,MATH 281B,A00,098053,Bradic; Jelena,3,0,15,12
1668031211624,MATH 282B,A00,098054,Arias-Castro; Ery,2,0,15,13
1668031212097,MATH 285,A00,098055,Fitzsimmons; Patrick J,0,0,15,17
1668031212526,MATH 287B,A00,098056,Arias-Castro; Ery,4,0,15,11
1668031212958,MATH 288,A00,098057,Agarwal; Pooja,9,0,10,1
1668031212958,MATH 288,B00,098058,Zhang; Danna,9,0,10,1
1668031212958,MATH 288,C00,098059,Williams; Ruth J,10,0,10,0
1668031213392,MATH 290B,A00,098060,Roberts; Justin Deritter,13,0,15,2
1668031213832,MATH 292,A00,098061,Belmont; Eva Kinoshita,10,0,10,0
1668031214269,MATH 295,A00,098062,Suk; Andrew Hoon,48,0,50,2
1668031214708,MATH 296,A00,098063,Novak; Jonathan I,20,0,20,0
1668031215149,MATH 297,001,098064,Gamst; Anthony Collins,9997,0,9999,2
1668031723504,COGS 205,A00,101395,Chiba; Andrea,19,0,20,1
1668031723942,COGS 210B,001,101404,Greene; Deanna Jacquelyn,9998,0,9999,1
1668031723942,COGS 210B,002,101417,Xia; Haijun,9999,0,9999,0
1668031723942,COGS 210B,003,101422,Nitz; Douglas A.,9999,0,9999,0
1668031723942,COGS 210B,004,101423,Hollan; James D.,9998,0,9999,1
1668031723942,COGS 210B,005,101424,Deak; Gedeon O.,9999,0,9999,0
1668031723942,COGS 210B,006,101425,Rossano; Federico,9999,0,9999,0
1668031724366,COGS 211B,A00,101427,Coulson; Seana M,9997,0,9999,2
1668031724790,COGS 220,A00,101428,Hollan; James D.,0,0,25,25
1668031725223,COGS 229,A00,101429,Dow; Steven P,18,0,25,7
1668031725660,COGS 230,A00,101430,Klemmer; Scott R,13,0,17,4
1668031726084,COGS 234,A00,101431,Xia; Haijun,5,0,25,20
1668031726512,COGS 260,A00,101432,Kiyonaga; Anastasia,20,0,25,5
1668031726512,COGS 260,B00,101433,Kirsh; David Joel,16,0,25,9
1668031726944,CSE 202,A00,102371,Impagliazzo; Russell,0,0,0,0
1668031727369,CSE 203B,A01,102373,Cheng; Chung Kuan,0,0,0,0
1668031727793,CSE 208,A00,102374,Micciancio; Daniele,0,0,0,0
1668031728218,CSE 209A,A00,112895,Impagliazzo; Russell,0,0,15,15
1668031728654,CSE 209B,A00,108005,Bellare; Mihir,0,0,0,0
1668031729085,CSE 210,A00,113163,Coblenz; Michael J,0,0,0,0
1668031729531,CSE 219,A00,106111,Dow; Steven P,0,0,20,20
1668031729956,CSE 221,A00,102376,Voelker; Geoffrey M.,0,0,0,0
1668031730382,CSE 224,A01,102378,Porter; George M,0,0,0,0
1668031730804,CSE 229A,A00,102379,Savage; Stefan,0,0,0,0
1668031731235,CSE 229C,A00,102380,Munyaka; Imani N. S.,0,0,0,0
1668031731656,CSE 232B,A00,102382,Deutsch; Alin Bernard,0,0,0,0
1668031732077,CSE 234,A01,112904,Kumar; Arun Kumar,0,0,0,0
1668031732511,CSE 237A,A00,102383,Rosing; Tajana Simunic,0,0,0,0
1668031732946,CSE 239A,A00,102384,Deutsch; Alin Bernard,0,0,0,0
1668031733379,CSE 239B,A00,102385,Polikarpova; Nadezhda,0,0,0,0
1668031733811,CSE 240A,A00,102386,Pannuto; Patrick William,0,0,0,0
1668031734250,CSE 240B,A00,102387,Zhao; Jishen,0,0,0,0
1668031734678,CSE 241A,A00,106406,Kang; Mingu,0,0,0,0
1668031735102,CSE 249B,A00,102388,Kahng; Andrew Byun,0,0,8,8
1668031735530,CSE 251B,A01,102392,Cottrell; Garrison W,0,0,0,0
1668031735530,CSE 251B,A02,102393,Cottrell; Garrison W,0,0,0,0
1668031735958,CSE 252B,A00,102394,Ochoa; Benjamin Lawrence,0,0,0,0
1668031736388,CSE 257,A01,102396,Gao; Sicun,0,0,0,0
1668031736828,CSE 272,A00,102397,Li; Tzumao,0,0,0,0
1668031737268,CSE 274,A00,111323,Chern; Albert Ren-Haur,0,0,0,0
1668031737698,CSE 282,A00,102398,Pevzner; Pavel Arkadjevich,0,0,0,0
1668031738129,CSE 284,A00,114175,Gymrek; Melissa Ann,0,0,0,0
1668031738560,CSE 290,A00,102399,Chandraker; Manmohan Krishna,0,0,0,0
1668031738560,CSE 290,B00,102400,Vaccaro; Kristen Marie,0,0,25,25
1668031738560,CSE 290,C00,102414,Pannuto; Patrick William,0,0,25,25
1668031738560,CSE 290,D00,102427,Pevzner; Pavel Arkadjevich,0,0,0,0
1668031738560,CSE 290,E00,102429,Zhao; Jishen,0,0,0,0
1668031738560,CSE 290,F00,102436,Tullsen; Dean Michael,0,0,0,0
1668031738560,CSE 290,G00,102440,Christensen; Henrik I,0,0,20,20
1668031738994,CSE 291,A00,102443,Su; Hao,0,0,0,0
1668031738994,CSE 291,B00,102448,Polikarpova; Nadezhda,0,0,0,0
1668031738994,CSE 291,C00,102453,Vaccaro; Kristen Marie,0,0,0,0
1668031738994,CSE 291,D00,111343,Savage; Stefan,0,0,0,0
1668031738994,CSE 291,E00,116474,Claffy; Kimberly Claire,0,0,0,0
1668031738994,CSE 291,F00,116479,Pasquale; Joseph,0,0,0,0
1668031739441,CSE 293,001,119111,Bafna; Vineet,9999,0,9999,0
1668031739441,CSE 293,002,119118,Bellare; Mihir,9999,0,9999,0
1668031739441,CSE 293,003,119122,Berg-Kirkpatrick; Taylor D,9999,0,9999,0
1668031739441,CSE 293,004,119135,Christensen; Henrik I,9999,0,9999,0
1668031739441,CSE 293,005,119142,Cottrell; Garrison W,9999,0,9999,0
1668031739441,CSE 293,006,119146,Deutsch; Alin Bernard,9999,0,9999,0
1668031739441,CSE 293,007,119159,Esmaeilzadeh; Hadi,9999,0,9999,0
1668031739441,CSE 293,008,119166,Freund; Yoav,9999,0,9999,0
1668031739441,CSE 293,009,119170,Griswold; William G.,9999,0,9999,0
1668031739441,CSE 293,010,119183,Gymrek; Melissa Ann,9999,0,9999,0
1668031739441,CSE 293,011,119190,Heninger; Nadia A,9999,0,9999,0
1668031739441,CSE 293,012,119230,Impagliazzo; Russell,9999,0,9999,0
1668031739441,CSE 293,013,119232,Jhala; Ranjit,9999,0,9999,0
1668031739441,CSE 293,014,119233,Kahng; Andrew Byun,9999,0,9999,0
1668031739441,CSE 293,015,119298,Kane; Daniel Mertz,9999,0,9999,0
1668031739441,CSE 293,016,119299,Kriegman; David J,9999,0,9999,0
1668031739441,CSE 293,017,119300,Kumar; Arun Kumar,9999,0,9999,0
1668031739441,CSE 293,018,119301,Lerner; Sorin,9999,0,9999,0
1668031739441,CSE 293,019,119302,Lovett; Shachar,9999,0,9999,0
1668031739441,CSE 293,020,119303,McAuley; Julian John,9999,0,9999,0
1668031739441,CSE 293,021,119304,Micciancio; Daniele,9999,0,9999,0
1668031739441,CSE 293,022,119367,Orailoglu; Alex,9999,0,9999,0
1668031739441,CSE 293,023,119382,Paturi; Ramamohan,9999,0,9999,0
1668031739441,CSE 293,024,119404,Polikarpova; Nadezhda,9999,0,9999,0
1668031739441,CSE 293,025,119406,Politz; Joseph Gibbs,9999,0,9999,0
1668031739441,CSE 293,026,119411,Porter; George M,9999,0,9999,0
1668031739441,CSE 293,027,119414,Porter; Leonard Emerson,9999,0,9999,0
1668031739441,CSE 293,028,119416,Ramamoorthi; Ravi,9999,0,9999,0
1668031739441,CSE 293,029,119417,Sahoo; Debashis,9999,0,9999,0
1668031739441,CSE 293,030,119420,Saul; Lawrence,9999,0,9999,0
1668031739441,CSE 293,031,119421,Savage; Stefan,9999,0,9999,0
1668031739441,CSE 293,032,119425,Schulze; Jurgen P.,9999,0,9999,0
1668031739441,CSE 293,033,119426,Snoeren; Alex C.,9999,0,9999,0
1668031739441,CSE 293,034,119428,Shang; Jingbo,9999,0,9999,0
1668031739441,CSE 293,035,119430,Stefan; Deian,9999,0,9999,0
1668031739441,CSE 293,036,119431,Su; Hao,9999,0,9999,0
1668031739441,CSE 293,037,119433,Swanson; Steven James,9999,0,9999,0
1668031739441,CSE 293,038,119435,Tullsen; Dean Michael,9999,0,9999,0
1668031739441,CSE 293,039,119483,Voelker; Geoffrey M.,9999,0,9999,0
1668031739441,CSE 293,040,119537,Zhao; Jishen,9999,0,9999,0
1668031739441,CSE 293,041,119538,Zhou; Yuan-Yuan,9999,0,9999,0
1668031739441,CSE 293,042,119539,Gao; Sicun,9999,0,9999,0
1668031739441,CSE 293,043,119540,Weibel; Nadir,9999,0,9999,0
1668031739441,CSE 293,044,119541,Gupta; Rajesh K.,9999,0,9999,0
1668031739441,CSE 293,045,126410,Vaccaro; Kristen Marie,9999,0,9999,0
1668031739441,CSE 293,046,126411,Klemke; Richard,9999,0,9999,0
1668031739878,CSE 294,A00,102459,Voelker; Geoffrey M.,0,0,0,0
1668031739878,CSE 294,B00,111322,Orailoglu; Alex,0,0,0,0
1668031740301,DSE 201,A00,096914,Deutsch; Alin Bernard,30,0,30,0
1668031740731,DSE 210,A00,096915,Dasgupta; Sanjoy,30,0,30,0
1668031741174,DSE 260A,A00,096916,Altintas De Callaf; Ilkay,30,0,30,0
1668031741618,ECE 200,001,103586,Antipa; Nicholas A,9999,0,9999,0
1668031741618,ECE 200,002,103587,Atanasov; Nikolay A.,9999,0,9999,0
1668031741618,ECE 200,003,103588,Bharadia; Dinesh,9999,0,9999,0
1668031741618,ECE 200,004,103589,Cheng; Chung Kuan,9999,0,9999,0
1668031741618,ECE 200,005,103590,Cosman; Pamela C.,9999,0,9999,0
1668031741618,ECE 200,006,103591,Dayeh; Shadi Ahmad,9999,0,9999,0
1668031741618,ECE 200,007,103592,Fainman; Yeshaiahu,9999,0,9999,0
1668031741618,ECE 200,008,103593,Ford; Joseph Earl,9999,0,9999,0
1668031741618,ECE 200,009,103594,Franceschetti; Massimo,9999,0,9999,0
1668031741618,ECE 200,010,103595,Fullerton; Eric E,9999,0,9999,0
1668031741618,ECE 200,011,103596,Galton; Ian A,9999,0,9999,0
1668031741618,ECE 200,012,103597,Gilja; Vikash,9999,0,9999,0
1668031741618,ECE 200,013,103598,Hall; Drew A.,9999,0,9999,0
1668031741618,ECE 200,014,103599,Hsueh; Tzu-Chien,9999,0,9999,0
1668031741618,ECE 200,015,103600,Javidi; Tara,9999,0,9999,0
1668031741618,ECE 200,016,103601,Kahng; Andrew Byun,9999,0,9999,0
1668031741618,ECE 200,017,103602,Kim; Young-Han,9999,0,9999,0
1668031741618,ECE 200,018,103603,Koushanfar; Farinaz,9999,0,9999,0
1668031741618,ECE 200,019,103604,Kuzum; Duygu,9999,0,9999,0
1668031741618,ECE 200,020,103605,Le; Hanh-Phuc,9999,0,9999,0
1668031741618,ECE 200,021,103606,Lin; Bill,9999,0,9999,0
1668031741618,ECE 200,022,103607,Liu; Zhaowei,9998,0,9999,1
1668031741618,ECE 200,023,103608,Lo; Yu-Hwa,9999,0,9999,0
1668031741618,ECE 200,024,103609,Lomakin; Vitaliy,9999,0,9999,0
1668031741618,ECE 200,025,103610,Mercier; Patrick Philip,9999,0,9999,0
1668031741618,ECE 200,026,103611,Meyer; Florian,9999,0,9999,0
1668031741618,ECE 200,027,103612,Milstein; Laurence B.,9999,0,9999,0
1668031741618,ECE 200,028,103613,Mir Arabbaygi; Siavash,9999,0,9999,0
1668031741618,ECE 200,029,103614,Mookherjea; Shayan,9999,0,9999,0
1668031741618,ECE 200,030,103615,Morris; Karcher William,9999,0,9999,0
1668031741618,ECE 200,031,103616,Ng; Tse Nga,9999,0,9999,0
1668031741618,ECE 200,032,103617,Nguyen; Truong Quang,9999,0,9999,0
1668031741618,ECE 200,033,103618,Nomura; Kenji,9999,0,9999,0
1668031741618,ECE 200,034,103619,Orlitsky; Alon,9999,0,9999,0
1668031741618,ECE 200,035,103620,Pal; Piya,9999,0,9999,0
1668031741618,ECE 200,036,103621,Papen; George C.,9999,0,9999,0
1668031741618,ECE 200,037,103622,Radic; Stojan,9999,0,9999,0
1668031741618,ECE 200,038,103623,Rao; Bhaskar D.,9999,0,9999,0
1668031741618,ECE 200,039,103624,Rao; Ramesh R,9999,0,9999,0
1668031741618,ECE 200,040,103625,Rebeiz; Gabriel,9999,0,9999,0
1668031741618,ECE 200,041,103626,Sanford; John R,9999,0,9999,0
1668031741618,ECE 200,042,103627,Siegel; Paul H.,9999,0,9999,0
1668031741618,ECE 200,043,103628,Sievenpiper; Daniel F.,9999,0,9999,0
1668031741618,ECE 200,044,103629,Sworder; David D.,9999,0,9999,0
1668031741618,ECE 200,045,103630,Taur; Yuan,9999,0,9999,0
1668031741618,ECE 200,046,103631,Touri; Behrouz,9999,0,9999,0
1668031741618,ECE 200,047,103632,Trivedi; Mohan M.,9999,0,9999,0
1668031741618,ECE 200,048,103633,Vasconcelos; Nuno,9999,0,9999,0
1668031741618,ECE 200,049,103634,Wang; Xiaolong,9999,0,9999,0
1668031741618,ECE 200,050,103635,Xie; Pengtao,9999,0,9999,0
1668031741618,ECE 200,051,103636,Yip; Michael,9999,0,9999,0
1668031741618,ECE 200,052,103637,Zeger; Kenneth A.,999,0,999,0
1668031741618,ECE 200,053,103638,Zhang; Xinyu,9999,0,9999,0
1668031741618,ECE 200,054,103639,Turakhia; Yatish Girish,9999,0,9999,0
1668031741618,ECE 200,055,103640,Kang; Mingu,9999,0,9999,0
1668031741618,ECE 200,056,103641,Shi; Yuanyuan,9999,0,9999,0
1668031741618,ECE 200,057,103642,Wang; Edward Jay,9999,0,9999,0
1668031741618,ECE 200,058,103643,Zheng; Yang,9999,0,9999,0
1668031742054,ECE 202,A00,103644,Kuzum; Duygu,0,0,0,0
1668031742487,ECE 212BN,A00,103646,Ng; Tse Nga,0,0,0,0
1668031742910,ECE 221,A00,111493,Staff,0,0,0,0
1668031743337,ECE 222B,A00,103647,Lomakin; Vitaliy,0,0,0,0
1668031743758,ECE 230B,A00,103648,Taur; Yuan,0,0,0,0
1668031744191,ECE 238B,A00,103649,Garay; Javier,0,0,0,0
1668031744618,ECE 240B,A00,112900,Fainman; Yeshaiahu,0,0,0,0
1668031745043,ECE 247A,A00,103650,Jokerst; Jesse Vincent,0,0,0,0
1668031745471,ECE 247B,A00,103651,Wang; Joseph,0,0,0,0
1668031745912,ECE 250,A00,103652,Siegel; Paul H.,0,0,0,0
1668031746338,ECE 251A,A00,103654,Rao; Bhaskar D.,0,0,0,0
1668031746763,ECE 257B,A00,103655,Bharadia; Dinesh,0,0,0,0
1668031747191,ECE 258A,A00,103656,Milstein; Laurence B.,0,0,0,0
1668031747616,ECE 260B,A00,103658,Kang; Mingu,0,0,0,0
1668031748050,ECE 264A,A00,103659,Galton; Ian A,0,0,0,0
1668031748472,ECE 265A,A00,103661,Gudem; Prasad S.S.,0,0,0,0
1668031748895,ECE 265D,A00,103662,Gudem; Prasad S.S.,0,0,0,0
1668031749322,ECE 268,A00,103663,Koushanfar; Farinaz,0,0,0,0
1668031749745,ECE 269,A01,103665,Pal; Piya,0,0,0,0
1668031750169,ECE 271B,A00,103666,Vasconcelos; Manuela,0,0,0,0
1668031750594,ECE 276A,A00,103667,Atanasov; Nikolay A.,0,0,0,0
1668031751027,ECE 277,A00,103668,An; Cheolhong,0,0,0,0
1668031751468,ECE 279,A00,117947,Hall; Drew A.,0,0,0,0
1668031752331,ECE 283,A00,103670,Hsueh; Tzu-Chien,0,0,0,0
1668031752756,ECE 284,A00,103671,Turakhia; Yatish Girish,0,0,0,0
1668031753181,ECE 285,A00,103672,Zheng; Yang,0,0,0,0
1668031753181,ECE 285,B00,103673,Sworder; David D.,0,0,0,0
1668031753604,ECE 287,A00,103676,Javidi; Tara,0,0,0,0
1668031754037,MATH 200B,A00,098023,Salehi Golsefidy; Alireza,13,0,15,2
1668031754468,MATH 202B,A00,098024,Rhoades; Brendon Patrick,10,0,15,5
1668031754906,MATH 203B,A00,098025,Oprea; Dragos N.,11,0,15,4
1668031755328,MATH 204B,A00,098026,Sorensen; Claus M,14,0,15,1
1668031755772,MATH 208,A00,098027,Izadi; Elham,7,0,10,3
1668031756198,MATH 209,A00,098028,Pollack; Aaron,10,0,10,0
1668031756620,MATH 211A,A00,112919,Rogalski; Daniel,9,0,10,1
1668031757150,MATH 211B,A00,112920,Seward; Brandon M.,9,0,10,1
1668031757586,MATH 218,A00,098029,Li; Bo,10,0,10,0
1668031758010,MATH 220B,A00,098030,Novak; Jonathan I,13,0,15,2
1668031758443,MATH 221A,A00,098031,Ebenfelt; Peter F,13,0,15,2
1668031758881,MATH 231B,A00,098032,Zlatos; Andrej,12,0,15,3
1668031759315,MATH 240B,A00,098033,Ni; Lei,9,0,15,6
1668031759737,MATH 243,A00,098034,Jekel; David Andrew,10,0,10,0
1668031760168,MATH 245A,A00,098035,Nie; Jiawang,0,0,15,16
1668031760591,MATH 248,A00,098036,Bejenaru; Ioan,10,0,10,0
1668031761019,MATH 250B,A00,098037,Spolaor; Luca,14,0,15,1
1668031761455,MATH 258,A00,098038,Ni; Lei,10,0,10,0
1668031761893,MATH 264B,A00,098041,Rhoades; Brendon Patrick,10,0,15,5
1668031762327,MATH 268,A00,098042,Buss; Samuel R,10,0,10,0
1668031762751,MATH 269,A00,098043,Rhoades; Brendon Patrick,10,0,10,0
1668031763176,MATH 270B,A00,098044,Li; Bo,11,0,15,4
1668031763597,MATH 272B,A00,098045,Holst; Michael J,13,0,15,2
1668031764024,MATH 273A,A00,098046,Tian; Xiaochuan,10,0,15,5
1668031764467,MATH 275,A01,098048,Tian; Xiaochuan,6,0,10,4
1668031764890,MATH 278A,A00,098049,Holst; Michael J,8,0,10,2
1668031765319,MATH 278B,A00,098050,Cloninger; Alexander,10,0,10,0
1668031765743,MATH 278C,A00,098051,Nie; Jiawang,8,0,10,2
1668031766168,MATH 280B,A00,098052,Zheng; Tianyi,11,0,15,4
1668031766593,MATH 281B,A00,098053,Bradic; Jelena,3,0,15,12
1668031767027,MATH 282B,A00,098054,Arias-Castro; Ery,2,0,15,13
1668031767476,MATH 285,A00,098055,Fitzsimmons; Patrick J,0,0,15,17
1668031767901,MATH 287B,A00,098056,Arias-Castro; Ery,4,0,15,11
1668031768324,MATH 288,A00,098057,Agarwal; Pooja,9,0,10,1
1668031768324,MATH 288,B00,098058,Zhang; Danna,9,0,10,1
1668031768324,MATH 288,C00,098059,Williams; Ruth J,10,0,10,0
1668031768752,MATH 290B,A00,098060,Roberts; Justin Deritter,13,0,15,2
1668031769186,MATH 292,A00,098061,Belmont; Eva Kinoshita,10,0,10,0
1668031769608,MATH 295,A00,098062,Suk; Andrew Hoon,48,0,50,2
1668031770034,MATH 296,A00,098063,Novak; Jonathan I,20,0,20,0
1668031770458,MATH 297,001,098064,Gamst; Anthony Collins,9997,0,9999,2
1668032291074,COGS 205,A00,101395,Chiba; Andrea,19,0,20,1
1668032291510,COGS 210B,001,101404,Greene; Deanna Jacquelyn,9998,0,9999,1
1668032291510,COGS 210B,002,101417,Xia; Haijun,9999,0,9999,0
1668032291510,COGS 210B,003,101422,Nitz; Douglas A.,9999,0,9999,0
1668032291510,COGS 210B,004,101423,Hollan; James D.,9998,0,9999,1
1668032291510,COGS 210B,005,101424,Deak; Gedeon O.,9998,0,9999,1
1668032291510,COGS 210B,006,101425,Rossano; Federico,9999,0,9999,0
1668032291936,COGS 211B,A00,101427,Coulson; Seana M,9996,0,9999,3
1668032292358,COGS 220,A00,101428,Hollan; James D.,0,0,25,25
1668032292782,COGS 229,A00,101429,Dow; Steven P,18,0,25,7
1668032293221,COGS 230,A00,101430,Klemmer; Scott R,13,0,17,4
1668032293648,COGS 234,A00,101431,Xia; Haijun,5,0,25,20
1668032294073,COGS 260,A00,101432,Kiyonaga; Anastasia,19,0,25,6
1668032294073,COGS 260,B00,101433,Kirsh; David Joel,16,0,25,9
1668032294504,CSE 202,A00,102371,Impagliazzo; Russell,0,0,0,0
1668032294928,CSE 203B,A01,102373,Cheng; Chung Kuan,0,0,0,0
1668032295365,CSE 208,A00,102374,Micciancio; Daniele,0,0,0,0
1668032295792,CSE 209A,A00,112895,Impagliazzo; Russell,0,0,15,15
1668032296223,CSE 209B,A00,108005,Bellare; Mihir,0,0,0,0
1668032296657,CSE 210,A00,113163,Coblenz; Michael J,0,0,0,0
1668032297092,CSE 219,A00,106111,Dow; Steven P,0,0,20,20
1668032297520,CSE 221,A00,102376,Voelker; Geoffrey M.,0,0,0,0
1668032298026,CSE 224,A01,102378,Porter; George M,0,0,0,0
1668032298461,CSE 229A,A00,102379,Savage; Stefan,0,0,0,0
1668032298900,CSE 229C,A00,102380,Munyaka; Imani N. S.,0,0,0,0
1668032299327,CSE 232B,A00,102382,Deutsch; Alin Bernard,0,0,0,0
1668032299762,CSE 234,A01,112904,Kumar; Arun Kumar,0,0,0,0
1668032300188,CSE 237A,A00,102383,Rosing; Tajana Simunic,0,0,0,0
1668032300614,CSE 239A,A00,102384,Deutsch; Alin Bernard,0,0,0,0
1668032301039,CSE 239B,A00,102385,Polikarpova; Nadezhda,0,0,0,0
1668032301462,CSE 240A,A00,102386,Pannuto; Patrick William,0,0,0,0
1668032301896,CSE 240B,A00,102387,Zhao; Jishen,0,0,0,0
1668032302324,CSE 241A,A00,106406,Kang; Mingu,0,0,0,0
1668032302748,CSE 249B,A00,102388,Kahng; Andrew Byun,0,0,8,8
1668032303174,CSE 251B,A01,102392,Cottrell; Garrison W,0,0,0,0
1668032303174,CSE 251B,A02,102393,Cottrell; Garrison W,0,0,0,0
1668032303603,CSE 252B,A00,102394,Ochoa; Benjamin Lawrence,0,0,0,0
1668032304032,CSE 257,A01,102396,Gao; Sicun,0,0,0,0
1668032304605,CSE 272,A00,102397,Li; Tzumao,0,0,0,0
1668032305029,CSE 274,A00,111323,Chern; Albert Ren-Haur,0,0,0,0
1668032305451,CSE 282,A00,102398,Pevzner; Pavel Arkadjevich,0,0,0,0
1668032305890,CSE 284,A00,114175,Gymrek; Melissa Ann,0,0,0,0
1668032306315,CSE 290,A00,102399,Chandraker; Manmohan Krishna,0,0,0,0
1668032306315,CSE 290,B00,102400,Vaccaro; Kristen Marie,0,0,25,25
1668032306315,CSE 290,C00,102414,Pannuto; Patrick William,0,0,25,25
1668032306315,CSE 290,D00,102427,Pevzner; Pavel Arkadjevich,0,0,0,0
1668032306315,CSE 290,E00,102429,Zhao; Jishen,0,0,0,0
1668032306315,CSE 290,F00,102436,Tullsen; Dean Michael,0,0,0,0
1668032306315,CSE 290,G00,102440,Christensen; Henrik I,0,0,20,20
1668032306749,CSE 291,A00,102443,Su; Hao,0,0,0,0
1668032306749,CSE 291,B00,102448,Polikarpova; Nadezhda,0,0,0,0
1668032306749,CSE 291,C00,102453,Vaccaro; Kristen Marie,0,0,0,0
1668032306749,CSE 291,D00,111343,Savage; Stefan,0,0,0,0
1668032306749,CSE 291,E00,116474,Claffy; Kimberly Claire,0,0,0,0
1668032306749,CSE 291,F00,116479,Pasquale; Joseph,0,0,0,0
1668032307184,CSE 293,001,119111,Bafna; Vineet,9999,0,9999,0
1668032307184,CSE 293,002,119118,Bellare; Mihir,9999,0,9999,0
1668032307184,CSE 293,003,119122,Berg-Kirkpatrick; Taylor D,9999,0,9999,0
1668032307184,CSE 293,004,119135,Christensen; Henrik I,9999,0,9999,0
1668032307184,CSE 293,005,119142,Cottrell; Garrison W,9999,0,9999,0
1668032307184,CSE 293,006,119146,Deutsch; Alin Bernard,9999,0,9999,0
1668032307184,CSE 293,007,119159,Esmaeilzadeh; Hadi,9999,0,9999,0
1668032307184,CSE 293,008,119166,Freund; Yoav,9999,0,9999,0
1668032307184,CSE 293,009,119170,Griswold; William G.,9999,0,9999,0
1668032307184,CSE 293,010,119183,Gymrek; Melissa Ann,9999,0,9999,0
1668032307184,CSE 293,011,119190,Heninger; Nadia A,9999,0,9999,0
1668032307184,CSE 293,012,119230,Impagliazzo; Russell,9999,0,9999,0
1668032307184,CSE 293,013,119232,Jhala; Ranjit,9999,0,9999,0
1668032307184,CSE 293,014,119233,Kahng; Andrew Byun,9999,0,9999,0
1668032307184,CSE 293,015,119298,Kane; Daniel Mertz,9999,0,9999,0
1668032307184,CSE 293,016,119299,Kriegman; David J,9999,0,9999,0
1668032307184,CSE 293,017,119300,Kumar; Arun Kumar,9999,0,9999,0
1668032307184,CSE 293,018,119301,Lerner; Sorin,9999,0,9999,0
1668032307184,CSE 293,019,119302,Lovett; Shachar,9999,0,9999,0
1668032307184,CSE 293,020,119303,McAuley; Julian John,9999,0,9999,0
1668032307184,CSE 293,021,119304,Micciancio; Daniele,9999,0,9999,0
1668032307184,CSE 293,022,119367,Orailoglu; Alex,9999,0,9999,0
1668032307184,CSE 293,023,119382,Paturi; Ramamohan,9999,0,9999,0
1668032307184,CSE 293,024,119404,Polikarpova; Nadezhda,9999,0,9999,0
1668032307184,CSE 293,025,119406,Politz; Joseph Gibbs,9999,0,9999,0
1668032307184,CSE 293,026,119411,Porter; George M,9999,0,9999,0
1668032307184,CSE 293,027,119414,Porter; Leonard Emerson,9999,0,9999,0
1668032307184,CSE 293,028,119416,Ramamoorthi; Ravi,9999,0,9999,0
1668032307184,CSE 293,029,119417,Sahoo; Debashis,9999,0,9999,0
1668032307184,CSE 293,030,119420,Saul; Lawrence,9999,0,9999,0
1668032307184,CSE 293,031,119421,Savage; Stefan,9999,0,9999,0
1668032307184,CSE 293,032,119425,Schulze; Jurgen P.,9999,0,9999,0
1668032307184,CSE 293,033,119426,Snoeren; Alex C.,9999,0,9999,0
1668032307184,CSE 293,034,119428,Shang; Jingbo,9999,0,9999,0
1668032307184,CSE 293,035,119430,Stefan; Deian,9999,0,9999,0
1668032307184,CSE 293,036,119431,Su; Hao,9999,0,9999,0
1668032307184,CSE 293,037,119433,Swanson; Steven James,9999,0,9999,0
1668032307184,CSE 293,038,119435,Tullsen; Dean Michael,9999,0,9999,0
1668032307184,CSE 293,039,119483,Voelker; Geoffrey M.,9999,0,9999,0
1668032307184,CSE 293,040,119537,Zhao; Jishen,9999,0,9999,0
1668032307184,CSE 293,041,119538,Zhou; Yuan-Yuan,9999,0,9999,0
1668032307184,CSE 293,042,119539,Gao; Sicun,9999,0,9999,0
1668032307184,CSE 293,043,119540,Weibel; Nadir,9999,0,9999,0
1668032307184,CSE 293,044,119541,Gupta; Rajesh K.,9999,0,9999,0
1668032307184,CSE 293,045,126410,Vaccaro; Kristen Marie,9999,0,9999,0
1668032307184,CSE 293,046,126411,Klemke; Richard,9999,0,9999,0
1668032307609,CSE 294,A00,102459,Voelker; Geoffrey M.,0,0,0,0
1668032307609,CSE 294,B00,111322,Orailoglu; Alex,0,0,0,0
1668032308035,DSE 201,A00,096914,Deutsch; Alin Bernard,30,0,30,0
1668032308473,DSE 210,A00,096915,Dasgupta; Sanjoy,30,0,30,0
1668032308902,DSE 260A,A00,096916,Altintas De Callaf; Ilkay,30,0,30,0
1668032309353,ECE 200,001,103586,Antipa; Nicholas A,9999,0,9999,0
1668032309353,ECE 200,002,103587,Atanasov; Nikolay A.,9999,0,9999,0
1668032309353,ECE 200,003,103588,Bharadia; Dinesh,9999,0,9999,0
1668032309353,ECE 200,004,103589,Cheng; Chung Kuan,9999,0,9999,0
1668032309353,ECE 200,005,103590,Cosman; Pamela C.,9999,0,9999,0
1668032309353,ECE 200,006,103591,Dayeh; Shadi Ahmad,9999,0,9999,0
1668032309353,ECE 200,007,103592,Fainman; Yeshaiahu,9999,0,9999,0
1668032309353,ECE 200,008,103593,Ford; Joseph Earl,9999,0,9999,0
1668032309353,ECE 200,009,103594,Franceschetti; Massimo,9999,0,9999,0
1668032309353,ECE 200,010,103595,Fullerton; Eric E,9999,0,9999,0
1668032309353,ECE 200,011,103596,Galton; Ian A,9999,0,9999,0
1668032309353,ECE 200,012,103597,Gilja; Vikash,9999,0,9999,0
1668032309353,ECE 200,013,103598,Hall; Drew A.,9999,0,9999,0
1668032309353,ECE 200,014,103599,Hsueh; Tzu-Chien,9999,0,9999,0
1668032309353,ECE 200,015,103600,Javidi; Tara,9999,0,9999,0
1668032309353,ECE 200,016,103601,Kahng; Andrew Byun,9999,0,9999,0
1668032309353,ECE 200,017,103602,Kim; Young-Han,9999,0,9999,0
1668032309353,ECE 200,018,103603,Koushanfar; Farinaz,9999,0,9999,0
1668032309353,ECE 200,019,103604,Kuzum; Duygu,9999,0,9999,0
1668032309353,ECE 200,020,103605,Le; Hanh-Phuc,9999,0,9999,0
1668032309353,ECE 200,021,103606,Lin; Bill,9999,0,9999,0
1668032309353,ECE 200,022,103607,Liu; Zhaowei,9998,0,9999,1
1668032309353,ECE 200,023,103608,Lo; Yu-Hwa,9999,0,9999,0
1668032309353,ECE 200,024,103609,Lomakin; Vitaliy,9999,0,9999,0
1668032309353,ECE 200,025,103610,Mercier; Patrick Philip,9999,0,9999,0
1668032309353,ECE 200,026,103611,Meyer; Florian,9999,0,9999,0
1668032309353,ECE 200,027,103612,Milstein; Laurence B.,9999,0,9999,0
1668032309353,ECE 200,028,103613,Mir Arabbaygi; Siavash,9999,0,9999,0
1668032309353,ECE 200,029,103614,Mookherjea; Shayan,9999,0,9999,0
1668032309353,ECE 200,030,103615,Morris; Karcher William,9999,0,9999,0
1668032309353,ECE 200,031,103616,Ng; Tse Nga,9999,0,9999,0
1668032309353,ECE 200,032,103617,Nguyen; Truong Quang,9999,0,9999,0
1668032309353,ECE 200,033,103618,Nomura; Kenji,9999,0,9999,0
1668032309353,ECE 200,034,103619,Orlitsky; Alon,9999,0,9999,0
1668032309353,ECE 200,035,103620,Pal; Piya,9999,0,9999,0
1668032309353,ECE 200,036,103621,Papen; George C.,9999,0,9999,0
1668032309353,ECE 200,037,103622,Radic; Stojan,9999,0,9999,0
1668032309353,ECE 200,038,103623,Rao; Bhaskar D.,9999,0,9999,0
1668032309353,ECE 200,039,103624,Rao; Ramesh R,9999,0,9999,0
1668032309353,ECE 200,040,103625,Rebeiz; Gabriel,9999,0,9999,0
1668032309353,ECE 200,041,103626,Sanford; John R,9999,0,9999,0
1668032309353,ECE 200,042,103627,Siegel; Paul H.,9999,0,9999,0
1668032309353,ECE 200,043,103628,Sievenpiper; Daniel F.,9999,0,9999,0
1668032309353,ECE 200,044,103629,Sworder; David D.,9999,0,9999,0
1668032309353,ECE 200,045,103630,Taur; Yuan,9999,0,9999,0
1668032309353,ECE 200,046,103631,Touri; Behrouz,9999,0,9999,0
1668032309353,ECE 200,047,103632,Trivedi; Mohan M.,9999,0,9999,0
1668032309353,ECE 200,048,103633,Vasconcelos; Nuno,9999,0,9999,0
1668032309353,ECE 200,049,103634,Wang; Xiaolong,9999,0,9999,0
1668032309353,ECE 200,050,103635,Xie; Pengtao,9999,0,9999,0
1668032309353,ECE 200,051,103636,Yip; Michael,9999,0,9999,0
1668032309353,ECE 200,052,103637,Zeger; Kenneth A.,999,0,999,0
1668032309353,ECE 200,053,103638,Zhang; Xinyu,9999,0,9999,0
1668032309353,ECE 200,054,103639,Turakhia; Yatish Girish,9999,0,9999,0
1668032309353,ECE 200,055,103640,Kang; Mingu,9999,0,9999,0
1668032309353,ECE 200,056,103641,Shi; Yuanyuan,9999,0,9999,0
1668032309353,ECE 200,057,103642,Wang; Edward Jay,9999,0,9999,0
1668032309353,ECE 200,058,103643,Zheng; Yang,9999,0,9999,0
1668032309785,ECE 202,A00,103644,Kuzum; Duygu,0,0,0,0
1668032310207,ECE 212BN,A00,103646,Ng; Tse Nga,0,0,0,0
1668032310630,ECE 221,A00,111493,Staff,0,0,0,0
1668032311053,ECE 222B,A00,103647,Lomakin; Vitaliy,0,0,0,0
1668032311475,ECE 230B,A00,103648,Taur; Yuan,0,0,0,0
1668032311908,ECE 238B,A00,103649,Garay; Javier,0,0,0,0
1668032312337,ECE 240B,A00,112900,Fainman; Yeshaiahu,0,0,0,0
1668032312764,ECE 247A,A00,103650,Jokerst; Jesse Vincent,0,0,0,0
1668032313190,ECE 247B,A00,103651,Wang; Joseph,0,0,0,0
1668032313630,ECE 250,A00,103652,Siegel; Paul H.,0,0,0,0
1668032314063,ECE 251A,A00,103654,Rao; Bhaskar D.,0,0,0,0
1668032314491,ECE 257B,A00,103655,Bharadia; Dinesh,0,0,0,0
1668032314916,ECE 258A,A00,103656,Milstein; Laurence B.,0,0,0,0
1668032315341,ECE 260B,A00,103658,Kang; Mingu,0,0,0,0
1668032315772,ECE 264A,A00,103659,Galton; Ian A,0,0,0,0
1668032316202,ECE 265A,A00,103661,Gudem; Prasad S.S.,0,0,0,0
1668032316627,ECE 265D,A00,103662,Gudem; Prasad S.S.,0,0,0,0
1668032317058,ECE 268,A00,103663,Koushanfar; Farinaz,0,0,0,0
1668032317482,ECE 269,A01,103665,Pal; Piya,0,0,0,0
1668032317908,ECE 271B,A00,103666,Vasconcelos; Manuela,0,0,0,0
1668032318336,ECE 276A,A00,103667,Atanasov; Nikolay A.,0,0,0,0
1668032318778,ECE 277,A00,103668,An; Cheolhong,0,0,0,0
1668032319211,ECE 279,A00,117947,Hall; Drew A.,0,0,0,0
1668032320068,ECE 283,A00,103670,Hsueh; Tzu-Chien,0,0,0,0
1668032320491,ECE 284,A00,103671,Turakhia; Yatish Girish,0,0,0,0
1668032320918,ECE 285,A00,103672,Zheng; Yang,0,0,0,0
1668032320918,ECE 285,B00,103673,Sworder; David D.,0,0,0,0
1668032321348,ECE 287,A00,103676,Javidi; Tara,0,0,0,0
1668032321772,MATH 200B,A00,098023,Salehi Golsefidy; Alireza,13,0,15,2
1668032322204,MATH 202B,A00,098024,Rhoades; Brendon Patrick,10,0,15,5
1668032322632,MATH 203B,A00,098025,Oprea; Dragos N.,11,0,15,4
1668032323065,MATH 204B,A00,098026,Sorensen; Claus M,14,0,15,1
1668032323491,MATH 208,A00,098027,Izadi; Elham,7,0,10,3
1668032323925,MATH 209,A00,098028,Pollack; Aaron,10,0,10,0
1668032324348,MATH 211A,A00,112919,Rogalski; Daniel,9,0,10,1
1668032324782,MATH 211B,A00,112920,Seward; Brandon M.,9,0,10,1
1668032325215,MATH 218,A00,098029,Li; Bo,10,0,10,0
1668032325658,MATH 220B,A00,098030,Novak; Jonathan I,13,0,15,2
1668032326085,MATH 221A,A00,098031,Ebenfelt; Peter F,13,0,15,2
1668032326508,MATH 231B,A00,098032,Zlatos; Andrej,12,0,15,3
1668032326932,MATH 240B,A00,098033,Ni; Lei,9,0,15,6
1668032327356,MATH 243,A00,098034,Jekel; David Andrew,10,0,10,0
1668032327786,MATH 245A,A00,098035,Nie; Jiawang,0,0,15,16
1668032328210,MATH 248,A00,098036,Bejenaru; Ioan,10,0,10,0
1668032328632,MATH 250B,A00,098037,Spolaor; Luca,14,0,15,1
1668032329069,MATH 258,A00,098038,Ni; Lei,10,0,10,0
1668032329492,MATH 264B,A00,098041,Rhoades; Brendon Patrick,10,0,15,5
1668032329925,MATH 268,A00,098042,Buss; Samuel R,10,0,10,0
1668032330352,MATH 269,A00,098043,Rhoades; Brendon Patrick,10,0,10,0
1668032330773,MATH 270B,A00,098044,Li; Bo,11,0,15,4
1668032331197,MATH 272B,A00,098045,Holst; Michael J,13,0,15,2
1668032331632,MATH 273A,A00,098046,Tian; Xiaochuan,10,0,15,5
1668032332057,MATH 275,A01,098048,Tian; Xiaochuan,6,0,10,4
1668032332481,MATH 278A,A00,098049,Holst; Michael J,8,0,10,2
1668032332909,MATH 278B,A00,098050,Cloninger; Alexander,10,0,10,0
1668032333334,MATH 278C,A00,098051,Nie; Jiawang,8,0,10,2
1668032333768,MATH 280B,A00,098052,Zheng; Tianyi,11,0,15,4
1668032334191,MATH 281B,A00,098053,Bradic; Jelena,3,0,15,12
1668032334630,MATH 282B,A00,098054,Arias-Castro; Ery,2,0,15,13
1668032335057,MATH 285,A00,098055,Fitzsimmons; Patrick J,0,0,15,17
1668032335498,MATH 287B,A00,098056,Arias-Castro; Ery,4,0,15,11
1668032335953,MATH 288,A00,098057,Agarwal; Pooja,9,0,10,1
1668032335953,MATH 288,B00,098058,Zhang; Danna,9,0,10,1
1668032335953,MATH 288,C00,098059,Williams; Ruth J,10,0,10,0
1668032336390,MATH 290B,A00,098060,Roberts; Justin Deritter,13,0,15,2
1668032336821,MATH 292,A00,098061,Belmont; Eva Kinoshita,10,0,10,0
1668032337243,MATH 295,A00,098062,Suk; Andrew Hoon,48,0,50,2
1668032337666,MATH 296,A00,098063,Novak; Jonathan I,20,0,20,0
1668032338104,MATH 297,001,098064,Gamst; Anthony Collins,9997,0,9999,2
1668032844136,COGS 205,A00,101395,Chiba; Andrea,19,0,20,1
1668032844580,COGS 210B,001,101404,Greene; Deanna Jacquelyn,9998,0,9999,1
1668032844580,COGS 210B,002,101417,Xia; Haijun,9999,0,9999,0
1668032844580,COGS 210B,003,101422,Nitz; Douglas A.,9999,0,9999,0
1668032844580,COGS 210B,004,101423,Hollan; James D.,9998,0,9999,1
1668032844580,COGS 210B,005,101424,Deak; Gedeon O.,9998,0,9999,1
1668032844580,COGS 210B,006,101425,Rossano; Federico,9999,0,9999,0
1668032845002,COGS 211B,A00,101427,Coulson; Seana M,9996,0,9999,3
1668032845442,COGS 220,A00,101428,Hollan; James D.,0,0,25,25
1668032845872,COGS 229,A00,101429,Dow; Steven P,18,0,25,7
1668032846307,COGS 230,A00,101430,Klemmer; Scott R,13,0,17,4
1668032846736,COGS 234,A00,101431,Xia; Haijun,5,0,25,20
1668032847160,COGS 260,A00,101432,Kiyonaga; Anastasia,19,0,25,6
1668032847160,COGS 260,B00,101433,Kirsh; David Joel,16,0,25,9
1668032847597,CSE 202,A00,102371,Impagliazzo; Russell,0,0,0,0
1668032848059,CSE 203B,A01,102373,Cheng; Chung Kuan,0,0,0,0
1668032848483,CSE 208,A00,102374,Micciancio; Daniele,0,0,0,0
1668032848909,CSE 209A,A00,112895,Impagliazzo; Russell,0,0,15,15
1668032849335,CSE 209B,A00,108005,Bellare; Mihir,0,0,0,0
1668032849760,CSE 210,A00,113163,Coblenz; Michael J,0,0,0,0
1668032850188,CSE 219,A00,106111,Dow; Steven P,0,0,20,20
1668032850616,CSE 221,A00,102376,Voelker; Geoffrey M.,0,0,0,0
1668032851049,CSE 224,A01,102378,Porter; George M,0,0,0,0
1668032851481,CSE 229A,A00,102379,Savage; Stefan,0,0,0,0
1668032851933,CSE 229C,A00,102380,Munyaka; Imani N. S.,0,0,0,0
1668032852357,CSE 232B,A00,102382,Deutsch; Alin Bernard,0,0,0,0
1668032852805,CSE 234,A01,112904,Kumar; Arun Kumar,0,0,0,0
1668032853228,CSE 237A,A00,102383,Rosing; Tajana Simunic,0,0,0,0
1668032853674,CSE 239A,A00,102384,Deutsch; Alin Bernard,0,0,0,0
1668032854097,CSE 239B,A00,102385,Polikarpova; Nadezhda,0,0,0,0
1668032854534,CSE 240A,A00,102386,Pannuto; Patrick William,0,0,0,0
1668032854958,CSE 240B,A00,102387,Zhao; Jishen,0,0,0,0
1668032855382,CSE 241A,A00,106406,Kang; Mingu,0,0,0,0
1668032855807,CSE 249B,A00,102388,Kahng; Andrew Byun,0,0,8,8
1668032856264,CSE 251B,A01,102392,Cottrell; Garrison W,0,0,0,0
1668032856264,CSE 251B,A02,102393,Cottrell; Garrison W,0,0,0,0
1668032856703,CSE 252B,A00,102394,Ochoa; Benjamin Lawrence,0,0,0,0
1668032857265,CSE 257,A01,102396,Gao; Sicun,0,0,0,0
1668032857706,CSE 272,A00,102397,Li; Tzumao,0,0,0,0
1668032858131,CSE 274,A00,111323,Chern; Albert Ren-Haur,0,0,0,0
1668032858570,CSE 282,A00,102398,Pevzner; Pavel Arkadjevich,0,0,0,0
1668032859001,CSE 284,A00,114175,Gymrek; Melissa Ann,0,0,0,0
1668032859433,CSE 290,A00,102399,Chandraker; Manmohan Krishna,0,0,0,0
1668032859433,CSE 290,B00,102400,Vaccaro; Kristen Marie,0,0,25,25
1668032859433,CSE 290,C00,102414,Pannuto; Patrick William,0,0,25,25
1668032859433,CSE 290,D00,102427,Pevzner; Pavel Arkadjevich,0,0,0,0
1668032859433,CSE 290,E00,102429,Zhao; Jishen,0,0,0,0
1668032859433,CSE 290,F00,102436,Tullsen; Dean Michael,0,0,0,0
1668032859433,CSE 290,G00,102440,Christensen; Henrik I,0,0,20,20
1668032859876,CSE 291,A00,102443,Su; Hao,0,0,0,0
1668032859876,CSE 291,B00,102448,Polikarpova; Nadezhda,0,0,0,0
1668032859876,CSE 291,C00,102453,Vaccaro; Kristen Marie,0,0,0,0
1668032859876,CSE 291,D00,111343,Savage; Stefan,0,0,0,0
1668032859876,CSE 291,E00,116474,Claffy; Kimberly Claire,0,0,0,0
1668032859876,CSE 291,F00,116479,Pasquale; Joseph,0,0,0,0
1668032860347,CSE 293,001,119111,Bafna; Vineet,9999,0,9999,0
1668032860347,CSE 293,002,119118,Bellare; Mihir,9999,0,9999,0
1668032860347,CSE 293,003,119122,Berg-Kirkpatrick; Taylor D,9999,0,9999,0
1668032860347,CSE 293,004,119135,Christensen; Henrik I,9999,0,9999,0
1668032860347,CSE 293,005,119142,Cottrell; Garrison W,9999,0,9999,0
1668032860347,CSE 293,006,119146,Deutsch; Alin Bernard,9999,0,9999,0
1668032860347,CSE 293,007,119159,Esmaeilzadeh; Hadi,9999,0,9999,0
1668032860347,CSE 293,008,119166,Freund; Yoav,9999,0,9999,0
1668032860347,CSE 293,009,119170,Griswold; William G.,9999,0,9999,0
1668032860347,CSE 293,010,119183,Gymrek; Melissa Ann,9999,0,9999,0
1668032860347,CSE 293,011,119190,Heninger; Nadia A,9999,0,9999,0
1668032860347,CSE 293,012,119230,Impagliazzo; Russell,9999,0,9999,0
1668032860347,CSE 293,013,119232,Jhala; Ranjit,9999,0,9999,0
1668032860347,CSE 293,014,119233,Kahng; Andrew Byun,9999,0,9999,0
1668032860347,CSE 293,015,119298,Kane; Daniel Mertz,9999,0,9999,0
1668032860347,CSE 293,016,119299,Kriegman; David J,9999,0,9999,0
1668032860347,CSE 293,017,119300,Kumar; Arun Kumar,9999,0,9999,0
1668032860347,CSE 293,018,119301,Lerner; Sorin,9999,0,9999,0
1668032860347,CSE 293,019,119302,Lovett; Shachar,9999,0,9999,0
1668032860347,CSE 293,020,119303,McAuley; Julian John,9999,0,9999,0
1668032860347,CSE 293,021,119304,Micciancio; Daniele,9999,0,9999,0
1668032860347,CSE 293,022,119367,Orailoglu; Alex,9999,0,9999,0
1668032860347,CSE 293,023,119382,Paturi; Ramamohan,9999,0,9999,0
1668032860347,CSE 293,024,119404,Polikarpova; Nadezhda,9999,0,9999,0
1668032860347,CSE 293,025,119406,Politz; Joseph Gibbs,9999,0,9999,0
1668032860347,CSE 293,026,119411,Porter; George M,9999,0,9999,0
1668032860347,CSE 293,027,119414,Porter; Leonard Emerson,9999,0,9999,0
1668032860347,CSE 293,028,119416,Ramamoorthi; Ravi,9999,0,9999,0
1668032860347,CSE 293,029,119417,Sahoo; Debashis,9999,0,9999,0
1668032860347,CSE 293,030,119420,Saul; Lawrence,9999,0,9999,0
1668032860347,CSE 293,031,119421,Savage; Stefan,9999,0,9999,0
1668032860347,CSE 293,032,119425,Schulze; Jurgen P.,9999,0,9999,0
1668032860347,CSE 293,033,119426,Snoeren; Alex C.,9999,0,9999,0
1668032860347,CSE 293,034,119428,Shang; Jingbo,9999,0,9999,0
1668032860347,CSE 293,035,119430,Stefan; Deian,9999,0,9999,0
1668032860347,CSE 293,036,119431,Su; Hao,9999,0,9999,0
1668032860347,CSE 293,037,119433,Swanson; Steven James,9999,0,9999,0
1668032860347,CSE 293,038,119435,Tullsen; Dean Michael,9999,0,9999,0
1668032860347,CSE 293,039,119483,Voelker; Geoffrey M.,9999,0,9999,0
1668032860347,CSE 293,040,119537,Zhao; Jishen,9999,0,9999,0
1668032860347,CSE 293,041,119538,Zhou; Yuan-Yuan,9999,0,9999,0
1668032860347,CSE 293,042,119539,Gao; Sicun,9999,0,9999,0
1668032860347,CSE 293,043,119540,Weibel; Nadir,9999,0,9999,0
1668032860347,CSE 293,044,119541,Gupta; Rajesh K.,9999,0,9999,0
1668032860347,CSE 293,045,126410,Vaccaro; Kristen Marie,9999,0,9999,0
1668032860347,CSE 293,046,126411,Klemke; Richard,9999,0,9999,0
1668032860769,CSE 294,A00,102459,Voelker; Geoffrey M.,0,0,0,0
1668032860769,CSE 294,B00,111322,Orailoglu; Alex,0,0,0,0
1668032861193,DSE 201,A00,096914,Deutsch; Alin Bernard,30,0,30,0
1668032861630,DSE 210,A00,096915,Dasgupta; Sanjoy,30,0,30,0
1668032862056,DSE 260A,A00,096916,Altintas De Callaf; Ilkay,30,0,30,0
1668032862502,ECE 200,001,103586,Antipa; Nicholas A,9999,0,9999,0
1668032862502,ECE 200,002,103587,Atanasov; Nikolay A.,9999,0,9999,0
1668032862502,ECE 200,003,103588,Bharadia; Dinesh,9999,0,9999,0
1668032862502,ECE 200,004,103589,Cheng; Chung Kuan,9999,0,9999,0
1668032862502,ECE 200,005,103590,Cosman; Pamela C.,9999,0,9999,0
1668032862502,ECE 200,006,103591,Dayeh; Shadi Ahmad,9999,0,9999,0
1668032862502,ECE 200,007,103592,Fainman; Yeshaiahu,9999,0,9999,0
1668032862502,ECE 200,008,103593,Ford; Joseph Earl,9999,0,9999,0
1668032862502,ECE 200,009,103594,Franceschetti; Massimo,9999,0,9999,0
1668032862502,ECE 200,010,103595,Fullerton; Eric E,9999,0,9999,0
1668032862502,ECE 200,011,103596,Galton; Ian A,9999,0,9999,0
1668032862502,ECE 200,012,103597,Gilja; Vikash,9999,0,9999,0
1668032862502,ECE 200,013,103598,Hall; Drew A.,9999,0,9999,0
1668032862502,ECE 200,014,103599,Hsueh; Tzu-Chien,9999,0,9999,0
1668032862502,ECE 200,015,103600,Javidi; Tara,9999,0,9999,0
1668032862502,ECE 200,016,103601,Kahng; Andrew Byun,9999,0,9999,0
1668032862502,ECE 200,017,103602,Kim; Young-Han,9999,0,9999,0
1668032862502,ECE 200,018,103603,Koushanfar; Farinaz,9999,0,9999,0
1668032862502,ECE 200,019,103604,Kuzum; Duygu,9999,0,9999,0
1668032862502,ECE 200,020,103605,Le; Hanh-Phuc,9999,0,9999,0
1668032862502,ECE 200,021,103606,Lin; Bill,9999,0,9999,0
1668032862502,ECE 200,022,103607,Liu; Zhaowei,9998,0,9999,1
1668032862502,ECE 200,023,103608,Lo; Yu-Hwa,9999,0,9999,0
1668032862502,ECE 200,024,103609,Lomakin; Vitaliy,9999,0,9999,0
1668032862502,ECE 200,025,103610,Mercier; Patrick Philip,9999,0,9999,0
1668032862502,ECE 200,026,103611,Meyer; Florian,9999,0,9999,0
1668032862502,ECE 200,027,103612,Milstein; Laurence B.,9999,0,9999,0
1668032862502,ECE 200,028,103613,Mir Arabbaygi; Siavash,9999,0,9999,0
1668032862502,ECE 200,029,103614,Mookherjea; Shayan,9999,0,9999,0
1668032862502,ECE 200,030,103615,Morris; Karcher William,9999,0,9999,0
1668032862502,ECE 200,031,103616,Ng; Tse Nga,9999,0,9999,0
1668032862502,ECE 200,032,103617,Nguyen; Truong Quang,9999,0,9999,0
1668032862502,ECE 200,033,103618,Nomura; Kenji,9999,0,9999,0
1668032862502,ECE 200,034,103619,Orlitsky; Alon,9999,0,9999,0
1668032862502,ECE 200,035,103620,Pal; Piya,9999,0,9999,0
1668032862502,ECE 200,036,103621,Papen; George C.,9999,0,9999,0
1668032862502,ECE 200,037,103622,Radic; Stojan,9999,0,9999,0
1668032862502,ECE 200,038,103623,Rao; Bhaskar D.,9999,0,9999,0
1668032862502,ECE 200,039,103624,Rao; Ramesh R,9999,0,9999,0
1668032862502,ECE 200,040,103625,Rebeiz; Gabriel,9999,0,9999,0
1668032862502,ECE 200,041,103626,Sanford; John R,9999,0,9999,0
1668032862502,ECE 200,042,103627,Siegel; Paul H.,9999,0,9999,0
1668032862502,ECE 200,043,103628,Sievenpiper; Daniel F.,9999,0,9999,0
1668032862502,ECE 200,044,103629,Sworder; David D.,9999,0,9999,0
1668032862502,ECE 200,045,103630,Taur; Yuan,9999,0,9999,0
1668032862502,ECE 200,046,103631,Touri; Behrouz,9999,0,9999,0
1668032862502,ECE 200,047,103632,Trivedi; Mohan M.,9999,0,9999,0
1668032862502,ECE 200,048,103633,Vasconcelos; Nuno,9999,0,9999,0
1668032862502,ECE 200,049,103634,Wang; Xiaolong,9999,0,9999,0
1668032862502,ECE 200,050,103635,Xie; Pengtao,9999,0,9999,0
1668032862502,ECE 200,051,103636,Yip; Michael,9999,0,9999,0
1668032862502,ECE 200,052,103637,Zeger; Kenneth A.,999,0,999,0
1668032862502,ECE 200,053,103638,Zhang; Xinyu,9999,0,9999,0
1668032862502,ECE 200,054,103639,Turakhia; Yatish Girish,9999,0,9999,0
1668032862502,ECE 200,055,103640,Kang; Mingu,9999,0,9999,0
1668032862502,ECE 200,056,103641,Shi; Yuanyuan,9999,0,9999,0
1668032862502,ECE 200,057,103642,Wang; Edward Jay,9999,0,9999,0
1668032862502,ECE 200,058,103643,Zheng; Yang,9999,0,9999,0
1668032862936,ECE 202,A00,103644,Kuzum; Duygu,0,0,0,0
1668032863362,ECE 212BN,A00,103646,Ng; Tse Nga,0,0,0,0
1668032863789,ECE 221,A00,111493,Staff,0,0,0,0
1668032864213,ECE 222B,A00,103647,Lomakin; Vitaliy,0,0,0,0
1668032864637,ECE 230B,A00,103648,Taur; Yuan,0,0,0,0
1668032865070,ECE 238B,A00,103649,Garay; Javier,0,0,0,0
1668032865492,ECE 240B,A00,112900,Fainman; Yeshaiahu,0,0,0,0
1668032865925,ECE 247A,A00,103650,Jokerst; Jesse Vincent,0,0,0,0
1668032866362,ECE 247B,A00,103651,Wang; Joseph,0,0,0,0
1668032866796,ECE 250,A00,103652,Siegel; Paul H.,0,0,0,0
1668032867224,ECE 251A,A00,103654,Rao; Bhaskar D.,0,0,0,0
1668032867653,ECE 257B,A00,103655,Bharadia; Dinesh,0,0,0,0
1668032868170,ECE 258A,A00,103656,Milstein; Laurence B.,0,0,0,0
1668032868595,ECE 260B,A00,103658,Kang; Mingu,0,0,0,0
1668032869021,ECE 264A,A00,103659,Galton; Ian A,0,0,0,0
1668032869452,ECE 265A,A00,103661,Gudem; Prasad S.S.,0,0,0,0
1668032869880,ECE 265D,A00,103662,Gudem; Prasad S.S.,0,0,0,0
1668032870303,ECE 268,A00,103663,Koushanfar; Farinaz,0,0,0,0
1668032870728,ECE 269,A01,103665,Pal; Piya,0,0,0,0
1668032871154,ECE 271B,A00,103666,Vasconcelos; Manuela,0,0,0,0
1668032871591,ECE 276A,A00,103667,Atanasov; Nikolay A.,0,0,0,0
1668032872015,ECE 277,A00,103668,An; Cheolhong,0,0,0,0
1668032872437,ECE 279,A00,117947,Hall; Drew A.,0,0,0,0
1668032873307,ECE 283,A00,103670,Hsueh; Tzu-Chien,0,0,0,0
1668032873731,ECE 284,A00,103671,Turakhia; Yatish Girish,0,0,0,0
1668032874164,ECE 285,A00,103672,Zheng; Yang,0,0,0,0
1668032874164,ECE 285,B00,103673,Sworder; David D.,0,0,0,0
1668032874598,ECE 287,A00,103676,Javidi; Tara,0,0,0,0
1668032875027,MATH 200B,A00,098023,Salehi Golsefidy; Alireza,13,0,15,2
1668032875462,MATH 202B,A00,098024,Rhoades; Brendon Patrick,10,0,15,5
1668032875888,MATH 203B,A00,098025,Oprea; Dragos N.,11,0,15,4
1668032876310,MATH 204B,A00,098026,Sorensen; Claus M,14,0,15,1
1668032876737,MATH 208,A00,098027,Izadi; Elham,7,0,10,3
1668032877258,MATH 209,A00,098028,Pollack; Aaron,10,0,10,0
1668032877685,MATH 211A,A00,112919,Rogalski; Daniel,9,0,10,1
1668032878110,MATH 211B,A00,112920,Seward; Brandon M.,9,0,10,1
1668032878532,MATH 218,A00,098029,Li; Bo,10,0,10,0
1668032878968,MATH 220B,A00,098030,Novak; Jonathan I,13,0,15,2
1668032879392,MATH 221A,A00,098031,Ebenfelt; Peter F,13,0,15,2
1668032879816,MATH 231B,A00,098032,Zlatos; Andrej,12,0,15,3
1668032880251,MATH 240B,A00,098033,Ni; Lei,9,0,15,6
1668032880688,MATH 243,A00,098034,Jekel; David Andrew,10,0,10,0
1668032881111,MATH 245A,A00,098035,Nie; Jiawang,0,0,15,16
1668032881534,MATH 248,A00,098036,Bejenaru; Ioan,10,0,10,0
1668032881958,MATH 250B,A00,098037,Spolaor; Luca,14,0,15,1
1668032882384,MATH 258,A00,098038,Ni; Lei,10,0,10,0
1668032882807,MATH 264B,A00,098041,Rhoades; Brendon Patrick,10,0,15,5
1668032883235,MATH 268,A00,098042,Buss; Samuel R,10,0,10,0
1668032883659,MATH 269,A00,098043,Rhoades; Brendon Patrick,10,0,10,0
1668032884084,MATH 270B,A00,098044,Li; Bo,11,0,15,4
1668032884512,MATH 272B,A00,098045,Holst; Michael J,13,0,15,2
1668032884941,MATH 273A,A00,098046,Tian; Xiaochuan,10,0,15,5
1668032885372,MATH 275,A01,098048,Tian; Xiaochuan,6,0,10,4
1668032885814,MATH 278A,A00,098049,Holst; Michael J,8,0,10,2
1668032886238,MATH 278B,A00,098050,Cloninger; Alexander,10,0,10,0
1668032886664,MATH 278C,A00,098051,Nie; Jiawang,8,0,10,2
1668032887101,MATH 280B,A00,098052,Zheng; Tianyi,11,0,15,4
1668032887534,MATH 281B,A00,098053,Bradic; Jelena,3,0,15,12
1668032887979,MATH 282B,A00,098054,Arias-Castro; Ery,2,0,15,13
1668032888407,MATH 285,A00,098055,Fitzsimmons; Patrick J,0,0,15,17
1668032888847,MATH 287B,A00,098056,Arias-Castro; Ery,4,0,15,11
1668032889337,MATH 288,A00,098057,Agarwal; Pooja,9,0,10,1
1668032889337,MATH 288,B00,098058,Zhang; Danna,9,0,10,1
1668032889337,MATH 288,C00,098059,Williams; Ruth J,10,0,10,0
1668032889767,MATH 290B,A00,098060,Roberts; Justin Deritter,13,0,15,2
1668032890199,MATH 292,A00,098061,Belmont; Eva Kinoshita,10,0,10,0
1668032890622,MATH 295,A00,098062,Suk; Andrew Hoon,48,0,50,2
1668032891074,MATH 296,A00,098063,Novak; Jonathan I,20,0,20,0
1668032891497,MATH 297,001,098064,Gamst; Anthony Collins,9997,0,9999,2
1668033397766,COGS 205,A00,101395,Chiba; Andrea,19,0,20,1
1668033398194,COGS 210B,001,101404,Greene; Deanna Jacquelyn,9998,0,9999,1
1668033398194,COGS 210B,002,101417,Xia; Haijun,9999,0,9999,0
1668033398194,COGS 210B,003,101422,Nitz; Douglas A.,9999,0,9999,0
1668033398194,COGS 210B,004,101423,Hollan; James D.,9998,0,9999,1
1668033398194,COGS 210B,005,101424,Deak; Gedeon O.,9998,0,9999,1
1668033398194,COGS 210B,006,101425,Rossano; Federico,9999,0,9999,0
1668033398619,COGS 211B,A00,101427,Coulson; Seana M,9996,0,9999,3
1668033399043,COGS 220,A00,101428,Hollan; James D.,0,0,25,25
1668033399471,COGS 229,A00,101429,Dow; Steven P,18,0,25,7
1668033399908,COGS 230,A00,101430,Klemmer; Scott R,13,0,17,4
1668033400348,COGS 234,A00,101431,Xia; Haijun,5,0,25,20
1668033400795,COGS 260,A00,101432,Kiyonaga; Anastasia,19,0,25,6
1668033400795,COGS 260,B00,101433,Kirsh; David Joel,16,0,25,9
1668033401221,CSE 202,A00,102371,Impagliazzo; Russell,0,0,0,0
1668033401815,CSE 203B,A01,102373,Cheng; Chung Kuan,0,0,0,0
1668033402246,CSE 208,A00,102374,Micciancio; Daniele,0,0,0,0
1668033402674,CSE 209A,A00,112895,Impagliazzo; Russell,0,0,15,15
1668033403100,CSE 209B,A00,108005,Bellare; Mihir,0,0,0,0
1668033403533,CSE 210,A00,113163,Coblenz; Michael J,0,0,0,0
1668033403961,CSE 219,A00,106111,Dow; Steven P,0,0,20,20
1668033404383,CSE 221,A00,102376,Voelker; Geoffrey M.,0,0,0,0
1668033404807,CSE 224,A01,102378,Porter; George M,0,0,0,0
1668033405249,CSE 229A,A00,102379,Savage; Stefan,0,0,0,0
1668033405688,CSE 229C,A00,102380,Munyaka; Imani N. S.,0,0,0,0
1668033406116,CSE 232B,A00,102382,Deutsch; Alin Bernard,0,0,0,0
1668033406543,CSE 234,A01,112904,Kumar; Arun Kumar,0,0,0,0
1668033406972,CSE 237A,A00,102383,Rosing; Tajana Simunic,0,0,0,0
1668033407404,CSE 239A,A00,102384,Deutsch; Alin Bernard,0,0,0,0
1668033407830,CSE 239B,A00,102385,Polikarpova; Nadezhda,0,0,0,0
1668033408256,CSE 240A,A00,102386,Pannuto; Patrick William,0,0,0,0
1668033408700,CSE 240B,A00,102387,Zhao; Jishen,0,0,0,0
1668033409124,CSE 241A,A00,106406,Kang; Mingu,0,0,0,0
1668033409557,CSE 249B,A00,102388,Kahng; Andrew Byun,0,0,8,8
1668033409995,CSE 251B,A01,102392,Cottrell; Garrison W,0,0,0,0
1668033409995,CSE 251B,A02,102393,Cottrell; Garrison W,0,0,0,0
1668033410423,CSE 252B,A00,102394,Ochoa; Benjamin Lawrence,0,0,0,0
1668033410896,CSE 257,A01,102396,Gao; Sicun,0,0,0,0
1668033411329,CSE 272,A00,102397,Li; Tzumao,0,0,0,0
1668033411774,CSE 274,A00,111323,Chern; Albert Ren-Haur,0,0,0,0
1668033412210,CSE 282,A00,102398,Pevzner; Pavel Arkadjevich,0,0,0,0
1668033412635,CSE 284,A00,114175,Gymrek; Melissa Ann,0,0,0,0
1668033413071,CSE 290,A00,102399,Chandraker; Manmohan Krishna,0,0,0,0
1668033413071,CSE 290,B00,102400,Vaccaro; Kristen Marie,0,0,25,25
1668033413071,CSE 290,C00,102414,Pannuto; Patrick William,0,0,25,25
1668033413071,CSE 290,D00,102427,Pevzner; Pavel Arkadjevich,0,0,0,0
1668033413071,CSE 290,E00,102429,Zhao; Jishen,0,0,0,0
1668033413071,CSE 290,F00,102436,Tullsen; Dean Michael,0,0,0,0
1668033413071,CSE 290,G00,102440,Christensen; Henrik I,0,0,20,20
1668033413496,CSE 291,A00,102443,Su; Hao,0,0,0,0
1668033413496,CSE 291,B00,102448,Polikarpova; Nadezhda,0,0,0,0
1668033413496,CSE 291,C00,102453,Vaccaro; Kristen Marie,0,0,0,0
1668033413496,CSE 291,D00,111343,Savage; Stefan,0,0,0,0
1668033413496,CSE 291,E00,116474,Claffy; Kimberly Claire,0,0,0,0
1668033413496,CSE 291,F00,116479,Pasquale; Joseph,0,0,0,0
1668033413957,CSE 293,001,119111,Bafna; Vineet,9999,0,9999,0
1668033413957,CSE 293,002,119118,Bellare; Mihir,9999,0,9999,0
1668033413957,CSE 293,003,119122,Berg-Kirkpatrick; Taylor D,9999,0,9999,0
1668033413957,CSE 293,004,119135,Christensen; Henrik I,9999,0,9999,0
1668033413957,CSE 293,005,119142,Cottrell; Garrison W,9999,0,9999,0
1668033413957,CSE 293,006,119146,Deutsch; Alin Bernard,9999,0,9999,0
1668033413957,CSE 293,007,119159,Esmaeilzadeh; Hadi,9999,0,9999,0
1668033413957,CSE 293,008,119166,Freund; Yoav,9999,0,9999,0
1668033413957,CSE 293,009,119170,Griswold; William G.,9999,0,9999,0
1668033413957,CSE 293,010,119183,Gymrek; Melissa Ann,9999,0,9999,0
1668033413957,CSE 293,011,119190,Heninger; Nadia A,9999,0,9999,0
1668033413957,CSE 293,012,119230,Impagliazzo; Russell,9999,0,9999,0
1668033413957,CSE 293,013,119232,Jhala; Ranjit,9999,0,9999,0
1668033413957,CSE 293,014,119233,Kahng; Andrew Byun,9999,0,9999,0
1668033413957,CSE 293,015,119298,Kane; Daniel Mertz,9999,0,9999,0
1668033413957,CSE 293,016,119299,Kriegman; David J,9999,0,9999,0
1668033413957,CSE 293,017,119300,Kumar; Arun Kumar,9999,0,9999,0
1668033413957,CSE 293,018,119301,Lerner; Sorin,9999,0,9999,0
1668033413957,CSE 293,019,119302,Lovett; Shachar,9999,0,9999,0
1668033413957,CSE 293,020,119303,McAuley; Julian John,9999,0,9999,0
1668033413957,CSE 293,021,119304,Micciancio; Daniele,9999,0,9999,0
1668033413957,CSE 293,022,119367,Orailoglu; Alex,9999,0,9999,0
1668033413957,CSE 293,023,119382,Paturi; Ramamohan,9999,0,9999,0
1668033413957,CSE 293,024,119404,Polikarpova; Nadezhda,9999,0,9999,0
1668033413957,CSE 293,025,119406,Politz; Joseph Gibbs,9999,0,9999,0
1668033413957,CSE 293,026,119411,Porter; George M,9999,0,9999,0
1668033413957,CSE 293,027,119414,Porter; Leonard Emerson,9999,0,9999,0
1668033413957,CSE 293,028,119416,Ramamoorthi; Ravi,9999,0,9999,0
1668033413957,CSE 293,029,119417,Sahoo; Debashis,9999,0,9999,0
1668033413957,CSE 293,030,119420,Saul; Lawrence,9999,0,9999,0
1668033413957,CSE 293,031,119421,Savage; Stefan,9999,0,9999,0
1668033413957,CSE 293,032,119425,Schulze; Jurgen P.,9999,0,9999,0
1668033413957,CSE 293,033,119426,Snoeren; Alex C.,9999,0,9999,0
1668033413957,CSE 293,034,119428,Shang; Jingbo,9999,0,9999,0
1668033413957,CSE 293,035,119430,Stefan; Deian,9999,0,9999,0
1668033413957,CSE 293,036,119431,Su; Hao,9999,0,9999,0
1668033413957,CSE 293,037,119433,Swanson; Steven James,9999,0,9999,0
1668033413957,CSE 293,038,119435,Tullsen; Dean Michael,9999,0,9999,0
1668033413957,CSE 293,039,119483,Voelker; Geoffrey M.,9999,0,9999,0
1668033413957,CSE 293,040,119537,Zhao; Jishen,9999,0,9999,0
1668033413957,CSE 293,041,119538,Zhou; Yuan-Yuan,9999,0,9999,0
1668033413957,CSE 293,042,119539,Gao; Sicun,9999,0,9999,0
1668033413957,CSE 293,043,119540,Weibel; Nadir,9999,0,9999,0
1668033413957,CSE 293,044,119541,Gupta; Rajesh K.,9999,0,9999,0
1668033413957,CSE 293,045,126410,Vaccaro; Kristen Marie,9999,0,9999,0
1668033413957,CSE 293,046,126411,Klemke; Richard,9999,0,9999,0
1668033414385,CSE 294,A00,102459,Voelker; Geoffrey M.,0,0,0,0
1668033414385,CSE 294,B00,111322,Orailoglu; Alex,0,0,0,0
1668033414815,DSE 201,A00,096914,Deutsch; Alin Bernard,30,0,30,0
1668033415242,DSE 210,A00,096915,Dasgupta; Sanjoy,30,0,30,0
1668033415667,DSE 260A,A00,096916,Altintas De Callaf; Ilkay,30,0,30,0
1668033416114,ECE 200,001,103586,Antipa; Nicholas A,9999,0,9999,0
1668033416114,ECE 200,002,103587,Atanasov; Nikolay A.,9999,0,9999,0
1668033416114,ECE 200,003,103588,Bharadia; Dinesh,9999,0,9999,0
1668033416114,ECE 200,004,103589,Cheng; Chung Kuan,9999,0,9999,0
1668033416114,ECE 200,005,103590,Cosman; Pamela C.,9999,0,9999,0
1668033416114,ECE 200,006,103591,Dayeh; Shadi Ahmad,9999,0,9999,0
1668033416114,ECE 200,007,103592,Fainman; Yeshaiahu,9999,0,9999,0
1668033416114,ECE 200,008,103593,Ford; Joseph Earl,9999,0,9999,0
1668033416114,ECE 200,009,103594,Franceschetti; Massimo,9999,0,9999,0
1668033416114,ECE 200,010,103595,Fullerton; Eric E,9999,0,9999,0
1668033416114,ECE 200,011,103596,Galton; Ian A,9999,0,9999,0
1668033416114,ECE 200,012,103597,Gilja; Vikash,9999,0,9999,0
1668033416114,ECE 200,013,103598,Hall; Drew A.,9999,0,9999,0
1668033416114,ECE 200,014,103599,Hsueh; Tzu-Chien,9999,0,9999,0
1668033416114,ECE 200,015,103600,Javidi; Tara,9999,0,9999,0
1668033416114,ECE 200,016,103601,Kahng; Andrew Byun,9999,0,9999,0
1668033416114,ECE 200,017,103602,Kim; Young-Han,9999,0,9999,0
1668033416114,ECE 200,018,103603,Koushanfar; Farinaz,9999,0,9999,0
1668033416114,ECE 200,019,103604,Kuzum; Duygu,9999,0,9999,0
1668033416114,ECE 200,020,103605,Le; Hanh-Phuc,9999,0,9999,0
1668033416114,ECE 200,021,103606,Lin; Bill,9999,0,9999,0
1668033416114,ECE 200,022,103607,Liu; Zhaowei,9998,0,9999,1
1668033416114,ECE 200,023,103608,Lo; Yu-Hwa,9999,0,9999,0
1668033416114,ECE 200,024,103609,Lomakin; Vitaliy,9999,0,9999,0
1668033416114,ECE 200,025,103610,Mercier; Patrick Philip,9999,0,9999,0
1668033416114,ECE 200,026,103611,Meyer; Florian,9999,0,9999,0
1668033416114,ECE 200,027,103612,Milstein; Laurence B.,9999,0,9999,0
1668033416114,ECE 200,028,103613,Mir Arabbaygi; Siavash,9999,0,9999,0
1668033416114,ECE 200,029,103614,Mookherjea; Shayan,9999,0,9999,0
1668033416114,ECE 200,030,103615,Morris; Karcher William,9999,0,9999,0
1668033416114,ECE 200,031,103616,Ng; Tse Nga,9999,0,9999,0
1668033416114,ECE 200,032,103617,Nguyen; Truong Quang,9999,0,9999,0
1668033416114,ECE 200,033,103618,Nomura; Kenji,9999,0,9999,0
1668033416114,ECE 200,034,103619,Orlitsky; Alon,9999,0,9999,0
1668033416114,ECE 200,035,103620,Pal; Piya,9999,0,9999,0
1668033416114,ECE 200,036,103621,Papen; George C.,9999,0,9999,0
1668033416114,ECE 200,037,103622,Radic; Stojan,9999,0,9999,0
1668033416114,ECE 200,038,103623,Rao; Bhaskar D.,9999,0,9999,0
1668033416114,ECE 200,039,103624,Rao; Ramesh R,9999,0,9999,0
1668033416114,ECE 200,040,103625,Rebeiz; Gabriel,9999,0,9999,0
1668033416114,ECE 200,041,103626,Sanford; John R,9999,0,9999,0
1668033416114,ECE 200,042,103627,Siegel; Paul H.,9999,0,9999,0
1668033416114,ECE 200,043,103628,Sievenpiper; Daniel F.,9999,0,9999,0
1668033416114,ECE 200,044,103629,Sworder; David D.,9999,0,9999,0
1668033416114,ECE 200,045,103630,Taur; Yuan,9999,0,9999,0
1668033416114,ECE 200,046,103631,Touri; Behrouz,9999,0,9999,0
1668033416114,ECE 200,047,103632,Trivedi; Mohan M.,9999,0,9999,0
1668033416114,ECE 200,048,103633,Vasconcelos; Nuno,9999,0,9999,0
1668033416114,ECE 200,049,103634,Wang; Xiaolong,9999,0,9999,0
1668033416114,ECE 200,050,103635,Xie; Pengtao,9999,0,9999,0
1668033416114,ECE 200,051,103636,Yip; Michael,9999,0,9999,0
1668033416114,ECE 200,052,103637,Zeger; Kenneth A.,999,0,999,0
1668033416114,ECE 200,053,103638,Zhang; Xinyu,9999,0,9999,0
1668033416114,ECE 200,054,103639,Turakhia; Yatish Girish,9999,0,9999,0
1668033416114,ECE 200,055,103640,Kang; Mingu,9999,0,9999,0
1668033416114,ECE 200,056,103641,Shi; Yuanyuan,9999,0,9999,0
1668033416114,ECE 200,057,103642,Wang; Edward Jay,9999,0,9999,0
1668033416114,ECE 200,058,103643,Zheng; Yang,9999,0,9999,0
1668033416539,ECE 202,A00,103644,Kuzum; Duygu,0,0,0,0
1668033416968,ECE 212BN,A00,103646,Ng; Tse Nga,0,0,0,0
1668033417400,ECE 221,A00,111493,Staff,0,0,0,0
1668033417826,ECE 222B,A00,103647,Lomakin; Vitaliy,0,0,0,0
1668033418250,ECE 230B,A00,103648,Taur; Yuan,0,0,0,0
1668033418687,ECE 238B,A00,103649,Garay; Javier,0,0,0,0
1668033419110,ECE 240B,A00,112900,Fainman; Yeshaiahu,0,0,0,0
1668033419541,ECE 247A,A00,103650,Jokerst; Jesse Vincent,0,0,0,0
1668033419965,ECE 247B,A00,103651,Wang; Joseph,0,0,0,0
1668033420390,ECE 250,A00,103652,Siegel; Paul H.,0,0,0,0
1668033420827,ECE 251A,A00,103654,Rao; Bhaskar D.,0,0,0,0
1668033421251,ECE 257B,A00,103655,Bharadia; Dinesh,0,0,0,0
1668033421683,ECE 258A,A00,103656,Milstein; Laurence B.,0,0,0,0
1668033422119,ECE 260B,A00,103658,Kang; Mingu,0,0,0,0
1668033422543,ECE 264A,A00,103659,Galton; Ian A,0,0,0,0
1668033422977,ECE 265A,A00,103661,Gudem; Prasad S.S.,0,0,0,0
1668033423418,ECE 265D,A00,103662,Gudem; Prasad S.S.,0,0,0,0
1668033423841,ECE 268,A00,103663,Koushanfar; Farinaz,0,0,0,0
1668033424264,ECE 269,A01,103665,Pal; Piya,0,0,0,0
1668033424695,ECE 271B,A00,103666,Vasconcelos; Manuela,0,0,0,0
1668033425122,ECE 276A,A00,103667,Atanasov; Nikolay A.,0,0,0,0
1668033425547,ECE 277,A00,103668,An; Cheolhong,0,0,0,0
1668033425972,ECE 279,A00,117947,Hall; Drew A.,0,0,0,0
1668033426826,ECE 283,A00,103670,Hsueh; Tzu-Chien,0,0,0,0
1668033427262,ECE 284,A00,103671,Turakhia; Yatish Girish,0,0,0,0
1668033427686,ECE 285,A00,103672,Zheng; Yang,0,0,0,0
1668033427686,ECE 285,B00,103673,Sworder; David D.,0,0,0,0
1668033428108,ECE 287,A00,103676,Javidi; Tara,0,0,0,0
1668033428538,MATH 200B,A00,098023,Salehi Golsefidy; Alireza,13,0,15,2
1668033428978,MATH 202B,A00,098024,Rhoades; Brendon Patrick,10,0,15,5
1668033429403,MATH 203B,A00,098025,Oprea; Dragos N.,11,0,15,4
1668033429842,MATH 204B,A00,098026,Sorensen; Claus M,14,0,15,1
1668033430266,MATH 208,A00,098027,Izadi; Elham,7,0,10,3
1668033430700,MATH 209,A00,098028,Pollack; Aaron,10,0,10,0
1668033431130,MATH 211A,A00,112919,Rogalski; Daniel,9,0,10,1
1668033431555,MATH 211B,A00,112920,Seward; Brandon M.,9,0,10,1
1668033431995,MATH 218,A00,098029,Li; Bo,10,0,10,0
1668033432424,MATH 220B,A00,098030,Novak; Jonathan I,13,0,15,2
1668033432848,MATH 221A,A00,098031,Ebenfelt; Peter F,13,0,15,2
1668033433275,MATH 231B,A00,098032,Zlatos; Andrej,12,0,15,3
1668033433700,MATH 240B,A00,098033,Ni; Lei,9,0,15,6
1668033434141,MATH 243,A00,098034,Jekel; David Andrew,10,0,10,0
1668033434568,MATH 245A,A00,098035,Nie; Jiawang,0,0,15,16
1668033434991,MATH 248,A00,098036,Bejenaru; Ioan,10,0,10,0
1668033435414,MATH 250B,A00,098037,Spolaor; Luca,14,0,15,1
1668033435844,MATH 258,A00,098038,Ni; Lei,10,0,10,0
1668033436278,MATH 264B,A00,098041,Rhoades; Brendon Patrick,10,0,15,5
1668033436700,MATH 268,A00,098042,Buss; Samuel R,10,0,10,0
1668033437139,MATH 269,A00,098043,Rhoades; Brendon Patrick,10,0,10,0
1668033437561,MATH 270B,A00,098044,Li; Bo,11,0,15,4
1668033437990,MATH 272B,A00,098045,Holst; Michael J,13,0,15,2
1668033438495,MATH 273A,A00,098046,Tian; Xiaochuan,10,0,15,5
1668033438930,MATH 275,A01,098048,Tian; Xiaochuan,6,0,10,4
1668033439358,MATH 278A,A00,098049,Holst; Michael J,8,0,10,2
1668033439794,MATH 278B,A00,098050,Cloninger; Alexander,10,0,10,0
1668033440221,MATH 278C,A00,098051,Nie; Jiawang,8,0,10,2
1668033440656,MATH 280B,A00,098052,Zheng; Tianyi,11,0,15,4
1668033441100,MATH 281B,A00,098053,Bradic; Jelena,3,0,15,12
1668033441528,MATH 282B,A00,098054,Arias-Castro; Ery,2,0,15,13
1668033441960,MATH 285,A00,098055,Fitzsimmons; Patrick J,0,0,15,17
1668033442391,MATH 287B,A00,098056,Arias-Castro; Ery,4,0,15,11
1668033442821,MATH 288,A00,098057,Agarwal; Pooja,9,0,10,1
1668033442821,MATH 288,B00,098058,Zhang; Danna,9,0,10,1
1668033442821,MATH 288,C00,098059,Williams; Ruth J,10,0,10,0
1668033443250,MATH 290B,A00,098060,Roberts; Justin Deritter,13,0,15,2
1668033443684,MATH 292,A00,098061,Belmont; Eva Kinoshita,10,0,10,0
1668033444128,MATH 295,A00,098062,Suk; Andrew Hoon,48,0,50,2
1668033444552,MATH 296,A00,098063,Novak; Jonathan I,20,0,20,0
1668033444988,MATH 297,001,098064,Gamst; Anthony Collins,9997,0,9999,2
1668033950514,COGS 205,A00,101395,Chiba; Andrea,19,0,20,1
1668033950953,COGS 210B,001,101404,Greene; Deanna Jacquelyn,9998,0,9999,1
1668033950953,COGS 210B,002,101417,Xia; Haijun,9999,0,9999,0
1668033950953,COGS 210B,003,101422,Nitz; Douglas A.,9999,0,9999,0
1668033950953,COGS 210B,004,101423,Hollan; James D.,9998,0,9999,1
1668033950953,COGS 210B,005,101424,Deak; Gedeon O.,9998,0,9999,1
1668033950953,COGS 210B,006,101425,Rossano; Federico,9999,0,9999,0
1668033951397,COGS 211B,A00,101427,Coulson; Seana M,9996,0,9999,3
1668033951818,COGS 220,A00,101428,Hollan; James D.,0,0,25,25
1668033952260,COGS 229,A00,101429,Dow; Steven P,18,0,25,7
1668033952687,COGS 230,A00,101430,Klemmer; Scott R,13,0,17,4
1668033953110,COGS 234,A00,101431,Xia; Haijun,5,0,25,20
1668033953535,COGS 260,A00,101432,Kiyonaga; Anastasia,19,0,25,6
1668033953535,COGS 260,B00,101433,Kirsh; David Joel,16,0,25,9
1668033953961,CSE 202,A00,102371,Impagliazzo; Russell,0,0,0,0
1668033954384,CSE 203B,A01,102373,Cheng; Chung Kuan,0,0,0,0
1668033954810,CSE 208,A00,102374,Micciancio; Daniele,0,0,0,0
1668033955250,CSE 209A,A00,112895,Impagliazzo; Russell,0,0,15,15
1668033955675,CSE 209B,A00,108005,Bellare; Mihir,0,0,0,0
1668033956107,CSE 210,A00,113163,Coblenz; Michael J,0,0,0,0
1668033956544,CSE 219,A00,106111,Dow; Steven P,0,0,20,20
1668033956969,CSE 221,A00,102376,Voelker; Geoffrey M.,0,0,0,0
1668033957398,CSE 224,A01,102378,Porter; George M,0,0,0,0
1668033957835,CSE 229A,A00,102379,Savage; Stefan,0,0,0,0
1668033958257,CSE 229C,A00,102380,Munyaka; Imani N. S.,0,0,0,0
1668033958702,CSE 232B,A00,102382,Deutsch; Alin Bernard,0,0,0,0
1668033959128,CSE 234,A01,112904,Kumar; Arun Kumar,0,0,0,0
1668033959554,CSE 237A,A00,102383,Rosing; Tajana Simunic,0,0,0,0
1668033959979,CSE 239A,A00,102384,Deutsch; Alin Bernard,0,0,0,0
1668033960402,CSE 239B,A00,102385,Polikarpova; Nadezhda,0,0,0,0
1668033960827,CSE 240A,A00,102386,Pannuto; Patrick William,0,0,0,0
1668033961249,CSE 240B,A00,102387,Zhao; Jishen,0,0,0,0
1668033961697,CSE 241A,A00,106406,Kang; Mingu,0,0,0,0
1668033962120,CSE 249B,A00,102388,Kahng; Andrew Byun,0,0,8,8
1668033962562,CSE 251B,A01,102392,Cottrell; Garrison W,0,0,0,0
1668033962562,CSE 251B,A02,102393,Cottrell; Garrison W,0,0,0,0
1668033962992,CSE 252B,A00,102394,Ochoa; Benjamin Lawrence,0,0,0,0
1668033963423,CSE 257,A01,102396,Gao; Sicun,0,0,0,0
1668033963851,CSE 272,A00,102397,Li; Tzumao,0,0,0,0
1668033964364,CSE 274,A00,111323,Chern; Albert Ren-Haur,0,0,0,0
1668033964803,CSE 282,A00,102398,Pevzner; Pavel Arkadjevich,0,0,0,0
1668033965246,CSE 284,A00,114175,Gymrek; Melissa Ann,0,0,0,0
1668033965671,CSE 290,A00,102399,Chandraker; Manmohan Krishna,0,0,0,0
1668033965671,CSE 290,B00,102400,Vaccaro; Kristen Marie,0,0,25,25
1668033965671,CSE 290,C00,102414,Pannuto; Patrick William,0,0,25,25
1668033965671,CSE 290,D00,102427,Pevzner; Pavel Arkadjevich,0,0,0,0
1668033965671,CSE 290,E00,102429,Zhao; Jishen,0,0,0,0
1668033965671,CSE 290,F00,102436,Tullsen; Dean Michael,0,0,0,0
1668033965671,CSE 290,G00,102440,Christensen; Henrik I,0,0,20,20
1668033966102,CSE 291,A00,102443,Su; Hao,0,0,0,0
1668033966102,CSE 291,B00,102448,Polikarpova; Nadezhda,0,0,0,0
1668033966102,CSE 291,C00,102453,Vaccaro; Kristen Marie,0,0,0,0
1668033966102,CSE 291,D00,111343,Savage; Stefan,0,0,0,0
1668033966102,CSE 291,E00,116474,Claffy; Kimberly Claire,0,0,0,0
1668033966102,CSE 291,F00,116479,Pasquale; Joseph,0,0,0,0
1668033966567,CSE 293,001,119111,Bafna; Vineet,9999,0,9999,0
1668033966567,CSE 293,002,119118,Bellare; Mihir,9999,0,9999,0
1668033966567,CSE 293,003,119122,Berg-Kirkpatrick; Taylor D,9999,0,9999,0
1668033966567,CSE 293,004,119135,Christensen; Henrik I,9999,0,9999,0
1668033966567,CSE 293,005,119142,Cottrell; Garrison W,9999,0,9999,0
1668033966567,CSE 293,006,119146,Deutsch; Alin Bernard,9999,0,9999,0
1668033966567,CSE 293,007,119159,Esmaeilzadeh; Hadi,9999,0,9999,0
1668033966567,CSE 293,008,119166,Freund; Yoav,9999,0,9999,0
1668033966567,CSE 293,009,119170,Griswold; William G.,9999,0,9999,0
1668033966567,CSE 293,010,119183,Gymrek; Melissa Ann,9999,0,9999,0
1668033966567,CSE 293,011,119190,Heninger; Nadia A,9999,0,9999,0
1668033966567,CSE 293,012,119230,Impagliazzo; Russell,9999,0,9999,0
1668033966567,CSE 293,013,119232,Jhala; Ranjit,9999,0,9999,0
1668033966567,CSE 293,014,119233,Kahng; Andrew Byun,9999,0,9999,0
1668033966567,CSE 293,015,119298,Kane; Daniel Mertz,9999,0,9999,0
1668033966567,CSE 293,016,119299,Kriegman; David J,9999,0,9999,0
1668033966567,CSE 293,017,119300,Kumar; Arun Kumar,9999,0,9999,0
1668033966567,CSE 293,018,119301,Lerner; Sorin,9999,0,9999,0
1668033966567,CSE 293,019,119302,Lovett; Shachar,9999,0,9999,0
1668033966567,CSE 293,020,119303,McAuley; Julian John,9999,0,9999,0
1668033966567,CSE 293,021,119304,Micciancio; Daniele,9999,0,9999,0
1668033966567,CSE 293,022,119367,Orailoglu; Alex,9999,0,9999,0
1668033966567,CSE 293,023,119382,Paturi; Ramamohan,9999,0,9999,0
1668033966567,CSE 293,024,119404,Polikarpova; Nadezhda,9999,0,9999,0
1668033966567,CSE 293,025,119406,Politz; Joseph Gibbs,9999,0,9999,0
1668033966567,CSE 293,026,119411,Porter; George M,9999,0,9999,0
1668033966567,CSE 293,027,119414,Porter; Leonard Emerson,9999,0,9999,0
1668033966567,CSE 293,028,119416,Ramamoorthi; Ravi,9999,0,9999,0
1668033966567,CSE 293,029,119417,Sahoo; Debashis,9999,0,9999,0
1668033966567,CSE 293,030,119420,Saul; Lawrence,9999,0,9999,0
1668033966567,CSE 293,031,119421,Savage; Stefan,9999,0,9999,0
1668033966567,CSE 293,032,119425,Schulze; Jurgen P.,9999,0,9999,0
1668033966567,CSE 293,033,119426,Snoeren; Alex C.,9999,0,9999,0
1668033966567,CSE 293,034,119428,Shang; Jingbo,9999,0,9999,0
1668033966567,CSE 293,035,119430,Stefan; Deian,9999,0,9999,0
1668033966567,CSE 293,036,119431,Su; Hao,9999,0,9999,0
1668033966567,CSE 293,037,119433,Swanson; Steven James,9999,0,9999,0
1668033966567,CSE 293,038,119435,Tullsen; Dean Michael,9999,0,9999,0
1668033966567,CSE 293,039,119483,Voelker; Geoffrey M.,9999,0,9999,0
1668033966567,CSE 293,040,119537,Zhao; Jishen,9999,0,9999,0
1668033966567,CSE 293,041,119538,Zhou; Yuan-Yuan,9999,0,9999,0
1668033966567,CSE 293,042,119539,Gao; Sicun,9999,0,9999,0
1668033966567,CSE 293,043,119540,Weibel; Nadir,9999,0,9999,0
1668033966567,CSE 293,044,119541,Gupta; Rajesh K.,9999,0,9999,0
1668033966567,CSE 293,045,126410,Vaccaro; Kristen Marie,9999,0,9999,0
1668033966567,CSE 293,046,126411,Klemke; Richard,9999,0,9999,0
1668033967004,CSE 294,A00,102459,Voelker; Geoffrey M.,0,0,0,0
1668033967004,CSE 294,B00,111322,Orailoglu; Alex,0,0,0,0
1668033967443,DSE 201,A00,096914,Deutsch; Alin Bernard,30,0,30,0
1668033967869,DSE 210,A00,096915,Dasgupta; Sanjoy,30,0,30,0
1668033968295,DSE 260A,A00,096916,Altintas De Callaf; Ilkay,30,0,30,0
1668033968764,ECE 200,001,103586,Antipa; Nicholas A,9999,0,9999,0
1668033968764,ECE 200,002,103587,Atanasov; Nikolay A.,9999,0,9999,0
1668033968764,ECE 200,003,103588,Bharadia; Dinesh,9999,0,9999,0
1668033968764,ECE 200,004,103589,Cheng; Chung Kuan,9999,0,9999,0
1668033968764,ECE 200,005,103590,Cosman; Pamela C.,9999,0,9999,0
1668033968764,ECE 200,006,103591,Dayeh; Shadi Ahmad,9999,0,9999,0
1668033968764,ECE 200,007,103592,Fainman; Yeshaiahu,9999,0,9999,0
1668033968764,ECE 200,008,103593,Ford; Joseph Earl,9999,0,9999,0
1668033968764,ECE 200,009,103594,Franceschetti; Massimo,9999,0,9999,0
1668033968764,ECE 200,010,103595,Fullerton; Eric E,9999,0,9999,0
1668033968764,ECE 200,011,103596,Galton; Ian A,9999,0,9999,0
1668033968764,ECE 200,012,103597,Gilja; Vikash,9999,0,9999,0
1668033968764,ECE 200,013,103598,Hall; Drew A.,9999,0,9999,0
1668033968764,ECE 200,014,103599,Hsueh; Tzu-Chien,9999,0,9999,0
1668033968764,ECE 200,015,103600,Javidi; Tara,9999,0,9999,0
1668033968764,ECE 200,016,103601,Kahng; Andrew Byun,9999,0,9999,0
1668033968764,ECE 200,017,103602,Kim; Young-Han,9999,0,9999,0
1668033968764,ECE 200,018,103603,Koushanfar; Farinaz,9999,0,9999,0
1668033968764,ECE 200,019,103604,Kuzum; Duygu,9999,0,9999,0
1668033968764,ECE 200,020,103605,Le; Hanh-Phuc,9999,0,9999,0
1668033968764,ECE 200,021,103606,Lin; Bill,9999,0,9999,0
1668033968764,ECE 200,022,103607,Liu; Zhaowei,9998,0,9999,1
1668033968764,ECE 200,023,103608,Lo; Yu-Hwa,9999,0,9999,0
1668033968764,ECE 200,024,103609,Lomakin; Vitaliy,9999,0,9999,0
1668033968764,ECE 200,025,103610,Mercier; Patrick Philip,9999,0,9999,0
1668033968764,ECE 200,026,103611,Meyer; Florian,9999,0,9999,0
1668033968764,ECE 200,027,103612,Milstein; Laurence B.,9999,0,9999,0
1668033968764,ECE 200,028,103613,Mir Arabbaygi; Siavash,9999,0,9999,0
1668033968764,ECE 200,029,103614,Mookherjea; Shayan,9999,0,9999,0
1668033968764,ECE 200,030,103615,Morris; Karcher William,9999,0,9999,0
1668033968764,ECE 200,031,103616,Ng; Tse Nga,9999,0,9999,0
1668033968764,ECE 200,032,103617,Nguyen; Truong Quang,9999,0,9999,0
1668033968764,ECE 200,033,103618,Nomura; Kenji,9999,0,9999,0
1668033968764,ECE 200,034,103619,Orlitsky; Alon,9999,0,9999,0
1668033968764,ECE 200,035,103620,Pal; Piya,9999,0,9999,0
1668033968764,ECE 200,036,103621,Papen; George C.,9999,0,9999,0
1668033968764,ECE 200,037,103622,Radic; Stojan,9999,0,9999,0
1668033968764,ECE 200,038,103623,Rao; Bhaskar D.,9999,0,9999,0
1668033968764,ECE 200,039,103624,Rao; Ramesh R,9999,0,9999,0
1668033968764,ECE 200,040,103625,Rebeiz; Gabriel,9999,0,9999,0
1668033968764,ECE 200,041,103626,Sanford; John R,9999,0,9999,0
1668033968764,ECE 200,042,103627,Siegel; Paul H.,9999,0,9999,0
1668033968764,ECE 200,043,103628,Sievenpiper; Daniel F.,9999,0,9999,0
1668033968764,ECE 200,044,103629,Sworder; David D.,9999,0,9999,0
1668033968764,ECE 200,045,103630,Taur; Yuan,9999,0,9999,0
1668033968764,ECE 200,046,103631,Touri; Behrouz,9999,0,9999,0
1668033968764,ECE 200,047,103632,Trivedi; Mohan M.,9999,0,9999,0
1668033968764,ECE 200,048,103633,Vasconcelos; Nuno,9999,0,9999,0
1668033968764,ECE 200,049,103634,Wang; Xiaolong,9999,0,9999,0
1668033968764,ECE 200,050,103635,Xie; Pengtao,9999,0,9999,0
1668033968764,ECE 200,051,103636,Yip; Michael,9999,0,9999,0
1668033968764,ECE 200,052,103637,Zeger; Kenneth A.,999,0,999,0
1668033968764,ECE 200,053,103638,Zhang; Xinyu,9999,0,9999,0
1668033968764,ECE 200,054,103639,Turakhia; Yatish Girish,9999,0,9999,0
1668033968764,ECE 200,055,103640,Kang; Mingu,9999,0,9999,0
1668033968764,ECE 200,056,103641,Shi; Yuanyuan,9999,0,9999,0
1668033968764,ECE 200,057,103642,Wang; Edward Jay,9999,0,9999,0
1668033968764,ECE 200,058,103643,Zheng; Yang,9999,0,9999,0
1668033969199,ECE 202,A00,103644,Kuzum; Duygu,0,0,0,0
1668033969623,ECE 212BN,A00,103646,Ng; Tse Nga,0,0,0,0
1668033970046,ECE 221,A00,111493,Staff,0,0,0,0
1668033970469,ECE 222B,A00,103647,Lomakin; Vitaliy,0,0,0,0
1668033970891,ECE 230B,A00,103648,Taur; Yuan,0,0,0,0
1668033971320,ECE 238B,A00,103649,Garay; Javier,0,0,0,0
1668033971743,ECE 240B,A00,112900,Fainman; Yeshaiahu,0,0,0,0
1668033972166,ECE 247A,A00,103650,Jokerst; Jesse Vincent,0,0,0,0
1668033972591,ECE 247B,A00,103651,Wang; Joseph,0,0,0,0
1668033973018,ECE 250,A00,103652,Siegel; Paul H.,0,0,0,0
1668033973444,ECE 251A,A00,103654,Rao; Bhaskar D.,0,0,0,0
1668033973874,ECE 257B,A00,103655,Bharadia; Dinesh,0,0,0,0
1668033974303,ECE 258A,A00,103656,Milstein; Laurence B.,0,0,0,0
1668033974726,ECE 260B,A00,103658,Kang; Mingu,0,0,0,0
1668033975183,ECE 264A,A00,103659,Galton; Ian A,0,0,0,0
1668033975608,ECE 265A,A00,103661,Gudem; Prasad S.S.,0,0,0,0
1668033976052,ECE 265D,A00,103662,Gudem; Prasad S.S.,0,0,0,0
1668033976485,ECE 268,A00,103663,Koushanfar; Farinaz,0,0,0,0
1668033976920,ECE 269,A01,103665,Pal; Piya,0,0,0,0
1668033977345,ECE 271B,A00,103666,Vasconcelos; Manuela,0,0,0,0
1668033977769,ECE 276A,A00,103667,Atanasov; Nikolay A.,0,0,0,0
1668033978207,ECE 277,A00,103668,An; Cheolhong,0,0,0,0
1668033978642,ECE 279,A00,117947,Hall; Drew A.,0,0,0,0
1668033979499,ECE 283,A00,103670,Hsueh; Tzu-Chien,0,0,0,0
1668033979930,ECE 284,A00,103671,Turakhia; Yatish Girish,0,0,0,0
1668033980355,ECE 285,A00,103672,Zheng; Yang,0,0,0,0
1668033980355,ECE 285,B00,103673,Sworder; David D.,0,0,0,0
1668033980779,ECE 287,A00,103676,Javidi; Tara,0,0,0,0
1668033981207,MATH 200B,A00,098023,Salehi Golsefidy; Alireza,13,0,15,2
1668033981631,MATH 202B,A00,098024,Rhoades; Brendon Patrick,10,0,15,5
1668033982054,MATH 203B,A00,098025,Oprea; Dragos N.,11,0,15,4
1668033982490,MATH 204B,A00,098026,Sorensen; Claus M,14,0,15,1
1668033982921,MATH 208,A00,098027,Izadi; Elham,7,0,10,3
1668033983344,MATH 209,A00,098028,Pollack; Aaron,10,0,10,0
1668033983773,MATH 211A,A00,112919,Rogalski; Daniel,9,0,10,1
1668033984203,MATH 211B,A00,112920,Seward; Brandon M.,9,0,10,1
1668033984625,MATH 218,A00,098029,Li; Bo,10,0,10,0
1668033985058,MATH 220B,A00,098030,Novak; Jonathan I,13,0,15,2
1668033985489,MATH 221A,A00,098031,Ebenfelt; Peter F,13,0,15,2
1668033985921,MATH 231B,A00,098032,Zlatos; Andrej,12,0,15,3
1668033986346,MATH 240B,A00,098033,Ni; Lei,9,0,15,6
1668033986778,MATH 243,A00,098034,Jekel; David Andrew,10,0,10,0
1668033987204,MATH 245A,A00,098035,Nie; Jiawang,0,0,15,16
1668033987627,MATH 248,A00,098036,Bejenaru; Ioan,10,0,10,0
1668033988067,MATH 250B,A00,098037,Spolaor; Luca,14,0,15,1
1668033988498,MATH 258,A00,098038,Ni; Lei,10,0,10,0
1668033988931,MATH 264B,A00,098041,Rhoades; Brendon Patrick,10,0,15,5
1668033989371,MATH 268,A00,098042,Buss; Samuel R,10,0,10,0
1668033989803,MATH 269,A00,098043,Rhoades; Brendon Patrick,10,0,10,0
1668033990232,MATH 270B,A00,098044,Li; Bo,11,0,15,4
1668033990654,MATH 272B,A00,098045,Holst; Michael J,13,0,15,2
1668033991078,MATH 273A,A00,098046,Tian; Xiaochuan,10,0,15,5
1668033991504,MATH 275,A01,098048,Tian; Xiaochuan,6,0,10,4
1668033991941,MATH 278A,A00,098049,Holst; Michael J,8,0,10,2
1668033992364,MATH 278B,A00,098050,Cloninger; Alexander,10,0,10,0
1668033992790,MATH 278C,A00,098051,Nie; Jiawang,8,0,10,2
1668033993215,MATH 280B,A00,098052,Zheng; Tianyi,11,0,15,4
1668033993646,MATH 281B,A00,098053,Bradic; Jelena,3,0,15,12
1668033994073,MATH 282B,A00,098054,Arias-Castro; Ery,2,0,15,13
1668033994505,MATH 285,A00,098055,Fitzsimmons; Patrick J,0,0,15,17
1668033994933,MATH 287B,A00,098056,Arias-Castro; Ery,4,0,15,11
1668033995390,MATH 288,A00,098057,Agarwal; Pooja,9,0,10,1
1668033995390,MATH 288,B00,098058,Zhang; Danna,9,0,10,1
1668033995390,MATH 288,C00,098059,Williams; Ruth J,10,0,10,0
1668033995821,MATH 290B,A00,098060,Roberts; Justin Deritter,13,0,15,2
1668033996247,MATH 292,A00,098061,Belmont; Eva Kinoshita,10,0,10,0
1668033996670,MATH 295,A00,098062,Suk; Andrew Hoon,48,0,50,2
1668033997094,MATH 296,A00,098063,Novak; Jonathan I,20,0,20,0
1668033997520,MATH 297,001,098064,Gamst; Anthony Collins,9997,0,9999,2
1668034514877,COGS 205,A00,101395,Chiba; Andrea,19,0,20,1
1668034515300,COGS 210B,001,101404,Greene; Deanna Jacquelyn,9998,0,9999,1
1668034515300,COGS 210B,002,101417,Xia; Haijun,9999,0,9999,0
1668034515300,COGS 210B,003,101422,Nitz; Douglas A.,9999,0,9999,0
1668034515300,COGS 210B,004,101423,Hollan; James D.,9998,0,9999,1
1668034515300,COGS 210B,005,101424,Deak; Gedeon O.,9998,0,9999,1
1668034515300,COGS 210B,006,101425,Rossano; Federico,9999,0,9999,0
1668034515721,COGS 211B,A00,101427,Coulson; Seana M,9996,0,9999,3
1668034516144,COGS 220,A00,101428,Hollan; James D.,0,0,25,25
1668034516570,COGS 229,A00,101429,Dow; Steven P,18,0,25,7
1668034517010,COGS 230,A00,101430,Klemmer; Scott R,13,0,17,4
1668034517449,COGS 234,A00,101431,Xia; Haijun,5,0,25,20
1668034517885,COGS 260,A00,101432,Kiyonaga; Anastasia,19,0,25,6
1668034517885,COGS 260,B00,101433,Kirsh; David Joel,16,0,25,9
1668034518315,CSE 202,A00,102371,Impagliazzo; Russell,0,0,0,0
1668034518738,CSE 203B,A01,102373,Cheng; Chung Kuan,0,0,0,0
1668034519169,CSE 208,A00,102374,Micciancio; Daniele,0,0,0,0
1668034519602,CSE 209A,A00,112895,Impagliazzo; Russell,0,0,15,15
1668034520028,CSE 209B,A00,108005,Bellare; Mihir,0,0,0,0
1668034520453,CSE 210,A00,113163,Coblenz; Michael J,0,0,0,0
1668034520884,CSE 219,A00,106111,Dow; Steven P,0,0,20,20
1668034521316,CSE 221,A00,102376,Voelker; Geoffrey M.,0,0,0,0
1668034521742,CSE 224,A01,102378,Porter; George M,0,0,0,0
1668034522169,CSE 229A,A00,102379,Savage; Stefan,0,0,0,0
1668034522593,CSE 229C,A00,102380,Munyaka; Imani N. S.,0,0,0,0
1668034523042,CSE 232B,A00,102382,Deutsch; Alin Bernard,0,0,0,0
1668034523467,CSE 234,A01,112904,Kumar; Arun Kumar,0,0,0,0
1668034523902,CSE 237A,A00,102383,Rosing; Tajana Simunic,0,0,0,0
1668034524342,CSE 239A,A00,102384,Deutsch; Alin Bernard,0,0,0,0
1668034524769,CSE 239B,A00,102385,Polikarpova; Nadezhda,0,0,0,0
1668034525198,CSE 240A,A00,102386,Pannuto; Patrick William,0,0,0,0
1668034525619,CSE 240B,A00,102387,Zhao; Jishen,0,0,0,0
1668034526041,CSE 241A,A00,106406,Kang; Mingu,0,0,0,0
1668034526463,CSE 249B,A00,102388,Kahng; Andrew Byun,0,0,8,8
1668034526887,CSE 251B,A01,102392,Cottrell; Garrison W,0,0,0,0
1668034526887,CSE 251B,A02,102393,Cottrell; Garrison W,0,0,0,0
1668034527327,CSE 252B,A00,102394,Ochoa; Benjamin Lawrence,0,0,0,0
1668034527751,CSE 257,A01,102396,Gao; Sicun,0,0,0,0
1668034528173,CSE 272,A00,102397,Li; Tzumao,0,0,0,0
1668034528600,CSE 274,A00,111323,Chern; Albert Ren-Haur,0,0,0,0
1668034529046,CSE 282,A00,102398,Pevzner; Pavel Arkadjevich,0,0,0,0
1668034529471,CSE 284,A00,114175,Gymrek; Melissa Ann,0,0,0,0
1668034529901,CSE 290,A00,102399,Chandraker; Manmohan Krishna,0,0,0,0
1668034529901,CSE 290,B00,102400,Vaccaro; Kristen Marie,0,0,25,25
1668034529901,CSE 290,C00,102414,Pannuto; Patrick William,0,0,25,25
1668034529901,CSE 290,D00,102427,Pevzner; Pavel Arkadjevich,0,0,0,0
1668034529901,CSE 290,E00,102429,Zhao; Jishen,0,0,0,0
1668034529901,CSE 290,F00,102436,Tullsen; Dean Michael,0,0,0,0
1668034529901,CSE 290,G00,102440,Christensen; Henrik I,0,0,20,20
1668034530361,CSE 291,A00,102443,Su; Hao,0,0,0,0
1668034530361,CSE 291,B00,102448,Polikarpova; Nadezhda,0,0,0,0
1668034530361,CSE 291,C00,102453,Vaccaro; Kristen Marie,0,0,0,0
1668034530361,CSE 291,D00,111343,Savage; Stefan,0,0,0,0
1668034530361,CSE 291,E00,116474,Claffy; Kimberly Claire,0,0,0,0
1668034530361,CSE 291,F00,116479,Pasquale; Joseph,0,0,0,0
1668034530787,CSE 293,001,119111,Bafna; Vineet,9999,0,9999,0
1668034530787,CSE 293,002,119118,Bellare; Mihir,9999,0,9999,0
1668034530787,CSE 293,003,119122,Berg-Kirkpatrick; Taylor D,9999,0,9999,0
1668034530787,CSE 293,004,119135,Christensen; Henrik I,9999,0,9999,0
1668034530787,CSE 293,005,119142,Cottrell; Garrison W,9999,0,9999,0
1668034530787,CSE 293,006,119146,Deutsch; Alin Bernard,9999,0,9999,0
1668034530787,CSE 293,007,119159,Esmaeilzadeh; Hadi,9999,0,9999,0
1668034530787,CSE 293,008,119166,Freund; Yoav,9999,0,9999,0
1668034530787,CSE 293,009,119170,Griswold; William G.,9999,0,9999,0
1668034530787,CSE 293,010,119183,Gymrek; Melissa Ann,9999,0,9999,0
1668034530787,CSE 293,011,119190,Heninger; Nadia A,9999,0,9999,0
1668034530787,CSE 293,012,119230,Impagliazzo; Russell,9999,0,9999,0
1668034530787,CSE 293,013,119232,Jhala; Ranjit,9999,0,9999,0
1668034530787,CSE 293,014,119233,Kahng; Andrew Byun,9999,0,9999,0
1668034530787,CSE 293,015,119298,Kane; Daniel Mertz,9999,0,9999,0
1668034530787,CSE 293,016,119299,Kriegman; David J,9999,0,9999,0
1668034530787,CSE 293,017,119300,Kumar; Arun Kumar,9999,0,9999,0
1668034530787,CSE 293,018,119301,Lerner; Sorin,9999,0,9999,0
1668034530787,CSE 293,019,119302,Lovett; Shachar,9999,0,9999,0
1668034530787,CSE 293,020,119303,McAuley; Julian John,9999,0,9999,0
1668034530787,CSE 293,021,119304,Micciancio; Daniele,9999,0,9999,0
1668034530787,CSE 293,022,119367,Orailoglu; Alex,9999,0,9999,0
1668034530787,CSE 293,023,119382,Paturi; Ramamohan,9999,0,9999,0
1668034530787,CSE 293,024,119404,Polikarpova; Nadezhda,9999,0,9999,0
1668034530787,CSE 293,025,119406,Politz; Joseph Gibbs,9999,0,9999,0
1668034530787,CSE 293,026,119411,Porter; George M,9999,0,9999,0
1668034530787,CSE 293,027,119414,Porter; Leonard Emerson,9999,0,9999,0
1668034530787,CSE 293,028,119416,Ramamoorthi; Ravi,9999,0,9999,0
1668034530787,CSE 293,029,119417,Sahoo; Debashis,9999,0,9999,0
1668034530787,CSE 293,030,119420,Saul; Lawrence,9999,0,9999,0
1668034530787,CSE 293,031,119421,Savage; Stefan,9999,0,9999,0
1668034530787,CSE 293,032,119425,Schulze; Jurgen P.,9999,0,9999,0
1668034530787,CSE 293,033,119426,Snoeren; Alex C.,9999,0,9999,0
1668034530787,CSE 293,034,119428,Shang; Jingbo,9999,0,9999,0
1668034530787,CSE 293,035,119430,Stefan; Deian,9999,0,9999,0
1668034530787,CSE 293,036,119431,Su; Hao,9999,0,9999,0
1668034530787,CSE 293,037,119433,Swanson; Steven James,9999,0,9999,0
1668034530787,CSE 293,038,119435,Tullsen; Dean Michael,9999,0,9999,0
1668034530787,CSE 293,039,119483,Voelker; Geoffrey M.,9999,0,9999,0
1668034530787,CSE 293,040,119537,Zhao; Jishen,9999,0,9999,0
1668034530787,CSE 293,041,119538,Zhou; Yuan-Yuan,9999,0,9999,0
1668034530787,CSE 293,042,119539,Gao; Sicun,9999,0,9999,0
1668034530787,CSE 293,043,119540,Weibel; Nadir,9999,0,9999,0
1668034530787,CSE 293,044,119541,Gupta; Rajesh K.,9999,0,9999,0
1668034530787,CSE 293,045,126410,Vaccaro; Kristen Marie,9999,0,9999,0
1668034530787,CSE 293,046,126411,Klemke; Richard,9999,0,9999,0
1668034531221,CSE 294,A00,102459,Voelker; Geoffrey M.,0,0,0,0
1668034531221,CSE 294,B00,111322,Orailoglu; Alex,0,0,0,0
1668034531653,DSE 201,A00,096914,Deutsch; Alin Bernard,30,0,30,0
1668034532084,DSE 210,A00,096915,Dasgupta; Sanjoy,30,0,30,0
1668034532507,DSE 260A,A00,096916,Altintas De Callaf; Ilkay,30,0,30,0
1668034532944,ECE 200,001,103586,Antipa; Nicholas A,9999,0,9999,0
1668034532944,ECE 200,002,103587,Atanasov; Nikolay A.,9999,0,9999,0
1668034532944,ECE 200,003,103588,Bharadia; Dinesh,9999,0,9999,0
1668034532944,ECE 200,004,103589,Cheng; Chung Kuan,9999,0,9999,0
1668034532944,ECE 200,005,103590,Cosman; Pamela C.,9999,0,9999,0
1668034532944,ECE 200,006,103591,Dayeh; Shadi Ahmad,9999,0,9999,0
1668034532944,ECE 200,007,103592,Fainman; Yeshaiahu,9999,0,9999,0
1668034532944,ECE 200,008,103593,Ford; Joseph Earl,9999,0,9999,0
1668034532944,ECE 200,009,103594,Franceschetti; Massimo,9999,0,9999,0
1668034532944,ECE 200,010,103595,Fullerton; Eric E,9999,0,9999,0
1668034532944,ECE 200,011,103596,Galton; Ian A,9999,0,9999,0
1668034532944,ECE 200,012,103597,Gilja; Vikash,9999,0,9999,0
1668034532944,ECE 200,013,103598,Hall; Drew A.,9999,0,9999,0
1668034532944,ECE 200,014,103599,Hsueh; Tzu-Chien,9999,0,9999,0
1668034532944,ECE 200,015,103600,Javidi; Tara,9999,0,9999,0
1668034532944,ECE 200,016,103601,Kahng; Andrew Byun,9999,0,9999,0
1668034532944,ECE 200,017,103602,Kim; Young-Han,9999,0,9999,0
1668034532944,ECE 200,018,103603,Koushanfar; Farinaz,9999,0,9999,0
1668034532944,ECE 200,019,103604,Kuzum; Duygu,9999,0,9999,0
1668034532944,ECE 200,020,103605,Le; Hanh-Phuc,9999,0,9999,0
1668034532944,ECE 200,021,103606,Lin; Bill,9999,0,9999,0
1668034532944,ECE 200,022,103607,Liu; Zhaowei,9998,0,9999,1
1668034532944,ECE 200,023,103608,Lo; Yu-Hwa,9999,0,9999,0
1668034532944,ECE 200,024,103609,Lomakin; Vitaliy,9999,0,9999,0
1668034532944,ECE 200,025,103610,Mercier; Patrick Philip,9999,0,9999,0
1668034532944,ECE 200,026,103611,Meyer; Florian,9999,0,9999,0
1668034532944,ECE 200,027,103612,Milstein; Laurence B.,9999,0,9999,0
1668034532944,ECE 200,028,103613,Mir Arabbaygi; Siavash,9999,0,9999,0
1668034532944,ECE 200,029,103614,Mookherjea; Shayan,9999,0,9999,0
1668034532944,ECE 200,030,103615,Morris; Karcher William,9999,0,9999,0
1668034532944,ECE 200,031,103616,Ng; Tse Nga,9999,0,9999,0
1668034532944,ECE 200,032,103617,Nguyen; Truong Quang,9999,0,9999,0
1668034532944,ECE 200,033,103618,Nomura; Kenji,9999,0,9999,0
1668034532944,ECE 200,034,103619,Orlitsky; Alon,9999,0,9999,0
1668034532944,ECE 200,035,103620,Pal; Piya,9999,0,9999,0
1668034532944,ECE 200,036,103621,Papen; George C.,9999,0,9999,0
1668034532944,ECE 200,037,103622,Radic; Stojan,9999,0,9999,0
1668034532944,ECE 200,038,103623,Rao; Bhaskar D.,9999,0,9999,0
1668034532944,ECE 200,039,103624,Rao; Ramesh R,9999,0,9999,0
1668034532944,ECE 200,040,103625,Rebeiz; Gabriel,9999,0,9999,0
1668034532944,ECE 200,041,103626,Sanford; John R,9999,0,9999,0
1668034532944,ECE 200,042,103627,Siegel; Paul H.,9999,0,9999,0
1668034532944,ECE 200,043,103628,Sievenpiper; Daniel F.,9999,0,9999,0
1668034532944,ECE 200,044,103629,Sworder; David D.,9999,0,9999,0
1668034532944,ECE 200,045,103630,Taur; Yuan,9999,0,9999,0
1668034532944,ECE 200,046,103631,Touri; Behrouz,9999,0,9999,0
1668034532944,ECE 200,047,103632,Trivedi; Mohan M.,9999,0,9999,0
1668034532944,ECE 200,048,103633,Vasconcelos; Nuno,9999,0,9999,0
1668034532944,ECE 200,049,103634,Wang; Xiaolong,9999,0,9999,0
1668034532944,ECE 200,050,103635,Xie; Pengtao,9999,0,9999,0
1668034532944,ECE 200,051,103636,Yip; Michael,9999,0,9999,0
1668034532944,ECE 200,052,103637,Zeger; Kenneth A.,999,0,999,0
1668034532944,ECE 200,053,103638,Zhang; Xinyu,9999,0,9999,0
1668034532944,ECE 200,054,103639,Turakhia; Yatish Girish,9999,0,9999,0
1668034532944,ECE 200,055,103640,Kang; Mingu,9999,0,9999,0
1668034532944,ECE 200,056,103641,Shi; Yuanyuan,9999,0,9999,0
1668034532944,ECE 200,057,103642,Wang; Edward Jay,9999,0,9999,0
1668034532944,ECE 200,058,103643,Zheng; Yang,9999,0,9999,0
1668034533367,ECE 202,A00,103644,Kuzum; Duygu,0,0,0,0
1668034533790,ECE 212BN,A00,103646,Ng; Tse Nga,0,0,0,0
1668034534217,ECE 221,A00,111493,Staff,0,0,0,0
1668034534644,ECE 222B,A00,103647,Lomakin; Vitaliy,0,0,0,0
1668034535087,ECE 230B,A00,103648,Taur; Yuan,0,0,0,0
1668034535527,ECE 238B,A00,103649,Garay; Javier,0,0,0,0
1668034535965,ECE 240B,A00,112900,Fainman; Yeshaiahu,0,0,0,0
1668034536405,ECE 247A,A00,103650,Jokerst; Jesse Vincent,0,0,0,0
1668034536833,ECE 247B,A00,103651,Wang; Joseph,0,0,0,0
1668034537277,ECE 250,A00,103652,Siegel; Paul H.,0,0,0,0
1668034537706,ECE 251A,A00,103654,Rao; Bhaskar D.,0,0,0,0
1668034538150,ECE 257B,A00,103655,Bharadia; Dinesh,0,0,0,0
1668034538579,ECE 258A,A00,103656,Milstein; Laurence B.,0,0,0,0
1668034539009,ECE 260B,A00,103658,Kang; Mingu,0,0,0,0
1668034539436,ECE 264A,A00,103659,Galton; Ian A,0,0,0,0
1668034539872,ECE 265A,A00,103661,Gudem; Prasad S.S.,0,0,0,0
1668034540296,ECE 265D,A00,103662,Gudem; Prasad S.S.,0,0,0,0
1668034540727,ECE 268,A00,103663,Koushanfar; Farinaz,0,0,0,0
1668034541160,ECE 269,A01,103665,Pal; Piya,0,0,0,0
1668034541586,ECE 271B,A00,103666,Vasconcelos; Manuela,0,0,0,0
1668034542014,ECE 276A,A00,103667,Atanasov; Nikolay A.,0,0,0,0
1668034542437,ECE 277,A00,103668,An; Cheolhong,0,0,0,0
1668034542867,ECE 279,A00,117947,Hall; Drew A.,0,0,0,0
1668034543723,ECE 283,A00,103670,Hsueh; Tzu-Chien,0,0,0,0
1668034544174,ECE 284,A00,103671,Turakhia; Yatish Girish,0,0,0,0
1668034544607,ECE 285,A00,103672,Zheng; Yang,0,0,0,0
1668034544607,ECE 285,B00,103673,Sworder; David D.,0,0,0,0
1668034545031,ECE 287,A00,103676,Javidi; Tara,0,0,0,0
1668034545622,MATH 200B,A00,098023,Salehi Golsefidy; Alireza,13,0,15,2
1668034546060,MATH 202B,A00,098024,Rhoades; Brendon Patrick,10,0,15,5
1668034546494,MATH 203B,A00,098025,Oprea; Dragos N.,11,0,15,4
1668034546917,MATH 204B,A00,098026,Sorensen; Claus M,14,0,15,1
1668034547350,MATH 208,A00,098027,Izadi; Elham,7,0,10,3
1668034547776,MATH 209,A00,098028,Pollack; Aaron,10,0,10,0
1668034548200,MATH 211A,A00,112919,Rogalski; Daniel,9,0,10,1
1668034548637,MATH 211B,A00,112920,Seward; Brandon M.,9,0,10,1
1668034549062,MATH 218,A00,098029,Li; Bo,10,0,10,0
1668034549488,MATH 220B,A00,098030,Novak; Jonathan I,13,0,15,2
1668034549914,MATH 221A,A00,098031,Ebenfelt; Peter F,13,0,15,2
1668034550342,MATH 231B,A00,098032,Zlatos; Andrej,12,0,15,3
1668034550776,MATH 240B,A00,098033,Ni; Lei,9,0,15,6
1668034551206,MATH 243,A00,098034,Jekel; David Andrew,10,0,10,0
1668034551636,MATH 245A,A00,098035,Nie; Jiawang,0,0,15,16
1668034552075,MATH 248,A00,098036,Bejenaru; Ioan,10,0,10,0
1668034552505,MATH 250B,A00,098037,Spolaor; Luca,14,0,15,1
1668034552932,MATH 258,A00,098038,Ni; Lei,10,0,10,0
1668034553365,MATH 264B,A00,098041,Rhoades; Brendon Patrick,10,0,15,5
1668034553806,MATH 268,A00,098042,Buss; Samuel R,10,0,10,0
1668034554241,MATH 269,A00,098043,Rhoades; Brendon Patrick,10,0,10,0
1668034554670,MATH 270B,A00,098044,Li; Bo,11,0,15,4
1668034555104,MATH 272B,A00,098045,Holst; Michael J,13,0,15,2
1668034555535,MATH 273A,A00,098046,Tian; Xiaochuan,10,0,15,5
1668034555957,MATH 275,A01,098048,Tian; Xiaochuan,6,0,10,4
1668034556381,MATH 278A,A00,098049,Holst; Michael J,8,0,10,2
1668034556807,MATH 278B,A00,098050,Cloninger; Alexander,10,0,10,0
1668034557234,MATH 278C,A00,098051,Nie; Jiawang,8,0,10,2
1668034557656,MATH 280B,A00,098052,Zheng; Tianyi,11,0,15,4
1668034558078,MATH 281B,A00,098053,Bradic; Jelena,3,0,15,12
1668034558503,MATH 282B,A00,098054,Arias-Castro; Ery,2,0,15,13
1668034558927,MATH 285,A00,098055,Fitzsimmons; Patrick J,0,0,15,17
1668034559351,MATH 287B,A00,098056,Arias-Castro; Ery,4,0,15,11
1668034559786,MATH 288,A00,098057,Agarwal; Pooja,9,0,10,1
1668034559786,MATH 288,B00,098058,Zhang; Danna,9,0,10,1
1668034559786,MATH 288,C00,098059,Williams; Ruth J,10,0,10,0
1668034560215,MATH 290B,A00,098060,Roberts; Justin Deritter,13,0,15,2
1668034560640,MATH 292,A00,098061,Belmont; Eva Kinoshita,10,0,10,0
1668034561070,MATH 295,A00,098062,Suk; Andrew Hoon,48,0,50,2
1668034561494,MATH 296,A00,098063,Novak; Jonathan I,20,0,20,0
1668034561924,MATH 297,001,098064,Gamst; Anthony Collins,9997,0,9999,2
1668035070242,COGS 205,A00,101395,Chiba; Andrea,19,0,20,1
1668035070664,COGS 210B,001,101404,Greene; Deanna Jacquelyn,9998,0,9999,1
1668035070664,COGS 210B,002,101417,Xia; Haijun,9999,0,9999,0
1668035070664,COGS 210B,003,101422,Nitz; Douglas A.,9999,0,9999,0
1668035070664,COGS 210B,004,101423,Hollan; James D.,9998,0,9999,1
1668035070664,COGS 210B,005,101424,Deak; Gedeon O.,9998,0,9999,1
1668035070664,COGS 210B,006,101425,Rossano; Federico,9999,0,9999,0
1668035071088,COGS 211B,A00,101427,Coulson; Seana M,9996,0,9999,3
1668035071511,COGS 220,A00,101428,Hollan; James D.,0,0,25,25
1668035071955,COGS 229,A00,101429,Dow; Steven P,18,0,25,7
1668035072393,COGS 230,A00,101430,Klemmer; Scott R,13,0,17,4
1668035072823,COGS 234,A00,101431,Xia; Haijun,5,0,25,20
1668035073256,COGS 260,A00,101432,Kiyonaga; Anastasia,19,0,25,6
1668035073256,COGS 260,B00,101433,Kirsh; David Joel,16,0,25,9
1668035073682,CSE 202,A00,102371,Impagliazzo; Russell,0,0,0,0
1668035074219,CSE 203B,A01,102373,Cheng; Chung Kuan,0,0,0,0
1668035074645,CSE 208,A00,102374,Micciancio; Daniele,0,0,0,0
1668035075070,CSE 209A,A00,112895,Impagliazzo; Russell,0,0,15,15
1668035075494,CSE 209B,A00,108005,Bellare; Mihir,0,0,0,0
1668035075924,CSE 210,A00,113163,Coblenz; Michael J,0,0,0,0
1668035076364,CSE 219,A00,106111,Dow; Steven P,0,0,20,20
1668035076799,CSE 221,A00,102376,Voelker; Geoffrey M.,0,0,0,0
1668035077226,CSE 224,A01,102378,Porter; George M,0,0,0,0
1668035077655,CSE 229A,A00,102379,Savage; Stefan,0,0,0,0
1668035078083,CSE 229C,A00,102380,Munyaka; Imani N. S.,0,0,0,0
1668035078505,CSE 232B,A00,102382,Deutsch; Alin Bernard,0,0,0,0
1668035078933,CSE 234,A01,112904,Kumar; Arun Kumar,0,0,0,0
1668035079361,CSE 237A,A00,102383,Rosing; Tajana Simunic,0,0,0,0
1668035079788,CSE 239A,A00,102384,Deutsch; Alin Bernard,0,0,0,0
1668035080210,CSE 239B,A00,102385,Polikarpova; Nadezhda,0,0,0,0
1668035080638,CSE 240A,A00,102386,Pannuto; Patrick William,0,0,0,0
1668035081070,CSE 240B,A00,102387,Zhao; Jishen,0,0,0,0
1668035081496,CSE 241A,A00,106406,Kang; Mingu,0,0,0,0
1668035081925,CSE 249B,A00,102388,Kahng; Andrew Byun,0,0,8,8
1668035082368,CSE 251B,A01,102392,Cottrell; Garrison W,0,0,0,0
1668035082368,CSE 251B,A02,102393,Cottrell; Garrison W,0,0,0,0
1668035082793,CSE 252B,A00,102394,Ochoa; Benjamin Lawrence,0,0,0,0
1668035083216,CSE 257,A01,102396,Gao; Sicun,0,0,0,0
1668035083649,CSE 272,A00,102397,Li; Tzumao,0,0,0,0
1668035084077,CSE 274,A00,111323,Chern; Albert Ren-Haur,0,0,0,0
1668035084504,CSE 282,A00,102398,Pevzner; Pavel Arkadjevich,0,0,0,0
1668035084928,CSE 284,A00,114175,Gymrek; Melissa Ann,0,0,0,0
1668035085361,CSE 290,A00,102399,Chandraker; Manmohan Krishna,0,0,0,0
1668035085361,CSE 290,B00,102400,Vaccaro; Kristen Marie,0,0,25,25
1668035085361,CSE 290,C00,102414,Pannuto; Patrick William,0,0,25,25
1668035085361,CSE 290,D00,102427,Pevzner; Pavel Arkadjevich,0,0,0,0
1668035085361,CSE 290,E00,102429,Zhao; Jishen,0,0,0,0
1668035085361,CSE 290,F00,102436,Tullsen; Dean Michael,0,0,0,0
1668035085361,CSE 290,G00,102440,Christensen; Henrik I,0,0,20,20
1668035085784,CSE 291,A00,102443,Su; Hao,0,0,0,0
1668035085784,CSE 291,B00,102448,Polikarpova; Nadezhda,0,0,0,0
1668035085784,CSE 291,C00,102453,Vaccaro; Kristen Marie,0,0,0,0
1668035085784,CSE 291,D00,111343,Savage; Stefan,0,0,0,0
1668035085784,CSE 291,E00,116474,Claffy; Kimberly Claire,0,0,0,0
1668035085784,CSE 291,F00,116479,Pasquale; Joseph,0,0,0,0
1668035086213,CSE 293,001,119111,Bafna; Vineet,9999,0,9999,0
1668035086213,CSE 293,002,119118,Bellare; Mihir,9999,0,9999,0
1668035086213,CSE 293,003,119122,Berg-Kirkpatrick; Taylor D,9999,0,9999,0
1668035086213,CSE 293,004,119135,Christensen; Henrik I,9999,0,9999,0
1668035086213,CSE 293,005,119142,Cottrell; Garrison W,9999,0,9999,0
1668035086213,CSE 293,006,119146,Deutsch; Alin Bernard,9999,0,9999,0
1668035086213,CSE 293,007,119159,Esmaeilzadeh; Hadi,9999,0,9999,0
1668035086213,CSE 293,008,119166,Freund; Yoav,9999,0,9999,0
1668035086213,CSE 293,009,119170,Griswold; William G.,9999,0,9999,0
1668035086213,CSE 293,010,119183,Gymrek; Melissa Ann,9999,0,9999,0
1668035086213,CSE 293,011,119190,Heninger; Nadia A,9999,0,9999,0
1668035086213,CSE 293,012,119230,Impagliazzo; Russell,9999,0,9999,0
1668035086213,CSE 293,013,119232,Jhala; Ranjit,9999,0,9999,0
1668035086213,CSE 293,014,119233,Kahng; Andrew Byun,9999,0,9999,0
1668035086213,CSE 293,015,119298,Kane; Daniel Mertz,9999,0,9999,0
1668035086213,CSE 293,016,119299,Kriegman; David J,9999,0,9999,0
1668035086213,CSE 293,017,119300,Kumar; Arun Kumar,9999,0,9999,0
1668035086213,CSE 293,018,119301,Lerner; Sorin,9999,0,9999,0
1668035086213,CSE 293,019,119302,Lovett; Shachar,9999,0,9999,0
1668035086213,CSE 293,020,119303,McAuley; Julian John,9999,0,9999,0
1668035086213,CSE 293,021,119304,Micciancio; Daniele,9999,0,9999,0
1668035086213,CSE 293,022,119367,Orailoglu; Alex,9999,0,9999,0
1668035086213,CSE 293,023,119382,Paturi; Ramamohan,9999,0,9999,0
1668035086213,CSE 293,024,119404,Polikarpova; Nadezhda,9999,0,9999,0
1668035086213,CSE 293,025,119406,Politz; Joseph Gibbs,9999,0,9999,0
1668035086213,CSE 293,026,119411,Porter; George M,9999,0,9999,0
1668035086213,CSE 293,027,119414,Porter; Leonard Emerson,9999,0,9999,0
1668035086213,CSE 293,028,119416,Ramamoorthi; Ravi,9999,0,9999,0
1668035086213,CSE 293,029,119417,Sahoo; Debashis,9999,0,9999,0
1668035086213,CSE 293,030,119420,Saul; Lawrence,9999,0,9999,0
1668035086213,CSE 293,031,119421,Savage; Stefan,9999,0,9999,0
1668035086213,CSE 293,032,119425,Schulze; Jurgen P.,9999,0,9999,0
1668035086213,CSE 293,033,119426,Snoeren; Alex C.,9999,0,9999,0
1668035086213,CSE 293,034,119428,Shang; Jingbo,9999,0,9999,0
1668035086213,CSE 293,035,119430,Stefan; Deian,9999,0,9999,0
1668035086213,CSE 293,036,119431,Su; Hao,9999,0,9999,0
1668035086213,CSE 293,037,119433,Swanson; Steven James,9999,0,9999,0
1668035086213,CSE 293,038,119435,Tullsen; Dean Michael,9999,0,9999,0
1668035086213,CSE 293,039,119483,Voelker; Geoffrey M.,9999,0,9999,0
1668035086213,CSE 293,040,119537,Zhao; Jishen,9999,0,9999,0
1668035086213,CSE 293,041,119538,Zhou; Yuan-Yuan,9999,0,9999,0
1668035086213,CSE 293,042,119539,Gao; Sicun,9999,0,9999,0
1668035086213,CSE 293,043,119540,Weibel; Nadir,9999,0,9999,0
1668035086213,CSE 293,044,119541,Gupta; Rajesh K.,9999,0,9999,0
1668035086213,CSE 293,045,126410,Vaccaro; Kristen Marie,9999,0,9999,0
1668035086213,CSE 293,046,126411,Klemke; Richard,9999,0,9999,0
1668035086640,CSE 294,A00,102459,Voelker; Geoffrey M.,0,0,0,0
1668035086640,CSE 294,B00,111322,Orailoglu; Alex,0,0,0,0
1668035087071,DSE 201,A00,096914,Deutsch; Alin Bernard,30,0,30,0
1668035087508,DSE 210,A00,096915,Dasgupta; Sanjoy,30,0,30,0
1668035087942,DSE 260A,A00,096916,Altintas De Callaf; Ilkay,30,0,30,0
1668035088415,ECE 200,001,103586,Antipa; Nicholas A,9999,0,9999,0
1668035088415,ECE 200,002,103587,Atanasov; Nikolay A.,9999,0,9999,0
1668035088415,ECE 200,003,103588,Bharadia; Dinesh,9999,0,9999,0
1668035088415,ECE 200,004,103589,Cheng; Chung Kuan,9999,0,9999,0
1668035088415,ECE 200,005,103590,Cosman; Pamela C.,9999,0,9999,0
1668035088415,ECE 200,006,103591,Dayeh; Shadi Ahmad,9999,0,9999,0
1668035088415,ECE 200,007,103592,Fainman; Yeshaiahu,9999,0,9999,0
1668035088415,ECE 200,008,103593,Ford; Joseph Earl,9999,0,9999,0
1668035088415,ECE 200,009,103594,Franceschetti; Massimo,9999,0,9999,0
1668035088415,ECE 200,010,103595,Fullerton; Eric E,9999,0,9999,0
1668035088415,ECE 200,011,103596,Galton; Ian A,9999,0,9999,0
1668035088415,ECE 200,012,103597,Gilja; Vikash,9999,0,9999,0
1668035088415,ECE 200,013,103598,Hall; Drew A.,9999,0,9999,0
1668035088415,ECE 200,014,103599,Hsueh; Tzu-Chien,9999,0,9999,0
1668035088415,ECE 200,015,103600,Javidi; Tara,9999,0,9999,0
1668035088415,ECE 200,016,103601,Kahng; Andrew Byun,9999,0,9999,0
1668035088415,ECE 200,017,103602,Kim; Young-Han,9999,0,9999,0
1668035088415,ECE 200,018,103603,Koushanfar; Farinaz,9999,0,9999,0
1668035088415,ECE 200,019,103604,Kuzum; Duygu,9999,0,9999,0
1668035088415,ECE 200,020,103605,Le; Hanh-Phuc,9999,0,9999,0
1668035088415,ECE 200,021,103606,Lin; Bill,9999,0,9999,0
1668035088415,ECE 200,022,103607,Liu; Zhaowei,9998,0,9999,1
1668035088415,ECE 200,023,103608,Lo; Yu-Hwa,9999,0,9999,0
1668035088415,ECE 200,024,103609,Lomakin; Vitaliy,9999,0,9999,0
1668035088415,ECE 200,025,103610,Mercier; Patrick Philip,9999,0,9999,0
1668035088415,ECE 200,026,103611,Meyer; Florian,9999,0,9999,0
1668035088415,ECE 200,027,103612,Milstein; Laurence B.,9999,0,9999,0
1668035088415,ECE 200,028,103613,Mir Arabbaygi; Siavash,9999,0,9999,0
1668035088415,ECE 200,029,103614,Mookherjea; Shayan,9999,0,9999,0
1668035088415,ECE 200,030,103615,Morris; Karcher William,9999,0,9999,0
1668035088415,ECE 200,031,103616,Ng; Tse Nga,9999,0,9999,0
1668035088415,ECE 200,032,103617,Nguyen; Truong Quang,9999,0,9999,0
1668035088415,ECE 200,033,103618,Nomura; Kenji,9999,0,9999,0
1668035088415,ECE 200,034,103619,Orlitsky; Alon,9999,0,9999,0
1668035088415,ECE 200,035,103620,Pal; Piya,9999,0,9999,0
1668035088415,ECE 200,036,103621,Papen; George C.,9999,0,9999,0
1668035088415,ECE 200,037,103622,Radic; Stojan,9999,0,9999,0
1668035088415,ECE 200,038,103623,Rao; Bhaskar D.,9999,0,9999,0
1668035088415,ECE 200,039,103624,Rao; Ramesh R,9999,0,9999,0
1668035088415,ECE 200,040,103625,Rebeiz; Gabriel,9999,0,9999,0
1668035088415,ECE 200,041,103626,Sanford; John R,9999,0,9999,0
1668035088415,ECE 200,042,103627,Siegel; Paul H.,9999,0,9999,0
1668035088415,ECE 200,043,103628,Sievenpiper; Daniel F.,9999,0,9999,0
1668035088415,ECE 200,044,103629,Sworder; David D.,9999,0,9999,0
1668035088415,ECE 200,045,103630,Taur; Yuan,9999,0,9999,0
1668035088415,ECE 200,046,103631,Touri; Behrouz,9999,0,9999,0
1668035088415,ECE 200,047,103632,Trivedi; Mohan M.,9999,0,9999,0
1668035088415,ECE 200,048,103633,Vasconcelos; Nuno,9999,0,9999,0
1668035088415,ECE 200,049,103634,Wang; Xiaolong,9999,0,9999,0
1668035088415,ECE 200,050,103635,Xie; Pengtao,9999,0,9999,0
1668035088415,ECE 200,051,103636,Yip; Michael,9999,0,9999,0
1668035088415,ECE 200,052,103637,Zeger; Kenneth A.,999,0,999,0
1668035088415,ECE 200,053,103638,Zhang; Xinyu,9999,0,9999,0
1668035088415,ECE 200,054,103639,Turakhia; Yatish Girish,9999,0,9999,0
1668035088415,ECE 200,055,103640,Kang; Mingu,9999,0,9999,0
1668035088415,ECE 200,056,103641,Shi; Yuanyuan,9999,0,9999,0
1668035088415,ECE 200,057,103642,Wang; Edward Jay,9999,0,9999,0
1668035088415,ECE 200,058,103643,Zheng; Yang,9999,0,9999,0
1668035088846,ECE 202,A00,103644,Kuzum; Duygu,0,0,0,0
1668035089268,ECE 212BN,A00,103646,Ng; Tse Nga,0,0,0,0
1668035089689,ECE 221,A00,111493,Staff,0,0,0,0
1668035090117,ECE 222B,A00,103647,Lomakin; Vitaliy,0,0,0,0
1668035090540,ECE 230B,A00,103648,Taur; Yuan,0,0,0,0
1668035091033,ECE 238B,A00,103649,Garay; Javier,0,0,0,0
1668035091469,ECE 240B,A00,112900,Fainman; Yeshaiahu,0,0,0,0
1668035091896,ECE 247A,A00,103650,Jokerst; Jesse Vincent,0,0,0,0
1668035092333,ECE 247B,A00,103651,Wang; Joseph,0,0,0,0
1668035092765,ECE 250,A00,103652,Siegel; Paul H.,0,0,0,0
1668035093198,ECE 251A,A00,103654,Rao; Bhaskar D.,0,0,0,0
1668035093627,ECE 257B,A00,103655,Bharadia; Dinesh,0,0,0,0
1668035094052,ECE 258A,A00,103656,Milstein; Laurence B.,0,0,0,0
1668035094485,ECE 260B,A00,103658,Kang; Mingu,0,0,0,0
1668035094922,ECE 264A,A00,103659,Galton; Ian A,0,0,0,0
1668035095355,ECE 265A,A00,103661,Gudem; Prasad S.S.,0,0,0,0
1668035095784,ECE 265D,A00,103662,Gudem; Prasad S.S.,0,0,0,0
1668035096215,ECE 268,A00,103663,Koushanfar; Farinaz,0,0,0,0
1668035096645,ECE 269,A01,103665,Pal; Piya,0,0,0,0
1668035097080,ECE 271B,A00,103666,Vasconcelos; Manuela,0,0,0,0
1668035097522,ECE 276A,A00,103667,Atanasov; Nikolay A.,0,0,0,0
1668035097946,ECE 277,A00,103668,An; Cheolhong,0,0,0,0
1668035098373,ECE 279,A00,117947,Hall; Drew A.,0,0,0,0
1668035099250,ECE 283,A00,103670,Hsueh; Tzu-Chien,0,0,0,0
1668035099689,ECE 284,A00,103671,Turakhia; Yatish Girish,0,0,0,0
1668035100123,ECE 285,A00,103672,Zheng; Yang,0,0,0,0
1668035100123,ECE 285,B00,103673,Sworder; David D.,0,0,0,0
1668035100557,ECE 287,A00,103676,Javidi; Tara,0,0,0,0
1668035100983,MATH 200B,A00,098023,Salehi Golsefidy; Alireza,13,0,15,2
1668035101406,MATH 202B,A00,098024,Rhoades; Brendon Patrick,10,0,15,5
1668035101849,MATH 203B,A00,098025,Oprea; Dragos N.,11,0,15,4
1668035102280,MATH 204B,A00,098026,Sorensen; Claus M,14,0,15,1
1668035102717,MATH 208,A00,098027,Izadi; Elham,7,0,10,3
1668035103154,MATH 209,A00,098028,Pollack; Aaron,10,0,10,0
1668035103577,MATH 211A,A00,112919,Rogalski; Daniel,9,0,10,1
1668035104003,MATH 211B,A00,112920,Seward; Brandon M.,9,0,10,1
1668035104440,MATH 218,A00,098029,Li; Bo,10,0,10,0
1668035104865,MATH 220B,A00,098030,Novak; Jonathan I,13,0,15,2
1668035105291,MATH 221A,A00,098031,Ebenfelt; Peter F,13,0,15,2
1668035105721,MATH 231B,A00,098032,Zlatos; Andrej,12,0,15,3
1668035106146,MATH 240B,A00,098033,Ni; Lei,9,0,15,6
1668035106570,MATH 243,A00,098034,Jekel; David Andrew,10,0,10,0
1668035107012,MATH 245A,A00,098035,Nie; Jiawang,0,0,15,16
1668035107450,MATH 248,A00,098036,Bejenaru; Ioan,10,0,10,0
1668035107875,MATH 250B,A00,098037,Spolaor; Luca,14,0,15,1
1668035108303,MATH 258,A00,098038,Ni; Lei,10,0,10,0
1668035108742,MATH 264B,A00,098041,Rhoades; Brendon Patrick,10,0,15,5
1668035109184,MATH 268,A00,098042,Buss; Samuel R,10,0,10,0
1668035109613,MATH 269,A00,098043,Rhoades; Brendon Patrick,10,0,10,0
1668035110038,MATH 270B,A00,098044,Li; Bo,11,0,15,4
1668035110469,MATH 272B,A00,098045,Holst; Michael J,13,0,15,2
1668035110898,MATH 273A,A00,098046,Tian; Xiaochuan,10,0,15,5
1668035111323,MATH 275,A01,098048,Tian; Xiaochuan,6,0,10,4
1668035111748,MATH 278A,A00,098049,Holst; Michael J,8,0,10,2
1668035112173,MATH 278B,A00,098050,Cloninger; Alexander,10,0,10,0
1668035112609,MATH 278C,A00,098051,Nie; Jiawang,8,0,10,2
1668035113043,MATH 280B,A00,098052,Zheng; Tianyi,11,0,15,4
1668035113471,MATH 281B,A00,098053,Bradic; Jelena,3,0,15,12
1668035113895,MATH 282B,A00,098054,Arias-Castro; Ery,2,0,15,13
1668035114332,MATH 285,A00,098055,Fitzsimmons; Patrick J,0,0,15,17
1668035114763,MATH 287B,A00,098056,Arias-Castro; Ery,4,0,15,11
1668035115195,MATH 288,A00,098057,Agarwal; Pooja,9,0,10,1
1668035115195,MATH 288,B00,098058,Zhang; Danna,9,0,10,1
1668035115195,MATH 288,C00,098059,Williams; Ruth J,10,0,10,0
1668035115619,MATH 290B,A00,098060,Roberts; Justin Deritter,13,0,15,2
1668035116043,MATH 292,A00,098061,Belmont; Eva Kinoshita,10,0,10,0
1668035116464,MATH 295,A00,098062,Suk; Andrew Hoon,48,0,50,2
1668035116889,MATH 296,A00,098063,Novak; Jonathan I,20,0,20,0
1668035117318,MATH 297,001,098064,Gamst; Anthony Collins,9997,0,9999,2
1668035623792,COGS 205,A00,101395,Chiba; Andrea,19,0,20,1
1668035624217,COGS 210B,001,101404,Greene; Deanna Jacquelyn,9998,0,9999,1
1668035624217,COGS 210B,002,101417,Xia; Haijun,9999,0,9999,0
1668035624217,COGS 210B,003,101422,Nitz; Douglas A.,9999,0,9999,0
1668035624217,COGS 210B,004,101423,Hollan; James D.,9998,0,9999,1
1668035624217,COGS 210B,005,101424,Deak; Gedeon O.,9998,0,9999,1
1668035624217,COGS 210B,006,101425,Rossano; Federico,9999,0,9999,0
1668035624643,COGS 211B,A00,101427,Coulson; Seana M,9996,0,9999,3
1668035625086,COGS 220,A00,101428,Hollan; James D.,0,0,25,25
1668035625509,COGS 229,A00,101429,Dow; Steven P,18,0,25,7
1668035625935,COGS 230,A00,101430,Klemmer; Scott R,13,0,17,4
1668035626368,COGS 234,A00,101431,Xia; Haijun,5,0,25,20
1668035626805,COGS 260,A00,101432,Kiyonaga; Anastasia,19,0,25,6
1668035626805,COGS 260,B00,101433,Kirsh; David Joel,16,0,25,9
1668035627244,CSE 202,A00,102371,Impagliazzo; Russell,0,0,0,0
1668035627674,CSE 203B,A01,102373,Cheng; Chung Kuan,0,0,0,0
1668035628106,CSE 208,A00,102374,Micciancio; Daniele,0,0,0,0
1668035628543,CSE 209A,A00,112895,Impagliazzo; Russell,0,0,15,15
1668035628967,CSE 209B,A00,108005,Bellare; Mihir,0,0,0,0
1668035629391,CSE 210,A00,113163,Coblenz; Michael J,0,0,0,0
1668035629821,CSE 219,A00,106111,Dow; Steven P,0,0,20,20
1668035630248,CSE 221,A00,102376,Voelker; Geoffrey M.,0,0,0,0
1668035630675,CSE 224,A01,102378,Porter; George M,0,0,0,0
1668035631103,CSE 229A,A00,102379,Savage; Stefan,0,0,0,0
1668035631526,CSE 229C,A00,102380,Munyaka; Imani N. S.,0,0,0,0
1668035631950,CSE 232B,A00,102382,Deutsch; Alin Bernard,0,0,0,0
1668035632395,CSE 234,A01,112904,Kumar; Arun Kumar,0,0,0,0
1668035632820,CSE 237A,A00,102383,Rosing; Tajana Simunic,0,0,0,0
1668035633244,CSE 239A,A00,102384,Deutsch; Alin Bernard,0,0,0,0
1668035633683,CSE 239B,A00,102385,Polikarpova; Nadezhda,0,0,0,0
1668035634113,CSE 240A,A00,102386,Pannuto; Patrick William,0,0,0,0
1668035634540,CSE 240B,A00,102387,Zhao; Jishen,0,0,0,0
1668035634972,CSE 241A,A00,106406,Kang; Mingu,0,0,0,0
1668035635399,CSE 249B,A00,102388,Kahng; Andrew Byun,0,0,8,8
1668035635839,CSE 251B,A01,102392,Cottrell; Garrison W,0,0,0,0
1668035635839,CSE 251B,A02,102393,Cottrell; Garrison W,0,0,0,0
1668035636268,CSE 252B,A00,102394,Ochoa; Benjamin Lawrence,0,0,0,0
1668035636698,CSE 257,A01,102396,Gao; Sicun,0,0,0,0
1668035637121,CSE 272,A00,102397,Li; Tzumao,0,0,0,0
1668035637546,CSE 274,A00,111323,Chern; Albert Ren-Haur,0,0,0,0
1668035637974,CSE 282,A00,102398,Pevzner; Pavel Arkadjevich,0,0,0,0
1668035638412,CSE 284,A00,114175,Gymrek; Melissa Ann,0,0,0,0
1668035638836,CSE 290,A00,102399,Chandraker; Manmohan Krishna,0,0,0,0
1668035638836,CSE 290,B00,102400,Vaccaro; Kristen Marie,0,0,25,25
1668035638836,CSE 290,C00,102414,Pannuto; Patrick William,0,0,25,25
1668035638836,CSE 290,D00,102427,Pevzner; Pavel Arkadjevich,0,0,0,0
1668035638836,CSE 290,E00,102429,Zhao; Jishen,0,0,0,0
1668035638836,CSE 290,F00,102436,Tullsen; Dean Michael,0,0,0,0
1668035638836,CSE 290,G00,102440,Christensen; Henrik I,0,0,20,20
1668035639265,CSE 291,A00,102443,Su; Hao,0,0,0,0
1668035639265,CSE 291,B00,102448,Polikarpova; Nadezhda,0,0,0,0
1668035639265,CSE 291,C00,102453,Vaccaro; Kristen Marie,0,0,0,0
1668035639265,CSE 291,D00,111343,Savage; Stefan,0,0,0,0
1668035639265,CSE 291,E00,116474,Claffy; Kimberly Claire,0,0,0,0
1668035639265,CSE 291,F00,116479,Pasquale; Joseph,0,0,0,0
1668035639708,CSE 293,001,119111,Bafna; Vineet,9999,0,9999,0
1668035639708,CSE 293,002,119118,Bellare; Mihir,9999,0,9999,0
1668035639708,CSE 293,003,119122,Berg-Kirkpatrick; Taylor D,9999,0,9999,0
1668035639708,CSE 293,004,119135,Christensen; Henrik I,9999,0,9999,0
1668035639708,CSE 293,005,119142,Cottrell; Garrison W,9999,0,9999,0
1668035639708,CSE 293,006,119146,Deutsch; Alin Bernard,9999,0,9999,0
1668035639708,CSE 293,007,119159,Esmaeilzadeh; Hadi,9999,0,9999,0
1668035639708,CSE 293,008,119166,Freund; Yoav,9999,0,9999,0
1668035639708,CSE 293,009,119170,Griswold; William G.,9999,0,9999,0
1668035639708,CSE 293,010,119183,Gymrek; Melissa Ann,9999,0,9999,0
1668035639708,CSE 293,011,119190,Heninger; Nadia A,9999,0,9999,0
1668035639708,CSE 293,012,119230,Impagliazzo; Russell,9999,0,9999,0
1668035639708,CSE 293,013,119232,Jhala; Ranjit,9999,0,9999,0
1668035639708,CSE 293,014,119233,Kahng; Andrew Byun,9999,0,9999,0
1668035639708,CSE 293,015,119298,Kane; Daniel Mertz,9999,0,9999,0
1668035639708,CSE 293,016,119299,Kriegman; David J,9999,0,9999,0
1668035639708,CSE 293,017,119300,Kumar; Arun Kumar,9999,0,9999,0
1668035639708,CSE 293,018,119301,Lerner; Sorin,9999,0,9999,0
1668035639708,CSE 293,019,119302,Lovett; Shachar,9999,0,9999,0
1668035639708,CSE 293,020,119303,McAuley; Julian John,9999,0,9999,0
1668035639708,CSE 293,021,119304,Micciancio; Daniele,9999,0,9999,0
1668035639708,CSE 293,022,119367,Orailoglu; Alex,9999,0,9999,0
1668035639708,CSE 293,023,119382,Paturi; Ramamohan,9999,0,9999,0
1668035639708,CSE 293,024,119404,Polikarpova; Nadezhda,9999,0,9999,0
1668035639708,CSE 293,025,119406,Politz; Joseph Gibbs,9999,0,9999,0
1668035639708,CSE 293,026,119411,Porter; George M,9999,0,9999,0
1668035639708,CSE 293,027,119414,Porter; Leonard Emerson,9999,0,9999,0
1668035639708,CSE 293,028,119416,Ramamoorthi; Ravi,9999,0,9999,0
1668035639708,CSE 293,029,119417,Sahoo; Debashis,9999,0,9999,0
1668035639708,CSE 293,030,119420,Saul; Lawrence,9999,0,9999,0
1668035639708,CSE 293,031,119421,Savage; Stefan,9999,0,9999,0
1668035639708,CSE 293,032,119425,Schulze; Jurgen P.,9999,0,9999,0
1668035639708,CSE 293,033,119426,Snoeren; Alex C.,9999,0,9999,0
1668035639708,CSE 293,034,119428,Shang; Jingbo,9999,0,9999,0
1668035639708,CSE 293,035,119430,Stefan; Deian,9999,0,9999,0
1668035639708,CSE 293,036,119431,Su; Hao,9999,0,9999,0
1668035639708,CSE 293,037,119433,Swanson; Steven James,9999,0,9999,0
1668035639708,CSE 293,038,119435,Tullsen; Dean Michael,9999,0,9999,0
1668035639708,CSE 293,039,119483,Voelker; Geoffrey M.,9999,0,9999,0
1668035639708,CSE 293,040,119537,Zhao; Jishen,9999,0,9999,0
1668035639708,CSE 293,041,119538,Zhou; Yuan-Yuan,9999,0,9999,0
1668035639708,CSE 293,042,119539,Gao; Sicun,9999,0,9999,0
1668035639708,CSE 293,043,119540,Weibel; Nadir,9999,0,9999,0
1668035639708,CSE 293,044,119541,Gupta; Rajesh K.,9999,0,9999,0
1668035639708,CSE 293,045,126410,Vaccaro; Kristen Marie,9999,0,9999,0
1668035639708,CSE 293,046,126411,Klemke; Richard,9999,0,9999,0
1668035640137,CSE 294,A00,102459,Voelker; Geoffrey M.,0,0,0,0
1668035640137,CSE 294,B00,111322,Orailoglu; Alex,0,0,0,0
1668035640566,DSE 201,A00,096914,Deutsch; Alin Bernard,30,0,30,0
1668035640995,DSE 210,A00,096915,Dasgupta; Sanjoy,30,0,30,0
1668035641426,DSE 260A,A00,096916,Altintas De Callaf; Ilkay,30,0,30,0
1668035641882,ECE 200,001,103586,Antipa; Nicholas A,9999,0,9999,0
1668035641882,ECE 200,002,103587,Atanasov; Nikolay A.,9999,0,9999,0
1668035641882,ECE 200,003,103588,Bharadia; Dinesh,9999,0,9999,0
1668035641882,ECE 200,004,103589,Cheng; Chung Kuan,9999,0,9999,0
1668035641882,ECE 200,005,103590,Cosman; Pamela C.,9999,0,9999,0
1668035641882,ECE 200,006,103591,Dayeh; Shadi Ahmad,9999,0,9999,0
1668035641882,ECE 200,007,103592,Fainman; Yeshaiahu,9999,0,9999,0
1668035641882,ECE 200,008,103593,Ford; Joseph Earl,9999,0,9999,0
1668035641882,ECE 200,009,103594,Franceschetti; Massimo,9999,0,9999,0
1668035641882,ECE 200,010,103595,Fullerton; Eric E,9999,0,9999,0
1668035641882,ECE 200,011,103596,Galton; Ian A,9999,0,9999,0
1668035641882,ECE 200,012,103597,Gilja; Vikash,9999,0,9999,0
1668035641882,ECE 200,013,103598,Hall; Drew A.,9999,0,9999,0
1668035641882,ECE 200,014,103599,Hsueh; Tzu-Chien,9999,0,9999,0
1668035641882,ECE 200,015,103600,Javidi; Tara,9999,0,9999,0
1668035641882,ECE 200,016,103601,Kahng; Andrew Byun,9999,0,9999,0
1668035641882,ECE 200,017,103602,Kim; Young-Han,9999,0,9999,0
1668035641882,ECE 200,018,103603,Koushanfar; Farinaz,9999,0,9999,0
1668035641882,ECE 200,019,103604,Kuzum; Duygu,9999,0,9999,0
1668035641882,ECE 200,020,103605,Le; Hanh-Phuc,9999,0,9999,0
1668035641882,ECE 200,021,103606,Lin; Bill,9999,0,9999,0
1668035641882,ECE 200,022,103607,Liu; Zhaowei,9998,0,9999,1
1668035641882,ECE 200,023,103608,Lo; Yu-Hwa,9999,0,9999,0
1668035641882,ECE 200,024,103609,Lomakin; Vitaliy,9999,0,9999,0
1668035641882,ECE 200,025,103610,Mercier; Patrick Philip,9999,0,9999,0
1668035641882,ECE 200,026,103611,Meyer; Florian,9999,0,9999,0
1668035641882,ECE 200,027,103612,Milstein; Laurence B.,9999,0,9999,0
1668035641882,ECE 200,028,103613,Mir Arabbaygi; Siavash,9999,0,9999,0
1668035641882,ECE 200,029,103614,Mookherjea; Shayan,9999,0,9999,0
1668035641882,ECE 200,030,103615,Morris; Karcher William,9999,0,9999,0
1668035641882,ECE 200,031,103616,Ng; Tse Nga,9999,0,9999,0
1668035641882,ECE 200,032,103617,Nguyen; Truong Quang,9999,0,9999,0
1668035641882,ECE 200,033,103618,Nomura; Kenji,9999,0,9999,0
1668035641882,ECE 200,034,103619,Orlitsky; Alon,9999,0,9999,0
1668035641882,ECE 200,035,103620,Pal; Piya,9999,0,9999,0
1668035641882,ECE 200,036,103621,Papen; George C.,9999,0,9999,0
1668035641882,ECE 200,037,103622,Radic; Stojan,9999,0,9999,0
1668035641882,ECE 200,038,103623,Rao; Bhaskar D.,9999,0,9999,0
1668035641882,ECE 200,039,103624,Rao; Ramesh R,9999,0,9999,0
1668035641882,ECE 200,040,103625,Rebeiz; Gabriel,9999,0,9999,0
1668035641882,ECE 200,041,103626,Sanford; John R,9999,0,9999,0
1668035641882,ECE 200,042,103627,Siegel; Paul H.,9999,0,9999,0
1668035641882,ECE 200,043,103628,Sievenpiper; Daniel F.,9999,0,9999,0
1668035641882,ECE 200,044,103629,Sworder; David D.,9999,0,9999,0
1668035641882,ECE 200,045,103630,Taur; Yuan,9999,0,9999,0
1668035641882,ECE 200,046,103631,Touri; Behrouz,9999,0,9999,0
1668035641882,ECE 200,047,103632,Trivedi; Mohan M.,9999,0,9999,0
1668035641882,ECE 200,048,103633,Vasconcelos; Nuno,9999,0,9999,0
1668035641882,ECE 200,049,103634,Wang; Xiaolong,9999,0,9999,0
1668035641882,ECE 200,050,103635,Xie; Pengtao,9999,0,9999,0
1668035641882,ECE 200,051,103636,Yip; Michael,9999,0,9999,0
1668035641882,ECE 200,052,103637,Zeger; Kenneth A.,999,0,999,0
1668035641882,ECE 200,053,103638,Zhang; Xinyu,9999,0,9999,0
1668035641882,ECE 200,054,103639,Turakhia; Yatish Girish,9999,0,9999,0
1668035641882,ECE 200,055,103640,Kang; Mingu,9999,0,9999,0
1668035641882,ECE 200,056,103641,Shi; Yuanyuan,9999,0,9999,0
1668035641882,ECE 200,057,103642,Wang; Edward Jay,9999,0,9999,0
1668035641882,ECE 200,058,103643,Zheng; Yang,9999,0,9999,0
1668035642308,ECE 202,A00,103644,Kuzum; Duygu,0,0,0,0
1668035642733,ECE 212BN,A00,103646,Ng; Tse Nga,0,0,0,0
1668035643159,ECE 221,A00,111493,Staff,0,0,0,0
1668035643586,ECE 222B,A00,103647,Lomakin; Vitaliy,0,0,0,0
1668035644015,ECE 230B,A00,103648,Taur; Yuan,0,0,0,0
1668035644562,ECE 238B,A00,103649,Garay; Javier,0,0,0,0
1668035644993,ECE 240B,A00,112900,Fainman; Yeshaiahu,0,0,0,0
1668035645426,ECE 247A,A00,103650,Jokerst; Jesse Vincent,0,0,0,0
1668035645859,ECE 247B,A00,103651,Wang; Joseph,0,0,0,0
1668035646310,ECE 250,A00,103652,Siegel; Paul H.,0,0,0,0
1668035646746,ECE 251A,A00,103654,Rao; Bhaskar D.,0,0,0,0
1668035647171,ECE 257B,A00,103655,Bharadia; Dinesh,0,0,0,0
1668035647603,ECE 258A,A00,103656,Milstein; Laurence B.,0,0,0,0
1668035648026,ECE 260B,A00,103658,Kang; Mingu,0,0,0,0
1668035648452,ECE 264A,A00,103659,Galton; Ian A,0,0,0,0
1668035648875,ECE 265A,A00,103661,Gudem; Prasad S.S.,0,0,0,0
1668035649309,ECE 265D,A00,103662,Gudem; Prasad S.S.,0,0,0,0
1668035649733,ECE 268,A00,103663,Koushanfar; Farinaz,0,0,0,0
1668035650158,ECE 269,A01,103665,Pal; Piya,0,0,0,0
1668035650579,ECE 271B,A00,103666,Vasconcelos; Manuela,0,0,0,0
1668035651042,ECE 276A,A00,103667,Atanasov; Nikolay A.,0,0,0,0
1668035651471,ECE 277,A00,103668,An; Cheolhong,0,0,0,0
1668035651905,ECE 279,A00,117947,Hall; Drew A.,0,0,0,0
1668035652767,ECE 283,A00,103670,Hsueh; Tzu-Chien,0,0,0,0
1668035653192,ECE 284,A00,103671,Turakhia; Yatish Girish,0,0,0,0
1668035653628,ECE 285,A00,103672,Zheng; Yang,0,0,0,0
1668035653628,ECE 285,B00,103673,Sworder; David D.,0,0,0,0
1668035654061,ECE 287,A00,103676,Javidi; Tara,0,0,0,0
1668035654494,MATH 200B,A00,098023,Salehi Golsefidy; Alireza,13,0,15,2
1668035654930,MATH 202B,A00,098024,Rhoades; Brendon Patrick,10,0,15,5
1668035655371,MATH 203B,A00,098025,Oprea; Dragos N.,11,0,15,4
1668035655802,MATH 204B,A00,098026,Sorensen; Claus M,14,0,15,1
1668035656229,MATH 208,A00,098027,Izadi; Elham,7,0,10,3
1668035656657,MATH 209,A00,098028,Pollack; Aaron,10,0,10,0
1668035657092,MATH 211A,A00,112919,Rogalski; Daniel,9,0,10,1
1668035657516,MATH 211B,A00,112920,Seward; Brandon M.,9,0,10,1
1668035657939,MATH 218,A00,098029,Li; Bo,10,0,10,0
1668035658364,MATH 220B,A00,098030,Novak; Jonathan I,13,0,15,2
1668035658832,MATH 221A,A00,098031,Ebenfelt; Peter F,13,0,15,2
1668035659259,MATH 231B,A00,098032,Zlatos; Andrej,12,0,15,3
1668035659694,MATH 240B,A00,098033,Ni; Lei,9,0,15,6
1668035660137,MATH 243,A00,098034,Jekel; David Andrew,10,0,10,0
1668035660563,MATH 245A,A00,098035,Nie; Jiawang,0,0,15,16
1668035660989,MATH 248,A00,098036,Bejenaru; Ioan,10,0,10,0
1668035661428,MATH 250B,A00,098037,Spolaor; Luca,14,0,15,1
1668035661853,MATH 258,A00,098038,Ni; Lei,10,0,10,0
1668035662286,MATH 264B,A00,098041,Rhoades; Brendon Patrick,10,0,15,5
1668035662718,MATH 268,A00,098042,Buss; Samuel R,10,0,10,0
1668035663156,MATH 269,A00,098043,Rhoades; Brendon Patrick,10,0,10,0
1668035663596,MATH 270B,A00,098044,Li; Bo,11,0,15,4
1668035664065,MATH 272B,A00,098045,Holst; Michael J,13,0,15,2
1668035664489,MATH 273A,A00,098046,Tian; Xiaochuan,10,0,15,5
1668035664915,MATH 275,A01,098048,Tian; Xiaochuan,6,0,10,4
1668035665344,MATH 278A,A00,098049,Holst; Michael J,8,0,10,2
1668035665786,MATH 278B,A00,098050,Cloninger; Alexander,10,0,10,0
1668035666219,MATH 278C,A00,098051,Nie; Jiawang,8,0,10,2
1668035666654,MATH 280B,A00,098052,Zheng; Tianyi,11,0,15,4
1668035667092,MATH 281B,A00,098053,Bradic; Jelena,3,0,15,12
1668035667529,MATH 282B,A00,098054,Arias-Castro; Ery,2,0,15,13
1668035667953,MATH 285,A00,098055,Fitzsimmons; Patrick J,0,0,15,17
1668035668384,MATH 287B,A00,098056,Arias-Castro; Ery,4,0,15,11
1668035668814,MATH 288,A00,098057,Agarwal; Pooja,9,0,10,1
1668035668814,MATH 288,B00,098058,Zhang; Danna,9,0,10,1
1668035668814,MATH 288,C00,098059,Williams; Ruth J,10,0,10,0
1668035669252,MATH 290B,A00,098060,Roberts; Justin Deritter,13,0,15,2
1668035669675,MATH 292,A00,098061,Belmont; Eva Kinoshita,10,0,10,0
1668035670103,MATH 295,A00,098062,Suk; Andrew Hoon,48,0,50,2
1668035670527,MATH 296,A00,098063,Novak; Jonathan I,20,0,20,0
1668035670948,MATH 297,001,098064,Gamst; Anthony Collins,9997,0,9999,2
1668036175837,COGS 205,A00,101395,Chiba; Andrea,19,0,20,1
1668036176278,COGS 210B,001,101404,Greene; Deanna Jacquelyn,9998,0,9999,1
1668036176278,COGS 210B,002,101417,Xia; Haijun,9999,0,9999,0
1668036176278,COGS 210B,003,101422,Nitz; Douglas A.,9999,0,9999,0
1668036176278,COGS 210B,004,101423,Hollan; James D.,9998,0,9999,1
1668036176278,COGS 210B,005,101424,Deak; Gedeon O.,9998,0,9999,1
1668036176278,COGS 210B,006,101425,Rossano; Federico,9999,0,9999,0
1668036176704,COGS 211B,A00,101427,Coulson; Seana M,9996,0,9999,3
1668036177131,COGS 220,A00,101428,Hollan; James D.,0,0,25,25
1668036177556,COGS 229,A00,101429,Dow; Steven P,18,0,25,7
1668036177978,COGS 230,A00,101430,Klemmer; Scott R,13,0,17,4
1668036178403,COGS 234,A00,101431,Xia; Haijun,5,0,25,20
1668036178826,COGS 260,A00,101432,Kiyonaga; Anastasia,19,0,25,6
1668036178826,COGS 260,B00,101433,Kirsh; David Joel,16,0,25,9
1668036179254,CSE 202,A00,102371,Impagliazzo; Russell,0,0,0,0
1668036179681,CSE 203B,A01,102373,Cheng; Chung Kuan,0,0,0,0
1668036180106,CSE 208,A00,102374,Micciancio; Daniele,0,0,0,0
1668036180529,CSE 209A,A00,112895,Impagliazzo; Russell,0,0,15,15
1668036180953,CSE 209B,A00,108005,Bellare; Mihir,0,0,0,0
1668036181383,CSE 210,A00,113163,Coblenz; Michael J,0,0,0,0
1668036181832,CSE 219,A00,106111,Dow; Steven P,0,0,20,20
1668036182264,CSE 221,A00,102376,Voelker; Geoffrey M.,0,0,0,0
1668036182708,CSE 224,A01,102378,Porter; George M,0,0,0,0
1668036183136,CSE 229A,A00,102379,Savage; Stefan,0,0,0,0
1668036183584,CSE 229C,A00,102380,Munyaka; Imani N. S.,0,0,0,0
1668036184008,CSE 232B,A00,102382,Deutsch; Alin Bernard,0,0,0,0
1668036184441,CSE 234,A01,112904,Kumar; Arun Kumar,0,0,0,0
1668036184864,CSE 237A,A00,102383,Rosing; Tajana Simunic,0,0,0,0
1668036185296,CSE 239A,A00,102384,Deutsch; Alin Bernard,0,0,0,0
1668036185726,CSE 239B,A00,102385,Polikarpova; Nadezhda,0,0,0,0
1668036186158,CSE 240A,A00,102386,Pannuto; Patrick William,0,0,0,0
1668036186584,CSE 240B,A00,102387,Zhao; Jishen,0,0,0,0
1668036187012,CSE 241A,A00,106406,Kang; Mingu,0,0,0,0
1668036187444,CSE 249B,A00,102388,Kahng; Andrew Byun,0,0,8,8
1668036187868,CSE 251B,A01,102392,Cottrell; Garrison W,0,0,0,0
1668036187868,CSE 251B,A02,102393,Cottrell; Garrison W,0,0,0,0
1668036188292,CSE 252B,A00,102394,Ochoa; Benjamin Lawrence,0,0,0,0
1668036188719,CSE 257,A01,102396,Gao; Sicun,0,0,0,0
1668036189146,CSE 272,A00,102397,Li; Tzumao,0,0,0,0
1668036189569,CSE 274,A00,111323,Chern; Albert Ren-Haur,0,0,0,0
1668036190007,CSE 282,A00,102398,Pevzner; Pavel Arkadjevich,0,0,0,0
1668036190440,CSE 284,A00,114175,Gymrek; Melissa Ann,0,0,0,0
1668036190864,CSE 290,A00,102399,Chandraker; Manmohan Krishna,0,0,0,0
1668036190864,CSE 290,B00,102400,Vaccaro; Kristen Marie,0,0,25,25
1668036190864,CSE 290,C00,102414,Pannuto; Patrick William,0,0,25,25
1668036190864,CSE 290,D00,102427,Pevzner; Pavel Arkadjevich,0,0,0,0
1668036190864,CSE 290,E00,102429,Zhao; Jishen,0,0,0,0
1668036190864,CSE 290,F00,102436,Tullsen; Dean Michael,0,0,0,0
1668036190864,CSE 290,G00,102440,Christensen; Henrik I,0,0,20,20
1668036191293,CSE 291,A00,102443,Su; Hao,0,0,0,0
1668036191293,CSE 291,B00,102448,Polikarpova; Nadezhda,0,0,0,0
1668036191293,CSE 291,C00,102453,Vaccaro; Kristen Marie,0,0,0,0
1668036191293,CSE 291,D00,111343,Savage; Stefan,0,0,0,0
1668036191293,CSE 291,E00,116474,Claffy; Kimberly Claire,0,0,0,0
1668036191293,CSE 291,F00,116479,Pasquale; Joseph,0,0,0,0
1668036191731,CSE 293,001,119111,Bafna; Vineet,9999,0,9999,0
1668036191731,CSE 293,002,119118,Bellare; Mihir,9999,0,9999,0
1668036191731,CSE 293,003,119122,Berg-Kirkpatrick; Taylor D,9999,0,9999,0
1668036191731,CSE 293,004,119135,Christensen; Henrik I,9999,0,9999,0
1668036191731,CSE 293,005,119142,Cottrell; Garrison W,9999,0,9999,0
1668036191731,CSE 293,006,119146,Deutsch; Alin Bernard,9999,0,9999,0
1668036191731,CSE 293,007,119159,Esmaeilzadeh; Hadi,9999,0,9999,0
1668036191731,CSE 293,008,119166,Freund; Yoav,9999,0,9999,0
1668036191731,CSE 293,009,119170,Griswold; William G.,9999,0,9999,0
1668036191731,CSE 293,010,119183,Gymrek; Melissa Ann,9999,0,9999,0
1668036191731,CSE 293,011,119190,Heninger; Nadia A,9999,0,9999,0
1668036191731,CSE 293,012,119230,Impagliazzo; Russell,9999,0,9999,0
1668036191731,CSE 293,013,119232,Jhala; Ranjit,9999,0,9999,0
1668036191731,CSE 293,014,119233,Kahng; Andrew Byun,9999,0,9999,0
1668036191731,CSE 293,015,119298,Kane; Daniel Mertz,9999,0,9999,0
1668036191731,CSE 293,016,119299,Kriegman; David J,9999,0,9999,0
1668036191731,CSE 293,017,119300,Kumar; Arun Kumar,9999,0,9999,0
1668036191731,CSE 293,018,119301,Lerner; Sorin,9999,0,9999,0
1668036191731,CSE 293,019,119302,Lovett; Shachar,9999,0,9999,0
1668036191731,CSE 293,020,119303,McAuley; Julian John,9999,0,9999,0
1668036191731,CSE 293,021,119304,Micciancio; Daniele,9999,0,9999,0
1668036191731,CSE 293,022,119367,Orailoglu; Alex,9999,0,9999,0
1668036191731,CSE 293,023,119382,Paturi; Ramamohan,9999,0,9999,0
1668036191731,CSE 293,024,119404,Polikarpova; Nadezhda,9999,0,9999,0
1668036191731,CSE 293,025,119406,Politz; Joseph Gibbs,9999,0,9999,0
1668036191731,CSE 293,026,119411,Porter; George M,9999,0,9999,0
1668036191731,CSE 293,027,119414,Porter; Leonard Emerson,9999,0,9999,0
1668036191731,CSE 293,028,119416,Ramamoorthi; Ravi,9999,0,9999,0
1668036191731,CSE 293,029,119417,Sahoo; Debashis,9999,0,9999,0
1668036191731,CSE 293,030,119420,Saul; Lawrence,9999,0,9999,0
1668036191731,CSE 293,031,119421,Savage; Stefan,9999,0,9999,0
1668036191731,CSE 293,032,119425,Schulze; Jurgen P.,9999,0,9999,0
1668036191731,CSE 293,033,119426,Snoeren; Alex C.,9999,0,9999,0
1668036191731,CSE 293,034,119428,Shang; Jingbo,9999,0,9999,0
1668036191731,CSE 293,035,119430,Stefan; Deian,9999,0,9999,0
1668036191731,CSE 293,036,119431,Su; Hao,9999,0,9999,0
1668036191731,CSE 293,037,119433,Swanson; Steven James,9999,0,9999,0
1668036191731,CSE 293,038,119435,Tullsen; Dean Michael,9999,0,9999,0
1668036191731,CSE 293,039,119483,Voelker; Geoffrey M.,9999,0,9999,0
1668036191731,CSE 293,040,119537,Zhao; Jishen,9999,0,9999,0
1668036191731,CSE 293,041,119538,Zhou; Yuan-Yuan,9999,0,9999,0
1668036191731,CSE 293,042,119539,Gao; Sicun,9999,0,9999,0
1668036191731,CSE 293,043,119540,Weibel; Nadir,9999,0,9999,0
1668036191731,CSE 293,044,119541,Gupta; Rajesh K.,9999,0,9999,0
1668036191731,CSE 293,045,126410,Vaccaro; Kristen Marie,9999,0,9999,0
1668036191731,CSE 293,046,126411,Klemke; Richard,9999,0,9999,0
1668036192175,CSE 294,A00,102459,Voelker; Geoffrey M.,0,0,0,0
1668036192175,CSE 294,B00,111322,Orailoglu; Alex,0,0,0,0
1668036192600,DSE 201,A00,096914,Deutsch; Alin Bernard,30,0,30,0
1668036193037,DSE 210,A00,096915,Dasgupta; Sanjoy,30,0,30,0
1668036193459,DSE 260A,A00,096916,Altintas De Callaf; Ilkay,30,0,30,0
1668036193924,ECE 200,001,103586,Antipa; Nicholas A,9999,0,9999,0
1668036193924,ECE 200,002,103587,Atanasov; Nikolay A.,9999,0,9999,0
1668036193924,ECE 200,003,103588,Bharadia; Dinesh,9999,0,9999,0
1668036193924,ECE 200,004,103589,Cheng; Chung Kuan,9999,0,9999,0
1668036193924,ECE 200,005,103590,Cosman; Pamela C.,9999,0,9999,0
1668036193924,ECE 200,006,103591,Dayeh; Shadi Ahmad,9999,0,9999,0
1668036193924,ECE 200,007,103592,Fainman; Yeshaiahu,9999,0,9999,0
1668036193924,ECE 200,008,103593,Ford; Joseph Earl,9999,0,9999,0
1668036193924,ECE 200,009,103594,Franceschetti; Massimo,9999,0,9999,0
1668036193924,ECE 200,010,103595,Fullerton; Eric E,9999,0,9999,0
1668036193924,ECE 200,011,103596,Galton; Ian A,9999,0,9999,0
1668036193924,ECE 200,012,103597,Gilja; Vikash,9999,0,9999,0
1668036193924,ECE 200,013,103598,Hall; Drew A.,9999,0,9999,0
1668036193924,ECE 200,014,103599,Hsueh; Tzu-Chien,9999,0,9999,0
1668036193924,ECE 200,015,103600,Javidi; Tara,9999,0,9999,0
1668036193924,ECE 200,016,103601,Kahng; Andrew Byun,9999,0,9999,0
1668036193924,ECE 200,017,103602,Kim; Young-Han,9999,0,9999,0
1668036193924,ECE 200,018,103603,Koushanfar; Farinaz,9999,0,9999,0
1668036193924,ECE 200,019,103604,Kuzum; Duygu,9999,0,9999,0
1668036193924,ECE 200,020,103605,Le; Hanh-Phuc,9999,0,9999,0
1668036193924,ECE 200,021,103606,Lin; Bill,9999,0,9999,0
1668036193924,ECE 200,022,103607,Liu; Zhaowei,9998,0,9999,1
1668036193924,ECE 200,023,103608,Lo; Yu-Hwa,9999,0,9999,0
1668036193924,ECE 200,024,103609,Lomakin; Vitaliy,9999,0,9999,0
1668036193924,ECE 200,025,103610,Mercier; Patrick Philip,9999,0,9999,0
1668036193924,ECE 200,026,103611,Meyer; Florian,9999,0,9999,0
1668036193924,ECE 200,027,103612,Milstein; Laurence B.,9999,0,9999,0
1668036193924,ECE 200,028,103613,Mir Arabbaygi; Siavash,9999,0,9999,0
1668036193924,ECE 200,029,103614,Mookherjea; Shayan,9999,0,9999,0
1668036193924,ECE 200,030,103615,Morris; Karcher William,9999,0,9999,0
1668036193924,ECE 200,031,103616,Ng; Tse Nga,9999,0,9999,0
1668036193924,ECE 200,032,103617,Nguyen; Truong Quang,9999,0,9999,0
1668036193924,ECE 200,033,103618,Nomura; Kenji,9999,0,9999,0
1668036193924,ECE 200,034,103619,Orlitsky; Alon,9999,0,9999,0
1668036193924,ECE 200,035,103620,Pal; Piya,9999,0,9999,0
1668036193924,ECE 200,036,103621,Papen; George C.,9999,0,9999,0
1668036193924,ECE 200,037,103622,Radic; Stojan,9999,0,9999,0
1668036193924,ECE 200,038,103623,Rao; Bhaskar D.,9999,0,9999,0
1668036193924,ECE 200,039,103624,Rao; Ramesh R,9999,0,9999,0
1668036193924,ECE 200,040,103625,Rebeiz; Gabriel,9999,0,9999,0
1668036193924,ECE 200,041,103626,Sanford; John R,9999,0,9999,0
1668036193924,ECE 200,042,103627,Siegel; Paul H.,9999,0,9999,0
1668036193924,ECE 200,043,103628,Sievenpiper; Daniel F.,9999,0,9999,0
1668036193924,ECE 200,044,103629,Sworder; David D.,9999,0,9999,0
1668036193924,ECE 200,045,103630,Taur; Yuan,9999,0,9999,0
1668036193924,ECE 200,046,103631,Touri; Behrouz,9999,0,9999,0
1668036193924,ECE 200,047,103632,Trivedi; Mohan M.,9999,0,9999,0
1668036193924,ECE 200,048,103633,Vasconcelos; Nuno,9999,0,9999,0
1668036193924,ECE 200,049,103634,Wang; Xiaolong,9999,0,9999,0
1668036193924,ECE 200,050,103635,Xie; Pengtao,9999,0,9999,0
1668036193924,ECE 200,051,103636,Yip; Michael,9999,0,9999,0
1668036193924,ECE 200,052,103637,Zeger; Kenneth A.,999,0,999,0
1668036193924,ECE 200,053,103638,Zhang; Xinyu,9999,0,9999,0
1668036193924,ECE 200,054,103639,Turakhia; Yatish Girish,9999,0,9999,0
1668036193924,ECE 200,055,103640,Kang; Mingu,9999,0,9999,0
1668036193924,ECE 200,056,103641,Shi; Yuanyuan,9999,0,9999,0
1668036193924,ECE 200,057,103642,Wang; Edward Jay,9999,0,9999,0
1668036193924,ECE 200,058,103643,Zheng; Yang,9999,0,9999,0
1668036194348,ECE 202,A00,103644,Kuzum; Duygu,0,0,0,0
1668036194777,ECE 212BN,A00,103646,Ng; Tse Nga,0,0,0,0
1668036195212,ECE 221,A00,111493,Staff,0,0,0,0
1668036195634,ECE 222B,A00,103647,Lomakin; Vitaliy,0,0,0,0
1668036196068,ECE 230B,A00,103648,Taur; Yuan,0,0,0,0
1668036196504,ECE 238B,A00,103649,Garay; Javier,0,0,0,0
1668036196935,ECE 240B,A00,112900,Fainman; Yeshaiahu,0,0,0,0
1668036197374,ECE 247A,A00,103650,Jokerst; Jesse Vincent,0,0,0,0
1668036197797,ECE 247B,A00,103651,Wang; Joseph,0,0,0,0
1668036198232,ECE 250,A00,103652,Siegel; Paul H.,0,0,0,0
1668036198655,ECE 251A,A00,103654,Rao; Bhaskar D.,0,0,0,0
1668036199080,ECE 257B,A00,103655,Bharadia; Dinesh,0,0,0,0
1668036199507,ECE 258A,A00,103656,Milstein; Laurence B.,0,0,0,0
1668036199939,ECE 260B,A00,103658,Kang; Mingu,0,0,0,0
1668036200360,ECE 264A,A00,103659,Galton; Ian A,0,0,0,0
1668036200793,ECE 265A,A00,103661,Gudem; Prasad S.S.,0,0,0,0
1668036201227,ECE 265D,A00,103662,Gudem; Prasad S.S.,0,0,0,0
1668036201652,ECE 268,A00,103663,Koushanfar; Farinaz,0,0,0,0
1668036202098,ECE 269,A01,103665,Pal; Piya,0,0,0,0
1668036202519,ECE 271B,A00,103666,Vasconcelos; Manuela,0,0,0,0
1668036202954,ECE 276A,A00,103667,Atanasov; Nikolay A.,0,0,0,0
1668036203377,ECE 277,A00,103668,An; Cheolhong,0,0,0,0
1668036203808,ECE 279,A00,117947,Hall; Drew A.,0,0,0,0
1668036204655,ECE 283,A00,103670,Hsueh; Tzu-Chien,0,0,0,0
1668036205083,ECE 284,A00,103671,Turakhia; Yatish Girish,0,0,0,0
1668036205506,ECE 285,A00,103672,Zheng; Yang,0,0,0,0
1668036205506,ECE 285,B00,103673,Sworder; David D.,0,0,0,0
1668036205933,ECE 287,A00,103676,Javidi; Tara,0,0,0,0
1668036206361,MATH 200B,A00,098023,Salehi Golsefidy; Alireza,13,0,15,2
1668036206816,MATH 202B,A00,098024,Rhoades; Brendon Patrick,10,0,15,5
1668036207243,MATH 203B,A00,098025,Oprea; Dragos N.,11,0,15,4
1668036207668,MATH 204B,A00,098026,Sorensen; Claus M,14,0,15,1
1668036208091,MATH 208,A00,098027,Izadi; Elham,7,0,10,3
1668036208527,MATH 209,A00,098028,Pollack; Aaron,10,0,10,0
1668036208971,MATH 211A,A00,112919,Rogalski; Daniel,9,0,10,1
1668036209395,MATH 211B,A00,112920,Seward; Brandon M.,9,0,10,1
1668036209825,MATH 218,A00,098029,Li; Bo,10,0,10,0
1668036210267,MATH 220B,A00,098030,Novak; Jonathan I,13,0,15,2
1668036210691,MATH 221A,A00,098031,Ebenfelt; Peter F,13,0,15,2
1668036211131,MATH 231B,A00,098032,Zlatos; Andrej,12,0,15,3
1668036211555,MATH 240B,A00,098033,Ni; Lei,9,0,15,6
1668036212008,MATH 243,A00,098034,Jekel; David Andrew,10,0,10,0
1668036212444,MATH 245A,A00,098035,Nie; Jiawang,0,0,15,16
1668036212876,MATH 248,A00,098036,Bejenaru; Ioan,10,0,10,0
1668036213383,MATH 250B,A00,098037,Spolaor; Luca,14,0,15,1
1668036213807,MATH 258,A00,098038,Ni; Lei,10,0,10,0
1668036214230,MATH 264B,A00,098041,Rhoades; Brendon Patrick,10,0,15,5
1668036214675,MATH 268,A00,098042,Buss; Samuel R,10,0,10,0
1668036215119,MATH 269,A00,098043,Rhoades; Brendon Patrick,10,0,10,0
1668036215545,MATH 270B,A00,098044,Li; Bo,11,0,15,4
1668036215980,MATH 272B,A00,098045,Holst; Michael J,13,0,15,2
1668036216415,MATH 273A,A00,098046,Tian; Xiaochuan,10,0,15,5
1668036216843,MATH 275,A01,098048,Tian; Xiaochuan,6,0,10,4
1668036217266,MATH 278A,A00,098049,Holst; Michael J,8,0,10,2
1668036217695,MATH 278B,A00,098050,Cloninger; Alexander,10,0,10,0
1668036218121,MATH 278C,A00,098051,Nie; Jiawang,8,0,10,2
1668036218556,MATH 280B,A00,098052,Zheng; Tianyi,11,0,15,4
1668036218999,MATH 281B,A00,098053,Bradic; Jelena,3,0,15,12
1668036219428,MATH 282B,A00,098054,Arias-Castro; Ery,2,0,15,13
1668036219855,MATH 285,A00,098055,Fitzsimmons; Patrick J,0,0,15,17
1668036220288,MATH 287B,A00,098056,Arias-Castro; Ery,4,0,15,11
1668036220722,MATH 288,A00,098057,Agarwal; Pooja,9,0,10,1
1668036220722,MATH 288,B00,098058,Zhang; Danna,9,0,10,1
1668036220722,MATH 288,C00,098059,Williams; Ruth J,10,0,10,0
1668036221153,MATH 290B,A00,098060,Roberts; Justin Deritter,13,0,15,2
1668036221575,MATH 292,A00,098061,Belmont; Eva Kinoshita,10,0,10,0
1668036222000,MATH 295,A00,098062,Suk; Andrew Hoon,48,0,50,2
1668036222423,MATH 296,A00,098063,Novak; Jonathan I,20,0,20,0
1668036222862,MATH 297,001,098064,Gamst; Anthony Collins,9997,0,9999,2
1668036739686,COGS 205,A00,101395,Chiba; Andrea,19,0,20,1
1668036740110,COGS 210B,001,101404,Greene; Deanna Jacquelyn,9998,0,9999,1
1668036740110,COGS 210B,002,101417,Xia; Haijun,9999,0,9999,0
1668036740110,COGS 210B,003,101422,Nitz; Douglas A.,9999,0,9999,0
1668036740110,COGS 210B,004,101423,Hollan; James D.,9998,0,9999,1
1668036740110,COGS 210B,005,101424,Deak; Gedeon O.,9998,0,9999,1
1668036740110,COGS 210B,006,101425,Rossano; Federico,9999,0,9999,0
1668036740552,COGS 211B,A00,101427,Coulson; Seana M,9996,0,9999,3
1668036740991,COGS 220,A00,101428,Hollan; James D.,0,0,25,25
1668036741423,COGS 229,A00,101429,Dow; Steven P,18,0,25,7
1668036741852,COGS 230,A00,101430,Klemmer; Scott R,13,0,17,4
1668036742280,COGS 234,A00,101431,Xia; Haijun,5,0,25,20
1668036742704,COGS 260,A00,101432,Kiyonaga; Anastasia,19,0,25,6
1668036742704,COGS 260,B00,101433,Kirsh; David Joel,16,0,25,9
1668036743128,CSE 202,A00,102371,Impagliazzo; Russell,0,0,0,0
1668036743556,CSE 203B,A01,102373,Cheng; Chung Kuan,0,0,0,0
1668036743980,CSE 208,A00,102374,Micciancio; Daniele,0,0,0,0
1668036744419,CSE 209A,A00,112895,Impagliazzo; Russell,0,0,15,15
1668036744854,CSE 209B,A00,108005,Bellare; Mihir,0,0,0,0
1668036745277,CSE 210,A00,113163,Coblenz; Michael J,0,0,0,0
1668036745703,CSE 219,A00,106111,Dow; Steven P,0,0,20,20
1668036746130,CSE 221,A00,102376,Voelker; Geoffrey M.,0,0,0,0
1668036746565,CSE 224,A01,102378,Porter; George M,0,0,0,0
1668036746991,CSE 229A,A00,102379,Savage; Stefan,0,0,0,0
1668036747434,CSE 229C,A00,102380,Munyaka; Imani N. S.,0,0,0,0
1668036747859,CSE 232B,A00,102382,Deutsch; Alin Bernard,0,0,0,0
1668036748282,CSE 234,A01,112904,Kumar; Arun Kumar,0,0,0,0
1668036748715,CSE 237A,A00,102383,Rosing; Tajana Simunic,0,0,0,0
1668036749140,CSE 239A,A00,102384,Deutsch; Alin Bernard,0,0,0,0
1668036749569,CSE 239B,A00,102385,Polikarpova; Nadezhda,0,0,0,0
1668036749996,CSE 240A,A00,102386,Pannuto; Patrick William,0,0,0,0
1668036750518,CSE 240B,A00,102387,Zhao; Jishen,0,0,0,0
1668036750943,CSE 241A,A00,106406,Kang; Mingu,0,0,0,0
1668036751371,CSE 249B,A00,102388,Kahng; Andrew Byun,0,0,8,8
1668036751823,CSE 251B,A01,102392,Cottrell; Garrison W,0,0,0,0
1668036751823,CSE 251B,A02,102393,Cottrell; Garrison W,0,0,0,0
1668036752245,CSE 252B,A00,102394,Ochoa; Benjamin Lawrence,0,0,0,0
1668036752671,CSE 257,A01,102396,Gao; Sicun,0,0,0,0
1668036753102,CSE 272,A00,102397,Li; Tzumao,0,0,0,0
1668036753526,CSE 274,A00,111323,Chern; Albert Ren-Haur,0,0,0,0
1668036753958,CSE 282,A00,102398,Pevzner; Pavel Arkadjevich,0,0,0,0
1668036754390,CSE 284,A00,114175,Gymrek; Melissa Ann,0,0,0,0
1668036754814,CSE 290,A00,102399,Chandraker; Manmohan Krishna,0,0,0,0
1668036754814,CSE 290,B00,102400,Vaccaro; Kristen Marie,0,0,25,25
1668036754814,CSE 290,C00,102414,Pannuto; Patrick William,0,0,25,25
1668036754814,CSE 290,D00,102427,Pevzner; Pavel Arkadjevich,0,0,0,0
1668036754814,CSE 290,E00,102429,Zhao; Jishen,0,0,0,0
1668036754814,CSE 290,F00,102436,Tullsen; Dean Michael,0,0,0,0
1668036754814,CSE 290,G00,102440,Christensen; Henrik I,0,0,20,20
1668036755253,CSE 291,A00,102443,Su; Hao,0,0,0,0
1668036755253,CSE 291,B00,102448,Polikarpova; Nadezhda,0,0,0,0
1668036755253,CSE 291,C00,102453,Vaccaro; Kristen Marie,0,0,0,0
1668036755253,CSE 291,D00,111343,Savage; Stefan,0,0,0,0
1668036755253,CSE 291,E00,116474,Claffy; Kimberly Claire,0,0,0,0
1668036755253,CSE 291,F00,116479,Pasquale; Joseph,0,0,0,0
1668036755709,CSE 293,001,119111,Bafna; Vineet,9999,0,9999,0
1668036755709,CSE 293,002,119118,Bellare; Mihir,9999,0,9999,0
1668036755709,CSE 293,003,119122,Berg-Kirkpatrick; Taylor D,9999,0,9999,0
1668036755709,CSE 293,004,119135,Christensen; Henrik I,9999,0,9999,0
1668036755709,CSE 293,005,119142,Cottrell; Garrison W,9999,0,9999,0
1668036755709,CSE 293,006,119146,Deutsch; Alin Bernard,9999,0,9999,0
1668036755709,CSE 293,007,119159,Esmaeilzadeh; Hadi,9999,0,9999,0
1668036755709,CSE 293,008,119166,Freund; Yoav,9999,0,9999,0
1668036755709,CSE 293,009,119170,Griswold; William G.,9999,0,9999,0
1668036755709,CSE 293,010,119183,Gymrek; Melissa Ann,9999,0,9999,0
1668036755709,CSE 293,011,119190,Heninger; Nadia A,9999,0,9999,0
1668036755709,CSE 293,012,119230,Impagliazzo; Russell,9999,0,9999,0
1668036755709,CSE 293,013,119232,Jhala; Ranjit,9999,0,9999,0
1668036755709,CSE 293,014,119233,Kahng; Andrew Byun,9999,0,9999,0
1668036755709,CSE 293,015,119298,Kane; Daniel Mertz,9999,0,9999,0
1668036755709,CSE 293,016,119299,Kriegman; David J,9999,0,9999,0
1668036755709,CSE 293,017,119300,Kumar; Arun Kumar,9999,0,9999,0
1668036755709,CSE 293,018,119301,Lerner; Sorin,9999,0,9999,0
1668036755709,CSE 293,019,119302,Lovett; Shachar,9999,0,9999,0
1668036755709,CSE 293,020,119303,McAuley; Julian John,9999,0,9999,0
1668036755709,CSE 293,021,119304,Micciancio; Daniele,9999,0,9999,0
1668036755709,CSE 293,022,119367,Orailoglu; Alex,9999,0,9999,0
1668036755709,CSE 293,023,119382,Paturi; Ramamohan,9999,0,9999,0
1668036755709,CSE 293,024,119404,Polikarpova; Nadezhda,9999,0,9999,0
1668036755709,CSE 293,025,119406,Politz; Joseph Gibbs,9999,0,9999,0
1668036755709,CSE 293,026,119411,Porter; George M,9999,0,9999,0
1668036755709,CSE 293,027,119414,Porter; Leonard Emerson,9999,0,9999,0
1668036755709,CSE 293,028,119416,Ramamoorthi; Ravi,9999,0,9999,0
1668036755709,CSE 293,029,119417,Sahoo; Debashis,9999,0,9999,0
1668036755709,CSE 293,030,119420,Saul; Lawrence,9999,0,9999,0
1668036755709,CSE 293,031,119421,Savage; Stefan,9999,0,9999,0
1668036755709,CSE 293,032,119425,Schulze; Jurgen P.,9999,0,9999,0
1668036755709,CSE 293,033,119426,Snoeren; Alex C.,9999,0,9999,0
1668036755709,CSE 293,034,119428,Shang; Jingbo,9999,0,9999,0
1668036755709,CSE 293,035,119430,Stefan; Deian,9999,0,9999,0
1668036755709,CSE 293,036,119431,Su; Hao,9999,0,9999,0
1668036755709,CSE 293,037,119433,Swanson; Steven James,9999,0,9999,0
1668036755709,CSE 293,038,119435,Tullsen; Dean Michael,9999,0,9999,0
1668036755709,CSE 293,039,119483,Voelker; Geoffrey M.,9999,0,9999,0
1668036755709,CSE 293,040,119537,Zhao; Jishen,9999,0,9999,0
1668036755709,CSE 293,041,119538,Zhou; Yuan-Yuan,9999,0,9999,0
1668036755709,CSE 293,042,119539,Gao; Sicun,9999,0,9999,0
1668036755709,CSE 293,043,119540,Weibel; Nadir,9999,0,9999,0
1668036755709,CSE 293,044,119541,Gupta; Rajesh K.,9999,0,9999,0
1668036755709,CSE 293,045,126410,Vaccaro; Kristen Marie,9999,0,9999,0
1668036755709,CSE 293,046,126411,Klemke; Richard,9999,0,9999,0
1668036756144,CSE 294,A00,102459,Voelker; Geoffrey M.,0,0,0,0
1668036756144,CSE 294,B00,111322,Orailoglu; Alex,0,0,0,0
1668036756570,DSE 201,A00,096914,Deutsch; Alin Bernard,30,0,30,0
1668036757028,DSE 210,A00,096915,Dasgupta; Sanjoy,30,0,30,0
1668036757463,DSE 260A,A00,096916,Altintas De Callaf; Ilkay,30,0,30,0
1668036757924,ECE 200,001,103586,Antipa; Nicholas A,9999,0,9999,0
1668036757924,ECE 200,002,103587,Atanasov; Nikolay A.,9999,0,9999,0
1668036757924,ECE 200,003,103588,Bharadia; Dinesh,9999,0,9999,0
1668036757924,ECE 200,004,103589,Cheng; Chung Kuan,9999,0,9999,0
1668036757924,ECE 200,005,103590,Cosman; Pamela C.,9999,0,9999,0
1668036757924,ECE 200,006,103591,Dayeh; Shadi Ahmad,9999,0,9999,0
1668036757924,ECE 200,007,103592,Fainman; Yeshaiahu,9999,0,9999,0
1668036757924,ECE 200,008,103593,Ford; Joseph Earl,9999,0,9999,0
1668036757924,ECE 200,009,103594,Franceschetti; Massimo,9999,0,9999,0
1668036757924,ECE 200,010,103595,Fullerton; Eric E,9999,0,9999,0
1668036757924,ECE 200,011,103596,Galton; Ian A,9999,0,9999,0
1668036757924,ECE 200,012,103597,Gilja; Vikash,9999,0,9999,0
1668036757924,ECE 200,013,103598,Hall; Drew A.,9999,0,9999,0
1668036757924,ECE 200,014,103599,Hsueh; Tzu-Chien,9999,0,9999,0
1668036757924,ECE 200,015,103600,Javidi; Tara,9999,0,9999,0
1668036757924,ECE 200,016,103601,Kahng; Andrew Byun,9999,0,9999,0
1668036757924,ECE 200,017,103602,Kim; Young-Han,9999,0,9999,0
1668036757924,ECE 200,018,103603,Koushanfar; Farinaz,9999,0,9999,0
1668036757924,ECE 200,019,103604,Kuzum; Duygu,9999,0,9999,0
1668036757924,ECE 200,020,103605,Le; Hanh-Phuc,9999,0,9999,0
1668036757924,ECE 200,021,103606,Lin; Bill,9999,0,9999,0
1668036757924,ECE 200,022,103607,Liu; Zhaowei,9998,0,9999,1
1668036757924,ECE 200,023,103608,Lo; Yu-Hwa,9999,0,9999,0
1668036757924,ECE 200,024,103609,Lomakin; Vitaliy,9999,0,9999,0
1668036757924,ECE 200,025,103610,Mercier; Patrick Philip,9999,0,9999,0
1668036757924,ECE 200,026,103611,Meyer; Florian,9999,0,9999,0
1668036757924,ECE 200,027,103612,Milstein; Laurence B.,9999,0,9999,0
1668036757924,ECE 200,028,103613,Mir Arabbaygi; Siavash,9999,0,9999,0
1668036757924,ECE 200,029,103614,Mookherjea; Shayan,9999,0,9999,0
1668036757924,ECE 200,030,103615,Morris; Karcher William,9999,0,9999,0
1668036757924,ECE 200,031,103616,Ng; Tse Nga,9999,0,9999,0
1668036757924,ECE 200,032,103617,Nguyen; Truong Quang,9999,0,9999,0
1668036757924,ECE 200,033,103618,Nomura; Kenji,9999,0,9999,0
1668036757924,ECE 200,034,103619,Orlitsky; Alon,9999,0,9999,0
1668036757924,ECE 200,035,103620,Pal; Piya,9999,0,9999,0
1668036757924,ECE 200,036,103621,Papen; George C.,9999,0,9999,0
1668036757924,ECE 200,037,103622,Radic; Stojan,9999,0,9999,0
1668036757924,ECE 200,038,103623,Rao; Bhaskar D.,9999,0,9999,0
1668036757924,ECE 200,039,103624,Rao; Ramesh R,9999,0,9999,0
1668036757924,ECE 200,040,103625,Rebeiz; Gabriel,9999,0,9999,0
1668036757924,ECE 200,041,103626,Sanford; John R,9999,0,9999,0
1668036757924,ECE 200,042,103627,Siegel; Paul H.,9999,0,9999,0
1668036757924,ECE 200,043,103628,Sievenpiper; Daniel F.,9999,0,9999,0
1668036757924,ECE 200,044,103629,Sworder; David D.,9999,0,9999,0
1668036757924,ECE 200,045,103630,Taur; Yuan,9999,0,9999,0
1668036757924,ECE 200,046,103631,Touri; Behrouz,9999,0,9999,0
1668036757924,ECE 200,047,103632,Trivedi; Mohan M.,9999,0,9999,0
1668036757924,ECE 200,048,103633,Vasconcelos; Nuno,9999,0,9999,0
1668036757924,ECE 200,049,103634,Wang; Xiaolong,9999,0,9999,0
1668036757924,ECE 200,050,103635,Xie; Pengtao,9999,0,9999,0
1668036757924,ECE 200,051,103636,Yip; Michael,9999,0,9999,0
1668036757924,ECE 200,052,103637,Zeger; Kenneth A.,999,0,999,0
1668036757924,ECE 200,053,103638,Zhang; Xinyu,9999,0,9999,0
1668036757924,ECE 200,054,103639,Turakhia; Yatish Girish,9999,0,9999,0
1668036757924,ECE 200,055,103640,Kang; Mingu,9999,0,9999,0
1668036757924,ECE 200,056,103641,Shi; Yuanyuan,9999,0,9999,0
1668036757924,ECE 200,057,103642,Wang; Edward Jay,9999,0,9999,0
1668036757924,ECE 200,058,103643,Zheng; Yang,9999,0,9999,0
1668036758349,ECE 202,A00,103644,Kuzum; Duygu,0,0,0,0
1668036758779,ECE 212BN,A00,103646,Ng; Tse Nga,0,0,0,0
1668036759206,ECE 221,A00,111493,Staff,0,0,0,0
1668036759637,ECE 222B,A00,103647,Lomakin; Vitaliy,0,0,0,0
1668036760060,ECE 230B,A00,103648,Taur; Yuan,0,0,0,0
1668036760483,ECE 238B,A00,103649,Garay; Javier,0,0,0,0
1668036760921,ECE 240B,A00,112900,Fainman; Yeshaiahu,0,0,0,0
1668036761346,ECE 247A,A00,103650,Jokerst; Jesse Vincent,0,0,0,0
1668036761782,ECE 247B,A00,103651,Wang; Joseph,0,0,0,0
1668036762216,ECE 250,A00,103652,Siegel; Paul H.,0,0,0,0
1668036762642,ECE 251A,A00,103654,Rao; Bhaskar D.,0,0,0,0
1668036763074,ECE 257B,A00,103655,Bharadia; Dinesh,0,0,0,0
1668036763502,ECE 258A,A00,103656,Milstein; Laurence B.,0,0,0,0
1668036763931,ECE 260B,A00,103658,Kang; Mingu,0,0,0,0
1668036764353,ECE 264A,A00,103659,Galton; Ian A,0,0,0,0
1668036764784,ECE 265A,A00,103661,Gudem; Prasad S.S.,0,0,0,0
1668036765222,ECE 265D,A00,103662,Gudem; Prasad S.S.,0,0,0,0
1668036765647,ECE 268,A00,103663,Koushanfar; Farinaz,0,0,0,0
1668036766075,ECE 269,A01,103665,Pal; Piya,0,0,0,0
1668036766517,ECE 271B,A00,103666,Vasconcelos; Manuela,0,0,0,0
1668036766952,ECE 276A,A00,103667,Atanasov; Nikolay A.,0,0,0,0
1668036767389,ECE 277,A00,103668,An; Cheolhong,0,0,0,0
1668036767816,ECE 279,A00,117947,Hall; Drew A.,0,0,0,0
1668036768666,ECE 283,A00,103670,Hsueh; Tzu-Chien,0,0,0,0
1668036769091,ECE 284,A00,103671,Turakhia; Yatish Girish,0,0,0,0
1668036769515,ECE 285,A00,103672,Zheng; Yang,0,0,0,0
1668036769515,ECE 285,B00,103673,Sworder; David D.,0,0,0,0
1668036769943,ECE 287,A00,103676,Javidi; Tara,0,0,0,0
1668036770369,MATH 200B,A00,098023,Salehi Golsefidy; Alireza,13,0,15,2
1668036770791,MATH 202B,A00,098024,Rhoades; Brendon Patrick,10,0,15,5
1668036771214,MATH 203B,A00,098025,Oprea; Dragos N.,11,0,15,4
1668036771662,MATH 204B,A00,098026,Sorensen; Claus M,14,0,15,1
1668036772097,MATH 208,A00,098027,Izadi; Elham,7,0,10,3
1668036772531,MATH 209,A00,098028,Pollack; Aaron,10,0,10,0
1668036772969,MATH 211A,A00,112919,Rogalski; Daniel,9,0,10,1
1668036773393,MATH 211B,A00,112920,Seward; Brandon M.,9,0,10,1
1668036773829,MATH 218,A00,098029,Li; Bo,10,0,10,0
1668036774255,MATH 220B,A00,098030,Novak; Jonathan I,13,0,15,2
1668036774685,MATH 221A,A00,098031,Ebenfelt; Peter F,13,0,15,2
1668036775108,MATH 231B,A00,098032,Zlatos; Andrej,12,0,15,3
1668036775539,MATH 240B,A00,098033,Ni; Lei,9,0,15,6
1668036775963,MATH 243,A00,098034,Jekel; David Andrew,10,0,10,0
1668036776390,MATH 245A,A00,098035,Nie; Jiawang,0,0,15,16
1668036776818,MATH 248,A00,098036,Bejenaru; Ioan,10,0,10,0
1668036777243,MATH 250B,A00,098037,Spolaor; Luca,14,0,15,1
1668036777695,MATH 258,A00,098038,Ni; Lei,10,0,10,0
1668036778123,MATH 264B,A00,098041,Rhoades; Brendon Patrick,10,0,15,5
1668036778546,MATH 268,A00,098042,Buss; Samuel R,10,0,10,0
1668036778971,MATH 269,A00,098043,Rhoades; Brendon Patrick,10,0,10,0
1668036779395,MATH 270B,A00,098044,Li; Bo,11,0,15,4
1668036779822,MATH 272B,A00,098045,Holst; Michael J,13,0,15,2
1668036780254,MATH 273A,A00,098046,Tian; Xiaochuan,10,0,15,5
1668036780677,MATH 275,A01,098048,Tian; Xiaochuan,6,0,10,4
1668036781107,MATH 278A,A00,098049,Holst; Michael J,8,0,10,2
1668036781551,MATH 278B,A00,098050,Cloninger; Alexander,10,0,10,0
1668036781993,MATH 278C,A00,098051,Nie; Jiawang,8,0,10,2
1668036782418,MATH 280B,A00,098052,Zheng; Tianyi,11,0,15,4
1668036782846,MATH 281B,A00,098053,Bradic; Jelena,3,0,15,12
1668036783272,MATH 282B,A00,098054,Arias-Castro; Ery,2,0,15,13
1668036783698,MATH 285,A00,098055,Fitzsimmons; Patrick J,0,0,15,17
1668036784123,MATH 287B,A00,098056,Arias-Castro; Ery,4,0,15,11
1668036784544,MATH 288,A00,098057,Agarwal; Pooja,9,0,10,1
1668036784544,MATH 288,B00,098058,Zhang; Danna,9,0,10,1
1668036784544,MATH 288,C00,098059,Williams; Ruth J,10,0,10,0
1668036784968,MATH 290B,A00,098060,Roberts; Justin Deritter,13,0,15,2
1668036785392,MATH 292,A00,098061,Belmont; Eva Kinoshita,10,0,10,0
1668036785819,MATH 295,A00,098062,Suk; Andrew Hoon,48,0,50,2
1668036786250,MATH 296,A00,098063,Novak; Jonathan I,20,0,20,0
1668036786685,MATH 297,001,098064,Gamst; Anthony Collins,9997,0,9999,2
1668037292728,COGS 205,A00,101395,Chiba; Andrea,19,0,20,1
1668037293160,COGS 210B,001,101404,Greene; Deanna Jacquelyn,9998,0,9999,1
1668037293160,COGS 210B,002,101417,Xia; Haijun,9999,0,9999,0
1668037293160,COGS 210B,003,101422,Nitz; Douglas A.,9999,0,9999,0
1668037293160,COGS 210B,004,101423,Hollan; James D.,9998,0,9999,1
1668037293160,COGS 210B,005,101424,Deak; Gedeon O.,9998,0,9999,1
1668037293160,COGS 210B,006,101425,Rossano; Federico,9999,0,9999,0
1668037293607,COGS 211B,A00,101427,Coulson; Seana M,9996,0,9999,3
1668037294034,COGS 220,A00,101428,Hollan; James D.,0,0,25,25
1668037294459,COGS 229,A00,101429,Dow; Steven P,18,0,25,7
1668037294881,COGS 230,A00,101430,Klemmer; Scott R,13,0,17,4
1668037295305,COGS 234,A00,101431,Xia; Haijun,5,0,25,20
1668037295728,COGS 260,A00,101432,Kiyonaga; Anastasia,19,0,25,6
1668037295728,COGS 260,B00,101433,Kirsh; David Joel,16,0,25,9
1668037296165,CSE 202,A00,102371,Impagliazzo; Russell,0,0,0,0
1668037296588,CSE 203B,A01,102373,Cheng; Chung Kuan,0,0,0,0
1668037297019,CSE 208,A00,102374,Micciancio; Daniele,0,0,0,0
1668037297442,CSE 209A,A00,112895,Impagliazzo; Russell,0,0,15,15
1668037297868,CSE 209B,A00,108005,Bellare; Mihir,0,0,0,0
1668037298296,CSE 210,A00,113163,Coblenz; Michael J,0,0,0,0
1668037298735,CSE 219,A00,106111,Dow; Steven P,0,0,20,20
1668037299173,CSE 221,A00,102376,Voelker; Geoffrey M.,0,0,0,0
1668037299622,CSE 224,A01,102378,Porter; George M,0,0,0,0
1668037300049,CSE 229A,A00,102379,Savage; Stefan,0,0,0,0
1668037300475,CSE 229C,A00,102380,Munyaka; Imani N. S.,0,0,0,0
1668037300900,CSE 232B,A00,102382,Deutsch; Alin Bernard,0,0,0,0
1668037301329,CSE 234,A01,112904,Kumar; Arun Kumar,0,0,0,0
1668037301753,CSE 237A,A00,102383,Rosing; Tajana Simunic,0,0,0,0
1668037302187,CSE 239A,A00,102384,Deutsch; Alin Bernard,0,0,0,0
1668037302616,CSE 239B,A00,102385,Polikarpova; Nadezhda,0,0,0,0
1668037303043,CSE 240A,A00,102386,Pannuto; Patrick William,0,0,0,0
1668037303478,CSE 240B,A00,102387,Zhao; Jishen,0,0,0,0
1668037303910,CSE 241A,A00,106406,Kang; Mingu,0,0,0,0
1668037304349,CSE 249B,A00,102388,Kahng; Andrew Byun,0,0,8,8
1668037304783,CSE 251B,A01,102392,Cottrell; Garrison W,0,0,0,0
1668037304783,CSE 251B,A02,102393,Cottrell; Garrison W,0,0,0,0
1668037305215,CSE 252B,A00,102394,Ochoa; Benjamin Lawrence,0,0,0,0
1668037305640,CSE 257,A01,102396,Gao; Sicun,0,0,0,0
1668037306066,CSE 272,A00,102397,Li; Tzumao,0,0,0,0
1668037306491,CSE 274,A00,111323,Chern; Albert Ren-Haur,0,0,0,0
1668037306940,CSE 282,A00,102398,Pevzner; Pavel Arkadjevich,0,0,0,0
1668037307377,CSE 284,A00,114175,Gymrek; Melissa Ann,0,0,0,0
1668037307811,CSE 290,A00,102399,Chandraker; Manmohan Krishna,0,0,0,0
1668037307811,CSE 290,B00,102400,Vaccaro; Kristen Marie,0,0,25,25
1668037307811,CSE 290,C00,102414,Pannuto; Patrick William,0,0,25,25
1668037307811,CSE 290,D00,102427,Pevzner; Pavel Arkadjevich,0,0,0,0
1668037307811,CSE 290,E00,102429,Zhao; Jishen,0,0,0,0
1668037307811,CSE 290,F00,102436,Tullsen; Dean Michael,0,0,0,0
1668037307811,CSE 290,G00,102440,Christensen; Henrik I,0,0,20,20
1668037308243,CSE 291,A00,102443,Su; Hao,0,0,0,0
1668037308243,CSE 291,B00,102448,Polikarpova; Nadezhda,0,0,0,0
1668037308243,CSE 291,C00,102453,Vaccaro; Kristen Marie,0,0,0,0
1668037308243,CSE 291,D00,111343,Savage; Stefan,0,0,0,0
1668037308243,CSE 291,E00,116474,Claffy; Kimberly Claire,0,0,0,0
1668037308243,CSE 291,F00,116479,Pasquale; Joseph,0,0,0,0
1668037308716,CSE 293,001,119111,Bafna; Vineet,9999,0,9999,0
1668037308716,CSE 293,002,119118,Bellare; Mihir,9999,0,9999,0
1668037308716,CSE 293,003,119122,Berg-Kirkpatrick; Taylor D,9999,0,9999,0
1668037308716,CSE 293,004,119135,Christensen; Henrik I,9999,0,9999,0
1668037308716,CSE 293,005,119142,Cottrell; Garrison W,9999,0,9999,0
1668037308716,CSE 293,006,119146,Deutsch; Alin Bernard,9999,0,9999,0
1668037308716,CSE 293,007,119159,Esmaeilzadeh; Hadi,9999,0,9999,0
1668037308716,CSE 293,008,119166,Freund; Yoav,9999,0,9999,0
1668037308716,CSE 293,009,119170,Griswold; William G.,9999,0,9999,0
1668037308716,CSE 293,010,119183,Gymrek; Melissa Ann,9999,0,9999,0
1668037308716,CSE 293,011,119190,Heninger; Nadia A,9999,0,9999,0
1668037308716,CSE 293,012,119230,Impagliazzo; Russell,9999,0,9999,0
1668037308716,CSE 293,013,119232,Jhala; Ranjit,9999,0,9999,0
1668037308716,CSE 293,014,119233,Kahng; Andrew Byun,9999,0,9999,0
1668037308716,CSE 293,015,119298,Kane; Daniel Mertz,9999,0,9999,0
1668037308716,CSE 293,016,119299,Kriegman; David J,9999,0,9999,0
1668037308716,CSE 293,017,119300,Kumar; Arun Kumar,9999,0,9999,0
1668037308716,CSE 293,018,119301,Lerner; Sorin,9999,0,9999,0
1668037308716,CSE 293,019,119302,Lovett; Shachar,9999,0,9999,0
1668037308716,CSE 293,020,119303,McAuley; Julian John,9999,0,9999,0
1668037308716,CSE 293,021,119304,Micciancio; Daniele,9999,0,9999,0
1668037308716,CSE 293,022,119367,Orailoglu; Alex,9999,0,9999,0
1668037308716,CSE 293,023,119382,Paturi; Ramamohan,9999,0,9999,0
1668037308716,CSE 293,024,119404,Polikarpova; Nadezhda,9999,0,9999,0
1668037308716,CSE 293,025,119406,Politz; Joseph Gibbs,9999,0,9999,0
1668037308716,CSE 293,026,119411,Porter; George M,9999,0,9999,0
1668037308716,CSE 293,027,119414,Porter; Leonard Emerson,9999,0,9999,0
1668037308716,CSE 293,028,119416,Ramamoorthi; Ravi,9999,0,9999,0
1668037308716,CSE 293,029,119417,Sahoo; Debashis,9999,0,9999,0
1668037308716,CSE 293,030,119420,Saul; Lawrence,9999,0,9999,0
1668037308716,CSE 293,031,119421,Savage; Stefan,9999,0,9999,0
1668037308716,CSE 293,032,119425,Schulze; Jurgen P.,9999,0,9999,0
1668037308716,CSE 293,033,119426,Snoeren; Alex C.,9999,0,9999,0
1668037308716,CSE 293,034,119428,Shang; Jingbo,9999,0,9999,0
1668037308716,CSE 293,035,119430,Stefan; Deian,9999,0,9999,0
1668037308716,CSE 293,036,119431,Su; Hao,9999,0,9999,0
1668037308716,CSE 293,037,119433,Swanson; Steven James,9999,0,9999,0
1668037308716,CSE 293,038,119435,Tullsen; Dean Michael,9999,0,9999,0
1668037308716,CSE 293,039,119483,Voelker; Geoffrey M.,9999,0,9999,0
1668037308716,CSE 293,040,119537,Zhao; Jishen,9999,0,9999,0
1668037308716,CSE 293,041,119538,Zhou; Yuan-Yuan,9999,0,9999,0
1668037308716,CSE 293,042,119539,Gao; Sicun,9999,0,9999,0
1668037308716,CSE 293,043,119540,Weibel; Nadir,9999,0,9999,0
1668037308716,CSE 293,044,119541,Gupta; Rajesh K.,9999,0,9999,0
1668037308716,CSE 293,045,126410,Vaccaro; Kristen Marie,9999,0,9999,0
1668037308716,CSE 293,046,126411,Klemke; Richard,9999,0,9999,0
1668037309140,CSE 294,A00,102459,Voelker; Geoffrey M.,0,0,0,0
1668037309140,CSE 294,B00,111322,Orailoglu; Alex,0,0,0,0
1668037309568,DSE 201,A00,096914,Deutsch; Alin Bernard,30,0,30,0
1668037309994,DSE 210,A00,096915,Dasgupta; Sanjoy,30,0,30,0
1668037310436,DSE 260A,A00,096916,Altintas De Callaf; Ilkay,30,0,30,0
1668037310888,ECE 200,001,103586,Antipa; Nicholas A,9999,0,9999,0
1668037310888,ECE 200,002,103587,Atanasov; Nikolay A.,9999,0,9999,0
1668037310888,ECE 200,003,103588,Bharadia; Dinesh,9999,0,9999,0
1668037310888,ECE 200,004,103589,Cheng; Chung Kuan,9999,0,9999,0
1668037310888,ECE 200,005,103590,Cosman; Pamela C.,9999,0,9999,0
1668037310888,ECE 200,006,103591,Dayeh; Shadi Ahmad,9999,0,9999,0
1668037310888,ECE 200,007,103592,Fainman; Yeshaiahu,9999,0,9999,0
1668037310888,ECE 200,008,103593,Ford; Joseph Earl,9999,0,9999,0
1668037310888,ECE 200,009,103594,Franceschetti; Massimo,9999,0,9999,0
1668037310888,ECE 200,010,103595,Fullerton; Eric E,9999,0,9999,0
1668037310888,ECE 200,011,103596,Galton; Ian A,9999,0,9999,0
1668037310888,ECE 200,012,103597,Gilja; Vikash,9999,0,9999,0
1668037310888,ECE 200,013,103598,Hall; Drew A.,9999,0,9999,0
1668037310888,ECE 200,014,103599,Hsueh; Tzu-Chien,9999,0,9999,0
1668037310888,ECE 200,015,103600,Javidi; Tara,9999,0,9999,0
1668037310888,ECE 200,016,103601,Kahng; Andrew Byun,9999,0,9999,0
1668037310888,ECE 200,017,103602,Kim; Young-Han,9999,0,9999,0
1668037310888,ECE 200,018,103603,Koushanfar; Farinaz,9999,0,9999,0
1668037310888,ECE 200,019,103604,Kuzum; Duygu,9999,0,9999,0
1668037310888,ECE 200,020,103605,Le; Hanh-Phuc,9999,0,9999,0
1668037310888,ECE 200,021,103606,Lin; Bill,9999,0,9999,0
1668037310888,ECE 200,022,103607,Liu; Zhaowei,9998,0,9999,1
1668037310888,ECE 200,023,103608,Lo; Yu-Hwa,9999,0,9999,0
1668037310888,ECE 200,024,103609,Lomakin; Vitaliy,9999,0,9999,0
1668037310888,ECE 200,025,103610,Mercier; Patrick Philip,9999,0,9999,0
1668037310888,ECE 200,026,103611,Meyer; Florian,9999,0,9999,0
1668037310888,ECE 200,027,103612,Milstein; Laurence B.,9999,0,9999,0
1668037310888,ECE 200,028,103613,Mir Arabbaygi; Siavash,9999,0,9999,0
1668037310888,ECE 200,029,103614,Mookherjea; Shayan,9999,0,9999,0
1668037310888,ECE 200,030,103615,Morris; Karcher William,9999,0,9999,0
1668037310888,ECE 200,031,103616,Ng; Tse Nga,9999,0,9999,0
1668037310888,ECE 200,032,103617,Nguyen; Truong Quang,9999,0,9999,0
1668037310888,ECE 200,033,103618,Nomura; Kenji,9999,0,9999,0
1668037310888,ECE 200,034,103619,Orlitsky; Alon,9999,0,9999,0
1668037310888,ECE 200,035,103620,Pal; Piya,9999,0,9999,0
1668037310888,ECE 200,036,103621,Papen; George C.,9999,0,9999,0
1668037310888,ECE 200,037,103622,Radic; Stojan,9999,0,9999,0
1668037310888,ECE 200,038,103623,Rao; Bhaskar D.,9999,0,9999,0
1668037310888,ECE 200,039,103624,Rao; Ramesh R,9999,0,9999,0
1668037310888,ECE 200,040,103625,Rebeiz; Gabriel,9999,0,9999,0
1668037310888,ECE 200,041,103626,Sanford; John R,9999,0,9999,0
1668037310888,ECE 200,042,103627,Siegel; Paul H.,9999,0,9999,0
1668037310888,ECE 200,043,103628,Sievenpiper; Daniel F.,9999,0,9999,0
1668037310888,ECE 200,044,103629,Sworder; David D.,9999,0,9999,0
1668037310888,ECE 200,045,103630,Taur; Yuan,9999,0,9999,0
1668037310888,ECE 200,046,103631,Touri; Behrouz,9999,0,9999,0
1668037310888,ECE 200,047,103632,Trivedi; Mohan M.,9999,0,9999,0
1668037310888,ECE 200,048,103633,Vasconcelos; Nuno,9999,0,9999,0
1668037310888,ECE 200,049,103634,Wang; Xiaolong,9999,0,9999,0
1668037310888,ECE 200,050,103635,Xie; Pengtao,9999,0,9999,0
1668037310888,ECE 200,051,103636,Yip; Michael,9999,0,9999,0
1668037310888,ECE 200,052,103637,Zeger; Kenneth A.,999,0,999,0
1668037310888,ECE 200,053,103638,Zhang; Xinyu,9999,0,9999,0
1668037310888,ECE 200,054,103639,Turakhia; Yatish Girish,9999,0,9999,0
1668037310888,ECE 200,055,103640,Kang; Mingu,9999,0,9999,0
1668037310888,ECE 200,056,103641,Shi; Yuanyuan,9999,0,9999,0
1668037310888,ECE 200,057,103642,Wang; Edward Jay,9999,0,9999,0
1668037310888,ECE 200,058,103643,Zheng; Yang,9999,0,9999,0
1668037311312,ECE 202,A00,103644,Kuzum; Duygu,0,0,0,0
1668037311744,ECE 212BN,A00,103646,Ng; Tse Nga,0,0,0,0
1668037312183,ECE 221,A00,111493,Staff,0,0,0,0
1668037312620,ECE 222B,A00,103647,Lomakin; Vitaliy,0,0,0,0
1668037313052,ECE 230B,A00,103648,Taur; Yuan,0,0,0,0
1668037313474,ECE 238B,A00,103649,Garay; Javier,0,0,0,0
1668037313898,ECE 240B,A00,112900,Fainman; Yeshaiahu,0,0,0,0
1668037314321,ECE 247A,A00,103650,Jokerst; Jesse Vincent,0,0,0,0
1668037314743,ECE 247B,A00,103651,Wang; Joseph,0,0,0,0
1668037315167,ECE 250,A00,103652,Siegel; Paul H.,0,0,0,0
1668037315589,ECE 251A,A00,103654,Rao; Bhaskar D.,0,0,0,0
1668037316023,ECE 257B,A00,103655,Bharadia; Dinesh,0,0,0,0
1668037316446,ECE 258A,A00,103656,Milstein; Laurence B.,0,0,0,0
1668037316877,ECE 260B,A00,103658,Kang; Mingu,0,0,0,0
1668037317304,ECE 264A,A00,103659,Galton; Ian A,0,0,0,0
1668037317730,ECE 265A,A00,103661,Gudem; Prasad S.S.,0,0,0,0
1668037318152,ECE 265D,A00,103662,Gudem; Prasad S.S.,0,0,0,0
1668037318590,ECE 268,A00,103663,Koushanfar; Farinaz,0,0,0,0
1668037319043,ECE 269,A01,103665,Pal; Piya,0,0,0,0
1668037319468,ECE 271B,A00,103666,Vasconcelos; Manuela,0,0,0,0
1668037319892,ECE 276A,A00,103667,Atanasov; Nikolay A.,0,0,0,0
1668037320399,ECE 277,A00,103668,An; Cheolhong,0,0,0,0
1668037320823,ECE 279,A00,117947,Hall; Drew A.,0,0,0,0
1668037321676,ECE 283,A00,103670,Hsueh; Tzu-Chien,0,0,0,0
1668037322104,ECE 284,A00,103671,Turakhia; Yatish Girish,0,0,0,0
1668037322538,ECE 285,A00,103672,Zheng; Yang,0,0,0,0
1668037322538,ECE 285,B00,103673,Sworder; David D.,0,0,0,0
1668037322967,ECE 287,A00,103676,Javidi; Tara,0,0,0,0
1668037323452,MATH 200B,A00,098023,Salehi Golsefidy; Alireza,13,0,15,2
1668037323891,MATH 202B,A00,098024,Rhoades; Brendon Patrick,10,0,15,5
1668037324325,MATH 203B,A00,098025,Oprea; Dragos N.,11,0,15,4
1668037324767,MATH 204B,A00,098026,Sorensen; Claus M,14,0,15,1
1668037325203,MATH 208,A00,098027,Izadi; Elham,7,0,10,3
1668037325646,MATH 209,A00,098028,Pollack; Aaron,10,0,10,0
1668037326072,MATH 211A,A00,112919,Rogalski; Daniel,9,0,10,1
1668037326500,MATH 211B,A00,112920,Seward; Brandon M.,9,0,10,1
1668037326924,MATH 218,A00,098029,Li; Bo,10,0,10,0
1668037327351,MATH 220B,A00,098030,Novak; Jonathan I,13,0,15,2
1668037327791,MATH 221A,A00,098031,Ebenfelt; Peter F,13,0,15,2
1668037328222,MATH 231B,A00,098032,Zlatos; Andrej,12,0,15,3
1668037328650,MATH 240B,A00,098033,Ni; Lei,9,0,15,6
1668037329075,MATH 243,A00,098034,Jekel; David Andrew,10,0,10,0
1668037329502,MATH 245A,A00,098035,Nie; Jiawang,0,0,15,16
1668037329946,MATH 248,A00,098036,Bejenaru; Ioan,10,0,10,0
1668037330373,MATH 250B,A00,098037,Spolaor; Luca,14,0,15,1
1668037330807,MATH 258,A00,098038,Ni; Lei,10,0,10,0
1668037331239,MATH 264B,A00,098041,Rhoades; Brendon Patrick,10,0,15,5
1668037331663,MATH 268,A00,098042,Buss; Samuel R,10,0,10,0
1668037332092,MATH 269,A00,098043,Rhoades; Brendon Patrick,10,0,10,0
1668037332514,MATH 270B,A00,098044,Li; Bo,11,0,15,4
1668037332949,MATH 272B,A00,098045,Holst; Michael J,13,0,15,2
1668037333379,MATH 273A,A00,098046,Tian; Xiaochuan,10,0,15,5
1668037333816,MATH 275,A01,098048,Tian; Xiaochuan,6,0,10,4
1668037334241,MATH 278A,A00,098049,Holst; Michael J,8,0,10,2
1668037334668,MATH 278B,A00,098050,Cloninger; Alexander,10,0,10,0
1668037335102,MATH 278C,A00,098051,Nie; Jiawang,8,0,10,2
1668037335539,MATH 280B,A00,098052,Zheng; Tianyi,11,0,15,4
1668037335969,MATH 281B,A00,098053,Bradic; Jelena,3,0,15,12
1668037336394,MATH 282B,A00,098054,Arias-Castro; Ery,2,0,15,13
1668037336817,MATH 285,A00,098055,Fitzsimmons; Patrick J,0,0,15,17
1668037337255,MATH 287B,A00,098056,Arias-Castro; Ery,4,0,15,11
1668037337683,MATH 288,A00,098057,Agarwal; Pooja,9,0,10,1
1668037337683,MATH 288,B00,098058,Zhang; Danna,9,0,10,1
1668037337683,MATH 288,C00,098059,Williams; Ruth J,10,0,10,0
1668037338107,MATH 290B,A00,098060,Roberts; Justin Deritter,13,0,15,2
1668037338535,MATH 292,A00,098061,Belmont; Eva Kinoshita,10,0,10,0
1668037338959,MATH 295,A00,098062,Suk; Andrew Hoon,48,0,50,2
1668037339392,MATH 296,A00,098063,Novak; Jonathan I,20,0,20,0
1668037339819,MATH 297,001,098064,Gamst; Anthony Collins,9997,0,9999,2
1668037845104,COGS 205,A00,101395,Chiba; Andrea,19,0,20,1
1668037845539,COGS 210B,001,101404,Greene; Deanna Jacquelyn,9998,0,9999,1
1668037845539,COGS 210B,002,101417,Xia; Haijun,9999,0,9999,0
1668037845539,COGS 210B,003,101422,Nitz; Douglas A.,9999,0,9999,0
1668037845539,COGS 210B,004,101423,Hollan; James D.,9998,0,9999,1
1668037845539,COGS 210B,005,101424,Deak; Gedeon O.,9998,0,9999,1
1668037845539,COGS 210B,006,101425,Rossano; Federico,9999,0,9999,0
1668037846063,COGS 211B,A00,101427,Coulson; Seana M,9996,0,9999,3
1668037846487,COGS 220,A00,101428,Hollan; James D.,0,0,25,25
1668037846911,COGS 229,A00,101429,Dow; Steven P,18,0,25,7
1668037847343,COGS 230,A00,101430,Klemmer; Scott R,13,0,17,4
1668037847772,COGS 234,A00,101431,Xia; Haijun,5,0,25,20
1668037848200,COGS 260,A00,101432,Kiyonaga; Anastasia,19,0,25,6
1668037848200,COGS 260,B00,101433,Kirsh; David Joel,16,0,25,9
1668037848628,CSE 202,A00,102371,Impagliazzo; Russell,0,0,0,0
1668037849074,CSE 203B,A01,102373,Cheng; Chung Kuan,0,0,0,0
1668037849504,CSE 208,A00,102374,Micciancio; Daniele,0,0,0,0
1668037849935,CSE 209A,A00,112895,Impagliazzo; Russell,0,0,15,15
1668037850367,CSE 209B,A00,108005,Bellare; Mihir,0,0,0,0
1668037850799,CSE 210,A00,113163,Coblenz; Michael J,0,0,0,0
1668037851234,CSE 219,A00,106111,Dow; Steven P,0,0,20,20
1668037851657,CSE 221,A00,102376,Voelker; Geoffrey M.,0,0,0,0
1668037852083,CSE 224,A01,102378,Porter; George M,0,0,0,0
1668037852504,CSE 229A,A00,102379,Savage; Stefan,0,0,0,0
1668037852926,CSE 229C,A00,102380,Munyaka; Imani N. S.,0,0,0,0
1668037853355,CSE 232B,A00,102382,Deutsch; Alin Bernard,0,0,0,0
1668037853779,CSE 234,A01,112904,Kumar; Arun Kumar,0,0,0,0
1668037854205,CSE 237A,A00,102383,Rosing; Tajana Simunic,0,0,0,0
1668037854631,CSE 239A,A00,102384,Deutsch; Alin Bernard,0,0,0,0
1668037855064,CSE 239B,A00,102385,Polikarpova; Nadezhda,0,0,0,0
1668037855490,CSE 240A,A00,102386,Pannuto; Patrick William,0,0,0,0
1668037855915,CSE 240B,A00,102387,Zhao; Jishen,0,0,0,0
1668037856338,CSE 241A,A00,106406,Kang; Mingu,0,0,0,0
1668037856766,CSE 249B,A00,102388,Kahng; Andrew Byun,0,0,8,8
1668037857204,CSE 251B,A01,102392,Cottrell; Garrison W,0,0,0,0
1668037857204,CSE 251B,A02,102393,Cottrell; Garrison W,0,0,0,0
1668037857630,CSE 252B,A00,102394,Ochoa; Benjamin Lawrence,0,0,0,0
1668037858057,CSE 257,A01,102396,Gao; Sicun,0,0,0,0
1668037858483,CSE 272,A00,102397,Li; Tzumao,0,0,0,0
1668037858915,CSE 274,A00,111323,Chern; Albert Ren-Haur,0,0,0,0
1668037859345,CSE 282,A00,102398,Pevzner; Pavel Arkadjevich,0,0,0,0
1668037859791,CSE 284,A00,114175,Gymrek; Melissa Ann,0,0,0,0
1668037860218,CSE 290,A00,102399,Chandraker; Manmohan Krishna,0,0,0,0
1668037860218,CSE 290,B00,102400,Vaccaro; Kristen Marie,0,0,25,25
1668037860218,CSE 290,C00,102414,Pannuto; Patrick William,0,0,25,25
1668037860218,CSE 290,D00,102427,Pevzner; Pavel Arkadjevich,0,0,0,0
1668037860218,CSE 290,E00,102429,Zhao; Jishen,0,0,0,0
1668037860218,CSE 290,F00,102436,Tullsen; Dean Michael,0,0,0,0
1668037860218,CSE 290,G00,102440,Christensen; Henrik I,0,0,20,20
1668037860650,CSE 291,A00,102443,Su; Hao,0,0,0,0
1668037860650,CSE 291,B00,102448,Polikarpova; Nadezhda,0,0,0,0
1668037860650,CSE 291,C00,102453,Vaccaro; Kristen Marie,0,0,0,0
1668037860650,CSE 291,D00,111343,Savage; Stefan,0,0,0,0
1668037860650,CSE 291,E00,116474,Claffy; Kimberly Claire,0,0,0,0
1668037860650,CSE 291,F00,116479,Pasquale; Joseph,0,0,0,0
1668037861082,CSE 293,001,119111,Bafna; Vineet,9999,0,9999,0
1668037861082,CSE 293,002,119118,Bellare; Mihir,9999,0,9999,0
1668037861082,CSE 293,003,119122,Berg-Kirkpatrick; Taylor D,9999,0,9999,0
1668037861082,CSE 293,004,119135,Christensen; Henrik I,9999,0,9999,0
1668037861082,CSE 293,005,119142,Cottrell; Garrison W,9999,0,9999,0
1668037861082,CSE 293,006,119146,Deutsch; Alin Bernard,9999,0,9999,0
1668037861082,CSE 293,007,119159,Esmaeilzadeh; Hadi,9999,0,9999,0
1668037861082,CSE 293,008,119166,Freund; Yoav,9999,0,9999,0
1668037861082,CSE 293,009,119170,Griswold; William G.,9999,0,9999,0
1668037861082,CSE 293,010,119183,Gymrek; Melissa Ann,9999,0,9999,0
1668037861082,CSE 293,011,119190,Heninger; Nadia A,9999,0,9999,0
1668037861082,CSE 293,012,119230,Impagliazzo; Russell,9999,0,9999,0
1668037861082,CSE 293,013,119232,Jhala; Ranjit,9999,0,9999,0
1668037861082,CSE 293,014,119233,Kahng; Andrew Byun,9999,0,9999,0
1668037861082,CSE 293,015,119298,Kane; Daniel Mertz,9999,0,9999,0
1668037861082,CSE 293,016,119299,Kriegman; David J,9999,0,9999,0
1668037861082,CSE 293,017,119300,Kumar; Arun Kumar,9999,0,9999,0
1668037861082,CSE 293,018,119301,Lerner; Sorin,9999,0,9999,0
1668037861082,CSE 293,019,119302,Lovett; Shachar,9999,0,9999,0
1668037861082,CSE 293,020,119303,McAuley; Julian John,9999,0,9999,0
1668037861082,CSE 293,021,119304,Micciancio; Daniele,9999,0,9999,0
1668037861082,CSE 293,022,119367,Orailoglu; Alex,9999,0,9999,0
1668037861082,CSE 293,023,119382,Paturi; Ramamohan,9999,0,9999,0
1668037861082,CSE 293,024,119404,Polikarpova; Nadezhda,9999,0,9999,0
1668037861082,CSE 293,025,119406,Politz; Joseph Gibbs,9999,0,9999,0
1668037861082,CSE 293,026,119411,Porter; George M,9999,0,9999,0
1668037861082,CSE 293,027,119414,Porter; Leonard Emerson,9999,0,9999,0
1668037861082,CSE 293,028,119416,Ramamoorthi; Ravi,9999,0,9999,0
1668037861082,CSE 293,029,119417,Sahoo; Debashis,9999,0,9999,0
1668037861082,CSE 293,030,119420,Saul; Lawrence,9999,0,9999,0
1668037861082,CSE 293,031,119421,Savage; Stefan,9999,0,9999,0
1668037861082,CSE 293,032,119425,Schulze; Jurgen P.,9999,0,9999,0
1668037861082,CSE 293,033,119426,Snoeren; Alex C.,9999,0,9999,0
1668037861082,CSE 293,034,119428,Shang; Jingbo,9999,0,9999,0
1668037861082,CSE 293,035,119430,Stefan; Deian,9999,0,9999,0
1668037861082,CSE 293,036,119431,Su; Hao,9999,0,9999,0
1668037861082,CSE 293,037,119433,Swanson; Steven James,9999,0,9999,0
1668037861082,CSE 293,038,119435,Tullsen; Dean Michael,9999,0,9999,0
1668037861082,CSE 293,039,119483,Voelker; Geoffrey M.,9999,0,9999,0
1668037861082,CSE 293,040,119537,Zhao; Jishen,9999,0,9999,0
1668037861082,CSE 293,041,119538,Zhou; Yuan-Yuan,9999,0,9999,0
1668037861082,CSE 293,042,119539,Gao; Sicun,9999,0,9999,0
1668037861082,CSE 293,043,119540,Weibel; Nadir,9999,0,9999,0
1668037861082,CSE 293,044,119541,Gupta; Rajesh K.,9999,0,9999,0
1668037861082,CSE 293,045,126410,Vaccaro; Kristen Marie,9999,0,9999,0
1668037861082,CSE 293,046,126411,Klemke; Richard,9999,0,9999,0
1668037861505,CSE 294,A00,102459,Voelker; Geoffrey M.,0,0,0,0
1668037861505,CSE 294,B00,111322,Orailoglu; Alex,0,0,0,0
1668037861932,DSE 201,A00,096914,Deutsch; Alin Bernard,30,0,30,0
1668037862354,DSE 210,A00,096915,Dasgupta; Sanjoy,30,0,30,0
1668037862793,DSE 260A,A00,096916,Altintas De Callaf; Ilkay,30,0,30,0
1668037863267,ECE 200,001,103586,Antipa; Nicholas A,9999,0,9999,0
1668037863267,ECE 200,002,103587,Atanasov; Nikolay A.,9999,0,9999,0
1668037863267,ECE 200,003,103588,Bharadia; Dinesh,9999,0,9999,0
1668037863267,ECE 200,004,103589,Cheng; Chung Kuan,9999,0,9999,0
1668037863267,ECE 200,005,103590,Cosman; Pamela C.,9999,0,9999,0
1668037863267,ECE 200,006,103591,Dayeh; Shadi Ahmad,9999,0,9999,0
1668037863267,ECE 200,007,103592,Fainman; Yeshaiahu,9999,0,9999,0
1668037863267,ECE 200,008,103593,Ford; Joseph Earl,9999,0,9999,0
1668037863267,ECE 200,009,103594,Franceschetti; Massimo,9999,0,9999,0
1668037863267,ECE 200,010,103595,Fullerton; Eric E,9999,0,9999,0
1668037863267,ECE 200,011,103596,Galton; Ian A,9999,0,9999,0
1668037863267,ECE 200,012,103597,Gilja; Vikash,9999,0,9999,0
1668037863267,ECE 200,013,103598,Hall; Drew A.,9999,0,9999,0
1668037863267,ECE 200,014,103599,Hsueh; Tzu-Chien,9999,0,9999,0
1668037863267,ECE 200,015,103600,Javidi; Tara,9999,0,9999,0
1668037863267,ECE 200,016,103601,Kahng; Andrew Byun,9999,0,9999,0
1668037863267,ECE 200,017,103602,Kim; Young-Han,9999,0,9999,0
1668037863267,ECE 200,018,103603,Koushanfar; Farinaz,9999,0,9999,0
1668037863267,ECE 200,019,103604,Kuzum; Duygu,9999,0,9999,0
1668037863267,ECE 200,020,103605,Le; Hanh-Phuc,9999,0,9999,0
1668037863267,ECE 200,021,103606,Lin; Bill,9999,0,9999,0
1668037863267,ECE 200,022,103607,Liu; Zhaowei,9998,0,9999,1
1668037863267,ECE 200,023,103608,Lo; Yu-Hwa,9999,0,9999,0
1668037863267,ECE 200,024,103609,Lomakin; Vitaliy,9999,0,9999,0
1668037863267,ECE 200,025,103610,Mercier; Patrick Philip,9999,0,9999,0
1668037863267,ECE 200,026,103611,Meyer; Florian,9999,0,9999,0
1668037863267,ECE 200,027,103612,Milstein; Laurence B.,9999,0,9999,0
1668037863267,ECE 200,028,103613,Mir Arabbaygi; Siavash,9999,0,9999,0
1668037863267,ECE 200,029,103614,Mookherjea; Shayan,9999,0,9999,0
1668037863267,ECE 200,030,103615,Morris; Karcher William,9999,0,9999,0
1668037863267,ECE 200,031,103616,Ng; Tse Nga,9999,0,9999,0
1668037863267,ECE 200,032,103617,Nguyen; Truong Quang,9999,0,9999,0
1668037863267,ECE 200,033,103618,Nomura; Kenji,9999,0,9999,0
1668037863267,ECE 200,034,103619,Orlitsky; Alon,9999,0,9999,0
1668037863267,ECE 200,035,103620,Pal; Piya,9999,0,9999,0
1668037863267,ECE 200,036,103621,Papen; George C.,9999,0,9999,0
1668037863267,ECE 200,037,103622,Radic; Stojan,9999,0,9999,0
1668037863267,ECE 200,038,103623,Rao; Bhaskar D.,9999,0,9999,0
1668037863267,ECE 200,039,103624,Rao; Ramesh R,9999,0,9999,0
1668037863267,ECE 200,040,103625,Rebeiz; Gabriel,9999,0,9999,0
1668037863267,ECE 200,041,103626,Sanford; John R,9999,0,9999,0
1668037863267,ECE 200,042,103627,Siegel; Paul H.,9999,0,9999,0
1668037863267,ECE 200,043,103628,Sievenpiper; Daniel F.,9999,0,9999,0
1668037863267,ECE 200,044,103629,Sworder; David D.,9999,0,9999,0
1668037863267,ECE 200,045,103630,Taur; Yuan,9999,0,9999,0
1668037863267,ECE 200,046,103631,Touri; Behrouz,9999,0,9999,0
1668037863267,ECE 200,047,103632,Trivedi; Mohan M.,9999,0,9999,0
1668037863267,ECE 200,048,103633,Vasconcelos; Nuno,9999,0,9999,0
1668037863267,ECE 200,049,103634,Wang; Xiaolong,9999,0,9999,0
1668037863267,ECE 200,050,103635,Xie; Pengtao,9999,0,9999,0
1668037863267,ECE 200,051,103636,Yip; Michael,9999,0,9999,0
1668037863267,ECE 200,052,103637,Zeger; Kenneth A.,999,0,999,0
1668037863267,ECE 200,053,103638,Zhang; Xinyu,9999,0,9999,0
1668037863267,ECE 200,054,103639,Turakhia; Yatish Girish,9999,0,9999,0
1668037863267,ECE 200,055,103640,Kang; Mingu,9999,0,9999,0
1668037863267,ECE 200,056,103641,Shi; Yuanyuan,9999,0,9999,0
1668037863267,ECE 200,057,103642,Wang; Edward Jay,9999,0,9999,0
1668037863267,ECE 200,058,103643,Zheng; Yang,9999,0,9999,0
1668037863703,ECE 202,A00,103644,Kuzum; Duygu,0,0,0,0
1668037864133,ECE 212BN,A00,103646,Ng; Tse Nga,0,0,0,0
1668037864556,ECE 221,A00,111493,Staff,0,0,0,0
1668037864981,ECE 222B,A00,103647,Lomakin; Vitaliy,0,0,0,0
1668037865405,ECE 230B,A00,103648,Taur; Yuan,0,0,0,0
1668037865839,ECE 238B,A00,103649,Garay; Javier,0,0,0,0
1668037866273,ECE 240B,A00,112900,Fainman; Yeshaiahu,0,0,0,0
1668037866694,ECE 247A,A00,103650,Jokerst; Jesse Vincent,0,0,0,0
1668037867118,ECE 247B,A00,103651,Wang; Joseph,0,0,0,0
1668037867541,ECE 250,A00,103652,Siegel; Paul H.,0,0,0,0
1668037867970,ECE 251A,A00,103654,Rao; Bhaskar D.,0,0,0,0
1668037868392,ECE 257B,A00,103655,Bharadia; Dinesh,0,0,0,0
1668037868814,ECE 258A,A00,103656,Milstein; Laurence B.,0,0,0,0
1668037869242,ECE 260B,A00,103658,Kang; Mingu,0,0,0,0
1668037869672,ECE 264A,A00,103659,Galton; Ian A,0,0,0,0
1668037870100,ECE 265A,A00,103661,Gudem; Prasad S.S.,0,0,0,0
1668037870530,ECE 265D,A00,103662,Gudem; Prasad S.S.,0,0,0,0
1668037870959,ECE 268,A00,103663,Koushanfar; Farinaz,0,0,0,0
1668037871385,ECE 269,A01,103665,Pal; Piya,0,0,0,0
1668037871813,ECE 271B,A00,103666,Vasconcelos; Manuela,0,0,0,0
1668037872245,ECE 276A,A00,103667,Atanasov; Nikolay A.,0,0,0,0
1668037872672,ECE 277,A00,103668,An; Cheolhong,0,0,0,0
1668037873106,ECE 279,A00,117947,Hall; Drew A.,0,0,0,0
1668037873979,ECE 283,A00,103670,Hsueh; Tzu-Chien,0,0,0,0
1668037874403,ECE 284,A00,103671,Turakhia; Yatish Girish,0,0,0,0
1668037874835,ECE 285,A00,103672,Zheng; Yang,0,0,0,0
1668037874835,ECE 285,B00,103673,Sworder; David D.,0,0,0,0
1668037875258,ECE 287,A00,103676,Javidi; Tara,0,0,0,0
1668037875679,MATH 200B,A00,098023,Salehi Golsefidy; Alireza,13,0,15,2
1668037876128,MATH 202B,A00,098024,Rhoades; Brendon Patrick,9,0,15,6
1668037876552,MATH 203B,A00,098025,Oprea; Dragos N.,11,0,15,4
1668037876977,MATH 204B,A00,098026,Sorensen; Claus M,14,0,15,1
1668037877409,MATH 208,A00,098027,Izadi; Elham,7,0,10,3
1668037877841,MATH 209,A00,098028,Pollack; Aaron,10,0,10,0
1668037878270,MATH 211A,A00,112919,Rogalski; Daniel,9,0,10,1
1668037878698,MATH 211B,A00,112920,Seward; Brandon M.,9,0,10,1
1668037879120,MATH 218,A00,098029,Li; Bo,10,0,10,0
1668037879550,MATH 220B,A00,098030,Novak; Jonathan I,13,0,15,2
1668037879974,MATH 221A,A00,098031,Ebenfelt; Peter F,13,0,15,2
1668037880396,MATH 231B,A00,098032,Zlatos; Andrej,12,0,15,3
1668037880819,MATH 240B,A00,098033,Ni; Lei,9,0,15,6
1668037881243,MATH 243,A00,098034,Jekel; David Andrew,10,0,10,0
1668037881670,MATH 245A,A00,098035,Nie; Jiawang,0,0,15,16
1668037882094,MATH 248,A00,098036,Bejenaru; Ioan,10,0,10,0
1668037882520,MATH 250B,A00,098037,Spolaor; Luca,14,0,15,1
1668037882944,MATH 258,A00,098038,Ni; Lei,10,0,10,0
1668037883370,MATH 264B,A00,098041,Rhoades; Brendon Patrick,10,0,15,5
1668037883796,MATH 268,A00,098042,Buss; Samuel R,10,0,10,0
1668037884220,MATH 269,A00,098043,Rhoades; Brendon Patrick,10,0,10,0
1668037884648,MATH 270B,A00,098044,Li; Bo,11,0,15,4
1668037885077,MATH 272B,A00,098045,Holst; Michael J,13,0,15,2
1668037885502,MATH 273A,A00,098046,Tian; Xiaochuan,10,0,15,5
1668037885934,MATH 275,A01,098048,Tian; Xiaochuan,6,0,10,4
1668037886357,MATH 278A,A00,098049,Holst; Michael J,8,0,10,2
1668037886789,MATH 278B,A00,098050,Cloninger; Alexander,10,0,10,0
1668037887220,MATH 278C,A00,098051,Nie; Jiawang,8,0,10,2
1668037887653,MATH 280B,A00,098052,Zheng; Tianyi,11,0,15,4
1668037888081,MATH 281B,A00,098053,Bradic; Jelena,3,0,15,12
1668037888506,MATH 282B,A00,098054,Arias-Castro; Ery,1,0,15,14
1668037888941,MATH 285,A00,098055,Fitzsimmons; Patrick J,0,0,15,17
1668037889456,MATH 287B,A00,098056,Arias-Castro; Ery,4,0,15,11
1668037889895,MATH 288,A00,098057,Agarwal; Pooja,9,0,10,1
1668037889895,MATH 288,B00,098058,Zhang; Danna,9,0,10,1
1668037889895,MATH 288,C00,098059,Williams; Ruth J,10,0,10,0
1668037890327,MATH 290B,A00,098060,Roberts; Justin Deritter,13,0,15,2
1668037890757,MATH 292,A00,098061,Belmont; Eva Kinoshita,10,0,10,0
1668037891182,MATH 295,A00,098062,Suk; Andrew Hoon,48,0,50,2
1668037891616,MATH 296,A00,098063,Novak; Jonathan I,20,0,20,0
1668037892041,MATH 297,001,098064,Gamst; Anthony Collins,9997,0,9999,2
1668038396347,COGS 205,A00,101395,Chiba; Andrea,19,0,20,1
1668038396775,COGS 210B,001,101404,Greene; Deanna Jacquelyn,9998,0,9999,1
1668038396775,COGS 210B,002,101417,Xia; Haijun,9999,0,9999,0
1668038396775,COGS 210B,003,101422,Nitz; Douglas A.,9999,0,9999,0
1668038396775,COGS 210B,004,101423,Hollan; James D.,9998,0,9999,1
1668038396775,COGS 210B,005,101424,Deak; Gedeon O.,9998,0,9999,1
1668038396775,COGS 210B,006,101425,Rossano; Federico,9999,0,9999,0
1668038397204,COGS 211B,A00,101427,Coulson; Seana M,9996,0,9999,3
1668038397630,COGS 220,A00,101428,Hollan; James D.,0,0,25,25
1668038398061,COGS 229,A00,101429,Dow; Steven P,18,0,25,7
1668038398503,COGS 230,A00,101430,Klemmer; Scott R,13,0,17,4
1668038398929,COGS 234,A00,101431,Xia; Haijun,5,0,25,20
1668038399364,COGS 260,A00,101432,Kiyonaga; Anastasia,19,0,25,6
1668038399364,COGS 260,B00,101433,Kirsh; David Joel,16,0,25,9
1668038399787,CSE 202,A00,102371,Impagliazzo; Russell,0,0,0,0
1668038400210,CSE 203B,A01,102373,Cheng; Chung Kuan,0,0,0,0
1668038400685,CSE 208,A00,102374,Micciancio; Daniele,0,0,0,0
1668038401115,CSE 209A,A00,112895,Impagliazzo; Russell,0,0,15,15
1668038401574,CSE 209B,A00,108005,Bellare; Mihir,0,0,0,0
1668038402011,CSE 210,A00,113163,Coblenz; Michael J,0,0,0,0
1668038402447,CSE 219,A00,106111,Dow; Steven P,0,0,20,20
1668038402892,CSE 221,A00,102376,Voelker; Geoffrey M.,0,0,0,0
1668038403322,CSE 224,A01,102378,Porter; George M,0,0,0,0
1668038403764,CSE 229A,A00,102379,Savage; Stefan,0,0,0,0
1668038404189,CSE 229C,A00,102380,Munyaka; Imani N. S.,0,0,0,0
1668038404618,CSE 232B,A00,102382,Deutsch; Alin Bernard,0,0,0,0
1668038407091,CSE 234,A01,112904,Kumar; Arun Kumar,0,0,0,0
1668038407531,CSE 237A,A00,102383,Rosing; Tajana Simunic,0,0,0,0
1668038407973,CSE 239A,A00,102384,Deutsch; Alin Bernard,0,0,0,0
1668038408402,CSE 239B,A00,102385,Polikarpova; Nadezhda,0,0,0,0
1668038408886,CSE 240A,A00,102386,Pannuto; Patrick William,0,0,0,0
1668038409458,CSE 240B,A00,102387,Zhao; Jishen,0,0,0,0
1668038409928,CSE 241A,A00,106406,Kang; Mingu,0,0,0,0
1668038410356,CSE 249B,A00,102388,Kahng; Andrew Byun,0,0,8,8
1668038410789,CSE 251B,A01,102392,Cottrell; Garrison W,0,0,0,0
1668038410789,CSE 251B,A02,102393,Cottrell; Garrison W,0,0,0,0
1668038411221,CSE 252B,A00,102394,Ochoa; Benjamin Lawrence,0,0,0,0
1668038411651,CSE 257,A01,102396,Gao; Sicun,0,0,0,0
1668038412087,CSE 272,A00,102397,Li; Tzumao,0,0,0,0
1668038412529,CSE 274,A00,111323,Chern; Albert Ren-Haur,0,0,0,0
1668038412962,CSE 282,A00,102398,Pevzner; Pavel Arkadjevich,0,0,0,0
1668038413404,CSE 284,A00,114175,Gymrek; Melissa Ann,0,0,0,0
1668038413843,CSE 290,A00,102399,Chandraker; Manmohan Krishna,0,0,0,0
1668038413843,CSE 290,B00,102400,Vaccaro; Kristen Marie,0,0,25,25
1668038413843,CSE 290,C00,102414,Pannuto; Patrick William,0,0,25,25
1668038413843,CSE 290,D00,102427,Pevzner; Pavel Arkadjevich,0,0,0,0
1668038413843,CSE 290,E00,102429,Zhao; Jishen,0,0,0,0
1668038413843,CSE 290,F00,102436,Tullsen; Dean Michael,0,0,0,0
1668038413843,CSE 290,G00,102440,Christensen; Henrik I,0,0,20,20
1668038414293,CSE 291,A00,102443,Su; Hao,0,0,0,0
1668038414293,CSE 291,B00,102448,Polikarpova; Nadezhda,0,0,0,0
1668038414293,CSE 291,C00,102453,Vaccaro; Kristen Marie,0,0,0,0
1668038414293,CSE 291,D00,111343,Savage; Stefan,0,0,0,0
1668038414293,CSE 291,E00,116474,Claffy; Kimberly Claire,0,0,0,0
1668038414293,CSE 291,F00,116479,Pasquale; Joseph,0,0,0,0
1668038414969,CSE 293,001,119111,Bafna; Vineet,9999,0,9999,0
1668038414969,CSE 293,002,119118,Bellare; Mihir,9999,0,9999,0
1668038414969,CSE 293,003,119122,Berg-Kirkpatrick; Taylor D,9999,0,9999,0
1668038414969,CSE 293,004,119135,Christensen; Henrik I,9999,0,9999,0
1668038414969,CSE 293,005,119142,Cottrell; Garrison W,9999,0,9999,0
1668038414969,CSE 293,006,119146,Deutsch; Alin Bernard,9999,0,9999,0
1668038414969,CSE 293,007,119159,Esmaeilzadeh; Hadi,9999,0,9999,0
1668038414969,CSE 293,008,119166,Freund; Yoav,9999,0,9999,0
1668038414969,CSE 293,009,119170,Griswold; William G.,9999,0,9999,0
1668038414969,CSE 293,010,119183,Gymrek; Melissa Ann,9999,0,9999,0
1668038414969,CSE 293,011,119190,Heninger; Nadia A,9999,0,9999,0
1668038414969,CSE 293,012,119230,Impagliazzo; Russell,9999,0,9999,0
1668038414969,CSE 293,013,119232,Jhala; Ranjit,9999,0,9999,0
1668038414969,CSE 293,014,119233,Kahng; Andrew Byun,9999,0,9999,0
1668038414969,CSE 293,015,119298,Kane; Daniel Mertz,9999,0,9999,0
1668038414969,CSE 293,016,119299,Kriegman; David J,9999,0,9999,0
1668038414969,CSE 293,017,119300,Kumar; Arun Kumar,9999,0,9999,0
1668038414969,CSE 293,018,119301,Lerner; Sorin,9999,0,9999,0
1668038414969,CSE 293,019,119302,Lovett; Shachar,9999,0,9999,0
1668038414969,CSE 293,020,119303,McAuley; Julian John,9999,0,9999,0
1668038414969,CSE 293,021,119304,Micciancio; Daniele,9999,0,9999,0
1668038414969,CSE 293,022,119367,Orailoglu; Alex,9999,0,9999,0
1668038414969,CSE 293,023,119382,Paturi; Ramamohan,9999,0,9999,0
1668038414969,CSE 293,024,119404,Polikarpova; Nadezhda,9999,0,9999,0
1668038414969,CSE 293,025,119406,Politz; Joseph Gibbs,9999,0,9999,0
1668038414969,CSE 293,026,119411,Porter; George M,9999,0,9999,0
1668038414969,CSE 293,027,119414,Porter; Leonard Emerson,9999,0,9999,0
1668038414969,CSE 293,028,119416,Ramamoorthi; Ravi,9999,0,9999,0
1668038414969,CSE 293,029,119417,Sahoo; Debashis,9999,0,9999,0
1668038414969,CSE 293,030,119420,Saul; Lawrence,9999,0,9999,0
1668038414969,CSE 293,031,119421,Savage; Stefan,9999,0,9999,0
1668038414969,CSE 293,032,119425,Schulze; Jurgen P.,9999,0,9999,0
1668038414969,CSE 293,033,119426,Snoeren; Alex C.,9999,0,9999,0
1668038414969,CSE 293,034,119428,Shang; Jingbo,9999,0,9999,0
1668038414969,CSE 293,035,119430,Stefan; Deian,9999,0,9999,0
1668038414969,CSE 293,036,119431,Su; Hao,9999,0,9999,0
1668038414969,CSE 293,037,119433,Swanson; Steven James,9999,0,9999,0
1668038414969,CSE 293,038,119435,Tullsen; Dean Michael,9999,0,9999,0
1668038414969,CSE 293,039,119483,Voelker; Geoffrey M.,9999,0,9999,0
1668038414969,CSE 293,040,119537,Zhao; Jishen,9999,0,9999,0
1668038414969,CSE 293,041,119538,Zhou; Yuan-Yuan,9999,0,9999,0
1668038414969,CSE 293,042,119539,Gao; Sicun,9999,0,9999,0
1668038414969,CSE 293,043,119540,Weibel; Nadir,9999,0,9999,0
1668038414969,CSE 293,044,119541,Gupta; Rajesh K.,9999,0,9999,0
1668038414969,CSE 293,045,126410,Vaccaro; Kristen Marie,9999,0,9999,0
1668038414969,CSE 293,046,126411,Klemke; Richard,9999,0,9999,0
1668038415392,CSE 294,A00,102459,Voelker; Geoffrey M.,0,0,0,0
1668038415392,CSE 294,B00,111322,Orailoglu; Alex,0,0,0,0
1668038415827,DSE 201,A00,096914,Deutsch; Alin Bernard,30,0,30,0
1668038416262,DSE 210,A00,096915,Dasgupta; Sanjoy,30,0,30,0
1668038416793,DSE 260A,A00,096916,Altintas De Callaf; Ilkay,30,0,30,0
1668038417244,ECE 200,001,103586,Antipa; Nicholas A,9999,0,9999,0
1668038417244,ECE 200,002,103587,Atanasov; Nikolay A.,9999,0,9999,0
1668038417244,ECE 200,003,103588,Bharadia; Dinesh,9999,0,9999,0
1668038417244,ECE 200,004,103589,Cheng; Chung Kuan,9999,0,9999,0
1668038417244,ECE 200,005,103590,Cosman; Pamela C.,9999,0,9999,0
1668038417244,ECE 200,006,103591,Dayeh; Shadi Ahmad,9999,0,9999,0
1668038417244,ECE 200,007,103592,Fainman; Yeshaiahu,9999,0,9999,0
1668038417244,ECE 200,008,103593,Ford; Joseph Earl,9999,0,9999,0
1668038417244,ECE 200,009,103594,Franceschetti; Massimo,9999,0,9999,0
1668038417244,ECE 200,010,103595,Fullerton; Eric E,9999,0,9999,0
1668038417244,ECE 200,011,103596,Galton; Ian A,9999,0,9999,0
1668038417244,ECE 200,012,103597,Gilja; Vikash,9999,0,9999,0
1668038417244,ECE 200,013,103598,Hall; Drew A.,9999,0,9999,0
1668038417244,ECE 200,014,103599,Hsueh; Tzu-Chien,9999,0,9999,0
1668038417244,ECE 200,015,103600,Javidi; Tara,9999,0,9999,0
1668038417244,ECE 200,016,103601,Kahng; Andrew Byun,9999,0,9999,0
1668038417244,ECE 200,017,103602,Kim; Young-Han,9999,0,9999,0
1668038417244,ECE 200,018,103603,Koushanfar; Farinaz,9999,0,9999,0
1668038417244,ECE 200,019,103604,Kuzum; Duygu,9999,0,9999,0
1668038417244,ECE 200,020,103605,Le; Hanh-Phuc,9999,0,9999,0
1668038417244,ECE 200,021,103606,Lin; Bill,9999,0,9999,0
1668038417244,ECE 200,022,103607,Liu; Zhaowei,9998,0,9999,1
1668038417244,ECE 200,023,103608,Lo; Yu-Hwa,9999,0,9999,0
1668038417244,ECE 200,024,103609,Lomakin; Vitaliy,9999,0,9999,0
1668038417244,ECE 200,025,103610,Mercier; Patrick Philip,9999,0,9999,0
1668038417244,ECE 200,026,103611,Meyer; Florian,9999,0,9999,0
1668038417244,ECE 200,027,103612,Milstein; Laurence B.,9999,0,9999,0
1668038417244,ECE 200,028,103613,Mir Arabbaygi; Siavash,9999,0,9999,0
1668038417244,ECE 200,029,103614,Mookherjea; Shayan,9999,0,9999,0
1668038417244,ECE 200,030,103615,Morris; Karcher William,9999,0,9999,0
1668038417244,ECE 200,031,103616,Ng; Tse Nga,9999,0,9999,0
1668038417244,ECE 200,032,103617,Nguyen; Truong Quang,9999,0,9999,0
1668038417244,ECE 200,033,103618,Nomura; Kenji,9999,0,9999,0
1668038417244,ECE 200,034,103619,Orlitsky; Alon,9999,0,9999,0
1668038417244,ECE 200,035,103620,Pal; Piya,9999,0,9999,0
1668038417244,ECE 200,036,103621,Papen; George C.,9999,0,9999,0
1668038417244,ECE 200,037,103622,Radic; Stojan,9999,0,9999,0
1668038417244,ECE 200,038,103623,Rao; Bhaskar D.,9999,0,9999,0
1668038417244,ECE 200,039,103624,Rao; Ramesh R,9999,0,9999,0
1668038417244,ECE 200,040,103625,Rebeiz; Gabriel,9999,0,9999,0
1668038417244,ECE 200,041,103626,Sanford; John R,9999,0,9999,0
1668038417244,ECE 200,042,103627,Siegel; Paul H.,9999,0,9999,0
1668038417244,ECE 200,043,103628,Sievenpiper; Daniel F.,9999,0,9999,0
1668038417244,ECE 200,044,103629,Sworder; David D.,9999,0,9999,0
1668038417244,ECE 200,045,103630,Taur; Yuan,9999,0,9999,0
1668038417244,ECE 200,046,103631,Touri; Behrouz,9999,0,9999,0
1668038417244,ECE 200,047,103632,Trivedi; Mohan M.,9999,0,9999,0
1668038417244,ECE 200,048,103633,Vasconcelos; Nuno,9999,0,9999,0
1668038417244,ECE 200,049,103634,Wang; Xiaolong,9999,0,9999,0
1668038417244,ECE 200,050,103635,Xie; Pengtao,9999,0,9999,0
1668038417244,ECE 200,051,103636,Yip; Michael,9999,0,9999,0
1668038417244,ECE 200,052,103637,Zeger; Kenneth A.,999,0,999,0
1668038417244,ECE 200,053,103638,Zhang; Xinyu,9999,0,9999,0
1668038417244,ECE 200,054,103639,Turakhia; Yatish Girish,9999,0,9999,0
1668038417244,ECE 200,055,103640,Kang; Mingu,9999,0,9999,0
1668038417244,ECE 200,056,103641,Shi; Yuanyuan,9999,0,9999,0
1668038417244,ECE 200,057,103642,Wang; Edward Jay,9999,0,9999,0
1668038417244,ECE 200,058,103643,Zheng; Yang,9999,0,9999,0
1668038417680,ECE 202,A00,103644,Kuzum; Duygu,0,0,0,0
1668038418123,ECE 212BN,A00,103646,Ng; Tse Nga,0,0,0,0
1668038418560,ECE 221,A00,111493,Staff,0,0,0,0
1668038418986,ECE 222B,A00,103647,Lomakin; Vitaliy,0,0,0,0
1668038419413,ECE 230B,A00,103648,Taur; Yuan,0,0,0,0
1668038419838,ECE 238B,A00,103649,Garay; Javier,0,0,0,0
1668038420278,ECE 240B,A00,112900,Fainman; Yeshaiahu,0,0,0,0
1668038420700,ECE 247A,A00,103650,Jokerst; Jesse Vincent,0,0,0,0
1668038421145,ECE 247B,A00,103651,Wang; Joseph,0,0,0,0
1668038421572,ECE 250,A00,103652,Siegel; Paul H.,0,0,0,0
1668038422012,ECE 251A,A00,103654,Rao; Bhaskar D.,0,0,0,0
1668038422440,ECE 257B,A00,103655,Bharadia; Dinesh,0,0,0,0
1668038422866,ECE 258A,A00,103656,Milstein; Laurence B.,0,0,0,0
1668038423311,ECE 260B,A00,103658,Kang; Mingu,0,0,0,0
1668038423752,ECE 264A,A00,103659,Galton; Ian A,0,0,0,0
1668038424177,ECE 265A,A00,103661,Gudem; Prasad S.S.,0,0,0,0
1668038424789,ECE 265D,A00,103662,Gudem; Prasad S.S.,0,0,0,0
1668038425233,ECE 268,A00,103663,Koushanfar; Farinaz,0,0,0,0
1668038425668,ECE 269,A01,103665,Pal; Piya,0,0,0,0
1668038426093,ECE 271B,A00,103666,Vasconcelos; Manuela,0,0,0,0
1668038426524,ECE 276A,A00,103667,Atanasov; Nikolay A.,0,0,0,0
1668038426945,ECE 277,A00,103668,An; Cheolhong,0,0,0,0
1668038427376,ECE 279,A00,117947,Hall; Drew A.,0,0,0,0
1668038428236,ECE 283,A00,103670,Hsueh; Tzu-Chien,0,0,0,0
1668038428670,ECE 284,A00,103671,Turakhia; Yatish Girish,0,0,0,0
1668038429097,ECE 285,A00,103672,Zheng; Yang,0,0,0,0
1668038429097,ECE 285,B00,103673,Sworder; David D.,0,0,0,0
1668038429527,ECE 287,A00,103676,Javidi; Tara,0,0,0,0
1668038429963,MATH 200B,A00,098023,Salehi Golsefidy; Alireza,13,0,15,2
1668038430389,MATH 202B,A00,098024,Rhoades; Brendon Patrick,9,0,15,6
1668038430829,MATH 203B,A00,098025,Oprea; Dragos N.,11,0,15,4
1668038431253,MATH 204B,A00,098026,Sorensen; Claus M,14,0,15,1
1668038431681,MATH 208,A00,098027,Izadi; Elham,7,0,10,3
1668038432106,MATH 209,A00,098028,Pollack; Aaron,10,0,10,0
1668038432538,MATH 211A,A00,112919,Rogalski; Daniel,9,0,10,1
1668038432971,MATH 211B,A00,112920,Seward; Brandon M.,9,0,10,1
1668038433412,MATH 218,A00,098029,Li; Bo,10,0,10,0
1668038433848,MATH 220B,A00,098030,Novak; Jonathan I,13,0,15,2
1668038434278,MATH 221A,A00,098031,Ebenfelt; Peter F,13,0,15,2
1668038434705,MATH 231B,A00,098032,Zlatos; Andrej,12,0,15,3
1668038435134,MATH 240B,A00,098033,Ni; Lei,9,0,15,6
1668038435570,MATH 243,A00,098034,Jekel; David Andrew,10,0,10,0
1668038436004,MATH 245A,A00,098035,Nie; Jiawang,0,0,15,16
1668038436427,MATH 248,A00,098036,Bejenaru; Ioan,10,0,10,0
1668038436864,MATH 250B,A00,098037,Spolaor; Luca,14,0,15,1
1668038437292,MATH 258,A00,098038,Ni; Lei,10,0,10,0
1668038437716,MATH 264B,A00,098041,Rhoades; Brendon Patrick,10,0,15,5
1668038438139,MATH 268,A00,098042,Buss; Samuel R,10,0,10,0
1668038438580,MATH 269,A00,098043,Rhoades; Brendon Patrick,10,0,10,0
1668038439016,MATH 270B,A00,098044,Li; Bo,11,0,15,4
1668038439447,MATH 272B,A00,098045,Holst; Michael J,13,0,15,2
1668038439889,MATH 273A,A00,098046,Tian; Xiaochuan,10,0,15,5
1668038440321,MATH 275,A01,098048,Tian; Xiaochuan,6,0,10,4
1668038440751,MATH 278A,A00,098049,Holst; Michael J,8,0,10,2
1668038441184,MATH 278B,A00,098050,Cloninger; Alexander,10,0,10,0
1668038441620,MATH 278C,A00,098051,Nie; Jiawang,8,0,10,2
1668038442058,MATH 280B,A00,098052,Zheng; Tianyi,11,0,15,4
1668038442505,MATH 281B,A00,098053,Bradic; Jelena,3,0,15,12
1668038442934,MATH 282B,A00,098054,Arias-Castro; Ery,0,0,15,15
1668038443361,MATH 285,A00,098055,Fitzsimmons; Patrick J,0,0,15,17
1668038443785,MATH 287B,A00,098056,Arias-Castro; Ery,3,0,15,12
1668038444290,MATH 288,A00,098057,Agarwal; Pooja,9,0,10,1
1668038444290,MATH 288,B00,098058,Zhang; Danna,9,0,10,1
1668038444290,MATH 288,C00,098059,Williams; Ruth J,10,0,10,0
1668038444720,MATH 290B,A00,098060,Roberts; Justin Deritter,13,0,15,2
1668038445168,MATH 292,A00,098061,Belmont; Eva Kinoshita,10,0,10,0
1668038445596,MATH 295,A00,098062,Suk; Andrew Hoon,48,0,50,2
1668038446020,MATH 296,A00,098063,Novak; Jonathan I,20,0,20,0
1668038446445,MATH 297,001,098064,Gamst; Anthony Collins,9997,0,9999,2
1668038963849,COGS 205,A00,101395,Chiba; Andrea,19,0,20,1
1668038964281,COGS 210B,001,101404,Greene; Deanna Jacquelyn,9998,0,9999,1
1668038964281,COGS 210B,002,101417,Xia; Haijun,9999,0,9999,0
1668038964281,COGS 210B,003,101422,Nitz; Douglas A.,9999,0,9999,0
1668038964281,COGS 210B,004,101423,Hollan; James D.,9998,0,9999,1
1668038964281,COGS 210B,005,101424,Deak; Gedeon O.,9998,0,9999,1
1668038964281,COGS 210B,006,101425,Rossano; Federico,9999,0,9999,0
1668038964722,COGS 211B,A00,101427,Coulson; Seana M,9996,0,9999,3
1668038965144,COGS 220,A00,101428,Hollan; James D.,0,0,25,25
1668038965577,COGS 229,A00,101429,Dow; Steven P,18,0,25,7
1668038966004,COGS 230,A00,101430,Klemmer; Scott R,13,0,17,4
1668038966425,COGS 234,A00,101431,Xia; Haijun,5,0,25,20
1668038966862,COGS 260,A00,101432,Kiyonaga; Anastasia,19,0,25,6
1668038966862,COGS 260,B00,101433,Kirsh; David Joel,16,0,25,9
1668038967287,CSE 202,A00,102371,Impagliazzo; Russell,0,0,0,0
1668038967723,CSE 203B,A01,102373,Cheng; Chung Kuan,0,0,0,0
1668038968155,CSE 208,A00,102374,Micciancio; Daniele,0,0,0,0
1668038968578,CSE 209A,A00,112895,Impagliazzo; Russell,0,0,15,15
1668038969001,CSE 209B,A00,108005,Bellare; Mihir,0,0,0,0
1668038969427,CSE 210,A00,113163,Coblenz; Michael J,0,0,0,0
1668038969851,CSE 219,A00,106111,Dow; Steven P,0,0,20,20
1668038970304,CSE 221,A00,102376,Voelker; Geoffrey M.,0,0,0,0
1668038970733,CSE 224,A01,102378,Porter; George M,0,0,0,0
1668038971320,CSE 229A,A00,102379,Savage; Stefan,0,0,0,0
1668038971743,CSE 229C,A00,102380,Munyaka; Imani N. S.,0,0,0,0
1668038972179,CSE 232B,A00,102382,Deutsch; Alin Bernard,0,0,0,0
1668038972623,CSE 234,A01,112904,Kumar; Arun Kumar,0,0,0,0
1668038973046,CSE 237A,A00,102383,Rosing; Tajana Simunic,0,0,0,0
1668038973487,CSE 239A,A00,102384,Deutsch; Alin Bernard,0,0,0,0
1668038973928,CSE 239B,A00,102385,Polikarpova; Nadezhda,0,0,0,0
1668038974368,CSE 240A,A00,102386,Pannuto; Patrick William,0,0,0,0
1668038974791,CSE 240B,A00,102387,Zhao; Jishen,0,0,0,0
1668038975218,CSE 241A,A00,106406,Kang; Mingu,0,0,0,0
1668038975647,CSE 249B,A00,102388,Kahng; Andrew Byun,0,0,8,8
1668038976078,CSE 251B,A01,102392,Cottrell; Garrison W,0,0,0,0
1668038976078,CSE 251B,A02,102393,Cottrell; Garrison W,0,0,0,0
1668038976514,CSE 252B,A00,102394,Ochoa; Benjamin Lawrence,0,0,0,0
1668038976938,CSE 257,A01,102396,Gao; Sicun,0,0,0,0
1668038977362,CSE 272,A00,102397,Li; Tzumao,0,0,0,0
1668038977784,CSE 274,A00,111323,Chern; Albert Ren-Haur,0,0,0,0
1668038978213,CSE 282,A00,102398,Pevzner; Pavel Arkadjevich,0,0,0,0
1668038978637,CSE 284,A00,114175,Gymrek; Melissa Ann,0,0,0,0
1668038979070,CSE 290,A00,102399,Chandraker; Manmohan Krishna,0,0,0,0
1668038979070,CSE 290,B00,102400,Vaccaro; Kristen Marie,0,0,25,25
1668038979070,CSE 290,C00,102414,Pannuto; Patrick William,0,0,25,25
1668038979070,CSE 290,D00,102427,Pevzner; Pavel Arkadjevich,0,0,0,0
1668038979070,CSE 290,E00,102429,Zhao; Jishen,0,0,0,0
1668038979070,CSE 290,F00,102436,Tullsen; Dean Michael,0,0,0,0
1668038979070,CSE 290,G00,102440,Christensen; Henrik I,0,0,20,20
1668038979509,CSE 291,A00,102443,Su; Hao,0,0,0,0
1668038979509,CSE 291,B00,102448,Polikarpova; Nadezhda,0,0,0,0
1668038979509,CSE 291,C00,102453,Vaccaro; Kristen Marie,0,0,0,0
1668038979509,CSE 291,D00,111343,Savage; Stefan,0,0,0,0
1668038979509,CSE 291,E00,116474,Claffy; Kimberly Claire,0,0,0,0
1668038979509,CSE 291,F00,116479,Pasquale; Joseph,0,0,0,0
1668038979952,CSE 293,001,119111,Bafna; Vineet,9999,0,9999,0
1668038979952,CSE 293,002,119118,Bellare; Mihir,9999,0,9999,0
1668038979952,CSE 293,003,119122,Berg-Kirkpatrick; Taylor D,9999,0,9999,0
1668038979952,CSE 293,004,119135,Christensen; Henrik I,9999,0,9999,0
1668038979952,CSE 293,005,119142,Cottrell; Garrison W,9999,0,9999,0
1668038979952,CSE 293,006,119146,Deutsch; Alin Bernard,9999,0,9999,0
1668038979952,CSE 293,007,119159,Esmaeilzadeh; Hadi,9999,0,9999,0
1668038979952,CSE 293,008,119166,Freund; Yoav,9999,0,9999,0
1668038979952,CSE 293,009,119170,Griswold; William G.,9999,0,9999,0
1668038979952,CSE 293,010,119183,Gymrek; Melissa Ann,9999,0,9999,0
1668038979952,CSE 293,011,119190,Heninger; Nadia A,9999,0,9999,0
1668038979952,CSE 293,012,119230,Impagliazzo; Russell,9999,0,9999,0
1668038979952,CSE 293,013,119232,Jhala; Ranjit,9999,0,9999,0
1668038979952,CSE 293,014,119233,Kahng; Andrew Byun,9999,0,9999,0
1668038979952,CSE 293,015,119298,Kane; Daniel Mertz,9999,0,9999,0
1668038979952,CSE 293,016,119299,Kriegman; David J,9999,0,9999,0
1668038979952,CSE 293,017,119300,Kumar; Arun Kumar,9999,0,9999,0
1668038979952,CSE 293,018,119301,Lerner; Sorin,9999,0,9999,0
1668038979952,CSE 293,019,119302,Lovett; Shachar,9999,0,9999,0
1668038979952,CSE 293,020,119303,McAuley; Julian John,9999,0,9999,0
1668038979952,CSE 293,021,119304,Micciancio; Daniele,9999,0,9999,0
1668038979952,CSE 293,022,119367,Orailoglu; Alex,9999,0,9999,0
1668038979952,CSE 293,023,119382,Paturi; Ramamohan,9999,0,9999,0
1668038979952,CSE 293,024,119404,Polikarpova; Nadezhda,9999,0,9999,0
1668038979952,CSE 293,025,119406,Politz; Joseph Gibbs,9999,0,9999,0
1668038979952,CSE 293,026,119411,Porter; George M,9999,0,9999,0
1668038979952,CSE 293,027,119414,Porter; Leonard Emerson,9999,0,9999,0
1668038979952,CSE 293,028,119416,Ramamoorthi; Ravi,9999,0,9999,0
1668038979952,CSE 293,029,119417,Sahoo; Debashis,9999,0,9999,0
1668038979952,CSE 293,030,119420,Saul; Lawrence,9999,0,9999,0
1668038979952,CSE 293,031,119421,Savage; Stefan,9999,0,9999,0
1668038979952,CSE 293,032,119425,Schulze; Jurgen P.,9999,0,9999,0
1668038979952,CSE 293,033,119426,Snoeren; Alex C.,9999,0,9999,0
1668038979952,CSE 293,034,119428,Shang; Jingbo,9999,0,9999,0
1668038979952,CSE 293,035,119430,Stefan; Deian,9999,0,9999,0
1668038979952,CSE 293,036,119431,Su; Hao,9999,0,9999,0
1668038979952,CSE 293,037,119433,Swanson; Steven James,9999,0,9999,0
1668038979952,CSE 293,038,119435,Tullsen; Dean Michael,9999,0,9999,0
1668038979952,CSE 293,039,119483,Voelker; Geoffrey M.,9999,0,9999,0
1668038979952,CSE 293,040,119537,Zhao; Jishen,9999,0,9999,0
1668038979952,CSE 293,041,119538,Zhou; Yuan-Yuan,9999,0,9999,0
1668038979952,CSE 293,042,119539,Gao; Sicun,9999,0,9999,0
1668038979952,CSE 293,043,119540,Weibel; Nadir,9999,0,9999,0
1668038979952,CSE 293,044,119541,Gupta; Rajesh K.,9999,0,9999,0
1668038979952,CSE 293,045,126410,Vaccaro; Kristen Marie,9999,0,9999,0
1668038979952,CSE 293,046,126411,Klemke; Richard,9999,0,9999,0
1668038980388,CSE 294,A00,102459,Voelker; Geoffrey M.,0,0,0,0
1668038980388,CSE 294,B00,111322,Orailoglu; Alex,0,0,0,0
1668038980814,DSE 201,A00,096914,Deutsch; Alin Bernard,30,0,30,0
1668038981258,DSE 210,A00,096915,Dasgupta; Sanjoy,30,0,30,0
1668038981694,DSE 260A,A00,096916,Altintas De Callaf; Ilkay,30,0,30,0
1668038982146,ECE 200,001,103586,Antipa; Nicholas A,9999,0,9999,0
1668038982146,ECE 200,002,103587,Atanasov; Nikolay A.,9999,0,9999,0
1668038982146,ECE 200,003,103588,Bharadia; Dinesh,9999,0,9999,0
1668038982146,ECE 200,004,103589,Cheng; Chung Kuan,9999,0,9999,0
1668038982146,ECE 200,005,103590,Cosman; Pamela C.,9999,0,9999,0
1668038982146,ECE 200,006,103591,Dayeh; Shadi Ahmad,9999,0,9999,0
1668038982146,ECE 200,007,103592,Fainman; Yeshaiahu,9999,0,9999,0
1668038982146,ECE 200,008,103593,Ford; Joseph Earl,9999,0,9999,0
1668038982146,ECE 200,009,103594,Franceschetti; Massimo,9999,0,9999,0
1668038982146,ECE 200,010,103595,Fullerton; Eric E,9999,0,9999,0
1668038982146,ECE 200,011,103596,Galton; Ian A,9999,0,9999,0
1668038982146,ECE 200,012,103597,Gilja; Vikash,9999,0,9999,0
1668038982146,ECE 200,013,103598,Hall; Drew A.,9999,0,9999,0
1668038982146,ECE 200,014,103599,Hsueh; Tzu-Chien,9999,0,9999,0
1668038982146,ECE 200,015,103600,Javidi; Tara,9999,0,9999,0
1668038982146,ECE 200,016,103601,Kahng; Andrew Byun,9999,0,9999,0
1668038982146,ECE 200,017,103602,Kim; Young-Han,9999,0,9999,0
1668038982146,ECE 200,018,103603,Koushanfar; Farinaz,9999,0,9999,0
1668038982146,ECE 200,019,103604,Kuzum; Duygu,9999,0,9999,0
1668038982146,ECE 200,020,103605,Le; Hanh-Phuc,9999,0,9999,0
1668038982146,ECE 200,021,103606,Lin; Bill,9999,0,9999,0
1668038982146,ECE 200,022,103607,Liu; Zhaowei,9998,0,9999,1
1668038982146,ECE 200,023,103608,Lo; Yu-Hwa,9999,0,9999,0
1668038982146,ECE 200,024,103609,Lomakin; Vitaliy,9999,0,9999,0
1668038982146,ECE 200,025,103610,Mercier; Patrick Philip,9999,0,9999,0
1668038982146,ECE 200,026,103611,Meyer; Florian,9999,0,9999,0
1668038982146,ECE 200,027,103612,Milstein; Laurence B.,9999,0,9999,0
1668038982146,ECE 200,028,103613,Mir Arabbaygi; Siavash,9999,0,9999,0
1668038982146,ECE 200,029,103614,Mookherjea; Shayan,9999,0,9999,0
1668038982146,ECE 200,030,103615,Morris; Karcher William,9999,0,9999,0
1668038982146,ECE 200,031,103616,Ng; Tse Nga,9999,0,9999,0
1668038982146,ECE 200,032,103617,Nguyen; Truong Quang,9999,0,9999,0
1668038982146,ECE 200,033,103618,Nomura; Kenji,9999,0,9999,0
1668038982146,ECE 200,034,103619,Orlitsky; Alon,9999,0,9999,0
1668038982146,ECE 200,035,103620,Pal; Piya,9999,0,9999,0
1668038982146,ECE 200,036,103621,Papen; George C.,9999,0,9999,0
1668038982146,ECE 200,037,103622,Radic; Stojan,9999,0,9999,0
1668038982146,ECE 200,038,103623,Rao; Bhaskar D.,9999,0,9999,0
1668038982146,ECE 200,039,103624,Rao; Ramesh R,9999,0,9999,0
1668038982146,ECE 200,040,103625,Rebeiz; Gabriel,9999,0,9999,0
1668038982146,ECE 200,041,103626,Sanford; John R,9999,0,9999,0
1668038982146,ECE 200,042,103627,Siegel; Paul H.,9999,0,9999,0
1668038982146,ECE 200,043,103628,Sievenpiper; Daniel F.,9999,0,9999,0
1668038982146,ECE 200,044,103629,Sworder; David D.,9999,0,9999,0
1668038982146,ECE 200,045,103630,Taur; Yuan,9999,0,9999,0
1668038982146,ECE 200,046,103631,Touri; Behrouz,9999,0,9999,0
1668038982146,ECE 200,047,103632,Trivedi; Mohan M.,9999,0,9999,0
1668038982146,ECE 200,048,103633,Vasconcelos; Nuno,9999,0,9999,0
1668038982146,ECE 200,049,103634,Wang; Xiaolong,9999,0,9999,0
1668038982146,ECE 200,050,103635,Xie; Pengtao,9999,0,9999,0
1668038982146,ECE 200,051,103636,Yip; Michael,9999,0,9999,0
1668038982146,ECE 200,052,103637,Zeger; Kenneth A.,999,0,999,0
1668038982146,ECE 200,053,103638,Zhang; Xinyu,9999,0,9999,0
1668038982146,ECE 200,054,103639,Turakhia; Yatish Girish,9999,0,9999,0
1668038982146,ECE 200,055,103640,Kang; Mingu,9999,0,9999,0
1668038982146,ECE 200,056,103641,Shi; Yuanyuan,9999,0,9999,0
1668038982146,ECE 200,057,103642,Wang; Edward Jay,9999,0,9999,0
1668038982146,ECE 200,058,103643,Zheng; Yang,9999,0,9999,0
1668038982585,ECE 202,A00,103644,Kuzum; Duygu,0,0,0,0
1668038983009,ECE 212BN,A00,103646,Ng; Tse Nga,0,0,0,0
1668038983437,ECE 221,A00,111493,Staff,0,0,0,0
1668038983865,ECE 222B,A00,103647,Lomakin; Vitaliy,0,0,0,0
1668038984293,ECE 230B,A00,103648,Taur; Yuan,0,0,0,0
1668038984725,ECE 238B,A00,103649,Garay; Javier,0,0,0,0
1668038985157,ECE 240B,A00,112900,Fainman; Yeshaiahu,0,0,0,0
1668038985589,ECE 247A,A00,103650,Jokerst; Jesse Vincent,0,0,0,0
1668038986016,ECE 247B,A00,103651,Wang; Joseph,0,0,0,0
1668038986457,ECE 250,A00,103652,Siegel; Paul H.,0,0,0,0
1668038986880,ECE 251A,A00,103654,Rao; Bhaskar D.,0,0,0,0
1668038987304,ECE 257B,A00,103655,Bharadia; Dinesh,0,0,0,0
1668038987744,ECE 258A,A00,103656,Milstein; Laurence B.,0,0,0,0
1668038988178,ECE 260B,A00,103658,Kang; Mingu,0,0,0,0
1668038988617,ECE 264A,A00,103659,Galton; Ian A,0,0,0,0
1668038989056,ECE 265A,A00,103661,Gudem; Prasad S.S.,0,0,0,0
1668038989481,ECE 265D,A00,103662,Gudem; Prasad S.S.,0,0,0,0
1668038989919,ECE 268,A00,103663,Koushanfar; Farinaz,0,0,0,0
1668038990349,ECE 269,A01,103665,Pal; Piya,0,0,0,0
1668038990772,ECE 271B,A00,103666,Vasconcelos; Manuela,0,0,0,0
1668038991208,ECE 276A,A00,103667,Atanasov; Nikolay A.,0,0,0,0
1668038991634,ECE 277,A00,103668,An; Cheolhong,0,0,0,0
1668038992071,ECE 279,A00,117947,Hall; Drew A.,0,0,0,0
1668038992940,ECE 283,A00,103670,Hsueh; Tzu-Chien,0,0,0,0
1668038993364,ECE 284,A00,103671,Turakhia; Yatish Girish,0,0,0,0
1668038993796,ECE 285,A00,103672,Zheng; Yang,0,0,0,0
1668038993796,ECE 285,B00,103673,Sworder; David D.,0,0,0,0
1668038994237,ECE 287,A00,103676,Javidi; Tara,0,0,0,0
1668038994667,MATH 200B,A00,098023,Salehi Golsefidy; Alireza,13,0,15,2
1668038995102,MATH 202B,A00,098024,Rhoades; Brendon Patrick,9,0,15,6
1668038995533,MATH 203B,A00,098025,Oprea; Dragos N.,11,0,15,4
1668038995972,MATH 204B,A00,098026,Sorensen; Claus M,13,0,15,2
1668038996415,MATH 208,A00,098027,Izadi; Elham,7,0,10,3
1668038996840,MATH 209,A00,098028,Pollack; Aaron,10,0,10,0
1668038997262,MATH 211A,A00,112919,Rogalski; Daniel,9,0,10,1
1668038997685,MATH 211B,A00,112920,Seward; Brandon M.,9,0,10,1
1668038998109,MATH 218,A00,098029,Li; Bo,10,0,10,0
1668038998631,MATH 220B,A00,098030,Novak; Jonathan I,13,0,15,2
1668038999058,MATH 221A,A00,098031,Ebenfelt; Peter F,13,0,15,2
1668038999484,MATH 231B,A00,098032,Zlatos; Andrej,12,0,15,3
1668038999908,MATH 240B,A00,098033,Ni; Lei,9,0,15,6
1668039000331,MATH 243,A00,098034,Jekel; David Andrew,10,0,10,0
1668039000754,MATH 245A,A00,098035,Nie; Jiawang,0,0,15,16
1668039001184,MATH 248,A00,098036,Bejenaru; Ioan,10,0,10,0
1668039001615,MATH 250B,A00,098037,Spolaor; Luca,14,0,15,1
1668039002038,MATH 258,A00,098038,Ni; Lei,10,0,10,0
1668039002468,MATH 264B,A00,098041,Rhoades; Brendon Patrick,10,0,15,5
1668039002899,MATH 268,A00,098042,Buss; Samuel R,10,0,10,0
1668039003332,MATH 269,A00,098043,Rhoades; Brendon Patrick,10,0,10,0
1668039003761,MATH 270B,A00,098044,Li; Bo,11,0,15,4
1668039004198,MATH 272B,A00,098045,Holst; Michael J,13,0,15,2
1668039004638,MATH 273A,A00,098046,Tian; Xiaochuan,10,0,15,5
1668039005065,MATH 275,A01,098048,Tian; Xiaochuan,6,0,10,4
1668039005502,MATH 278A,A00,098049,Holst; Michael J,8,0,10,2
1668039005927,MATH 278B,A00,098050,Cloninger; Alexander,10,0,10,0
1668039006351,MATH 278C,A00,098051,Nie; Jiawang,7,0,10,3
1668039006773,MATH 280B,A00,098052,Zheng; Tianyi,11,0,15,4
1668039007204,MATH 281B,A00,098053,Bradic; Jelena,3,0,15,12
1668039007647,MATH 282B,A00,098054,Arias-Castro; Ery,0,0,15,15
1668039008080,MATH 285,A00,098055,Fitzsimmons; Patrick J,0,0,15,17
1668039008519,MATH 287B,A00,098056,Arias-Castro; Ery,3,0,15,12
1668039008965,MATH 288,A00,098057,Agarwal; Pooja,9,0,10,1
1668039008965,MATH 288,B00,098058,Zhang; Danna,8,0,10,2
1668039008965,MATH 288,C00,098059,Williams; Ruth J,10,0,10,0
1668039009391,MATH 290B,A00,098060,Roberts; Justin Deritter,13,0,15,2
1668039009817,MATH 292,A00,098061,Belmont; Eva Kinoshita,10,0,10,0
1668039010251,MATH 295,A00,098062,Suk; Andrew Hoon,48,0,50,2
1668039010695,MATH 296,A00,098063,Novak; Jonathan I,20,0,20,0
1668039011123,MATH 297,001,098064,Gamst; Anthony Collins,9997,0,9999,2
1668039515116,COGS 205,A00,101395,Chiba; Andrea,19,0,20,1
1668039515558,COGS 210B,001,101404,Greene; Deanna Jacquelyn,9998,0,9999,1
1668039515558,COGS 210B,002,101417,Xia; Haijun,9999,0,9999,0
1668039515558,COGS 210B,003,101422,Nitz; Douglas A.,9999,0,9999,0
1668039515558,COGS 210B,004,101423,Hollan; James D.,9998,0,9999,1
1668039515558,COGS 210B,005,101424,Deak; Gedeon O.,9998,0,9999,1
1668039515558,COGS 210B,006,101425,Rossano; Federico,9999,0,9999,0
1668039515988,COGS 211B,A00,101427,Coulson; Seana M,9996,0,9999,3
1668039516426,COGS 220,A00,101428,Hollan; James D.,0,0,25,25
1668039516868,COGS 229,A00,101429,Dow; Steven P,18,0,25,7
1668039517293,COGS 230,A00,101430,Klemmer; Scott R,13,0,17,4
1668039517723,COGS 234,A00,101431,Xia; Haijun,4,0,25,21
1668039518147,COGS 260,A00,101432,Kiyonaga; Anastasia,19,0,25,6
1668039518147,COGS 260,B00,101433,Kirsh; David Joel,16,0,25,9
1668039518577,CSE 202,A00,102371,Impagliazzo; Russell,0,0,0,0
1668039519001,CSE 203B,A01,102373,Cheng; Chung Kuan,0,0,0,0
1668039519427,CSE 208,A00,102374,Micciancio; Daniele,0,0,0,0
1668039519851,CSE 209A,A00,112895,Impagliazzo; Russell,0,0,15,15
1668039520276,CSE 209B,A00,108005,Bellare; Mihir,0,0,0,0
1668039520700,CSE 210,A00,113163,Coblenz; Michael J,0,0,0,0
1668039521135,CSE 219,A00,106111,Dow; Steven P,0,0,20,20
1668039521560,CSE 221,A00,102376,Voelker; Geoffrey M.,0,0,0,0
1668039521983,CSE 224,A01,102378,Porter; George M,0,0,0,0
1668039522407,CSE 229A,A00,102379,Savage; Stefan,0,0,0,0
1668039522924,CSE 229C,A00,102380,Munyaka; Imani N. S.,0,0,0,0
1668039523357,CSE 232B,A00,102382,Deutsch; Alin Bernard,0,0,0,0
1668039523792,CSE 234,A01,112904,Kumar; Arun Kumar,0,0,0,0
1668039524222,CSE 237A,A00,102383,Rosing; Tajana Simunic,0,0,0,0
1668039524653,CSE 239A,A00,102384,Deutsch; Alin Bernard,0,0,0,0
1668039525079,CSE 239B,A00,102385,Polikarpova; Nadezhda,0,0,0,0
1668039525504,CSE 240A,A00,102386,Pannuto; Patrick William,0,0,0,0
1668039525942,CSE 240B,A00,102387,Zhao; Jishen,0,0,0,0
1668039526375,CSE 241A,A00,106406,Kang; Mingu,0,0,0,0
1668039526799,CSE 249B,A00,102388,Kahng; Andrew Byun,0,0,8,8
1668039527225,CSE 251B,A01,102392,Cottrell; Garrison W,0,0,0,0
1668039527225,CSE 251B,A02,102393,Cottrell; Garrison W,0,0,0,0
1668039527652,CSE 252B,A00,102394,Ochoa; Benjamin Lawrence,0,0,0,0
1668039528074,CSE 257,A01,102396,Gao; Sicun,0,0,0,0
1668039528495,CSE 272,A00,102397,Li; Tzumao,0,0,0,0
1668039528918,CSE 274,A00,111323,Chern; Albert Ren-Haur,0,0,0,0
1668039529348,CSE 282,A00,102398,Pevzner; Pavel Arkadjevich,0,0,0,0
1668039529781,CSE 284,A00,114175,Gymrek; Melissa Ann,0,0,0,0
1668039530204,CSE 290,A00,102399,Chandraker; Manmohan Krishna,0,0,0,0
1668039530204,CSE 290,B00,102400,Vaccaro; Kristen Marie,0,0,25,25
1668039530204,CSE 290,C00,102414,Pannuto; Patrick William,0,0,25,25
1668039530204,CSE 290,D00,102427,Pevzner; Pavel Arkadjevich,0,0,0,0
1668039530204,CSE 290,E00,102429,Zhao; Jishen,0,0,0,0
1668039530204,CSE 290,F00,102436,Tullsen; Dean Michael,0,0,0,0
1668039530204,CSE 290,G00,102440,Christensen; Henrik I,0,0,20,20
1668039530640,CSE 291,A00,102443,Su; Hao,0,0,0,0
1668039530640,CSE 291,B00,102448,Polikarpova; Nadezhda,0,0,0,0
1668039530640,CSE 291,C00,102453,Vaccaro; Kristen Marie,0,0,0,0
1668039530640,CSE 291,D00,111343,Savage; Stefan,0,0,0,0
1668039530640,CSE 291,E00,116474,Claffy; Kimberly Claire,0,0,0,0
1668039530640,CSE 291,F00,116479,Pasquale; Joseph,0,0,0,0
1668039531091,CSE 293,001,119111,Bafna; Vineet,9999,0,9999,0
1668039531091,CSE 293,002,119118,Bellare; Mihir,9999,0,9999,0
1668039531091,CSE 293,003,119122,Berg-Kirkpatrick; Taylor D,9999,0,9999,0
1668039531091,CSE 293,004,119135,Christensen; Henrik I,9999,0,9999,0
1668039531091,CSE 293,005,119142,Cottrell; Garrison W,9999,0,9999,0
1668039531091,CSE 293,006,119146,Deutsch; Alin Bernard,9999,0,9999,0
1668039531091,CSE 293,007,119159,Esmaeilzadeh; Hadi,9999,0,9999,0
1668039531091,CSE 293,008,119166,Freund; Yoav,9999,0,9999,0
1668039531091,CSE 293,009,119170,Griswold; William G.,9999,0,9999,0
1668039531091,CSE 293,010,119183,Gymrek; Melissa Ann,9999,0,9999,0
1668039531091,CSE 293,011,119190,Heninger; Nadia A,9999,0,9999,0
1668039531091,CSE 293,012,119230,Impagliazzo; Russell,9999,0,9999,0
1668039531091,CSE 293,013,119232,Jhala; Ranjit,9999,0,9999,0
1668039531091,CSE 293,014,119233,Kahng; Andrew Byun,9999,0,9999,0
1668039531091,CSE 293,015,119298,Kane; Daniel Mertz,9999,0,9999,0
1668039531091,CSE 293,016,119299,Kriegman; David J,9999,0,9999,0
1668039531091,CSE 293,017,119300,Kumar; Arun Kumar,9999,0,9999,0
1668039531091,CSE 293,018,119301,Lerner; Sorin,9999,0,9999,0
1668039531091,CSE 293,019,119302,Lovett; Shachar,9999,0,9999,0
1668039531091,CSE 293,020,119303,McAuley; Julian John,9999,0,9999,0
1668039531091,CSE 293,021,119304,Micciancio; Daniele,9999,0,9999,0
1668039531091,CSE 293,022,119367,Orailoglu; Alex,9999,0,9999,0
1668039531091,CSE 293,023,119382,Paturi; Ramamohan,9999,0,9999,0
1668039531091,CSE 293,024,119404,Polikarpova; Nadezhda,9999,0,9999,0
1668039531091,CSE 293,025,119406,Politz; Joseph Gibbs,9999,0,9999,0
1668039531091,CSE 293,026,119411,Porter; George M,9999,0,9999,0
1668039531091,CSE 293,027,119414,Porter; Leonard Emerson,9999,0,9999,0
1668039531091,CSE 293,028,119416,Ramamoorthi; Ravi,9999,0,9999,0
1668039531091,CSE 293,029,119417,Sahoo; Debashis,9999,0,9999,0
1668039531091,CSE 293,030,119420,Saul; Lawrence,9999,0,9999,0
1668039531091,CSE 293,031,119421,Savage; Stefan,9999,0,9999,0
1668039531091,CSE 293,032,119425,Schulze; Jurgen P.,9999,0,9999,0
1668039531091,CSE 293,033,119426,Snoeren; Alex C.,9999,0,9999,0
1668039531091,CSE 293,034,119428,Shang; Jingbo,9999,0,9999,0
1668039531091,CSE 293,035,119430,Stefan; Deian,9999,0,9999,0
1668039531091,CSE 293,036,119431,Su; Hao,9999,0,9999,0
1668039531091,CSE 293,037,119433,Swanson; Steven James,9999,0,9999,0
1668039531091,CSE 293,038,119435,Tullsen; Dean Michael,9999,0,9999,0
1668039531091,CSE 293,039,119483,Voelker; Geoffrey M.,9999,0,9999,0
1668039531091,CSE 293,040,119537,Zhao; Jishen,9999,0,9999,0
1668039531091,CSE 293,041,119538,Zhou; Yuan-Yuan,9999,0,9999,0
1668039531091,CSE 293,042,119539,Gao; Sicun,9999,0,9999,0
1668039531091,CSE 293,043,119540,Weibel; Nadir,9999,0,9999,0
1668039531091,CSE 293,044,119541,Gupta; Rajesh K.,9999,0,9999,0
1668039531091,CSE 293,045,126410,Vaccaro; Kristen Marie,9999,0,9999,0
1668039531091,CSE 293,046,126411,Klemke; Richard,9999,0,9999,0
1668039531523,CSE 294,A00,102459,Voelker; Geoffrey M.,0,0,0,0
1668039531523,CSE 294,B00,111322,Orailoglu; Alex,0,0,0,0
1668039531945,DSE 201,A00,096914,Deutsch; Alin Bernard,30,0,30,0
1668039532372,DSE 210,A00,096915,Dasgupta; Sanjoy,30,0,30,0
1668039532793,DSE 260A,A00,096916,Altintas De Callaf; Ilkay,30,0,30,0
1668039533223,ECE 200,001,103586,Antipa; Nicholas A,9999,0,9999,0
1668039533223,ECE 200,002,103587,Atanasov; Nikolay A.,9999,0,9999,0
1668039533223,ECE 200,003,103588,Bharadia; Dinesh,9999,0,9999,0
1668039533223,ECE 200,004,103589,Cheng; Chung Kuan,9999,0,9999,0
1668039533223,ECE 200,005,103590,Cosman; Pamela C.,9999,0,9999,0
1668039533223,ECE 200,006,103591,Dayeh; Shadi Ahmad,9999,0,9999,0
1668039533223,ECE 200,007,103592,Fainman; Yeshaiahu,9999,0,9999,0
1668039533223,ECE 200,008,103593,Ford; Joseph Earl,9999,0,9999,0
1668039533223,ECE 200,009,103594,Franceschetti; Massimo,9999,0,9999,0
1668039533223,ECE 200,010,103595,Fullerton; Eric E,9999,0,9999,0
1668039533223,ECE 200,011,103596,Galton; Ian A,9999,0,9999,0
1668039533223,ECE 200,012,103597,Gilja; Vikash,9999,0,9999,0
1668039533223,ECE 200,013,103598,Hall; Drew A.,9999,0,9999,0
1668039533223,ECE 200,014,103599,Hsueh; Tzu-Chien,9999,0,9999,0
1668039533223,ECE 200,015,103600,Javidi; Tara,9999,0,9999,0
1668039533223,ECE 200,016,103601,Kahng; Andrew Byun,9999,0,9999,0
1668039533223,ECE 200,017,103602,Kim; Young-Han,9999,0,9999,0
1668039533223,ECE 200,018,103603,Koushanfar; Farinaz,9999,0,9999,0
1668039533223,ECE 200,019,103604,Kuzum; Duygu,9999,0,9999,0
1668039533223,ECE 200,020,103605,Le; Hanh-Phuc,9999,0,9999,0
1668039533223,ECE 200,021,103606,Lin; Bill,9999,0,9999,0
1668039533223,ECE 200,022,103607,Liu; Zhaowei,9998,0,9999,1
1668039533223,ECE 200,023,103608,Lo; Yu-Hwa,9999,0,9999,0
1668039533223,ECE 200,024,103609,Lomakin; Vitaliy,9999,0,9999,0
1668039533223,ECE 200,025,103610,Mercier; Patrick Philip,9999,0,9999,0
1668039533223,ECE 200,026,103611,Meyer; Florian,9999,0,9999,0
1668039533223,ECE 200,027,103612,Milstein; Laurence B.,9999,0,9999,0
1668039533223,ECE 200,028,103613,Mir Arabbaygi; Siavash,9999,0,9999,0
1668039533223,ECE 200,029,103614,Mookherjea; Shayan,9999,0,9999,0
1668039533223,ECE 200,030,103615,Morris; Karcher William,9999,0,9999,0
1668039533223,ECE 200,031,103616,Ng; Tse Nga,9999,0,9999,0
1668039533223,ECE 200,032,103617,Nguyen; Truong Quang,9999,0,9999,0
1668039533223,ECE 200,033,103618,Nomura; Kenji,9999,0,9999,0
1668039533223,ECE 200,034,103619,Orlitsky; Alon,9999,0,9999,0
1668039533223,ECE 200,035,103620,Pal; Piya,9999,0,9999,0
1668039533223,ECE 200,036,103621,Papen; George C.,9999,0,9999,0
1668039533223,ECE 200,037,103622,Radic; Stojan,9999,0,9999,0
1668039533223,ECE 200,038,103623,Rao; Bhaskar D.,9999,0,9999,0
1668039533223,ECE 200,039,103624,Rao; Ramesh R,9999,0,9999,0
1668039533223,ECE 200,040,103625,Rebeiz; Gabriel,9999,0,9999,0
1668039533223,ECE 200,041,103626,Sanford; John R,9999,0,9999,0
1668039533223,ECE 200,042,103627,Siegel; Paul H.,9999,0,9999,0
1668039533223,ECE 200,043,103628,Sievenpiper; Daniel F.,9999,0,9999,0
1668039533223,ECE 200,044,103629,Sworder; David D.,9999,0,9999,0
1668039533223,ECE 200,045,103630,Taur; Yuan,9999,0,9999,0
1668039533223,ECE 200,046,103631,Touri; Behrouz,9999,0,9999,0
1668039533223,ECE 200,047,103632,Trivedi; Mohan M.,9999,0,9999,0
1668039533223,ECE 200,048,103633,Vasconcelos; Nuno,9999,0,9999,0
1668039533223,ECE 200,049,103634,Wang; Xiaolong,9999,0,9999,0
1668039533223,ECE 200,050,103635,Xie; Pengtao,9999,0,9999,0
1668039533223,ECE 200,051,103636,Yip; Michael,9999,0,9999,0
1668039533223,ECE 200,052,103637,Zeger; Kenneth A.,999,0,999,0
1668039533223,ECE 200,053,103638,Zhang; Xinyu,9999,0,9999,0
1668039533223,ECE 200,054,103639,Turakhia; Yatish Girish,9999,0,9999,0
1668039533223,ECE 200,055,103640,Kang; Mingu,9999,0,9999,0
1668039533223,ECE 200,056,103641,Shi; Yuanyuan,9999,0,9999,0
1668039533223,ECE 200,057,103642,Wang; Edward Jay,9999,0,9999,0
1668039533223,ECE 200,058,103643,Zheng; Yang,9999,0,9999,0
1668039533646,ECE 202,A00,103644,Kuzum; Duygu,0,0,0,0
1668039534077,ECE 212BN,A00,103646,Ng; Tse Nga,0,0,0,0
1668039534512,ECE 221,A00,111493,Staff,0,0,0,0
1668039534941,ECE 222B,A00,103647,Lomakin; Vitaliy,0,0,0,0
1668039535373,ECE 230B,A00,103648,Taur; Yuan,0,0,0,0
1668039535807,ECE 238B,A00,103649,Garay; Javier,0,0,0,0
1668039536237,ECE 240B,A00,112900,Fainman; Yeshaiahu,0,0,0,0
1668039536660,ECE 247A,A00,103650,Jokerst; Jesse Vincent,0,0,0,0
1668039537088,ECE 247B,A00,103651,Wang; Joseph,0,0,0,0
1668039537524,ECE 250,A00,103652,Siegel; Paul H.,0,0,0,0
1668039537948,ECE 251A,A00,103654,Rao; Bhaskar D.,0,0,0,0
1668039538371,ECE 257B,A00,103655,Bharadia; Dinesh,0,0,0,0
1668039538799,ECE 258A,A00,103656,Milstein; Laurence B.,0,0,0,0
1668039539225,ECE 260B,A00,103658,Kang; Mingu,0,0,0,0
1668039539647,ECE 264A,A00,103659,Galton; Ian A,0,0,0,0
1668039540080,ECE 265A,A00,103661,Gudem; Prasad S.S.,0,0,0,0
1668039540508,ECE 265D,A00,103662,Gudem; Prasad S.S.,0,0,0,0
1668039540932,ECE 268,A00,103663,Koushanfar; Farinaz,0,0,0,0
1668039541358,ECE 269,A01,103665,Pal; Piya,0,0,0,0
1668039541792,ECE 271B,A00,103666,Vasconcelos; Manuela,0,0,0,0
1668039542236,ECE 276A,A00,103667,Atanasov; Nikolay A.,0,0,0,0
1668039542669,ECE 277,A00,103668,An; Cheolhong,0,0,0,0
1668039543107,ECE 279,A00,117947,Hall; Drew A.,0,0,0,0
1668039543961,ECE 283,A00,103670,Hsueh; Tzu-Chien,0,0,0,0
1668039544386,ECE 284,A00,103671,Turakhia; Yatish Girish,0,0,0,0
1668039544812,ECE 285,A00,103672,Zheng; Yang,0,0,0,0
1668039544812,ECE 285,B00,103673,Sworder; David D.,0,0,0,0
1668039545255,ECE 287,A00,103676,Javidi; Tara,0,0,0,0
1668039545686,MATH 200B,A00,098023,Salehi Golsefidy; Alireza,13,0,15,2
1668039546135,MATH 202B,A00,098024,Rhoades; Brendon Patrick,9,0,15,6
1668039546564,MATH 203B,A00,098025,Oprea; Dragos N.,11,0,15,4
1668039546989,MATH 204B,A00,098026,Sorensen; Claus M,13,0,15,2
1668039547422,MATH 208,A00,098027,Izadi; Elham,7,0,10,3
1668039547850,MATH 209,A00,098028,Pollack; Aaron,10,0,10,0
1668039548281,MATH 211A,A00,112919,Rogalski; Daniel,9,0,10,1
1668039548729,MATH 211B,A00,112920,Seward; Brandon M.,9,0,10,1
1668039549171,MATH 218,A00,098029,Li; Bo,10,0,10,0
1668039549610,MATH 220B,A00,098030,Novak; Jonathan I,13,0,15,2
1668039550044,MATH 221A,A00,098031,Ebenfelt; Peter F,13,0,15,2
1668039550466,MATH 231B,A00,098032,Zlatos; Andrej,12,0,15,3
1668039550891,MATH 240B,A00,098033,Ni; Lei,9,0,15,6
1668039551315,MATH 243,A00,098034,Jekel; David Andrew,10,0,10,0
1668039551739,MATH 245A,A00,098035,Nie; Jiawang,0,0,15,16
1668039552177,MATH 248,A00,098036,Bejenaru; Ioan,10,0,10,0
1668039552600,MATH 250B,A00,098037,Spolaor; Luca,14,0,15,1
1668039553086,MATH 258,A00,098038,Ni; Lei,10,0,10,0
1668039553528,MATH 264B,A00,098041,Rhoades; Brendon Patrick,10,0,15,5
1668039553956,MATH 268,A00,098042,Buss; Samuel R,10,0,10,0
1668039554404,MATH 269,A00,098043,Rhoades; Brendon Patrick,10,0,10,0
1668039554850,MATH 270B,A00,098044,Li; Bo,11,0,15,4
1668039555273,MATH 272B,A00,098045,Holst; Michael J,13,0,15,2
1668039555696,MATH 273A,A00,098046,Tian; Xiaochuan,10,0,15,5
1668039556117,MATH 275,A01,098048,Tian; Xiaochuan,6,0,10,4
1668039556541,MATH 278A,A00,098049,Holst; Michael J,8,0,10,2
1668039556964,MATH 278B,A00,098050,Cloninger; Alexander,10,0,10,0
1668039557387,MATH 278C,A00,098051,Nie; Jiawang,7,0,10,3
1668039557810,MATH 280B,A00,098052,Zheng; Tianyi,11,0,15,4
1668039558236,MATH 281B,A00,098053,Bradic; Jelena,3,0,15,12
1668039558671,MATH 282B,A00,098054,Arias-Castro; Ery,0,0,15,15
1668039559097,MATH 285,A00,098055,Fitzsimmons; Patrick J,0,0,15,17
1668039559521,MATH 287B,A00,098056,Arias-Castro; Ery,3,0,15,12
1668039559948,MATH 288,A00,098057,Agarwal; Pooja,9,0,10,1
1668039559948,MATH 288,B00,098058,Zhang; Danna,8,0,10,2
1668039559948,MATH 288,C00,098059,Williams; Ruth J,10,0,10,0
1668039560370,MATH 290B,A00,098060,Roberts; Justin Deritter,13,0,15,2
1668039560802,MATH 292,A00,098061,Belmont; Eva Kinoshita,10,0,10,0
1668039561229,MATH 295,A00,098062,Suk; Andrew Hoon,48,0,50,2
1668039561652,MATH 296,A00,098063,Novak; Jonathan I,20,0,20,0
1668039562089,MATH 297,001,098064,Gamst; Anthony Collins,9997,0,9999,2
1668040067026,COGS 205,A00,101395,Chiba; Andrea,19,0,20,1
1668040067459,COGS 210B,001,101404,Greene; Deanna Jacquelyn,9998,0,9999,1
1668040067459,COGS 210B,002,101417,Xia; Haijun,9999,0,9999,0
1668040067459,COGS 210B,003,101422,Nitz; Douglas A.,9999,0,9999,0
1668040067459,COGS 210B,004,101423,Hollan; James D.,9998,0,9999,1
1668040067459,COGS 210B,005,101424,Deak; Gedeon O.,9998,0,9999,1
1668040067459,COGS 210B,006,101425,Rossano; Federico,9999,0,9999,0
1668040067884,COGS 211B,A00,101427,Coulson; Seana M,9996,0,9999,3
1668040068315,COGS 220,A00,101428,Hollan; James D.,0,0,25,25
1668040068751,COGS 229,A00,101429,Dow; Steven P,18,0,25,7
1668040069186,COGS 230,A00,101430,Klemmer; Scott R,13,0,17,4
1668040069609,COGS 234,A00,101431,Xia; Haijun,4,0,25,21
1668040070036,COGS 260,A00,101432,Kiyonaga; Anastasia,19,0,25,6
1668040070036,COGS 260,B00,101433,Kirsh; David Joel,16,0,25,9
1668040070476,CSE 202,A00,102371,Impagliazzo; Russell,0,0,0,0
1668040070900,CSE 203B,A01,102373,Cheng; Chung Kuan,0,0,0,0
1668040071334,CSE 208,A00,102374,Micciancio; Daniele,0,0,0,0
1668040071767,CSE 209A,A00,112895,Impagliazzo; Russell,0,0,15,15
1668040072191,CSE 209B,A00,108005,Bellare; Mihir,0,0,0,0
1668040072623,CSE 210,A00,113163,Coblenz; Michael J,0,0,0,0
1668040073046,CSE 219,A00,106111,Dow; Steven P,0,0,20,20
1668040073471,CSE 221,A00,102376,Voelker; Geoffrey M.,0,0,0,0
1668040073897,CSE 224,A01,102378,Porter; George M,0,0,0,0
1668040074332,CSE 229A,A00,102379,Savage; Stefan,0,0,0,0
1668040074793,CSE 229C,A00,102380,Munyaka; Imani N. S.,0,0,0,0
1668040075243,CSE 232B,A00,102382,Deutsch; Alin Bernard,0,0,0,0
1668040075669,CSE 234,A01,112904,Kumar; Arun Kumar,0,0,0,0
1668040076095,CSE 237A,A00,102383,Rosing; Tajana Simunic,0,0,0,0
1668040076525,CSE 239A,A00,102384,Deutsch; Alin Bernard,0,0,0,0
1668040076956,CSE 239B,A00,102385,Polikarpova; Nadezhda,0,0,0,0
1668040077381,CSE 240A,A00,102386,Pannuto; Patrick William,0,0,0,0
1668040077805,CSE 240B,A00,102387,Zhao; Jishen,0,0,0,0
1668040078231,CSE 241A,A00,106406,Kang; Mingu,0,0,0,0
1668040078654,CSE 249B,A00,102388,Kahng; Andrew Byun,0,0,8,8
1668040079082,CSE 251B,A01,102392,Cottrell; Garrison W,0,0,0,0
1668040079082,CSE 251B,A02,102393,Cottrell; Garrison W,0,0,0,0
1668040079508,CSE 252B,A00,102394,Ochoa; Benjamin Lawrence,0,0,0,0
1668040079938,CSE 257,A01,102396,Gao; Sicun,0,0,0,0
1668040080364,CSE 272,A00,102397,Li; Tzumao,0,0,0,0
1668040080787,CSE 274,A00,111323,Chern; Albert Ren-Haur,0,0,0,0
1668040081217,CSE 282,A00,102398,Pevzner; Pavel Arkadjevich,0,0,0,0
1668040081651,CSE 284,A00,114175,Gymrek; Melissa Ann,0,0,0,0
1668040082080,CSE 290,A00,102399,Chandraker; Manmohan Krishna,0,0,0,0
1668040082080,CSE 290,B00,102400,Vaccaro; Kristen Marie,0,0,25,25
1668040082080,CSE 290,C00,102414,Pannuto; Patrick William,0,0,25,25
1668040082080,CSE 290,D00,102427,Pevzner; Pavel Arkadjevich,0,0,0,0
1668040082080,CSE 290,E00,102429,Zhao; Jishen,0,0,0,0
1668040082080,CSE 290,F00,102436,Tullsen; Dean Michael,0,0,0,0
1668040082080,CSE 290,G00,102440,Christensen; Henrik I,0,0,20,20
1668040082514,CSE 291,A00,102443,Su; Hao,0,0,0,0
1668040082514,CSE 291,B00,102448,Polikarpova; Nadezhda,0,0,0,0
1668040082514,CSE 291,C00,102453,Vaccaro; Kristen Marie,0,0,0,0
1668040082514,CSE 291,D00,111343,Savage; Stefan,0,0,0,0
1668040082514,CSE 291,E00,116474,Claffy; Kimberly Claire,0,0,0,0
1668040082514,CSE 291,F00,116479,Pasquale; Joseph,0,0,0,0
1668040082959,CSE 293,001,119111,Bafna; Vineet,9999,0,9999,0
1668040082959,CSE 293,002,119118,Bellare; Mihir,9999,0,9999,0
1668040082959,CSE 293,003,119122,Berg-Kirkpatrick; Taylor D,9999,0,9999,0
1668040082959,CSE 293,004,119135,Christensen; Henrik I,9999,0,9999,0
1668040082959,CSE 293,005,119142,Cottrell; Garrison W,9999,0,9999,0
1668040082959,CSE 293,006,119146,Deutsch; Alin Bernard,9999,0,9999,0
1668040082959,CSE 293,007,119159,Esmaeilzadeh; Hadi,9999,0,9999,0
1668040082959,CSE 293,008,119166,Freund; Yoav,9999,0,9999,0
1668040082959,CSE 293,009,119170,Griswold; William G.,9999,0,9999,0
1668040082959,CSE 293,010,119183,Gymrek; Melissa Ann,9999,0,9999,0
1668040082959,CSE 293,011,119190,Heninger; Nadia A,9999,0,9999,0
1668040082959,CSE 293,012,119230,Impagliazzo; Russell,9999,0,9999,0
1668040082959,CSE 293,013,119232,Jhala; Ranjit,9999,0,9999,0
1668040082959,CSE 293,014,119233,Kahng; Andrew Byun,9999,0,9999,0
1668040082959,CSE 293,015,119298,Kane; Daniel Mertz,9999,0,9999,0
1668040082959,CSE 293,016,119299,Kriegman; David J,9999,0,9999,0
1668040082959,CSE 293,017,119300,Kumar; Arun Kumar,9999,0,9999,0
1668040082959,CSE 293,018,119301,Lerner; Sorin,9999,0,9999,0
1668040082959,CSE 293,019,119302,Lovett; Shachar,9999,0,9999,0
1668040082959,CSE 293,020,119303,McAuley; Julian John,9999,0,9999,0
1668040082959,CSE 293,021,119304,Micciancio; Daniele,9999,0,9999,0
1668040082959,CSE 293,022,119367,Orailoglu; Alex,9999,0,9999,0
1668040082959,CSE 293,023,119382,Paturi; Ramamohan,9999,0,9999,0
1668040082959,CSE 293,024,119404,Polikarpova; Nadezhda,9999,0,9999,0
1668040082959,CSE 293,025,119406,Politz; Joseph Gibbs,9999,0,9999,0
1668040082959,CSE 293,026,119411,Porter; George M,9999,0,9999,0
1668040082959,CSE 293,027,119414,Porter; Leonard Emerson,9999,0,9999,0
1668040082959,CSE 293,028,119416,Ramamoorthi; Ravi,9999,0,9999,0
1668040082959,CSE 293,029,119417,Sahoo; Debashis,9999,0,9999,0
1668040082959,CSE 293,030,119420,Saul; Lawrence,9999,0,9999,0
1668040082959,CSE 293,031,119421,Savage; Stefan,9999,0,9999,0
1668040082959,CSE 293,032,119425,Schulze; Jurgen P.,9999,0,9999,0
1668040082959,CSE 293,033,119426,Snoeren; Alex C.,9999,0,9999,0
1668040082959,CSE 293,034,119428,Shang; Jingbo,9999,0,9999,0
1668040082959,CSE 293,035,119430,Stefan; Deian,9999,0,9999,0
1668040082959,CSE 293,036,119431,Su; Hao,9999,0,9999,0
1668040082959,CSE 293,037,119433,Swanson; Steven James,9999,0,9999,0
1668040082959,CSE 293,038,119435,Tullsen; Dean Michael,9999,0,9999,0
1668040082959,CSE 293,039,119483,Voelker; Geoffrey M.,9999,0,9999,0
1668040082959,CSE 293,040,119537,Zhao; Jishen,9999,0,9999,0
1668040082959,CSE 293,041,119538,Zhou; Yuan-Yuan,9999,0,9999,0
1668040082959,CSE 293,042,119539,Gao; Sicun,9999,0,9999,0
1668040082959,CSE 293,043,119540,Weibel; Nadir,9999,0,9999,0
1668040082959,CSE 293,044,119541,Gupta; Rajesh K.,9999,0,9999,0
1668040082959,CSE 293,045,126410,Vaccaro; Kristen Marie,9999,0,9999,0
1668040082959,CSE 293,046,126411,Klemke; Richard,9999,0,9999,0
1668040083386,CSE 294,A00,102459,Voelker; Geoffrey M.,0,0,0,0
1668040083386,CSE 294,B00,111322,Orailoglu; Alex,0,0,0,0
1668040083810,DSE 201,A00,096914,Deutsch; Alin Bernard,30,0,30,0
1668040084256,DSE 210,A00,096915,Dasgupta; Sanjoy,30,0,30,0
1668040084692,DSE 260A,A00,096916,Altintas De Callaf; Ilkay,30,0,30,0
1668040085146,ECE 200,001,103586,Antipa; Nicholas A,9999,0,9999,0
1668040085146,ECE 200,002,103587,Atanasov; Nikolay A.,9999,0,9999,0
1668040085146,ECE 200,003,103588,Bharadia; Dinesh,9999,0,9999,0
1668040085146,ECE 200,004,103589,Cheng; Chung Kuan,9999,0,9999,0
1668040085146,ECE 200,005,103590,Cosman; Pamela C.,9999,0,9999,0
1668040085146,ECE 200,006,103591,Dayeh; Shadi Ahmad,9999,0,9999,0
1668040085146,ECE 200,007,103592,Fainman; Yeshaiahu,9999,0,9999,0
1668040085146,ECE 200,008,103593,Ford; Joseph Earl,9999,0,9999,0
1668040085146,ECE 200,009,103594,Franceschetti; Massimo,9999,0,9999,0
1668040085146,ECE 200,010,103595,Fullerton; Eric E,9999,0,9999,0
1668040085146,ECE 200,011,103596,Galton; Ian A,9999,0,9999,0
1668040085146,ECE 200,012,103597,Gilja; Vikash,9999,0,9999,0
1668040085146,ECE 200,013,103598,Hall; Drew A.,9999,0,9999,0
1668040085146,ECE 200,014,103599,Hsueh; Tzu-Chien,9999,0,9999,0
1668040085146,ECE 200,015,103600,Javidi; Tara,9999,0,9999,0
1668040085146,ECE 200,016,103601,Kahng; Andrew Byun,9999,0,9999,0
1668040085146,ECE 200,017,103602,Kim; Young-Han,9999,0,9999,0
1668040085146,ECE 200,018,103603,Koushanfar; Farinaz,9999,0,9999,0
1668040085146,ECE 200,019,103604,Kuzum; Duygu,9999,0,9999,0
1668040085146,ECE 200,020,103605,Le; Hanh-Phuc,9999,0,9999,0
1668040085146,ECE 200,021,103606,Lin; Bill,9999,0,9999,0
1668040085146,ECE 200,022,103607,Liu; Zhaowei,9998,0,9999,1
1668040085146,ECE 200,023,103608,Lo; Yu-Hwa,9999,0,9999,0
1668040085146,ECE 200,024,103609,Lomakin; Vitaliy,9999,0,9999,0
1668040085146,ECE 200,025,103610,Mercier; Patrick Philip,9999,0,9999,0
1668040085146,ECE 200,026,103611,Meyer; Florian,9999,0,9999,0
1668040085146,ECE 200,027,103612,Milstein; Laurence B.,9999,0,9999,0
1668040085146,ECE 200,028,103613,Mir Arabbaygi; Siavash,9999,0,9999,0
1668040085146,ECE 200,029,103614,Mookherjea; Shayan,9999,0,9999,0
1668040085146,ECE 200,030,103615,Morris; Karcher William,9999,0,9999,0
1668040085146,ECE 200,031,103616,Ng; Tse Nga,9999,0,9999,0
1668040085146,ECE 200,032,103617,Nguyen; Truong Quang,9999,0,9999,0
1668040085146,ECE 200,033,103618,Nomura; Kenji,9999,0,9999,0
1668040085146,ECE 200,034,103619,Orlitsky; Alon,9999,0,9999,0
1668040085146,ECE 200,035,103620,Pal; Piya,9999,0,9999,0
1668040085146,ECE 200,036,103621,Papen; George C.,9999,0,9999,0
1668040085146,ECE 200,037,103622,Radic; Stojan,9999,0,9999,0
1668040085146,ECE 200,038,103623,Rao; Bhaskar D.,9999,0,9999,0
1668040085146,ECE 200,039,103624,Rao; Ramesh R,9999,0,9999,0
1668040085146,ECE 200,040,103625,Rebeiz; Gabriel,9999,0,9999,0
1668040085146,ECE 200,041,103626,Sanford; John R,9999,0,9999,0
1668040085146,ECE 200,042,103627,Siegel; Paul H.,9999,0,9999,0
1668040085146,ECE 200,043,103628,Sievenpiper; Daniel F.,9999,0,9999,0
1668040085146,ECE 200,044,103629,Sworder; David D.,9999,0,9999,0
1668040085146,ECE 200,045,103630,Taur; Yuan,9999,0,9999,0
1668040085146,ECE 200,046,103631,Touri; Behrouz,9999,0,9999,0
1668040085146,ECE 200,047,103632,Trivedi; Mohan M.,9999,0,9999,0
1668040085146,ECE 200,048,103633,Vasconcelos; Nuno,9999,0,9999,0
1668040085146,ECE 200,049,103634,Wang; Xiaolong,9999,0,9999,0
1668040085146,ECE 200,050,103635,Xie; Pengtao,9999,0,9999,0
1668040085146,ECE 200,051,103636,Yip; Michael,9999,0,9999,0
1668040085146,ECE 200,052,103637,Zeger; Kenneth A.,999,0,999,0
1668040085146,ECE 200,053,103638,Zhang; Xinyu,9999,0,9999,0
1668040085146,ECE 200,054,103639,Turakhia; Yatish Girish,9999,0,9999,0
1668040085146,ECE 200,055,103640,Kang; Mingu,9999,0,9999,0
1668040085146,ECE 200,056,103641,Shi; Yuanyuan,9999,0,9999,0
1668040085146,ECE 200,057,103642,Wang; Edward Jay,9999,0,9999,0
1668040085146,ECE 200,058,103643,Zheng; Yang,9999,0,9999,0
1668040085573,ECE 202,A00,103644,Kuzum; Duygu,0,0,0,0
1668040085999,ECE 212BN,A00,103646,Ng; Tse Nga,0,0,0,0
1668040086425,ECE 221,A00,111493,Staff,0,0,0,0
1668040086860,ECE 222B,A00,103647,Lomakin; Vitaliy,0,0,0,0
1668040087309,ECE 230B,A00,103648,Taur; Yuan,0,0,0,0
1668040087740,ECE 238B,A00,103649,Garay; Javier,0,0,0,0
1668040088180,ECE 240B,A00,112900,Fainman; Yeshaiahu,0,0,0,0
1668040088605,ECE 247A,A00,103650,Jokerst; Jesse Vincent,0,0,0,0
1668040089034,ECE 247B,A00,103651,Wang; Joseph,0,0,0,0
1668040089457,ECE 250,A00,103652,Siegel; Paul H.,0,0,0,0
1668040089887,ECE 251A,A00,103654,Rao; Bhaskar D.,0,0,0,0
1668040090320,ECE 257B,A00,103655,Bharadia; Dinesh,0,0,0,0
1668040090778,ECE 258A,A00,103656,Milstein; Laurence B.,0,0,0,0
1668040091215,ECE 260B,A00,103658,Kang; Mingu,0,0,0,0
1668040091759,ECE 264A,A00,103659,Galton; Ian A,0,0,0,0
1668040092200,ECE 265A,A00,103661,Gudem; Prasad S.S.,0,0,0,0
1668040092624,ECE 265D,A00,103662,Gudem; Prasad S.S.,0,0,0,0
1668040093056,ECE 268,A00,103663,Koushanfar; Farinaz,0,0,0,0
1668040093493,ECE 269,A01,103665,Pal; Piya,0,0,0,0
1668040093918,ECE 271B,A00,103666,Vasconcelos; Manuela,0,0,0,0
1668040094345,ECE 276A,A00,103667,Atanasov; Nikolay A.,0,0,0,0
1668040094772,ECE 277,A00,103668,An; Cheolhong,0,0,0,0
1668040095209,ECE 279,A00,117947,Hall; Drew A.,0,0,0,0
1668040096076,ECE 283,A00,103670,Hsueh; Tzu-Chien,0,0,0,0
1668040096515,ECE 284,A00,103671,Turakhia; Yatish Girish,0,0,0,0
1668040096939,ECE 285,A00,103672,Zheng; Yang,0,0,0,0
1668040096939,ECE 285,B00,103673,Sworder; David D.,0,0,0,0
1668040097366,ECE 287,A00,103676,Javidi; Tara,0,0,0,0
1668040097794,MATH 200B,A00,098023,Salehi Golsefidy; Alireza,13,0,15,2
1668040098219,MATH 202B,A00,098024,Rhoades; Brendon Patrick,9,0,15,6
1668040098642,MATH 203B,A00,098025,Oprea; Dragos N.,11,0,15,4
1668040099064,MATH 204B,A00,098026,Sorensen; Claus M,13,0,15,2
1668040099494,MATH 208,A00,098027,Izadi; Elham,7,0,10,3
1668040099920,MATH 209,A00,098028,Pollack; Aaron,10,0,10,0
1668040100351,MATH 211A,A00,112919,Rogalski; Daniel,9,0,10,1
1668040100773,MATH 211B,A00,112920,Seward; Brandon M.,9,0,10,1
1668040101211,MATH 218,A00,098029,Li; Bo,10,0,10,0
1668040101647,MATH 220B,A00,098030,Novak; Jonathan I,13,0,15,2
1668040102086,MATH 221A,A00,098031,Ebenfelt; Peter F,13,0,15,2
1668040102523,MATH 231B,A00,098032,Zlatos; Andrej,12,0,15,3
1668040102949,MATH 240B,A00,098033,Ni; Lei,9,0,15,6
1668040103374,MATH 243,A00,098034,Jekel; David Andrew,10,0,10,0
1668040103809,MATH 245A,A00,098035,Nie; Jiawang,0,0,15,16
1668040104237,MATH 248,A00,098036,Bejenaru; Ioan,10,0,10,0
1668040104662,MATH 250B,A00,098037,Spolaor; Luca,14,0,15,1
1668040105107,MATH 258,A00,098038,Ni; Lei,10,0,10,0
1668040105537,MATH 264B,A00,098041,Rhoades; Brendon Patrick,10,0,15,5
1668040105961,MATH 268,A00,098042,Buss; Samuel R,10,0,10,0
1668040106395,MATH 269,A00,098043,Rhoades; Brendon Patrick,10,0,10,0
1668040106823,MATH 270B,A00,098044,Li; Bo,11,0,15,4
1668040107252,MATH 272B,A00,098045,Holst; Michael J,13,0,15,2
1668040107681,MATH 273A,A00,098046,Tian; Xiaochuan,10,0,15,5
1668040108110,MATH 275,A01,098048,Tian; Xiaochuan,6,0,10,4
1668040108540,MATH 278A,A00,098049,Holst; Michael J,8,0,10,2
1668040108974,MATH 278B,A00,098050,Cloninger; Alexander,10,0,10,0
1668040109408,MATH 278C,A00,098051,Nie; Jiawang,7,0,10,3
1668040109832,MATH 280B,A00,098052,Zheng; Tianyi,11,0,15,4
1668040110269,MATH 281B,A00,098053,Bradic; Jelena,3,0,15,12
1668040110695,MATH 282B,A00,098054,Arias-Castro; Ery,0,0,15,15
1668040111132,MATH 285,A00,098055,Fitzsimmons; Patrick J,0,0,15,17
1668040111555,MATH 287B,A00,098056,Arias-Castro; Ery,3,0,15,12
1668040111983,MATH 288,A00,098057,Agarwal; Pooja,9,0,10,1
1668040111983,MATH 288,B00,098058,Zhang; Danna,8,0,10,2
1668040111983,MATH 288,C00,098059,Williams; Ruth J,10,0,10,0
1668040112419,MATH 290B,A00,098060,Roberts; Justin Deritter,13,0,15,2
1668040112847,MATH 292,A00,098061,Belmont; Eva Kinoshita,10,0,10,0
1668040113272,MATH 295,A00,098062,Suk; Andrew Hoon,48,0,50,2
1668040113696,MATH 296,A00,098063,Novak; Jonathan I,20,0,20,0
1668040114121,MATH 297,001,098064,Gamst; Anthony Collins,9997,0,9999,2
1668040621896,COGS 205,A00,101395,Chiba; Andrea,19,0,20,1
1668040622326,COGS 210B,001,101404,Greene; Deanna Jacquelyn,9998,0,9999,1
1668040622326,COGS 210B,002,101417,Xia; Haijun,9999,0,9999,0
1668040622326,COGS 210B,003,101422,Nitz; Douglas A.,9999,0,9999,0
1668040622326,COGS 210B,004,101423,Hollan; James D.,9998,0,9999,1
1668040622326,COGS 210B,005,101424,Deak; Gedeon O.,9998,0,9999,1
1668040622326,COGS 210B,006,101425,Rossano; Federico,9999,0,9999,0
1668040622754,COGS 211B,A00,101427,Coulson; Seana M,9996,0,9999,3
1668040623182,COGS 220,A00,101428,Hollan; James D.,0,0,25,25
1668040623609,COGS 229,A00,101429,Dow; Steven P,18,0,25,7
1668040624032,COGS 230,A00,101430,Klemmer; Scott R,13,0,17,4
1668040624460,COGS 234,A00,101431,Xia; Haijun,4,0,25,21
1668040624883,COGS 260,A00,101432,Kiyonaga; Anastasia,19,0,25,6
1668040624883,COGS 260,B00,101433,Kirsh; David Joel,16,0,25,9
1668040625309,CSE 202,A00,102371,Impagliazzo; Russell,0,0,0,0
1668040625737,CSE 203B,A01,102373,Cheng; Chung Kuan,0,0,0,0
1668040626166,CSE 208,A00,102374,Micciancio; Daniele,0,0,0,0
1668040626589,CSE 209A,A00,112895,Impagliazzo; Russell,0,0,15,15
1668040627020,CSE 209B,A00,108005,Bellare; Mihir,0,0,0,0
1668040627443,CSE 210,A00,113163,Coblenz; Michael J,0,0,0,0
1668040627875,CSE 219,A00,106111,Dow; Steven P,0,0,20,20
1668040628307,CSE 221,A00,102376,Voelker; Geoffrey M.,0,0,0,0
1668040628735,CSE 224,A01,102378,Porter; George M,0,0,0,0
1668040629179,CSE 229A,A00,102379,Savage; Stefan,0,0,0,0
1668040629609,CSE 229C,A00,102380,Munyaka; Imani N. S.,0,0,0,0
1668040630034,CSE 232B,A00,102382,Deutsch; Alin Bernard,0,0,0,0
1668040630462,CSE 234,A01,112904,Kumar; Arun Kumar,0,0,0,0
1668040630895,CSE 237A,A00,102383,Rosing; Tajana Simunic,0,0,0,0
1668040631333,CSE 239A,A00,102384,Deutsch; Alin Bernard,0,0,0,0
1668040631766,CSE 239B,A00,102385,Polikarpova; Nadezhda,0,0,0,0
1668040632189,CSE 240A,A00,102386,Pannuto; Patrick William,0,0,0,0
1668040632624,CSE 240B,A00,102387,Zhao; Jishen,0,0,0,0
1668040633048,CSE 241A,A00,106406,Kang; Mingu,0,0,0,0
1668040633471,CSE 249B,A00,102388,Kahng; Andrew Byun,0,0,8,8
1668040633904,CSE 251B,A01,102392,Cottrell; Garrison W,0,0,0,0
1668040633904,CSE 251B,A02,102393,Cottrell; Garrison W,0,0,0,0
1668040634343,CSE 252B,A00,102394,Ochoa; Benjamin Lawrence,0,0,0,0
1668040634765,CSE 257,A01,102396,Gao; Sicun,0,0,0,0
1668040635189,CSE 272,A00,102397,Li; Tzumao,0,0,0,0
1668040635612,CSE 274,A00,111323,Chern; Albert Ren-Haur,0,0,0,0
1668040636038,CSE 282,A00,102398,Pevzner; Pavel Arkadjevich,0,0,0,0
1668040636461,CSE 284,A00,114175,Gymrek; Melissa Ann,0,0,0,0
1668040636886,CSE 290,A00,102399,Chandraker; Manmohan Krishna,0,0,0,0
1668040636886,CSE 290,B00,102400,Vaccaro; Kristen Marie,0,0,25,25
1668040636886,CSE 290,C00,102414,Pannuto; Patrick William,0,0,25,25
1668040636886,CSE 290,D00,102427,Pevzner; Pavel Arkadjevich,0,0,0,0
1668040636886,CSE 290,E00,102429,Zhao; Jishen,0,0,0,0
1668040636886,CSE 290,F00,102436,Tullsen; Dean Michael,0,0,0,0
1668040636886,CSE 290,G00,102440,Christensen; Henrik I,0,0,20,20
1668040637318,CSE 291,A00,102443,Su; Hao,0,0,0,0
1668040637318,CSE 291,B00,102448,Polikarpova; Nadezhda,0,0,0,0
1668040637318,CSE 291,C00,102453,Vaccaro; Kristen Marie,0,0,0,0
1668040637318,CSE 291,D00,111343,Savage; Stefan,0,0,0,0
1668040637318,CSE 291,E00,116474,Claffy; Kimberly Claire,0,0,0,0
1668040637318,CSE 291,F00,116479,Pasquale; Joseph,0,0,0,0
1668040637751,CSE 293,001,119111,Bafna; Vineet,9999,0,9999,0
1668040637751,CSE 293,002,119118,Bellare; Mihir,9999,0,9999,0
1668040637751,CSE 293,003,119122,Berg-Kirkpatrick; Taylor D,9999,0,9999,0
1668040637751,CSE 293,004,119135,Christensen; Henrik I,9999,0,9999,0
1668040637751,CSE 293,005,119142,Cottrell; Garrison W,9999,0,9999,0
1668040637751,CSE 293,006,119146,Deutsch; Alin Bernard,9999,0,9999,0
1668040637751,CSE 293,007,119159,Esmaeilzadeh; Hadi,9999,0,9999,0
1668040637751,CSE 293,008,119166,Freund; Yoav,9999,0,9999,0
1668040637751,CSE 293,009,119170,Griswold; William G.,9999,0,9999,0
1668040637751,CSE 293,010,119183,Gymrek; Melissa Ann,9999,0,9999,0
1668040637751,CSE 293,011,119190,Heninger; Nadia A,9999,0,9999,0
1668040637751,CSE 293,012,119230,Impagliazzo; Russell,9999,0,9999,0
1668040637751,CSE 293,013,119232,Jhala; Ranjit,9999,0,9999,0
1668040637751,CSE 293,014,119233,Kahng; Andrew Byun,9999,0,9999,0
1668040637751,CSE 293,015,119298,Kane; Daniel Mertz,9999,0,9999,0
1668040637751,CSE 293,016,119299,Kriegman; David J,9999,0,9999,0
1668040637751,CSE 293,017,119300,Kumar; Arun Kumar,9999,0,9999,0
1668040637751,CSE 293,018,119301,Lerner; Sorin,9999,0,9999,0
1668040637751,CSE 293,019,119302,Lovett; Shachar,9999,0,9999,0
1668040637751,CSE 293,020,119303,McAuley; Julian John,9999,0,9999,0
1668040637751,CSE 293,021,119304,Micciancio; Daniele,9999,0,9999,0
1668040637751,CSE 293,022,119367,Orailoglu; Alex,9999,0,9999,0
1668040637751,CSE 293,023,119382,Paturi; Ramamohan,9999,0,9999,0
1668040637751,CSE 293,024,119404,Polikarpova; Nadezhda,9999,0,9999,0
1668040637751,CSE 293,025,119406,Politz; Joseph Gibbs,9999,0,9999,0
1668040637751,CSE 293,026,119411,Porter; George M,9999,0,9999,0
1668040637751,CSE 293,027,119414,Porter; Leonard Emerson,9999,0,9999,0
1668040637751,CSE 293,028,119416,Ramamoorthi; Ravi,9999,0,9999,0
1668040637751,CSE 293,029,119417,Sahoo; Debashis,9999,0,9999,0
1668040637751,CSE 293,030,119420,Saul; Lawrence,9999,0,9999,0
1668040637751,CSE 293,031,119421,Savage; Stefan,9999,0,9999,0
1668040637751,CSE 293,032,119425,Schulze; Jurgen P.,9999,0,9999,0
1668040637751,CSE 293,033,119426,Snoeren; Alex C.,9999,0,9999,0
1668040637751,CSE 293,034,119428,Shang; Jingbo,9999,0,9999,0
1668040637751,CSE 293,035,119430,Stefan; Deian,9999,0,9999,0
1668040637751,CSE 293,036,119431,Su; Hao,9999,0,9999,0
1668040637751,CSE 293,037,119433,Swanson; Steven James,9999,0,9999,0
1668040637751,CSE 293,038,119435,Tullsen; Dean Michael,9999,0,9999,0
1668040637751,CSE 293,039,119483,Voelker; Geoffrey M.,9999,0,9999,0
1668040637751,CSE 293,040,119537,Zhao; Jishen,9999,0,9999,0
1668040637751,CSE 293,041,119538,Zhou; Yuan-Yuan,9999,0,9999,0
1668040637751,CSE 293,042,119539,Gao; Sicun,9999,0,9999,0
1668040637751,CSE 293,043,119540,Weibel; Nadir,9999,0,9999,0
1668040637751,CSE 293,044,119541,Gupta; Rajesh K.,9999,0,9999,0
1668040637751,CSE 293,045,126410,Vaccaro; Kristen Marie,9999,0,9999,0
1668040637751,CSE 293,046,126411,Klemke; Richard,9999,0,9999,0
1668040638191,CSE 294,A00,102459,Voelker; Geoffrey M.,0,0,0,0
1668040638191,CSE 294,B00,111322,Orailoglu; Alex,0,0,0,0
1668040638622,DSE 201,A00,096914,Deutsch; Alin Bernard,30,0,30,0
1668040639049,DSE 210,A00,096915,Dasgupta; Sanjoy,30,0,30,0
1668040639471,DSE 260A,A00,096916,Altintas De Callaf; Ilkay,30,0,30,0
1668040639905,ECE 200,001,103586,Antipa; Nicholas A,9999,0,9999,0
1668040639905,ECE 200,002,103587,Atanasov; Nikolay A.,9999,0,9999,0
1668040639905,ECE 200,003,103588,Bharadia; Dinesh,9999,0,9999,0
1668040639905,ECE 200,004,103589,Cheng; Chung Kuan,9999,0,9999,0
1668040639905,ECE 200,005,103590,Cosman; Pamela C.,9999,0,9999,0
1668040639905,ECE 200,006,103591,Dayeh; Shadi Ahmad,9999,0,9999,0
1668040639905,ECE 200,007,103592,Fainman; Yeshaiahu,9999,0,9999,0
1668040639905,ECE 200,008,103593,Ford; Joseph Earl,9999,0,9999,0
1668040639905,ECE 200,009,103594,Franceschetti; Massimo,9999,0,9999,0
1668040639905,ECE 200,010,103595,Fullerton; Eric E,9999,0,9999,0
1668040639905,ECE 200,011,103596,Galton; Ian A,9999,0,9999,0
1668040639905,ECE 200,012,103597,Gilja; Vikash,9999,0,9999,0
1668040639905,ECE 200,013,103598,Hall; Drew A.,9999,0,9999,0
1668040639905,ECE 200,014,103599,Hsueh; Tzu-Chien,9999,0,9999,0
1668040639905,ECE 200,015,103600,Javidi; Tara,9999,0,9999,0
1668040639905,ECE 200,016,103601,Kahng; Andrew Byun,9999,0,9999,0
1668040639905,ECE 200,017,103602,Kim; Young-Han,9999,0,9999,0
1668040639905,ECE 200,018,103603,Koushanfar; Farinaz,9999,0,9999,0
1668040639905,ECE 200,019,103604,Kuzum; Duygu,9999,0,9999,0
1668040639905,ECE 200,020,103605,Le; Hanh-Phuc,9999,0,9999,0
1668040639905,ECE 200,021,103606,Lin; Bill,9999,0,9999,0
1668040639905,ECE 200,022,103607,Liu; Zhaowei,9998,0,9999,1
1668040639905,ECE 200,023,103608,Lo; Yu-Hwa,9999,0,9999,0
1668040639905,ECE 200,024,103609,Lomakin; Vitaliy,9999,0,9999,0
1668040639905,ECE 200,025,103610,Mercier; Patrick Philip,9999,0,9999,0
1668040639905,ECE 200,026,103611,Meyer; Florian,9999,0,9999,0
1668040639905,ECE 200,027,103612,Milstein; Laurence B.,9999,0,9999,0
1668040639905,ECE 200,028,103613,Mir Arabbaygi; Siavash,9999,0,9999,0
1668040639905,ECE 200,029,103614,Mookherjea; Shayan,9999,0,9999,0
1668040639905,ECE 200,030,103615,Morris; Karcher William,9999,0,9999,0
1668040639905,ECE 200,031,103616,Ng; Tse Nga,9999,0,9999,0
1668040639905,ECE 200,032,103617,Nguyen; Truong Quang,9999,0,9999,0
1668040639905,ECE 200,033,103618,Nomura; Kenji,9999,0,9999,0
1668040639905,ECE 200,034,103619,Orlitsky; Alon,9999,0,9999,0
1668040639905,ECE 200,035,103620,Pal; Piya,9999,0,9999,0
1668040639905,ECE 200,036,103621,Papen; George C.,9999,0,9999,0
1668040639905,ECE 200,037,103622,Radic; Stojan,9999,0,9999,0
1668040639905,ECE 200,038,103623,Rao; Bhaskar D.,9999,0,9999,0
1668040639905,ECE 200,039,103624,Rao; Ramesh R,9999,0,9999,0
1668040639905,ECE 200,040,103625,Rebeiz; Gabriel,9999,0,9999,0
1668040639905,ECE 200,041,103626,Sanford; John R,9999,0,9999,0
1668040639905,ECE 200,042,103627,Siegel; Paul H.,9999,0,9999,0
1668040639905,ECE 200,043,103628,Sievenpiper; Daniel F.,9999,0,9999,0
1668040639905,ECE 200,044,103629,Sworder; David D.,9999,0,9999,0
1668040639905,ECE 200,045,103630,Taur; Yuan,9999,0,9999,0
1668040639905,ECE 200,046,103631,Touri; Behrouz,9999,0,9999,0
1668040639905,ECE 200,047,103632,Trivedi; Mohan M.,9999,0,9999,0
1668040639905,ECE 200,048,103633,Vasconcelos; Nuno,9999,0,9999,0
1668040639905,ECE 200,049,103634,Wang; Xiaolong,9999,0,9999,0
1668040639905,ECE 200,050,103635,Xie; Pengtao,9999,0,9999,0
1668040639905,ECE 200,051,103636,Yip; Michael,9999,0,9999,0
1668040639905,ECE 200,052,103637,Zeger; Kenneth A.,999,0,999,0
1668040639905,ECE 200,053,103638,Zhang; Xinyu,9999,0,9999,0
1668040639905,ECE 200,054,103639,Turakhia; Yatish Girish,9999,0,9999,0
1668040639905,ECE 200,055,103640,Kang; Mingu,9999,0,9999,0
1668040639905,ECE 200,056,103641,Shi; Yuanyuan,9999,0,9999,0
1668040639905,ECE 200,057,103642,Wang; Edward Jay,9999,0,9999,0
1668040639905,ECE 200,058,103643,Zheng; Yang,9999,0,9999,0
1668040640335,ECE 202,A00,103644,Kuzum; Duygu,0,0,0,0
1668040640757,ECE 212BN,A00,103646,Ng; Tse Nga,0,0,0,0
1668040641184,ECE 221,A00,111493,Staff,0,0,0,0
1668040641611,ECE 222B,A00,103647,Lomakin; Vitaliy,0,0,0,0
1668040642035,ECE 230B,A00,103648,Taur; Yuan,0,0,0,0
1668040642461,ECE 238B,A00,103649,Garay; Javier,0,0,0,0
1668040642887,ECE 240B,A00,112900,Fainman; Yeshaiahu,0,0,0,0
1668040643311,ECE 247A,A00,103650,Jokerst; Jesse Vincent,0,0,0,0
1668040643741,ECE 247B,A00,103651,Wang; Joseph,0,0,0,0
1668040644173,ECE 250,A00,103652,Siegel; Paul H.,0,0,0,0
1668040644595,ECE 251A,A00,103654,Rao; Bhaskar D.,0,0,0,0
1668040645028,ECE 257B,A00,103655,Bharadia; Dinesh,0,0,0,0
1668040645451,ECE 258A,A00,103656,Milstein; Laurence B.,0,0,0,0
1668040645886,ECE 260B,A00,103658,Kang; Mingu,0,0,0,0
1668040646314,ECE 264A,A00,103659,Galton; Ian A,0,0,0,0
1668040646741,ECE 265A,A00,103661,Gudem; Prasad S.S.,0,0,0,0
1668040647172,ECE 265D,A00,103662,Gudem; Prasad S.S.,0,0,0,0
1668040647598,ECE 268,A00,103663,Koushanfar; Farinaz,0,0,0,0
1668040648035,ECE 269,A01,103665,Pal; Piya,0,0,0,0
1668040648481,ECE 271B,A00,103666,Vasconcelos; Manuela,0,0,0,0
1668040648913,ECE 276A,A00,103667,Atanasov; Nikolay A.,0,0,0,0
1668040649347,ECE 277,A00,103668,An; Cheolhong,0,0,0,0
1668040649927,ECE 279,A00,117947,Hall; Drew A.,0,0,0,0
1668040650795,ECE 283,A00,103670,Hsueh; Tzu-Chien,0,0,0,0
1668040651231,ECE 284,A00,103671,Turakhia; Yatish Girish,0,0,0,0
1668040651658,ECE 285,A00,103672,Zheng; Yang,0,0,0,0
1668040651658,ECE 285,B00,103673,Sworder; David D.,0,0,0,0
1668040652080,ECE 287,A00,103676,Javidi; Tara,0,0,0,0
1668040652507,MATH 200B,A00,098023,Salehi Golsefidy; Alireza,13,0,15,2
1668040652937,MATH 202B,A00,098024,Rhoades; Brendon Patrick,9,0,15,6
1668040653366,MATH 203B,A00,098025,Oprea; Dragos N.,11,0,15,4
1668040653787,MATH 204B,A00,098026,Sorensen; Claus M,13,0,15,2
1668040654220,MATH 208,A00,098027,Izadi; Elham,7,0,10,3
1668040654645,MATH 209,A00,098028,Pollack; Aaron,10,0,10,0
1668040655069,MATH 211A,A00,112919,Rogalski; Daniel,9,0,10,1
1668040655492,MATH 211B,A00,112920,Seward; Brandon M.,9,0,10,1
1668040655917,MATH 218,A00,098029,Li; Bo,10,0,10,0
1668040656341,MATH 220B,A00,098030,Novak; Jonathan I,13,0,15,2
1668040656764,MATH 221A,A00,098031,Ebenfelt; Peter F,13,0,15,2
1668040657190,MATH 231B,A00,098032,Zlatos; Andrej,12,0,15,3
1668040657627,MATH 240B,A00,098033,Ni; Lei,9,0,15,6
1668040658050,MATH 243,A00,098034,Jekel; David Andrew,10,0,10,0
1668040658479,MATH 245A,A00,098035,Nie; Jiawang,0,0,15,16
1668040658904,MATH 248,A00,098036,Bejenaru; Ioan,10,0,10,0
1668040659329,MATH 250B,A00,098037,Spolaor; Luca,14,0,15,1
1668040659752,MATH 258,A00,098038,Ni; Lei,10,0,10,0
1668040660178,MATH 264B,A00,098041,Rhoades; Brendon Patrick,10,0,15,5
1668040660603,MATH 268,A00,098042,Buss; Samuel R,10,0,10,0
1668040661028,MATH 269,A00,098043,Rhoades; Brendon Patrick,10,0,10,0
1668040661459,MATH 270B,A00,098044,Li; Bo,11,0,15,4
1668040661886,MATH 272B,A00,098045,Holst; Michael J,13,0,15,2
1668040662325,MATH 273A,A00,098046,Tian; Xiaochuan,10,0,15,5
1668040662751,MATH 275,A01,098048,Tian; Xiaochuan,6,0,10,4
1668040663282,MATH 278A,A00,098049,Holst; Michael J,8,0,10,2
1668040663714,MATH 278B,A00,098050,Cloninger; Alexander,10,0,10,0
1668040664147,MATH 278C,A00,098051,Nie; Jiawang,7,0,10,3
1668040664570,MATH 280B,A00,098052,Zheng; Tianyi,11,0,15,4
1668040665002,MATH 281B,A00,098053,Bradic; Jelena,3,0,15,12
1668040665424,MATH 282B,A00,098054,Arias-Castro; Ery,0,0,15,15
1668040665846,MATH 285,A00,098055,Fitzsimmons; Patrick J,0,0,15,17
1668040666268,MATH 287B,A00,098056,Arias-Castro; Ery,3,0,15,12
1668040666704,MATH 288,A00,098057,Agarwal; Pooja,9,0,10,1
1668040666704,MATH 288,B00,098058,Zhang; Danna,8,0,10,2
1668040666704,MATH 288,C00,098059,Williams; Ruth J,10,0,10,0
1668040667131,MATH 290B,A00,098060,Roberts; Justin Deritter,13,0,15,2
1668040667567,MATH 292,A00,098061,Belmont; Eva Kinoshita,10,0,10,0
1668040668001,MATH 295,A00,098062,Suk; Andrew Hoon,48,0,50,2
1668040668433,MATH 296,A00,098063,Novak; Jonathan I,20,0,20,0
1668040668869,MATH 297,001,098064,Gamst; Anthony Collins,9997,0,9999,2
1668041185232,COGS 205,A00,101395,Chiba; Andrea,19,0,20,1
1668041185681,COGS 210B,001,101404,Greene; Deanna Jacquelyn,9998,0,9999,1
1668041185681,COGS 210B,002,101417,Xia; Haijun,9999,0,9999,0
1668041185681,COGS 210B,003,101422,Nitz; Douglas A.,9999,0,9999,0
1668041185681,COGS 210B,004,101423,Hollan; James D.,9998,0,9999,1
1668041185681,COGS 210B,005,101424,Deak; Gedeon O.,9998,0,9999,1
1668041185681,COGS 210B,006,101425,Rossano; Federico,9999,0,9999,0
1668041186108,COGS 211B,A00,101427,Coulson; Seana M,9996,0,9999,3
1668041186531,COGS 220,A00,101428,Hollan; James D.,0,0,25,25
1668041186969,COGS 229,A00,101429,Dow; Steven P,18,0,25,7
1668041187404,COGS 230,A00,101430,Klemmer; Scott R,13,0,17,4
1668041187827,COGS 234,A00,101431,Xia; Haijun,4,0,25,21
1668041188252,COGS 260,A00,101432,Kiyonaga; Anastasia,19,0,25,6
1668041188252,COGS 260,B00,101433,Kirsh; David Joel,16,0,25,9
1668041188681,CSE 202,A00,102371,Impagliazzo; Russell,0,0,0,0
1668041189106,CSE 203B,A01,102373,Cheng; Chung Kuan,0,0,0,0
1668041189538,CSE 208,A00,102374,Micciancio; Daniele,0,0,0,0
1668041189962,CSE 209A,A00,112895,Impagliazzo; Russell,0,0,15,15
1668041190387,CSE 209B,A00,108005,Bellare; Mihir,0,0,0,0
1668041190812,CSE 210,A00,113163,Coblenz; Michael J,0,0,0,0
1668041191236,CSE 219,A00,106111,Dow; Steven P,0,0,20,20
1668041191670,CSE 221,A00,102376,Voelker; Geoffrey M.,0,0,0,0
1668041192094,CSE 224,A01,102378,Porter; George M,0,0,0,0
1668041192525,CSE 229A,A00,102379,Savage; Stefan,0,0,0,0
1668041192954,CSE 229C,A00,102380,Munyaka; Imani N. S.,0,0,0,0
1668041193391,CSE 232B,A00,102382,Deutsch; Alin Bernard,0,0,0,0
1668041193816,CSE 234,A01,112904,Kumar; Arun Kumar,0,0,0,0
1668041194245,CSE 237A,A00,102383,Rosing; Tajana Simunic,0,0,0,0
1668041194684,CSE 239A,A00,102384,Deutsch; Alin Bernard,0,0,0,0
1668041195110,CSE 239B,A00,102385,Polikarpova; Nadezhda,0,0,0,0
1668041195534,CSE 240A,A00,102386,Pannuto; Patrick William,0,0,0,0
1668041195960,CSE 240B,A00,102387,Zhao; Jishen,0,0,0,0
1668041196389,CSE 241A,A00,106406,Kang; Mingu,0,0,0,0
1668041196820,CSE 249B,A00,102388,Kahng; Andrew Byun,0,0,8,8
1668041197243,CSE 251B,A01,102392,Cottrell; Garrison W,0,0,0,0
1668041197243,CSE 251B,A02,102393,Cottrell; Garrison W,0,0,0,0
1668041197668,CSE 252B,A00,102394,Ochoa; Benjamin Lawrence,0,0,0,0
1668041198091,CSE 257,A01,102396,Gao; Sicun,0,0,0,0
1668041198516,CSE 272,A00,102397,Li; Tzumao,0,0,0,0
1668041198950,CSE 274,A00,111323,Chern; Albert Ren-Haur,0,0,0,0
1668041199375,CSE 282,A00,102398,Pevzner; Pavel Arkadjevich,0,0,0,0
1668041199887,CSE 284,A00,114175,Gymrek; Melissa Ann,0,0,0,0
1668041200317,CSE 290,A00,102399,Chandraker; Manmohan Krishna,0,0,0,0
1668041200317,CSE 290,B00,102400,Vaccaro; Kristen Marie,0,0,25,25
1668041200317,CSE 290,C00,102414,Pannuto; Patrick William,0,0,25,25
1668041200317,CSE 290,D00,102427,Pevzner; Pavel Arkadjevich,0,0,0,0
1668041200317,CSE 290,E00,102429,Zhao; Jishen,0,0,0,0
1668041200317,CSE 290,F00,102436,Tullsen; Dean Michael,0,0,0,0
1668041200317,CSE 290,G00,102440,Christensen; Henrik I,0,0,20,20
1668041200746,CSE 291,A00,102443,Su; Hao,0,0,0,0
1668041200746,CSE 291,B00,102448,Polikarpova; Nadezhda,0,0,0,0
1668041200746,CSE 291,C00,102453,Vaccaro; Kristen Marie,0,0,0,0
1668041200746,CSE 291,D00,111343,Savage; Stefan,0,0,0,0
1668041200746,CSE 291,E00,116474,Claffy; Kimberly Claire,0,0,0,0
1668041200746,CSE 291,F00,116479,Pasquale; Joseph,0,0,0,0
1668041201225,CSE 293,001,119111,Bafna; Vineet,9999,0,9999,0
1668041201225,CSE 293,002,119118,Bellare; Mihir,9999,0,9999,0
1668041201225,CSE 293,003,119122,Berg-Kirkpatrick; Taylor D,9999,0,9999,0
1668041201225,CSE 293,004,119135,Christensen; Henrik I,9999,0,9999,0
1668041201225,CSE 293,005,119142,Cottrell; Garrison W,9999,0,9999,0
1668041201225,CSE 293,006,119146,Deutsch; Alin Bernard,9999,0,9999,0
1668041201225,CSE 293,007,119159,Esmaeilzadeh; Hadi,9999,0,9999,0
1668041201225,CSE 293,008,119166,Freund; Yoav,9999,0,9999,0
1668041201225,CSE 293,009,119170,Griswold; William G.,9999,0,9999,0
1668041201225,CSE 293,010,119183,Gymrek; Melissa Ann,9999,0,9999,0
1668041201225,CSE 293,011,119190,Heninger; Nadia A,9999,0,9999,0
1668041201225,CSE 293,012,119230,Impagliazzo; Russell,9999,0,9999,0
1668041201225,CSE 293,013,119232,Jhala; Ranjit,9999,0,9999,0
1668041201225,CSE 293,014,119233,Kahng; Andrew Byun,9999,0,9999,0
1668041201225,CSE 293,015,119298,Kane; Daniel Mertz,9999,0,9999,0
1668041201225,CSE 293,016,119299,Kriegman; David J,9999,0,9999,0
1668041201225,CSE 293,017,119300,Kumar; Arun Kumar,9999,0,9999,0
1668041201225,CSE 293,018,119301,Lerner; Sorin,9999,0,9999,0
1668041201225,CSE 293,019,119302,Lovett; Shachar,9999,0,9999,0
1668041201225,CSE 293,020,119303,McAuley; Julian John,9999,0,9999,0
1668041201225,CSE 293,021,119304,Micciancio; Daniele,9999,0,9999,0
1668041201225,CSE 293,022,119367,Orailoglu; Alex,9999,0,9999,0
1668041201225,CSE 293,023,119382,Paturi; Ramamohan,9999,0,9999,0
1668041201225,CSE 293,024,119404,Polikarpova; Nadezhda,9999,0,9999,0
1668041201225,CSE 293,025,119406,Politz; Joseph Gibbs,9999,0,9999,0
1668041201225,CSE 293,026,119411,Porter; George M,9999,0,9999,0
1668041201225,CSE 293,027,119414,Porter; Leonard Emerson,9999,0,9999,0
1668041201225,CSE 293,028,119416,Ramamoorthi; Ravi,9999,0,9999,0
1668041201225,CSE 293,029,119417,Sahoo; Debashis,9999,0,9999,0
1668041201225,CSE 293,030,119420,Saul; Lawrence,9999,0,9999,0
1668041201225,CSE 293,031,119421,Savage; Stefan,9999,0,9999,0
1668041201225,CSE 293,032,119425,Schulze; Jurgen P.,9999,0,9999,0
1668041201225,CSE 293,033,119426,Snoeren; Alex C.,9999,0,9999,0
1668041201225,CSE 293,034,119428,Shang; Jingbo,9999,0,9999,0
1668041201225,CSE 293,035,119430,Stefan; Deian,9999,0,9999,0
1668041201225,CSE 293,036,119431,Su; Hao,9999,0,9999,0
1668041201225,CSE 293,037,119433,Swanson; Steven James,9999,0,9999,0
1668041201225,CSE 293,038,119435,Tullsen; Dean Michael,9999,0,9999,0
1668041201225,CSE 293,039,119483,Voelker; Geoffrey M.,9999,0,9999,0
1668041201225,CSE 293,040,119537,Zhao; Jishen,9999,0,9999,0
1668041201225,CSE 293,041,119538,Zhou; Yuan-Yuan,9999,0,9999,0
1668041201225,CSE 293,042,119539,Gao; Sicun,9999,0,9999,0
1668041201225,CSE 293,043,119540,Weibel; Nadir,9999,0,9999,0
1668041201225,CSE 293,044,119541,Gupta; Rajesh K.,9999,0,9999,0
1668041201225,CSE 293,045,126410,Vaccaro; Kristen Marie,9999,0,9999,0
1668041201225,CSE 293,046,126411,Klemke; Richard,9999,0,9999,0
1668041201648,CSE 294,A00,102459,Voelker; Geoffrey M.,0,0,0,0
1668041201648,CSE 294,B00,111322,Orailoglu; Alex,0,0,0,0
1668041202081,DSE 201,A00,096914,Deutsch; Alin Bernard,30,0,30,0
1668041202520,DSE 210,A00,096915,Dasgupta; Sanjoy,30,0,30,0
1668041202943,DSE 260A,A00,096916,Altintas De Callaf; Ilkay,30,0,30,0
1668041203380,ECE 200,001,103586,Antipa; Nicholas A,9999,0,9999,0
1668041203380,ECE 200,002,103587,Atanasov; Nikolay A.,9999,0,9999,0
1668041203380,ECE 200,003,103588,Bharadia; Dinesh,9999,0,9999,0
1668041203380,ECE 200,004,103589,Cheng; Chung Kuan,9999,0,9999,0
1668041203380,ECE 200,005,103590,Cosman; Pamela C.,9999,0,9999,0
1668041203380,ECE 200,006,103591,Dayeh; Shadi Ahmad,9999,0,9999,0
1668041203380,ECE 200,007,103592,Fainman; Yeshaiahu,9999,0,9999,0
1668041203380,ECE 200,008,103593,Ford; Joseph Earl,9999,0,9999,0
1668041203380,ECE 200,009,103594,Franceschetti; Massimo,9999,0,9999,0
1668041203380,ECE 200,010,103595,Fullerton; Eric E,9999,0,9999,0
1668041203380,ECE 200,011,103596,Galton; Ian A,9999,0,9999,0
1668041203380,ECE 200,012,103597,Gilja; Vikash,9999,0,9999,0
1668041203380,ECE 200,013,103598,Hall; Drew A.,9999,0,9999,0
1668041203380,ECE 200,014,103599,Hsueh; Tzu-Chien,9999,0,9999,0
1668041203380,ECE 200,015,103600,Javidi; Tara,9999,0,9999,0
1668041203380,ECE 200,016,103601,Kahng; Andrew Byun,9999,0,9999,0
1668041203380,ECE 200,017,103602,Kim; Young-Han,9999,0,9999,0
1668041203380,ECE 200,018,103603,Koushanfar; Farinaz,9999,0,9999,0
1668041203380,ECE 200,019,103604,Kuzum; Duygu,9999,0,9999,0
1668041203380,ECE 200,020,103605,Le; Hanh-Phuc,9999,0,9999,0
1668041203380,ECE 200,021,103606,Lin; Bill,9999,0,9999,0
1668041203380,ECE 200,022,103607,Liu; Zhaowei,9998,0,9999,1
1668041203380,ECE 200,023,103608,Lo; Yu-Hwa,9999,0,9999,0
1668041203380,ECE 200,024,103609,Lomakin; Vitaliy,9999,0,9999,0
1668041203380,ECE 200,025,103610,Mercier; Patrick Philip,9999,0,9999,0
1668041203380,ECE 200,026,103611,Meyer; Florian,9999,0,9999,0
1668041203380,ECE 200,027,103612,Milstein; Laurence B.,9999,0,9999,0
1668041203380,ECE 200,028,103613,Mir Arabbaygi; Siavash,9999,0,9999,0
1668041203380,ECE 200,029,103614,Mookherjea; Shayan,9999,0,9999,0
1668041203380,ECE 200,030,103615,Morris; Karcher William,9999,0,9999,0
1668041203380,ECE 200,031,103616,Ng; Tse Nga,9999,0,9999,0
1668041203380,ECE 200,032,103617,Nguyen; Truong Quang,9999,0,9999,0
1668041203380,ECE 200,033,103618,Nomura; Kenji,9999,0,9999,0
1668041203380,ECE 200,034,103619,Orlitsky; Alon,9999,0,9999,0
1668041203380,ECE 200,035,103620,Pal; Piya,9999,0,9999,0
1668041203380,ECE 200,036,103621,Papen; George C.,9999,0,9999,0
1668041203380,ECE 200,037,103622,Radic; Stojan,9999,0,9999,0
1668041203380,ECE 200,038,103623,Rao; Bhaskar D.,9999,0,9999,0
1668041203380,ECE 200,039,103624,Rao; Ramesh R,9999,0,9999,0
1668041203380,ECE 200,040,103625,Rebeiz; Gabriel,9999,0,9999,0
1668041203380,ECE 200,041,103626,Sanford; John R,9999,0,9999,0
1668041203380,ECE 200,042,103627,Siegel; Paul H.,9999,0,9999,0
1668041203380,ECE 200,043,103628,Sievenpiper; Daniel F.,9999,0,9999,0
1668041203380,ECE 200,044,103629,Sworder; David D.,9999,0,9999,0
1668041203380,ECE 200,045,103630,Taur; Yuan,9999,0,9999,0
1668041203380,ECE 200,046,103631,Touri; Behrouz,9999,0,9999,0
1668041203380,ECE 200,047,103632,Trivedi; Mohan M.,9999,0,9999,0
1668041203380,ECE 200,048,103633,Vasconcelos; Nuno,9999,0,9999,0
1668041203380,ECE 200,049,103634,Wang; Xiaolong,9999,0,9999,0
1668041203380,ECE 200,050,103635,Xie; Pengtao,9999,0,9999,0
1668041203380,ECE 200,051,103636,Yip; Michael,9999,0,9999,0
1668041203380,ECE 200,052,103637,Zeger; Kenneth A.,999,0,999,0
1668041203380,ECE 200,053,103638,Zhang; Xinyu,9999,0,9999,0
1668041203380,ECE 200,054,103639,Turakhia; Yatish Girish,9999,0,9999,0
1668041203380,ECE 200,055,103640,Kang; Mingu,9999,0,9999,0
1668041203380,ECE 200,056,103641,Shi; Yuanyuan,9999,0,9999,0
1668041203380,ECE 200,057,103642,Wang; Edward Jay,9999,0,9999,0
1668041203380,ECE 200,058,103643,Zheng; Yang,9999,0,9999,0
1668041203810,ECE 202,A00,103644,Kuzum; Duygu,0,0,0,0
1668041204239,ECE 212BN,A00,103646,Ng; Tse Nga,0,0,0,0
1668041204666,ECE 221,A00,111493,Staff,0,0,0,0
1668041205103,ECE 222B,A00,103647,Lomakin; Vitaliy,0,0,0,0
1668041205545,ECE 230B,A00,103648,Taur; Yuan,0,0,0,0
1668041205969,ECE 238B,A00,103649,Garay; Javier,0,0,0,0
1668041206403,ECE 240B,A00,112900,Fainman; Yeshaiahu,0,0,0,0
1668041206832,ECE 247A,A00,103650,Jokerst; Jesse Vincent,0,0,0,0
1668041207256,ECE 247B,A00,103651,Wang; Joseph,0,0,0,0
1668041207688,ECE 250,A00,103652,Siegel; Paul H.,0,0,0,0
1668041208112,ECE 251A,A00,103654,Rao; Bhaskar D.,0,0,0,0
1668041208536,ECE 257B,A00,103655,Bharadia; Dinesh,0,0,0,0
1668041208963,ECE 258A,A00,103656,Milstein; Laurence B.,0,0,0,0
1668041209395,ECE 260B,A00,103658,Kang; Mingu,0,0,0,0
1668041209826,ECE 264A,A00,103659,Galton; Ian A,0,0,0,0
1668041210254,ECE 265A,A00,103661,Gudem; Prasad S.S.,0,0,0,0
1668041210689,ECE 265D,A00,103662,Gudem; Prasad S.S.,0,0,0,0
1668041211116,ECE 268,A00,103663,Koushanfar; Farinaz,0,0,0,0
1668041211554,ECE 269,A01,103665,Pal; Piya,0,0,0,0
1668041211981,ECE 271B,A00,103666,Vasconcelos; Manuela,0,0,0,0
1668041212403,ECE 276A,A00,103667,Atanasov; Nikolay A.,0,0,0,0
1668041212842,ECE 277,A00,103668,An; Cheolhong,0,0,0,0
1668041213265,ECE 279,A00,117947,Hall; Drew A.,0,0,0,0
1668041214116,ECE 283,A00,103670,Hsueh; Tzu-Chien,0,0,0,0
1668041214554,ECE 284,A00,103671,Turakhia; Yatish Girish,0,0,0,0
1668041214975,ECE 285,A00,103672,Zheng; Yang,0,0,0,0
1668041214975,ECE 285,B00,103673,Sworder; David D.,0,0,0,0
1668041215399,ECE 287,A00,103676,Javidi; Tara,0,0,0,0
1668041215823,MATH 200B,A00,098023,Salehi Golsefidy; Alireza,13,0,15,2
1668041216248,MATH 202B,A00,098024,Rhoades; Brendon Patrick,9,0,15,6
1668041216686,MATH 203B,A00,098025,Oprea; Dragos N.,11,0,15,4
1668041217117,MATH 204B,A00,098026,Sorensen; Claus M,13,0,15,2
1668041217541,MATH 208,A00,098027,Izadi; Elham,7,0,10,3
1668041217963,MATH 209,A00,098028,Pollack; Aaron,10,0,10,0
1668041218387,MATH 211A,A00,112919,Rogalski; Daniel,9,0,10,1
1668041218811,MATH 211B,A00,112920,Seward; Brandon M.,9,0,10,1
1668041219234,MATH 218,A00,098029,Li; Bo,10,0,10,0
1668041219661,MATH 220B,A00,098030,Novak; Jonathan I,13,0,15,2
1668041220098,MATH 221A,A00,098031,Ebenfelt; Peter F,13,0,15,2
1668041220527,MATH 231B,A00,098032,Zlatos; Andrej,12,0,15,3
1668041220962,MATH 240B,A00,098033,Ni; Lei,9,0,15,6
1668041221394,MATH 243,A00,098034,Jekel; David Andrew,10,0,10,0
1668041221824,MATH 245A,A00,098035,Nie; Jiawang,0,0,15,16
1668041222264,MATH 248,A00,098036,Bejenaru; Ioan,10,0,10,0
1668041222702,MATH 250B,A00,098037,Spolaor; Luca,14,0,15,1
1668041223134,MATH 258,A00,098038,Ni; Lei,10,0,10,0
1668041223560,MATH 264B,A00,098041,Rhoades; Brendon Patrick,10,0,15,5
1668041223984,MATH 268,A00,098042,Buss; Samuel R,10,0,10,0
1668041224408,MATH 269,A00,098043,Rhoades; Brendon Patrick,10,0,10,0
1668041224841,MATH 270B,A00,098044,Li; Bo,11,0,15,4
1668041225268,MATH 272B,A00,098045,Holst; Michael J,13,0,15,2
1668041225702,MATH 273A,A00,098046,Tian; Xiaochuan,10,0,15,5
1668041226133,MATH 275,A01,098048,Tian; Xiaochuan,6,0,10,4
1668041226554,MATH 278A,A00,098049,Holst; Michael J,8,0,10,2
1668041226978,MATH 278B,A00,098050,Cloninger; Alexander,10,0,10,0
1668041227401,MATH 278C,A00,098051,Nie; Jiawang,7,0,10,3
1668041227826,MATH 280B,A00,098052,Zheng; Tianyi,11,0,15,4
1668041228248,MATH 281B,A00,098053,Bradic; Jelena,3,0,15,12
1668041228678,MATH 282B,A00,098054,Arias-Castro; Ery,0,0,15,15
1668041229102,MATH 285,A00,098055,Fitzsimmons; Patrick J,0,0,15,17
1668041229526,MATH 287B,A00,098056,Arias-Castro; Ery,3,0,15,12
1668041229950,MATH 288,A00,098057,Agarwal; Pooja,9,0,10,1
1668041229950,MATH 288,B00,098058,Zhang; Danna,8,0,10,2
1668041229950,MATH 288,C00,098059,Williams; Ruth J,10,0,10,0
1668041230375,MATH 290B,A00,098060,Roberts; Justin Deritter,13,0,15,2
1668041230800,MATH 292,A00,098061,Belmont; Eva Kinoshita,10,0,10,0
1668041231226,MATH 295,A00,098062,Suk; Andrew Hoon,48,0,50,2
1668041231649,MATH 296,A00,098063,Novak; Jonathan I,20,0,20,0
1668041232073,MATH 297,001,098064,Gamst; Anthony Collins,9997,0,9999,2
1668041736485,COGS 205,A00,101395,Chiba; Andrea,19,0,20,1
1668041736913,COGS 210B,001,101404,Greene; Deanna Jacquelyn,9998,0,9999,1
1668041736913,COGS 210B,002,101417,Xia; Haijun,9999,0,9999,0
1668041736913,COGS 210B,003,101422,Nitz; Douglas A.,9999,0,9999,0
1668041736913,COGS 210B,004,101423,Hollan; James D.,9998,0,9999,1
1668041736913,COGS 210B,005,101424,Deak; Gedeon O.,9998,0,9999,1
1668041736913,COGS 210B,006,101425,Rossano; Federico,9999,0,9999,0
1668041737337,COGS 211B,A00,101427,Coulson; Seana M,9996,0,9999,3
1668041737761,COGS 220,A00,101428,Hollan; James D.,0,0,25,25
1668041738184,COGS 229,A00,101429,Dow; Steven P,18,0,25,7
1668041738637,COGS 230,A00,101430,Klemmer; Scott R,13,0,17,4
1668041739065,COGS 234,A00,101431,Xia; Haijun,4,0,25,21
1668041739504,COGS 260,A00,101432,Kiyonaga; Anastasia,19,0,25,6
1668041739504,COGS 260,B00,101433,Kirsh; David Joel,16,0,25,9
1668041739927,CSE 202,A00,102371,Impagliazzo; Russell,0,0,0,0
1668041740356,CSE 203B,A01,102373,Cheng; Chung Kuan,0,0,0,0
1668041740787,CSE 208,A00,102374,Micciancio; Daniele,0,0,0,0
1668041741219,CSE 209A,A00,112895,Impagliazzo; Russell,0,0,15,15
1668041741662,CSE 209B,A00,108005,Bellare; Mihir,0,0,0,0
1668041742094,CSE 210,A00,113163,Coblenz; Michael J,0,0,0,0
1668041742533,CSE 219,A00,106111,Dow; Steven P,0,0,20,20
1668041742971,CSE 221,A00,102376,Voelker; Geoffrey M.,0,0,0,0
1668041743402,CSE 224,A01,102378,Porter; George M,0,0,0,0
1668041743828,CSE 229A,A00,102379,Savage; Stefan,0,0,0,0
1668041744250,CSE 229C,A00,102380,Munyaka; Imani N. S.,0,0,0,0
1668041744675,CSE 232B,A00,102382,Deutsch; Alin Bernard,0,0,0,0
1668041745100,CSE 234,A01,112904,Kumar; Arun Kumar,0,0,0,0
1668041745532,CSE 237A,A00,102383,Rosing; Tajana Simunic,0,0,0,0
1668041745964,CSE 239A,A00,102384,Deutsch; Alin Bernard,0,0,0,0
1668041746404,CSE 239B,A00,102385,Polikarpova; Nadezhda,0,0,0,0
1668041746829,CSE 240A,A00,102386,Pannuto; Patrick William,0,0,0,0
1668041747268,CSE 240B,A00,102387,Zhao; Jishen,0,0,0,0
1668041747699,CSE 241A,A00,106406,Kang; Mingu,0,0,0,0
1668041748135,CSE 249B,A00,102388,Kahng; Andrew Byun,0,0,8,8
1668041748568,CSE 251B,A01,102392,Cottrell; Garrison W,0,0,0,0
1668041748568,CSE 251B,A02,102393,Cottrell; Garrison W,0,0,0,0
1668041748998,CSE 252B,A00,102394,Ochoa; Benjamin Lawrence,0,0,0,0
1668041749430,CSE 257,A01,102396,Gao; Sicun,0,0,0,0
1668041749858,CSE 272,A00,102397,Li; Tzumao,0,0,0,0
1668041750283,CSE 274,A00,111323,Chern; Albert Ren-Haur,0,0,0,0
1668041750708,CSE 282,A00,102398,Pevzner; Pavel Arkadjevich,0,0,0,0
1668041751133,CSE 284,A00,114175,Gymrek; Melissa Ann,0,0,0,0
1668041751570,CSE 290,A00,102399,Chandraker; Manmohan Krishna,0,0,0,0
1668041751570,CSE 290,B00,102400,Vaccaro; Kristen Marie,0,0,25,25
1668041751570,CSE 290,C00,102414,Pannuto; Patrick William,0,0,25,25
1668041751570,CSE 290,D00,102427,Pevzner; Pavel Arkadjevich,0,0,0,0
1668041751570,CSE 290,E00,102429,Zhao; Jishen,0,0,0,0
1668041751570,CSE 290,F00,102436,Tullsen; Dean Michael,0,0,0,0
1668041751570,CSE 290,G00,102440,Christensen; Henrik I,0,0,20,20
1668041752005,CSE 291,A00,102443,Su; Hao,0,0,0,0
1668041752005,CSE 291,B00,102448,Polikarpova; Nadezhda,0,0,0,0
1668041752005,CSE 291,C00,102453,Vaccaro; Kristen Marie,0,0,0,0
1668041752005,CSE 291,D00,111343,Savage; Stefan,0,0,0,0
1668041752005,CSE 291,E00,116474,Claffy; Kimberly Claire,0,0,0,0
1668041752005,CSE 291,F00,116479,Pasquale; Joseph,0,0,0,0
1668041752450,CSE 293,001,119111,Bafna; Vineet,9999,0,9999,0
1668041752450,CSE 293,002,119118,Bellare; Mihir,9999,0,9999,0
1668041752450,CSE 293,003,119122,Berg-Kirkpatrick; Taylor D,9999,0,9999,0
1668041752450,CSE 293,004,119135,Christensen; Henrik I,9999,0,9999,0
1668041752450,CSE 293,005,119142,Cottrell; Garrison W,9999,0,9999,0
1668041752450,CSE 293,006,119146,Deutsch; Alin Bernard,9999,0,9999,0
1668041752450,CSE 293,007,119159,Esmaeilzadeh; Hadi,9999,0,9999,0
1668041752450,CSE 293,008,119166,Freund; Yoav,9999,0,9999,0
1668041752450,CSE 293,009,119170,Griswold; William G.,9999,0,9999,0
1668041752450,CSE 293,010,119183,Gymrek; Melissa Ann,9999,0,9999,0
1668041752450,CSE 293,011,119190,Heninger; Nadia A,9999,0,9999,0
1668041752450,CSE 293,012,119230,Impagliazzo; Russell,9999,0,9999,0
1668041752450,CSE 293,013,119232,Jhala; Ranjit,9999,0,9999,0
1668041752450,CSE 293,014,119233,Kahng; Andrew Byun,9999,0,9999,0
1668041752450,CSE 293,015,119298,Kane; Daniel Mertz,9999,0,9999,0
1668041752450,CSE 293,016,119299,Kriegman; David J,9999,0,9999,0
1668041752450,CSE 293,017,119300,Kumar; Arun Kumar,9999,0,9999,0
1668041752450,CSE 293,018,119301,Lerner; Sorin,9999,0,9999,0
1668041752450,CSE 293,019,119302,Lovett; Shachar,9999,0,9999,0
1668041752450,CSE 293,020,119303,McAuley; Julian John,9999,0,9999,0
1668041752450,CSE 293,021,119304,Micciancio; Daniele,9999,0,9999,0
1668041752450,CSE 293,022,119367,Orailoglu; Alex,9999,0,9999,0
1668041752450,CSE 293,023,119382,Paturi; Ramamohan,9999,0,9999,0
1668041752450,CSE 293,024,119404,Polikarpova; Nadezhda,9999,0,9999,0
1668041752450,CSE 293,025,119406,Politz; Joseph Gibbs,9999,0,9999,0
1668041752450,CSE 293,026,119411,Porter; George M,9999,0,9999,0
1668041752450,CSE 293,027,119414,Porter; Leonard Emerson,9999,0,9999,0
1668041752450,CSE 293,028,119416,Ramamoorthi; Ravi,9999,0,9999,0
1668041752450,CSE 293,029,119417,Sahoo; Debashis,9999,0,9999,0
1668041752450,CSE 293,030,119420,Saul; Lawrence,9999,0,9999,0
1668041752450,CSE 293,031,119421,Savage; Stefan,9999,0,9999,0
1668041752450,CSE 293,032,119425,Schulze; Jurgen P.,9999,0,9999,0
1668041752450,CSE 293,033,119426,Snoeren; Alex C.,9999,0,9999,0
1668041752450,CSE 293,034,119428,Shang; Jingbo,9999,0,9999,0
1668041752450,CSE 293,035,119430,Stefan; Deian,9999,0,9999,0
1668041752450,CSE 293,036,119431,Su; Hao,9999,0,9999,0
1668041752450,CSE 293,037,119433,Swanson; Steven James,9999,0,9999,0
1668041752450,CSE 293,038,119435,Tullsen; Dean Michael,9999,0,9999,0
1668041752450,CSE 293,039,119483,Voelker; Geoffrey M.,9999,0,9999,0
1668041752450,CSE 293,040,119537,Zhao; Jishen,9999,0,9999,0
1668041752450,CSE 293,041,119538,Zhou; Yuan-Yuan,9999,0,9999,0
1668041752450,CSE 293,042,119539,Gao; Sicun,9999,0,9999,0
1668041752450,CSE 293,043,119540,Weibel; Nadir,9999,0,9999,0
1668041752450,CSE 293,044,119541,Gupta; Rajesh K.,9999,0,9999,0
1668041752450,CSE 293,045,126410,Vaccaro; Kristen Marie,9999,0,9999,0
1668041752450,CSE 293,046,126411,Klemke; Richard,9999,0,9999,0
1668041752879,CSE 294,A00,102459,Voelker; Geoffrey M.,0,0,0,0
1668041752879,CSE 294,B00,111322,Orailoglu; Alex,0,0,0,0
1668041753315,DSE 201,A00,096914,Deutsch; Alin Bernard,30,0,30,0
1668041753736,DSE 210,A00,096915,Dasgupta; Sanjoy,30,0,30,0
1668041754166,DSE 260A,A00,096916,Altintas De Callaf; Ilkay,30,0,30,0
1668041754608,ECE 200,001,103586,Antipa; Nicholas A,9999,0,9999,0
1668041754608,ECE 200,002,103587,Atanasov; Nikolay A.,9999,0,9999,0
1668041754608,ECE 200,003,103588,Bharadia; Dinesh,9999,0,9999,0
1668041754608,ECE 200,004,103589,Cheng; Chung Kuan,9999,0,9999,0
1668041754608,ECE 200,005,103590,Cosman; Pamela C.,9999,0,9999,0
1668041754608,ECE 200,006,103591,Dayeh; Shadi Ahmad,9999,0,9999,0
1668041754608,ECE 200,007,103592,Fainman; Yeshaiahu,9999,0,9999,0
1668041754608,ECE 200,008,103593,Ford; Joseph Earl,9999,0,9999,0
1668041754608,ECE 200,009,103594,Franceschetti; Massimo,9999,0,9999,0
1668041754608,ECE 200,010,103595,Fullerton; Eric E,9999,0,9999,0
1668041754608,ECE 200,011,103596,Galton; Ian A,9999,0,9999,0
1668041754608,ECE 200,012,103597,Gilja; Vikash,9999,0,9999,0
1668041754608,ECE 200,013,103598,Hall; Drew A.,9999,0,9999,0
1668041754608,ECE 200,014,103599,Hsueh; Tzu-Chien,9999,0,9999,0
1668041754608,ECE 200,015,103600,Javidi; Tara,9999,0,9999,0
1668041754608,ECE 200,016,103601,Kahng; Andrew Byun,9999,0,9999,0
1668041754608,ECE 200,017,103602,Kim; Young-Han,9999,0,9999,0
1668041754608,ECE 200,018,103603,Koushanfar; Farinaz,9999,0,9999,0
1668041754608,ECE 200,019,103604,Kuzum; Duygu,9999,0,9999,0
1668041754608,ECE 200,020,103605,Le; Hanh-Phuc,9999,0,9999,0
1668041754608,ECE 200,021,103606,Lin; Bill,9999,0,9999,0
1668041754608,ECE 200,022,103607,Liu; Zhaowei,9998,0,9999,1
1668041754608,ECE 200,023,103608,Lo; Yu-Hwa,9999,0,9999,0
1668041754608,ECE 200,024,103609,Lomakin; Vitaliy,9999,0,9999,0
1668041754608,ECE 200,025,103610,Mercier; Patrick Philip,9999,0,9999,0
1668041754608,ECE 200,026,103611,Meyer; Florian,9999,0,9999,0
1668041754608,ECE 200,027,103612,Milstein; Laurence B.,9999,0,9999,0
1668041754608,ECE 200,028,103613,Mir Arabbaygi; Siavash,9999,0,9999,0
1668041754608,ECE 200,029,103614,Mookherjea; Shayan,9999,0,9999,0
1668041754608,ECE 200,030,103615,Morris; Karcher William,9999,0,9999,0
1668041754608,ECE 200,031,103616,Ng; Tse Nga,9999,0,9999,0
1668041754608,ECE 200,032,103617,Nguyen; Truong Quang,9999,0,9999,0
1668041754608,ECE 200,033,103618,Nomura; Kenji,9999,0,9999,0
1668041754608,ECE 200,034,103619,Orlitsky; Alon,9999,0,9999,0
1668041754608,ECE 200,035,103620,Pal; Piya,9999,0,9999,0
1668041754608,ECE 200,036,103621,Papen; George C.,9999,0,9999,0
1668041754608,ECE 200,037,103622,Radic; Stojan,9999,0,9999,0
1668041754608,ECE 200,038,103623,Rao; Bhaskar D.,9999,0,9999,0
1668041754608,ECE 200,039,103624,Rao; Ramesh R,9999,0,9999,0
1668041754608,ECE 200,040,103625,Rebeiz; Gabriel,9999,0,9999,0
1668041754608,ECE 200,041,103626,Sanford; John R,9999,0,9999,0
1668041754608,ECE 200,042,103627,Siegel; Paul H.,9999,0,9999,0
1668041754608,ECE 200,043,103628,Sievenpiper; Daniel F.,9999,0,9999,0
1668041754608,ECE 200,044,103629,Sworder; David D.,9999,0,9999,0
1668041754608,ECE 200,045,103630,Taur; Yuan,9999,0,9999,0
1668041754608,ECE 200,046,103631,Touri; Behrouz,9999,0,9999,0
1668041754608,ECE 200,047,103632,Trivedi; Mohan M.,9999,0,9999,0
1668041754608,ECE 200,048,103633,Vasconcelos; Nuno,9999,0,9999,0
1668041754608,ECE 200,049,103634,Wang; Xiaolong,9999,0,9999,0
1668041754608,ECE 200,050,103635,Xie; Pengtao,9999,0,9999,0
1668041754608,ECE 200,051,103636,Yip; Michael,9999,0,9999,0
1668041754608,ECE 200,052,103637,Zeger; Kenneth A.,999,0,999,0
1668041754608,ECE 200,053,103638,Zhang; Xinyu,9999,0,9999,0
1668041754608,ECE 200,054,103639,Turakhia; Yatish Girish,9999,0,9999,0
1668041754608,ECE 200,055,103640,Kang; Mingu,9999,0,9999,0
1668041754608,ECE 200,056,103641,Shi; Yuanyuan,9999,0,9999,0
1668041754608,ECE 200,057,103642,Wang; Edward Jay,9999,0,9999,0
1668041754608,ECE 200,058,103643,Zheng; Yang,9999,0,9999,0
1668041755031,ECE 202,A00,103644,Kuzum; Duygu,0,0,0,0
1668041755458,ECE 212BN,A00,103646,Ng; Tse Nga,0,0,0,0
1668041755898,ECE 221,A00,111493,Staff,0,0,0,0
1668041756321,ECE 222B,A00,103647,Lomakin; Vitaliy,0,0,0,0
1668041756754,ECE 230B,A00,103648,Taur; Yuan,0,0,0,0
1668041757189,ECE 238B,A00,103649,Garay; Javier,0,0,0,0
1668041757617,ECE 240B,A00,112900,Fainman; Yeshaiahu,0,0,0,0
1668041758041,ECE 247A,A00,103650,Jokerst; Jesse Vincent,0,0,0,0
1668041758464,ECE 247B,A00,103651,Wang; Joseph,0,0,0,0
1668041758898,ECE 250,A00,103652,Siegel; Paul H.,0,0,0,0
1668041759327,ECE 251A,A00,103654,Rao; Bhaskar D.,0,0,0,0
1668041759766,ECE 257B,A00,103655,Bharadia; Dinesh,0,0,0,0
1668041760196,ECE 258A,A00,103656,Milstein; Laurence B.,0,0,0,0
1668041760627,ECE 260B,A00,103658,Kang; Mingu,0,0,0,0
1668041761050,ECE 264A,A00,103659,Galton; Ian A,0,0,0,0
1668041761474,ECE 265A,A00,103661,Gudem; Prasad S.S.,0,0,0,0
1668041761897,ECE 265D,A00,103662,Gudem; Prasad S.S.,0,0,0,0
1668041762338,ECE 268,A00,103663,Koushanfar; Farinaz,0,0,0,0
1668041762764,ECE 269,A01,103665,Pal; Piya,0,0,0,0
1668041763190,ECE 271B,A00,103666,Vasconcelos; Manuela,0,0,0,0
1668041763617,ECE 276A,A00,103667,Atanasov; Nikolay A.,0,0,0,0
1668041764047,ECE 277,A00,103668,An; Cheolhong,0,0,0,0
1668041764475,ECE 279,A00,117947,Hall; Drew A.,0,0,0,0
1668041765342,ECE 283,A00,103670,Hsueh; Tzu-Chien,0,0,0,0
1668041765767,ECE 284,A00,103671,Turakhia; Yatish Girish,0,0,0,0
1668041766189,ECE 285,A00,103672,Zheng; Yang,0,0,0,0
1668041766189,ECE 285,B00,103673,Sworder; David D.,0,0,0,0
1668041766616,ECE 287,A00,103676,Javidi; Tara,0,0,0,0
1668041767044,MATH 200B,A00,098023,Salehi Golsefidy; Alireza,13,0,15,2
1668041767481,MATH 202B,A00,098024,Rhoades; Brendon Patrick,9,0,15,6
1668041768044,MATH 203B,A00,098025,Oprea; Dragos N.,11,0,15,4
1668041768474,MATH 204B,A00,098026,Sorensen; Claus M,13,0,15,2
1668041768913,MATH 208,A00,098027,Izadi; Elham,7,0,10,3
1668041769344,MATH 209,A00,098028,Pollack; Aaron,10,0,10,0
1668041769773,MATH 211A,A00,112919,Rogalski; Daniel,9,0,10,1
1668041770196,MATH 211B,A00,112920,Seward; Brandon M.,9,0,10,1
1668041770619,MATH 218,A00,098029,Li; Bo,10,0,10,0
1668041771044,MATH 220B,A00,098030,Novak; Jonathan I,13,0,15,2
1668041771471,MATH 221A,A00,098031,Ebenfelt; Peter F,13,0,15,2
1668041771899,MATH 231B,A00,098032,Zlatos; Andrej,12,0,15,3
1668041772333,MATH 240B,A00,098033,Ni; Lei,9,0,15,6
1668041772776,MATH 243,A00,098034,Jekel; David Andrew,10,0,10,0
1668041773202,MATH 245A,A00,098035,Nie; Jiawang,0,0,15,16
1668041773631,MATH 248,A00,098036,Bejenaru; Ioan,10,0,10,0
1668041774066,MATH 250B,A00,098037,Spolaor; Luca,14,0,15,1
1668041774492,MATH 258,A00,098038,Ni; Lei,10,0,10,0
1668041774923,MATH 264B,A00,098041,Rhoades; Brendon Patrick,10,0,15,5
1668041775354,MATH 268,A00,098042,Buss; Samuel R,10,0,10,0
1668041775787,MATH 269,A00,098043,Rhoades; Brendon Patrick,10,0,10,0
1668041776240,MATH 270B,A00,098044,Li; Bo,11,0,15,4
1668041776683,MATH 272B,A00,098045,Holst; Michael J,13,0,15,2
1668041777107,MATH 273A,A00,098046,Tian; Xiaochuan,10,0,15,5
1668041777554,MATH 275,A01,098048,Tian; Xiaochuan,6,0,10,4
1668041777983,MATH 278A,A00,098049,Holst; Michael J,8,0,10,2
1668041778415,MATH 278B,A00,098050,Cloninger; Alexander,10,0,10,0
1668041778840,MATH 278C,A00,098051,Nie; Jiawang,7,0,10,3
1668041779264,MATH 280B,A00,098052,Zheng; Tianyi,11,0,15,4
1668041779689,MATH 281B,A00,098053,Bradic; Jelena,3,0,15,12
1668041780116,MATH 282B,A00,098054,Arias-Castro; Ery,0,0,15,15
1668041780539,MATH 285,A00,098055,Fitzsimmons; Patrick J,0,0,15,17
1668041780965,MATH 287B,A00,098056,Arias-Castro; Ery,3,0,15,12
1668041781393,MATH 288,A00,098057,Agarwal; Pooja,9,0,10,1
1668041781393,MATH 288,B00,098058,Zhang; Danna,8,0,10,2
1668041781393,MATH 288,C00,098059,Williams; Ruth J,10,0,10,0
1668041781819,MATH 290B,A00,098060,Roberts; Justin Deritter,13,0,15,2
1668041782244,MATH 292,A00,098061,Belmont; Eva Kinoshita,10,0,10,0
1668041782671,MATH 295,A00,098062,Suk; Andrew Hoon,48,0,50,2
1668041783099,MATH 296,A00,098063,Novak; Jonathan I,20,0,20,0
1668041783527,MATH 297,001,098064,Gamst; Anthony Collins,9997,0,9999,2
1668042290188,COGS 205,A00,101395,Chiba; Andrea,19,0,20,1
1668042290626,COGS 210B,001,101404,Greene; Deanna Jacquelyn,9998,0,9999,1
1668042290626,COGS 210B,002,101417,Xia; Haijun,9999,0,9999,0
1668042290626,COGS 210B,003,101422,Nitz; Douglas A.,9999,0,9999,0
1668042290626,COGS 210B,004,101423,Hollan; James D.,9998,0,9999,1
1668042290626,COGS 210B,005,101424,Deak; Gedeon O.,9998,0,9999,1
1668042290626,COGS 210B,006,101425,Rossano; Federico,9999,0,9999,0
1668042291052,COGS 211B,A00,101427,Coulson; Seana M,9996,0,9999,3
1668042291497,COGS 220,A00,101428,Hollan; James D.,0,0,25,25
1668042291923,COGS 229,A00,101429,Dow; Steven P,18,0,25,7
1668042292357,COGS 230,A00,101430,Klemmer; Scott R,13,0,17,4
1668042292792,COGS 234,A00,101431,Xia; Haijun,4,0,25,21
1668042293215,COGS 260,A00,101432,Kiyonaga; Anastasia,19,0,25,6
1668042293215,COGS 260,B00,101433,Kirsh; David Joel,16,0,25,9
1668042293639,CSE 202,A00,102371,Impagliazzo; Russell,0,0,0,0
1668042294081,CSE 203B,A01,102373,Cheng; Chung Kuan,0,0,0,0
1668042294528,CSE 208,A00,102374,Micciancio; Daniele,0,0,0,0
1668042295081,CSE 209A,A00,112895,Impagliazzo; Russell,0,0,15,15
1668042295538,CSE 209B,A00,108005,Bellare; Mihir,0,0,0,0
1668042295968,CSE 210,A00,113163,Coblenz; Michael J,0,0,0,0
1668042296406,CSE 219,A00,106111,Dow; Steven P,0,0,20,20
1668042296830,CSE 221,A00,102376,Voelker; Geoffrey M.,0,0,0,0
1668042297278,CSE 224,A01,102378,Porter; George M,0,0,0,0
1668042297703,CSE 229A,A00,102379,Savage; Stefan,0,0,0,0
1668042298196,CSE 229C,A00,102380,Munyaka; Imani N. S.,0,0,0,0
1668042298650,CSE 232B,A00,102382,Deutsch; Alin Bernard,0,0,0,0
1668042299077,CSE 234,A01,112904,Kumar; Arun Kumar,0,0,0,0
1668042299501,CSE 237A,A00,102383,Rosing; Tajana Simunic,0,0,0,0
1668042299924,CSE 239A,A00,102384,Deutsch; Alin Bernard,0,0,0,0
1668042300362,CSE 239B,A00,102385,Polikarpova; Nadezhda,0,0,0,0
1668042300796,CSE 240A,A00,102386,Pannuto; Patrick William,0,0,0,0
1668042301235,CSE 240B,A00,102387,Zhao; Jishen,0,0,0,0
1668042301666,CSE 241A,A00,106406,Kang; Mingu,0,0,0,0
1668042302093,CSE 249B,A00,102388,Kahng; Andrew Byun,0,0,8,8
1668042302530,CSE 251B,A01,102392,Cottrell; Garrison W,0,0,0,0
1668042302530,CSE 251B,A02,102393,Cottrell; Garrison W,0,0,0,0
1668042302985,CSE 252B,A00,102394,Ochoa; Benjamin Lawrence,0,0,0,0
1668042303413,CSE 257,A01,102396,Gao; Sicun,0,0,0,0
1668042303849,CSE 272,A00,102397,Li; Tzumao,0,0,0,0
1668042304276,CSE 274,A00,111323,Chern; Albert Ren-Haur,0,0,0,0
1668042304954,CSE 282,A00,102398,Pevzner; Pavel Arkadjevich,0,0,0,0
1668042305378,CSE 284,A00,114175,Gymrek; Melissa Ann,0,0,0,0
1668042305801,CSE 290,A00,102399,Chandraker; Manmohan Krishna,0,0,0,0
1668042305801,CSE 290,B00,102400,Vaccaro; Kristen Marie,0,0,25,25
1668042305801,CSE 290,C00,102414,Pannuto; Patrick William,0,0,25,25
1668042305801,CSE 290,D00,102427,Pevzner; Pavel Arkadjevich,0,0,0,0
1668042305801,CSE 290,E00,102429,Zhao; Jishen,0,0,0,0
1668042305801,CSE 290,F00,102436,Tullsen; Dean Michael,0,0,0,0
1668042305801,CSE 290,G00,102440,Christensen; Henrik I,0,0,20,20
1668042306235,CSE 291,A00,102443,Su; Hao,0,0,0,0
1668042306235,CSE 291,B00,102448,Polikarpova; Nadezhda,0,0,0,0
1668042306235,CSE 291,C00,102453,Vaccaro; Kristen Marie,0,0,0,0
1668042306235,CSE 291,D00,111343,Savage; Stefan,0,0,0,0
1668042306235,CSE 291,E00,116474,Claffy; Kimberly Claire,0,0,0,0
1668042306235,CSE 291,F00,116479,Pasquale; Joseph,0,0,0,0
1668042306695,CSE 293,001,119111,Bafna; Vineet,9999,0,9999,0
1668042306695,CSE 293,002,119118,Bellare; Mihir,9999,0,9999,0
1668042306695,CSE 293,003,119122,Berg-Kirkpatrick; Taylor D,9999,0,9999,0
1668042306695,CSE 293,004,119135,Christensen; Henrik I,9999,0,9999,0
1668042306695,CSE 293,005,119142,Cottrell; Garrison W,9999,0,9999,0
1668042306695,CSE 293,006,119146,Deutsch; Alin Bernard,9999,0,9999,0
1668042306695,CSE 293,007,119159,Esmaeilzadeh; Hadi,9999,0,9999,0
1668042306695,CSE 293,008,119166,Freund; Yoav,9999,0,9999,0
1668042306695,CSE 293,009,119170,Griswold; William G.,9999,0,9999,0
1668042306695,CSE 293,010,119183,Gymrek; Melissa Ann,9999,0,9999,0
1668042306695,CSE 293,011,119190,Heninger; Nadia A,9999,0,9999,0
1668042306695,CSE 293,012,119230,Impagliazzo; Russell,9999,0,9999,0
1668042306695,CSE 293,013,119232,Jhala; Ranjit,9999,0,9999,0
1668042306695,CSE 293,014,119233,Kahng; Andrew Byun,9999,0,9999,0
1668042306695,CSE 293,015,119298,Kane; Daniel Mertz,9999,0,9999,0
1668042306695,CSE 293,016,119299,Kriegman; David J,9999,0,9999,0
1668042306695,CSE 293,017,119300,Kumar; Arun Kumar,9999,0,9999,0
1668042306695,CSE 293,018,119301,Lerner; Sorin,9999,0,9999,0
1668042306695,CSE 293,019,119302,Lovett; Shachar,9999,0,9999,0
1668042306695,CSE 293,020,119303,McAuley; Julian John,9999,0,9999,0
1668042306695,CSE 293,021,119304,Micciancio; Daniele,9999,0,9999,0
1668042306695,CSE 293,022,119367,Orailoglu; Alex,9999,0,9999,0
1668042306695,CSE 293,023,119382,Paturi; Ramamohan,9999,0,9999,0
1668042306695,CSE 293,024,119404,Polikarpova; Nadezhda,9999,0,9999,0
1668042306695,CSE 293,025,119406,Politz; Joseph Gibbs,9999,0,9999,0
1668042306695,CSE 293,026,119411,Porter; George M,9999,0,9999,0
1668042306695,CSE 293,027,119414,Porter; Leonard Emerson,9999,0,9999,0
1668042306695,CSE 293,028,119416,Ramamoorthi; Ravi,9999,0,9999,0
1668042306695,CSE 293,029,119417,Sahoo; Debashis,9999,0,9999,0
1668042306695,CSE 293,030,119420,Saul; Lawrence,9999,0,9999,0
1668042306695,CSE 293,031,119421,Savage; Stefan,9999,0,9999,0
1668042306695,CSE 293,032,119425,Schulze; Jurgen P.,9999,0,9999,0
1668042306695,CSE 293,033,119426,Snoeren; Alex C.,9999,0,9999,0
1668042306695,CSE 293,034,119428,Shang; Jingbo,9999,0,9999,0
1668042306695,CSE 293,035,119430,Stefan; Deian,9999,0,9999,0
1668042306695,CSE 293,036,119431,Su; Hao,9999,0,9999,0
1668042306695,CSE 293,037,119433,Swanson; Steven James,9999,0,9999,0
1668042306695,CSE 293,038,119435,Tullsen; Dean Michael,9999,0,9999,0
1668042306695,CSE 293,039,119483,Voelker; Geoffrey M.,9999,0,9999,0
1668042306695,CSE 293,040,119537,Zhao; Jishen,9999,0,9999,0
1668042306695,CSE 293,041,119538,Zhou; Yuan-Yuan,9999,0,9999,0
1668042306695,CSE 293,042,119539,Gao; Sicun,9999,0,9999,0
1668042306695,CSE 293,043,119540,Weibel; Nadir,9999,0,9999,0
1668042306695,CSE 293,044,119541,Gupta; Rajesh K.,9999,0,9999,0
1668042306695,CSE 293,045,126410,Vaccaro; Kristen Marie,9999,0,9999,0
1668042306695,CSE 293,046,126411,Klemke; Richard,9999,0,9999,0
1668042307130,CSE 294,A00,102459,Voelker; Geoffrey M.,0,0,0,0
1668042307130,CSE 294,B00,111322,Orailoglu; Alex,0,0,0,0
1668042307570,DSE 201,A00,096914,Deutsch; Alin Bernard,30,0,30,0
1668042307996,DSE 210,A00,096915,Dasgupta; Sanjoy,30,0,30,0
1668042308419,DSE 260A,A00,096916,Altintas De Callaf; Ilkay,30,0,30,0
1668042308857,ECE 200,001,103586,Antipa; Nicholas A,9999,0,9999,0
1668042308857,ECE 200,002,103587,Atanasov; Nikolay A.,9999,0,9999,0
1668042308857,ECE 200,003,103588,Bharadia; Dinesh,9999,0,9999,0
1668042308857,ECE 200,004,103589,Cheng; Chung Kuan,9999,0,9999,0
1668042308857,ECE 200,005,103590,Cosman; Pamela C.,9999,0,9999,0
1668042308857,ECE 200,006,103591,Dayeh; Shadi Ahmad,9999,0,9999,0
1668042308857,ECE 200,007,103592,Fainman; Yeshaiahu,9999,0,9999,0
1668042308857,ECE 200,008,103593,Ford; Joseph Earl,9999,0,9999,0
1668042308857,ECE 200,009,103594,Franceschetti; Massimo,9999,0,9999,0
1668042308857,ECE 200,010,103595,Fullerton; Eric E,9999,0,9999,0
1668042308857,ECE 200,011,103596,Galton; Ian A,9999,0,9999,0
1668042308857,ECE 200,012,103597,Gilja; Vikash,9999,0,9999,0
1668042308857,ECE 200,013,103598,Hall; Drew A.,9999,0,9999,0
1668042308857,ECE 200,014,103599,Hsueh; Tzu-Chien,9999,0,9999,0
1668042308857,ECE 200,015,103600,Javidi; Tara,9999,0,9999,0
1668042308857,ECE 200,016,103601,Kahng; Andrew Byun,9999,0,9999,0
1668042308857,ECE 200,017,103602,Kim; Young-Han,9999,0,9999,0
1668042308857,ECE 200,018,103603,Koushanfar; Farinaz,9999,0,9999,0
1668042308857,ECE 200,019,103604,Kuzum; Duygu,9999,0,9999,0
1668042308857,ECE 200,020,103605,Le; Hanh-Phuc,9999,0,9999,0
1668042308857,ECE 200,021,103606,Lin; Bill,9999,0,9999,0
1668042308857,ECE 200,022,103607,Liu; Zhaowei,9998,0,9999,1
1668042308857,ECE 200,023,103608,Lo; Yu-Hwa,9999,0,9999,0
1668042308857,ECE 200,024,103609,Lomakin; Vitaliy,9999,0,9999,0
1668042308857,ECE 200,025,103610,Mercier; Patrick Philip,9999,0,9999,0
1668042308857,ECE 200,026,103611,Meyer; Florian,9999,0,9999,0
1668042308857,ECE 200,027,103612,Milstein; Laurence B.,9999,0,9999,0
1668042308857,ECE 200,028,103613,Mir Arabbaygi; Siavash,9999,0,9999,0
1668042308857,ECE 200,029,103614,Mookherjea; Shayan,9999,0,9999,0
1668042308857,ECE 200,030,103615,Morris; Karcher William,9999,0,9999,0
1668042308857,ECE 200,031,103616,Ng; Tse Nga,9999,0,9999,0
1668042308857,ECE 200,032,103617,Nguyen; Truong Quang,9999,0,9999,0
1668042308857,ECE 200,033,103618,Nomura; Kenji,9999,0,9999,0
1668042308857,ECE 200,034,103619,Orlitsky; Alon,9999,0,9999,0
1668042308857,ECE 200,035,103620,Pal; Piya,9999,0,9999,0
1668042308857,ECE 200,036,103621,Papen; George C.,9999,0,9999,0
1668042308857,ECE 200,037,103622,Radic; Stojan,9999,0,9999,0
1668042308857,ECE 200,038,103623,Rao; Bhaskar D.,9999,0,9999,0
1668042308857,ECE 200,039,103624,Rao; Ramesh R,9999,0,9999,0
1668042308857,ECE 200,040,103625,Rebeiz; Gabriel,9999,0,9999,0
1668042308857,ECE 200,041,103626,Sanford; John R,9999,0,9999,0
1668042308857,ECE 200,042,103627,Siegel; Paul H.,9999,0,9999,0
1668042308857,ECE 200,043,103628,Sievenpiper; Daniel F.,9999,0,9999,0
1668042308857,ECE 200,044,103629,Sworder; David D.,9999,0,9999,0
1668042308857,ECE 200,045,103630,Taur; Yuan,9999,0,9999,0
1668042308857,ECE 200,046,103631,Touri; Behrouz,9999,0,9999,0
1668042308857,ECE 200,047,103632,Trivedi; Mohan M.,9999,0,9999,0
1668042308857,ECE 200,048,103633,Vasconcelos; Nuno,9999,0,9999,0
1668042308857,ECE 200,049,103634,Wang; Xiaolong,9999,0,9999,0
1668042308857,ECE 200,050,103635,Xie; Pengtao,9999,0,9999,0
1668042308857,ECE 200,051,103636,Yip; Michael,9999,0,9999,0
1668042308857,ECE 200,052,103637,Zeger; Kenneth A.,999,0,999,0
1668042308857,ECE 200,053,103638,Zhang; Xinyu,9999,0,9999,0
1668042308857,ECE 200,054,103639,Turakhia; Yatish Girish,9999,0,9999,0
1668042308857,ECE 200,055,103640,Kang; Mingu,9999,0,9999,0
1668042308857,ECE 200,056,103641,Shi; Yuanyuan,9999,0,9999,0
1668042308857,ECE 200,057,103642,Wang; Edward Jay,9999,0,9999,0
1668042308857,ECE 200,058,103643,Zheng; Yang,9999,0,9999,0
1668042309287,ECE 202,A00,103644,Kuzum; Duygu,0,0,0,0
1668042309721,ECE 212BN,A00,103646,Ng; Tse Nga,0,0,0,0
1668042310146,ECE 221,A00,111493,Staff,0,0,0,0
1668042310568,ECE 222B,A00,103647,Lomakin; Vitaliy,0,0,0,0
1668042311035,ECE 230B,A00,103648,Taur; Yuan,0,0,0,0
1668042311489,ECE 238B,A00,103649,Garay; Javier,0,0,0,0
1668042311924,ECE 240B,A00,112900,Fainman; Yeshaiahu,0,0,0,0
1668042312355,ECE 247A,A00,103650,Jokerst; Jesse Vincent,0,0,0,0
1668042312791,ECE 247B,A00,103651,Wang; Joseph,0,0,0,0
1668042313222,ECE 250,A00,103652,Siegel; Paul H.,0,0,0,0
1668042313649,ECE 251A,A00,103654,Rao; Bhaskar D.,0,0,0,0
1668042314074,ECE 257B,A00,103655,Bharadia; Dinesh,0,0,0,0
1668042314496,ECE 258A,A00,103656,Milstein; Laurence B.,0,0,0,0
1668042314946,ECE 260B,A00,103658,Kang; Mingu,0,0,0,0
1668042315371,ECE 264A,A00,103659,Galton; Ian A,0,0,0,0
1668042315793,ECE 265A,A00,103661,Gudem; Prasad S.S.,0,0,0,0
1668042316224,ECE 265D,A00,103662,Gudem; Prasad S.S.,0,0,0,0
1668042316646,ECE 268,A00,103663,Koushanfar; Farinaz,0,0,0,0
1668042317075,ECE 269,A01,103665,Pal; Piya,0,0,0,0
1668042317507,ECE 271B,A00,103666,Vasconcelos; Manuela,0,0,0,0
1668042317930,ECE 276A,A00,103667,Atanasov; Nikolay A.,0,0,0,0
1668042318359,ECE 277,A00,103668,An; Cheolhong,0,0,0,0
1668042318806,ECE 279,A00,117947,Hall; Drew A.,0,0,0,0
1668042319661,ECE 283,A00,103670,Hsueh; Tzu-Chien,0,0,0,0
1668042320085,ECE 284,A00,103671,Turakhia; Yatish Girish,0,0,0,0
1668042320515,ECE 285,A00,103672,Zheng; Yang,0,0,0,0
1668042320515,ECE 285,B00,103673,Sworder; David D.,0,0,0,0
1668042320946,ECE 287,A00,103676,Javidi; Tara,0,0,0,0
1668042321375,MATH 200B,A00,098023,Salehi Golsefidy; Alireza,13,0,15,2
1668042321803,MATH 202B,A00,098024,Rhoades; Brendon Patrick,9,0,15,6
1668042322232,MATH 203B,A00,098025,Oprea; Dragos N.,11,0,15,4
1668042322655,MATH 204B,A00,098026,Sorensen; Claus M,13,0,15,2
1668042323088,MATH 208,A00,098027,Izadi; Elham,7,0,10,3
1668042323512,MATH 209,A00,098028,Pollack; Aaron,10,0,10,0
1668042323938,MATH 211A,A00,112919,Rogalski; Daniel,9,0,10,1
1668042324366,MATH 211B,A00,112920,Seward; Brandon M.,9,0,10,1
1668042324793,MATH 218,A00,098029,Li; Bo,10,0,10,0
1668042325230,MATH 220B,A00,098030,Novak; Jonathan I,13,0,15,2
1668042325665,MATH 221A,A00,098031,Ebenfelt; Peter F,13,0,15,2
1668042326088,MATH 231B,A00,098032,Zlatos; Andrej,12,0,15,3
1668042326524,MATH 240B,A00,098033,Ni; Lei,9,0,15,6
1668042326953,MATH 243,A00,098034,Jekel; David Andrew,10,0,10,0
1668042327390,MATH 245A,A00,098035,Nie; Jiawang,0,0,15,16
1668042327827,MATH 248,A00,098036,Bejenaru; Ioan,10,0,10,0
1668042328262,MATH 250B,A00,098037,Spolaor; Luca,14,0,15,1
1668042328690,MATH 258,A00,098038,Ni; Lei,10,0,10,0
1668042329119,MATH 264B,A00,098041,Rhoades; Brendon Patrick,10,0,15,5
1668042329547,MATH 268,A00,098042,Buss; Samuel R,10,0,10,0
1668042329973,MATH 269,A00,098043,Rhoades; Brendon Patrick,10,0,10,0
1668042330399,MATH 270B,A00,098044,Li; Bo,11,0,15,4
1668042330823,MATH 272B,A00,098045,Holst; Michael J,13,0,15,2
1668042331255,MATH 273A,A00,098046,Tian; Xiaochuan,10,0,15,5
1668042331678,MATH 275,A01,098048,Tian; Xiaochuan,6,0,10,4
1668042332105,MATH 278A,A00,098049,Holst; Michael J,8,0,10,2
1668042332545,MATH 278B,A00,098050,Cloninger; Alexander,10,0,10,0
1668042332973,MATH 278C,A00,098051,Nie; Jiawang,7,0,10,3
1668042333398,MATH 280B,A00,098052,Zheng; Tianyi,11,0,15,4
1668042333832,MATH 281B,A00,098053,Bradic; Jelena,3,0,15,12
1668042334258,MATH 282B,A00,098054,Arias-Castro; Ery,0,0,15,15
1668042334685,MATH 285,A00,098055,Fitzsimmons; Patrick J,0,0,15,17
1668042335116,MATH 287B,A00,098056,Arias-Castro; Ery,3,0,15,12
1668042335546,MATH 288,A00,098057,Agarwal; Pooja,9,0,10,1
1668042335546,MATH 288,B00,098058,Zhang; Danna,8,0,10,2
1668042335546,MATH 288,C00,098059,Williams; Ruth J,10,0,10,0
1668042335976,MATH 290B,A00,098060,Roberts; Justin Deritter,13,0,15,2
1668042336402,MATH 292,A00,098061,Belmont; Eva Kinoshita,10,0,10,0
1668042336827,MATH 295,A00,098062,Suk; Andrew Hoon,48,0,50,2
1668042337261,MATH 296,A00,098063,Novak; Jonathan I,20,0,20,0
1668042337695,MATH 297,001,098064,Gamst; Anthony Collins,9997,0,9999,2
1668042842789,COGS 205,A00,101395,Chiba; Andrea,19,0,20,1
1668042843214,COGS 210B,001,101404,Greene; Deanna Jacquelyn,9998,0,9999,1
1668042843214,COGS 210B,002,101417,Xia; Haijun,9999,0,9999,0
1668042843214,COGS 210B,003,101422,Nitz; Douglas A.,9999,0,9999,0
1668042843214,COGS 210B,004,101423,Hollan; James D.,9998,0,9999,1
1668042843214,COGS 210B,005,101424,Deak; Gedeon O.,9998,0,9999,1
1668042843214,COGS 210B,006,101425,Rossano; Federico,9999,0,9999,0
1668042843637,COGS 211B,A00,101427,Coulson; Seana M,9996,0,9999,3
1668042844063,COGS 220,A00,101428,Hollan; James D.,0,0,25,25
1668042844505,COGS 229,A00,101429,Dow; Steven P,18,0,25,7
1668042844938,COGS 230,A00,101430,Klemmer; Scott R,13,0,17,4
1668042845361,COGS 234,A00,101431,Xia; Haijun,4,0,25,21
1668042845786,COGS 260,A00,101432,Kiyonaga; Anastasia,19,0,25,6
1668042845786,COGS 260,B00,101433,Kirsh; David Joel,16,0,25,9
1668042846212,CSE 202,A00,102371,Impagliazzo; Russell,0,0,0,0
1668042846641,CSE 203B,A01,102373,Cheng; Chung Kuan,0,0,0,0
1668042847077,CSE 208,A00,102374,Micciancio; Daniele,0,0,0,0
1668042847502,CSE 209A,A00,112895,Impagliazzo; Russell,0,0,15,15
1668042847930,CSE 209B,A00,108005,Bellare; Mihir,0,0,0,0
1668042848359,CSE 210,A00,113163,Coblenz; Michael J,0,0,0,0
1668042848799,CSE 219,A00,106111,Dow; Steven P,0,0,20,20
1668042849226,CSE 221,A00,102376,Voelker; Geoffrey M.,0,0,0,0
1668042849667,CSE 224,A01,102378,Porter; George M,0,0,0,0
1668042850103,CSE 229A,A00,102379,Savage; Stefan,0,0,0,0
1668042850533,CSE 229C,A00,102380,Munyaka; Imani N. S.,0,0,0,0
1668042850959,CSE 232B,A00,102382,Deutsch; Alin Bernard,0,0,0,0
1668042851403,CSE 234,A01,112904,Kumar; Arun Kumar,0,0,0,0
1668042851839,CSE 237A,A00,102383,Rosing; Tajana Simunic,0,0,0,0
1668042852280,CSE 239A,A00,102384,Deutsch; Alin Bernard,0,0,0,0
1668042852715,CSE 239B,A00,102385,Polikarpova; Nadezhda,0,0,0,0
1668042853138,CSE 240A,A00,102386,Pannuto; Patrick William,0,0,0,0
1668042853573,CSE 240B,A00,102387,Zhao; Jishen,0,0,0,0
1668042854008,CSE 241A,A00,106406,Kang; Mingu,0,0,0,0
1668042854432,CSE 249B,A00,102388,Kahng; Andrew Byun,0,0,8,8
1668042854857,CSE 251B,A01,102392,Cottrell; Garrison W,0,0,0,0
1668042854857,CSE 251B,A02,102393,Cottrell; Garrison W,0,0,0,0
1668042855284,CSE 252B,A00,102394,Ochoa; Benjamin Lawrence,0,0,0,0
1668042855720,CSE 257,A01,102396,Gao; Sicun,0,0,0,0
1668042856143,CSE 272,A00,102397,Li; Tzumao,0,0,0,0
1668042856584,CSE 274,A00,111323,Chern; Albert Ren-Haur,0,0,0,0
1668042857007,CSE 282,A00,102398,Pevzner; Pavel Arkadjevich,0,0,0,0
1668042857435,CSE 284,A00,114175,Gymrek; Melissa Ann,0,0,0,0
1668042857860,CSE 290,A00,102399,Chandraker; Manmohan Krishna,0,0,0,0
1668042857860,CSE 290,B00,102400,Vaccaro; Kristen Marie,0,0,25,25
1668042857860,CSE 290,C00,102414,Pannuto; Patrick William,0,0,25,25
1668042857860,CSE 290,D00,102427,Pevzner; Pavel Arkadjevich,0,0,0,0
1668042857860,CSE 290,E00,102429,Zhao; Jishen,0,0,0,0
1668042857860,CSE 290,F00,102436,Tullsen; Dean Michael,0,0,0,0
1668042857860,CSE 290,G00,102440,Christensen; Henrik I,0,0,20,20
1668042858299,CSE 291,A00,102443,Su; Hao,0,0,0,0
1668042858299,CSE 291,B00,102448,Polikarpova; Nadezhda,0,0,0,0
1668042858299,CSE 291,C00,102453,Vaccaro; Kristen Marie,0,0,0,0
1668042858299,CSE 291,D00,111343,Savage; Stefan,0,0,0,0
1668042858299,CSE 291,E00,116474,Claffy; Kimberly Claire,0,0,0,0
1668042858299,CSE 291,F00,116479,Pasquale; Joseph,0,0,0,0
1668042858732,CSE 293,001,119111,Bafna; Vineet,9999,0,9999,0
1668042858732,CSE 293,002,119118,Bellare; Mihir,9999,0,9999,0
1668042858732,CSE 293,003,119122,Berg-Kirkpatrick; Taylor D,9999,0,9999,0
1668042858732,CSE 293,004,119135,Christensen; Henrik I,9999,0,9999,0
1668042858732,CSE 293,005,119142,Cottrell; Garrison W,9999,0,9999,0
1668042858732,CSE 293,006,119146,Deutsch; Alin Bernard,9999,0,9999,0
1668042858732,CSE 293,007,119159,Esmaeilzadeh; Hadi,9999,0,9999,0
1668042858732,CSE 293,008,119166,Freund; Yoav,9999,0,9999,0
1668042858732,CSE 293,009,119170,Griswold; William G.,9999,0,9999,0
1668042858732,CSE 293,010,119183,Gymrek; Melissa Ann,9999,0,9999,0
1668042858732,CSE 293,011,119190,Heninger; Nadia A,9999,0,9999,0
1668042858732,CSE 293,012,119230,Impagliazzo; Russell,9999,0,9999,0
1668042858732,CSE 293,013,119232,Jhala; Ranjit,9999,0,9999,0
1668042858732,CSE 293,014,119233,Kahng; Andrew Byun,9999,0,9999,0
1668042858732,CSE 293,015,119298,Kane; Daniel Mertz,9999,0,9999,0
1668042858732,CSE 293,016,119299,Kriegman; David J,9999,0,9999,0
1668042858732,CSE 293,017,119300,Kumar; Arun Kumar,9999,0,9999,0
1668042858732,CSE 293,018,119301,Lerner; Sorin,9999,0,9999,0
1668042858732,CSE 293,019,119302,Lovett; Shachar,9999,0,9999,0
1668042858732,CSE 293,020,119303,McAuley; Julian John,9999,0,9999,0
1668042858732,CSE 293,021,119304,Micciancio; Daniele,9999,0,9999,0
1668042858732,CSE 293,022,119367,Orailoglu; Alex,9999,0,9999,0
1668042858732,CSE 293,023,119382,Paturi; Ramamohan,9999,0,9999,0
1668042858732,CSE 293,024,119404,Polikarpova; Nadezhda,9999,0,9999,0
1668042858732,CSE 293,025,119406,Politz; Joseph Gibbs,9999,0,9999,0
1668042858732,CSE 293,026,119411,Porter; George M,9999,0,9999,0
1668042858732,CSE 293,027,119414,Porter; Leonard Emerson,9999,0,9999,0
1668042858732,CSE 293,028,119416,Ramamoorthi; Ravi,9999,0,9999,0
1668042858732,CSE 293,029,119417,Sahoo; Debashis,9999,0,9999,0
1668042858732,CSE 293,030,119420,Saul; Lawrence,9999,0,9999,0
1668042858732,CSE 293,031,119421,Savage; Stefan,9999,0,9999,0
1668042858732,CSE 293,032,119425,Schulze; Jurgen P.,9999,0,9999,0
1668042858732,CSE 293,033,119426,Snoeren; Alex C.,9999,0,9999,0
1668042858732,CSE 293,034,119428,Shang; Jingbo,9999,0,9999,0
1668042858732,CSE 293,035,119430,Stefan; Deian,9999,0,9999,0
1668042858732,CSE 293,036,119431,Su; Hao,9999,0,9999,0
1668042858732,CSE 293,037,119433,Swanson; Steven James,9999,0,9999,0
1668042858732,CSE 293,038,119435,Tullsen; Dean Michael,9999,0,9999,0
1668042858732,CSE 293,039,119483,Voelker; Geoffrey M.,9999,0,9999,0
1668042858732,CSE 293,040,119537,Zhao; Jishen,9999,0,9999,0
1668042858732,CSE 293,041,119538,Zhou; Yuan-Yuan,9999,0,9999,0
1668042858732,CSE 293,042,119539,Gao; Sicun,9999,0,9999,0
1668042858732,CSE 293,043,119540,Weibel; Nadir,9999,0,9999,0
1668042858732,CSE 293,044,119541,Gupta; Rajesh K.,9999,0,9999,0
1668042858732,CSE 293,045,126410,Vaccaro; Kristen Marie,9999,0,9999,0
1668042858732,CSE 293,046,126411,Klemke; Richard,9999,0,9999,0
1668042859156,CSE 294,A00,102459,Voelker; Geoffrey M.,0,0,0,0
1668042859156,CSE 294,B00,111322,Orailoglu; Alex,0,0,0,0
1668042859592,DSE 201,A00,096914,Deutsch; Alin Bernard,30,0,30,0
1668042860033,DSE 210,A00,096915,Dasgupta; Sanjoy,30,0,30,0
1668042860478,DSE 260A,A00,096916,Altintas De Callaf; Ilkay,30,0,30,0
1668042860921,ECE 200,001,103586,Antipa; Nicholas A,9999,0,9999,0
1668042860921,ECE 200,002,103587,Atanasov; Nikolay A.,9999,0,9999,0
1668042860921,ECE 200,003,103588,Bharadia; Dinesh,9999,0,9999,0
1668042860921,ECE 200,004,103589,Cheng; Chung Kuan,9999,0,9999,0
1668042860921,ECE 200,005,103590,Cosman; Pamela C.,9999,0,9999,0
1668042860921,ECE 200,006,103591,Dayeh; Shadi Ahmad,9999,0,9999,0
1668042860921,ECE 200,007,103592,Fainman; Yeshaiahu,9999,0,9999,0
1668042860921,ECE 200,008,103593,Ford; Joseph Earl,9999,0,9999,0
1668042860921,ECE 200,009,103594,Franceschetti; Massimo,9999,0,9999,0
1668042860921,ECE 200,010,103595,Fullerton; Eric E,9999,0,9999,0
1668042860921,ECE 200,011,103596,Galton; Ian A,9999,0,9999,0
1668042860921,ECE 200,012,103597,Gilja; Vikash,9999,0,9999,0
1668042860921,ECE 200,013,103598,Hall; Drew A.,9999,0,9999,0
1668042860921,ECE 200,014,103599,Hsueh; Tzu-Chien,9999,0,9999,0
1668042860921,ECE 200,015,103600,Javidi; Tara,9999,0,9999,0
1668042860921,ECE 200,016,103601,Kahng; Andrew Byun,9999,0,9999,0
1668042860921,ECE 200,017,103602,Kim; Young-Han,9999,0,9999,0
1668042860921,ECE 200,018,103603,Koushanfar; Farinaz,9999,0,9999,0
1668042860921,ECE 200,019,103604,Kuzum; Duygu,9999,0,9999,0
1668042860921,ECE 200,020,103605,Le; Hanh-Phuc,9999,0,9999,0
1668042860921,ECE 200,021,103606,Lin; Bill,9999,0,9999,0
1668042860921,ECE 200,022,103607,Liu; Zhaowei,9998,0,9999,1
1668042860921,ECE 200,023,103608,Lo; Yu-Hwa,9999,0,9999,0
1668042860921,ECE 200,024,103609,Lomakin; Vitaliy,9999,0,9999,0
1668042860921,ECE 200,025,103610,Mercier; Patrick Philip,9999,0,9999,0
1668042860921,ECE 200,026,103611,Meyer; Florian,9999,0,9999,0
1668042860921,ECE 200,027,103612,Milstein; Laurence B.,9999,0,9999,0
1668042860921,ECE 200,028,103613,Mir Arabbaygi; Siavash,9999,0,9999,0
1668042860921,ECE 200,029,103614,Mookherjea; Shayan,9999,0,9999,0
1668042860921,ECE 200,030,103615,Morris; Karcher William,9999,0,9999,0
1668042860921,ECE 200,031,103616,Ng; Tse Nga,9999,0,9999,0
1668042860921,ECE 200,032,103617,Nguyen; Truong Quang,9999,0,9999,0
1668042860921,ECE 200,033,103618,Nomura; Kenji,9999,0,9999,0
1668042860921,ECE 200,034,103619,Orlitsky; Alon,9999,0,9999,0
1668042860921,ECE 200,035,103620,Pal; Piya,9999,0,9999,0
1668042860921,ECE 200,036,103621,Papen; George C.,9999,0,9999,0
1668042860921,ECE 200,037,103622,Radic; Stojan,9999,0,9999,0
1668042860921,ECE 200,038,103623,Rao; Bhaskar D.,9999,0,9999,0
1668042860921,ECE 200,039,103624,Rao; Ramesh R,9999,0,9999,0
1668042860921,ECE 200,040,103625,Rebeiz; Gabriel,9999,0,9999,0
1668042860921,ECE 200,041,103626,Sanford; John R,9999,0,9999,0
1668042860921,ECE 200,042,103627,Siegel; Paul H.,9999,0,9999,0
1668042860921,ECE 200,043,103628,Sievenpiper; Daniel F.,9999,0,9999,0
1668042860921,ECE 200,044,103629,Sworder; David D.,9999,0,9999,0
1668042860921,ECE 200,045,103630,Taur; Yuan,9999,0,9999,0
1668042860921,ECE 200,046,103631,Touri; Behrouz,9999,0,9999,0
1668042860921,ECE 200,047,103632,Trivedi; Mohan M.,9999,0,9999,0
1668042860921,ECE 200,048,103633,Vasconcelos; Nuno,9999,0,9999,0
1668042860921,ECE 200,049,103634,Wang; Xiaolong,9999,0,9999,0
1668042860921,ECE 200,050,103635,Xie; Pengtao,9999,0,9999,0
1668042860921,ECE 200,051,103636,Yip; Michael,9999,0,9999,0
1668042860921,ECE 200,052,103637,Zeger; Kenneth A.,999,0,999,0
1668042860921,ECE 200,053,103638,Zhang; Xinyu,9999,0,9999,0
1668042860921,ECE 200,054,103639,Turakhia; Yatish Girish,9999,0,9999,0
1668042860921,ECE 200,055,103640,Kang; Mingu,9999,0,9999,0
1668042860921,ECE 200,056,103641,Shi; Yuanyuan,9999,0,9999,0
1668042860921,ECE 200,057,103642,Wang; Edward Jay,9999,0,9999,0
1668042860921,ECE 200,058,103643,Zheng; Yang,9999,0,9999,0
1668042861345,ECE 202,A00,103644,Kuzum; Duygu,0,0,0,0
1668042861776,ECE 212BN,A00,103646,Ng; Tse Nga,0,0,0,0
1668042862197,ECE 221,A00,111493,Staff,0,0,0,0
1668042862621,ECE 222B,A00,103647,Lomakin; Vitaliy,0,0,0,0
1668042863047,ECE 230B,A00,103648,Taur; Yuan,0,0,0,0
1668042863482,ECE 238B,A00,103649,Garay; Javier,0,0,0,0
1668042863919,ECE 240B,A00,112900,Fainman; Yeshaiahu,0,0,0,0
1668042864425,ECE 247A,A00,103650,Jokerst; Jesse Vincent,0,0,0,0
1668042864854,ECE 247B,A00,103651,Wang; Joseph,0,0,0,0
1668042865280,ECE 250,A00,103652,Siegel; Paul H.,0,0,0,0
1668042865702,ECE 251A,A00,103654,Rao; Bhaskar D.,0,0,0,0
1668042866149,ECE 257B,A00,103655,Bharadia; Dinesh,0,0,0,0
1668042866589,ECE 258A,A00,103656,Milstein; Laurence B.,0,0,0,0
1668042867027,ECE 260B,A00,103658,Kang; Mingu,0,0,0,0
1668042867451,ECE 264A,A00,103659,Galton; Ian A,0,0,0,0
1668042867887,ECE 265A,A00,103661,Gudem; Prasad S.S.,0,0,0,0
1668042868313,ECE 265D,A00,103662,Gudem; Prasad S.S.,0,0,0,0
1668042868737,ECE 268,A00,103663,Koushanfar; Farinaz,0,0,0,0
1668042869160,ECE 269,A01,103665,Pal; Piya,0,0,0,0
1668042869589,ECE 271B,A00,103666,Vasconcelos; Manuela,0,0,0,0
1668042870022,ECE 276A,A00,103667,Atanasov; Nikolay A.,0,0,0,0
1668042870449,ECE 277,A00,103668,An; Cheolhong,0,0,0,0
1668042870874,ECE 279,A00,117947,Hall; Drew A.,0,0,0,0
1668042871736,ECE 283,A00,103670,Hsueh; Tzu-Chien,0,0,0,0
1668042872163,ECE 284,A00,103671,Turakhia; Yatish Girish,0,0,0,0
1668042872593,ECE 285,A00,103672,Zheng; Yang,0,0,0,0
1668042872593,ECE 285,B00,103673,Sworder; David D.,0,0,0,0
1668042873017,ECE 287,A00,103676,Javidi; Tara,0,0,0,0
1668042873453,MATH 200B,A00,098023,Salehi Golsefidy; Alireza,13,0,15,2
1668042873885,MATH 202B,A00,098024,Rhoades; Brendon Patrick,9,0,15,6
1668042874309,MATH 203B,A00,098025,Oprea; Dragos N.,11,0,15,4
1668042874740,MATH 204B,A00,098026,Sorensen; Claus M,13,0,15,2
1668042875166,MATH 208,A00,098027,Izadi; Elham,7,0,10,3
1668042875591,MATH 209,A00,098028,Pollack; Aaron,10,0,10,0
1668042876018,MATH 211A,A00,112919,Rogalski; Daniel,9,0,10,1
1668042876443,MATH 211B,A00,112920,Seward; Brandon M.,9,0,10,1
1668042876868,MATH 218,A00,098029,Li; Bo,10,0,10,0
1668042877293,MATH 220B,A00,098030,Novak; Jonathan I,13,0,15,2
1668042877714,MATH 221A,A00,098031,Ebenfelt; Peter F,13,0,15,2
1668042878138,MATH 231B,A00,098032,Zlatos; Andrej,12,0,15,3
1668042878564,MATH 240B,A00,098033,Ni; Lei,9,0,15,6
1668042878990,MATH 243,A00,098034,Jekel; David Andrew,10,0,10,0
1668042879418,MATH 245A,A00,098035,Nie; Jiawang,0,0,15,16
1668042879844,MATH 248,A00,098036,Bejenaru; Ioan,10,0,10,0
1668042880268,MATH 250B,A00,098037,Spolaor; Luca,14,0,15,1
1668042880693,MATH 258,A00,098038,Ni; Lei,10,0,10,0
1668042881124,MATH 264B,A00,098041,Rhoades; Brendon Patrick,10,0,15,5
1668042881554,MATH 268,A00,098042,Buss; Samuel R,10,0,10,0
1668042881985,MATH 269,A00,098043,Rhoades; Brendon Patrick,10,0,10,0
1668042882410,MATH 270B,A00,098044,Li; Bo,11,0,15,4
1668042882838,MATH 272B,A00,098045,Holst; Michael J,13,0,15,2
1668042883263,MATH 273A,A00,098046,Tian; Xiaochuan,10,0,15,5
1668042883685,MATH 275,A01,098048,Tian; Xiaochuan,6,0,10,4
1668042884112,MATH 278A,A00,098049,Holst; Michael J,8,0,10,2
1668042897203,MATH 278B,A00,098050,Cloninger; Alexander,10,0,10,0
1668042897627,MATH 278C,A00,098051,Nie; Jiawang,7,0,10,3
1668042898054,MATH 280B,A00,098052,Zheng; Tianyi,11,0,15,4
1668042898497,MATH 281B,A00,098053,Bradic; Jelena,3,0,15,12
1668042898937,MATH 282B,A00,098054,Arias-Castro; Ery,0,0,15,15
1668042899360,MATH 285,A00,098055,Fitzsimmons; Patrick J,0,0,15,17
1668042899783,MATH 287B,A00,098056,Arias-Castro; Ery,3,0,15,12
1668042900210,MATH 288,A00,098057,Agarwal; Pooja,9,0,10,1
1668042900210,MATH 288,B00,098058,Zhang; Danna,8,0,10,2
1668042900210,MATH 288,C00,098059,Williams; Ruth J,10,0,10,0
1668042900645,MATH 290B,A00,098060,Roberts; Justin Deritter,13,0,15,2
1668042901067,MATH 292,A00,098061,Belmont; Eva Kinoshita,10,0,10,0
1668042901497,MATH 295,A00,098062,Suk; Andrew Hoon,48,0,50,2
1668042901927,MATH 296,A00,098063,Novak; Jonathan I,20,0,20,0
1668042902352,MATH 297,001,098064,Gamst; Anthony Collins,9997,0,9999,2
1668043406700,COGS 205,A00,101395,Chiba; Andrea,19,0,20,1
1668043407127,COGS 210B,001,101404,Greene; Deanna Jacquelyn,9998,0,9999,1
1668043407127,COGS 210B,002,101417,Xia; Haijun,9999,0,9999,0
1668043407127,COGS 210B,003,101422,Nitz; Douglas A.,9999,0,9999,0
1668043407127,COGS 210B,004,101423,Hollan; James D.,9998,0,9999,1
1668043407127,COGS 210B,005,101424,Deak; Gedeon O.,9998,0,9999,1
1668043407127,COGS 210B,006,101425,Rossano; Federico,9999,0,9999,0
1668043407561,COGS 211B,A00,101427,Coulson; Seana M,9996,0,9999,3
1668043407985,COGS 220,A00,101428,Hollan; James D.,0,0,25,25
1668043408418,COGS 229,A00,101429,Dow; Steven P,18,0,25,7
1668043408850,COGS 230,A00,101430,Klemmer; Scott R,13,0,17,4
1668043409274,COGS 234,A00,101431,Xia; Haijun,4,0,25,21
1668043409701,COGS 260,A00,101432,Kiyonaga; Anastasia,19,0,25,6
1668043409701,COGS 260,B00,101433,Kirsh; David Joel,16,0,25,9
1668043410249,CSE 202,A00,102371,Impagliazzo; Russell,0,0,0,0
1668043410677,CSE 203B,A01,102373,Cheng; Chung Kuan,0,0,0,0
1668043411101,CSE 208,A00,102374,Micciancio; Daniele,0,0,0,0
1668043411536,CSE 209A,A00,112895,Impagliazzo; Russell,0,0,15,15
1668043411958,CSE 209B,A00,108005,Bellare; Mihir,0,0,0,0
1668043412379,CSE 210,A00,113163,Coblenz; Michael J,0,0,0,0
1668043412809,CSE 219,A00,106111,Dow; Steven P,0,0,20,20
1668043413234,CSE 221,A00,102376,Voelker; Geoffrey M.,0,0,0,0
1668043413666,CSE 224,A01,102378,Porter; George M,0,0,0,0
1668043414101,CSE 229A,A00,102379,Savage; Stefan,0,0,0,0
1668043414524,CSE 229C,A00,102380,Munyaka; Imani N. S.,0,0,0,0
1668043414968,CSE 232B,A00,102382,Deutsch; Alin Bernard,0,0,0,0
1668043415404,CSE 234,A01,112904,Kumar; Arun Kumar,0,0,0,0
1668043415826,CSE 237A,A00,102383,Rosing; Tajana Simunic,0,0,0,0
1668043416258,CSE 239A,A00,102384,Deutsch; Alin Bernard,0,0,0,0
1668043416685,CSE 239B,A00,102385,Polikarpova; Nadezhda,0,0,0,0
1668043417111,CSE 240A,A00,102386,Pannuto; Patrick William,0,0,0,0
1668043417545,CSE 240B,A00,102387,Zhao; Jishen,0,0,0,0
1668043417966,CSE 241A,A00,106406,Kang; Mingu,0,0,0,0
1668043418392,CSE 249B,A00,102388,Kahng; Andrew Byun,0,0,8,8
1668043418816,CSE 251B,A01,102392,Cottrell; Garrison W,0,0,0,0
1668043418816,CSE 251B,A02,102393,Cottrell; Garrison W,0,0,0,0
1668043419247,CSE 252B,A00,102394,Ochoa; Benjamin Lawrence,0,0,0,0
1668043419675,CSE 257,A01,102396,Gao; Sicun,0,0,0,0
1668043420108,CSE 272,A00,102397,Li; Tzumao,0,0,0,0
1668043420533,CSE 274,A00,111323,Chern; Albert Ren-Haur,0,0,0,0
1668043420958,CSE 282,A00,102398,Pevzner; Pavel Arkadjevich,0,0,0,0
1668043421388,CSE 284,A00,114175,Gymrek; Melissa Ann,0,0,0,0
1668043421817,CSE 290,A00,102399,Chandraker; Manmohan Krishna,0,0,0,0
1668043421817,CSE 290,B00,102400,Vaccaro; Kristen Marie,0,0,25,25
1668043421817,CSE 290,C00,102414,Pannuto; Patrick William,0,0,25,25
1668043421817,CSE 290,D00,102427,Pevzner; Pavel Arkadjevich,0,0,0,0
1668043421817,CSE 290,E00,102429,Zhao; Jishen,0,0,0,0
1668043421817,CSE 290,F00,102436,Tullsen; Dean Michael,0,0,0,0
1668043421817,CSE 290,G00,102440,Christensen; Henrik I,0,0,20,20
1668043422250,CSE 291,A00,102443,Su; Hao,0,0,0,0
1668043422250,CSE 291,B00,102448,Polikarpova; Nadezhda,0,0,0,0
1668043422250,CSE 291,C00,102453,Vaccaro; Kristen Marie,0,0,0,0
1668043422250,CSE 291,D00,111343,Savage; Stefan,0,0,0,0
1668043422250,CSE 291,E00,116474,Claffy; Kimberly Claire,0,0,0,0
1668043422250,CSE 291,F00,116479,Pasquale; Joseph,0,0,0,0
1668043422684,CSE 293,001,119111,Bafna; Vineet,9999,0,9999,0
1668043422684,CSE 293,002,119118,Bellare; Mihir,9999,0,9999,0
1668043422684,CSE 293,003,119122,Berg-Kirkpatrick; Taylor D,9999,0,9999,0
1668043422684,CSE 293,004,119135,Christensen; Henrik I,9999,0,9999,0
1668043422684,CSE 293,005,119142,Cottrell; Garrison W,9999,0,9999,0
1668043422684,CSE 293,006,119146,Deutsch; Alin Bernard,9999,0,9999,0
1668043422684,CSE 293,007,119159,Esmaeilzadeh; Hadi,9999,0,9999,0
1668043422684,CSE 293,008,119166,Freund; Yoav,9999,0,9999,0
1668043422684,CSE 293,009,119170,Griswold; William G.,9999,0,9999,0
1668043422684,CSE 293,010,119183,Gymrek; Melissa Ann,9999,0,9999,0
1668043422684,CSE 293,011,119190,Heninger; Nadia A,9999,0,9999,0
1668043422684,CSE 293,012,119230,Impagliazzo; Russell,9999,0,9999,0
1668043422684,CSE 293,013,119232,Jhala; Ranjit,9999,0,9999,0
1668043422684,CSE 293,014,119233,Kahng; Andrew Byun,9999,0,9999,0
1668043422684,CSE 293,015,119298,Kane; Daniel Mertz,9999,0,9999,0
1668043422684,CSE 293,016,119299,Kriegman; David J,9999,0,9999,0
1668043422684,CSE 293,017,119300,Kumar; Arun Kumar,9999,0,9999,0
1668043422684,CSE 293,018,119301,Lerner; Sorin,9999,0,9999,0
1668043422684,CSE 293,019,119302,Lovett; Shachar,9999,0,9999,0
1668043422684,CSE 293,020,119303,McAuley; Julian John,9999,0,9999,0
1668043422684,CSE 293,021,119304,Micciancio; Daniele,9999,0,9999,0
1668043422684,CSE 293,022,119367,Orailoglu; Alex,9999,0,9999,0
1668043422684,CSE 293,023,119382,Paturi; Ramamohan,9999,0,9999,0
1668043422684,CSE 293,024,119404,Polikarpova; Nadezhda,9999,0,9999,0
1668043422684,CSE 293,025,119406,Politz; Joseph Gibbs,9999,0,9999,0
1668043422684,CSE 293,026,119411,Porter; George M,9999,0,9999,0
1668043422684,CSE 293,027,119414,Porter; Leonard Emerson,9999,0,9999,0
1668043422684,CSE 293,028,119416,Ramamoorthi; Ravi,9999,0,9999,0
1668043422684,CSE 293,029,119417,Sahoo; Debashis,9999,0,9999,0
1668043422684,CSE 293,030,119420,Saul; Lawrence,9999,0,9999,0
1668043422684,CSE 293,031,119421,Savage; Stefan,9999,0,9999,0
1668043422684,CSE 293,032,119425,Schulze; Jurgen P.,9999,0,9999,0
1668043422684,CSE 293,033,119426,Snoeren; Alex C.,9999,0,9999,0
1668043422684,CSE 293,034,119428,Shang; Jingbo,9999,0,9999,0
1668043422684,CSE 293,035,119430,Stefan; Deian,9999,0,9999,0
1668043422684,CSE 293,036,119431,Su; Hao,9999,0,9999,0
1668043422684,CSE 293,037,119433,Swanson; Steven James,9999,0,9999,0
1668043422684,CSE 293,038,119435,Tullsen; Dean Michael,9999,0,9999,0
1668043422684,CSE 293,039,119483,Voelker; Geoffrey M.,9999,0,9999,0
1668043422684,CSE 293,040,119537,Zhao; Jishen,9999,0,9999,0
1668043422684,CSE 293,041,119538,Zhou; Yuan-Yuan,9999,0,9999,0
1668043422684,CSE 293,042,119539,Gao; Sicun,9999,0,9999,0
1668043422684,CSE 293,043,119540,Weibel; Nadir,9999,0,9999,0
1668043422684,CSE 293,044,119541,Gupta; Rajesh K.,9999,0,9999,0
1668043422684,CSE 293,045,126410,Vaccaro; Kristen Marie,9999,0,9999,0
1668043422684,CSE 293,046,126411,Klemke; Richard,9999,0,9999,0
1668043423107,CSE 294,A00,102459,Voelker; Geoffrey M.,0,0,0,0
1668043423107,CSE 294,B00,111322,Orailoglu; Alex,0,0,0,0
1668043423549,DSE 201,A00,096914,Deutsch; Alin Bernard,30,0,30,0
1668043423973,DSE 210,A00,096915,Dasgupta; Sanjoy,30,0,30,0
1668043424397,DSE 260A,A00,096916,Altintas De Callaf; Ilkay,30,0,30,0
1668043424842,ECE 200,001,103586,Antipa; Nicholas A,9999,0,9999,0
1668043424842,ECE 200,002,103587,Atanasov; Nikolay A.,9999,0,9999,0
1668043424842,ECE 200,003,103588,Bharadia; Dinesh,9999,0,9999,0
1668043424842,ECE 200,004,103589,Cheng; Chung Kuan,9999,0,9999,0
1668043424842,ECE 200,005,103590,Cosman; Pamela C.,9999,0,9999,0
1668043424842,ECE 200,006,103591,Dayeh; Shadi Ahmad,9999,0,9999,0
1668043424842,ECE 200,007,103592,Fainman; Yeshaiahu,9999,0,9999,0
1668043424842,ECE 200,008,103593,Ford; Joseph Earl,9999,0,9999,0
1668043424842,ECE 200,009,103594,Franceschetti; Massimo,9999,0,9999,0
1668043424842,ECE 200,010,103595,Fullerton; Eric E,9999,0,9999,0
1668043424842,ECE 200,011,103596,Galton; Ian A,9999,0,9999,0
1668043424842,ECE 200,012,103597,Gilja; Vikash,9999,0,9999,0
1668043424842,ECE 200,013,103598,Hall; Drew A.,9999,0,9999,0
1668043424842,ECE 200,014,103599,Hsueh; Tzu-Chien,9999,0,9999,0
1668043424842,ECE 200,015,103600,Javidi; Tara,9999,0,9999,0
1668043424842,ECE 200,016,103601,Kahng; Andrew Byun,9999,0,9999,0
1668043424842,ECE 200,017,103602,Kim; Young-Han,9999,0,9999,0
1668043424842,ECE 200,018,103603,Koushanfar; Farinaz,9999,0,9999,0
1668043424842,ECE 200,019,103604,Kuzum; Duygu,9999,0,9999,0
1668043424842,ECE 200,020,103605,Le; Hanh-Phuc,9999,0,9999,0
1668043424842,ECE 200,021,103606,Lin; Bill,9999,0,9999,0
1668043424842,ECE 200,022,103607,Liu; Zhaowei,9998,0,9999,1
1668043424842,ECE 200,023,103608,Lo; Yu-Hwa,9999,0,9999,0
1668043424842,ECE 200,024,103609,Lomakin; Vitaliy,9999,0,9999,0
1668043424842,ECE 200,025,103610,Mercier; Patrick Philip,9999,0,9999,0
1668043424842,ECE 200,026,103611,Meyer; Florian,9999,0,9999,0
1668043424842,ECE 200,027,103612,Milstein; Laurence B.,9999,0,9999,0
1668043424842,ECE 200,028,103613,Mir Arabbaygi; Siavash,9999,0,9999,0
1668043424842,ECE 200,029,103614,Mookherjea; Shayan,9999,0,9999,0
1668043424842,ECE 200,030,103615,Morris; Karcher William,9999,0,9999,0
1668043424842,ECE 200,031,103616,Ng; Tse Nga,9999,0,9999,0
1668043424842,ECE 200,032,103617,Nguyen; Truong Quang,9999,0,9999,0
1668043424842,ECE 200,033,103618,Nomura; Kenji,9999,0,9999,0
1668043424842,ECE 200,034,103619,Orlitsky; Alon,9999,0,9999,0
1668043424842,ECE 200,035,103620,Pal; Piya,9999,0,9999,0
1668043424842,ECE 200,036,103621,Papen; George C.,9999,0,9999,0
1668043424842,ECE 200,037,103622,Radic; Stojan,9999,0,9999,0
1668043424842,ECE 200,038,103623,Rao; Bhaskar D.,9999,0,9999,0
1668043424842,ECE 200,039,103624,Rao; Ramesh R,9999,0,9999,0
1668043424842,ECE 200,040,103625,Rebeiz; Gabriel,9999,0,9999,0
1668043424842,ECE 200,041,103626,Sanford; John R,9999,0,9999,0
1668043424842,ECE 200,042,103627,Siegel; Paul H.,9999,0,9999,0
1668043424842,ECE 200,043,103628,Sievenpiper; Daniel F.,9999,0,9999,0
1668043424842,ECE 200,044,103629,Sworder; David D.,9999,0,9999,0
1668043424842,ECE 200,045,103630,Taur; Yuan,9999,0,9999,0
1668043424842,ECE 200,046,103631,Touri; Behrouz,9999,0,9999,0
1668043424842,ECE 200,047,103632,Trivedi; Mohan M.,9999,0,9999,0
1668043424842,ECE 200,048,103633,Vasconcelos; Nuno,9999,0,9999,0
1668043424842,ECE 200,049,103634,Wang; Xiaolong,9999,0,9999,0
1668043424842,ECE 200,050,103635,Xie; Pengtao,9999,0,9999,0
1668043424842,ECE 200,051,103636,Yip; Michael,9999,0,9999,0
1668043424842,ECE 200,052,103637,Zeger; Kenneth A.,999,0,999,0
1668043424842,ECE 200,053,103638,Zhang; Xinyu,9999,0,9999,0
1668043424842,ECE 200,054,103639,Turakhia; Yatish Girish,9999,0,9999,0
1668043424842,ECE 200,055,103640,Kang; Mingu,9999,0,9999,0
1668043424842,ECE 200,056,103641,Shi; Yuanyuan,9999,0,9999,0
1668043424842,ECE 200,057,103642,Wang; Edward Jay,9999,0,9999,0
1668043424842,ECE 200,058,103643,Zheng; Yang,9999,0,9999,0
1668043425268,ECE 202,A00,103644,Kuzum; Duygu,0,0,0,0
1668043425695,ECE 212BN,A00,103646,Ng; Tse Nga,0,0,0,0
1668043426118,ECE 221,A00,111493,Staff,0,0,0,0
1668043426555,ECE 222B,A00,103647,Lomakin; Vitaliy,0,0,0,0
1668043427009,ECE 230B,A00,103648,Taur; Yuan,0,0,0,0
1668043427436,ECE 238B,A00,103649,Garay; Javier,0,0,0,0
1668043427871,ECE 240B,A00,112900,Fainman; Yeshaiahu,0,0,0,0
1668043428300,ECE 247A,A00,103650,Jokerst; Jesse Vincent,0,0,0,0
1668043428731,ECE 247B,A00,103651,Wang; Joseph,0,0,0,0
1668043429162,ECE 250,A00,103652,Siegel; Paul H.,0,0,0,0
1668043429586,ECE 251A,A00,103654,Rao; Bhaskar D.,0,0,0,0
1668043430019,ECE 257B,A00,103655,Bharadia; Dinesh,0,0,0,0
1668043430446,ECE 258A,A00,103656,Milstein; Laurence B.,0,0,0,0
1668043430871,ECE 260B,A00,103658,Kang; Mingu,0,0,0,0
1668043431306,ECE 264A,A00,103659,Galton; Ian A,0,0,0,0
1668043431740,ECE 265A,A00,103661,Gudem; Prasad S.S.,0,0,0,0
1668043432164,ECE 265D,A00,103662,Gudem; Prasad S.S.,0,0,0,0
1668043432594,ECE 268,A00,103663,Koushanfar; Farinaz,0,0,0,0
1668043433019,ECE 269,A01,103665,Pal; Piya,0,0,0,0
1668043433455,ECE 271B,A00,103666,Vasconcelos; Manuela,0,0,0,0
1668043433895,ECE 276A,A00,103667,Atanasov; Nikolay A.,0,0,0,0
1668043434323,ECE 277,A00,103668,An; Cheolhong,0,0,0,0
1668043434748,ECE 279,A00,117947,Hall; Drew A.,0,0,0,0
1668043435599,ECE 283,A00,103670,Hsueh; Tzu-Chien,0,0,0,0
1668043436025,ECE 284,A00,103671,Turakhia; Yatish Girish,0,0,0,0
1668043436460,ECE 285,A00,103672,Zheng; Yang,0,0,0,0
1668043436460,ECE 285,B00,103673,Sworder; David D.,0,0,0,0
1668043436886,ECE 287,A00,103676,Javidi; Tara,0,0,0,0
1668043437314,MATH 200B,A00,098023,Salehi Golsefidy; Alireza,13,0,15,2
1668043437765,MATH 202B,A00,098024,Rhoades; Brendon Patrick,9,0,15,6
1668043438188,MATH 203B,A00,098025,Oprea; Dragos N.,11,0,15,4
1668043438617,MATH 204B,A00,098026,Sorensen; Claus M,13,0,15,2
1668043439044,MATH 208,A00,098027,Izadi; Elham,7,0,10,3
1668043439466,MATH 209,A00,098028,Pollack; Aaron,10,0,10,0
1668043439890,MATH 211A,A00,112919,Rogalski; Daniel,9,0,10,1
1668043440317,MATH 211B,A00,112920,Seward; Brandon M.,9,0,10,1
1668043440738,MATH 218,A00,098029,Li; Bo,10,0,10,0
1668043441162,MATH 220B,A00,098030,Novak; Jonathan I,13,0,15,2
1668043441585,MATH 221A,A00,098031,Ebenfelt; Peter F,13,0,15,2
1668043442022,MATH 231B,A00,098032,Zlatos; Andrej,12,0,15,3
1668043442446,MATH 240B,A00,098033,Ni; Lei,9,0,15,6
1668043442872,MATH 243,A00,098034,Jekel; David Andrew,10,0,10,0
1668043443298,MATH 245A,A00,098035,Nie; Jiawang,0,0,15,16
1668043443747,MATH 248,A00,098036,Bejenaru; Ioan,10,0,10,0
1668043444178,MATH 250B,A00,098037,Spolaor; Luca,14,0,15,1
1668043444610,MATH 258,A00,098038,Ni; Lei,10,0,10,0
1668043445142,MATH 264B,A00,098041,Rhoades; Brendon Patrick,10,0,15,5
1668043445567,MATH 268,A00,098042,Buss; Samuel R,10,0,10,0
1668043445997,MATH 269,A00,098043,Rhoades; Brendon Patrick,10,0,10,0
1668043446426,MATH 270B,A00,098044,Li; Bo,11,0,15,4
1668043446850,MATH 272B,A00,098045,Holst; Michael J,13,0,15,2
1668043447282,MATH 273A,A00,098046,Tian; Xiaochuan,10,0,15,5
1668043447737,MATH 275,A01,098048,Tian; Xiaochuan,6,0,10,4
1668043448174,MATH 278A,A00,098049,Holst; Michael J,8,0,10,2
1668043448613,MATH 278B,A00,098050,Cloninger; Alexander,10,0,10,0
1668043449041,MATH 278C,A00,098051,Nie; Jiawang,7,0,10,3
1668043449465,MATH 280B,A00,098052,Zheng; Tianyi,11,0,15,4
1668043449890,MATH 281B,A00,098053,Bradic; Jelena,3,0,15,12
1668043450322,MATH 282B,A00,098054,Arias-Castro; Ery,0,0,15,15
1668043450749,MATH 285,A00,098055,Fitzsimmons; Patrick J,0,0,15,17
1668043451218,MATH 287B,A00,098056,Arias-Castro; Ery,3,0,15,12
1668043451642,MATH 288,A00,098057,Agarwal; Pooja,9,0,10,1
1668043451642,MATH 288,B00,098058,Zhang; Danna,8,0,10,2
1668043451642,MATH 288,C00,098059,Williams; Ruth J,10,0,10,0
1668043452073,MATH 290B,A00,098060,Roberts; Justin Deritter,13,0,15,2
1668043452501,MATH 292,A00,098061,Belmont; Eva Kinoshita,10,0,10,0
1668043452938,MATH 295,A00,098062,Suk; Andrew Hoon,48,0,50,2
1668043453364,MATH 296,A00,098063,Novak; Jonathan I,20,0,20,0
1668043453787,MATH 297,001,098064,Gamst; Anthony Collins,9997,0,9999,2
1668043958787,COGS 205,A00,101395,Chiba; Andrea,19,0,20,1
1668043959211,COGS 210B,001,101404,Greene; Deanna Jacquelyn,9998,0,9999,1
1668043959211,COGS 210B,002,101417,Xia; Haijun,9999,0,9999,0
1668043959211,COGS 210B,003,101422,Nitz; Douglas A.,9999,0,9999,0
1668043959211,COGS 210B,004,101423,Hollan; James D.,9998,0,9999,1
1668043959211,COGS 210B,005,101424,Deak; Gedeon O.,9998,0,9999,1
1668043959211,COGS 210B,006,101425,Rossano; Federico,9999,0,9999,0
1668043959638,COGS 211B,A00,101427,Coulson; Seana M,9996,0,9999,3
1668043960073,COGS 220,A00,101428,Hollan; James D.,0,0,25,25
1668043960502,COGS 229,A00,101429,Dow; Steven P,18,0,25,7
1668043960929,COGS 230,A00,101430,Klemmer; Scott R,13,0,17,4
1668043961358,COGS 234,A00,101431,Xia; Haijun,4,0,25,21
1668043961787,COGS 260,A00,101432,Kiyonaga; Anastasia,19,0,25,6
1668043961787,COGS 260,B00,101433,Kirsh; David Joel,16,0,25,9
1668043962227,CSE 202,A00,102371,Impagliazzo; Russell,0,0,0,0
1668043962666,CSE 203B,A01,102373,Cheng; Chung Kuan,0,0,0,0
1668043963093,CSE 208,A00,102374,Micciancio; Daniele,0,0,0,0
1668043963525,CSE 209A,A00,112895,Impagliazzo; Russell,0,0,15,15
1668043963947,CSE 209B,A00,108005,Bellare; Mihir,0,0,0,0
1668043964373,CSE 210,A00,113163,Coblenz; Michael J,0,0,0,0
1668043964797,CSE 219,A00,106111,Dow; Steven P,0,0,20,20
1668043965222,CSE 221,A00,102376,Voelker; Geoffrey M.,0,0,0,0
1668043965656,CSE 224,A01,102378,Porter; George M,0,0,0,0
1668043966103,CSE 229A,A00,102379,Savage; Stefan,0,0,0,0
1668043966541,CSE 229C,A00,102380,Munyaka; Imani N. S.,0,0,0,0
1668043966965,CSE 232B,A00,102382,Deutsch; Alin Bernard,0,0,0,0
1668043967389,CSE 234,A01,112904,Kumar; Arun Kumar,0,0,0,0
1668043967813,CSE 237A,A00,102383,Rosing; Tajana Simunic,0,0,0,0
1668043968244,CSE 239A,A00,102384,Deutsch; Alin Bernard,0,0,0,0
1668043968667,CSE 239B,A00,102385,Polikarpova; Nadezhda,0,0,0,0
1668043969090,CSE 240A,A00,102386,Pannuto; Patrick William,0,0,0,0
1668043969517,CSE 240B,A00,102387,Zhao; Jishen,0,0,0,0
1668043969940,CSE 241A,A00,106406,Kang; Mingu,0,0,0,0
1668043970473,CSE 249B,A00,102388,Kahng; Andrew Byun,0,0,8,8
1668043970904,CSE 251B,A01,102392,Cottrell; Garrison W,0,0,0,0
1668043970904,CSE 251B,A02,102393,Cottrell; Garrison W,0,0,0,0
1668043971328,CSE 252B,A00,102394,Ochoa; Benjamin Lawrence,0,0,0,0
1668043971754,CSE 257,A01,102396,Gao; Sicun,0,0,0,0
1668043972179,CSE 272,A00,102397,Li; Tzumao,0,0,0,0
1668043972605,CSE 274,A00,111323,Chern; Albert Ren-Haur,0,0,0,0
1668043973042,CSE 282,A00,102398,Pevzner; Pavel Arkadjevich,0,0,0,0
1668043973466,CSE 284,A00,114175,Gymrek; Melissa Ann,0,0,0,0
1668043973894,CSE 290,A00,102399,Chandraker; Manmohan Krishna,0,0,0,0
1668043973894,CSE 290,B00,102400,Vaccaro; Kristen Marie,0,0,25,25
1668043973894,CSE 290,C00,102414,Pannuto; Patrick William,0,0,25,25
1668043973894,CSE 290,D00,102427,Pevzner; Pavel Arkadjevich,0,0,0,0
1668043973894,CSE 290,E00,102429,Zhao; Jishen,0,0,0,0
1668043973894,CSE 290,F00,102436,Tullsen; Dean Michael,0,0,0,0
1668043973894,CSE 290,G00,102440,Christensen; Henrik I,0,0,20,20
1668043974320,CSE 291,A00,102443,Su; Hao,0,0,0,0
1668043974320,CSE 291,B00,102448,Polikarpova; Nadezhda,0,0,0,0
1668043974320,CSE 291,C00,102453,Vaccaro; Kristen Marie,0,0,0,0
1668043974320,CSE 291,D00,111343,Savage; Stefan,0,0,0,0
1668043974320,CSE 291,E00,116474,Claffy; Kimberly Claire,0,0,0,0
1668043974320,CSE 291,F00,116479,Pasquale; Joseph,0,0,0,0
1668043974748,CSE 293,001,119111,Bafna; Vineet,9999,0,9999,0
1668043974748,CSE 293,002,119118,Bellare; Mihir,9999,0,9999,0
1668043974748,CSE 293,003,119122,Berg-Kirkpatrick; Taylor D,9999,0,9999,0
1668043974748,CSE 293,004,119135,Christensen; Henrik I,9999,0,9999,0
1668043974748,CSE 293,005,119142,Cottrell; Garrison W,9999,0,9999,0
1668043974748,CSE 293,006,119146,Deutsch; Alin Bernard,9999,0,9999,0
1668043974748,CSE 293,007,119159,Esmaeilzadeh; Hadi,9999,0,9999,0
1668043974748,CSE 293,008,119166,Freund; Yoav,9999,0,9999,0
1668043974748,CSE 293,009,119170,Griswold; William G.,9999,0,9999,0
1668043974748,CSE 293,010,119183,Gymrek; Melissa Ann,9999,0,9999,0
1668043974748,CSE 293,011,119190,Heninger; Nadia A,9999,0,9999,0
1668043974748,CSE 293,012,119230,Impagliazzo; Russell,9999,0,9999,0
1668043974748,CSE 293,013,119232,Jhala; Ranjit,9999,0,9999,0
1668043974748,CSE 293,014,119233,Kahng; Andrew Byun,9999,0,9999,0
1668043974748,CSE 293,015,119298,Kane; Daniel Mertz,9999,0,9999,0
1668043974748,CSE 293,016,119299,Kriegman; David J,9999,0,9999,0
1668043974748,CSE 293,017,119300,Kumar; Arun Kumar,9999,0,9999,0
1668043974748,CSE 293,018,119301,Lerner; Sorin,9999,0,9999,0
1668043974748,CSE 293,019,119302,Lovett; Shachar,9999,0,9999,0
1668043974748,CSE 293,020,119303,McAuley; Julian John,9999,0,9999,0
1668043974748,CSE 293,021,119304,Micciancio; Daniele,9999,0,9999,0
1668043974748,CSE 293,022,119367,Orailoglu; Alex,9999,0,9999,0
1668043974748,CSE 293,023,119382,Paturi; Ramamohan,9999,0,9999,0
1668043974748,CSE 293,024,119404,Polikarpova; Nadezhda,9999,0,9999,0
1668043974748,CSE 293,025,119406,Politz; Joseph Gibbs,9999,0,9999,0
1668043974748,CSE 293,026,119411,Porter; George M,9999,0,9999,0
1668043974748,CSE 293,027,119414,Porter; Leonard Emerson,9999,0,9999,0
1668043974748,CSE 293,028,119416,Ramamoorthi; Ravi,9999,0,9999,0
1668043974748,CSE 293,029,119417,Sahoo; Debashis,9999,0,9999,0
1668043974748,CSE 293,030,119420,Saul; Lawrence,9999,0,9999,0
1668043974748,CSE 293,031,119421,Savage; Stefan,9999,0,9999,0
1668043974748,CSE 293,032,119425,Schulze; Jurgen P.,9999,0,9999,0
1668043974748,CSE 293,033,119426,Snoeren; Alex C.,9999,0,9999,0
1668043974748,CSE 293,034,119428,Shang; Jingbo,9999,0,9999,0
1668043974748,CSE 293,035,119430,Stefan; Deian,9999,0,9999,0
1668043974748,CSE 293,036,119431,Su; Hao,9999,0,9999,0
1668043974748,CSE 293,037,119433,Swanson; Steven James,9999,0,9999,0
1668043974748,CSE 293,038,119435,Tullsen; Dean Michael,9999,0,9999,0
1668043974748,CSE 293,039,119483,Voelker; Geoffrey M.,9999,0,9999,0
1668043974748,CSE 293,040,119537,Zhao; Jishen,9999,0,9999,0
1668043974748,CSE 293,041,119538,Zhou; Yuan-Yuan,9999,0,9999,0
1668043974748,CSE 293,042,119539,Gao; Sicun,9999,0,9999,0
1668043974748,CSE 293,043,119540,Weibel; Nadir,9999,0,9999,0
1668043974748,CSE 293,044,119541,Gupta; Rajesh K.,9999,0,9999,0
1668043974748,CSE 293,045,126410,Vaccaro; Kristen Marie,9999,0,9999,0
1668043974748,CSE 293,046,126411,Klemke; Richard,9999,0,9999,0
1668043975174,CSE 294,A00,102459,Voelker; Geoffrey M.,0,0,0,0
1668043975174,CSE 294,B00,111322,Orailoglu; Alex,0,0,0,0
1668043975609,DSE 201,A00,096914,Deutsch; Alin Bernard,30,0,30,0
1668043976039,DSE 210,A00,096915,Dasgupta; Sanjoy,30,0,30,0
1668043976462,DSE 260A,A00,096916,Altintas De Callaf; Ilkay,30,0,30,0
1668043976929,ECE 200,001,103586,Antipa; Nicholas A,9999,0,9999,0
1668043976929,ECE 200,002,103587,Atanasov; Nikolay A.,9999,0,9999,0
1668043976929,ECE 200,003,103588,Bharadia; Dinesh,9999,0,9999,0
1668043976929,ECE 200,004,103589,Cheng; Chung Kuan,9999,0,9999,0
1668043976929,ECE 200,005,103590,Cosman; Pamela C.,9999,0,9999,0
1668043976929,ECE 200,006,103591,Dayeh; Shadi Ahmad,9999,0,9999,0
1668043976929,ECE 200,007,103592,Fainman; Yeshaiahu,9999,0,9999,0
1668043976929,ECE 200,008,103593,Ford; Joseph Earl,9999,0,9999,0
1668043976929,ECE 200,009,103594,Franceschetti; Massimo,9999,0,9999,0
1668043976929,ECE 200,010,103595,Fullerton; Eric E,9999,0,9999,0
1668043976929,ECE 200,011,103596,Galton; Ian A,9999,0,9999,0
1668043976929,ECE 200,012,103597,Gilja; Vikash,9999,0,9999,0
1668043976929,ECE 200,013,103598,Hall; Drew A.,9999,0,9999,0
1668043976929,ECE 200,014,103599,Hsueh; Tzu-Chien,9999,0,9999,0
1668043976929,ECE 200,015,103600,Javidi; Tara,9999,0,9999,0
1668043976929,ECE 200,016,103601,Kahng; Andrew Byun,9999,0,9999,0
1668043976929,ECE 200,017,103602,Kim; Young-Han,9999,0,9999,0
1668043976929,ECE 200,018,103603,Koushanfar; Farinaz,9999,0,9999,0
1668043976929,ECE 200,019,103604,Kuzum; Duygu,9999,0,9999,0
1668043976929,ECE 200,020,103605,Le; Hanh-Phuc,9999,0,9999,0
1668043976929,ECE 200,021,103606,Lin; Bill,9999,0,9999,0
1668043976929,ECE 200,022,103607,Liu; Zhaowei,9998,0,9999,1
1668043976929,ECE 200,023,103608,Lo; Yu-Hwa,9999,0,9999,0
1668043976929,ECE 200,024,103609,Lomakin; Vitaliy,9999,0,9999,0
1668043976929,ECE 200,025,103610,Mercier; Patrick Philip,9999,0,9999,0
1668043976929,ECE 200,026,103611,Meyer; Florian,9999,0,9999,0
1668043976929,ECE 200,027,103612,Milstein; Laurence B.,9999,0,9999,0
1668043976929,ECE 200,028,103613,Mir Arabbaygi; Siavash,9999,0,9999,0
1668043976929,ECE 200,029,103614,Mookherjea; Shayan,9999,0,9999,0
1668043976929,ECE 200,030,103615,Morris; Karcher William,9999,0,9999,0
1668043976929,ECE 200,031,103616,Ng; Tse Nga,9999,0,9999,0
1668043976929,ECE 200,032,103617,Nguyen; Truong Quang,9999,0,9999,0
1668043976929,ECE 200,033,103618,Nomura; Kenji,9999,0,9999,0
1668043976929,ECE 200,034,103619,Orlitsky; Alon,9999,0,9999,0
1668043976929,ECE 200,035,103620,Pal; Piya,9999,0,9999,0
1668043976929,ECE 200,036,103621,Papen; George C.,9999,0,9999,0
1668043976929,ECE 200,037,103622,Radic; Stojan,9999,0,9999,0
1668043976929,ECE 200,038,103623,Rao; Bhaskar D.,9999,0,9999,0
1668043976929,ECE 200,039,103624,Rao; Ramesh R,9999,0,9999,0
1668043976929,ECE 200,040,103625,Rebeiz; Gabriel,9999,0,9999,0
1668043976929,ECE 200,041,103626,Sanford; John R,9999,0,9999,0
1668043976929,ECE 200,042,103627,Siegel; Paul H.,9999,0,9999,0
1668043976929,ECE 200,043,103628,Sievenpiper; Daniel F.,9999,0,9999,0
1668043976929,ECE 200,044,103629,Sworder; David D.,9999,0,9999,0
1668043976929,ECE 200,045,103630,Taur; Yuan,9999,0,9999,0
1668043976929,ECE 200,046,103631,Touri; Behrouz,9999,0,9999,0
1668043976929,ECE 200,047,103632,Trivedi; Mohan M.,9999,0,9999,0
1668043976929,ECE 200,048,103633,Vasconcelos; Nuno,9999,0,9999,0
1668043976929,ECE 200,049,103634,Wang; Xiaolong,9999,0,9999,0
1668043976929,ECE 200,050,103635,Xie; Pengtao,9999,0,9999,0
1668043976929,ECE 200,051,103636,Yip; Michael,9999,0,9999,0
1668043976929,ECE 200,052,103637,Zeger; Kenneth A.,999,0,999,0
1668043976929,ECE 200,053,103638,Zhang; Xinyu,9999,0,9999,0
1668043976929,ECE 200,054,103639,Turakhia; Yatish Girish,9999,0,9999,0
1668043976929,ECE 200,055,103640,Kang; Mingu,9999,0,9999,0
1668043976929,ECE 200,056,103641,Shi; Yuanyuan,9999,0,9999,0
1668043976929,ECE 200,057,103642,Wang; Edward Jay,9999,0,9999,0
1668043976929,ECE 200,058,103643,Zheng; Yang,9999,0,9999,0
1668043977356,ECE 202,A00,103644,Kuzum; Duygu,0,0,0,0
1668043977789,ECE 212BN,A00,103646,Ng; Tse Nga,0,0,0,0
1668043978211,ECE 221,A00,111493,Staff,0,0,0,0
1668043978646,ECE 222B,A00,103647,Lomakin; Vitaliy,0,0,0,0
1668043979090,ECE 230B,A00,103648,Taur; Yuan,0,0,0,0
1668043979516,ECE 238B,A00,103649,Garay; Javier,0,0,0,0
1668043979946,ECE 240B,A00,112900,Fainman; Yeshaiahu,0,0,0,0
1668043980372,ECE 247A,A00,103650,Jokerst; Jesse Vincent,0,0,0,0
1668043980797,ECE 247B,A00,103651,Wang; Joseph,0,0,0,0
1668043981221,ECE 250,A00,103652,Siegel; Paul H.,0,0,0,0
1668043981659,ECE 251A,A00,103654,Rao; Bhaskar D.,0,0,0,0
1668043982082,ECE 257B,A00,103655,Bharadia; Dinesh,0,0,0,0
1668043982511,ECE 258A,A00,103656,Milstein; Laurence B.,0,0,0,0
1668043982942,ECE 260B,A00,103658,Kang; Mingu,0,0,0,0
1668043983377,ECE 264A,A00,103659,Galton; Ian A,0,0,0,0
1668043983801,ECE 265A,A00,103661,Gudem; Prasad S.S.,0,0,0,0
1668043984227,ECE 265D,A00,103662,Gudem; Prasad S.S.,0,0,0,0
1668043984670,ECE 268,A00,103663,Koushanfar; Farinaz,0,0,0,0
1668043985099,ECE 269,A01,103665,Pal; Piya,0,0,0,0
1668043985528,ECE 271B,A00,103666,Vasconcelos; Manuela,0,0,0,0
1668043985951,ECE 276A,A00,103667,Atanasov; Nikolay A.,0,0,0,0
1668043986386,ECE 277,A00,103668,An; Cheolhong,0,0,0,0
1668043986823,ECE 279,A00,117947,Hall; Drew A.,0,0,0,0
1668043987679,ECE 283,A00,103670,Hsueh; Tzu-Chien,0,0,0,0
1668043988101,ECE 284,A00,103671,Turakhia; Yatish Girish,0,0,0,0
1668043988527,ECE 285,A00,103672,Zheng; Yang,0,0,0,0
1668043988527,ECE 285,B00,103673,Sworder; David D.,0,0,0,0
1668043988952,ECE 287,A00,103676,Javidi; Tara,0,0,0,0
1668043989378,MATH 200B,A00,098023,Salehi Golsefidy; Alireza,13,0,15,2
1668043989807,MATH 202B,A00,098024,Rhoades; Brendon Patrick,9,0,15,6
1668043990239,MATH 203B,A00,098025,Oprea; Dragos N.,11,0,15,4
1668043990663,MATH 204B,A00,098026,Sorensen; Claus M,13,0,15,2
1668043991089,MATH 208,A00,098027,Izadi; Elham,7,0,10,3
1668043991515,MATH 209,A00,098028,Pollack; Aaron,10,0,10,0
1668043991940,MATH 211A,A00,112919,Rogalski; Daniel,9,0,10,1
1668043992364,MATH 211B,A00,112920,Seward; Brandon M.,9,0,10,1
1668043992789,MATH 218,A00,098029,Li; Bo,10,0,10,0
1668043993213,MATH 220B,A00,098030,Novak; Jonathan I,13,0,15,2
1668043993639,MATH 221A,A00,098031,Ebenfelt; Peter F,13,0,15,2
1668043994065,MATH 231B,A00,098032,Zlatos; Andrej,12,0,15,3
1668043994497,MATH 240B,A00,098033,Ni; Lei,9,0,15,6
1668043994922,MATH 243,A00,098034,Jekel; David Andrew,10,0,10,0
1668043995347,MATH 245A,A00,098035,Nie; Jiawang,0,0,15,16
1668043995776,MATH 248,A00,098036,Bejenaru; Ioan,10,0,10,0
1668043996201,MATH 250B,A00,098037,Spolaor; Luca,14,0,15,1
1668043996634,MATH 258,A00,098038,Ni; Lei,10,0,10,0
1668043997056,MATH 264B,A00,098041,Rhoades; Brendon Patrick,10,0,15,5
1668043997483,MATH 268,A00,098042,Buss; Samuel R,10,0,10,0
1668043997918,MATH 269,A00,098043,Rhoades; Brendon Patrick,10,0,10,0
1668043998343,MATH 270B,A00,098044,Li; Bo,11,0,15,4
1668043998770,MATH 272B,A00,098045,Holst; Michael J,13,0,15,2
1668043999195,MATH 273A,A00,098046,Tian; Xiaochuan,10,0,15,5
1668043999630,MATH 275,A01,098048,Tian; Xiaochuan,6,0,10,4
1668044000063,MATH 278A,A00,098049,Holst; Michael J,8,0,10,2
1668044000489,MATH 278B,A00,098050,Cloninger; Alexander,10,0,10,0
1668044000916,MATH 278C,A00,098051,Nie; Jiawang,7,0,10,3
1668044001337,MATH 280B,A00,098052,Zheng; Tianyi,11,0,15,4
1668044001764,MATH 281B,A00,098053,Bradic; Jelena,3,0,15,12
1668044002191,MATH 282B,A00,098054,Arias-Castro; Ery,0,0,15,15
1668044002616,MATH 285,A00,098055,Fitzsimmons; Patrick J,0,0,15,17
1668044003047,MATH 287B,A00,098056,Arias-Castro; Ery,3,0,15,12
1668044003492,MATH 288,A00,098057,Agarwal; Pooja,9,0,10,1
1668044003492,MATH 288,B00,098058,Zhang; Danna,8,0,10,2
1668044003492,MATH 288,C00,098059,Williams; Ruth J,10,0,10,0
1668044003916,MATH 290B,A00,098060,Roberts; Justin Deritter,13,0,15,2
1668044004340,MATH 292,A00,098061,Belmont; Eva Kinoshita,10,0,10,0
1668044004767,MATH 295,A00,098062,Suk; Andrew Hoon,48,0,50,2
1668044005198,MATH 296,A00,098063,Novak; Jonathan I,20,0,20,0
1668044005632,MATH 297,001,098064,Gamst; Anthony Collins,9997,0,9999,2
1668044509317,COGS 205,A00,101395,Chiba; Andrea,19,0,20,1
1668044509744,COGS 210B,001,101404,Greene; Deanna Jacquelyn,9998,0,9999,1
1668044509744,COGS 210B,002,101417,Xia; Haijun,9999,0,9999,0
1668044509744,COGS 210B,003,101422,Nitz; Douglas A.,9999,0,9999,0
1668044509744,COGS 210B,004,101423,Hollan; James D.,9998,0,9999,1
1668044509744,COGS 210B,005,101424,Deak; Gedeon O.,9998,0,9999,1
1668044509744,COGS 210B,006,101425,Rossano; Federico,9999,0,9999,0
1668044510167,COGS 211B,A00,101427,Coulson; Seana M,9996,0,9999,3
1668044510603,COGS 220,A00,101428,Hollan; James D.,0,0,25,25
1668044511037,COGS 229,A00,101429,Dow; Steven P,18,0,25,7
1668044511469,COGS 230,A00,101430,Klemmer; Scott R,13,0,17,4
1668044511901,COGS 234,A00,101431,Xia; Haijun,4,0,25,21
1668044512340,COGS 260,A00,101432,Kiyonaga; Anastasia,19,0,25,6
1668044512340,COGS 260,B00,101433,Kirsh; David Joel,16,0,25,9
1668044512768,CSE 202,A00,102371,Impagliazzo; Russell,0,0,0,0
1668044513192,CSE 203B,A01,102373,Cheng; Chung Kuan,0,0,0,0
1668044513623,CSE 208,A00,102374,Micciancio; Daniele,0,0,0,0
1668044514045,CSE 209A,A00,112895,Impagliazzo; Russell,0,0,15,15
1668044514469,CSE 209B,A00,108005,Bellare; Mihir,0,0,0,0
1668044514896,CSE 210,A00,113163,Coblenz; Michael J,0,0,0,0
1668044515326,CSE 219,A00,106111,Dow; Steven P,0,0,20,20
1668044515755,CSE 221,A00,102376,Voelker; Geoffrey M.,0,0,0,0
1668044516186,CSE 224,A01,102378,Porter; George M,0,0,0,0
1668044516608,CSE 229A,A00,102379,Savage; Stefan,0,0,0,0
1668044517048,CSE 229C,A00,102380,Munyaka; Imani N. S.,0,0,0,0
1668044517485,CSE 232B,A00,102382,Deutsch; Alin Bernard,0,0,0,0
1668044517910,CSE 234,A01,112904,Kumar; Arun Kumar,0,0,0,0
1668044518337,CSE 237A,A00,102383,Rosing; Tajana Simunic,0,0,0,0
1668044518761,CSE 239A,A00,102384,Deutsch; Alin Bernard,0,0,0,0
1668044519195,CSE 239B,A00,102385,Polikarpova; Nadezhda,0,0,0,0
1668044519619,CSE 240A,A00,102386,Pannuto; Patrick William,0,0,0,0
1668044520046,CSE 240B,A00,102387,Zhao; Jishen,0,0,0,0
1668044520472,CSE 241A,A00,106406,Kang; Mingu,0,0,0,0
1668044520906,CSE 249B,A00,102388,Kahng; Andrew Byun,0,0,8,8
1668044521335,CSE 251B,A01,102392,Cottrell; Garrison W,0,0,0,0
1668044521335,CSE 251B,A02,102393,Cottrell; Garrison W,0,0,0,0
1668044521769,CSE 252B,A00,102394,Ochoa; Benjamin Lawrence,0,0,0,0
1668044522360,CSE 257,A01,102396,Gao; Sicun,0,0,0,0
1668044522786,CSE 272,A00,102397,Li; Tzumao,0,0,0,0
1668044523211,CSE 274,A00,111323,Chern; Albert Ren-Haur,0,0,0,0
1668044523642,CSE 282,A00,102398,Pevzner; Pavel Arkadjevich,0,0,0,0
1668044524067,CSE 284,A00,114175,Gymrek; Melissa Ann,0,0,0,0
1668044524494,CSE 290,A00,102399,Chandraker; Manmohan Krishna,0,0,0,0
1668044524494,CSE 290,B00,102400,Vaccaro; Kristen Marie,0,0,25,25
1668044524494,CSE 290,C00,102414,Pannuto; Patrick William,0,0,25,25
1668044524494,CSE 290,D00,102427,Pevzner; Pavel Arkadjevich,0,0,0,0
1668044524494,CSE 290,E00,102429,Zhao; Jishen,0,0,0,0
1668044524494,CSE 290,F00,102436,Tullsen; Dean Michael,0,0,0,0
1668044524494,CSE 290,G00,102440,Christensen; Henrik I,0,0,20,20
1668044524919,CSE 291,A00,102443,Su; Hao,0,0,0,0
1668044524919,CSE 291,B00,102448,Polikarpova; Nadezhda,0,0,0,0
1668044524919,CSE 291,C00,102453,Vaccaro; Kristen Marie,0,0,0,0
1668044524919,CSE 291,D00,111343,Savage; Stefan,0,0,0,0
1668044524919,CSE 291,E00,116474,Claffy; Kimberly Claire,0,0,0,0
1668044524919,CSE 291,F00,116479,Pasquale; Joseph,0,0,0,0
1668044525355,CSE 293,001,119111,Bafna; Vineet,9999,0,9999,0
1668044525355,CSE 293,002,119118,Bellare; Mihir,9999,0,9999,0
1668044525355,CSE 293,003,119122,Berg-Kirkpatrick; Taylor D,9999,0,9999,0
1668044525355,CSE 293,004,119135,Christensen; Henrik I,9999,0,9999,0
1668044525355,CSE 293,005,119142,Cottrell; Garrison W,9999,0,9999,0
1668044525355,CSE 293,006,119146,Deutsch; Alin Bernard,9999,0,9999,0
1668044525355,CSE 293,007,119159,Esmaeilzadeh; Hadi,9999,0,9999,0
1668044525355,CSE 293,008,119166,Freund; Yoav,9999,0,9999,0
1668044525355,CSE 293,009,119170,Griswold; William G.,9999,0,9999,0
1668044525355,CSE 293,010,119183,Gymrek; Melissa Ann,9999,0,9999,0
1668044525355,CSE 293,011,119190,Heninger; Nadia A,9999,0,9999,0
1668044525355,CSE 293,012,119230,Impagliazzo; Russell,9999,0,9999,0
1668044525355,CSE 293,013,119232,Jhala; Ranjit,9999,0,9999,0
1668044525355,CSE 293,014,119233,Kahng; Andrew Byun,9999,0,9999,0
1668044525355,CSE 293,015,119298,Kane; Daniel Mertz,9999,0,9999,0
1668044525355,CSE 293,016,119299,Kriegman; David J,9999,0,9999,0
1668044525355,CSE 293,017,119300,Kumar; Arun Kumar,9999,0,9999,0
1668044525355,CSE 293,018,119301,Lerner; Sorin,9999,0,9999,0
1668044525355,CSE 293,019,119302,Lovett; Shachar,9999,0,9999,0
1668044525355,CSE 293,020,119303,McAuley; Julian John,9999,0,9999,0
1668044525355,CSE 293,021,119304,Micciancio; Daniele,9999,0,9999,0
1668044525355,CSE 293,022,119367,Orailoglu; Alex,9999,0,9999,0
1668044525355,CSE 293,023,119382,Paturi; Ramamohan,9999,0,9999,0
1668044525355,CSE 293,024,119404,Polikarpova; Nadezhda,9999,0,9999,0
1668044525355,CSE 293,025,119406,Politz; Joseph Gibbs,9999,0,9999,0
1668044525355,CSE 293,026,119411,Porter; George M,9999,0,9999,0
1668044525355,CSE 293,027,119414,Porter; Leonard Emerson,9999,0,9999,0
1668044525355,CSE 293,028,119416,Ramamoorthi; Ravi,9999,0,9999,0
1668044525355,CSE 293,029,119417,Sahoo; Debashis,9999,0,9999,0
1668044525355,CSE 293,030,119420,Saul; Lawrence,9999,0,9999,0
1668044525355,CSE 293,031,119421,Savage; Stefan,9999,0,9999,0
1668044525355,CSE 293,032,119425,Schulze; Jurgen P.,9999,0,9999,0
1668044525355,CSE 293,033,119426,Snoeren; Alex C.,9999,0,9999,0
1668044525355,CSE 293,034,119428,Shang; Jingbo,9999,0,9999,0
1668044525355,CSE 293,035,119430,Stefan; Deian,9999,0,9999,0
1668044525355,CSE 293,036,119431,Su; Hao,9999,0,9999,0
1668044525355,CSE 293,037,119433,Swanson; Steven James,9999,0,9999,0
1668044525355,CSE 293,038,119435,Tullsen; Dean Michael,9999,0,9999,0
1668044525355,CSE 293,039,119483,Voelker; Geoffrey M.,9999,0,9999,0
1668044525355,CSE 293,040,119537,Zhao; Jishen,9999,0,9999,0
1668044525355,CSE 293,041,119538,Zhou; Yuan-Yuan,9999,0,9999,0
1668044525355,CSE 293,042,119539,Gao; Sicun,9999,0,9999,0
1668044525355,CSE 293,043,119540,Weibel; Nadir,9999,0,9999,0
1668044525355,CSE 293,044,119541,Gupta; Rajesh K.,9999,0,9999,0
1668044525355,CSE 293,045,126410,Vaccaro; Kristen Marie,9999,0,9999,0
1668044525355,CSE 293,046,126411,Klemke; Richard,9999,0,9999,0
1668044525779,CSE 294,A00,102459,Voelker; Geoffrey M.,0,0,0,0
1668044525779,CSE 294,B00,111322,Orailoglu; Alex,0,0,0,0
1668044526208,DSE 201,A00,096914,Deutsch; Alin Bernard,30,0,30,0
1668044526633,DSE 210,A00,096915,Dasgupta; Sanjoy,30,0,30,0
1668044527061,DSE 260A,A00,096916,Altintas De Callaf; Ilkay,30,0,30,0
1668044527521,ECE 200,001,103586,Antipa; Nicholas A,9999,0,9999,0
1668044527521,ECE 200,002,103587,Atanasov; Nikolay A.,9999,0,9999,0
1668044527521,ECE 200,003,103588,Bharadia; Dinesh,9999,0,9999,0
1668044527521,ECE 200,004,103589,Cheng; Chung Kuan,9999,0,9999,0
1668044527521,ECE 200,005,103590,Cosman; Pamela C.,9999,0,9999,0
1668044527521,ECE 200,006,103591,Dayeh; Shadi Ahmad,9999,0,9999,0
1668044527521,ECE 200,007,103592,Fainman; Yeshaiahu,9999,0,9999,0
1668044527521,ECE 200,008,103593,Ford; Joseph Earl,9999,0,9999,0
1668044527521,ECE 200,009,103594,Franceschetti; Massimo,9999,0,9999,0
1668044527521,ECE 200,010,103595,Fullerton; Eric E,9999,0,9999,0
1668044527521,ECE 200,011,103596,Galton; Ian A,9999,0,9999,0
1668044527521,ECE 200,012,103597,Gilja; Vikash,9999,0,9999,0
1668044527521,ECE 200,013,103598,Hall; Drew A.,9999,0,9999,0
1668044527521,ECE 200,014,103599,Hsueh; Tzu-Chien,9999,0,9999,0
1668044527521,ECE 200,015,103600,Javidi; Tara,9999,0,9999,0
1668044527521,ECE 200,016,103601,Kahng; Andrew Byun,9999,0,9999,0
1668044527521,ECE 200,017,103602,Kim; Young-Han,9999,0,9999,0
1668044527521,ECE 200,018,103603,Koushanfar; Farinaz,9999,0,9999,0
1668044527521,ECE 200,019,103604,Kuzum; Duygu,9999,0,9999,0
1668044527521,ECE 200,020,103605,Le; Hanh-Phuc,9999,0,9999,0
1668044527521,ECE 200,021,103606,Lin; Bill,9999,0,9999,0
1668044527521,ECE 200,022,103607,Liu; Zhaowei,9998,0,9999,1
1668044527521,ECE 200,023,103608,Lo; Yu-Hwa,9999,0,9999,0
1668044527521,ECE 200,024,103609,Lomakin; Vitaliy,9999,0,9999,0
1668044527521,ECE 200,025,103610,Mercier; Patrick Philip,9999,0,9999,0
1668044527521,ECE 200,026,103611,Meyer; Florian,9999,0,9999,0
1668044527521,ECE 200,027,103612,Milstein; Laurence B.,9999,0,9999,0
1668044527521,ECE 200,028,103613,Mir Arabbaygi; Siavash,9999,0,9999,0
1668044527521,ECE 200,029,103614,Mookherjea; Shayan,9999,0,9999,0
1668044527521,ECE 200,030,103615,Morris; Karcher William,9999,0,9999,0
1668044527521,ECE 200,031,103616,Ng; Tse Nga,9999,0,9999,0
1668044527521,ECE 200,032,103617,Nguyen; Truong Quang,9999,0,9999,0
1668044527521,ECE 200,033,103618,Nomura; Kenji,9999,0,9999,0
1668044527521,ECE 200,034,103619,Orlitsky; Alon,9999,0,9999,0
1668044527521,ECE 200,035,103620,Pal; Piya,9999,0,9999,0
1668044527521,ECE 200,036,103621,Papen; George C.,9999,0,9999,0
1668044527521,ECE 200,037,103622,Radic; Stojan,9999,0,9999,0
1668044527521,ECE 200,038,103623,Rao; Bhaskar D.,9999,0,9999,0
1668044527521,ECE 200,039,103624,Rao; Ramesh R,9999,0,9999,0
1668044527521,ECE 200,040,103625,Rebeiz; Gabriel,9999,0,9999,0
1668044527521,ECE 200,041,103626,Sanford; John R,9999,0,9999,0
1668044527521,ECE 200,042,103627,Siegel; Paul H.,9999,0,9999,0
1668044527521,ECE 200,043,103628,Sievenpiper; Daniel F.,9999,0,9999,0
1668044527521,ECE 200,044,103629,Sworder; David D.,9999,0,9999,0
1668044527521,ECE 200,045,103630,Taur; Yuan,9999,0,9999,0
1668044527521,ECE 200,046,103631,Touri; Behrouz,9999,0,9999,0
1668044527521,ECE 200,047,103632,Trivedi; Mohan M.,9999,0,9999,0
1668044527521,ECE 200,048,103633,Vasconcelos; Nuno,9999,0,9999,0
1668044527521,ECE 200,049,103634,Wang; Xiaolong,9999,0,9999,0
1668044527521,ECE 200,050,103635,Xie; Pengtao,9999,0,9999,0
1668044527521,ECE 200,051,103636,Yip; Michael,9999,0,9999,0
1668044527521,ECE 200,052,103637,Zeger; Kenneth A.,999,0,999,0
1668044527521,ECE 200,053,103638,Zhang; Xinyu,9999,0,9999,0
1668044527521,ECE 200,054,103639,Turakhia; Yatish Girish,9999,0,9999,0
1668044527521,ECE 200,055,103640,Kang; Mingu,9999,0,9999,0
1668044527521,ECE 200,056,103641,Shi; Yuanyuan,9999,0,9999,0
1668044527521,ECE 200,057,103642,Wang; Edward Jay,9999,0,9999,0
1668044527521,ECE 200,058,103643,Zheng; Yang,9999,0,9999,0
1668044527977,ECE 202,A00,103644,Kuzum; Duygu,0,0,0,0
1668044528411,ECE 212BN,A00,103646,Ng; Tse Nga,0,0,0,0
1668044528845,ECE 221,A00,111493,Staff,0,0,0,0
1668044529273,ECE 222B,A00,103647,Lomakin; Vitaliy,0,0,0,0
1668044529695,ECE 230B,A00,103648,Taur; Yuan,0,0,0,0
1668044530129,ECE 238B,A00,103649,Garay; Javier,0,0,0,0
1668044530561,ECE 240B,A00,112900,Fainman; Yeshaiahu,0,0,0,0
1668044530989,ECE 247A,A00,103650,Jokerst; Jesse Vincent,0,0,0,0
1668044531430,ECE 247B,A00,103651,Wang; Joseph,0,0,0,0
1668044531871,ECE 250,A00,103652,Siegel; Paul H.,0,0,0,0
1668044532297,ECE 251A,A00,103654,Rao; Bhaskar D.,0,0,0,0
1668044532732,ECE 257B,A00,103655,Bharadia; Dinesh,0,0,0,0
1668044533155,ECE 258A,A00,103656,Milstein; Laurence B.,0,0,0,0
1668044533583,ECE 260B,A00,103658,Kang; Mingu,0,0,0,0
1668044534021,ECE 264A,A00,103659,Galton; Ian A,0,0,0,0
1668044534467,ECE 265A,A00,103661,Gudem; Prasad S.S.,0,0,0,0
1668044534906,ECE 265D,A00,103662,Gudem; Prasad S.S.,0,0,0,0
1668044535335,ECE 268,A00,103663,Koushanfar; Farinaz,0,0,0,0
1668044535770,ECE 269,A01,103665,Pal; Piya,0,0,0,0
1668044536200,ECE 271B,A00,103666,Vasconcelos; Manuela,0,0,0,0
1668044536635,ECE 276A,A00,103667,Atanasov; Nikolay A.,0,0,0,0
1668044537062,ECE 277,A00,103668,An; Cheolhong,0,0,0,0
1668044537492,ECE 279,A00,117947,Hall; Drew A.,0,0,0,0
1668044538431,ECE 283,A00,103670,Hsueh; Tzu-Chien,0,0,0,0
1668044538867,ECE 284,A00,103671,Turakhia; Yatish Girish,0,0,0,0
1668044539298,ECE 285,A00,103672,Zheng; Yang,0,0,0,0
1668044539298,ECE 285,B00,103673,Sworder; David D.,0,0,0,0
1668044539724,ECE 287,A00,103676,Javidi; Tara,0,0,0,0
1668044540153,MATH 200B,A00,098023,Salehi Golsefidy; Alireza,13,0,15,2
1668044540580,MATH 202B,A00,098024,Rhoades; Brendon Patrick,9,0,15,6
1668044541009,MATH 203B,A00,098025,Oprea; Dragos N.,11,0,15,4
1668044541434,MATH 204B,A00,098026,Sorensen; Claus M,13,0,15,2
1668044541859,MATH 208,A00,098027,Izadi; Elham,7,0,10,3
1668044542283,MATH 209,A00,098028,Pollack; Aaron,10,0,10,0
1668044542706,MATH 211A,A00,112919,Rogalski; Daniel,9,0,10,1
1668044543130,MATH 211B,A00,112920,Seward; Brandon M.,9,0,10,1
1668044543552,MATH 218,A00,098029,Li; Bo,10,0,10,0
1668044543992,MATH 220B,A00,098030,Novak; Jonathan I,13,0,15,2
1668044544423,MATH 221A,A00,098031,Ebenfelt; Peter F,13,0,15,2
1668044544854,MATH 231B,A00,098032,Zlatos; Andrej,12,0,15,3
1668044545281,MATH 240B,A00,098033,Ni; Lei,9,0,15,6
1668044545704,MATH 243,A00,098034,Jekel; David Andrew,10,0,10,0
1668044546131,MATH 245A,A00,098035,Nie; Jiawang,0,0,15,16
1668044546560,MATH 248,A00,098036,Bejenaru; Ioan,10,0,10,0
1668044546983,MATH 250B,A00,098037,Spolaor; Luca,14,0,15,1
1668044547410,MATH 258,A00,098038,Ni; Lei,10,0,10,0
1668044547835,MATH 264B,A00,098041,Rhoades; Brendon Patrick,10,0,15,5
1668044548257,MATH 268,A00,098042,Buss; Samuel R,10,0,10,0
1668044548695,MATH 269,A00,098043,Rhoades; Brendon Patrick,10,0,10,0
1668044549125,MATH 270B,A00,098044,Li; Bo,11,0,15,4
1668044549557,MATH 272B,A00,098045,Holst; Michael J,13,0,15,2
1668044549978,MATH 273A,A00,098046,Tian; Xiaochuan,10,0,15,5
1668044550403,MATH 275,A01,098048,Tian; Xiaochuan,6,0,10,4
1668044550832,MATH 278A,A00,098049,Holst; Michael J,8,0,10,2
1668044551257,MATH 278B,A00,098050,Cloninger; Alexander,10,0,10,0
1668044551681,MATH 278C,A00,098051,Nie; Jiawang,7,0,10,3
1668044552120,MATH 280B,A00,098052,Zheng; Tianyi,11,0,15,4
1668044552544,MATH 281B,A00,098053,Bradic; Jelena,3,0,15,12
1668044552967,MATH 282B,A00,098054,Arias-Castro; Ery,0,0,15,15
1668044553397,MATH 285,A00,098055,Fitzsimmons; Patrick J,0,0,15,17
1668044553824,MATH 287B,A00,098056,Arias-Castro; Ery,3,0,15,12
1668044554251,MATH 288,A00,098057,Agarwal; Pooja,9,0,10,1
1668044554251,MATH 288,B00,098058,Zhang; Danna,8,0,10,2
1668044554251,MATH 288,C00,098059,Williams; Ruth J,10,0,10,0
1668044554677,MATH 290B,A00,098060,Roberts; Justin Deritter,13,0,15,2
1668044555113,MATH 292,A00,098061,Belmont; Eva Kinoshita,10,0,10,0
1668044555538,MATH 295,A00,098062,Suk; Andrew Hoon,48,0,50,2
1668044555964,MATH 296,A00,098063,Novak; Jonathan I,20,0,20,0
1668044556398,MATH 297,001,098064,Gamst; Anthony Collins,9997,0,9999,2
1668045060813,COGS 205,A00,101395,Chiba; Andrea,19,0,20,1
1668045061240,COGS 210B,001,101404,Greene; Deanna Jacquelyn,9998,0,9999,1
1668045061240,COGS 210B,002,101417,Xia; Haijun,9999,0,9999,0
1668045061240,COGS 210B,003,101422,Nitz; Douglas A.,9999,0,9999,0
1668045061240,COGS 210B,004,101423,Hollan; James D.,9998,0,9999,1
1668045061240,COGS 210B,005,101424,Deak; Gedeon O.,9998,0,9999,1
1668045061240,COGS 210B,006,101425,Rossano; Federico,9999,0,9999,0
1668045061665,COGS 211B,A00,101427,Coulson; Seana M,9996,0,9999,3
1668045062098,COGS 220,A00,101428,Hollan; James D.,0,0,25,25
1668045062618,COGS 229,A00,101429,Dow; Steven P,18,0,25,7
1668045063048,COGS 230,A00,101430,Klemmer; Scott R,13,0,17,4
1668045063472,COGS 234,A00,101431,Xia; Haijun,4,0,25,21
1668045063900,COGS 260,A00,101432,Kiyonaga; Anastasia,19,0,25,6
1668045063900,COGS 260,B00,101433,Kirsh; David Joel,16,0,25,9
1668045064323,CSE 202,A00,102371,Impagliazzo; Russell,0,0,0,0
1668045064756,CSE 203B,A01,102373,Cheng; Chung Kuan,0,0,0,0
1668045065190,CSE 208,A00,102374,Micciancio; Daniele,0,0,0,0
1668045065621,CSE 209A,A00,112895,Impagliazzo; Russell,0,0,15,15
1668045066049,CSE 209B,A00,108005,Bellare; Mihir,0,0,0,0
1668045066487,CSE 210,A00,113163,Coblenz; Michael J,0,0,0,0
1668045066925,CSE 219,A00,106111,Dow; Steven P,0,0,20,20
1668045067359,CSE 221,A00,102376,Voelker; Geoffrey M.,0,0,0,0
1668045067785,CSE 224,A01,102378,Porter; George M,0,0,0,0
1668045068210,CSE 229A,A00,102379,Savage; Stefan,0,0,0,0
1668045068631,CSE 229C,A00,102380,Munyaka; Imani N. S.,0,0,0,0
1668045069059,CSE 232B,A00,102382,Deutsch; Alin Bernard,0,0,0,0
1668045069485,CSE 234,A01,112904,Kumar; Arun Kumar,0,0,0,0
1668045069909,CSE 237A,A00,102383,Rosing; Tajana Simunic,0,0,0,0
1668045070337,CSE 239A,A00,102384,Deutsch; Alin Bernard,0,0,0,0
1668045070759,CSE 239B,A00,102385,Polikarpova; Nadezhda,0,0,0,0
1668045071183,CSE 240A,A00,102386,Pannuto; Patrick William,0,0,0,0
1668045071610,CSE 240B,A00,102387,Zhao; Jishen,0,0,0,0
1668045072050,CSE 241A,A00,106406,Kang; Mingu,0,0,0,0
1668045072487,CSE 249B,A00,102388,Kahng; Andrew Byun,0,0,8,8
1668045072912,CSE 251B,A01,102392,Cottrell; Garrison W,0,0,0,0
1668045072912,CSE 251B,A02,102393,Cottrell; Garrison W,0,0,0,0
1668045073340,CSE 252B,A00,102394,Ochoa; Benjamin Lawrence,0,0,0,0
1668045073767,CSE 257,A01,102396,Gao; Sicun,0,0,0,0
1668045074195,CSE 272,A00,102397,Li; Tzumao,0,0,0,0
1668045074622,CSE 274,A00,111323,Chern; Albert Ren-Haur,0,0,0,0
1668045075054,CSE 282,A00,102398,Pevzner; Pavel Arkadjevich,0,0,0,0
1668045075481,CSE 284,A00,114175,Gymrek; Melissa Ann,0,0,0,0
1668045075906,CSE 290,A00,102399,Chandraker; Manmohan Krishna,0,0,0,0
1668045075906,CSE 290,B00,102400,Vaccaro; Kristen Marie,0,0,25,25
1668045075906,CSE 290,C00,102414,Pannuto; Patrick William,0,0,25,25
1668045075906,CSE 290,D00,102427,Pevzner; Pavel Arkadjevich,0,0,0,0
1668045075906,CSE 290,E00,102429,Zhao; Jishen,0,0,0,0
1668045075906,CSE 290,F00,102436,Tullsen; Dean Michael,0,0,0,0
1668045075906,CSE 290,G00,102440,Christensen; Henrik I,0,0,20,20
1668045076344,CSE 291,A00,102443,Su; Hao,0,0,0,0
1668045076344,CSE 291,B00,102448,Polikarpova; Nadezhda,0,0,0,0
1668045076344,CSE 291,C00,102453,Vaccaro; Kristen Marie,0,0,0,0
1668045076344,CSE 291,D00,111343,Savage; Stefan,0,0,0,0
1668045076344,CSE 291,E00,116474,Claffy; Kimberly Claire,0,0,0,0
1668045076344,CSE 291,F00,116479,Pasquale; Joseph,0,0,0,0
1668045076777,CSE 293,001,119111,Bafna; Vineet,9999,0,9999,0
1668045076777,CSE 293,002,119118,Bellare; Mihir,9999,0,9999,0
1668045076777,CSE 293,003,119122,Berg-Kirkpatrick; Taylor D,9999,0,9999,0
1668045076777,CSE 293,004,119135,Christensen; Henrik I,9999,0,9999,0
1668045076777,CSE 293,005,119142,Cottrell; Garrison W,9999,0,9999,0
1668045076777,CSE 293,006,119146,Deutsch; Alin Bernard,9999,0,9999,0
1668045076777,CSE 293,007,119159,Esmaeilzadeh; Hadi,9999,0,9999,0
1668045076777,CSE 293,008,119166,Freund; Yoav,9999,0,9999,0
1668045076777,CSE 293,009,119170,Griswold; William G.,9999,0,9999,0
1668045076777,CSE 293,010,119183,Gymrek; Melissa Ann,9999,0,9999,0
1668045076777,CSE 293,011,119190,Heninger; Nadia A,9999,0,9999,0
1668045076777,CSE 293,012,119230,Impagliazzo; Russell,9999,0,9999,0
1668045076777,CSE 293,013,119232,Jhala; Ranjit,9999,0,9999,0
1668045076777,CSE 293,014,119233,Kahng; Andrew Byun,9999,0,9999,0
1668045076777,CSE 293,015,119298,Kane; Daniel Mertz,9999,0,9999,0
1668045076777,CSE 293,016,119299,Kriegman; David J,9999,0,9999,0
1668045076777,CSE 293,017,119300,Kumar; Arun Kumar,9999,0,9999,0
1668045076777,CSE 293,018,119301,Lerner; Sorin,9999,0,9999,0
1668045076777,CSE 293,019,119302,Lovett; Shachar,9999,0,9999,0
1668045076777,CSE 293,020,119303,McAuley; Julian John,9999,0,9999,0
1668045076777,CSE 293,021,119304,Micciancio; Daniele,9999,0,9999,0
1668045076777,CSE 293,022,119367,Orailoglu; Alex,9999,0,9999,0
1668045076777,CSE 293,023,119382,Paturi; Ramamohan,9999,0,9999,0
1668045076777,CSE 293,024,119404,Polikarpova; Nadezhda,9999,0,9999,0
1668045076777,CSE 293,025,119406,Politz; Joseph Gibbs,9999,0,9999,0
1668045076777,CSE 293,026,119411,Porter; George M,9999,0,9999,0
1668045076777,CSE 293,027,119414,Porter; Leonard Emerson,9999,0,9999,0
1668045076777,CSE 293,028,119416,Ramamoorthi; Ravi,9999,0,9999,0
1668045076777,CSE 293,029,119417,Sahoo; Debashis,9999,0,9999,0
1668045076777,CSE 293,030,119420,Saul; Lawrence,9999,0,9999,0
1668045076777,CSE 293,031,119421,Savage; Stefan,9999,0,9999,0
1668045076777,CSE 293,032,119425,Schulze; Jurgen P.,9999,0,9999,0
1668045076777,CSE 293,033,119426,Snoeren; Alex C.,9999,0,9999,0
1668045076777,CSE 293,034,119428,Shang; Jingbo,9999,0,9999,0
1668045076777,CSE 293,035,119430,Stefan; Deian,9999,0,9999,0
1668045076777,CSE 293,036,119431,Su; Hao,9999,0,9999,0
1668045076777,CSE 293,037,119433,Swanson; Steven James,9999,0,9999,0
1668045076777,CSE 293,038,119435,Tullsen; Dean Michael,9999,0,9999,0
1668045076777,CSE 293,039,119483,Voelker; Geoffrey M.,9999,0,9999,0
1668045076777,CSE 293,040,119537,Zhao; Jishen,9999,0,9999,0
1668045076777,CSE 293,041,119538,Zhou; Yuan-Yuan,9999,0,9999,0
1668045076777,CSE 293,042,119539,Gao; Sicun,9999,0,9999,0
1668045076777,CSE 293,043,119540,Weibel; Nadir,9999,0,9999,0
1668045076777,CSE 293,044,119541,Gupta; Rajesh K.,9999,0,9999,0
1668045076777,CSE 293,045,126410,Vaccaro; Kristen Marie,9999,0,9999,0
1668045076777,CSE 293,046,126411,Klemke; Richard,9999,0,9999,0
1668045077216,CSE 294,A00,102459,Voelker; Geoffrey M.,0,0,0,0
1668045077216,CSE 294,B00,111322,Orailoglu; Alex,0,0,0,0
1668045077645,DSE 201,A00,096914,Deutsch; Alin Bernard,30,0,30,0
1668045078088,DSE 210,A00,096915,Dasgupta; Sanjoy,30,0,30,0
1668045078518,DSE 260A,A00,096916,Altintas De Callaf; Ilkay,30,0,30,0
1668045078951,ECE 200,001,103586,Antipa; Nicholas A,9999,0,9999,0
1668045078951,ECE 200,002,103587,Atanasov; Nikolay A.,9999,0,9999,0
1668045078951,ECE 200,003,103588,Bharadia; Dinesh,9999,0,9999,0
1668045078951,ECE 200,004,103589,Cheng; Chung Kuan,9999,0,9999,0
1668045078951,ECE 200,005,103590,Cosman; Pamela C.,9999,0,9999,0
1668045078951,ECE 200,006,103591,Dayeh; Shadi Ahmad,9999,0,9999,0
1668045078951,ECE 200,007,103592,Fainman; Yeshaiahu,9999,0,9999,0
1668045078951,ECE 200,008,103593,Ford; Joseph Earl,9999,0,9999,0
1668045078951,ECE 200,009,103594,Franceschetti; Massimo,9999,0,9999,0
1668045078951,ECE 200,010,103595,Fullerton; Eric E,9999,0,9999,0
1668045078951,ECE 200,011,103596,Galton; Ian A,9999,0,9999,0
1668045078951,ECE 200,012,103597,Gilja; Vikash,9999,0,9999,0
1668045078951,ECE 200,013,103598,Hall; Drew A.,9999,0,9999,0
1668045078951,ECE 200,014,103599,Hsueh; Tzu-Chien,9999,0,9999,0
1668045078951,ECE 200,015,103600,Javidi; Tara,9999,0,9999,0
1668045078951,ECE 200,016,103601,Kahng; Andrew Byun,9999,0,9999,0
1668045078951,ECE 200,017,103602,Kim; Young-Han,9999,0,9999,0
1668045078951,ECE 200,018,103603,Koushanfar; Farinaz,9999,0,9999,0
1668045078951,ECE 200,019,103604,Kuzum; Duygu,9999,0,9999,0
1668045078951,ECE 200,020,103605,Le; Hanh-Phuc,9999,0,9999,0
1668045078951,ECE 200,021,103606,Lin; Bill,9999,0,9999,0
1668045078951,ECE 200,022,103607,Liu; Zhaowei,9998,0,9999,1
1668045078951,ECE 200,023,103608,Lo; Yu-Hwa,9999,0,9999,0
1668045078951,ECE 200,024,103609,Lomakin; Vitaliy,9999,0,9999,0
1668045078951,ECE 200,025,103610,Mercier; Patrick Philip,9999,0,9999,0
1668045078951,ECE 200,026,103611,Meyer; Florian,9999,0,9999,0
1668045078951,ECE 200,027,103612,Milstein; Laurence B.,9999,0,9999,0
1668045078951,ECE 200,028,103613,Mir Arabbaygi; Siavash,9999,0,9999,0
1668045078951,ECE 200,029,103614,Mookherjea; Shayan,9999,0,9999,0
1668045078951,ECE 200,030,103615,Morris; Karcher William,9999,0,9999,0
1668045078951,ECE 200,031,103616,Ng; Tse Nga,9999,0,9999,0
1668045078951,ECE 200,032,103617,Nguyen; Truong Quang,9999,0,9999,0
1668045078951,ECE 200,033,103618,Nomura; Kenji,9999,0,9999,0
1668045078951,ECE 200,034,103619,Orlitsky; Alon,9999,0,9999,0
1668045078951,ECE 200,035,103620,Pal; Piya,9999,0,9999,0
1668045078951,ECE 200,036,103621,Papen; George C.,9999,0,9999,0
1668045078951,ECE 200,037,103622,Radic; Stojan,9999,0,9999,0
1668045078951,ECE 200,038,103623,Rao; Bhaskar D.,9999,0,9999,0
1668045078951,ECE 200,039,103624,Rao; Ramesh R,9999,0,9999,0
1668045078951,ECE 200,040,103625,Rebeiz; Gabriel,9999,0,9999,0
1668045078951,ECE 200,041,103626,Sanford; John R,9999,0,9999,0
1668045078951,ECE 200,042,103627,Siegel; Paul H.,9999,0,9999,0
1668045078951,ECE 200,043,103628,Sievenpiper; Daniel F.,9999,0,9999,0
1668045078951,ECE 200,044,103629,Sworder; David D.,9999,0,9999,0
1668045078951,ECE 200,045,103630,Taur; Yuan,9999,0,9999,0
1668045078951,ECE 200,046,103631,Touri; Behrouz,9999,0,9999,0
1668045078951,ECE 200,047,103632,Trivedi; Mohan M.,9999,0,9999,0
1668045078951,ECE 200,048,103633,Vasconcelos; Nuno,9999,0,9999,0
1668045078951,ECE 200,049,103634,Wang; Xiaolong,9999,0,9999,0
1668045078951,ECE 200,050,103635,Xie; Pengtao,9999,0,9999,0
1668045078951,ECE 200,051,103636,Yip; Michael,9999,0,9999,0
1668045078951,ECE 200,052,103637,Zeger; Kenneth A.,999,0,999,0
1668045078951,ECE 200,053,103638,Zhang; Xinyu,9999,0,9999,0
1668045078951,ECE 200,054,103639,Turakhia; Yatish Girish,9999,0,9999,0
1668045078951,ECE 200,055,103640,Kang; Mingu,9999,0,9999,0
1668045078951,ECE 200,056,103641,Shi; Yuanyuan,9999,0,9999,0
1668045078951,ECE 200,057,103642,Wang; Edward Jay,9999,0,9999,0
1668045078951,ECE 200,058,103643,Zheng; Yang,9999,0,9999,0
1668045079378,ECE 202,A00,103644,Kuzum; Duygu,0,0,0,0
1668045079806,ECE 212BN,A00,103646,Ng; Tse Nga,0,0,0,0
1668045080231,ECE 221,A00,111493,Staff,0,0,0,0
1668045080658,ECE 222B,A00,103647,Lomakin; Vitaliy,0,0,0,0
1668045081087,ECE 230B,A00,103648,Taur; Yuan,0,0,0,0
1668045081520,ECE 238B,A00,103649,Garay; Javier,0,0,0,0
1668045081947,ECE 240B,A00,112900,Fainman; Yeshaiahu,0,0,0,0
1668045082374,ECE 247A,A00,103650,Jokerst; Jesse Vincent,0,0,0,0
1668045082804,ECE 247B,A00,103651,Wang; Joseph,0,0,0,0
1668045083230,ECE 250,A00,103652,Siegel; Paul H.,0,0,0,0
1668045083660,ECE 251A,A00,103654,Rao; Bhaskar D.,0,0,0,0
1668045084082,ECE 257B,A00,103655,Bharadia; Dinesh,0,0,0,0
1668045084509,ECE 258A,A00,103656,Milstein; Laurence B.,0,0,0,0
1668045084932,ECE 260B,A00,103658,Kang; Mingu,0,0,0,0
1668045085357,ECE 264A,A00,103659,Galton; Ian A,0,0,0,0
1668045085781,ECE 265A,A00,103661,Gudem; Prasad S.S.,0,0,0,0
1668045086214,ECE 265D,A00,103662,Gudem; Prasad S.S.,0,0,0,0
1668045086638,ECE 268,A00,103663,Koushanfar; Farinaz,0,0,0,0
1668045087078,ECE 269,A01,103665,Pal; Piya,0,0,0,0
1668045087509,ECE 271B,A00,103666,Vasconcelos; Manuela,0,0,0,0
1668045087946,ECE 276A,A00,103667,Atanasov; Nikolay A.,0,0,0,0
1668045088375,ECE 277,A00,103668,An; Cheolhong,0,0,0,0
1668045088800,ECE 279,A00,117947,Hall; Drew A.,0,0,0,0
1668045089664,ECE 283,A00,103670,Hsueh; Tzu-Chien,0,0,0,0
1668045090092,ECE 284,A00,103671,Turakhia; Yatish Girish,0,0,0,0
1668045090522,ECE 285,A00,103672,Zheng; Yang,0,0,0,0
1668045090522,ECE 285,B00,103673,Sworder; David D.,0,0,0,0
1668045090951,ECE 287,A00,103676,Javidi; Tara,0,0,0,0
1668045091378,MATH 200B,A00,098023,Salehi Golsefidy; Alireza,13,0,15,2
1668045091806,MATH 202B,A00,098024,Rhoades; Brendon Patrick,9,0,15,6
1668045092233,MATH 203B,A00,098025,Oprea; Dragos N.,11,0,15,4
1668045092656,MATH 204B,A00,098026,Sorensen; Claus M,13,0,15,2
1668045093088,MATH 208,A00,098027,Izadi; Elham,7,0,10,3
1668045093521,MATH 209,A00,098028,Pollack; Aaron,10,0,10,0
1668045093954,MATH 211A,A00,112919,Rogalski; Daniel,9,0,10,1
1668045094386,MATH 211B,A00,112920,Seward; Brandon M.,9,0,10,1
1668045094809,MATH 218,A00,098029,Li; Bo,10,0,10,0
1668045095236,MATH 220B,A00,098030,Novak; Jonathan I,13,0,15,2
1668045095662,MATH 221A,A00,098031,Ebenfelt; Peter F,13,0,15,2
1668045096086,MATH 231B,A00,098032,Zlatos; Andrej,12,0,15,3
1668045096522,MATH 240B,A00,098033,Ni; Lei,9,0,15,6
1668045096965,MATH 243,A00,098034,Jekel; David Andrew,10,0,10,0
1668045097392,MATH 245A,A00,098035,Nie; Jiawang,0,0,15,16
1668045097819,MATH 248,A00,098036,Bejenaru; Ioan,10,0,10,0
1668045098242,MATH 250B,A00,098037,Spolaor; Luca,14,0,15,1
1668045098668,MATH 258,A00,098038,Ni; Lei,10,0,10,0
1668045099098,MATH 264B,A00,098041,Rhoades; Brendon Patrick,10,0,15,5
1668045099522,MATH 268,A00,098042,Buss; Samuel R,10,0,10,0
1668045099948,MATH 269,A00,098043,Rhoades; Brendon Patrick,10,0,10,0
1668045100374,MATH 270B,A00,098044,Li; Bo,11,0,15,4
1668045100798,MATH 272B,A00,098045,Holst; Michael J,13,0,15,2
1668045101229,MATH 273A,A00,098046,Tian; Xiaochuan,10,0,15,5
1668045101671,MATH 275,A01,098048,Tian; Xiaochuan,6,0,10,4
1668045102094,MATH 278A,A00,098049,Holst; Michael J,8,0,10,2
1668045102522,MATH 278B,A00,098050,Cloninger; Alexander,10,0,10,0
1668045102947,MATH 278C,A00,098051,Nie; Jiawang,7,0,10,3
1668045103387,MATH 280B,A00,098052,Zheng; Tianyi,11,0,15,4
1668045103810,MATH 281B,A00,098053,Bradic; Jelena,3,0,15,12
1668045104244,MATH 282B,A00,098054,Arias-Castro; Ery,0,0,15,15
1668045104670,MATH 285,A00,098055,Fitzsimmons; Patrick J,0,0,15,17
1668045105093,MATH 287B,A00,098056,Arias-Castro; Ery,3,0,15,12
1668045105529,MATH 288,A00,098057,Agarwal; Pooja,9,0,10,1
1668045105529,MATH 288,B00,098058,Zhang; Danna,8,0,10,2
1668045105529,MATH 288,C00,098059,Williams; Ruth J,10,0,10,0
1668045106048,MATH 290B,A00,098060,Roberts; Justin Deritter,13,0,15,2
1668045106470,MATH 292,A00,098061,Belmont; Eva Kinoshita,10,0,10,0
1668045106901,MATH 295,A00,098062,Suk; Andrew Hoon,48,0,50,2
1668045107335,MATH 296,A00,098063,Novak; Jonathan I,20,0,20,0
1668045107760,MATH 297,001,098064,Gamst; Anthony Collins,9997,0,9999,2
1668045626102,COGS 205,A00,101395,Chiba; Andrea,19,0,20,1
1668045626535,COGS 210B,001,101404,Greene; Deanna Jacquelyn,9998,0,9999,1
1668045626535,COGS 210B,002,101417,Xia; Haijun,9999,0,9999,0
1668045626535,COGS 210B,003,101422,Nitz; Douglas A.,9999,0,9999,0
1668045626535,COGS 210B,004,101423,Hollan; James D.,9998,0,9999,1
1668045626535,COGS 210B,005,101424,Deak; Gedeon O.,9998,0,9999,1
1668045626535,COGS 210B,006,101425,Rossano; Federico,9999,0,9999,0
1668045626970,COGS 211B,A00,101427,Coulson; Seana M,9996,0,9999,3
1668045627398,COGS 220,A00,101428,Hollan; James D.,0,0,25,25
1668045627822,COGS 229,A00,101429,Dow; Steven P,18,0,25,7
1668045628247,COGS 230,A00,101430,Klemmer; Scott R,13,0,17,4
1668045628679,COGS 234,A00,101431,Xia; Haijun,4,0,25,21
1668045629107,COGS 260,A00,101432,Kiyonaga; Anastasia,19,0,25,6
1668045629107,COGS 260,B00,101433,Kirsh; David Joel,16,0,25,9
1668045629568,CSE 202,A00,102371,Impagliazzo; Russell,0,0,0,0
1668045630011,CSE 203B,A01,102373,Cheng; Chung Kuan,0,0,0,0
1668045630437,CSE 208,A00,102374,Micciancio; Daniele,0,0,0,0
1668045630876,CSE 209A,A00,112895,Impagliazzo; Russell,0,0,15,15
1668045631312,CSE 209B,A00,108005,Bellare; Mihir,0,0,0,0
1668045631737,CSE 210,A00,113163,Coblenz; Michael J,0,0,0,0
1668045632166,CSE 219,A00,106111,Dow; Steven P,0,0,20,20
1668045632598,CSE 221,A00,102376,Voelker; Geoffrey M.,0,0,0,0
1668045633028,CSE 224,A01,102378,Porter; George M,0,0,0,0
1668045633471,CSE 229A,A00,102379,Savage; Stefan,0,0,0,0
1668045633893,CSE 229C,A00,102380,Munyaka; Imani N. S.,0,0,0,0
1668045634329,CSE 232B,A00,102382,Deutsch; Alin Bernard,0,0,0,0
1668045634755,CSE 234,A01,112904,Kumar; Arun Kumar,0,0,0,0
1668045635178,CSE 237A,A00,102383,Rosing; Tajana Simunic,0,0,0,0
1668045635603,CSE 239A,A00,102384,Deutsch; Alin Bernard,0,0,0,0
1668045636029,CSE 239B,A00,102385,Polikarpova; Nadezhda,0,0,0,0
1668045636454,CSE 240A,A00,102386,Pannuto; Patrick William,0,0,0,0
1668045636879,CSE 240B,A00,102387,Zhao; Jishen,0,0,0,0
1668045637305,CSE 241A,A00,106406,Kang; Mingu,0,0,0,0
1668045637728,CSE 249B,A00,102388,Kahng; Andrew Byun,0,0,8,8
1668045638165,CSE 251B,A01,102392,Cottrell; Garrison W,0,0,0,0
1668045638165,CSE 251B,A02,102393,Cottrell; Garrison W,0,0,0,0
1668045638594,CSE 252B,A00,102394,Ochoa; Benjamin Lawrence,0,0,0,0
1668045639017,CSE 257,A01,102396,Gao; Sicun,0,0,0,0
1668045639442,CSE 272,A00,102397,Li; Tzumao,0,0,0,0
1668045639886,CSE 274,A00,111323,Chern; Albert Ren-Haur,0,0,0,0
1668045640315,CSE 282,A00,102398,Pevzner; Pavel Arkadjevich,0,0,0,0
1668045640747,CSE 284,A00,114175,Gymrek; Melissa Ann,0,0,0,0
1668045641174,CSE 290,A00,102399,Chandraker; Manmohan Krishna,0,0,0,0
1668045641174,CSE 290,B00,102400,Vaccaro; Kristen Marie,0,0,25,25
1668045641174,CSE 290,C00,102414,Pannuto; Patrick William,0,0,25,25
1668045641174,CSE 290,D00,102427,Pevzner; Pavel Arkadjevich,0,0,0,0
1668045641174,CSE 290,E00,102429,Zhao; Jishen,0,0,0,0
1668045641174,CSE 290,F00,102436,Tullsen; Dean Michael,0,0,0,0
1668045641174,CSE 290,G00,102440,Christensen; Henrik I,0,0,20,20
1668045641605,CSE 291,A00,102443,Su; Hao,0,0,0,0
1668045641605,CSE 291,B00,102448,Polikarpova; Nadezhda,0,0,0,0
1668045641605,CSE 291,C00,102453,Vaccaro; Kristen Marie,0,0,0,0
1668045641605,CSE 291,D00,111343,Savage; Stefan,0,0,0,0
1668045641605,CSE 291,E00,116474,Claffy; Kimberly Claire,0,0,0,0
1668045641605,CSE 291,F00,116479,Pasquale; Joseph,0,0,0,0
1668045642059,CSE 293,001,119111,Bafna; Vineet,9999,0,9999,0
1668045642059,CSE 293,002,119118,Bellare; Mihir,9999,0,9999,0
1668045642059,CSE 293,003,119122,Berg-Kirkpatrick; Taylor D,9999,0,9999,0
1668045642059,CSE 293,004,119135,Christensen; Henrik I,9999,0,9999,0
1668045642059,CSE 293,005,119142,Cottrell; Garrison W,9999,0,9999,0
1668045642059,CSE 293,006,119146,Deutsch; Alin Bernard,9999,0,9999,0
1668045642059,CSE 293,007,119159,Esmaeilzadeh; Hadi,9999,0,9999,0
1668045642059,CSE 293,008,119166,Freund; Yoav,9999,0,9999,0
1668045642059,CSE 293,009,119170,Griswold; William G.,9999,0,9999,0
1668045642059,CSE 293,010,119183,Gymrek; Melissa Ann,9999,0,9999,0
1668045642059,CSE 293,011,119190,Heninger; Nadia A,9999,0,9999,0
1668045642059,CSE 293,012,119230,Impagliazzo; Russell,9999,0,9999,0
1668045642059,CSE 293,013,119232,Jhala; Ranjit,9999,0,9999,0
1668045642059,CSE 293,014,119233,Kahng; Andrew Byun,9999,0,9999,0
1668045642059,CSE 293,015,119298,Kane; Daniel Mertz,9999,0,9999,0
1668045642059,CSE 293,016,119299,Kriegman; David J,9999,0,9999,0
1668045642059,CSE 293,017,119300,Kumar; Arun Kumar,9999,0,9999,0
1668045642059,CSE 293,018,119301,Lerner; Sorin,9999,0,9999,0
1668045642059,CSE 293,019,119302,Lovett; Shachar,9999,0,9999,0
1668045642059,CSE 293,020,119303,McAuley; Julian John,9999,0,9999,0
1668045642059,CSE 293,021,119304,Micciancio; Daniele,9999,0,9999,0
1668045642059,CSE 293,022,119367,Orailoglu; Alex,9999,0,9999,0
1668045642059,CSE 293,023,119382,Paturi; Ramamohan,9999,0,9999,0
1668045642059,CSE 293,024,119404,Polikarpova; Nadezhda,9999,0,9999,0
1668045642059,CSE 293,025,119406,Politz; Joseph Gibbs,9999,0,9999,0
1668045642059,CSE 293,026,119411,Porter; George M,9999,0,9999,0
1668045642059,CSE 293,027,119414,Porter; Leonard Emerson,9999,0,9999,0
1668045642059,CSE 293,028,119416,Ramamoorthi; Ravi,9999,0,9999,0
1668045642059,CSE 293,029,119417,Sahoo; Debashis,9999,0,9999,0
1668045642059,CSE 293,030,119420,Saul; Lawrence,9999,0,9999,0
1668045642059,CSE 293,031,119421,Savage; Stefan,9999,0,9999,0
1668045642059,CSE 293,032,119425,Schulze; Jurgen P.,9999,0,9999,0
1668045642059,CSE 293,033,119426,Snoeren; Alex C.,9999,0,9999,0
1668045642059,CSE 293,034,119428,Shang; Jingbo,9999,0,9999,0
1668045642059,CSE 293,035,119430,Stefan; Deian,9999,0,9999,0
1668045642059,CSE 293,036,119431,Su; Hao,9999,0,9999,0
1668045642059,CSE 293,037,119433,Swanson; Steven James,9999,0,9999,0
1668045642059,CSE 293,038,119435,Tullsen; Dean Michael,9999,0,9999,0
1668045642059,CSE 293,039,119483,Voelker; Geoffrey M.,9999,0,9999,0
1668045642059,CSE 293,040,119537,Zhao; Jishen,9999,0,9999,0
1668045642059,CSE 293,041,119538,Zhou; Yuan-Yuan,9999,0,9999,0
1668045642059,CSE 293,042,119539,Gao; Sicun,9999,0,9999,0
1668045642059,CSE 293,043,119540,Weibel; Nadir,9999,0,9999,0
1668045642059,CSE 293,044,119541,Gupta; Rajesh K.,9999,0,9999,0
1668045642059,CSE 293,045,126410,Vaccaro; Kristen Marie,9999,0,9999,0
1668045642059,CSE 293,046,126411,Klemke; Richard,9999,0,9999,0
1668045642495,CSE 294,A00,102459,Voelker; Geoffrey M.,0,0,0,0
1668045642495,CSE 294,B00,111322,Orailoglu; Alex,0,0,0,0
1668045642934,DSE 201,A00,096914,Deutsch; Alin Bernard,30,0,30,0
1668045643358,DSE 210,A00,096915,Dasgupta; Sanjoy,30,0,30,0
1668045643789,DSE 260A,A00,096916,Altintas De Callaf; Ilkay,30,0,30,0
1668045644265,ECE 200,001,103586,Antipa; Nicholas A,9999,0,9999,0
1668045644265,ECE 200,002,103587,Atanasov; Nikolay A.,9999,0,9999,0
1668045644265,ECE 200,003,103588,Bharadia; Dinesh,9999,0,9999,0
1668045644265,ECE 200,004,103589,Cheng; Chung Kuan,9999,0,9999,0
1668045644265,ECE 200,005,103590,Cosman; Pamela C.,9999,0,9999,0
1668045644265,ECE 200,006,103591,Dayeh; Shadi Ahmad,9999,0,9999,0
1668045644265,ECE 200,007,103592,Fainman; Yeshaiahu,9999,0,9999,0
1668045644265,ECE 200,008,103593,Ford; Joseph Earl,9999,0,9999,0
1668045644265,ECE 200,009,103594,Franceschetti; Massimo,9999,0,9999,0
1668045644265,ECE 200,010,103595,Fullerton; Eric E,9999,0,9999,0
1668045644265,ECE 200,011,103596,Galton; Ian A,9999,0,9999,0
1668045644265,ECE 200,012,103597,Gilja; Vikash,9999,0,9999,0
1668045644265,ECE 200,013,103598,Hall; Drew A.,9999,0,9999,0
1668045644265,ECE 200,014,103599,Hsueh; Tzu-Chien,9999,0,9999,0
1668045644265,ECE 200,015,103600,Javidi; Tara,9999,0,9999,0
1668045644265,ECE 200,016,103601,Kahng; Andrew Byun,9999,0,9999,0
1668045644265,ECE 200,017,103602,Kim; Young-Han,9999,0,9999,0
1668045644265,ECE 200,018,103603,Koushanfar; Farinaz,9999,0,9999,0
1668045644265,ECE 200,019,103604,Kuzum; Duygu,9999,0,9999,0
1668045644265,ECE 200,020,103605,Le; Hanh-Phuc,9999,0,9999,0
1668045644265,ECE 200,021,103606,Lin; Bill,9999,0,9999,0
1668045644265,ECE 200,022,103607,Liu; Zhaowei,9998,0,9999,1
1668045644265,ECE 200,023,103608,Lo; Yu-Hwa,9999,0,9999,0
1668045644265,ECE 200,024,103609,Lomakin; Vitaliy,9999,0,9999,0
1668045644265,ECE 200,025,103610,Mercier; Patrick Philip,9999,0,9999,0
1668045644265,ECE 200,026,103611,Meyer; Florian,9999,0,9999,0
1668045644265,ECE 200,027,103612,Milstein; Laurence B.,9999,0,9999,0
1668045644265,ECE 200,028,103613,Mir Arabbaygi; Siavash,9999,0,9999,0
1668045644265,ECE 200,029,103614,Mookherjea; Shayan,9999,0,9999,0
1668045644265,ECE 200,030,103615,Morris; Karcher William,9999,0,9999,0
1668045644265,ECE 200,031,103616,Ng; Tse Nga,9999,0,9999,0
1668045644265,ECE 200,032,103617,Nguyen; Truong Quang,9999,0,9999,0
1668045644265,ECE 200,033,103618,Nomura; Kenji,9999,0,9999,0
1668045644265,ECE 200,034,103619,Orlitsky; Alon,9999,0,9999,0
1668045644265,ECE 200,035,103620,Pal; Piya,9999,0,9999,0
1668045644265,ECE 200,036,103621,Papen; George C.,9999,0,9999,0
1668045644265,ECE 200,037,103622,Radic; Stojan,9999,0,9999,0
1668045644265,ECE 200,038,103623,Rao; Bhaskar D.,9999,0,9999,0
1668045644265,ECE 200,039,103624,Rao; Ramesh R,9999,0,9999,0
1668045644265,ECE 200,040,103625,Rebeiz; Gabriel,9999,0,9999,0
1668045644265,ECE 200,041,103626,Sanford; John R,9999,0,9999,0
1668045644265,ECE 200,042,103627,Siegel; Paul H.,9999,0,9999,0
1668045644265,ECE 200,043,103628,Sievenpiper; Daniel F.,9999,0,9999,0
1668045644265,ECE 200,044,103629,Sworder; David D.,9999,0,9999,0
1668045644265,ECE 200,045,103630,Taur; Yuan,9999,0,9999,0
1668045644265,ECE 200,046,103631,Touri; Behrouz,9999,0,9999,0
1668045644265,ECE 200,047,103632,Trivedi; Mohan M.,9999,0,9999,0
1668045644265,ECE 200,048,103633,Vasconcelos; Nuno,9999,0,9999,0
1668045644265,ECE 200,049,103634,Wang; Xiaolong,9999,0,9999,0
1668045644265,ECE 200,050,103635,Xie; Pengtao,9999,0,9999,0
1668045644265,ECE 200,051,103636,Yip; Michael,9999,0,9999,0
1668045644265,ECE 200,052,103637,Zeger; Kenneth A.,999,0,999,0
1668045644265,ECE 200,053,103638,Zhang; Xinyu,9999,0,9999,0
1668045644265,ECE 200,054,103639,Turakhia; Yatish Girish,9999,0,9999,0
1668045644265,ECE 200,055,103640,Kang; Mingu,9999,0,9999,0
1668045644265,ECE 200,056,103641,Shi; Yuanyuan,9999,0,9999,0
1668045644265,ECE 200,057,103642,Wang; Edward Jay,9999,0,9999,0
1668045644265,ECE 200,058,103643,Zheng; Yang,9999,0,9999,0
1668045644810,ECE 202,A00,103644,Kuzum; Duygu,0,0,0,0
1668045645246,ECE 212BN,A00,103646,Ng; Tse Nga,0,0,0,0
1668045645683,ECE 221,A00,111493,Staff,0,0,0,0
1668045646129,ECE 222B,A00,103647,Lomakin; Vitaliy,0,0,0,0
1668045646552,ECE 230B,A00,103648,Taur; Yuan,0,0,0,0
1668045646991,ECE 238B,A00,103649,Garay; Javier,0,0,0,0
1668045647430,ECE 240B,A00,112900,Fainman; Yeshaiahu,0,0,0,0
1668045647853,ECE 247A,A00,103650,Jokerst; Jesse Vincent,0,0,0,0
1668045648278,ECE 247B,A00,103651,Wang; Joseph,0,0,0,0
1668045648710,ECE 250,A00,103652,Siegel; Paul H.,0,0,0,0
1668045649136,ECE 251A,A00,103654,Rao; Bhaskar D.,0,0,0,0
1668045649558,ECE 257B,A00,103655,Bharadia; Dinesh,0,0,0,0
1668045649983,ECE 258A,A00,103656,Milstein; Laurence B.,0,0,0,0
1668045650411,ECE 260B,A00,103658,Kang; Mingu,0,0,0,0
1668045650835,ECE 264A,A00,103659,Galton; Ian A,0,0,0,0
1668045651262,ECE 265A,A00,103661,Gudem; Prasad S.S.,0,0,0,0
1668045651685,ECE 265D,A00,103662,Gudem; Prasad S.S.,0,0,0,0
1668045652118,ECE 268,A00,103663,Koushanfar; Farinaz,0,0,0,0
1668045652545,ECE 269,A01,103665,Pal; Piya,0,0,0,0
1668045652978,ECE 271B,A00,103666,Vasconcelos; Manuela,0,0,0,0
1668045653401,ECE 276A,A00,103667,Atanasov; Nikolay A.,0,0,0,0
1668045653837,ECE 277,A00,103668,An; Cheolhong,0,0,0,0
1668045654262,ECE 279,A00,117947,Hall; Drew A.,0,0,0,0
1668045655112,ECE 283,A00,103670,Hsueh; Tzu-Chien,0,0,0,0
1668045655542,ECE 284,A00,103671,Turakhia; Yatish Girish,0,0,0,0
1668045655965,ECE 285,A00,103672,Zheng; Yang,0,0,0,0
1668045655965,ECE 285,B00,103673,Sworder; David D.,0,0,0,0
1668045656390,ECE 287,A00,103676,Javidi; Tara,0,0,0,0
1668045656815,MATH 200B,A00,098023,Salehi Golsefidy; Alireza,13,0,15,2
1668045657250,MATH 202B,A00,098024,Rhoades; Brendon Patrick,9,0,15,6
1668045657681,MATH 203B,A00,098025,Oprea; Dragos N.,11,0,15,4
1668045658111,MATH 204B,A00,098026,Sorensen; Claus M,13,0,15,2
1668045658536,MATH 208,A00,098027,Izadi; Elham,7,0,10,3
1668045658958,MATH 209,A00,098028,Pollack; Aaron,10,0,10,0
1668045659394,MATH 211A,A00,112919,Rogalski; Daniel,9,0,10,1
1668045659820,MATH 211B,A00,112920,Seward; Brandon M.,9,0,10,1
1668045660260,MATH 218,A00,098029,Li; Bo,10,0,10,0
1668045660683,MATH 220B,A00,098030,Novak; Jonathan I,13,0,15,2
1668045661110,MATH 221A,A00,098031,Ebenfelt; Peter F,13,0,15,2
1668045661540,MATH 231B,A00,098032,Zlatos; Andrej,12,0,15,3
1668045661963,MATH 240B,A00,098033,Ni; Lei,9,0,15,6
1668045662396,MATH 243,A00,098034,Jekel; David Andrew,10,0,10,0
1668045662828,MATH 245A,A00,098035,Nie; Jiawang,0,0,15,16
1668045663251,MATH 248,A00,098036,Bejenaru; Ioan,10,0,10,0
1668045663678,MATH 250B,A00,098037,Spolaor; Luca,14,0,15,1
1668045664104,MATH 258,A00,098038,Ni; Lei,10,0,10,0
1668045664529,MATH 264B,A00,098041,Rhoades; Brendon Patrick,10,0,15,5
1668045664954,MATH 268,A00,098042,Buss; Samuel R,10,0,10,0
1668045665378,MATH 269,A00,098043,Rhoades; Brendon Patrick,10,0,10,0
1668045665809,MATH 270B,A00,098044,Li; Bo,11,0,15,4
1668045666232,MATH 272B,A00,098045,Holst; Michael J,13,0,15,2
1668045666658,MATH 273A,A00,098046,Tian; Xiaochuan,10,0,15,5
1668045667086,MATH 275,A01,098048,Tian; Xiaochuan,6,0,10,4
1668045667510,MATH 278A,A00,098049,Holst; Michael J,8,0,10,2
1668045667955,MATH 278B,A00,098050,Cloninger; Alexander,10,0,10,0
1668045668377,MATH 278C,A00,098051,Nie; Jiawang,7,0,10,3
1668045668803,MATH 280B,A00,098052,Zheng; Tianyi,10,0,15,5
1668045669232,MATH 281B,A00,098053,Bradic; Jelena,3,0,15,12
1668045669662,MATH 282B,A00,098054,Arias-Castro; Ery,0,0,15,15
1668045670099,MATH 285,A00,098055,Fitzsimmons; Patrick J,0,0,15,17
1668045670530,MATH 287B,A00,098056,Arias-Castro; Ery,3,0,15,12
1668045670965,MATH 288,A00,098057,Agarwal; Pooja,9,0,10,1
1668045670965,MATH 288,B00,098058,Zhang; Danna,8,0,10,2
1668045670965,MATH 288,C00,098059,Williams; Ruth J,10,0,10,0
1668045671388,MATH 290B,A00,098060,Roberts; Justin Deritter,13,0,15,2
1668045671814,MATH 292,A00,098061,Belmont; Eva Kinoshita,10,0,10,0
1668045672246,MATH 295,A00,098062,Suk; Andrew Hoon,48,0,50,2
1668045672680,MATH 296,A00,098063,Novak; Jonathan I,20,0,20,0
1668045673108,MATH 297,001,098064,Gamst; Anthony Collins,9997,0,9999,2
1668046178325,COGS 205,A00,101395,Chiba; Andrea,19,0,20,1
1668046178754,COGS 210B,001,101404,Greene; Deanna Jacquelyn,9998,0,9999,1
1668046178754,COGS 210B,002,101417,Xia; Haijun,9999,0,9999,0
1668046178754,COGS 210B,003,101422,Nitz; Douglas A.,9999,0,9999,0
1668046178754,COGS 210B,004,101423,Hollan; James D.,9998,0,9999,1
1668046178754,COGS 210B,005,101424,Deak; Gedeon O.,9998,0,9999,1
1668046178754,COGS 210B,006,101425,Rossano; Federico,9999,0,9999,0
1668046179177,COGS 211B,A00,101427,Coulson; Seana M,9996,0,9999,3
1668046179607,COGS 220,A00,101428,Hollan; James D.,0,0,25,25
1668046180034,COGS 229,A00,101429,Dow; Steven P,18,0,25,7
1668046180463,COGS 230,A00,101430,Klemmer; Scott R,13,0,17,4
1668046180888,COGS 234,A00,101431,Xia; Haijun,4,0,25,21
1668046181322,COGS 260,A00,101432,Kiyonaga; Anastasia,19,0,25,6
1668046181322,COGS 260,B00,101433,Kirsh; David Joel,16,0,25,9
1668046181749,CSE 202,A00,102371,Impagliazzo; Russell,0,0,0,0
1668046182171,CSE 203B,A01,102373,Cheng; Chung Kuan,0,0,0,0
1668046182598,CSE 208,A00,102374,Micciancio; Daniele,0,0,0,0
1668046183025,CSE 209A,A00,112895,Impagliazzo; Russell,0,0,15,15
1668046183451,CSE 209B,A00,108005,Bellare; Mihir,0,0,0,0
1668046183878,CSE 210,A00,113163,Coblenz; Michael J,0,0,0,0
1668046184304,CSE 219,A00,106111,Dow; Steven P,0,0,20,20
1668046184739,CSE 221,A00,102376,Voelker; Geoffrey M.,0,0,0,0
1668046185170,CSE 224,A01,102378,Porter; George M,0,0,0,0
1668046185609,CSE 229A,A00,102379,Savage; Stefan,0,0,0,0
1668046186036,CSE 229C,A00,102380,Munyaka; Imani N. S.,0,0,0,0
1668046186460,CSE 232B,A00,102382,Deutsch; Alin Bernard,0,0,0,0
1668046186891,CSE 234,A01,112904,Kumar; Arun Kumar,0,0,0,0
1668046187315,CSE 237A,A00,102383,Rosing; Tajana Simunic,0,0,0,0
1668046187738,CSE 239A,A00,102384,Deutsch; Alin Bernard,0,0,0,0
1668046188168,CSE 239B,A00,102385,Polikarpova; Nadezhda,0,0,0,0
1668046188600,CSE 240A,A00,102386,Pannuto; Patrick William,0,0,0,0
1668046189025,CSE 240B,A00,102387,Zhao; Jishen,0,0,0,0
1668046189450,CSE 241A,A00,106406,Kang; Mingu,0,0,0,0
1668046189879,CSE 249B,A00,102388,Kahng; Andrew Byun,0,0,8,8
1668046190310,CSE 251B,A01,102392,Cottrell; Garrison W,0,0,0,0
1668046190310,CSE 251B,A02,102393,Cottrell; Garrison W,0,0,0,0
1668046190734,CSE 252B,A00,102394,Ochoa; Benjamin Lawrence,0,0,0,0
1668046191158,CSE 257,A01,102396,Gao; Sicun,0,0,0,0
1668046191581,CSE 272,A00,102397,Li; Tzumao,0,0,0,0
1668046192009,CSE 274,A00,111323,Chern; Albert Ren-Haur,0,0,0,0
1668046192434,CSE 282,A00,102398,Pevzner; Pavel Arkadjevich,0,0,0,0
1668046192865,CSE 284,A00,114175,Gymrek; Melissa Ann,0,0,0,0
1668046193289,CSE 290,A00,102399,Chandraker; Manmohan Krishna,0,0,0,0
1668046193289,CSE 290,B00,102400,Vaccaro; Kristen Marie,0,0,25,25
1668046193289,CSE 290,C00,102414,Pannuto; Patrick William,0,0,25,25
1668046193289,CSE 290,D00,102427,Pevzner; Pavel Arkadjevich,0,0,0,0
1668046193289,CSE 290,E00,102429,Zhao; Jishen,0,0,0,0
1668046193289,CSE 290,F00,102436,Tullsen; Dean Michael,0,0,0,0
1668046193289,CSE 290,G00,102440,Christensen; Henrik I,0,0,20,20
1668046193712,CSE 291,A00,102443,Su; Hao,0,0,0,0
1668046193712,CSE 291,B00,102448,Polikarpova; Nadezhda,0,0,0,0
1668046193712,CSE 291,C00,102453,Vaccaro; Kristen Marie,0,0,0,0
1668046193712,CSE 291,D00,111343,Savage; Stefan,0,0,0,0
1668046193712,CSE 291,E00,116474,Claffy; Kimberly Claire,0,0,0,0
1668046193712,CSE 291,F00,116479,Pasquale; Joseph,0,0,0,0
1668046194180,CSE 293,001,119111,Bafna; Vineet,9999,0,9999,0
1668046194180,CSE 293,002,119118,Bellare; Mihir,9999,0,9999,0
1668046194180,CSE 293,003,119122,Berg-Kirkpatrick; Taylor D,9999,0,9999,0
1668046194180,CSE 293,004,119135,Christensen; Henrik I,9999,0,9999,0
1668046194180,CSE 293,005,119142,Cottrell; Garrison W,9999,0,9999,0
1668046194180,CSE 293,006,119146,Deutsch; Alin Bernard,9999,0,9999,0
1668046194180,CSE 293,007,119159,Esmaeilzadeh; Hadi,9999,0,9999,0
1668046194180,CSE 293,008,119166,Freund; Yoav,9999,0,9999,0
1668046194180,CSE 293,009,119170,Griswold; William G.,9999,0,9999,0
1668046194180,CSE 293,010,119183,Gymrek; Melissa Ann,9999,0,9999,0
1668046194180,CSE 293,011,119190,Heninger; Nadia A,9999,0,9999,0
1668046194180,CSE 293,012,119230,Impagliazzo; Russell,9999,0,9999,0
1668046194180,CSE 293,013,119232,Jhala; Ranjit,9999,0,9999,0
1668046194180,CSE 293,014,119233,Kahng; Andrew Byun,9999,0,9999,0
1668046194180,CSE 293,015,119298,Kane; Daniel Mertz,9999,0,9999,0
1668046194180,CSE 293,016,119299,Kriegman; David J,9999,0,9999,0
1668046194180,CSE 293,017,119300,Kumar; Arun Kumar,9999,0,9999,0
1668046194180,CSE 293,018,119301,Lerner; Sorin,9999,0,9999,0
1668046194180,CSE 293,019,119302,Lovett; Shachar,9999,0,9999,0
1668046194180,CSE 293,020,119303,McAuley; Julian John,9999,0,9999,0
1668046194180,CSE 293,021,119304,Micciancio; Daniele,9999,0,9999,0
1668046194180,CSE 293,022,119367,Orailoglu; Alex,9999,0,9999,0
1668046194180,CSE 293,023,119382,Paturi; Ramamohan,9999,0,9999,0
1668046194180,CSE 293,024,119404,Polikarpova; Nadezhda,9999,0,9999,0
1668046194180,CSE 293,025,119406,Politz; Joseph Gibbs,9999,0,9999,0
1668046194180,CSE 293,026,119411,Porter; George M,9999,0,9999,0
1668046194180,CSE 293,027,119414,Porter; Leonard Emerson,9999,0,9999,0
1668046194180,CSE 293,028,119416,Ramamoorthi; Ravi,9999,0,9999,0
1668046194180,CSE 293,029,119417,Sahoo; Debashis,9999,0,9999,0
1668046194180,CSE 293,030,119420,Saul; Lawrence,9999,0,9999,0
1668046194180,CSE 293,031,119421,Savage; Stefan,9999,0,9999,0
1668046194180,CSE 293,032,119425,Schulze; Jurgen P.,9999,0,9999,0
1668046194180,CSE 293,033,119426,Snoeren; Alex C.,9999,0,9999,0
1668046194180,CSE 293,034,119428,Shang; Jingbo,9999,0,9999,0
1668046194180,CSE 293,035,119430,Stefan; Deian,9999,0,9999,0
1668046194180,CSE 293,036,119431,Su; Hao,9999,0,9999,0
1668046194180,CSE 293,037,119433,Swanson; Steven James,9999,0,9999,0
1668046194180,CSE 293,038,119435,Tullsen; Dean Michael,9999,0,9999,0
1668046194180,CSE 293,039,119483,Voelker; Geoffrey M.,9999,0,9999,0
1668046194180,CSE 293,040,119537,Zhao; Jishen,9999,0,9999,0
1668046194180,CSE 293,041,119538,Zhou; Yuan-Yuan,9999,0,9999,0
1668046194180,CSE 293,042,119539,Gao; Sicun,9999,0,9999,0
1668046194180,CSE 293,043,119540,Weibel; Nadir,9999,0,9999,0
1668046194180,CSE 293,044,119541,Gupta; Rajesh K.,9999,0,9999,0
1668046194180,CSE 293,045,126410,Vaccaro; Kristen Marie,9999,0,9999,0
1668046194180,CSE 293,046,126411,Klemke; Richard,9999,0,9999,0
1668046194606,CSE 294,A00,102459,Voelker; Geoffrey M.,0,0,0,0
1668046194606,CSE 294,B00,111322,Orailoglu; Alex,0,0,0,0
1668046195033,DSE 201,A00,096914,Deutsch; Alin Bernard,30,0,30,0
1668046195454,DSE 210,A00,096915,Dasgupta; Sanjoy,30,0,30,0
1668046195890,DSE 260A,A00,096916,Altintas De Callaf; Ilkay,30,0,30,0
1668046196336,ECE 200,001,103586,Antipa; Nicholas A,9999,0,9999,0
1668046196336,ECE 200,002,103587,Atanasov; Nikolay A.,9999,0,9999,0
1668046196336,ECE 200,003,103588,Bharadia; Dinesh,9999,0,9999,0
1668046196336,ECE 200,004,103589,Cheng; Chung Kuan,9999,0,9999,0
1668046196336,ECE 200,005,103590,Cosman; Pamela C.,9999,0,9999,0
1668046196336,ECE 200,006,103591,Dayeh; Shadi Ahmad,9999,0,9999,0
1668046196336,ECE 200,007,103592,Fainman; Yeshaiahu,9999,0,9999,0
1668046196336,ECE 200,008,103593,Ford; Joseph Earl,9999,0,9999,0
1668046196336,ECE 200,009,103594,Franceschetti; Massimo,9999,0,9999,0
1668046196336,ECE 200,010,103595,Fullerton; Eric E,9999,0,9999,0
1668046196336,ECE 200,011,103596,Galton; Ian A,9999,0,9999,0
1668046196336,ECE 200,012,103597,Gilja; Vikash,9999,0,9999,0
1668046196336,ECE 200,013,103598,Hall; Drew A.,9999,0,9999,0
1668046196336,ECE 200,014,103599,Hsueh; Tzu-Chien,9999,0,9999,0
1668046196336,ECE 200,015,103600,Javidi; Tara,9999,0,9999,0
1668046196336,ECE 200,016,103601,Kahng; Andrew Byun,9999,0,9999,0
1668046196336,ECE 200,017,103602,Kim; Young-Han,9999,0,9999,0
1668046196336,ECE 200,018,103603,Koushanfar; Farinaz,9999,0,9999,0
1668046196336,ECE 200,019,103604,Kuzum; Duygu,9999,0,9999,0
1668046196336,ECE 200,020,103605,Le; Hanh-Phuc,9999,0,9999,0
1668046196336,ECE 200,021,103606,Lin; Bill,9999,0,9999,0
1668046196336,ECE 200,022,103607,Liu; Zhaowei,9998,0,9999,1
1668046196336,ECE 200,023,103608,Lo; Yu-Hwa,9999,0,9999,0
1668046196336,ECE 200,024,103609,Lomakin; Vitaliy,9999,0,9999,0
1668046196336,ECE 200,025,103610,Mercier; Patrick Philip,9999,0,9999,0
1668046196336,ECE 200,026,103611,Meyer; Florian,9999,0,9999,0
1668046196336,ECE 200,027,103612,Milstein; Laurence B.,9999,0,9999,0
1668046196336,ECE 200,028,103613,Mir Arabbaygi; Siavash,9999,0,9999,0
1668046196336,ECE 200,029,103614,Mookherjea; Shayan,9999,0,9999,0
1668046196336,ECE 200,030,103615,Morris; Karcher William,9999,0,9999,0
1668046196336,ECE 200,031,103616,Ng; Tse Nga,9999,0,9999,0
1668046196336,ECE 200,032,103617,Nguyen; Truong Quang,9999,0,9999,0
1668046196336,ECE 200,033,103618,Nomura; Kenji,9999,0,9999,0
1668046196336,ECE 200,034,103619,Orlitsky; Alon,9999,0,9999,0
1668046196336,ECE 200,035,103620,Pal; Piya,9999,0,9999,0
1668046196336,ECE 200,036,103621,Papen; George C.,9999,0,9999,0
1668046196336,ECE 200,037,103622,Radic; Stojan,9999,0,9999,0
1668046196336,ECE 200,038,103623,Rao; Bhaskar D.,9999,0,9999,0
1668046196336,ECE 200,039,103624,Rao; Ramesh R,9999,0,9999,0
1668046196336,ECE 200,040,103625,Rebeiz; Gabriel,9999,0,9999,0
1668046196336,ECE 200,041,103626,Sanford; John R,9999,0,9999,0
1668046196336,ECE 200,042,103627,Siegel; Paul H.,9999,0,9999,0
1668046196336,ECE 200,043,103628,Sievenpiper; Daniel F.,9999,0,9999,0
1668046196336,ECE 200,044,103629,Sworder; David D.,9999,0,9999,0
1668046196336,ECE 200,045,103630,Taur; Yuan,9999,0,9999,0
1668046196336,ECE 200,046,103631,Touri; Behrouz,9999,0,9999,0
1668046196336,ECE 200,047,103632,Trivedi; Mohan M.,9999,0,9999,0
1668046196336,ECE 200,048,103633,Vasconcelos; Nuno,9999,0,9999,0
1668046196336,ECE 200,049,103634,Wang; Xiaolong,9999,0,9999,0
1668046196336,ECE 200,050,103635,Xie; Pengtao,9999,0,9999,0
1668046196336,ECE 200,051,103636,Yip; Michael,9999,0,9999,0
1668046196336,ECE 200,052,103637,Zeger; Kenneth A.,999,0,999,0
1668046196336,ECE 200,053,103638,Zhang; Xinyu,9999,0,9999,0
1668046196336,ECE 200,054,103639,Turakhia; Yatish Girish,9999,0,9999,0
1668046196336,ECE 200,055,103640,Kang; Mingu,9999,0,9999,0
1668046196336,ECE 200,056,103641,Shi; Yuanyuan,9999,0,9999,0
1668046196336,ECE 200,057,103642,Wang; Edward Jay,9999,0,9999,0
1668046196336,ECE 200,058,103643,Zheng; Yang,9999,0,9999,0
1668046196763,ECE 202,A00,103644,Kuzum; Duygu,0,0,0,0
1668046197197,ECE 212BN,A00,103646,Ng; Tse Nga,0,0,0,0
1668046197617,ECE 221,A00,111493,Staff,0,0,0,0
1668046198042,ECE 222B,A00,103647,Lomakin; Vitaliy,0,0,0,0
1668046198463,ECE 230B,A00,103648,Taur; Yuan,0,0,0,0
1668046198887,ECE 238B,A00,103649,Garay; Javier,0,0,0,0
1668046199311,ECE 240B,A00,112900,Fainman; Yeshaiahu,0,0,0,0
1668046199734,ECE 247A,A00,103650,Jokerst; Jesse Vincent,0,0,0,0
1668046200965,ECE 247B,A00,103651,Wang; Joseph,0,0,0,0
1668046201404,ECE 250,A00,103652,Siegel; Paul H.,0,0,0,0
1668046201829,ECE 251A,A00,103654,Rao; Bhaskar D.,0,0,0,0
1668046202266,ECE 257B,A00,103655,Bharadia; Dinesh,0,0,0,0
1668046202696,ECE 258A,A00,103656,Milstein; Laurence B.,0,0,0,0
1668046203121,ECE 260B,A00,103658,Kang; Mingu,0,0,0,0
1668046203567,ECE 264A,A00,103659,Galton; Ian A,0,0,0,0
1668046203994,ECE 265A,A00,103661,Gudem; Prasad S.S.,0,0,0,0
1668046204431,ECE 265D,A00,103662,Gudem; Prasad S.S.,0,0,0,0
1668046204857,ECE 268,A00,103663,Koushanfar; Farinaz,0,0,0,0
1668046205306,ECE 269,A01,103665,Pal; Piya,0,0,0,0
1668046205732,ECE 271B,A00,103666,Vasconcelos; Manuela,0,0,0,0
1668046206159,ECE 276A,A00,103667,Atanasov; Nikolay A.,0,0,0,0
1668046206585,ECE 277,A00,103668,An; Cheolhong,0,0,0,0
1668046207090,ECE 279,A00,117947,Hall; Drew A.,0,0,0,0
1668046208012,ECE 283,A00,103670,Hsueh; Tzu-Chien,0,0,0,0
1668046208434,ECE 284,A00,103671,Turakhia; Yatish Girish,0,0,0,0
1668046208862,ECE 285,A00,103672,Zheng; Yang,0,0,0,0
1668046208862,ECE 285,B00,103673,Sworder; David D.,0,0,0,0
1668046209530,ECE 287,A00,103676,Javidi; Tara,0,0,0,0
1668046209961,MATH 200B,A00,098023,Salehi Golsefidy; Alireza,13,0,15,2
1668046210389,MATH 202B,A00,098024,Rhoades; Brendon Patrick,9,0,15,6
1668046210818,MATH 203B,A00,098025,Oprea; Dragos N.,11,0,15,4
1668046211321,MATH 204B,A00,098026,Sorensen; Claus M,13,0,15,2
1668046211746,MATH 208,A00,098027,Izadi; Elham,7,0,10,3
1668046212171,MATH 209,A00,098028,Pollack; Aaron,10,0,10,0
1668046212598,MATH 211A,A00,112919,Rogalski; Daniel,9,0,10,1
1668046213024,MATH 211B,A00,112920,Seward; Brandon M.,9,0,10,1
1668046213449,MATH 218,A00,098029,Li; Bo,10,0,10,0
1668046213878,MATH 220B,A00,098030,Novak; Jonathan I,13,0,15,2
1668046214306,MATH 221A,A00,098031,Ebenfelt; Peter F,13,0,15,2
1668046214831,MATH 231B,A00,098032,Zlatos; Andrej,12,0,15,3
1668046215256,MATH 240B,A00,098033,Ni; Lei,9,0,15,6
1668046215690,MATH 243,A00,098034,Jekel; David Andrew,10,0,10,0
1668046216113,MATH 245A,A00,098035,Nie; Jiawang,0,0,15,16
1668046216557,MATH 248,A00,098036,Bejenaru; Ioan,10,0,10,0
1668046216981,MATH 250B,A00,098037,Spolaor; Luca,14,0,15,1
1668046217418,MATH 258,A00,098038,Ni; Lei,10,0,10,0
1668046217845,MATH 264B,A00,098041,Rhoades; Brendon Patrick,10,0,15,5
1668046218269,MATH 268,A00,098042,Buss; Samuel R,10,0,10,0
1668046218696,MATH 269,A00,098043,Rhoades; Brendon Patrick,10,0,10,0
1668046219122,MATH 270B,A00,098044,Li; Bo,11,0,15,4
1668046219561,MATH 272B,A00,098045,Holst; Michael J,13,0,15,2
1668046219983,MATH 273A,A00,098046,Tian; Xiaochuan,10,0,15,5
1668046220406,MATH 275,A01,098048,Tian; Xiaochuan,6,0,10,4
1668046220864,MATH 278A,A00,098049,Holst; Michael J,8,0,10,2
1668046221289,MATH 278B,A00,098050,Cloninger; Alexander,10,0,10,0
1668046221728,MATH 278C,A00,098051,Nie; Jiawang,7,0,10,3
1668046222163,MATH 280B,A00,098052,Zheng; Tianyi,10,0,15,5
1668046222599,MATH 281B,A00,098053,Bradic; Jelena,3,0,15,12
1668046223035,MATH 282B,A00,098054,Arias-Castro; Ery,0,0,15,15
1668046223457,MATH 285,A00,098055,Fitzsimmons; Patrick J,0,0,15,17
1668046223887,MATH 287B,A00,098056,Arias-Castro; Ery,3,0,15,12
1668046224327,MATH 288,A00,098057,Agarwal; Pooja,9,0,10,1
1668046224327,MATH 288,B00,098058,Zhang; Danna,8,0,10,2
1668046224327,MATH 288,C00,098059,Williams; Ruth J,10,0,10,0
1668046224763,MATH 290B,A00,098060,Roberts; Justin Deritter,13,0,15,2
1668046225202,MATH 292,A00,098061,Belmont; Eva Kinoshita,10,0,10,0
1668046225629,MATH 295,A00,098062,Suk; Andrew Hoon,48,0,50,2
1668046226060,MATH 296,A00,098063,Novak; Jonathan I,20,0,20,0
1668046226480,MATH 297,001,098064,Gamst; Anthony Collins,9997,0,9999,2
1668046729584,COGS 205,A00,101395,Chiba; Andrea,19,0,20,1
1668046730020,COGS 210B,001,101404,Greene; Deanna Jacquelyn,9998,0,9999,1
1668046730020,COGS 210B,002,101417,Xia; Haijun,9999,0,9999,0
1668046730020,COGS 210B,003,101422,Nitz; Douglas A.,9999,0,9999,0
1668046730020,COGS 210B,004,101423,Hollan; James D.,9998,0,9999,1
1668046730020,COGS 210B,005,101424,Deak; Gedeon O.,9998,0,9999,1
1668046730020,COGS 210B,006,101425,Rossano; Federico,9999,0,9999,0
1668046730447,COGS 211B,A00,101427,Coulson; Seana M,9996,0,9999,3
1668046730882,COGS 220,A00,101428,Hollan; James D.,0,0,25,25
1668046731317,COGS 229,A00,101429,Dow; Steven P,18,0,25,7
1668046731743,COGS 230,A00,101430,Klemmer; Scott R,13,0,17,4
1668046732178,COGS 234,A00,101431,Xia; Haijun,4,0,25,21
1668046732612,COGS 260,A00,101432,Kiyonaga; Anastasia,19,0,25,6
1668046732612,COGS 260,B00,101433,Kirsh; David Joel,16,0,25,9
1668046733035,CSE 202,A00,102371,Impagliazzo; Russell,0,0,0,0
1668046733460,CSE 203B,A01,102373,Cheng; Chung Kuan,0,0,0,0
1668046733883,CSE 208,A00,102374,Micciancio; Daniele,0,0,0,0
1668046734306,CSE 209A,A00,112895,Impagliazzo; Russell,0,0,15,15
1668046734729,CSE 209B,A00,108005,Bellare; Mihir,0,0,0,0
1668046735155,CSE 210,A00,113163,Coblenz; Michael J,0,0,0,0
1668046735581,CSE 219,A00,106111,Dow; Steven P,0,0,20,20
1668046736005,CSE 221,A00,102376,Voelker; Geoffrey M.,0,0,0,0
1668046736548,CSE 224,A01,102378,Porter; George M,0,0,0,0
1668046736977,CSE 229A,A00,102379,Savage; Stefan,0,0,0,0
1668046737403,CSE 229C,A00,102380,Munyaka; Imani N. S.,0,0,0,0
1668046737830,CSE 232B,A00,102382,Deutsch; Alin Bernard,0,0,0,0
1668046738341,CSE 234,A01,112904,Kumar; Arun Kumar,0,0,0,0
1668046738767,CSE 237A,A00,102383,Rosing; Tajana Simunic,0,0,0,0
1668046739192,CSE 239A,A00,102384,Deutsch; Alin Bernard,0,0,0,0
1668046739615,CSE 239B,A00,102385,Polikarpova; Nadezhda,0,0,0,0
1668046740053,CSE 240A,A00,102386,Pannuto; Patrick William,0,0,0,0
1668046740491,CSE 240B,A00,102387,Zhao; Jishen,0,0,0,0
1668046740915,CSE 241A,A00,106406,Kang; Mingu,0,0,0,0
1668046741342,CSE 249B,A00,102388,Kahng; Andrew Byun,0,0,8,8
1668046741767,CSE 251B,A01,102392,Cottrell; Garrison W,0,0,0,0
1668046741767,CSE 251B,A02,102393,Cottrell; Garrison W,0,0,0,0
1668046742191,CSE 252B,A00,102394,Ochoa; Benjamin Lawrence,0,0,0,0
1668046742624,CSE 257,A01,102396,Gao; Sicun,0,0,0,0
1668046743057,CSE 272,A00,102397,Li; Tzumao,0,0,0,0
1668046743491,CSE 274,A00,111323,Chern; Albert Ren-Haur,0,0,0,0
1668046743917,CSE 282,A00,102398,Pevzner; Pavel Arkadjevich,0,0,0,0
1668046744342,CSE 284,A00,114175,Gymrek; Melissa Ann,0,0,0,0
1668046744775,CSE 290,A00,102399,Chandraker; Manmohan Krishna,0,0,0,0
1668046744775,CSE 290,B00,102400,Vaccaro; Kristen Marie,0,0,25,25
1668046744775,CSE 290,C00,102414,Pannuto; Patrick William,0,0,25,25
1668046744775,CSE 290,D00,102427,Pevzner; Pavel Arkadjevich,0,0,0,0
1668046744775,CSE 290,E00,102429,Zhao; Jishen,0,0,0,0
1668046744775,CSE 290,F00,102436,Tullsen; Dean Michael,0,0,0,0
1668046744775,CSE 290,G00,102440,Christensen; Henrik I,0,0,20,20
1668046745199,CSE 291,A00,102443,Su; Hao,0,0,0,0
1668046745199,CSE 291,B00,102448,Polikarpova; Nadezhda,0,0,0,0
1668046745199,CSE 291,C00,102453,Vaccaro; Kristen Marie,0,0,0,0
1668046745199,CSE 291,D00,111343,Savage; Stefan,0,0,0,0
1668046745199,CSE 291,E00,116474,Claffy; Kimberly Claire,0,0,0,0
1668046745199,CSE 291,F00,116479,Pasquale; Joseph,0,0,0,0
1668046745665,CSE 293,001,119111,Bafna; Vineet,9999,0,9999,0
1668046745665,CSE 293,002,119118,Bellare; Mihir,9999,0,9999,0
1668046745665,CSE 293,003,119122,Berg-Kirkpatrick; Taylor D,9999,0,9999,0
1668046745665,CSE 293,004,119135,Christensen; Henrik I,9999,0,9999,0
1668046745665,CSE 293,005,119142,Cottrell; Garrison W,9999,0,9999,0
1668046745665,CSE 293,006,119146,Deutsch; Alin Bernard,9999,0,9999,0
1668046745665,CSE 293,007,119159,Esmaeilzadeh; Hadi,9999,0,9999,0
1668046745665,CSE 293,008,119166,Freund; Yoav,9999,0,9999,0
1668046745665,CSE 293,009,119170,Griswold; William G.,9999,0,9999,0
1668046745665,CSE 293,010,119183,Gymrek; Melissa Ann,9999,0,9999,0
1668046745665,CSE 293,011,119190,Heninger; Nadia A,9999,0,9999,0
1668046745665,CSE 293,012,119230,Impagliazzo; Russell,9999,0,9999,0
1668046745665,CSE 293,013,119232,Jhala; Ranjit,9999,0,9999,0
1668046745665,CSE 293,014,119233,Kahng; Andrew Byun,9999,0,9999,0
1668046745665,CSE 293,015,119298,Kane; Daniel Mertz,9999,0,9999,0
1668046745665,CSE 293,016,119299,Kriegman; David J,9999,0,9999,0
1668046745665,CSE 293,017,119300,Kumar; Arun Kumar,9999,0,9999,0
1668046745665,CSE 293,018,119301,Lerner; Sorin,9999,0,9999,0
1668046745665,CSE 293,019,119302,Lovett; Shachar,9999,0,9999,0
1668046745665,CSE 293,020,119303,McAuley; Julian John,9999,0,9999,0
1668046745665,CSE 293,021,119304,Micciancio; Daniele,9999,0,9999,0
1668046745665,CSE 293,022,119367,Orailoglu; Alex,9999,0,9999,0
1668046745665,CSE 293,023,119382,Paturi; Ramamohan,9999,0,9999,0
1668046745665,CSE 293,024,119404,Polikarpova; Nadezhda,9999,0,9999,0
1668046745665,CSE 293,025,119406,Politz; Joseph Gibbs,9999,0,9999,0
1668046745665,CSE 293,026,119411,Porter; George M,9999,0,9999,0
1668046745665,CSE 293,027,119414,Porter; Leonard Emerson,9999,0,9999,0
1668046745665,CSE 293,028,119416,Ramamoorthi; Ravi,9999,0,9999,0
1668046745665,CSE 293,029,119417,Sahoo; Debashis,9999,0,9999,0
1668046745665,CSE 293,030,119420,Saul; Lawrence,9999,0,9999,0
1668046745665,CSE 293,031,119421,Savage; Stefan,9999,0,9999,0
1668046745665,CSE 293,032,119425,Schulze; Jurgen P.,9999,0,9999,0
1668046745665,CSE 293,033,119426,Snoeren; Alex C.,9999,0,9999,0
1668046745665,CSE 293,034,119428,Shang; Jingbo,9999,0,9999,0
1668046745665,CSE 293,035,119430,Stefan; Deian,9999,0,9999,0
1668046745665,CSE 293,036,119431,Su; Hao,9999,0,9999,0
1668046745665,CSE 293,037,119433,Swanson; Steven James,9999,0,9999,0
1668046745665,CSE 293,038,119435,Tullsen; Dean Michael,9999,0,9999,0
1668046745665,CSE 293,039,119483,Voelker; Geoffrey M.,9999,0,9999,0
1668046745665,CSE 293,040,119537,Zhao; Jishen,9999,0,9999,0
1668046745665,CSE 293,041,119538,Zhou; Yuan-Yuan,9999,0,9999,0
1668046745665,CSE 293,042,119539,Gao; Sicun,9999,0,9999,0
1668046745665,CSE 293,043,119540,Weibel; Nadir,9999,0,9999,0
1668046745665,CSE 293,044,119541,Gupta; Rajesh K.,9999,0,9999,0
1668046745665,CSE 293,045,126410,Vaccaro; Kristen Marie,9999,0,9999,0
1668046745665,CSE 293,046,126411,Klemke; Richard,9999,0,9999,0
1668046746099,CSE 294,A00,102459,Voelker; Geoffrey M.,0,0,0,0
1668046746099,CSE 294,B00,111322,Orailoglu; Alex,0,0,0,0
1668046746521,DSE 201,A00,096914,Deutsch; Alin Bernard,30,0,30,0
1668046746952,DSE 210,A00,096915,Dasgupta; Sanjoy,30,0,30,0
1668046747380,DSE 260A,A00,096916,Altintas De Callaf; Ilkay,30,0,30,0
1668046747813,ECE 200,001,103586,Antipa; Nicholas A,9999,0,9999,0
1668046747813,ECE 200,002,103587,Atanasov; Nikolay A.,9999,0,9999,0
1668046747813,ECE 200,003,103588,Bharadia; Dinesh,9999,0,9999,0
1668046747813,ECE 200,004,103589,Cheng; Chung Kuan,9999,0,9999,0
1668046747813,ECE 200,005,103590,Cosman; Pamela C.,9999,0,9999,0
1668046747813,ECE 200,006,103591,Dayeh; Shadi Ahmad,9999,0,9999,0
1668046747813,ECE 200,007,103592,Fainman; Yeshaiahu,9999,0,9999,0
1668046747813,ECE 200,008,103593,Ford; Joseph Earl,9999,0,9999,0
1668046747813,ECE 200,009,103594,Franceschetti; Massimo,9999,0,9999,0
1668046747813,ECE 200,010,103595,Fullerton; Eric E,9999,0,9999,0
1668046747813,ECE 200,011,103596,Galton; Ian A,9999,0,9999,0
1668046747813,ECE 200,012,103597,Gilja; Vikash,9999,0,9999,0
1668046747813,ECE 200,013,103598,Hall; Drew A.,9999,0,9999,0
1668046747813,ECE 200,014,103599,Hsueh; Tzu-Chien,9999,0,9999,0
1668046747813,ECE 200,015,103600,Javidi; Tara,9999,0,9999,0
1668046747813,ECE 200,016,103601,Kahng; Andrew Byun,9999,0,9999,0
1668046747813,ECE 200,017,103602,Kim; Young-Han,9999,0,9999,0
1668046747813,ECE 200,018,103603,Koushanfar; Farinaz,9999,0,9999,0
1668046747813,ECE 200,019,103604,Kuzum; Duygu,9999,0,9999,0
1668046747813,ECE 200,020,103605,Le; Hanh-Phuc,9999,0,9999,0
1668046747813,ECE 200,021,103606,Lin; Bill,9999,0,9999,0
1668046747813,ECE 200,022,103607,Liu; Zhaowei,9998,0,9999,1
1668046747813,ECE 200,023,103608,Lo; Yu-Hwa,9999,0,9999,0
1668046747813,ECE 200,024,103609,Lomakin; Vitaliy,9999,0,9999,0
1668046747813,ECE 200,025,103610,Mercier; Patrick Philip,9999,0,9999,0
1668046747813,ECE 200,026,103611,Meyer; Florian,9999,0,9999,0
1668046747813,ECE 200,027,103612,Milstein; Laurence B.,9999,0,9999,0
1668046747813,ECE 200,028,103613,Mir Arabbaygi; Siavash,9999,0,9999,0
1668046747813,ECE 200,029,103614,Mookherjea; Shayan,9999,0,9999,0
1668046747813,ECE 200,030,103615,Morris; Karcher William,9999,0,9999,0
1668046747813,ECE 200,031,103616,Ng; Tse Nga,9999,0,9999,0
1668046747813,ECE 200,032,103617,Nguyen; Truong Quang,9999,0,9999,0
1668046747813,ECE 200,033,103618,Nomura; Kenji,9999,0,9999,0
1668046747813,ECE 200,034,103619,Orlitsky; Alon,9999,0,9999,0
1668046747813,ECE 200,035,103620,Pal; Piya,9999,0,9999,0
1668046747813,ECE 200,036,103621,Papen; George C.,9999,0,9999,0
1668046747813,ECE 200,037,103622,Radic; Stojan,9999,0,9999,0
1668046747813,ECE 200,038,103623,Rao; Bhaskar D.,9999,0,9999,0
1668046747813,ECE 200,039,103624,Rao; Ramesh R,9999,0,9999,0
1668046747813,ECE 200,040,103625,Rebeiz; Gabriel,9999,0,9999,0
1668046747813,ECE 200,041,103626,Sanford; John R,9999,0,9999,0
1668046747813,ECE 200,042,103627,Siegel; Paul H.,9999,0,9999,0
1668046747813,ECE 200,043,103628,Sievenpiper; Daniel F.,9999,0,9999,0
1668046747813,ECE 200,044,103629,Sworder; David D.,9999,0,9999,0
1668046747813,ECE 200,045,103630,Taur; Yuan,9999,0,9999,0
1668046747813,ECE 200,046,103631,Touri; Behrouz,9999,0,9999,0
1668046747813,ECE 200,047,103632,Trivedi; Mohan M.,9999,0,9999,0
1668046747813,ECE 200,048,103633,Vasconcelos; Nuno,9999,0,9999,0
1668046747813,ECE 200,049,103634,Wang; Xiaolong,9999,0,9999,0
1668046747813,ECE 200,050,103635,Xie; Pengtao,9999,0,9999,0
1668046747813,ECE 200,051,103636,Yip; Michael,9999,0,9999,0
1668046747813,ECE 200,052,103637,Zeger; Kenneth A.,999,0,999,0
1668046747813,ECE 200,053,103638,Zhang; Xinyu,9999,0,9999,0
1668046747813,ECE 200,054,103639,Turakhia; Yatish Girish,9999,0,9999,0
1668046747813,ECE 200,055,103640,Kang; Mingu,9999,0,9999,0
1668046747813,ECE 200,056,103641,Shi; Yuanyuan,9999,0,9999,0
1668046747813,ECE 200,057,103642,Wang; Edward Jay,9999,0,9999,0
1668046747813,ECE 200,058,103643,Zheng; Yang,9999,0,9999,0
1668046748256,ECE 202,A00,103644,Kuzum; Duygu,0,0,0,0
1668046748689,ECE 212BN,A00,103646,Ng; Tse Nga,0,0,0,0
1668046749114,ECE 221,A00,111493,Staff,0,0,0,0
1668046749535,ECE 222B,A00,103647,Lomakin; Vitaliy,0,0,0,0
1668046749976,ECE 230B,A00,103648,Taur; Yuan,0,0,0,0
1668046750402,ECE 238B,A00,103649,Garay; Javier,0,0,0,0
1668046750847,ECE 240B,A00,112900,Fainman; Yeshaiahu,0,0,0,0
1668046751276,ECE 247A,A00,103650,Jokerst; Jesse Vincent,0,0,0,0
1668046751704,ECE 247B,A00,103651,Wang; Joseph,0,0,0,0
1668046752132,ECE 250,A00,103652,Siegel; Paul H.,0,0,0,0
1668046752555,ECE 251A,A00,103654,Rao; Bhaskar D.,0,0,0,0
1668046752981,ECE 257B,A00,103655,Bharadia; Dinesh,0,0,0,0
1668046753404,ECE 258A,A00,103656,Milstein; Laurence B.,0,0,0,0
1668046753825,ECE 260B,A00,103658,Kang; Mingu,0,0,0,0
1668046754257,ECE 264A,A00,103659,Galton; Ian A,0,0,0,0
1668046754686,ECE 265A,A00,103661,Gudem; Prasad S.S.,0,0,0,0
1668046755109,ECE 265D,A00,103662,Gudem; Prasad S.S.,0,0,0,0
1668046755539,ECE 268,A00,103663,Koushanfar; Farinaz,0,0,0,0
1668046755970,ECE 269,A01,103665,Pal; Piya,0,0,0,0
1668046756412,ECE 271B,A00,103666,Vasconcelos; Manuela,0,0,0,0
1668046756847,ECE 276A,A00,103667,Atanasov; Nikolay A.,0,0,0,0
1668046757275,ECE 277,A00,103668,An; Cheolhong,0,0,0,0
1668046757703,ECE 279,A00,117947,Hall; Drew A.,0,0,0,0
1668046758557,ECE 283,A00,103670,Hsueh; Tzu-Chien,0,0,0,0
1668046759004,ECE 284,A00,103671,Turakhia; Yatish Girish,0,0,0,0
1668046759448,ECE 285,A00,103672,Zheng; Yang,0,0,0,0
1668046759448,ECE 285,B00,103673,Sworder; David D.,0,0,0,0
1668046759877,ECE 287,A00,103676,Javidi; Tara,0,0,0,0
1668046760310,MATH 200B,A00,098023,Salehi Golsefidy; Alireza,13,0,15,2
1668046760742,MATH 202B,A00,098024,Rhoades; Brendon Patrick,9,0,15,6
1668046761165,MATH 203B,A00,098025,Oprea; Dragos N.,11,0,15,4
1668046761595,MATH 204B,A00,098026,Sorensen; Claus M,13,0,15,2
1668046762020,MATH 208,A00,098027,Izadi; Elham,7,0,10,3
1668046762458,MATH 209,A00,098028,Pollack; Aaron,10,0,10,0
1668046762880,MATH 211A,A00,112919,Rogalski; Daniel,9,0,10,1
1668046763305,MATH 211B,A00,112920,Seward; Brandon M.,9,0,10,1
1668046763738,MATH 218,A00,098029,Li; Bo,10,0,10,0
1668046764174,MATH 220B,A00,098030,Novak; Jonathan I,13,0,15,2
1668046764608,MATH 221A,A00,098031,Ebenfelt; Peter F,13,0,15,2
1668046765033,MATH 231B,A00,098032,Zlatos; Andrej,12,0,15,3
1668046765461,MATH 240B,A00,098033,Ni; Lei,9,0,15,6
1668046765882,MATH 243,A00,098034,Jekel; David Andrew,10,0,10,0
1668046766309,MATH 245A,A00,098035,Nie; Jiawang,0,0,15,16
1668046766733,MATH 248,A00,098036,Bejenaru; Ioan,10,0,10,0
1668046767164,MATH 250B,A00,098037,Spolaor; Luca,14,0,15,1
1668046767593,MATH 258,A00,098038,Ni; Lei,10,0,10,0
1668046768020,MATH 264B,A00,098041,Rhoades; Brendon Patrick,10,0,15,5
1668046768444,MATH 268,A00,098042,Buss; Samuel R,10,0,10,0
1668046768888,MATH 269,A00,098043,Rhoades; Brendon Patrick,10,0,10,0
1668046769315,MATH 270B,A00,098044,Li; Bo,11,0,15,4
1668046769742,MATH 272B,A00,098045,Holst; Michael J,13,0,15,2
1668046770165,MATH 273A,A00,098046,Tian; Xiaochuan,10,0,15,5
1668046770588,MATH 275,A01,098048,Tian; Xiaochuan,6,0,10,4
1668046771015,MATH 278A,A00,098049,Holst; Michael J,8,0,10,2
1668046771439,MATH 278B,A00,098050,Cloninger; Alexander,10,0,10,0
1668046771868,MATH 278C,A00,098051,Nie; Jiawang,7,0,10,3
1668046772291,MATH 280B,A00,098052,Zheng; Tianyi,10,0,15,5
1668046772716,MATH 281B,A00,098053,Bradic; Jelena,3,0,15,12
1668046773147,MATH 282B,A00,098054,Arias-Castro; Ery,0,0,15,15
1668046773577,MATH 285,A00,098055,Fitzsimmons; Patrick J,0,0,15,17
1668046774018,MATH 287B,A00,098056,Arias-Castro; Ery,3,0,15,12
1668046774443,MATH 288,A00,098057,Agarwal; Pooja,9,0,10,1
1668046774443,MATH 288,B00,098058,Zhang; Danna,8,0,10,2
1668046774443,MATH 288,C00,098059,Williams; Ruth J,10,0,10,0
1668046774870,MATH 290B,A00,098060,Roberts; Justin Deritter,13,0,15,2
1668046775295,MATH 292,A00,098061,Belmont; Eva Kinoshita,10,0,10,0
1668046775725,MATH 295,A00,098062,Suk; Andrew Hoon,48,0,50,2
1668046776149,MATH 296,A00,098063,Novak; Jonathan I,20,0,20,0
1668046776574,MATH 297,001,098064,Gamst; Anthony Collins,9997,0,9999,2
1668047280108,COGS 205,A00,101395,Chiba; Andrea,19,0,20,1
1668047280533,COGS 210B,001,101404,Greene; Deanna Jacquelyn,9998,0,9999,1
1668047280533,COGS 210B,002,101417,Xia; Haijun,9999,0,9999,0
1668047280533,COGS 210B,003,101422,Nitz; Douglas A.,9999,0,9999,0
1668047280533,COGS 210B,004,101423,Hollan; James D.,9998,0,9999,1
1668047280533,COGS 210B,005,101424,Deak; Gedeon O.,9998,0,9999,1
1668047280533,COGS 210B,006,101425,Rossano; Federico,9999,0,9999,0
1668047280959,COGS 211B,A00,101427,Coulson; Seana M,9996,0,9999,3
1668047281386,COGS 220,A00,101428,Hollan; James D.,0,0,25,25
1668047281817,COGS 229,A00,101429,Dow; Steven P,18,0,25,7
1668047282240,COGS 230,A00,101430,Klemmer; Scott R,13,0,17,4
1668047282681,COGS 234,A00,101431,Xia; Haijun,4,0,25,21
1668047283116,COGS 260,A00,101432,Kiyonaga; Anastasia,19,0,25,6
1668047283116,COGS 260,B00,101433,Kirsh; David Joel,16,0,25,9
1668047283562,CSE 202,A00,102371,Impagliazzo; Russell,0,0,0,0
1668047283996,CSE 203B,A01,102373,Cheng; Chung Kuan,0,0,0,0
1668047284420,CSE 208,A00,102374,Micciancio; Daniele,0,0,0,0
1668047284846,CSE 209A,A00,112895,Impagliazzo; Russell,0,0,15,15
1668047285275,CSE 209B,A00,108005,Bellare; Mihir,0,0,0,0
1668047285698,CSE 210,A00,113163,Coblenz; Michael J,0,0,0,0
1668047286132,CSE 219,A00,106111,Dow; Steven P,0,0,20,20
1668047286568,CSE 221,A00,102376,Voelker; Geoffrey M.,0,0,0,0
1668047287000,CSE 224,A01,102378,Porter; George M,0,0,0,0
1668047287430,CSE 229A,A00,102379,Savage; Stefan,0,0,0,0
1668047287852,CSE 229C,A00,102380,Munyaka; Imani N. S.,0,0,0,0
1668047288286,CSE 232B,A00,102382,Deutsch; Alin Bernard,0,0,0,0
1668047288720,CSE 234,A01,112904,Kumar; Arun Kumar,0,0,0,0
1668047289162,CSE 237A,A00,102383,Rosing; Tajana Simunic,0,0,0,0
1668047289591,CSE 239A,A00,102384,Deutsch; Alin Bernard,0,0,0,0
1668047290016,CSE 239B,A00,102385,Polikarpova; Nadezhda,0,0,0,0
1668047290439,CSE 240A,A00,102386,Pannuto; Patrick William,0,0,0,0
1668047290869,CSE 240B,A00,102387,Zhao; Jishen,0,0,0,0
1668047291295,CSE 241A,A00,106406,Kang; Mingu,0,0,0,0
1668047291719,CSE 249B,A00,102388,Kahng; Andrew Byun,0,0,8,8
1668047292144,CSE 251B,A01,102392,Cottrell; Garrison W,0,0,0,0
1668047292144,CSE 251B,A02,102393,Cottrell; Garrison W,0,0,0,0
1668047292566,CSE 252B,A00,102394,Ochoa; Benjamin Lawrence,0,0,0,0
1668047292991,CSE 257,A01,102396,Gao; Sicun,0,0,0,0
1668047293416,CSE 272,A00,102397,Li; Tzumao,0,0,0,0
1668047293847,CSE 274,A00,111323,Chern; Albert Ren-Haur,0,0,0,0
1668047294282,CSE 282,A00,102398,Pevzner; Pavel Arkadjevich,0,0,0,0
1668047294707,CSE 284,A00,114175,Gymrek; Melissa Ann,0,0,0,0
1668047295138,CSE 290,A00,102399,Chandraker; Manmohan Krishna,0,0,0,0
1668047295138,CSE 290,B00,102400,Vaccaro; Kristen Marie,0,0,25,25
1668047295138,CSE 290,C00,102414,Pannuto; Patrick William,0,0,25,25
1668047295138,CSE 290,D00,102427,Pevzner; Pavel Arkadjevich,0,0,0,0
1668047295138,CSE 290,E00,102429,Zhao; Jishen,0,0,0,0
1668047295138,CSE 290,F00,102436,Tullsen; Dean Michael,0,0,0,0
1668047295138,CSE 290,G00,102440,Christensen; Henrik I,0,0,20,20
1668047295567,CSE 291,A00,102443,Su; Hao,0,0,0,0
1668047295567,CSE 291,B00,102448,Polikarpova; Nadezhda,0,0,0,0
1668047295567,CSE 291,C00,102453,Vaccaro; Kristen Marie,0,0,0,0
1668047295567,CSE 291,D00,111343,Savage; Stefan,0,0,0,0
1668047295567,CSE 291,E00,116474,Claffy; Kimberly Claire,0,0,0,0
1668047295567,CSE 291,F00,116479,Pasquale; Joseph,0,0,0,0
1668047296024,CSE 293,001,119111,Bafna; Vineet,9999,0,9999,0
1668047296024,CSE 293,002,119118,Bellare; Mihir,9999,0,9999,0
1668047296024,CSE 293,003,119122,Berg-Kirkpatrick; Taylor D,9999,0,9999,0
1668047296024,CSE 293,004,119135,Christensen; Henrik I,9999,0,9999,0
1668047296024,CSE 293,005,119142,Cottrell; Garrison W,9999,0,9999,0
1668047296024,CSE 293,006,119146,Deutsch; Alin Bernard,9999,0,9999,0
1668047296024,CSE 293,007,119159,Esmaeilzadeh; Hadi,9999,0,9999,0
1668047296024,CSE 293,008,119166,Freund; Yoav,9999,0,9999,0
1668047296024,CSE 293,009,119170,Griswold; William G.,9999,0,9999,0
1668047296024,CSE 293,010,119183,Gymrek; Melissa Ann,9999,0,9999,0
1668047296024,CSE 293,011,119190,Heninger; Nadia A,9999,0,9999,0
1668047296024,CSE 293,012,119230,Impagliazzo; Russell,9999,0,9999,0
1668047296024,CSE 293,013,119232,Jhala; Ranjit,9999,0,9999,0
1668047296024,CSE 293,014,119233,Kahng; Andrew Byun,9999,0,9999,0
1668047296024,CSE 293,015,119298,Kane; Daniel Mertz,9999,0,9999,0
1668047296024,CSE 293,016,119299,Kriegman; David J,9999,0,9999,0
1668047296024,CSE 293,017,119300,Kumar; Arun Kumar,9999,0,9999,0
1668047296024,CSE 293,018,119301,Lerner; Sorin,9999,0,9999,0
1668047296024,CSE 293,019,119302,Lovett; Shachar,9999,0,9999,0
1668047296024,CSE 293,020,119303,McAuley; Julian John,9999,0,9999,0
1668047296024,CSE 293,021,119304,Micciancio; Daniele,9999,0,9999,0
1668047296024,CSE 293,022,119367,Orailoglu; Alex,9999,0,9999,0
1668047296024,CSE 293,023,119382,Paturi; Ramamohan,9999,0,9999,0
1668047296024,CSE 293,024,119404,Polikarpova; Nadezhda,9999,0,9999,0
1668047296024,CSE 293,025,119406,Politz; Joseph Gibbs,9999,0,9999,0
1668047296024,CSE 293,026,119411,Porter; George M,9999,0,9999,0
1668047296024,CSE 293,027,119414,Porter; Leonard Emerson,9999,0,9999,0
1668047296024,CSE 293,028,119416,Ramamoorthi; Ravi,9999,0,9999,0
1668047296024,CSE 293,029,119417,Sahoo; Debashis,9999,0,9999,0
1668047296024,CSE 293,030,119420,Saul; Lawrence,9999,0,9999,0
1668047296024,CSE 293,031,119421,Savage; Stefan,9999,0,9999,0
1668047296024,CSE 293,032,119425,Schulze; Jurgen P.,9999,0,9999,0
1668047296024,CSE 293,033,119426,Snoeren; Alex C.,9999,0,9999,0
1668047296024,CSE 293,034,119428,Shang; Jingbo,9999,0,9999,0
1668047296024,CSE 293,035,119430,Stefan; Deian,9999,0,9999,0
1668047296024,CSE 293,036,119431,Su; Hao,9999,0,9999,0
1668047296024,CSE 293,037,119433,Swanson; Steven James,9999,0,9999,0
1668047296024,CSE 293,038,119435,Tullsen; Dean Michael,9999,0,9999,0
1668047296024,CSE 293,039,119483,Voelker; Geoffrey M.,9999,0,9999,0
1668047296024,CSE 293,040,119537,Zhao; Jishen,9999,0,9999,0
1668047296024,CSE 293,041,119538,Zhou; Yuan-Yuan,9999,0,9999,0
1668047296024,CSE 293,042,119539,Gao; Sicun,9999,0,9999,0
1668047296024,CSE 293,043,119540,Weibel; Nadir,9999,0,9999,0
1668047296024,CSE 293,044,119541,Gupta; Rajesh K.,9999,0,9999,0
1668047296024,CSE 293,045,126410,Vaccaro; Kristen Marie,9999,0,9999,0
1668047296024,CSE 293,046,126411,Klemke; Richard,9999,0,9999,0
1668047296451,CSE 294,A00,102459,Voelker; Geoffrey M.,0,0,0,0
1668047296451,CSE 294,B00,111322,Orailoglu; Alex,0,0,0,0
1668047296874,DSE 201,A00,096914,Deutsch; Alin Bernard,30,0,30,0
1668047297298,DSE 210,A00,096915,Dasgupta; Sanjoy,30,0,30,0
1668047297733,DSE 260A,A00,096916,Altintas De Callaf; Ilkay,30,0,30,0
1668047298170,ECE 200,001,103586,Antipa; Nicholas A,9999,0,9999,0
1668047298170,ECE 200,002,103587,Atanasov; Nikolay A.,9999,0,9999,0
1668047298170,ECE 200,003,103588,Bharadia; Dinesh,9999,0,9999,0
1668047298170,ECE 200,004,103589,Cheng; Chung Kuan,9999,0,9999,0
1668047298170,ECE 200,005,103590,Cosman; Pamela C.,9999,0,9999,0
1668047298170,ECE 200,006,103591,Dayeh; Shadi Ahmad,9999,0,9999,0
1668047298170,ECE 200,007,103592,Fainman; Yeshaiahu,9999,0,9999,0
1668047298170,ECE 200,008,103593,Ford; Joseph Earl,9999,0,9999,0
1668047298170,ECE 200,009,103594,Franceschetti; Massimo,9999,0,9999,0
1668047298170,ECE 200,010,103595,Fullerton; Eric E,9999,0,9999,0
1668047298170,ECE 200,011,103596,Galton; Ian A,9999,0,9999,0
1668047298170,ECE 200,012,103597,Gilja; Vikash,9999,0,9999,0
1668047298170,ECE 200,013,103598,Hall; Drew A.,9999,0,9999,0
1668047298170,ECE 200,014,103599,Hsueh; Tzu-Chien,9999,0,9999,0
1668047298170,ECE 200,015,103600,Javidi; Tara,9999,0,9999,0
1668047298170,ECE 200,016,103601,Kahng; Andrew Byun,9999,0,9999,0
1668047298170,ECE 200,017,103602,Kim; Young-Han,9999,0,9999,0
1668047298170,ECE 200,018,103603,Koushanfar; Farinaz,9999,0,9999,0
1668047298170,ECE 200,019,103604,Kuzum; Duygu,9999,0,9999,0
1668047298170,ECE 200,020,103605,Le; Hanh-Phuc,9999,0,9999,0
1668047298170,ECE 200,021,103606,Lin; Bill,9999,0,9999,0
1668047298170,ECE 200,022,103607,Liu; Zhaowei,9998,0,9999,1
1668047298170,ECE 200,023,103608,Lo; Yu-Hwa,9999,0,9999,0
1668047298170,ECE 200,024,103609,Lomakin; Vitaliy,9999,0,9999,0
1668047298170,ECE 200,025,103610,Mercier; Patrick Philip,9999,0,9999,0
1668047298170,ECE 200,026,103611,Meyer; Florian,9999,0,9999,0
1668047298170,ECE 200,027,103612,Milstein; Laurence B.,9999,0,9999,0
1668047298170,ECE 200,028,103613,Mir Arabbaygi; Siavash,9999,0,9999,0
1668047298170,ECE 200,029,103614,Mookherjea; Shayan,9999,0,9999,0
1668047298170,ECE 200,030,103615,Morris; Karcher William,9999,0,9999,0
1668047298170,ECE 200,031,103616,Ng; Tse Nga,9999,0,9999,0
1668047298170,ECE 200,032,103617,Nguyen; Truong Quang,9999,0,9999,0
1668047298170,ECE 200,033,103618,Nomura; Kenji,9999,0,9999,0
1668047298170,ECE 200,034,103619,Orlitsky; Alon,9999,0,9999,0
1668047298170,ECE 200,035,103620,Pal; Piya,9999,0,9999,0
1668047298170,ECE 200,036,103621,Papen; George C.,9999,0,9999,0
1668047298170,ECE 200,037,103622,Radic; Stojan,9999,0,9999,0
1668047298170,ECE 200,038,103623,Rao; Bhaskar D.,9999,0,9999,0
1668047298170,ECE 200,039,103624,Rao; Ramesh R,9999,0,9999,0
1668047298170,ECE 200,040,103625,Rebeiz; Gabriel,9999,0,9999,0
1668047298170,ECE 200,041,103626,Sanford; John R,9999,0,9999,0
1668047298170,ECE 200,042,103627,Siegel; Paul H.,9999,0,9999,0
1668047298170,ECE 200,043,103628,Sievenpiper; Daniel F.,9999,0,9999,0
1668047298170,ECE 200,044,103629,Sworder; David D.,9999,0,9999,0
1668047298170,ECE 200,045,103630,Taur; Yuan,9999,0,9999,0
1668047298170,ECE 200,046,103631,Touri; Behrouz,9999,0,9999,0
1668047298170,ECE 200,047,103632,Trivedi; Mohan M.,9999,0,9999,0
1668047298170,ECE 200,048,103633,Vasconcelos; Nuno,9999,0,9999,0
1668047298170,ECE 200,049,103634,Wang; Xiaolong,9999,0,9999,0
1668047298170,ECE 200,050,103635,Xie; Pengtao,9999,0,9999,0
1668047298170,ECE 200,051,103636,Yip; Michael,9999,0,9999,0
1668047298170,ECE 200,052,103637,Zeger; Kenneth A.,999,0,999,0
1668047298170,ECE 200,053,103638,Zhang; Xinyu,9999,0,9999,0
1668047298170,ECE 200,054,103639,Turakhia; Yatish Girish,9999,0,9999,0
1668047298170,ECE 200,055,103640,Kang; Mingu,9999,0,9999,0
1668047298170,ECE 200,056,103641,Shi; Yuanyuan,9999,0,9999,0
1668047298170,ECE 200,057,103642,Wang; Edward Jay,9999,0,9999,0
1668047298170,ECE 200,058,103643,Zheng; Yang,9999,0,9999,0
1668047298599,ECE 202,A00,103644,Kuzum; Duygu,0,0,0,0
1668047299025,ECE 212BN,A00,103646,Ng; Tse Nga,0,0,0,0
1668047299458,ECE 221,A00,111493,Staff,0,0,0,0
1668047299881,ECE 222B,A00,103647,Lomakin; Vitaliy,0,0,0,0
1668047300304,ECE 230B,A00,103648,Taur; Yuan,0,0,0,0
1668047300733,ECE 238B,A00,103649,Garay; Javier,0,0,0,0
1668047301157,ECE 240B,A00,112900,Fainman; Yeshaiahu,0,0,0,0
1668047301588,ECE 247A,A00,103650,Jokerst; Jesse Vincent,0,0,0,0
1668047302011,ECE 247B,A00,103651,Wang; Joseph,0,0,0,0
1668047302449,ECE 250,A00,103652,Siegel; Paul H.,0,0,0,0
1668047302871,ECE 251A,A00,103654,Rao; Bhaskar D.,0,0,0,0
1668047303296,ECE 257B,A00,103655,Bharadia; Dinesh,0,0,0,0
1668047303719,ECE 258A,A00,103656,Milstein; Laurence B.,0,0,0,0
1668047304149,ECE 260B,A00,103658,Kang; Mingu,0,0,0,0
1668047304576,ECE 264A,A00,103659,Galton; Ian A,0,0,0,0
1668047305002,ECE 265A,A00,103661,Gudem; Prasad S.S.,0,0,0,0
1668047305508,ECE 265D,A00,103662,Gudem; Prasad S.S.,0,0,0,0
1668047305934,ECE 268,A00,103663,Koushanfar; Farinaz,0,0,0,0
1668047306358,ECE 269,A01,103665,Pal; Piya,0,0,0,0
1668047306781,ECE 271B,A00,103666,Vasconcelos; Manuela,0,0,0,0
1668047307212,ECE 276A,A00,103667,Atanasov; Nikolay A.,0,0,0,0
1668047307636,ECE 277,A00,103668,An; Cheolhong,0,0,0,0
1668047308071,ECE 279,A00,117947,Hall; Drew A.,0,0,0,0
1668047308945,ECE 283,A00,103670,Hsueh; Tzu-Chien,0,0,0,0
1668047309378,ECE 284,A00,103671,Turakhia; Yatish Girish,0,0,0,0
1668047309821,ECE 285,A00,103672,Zheng; Yang,0,0,0,0
1668047309821,ECE 285,B00,103673,Sworder; David D.,0,0,0,0
1668047310245,ECE 287,A00,103676,Javidi; Tara,0,0,0,0
1668047310676,MATH 200B,A00,098023,Salehi Golsefidy; Alireza,13,0,15,2
1668047311101,MATH 202B,A00,098024,Rhoades; Brendon Patrick,9,0,15,6
1668047311536,MATH 203B,A00,098025,Oprea; Dragos N.,11,0,15,4
1668047311964,MATH 204B,A00,098026,Sorensen; Claus M,13,0,15,2
1668047312390,MATH 208,A00,098027,Izadi; Elham,7,0,10,3
1668047312821,MATH 209,A00,098028,Pollack; Aaron,10,0,10,0
1668047313244,MATH 211A,A00,112919,Rogalski; Daniel,9,0,10,1
1668047313671,MATH 211B,A00,112920,Seward; Brandon M.,9,0,10,1
1668047314106,MATH 218,A00,098029,Li; Bo,10,0,10,0
1668047314534,MATH 220B,A00,098030,Novak; Jonathan I,13,0,15,2
1668047314963,MATH 221A,A00,098031,Ebenfelt; Peter F,13,0,15,2
1668047315387,MATH 231B,A00,098032,Zlatos; Andrej,12,0,15,3
1668047315808,MATH 240B,A00,098033,Ni; Lei,9,0,15,6
1668047316233,MATH 243,A00,098034,Jekel; David Andrew,10,0,10,0
1668047316656,MATH 245A,A00,098035,Nie; Jiawang,0,0,15,16
1668047317080,MATH 248,A00,098036,Bejenaru; Ioan,10,0,10,0
1668047317508,MATH 250B,A00,098037,Spolaor; Luca,14,0,15,1
1668047317934,MATH 258,A00,098038,Ni; Lei,10,0,10,0
1668047318357,MATH 264B,A00,098041,Rhoades; Brendon Patrick,10,0,15,5
1668047318781,MATH 268,A00,098042,Buss; Samuel R,10,0,10,0
1668047319206,MATH 269,A00,098043,Rhoades; Brendon Patrick,10,0,10,0
1668047319629,MATH 270B,A00,098044,Li; Bo,11,0,15,4
1668047320056,MATH 272B,A00,098045,Holst; Michael J,13,0,15,2
1668047320479,MATH 273A,A00,098046,Tian; Xiaochuan,10,0,15,5
1668047320905,MATH 275,A01,098048,Tian; Xiaochuan,6,0,10,4
1668047321340,MATH 278A,A00,098049,Holst; Michael J,8,0,10,2
1668047321766,MATH 278B,A00,098050,Cloninger; Alexander,10,0,10,0
1668047322197,MATH 278C,A00,098051,Nie; Jiawang,7,0,10,3
1668047322620,MATH 280B,A00,098052,Zheng; Tianyi,10,0,15,5
1668047323055,MATH 281B,A00,098053,Bradic; Jelena,3,0,15,12
1668047323479,MATH 282B,A00,098054,Arias-Castro; Ery,0,0,15,15
1668047323904,MATH 285,A00,098055,Fitzsimmons; Patrick J,0,0,15,17
1668047324330,MATH 287B,A00,098056,Arias-Castro; Ery,3,0,15,12
1668047324752,MATH 288,A00,098057,Agarwal; Pooja,9,0,10,1
1668047324752,MATH 288,B00,098058,Zhang; Danna,8,0,10,2
1668047324752,MATH 288,C00,098059,Williams; Ruth J,10,0,10,0
1668047325177,MATH 290B,A00,098060,Roberts; Justin Deritter,13,0,15,2
1668047325603,MATH 292,A00,098061,Belmont; Eva Kinoshita,10,0,10,0
1668047326028,MATH 295,A00,098062,Suk; Andrew Hoon,48,0,50,2
1668047326452,MATH 296,A00,098063,Novak; Jonathan I,20,0,20,0
1668047326875,MATH 297,001,098064,Gamst; Anthony Collins,9997,0,9999,2
1668047830551,COGS 205,A00,101395,Chiba; Andrea,19,0,20,1
1668047830974,COGS 210B,001,101404,Greene; Deanna Jacquelyn,9998,0,9999,1
1668047830974,COGS 210B,002,101417,Xia; Haijun,9999,0,9999,0
1668047830974,COGS 210B,003,101422,Nitz; Douglas A.,9999,0,9999,0
1668047830974,COGS 210B,004,101423,Hollan; James D.,9998,0,9999,1
1668047830974,COGS 210B,005,101424,Deak; Gedeon O.,9998,0,9999,1
1668047830974,COGS 210B,006,101425,Rossano; Federico,9999,0,9999,0
1668047831404,COGS 211B,A00,101427,Coulson; Seana M,9996,0,9999,3
1668047831829,COGS 220,A00,101428,Hollan; James D.,0,0,25,25
1668047832254,COGS 229,A00,101429,Dow; Steven P,18,0,25,7
1668047832678,COGS 230,A00,101430,Klemmer; Scott R,13,0,17,4
1668047833102,COGS 234,A00,101431,Xia; Haijun,4,0,25,21
1668047833527,COGS 260,A00,101432,Kiyonaga; Anastasia,19,0,25,6
1668047833527,COGS 260,B00,101433,Kirsh; David Joel,16,0,25,9
1668047833948,CSE 202,A00,102371,Impagliazzo; Russell,0,0,0,0
1668047834371,CSE 203B,A01,102373,Cheng; Chung Kuan,0,0,0,0
1668047834799,CSE 208,A00,102374,Micciancio; Daniele,0,0,0,0
1668047835233,CSE 209A,A00,112895,Impagliazzo; Russell,0,0,15,15
1668047835659,CSE 209B,A00,108005,Bellare; Mihir,0,0,0,0
1668047836089,CSE 210,A00,113163,Coblenz; Michael J,0,0,0,0
1668047836522,CSE 219,A00,106111,Dow; Steven P,0,0,20,20
1668047836948,CSE 221,A00,102376,Voelker; Geoffrey M.,0,0,0,0
1668047837372,CSE 224,A01,102378,Porter; George M,0,0,0,0
1668047837798,CSE 229A,A00,102379,Savage; Stefan,0,0,0,0
1668047838234,CSE 229C,A00,102380,Munyaka; Imani N. S.,0,0,0,0
1668047838659,CSE 232B,A00,102382,Deutsch; Alin Bernard,0,0,0,0
1668047839084,CSE 234,A01,112904,Kumar; Arun Kumar,0,0,0,0
1668047839512,CSE 237A,A00,102383,Rosing; Tajana Simunic,0,0,0,0
1668047839934,CSE 239A,A00,102384,Deutsch; Alin Bernard,0,0,0,0
1668047840359,CSE 239B,A00,102385,Polikarpova; Nadezhda,0,0,0,0
1668047840785,CSE 240A,A00,102386,Pannuto; Patrick William,0,0,0,0
1668047841209,CSE 240B,A00,102387,Zhao; Jishen,0,0,0,0
1668047841632,CSE 241A,A00,106406,Kang; Mingu,0,0,0,0
1668047842059,CSE 249B,A00,102388,Kahng; Andrew Byun,0,0,8,8
1668047842486,CSE 251B,A01,102392,Cottrell; Garrison W,0,0,0,0
1668047842486,CSE 251B,A02,102393,Cottrell; Garrison W,0,0,0,0
1668047842912,CSE 252B,A00,102394,Ochoa; Benjamin Lawrence,0,0,0,0
1668047843347,CSE 257,A01,102396,Gao; Sicun,0,0,0,0
1668047843778,CSE 272,A00,102397,Li; Tzumao,0,0,0,0
1668047844203,CSE 274,A00,111323,Chern; Albert Ren-Haur,0,0,0,0
1668047844635,CSE 282,A00,102398,Pevzner; Pavel Arkadjevich,0,0,0,0
1668047845065,CSE 284,A00,114175,Gymrek; Melissa Ann,0,0,0,0
1668047845495,CSE 290,A00,102399,Chandraker; Manmohan Krishna,0,0,0,0
1668047845495,CSE 290,B00,102400,Vaccaro; Kristen Marie,0,0,25,25
1668047845495,CSE 290,C00,102414,Pannuto; Patrick William,0,0,25,25
1668047845495,CSE 290,D00,102427,Pevzner; Pavel Arkadjevich,0,0,0,0
1668047845495,CSE 290,E00,102429,Zhao; Jishen,0,0,0,0
1668047845495,CSE 290,F00,102436,Tullsen; Dean Michael,0,0,0,0
1668047845495,CSE 290,G00,102440,Christensen; Henrik I,0,0,20,20
1668047845936,CSE 291,A00,102443,Su; Hao,0,0,0,0
1668047845936,CSE 291,B00,102448,Polikarpova; Nadezhda,0,0,0,0
1668047845936,CSE 291,C00,102453,Vaccaro; Kristen Marie,0,0,0,0
1668047845936,CSE 291,D00,111343,Savage; Stefan,0,0,0,0
1668047845936,CSE 291,E00,116474,Claffy; Kimberly Claire,0,0,0,0
1668047845936,CSE 291,F00,116479,Pasquale; Joseph,0,0,0,0
1668047846372,CSE 293,001,119111,Bafna; Vineet,9999,0,9999,0
1668047846372,CSE 293,002,119118,Bellare; Mihir,9999,0,9999,0
1668047846372,CSE 293,003,119122,Berg-Kirkpatrick; Taylor D,9999,0,9999,0
1668047846372,CSE 293,004,119135,Christensen; Henrik I,9999,0,9999,0
1668047846372,CSE 293,005,119142,Cottrell; Garrison W,9999,0,9999,0
1668047846372,CSE 293,006,119146,Deutsch; Alin Bernard,9999,0,9999,0
1668047846372,CSE 293,007,119159,Esmaeilzadeh; Hadi,9999,0,9999,0
1668047846372,CSE 293,008,119166,Freund; Yoav,9999,0,9999,0
1668047846372,CSE 293,009,119170,Griswold; William G.,9999,0,9999,0
1668047846372,CSE 293,010,119183,Gymrek; Melissa Ann,9999,0,9999,0
1668047846372,CSE 293,011,119190,Heninger; Nadia A,9999,0,9999,0
1668047846372,CSE 293,012,119230,Impagliazzo; Russell,9999,0,9999,0
1668047846372,CSE 293,013,119232,Jhala; Ranjit,9999,0,9999,0
1668047846372,CSE 293,014,119233,Kahng; Andrew Byun,9999,0,9999,0
1668047846372,CSE 293,015,119298,Kane; Daniel Mertz,9999,0,9999,0
1668047846372,CSE 293,016,119299,Kriegman; David J,9999,0,9999,0
1668047846372,CSE 293,017,119300,Kumar; Arun Kumar,9999,0,9999,0
1668047846372,CSE 293,018,119301,Lerner; Sorin,9999,0,9999,0
1668047846372,CSE 293,019,119302,Lovett; Shachar,9999,0,9999,0
1668047846372,CSE 293,020,119303,McAuley; Julian John,9999,0,9999,0
1668047846372,CSE 293,021,119304,Micciancio; Daniele,9999,0,9999,0
1668047846372,CSE 293,022,119367,Orailoglu; Alex,9999,0,9999,0
1668047846372,CSE 293,023,119382,Paturi; Ramamohan,9999,0,9999,0
1668047846372,CSE 293,024,119404,Polikarpova; Nadezhda,9999,0,9999,0
1668047846372,CSE 293,025,119406,Politz; Joseph Gibbs,9999,0,9999,0
1668047846372,CSE 293,026,119411,Porter; George M,9999,0,9999,0
1668047846372,CSE 293,027,119414,Porter; Leonard Emerson,9999,0,9999,0
1668047846372,CSE 293,028,119416,Ramamoorthi; Ravi,9999,0,9999,0
1668047846372,CSE 293,029,119417,Sahoo; Debashis,9999,0,9999,0
1668047846372,CSE 293,030,119420,Saul; Lawrence,9999,0,9999,0
1668047846372,CSE 293,031,119421,Savage; Stefan,9999,0,9999,0
1668047846372,CSE 293,032,119425,Schulze; Jurgen P.,9999,0,9999,0
1668047846372,CSE 293,033,119426,Snoeren; Alex C.,9999,0,9999,0
1668047846372,CSE 293,034,119428,Shang; Jingbo,9999,0,9999,0
1668047846372,CSE 293,035,119430,Stefan; Deian,9999,0,9999,0
1668047846372,CSE 293,036,119431,Su; Hao,9999,0,9999,0
1668047846372,CSE 293,037,119433,Swanson; Steven James,9999,0,9999,0
1668047846372,CSE 293,038,119435,Tullsen; Dean Michael,9999,0,9999,0
1668047846372,CSE 293,039,119483,Voelker; Geoffrey M.,9999,0,9999,0
1668047846372,CSE 293,040,119537,Zhao; Jishen,9999,0,9999,0
1668047846372,CSE 293,041,119538,Zhou; Yuan-Yuan,9999,0,9999,0
1668047846372,CSE 293,042,119539,Gao; Sicun,9999,0,9999,0
1668047846372,CSE 293,043,119540,Weibel; Nadir,9999,0,9999,0
1668047846372,CSE 293,044,119541,Gupta; Rajesh K.,9999,0,9999,0
1668047846372,CSE 293,045,126410,Vaccaro; Kristen Marie,9999,0,9999,0
1668047846372,CSE 293,046,126411,Klemke; Richard,9999,0,9999,0
1668047846797,CSE 294,A00,102459,Voelker; Geoffrey M.,0,0,0,0
1668047846797,CSE 294,B00,111322,Orailoglu; Alex,0,0,0,0
1668047847221,DSE 201,A00,096914,Deutsch; Alin Bernard,30,0,30,0
1668047847652,DSE 210,A00,096915,Dasgupta; Sanjoy,30,0,30,0
1668047848087,DSE 260A,A00,096916,Altintas De Callaf; Ilkay,30,0,30,0
1668047848550,ECE 200,001,103586,Antipa; Nicholas A,9999,0,9999,0
1668047848550,ECE 200,002,103587,Atanasov; Nikolay A.,9999,0,9999,0
1668047848550,ECE 200,003,103588,Bharadia; Dinesh,9999,0,9999,0
1668047848550,ECE 200,004,103589,Cheng; Chung Kuan,9999,0,9999,0
1668047848550,ECE 200,005,103590,Cosman; Pamela C.,9999,0,9999,0
1668047848550,ECE 200,006,103591,Dayeh; Shadi Ahmad,9999,0,9999,0
1668047848550,ECE 200,007,103592,Fainman; Yeshaiahu,9999,0,9999,0
1668047848550,ECE 200,008,103593,Ford; Joseph Earl,9999,0,9999,0
1668047848550,ECE 200,009,103594,Franceschetti; Massimo,9999,0,9999,0
1668047848550,ECE 200,010,103595,Fullerton; Eric E,9999,0,9999,0
1668047848550,ECE 200,011,103596,Galton; Ian A,9999,0,9999,0
1668047848550,ECE 200,012,103597,Gilja; Vikash,9999,0,9999,0
1668047848550,ECE 200,013,103598,Hall; Drew A.,9999,0,9999,0
1668047848550,ECE 200,014,103599,Hsueh; Tzu-Chien,9999,0,9999,0
1668047848550,ECE 200,015,103600,Javidi; Tara,9999,0,9999,0
1668047848550,ECE 200,016,103601,Kahng; Andrew Byun,9999,0,9999,0
1668047848550,ECE 200,017,103602,Kim; Young-Han,9999,0,9999,0
1668047848550,ECE 200,018,103603,Koushanfar; Farinaz,9999,0,9999,0
1668047848550,ECE 200,019,103604,Kuzum; Duygu,9999,0,9999,0
1668047848550,ECE 200,020,103605,Le; Hanh-Phuc,9999,0,9999,0
1668047848550,ECE 200,021,103606,Lin; Bill,9999,0,9999,0
1668047848550,ECE 200,022,103607,Liu; Zhaowei,9998,0,9999,1
1668047848550,ECE 200,023,103608,Lo; Yu-Hwa,9999,0,9999,0
1668047848550,ECE 200,024,103609,Lomakin; Vitaliy,9999,0,9999,0
1668047848550,ECE 200,025,103610,Mercier; Patrick Philip,9999,0,9999,0
1668047848550,ECE 200,026,103611,Meyer; Florian,9999,0,9999,0
1668047848550,ECE 200,027,103612,Milstein; Laurence B.,9999,0,9999,0
1668047848550,ECE 200,028,103613,Mir Arabbaygi; Siavash,9999,0,9999,0
1668047848550,ECE 200,029,103614,Mookherjea; Shayan,9999,0,9999,0
1668047848550,ECE 200,030,103615,Morris; Karcher William,9999,0,9999,0
1668047848550,ECE 200,031,103616,Ng; Tse Nga,9999,0,9999,0
1668047848550,ECE 200,032,103617,Nguyen; Truong Quang,9999,0,9999,0
1668047848550,ECE 200,033,103618,Nomura; Kenji,9999,0,9999,0
1668047848550,ECE 200,034,103619,Orlitsky; Alon,9999,0,9999,0
1668047848550,ECE 200,035,103620,Pal; Piya,9999,0,9999,0
1668047848550,ECE 200,036,103621,Papen; George C.,9999,0,9999,0
1668047848550,ECE 200,037,103622,Radic; Stojan,9999,0,9999,0
1668047848550,ECE 200,038,103623,Rao; Bhaskar D.,9999,0,9999,0
1668047848550,ECE 200,039,103624,Rao; Ramesh R,9999,0,9999,0
1668047848550,ECE 200,040,103625,Rebeiz; Gabriel,9999,0,9999,0
1668047848550,ECE 200,041,103626,Sanford; John R,9999,0,9999,0
1668047848550,ECE 200,042,103627,Siegel; Paul H.,9999,0,9999,0
1668047848550,ECE 200,043,103628,Sievenpiper; Daniel F.,9999,0,9999,0
1668047848550,ECE 200,044,103629,Sworder; David D.,9999,0,9999,0
1668047848550,ECE 200,045,103630,Taur; Yuan,9999,0,9999,0
1668047848550,ECE 200,046,103631,Touri; Behrouz,9999,0,9999,0
1668047848550,ECE 200,047,103632,Trivedi; Mohan M.,9999,0,9999,0
1668047848550,ECE 200,048,103633,Vasconcelos; Nuno,9999,0,9999,0
1668047848550,ECE 200,049,103634,Wang; Xiaolong,9999,0,9999,0
1668047848550,ECE 200,050,103635,Xie; Pengtao,9999,0,9999,0
1668047848550,ECE 200,051,103636,Yip; Michael,9999,0,9999,0
1668047848550,ECE 200,052,103637,Zeger; Kenneth A.,999,0,999,0
1668047848550,ECE 200,053,103638,Zhang; Xinyu,9999,0,9999,0
1668047848550,ECE 200,054,103639,Turakhia; Yatish Girish,9999,0,9999,0
1668047848550,ECE 200,055,103640,Kang; Mingu,9999,0,9999,0
1668047848550,ECE 200,056,103641,Shi; Yuanyuan,9999,0,9999,0
1668047848550,ECE 200,057,103642,Wang; Edward Jay,9999,0,9999,0
1668047848550,ECE 200,058,103643,Zheng; Yang,9999,0,9999,0
1668047848977,ECE 202,A00,103644,Kuzum; Duygu,0,0,0,0
1668047849404,ECE 212BN,A00,103646,Ng; Tse Nga,0,0,0,0
1668047849833,ECE 221,A00,111493,Staff,0,0,0,0
1668047850257,ECE 222B,A00,103647,Lomakin; Vitaliy,0,0,0,0
1668047850688,ECE 230B,A00,103648,Taur; Yuan,0,0,0,0
1668047851121,ECE 238B,A00,103649,Garay; Javier,0,0,0,0
1668047851553,ECE 240B,A00,112900,Fainman; Yeshaiahu,0,0,0,0
1668047851975,ECE 247A,A00,103650,Jokerst; Jesse Vincent,0,0,0,0
1668047852399,ECE 247B,A00,103651,Wang; Joseph,0,0,0,0
1668047852842,ECE 250,A00,103652,Siegel; Paul H.,0,0,0,0
1668047853270,ECE 251A,A00,103654,Rao; Bhaskar D.,0,0,0,0
1668047853701,ECE 257B,A00,103655,Bharadia; Dinesh,0,0,0,0
1668047854126,ECE 258A,A00,103656,Milstein; Laurence B.,0,0,0,0
1668047854552,ECE 260B,A00,103658,Kang; Mingu,0,0,0,0
1668047854978,ECE 264A,A00,103659,Galton; Ian A,0,0,0,0
1668047855406,ECE 265A,A00,103661,Gudem; Prasad S.S.,0,0,0,0
1668047855831,ECE 265D,A00,103662,Gudem; Prasad S.S.,0,0,0,0
1668047856264,ECE 268,A00,103663,Koushanfar; Farinaz,0,0,0,0
1668047856690,ECE 269,A01,103665,Pal; Piya,0,0,0,0
1668047857118,ECE 271B,A00,103666,Vasconcelos; Manuela,0,0,0,0
1668047857540,ECE 276A,A00,103667,Atanasov; Nikolay A.,0,0,0,0
1668047857965,ECE 277,A00,103668,An; Cheolhong,0,0,0,0
1668047858389,ECE 279,A00,117947,Hall; Drew A.,0,0,0,0
1668047859236,ECE 283,A00,103670,Hsueh; Tzu-Chien,0,0,0,0
1668047859659,ECE 284,A00,103671,Turakhia; Yatish Girish,0,0,0,0
1668047860085,ECE 285,A00,103672,Zheng; Yang,0,0,0,0
1668047860085,ECE 285,B00,103673,Sworder; David D.,0,0,0,0
1668047860509,ECE 287,A00,103676,Javidi; Tara,0,0,0,0
1668047860935,MATH 200B,A00,098023,Salehi Golsefidy; Alireza,13,0,15,2
1668047861362,MATH 202B,A00,098024,Rhoades; Brendon Patrick,9,0,15,6
1668047861797,MATH 203B,A00,098025,Oprea; Dragos N.,11,0,15,4
1668047862235,MATH 204B,A00,098026,Sorensen; Claus M,13,0,15,2
1668047862657,MATH 208,A00,098027,Izadi; Elham,7,0,10,3
1668047863084,MATH 209,A00,098028,Pollack; Aaron,10,0,10,0
1668047863510,MATH 211A,A00,112919,Rogalski; Daniel,9,0,10,1
1668047863942,MATH 211B,A00,112920,Seward; Brandon M.,9,0,10,1
1668047864366,MATH 218,A00,098029,Li; Bo,10,0,10,0
1668047864790,MATH 220B,A00,098030,Novak; Jonathan I,13,0,15,2
1668047865217,MATH 221A,A00,098031,Ebenfelt; Peter F,13,0,15,2
1668047865651,MATH 231B,A00,098032,Zlatos; Andrej,12,0,15,3
1668047866099,MATH 240B,A00,098033,Ni; Lei,9,0,15,6
1668047866531,MATH 243,A00,098034,Jekel; David Andrew,10,0,10,0
1668047866970,MATH 245A,A00,098035,Nie; Jiawang,0,0,15,16
1668047867405,MATH 248,A00,098036,Bejenaru; Ioan,10,0,10,0
1668047867843,MATH 250B,A00,098037,Spolaor; Luca,14,0,15,1
1668047868272,MATH 258,A00,098038,Ni; Lei,10,0,10,0
1668047868703,MATH 264B,A00,098041,Rhoades; Brendon Patrick,10,0,15,5
1668047869140,MATH 268,A00,098042,Buss; Samuel R,10,0,10,0
1668047869566,MATH 269,A00,098043,Rhoades; Brendon Patrick,10,0,10,0
1668047870004,MATH 270B,A00,098044,Li; Bo,11,0,15,4
1668047870433,MATH 272B,A00,098045,Holst; Michael J,13,0,15,2
1668047870857,MATH 273A,A00,098046,Tian; Xiaochuan,10,0,15,5
1668047871280,MATH 275,A01,098048,Tian; Xiaochuan,6,0,10,4
1668047871707,MATH 278A,A00,098049,Holst; Michael J,8,0,10,2
1668047872130,MATH 278B,A00,098050,Cloninger; Alexander,10,0,10,0
1668047872663,MATH 278C,A00,098051,Nie; Jiawang,7,0,10,3
1668047873087,MATH 280B,A00,098052,Zheng; Tianyi,10,0,15,5
1668047873512,MATH 281B,A00,098053,Bradic; Jelena,3,0,15,12
1668047873941,MATH 282B,A00,098054,Arias-Castro; Ery,0,0,15,15
1668047874363,MATH 285,A00,098055,Fitzsimmons; Patrick J,0,0,15,17
1668047874790,MATH 287B,A00,098056,Arias-Castro; Ery,3,0,15,12
1668047875225,MATH 288,A00,098057,Agarwal; Pooja,9,0,10,1
1668047875225,MATH 288,B00,098058,Zhang; Danna,8,0,10,2
1668047875225,MATH 288,C00,098059,Williams; Ruth J,10,0,10,0
1668047875651,MATH 290B,A00,098060,Roberts; Justin Deritter,13,0,15,2
1668047876075,MATH 292,A00,098061,Belmont; Eva Kinoshita,10,0,10,0
1668047876502,MATH 295,A00,098062,Suk; Andrew Hoon,48,0,50,2
1668047876933,MATH 296,A00,098063,Novak; Jonathan I,20,0,20,0
1668047877363,MATH 297,001,098064,Gamst; Anthony Collins,9997,0,9999,2
1668048392024,COGS 205,A00,101395,Chiba; Andrea,19,0,20,1
1668048392462,COGS 210B,001,101404,Greene; Deanna Jacquelyn,9998,0,9999,1
1668048392462,COGS 210B,002,101417,Xia; Haijun,9999,0,9999,0
1668048392462,COGS 210B,003,101422,Nitz; Douglas A.,9999,0,9999,0
1668048392462,COGS 210B,004,101423,Hollan; James D.,9998,0,9999,1
1668048392462,COGS 210B,005,101424,Deak; Gedeon O.,9998,0,9999,1
1668048392462,COGS 210B,006,101425,Rossano; Federico,9999,0,9999,0
1668048392887,COGS 211B,A00,101427,Coulson; Seana M,9996,0,9999,3
1668048393321,COGS 220,A00,101428,Hollan; James D.,0,0,25,25
1668048393745,COGS 229,A00,101429,Dow; Steven P,18,0,25,7
1668048394169,COGS 230,A00,101430,Klemmer; Scott R,13,0,17,4
1668048394598,COGS 234,A00,101431,Xia; Haijun,4,0,25,21
1668048395028,COGS 260,A00,101432,Kiyonaga; Anastasia,19,0,25,6
1668048395028,COGS 260,B00,101433,Kirsh; David Joel,16,0,25,9
1668048395451,CSE 202,A00,102371,Impagliazzo; Russell,0,0,0,0
1668048395879,CSE 203B,A01,102373,Cheng; Chung Kuan,0,0,0,0
1668048396302,CSE 208,A00,102374,Micciancio; Daniele,0,0,0,0
1668048396730,CSE 209A,A00,112895,Impagliazzo; Russell,0,0,15,15
1668048397156,CSE 209B,A00,108005,Bellare; Mihir,0,0,0,0
1668048397589,CSE 210,A00,113163,Coblenz; Michael J,0,0,0,0
1668048398015,CSE 219,A00,106111,Dow; Steven P,0,0,20,20
1668048398441,CSE 221,A00,102376,Voelker; Geoffrey M.,0,0,0,0
1668048398864,CSE 224,A01,102378,Porter; George M,0,0,0,0
1668048399287,CSE 229A,A00,102379,Savage; Stefan,0,0,0,0
1668048399711,CSE 229C,A00,102380,Munyaka; Imani N. S.,0,0,0,0
1668048400136,CSE 232B,A00,102382,Deutsch; Alin Bernard,0,0,0,0
1668048400561,CSE 234,A01,112904,Kumar; Arun Kumar,0,0,0,0
1668048401006,CSE 237A,A00,102383,Rosing; Tajana Simunic,0,0,0,0
1668048401430,CSE 239A,A00,102384,Deutsch; Alin Bernard,0,0,0,0
1668048401864,CSE 239B,A00,102385,Polikarpova; Nadezhda,0,0,0,0
1668048402299,CSE 240A,A00,102386,Pannuto; Patrick William,0,0,0,0
1668048402722,CSE 240B,A00,102387,Zhao; Jishen,0,0,0,0
1668048403147,CSE 241A,A00,106406,Kang; Mingu,0,0,0,0
1668048403580,CSE 249B,A00,102388,Kahng; Andrew Byun,0,0,8,8
1668048404018,CSE 251B,A01,102392,Cottrell; Garrison W,0,0,0,0
1668048404018,CSE 251B,A02,102393,Cottrell; Garrison W,0,0,0,0
1668048404439,CSE 252B,A00,102394,Ochoa; Benjamin Lawrence,0,0,0,0
1668048404866,CSE 257,A01,102396,Gao; Sicun,0,0,0,0
1668048405290,CSE 272,A00,102397,Li; Tzumao,0,0,0,0
1668048405719,CSE 274,A00,111323,Chern; Albert Ren-Haur,0,0,0,0
1668048406154,CSE 282,A00,102398,Pevzner; Pavel Arkadjevich,0,0,0,0
1668048406583,CSE 284,A00,114175,Gymrek; Melissa Ann,0,0,0,0
1668048407022,CSE 290,A00,102399,Chandraker; Manmohan Krishna,0,0,0,0
1668048407022,CSE 290,B00,102400,Vaccaro; Kristen Marie,0,0,25,25
1668048407022,CSE 290,C00,102414,Pannuto; Patrick William,0,0,25,25
1668048407022,CSE 290,D00,102427,Pevzner; Pavel Arkadjevich,0,0,0,0
1668048407022,CSE 290,E00,102429,Zhao; Jishen,0,0,0,0
1668048407022,CSE 290,F00,102436,Tullsen; Dean Michael,0,0,0,0
1668048407022,CSE 290,G00,102440,Christensen; Henrik I,0,0,20,20
1668048407559,CSE 291,A00,102443,Su; Hao,0,0,0,0
1668048407559,CSE 291,B00,102448,Polikarpova; Nadezhda,0,0,0,0
1668048407559,CSE 291,C00,102453,Vaccaro; Kristen Marie,0,0,0,0
1668048407559,CSE 291,D00,111343,Savage; Stefan,0,0,0,0
1668048407559,CSE 291,E00,116474,Claffy; Kimberly Claire,0,0,0,0
1668048407559,CSE 291,F00,116479,Pasquale; Joseph,0,0,0,0
1668048408002,CSE 293,001,119111,Bafna; Vineet,9999,0,9999,0
1668048408002,CSE 293,002,119118,Bellare; Mihir,9999,0,9999,0
1668048408002,CSE 293,003,119122,Berg-Kirkpatrick; Taylor D,9999,0,9999,0
1668048408002,CSE 293,004,119135,Christensen; Henrik I,9999,0,9999,0
1668048408002,CSE 293,005,119142,Cottrell; Garrison W,9999,0,9999,0
1668048408002,CSE 293,006,119146,Deutsch; Alin Bernard,9999,0,9999,0
1668048408002,CSE 293,007,119159,Esmaeilzadeh; Hadi,9999,0,9999,0
1668048408002,CSE 293,008,119166,Freund; Yoav,9999,0,9999,0
1668048408002,CSE 293,009,119170,Griswold; William G.,9999,0,9999,0
1668048408002,CSE 293,010,119183,Gymrek; Melissa Ann,9999,0,9999,0
1668048408002,CSE 293,011,119190,Heninger; Nadia A,9999,0,9999,0
1668048408002,CSE 293,012,119230,Impagliazzo; Russell,9999,0,9999,0
1668048408002,CSE 293,013,119232,Jhala; Ranjit,9999,0,9999,0
1668048408002,CSE 293,014,119233,Kahng; Andrew Byun,9999,0,9999,0
1668048408002,CSE 293,015,119298,Kane; Daniel Mertz,9999,0,9999,0
1668048408002,CSE 293,016,119299,Kriegman; David J,9999,0,9999,0
1668048408002,CSE 293,017,119300,Kumar; Arun Kumar,9999,0,9999,0
1668048408002,CSE 293,018,119301,Lerner; Sorin,9999,0,9999,0
1668048408002,CSE 293,019,119302,Lovett; Shachar,9999,0,9999,0
1668048408002,CSE 293,020,119303,McAuley; Julian John,9999,0,9999,0
1668048408002,CSE 293,021,119304,Micciancio; Daniele,9999,0,9999,0
1668048408002,CSE 293,022,119367,Orailoglu; Alex,9999,0,9999,0
1668048408002,CSE 293,023,119382,Paturi; Ramamohan,9999,0,9999,0
1668048408002,CSE 293,024,119404,Polikarpova; Nadezhda,9999,0,9999,0
1668048408002,CSE 293,025,119406,Politz; Joseph Gibbs,9999,0,9999,0
1668048408002,CSE 293,026,119411,Porter; George M,9999,0,9999,0
1668048408002,CSE 293,027,119414,Porter; Leonard Emerson,9999,0,9999,0
1668048408002,CSE 293,028,119416,Ramamoorthi; Ravi,9999,0,9999,0
1668048408002,CSE 293,029,119417,Sahoo; Debashis,9999,0,9999,0
1668048408002,CSE 293,030,119420,Saul; Lawrence,9999,0,9999,0
1668048408002,CSE 293,031,119421,Savage; Stefan,9999,0,9999,0
1668048408002,CSE 293,032,119425,Schulze; Jurgen P.,9999,0,9999,0
1668048408002,CSE 293,033,119426,Snoeren; Alex C.,9999,0,9999,0
1668048408002,CSE 293,034,119428,Shang; Jingbo,9999,0,9999,0
1668048408002,CSE 293,035,119430,Stefan; Deian,9999,0,9999,0
1668048408002,CSE 293,036,119431,Su; Hao,9999,0,9999,0
1668048408002,CSE 293,037,119433,Swanson; Steven James,9999,0,9999,0
1668048408002,CSE 293,038,119435,Tullsen; Dean Michael,9999,0,9999,0
1668048408002,CSE 293,039,119483,Voelker; Geoffrey M.,9999,0,9999,0
1668048408002,CSE 293,040,119537,Zhao; Jishen,9999,0,9999,0
1668048408002,CSE 293,041,119538,Zhou; Yuan-Yuan,9999,0,9999,0
1668048408002,CSE 293,042,119539,Gao; Sicun,9999,0,9999,0
1668048408002,CSE 293,043,119540,Weibel; Nadir,9999,0,9999,0
1668048408002,CSE 293,044,119541,Gupta; Rajesh K.,9999,0,9999,0
1668048408002,CSE 293,045,126410,Vaccaro; Kristen Marie,9999,0,9999,0
1668048408002,CSE 293,046,126411,Klemke; Richard,9999,0,9999,0
1668048408426,CSE 294,A00,102459,Voelker; Geoffrey M.,0,0,0,0
1668048408426,CSE 294,B00,111322,Orailoglu; Alex,0,0,0,0
1668048408852,DSE 201,A00,096914,Deutsch; Alin Bernard,30,0,30,0
1668048409278,DSE 210,A00,096915,Dasgupta; Sanjoy,30,0,30,0
1668048409701,DSE 260A,A00,096916,Altintas De Callaf; Ilkay,30,0,30,0
1668048410150,ECE 200,001,103586,Antipa; Nicholas A,9999,0,9999,0
1668048410150,ECE 200,002,103587,Atanasov; Nikolay A.,9999,0,9999,0
1668048410150,ECE 200,003,103588,Bharadia; Dinesh,9999,0,9999,0
1668048410150,ECE 200,004,103589,Cheng; Chung Kuan,9999,0,9999,0
1668048410150,ECE 200,005,103590,Cosman; Pamela C.,9999,0,9999,0
1668048410150,ECE 200,006,103591,Dayeh; Shadi Ahmad,9999,0,9999,0
1668048410150,ECE 200,007,103592,Fainman; Yeshaiahu,9999,0,9999,0
1668048410150,ECE 200,008,103593,Ford; Joseph Earl,9999,0,9999,0
1668048410150,ECE 200,009,103594,Franceschetti; Massimo,9999,0,9999,0
1668048410150,ECE 200,010,103595,Fullerton; Eric E,9999,0,9999,0
1668048410150,ECE 200,011,103596,Galton; Ian A,9999,0,9999,0
1668048410150,ECE 200,012,103597,Gilja; Vikash,9999,0,9999,0
1668048410150,ECE 200,013,103598,Hall; Drew A.,9999,0,9999,0
1668048410150,ECE 200,014,103599,Hsueh; Tzu-Chien,9999,0,9999,0
1668048410150,ECE 200,015,103600,Javidi; Tara,9999,0,9999,0
1668048410150,ECE 200,016,103601,Kahng; Andrew Byun,9999,0,9999,0
1668048410150,ECE 200,017,103602,Kim; Young-Han,9999,0,9999,0
1668048410150,ECE 200,018,103603,Koushanfar; Farinaz,9999,0,9999,0
1668048410150,ECE 200,019,103604,Kuzum; Duygu,9999,0,9999,0
1668048410150,ECE 200,020,103605,Le; Hanh-Phuc,9999,0,9999,0
1668048410150,ECE 200,021,103606,Lin; Bill,9999,0,9999,0
1668048410150,ECE 200,022,103607,Liu; Zhaowei,9998,0,9999,1
1668048410150,ECE 200,023,103608,Lo; Yu-Hwa,9999,0,9999,0
1668048410150,ECE 200,024,103609,Lomakin; Vitaliy,9999,0,9999,0
1668048410150,ECE 200,025,103610,Mercier; Patrick Philip,9999,0,9999,0
1668048410150,ECE 200,026,103611,Meyer; Florian,9999,0,9999,0
1668048410150,ECE 200,027,103612,Milstein; Laurence B.,9999,0,9999,0
1668048410150,ECE 200,028,103613,Mir Arabbaygi; Siavash,9999,0,9999,0
1668048410150,ECE 200,029,103614,Mookherjea; Shayan,9999,0,9999,0
1668048410150,ECE 200,030,103615,Morris; Karcher William,9999,0,9999,0
1668048410150,ECE 200,031,103616,Ng; Tse Nga,9999,0,9999,0
1668048410150,ECE 200,032,103617,Nguyen; Truong Quang,9999,0,9999,0
1668048410150,ECE 200,033,103618,Nomura; Kenji,9999,0,9999,0
1668048410150,ECE 200,034,103619,Orlitsky; Alon,9999,0,9999,0
1668048410150,ECE 200,035,103620,Pal; Piya,9999,0,9999,0
1668048410150,ECE 200,036,103621,Papen; George C.,9999,0,9999,0
1668048410150,ECE 200,037,103622,Radic; Stojan,9999,0,9999,0
1668048410150,ECE 200,038,103623,Rao; Bhaskar D.,9999,0,9999,0
1668048410150,ECE 200,039,103624,Rao; Ramesh R,9999,0,9999,0
1668048410150,ECE 200,040,103625,Rebeiz; Gabriel,9999,0,9999,0
1668048410150,ECE 200,041,103626,Sanford; John R,9999,0,9999,0
1668048410150,ECE 200,042,103627,Siegel; Paul H.,9999,0,9999,0
1668048410150,ECE 200,043,103628,Sievenpiper; Daniel F.,9999,0,9999,0
1668048410150,ECE 200,044,103629,Sworder; David D.,9999,0,9999,0
1668048410150,ECE 200,045,103630,Taur; Yuan,9999,0,9999,0
1668048410150,ECE 200,046,103631,Touri; Behrouz,9999,0,9999,0
1668048410150,ECE 200,047,103632,Trivedi; Mohan M.,9999,0,9999,0
1668048410150,ECE 200,048,103633,Vasconcelos; Nuno,9999,0,9999,0
1668048410150,ECE 200,049,103634,Wang; Xiaolong,9999,0,9999,0
1668048410150,ECE 200,050,103635,Xie; Pengtao,9999,0,9999,0
1668048410150,ECE 200,051,103636,Yip; Michael,9999,0,9999,0
1668048410150,ECE 200,052,103637,Zeger; Kenneth A.,999,0,999,0
1668048410150,ECE 200,053,103638,Zhang; Xinyu,9999,0,9999,0
1668048410150,ECE 200,054,103639,Turakhia; Yatish Girish,9999,0,9999,0
1668048410150,ECE 200,055,103640,Kang; Mingu,9999,0,9999,0
1668048410150,ECE 200,056,103641,Shi; Yuanyuan,9999,0,9999,0
1668048410150,ECE 200,057,103642,Wang; Edward Jay,9999,0,9999,0
1668048410150,ECE 200,058,103643,Zheng; Yang,9999,0,9999,0
1668048410577,ECE 202,A00,103644,Kuzum; Duygu,0,0,0,0
1668048410998,ECE 212BN,A00,103646,Ng; Tse Nga,0,0,0,0
1668048411422,ECE 221,A00,111493,Staff,0,0,0,0
1668048411844,ECE 222B,A00,103647,Lomakin; Vitaliy,0,0,0,0
1668048412272,ECE 230B,A00,103648,Taur; Yuan,0,0,0,0
1668048412695,ECE 238B,A00,103649,Garay; Javier,0,0,0,0
1668048413116,ECE 240B,A00,112900,Fainman; Yeshaiahu,0,0,0,0
1668048413554,ECE 247A,A00,103650,Jokerst; Jesse Vincent,0,0,0,0
1668048413980,ECE 247B,A00,103651,Wang; Joseph,0,0,0,0
1668048414416,ECE 250,A00,103652,Siegel; Paul H.,0,0,0,0
1668048414842,ECE 251A,A00,103654,Rao; Bhaskar D.,0,0,0,0
1668048415268,ECE 257B,A00,103655,Bharadia; Dinesh,0,0,0,0
1668048415695,ECE 258A,A00,103656,Milstein; Laurence B.,0,0,0,0
1668048416117,ECE 260B,A00,103658,Kang; Mingu,0,0,0,0
1668048416541,ECE 264A,A00,103659,Galton; Ian A,0,0,0,0
1668048416967,ECE 265A,A00,103661,Gudem; Prasad S.S.,0,0,0,0
1668048417395,ECE 265D,A00,103662,Gudem; Prasad S.S.,0,0,0,0
1668048417818,ECE 268,A00,103663,Koushanfar; Farinaz,0,0,0,0
1668048418242,ECE 269,A01,103665,Pal; Piya,0,0,0,0
1668048418669,ECE 271B,A00,103666,Vasconcelos; Manuela,0,0,0,0
1668048419092,ECE 276A,A00,103667,Atanasov; Nikolay A.,0,0,0,0
1668048419515,ECE 277,A00,103668,An; Cheolhong,0,0,0,0
1668048419947,ECE 279,A00,117947,Hall; Drew A.,0,0,0,0
1668048420804,ECE 283,A00,103670,Hsueh; Tzu-Chien,0,0,0,0
1668048421235,ECE 284,A00,103671,Turakhia; Yatish Girish,0,0,0,0
1668048421671,ECE 285,A00,103672,Zheng; Yang,0,0,0,0
1668048421671,ECE 285,B00,103673,Sworder; David D.,0,0,0,0
1668048422099,ECE 287,A00,103676,Javidi; Tara,0,0,0,0
1668048422522,MATH 200B,A00,098023,Salehi Golsefidy; Alireza,13,0,15,2
1668048422952,MATH 202B,A00,098024,Rhoades; Brendon Patrick,9,0,15,6
1668048423383,MATH 203B,A00,098025,Oprea; Dragos N.,11,0,15,4
1668048423808,MATH 204B,A00,098026,Sorensen; Claus M,13,0,15,2
1668048424246,MATH 208,A00,098027,Izadi; Elham,7,0,10,3
1668048424669,MATH 209,A00,098028,Pollack; Aaron,10,0,10,0
1668048425096,MATH 211A,A00,112919,Rogalski; Daniel,9,0,10,1
1668048425526,MATH 211B,A00,112920,Seward; Brandon M.,9,0,10,1
1668048425961,MATH 218,A00,098029,Li; Bo,10,0,10,0
1668048426388,MATH 220B,A00,098030,Novak; Jonathan I,13,0,15,2
1668048426813,MATH 221A,A00,098031,Ebenfelt; Peter F,13,0,15,2
1668048427237,MATH 231B,A00,098032,Zlatos; Andrej,12,0,15,3
1668048427672,MATH 240B,A00,098033,Ni; Lei,9,0,15,6
1668048428096,MATH 243,A00,098034,Jekel; David Andrew,10,0,10,0
1668048428523,MATH 245A,A00,098035,Nie; Jiawang,0,0,15,16
1668048428948,MATH 248,A00,098036,Bejenaru; Ioan,10,0,10,0
1668048429379,MATH 250B,A00,098037,Spolaor; Luca,14,0,15,1
1668048429811,MATH 258,A00,098038,Ni; Lei,10,0,10,0
1668048430234,MATH 264B,A00,098041,Rhoades; Brendon Patrick,10,0,15,5
1668048430662,MATH 268,A00,098042,Buss; Samuel R,10,0,10,0
1668048431087,MATH 269,A00,098043,Rhoades; Brendon Patrick,10,0,10,0
1668048431510,MATH 270B,A00,098044,Li; Bo,11,0,15,4
1668048431934,MATH 272B,A00,098045,Holst; Michael J,13,0,15,2
1668048432367,MATH 273A,A00,098046,Tian; Xiaochuan,10,0,15,5
1668048432796,MATH 275,A01,098048,Tian; Xiaochuan,6,0,10,4
1668048433226,MATH 278A,A00,098049,Holst; Michael J,8,0,10,2
1668048433660,MATH 278B,A00,098050,Cloninger; Alexander,10,0,10,0
1668048434084,MATH 278C,A00,098051,Nie; Jiawang,7,0,10,3
1668048434509,MATH 280B,A00,098052,Zheng; Tianyi,10,0,15,5
1668048434936,MATH 281B,A00,098053,Bradic; Jelena,3,0,15,12
1668048435359,MATH 282B,A00,098054,Arias-Castro; Ery,0,0,15,15
1668048435784,MATH 285,A00,098055,Fitzsimmons; Patrick J,0,0,15,17
1668048436209,MATH 287B,A00,098056,Arias-Castro; Ery,3,0,15,12
1668048436633,MATH 288,A00,098057,Agarwal; Pooja,9,0,10,1
1668048436633,MATH 288,B00,098058,Zhang; Danna,8,0,10,2
1668048436633,MATH 288,C00,098059,Williams; Ruth J,10,0,10,0
1668048437072,MATH 290B,A00,098060,Roberts; Justin Deritter,13,0,15,2
1668048437495,MATH 292,A00,098061,Belmont; Eva Kinoshita,10,0,10,0
1668048437920,MATH 295,A00,098062,Suk; Andrew Hoon,48,0,50,2
1668048438342,MATH 296,A00,098063,Novak; Jonathan I,20,0,20,0
1668048438775,MATH 297,001,098064,Gamst; Anthony Collins,9997,0,9999,2
1668048941831,COGS 205,A00,101395,Chiba; Andrea,19,0,20,1
1668048942264,COGS 210B,001,101404,Greene; Deanna Jacquelyn,9998,0,9999,1
1668048942264,COGS 210B,002,101417,Xia; Haijun,9999,0,9999,0
1668048942264,COGS 210B,003,101422,Nitz; Douglas A.,9999,0,9999,0
1668048942264,COGS 210B,004,101423,Hollan; James D.,9998,0,9999,1
1668048942264,COGS 210B,005,101424,Deak; Gedeon O.,9998,0,9999,1
1668048942264,COGS 210B,006,101425,Rossano; Federico,9999,0,9999,0
1668048942688,COGS 211B,A00,101427,Coulson; Seana M,9996,0,9999,3
1668048943111,COGS 220,A00,101428,Hollan; James D.,0,0,25,25
1668048943535,COGS 229,A00,101429,Dow; Steven P,18,0,25,7
1668048943970,COGS 230,A00,101430,Klemmer; Scott R,13,0,17,4
1668048944393,COGS 234,A00,101431,Xia; Haijun,4,0,25,21
1668048944816,COGS 260,A00,101432,Kiyonaga; Anastasia,19,0,25,6
1668048944816,COGS 260,B00,101433,Kirsh; David Joel,16,0,25,9
1668048945241,CSE 202,A00,102371,Impagliazzo; Russell,0,0,0,0
1668048945670,CSE 203B,A01,102373,Cheng; Chung Kuan,0,0,0,0
1668048946109,CSE 208,A00,102374,Micciancio; Daniele,0,0,0,0
1668048946536,CSE 209A,A00,112895,Impagliazzo; Russell,0,0,15,15
1668048946962,CSE 209B,A00,108005,Bellare; Mihir,0,0,0,0
1668048947392,CSE 210,A00,113163,Coblenz; Michael J,0,0,0,0
1668048947815,CSE 219,A00,106111,Dow; Steven P,0,0,20,20
1668048948243,CSE 221,A00,102376,Voelker; Geoffrey M.,0,0,0,0
1668048948670,CSE 224,A01,102378,Porter; George M,0,0,0,0
1668048949094,CSE 229A,A00,102379,Savage; Stefan,0,0,0,0
1668048949529,CSE 229C,A00,102380,Munyaka; Imani N. S.,0,0,0,0
1668048949967,CSE 232B,A00,102382,Deutsch; Alin Bernard,0,0,0,0
1668048950391,CSE 234,A01,112904,Kumar; Arun Kumar,0,0,0,0
1668048950815,CSE 237A,A00,102383,Rosing; Tajana Simunic,0,0,0,0
1668048951241,CSE 239A,A00,102384,Deutsch; Alin Bernard,0,0,0,0
1668048951685,CSE 239B,A00,102385,Polikarpova; Nadezhda,0,0,0,0
1668048952121,CSE 240A,A00,102386,Pannuto; Patrick William,0,0,0,0
1668048952545,CSE 240B,A00,102387,Zhao; Jishen,0,0,0,0
1668048952979,CSE 241A,A00,106406,Kang; Mingu,0,0,0,0
1668048953403,CSE 249B,A00,102388,Kahng; Andrew Byun,0,0,8,8
1668048953827,CSE 251B,A01,102392,Cottrell; Garrison W,0,0,0,0
1668048953827,CSE 251B,A02,102393,Cottrell; Garrison W,0,0,0,0
1668048954255,CSE 252B,A00,102394,Ochoa; Benjamin Lawrence,0,0,0,0
1668048954686,CSE 257,A01,102396,Gao; Sicun,0,0,0,0
1668048955114,CSE 272,A00,102397,Li; Tzumao,0,0,0,0
1668048955549,CSE 274,A00,111323,Chern; Albert Ren-Haur,0,0,0,0
1668048955979,CSE 282,A00,102398,Pevzner; Pavel Arkadjevich,0,0,0,0
1668048956418,CSE 284,A00,114175,Gymrek; Melissa Ann,0,0,0,0
1668048956843,CSE 290,A00,102399,Chandraker; Manmohan Krishna,0,0,0,0
1668048956843,CSE 290,B00,102400,Vaccaro; Kristen Marie,0,0,25,25
1668048956843,CSE 290,C00,102414,Pannuto; Patrick William,0,0,25,25
1668048956843,CSE 290,D00,102427,Pevzner; Pavel Arkadjevich,0,0,0,0
1668048956843,CSE 290,E00,102429,Zhao; Jishen,0,0,0,0
1668048956843,CSE 290,F00,102436,Tullsen; Dean Michael,0,0,0,0
1668048956843,CSE 290,G00,102440,Christensen; Henrik I,0,0,20,20
1668048957266,CSE 291,A00,102443,Su; Hao,0,0,0,0
1668048957266,CSE 291,B00,102448,Polikarpova; Nadezhda,0,0,0,0
1668048957266,CSE 291,C00,102453,Vaccaro; Kristen Marie,0,0,0,0
1668048957266,CSE 291,D00,111343,Savage; Stefan,0,0,0,0
1668048957266,CSE 291,E00,116474,Claffy; Kimberly Claire,0,0,0,0
1668048957266,CSE 291,F00,116479,Pasquale; Joseph,0,0,0,0
1668048957716,CSE 293,001,119111,Bafna; Vineet,9999,0,9999,0
1668048957716,CSE 293,002,119118,Bellare; Mihir,9999,0,9999,0
1668048957716,CSE 293,003,119122,Berg-Kirkpatrick; Taylor D,9999,0,9999,0
1668048957716,CSE 293,004,119135,Christensen; Henrik I,9999,0,9999,0
1668048957716,CSE 293,005,119142,Cottrell; Garrison W,9999,0,9999,0
1668048957716,CSE 293,006,119146,Deutsch; Alin Bernard,9999,0,9999,0
1668048957716,CSE 293,007,119159,Esmaeilzadeh; Hadi,9999,0,9999,0
1668048957716,CSE 293,008,119166,Freund; Yoav,9999,0,9999,0
1668048957716,CSE 293,009,119170,Griswold; William G.,9999,0,9999,0
1668048957716,CSE 293,010,119183,Gymrek; Melissa Ann,9999,0,9999,0
1668048957716,CSE 293,011,119190,Heninger; Nadia A,9999,0,9999,0
1668048957716,CSE 293,012,119230,Impagliazzo; Russell,9999,0,9999,0
1668048957716,CSE 293,013,119232,Jhala; Ranjit,9999,0,9999,0
1668048957716,CSE 293,014,119233,Kahng; Andrew Byun,9999,0,9999,0
1668048957716,CSE 293,015,119298,Kane; Daniel Mertz,9999,0,9999,0
1668048957716,CSE 293,016,119299,Kriegman; David J,9999,0,9999,0
1668048957716,CSE 293,017,119300,Kumar; Arun Kumar,9999,0,9999,0
1668048957716,CSE 293,018,119301,Lerner; Sorin,9999,0,9999,0
1668048957716,CSE 293,019,119302,Lovett; Shachar,9999,0,9999,0
1668048957716,CSE 293,020,119303,McAuley; Julian John,9999,0,9999,0
1668048957716,CSE 293,021,119304,Micciancio; Daniele,9999,0,9999,0
1668048957716,CSE 293,022,119367,Orailoglu; Alex,9999,0,9999,0
1668048957716,CSE 293,023,119382,Paturi; Ramamohan,9999,0,9999,0
1668048957716,CSE 293,024,119404,Polikarpova; Nadezhda,9999,0,9999,0
1668048957716,CSE 293,025,119406,Politz; Joseph Gibbs,9999,0,9999,0
1668048957716,CSE 293,026,119411,Porter; George M,9999,0,9999,0
1668048957716,CSE 293,027,119414,Porter; Leonard Emerson,9999,0,9999,0
1668048957716,CSE 293,028,119416,Ramamoorthi; Ravi,9999,0,9999,0
1668048957716,CSE 293,029,119417,Sahoo; Debashis,9999,0,9999,0
1668048957716,CSE 293,030,119420,Saul; Lawrence,9999,0,9999,0
1668048957716,CSE 293,031,119421,Savage; Stefan,9999,0,9999,0
1668048957716,CSE 293,032,119425,Schulze; Jurgen P.,9999,0,9999,0
1668048957716,CSE 293,033,119426,Snoeren; Alex C.,9999,0,9999,0
1668048957716,CSE 293,034,119428,Shang; Jingbo,9999,0,9999,0
1668048957716,CSE 293,035,119430,Stefan; Deian,9999,0,9999,0
1668048957716,CSE 293,036,119431,Su; Hao,9999,0,9999,0
1668048957716,CSE 293,037,119433,Swanson; Steven James,9999,0,9999,0
1668048957716,CSE 293,038,119435,Tullsen; Dean Michael,9999,0,9999,0
1668048957716,CSE 293,039,119483,Voelker; Geoffrey M.,9999,0,9999,0
1668048957716,CSE 293,040,119537,Zhao; Jishen,9999,0,9999,0
1668048957716,CSE 293,041,119538,Zhou; Yuan-Yuan,9999,0,9999,0
1668048957716,CSE 293,042,119539,Gao; Sicun,9999,0,9999,0
1668048957716,CSE 293,043,119540,Weibel; Nadir,9999,0,9999,0
1668048957716,CSE 293,044,119541,Gupta; Rajesh K.,9999,0,9999,0
1668048957716,CSE 293,045,126410,Vaccaro; Kristen Marie,9999,0,9999,0
1668048957716,CSE 293,046,126411,Klemke; Richard,9999,0,9999,0
1668048958146,CSE 294,A00,102459,Voelker; Geoffrey M.,0,0,0,0
1668048958146,CSE 294,B00,111322,Orailoglu; Alex,0,0,0,0
1668048958571,DSE 201,A00,096914,Deutsch; Alin Bernard,30,0,30,0
1668048958996,DSE 210,A00,096915,Dasgupta; Sanjoy,30,0,30,0
1668048959423,DSE 260A,A00,096916,Altintas De Callaf; Ilkay,30,0,30,0
1668048959889,ECE 200,001,103586,Antipa; Nicholas A,9999,0,9999,0
1668048959889,ECE 200,002,103587,Atanasov; Nikolay A.,9999,0,9999,0
1668048959889,ECE 200,003,103588,Bharadia; Dinesh,9999,0,9999,0
1668048959889,ECE 200,004,103589,Cheng; Chung Kuan,9999,0,9999,0
1668048959889,ECE 200,005,103590,Cosman; Pamela C.,9999,0,9999,0
1668048959889,ECE 200,006,103591,Dayeh; Shadi Ahmad,9999,0,9999,0
1668048959889,ECE 200,007,103592,Fainman; Yeshaiahu,9999,0,9999,0
1668048959889,ECE 200,008,103593,Ford; Joseph Earl,9999,0,9999,0
1668048959889,ECE 200,009,103594,Franceschetti; Massimo,9999,0,9999,0
1668048959889,ECE 200,010,103595,Fullerton; Eric E,9999,0,9999,0
1668048959889,ECE 200,011,103596,Galton; Ian A,9999,0,9999,0
1668048959889,ECE 200,012,103597,Gilja; Vikash,9999,0,9999,0
1668048959889,ECE 200,013,103598,Hall; Drew A.,9999,0,9999,0
1668048959889,ECE 200,014,103599,Hsueh; Tzu-Chien,9999,0,9999,0
1668048959889,ECE 200,015,103600,Javidi; Tara,9999,0,9999,0
1668048959889,ECE 200,016,103601,Kahng; Andrew Byun,9999,0,9999,0
1668048959889,ECE 200,017,103602,Kim; Young-Han,9999,0,9999,0
1668048959889,ECE 200,018,103603,Koushanfar; Farinaz,9999,0,9999,0
1668048959889,ECE 200,019,103604,Kuzum; Duygu,9999,0,9999,0
1668048959889,ECE 200,020,103605,Le; Hanh-Phuc,9999,0,9999,0
1668048959889,ECE 200,021,103606,Lin; Bill,9999,0,9999,0
1668048959889,ECE 200,022,103607,Liu; Zhaowei,9998,0,9999,1
1668048959889,ECE 200,023,103608,Lo; Yu-Hwa,9999,0,9999,0
1668048959889,ECE 200,024,103609,Lomakin; Vitaliy,9999,0,9999,0
1668048959889,ECE 200,025,103610,Mercier; Patrick Philip,9999,0,9999,0
1668048959889,ECE 200,026,103611,Meyer; Florian,9999,0,9999,0
1668048959889,ECE 200,027,103612,Milstein; Laurence B.,9999,0,9999,0
1668048959889,ECE 200,028,103613,Mir Arabbaygi; Siavash,9999,0,9999,0
1668048959889,ECE 200,029,103614,Mookherjea; Shayan,9999,0,9999,0
1668048959889,ECE 200,030,103615,Morris; Karcher William,9999,0,9999,0
1668048959889,ECE 200,031,103616,Ng; Tse Nga,9999,0,9999,0
1668048959889,ECE 200,032,103617,Nguyen; Truong Quang,9999,0,9999,0
1668048959889,ECE 200,033,103618,Nomura; Kenji,9999,0,9999,0
1668048959889,ECE 200,034,103619,Orlitsky; Alon,9999,0,9999,0
1668048959889,ECE 200,035,103620,Pal; Piya,9999,0,9999,0
1668048959889,ECE 200,036,103621,Papen; George C.,9999,0,9999,0
1668048959889,ECE 200,037,103622,Radic; Stojan,9999,0,9999,0
1668048959889,ECE 200,038,103623,Rao; Bhaskar D.,9999,0,9999,0
1668048959889,ECE 200,039,103624,Rao; Ramesh R,9999,0,9999,0
1668048959889,ECE 200,040,103625,Rebeiz; Gabriel,9999,0,9999,0
1668048959889,ECE 200,041,103626,Sanford; John R,9999,0,9999,0
1668048959889,ECE 200,042,103627,Siegel; Paul H.,9999,0,9999,0
1668048959889,ECE 200,043,103628,Sievenpiper; Daniel F.,9999,0,9999,0
1668048959889,ECE 200,044,103629,Sworder; David D.,9999,0,9999,0
1668048959889,ECE 200,045,103630,Taur; Yuan,9999,0,9999,0
1668048959889,ECE 200,046,103631,Touri; Behrouz,9999,0,9999,0
1668048959889,ECE 200,047,103632,Trivedi; Mohan M.,9999,0,9999,0
1668048959889,ECE 200,048,103633,Vasconcelos; Nuno,9999,0,9999,0
1668048959889,ECE 200,049,103634,Wang; Xiaolong,9999,0,9999,0
1668048959889,ECE 200,050,103635,Xie; Pengtao,9999,0,9999,0
1668048959889,ECE 200,051,103636,Yip; Michael,9999,0,9999,0
1668048959889,ECE 200,052,103637,Zeger; Kenneth A.,999,0,999,0
1668048959889,ECE 200,053,103638,Zhang; Xinyu,9999,0,9999,0
1668048959889,ECE 200,054,103639,Turakhia; Yatish Girish,9999,0,9999,0
1668048959889,ECE 200,055,103640,Kang; Mingu,9999,0,9999,0
1668048959889,ECE 200,056,103641,Shi; Yuanyuan,9999,0,9999,0
1668048959889,ECE 200,057,103642,Wang; Edward Jay,9999,0,9999,0
1668048959889,ECE 200,058,103643,Zheng; Yang,9999,0,9999,0
1668048960318,ECE 202,A00,103644,Kuzum; Duygu,0,0,0,0
1668048960744,ECE 212BN,A00,103646,Ng; Tse Nga,0,0,0,0
1668048961168,ECE 221,A00,111493,Staff,0,0,0,0
1668048961591,ECE 222B,A00,103647,Lomakin; Vitaliy,0,0,0,0
1668048962018,ECE 230B,A00,103648,Taur; Yuan,0,0,0,0
1668048962443,ECE 238B,A00,103649,Garay; Javier,0,0,0,0
1668048962879,ECE 240B,A00,112900,Fainman; Yeshaiahu,0,0,0,0
1668048963303,ECE 247A,A00,103650,Jokerst; Jesse Vincent,0,0,0,0
1668048963727,ECE 247B,A00,103651,Wang; Joseph,0,0,0,0
1668048964153,ECE 250,A00,103652,Siegel; Paul H.,0,0,0,0
1668048964585,ECE 251A,A00,103654,Rao; Bhaskar D.,0,0,0,0
1668048965025,ECE 257B,A00,103655,Bharadia; Dinesh,0,0,0,0
1668048965447,ECE 258A,A00,103656,Milstein; Laurence B.,0,0,0,0
1668048965874,ECE 260B,A00,103658,Kang; Mingu,0,0,0,0
1668048966302,ECE 264A,A00,103659,Galton; Ian A,0,0,0,0
1668048966734,ECE 265A,A00,103661,Gudem; Prasad S.S.,0,0,0,0
1668048967165,ECE 265D,A00,103662,Gudem; Prasad S.S.,0,0,0,0
1668048967590,ECE 268,A00,103663,Koushanfar; Farinaz,0,0,0,0
1668048968017,ECE 269,A01,103665,Pal; Piya,0,0,0,0
1668048968442,ECE 271B,A00,103666,Vasconcelos; Manuela,0,0,0,0
1668048968865,ECE 276A,A00,103667,Atanasov; Nikolay A.,0,0,0,0
1668048969292,ECE 277,A00,103668,An; Cheolhong,0,0,0,0
1668048969715,ECE 279,A00,117947,Hall; Drew A.,0,0,0,0
1668048970589,ECE 283,A00,103670,Hsueh; Tzu-Chien,0,0,0,0
1668048971025,ECE 284,A00,103671,Turakhia; Yatish Girish,0,0,0,0
1668048971447,ECE 285,A00,103672,Zheng; Yang,0,0,0,0
1668048971447,ECE 285,B00,103673,Sworder; David D.,0,0,0,0
1668048971869,ECE 287,A00,103676,Javidi; Tara,0,0,0,0
1668048972293,MATH 200B,A00,098023,Salehi Golsefidy; Alireza,13,0,15,2
1668048972717,MATH 202B,A00,098024,Rhoades; Brendon Patrick,9,0,15,6
1668048973143,MATH 203B,A00,098025,Oprea; Dragos N.,11,0,15,4
1668048973569,MATH 204B,A00,098026,Sorensen; Claus M,13,0,15,2
1668048974091,MATH 208,A00,098027,Izadi; Elham,7,0,10,3
1668048974518,MATH 209,A00,098028,Pollack; Aaron,10,0,10,0
1668048974943,MATH 211A,A00,112919,Rogalski; Daniel,9,0,10,1
1668048975368,MATH 211B,A00,112920,Seward; Brandon M.,9,0,10,1
1668048975797,MATH 218,A00,098029,Li; Bo,10,0,10,0
1668048976303,MATH 220B,A00,098030,Novak; Jonathan I,13,0,15,2
1668048976725,MATH 221A,A00,098031,Ebenfelt; Peter F,13,0,15,2
1668048977155,MATH 231B,A00,098032,Zlatos; Andrej,12,0,15,3
1668048977591,MATH 240B,A00,098033,Ni; Lei,9,0,15,6
1668048978022,MATH 243,A00,098034,Jekel; David Andrew,10,0,10,0
1668048978449,MATH 245A,A00,098035,Nie; Jiawang,0,0,15,16
1668048978873,MATH 248,A00,098036,Bejenaru; Ioan,10,0,10,0
1668048979305,MATH 250B,A00,098037,Spolaor; Luca,14,0,15,1
1668048979751,MATH 258,A00,098038,Ni; Lei,10,0,10,0
1668048980189,MATH 264B,A00,098041,Rhoades; Brendon Patrick,10,0,15,5
1668048980610,MATH 268,A00,098042,Buss; Samuel R,10,0,10,0
1668048981033,MATH 269,A00,098043,Rhoades; Brendon Patrick,10,0,10,0
1668048981456,MATH 270B,A00,098044,Li; Bo,11,0,15,4
1668048981880,MATH 272B,A00,098045,Holst; Michael J,13,0,15,2
1668048982312,MATH 273A,A00,098046,Tian; Xiaochuan,10,0,15,5
1668048982738,MATH 275,A01,098048,Tian; Xiaochuan,6,0,10,4
1668048983163,MATH 278A,A00,098049,Holst; Michael J,8,0,10,2
1668048983589,MATH 278B,A00,098050,Cloninger; Alexander,10,0,10,0
1668048984017,MATH 278C,A00,098051,Nie; Jiawang,7,0,10,3
1668048984442,MATH 280B,A00,098052,Zheng; Tianyi,10,0,15,5
1668048984866,MATH 281B,A00,098053,Bradic; Jelena,3,0,15,12
1668048985289,MATH 282B,A00,098054,Arias-Castro; Ery,0,0,15,15
1668048985710,MATH 285,A00,098055,Fitzsimmons; Patrick J,0,0,15,17
1668048986135,MATH 287B,A00,098056,Arias-Castro; Ery,3,0,15,12
1668048986570,MATH 288,A00,098057,Agarwal; Pooja,9,0,10,1
1668048986570,MATH 288,B00,098058,Zhang; Danna,8,0,10,2
1668048986570,MATH 288,C00,098059,Williams; Ruth J,10,0,10,0
1668048986993,MATH 290B,A00,098060,Roberts; Justin Deritter,13,0,15,2
1668048987415,MATH 292,A00,098061,Belmont; Eva Kinoshita,10,0,10,0
1668048987839,MATH 295,A00,098062,Suk; Andrew Hoon,48,0,50,2
1668048988267,MATH 296,A00,098063,Novak; Jonathan I,20,0,20,0
1668048988693,MATH 297,001,098064,Gamst; Anthony Collins,9997,0,9999,2
1668049492779,COGS 205,A00,101395,Chiba; Andrea,19,0,20,1
1668049493204,COGS 210B,001,101404,Greene; Deanna Jacquelyn,9998,0,9999,1
1668049493204,COGS 210B,002,101417,Xia; Haijun,9999,0,9999,0
1668049493204,COGS 210B,003,101422,Nitz; Douglas A.,9999,0,9999,0
1668049493204,COGS 210B,004,101423,Hollan; James D.,9998,0,9999,1
1668049493204,COGS 210B,005,101424,Deak; Gedeon O.,9998,0,9999,1
1668049493204,COGS 210B,006,101425,Rossano; Federico,9999,0,9999,0
1668049493625,COGS 211B,A00,101427,Coulson; Seana M,9996,0,9999,3
1668049494050,COGS 220,A00,101428,Hollan; James D.,0,0,25,25
1668049494473,COGS 229,A00,101429,Dow; Steven P,18,0,25,7
1668049494899,COGS 230,A00,101430,Klemmer; Scott R,13,0,17,4
1668049495322,COGS 234,A00,101431,Xia; Haijun,4,0,25,21
1668049495747,COGS 260,A00,101432,Kiyonaga; Anastasia,19,0,25,6
1668049495747,COGS 260,B00,101433,Kirsh; David Joel,16,0,25,9
1668049496179,CSE 202,A00,102371,Impagliazzo; Russell,0,0,0,0
1668049496604,CSE 203B,A01,102373,Cheng; Chung Kuan,0,0,0,0
1668049497029,CSE 208,A00,102374,Micciancio; Daniele,0,0,0,0
1668049497453,CSE 209A,A00,112895,Impagliazzo; Russell,0,0,15,15
1668049497878,CSE 209B,A00,108005,Bellare; Mihir,0,0,0,0
1668049498404,CSE 210,A00,113163,Coblenz; Michael J,0,0,0,0
1668049498827,CSE 219,A00,106111,Dow; Steven P,0,0,20,20
1668049499254,CSE 221,A00,102376,Voelker; Geoffrey M.,0,0,0,0
1668049499687,CSE 224,A01,102378,Porter; George M,0,0,0,0
1668049500121,CSE 229A,A00,102379,Savage; Stefan,0,0,0,0
1668049500544,CSE 229C,A00,102380,Munyaka; Imani N. S.,0,0,0,0
1668049500983,CSE 232B,A00,102382,Deutsch; Alin Bernard,0,0,0,0
1668049501413,CSE 234,A01,112904,Kumar; Arun Kumar,0,0,0,0
1668049501836,CSE 237A,A00,102383,Rosing; Tajana Simunic,0,0,0,0
1668049502264,CSE 239A,A00,102384,Deutsch; Alin Bernard,0,0,0,0
1668049502702,CSE 239B,A00,102385,Polikarpova; Nadezhda,0,0,0,0
1668049503130,CSE 240A,A00,102386,Pannuto; Patrick William,0,0,0,0
1668049503554,CSE 240B,A00,102387,Zhao; Jishen,0,0,0,0
1668049503977,CSE 241A,A00,106406,Kang; Mingu,0,0,0,0
1668049504400,CSE 249B,A00,102388,Kahng; Andrew Byun,0,0,8,8
1668049504826,CSE 251B,A01,102392,Cottrell; Garrison W,0,0,0,0
1668049504826,CSE 251B,A02,102393,Cottrell; Garrison W,0,0,0,0
1668049505256,CSE 252B,A00,102394,Ochoa; Benjamin Lawrence,0,0,0,0
1668049505687,CSE 257,A01,102396,Gao; Sicun,0,0,0,0
1668049506120,CSE 272,A00,102397,Li; Tzumao,0,0,0,0
1668049506549,CSE 274,A00,111323,Chern; Albert Ren-Haur,0,0,0,0
1668049506976,CSE 282,A00,102398,Pevzner; Pavel Arkadjevich,0,0,0,0
1668049507404,CSE 284,A00,114175,Gymrek; Melissa Ann,0,0,0,0
1668049507828,CSE 290,A00,102399,Chandraker; Manmohan Krishna,0,0,0,0
1668049507828,CSE 290,B00,102400,Vaccaro; Kristen Marie,0,0,25,25
1668049507828,CSE 290,C00,102414,Pannuto; Patrick William,0,0,25,25
1668049507828,CSE 290,D00,102427,Pevzner; Pavel Arkadjevich,0,0,0,0
1668049507828,CSE 290,E00,102429,Zhao; Jishen,0,0,0,0
1668049507828,CSE 290,F00,102436,Tullsen; Dean Michael,0,0,0,0
1668049507828,CSE 290,G00,102440,Christensen; Henrik I,0,0,20,20
1668049508263,CSE 291,A00,102443,Su; Hao,0,0,0,0
1668049508263,CSE 291,B00,102448,Polikarpova; Nadezhda,0,0,0,0
1668049508263,CSE 291,C00,102453,Vaccaro; Kristen Marie,0,0,0,0
1668049508263,CSE 291,D00,111343,Savage; Stefan,0,0,0,0
1668049508263,CSE 291,E00,116474,Claffy; Kimberly Claire,0,0,0,0
1668049508263,CSE 291,F00,116479,Pasquale; Joseph,0,0,0,0
1668049508727,CSE 293,001,119111,Bafna; Vineet,9999,0,9999,0
1668049508727,CSE 293,002,119118,Bellare; Mihir,9999,0,9999,0
1668049508727,CSE 293,003,119122,Berg-Kirkpatrick; Taylor D,9999,0,9999,0
1668049508727,CSE 293,004,119135,Christensen; Henrik I,9999,0,9999,0
1668049508727,CSE 293,005,119142,Cottrell; Garrison W,9999,0,9999,0
1668049508727,CSE 293,006,119146,Deutsch; Alin Bernard,9999,0,9999,0
1668049508727,CSE 293,007,119159,Esmaeilzadeh; Hadi,9999,0,9999,0
1668049508727,CSE 293,008,119166,Freund; Yoav,9999,0,9999,0
1668049508727,CSE 293,009,119170,Griswold; William G.,9999,0,9999,0
1668049508727,CSE 293,010,119183,Gymrek; Melissa Ann,9999,0,9999,0
1668049508727,CSE 293,011,119190,Heninger; Nadia A,9999,0,9999,0
1668049508727,CSE 293,012,119230,Impagliazzo; Russell,9999,0,9999,0
1668049508727,CSE 293,013,119232,Jhala; Ranjit,9999,0,9999,0
1668049508727,CSE 293,014,119233,Kahng; Andrew Byun,9999,0,9999,0
1668049508727,CSE 293,015,119298,Kane; Daniel Mertz,9999,0,9999,0
1668049508727,CSE 293,016,119299,Kriegman; David J,9999,0,9999,0
1668049508727,CSE 293,017,119300,Kumar; Arun Kumar,9999,0,9999,0
1668049508727,CSE 293,018,119301,Lerner; Sorin,9999,0,9999,0
1668049508727,CSE 293,019,119302,Lovett; Shachar,9999,0,9999,0
1668049508727,CSE 293,020,119303,McAuley; Julian John,9999,0,9999,0
1668049508727,CSE 293,021,119304,Micciancio; Daniele,9999,0,9999,0
1668049508727,CSE 293,022,119367,Orailoglu; Alex,9999,0,9999,0
1668049508727,CSE 293,023,119382,Paturi; Ramamohan,9999,0,9999,0
1668049508727,CSE 293,024,119404,Polikarpova; Nadezhda,9999,0,9999,0
1668049508727,CSE 293,025,119406,Politz; Joseph Gibbs,9999,0,9999,0
1668049508727,CSE 293,026,119411,Porter; George M,9999,0,9999,0
1668049508727,CSE 293,027,119414,Porter; Leonard Emerson,9999,0,9999,0
1668049508727,CSE 293,028,119416,Ramamoorthi; Ravi,9999,0,9999,0
1668049508727,CSE 293,029,119417,Sahoo; Debashis,9999,0,9999,0
1668049508727,CSE 293,030,119420,Saul; Lawrence,9999,0,9999,0
1668049508727,CSE 293,031,119421,Savage; Stefan,9999,0,9999,0
1668049508727,CSE 293,032,119425,Schulze; Jurgen P.,9999,0,9999,0
1668049508727,CSE 293,033,119426,Snoeren; Alex C.,9999,0,9999,0
1668049508727,CSE 293,034,119428,Shang; Jingbo,9999,0,9999,0
1668049508727,CSE 293,035,119430,Stefan; Deian,9999,0,9999,0
1668049508727,CSE 293,036,119431,Su; Hao,9999,0,9999,0
1668049508727,CSE 293,037,119433,Swanson; Steven James,9999,0,9999,0
1668049508727,CSE 293,038,119435,Tullsen; Dean Michael,9999,0,9999,0
1668049508727,CSE 293,039,119483,Voelker; Geoffrey M.,9999,0,9999,0
1668049508727,CSE 293,040,119537,Zhao; Jishen,9999,0,9999,0
1668049508727,CSE 293,041,119538,Zhou; Yuan-Yuan,9999,0,9999,0
1668049508727,CSE 293,042,119539,Gao; Sicun,9999,0,9999,0
1668049508727,CSE 293,043,119540,Weibel; Nadir,9999,0,9999,0
1668049508727,CSE 293,044,119541,Gupta; Rajesh K.,9999,0,9999,0
1668049508727,CSE 293,045,126410,Vaccaro; Kristen Marie,9999,0,9999,0
1668049508727,CSE 293,046,126411,Klemke; Richard,9999,0,9999,0
1668049509172,CSE 294,A00,102459,Voelker; Geoffrey M.,0,0,0,0
1668049509172,CSE 294,B00,111322,Orailoglu; Alex,0,0,0,0
1668049509601,DSE 201,A00,096914,Deutsch; Alin Bernard,30,0,30,0
1668049510036,DSE 210,A00,096915,Dasgupta; Sanjoy,30,0,30,0
1668049510459,DSE 260A,A00,096916,Altintas De Callaf; Ilkay,30,0,30,0
1668049510902,ECE 200,001,103586,Antipa; Nicholas A,9999,0,9999,0
1668049510902,ECE 200,002,103587,Atanasov; Nikolay A.,9999,0,9999,0
1668049510902,ECE 200,003,103588,Bharadia; Dinesh,9999,0,9999,0
1668049510902,ECE 200,004,103589,Cheng; Chung Kuan,9999,0,9999,0
1668049510902,ECE 200,005,103590,Cosman; Pamela C.,9999,0,9999,0
1668049510902,ECE 200,006,103591,Dayeh; Shadi Ahmad,9999,0,9999,0
1668049510902,ECE 200,007,103592,Fainman; Yeshaiahu,9999,0,9999,0
1668049510902,ECE 200,008,103593,Ford; Joseph Earl,9999,0,9999,0
1668049510902,ECE 200,009,103594,Franceschetti; Massimo,9999,0,9999,0
1668049510902,ECE 200,010,103595,Fullerton; Eric E,9999,0,9999,0
1668049510902,ECE 200,011,103596,Galton; Ian A,9999,0,9999,0
1668049510902,ECE 200,012,103597,Gilja; Vikash,9999,0,9999,0
1668049510902,ECE 200,013,103598,Hall; Drew A.,9999,0,9999,0
1668049510902,ECE 200,014,103599,Hsueh; Tzu-Chien,9999,0,9999,0
1668049510902,ECE 200,015,103600,Javidi; Tara,9999,0,9999,0
1668049510902,ECE 200,016,103601,Kahng; Andrew Byun,9999,0,9999,0
1668049510902,ECE 200,017,103602,Kim; Young-Han,9999,0,9999,0
1668049510902,ECE 200,018,103603,Koushanfar; Farinaz,9999,0,9999,0
1668049510902,ECE 200,019,103604,Kuzum; Duygu,9999,0,9999,0
1668049510902,ECE 200,020,103605,Le; Hanh-Phuc,9999,0,9999,0
1668049510902,ECE 200,021,103606,Lin; Bill,9999,0,9999,0
1668049510902,ECE 200,022,103607,Liu; Zhaowei,9998,0,9999,1
1668049510902,ECE 200,023,103608,Lo; Yu-Hwa,9999,0,9999,0
1668049510902,ECE 200,024,103609,Lomakin; Vitaliy,9999,0,9999,0
1668049510902,ECE 200,025,103610,Mercier; Patrick Philip,9999,0,9999,0
1668049510902,ECE 200,026,103611,Meyer; Florian,9999,0,9999,0
1668049510902,ECE 200,027,103612,Milstein; Laurence B.,9999,0,9999,0
1668049510902,ECE 200,028,103613,Mir Arabbaygi; Siavash,9999,0,9999,0
1668049510902,ECE 200,029,103614,Mookherjea; Shayan,9999,0,9999,0
1668049510902,ECE 200,030,103615,Morris; Karcher William,9999,0,9999,0
1668049510902,ECE 200,031,103616,Ng; Tse Nga,9999,0,9999,0
1668049510902,ECE 200,032,103617,Nguyen; Truong Quang,9999,0,9999,0
1668049510902,ECE 200,033,103618,Nomura; Kenji,9999,0,9999,0
1668049510902,ECE 200,034,103619,Orlitsky; Alon,9999,0,9999,0
1668049510902,ECE 200,035,103620,Pal; Piya,9999,0,9999,0
1668049510902,ECE 200,036,103621,Papen; George C.,9999,0,9999,0
1668049510902,ECE 200,037,103622,Radic; Stojan,9999,0,9999,0
1668049510902,ECE 200,038,103623,Rao; Bhaskar D.,9999,0,9999,0
1668049510902,ECE 200,039,103624,Rao; Ramesh R,9999,0,9999,0
1668049510902,ECE 200,040,103625,Rebeiz; Gabriel,9999,0,9999,0
1668049510902,ECE 200,041,103626,Sanford; John R,9999,0,9999,0
1668049510902,ECE 200,042,103627,Siegel; Paul H.,9999,0,9999,0
1668049510902,ECE 200,043,103628,Sievenpiper; Daniel F.,9999,0,9999,0
1668049510902,ECE 200,044,103629,Sworder; David D.,9999,0,9999,0
1668049510902,ECE 200,045,103630,Taur; Yuan,9999,0,9999,0
1668049510902,ECE 200,046,103631,Touri; Behrouz,9999,0,9999,0
1668049510902,ECE 200,047,103632,Trivedi; Mohan M.,9999,0,9999,0
1668049510902,ECE 200,048,103633,Vasconcelos; Nuno,9999,0,9999,0
1668049510902,ECE 200,049,103634,Wang; Xiaolong,9999,0,9999,0
1668049510902,ECE 200,050,103635,Xie; Pengtao,9999,0,9999,0
1668049510902,ECE 200,051,103636,Yip; Michael,9999,0,9999,0
1668049510902,ECE 200,052,103637,Zeger; Kenneth A.,999,0,999,0
1668049510902,ECE 200,053,103638,Zhang; Xinyu,9999,0,9999,0
1668049510902,ECE 200,054,103639,Turakhia; Yatish Girish,9999,0,9999,0
1668049510902,ECE 200,055,103640,Kang; Mingu,9999,0,9999,0
1668049510902,ECE 200,056,103641,Shi; Yuanyuan,9999,0,9999,0
1668049510902,ECE 200,057,103642,Wang; Edward Jay,9999,0,9999,0
1668049510902,ECE 200,058,103643,Zheng; Yang,9999,0,9999,0
1668049511331,ECE 202,A00,103644,Kuzum; Duygu,0,0,0,0
1668049511760,ECE 212BN,A00,103646,Ng; Tse Nga,0,0,0,0
1668049512184,ECE 221,A00,111493,Staff,0,0,0,0
1668049512618,ECE 222B,A00,103647,Lomakin; Vitaliy,0,0,0,0
1668049513040,ECE 230B,A00,103648,Taur; Yuan,0,0,0,0
1668049513476,ECE 238B,A00,103649,Garay; Javier,0,0,0,0
1668049513900,ECE 240B,A00,112900,Fainman; Yeshaiahu,0,0,0,0
1668049514323,ECE 247A,A00,103650,Jokerst; Jesse Vincent,0,0,0,0
1668049514759,ECE 247B,A00,103651,Wang; Joseph,0,0,0,0
1668049515197,ECE 250,A00,103652,Siegel; Paul H.,0,0,0,0
1668049515622,ECE 251A,A00,103654,Rao; Bhaskar D.,0,0,0,0
1668049516052,ECE 257B,A00,103655,Bharadia; Dinesh,0,0,0,0
1668049516477,ECE 258A,A00,103656,Milstein; Laurence B.,0,0,0,0
1668049516917,ECE 260B,A00,103658,Kang; Mingu,0,0,0,0
1668049517346,ECE 264A,A00,103659,Galton; Ian A,0,0,0,0
1668049517769,ECE 265A,A00,103661,Gudem; Prasad S.S.,0,0,0,0
1668049518203,ECE 265D,A00,103662,Gudem; Prasad S.S.,0,0,0,0
1668049518626,ECE 268,A00,103663,Koushanfar; Farinaz,0,0,0,0
1668049519049,ECE 269,A01,103665,Pal; Piya,0,0,0,0
1668049519478,ECE 271B,A00,103666,Vasconcelos; Manuela,0,0,0,0
1668049519909,ECE 276A,A00,103667,Atanasov; Nikolay A.,0,0,0,0
1668049520351,ECE 277,A00,103668,An; Cheolhong,0,0,0,0
1668049520784,ECE 279,A00,117947,Hall; Drew A.,0,0,0,0
1668049521634,ECE 283,A00,103670,Hsueh; Tzu-Chien,0,0,0,0
1668049522059,ECE 284,A00,103671,Turakhia; Yatish Girish,0,0,0,0
1668049522490,ECE 285,A00,103672,Zheng; Yang,0,0,0,0
1668049522490,ECE 285,B00,103673,Sworder; David D.,0,0,0,0
1668049522913,ECE 287,A00,103676,Javidi; Tara,0,0,0,0
1668049523341,MATH 200B,A00,098023,Salehi Golsefidy; Alireza,13,0,15,2
1668049523771,MATH 202B,A00,098024,Rhoades; Brendon Patrick,9,0,15,6
1668049524199,MATH 203B,A00,098025,Oprea; Dragos N.,11,0,15,4
1668049524634,MATH 204B,A00,098026,Sorensen; Claus M,13,0,15,2
1668049525058,MATH 208,A00,098027,Izadi; Elham,7,0,10,3
1668049525481,MATH 209,A00,098028,Pollack; Aaron,10,0,10,0
1668049525906,MATH 211A,A00,112919,Rogalski; Daniel,9,0,10,1
1668049526333,MATH 211B,A00,112920,Seward; Brandon M.,9,0,10,1
1668049526758,MATH 218,A00,098029,Li; Bo,10,0,10,0
1668049527180,MATH 220B,A00,098030,Novak; Jonathan I,13,0,15,2
1668049527619,MATH 221A,A00,098031,Ebenfelt; Peter F,13,0,15,2
1668049528052,MATH 231B,A00,098032,Zlatos; Andrej,12,0,15,3
1668049528486,MATH 240B,A00,098033,Ni; Lei,9,0,15,6
1668049528923,MATH 243,A00,098034,Jekel; David Andrew,10,0,10,0
1668049529348,MATH 245A,A00,098035,Nie; Jiawang,0,0,15,16
1668049529774,MATH 248,A00,098036,Bejenaru; Ioan,10,0,10,0
1668049530203,MATH 250B,A00,098037,Spolaor; Luca,14,0,15,1
1668049530626,MATH 258,A00,098038,Ni; Lei,10,0,10,0
1668049531050,MATH 264B,A00,098041,Rhoades; Brendon Patrick,10,0,15,5
1668049531471,MATH 268,A00,098042,Buss; Samuel R,10,0,10,0
1668049531910,MATH 269,A00,098043,Rhoades; Brendon Patrick,10,0,10,0
1668049532334,MATH 270B,A00,098044,Li; Bo,11,0,15,4
1668049532760,MATH 272B,A00,098045,Holst; Michael J,13,0,15,2
1668049533192,MATH 273A,A00,098046,Tian; Xiaochuan,10,0,15,5
1668049533619,MATH 275,A01,098048,Tian; Xiaochuan,6,0,10,4
1668049534050,MATH 278A,A00,098049,Holst; Michael J,8,0,10,2
1668049534486,MATH 278B,A00,098050,Cloninger; Alexander,10,0,10,0
1668049534913,MATH 278C,A00,098051,Nie; Jiawang,7,0,10,3
1668049535336,MATH 280B,A00,098052,Zheng; Tianyi,10,0,15,5
1668049535763,MATH 281B,A00,098053,Bradic; Jelena,3,0,15,12
1668049536202,MATH 282B,A00,098054,Arias-Castro; Ery,0,0,15,15
1668049536625,MATH 285,A00,098055,Fitzsimmons; Patrick J,0,0,15,17
1668049537056,MATH 287B,A00,098056,Arias-Castro; Ery,3,0,15,12
1668049537480,MATH 288,A00,098057,Agarwal; Pooja,9,0,10,1
1668049537480,MATH 288,B00,098058,Zhang; Danna,8,0,10,2
1668049537480,MATH 288,C00,098059,Williams; Ruth J,10,0,10,0
1668049537913,MATH 290B,A00,098060,Roberts; Justin Deritter,13,0,15,2
1668049538338,MATH 292,A00,098061,Belmont; Eva Kinoshita,10,0,10,0
1668049538763,MATH 295,A00,098062,Suk; Andrew Hoon,48,0,50,2
1668049539192,MATH 296,A00,098063,Novak; Jonathan I,20,0,20,0
1668049539618,MATH 297,001,098064,Gamst; Anthony Collins,9997,0,9999,2
1668050043642,COGS 205,A00,101395,Chiba; Andrea,19,0,20,1
1668050044067,COGS 210B,001,101404,Greene; Deanna Jacquelyn,9998,0,9999,1
1668050044067,COGS 210B,002,101417,Xia; Haijun,9999,0,9999,0
1668050044067,COGS 210B,003,101422,Nitz; Douglas A.,9999,0,9999,0
1668050044067,COGS 210B,004,101423,Hollan; James D.,9998,0,9999,1
1668050044067,COGS 210B,005,101424,Deak; Gedeon O.,9998,0,9999,1
1668050044067,COGS 210B,006,101425,Rossano; Federico,9999,0,9999,0
1668050044490,COGS 211B,A00,101427,Coulson; Seana M,9996,0,9999,3
1668050044927,COGS 220,A00,101428,Hollan; James D.,0,0,25,25
1668050045352,COGS 229,A00,101429,Dow; Steven P,18,0,25,7
1668050045778,COGS 230,A00,101430,Klemmer; Scott R,13,0,17,4
1668050046211,COGS 234,A00,101431,Xia; Haijun,4,0,25,21
1668050046633,COGS 260,A00,101432,Kiyonaga; Anastasia,19,0,25,6
1668050046633,COGS 260,B00,101433,Kirsh; David Joel,16,0,25,9
1668050047054,CSE 202,A00,102371,Impagliazzo; Russell,0,0,0,0
1668050047478,CSE 203B,A01,102373,Cheng; Chung Kuan,0,0,0,0
1668050047904,CSE 208,A00,102374,Micciancio; Daniele,0,0,0,0
1668050048337,CSE 209A,A00,112895,Impagliazzo; Russell,0,0,15,15
1668050048765,CSE 209B,A00,108005,Bellare; Mihir,0,0,0,0
1668050049189,CSE 210,A00,113163,Coblenz; Michael J,0,0,0,0
1668050049612,CSE 219,A00,106111,Dow; Steven P,0,0,20,20
1668050050038,CSE 221,A00,102376,Voelker; Geoffrey M.,0,0,0,0
1668050050477,CSE 224,A01,102378,Porter; George M,0,0,0,0
1668050050916,CSE 229A,A00,102379,Savage; Stefan,0,0,0,0
1668050051345,CSE 229C,A00,102380,Munyaka; Imani N. S.,0,0,0,0
1668050051768,CSE 232B,A00,102382,Deutsch; Alin Bernard,0,0,0,0
1668050052192,CSE 234,A01,112904,Kumar; Arun Kumar,0,0,0,0
1668050052615,CSE 237A,A00,102383,Rosing; Tajana Simunic,0,0,0,0
1668050053040,CSE 239A,A00,102384,Deutsch; Alin Bernard,0,0,0,0
1668050053468,CSE 239B,A00,102385,Polikarpova; Nadezhda,0,0,0,0
1668050053896,CSE 240A,A00,102386,Pannuto; Patrick William,0,0,0,0
1668050054322,CSE 240B,A00,102387,Zhao; Jishen,0,0,0,0
1668050054745,CSE 241A,A00,106406,Kang; Mingu,0,0,0,0
1668050055168,CSE 249B,A00,102388,Kahng; Andrew Byun,0,0,8,8
1668050055599,CSE 251B,A01,102392,Cottrell; Garrison W,0,0,0,0
1668050055599,CSE 251B,A02,102393,Cottrell; Garrison W,0,0,0,0
1668050056022,CSE 252B,A00,102394,Ochoa; Benjamin Lawrence,0,0,0,0
1668050056451,CSE 257,A01,102396,Gao; Sicun,0,0,0,0
1668050056876,CSE 272,A00,102397,Li; Tzumao,0,0,0,0
1668050057302,CSE 274,A00,111323,Chern; Albert Ren-Haur,0,0,0,0
1668050057727,CSE 282,A00,102398,Pevzner; Pavel Arkadjevich,0,0,0,0
1668050058150,CSE 284,A00,114175,Gymrek; Melissa Ann,0,0,0,0
1668050058583,CSE 290,A00,102399,Chandraker; Manmohan Krishna,0,0,0,0
1668050058583,CSE 290,B00,102400,Vaccaro; Kristen Marie,0,0,25,25
1668050058583,CSE 290,C00,102414,Pannuto; Patrick William,0,0,25,25
1668050058583,CSE 290,D00,102427,Pevzner; Pavel Arkadjevich,0,0,0,0
1668050058583,CSE 290,E00,102429,Zhao; Jishen,0,0,0,0
1668050058583,CSE 290,F00,102436,Tullsen; Dean Michael,0,0,0,0
1668050058583,CSE 290,G00,102440,Christensen; Henrik I,0,0,20,20
1668050059021,CSE 291,A00,102443,Su; Hao,0,0,0,0
1668050059021,CSE 291,B00,102448,Polikarpova; Nadezhda,0,0,0,0
1668050059021,CSE 291,C00,102453,Vaccaro; Kristen Marie,0,0,0,0
1668050059021,CSE 291,D00,111343,Savage; Stefan,0,0,0,0
1668050059021,CSE 291,E00,116474,Claffy; Kimberly Claire,0,0,0,0
1668050059021,CSE 291,F00,116479,Pasquale; Joseph,0,0,0,0
1668050059448,CSE 293,001,119111,Bafna; Vineet,9999,0,9999,0
1668050059448,CSE 293,002,119118,Bellare; Mihir,9999,0,9999,0
1668050059448,CSE 293,003,119122,Berg-Kirkpatrick; Taylor D,9999,0,9999,0
1668050059448,CSE 293,004,119135,Christensen; Henrik I,9999,0,9999,0
1668050059448,CSE 293,005,119142,Cottrell; Garrison W,9999,0,9999,0
1668050059448,CSE 293,006,119146,Deutsch; Alin Bernard,9999,0,9999,0
1668050059448,CSE 293,007,119159,Esmaeilzadeh; Hadi,9999,0,9999,0
1668050059448,CSE 293,008,119166,Freund; Yoav,9999,0,9999,0
1668050059448,CSE 293,009,119170,Griswold; William G.,9999,0,9999,0
1668050059448,CSE 293,010,119183,Gymrek; Melissa Ann,9999,0,9999,0
1668050059448,CSE 293,011,119190,Heninger; Nadia A,9999,0,9999,0
1668050059448,CSE 293,012,119230,Impagliazzo; Russell,9999,0,9999,0
1668050059448,CSE 293,013,119232,Jhala; Ranjit,9999,0,9999,0
1668050059448,CSE 293,014,119233,Kahng; Andrew Byun,9999,0,9999,0
1668050059448,CSE 293,015,119298,Kane; Daniel Mertz,9999,0,9999,0
1668050059448,CSE 293,016,119299,Kriegman; David J,9999,0,9999,0
1668050059448,CSE 293,017,119300,Kumar; Arun Kumar,9999,0,9999,0
1668050059448,CSE 293,018,119301,Lerner; Sorin,9999,0,9999,0
1668050059448,CSE 293,019,119302,Lovett; Shachar,9999,0,9999,0
1668050059448,CSE 293,020,119303,McAuley; Julian John,9999,0,9999,0
1668050059448,CSE 293,021,119304,Micciancio; Daniele,9999,0,9999,0
1668050059448,CSE 293,022,119367,Orailoglu; Alex,9999,0,9999,0
1668050059448,CSE 293,023,119382,Paturi; Ramamohan,9999,0,9999,0
1668050059448,CSE 293,024,119404,Polikarpova; Nadezhda,9999,0,9999,0
1668050059448,CSE 293,025,119406,Politz; Joseph Gibbs,9999,0,9999,0
1668050059448,CSE 293,026,119411,Porter; George M,9999,0,9999,0
1668050059448,CSE 293,027,119414,Porter; Leonard Emerson,9999,0,9999,0
1668050059448,CSE 293,028,119416,Ramamoorthi; Ravi,9999,0,9999,0
1668050059448,CSE 293,029,119417,Sahoo; Debashis,9999,0,9999,0
1668050059448,CSE 293,030,119420,Saul; Lawrence,9999,0,9999,0
1668050059448,CSE 293,031,119421,Savage; Stefan,9999,0,9999,0
1668050059448,CSE 293,032,119425,Schulze; Jurgen P.,9999,0,9999,0
1668050059448,CSE 293,033,119426,Snoeren; Alex C.,9999,0,9999,0
1668050059448,CSE 293,034,119428,Shang; Jingbo,9999,0,9999,0
1668050059448,CSE 293,035,119430,Stefan; Deian,9999,0,9999,0
1668050059448,CSE 293,036,119431,Su; Hao,9999,0,9999,0
1668050059448,CSE 293,037,119433,Swanson; Steven James,9999,0,9999,0
1668050059448,CSE 293,038,119435,Tullsen; Dean Michael,9999,0,9999,0
1668050059448,CSE 293,039,119483,Voelker; Geoffrey M.,9999,0,9999,0
1668050059448,CSE 293,040,119537,Zhao; Jishen,9999,0,9999,0
1668050059448,CSE 293,041,119538,Zhou; Yuan-Yuan,9999,0,9999,0
1668050059448,CSE 293,042,119539,Gao; Sicun,9999,0,9999,0
1668050059448,CSE 293,043,119540,Weibel; Nadir,9999,0,9999,0
1668050059448,CSE 293,044,119541,Gupta; Rajesh K.,9999,0,9999,0
1668050059448,CSE 293,045,126410,Vaccaro; Kristen Marie,9999,0,9999,0
1668050059448,CSE 293,046,126411,Klemke; Richard,9999,0,9999,0
1668050059872,CSE 294,A00,102459,Voelker; Geoffrey M.,0,0,0,0
1668050059872,CSE 294,B00,111322,Orailoglu; Alex,0,0,0,0
1668050060310,DSE 201,A00,096914,Deutsch; Alin Bernard,30,0,30,0
1668050060733,DSE 210,A00,096915,Dasgupta; Sanjoy,30,0,30,0
1668050061159,DSE 260A,A00,096916,Altintas De Callaf; Ilkay,30,0,30,0
1668050061620,ECE 200,001,103586,Antipa; Nicholas A,9999,0,9999,0
1668050061620,ECE 200,002,103587,Atanasov; Nikolay A.,9999,0,9999,0
1668050061620,ECE 200,003,103588,Bharadia; Dinesh,9999,0,9999,0
1668050061620,ECE 200,004,103589,Cheng; Chung Kuan,9999,0,9999,0
1668050061620,ECE 200,005,103590,Cosman; Pamela C.,9999,0,9999,0
1668050061620,ECE 200,006,103591,Dayeh; Shadi Ahmad,9999,0,9999,0
1668050061620,ECE 200,007,103592,Fainman; Yeshaiahu,9999,0,9999,0
1668050061620,ECE 200,008,103593,Ford; Joseph Earl,9999,0,9999,0
1668050061620,ECE 200,009,103594,Franceschetti; Massimo,9999,0,9999,0
1668050061620,ECE 200,010,103595,Fullerton; Eric E,9999,0,9999,0
1668050061620,ECE 200,011,103596,Galton; Ian A,9999,0,9999,0
1668050061620,ECE 200,012,103597,Gilja; Vikash,9999,0,9999,0
1668050061620,ECE 200,013,103598,Hall; Drew A.,9999,0,9999,0
1668050061620,ECE 200,014,103599,Hsueh; Tzu-Chien,9999,0,9999,0
1668050061620,ECE 200,015,103600,Javidi; Tara,9999,0,9999,0
1668050061620,ECE 200,016,103601,Kahng; Andrew Byun,9999,0,9999,0
1668050061620,ECE 200,017,103602,Kim; Young-Han,9999,0,9999,0
1668050061620,ECE 200,018,103603,Koushanfar; Farinaz,9999,0,9999,0
1668050061620,ECE 200,019,103604,Kuzum; Duygu,9999,0,9999,0
1668050061620,ECE 200,020,103605,Le; Hanh-Phuc,9999,0,9999,0
1668050061620,ECE 200,021,103606,Lin; Bill,9999,0,9999,0
1668050061620,ECE 200,022,103607,Liu; Zhaowei,9998,0,9999,1
1668050061620,ECE 200,023,103608,Lo; Yu-Hwa,9999,0,9999,0
1668050061620,ECE 200,024,103609,Lomakin; Vitaliy,9999,0,9999,0
1668050061620,ECE 200,025,103610,Mercier; Patrick Philip,9999,0,9999,0
1668050061620,ECE 200,026,103611,Meyer; Florian,9999,0,9999,0
1668050061620,ECE 200,027,103612,Milstein; Laurence B.,9999,0,9999,0
1668050061620,ECE 200,028,103613,Mir Arabbaygi; Siavash,9999,0,9999,0
1668050061620,ECE 200,029,103614,Mookherjea; Shayan,9999,0,9999,0
1668050061620,ECE 200,030,103615,Morris; Karcher William,9999,0,9999,0
1668050061620,ECE 200,031,103616,Ng; Tse Nga,9999,0,9999,0
1668050061620,ECE 200,032,103617,Nguyen; Truong Quang,9999,0,9999,0
1668050061620,ECE 200,033,103618,Nomura; Kenji,9999,0,9999,0
1668050061620,ECE 200,034,103619,Orlitsky; Alon,9999,0,9999,0
1668050061620,ECE 200,035,103620,Pal; Piya,9999,0,9999,0
1668050061620,ECE 200,036,103621,Papen; George C.,9999,0,9999,0
1668050061620,ECE 200,037,103622,Radic; Stojan,9999,0,9999,0
1668050061620,ECE 200,038,103623,Rao; Bhaskar D.,9999,0,9999,0
1668050061620,ECE 200,039,103624,Rao; Ramesh R,9999,0,9999,0
1668050061620,ECE 200,040,103625,Rebeiz; Gabriel,9999,0,9999,0
1668050061620,ECE 200,041,103626,Sanford; John R,9999,0,9999,0
1668050061620,ECE 200,042,103627,Siegel; Paul H.,9999,0,9999,0
1668050061620,ECE 200,043,103628,Sievenpiper; Daniel F.,9999,0,9999,0
1668050061620,ECE 200,044,103629,Sworder; David D.,9999,0,9999,0
1668050061620,ECE 200,045,103630,Taur; Yuan,9999,0,9999,0
1668050061620,ECE 200,046,103631,Touri; Behrouz,9999,0,9999,0
1668050061620,ECE 200,047,103632,Trivedi; Mohan M.,9999,0,9999,0
1668050061620,ECE 200,048,103633,Vasconcelos; Nuno,9999,0,9999,0
1668050061620,ECE 200,049,103634,Wang; Xiaolong,9999,0,9999,0
1668050061620,ECE 200,050,103635,Xie; Pengtao,9999,0,9999,0
1668050061620,ECE 200,051,103636,Yip; Michael,9999,0,9999,0
1668050061620,ECE 200,052,103637,Zeger; Kenneth A.,999,0,999,0
1668050061620,ECE 200,053,103638,Zhang; Xinyu,9999,0,9999,0
1668050061620,ECE 200,054,103639,Turakhia; Yatish Girish,9999,0,9999,0
1668050061620,ECE 200,055,103640,Kang; Mingu,9999,0,9999,0
1668050061620,ECE 200,056,103641,Shi; Yuanyuan,9999,0,9999,0
1668050061620,ECE 200,057,103642,Wang; Edward Jay,9999,0,9999,0
1668050061620,ECE 200,058,103643,Zheng; Yang,9999,0,9999,0
1668050062050,ECE 202,A00,103644,Kuzum; Duygu,0,0,0,0
1668050062475,ECE 212BN,A00,103646,Ng; Tse Nga,0,0,0,0
1668050062902,ECE 221,A00,111493,Staff,0,0,0,0
1668050063329,ECE 222B,A00,103647,Lomakin; Vitaliy,0,0,0,0
1668050063753,ECE 230B,A00,103648,Taur; Yuan,0,0,0,0
1668050064176,ECE 238B,A00,103649,Garay; Javier,0,0,0,0
1668050064615,ECE 240B,A00,112900,Fainman; Yeshaiahu,0,0,0,0
1668050065040,ECE 247A,A00,103650,Jokerst; Jesse Vincent,0,0,0,0
1668050065465,ECE 247B,A00,103651,Wang; Joseph,0,0,0,0
1668050065999,ECE 250,A00,103652,Siegel; Paul H.,0,0,0,0
1668050066444,ECE 251A,A00,103654,Rao; Bhaskar D.,0,0,0,0
1668050066885,ECE 257B,A00,103655,Bharadia; Dinesh,0,0,0,0
1668050067307,ECE 258A,A00,103656,Milstein; Laurence B.,0,0,0,0
1668050067733,ECE 260B,A00,103658,Kang; Mingu,0,0,0,0
1668050068157,ECE 264A,A00,103659,Galton; Ian A,0,0,0,0
1668050068579,ECE 265A,A00,103661,Gudem; Prasad S.S.,0,0,0,0
1668050069006,ECE 265D,A00,103662,Gudem; Prasad S.S.,0,0,0,0
1668050069429,ECE 268,A00,103663,Koushanfar; Farinaz,0,0,0,0
1668050069854,ECE 269,A01,103665,Pal; Piya,0,0,0,0
1668050070292,ECE 271B,A00,103666,Vasconcelos; Manuela,0,0,0,0
1668050070715,ECE 276A,A00,103667,Atanasov; Nikolay A.,0,0,0,0
1668050071143,ECE 277,A00,103668,An; Cheolhong,0,0,0,0
1668050071575,ECE 279,A00,117947,Hall; Drew A.,0,0,0,0
1668050072440,ECE 283,A00,103670,Hsueh; Tzu-Chien,0,0,0,0
1668050072872,ECE 284,A00,103671,Turakhia; Yatish Girish,0,0,0,0
1668050073298,ECE 285,A00,103672,Zheng; Yang,0,0,0,0
1668050073298,ECE 285,B00,103673,Sworder; David D.,0,0,0,0
1668050073721,ECE 287,A00,103676,Javidi; Tara,0,0,0,0
1668050074144,MATH 200B,A00,098023,Salehi Golsefidy; Alireza,13,0,15,2
1668050074571,MATH 202B,A00,098024,Rhoades; Brendon Patrick,9,0,15,6
1668050074996,MATH 203B,A00,098025,Oprea; Dragos N.,11,0,15,4
1668050075419,MATH 204B,A00,098026,Sorensen; Claus M,13,0,15,2
1668050075841,MATH 208,A00,098027,Izadi; Elham,7,0,10,3
1668050076266,MATH 209,A00,098028,Pollack; Aaron,10,0,10,0
1668050076703,MATH 211A,A00,112919,Rogalski; Daniel,9,0,10,1
1668050077135,MATH 211B,A00,112920,Seward; Brandon M.,9,0,10,1
1668050077558,MATH 218,A00,098029,Li; Bo,10,0,10,0
1668050077990,MATH 220B,A00,098030,Novak; Jonathan I,13,0,15,2
1668050078414,MATH 221A,A00,098031,Ebenfelt; Peter F,13,0,15,2
1668050078840,MATH 231B,A00,098032,Zlatos; Andrej,12,0,15,3
1668050079263,MATH 240B,A00,098033,Ni; Lei,9,0,15,6
1668050079685,MATH 243,A00,098034,Jekel; David Andrew,10,0,10,0
1668050080113,MATH 245A,A00,098035,Nie; Jiawang,0,0,15,16
1668050080537,MATH 248,A00,098036,Bejenaru; Ioan,10,0,10,0
1668050080959,MATH 250B,A00,098037,Spolaor; Luca,14,0,15,1
1668050081382,MATH 258,A00,098038,Ni; Lei,10,0,10,0
1668050081807,MATH 264B,A00,098041,Rhoades; Brendon Patrick,10,0,15,5
1668050082231,MATH 268,A00,098042,Buss; Samuel R,10,0,10,0
1668050082670,MATH 269,A00,098043,Rhoades; Brendon Patrick,10,0,10,0
1668050083094,MATH 270B,A00,098044,Li; Bo,11,0,15,4
1668050083519,MATH 272B,A00,098045,Holst; Michael J,13,0,15,2
1668050083944,MATH 273A,A00,098046,Tian; Xiaochuan,10,0,15,5
1668050084367,MATH 275,A01,098048,Tian; Xiaochuan,6,0,10,4
1668050084799,MATH 278A,A00,098049,Holst; Michael J,8,0,10,2
1668050085231,MATH 278B,A00,098050,Cloninger; Alexander,10,0,10,0
1668050085653,MATH 278C,A00,098051,Nie; Jiawang,7,0,10,3
1668050086079,MATH 280B,A00,098052,Zheng; Tianyi,10,0,15,5
1668050086510,MATH 281B,A00,098053,Bradic; Jelena,3,0,15,12
1668050086936,MATH 282B,A00,098054,Arias-Castro; Ery,0,0,15,15
1668050087364,MATH 285,A00,098055,Fitzsimmons; Patrick J,0,0,15,17
1668050087794,MATH 287B,A00,098056,Arias-Castro; Ery,3,0,15,12
1668050088224,MATH 288,A00,098057,Agarwal; Pooja,9,0,10,1
1668050088224,MATH 288,B00,098058,Zhang; Danna,8,0,10,2
1668050088224,MATH 288,C00,098059,Williams; Ruth J,10,0,10,0
1668050088651,MATH 290B,A00,098060,Roberts; Justin Deritter,13,0,15,2
1668050089079,MATH 292,A00,098061,Belmont; Eva Kinoshita,10,0,10,0
1668050089505,MATH 295,A00,098062,Suk; Andrew Hoon,48,0,50,2
1668050089940,MATH 296,A00,098063,Novak; Jonathan I,20,0,20,0
1668050090370,MATH 297,001,098064,Gamst; Anthony Collins,9997,0,9999,2
1668050594386,COGS 205,A00,101395,Chiba; Andrea,19,0,20,1
1668050594818,COGS 210B,001,101404,Greene; Deanna Jacquelyn,9998,0,9999,1
1668050594818,COGS 210B,002,101417,Xia; Haijun,9999,0,9999,0
1668050594818,COGS 210B,003,101422,Nitz; Douglas A.,9999,0,9999,0
1668050594818,COGS 210B,004,101423,Hollan; James D.,9998,0,9999,1
1668050594818,COGS 210B,005,101424,Deak; Gedeon O.,9998,0,9999,1
1668050594818,COGS 210B,006,101425,Rossano; Federico,9999,0,9999,0
1668050595250,COGS 211B,A00,101427,Coulson; Seana M,9996,0,9999,3
1668050595677,COGS 220,A00,101428,Hollan; James D.,0,0,25,25
1668050596101,COGS 229,A00,101429,Dow; Steven P,18,0,25,7
1668050596523,COGS 230,A00,101430,Klemmer; Scott R,13,0,17,4
1668050596950,COGS 234,A00,101431,Xia; Haijun,4,0,25,21
1668050597375,COGS 260,A00,101432,Kiyonaga; Anastasia,19,0,25,6
1668050597375,COGS 260,B00,101433,Kirsh; David Joel,16,0,25,9
1668050597802,CSE 202,A00,102371,Impagliazzo; Russell,0,0,0,0
1668050598225,CSE 203B,A01,102373,Cheng; Chung Kuan,0,0,0,0
1668050598649,CSE 208,A00,102374,Micciancio; Daniele,0,0,0,0
1668050599077,CSE 209A,A00,112895,Impagliazzo; Russell,0,0,15,15
1668050599503,CSE 209B,A00,108005,Bellare; Mihir,0,0,0,0
1668050599930,CSE 210,A00,113163,Coblenz; Michael J,0,0,0,0
1668050600364,CSE 219,A00,106111,Dow; Steven P,0,0,20,20
1668050600794,CSE 221,A00,102376,Voelker; Geoffrey M.,0,0,0,0
1668050601222,CSE 224,A01,102378,Porter; George M,0,0,0,0
1668050601645,CSE 229A,A00,102379,Savage; Stefan,0,0,0,0
1668050602070,CSE 229C,A00,102380,Munyaka; Imani N. S.,0,0,0,0
1668050602494,CSE 232B,A00,102382,Deutsch; Alin Bernard,0,0,0,0
1668050602920,CSE 234,A01,112904,Kumar; Arun Kumar,0,0,0,0
1668050603343,CSE 237A,A00,102383,Rosing; Tajana Simunic,0,0,0,0
1668050603773,CSE 239A,A00,102384,Deutsch; Alin Bernard,0,0,0,0
1668050604202,CSE 239B,A00,102385,Polikarpova; Nadezhda,0,0,0,0
1668050604637,CSE 240A,A00,102386,Pannuto; Patrick William,0,0,0,0
1668050605073,CSE 240B,A00,102387,Zhao; Jishen,0,0,0,0
1668050605506,CSE 241A,A00,106406,Kang; Mingu,0,0,0,0
1668050605944,CSE 249B,A00,102388,Kahng; Andrew Byun,0,0,8,8
1668050606368,CSE 251B,A01,102392,Cottrell; Garrison W,0,0,0,0
1668050606368,CSE 251B,A02,102393,Cottrell; Garrison W,0,0,0,0
1668050606807,CSE 252B,A00,102394,Ochoa; Benjamin Lawrence,0,0,0,0
1668050607235,CSE 257,A01,102396,Gao; Sicun,0,0,0,0
1668050607659,CSE 272,A00,102397,Li; Tzumao,0,0,0,0
1668050608081,CSE 274,A00,111323,Chern; Albert Ren-Haur,0,0,0,0
1668050608507,CSE 282,A00,102398,Pevzner; Pavel Arkadjevich,0,0,0,0
1668050608937,CSE 284,A00,114175,Gymrek; Melissa Ann,0,0,0,0
1668050609362,CSE 290,A00,102399,Chandraker; Manmohan Krishna,0,0,0,0
1668050609362,CSE 290,B00,102400,Vaccaro; Kristen Marie,0,0,25,25
1668050609362,CSE 290,C00,102414,Pannuto; Patrick William,0,0,25,25
1668050609362,CSE 290,D00,102427,Pevzner; Pavel Arkadjevich,0,0,0,0
1668050609362,CSE 290,E00,102429,Zhao; Jishen,0,0,0,0
1668050609362,CSE 290,F00,102436,Tullsen; Dean Michael,0,0,0,0
1668050609362,CSE 290,G00,102440,Christensen; Henrik I,0,0,20,20
1668050609799,CSE 291,A00,102443,Su; Hao,0,0,0,0
1668050609799,CSE 291,B00,102448,Polikarpova; Nadezhda,0,0,0,0
1668050609799,CSE 291,C00,102453,Vaccaro; Kristen Marie,0,0,0,0
1668050609799,CSE 291,D00,111343,Savage; Stefan,0,0,0,0
1668050609799,CSE 291,E00,116474,Claffy; Kimberly Claire,0,0,0,0
1668050609799,CSE 291,F00,116479,Pasquale; Joseph,0,0,0,0
1668050610226,CSE 293,001,119111,Bafna; Vineet,9999,0,9999,0
1668050610226,CSE 293,002,119118,Bellare; Mihir,9999,0,9999,0
1668050610226,CSE 293,003,119122,Berg-Kirkpatrick; Taylor D,9999,0,9999,0
1668050610226,CSE 293,004,119135,Christensen; Henrik I,9999,0,9999,0
1668050610226,CSE 293,005,119142,Cottrell; Garrison W,9999,0,9999,0
1668050610226,CSE 293,006,119146,Deutsch; Alin Bernard,9999,0,9999,0
1668050610226,CSE 293,007,119159,Esmaeilzadeh; Hadi,9999,0,9999,0
1668050610226,CSE 293,008,119166,Freund; Yoav,9999,0,9999,0
1668050610226,CSE 293,009,119170,Griswold; William G.,9999,0,9999,0
1668050610226,CSE 293,010,119183,Gymrek; Melissa Ann,9999,0,9999,0
1668050610226,CSE 293,011,119190,Heninger; Nadia A,9999,0,9999,0
1668050610226,CSE 293,012,119230,Impagliazzo; Russell,9999,0,9999,0
1668050610226,CSE 293,013,119232,Jhala; Ranjit,9999,0,9999,0
1668050610226,CSE 293,014,119233,Kahng; Andrew Byun,9999,0,9999,0
1668050610226,CSE 293,015,119298,Kane; Daniel Mertz,9999,0,9999,0
1668050610226,CSE 293,016,119299,Kriegman; David J,9999,0,9999,0
1668050610226,CSE 293,017,119300,Kumar; Arun Kumar,9999,0,9999,0
1668050610226,CSE 293,018,119301,Lerner; Sorin,9999,0,9999,0
1668050610226,CSE 293,019,119302,Lovett; Shachar,9999,0,9999,0
1668050610226,CSE 293,020,119303,McAuley; Julian John,9999,0,9999,0
1668050610226,CSE 293,021,119304,Micciancio; Daniele,9999,0,9999,0
1668050610226,CSE 293,022,119367,Orailoglu; Alex,9999,0,9999,0
1668050610226,CSE 293,023,119382,Paturi; Ramamohan,9999,0,9999,0
1668050610226,CSE 293,024,119404,Polikarpova; Nadezhda,9999,0,9999,0
1668050610226,CSE 293,025,119406,Politz; Joseph Gibbs,9999,0,9999,0
1668050610226,CSE 293,026,119411,Porter; George M,9999,0,9999,0
1668050610226,CSE 293,027,119414,Porter; Leonard Emerson,9999,0,9999,0
1668050610226,CSE 293,028,119416,Ramamoorthi; Ravi,9999,0,9999,0
1668050610226,CSE 293,029,119417,Sahoo; Debashis,9999,0,9999,0
1668050610226,CSE 293,030,119420,Saul; Lawrence,9999,0,9999,0
1668050610226,CSE 293,031,119421,Savage; Stefan,9999,0,9999,0
1668050610226,CSE 293,032,119425,Schulze; Jurgen P.,9999,0,9999,0
1668050610226,CSE 293,033,119426,Snoeren; Alex C.,9999,0,9999,0
1668050610226,CSE 293,034,119428,Shang; Jingbo,9999,0,9999,0
1668050610226,CSE 293,035,119430,Stefan; Deian,9999,0,9999,0
1668050610226,CSE 293,036,119431,Su; Hao,9999,0,9999,0
1668050610226,CSE 293,037,119433,Swanson; Steven James,9999,0,9999,0
1668050610226,CSE 293,038,119435,Tullsen; Dean Michael,9999,0,9999,0
1668050610226,CSE 293,039,119483,Voelker; Geoffrey M.,9999,0,9999,0
1668050610226,CSE 293,040,119537,Zhao; Jishen,9999,0,9999,0
1668050610226,CSE 293,041,119538,Zhou; Yuan-Yuan,9999,0,9999,0
1668050610226,CSE 293,042,119539,Gao; Sicun,9999,0,9999,0
1668050610226,CSE 293,043,119540,Weibel; Nadir,9999,0,9999,0
1668050610226,CSE 293,044,119541,Gupta; Rajesh K.,9999,0,9999,0
1668050610226,CSE 293,045,126410,Vaccaro; Kristen Marie,9999,0,9999,0
1668050610226,CSE 293,046,126411,Klemke; Richard,9999,0,9999,0
1668050610651,CSE 294,A00,102459,Voelker; Geoffrey M.,0,0,0,0
1668050610651,CSE 294,B00,111322,Orailoglu; Alex,0,0,0,0
1668050611075,DSE 201,A00,096914,Deutsch; Alin Bernard,30,0,30,0
1668050611510,DSE 210,A00,096915,Dasgupta; Sanjoy,30,0,30,0
1668050611934,DSE 260A,A00,096916,Altintas De Callaf; Ilkay,30,0,30,0
1668050612376,ECE 200,001,103586,Antipa; Nicholas A,9999,0,9999,0
1668050612376,ECE 200,002,103587,Atanasov; Nikolay A.,9999,0,9999,0
1668050612376,ECE 200,003,103588,Bharadia; Dinesh,9999,0,9999,0
1668050612376,ECE 200,004,103589,Cheng; Chung Kuan,9999,0,9999,0
1668050612376,ECE 200,005,103590,Cosman; Pamela C.,9999,0,9999,0
1668050612376,ECE 200,006,103591,Dayeh; Shadi Ahmad,9999,0,9999,0
1668050612376,ECE 200,007,103592,Fainman; Yeshaiahu,9999,0,9999,0
1668050612376,ECE 200,008,103593,Ford; Joseph Earl,9999,0,9999,0
1668050612376,ECE 200,009,103594,Franceschetti; Massimo,9999,0,9999,0
1668050612376,ECE 200,010,103595,Fullerton; Eric E,9999,0,9999,0
1668050612376,ECE 200,011,103596,Galton; Ian A,9999,0,9999,0
1668050612376,ECE 200,012,103597,Gilja; Vikash,9999,0,9999,0
1668050612376,ECE 200,013,103598,Hall; Drew A.,9999,0,9999,0
1668050612376,ECE 200,014,103599,Hsueh; Tzu-Chien,9999,0,9999,0
1668050612376,ECE 200,015,103600,Javidi; Tara,9999,0,9999,0
1668050612376,ECE 200,016,103601,Kahng; Andrew Byun,9999,0,9999,0
1668050612376,ECE 200,017,103602,Kim; Young-Han,9999,0,9999,0
1668050612376,ECE 200,018,103603,Koushanfar; Farinaz,9999,0,9999,0
1668050612376,ECE 200,019,103604,Kuzum; Duygu,9999,0,9999,0
1668050612376,ECE 200,020,103605,Le; Hanh-Phuc,9999,0,9999,0
1668050612376,ECE 200,021,103606,Lin; Bill,9999,0,9999,0
1668050612376,ECE 200,022,103607,Liu; Zhaowei,9998,0,9999,1
1668050612376,ECE 200,023,103608,Lo; Yu-Hwa,9999,0,9999,0
1668050612376,ECE 200,024,103609,Lomakin; Vitaliy,9999,0,9999,0
1668050612376,ECE 200,025,103610,Mercier; Patrick Philip,9999,0,9999,0
1668050612376,ECE 200,026,103611,Meyer; Florian,9999,0,9999,0
1668050612376,ECE 200,027,103612,Milstein; Laurence B.,9999,0,9999,0
1668050612376,ECE 200,028,103613,Mir Arabbaygi; Siavash,9999,0,9999,0
1668050612376,ECE 200,029,103614,Mookherjea; Shayan,9999,0,9999,0
1668050612376,ECE 200,030,103615,Morris; Karcher William,9999,0,9999,0
1668050612376,ECE 200,031,103616,Ng; Tse Nga,9999,0,9999,0
1668050612376,ECE 200,032,103617,Nguyen; Truong Quang,9999,0,9999,0
1668050612376,ECE 200,033,103618,Nomura; Kenji,9999,0,9999,0
1668050612376,ECE 200,034,103619,Orlitsky; Alon,9999,0,9999,0
1668050612376,ECE 200,035,103620,Pal; Piya,9999,0,9999,0
1668050612376,ECE 200,036,103621,Papen; George C.,9999,0,9999,0
1668050612376,ECE 200,037,103622,Radic; Stojan,9999,0,9999,0
1668050612376,ECE 200,038,103623,Rao; Bhaskar D.,9999,0,9999,0
1668050612376,ECE 200,039,103624,Rao; Ramesh R,9999,0,9999,0
1668050612376,ECE 200,040,103625,Rebeiz; Gabriel,9999,0,9999,0
1668050612376,ECE 200,041,103626,Sanford; John R,9999,0,9999,0
1668050612376,ECE 200,042,103627,Siegel; Paul H.,9999,0,9999,0
1668050612376,ECE 200,043,103628,Sievenpiper; Daniel F.,9999,0,9999,0
1668050612376,ECE 200,044,103629,Sworder; David D.,9999,0,9999,0
1668050612376,ECE 200,045,103630,Taur; Yuan,9999,0,9999,0
1668050612376,ECE 200,046,103631,Touri; Behrouz,9999,0,9999,0
1668050612376,ECE 200,047,103632,Trivedi; Mohan M.,9999,0,9999,0
1668050612376,ECE 200,048,103633,Vasconcelos; Nuno,9999,0,9999,0
1668050612376,ECE 200,049,103634,Wang; Xiaolong,9999,0,9999,0
1668050612376,ECE 200,050,103635,Xie; Pengtao,9999,0,9999,0
1668050612376,ECE 200,051,103636,Yip; Michael,9999,0,9999,0
1668050612376,ECE 200,052,103637,Zeger; Kenneth A.,999,0,999,0
1668050612376,ECE 200,053,103638,Zhang; Xinyu,9999,0,9999,0
1668050612376,ECE 200,054,103639,Turakhia; Yatish Girish,9999,0,9999,0
1668050612376,ECE 200,055,103640,Kang; Mingu,9999,0,9999,0
1668050612376,ECE 200,056,103641,Shi; Yuanyuan,9999,0,9999,0
1668050612376,ECE 200,057,103642,Wang; Edward Jay,9999,0,9999,0
1668050612376,ECE 200,058,103643,Zheng; Yang,9999,0,9999,0
1668050612809,ECE 202,A00,103644,Kuzum; Duygu,0,0,0,0
1668050613236,ECE 212BN,A00,103646,Ng; Tse Nga,0,0,0,0
1668050613667,ECE 221,A00,111493,Staff,0,0,0,0
1668050614095,ECE 222B,A00,103647,Lomakin; Vitaliy,0,0,0,0
1668050614524,ECE 230B,A00,103648,Taur; Yuan,0,0,0,0
1668050614951,ECE 238B,A00,103649,Garay; Javier,0,0,0,0
1668050615386,ECE 240B,A00,112900,Fainman; Yeshaiahu,0,0,0,0
1668050615824,ECE 247A,A00,103650,Jokerst; Jesse Vincent,0,0,0,0
1668050616248,ECE 247B,A00,103651,Wang; Joseph,0,0,0,0
1668050616669,ECE 250,A00,103652,Siegel; Paul H.,0,0,0,0
1668050617093,ECE 251A,A00,103654,Rao; Bhaskar D.,0,0,0,0
1668050617529,ECE 257B,A00,103655,Bharadia; Dinesh,0,0,0,0
1668050617952,ECE 258A,A00,103656,Milstein; Laurence B.,0,0,0,0
1668050618375,ECE 260B,A00,103658,Kang; Mingu,0,0,0,0
1668050618800,ECE 264A,A00,103659,Galton; Ian A,0,0,0,0
1668050619223,ECE 265A,A00,103661,Gudem; Prasad S.S.,0,0,0,0
1668050619646,ECE 265D,A00,103662,Gudem; Prasad S.S.,0,0,0,0
1668050620079,ECE 268,A00,103663,Koushanfar; Farinaz,0,0,0,0
1668050620502,ECE 269,A01,103665,Pal; Piya,0,0,0,0
1668050620928,ECE 271B,A00,103666,Vasconcelos; Manuela,0,0,0,0
1668050621354,ECE 276A,A00,103667,Atanasov; Nikolay A.,0,0,0,0
1668050621782,ECE 277,A00,103668,An; Cheolhong,0,0,0,0
1668050622205,ECE 279,A00,117947,Hall; Drew A.,0,0,0,0
1668050623055,ECE 283,A00,103670,Hsueh; Tzu-Chien,0,0,0,0
1668050623483,ECE 284,A00,103671,Turakhia; Yatish Girish,0,0,0,0
1668050623915,ECE 285,A00,103672,Zheng; Yang,0,0,0,0
1668050623915,ECE 285,B00,103673,Sworder; David D.,0,0,0,0
1668050624350,ECE 287,A00,103676,Javidi; Tara,0,0,0,0
1668050624772,MATH 200B,A00,098023,Salehi Golsefidy; Alireza,13,0,15,2
1668050625209,MATH 202B,A00,098024,Rhoades; Brendon Patrick,9,0,15,6
1668050625638,MATH 203B,A00,098025,Oprea; Dragos N.,11,0,15,4
1668050626075,MATH 204B,A00,098026,Sorensen; Claus M,13,0,15,2
1668050626506,MATH 208,A00,098027,Izadi; Elham,7,0,10,3
1668050626938,MATH 209,A00,098028,Pollack; Aaron,10,0,10,0
1668050627364,MATH 211A,A00,112919,Rogalski; Daniel,9,0,10,1
1668050627788,MATH 211B,A00,112920,Seward; Brandon M.,9,0,10,1
1668050628219,MATH 218,A00,098029,Li; Bo,10,0,10,0
1668050628647,MATH 220B,A00,098030,Novak; Jonathan I,13,0,15,2
1668050629071,MATH 221A,A00,098031,Ebenfelt; Peter F,13,0,15,2
1668050629510,MATH 231B,A00,098032,Zlatos; Andrej,12,0,15,3
1668050629936,MATH 240B,A00,098033,Ni; Lei,9,0,15,6
1668050630361,MATH 243,A00,098034,Jekel; David Andrew,10,0,10,0
1668050630787,MATH 245A,A00,098035,Nie; Jiawang,0,0,15,16
1668050631214,MATH 248,A00,098036,Bejenaru; Ioan,10,0,10,0
1668050631643,MATH 250B,A00,098037,Spolaor; Luca,14,0,15,1
1668050632070,MATH 258,A00,098038,Ni; Lei,10,0,10,0
1668050632495,MATH 264B,A00,098041,Rhoades; Brendon Patrick,10,0,15,5
1668050632927,MATH 268,A00,098042,Buss; Samuel R,10,0,10,0
1668050633462,MATH 269,A00,098043,Rhoades; Brendon Patrick,10,0,10,0
1668050633896,MATH 270B,A00,098044,Li; Bo,11,0,15,4
1668050634326,MATH 272B,A00,098045,Holst; Michael J,13,0,15,2
1668050634755,MATH 273A,A00,098046,Tian; Xiaochuan,10,0,15,5
1668050635180,MATH 275,A01,098048,Tian; Xiaochuan,6,0,10,4
1668050635606,MATH 278A,A00,098049,Holst; Michael J,8,0,10,2
1668050636030,MATH 278B,A00,098050,Cloninger; Alexander,10,0,10,0
1668050636459,MATH 278C,A00,098051,Nie; Jiawang,7,0,10,3
1668050636890,MATH 280B,A00,098052,Zheng; Tianyi,10,0,15,5
1668050637315,MATH 281B,A00,098053,Bradic; Jelena,3,0,15,12
1668050637739,MATH 282B,A00,098054,Arias-Castro; Ery,0,0,15,15
1668050638162,MATH 285,A00,098055,Fitzsimmons; Patrick J,0,0,15,17
1668050638590,MATH 287B,A00,098056,Arias-Castro; Ery,3,0,15,12
1668050639022,MATH 288,A00,098057,Agarwal; Pooja,9,0,10,1
1668050639022,MATH 288,B00,098058,Zhang; Danna,8,0,10,2
1668050639022,MATH 288,C00,098059,Williams; Ruth J,10,0,10,0
1668050639445,MATH 290B,A00,098060,Roberts; Justin Deritter,13,0,15,2
1668050639868,MATH 292,A00,098061,Belmont; Eva Kinoshita,10,0,10,0
1668050640297,MATH 295,A00,098062,Suk; Andrew Hoon,48,0,50,2
1668050640720,MATH 296,A00,098063,Novak; Jonathan I,20,0,20,0
1668050641145,MATH 297,001,098064,Gamst; Anthony Collins,9997,0,9999,2
1668051144125,COGS 205,A00,101395,Chiba; Andrea,19,0,20,1
1668051144563,COGS 210B,001,101404,Greene; Deanna Jacquelyn,9998,0,9999,1
1668051144563,COGS 210B,002,101417,Xia; Haijun,9999,0,9999,0
1668051144563,COGS 210B,003,101422,Nitz; Douglas A.,9999,0,9999,0
1668051144563,COGS 210B,004,101423,Hollan; James D.,9998,0,9999,1
1668051144563,COGS 210B,005,101424,Deak; Gedeon O.,9998,0,9999,1
1668051144563,COGS 210B,006,101425,Rossano; Federico,9999,0,9999,0
1668051144997,COGS 211B,A00,101427,Coulson; Seana M,9996,0,9999,3
1668051145427,COGS 220,A00,101428,Hollan; James D.,0,0,25,25
1668051145852,COGS 229,A00,101429,Dow; Steven P,18,0,25,7
1668051146291,COGS 230,A00,101430,Klemmer; Scott R,13,0,17,4
1668051146714,COGS 234,A00,101431,Xia; Haijun,4,0,25,21
1668051147141,COGS 260,A00,101432,Kiyonaga; Anastasia,19,0,25,6
1668051147141,COGS 260,B00,101433,Kirsh; David Joel,16,0,25,9
1668051147569,CSE 202,A00,102371,Impagliazzo; Russell,0,0,0,0
1668051147995,CSE 203B,A01,102373,Cheng; Chung Kuan,0,0,0,0
1668051148433,CSE 208,A00,102374,Micciancio; Daniele,0,0,0,0
1668051148860,CSE 209A,A00,112895,Impagliazzo; Russell,0,0,15,15
1668051149295,CSE 209B,A00,108005,Bellare; Mihir,0,0,0,0
1668051149734,CSE 210,A00,113163,Coblenz; Michael J,0,0,0,0
1668051150168,CSE 219,A00,106111,Dow; Steven P,0,0,20,20
1668051150613,CSE 221,A00,102376,Voelker; Geoffrey M.,0,0,0,0
1668051151047,CSE 224,A01,102378,Porter; George M,0,0,0,0
1668051151487,CSE 229A,A00,102379,Savage; Stefan,0,0,0,0
1668051151910,CSE 229C,A00,102380,Munyaka; Imani N. S.,0,0,0,0
1668051152340,CSE 232B,A00,102382,Deutsch; Alin Bernard,0,0,0,0
1668051152764,CSE 234,A01,112904,Kumar; Arun Kumar,0,0,0,0
1668051153191,CSE 237A,A00,102383,Rosing; Tajana Simunic,0,0,0,0
1668051153612,CSE 239A,A00,102384,Deutsch; Alin Bernard,0,0,0,0
1668051154036,CSE 239B,A00,102385,Polikarpova; Nadezhda,0,0,0,0
1668051154469,CSE 240A,A00,102386,Pannuto; Patrick William,0,0,0,0
1668051154893,CSE 240B,A00,102387,Zhao; Jishen,0,0,0,0
1668051155327,CSE 241A,A00,106406,Kang; Mingu,0,0,0,0
1668051155762,CSE 249B,A00,102388,Kahng; Andrew Byun,0,0,8,8
1668051156190,CSE 251B,A01,102392,Cottrell; Garrison W,0,0,0,0
1668051156190,CSE 251B,A02,102393,Cottrell; Garrison W,0,0,0,0
1668051156698,CSE 252B,A00,102394,Ochoa; Benjamin Lawrence,0,0,0,0
1668051157126,CSE 257,A01,102396,Gao; Sicun,0,0,0,0
1668051157554,CSE 272,A00,102397,Li; Tzumao,0,0,0,0
1668051157997,CSE 274,A00,111323,Chern; Albert Ren-Haur,0,0,0,0
1668051158425,CSE 282,A00,102398,Pevzner; Pavel Arkadjevich,0,0,0,0
1668051158849,CSE 284,A00,114175,Gymrek; Melissa Ann,0,0,0,0
1668051159281,CSE 290,A00,102399,Chandraker; Manmohan Krishna,0,0,0,0
1668051159281,CSE 290,B00,102400,Vaccaro; Kristen Marie,0,0,25,25
1668051159281,CSE 290,C00,102414,Pannuto; Patrick William,0,0,25,25
1668051159281,CSE 290,D00,102427,Pevzner; Pavel Arkadjevich,0,0,0,0
1668051159281,CSE 290,E00,102429,Zhao; Jishen,0,0,0,0
1668051159281,CSE 290,F00,102436,Tullsen; Dean Michael,0,0,0,0
1668051159281,CSE 290,G00,102440,Christensen; Henrik I,0,0,20,20
1668051159722,CSE 291,A00,102443,Su; Hao,0,0,0,0
1668051159722,CSE 291,B00,102448,Polikarpova; Nadezhda,0,0,0,0
1668051159722,CSE 291,C00,102453,Vaccaro; Kristen Marie,0,0,0,0
1668051159722,CSE 291,D00,111343,Savage; Stefan,0,0,0,0
1668051159722,CSE 291,E00,116474,Claffy; Kimberly Claire,0,0,0,0
1668051159722,CSE 291,F00,116479,Pasquale; Joseph,0,0,0,0
1668051160181,CSE 293,001,119111,Bafna; Vineet,9999,0,9999,0
1668051160181,CSE 293,002,119118,Bellare; Mihir,9999,0,9999,0
1668051160181,CSE 293,003,119122,Berg-Kirkpatrick; Taylor D,9999,0,9999,0
1668051160181,CSE 293,004,119135,Christensen; Henrik I,9999,0,9999,0
1668051160181,CSE 293,005,119142,Cottrell; Garrison W,9999,0,9999,0
1668051160181,CSE 293,006,119146,Deutsch; Alin Bernard,9999,0,9999,0
1668051160181,CSE 293,007,119159,Esmaeilzadeh; Hadi,9999,0,9999,0
1668051160181,CSE 293,008,119166,Freund; Yoav,9999,0,9999,0
1668051160181,CSE 293,009,119170,Griswold; William G.,9999,0,9999,0
1668051160181,CSE 293,010,119183,Gymrek; Melissa Ann,9999,0,9999,0
1668051160181,CSE 293,011,119190,Heninger; Nadia A,9999,0,9999,0
1668051160181,CSE 293,012,119230,Impagliazzo; Russell,9999,0,9999,0
1668051160181,CSE 293,013,119232,Jhala; Ranjit,9999,0,9999,0
1668051160181,CSE 293,014,119233,Kahng; Andrew Byun,9999,0,9999,0
1668051160181,CSE 293,015,119298,Kane; Daniel Mertz,9999,0,9999,0
1668051160181,CSE 293,016,119299,Kriegman; David J,9999,0,9999,0
1668051160181,CSE 293,017,119300,Kumar; Arun Kumar,9999,0,9999,0
1668051160181,CSE 293,018,119301,Lerner; Sorin,9999,0,9999,0
1668051160181,CSE 293,019,119302,Lovett; Shachar,9999,0,9999,0
1668051160181,CSE 293,020,119303,McAuley; Julian John,9999,0,9999,0
1668051160181,CSE 293,021,119304,Micciancio; Daniele,9999,0,9999,0
1668051160181,CSE 293,022,119367,Orailoglu; Alex,9999,0,9999,0
1668051160181,CSE 293,023,119382,Paturi; Ramamohan,9999,0,9999,0
1668051160181,CSE 293,024,119404,Polikarpova; Nadezhda,9999,0,9999,0
1668051160181,CSE 293,025,119406,Politz; Joseph Gibbs,9999,0,9999,0
1668051160181,CSE 293,026,119411,Porter; George M,9999,0,9999,0
1668051160181,CSE 293,027,119414,Porter; Leonard Emerson,9999,0,9999,0
1668051160181,CSE 293,028,119416,Ramamoorthi; Ravi,9999,0,9999,0
1668051160181,CSE 293,029,119417,Sahoo; Debashis,9999,0,9999,0
1668051160181,CSE 293,030,119420,Saul; Lawrence,9999,0,9999,0
1668051160181,CSE 293,031,119421,Savage; Stefan,9999,0,9999,0
1668051160181,CSE 293,032,119425,Schulze; Jurgen P.,9999,0,9999,0
1668051160181,CSE 293,033,119426,Snoeren; Alex C.,9999,0,9999,0
1668051160181,CSE 293,034,119428,Shang; Jingbo,9999,0,9999,0
1668051160181,CSE 293,035,119430,Stefan; Deian,9999,0,9999,0
1668051160181,CSE 293,036,119431,Su; Hao,9999,0,9999,0
1668051160181,CSE 293,037,119433,Swanson; Steven James,9999,0,9999,0
1668051160181,CSE 293,038,119435,Tullsen; Dean Michael,9999,0,9999,0
1668051160181,CSE 293,039,119483,Voelker; Geoffrey M.,9999,0,9999,0
1668051160181,CSE 293,040,119537,Zhao; Jishen,9999,0,9999,0
1668051160181,CSE 293,041,119538,Zhou; Yuan-Yuan,9999,0,9999,0
1668051160181,CSE 293,042,119539,Gao; Sicun,9999,0,9999,0
1668051160181,CSE 293,043,119540,Weibel; Nadir,9999,0,9999,0
1668051160181,CSE 293,044,119541,Gupta; Rajesh K.,9999,0,9999,0
1668051160181,CSE 293,045,126410,Vaccaro; Kristen Marie,9999,0,9999,0
1668051160181,CSE 293,046,126411,Klemke; Richard,9999,0,9999,0
1668051160611,CSE 294,A00,102459,Voelker; Geoffrey M.,0,0,0,0
1668051160611,CSE 294,B00,111322,Orailoglu; Alex,0,0,0,0
1668051161035,DSE 201,A00,096914,Deutsch; Alin Bernard,30,0,30,0
1668051161462,DSE 210,A00,096915,Dasgupta; Sanjoy,30,0,30,0
1668051161909,DSE 260A,A00,096916,Altintas De Callaf; Ilkay,30,0,30,0
1668051162409,ECE 200,001,103586,Antipa; Nicholas A,9999,0,9999,0
1668051162409,ECE 200,002,103587,Atanasov; Nikolay A.,9999,0,9999,0
1668051162409,ECE 200,003,103588,Bharadia; Dinesh,9999,0,9999,0
1668051162409,ECE 200,004,103589,Cheng; Chung Kuan,9999,0,9999,0
1668051162409,ECE 200,005,103590,Cosman; Pamela C.,9999,0,9999,0
1668051162409,ECE 200,006,103591,Dayeh; Shadi Ahmad,9999,0,9999,0
1668051162409,ECE 200,007,103592,Fainman; Yeshaiahu,9999,0,9999,0
1668051162409,ECE 200,008,103593,Ford; Joseph Earl,9999,0,9999,0
1668051162409,ECE 200,009,103594,Franceschetti; Massimo,9999,0,9999,0
1668051162409,ECE 200,010,103595,Fullerton; Eric E,9999,0,9999,0
1668051162409,ECE 200,011,103596,Galton; Ian A,9999,0,9999,0
1668051162409,ECE 200,012,103597,Gilja; Vikash,9999,0,9999,0
1668051162409,ECE 200,013,103598,Hall; Drew A.,9999,0,9999,0
1668051162409,ECE 200,014,103599,Hsueh; Tzu-Chien,9999,0,9999,0
1668051162409,ECE 200,015,103600,Javidi; Tara,9999,0,9999,0
1668051162409,ECE 200,016,103601,Kahng; Andrew Byun,9999,0,9999,0
1668051162409,ECE 200,017,103602,Kim; Young-Han,9999,0,9999,0
1668051162409,ECE 200,018,103603,Koushanfar; Farinaz,9999,0,9999,0
1668051162409,ECE 200,019,103604,Kuzum; Duygu,9999,0,9999,0
1668051162409,ECE 200,020,103605,Le; Hanh-Phuc,9999,0,9999,0
1668051162409,ECE 200,021,103606,Lin; Bill,9999,0,9999,0
1668051162409,ECE 200,022,103607,Liu; Zhaowei,9998,0,9999,1
1668051162409,ECE 200,023,103608,Lo; Yu-Hwa,9999,0,9999,0
1668051162409,ECE 200,024,103609,Lomakin; Vitaliy,9999,0,9999,0
1668051162409,ECE 200,025,103610,Mercier; Patrick Philip,9999,0,9999,0
1668051162409,ECE 200,026,103611,Meyer; Florian,9999,0,9999,0
1668051162409,ECE 200,027,103612,Milstein; Laurence B.,9999,0,9999,0
1668051162409,ECE 200,028,103613,Mir Arabbaygi; Siavash,9999,0,9999,0
1668051162409,ECE 200,029,103614,Mookherjea; Shayan,9999,0,9999,0
1668051162409,ECE 200,030,103615,Morris; Karcher William,9999,0,9999,0
1668051162409,ECE 200,031,103616,Ng; Tse Nga,9999,0,9999,0
1668051162409,ECE 200,032,103617,Nguyen; Truong Quang,9999,0,9999,0
1668051162409,ECE 200,033,103618,Nomura; Kenji,9999,0,9999,0
1668051162409,ECE 200,034,103619,Orlitsky; Alon,9999,0,9999,0
1668051162409,ECE 200,035,103620,Pal; Piya,9999,0,9999,0
1668051162409,ECE 200,036,103621,Papen; George C.,9999,0,9999,0
1668051162409,ECE 200,037,103622,Radic; Stojan,9999,0,9999,0
1668051162409,ECE 200,038,103623,Rao; Bhaskar D.,9999,0,9999,0
1668051162409,ECE 200,039,103624,Rao; Ramesh R,9999,0,9999,0
1668051162409,ECE 200,040,103625,Rebeiz; Gabriel,9999,0,9999,0
1668051162409,ECE 200,041,103626,Sanford; John R,9999,0,9999,0
1668051162409,ECE 200,042,103627,Siegel; Paul H.,9999,0,9999,0
1668051162409,ECE 200,043,103628,Sievenpiper; Daniel F.,9999,0,9999,0
1668051162409,ECE 200,044,103629,Sworder; David D.,9999,0,9999,0
1668051162409,ECE 200,045,103630,Taur; Yuan,9999,0,9999,0
1668051162409,ECE 200,046,103631,Touri; Behrouz,9999,0,9999,0
1668051162409,ECE 200,047,103632,Trivedi; Mohan M.,9999,0,9999,0
1668051162409,ECE 200,048,103633,Vasconcelos; Nuno,9999,0,9999,0
1668051162409,ECE 200,049,103634,Wang; Xiaolong,9999,0,9999,0
1668051162409,ECE 200,050,103635,Xie; Pengtao,9999,0,9999,0
1668051162409,ECE 200,051,103636,Yip; Michael,9999,0,9999,0
1668051162409,ECE 200,052,103637,Zeger; Kenneth A.,999,0,999,0
1668051162409,ECE 200,053,103638,Zhang; Xinyu,9999,0,9999,0
1668051162409,ECE 200,054,103639,Turakhia; Yatish Girish,9999,0,9999,0
1668051162409,ECE 200,055,103640,Kang; Mingu,9999,0,9999,0
1668051162409,ECE 200,056,103641,Shi; Yuanyuan,9999,0,9999,0
1668051162409,ECE 200,057,103642,Wang; Edward Jay,9999,0,9999,0
1668051162409,ECE 200,058,103643,Zheng; Yang,9999,0,9999,0
1668051162831,ECE 202,A00,103644,Kuzum; Duygu,0,0,0,0
1668051163256,ECE 212BN,A00,103646,Ng; Tse Nga,0,0,0,0
1668051163679,ECE 221,A00,111493,Staff,0,0,0,0
1668051164108,ECE 222B,A00,103647,Lomakin; Vitaliy,0,0,0,0
1668051164536,ECE 230B,A00,103648,Taur; Yuan,0,0,0,0
1668051164973,ECE 238B,A00,103649,Garay; Javier,0,0,0,0
1668051165404,ECE 240B,A00,112900,Fainman; Yeshaiahu,0,0,0,0
1668051165850,ECE 247A,A00,103650,Jokerst; Jesse Vincent,0,0,0,0
1668051166280,ECE 247B,A00,103651,Wang; Joseph,0,0,0,0
1668051166713,ECE 250,A00,103652,Siegel; Paul H.,0,0,0,0
1668051167148,ECE 251A,A00,103654,Rao; Bhaskar D.,0,0,0,0
1668051167570,ECE 257B,A00,103655,Bharadia; Dinesh,0,0,0,0
1668051168002,ECE 258A,A00,103656,Milstein; Laurence B.,0,0,0,0
1668051168430,ECE 260B,A00,103658,Kang; Mingu,0,0,0,0
1668051168856,ECE 264A,A00,103659,Galton; Ian A,0,0,0,0
1668051169288,ECE 265A,A00,103661,Gudem; Prasad S.S.,0,0,0,0
1668051169719,ECE 265D,A00,103662,Gudem; Prasad S.S.,0,0,0,0
1668051170142,ECE 268,A00,103663,Koushanfar; Farinaz,0,0,0,0
1668051170566,ECE 269,A01,103665,Pal; Piya,0,0,0,0
1668051170994,ECE 271B,A00,103666,Vasconcelos; Manuela,0,0,0,0
1668051171422,ECE 276A,A00,103667,Atanasov; Nikolay A.,0,0,0,0
1668051171860,ECE 277,A00,103668,An; Cheolhong,0,0,0,0
1668051172302,ECE 279,A00,117947,Hall; Drew A.,0,0,0,0
1668051173153,ECE 283,A00,103670,Hsueh; Tzu-Chien,0,0,0,0
1668051173580,ECE 284,A00,103671,Turakhia; Yatish Girish,0,0,0,0
1668051174009,ECE 285,A00,103672,Zheng; Yang,0,0,0,0
1668051174009,ECE 285,B00,103673,Sworder; David D.,0,0,0,0
1668051174436,ECE 287,A00,103676,Javidi; Tara,0,0,0,0
1668051174863,MATH 200B,A00,098023,Salehi Golsefidy; Alireza,13,0,15,2
1668051175290,MATH 202B,A00,098024,Rhoades; Brendon Patrick,9,0,15,6
1668051175716,MATH 203B,A00,098025,Oprea; Dragos N.,11,0,15,4
1668051176150,MATH 204B,A00,098026,Sorensen; Claus M,13,0,15,2
1668051176574,MATH 208,A00,098027,Izadi; Elham,7,0,10,3
1668051177005,MATH 209,A00,098028,Pollack; Aaron,10,0,10,0
1668051177431,MATH 211A,A00,112919,Rogalski; Daniel,9,0,10,1
1668051177855,MATH 211B,A00,112920,Seward; Brandon M.,9,0,10,1
1668051178282,MATH 218,A00,098029,Li; Bo,10,0,10,0
1668051178708,MATH 220B,A00,098030,Novak; Jonathan I,13,0,15,2
1668051179134,MATH 221A,A00,098031,Ebenfelt; Peter F,13,0,15,2
1668051179563,MATH 231B,A00,098032,Zlatos; Andrej,12,0,15,3
1668051179989,MATH 240B,A00,098033,Ni; Lei,9,0,15,6
1668051180429,MATH 243,A00,098034,Jekel; David Andrew,10,0,10,0
1668051180860,MATH 245A,A00,098035,Nie; Jiawang,0,0,15,16
1668051181289,MATH 248,A00,098036,Bejenaru; Ioan,10,0,10,0
1668051181716,MATH 250B,A00,098037,Spolaor; Luca,14,0,15,1
1668051182147,MATH 258,A00,098038,Ni; Lei,10,0,10,0
1668051182573,MATH 264B,A00,098041,Rhoades; Brendon Patrick,10,0,15,5
1668051182998,MATH 268,A00,098042,Buss; Samuel R,10,0,10,0
1668051183425,MATH 269,A00,098043,Rhoades; Brendon Patrick,10,0,10,0
1668051183851,MATH 270B,A00,098044,Li; Bo,11,0,15,4
1668051184456,MATH 272B,A00,098045,Holst; Michael J,13,0,15,2
1668051184877,MATH 273A,A00,098046,Tian; Xiaochuan,10,0,15,5
1668051185303,MATH 275,A01,098048,Tian; Xiaochuan,6,0,10,4
1668051185729,MATH 278A,A00,098049,Holst; Michael J,8,0,10,2
1668051186155,MATH 278B,A00,098050,Cloninger; Alexander,10,0,10,0
1668051186577,MATH 278C,A00,098051,Nie; Jiawang,7,0,10,3
1668051187010,MATH 280B,A00,098052,Zheng; Tianyi,10,0,15,5
1668051187441,MATH 281B,A00,098053,Bradic; Jelena,3,0,15,12
1668051187866,MATH 282B,A00,098054,Arias-Castro; Ery,0,0,15,15
1668051188290,MATH 285,A00,098055,Fitzsimmons; Patrick J,0,0,15,17
1668051188719,MATH 287B,A00,098056,Arias-Castro; Ery,3,0,15,12
1668051189156,MATH 288,A00,098057,Agarwal; Pooja,9,0,10,1
1668051189156,MATH 288,B00,098058,Zhang; Danna,8,0,10,2
1668051189156,MATH 288,C00,098059,Williams; Ruth J,10,0,10,0
1668051189584,MATH 290B,A00,098060,Roberts; Justin Deritter,13,0,15,2
1668051190007,MATH 292,A00,098061,Belmont; Eva Kinoshita,10,0,10,0
1668051190433,MATH 295,A00,098062,Suk; Andrew Hoon,48,0,50,2
1668051190861,MATH 296,A00,098063,Novak; Jonathan I,20,0,20,0
1668051191286,MATH 297,001,098064,Gamst; Anthony Collins,9997,0,9999,2
1668051705753,COGS 205,A00,101395,Chiba; Andrea,19,0,20,1
1668051706180,COGS 210B,001,101404,Greene; Deanna Jacquelyn,9998,0,9999,1
1668051706180,COGS 210B,002,101417,Xia; Haijun,9999,0,9999,0
1668051706180,COGS 210B,003,101422,Nitz; Douglas A.,9999,0,9999,0
1668051706180,COGS 210B,004,101423,Hollan; James D.,9998,0,9999,1
1668051706180,COGS 210B,005,101424,Deak; Gedeon O.,9998,0,9999,1
1668051706180,COGS 210B,006,101425,Rossano; Federico,9999,0,9999,0
1668051706603,COGS 211B,A00,101427,Coulson; Seana M,9996,0,9999,3
1668051707043,COGS 220,A00,101428,Hollan; James D.,0,0,25,25
1668051707474,COGS 229,A00,101429,Dow; Steven P,18,0,25,7
1668051707901,COGS 230,A00,101430,Klemmer; Scott R,13,0,17,4
1668051708329,COGS 234,A00,101431,Xia; Haijun,4,0,25,21
1668051708760,COGS 260,A00,101432,Kiyonaga; Anastasia,19,0,25,6
1668051708760,COGS 260,B00,101433,Kirsh; David Joel,16,0,25,9
1668051709201,CSE 202,A00,102371,Impagliazzo; Russell,0,0,0,0
1668051709632,CSE 203B,A01,102373,Cheng; Chung Kuan,0,0,0,0
1668051710064,CSE 208,A00,102374,Micciancio; Daniele,0,0,0,0
1668051710488,CSE 209A,A00,112895,Impagliazzo; Russell,0,0,15,15
1668051710919,CSE 209B,A00,108005,Bellare; Mihir,0,0,0,0
1668051711356,CSE 210,A00,113163,Coblenz; Michael J,0,0,0,0
1668051711780,CSE 219,A00,106111,Dow; Steven P,0,0,20,20
1668051712211,CSE 221,A00,102376,Voelker; Geoffrey M.,0,0,0,0
1668051712641,CSE 224,A01,102378,Porter; George M,0,0,0,0
1668051713072,CSE 229A,A00,102379,Savage; Stefan,0,0,0,0
1668051713495,CSE 229C,A00,102380,Munyaka; Imani N. S.,0,0,0,0
1668051713919,CSE 232B,A00,102382,Deutsch; Alin Bernard,0,0,0,0
1668051714353,CSE 234,A01,112904,Kumar; Arun Kumar,0,0,0,0
1668051714789,CSE 237A,A00,102383,Rosing; Tajana Simunic,0,0,0,0
1668051715216,CSE 239A,A00,102384,Deutsch; Alin Bernard,0,0,0,0
1668051715646,CSE 239B,A00,102385,Polikarpova; Nadezhda,0,0,0,0
1668051716070,CSE 240A,A00,102386,Pannuto; Patrick William,0,0,0,0
1668051716501,CSE 240B,A00,102387,Zhao; Jishen,0,0,0,0
1668051716943,CSE 241A,A00,106406,Kang; Mingu,0,0,0,0
1668051717365,CSE 249B,A00,102388,Kahng; Andrew Byun,0,0,8,8
1668051717788,CSE 251B,A01,102392,Cottrell; Garrison W,0,0,0,0
1668051717788,CSE 251B,A02,102393,Cottrell; Garrison W,0,0,0,0
1668051718212,CSE 252B,A00,102394,Ochoa; Benjamin Lawrence,0,0,0,0
1668051718645,CSE 257,A01,102396,Gao; Sicun,0,0,0,0
1668051719076,CSE 272,A00,102397,Li; Tzumao,0,0,0,0
1668051719504,CSE 274,A00,111323,Chern; Albert Ren-Haur,0,0,0,0
1668051719932,CSE 282,A00,102398,Pevzner; Pavel Arkadjevich,0,0,0,0
1668051720358,CSE 284,A00,114175,Gymrek; Melissa Ann,0,0,0,0
1668051720782,CSE 290,A00,102399,Chandraker; Manmohan Krishna,0,0,0,0
1668051720782,CSE 290,B00,102400,Vaccaro; Kristen Marie,0,0,25,25
1668051720782,CSE 290,C00,102414,Pannuto; Patrick William,0,0,25,25
1668051720782,CSE 290,D00,102427,Pevzner; Pavel Arkadjevich,0,0,0,0
1668051720782,CSE 290,E00,102429,Zhao; Jishen,0,0,0,0
1668051720782,CSE 290,F00,102436,Tullsen; Dean Michael,0,0,0,0
1668051720782,CSE 290,G00,102440,Christensen; Henrik I,0,0,20,20
1668051721206,CSE 291,A00,102443,Su; Hao,0,0,0,0
1668051721206,CSE 291,B00,102448,Polikarpova; Nadezhda,0,0,0,0
1668051721206,CSE 291,C00,102453,Vaccaro; Kristen Marie,0,0,0,0
1668051721206,CSE 291,D00,111343,Savage; Stefan,0,0,0,0
1668051721206,CSE 291,E00,116474,Claffy; Kimberly Claire,0,0,0,0
1668051721206,CSE 291,F00,116479,Pasquale; Joseph,0,0,0,0
1668051721663,CSE 293,001,119111,Bafna; Vineet,9999,0,9999,0
1668051721663,CSE 293,002,119118,Bellare; Mihir,9999,0,9999,0
1668051721663,CSE 293,003,119122,Berg-Kirkpatrick; Taylor D,9999,0,9999,0
1668051721663,CSE 293,004,119135,Christensen; Henrik I,9999,0,9999,0
1668051721663,CSE 293,005,119142,Cottrell; Garrison W,9999,0,9999,0
1668051721663,CSE 293,006,119146,Deutsch; Alin Bernard,9999,0,9999,0
1668051721663,CSE 293,007,119159,Esmaeilzadeh; Hadi,9999,0,9999,0
1668051721663,CSE 293,008,119166,Freund; Yoav,9999,0,9999,0
1668051721663,CSE 293,009,119170,Griswold; William G.,9999,0,9999,0
1668051721663,CSE 293,010,119183,Gymrek; Melissa Ann,9999,0,9999,0
1668051721663,CSE 293,011,119190,Heninger; Nadia A,9999,0,9999,0
1668051721663,CSE 293,012,119230,Impagliazzo; Russell,9999,0,9999,0
1668051721663,CSE 293,013,119232,Jhala; Ranjit,9999,0,9999,0
1668051721663,CSE 293,014,119233,Kahng; Andrew Byun,9999,0,9999,0
1668051721663,CSE 293,015,119298,Kane; Daniel Mertz,9999,0,9999,0
1668051721663,CSE 293,016,119299,Kriegman; David J,9999,0,9999,0
1668051721663,CSE 293,017,119300,Kumar; Arun Kumar,9999,0,9999,0
1668051721663,CSE 293,018,119301,Lerner; Sorin,9999,0,9999,0
1668051721663,CSE 293,019,119302,Lovett; Shachar,9999,0,9999,0
1668051721663,CSE 293,020,119303,McAuley; Julian John,9999,0,9999,0
1668051721663,CSE 293,021,119304,Micciancio; Daniele,9999,0,9999,0
1668051721663,CSE 293,022,119367,Orailoglu; Alex,9999,0,9999,0
1668051721663,CSE 293,023,119382,Paturi; Ramamohan,9999,0,9999,0
1668051721663,CSE 293,024,119404,Polikarpova; Nadezhda,9999,0,9999,0
1668051721663,CSE 293,025,119406,Politz; Joseph Gibbs,9999,0,9999,0
1668051721663,CSE 293,026,119411,Porter; George M,9999,0,9999,0
1668051721663,CSE 293,027,119414,Porter; Leonard Emerson,9999,0,9999,0
1668051721663,CSE 293,028,119416,Ramamoorthi; Ravi,9999,0,9999,0
1668051721663,CSE 293,029,119417,Sahoo; Debashis,9999,0,9999,0
1668051721663,CSE 293,030,119420,Saul; Lawrence,9999,0,9999,0
1668051721663,CSE 293,031,119421,Savage; Stefan,9999,0,9999,0
1668051721663,CSE 293,032,119425,Schulze; Jurgen P.,9999,0,9999,0
1668051721663,CSE 293,033,119426,Snoeren; Alex C.,9999,0,9999,0
1668051721663,CSE 293,034,119428,Shang; Jingbo,9999,0,9999,0
1668051721663,CSE 293,035,119430,Stefan; Deian,9999,0,9999,0
1668051721663,CSE 293,036,119431,Su; Hao,9999,0,9999,0
1668051721663,CSE 293,037,119433,Swanson; Steven James,9999,0,9999,0
1668051721663,CSE 293,038,119435,Tullsen; Dean Michael,9999,0,9999,0
1668051721663,CSE 293,039,119483,Voelker; Geoffrey M.,9999,0,9999,0
1668051721663,CSE 293,040,119537,Zhao; Jishen,9999,0,9999,0
1668051721663,CSE 293,041,119538,Zhou; Yuan-Yuan,9999,0,9999,0
1668051721663,CSE 293,042,119539,Gao; Sicun,9999,0,9999,0
1668051721663,CSE 293,043,119540,Weibel; Nadir,9999,0,9999,0
1668051721663,CSE 293,044,119541,Gupta; Rajesh K.,9999,0,9999,0
1668051721663,CSE 293,045,126410,Vaccaro; Kristen Marie,9999,0,9999,0
1668051721663,CSE 293,046,126411,Klemke; Richard,9999,0,9999,0
1668051722089,CSE 294,A00,102459,Voelker; Geoffrey M.,0,0,0,0
1668051722089,CSE 294,B00,111322,Orailoglu; Alex,0,0,0,0
1668051722515,DSE 201,A00,096914,Deutsch; Alin Bernard,30,0,30,0
1668051722940,DSE 210,A00,096915,Dasgupta; Sanjoy,30,0,30,0
1668051723367,DSE 260A,A00,096916,Altintas De Callaf; Ilkay,30,0,30,0
1668051723799,ECE 200,001,103586,Antipa; Nicholas A,9999,0,9999,0
1668051723799,ECE 200,002,103587,Atanasov; Nikolay A.,9999,0,9999,0
1668051723799,ECE 200,003,103588,Bharadia; Dinesh,9999,0,9999,0
1668051723799,ECE 200,004,103589,Cheng; Chung Kuan,9999,0,9999,0
1668051723799,ECE 200,005,103590,Cosman; Pamela C.,9999,0,9999,0
1668051723799,ECE 200,006,103591,Dayeh; Shadi Ahmad,9999,0,9999,0
1668051723799,ECE 200,007,103592,Fainman; Yeshaiahu,9999,0,9999,0
1668051723799,ECE 200,008,103593,Ford; Joseph Earl,9999,0,9999,0
1668051723799,ECE 200,009,103594,Franceschetti; Massimo,9999,0,9999,0
1668051723799,ECE 200,010,103595,Fullerton; Eric E,9999,0,9999,0
1668051723799,ECE 200,011,103596,Galton; Ian A,9999,0,9999,0
1668051723799,ECE 200,012,103597,Gilja; Vikash,9999,0,9999,0
1668051723799,ECE 200,013,103598,Hall; Drew A.,9999,0,9999,0
1668051723799,ECE 200,014,103599,Hsueh; Tzu-Chien,9999,0,9999,0
1668051723799,ECE 200,015,103600,Javidi; Tara,9999,0,9999,0
1668051723799,ECE 200,016,103601,Kahng; Andrew Byun,9999,0,9999,0
1668051723799,ECE 200,017,103602,Kim; Young-Han,9999,0,9999,0
1668051723799,ECE 200,018,103603,Koushanfar; Farinaz,9999,0,9999,0
1668051723799,ECE 200,019,103604,Kuzum; Duygu,9999,0,9999,0
1668051723799,ECE 200,020,103605,Le; Hanh-Phuc,9999,0,9999,0
1668051723799,ECE 200,021,103606,Lin; Bill,9999,0,9999,0
1668051723799,ECE 200,022,103607,Liu; Zhaowei,9998,0,9999,1
1668051723799,ECE 200,023,103608,Lo; Yu-Hwa,9999,0,9999,0
1668051723799,ECE 200,024,103609,Lomakin; Vitaliy,9999,0,9999,0
1668051723799,ECE 200,025,103610,Mercier; Patrick Philip,9999,0,9999,0
1668051723799,ECE 200,026,103611,Meyer; Florian,9999,0,9999,0
1668051723799,ECE 200,027,103612,Milstein; Laurence B.,9999,0,9999,0
1668051723799,ECE 200,028,103613,Mir Arabbaygi; Siavash,9999,0,9999,0
1668051723799,ECE 200,029,103614,Mookherjea; Shayan,9999,0,9999,0
1668051723799,ECE 200,030,103615,Morris; Karcher William,9999,0,9999,0
1668051723799,ECE 200,031,103616,Ng; Tse Nga,9999,0,9999,0
1668051723799,ECE 200,032,103617,Nguyen; Truong Quang,9999,0,9999,0
1668051723799,ECE 200,033,103618,Nomura; Kenji,9999,0,9999,0
1668051723799,ECE 200,034,103619,Orlitsky; Alon,9999,0,9999,0
1668051723799,ECE 200,035,103620,Pal; Piya,9999,0,9999,0
1668051723799,ECE 200,036,103621,Papen; George C.,9999,0,9999,0
1668051723799,ECE 200,037,103622,Radic; Stojan,9999,0,9999,0
1668051723799,ECE 200,038,103623,Rao; Bhaskar D.,9999,0,9999,0
1668051723799,ECE 200,039,103624,Rao; Ramesh R,9999,0,9999,0
1668051723799,ECE 200,040,103625,Rebeiz; Gabriel,9999,0,9999,0
1668051723799,ECE 200,041,103626,Sanford; John R,9999,0,9999,0
1668051723799,ECE 200,042,103627,Siegel; Paul H.,9999,0,9999,0
1668051723799,ECE 200,043,103628,Sievenpiper; Daniel F.,9999,0,9999,0
1668051723799,ECE 200,044,103629,Sworder; David D.,9999,0,9999,0
1668051723799,ECE 200,045,103630,Taur; Yuan,9999,0,9999,0
1668051723799,ECE 200,046,103631,Touri; Behrouz,9999,0,9999,0
1668051723799,ECE 200,047,103632,Trivedi; Mohan M.,9999,0,9999,0
1668051723799,ECE 200,048,103633,Vasconcelos; Nuno,9999,0,9999,0
1668051723799,ECE 200,049,103634,Wang; Xiaolong,9999,0,9999,0
1668051723799,ECE 200,050,103635,Xie; Pengtao,9999,0,9999,0
1668051723799,ECE 200,051,103636,Yip; Michael,9999,0,9999,0
1668051723799,ECE 200,052,103637,Zeger; Kenneth A.,999,0,999,0
1668051723799,ECE 200,053,103638,Zhang; Xinyu,9999,0,9999,0
1668051723799,ECE 200,054,103639,Turakhia; Yatish Girish,9999,0,9999,0
1668051723799,ECE 200,055,103640,Kang; Mingu,9999,0,9999,0
1668051723799,ECE 200,056,103641,Shi; Yuanyuan,9999,0,9999,0
1668051723799,ECE 200,057,103642,Wang; Edward Jay,9999,0,9999,0
1668051723799,ECE 200,058,103643,Zheng; Yang,9999,0,9999,0
1668051724227,ECE 202,A00,103644,Kuzum; Duygu,0,0,0,0
1668051724655,ECE 212BN,A00,103646,Ng; Tse Nga,0,0,0,0
1668051725100,ECE 221,A00,111493,Staff,0,0,0,0
1668051725524,ECE 222B,A00,103647,Lomakin; Vitaliy,0,0,0,0
1668051725949,ECE 230B,A00,103648,Taur; Yuan,0,0,0,0
1668051726373,ECE 238B,A00,103649,Garay; Javier,0,0,0,0
1668051726799,ECE 240B,A00,112900,Fainman; Yeshaiahu,0,0,0,0
1668051727225,ECE 247A,A00,103650,Jokerst; Jesse Vincent,0,0,0,0
1668051727652,ECE 247B,A00,103651,Wang; Joseph,0,0,0,0
1668051728080,ECE 250,A00,103652,Siegel; Paul H.,0,0,0,0
1668051728502,ECE 251A,A00,103654,Rao; Bhaskar D.,0,0,0,0
1668051728925,ECE 257B,A00,103655,Bharadia; Dinesh,0,0,0,0
1668051729349,ECE 258A,A00,103656,Milstein; Laurence B.,0,0,0,0
1668051729777,ECE 260B,A00,103658,Kang; Mingu,0,0,0,0
1668051730200,ECE 264A,A00,103659,Galton; Ian A,0,0,0,0
1668051730629,ECE 265A,A00,103661,Gudem; Prasad S.S.,0,0,0,0
1668051731051,ECE 265D,A00,103662,Gudem; Prasad S.S.,0,0,0,0
1668051731477,ECE 268,A00,103663,Koushanfar; Farinaz,0,0,0,0
1668051731900,ECE 269,A01,103665,Pal; Piya,0,0,0,0
1668051732325,ECE 271B,A00,103666,Vasconcelos; Manuela,0,0,0,0
1668051732749,ECE 276A,A00,103667,Atanasov; Nikolay A.,0,0,0,0
1668051733185,ECE 277,A00,103668,An; Cheolhong,0,0,0,0
1668051733612,ECE 279,A00,117947,Hall; Drew A.,0,0,0,0
1668051734460,ECE 283,A00,103670,Hsueh; Tzu-Chien,0,0,0,0
1668051734998,ECE 284,A00,103671,Turakhia; Yatish Girish,0,0,0,0
1668051735421,ECE 285,A00,103672,Zheng; Yang,0,0,0,0
1668051735421,ECE 285,B00,103673,Sworder; David D.,0,0,0,0
1668051735842,ECE 287,A00,103676,Javidi; Tara,0,0,0,0
1668051736270,MATH 200B,A00,098023,Salehi Golsefidy; Alireza,13,0,15,2
1668051736697,MATH 202B,A00,098024,Rhoades; Brendon Patrick,9,0,15,6
1668051737124,MATH 203B,A00,098025,Oprea; Dragos N.,11,0,15,4
1668051737550,MATH 204B,A00,098026,Sorensen; Claus M,13,0,15,2
1668051737973,MATH 208,A00,098027,Izadi; Elham,7,0,10,3
1668051738398,MATH 209,A00,098028,Pollack; Aaron,10,0,10,0
1668051738821,MATH 211A,A00,112919,Rogalski; Daniel,9,0,10,1
1668051739256,MATH 211B,A00,112920,Seward; Brandon M.,9,0,10,1
1668051739683,MATH 218,A00,098029,Li; Bo,10,0,10,0
1668051740115,MATH 220B,A00,098030,Novak; Jonathan I,13,0,15,2
1668051740539,MATH 221A,A00,098031,Ebenfelt; Peter F,13,0,15,2
1668051740980,MATH 231B,A00,098032,Zlatos; Andrej,12,0,15,3
1668051741406,MATH 240B,A00,098033,Ni; Lei,9,0,15,6
1668051741846,MATH 243,A00,098034,Jekel; David Andrew,10,0,10,0
1668051742283,MATH 245A,A00,098035,Nie; Jiawang,0,0,15,16
1668051742710,MATH 248,A00,098036,Bejenaru; Ioan,10,0,10,0
1668051743135,MATH 250B,A00,098037,Spolaor; Luca,14,0,15,1
1668051743572,MATH 258,A00,098038,Ni; Lei,10,0,10,0
1668051743998,MATH 264B,A00,098041,Rhoades; Brendon Patrick,10,0,15,5
1668051744423,MATH 268,A00,098042,Buss; Samuel R,10,0,10,0
1668051744846,MATH 269,A00,098043,Rhoades; Brendon Patrick,10,0,10,0
1668051745271,MATH 270B,A00,098044,Li; Bo,11,0,15,4
1668051745694,MATH 272B,A00,098045,Holst; Michael J,13,0,15,2
1668051746120,MATH 273A,A00,098046,Tian; Xiaochuan,10,0,15,5
1668051746550,MATH 275,A01,098048,Tian; Xiaochuan,6,0,10,4
1668051746981,MATH 278A,A00,098049,Holst; Michael J,8,0,10,2
1668051747416,MATH 278B,A00,098050,Cloninger; Alexander,10,0,10,0
1668051747849,MATH 278C,A00,098051,Nie; Jiawang,7,0,10,3
1668051748273,MATH 280B,A00,098052,Zheng; Tianyi,10,0,15,5
1668051748697,MATH 281B,A00,098053,Bradic; Jelena,3,0,15,12
1668051749126,MATH 282B,A00,098054,Arias-Castro; Ery,0,0,15,15
1668051749551,MATH 285,A00,098055,Fitzsimmons; Patrick J,0,0,15,17
1668051749980,MATH 287B,A00,098056,Arias-Castro; Ery,3,0,15,12
1668051750417,MATH 288,A00,098057,Agarwal; Pooja,9,0,10,1
1668051750417,MATH 288,B00,098058,Zhang; Danna,8,0,10,2
1668051750417,MATH 288,C00,098059,Williams; Ruth J,10,0,10,0
1668051750845,MATH 290B,A00,098060,Roberts; Justin Deritter,13,0,15,2
1668051751271,MATH 292,A00,098061,Belmont; Eva Kinoshita,10,0,10,0
1668051751702,MATH 295,A00,098062,Suk; Andrew Hoon,48,0,50,2
1668051752146,MATH 296,A00,098063,Novak; Jonathan I,20,0,20,0
1668051752570,MATH 297,001,098064,Gamst; Anthony Collins,9997,0,9999,2
1668052254563,COGS 205,A00,101395,Chiba; Andrea,19,0,20,1
1668052254987,COGS 210B,001,101404,Greene; Deanna Jacquelyn,9998,0,9999,1
1668052254987,COGS 210B,002,101417,Xia; Haijun,9999,0,9999,0
1668052254987,COGS 210B,003,101422,Nitz; Douglas A.,9999,0,9999,0
1668052254987,COGS 210B,004,101423,Hollan; James D.,9998,0,9999,1
1668052254987,COGS 210B,005,101424,Deak; Gedeon O.,9998,0,9999,1
1668052254987,COGS 210B,006,101425,Rossano; Federico,9999,0,9999,0
1668052255425,COGS 211B,A00,101427,Coulson; Seana M,9996,0,9999,3
1668052255857,COGS 220,A00,101428,Hollan; James D.,0,0,25,25
1668052256283,COGS 229,A00,101429,Dow; Steven P,18,0,25,7
1668052256715,COGS 230,A00,101430,Klemmer; Scott R,13,0,17,4
1668052257230,COGS 234,A00,101431,Xia; Haijun,4,0,25,21
1668052257661,COGS 260,A00,101432,Kiyonaga; Anastasia,19,0,25,6
1668052257661,COGS 260,B00,101433,Kirsh; David Joel,16,0,25,9
1668052258093,CSE 202,A00,102371,Impagliazzo; Russell,0,0,0,0
1668052258515,CSE 203B,A01,102373,Cheng; Chung Kuan,0,0,0,0
1668052258944,CSE 208,A00,102374,Micciancio; Daniele,0,0,0,0
1668052259383,CSE 209A,A00,112895,Impagliazzo; Russell,0,0,15,15
1668052259810,CSE 209B,A00,108005,Bellare; Mihir,0,0,0,0
1668052260232,CSE 210,A00,113163,Coblenz; Michael J,0,0,0,0
1668052260657,CSE 219,A00,106111,Dow; Steven P,0,0,20,20
1668052261081,CSE 221,A00,102376,Voelker; Geoffrey M.,0,0,0,0
1668052261509,CSE 224,A01,102378,Porter; George M,0,0,0,0
1668052261931,CSE 229A,A00,102379,Savage; Stefan,0,0,0,0
1668052262359,CSE 229C,A00,102380,Munyaka; Imani N. S.,0,0,0,0
1668052262787,CSE 232B,A00,102382,Deutsch; Alin Bernard,0,0,0,0
1668052263211,CSE 234,A01,112904,Kumar; Arun Kumar,0,0,0,0
1668052263635,CSE 237A,A00,102383,Rosing; Tajana Simunic,0,0,0,0
1668052264059,CSE 239A,A00,102384,Deutsch; Alin Bernard,0,0,0,0
1668052264494,CSE 239B,A00,102385,Polikarpova; Nadezhda,0,0,0,0
1668052264938,CSE 240A,A00,102386,Pannuto; Patrick William,0,0,0,0
1668052265363,CSE 240B,A00,102387,Zhao; Jishen,0,0,0,0
1668052265790,CSE 241A,A00,106406,Kang; Mingu,0,0,0,0
1668052266236,CSE 249B,A00,102388,Kahng; Andrew Byun,0,0,8,8
1668052266660,CSE 251B,A01,102392,Cottrell; Garrison W,0,0,0,0
1668052266660,CSE 251B,A02,102393,Cottrell; Garrison W,0,0,0,0
1668052267094,CSE 252B,A00,102394,Ochoa; Benjamin Lawrence,0,0,0,0
1668052267517,CSE 257,A01,102396,Gao; Sicun,0,0,0,0
1668052267942,CSE 272,A00,102397,Li; Tzumao,0,0,0,0
1668052268366,CSE 274,A00,111323,Chern; Albert Ren-Haur,0,0,0,0
1668052268804,CSE 282,A00,102398,Pevzner; Pavel Arkadjevich,0,0,0,0
1668052269241,CSE 284,A00,114175,Gymrek; Melissa Ann,0,0,0,0
1668052269669,CSE 290,A00,102399,Chandraker; Manmohan Krishna,0,0,0,0
1668052269669,CSE 290,B00,102400,Vaccaro; Kristen Marie,0,0,25,25
1668052269669,CSE 290,C00,102414,Pannuto; Patrick William,0,0,25,25
1668052269669,CSE 290,D00,102427,Pevzner; Pavel Arkadjevich,0,0,0,0
1668052269669,CSE 290,E00,102429,Zhao; Jishen,0,0,0,0
1668052269669,CSE 290,F00,102436,Tullsen; Dean Michael,0,0,0,0
1668052269669,CSE 290,G00,102440,Christensen; Henrik I,0,0,20,20
1668052270116,CSE 291,A00,102443,Su; Hao,0,0,0,0
1668052270116,CSE 291,B00,102448,Polikarpova; Nadezhda,0,0,0,0
1668052270116,CSE 291,C00,102453,Vaccaro; Kristen Marie,0,0,0,0
1668052270116,CSE 291,D00,111343,Savage; Stefan,0,0,0,0
1668052270116,CSE 291,E00,116474,Claffy; Kimberly Claire,0,0,0,0
1668052270116,CSE 291,F00,116479,Pasquale; Joseph,0,0,0,0
1668052270553,CSE 293,001,119111,Bafna; Vineet,9999,0,9999,0
1668052270553,CSE 293,002,119118,Bellare; Mihir,9999,0,9999,0
1668052270553,CSE 293,003,119122,Berg-Kirkpatrick; Taylor D,9999,0,9999,0
1668052270553,CSE 293,004,119135,Christensen; Henrik I,9999,0,9999,0
1668052270553,CSE 293,005,119142,Cottrell; Garrison W,9999,0,9999,0
1668052270553,CSE 293,006,119146,Deutsch; Alin Bernard,9999,0,9999,0
1668052270553,CSE 293,007,119159,Esmaeilzadeh; Hadi,9999,0,9999,0
1668052270553,CSE 293,008,119166,Freund; Yoav,9999,0,9999,0
1668052270553,CSE 293,009,119170,Griswold; William G.,9999,0,9999,0
1668052270553,CSE 293,010,119183,Gymrek; Melissa Ann,9999,0,9999,0
1668052270553,CSE 293,011,119190,Heninger; Nadia A,9999,0,9999,0
1668052270553,CSE 293,012,119230,Impagliazzo; Russell,9999,0,9999,0
1668052270553,CSE 293,013,119232,Jhala; Ranjit,9999,0,9999,0
1668052270553,CSE 293,014,119233,Kahng; Andrew Byun,9999,0,9999,0
1668052270553,CSE 293,015,119298,Kane; Daniel Mertz,9999,0,9999,0
1668052270553,CSE 293,016,119299,Kriegman; David J,9999,0,9999,0
1668052270553,CSE 293,017,119300,Kumar; Arun Kumar,9999,0,9999,0
1668052270553,CSE 293,018,119301,Lerner; Sorin,9999,0,9999,0
1668052270553,CSE 293,019,119302,Lovett; Shachar,9999,0,9999,0
1668052270553,CSE 293,020,119303,McAuley; Julian John,9999,0,9999,0
1668052270553,CSE 293,021,119304,Micciancio; Daniele,9999,0,9999,0
1668052270553,CSE 293,022,119367,Orailoglu; Alex,9999,0,9999,0
1668052270553,CSE 293,023,119382,Paturi; Ramamohan,9999,0,9999,0
1668052270553,CSE 293,024,119404,Polikarpova; Nadezhda,9999,0,9999,0
1668052270553,CSE 293,025,119406,Politz; Joseph Gibbs,9999,0,9999,0
1668052270553,CSE 293,026,119411,Porter; George M,9999,0,9999,0
1668052270553,CSE 293,027,119414,Porter; Leonard Emerson,9999,0,9999,0
1668052270553,CSE 293,028,119416,Ramamoorthi; Ravi,9999,0,9999,0
1668052270553,CSE 293,029,119417,Sahoo; Debashis,9999,0,9999,0
1668052270553,CSE 293,030,119420,Saul; Lawrence,9999,0,9999,0
1668052270553,CSE 293,031,119421,Savage; Stefan,9999,0,9999,0
1668052270553,CSE 293,032,119425,Schulze; Jurgen P.,9999,0,9999,0
1668052270553,CSE 293,033,119426,Snoeren; Alex C.,9999,0,9999,0
1668052270553,CSE 293,034,119428,Shang; Jingbo,9999,0,9999,0
1668052270553,CSE 293,035,119430,Stefan; Deian,9999,0,9999,0
1668052270553,CSE 293,036,119431,Su; Hao,9999,0,9999,0
1668052270553,CSE 293,037,119433,Swanson; Steven James,9999,0,9999,0
1668052270553,CSE 293,038,119435,Tullsen; Dean Michael,9999,0,9999,0
1668052270553,CSE 293,039,119483,Voelker; Geoffrey M.,9999,0,9999,0
1668052270553,CSE 293,040,119537,Zhao; Jishen,9999,0,9999,0
1668052270553,CSE 293,041,119538,Zhou; Yuan-Yuan,9999,0,9999,0
1668052270553,CSE 293,042,119539,Gao; Sicun,9999,0,9999,0
1668052270553,CSE 293,043,119540,Weibel; Nadir,9999,0,9999,0
1668052270553,CSE 293,044,119541,Gupta; Rajesh K.,9999,0,9999,0
1668052270553,CSE 293,045,126410,Vaccaro; Kristen Marie,9999,0,9999,0
1668052270553,CSE 293,046,126411,Klemke; Richard,9999,0,9999,0
1668052270981,CSE 294,A00,102459,Voelker; Geoffrey M.,0,0,0,0
1668052270981,CSE 294,B00,111322,Orailoglu; Alex,0,0,0,0
1668052271404,DSE 201,A00,096914,Deutsch; Alin Bernard,30,0,30,0
1668052271843,DSE 210,A00,096915,Dasgupta; Sanjoy,30,0,30,0
1668052272270,DSE 260A,A00,096916,Altintas De Callaf; Ilkay,30,0,30,0
1668052272753,ECE 200,001,103586,Antipa; Nicholas A,9999,0,9999,0
1668052272753,ECE 200,002,103587,Atanasov; Nikolay A.,9999,0,9999,0
1668052272753,ECE 200,003,103588,Bharadia; Dinesh,9999,0,9999,0
1668052272753,ECE 200,004,103589,Cheng; Chung Kuan,9999,0,9999,0
1668052272753,ECE 200,005,103590,Cosman; Pamela C.,9999,0,9999,0
1668052272753,ECE 200,006,103591,Dayeh; Shadi Ahmad,9999,0,9999,0
1668052272753,ECE 200,007,103592,Fainman; Yeshaiahu,9999,0,9999,0
1668052272753,ECE 200,008,103593,Ford; Joseph Earl,9999,0,9999,0
1668052272753,ECE 200,009,103594,Franceschetti; Massimo,9999,0,9999,0
1668052272753,ECE 200,010,103595,Fullerton; Eric E,9999,0,9999,0
1668052272753,ECE 200,011,103596,Galton; Ian A,9999,0,9999,0
1668052272753,ECE 200,012,103597,Gilja; Vikash,9999,0,9999,0
1668052272753,ECE 200,013,103598,Hall; Drew A.,9999,0,9999,0
1668052272753,ECE 200,014,103599,Hsueh; Tzu-Chien,9999,0,9999,0
1668052272753,ECE 200,015,103600,Javidi; Tara,9999,0,9999,0
1668052272753,ECE 200,016,103601,Kahng; Andrew Byun,9999,0,9999,0
1668052272753,ECE 200,017,103602,Kim; Young-Han,9999,0,9999,0
1668052272753,ECE 200,018,103603,Koushanfar; Farinaz,9999,0,9999,0
1668052272753,ECE 200,019,103604,Kuzum; Duygu,9999,0,9999,0
1668052272753,ECE 200,020,103605,Le; Hanh-Phuc,9999,0,9999,0
1668052272753,ECE 200,021,103606,Lin; Bill,9999,0,9999,0
1668052272753,ECE 200,022,103607,Liu; Zhaowei,9998,0,9999,1
1668052272753,ECE 200,023,103608,Lo; Yu-Hwa,9999,0,9999,0
1668052272753,ECE 200,024,103609,Lomakin; Vitaliy,9999,0,9999,0
1668052272753,ECE 200,025,103610,Mercier; Patrick Philip,9999,0,9999,0
1668052272753,ECE 200,026,103611,Meyer; Florian,9999,0,9999,0
1668052272753,ECE 200,027,103612,Milstein; Laurence B.,9999,0,9999,0
1668052272753,ECE 200,028,103613,Mir Arabbaygi; Siavash,9999,0,9999,0
1668052272753,ECE 200,029,103614,Mookherjea; Shayan,9999,0,9999,0
1668052272753,ECE 200,030,103615,Morris; Karcher William,9999,0,9999,0
1668052272753,ECE 200,031,103616,Ng; Tse Nga,9999,0,9999,0
1668052272753,ECE 200,032,103617,Nguyen; Truong Quang,9999,0,9999,0
1668052272753,ECE 200,033,103618,Nomura; Kenji,9999,0,9999,0
1668052272753,ECE 200,034,103619,Orlitsky; Alon,9999,0,9999,0
1668052272753,ECE 200,035,103620,Pal; Piya,9999,0,9999,0
1668052272753,ECE 200,036,103621,Papen; George C.,9999,0,9999,0
1668052272753,ECE 200,037,103622,Radic; Stojan,9999,0,9999,0
1668052272753,ECE 200,038,103623,Rao; Bhaskar D.,9999,0,9999,0
1668052272753,ECE 200,039,103624,Rao; Ramesh R,9999,0,9999,0
1668052272753,ECE 200,040,103625,Rebeiz; Gabriel,9999,0,9999,0
1668052272753,ECE 200,041,103626,Sanford; John R,9999,0,9999,0
1668052272753,ECE 200,042,103627,Siegel; Paul H.,9999,0,9999,0
1668052272753,ECE 200,043,103628,Sievenpiper; Daniel F.,9999,0,9999,0
1668052272753,ECE 200,044,103629,Sworder; David D.,9999,0,9999,0
1668052272753,ECE 200,045,103630,Taur; Yuan,9999,0,9999,0
1668052272753,ECE 200,046,103631,Touri; Behrouz,9999,0,9999,0
1668052272753,ECE 200,047,103632,Trivedi; Mohan M.,9999,0,9999,0
1668052272753,ECE 200,048,103633,Vasconcelos; Nuno,9999,0,9999,0
1668052272753,ECE 200,049,103634,Wang; Xiaolong,9999,0,9999,0
1668052272753,ECE 200,050,103635,Xie; Pengtao,9999,0,9999,0
1668052272753,ECE 200,051,103636,Yip; Michael,9999,0,9999,0
1668052272753,ECE 200,052,103637,Zeger; Kenneth A.,999,0,999,0
1668052272753,ECE 200,053,103638,Zhang; Xinyu,9999,0,9999,0
1668052272753,ECE 200,054,103639,Turakhia; Yatish Girish,9999,0,9999,0
1668052272753,ECE 200,055,103640,Kang; Mingu,9999,0,9999,0
1668052272753,ECE 200,056,103641,Shi; Yuanyuan,9999,0,9999,0
1668052272753,ECE 200,057,103642,Wang; Edward Jay,9999,0,9999,0
1668052272753,ECE 200,058,103643,Zheng; Yang,9999,0,9999,0
1668052273181,ECE 202,A00,103644,Kuzum; Duygu,0,0,0,0
1668052273615,ECE 212BN,A00,103646,Ng; Tse Nga,0,0,0,0
1668052274043,ECE 221,A00,111493,Staff,0,0,0,0
1668052274473,ECE 222B,A00,103647,Lomakin; Vitaliy,0,0,0,0
1668052274897,ECE 230B,A00,103648,Taur; Yuan,0,0,0,0
1668052275320,ECE 238B,A00,103649,Garay; Javier,0,0,0,0
1668052275744,ECE 240B,A00,112900,Fainman; Yeshaiahu,0,0,0,0
1668052276171,ECE 247A,A00,103650,Jokerst; Jesse Vincent,0,0,0,0
1668052276598,ECE 247B,A00,103651,Wang; Joseph,0,0,0,0
1668052277022,ECE 250,A00,103652,Siegel; Paul H.,0,0,0,0
1668052277449,ECE 251A,A00,103654,Rao; Bhaskar D.,0,0,0,0
1668052277882,ECE 257B,A00,103655,Bharadia; Dinesh,0,0,0,0
1668052278321,ECE 258A,A00,103656,Milstein; Laurence B.,0,0,0,0
1668052278743,ECE 260B,A00,103658,Kang; Mingu,0,0,0,0
1668052279172,ECE 264A,A00,103659,Galton; Ian A,0,0,0,0
1668052279597,ECE 265A,A00,103661,Gudem; Prasad S.S.,0,0,0,0
1668052280034,ECE 265D,A00,103662,Gudem; Prasad S.S.,0,0,0,0
1668052280469,ECE 268,A00,103663,Koushanfar; Farinaz,0,0,0,0
1668052280891,ECE 269,A01,103665,Pal; Piya,0,0,0,0
1668052281315,ECE 271B,A00,103666,Vasconcelos; Manuela,0,0,0,0
1668052281738,ECE 276A,A00,103667,Atanasov; Nikolay A.,0,0,0,0
1668052282166,ECE 277,A00,103668,An; Cheolhong,0,0,0,0
1668052282593,ECE 279,A00,117947,Hall; Drew A.,0,0,0,0
1668052283469,ECE 283,A00,103670,Hsueh; Tzu-Chien,0,0,0,0
1668052283893,ECE 284,A00,103671,Turakhia; Yatish Girish,0,0,0,0
1668052284324,ECE 285,A00,103672,Zheng; Yang,0,0,0,0
1668052284324,ECE 285,B00,103673,Sworder; David D.,0,0,0,0
1668052284758,ECE 287,A00,103676,Javidi; Tara,0,0,0,0
1668052285189,MATH 200B,A00,098023,Salehi Golsefidy; Alireza,13,0,15,2
1668052285617,MATH 202B,A00,098024,Rhoades; Brendon Patrick,9,0,15,6
1668052286045,MATH 203B,A00,098025,Oprea; Dragos N.,11,0,15,4
1668052286473,MATH 204B,A00,098026,Sorensen; Claus M,13,0,15,2
1668052286900,MATH 208,A00,098027,Izadi; Elham,7,0,10,3
1668052287324,MATH 209,A00,098028,Pollack; Aaron,10,0,10,0
1668052287745,MATH 211A,A00,112919,Rogalski; Daniel,9,0,10,1
1668052288170,MATH 211B,A00,112920,Seward; Brandon M.,9,0,10,1
1668052288599,MATH 218,A00,098029,Li; Bo,10,0,10,0
1668052289024,MATH 220B,A00,098030,Novak; Jonathan I,13,0,15,2
1668052289452,MATH 221A,A00,098031,Ebenfelt; Peter F,13,0,15,2
1668052289889,MATH 231B,A00,098032,Zlatos; Andrej,12,0,15,3
1668052290318,MATH 240B,A00,098033,Ni; Lei,9,0,15,6
1668052290747,MATH 243,A00,098034,Jekel; David Andrew,10,0,10,0
1668052291177,MATH 245A,A00,098035,Nie; Jiawang,0,0,15,16
1668052291608,MATH 248,A00,098036,Bejenaru; Ioan,10,0,10,0
1668052292037,MATH 250B,A00,098037,Spolaor; Luca,14,0,15,1
1668052292476,MATH 258,A00,098038,Ni; Lei,10,0,10,0
1668052292904,MATH 264B,A00,098041,Rhoades; Brendon Patrick,10,0,15,5
1668052293338,MATH 268,A00,098042,Buss; Samuel R,10,0,10,0
1668052293764,MATH 269,A00,098043,Rhoades; Brendon Patrick,10,0,10,0
1668052294196,MATH 270B,A00,098044,Li; Bo,11,0,15,4
1668052294622,MATH 272B,A00,098045,Holst; Michael J,13,0,15,2
1668052295048,MATH 273A,A00,098046,Tian; Xiaochuan,10,0,15,5
1668052295477,MATH 275,A01,098048,Tian; Xiaochuan,6,0,10,4
1668052295899,MATH 278A,A00,098049,Holst; Michael J,8,0,10,2
1668052296334,MATH 278B,A00,098050,Cloninger; Alexander,10,0,10,0
1668052296758,MATH 278C,A00,098051,Nie; Jiawang,7,0,10,3
1668052297182,MATH 280B,A00,098052,Zheng; Tianyi,10,0,15,5
1668052297605,MATH 281B,A00,098053,Bradic; Jelena,3,0,15,12
1668052298033,MATH 282B,A00,098054,Arias-Castro; Ery,0,0,15,15
1668052298467,MATH 285,A00,098055,Fitzsimmons; Patrick J,0,0,15,17
1668052298890,MATH 287B,A00,098056,Arias-Castro; Ery,3,0,15,12
1668052299316,MATH 288,A00,098057,Agarwal; Pooja,9,0,10,1
1668052299316,MATH 288,B00,098058,Zhang; Danna,8,0,10,2
1668052299316,MATH 288,C00,098059,Williams; Ruth J,10,0,10,0
1668052299744,MATH 290B,A00,098060,Roberts; Justin Deritter,13,0,15,2
1668052300183,MATH 292,A00,098061,Belmont; Eva Kinoshita,10,0,10,0
1668052300705,MATH 295,A00,098062,Suk; Andrew Hoon,48,0,50,2
1668052301134,MATH 296,A00,098063,Novak; Jonathan I,20,0,20,0
1668052301569,MATH 297,001,098064,Gamst; Anthony Collins,9997,0,9999,2
1668052803954,COGS 205,A00,101395,Chiba; Andrea,19,0,20,1
1668052804376,COGS 210B,001,101404,Greene; Deanna Jacquelyn,9998,0,9999,1
1668052804376,COGS 210B,002,101417,Xia; Haijun,9999,0,9999,0
1668052804376,COGS 210B,003,101422,Nitz; Douglas A.,9999,0,9999,0
1668052804376,COGS 210B,004,101423,Hollan; James D.,9998,0,9999,1
1668052804376,COGS 210B,005,101424,Deak; Gedeon O.,9998,0,9999,1
1668052804376,COGS 210B,006,101425,Rossano; Federico,9999,0,9999,0
1668052804804,COGS 211B,A00,101427,Coulson; Seana M,9996,0,9999,3
1668052805233,COGS 220,A00,101428,Hollan; James D.,0,0,25,25
1668052805665,COGS 229,A00,101429,Dow; Steven P,18,0,25,7
1668052806089,COGS 230,A00,101430,Klemmer; Scott R,13,0,17,4
1668052806547,COGS 234,A00,101431,Xia; Haijun,4,0,25,21
1668052806981,COGS 260,A00,101432,Kiyonaga; Anastasia,19,0,25,6
1668052806981,COGS 260,B00,101433,Kirsh; David Joel,16,0,25,9
1668052807416,CSE 202,A00,102371,Impagliazzo; Russell,0,0,0,0
1668052807856,CSE 203B,A01,102373,Cheng; Chung Kuan,0,0,0,0
1668052808297,CSE 208,A00,102374,Micciancio; Daniele,0,0,0,0
1668052808721,CSE 209A,A00,112895,Impagliazzo; Russell,0,0,15,15
1668052809155,CSE 209B,A00,108005,Bellare; Mihir,0,0,0,0
1668052809715,CSE 210,A00,113163,Coblenz; Michael J,0,0,0,0
1668052810139,CSE 219,A00,106111,Dow; Steven P,0,0,20,20
1668052810563,CSE 221,A00,102376,Voelker; Geoffrey M.,0,0,0,0
1668052810989,CSE 224,A01,102378,Porter; George M,0,0,0,0
1668052811414,CSE 229A,A00,102379,Savage; Stefan,0,0,0,0
1668052811842,CSE 229C,A00,102380,Munyaka; Imani N. S.,0,0,0,0
1668052812265,CSE 232B,A00,102382,Deutsch; Alin Bernard,0,0,0,0
1668052812688,CSE 234,A01,112904,Kumar; Arun Kumar,0,0,0,0
1668052813115,CSE 237A,A00,102383,Rosing; Tajana Simunic,0,0,0,0
1668052813541,CSE 239A,A00,102384,Deutsch; Alin Bernard,0,0,0,0
1668052813967,CSE 239B,A00,102385,Polikarpova; Nadezhda,0,0,0,0
1668052814393,CSE 240A,A00,102386,Pannuto; Patrick William,0,0,0,0
1668052814826,CSE 240B,A00,102387,Zhao; Jishen,0,0,0,0
1668052815253,CSE 241A,A00,106406,Kang; Mingu,0,0,0,0
1668052815676,CSE 249B,A00,102388,Kahng; Andrew Byun,0,0,8,8
1668052816101,CSE 251B,A01,102392,Cottrell; Garrison W,0,0,0,0
1668052816101,CSE 251B,A02,102393,Cottrell; Garrison W,0,0,0,0
1668052816524,CSE 252B,A00,102394,Ochoa; Benjamin Lawrence,0,0,0,0
1668052816948,CSE 257,A01,102396,Gao; Sicun,0,0,0,0
1668052817376,CSE 272,A00,102397,Li; Tzumao,0,0,0,0
1668052817801,CSE 274,A00,111323,Chern; Albert Ren-Haur,0,0,0,0
1668052818225,CSE 282,A00,102398,Pevzner; Pavel Arkadjevich,0,0,0,0
1668052818650,CSE 284,A00,114175,Gymrek; Melissa Ann,0,0,0,0
1668052819076,CSE 290,A00,102399,Chandraker; Manmohan Krishna,0,0,0,0
1668052819076,CSE 290,B00,102400,Vaccaro; Kristen Marie,0,0,25,25
1668052819076,CSE 290,C00,102414,Pannuto; Patrick William,0,0,25,25
1668052819076,CSE 290,D00,102427,Pevzner; Pavel Arkadjevich,0,0,0,0
1668052819076,CSE 290,E00,102429,Zhao; Jishen,0,0,0,0
1668052819076,CSE 290,F00,102436,Tullsen; Dean Michael,0,0,0,0
1668052819076,CSE 290,G00,102440,Christensen; Henrik I,0,0,20,20
1668052819501,CSE 291,A00,102443,Su; Hao,0,0,0,0
1668052819501,CSE 291,B00,102448,Polikarpova; Nadezhda,0,0,0,0
1668052819501,CSE 291,C00,102453,Vaccaro; Kristen Marie,0,0,0,0
1668052819501,CSE 291,D00,111343,Savage; Stefan,0,0,0,0
1668052819501,CSE 291,E00,116474,Claffy; Kimberly Claire,0,0,0,0
1668052819501,CSE 291,F00,116479,Pasquale; Joseph,0,0,0,0
1668052819937,CSE 293,001,119111,Bafna; Vineet,9999,0,9999,0
1668052819937,CSE 293,002,119118,Bellare; Mihir,9999,0,9999,0
1668052819937,CSE 293,003,119122,Berg-Kirkpatrick; Taylor D,9999,0,9999,0
1668052819937,CSE 293,004,119135,Christensen; Henrik I,9999,0,9999,0
1668052819937,CSE 293,005,119142,Cottrell; Garrison W,9999,0,9999,0
1668052819937,CSE 293,006,119146,Deutsch; Alin Bernard,9999,0,9999,0
1668052819937,CSE 293,007,119159,Esmaeilzadeh; Hadi,9999,0,9999,0
1668052819937,CSE 293,008,119166,Freund; Yoav,9999,0,9999,0
1668052819937,CSE 293,009,119170,Griswold; William G.,9999,0,9999,0
1668052819937,CSE 293,010,119183,Gymrek; Melissa Ann,9999,0,9999,0
1668052819937,CSE 293,011,119190,Heninger; Nadia A,9999,0,9999,0
1668052819937,CSE 293,012,119230,Impagliazzo; Russell,9999,0,9999,0
1668052819937,CSE 293,013,119232,Jhala; Ranjit,9999,0,9999,0
1668052819937,CSE 293,014,119233,Kahng; Andrew Byun,9999,0,9999,0
1668052819937,CSE 293,015,119298,Kane; Daniel Mertz,9999,0,9999,0
1668052819937,CSE 293,016,119299,Kriegman; David J,9999,0,9999,0
1668052819937,CSE 293,017,119300,Kumar; Arun Kumar,9999,0,9999,0
1668052819937,CSE 293,018,119301,Lerner; Sorin,9999,0,9999,0
1668052819937,CSE 293,019,119302,Lovett; Shachar,9999,0,9999,0
1668052819937,CSE 293,020,119303,McAuley; Julian John,9999,0,9999,0
1668052819937,CSE 293,021,119304,Micciancio; Daniele,9999,0,9999,0
1668052819937,CSE 293,022,119367,Orailoglu; Alex,9999,0,9999,0
1668052819937,CSE 293,023,119382,Paturi; Ramamohan,9999,0,9999,0
1668052819937,CSE 293,024,119404,Polikarpova; Nadezhda,9999,0,9999,0
1668052819937,CSE 293,025,119406,Politz; Joseph Gibbs,9999,0,9999,0
1668052819937,CSE 293,026,119411,Porter; George M,9999,0,9999,0
1668052819937,CSE 293,027,119414,Porter; Leonard Emerson,9999,0,9999,0
1668052819937,CSE 293,028,119416,Ramamoorthi; Ravi,9999,0,9999,0
1668052819937,CSE 293,029,119417,Sahoo; Debashis,9999,0,9999,0
1668052819937,CSE 293,030,119420,Saul; Lawrence,9999,0,9999,0
1668052819937,CSE 293,031,119421,Savage; Stefan,9999,0,9999,0
1668052819937,CSE 293,032,119425,Schulze; Jurgen P.,9999,0,9999,0
1668052819937,CSE 293,033,119426,Snoeren; Alex C.,9999,0,9999,0
1668052819937,CSE 293,034,119428,Shang; Jingbo,9999,0,9999,0
1668052819937,CSE 293,035,119430,Stefan; Deian,9999,0,9999,0
1668052819937,CSE 293,036,119431,Su; Hao,9999,0,9999,0
1668052819937,CSE 293,037,119433,Swanson; Steven James,9999,0,9999,0
1668052819937,CSE 293,038,119435,Tullsen; Dean Michael,9999,0,9999,0
1668052819937,CSE 293,039,119483,Voelker; Geoffrey M.,9999,0,9999,0
1668052819937,CSE 293,040,119537,Zhao; Jishen,9999,0,9999,0
1668052819937,CSE 293,041,119538,Zhou; Yuan-Yuan,9999,0,9999,0
1668052819937,CSE 293,042,119539,Gao; Sicun,9999,0,9999,0
1668052819937,CSE 293,043,119540,Weibel; Nadir,9999,0,9999,0
1668052819937,CSE 293,044,119541,Gupta; Rajesh K.,9999,0,9999,0
1668052819937,CSE 293,045,126410,Vaccaro; Kristen Marie,9999,0,9999,0
1668052819937,CSE 293,046,126411,Klemke; Richard,9999,0,9999,0
1668052820377,CSE 294,A00,102459,Voelker; Geoffrey M.,0,0,0,0
1668052820377,CSE 294,B00,111322,Orailoglu; Alex,0,0,0,0
1668052820801,DSE 201,A00,096914,Deutsch; Alin Bernard,30,0,30,0
1668052821225,DSE 210,A00,096915,Dasgupta; Sanjoy,30,0,30,0
1668052821654,DSE 260A,A00,096916,Altintas De Callaf; Ilkay,30,0,30,0
1668052822144,ECE 200,001,103586,Antipa; Nicholas A,9999,0,9999,0
1668052822144,ECE 200,002,103587,Atanasov; Nikolay A.,9999,0,9999,0
1668052822144,ECE 200,003,103588,Bharadia; Dinesh,9999,0,9999,0
1668052822144,ECE 200,004,103589,Cheng; Chung Kuan,9999,0,9999,0
1668052822144,ECE 200,005,103590,Cosman; Pamela C.,9999,0,9999,0
1668052822144,ECE 200,006,103591,Dayeh; Shadi Ahmad,9999,0,9999,0
1668052822144,ECE 200,007,103592,Fainman; Yeshaiahu,9999,0,9999,0
1668052822144,ECE 200,008,103593,Ford; Joseph Earl,9999,0,9999,0
1668052822144,ECE 200,009,103594,Franceschetti; Massimo,9999,0,9999,0
1668052822144,ECE 200,010,103595,Fullerton; Eric E,9999,0,9999,0
1668052822144,ECE 200,011,103596,Galton; Ian A,9999,0,9999,0
1668052822144,ECE 200,012,103597,Gilja; Vikash,9999,0,9999,0
1668052822144,ECE 200,013,103598,Hall; Drew A.,9999,0,9999,0
1668052822144,ECE 200,014,103599,Hsueh; Tzu-Chien,9999,0,9999,0
1668052822144,ECE 200,015,103600,Javidi; Tara,9999,0,9999,0
1668052822144,ECE 200,016,103601,Kahng; Andrew Byun,9999,0,9999,0
1668052822144,ECE 200,017,103602,Kim; Young-Han,9999,0,9999,0
1668052822144,ECE 200,018,103603,Koushanfar; Farinaz,9999,0,9999,0
1668052822144,ECE 200,019,103604,Kuzum; Duygu,9999,0,9999,0
1668052822144,ECE 200,020,103605,Le; Hanh-Phuc,9999,0,9999,0
1668052822144,ECE 200,021,103606,Lin; Bill,9999,0,9999,0
1668052822144,ECE 200,022,103607,Liu; Zhaowei,9998,0,9999,1
1668052822144,ECE 200,023,103608,Lo; Yu-Hwa,9999,0,9999,0
1668052822144,ECE 200,024,103609,Lomakin; Vitaliy,9999,0,9999,0
1668052822144,ECE 200,025,103610,Mercier; Patrick Philip,9999,0,9999,0
1668052822144,ECE 200,026,103611,Meyer; Florian,9999,0,9999,0
1668052822144,ECE 200,027,103612,Milstein; Laurence B.,9999,0,9999,0
1668052822144,ECE 200,028,103613,Mir Arabbaygi; Siavash,9999,0,9999,0
1668052822144,ECE 200,029,103614,Mookherjea; Shayan,9999,0,9999,0
1668052822144,ECE 200,030,103615,Morris; Karcher William,9999,0,9999,0
1668052822144,ECE 200,031,103616,Ng; Tse Nga,9999,0,9999,0
1668052822144,ECE 200,032,103617,Nguyen; Truong Quang,9999,0,9999,0
1668052822144,ECE 200,033,103618,Nomura; Kenji,9999,0,9999,0
1668052822144,ECE 200,034,103619,Orlitsky; Alon,9999,0,9999,0
1668052822144,ECE 200,035,103620,Pal; Piya,9999,0,9999,0
1668052822144,ECE 200,036,103621,Papen; George C.,9999,0,9999,0
1668052822144,ECE 200,037,103622,Radic; Stojan,9999,0,9999,0
1668052822144,ECE 200,038,103623,Rao; Bhaskar D.,9999,0,9999,0
1668052822144,ECE 200,039,103624,Rao; Ramesh R,9999,0,9999,0
1668052822144,ECE 200,040,103625,Rebeiz; Gabriel,9999,0,9999,0
1668052822144,ECE 200,041,103626,Sanford; John R,9999,0,9999,0
1668052822144,ECE 200,042,103627,Siegel; Paul H.,9999,0,9999,0
1668052822144,ECE 200,043,103628,Sievenpiper; Daniel F.,9999,0,9999,0
1668052822144,ECE 200,044,103629,Sworder; David D.,9999,0,9999,0
1668052822144,ECE 200,045,103630,Taur; Yuan,9999,0,9999,0
1668052822144,ECE 200,046,103631,Touri; Behrouz,9999,0,9999,0
1668052822144,ECE 200,047,103632,Trivedi; Mohan M.,9999,0,9999,0
1668052822144,ECE 200,048,103633,Vasconcelos; Nuno,9999,0,9999,0
1668052822144,ECE 200,049,103634,Wang; Xiaolong,9999,0,9999,0
1668052822144,ECE 200,050,103635,Xie; Pengtao,9999,0,9999,0
1668052822144,ECE 200,051,103636,Yip; Michael,9999,0,9999,0
1668052822144,ECE 200,052,103637,Zeger; Kenneth A.,999,0,999,0
1668052822144,ECE 200,053,103638,Zhang; Xinyu,9999,0,9999,0
1668052822144,ECE 200,054,103639,Turakhia; Yatish Girish,9999,0,9999,0
1668052822144,ECE 200,055,103640,Kang; Mingu,9999,0,9999,0
1668052822144,ECE 200,056,103641,Shi; Yuanyuan,9999,0,9999,0
1668052822144,ECE 200,057,103642,Wang; Edward Jay,9999,0,9999,0
1668052822144,ECE 200,058,103643,Zheng; Yang,9999,0,9999,0
1668052822569,ECE 202,A00,103644,Kuzum; Duygu,0,0,0,0
1668052822994,ECE 212BN,A00,103646,Ng; Tse Nga,0,0,0,0
1668052823498,ECE 221,A00,111493,Staff,0,0,0,0
1668052823924,ECE 222B,A00,103647,Lomakin; Vitaliy,0,0,0,0
1668052824352,ECE 230B,A00,103648,Taur; Yuan,0,0,0,0
1668052824776,ECE 238B,A00,103649,Garay; Javier,0,0,0,0
1668052825211,ECE 240B,A00,112900,Fainman; Yeshaiahu,0,0,0,0
1668052825636,ECE 247A,A00,103650,Jokerst; Jesse Vincent,0,0,0,0
1668052826064,ECE 247B,A00,103651,Wang; Joseph,0,0,0,0
1668052826491,ECE 250,A00,103652,Siegel; Paul H.,0,0,0,0
1668052826923,ECE 251A,A00,103654,Rao; Bhaskar D.,0,0,0,0
1668052827354,ECE 257B,A00,103655,Bharadia; Dinesh,0,0,0,0
1668052827796,ECE 258A,A00,103656,Milstein; Laurence B.,0,0,0,0
1668052828241,ECE 260B,A00,103658,Kang; Mingu,0,0,0,0
1668052828671,ECE 264A,A00,103659,Galton; Ian A,0,0,0,0
1668052829104,ECE 265A,A00,103661,Gudem; Prasad S.S.,0,0,0,0
1668052829529,ECE 265D,A00,103662,Gudem; Prasad S.S.,0,0,0,0
1668052829953,ECE 268,A00,103663,Koushanfar; Farinaz,0,0,0,0
1668052830380,ECE 269,A01,103665,Pal; Piya,0,0,0,0
1668052830817,ECE 271B,A00,103666,Vasconcelos; Manuela,0,0,0,0
1668052831241,ECE 276A,A00,103667,Atanasov; Nikolay A.,0,0,0,0
1668052831698,ECE 277,A00,103668,An; Cheolhong,0,0,0,0
1668052832131,ECE 279,A00,117947,Hall; Drew A.,0,0,0,0
1668052832983,ECE 283,A00,103670,Hsueh; Tzu-Chien,0,0,0,0
1668052833413,ECE 284,A00,103671,Turakhia; Yatish Girish,0,0,0,0
1668052833838,ECE 285,A00,103672,Zheng; Yang,0,0,0,0
1668052833838,ECE 285,B00,103673,Sworder; David D.,0,0,0,0
1668052834261,ECE 287,A00,103676,Javidi; Tara,0,0,0,0
1668052834687,MATH 200B,A00,098023,Salehi Golsefidy; Alireza,13,0,15,2
1668052835110,MATH 202B,A00,098024,Rhoades; Brendon Patrick,9,0,15,6
1668052835537,MATH 203B,A00,098025,Oprea; Dragos N.,11,0,15,4
1668052835959,MATH 204B,A00,098026,Sorensen; Claus M,13,0,15,2
1668052836389,MATH 208,A00,098027,Izadi; Elham,7,0,10,3
1668052836816,MATH 209,A00,098028,Pollack; Aaron,10,0,10,0
1668052837248,MATH 211A,A00,112919,Rogalski; Daniel,9,0,10,1
1668052837684,MATH 211B,A00,112920,Seward; Brandon M.,9,0,10,1
1668052838106,MATH 218,A00,098029,Li; Bo,10,0,10,0
1668052838533,MATH 220B,A00,098030,Novak; Jonathan I,13,0,15,2
1668052838957,MATH 221A,A00,098031,Ebenfelt; Peter F,13,0,15,2
1668052839379,MATH 231B,A00,098032,Zlatos; Andrej,12,0,15,3
1668052839806,MATH 240B,A00,098033,Ni; Lei,9,0,15,6
1668052840241,MATH 243,A00,098034,Jekel; David Andrew,10,0,10,0
1668052840678,MATH 245A,A00,098035,Nie; Jiawang,0,0,15,16
1668052841105,MATH 248,A00,098036,Bejenaru; Ioan,10,0,10,0
1668052841536,MATH 250B,A00,098037,Spolaor; Luca,14,0,15,1
1668052841960,MATH 258,A00,098038,Ni; Lei,10,0,10,0
1668052842396,MATH 264B,A00,098041,Rhoades; Brendon Patrick,10,0,15,5
1668052842818,MATH 268,A00,098042,Buss; Samuel R,10,0,10,0
1668052843241,MATH 269,A00,098043,Rhoades; Brendon Patrick,10,0,10,0
1668052843671,MATH 270B,A00,098044,Li; Bo,11,0,15,4
1668052844095,MATH 272B,A00,098045,Holst; Michael J,13,0,15,2
1668052844518,MATH 273A,A00,098046,Tian; Xiaochuan,10,0,15,5
1668052844945,MATH 275,A01,098048,Tian; Xiaochuan,6,0,10,4
1668052845373,MATH 278A,A00,098049,Holst; Michael J,8,0,10,2
1668052845810,MATH 278B,A00,098050,Cloninger; Alexander,10,0,10,0
1668052846236,MATH 278C,A00,098051,Nie; Jiawang,7,0,10,3
1668052846665,MATH 280B,A00,098052,Zheng; Tianyi,10,0,15,5
1668052847087,MATH 281B,A00,098053,Bradic; Jelena,3,0,15,12
1668052847510,MATH 282B,A00,098054,Arias-Castro; Ery,0,0,15,15
1668052847946,MATH 285,A00,098055,Fitzsimmons; Patrick J,0,0,15,17
1668052848374,MATH 287B,A00,098056,Arias-Castro; Ery,3,0,15,12
1668052848811,MATH 288,A00,098057,Agarwal; Pooja,9,0,10,1
1668052848811,MATH 288,B00,098058,Zhang; Danna,8,0,10,2
1668052848811,MATH 288,C00,098059,Williams; Ruth J,10,0,10,0
1668052849255,MATH 290B,A00,098060,Roberts; Justin Deritter,13,0,15,2
1668052849683,MATH 292,A00,098061,Belmont; Eva Kinoshita,10,0,10,0
1668052850109,MATH 295,A00,098062,Suk; Andrew Hoon,48,0,50,2
1668052850537,MATH 296,A00,098063,Novak; Jonathan I,20,0,20,0
1668052850967,MATH 297,001,098064,Gamst; Anthony Collins,9997,0,9999,2
1668053353675,COGS 205,A00,101395,Chiba; Andrea,19,0,20,1
1668053354102,COGS 210B,001,101404,Greene; Deanna Jacquelyn,9998,0,9999,1
1668053354102,COGS 210B,002,101417,Xia; Haijun,9999,0,9999,0
1668053354102,COGS 210B,003,101422,Nitz; Douglas A.,9999,0,9999,0
1668053354102,COGS 210B,004,101423,Hollan; James D.,9998,0,9999,1
1668053354102,COGS 210B,005,101424,Deak; Gedeon O.,9998,0,9999,1
1668053354102,COGS 210B,006,101425,Rossano; Federico,9999,0,9999,0
1668053354527,COGS 211B,A00,101427,Coulson; Seana M,9996,0,9999,3
1668053354956,COGS 220,A00,101428,Hollan; James D.,0,0,25,25
1668053355378,COGS 229,A00,101429,Dow; Steven P,18,0,25,7
1668053355801,COGS 230,A00,101430,Klemmer; Scott R,13,0,17,4
1668053356224,COGS 234,A00,101431,Xia; Haijun,4,0,25,21
1668053356651,COGS 260,A00,101432,Kiyonaga; Anastasia,19,0,25,6
1668053356651,COGS 260,B00,101433,Kirsh; David Joel,16,0,25,9
1668053357073,CSE 202,A00,102371,Impagliazzo; Russell,0,0,0,0
1668053357500,CSE 203B,A01,102373,Cheng; Chung Kuan,0,0,0,0
1668053357926,CSE 208,A00,102374,Micciancio; Daniele,0,0,0,0
1668053358352,CSE 209A,A00,112895,Impagliazzo; Russell,0,0,15,15
1668053358775,CSE 209B,A00,108005,Bellare; Mihir,0,0,0,0
1668053359221,CSE 210,A00,113163,Coblenz; Michael J,0,0,0,0
1668053359645,CSE 219,A00,106111,Dow; Steven P,0,0,20,20
1668053360068,CSE 221,A00,102376,Voelker; Geoffrey M.,0,0,0,0
1668053360494,CSE 224,A01,102378,Porter; George M,0,0,0,0
1668053360925,CSE 229A,A00,102379,Savage; Stefan,0,0,0,0
1668053361348,CSE 229C,A00,102380,Munyaka; Imani N. S.,0,0,0,0
1668053361782,CSE 232B,A00,102382,Deutsch; Alin Bernard,0,0,0,0
1668053362209,CSE 234,A01,112904,Kumar; Arun Kumar,0,0,0,0
1668053362632,CSE 237A,A00,102383,Rosing; Tajana Simunic,0,0,0,0
1668053363058,CSE 239A,A00,102384,Deutsch; Alin Bernard,0,0,0,0
1668053363487,CSE 239B,A00,102385,Polikarpova; Nadezhda,0,0,0,0
1668053363923,CSE 240A,A00,102386,Pannuto; Patrick William,0,0,0,0
1668053364360,CSE 240B,A00,102387,Zhao; Jishen,0,0,0,0
1668053364783,CSE 241A,A00,106406,Kang; Mingu,0,0,0,0
1668053365206,CSE 249B,A00,102388,Kahng; Andrew Byun,0,0,8,8
1668053365628,CSE 251B,A01,102392,Cottrell; Garrison W,0,0,0,0
1668053365628,CSE 251B,A02,102393,Cottrell; Garrison W,0,0,0,0
1668053366051,CSE 252B,A00,102394,Ochoa; Benjamin Lawrence,0,0,0,0
1668053366478,CSE 257,A01,102396,Gao; Sicun,0,0,0,0
1668053366908,CSE 272,A00,102397,Li; Tzumao,0,0,0,0
1668053367335,CSE 274,A00,111323,Chern; Albert Ren-Haur,0,0,0,0
1668053367767,CSE 282,A00,102398,Pevzner; Pavel Arkadjevich,0,0,0,0
1668053368198,CSE 284,A00,114175,Gymrek; Melissa Ann,0,0,0,0
1668053368633,CSE 290,A00,102399,Chandraker; Manmohan Krishna,0,0,0,0
1668053368633,CSE 290,B00,102400,Vaccaro; Kristen Marie,0,0,25,25
1668053368633,CSE 290,C00,102414,Pannuto; Patrick William,0,0,25,25
1668053368633,CSE 290,D00,102427,Pevzner; Pavel Arkadjevich,0,0,0,0
1668053368633,CSE 290,E00,102429,Zhao; Jishen,0,0,0,0
1668053368633,CSE 290,F00,102436,Tullsen; Dean Michael,0,0,0,0
1668053368633,CSE 290,G00,102440,Christensen; Henrik I,0,0,20,20
1668053369059,CSE 291,A00,102443,Su; Hao,0,0,0,0
1668053369059,CSE 291,B00,102448,Polikarpova; Nadezhda,0,0,0,0
1668053369059,CSE 291,C00,102453,Vaccaro; Kristen Marie,0,0,0,0
1668053369059,CSE 291,D00,111343,Savage; Stefan,0,0,0,0
1668053369059,CSE 291,E00,116474,Claffy; Kimberly Claire,0,0,0,0
1668053369059,CSE 291,F00,116479,Pasquale; Joseph,0,0,0,0
1668053369488,CSE 293,001,119111,Bafna; Vineet,9999,0,9999,0
1668053369488,CSE 293,002,119118,Bellare; Mihir,9999,0,9999,0
1668053369488,CSE 293,003,119122,Berg-Kirkpatrick; Taylor D,9999,0,9999,0
1668053369488,CSE 293,004,119135,Christensen; Henrik I,9999,0,9999,0
1668053369488,CSE 293,005,119142,Cottrell; Garrison W,9999,0,9999,0
1668053369488,CSE 293,006,119146,Deutsch; Alin Bernard,9999,0,9999,0
1668053369488,CSE 293,007,119159,Esmaeilzadeh; Hadi,9999,0,9999,0
1668053369488,CSE 293,008,119166,Freund; Yoav,9999,0,9999,0
1668053369488,CSE 293,009,119170,Griswold; William G.,9999,0,9999,0
1668053369488,CSE 293,010,119183,Gymrek; Melissa Ann,9999,0,9999,0
1668053369488,CSE 293,011,119190,Heninger; Nadia A,9999,0,9999,0
1668053369488,CSE 293,012,119230,Impagliazzo; Russell,9999,0,9999,0
1668053369488,CSE 293,013,119232,Jhala; Ranjit,9999,0,9999,0
1668053369488,CSE 293,014,119233,Kahng; Andrew Byun,9999,0,9999,0
1668053369488,CSE 293,015,119298,Kane; Daniel Mertz,9999,0,9999,0
1668053369488,CSE 293,016,119299,Kriegman; David J,9999,0,9999,0
1668053369488,CSE 293,017,119300,Kumar; Arun Kumar,9999,0,9999,0
1668053369488,CSE 293,018,119301,Lerner; Sorin,9999,0,9999,0
1668053369488,CSE 293,019,119302,Lovett; Shachar,9999,0,9999,0
1668053369488,CSE 293,020,119303,McAuley; Julian John,9999,0,9999,0
1668053369488,CSE 293,021,119304,Micciancio; Daniele,9999,0,9999,0
1668053369488,CSE 293,022,119367,Orailoglu; Alex,9999,0,9999,0
1668053369488,CSE 293,023,119382,Paturi; Ramamohan,9999,0,9999,0
1668053369488,CSE 293,024,119404,Polikarpova; Nadezhda,9999,0,9999,0
1668053369488,CSE 293,025,119406,Politz; Joseph Gibbs,9999,0,9999,0
1668053369488,CSE 293,026,119411,Porter; George M,9999,0,9999,0
1668053369488,CSE 293,027,119414,Porter; Leonard Emerson,9999,0,9999,0
1668053369488,CSE 293,028,119416,Ramamoorthi; Ravi,9999,0,9999,0
1668053369488,CSE 293,029,119417,Sahoo; Debashis,9999,0,9999,0
1668053369488,CSE 293,030,119420,Saul; Lawrence,9999,0,9999,0
1668053369488,CSE 293,031,119421,Savage; Stefan,9999,0,9999,0
1668053369488,CSE 293,032,119425,Schulze; Jurgen P.,9999,0,9999,0
1668053369488,CSE 293,033,119426,Snoeren; Alex C.,9999,0,9999,0
1668053369488,CSE 293,034,119428,Shang; Jingbo,9999,0,9999,0
1668053369488,CSE 293,035,119430,Stefan; Deian,9999,0,9999,0
1668053369488,CSE 293,036,119431,Su; Hao,9999,0,9999,0
1668053369488,CSE 293,037,119433,Swanson; Steven James,9999,0,9999,0
1668053369488,CSE 293,038,119435,Tullsen; Dean Michael,9999,0,9999,0
1668053369488,CSE 293,039,119483,Voelker; Geoffrey M.,9999,0,9999,0
1668053369488,CSE 293,040,119537,Zhao; Jishen,9999,0,9999,0
1668053369488,CSE 293,041,119538,Zhou; Yuan-Yuan,9999,0,9999,0
1668053369488,CSE 293,042,119539,Gao; Sicun,9999,0,9999,0
1668053369488,CSE 293,043,119540,Weibel; Nadir,9999,0,9999,0
1668053369488,CSE 293,044,119541,Gupta; Rajesh K.,9999,0,9999,0
1668053369488,CSE 293,045,126410,Vaccaro; Kristen Marie,9999,0,9999,0
1668053369488,CSE 293,046,126411,Klemke; Richard,9999,0,9999,0
1668053369915,CSE 294,A00,102459,Voelker; Geoffrey M.,0,0,0,0
1668053369915,CSE 294,B00,111322,Orailoglu; Alex,0,0,0,0
1668053370344,DSE 201,A00,096914,Deutsch; Alin Bernard,30,0,30,0
1668053370767,DSE 210,A00,096915,Dasgupta; Sanjoy,30,0,30,0
1668053371199,DSE 260A,A00,096916,Altintas De Callaf; Ilkay,30,0,30,0
1668053371638,ECE 200,001,103586,Antipa; Nicholas A,9999,0,9999,0
1668053371638,ECE 200,002,103587,Atanasov; Nikolay A.,9999,0,9999,0
1668053371638,ECE 200,003,103588,Bharadia; Dinesh,9999,0,9999,0
1668053371638,ECE 200,004,103589,Cheng; Chung Kuan,9999,0,9999,0
1668053371638,ECE 200,005,103590,Cosman; Pamela C.,9999,0,9999,0
1668053371638,ECE 200,006,103591,Dayeh; Shadi Ahmad,9999,0,9999,0
1668053371638,ECE 200,007,103592,Fainman; Yeshaiahu,9999,0,9999,0
1668053371638,ECE 200,008,103593,Ford; Joseph Earl,9999,0,9999,0
1668053371638,ECE 200,009,103594,Franceschetti; Massimo,9999,0,9999,0
1668053371638,ECE 200,010,103595,Fullerton; Eric E,9999,0,9999,0
1668053371638,ECE 200,011,103596,Galton; Ian A,9999,0,9999,0
1668053371638,ECE 200,012,103597,Gilja; Vikash,9999,0,9999,0
1668053371638,ECE 200,013,103598,Hall; Drew A.,9999,0,9999,0
1668053371638,ECE 200,014,103599,Hsueh; Tzu-Chien,9999,0,9999,0
1668053371638,ECE 200,015,103600,Javidi; Tara,9999,0,9999,0
1668053371638,ECE 200,016,103601,Kahng; Andrew Byun,9999,0,9999,0
1668053371638,ECE 200,017,103602,Kim; Young-Han,9999,0,9999,0
1668053371638,ECE 200,018,103603,Koushanfar; Farinaz,9999,0,9999,0
1668053371638,ECE 200,019,103604,Kuzum; Duygu,9999,0,9999,0
1668053371638,ECE 200,020,103605,Le; Hanh-Phuc,9999,0,9999,0
1668053371638,ECE 200,021,103606,Lin; Bill,9999,0,9999,0
1668053371638,ECE 200,022,103607,Liu; Zhaowei,9998,0,9999,1
1668053371638,ECE 200,023,103608,Lo; Yu-Hwa,9999,0,9999,0
1668053371638,ECE 200,024,103609,Lomakin; Vitaliy,9999,0,9999,0
1668053371638,ECE 200,025,103610,Mercier; Patrick Philip,9999,0,9999,0
1668053371638,ECE 200,026,103611,Meyer; Florian,9999,0,9999,0
1668053371638,ECE 200,027,103612,Milstein; Laurence B.,9999,0,9999,0
1668053371638,ECE 200,028,103613,Mir Arabbaygi; Siavash,9999,0,9999,0
1668053371638,ECE 200,029,103614,Mookherjea; Shayan,9999,0,9999,0
1668053371638,ECE 200,030,103615,Morris; Karcher William,9999,0,9999,0
1668053371638,ECE 200,031,103616,Ng; Tse Nga,9999,0,9999,0
1668053371638,ECE 200,032,103617,Nguyen; Truong Quang,9999,0,9999,0
1668053371638,ECE 200,033,103618,Nomura; Kenji,9999,0,9999,0
1668053371638,ECE 200,034,103619,Orlitsky; Alon,9999,0,9999,0
1668053371638,ECE 200,035,103620,Pal; Piya,9999,0,9999,0
1668053371638,ECE 200,036,103621,Papen; George C.,9999,0,9999,0
1668053371638,ECE 200,037,103622,Radic; Stojan,9999,0,9999,0
1668053371638,ECE 200,038,103623,Rao; Bhaskar D.,9999,0,9999,0
1668053371638,ECE 200,039,103624,Rao; Ramesh R,9999,0,9999,0
1668053371638,ECE 200,040,103625,Rebeiz; Gabriel,9999,0,9999,0
1668053371638,ECE 200,041,103626,Sanford; John R,9999,0,9999,0
1668053371638,ECE 200,042,103627,Siegel; Paul H.,9999,0,9999,0
1668053371638,ECE 200,043,103628,Sievenpiper; Daniel F.,9999,0,9999,0
1668053371638,ECE 200,044,103629,Sworder; David D.,9999,0,9999,0
1668053371638,ECE 200,045,103630,Taur; Yuan,9999,0,9999,0
1668053371638,ECE 200,046,103631,Touri; Behrouz,9999,0,9999,0
1668053371638,ECE 200,047,103632,Trivedi; Mohan M.,9999,0,9999,0
1668053371638,ECE 200,048,103633,Vasconcelos; Nuno,9999,0,9999,0
1668053371638,ECE 200,049,103634,Wang; Xiaolong,9999,0,9999,0
1668053371638,ECE 200,050,103635,Xie; Pengtao,9999,0,9999,0
1668053371638,ECE 200,051,103636,Yip; Michael,9999,0,9999,0
1668053371638,ECE 200,052,103637,Zeger; Kenneth A.,999,0,999,0
1668053371638,ECE 200,053,103638,Zhang; Xinyu,9999,0,9999,0
1668053371638,ECE 200,054,103639,Turakhia; Yatish Girish,9999,0,9999,0
1668053371638,ECE 200,055,103640,Kang; Mingu,9999,0,9999,0
1668053371638,ECE 200,056,103641,Shi; Yuanyuan,9999,0,9999,0
1668053371638,ECE 200,057,103642,Wang; Edward Jay,9999,0,9999,0
1668053371638,ECE 200,058,103643,Zheng; Yang,9999,0,9999,0
1668053372078,ECE 202,A00,103644,Kuzum; Duygu,0,0,0,0
1668053372508,ECE 212BN,A00,103646,Ng; Tse Nga,0,0,0,0
1668053372954,ECE 221,A00,111493,Staff,0,0,0,0
1668053373388,ECE 222B,A00,103647,Lomakin; Vitaliy,0,0,0,0
1668053373838,ECE 230B,A00,103648,Taur; Yuan,0,0,0,0
1668053374266,ECE 238B,A00,103649,Garay; Javier,0,0,0,0
1668053374693,ECE 240B,A00,112900,Fainman; Yeshaiahu,0,0,0,0
1668053375130,ECE 247A,A00,103650,Jokerst; Jesse Vincent,0,0,0,0
1668053375569,ECE 247B,A00,103651,Wang; Joseph,0,0,0,0
1668053376002,ECE 250,A00,103652,Siegel; Paul H.,0,0,0,0
1668053376426,ECE 251A,A00,103654,Rao; Bhaskar D.,0,0,0,0
1668053376856,ECE 257B,A00,103655,Bharadia; Dinesh,0,0,0,0
1668053377282,ECE 258A,A00,103656,Milstein; Laurence B.,0,0,0,0
1668053377719,ECE 260B,A00,103658,Kang; Mingu,0,0,0,0
1668053378160,ECE 264A,A00,103659,Galton; Ian A,0,0,0,0
1668053378586,ECE 265A,A00,103661,Gudem; Prasad S.S.,0,0,0,0
1668053379014,ECE 265D,A00,103662,Gudem; Prasad S.S.,0,0,0,0
1668053379441,ECE 268,A00,103663,Koushanfar; Farinaz,0,0,0,0
1668053379873,ECE 269,A01,103665,Pal; Piya,0,0,0,0
1668053380298,ECE 271B,A00,103666,Vasconcelos; Manuela,0,0,0,0
1668053380721,ECE 276A,A00,103667,Atanasov; Nikolay A.,0,0,0,0
1668053381146,ECE 277,A00,103668,An; Cheolhong,0,0,0,0
1668053381573,ECE 279,A00,117947,Hall; Drew A.,0,0,0,0
1668053382423,ECE 283,A00,103670,Hsueh; Tzu-Chien,0,0,0,0
1668053382848,ECE 284,A00,103671,Turakhia; Yatish Girish,0,0,0,0
1668053383273,ECE 285,A00,103672,Zheng; Yang,0,0,0,0
1668053383273,ECE 285,B00,103673,Sworder; David D.,0,0,0,0
1668053383695,ECE 287,A00,103676,Javidi; Tara,0,0,0,0
1668053384119,MATH 200B,A00,098023,Salehi Golsefidy; Alireza,13,0,15,2
1668053384549,MATH 202B,A00,098024,Rhoades; Brendon Patrick,9,0,15,6
1668053384973,MATH 203B,A00,098025,Oprea; Dragos N.,11,0,15,4
1668053385410,MATH 204B,A00,098026,Sorensen; Claus M,13,0,15,2
1668053385834,MATH 208,A00,098027,Izadi; Elham,7,0,10,3
1668053386257,MATH 209,A00,098028,Pollack; Aaron,10,0,10,0
1668053386694,MATH 211A,A00,112919,Rogalski; Daniel,9,0,10,1
1668053387119,MATH 211B,A00,112920,Seward; Brandon M.,9,0,10,1
1668053387547,MATH 218,A00,098029,Li; Bo,10,0,10,0
1668053387970,MATH 220B,A00,098030,Novak; Jonathan I,13,0,15,2
1668053388396,MATH 221A,A00,098031,Ebenfelt; Peter F,13,0,15,2
1668053388825,MATH 231B,A00,098032,Zlatos; Andrej,12,0,15,3
1668053389250,MATH 240B,A00,098033,Ni; Lei,9,0,15,6
1668053389769,MATH 243,A00,098034,Jekel; David Andrew,10,0,10,0
1668053390198,MATH 245A,A00,098035,Nie; Jiawang,0,0,15,16
1668053390633,MATH 248,A00,098036,Bejenaru; Ioan,10,0,10,0
1668053391057,MATH 250B,A00,098037,Spolaor; Luca,14,0,15,1
1668053391488,MATH 258,A00,098038,Ni; Lei,10,0,10,0
1668053391919,MATH 264B,A00,098041,Rhoades; Brendon Patrick,10,0,15,5
1668053392357,MATH 268,A00,098042,Buss; Samuel R,10,0,10,0
1668053392788,MATH 269,A00,098043,Rhoades; Brendon Patrick,10,0,10,0
1668053393216,MATH 270B,A00,098044,Li; Bo,11,0,15,4
1668053393638,MATH 272B,A00,098045,Holst; Michael J,13,0,15,2
1668053394062,MATH 273A,A00,098046,Tian; Xiaochuan,10,0,15,5
1668053394485,MATH 275,A01,098048,Tian; Xiaochuan,6,0,10,4
1668053394910,MATH 278A,A00,098049,Holst; Michael J,8,0,10,2
1668053395335,MATH 278B,A00,098050,Cloninger; Alexander,10,0,10,0
1668053395760,MATH 278C,A00,098051,Nie; Jiawang,7,0,10,3
1668053396185,MATH 280B,A00,098052,Zheng; Tianyi,10,0,15,5
1668053396613,MATH 281B,A00,098053,Bradic; Jelena,3,0,15,12
1668053397037,MATH 282B,A00,098054,Arias-Castro; Ery,0,0,15,15
1668053397459,MATH 285,A00,098055,Fitzsimmons; Patrick J,0,0,15,17
1668053397889,MATH 287B,A00,098056,Arias-Castro; Ery,3,0,15,12
1668053398316,MATH 288,A00,098057,Agarwal; Pooja,9,0,10,1
1668053398316,MATH 288,B00,098058,Zhang; Danna,8,0,10,2
1668053398316,MATH 288,C00,098059,Williams; Ruth J,10,0,10,0
1668053398751,MATH 290B,A00,098060,Roberts; Justin Deritter,13,0,15,2
1668053399176,MATH 292,A00,098061,Belmont; Eva Kinoshita,10,0,10,0
1668053399611,MATH 295,A00,098062,Suk; Andrew Hoon,48,0,50,2
1668053400048,MATH 296,A00,098063,Novak; Jonathan I,20,0,20,0
1668053400829,MATH 297,001,098064,Gamst; Anthony Collins,9997,0,9999,2
1668053902932,COGS 205,A00,101395,Chiba; Andrea,19,0,20,1
1668053903368,COGS 210B,001,101404,Greene; Deanna Jacquelyn,9998,0,9999,1
1668053903368,COGS 210B,002,101417,Xia; Haijun,9999,0,9999,0
1668053903368,COGS 210B,003,101422,Nitz; Douglas A.,9999,0,9999,0
1668053903368,COGS 210B,004,101423,Hollan; James D.,9998,0,9999,1
1668053903368,COGS 210B,005,101424,Deak; Gedeon O.,9998,0,9999,1
1668053903368,COGS 210B,006,101425,Rossano; Federico,9999,0,9999,0
1668053903807,COGS 211B,A00,101427,Coulson; Seana M,9996,0,9999,3
1668053904236,COGS 220,A00,101428,Hollan; James D.,0,0,25,25
1668053904663,COGS 229,A00,101429,Dow; Steven P,18,0,25,7
1668053905102,COGS 230,A00,101430,Klemmer; Scott R,13,0,17,4
1668053905526,COGS 234,A00,101431,Xia; Haijun,4,0,25,21
1668053905949,COGS 260,A00,101432,Kiyonaga; Anastasia,19,0,25,6
1668053905949,COGS 260,B00,101433,Kirsh; David Joel,16,0,25,9
1668053906372,CSE 202,A00,102371,Impagliazzo; Russell,0,0,0,0
1668053906809,CSE 203B,A01,102373,Cheng; Chung Kuan,0,0,0,0
1668053907234,CSE 208,A00,102374,Micciancio; Daniele,0,0,0,0
1668053907657,CSE 209A,A00,112895,Impagliazzo; Russell,0,0,15,15
1668053908082,CSE 209B,A00,108005,Bellare; Mihir,0,0,0,0
1668053908505,CSE 210,A00,113163,Coblenz; Michael J,0,0,0,0
1668053908928,CSE 219,A00,106111,Dow; Steven P,0,0,20,20
1668053909352,CSE 221,A00,102376,Voelker; Geoffrey M.,0,0,0,0
1668053909781,CSE 224,A01,102378,Porter; George M,0,0,0,0
1668053910217,CSE 229A,A00,102379,Savage; Stefan,0,0,0,0
1668053910642,CSE 229C,A00,102380,Munyaka; Imani N. S.,0,0,0,0
1668053911064,CSE 232B,A00,102382,Deutsch; Alin Bernard,0,0,0,0
1668053911491,CSE 234,A01,112904,Kumar; Arun Kumar,0,0,0,0
1668053911918,CSE 237A,A00,102383,Rosing; Tajana Simunic,0,0,0,0
1668053912436,CSE 239A,A00,102384,Deutsch; Alin Bernard,0,0,0,0
1668053912863,CSE 239B,A00,102385,Polikarpova; Nadezhda,0,0,0,0
1668053913293,CSE 240A,A00,102386,Pannuto; Patrick William,0,0,0,0
1668053913717,CSE 240B,A00,102387,Zhao; Jishen,0,0,0,0
1668053914154,CSE 241A,A00,106406,Kang; Mingu,0,0,0,0
1668053914579,CSE 249B,A00,102388,Kahng; Andrew Byun,0,0,8,8
1668053915018,CSE 251B,A01,102392,Cottrell; Garrison W,0,0,0,0
1668053915018,CSE 251B,A02,102393,Cottrell; Garrison W,0,0,0,0
1668053915446,CSE 252B,A00,102394,Ochoa; Benjamin Lawrence,0,0,0,0
1668053915872,CSE 257,A01,102396,Gao; Sicun,0,0,0,0
1668053916301,CSE 272,A00,102397,Li; Tzumao,0,0,0,0
1668053916725,CSE 274,A00,111323,Chern; Albert Ren-Haur,0,0,0,0
1668053917149,CSE 282,A00,102398,Pevzner; Pavel Arkadjevich,0,0,0,0
1668053917574,CSE 284,A00,114175,Gymrek; Melissa Ann,0,0,0,0
1668053917998,CSE 290,A00,102399,Chandraker; Manmohan Krishna,0,0,0,0
1668053917998,CSE 290,B00,102400,Vaccaro; Kristen Marie,0,0,25,25
1668053917998,CSE 290,C00,102414,Pannuto; Patrick William,0,0,25,25
1668053917998,CSE 290,D00,102427,Pevzner; Pavel Arkadjevich,0,0,0,0
1668053917998,CSE 290,E00,102429,Zhao; Jishen,0,0,0,0
1668053917998,CSE 290,F00,102436,Tullsen; Dean Michael,0,0,0,0
1668053917998,CSE 290,G00,102440,Christensen; Henrik I,0,0,20,20
1668053918428,CSE 291,A00,102443,Su; Hao,0,0,0,0
1668053918428,CSE 291,B00,102448,Polikarpova; Nadezhda,0,0,0,0
1668053918428,CSE 291,C00,102453,Vaccaro; Kristen Marie,0,0,0,0
1668053918428,CSE 291,D00,111343,Savage; Stefan,0,0,0,0
1668053918428,CSE 291,E00,116474,Claffy; Kimberly Claire,0,0,0,0
1668053918428,CSE 291,F00,116479,Pasquale; Joseph,0,0,0,0
1668053918854,CSE 293,001,119111,Bafna; Vineet,9999,0,9999,0
1668053918854,CSE 293,002,119118,Bellare; Mihir,9999,0,9999,0
1668053918854,CSE 293,003,119122,Berg-Kirkpatrick; Taylor D,9999,0,9999,0
1668053918854,CSE 293,004,119135,Christensen; Henrik I,9999,0,9999,0
1668053918854,CSE 293,005,119142,Cottrell; Garrison W,9999,0,9999,0
1668053918854,CSE 293,006,119146,Deutsch; Alin Bernard,9999,0,9999,0
1668053918854,CSE 293,007,119159,Esmaeilzadeh; Hadi,9999,0,9999,0
1668053918854,CSE 293,008,119166,Freund; Yoav,9999,0,9999,0
1668053918854,CSE 293,009,119170,Griswold; William G.,9999,0,9999,0
1668053918854,CSE 293,010,119183,Gymrek; Melissa Ann,9999,0,9999,0
1668053918854,CSE 293,011,119190,Heninger; Nadia A,9999,0,9999,0
1668053918854,CSE 293,012,119230,Impagliazzo; Russell,9999,0,9999,0
1668053918854,CSE 293,013,119232,Jhala; Ranjit,9999,0,9999,0
1668053918854,CSE 293,014,119233,Kahng; Andrew Byun,9999,0,9999,0
1668053918854,CSE 293,015,119298,Kane; Daniel Mertz,9999,0,9999,0
1668053918854,CSE 293,016,119299,Kriegman; David J,9999,0,9999,0
1668053918854,CSE 293,017,119300,Kumar; Arun Kumar,9999,0,9999,0
1668053918854,CSE 293,018,119301,Lerner; Sorin,9999,0,9999,0
1668053918854,CSE 293,019,119302,Lovett; Shachar,9999,0,9999,0
1668053918854,CSE 293,020,119303,McAuley; Julian John,9999,0,9999,0
1668053918854,CSE 293,021,119304,Micciancio; Daniele,9999,0,9999,0
1668053918854,CSE 293,022,119367,Orailoglu; Alex,9999,0,9999,0
1668053918854,CSE 293,023,119382,Paturi; Ramamohan,9999,0,9999,0
1668053918854,CSE 293,024,119404,Polikarpova; Nadezhda,9999,0,9999,0
1668053918854,CSE 293,025,119406,Politz; Joseph Gibbs,9999,0,9999,0
1668053918854,CSE 293,026,119411,Porter; George M,9999,0,9999,0
1668053918854,CSE 293,027,119414,Porter; Leonard Emerson,9999,0,9999,0
1668053918854,CSE 293,028,119416,Ramamoorthi; Ravi,9999,0,9999,0
1668053918854,CSE 293,029,119417,Sahoo; Debashis,9999,0,9999,0
1668053918854,CSE 293,030,119420,Saul; Lawrence,9999,0,9999,0
1668053918854,CSE 293,031,119421,Savage; Stefan,9999,0,9999,0
1668053918854,CSE 293,032,119425,Schulze; Jurgen P.,9999,0,9999,0
1668053918854,CSE 293,033,119426,Snoeren; Alex C.,9999,0,9999,0
1668053918854,CSE 293,034,119428,Shang; Jingbo,9999,0,9999,0
1668053918854,CSE 293,035,119430,Stefan; Deian,9999,0,9999,0
1668053918854,CSE 293,036,119431,Su; Hao,9999,0,9999,0
1668053918854,CSE 293,037,119433,Swanson; Steven James,9999,0,9999,0
1668053918854,CSE 293,038,119435,Tullsen; Dean Michael,9999,0,9999,0
1668053918854,CSE 293,039,119483,Voelker; Geoffrey M.,9999,0,9999,0
1668053918854,CSE 293,040,119537,Zhao; Jishen,9999,0,9999,0
1668053918854,CSE 293,041,119538,Zhou; Yuan-Yuan,9999,0,9999,0
1668053918854,CSE 293,042,119539,Gao; Sicun,9999,0,9999,0
1668053918854,CSE 293,043,119540,Weibel; Nadir,9999,0,9999,0
1668053918854,CSE 293,044,119541,Gupta; Rajesh K.,9999,0,9999,0
1668053918854,CSE 293,045,126410,Vaccaro; Kristen Marie,9999,0,9999,0
1668053918854,CSE 293,046,126411,Klemke; Richard,9999,0,9999,0
1668053919278,CSE 294,A00,102459,Voelker; Geoffrey M.,0,0,0,0
1668053919278,CSE 294,B00,111322,Orailoglu; Alex,0,0,0,0
1668053919704,DSE 201,A00,096914,Deutsch; Alin Bernard,30,0,30,0
1668053920141,DSE 210,A00,096915,Dasgupta; Sanjoy,30,0,30,0
1668053920567,DSE 260A,A00,096916,Altintas De Callaf; Ilkay,30,0,30,0
1668053921005,ECE 200,001,103586,Antipa; Nicholas A,9999,0,9999,0
1668053921005,ECE 200,002,103587,Atanasov; Nikolay A.,9999,0,9999,0
1668053921005,ECE 200,003,103588,Bharadia; Dinesh,9999,0,9999,0
1668053921005,ECE 200,004,103589,Cheng; Chung Kuan,9999,0,9999,0
1668053921005,ECE 200,005,103590,Cosman; Pamela C.,9999,0,9999,0
1668053921005,ECE 200,006,103591,Dayeh; Shadi Ahmad,9999,0,9999,0
1668053921005,ECE 200,007,103592,Fainman; Yeshaiahu,9999,0,9999,0
1668053921005,ECE 200,008,103593,Ford; Joseph Earl,9999,0,9999,0
1668053921005,ECE 200,009,103594,Franceschetti; Massimo,9999,0,9999,0
1668053921005,ECE 200,010,103595,Fullerton; Eric E,9999,0,9999,0
1668053921005,ECE 200,011,103596,Galton; Ian A,9999,0,9999,0
1668053921005,ECE 200,012,103597,Gilja; Vikash,9999,0,9999,0
1668053921005,ECE 200,013,103598,Hall; Drew A.,9999,0,9999,0
1668053921005,ECE 200,014,103599,Hsueh; Tzu-Chien,9999,0,9999,0
1668053921005,ECE 200,015,103600,Javidi; Tara,9999,0,9999,0
1668053921005,ECE 200,016,103601,Kahng; Andrew Byun,9999,0,9999,0
1668053921005,ECE 200,017,103602,Kim; Young-Han,9999,0,9999,0
1668053921005,ECE 200,018,103603,Koushanfar; Farinaz,9999,0,9999,0
1668053921005,ECE 200,019,103604,Kuzum; Duygu,9999,0,9999,0
1668053921005,ECE 200,020,103605,Le; Hanh-Phuc,9999,0,9999,0
1668053921005,ECE 200,021,103606,Lin; Bill,9999,0,9999,0
1668053921005,ECE 200,022,103607,Liu; Zhaowei,9998,0,9999,1
1668053921005,ECE 200,023,103608,Lo; Yu-Hwa,9999,0,9999,0
1668053921005,ECE 200,024,103609,Lomakin; Vitaliy,9999,0,9999,0
1668053921005,ECE 200,025,103610,Mercier; Patrick Philip,9999,0,9999,0
1668053921005,ECE 200,026,103611,Meyer; Florian,9999,0,9999,0
1668053921005,ECE 200,027,103612,Milstein; Laurence B.,9999,0,9999,0
1668053921005,ECE 200,028,103613,Mir Arabbaygi; Siavash,9999,0,9999,0
1668053921005,ECE 200,029,103614,Mookherjea; Shayan,9999,0,9999,0
1668053921005,ECE 200,030,103615,Morris; Karcher William,9999,0,9999,0
1668053921005,ECE 200,031,103616,Ng; Tse Nga,9999,0,9999,0
1668053921005,ECE 200,032,103617,Nguyen; Truong Quang,9999,0,9999,0
1668053921005,ECE 200,033,103618,Nomura; Kenji,9999,0,9999,0
1668053921005,ECE 200,034,103619,Orlitsky; Alon,9999,0,9999,0
1668053921005,ECE 200,035,103620,Pal; Piya,9999,0,9999,0
1668053921005,ECE 200,036,103621,Papen; George C.,9999,0,9999,0
1668053921005,ECE 200,037,103622,Radic; Stojan,9999,0,9999,0
1668053921005,ECE 200,038,103623,Rao; Bhaskar D.,9999,0,9999,0
1668053921005,ECE 200,039,103624,Rao; Ramesh R,9999,0,9999,0
1668053921005,ECE 200,040,103625,Rebeiz; Gabriel,9999,0,9999,0
1668053921005,ECE 200,041,103626,Sanford; John R,9999,0,9999,0
1668053921005,ECE 200,042,103627,Siegel; Paul H.,9999,0,9999,0
1668053921005,ECE 200,043,103628,Sievenpiper; Daniel F.,9999,0,9999,0
1668053921005,ECE 200,044,103629,Sworder; David D.,9999,0,9999,0
1668053921005,ECE 200,045,103630,Taur; Yuan,9999,0,9999,0
1668053921005,ECE 200,046,103631,Touri; Behrouz,9999,0,9999,0
1668053921005,ECE 200,047,103632,Trivedi; Mohan M.,9999,0,9999,0
1668053921005,ECE 200,048,103633,Vasconcelos; Nuno,9999,0,9999,0
1668053921005,ECE 200,049,103634,Wang; Xiaolong,9999,0,9999,0
1668053921005,ECE 200,050,103635,Xie; Pengtao,9999,0,9999,0
1668053921005,ECE 200,051,103636,Yip; Michael,9999,0,9999,0
1668053921005,ECE 200,052,103637,Zeger; Kenneth A.,999,0,999,0
1668053921005,ECE 200,053,103638,Zhang; Xinyu,9999,0,9999,0
1668053921005,ECE 200,054,103639,Turakhia; Yatish Girish,9999,0,9999,0
1668053921005,ECE 200,055,103640,Kang; Mingu,9999,0,9999,0
1668053921005,ECE 200,056,103641,Shi; Yuanyuan,9999,0,9999,0
1668053921005,ECE 200,057,103642,Wang; Edward Jay,9999,0,9999,0
1668053921005,ECE 200,058,103643,Zheng; Yang,9999,0,9999,0
1668053921431,ECE 202,A00,103644,Kuzum; Duygu,0,0,0,0
1668053921864,ECE 212BN,A00,103646,Ng; Tse Nga,0,0,0,0
1668053922298,ECE 221,A00,111493,Staff,0,0,0,0
1668053922725,ECE 222B,A00,103647,Lomakin; Vitaliy,0,0,0,0
1668053923160,ECE 230B,A00,103648,Taur; Yuan,0,0,0,0
1668053923591,ECE 238B,A00,103649,Garay; Javier,0,0,0,0
1668053924015,ECE 240B,A00,112900,Fainman; Yeshaiahu,0,0,0,0
1668053924453,ECE 247A,A00,103650,Jokerst; Jesse Vincent,0,0,0,0
1668053924876,ECE 247B,A00,103651,Wang; Joseph,0,0,0,0
1668053925311,ECE 250,A00,103652,Siegel; Paul H.,0,0,0,0
1668053925743,ECE 251A,A00,103654,Rao; Bhaskar D.,0,0,0,0
1668053926184,ECE 257B,A00,103655,Bharadia; Dinesh,0,0,0,0
1668053926616,ECE 258A,A00,103656,Milstein; Laurence B.,0,0,0,0
1668053927040,ECE 260B,A00,103658,Kang; Mingu,0,0,0,0
1668053927470,ECE 264A,A00,103659,Galton; Ian A,0,0,0,0
1668053927893,ECE 265A,A00,103661,Gudem; Prasad S.S.,0,0,0,0
1668053928319,ECE 265D,A00,103662,Gudem; Prasad S.S.,0,0,0,0
1668053928745,ECE 268,A00,103663,Koushanfar; Farinaz,0,0,0,0
1668053929172,ECE 269,A01,103665,Pal; Piya,0,0,0,0
1668053929602,ECE 271B,A00,103666,Vasconcelos; Manuela,0,0,0,0
1668053930029,ECE 276A,A00,103667,Atanasov; Nikolay A.,0,0,0,0
1668053930455,ECE 277,A00,103668,An; Cheolhong,0,0,0,0
1668053930893,ECE 279,A00,117947,Hall; Drew A.,0,0,0,0
1668053931753,ECE 283,A00,103670,Hsueh; Tzu-Chien,0,0,0,0
1668053932177,ECE 284,A00,103671,Turakhia; Yatish Girish,0,0,0,0
1668053932600,ECE 285,A00,103672,Zheng; Yang,0,0,0,0
1668053932600,ECE 285,B00,103673,Sworder; David D.,0,0,0,0
1668053933031,ECE 287,A00,103676,Javidi; Tara,0,0,0,0
1668053933461,MATH 200B,A00,098023,Salehi Golsefidy; Alireza,13,0,15,2
1668053933898,MATH 202B,A00,098024,Rhoades; Brendon Patrick,9,0,15,6
1668053934323,MATH 203B,A00,098025,Oprea; Dragos N.,11,0,15,4
1668053934755,MATH 204B,A00,098026,Sorensen; Claus M,13,0,15,2
1668053935178,MATH 208,A00,098027,Izadi; Elham,7,0,10,3
1668053935605,MATH 209,A00,098028,Pollack; Aaron,10,0,10,0
1668053936044,MATH 211A,A00,112919,Rogalski; Daniel,9,0,10,1
1668053936481,MATH 211B,A00,112920,Seward; Brandon M.,9,0,10,1
1668053936910,MATH 218,A00,098029,Li; Bo,10,0,10,0
1668053937342,MATH 220B,A00,098030,Novak; Jonathan I,13,0,15,2
1668053937778,MATH 221A,A00,098031,Ebenfelt; Peter F,13,0,15,2
1668053938202,MATH 231B,A00,098032,Zlatos; Andrej,12,0,15,3
1668053938638,MATH 240B,A00,098033,Ni; Lei,9,0,15,6
1668053939062,MATH 243,A00,098034,Jekel; David Andrew,10,0,10,0
1668053939488,MATH 245A,A00,098035,Nie; Jiawang,0,0,15,16
1668053939911,MATH 248,A00,098036,Bejenaru; Ioan,10,0,10,0
1668053940341,MATH 250B,A00,098037,Spolaor; Luca,14,0,15,1
1668053940762,MATH 258,A00,098038,Ni; Lei,10,0,10,0
1668053941189,MATH 264B,A00,098041,Rhoades; Brendon Patrick,10,0,15,5
1668053941613,MATH 268,A00,098042,Buss; Samuel R,10,0,10,0
1668053942037,MATH 269,A00,098043,Rhoades; Brendon Patrick,10,0,10,0
1668053942460,MATH 270B,A00,098044,Li; Bo,11,0,15,4
1668053942884,MATH 272B,A00,098045,Holst; Michael J,13,0,15,2
1668053943313,MATH 273A,A00,098046,Tian; Xiaochuan,10,0,15,5
1668053943744,MATH 275,A01,098048,Tian; Xiaochuan,6,0,10,4
1668053944177,MATH 278A,A00,098049,Holst; Michael J,8,0,10,2
1668053944609,MATH 278B,A00,098050,Cloninger; Alexander,10,0,10,0
1668053945038,MATH 278C,A00,098051,Nie; Jiawang,7,0,10,3
1668053945463,MATH 280B,A00,098052,Zheng; Tianyi,10,0,15,5
1668053945889,MATH 281B,A00,098053,Bradic; Jelena,3,0,15,12
1668053946321,MATH 282B,A00,098054,Arias-Castro; Ery,0,0,15,15
1668053946753,MATH 285,A00,098055,Fitzsimmons; Patrick J,0,0,15,17
1668053947182,MATH 287B,A00,098056,Arias-Castro; Ery,3,0,15,12
1668053947609,MATH 288,A00,098057,Agarwal; Pooja,9,0,10,1
1668053947609,MATH 288,B00,098058,Zhang; Danna,8,0,10,2
1668053947609,MATH 288,C00,098059,Williams; Ruth J,10,0,10,0
1668053948032,MATH 290B,A00,098060,Roberts; Justin Deritter,13,0,15,2
1668053948468,MATH 292,A00,098061,Belmont; Eva Kinoshita,10,0,10,0
1668053948894,MATH 295,A00,098062,Suk; Andrew Hoon,48,0,50,2
1668053949319,MATH 296,A00,098063,Novak; Jonathan I,20,0,20,0
1668053949745,MATH 297,001,098064,Gamst; Anthony Collins,9997,0,9999,2
1668054463329,COGS 205,A00,101395,Chiba; Andrea,19,0,20,1
1668054463785,COGS 210B,001,101404,Greene; Deanna Jacquelyn,9998,0,9999,1
1668054463785,COGS 210B,002,101417,Xia; Haijun,9999,0,9999,0
1668054463785,COGS 210B,003,101422,Nitz; Douglas A.,9999,0,9999,0
1668054463785,COGS 210B,004,101423,Hollan; James D.,9998,0,9999,1
1668054463785,COGS 210B,005,101424,Deak; Gedeon O.,9998,0,9999,1
1668054463785,COGS 210B,006,101425,Rossano; Federico,9999,0,9999,0
1668054464209,COGS 211B,A00,101427,Coulson; Seana M,9996,0,9999,3
1668054464633,COGS 220,A00,101428,Hollan; James D.,0,0,25,25
1668054465058,COGS 229,A00,101429,Dow; Steven P,18,0,25,7
1668054465487,COGS 230,A00,101430,Klemmer; Scott R,13,0,17,4
1668054465920,COGS 234,A00,101431,Xia; Haijun,4,0,25,21
1668054466343,COGS 260,A00,101432,Kiyonaga; Anastasia,19,0,25,6
1668054466343,COGS 260,B00,101433,Kirsh; David Joel,16,0,25,9
1668054466771,CSE 202,A00,102371,Impagliazzo; Russell,0,0,0,0
1668054467205,CSE 203B,A01,102373,Cheng; Chung Kuan,0,0,0,0
1668054467641,CSE 208,A00,102374,Micciancio; Daniele,0,0,0,0
1668054468076,CSE 209A,A00,112895,Impagliazzo; Russell,0,0,15,15
1668054468503,CSE 209B,A00,108005,Bellare; Mihir,0,0,0,0
1668054468933,CSE 210,A00,113163,Coblenz; Michael J,0,0,0,0
1668054469369,CSE 219,A00,106111,Dow; Steven P,0,0,20,20
1668054469807,CSE 221,A00,102376,Voelker; Geoffrey M.,0,0,0,0
1668054470231,CSE 224,A01,102378,Porter; George M,0,0,0,0
1668054470659,CSE 229A,A00,102379,Savage; Stefan,0,0,0,0
1668054471083,CSE 229C,A00,102380,Munyaka; Imani N. S.,0,0,0,0
1668054471507,CSE 232B,A00,102382,Deutsch; Alin Bernard,0,0,0,0
1668054471935,CSE 234,A01,112904,Kumar; Arun Kumar,0,0,0,0
1668054472394,CSE 237A,A00,102383,Rosing; Tajana Simunic,0,0,0,0
1668054472833,CSE 239A,A00,102384,Deutsch; Alin Bernard,0,0,0,0
1668054473275,CSE 239B,A00,102385,Polikarpova; Nadezhda,0,0,0,0
1668054473698,CSE 240A,A00,102386,Pannuto; Patrick William,0,0,0,0
1668054474134,CSE 240B,A00,102387,Zhao; Jishen,0,0,0,0
1668054474558,CSE 241A,A00,106406,Kang; Mingu,0,0,0,0
1668054474980,CSE 249B,A00,102388,Kahng; Andrew Byun,0,0,8,8
1668054475404,CSE 251B,A01,102392,Cottrell; Garrison W,0,0,0,0
1668054475404,CSE 251B,A02,102393,Cottrell; Garrison W,0,0,0,0
1668054475831,CSE 252B,A00,102394,Ochoa; Benjamin Lawrence,0,0,0,0
1668054476253,CSE 257,A01,102396,Gao; Sicun,0,0,0,0
1668054476683,CSE 272,A00,102397,Li; Tzumao,0,0,0,0
1668054477110,CSE 274,A00,111323,Chern; Albert Ren-Haur,0,0,0,0
1668054477536,CSE 282,A00,102398,Pevzner; Pavel Arkadjevich,0,0,0,0
1668054477963,CSE 284,A00,114175,Gymrek; Melissa Ann,0,0,0,0
1668054478389,CSE 290,A00,102399,Chandraker; Manmohan Krishna,0,0,0,0
1668054478389,CSE 290,B00,102400,Vaccaro; Kristen Marie,0,0,25,25
1668054478389,CSE 290,C00,102414,Pannuto; Patrick William,0,0,25,25
1668054478389,CSE 290,D00,102427,Pevzner; Pavel Arkadjevich,0,0,0,0
1668054478389,CSE 290,E00,102429,Zhao; Jishen,0,0,0,0
1668054478389,CSE 290,F00,102436,Tullsen; Dean Michael,0,0,0,0
1668054478389,CSE 290,G00,102440,Christensen; Henrik I,0,0,20,20
1668054478812,CSE 291,A00,102443,Su; Hao,0,0,0,0
1668054478812,CSE 291,B00,102448,Polikarpova; Nadezhda,0,0,0,0
1668054478812,CSE 291,C00,102453,Vaccaro; Kristen Marie,0,0,0,0
1668054478812,CSE 291,D00,111343,Savage; Stefan,0,0,0,0
1668054478812,CSE 291,E00,116474,Claffy; Kimberly Claire,0,0,0,0
1668054478812,CSE 291,F00,116479,Pasquale; Joseph,0,0,0,0
1668054479271,CSE 293,001,119111,Bafna; Vineet,9999,0,9999,0
1668054479271,CSE 293,002,119118,Bellare; Mihir,9999,0,9999,0
1668054479271,CSE 293,003,119122,Berg-Kirkpatrick; Taylor D,9999,0,9999,0
1668054479271,CSE 293,004,119135,Christensen; Henrik I,9999,0,9999,0
1668054479271,CSE 293,005,119142,Cottrell; Garrison W,9999,0,9999,0
1668054479271,CSE 293,006,119146,Deutsch; Alin Bernard,9999,0,9999,0
1668054479271,CSE 293,007,119159,Esmaeilzadeh; Hadi,9999,0,9999,0
1668054479271,CSE 293,008,119166,Freund; Yoav,9999,0,9999,0
1668054479271,CSE 293,009,119170,Griswold; William G.,9999,0,9999,0
1668054479271,CSE 293,010,119183,Gymrek; Melissa Ann,9999,0,9999,0
1668054479271,CSE 293,011,119190,Heninger; Nadia A,9999,0,9999,0
1668054479271,CSE 293,012,119230,Impagliazzo; Russell,9999,0,9999,0
1668054479271,CSE 293,013,119232,Jhala; Ranjit,9999,0,9999,0
1668054479271,CSE 293,014,119233,Kahng; Andrew Byun,9999,0,9999,0
1668054479271,CSE 293,015,119298,Kane; Daniel Mertz,9999,0,9999,0
1668054479271,CSE 293,016,119299,Kriegman; David J,9999,0,9999,0
1668054479271,CSE 293,017,119300,Kumar; Arun Kumar,9999,0,9999,0
1668054479271,CSE 293,018,119301,Lerner; Sorin,9999,0,9999,0
1668054479271,CSE 293,019,119302,Lovett; Shachar,9999,0,9999,0
1668054479271,CSE 293,020,119303,McAuley; Julian John,9999,0,9999,0
1668054479271,CSE 293,021,119304,Micciancio; Daniele,9999,0,9999,0
1668054479271,CSE 293,022,119367,Orailoglu; Alex,9999,0,9999,0
1668054479271,CSE 293,023,119382,Paturi; Ramamohan,9999,0,9999,0
1668054479271,CSE 293,024,119404,Polikarpova; Nadezhda,9999,0,9999,0
1668054479271,CSE 293,025,119406,Politz; Joseph Gibbs,9999,0,9999,0
1668054479271,CSE 293,026,119411,Porter; George M,9999,0,9999,0
1668054479271,CSE 293,027,119414,Porter; Leonard Emerson,9999,0,9999,0
1668054479271,CSE 293,028,119416,Ramamoorthi; Ravi,9999,0,9999,0
1668054479271,CSE 293,029,119417,Sahoo; Debashis,9999,0,9999,0
1668054479271,CSE 293,030,119420,Saul; Lawrence,9999,0,9999,0
1668054479271,CSE 293,031,119421,Savage; Stefan,9999,0,9999,0
1668054479271,CSE 293,032,119425,Schulze; Jurgen P.,9999,0,9999,0
1668054479271,CSE 293,033,119426,Snoeren; Alex C.,9999,0,9999,0
1668054479271,CSE 293,034,119428,Shang; Jingbo,9999,0,9999,0
1668054479271,CSE 293,035,119430,Stefan; Deian,9999,0,9999,0
1668054479271,CSE 293,036,119431,Su; Hao,9999,0,9999,0
1668054479271,CSE 293,037,119433,Swanson; Steven James,9999,0,9999,0
1668054479271,CSE 293,038,119435,Tullsen; Dean Michael,9999,0,9999,0
1668054479271,CSE 293,039,119483,Voelker; Geoffrey M.,9999,0,9999,0
1668054479271,CSE 293,040,119537,Zhao; Jishen,9999,0,9999,0
1668054479271,CSE 293,041,119538,Zhou; Yuan-Yuan,9999,0,9999,0
1668054479271,CSE 293,042,119539,Gao; Sicun,9999,0,9999,0
1668054479271,CSE 293,043,119540,Weibel; Nadir,9999,0,9999,0
1668054479271,CSE 293,044,119541,Gupta; Rajesh K.,9999,0,9999,0
1668054479271,CSE 293,045,126410,Vaccaro; Kristen Marie,9999,0,9999,0
1668054479271,CSE 293,046,126411,Klemke; Richard,9999,0,9999,0
1668054479700,CSE 294,A00,102459,Voelker; Geoffrey M.,0,0,0,0
1668054479700,CSE 294,B00,111322,Orailoglu; Alex,0,0,0,0
1668054480124,DSE 201,A00,096914,Deutsch; Alin Bernard,30,0,30,0
1668054480550,DSE 210,A00,096915,Dasgupta; Sanjoy,30,0,30,0
1668054480974,DSE 260A,A00,096916,Altintas De Callaf; Ilkay,30,0,30,0
1668054481408,ECE 200,001,103586,Antipa; Nicholas A,9999,0,9999,0
1668054481408,ECE 200,002,103587,Atanasov; Nikolay A.,9999,0,9999,0
1668054481408,ECE 200,003,103588,Bharadia; Dinesh,9999,0,9999,0
1668054481408,ECE 200,004,103589,Cheng; Chung Kuan,9999,0,9999,0
1668054481408,ECE 200,005,103590,Cosman; Pamela C.,9999,0,9999,0
1668054481408,ECE 200,006,103591,Dayeh; Shadi Ahmad,9999,0,9999,0
1668054481408,ECE 200,007,103592,Fainman; Yeshaiahu,9999,0,9999,0
1668054481408,ECE 200,008,103593,Ford; Joseph Earl,9999,0,9999,0
1668054481408,ECE 200,009,103594,Franceschetti; Massimo,9999,0,9999,0
1668054481408,ECE 200,010,103595,Fullerton; Eric E,9999,0,9999,0
1668054481408,ECE 200,011,103596,Galton; Ian A,9999,0,9999,0
1668054481408,ECE 200,012,103597,Gilja; Vikash,9999,0,9999,0
1668054481408,ECE 200,013,103598,Hall; Drew A.,9999,0,9999,0
1668054481408,ECE 200,014,103599,Hsueh; Tzu-Chien,9999,0,9999,0
1668054481408,ECE 200,015,103600,Javidi; Tara,9999,0,9999,0
1668054481408,ECE 200,016,103601,Kahng; Andrew Byun,9999,0,9999,0
1668054481408,ECE 200,017,103602,Kim; Young-Han,9999,0,9999,0
1668054481408,ECE 200,018,103603,Koushanfar; Farinaz,9999,0,9999,0
1668054481408,ECE 200,019,103604,Kuzum; Duygu,9999,0,9999,0
1668054481408,ECE 200,020,103605,Le; Hanh-Phuc,9999,0,9999,0
1668054481408,ECE 200,021,103606,Lin; Bill,9999,0,9999,0
1668054481408,ECE 200,022,103607,Liu; Zhaowei,9998,0,9999,1
1668054481408,ECE 200,023,103608,Lo; Yu-Hwa,9999,0,9999,0
1668054481408,ECE 200,024,103609,Lomakin; Vitaliy,9999,0,9999,0
1668054481408,ECE 200,025,103610,Mercier; Patrick Philip,9999,0,9999,0
1668054481408,ECE 200,026,103611,Meyer; Florian,9999,0,9999,0
1668054481408,ECE 200,027,103612,Milstein; Laurence B.,9999,0,9999,0
1668054481408,ECE 200,028,103613,Mir Arabbaygi; Siavash,9999,0,9999,0
1668054481408,ECE 200,029,103614,Mookherjea; Shayan,9999,0,9999,0
1668054481408,ECE 200,030,103615,Morris; Karcher William,9999,0,9999,0
1668054481408,ECE 200,031,103616,Ng; Tse Nga,9999,0,9999,0
1668054481408,ECE 200,032,103617,Nguyen; Truong Quang,9999,0,9999,0
1668054481408,ECE 200,033,103618,Nomura; Kenji,9999,0,9999,0
1668054481408,ECE 200,034,103619,Orlitsky; Alon,9999,0,9999,0
1668054481408,ECE 200,035,103620,Pal; Piya,9999,0,9999,0
1668054481408,ECE 200,036,103621,Papen; George C.,9999,0,9999,0
1668054481408,ECE 200,037,103622,Radic; Stojan,9999,0,9999,0
1668054481408,ECE 200,038,103623,Rao; Bhaskar D.,9999,0,9999,0
1668054481408,ECE 200,039,103624,Rao; Ramesh R,9999,0,9999,0
1668054481408,ECE 200,040,103625,Rebeiz; Gabriel,9999,0,9999,0
1668054481408,ECE 200,041,103626,Sanford; John R,9999,0,9999,0
1668054481408,ECE 200,042,103627,Siegel; Paul H.,9999,0,9999,0
1668054481408,ECE 200,043,103628,Sievenpiper; Daniel F.,9999,0,9999,0
1668054481408,ECE 200,044,103629,Sworder; David D.,9999,0,9999,0
1668054481408,ECE 200,045,103630,Taur; Yuan,9999,0,9999,0
1668054481408,ECE 200,046,103631,Touri; Behrouz,9999,0,9999,0
1668054481408,ECE 200,047,103632,Trivedi; Mohan M.,9999,0,9999,0
1668054481408,ECE 200,048,103633,Vasconcelos; Nuno,9999,0,9999,0
1668054481408,ECE 200,049,103634,Wang; Xiaolong,9999,0,9999,0
1668054481408,ECE 200,050,103635,Xie; Pengtao,9999,0,9999,0
1668054481408,ECE 200,051,103636,Yip; Michael,9999,0,9999,0
1668054481408,ECE 200,052,103637,Zeger; Kenneth A.,999,0,999,0
1668054481408,ECE 200,053,103638,Zhang; Xinyu,9999,0,9999,0
1668054481408,ECE 200,054,103639,Turakhia; Yatish Girish,9999,0,9999,0
1668054481408,ECE 200,055,103640,Kang; Mingu,9999,0,9999,0
1668054481408,ECE 200,056,103641,Shi; Yuanyuan,9999,0,9999,0
1668054481408,ECE 200,057,103642,Wang; Edward Jay,9999,0,9999,0
1668054481408,ECE 200,058,103643,Zheng; Yang,9999,0,9999,0
1668054481832,ECE 202,A00,103644,Kuzum; Duygu,0,0,0,0
1668054482255,ECE 212BN,A00,103646,Ng; Tse Nga,0,0,0,0
1668054482686,ECE 221,A00,111493,Staff,0,0,0,0
1668054483117,ECE 222B,A00,103647,Lomakin; Vitaliy,0,0,0,0
1668054483541,ECE 230B,A00,103648,Taur; Yuan,0,0,0,0
1668054483972,ECE 238B,A00,103649,Garay; Javier,0,0,0,0
1668054484396,ECE 240B,A00,112900,Fainman; Yeshaiahu,0,0,0,0
1668054484820,ECE 247A,A00,103650,Jokerst; Jesse Vincent,0,0,0,0
1668054485253,ECE 247B,A00,103651,Wang; Joseph,0,0,0,0
1668054485697,ECE 250,A00,103652,Siegel; Paul H.,0,0,0,0
1668054486125,ECE 251A,A00,103654,Rao; Bhaskar D.,0,0,0,0
1668054486564,ECE 257B,A00,103655,Bharadia; Dinesh,0,0,0,0
1668054486989,ECE 258A,A00,103656,Milstein; Laurence B.,0,0,0,0
1668054487423,ECE 260B,A00,103658,Kang; Mingu,0,0,0,0
1668054487854,ECE 264A,A00,103659,Galton; Ian A,0,0,0,0
1668054488276,ECE 265A,A00,103661,Gudem; Prasad S.S.,0,0,0,0
1668054488701,ECE 265D,A00,103662,Gudem; Prasad S.S.,0,0,0,0
1668054489133,ECE 268,A00,103663,Koushanfar; Farinaz,0,0,0,0
1668054489674,ECE 269,A01,103665,Pal; Piya,0,0,0,0
1668054490100,ECE 271B,A00,103666,Vasconcelos; Manuela,0,0,0,0
1668054490523,ECE 276A,A00,103667,Atanasov; Nikolay A.,0,0,0,0
1668054490954,ECE 277,A00,103668,An; Cheolhong,0,0,0,0
1668054491377,ECE 279,A00,117947,Hall; Drew A.,0,0,0,0
1668054492229,ECE 283,A00,103670,Hsueh; Tzu-Chien,0,0,0,0
1668054492655,ECE 284,A00,103671,Turakhia; Yatish Girish,0,0,0,0
1668054493079,ECE 285,A00,103672,Zheng; Yang,0,0,0,0
1668054493079,ECE 285,B00,103673,Sworder; David D.,0,0,0,0
1668054493513,ECE 287,A00,103676,Javidi; Tara,0,0,0,0
1668054493949,MATH 200B,A00,098023,Salehi Golsefidy; Alireza,13,0,15,2
1668054494373,MATH 202B,A00,098024,Rhoades; Brendon Patrick,9,0,15,6
1668054494804,MATH 203B,A00,098025,Oprea; Dragos N.,11,0,15,4
1668054495238,MATH 204B,A00,098026,Sorensen; Claus M,13,0,15,2
1668054495673,MATH 208,A00,098027,Izadi; Elham,7,0,10,3
1668054496104,MATH 209,A00,098028,Pollack; Aaron,10,0,10,0
1668054496529,MATH 211A,A00,112919,Rogalski; Daniel,9,0,10,1
1668054496951,MATH 211B,A00,112920,Seward; Brandon M.,9,0,10,1
1668054497379,MATH 218,A00,098029,Li; Bo,10,0,10,0
1668054497817,MATH 220B,A00,098030,Novak; Jonathan I,13,0,15,2
1668054498241,MATH 221A,A00,098031,Ebenfelt; Peter F,13,0,15,2
1668054498666,MATH 231B,A00,098032,Zlatos; Andrej,12,0,15,3
1668054499098,MATH 240B,A00,098033,Ni; Lei,9,0,15,6
1668054499521,MATH 243,A00,098034,Jekel; David Andrew,10,0,10,0
1668054499946,MATH 245A,A00,098035,Nie; Jiawang,0,0,15,16
1668054500370,MATH 248,A00,098036,Bejenaru; Ioan,10,0,10,0
1668054500793,MATH 250B,A00,098037,Spolaor; Luca,14,0,15,1
1668054501227,MATH 258,A00,098038,Ni; Lei,10,0,10,0
1668054501654,MATH 264B,A00,098041,Rhoades; Brendon Patrick,10,0,15,5
1668054502078,MATH 268,A00,098042,Buss; Samuel R,10,0,10,0
1668054502501,MATH 269,A00,098043,Rhoades; Brendon Patrick,10,0,10,0
1668054502923,MATH 270B,A00,098044,Li; Bo,11,0,15,4
1668054503346,MATH 272B,A00,098045,Holst; Michael J,13,0,15,2
1668054503769,MATH 273A,A00,098046,Tian; Xiaochuan,10,0,15,5
1668054504205,MATH 275,A01,098048,Tian; Xiaochuan,6,0,10,4
1668054504634,MATH 278A,A00,098049,Holst; Michael J,8,0,10,2
1668054505064,MATH 278B,A00,098050,Cloninger; Alexander,10,0,10,0
1668054505490,MATH 278C,A00,098051,Nie; Jiawang,7,0,10,3
1668054505925,MATH 280B,A00,098052,Zheng; Tianyi,10,0,15,5
1668054506352,MATH 281B,A00,098053,Bradic; Jelena,3,0,15,12
1668054506794,MATH 282B,A00,098054,Arias-Castro; Ery,0,0,15,15
1668054507217,MATH 285,A00,098055,Fitzsimmons; Patrick J,0,0,15,17
1668054507640,MATH 287B,A00,098056,Arias-Castro; Ery,3,0,15,12
1668054508070,MATH 288,A00,098057,Agarwal; Pooja,9,0,10,1
1668054508070,MATH 288,B00,098058,Zhang; Danna,8,0,10,2
1668054508070,MATH 288,C00,098059,Williams; Ruth J,10,0,10,0
1668054508494,MATH 290B,A00,098060,Roberts; Justin Deritter,13,0,15,2
1668054508916,MATH 292,A00,098061,Belmont; Eva Kinoshita,10,0,10,0
1668054509351,MATH 295,A00,098062,Suk; Andrew Hoon,48,0,50,2
1668054509777,MATH 296,A00,098063,Novak; Jonathan I,20,0,20,0
1668054510201,MATH 297,001,098064,Gamst; Anthony Collins,9997,0,9999,2
1668055013208,COGS 205,A00,101395,Chiba; Andrea,19,0,20,1
1668055013640,COGS 210B,001,101404,Greene; Deanna Jacquelyn,9998,0,9999,1
1668055013640,COGS 210B,002,101417,Xia; Haijun,9999,0,9999,0
1668055013640,COGS 210B,003,101422,Nitz; Douglas A.,9999,0,9999,0
1668055013640,COGS 210B,004,101423,Hollan; James D.,9998,0,9999,1
1668055013640,COGS 210B,005,101424,Deak; Gedeon O.,9998,0,9999,1
1668055013640,COGS 210B,006,101425,Rossano; Federico,9999,0,9999,0
1668055014063,COGS 211B,A00,101427,Coulson; Seana M,9996,0,9999,3
1668055014487,COGS 220,A00,101428,Hollan; James D.,0,0,25,25
1668055014913,COGS 229,A00,101429,Dow; Steven P,18,0,25,7
1668055015340,COGS 230,A00,101430,Klemmer; Scott R,13,0,17,4
1668055015785,COGS 234,A00,101431,Xia; Haijun,4,0,25,21
1668055016209,COGS 260,A00,101432,Kiyonaga; Anastasia,19,0,25,6
1668055016209,COGS 260,B00,101433,Kirsh; David Joel,16,0,25,9
1668055016641,CSE 202,A00,102371,Impagliazzo; Russell,0,0,0,0
1668055017075,CSE 203B,A01,102373,Cheng; Chung Kuan,0,0,0,0
1668055017501,CSE 208,A00,102374,Micciancio; Daniele,0,0,0,0
1668055017925,CSE 209A,A00,112895,Impagliazzo; Russell,0,0,15,15
1668055018352,CSE 209B,A00,108005,Bellare; Mihir,0,0,0,0
1668055018777,CSE 210,A00,113163,Coblenz; Michael J,0,0,0,0
1668055019203,CSE 219,A00,106111,Dow; Steven P,0,0,20,20
1668055019630,CSE 221,A00,102376,Voelker; Geoffrey M.,0,0,0,0
1668055020053,CSE 224,A01,102378,Porter; George M,0,0,0,0
1668055020490,CSE 229A,A00,102379,Savage; Stefan,0,0,0,0
1668055020914,CSE 229C,A00,102380,Munyaka; Imani N. S.,0,0,0,0
1668055021341,CSE 232B,A00,102382,Deutsch; Alin Bernard,0,0,0,0
1668055021765,CSE 234,A01,112904,Kumar; Arun Kumar,0,0,0,0
1668055022198,CSE 237A,A00,102383,Rosing; Tajana Simunic,0,0,0,0
1668055022637,CSE 239A,A00,102384,Deutsch; Alin Bernard,0,0,0,0
1668055023059,CSE 239B,A00,102385,Polikarpova; Nadezhda,0,0,0,0
1668055023486,CSE 240A,A00,102386,Pannuto; Patrick William,0,0,0,0
1668055023909,CSE 240B,A00,102387,Zhao; Jishen,0,0,0,0
1668055024336,CSE 241A,A00,106406,Kang; Mingu,0,0,0,0
1668055024759,CSE 249B,A00,102388,Kahng; Andrew Byun,0,0,8,8
1668055025183,CSE 251B,A01,102392,Cottrell; Garrison W,0,0,0,0
1668055025183,CSE 251B,A02,102393,Cottrell; Garrison W,0,0,0,0
1668055025609,CSE 252B,A00,102394,Ochoa; Benjamin Lawrence,0,0,0,0
1668055026036,CSE 257,A01,102396,Gao; Sicun,0,0,0,0
1668055026463,CSE 272,A00,102397,Li; Tzumao,0,0,0,0
1668055026890,CSE 274,A00,111323,Chern; Albert Ren-Haur,0,0,0,0
1668055027328,CSE 282,A00,102398,Pevzner; Pavel Arkadjevich,0,0,0,0
1668055027752,CSE 284,A00,114175,Gymrek; Melissa Ann,0,0,0,0
1668055028175,CSE 290,A00,102399,Chandraker; Manmohan Krishna,0,0,0,0
1668055028175,CSE 290,B00,102400,Vaccaro; Kristen Marie,0,0,25,25
1668055028175,CSE 290,C00,102414,Pannuto; Patrick William,0,0,25,25
1668055028175,CSE 290,D00,102427,Pevzner; Pavel Arkadjevich,0,0,0,0
1668055028175,CSE 290,E00,102429,Zhao; Jishen,0,0,0,0
1668055028175,CSE 290,F00,102436,Tullsen; Dean Michael,0,0,0,0
1668055028175,CSE 290,G00,102440,Christensen; Henrik I,0,0,20,20
1668055028598,CSE 291,A00,102443,Su; Hao,0,0,0,0
1668055028598,CSE 291,B00,102448,Polikarpova; Nadezhda,0,0,0,0
1668055028598,CSE 291,C00,102453,Vaccaro; Kristen Marie,0,0,0,0
1668055028598,CSE 291,D00,111343,Savage; Stefan,0,0,0,0
1668055028598,CSE 291,E00,116474,Claffy; Kimberly Claire,0,0,0,0
1668055028598,CSE 291,F00,116479,Pasquale; Joseph,0,0,0,0
1668055029063,CSE 293,001,119111,Bafna; Vineet,9999,0,9999,0
1668055029063,CSE 293,002,119118,Bellare; Mihir,9999,0,9999,0
1668055029063,CSE 293,003,119122,Berg-Kirkpatrick; Taylor D,9999,0,9999,0
1668055029063,CSE 293,004,119135,Christensen; Henrik I,9999,0,9999,0
1668055029063,CSE 293,005,119142,Cottrell; Garrison W,9999,0,9999,0
1668055029063,CSE 293,006,119146,Deutsch; Alin Bernard,9999,0,9999,0
1668055029063,CSE 293,007,119159,Esmaeilzadeh; Hadi,9999,0,9999,0
1668055029063,CSE 293,008,119166,Freund; Yoav,9999,0,9999,0
1668055029063,CSE 293,009,119170,Griswold; William G.,9999,0,9999,0
1668055029063,CSE 293,010,119183,Gymrek; Melissa Ann,9999,0,9999,0
1668055029063,CSE 293,011,119190,Heninger; Nadia A,9999,0,9999,0
1668055029063,CSE 293,012,119230,Impagliazzo; Russell,9999,0,9999,0
1668055029063,CSE 293,013,119232,Jhala; Ranjit,9999,0,9999,0
1668055029063,CSE 293,014,119233,Kahng; Andrew Byun,9999,0,9999,0
1668055029063,CSE 293,015,119298,Kane; Daniel Mertz,9999,0,9999,0
1668055029063,CSE 293,016,119299,Kriegman; David J,9999,0,9999,0
1668055029063,CSE 293,017,119300,Kumar; Arun Kumar,9999,0,9999,0
1668055029063,CSE 293,018,119301,Lerner; Sorin,9999,0,9999,0
1668055029063,CSE 293,019,119302,Lovett; Shachar,9999,0,9999,0
1668055029063,CSE 293,020,119303,McAuley; Julian John,9999,0,9999,0
1668055029063,CSE 293,021,119304,Micciancio; Daniele,9999,0,9999,0
1668055029063,CSE 293,022,119367,Orailoglu; Alex,9999,0,9999,0
1668055029063,CSE 293,023,119382,Paturi; Ramamohan,9999,0,9999,0
1668055029063,CSE 293,024,119404,Polikarpova; Nadezhda,9999,0,9999,0
1668055029063,CSE 293,025,119406,Politz; Joseph Gibbs,9999,0,9999,0
1668055029063,CSE 293,026,119411,Porter; George M,9999,0,9999,0
1668055029063,CSE 293,027,119414,Porter; Leonard Emerson,9999,0,9999,0
1668055029063,CSE 293,028,119416,Ramamoorthi; Ravi,9999,0,9999,0
1668055029063,CSE 293,029,119417,Sahoo; Debashis,9999,0,9999,0
1668055029063,CSE 293,030,119420,Saul; Lawrence,9999,0,9999,0
1668055029063,CSE 293,031,119421,Savage; Stefan,9999,0,9999,0
1668055029063,CSE 293,032,119425,Schulze; Jurgen P.,9999,0,9999,0
1668055029063,CSE 293,033,119426,Snoeren; Alex C.,9999,0,9999,0
1668055029063,CSE 293,034,119428,Shang; Jingbo,9999,0,9999,0
1668055029063,CSE 293,035,119430,Stefan; Deian,9999,0,9999,0
1668055029063,CSE 293,036,119431,Su; Hao,9999,0,9999,0
1668055029063,CSE 293,037,119433,Swanson; Steven James,9999,0,9999,0
1668055029063,CSE 293,038,119435,Tullsen; Dean Michael,9999,0,9999,0
1668055029063,CSE 293,039,119483,Voelker; Geoffrey M.,9999,0,9999,0
1668055029063,CSE 293,040,119537,Zhao; Jishen,9999,0,9999,0
1668055029063,CSE 293,041,119538,Zhou; Yuan-Yuan,9999,0,9999,0
1668055029063,CSE 293,042,119539,Gao; Sicun,9999,0,9999,0
1668055029063,CSE 293,043,119540,Weibel; Nadir,9999,0,9999,0
1668055029063,CSE 293,044,119541,Gupta; Rajesh K.,9999,0,9999,0
1668055029063,CSE 293,045,126410,Vaccaro; Kristen Marie,9999,0,9999,0
1668055029063,CSE 293,046,126411,Klemke; Richard,9999,0,9999,0
1668055029489,CSE 294,A00,102459,Voelker; Geoffrey M.,0,0,0,0
1668055029489,CSE 294,B00,111322,Orailoglu; Alex,0,0,0,0
1668055029913,DSE 201,A00,096914,Deutsch; Alin Bernard,30,0,30,0
1668055030340,DSE 210,A00,096915,Dasgupta; Sanjoy,30,0,30,0
1668055030764,DSE 260A,A00,096916,Altintas De Callaf; Ilkay,30,0,30,0
1668055031205,ECE 200,001,103586,Antipa; Nicholas A,9999,0,9999,0
1668055031205,ECE 200,002,103587,Atanasov; Nikolay A.,9999,0,9999,0
1668055031205,ECE 200,003,103588,Bharadia; Dinesh,9999,0,9999,0
1668055031205,ECE 200,004,103589,Cheng; Chung Kuan,9999,0,9999,0
1668055031205,ECE 200,005,103590,Cosman; Pamela C.,9999,0,9999,0
1668055031205,ECE 200,006,103591,Dayeh; Shadi Ahmad,9999,0,9999,0
1668055031205,ECE 200,007,103592,Fainman; Yeshaiahu,9999,0,9999,0
1668055031205,ECE 200,008,103593,Ford; Joseph Earl,9999,0,9999,0
1668055031205,ECE 200,009,103594,Franceschetti; Massimo,9999,0,9999,0
1668055031205,ECE 200,010,103595,Fullerton; Eric E,9999,0,9999,0
1668055031205,ECE 200,011,103596,Galton; Ian A,9999,0,9999,0
1668055031205,ECE 200,012,103597,Gilja; Vikash,9999,0,9999,0
1668055031205,ECE 200,013,103598,Hall; Drew A.,9999,0,9999,0
1668055031205,ECE 200,014,103599,Hsueh; Tzu-Chien,9999,0,9999,0
1668055031205,ECE 200,015,103600,Javidi; Tara,9999,0,9999,0
1668055031205,ECE 200,016,103601,Kahng; Andrew Byun,9999,0,9999,0
1668055031205,ECE 200,017,103602,Kim; Young-Han,9999,0,9999,0
1668055031205,ECE 200,018,103603,Koushanfar; Farinaz,9999,0,9999,0
1668055031205,ECE 200,019,103604,Kuzum; Duygu,9999,0,9999,0
1668055031205,ECE 200,020,103605,Le; Hanh-Phuc,9999,0,9999,0
1668055031205,ECE 200,021,103606,Lin; Bill,9999,0,9999,0
1668055031205,ECE 200,022,103607,Liu; Zhaowei,9998,0,9999,1
1668055031205,ECE 200,023,103608,Lo; Yu-Hwa,9999,0,9999,0
1668055031205,ECE 200,024,103609,Lomakin; Vitaliy,9999,0,9999,0
1668055031205,ECE 200,025,103610,Mercier; Patrick Philip,9999,0,9999,0
1668055031205,ECE 200,026,103611,Meyer; Florian,9999,0,9999,0
1668055031205,ECE 200,027,103612,Milstein; Laurence B.,9999,0,9999,0
1668055031205,ECE 200,028,103613,Mir Arabbaygi; Siavash,9999,0,9999,0
1668055031205,ECE 200,029,103614,Mookherjea; Shayan,9999,0,9999,0
1668055031205,ECE 200,030,103615,Morris; Karcher William,9999,0,9999,0
1668055031205,ECE 200,031,103616,Ng; Tse Nga,9999,0,9999,0
1668055031205,ECE 200,032,103617,Nguyen; Truong Quang,9999,0,9999,0
1668055031205,ECE 200,033,103618,Nomura; Kenji,9999,0,9999,0
1668055031205,ECE 200,034,103619,Orlitsky; Alon,9999,0,9999,0
1668055031205,ECE 200,035,103620,Pal; Piya,9999,0,9999,0
1668055031205,ECE 200,036,103621,Papen; George C.,9999,0,9999,0
1668055031205,ECE 200,037,103622,Radic; Stojan,9999,0,9999,0
1668055031205,ECE 200,038,103623,Rao; Bhaskar D.,9999,0,9999,0
1668055031205,ECE 200,039,103624,Rao; Ramesh R,9999,0,9999,0
1668055031205,ECE 200,040,103625,Rebeiz; Gabriel,9999,0,9999,0
1668055031205,ECE 200,041,103626,Sanford; John R,9999,0,9999,0
1668055031205,ECE 200,042,103627,Siegel; Paul H.,9999,0,9999,0
1668055031205,ECE 200,043,103628,Sievenpiper; Daniel F.,9999,0,9999,0
1668055031205,ECE 200,044,103629,Sworder; David D.,9999,0,9999,0
1668055031205,ECE 200,045,103630,Taur; Yuan,9999,0,9999,0
1668055031205,ECE 200,046,103631,Touri; Behrouz,9999,0,9999,0
1668055031205,ECE 200,047,103632,Trivedi; Mohan M.,9999,0,9999,0
1668055031205,ECE 200,048,103633,Vasconcelos; Nuno,9999,0,9999,0
1668055031205,ECE 200,049,103634,Wang; Xiaolong,9999,0,9999,0
1668055031205,ECE 200,050,103635,Xie; Pengtao,9999,0,9999,0
1668055031205,ECE 200,051,103636,Yip; Michael,9999,0,9999,0
1668055031205,ECE 200,052,103637,Zeger; Kenneth A.,999,0,999,0
1668055031205,ECE 200,053,103638,Zhang; Xinyu,9999,0,9999,0
1668055031205,ECE 200,054,103639,Turakhia; Yatish Girish,9999,0,9999,0
1668055031205,ECE 200,055,103640,Kang; Mingu,9999,0,9999,0
1668055031205,ECE 200,056,103641,Shi; Yuanyuan,9999,0,9999,0
1668055031205,ECE 200,057,103642,Wang; Edward Jay,9999,0,9999,0
1668055031205,ECE 200,058,103643,Zheng; Yang,9999,0,9999,0
1668055031632,ECE 202,A00,103644,Kuzum; Duygu,0,0,0,0
1668055032056,ECE 212BN,A00,103646,Ng; Tse Nga,0,0,0,0
1668055032479,ECE 221,A00,111493,Staff,0,0,0,0
1668055032907,ECE 222B,A00,103647,Lomakin; Vitaliy,0,0,0,0
1668055033330,ECE 230B,A00,103648,Taur; Yuan,0,0,0,0
1668055033758,ECE 238B,A00,103649,Garay; Javier,0,0,0,0
1668055034181,ECE 240B,A00,112900,Fainman; Yeshaiahu,0,0,0,0
1668055034604,ECE 247A,A00,103650,Jokerst; Jesse Vincent,0,0,0,0
1668055035031,ECE 247B,A00,103651,Wang; Joseph,0,0,0,0
1668055035454,ECE 250,A00,103652,Siegel; Paul H.,0,0,0,0
1668055035880,ECE 251A,A00,103654,Rao; Bhaskar D.,0,0,0,0
1668055036313,ECE 257B,A00,103655,Bharadia; Dinesh,0,0,0,0
1668055036738,ECE 258A,A00,103656,Milstein; Laurence B.,0,0,0,0
1668055037161,ECE 260B,A00,103658,Kang; Mingu,0,0,0,0
1668055037586,ECE 264A,A00,103659,Galton; Ian A,0,0,0,0
1668055038012,ECE 265A,A00,103661,Gudem; Prasad S.S.,0,0,0,0
1668055038438,ECE 265D,A00,103662,Gudem; Prasad S.S.,0,0,0,0
1668055038870,ECE 268,A00,103663,Koushanfar; Farinaz,0,0,0,0
1668055039292,ECE 269,A01,103665,Pal; Piya,0,0,0,0
1668055039720,ECE 271B,A00,103666,Vasconcelos; Manuela,0,0,0,0
1668055040146,ECE 276A,A00,103667,Atanasov; Nikolay A.,0,0,0,0
1668055040568,ECE 277,A00,103668,An; Cheolhong,0,0,0,0
1668055040999,ECE 279,A00,117947,Hall; Drew A.,0,0,0,0
1668055041863,ECE 283,A00,103670,Hsueh; Tzu-Chien,0,0,0,0
1668055042287,ECE 284,A00,103671,Turakhia; Yatish Girish,0,0,0,0
1668055042727,ECE 285,A00,103672,Zheng; Yang,0,0,0,0
1668055042727,ECE 285,B00,103673,Sworder; David D.,0,0,0,0
1668055043152,ECE 287,A00,103676,Javidi; Tara,0,0,0,0
1668055043578,MATH 200B,A00,098023,Salehi Golsefidy; Alireza,13,0,15,2
1668055044003,MATH 202B,A00,098024,Rhoades; Brendon Patrick,9,0,15,6
1668055044428,MATH 203B,A00,098025,Oprea; Dragos N.,11,0,15,4
1668055044850,MATH 204B,A00,098026,Sorensen; Claus M,13,0,15,2
1668055045285,MATH 208,A00,098027,Izadi; Elham,7,0,10,3
1668055045715,MATH 209,A00,098028,Pollack; Aaron,10,0,10,0
1668055046137,MATH 211A,A00,112919,Rogalski; Daniel,9,0,10,1
1668055046561,MATH 211B,A00,112920,Seward; Brandon M.,9,0,10,1
1668055046986,MATH 218,A00,098029,Li; Bo,10,0,10,0
1668055047408,MATH 220B,A00,098030,Novak; Jonathan I,13,0,15,2
1668055047839,MATH 221A,A00,098031,Ebenfelt; Peter F,13,0,15,2
1668055048265,MATH 231B,A00,098032,Zlatos; Andrej,12,0,15,3
1668055048689,MATH 240B,A00,098033,Ni; Lei,9,0,15,6
1668055049112,MATH 243,A00,098034,Jekel; David Andrew,10,0,10,0
1668055049535,MATH 245A,A00,098035,Nie; Jiawang,0,0,15,16
1668055049961,MATH 248,A00,098036,Bejenaru; Ioan,10,0,10,0
1668055050386,MATH 250B,A00,098037,Spolaor; Luca,14,0,15,1
1668055050808,MATH 258,A00,098038,Ni; Lei,10,0,10,0
1668055051233,MATH 264B,A00,098041,Rhoades; Brendon Patrick,10,0,15,5
1668055051657,MATH 268,A00,098042,Buss; Samuel R,10,0,10,0
1668055052088,MATH 269,A00,098043,Rhoades; Brendon Patrick,10,0,10,0
1668055052515,MATH 270B,A00,098044,Li; Bo,11,0,15,4
1668055052940,MATH 272B,A00,098045,Holst; Michael J,13,0,15,2
1668055053370,MATH 273A,A00,098046,Tian; Xiaochuan,10,0,15,5
1668055053800,MATH 275,A01,098048,Tian; Xiaochuan,6,0,10,4
1668055054221,MATH 278A,A00,098049,Holst; Michael J,8,0,10,2
1668055054648,MATH 278B,A00,098050,Cloninger; Alexander,10,0,10,0
1668055055071,MATH 278C,A00,098051,Nie; Jiawang,7,0,10,3
1668055055499,MATH 280B,A00,098052,Zheng; Tianyi,10,0,15,5
1668055056026,MATH 281B,A00,098053,Bradic; Jelena,3,0,15,12
1668055056450,MATH 282B,A00,098054,Arias-Castro; Ery,0,0,15,15
1668055056877,MATH 285,A00,098055,Fitzsimmons; Patrick J,0,0,15,17
1668055057303,MATH 287B,A00,098056,Arias-Castro; Ery,3,0,15,12
1668055057735,MATH 288,A00,098057,Agarwal; Pooja,9,0,10,1
1668055057735,MATH 288,B00,098058,Zhang; Danna,8,0,10,2
1668055057735,MATH 288,C00,098059,Williams; Ruth J,10,0,10,0
1668055058166,MATH 290B,A00,098060,Roberts; Justin Deritter,13,0,15,2
1668055058596,MATH 292,A00,098061,Belmont; Eva Kinoshita,10,0,10,0
1668055059020,MATH 295,A00,098062,Suk; Andrew Hoon,48,0,50,2
1668055059444,MATH 296,A00,098063,Novak; Jonathan I,20,0,20,0
1668055059877,MATH 297,001,098064,Gamst; Anthony Collins,9997,0,9999,2
1668055563207,COGS 205,A00,101395,Chiba; Andrea,19,0,20,1
1668055563632,COGS 210B,001,101404,Greene; Deanna Jacquelyn,9998,0,9999,1
1668055563632,COGS 210B,002,101417,Xia; Haijun,9999,0,9999,0
1668055563632,COGS 210B,003,101422,Nitz; Douglas A.,9999,0,9999,0
1668055563632,COGS 210B,004,101423,Hollan; James D.,9998,0,9999,1
1668055563632,COGS 210B,005,101424,Deak; Gedeon O.,9998,0,9999,1
1668055563632,COGS 210B,006,101425,Rossano; Federico,9999,0,9999,0
1668055564062,COGS 211B,A00,101427,Coulson; Seana M,9996,0,9999,3
1668055564488,COGS 220,A00,101428,Hollan; James D.,0,0,25,25
1668055564911,COGS 229,A00,101429,Dow; Steven P,18,0,25,7
1668055565338,COGS 230,A00,101430,Klemmer; Scott R,13,0,17,4
1668055565763,COGS 234,A00,101431,Xia; Haijun,4,0,25,21
1668055566187,COGS 260,A00,101432,Kiyonaga; Anastasia,19,0,25,6
1668055566187,COGS 260,B00,101433,Kirsh; David Joel,16,0,25,9
1668055566612,CSE 202,A00,102371,Impagliazzo; Russell,0,0,0,0
1668055567048,CSE 203B,A01,102373,Cheng; Chung Kuan,0,0,0,0
1668055567473,CSE 208,A00,102374,Micciancio; Daniele,0,0,0,0
1668055567904,CSE 209A,A00,112895,Impagliazzo; Russell,0,0,15,15
1668055568337,CSE 209B,A00,108005,Bellare; Mihir,0,0,0,0
1668055568759,CSE 210,A00,113163,Coblenz; Michael J,0,0,0,0
1668055569188,CSE 219,A00,106111,Dow; Steven P,0,0,20,20
1668055569610,CSE 221,A00,102376,Voelker; Geoffrey M.,0,0,0,0
1668055570055,CSE 224,A01,102378,Porter; George M,0,0,0,0
1668055570493,CSE 229A,A00,102379,Savage; Stefan,0,0,0,0
1668055570931,CSE 229C,A00,102380,Munyaka; Imani N. S.,0,0,0,0
1668055571361,CSE 232B,A00,102382,Deutsch; Alin Bernard,0,0,0,0
1668055571791,CSE 234,A01,112904,Kumar; Arun Kumar,0,0,0,0
1668055572215,CSE 237A,A00,102383,Rosing; Tajana Simunic,0,0,0,0
1668055572646,CSE 239A,A00,102384,Deutsch; Alin Bernard,0,0,0,0
1668055573083,CSE 239B,A00,102385,Polikarpova; Nadezhda,0,0,0,0
1668055573514,CSE 240A,A00,102386,Pannuto; Patrick William,0,0,0,0
1668055573947,CSE 240B,A00,102387,Zhao; Jishen,0,0,0,0
1668055574371,CSE 241A,A00,106406,Kang; Mingu,0,0,0,0
1668055574797,CSE 249B,A00,102388,Kahng; Andrew Byun,0,0,8,8
1668055575222,CSE 251B,A01,102392,Cottrell; Garrison W,0,0,0,0
1668055575222,CSE 251B,A02,102393,Cottrell; Garrison W,0,0,0,0
1668055575647,CSE 252B,A00,102394,Ochoa; Benjamin Lawrence,0,0,0,0
1668055576080,CSE 257,A01,102396,Gao; Sicun,0,0,0,0
1668055576504,CSE 272,A00,102397,Li; Tzumao,0,0,0,0
1668055576929,CSE 274,A00,111323,Chern; Albert Ren-Haur,0,0,0,0
1668055577366,CSE 282,A00,102398,Pevzner; Pavel Arkadjevich,0,0,0,0
1668055577791,CSE 284,A00,114175,Gymrek; Melissa Ann,0,0,0,0
1668055578223,CSE 290,A00,102399,Chandraker; Manmohan Krishna,0,0,0,0
1668055578223,CSE 290,B00,102400,Vaccaro; Kristen Marie,0,0,25,25
1668055578223,CSE 290,C00,102414,Pannuto; Patrick William,0,0,25,25
1668055578223,CSE 290,D00,102427,Pevzner; Pavel Arkadjevich,0,0,0,0
1668055578223,CSE 290,E00,102429,Zhao; Jishen,0,0,0,0
1668055578223,CSE 290,F00,102436,Tullsen; Dean Michael,0,0,0,0
1668055578223,CSE 290,G00,102440,Christensen; Henrik I,0,0,20,20
1668055578651,CSE 291,A00,102443,Su; Hao,0,0,0,0
1668055578651,CSE 291,B00,102448,Polikarpova; Nadezhda,0,0,0,0
1668055578651,CSE 291,C00,102453,Vaccaro; Kristen Marie,0,0,0,0
1668055578651,CSE 291,D00,111343,Savage; Stefan,0,0,0,0
1668055578651,CSE 291,E00,116474,Claffy; Kimberly Claire,0,0,0,0
1668055578651,CSE 291,F00,116479,Pasquale; Joseph,0,0,0,0
1668055579080,CSE 293,001,119111,Bafna; Vineet,9999,0,9999,0
1668055579080,CSE 293,002,119118,Bellare; Mihir,9999,0,9999,0
1668055579080,CSE 293,003,119122,Berg-Kirkpatrick; Taylor D,9999,0,9999,0
1668055579080,CSE 293,004,119135,Christensen; Henrik I,9999,0,9999,0
1668055579080,CSE 293,005,119142,Cottrell; Garrison W,9999,0,9999,0
1668055579080,CSE 293,006,119146,Deutsch; Alin Bernard,9999,0,9999,0
1668055579080,CSE 293,007,119159,Esmaeilzadeh; Hadi,9999,0,9999,0
1668055579080,CSE 293,008,119166,Freund; Yoav,9999,0,9999,0
1668055579080,CSE 293,009,119170,Griswold; William G.,9999,0,9999,0
1668055579080,CSE 293,010,119183,Gymrek; Melissa Ann,9999,0,9999,0
1668055579080,CSE 293,011,119190,Heninger; Nadia A,9999,0,9999,0
1668055579080,CSE 293,012,119230,Impagliazzo; Russell,9999,0,9999,0
1668055579080,CSE 293,013,119232,Jhala; Ranjit,9999,0,9999,0
1668055579080,CSE 293,014,119233,Kahng; Andrew Byun,9999,0,9999,0
1668055579080,CSE 293,015,119298,Kane; Daniel Mertz,9999,0,9999,0
1668055579080,CSE 293,016,119299,Kriegman; David J,9999,0,9999,0
1668055579080,CSE 293,017,119300,Kumar; Arun Kumar,9999,0,9999,0
1668055579080,CSE 293,018,119301,Lerner; Sorin,9999,0,9999,0
1668055579080,CSE 293,019,119302,Lovett; Shachar,9999,0,9999,0
1668055579080,CSE 293,020,119303,McAuley; Julian John,9999,0,9999,0
1668055579080,CSE 293,021,119304,Micciancio; Daniele,9999,0,9999,0
1668055579080,CSE 293,022,119367,Orailoglu; Alex,9999,0,9999,0
1668055579080,CSE 293,023,119382,Paturi; Ramamohan,9999,0,9999,0
1668055579080,CSE 293,024,119404,Polikarpova; Nadezhda,9999,0,9999,0
1668055579080,CSE 293,025,119406,Politz; Joseph Gibbs,9999,0,9999,0
1668055579080,CSE 293,026,119411,Porter; George M,9999,0,9999,0
1668055579080,CSE 293,027,119414,Porter; Leonard Emerson,9999,0,9999,0
1668055579080,CSE 293,028,119416,Ramamoorthi; Ravi,9999,0,9999,0
1668055579080,CSE 293,029,119417,Sahoo; Debashis,9999,0,9999,0
1668055579080,CSE 293,030,119420,Saul; Lawrence,9999,0,9999,0
1668055579080,CSE 293,031,119421,Savage; Stefan,9999,0,9999,0
1668055579080,CSE 293,032,119425,Schulze; Jurgen P.,9999,0,9999,0
1668055579080,CSE 293,033,119426,Snoeren; Alex C.,9999,0,9999,0
1668055579080,CSE 293,034,119428,Shang; Jingbo,9999,0,9999,0
1668055579080,CSE 293,035,119430,Stefan; Deian,9999,0,9999,0
1668055579080,CSE 293,036,119431,Su; Hao,9999,0,9999,0
1668055579080,CSE 293,037,119433,Swanson; Steven James,9999,0,9999,0
1668055579080,CSE 293,038,119435,Tullsen; Dean Michael,9999,0,9999,0
1668055579080,CSE 293,039,119483,Voelker; Geoffrey M.,9999,0,9999,0
1668055579080,CSE 293,040,119537,Zhao; Jishen,9999,0,9999,0
1668055579080,CSE 293,041,119538,Zhou; Yuan-Yuan,9999,0,9999,0
1668055579080,CSE 293,042,119539,Gao; Sicun,9999,0,9999,0
1668055579080,CSE 293,043,119540,Weibel; Nadir,9999,0,9999,0
1668055579080,CSE 293,044,119541,Gupta; Rajesh K.,9999,0,9999,0
1668055579080,CSE 293,045,126410,Vaccaro; Kristen Marie,9999,0,9999,0
1668055579080,CSE 293,046,126411,Klemke; Richard,9999,0,9999,0
1668055579608,CSE 294,A00,102459,Voelker; Geoffrey M.,0,0,0,0
1668055579608,CSE 294,B00,111322,Orailoglu; Alex,0,0,0,0
1668055580035,DSE 201,A00,096914,Deutsch; Alin Bernard,30,0,30,0
1668055580459,DSE 210,A00,096915,Dasgupta; Sanjoy,30,0,30,0
1668055580885,DSE 260A,A00,096916,Altintas De Callaf; Ilkay,30,0,30,0
1668055581338,ECE 200,001,103586,Antipa; Nicholas A,9999,0,9999,0
1668055581338,ECE 200,002,103587,Atanasov; Nikolay A.,9999,0,9999,0
1668055581338,ECE 200,003,103588,Bharadia; Dinesh,9999,0,9999,0
1668055581338,ECE 200,004,103589,Cheng; Chung Kuan,9999,0,9999,0
1668055581338,ECE 200,005,103590,Cosman; Pamela C.,9999,0,9999,0
1668055581338,ECE 200,006,103591,Dayeh; Shadi Ahmad,9999,0,9999,0
1668055581338,ECE 200,007,103592,Fainman; Yeshaiahu,9999,0,9999,0
1668055581338,ECE 200,008,103593,Ford; Joseph Earl,9999,0,9999,0
1668055581338,ECE 200,009,103594,Franceschetti; Massimo,9999,0,9999,0
1668055581338,ECE 200,010,103595,Fullerton; Eric E,9999,0,9999,0
1668055581338,ECE 200,011,103596,Galton; Ian A,9999,0,9999,0
1668055581338,ECE 200,012,103597,Gilja; Vikash,9999,0,9999,0
1668055581338,ECE 200,013,103598,Hall; Drew A.,9999,0,9999,0
1668055581338,ECE 200,014,103599,Hsueh; Tzu-Chien,9999,0,9999,0
1668055581338,ECE 200,015,103600,Javidi; Tara,9999,0,9999,0
1668055581338,ECE 200,016,103601,Kahng; Andrew Byun,9999,0,9999,0
1668055581338,ECE 200,017,103602,Kim; Young-Han,9999,0,9999,0
1668055581338,ECE 200,018,103603,Koushanfar; Farinaz,9999,0,9999,0
1668055581338,ECE 200,019,103604,Kuzum; Duygu,9999,0,9999,0
1668055581338,ECE 200,020,103605,Le; Hanh-Phuc,9999,0,9999,0
1668055581338,ECE 200,021,103606,Lin; Bill,9999,0,9999,0
1668055581338,ECE 200,022,103607,Liu; Zhaowei,9998,0,9999,1
1668055581338,ECE 200,023,103608,Lo; Yu-Hwa,9999,0,9999,0
1668055581338,ECE 200,024,103609,Lomakin; Vitaliy,9999,0,9999,0
1668055581338,ECE 200,025,103610,Mercier; Patrick Philip,9999,0,9999,0
1668055581338,ECE 200,026,103611,Meyer; Florian,9999,0,9999,0
1668055581338,ECE 200,027,103612,Milstein; Laurence B.,9999,0,9999,0
1668055581338,ECE 200,028,103613,Mir Arabbaygi; Siavash,9999,0,9999,0
1668055581338,ECE 200,029,103614,Mookherjea; Shayan,9999,0,9999,0
1668055581338,ECE 200,030,103615,Morris; Karcher William,9999,0,9999,0
1668055581338,ECE 200,031,103616,Ng; Tse Nga,9999,0,9999,0
1668055581338,ECE 200,032,103617,Nguyen; Truong Quang,9999,0,9999,0
1668055581338,ECE 200,033,103618,Nomura; Kenji,9999,0,9999,0
1668055581338,ECE 200,034,103619,Orlitsky; Alon,9999,0,9999,0
1668055581338,ECE 200,035,103620,Pal; Piya,9999,0,9999,0
1668055581338,ECE 200,036,103621,Papen; George C.,9999,0,9999,0
1668055581338,ECE 200,037,103622,Radic; Stojan,9999,0,9999,0
1668055581338,ECE 200,038,103623,Rao; Bhaskar D.,9999,0,9999,0
1668055581338,ECE 200,039,103624,Rao; Ramesh R,9999,0,9999,0
1668055581338,ECE 200,040,103625,Rebeiz; Gabriel,9999,0,9999,0
1668055581338,ECE 200,041,103626,Sanford; John R,9999,0,9999,0
1668055581338,ECE 200,042,103627,Siegel; Paul H.,9999,0,9999,0
1668055581338,ECE 200,043,103628,Sievenpiper; Daniel F.,9999,0,9999,0
1668055581338,ECE 200,044,103629,Sworder; David D.,9999,0,9999,0
1668055581338,ECE 200,045,103630,Taur; Yuan,9999,0,9999,0
1668055581338,ECE 200,046,103631,Touri; Behrouz,9999,0,9999,0
1668055581338,ECE 200,047,103632,Trivedi; Mohan M.,9999,0,9999,0
1668055581338,ECE 200,048,103633,Vasconcelos; Nuno,9999,0,9999,0
1668055581338,ECE 200,049,103634,Wang; Xiaolong,9999,0,9999,0
1668055581338,ECE 200,050,103635,Xie; Pengtao,9999,0,9999,0
1668055581338,ECE 200,051,103636,Yip; Michael,9999,0,9999,0
1668055581338,ECE 200,052,103637,Zeger; Kenneth A.,999,0,999,0
1668055581338,ECE 200,053,103638,Zhang; Xinyu,9999,0,9999,0
1668055581338,ECE 200,054,103639,Turakhia; Yatish Girish,9999,0,9999,0
1668055581338,ECE 200,055,103640,Kang; Mingu,9999,0,9999,0
1668055581338,ECE 200,056,103641,Shi; Yuanyuan,9999,0,9999,0
1668055581338,ECE 200,057,103642,Wang; Edward Jay,9999,0,9999,0
1668055581338,ECE 200,058,103643,Zheng; Yang,9999,0,9999,0
1668055581763,ECE 202,A00,103644,Kuzum; Duygu,0,0,0,0
1668055582192,ECE 212BN,A00,103646,Ng; Tse Nga,0,0,0,0
1668055582621,ECE 221,A00,111493,Staff,0,0,0,0
1668055583060,ECE 222B,A00,103647,Lomakin; Vitaliy,0,0,0,0
1668055583491,ECE 230B,A00,103648,Taur; Yuan,0,0,0,0
1668055583923,ECE 238B,A00,103649,Garay; Javier,0,0,0,0
1668055584346,ECE 240B,A00,112900,Fainman; Yeshaiahu,0,0,0,0
1668055584772,ECE 247A,A00,103650,Jokerst; Jesse Vincent,0,0,0,0
1668055585205,ECE 247B,A00,103651,Wang; Joseph,0,0,0,0
1668055585628,ECE 250,A00,103652,Siegel; Paul H.,0,0,0,0
1668055586056,ECE 251A,A00,103654,Rao; Bhaskar D.,0,0,0,0
1668055586494,ECE 257B,A00,103655,Bharadia; Dinesh,0,0,0,0
1668055586933,ECE 258A,A00,103656,Milstein; Laurence B.,0,0,0,0
1668055587357,ECE 260B,A00,103658,Kang; Mingu,0,0,0,0
1668055587785,ECE 264A,A00,103659,Galton; Ian A,0,0,0,0
1668055588227,ECE 265A,A00,103661,Gudem; Prasad S.S.,0,0,0,0
1668055588665,ECE 265D,A00,103662,Gudem; Prasad S.S.,0,0,0,0
1668055589102,ECE 268,A00,103663,Koushanfar; Farinaz,0,0,0,0
1668055589535,ECE 269,A01,103665,Pal; Piya,0,0,0,0
1668055589961,ECE 271B,A00,103666,Vasconcelos; Manuela,0,0,0,0
1668055590387,ECE 276A,A00,103667,Atanasov; Nikolay A.,0,0,0,0
1668055590812,ECE 277,A00,103668,An; Cheolhong,0,0,0,0
1668055591235,ECE 279,A00,117947,Hall; Drew A.,0,0,0,0
1668055592083,ECE 283,A00,103670,Hsueh; Tzu-Chien,0,0,0,0
1668055592506,ECE 284,A00,103671,Turakhia; Yatish Girish,0,0,0,0
1668055592930,ECE 285,A00,103672,Zheng; Yang,0,0,0,0
1668055592930,ECE 285,B00,103673,Sworder; David D.,0,0,0,0
1668055593367,ECE 287,A00,103676,Javidi; Tara,0,0,0,0
1668055593802,MATH 200B,A00,098023,Salehi Golsefidy; Alireza,13,0,15,2
1668055594236,MATH 202B,A00,098024,Rhoades; Brendon Patrick,9,0,15,6
1668055594666,MATH 203B,A00,098025,Oprea; Dragos N.,11,0,15,4
1668055595089,MATH 204B,A00,098026,Sorensen; Claus M,13,0,15,2
1668055595531,MATH 208,A00,098027,Izadi; Elham,7,0,10,3
1668055595956,MATH 209,A00,098028,Pollack; Aaron,10,0,10,0
1668055596380,MATH 211A,A00,112919,Rogalski; Daniel,9,0,10,1
1668055596808,MATH 211B,A00,112920,Seward; Brandon M.,9,0,10,1
1668055597232,MATH 218,A00,098029,Li; Bo,10,0,10,0
1668055597656,MATH 220B,A00,098030,Novak; Jonathan I,13,0,15,2
1668055598077,MATH 221A,A00,098031,Ebenfelt; Peter F,13,0,15,2
1668055598506,MATH 231B,A00,098032,Zlatos; Andrej,12,0,15,3
1668055598931,MATH 240B,A00,098033,Ni; Lei,9,0,15,6
1668055599354,MATH 243,A00,098034,Jekel; David Andrew,10,0,10,0
1668055599776,MATH 245A,A00,098035,Nie; Jiawang,0,0,15,16
1668055600201,MATH 248,A00,098036,Bejenaru; Ioan,10,0,10,0
1668055600632,MATH 250B,A00,098037,Spolaor; Luca,14,0,15,1
1668055601055,MATH 258,A00,098038,Ni; Lei,10,0,10,0
1668055601479,MATH 264B,A00,098041,Rhoades; Brendon Patrick,10,0,15,5
1668055601904,MATH 268,A00,098042,Buss; Samuel R,10,0,10,0
1668055602327,MATH 269,A00,098043,Rhoades; Brendon Patrick,10,0,10,0
1668055602750,MATH 270B,A00,098044,Li; Bo,11,0,15,4
1668055603173,MATH 272B,A00,098045,Holst; Michael J,13,0,15,2
1668055603598,MATH 273A,A00,098046,Tian; Xiaochuan,10,0,15,5
1668055604023,MATH 275,A01,098048,Tian; Xiaochuan,6,0,10,4
1668055604450,MATH 278A,A00,098049,Holst; Michael J,8,0,10,2
1668055604882,MATH 278B,A00,098050,Cloninger; Alexander,10,0,10,0
1668055605307,MATH 278C,A00,098051,Nie; Jiawang,7,0,10,3
1668055605729,MATH 280B,A00,098052,Zheng; Tianyi,10,0,15,5
1668055606164,MATH 281B,A00,098053,Bradic; Jelena,3,0,15,12
1668055606607,MATH 282B,A00,098054,Arias-Castro; Ery,0,0,15,15
1668055607031,MATH 285,A00,098055,Fitzsimmons; Patrick J,0,0,15,17
1668055607458,MATH 287B,A00,098056,Arias-Castro; Ery,3,0,15,12
1668055607887,MATH 288,A00,098057,Agarwal; Pooja,9,0,10,1
1668055607887,MATH 288,B00,098058,Zhang; Danna,8,0,10,2
1668055607887,MATH 288,C00,098059,Williams; Ruth J,10,0,10,0
1668055608321,MATH 290B,A00,098060,Roberts; Justin Deritter,13,0,15,2
1668055608744,MATH 292,A00,098061,Belmont; Eva Kinoshita,10,0,10,0
1668055609168,MATH 295,A00,098062,Suk; Andrew Hoon,48,0,50,2
1668055609607,MATH 296,A00,098063,Novak; Jonathan I,20,0,20,0
1668055610029,MATH 297,001,098064,Gamst; Anthony Collins,9997,0,9999,2
1668056112346,COGS 205,A00,101395,Chiba; Andrea,19,0,20,1
1668056112775,COGS 210B,001,101404,Greene; Deanna Jacquelyn,9998,0,9999,1
1668056112775,COGS 210B,002,101417,Xia; Haijun,9999,0,9999,0
1668056112775,COGS 210B,003,101422,Nitz; Douglas A.,9999,0,9999,0
1668056112775,COGS 210B,004,101423,Hollan; James D.,9998,0,9999,1
1668056112775,COGS 210B,005,101424,Deak; Gedeon O.,9998,0,9999,1
1668056112775,COGS 210B,006,101425,Rossano; Federico,9999,0,9999,0
1668056113198,COGS 211B,A00,101427,Coulson; Seana M,9996,0,9999,3
1668056113627,COGS 220,A00,101428,Hollan; James D.,0,0,25,25
1668056114050,COGS 229,A00,101429,Dow; Steven P,18,0,25,7
1668056114473,COGS 230,A00,101430,Klemmer; Scott R,13,0,17,4
1668056114899,COGS 234,A00,101431,Xia; Haijun,4,0,25,21
1668056115322,COGS 260,A00,101432,Kiyonaga; Anastasia,19,0,25,6
1668056115322,COGS 260,B00,101433,Kirsh; David Joel,16,0,25,9
1668056115754,CSE 202,A00,102371,Impagliazzo; Russell,0,0,0,0
1668056116186,CSE 203B,A01,102373,Cheng; Chung Kuan,0,0,0,0
1668056116614,CSE 208,A00,102374,Micciancio; Daniele,0,0,0,0
1668056117036,CSE 209A,A00,112895,Impagliazzo; Russell,0,0,15,15
1668056117461,CSE 209B,A00,108005,Bellare; Mihir,0,0,0,0
1668056117885,CSE 210,A00,113163,Coblenz; Michael J,0,0,0,0
1668056118321,CSE 219,A00,106111,Dow; Steven P,0,0,20,20
1668056118746,CSE 221,A00,102376,Voelker; Geoffrey M.,0,0,0,0
1668056119173,CSE 224,A01,102378,Porter; George M,0,0,0,0
1668056119613,CSE 229A,A00,102379,Savage; Stefan,0,0,0,0
1668056120039,CSE 229C,A00,102380,Munyaka; Imani N. S.,0,0,0,0
1668056120464,CSE 232B,A00,102382,Deutsch; Alin Bernard,0,0,0,0
1668056120894,CSE 234,A01,112904,Kumar; Arun Kumar,0,0,0,0
1668056121317,CSE 237A,A00,102383,Rosing; Tajana Simunic,0,0,0,0
1668056121742,CSE 239A,A00,102384,Deutsch; Alin Bernard,0,0,0,0
1668056122166,CSE 239B,A00,102385,Polikarpova; Nadezhda,0,0,0,0
1668056122601,CSE 240A,A00,102386,Pannuto; Patrick William,0,0,0,0
1668056123025,CSE 240B,A00,102387,Zhao; Jishen,0,0,0,0
1668056123456,CSE 241A,A00,106406,Kang; Mingu,0,0,0,0
1668056123891,CSE 249B,A00,102388,Kahng; Andrew Byun,0,0,8,8
1668056124338,CSE 251B,A01,102392,Cottrell; Garrison W,0,0,0,0
1668056124338,CSE 251B,A02,102393,Cottrell; Garrison W,0,0,0,0
1668056124764,CSE 252B,A00,102394,Ochoa; Benjamin Lawrence,0,0,0,0
1668056125198,CSE 257,A01,102396,Gao; Sicun,0,0,0,0
1668056125624,CSE 272,A00,102397,Li; Tzumao,0,0,0,0
1668056126061,CSE 274,A00,111323,Chern; Albert Ren-Haur,0,0,0,0
1668056126486,CSE 282,A00,102398,Pevzner; Pavel Arkadjevich,0,0,0,0
1668056126919,CSE 284,A00,114175,Gymrek; Melissa Ann,0,0,0,0
1668056127344,CSE 290,A00,102399,Chandraker; Manmohan Krishna,0,0,0,0
1668056127344,CSE 290,B00,102400,Vaccaro; Kristen Marie,0,0,25,25
1668056127344,CSE 290,C00,102414,Pannuto; Patrick William,0,0,25,25
1668056127344,CSE 290,D00,102427,Pevzner; Pavel Arkadjevich,0,0,0,0
1668056127344,CSE 290,E00,102429,Zhao; Jishen,0,0,0,0
1668056127344,CSE 290,F00,102436,Tullsen; Dean Michael,0,0,0,0
1668056127344,CSE 290,G00,102440,Christensen; Henrik I,0,0,20,20
1668056127772,CSE 291,A00,102443,Su; Hao,0,0,0,0
1668056127772,CSE 291,B00,102448,Polikarpova; Nadezhda,0,0,0,0
1668056127772,CSE 291,C00,102453,Vaccaro; Kristen Marie,0,0,0,0
1668056127772,CSE 291,D00,111343,Savage; Stefan,0,0,0,0
1668056127772,CSE 291,E00,116474,Claffy; Kimberly Claire,0,0,0,0
1668056127772,CSE 291,F00,116479,Pasquale; Joseph,0,0,0,0
1668056128200,CSE 293,001,119111,Bafna; Vineet,9999,0,9999,0
1668056128200,CSE 293,002,119118,Bellare; Mihir,9999,0,9999,0
1668056128200,CSE 293,003,119122,Berg-Kirkpatrick; Taylor D,9999,0,9999,0
1668056128200,CSE 293,004,119135,Christensen; Henrik I,9999,0,9999,0
1668056128200,CSE 293,005,119142,Cottrell; Garrison W,9999,0,9999,0
1668056128200,CSE 293,006,119146,Deutsch; Alin Bernard,9999,0,9999,0
1668056128200,CSE 293,007,119159,Esmaeilzadeh; Hadi,9999,0,9999,0
1668056128200,CSE 293,008,119166,Freund; Yoav,9999,0,9999,0
1668056128200,CSE 293,009,119170,Griswold; William G.,9999,0,9999,0
1668056128200,CSE 293,010,119183,Gymrek; Melissa Ann,9999,0,9999,0
1668056128200,CSE 293,011,119190,Heninger; Nadia A,9999,0,9999,0
1668056128200,CSE 293,012,119230,Impagliazzo; Russell,9999,0,9999,0
1668056128200,CSE 293,013,119232,Jhala; Ranjit,9999,0,9999,0
1668056128200,CSE 293,014,119233,Kahng; Andrew Byun,9999,0,9999,0
1668056128200,CSE 293,015,119298,Kane; Daniel Mertz,9999,0,9999,0
1668056128200,CSE 293,016,119299,Kriegman; David J,9999,0,9999,0
1668056128200,CSE 293,017,119300,Kumar; Arun Kumar,9999,0,9999,0
1668056128200,CSE 293,018,119301,Lerner; Sorin,9999,0,9999,0
1668056128200,CSE 293,019,119302,Lovett; Shachar,9999,0,9999,0
1668056128200,CSE 293,020,119303,McAuley; Julian John,9999,0,9999,0
1668056128200,CSE 293,021,119304,Micciancio; Daniele,9999,0,9999,0
1668056128200,CSE 293,022,119367,Orailoglu; Alex,9999,0,9999,0
1668056128200,CSE 293,023,119382,Paturi; Ramamohan,9999,0,9999,0
1668056128200,CSE 293,024,119404,Polikarpova; Nadezhda,9999,0,9999,0
1668056128200,CSE 293,025,119406,Politz; Joseph Gibbs,9999,0,9999,0
1668056128200,CSE 293,026,119411,Porter; George M,9999,0,9999,0
1668056128200,CSE 293,027,119414,Porter; Leonard Emerson,9999,0,9999,0
1668056128200,CSE 293,028,119416,Ramamoorthi; Ravi,9999,0,9999,0
1668056128200,CSE 293,029,119417,Sahoo; Debashis,9999,0,9999,0
1668056128200,CSE 293,030,119420,Saul; Lawrence,9999,0,9999,0
1668056128200,CSE 293,031,119421,Savage; Stefan,9999,0,9999,0
1668056128200,CSE 293,032,119425,Schulze; Jurgen P.,9999,0,9999,0
1668056128200,CSE 293,033,119426,Snoeren; Alex C.,9999,0,9999,0
1668056128200,CSE 293,034,119428,Shang; Jingbo,9999,0,9999,0
1668056128200,CSE 293,035,119430,Stefan; Deian,9999,0,9999,0
1668056128200,CSE 293,036,119431,Su; Hao,9999,0,9999,0
1668056128200,CSE 293,037,119433,Swanson; Steven James,9999,0,9999,0
1668056128200,CSE 293,038,119435,Tullsen; Dean Michael,9999,0,9999,0
1668056128200,CSE 293,039,119483,Voelker; Geoffrey M.,9999,0,9999,0
1668056128200,CSE 293,040,119537,Zhao; Jishen,9999,0,9999,0
1668056128200,CSE 293,041,119538,Zhou; Yuan-Yuan,9999,0,9999,0
1668056128200,CSE 293,042,119539,Gao; Sicun,9999,0,9999,0
1668056128200,CSE 293,043,119540,Weibel; Nadir,9999,0,9999,0
1668056128200,CSE 293,044,119541,Gupta; Rajesh K.,9999,0,9999,0
1668056128200,CSE 293,045,126410,Vaccaro; Kristen Marie,9999,0,9999,0
1668056128200,CSE 293,046,126411,Klemke; Richard,9999,0,9999,0
1668056128625,CSE 294,A00,102459,Voelker; Geoffrey M.,0,0,0,0
1668056128625,CSE 294,B00,111322,Orailoglu; Alex,0,0,0,0
1668056129055,DSE 201,A00,096914,Deutsch; Alin Bernard,30,0,30,0
1668056129481,DSE 210,A00,096915,Dasgupta; Sanjoy,30,0,30,0
1668056129913,DSE 260A,A00,096916,Altintas De Callaf; Ilkay,30,0,30,0
1668056130385,ECE 200,001,103586,Antipa; Nicholas A,9999,0,9999,0
1668056130385,ECE 200,002,103587,Atanasov; Nikolay A.,9999,0,9999,0
1668056130385,ECE 200,003,103588,Bharadia; Dinesh,9999,0,9999,0
1668056130385,ECE 200,004,103589,Cheng; Chung Kuan,9999,0,9999,0
1668056130385,ECE 200,005,103590,Cosman; Pamela C.,9999,0,9999,0
1668056130385,ECE 200,006,103591,Dayeh; Shadi Ahmad,9999,0,9999,0
1668056130385,ECE 200,007,103592,Fainman; Yeshaiahu,9999,0,9999,0
1668056130385,ECE 200,008,103593,Ford; Joseph Earl,9999,0,9999,0
1668056130385,ECE 200,009,103594,Franceschetti; Massimo,9999,0,9999,0
1668056130385,ECE 200,010,103595,Fullerton; Eric E,9999,0,9999,0
1668056130385,ECE 200,011,103596,Galton; Ian A,9999,0,9999,0
1668056130385,ECE 200,012,103597,Gilja; Vikash,9999,0,9999,0
1668056130385,ECE 200,013,103598,Hall; Drew A.,9999,0,9999,0
1668056130385,ECE 200,014,103599,Hsueh; Tzu-Chien,9999,0,9999,0
1668056130385,ECE 200,015,103600,Javidi; Tara,9999,0,9999,0
1668056130385,ECE 200,016,103601,Kahng; Andrew Byun,9999,0,9999,0
1668056130385,ECE 200,017,103602,Kim; Young-Han,9999,0,9999,0
1668056130385,ECE 200,018,103603,Koushanfar; Farinaz,9999,0,9999,0
1668056130385,ECE 200,019,103604,Kuzum; Duygu,9999,0,9999,0
1668056130385,ECE 200,020,103605,Le; Hanh-Phuc,9999,0,9999,0
1668056130385,ECE 200,021,103606,Lin; Bill,9999,0,9999,0
1668056130385,ECE 200,022,103607,Liu; Zhaowei,9998,0,9999,1
1668056130385,ECE 200,023,103608,Lo; Yu-Hwa,9999,0,9999,0
1668056130385,ECE 200,024,103609,Lomakin; Vitaliy,9999,0,9999,0
1668056130385,ECE 200,025,103610,Mercier; Patrick Philip,9999,0,9999,0
1668056130385,ECE 200,026,103611,Meyer; Florian,9999,0,9999,0
1668056130385,ECE 200,027,103612,Milstein; Laurence B.,9999,0,9999,0
1668056130385,ECE 200,028,103613,Mir Arabbaygi; Siavash,9999,0,9999,0
1668056130385,ECE 200,029,103614,Mookherjea; Shayan,9999,0,9999,0
1668056130385,ECE 200,030,103615,Morris; Karcher William,9999,0,9999,0
1668056130385,ECE 200,031,103616,Ng; Tse Nga,9999,0,9999,0
1668056130385,ECE 200,032,103617,Nguyen; Truong Quang,9999,0,9999,0
1668056130385,ECE 200,033,103618,Nomura; Kenji,9999,0,9999,0
1668056130385,ECE 200,034,103619,Orlitsky; Alon,9999,0,9999,0
1668056130385,ECE 200,035,103620,Pal; Piya,9999,0,9999,0
1668056130385,ECE 200,036,103621,Papen; George C.,9999,0,9999,0
1668056130385,ECE 200,037,103622,Radic; Stojan,9999,0,9999,0
1668056130385,ECE 200,038,103623,Rao; Bhaskar D.,9999,0,9999,0
1668056130385,ECE 200,039,103624,Rao; Ramesh R,9999,0,9999,0
1668056130385,ECE 200,040,103625,Rebeiz; Gabriel,9999,0,9999,0
1668056130385,ECE 200,041,103626,Sanford; John R,9999,0,9999,0
1668056130385,ECE 200,042,103627,Siegel; Paul H.,9999,0,9999,0
1668056130385,ECE 200,043,103628,Sievenpiper; Daniel F.,9999,0,9999,0
1668056130385,ECE 200,044,103629,Sworder; David D.,9999,0,9999,0
1668056130385,ECE 200,045,103630,Taur; Yuan,9999,0,9999,0
1668056130385,ECE 200,046,103631,Touri; Behrouz,9999,0,9999,0
1668056130385,ECE 200,047,103632,Trivedi; Mohan M.,9999,0,9999,0
1668056130385,ECE 200,048,103633,Vasconcelos; Nuno,9999,0,9999,0
1668056130385,ECE 200,049,103634,Wang; Xiaolong,9999,0,9999,0
1668056130385,ECE 200,050,103635,Xie; Pengtao,9999,0,9999,0
1668056130385,ECE 200,051,103636,Yip; Michael,9999,0,9999,0
1668056130385,ECE 200,052,103637,Zeger; Kenneth A.,999,0,999,0
1668056130385,ECE 200,053,103638,Zhang; Xinyu,9999,0,9999,0
1668056130385,ECE 200,054,103639,Turakhia; Yatish Girish,9999,0,9999,0
1668056130385,ECE 200,055,103640,Kang; Mingu,9999,0,9999,0
1668056130385,ECE 200,056,103641,Shi; Yuanyuan,9999,0,9999,0
1668056130385,ECE 200,057,103642,Wang; Edward Jay,9999,0,9999,0
1668056130385,ECE 200,058,103643,Zheng; Yang,9999,0,9999,0
1668056130826,ECE 202,A00,103644,Kuzum; Duygu,0,0,0,0
1668056131258,ECE 212BN,A00,103646,Ng; Tse Nga,0,0,0,0
1668056131684,ECE 221,A00,111493,Staff,0,0,0,0
1668056132125,ECE 222B,A00,103647,Lomakin; Vitaliy,0,0,0,0
1668056132564,ECE 230B,A00,103648,Taur; Yuan,0,0,0,0
1668056132989,ECE 238B,A00,103649,Garay; Javier,0,0,0,0
1668056133414,ECE 240B,A00,112900,Fainman; Yeshaiahu,0,0,0,0
1668056133839,ECE 247A,A00,103650,Jokerst; Jesse Vincent,0,0,0,0
1668056134262,ECE 247B,A00,103651,Wang; Joseph,0,0,0,0
1668056134704,ECE 250,A00,103652,Siegel; Paul H.,0,0,0,0
1668056135140,ECE 251A,A00,103654,Rao; Bhaskar D.,0,0,0,0
1668056135565,ECE 257B,A00,103655,Bharadia; Dinesh,0,0,0,0
1668056135988,ECE 258A,A00,103656,Milstein; Laurence B.,0,0,0,0
1668056136412,ECE 260B,A00,103658,Kang; Mingu,0,0,0,0
1668056136842,ECE 264A,A00,103659,Galton; Ian A,0,0,0,0
1668056137266,ECE 265A,A00,103661,Gudem; Prasad S.S.,0,0,0,0
1668056137694,ECE 265D,A00,103662,Gudem; Prasad S.S.,0,0,0,0
1668056138118,ECE 268,A00,103663,Koushanfar; Farinaz,0,0,0,0
1668056138552,ECE 269,A01,103665,Pal; Piya,0,0,0,0
1668056138977,ECE 271B,A00,103666,Vasconcelos; Manuela,0,0,0,0
1668056139414,ECE 276A,A00,103667,Atanasov; Nikolay A.,0,0,0,0
1668056139839,ECE 277,A00,103668,An; Cheolhong,0,0,0,0
1668056140271,ECE 279,A00,117947,Hall; Drew A.,0,0,0,0
1668056141121,ECE 283,A00,103670,Hsueh; Tzu-Chien,0,0,0,0
1668056141549,ECE 284,A00,103671,Turakhia; Yatish Girish,0,0,0,0
1668056141975,ECE 285,A00,103672,Zheng; Yang,0,0,0,0
1668056141975,ECE 285,B00,103673,Sworder; David D.,0,0,0,0
1668056142399,ECE 287,A00,103676,Javidi; Tara,0,0,0,0
1668056142826,MATH 200B,A00,098023,Salehi Golsefidy; Alireza,13,0,15,2
1668056143252,MATH 202B,A00,098024,Rhoades; Brendon Patrick,9,0,15,6
1668056143680,MATH 203B,A00,098025,Oprea; Dragos N.,11,0,15,4
1668056144106,MATH 204B,A00,098026,Sorensen; Claus M,13,0,15,2
1668056144537,MATH 208,A00,098027,Izadi; Elham,7,0,10,3
1668056144962,MATH 209,A00,098028,Pollack; Aaron,10,0,10,0
1668056145476,MATH 211A,A00,112919,Rogalski; Daniel,9,0,10,1
1668056145901,MATH 211B,A00,112920,Seward; Brandon M.,9,0,10,1
1668056146325,MATH 218,A00,098029,Li; Bo,10,0,10,0
1668056146749,MATH 220B,A00,098030,Novak; Jonathan I,13,0,15,2
1668056147182,MATH 221A,A00,098031,Ebenfelt; Peter F,13,0,15,2
1668056147613,MATH 231B,A00,098032,Zlatos; Andrej,12,0,15,3
1668056148050,MATH 240B,A00,098033,Ni; Lei,9,0,15,6
1668056148473,MATH 243,A00,098034,Jekel; David Andrew,10,0,10,0
1668056148906,MATH 245A,A00,098035,Nie; Jiawang,0,0,15,16
1668056149334,MATH 248,A00,098036,Bejenaru; Ioan,10,0,10,0
1668056149757,MATH 250B,A00,098037,Spolaor; Luca,14,0,15,1
1668056150186,MATH 258,A00,098038,Ni; Lei,10,0,10,0
1668056150630,MATH 264B,A00,098041,Rhoades; Brendon Patrick,10,0,15,5
1668056151054,MATH 268,A00,098042,Buss; Samuel R,10,0,10,0
1668056151478,MATH 269,A00,098043,Rhoades; Brendon Patrick,10,0,10,0
1668056151904,MATH 270B,A00,098044,Li; Bo,11,0,15,4
1668056152329,MATH 272B,A00,098045,Holst; Michael J,13,0,15,2
1668056152756,MATH 273A,A00,098046,Tian; Xiaochuan,10,0,15,5
1668056153192,MATH 275,A01,098048,Tian; Xiaochuan,6,0,10,4
1668056153619,MATH 278A,A00,098049,Holst; Michael J,8,0,10,2
1668056154041,MATH 278B,A00,098050,Cloninger; Alexander,10,0,10,0
1668056154467,MATH 278C,A00,098051,Nie; Jiawang,7,0,10,3
1668056154906,MATH 280B,A00,098052,Zheng; Tianyi,10,0,15,5
1668056155334,MATH 281B,A00,098053,Bradic; Jelena,3,0,15,12
1668056155767,MATH 282B,A00,098054,Arias-Castro; Ery,0,0,15,15
1668056156189,MATH 285,A00,098055,Fitzsimmons; Patrick J,0,0,15,17
1668056156613,MATH 287B,A00,098056,Arias-Castro; Ery,3,0,15,12
1668056157036,MATH 288,A00,098057,Agarwal; Pooja,9,0,10,1
1668056157036,MATH 288,B00,098058,Zhang; Danna,8,0,10,2
1668056157036,MATH 288,C00,098059,Williams; Ruth J,10,0,10,0
1668056157458,MATH 290B,A00,098060,Roberts; Justin Deritter,13,0,15,2
1668056157892,MATH 292,A00,098061,Belmont; Eva Kinoshita,10,0,10,0
1668056158320,MATH 295,A00,098062,Suk; Andrew Hoon,48,0,50,2
1668056158747,MATH 296,A00,098063,Novak; Jonathan I,20,0,20,0
1668056159168,MATH 297,001,098064,Gamst; Anthony Collins,9997,0,9999,2
1668056661295,COGS 205,A00,101395,Chiba; Andrea,19,0,20,1
1668056661727,COGS 210B,001,101404,Greene; Deanna Jacquelyn,9998,0,9999,1
1668056661727,COGS 210B,002,101417,Xia; Haijun,9999,0,9999,0
1668056661727,COGS 210B,003,101422,Nitz; Douglas A.,9999,0,9999,0
1668056661727,COGS 210B,004,101423,Hollan; James D.,9998,0,9999,1
1668056661727,COGS 210B,005,101424,Deak; Gedeon O.,9998,0,9999,1
1668056661727,COGS 210B,006,101425,Rossano; Federico,9999,0,9999,0
1668056662148,COGS 211B,A00,101427,Coulson; Seana M,9996,0,9999,3
1668056662576,COGS 220,A00,101428,Hollan; James D.,0,0,25,25
1668056663004,COGS 229,A00,101429,Dow; Steven P,18,0,25,7
1668056663446,COGS 230,A00,101430,Klemmer; Scott R,13,0,17,4
1668056663880,COGS 234,A00,101431,Xia; Haijun,4,0,25,21
1668056664309,COGS 260,A00,101432,Kiyonaga; Anastasia,19,0,25,6
1668056664309,COGS 260,B00,101433,Kirsh; David Joel,16,0,25,9
1668056664732,CSE 202,A00,102371,Impagliazzo; Russell,0,0,0,0
1668056665156,CSE 203B,A01,102373,Cheng; Chung Kuan,0,0,0,0
1668056665581,CSE 208,A00,102374,Micciancio; Daniele,0,0,0,0
1668056666007,CSE 209A,A00,112895,Impagliazzo; Russell,0,0,15,15
1668056666434,CSE 209B,A00,108005,Bellare; Mihir,0,0,0,0
1668056666866,CSE 210,A00,113163,Coblenz; Michael J,0,0,0,0
1668056667299,CSE 219,A00,106111,Dow; Steven P,0,0,20,20
1668056667814,CSE 221,A00,102376,Voelker; Geoffrey M.,0,0,0,0
1668056668242,CSE 224,A01,102378,Porter; George M,0,0,0,0
1668056668669,CSE 229A,A00,102379,Savage; Stefan,0,0,0,0
1668056669099,CSE 229C,A00,102380,Munyaka; Imani N. S.,0,0,0,0
1668056669525,CSE 232B,A00,102382,Deutsch; Alin Bernard,0,0,0,0
1668056669962,CSE 234,A01,112904,Kumar; Arun Kumar,0,0,0,0
1668056670395,CSE 237A,A00,102383,Rosing; Tajana Simunic,0,0,0,0
1668056670823,CSE 239A,A00,102384,Deutsch; Alin Bernard,0,0,0,0
1668056671247,CSE 239B,A00,102385,Polikarpova; Nadezhda,0,0,0,0
1668056671672,CSE 240A,A00,102386,Pannuto; Patrick William,0,0,0,0
1668056672102,CSE 240B,A00,102387,Zhao; Jishen,0,0,0,0
1668056672534,CSE 241A,A00,106406,Kang; Mingu,0,0,0,0
1668056672975,CSE 249B,A00,102388,Kahng; Andrew Byun,0,0,8,8
1668056673408,CSE 251B,A01,102392,Cottrell; Garrison W,0,0,0,0
1668056673408,CSE 251B,A02,102393,Cottrell; Garrison W,0,0,0,0
1668056673835,CSE 252B,A00,102394,Ochoa; Benjamin Lawrence,0,0,0,0
1668056674269,CSE 257,A01,102396,Gao; Sicun,0,0,0,0
1668056674703,CSE 272,A00,102397,Li; Tzumao,0,0,0,0
1668056675129,CSE 274,A00,111323,Chern; Albert Ren-Haur,0,0,0,0
1668056675559,CSE 282,A00,102398,Pevzner; Pavel Arkadjevich,0,0,0,0
1668056675987,CSE 284,A00,114175,Gymrek; Melissa Ann,0,0,0,0
1668056676411,CSE 290,A00,102399,Chandraker; Manmohan Krishna,0,0,0,0
1668056676411,CSE 290,B00,102400,Vaccaro; Kristen Marie,0,0,25,25
1668056676411,CSE 290,C00,102414,Pannuto; Patrick William,0,0,25,25
1668056676411,CSE 290,D00,102427,Pevzner; Pavel Arkadjevich,0,0,0,0
1668056676411,CSE 290,E00,102429,Zhao; Jishen,0,0,0,0
1668056676411,CSE 290,F00,102436,Tullsen; Dean Michael,0,0,0,0
1668056676411,CSE 290,G00,102440,Christensen; Henrik I,0,0,20,20
1668056676838,CSE 291,A00,102443,Su; Hao,0,0,0,0
1668056676838,CSE 291,B00,102448,Polikarpova; Nadezhda,0,0,0,0
1668056676838,CSE 291,C00,102453,Vaccaro; Kristen Marie,0,0,0,0
1668056676838,CSE 291,D00,111343,Savage; Stefan,0,0,0,0
1668056676838,CSE 291,E00,116474,Claffy; Kimberly Claire,0,0,0,0
1668056676838,CSE 291,F00,116479,Pasquale; Joseph,0,0,0,0
1668056677266,CSE 293,001,119111,Bafna; Vineet,9999,0,9999,0
1668056677266,CSE 293,002,119118,Bellare; Mihir,9999,0,9999,0
1668056677266,CSE 293,003,119122,Berg-Kirkpatrick; Taylor D,9999,0,9999,0
1668056677266,CSE 293,004,119135,Christensen; Henrik I,9999,0,9999,0
1668056677266,CSE 293,005,119142,Cottrell; Garrison W,9999,0,9999,0
1668056677266,CSE 293,006,119146,Deutsch; Alin Bernard,9999,0,9999,0
1668056677266,CSE 293,007,119159,Esmaeilzadeh; Hadi,9999,0,9999,0
1668056677266,CSE 293,008,119166,Freund; Yoav,9999,0,9999,0
1668056677266,CSE 293,009,119170,Griswold; William G.,9999,0,9999,0
1668056677266,CSE 293,010,119183,Gymrek; Melissa Ann,9999,0,9999,0
1668056677266,CSE 293,011,119190,Heninger; Nadia A,9999,0,9999,0
1668056677266,CSE 293,012,119230,Impagliazzo; Russell,9999,0,9999,0
1668056677266,CSE 293,013,119232,Jhala; Ranjit,9999,0,9999,0
1668056677266,CSE 293,014,119233,Kahng; Andrew Byun,9999,0,9999,0
1668056677266,CSE 293,015,119298,Kane; Daniel Mertz,9999,0,9999,0
1668056677266,CSE 293,016,119299,Kriegman; David J,9999,0,9999,0
1668056677266,CSE 293,017,119300,Kumar; Arun Kumar,9999,0,9999,0
1668056677266,CSE 293,018,119301,Lerner; Sorin,9999,0,9999,0
1668056677266,CSE 293,019,119302,Lovett; Shachar,9999,0,9999,0
1668056677266,CSE 293,020,119303,McAuley; Julian John,9999,0,9999,0
1668056677266,CSE 293,021,119304,Micciancio; Daniele,9999,0,9999,0
1668056677266,CSE 293,022,119367,Orailoglu; Alex,9999,0,9999,0
1668056677266,CSE 293,023,119382,Paturi; Ramamohan,9999,0,9999,0
1668056677266,CSE 293,024,119404,Polikarpova; Nadezhda,9999,0,9999,0
1668056677266,CSE 293,025,119406,Politz; Joseph Gibbs,9999,0,9999,0
1668056677266,CSE 293,026,119411,Porter; George M,9999,0,9999,0
1668056677266,CSE 293,027,119414,Porter; Leonard Emerson,9999,0,9999,0
1668056677266,CSE 293,028,119416,Ramamoorthi; Ravi,9999,0,9999,0
1668056677266,CSE 293,029,119417,Sahoo; Debashis,9999,0,9999,0
1668056677266,CSE 293,030,119420,Saul; Lawrence,9999,0,9999,0
1668056677266,CSE 293,031,119421,Savage; Stefan,9999,0,9999,0
1668056677266,CSE 293,032,119425,Schulze; Jurgen P.,9999,0,9999,0
1668056677266,CSE 293,033,119426,Snoeren; Alex C.,9999,0,9999,0
1668056677266,CSE 293,034,119428,Shang; Jingbo,9999,0,9999,0
1668056677266,CSE 293,035,119430,Stefan; Deian,9999,0,9999,0
1668056677266,CSE 293,036,119431,Su; Hao,9999,0,9999,0
1668056677266,CSE 293,037,119433,Swanson; Steven James,9999,0,9999,0
1668056677266,CSE 293,038,119435,Tullsen; Dean Michael,9999,0,9999,0
1668056677266,CSE 293,039,119483,Voelker; Geoffrey M.,9999,0,9999,0
1668056677266,CSE 293,040,119537,Zhao; Jishen,9999,0,9999,0
1668056677266,CSE 293,041,119538,Zhou; Yuan-Yuan,9999,0,9999,0
1668056677266,CSE 293,042,119539,Gao; Sicun,9999,0,9999,0
1668056677266,CSE 293,043,119540,Weibel; Nadir,9999,0,9999,0
1668056677266,CSE 293,044,119541,Gupta; Rajesh K.,9999,0,9999,0
1668056677266,CSE 293,045,126410,Vaccaro; Kristen Marie,9999,0,9999,0
1668056677266,CSE 293,046,126411,Klemke; Richard,9999,0,9999,0
1668056677693,CSE 294,A00,102459,Voelker; Geoffrey M.,0,0,0,0
1668056677693,CSE 294,B00,111322,Orailoglu; Alex,0,0,0,0
1668056678117,DSE 201,A00,096914,Deutsch; Alin Bernard,30,0,30,0
1668056678541,DSE 210,A00,096915,Dasgupta; Sanjoy,30,0,30,0
1668056678967,DSE 260A,A00,096916,Altintas De Callaf; Ilkay,30,0,30,0
1668056680015,ECE 200,001,103586,Antipa; Nicholas A,9999,0,9999,0
1668056680015,ECE 200,002,103587,Atanasov; Nikolay A.,9999,0,9999,0
1668056680015,ECE 200,003,103588,Bharadia; Dinesh,9999,0,9999,0
1668056680015,ECE 200,004,103589,Cheng; Chung Kuan,9999,0,9999,0
1668056680015,ECE 200,005,103590,Cosman; Pamela C.,9999,0,9999,0
1668056680015,ECE 200,006,103591,Dayeh; Shadi Ahmad,9999,0,9999,0
1668056680015,ECE 200,007,103592,Fainman; Yeshaiahu,9999,0,9999,0
1668056680015,ECE 200,008,103593,Ford; Joseph Earl,9999,0,9999,0
1668056680015,ECE 200,009,103594,Franceschetti; Massimo,9999,0,9999,0
1668056680015,ECE 200,010,103595,Fullerton; Eric E,9999,0,9999,0
1668056680015,ECE 200,011,103596,Galton; Ian A,9999,0,9999,0
1668056680015,ECE 200,012,103597,Gilja; Vikash,9999,0,9999,0
1668056680015,ECE 200,013,103598,Hall; Drew A.,9999,0,9999,0
1668056680015,ECE 200,014,103599,Hsueh; Tzu-Chien,9999,0,9999,0
1668056680015,ECE 200,015,103600,Javidi; Tara,9999,0,9999,0
1668056680015,ECE 200,016,103601,Kahng; Andrew Byun,9999,0,9999,0
1668056680015,ECE 200,017,103602,Kim; Young-Han,9999,0,9999,0
1668056680015,ECE 200,018,103603,Koushanfar; Farinaz,9999,0,9999,0
1668056680015,ECE 200,019,103604,Kuzum; Duygu,9999,0,9999,0
1668056680015,ECE 200,020,103605,Le; Hanh-Phuc,9999,0,9999,0
1668056680015,ECE 200,021,103606,Lin; Bill,9999,0,9999,0
1668056680015,ECE 200,022,103607,Liu; Zhaowei,9998,0,9999,1
1668056680015,ECE 200,023,103608,Lo; Yu-Hwa,9999,0,9999,0
1668056680015,ECE 200,024,103609,Lomakin; Vitaliy,9999,0,9999,0
1668056680015,ECE 200,025,103610,Mercier; Patrick Philip,9999,0,9999,0
1668056680015,ECE 200,026,103611,Meyer; Florian,9999,0,9999,0
1668056680015,ECE 200,027,103612,Milstein; Laurence B.,9999,0,9999,0
1668056680015,ECE 200,028,103613,Mir Arabbaygi; Siavash,9999,0,9999,0
1668056680015,ECE 200,029,103614,Mookherjea; Shayan,9999,0,9999,0
1668056680015,ECE 200,030,103615,Morris; Karcher William,9999,0,9999,0
1668056680015,ECE 200,031,103616,Ng; Tse Nga,9999,0,9999,0
1668056680015,ECE 200,032,103617,Nguyen; Truong Quang,9999,0,9999,0
1668056680015,ECE 200,033,103618,Nomura; Kenji,9999,0,9999,0
1668056680015,ECE 200,034,103619,Orlitsky; Alon,9999,0,9999,0
1668056680015,ECE 200,035,103620,Pal; Piya,9999,0,9999,0
1668056680015,ECE 200,036,103621,Papen; George C.,9999,0,9999,0
1668056680015,ECE 200,037,103622,Radic; Stojan,9999,0,9999,0
1668056680015,ECE 200,038,103623,Rao; Bhaskar D.,9999,0,9999,0
1668056680015,ECE 200,039,103624,Rao; Ramesh R,9999,0,9999,0
1668056680015,ECE 200,040,103625,Rebeiz; Gabriel,9999,0,9999,0
1668056680015,ECE 200,041,103626,Sanford; John R,9999,0,9999,0
1668056680015,ECE 200,042,103627,Siegel; Paul H.,9999,0,9999,0
1668056680015,ECE 200,043,103628,Sievenpiper; Daniel F.,9999,0,9999,0
1668056680015,ECE 200,044,103629,Sworder; David D.,9999,0,9999,0
1668056680015,ECE 200,045,103630,Taur; Yuan,9999,0,9999,0
1668056680015,ECE 200,046,103631,Touri; Behrouz,9999,0,9999,0
1668056680015,ECE 200,047,103632,Trivedi; Mohan M.,9999,0,9999,0
1668056680015,ECE 200,048,103633,Vasconcelos; Nuno,9999,0,9999,0
1668056680015,ECE 200,049,103634,Wang; Xiaolong,9999,0,9999,0
1668056680015,ECE 200,050,103635,Xie; Pengtao,9999,0,9999,0
1668056680015,ECE 200,051,103636,Yip; Michael,9999,0,9999,0
1668056680015,ECE 200,052,103637,Zeger; Kenneth A.,999,0,999,0
1668056680015,ECE 200,053,103638,Zhang; Xinyu,9999,0,9999,0
1668056680015,ECE 200,054,103639,Turakhia; Yatish Girish,9999,0,9999,0
1668056680015,ECE 200,055,103640,Kang; Mingu,9999,0,9999,0
1668056680015,ECE 200,056,103641,Shi; Yuanyuan,9999,0,9999,0
1668056680015,ECE 200,057,103642,Wang; Edward Jay,9999,0,9999,0
1668056680015,ECE 200,058,103643,Zheng; Yang,9999,0,9999,0
1668056680439,ECE 202,A00,103644,Kuzum; Duygu,0,0,0,0
1668056680862,ECE 212BN,A00,103646,Ng; Tse Nga,0,0,0,0
1668056681288,ECE 221,A00,111493,Staff,0,0,0,0
1668056681714,ECE 222B,A00,103647,Lomakin; Vitaliy,0,0,0,0
1668056682139,ECE 230B,A00,103648,Taur; Yuan,0,0,0,0
1668056682561,ECE 238B,A00,103649,Garay; Javier,0,0,0,0
1668056682990,ECE 240B,A00,112900,Fainman; Yeshaiahu,0,0,0,0
1668056683414,ECE 247A,A00,103650,Jokerst; Jesse Vincent,0,0,0,0
1668056683841,ECE 247B,A00,103651,Wang; Joseph,0,0,0,0
1668056684276,ECE 250,A00,103652,Siegel; Paul H.,0,0,0,0
1668056684718,ECE 251A,A00,103654,Rao; Bhaskar D.,0,0,0,0
1668056685144,ECE 257B,A00,103655,Bharadia; Dinesh,0,0,0,0
1668056685568,ECE 258A,A00,103656,Milstein; Laurence B.,0,0,0,0
1668056685993,ECE 260B,A00,103658,Kang; Mingu,0,0,0,0
1668056686416,ECE 264A,A00,103659,Galton; Ian A,0,0,0,0
1668056686838,ECE 265A,A00,103661,Gudem; Prasad S.S.,0,0,0,0
1668056687263,ECE 265D,A00,103662,Gudem; Prasad S.S.,0,0,0,0
1668056687685,ECE 268,A00,103663,Koushanfar; Farinaz,0,0,0,0
1668056688110,ECE 269,A01,103665,Pal; Piya,0,0,0,0
1668056688538,ECE 271B,A00,103666,Vasconcelos; Manuela,0,0,0,0
1668056688959,ECE 276A,A00,103667,Atanasov; Nikolay A.,0,0,0,0
1668056689384,ECE 277,A00,103668,An; Cheolhong,0,0,0,0
1668056689811,ECE 279,A00,117947,Hall; Drew A.,0,0,0,0
1668056690663,ECE 283,A00,103670,Hsueh; Tzu-Chien,0,0,0,0
1668056691093,ECE 284,A00,103671,Turakhia; Yatish Girish,0,0,0,0
1668056691519,ECE 285,A00,103672,Zheng; Yang,0,0,0,0
1668056691519,ECE 285,B00,103673,Sworder; David D.,0,0,0,0
1668056691950,ECE 287,A00,103676,Javidi; Tara,0,0,0,0
1668056692373,MATH 200B,A00,098023,Salehi Golsefidy; Alireza,13,0,15,2
1668056692803,MATH 202B,A00,098024,Rhoades; Brendon Patrick,9,0,15,6
1668056693232,MATH 203B,A00,098025,Oprea; Dragos N.,11,0,15,4
1668056693661,MATH 204B,A00,098026,Sorensen; Claus M,13,0,15,2
1668056694084,MATH 208,A00,098027,Izadi; Elham,7,0,10,3
1668056694508,MATH 209,A00,098028,Pollack; Aaron,10,0,10,0
1668056694961,MATH 211A,A00,112919,Rogalski; Daniel,9,0,10,1
1668056695384,MATH 211B,A00,112920,Seward; Brandon M.,9,0,10,1
1668056695806,MATH 218,A00,098029,Li; Bo,10,0,10,0
1668056696234,MATH 220B,A00,098030,Novak; Jonathan I,13,0,15,2
1668056696656,MATH 221A,A00,098031,Ebenfelt; Peter F,13,0,15,2
1668056697088,MATH 231B,A00,098032,Zlatos; Andrej,12,0,15,3
1668056697512,MATH 240B,A00,098033,Ni; Lei,9,0,15,6
1668056697949,MATH 243,A00,098034,Jekel; David Andrew,10,0,10,0
1668056698373,MATH 245A,A00,098035,Nie; Jiawang,0,0,15,16
1668056698798,MATH 248,A00,098036,Bejenaru; Ioan,10,0,10,0
1668056699220,MATH 250B,A00,098037,Spolaor; Luca,14,0,15,1
1668056699654,MATH 258,A00,098038,Ni; Lei,10,0,10,0
1668056700078,MATH 264B,A00,098041,Rhoades; Brendon Patrick,10,0,15,5
1668056700503,MATH 268,A00,098042,Buss; Samuel R,10,0,10,0
1668056700936,MATH 269,A00,098043,Rhoades; Brendon Patrick,10,0,10,0
1668056701360,MATH 270B,A00,098044,Li; Bo,11,0,15,4
1668056701784,MATH 272B,A00,098045,Holst; Michael J,13,0,15,2
1668056702208,MATH 273A,A00,098046,Tian; Xiaochuan,10,0,15,5
1668056702633,MATH 275,A01,098048,Tian; Xiaochuan,6,0,10,4
1668056703058,MATH 278A,A00,098049,Holst; Michael J,8,0,10,2
1668056703487,MATH 278B,A00,098050,Cloninger; Alexander,10,0,10,0
1668056703911,MATH 278C,A00,098051,Nie; Jiawang,7,0,10,3
1668056704338,MATH 280B,A00,098052,Zheng; Tianyi,10,0,15,5
1668056704771,MATH 281B,A00,098053,Bradic; Jelena,3,0,15,12
1668056705213,MATH 282B,A00,098054,Arias-Castro; Ery,0,0,15,15
1668056705654,MATH 285,A00,098055,Fitzsimmons; Patrick J,0,0,15,17
1668056706081,MATH 287B,A00,098056,Arias-Castro; Ery,3,0,15,12
1668056706518,MATH 288,A00,098057,Agarwal; Pooja,9,0,10,1
1668056706518,MATH 288,B00,098058,Zhang; Danna,8,0,10,2
1668056706518,MATH 288,C00,098059,Williams; Ruth J,10,0,10,0
1668056706951,MATH 290B,A00,098060,Roberts; Justin Deritter,13,0,15,2
1668056707375,MATH 292,A00,098061,Belmont; Eva Kinoshita,10,0,10,0
1668056707802,MATH 295,A00,098062,Suk; Andrew Hoon,48,0,50,2
1668056708224,MATH 296,A00,098063,Novak; Jonathan I,20,0,20,0
1668056708666,MATH 297,001,098064,Gamst; Anthony Collins,9997,0,9999,2
1668057222126,COGS 205,A00,101395,Chiba; Andrea,19,0,20,1
1668057222552,COGS 210B,001,101404,Greene; Deanna Jacquelyn,9998,0,9999,1
1668057222552,COGS 210B,002,101417,Xia; Haijun,9999,0,9999,0
1668057222552,COGS 210B,003,101422,Nitz; Douglas A.,9999,0,9999,0
1668057222552,COGS 210B,004,101423,Hollan; James D.,9998,0,9999,1
1668057222552,COGS 210B,005,101424,Deak; Gedeon O.,9998,0,9999,1
1668057222552,COGS 210B,006,101425,Rossano; Federico,9999,0,9999,0
1668057222981,COGS 211B,A00,101427,Coulson; Seana M,9996,0,9999,3
1668057223410,COGS 220,A00,101428,Hollan; James D.,0,0,25,25
1668057223841,COGS 229,A00,101429,Dow; Steven P,18,0,25,7
1668057224265,COGS 230,A00,101430,Klemmer; Scott R,13,0,17,4
1668057224702,COGS 234,A00,101431,Xia; Haijun,4,0,25,21
1668057225147,COGS 260,A00,101432,Kiyonaga; Anastasia,19,0,25,6
1668057225147,COGS 260,B00,101433,Kirsh; David Joel,16,0,25,9
1668057225578,CSE 202,A00,102371,Impagliazzo; Russell,0,0,0,0
1668057226003,CSE 203B,A01,102373,Cheng; Chung Kuan,0,0,0,0
1668057226431,CSE 208,A00,102374,Micciancio; Daniele,0,0,0,0
1668057226858,CSE 209A,A00,112895,Impagliazzo; Russell,0,0,15,15
1668057227286,CSE 209B,A00,108005,Bellare; Mihir,0,0,0,0
1668057227721,CSE 210,A00,113163,Coblenz; Michael J,0,0,0,0
1668057228146,CSE 219,A00,106111,Dow; Steven P,0,0,20,20
1668057228570,CSE 221,A00,102376,Voelker; Geoffrey M.,0,0,0,0
1668057228994,CSE 224,A01,102378,Porter; George M,0,0,0,0
1668057229423,CSE 229A,A00,102379,Savage; Stefan,0,0,0,0
1668057229864,CSE 229C,A00,102380,Munyaka; Imani N. S.,0,0,0,0
1668057230295,CSE 232B,A00,102382,Deutsch; Alin Bernard,0,0,0,0
1668057230718,CSE 234,A01,112904,Kumar; Arun Kumar,0,0,0,0
1668057231156,CSE 237A,A00,102383,Rosing; Tajana Simunic,0,0,0,0
1668057231586,CSE 239A,A00,102384,Deutsch; Alin Bernard,0,0,0,0
1668057232008,CSE 239B,A00,102385,Polikarpova; Nadezhda,0,0,0,0
1668057232431,CSE 240A,A00,102386,Pannuto; Patrick William,0,0,0,0
1668057232860,CSE 240B,A00,102387,Zhao; Jishen,0,0,0,0
1668057233290,CSE 241A,A00,106406,Kang; Mingu,0,0,0,0
1668057233714,CSE 249B,A00,102388,Kahng; Andrew Byun,0,0,8,8
1668057234143,CSE 251B,A01,102392,Cottrell; Garrison W,0,0,0,0
1668057234143,CSE 251B,A02,102393,Cottrell; Garrison W,0,0,0,0
1668057234567,CSE 252B,A00,102394,Ochoa; Benjamin Lawrence,0,0,0,0
1668057234999,CSE 257,A01,102396,Gao; Sicun,0,0,0,0
1668057235432,CSE 272,A00,102397,Li; Tzumao,0,0,0,0
1668057235867,CSE 274,A00,111323,Chern; Albert Ren-Haur,0,0,0,0
1668057236299,CSE 282,A00,102398,Pevzner; Pavel Arkadjevich,0,0,0,0
1668057236723,CSE 284,A00,114175,Gymrek; Melissa Ann,0,0,0,0
1668057237155,CSE 290,A00,102399,Chandraker; Manmohan Krishna,0,0,0,0
1668057237155,CSE 290,B00,102400,Vaccaro; Kristen Marie,0,0,25,25
1668057237155,CSE 290,C00,102414,Pannuto; Patrick William,0,0,25,25
1668057237155,CSE 290,D00,102427,Pevzner; Pavel Arkadjevich,0,0,0,0
1668057237155,CSE 290,E00,102429,Zhao; Jishen,0,0,0,0
1668057237155,CSE 290,F00,102436,Tullsen; Dean Michael,0,0,0,0
1668057237155,CSE 290,G00,102440,Christensen; Henrik I,0,0,20,20
1668057237585,CSE 291,A00,102443,Su; Hao,0,0,0,0
1668057237585,CSE 291,B00,102448,Polikarpova; Nadezhda,0,0,0,0
1668057237585,CSE 291,C00,102453,Vaccaro; Kristen Marie,0,0,0,0
1668057237585,CSE 291,D00,111343,Savage; Stefan,0,0,0,0
1668057237585,CSE 291,E00,116474,Claffy; Kimberly Claire,0,0,0,0
1668057237585,CSE 291,F00,116479,Pasquale; Joseph,0,0,0,0
1668057238015,CSE 293,001,119111,Bafna; Vineet,9999,0,9999,0
1668057238015,CSE 293,002,119118,Bellare; Mihir,9999,0,9999,0
1668057238015,CSE 293,003,119122,Berg-Kirkpatrick; Taylor D,9999,0,9999,0
1668057238015,CSE 293,004,119135,Christensen; Henrik I,9999,0,9999,0
1668057238015,CSE 293,005,119142,Cottrell; Garrison W,9999,0,9999,0
1668057238015,CSE 293,006,119146,Deutsch; Alin Bernard,9999,0,9999,0
1668057238015,CSE 293,007,119159,Esmaeilzadeh; Hadi,9999,0,9999,0
1668057238015,CSE 293,008,119166,Freund; Yoav,9999,0,9999,0
1668057238015,CSE 293,009,119170,Griswold; William G.,9999,0,9999,0
1668057238015,CSE 293,010,119183,Gymrek; Melissa Ann,9999,0,9999,0
1668057238015,CSE 293,011,119190,Heninger; Nadia A,9999,0,9999,0
1668057238015,CSE 293,012,119230,Impagliazzo; Russell,9999,0,9999,0
1668057238015,CSE 293,013,119232,Jhala; Ranjit,9999,0,9999,0
1668057238015,CSE 293,014,119233,Kahng; Andrew Byun,9999,0,9999,0
1668057238015,CSE 293,015,119298,Kane; Daniel Mertz,9999,0,9999,0
1668057238015,CSE 293,016,119299,Kriegman; David J,9999,0,9999,0
1668057238015,CSE 293,017,119300,Kumar; Arun Kumar,9999,0,9999,0
1668057238015,CSE 293,018,119301,Lerner; Sorin,9999,0,9999,0
1668057238015,CSE 293,019,119302,Lovett; Shachar,9999,0,9999,0
1668057238015,CSE 293,020,119303,McAuley; Julian John,9999,0,9999,0
1668057238015,CSE 293,021,119304,Micciancio; Daniele,9999,0,9999,0
1668057238015,CSE 293,022,119367,Orailoglu; Alex,9999,0,9999,0
1668057238015,CSE 293,023,119382,Paturi; Ramamohan,9999,0,9999,0
1668057238015,CSE 293,024,119404,Polikarpova; Nadezhda,9999,0,9999,0
1668057238015,CSE 293,025,119406,Politz; Joseph Gibbs,9999,0,9999,0
1668057238015,CSE 293,026,119411,Porter; George M,9999,0,9999,0
1668057238015,CSE 293,027,119414,Porter; Leonard Emerson,9999,0,9999,0
1668057238015,CSE 293,028,119416,Ramamoorthi; Ravi,9999,0,9999,0
1668057238015,CSE 293,029,119417,Sahoo; Debashis,9999,0,9999,0
1668057238015,CSE 293,030,119420,Saul; Lawrence,9999,0,9999,0
1668057238015,CSE 293,031,119421,Savage; Stefan,9999,0,9999,0
1668057238015,CSE 293,032,119425,Schulze; Jurgen P.,9999,0,9999,0
1668057238015,CSE 293,033,119426,Snoeren; Alex C.,9999,0,9999,0
1668057238015,CSE 293,034,119428,Shang; Jingbo,9999,0,9999,0
1668057238015,CSE 293,035,119430,Stefan; Deian,9999,0,9999,0
1668057238015,CSE 293,036,119431,Su; Hao,9999,0,9999,0
1668057238015,CSE 293,037,119433,Swanson; Steven James,9999,0,9999,0
1668057238015,CSE 293,038,119435,Tullsen; Dean Michael,9999,0,9999,0
1668057238015,CSE 293,039,119483,Voelker; Geoffrey M.,9999,0,9999,0
1668057238015,CSE 293,040,119537,Zhao; Jishen,9999,0,9999,0
1668057238015,CSE 293,041,119538,Zhou; Yuan-Yuan,9999,0,9999,0
1668057238015,CSE 293,042,119539,Gao; Sicun,9999,0,9999,0
1668057238015,CSE 293,043,119540,Weibel; Nadir,9999,0,9999,0
1668057238015,CSE 293,044,119541,Gupta; Rajesh K.,9999,0,9999,0
1668057238015,CSE 293,045,126410,Vaccaro; Kristen Marie,9999,0,9999,0
1668057238015,CSE 293,046,126411,Klemke; Richard,9999,0,9999,0
1668057238437,CSE 294,A00,102459,Voelker; Geoffrey M.,0,0,0,0
1668057238437,CSE 294,B00,111322,Orailoglu; Alex,0,0,0,0
1668057238866,DSE 201,A00,096914,Deutsch; Alin Bernard,30,0,30,0
1668057239299,DSE 210,A00,096915,Dasgupta; Sanjoy,30,0,30,0
1668057239724,DSE 260A,A00,096916,Altintas De Callaf; Ilkay,30,0,30,0
1668057240164,ECE 200,001,103586,Antipa; Nicholas A,9999,0,9999,0
1668057240164,ECE 200,002,103587,Atanasov; Nikolay A.,9999,0,9999,0
1668057240164,ECE 200,003,103588,Bharadia; Dinesh,9999,0,9999,0
1668057240164,ECE 200,004,103589,Cheng; Chung Kuan,9999,0,9999,0
1668057240164,ECE 200,005,103590,Cosman; Pamela C.,9999,0,9999,0
1668057240164,ECE 200,006,103591,Dayeh; Shadi Ahmad,9999,0,9999,0
1668057240164,ECE 200,007,103592,Fainman; Yeshaiahu,9999,0,9999,0
1668057240164,ECE 200,008,103593,Ford; Joseph Earl,9999,0,9999,0
1668057240164,ECE 200,009,103594,Franceschetti; Massimo,9999,0,9999,0
1668057240164,ECE 200,010,103595,Fullerton; Eric E,9999,0,9999,0
1668057240164,ECE 200,011,103596,Galton; Ian A,9999,0,9999,0
1668057240164,ECE 200,012,103597,Gilja; Vikash,9999,0,9999,0
1668057240164,ECE 200,013,103598,Hall; Drew A.,9999,0,9999,0
1668057240164,ECE 200,014,103599,Hsueh; Tzu-Chien,9999,0,9999,0
1668057240164,ECE 200,015,103600,Javidi; Tara,9999,0,9999,0
1668057240164,ECE 200,016,103601,Kahng; Andrew Byun,9999,0,9999,0
1668057240164,ECE 200,017,103602,Kim; Young-Han,9999,0,9999,0
1668057240164,ECE 200,018,103603,Koushanfar; Farinaz,9999,0,9999,0
1668057240164,ECE 200,019,103604,Kuzum; Duygu,9999,0,9999,0
1668057240164,ECE 200,020,103605,Le; Hanh-Phuc,9999,0,9999,0
1668057240164,ECE 200,021,103606,Lin; Bill,9999,0,9999,0
1668057240164,ECE 200,022,103607,Liu; Zhaowei,9998,0,9999,1
1668057240164,ECE 200,023,103608,Lo; Yu-Hwa,9999,0,9999,0
1668057240164,ECE 200,024,103609,Lomakin; Vitaliy,9999,0,9999,0
1668057240164,ECE 200,025,103610,Mercier; Patrick Philip,9999,0,9999,0
1668057240164,ECE 200,026,103611,Meyer; Florian,9999,0,9999,0
1668057240164,ECE 200,027,103612,Milstein; Laurence B.,9999,0,9999,0
1668057240164,ECE 200,028,103613,Mir Arabbaygi; Siavash,9999,0,9999,0
1668057240164,ECE 200,029,103614,Mookherjea; Shayan,9999,0,9999,0
1668057240164,ECE 200,030,103615,Morris; Karcher William,9999,0,9999,0
1668057240164,ECE 200,031,103616,Ng; Tse Nga,9999,0,9999,0
1668057240164,ECE 200,032,103617,Nguyen; Truong Quang,9999,0,9999,0
1668057240164,ECE 200,033,103618,Nomura; Kenji,9999,0,9999,0
1668057240164,ECE 200,034,103619,Orlitsky; Alon,9999,0,9999,0
1668057240164,ECE 200,035,103620,Pal; Piya,9999,0,9999,0
1668057240164,ECE 200,036,103621,Papen; George C.,9999,0,9999,0
1668057240164,ECE 200,037,103622,Radic; Stojan,9999,0,9999,0
1668057240164,ECE 200,038,103623,Rao; Bhaskar D.,9999,0,9999,0
1668057240164,ECE 200,039,103624,Rao; Ramesh R,9999,0,9999,0
1668057240164,ECE 200,040,103625,Rebeiz; Gabriel,9999,0,9999,0
1668057240164,ECE 200,041,103626,Sanford; John R,9999,0,9999,0
1668057240164,ECE 200,042,103627,Siegel; Paul H.,9999,0,9999,0
1668057240164,ECE 200,043,103628,Sievenpiper; Daniel F.,9999,0,9999,0
1668057240164,ECE 200,044,103629,Sworder; David D.,9999,0,9999,0
1668057240164,ECE 200,045,103630,Taur; Yuan,9999,0,9999,0
1668057240164,ECE 200,046,103631,Touri; Behrouz,9999,0,9999,0
1668057240164,ECE 200,047,103632,Trivedi; Mohan M.,9999,0,9999,0
1668057240164,ECE 200,048,103633,Vasconcelos; Nuno,9999,0,9999,0
1668057240164,ECE 200,049,103634,Wang; Xiaolong,9999,0,9999,0
1668057240164,ECE 200,050,103635,Xie; Pengtao,9999,0,9999,0
1668057240164,ECE 200,051,103636,Yip; Michael,9999,0,9999,0
1668057240164,ECE 200,052,103637,Zeger; Kenneth A.,999,0,999,0
1668057240164,ECE 200,053,103638,Zhang; Xinyu,9999,0,9999,0
1668057240164,ECE 200,054,103639,Turakhia; Yatish Girish,9999,0,9999,0
1668057240164,ECE 200,055,103640,Kang; Mingu,9999,0,9999,0
1668057240164,ECE 200,056,103641,Shi; Yuanyuan,9999,0,9999,0
1668057240164,ECE 200,057,103642,Wang; Edward Jay,9999,0,9999,0
1668057240164,ECE 200,058,103643,Zheng; Yang,9999,0,9999,0
1668057240596,ECE 202,A00,103644,Kuzum; Duygu,0,0,0,0
1668057241037,ECE 212BN,A00,103646,Ng; Tse Nga,0,0,0,0
1668057241470,ECE 221,A00,111493,Staff,0,0,0,0
1668057241898,ECE 222B,A00,103647,Lomakin; Vitaliy,0,0,0,0
1668057242331,ECE 230B,A00,103648,Taur; Yuan,0,0,0,0
1668057242762,ECE 238B,A00,103649,Garay; Javier,0,0,0,0
1668057243194,ECE 240B,A00,112900,Fainman; Yeshaiahu,0,0,0,0
1668057243620,ECE 247A,A00,103650,Jokerst; Jesse Vincent,0,0,0,0
1668057244045,ECE 247B,A00,103651,Wang; Joseph,0,0,0,0
1668057244473,ECE 250,A00,103652,Siegel; Paul H.,0,0,0,0
1668057244915,ECE 251A,A00,103654,Rao; Bhaskar D.,0,0,0,0
1668057245433,ECE 257B,A00,103655,Bharadia; Dinesh,0,0,0,0
1668057245858,ECE 258A,A00,103656,Milstein; Laurence B.,0,0,0,0
1668057246290,ECE 260B,A00,103658,Kang; Mingu,0,0,0,0
1668057246727,ECE 264A,A00,103659,Galton; Ian A,0,0,0,0
1668057247151,ECE 265A,A00,103661,Gudem; Prasad S.S.,0,0,0,0
1668057247579,ECE 265D,A00,103662,Gudem; Prasad S.S.,0,0,0,0
1668057248013,ECE 268,A00,103663,Koushanfar; Farinaz,0,0,0,0
1668057248458,ECE 269,A01,103665,Pal; Piya,0,0,0,0
1668057248884,ECE 271B,A00,103666,Vasconcelos; Manuela,0,0,0,0
1668057249309,ECE 276A,A00,103667,Atanasov; Nikolay A.,0,0,0,0
1668057249737,ECE 277,A00,103668,An; Cheolhong,0,0,0,0
1668057250159,ECE 279,A00,117947,Hall; Drew A.,0,0,0,0
1668057251008,ECE 283,A00,103670,Hsueh; Tzu-Chien,0,0,0,0
1668057251439,ECE 284,A00,103671,Turakhia; Yatish Girish,0,0,0,0
1668057251866,ECE 285,A00,103672,Zheng; Yang,0,0,0,0
1668057251866,ECE 285,B00,103673,Sworder; David D.,0,0,0,0
1668057252296,ECE 287,A00,103676,Javidi; Tara,0,0,0,0
1668057252738,MATH 200B,A00,098023,Salehi Golsefidy; Alireza,13,0,15,2
1668057253171,MATH 202B,A00,098024,Rhoades; Brendon Patrick,9,0,15,6
1668057253600,MATH 203B,A00,098025,Oprea; Dragos N.,11,0,15,4
1668057254022,MATH 204B,A00,098026,Sorensen; Claus M,13,0,15,2
1668057254450,MATH 208,A00,098027,Izadi; Elham,7,0,10,3
1668057254881,MATH 209,A00,098028,Pollack; Aaron,10,0,10,0
1668057255303,MATH 211A,A00,112919,Rogalski; Daniel,9,0,10,1
1668057255726,MATH 211B,A00,112920,Seward; Brandon M.,9,0,10,1
1668057256156,MATH 218,A00,098029,Li; Bo,10,0,10,0
1668057256588,MATH 220B,A00,098030,Novak; Jonathan I,13,0,15,2
1668057257012,MATH 221A,A00,098031,Ebenfelt; Peter F,13,0,15,2
1668057257439,MATH 231B,A00,098032,Zlatos; Andrej,12,0,15,3
1668057257862,MATH 240B,A00,098033,Ni; Lei,9,0,15,6
1668057258285,MATH 243,A00,098034,Jekel; David Andrew,10,0,10,0
1668057258710,MATH 245A,A00,098035,Nie; Jiawang,0,0,15,16
1668057259143,MATH 248,A00,098036,Bejenaru; Ioan,10,0,10,0
1668057259570,MATH 250B,A00,098037,Spolaor; Luca,14,0,15,1
1668057259994,MATH 258,A00,098038,Ni; Lei,10,0,10,0
1668057260417,MATH 264B,A00,098041,Rhoades; Brendon Patrick,10,0,15,5
1668057260844,MATH 268,A00,098042,Buss; Samuel R,10,0,10,0
1668057261280,MATH 269,A00,098043,Rhoades; Brendon Patrick,10,0,10,0
1668057261709,MATH 270B,A00,098044,Li; Bo,11,0,15,4
1668057262134,MATH 272B,A00,098045,Holst; Michael J,13,0,15,2
1668057262557,MATH 273A,A00,098046,Tian; Xiaochuan,10,0,15,5
1668057262987,MATH 275,A01,098048,Tian; Xiaochuan,6,0,10,4
1668057263416,MATH 278A,A00,098049,Holst; Michael J,8,0,10,2
1668057263839,MATH 278B,A00,098050,Cloninger; Alexander,10,0,10,0
1668057264264,MATH 278C,A00,098051,Nie; Jiawang,7,0,10,3
1668057264691,MATH 280B,A00,098052,Zheng; Tianyi,10,0,15,5
1668057265114,MATH 281B,A00,098053,Bradic; Jelena,3,0,15,12
1668057265539,MATH 282B,A00,098054,Arias-Castro; Ery,0,0,15,15
1668057265965,MATH 285,A00,098055,Fitzsimmons; Patrick J,0,0,15,17
1668057266396,MATH 287B,A00,098056,Arias-Castro; Ery,3,0,15,12
1668057266823,MATH 288,A00,098057,Agarwal; Pooja,9,0,10,1
1668057266823,MATH 288,B00,098058,Zhang; Danna,8,0,10,2
1668057266823,MATH 288,C00,098059,Williams; Ruth J,10,0,10,0
1668057267249,MATH 290B,A00,098060,Roberts; Justin Deritter,13,0,15,2
1668057267673,MATH 292,A00,098061,Belmont; Eva Kinoshita,10,0,10,0
1668057268098,MATH 295,A00,098062,Suk; Andrew Hoon,48,0,50,2
1668057268522,MATH 296,A00,098063,Novak; Jonathan I,20,0,20,0
1668057268947,MATH 297,001,098064,Gamst; Anthony Collins,9997,0,9999,2
1668057770828,COGS 205,A00,101395,Chiba; Andrea,19,0,20,1
1668057771253,COGS 210B,001,101404,Greene; Deanna Jacquelyn,9998,0,9999,1
1668057771253,COGS 210B,002,101417,Xia; Haijun,9999,0,9999,0
1668057771253,COGS 210B,003,101422,Nitz; Douglas A.,9999,0,9999,0
1668057771253,COGS 210B,004,101423,Hollan; James D.,9998,0,9999,1
1668057771253,COGS 210B,005,101424,Deak; Gedeon O.,9998,0,9999,1
1668057771253,COGS 210B,006,101425,Rossano; Federico,9999,0,9999,0
1668057771681,COGS 211B,A00,101427,Coulson; Seana M,9996,0,9999,3
1668057772114,COGS 220,A00,101428,Hollan; James D.,0,0,25,25
1668057772544,COGS 229,A00,101429,Dow; Steven P,18,0,25,7
1668057772967,COGS 230,A00,101430,Klemmer; Scott R,13,0,17,4
1668057773392,COGS 234,A00,101431,Xia; Haijun,4,0,25,21
1668057773816,COGS 260,A00,101432,Kiyonaga; Anastasia,19,0,25,6
1668057773816,COGS 260,B00,101433,Kirsh; David Joel,16,0,25,9
1668057774243,CSE 202,A00,102371,Impagliazzo; Russell,0,0,0,0
1668057774676,CSE 203B,A01,102373,Cheng; Chung Kuan,0,0,0,0
1668057775099,CSE 208,A00,102374,Micciancio; Daniele,0,0,0,0
1668057775530,CSE 209A,A00,112895,Impagliazzo; Russell,0,0,15,15
1668057775963,CSE 209B,A00,108005,Bellare; Mihir,0,0,0,0
1668057776388,CSE 210,A00,113163,Coblenz; Michael J,0,0,0,0
1668057776812,CSE 219,A00,106111,Dow; Steven P,0,0,20,20
1668057777239,CSE 221,A00,102376,Voelker; Geoffrey M.,0,0,0,0
1668057777663,CSE 224,A01,102378,Porter; George M,0,0,0,0
1668057778097,CSE 229A,A00,102379,Savage; Stefan,0,0,0,0
1668057778522,CSE 229C,A00,102380,Munyaka; Imani N. S.,0,0,0,0
1668057778945,CSE 232B,A00,102382,Deutsch; Alin Bernard,0,0,0,0
1668057779367,CSE 234,A01,112904,Kumar; Arun Kumar,0,0,0,0
1668057779799,CSE 237A,A00,102383,Rosing; Tajana Simunic,0,0,0,0
1668057780224,CSE 239A,A00,102384,Deutsch; Alin Bernard,0,0,0,0
1668057780648,CSE 239B,A00,102385,Polikarpova; Nadezhda,0,0,0,0
1668057781075,CSE 240A,A00,102386,Pannuto; Patrick William,0,0,0,0
1668057781502,CSE 240B,A00,102387,Zhao; Jishen,0,0,0,0
1668057781927,CSE 241A,A00,106406,Kang; Mingu,0,0,0,0
1668057782351,CSE 249B,A00,102388,Kahng; Andrew Byun,0,0,8,8
1668057782775,CSE 251B,A01,102392,Cottrell; Garrison W,0,0,0,0
1668057782775,CSE 251B,A02,102393,Cottrell; Garrison W,0,0,0,0
1668057783206,CSE 252B,A00,102394,Ochoa; Benjamin Lawrence,0,0,0,0
1668057783629,CSE 257,A01,102396,Gao; Sicun,0,0,0,0
1668057784057,CSE 272,A00,102397,Li; Tzumao,0,0,0,0
1668057784492,CSE 274,A00,111323,Chern; Albert Ren-Haur,0,0,0,0
1668057784922,CSE 282,A00,102398,Pevzner; Pavel Arkadjevich,0,0,0,0
1668057785350,CSE 284,A00,114175,Gymrek; Melissa Ann,0,0,0,0
1668057785778,CSE 290,A00,102399,Chandraker; Manmohan Krishna,0,0,0,0
1668057785778,CSE 290,B00,102400,Vaccaro; Kristen Marie,0,0,25,25
1668057785778,CSE 290,C00,102414,Pannuto; Patrick William,0,0,25,25
1668057785778,CSE 290,D00,102427,Pevzner; Pavel Arkadjevich,0,0,0,0
1668057785778,CSE 290,E00,102429,Zhao; Jishen,0,0,0,0
1668057785778,CSE 290,F00,102436,Tullsen; Dean Michael,0,0,0,0
1668057785778,CSE 290,G00,102440,Christensen; Henrik I,0,0,20,20
1668057786207,CSE 291,A00,102443,Su; Hao,0,0,0,0
1668057786207,CSE 291,B00,102448,Polikarpova; Nadezhda,0,0,0,0
1668057786207,CSE 291,C00,102453,Vaccaro; Kristen Marie,0,0,0,0
1668057786207,CSE 291,D00,111343,Savage; Stefan,0,0,0,0
1668057786207,CSE 291,E00,116474,Claffy; Kimberly Claire,0,0,0,0
1668057786207,CSE 291,F00,116479,Pasquale; Joseph,0,0,0,0
1668057786642,CSE 293,001,119111,Bafna; Vineet,9999,0,9999,0
1668057786642,CSE 293,002,119118,Bellare; Mihir,9999,0,9999,0
1668057786642,CSE 293,003,119122,Berg-Kirkpatrick; Taylor D,9999,0,9999,0
1668057786642,CSE 293,004,119135,Christensen; Henrik I,9999,0,9999,0
1668057786642,CSE 293,005,119142,Cottrell; Garrison W,9999,0,9999,0
1668057786642,CSE 293,006,119146,Deutsch; Alin Bernard,9999,0,9999,0
1668057786642,CSE 293,007,119159,Esmaeilzadeh; Hadi,9999,0,9999,0
1668057786642,CSE 293,008,119166,Freund; Yoav,9999,0,9999,0
1668057786642,CSE 293,009,119170,Griswold; William G.,9999,0,9999,0
1668057786642,CSE 293,010,119183,Gymrek; Melissa Ann,9999,0,9999,0
1668057786642,CSE 293,011,119190,Heninger; Nadia A,9999,0,9999,0
1668057786642,CSE 293,012,119230,Impagliazzo; Russell,9999,0,9999,0
1668057786642,CSE 293,013,119232,Jhala; Ranjit,9999,0,9999,0
1668057786642,CSE 293,014,119233,Kahng; Andrew Byun,9999,0,9999,0
1668057786642,CSE 293,015,119298,Kane; Daniel Mertz,9999,0,9999,0
1668057786642,CSE 293,016,119299,Kriegman; David J,9999,0,9999,0
1668057786642,CSE 293,017,119300,Kumar; Arun Kumar,9999,0,9999,0
1668057786642,CSE 293,018,119301,Lerner; Sorin,9999,0,9999,0
1668057786642,CSE 293,019,119302,Lovett; Shachar,9999,0,9999,0
1668057786642,CSE 293,020,119303,McAuley; Julian John,9999,0,9999,0
1668057786642,CSE 293,021,119304,Micciancio; Daniele,9999,0,9999,0
1668057786642,CSE 293,022,119367,Orailoglu; Alex,9999,0,9999,0
1668057786642,CSE 293,023,119382,Paturi; Ramamohan,9999,0,9999,0
1668057786642,CSE 293,024,119404,Polikarpova; Nadezhda,9999,0,9999,0
1668057786642,CSE 293,025,119406,Politz; Joseph Gibbs,9999,0,9999,0
1668057786642,CSE 293,026,119411,Porter; George M,9999,0,9999,0
1668057786642,CSE 293,027,119414,Porter; Leonard Emerson,9999,0,9999,0
1668057786642,CSE 293,028,119416,Ramamoorthi; Ravi,9999,0,9999,0
1668057786642,CSE 293,029,119417,Sahoo; Debashis,9999,0,9999,0
1668057786642,CSE 293,030,119420,Saul; Lawrence,9999,0,9999,0
1668057786642,CSE 293,031,119421,Savage; Stefan,9999,0,9999,0
1668057786642,CSE 293,032,119425,Schulze; Jurgen P.,9999,0,9999,0
1668057786642,CSE 293,033,119426,Snoeren; Alex C.,9999,0,9999,0
1668057786642,CSE 293,034,119428,Shang; Jingbo,9999,0,9999,0
1668057786642,CSE 293,035,119430,Stefan; Deian,9999,0,9999,0
1668057786642,CSE 293,036,119431,Su; Hao,9999,0,9999,0
1668057786642,CSE 293,037,119433,Swanson; Steven James,9999,0,9999,0
1668057786642,CSE 293,038,119435,Tullsen; Dean Michael,9999,0,9999,0
1668057786642,CSE 293,039,119483,Voelker; Geoffrey M.,9999,0,9999,0
1668057786642,CSE 293,040,119537,Zhao; Jishen,9999,0,9999,0
1668057786642,CSE 293,041,119538,Zhou; Yuan-Yuan,9999,0,9999,0
1668057786642,CSE 293,042,119539,Gao; Sicun,9999,0,9999,0
1668057786642,CSE 293,043,119540,Weibel; Nadir,9999,0,9999,0
1668057786642,CSE 293,044,119541,Gupta; Rajesh K.,9999,0,9999,0
1668057786642,CSE 293,045,126410,Vaccaro; Kristen Marie,9999,0,9999,0
1668057786642,CSE 293,046,126411,Klemke; Richard,9999,0,9999,0
1668057787067,CSE 294,A00,102459,Voelker; Geoffrey M.,0,0,0,0
1668057787067,CSE 294,B00,111322,Orailoglu; Alex,0,0,0,0
1668057787497,DSE 201,A00,096914,Deutsch; Alin Bernard,30,0,30,0
1668057787945,DSE 210,A00,096915,Dasgupta; Sanjoy,30,0,30,0
1668057788369,DSE 260A,A00,096916,Altintas De Callaf; Ilkay,30,0,30,0
1668057788811,ECE 200,001,103586,Antipa; Nicholas A,9999,0,9999,0
1668057788811,ECE 200,002,103587,Atanasov; Nikolay A.,9999,0,9999,0
1668057788811,ECE 200,003,103588,Bharadia; Dinesh,9999,0,9999,0
1668057788811,ECE 200,004,103589,Cheng; Chung Kuan,9999,0,9999,0
1668057788811,ECE 200,005,103590,Cosman; Pamela C.,9999,0,9999,0
1668057788811,ECE 200,006,103591,Dayeh; Shadi Ahmad,9999,0,9999,0
1668057788811,ECE 200,007,103592,Fainman; Yeshaiahu,9999,0,9999,0
1668057788811,ECE 200,008,103593,Ford; Joseph Earl,9999,0,9999,0
1668057788811,ECE 200,009,103594,Franceschetti; Massimo,9999,0,9999,0
1668057788811,ECE 200,010,103595,Fullerton; Eric E,9999,0,9999,0
1668057788811,ECE 200,011,103596,Galton; Ian A,9999,0,9999,0
1668057788811,ECE 200,012,103597,Gilja; Vikash,9999,0,9999,0
1668057788811,ECE 200,013,103598,Hall; Drew A.,9999,0,9999,0
1668057788811,ECE 200,014,103599,Hsueh; Tzu-Chien,9999,0,9999,0
1668057788811,ECE 200,015,103600,Javidi; Tara,9999,0,9999,0
1668057788811,ECE 200,016,103601,Kahng; Andrew Byun,9999,0,9999,0
1668057788811,ECE 200,017,103602,Kim; Young-Han,9999,0,9999,0
1668057788811,ECE 200,018,103603,Koushanfar; Farinaz,9999,0,9999,0
1668057788811,ECE 200,019,103604,Kuzum; Duygu,9999,0,9999,0
1668057788811,ECE 200,020,103605,Le; Hanh-Phuc,9999,0,9999,0
1668057788811,ECE 200,021,103606,Lin; Bill,9999,0,9999,0
1668057788811,ECE 200,022,103607,Liu; Zhaowei,9998,0,9999,1
1668057788811,ECE 200,023,103608,Lo; Yu-Hwa,9999,0,9999,0
1668057788811,ECE 200,024,103609,Lomakin; Vitaliy,9999,0,9999,0
1668057788811,ECE 200,025,103610,Mercier; Patrick Philip,9999,0,9999,0
1668057788811,ECE 200,026,103611,Meyer; Florian,9999,0,9999,0
1668057788811,ECE 200,027,103612,Milstein; Laurence B.,9999,0,9999,0
1668057788811,ECE 200,028,103613,Mir Arabbaygi; Siavash,9999,0,9999,0
1668057788811,ECE 200,029,103614,Mookherjea; Shayan,9999,0,9999,0
1668057788811,ECE 200,030,103615,Morris; Karcher William,9999,0,9999,0
1668057788811,ECE 200,031,103616,Ng; Tse Nga,9999,0,9999,0
1668057788811,ECE 200,032,103617,Nguyen; Truong Quang,9999,0,9999,0
1668057788811,ECE 200,033,103618,Nomura; Kenji,9999,0,9999,0
1668057788811,ECE 200,034,103619,Orlitsky; Alon,9999,0,9999,0
1668057788811,ECE 200,035,103620,Pal; Piya,9999,0,9999,0
1668057788811,ECE 200,036,103621,Papen; George C.,9999,0,9999,0
1668057788811,ECE 200,037,103622,Radic; Stojan,9999,0,9999,0
1668057788811,ECE 200,038,103623,Rao; Bhaskar D.,9999,0,9999,0
1668057788811,ECE 200,039,103624,Rao; Ramesh R,9999,0,9999,0
1668057788811,ECE 200,040,103625,Rebeiz; Gabriel,9999,0,9999,0
1668057788811,ECE 200,041,103626,Sanford; John R,9999,0,9999,0
1668057788811,ECE 200,042,103627,Siegel; Paul H.,9999,0,9999,0
1668057788811,ECE 200,043,103628,Sievenpiper; Daniel F.,9999,0,9999,0
1668057788811,ECE 200,044,103629,Sworder; David D.,9999,0,9999,0
1668057788811,ECE 200,045,103630,Taur; Yuan,9999,0,9999,0
1668057788811,ECE 200,046,103631,Touri; Behrouz,9999,0,9999,0
1668057788811,ECE 200,047,103632,Trivedi; Mohan M.,9999,0,9999,0
1668057788811,ECE 200,048,103633,Vasconcelos; Nuno,9999,0,9999,0
1668057788811,ECE 200,049,103634,Wang; Xiaolong,9999,0,9999,0
1668057788811,ECE 200,050,103635,Xie; Pengtao,9999,0,9999,0
1668057788811,ECE 200,051,103636,Yip; Michael,9999,0,9999,0
1668057788811,ECE 200,052,103637,Zeger; Kenneth A.,999,0,999,0
1668057788811,ECE 200,053,103638,Zhang; Xinyu,9999,0,9999,0
1668057788811,ECE 200,054,103639,Turakhia; Yatish Girish,9999,0,9999,0
1668057788811,ECE 200,055,103640,Kang; Mingu,9999,0,9999,0
1668057788811,ECE 200,056,103641,Shi; Yuanyuan,9999,0,9999,0
1668057788811,ECE 200,057,103642,Wang; Edward Jay,9999,0,9999,0
1668057788811,ECE 200,058,103643,Zheng; Yang,9999,0,9999,0
1668057789237,ECE 202,A00,103644,Kuzum; Duygu,0,0,0,0
1668057789661,ECE 212BN,A00,103646,Ng; Tse Nga,0,0,0,0
1668057790088,ECE 221,A00,111493,Staff,0,0,0,0
1668057790519,ECE 222B,A00,103647,Lomakin; Vitaliy,0,0,0,0
1668057790951,ECE 230B,A00,103648,Taur; Yuan,0,0,0,0
1668057791378,ECE 238B,A00,103649,Garay; Javier,0,0,0,0
1668057791800,ECE 240B,A00,112900,Fainman; Yeshaiahu,0,0,0,0
1668057792234,ECE 247A,A00,103650,Jokerst; Jesse Vincent,0,0,0,0
1668057792660,ECE 247B,A00,103651,Wang; Joseph,0,0,0,0
1668057793083,ECE 250,A00,103652,Siegel; Paul H.,0,0,0,0
1668057793511,ECE 251A,A00,103654,Rao; Bhaskar D.,0,0,0,0
1668057793944,ECE 257B,A00,103655,Bharadia; Dinesh,0,0,0,0
1668057794367,ECE 258A,A00,103656,Milstein; Laurence B.,0,0,0,0
1668057794792,ECE 260B,A00,103658,Kang; Mingu,0,0,0,0
1668057795216,ECE 264A,A00,103659,Galton; Ian A,0,0,0,0
1668057795641,ECE 265A,A00,103661,Gudem; Prasad S.S.,0,0,0,0
1668057796070,ECE 265D,A00,103662,Gudem; Prasad S.S.,0,0,0,0
1668057796492,ECE 268,A00,103663,Koushanfar; Farinaz,0,0,0,0
1668057796916,ECE 269,A01,103665,Pal; Piya,0,0,0,0
1668057797344,ECE 271B,A00,103666,Vasconcelos; Manuela,0,0,0,0
1668057797769,ECE 276A,A00,103667,Atanasov; Nikolay A.,0,0,0,0
1668057798192,ECE 277,A00,103668,An; Cheolhong,0,0,0,0
1668057798615,ECE 279,A00,117947,Hall; Drew A.,0,0,0,0
1668057799463,ECE 283,A00,103670,Hsueh; Tzu-Chien,0,0,0,0
1668057799897,ECE 284,A00,103671,Turakhia; Yatish Girish,0,0,0,0
1668057800323,ECE 285,A00,103672,Zheng; Yang,0,0,0,0
1668057800323,ECE 285,B00,103673,Sworder; David D.,0,0,0,0
1668057800749,ECE 287,A00,103676,Javidi; Tara,0,0,0,0
1668057801173,MATH 200B,A00,098023,Salehi Golsefidy; Alireza,13,0,15,2
1668057801596,MATH 202B,A00,098024,Rhoades; Brendon Patrick,9,0,15,6
1668057802022,MATH 203B,A00,098025,Oprea; Dragos N.,11,0,15,4
1668057802449,MATH 204B,A00,098026,Sorensen; Claus M,13,0,15,2
1668057802888,MATH 208,A00,098027,Izadi; Elham,7,0,10,3
1668057803318,MATH 209,A00,098028,Pollack; Aaron,10,0,10,0
1668057803753,MATH 211A,A00,112919,Rogalski; Daniel,9,0,10,1
1668057804175,MATH 211B,A00,112920,Seward; Brandon M.,9,0,10,1
1668057804602,MATH 218,A00,098029,Li; Bo,10,0,10,0
1668057805031,MATH 220B,A00,098030,Novak; Jonathan I,13,0,15,2
1668057805454,MATH 221A,A00,098031,Ebenfelt; Peter F,13,0,15,2
1668057805884,MATH 231B,A00,098032,Zlatos; Andrej,12,0,15,3
1668057806310,MATH 240B,A00,098033,Ni; Lei,9,0,15,6
1668057806733,MATH 243,A00,098034,Jekel; David Andrew,10,0,10,0
1668057807163,MATH 245A,A00,098035,Nie; Jiawang,0,0,15,16
1668057807597,MATH 248,A00,098036,Bejenaru; Ioan,10,0,10,0
1668057808022,MATH 250B,A00,098037,Spolaor; Luca,14,0,15,1
1668057808444,MATH 258,A00,098038,Ni; Lei,10,0,10,0
1668057808870,MATH 264B,A00,098041,Rhoades; Brendon Patrick,10,0,15,5
1668057809291,MATH 268,A00,098042,Buss; Samuel R,10,0,10,0
1668057809719,MATH 269,A00,098043,Rhoades; Brendon Patrick,10,0,10,0
1668057810146,MATH 270B,A00,098044,Li; Bo,11,0,15,4
1668057810667,MATH 272B,A00,098045,Holst; Michael J,13,0,15,2
1668057811091,MATH 273A,A00,098046,Tian; Xiaochuan,10,0,15,5
1668057811517,MATH 275,A01,098048,Tian; Xiaochuan,6,0,10,4
1668057811942,MATH 278A,A00,098049,Holst; Michael J,8,0,10,2
1668057812370,MATH 278B,A00,098050,Cloninger; Alexander,10,0,10,0
1668057812800,MATH 278C,A00,098051,Nie; Jiawang,7,0,10,3
1668057813227,MATH 280B,A00,098052,Zheng; Tianyi,10,0,15,5
1668057813652,MATH 281B,A00,098053,Bradic; Jelena,3,0,15,12
1668057814074,MATH 282B,A00,098054,Arias-Castro; Ery,0,0,15,15
1668057814501,MATH 285,A00,098055,Fitzsimmons; Patrick J,0,0,15,17
1668057814925,MATH 287B,A00,098056,Arias-Castro; Ery,3,0,15,12
1668057815348,MATH 288,A00,098057,Agarwal; Pooja,9,0,10,1
1668057815348,MATH 288,B00,098058,Zhang; Danna,8,0,10,2
1668057815348,MATH 288,C00,098059,Williams; Ruth J,10,0,10,0
1668057815772,MATH 290B,A00,098060,Roberts; Justin Deritter,13,0,15,2
1668057816212,MATH 292,A00,098061,Belmont; Eva Kinoshita,10,0,10,0
1668057816634,MATH 295,A00,098062,Suk; Andrew Hoon,48,0,50,2
1668057817061,MATH 296,A00,098063,Novak; Jonathan I,20,0,20,0
1668057817483,MATH 297,001,098064,Gamst; Anthony Collins,9997,0,9999,2
1668058319729,COGS 205,A00,101395,Chiba; Andrea,19,0,20,1
1668058320154,COGS 210B,001,101404,Greene; Deanna Jacquelyn,9998,0,9999,1
1668058320154,COGS 210B,002,101417,Xia; Haijun,9999,0,9999,0
1668058320154,COGS 210B,003,101422,Nitz; Douglas A.,9999,0,9999,0
1668058320154,COGS 210B,004,101423,Hollan; James D.,9998,0,9999,1
1668058320154,COGS 210B,005,101424,Deak; Gedeon O.,9998,0,9999,1
1668058320154,COGS 210B,006,101425,Rossano; Federico,9999,0,9999,0
1668058320587,COGS 211B,A00,101427,Coulson; Seana M,9996,0,9999,3
1668058321030,COGS 220,A00,101428,Hollan; James D.,0,0,25,25
1668058321455,COGS 229,A00,101429,Dow; Steven P,18,0,25,7
1668058321879,COGS 230,A00,101430,Klemmer; Scott R,13,0,17,4
1668058322303,COGS 234,A00,101431,Xia; Haijun,4,0,25,21
1668058322728,COGS 260,A00,101432,Kiyonaga; Anastasia,19,0,25,6
1668058322728,COGS 260,B00,101433,Kirsh; David Joel,16,0,25,9
1668058323157,CSE 202,A00,102371,Impagliazzo; Russell,0,0,0,0
1668058323581,CSE 203B,A01,102373,Cheng; Chung Kuan,0,0,0,0
1668058324004,CSE 208,A00,102374,Micciancio; Daniele,0,0,0,0
1668058324433,CSE 209A,A00,112895,Impagliazzo; Russell,0,0,15,15
1668058324854,CSE 209B,A00,108005,Bellare; Mihir,0,0,0,0
1668058325286,CSE 210,A00,113163,Coblenz; Michael J,0,0,0,0
1668058325725,CSE 219,A00,106111,Dow; Steven P,0,0,20,20
1668058326148,CSE 221,A00,102376,Voelker; Geoffrey M.,0,0,0,0
1668058326591,CSE 224,A01,102378,Porter; George M,0,0,0,0
1668058327018,CSE 229A,A00,102379,Savage; Stefan,0,0,0,0
1668058327451,CSE 229C,A00,102380,Munyaka; Imani N. S.,0,0,0,0
1668058327885,CSE 232B,A00,102382,Deutsch; Alin Bernard,0,0,0,0
1668058328324,CSE 234,A01,112904,Kumar; Arun Kumar,0,0,0,0
1668058328750,CSE 237A,A00,102383,Rosing; Tajana Simunic,0,0,0,0
1668058329178,CSE 239A,A00,102384,Deutsch; Alin Bernard,0,0,0,0
1668058329606,CSE 239B,A00,102385,Polikarpova; Nadezhda,0,0,0,0
1668058330041,CSE 240A,A00,102386,Pannuto; Patrick William,0,0,0,0
1668058330463,CSE 240B,A00,102387,Zhao; Jishen,0,0,0,0
1668058330885,CSE 241A,A00,106406,Kang; Mingu,0,0,0,0
1668058331312,CSE 249B,A00,102388,Kahng; Andrew Byun,0,0,8,8
1668058331741,CSE 251B,A01,102392,Cottrell; Garrison W,0,0,0,0
1668058331741,CSE 251B,A02,102393,Cottrell; Garrison W,0,0,0,0
1668058332165,CSE 252B,A00,102394,Ochoa; Benjamin Lawrence,0,0,0,0
1668058332587,CSE 257,A01,102396,Gao; Sicun,0,0,0,0
1668058333179,CSE 272,A00,102397,Li; Tzumao,0,0,0,0
1668058333602,CSE 274,A00,111323,Chern; Albert Ren-Haur,0,0,0,0
1668058334028,CSE 282,A00,102398,Pevzner; Pavel Arkadjevich,0,0,0,0
1668058334451,CSE 284,A00,114175,Gymrek; Melissa Ann,0,0,0,0
1668058334886,CSE 290,A00,102399,Chandraker; Manmohan Krishna,0,0,0,0
1668058334886,CSE 290,B00,102400,Vaccaro; Kristen Marie,0,0,25,25
1668058334886,CSE 290,C00,102414,Pannuto; Patrick William,0,0,25,25
1668058334886,CSE 290,D00,102427,Pevzner; Pavel Arkadjevich,0,0,0,0
1668058334886,CSE 290,E00,102429,Zhao; Jishen,0,0,0,0
1668058334886,CSE 290,F00,102436,Tullsen; Dean Michael,0,0,0,0
1668058334886,CSE 290,G00,102440,Christensen; Henrik I,0,0,20,20
1668058335310,CSE 291,A00,102443,Su; Hao,0,0,0,0
1668058335310,CSE 291,B00,102448,Polikarpova; Nadezhda,0,0,0,0
1668058335310,CSE 291,C00,102453,Vaccaro; Kristen Marie,0,0,0,0
1668058335310,CSE 291,D00,111343,Savage; Stefan,0,0,0,0
1668058335310,CSE 291,E00,116474,Claffy; Kimberly Claire,0,0,0,0
1668058335310,CSE 291,F00,116479,Pasquale; Joseph,0,0,0,0
1668058335743,CSE 293,001,119111,Bafna; Vineet,9999,0,9999,0
1668058335743,CSE 293,002,119118,Bellare; Mihir,9999,0,9999,0
1668058335743,CSE 293,003,119122,Berg-Kirkpatrick; Taylor D,9999,0,9999,0
1668058335743,CSE 293,004,119135,Christensen; Henrik I,9999,0,9999,0
1668058335743,CSE 293,005,119142,Cottrell; Garrison W,9999,0,9999,0
1668058335743,CSE 293,006,119146,Deutsch; Alin Bernard,9999,0,9999,0
1668058335743,CSE 293,007,119159,Esmaeilzadeh; Hadi,9999,0,9999,0
1668058335743,CSE 293,008,119166,Freund; Yoav,9999,0,9999,0
1668058335743,CSE 293,009,119170,Griswold; William G.,9999,0,9999,0
1668058335743,CSE 293,010,119183,Gymrek; Melissa Ann,9999,0,9999,0
1668058335743,CSE 293,011,119190,Heninger; Nadia A,9999,0,9999,0
1668058335743,CSE 293,012,119230,Impagliazzo; Russell,9999,0,9999,0
1668058335743,CSE 293,013,119232,Jhala; Ranjit,9999,0,9999,0
1668058335743,CSE 293,014,119233,Kahng; Andrew Byun,9999,0,9999,0
1668058335743,CSE 293,015,119298,Kane; Daniel Mertz,9999,0,9999,0
1668058335743,CSE 293,016,119299,Kriegman; David J,9999,0,9999,0
1668058335743,CSE 293,017,119300,Kumar; Arun Kumar,9999,0,9999,0
1668058335743,CSE 293,018,119301,Lerner; Sorin,9999,0,9999,0
1668058335743,CSE 293,019,119302,Lovett; Shachar,9999,0,9999,0
1668058335743,CSE 293,020,119303,McAuley; Julian John,9999,0,9999,0
1668058335743,CSE 293,021,119304,Micciancio; Daniele,9999,0,9999,0
1668058335743,CSE 293,022,119367,Orailoglu; Alex,9999,0,9999,0
1668058335743,CSE 293,023,119382,Paturi; Ramamohan,9999,0,9999,0
1668058335743,CSE 293,024,119404,Polikarpova; Nadezhda,9999,0,9999,0
1668058335743,CSE 293,025,119406,Politz; Joseph Gibbs,9999,0,9999,0
1668058335743,CSE 293,026,119411,Porter; George M,9999,0,9999,0
1668058335743,CSE 293,027,119414,Porter; Leonard Emerson,9999,0,9999,0
1668058335743,CSE 293,028,119416,Ramamoorthi; Ravi,9999,0,9999,0
1668058335743,CSE 293,029,119417,Sahoo; Debashis,9999,0,9999,0
1668058335743,CSE 293,030,119420,Saul; Lawrence,9999,0,9999,0
1668058335743,CSE 293,031,119421,Savage; Stefan,9999,0,9999,0
1668058335743,CSE 293,032,119425,Schulze; Jurgen P.,9999,0,9999,0
1668058335743,CSE 293,033,119426,Snoeren; Alex C.,9999,0,9999,0
1668058335743,CSE 293,034,119428,Shang; Jingbo,9999,0,9999,0
1668058335743,CSE 293,035,119430,Stefan; Deian,9999,0,9999,0
1668058335743,CSE 293,036,119431,Su; Hao,9999,0,9999,0
1668058335743,CSE 293,037,119433,Swanson; Steven James,9999,0,9999,0
1668058335743,CSE 293,038,119435,Tullsen; Dean Michael,9999,0,9999,0
1668058335743,CSE 293,039,119483,Voelker; Geoffrey M.,9999,0,9999,0
1668058335743,CSE 293,040,119537,Zhao; Jishen,9999,0,9999,0
1668058335743,CSE 293,041,119538,Zhou; Yuan-Yuan,9999,0,9999,0
1668058335743,CSE 293,042,119539,Gao; Sicun,9999,0,9999,0
1668058335743,CSE 293,043,119540,Weibel; Nadir,9999,0,9999,0
1668058335743,CSE 293,044,119541,Gupta; Rajesh K.,9999,0,9999,0
1668058335743,CSE 293,045,126410,Vaccaro; Kristen Marie,9999,0,9999,0
1668058335743,CSE 293,046,126411,Klemke; Richard,9999,0,9999,0
1668058336170,CSE 294,A00,102459,Voelker; Geoffrey M.,0,0,0,0
1668058336170,CSE 294,B00,111322,Orailoglu; Alex,0,0,0,0
1668058336596,DSE 201,A00,096914,Deutsch; Alin Bernard,30,0,30,0
1668058337022,DSE 210,A00,096915,Dasgupta; Sanjoy,30,0,30,0
1668058337462,DSE 260A,A00,096916,Altintas De Callaf; Ilkay,30,0,30,0
1668058337898,ECE 200,001,103586,Antipa; Nicholas A,9999,0,9999,0
1668058337898,ECE 200,002,103587,Atanasov; Nikolay A.,9999,0,9999,0
1668058337898,ECE 200,003,103588,Bharadia; Dinesh,9999,0,9999,0
1668058337898,ECE 200,004,103589,Cheng; Chung Kuan,9999,0,9999,0
1668058337898,ECE 200,005,103590,Cosman; Pamela C.,9999,0,9999,0
1668058337898,ECE 200,006,103591,Dayeh; Shadi Ahmad,9999,0,9999,0
1668058337898,ECE 200,007,103592,Fainman; Yeshaiahu,9999,0,9999,0
1668058337898,ECE 200,008,103593,Ford; Joseph Earl,9999,0,9999,0
1668058337898,ECE 200,009,103594,Franceschetti; Massimo,9999,0,9999,0
1668058337898,ECE 200,010,103595,Fullerton; Eric E,9999,0,9999,0
1668058337898,ECE 200,011,103596,Galton; Ian A,9999,0,9999,0
1668058337898,ECE 200,012,103597,Gilja; Vikash,9999,0,9999,0
1668058337898,ECE 200,013,103598,Hall; Drew A.,9999,0,9999,0
1668058337898,ECE 200,014,103599,Hsueh; Tzu-Chien,9999,0,9999,0
1668058337898,ECE 200,015,103600,Javidi; Tara,9999,0,9999,0
1668058337898,ECE 200,016,103601,Kahng; Andrew Byun,9999,0,9999,0
1668058337898,ECE 200,017,103602,Kim; Young-Han,9999,0,9999,0
1668058337898,ECE 200,018,103603,Koushanfar; Farinaz,9999,0,9999,0
1668058337898,ECE 200,019,103604,Kuzum; Duygu,9999,0,9999,0
1668058337898,ECE 200,020,103605,Le; Hanh-Phuc,9999,0,9999,0
1668058337898,ECE 200,021,103606,Lin; Bill,9999,0,9999,0
1668058337898,ECE 200,022,103607,Liu; Zhaowei,9998,0,9999,1
1668058337898,ECE 200,023,103608,Lo; Yu-Hwa,9999,0,9999,0
1668058337898,ECE 200,024,103609,Lomakin; Vitaliy,9999,0,9999,0
1668058337898,ECE 200,025,103610,Mercier; Patrick Philip,9999,0,9999,0
1668058337898,ECE 200,026,103611,Meyer; Florian,9999,0,9999,0
1668058337898,ECE 200,027,103612,Milstein; Laurence B.,9999,0,9999,0
1668058337898,ECE 200,028,103613,Mir Arabbaygi; Siavash,9999,0,9999,0
1668058337898,ECE 200,029,103614,Mookherjea; Shayan,9999,0,9999,0
1668058337898,ECE 200,030,103615,Morris; Karcher William,9999,0,9999,0
1668058337898,ECE 200,031,103616,Ng; Tse Nga,9999,0,9999,0
1668058337898,ECE 200,032,103617,Nguyen; Truong Quang,9999,0,9999,0
1668058337898,ECE 200,033,103618,Nomura; Kenji,9999,0,9999,0
1668058337898,ECE 200,034,103619,Orlitsky; Alon,9999,0,9999,0
1668058337898,ECE 200,035,103620,Pal; Piya,9999,0,9999,0
1668058337898,ECE 200,036,103621,Papen; George C.,9999,0,9999,0
1668058337898,ECE 200,037,103622,Radic; Stojan,9999,0,9999,0
1668058337898,ECE 200,038,103623,Rao; Bhaskar D.,9999,0,9999,0
1668058337898,ECE 200,039,103624,Rao; Ramesh R,9999,0,9999,0
1668058337898,ECE 200,040,103625,Rebeiz; Gabriel,9999,0,9999,0
1668058337898,ECE 200,041,103626,Sanford; John R,9999,0,9999,0
1668058337898,ECE 200,042,103627,Siegel; Paul H.,9999,0,9999,0
1668058337898,ECE 200,043,103628,Sievenpiper; Daniel F.,9999,0,9999,0
1668058337898,ECE 200,044,103629,Sworder; David D.,9999,0,9999,0
1668058337898,ECE 200,045,103630,Taur; Yuan,9999,0,9999,0
1668058337898,ECE 200,046,103631,Touri; Behrouz,9999,0,9999,0
1668058337898,ECE 200,047,103632,Trivedi; Mohan M.,9999,0,9999,0
1668058337898,ECE 200,048,103633,Vasconcelos; Nuno,9999,0,9999,0
1668058337898,ECE 200,049,103634,Wang; Xiaolong,9999,0,9999,0
1668058337898,ECE 200,050,103635,Xie; Pengtao,9999,0,9999,0
1668058337898,ECE 200,051,103636,Yip; Michael,9999,0,9999,0
1668058337898,ECE 200,052,103637,Zeger; Kenneth A.,999,0,999,0
1668058337898,ECE 200,053,103638,Zhang; Xinyu,9999,0,9999,0
1668058337898,ECE 200,054,103639,Turakhia; Yatish Girish,9999,0,9999,0
1668058337898,ECE 200,055,103640,Kang; Mingu,9999,0,9999,0
1668058337898,ECE 200,056,103641,Shi; Yuanyuan,9999,0,9999,0
1668058337898,ECE 200,057,103642,Wang; Edward Jay,9999,0,9999,0
1668058337898,ECE 200,058,103643,Zheng; Yang,9999,0,9999,0
1668058338328,ECE 202,A00,103644,Kuzum; Duygu,0,0,0,0
1668058338761,ECE 212BN,A00,103646,Ng; Tse Nga,0,0,0,0
1668058339187,ECE 221,A00,111493,Staff,0,0,0,0
1668058339613,ECE 222B,A00,103647,Lomakin; Vitaliy,0,0,0,0
1668058340040,ECE 230B,A00,103648,Taur; Yuan,0,0,0,0
1668058340476,ECE 238B,A00,103649,Garay; Javier,0,0,0,0
1668058340912,ECE 240B,A00,112900,Fainman; Yeshaiahu,0,0,0,0
1668058341337,ECE 247A,A00,103650,Jokerst; Jesse Vincent,0,0,0,0
1668058341762,ECE 247B,A00,103651,Wang; Joseph,0,0,0,0
1668058342186,ECE 250,A00,103652,Siegel; Paul H.,0,0,0,0
1668058342610,ECE 251A,A00,103654,Rao; Bhaskar D.,0,0,0,0
1668058343047,ECE 257B,A00,103655,Bharadia; Dinesh,0,0,0,0
1668058343471,ECE 258A,A00,103656,Milstein; Laurence B.,0,0,0,0
1668058343900,ECE 260B,A00,103658,Kang; Mingu,0,0,0,0
1668058344323,ECE 264A,A00,103659,Galton; Ian A,0,0,0,0
1668058344746,ECE 265A,A00,103661,Gudem; Prasad S.S.,0,0,0,0
1668058345173,ECE 265D,A00,103662,Gudem; Prasad S.S.,0,0,0,0
1668058345596,ECE 268,A00,103663,Koushanfar; Farinaz,0,0,0,0
1668058346021,ECE 269,A01,103665,Pal; Piya,0,0,0,0
1668058346452,ECE 271B,A00,103666,Vasconcelos; Manuela,0,0,0,0
1668058346879,ECE 276A,A00,103667,Atanasov; Nikolay A.,0,0,0,0
1668058347311,ECE 277,A00,103668,An; Cheolhong,0,0,0,0
1668058347736,ECE 279,A00,117947,Hall; Drew A.,0,0,0,0
1668058348600,ECE 283,A00,103670,Hsueh; Tzu-Chien,0,0,0,0
1668058349025,ECE 284,A00,103671,Turakhia; Yatish Girish,0,0,0,0
1668058349450,ECE 285,A00,103672,Zheng; Yang,0,0,0,0
1668058349450,ECE 285,B00,103673,Sworder; David D.,0,0,0,0
1668058349874,ECE 287,A00,103676,Javidi; Tara,0,0,0,0
1668058350299,MATH 200B,A00,098023,Salehi Golsefidy; Alireza,13,0,15,2
1668058350724,MATH 202B,A00,098024,Rhoades; Brendon Patrick,9,0,15,6
1668058351146,MATH 203B,A00,098025,Oprea; Dragos N.,11,0,15,4
1668058351572,MATH 204B,A00,098026,Sorensen; Claus M,13,0,15,2
1668058351995,MATH 208,A00,098027,Izadi; Elham,7,0,10,3
1668058352417,MATH 209,A00,098028,Pollack; Aaron,10,0,10,0
1668058352843,MATH 211A,A00,112919,Rogalski; Daniel,9,0,10,1
1668058353279,MATH 211B,A00,112920,Seward; Brandon M.,9,0,10,1
1668058353710,MATH 218,A00,098029,Li; Bo,10,0,10,0
1668058354141,MATH 220B,A00,098030,Novak; Jonathan I,13,0,15,2
1668058354564,MATH 221A,A00,098031,Ebenfelt; Peter F,13,0,15,2
1668058354989,MATH 231B,A00,098032,Zlatos; Andrej,12,0,15,3
1668058355414,MATH 240B,A00,098033,Ni; Lei,9,0,15,6
1668058355840,MATH 243,A00,098034,Jekel; David Andrew,10,0,10,0
1668058356301,MATH 245A,A00,098035,Nie; Jiawang,0,0,15,16
1668058356725,MATH 248,A00,098036,Bejenaru; Ioan,10,0,10,0
1668058357155,MATH 250B,A00,098037,Spolaor; Luca,14,0,15,1
1668058357581,MATH 258,A00,098038,Ni; Lei,10,0,10,0
1668058358008,MATH 264B,A00,098041,Rhoades; Brendon Patrick,10,0,15,5
1668058358430,MATH 268,A00,098042,Buss; Samuel R,10,0,10,0
1668058358857,MATH 269,A00,098043,Rhoades; Brendon Patrick,10,0,10,0
1668058359284,MATH 270B,A00,098044,Li; Bo,11,0,15,4
1668058359709,MATH 272B,A00,098045,Holst; Michael J,13,0,15,2
1668058360134,MATH 273A,A00,098046,Tian; Xiaochuan,10,0,15,5
1668058360557,MATH 275,A01,098048,Tian; Xiaochuan,6,0,10,4
1668058360980,MATH 278A,A00,098049,Holst; Michael J,8,0,10,2
1668058361405,MATH 278B,A00,098050,Cloninger; Alexander,10,0,10,0
1668058361830,MATH 278C,A00,098051,Nie; Jiawang,7,0,10,3
1668058362258,MATH 280B,A00,098052,Zheng; Tianyi,10,0,15,5
1668058362689,MATH 281B,A00,098053,Bradic; Jelena,3,0,15,12
1668058363113,MATH 282B,A00,098054,Arias-Castro; Ery,0,0,15,15
1668058363538,MATH 285,A00,098055,Fitzsimmons; Patrick J,0,0,15,17
1668058363961,MATH 287B,A00,098056,Arias-Castro; Ery,3,0,15,12
1668058364384,MATH 288,A00,098057,Agarwal; Pooja,9,0,10,1
1668058364384,MATH 288,B00,098058,Zhang; Danna,8,0,10,2
1668058364384,MATH 288,C00,098059,Williams; Ruth J,10,0,10,0
1668058364808,MATH 290B,A00,098060,Roberts; Justin Deritter,13,0,15,2
1668058365232,MATH 292,A00,098061,Belmont; Eva Kinoshita,10,0,10,0
1668058365657,MATH 295,A00,098062,Suk; Andrew Hoon,48,0,50,2
1668058366081,MATH 296,A00,098063,Novak; Jonathan I,20,0,20,0
1668058366516,MATH 297,001,098064,Gamst; Anthony Collins,9997,0,9999,2
1668058868664,COGS 205,A00,101395,Chiba; Andrea,19,0,20,1
1668058869091,COGS 210B,001,101404,Greene; Deanna Jacquelyn,9998,0,9999,1
1668058869091,COGS 210B,002,101417,Xia; Haijun,9999,0,9999,0
1668058869091,COGS 210B,003,101422,Nitz; Douglas A.,9999,0,9999,0
1668058869091,COGS 210B,004,101423,Hollan; James D.,9998,0,9999,1
1668058869091,COGS 210B,005,101424,Deak; Gedeon O.,9998,0,9999,1
1668058869091,COGS 210B,006,101425,Rossano; Federico,9999,0,9999,0
1668058869529,COGS 211B,A00,101427,Coulson; Seana M,9996,0,9999,3
1668058869953,COGS 220,A00,101428,Hollan; James D.,0,0,25,25
1668058870376,COGS 229,A00,101429,Dow; Steven P,18,0,25,7
1668058870802,COGS 230,A00,101430,Klemmer; Scott R,13,0,17,4
1668058871224,COGS 234,A00,101431,Xia; Haijun,4,0,25,21
1668058871651,COGS 260,A00,101432,Kiyonaga; Anastasia,19,0,25,6
1668058871651,COGS 260,B00,101433,Kirsh; David Joel,16,0,25,9
1668058872077,CSE 202,A00,102371,Impagliazzo; Russell,0,0,0,0
1668058872505,CSE 203B,A01,102373,Cheng; Chung Kuan,0,0,0,0
1668058872928,CSE 208,A00,102374,Micciancio; Daniele,0,0,0,0
1668058873355,CSE 209A,A00,112895,Impagliazzo; Russell,0,0,15,15
1668058873780,CSE 209B,A00,108005,Bellare; Mihir,0,0,0,0
1668058874213,CSE 210,A00,113163,Coblenz; Michael J,0,0,0,0
1668058874636,CSE 219,A00,106111,Dow; Steven P,0,0,20,20
1668058875062,CSE 221,A00,102376,Voelker; Geoffrey M.,0,0,0,0
1668058875485,CSE 224,A01,102378,Porter; George M,0,0,0,0
1668058875907,CSE 229A,A00,102379,Savage; Stefan,0,0,0,0
1668058876332,CSE 229C,A00,102380,Munyaka; Imani N. S.,0,0,0,0
1668058876757,CSE 232B,A00,102382,Deutsch; Alin Bernard,0,0,0,0
1668058877191,CSE 234,A01,112904,Kumar; Arun Kumar,0,0,0,0
1668058877616,CSE 237A,A00,102383,Rosing; Tajana Simunic,0,0,0,0
1668058878041,CSE 239A,A00,102384,Deutsch; Alin Bernard,0,0,0,0
1668058878467,CSE 239B,A00,102385,Polikarpova; Nadezhda,0,0,0,0
1668058878896,CSE 240A,A00,102386,Pannuto; Patrick William,0,0,0,0
1668058879320,CSE 240B,A00,102387,Zhao; Jishen,0,0,0,0
1668058879758,CSE 241A,A00,106406,Kang; Mingu,0,0,0,0
1668058880181,CSE 249B,A00,102388,Kahng; Andrew Byun,0,0,8,8
1668058880614,CSE 251B,A01,102392,Cottrell; Garrison W,0,0,0,0
1668058880614,CSE 251B,A02,102393,Cottrell; Garrison W,0,0,0,0
1668058881041,CSE 252B,A00,102394,Ochoa; Benjamin Lawrence,0,0,0,0
1668058881470,CSE 257,A01,102396,Gao; Sicun,0,0,0,0
1668058881897,CSE 272,A00,102397,Li; Tzumao,0,0,0,0
1668058882321,CSE 274,A00,111323,Chern; Albert Ren-Haur,0,0,0,0
1668058882744,CSE 282,A00,102398,Pevzner; Pavel Arkadjevich,0,0,0,0
1668058883196,CSE 284,A00,114175,Gymrek; Melissa Ann,0,0,0,0
1668058883637,CSE 290,A00,102399,Chandraker; Manmohan Krishna,0,0,0,0
1668058883637,CSE 290,B00,102400,Vaccaro; Kristen Marie,0,0,25,25
1668058883637,CSE 290,C00,102414,Pannuto; Patrick William,0,0,25,25
1668058883637,CSE 290,D00,102427,Pevzner; Pavel Arkadjevich,0,0,0,0
1668058883637,CSE 290,E00,102429,Zhao; Jishen,0,0,0,0
1668058883637,CSE 290,F00,102436,Tullsen; Dean Michael,0,0,0,0
1668058883637,CSE 290,G00,102440,Christensen; Henrik I,0,0,20,20
1668058884073,CSE 291,A00,102443,Su; Hao,0,0,0,0
1668058884073,CSE 291,B00,102448,Polikarpova; Nadezhda,0,0,0,0
1668058884073,CSE 291,C00,102453,Vaccaro; Kristen Marie,0,0,0,0
1668058884073,CSE 291,D00,111343,Savage; Stefan,0,0,0,0
1668058884073,CSE 291,E00,116474,Claffy; Kimberly Claire,0,0,0,0
1668058884073,CSE 291,F00,116479,Pasquale; Joseph,0,0,0,0
1668058884499,CSE 293,001,119111,Bafna; Vineet,9999,0,9999,0
1668058884499,CSE 293,002,119118,Bellare; Mihir,9999,0,9999,0
1668058884499,CSE 293,003,119122,Berg-Kirkpatrick; Taylor D,9999,0,9999,0
1668058884499,CSE 293,004,119135,Christensen; Henrik I,9999,0,9999,0
1668058884499,CSE 293,005,119142,Cottrell; Garrison W,9999,0,9999,0
1668058884499,CSE 293,006,119146,Deutsch; Alin Bernard,9999,0,9999,0
1668058884499,CSE 293,007,119159,Esmaeilzadeh; Hadi,9999,0,9999,0
1668058884499,CSE 293,008,119166,Freund; Yoav,9999,0,9999,0
1668058884499,CSE 293,009,119170,Griswold; William G.,9999,0,9999,0
1668058884499,CSE 293,010,119183,Gymrek; Melissa Ann,9999,0,9999,0
1668058884499,CSE 293,011,119190,Heninger; Nadia A,9999,0,9999,0
1668058884499,CSE 293,012,119230,Impagliazzo; Russell,9999,0,9999,0
1668058884499,CSE 293,013,119232,Jhala; Ranjit,9999,0,9999,0
1668058884499,CSE 293,014,119233,Kahng; Andrew Byun,9999,0,9999,0
1668058884499,CSE 293,015,119298,Kane; Daniel Mertz,9999,0,9999,0
1668058884499,CSE 293,016,119299,Kriegman; David J,9999,0,9999,0
1668058884499,CSE 293,017,119300,Kumar; Arun Kumar,9999,0,9999,0
1668058884499,CSE 293,018,119301,Lerner; Sorin,9999,0,9999,0
1668058884499,CSE 293,019,119302,Lovett; Shachar,9999,0,9999,0
1668058884499,CSE 293,020,119303,McAuley; Julian John,9999,0,9999,0
1668058884499,CSE 293,021,119304,Micciancio; Daniele,9999,0,9999,0
1668058884499,CSE 293,022,119367,Orailoglu; Alex,9999,0,9999,0
1668058884499,CSE 293,023,119382,Paturi; Ramamohan,9999,0,9999,0
1668058884499,CSE 293,024,119404,Polikarpova; Nadezhda,9999,0,9999,0
1668058884499,CSE 293,025,119406,Politz; Joseph Gibbs,9999,0,9999,0
1668058884499,CSE 293,026,119411,Porter; George M,9999,0,9999,0
1668058884499,CSE 293,027,119414,Porter; Leonard Emerson,9999,0,9999,0
1668058884499,CSE 293,028,119416,Ramamoorthi; Ravi,9999,0,9999,0
1668058884499,CSE 293,029,119417,Sahoo; Debashis,9999,0,9999,0
1668058884499,CSE 293,030,119420,Saul; Lawrence,9999,0,9999,0
1668058884499,CSE 293,031,119421,Savage; Stefan,9999,0,9999,0
1668058884499,CSE 293,032,119425,Schulze; Jurgen P.,9999,0,9999,0
1668058884499,CSE 293,033,119426,Snoeren; Alex C.,9999,0,9999,0
1668058884499,CSE 293,034,119428,Shang; Jingbo,9999,0,9999,0
1668058884499,CSE 293,035,119430,Stefan; Deian,9999,0,9999,0
1668058884499,CSE 293,036,119431,Su; Hao,9999,0,9999,0
1668058884499,CSE 293,037,119433,Swanson; Steven James,9999,0,9999,0
1668058884499,CSE 293,038,119435,Tullsen; Dean Michael,9999,0,9999,0
1668058884499,CSE 293,039,119483,Voelker; Geoffrey M.,9999,0,9999,0
1668058884499,CSE 293,040,119537,Zhao; Jishen,9999,0,9999,0
1668058884499,CSE 293,041,119538,Zhou; Yuan-Yuan,9999,0,9999,0
1668058884499,CSE 293,042,119539,Gao; Sicun,9999,0,9999,0
1668058884499,CSE 293,043,119540,Weibel; Nadir,9999,0,9999,0
1668058884499,CSE 293,044,119541,Gupta; Rajesh K.,9999,0,9999,0
1668058884499,CSE 293,045,126410,Vaccaro; Kristen Marie,9999,0,9999,0
1668058884499,CSE 293,046,126411,Klemke; Richard,9999,0,9999,0
1668058884932,CSE 294,A00,102459,Voelker; Geoffrey M.,0,0,0,0
1668058884932,CSE 294,B00,111322,Orailoglu; Alex,0,0,0,0
1668058885362,DSE 201,A00,096914,Deutsch; Alin Bernard,30,0,30,0
1668058885785,DSE 210,A00,096915,Dasgupta; Sanjoy,30,0,30,0
1668058886214,DSE 260A,A00,096916,Altintas De Callaf; Ilkay,30,0,30,0
1668058886643,ECE 200,001,103586,Antipa; Nicholas A,9999,0,9999,0
1668058886643,ECE 200,002,103587,Atanasov; Nikolay A.,9999,0,9999,0
1668058886643,ECE 200,003,103588,Bharadia; Dinesh,9999,0,9999,0
1668058886643,ECE 200,004,103589,Cheng; Chung Kuan,9999,0,9999,0
1668058886643,ECE 200,005,103590,Cosman; Pamela C.,9999,0,9999,0
1668058886643,ECE 200,006,103591,Dayeh; Shadi Ahmad,9999,0,9999,0
1668058886643,ECE 200,007,103592,Fainman; Yeshaiahu,9999,0,9999,0
1668058886643,ECE 200,008,103593,Ford; Joseph Earl,9999,0,9999,0
1668058886643,ECE 200,009,103594,Franceschetti; Massimo,9999,0,9999,0
1668058886643,ECE 200,010,103595,Fullerton; Eric E,9999,0,9999,0
1668058886643,ECE 200,011,103596,Galton; Ian A,9999,0,9999,0
1668058886643,ECE 200,012,103597,Gilja; Vikash,9999,0,9999,0
1668058886643,ECE 200,013,103598,Hall; Drew A.,9999,0,9999,0
1668058886643,ECE 200,014,103599,Hsueh; Tzu-Chien,9999,0,9999,0
1668058886643,ECE 200,015,103600,Javidi; Tara,9999,0,9999,0
1668058886643,ECE 200,016,103601,Kahng; Andrew Byun,9999,0,9999,0
1668058886643,ECE 200,017,103602,Kim; Young-Han,9999,0,9999,0
1668058886643,ECE 200,018,103603,Koushanfar; Farinaz,9999,0,9999,0
1668058886643,ECE 200,019,103604,Kuzum; Duygu,9999,0,9999,0
1668058886643,ECE 200,020,103605,Le; Hanh-Phuc,9999,0,9999,0
1668058886643,ECE 200,021,103606,Lin; Bill,9999,0,9999,0
1668058886643,ECE 200,022,103607,Liu; Zhaowei,9998,0,9999,1
1668058886643,ECE 200,023,103608,Lo; Yu-Hwa,9999,0,9999,0
1668058886643,ECE 200,024,103609,Lomakin; Vitaliy,9999,0,9999,0
1668058886643,ECE 200,025,103610,Mercier; Patrick Philip,9999,0,9999,0
1668058886643,ECE 200,026,103611,Meyer; Florian,9999,0,9999,0
1668058886643,ECE 200,027,103612,Milstein; Laurence B.,9999,0,9999,0
1668058886643,ECE 200,028,103613,Mir Arabbaygi; Siavash,9999,0,9999,0
1668058886643,ECE 200,029,103614,Mookherjea; Shayan,9999,0,9999,0
1668058886643,ECE 200,030,103615,Morris; Karcher William,9999,0,9999,0
1668058886643,ECE 200,031,103616,Ng; Tse Nga,9999,0,9999,0
1668058886643,ECE 200,032,103617,Nguyen; Truong Quang,9999,0,9999,0
1668058886643,ECE 200,033,103618,Nomura; Kenji,9999,0,9999,0
1668058886643,ECE 200,034,103619,Orlitsky; Alon,9999,0,9999,0
1668058886643,ECE 200,035,103620,Pal; Piya,9999,0,9999,0
1668058886643,ECE 200,036,103621,Papen; George C.,9999,0,9999,0
1668058886643,ECE 200,037,103622,Radic; Stojan,9999,0,9999,0
1668058886643,ECE 200,038,103623,Rao; Bhaskar D.,9999,0,9999,0
1668058886643,ECE 200,039,103624,Rao; Ramesh R,9999,0,9999,0
1668058886643,ECE 200,040,103625,Rebeiz; Gabriel,9999,0,9999,0
1668058886643,ECE 200,041,103626,Sanford; John R,9999,0,9999,0
1668058886643,ECE 200,042,103627,Siegel; Paul H.,9999,0,9999,0
1668058886643,ECE 200,043,103628,Sievenpiper; Daniel F.,9999,0,9999,0
1668058886643,ECE 200,044,103629,Sworder; David D.,9999,0,9999,0
1668058886643,ECE 200,045,103630,Taur; Yuan,9999,0,9999,0
1668058886643,ECE 200,046,103631,Touri; Behrouz,9999,0,9999,0
1668058886643,ECE 200,047,103632,Trivedi; Mohan M.,9999,0,9999,0
1668058886643,ECE 200,048,103633,Vasconcelos; Nuno,9999,0,9999,0
1668058886643,ECE 200,049,103634,Wang; Xiaolong,9999,0,9999,0
1668058886643,ECE 200,050,103635,Xie; Pengtao,9999,0,9999,0
1668058886643,ECE 200,051,103636,Yip; Michael,9999,0,9999,0
1668058886643,ECE 200,052,103637,Zeger; Kenneth A.,999,0,999,0
1668058886643,ECE 200,053,103638,Zhang; Xinyu,9999,0,9999,0
1668058886643,ECE 200,054,103639,Turakhia; Yatish Girish,9999,0,9999,0
1668058886643,ECE 200,055,103640,Kang; Mingu,9999,0,9999,0
1668058886643,ECE 200,056,103641,Shi; Yuanyuan,9999,0,9999,0
1668058886643,ECE 200,057,103642,Wang; Edward Jay,9999,0,9999,0
1668058886643,ECE 200,058,103643,Zheng; Yang,9999,0,9999,0
1668058887070,ECE 202,A00,103644,Kuzum; Duygu,0,0,0,0
1668058887493,ECE 212BN,A00,103646,Ng; Tse Nga,0,0,0,0
1668058887916,ECE 221,A00,111493,Staff,0,0,0,0
1668058888357,ECE 222B,A00,103647,Lomakin; Vitaliy,0,0,0,0
1668058888781,ECE 230B,A00,103648,Taur; Yuan,0,0,0,0
1668058889210,ECE 238B,A00,103649,Garay; Javier,0,0,0,0
1668058889635,ECE 240B,A00,112900,Fainman; Yeshaiahu,0,0,0,0
1668058890057,ECE 247A,A00,103650,Jokerst; Jesse Vincent,0,0,0,0
1668058890485,ECE 247B,A00,103651,Wang; Joseph,0,0,0,0
1668058890912,ECE 250,A00,103652,Siegel; Paul H.,0,0,0,0
1668058891334,ECE 251A,A00,103654,Rao; Bhaskar D.,0,0,0,0
1668058891758,ECE 257B,A00,103655,Bharadia; Dinesh,0,0,0,0
1668058892196,ECE 258A,A00,103656,Milstein; Laurence B.,0,0,0,0
1668058892619,ECE 260B,A00,103658,Kang; Mingu,0,0,0,0
1668058893048,ECE 264A,A00,103659,Galton; Ian A,0,0,0,0
1668058893472,ECE 265A,A00,103661,Gudem; Prasad S.S.,0,0,0,0
1668058893909,ECE 265D,A00,103662,Gudem; Prasad S.S.,0,0,0,0
1668058894332,ECE 268,A00,103663,Koushanfar; Farinaz,0,0,0,0
1668058894762,ECE 269,A01,103665,Pal; Piya,0,0,0,0
1668058895201,ECE 271B,A00,103666,Vasconcelos; Manuela,0,0,0,0
1668058895647,ECE 276A,A00,103667,Atanasov; Nikolay A.,0,0,0,0
1668058896074,ECE 277,A00,103668,An; Cheolhong,0,0,0,0
1668058896499,ECE 279,A00,117947,Hall; Drew A.,0,0,0,0
1668058897365,ECE 283,A00,103670,Hsueh; Tzu-Chien,0,0,0,0
1668058897789,ECE 284,A00,103671,Turakhia; Yatish Girish,0,0,0,0
1668058898212,ECE 285,A00,103672,Zheng; Yang,0,0,0,0
1668058898212,ECE 285,B00,103673,Sworder; David D.,0,0,0,0
1668058898709,ECE 287,A00,103676,Javidi; Tara,0,0,0,0
1668058899134,MATH 200B,A00,098023,Salehi Golsefidy; Alireza,13,0,15,2
1668058899572,MATH 202B,A00,098024,Rhoades; Brendon Patrick,9,0,15,6
1668058899998,MATH 203B,A00,098025,Oprea; Dragos N.,11,0,15,4
1668058900424,MATH 204B,A00,098026,Sorensen; Claus M,13,0,15,2
1668058900852,MATH 208,A00,098027,Izadi; Elham,7,0,10,3
1668058901285,MATH 209,A00,098028,Pollack; Aaron,10,0,10,0
1668058901718,MATH 211A,A00,112919,Rogalski; Daniel,9,0,10,1
1668058902143,MATH 211B,A00,112920,Seward; Brandon M.,9,0,10,1
1668058902570,MATH 218,A00,098029,Li; Bo,10,0,10,0
1668058902994,MATH 220B,A00,098030,Novak; Jonathan I,13,0,15,2
1668058903420,MATH 221A,A00,098031,Ebenfelt; Peter F,13,0,15,2
1668058903858,MATH 231B,A00,098032,Zlatos; Andrej,12,0,15,3
1668058904285,MATH 240B,A00,098033,Ni; Lei,9,0,15,6
1668058904710,MATH 243,A00,098034,Jekel; David Andrew,10,0,10,0
1668058905134,MATH 245A,A00,098035,Nie; Jiawang,0,0,15,16
1668058905556,MATH 248,A00,098036,Bejenaru; Ioan,10,0,10,0
1668058905979,MATH 250B,A00,098037,Spolaor; Luca,14,0,15,1
1668058906413,MATH 258,A00,098038,Ni; Lei,10,0,10,0
1668058906866,MATH 264B,A00,098041,Rhoades; Brendon Patrick,10,0,15,5
1668058907295,MATH 268,A00,098042,Buss; Samuel R,10,0,10,0
1668058907721,MATH 269,A00,098043,Rhoades; Brendon Patrick,10,0,10,0
1668058908146,MATH 270B,A00,098044,Li; Bo,11,0,15,4
1668058908570,MATH 272B,A00,098045,Holst; Michael J,13,0,15,2
1668058909016,MATH 273A,A00,098046,Tian; Xiaochuan,10,0,15,5
1668058909447,MATH 275,A01,098048,Tian; Xiaochuan,6,0,10,4
1668058909868,MATH 278A,A00,098049,Holst; Michael J,8,0,10,2
1668058910305,MATH 278B,A00,098050,Cloninger; Alexander,10,0,10,0
1668058910742,MATH 278C,A00,098051,Nie; Jiawang,7,0,10,3
1668058911169,MATH 280B,A00,098052,Zheng; Tianyi,10,0,15,5
1668058911590,MATH 281B,A00,098053,Bradic; Jelena,3,0,15,12
1668058912029,MATH 282B,A00,098054,Arias-Castro; Ery,0,0,15,15
1668058912475,MATH 285,A00,098055,Fitzsimmons; Patrick J,0,0,15,17
1668058912901,MATH 287B,A00,098056,Arias-Castro; Ery,3,0,15,12
1668058913337,MATH 288,A00,098057,Agarwal; Pooja,9,0,10,1
1668058913337,MATH 288,B00,098058,Zhang; Danna,8,0,10,2
1668058913337,MATH 288,C00,098059,Williams; Ruth J,10,0,10,0
1668058913792,MATH 290B,A00,098060,Roberts; Justin Deritter,13,0,15,2
1668058914223,MATH 292,A00,098061,Belmont; Eva Kinoshita,10,0,10,0
1668058914646,MATH 295,A00,098062,Suk; Andrew Hoon,48,0,50,2
1668058915078,MATH 296,A00,098063,Novak; Jonathan I,20,0,20,0
1668058915506,MATH 297,001,098064,Gamst; Anthony Collins,9997,0,9999,2
1668059418170,COGS 205,A00,101395,Chiba; Andrea,19,0,20,1
1668059418602,COGS 210B,001,101404,Greene; Deanna Jacquelyn,9998,0,9999,1
1668059418602,COGS 210B,002,101417,Xia; Haijun,9999,0,9999,0
1668059418602,COGS 210B,003,101422,Nitz; Douglas A.,9999,0,9999,0
1668059418602,COGS 210B,004,101423,Hollan; James D.,9998,0,9999,1
1668059418602,COGS 210B,005,101424,Deak; Gedeon O.,9998,0,9999,1
1668059418602,COGS 210B,006,101425,Rossano; Federico,9999,0,9999,0
1668059419042,COGS 211B,A00,101427,Coulson; Seana M,9996,0,9999,3
1668059419469,COGS 220,A00,101428,Hollan; James D.,0,0,25,25
1668059419894,COGS 229,A00,101429,Dow; Steven P,18,0,25,7
1668059420320,COGS 230,A00,101430,Klemmer; Scott R,13,0,17,4
1668059420747,COGS 234,A00,101431,Xia; Haijun,4,0,25,21
1668059421174,COGS 260,A00,101432,Kiyonaga; Anastasia,19,0,25,6
1668059421174,COGS 260,B00,101433,Kirsh; David Joel,16,0,25,9
1668059421691,CSE 202,A00,102371,Impagliazzo; Russell,0,0,0,0
1668059422132,CSE 203B,A01,102373,Cheng; Chung Kuan,0,0,0,0
1668059422558,CSE 208,A00,102374,Micciancio; Daniele,0,0,0,0
1668059422984,CSE 209A,A00,112895,Impagliazzo; Russell,0,0,15,15
1668059423412,CSE 209B,A00,108005,Bellare; Mihir,0,0,0,0
1668059423836,CSE 210,A00,113163,Coblenz; Michael J,0,0,0,0
1668059424270,CSE 219,A00,106111,Dow; Steven P,0,0,20,20
1668059424702,CSE 221,A00,102376,Voelker; Geoffrey M.,0,0,0,0
1668059425137,CSE 224,A01,102378,Porter; George M,0,0,0,0
1668059425571,CSE 229A,A00,102379,Savage; Stefan,0,0,0,0
1668059425996,CSE 229C,A00,102380,Munyaka; Imani N. S.,0,0,0,0
1668059426423,CSE 232B,A00,102382,Deutsch; Alin Bernard,0,0,0,0
1668059426847,CSE 234,A01,112904,Kumar; Arun Kumar,0,0,0,0
1668059427270,CSE 237A,A00,102383,Rosing; Tajana Simunic,0,0,0,0
1668059427698,CSE 239A,A00,102384,Deutsch; Alin Bernard,0,0,0,0
1668059428142,CSE 239B,A00,102385,Polikarpova; Nadezhda,0,0,0,0
1668059428581,CSE 240A,A00,102386,Pannuto; Patrick William,0,0,0,0
1668059429007,CSE 240B,A00,102387,Zhao; Jishen,0,0,0,0
1668059429437,CSE 241A,A00,106406,Kang; Mingu,0,0,0,0
1668059429863,CSE 249B,A00,102388,Kahng; Andrew Byun,0,0,8,8
1668059430291,CSE 251B,A01,102392,Cottrell; Garrison W,0,0,0,0
1668059430291,CSE 251B,A02,102393,Cottrell; Garrison W,0,0,0,0
1668059430729,CSE 252B,A00,102394,Ochoa; Benjamin Lawrence,0,0,0,0
1668059431156,CSE 257,A01,102396,Gao; Sicun,0,0,0,0
1668059431579,CSE 272,A00,102397,Li; Tzumao,0,0,0,0
1668059432009,CSE 274,A00,111323,Chern; Albert Ren-Haur,0,0,0,0
1668059432452,CSE 282,A00,102398,Pevzner; Pavel Arkadjevich,0,0,0,0
1668059432889,CSE 284,A00,114175,Gymrek; Melissa Ann,0,0,0,0
1668059433312,CSE 290,A00,102399,Chandraker; Manmohan Krishna,0,0,0,0
1668059433312,CSE 290,B00,102400,Vaccaro; Kristen Marie,0,0,25,25
1668059433312,CSE 290,C00,102414,Pannuto; Patrick William,0,0,25,25
1668059433312,CSE 290,D00,102427,Pevzner; Pavel Arkadjevich,0,0,0,0
1668059433312,CSE 290,E00,102429,Zhao; Jishen,0,0,0,0
1668059433312,CSE 290,F00,102436,Tullsen; Dean Michael,0,0,0,0
1668059433312,CSE 290,G00,102440,Christensen; Henrik I,0,0,20,20
1668059433742,CSE 291,A00,102443,Su; Hao,0,0,0,0
1668059433742,CSE 291,B00,102448,Polikarpova; Nadezhda,0,0,0,0
1668059433742,CSE 291,C00,102453,Vaccaro; Kristen Marie,0,0,0,0
1668059433742,CSE 291,D00,111343,Savage; Stefan,0,0,0,0
1668059433742,CSE 291,E00,116474,Claffy; Kimberly Claire,0,0,0,0
1668059433742,CSE 291,F00,116479,Pasquale; Joseph,0,0,0,0
1668059434170,CSE 293,001,119111,Bafna; Vineet,9999,0,9999,0
1668059434170,CSE 293,002,119118,Bellare; Mihir,9999,0,9999,0
1668059434170,CSE 293,003,119122,Berg-Kirkpatrick; Taylor D,9999,0,9999,0
1668059434170,CSE 293,004,119135,Christensen; Henrik I,9999,0,9999,0
1668059434170,CSE 293,005,119142,Cottrell; Garrison W,9999,0,9999,0
1668059434170,CSE 293,006,119146,Deutsch; Alin Bernard,9999,0,9999,0
1668059434170,CSE 293,007,119159,Esmaeilzadeh; Hadi,9999,0,9999,0
1668059434170,CSE 293,008,119166,Freund; Yoav,9999,0,9999,0
1668059434170,CSE 293,009,119170,Griswold; William G.,9999,0,9999,0
1668059434170,CSE 293,010,119183,Gymrek; Melissa Ann,9999,0,9999,0
1668059434170,CSE 293,011,119190,Heninger; Nadia A,9999,0,9999,0
1668059434170,CSE 293,012,119230,Impagliazzo; Russell,9999,0,9999,0
1668059434170,CSE 293,013,119232,Jhala; Ranjit,9999,0,9999,0
1668059434170,CSE 293,014,119233,Kahng; Andrew Byun,9999,0,9999,0
1668059434170,CSE 293,015,119298,Kane; Daniel Mertz,9999,0,9999,0
1668059434170,CSE 293,016,119299,Kriegman; David J,9999,0,9999,0
1668059434170,CSE 293,017,119300,Kumar; Arun Kumar,9999,0,9999,0
1668059434170,CSE 293,018,119301,Lerner; Sorin,9999,0,9999,0
1668059434170,CSE 293,019,119302,Lovett; Shachar,9999,0,9999,0
1668059434170,CSE 293,020,119303,McAuley; Julian John,9999,0,9999,0
1668059434170,CSE 293,021,119304,Micciancio; Daniele,9999,0,9999,0
1668059434170,CSE 293,022,119367,Orailoglu; Alex,9999,0,9999,0
1668059434170,CSE 293,023,119382,Paturi; Ramamohan,9999,0,9999,0
1668059434170,CSE 293,024,119404,Polikarpova; Nadezhda,9999,0,9999,0
1668059434170,CSE 293,025,119406,Politz; Joseph Gibbs,9999,0,9999,0
1668059434170,CSE 293,026,119411,Porter; George M,9999,0,9999,0
1668059434170,CSE 293,027,119414,Porter; Leonard Emerson,9999,0,9999,0
1668059434170,CSE 293,028,119416,Ramamoorthi; Ravi,9999,0,9999,0
1668059434170,CSE 293,029,119417,Sahoo; Debashis,9999,0,9999,0
1668059434170,CSE 293,030,119420,Saul; Lawrence,9999,0,9999,0
1668059434170,CSE 293,031,119421,Savage; Stefan,9999,0,9999,0
1668059434170,CSE 293,032,119425,Schulze; Jurgen P.,9999,0,9999,0
1668059434170,CSE 293,033,119426,Snoeren; Alex C.,9999,0,9999,0
1668059434170,CSE 293,034,119428,Shang; Jingbo,9999,0,9999,0
1668059434170,CSE 293,035,119430,Stefan; Deian,9999,0,9999,0
1668059434170,CSE 293,036,119431,Su; Hao,9999,0,9999,0
1668059434170,CSE 293,037,119433,Swanson; Steven James,9999,0,9999,0
1668059434170,CSE 293,038,119435,Tullsen; Dean Michael,9999,0,9999,0
1668059434170,CSE 293,039,119483,Voelker; Geoffrey M.,9999,0,9999,0
1668059434170,CSE 293,040,119537,Zhao; Jishen,9999,0,9999,0
1668059434170,CSE 293,041,119538,Zhou; Yuan-Yuan,9999,0,9999,0
1668059434170,CSE 293,042,119539,Gao; Sicun,9999,0,9999,0
1668059434170,CSE 293,043,119540,Weibel; Nadir,9999,0,9999,0
1668059434170,CSE 293,044,119541,Gupta; Rajesh K.,9999,0,9999,0
1668059434170,CSE 293,045,126410,Vaccaro; Kristen Marie,9999,0,9999,0
1668059434170,CSE 293,046,126411,Klemke; Richard,9999,0,9999,0
1668059434599,CSE 294,A00,102459,Voelker; Geoffrey M.,0,0,0,0
1668059434599,CSE 294,B00,111322,Orailoglu; Alex,0,0,0,0
1668059435023,DSE 201,A00,096914,Deutsch; Alin Bernard,30,0,30,0
1668059435451,DSE 210,A00,096915,Dasgupta; Sanjoy,30,0,30,0
1668059435877,DSE 260A,A00,096916,Altintas De Callaf; Ilkay,30,0,30,0
1668059436307,ECE 200,001,103586,Antipa; Nicholas A,9999,0,9999,0
1668059436307,ECE 200,002,103587,Atanasov; Nikolay A.,9999,0,9999,0
1668059436307,ECE 200,003,103588,Bharadia; Dinesh,9999,0,9999,0
1668059436307,ECE 200,004,103589,Cheng; Chung Kuan,9999,0,9999,0
1668059436307,ECE 200,005,103590,Cosman; Pamela C.,9999,0,9999,0
1668059436307,ECE 200,006,103591,Dayeh; Shadi Ahmad,9999,0,9999,0
1668059436307,ECE 200,007,103592,Fainman; Yeshaiahu,9999,0,9999,0
1668059436307,ECE 200,008,103593,Ford; Joseph Earl,9999,0,9999,0
1668059436307,ECE 200,009,103594,Franceschetti; Massimo,9999,0,9999,0
1668059436307,ECE 200,010,103595,Fullerton; Eric E,9999,0,9999,0
1668059436307,ECE 200,011,103596,Galton; Ian A,9999,0,9999,0
1668059436307,ECE 200,012,103597,Gilja; Vikash,9999,0,9999,0
1668059436307,ECE 200,013,103598,Hall; Drew A.,9999,0,9999,0
1668059436307,ECE 200,014,103599,Hsueh; Tzu-Chien,9999,0,9999,0
1668059436307,ECE 200,015,103600,Javidi; Tara,9999,0,9999,0
1668059436307,ECE 200,016,103601,Kahng; Andrew Byun,9999,0,9999,0
1668059436307,ECE 200,017,103602,Kim; Young-Han,9999,0,9999,0
1668059436307,ECE 200,018,103603,Koushanfar; Farinaz,9999,0,9999,0
1668059436307,ECE 200,019,103604,Kuzum; Duygu,9999,0,9999,0
1668059436307,ECE 200,020,103605,Le; Hanh-Phuc,9999,0,9999,0
1668059436307,ECE 200,021,103606,Lin; Bill,9999,0,9999,0
1668059436307,ECE 200,022,103607,Liu; Zhaowei,9998,0,9999,1
1668059436307,ECE 200,023,103608,Lo; Yu-Hwa,9999,0,9999,0
1668059436307,ECE 200,024,103609,Lomakin; Vitaliy,9999,0,9999,0
1668059436307,ECE 200,025,103610,Mercier; Patrick Philip,9999,0,9999,0
1668059436307,ECE 200,026,103611,Meyer; Florian,9999,0,9999,0
1668059436307,ECE 200,027,103612,Milstein; Laurence B.,9999,0,9999,0
1668059436307,ECE 200,028,103613,Mir Arabbaygi; Siavash,9999,0,9999,0
1668059436307,ECE 200,029,103614,Mookherjea; Shayan,9999,0,9999,0
1668059436307,ECE 200,030,103615,Morris; Karcher William,9999,0,9999,0
1668059436307,ECE 200,031,103616,Ng; Tse Nga,9999,0,9999,0
1668059436307,ECE 200,032,103617,Nguyen; Truong Quang,9999,0,9999,0
1668059436307,ECE 200,033,103618,Nomura; Kenji,9999,0,9999,0
1668059436307,ECE 200,034,103619,Orlitsky; Alon,9999,0,9999,0
1668059436307,ECE 200,035,103620,Pal; Piya,9999,0,9999,0
1668059436307,ECE 200,036,103621,Papen; George C.,9999,0,9999,0
1668059436307,ECE 200,037,103622,Radic; Stojan,9999,0,9999,0
1668059436307,ECE 200,038,103623,Rao; Bhaskar D.,9999,0,9999,0
1668059436307,ECE 200,039,103624,Rao; Ramesh R,9999,0,9999,0
1668059436307,ECE 200,040,103625,Rebeiz; Gabriel,9999,0,9999,0
1668059436307,ECE 200,041,103626,Sanford; John R,9999,0,9999,0
1668059436307,ECE 200,042,103627,Siegel; Paul H.,9999,0,9999,0
1668059436307,ECE 200,043,103628,Sievenpiper; Daniel F.,9999,0,9999,0
1668059436307,ECE 200,044,103629,Sworder; David D.,9999,0,9999,0
1668059436307,ECE 200,045,103630,Taur; Yuan,9999,0,9999,0
1668059436307,ECE 200,046,103631,Touri; Behrouz,9999,0,9999,0
1668059436307,ECE 200,047,103632,Trivedi; Mohan M.,9999,0,9999,0
1668059436307,ECE 200,048,103633,Vasconcelos; Nuno,9999,0,9999,0
1668059436307,ECE 200,049,103634,Wang; Xiaolong,9999,0,9999,0
1668059436307,ECE 200,050,103635,Xie; Pengtao,9999,0,9999,0
1668059436307,ECE 200,051,103636,Yip; Michael,9999,0,9999,0
1668059436307,ECE 200,052,103637,Zeger; Kenneth A.,999,0,999,0
1668059436307,ECE 200,053,103638,Zhang; Xinyu,9999,0,9999,0
1668059436307,ECE 200,054,103639,Turakhia; Yatish Girish,9999,0,9999,0
1668059436307,ECE 200,055,103640,Kang; Mingu,9999,0,9999,0
1668059436307,ECE 200,056,103641,Shi; Yuanyuan,9999,0,9999,0
1668059436307,ECE 200,057,103642,Wang; Edward Jay,9999,0,9999,0
1668059436307,ECE 200,058,103643,Zheng; Yang,9999,0,9999,0
1668059436731,ECE 202,A00,103644,Kuzum; Duygu,0,0,0,0
1668059437156,ECE 212BN,A00,103646,Ng; Tse Nga,0,0,0,0
1668059437579,ECE 221,A00,111493,Staff,0,0,0,0
1668059438001,ECE 222B,A00,103647,Lomakin; Vitaliy,0,0,0,0
1668059438435,ECE 230B,A00,103648,Taur; Yuan,0,0,0,0
1668059438859,ECE 238B,A00,103649,Garay; Javier,0,0,0,0
1668059439283,ECE 240B,A00,112900,Fainman; Yeshaiahu,0,0,0,0
1668059439707,ECE 247A,A00,103650,Jokerst; Jesse Vincent,0,0,0,0
1668059440129,ECE 247B,A00,103651,Wang; Joseph,0,0,0,0
1668059440557,ECE 250,A00,103652,Siegel; Paul H.,0,0,0,0
1668059440997,ECE 251A,A00,103654,Rao; Bhaskar D.,0,0,0,0
1668059441419,ECE 257B,A00,103655,Bharadia; Dinesh,0,0,0,0
1668059441846,ECE 258A,A00,103656,Milstein; Laurence B.,0,0,0,0
1668059442269,ECE 260B,A00,103658,Kang; Mingu,0,0,0,0
1668059442700,ECE 264A,A00,103659,Galton; Ian A,0,0,0,0
1668059443130,ECE 265A,A00,103661,Gudem; Prasad S.S.,0,0,0,0
1668059443552,ECE 265D,A00,103662,Gudem; Prasad S.S.,0,0,0,0
1668059443988,ECE 268,A00,103663,Koushanfar; Farinaz,0,0,0,0
1668059444410,ECE 269,A01,103665,Pal; Piya,0,0,0,0
1668059444834,ECE 271B,A00,103666,Vasconcelos; Manuela,0,0,0,0
1668059445258,ECE 276A,A00,103667,Atanasov; Nikolay A.,0,0,0,0
1668059445680,ECE 277,A00,103668,An; Cheolhong,0,0,0,0
1668059446111,ECE 279,A00,117947,Hall; Drew A.,0,0,0,0
1668059446982,ECE 283,A00,103670,Hsueh; Tzu-Chien,0,0,0,0
1668059447418,ECE 284,A00,103671,Turakhia; Yatish Girish,0,0,0,0
1668059447848,ECE 285,A00,103672,Zheng; Yang,0,0,0,0
1668059447848,ECE 285,B00,103673,Sworder; David D.,0,0,0,0
1668059448283,ECE 287,A00,103676,Javidi; Tara,0,0,0,0
1668059448708,MATH 200B,A00,098023,Salehi Golsefidy; Alireza,13,0,15,2
1668059449157,MATH 202B,A00,098024,Rhoades; Brendon Patrick,9,0,15,6
1668059449584,MATH 203B,A00,098025,Oprea; Dragos N.,11,0,15,4
1668059450010,MATH 204B,A00,098026,Sorensen; Claus M,13,0,15,2
1668059450433,MATH 208,A00,098027,Izadi; Elham,7,0,10,3
1668059450857,MATH 209,A00,098028,Pollack; Aaron,10,0,10,0
1668059451288,MATH 211A,A00,112919,Rogalski; Daniel,9,0,10,1
1668059451716,MATH 211B,A00,112920,Seward; Brandon M.,9,0,10,1
1668059452141,MATH 218,A00,098029,Li; Bo,10,0,10,0
1668059452566,MATH 220B,A00,098030,Novak; Jonathan I,13,0,15,2
1668059452994,MATH 221A,A00,098031,Ebenfelt; Peter F,13,0,15,2
1668059453417,MATH 231B,A00,098032,Zlatos; Andrej,12,0,15,3
1668059453843,MATH 240B,A00,098033,Ni; Lei,9,0,15,6
1668059454265,MATH 243,A00,098034,Jekel; David Andrew,10,0,10,0
1668059454688,MATH 245A,A00,098035,Nie; Jiawang,0,0,15,16
1668059455114,MATH 248,A00,098036,Bejenaru; Ioan,10,0,10,0
1668059455541,MATH 250B,A00,098037,Spolaor; Luca,14,0,15,1
1668059455966,MATH 258,A00,098038,Ni; Lei,10,0,10,0
1668059456390,MATH 264B,A00,098041,Rhoades; Brendon Patrick,10,0,15,5
1668059456817,MATH 268,A00,098042,Buss; Samuel R,10,0,10,0
1668059457251,MATH 269,A00,098043,Rhoades; Brendon Patrick,10,0,10,0
1668059457678,MATH 270B,A00,098044,Li; Bo,11,0,15,4
1668059458101,MATH 272B,A00,098045,Holst; Michael J,13,0,15,2
1668059458524,MATH 273A,A00,098046,Tian; Xiaochuan,10,0,15,5
1668059458947,MATH 275,A01,098048,Tian; Xiaochuan,6,0,10,4
1668059459376,MATH 278A,A00,098049,Holst; Michael J,8,0,10,2
1668059459801,MATH 278B,A00,098050,Cloninger; Alexander,10,0,10,0
1668059460225,MATH 278C,A00,098051,Nie; Jiawang,7,0,10,3
1668059460657,MATH 280B,A00,098052,Zheng; Tianyi,10,0,15,5
1668059461080,MATH 281B,A00,098053,Bradic; Jelena,3,0,15,12
1668059461506,MATH 282B,A00,098054,Arias-Castro; Ery,0,0,15,15
1668059461929,MATH 285,A00,098055,Fitzsimmons; Patrick J,0,0,15,17
1668059462355,MATH 287B,A00,098056,Arias-Castro; Ery,3,0,15,12
1668059462782,MATH 288,A00,098057,Agarwal; Pooja,9,0,10,1
1668059462782,MATH 288,B00,098058,Zhang; Danna,8,0,10,2
1668059462782,MATH 288,C00,098059,Williams; Ruth J,10,0,10,0
1668059463204,MATH 290B,A00,098060,Roberts; Justin Deritter,13,0,15,2
1668059463631,MATH 292,A00,098061,Belmont; Eva Kinoshita,10,0,10,0
1668059464056,MATH 295,A00,098062,Suk; Andrew Hoon,48,0,50,2
1668059464478,MATH 296,A00,098063,Novak; Jonathan I,20,0,20,0
1668059464983,MATH 297,001,098064,Gamst; Anthony Collins,9997,0,9999,2
1668059966126,COGS 205,A00,101395,Chiba; Andrea,19,0,20,1
1668059966550,COGS 210B,001,101404,Greene; Deanna Jacquelyn,9998,0,9999,1
1668059966550,COGS 210B,002,101417,Xia; Haijun,9999,0,9999,0
1668059966550,COGS 210B,003,101422,Nitz; Douglas A.,9999,0,9999,0
1668059966550,COGS 210B,004,101423,Hollan; James D.,9998,0,9999,1
1668059966550,COGS 210B,005,101424,Deak; Gedeon O.,9998,0,9999,1
1668059966550,COGS 210B,006,101425,Rossano; Federico,9999,0,9999,0
1668059966974,COGS 211B,A00,101427,Coulson; Seana M,9996,0,9999,3
1668059967400,COGS 220,A00,101428,Hollan; James D.,0,0,25,25
1668059967832,COGS 229,A00,101429,Dow; Steven P,18,0,25,7
1668059968258,COGS 230,A00,101430,Klemmer; Scott R,13,0,17,4
1668059968684,COGS 234,A00,101431,Xia; Haijun,4,0,25,21
1668059969112,COGS 260,A00,101432,Kiyonaga; Anastasia,19,0,25,6
1668059969112,COGS 260,B00,101433,Kirsh; David Joel,16,0,25,9
1668059969543,CSE 202,A00,102371,Impagliazzo; Russell,0,0,0,0
1668059969971,CSE 203B,A01,102373,Cheng; Chung Kuan,0,0,0,0
1668059970395,CSE 208,A00,102374,Micciancio; Daniele,0,0,0,0
1668059970827,CSE 209A,A00,112895,Impagliazzo; Russell,0,0,15,15
1668059971254,CSE 209B,A00,108005,Bellare; Mihir,0,0,0,0
1668059971678,CSE 210,A00,113163,Coblenz; Michael J,0,0,0,0
1668059972116,CSE 219,A00,106111,Dow; Steven P,0,0,20,20
1668059972543,CSE 221,A00,102376,Voelker; Geoffrey M.,0,0,0,0
1668059972969,CSE 224,A01,102378,Porter; George M,0,0,0,0
1668059973396,CSE 229A,A00,102379,Savage; Stefan,0,0,0,0
1668059973820,CSE 229C,A00,102380,Munyaka; Imani N. S.,0,0,0,0
1668059974246,CSE 232B,A00,102382,Deutsch; Alin Bernard,0,0,0,0
1668059974671,CSE 234,A01,112904,Kumar; Arun Kumar,0,0,0,0
1668059975094,CSE 237A,A00,102383,Rosing; Tajana Simunic,0,0,0,0
1668059975519,CSE 239A,A00,102384,Deutsch; Alin Bernard,0,0,0,0
1668059975944,CSE 239B,A00,102385,Polikarpova; Nadezhda,0,0,0,0
1668059976369,CSE 240A,A00,102386,Pannuto; Patrick William,0,0,0,0
1668059976797,CSE 240B,A00,102387,Zhao; Jishen,0,0,0,0
1668059977220,CSE 241A,A00,106406,Kang; Mingu,0,0,0,0
1668059977650,CSE 249B,A00,102388,Kahng; Andrew Byun,0,0,8,8
1668059978101,CSE 251B,A01,102392,Cottrell; Garrison W,0,0,0,0
1668059978101,CSE 251B,A02,102393,Cottrell; Garrison W,0,0,0,0
1668059978544,CSE 252B,A00,102394,Ochoa; Benjamin Lawrence,0,0,0,0
1668059978970,CSE 257,A01,102396,Gao; Sicun,0,0,0,0
1668059979396,CSE 272,A00,102397,Li; Tzumao,0,0,0,0
1668059979824,CSE 274,A00,111323,Chern; Albert Ren-Haur,0,0,0,0
1668059980250,CSE 282,A00,102398,Pevzner; Pavel Arkadjevich,0,0,0,0
1668059980675,CSE 284,A00,114175,Gymrek; Melissa Ann,0,0,0,0
1668059981099,CSE 290,A00,102399,Chandraker; Manmohan Krishna,0,0,0,0
1668059981099,CSE 290,B00,102400,Vaccaro; Kristen Marie,0,0,25,25
1668059981099,CSE 290,C00,102414,Pannuto; Patrick William,0,0,25,25
1668059981099,CSE 290,D00,102427,Pevzner; Pavel Arkadjevich,0,0,0,0
1668059981099,CSE 290,E00,102429,Zhao; Jishen,0,0,0,0
1668059981099,CSE 290,F00,102436,Tullsen; Dean Michael,0,0,0,0
1668059981099,CSE 290,G00,102440,Christensen; Henrik I,0,0,20,20
1668059981525,CSE 291,A00,102443,Su; Hao,0,0,0,0
1668059981525,CSE 291,B00,102448,Polikarpova; Nadezhda,0,0,0,0
1668059981525,CSE 291,C00,102453,Vaccaro; Kristen Marie,0,0,0,0
1668059981525,CSE 291,D00,111343,Savage; Stefan,0,0,0,0
1668059981525,CSE 291,E00,116474,Claffy; Kimberly Claire,0,0,0,0
1668059981525,CSE 291,F00,116479,Pasquale; Joseph,0,0,0,0
1668059981950,CSE 293,001,119111,Bafna; Vineet,9999,0,9999,0
1668059981950,CSE 293,002,119118,Bellare; Mihir,9999,0,9999,0
1668059981950,CSE 293,003,119122,Berg-Kirkpatrick; Taylor D,9999,0,9999,0
1668059981950,CSE 293,004,119135,Christensen; Henrik I,9999,0,9999,0
1668059981950,CSE 293,005,119142,Cottrell; Garrison W,9999,0,9999,0
1668059981950,CSE 293,006,119146,Deutsch; Alin Bernard,9999,0,9999,0
1668059981950,CSE 293,007,119159,Esmaeilzadeh; Hadi,9999,0,9999,0
1668059981950,CSE 293,008,119166,Freund; Yoav,9999,0,9999,0
1668059981950,CSE 293,009,119170,Griswold; William G.,9999,0,9999,0
1668059981950,CSE 293,010,119183,Gymrek; Melissa Ann,9999,0,9999,0
1668059981950,CSE 293,011,119190,Heninger; Nadia A,9999,0,9999,0
1668059981950,CSE 293,012,119230,Impagliazzo; Russell,9999,0,9999,0
1668059981950,CSE 293,013,119232,Jhala; Ranjit,9999,0,9999,0
1668059981950,CSE 293,014,119233,Kahng; Andrew Byun,9999,0,9999,0
1668059981950,CSE 293,015,119298,Kane; Daniel Mertz,9999,0,9999,0
1668059981950,CSE 293,016,119299,Kriegman; David J,9999,0,9999,0
1668059981950,CSE 293,017,119300,Kumar; Arun Kumar,9999,0,9999,0
1668059981950,CSE 293,018,119301,Lerner; Sorin,9999,0,9999,0
1668059981950,CSE 293,019,119302,Lovett; Shachar,9999,0,9999,0
1668059981950,CSE 293,020,119303,McAuley; Julian John,9999,0,9999,0
1668059981950,CSE 293,021,119304,Micciancio; Daniele,9999,0,9999,0
1668059981950,CSE 293,022,119367,Orailoglu; Alex,9999,0,9999,0
1668059981950,CSE 293,023,119382,Paturi; Ramamohan,9999,0,9999,0
1668059981950,CSE 293,024,119404,Polikarpova; Nadezhda,9999,0,9999,0
1668059981950,CSE 293,025,119406,Politz; Joseph Gibbs,9999,0,9999,0
1668059981950,CSE 293,026,119411,Porter; George M,9999,0,9999,0
1668059981950,CSE 293,027,119414,Porter; Leonard Emerson,9999,0,9999,0
1668059981950,CSE 293,028,119416,Ramamoorthi; Ravi,9999,0,9999,0
1668059981950,CSE 293,029,119417,Sahoo; Debashis,9999,0,9999,0
1668059981950,CSE 293,030,119420,Saul; Lawrence,9999,0,9999,0
1668059981950,CSE 293,031,119421,Savage; Stefan,9999,0,9999,0
1668059981950,CSE 293,032,119425,Schulze; Jurgen P.,9999,0,9999,0
1668059981950,CSE 293,033,119426,Snoeren; Alex C.,9999,0,9999,0
1668059981950,CSE 293,034,119428,Shang; Jingbo,9999,0,9999,0
1668059981950,CSE 293,035,119430,Stefan; Deian,9999,0,9999,0
1668059981950,CSE 293,036,119431,Su; Hao,9999,0,9999,0
1668059981950,CSE 293,037,119433,Swanson; Steven James,9999,0,9999,0
1668059981950,CSE 293,038,119435,Tullsen; Dean Michael,9999,0,9999,0
1668059981950,CSE 293,039,119483,Voelker; Geoffrey M.,9999,0,9999,0
1668059981950,CSE 293,040,119537,Zhao; Jishen,9999,0,9999,0
1668059981950,CSE 293,041,119538,Zhou; Yuan-Yuan,9999,0,9999,0
1668059981950,CSE 293,042,119539,Gao; Sicun,9999,0,9999,0
1668059981950,CSE 293,043,119540,Weibel; Nadir,9999,0,9999,0
1668059981950,CSE 293,044,119541,Gupta; Rajesh K.,9999,0,9999,0
1668059981950,CSE 293,045,126410,Vaccaro; Kristen Marie,9999,0,9999,0
1668059981950,CSE 293,046,126411,Klemke; Richard,9999,0,9999,0
1668059982376,CSE 294,A00,102459,Voelker; Geoffrey M.,0,0,0,0
1668059982376,CSE 294,B00,111322,Orailoglu; Alex,0,0,0,0
1668059982798,DSE 201,A00,096914,Deutsch; Alin Bernard,30,0,30,0
1668059983222,DSE 210,A00,096915,Dasgupta; Sanjoy,30,0,30,0
1668059983648,DSE 260A,A00,096916,Altintas De Callaf; Ilkay,30,0,30,0
1668059984105,ECE 200,001,103586,Antipa; Nicholas A,9999,0,9999,0
1668059984105,ECE 200,002,103587,Atanasov; Nikolay A.,9999,0,9999,0
1668059984105,ECE 200,003,103588,Bharadia; Dinesh,9999,0,9999,0
1668059984105,ECE 200,004,103589,Cheng; Chung Kuan,9999,0,9999,0
1668059984105,ECE 200,005,103590,Cosman; Pamela C.,9999,0,9999,0
1668059984105,ECE 200,006,103591,Dayeh; Shadi Ahmad,9999,0,9999,0
1668059984105,ECE 200,007,103592,Fainman; Yeshaiahu,9999,0,9999,0
1668059984105,ECE 200,008,103593,Ford; Joseph Earl,9999,0,9999,0
1668059984105,ECE 200,009,103594,Franceschetti; Massimo,9999,0,9999,0
1668059984105,ECE 200,010,103595,Fullerton; Eric E,9999,0,9999,0
1668059984105,ECE 200,011,103596,Galton; Ian A,9999,0,9999,0
1668059984105,ECE 200,012,103597,Gilja; Vikash,9999,0,9999,0
1668059984105,ECE 200,013,103598,Hall; Drew A.,9999,0,9999,0
1668059984105,ECE 200,014,103599,Hsueh; Tzu-Chien,9999,0,9999,0
1668059984105,ECE 200,015,103600,Javidi; Tara,9999,0,9999,0
1668059984105,ECE 200,016,103601,Kahng; Andrew Byun,9999,0,9999,0
1668059984105,ECE 200,017,103602,Kim; Young-Han,9999,0,9999,0
1668059984105,ECE 200,018,103603,Koushanfar; Farinaz,9999,0,9999,0
1668059984105,ECE 200,019,103604,Kuzum; Duygu,9999,0,9999,0
1668059984105,ECE 200,020,103605,Le; Hanh-Phuc,9999,0,9999,0
1668059984105,ECE 200,021,103606,Lin; Bill,9999,0,9999,0
1668059984105,ECE 200,022,103607,Liu; Zhaowei,9998,0,9999,1
1668059984105,ECE 200,023,103608,Lo; Yu-Hwa,9999,0,9999,0
1668059984105,ECE 200,024,103609,Lomakin; Vitaliy,9999,0,9999,0
1668059984105,ECE 200,025,103610,Mercier; Patrick Philip,9999,0,9999,0
1668059984105,ECE 200,026,103611,Meyer; Florian,9999,0,9999,0
1668059984105,ECE 200,027,103612,Milstein; Laurence B.,9999,0,9999,0
1668059984105,ECE 200,028,103613,Mir Arabbaygi; Siavash,9999,0,9999,0
1668059984105,ECE 200,029,103614,Mookherjea; Shayan,9999,0,9999,0
1668059984105,ECE 200,030,103615,Morris; Karcher William,9999,0,9999,0
1668059984105,ECE 200,031,103616,Ng; Tse Nga,9999,0,9999,0
1668059984105,ECE 200,032,103617,Nguyen; Truong Quang,9999,0,9999,0
1668059984105,ECE 200,033,103618,Nomura; Kenji,9999,0,9999,0
1668059984105,ECE 200,034,103619,Orlitsky; Alon,9999,0,9999,0
1668059984105,ECE 200,035,103620,Pal; Piya,9999,0,9999,0
1668059984105,ECE 200,036,103621,Papen; George C.,9999,0,9999,0
1668059984105,ECE 200,037,103622,Radic; Stojan,9999,0,9999,0
1668059984105,ECE 200,038,103623,Rao; Bhaskar D.,9999,0,9999,0
1668059984105,ECE 200,039,103624,Rao; Ramesh R,9999,0,9999,0
1668059984105,ECE 200,040,103625,Rebeiz; Gabriel,9999,0,9999,0
1668059984105,ECE 200,041,103626,Sanford; John R,9999,0,9999,0
1668059984105,ECE 200,042,103627,Siegel; Paul H.,9999,0,9999,0
1668059984105,ECE 200,043,103628,Sievenpiper; Daniel F.,9999,0,9999,0
1668059984105,ECE 200,044,103629,Sworder; David D.,9999,0,9999,0
1668059984105,ECE 200,045,103630,Taur; Yuan,9999,0,9999,0
1668059984105,ECE 200,046,103631,Touri; Behrouz,9999,0,9999,0
1668059984105,ECE 200,047,103632,Trivedi; Mohan M.,9999,0,9999,0
1668059984105,ECE 200,048,103633,Vasconcelos; Nuno,9999,0,9999,0
1668059984105,ECE 200,049,103634,Wang; Xiaolong,9999,0,9999,0
1668059984105,ECE 200,050,103635,Xie; Pengtao,9999,0,9999,0
1668059984105,ECE 200,051,103636,Yip; Michael,9999,0,9999,0
1668059984105,ECE 200,052,103637,Zeger; Kenneth A.,999,0,999,0
1668059984105,ECE 200,053,103638,Zhang; Xinyu,9999,0,9999,0
1668059984105,ECE 200,054,103639,Turakhia; Yatish Girish,9999,0,9999,0
1668059984105,ECE 200,055,103640,Kang; Mingu,9999,0,9999,0
1668059984105,ECE 200,056,103641,Shi; Yuanyuan,9999,0,9999,0
1668059984105,ECE 200,057,103642,Wang; Edward Jay,9999,0,9999,0
1668059984105,ECE 200,058,103643,Zheng; Yang,9999,0,9999,0
1668059984533,ECE 202,A00,103644,Kuzum; Duygu,0,0,0,0
1668059984967,ECE 212BN,A00,103646,Ng; Tse Nga,0,0,0,0
1668059985392,ECE 221,A00,111493,Staff,0,0,0,0
1668059985826,ECE 222B,A00,103647,Lomakin; Vitaliy,0,0,0,0
1668059986327,ECE 230B,A00,103648,Taur; Yuan,0,0,0,0
1668059986767,ECE 238B,A00,103649,Garay; Javier,0,0,0,0
1668059987204,ECE 240B,A00,112900,Fainman; Yeshaiahu,0,0,0,0
1668059987636,ECE 247A,A00,103650,Jokerst; Jesse Vincent,0,0,0,0
1668059988070,ECE 247B,A00,103651,Wang; Joseph,0,0,0,0
1668059988494,ECE 250,A00,103652,Siegel; Paul H.,0,0,0,0
1668059988935,ECE 251A,A00,103654,Rao; Bhaskar D.,0,0,0,0
1668059989368,ECE 257B,A00,103655,Bharadia; Dinesh,0,0,0,0
1668059989792,ECE 258A,A00,103656,Milstein; Laurence B.,0,0,0,0
1668059990218,ECE 260B,A00,103658,Kang; Mingu,0,0,0,0
1668059990650,ECE 264A,A00,103659,Galton; Ian A,0,0,0,0
1668059991074,ECE 265A,A00,103661,Gudem; Prasad S.S.,0,0,0,0
1668059991498,ECE 265D,A00,103662,Gudem; Prasad S.S.,0,0,0,0
1668059991920,ECE 268,A00,103663,Koushanfar; Farinaz,0,0,0,0
1668059992342,ECE 269,A01,103665,Pal; Piya,0,0,0,0
1668059992771,ECE 271B,A00,103666,Vasconcelos; Manuela,0,0,0,0
1668059993198,ECE 276A,A00,103667,Atanasov; Nikolay A.,0,0,0,0
1668059993620,ECE 277,A00,103668,An; Cheolhong,0,0,0,0
1668059994042,ECE 279,A00,117947,Hall; Drew A.,0,0,0,0
1668059994899,ECE 283,A00,103670,Hsueh; Tzu-Chien,0,0,0,0
1668059995324,ECE 284,A00,103671,Turakhia; Yatish Girish,0,0,0,0
1668059995751,ECE 285,A00,103672,Zheng; Yang,0,0,0,0
1668059995751,ECE 285,B00,103673,Sworder; David D.,0,0,0,0
1668059996176,ECE 287,A00,103676,Javidi; Tara,0,0,0,0
1668059996601,MATH 200B,A00,098023,Salehi Golsefidy; Alireza,13,0,15,2
1668059997029,MATH 202B,A00,098024,Rhoades; Brendon Patrick,9,0,15,6
1668059997455,MATH 203B,A00,098025,Oprea; Dragos N.,11,0,15,4
1668059997880,MATH 204B,A00,098026,Sorensen; Claus M,13,0,15,2
1668059998304,MATH 208,A00,098027,Izadi; Elham,7,0,10,3
1668059998729,MATH 209,A00,098028,Pollack; Aaron,10,0,10,0
1668059999155,MATH 211A,A00,112919,Rogalski; Daniel,9,0,10,1
1668059999579,MATH 211B,A00,112920,Seward; Brandon M.,9,0,10,1
1668060000002,MATH 218,A00,098029,Li; Bo,10,0,10,0
1668060000441,MATH 220B,A00,098030,Novak; Jonathan I,13,0,15,2
1668060000877,MATH 221A,A00,098031,Ebenfelt; Peter F,13,0,15,2
1668060001301,MATH 231B,A00,098032,Zlatos; Andrej,12,0,15,3
1668060001728,MATH 240B,A00,098033,Ni; Lei,9,0,15,6
1668060002156,MATH 243,A00,098034,Jekel; David Andrew,10,0,10,0
1668060002597,MATH 245A,A00,098035,Nie; Jiawang,0,0,15,16
1668060003022,MATH 248,A00,098036,Bejenaru; Ioan,10,0,10,0
1668060003578,MATH 250B,A00,098037,Spolaor; Luca,14,0,15,1
1668060004003,MATH 258,A00,098038,Ni; Lei,10,0,10,0
1668060004431,MATH 264B,A00,098041,Rhoades; Brendon Patrick,10,0,15,5
1668060004871,MATH 268,A00,098042,Buss; Samuel R,10,0,10,0
1668060005308,MATH 269,A00,098043,Rhoades; Brendon Patrick,10,0,10,0
1668060005736,MATH 270B,A00,098044,Li; Bo,11,0,15,4
1668060006157,MATH 272B,A00,098045,Holst; Michael J,13,0,15,2
1668060006585,MATH 273A,A00,098046,Tian; Xiaochuan,10,0,15,5
1668060007012,MATH 275,A01,098048,Tian; Xiaochuan,6,0,10,4
1668060007437,MATH 278A,A00,098049,Holst; Michael J,8,0,10,2
1668060007861,MATH 278B,A00,098050,Cloninger; Alexander,10,0,10,0
1668060008284,MATH 278C,A00,098051,Nie; Jiawang,7,0,10,3
1668060008709,MATH 280B,A00,098052,Zheng; Tianyi,10,0,15,5
1668060009134,MATH 281B,A00,098053,Bradic; Jelena,3,0,15,12
1668060009573,MATH 282B,A00,098054,Arias-Castro; Ery,0,0,15,15
1668060010000,MATH 285,A00,098055,Fitzsimmons; Patrick J,0,0,15,17
1668060010423,MATH 287B,A00,098056,Arias-Castro; Ery,3,0,15,12
1668060010850,MATH 288,A00,098057,Agarwal; Pooja,9,0,10,1
1668060010850,MATH 288,B00,098058,Zhang; Danna,8,0,10,2
1668060010850,MATH 288,C00,098059,Williams; Ruth J,10,0,10,0
1668060011276,MATH 290B,A00,098060,Roberts; Justin Deritter,13,0,15,2
1668060011713,MATH 292,A00,098061,Belmont; Eva Kinoshita,10,0,10,0
1668060012137,MATH 295,A00,098062,Suk; Andrew Hoon,48,0,50,2
1668060012573,MATH 296,A00,098063,Novak; Jonathan I,20,0,20,0
1668060013003,MATH 297,001,098064,Gamst; Anthony Collins,9997,0,9999,2
1668060526804,COGS 205,A00,101395,Chiba; Andrea,19,0,20,1
1668060527232,COGS 210B,001,101404,Greene; Deanna Jacquelyn,9998,0,9999,1
1668060527232,COGS 210B,002,101417,Xia; Haijun,9999,0,9999,0
1668060527232,COGS 210B,003,101422,Nitz; Douglas A.,9999,0,9999,0
1668060527232,COGS 210B,004,101423,Hollan; James D.,9998,0,9999,1
1668060527232,COGS 210B,005,101424,Deak; Gedeon O.,9998,0,9999,1
1668060527232,COGS 210B,006,101425,Rossano; Federico,9999,0,9999,0
1668060527682,COGS 211B,A00,101427,Coulson; Seana M,9996,0,9999,3
1668060528105,COGS 220,A00,101428,Hollan; James D.,0,0,25,25
1668060528530,COGS 229,A00,101429,Dow; Steven P,18,0,25,7
1668060528957,COGS 230,A00,101430,Klemmer; Scott R,13,0,17,4
1668060529391,COGS 234,A00,101431,Xia; Haijun,4,0,25,21
1668060529820,COGS 260,A00,101432,Kiyonaga; Anastasia,19,0,25,6
1668060529820,COGS 260,B00,101433,Kirsh; David Joel,16,0,25,9
1668060530245,CSE 202,A00,102371,Impagliazzo; Russell,0,0,0,0
1668060530694,CSE 203B,A01,102373,Cheng; Chung Kuan,0,0,0,0
1668060531128,CSE 208,A00,102374,Micciancio; Daniele,0,0,0,0
1668060531557,CSE 209A,A00,112895,Impagliazzo; Russell,0,0,15,15
1668060531981,CSE 209B,A00,108005,Bellare; Mihir,0,0,0,0
1668060532408,CSE 210,A00,113163,Coblenz; Michael J,0,0,0,0
1668060532837,CSE 219,A00,106111,Dow; Steven P,0,0,20,20
1668060533262,CSE 221,A00,102376,Voelker; Geoffrey M.,0,0,0,0
1668060533686,CSE 224,A01,102378,Porter; George M,0,0,0,0
1668060534112,CSE 229A,A00,102379,Savage; Stefan,0,0,0,0
1668060534539,CSE 229C,A00,102380,Munyaka; Imani N. S.,0,0,0,0
1668060534962,CSE 232B,A00,102382,Deutsch; Alin Bernard,0,0,0,0
1668060535396,CSE 234,A01,112904,Kumar; Arun Kumar,0,0,0,0
1668060535823,CSE 237A,A00,102383,Rosing; Tajana Simunic,0,0,0,0
1668060536247,CSE 239A,A00,102384,Deutsch; Alin Bernard,0,0,0,0
1668060536673,CSE 239B,A00,102385,Polikarpova; Nadezhda,0,0,0,0
1668060537100,CSE 240A,A00,102386,Pannuto; Patrick William,0,0,0,0
1668060537526,CSE 240B,A00,102387,Zhao; Jishen,0,0,0,0
1668060537951,CSE 241A,A00,106406,Kang; Mingu,0,0,0,0
1668060538376,CSE 249B,A00,102388,Kahng; Andrew Byun,0,0,8,8
1668060538813,CSE 251B,A01,102392,Cottrell; Garrison W,0,0,0,0
1668060538813,CSE 251B,A02,102393,Cottrell; Garrison W,0,0,0,0
1668060539241,CSE 252B,A00,102394,Ochoa; Benjamin Lawrence,0,0,0,0
1668060539669,CSE 257,A01,102396,Gao; Sicun,0,0,0,0
1668060540101,CSE 272,A00,102397,Li; Tzumao,0,0,0,0
1668060540541,CSE 274,A00,111323,Chern; Albert Ren-Haur,0,0,0,0
1668060540964,CSE 282,A00,102398,Pevzner; Pavel Arkadjevich,0,0,0,0
1668060541392,CSE 284,A00,114175,Gymrek; Melissa Ann,0,0,0,0
1668060541822,CSE 290,A00,102399,Chandraker; Manmohan Krishna,0,0,0,0
1668060541822,CSE 290,B00,102400,Vaccaro; Kristen Marie,0,0,25,25
1668060541822,CSE 290,C00,102414,Pannuto; Patrick William,0,0,25,25
1668060541822,CSE 290,D00,102427,Pevzner; Pavel Arkadjevich,0,0,0,0
1668060541822,CSE 290,E00,102429,Zhao; Jishen,0,0,0,0
1668060541822,CSE 290,F00,102436,Tullsen; Dean Michael,0,0,0,0
1668060541822,CSE 290,G00,102440,Christensen; Henrik I,0,0,20,20
1668060542252,CSE 291,A00,102443,Su; Hao,0,0,0,0
1668060542252,CSE 291,B00,102448,Polikarpova; Nadezhda,0,0,0,0
1668060542252,CSE 291,C00,102453,Vaccaro; Kristen Marie,0,0,0,0
1668060542252,CSE 291,D00,111343,Savage; Stefan,0,0,0,0
1668060542252,CSE 291,E00,116474,Claffy; Kimberly Claire,0,0,0,0
1668060542252,CSE 291,F00,116479,Pasquale; Joseph,0,0,0,0
1668060542700,CSE 293,001,119111,Bafna; Vineet,9999,0,9999,0
1668060542700,CSE 293,002,119118,Bellare; Mihir,9999,0,9999,0
1668060542700,CSE 293,003,119122,Berg-Kirkpatrick; Taylor D,9999,0,9999,0
1668060542700,CSE 293,004,119135,Christensen; Henrik I,9999,0,9999,0
1668060542700,CSE 293,005,119142,Cottrell; Garrison W,9999,0,9999,0
1668060542700,CSE 293,006,119146,Deutsch; Alin Bernard,9999,0,9999,0
1668060542700,CSE 293,007,119159,Esmaeilzadeh; Hadi,9999,0,9999,0
1668060542700,CSE 293,008,119166,Freund; Yoav,9999,0,9999,0
1668060542700,CSE 293,009,119170,Griswold; William G.,9999,0,9999,0
1668060542700,CSE 293,010,119183,Gymrek; Melissa Ann,9999,0,9999,0
1668060542700,CSE 293,011,119190,Heninger; Nadia A,9999,0,9999,0
1668060542700,CSE 293,012,119230,Impagliazzo; Russell,9999,0,9999,0
1668060542700,CSE 293,013,119232,Jhala; Ranjit,9999,0,9999,0
1668060542700,CSE 293,014,119233,Kahng; Andrew Byun,9999,0,9999,0
1668060542700,CSE 293,015,119298,Kane; Daniel Mertz,9999,0,9999,0
1668060542700,CSE 293,016,119299,Kriegman; David J,9999,0,9999,0
1668060542700,CSE 293,017,119300,Kumar; Arun Kumar,9999,0,9999,0
1668060542700,CSE 293,018,119301,Lerner; Sorin,9999,0,9999,0
1668060542700,CSE 293,019,119302,Lovett; Shachar,9999,0,9999,0
1668060542700,CSE 293,020,119303,McAuley; Julian John,9999,0,9999,0
1668060542700,CSE 293,021,119304,Micciancio; Daniele,9999,0,9999,0
1668060542700,CSE 293,022,119367,Orailoglu; Alex,9999,0,9999,0
1668060542700,CSE 293,023,119382,Paturi; Ramamohan,9999,0,9999,0
1668060542700,CSE 293,024,119404,Polikarpova; Nadezhda,9999,0,9999,0
1668060542700,CSE 293,025,119406,Politz; Joseph Gibbs,9999,0,9999,0
1668060542700,CSE 293,026,119411,Porter; George M,9999,0,9999,0
1668060542700,CSE 293,027,119414,Porter; Leonard Emerson,9999,0,9999,0
1668060542700,CSE 293,028,119416,Ramamoorthi; Ravi,9999,0,9999,0
1668060542700,CSE 293,029,119417,Sahoo; Debashis,9999,0,9999,0
1668060542700,CSE 293,030,119420,Saul; Lawrence,9999,0,9999,0
1668060542700,CSE 293,031,119421,Savage; Stefan,9999,0,9999,0
1668060542700,CSE 293,032,119425,Schulze; Jurgen P.,9999,0,9999,0
1668060542700,CSE 293,033,119426,Snoeren; Alex C.,9999,0,9999,0
1668060542700,CSE 293,034,119428,Shang; Jingbo,9999,0,9999,0
1668060542700,CSE 293,035,119430,Stefan; Deian,9999,0,9999,0
1668060542700,CSE 293,036,119431,Su; Hao,9999,0,9999,0
1668060542700,CSE 293,037,119433,Swanson; Steven James,9999,0,9999,0
1668060542700,CSE 293,038,119435,Tullsen; Dean Michael,9999,0,9999,0
1668060542700,CSE 293,039,119483,Voelker; Geoffrey M.,9999,0,9999,0
1668060542700,CSE 293,040,119537,Zhao; Jishen,9999,0,9999,0
1668060542700,CSE 293,041,119538,Zhou; Yuan-Yuan,9999,0,9999,0
1668060542700,CSE 293,042,119539,Gao; Sicun,9999,0,9999,0
1668060542700,CSE 293,043,119540,Weibel; Nadir,9999,0,9999,0
1668060542700,CSE 293,044,119541,Gupta; Rajesh K.,9999,0,9999,0
1668060542700,CSE 293,045,126410,Vaccaro; Kristen Marie,9999,0,9999,0
1668060542700,CSE 293,046,126411,Klemke; Richard,9999,0,9999,0
1668060543126,CSE 294,A00,102459,Voelker; Geoffrey M.,0,0,0,0
1668060543126,CSE 294,B00,111322,Orailoglu; Alex,0,0,0,0
1668060543553,DSE 201,A00,096914,Deutsch; Alin Bernard,30,0,30,0
1668060543978,DSE 210,A00,096915,Dasgupta; Sanjoy,30,0,30,0
1668060544406,DSE 260A,A00,096916,Altintas De Callaf; Ilkay,30,0,30,0
1668060544872,ECE 200,001,103586,Antipa; Nicholas A,9999,0,9999,0
1668060544872,ECE 200,002,103587,Atanasov; Nikolay A.,9999,0,9999,0
1668060544872,ECE 200,003,103588,Bharadia; Dinesh,9999,0,9999,0
1668060544872,ECE 200,004,103589,Cheng; Chung Kuan,9999,0,9999,0
1668060544872,ECE 200,005,103590,Cosman; Pamela C.,9999,0,9999,0
1668060544872,ECE 200,006,103591,Dayeh; Shadi Ahmad,9999,0,9999,0
1668060544872,ECE 200,007,103592,Fainman; Yeshaiahu,9999,0,9999,0
1668060544872,ECE 200,008,103593,Ford; Joseph Earl,9999,0,9999,0
1668060544872,ECE 200,009,103594,Franceschetti; Massimo,9999,0,9999,0
1668060544872,ECE 200,010,103595,Fullerton; Eric E,9999,0,9999,0
1668060544872,ECE 200,011,103596,Galton; Ian A,9999,0,9999,0
1668060544872,ECE 200,012,103597,Gilja; Vikash,9999,0,9999,0
1668060544872,ECE 200,013,103598,Hall; Drew A.,9999,0,9999,0
1668060544872,ECE 200,014,103599,Hsueh; Tzu-Chien,9999,0,9999,0
1668060544872,ECE 200,015,103600,Javidi; Tara,9999,0,9999,0
1668060544872,ECE 200,016,103601,Kahng; Andrew Byun,9999,0,9999,0
1668060544872,ECE 200,017,103602,Kim; Young-Han,9999,0,9999,0
1668060544872,ECE 200,018,103603,Koushanfar; Farinaz,9999,0,9999,0
1668060544872,ECE 200,019,103604,Kuzum; Duygu,9999,0,9999,0
1668060544872,ECE 200,020,103605,Le; Hanh-Phuc,9999,0,9999,0
1668060544872,ECE 200,021,103606,Lin; Bill,9999,0,9999,0
1668060544872,ECE 200,022,103607,Liu; Zhaowei,9998,0,9999,1
1668060544872,ECE 200,023,103608,Lo; Yu-Hwa,9999,0,9999,0
1668060544872,ECE 200,024,103609,Lomakin; Vitaliy,9999,0,9999,0
1668060544872,ECE 200,025,103610,Mercier; Patrick Philip,9999,0,9999,0
1668060544872,ECE 200,026,103611,Meyer; Florian,9999,0,9999,0
1668060544872,ECE 200,027,103612,Milstein; Laurence B.,9999,0,9999,0
1668060544872,ECE 200,028,103613,Mir Arabbaygi; Siavash,9999,0,9999,0
1668060544872,ECE 200,029,103614,Mookherjea; Shayan,9999,0,9999,0
1668060544872,ECE 200,030,103615,Morris; Karcher William,9999,0,9999,0
1668060544872,ECE 200,031,103616,Ng; Tse Nga,9999,0,9999,0
1668060544872,ECE 200,032,103617,Nguyen; Truong Quang,9999,0,9999,0
1668060544872,ECE 200,033,103618,Nomura; Kenji,9999,0,9999,0
1668060544872,ECE 200,034,103619,Orlitsky; Alon,9999,0,9999,0
1668060544872,ECE 200,035,103620,Pal; Piya,9999,0,9999,0
1668060544872,ECE 200,036,103621,Papen; George C.,9999,0,9999,0
1668060544872,ECE 200,037,103622,Radic; Stojan,9999,0,9999,0
1668060544872,ECE 200,038,103623,Rao; Bhaskar D.,9999,0,9999,0
1668060544872,ECE 200,039,103624,Rao; Ramesh R,9999,0,9999,0
1668060544872,ECE 200,040,103625,Rebeiz; Gabriel,9999,0,9999,0
1668060544872,ECE 200,041,103626,Sanford; John R,9999,0,9999,0
1668060544872,ECE 200,042,103627,Siegel; Paul H.,9999,0,9999,0
1668060544872,ECE 200,043,103628,Sievenpiper; Daniel F.,9999,0,9999,0
1668060544872,ECE 200,044,103629,Sworder; David D.,9999,0,9999,0
1668060544872,ECE 200,045,103630,Taur; Yuan,9999,0,9999,0
1668060544872,ECE 200,046,103631,Touri; Behrouz,9999,0,9999,0
1668060544872,ECE 200,047,103632,Trivedi; Mohan M.,9999,0,9999,0
1668060544872,ECE 200,048,103633,Vasconcelos; Nuno,9999,0,9999,0
1668060544872,ECE 200,049,103634,Wang; Xiaolong,9999,0,9999,0
1668060544872,ECE 200,050,103635,Xie; Pengtao,9999,0,9999,0
1668060544872,ECE 200,051,103636,Yip; Michael,9999,0,9999,0
1668060544872,ECE 200,052,103637,Zeger; Kenneth A.,999,0,999,0
1668060544872,ECE 200,053,103638,Zhang; Xinyu,9999,0,9999,0
1668060544872,ECE 200,054,103639,Turakhia; Yatish Girish,9999,0,9999,0
1668060544872,ECE 200,055,103640,Kang; Mingu,9999,0,9999,0
1668060544872,ECE 200,056,103641,Shi; Yuanyuan,9999,0,9999,0
1668060544872,ECE 200,057,103642,Wang; Edward Jay,9999,0,9999,0
1668060544872,ECE 200,058,103643,Zheng; Yang,9999,0,9999,0
1668060545302,ECE 202,A00,103644,Kuzum; Duygu,0,0,0,0
1668060545742,ECE 212BN,A00,103646,Ng; Tse Nga,0,0,0,0
1668060546183,ECE 221,A00,111493,Staff,0,0,0,0
1668060546605,ECE 222B,A00,103647,Lomakin; Vitaliy,0,0,0,0
1668060547028,ECE 230B,A00,103648,Taur; Yuan,0,0,0,0
1668060547452,ECE 238B,A00,103649,Garay; Javier,0,0,0,0
1668060547875,ECE 240B,A00,112900,Fainman; Yeshaiahu,0,0,0,0
1668060548301,ECE 247A,A00,103650,Jokerst; Jesse Vincent,0,0,0,0
1668060548736,ECE 247B,A00,103651,Wang; Joseph,0,0,0,0
1668060549161,ECE 250,A00,103652,Siegel; Paul H.,0,0,0,0
1668060549586,ECE 251A,A00,103654,Rao; Bhaskar D.,0,0,0,0
1668060550012,ECE 257B,A00,103655,Bharadia; Dinesh,0,0,0,0
1668060550435,ECE 258A,A00,103656,Milstein; Laurence B.,0,0,0,0
1668060550858,ECE 260B,A00,103658,Kang; Mingu,0,0,0,0
1668060551295,ECE 264A,A00,103659,Galton; Ian A,0,0,0,0
1668060551720,ECE 265A,A00,103661,Gudem; Prasad S.S.,0,0,0,0
1668060552142,ECE 265D,A00,103662,Gudem; Prasad S.S.,0,0,0,0
1668060552582,ECE 268,A00,103663,Koushanfar; Farinaz,0,0,0,0
1668060553009,ECE 269,A01,103665,Pal; Piya,0,0,0,0
1668060553449,ECE 271B,A00,103666,Vasconcelos; Manuela,0,0,0,0
1668060553874,ECE 276A,A00,103667,Atanasov; Nikolay A.,0,0,0,0
1668060554301,ECE 277,A00,103668,An; Cheolhong,0,0,0,0
1668060554725,ECE 279,A00,117947,Hall; Drew A.,0,0,0,0
1668060555577,ECE 283,A00,103670,Hsueh; Tzu-Chien,0,0,0,0
1668060556000,ECE 284,A00,103671,Turakhia; Yatish Girish,0,0,0,0
1668060556433,ECE 285,A00,103672,Zheng; Yang,0,0,0,0
1668060556433,ECE 285,B00,103673,Sworder; David D.,0,0,0,0
1668060556856,ECE 287,A00,103676,Javidi; Tara,0,0,0,0
1668060557282,MATH 200B,A00,098023,Salehi Golsefidy; Alireza,13,0,15,2
1668060557730,MATH 202B,A00,098024,Rhoades; Brendon Patrick,9,0,15,6
1668060558154,MATH 203B,A00,098025,Oprea; Dragos N.,11,0,15,4
1668060558577,MATH 204B,A00,098026,Sorensen; Claus M,13,0,15,2
1668060559002,MATH 208,A00,098027,Izadi; Elham,7,0,10,3
1668060559427,MATH 209,A00,098028,Pollack; Aaron,10,0,10,0
1668060559853,MATH 211A,A00,112919,Rogalski; Daniel,9,0,10,1
1668060560280,MATH 211B,A00,112920,Seward; Brandon M.,9,0,10,1
1668060560702,MATH 218,A00,098029,Li; Bo,10,0,10,0
1668060561133,MATH 220B,A00,098030,Novak; Jonathan I,13,0,15,2
1668060561564,MATH 221A,A00,098031,Ebenfelt; Peter F,13,0,15,2
1668060561991,MATH 231B,A00,098032,Zlatos; Andrej,12,0,15,3
1668060562426,MATH 240B,A00,098033,Ni; Lei,9,0,15,6
1668060562869,MATH 243,A00,098034,Jekel; David Andrew,10,0,10,0
1668060563306,MATH 245A,A00,098035,Nie; Jiawang,0,0,15,16
1668060563826,MATH 248,A00,098036,Bejenaru; Ioan,10,0,10,0
1668060564248,MATH 250B,A00,098037,Spolaor; Luca,14,0,15,1
1668060564676,MATH 258,A00,098038,Ni; Lei,10,0,10,0
1668060565103,MATH 264B,A00,098041,Rhoades; Brendon Patrick,10,0,15,5
1668060565525,MATH 268,A00,098042,Buss; Samuel R,10,0,10,0
1668060565946,MATH 269,A00,098043,Rhoades; Brendon Patrick,10,0,10,0
1668060566373,MATH 270B,A00,098044,Li; Bo,11,0,15,4
1668060566803,MATH 272B,A00,098045,Holst; Michael J,13,0,15,2
1668060567229,MATH 273A,A00,098046,Tian; Xiaochuan,10,0,15,5
1668060567651,MATH 275,A01,098048,Tian; Xiaochuan,6,0,10,4
1668060568074,MATH 278A,A00,098049,Holst; Michael J,8,0,10,2
1668060568501,MATH 278B,A00,098050,Cloninger; Alexander,10,0,10,0
1668060568924,MATH 278C,A00,098051,Nie; Jiawang,7,0,10,3
1668060569350,MATH 280B,A00,098052,Zheng; Tianyi,10,0,15,5
1668060569786,MATH 281B,A00,098053,Bradic; Jelena,3,0,15,12
1668060570212,MATH 282B,A00,098054,Arias-Castro; Ery,0,0,15,15
1668060570635,MATH 285,A00,098055,Fitzsimmons; Patrick J,0,0,15,17
1668060571062,MATH 287B,A00,098056,Arias-Castro; Ery,3,0,15,12
1668060571488,MATH 288,A00,098057,Agarwal; Pooja,9,0,10,1
1668060571488,MATH 288,B00,098058,Zhang; Danna,8,0,10,2
1668060571488,MATH 288,C00,098059,Williams; Ruth J,10,0,10,0
1668060571922,MATH 290B,A00,098060,Roberts; Justin Deritter,13,0,15,2
1668060572346,MATH 292,A00,098061,Belmont; Eva Kinoshita,10,0,10,0
1668060572770,MATH 295,A00,098062,Suk; Andrew Hoon,48,0,50,2
1668060573207,MATH 296,A00,098063,Novak; Jonathan I,20,0,20,0
1668060573631,MATH 297,001,098064,Gamst; Anthony Collins,9997,0,9999,2
1668061076393,COGS 205,A00,101395,Chiba; Andrea,19,0,20,1
1668061076820,COGS 210B,001,101404,Greene; Deanna Jacquelyn,9998,0,9999,1
1668061076820,COGS 210B,002,101417,Xia; Haijun,9999,0,9999,0
1668061076820,COGS 210B,003,101422,Nitz; Douglas A.,9999,0,9999,0
1668061076820,COGS 210B,004,101423,Hollan; James D.,9998,0,9999,1
1668061076820,COGS 210B,005,101424,Deak; Gedeon O.,9998,0,9999,1
1668061076820,COGS 210B,006,101425,Rossano; Federico,9999,0,9999,0
1668061077246,COGS 211B,A00,101427,Coulson; Seana M,9996,0,9999,3
1668061077670,COGS 220,A00,101428,Hollan; James D.,0,0,25,25
1668061078093,COGS 229,A00,101429,Dow; Steven P,18,0,25,7
1668061078518,COGS 230,A00,101430,Klemmer; Scott R,13,0,17,4
1668061078943,COGS 234,A00,101431,Xia; Haijun,4,0,25,21
1668061079371,COGS 260,A00,101432,Kiyonaga; Anastasia,19,0,25,6
1668061079371,COGS 260,B00,101433,Kirsh; David Joel,16,0,25,9
1668061079795,CSE 202,A00,102371,Impagliazzo; Russell,0,0,0,0
1668061080233,CSE 203B,A01,102373,Cheng; Chung Kuan,0,0,0,0
1668061080659,CSE 208,A00,102374,Micciancio; Daniele,0,0,0,0
1668061081083,CSE 209A,A00,112895,Impagliazzo; Russell,0,0,15,15
1668061081516,CSE 209B,A00,108005,Bellare; Mihir,0,0,0,0
1668061081940,CSE 210,A00,113163,Coblenz; Michael J,0,0,0,0
1668061082365,CSE 219,A00,106111,Dow; Steven P,0,0,20,20
1668061082798,CSE 221,A00,102376,Voelker; Geoffrey M.,0,0,0,0
1668061083229,CSE 224,A01,102378,Porter; George M,0,0,0,0
1668061083655,CSE 229A,A00,102379,Savage; Stefan,0,0,0,0
1668061084082,CSE 229C,A00,102380,Munyaka; Imani N. S.,0,0,0,0
1668061084513,CSE 232B,A00,102382,Deutsch; Alin Bernard,0,0,0,0
1668061084947,CSE 234,A01,112904,Kumar; Arun Kumar,0,0,0,0
1668061085373,CSE 237A,A00,102383,Rosing; Tajana Simunic,0,0,0,0
1668061085801,CSE 239A,A00,102384,Deutsch; Alin Bernard,0,0,0,0
1668061086231,CSE 239B,A00,102385,Polikarpova; Nadezhda,0,0,0,0
1668061086749,CSE 240A,A00,102386,Pannuto; Patrick William,0,0,0,0
1668061087182,CSE 240B,A00,102387,Zhao; Jishen,0,0,0,0
1668061087609,CSE 241A,A00,106406,Kang; Mingu,0,0,0,0
1668061088033,CSE 249B,A00,102388,Kahng; Andrew Byun,0,0,8,8
1668061088457,CSE 251B,A01,102392,Cottrell; Garrison W,0,0,0,0
1668061088457,CSE 251B,A02,102393,Cottrell; Garrison W,0,0,0,0
1668061088884,CSE 252B,A00,102394,Ochoa; Benjamin Lawrence,0,0,0,0
1668061089314,CSE 257,A01,102396,Gao; Sicun,0,0,0,0
1668061089738,CSE 272,A00,102397,Li; Tzumao,0,0,0,0
1668061090164,CSE 274,A00,111323,Chern; Albert Ren-Haur,0,0,0,0
1668061090587,CSE 282,A00,102398,Pevzner; Pavel Arkadjevich,0,0,0,0
1668061091014,CSE 284,A00,114175,Gymrek; Melissa Ann,0,0,0,0
1668061091438,CSE 290,A00,102399,Chandraker; Manmohan Krishna,0,0,0,0
1668061091438,CSE 290,B00,102400,Vaccaro; Kristen Marie,0,0,25,25
1668061091438,CSE 290,C00,102414,Pannuto; Patrick William,0,0,25,25
1668061091438,CSE 290,D00,102427,Pevzner; Pavel Arkadjevich,0,0,0,0
1668061091438,CSE 290,E00,102429,Zhao; Jishen,0,0,0,0
1668061091438,CSE 290,F00,102436,Tullsen; Dean Michael,0,0,0,0
1668061091438,CSE 290,G00,102440,Christensen; Henrik I,0,0,20,20
1668061091861,CSE 291,A00,102443,Su; Hao,0,0,0,0
1668061091861,CSE 291,B00,102448,Polikarpova; Nadezhda,0,0,0,0
1668061091861,CSE 291,C00,102453,Vaccaro; Kristen Marie,0,0,0,0
1668061091861,CSE 291,D00,111343,Savage; Stefan,0,0,0,0
1668061091861,CSE 291,E00,116474,Claffy; Kimberly Claire,0,0,0,0
1668061091861,CSE 291,F00,116479,Pasquale; Joseph,0,0,0,0
1668061092296,CSE 293,001,119111,Bafna; Vineet,9999,0,9999,0
1668061092296,CSE 293,002,119118,Bellare; Mihir,9999,0,9999,0
1668061092296,CSE 293,003,119122,Berg-Kirkpatrick; Taylor D,9999,0,9999,0
1668061092296,CSE 293,004,119135,Christensen; Henrik I,9999,0,9999,0
1668061092296,CSE 293,005,119142,Cottrell; Garrison W,9999,0,9999,0
1668061092296,CSE 293,006,119146,Deutsch; Alin Bernard,9999,0,9999,0
1668061092296,CSE 293,007,119159,Esmaeilzadeh; Hadi,9999,0,9999,0
1668061092296,CSE 293,008,119166,Freund; Yoav,9999,0,9999,0
1668061092296,CSE 293,009,119170,Griswold; William G.,9999,0,9999,0
1668061092296,CSE 293,010,119183,Gymrek; Melissa Ann,9999,0,9999,0
1668061092296,CSE 293,011,119190,Heninger; Nadia A,9999,0,9999,0
1668061092296,CSE 293,012,119230,Impagliazzo; Russell,9999,0,9999,0
1668061092296,CSE 293,013,119232,Jhala; Ranjit,9999,0,9999,0
1668061092296,CSE 293,014,119233,Kahng; Andrew Byun,9999,0,9999,0
1668061092296,CSE 293,015,119298,Kane; Daniel Mertz,9999,0,9999,0
1668061092296,CSE 293,016,119299,Kriegman; David J,9999,0,9999,0
1668061092296,CSE 293,017,119300,Kumar; Arun Kumar,9999,0,9999,0
1668061092296,CSE 293,018,119301,Lerner; Sorin,9999,0,9999,0
1668061092296,CSE 293,019,119302,Lovett; Shachar,9999,0,9999,0
1668061092296,CSE 293,020,119303,McAuley; Julian John,9999,0,9999,0
1668061092296,CSE 293,021,119304,Micciancio; Daniele,9999,0,9999,0
1668061092296,CSE 293,022,119367,Orailoglu; Alex,9999,0,9999,0
1668061092296,CSE 293,023,119382,Paturi; Ramamohan,9999,0,9999,0
1668061092296,CSE 293,024,119404,Polikarpova; Nadezhda,9999,0,9999,0
1668061092296,CSE 293,025,119406,Politz; Joseph Gibbs,9999,0,9999,0
1668061092296,CSE 293,026,119411,Porter; George M,9999,0,9999,0
1668061092296,CSE 293,027,119414,Porter; Leonard Emerson,9999,0,9999,0
1668061092296,CSE 293,028,119416,Ramamoorthi; Ravi,9999,0,9999,0
1668061092296,CSE 293,029,119417,Sahoo; Debashis,9999,0,9999,0
1668061092296,CSE 293,030,119420,Saul; Lawrence,9999,0,9999,0
1668061092296,CSE 293,031,119421,Savage; Stefan,9999,0,9999,0
1668061092296,CSE 293,032,119425,Schulze; Jurgen P.,9999,0,9999,0
1668061092296,CSE 293,033,119426,Snoeren; Alex C.,9999,0,9999,0
1668061092296,CSE 293,034,119428,Shang; Jingbo,9999,0,9999,0
1668061092296,CSE 293,035,119430,Stefan; Deian,9999,0,9999,0
1668061092296,CSE 293,036,119431,Su; Hao,9999,0,9999,0
1668061092296,CSE 293,037,119433,Swanson; Steven James,9999,0,9999,0
1668061092296,CSE 293,038,119435,Tullsen; Dean Michael,9999,0,9999,0
1668061092296,CSE 293,039,119483,Voelker; Geoffrey M.,9999,0,9999,0
1668061092296,CSE 293,040,119537,Zhao; Jishen,9999,0,9999,0
1668061092296,CSE 293,041,119538,Zhou; Yuan-Yuan,9999,0,9999,0
1668061092296,CSE 293,042,119539,Gao; Sicun,9999,0,9999,0
1668061092296,CSE 293,043,119540,Weibel; Nadir,9999,0,9999,0
1668061092296,CSE 293,044,119541,Gupta; Rajesh K.,9999,0,9999,0
1668061092296,CSE 293,045,126410,Vaccaro; Kristen Marie,9999,0,9999,0
1668061092296,CSE 293,046,126411,Klemke; Richard,9999,0,9999,0
1668061092726,CSE 294,A00,102459,Voelker; Geoffrey M.,0,0,0,0
1668061092726,CSE 294,B00,111322,Orailoglu; Alex,0,0,0,0
1668061093150,DSE 201,A00,096914,Deutsch; Alin Bernard,30,0,30,0
1668061093574,DSE 210,A00,096915,Dasgupta; Sanjoy,30,0,30,0
1668061093998,DSE 260A,A00,096916,Altintas De Callaf; Ilkay,30,0,30,0
1668061094433,ECE 200,001,103586,Antipa; Nicholas A,9999,0,9999,0
1668061094433,ECE 200,002,103587,Atanasov; Nikolay A.,9999,0,9999,0
1668061094433,ECE 200,003,103588,Bharadia; Dinesh,9999,0,9999,0
1668061094433,ECE 200,004,103589,Cheng; Chung Kuan,9999,0,9999,0
1668061094433,ECE 200,005,103590,Cosman; Pamela C.,9999,0,9999,0
1668061094433,ECE 200,006,103591,Dayeh; Shadi Ahmad,9999,0,9999,0
1668061094433,ECE 200,007,103592,Fainman; Yeshaiahu,9999,0,9999,0
1668061094433,ECE 200,008,103593,Ford; Joseph Earl,9999,0,9999,0
1668061094433,ECE 200,009,103594,Franceschetti; Massimo,9999,0,9999,0
1668061094433,ECE 200,010,103595,Fullerton; Eric E,9999,0,9999,0
1668061094433,ECE 200,011,103596,Galton; Ian A,9999,0,9999,0
1668061094433,ECE 200,012,103597,Gilja; Vikash,9999,0,9999,0
1668061094433,ECE 200,013,103598,Hall; Drew A.,9999,0,9999,0
1668061094433,ECE 200,014,103599,Hsueh; Tzu-Chien,9999,0,9999,0
1668061094433,ECE 200,015,103600,Javidi; Tara,9999,0,9999,0
1668061094433,ECE 200,016,103601,Kahng; Andrew Byun,9999,0,9999,0
1668061094433,ECE 200,017,103602,Kim; Young-Han,9999,0,9999,0
1668061094433,ECE 200,018,103603,Koushanfar; Farinaz,9999,0,9999,0
1668061094433,ECE 200,019,103604,Kuzum; Duygu,9999,0,9999,0
1668061094433,ECE 200,020,103605,Le; Hanh-Phuc,9999,0,9999,0
1668061094433,ECE 200,021,103606,Lin; Bill,9999,0,9999,0
1668061094433,ECE 200,022,103607,Liu; Zhaowei,9998,0,9999,1
1668061094433,ECE 200,023,103608,Lo; Yu-Hwa,9999,0,9999,0
1668061094433,ECE 200,024,103609,Lomakin; Vitaliy,9999,0,9999,0
1668061094433,ECE 200,025,103610,Mercier; Patrick Philip,9999,0,9999,0
1668061094433,ECE 200,026,103611,Meyer; Florian,9999,0,9999,0
1668061094433,ECE 200,027,103612,Milstein; Laurence B.,9999,0,9999,0
1668061094433,ECE 200,028,103613,Mir Arabbaygi; Siavash,9999,0,9999,0
1668061094433,ECE 200,029,103614,Mookherjea; Shayan,9999,0,9999,0
1668061094433,ECE 200,030,103615,Morris; Karcher William,9999,0,9999,0
1668061094433,ECE 200,031,103616,Ng; Tse Nga,9999,0,9999,0
1668061094433,ECE 200,032,103617,Nguyen; Truong Quang,9999,0,9999,0
1668061094433,ECE 200,033,103618,Nomura; Kenji,9999,0,9999,0
1668061094433,ECE 200,034,103619,Orlitsky; Alon,9999,0,9999,0
1668061094433,ECE 200,035,103620,Pal; Piya,9999,0,9999,0
1668061094433,ECE 200,036,103621,Papen; George C.,9999,0,9999,0
1668061094433,ECE 200,037,103622,Radic; Stojan,9999,0,9999,0
1668061094433,ECE 200,038,103623,Rao; Bhaskar D.,9999,0,9999,0
1668061094433,ECE 200,039,103624,Rao; Ramesh R,9999,0,9999,0
1668061094433,ECE 200,040,103625,Rebeiz; Gabriel,9999,0,9999,0
1668061094433,ECE 200,041,103626,Sanford; John R,9999,0,9999,0
1668061094433,ECE 200,042,103627,Siegel; Paul H.,9999,0,9999,0
1668061094433,ECE 200,043,103628,Sievenpiper; Daniel F.,9999,0,9999,0
1668061094433,ECE 200,044,103629,Sworder; David D.,9999,0,9999,0
1668061094433,ECE 200,045,103630,Taur; Yuan,9999,0,9999,0
1668061094433,ECE 200,046,103631,Touri; Behrouz,9999,0,9999,0
1668061094433,ECE 200,047,103632,Trivedi; Mohan M.,9999,0,9999,0
1668061094433,ECE 200,048,103633,Vasconcelos; Nuno,9999,0,9999,0
1668061094433,ECE 200,049,103634,Wang; Xiaolong,9999,0,9999,0
1668061094433,ECE 200,050,103635,Xie; Pengtao,9999,0,9999,0
1668061094433,ECE 200,051,103636,Yip; Michael,9999,0,9999,0
1668061094433,ECE 200,052,103637,Zeger; Kenneth A.,999,0,999,0
1668061094433,ECE 200,053,103638,Zhang; Xinyu,9999,0,9999,0
1668061094433,ECE 200,054,103639,Turakhia; Yatish Girish,9999,0,9999,0
1668061094433,ECE 200,055,103640,Kang; Mingu,9999,0,9999,0
1668061094433,ECE 200,056,103641,Shi; Yuanyuan,9999,0,9999,0
1668061094433,ECE 200,057,103642,Wang; Edward Jay,9999,0,9999,0
1668061094433,ECE 200,058,103643,Zheng; Yang,9999,0,9999,0
1668061094860,ECE 202,A00,103644,Kuzum; Duygu,0,0,0,0
1668061095294,ECE 212BN,A00,103646,Ng; Tse Nga,0,0,0,0
1668061095733,ECE 221,A00,111493,Staff,0,0,0,0
1668061096158,ECE 222B,A00,103647,Lomakin; Vitaliy,0,0,0,0
1668061096591,ECE 230B,A00,103648,Taur; Yuan,0,0,0,0
1668061097013,ECE 238B,A00,103649,Garay; Javier,0,0,0,0
1668061097436,ECE 240B,A00,112900,Fainman; Yeshaiahu,0,0,0,0
1668061097863,ECE 247A,A00,103650,Jokerst; Jesse Vincent,0,0,0,0
1668061098286,ECE 247B,A00,103651,Wang; Joseph,0,0,0,0
1668061098710,ECE 250,A00,103652,Siegel; Paul H.,0,0,0,0
1668061099138,ECE 251A,A00,103654,Rao; Bhaskar D.,0,0,0,0
1668061099567,ECE 257B,A00,103655,Bharadia; Dinesh,0,0,0,0
1668061099993,ECE 258A,A00,103656,Milstein; Laurence B.,0,0,0,0
1668061100422,ECE 260B,A00,103658,Kang; Mingu,0,0,0,0
1668061100845,ECE 264A,A00,103659,Galton; Ian A,0,0,0,0
1668061101270,ECE 265A,A00,103661,Gudem; Prasad S.S.,0,0,0,0
1668061101694,ECE 265D,A00,103662,Gudem; Prasad S.S.,0,0,0,0
1668061102121,ECE 268,A00,103663,Koushanfar; Farinaz,0,0,0,0
1668061102546,ECE 269,A01,103665,Pal; Piya,0,0,0,0
1668061102971,ECE 271B,A00,103666,Vasconcelos; Manuela,0,0,0,0
1668061103399,ECE 276A,A00,103667,Atanasov; Nikolay A.,0,0,0,0
1668061103829,ECE 277,A00,103668,An; Cheolhong,0,0,0,0
1668061104251,ECE 279,A00,117947,Hall; Drew A.,0,0,0,0
1668061105102,ECE 283,A00,103670,Hsueh; Tzu-Chien,0,0,0,0
1668061105534,ECE 284,A00,103671,Turakhia; Yatish Girish,0,0,0,0
1668061105961,ECE 285,A00,103672,Zheng; Yang,0,0,0,0
1668061105961,ECE 285,B00,103673,Sworder; David D.,0,0,0,0
1668061106399,ECE 287,A00,103676,Javidi; Tara,0,0,0,0
1668061106835,MATH 200B,A00,098023,Salehi Golsefidy; Alireza,13,0,15,2
1668061107262,MATH 202B,A00,098024,Rhoades; Brendon Patrick,9,0,15,6
1668061107700,MATH 203B,A00,098025,Oprea; Dragos N.,11,0,15,4
1668061108132,MATH 204B,A00,098026,Sorensen; Claus M,13,0,15,2
1668061108559,MATH 208,A00,098027,Izadi; Elham,7,0,10,3
1668061108990,MATH 209,A00,098028,Pollack; Aaron,10,0,10,0
1668061109413,MATH 211A,A00,112919,Rogalski; Daniel,9,0,10,1
1668061109838,MATH 211B,A00,112920,Seward; Brandon M.,9,0,10,1
1668061110274,MATH 218,A00,098029,Li; Bo,10,0,10,0
1668061110697,MATH 220B,A00,098030,Novak; Jonathan I,13,0,15,2
1668061111119,MATH 221A,A00,098031,Ebenfelt; Peter F,13,0,15,2
1668061111554,MATH 231B,A00,098032,Zlatos; Andrej,12,0,15,3
1668061111978,MATH 240B,A00,098033,Ni; Lei,9,0,15,6
1668061112408,MATH 243,A00,098034,Jekel; David Andrew,10,0,10,0
1668061112832,MATH 245A,A00,098035,Nie; Jiawang,0,0,15,16
1668061113264,MATH 248,A00,098036,Bejenaru; Ioan,10,0,10,0
1668061113694,MATH 250B,A00,098037,Spolaor; Luca,14,0,15,1
1668061114116,MATH 258,A00,098038,Ni; Lei,10,0,10,0
1668061114551,MATH 264B,A00,098041,Rhoades; Brendon Patrick,10,0,15,5
1668061114975,MATH 268,A00,098042,Buss; Samuel R,10,0,10,0
1668061115405,MATH 269,A00,098043,Rhoades; Brendon Patrick,10,0,10,0
1668061115836,MATH 270B,A00,098044,Li; Bo,11,0,15,4
1668061116265,MATH 272B,A00,098045,Holst; Michael J,13,0,15,2
1668061116689,MATH 273A,A00,098046,Tian; Xiaochuan,10,0,15,5
1668061117117,MATH 275,A01,098048,Tian; Xiaochuan,6,0,10,4
1668061117543,MATH 278A,A00,098049,Holst; Michael J,8,0,10,2
1668061117969,MATH 278B,A00,098050,Cloninger; Alexander,10,0,10,0
1668061118392,MATH 278C,A00,098051,Nie; Jiawang,7,0,10,3
1668061118816,MATH 280B,A00,098052,Zheng; Tianyi,10,0,15,5
1668061119242,MATH 281B,A00,098053,Bradic; Jelena,3,0,15,12
1668061119664,MATH 282B,A00,098054,Arias-Castro; Ery,0,0,15,15
1668061120091,MATH 285,A00,098055,Fitzsimmons; Patrick J,0,0,15,17
1668061120517,MATH 287B,A00,098056,Arias-Castro; Ery,3,0,15,12
1668061120940,MATH 288,A00,098057,Agarwal; Pooja,9,0,10,1
1668061120940,MATH 288,B00,098058,Zhang; Danna,8,0,10,2
1668061120940,MATH 288,C00,098059,Williams; Ruth J,10,0,10,0
1668061121374,MATH 290B,A00,098060,Roberts; Justin Deritter,13,0,15,2
1668061121797,MATH 292,A00,098061,Belmont; Eva Kinoshita,10,0,10,0
1668061122224,MATH 295,A00,098062,Suk; Andrew Hoon,48,0,50,2
1668061122649,MATH 296,A00,098063,Novak; Jonathan I,20,0,20,0
1668061123070,MATH 297,001,098064,Gamst; Anthony Collins,9997,0,9999,2
1668061624867,COGS 205,A00,101395,Chiba; Andrea,19,0,20,1
1668061625301,COGS 210B,001,101404,Greene; Deanna Jacquelyn,9998,0,9999,1
1668061625301,COGS 210B,002,101417,Xia; Haijun,9999,0,9999,0
1668061625301,COGS 210B,003,101422,Nitz; Douglas A.,9999,0,9999,0
1668061625301,COGS 210B,004,101423,Hollan; James D.,9998,0,9999,1
1668061625301,COGS 210B,005,101424,Deak; Gedeon O.,9998,0,9999,1
1668061625301,COGS 210B,006,101425,Rossano; Federico,9999,0,9999,0
1668061625740,COGS 211B,A00,101427,Coulson; Seana M,9996,0,9999,3
1668061626162,COGS 220,A00,101428,Hollan; James D.,0,0,25,25
1668061626589,COGS 229,A00,101429,Dow; Steven P,18,0,25,7
1668061627014,COGS 230,A00,101430,Klemmer; Scott R,13,0,17,4
1668061627436,COGS 234,A00,101431,Xia; Haijun,4,0,25,21
1668061627863,COGS 260,A00,101432,Kiyonaga; Anastasia,19,0,25,6
1668061627863,COGS 260,B00,101433,Kirsh; David Joel,16,0,25,9
1668061628285,CSE 202,A00,102371,Impagliazzo; Russell,0,0,0,0
1668061628708,CSE 203B,A01,102373,Cheng; Chung Kuan,0,0,0,0
1668061629139,CSE 208,A00,102374,Micciancio; Daniele,0,0,0,0
1668061629564,CSE 209A,A00,112895,Impagliazzo; Russell,0,0,15,15
1668061629989,CSE 209B,A00,108005,Bellare; Mihir,0,0,0,0
1668061630417,CSE 210,A00,113163,Coblenz; Michael J,0,0,0,0
1668061630841,CSE 219,A00,106111,Dow; Steven P,0,0,20,20
1668061631268,CSE 221,A00,102376,Voelker; Geoffrey M.,0,0,0,0
1668061631704,CSE 224,A01,102378,Porter; George M,0,0,0,0
1668061632129,CSE 229A,A00,102379,Savage; Stefan,0,0,0,0
1668061632551,CSE 229C,A00,102380,Munyaka; Imani N. S.,0,0,0,0
1668061632987,CSE 232B,A00,102382,Deutsch; Alin Bernard,0,0,0,0
1668061633410,CSE 234,A01,112904,Kumar; Arun Kumar,0,0,0,0
1668061633835,CSE 237A,A00,102383,Rosing; Tajana Simunic,0,0,0,0
1668061634260,CSE 239A,A00,102384,Deutsch; Alin Bernard,0,0,0,0
1668061634684,CSE 239B,A00,102385,Polikarpova; Nadezhda,0,0,0,0
1668061635112,CSE 240A,A00,102386,Pannuto; Patrick William,0,0,0,0
1668061635540,CSE 240B,A00,102387,Zhao; Jishen,0,0,0,0
1668061635978,CSE 241A,A00,106406,Kang; Mingu,0,0,0,0
1668061636402,CSE 249B,A00,102388,Kahng; Andrew Byun,0,0,8,8
1668061636825,CSE 251B,A01,102392,Cottrell; Garrison W,0,0,0,0
1668061636825,CSE 251B,A02,102393,Cottrell; Garrison W,0,0,0,0
1668061637250,CSE 252B,A00,102394,Ochoa; Benjamin Lawrence,0,0,0,0
1668061637682,CSE 257,A01,102396,Gao; Sicun,0,0,0,0
1668061638105,CSE 272,A00,102397,Li; Tzumao,0,0,0,0
1668061638530,CSE 274,A00,111323,Chern; Albert Ren-Haur,0,0,0,0
1668061638953,CSE 282,A00,102398,Pevzner; Pavel Arkadjevich,0,0,0,0
1668061639379,CSE 284,A00,114175,Gymrek; Melissa Ann,0,0,0,0
1668061639810,CSE 290,A00,102399,Chandraker; Manmohan Krishna,0,0,0,0
1668061639810,CSE 290,B00,102400,Vaccaro; Kristen Marie,0,0,25,25
1668061639810,CSE 290,C00,102414,Pannuto; Patrick William,0,0,25,25
1668061639810,CSE 290,D00,102427,Pevzner; Pavel Arkadjevich,0,0,0,0
1668061639810,CSE 290,E00,102429,Zhao; Jishen,0,0,0,0
1668061639810,CSE 290,F00,102436,Tullsen; Dean Michael,0,0,0,0
1668061639810,CSE 290,G00,102440,Christensen; Henrik I,0,0,20,20
1668061640250,CSE 291,A00,102443,Su; Hao,0,0,0,0
1668061640250,CSE 291,B00,102448,Polikarpova; Nadezhda,0,0,0,0
1668061640250,CSE 291,C00,102453,Vaccaro; Kristen Marie,0,0,0,0
1668061640250,CSE 291,D00,111343,Savage; Stefan,0,0,0,0
1668061640250,CSE 291,E00,116474,Claffy; Kimberly Claire,0,0,0,0
1668061640250,CSE 291,F00,116479,Pasquale; Joseph,0,0,0,0
1668061640676,CSE 293,001,119111,Bafna; Vineet,9999,0,9999,0
1668061640676,CSE 293,002,119118,Bellare; Mihir,9999,0,9999,0
1668061640676,CSE 293,003,119122,Berg-Kirkpatrick; Taylor D,9999,0,9999,0
1668061640676,CSE 293,004,119135,Christensen; Henrik I,9999,0,9999,0
1668061640676,CSE 293,005,119142,Cottrell; Garrison W,9999,0,9999,0
1668061640676,CSE 293,006,119146,Deutsch; Alin Bernard,9999,0,9999,0
1668061640676,CSE 293,007,119159,Esmaeilzadeh; Hadi,9999,0,9999,0
1668061640676,CSE 293,008,119166,Freund; Yoav,9999,0,9999,0
1668061640676,CSE 293,009,119170,Griswold; William G.,9999,0,9999,0
1668061640676,CSE 293,010,119183,Gymrek; Melissa Ann,9999,0,9999,0
1668061640676,CSE 293,011,119190,Heninger; Nadia A,9999,0,9999,0
1668061640676,CSE 293,012,119230,Impagliazzo; Russell,9999,0,9999,0
1668061640676,CSE 293,013,119232,Jhala; Ranjit,9999,0,9999,0
1668061640676,CSE 293,014,119233,Kahng; Andrew Byun,9999,0,9999,0
1668061640676,CSE 293,015,119298,Kane; Daniel Mertz,9999,0,9999,0
1668061640676,CSE 293,016,119299,Kriegman; David J,9999,0,9999,0
1668061640676,CSE 293,017,119300,Kumar; Arun Kumar,9999,0,9999,0
1668061640676,CSE 293,018,119301,Lerner; Sorin,9999,0,9999,0
1668061640676,CSE 293,019,119302,Lovett; Shachar,9999,0,9999,0
1668061640676,CSE 293,020,119303,McAuley; Julian John,9999,0,9999,0
1668061640676,CSE 293,021,119304,Micciancio; Daniele,9999,0,9999,0
1668061640676,CSE 293,022,119367,Orailoglu; Alex,9999,0,9999,0
1668061640676,CSE 293,023,119382,Paturi; Ramamohan,9999,0,9999,0
1668061640676,CSE 293,024,119404,Polikarpova; Nadezhda,9999,0,9999,0
1668061640676,CSE 293,025,119406,Politz; Joseph Gibbs,9999,0,9999,0
1668061640676,CSE 293,026,119411,Porter; George M,9999,0,9999,0
1668061640676,CSE 293,027,119414,Porter; Leonard Emerson,9999,0,9999,0
1668061640676,CSE 293,028,119416,Ramamoorthi; Ravi,9999,0,9999,0
1668061640676,CSE 293,029,119417,Sahoo; Debashis,9999,0,9999,0
1668061640676,CSE 293,030,119420,Saul; Lawrence,9999,0,9999,0
1668061640676,CSE 293,031,119421,Savage; Stefan,9999,0,9999,0
1668061640676,CSE 293,032,119425,Schulze; Jurgen P.,9999,0,9999,0
1668061640676,CSE 293,033,119426,Snoeren; Alex C.,9999,0,9999,0
1668061640676,CSE 293,034,119428,Shang; Jingbo,9999,0,9999,0
1668061640676,CSE 293,035,119430,Stefan; Deian,9999,0,9999,0
1668061640676,CSE 293,036,119431,Su; Hao,9999,0,9999,0
1668061640676,CSE 293,037,119433,Swanson; Steven James,9999,0,9999,0
1668061640676,CSE 293,038,119435,Tullsen; Dean Michael,9999,0,9999,0
1668061640676,CSE 293,039,119483,Voelker; Geoffrey M.,9999,0,9999,0
1668061640676,CSE 293,040,119537,Zhao; Jishen,9999,0,9999,0
1668061640676,CSE 293,041,119538,Zhou; Yuan-Yuan,9999,0,9999,0
1668061640676,CSE 293,042,119539,Gao; Sicun,9999,0,9999,0
1668061640676,CSE 293,043,119540,Weibel; Nadir,9999,0,9999,0
1668061640676,CSE 293,044,119541,Gupta; Rajesh K.,9999,0,9999,0
1668061640676,CSE 293,045,126410,Vaccaro; Kristen Marie,9999,0,9999,0
1668061640676,CSE 293,046,126411,Klemke; Richard,9999,0,9999,0
1668061641099,CSE 294,A00,102459,Voelker; Geoffrey M.,0,0,0,0
1668061641099,CSE 294,B00,111322,Orailoglu; Alex,0,0,0,0
1668061641520,DSE 201,A00,096914,Deutsch; Alin Bernard,30,0,30,0
1668061641946,DSE 210,A00,096915,Dasgupta; Sanjoy,30,0,30,0
1668061642371,DSE 260A,A00,096916,Altintas De Callaf; Ilkay,30,0,30,0
1668061642797,ECE 200,001,103586,Antipa; Nicholas A,9999,0,9999,0
1668061642797,ECE 200,002,103587,Atanasov; Nikolay A.,9999,0,9999,0
1668061642797,ECE 200,003,103588,Bharadia; Dinesh,9999,0,9999,0
1668061642797,ECE 200,004,103589,Cheng; Chung Kuan,9999,0,9999,0
1668061642797,ECE 200,005,103590,Cosman; Pamela C.,9999,0,9999,0
1668061642797,ECE 200,006,103591,Dayeh; Shadi Ahmad,9999,0,9999,0
1668061642797,ECE 200,007,103592,Fainman; Yeshaiahu,9999,0,9999,0
1668061642797,ECE 200,008,103593,Ford; Joseph Earl,9999,0,9999,0
1668061642797,ECE 200,009,103594,Franceschetti; Massimo,9999,0,9999,0
1668061642797,ECE 200,010,103595,Fullerton; Eric E,9999,0,9999,0
1668061642797,ECE 200,011,103596,Galton; Ian A,9999,0,9999,0
1668061642797,ECE 200,012,103597,Gilja; Vikash,9999,0,9999,0
1668061642797,ECE 200,013,103598,Hall; Drew A.,9999,0,9999,0
1668061642797,ECE 200,014,103599,Hsueh; Tzu-Chien,9999,0,9999,0
1668061642797,ECE 200,015,103600,Javidi; Tara,9999,0,9999,0
1668061642797,ECE 200,016,103601,Kahng; Andrew Byun,9999,0,9999,0
1668061642797,ECE 200,017,103602,Kim; Young-Han,9999,0,9999,0
1668061642797,ECE 200,018,103603,Koushanfar; Farinaz,9999,0,9999,0
1668061642797,ECE 200,019,103604,Kuzum; Duygu,9999,0,9999,0
1668061642797,ECE 200,020,103605,Le; Hanh-Phuc,9999,0,9999,0
1668061642797,ECE 200,021,103606,Lin; Bill,9999,0,9999,0
1668061642797,ECE 200,022,103607,Liu; Zhaowei,9998,0,9999,1
1668061642797,ECE 200,023,103608,Lo; Yu-Hwa,9999,0,9999,0
1668061642797,ECE 200,024,103609,Lomakin; Vitaliy,9999,0,9999,0
1668061642797,ECE 200,025,103610,Mercier; Patrick Philip,9999,0,9999,0
1668061642797,ECE 200,026,103611,Meyer; Florian,9999,0,9999,0
1668061642797,ECE 200,027,103612,Milstein; Laurence B.,9999,0,9999,0
1668061642797,ECE 200,028,103613,Mir Arabbaygi; Siavash,9999,0,9999,0
1668061642797,ECE 200,029,103614,Mookherjea; Shayan,9999,0,9999,0
1668061642797,ECE 200,030,103615,Morris; Karcher William,9999,0,9999,0
1668061642797,ECE 200,031,103616,Ng; Tse Nga,9999,0,9999,0
1668061642797,ECE 200,032,103617,Nguyen; Truong Quang,9999,0,9999,0
1668061642797,ECE 200,033,103618,Nomura; Kenji,9999,0,9999,0
1668061642797,ECE 200,034,103619,Orlitsky; Alon,9999,0,9999,0
1668061642797,ECE 200,035,103620,Pal; Piya,9999,0,9999,0
1668061642797,ECE 200,036,103621,Papen; George C.,9999,0,9999,0
1668061642797,ECE 200,037,103622,Radic; Stojan,9999,0,9999,0
1668061642797,ECE 200,038,103623,Rao; Bhaskar D.,9999,0,9999,0
1668061642797,ECE 200,039,103624,Rao; Ramesh R,9999,0,9999,0
1668061642797,ECE 200,040,103625,Rebeiz; Gabriel,9999,0,9999,0
1668061642797,ECE 200,041,103626,Sanford; John R,9999,0,9999,0
1668061642797,ECE 200,042,103627,Siegel; Paul H.,9999,0,9999,0
1668061642797,ECE 200,043,103628,Sievenpiper; Daniel F.,9999,0,9999,0
1668061642797,ECE 200,044,103629,Sworder; David D.,9999,0,9999,0
1668061642797,ECE 200,045,103630,Taur; Yuan,9999,0,9999,0
1668061642797,ECE 200,046,103631,Touri; Behrouz,9999,0,9999,0
1668061642797,ECE 200,047,103632,Trivedi; Mohan M.,9999,0,9999,0
1668061642797,ECE 200,048,103633,Vasconcelos; Nuno,9999,0,9999,0
1668061642797,ECE 200,049,103634,Wang; Xiaolong,9999,0,9999,0
1668061642797,ECE 200,050,103635,Xie; Pengtao,9999,0,9999,0
1668061642797,ECE 200,051,103636,Yip; Michael,9999,0,9999,0
1668061642797,ECE 200,052,103637,Zeger; Kenneth A.,999,0,999,0
1668061642797,ECE 200,053,103638,Zhang; Xinyu,9999,0,9999,0
1668061642797,ECE 200,054,103639,Turakhia; Yatish Girish,9999,0,9999,0
1668061642797,ECE 200,055,103640,Kang; Mingu,9999,0,9999,0
1668061642797,ECE 200,056,103641,Shi; Yuanyuan,9999,0,9999,0
1668061642797,ECE 200,057,103642,Wang; Edward Jay,9999,0,9999,0
1668061642797,ECE 200,058,103643,Zheng; Yang,9999,0,9999,0
1668061643225,ECE 202,A00,103644,Kuzum; Duygu,0,0,0,0
1668061643647,ECE 212BN,A00,103646,Ng; Tse Nga,0,0,0,0
1668061644071,ECE 221,A00,111493,Staff,0,0,0,0
1668061644495,ECE 222B,A00,103647,Lomakin; Vitaliy,0,0,0,0
1668061644920,ECE 230B,A00,103648,Taur; Yuan,0,0,0,0
1668061645345,ECE 238B,A00,103649,Garay; Javier,0,0,0,0
1668061645798,ECE 240B,A00,112900,Fainman; Yeshaiahu,0,0,0,0
1668061646221,ECE 247A,A00,103650,Jokerst; Jesse Vincent,0,0,0,0
1668061646642,ECE 247B,A00,103651,Wang; Joseph,0,0,0,0
1668061647075,ECE 250,A00,103652,Siegel; Paul H.,0,0,0,0
1668061647501,ECE 251A,A00,103654,Rao; Bhaskar D.,0,0,0,0
1668061647924,ECE 257B,A00,103655,Bharadia; Dinesh,0,0,0,0
1668061648351,ECE 258A,A00,103656,Milstein; Laurence B.,0,0,0,0
1668061648788,ECE 260B,A00,103658,Kang; Mingu,0,0,0,0
1668061649224,ECE 264A,A00,103659,Galton; Ian A,0,0,0,0
1668061649655,ECE 265A,A00,103661,Gudem; Prasad S.S.,0,0,0,0
1668061650082,ECE 265D,A00,103662,Gudem; Prasad S.S.,0,0,0,0
1668061650506,ECE 268,A00,103663,Koushanfar; Farinaz,0,0,0,0
1668061650931,ECE 269,A01,103665,Pal; Piya,0,0,0,0
1668061651353,ECE 271B,A00,103666,Vasconcelos; Manuela,0,0,0,0
1668061651862,ECE 276A,A00,103667,Atanasov; Nikolay A.,0,0,0,0
1668061652291,ECE 277,A00,103668,An; Cheolhong,0,0,0,0
1668061652734,ECE 279,A00,117947,Hall; Drew A.,0,0,0,0
1668061653581,ECE 283,A00,103670,Hsueh; Tzu-Chien,0,0,0,0
1668061654004,ECE 284,A00,103671,Turakhia; Yatish Girish,0,0,0,0
1668061654432,ECE 285,A00,103672,Zheng; Yang,0,0,0,0
1668061654432,ECE 285,B00,103673,Sworder; David D.,0,0,0,0
1668061654874,ECE 287,A00,103676,Javidi; Tara,0,0,0,0
1668061655303,MATH 200B,A00,098023,Salehi Golsefidy; Alireza,13,0,15,2
1668061655725,MATH 202B,A00,098024,Rhoades; Brendon Patrick,9,0,15,6
1668061656155,MATH 203B,A00,098025,Oprea; Dragos N.,11,0,15,4
1668061656581,MATH 204B,A00,098026,Sorensen; Claus M,13,0,15,2
1668061657008,MATH 208,A00,098027,Izadi; Elham,7,0,10,3
1668061657433,MATH 209,A00,098028,Pollack; Aaron,10,0,10,0
1668061657879,MATH 211A,A00,112919,Rogalski; Daniel,9,0,10,1
1668061658304,MATH 211B,A00,112920,Seward; Brandon M.,9,0,10,1
1668061658734,MATH 218,A00,098029,Li; Bo,10,0,10,0
1668061659166,MATH 220B,A00,098030,Novak; Jonathan I,13,0,15,2
1668061659593,MATH 221A,A00,098031,Ebenfelt; Peter F,13,0,15,2
1668061660023,MATH 231B,A00,098032,Zlatos; Andrej,12,0,15,3
1668061660447,MATH 240B,A00,098033,Ni; Lei,9,0,15,6
1668061660874,MATH 243,A00,098034,Jekel; David Andrew,10,0,10,0
1668061661297,MATH 245A,A00,098035,Nie; Jiawang,0,0,15,16
1668061661740,MATH 248,A00,098036,Bejenaru; Ioan,10,0,10,0
1668061662162,MATH 250B,A00,098037,Spolaor; Luca,14,0,15,1
1668061662586,MATH 258,A00,098038,Ni; Lei,10,0,10,0
1668061663021,MATH 264B,A00,098041,Rhoades; Brendon Patrick,10,0,15,5
1668061663456,MATH 268,A00,098042,Buss; Samuel R,10,0,10,0
1668061663878,MATH 269,A00,098043,Rhoades; Brendon Patrick,10,0,10,0
1668061664307,MATH 270B,A00,098044,Li; Bo,11,0,15,4
1668061664742,MATH 272B,A00,098045,Holst; Michael J,13,0,15,2
1668061665168,MATH 273A,A00,098046,Tian; Xiaochuan,10,0,15,5
1668061665593,MATH 275,A01,098048,Tian; Xiaochuan,6,0,10,4
1668061666019,MATH 278A,A00,098049,Holst; Michael J,8,0,10,2
1668061666451,MATH 278B,A00,098050,Cloninger; Alexander,10,0,10,0
1668061666874,MATH 278C,A00,098051,Nie; Jiawang,7,0,10,3
1668061667309,MATH 280B,A00,098052,Zheng; Tianyi,10,0,15,5
1668061667732,MATH 281B,A00,098053,Bradic; Jelena,3,0,15,12
1668061668167,MATH 282B,A00,098054,Arias-Castro; Ery,0,0,15,15
1668061668590,MATH 285,A00,098055,Fitzsimmons; Patrick J,0,0,15,17
1668061669015,MATH 287B,A00,098056,Arias-Castro; Ery,3,0,15,12
1668061669448,MATH 288,A00,098057,Agarwal; Pooja,9,0,10,1
1668061669448,MATH 288,B00,098058,Zhang; Danna,8,0,10,2
1668061669448,MATH 288,C00,098059,Williams; Ruth J,10,0,10,0
1668061669871,MATH 290B,A00,098060,Roberts; Justin Deritter,13,0,15,2
1668061670295,MATH 292,A00,098061,Belmont; Eva Kinoshita,10,0,10,0
1668061670720,MATH 295,A00,098062,Suk; Andrew Hoon,48,0,50,2
1668061671144,MATH 296,A00,098063,Novak; Jonathan I,20,0,20,0
1668061671570,MATH 297,001,098064,Gamst; Anthony Collins,9997,0,9999,2
1668062173514,COGS 205,A00,101395,Chiba; Andrea,19,0,20,1
1668062174015,COGS 210B,001,101404,Greene; Deanna Jacquelyn,9998,0,9999,1
1668062174015,COGS 210B,002,101417,Xia; Haijun,9999,0,9999,0
1668062174015,COGS 210B,003,101422,Nitz; Douglas A.,9999,0,9999,0
1668062174015,COGS 210B,004,101423,Hollan; James D.,9998,0,9999,1
1668062174015,COGS 210B,005,101424,Deak; Gedeon O.,9998,0,9999,1
1668062174015,COGS 210B,006,101425,Rossano; Federico,9999,0,9999,0
1668062174446,COGS 211B,A00,101427,Coulson; Seana M,9996,0,9999,3
1668062174868,COGS 220,A00,101428,Hollan; James D.,0,0,25,25
1668062175298,COGS 229,A00,101429,Dow; Steven P,18,0,25,7
1668062175720,COGS 230,A00,101430,Klemmer; Scott R,13,0,17,4
1668062176145,COGS 234,A00,101431,Xia; Haijun,4,0,25,21
1668062176570,COGS 260,A00,101432,Kiyonaga; Anastasia,19,0,25,6
1668062176570,COGS 260,B00,101433,Kirsh; David Joel,16,0,25,9
1668062177007,CSE 202,A00,102371,Impagliazzo; Russell,0,0,0,0
1668062177449,CSE 203B,A01,102373,Cheng; Chung Kuan,0,0,0,0
1668062177878,CSE 208,A00,102374,Micciancio; Daniele,0,0,0,0
1668062178306,CSE 209A,A00,112895,Impagliazzo; Russell,0,0,15,15
1668062178730,CSE 209B,A00,108005,Bellare; Mihir,0,0,0,0
1668062179153,CSE 210,A00,113163,Coblenz; Michael J,0,0,0,0
1668062179590,CSE 219,A00,106111,Dow; Steven P,0,0,20,20
1668062180017,CSE 221,A00,102376,Voelker; Geoffrey M.,0,0,0,0
1668062180440,CSE 224,A01,102378,Porter; George M,0,0,0,0
1668062180874,CSE 229A,A00,102379,Savage; Stefan,0,0,0,0
1668062181298,CSE 229C,A00,102380,Munyaka; Imani N. S.,0,0,0,0
1668062181725,CSE 232B,A00,102382,Deutsch; Alin Bernard,0,0,0,0
1668062182149,CSE 234,A01,112904,Kumar; Arun Kumar,0,0,0,0
1668062182576,CSE 237A,A00,102383,Rosing; Tajana Simunic,0,0,0,0
1668062183002,CSE 239A,A00,102384,Deutsch; Alin Bernard,0,0,0,0
1668062183433,CSE 239B,A00,102385,Polikarpova; Nadezhda,0,0,0,0
1668062183872,CSE 240A,A00,102386,Pannuto; Patrick William,0,0,0,0
1668062184299,CSE 240B,A00,102387,Zhao; Jishen,0,0,0,0
1668062184724,CSE 241A,A00,106406,Kang; Mingu,0,0,0,0
1668062185147,CSE 249B,A00,102388,Kahng; Andrew Byun,0,0,8,8
1668062185571,CSE 251B,A01,102392,Cottrell; Garrison W,0,0,0,0
1668062185571,CSE 251B,A02,102393,Cottrell; Garrison W,0,0,0,0
1668062185994,CSE 252B,A00,102394,Ochoa; Benjamin Lawrence,0,0,0,0
1668062186420,CSE 257,A01,102396,Gao; Sicun,0,0,0,0
1668062186842,CSE 272,A00,102397,Li; Tzumao,0,0,0,0
1668062187267,CSE 274,A00,111323,Chern; Albert Ren-Haur,0,0,0,0
1668062187692,CSE 282,A00,102398,Pevzner; Pavel Arkadjevich,0,0,0,0
1668062188117,CSE 284,A00,114175,Gymrek; Melissa Ann,0,0,0,0
1668062188544,CSE 290,A00,102399,Chandraker; Manmohan Krishna,0,0,0,0
1668062188544,CSE 290,B00,102400,Vaccaro; Kristen Marie,0,0,25,25
1668062188544,CSE 290,C00,102414,Pannuto; Patrick William,0,0,25,25
1668062188544,CSE 290,D00,102427,Pevzner; Pavel Arkadjevich,0,0,0,0
1668062188544,CSE 290,E00,102429,Zhao; Jishen,0,0,0,0
1668062188544,CSE 290,F00,102436,Tullsen; Dean Michael,0,0,0,0
1668062188544,CSE 290,G00,102440,Christensen; Henrik I,0,0,20,20
1668062188967,CSE 291,A00,102443,Su; Hao,0,0,0,0
1668062188967,CSE 291,B00,102448,Polikarpova; Nadezhda,0,0,0,0
1668062188967,CSE 291,C00,102453,Vaccaro; Kristen Marie,0,0,0,0
1668062188967,CSE 291,D00,111343,Savage; Stefan,0,0,0,0
1668062188967,CSE 291,E00,116474,Claffy; Kimberly Claire,0,0,0,0
1668062188967,CSE 291,F00,116479,Pasquale; Joseph,0,0,0,0
1668062189429,CSE 293,001,119111,Bafna; Vineet,9999,0,9999,0
1668062189429,CSE 293,002,119118,Bellare; Mihir,9999,0,9999,0
1668062189429,CSE 293,003,119122,Berg-Kirkpatrick; Taylor D,9999,0,9999,0
1668062189429,CSE 293,004,119135,Christensen; Henrik I,9999,0,9999,0
1668062189429,CSE 293,005,119142,Cottrell; Garrison W,9999,0,9999,0
1668062189429,CSE 293,006,119146,Deutsch; Alin Bernard,9999,0,9999,0
1668062189429,CSE 293,007,119159,Esmaeilzadeh; Hadi,9999,0,9999,0
1668062189429,CSE 293,008,119166,Freund; Yoav,9999,0,9999,0
1668062189429,CSE 293,009,119170,Griswold; William G.,9999,0,9999,0
1668062189429,CSE 293,010,119183,Gymrek; Melissa Ann,9999,0,9999,0
1668062189429,CSE 293,011,119190,Heninger; Nadia A,9999,0,9999,0
1668062189429,CSE 293,012,119230,Impagliazzo; Russell,9999,0,9999,0
1668062189429,CSE 293,013,119232,Jhala; Ranjit,9999,0,9999,0
1668062189429,CSE 293,014,119233,Kahng; Andrew Byun,9999,0,9999,0
1668062189429,CSE 293,015,119298,Kane; Daniel Mertz,9999,0,9999,0
1668062189429,CSE 293,016,119299,Kriegman; David J,9999,0,9999,0
1668062189429,CSE 293,017,119300,Kumar; Arun Kumar,9999,0,9999,0
1668062189429,CSE 293,018,119301,Lerner; Sorin,9999,0,9999,0
1668062189429,CSE 293,019,119302,Lovett; Shachar,9999,0,9999,0
1668062189429,CSE 293,020,119303,McAuley; Julian John,9999,0,9999,0
1668062189429,CSE 293,021,119304,Micciancio; Daniele,9999,0,9999,0
1668062189429,CSE 293,022,119367,Orailoglu; Alex,9999,0,9999,0
1668062189429,CSE 293,023,119382,Paturi; Ramamohan,9999,0,9999,0
1668062189429,CSE 293,024,119404,Polikarpova; Nadezhda,9999,0,9999,0
1668062189429,CSE 293,025,119406,Politz; Joseph Gibbs,9999,0,9999,0
1668062189429,CSE 293,026,119411,Porter; George M,9999,0,9999,0
1668062189429,CSE 293,027,119414,Porter; Leonard Emerson,9999,0,9999,0
1668062189429,CSE 293,028,119416,Ramamoorthi; Ravi,9999,0,9999,0
1668062189429,CSE 293,029,119417,Sahoo; Debashis,9999,0,9999,0
1668062189429,CSE 293,030,119420,Saul; Lawrence,9999,0,9999,0
1668062189429,CSE 293,031,119421,Savage; Stefan,9999,0,9999,0
1668062189429,CSE 293,032,119425,Schulze; Jurgen P.,9999,0,9999,0
1668062189429,CSE 293,033,119426,Snoeren; Alex C.,9999,0,9999,0
1668062189429,CSE 293,034,119428,Shang; Jingbo,9999,0,9999,0
1668062189429,CSE 293,035,119430,Stefan; Deian,9999,0,9999,0
1668062189429,CSE 293,036,119431,Su; Hao,9999,0,9999,0
1668062189429,CSE 293,037,119433,Swanson; Steven James,9999,0,9999,0
1668062189429,CSE 293,038,119435,Tullsen; Dean Michael,9999,0,9999,0
1668062189429,CSE 293,039,119483,Voelker; Geoffrey M.,9999,0,9999,0
1668062189429,CSE 293,040,119537,Zhao; Jishen,9999,0,9999,0
1668062189429,CSE 293,041,119538,Zhou; Yuan-Yuan,9999,0,9999,0
1668062189429,CSE 293,042,119539,Gao; Sicun,9999,0,9999,0
1668062189429,CSE 293,043,119540,Weibel; Nadir,9999,0,9999,0
1668062189429,CSE 293,044,119541,Gupta; Rajesh K.,9999,0,9999,0
1668062189429,CSE 293,045,126410,Vaccaro; Kristen Marie,9999,0,9999,0
1668062189429,CSE 293,046,126411,Klemke; Richard,9999,0,9999,0
1668062189860,CSE 294,A00,102459,Voelker; Geoffrey M.,0,0,0,0
1668062189860,CSE 294,B00,111322,Orailoglu; Alex,0,0,0,0
1668062190291,DSE 201,A00,096914,Deutsch; Alin Bernard,30,0,30,0
1668062190713,DSE 210,A00,096915,Dasgupta; Sanjoy,30,0,30,0
1668062191153,DSE 260A,A00,096916,Altintas De Callaf; Ilkay,30,0,30,0
1668062191617,ECE 200,001,103586,Antipa; Nicholas A,9999,0,9999,0
1668062191617,ECE 200,002,103587,Atanasov; Nikolay A.,9999,0,9999,0
1668062191617,ECE 200,003,103588,Bharadia; Dinesh,9999,0,9999,0
1668062191617,ECE 200,004,103589,Cheng; Chung Kuan,9999,0,9999,0
1668062191617,ECE 200,005,103590,Cosman; Pamela C.,9999,0,9999,0
1668062191617,ECE 200,006,103591,Dayeh; Shadi Ahmad,9999,0,9999,0
1668062191617,ECE 200,007,103592,Fainman; Yeshaiahu,9999,0,9999,0
1668062191617,ECE 200,008,103593,Ford; Joseph Earl,9999,0,9999,0
1668062191617,ECE 200,009,103594,Franceschetti; Massimo,9999,0,9999,0
1668062191617,ECE 200,010,103595,Fullerton; Eric E,9999,0,9999,0
1668062191617,ECE 200,011,103596,Galton; Ian A,9999,0,9999,0
1668062191617,ECE 200,012,103597,Gilja; Vikash,9999,0,9999,0
1668062191617,ECE 200,013,103598,Hall; Drew A.,9999,0,9999,0
1668062191617,ECE 200,014,103599,Hsueh; Tzu-Chien,9999,0,9999,0
1668062191617,ECE 200,015,103600,Javidi; Tara,9999,0,9999,0
1668062191617,ECE 200,016,103601,Kahng; Andrew Byun,9999,0,9999,0
1668062191617,ECE 200,017,103602,Kim; Young-Han,9999,0,9999,0
1668062191617,ECE 200,018,103603,Koushanfar; Farinaz,9999,0,9999,0
1668062191617,ECE 200,019,103604,Kuzum; Duygu,9999,0,9999,0
1668062191617,ECE 200,020,103605,Le; Hanh-Phuc,9999,0,9999,0
1668062191617,ECE 200,021,103606,Lin; Bill,9999,0,9999,0
1668062191617,ECE 200,022,103607,Liu; Zhaowei,9998,0,9999,1
1668062191617,ECE 200,023,103608,Lo; Yu-Hwa,9999,0,9999,0
1668062191617,ECE 200,024,103609,Lomakin; Vitaliy,9999,0,9999,0
1668062191617,ECE 200,025,103610,Mercier; Patrick Philip,9999,0,9999,0
1668062191617,ECE 200,026,103611,Meyer; Florian,9999,0,9999,0
1668062191617,ECE 200,027,103612,Milstein; Laurence B.,9999,0,9999,0
1668062191617,ECE 200,028,103613,Mir Arabbaygi; Siavash,9999,0,9999,0
1668062191617,ECE 200,029,103614,Mookherjea; Shayan,9999,0,9999,0
1668062191617,ECE 200,030,103615,Morris; Karcher William,9999,0,9999,0
1668062191617,ECE 200,031,103616,Ng; Tse Nga,9999,0,9999,0
1668062191617,ECE 200,032,103617,Nguyen; Truong Quang,9999,0,9999,0
1668062191617,ECE 200,033,103618,Nomura; Kenji,9999,0,9999,0
1668062191617,ECE 200,034,103619,Orlitsky; Alon,9999,0,9999,0
1668062191617,ECE 200,035,103620,Pal; Piya,9999,0,9999,0
1668062191617,ECE 200,036,103621,Papen; George C.,9999,0,9999,0
1668062191617,ECE 200,037,103622,Radic; Stojan,9999,0,9999,0
1668062191617,ECE 200,038,103623,Rao; Bhaskar D.,9999,0,9999,0
1668062191617,ECE 200,039,103624,Rao; Ramesh R,9999,0,9999,0
1668062191617,ECE 200,040,103625,Rebeiz; Gabriel,9999,0,9999,0
1668062191617,ECE 200,041,103626,Sanford; John R,9999,0,9999,0
1668062191617,ECE 200,042,103627,Siegel; Paul H.,9999,0,9999,0
1668062191617,ECE 200,043,103628,Sievenpiper; Daniel F.,9999,0,9999,0
1668062191617,ECE 200,044,103629,Sworder; David D.,9999,0,9999,0
1668062191617,ECE 200,045,103630,Taur; Yuan,9999,0,9999,0
1668062191617,ECE 200,046,103631,Touri; Behrouz,9999,0,9999,0
1668062191617,ECE 200,047,103632,Trivedi; Mohan M.,9999,0,9999,0
1668062191617,ECE 200,048,103633,Vasconcelos; Nuno,9999,0,9999,0
1668062191617,ECE 200,049,103634,Wang; Xiaolong,9999,0,9999,0
1668062191617,ECE 200,050,103635,Xie; Pengtao,9999,0,9999,0
1668062191617,ECE 200,051,103636,Yip; Michael,9999,0,9999,0
1668062191617,ECE 200,052,103637,Zeger; Kenneth A.,999,0,999,0
1668062191617,ECE 200,053,103638,Zhang; Xinyu,9999,0,9999,0
1668062191617,ECE 200,054,103639,Turakhia; Yatish Girish,9999,0,9999,0
1668062191617,ECE 200,055,103640,Kang; Mingu,9999,0,9999,0
1668062191617,ECE 200,056,103641,Shi; Yuanyuan,9999,0,9999,0
1668062191617,ECE 200,057,103642,Wang; Edward Jay,9999,0,9999,0
1668062191617,ECE 200,058,103643,Zheng; Yang,9999,0,9999,0
1668062192052,ECE 202,A00,103644,Kuzum; Duygu,0,0,0,0
1668062192481,ECE 212BN,A00,103646,Ng; Tse Nga,0,0,0,0
1668062192923,ECE 221,A00,111493,Staff,0,0,0,0
1668062193346,ECE 222B,A00,103647,Lomakin; Vitaliy,0,0,0,0
1668062193773,ECE 230B,A00,103648,Taur; Yuan,0,0,0,0
1668062194196,ECE 238B,A00,103649,Garay; Javier,0,0,0,0
1668062194619,ECE 240B,A00,112900,Fainman; Yeshaiahu,0,0,0,0
1668062195043,ECE 247A,A00,103650,Jokerst; Jesse Vincent,0,0,0,0
1668062195476,ECE 247B,A00,103651,Wang; Joseph,0,0,0,0
1668062195918,ECE 250,A00,103652,Siegel; Paul H.,0,0,0,0
1668062196345,ECE 251A,A00,103654,Rao; Bhaskar D.,0,0,0,0
1668062196770,ECE 257B,A00,103655,Bharadia; Dinesh,0,0,0,0
1668062197197,ECE 258A,A00,103656,Milstein; Laurence B.,0,0,0,0
1668062197625,ECE 260B,A00,103658,Kang; Mingu,0,0,0,0
1668062198052,ECE 264A,A00,103659,Galton; Ian A,0,0,0,0
1668062198477,ECE 265A,A00,103661,Gudem; Prasad S.S.,0,0,0,0
1668062198900,ECE 265D,A00,103662,Gudem; Prasad S.S.,0,0,0,0
1668062199329,ECE 268,A00,103663,Koushanfar; Farinaz,0,0,0,0
1668062199751,ECE 269,A01,103665,Pal; Piya,0,0,0,0
1668062200174,ECE 271B,A00,103666,Vasconcelos; Manuela,0,0,0,0
1668062200596,ECE 276A,A00,103667,Atanasov; Nikolay A.,0,0,0,0
1668062201020,ECE 277,A00,103668,An; Cheolhong,0,0,0,0
1668062201454,ECE 279,A00,117947,Hall; Drew A.,0,0,0,0
1668062202307,ECE 283,A00,103670,Hsueh; Tzu-Chien,0,0,0,0
1668062202733,ECE 284,A00,103671,Turakhia; Yatish Girish,0,0,0,0
1668062203158,ECE 285,A00,103672,Zheng; Yang,0,0,0,0
1668062203158,ECE 285,B00,103673,Sworder; David D.,0,0,0,0
1668062203581,ECE 287,A00,103676,Javidi; Tara,0,0,0,0
1668062204015,MATH 200B,A00,098023,Salehi Golsefidy; Alireza,13,0,15,2
1668062204438,MATH 202B,A00,098024,Rhoades; Brendon Patrick,9,0,15,6
1668062204860,MATH 203B,A00,098025,Oprea; Dragos N.,11,0,15,4
1668062205290,MATH 204B,A00,098026,Sorensen; Claus M,13,0,15,2
1668062205718,MATH 208,A00,098027,Izadi; Elham,7,0,10,3
1668062206142,MATH 209,A00,098028,Pollack; Aaron,10,0,10,0
1668062206565,MATH 211A,A00,112919,Rogalski; Daniel,9,0,10,1
1668062206990,MATH 211B,A00,112920,Seward; Brandon M.,9,0,10,1
1668062207413,MATH 218,A00,098029,Li; Bo,10,0,10,0
1668062207840,MATH 220B,A00,098030,Novak; Jonathan I,13,0,15,2
1668062208267,MATH 221A,A00,098031,Ebenfelt; Peter F,13,0,15,2
1668062208694,MATH 231B,A00,098032,Zlatos; Andrej,12,0,15,3
1668062209117,MATH 240B,A00,098033,Ni; Lei,9,0,15,6
1668062209543,MATH 243,A00,098034,Jekel; David Andrew,10,0,10,0
1668062209971,MATH 245A,A00,098035,Nie; Jiawang,0,0,15,16
1668062210398,MATH 248,A00,098036,Bejenaru; Ioan,10,0,10,0
1668062210835,MATH 250B,A00,098037,Spolaor; Luca,14,0,15,1
1668062211259,MATH 258,A00,098038,Ni; Lei,10,0,10,0
1668062211684,MATH 264B,A00,098041,Rhoades; Brendon Patrick,10,0,15,5
1668062212110,MATH 268,A00,098042,Buss; Samuel R,10,0,10,0
1668062212533,MATH 269,A00,098043,Rhoades; Brendon Patrick,10,0,10,0
1668062212974,MATH 270B,A00,098044,Li; Bo,11,0,15,4
1668062213398,MATH 272B,A00,098045,Holst; Michael J,13,0,15,2
1668062213820,MATH 273A,A00,098046,Tian; Xiaochuan,10,0,15,5
1668062214244,MATH 275,A01,098048,Tian; Xiaochuan,6,0,10,4
1668062214666,MATH 278A,A00,098049,Holst; Michael J,8,0,10,2
1668062215091,MATH 278B,A00,098050,Cloninger; Alexander,10,0,10,0
1668062215514,MATH 278C,A00,098051,Nie; Jiawang,7,0,10,3
1668062215937,MATH 280B,A00,098052,Zheng; Tianyi,10,0,15,5
1668062216361,MATH 281B,A00,098053,Bradic; Jelena,3,0,15,12
1668062216788,MATH 282B,A00,098054,Arias-Castro; Ery,0,0,15,15
1668062217296,MATH 285,A00,098055,Fitzsimmons; Patrick J,0,0,15,17
1668062217727,MATH 287B,A00,098056,Arias-Castro; Ery,3,0,15,12
1668062218160,MATH 288,A00,098057,Agarwal; Pooja,9,0,10,1
1668062218160,MATH 288,B00,098058,Zhang; Danna,8,0,10,2
1668062218160,MATH 288,C00,098059,Williams; Ruth J,10,0,10,0
1668062218585,MATH 290B,A00,098060,Roberts; Justin Deritter,13,0,15,2
1668062219016,MATH 292,A00,098061,Belmont; Eva Kinoshita,10,0,10,0
1668062219439,MATH 295,A00,098062,Suk; Andrew Hoon,48,0,50,2
1668062219861,MATH 296,A00,098063,Novak; Jonathan I,20,0,20,0
1668062220286,MATH 297,001,098064,Gamst; Anthony Collins,9997,0,9999,2
1668062721843,COGS 205,A00,101395,Chiba; Andrea,19,0,20,1
1668062722274,COGS 210B,001,101404,Greene; Deanna Jacquelyn,9998,0,9999,1
1668062722274,COGS 210B,002,101417,Xia; Haijun,9999,0,9999,0
1668062722274,COGS 210B,003,101422,Nitz; Douglas A.,9999,0,9999,0
1668062722274,COGS 210B,004,101423,Hollan; James D.,9998,0,9999,1
1668062722274,COGS 210B,005,101424,Deak; Gedeon O.,9998,0,9999,1
1668062722274,COGS 210B,006,101425,Rossano; Federico,9999,0,9999,0
1668062722698,COGS 211B,A00,101427,Coulson; Seana M,9996,0,9999,3
1668062723132,COGS 220,A00,101428,Hollan; James D.,0,0,25,25
1668062723555,COGS 229,A00,101429,Dow; Steven P,18,0,25,7
1668062723977,COGS 230,A00,101430,Klemmer; Scott R,13,0,17,4
1668062724399,COGS 234,A00,101431,Xia; Haijun,4,0,25,21
1668062724831,COGS 260,A00,101432,Kiyonaga; Anastasia,19,0,25,6
1668062724831,COGS 260,B00,101433,Kirsh; David Joel,16,0,25,9
1668062725258,CSE 202,A00,102371,Impagliazzo; Russell,0,0,0,0
1668062725685,CSE 203B,A01,102373,Cheng; Chung Kuan,0,0,0,0
1668062726108,CSE 208,A00,102374,Micciancio; Daniele,0,0,0,0
1668062726539,CSE 209A,A00,112895,Impagliazzo; Russell,0,0,15,15
1668062726964,CSE 209B,A00,108005,Bellare; Mihir,0,0,0,0
1668062727387,CSE 210,A00,113163,Coblenz; Michael J,0,0,0,0
1668062727813,CSE 219,A00,106111,Dow; Steven P,0,0,20,20
1668062728249,CSE 221,A00,102376,Voelker; Geoffrey M.,0,0,0,0
1668062728672,CSE 224,A01,102378,Porter; George M,0,0,0,0
1668062729099,CSE 229A,A00,102379,Savage; Stefan,0,0,0,0
1668062729526,CSE 229C,A00,102380,Munyaka; Imani N. S.,0,0,0,0
1668062729948,CSE 232B,A00,102382,Deutsch; Alin Bernard,0,0,0,0
1668062730371,CSE 234,A01,112904,Kumar; Arun Kumar,0,0,0,0
1668062730797,CSE 237A,A00,102383,Rosing; Tajana Simunic,0,0,0,0
1668062731220,CSE 239A,A00,102384,Deutsch; Alin Bernard,0,0,0,0
1668062731642,CSE 239B,A00,102385,Polikarpova; Nadezhda,0,0,0,0
1668062732067,CSE 240A,A00,102386,Pannuto; Patrick William,0,0,0,0
1668062732495,CSE 240B,A00,102387,Zhao; Jishen,0,0,0,0
1668062732919,CSE 241A,A00,106406,Kang; Mingu,0,0,0,0
1668062733344,CSE 249B,A00,102388,Kahng; Andrew Byun,0,0,8,8
1668062733766,CSE 251B,A01,102392,Cottrell; Garrison W,0,0,0,0
1668062733766,CSE 251B,A02,102393,Cottrell; Garrison W,0,0,0,0
1668062734193,CSE 252B,A00,102394,Ochoa; Benjamin Lawrence,0,0,0,0
1668062734623,CSE 257,A01,102396,Gao; Sicun,0,0,0,0
1668062735048,CSE 272,A00,102397,Li; Tzumao,0,0,0,0
1668062735471,CSE 274,A00,111323,Chern; Albert Ren-Haur,0,0,0,0
1668062735900,CSE 282,A00,102398,Pevzner; Pavel Arkadjevich,0,0,0,0
1668062736337,CSE 284,A00,114175,Gymrek; Melissa Ann,0,0,0,0
1668062736760,CSE 290,A00,102399,Chandraker; Manmohan Krishna,0,0,0,0
1668062736760,CSE 290,B00,102400,Vaccaro; Kristen Marie,0,0,25,25
1668062736760,CSE 290,C00,102414,Pannuto; Patrick William,0,0,25,25
1668062736760,CSE 290,D00,102427,Pevzner; Pavel Arkadjevich,0,0,0,0
1668062736760,CSE 290,E00,102429,Zhao; Jishen,0,0,0,0
1668062736760,CSE 290,F00,102436,Tullsen; Dean Michael,0,0,0,0
1668062736760,CSE 290,G00,102440,Christensen; Henrik I,0,0,20,20
1668062737184,CSE 291,A00,102443,Su; Hao,0,0,0,0
1668062737184,CSE 291,B00,102448,Polikarpova; Nadezhda,0,0,0,0
1668062737184,CSE 291,C00,102453,Vaccaro; Kristen Marie,0,0,0,0
1668062737184,CSE 291,D00,111343,Savage; Stefan,0,0,0,0
1668062737184,CSE 291,E00,116474,Claffy; Kimberly Claire,0,0,0,0
1668062737184,CSE 291,F00,116479,Pasquale; Joseph,0,0,0,0
1668062737610,CSE 293,001,119111,Bafna; Vineet,9999,0,9999,0
1668062737610,CSE 293,002,119118,Bellare; Mihir,9999,0,9999,0
1668062737610,CSE 293,003,119122,Berg-Kirkpatrick; Taylor D,9999,0,9999,0
1668062737610,CSE 293,004,119135,Christensen; Henrik I,9999,0,9999,0
1668062737610,CSE 293,005,119142,Cottrell; Garrison W,9999,0,9999,0
1668062737610,CSE 293,006,119146,Deutsch; Alin Bernard,9999,0,9999,0
1668062737610,CSE 293,007,119159,Esmaeilzadeh; Hadi,9999,0,9999,0
1668062737610,CSE 293,008,119166,Freund; Yoav,9999,0,9999,0
1668062737610,CSE 293,009,119170,Griswold; William G.,9999,0,9999,0
1668062737610,CSE 293,010,119183,Gymrek; Melissa Ann,9999,0,9999,0
1668062737610,CSE 293,011,119190,Heninger; Nadia A,9999,0,9999,0
1668062737610,CSE 293,012,119230,Impagliazzo; Russell,9999,0,9999,0
1668062737610,CSE 293,013,119232,Jhala; Ranjit,9999,0,9999,0
1668062737610,CSE 293,014,119233,Kahng; Andrew Byun,9999,0,9999,0
1668062737610,CSE 293,015,119298,Kane; Daniel Mertz,9999,0,9999,0
1668062737610,CSE 293,016,119299,Kriegman; David J,9999,0,9999,0
1668062737610,CSE 293,017,119300,Kumar; Arun Kumar,9999,0,9999,0
1668062737610,CSE 293,018,119301,Lerner; Sorin,9999,0,9999,0
1668062737610,CSE 293,019,119302,Lovett; Shachar,9999,0,9999,0
1668062737610,CSE 293,020,119303,McAuley; Julian John,9999,0,9999,0
1668062737610,CSE 293,021,119304,Micciancio; Daniele,9999,0,9999,0
1668062737610,CSE 293,022,119367,Orailoglu; Alex,9999,0,9999,0
1668062737610,CSE 293,023,119382,Paturi; Ramamohan,9999,0,9999,0
1668062737610,CSE 293,024,119404,Polikarpova; Nadezhda,9999,0,9999,0
1668062737610,CSE 293,025,119406,Politz; Joseph Gibbs,9999,0,9999,0
1668062737610,CSE 293,026,119411,Porter; George M,9999,0,9999,0
1668062737610,CSE 293,027,119414,Porter; Leonard Emerson,9999,0,9999,0
1668062737610,CSE 293,028,119416,Ramamoorthi; Ravi,9999,0,9999,0
1668062737610,CSE 293,029,119417,Sahoo; Debashis,9999,0,9999,0
1668062737610,CSE 293,030,119420,Saul; Lawrence,9999,0,9999,0
1668062737610,CSE 293,031,119421,Savage; Stefan,9999,0,9999,0
1668062737610,CSE 293,032,119425,Schulze; Jurgen P.,9999,0,9999,0
1668062737610,CSE 293,033,119426,Snoeren; Alex C.,9999,0,9999,0
1668062737610,CSE 293,034,119428,Shang; Jingbo,9999,0,9999,0
1668062737610,CSE 293,035,119430,Stefan; Deian,9999,0,9999,0
1668062737610,CSE 293,036,119431,Su; Hao,9999,0,9999,0
1668062737610,CSE 293,037,119433,Swanson; Steven James,9999,0,9999,0
1668062737610,CSE 293,038,119435,Tullsen; Dean Michael,9999,0,9999,0
1668062737610,CSE 293,039,119483,Voelker; Geoffrey M.,9999,0,9999,0
1668062737610,CSE 293,040,119537,Zhao; Jishen,9999,0,9999,0
1668062737610,CSE 293,041,119538,Zhou; Yuan-Yuan,9999,0,9999,0
1668062737610,CSE 293,042,119539,Gao; Sicun,9999,0,9999,0
1668062737610,CSE 293,043,119540,Weibel; Nadir,9999,0,9999,0
1668062737610,CSE 293,044,119541,Gupta; Rajesh K.,9999,0,9999,0
1668062737610,CSE 293,045,126410,Vaccaro; Kristen Marie,9999,0,9999,0
1668062737610,CSE 293,046,126411,Klemke; Richard,9999,0,9999,0
1668062738032,CSE 294,A00,102459,Voelker; Geoffrey M.,0,0,0,0
1668062738032,CSE 294,B00,111322,Orailoglu; Alex,0,0,0,0
1668062738457,DSE 201,A00,096914,Deutsch; Alin Bernard,30,0,30,0
1668062738958,DSE 210,A00,096915,Dasgupta; Sanjoy,30,0,30,0
1668062739379,DSE 260A,A00,096916,Altintas De Callaf; Ilkay,30,0,30,0
1668062739838,ECE 200,001,103586,Antipa; Nicholas A,9999,0,9999,0
1668062739838,ECE 200,002,103587,Atanasov; Nikolay A.,9999,0,9999,0
1668062739838,ECE 200,003,103588,Bharadia; Dinesh,9999,0,9999,0
1668062739838,ECE 200,004,103589,Cheng; Chung Kuan,9999,0,9999,0
1668062739838,ECE 200,005,103590,Cosman; Pamela C.,9999,0,9999,0
1668062739838,ECE 200,006,103591,Dayeh; Shadi Ahmad,9999,0,9999,0
1668062739838,ECE 200,007,103592,Fainman; Yeshaiahu,9999,0,9999,0
1668062739838,ECE 200,008,103593,Ford; Joseph Earl,9999,0,9999,0
1668062739838,ECE 200,009,103594,Franceschetti; Massimo,9999,0,9999,0
1668062739838,ECE 200,010,103595,Fullerton; Eric E,9999,0,9999,0
1668062739838,ECE 200,011,103596,Galton; Ian A,9999,0,9999,0
1668062739838,ECE 200,012,103597,Gilja; Vikash,9999,0,9999,0
1668062739838,ECE 200,013,103598,Hall; Drew A.,9999,0,9999,0
1668062739838,ECE 200,014,103599,Hsueh; Tzu-Chien,9999,0,9999,0
1668062739838,ECE 200,015,103600,Javidi; Tara,9999,0,9999,0
1668062739838,ECE 200,016,103601,Kahng; Andrew Byun,9999,0,9999,0
1668062739838,ECE 200,017,103602,Kim; Young-Han,9999,0,9999,0
1668062739838,ECE 200,018,103603,Koushanfar; Farinaz,9999,0,9999,0
1668062739838,ECE 200,019,103604,Kuzum; Duygu,9999,0,9999,0
1668062739838,ECE 200,020,103605,Le; Hanh-Phuc,9999,0,9999,0
1668062739838,ECE 200,021,103606,Lin; Bill,9999,0,9999,0
1668062739838,ECE 200,022,103607,Liu; Zhaowei,9998,0,9999,1
1668062739838,ECE 200,023,103608,Lo; Yu-Hwa,9999,0,9999,0
1668062739838,ECE 200,024,103609,Lomakin; Vitaliy,9999,0,9999,0
1668062739838,ECE 200,025,103610,Mercier; Patrick Philip,9999,0,9999,0
1668062739838,ECE 200,026,103611,Meyer; Florian,9999,0,9999,0
1668062739838,ECE 200,027,103612,Milstein; Laurence B.,9999,0,9999,0
1668062739838,ECE 200,028,103613,Mir Arabbaygi; Siavash,9999,0,9999,0
1668062739838,ECE 200,029,103614,Mookherjea; Shayan,9999,0,9999,0
1668062739838,ECE 200,030,103615,Morris; Karcher William,9999,0,9999,0
1668062739838,ECE 200,031,103616,Ng; Tse Nga,9999,0,9999,0
1668062739838,ECE 200,032,103617,Nguyen; Truong Quang,9999,0,9999,0
1668062739838,ECE 200,033,103618,Nomura; Kenji,9999,0,9999,0
1668062739838,ECE 200,034,103619,Orlitsky; Alon,9999,0,9999,0
1668062739838,ECE 200,035,103620,Pal; Piya,9999,0,9999,0
1668062739838,ECE 200,036,103621,Papen; George C.,9999,0,9999,0
1668062739838,ECE 200,037,103622,Radic; Stojan,9999,0,9999,0
1668062739838,ECE 200,038,103623,Rao; Bhaskar D.,9999,0,9999,0
1668062739838,ECE 200,039,103624,Rao; Ramesh R,9999,0,9999,0
1668062739838,ECE 200,040,103625,Rebeiz; Gabriel,9999,0,9999,0
1668062739838,ECE 200,041,103626,Sanford; John R,9999,0,9999,0
1668062739838,ECE 200,042,103627,Siegel; Paul H.,9999,0,9999,0
1668062739838,ECE 200,043,103628,Sievenpiper; Daniel F.,9999,0,9999,0
1668062739838,ECE 200,044,103629,Sworder; David D.,9999,0,9999,0
1668062739838,ECE 200,045,103630,Taur; Yuan,9999,0,9999,0
1668062739838,ECE 200,046,103631,Touri; Behrouz,9999,0,9999,0
1668062739838,ECE 200,047,103632,Trivedi; Mohan M.,9999,0,9999,0
1668062739838,ECE 200,048,103633,Vasconcelos; Nuno,9999,0,9999,0
1668062739838,ECE 200,049,103634,Wang; Xiaolong,9999,0,9999,0
1668062739838,ECE 200,050,103635,Xie; Pengtao,9999,0,9999,0
1668062739838,ECE 200,051,103636,Yip; Michael,9999,0,9999,0
1668062739838,ECE 200,052,103637,Zeger; Kenneth A.,999,0,999,0
1668062739838,ECE 200,053,103638,Zhang; Xinyu,9999,0,9999,0
1668062739838,ECE 200,054,103639,Turakhia; Yatish Girish,9999,0,9999,0
1668062739838,ECE 200,055,103640,Kang; Mingu,9999,0,9999,0
1668062739838,ECE 200,056,103641,Shi; Yuanyuan,9999,0,9999,0
1668062739838,ECE 200,057,103642,Wang; Edward Jay,9999,0,9999,0
1668062739838,ECE 200,058,103643,Zheng; Yang,9999,0,9999,0
1668062740269,ECE 202,A00,103644,Kuzum; Duygu,0,0,0,0
1668062740693,ECE 212BN,A00,103646,Ng; Tse Nga,0,0,0,0
1668062741118,ECE 221,A00,111493,Staff,0,0,0,0
1668062741543,ECE 222B,A00,103647,Lomakin; Vitaliy,0,0,0,0
1668062741968,ECE 230B,A00,103648,Taur; Yuan,0,0,0,0
1668062742391,ECE 238B,A00,103649,Garay; Javier,0,0,0,0
1668062742829,ECE 240B,A00,112900,Fainman; Yeshaiahu,0,0,0,0
1668062743250,ECE 247A,A00,103650,Jokerst; Jesse Vincent,0,0,0,0
1668062743682,ECE 247B,A00,103651,Wang; Joseph,0,0,0,0
1668062744108,ECE 250,A00,103652,Siegel; Paul H.,0,0,0,0
1668062744530,ECE 251A,A00,103654,Rao; Bhaskar D.,0,0,0,0
1668062745007,ECE 257B,A00,103655,Bharadia; Dinesh,0,0,0,0
1668062745437,ECE 258A,A00,103656,Milstein; Laurence B.,0,0,0,0
1668062745861,ECE 260B,A00,103658,Kang; Mingu,0,0,0,0
1668062746293,ECE 264A,A00,103659,Galton; Ian A,0,0,0,0
1668062746718,ECE 265A,A00,103661,Gudem; Prasad S.S.,0,0,0,0
1668062747139,ECE 265D,A00,103662,Gudem; Prasad S.S.,0,0,0,0
1668062747565,ECE 268,A00,103663,Koushanfar; Farinaz,0,0,0,0
1668062747992,ECE 269,A01,103665,Pal; Piya,0,0,0,0
1668062748413,ECE 271B,A00,103666,Vasconcelos; Manuela,0,0,0,0
1668062748836,ECE 276A,A00,103667,Atanasov; Nikolay A.,0,0,0,0
1668062749262,ECE 277,A00,103668,An; Cheolhong,0,0,0,0
1668062749687,ECE 279,A00,117947,Hall; Drew A.,0,0,0,0
1668062750535,ECE 283,A00,103670,Hsueh; Tzu-Chien,0,0,0,0
1668062750968,ECE 284,A00,103671,Turakhia; Yatish Girish,0,0,0,0
1668062751400,ECE 285,A00,103672,Zheng; Yang,0,0,0,0
1668062751400,ECE 285,B00,103673,Sworder; David D.,0,0,0,0
1668062751827,ECE 287,A00,103676,Javidi; Tara,0,0,0,0
1668062752251,MATH 200B,A00,098023,Salehi Golsefidy; Alireza,13,0,15,2
1668062752675,MATH 202B,A00,098024,Rhoades; Brendon Patrick,9,0,15,6
1668062753107,MATH 203B,A00,098025,Oprea; Dragos N.,11,0,15,4
1668062753529,MATH 204B,A00,098026,Sorensen; Claus M,13,0,15,2
1668062753955,MATH 208,A00,098027,Izadi; Elham,7,0,10,3
1668062754379,MATH 209,A00,098028,Pollack; Aaron,10,0,10,0
1668062754802,MATH 211A,A00,112919,Rogalski; Daniel,9,0,10,1
1668062755228,MATH 211B,A00,112920,Seward; Brandon M.,9,0,10,1
1668062755650,MATH 218,A00,098029,Li; Bo,10,0,10,0
1668062756082,MATH 220B,A00,098030,Novak; Jonathan I,13,0,15,2
1668062756511,MATH 221A,A00,098031,Ebenfelt; Peter F,13,0,15,2
1668062756939,MATH 231B,A00,098032,Zlatos; Andrej,12,0,15,3
1668062757368,MATH 240B,A00,098033,Ni; Lei,9,0,15,6
1668062757792,MATH 243,A00,098034,Jekel; David Andrew,10,0,10,0
1668062758214,MATH 245A,A00,098035,Nie; Jiawang,0,0,15,16
1668062758643,MATH 248,A00,098036,Bejenaru; Ioan,10,0,10,0
1668062759076,MATH 250B,A00,098037,Spolaor; Luca,14,0,15,1
1668062759503,MATH 258,A00,098038,Ni; Lei,10,0,10,0
1668062759926,MATH 264B,A00,098041,Rhoades; Brendon Patrick,10,0,15,5
1668062760348,MATH 268,A00,098042,Buss; Samuel R,10,0,10,0
1668062760784,MATH 269,A00,098043,Rhoades; Brendon Patrick,10,0,10,0
1668062761217,MATH 270B,A00,098044,Li; Bo,11,0,15,4
1668062761650,MATH 272B,A00,098045,Holst; Michael J,13,0,15,2
1668062762085,MATH 273A,A00,098046,Tian; Xiaochuan,10,0,15,5
1668062762523,MATH 275,A01,098048,Tian; Xiaochuan,6,0,10,4
1668062762944,MATH 278A,A00,098049,Holst; Michael J,8,0,10,2
1668062763374,MATH 278B,A00,098050,Cloninger; Alexander,10,0,10,0
1668062763797,MATH 278C,A00,098051,Nie; Jiawang,7,0,10,3
1668062764231,MATH 280B,A00,098052,Zheng; Tianyi,10,0,15,5
1668062764654,MATH 281B,A00,098053,Bradic; Jelena,3,0,15,12
1668062765079,MATH 282B,A00,098054,Arias-Castro; Ery,0,0,15,15
1668062765509,MATH 285,A00,098055,Fitzsimmons; Patrick J,0,0,15,17
1668062765933,MATH 287B,A00,098056,Arias-Castro; Ery,3,0,15,12
1668062766361,MATH 288,A00,098057,Agarwal; Pooja,9,0,10,1
1668062766361,MATH 288,B00,098058,Zhang; Danna,8,0,10,2
1668062766361,MATH 288,C00,098059,Williams; Ruth J,10,0,10,0
1668062766789,MATH 290B,A00,098060,Roberts; Justin Deritter,13,0,15,2
1668062767218,MATH 292,A00,098061,Belmont; Eva Kinoshita,10,0,10,0
1668062767642,MATH 295,A00,098062,Suk; Andrew Hoon,48,0,50,2
1668062768066,MATH 296,A00,098063,Novak; Jonathan I,20,0,20,0
1668062768492,MATH 297,001,098064,Gamst; Anthony Collins,9997,0,9999,2
1668063280951,COGS 205,A00,101395,Chiba; Andrea,19,0,20,1
1668063281373,COGS 210B,001,101404,Greene; Deanna Jacquelyn,9998,0,9999,1
1668063281373,COGS 210B,002,101417,Xia; Haijun,9999,0,9999,0
1668063281373,COGS 210B,003,101422,Nitz; Douglas A.,9999,0,9999,0
1668063281373,COGS 210B,004,101423,Hollan; James D.,9998,0,9999,1
1668063281373,COGS 210B,005,101424,Deak; Gedeon O.,9998,0,9999,1
1668063281373,COGS 210B,006,101425,Rossano; Federico,9999,0,9999,0
1668063281800,COGS 211B,A00,101427,Coulson; Seana M,9996,0,9999,3
1668063282228,COGS 220,A00,101428,Hollan; James D.,0,0,25,25
1668063282662,COGS 229,A00,101429,Dow; Steven P,18,0,25,7
1668063283085,COGS 230,A00,101430,Klemmer; Scott R,13,0,17,4
1668063283519,COGS 234,A00,101431,Xia; Haijun,4,0,25,21
1668063283941,COGS 260,A00,101432,Kiyonaga; Anastasia,19,0,25,6
1668063283941,COGS 260,B00,101433,Kirsh; David Joel,16,0,25,9
1668063284381,CSE 202,A00,102371,Impagliazzo; Russell,0,0,0,0
1668063284803,CSE 203B,A01,102373,Cheng; Chung Kuan,0,0,0,0
1668063285226,CSE 208,A00,102374,Micciancio; Daniele,0,0,0,0
1668063285652,CSE 209A,A00,112895,Impagliazzo; Russell,0,0,15,15
1668063286074,CSE 209B,A00,108005,Bellare; Mihir,0,0,0,0
1668063286506,CSE 210,A00,113163,Coblenz; Michael J,0,0,0,0
1668063286930,CSE 219,A00,106111,Dow; Steven P,0,0,20,20
1668063287367,CSE 221,A00,102376,Voelker; Geoffrey M.,0,0,0,0
1668063287807,CSE 224,A01,102378,Porter; George M,0,0,0,0
1668063288241,CSE 229A,A00,102379,Savage; Stefan,0,0,0,0
1668063288669,CSE 229C,A00,102380,Munyaka; Imani N. S.,0,0,0,0
1668063289104,CSE 232B,A00,102382,Deutsch; Alin Bernard,0,0,0,0
1668063289547,CSE 234,A01,112904,Kumar; Arun Kumar,0,0,0,0
1668063289971,CSE 237A,A00,102383,Rosing; Tajana Simunic,0,0,0,0
1668063290394,CSE 239A,A00,102384,Deutsch; Alin Bernard,0,0,0,0
1668063290818,CSE 239B,A00,102385,Polikarpova; Nadezhda,0,0,0,0
1668063291242,CSE 240A,A00,102386,Pannuto; Patrick William,0,0,0,0
1668063291667,CSE 240B,A00,102387,Zhao; Jishen,0,0,0,0
1668063292090,CSE 241A,A00,106406,Kang; Mingu,0,0,0,0
1668063292516,CSE 249B,A00,102388,Kahng; Andrew Byun,0,0,8,8
1668063292941,CSE 251B,A01,102392,Cottrell; Garrison W,0,0,0,0
1668063292941,CSE 251B,A02,102393,Cottrell; Garrison W,0,0,0,0
1668063293377,CSE 252B,A00,102394,Ochoa; Benjamin Lawrence,0,0,0,0
1668063293802,CSE 257,A01,102396,Gao; Sicun,0,0,0,0
1668063294225,CSE 272,A00,102397,Li; Tzumao,0,0,0,0
1668063294653,CSE 274,A00,111323,Chern; Albert Ren-Haur,0,0,0,0
1668063295077,CSE 282,A00,102398,Pevzner; Pavel Arkadjevich,0,0,0,0
1668063295503,CSE 284,A00,114175,Gymrek; Melissa Ann,0,0,0,0
1668063295930,CSE 290,A00,102399,Chandraker; Manmohan Krishna,0,0,0,0
1668063295930,CSE 290,B00,102400,Vaccaro; Kristen Marie,0,0,25,25
1668063295930,CSE 290,C00,102414,Pannuto; Patrick William,0,0,25,25
1668063295930,CSE 290,D00,102427,Pevzner; Pavel Arkadjevich,0,0,0,0
1668063295930,CSE 290,E00,102429,Zhao; Jishen,0,0,0,0
1668063295930,CSE 290,F00,102436,Tullsen; Dean Michael,0,0,0,0
1668063295930,CSE 290,G00,102440,Christensen; Henrik I,0,0,20,20
1668063296363,CSE 291,A00,102443,Su; Hao,0,0,0,0
1668063296363,CSE 291,B00,102448,Polikarpova; Nadezhda,0,0,0,0
1668063296363,CSE 291,C00,102453,Vaccaro; Kristen Marie,0,0,0,0
1668063296363,CSE 291,D00,111343,Savage; Stefan,0,0,0,0
1668063296363,CSE 291,E00,116474,Claffy; Kimberly Claire,0,0,0,0
1668063296363,CSE 291,F00,116479,Pasquale; Joseph,0,0,0,0
1668063296799,CSE 293,001,119111,Bafna; Vineet,9999,0,9999,0
1668063296799,CSE 293,002,119118,Bellare; Mihir,9999,0,9999,0
1668063296799,CSE 293,003,119122,Berg-Kirkpatrick; Taylor D,9999,0,9999,0
1668063296799,CSE 293,004,119135,Christensen; Henrik I,9999,0,9999,0
1668063296799,CSE 293,005,119142,Cottrell; Garrison W,9999,0,9999,0
1668063296799,CSE 293,006,119146,Deutsch; Alin Bernard,9999,0,9999,0
1668063296799,CSE 293,007,119159,Esmaeilzadeh; Hadi,9999,0,9999,0
1668063296799,CSE 293,008,119166,Freund; Yoav,9999,0,9999,0
1668063296799,CSE 293,009,119170,Griswold; William G.,9999,0,9999,0
1668063296799,CSE 293,010,119183,Gymrek; Melissa Ann,9999,0,9999,0
1668063296799,CSE 293,011,119190,Heninger; Nadia A,9999,0,9999,0
1668063296799,CSE 293,012,119230,Impagliazzo; Russell,9999,0,9999,0
1668063296799,CSE 293,013,119232,Jhala; Ranjit,9999,0,9999,0
1668063296799,CSE 293,014,119233,Kahng; Andrew Byun,9999,0,9999,0
1668063296799,CSE 293,015,119298,Kane; Daniel Mertz,9999,0,9999,0
1668063296799,CSE 293,016,119299,Kriegman; David J,9999,0,9999,0
1668063296799,CSE 293,017,119300,Kumar; Arun Kumar,9999,0,9999,0
1668063296799,CSE 293,018,119301,Lerner; Sorin,9999,0,9999,0
1668063296799,CSE 293,019,119302,Lovett; Shachar,9999,0,9999,0
1668063296799,CSE 293,020,119303,McAuley; Julian John,9999,0,9999,0
1668063296799,CSE 293,021,119304,Micciancio; Daniele,9999,0,9999,0
1668063296799,CSE 293,022,119367,Orailoglu; Alex,9999,0,9999,0
1668063296799,CSE 293,023,119382,Paturi; Ramamohan,9999,0,9999,0
1668063296799,CSE 293,024,119404,Polikarpova; Nadezhda,9999,0,9999,0
1668063296799,CSE 293,025,119406,Politz; Joseph Gibbs,9999,0,9999,0
1668063296799,CSE 293,026,119411,Porter; George M,9999,0,9999,0
1668063296799,CSE 293,027,119414,Porter; Leonard Emerson,9999,0,9999,0
1668063296799,CSE 293,028,119416,Ramamoorthi; Ravi,9999,0,9999,0
1668063296799,CSE 293,029,119417,Sahoo; Debashis,9999,0,9999,0
1668063296799,CSE 293,030,119420,Saul; Lawrence,9999,0,9999,0
1668063296799,CSE 293,031,119421,Savage; Stefan,9999,0,9999,0
1668063296799,CSE 293,032,119425,Schulze; Jurgen P.,9999,0,9999,0
1668063296799,CSE 293,033,119426,Snoeren; Alex C.,9999,0,9999,0
1668063296799,CSE 293,034,119428,Shang; Jingbo,9999,0,9999,0
1668063296799,CSE 293,035,119430,Stefan; Deian,9999,0,9999,0
1668063296799,CSE 293,036,119431,Su; Hao,9999,0,9999,0
1668063296799,CSE 293,037,119433,Swanson; Steven James,9999,0,9999,0
1668063296799,CSE 293,038,119435,Tullsen; Dean Michael,9999,0,9999,0
1668063296799,CSE 293,039,119483,Voelker; Geoffrey M.,9999,0,9999,0
1668063296799,CSE 293,040,119537,Zhao; Jishen,9999,0,9999,0
1668063296799,CSE 293,041,119538,Zhou; Yuan-Yuan,9999,0,9999,0
1668063296799,CSE 293,042,119539,Gao; Sicun,9999,0,9999,0
1668063296799,CSE 293,043,119540,Weibel; Nadir,9999,0,9999,0
1668063296799,CSE 293,044,119541,Gupta; Rajesh K.,9999,0,9999,0
1668063296799,CSE 293,045,126410,Vaccaro; Kristen Marie,9999,0,9999,0
1668063296799,CSE 293,046,126411,Klemke; Richard,9999,0,9999,0
1668063297225,CSE 294,A00,102459,Voelker; Geoffrey M.,0,0,0,0
1668063297225,CSE 294,B00,111322,Orailoglu; Alex,0,0,0,0
1668063297655,DSE 201,A00,096914,Deutsch; Alin Bernard,30,0,30,0
1668063298078,DSE 210,A00,096915,Dasgupta; Sanjoy,30,0,30,0
1668063298501,DSE 260A,A00,096916,Altintas De Callaf; Ilkay,30,0,30,0
1668063298964,ECE 200,001,103586,Antipa; Nicholas A,9999,0,9999,0
1668063298964,ECE 200,002,103587,Atanasov; Nikolay A.,9999,0,9999,0
1668063298964,ECE 200,003,103588,Bharadia; Dinesh,9999,0,9999,0
1668063298964,ECE 200,004,103589,Cheng; Chung Kuan,9999,0,9999,0
1668063298964,ECE 200,005,103590,Cosman; Pamela C.,9999,0,9999,0
1668063298964,ECE 200,006,103591,Dayeh; Shadi Ahmad,9999,0,9999,0
1668063298964,ECE 200,007,103592,Fainman; Yeshaiahu,9999,0,9999,0
1668063298964,ECE 200,008,103593,Ford; Joseph Earl,9999,0,9999,0
1668063298964,ECE 200,009,103594,Franceschetti; Massimo,9999,0,9999,0
1668063298964,ECE 200,010,103595,Fullerton; Eric E,9999,0,9999,0
1668063298964,ECE 200,011,103596,Galton; Ian A,9999,0,9999,0
1668063298964,ECE 200,012,103597,Gilja; Vikash,9999,0,9999,0
1668063298964,ECE 200,013,103598,Hall; Drew A.,9999,0,9999,0
1668063298964,ECE 200,014,103599,Hsueh; Tzu-Chien,9999,0,9999,0
1668063298964,ECE 200,015,103600,Javidi; Tara,9999,0,9999,0
1668063298964,ECE 200,016,103601,Kahng; Andrew Byun,9999,0,9999,0
1668063298964,ECE 200,017,103602,Kim; Young-Han,9999,0,9999,0
1668063298964,ECE 200,018,103603,Koushanfar; Farinaz,9999,0,9999,0
1668063298964,ECE 200,019,103604,Kuzum; Duygu,9999,0,9999,0
1668063298964,ECE 200,020,103605,Le; Hanh-Phuc,9999,0,9999,0
1668063298964,ECE 200,021,103606,Lin; Bill,9999,0,9999,0
1668063298964,ECE 200,022,103607,Liu; Zhaowei,9998,0,9999,1
1668063298964,ECE 200,023,103608,Lo; Yu-Hwa,9999,0,9999,0
1668063298964,ECE 200,024,103609,Lomakin; Vitaliy,9999,0,9999,0
1668063298964,ECE 200,025,103610,Mercier; Patrick Philip,9999,0,9999,0
1668063298964,ECE 200,026,103611,Meyer; Florian,9999,0,9999,0
1668063298964,ECE 200,027,103612,Milstein; Laurence B.,9999,0,9999,0
1668063298964,ECE 200,028,103613,Mir Arabbaygi; Siavash,9999,0,9999,0
1668063298964,ECE 200,029,103614,Mookherjea; Shayan,9999,0,9999,0
1668063298964,ECE 200,030,103615,Morris; Karcher William,9999,0,9999,0
1668063298964,ECE 200,031,103616,Ng; Tse Nga,9999,0,9999,0
1668063298964,ECE 200,032,103617,Nguyen; Truong Quang,9999,0,9999,0
1668063298964,ECE 200,033,103618,Nomura; Kenji,9999,0,9999,0
1668063298964,ECE 200,034,103619,Orlitsky; Alon,9999,0,9999,0
1668063298964,ECE 200,035,103620,Pal; Piya,9999,0,9999,0
1668063298964,ECE 200,036,103621,Papen; George C.,9999,0,9999,0
1668063298964,ECE 200,037,103622,Radic; Stojan,9999,0,9999,0
1668063298964,ECE 200,038,103623,Rao; Bhaskar D.,9999,0,9999,0
1668063298964,ECE 200,039,103624,Rao; Ramesh R,9999,0,9999,0
1668063298964,ECE 200,040,103625,Rebeiz; Gabriel,9999,0,9999,0
1668063298964,ECE 200,041,103626,Sanford; John R,9999,0,9999,0
1668063298964,ECE 200,042,103627,Siegel; Paul H.,9999,0,9999,0
1668063298964,ECE 200,043,103628,Sievenpiper; Daniel F.,9999,0,9999,0
1668063298964,ECE 200,044,103629,Sworder; David D.,9999,0,9999,0
1668063298964,ECE 200,045,103630,Taur; Yuan,9999,0,9999,0
1668063298964,ECE 200,046,103631,Touri; Behrouz,9999,0,9999,0
1668063298964,ECE 200,047,103632,Trivedi; Mohan M.,9999,0,9999,0
1668063298964,ECE 200,048,103633,Vasconcelos; Nuno,9999,0,9999,0
1668063298964,ECE 200,049,103634,Wang; Xiaolong,9999,0,9999,0
1668063298964,ECE 200,050,103635,Xie; Pengtao,9999,0,9999,0
1668063298964,ECE 200,051,103636,Yip; Michael,9999,0,9999,0
1668063298964,ECE 200,052,103637,Zeger; Kenneth A.,999,0,999,0
1668063298964,ECE 200,053,103638,Zhang; Xinyu,9999,0,9999,0
1668063298964,ECE 200,054,103639,Turakhia; Yatish Girish,9999,0,9999,0
1668063298964,ECE 200,055,103640,Kang; Mingu,9999,0,9999,0
1668063298964,ECE 200,056,103641,Shi; Yuanyuan,9999,0,9999,0
1668063298964,ECE 200,057,103642,Wang; Edward Jay,9999,0,9999,0
1668063298964,ECE 200,058,103643,Zheng; Yang,9999,0,9999,0
1668063299388,ECE 202,A00,103644,Kuzum; Duygu,0,0,0,0
1668063299822,ECE 212BN,A00,103646,Ng; Tse Nga,0,0,0,0
1668063300249,ECE 221,A00,111493,Staff,0,0,0,0
1668063300671,ECE 222B,A00,103647,Lomakin; Vitaliy,0,0,0,0
1668063301097,ECE 230B,A00,103648,Taur; Yuan,0,0,0,0
1668063301518,ECE 238B,A00,103649,Garay; Javier,0,0,0,0
1668063301943,ECE 240B,A00,112900,Fainman; Yeshaiahu,0,0,0,0
1668063302369,ECE 247A,A00,103650,Jokerst; Jesse Vincent,0,0,0,0
1668063302793,ECE 247B,A00,103651,Wang; Joseph,0,0,0,0
1668063303221,ECE 250,A00,103652,Siegel; Paul H.,0,0,0,0
1668063303645,ECE 251A,A00,103654,Rao; Bhaskar D.,0,0,0,0
1668063304072,ECE 257B,A00,103655,Bharadia; Dinesh,0,0,0,0
1668063304499,ECE 258A,A00,103656,Milstein; Laurence B.,0,0,0,0
1668063304921,ECE 260B,A00,103658,Kang; Mingu,0,0,0,0
1668063305345,ECE 264A,A00,103659,Galton; Ian A,0,0,0,0
1668063305768,ECE 265A,A00,103661,Gudem; Prasad S.S.,0,0,0,0
1668063306191,ECE 265D,A00,103662,Gudem; Prasad S.S.,0,0,0,0
1668063306621,ECE 268,A00,103663,Koushanfar; Farinaz,0,0,0,0
1668063307045,ECE 269,A01,103665,Pal; Piya,0,0,0,0
1668063307478,ECE 271B,A00,103666,Vasconcelos; Manuela,0,0,0,0
1668063307914,ECE 276A,A00,103667,Atanasov; Nikolay A.,0,0,0,0
1668063308338,ECE 277,A00,103668,An; Cheolhong,0,0,0,0
1668063308763,ECE 279,A00,117947,Hall; Drew A.,0,0,0,0
1668063309611,ECE 283,A00,103670,Hsueh; Tzu-Chien,0,0,0,0
1668063310041,ECE 284,A00,103671,Turakhia; Yatish Girish,0,0,0,0
1668063310475,ECE 285,A00,103672,Zheng; Yang,0,0,0,0
1668063310475,ECE 285,B00,103673,Sworder; David D.,0,0,0,0
1668063310904,ECE 287,A00,103676,Javidi; Tara,0,0,0,0
1668063311345,MATH 200B,A00,098023,Salehi Golsefidy; Alireza,13,0,15,2
1668063311773,MATH 202B,A00,098024,Rhoades; Brendon Patrick,9,0,15,6
1668063312200,MATH 203B,A00,098025,Oprea; Dragos N.,11,0,15,4
1668063312628,MATH 204B,A00,098026,Sorensen; Claus M,13,0,15,2
1668063313064,MATH 208,A00,098027,Izadi; Elham,7,0,10,3
1668063313490,MATH 209,A00,098028,Pollack; Aaron,10,0,10,0
1668063313918,MATH 211A,A00,112919,Rogalski; Daniel,9,0,10,1
1668063314347,MATH 211B,A00,112920,Seward; Brandon M.,9,0,10,1
1668063314875,MATH 218,A00,098029,Li; Bo,10,0,10,0
1668063315300,MATH 220B,A00,098030,Novak; Jonathan I,13,0,15,2
1668063315735,MATH 221A,A00,098031,Ebenfelt; Peter F,13,0,15,2
1668063316161,MATH 231B,A00,098032,Zlatos; Andrej,12,0,15,3
1668063316585,MATH 240B,A00,098033,Ni; Lei,9,0,15,6
1668063317007,MATH 243,A00,098034,Jekel; David Andrew,10,0,10,0
1668063317434,MATH 245A,A00,098035,Nie; Jiawang,0,0,15,16
1668063317858,MATH 248,A00,098036,Bejenaru; Ioan,10,0,10,0
1668063318282,MATH 250B,A00,098037,Spolaor; Luca,14,0,15,1
1668063318705,MATH 258,A00,098038,Ni; Lei,10,0,10,0
1668063319136,MATH 264B,A00,098041,Rhoades; Brendon Patrick,10,0,15,5
1668063319566,MATH 268,A00,098042,Buss; Samuel R,10,0,10,0
1668063319989,MATH 269,A00,098043,Rhoades; Brendon Patrick,10,0,10,0
1668063320417,MATH 270B,A00,098044,Li; Bo,11,0,15,4
1668063320844,MATH 272B,A00,098045,Holst; Michael J,13,0,15,2
1668063321286,MATH 273A,A00,098046,Tian; Xiaochuan,10,0,15,5
1668063321714,MATH 275,A01,098048,Tian; Xiaochuan,6,0,10,4
1668063322140,MATH 278A,A00,098049,Holst; Michael J,8,0,10,2
1668063322564,MATH 278B,A00,098050,Cloninger; Alexander,10,0,10,0
1668063322987,MATH 278C,A00,098051,Nie; Jiawang,7,0,10,3
1668063323408,MATH 280B,A00,098052,Zheng; Tianyi,10,0,15,5
1668063323833,MATH 281B,A00,098053,Bradic; Jelena,3,0,15,12
1668063324265,MATH 282B,A00,098054,Arias-Castro; Ery,0,0,15,15
1668063324688,MATH 285,A00,098055,Fitzsimmons; Patrick J,0,0,15,17
1668063325113,MATH 287B,A00,098056,Arias-Castro; Ery,3,0,15,12
1668063325537,MATH 288,A00,098057,Agarwal; Pooja,9,0,10,1
1668063325537,MATH 288,B00,098058,Zhang; Danna,8,0,10,2
1668063325537,MATH 288,C00,098059,Williams; Ruth J,10,0,10,0
1668063325959,MATH 290B,A00,098060,Roberts; Justin Deritter,13,0,15,2
1668063326385,MATH 292,A00,098061,Belmont; Eva Kinoshita,10,0,10,0
1668063326812,MATH 295,A00,098062,Suk; Andrew Hoon,48,0,50,2
1668063327239,MATH 296,A00,098063,Novak; Jonathan I,20,0,20,0
1668063327676,MATH 297,001,098064,Gamst; Anthony Collins,9997,0,9999,2
1668063829076,COGS 205,A00,101395,Chiba; Andrea,19,0,20,1
1668063829500,COGS 210B,001,101404,Greene; Deanna Jacquelyn,9998,0,9999,1
1668063829500,COGS 210B,002,101417,Xia; Haijun,9999,0,9999,0
1668063829500,COGS 210B,003,101422,Nitz; Douglas A.,9999,0,9999,0
1668063829500,COGS 210B,004,101423,Hollan; James D.,9998,0,9999,1
1668063829500,COGS 210B,005,101424,Deak; Gedeon O.,9998,0,9999,1
1668063829500,COGS 210B,006,101425,Rossano; Federico,9999,0,9999,0
1668063829925,COGS 211B,A00,101427,Coulson; Seana M,9996,0,9999,3
1668063830348,COGS 220,A00,101428,Hollan; James D.,0,0,25,25
1668063830773,COGS 229,A00,101429,Dow; Steven P,18,0,25,7
1668063831199,COGS 230,A00,101430,Klemmer; Scott R,13,0,17,4
1668063831637,COGS 234,A00,101431,Xia; Haijun,4,0,25,21
1668063832062,COGS 260,A00,101432,Kiyonaga; Anastasia,19,0,25,6
1668063832062,COGS 260,B00,101433,Kirsh; David Joel,16,0,25,9
1668063832489,CSE 202,A00,102371,Impagliazzo; Russell,0,0,0,0
1668063832920,CSE 203B,A01,102373,Cheng; Chung Kuan,0,0,0,0
1668063833345,CSE 208,A00,102374,Micciancio; Daniele,0,0,0,0
1668063833767,CSE 209A,A00,112895,Impagliazzo; Russell,0,0,15,15
1668063834190,CSE 209B,A00,108005,Bellare; Mihir,0,0,0,0
1668063834615,CSE 210,A00,113163,Coblenz; Michael J,0,0,0,0
1668063835040,CSE 219,A00,106111,Dow; Steven P,0,0,20,20
1668063835465,CSE 221,A00,102376,Voelker; Geoffrey M.,0,0,0,0
1668063835888,CSE 224,A01,102378,Porter; George M,0,0,0,0
1668063836406,CSE 229A,A00,102379,Savage; Stefan,0,0,0,0
1668063836830,CSE 229C,A00,102380,Munyaka; Imani N. S.,0,0,0,0
1668063837255,CSE 232B,A00,102382,Deutsch; Alin Bernard,0,0,0,0
1668063837678,CSE 234,A01,112904,Kumar; Arun Kumar,0,0,0,0
1668063838111,CSE 237A,A00,102383,Rosing; Tajana Simunic,0,0,0,0
1668063838534,CSE 239A,A00,102384,Deutsch; Alin Bernard,0,0,0,0
1668063838969,CSE 239B,A00,102385,Polikarpova; Nadezhda,0,0,0,0
1668063839395,CSE 240A,A00,102386,Pannuto; Patrick William,0,0,0,0
1668063839822,CSE 240B,A00,102387,Zhao; Jishen,0,0,0,0
1668063840248,CSE 241A,A00,106406,Kang; Mingu,0,0,0,0
1668063840679,CSE 249B,A00,102388,Kahng; Andrew Byun,0,0,8,8
1668063841118,CSE 251B,A01,102392,Cottrell; Garrison W,0,0,0,0
1668063841118,CSE 251B,A02,102393,Cottrell; Garrison W,0,0,0,0
1668063841544,CSE 252B,A00,102394,Ochoa; Benjamin Lawrence,0,0,0,0
1668063841966,CSE 257,A01,102396,Gao; Sicun,0,0,0,0
1668063842491,CSE 272,A00,102397,Li; Tzumao,0,0,0,0
1668063842922,CSE 274,A00,111323,Chern; Albert Ren-Haur,0,0,0,0
1668063843370,CSE 282,A00,102398,Pevzner; Pavel Arkadjevich,0,0,0,0
1668063843802,CSE 284,A00,114175,Gymrek; Melissa Ann,0,0,0,0
1668063844225,CSE 290,A00,102399,Chandraker; Manmohan Krishna,0,0,0,0
1668063844225,CSE 290,B00,102400,Vaccaro; Kristen Marie,0,0,25,25
1668063844225,CSE 290,C00,102414,Pannuto; Patrick William,0,0,25,25
1668063844225,CSE 290,D00,102427,Pevzner; Pavel Arkadjevich,0,0,0,0
1668063844225,CSE 290,E00,102429,Zhao; Jishen,0,0,0,0
1668063844225,CSE 290,F00,102436,Tullsen; Dean Michael,0,0,0,0
1668063844225,CSE 290,G00,102440,Christensen; Henrik I,0,0,20,20
1668063844650,CSE 291,A00,102443,Su; Hao,0,0,0,0
1668063844650,CSE 291,B00,102448,Polikarpova; Nadezhda,0,0,0,0
1668063844650,CSE 291,C00,102453,Vaccaro; Kristen Marie,0,0,0,0
1668063844650,CSE 291,D00,111343,Savage; Stefan,0,0,0,0
1668063844650,CSE 291,E00,116474,Claffy; Kimberly Claire,0,0,0,0
1668063844650,CSE 291,F00,116479,Pasquale; Joseph,0,0,0,0
1668063845080,CSE 293,001,119111,Bafna; Vineet,9999,0,9999,0
1668063845080,CSE 293,002,119118,Bellare; Mihir,9999,0,9999,0
1668063845080,CSE 293,003,119122,Berg-Kirkpatrick; Taylor D,9999,0,9999,0
1668063845080,CSE 293,004,119135,Christensen; Henrik I,9999,0,9999,0
1668063845080,CSE 293,005,119142,Cottrell; Garrison W,9999,0,9999,0
1668063845080,CSE 293,006,119146,Deutsch; Alin Bernard,9999,0,9999,0
1668063845080,CSE 293,007,119159,Esmaeilzadeh; Hadi,9999,0,9999,0
1668063845080,CSE 293,008,119166,Freund; Yoav,9999,0,9999,0
1668063845080,CSE 293,009,119170,Griswold; William G.,9999,0,9999,0
1668063845080,CSE 293,010,119183,Gymrek; Melissa Ann,9999,0,9999,0
1668063845080,CSE 293,011,119190,Heninger; Nadia A,9999,0,9999,0
1668063845080,CSE 293,012,119230,Impagliazzo; Russell,9999,0,9999,0
1668063845080,CSE 293,013,119232,Jhala; Ranjit,9999,0,9999,0
1668063845080,CSE 293,014,119233,Kahng; Andrew Byun,9999,0,9999,0
1668063845080,CSE 293,015,119298,Kane; Daniel Mertz,9999,0,9999,0
1668063845080,CSE 293,016,119299,Kriegman; David J,9999,0,9999,0
1668063845080,CSE 293,017,119300,Kumar; Arun Kumar,9999,0,9999,0
1668063845080,CSE 293,018,119301,Lerner; Sorin,9999,0,9999,0
1668063845080,CSE 293,019,119302,Lovett; Shachar,9999,0,9999,0
1668063845080,CSE 293,020,119303,McAuley; Julian John,9999,0,9999,0
1668063845080,CSE 293,021,119304,Micciancio; Daniele,9999,0,9999,0
1668063845080,CSE 293,022,119367,Orailoglu; Alex,9999,0,9999,0
1668063845080,CSE 293,023,119382,Paturi; Ramamohan,9999,0,9999,0
1668063845080,CSE 293,024,119404,Polikarpova; Nadezhda,9999,0,9999,0
1668063845080,CSE 293,025,119406,Politz; Joseph Gibbs,9999,0,9999,0
1668063845080,CSE 293,026,119411,Porter; George M,9999,0,9999,0
1668063845080,CSE 293,027,119414,Porter; Leonard Emerson,9999,0,9999,0
1668063845080,CSE 293,028,119416,Ramamoorthi; Ravi,9999,0,9999,0
1668063845080,CSE 293,029,119417,Sahoo; Debashis,9999,0,9999,0
1668063845080,CSE 293,030,119420,Saul; Lawrence,9999,0,9999,0
1668063845080,CSE 293,031,119421,Savage; Stefan,9999,0,9999,0
1668063845080,CSE 293,032,119425,Schulze; Jurgen P.,9999,0,9999,0
1668063845080,CSE 293,033,119426,Snoeren; Alex C.,9999,0,9999,0
1668063845080,CSE 293,034,119428,Shang; Jingbo,9999,0,9999,0
1668063845080,CSE 293,035,119430,Stefan; Deian,9999,0,9999,0
1668063845080,CSE 293,036,119431,Su; Hao,9999,0,9999,0
1668063845080,CSE 293,037,119433,Swanson; Steven James,9999,0,9999,0
1668063845080,CSE 293,038,119435,Tullsen; Dean Michael,9999,0,9999,0
1668063845080,CSE 293,039,119483,Voelker; Geoffrey M.,9999,0,9999,0
1668063845080,CSE 293,040,119537,Zhao; Jishen,9999,0,9999,0
1668063845080,CSE 293,041,119538,Zhou; Yuan-Yuan,9999,0,9999,0
1668063845080,CSE 293,042,119539,Gao; Sicun,9999,0,9999,0
1668063845080,CSE 293,043,119540,Weibel; Nadir,9999,0,9999,0
1668063845080,CSE 293,044,119541,Gupta; Rajesh K.,9999,0,9999,0
1668063845080,CSE 293,045,126410,Vaccaro; Kristen Marie,9999,0,9999,0
1668063845080,CSE 293,046,126411,Klemke; Richard,9999,0,9999,0
1668063845505,CSE 294,A00,102459,Voelker; Geoffrey M.,0,0,0,0
1668063845505,CSE 294,B00,111322,Orailoglu; Alex,0,0,0,0
1668063845958,DSE 201,A00,096914,Deutsch; Alin Bernard,30,0,30,0
1668063846381,DSE 210,A00,096915,Dasgupta; Sanjoy,30,0,30,0
1668063846805,DSE 260A,A00,096916,Altintas De Callaf; Ilkay,30,0,30,0
1668063847280,ECE 200,001,103586,Antipa; Nicholas A,9999,0,9999,0
1668063847280,ECE 200,002,103587,Atanasov; Nikolay A.,9999,0,9999,0
1668063847280,ECE 200,003,103588,Bharadia; Dinesh,9999,0,9999,0
1668063847280,ECE 200,004,103589,Cheng; Chung Kuan,9999,0,9999,0
1668063847280,ECE 200,005,103590,Cosman; Pamela C.,9999,0,9999,0
1668063847280,ECE 200,006,103591,Dayeh; Shadi Ahmad,9999,0,9999,0
1668063847280,ECE 200,007,103592,Fainman; Yeshaiahu,9999,0,9999,0
1668063847280,ECE 200,008,103593,Ford; Joseph Earl,9999,0,9999,0
1668063847280,ECE 200,009,103594,Franceschetti; Massimo,9999,0,9999,0
1668063847280,ECE 200,010,103595,Fullerton; Eric E,9999,0,9999,0
1668063847280,ECE 200,011,103596,Galton; Ian A,9999,0,9999,0
1668063847280,ECE 200,012,103597,Gilja; Vikash,9999,0,9999,0
1668063847280,ECE 200,013,103598,Hall; Drew A.,9999,0,9999,0
1668063847280,ECE 200,014,103599,Hsueh; Tzu-Chien,9999,0,9999,0
1668063847280,ECE 200,015,103600,Javidi; Tara,9999,0,9999,0
1668063847280,ECE 200,016,103601,Kahng; Andrew Byun,9999,0,9999,0
1668063847280,ECE 200,017,103602,Kim; Young-Han,9999,0,9999,0
1668063847280,ECE 200,018,103603,Koushanfar; Farinaz,9999,0,9999,0
1668063847280,ECE 200,019,103604,Kuzum; Duygu,9999,0,9999,0
1668063847280,ECE 200,020,103605,Le; Hanh-Phuc,9999,0,9999,0
1668063847280,ECE 200,021,103606,Lin; Bill,9999,0,9999,0
1668063847280,ECE 200,022,103607,Liu; Zhaowei,9998,0,9999,1
1668063847280,ECE 200,023,103608,Lo; Yu-Hwa,9999,0,9999,0
1668063847280,ECE 200,024,103609,Lomakin; Vitaliy,9999,0,9999,0
1668063847280,ECE 200,025,103610,Mercier; Patrick Philip,9999,0,9999,0
1668063847280,ECE 200,026,103611,Meyer; Florian,9999,0,9999,0
1668063847280,ECE 200,027,103612,Milstein; Laurence B.,9999,0,9999,0
1668063847280,ECE 200,028,103613,Mir Arabbaygi; Siavash,9999,0,9999,0
1668063847280,ECE 200,029,103614,Mookherjea; Shayan,9999,0,9999,0
1668063847280,ECE 200,030,103615,Morris; Karcher William,9999,0,9999,0
1668063847280,ECE 200,031,103616,Ng; Tse Nga,9999,0,9999,0
1668063847280,ECE 200,032,103617,Nguyen; Truong Quang,9999,0,9999,0
1668063847280,ECE 200,033,103618,Nomura; Kenji,9999,0,9999,0
1668063847280,ECE 200,034,103619,Orlitsky; Alon,9999,0,9999,0
1668063847280,ECE 200,035,103620,Pal; Piya,9999,0,9999,0
1668063847280,ECE 200,036,103621,Papen; George C.,9999,0,9999,0
1668063847280,ECE 200,037,103622,Radic; Stojan,9999,0,9999,0
1668063847280,ECE 200,038,103623,Rao; Bhaskar D.,9999,0,9999,0
1668063847280,ECE 200,039,103624,Rao; Ramesh R,9999,0,9999,0
1668063847280,ECE 200,040,103625,Rebeiz; Gabriel,9999,0,9999,0
1668063847280,ECE 200,041,103626,Sanford; John R,9999,0,9999,0
1668063847280,ECE 200,042,103627,Siegel; Paul H.,9999,0,9999,0
1668063847280,ECE 200,043,103628,Sievenpiper; Daniel F.,9999,0,9999,0
1668063847280,ECE 200,044,103629,Sworder; David D.,9999,0,9999,0
1668063847280,ECE 200,045,103630,Taur; Yuan,9999,0,9999,0
1668063847280,ECE 200,046,103631,Touri; Behrouz,9999,0,9999,0
1668063847280,ECE 200,047,103632,Trivedi; Mohan M.,9999,0,9999,0
1668063847280,ECE 200,048,103633,Vasconcelos; Nuno,9999,0,9999,0
1668063847280,ECE 200,049,103634,Wang; Xiaolong,9999,0,9999,0
1668063847280,ECE 200,050,103635,Xie; Pengtao,9999,0,9999,0
1668063847280,ECE 200,051,103636,Yip; Michael,9999,0,9999,0
1668063847280,ECE 200,052,103637,Zeger; Kenneth A.,999,0,999,0
1668063847280,ECE 200,053,103638,Zhang; Xinyu,9999,0,9999,0
1668063847280,ECE 200,054,103639,Turakhia; Yatish Girish,9999,0,9999,0
1668063847280,ECE 200,055,103640,Kang; Mingu,9999,0,9999,0
1668063847280,ECE 200,056,103641,Shi; Yuanyuan,9999,0,9999,0
1668063847280,ECE 200,057,103642,Wang; Edward Jay,9999,0,9999,0
1668063847280,ECE 200,058,103643,Zheng; Yang,9999,0,9999,0
1668063847706,ECE 202,A00,103644,Kuzum; Duygu,0,0,0,0
1668063848140,ECE 212BN,A00,103646,Ng; Tse Nga,0,0,0,0
1668063848580,ECE 221,A00,111493,Staff,0,0,0,0
1668063849002,ECE 222B,A00,103647,Lomakin; Vitaliy,0,0,0,0
1668063849437,ECE 230B,A00,103648,Taur; Yuan,0,0,0,0
1668063849870,ECE 238B,A00,103649,Garay; Javier,0,0,0,0
1668063850297,ECE 240B,A00,112900,Fainman; Yeshaiahu,0,0,0,0
1668063850728,ECE 247A,A00,103650,Jokerst; Jesse Vincent,0,0,0,0
1668063851161,ECE 247B,A00,103651,Wang; Joseph,0,0,0,0
1668063851589,ECE 250,A00,103652,Siegel; Paul H.,0,0,0,0
1668063852017,ECE 251A,A00,103654,Rao; Bhaskar D.,0,0,0,0
1668063852440,ECE 257B,A00,103655,Bharadia; Dinesh,0,0,0,0
1668063852874,ECE 258A,A00,103656,Milstein; Laurence B.,0,0,0,0
1668063853301,ECE 260B,A00,103658,Kang; Mingu,0,0,0,0
1668063853727,ECE 264A,A00,103659,Galton; Ian A,0,0,0,0
1668063854153,ECE 265A,A00,103661,Gudem; Prasad S.S.,0,0,0,0
1668063854579,ECE 265D,A00,103662,Gudem; Prasad S.S.,0,0,0,0
1668063855005,ECE 268,A00,103663,Koushanfar; Farinaz,0,0,0,0
1668063855428,ECE 269,A01,103665,Pal; Piya,0,0,0,0
1668063855856,ECE 271B,A00,103666,Vasconcelos; Manuela,0,0,0,0
1668063856280,ECE 276A,A00,103667,Atanasov; Nikolay A.,0,0,0,0
1668063856703,ECE 277,A00,103668,An; Cheolhong,0,0,0,0
1668063857127,ECE 279,A00,117947,Hall; Drew A.,0,0,0,0
1668063857978,ECE 283,A00,103670,Hsueh; Tzu-Chien,0,0,0,0
1668063858401,ECE 284,A00,103671,Turakhia; Yatish Girish,0,0,0,0
1668063858826,ECE 285,A00,103672,Zheng; Yang,0,0,0,0
1668063858826,ECE 285,B00,103673,Sworder; David D.,0,0,0,0
1668063859256,ECE 287,A00,103676,Javidi; Tara,0,0,0,0
1668063859684,MATH 200B,A00,098023,Salehi Golsefidy; Alireza,13,0,15,2
1668063860111,MATH 202B,A00,098024,Rhoades; Brendon Patrick,9,0,15,6
1668063860545,MATH 203B,A00,098025,Oprea; Dragos N.,11,0,15,4
1668063860970,MATH 204B,A00,098026,Sorensen; Claus M,13,0,15,2
1668063861396,MATH 208,A00,098027,Izadi; Elham,7,0,10,3
1668063861819,MATH 209,A00,098028,Pollack; Aaron,10,0,10,0
1668063862247,MATH 211A,A00,112919,Rogalski; Daniel,9,0,10,1
1668063862676,MATH 211B,A00,112920,Seward; Brandon M.,9,0,10,1
1668063863102,MATH 218,A00,098029,Li; Bo,10,0,10,0
1668063863528,MATH 220B,A00,098030,Novak; Jonathan I,13,0,15,2
1668063863952,MATH 221A,A00,098031,Ebenfelt; Peter F,13,0,15,2
1668063864383,MATH 231B,A00,098032,Zlatos; Andrej,12,0,15,3
1668063864812,MATH 240B,A00,098033,Ni; Lei,9,0,15,6
1668063865236,MATH 243,A00,098034,Jekel; David Andrew,10,0,10,0
1668063865659,MATH 245A,A00,098035,Nie; Jiawang,0,0,15,16
1668063866084,MATH 248,A00,098036,Bejenaru; Ioan,10,0,10,0
1668063866511,MATH 250B,A00,098037,Spolaor; Luca,14,0,15,1
1668063866937,MATH 258,A00,098038,Ni; Lei,10,0,10,0
1668063867362,MATH 264B,A00,098041,Rhoades; Brendon Patrick,10,0,15,5
1668063867790,MATH 268,A00,098042,Buss; Samuel R,10,0,10,0
1668063868215,MATH 269,A00,098043,Rhoades; Brendon Patrick,10,0,10,0
1668063868640,MATH 270B,A00,098044,Li; Bo,11,0,15,4
1668063869075,MATH 272B,A00,098045,Holst; Michael J,13,0,15,2
1668063869516,MATH 273A,A00,098046,Tian; Xiaochuan,10,0,15,5
1668063869951,MATH 275,A01,098048,Tian; Xiaochuan,6,0,10,4
1668063870377,MATH 278A,A00,098049,Holst; Michael J,8,0,10,2
1668063870803,MATH 278B,A00,098050,Cloninger; Alexander,10,0,10,0
1668063871226,MATH 278C,A00,098051,Nie; Jiawang,7,0,10,3
1668063871659,MATH 280B,A00,098052,Zheng; Tianyi,10,0,15,5
1668063872084,MATH 281B,A00,098053,Bradic; Jelena,3,0,15,12
1668063872513,MATH 282B,A00,098054,Arias-Castro; Ery,0,0,15,15
1668063872940,MATH 285,A00,098055,Fitzsimmons; Patrick J,0,0,15,17
1668063873363,MATH 287B,A00,098056,Arias-Castro; Ery,3,0,15,12
1668063873787,MATH 288,A00,098057,Agarwal; Pooja,9,0,10,1
1668063873787,MATH 288,B00,098058,Zhang; Danna,8,0,10,2
1668063873787,MATH 288,C00,098059,Williams; Ruth J,10,0,10,0
1668063874224,MATH 290B,A00,098060,Roberts; Justin Deritter,13,0,15,2
1668063874659,MATH 292,A00,098061,Belmont; Eva Kinoshita,10,0,10,0
1668063875086,MATH 295,A00,098062,Suk; Andrew Hoon,48,0,50,2
1668063875516,MATH 296,A00,098063,Novak; Jonathan I,20,0,20,0
1668063875956,MATH 297,001,098064,Gamst; Anthony Collins,9997,0,9999,2
1668064377892,COGS 205,A00,101395,Chiba; Andrea,19,0,20,1
1668064378316,COGS 210B,001,101404,Greene; Deanna Jacquelyn,9998,0,9999,1
1668064378316,COGS 210B,002,101417,Xia; Haijun,9999,0,9999,0
1668064378316,COGS 210B,003,101422,Nitz; Douglas A.,9999,0,9999,0
1668064378316,COGS 210B,004,101423,Hollan; James D.,9998,0,9999,1
1668064378316,COGS 210B,005,101424,Deak; Gedeon O.,9998,0,9999,1
1668064378316,COGS 210B,006,101425,Rossano; Federico,9999,0,9999,0
1668064378754,COGS 211B,A00,101427,Coulson; Seana M,9996,0,9999,3
1668064379178,COGS 220,A00,101428,Hollan; James D.,0,0,25,25
1668064379606,COGS 229,A00,101429,Dow; Steven P,18,0,25,7
1668064380030,COGS 230,A00,101430,Klemmer; Scott R,13,0,17,4
1668064380456,COGS 234,A00,101431,Xia; Haijun,4,0,25,21
1668064380880,COGS 260,A00,101432,Kiyonaga; Anastasia,19,0,25,6
1668064380880,COGS 260,B00,101433,Kirsh; David Joel,16,0,25,9
1668064381305,CSE 202,A00,102371,Impagliazzo; Russell,0,0,0,0
1668064381737,CSE 203B,A01,102373,Cheng; Chung Kuan,0,0,0,0
1668064382162,CSE 208,A00,102374,Micciancio; Daniele,0,0,0,0
1668064382596,CSE 209A,A00,112895,Impagliazzo; Russell,0,0,15,15
1668064383028,CSE 209B,A00,108005,Bellare; Mihir,0,0,0,0
1668064383460,CSE 210,A00,113163,Coblenz; Michael J,0,0,0,0
1668064383896,CSE 219,A00,106111,Dow; Steven P,0,0,20,20
1668064384333,CSE 221,A00,102376,Voelker; Geoffrey M.,0,0,0,0
1668064384761,CSE 224,A01,102378,Porter; George M,0,0,0,0
1668064385208,CSE 229A,A00,102379,Savage; Stefan,0,0,0,0
1668064385637,CSE 229C,A00,102380,Munyaka; Imani N. S.,0,0,0,0
1668064386065,CSE 232B,A00,102382,Deutsch; Alin Bernard,0,0,0,0
1668064386488,CSE 234,A01,112904,Kumar; Arun Kumar,0,0,0,0
1668064386916,CSE 237A,A00,102383,Rosing; Tajana Simunic,0,0,0,0
1668064387342,CSE 239A,A00,102384,Deutsch; Alin Bernard,0,0,0,0
1668064387765,CSE 239B,A00,102385,Polikarpova; Nadezhda,0,0,0,0
1668064388190,CSE 240A,A00,102386,Pannuto; Patrick William,0,0,0,0
1668064388618,CSE 240B,A00,102387,Zhao; Jishen,0,0,0,0
1668064389041,CSE 241A,A00,106406,Kang; Mingu,0,0,0,0
1668064389468,CSE 249B,A00,102388,Kahng; Andrew Byun,0,0,8,8
1668064389895,CSE 251B,A01,102392,Cottrell; Garrison W,0,0,0,0
1668064389895,CSE 251B,A02,102393,Cottrell; Garrison W,0,0,0,0
1668064390319,CSE 252B,A00,102394,Ochoa; Benjamin Lawrence,0,0,0,0
1668064390745,CSE 257,A01,102396,Gao; Sicun,0,0,0,0
1668064391169,CSE 272,A00,102397,Li; Tzumao,0,0,0,0
1668064391596,CSE 274,A00,111323,Chern; Albert Ren-Haur,0,0,0,0
1668064392020,CSE 282,A00,102398,Pevzner; Pavel Arkadjevich,0,0,0,0
1668064392443,CSE 284,A00,114175,Gymrek; Melissa Ann,0,0,0,0
1668064392868,CSE 290,A00,102399,Chandraker; Manmohan Krishna,0,0,0,0
1668064392868,CSE 290,B00,102400,Vaccaro; Kristen Marie,0,0,25,25
1668064392868,CSE 290,C00,102414,Pannuto; Patrick William,0,0,25,25
1668064392868,CSE 290,D00,102427,Pevzner; Pavel Arkadjevich,0,0,0,0
1668064392868,CSE 290,E00,102429,Zhao; Jishen,0,0,0,0
1668064392868,CSE 290,F00,102436,Tullsen; Dean Michael,0,0,0,0
1668064392868,CSE 290,G00,102440,Christensen; Henrik I,0,0,20,20
1668064393302,CSE 291,A00,102443,Su; Hao,0,0,0,0
1668064393302,CSE 291,B00,102448,Polikarpova; Nadezhda,0,0,0,0
1668064393302,CSE 291,C00,102453,Vaccaro; Kristen Marie,0,0,0,0
1668064393302,CSE 291,D00,111343,Savage; Stefan,0,0,0,0
1668064393302,CSE 291,E00,116474,Claffy; Kimberly Claire,0,0,0,0
1668064393302,CSE 291,F00,116479,Pasquale; Joseph,0,0,0,0
1668064393733,CSE 293,001,119111,Bafna; Vineet,9999,0,9999,0
1668064393733,CSE 293,002,119118,Bellare; Mihir,9999,0,9999,0
1668064393733,CSE 293,003,119122,Berg-Kirkpatrick; Taylor D,9999,0,9999,0
1668064393733,CSE 293,004,119135,Christensen; Henrik I,9999,0,9999,0
1668064393733,CSE 293,005,119142,Cottrell; Garrison W,9999,0,9999,0
1668064393733,CSE 293,006,119146,Deutsch; Alin Bernard,9999,0,9999,0
1668064393733,CSE 293,007,119159,Esmaeilzadeh; Hadi,9999,0,9999,0
1668064393733,CSE 293,008,119166,Freund; Yoav,9999,0,9999,0
1668064393733,CSE 293,009,119170,Griswold; William G.,9999,0,9999,0
1668064393733,CSE 293,010,119183,Gymrek; Melissa Ann,9999,0,9999,0
1668064393733,CSE 293,011,119190,Heninger; Nadia A,9999,0,9999,0
1668064393733,CSE 293,012,119230,Impagliazzo; Russell,9999,0,9999,0
1668064393733,CSE 293,013,119232,Jhala; Ranjit,9999,0,9999,0
1668064393733,CSE 293,014,119233,Kahng; Andrew Byun,9999,0,9999,0
1668064393733,CSE 293,015,119298,Kane; Daniel Mertz,9999,0,9999,0
1668064393733,CSE 293,016,119299,Kriegman; David J,9999,0,9999,0
1668064393733,CSE 293,017,119300,Kumar; Arun Kumar,9999,0,9999,0
1668064393733,CSE 293,018,119301,Lerner; Sorin,9999,0,9999,0
1668064393733,CSE 293,019,119302,Lovett; Shachar,9999,0,9999,0
1668064393733,CSE 293,020,119303,McAuley; Julian John,9999,0,9999,0
1668064393733,CSE 293,021,119304,Micciancio; Daniele,9999,0,9999,0
1668064393733,CSE 293,022,119367,Orailoglu; Alex,9999,0,9999,0
1668064393733,CSE 293,023,119382,Paturi; Ramamohan,9999,0,9999,0
1668064393733,CSE 293,024,119404,Polikarpova; Nadezhda,9999,0,9999,0
1668064393733,CSE 293,025,119406,Politz; Joseph Gibbs,9999,0,9999,0
1668064393733,CSE 293,026,119411,Porter; George M,9999,0,9999,0
1668064393733,CSE 293,027,119414,Porter; Leonard Emerson,9999,0,9999,0
1668064393733,CSE 293,028,119416,Ramamoorthi; Ravi,9999,0,9999,0
1668064393733,CSE 293,029,119417,Sahoo; Debashis,9999,0,9999,0
1668064393733,CSE 293,030,119420,Saul; Lawrence,9999,0,9999,0
1668064393733,CSE 293,031,119421,Savage; Stefan,9999,0,9999,0
1668064393733,CSE 293,032,119425,Schulze; Jurgen P.,9999,0,9999,0
1668064393733,CSE 293,033,119426,Snoeren; Alex C.,9999,0,9999,0
1668064393733,CSE 293,034,119428,Shang; Jingbo,9999,0,9999,0
1668064393733,CSE 293,035,119430,Stefan; Deian,9999,0,9999,0
1668064393733,CSE 293,036,119431,Su; Hao,9999,0,9999,0
1668064393733,CSE 293,037,119433,Swanson; Steven James,9999,0,9999,0
1668064393733,CSE 293,038,119435,Tullsen; Dean Michael,9999,0,9999,0
1668064393733,CSE 293,039,119483,Voelker; Geoffrey M.,9999,0,9999,0
1668064393733,CSE 293,040,119537,Zhao; Jishen,9999,0,9999,0
1668064393733,CSE 293,041,119538,Zhou; Yuan-Yuan,9999,0,9999,0
1668064393733,CSE 293,042,119539,Gao; Sicun,9999,0,9999,0
1668064393733,CSE 293,043,119540,Weibel; Nadir,9999,0,9999,0
1668064393733,CSE 293,044,119541,Gupta; Rajesh K.,9999,0,9999,0
1668064393733,CSE 293,045,126410,Vaccaro; Kristen Marie,9999,0,9999,0
1668064393733,CSE 293,046,126411,Klemke; Richard,9999,0,9999,0
1668064394159,CSE 294,A00,102459,Voelker; Geoffrey M.,0,0,0,0
1668064394159,CSE 294,B00,111322,Orailoglu; Alex,0,0,0,0
1668064394588,DSE 201,A00,096914,Deutsch; Alin Bernard,30,0,30,0
1668064395011,DSE 210,A00,096915,Dasgupta; Sanjoy,30,0,30,0
1668064395442,DSE 260A,A00,096916,Altintas De Callaf; Ilkay,30,0,30,0
1668064395872,ECE 200,001,103586,Antipa; Nicholas A,9999,0,9999,0
1668064395872,ECE 200,002,103587,Atanasov; Nikolay A.,9999,0,9999,0
1668064395872,ECE 200,003,103588,Bharadia; Dinesh,9999,0,9999,0
1668064395872,ECE 200,004,103589,Cheng; Chung Kuan,9999,0,9999,0
1668064395872,ECE 200,005,103590,Cosman; Pamela C.,9999,0,9999,0
1668064395872,ECE 200,006,103591,Dayeh; Shadi Ahmad,9999,0,9999,0
1668064395872,ECE 200,007,103592,Fainman; Yeshaiahu,9999,0,9999,0
1668064395872,ECE 200,008,103593,Ford; Joseph Earl,9999,0,9999,0
1668064395872,ECE 200,009,103594,Franceschetti; Massimo,9999,0,9999,0
1668064395872,ECE 200,010,103595,Fullerton; Eric E,9999,0,9999,0
1668064395872,ECE 200,011,103596,Galton; Ian A,9999,0,9999,0
1668064395872,ECE 200,012,103597,Gilja; Vikash,9999,0,9999,0
1668064395872,ECE 200,013,103598,Hall; Drew A.,9999,0,9999,0
1668064395872,ECE 200,014,103599,Hsueh; Tzu-Chien,9999,0,9999,0
1668064395872,ECE 200,015,103600,Javidi; Tara,9999,0,9999,0
1668064395872,ECE 200,016,103601,Kahng; Andrew Byun,9999,0,9999,0
1668064395872,ECE 200,017,103602,Kim; Young-Han,9999,0,9999,0
1668064395872,ECE 200,018,103603,Koushanfar; Farinaz,9999,0,9999,0
1668064395872,ECE 200,019,103604,Kuzum; Duygu,9999,0,9999,0
1668064395872,ECE 200,020,103605,Le; Hanh-Phuc,9999,0,9999,0
1668064395872,ECE 200,021,103606,Lin; Bill,9999,0,9999,0
1668064395872,ECE 200,022,103607,Liu; Zhaowei,9998,0,9999,1
1668064395872,ECE 200,023,103608,Lo; Yu-Hwa,9999,0,9999,0
1668064395872,ECE 200,024,103609,Lomakin; Vitaliy,9999,0,9999,0
1668064395872,ECE 200,025,103610,Mercier; Patrick Philip,9999,0,9999,0
1668064395872,ECE 200,026,103611,Meyer; Florian,9999,0,9999,0
1668064395872,ECE 200,027,103612,Milstein; Laurence B.,9999,0,9999,0
1668064395872,ECE 200,028,103613,Mir Arabbaygi; Siavash,9999,0,9999,0
1668064395872,ECE 200,029,103614,Mookherjea; Shayan,9999,0,9999,0
1668064395872,ECE 200,030,103615,Morris; Karcher William,9999,0,9999,0
1668064395872,ECE 200,031,103616,Ng; Tse Nga,9999,0,9999,0
1668064395872,ECE 200,032,103617,Nguyen; Truong Quang,9999,0,9999,0
1668064395872,ECE 200,033,103618,Nomura; Kenji,9999,0,9999,0
1668064395872,ECE 200,034,103619,Orlitsky; Alon,9999,0,9999,0
1668064395872,ECE 200,035,103620,Pal; Piya,9999,0,9999,0
1668064395872,ECE 200,036,103621,Papen; George C.,9999,0,9999,0
1668064395872,ECE 200,037,103622,Radic; Stojan,9999,0,9999,0
1668064395872,ECE 200,038,103623,Rao; Bhaskar D.,9999,0,9999,0
1668064395872,ECE 200,039,103624,Rao; Ramesh R,9999,0,9999,0
1668064395872,ECE 200,040,103625,Rebeiz; Gabriel,9999,0,9999,0
1668064395872,ECE 200,041,103626,Sanford; John R,9999,0,9999,0
1668064395872,ECE 200,042,103627,Siegel; Paul H.,9999,0,9999,0
1668064395872,ECE 200,043,103628,Sievenpiper; Daniel F.,9999,0,9999,0
1668064395872,ECE 200,044,103629,Sworder; David D.,9999,0,9999,0
1668064395872,ECE 200,045,103630,Taur; Yuan,9999,0,9999,0
1668064395872,ECE 200,046,103631,Touri; Behrouz,9999,0,9999,0
1668064395872,ECE 200,047,103632,Trivedi; Mohan M.,9999,0,9999,0
1668064395872,ECE 200,048,103633,Vasconcelos; Nuno,9999,0,9999,0
1668064395872,ECE 200,049,103634,Wang; Xiaolong,9999,0,9999,0
1668064395872,ECE 200,050,103635,Xie; Pengtao,9999,0,9999,0
1668064395872,ECE 200,051,103636,Yip; Michael,9999,0,9999,0
1668064395872,ECE 200,052,103637,Zeger; Kenneth A.,999,0,999,0
1668064395872,ECE 200,053,103638,Zhang; Xinyu,9999,0,9999,0
1668064395872,ECE 200,054,103639,Turakhia; Yatish Girish,9999,0,9999,0
1668064395872,ECE 200,055,103640,Kang; Mingu,9999,0,9999,0
1668064395872,ECE 200,056,103641,Shi; Yuanyuan,9999,0,9999,0
1668064395872,ECE 200,057,103642,Wang; Edward Jay,9999,0,9999,0
1668064395872,ECE 200,058,103643,Zheng; Yang,9999,0,9999,0
1668064396299,ECE 202,A00,103644,Kuzum; Duygu,0,0,0,0
1668064396722,ECE 212BN,A00,103646,Ng; Tse Nga,0,0,0,0
1668064397157,ECE 221,A00,111493,Staff,0,0,0,0
1668064397590,ECE 222B,A00,103647,Lomakin; Vitaliy,0,0,0,0
1668064398019,ECE 230B,A00,103648,Taur; Yuan,0,0,0,0
1668064398444,ECE 238B,A00,103649,Garay; Javier,0,0,0,0
1668064398913,ECE 240B,A00,112900,Fainman; Yeshaiahu,0,0,0,0
1668064399343,ECE 247A,A00,103650,Jokerst; Jesse Vincent,0,0,0,0
1668064399768,ECE 247B,A00,103651,Wang; Joseph,0,0,0,0
1668064400195,ECE 250,A00,103652,Siegel; Paul H.,0,0,0,0
1668064400618,ECE 251A,A00,103654,Rao; Bhaskar D.,0,0,0,0
1668064401045,ECE 257B,A00,103655,Bharadia; Dinesh,0,0,0,0
1668064401469,ECE 258A,A00,103656,Milstein; Laurence B.,0,0,0,0
1668064401971,ECE 260B,A00,103658,Kang; Mingu,0,0,0,0
1668064402396,ECE 264A,A00,103659,Galton; Ian A,0,0,0,0
1668064402819,ECE 265A,A00,103661,Gudem; Prasad S.S.,0,0,0,0
1668064403246,ECE 265D,A00,103662,Gudem; Prasad S.S.,0,0,0,0
1668064403671,ECE 268,A00,103663,Koushanfar; Farinaz,0,0,0,0
1668064404096,ECE 269,A01,103665,Pal; Piya,0,0,0,0
1668064404520,ECE 271B,A00,103666,Vasconcelos; Manuela,0,0,0,0
1668064404946,ECE 276A,A00,103667,Atanasov; Nikolay A.,0,0,0,0
1668064405375,ECE 277,A00,103668,An; Cheolhong,0,0,0,0
1668064405798,ECE 279,A00,117947,Hall; Drew A.,0,0,0,0
1668064406658,ECE 283,A00,103670,Hsueh; Tzu-Chien,0,0,0,0
1668064407084,ECE 284,A00,103671,Turakhia; Yatish Girish,0,0,0,0
1668064407506,ECE 285,A00,103672,Zheng; Yang,0,0,0,0
1668064407506,ECE 285,B00,103673,Sworder; David D.,0,0,0,0
1668064407929,ECE 287,A00,103676,Javidi; Tara,0,0,0,0
1668064408353,MATH 200B,A00,098023,Salehi Golsefidy; Alireza,13,0,15,2
1668064408776,MATH 202B,A00,098024,Rhoades; Brendon Patrick,9,0,15,6
1668064409210,MATH 203B,A00,098025,Oprea; Dragos N.,11,0,15,4
1668064409643,MATH 204B,A00,098026,Sorensen; Claus M,13,0,15,2
1668064410075,MATH 208,A00,098027,Izadi; Elham,7,0,10,3
1668064410506,MATH 209,A00,098028,Pollack; Aaron,10,0,10,0
1668064410931,MATH 211A,A00,112919,Rogalski; Daniel,9,0,10,1
1668064411353,MATH 211B,A00,112920,Seward; Brandon M.,9,0,10,1
1668064411775,MATH 218,A00,098029,Li; Bo,10,0,10,0
1668064412199,MATH 220B,A00,098030,Novak; Jonathan I,13,0,15,2
1668064412624,MATH 221A,A00,098031,Ebenfelt; Peter F,13,0,15,2
1668064413056,MATH 231B,A00,098032,Zlatos; Andrej,12,0,15,3
1668064413479,MATH 240B,A00,098033,Ni; Lei,9,0,15,6
1668064413903,MATH 243,A00,098034,Jekel; David Andrew,10,0,10,0
1668064414326,MATH 245A,A00,098035,Nie; Jiawang,0,0,15,16
1668064414749,MATH 248,A00,098036,Bejenaru; Ioan,10,0,10,0
1668064415175,MATH 250B,A00,098037,Spolaor; Luca,14,0,15,1
1668064415597,MATH 258,A00,098038,Ni; Lei,10,0,10,0
1668064416021,MATH 264B,A00,098041,Rhoades; Brendon Patrick,10,0,15,5
1668064416445,MATH 268,A00,098042,Buss; Samuel R,10,0,10,0
1668064416868,MATH 269,A00,098043,Rhoades; Brendon Patrick,10,0,10,0
1668064417291,MATH 270B,A00,098044,Li; Bo,11,0,15,4
1668064417716,MATH 272B,A00,098045,Holst; Michael J,13,0,15,2
1668064418149,MATH 273A,A00,098046,Tian; Xiaochuan,10,0,15,5
1668064418573,MATH 275,A01,098048,Tian; Xiaochuan,6,0,10,4
1668064418997,MATH 278A,A00,098049,Holst; Michael J,8,0,10,2
1668064419422,MATH 278B,A00,098050,Cloninger; Alexander,10,0,10,0
1668064419877,MATH 278C,A00,098051,Nie; Jiawang,7,0,10,3
1668064420305,MATH 280B,A00,098052,Zheng; Tianyi,10,0,15,5
1668064420732,MATH 281B,A00,098053,Bradic; Jelena,3,0,15,12
1668064421159,MATH 282B,A00,098054,Arias-Castro; Ery,0,0,15,15
1668064421591,MATH 285,A00,098055,Fitzsimmons; Patrick J,0,0,15,17
1668064422020,MATH 287B,A00,098056,Arias-Castro; Ery,3,0,15,12
1668064422447,MATH 288,A00,098057,Agarwal; Pooja,9,0,10,1
1668064422447,MATH 288,B00,098058,Zhang; Danna,8,0,10,2
1668064422447,MATH 288,C00,098059,Williams; Ruth J,10,0,10,0
1668064422872,MATH 290B,A00,098060,Roberts; Justin Deritter,13,0,15,2
1668064423302,MATH 292,A00,098061,Belmont; Eva Kinoshita,10,0,10,0
1668064423728,MATH 295,A00,098062,Suk; Andrew Hoon,48,0,50,2
1668064424161,MATH 296,A00,098063,Novak; Jonathan I,20,0,20,0
1668064424593,MATH 297,001,098064,Gamst; Anthony Collins,9997,0,9999,2
1668064926457,COGS 205,A00,101395,Chiba; Andrea,19,0,20,1
1668064926888,COGS 210B,001,101404,Greene; Deanna Jacquelyn,9998,0,9999,1
1668064926888,COGS 210B,002,101417,Xia; Haijun,9999,0,9999,0
1668064926888,COGS 210B,003,101422,Nitz; Douglas A.,9999,0,9999,0
1668064926888,COGS 210B,004,101423,Hollan; James D.,9998,0,9999,1
1668064926888,COGS 210B,005,101424,Deak; Gedeon O.,9998,0,9999,1
1668064926888,COGS 210B,006,101425,Rossano; Federico,9999,0,9999,0
1668064927312,COGS 211B,A00,101427,Coulson; Seana M,9996,0,9999,3
1668064927735,COGS 220,A00,101428,Hollan; James D.,0,0,25,25
1668064928161,COGS 229,A00,101429,Dow; Steven P,18,0,25,7
1668064928586,COGS 230,A00,101430,Klemmer; Scott R,13,0,17,4
1668064929011,COGS 234,A00,101431,Xia; Haijun,3,0,25,22
1668064929440,COGS 260,A00,101432,Kiyonaga; Anastasia,19,0,25,6
1668064929440,COGS 260,B00,101433,Kirsh; David Joel,16,0,25,9
1668064929866,CSE 202,A00,102371,Impagliazzo; Russell,0,0,0,0
1668064930297,CSE 203B,A01,102373,Cheng; Chung Kuan,0,0,0,0
1668064930721,CSE 208,A00,102374,Micciancio; Daniele,0,0,0,0
1668064931147,CSE 209A,A00,112895,Impagliazzo; Russell,0,0,15,15
1668064931570,CSE 209B,A00,108005,Bellare; Mihir,0,0,0,0
1668064931994,CSE 210,A00,113163,Coblenz; Michael J,0,0,0,0
1668064932419,CSE 219,A00,106111,Dow; Steven P,0,0,20,20
1668064932843,CSE 221,A00,102376,Voelker; Geoffrey M.,0,0,0,0
1668064933269,CSE 224,A01,102378,Porter; George M,0,0,0,0
1668064933704,CSE 229A,A00,102379,Savage; Stefan,0,0,0,0
1668064934127,CSE 229C,A00,102380,Munyaka; Imani N. S.,0,0,0,0
1668064934557,CSE 232B,A00,102382,Deutsch; Alin Bernard,0,0,0,0
1668064934979,CSE 234,A01,112904,Kumar; Arun Kumar,0,0,0,0
1668064935403,CSE 237A,A00,102383,Rosing; Tajana Simunic,0,0,0,0
1668064935826,CSE 239A,A00,102384,Deutsch; Alin Bernard,0,0,0,0
1668064936252,CSE 239B,A00,102385,Polikarpova; Nadezhda,0,0,0,0
1668064936681,CSE 240A,A00,102386,Pannuto; Patrick William,0,0,0,0
1668064937109,CSE 240B,A00,102387,Zhao; Jishen,0,0,0,0
1668064937533,CSE 241A,A00,106406,Kang; Mingu,0,0,0,0
1668064937964,CSE 249B,A00,102388,Kahng; Andrew Byun,0,0,8,8
1668064938396,CSE 251B,A01,102392,Cottrell; Garrison W,0,0,0,0
1668064938396,CSE 251B,A02,102393,Cottrell; Garrison W,0,0,0,0
1668064938821,CSE 252B,A00,102394,Ochoa; Benjamin Lawrence,0,0,0,0
1668064939244,CSE 257,A01,102396,Gao; Sicun,0,0,0,0
1668064939668,CSE 272,A00,102397,Li; Tzumao,0,0,0,0
1668064940094,CSE 274,A00,111323,Chern; Albert Ren-Haur,0,0,0,0
1668064940518,CSE 282,A00,102398,Pevzner; Pavel Arkadjevich,0,0,0,0
1668064940950,CSE 284,A00,114175,Gymrek; Melissa Ann,0,0,0,0
1668064941381,CSE 290,A00,102399,Chandraker; Manmohan Krishna,0,0,0,0
1668064941381,CSE 290,B00,102400,Vaccaro; Kristen Marie,0,0,25,25
1668064941381,CSE 290,C00,102414,Pannuto; Patrick William,0,0,25,25
1668064941381,CSE 290,D00,102427,Pevzner; Pavel Arkadjevich,0,0,0,0
1668064941381,CSE 290,E00,102429,Zhao; Jishen,0,0,0,0
1668064941381,CSE 290,F00,102436,Tullsen; Dean Michael,0,0,0,0
1668064941381,CSE 290,G00,102440,Christensen; Henrik I,0,0,20,20
1668064941811,CSE 291,A00,102443,Su; Hao,0,0,0,0
1668064941811,CSE 291,B00,102448,Polikarpova; Nadezhda,0,0,0,0
1668064941811,CSE 291,C00,102453,Vaccaro; Kristen Marie,0,0,0,0
1668064941811,CSE 291,D00,111343,Savage; Stefan,0,0,0,0
1668064941811,CSE 291,E00,116474,Claffy; Kimberly Claire,0,0,0,0
1668064941811,CSE 291,F00,116479,Pasquale; Joseph,0,0,0,0
1668064942250,CSE 293,001,119111,Bafna; Vineet,9999,0,9999,0
1668064942250,CSE 293,002,119118,Bellare; Mihir,9999,0,9999,0
1668064942250,CSE 293,003,119122,Berg-Kirkpatrick; Taylor D,9999,0,9999,0
1668064942250,CSE 293,004,119135,Christensen; Henrik I,9999,0,9999,0
1668064942250,CSE 293,005,119142,Cottrell; Garrison W,9999,0,9999,0
1668064942250,CSE 293,006,119146,Deutsch; Alin Bernard,9999,0,9999,0
1668064942250,CSE 293,007,119159,Esmaeilzadeh; Hadi,9999,0,9999,0
1668064942250,CSE 293,008,119166,Freund; Yoav,9999,0,9999,0
1668064942250,CSE 293,009,119170,Griswold; William G.,9999,0,9999,0
1668064942250,CSE 293,010,119183,Gymrek; Melissa Ann,9999,0,9999,0
1668064942250,CSE 293,011,119190,Heninger; Nadia A,9999,0,9999,0
1668064942250,CSE 293,012,119230,Impagliazzo; Russell,9999,0,9999,0
1668064942250,CSE 293,013,119232,Jhala; Ranjit,9999,0,9999,0
1668064942250,CSE 293,014,119233,Kahng; Andrew Byun,9999,0,9999,0
1668064942250,CSE 293,015,119298,Kane; Daniel Mertz,9999,0,9999,0
1668064942250,CSE 293,016,119299,Kriegman; David J,9999,0,9999,0
1668064942250,CSE 293,017,119300,Kumar; Arun Kumar,9999,0,9999,0
1668064942250,CSE 293,018,119301,Lerner; Sorin,9999,0,9999,0
1668064942250,CSE 293,019,119302,Lovett; Shachar,9999,0,9999,0
1668064942250,CSE 293,020,119303,McAuley; Julian John,9999,0,9999,0
1668064942250,CSE 293,021,119304,Micciancio; Daniele,9999,0,9999,0
1668064942250,CSE 293,022,119367,Orailoglu; Alex,9999,0,9999,0
1668064942250,CSE 293,023,119382,Paturi; Ramamohan,9999,0,9999,0
1668064942250,CSE 293,024,119404,Polikarpova; Nadezhda,9999,0,9999,0
1668064942250,CSE 293,025,119406,Politz; Joseph Gibbs,9999,0,9999,0
1668064942250,CSE 293,026,119411,Porter; George M,9999,0,9999,0
1668064942250,CSE 293,027,119414,Porter; Leonard Emerson,9999,0,9999,0
1668064942250,CSE 293,028,119416,Ramamoorthi; Ravi,9999,0,9999,0
1668064942250,CSE 293,029,119417,Sahoo; Debashis,9999,0,9999,0
1668064942250,CSE 293,030,119420,Saul; Lawrence,9999,0,9999,0
1668064942250,CSE 293,031,119421,Savage; Stefan,9999,0,9999,0
1668064942250,CSE 293,032,119425,Schulze; Jurgen P.,9999,0,9999,0
1668064942250,CSE 293,033,119426,Snoeren; Alex C.,9999,0,9999,0
1668064942250,CSE 293,034,119428,Shang; Jingbo,9999,0,9999,0
1668064942250,CSE 293,035,119430,Stefan; Deian,9999,0,9999,0
1668064942250,CSE 293,036,119431,Su; Hao,9999,0,9999,0
1668064942250,CSE 293,037,119433,Swanson; Steven James,9999,0,9999,0
1668064942250,CSE 293,038,119435,Tullsen; Dean Michael,9999,0,9999,0
1668064942250,CSE 293,039,119483,Voelker; Geoffrey M.,9999,0,9999,0
1668064942250,CSE 293,040,119537,Zhao; Jishen,9999,0,9999,0
1668064942250,CSE 293,041,119538,Zhou; Yuan-Yuan,9999,0,9999,0
1668064942250,CSE 293,042,119539,Gao; Sicun,9999,0,9999,0
1668064942250,CSE 293,043,119540,Weibel; Nadir,9999,0,9999,0
1668064942250,CSE 293,044,119541,Gupta; Rajesh K.,9999,0,9999,0
1668064942250,CSE 293,045,126410,Vaccaro; Kristen Marie,9999,0,9999,0
1668064942250,CSE 293,046,126411,Klemke; Richard,9999,0,9999,0
1668064942675,CSE 294,A00,102459,Voelker; Geoffrey M.,0,0,0,0
1668064942675,CSE 294,B00,111322,Orailoglu; Alex,0,0,0,0
1668064943099,DSE 201,A00,096914,Deutsch; Alin Bernard,30,0,30,0
1668064943525,DSE 210,A00,096915,Dasgupta; Sanjoy,30,0,30,0
1668064943951,DSE 260A,A00,096916,Altintas De Callaf; Ilkay,30,0,30,0
1668064944402,ECE 200,001,103586,Antipa; Nicholas A,9999,0,9999,0
1668064944402,ECE 200,002,103587,Atanasov; Nikolay A.,9999,0,9999,0
1668064944402,ECE 200,003,103588,Bharadia; Dinesh,9999,0,9999,0
1668064944402,ECE 200,004,103589,Cheng; Chung Kuan,9999,0,9999,0
1668064944402,ECE 200,005,103590,Cosman; Pamela C.,9999,0,9999,0
1668064944402,ECE 200,006,103591,Dayeh; Shadi Ahmad,9999,0,9999,0
1668064944402,ECE 200,007,103592,Fainman; Yeshaiahu,9999,0,9999,0
1668064944402,ECE 200,008,103593,Ford; Joseph Earl,9999,0,9999,0
1668064944402,ECE 200,009,103594,Franceschetti; Massimo,9999,0,9999,0
1668064944402,ECE 200,010,103595,Fullerton; Eric E,9999,0,9999,0
1668064944402,ECE 200,011,103596,Galton; Ian A,9999,0,9999,0
1668064944402,ECE 200,012,103597,Gilja; Vikash,9999,0,9999,0
1668064944402,ECE 200,013,103598,Hall; Drew A.,9999,0,9999,0
1668064944402,ECE 200,014,103599,Hsueh; Tzu-Chien,9999,0,9999,0
1668064944402,ECE 200,015,103600,Javidi; Tara,9999,0,9999,0
1668064944402,ECE 200,016,103601,Kahng; Andrew Byun,9999,0,9999,0
1668064944402,ECE 200,017,103602,Kim; Young-Han,9999,0,9999,0
1668064944402,ECE 200,018,103603,Koushanfar; Farinaz,9999,0,9999,0
1668064944402,ECE 200,019,103604,Kuzum; Duygu,9999,0,9999,0
1668064944402,ECE 200,020,103605,Le; Hanh-Phuc,9999,0,9999,0
1668064944402,ECE 200,021,103606,Lin; Bill,9999,0,9999,0
1668064944402,ECE 200,022,103607,Liu; Zhaowei,9998,0,9999,1
1668064944402,ECE 200,023,103608,Lo; Yu-Hwa,9999,0,9999,0
1668064944402,ECE 200,024,103609,Lomakin; Vitaliy,9999,0,9999,0
1668064944402,ECE 200,025,103610,Mercier; Patrick Philip,9999,0,9999,0
1668064944402,ECE 200,026,103611,Meyer; Florian,9999,0,9999,0
1668064944402,ECE 200,027,103612,Milstein; Laurence B.,9999,0,9999,0
1668064944402,ECE 200,028,103613,Mir Arabbaygi; Siavash,9999,0,9999,0
1668064944402,ECE 200,029,103614,Mookherjea; Shayan,9999,0,9999,0
1668064944402,ECE 200,030,103615,Morris; Karcher William,9999,0,9999,0
1668064944402,ECE 200,031,103616,Ng; Tse Nga,9999,0,9999,0
1668064944402,ECE 200,032,103617,Nguyen; Truong Quang,9999,0,9999,0
1668064944402,ECE 200,033,103618,Nomura; Kenji,9999,0,9999,0
1668064944402,ECE 200,034,103619,Orlitsky; Alon,9999,0,9999,0
1668064944402,ECE 200,035,103620,Pal; Piya,9999,0,9999,0
1668064944402,ECE 200,036,103621,Papen; George C.,9999,0,9999,0
1668064944402,ECE 200,037,103622,Radic; Stojan,9999,0,9999,0
1668064944402,ECE 200,038,103623,Rao; Bhaskar D.,9999,0,9999,0
1668064944402,ECE 200,039,103624,Rao; Ramesh R,9999,0,9999,0
1668064944402,ECE 200,040,103625,Rebeiz; Gabriel,9999,0,9999,0
1668064944402,ECE 200,041,103626,Sanford; John R,9999,0,9999,0
1668064944402,ECE 200,042,103627,Siegel; Paul H.,9999,0,9999,0
1668064944402,ECE 200,043,103628,Sievenpiper; Daniel F.,9999,0,9999,0
1668064944402,ECE 200,044,103629,Sworder; David D.,9999,0,9999,0
1668064944402,ECE 200,045,103630,Taur; Yuan,9999,0,9999,0
1668064944402,ECE 200,046,103631,Touri; Behrouz,9999,0,9999,0
1668064944402,ECE 200,047,103632,Trivedi; Mohan M.,9999,0,9999,0
1668064944402,ECE 200,048,103633,Vasconcelos; Nuno,9999,0,9999,0
1668064944402,ECE 200,049,103634,Wang; Xiaolong,9999,0,9999,0
1668064944402,ECE 200,050,103635,Xie; Pengtao,9999,0,9999,0
1668064944402,ECE 200,051,103636,Yip; Michael,9999,0,9999,0
1668064944402,ECE 200,052,103637,Zeger; Kenneth A.,999,0,999,0
1668064944402,ECE 200,053,103638,Zhang; Xinyu,9999,0,9999,0
1668064944402,ECE 200,054,103639,Turakhia; Yatish Girish,9999,0,9999,0
1668064944402,ECE 200,055,103640,Kang; Mingu,9999,0,9999,0
1668064944402,ECE 200,056,103641,Shi; Yuanyuan,9999,0,9999,0
1668064944402,ECE 200,057,103642,Wang; Edward Jay,9999,0,9999,0
1668064944402,ECE 200,058,103643,Zheng; Yang,9999,0,9999,0
1668064944838,ECE 202,A00,103644,Kuzum; Duygu,0,0,0,0
1668064945266,ECE 212BN,A00,103646,Ng; Tse Nga,0,0,0,0
1668064945702,ECE 221,A00,111493,Staff,0,0,0,0
1668064946138,ECE 222B,A00,103647,Lomakin; Vitaliy,0,0,0,0
1668064946566,ECE 230B,A00,103648,Taur; Yuan,0,0,0,0
1668064947000,ECE 238B,A00,103649,Garay; Javier,0,0,0,0
1668064947432,ECE 240B,A00,112900,Fainman; Yeshaiahu,0,0,0,0
1668064947859,ECE 247A,A00,103650,Jokerst; Jesse Vincent,0,0,0,0
1668064948297,ECE 247B,A00,103651,Wang; Joseph,0,0,0,0
1668064948747,ECE 250,A00,103652,Siegel; Paul H.,0,0,0,0
1668064949180,ECE 251A,A00,103654,Rao; Bhaskar D.,0,0,0,0
1668064949605,ECE 257B,A00,103655,Bharadia; Dinesh,0,0,0,0
1668064950029,ECE 258A,A00,103656,Milstein; Laurence B.,0,0,0,0
1668064950470,ECE 260B,A00,103658,Kang; Mingu,0,0,0,0
1668064950892,ECE 264A,A00,103659,Galton; Ian A,0,0,0,0
1668064951318,ECE 265A,A00,103661,Gudem; Prasad S.S.,0,0,0,0
1668064951745,ECE 265D,A00,103662,Gudem; Prasad S.S.,0,0,0,0
1668064952167,ECE 268,A00,103663,Koushanfar; Farinaz,0,0,0,0
1668064952607,ECE 269,A01,103665,Pal; Piya,0,0,0,0
1668064953038,ECE 271B,A00,103666,Vasconcelos; Manuela,0,0,0,0
1668064953467,ECE 276A,A00,103667,Atanasov; Nikolay A.,0,0,0,0
1668064953917,ECE 277,A00,103668,An; Cheolhong,0,0,0,0
1668064954343,ECE 279,A00,117947,Hall; Drew A.,0,0,0,0
1668064955200,ECE 283,A00,103670,Hsueh; Tzu-Chien,0,0,0,0
1668064955624,ECE 284,A00,103671,Turakhia; Yatish Girish,0,0,0,0
1668064956048,ECE 285,A00,103672,Zheng; Yang,0,0,0,0
1668064956048,ECE 285,B00,103673,Sworder; David D.,0,0,0,0
1668064956480,ECE 287,A00,103676,Javidi; Tara,0,0,0,0
1668064956910,MATH 200B,A00,098023,Salehi Golsefidy; Alireza,13,0,15,2
1668064957344,MATH 202B,A00,098024,Rhoades; Brendon Patrick,9,0,15,6
1668064957780,MATH 203B,A00,098025,Oprea; Dragos N.,11,0,15,4
1668064958204,MATH 204B,A00,098026,Sorensen; Claus M,13,0,15,2
1668064958647,MATH 208,A00,098027,Izadi; Elham,7,0,10,3
1668064959072,MATH 209,A00,098028,Pollack; Aaron,10,0,10,0
1668064959507,MATH 211A,A00,112919,Rogalski; Daniel,9,0,10,1
1668064959943,MATH 211B,A00,112920,Seward; Brandon M.,9,0,10,1
1668064960367,MATH 218,A00,098029,Li; Bo,10,0,10,0
1668064960796,MATH 220B,A00,098030,Novak; Jonathan I,13,0,15,2
1668064961230,MATH 221A,A00,098031,Ebenfelt; Peter F,13,0,15,2
1668064961655,MATH 231B,A00,098032,Zlatos; Andrej,12,0,15,3
1668064962081,MATH 240B,A00,098033,Ni; Lei,9,0,15,6
1668064962503,MATH 243,A00,098034,Jekel; David Andrew,10,0,10,0
1668064962927,MATH 245A,A00,098035,Nie; Jiawang,0,0,15,16
1668064963350,MATH 248,A00,098036,Bejenaru; Ioan,10,0,10,0
1668064963778,MATH 250B,A00,098037,Spolaor; Luca,14,0,15,1
1668064964208,MATH 258,A00,098038,Ni; Lei,10,0,10,0
1668064964645,MATH 264B,A00,098041,Rhoades; Brendon Patrick,10,0,15,5
1668064965067,MATH 268,A00,098042,Buss; Samuel R,10,0,10,0
1668064965497,MATH 269,A00,098043,Rhoades; Brendon Patrick,10,0,10,0
1668064965920,MATH 270B,A00,098044,Li; Bo,11,0,15,4
1668064966351,MATH 272B,A00,098045,Holst; Michael J,13,0,15,2
1668064966781,MATH 273A,A00,098046,Tian; Xiaochuan,10,0,15,5
1668064967304,MATH 275,A01,098048,Tian; Xiaochuan,6,0,10,4
1668064967747,MATH 278A,A00,098049,Holst; Michael J,8,0,10,2
1668064968180,MATH 278B,A00,098050,Cloninger; Alexander,10,0,10,0
1668064968607,MATH 278C,A00,098051,Nie; Jiawang,7,0,10,3
1668064969032,MATH 280B,A00,098052,Zheng; Tianyi,10,0,15,5
1668064969455,MATH 281B,A00,098053,Bradic; Jelena,3,0,15,12
1668064969885,MATH 282B,A00,098054,Arias-Castro; Ery,0,0,15,15
1668064970312,MATH 285,A00,098055,Fitzsimmons; Patrick J,0,0,15,17
1668064970738,MATH 287B,A00,098056,Arias-Castro; Ery,3,0,15,12
1668064971180,MATH 288,A00,098057,Agarwal; Pooja,9,0,10,1
1668064971180,MATH 288,B00,098058,Zhang; Danna,8,0,10,2
1668064971180,MATH 288,C00,098059,Williams; Ruth J,10,0,10,0
1668064971625,MATH 290B,A00,098060,Roberts; Justin Deritter,13,0,15,2
1668064972047,MATH 292,A00,098061,Belmont; Eva Kinoshita,10,0,10,0
1668064972474,MATH 295,A00,098062,Suk; Andrew Hoon,48,0,50,2
1668064972906,MATH 296,A00,098063,Novak; Jonathan I,20,0,20,0
1668064973349,MATH 297,001,098064,Gamst; Anthony Collins,9997,0,9999,2
1668065474664,COGS 205,A00,101395,Chiba; Andrea,19,0,20,1
1668065475091,COGS 210B,001,101404,Greene; Deanna Jacquelyn,9998,0,9999,1
1668065475091,COGS 210B,002,101417,Xia; Haijun,9999,0,9999,0
1668065475091,COGS 210B,003,101422,Nitz; Douglas A.,9999,0,9999,0
1668065475091,COGS 210B,004,101423,Hollan; James D.,9998,0,9999,1
1668065475091,COGS 210B,005,101424,Deak; Gedeon O.,9998,0,9999,1
1668065475091,COGS 210B,006,101425,Rossano; Federico,9999,0,9999,0
1668065475514,COGS 211B,A00,101427,Coulson; Seana M,9996,0,9999,3
1668065475937,COGS 220,A00,101428,Hollan; James D.,0,0,25,25
1668065476361,COGS 229,A00,101429,Dow; Steven P,18,0,25,7
1668065476787,COGS 230,A00,101430,Klemmer; Scott R,13,0,17,4
1668065477211,COGS 234,A00,101431,Xia; Haijun,3,0,25,22
1668065477635,COGS 260,A00,101432,Kiyonaga; Anastasia,19,0,25,6
1668065477635,COGS 260,B00,101433,Kirsh; David Joel,16,0,25,9
1668065478070,CSE 202,A00,102371,Impagliazzo; Russell,0,0,0,0
1668065478497,CSE 203B,A01,102373,Cheng; Chung Kuan,0,0,0,0
1668065478935,CSE 208,A00,102374,Micciancio; Daniele,0,0,0,0
1668065479365,CSE 209A,A00,112895,Impagliazzo; Russell,0,0,15,15
1668065479796,CSE 209B,A00,108005,Bellare; Mihir,0,0,0,0
1668065480218,CSE 210,A00,113163,Coblenz; Michael J,0,0,0,0
1668065480652,CSE 219,A00,106111,Dow; Steven P,0,0,20,20
1668065481076,CSE 221,A00,102376,Voelker; Geoffrey M.,0,0,0,0
1668065481503,CSE 224,A01,102378,Porter; George M,0,0,0,0
1668065481929,CSE 229A,A00,102379,Savage; Stefan,0,0,0,0
1668065482356,CSE 229C,A00,102380,Munyaka; Imani N. S.,0,0,0,0
1668065482782,CSE 232B,A00,102382,Deutsch; Alin Bernard,0,0,0,0
1668065483208,CSE 234,A01,112904,Kumar; Arun Kumar,0,0,0,0
1668065483649,CSE 237A,A00,102383,Rosing; Tajana Simunic,0,0,0,0
1668065484071,CSE 239A,A00,102384,Deutsch; Alin Bernard,0,0,0,0
1668065484492,CSE 239B,A00,102385,Polikarpova; Nadezhda,0,0,0,0
1668065484921,CSE 240A,A00,102386,Pannuto; Patrick William,0,0,0,0
1668065485348,CSE 240B,A00,102387,Zhao; Jishen,0,0,0,0
1668065485773,CSE 241A,A00,106406,Kang; Mingu,0,0,0,0
1668065486199,CSE 249B,A00,102388,Kahng; Andrew Byun,0,0,8,8
1668065486626,CSE 251B,A01,102392,Cottrell; Garrison W,0,0,0,0
1668065486626,CSE 251B,A02,102393,Cottrell; Garrison W,0,0,0,0
1668065487050,CSE 252B,A00,102394,Ochoa; Benjamin Lawrence,0,0,0,0
1668065487486,CSE 257,A01,102396,Gao; Sicun,0,0,0,0
1668065487918,CSE 272,A00,102397,Li; Tzumao,0,0,0,0
1668065488346,CSE 274,A00,111323,Chern; Albert Ren-Haur,0,0,0,0
1668065488873,CSE 282,A00,102398,Pevzner; Pavel Arkadjevich,0,0,0,0
1668065489309,CSE 284,A00,114175,Gymrek; Melissa Ann,0,0,0,0
1668065489737,CSE 290,A00,102399,Chandraker; Manmohan Krishna,0,0,0,0
1668065489737,CSE 290,B00,102400,Vaccaro; Kristen Marie,0,0,25,25
1668065489737,CSE 290,C00,102414,Pannuto; Patrick William,0,0,25,25
1668065489737,CSE 290,D00,102427,Pevzner; Pavel Arkadjevich,0,0,0,0
1668065489737,CSE 290,E00,102429,Zhao; Jishen,0,0,0,0
1668065489737,CSE 290,F00,102436,Tullsen; Dean Michael,0,0,0,0
1668065489737,CSE 290,G00,102440,Christensen; Henrik I,0,0,20,20
1668065490162,CSE 291,A00,102443,Su; Hao,0,0,0,0
1668065490162,CSE 291,B00,102448,Polikarpova; Nadezhda,0,0,0,0
1668065490162,CSE 291,C00,102453,Vaccaro; Kristen Marie,0,0,0,0
1668065490162,CSE 291,D00,111343,Savage; Stefan,0,0,0,0
1668065490162,CSE 291,E00,116474,Claffy; Kimberly Claire,0,0,0,0
1668065490162,CSE 291,F00,116479,Pasquale; Joseph,0,0,0,0
1668065490600,CSE 293,001,119111,Bafna; Vineet,9999,0,9999,0
1668065490600,CSE 293,002,119118,Bellare; Mihir,9999,0,9999,0
1668065490600,CSE 293,003,119122,Berg-Kirkpatrick; Taylor D,9999,0,9999,0
1668065490600,CSE 293,004,119135,Christensen; Henrik I,9999,0,9999,0
1668065490600,CSE 293,005,119142,Cottrell; Garrison W,9999,0,9999,0
1668065490600,CSE 293,006,119146,Deutsch; Alin Bernard,9999,0,9999,0
1668065490600,CSE 293,007,119159,Esmaeilzadeh; Hadi,9999,0,9999,0
1668065490600,CSE 293,008,119166,Freund; Yoav,9999,0,9999,0
1668065490600,CSE 293,009,119170,Griswold; William G.,9999,0,9999,0
1668065490600,CSE 293,010,119183,Gymrek; Melissa Ann,9999,0,9999,0
1668065490600,CSE 293,011,119190,Heninger; Nadia A,9999,0,9999,0
1668065490600,CSE 293,012,119230,Impagliazzo; Russell,9999,0,9999,0
1668065490600,CSE 293,013,119232,Jhala; Ranjit,9999,0,9999,0
1668065490600,CSE 293,014,119233,Kahng; Andrew Byun,9999,0,9999,0
1668065490600,CSE 293,015,119298,Kane; Daniel Mertz,9999,0,9999,0
1668065490600,CSE 293,016,119299,Kriegman; David J,9999,0,9999,0
1668065490600,CSE 293,017,119300,Kumar; Arun Kumar,9999,0,9999,0
1668065490600,CSE 293,018,119301,Lerner; Sorin,9999,0,9999,0
1668065490600,CSE 293,019,119302,Lovett; Shachar,9999,0,9999,0
1668065490600,CSE 293,020,119303,McAuley; Julian John,9999,0,9999,0
1668065490600,CSE 293,021,119304,Micciancio; Daniele,9999,0,9999,0
1668065490600,CSE 293,022,119367,Orailoglu; Alex,9999,0,9999,0
1668065490600,CSE 293,023,119382,Paturi; Ramamohan,9999,0,9999,0
1668065490600,CSE 293,024,119404,Polikarpova; Nadezhda,9999,0,9999,0
1668065490600,CSE 293,025,119406,Politz; Joseph Gibbs,9999,0,9999,0
1668065490600,CSE 293,026,119411,Porter; George M,9999,0,9999,0
1668065490600,CSE 293,027,119414,Porter; Leonard Emerson,9999,0,9999,0
1668065490600,CSE 293,028,119416,Ramamoorthi; Ravi,9999,0,9999,0
1668065490600,CSE 293,029,119417,Sahoo; Debashis,9999,0,9999,0
1668065490600,CSE 293,030,119420,Saul; Lawrence,9999,0,9999,0
1668065490600,CSE 293,031,119421,Savage; Stefan,9999,0,9999,0
1668065490600,CSE 293,032,119425,Schulze; Jurgen P.,9999,0,9999,0
1668065490600,CSE 293,033,119426,Snoeren; Alex C.,9999,0,9999,0
1668065490600,CSE 293,034,119428,Shang; Jingbo,9999,0,9999,0
1668065490600,CSE 293,035,119430,Stefan; Deian,9999,0,9999,0
1668065490600,CSE 293,036,119431,Su; Hao,9999,0,9999,0
1668065490600,CSE 293,037,119433,Swanson; Steven James,9999,0,9999,0
1668065490600,CSE 293,038,119435,Tullsen; Dean Michael,9999,0,9999,0
1668065490600,CSE 293,039,119483,Voelker; Geoffrey M.,9999,0,9999,0
1668065490600,CSE 293,040,119537,Zhao; Jishen,9999,0,9999,0
1668065490600,CSE 293,041,119538,Zhou; Yuan-Yuan,9999,0,9999,0
1668065490600,CSE 293,042,119539,Gao; Sicun,9999,0,9999,0
1668065490600,CSE 293,043,119540,Weibel; Nadir,9999,0,9999,0
1668065490600,CSE 293,044,119541,Gupta; Rajesh K.,9999,0,9999,0
1668065490600,CSE 293,045,126410,Vaccaro; Kristen Marie,9999,0,9999,0
1668065490600,CSE 293,046,126411,Klemke; Richard,9999,0,9999,0
1668065491032,CSE 294,A00,102459,Voelker; Geoffrey M.,0,0,0,0
1668065491032,CSE 294,B00,111322,Orailoglu; Alex,0,0,0,0
1668065491457,DSE 201,A00,096914,Deutsch; Alin Bernard,30,0,30,0
1668065491881,DSE 210,A00,096915,Dasgupta; Sanjoy,30,0,30,0
1668065492304,DSE 260A,A00,096916,Altintas De Callaf; Ilkay,30,0,30,0
1668065492732,ECE 200,001,103586,Antipa; Nicholas A,9999,0,9999,0
1668065492732,ECE 200,002,103587,Atanasov; Nikolay A.,9999,0,9999,0
1668065492732,ECE 200,003,103588,Bharadia; Dinesh,9999,0,9999,0
1668065492732,ECE 200,004,103589,Cheng; Chung Kuan,9999,0,9999,0
1668065492732,ECE 200,005,103590,Cosman; Pamela C.,9999,0,9999,0
1668065492732,ECE 200,006,103591,Dayeh; Shadi Ahmad,9999,0,9999,0
1668065492732,ECE 200,007,103592,Fainman; Yeshaiahu,9999,0,9999,0
1668065492732,ECE 200,008,103593,Ford; Joseph Earl,9999,0,9999,0
1668065492732,ECE 200,009,103594,Franceschetti; Massimo,9999,0,9999,0
1668065492732,ECE 200,010,103595,Fullerton; Eric E,9999,0,9999,0
1668065492732,ECE 200,011,103596,Galton; Ian A,9999,0,9999,0
1668065492732,ECE 200,012,103597,Gilja; Vikash,9999,0,9999,0
1668065492732,ECE 200,013,103598,Hall; Drew A.,9999,0,9999,0
1668065492732,ECE 200,014,103599,Hsueh; Tzu-Chien,9999,0,9999,0
1668065492732,ECE 200,015,103600,Javidi; Tara,9999,0,9999,0
1668065492732,ECE 200,016,103601,Kahng; Andrew Byun,9999,0,9999,0
1668065492732,ECE 200,017,103602,Kim; Young-Han,9999,0,9999,0
1668065492732,ECE 200,018,103603,Koushanfar; Farinaz,9999,0,9999,0
1668065492732,ECE 200,019,103604,Kuzum; Duygu,9999,0,9999,0
1668065492732,ECE 200,020,103605,Le; Hanh-Phuc,9999,0,9999,0
1668065492732,ECE 200,021,103606,Lin; Bill,9999,0,9999,0
1668065492732,ECE 200,022,103607,Liu; Zhaowei,9998,0,9999,1
1668065492732,ECE 200,023,103608,Lo; Yu-Hwa,9999,0,9999,0
1668065492732,ECE 200,024,103609,Lomakin; Vitaliy,9999,0,9999,0
1668065492732,ECE 200,025,103610,Mercier; Patrick Philip,9999,0,9999,0
1668065492732,ECE 200,026,103611,Meyer; Florian,9999,0,9999,0
1668065492732,ECE 200,027,103612,Milstein; Laurence B.,9999,0,9999,0
1668065492732,ECE 200,028,103613,Mir Arabbaygi; Siavash,9999,0,9999,0
1668065492732,ECE 200,029,103614,Mookherjea; Shayan,9999,0,9999,0
1668065492732,ECE 200,030,103615,Morris; Karcher William,9999,0,9999,0
1668065492732,ECE 200,031,103616,Ng; Tse Nga,9999,0,9999,0
1668065492732,ECE 200,032,103617,Nguyen; Truong Quang,9999,0,9999,0
1668065492732,ECE 200,033,103618,Nomura; Kenji,9999,0,9999,0
1668065492732,ECE 200,034,103619,Orlitsky; Alon,9999,0,9999,0
1668065492732,ECE 200,035,103620,Pal; Piya,9999,0,9999,0
1668065492732,ECE 200,036,103621,Papen; George C.,9999,0,9999,0
1668065492732,ECE 200,037,103622,Radic; Stojan,9999,0,9999,0
1668065492732,ECE 200,038,103623,Rao; Bhaskar D.,9999,0,9999,0
1668065492732,ECE 200,039,103624,Rao; Ramesh R,9999,0,9999,0
1668065492732,ECE 200,040,103625,Rebeiz; Gabriel,9999,0,9999,0
1668065492732,ECE 200,041,103626,Sanford; John R,9999,0,9999,0
1668065492732,ECE 200,042,103627,Siegel; Paul H.,9999,0,9999,0
1668065492732,ECE 200,043,103628,Sievenpiper; Daniel F.,9999,0,9999,0
1668065492732,ECE 200,044,103629,Sworder; David D.,9999,0,9999,0
1668065492732,ECE 200,045,103630,Taur; Yuan,9999,0,9999,0
1668065492732,ECE 200,046,103631,Touri; Behrouz,9999,0,9999,0
1668065492732,ECE 200,047,103632,Trivedi; Mohan M.,9999,0,9999,0
1668065492732,ECE 200,048,103633,Vasconcelos; Nuno,9999,0,9999,0
1668065492732,ECE 200,049,103634,Wang; Xiaolong,9999,0,9999,0
1668065492732,ECE 200,050,103635,Xie; Pengtao,9999,0,9999,0
1668065492732,ECE 200,051,103636,Yip; Michael,9999,0,9999,0
1668065492732,ECE 200,052,103637,Zeger; Kenneth A.,999,0,999,0
1668065492732,ECE 200,053,103638,Zhang; Xinyu,9999,0,9999,0
1668065492732,ECE 200,054,103639,Turakhia; Yatish Girish,9999,0,9999,0
1668065492732,ECE 200,055,103640,Kang; Mingu,9999,0,9999,0
1668065492732,ECE 200,056,103641,Shi; Yuanyuan,9999,0,9999,0
1668065492732,ECE 200,057,103642,Wang; Edward Jay,9999,0,9999,0
1668065492732,ECE 200,058,103643,Zheng; Yang,9999,0,9999,0
1668065493154,ECE 202,A00,103644,Kuzum; Duygu,0,0,0,0
1668065493588,ECE 212BN,A00,103646,Ng; Tse Nga,0,0,0,0
1668065494017,ECE 221,A00,111493,Staff,0,0,0,0
1668065494440,ECE 222B,A00,103647,Lomakin; Vitaliy,0,0,0,0
1668065494864,ECE 230B,A00,103648,Taur; Yuan,0,0,0,0
1668065495287,ECE 238B,A00,103649,Garay; Javier,0,0,0,0
1668065495730,ECE 240B,A00,112900,Fainman; Yeshaiahu,0,0,0,0
1668065496153,ECE 247A,A00,103650,Jokerst; Jesse Vincent,0,0,0,0
1668065496576,ECE 247B,A00,103651,Wang; Joseph,0,0,0,0
1668065496999,ECE 250,A00,103652,Siegel; Paul H.,0,0,0,0
1668065497426,ECE 251A,A00,103654,Rao; Bhaskar D.,0,0,0,0
1668065497850,ECE 257B,A00,103655,Bharadia; Dinesh,0,0,0,0
1668065498278,ECE 258A,A00,103656,Milstein; Laurence B.,0,0,0,0
1668065498707,ECE 260B,A00,103658,Kang; Mingu,0,0,0,0
1668065499131,ECE 264A,A00,103659,Galton; Ian A,0,0,0,0
1668065499556,ECE 265A,A00,103661,Gudem; Prasad S.S.,0,0,0,0
1668065499996,ECE 265D,A00,103662,Gudem; Prasad S.S.,0,0,0,0
1668065500421,ECE 268,A00,103663,Koushanfar; Farinaz,0,0,0,0
1668065500848,ECE 269,A01,103665,Pal; Piya,0,0,0,0
1668065501276,ECE 271B,A00,103666,Vasconcelos; Manuela,0,0,0,0
1668065501705,ECE 276A,A00,103667,Atanasov; Nikolay A.,0,0,0,0
1668065502131,ECE 277,A00,103668,An; Cheolhong,0,0,0,0
1668065502553,ECE 279,A00,117947,Hall; Drew A.,0,0,0,0
1668065503423,ECE 283,A00,103670,Hsueh; Tzu-Chien,0,0,0,0
1668065503850,ECE 284,A00,103671,Turakhia; Yatish Girish,0,0,0,0
1668065504279,ECE 285,A00,103672,Zheng; Yang,0,0,0,0
1668065504279,ECE 285,B00,103673,Sworder; David D.,0,0,0,0
1668065504703,ECE 287,A00,103676,Javidi; Tara,0,0,0,0
1668065505130,MATH 200B,A00,098023,Salehi Golsefidy; Alireza,13,0,15,2
1668065505564,MATH 202B,A00,098024,Rhoades; Brendon Patrick,9,0,15,6
1668065506000,MATH 203B,A00,098025,Oprea; Dragos N.,11,0,15,4
1668065506422,MATH 204B,A00,098026,Sorensen; Claus M,13,0,15,2
1668065506844,MATH 208,A00,098027,Izadi; Elham,7,0,10,3
1668065507268,MATH 209,A00,098028,Pollack; Aaron,10,0,10,0
1668065507702,MATH 211A,A00,112919,Rogalski; Daniel,9,0,10,1
1668065508132,MATH 211B,A00,112920,Seward; Brandon M.,9,0,10,1
1668065508569,MATH 218,A00,098029,Li; Bo,10,0,10,0
1668065508993,MATH 220B,A00,098030,Novak; Jonathan I,13,0,15,2
1668065509416,MATH 221A,A00,098031,Ebenfelt; Peter F,13,0,15,2
1668065509845,MATH 231B,A00,098032,Zlatos; Andrej,12,0,15,3
1668065510272,MATH 240B,A00,098033,Ni; Lei,9,0,15,6
1668065510697,MATH 243,A00,098034,Jekel; David Andrew,10,0,10,0
1668065511119,MATH 245A,A00,098035,Nie; Jiawang,0,0,15,16
1668065511544,MATH 248,A00,098036,Bejenaru; Ioan,10,0,10,0
1668065511968,MATH 250B,A00,098037,Spolaor; Luca,14,0,15,1
1668065512391,MATH 258,A00,098038,Ni; Lei,10,0,10,0
1668065512819,MATH 264B,A00,098041,Rhoades; Brendon Patrick,10,0,15,5
1668065513241,MATH 268,A00,098042,Buss; Samuel R,10,0,10,0
1668065513679,MATH 269,A00,098043,Rhoades; Brendon Patrick,10,0,10,0
1668065514106,MATH 270B,A00,098044,Li; Bo,11,0,15,4
1668065514539,MATH 272B,A00,098045,Holst; Michael J,13,0,15,2
1668065514962,MATH 273A,A00,098046,Tian; Xiaochuan,10,0,15,5
1668065515391,MATH 275,A01,098048,Tian; Xiaochuan,6,0,10,4
1668065515825,MATH 278A,A00,098049,Holst; Michael J,8,0,10,2
1668065516252,MATH 278B,A00,098050,Cloninger; Alexander,10,0,10,0
1668065516681,MATH 278C,A00,098051,Nie; Jiawang,7,0,10,3
1668065517106,MATH 280B,A00,098052,Zheng; Tianyi,10,0,15,5
1668065517529,MATH 281B,A00,098053,Bradic; Jelena,3,0,15,12
1668065517964,MATH 282B,A00,098054,Arias-Castro; Ery,0,0,15,15
1668065518387,MATH 285,A00,098055,Fitzsimmons; Patrick J,0,0,15,17
1668065518817,MATH 287B,A00,098056,Arias-Castro; Ery,3,0,15,12
1668065519242,MATH 288,A00,098057,Agarwal; Pooja,9,0,10,1
1668065519242,MATH 288,B00,098058,Zhang; Danna,8,0,10,2
1668065519242,MATH 288,C00,098059,Williams; Ruth J,10,0,10,0
1668065519678,MATH 290B,A00,098060,Roberts; Justin Deritter,13,0,15,2
1668065520102,MATH 292,A00,098061,Belmont; Eva Kinoshita,10,0,10,0
1668065520536,MATH 295,A00,098062,Suk; Andrew Hoon,48,0,50,2
1668065520963,MATH 296,A00,098063,Novak; Jonathan I,20,0,20,0
1668065521390,MATH 297,001,098064,Gamst; Anthony Collins,9997,0,9999,2
1668066023115,COGS 205,A00,101395,Chiba; Andrea,19,0,20,1
1668066023540,COGS 210B,001,101404,Greene; Deanna Jacquelyn,9998,0,9999,1
1668066023540,COGS 210B,002,101417,Xia; Haijun,9999,0,9999,0
1668066023540,COGS 210B,003,101422,Nitz; Douglas A.,9999,0,9999,0
1668066023540,COGS 210B,004,101423,Hollan; James D.,9998,0,9999,1
1668066023540,COGS 210B,005,101424,Deak; Gedeon O.,9998,0,9999,1
1668066023540,COGS 210B,006,101425,Rossano; Federico,9999,0,9999,0
1668066023967,COGS 211B,A00,101427,Coulson; Seana M,9996,0,9999,3
1668066024391,COGS 220,A00,101428,Hollan; James D.,0,0,25,25
1668066024819,COGS 229,A00,101429,Dow; Steven P,18,0,25,7
1668066025241,COGS 230,A00,101430,Klemmer; Scott R,13,0,17,4
1668066025663,COGS 234,A00,101431,Xia; Haijun,3,0,25,22
1668066026093,COGS 260,A00,101432,Kiyonaga; Anastasia,19,0,25,6
1668066026093,COGS 260,B00,101433,Kirsh; David Joel,16,0,25,9
1668066026516,CSE 202,A00,102371,Impagliazzo; Russell,0,0,0,0
1668066026944,CSE 203B,A01,102373,Cheng; Chung Kuan,0,0,0,0
1668066027376,CSE 208,A00,102374,Micciancio; Daniele,0,0,0,0
1668066027801,CSE 209A,A00,112895,Impagliazzo; Russell,0,0,15,15
1668066028228,CSE 209B,A00,108005,Bellare; Mihir,0,0,0,0
1668066028657,CSE 210,A00,113163,Coblenz; Michael J,0,0,0,0
1668066029084,CSE 219,A00,106111,Dow; Steven P,0,0,20,20
1668066029510,CSE 221,A00,102376,Voelker; Geoffrey M.,0,0,0,0
1668066029933,CSE 224,A01,102378,Porter; George M,0,0,0,0
1668066030358,CSE 229A,A00,102379,Savage; Stefan,0,0,0,0
1668066030785,CSE 229C,A00,102380,Munyaka; Imani N. S.,0,0,0,0
1668066031211,CSE 232B,A00,102382,Deutsch; Alin Bernard,0,0,0,0
1668066031657,CSE 234,A01,112904,Kumar; Arun Kumar,0,0,0,0
1668066032090,CSE 237A,A00,102383,Rosing; Tajana Simunic,0,0,0,0
1668066032526,CSE 239A,A00,102384,Deutsch; Alin Bernard,0,0,0,0
1668066032964,CSE 239B,A00,102385,Polikarpova; Nadezhda,0,0,0,0
1668066033392,CSE 240A,A00,102386,Pannuto; Patrick William,0,0,0,0
1668066033816,CSE 240B,A00,102387,Zhao; Jishen,0,0,0,0
1668066034240,CSE 241A,A00,106406,Kang; Mingu,0,0,0,0
1668066034664,CSE 249B,A00,102388,Kahng; Andrew Byun,0,0,8,8
1668066035093,CSE 251B,A01,102392,Cottrell; Garrison W,0,0,0,0
1668066035093,CSE 251B,A02,102393,Cottrell; Garrison W,0,0,0,0
1668066035519,CSE 252B,A00,102394,Ochoa; Benjamin Lawrence,0,0,0,0
1668066035947,CSE 257,A01,102396,Gao; Sicun,0,0,0,0
1668066036370,CSE 272,A00,102397,Li; Tzumao,0,0,0,0
1668066036794,CSE 274,A00,111323,Chern; Albert Ren-Haur,0,0,0,0
1668066037221,CSE 282,A00,102398,Pevzner; Pavel Arkadjevich,0,0,0,0
1668066037647,CSE 284,A00,114175,Gymrek; Melissa Ann,0,0,0,0
1668066038074,CSE 290,A00,102399,Chandraker; Manmohan Krishna,0,0,0,0
1668066038074,CSE 290,B00,102400,Vaccaro; Kristen Marie,0,0,25,25
1668066038074,CSE 290,C00,102414,Pannuto; Patrick William,0,0,25,25
1668066038074,CSE 290,D00,102427,Pevzner; Pavel Arkadjevich,0,0,0,0
1668066038074,CSE 290,E00,102429,Zhao; Jishen,0,0,0,0
1668066038074,CSE 290,F00,102436,Tullsen; Dean Michael,0,0,0,0
1668066038074,CSE 290,G00,102440,Christensen; Henrik I,0,0,20,20
1668066038503,CSE 291,A00,102443,Su; Hao,0,0,0,0
1668066038503,CSE 291,B00,102448,Polikarpova; Nadezhda,0,0,0,0
1668066038503,CSE 291,C00,102453,Vaccaro; Kristen Marie,0,0,0,0
1668066038503,CSE 291,D00,111343,Savage; Stefan,0,0,0,0
1668066038503,CSE 291,E00,116474,Claffy; Kimberly Claire,0,0,0,0
1668066038503,CSE 291,F00,116479,Pasquale; Joseph,0,0,0,0
1668066038930,CSE 293,001,119111,Bafna; Vineet,9999,0,9999,0
1668066038930,CSE 293,002,119118,Bellare; Mihir,9999,0,9999,0
1668066038930,CSE 293,003,119122,Berg-Kirkpatrick; Taylor D,9999,0,9999,0
1668066038930,CSE 293,004,119135,Christensen; Henrik I,9999,0,9999,0
1668066038930,CSE 293,005,119142,Cottrell; Garrison W,9999,0,9999,0
1668066038930,CSE 293,006,119146,Deutsch; Alin Bernard,9999,0,9999,0
1668066038930,CSE 293,007,119159,Esmaeilzadeh; Hadi,9999,0,9999,0
1668066038930,CSE 293,008,119166,Freund; Yoav,9999,0,9999,0
1668066038930,CSE 293,009,119170,Griswold; William G.,9999,0,9999,0
1668066038930,CSE 293,010,119183,Gymrek; Melissa Ann,9999,0,9999,0
1668066038930,CSE 293,011,119190,Heninger; Nadia A,9999,0,9999,0
1668066038930,CSE 293,012,119230,Impagliazzo; Russell,9999,0,9999,0
1668066038930,CSE 293,013,119232,Jhala; Ranjit,9999,0,9999,0
1668066038930,CSE 293,014,119233,Kahng; Andrew Byun,9999,0,9999,0
1668066038930,CSE 293,015,119298,Kane; Daniel Mertz,9999,0,9999,0
1668066038930,CSE 293,016,119299,Kriegman; David J,9999,0,9999,0
1668066038930,CSE 293,017,119300,Kumar; Arun Kumar,9999,0,9999,0
1668066038930,CSE 293,018,119301,Lerner; Sorin,9999,0,9999,0
1668066038930,CSE 293,019,119302,Lovett; Shachar,9999,0,9999,0
1668066038930,CSE 293,020,119303,McAuley; Julian John,9999,0,9999,0
1668066038930,CSE 293,021,119304,Micciancio; Daniele,9999,0,9999,0
1668066038930,CSE 293,022,119367,Orailoglu; Alex,9999,0,9999,0
1668066038930,CSE 293,023,119382,Paturi; Ramamohan,9999,0,9999,0
1668066038930,CSE 293,024,119404,Polikarpova; Nadezhda,9999,0,9999,0
1668066038930,CSE 293,025,119406,Politz; Joseph Gibbs,9999,0,9999,0
1668066038930,CSE 293,026,119411,Porter; George M,9999,0,9999,0
1668066038930,CSE 293,027,119414,Porter; Leonard Emerson,9999,0,9999,0
1668066038930,CSE 293,028,119416,Ramamoorthi; Ravi,9999,0,9999,0
1668066038930,CSE 293,029,119417,Sahoo; Debashis,9999,0,9999,0
1668066038930,CSE 293,030,119420,Saul; Lawrence,9999,0,9999,0
1668066038930,CSE 293,031,119421,Savage; Stefan,9999,0,9999,0
1668066038930,CSE 293,032,119425,Schulze; Jurgen P.,9999,0,9999,0
1668066038930,CSE 293,033,119426,Snoeren; Alex C.,9999,0,9999,0
1668066038930,CSE 293,034,119428,Shang; Jingbo,9999,0,9999,0
1668066038930,CSE 293,035,119430,Stefan; Deian,9999,0,9999,0
1668066038930,CSE 293,036,119431,Su; Hao,9999,0,9999,0
1668066038930,CSE 293,037,119433,Swanson; Steven James,9999,0,9999,0
1668066038930,CSE 293,038,119435,Tullsen; Dean Michael,9999,0,9999,0
1668066038930,CSE 293,039,119483,Voelker; Geoffrey M.,9999,0,9999,0
1668066038930,CSE 293,040,119537,Zhao; Jishen,9999,0,9999,0
1668066038930,CSE 293,041,119538,Zhou; Yuan-Yuan,9999,0,9999,0
1668066038930,CSE 293,042,119539,Gao; Sicun,9999,0,9999,0
1668066038930,CSE 293,043,119540,Weibel; Nadir,9999,0,9999,0
1668066038930,CSE 293,044,119541,Gupta; Rajesh K.,9999,0,9999,0
1668066038930,CSE 293,045,126410,Vaccaro; Kristen Marie,9999,0,9999,0
1668066038930,CSE 293,046,126411,Klemke; Richard,9999,0,9999,0
1668066039353,CSE 294,A00,102459,Voelker; Geoffrey M.,0,0,0,0
1668066039353,CSE 294,B00,111322,Orailoglu; Alex,0,0,0,0
1668066039775,DSE 201,A00,096914,Deutsch; Alin Bernard,30,0,30,0
1668066040201,DSE 210,A00,096915,Dasgupta; Sanjoy,30,0,30,0
1668066040632,DSE 260A,A00,096916,Altintas De Callaf; Ilkay,30,0,30,0
1668066041099,ECE 200,001,103586,Antipa; Nicholas A,9999,0,9999,0
1668066041099,ECE 200,002,103587,Atanasov; Nikolay A.,9999,0,9999,0
1668066041099,ECE 200,003,103588,Bharadia; Dinesh,9999,0,9999,0
1668066041099,ECE 200,004,103589,Cheng; Chung Kuan,9999,0,9999,0
1668066041099,ECE 200,005,103590,Cosman; Pamela C.,9999,0,9999,0
1668066041099,ECE 200,006,103591,Dayeh; Shadi Ahmad,9999,0,9999,0
1668066041099,ECE 200,007,103592,Fainman; Yeshaiahu,9999,0,9999,0
1668066041099,ECE 200,008,103593,Ford; Joseph Earl,9999,0,9999,0
1668066041099,ECE 200,009,103594,Franceschetti; Massimo,9999,0,9999,0
1668066041099,ECE 200,010,103595,Fullerton; Eric E,9999,0,9999,0
1668066041099,ECE 200,011,103596,Galton; Ian A,9999,0,9999,0
1668066041099,ECE 200,012,103597,Gilja; Vikash,9999,0,9999,0
1668066041099,ECE 200,013,103598,Hall; Drew A.,9999,0,9999,0
1668066041099,ECE 200,014,103599,Hsueh; Tzu-Chien,9999,0,9999,0
1668066041099,ECE 200,015,103600,Javidi; Tara,9999,0,9999,0
1668066041099,ECE 200,016,103601,Kahng; Andrew Byun,9999,0,9999,0
1668066041099,ECE 200,017,103602,Kim; Young-Han,9999,0,9999,0
1668066041099,ECE 200,018,103603,Koushanfar; Farinaz,9999,0,9999,0
1668066041099,ECE 200,019,103604,Kuzum; Duygu,9999,0,9999,0
1668066041099,ECE 200,020,103605,Le; Hanh-Phuc,9999,0,9999,0
1668066041099,ECE 200,021,103606,Lin; Bill,9999,0,9999,0
1668066041099,ECE 200,022,103607,Liu; Zhaowei,9998,0,9999,1
1668066041099,ECE 200,023,103608,Lo; Yu-Hwa,9999,0,9999,0
1668066041099,ECE 200,024,103609,Lomakin; Vitaliy,9999,0,9999,0
1668066041099,ECE 200,025,103610,Mercier; Patrick Philip,9999,0,9999,0
1668066041099,ECE 200,026,103611,Meyer; Florian,9999,0,9999,0
1668066041099,ECE 200,027,103612,Milstein; Laurence B.,9999,0,9999,0
1668066041099,ECE 200,028,103613,Mir Arabbaygi; Siavash,9999,0,9999,0
1668066041099,ECE 200,029,103614,Mookherjea; Shayan,9999,0,9999,0
1668066041099,ECE 200,030,103615,Morris; Karcher William,9999,0,9999,0
1668066041099,ECE 200,031,103616,Ng; Tse Nga,9999,0,9999,0
1668066041099,ECE 200,032,103617,Nguyen; Truong Quang,9999,0,9999,0
1668066041099,ECE 200,033,103618,Nomura; Kenji,9999,0,9999,0
1668066041099,ECE 200,034,103619,Orlitsky; Alon,9999,0,9999,0
1668066041099,ECE 200,035,103620,Pal; Piya,9999,0,9999,0
1668066041099,ECE 200,036,103621,Papen; George C.,9999,0,9999,0
1668066041099,ECE 200,037,103622,Radic; Stojan,9999,0,9999,0
1668066041099,ECE 200,038,103623,Rao; Bhaskar D.,9999,0,9999,0
1668066041099,ECE 200,039,103624,Rao; Ramesh R,9999,0,9999,0
1668066041099,ECE 200,040,103625,Rebeiz; Gabriel,9999,0,9999,0
1668066041099,ECE 200,041,103626,Sanford; John R,9999,0,9999,0
1668066041099,ECE 200,042,103627,Siegel; Paul H.,9999,0,9999,0
1668066041099,ECE 200,043,103628,Sievenpiper; Daniel F.,9999,0,9999,0
1668066041099,ECE 200,044,103629,Sworder; David D.,9999,0,9999,0
1668066041099,ECE 200,045,103630,Taur; Yuan,9999,0,9999,0
1668066041099,ECE 200,046,103631,Touri; Behrouz,9999,0,9999,0
1668066041099,ECE 200,047,103632,Trivedi; Mohan M.,9999,0,9999,0
1668066041099,ECE 200,048,103633,Vasconcelos; Nuno,9999,0,9999,0
1668066041099,ECE 200,049,103634,Wang; Xiaolong,9999,0,9999,0
1668066041099,ECE 200,050,103635,Xie; Pengtao,9999,0,9999,0
1668066041099,ECE 200,051,103636,Yip; Michael,9999,0,9999,0
1668066041099,ECE 200,052,103637,Zeger; Kenneth A.,999,0,999,0
1668066041099,ECE 200,053,103638,Zhang; Xinyu,9999,0,9999,0
1668066041099,ECE 200,054,103639,Turakhia; Yatish Girish,9999,0,9999,0
1668066041099,ECE 200,055,103640,Kang; Mingu,9999,0,9999,0
1668066041099,ECE 200,056,103641,Shi; Yuanyuan,9999,0,9999,0
1668066041099,ECE 200,057,103642,Wang; Edward Jay,9999,0,9999,0
1668066041099,ECE 200,058,103643,Zheng; Yang,9999,0,9999,0
1668066041536,ECE 202,A00,103644,Kuzum; Duygu,0,0,0,0
1668066041964,ECE 212BN,A00,103646,Ng; Tse Nga,0,0,0,0
1668066042389,ECE 221,A00,111493,Staff,0,0,0,0
1668066042822,ECE 222B,A00,103647,Lomakin; Vitaliy,0,0,0,0
1668066043247,ECE 230B,A00,103648,Taur; Yuan,0,0,0,0
1668066043677,ECE 238B,A00,103649,Garay; Javier,0,0,0,0
1668066044109,ECE 240B,A00,112900,Fainman; Yeshaiahu,0,0,0,0
1668066044533,ECE 247A,A00,103650,Jokerst; Jesse Vincent,0,0,0,0
1668066044957,ECE 247B,A00,103651,Wang; Joseph,0,0,0,0
1668066045383,ECE 250,A00,103652,Siegel; Paul H.,0,0,0,0
1668066045806,ECE 251A,A00,103654,Rao; Bhaskar D.,0,0,0,0
1668066046230,ECE 257B,A00,103655,Bharadia; Dinesh,0,0,0,0
1668066046656,ECE 258A,A00,103656,Milstein; Laurence B.,0,0,0,0
1668066047081,ECE 260B,A00,103658,Kang; Mingu,0,0,0,0
1668066047507,ECE 264A,A00,103659,Galton; Ian A,0,0,0,0
1668066047936,ECE 265A,A00,103661,Gudem; Prasad S.S.,0,0,0,0
1668066048378,ECE 265D,A00,103662,Gudem; Prasad S.S.,0,0,0,0
1668066048802,ECE 268,A00,103663,Koushanfar; Farinaz,0,0,0,0
1668066049226,ECE 269,A01,103665,Pal; Piya,0,0,0,0
1668066049650,ECE 271B,A00,103666,Vasconcelos; Manuela,0,0,0,0
1668066050075,ECE 276A,A00,103667,Atanasov; Nikolay A.,0,0,0,0
1668066050507,ECE 277,A00,103668,An; Cheolhong,0,0,0,0
1668066050931,ECE 279,A00,117947,Hall; Drew A.,0,0,0,0
1668066051779,ECE 283,A00,103670,Hsueh; Tzu-Chien,0,0,0,0
1668066052204,ECE 284,A00,103671,Turakhia; Yatish Girish,0,0,0,0
1668066052627,ECE 285,A00,103672,Zheng; Yang,0,0,0,0
1668066052627,ECE 285,B00,103673,Sworder; David D.,0,0,0,0
1668066053053,ECE 287,A00,103676,Javidi; Tara,0,0,0,0
1668066053479,MATH 200B,A00,098023,Salehi Golsefidy; Alireza,13,0,15,2
1668066053983,MATH 202B,A00,098024,Rhoades; Brendon Patrick,9,0,15,6
1668066054408,MATH 203B,A00,098025,Oprea; Dragos N.,11,0,15,4
1668066054835,MATH 204B,A00,098026,Sorensen; Claus M,13,0,15,2
1668066055258,MATH 208,A00,098027,Izadi; Elham,7,0,10,3
1668066055682,MATH 209,A00,098028,Pollack; Aaron,10,0,10,0
1668066056122,MATH 211A,A00,112919,Rogalski; Daniel,9,0,10,1
1668066056544,MATH 211B,A00,112920,Seward; Brandon M.,9,0,10,1
1668066056970,MATH 218,A00,098029,Li; Bo,10,0,10,0
1668066057393,MATH 220B,A00,098030,Novak; Jonathan I,13,0,15,2
1668066057817,MATH 221A,A00,098031,Ebenfelt; Peter F,13,0,15,2
1668066058243,MATH 231B,A00,098032,Zlatos; Andrej,12,0,15,3
1668066058665,MATH 240B,A00,098033,Ni; Lei,9,0,15,6
1668066059090,MATH 243,A00,098034,Jekel; David Andrew,10,0,10,0
1668066059515,MATH 245A,A00,098035,Nie; Jiawang,0,0,15,16
1668066059951,MATH 248,A00,098036,Bejenaru; Ioan,10,0,10,0
1668066060381,MATH 250B,A00,098037,Spolaor; Luca,14,0,15,1
1668066060802,MATH 258,A00,098038,Ni; Lei,10,0,10,0
1668066061227,MATH 264B,A00,098041,Rhoades; Brendon Patrick,10,0,15,5
1668066061649,MATH 268,A00,098042,Buss; Samuel R,10,0,10,0
1668066062072,MATH 269,A00,098043,Rhoades; Brendon Patrick,10,0,10,0
1668066062508,MATH 270B,A00,098044,Li; Bo,11,0,15,4
1668066062942,MATH 272B,A00,098045,Holst; Michael J,13,0,15,2
1668066063366,MATH 273A,A00,098046,Tian; Xiaochuan,10,0,15,5
1668066063794,MATH 275,A01,098048,Tian; Xiaochuan,6,0,10,4
1668066064217,MATH 278A,A00,098049,Holst; Michael J,8,0,10,2
1668066064641,MATH 278B,A00,098050,Cloninger; Alexander,10,0,10,0
1668066065068,MATH 278C,A00,098051,Nie; Jiawang,7,0,10,3
1668066065492,MATH 280B,A00,098052,Zheng; Tianyi,10,0,15,5
1668066065918,MATH 281B,A00,098053,Bradic; Jelena,3,0,15,12
1668066066340,MATH 282B,A00,098054,Arias-Castro; Ery,0,0,15,15
1668066066772,MATH 285,A00,098055,Fitzsimmons; Patrick J,0,0,15,17
1668066067199,MATH 287B,A00,098056,Arias-Castro; Ery,3,0,15,12
1668066067625,MATH 288,A00,098057,Agarwal; Pooja,9,0,10,1
1668066067625,MATH 288,B00,098058,Zhang; Danna,8,0,10,2
1668066067625,MATH 288,C00,098059,Williams; Ruth J,10,0,10,0
1668066068049,MATH 290B,A00,098060,Roberts; Justin Deritter,13,0,15,2
1668066068476,MATH 292,A00,098061,Belmont; Eva Kinoshita,10,0,10,0
1668066068911,MATH 295,A00,098062,Suk; Andrew Hoon,48,0,50,2
1668066069334,MATH 296,A00,098063,Novak; Jonathan I,20,0,20,0
1668066069760,MATH 297,001,098064,Gamst; Anthony Collins,9997,0,9999,2
1668066571242,COGS 205,A00,101395,Chiba; Andrea,19,0,20,1
1668066571671,COGS 210B,001,101404,Greene; Deanna Jacquelyn,9998,0,9999,1
1668066571671,COGS 210B,002,101417,Xia; Haijun,9999,0,9999,0
1668066571671,COGS 210B,003,101422,Nitz; Douglas A.,9999,0,9999,0
1668066571671,COGS 210B,004,101423,Hollan; James D.,9998,0,9999,1
1668066571671,COGS 210B,005,101424,Deak; Gedeon O.,9998,0,9999,1
1668066571671,COGS 210B,006,101425,Rossano; Federico,9999,0,9999,0
1668066572096,COGS 211B,A00,101427,Coulson; Seana M,9996,0,9999,3
1668066572520,COGS 220,A00,101428,Hollan; James D.,0,0,25,25
1668066572951,COGS 229,A00,101429,Dow; Steven P,18,0,25,7
1668066573389,COGS 230,A00,101430,Klemmer; Scott R,13,0,17,4
1668066573814,COGS 234,A00,101431,Xia; Haijun,3,0,25,22
1668066574241,COGS 260,A00,101432,Kiyonaga; Anastasia,19,0,25,6
1668066574241,COGS 260,B00,101433,Kirsh; David Joel,16,0,25,9
1668066574683,CSE 202,A00,102371,Impagliazzo; Russell,0,0,0,0
1668066575121,CSE 203B,A01,102373,Cheng; Chung Kuan,0,0,0,0
1668066575626,CSE 208,A00,102374,Micciancio; Daniele,0,0,0,0
1668066576049,CSE 209A,A00,112895,Impagliazzo; Russell,0,0,15,15
1668066576471,CSE 209B,A00,108005,Bellare; Mihir,0,0,0,0
1668066576897,CSE 210,A00,113163,Coblenz; Michael J,0,0,0,0
1668066577321,CSE 219,A00,106111,Dow; Steven P,0,0,20,20
1668066577750,CSE 221,A00,102376,Voelker; Geoffrey M.,0,0,0,0
1668066578181,CSE 224,A01,102378,Porter; George M,0,0,0,0
1668066578612,CSE 229A,A00,102379,Savage; Stefan,0,0,0,0
1668066579051,CSE 229C,A00,102380,Munyaka; Imani N. S.,0,0,0,0
1668066579481,CSE 232B,A00,102382,Deutsch; Alin Bernard,0,0,0,0
1668066579915,CSE 234,A01,112904,Kumar; Arun Kumar,0,0,0,0
1668066580346,CSE 237A,A00,102383,Rosing; Tajana Simunic,0,0,0,0
1668066580769,CSE 239A,A00,102384,Deutsch; Alin Bernard,0,0,0,0
1668066581193,CSE 239B,A00,102385,Polikarpova; Nadezhda,0,0,0,0
1668066581621,CSE 240A,A00,102386,Pannuto; Patrick William,0,0,0,0
1668066582045,CSE 240B,A00,102387,Zhao; Jishen,0,0,0,0
1668066582467,CSE 241A,A00,106406,Kang; Mingu,0,0,0,0
1668066582907,CSE 249B,A00,102388,Kahng; Andrew Byun,0,0,8,8
1668066583330,CSE 251B,A01,102392,Cottrell; Garrison W,0,0,0,0
1668066583330,CSE 251B,A02,102393,Cottrell; Garrison W,0,0,0,0
1668066583758,CSE 252B,A00,102394,Ochoa; Benjamin Lawrence,0,0,0,0
1668066584181,CSE 257,A01,102396,Gao; Sicun,0,0,0,0
1668066584605,CSE 272,A00,102397,Li; Tzumao,0,0,0,0
1668066585029,CSE 274,A00,111323,Chern; Albert Ren-Haur,0,0,0,0
1668066585460,CSE 282,A00,102398,Pevzner; Pavel Arkadjevich,0,0,0,0
1668066585885,CSE 284,A00,114175,Gymrek; Melissa Ann,0,0,0,0
1668066586309,CSE 290,A00,102399,Chandraker; Manmohan Krishna,0,0,0,0
1668066586309,CSE 290,B00,102400,Vaccaro; Kristen Marie,0,0,25,25
1668066586309,CSE 290,C00,102414,Pannuto; Patrick William,0,0,25,25
1668066586309,CSE 290,D00,102427,Pevzner; Pavel Arkadjevich,0,0,0,0
1668066586309,CSE 290,E00,102429,Zhao; Jishen,0,0,0,0
1668066586309,CSE 290,F00,102436,Tullsen; Dean Michael,0,0,0,0
1668066586309,CSE 290,G00,102440,Christensen; Henrik I,0,0,20,20
1668066586740,CSE 291,A00,102443,Su; Hao,0,0,0,0
1668066586740,CSE 291,B00,102448,Polikarpova; Nadezhda,0,0,0,0
1668066586740,CSE 291,C00,102453,Vaccaro; Kristen Marie,0,0,0,0
1668066586740,CSE 291,D00,111343,Savage; Stefan,0,0,0,0
1668066586740,CSE 291,E00,116474,Claffy; Kimberly Claire,0,0,0,0
1668066586740,CSE 291,F00,116479,Pasquale; Joseph,0,0,0,0
1668066587169,CSE 293,001,119111,Bafna; Vineet,9999,0,9999,0
1668066587169,CSE 293,002,119118,Bellare; Mihir,9999,0,9999,0
1668066587169,CSE 293,003,119122,Berg-Kirkpatrick; Taylor D,9999,0,9999,0
1668066587169,CSE 293,004,119135,Christensen; Henrik I,9999,0,9999,0
1668066587169,CSE 293,005,119142,Cottrell; Garrison W,9999,0,9999,0
1668066587169,CSE 293,006,119146,Deutsch; Alin Bernard,9999,0,9999,0
1668066587169,CSE 293,007,119159,Esmaeilzadeh; Hadi,9999,0,9999,0
1668066587169,CSE 293,008,119166,Freund; Yoav,9999,0,9999,0
1668066587169,CSE 293,009,119170,Griswold; William G.,9999,0,9999,0
1668066587169,CSE 293,010,119183,Gymrek; Melissa Ann,9999,0,9999,0
1668066587169,CSE 293,011,119190,Heninger; Nadia A,9999,0,9999,0
1668066587169,CSE 293,012,119230,Impagliazzo; Russell,9999,0,9999,0
1668066587169,CSE 293,013,119232,Jhala; Ranjit,9999,0,9999,0
1668066587169,CSE 293,014,119233,Kahng; Andrew Byun,9999,0,9999,0
1668066587169,CSE 293,015,119298,Kane; Daniel Mertz,9999,0,9999,0
1668066587169,CSE 293,016,119299,Kriegman; David J,9999,0,9999,0
1668066587169,CSE 293,017,119300,Kumar; Arun Kumar,9999,0,9999,0
1668066587169,CSE 293,018,119301,Lerner; Sorin,9999,0,9999,0
1668066587169,CSE 293,019,119302,Lovett; Shachar,9999,0,9999,0
1668066587169,CSE 293,020,119303,McAuley; Julian John,9999,0,9999,0
1668066587169,CSE 293,021,119304,Micciancio; Daniele,9999,0,9999,0
1668066587169,CSE 293,022,119367,Orailoglu; Alex,9999,0,9999,0
1668066587169,CSE 293,023,119382,Paturi; Ramamohan,9999,0,9999,0
1668066587169,CSE 293,024,119404,Polikarpova; Nadezhda,9999,0,9999,0
1668066587169,CSE 293,025,119406,Politz; Joseph Gibbs,9999,0,9999,0
1668066587169,CSE 293,026,119411,Porter; George M,9999,0,9999,0
1668066587169,CSE 293,027,119414,Porter; Leonard Emerson,9999,0,9999,0
1668066587169,CSE 293,028,119416,Ramamoorthi; Ravi,9999,0,9999,0
1668066587169,CSE 293,029,119417,Sahoo; Debashis,9999,0,9999,0
1668066587169,CSE 293,030,119420,Saul; Lawrence,9999,0,9999,0
1668066587169,CSE 293,031,119421,Savage; Stefan,9999,0,9999,0
1668066587169,CSE 293,032,119425,Schulze; Jurgen P.,9999,0,9999,0
1668066587169,CSE 293,033,119426,Snoeren; Alex C.,9999,0,9999,0
1668066587169,CSE 293,034,119428,Shang; Jingbo,9999,0,9999,0
1668066587169,CSE 293,035,119430,Stefan; Deian,9999,0,9999,0
1668066587169,CSE 293,036,119431,Su; Hao,9999,0,9999,0
1668066587169,CSE 293,037,119433,Swanson; Steven James,9999,0,9999,0
1668066587169,CSE 293,038,119435,Tullsen; Dean Michael,9999,0,9999,0
1668066587169,CSE 293,039,119483,Voelker; Geoffrey M.,9999,0,9999,0
1668066587169,CSE 293,040,119537,Zhao; Jishen,9999,0,9999,0
1668066587169,CSE 293,041,119538,Zhou; Yuan-Yuan,9999,0,9999,0
1668066587169,CSE 293,042,119539,Gao; Sicun,9999,0,9999,0
1668066587169,CSE 293,043,119540,Weibel; Nadir,9999,0,9999,0
1668066587169,CSE 293,044,119541,Gupta; Rajesh K.,9999,0,9999,0
1668066587169,CSE 293,045,126410,Vaccaro; Kristen Marie,9999,0,9999,0
1668066587169,CSE 293,046,126411,Klemke; Richard,9999,0,9999,0
1668066587595,CSE 294,A00,102459,Voelker; Geoffrey M.,0,0,0,0
1668066587595,CSE 294,B00,111322,Orailoglu; Alex,0,0,0,0
1668066588022,DSE 201,A00,096914,Deutsch; Alin Bernard,30,0,30,0
1668066588448,DSE 210,A00,096915,Dasgupta; Sanjoy,30,0,30,0
1668066588873,DSE 260A,A00,096916,Altintas De Callaf; Ilkay,30,0,30,0
1668066589303,ECE 200,001,103586,Antipa; Nicholas A,9999,0,9999,0
1668066589303,ECE 200,002,103587,Atanasov; Nikolay A.,9999,0,9999,0
1668066589303,ECE 200,003,103588,Bharadia; Dinesh,9999,0,9999,0
1668066589303,ECE 200,004,103589,Cheng; Chung Kuan,9999,0,9999,0
1668066589303,ECE 200,005,103590,Cosman; Pamela C.,9999,0,9999,0
1668066589303,ECE 200,006,103591,Dayeh; Shadi Ahmad,9999,0,9999,0
1668066589303,ECE 200,007,103592,Fainman; Yeshaiahu,9999,0,9999,0
1668066589303,ECE 200,008,103593,Ford; Joseph Earl,9999,0,9999,0
1668066589303,ECE 200,009,103594,Franceschetti; Massimo,9999,0,9999,0
1668066589303,ECE 200,010,103595,Fullerton; Eric E,9999,0,9999,0
1668066589303,ECE 200,011,103596,Galton; Ian A,9999,0,9999,0
1668066589303,ECE 200,012,103597,Gilja; Vikash,9999,0,9999,0
1668066589303,ECE 200,013,103598,Hall; Drew A.,9999,0,9999,0
1668066589303,ECE 200,014,103599,Hsueh; Tzu-Chien,9999,0,9999,0
1668066589303,ECE 200,015,103600,Javidi; Tara,9999,0,9999,0
1668066589303,ECE 200,016,103601,Kahng; Andrew Byun,9999,0,9999,0
1668066589303,ECE 200,017,103602,Kim; Young-Han,9999,0,9999,0
1668066589303,ECE 200,018,103603,Koushanfar; Farinaz,9999,0,9999,0
1668066589303,ECE 200,019,103604,Kuzum; Duygu,9999,0,9999,0
1668066589303,ECE 200,020,103605,Le; Hanh-Phuc,9999,0,9999,0
1668066589303,ECE 200,021,103606,Lin; Bill,9999,0,9999,0
1668066589303,ECE 200,022,103607,Liu; Zhaowei,9998,0,9999,1
1668066589303,ECE 200,023,103608,Lo; Yu-Hwa,9999,0,9999,0
1668066589303,ECE 200,024,103609,Lomakin; Vitaliy,9999,0,9999,0
1668066589303,ECE 200,025,103610,Mercier; Patrick Philip,9999,0,9999,0
1668066589303,ECE 200,026,103611,Meyer; Florian,9999,0,9999,0
1668066589303,ECE 200,027,103612,Milstein; Laurence B.,9999,0,9999,0
1668066589303,ECE 200,028,103613,Mir Arabbaygi; Siavash,9999,0,9999,0
1668066589303,ECE 200,029,103614,Mookherjea; Shayan,9999,0,9999,0
1668066589303,ECE 200,030,103615,Morris; Karcher William,9999,0,9999,0
1668066589303,ECE 200,031,103616,Ng; Tse Nga,9999,0,9999,0
1668066589303,ECE 200,032,103617,Nguyen; Truong Quang,9999,0,9999,0
1668066589303,ECE 200,033,103618,Nomura; Kenji,9999,0,9999,0
1668066589303,ECE 200,034,103619,Orlitsky; Alon,9999,0,9999,0
1668066589303,ECE 200,035,103620,Pal; Piya,9999,0,9999,0
1668066589303,ECE 200,036,103621,Papen; George C.,9999,0,9999,0
1668066589303,ECE 200,037,103622,Radic; Stojan,9999,0,9999,0
1668066589303,ECE 200,038,103623,Rao; Bhaskar D.,9999,0,9999,0
1668066589303,ECE 200,039,103624,Rao; Ramesh R,9999,0,9999,0
1668066589303,ECE 200,040,103625,Rebeiz; Gabriel,9999,0,9999,0
1668066589303,ECE 200,041,103626,Sanford; John R,9999,0,9999,0
1668066589303,ECE 200,042,103627,Siegel; Paul H.,9999,0,9999,0
1668066589303,ECE 200,043,103628,Sievenpiper; Daniel F.,9999,0,9999,0
1668066589303,ECE 200,044,103629,Sworder; David D.,9999,0,9999,0
1668066589303,ECE 200,045,103630,Taur; Yuan,9999,0,9999,0
1668066589303,ECE 200,046,103631,Touri; Behrouz,9999,0,9999,0
1668066589303,ECE 200,047,103632,Trivedi; Mohan M.,9999,0,9999,0
1668066589303,ECE 200,048,103633,Vasconcelos; Nuno,9999,0,9999,0
1668066589303,ECE 200,049,103634,Wang; Xiaolong,9999,0,9999,0
1668066589303,ECE 200,050,103635,Xie; Pengtao,9999,0,9999,0
1668066589303,ECE 200,051,103636,Yip; Michael,9999,0,9999,0
1668066589303,ECE 200,052,103637,Zeger; Kenneth A.,999,0,999,0
1668066589303,ECE 200,053,103638,Zhang; Xinyu,9999,0,9999,0
1668066589303,ECE 200,054,103639,Turakhia; Yatish Girish,9999,0,9999,0
1668066589303,ECE 200,055,103640,Kang; Mingu,9999,0,9999,0
1668066589303,ECE 200,056,103641,Shi; Yuanyuan,9999,0,9999,0
1668066589303,ECE 200,057,103642,Wang; Edward Jay,9999,0,9999,0
1668066589303,ECE 200,058,103643,Zheng; Yang,9999,0,9999,0
1668066589726,ECE 202,A00,103644,Kuzum; Duygu,0,0,0,0
1668066590148,ECE 212BN,A00,103646,Ng; Tse Nga,0,0,0,0
1668066590572,ECE 221,A00,111493,Staff,0,0,0,0
1668066590996,ECE 222B,A00,103647,Lomakin; Vitaliy,0,0,0,0
1668066591428,ECE 230B,A00,103648,Taur; Yuan,0,0,0,0
1668066591853,ECE 238B,A00,103649,Garay; Javier,0,0,0,0
1668066592279,ECE 240B,A00,112900,Fainman; Yeshaiahu,0,0,0,0
1668066592703,ECE 247A,A00,103650,Jokerst; Jesse Vincent,0,0,0,0
1668066593130,ECE 247B,A00,103651,Wang; Joseph,0,0,0,0
1668066593560,ECE 250,A00,103652,Siegel; Paul H.,0,0,0,0
1668066593990,ECE 251A,A00,103654,Rao; Bhaskar D.,0,0,0,0
1668066594423,ECE 257B,A00,103655,Bharadia; Dinesh,0,0,0,0
1668066594862,ECE 258A,A00,103656,Milstein; Laurence B.,0,0,0,0
1668066595292,ECE 260B,A00,103658,Kang; Mingu,0,0,0,0
1668066595721,ECE 264A,A00,103659,Galton; Ian A,0,0,0,0
1668066596144,ECE 265A,A00,103661,Gudem; Prasad S.S.,0,0,0,0
1668066596570,ECE 265D,A00,103662,Gudem; Prasad S.S.,0,0,0,0
1668066597005,ECE 268,A00,103663,Koushanfar; Farinaz,0,0,0,0
1668066597431,ECE 269,A01,103665,Pal; Piya,0,0,0,0
1668066597858,ECE 271B,A00,103666,Vasconcelos; Manuela,0,0,0,0
1668066598282,ECE 276A,A00,103667,Atanasov; Nikolay A.,0,0,0,0
1668066598710,ECE 277,A00,103668,An; Cheolhong,0,0,0,0
1668066599138,ECE 279,A00,117947,Hall; Drew A.,0,0,0,0
1668066600007,ECE 283,A00,103670,Hsueh; Tzu-Chien,0,0,0,0
1668066600430,ECE 284,A00,103671,Turakhia; Yatish Girish,0,0,0,0
1668066600854,ECE 285,A00,103672,Zheng; Yang,0,0,0,0
1668066600854,ECE 285,B00,103673,Sworder; David D.,0,0,0,0
1668066601286,ECE 287,A00,103676,Javidi; Tara,0,0,0,0
1668066601713,MATH 200B,A00,098023,Salehi Golsefidy; Alireza,13,0,15,2
1668066602139,MATH 202B,A00,098024,Rhoades; Brendon Patrick,9,0,15,6
1668066602573,MATH 203B,A00,098025,Oprea; Dragos N.,11,0,15,4
1668066603020,MATH 204B,A00,098026,Sorensen; Claus M,13,0,15,2
1668066603454,MATH 208,A00,098027,Izadi; Elham,7,0,10,3
1668066603888,MATH 209,A00,098028,Pollack; Aaron,10,0,10,0
1668066604314,MATH 211A,A00,112919,Rogalski; Daniel,9,0,10,1
1668066604747,MATH 211B,A00,112920,Seward; Brandon M.,9,0,10,1
1668066605175,MATH 218,A00,098029,Li; Bo,10,0,10,0
1668066605611,MATH 220B,A00,098030,Novak; Jonathan I,13,0,15,2
1668066606037,MATH 221A,A00,098031,Ebenfelt; Peter F,13,0,15,2
1668066606465,MATH 231B,A00,098032,Zlatos; Andrej,12,0,15,3
1668066606890,MATH 240B,A00,098033,Ni; Lei,9,0,15,6
1668066607313,MATH 243,A00,098034,Jekel; David Andrew,10,0,10,0
1668066607738,MATH 245A,A00,098035,Nie; Jiawang,0,0,15,16
1668066608161,MATH 248,A00,098036,Bejenaru; Ioan,10,0,10,0
1668066608582,MATH 250B,A00,098037,Spolaor; Luca,14,0,15,1
1668066609006,MATH 258,A00,098038,Ni; Lei,10,0,10,0
1668066609439,MATH 264B,A00,098041,Rhoades; Brendon Patrick,10,0,15,5
1668066609875,MATH 268,A00,098042,Buss; Samuel R,10,0,10,0
1668066610310,MATH 269,A00,098043,Rhoades; Brendon Patrick,10,0,10,0
1668066610733,MATH 270B,A00,098044,Li; Bo,11,0,15,4
1668066611158,MATH 272B,A00,098045,Holst; Michael J,13,0,15,2
1668066611581,MATH 273A,A00,098046,Tian; Xiaochuan,10,0,15,5
1668066612009,MATH 275,A01,098048,Tian; Xiaochuan,6,0,10,4
1668066612434,MATH 278A,A00,098049,Holst; Michael J,8,0,10,2
1668066612863,MATH 278B,A00,098050,Cloninger; Alexander,10,0,10,0
1668066613285,MATH 278C,A00,098051,Nie; Jiawang,7,0,10,3
1668066613709,MATH 280B,A00,098052,Zheng; Tianyi,10,0,15,5
1668066614135,MATH 281B,A00,098053,Bradic; Jelena,3,0,15,12
1668066614559,MATH 282B,A00,098054,Arias-Castro; Ery,0,0,15,15
1668066614987,MATH 285,A00,098055,Fitzsimmons; Patrick J,0,0,15,17
1668066615413,MATH 287B,A00,098056,Arias-Castro; Ery,3,0,15,12
1668066615841,MATH 288,A00,098057,Agarwal; Pooja,9,0,10,1
1668066615841,MATH 288,B00,098058,Zhang; Danna,8,0,10,2
1668066615841,MATH 288,C00,098059,Williams; Ruth J,10,0,10,0
1668066616267,MATH 290B,A00,098060,Roberts; Justin Deritter,13,0,15,2
1668066616691,MATH 292,A00,098061,Belmont; Eva Kinoshita,10,0,10,0
1668066617114,MATH 295,A00,098062,Suk; Andrew Hoon,48,0,50,2
1668066617538,MATH 296,A00,098063,Novak; Jonathan I,20,0,20,0
1668066617968,MATH 297,001,098064,Gamst; Anthony Collins,9997,0,9999,2
1668067119125,COGS 205,A00,101395,Chiba; Andrea,19,0,20,1
1668067119550,COGS 210B,001,101404,Greene; Deanna Jacquelyn,9998,0,9999,1
1668067119550,COGS 210B,002,101417,Xia; Haijun,9999,0,9999,0
1668067119550,COGS 210B,003,101422,Nitz; Douglas A.,9999,0,9999,0
1668067119550,COGS 210B,004,101423,Hollan; James D.,9998,0,9999,1
1668067119550,COGS 210B,005,101424,Deak; Gedeon O.,9998,0,9999,1
1668067119550,COGS 210B,006,101425,Rossano; Federico,9999,0,9999,0
1668067119973,COGS 211B,A00,101427,Coulson; Seana M,9996,0,9999,3
1668067120395,COGS 220,A00,101428,Hollan; James D.,0,0,25,25
1668067120836,COGS 229,A00,101429,Dow; Steven P,18,0,25,7
1668067121271,COGS 230,A00,101430,Klemmer; Scott R,13,0,17,4
1668067121698,COGS 234,A00,101431,Xia; Haijun,3,0,25,22
1668067122121,COGS 260,A00,101432,Kiyonaga; Anastasia,19,0,25,6
1668067122121,COGS 260,B00,101433,Kirsh; David Joel,16,0,25,9
1668067122548,CSE 202,A00,102371,Impagliazzo; Russell,0,0,0,0
1668067122972,CSE 203B,A01,102373,Cheng; Chung Kuan,0,0,0,0
1668067123395,CSE 208,A00,102374,Micciancio; Daniele,0,0,0,0
1668067123819,CSE 209A,A00,112895,Impagliazzo; Russell,0,0,15,15
1668067124255,CSE 209B,A00,108005,Bellare; Mihir,0,0,0,0
1668067124678,CSE 210,A00,113163,Coblenz; Michael J,0,0,0,0
1668067125113,CSE 219,A00,106111,Dow; Steven P,0,0,20,20
1668067125548,CSE 221,A00,102376,Voelker; Geoffrey M.,0,0,0,0
1668067125988,CSE 224,A01,102378,Porter; George M,0,0,0,0
1668067126411,CSE 229A,A00,102379,Savage; Stefan,0,0,0,0
1668067126835,CSE 229C,A00,102380,Munyaka; Imani N. S.,0,0,0,0
1668067127258,CSE 232B,A00,102382,Deutsch; Alin Bernard,0,0,0,0
1668067127689,CSE 234,A01,112904,Kumar; Arun Kumar,0,0,0,0
1668067128127,CSE 237A,A00,102383,Rosing; Tajana Simunic,0,0,0,0
1668067128553,CSE 239A,A00,102384,Deutsch; Alin Bernard,0,0,0,0
1668067128977,CSE 239B,A00,102385,Polikarpova; Nadezhda,0,0,0,0
1668067129405,CSE 240A,A00,102386,Pannuto; Patrick William,0,0,0,0
1668067129832,CSE 240B,A00,102387,Zhao; Jishen,0,0,0,0
1668067130265,CSE 241A,A00,106406,Kang; Mingu,0,0,0,0
1668067130690,CSE 249B,A00,102388,Kahng; Andrew Byun,0,0,8,8
1668067131120,CSE 251B,A01,102392,Cottrell; Garrison W,0,0,0,0
1668067131120,CSE 251B,A02,102393,Cottrell; Garrison W,0,0,0,0
1668067131544,CSE 252B,A00,102394,Ochoa; Benjamin Lawrence,0,0,0,0
1668067131967,CSE 257,A01,102396,Gao; Sicun,0,0,0,0
1668067132397,CSE 272,A00,102397,Li; Tzumao,0,0,0,0
1668067132820,CSE 274,A00,111323,Chern; Albert Ren-Haur,0,0,0,0
1668067133251,CSE 282,A00,102398,Pevzner; Pavel Arkadjevich,0,0,0,0
1668067133676,CSE 284,A00,114175,Gymrek; Melissa Ann,0,0,0,0
1668067134103,CSE 290,A00,102399,Chandraker; Manmohan Krishna,0,0,0,0
1668067134103,CSE 290,B00,102400,Vaccaro; Kristen Marie,0,0,25,25
1668067134103,CSE 290,C00,102414,Pannuto; Patrick William,0,0,25,25
1668067134103,CSE 290,D00,102427,Pevzner; Pavel Arkadjevich,0,0,0,0
1668067134103,CSE 290,E00,102429,Zhao; Jishen,0,0,0,0
1668067134103,CSE 290,F00,102436,Tullsen; Dean Michael,0,0,0,0
1668067134103,CSE 290,G00,102440,Christensen; Henrik I,0,0,20,20
1668067134530,CSE 291,A00,102443,Su; Hao,0,0,0,0
1668067134530,CSE 291,B00,102448,Polikarpova; Nadezhda,0,0,0,0
1668067134530,CSE 291,C00,102453,Vaccaro; Kristen Marie,0,0,0,0
1668067134530,CSE 291,D00,111343,Savage; Stefan,0,0,0,0
1668067134530,CSE 291,E00,116474,Claffy; Kimberly Claire,0,0,0,0
1668067134530,CSE 291,F00,116479,Pasquale; Joseph,0,0,0,0
1668067134959,CSE 293,001,119111,Bafna; Vineet,9999,0,9999,0
1668067134959,CSE 293,002,119118,Bellare; Mihir,9999,0,9999,0
1668067134959,CSE 293,003,119122,Berg-Kirkpatrick; Taylor D,9999,0,9999,0
1668067134959,CSE 293,004,119135,Christensen; Henrik I,9999,0,9999,0
1668067134959,CSE 293,005,119142,Cottrell; Garrison W,9999,0,9999,0
1668067134959,CSE 293,006,119146,Deutsch; Alin Bernard,9999,0,9999,0
1668067134959,CSE 293,007,119159,Esmaeilzadeh; Hadi,9999,0,9999,0
1668067134959,CSE 293,008,119166,Freund; Yoav,9999,0,9999,0
1668067134959,CSE 293,009,119170,Griswold; William G.,9999,0,9999,0
1668067134959,CSE 293,010,119183,Gymrek; Melissa Ann,9999,0,9999,0
1668067134959,CSE 293,011,119190,Heninger; Nadia A,9999,0,9999,0
1668067134959,CSE 293,012,119230,Impagliazzo; Russell,9999,0,9999,0
1668067134959,CSE 293,013,119232,Jhala; Ranjit,9999,0,9999,0
1668067134959,CSE 293,014,119233,Kahng; Andrew Byun,9999,0,9999,0
1668067134959,CSE 293,015,119298,Kane; Daniel Mertz,9999,0,9999,0
1668067134959,CSE 293,016,119299,Kriegman; David J,9999,0,9999,0
1668067134959,CSE 293,017,119300,Kumar; Arun Kumar,9999,0,9999,0
1668067134959,CSE 293,018,119301,Lerner; Sorin,9999,0,9999,0
1668067134959,CSE 293,019,119302,Lovett; Shachar,9999,0,9999,0
1668067134959,CSE 293,020,119303,McAuley; Julian John,9999,0,9999,0
1668067134959,CSE 293,021,119304,Micciancio; Daniele,9999,0,9999,0
1668067134959,CSE 293,022,119367,Orailoglu; Alex,9999,0,9999,0
1668067134959,CSE 293,023,119382,Paturi; Ramamohan,9999,0,9999,0
1668067134959,CSE 293,024,119404,Polikarpova; Nadezhda,9999,0,9999,0
1668067134959,CSE 293,025,119406,Politz; Joseph Gibbs,9999,0,9999,0
1668067134959,CSE 293,026,119411,Porter; George M,9999,0,9999,0
1668067134959,CSE 293,027,119414,Porter; Leonard Emerson,9999,0,9999,0
1668067134959,CSE 293,028,119416,Ramamoorthi; Ravi,9999,0,9999,0
1668067134959,CSE 293,029,119417,Sahoo; Debashis,9999,0,9999,0
1668067134959,CSE 293,030,119420,Saul; Lawrence,9999,0,9999,0
1668067134959,CSE 293,031,119421,Savage; Stefan,9999,0,9999,0
1668067134959,CSE 293,032,119425,Schulze; Jurgen P.,9999,0,9999,0
1668067134959,CSE 293,033,119426,Snoeren; Alex C.,9999,0,9999,0
1668067134959,CSE 293,034,119428,Shang; Jingbo,9999,0,9999,0
1668067134959,CSE 293,035,119430,Stefan; Deian,9999,0,9999,0
1668067134959,CSE 293,036,119431,Su; Hao,9999,0,9999,0
1668067134959,CSE 293,037,119433,Swanson; Steven James,9999,0,9999,0
1668067134959,CSE 293,038,119435,Tullsen; Dean Michael,9999,0,9999,0
1668067134959,CSE 293,039,119483,Voelker; Geoffrey M.,9999,0,9999,0
1668067134959,CSE 293,040,119537,Zhao; Jishen,9999,0,9999,0
1668067134959,CSE 293,041,119538,Zhou; Yuan-Yuan,9999,0,9999,0
1668067134959,CSE 293,042,119539,Gao; Sicun,9999,0,9999,0
1668067134959,CSE 293,043,119540,Weibel; Nadir,9999,0,9999,0
1668067134959,CSE 293,044,119541,Gupta; Rajesh K.,9999,0,9999,0
1668067134959,CSE 293,045,126410,Vaccaro; Kristen Marie,9999,0,9999,0
1668067134959,CSE 293,046,126411,Klemke; Richard,9999,0,9999,0
1668067135382,CSE 294,A00,102459,Voelker; Geoffrey M.,0,0,0,0
1668067135382,CSE 294,B00,111322,Orailoglu; Alex,0,0,0,0
1668067135822,DSE 201,A00,096914,Deutsch; Alin Bernard,30,0,30,0
1668067136249,DSE 210,A00,096915,Dasgupta; Sanjoy,30,0,30,0
1668067136683,DSE 260A,A00,096916,Altintas De Callaf; Ilkay,30,0,30,0
1668067137113,ECE 200,001,103586,Antipa; Nicholas A,9999,0,9999,0
1668067137113,ECE 200,002,103587,Atanasov; Nikolay A.,9999,0,9999,0
1668067137113,ECE 200,003,103588,Bharadia; Dinesh,9999,0,9999,0
1668067137113,ECE 200,004,103589,Cheng; Chung Kuan,9999,0,9999,0
1668067137113,ECE 200,005,103590,Cosman; Pamela C.,9999,0,9999,0
1668067137113,ECE 200,006,103591,Dayeh; Shadi Ahmad,9999,0,9999,0
1668067137113,ECE 200,007,103592,Fainman; Yeshaiahu,9999,0,9999,0
1668067137113,ECE 200,008,103593,Ford; Joseph Earl,9999,0,9999,0
1668067137113,ECE 200,009,103594,Franceschetti; Massimo,9999,0,9999,0
1668067137113,ECE 200,010,103595,Fullerton; Eric E,9999,0,9999,0
1668067137113,ECE 200,011,103596,Galton; Ian A,9999,0,9999,0
1668067137113,ECE 200,012,103597,Gilja; Vikash,9999,0,9999,0
1668067137113,ECE 200,013,103598,Hall; Drew A.,9999,0,9999,0
1668067137113,ECE 200,014,103599,Hsueh; Tzu-Chien,9999,0,9999,0
1668067137113,ECE 200,015,103600,Javidi; Tara,9999,0,9999,0
1668067137113,ECE 200,016,103601,Kahng; Andrew Byun,9999,0,9999,0
1668067137113,ECE 200,017,103602,Kim; Young-Han,9999,0,9999,0
1668067137113,ECE 200,018,103603,Koushanfar; Farinaz,9999,0,9999,0
1668067137113,ECE 200,019,103604,Kuzum; Duygu,9999,0,9999,0
1668067137113,ECE 200,020,103605,Le; Hanh-Phuc,9999,0,9999,0
1668067137113,ECE 200,021,103606,Lin; Bill,9999,0,9999,0
1668067137113,ECE 200,022,103607,Liu; Zhaowei,9998,0,9999,1
1668067137113,ECE 200,023,103608,Lo; Yu-Hwa,9999,0,9999,0
1668067137113,ECE 200,024,103609,Lomakin; Vitaliy,9999,0,9999,0
1668067137113,ECE 200,025,103610,Mercier; Patrick Philip,9999,0,9999,0
1668067137113,ECE 200,026,103611,Meyer; Florian,9999,0,9999,0
1668067137113,ECE 200,027,103612,Milstein; Laurence B.,9999,0,9999,0
1668067137113,ECE 200,028,103613,Mir Arabbaygi; Siavash,9999,0,9999,0
1668067137113,ECE 200,029,103614,Mookherjea; Shayan,9999,0,9999,0
1668067137113,ECE 200,030,103615,Morris; Karcher William,9999,0,9999,0
1668067137113,ECE 200,031,103616,Ng; Tse Nga,9999,0,9999,0
1668067137113,ECE 200,032,103617,Nguyen; Truong Quang,9999,0,9999,0
1668067137113,ECE 200,033,103618,Nomura; Kenji,9999,0,9999,0
1668067137113,ECE 200,034,103619,Orlitsky; Alon,9999,0,9999,0
1668067137113,ECE 200,035,103620,Pal; Piya,9999,0,9999,0
1668067137113,ECE 200,036,103621,Papen; George C.,9999,0,9999,0
1668067137113,ECE 200,037,103622,Radic; Stojan,9999,0,9999,0
1668067137113,ECE 200,038,103623,Rao; Bhaskar D.,9999,0,9999,0
1668067137113,ECE 200,039,103624,Rao; Ramesh R,9999,0,9999,0
1668067137113,ECE 200,040,103625,Rebeiz; Gabriel,9999,0,9999,0
1668067137113,ECE 200,041,103626,Sanford; John R,9999,0,9999,0
1668067137113,ECE 200,042,103627,Siegel; Paul H.,9999,0,9999,0
1668067137113,ECE 200,043,103628,Sievenpiper; Daniel F.,9999,0,9999,0
1668067137113,ECE 200,044,103629,Sworder; David D.,9999,0,9999,0
1668067137113,ECE 200,045,103630,Taur; Yuan,9999,0,9999,0
1668067137113,ECE 200,046,103631,Touri; Behrouz,9999,0,9999,0
1668067137113,ECE 200,047,103632,Trivedi; Mohan M.,9999,0,9999,0
1668067137113,ECE 200,048,103633,Vasconcelos; Nuno,9999,0,9999,0
1668067137113,ECE 200,049,103634,Wang; Xiaolong,9999,0,9999,0
1668067137113,ECE 200,050,103635,Xie; Pengtao,9999,0,9999,0
1668067137113,ECE 200,051,103636,Yip; Michael,9999,0,9999,0
1668067137113,ECE 200,052,103637,Zeger; Kenneth A.,999,0,999,0
1668067137113,ECE 200,053,103638,Zhang; Xinyu,9999,0,9999,0
1668067137113,ECE 200,054,103639,Turakhia; Yatish Girish,9999,0,9999,0
1668067137113,ECE 200,055,103640,Kang; Mingu,9999,0,9999,0
1668067137113,ECE 200,056,103641,Shi; Yuanyuan,9999,0,9999,0
1668067137113,ECE 200,057,103642,Wang; Edward Jay,9999,0,9999,0
1668067137113,ECE 200,058,103643,Zheng; Yang,9999,0,9999,0
1668067137539,ECE 202,A00,103644,Kuzum; Duygu,0,0,0,0
1668067137971,ECE 212BN,A00,103646,Ng; Tse Nga,0,0,0,0
1668067138395,ECE 221,A00,111493,Staff,0,0,0,0
1668067138831,ECE 222B,A00,103647,Lomakin; Vitaliy,0,0,0,0
1668067139265,ECE 230B,A00,103648,Taur; Yuan,0,0,0,0
1668067139688,ECE 238B,A00,103649,Garay; Javier,0,0,0,0
1668067140215,ECE 240B,A00,112900,Fainman; Yeshaiahu,0,0,0,0
1668067140643,ECE 247A,A00,103650,Jokerst; Jesse Vincent,0,0,0,0
1668067141066,ECE 247B,A00,103651,Wang; Joseph,0,0,0,0
1668067141497,ECE 250,A00,103652,Siegel; Paul H.,0,0,0,0
1668067141923,ECE 251A,A00,103654,Rao; Bhaskar D.,0,0,0,0
1668067142347,ECE 257B,A00,103655,Bharadia; Dinesh,0,0,0,0
1668067142769,ECE 258A,A00,103656,Milstein; Laurence B.,0,0,0,0
1668067143194,ECE 260B,A00,103658,Kang; Mingu,0,0,0,0
1668067143623,ECE 264A,A00,103659,Galton; Ian A,0,0,0,0
1668067144048,ECE 265A,A00,103661,Gudem; Prasad S.S.,0,0,0,0
1668067144472,ECE 265D,A00,103662,Gudem; Prasad S.S.,0,0,0,0
1668067144895,ECE 268,A00,103663,Koushanfar; Farinaz,0,0,0,0
1668067145322,ECE 269,A01,103665,Pal; Piya,0,0,0,0
1668067145749,ECE 271B,A00,103666,Vasconcelos; Manuela,0,0,0,0
1668067146178,ECE 276A,A00,103667,Atanasov; Nikolay A.,0,0,0,0
1668067146600,ECE 277,A00,103668,An; Cheolhong,0,0,0,0
1668067147022,ECE 279,A00,117947,Hall; Drew A.,0,0,0,0
1668067147874,ECE 283,A00,103670,Hsueh; Tzu-Chien,0,0,0,0
1668067148298,ECE 284,A00,103671,Turakhia; Yatish Girish,0,0,0,0
1668067148721,ECE 285,A00,103672,Zheng; Yang,0,0,0,0
1668067148721,ECE 285,B00,103673,Sworder; David D.,0,0,0,0
1668067149154,ECE 287,A00,103676,Javidi; Tara,0,0,0,0
1668067149581,MATH 200B,A00,098023,Salehi Golsefidy; Alireza,13,0,15,2
1668067150006,MATH 202B,A00,098024,Rhoades; Brendon Patrick,9,0,15,6
1668067150433,MATH 203B,A00,098025,Oprea; Dragos N.,10,0,15,5
1668067150870,MATH 204B,A00,098026,Sorensen; Claus M,13,0,15,2
1668067151292,MATH 208,A00,098027,Izadi; Elham,7,0,10,3
1668067151716,MATH 209,A00,098028,Pollack; Aaron,10,0,10,0
1668067152143,MATH 211A,A00,112919,Rogalski; Daniel,9,0,10,1
1668067152570,MATH 211B,A00,112920,Seward; Brandon M.,9,0,10,1
1668067152997,MATH 218,A00,098029,Li; Bo,10,0,10,0
1668067153420,MATH 220B,A00,098030,Novak; Jonathan I,12,0,15,3
1668067153845,MATH 221A,A00,098031,Ebenfelt; Peter F,13,0,15,2
1668067154285,MATH 231B,A00,098032,Zlatos; Andrej,12,0,15,3
1668067154710,MATH 240B,A00,098033,Ni; Lei,9,0,15,6
1668067155140,MATH 243,A00,098034,Jekel; David Andrew,10,0,10,0
1668067155565,MATH 245A,A00,098035,Nie; Jiawang,0,0,15,16
1668067155989,MATH 248,A00,098036,Bejenaru; Ioan,10,0,10,0
1668067156416,MATH 250B,A00,098037,Spolaor; Luca,14,0,15,1
1668067156840,MATH 258,A00,098038,Ni; Lei,10,0,10,0
1668067157267,MATH 264B,A00,098041,Rhoades; Brendon Patrick,10,0,15,5
1668067157691,MATH 268,A00,098042,Buss; Samuel R,10,0,10,0
1668067158124,MATH 269,A00,098043,Rhoades; Brendon Patrick,10,0,10,0
1668067158550,MATH 270B,A00,098044,Li; Bo,11,0,15,4
1668067158985,MATH 272B,A00,098045,Holst; Michael J,13,0,15,2
1668067159413,MATH 273A,A00,098046,Tian; Xiaochuan,10,0,15,5
1668067159841,MATH 275,A01,098048,Tian; Xiaochuan,6,0,10,4
1668067160266,MATH 278A,A00,098049,Holst; Michael J,8,0,10,2
1668067160690,MATH 278B,A00,098050,Cloninger; Alexander,10,0,10,0
1668067161116,MATH 278C,A00,098051,Nie; Jiawang,7,0,10,3
1668067161555,MATH 280B,A00,098052,Zheng; Tianyi,10,0,15,5
1668067161977,MATH 281B,A00,098053,Bradic; Jelena,3,0,15,12
1668067162401,MATH 282B,A00,098054,Arias-Castro; Ery,0,0,15,15
1668067162839,MATH 285,A00,098055,Fitzsimmons; Patrick J,0,0,15,17
1668067163261,MATH 287B,A00,098056,Arias-Castro; Ery,3,0,15,12
1668067163694,MATH 288,A00,098057,Agarwal; Pooja,9,0,10,1
1668067163694,MATH 288,B00,098058,Zhang; Danna,8,0,10,2
1668067163694,MATH 288,C00,098059,Williams; Ruth J,10,0,10,0
1668067164117,MATH 290B,A00,098060,Roberts; Justin Deritter,13,0,15,2
1668067164538,MATH 292,A00,098061,Belmont; Eva Kinoshita,10,0,10,0
1668067164961,MATH 295,A00,098062,Suk; Andrew Hoon,48,0,50,2
1668067165384,MATH 296,A00,098063,Novak; Jonathan I,20,0,20,0
1668067165806,MATH 297,001,098064,Gamst; Anthony Collins,9997,0,9999,2
1668067680298,COGS 205,A00,101395,Chiba; Andrea,19,0,20,1
1668067680737,COGS 210B,001,101404,Greene; Deanna Jacquelyn,9998,0,9999,1
1668067680737,COGS 210B,002,101417,Xia; Haijun,9999,0,9999,0
1668067680737,COGS 210B,003,101422,Nitz; Douglas A.,9999,0,9999,0
1668067680737,COGS 210B,004,101423,Hollan; James D.,9998,0,9999,1
1668067680737,COGS 210B,005,101424,Deak; Gedeon O.,9998,0,9999,1
1668067680737,COGS 210B,006,101425,Rossano; Federico,9999,0,9999,0
1668067681183,COGS 211B,A00,101427,Coulson; Seana M,9996,0,9999,3
1668067681618,COGS 220,A00,101428,Hollan; James D.,0,0,25,25
1668067682049,COGS 229,A00,101429,Dow; Steven P,18,0,25,7
1668067682488,COGS 230,A00,101430,Klemmer; Scott R,13,0,17,4
1668067682915,COGS 234,A00,101431,Xia; Haijun,3,0,25,22
1668067683339,COGS 260,A00,101432,Kiyonaga; Anastasia,19,0,25,6
1668067683339,COGS 260,B00,101433,Kirsh; David Joel,16,0,25,9
1668067683763,CSE 202,A00,102371,Impagliazzo; Russell,0,0,0,0
1668067684189,CSE 203B,A01,102373,Cheng; Chung Kuan,0,0,0,0
1668067684618,CSE 208,A00,102374,Micciancio; Daniele,0,0,0,0
1668067685047,CSE 209A,A00,112895,Impagliazzo; Russell,0,0,15,15
1668067685471,CSE 209B,A00,108005,Bellare; Mihir,0,0,0,0
1668067685902,CSE 210,A00,113163,Coblenz; Michael J,0,0,0,0
1668067686329,CSE 219,A00,106111,Dow; Steven P,0,0,20,20
1668067686761,CSE 221,A00,102376,Voelker; Geoffrey M.,0,0,0,0
1668067687191,CSE 224,A01,102378,Porter; George M,0,0,0,0
1668067687624,CSE 229A,A00,102379,Savage; Stefan,0,0,0,0
1668067688058,CSE 229C,A00,102380,Munyaka; Imani N. S.,0,0,0,0
1668067688500,CSE 232B,A00,102382,Deutsch; Alin Bernard,0,0,0,0
1668067688942,CSE 234,A01,112904,Kumar; Arun Kumar,0,0,0,0
1668067689374,CSE 237A,A00,102383,Rosing; Tajana Simunic,0,0,0,0
1668067689808,CSE 239A,A00,102384,Deutsch; Alin Bernard,0,0,0,0
1668067690238,CSE 239B,A00,102385,Polikarpova; Nadezhda,0,0,0,0
1668067690679,CSE 240A,A00,102386,Pannuto; Patrick William,0,0,0,0
1668067691115,CSE 240B,A00,102387,Zhao; Jishen,0,0,0,0
1668067691546,CSE 241A,A00,106406,Kang; Mingu,0,0,0,0
1668067691985,CSE 249B,A00,102388,Kahng; Andrew Byun,0,0,8,8
1668067692428,CSE 251B,A01,102392,Cottrell; Garrison W,0,0,0,0
1668067692428,CSE 251B,A02,102393,Cottrell; Garrison W,0,0,0,0
1668067692852,CSE 252B,A00,102394,Ochoa; Benjamin Lawrence,0,0,0,0
1668067693288,CSE 257,A01,102396,Gao; Sicun,0,0,0,0
1668067693712,CSE 272,A00,102397,Li; Tzumao,0,0,0,0
1668067694135,CSE 274,A00,111323,Chern; Albert Ren-Haur,0,0,0,0
1668067694559,CSE 282,A00,102398,Pevzner; Pavel Arkadjevich,0,0,0,0
1668067694982,CSE 284,A00,114175,Gymrek; Melissa Ann,0,0,0,0
1668067695409,CSE 290,A00,102399,Chandraker; Manmohan Krishna,0,0,0,0
1668067695409,CSE 290,B00,102400,Vaccaro; Kristen Marie,0,0,25,25
1668067695409,CSE 290,C00,102414,Pannuto; Patrick William,0,0,25,25
1668067695409,CSE 290,D00,102427,Pevzner; Pavel Arkadjevich,0,0,0,0
1668067695409,CSE 290,E00,102429,Zhao; Jishen,0,0,0,0
1668067695409,CSE 290,F00,102436,Tullsen; Dean Michael,0,0,0,0
1668067695409,CSE 290,G00,102440,Christensen; Henrik I,0,0,20,20
1668067695835,CSE 291,A00,102443,Su; Hao,0,0,0,0
1668067695835,CSE 291,B00,102448,Polikarpova; Nadezhda,0,0,0,0
1668067695835,CSE 291,C00,102453,Vaccaro; Kristen Marie,0,0,0,0
1668067695835,CSE 291,D00,111343,Savage; Stefan,0,0,0,0
1668067695835,CSE 291,E00,116474,Claffy; Kimberly Claire,0,0,0,0
1668067695835,CSE 291,F00,116479,Pasquale; Joseph,0,0,0,0
1668067696266,CSE 293,001,119111,Bafna; Vineet,9999,0,9999,0
1668067696266,CSE 293,002,119118,Bellare; Mihir,9999,0,9999,0
1668067696266,CSE 293,003,119122,Berg-Kirkpatrick; Taylor D,9999,0,9999,0
1668067696266,CSE 293,004,119135,Christensen; Henrik I,9999,0,9999,0
1668067696266,CSE 293,005,119142,Cottrell; Garrison W,9999,0,9999,0
1668067696266,CSE 293,006,119146,Deutsch; Alin Bernard,9999,0,9999,0
1668067696266,CSE 293,007,119159,Esmaeilzadeh; Hadi,9999,0,9999,0
1668067696266,CSE 293,008,119166,Freund; Yoav,9999,0,9999,0
1668067696266,CSE 293,009,119170,Griswold; William G.,9999,0,9999,0
1668067696266,CSE 293,010,119183,Gymrek; Melissa Ann,9999,0,9999,0
1668067696266,CSE 293,011,119190,Heninger; Nadia A,9999,0,9999,0
1668067696266,CSE 293,012,119230,Impagliazzo; Russell,9999,0,9999,0
1668067696266,CSE 293,013,119232,Jhala; Ranjit,9999,0,9999,0
1668067696266,CSE 293,014,119233,Kahng; Andrew Byun,9999,0,9999,0
1668067696266,CSE 293,015,119298,Kane; Daniel Mertz,9999,0,9999,0
1668067696266,CSE 293,016,119299,Kriegman; David J,9999,0,9999,0
1668067696266,CSE 293,017,119300,Kumar; Arun Kumar,9999,0,9999,0
1668067696266,CSE 293,018,119301,Lerner; Sorin,9999,0,9999,0
1668067696266,CSE 293,019,119302,Lovett; Shachar,9999,0,9999,0
1668067696266,CSE 293,020,119303,McAuley; Julian John,9999,0,9999,0
1668067696266,CSE 293,021,119304,Micciancio; Daniele,9999,0,9999,0
1668067696266,CSE 293,022,119367,Orailoglu; Alex,9999,0,9999,0
1668067696266,CSE 293,023,119382,Paturi; Ramamohan,9999,0,9999,0
1668067696266,CSE 293,024,119404,Polikarpova; Nadezhda,9999,0,9999,0
1668067696266,CSE 293,025,119406,Politz; Joseph Gibbs,9999,0,9999,0
1668067696266,CSE 293,026,119411,Porter; George M,9999,0,9999,0
1668067696266,CSE 293,027,119414,Porter; Leonard Emerson,9999,0,9999,0
1668067696266,CSE 293,028,119416,Ramamoorthi; Ravi,9999,0,9999,0
1668067696266,CSE 293,029,119417,Sahoo; Debashis,9999,0,9999,0
1668067696266,CSE 293,030,119420,Saul; Lawrence,9999,0,9999,0
1668067696266,CSE 293,031,119421,Savage; Stefan,9999,0,9999,0
1668067696266,CSE 293,032,119425,Schulze; Jurgen P.,9999,0,9999,0
1668067696266,CSE 293,033,119426,Snoeren; Alex C.,9999,0,9999,0
1668067696266,CSE 293,034,119428,Shang; Jingbo,9999,0,9999,0
1668067696266,CSE 293,035,119430,Stefan; Deian,9999,0,9999,0
1668067696266,CSE 293,036,119431,Su; Hao,9999,0,9999,0
1668067696266,CSE 293,037,119433,Swanson; Steven James,9999,0,9999,0
1668067696266,CSE 293,038,119435,Tullsen; Dean Michael,9999,0,9999,0
1668067696266,CSE 293,039,119483,Voelker; Geoffrey M.,9999,0,9999,0
1668067696266,CSE 293,040,119537,Zhao; Jishen,9999,0,9999,0
1668067696266,CSE 293,041,119538,Zhou; Yuan-Yuan,9999,0,9999,0
1668067696266,CSE 293,042,119539,Gao; Sicun,9999,0,9999,0
1668067696266,CSE 293,043,119540,Weibel; Nadir,9999,0,9999,0
1668067696266,CSE 293,044,119541,Gupta; Rajesh K.,9999,0,9999,0
1668067696266,CSE 293,045,126410,Vaccaro; Kristen Marie,9999,0,9999,0
1668067696266,CSE 293,046,126411,Klemke; Richard,9999,0,9999,0
1668067696690,CSE 294,A00,102459,Voelker; Geoffrey M.,0,0,0,0
1668067696690,CSE 294,B00,111322,Orailoglu; Alex,0,0,0,0
1668067697119,DSE 201,A00,096914,Deutsch; Alin Bernard,30,0,30,0
1668067697556,DSE 210,A00,096915,Dasgupta; Sanjoy,30,0,30,0
1668067697985,DSE 260A,A00,096916,Altintas De Callaf; Ilkay,30,0,30,0
1668067698415,ECE 200,001,103586,Antipa; Nicholas A,9999,0,9999,0
1668067698415,ECE 200,002,103587,Atanasov; Nikolay A.,9999,0,9999,0
1668067698415,ECE 200,003,103588,Bharadia; Dinesh,9999,0,9999,0
1668067698415,ECE 200,004,103589,Cheng; Chung Kuan,9999,0,9999,0
1668067698415,ECE 200,005,103590,Cosman; Pamela C.,9999,0,9999,0
1668067698415,ECE 200,006,103591,Dayeh; Shadi Ahmad,9999,0,9999,0
1668067698415,ECE 200,007,103592,Fainman; Yeshaiahu,9999,0,9999,0
1668067698415,ECE 200,008,103593,Ford; Joseph Earl,9999,0,9999,0
1668067698415,ECE 200,009,103594,Franceschetti; Massimo,9999,0,9999,0
1668067698415,ECE 200,010,103595,Fullerton; Eric E,9999,0,9999,0
1668067698415,ECE 200,011,103596,Galton; Ian A,9999,0,9999,0
1668067698415,ECE 200,012,103597,Gilja; Vikash,9999,0,9999,0
1668067698415,ECE 200,013,103598,Hall; Drew A.,9999,0,9999,0
1668067698415,ECE 200,014,103599,Hsueh; Tzu-Chien,9999,0,9999,0
1668067698415,ECE 200,015,103600,Javidi; Tara,9999,0,9999,0
1668067698415,ECE 200,016,103601,Kahng; Andrew Byun,9999,0,9999,0
1668067698415,ECE 200,017,103602,Kim; Young-Han,9999,0,9999,0
1668067698415,ECE 200,018,103603,Koushanfar; Farinaz,9999,0,9999,0
1668067698415,ECE 200,019,103604,Kuzum; Duygu,9999,0,9999,0
1668067698415,ECE 200,020,103605,Le; Hanh-Phuc,9999,0,9999,0
1668067698415,ECE 200,021,103606,Lin; Bill,9999,0,9999,0
1668067698415,ECE 200,022,103607,Liu; Zhaowei,9998,0,9999,1
1668067698415,ECE 200,023,103608,Lo; Yu-Hwa,9999,0,9999,0
1668067698415,ECE 200,024,103609,Lomakin; Vitaliy,9999,0,9999,0
1668067698415,ECE 200,025,103610,Mercier; Patrick Philip,9999,0,9999,0
1668067698415,ECE 200,026,103611,Meyer; Florian,9999,0,9999,0
1668067698415,ECE 200,027,103612,Milstein; Laurence B.,9999,0,9999,0
1668067698415,ECE 200,028,103613,Mir Arabbaygi; Siavash,9999,0,9999,0
1668067698415,ECE 200,029,103614,Mookherjea; Shayan,9999,0,9999,0
1668067698415,ECE 200,030,103615,Morris; Karcher William,9999,0,9999,0
1668067698415,ECE 200,031,103616,Ng; Tse Nga,9999,0,9999,0
1668067698415,ECE 200,032,103617,Nguyen; Truong Quang,9999,0,9999,0
1668067698415,ECE 200,033,103618,Nomura; Kenji,9999,0,9999,0
1668067698415,ECE 200,034,103619,Orlitsky; Alon,9999,0,9999,0
1668067698415,ECE 200,035,103620,Pal; Piya,9999,0,9999,0
1668067698415,ECE 200,036,103621,Papen; George C.,9999,0,9999,0
1668067698415,ECE 200,037,103622,Radic; Stojan,9999,0,9999,0
1668067698415,ECE 200,038,103623,Rao; Bhaskar D.,9999,0,9999,0
1668067698415,ECE 200,039,103624,Rao; Ramesh R,9999,0,9999,0
1668067698415,ECE 200,040,103625,Rebeiz; Gabriel,9999,0,9999,0
1668067698415,ECE 200,041,103626,Sanford; John R,9999,0,9999,0
1668067698415,ECE 200,042,103627,Siegel; Paul H.,9999,0,9999,0
1668067698415,ECE 200,043,103628,Sievenpiper; Daniel F.,9999,0,9999,0
1668067698415,ECE 200,044,103629,Sworder; David D.,9999,0,9999,0
1668067698415,ECE 200,045,103630,Taur; Yuan,9999,0,9999,0
1668067698415,ECE 200,046,103631,Touri; Behrouz,9999,0,9999,0
1668067698415,ECE 200,047,103632,Trivedi; Mohan M.,9999,0,9999,0
1668067698415,ECE 200,048,103633,Vasconcelos; Nuno,9999,0,9999,0
1668067698415,ECE 200,049,103634,Wang; Xiaolong,9999,0,9999,0
1668067698415,ECE 200,050,103635,Xie; Pengtao,9999,0,9999,0
1668067698415,ECE 200,051,103636,Yip; Michael,9999,0,9999,0
1668067698415,ECE 200,052,103637,Zeger; Kenneth A.,999,0,999,0
1668067698415,ECE 200,053,103638,Zhang; Xinyu,9999,0,9999,0
1668067698415,ECE 200,054,103639,Turakhia; Yatish Girish,9999,0,9999,0
1668067698415,ECE 200,055,103640,Kang; Mingu,9999,0,9999,0
1668067698415,ECE 200,056,103641,Shi; Yuanyuan,9999,0,9999,0
1668067698415,ECE 200,057,103642,Wang; Edward Jay,9999,0,9999,0
1668067698415,ECE 200,058,103643,Zheng; Yang,9999,0,9999,0
1668067698859,ECE 202,A00,103644,Kuzum; Duygu,0,0,0,0
1668067699283,ECE 212BN,A00,103646,Ng; Tse Nga,0,0,0,0
1668067699708,ECE 221,A00,111493,Staff,0,0,0,0
1668067700133,ECE 222B,A00,103647,Lomakin; Vitaliy,0,0,0,0
1668067700557,ECE 230B,A00,103648,Taur; Yuan,0,0,0,0
1668067700982,ECE 238B,A00,103649,Garay; Javier,0,0,0,0
1668067701431,ECE 240B,A00,112900,Fainman; Yeshaiahu,0,0,0,0
1668067701857,ECE 247A,A00,103650,Jokerst; Jesse Vincent,0,0,0,0
1668067702282,ECE 247B,A00,103651,Wang; Joseph,0,0,0,0
1668067702708,ECE 250,A00,103652,Siegel; Paul H.,0,0,0,0
1668067703141,ECE 251A,A00,103654,Rao; Bhaskar D.,0,0,0,0
1668067703567,ECE 257B,A00,103655,Bharadia; Dinesh,0,0,0,0
1668067703995,ECE 258A,A00,103656,Milstein; Laurence B.,0,0,0,0
1668067704421,ECE 260B,A00,103658,Kang; Mingu,0,0,0,0
1668067704849,ECE 264A,A00,103659,Galton; Ian A,0,0,0,0
1668067705274,ECE 265A,A00,103661,Gudem; Prasad S.S.,0,0,0,0
1668067705706,ECE 265D,A00,103662,Gudem; Prasad S.S.,0,0,0,0
1668067706133,ECE 268,A00,103663,Koushanfar; Farinaz,0,0,0,0
1668067706558,ECE 269,A01,103665,Pal; Piya,0,0,0,0
1668067706994,ECE 271B,A00,103666,Vasconcelos; Manuela,0,0,0,0
1668067707425,ECE 276A,A00,103667,Atanasov; Nikolay A.,0,0,0,0
1668067707847,ECE 277,A00,103668,An; Cheolhong,0,0,0,0
1668067708274,ECE 279,A00,117947,Hall; Drew A.,0,0,0,0
1668067709138,ECE 283,A00,103670,Hsueh; Tzu-Chien,0,0,0,0
1668067709568,ECE 284,A00,103671,Turakhia; Yatish Girish,0,0,0,0
1668067709998,ECE 285,A00,103672,Zheng; Yang,0,0,0,0
1668067709998,ECE 285,B00,103673,Sworder; David D.,0,0,0,0
1668067710420,ECE 287,A00,103676,Javidi; Tara,0,0,0,0
1668067710856,MATH 200B,A00,098023,Salehi Golsefidy; Alireza,13,0,15,2
1668067711289,MATH 202B,A00,098024,Rhoades; Brendon Patrick,9,0,15,6
1668067711723,MATH 203B,A00,098025,Oprea; Dragos N.,10,0,15,5
1668067712145,MATH 204B,A00,098026,Sorensen; Claus M,13,0,15,2
1668067712573,MATH 208,A00,098027,Izadi; Elham,7,0,10,3
1668067712997,MATH 209,A00,098028,Pollack; Aaron,10,0,10,0
1668067713418,MATH 211A,A00,112919,Rogalski; Daniel,9,0,10,1
1668067713848,MATH 211B,A00,112920,Seward; Brandon M.,9,0,10,1
1668067714272,MATH 218,A00,098029,Li; Bo,10,0,10,0
1668067714695,MATH 220B,A00,098030,Novak; Jonathan I,12,0,15,3
1668067715124,MATH 221A,A00,098031,Ebenfelt; Peter F,13,0,15,2
1668067715557,MATH 231B,A00,098032,Zlatos; Andrej,12,0,15,3
1668067715981,MATH 240B,A00,098033,Ni; Lei,9,0,15,6
1668067716417,MATH 243,A00,098034,Jekel; David Andrew,10,0,10,0
1668067716841,MATH 245A,A00,098035,Nie; Jiawang,0,0,15,16
1668067717264,MATH 248,A00,098036,Bejenaru; Ioan,10,0,10,0
1668067717695,MATH 250B,A00,098037,Spolaor; Luca,14,0,15,1
1668067718224,MATH 258,A00,098038,Ni; Lei,10,0,10,0
1668067718652,MATH 264B,A00,098041,Rhoades; Brendon Patrick,10,0,15,5
1668067719079,MATH 268,A00,098042,Buss; Samuel R,10,0,10,0
1668067719505,MATH 269,A00,098043,Rhoades; Brendon Patrick,10,0,10,0
1668067719935,MATH 270B,A00,098044,Li; Bo,11,0,15,4
1668067720359,MATH 272B,A00,098045,Holst; Michael J,13,0,15,2
1668067720784,MATH 273A,A00,098046,Tian; Xiaochuan,10,0,15,5
1668067721209,MATH 275,A01,098048,Tian; Xiaochuan,6,0,10,4
1668067721632,MATH 278A,A00,098049,Holst; Michael J,8,0,10,2
1668067722057,MATH 278B,A00,098050,Cloninger; Alexander,10,0,10,0
1668067722483,MATH 278C,A00,098051,Nie; Jiawang,7,0,10,3
1668067722909,MATH 280B,A00,098052,Zheng; Tianyi,10,0,15,5
1668067723344,MATH 281B,A00,098053,Bradic; Jelena,3,0,15,12
1668067723768,MATH 282B,A00,098054,Arias-Castro; Ery,0,0,15,15
1668067724215,MATH 285,A00,098055,Fitzsimmons; Patrick J,0,0,15,17
1668067724642,MATH 287B,A00,098056,Arias-Castro; Ery,3,0,15,12
1668067725071,MATH 288,A00,098057,Agarwal; Pooja,9,0,10,1
1668067725071,MATH 288,B00,098058,Zhang; Danna,8,0,10,2
1668067725071,MATH 288,C00,098059,Williams; Ruth J,10,0,10,0
1668067725493,MATH 290B,A00,098060,Roberts; Justin Deritter,13,0,15,2
1668067725921,MATH 292,A00,098061,Belmont; Eva Kinoshita,10,0,10,0
1668067726351,MATH 295,A00,098062,Suk; Andrew Hoon,48,0,50,2
1668067726778,MATH 296,A00,098063,Novak; Jonathan I,20,0,20,0
1668067727207,MATH 297,001,098064,Gamst; Anthony Collins,9997,0,9999,2
1668068239959,COGS 205,A00,101395,Chiba; Andrea,19,0,20,1
1668068240385,COGS 210B,001,101404,Greene; Deanna Jacquelyn,9998,0,9999,1
1668068240385,COGS 210B,002,101417,Xia; Haijun,9999,0,9999,0
1668068240385,COGS 210B,003,101422,Nitz; Douglas A.,9999,0,9999,0
1668068240385,COGS 210B,004,101423,Hollan; James D.,9998,0,9999,1
1668068240385,COGS 210B,005,101424,Deak; Gedeon O.,9998,0,9999,1
1668068240385,COGS 210B,006,101425,Rossano; Federico,9999,0,9999,0
1668068240814,COGS 211B,A00,101427,Coulson; Seana M,9996,0,9999,3
1668068241238,COGS 220,A00,101428,Hollan; James D.,0,0,25,25
1668068241663,COGS 229,A00,101429,Dow; Steven P,18,0,25,7
1668068242093,COGS 230,A00,101430,Klemmer; Scott R,13,0,17,4
1668068242519,COGS 234,A00,101431,Xia; Haijun,3,0,25,22
1668068242946,COGS 260,A00,101432,Kiyonaga; Anastasia,19,0,25,6
1668068242946,COGS 260,B00,101433,Kirsh; David Joel,16,0,25,9
1668068243383,CSE 202,A00,102371,Impagliazzo; Russell,0,0,0,0
1668068243816,CSE 203B,A01,102373,Cheng; Chung Kuan,0,0,0,0
1668068244265,CSE 208,A00,102374,Micciancio; Daniele,0,0,0,0
1668068244695,CSE 209A,A00,112895,Impagliazzo; Russell,0,0,15,15
1668068245121,CSE 209B,A00,108005,Bellare; Mihir,0,0,0,0
1668068245544,CSE 210,A00,113163,Coblenz; Michael J,0,0,0,0
1668068245973,CSE 219,A00,106111,Dow; Steven P,0,0,20,20
1668068246405,CSE 221,A00,102376,Voelker; Geoffrey M.,0,0,0,0
1668068246830,CSE 224,A01,102378,Porter; George M,0,0,0,0
1668068247260,CSE 229A,A00,102379,Savage; Stefan,0,0,0,0
1668068247685,CSE 229C,A00,102380,Munyaka; Imani N. S.,0,0,0,0
1668068248112,CSE 232B,A00,102382,Deutsch; Alin Bernard,0,0,0,0
1668068248547,CSE 234,A01,112904,Kumar; Arun Kumar,0,0,0,0
1668068248999,CSE 237A,A00,102383,Rosing; Tajana Simunic,0,0,0,0
1668068249437,CSE 239A,A00,102384,Deutsch; Alin Bernard,0,0,0,0
1668068249873,CSE 239B,A00,102385,Polikarpova; Nadezhda,0,0,0,0
1668068250307,CSE 240A,A00,102386,Pannuto; Patrick William,0,0,0,0
1668068250742,CSE 240B,A00,102387,Zhao; Jishen,0,0,0,0
1668068251262,CSE 241A,A00,106406,Kang; Mingu,0,0,0,0
1668068251707,CSE 249B,A00,102388,Kahng; Andrew Byun,0,0,8,8
1668068252132,CSE 251B,A01,102392,Cottrell; Garrison W,0,0,0,0
1668068252132,CSE 251B,A02,102393,Cottrell; Garrison W,0,0,0,0
1668068252559,CSE 252B,A00,102394,Ochoa; Benjamin Lawrence,0,0,0,0
1668068252987,CSE 257,A01,102396,Gao; Sicun,0,0,0,0
1668068253417,CSE 272,A00,102397,Li; Tzumao,0,0,0,0
1668068253849,CSE 274,A00,111323,Chern; Albert Ren-Haur,0,0,0,0
1668068254277,CSE 282,A00,102398,Pevzner; Pavel Arkadjevich,0,0,0,0
1668068254702,CSE 284,A00,114175,Gymrek; Melissa Ann,0,0,0,0
1668068255128,CSE 290,A00,102399,Chandraker; Manmohan Krishna,0,0,0,0
1668068255128,CSE 290,B00,102400,Vaccaro; Kristen Marie,0,0,25,25
1668068255128,CSE 290,C00,102414,Pannuto; Patrick William,0,0,25,25
1668068255128,CSE 290,D00,102427,Pevzner; Pavel Arkadjevich,0,0,0,0
1668068255128,CSE 290,E00,102429,Zhao; Jishen,0,0,0,0
1668068255128,CSE 290,F00,102436,Tullsen; Dean Michael,0,0,0,0
1668068255128,CSE 290,G00,102440,Christensen; Henrik I,0,0,20,20
1668068255561,CSE 291,A00,102443,Su; Hao,0,0,0,0
1668068255561,CSE 291,B00,102448,Polikarpova; Nadezhda,0,0,0,0
1668068255561,CSE 291,C00,102453,Vaccaro; Kristen Marie,0,0,0,0
1668068255561,CSE 291,D00,111343,Savage; Stefan,0,0,0,0
1668068255561,CSE 291,E00,116474,Claffy; Kimberly Claire,0,0,0,0
1668068255561,CSE 291,F00,116479,Pasquale; Joseph,0,0,0,0
1668068256004,CSE 293,001,119111,Bafna; Vineet,9999,0,9999,0
1668068256004,CSE 293,002,119118,Bellare; Mihir,9999,0,9999,0
1668068256004,CSE 293,003,119122,Berg-Kirkpatrick; Taylor D,9999,0,9999,0
1668068256004,CSE 293,004,119135,Christensen; Henrik I,9999,0,9999,0
1668068256004,CSE 293,005,119142,Cottrell; Garrison W,9999,0,9999,0
1668068256004,CSE 293,006,119146,Deutsch; Alin Bernard,9999,0,9999,0
1668068256004,CSE 293,007,119159,Esmaeilzadeh; Hadi,9999,0,9999,0
1668068256004,CSE 293,008,119166,Freund; Yoav,9999,0,9999,0
1668068256004,CSE 293,009,119170,Griswold; William G.,9999,0,9999,0
1668068256004,CSE 293,010,119183,Gymrek; Melissa Ann,9999,0,9999,0
1668068256004,CSE 293,011,119190,Heninger; Nadia A,9999,0,9999,0
1668068256004,CSE 293,012,119230,Impagliazzo; Russell,9999,0,9999,0
1668068256004,CSE 293,013,119232,Jhala; Ranjit,9999,0,9999,0
1668068256004,CSE 293,014,119233,Kahng; Andrew Byun,9999,0,9999,0
1668068256004,CSE 293,015,119298,Kane; Daniel Mertz,9999,0,9999,0
1668068256004,CSE 293,016,119299,Kriegman; David J,9999,0,9999,0
1668068256004,CSE 293,017,119300,Kumar; Arun Kumar,9999,0,9999,0
1668068256004,CSE 293,018,119301,Lerner; Sorin,9999,0,9999,0
1668068256004,CSE 293,019,119302,Lovett; Shachar,9999,0,9999,0
1668068256004,CSE 293,020,119303,McAuley; Julian John,9999,0,9999,0
1668068256004,CSE 293,021,119304,Micciancio; Daniele,9999,0,9999,0
1668068256004,CSE 293,022,119367,Orailoglu; Alex,9999,0,9999,0
1668068256004,CSE 293,023,119382,Paturi; Ramamohan,9999,0,9999,0
1668068256004,CSE 293,024,119404,Polikarpova; Nadezhda,9999,0,9999,0
1668068256004,CSE 293,025,119406,Politz; Joseph Gibbs,9999,0,9999,0
1668068256004,CSE 293,026,119411,Porter; George M,9999,0,9999,0
1668068256004,CSE 293,027,119414,Porter; Leonard Emerson,9999,0,9999,0
1668068256004,CSE 293,028,119416,Ramamoorthi; Ravi,9999,0,9999,0
1668068256004,CSE 293,029,119417,Sahoo; Debashis,9999,0,9999,0
1668068256004,CSE 293,030,119420,Saul; Lawrence,9999,0,9999,0
1668068256004,CSE 293,031,119421,Savage; Stefan,9999,0,9999,0
1668068256004,CSE 293,032,119425,Schulze; Jurgen P.,9999,0,9999,0
1668068256004,CSE 293,033,119426,Snoeren; Alex C.,9999,0,9999,0
1668068256004,CSE 293,034,119428,Shang; Jingbo,9999,0,9999,0
1668068256004,CSE 293,035,119430,Stefan; Deian,9999,0,9999,0
1668068256004,CSE 293,036,119431,Su; Hao,9999,0,9999,0
1668068256004,CSE 293,037,119433,Swanson; Steven James,9999,0,9999,0
1668068256004,CSE 293,038,119435,Tullsen; Dean Michael,9999,0,9999,0
1668068256004,CSE 293,039,119483,Voelker; Geoffrey M.,9999,0,9999,0
1668068256004,CSE 293,040,119537,Zhao; Jishen,9999,0,9999,0
1668068256004,CSE 293,041,119538,Zhou; Yuan-Yuan,9999,0,9999,0
1668068256004,CSE 293,042,119539,Gao; Sicun,9999,0,9999,0
1668068256004,CSE 293,043,119540,Weibel; Nadir,9999,0,9999,0
1668068256004,CSE 293,044,119541,Gupta; Rajesh K.,9999,0,9999,0
1668068256004,CSE 293,045,126410,Vaccaro; Kristen Marie,9999,0,9999,0
1668068256004,CSE 293,046,126411,Klemke; Richard,9999,0,9999,0
1668068256430,CSE 294,A00,102459,Voelker; Geoffrey M.,0,0,0,0
1668068256430,CSE 294,B00,111322,Orailoglu; Alex,0,0,0,0
1668068256866,DSE 201,A00,096914,Deutsch; Alin Bernard,30,0,30,0
1668068257305,DSE 210,A00,096915,Dasgupta; Sanjoy,30,0,30,0
1668068257748,DSE 260A,A00,096916,Altintas De Callaf; Ilkay,30,0,30,0
1668068258195,ECE 200,001,103586,Antipa; Nicholas A,9999,0,9999,0
1668068258195,ECE 200,002,103587,Atanasov; Nikolay A.,9999,0,9999,0
1668068258195,ECE 200,003,103588,Bharadia; Dinesh,9999,0,9999,0
1668068258195,ECE 200,004,103589,Cheng; Chung Kuan,9999,0,9999,0
1668068258195,ECE 200,005,103590,Cosman; Pamela C.,9999,0,9999,0
1668068258195,ECE 200,006,103591,Dayeh; Shadi Ahmad,9999,0,9999,0
1668068258195,ECE 200,007,103592,Fainman; Yeshaiahu,9999,0,9999,0
1668068258195,ECE 200,008,103593,Ford; Joseph Earl,9999,0,9999,0
1668068258195,ECE 200,009,103594,Franceschetti; Massimo,9999,0,9999,0
1668068258195,ECE 200,010,103595,Fullerton; Eric E,9999,0,9999,0
1668068258195,ECE 200,011,103596,Galton; Ian A,9999,0,9999,0
1668068258195,ECE 200,012,103597,Gilja; Vikash,9999,0,9999,0
1668068258195,ECE 200,013,103598,Hall; Drew A.,9999,0,9999,0
1668068258195,ECE 200,014,103599,Hsueh; Tzu-Chien,9999,0,9999,0
1668068258195,ECE 200,015,103600,Javidi; Tara,9999,0,9999,0
1668068258195,ECE 200,016,103601,Kahng; Andrew Byun,9999,0,9999,0
1668068258195,ECE 200,017,103602,Kim; Young-Han,9999,0,9999,0
1668068258195,ECE 200,018,103603,Koushanfar; Farinaz,9999,0,9999,0
1668068258195,ECE 200,019,103604,Kuzum; Duygu,9999,0,9999,0
1668068258195,ECE 200,020,103605,Le; Hanh-Phuc,9999,0,9999,0
1668068258195,ECE 200,021,103606,Lin; Bill,9999,0,9999,0
1668068258195,ECE 200,022,103607,Liu; Zhaowei,9998,0,9999,1
1668068258195,ECE 200,023,103608,Lo; Yu-Hwa,9999,0,9999,0
1668068258195,ECE 200,024,103609,Lomakin; Vitaliy,9999,0,9999,0
1668068258195,ECE 200,025,103610,Mercier; Patrick Philip,9999,0,9999,0
1668068258195,ECE 200,026,103611,Meyer; Florian,9999,0,9999,0
1668068258195,ECE 200,027,103612,Milstein; Laurence B.,9999,0,9999,0
1668068258195,ECE 200,028,103613,Mir Arabbaygi; Siavash,9999,0,9999,0
1668068258195,ECE 200,029,103614,Mookherjea; Shayan,9999,0,9999,0
1668068258195,ECE 200,030,103615,Morris; Karcher William,9999,0,9999,0
1668068258195,ECE 200,031,103616,Ng; Tse Nga,9999,0,9999,0
1668068258195,ECE 200,032,103617,Nguyen; Truong Quang,9999,0,9999,0
1668068258195,ECE 200,033,103618,Nomura; Kenji,9999,0,9999,0
1668068258195,ECE 200,034,103619,Orlitsky; Alon,9999,0,9999,0
1668068258195,ECE 200,035,103620,Pal; Piya,9999,0,9999,0
1668068258195,ECE 200,036,103621,Papen; George C.,9999,0,9999,0
1668068258195,ECE 200,037,103622,Radic; Stojan,9999,0,9999,0
1668068258195,ECE 200,038,103623,Rao; Bhaskar D.,9999,0,9999,0
1668068258195,ECE 200,039,103624,Rao; Ramesh R,9999,0,9999,0
1668068258195,ECE 200,040,103625,Rebeiz; Gabriel,9999,0,9999,0
1668068258195,ECE 200,041,103626,Sanford; John R,9999,0,9999,0
1668068258195,ECE 200,042,103627,Siegel; Paul H.,9999,0,9999,0
1668068258195,ECE 200,043,103628,Sievenpiper; Daniel F.,9999,0,9999,0
1668068258195,ECE 200,044,103629,Sworder; David D.,9999,0,9999,0
1668068258195,ECE 200,045,103630,Taur; Yuan,9999,0,9999,0
1668068258195,ECE 200,046,103631,Touri; Behrouz,9999,0,9999,0
1668068258195,ECE 200,047,103632,Trivedi; Mohan M.,9999,0,9999,0
1668068258195,ECE 200,048,103633,Vasconcelos; Nuno,9999,0,9999,0
1668068258195,ECE 200,049,103634,Wang; Xiaolong,9999,0,9999,0
1668068258195,ECE 200,050,103635,Xie; Pengtao,9999,0,9999,0
1668068258195,ECE 200,051,103636,Yip; Michael,9999,0,9999,0
1668068258195,ECE 200,052,103637,Zeger; Kenneth A.,999,0,999,0
1668068258195,ECE 200,053,103638,Zhang; Xinyu,9999,0,9999,0
1668068258195,ECE 200,054,103639,Turakhia; Yatish Girish,9999,0,9999,0
1668068258195,ECE 200,055,103640,Kang; Mingu,9999,0,9999,0
1668068258195,ECE 200,056,103641,Shi; Yuanyuan,9999,0,9999,0
1668068258195,ECE 200,057,103642,Wang; Edward Jay,9999,0,9999,0
1668068258195,ECE 200,058,103643,Zheng; Yang,9999,0,9999,0
1668068258619,ECE 202,A00,103644,Kuzum; Duygu,0,0,0,0
1668068259046,ECE 212BN,A00,103646,Ng; Tse Nga,0,0,0,0
1668068259474,ECE 221,A00,111493,Staff,0,0,0,0
1668068259902,ECE 222B,A00,103647,Lomakin; Vitaliy,0,0,0,0
1668068260333,ECE 230B,A00,103648,Taur; Yuan,0,0,0,0
1668068260758,ECE 238B,A00,103649,Garay; Javier,0,0,0,0
1668068261187,ECE 240B,A00,112900,Fainman; Yeshaiahu,0,0,0,0
1668068261612,ECE 247A,A00,103650,Jokerst; Jesse Vincent,0,0,0,0
1668068262040,ECE 247B,A00,103651,Wang; Joseph,0,0,0,0
1668068262463,ECE 250,A00,103652,Siegel; Paul H.,0,0,0,0
1668068262888,ECE 251A,A00,103654,Rao; Bhaskar D.,0,0,0,0
1668068263323,ECE 257B,A00,103655,Bharadia; Dinesh,0,0,0,0
1668068263759,ECE 258A,A00,103656,Milstein; Laurence B.,0,0,0,0
1668068264202,ECE 260B,A00,103658,Kang; Mingu,0,0,0,0
1668068264640,ECE 264A,A00,103659,Galton; Ian A,0,0,0,0
1668068265070,ECE 265A,A00,103661,Gudem; Prasad S.S.,0,0,0,0
1668068265499,ECE 265D,A00,103662,Gudem; Prasad S.S.,0,0,0,0
1668068265941,ECE 268,A00,103663,Koushanfar; Farinaz,0,0,0,0
1668068266369,ECE 269,A01,103665,Pal; Piya,0,0,0,0
1668068266794,ECE 271B,A00,103666,Vasconcelos; Manuela,0,0,0,0
1668068267223,ECE 276A,A00,103667,Atanasov; Nikolay A.,0,0,0,0
1668068267650,ECE 277,A00,103668,An; Cheolhong,0,0,0,0
1668068268078,ECE 279,A00,117947,Hall; Drew A.,0,0,0,0
1668068268937,ECE 283,A00,103670,Hsueh; Tzu-Chien,0,0,0,0
1668068269363,ECE 284,A00,103671,Turakhia; Yatish Girish,0,0,0,0
1668068269793,ECE 285,A00,103672,Zheng; Yang,0,0,0,0
1668068269793,ECE 285,B00,103673,Sworder; David D.,0,0,0,0
1668068270219,ECE 287,A00,103676,Javidi; Tara,0,0,0,0
1668068270650,MATH 200B,A00,098023,Salehi Golsefidy; Alireza,13,0,15,2
1668068271077,MATH 202B,A00,098024,Rhoades; Brendon Patrick,9,0,15,6
1668068271505,MATH 203B,A00,098025,Oprea; Dragos N.,10,0,15,5
1668068271938,MATH 204B,A00,098026,Sorensen; Claus M,13,0,15,2
1668068272363,MATH 208,A00,098027,Izadi; Elham,7,0,10,3
1668068272790,MATH 209,A00,098028,Pollack; Aaron,10,0,10,0
1668068273214,MATH 211A,A00,112919,Rogalski; Daniel,9,0,10,1
1668068273641,MATH 211B,A00,112920,Seward; Brandon M.,9,0,10,1
1668068274066,MATH 218,A00,098029,Li; Bo,10,0,10,0
1668068274511,MATH 220B,A00,098030,Novak; Jonathan I,12,0,15,3
1668068274936,MATH 221A,A00,098031,Ebenfelt; Peter F,13,0,15,2
1668068275380,MATH 231B,A00,098032,Zlatos; Andrej,12,0,15,3
1668068275804,MATH 240B,A00,098033,Ni; Lei,9,0,15,6
1668068276229,MATH 243,A00,098034,Jekel; David Andrew,10,0,10,0
1668068276656,MATH 245A,A00,098035,Nie; Jiawang,0,0,15,16
1668068277084,MATH 248,A00,098036,Bejenaru; Ioan,10,0,10,0
1668068277520,MATH 250B,A00,098037,Spolaor; Luca,14,0,15,1
1668068277947,MATH 258,A00,098038,Ni; Lei,10,0,10,0
1668068278380,MATH 264B,A00,098041,Rhoades; Brendon Patrick,10,0,15,5
1668068278807,MATH 268,A00,098042,Buss; Samuel R,10,0,10,0
1668068279243,MATH 269,A00,098043,Rhoades; Brendon Patrick,10,0,10,0
1668068279668,MATH 270B,A00,098044,Li; Bo,11,0,15,4
1668068280102,MATH 272B,A00,098045,Holst; Michael J,13,0,15,2
1668068280535,MATH 273A,A00,098046,Tian; Xiaochuan,10,0,15,5
1668068280971,MATH 275,A01,098048,Tian; Xiaochuan,6,0,10,4
1668068281403,MATH 278A,A00,098049,Holst; Michael J,8,0,10,2
1668068281830,MATH 278B,A00,098050,Cloninger; Alexander,10,0,10,0
1668068282259,MATH 278C,A00,098051,Nie; Jiawang,7,0,10,3
1668068282686,MATH 280B,A00,098052,Zheng; Tianyi,10,0,15,5
1668068283116,MATH 281B,A00,098053,Bradic; Jelena,3,0,15,12
1668068283544,MATH 282B,A00,098054,Arias-Castro; Ery,0,0,15,15
1668068283972,MATH 285,A00,098055,Fitzsimmons; Patrick J,0,0,15,17
1668068284396,MATH 287B,A00,098056,Arias-Castro; Ery,3,0,15,12
1668068284824,MATH 288,A00,098057,Agarwal; Pooja,9,0,10,1
1668068284824,MATH 288,B00,098058,Zhang; Danna,8,0,10,2
1668068284824,MATH 288,C00,098059,Williams; Ruth J,10,0,10,0
1668068285249,MATH 290B,A00,098060,Roberts; Justin Deritter,13,0,15,2
1668068285677,MATH 292,A00,098061,Belmont; Eva Kinoshita,10,0,10,0
1668068286101,MATH 295,A00,098062,Suk; Andrew Hoon,48,0,50,2
1668068286525,MATH 296,A00,098063,Novak; Jonathan I,20,0,20,0
1668068286950,MATH 297,001,098064,Gamst; Anthony Collins,9997,0,9999,2
1668068789651,COGS 205,A00,101395,Chiba; Andrea,19,0,20,1
1668068790077,COGS 210B,001,101404,Greene; Deanna Jacquelyn,9998,0,9999,1
1668068790077,COGS 210B,002,101417,Xia; Haijun,9999,0,9999,0
1668068790077,COGS 210B,003,101422,Nitz; Douglas A.,9999,0,9999,0
1668068790077,COGS 210B,004,101423,Hollan; James D.,9998,0,9999,1
1668068790077,COGS 210B,005,101424,Deak; Gedeon O.,9998,0,9999,1
1668068790077,COGS 210B,006,101425,Rossano; Federico,9999,0,9999,0
1668068790502,COGS 211B,A00,101427,Coulson; Seana M,9996,0,9999,3
1668068790930,COGS 220,A00,101428,Hollan; James D.,0,0,25,25
1668068791354,COGS 229,A00,101429,Dow; Steven P,18,0,25,7
1668068791784,COGS 230,A00,101430,Klemmer; Scott R,13,0,17,4
1668068792208,COGS 234,A00,101431,Xia; Haijun,3,0,25,22
1668068792632,COGS 260,A00,101432,Kiyonaga; Anastasia,19,0,25,6
1668068792632,COGS 260,B00,101433,Kirsh; David Joel,16,0,25,9
1668068793055,CSE 202,A00,102371,Impagliazzo; Russell,0,0,0,0
1668068793483,CSE 203B,A01,102373,Cheng; Chung Kuan,0,0,0,0
1668068793917,CSE 208,A00,102374,Micciancio; Daniele,0,0,0,0
1668068794339,CSE 209A,A00,112895,Impagliazzo; Russell,0,0,15,15
1668068794770,CSE 209B,A00,108005,Bellare; Mihir,0,0,0,0
1668068795195,CSE 210,A00,113163,Coblenz; Michael J,0,0,0,0
1668068795622,CSE 219,A00,106111,Dow; Steven P,0,0,20,20
1668068796045,CSE 221,A00,102376,Voelker; Geoffrey M.,0,0,0,0
1668068796470,CSE 224,A01,102378,Porter; George M,0,0,0,0
1668068796898,CSE 229A,A00,102379,Savage; Stefan,0,0,0,0
1668068797336,CSE 229C,A00,102380,Munyaka; Imani N. S.,0,0,0,0
1668068797769,CSE 232B,A00,102382,Deutsch; Alin Bernard,0,0,0,0
1668068798201,CSE 234,A01,112904,Kumar; Arun Kumar,0,0,0,0
1668068798660,CSE 237A,A00,102383,Rosing; Tajana Simunic,0,0,0,0
1668068799085,CSE 239A,A00,102384,Deutsch; Alin Bernard,0,0,0,0
1668068799509,CSE 239B,A00,102385,Polikarpova; Nadezhda,0,0,0,0
1668068799935,CSE 240A,A00,102386,Pannuto; Patrick William,0,0,0,0
1668068800358,CSE 240B,A00,102387,Zhao; Jishen,0,0,0,0
1668068800784,CSE 241A,A00,106406,Kang; Mingu,0,0,0,0
1668068801219,CSE 249B,A00,102388,Kahng; Andrew Byun,0,0,8,8
1668068801650,CSE 251B,A01,102392,Cottrell; Garrison W,0,0,0,0
1668068801650,CSE 251B,A02,102393,Cottrell; Garrison W,0,0,0,0
1668068802077,CSE 252B,A00,102394,Ochoa; Benjamin Lawrence,0,0,0,0
1668068802508,CSE 257,A01,102396,Gao; Sicun,0,0,0,0
1668068802936,CSE 272,A00,102397,Li; Tzumao,0,0,0,0
1668068803375,CSE 274,A00,111323,Chern; Albert Ren-Haur,0,0,0,0
1668068803799,CSE 282,A00,102398,Pevzner; Pavel Arkadjevich,0,0,0,0
1668068804222,CSE 284,A00,114175,Gymrek; Melissa Ann,0,0,0,0
1668068804646,CSE 290,A00,102399,Chandraker; Manmohan Krishna,0,0,0,0
1668068804646,CSE 290,B00,102400,Vaccaro; Kristen Marie,0,0,25,25
1668068804646,CSE 290,C00,102414,Pannuto; Patrick William,0,0,25,25
1668068804646,CSE 290,D00,102427,Pevzner; Pavel Arkadjevich,0,0,0,0
1668068804646,CSE 290,E00,102429,Zhao; Jishen,0,0,0,0
1668068804646,CSE 290,F00,102436,Tullsen; Dean Michael,0,0,0,0
1668068804646,CSE 290,G00,102440,Christensen; Henrik I,0,0,20,20
1668068805082,CSE 291,A00,102443,Su; Hao,0,0,0,0
1668068805082,CSE 291,B00,102448,Polikarpova; Nadezhda,0,0,0,0
1668068805082,CSE 291,C00,102453,Vaccaro; Kristen Marie,0,0,0,0
1668068805082,CSE 291,D00,111343,Savage; Stefan,0,0,0,0
1668068805082,CSE 291,E00,116474,Claffy; Kimberly Claire,0,0,0,0
1668068805082,CSE 291,F00,116479,Pasquale; Joseph,0,0,0,0
1668068805589,CSE 293,001,119111,Bafna; Vineet,9999,0,9999,0
1668068805589,CSE 293,002,119118,Bellare; Mihir,9999,0,9999,0
1668068805589,CSE 293,003,119122,Berg-Kirkpatrick; Taylor D,9999,0,9999,0
1668068805589,CSE 293,004,119135,Christensen; Henrik I,9999,0,9999,0
1668068805589,CSE 293,005,119142,Cottrell; Garrison W,9999,0,9999,0
1668068805589,CSE 293,006,119146,Deutsch; Alin Bernard,9999,0,9999,0
1668068805589,CSE 293,007,119159,Esmaeilzadeh; Hadi,9999,0,9999,0
1668068805589,CSE 293,008,119166,Freund; Yoav,9999,0,9999,0
1668068805589,CSE 293,009,119170,Griswold; William G.,9999,0,9999,0
1668068805589,CSE 293,010,119183,Gymrek; Melissa Ann,9999,0,9999,0
1668068805589,CSE 293,011,119190,Heninger; Nadia A,9999,0,9999,0
1668068805589,CSE 293,012,119230,Impagliazzo; Russell,9999,0,9999,0
1668068805589,CSE 293,013,119232,Jhala; Ranjit,9999,0,9999,0
1668068805589,CSE 293,014,119233,Kahng; Andrew Byun,9999,0,9999,0
1668068805589,CSE 293,015,119298,Kane; Daniel Mertz,9999,0,9999,0
1668068805589,CSE 293,016,119299,Kriegman; David J,9999,0,9999,0
1668068805589,CSE 293,017,119300,Kumar; Arun Kumar,9999,0,9999,0
1668068805589,CSE 293,018,119301,Lerner; Sorin,9999,0,9999,0
1668068805589,CSE 293,019,119302,Lovett; Shachar,9999,0,9999,0
1668068805589,CSE 293,020,119303,McAuley; Julian John,9999,0,9999,0
1668068805589,CSE 293,021,119304,Micciancio; Daniele,9999,0,9999,0
1668068805589,CSE 293,022,119367,Orailoglu; Alex,9999,0,9999,0
1668068805589,CSE 293,023,119382,Paturi; Ramamohan,9999,0,9999,0
1668068805589,CSE 293,024,119404,Polikarpova; Nadezhda,9999,0,9999,0
1668068805589,CSE 293,025,119406,Politz; Joseph Gibbs,9999,0,9999,0
1668068805589,CSE 293,026,119411,Porter; George M,9999,0,9999,0
1668068805589,CSE 293,027,119414,Porter; Leonard Emerson,9999,0,9999,0
1668068805589,CSE 293,028,119416,Ramamoorthi; Ravi,9999,0,9999,0
1668068805589,CSE 293,029,119417,Sahoo; Debashis,9999,0,9999,0
1668068805589,CSE 293,030,119420,Saul; Lawrence,9999,0,9999,0
1668068805589,CSE 293,031,119421,Savage; Stefan,9999,0,9999,0
1668068805589,CSE 293,032,119425,Schulze; Jurgen P.,9999,0,9999,0
1668068805589,CSE 293,033,119426,Snoeren; Alex C.,9999,0,9999,0
1668068805589,CSE 293,034,119428,Shang; Jingbo,9999,0,9999,0
1668068805589,CSE 293,035,119430,Stefan; Deian,9999,0,9999,0
1668068805589,CSE 293,036,119431,Su; Hao,9999,0,9999,0
1668068805589,CSE 293,037,119433,Swanson; Steven James,9999,0,9999,0
1668068805589,CSE 293,038,119435,Tullsen; Dean Michael,9999,0,9999,0
1668068805589,CSE 293,039,119483,Voelker; Geoffrey M.,9999,0,9999,0
1668068805589,CSE 293,040,119537,Zhao; Jishen,9999,0,9999,0
1668068805589,CSE 293,041,119538,Zhou; Yuan-Yuan,9999,0,9999,0
1668068805589,CSE 293,042,119539,Gao; Sicun,9999,0,9999,0
1668068805589,CSE 293,043,119540,Weibel; Nadir,9999,0,9999,0
1668068805589,CSE 293,044,119541,Gupta; Rajesh K.,9999,0,9999,0
1668068805589,CSE 293,045,126410,Vaccaro; Kristen Marie,9999,0,9999,0
1668068805589,CSE 293,046,126411,Klemke; Richard,9999,0,9999,0
1668068806031,CSE 294,A00,102459,Voelker; Geoffrey M.,0,0,0,0
1668068806031,CSE 294,B00,111322,Orailoglu; Alex,0,0,0,0
1668068806457,DSE 201,A00,096914,Deutsch; Alin Bernard,30,0,30,0
1668068806882,DSE 210,A00,096915,Dasgupta; Sanjoy,30,0,30,0
1668068807316,DSE 260A,A00,096916,Altintas De Callaf; Ilkay,30,0,30,0
1668068807762,ECE 200,001,103586,Antipa; Nicholas A,9999,0,9999,0
1668068807762,ECE 200,002,103587,Atanasov; Nikolay A.,9999,0,9999,0
1668068807762,ECE 200,003,103588,Bharadia; Dinesh,9999,0,9999,0
1668068807762,ECE 200,004,103589,Cheng; Chung Kuan,9999,0,9999,0
1668068807762,ECE 200,005,103590,Cosman; Pamela C.,9999,0,9999,0
1668068807762,ECE 200,006,103591,Dayeh; Shadi Ahmad,9999,0,9999,0
1668068807762,ECE 200,007,103592,Fainman; Yeshaiahu,9999,0,9999,0
1668068807762,ECE 200,008,103593,Ford; Joseph Earl,9999,0,9999,0
1668068807762,ECE 200,009,103594,Franceschetti; Massimo,9999,0,9999,0
1668068807762,ECE 200,010,103595,Fullerton; Eric E,9999,0,9999,0
1668068807762,ECE 200,011,103596,Galton; Ian A,9999,0,9999,0
1668068807762,ECE 200,012,103597,Gilja; Vikash,9999,0,9999,0
1668068807762,ECE 200,013,103598,Hall; Drew A.,9999,0,9999,0
1668068807762,ECE 200,014,103599,Hsueh; Tzu-Chien,9999,0,9999,0
1668068807762,ECE 200,015,103600,Javidi; Tara,9999,0,9999,0
1668068807762,ECE 200,016,103601,Kahng; Andrew Byun,9999,0,9999,0
1668068807762,ECE 200,017,103602,Kim; Young-Han,9999,0,9999,0
1668068807762,ECE 200,018,103603,Koushanfar; Farinaz,9999,0,9999,0
1668068807762,ECE 200,019,103604,Kuzum; Duygu,9999,0,9999,0
1668068807762,ECE 200,020,103605,Le; Hanh-Phuc,9999,0,9999,0
1668068807762,ECE 200,021,103606,Lin; Bill,9999,0,9999,0
1668068807762,ECE 200,022,103607,Liu; Zhaowei,9998,0,9999,1
1668068807762,ECE 200,023,103608,Lo; Yu-Hwa,9999,0,9999,0
1668068807762,ECE 200,024,103609,Lomakin; Vitaliy,9999,0,9999,0
1668068807762,ECE 200,025,103610,Mercier; Patrick Philip,9999,0,9999,0
1668068807762,ECE 200,026,103611,Meyer; Florian,9999,0,9999,0
1668068807762,ECE 200,027,103612,Milstein; Laurence B.,9999,0,9999,0
1668068807762,ECE 200,028,103613,Mir Arabbaygi; Siavash,9999,0,9999,0
1668068807762,ECE 200,029,103614,Mookherjea; Shayan,9999,0,9999,0
1668068807762,ECE 200,030,103615,Morris; Karcher William,9999,0,9999,0
1668068807762,ECE 200,031,103616,Ng; Tse Nga,9999,0,9999,0
1668068807762,ECE 200,032,103617,Nguyen; Truong Quang,9999,0,9999,0
1668068807762,ECE 200,033,103618,Nomura; Kenji,9999,0,9999,0
1668068807762,ECE 200,034,103619,Orlitsky; Alon,9999,0,9999,0
1668068807762,ECE 200,035,103620,Pal; Piya,9999,0,9999,0
1668068807762,ECE 200,036,103621,Papen; George C.,9999,0,9999,0
1668068807762,ECE 200,037,103622,Radic; Stojan,9999,0,9999,0
1668068807762,ECE 200,038,103623,Rao; Bhaskar D.,9999,0,9999,0
1668068807762,ECE 200,039,103624,Rao; Ramesh R,9999,0,9999,0
1668068807762,ECE 200,040,103625,Rebeiz; Gabriel,9999,0,9999,0
1668068807762,ECE 200,041,103626,Sanford; John R,9999,0,9999,0
1668068807762,ECE 200,042,103627,Siegel; Paul H.,9999,0,9999,0
1668068807762,ECE 200,043,103628,Sievenpiper; Daniel F.,9999,0,9999,0
1668068807762,ECE 200,044,103629,Sworder; David D.,9999,0,9999,0
1668068807762,ECE 200,045,103630,Taur; Yuan,9999,0,9999,0
1668068807762,ECE 200,046,103631,Touri; Behrouz,9999,0,9999,0
1668068807762,ECE 200,047,103632,Trivedi; Mohan M.,9999,0,9999,0
1668068807762,ECE 200,048,103633,Vasconcelos; Nuno,9999,0,9999,0
1668068807762,ECE 200,049,103634,Wang; Xiaolong,9999,0,9999,0
1668068807762,ECE 200,050,103635,Xie; Pengtao,9999,0,9999,0
1668068807762,ECE 200,051,103636,Yip; Michael,9999,0,9999,0
1668068807762,ECE 200,052,103637,Zeger; Kenneth A.,999,0,999,0
1668068807762,ECE 200,053,103638,Zhang; Xinyu,9999,0,9999,0
1668068807762,ECE 200,054,103639,Turakhia; Yatish Girish,9999,0,9999,0
1668068807762,ECE 200,055,103640,Kang; Mingu,9999,0,9999,0
1668068807762,ECE 200,056,103641,Shi; Yuanyuan,9999,0,9999,0
1668068807762,ECE 200,057,103642,Wang; Edward Jay,9999,0,9999,0
1668068807762,ECE 200,058,103643,Zheng; Yang,9999,0,9999,0
1668068808188,ECE 202,A00,103644,Kuzum; Duygu,0,0,0,0
1668068808610,ECE 212BN,A00,103646,Ng; Tse Nga,0,0,0,0
1668068809036,ECE 221,A00,111493,Staff,0,0,0,0
1668068809465,ECE 222B,A00,103647,Lomakin; Vitaliy,0,0,0,0
1668068809893,ECE 230B,A00,103648,Taur; Yuan,0,0,0,0
1668068810318,ECE 238B,A00,103649,Garay; Javier,0,0,0,0
1668068810740,ECE 240B,A00,112900,Fainman; Yeshaiahu,0,0,0,0
1668068811173,ECE 247A,A00,103650,Jokerst; Jesse Vincent,0,0,0,0
1668068811595,ECE 247B,A00,103651,Wang; Joseph,0,0,0,0
1668068812020,ECE 250,A00,103652,Siegel; Paul H.,0,0,0,0
1668068812451,ECE 251A,A00,103654,Rao; Bhaskar D.,0,0,0,0
1668068812877,ECE 257B,A00,103655,Bharadia; Dinesh,0,0,0,0
1668068813309,ECE 258A,A00,103656,Milstein; Laurence B.,0,0,0,0
1668068813734,ECE 260B,A00,103658,Kang; Mingu,0,0,0,0
1668068814161,ECE 264A,A00,103659,Galton; Ian A,0,0,0,0
1668068814590,ECE 265A,A00,103661,Gudem; Prasad S.S.,0,0,0,0
1668068815019,ECE 265D,A00,103662,Gudem; Prasad S.S.,0,0,0,0
1668068815446,ECE 268,A00,103663,Koushanfar; Farinaz,0,0,0,0
1668068815881,ECE 269,A01,103665,Pal; Piya,0,0,0,0
1668068816309,ECE 271B,A00,103666,Vasconcelos; Manuela,0,0,0,0
1668068816737,ECE 276A,A00,103667,Atanasov; Nikolay A.,0,0,0,0
1668068817162,ECE 277,A00,103668,An; Cheolhong,0,0,0,0
1668068817667,ECE 279,A00,117947,Hall; Drew A.,0,0,0,0
1668068818521,ECE 283,A00,103670,Hsueh; Tzu-Chien,0,0,0,0
1668068818951,ECE 284,A00,103671,Turakhia; Yatish Girish,0,0,0,0
1668068819380,ECE 285,A00,103672,Zheng; Yang,0,0,0,0
1668068819380,ECE 285,B00,103673,Sworder; David D.,0,0,0,0
1668068819806,ECE 287,A00,103676,Javidi; Tara,0,0,0,0
1668068820229,MATH 200B,A00,098023,Salehi Golsefidy; Alireza,13,0,15,2
1668068820658,MATH 202B,A00,098024,Rhoades; Brendon Patrick,9,0,15,6
1668068821081,MATH 203B,A00,098025,Oprea; Dragos N.,10,0,15,5
1668068821506,MATH 204B,A00,098026,Sorensen; Claus M,13,0,15,2
1668068821930,MATH 208,A00,098027,Izadi; Elham,7,0,10,3
1668068822363,MATH 209,A00,098028,Pollack; Aaron,10,0,10,0
1668068822788,MATH 211A,A00,112919,Rogalski; Daniel,9,0,10,1
1668068823214,MATH 211B,A00,112920,Seward; Brandon M.,9,0,10,1
1668068823636,MATH 218,A00,098029,Li; Bo,10,0,10,0
1668068824063,MATH 220B,A00,098030,Novak; Jonathan I,12,0,15,3
1668068824495,MATH 221A,A00,098031,Ebenfelt; Peter F,13,0,15,2
1668068824919,MATH 231B,A00,098032,Zlatos; Andrej,12,0,15,3
1668068825352,MATH 240B,A00,098033,Ni; Lei,9,0,15,6
1668068825775,MATH 243,A00,098034,Jekel; David Andrew,10,0,10,0
1668068826207,MATH 245A,A00,098035,Nie; Jiawang,0,0,15,16
1668068826630,MATH 248,A00,098036,Bejenaru; Ioan,10,0,10,0
1668068827054,MATH 250B,A00,098037,Spolaor; Luca,14,0,15,1
1668068827481,MATH 258,A00,098038,Ni; Lei,10,0,10,0
1668068827905,MATH 264B,A00,098041,Rhoades; Brendon Patrick,10,0,15,5
1668068828328,MATH 268,A00,098042,Buss; Samuel R,10,0,10,0
1668068828751,MATH 269,A00,098043,Rhoades; Brendon Patrick,10,0,10,0
1668068829180,MATH 270B,A00,098044,Li; Bo,11,0,15,4
1668068829609,MATH 272B,A00,098045,Holst; Michael J,13,0,15,2
1668068830032,MATH 273A,A00,098046,Tian; Xiaochuan,10,0,15,5
1668068830473,MATH 275,A01,098048,Tian; Xiaochuan,6,0,10,4
1668068830899,MATH 278A,A00,098049,Holst; Michael J,8,0,10,2
1668068831325,MATH 278B,A00,098050,Cloninger; Alexander,10,0,10,0
1668068831751,MATH 278C,A00,098051,Nie; Jiawang,7,0,10,3
1668068832178,MATH 280B,A00,098052,Zheng; Tianyi,10,0,15,5
1668068832604,MATH 281B,A00,098053,Bradic; Jelena,3,0,15,12
1668068833029,MATH 282B,A00,098054,Arias-Castro; Ery,0,0,15,15
1668068833454,MATH 285,A00,098055,Fitzsimmons; Patrick J,0,0,15,17
1668068833890,MATH 287B,A00,098056,Arias-Castro; Ery,3,0,15,12
1668068834317,MATH 288,A00,098057,Agarwal; Pooja,9,0,10,1
1668068834317,MATH 288,B00,098058,Zhang; Danna,8,0,10,2
1668068834317,MATH 288,C00,098059,Williams; Ruth J,10,0,10,0
1668068834742,MATH 290B,A00,098060,Roberts; Justin Deritter,13,0,15,2
1668068835170,MATH 292,A00,098061,Belmont; Eva Kinoshita,10,0,10,0
1668068835594,MATH 295,A00,098062,Suk; Andrew Hoon,48,0,50,2
1668068836022,MATH 296,A00,098063,Novak; Jonathan I,20,0,20,0
1668068836465,MATH 297,001,098064,Gamst; Anthony Collins,9997,0,9999,2
1668069339960,COGS 205,A00,101395,Chiba; Andrea,19,0,20,1
1668069340389,COGS 210B,001,101404,Greene; Deanna Jacquelyn,9998,0,9999,1
1668069340389,COGS 210B,002,101417,Xia; Haijun,9999,0,9999,0
1668069340389,COGS 210B,003,101422,Nitz; Douglas A.,9999,0,9999,0
1668069340389,COGS 210B,004,101423,Hollan; James D.,9998,0,9999,1
1668069340389,COGS 210B,005,101424,Deak; Gedeon O.,9998,0,9999,1
1668069340389,COGS 210B,006,101425,Rossano; Federico,9999,0,9999,0
1668069340814,COGS 211B,A00,101427,Coulson; Seana M,9996,0,9999,3
1668069341316,COGS 220,A00,101428,Hollan; James D.,0,0,25,25
1668069341743,COGS 229,A00,101429,Dow; Steven P,18,0,25,7
1668069342169,COGS 230,A00,101430,Klemmer; Scott R,13,0,17,4
1668069342592,COGS 234,A00,101431,Xia; Haijun,3,0,25,22
1668069343026,COGS 260,A00,101432,Kiyonaga; Anastasia,19,0,25,6
1668069343026,COGS 260,B00,101433,Kirsh; David Joel,16,0,25,9
1668069343451,CSE 202,A00,102371,Impagliazzo; Russell,0,0,0,0
1668069343883,CSE 203B,A01,102373,Cheng; Chung Kuan,0,0,0,0
1668069344310,CSE 208,A00,102374,Micciancio; Daniele,0,0,0,0
1668069344746,CSE 209A,A00,112895,Impagliazzo; Russell,0,0,15,15
1668069345172,CSE 209B,A00,108005,Bellare; Mihir,0,0,0,0
1668069345614,CSE 210,A00,113163,Coblenz; Michael J,0,0,0,0
1668069346044,CSE 219,A00,106111,Dow; Steven P,0,0,20,20
1668069346475,CSE 221,A00,102376,Voelker; Geoffrey M.,0,0,0,0
1668069346919,CSE 224,A01,102378,Porter; George M,0,0,0,0
1668069347355,CSE 229A,A00,102379,Savage; Stefan,0,0,0,0
1668069347794,CSE 229C,A00,102380,Munyaka; Imani N. S.,0,0,0,0
1668069348240,CSE 232B,A00,102382,Deutsch; Alin Bernard,0,0,0,0
1668069348679,CSE 234,A01,112904,Kumar; Arun Kumar,0,0,0,0
1668069349108,CSE 237A,A00,102383,Rosing; Tajana Simunic,0,0,0,0
1668069349531,CSE 239A,A00,102384,Deutsch; Alin Bernard,0,0,0,0
1668069349968,CSE 239B,A00,102385,Polikarpova; Nadezhda,0,0,0,0
1668069350397,CSE 240A,A00,102386,Pannuto; Patrick William,0,0,0,0
1668069350827,CSE 240B,A00,102387,Zhao; Jishen,0,0,0,0
1668069351257,CSE 241A,A00,106406,Kang; Mingu,0,0,0,0
1668069351702,CSE 249B,A00,102388,Kahng; Andrew Byun,0,0,8,8
1668069352141,CSE 251B,A01,102392,Cottrell; Garrison W,0,0,0,0
1668069352141,CSE 251B,A02,102393,Cottrell; Garrison W,0,0,0,0
1668069352564,CSE 252B,A00,102394,Ochoa; Benjamin Lawrence,0,0,0,0
1668069352990,CSE 257,A01,102396,Gao; Sicun,0,0,0,0
1668069353436,CSE 272,A00,102397,Li; Tzumao,0,0,0,0
1668069353873,CSE 274,A00,111323,Chern; Albert Ren-Haur,0,0,0,0
1668069354296,CSE 282,A00,102398,Pevzner; Pavel Arkadjevich,0,0,0,0
1668069354721,CSE 284,A00,114175,Gymrek; Melissa Ann,0,0,0,0
1668069355155,CSE 290,A00,102399,Chandraker; Manmohan Krishna,0,0,0,0
1668069355155,CSE 290,B00,102400,Vaccaro; Kristen Marie,0,0,25,25
1668069355155,CSE 290,C00,102414,Pannuto; Patrick William,0,0,25,25
1668069355155,CSE 290,D00,102427,Pevzner; Pavel Arkadjevich,0,0,0,0
1668069355155,CSE 290,E00,102429,Zhao; Jishen,0,0,0,0
1668069355155,CSE 290,F00,102436,Tullsen; Dean Michael,0,0,0,0
1668069355155,CSE 290,G00,102440,Christensen; Henrik I,0,0,20,20
1668069355590,CSE 291,A00,102443,Su; Hao,0,0,0,0
1668069355590,CSE 291,B00,102448,Polikarpova; Nadezhda,0,0,0,0
1668069355590,CSE 291,C00,102453,Vaccaro; Kristen Marie,0,0,0,0
1668069355590,CSE 291,D00,111343,Savage; Stefan,0,0,0,0
1668069355590,CSE 291,E00,116474,Claffy; Kimberly Claire,0,0,0,0
1668069355590,CSE 291,F00,116479,Pasquale; Joseph,0,0,0,0
1668069356036,CSE 293,001,119111,Bafna; Vineet,9999,0,9999,0
1668069356036,CSE 293,002,119118,Bellare; Mihir,9999,0,9999,0
1668069356036,CSE 293,003,119122,Berg-Kirkpatrick; Taylor D,9999,0,9999,0
1668069356036,CSE 293,004,119135,Christensen; Henrik I,9999,0,9999,0
1668069356036,CSE 293,005,119142,Cottrell; Garrison W,9999,0,9999,0
1668069356036,CSE 293,006,119146,Deutsch; Alin Bernard,9999,0,9999,0
1668069356036,CSE 293,007,119159,Esmaeilzadeh; Hadi,9999,0,9999,0
1668069356036,CSE 293,008,119166,Freund; Yoav,9999,0,9999,0
1668069356036,CSE 293,009,119170,Griswold; William G.,9999,0,9999,0
1668069356036,CSE 293,010,119183,Gymrek; Melissa Ann,9999,0,9999,0
1668069356036,CSE 293,011,119190,Heninger; Nadia A,9999,0,9999,0
1668069356036,CSE 293,012,119230,Impagliazzo; Russell,9999,0,9999,0
1668069356036,CSE 293,013,119232,Jhala; Ranjit,9999,0,9999,0
1668069356036,CSE 293,014,119233,Kahng; Andrew Byun,9999,0,9999,0
1668069356036,CSE 293,015,119298,Kane; Daniel Mertz,9999,0,9999,0
1668069356036,CSE 293,016,119299,Kriegman; David J,9999,0,9999,0
1668069356036,CSE 293,017,119300,Kumar; Arun Kumar,9999,0,9999,0
1668069356036,CSE 293,018,119301,Lerner; Sorin,9999,0,9999,0
1668069356036,CSE 293,019,119302,Lovett; Shachar,9999,0,9999,0
1668069356036,CSE 293,020,119303,McAuley; Julian John,9999,0,9999,0
1668069356036,CSE 293,021,119304,Micciancio; Daniele,9999,0,9999,0
1668069356036,CSE 293,022,119367,Orailoglu; Alex,9999,0,9999,0
1668069356036,CSE 293,023,119382,Paturi; Ramamohan,9999,0,9999,0
1668069356036,CSE 293,024,119404,Polikarpova; Nadezhda,9999,0,9999,0
1668069356036,CSE 293,025,119406,Politz; Joseph Gibbs,9999,0,9999,0
1668069356036,CSE 293,026,119411,Porter; George M,9999,0,9999,0
1668069356036,CSE 293,027,119414,Porter; Leonard Emerson,9999,0,9999,0
1668069356036,CSE 293,028,119416,Ramamoorthi; Ravi,9999,0,9999,0
1668069356036,CSE 293,029,119417,Sahoo; Debashis,9999,0,9999,0
1668069356036,CSE 293,030,119420,Saul; Lawrence,9999,0,9999,0
1668069356036,CSE 293,031,119421,Savage; Stefan,9999,0,9999,0
1668069356036,CSE 293,032,119425,Schulze; Jurgen P.,9999,0,9999,0
1668069356036,CSE 293,033,119426,Snoeren; Alex C.,9999,0,9999,0
1668069356036,CSE 293,034,119428,Shang; Jingbo,9999,0,9999,0
1668069356036,CSE 293,035,119430,Stefan; Deian,9999,0,9999,0
1668069356036,CSE 293,036,119431,Su; Hao,9999,0,9999,0
1668069356036,CSE 293,037,119433,Swanson; Steven James,9999,0,9999,0
1668069356036,CSE 293,038,119435,Tullsen; Dean Michael,9999,0,9999,0
1668069356036,CSE 293,039,119483,Voelker; Geoffrey M.,9999,0,9999,0
1668069356036,CSE 293,040,119537,Zhao; Jishen,9999,0,9999,0
1668069356036,CSE 293,041,119538,Zhou; Yuan-Yuan,9999,0,9999,0
1668069356036,CSE 293,042,119539,Gao; Sicun,9999,0,9999,0
1668069356036,CSE 293,043,119540,Weibel; Nadir,9999,0,9999,0
1668069356036,CSE 293,044,119541,Gupta; Rajesh K.,9999,0,9999,0
1668069356036,CSE 293,045,126410,Vaccaro; Kristen Marie,9999,0,9999,0
1668069356036,CSE 293,046,126411,Klemke; Richard,9999,0,9999,0
1668069356463,CSE 294,A00,102459,Voelker; Geoffrey M.,0,0,0,0
1668069356463,CSE 294,B00,111322,Orailoglu; Alex,0,0,0,0
1668069356892,DSE 201,A00,096914,Deutsch; Alin Bernard,30,0,30,0
1668069357319,DSE 210,A00,096915,Dasgupta; Sanjoy,30,0,30,0
1668069357743,DSE 260A,A00,096916,Altintas De Callaf; Ilkay,30,0,30,0
1668069358221,ECE 200,001,103586,Antipa; Nicholas A,9999,0,9999,0
1668069358221,ECE 200,002,103587,Atanasov; Nikolay A.,9999,0,9999,0
1668069358221,ECE 200,003,103588,Bharadia; Dinesh,9999,0,9999,0
1668069358221,ECE 200,004,103589,Cheng; Chung Kuan,9999,0,9999,0
1668069358221,ECE 200,005,103590,Cosman; Pamela C.,9999,0,9999,0
1668069358221,ECE 200,006,103591,Dayeh; Shadi Ahmad,9999,0,9999,0
1668069358221,ECE 200,007,103592,Fainman; Yeshaiahu,9999,0,9999,0
1668069358221,ECE 200,008,103593,Ford; Joseph Earl,9999,0,9999,0
1668069358221,ECE 200,009,103594,Franceschetti; Massimo,9999,0,9999,0
1668069358221,ECE 200,010,103595,Fullerton; Eric E,9999,0,9999,0
1668069358221,ECE 200,011,103596,Galton; Ian A,9999,0,9999,0
1668069358221,ECE 200,012,103597,Gilja; Vikash,9999,0,9999,0
1668069358221,ECE 200,013,103598,Hall; Drew A.,9999,0,9999,0
1668069358221,ECE 200,014,103599,Hsueh; Tzu-Chien,9999,0,9999,0
1668069358221,ECE 200,015,103600,Javidi; Tara,9999,0,9999,0
1668069358221,ECE 200,016,103601,Kahng; Andrew Byun,9999,0,9999,0
1668069358221,ECE 200,017,103602,Kim; Young-Han,9999,0,9999,0
1668069358221,ECE 200,018,103603,Koushanfar; Farinaz,9999,0,9999,0
1668069358221,ECE 200,019,103604,Kuzum; Duygu,9999,0,9999,0
1668069358221,ECE 200,020,103605,Le; Hanh-Phuc,9999,0,9999,0
1668069358221,ECE 200,021,103606,Lin; Bill,9999,0,9999,0
1668069358221,ECE 200,022,103607,Liu; Zhaowei,9998,0,9999,1
1668069358221,ECE 200,023,103608,Lo; Yu-Hwa,9999,0,9999,0
1668069358221,ECE 200,024,103609,Lomakin; Vitaliy,9999,0,9999,0
1668069358221,ECE 200,025,103610,Mercier; Patrick Philip,9999,0,9999,0
1668069358221,ECE 200,026,103611,Meyer; Florian,9999,0,9999,0
1668069358221,ECE 200,027,103612,Milstein; Laurence B.,9999,0,9999,0
1668069358221,ECE 200,028,103613,Mir Arabbaygi; Siavash,9999,0,9999,0
1668069358221,ECE 200,029,103614,Mookherjea; Shayan,9999,0,9999,0
1668069358221,ECE 200,030,103615,Morris; Karcher William,9999,0,9999,0
1668069358221,ECE 200,031,103616,Ng; Tse Nga,9999,0,9999,0
1668069358221,ECE 200,032,103617,Nguyen; Truong Quang,9999,0,9999,0
1668069358221,ECE 200,033,103618,Nomura; Kenji,9999,0,9999,0
1668069358221,ECE 200,034,103619,Orlitsky; Alon,9999,0,9999,0
1668069358221,ECE 200,035,103620,Pal; Piya,9999,0,9999,0
1668069358221,ECE 200,036,103621,Papen; George C.,9999,0,9999,0
1668069358221,ECE 200,037,103622,Radic; Stojan,9999,0,9999,0
1668069358221,ECE 200,038,103623,Rao; Bhaskar D.,9999,0,9999,0
1668069358221,ECE 200,039,103624,Rao; Ramesh R,9999,0,9999,0
1668069358221,ECE 200,040,103625,Rebeiz; Gabriel,9999,0,9999,0
1668069358221,ECE 200,041,103626,Sanford; John R,9999,0,9999,0
1668069358221,ECE 200,042,103627,Siegel; Paul H.,9999,0,9999,0
1668069358221,ECE 200,043,103628,Sievenpiper; Daniel F.,9999,0,9999,0
1668069358221,ECE 200,044,103629,Sworder; David D.,9999,0,9999,0
1668069358221,ECE 200,045,103630,Taur; Yuan,9999,0,9999,0
1668069358221,ECE 200,046,103631,Touri; Behrouz,9999,0,9999,0
1668069358221,ECE 200,047,103632,Trivedi; Mohan M.,9999,0,9999,0
1668069358221,ECE 200,048,103633,Vasconcelos; Nuno,9999,0,9999,0
1668069358221,ECE 200,049,103634,Wang; Xiaolong,9999,0,9999,0
1668069358221,ECE 200,050,103635,Xie; Pengtao,9999,0,9999,0
1668069358221,ECE 200,051,103636,Yip; Michael,9999,0,9999,0
1668069358221,ECE 200,052,103637,Zeger; Kenneth A.,999,0,999,0
1668069358221,ECE 200,053,103638,Zhang; Xinyu,9999,0,9999,0
1668069358221,ECE 200,054,103639,Turakhia; Yatish Girish,9999,0,9999,0
1668069358221,ECE 200,055,103640,Kang; Mingu,9999,0,9999,0
1668069358221,ECE 200,056,103641,Shi; Yuanyuan,9999,0,9999,0
1668069358221,ECE 200,057,103642,Wang; Edward Jay,9999,0,9999,0
1668069358221,ECE 200,058,103643,Zheng; Yang,9999,0,9999,0
1668069358645,ECE 202,A00,103644,Kuzum; Duygu,0,0,0,0
1668069359070,ECE 212BN,A00,103646,Ng; Tse Nga,0,0,0,0
1668069359505,ECE 221,A00,111493,Staff,0,0,0,0
1668069359930,ECE 222B,A00,103647,Lomakin; Vitaliy,0,0,0,0
1668069360354,ECE 230B,A00,103648,Taur; Yuan,0,0,0,0
1668069360784,ECE 238B,A00,103649,Garay; Javier,0,0,0,0
1668069361214,ECE 240B,A00,112900,Fainman; Yeshaiahu,0,0,0,0
1668069361641,ECE 247A,A00,103650,Jokerst; Jesse Vincent,0,0,0,0
1668069362071,ECE 247B,A00,103651,Wang; Joseph,0,0,0,0
1668069362501,ECE 250,A00,103652,Siegel; Paul H.,0,0,0,0
1668069362926,ECE 251A,A00,103654,Rao; Bhaskar D.,0,0,0,0
1668069363352,ECE 257B,A00,103655,Bharadia; Dinesh,0,0,0,0
1668069363780,ECE 258A,A00,103656,Milstein; Laurence B.,0,0,0,0
1668069364224,ECE 260B,A00,103658,Kang; Mingu,0,0,0,0
1668069364651,ECE 264A,A00,103659,Galton; Ian A,0,0,0,0
1668069365082,ECE 265A,A00,103661,Gudem; Prasad S.S.,0,0,0,0
1668069365513,ECE 265D,A00,103662,Gudem; Prasad S.S.,0,0,0,0
1668069365936,ECE 268,A00,103663,Koushanfar; Farinaz,0,0,0,0
1668069366359,ECE 269,A01,103665,Pal; Piya,0,0,0,0
1668069366787,ECE 271B,A00,103666,Vasconcelos; Manuela,0,0,0,0
1668069367218,ECE 276A,A00,103667,Atanasov; Nikolay A.,0,0,0,0
1668069367656,ECE 277,A00,103668,An; Cheolhong,0,0,0,0
1668069368090,ECE 279,A00,117947,Hall; Drew A.,0,0,0,0
1668069368942,ECE 283,A00,103670,Hsueh; Tzu-Chien,0,0,0,0
1668069369366,ECE 284,A00,103671,Turakhia; Yatish Girish,0,0,0,0
1668069369794,ECE 285,A00,103672,Zheng; Yang,0,0,0,0
1668069369794,ECE 285,B00,103673,Sworder; David D.,0,0,0,0
1668069370223,ECE 287,A00,103676,Javidi; Tara,0,0,0,0
1668069370666,MATH 200B,A00,098023,Salehi Golsefidy; Alireza,13,0,15,2
1668069371094,MATH 202B,A00,098024,Rhoades; Brendon Patrick,9,0,15,6
1668069371530,MATH 203B,A00,098025,Oprea; Dragos N.,10,0,15,5
1668069371955,MATH 204B,A00,098026,Sorensen; Claus M,13,0,15,2
1668069372385,MATH 208,A00,098027,Izadi; Elham,7,0,10,3
1668069372818,MATH 209,A00,098028,Pollack; Aaron,10,0,10,0
1668069373246,MATH 211A,A00,112919,Rogalski; Daniel,9,0,10,1
1668069373671,MATH 211B,A00,112920,Seward; Brandon M.,9,0,10,1
1668069374097,MATH 218,A00,098029,Li; Bo,10,0,10,0
1668069374521,MATH 220B,A00,098030,Novak; Jonathan I,12,0,15,3
1668069374944,MATH 221A,A00,098031,Ebenfelt; Peter F,13,0,15,2
1668069375373,MATH 231B,A00,098032,Zlatos; Andrej,12,0,15,3
1668069375795,MATH 240B,A00,098033,Ni; Lei,9,0,15,6
1668069376219,MATH 243,A00,098034,Jekel; David Andrew,10,0,10,0
1668069376647,MATH 245A,A00,098035,Nie; Jiawang,0,0,15,16
1668069377075,MATH 248,A00,098036,Bejenaru; Ioan,10,0,10,0
1668069377501,MATH 250B,A00,098037,Spolaor; Luca,14,0,15,1
1668069377927,MATH 258,A00,098038,Ni; Lei,10,0,10,0
1668069378366,MATH 264B,A00,098041,Rhoades; Brendon Patrick,10,0,15,5
1668069378787,MATH 268,A00,098042,Buss; Samuel R,10,0,10,0
1668069379222,MATH 269,A00,098043,Rhoades; Brendon Patrick,10,0,10,0
1668069379652,MATH 270B,A00,098044,Li; Bo,11,0,15,4
1668069380076,MATH 272B,A00,098045,Holst; Michael J,13,0,15,2
1668069380505,MATH 273A,A00,098046,Tian; Xiaochuan,10,0,15,5
1668069380939,MATH 275,A01,098048,Tian; Xiaochuan,6,0,10,4
1668069381379,MATH 278A,A00,098049,Holst; Michael J,8,0,10,2
1668069381809,MATH 278B,A00,098050,Cloninger; Alexander,10,0,10,0
1668069382240,MATH 278C,A00,098051,Nie; Jiawang,7,0,10,3
1668069382665,MATH 280B,A00,098052,Zheng; Tianyi,10,0,15,5
1668069383091,MATH 281B,A00,098053,Bradic; Jelena,3,0,15,12
1668069383518,MATH 282B,A00,098054,Arias-Castro; Ery,0,0,15,15
1668069383945,MATH 285,A00,098055,Fitzsimmons; Patrick J,0,0,15,17
1668069384381,MATH 287B,A00,098056,Arias-Castro; Ery,3,0,15,12
1668069384904,MATH 288,A00,098057,Agarwal; Pooja,9,0,10,1
1668069384904,MATH 288,B00,098058,Zhang; Danna,8,0,10,2
1668069384904,MATH 288,C00,098059,Williams; Ruth J,10,0,10,0
1668069385332,MATH 290B,A00,098060,Roberts; Justin Deritter,13,0,15,2
1668069385774,MATH 292,A00,098061,Belmont; Eva Kinoshita,10,0,10,0
1668069386206,MATH 295,A00,098062,Suk; Andrew Hoon,48,0,50,2
1668069386631,MATH 296,A00,098063,Novak; Jonathan I,20,0,20,0
1668069387055,MATH 297,001,098064,Gamst; Anthony Collins,9997,0,9999,2
1668069892114,COGS 205,A00,101395,Chiba; Andrea,19,0,20,1
1668069892554,COGS 210B,001,101404,Greene; Deanna Jacquelyn,9998,0,9999,1
1668069892554,COGS 210B,002,101417,Xia; Haijun,9999,0,9999,0
1668069892554,COGS 210B,003,101422,Nitz; Douglas A.,9999,0,9999,0
1668069892554,COGS 210B,004,101423,Hollan; James D.,9998,0,9999,1
1668069892554,COGS 210B,005,101424,Deak; Gedeon O.,9998,0,9999,1
1668069892554,COGS 210B,006,101425,Rossano; Federico,9999,0,9999,0
1668069892978,COGS 211B,A00,101427,Coulson; Seana M,9996,0,9999,3
1668069893406,COGS 220,A00,101428,Hollan; James D.,0,0,25,25
1668069893853,COGS 229,A00,101429,Dow; Steven P,18,0,25,7
1668069894284,COGS 230,A00,101430,Klemmer; Scott R,13,0,17,4
1668069894706,COGS 234,A00,101431,Xia; Haijun,3,0,25,22
1668069895132,COGS 260,A00,101432,Kiyonaga; Anastasia,19,0,25,6
1668069895132,COGS 260,B00,101433,Kirsh; David Joel,16,0,25,9
1668069895558,CSE 202,A00,102371,Impagliazzo; Russell,0,0,0,0
1668069895989,CSE 203B,A01,102373,Cheng; Chung Kuan,0,0,0,0
1668069896415,CSE 208,A00,102374,Micciancio; Daniele,0,0,0,0
1668069896844,CSE 209A,A00,112895,Impagliazzo; Russell,0,0,15,15
1668069897277,CSE 209B,A00,108005,Bellare; Mihir,0,0,0,0
1668069897701,CSE 210,A00,113163,Coblenz; Michael J,0,0,0,0
1668069898129,CSE 219,A00,106111,Dow; Steven P,0,0,20,20
1668069898567,CSE 221,A00,102376,Voelker; Geoffrey M.,0,0,0,0
1668069898992,CSE 224,A01,102378,Porter; George M,0,0,0,0
1668069899419,CSE 229A,A00,102379,Savage; Stefan,0,0,0,0
1668069899845,CSE 229C,A00,102380,Munyaka; Imani N. S.,0,0,0,0
1668069900273,CSE 232B,A00,102382,Deutsch; Alin Bernard,0,0,0,0
1668069900711,CSE 234,A01,112904,Kumar; Arun Kumar,0,0,0,0
1668069901154,CSE 237A,A00,102383,Rosing; Tajana Simunic,0,0,0,0
1668069901577,CSE 239A,A00,102384,Deutsch; Alin Bernard,0,0,0,0
1668069902006,CSE 239B,A00,102385,Polikarpova; Nadezhda,0,0,0,0
1668069902436,CSE 240A,A00,102386,Pannuto; Patrick William,0,0,0,0
1668069902864,CSE 240B,A00,102387,Zhao; Jishen,0,0,0,0
1668069903289,CSE 241A,A00,106406,Kang; Mingu,0,0,0,0
1668069903718,CSE 249B,A00,102388,Kahng; Andrew Byun,0,0,8,8
1668069904141,CSE 251B,A01,102392,Cottrell; Garrison W,0,0,0,0
1668069904141,CSE 251B,A02,102393,Cottrell; Garrison W,0,0,0,0
1668069904571,CSE 252B,A00,102394,Ochoa; Benjamin Lawrence,0,0,0,0
1668069905003,CSE 257,A01,102396,Gao; Sicun,0,0,0,0
1668069905428,CSE 272,A00,102397,Li; Tzumao,0,0,0,0
1668069905857,CSE 274,A00,111323,Chern; Albert Ren-Haur,0,0,0,0
1668069906279,CSE 282,A00,102398,Pevzner; Pavel Arkadjevich,0,0,0,0
1668069906706,CSE 284,A00,114175,Gymrek; Melissa Ann,0,0,0,0
1668069907134,CSE 290,A00,102399,Chandraker; Manmohan Krishna,0,0,0,0
1668069907134,CSE 290,B00,102400,Vaccaro; Kristen Marie,0,0,25,25
1668069907134,CSE 290,C00,102414,Pannuto; Patrick William,0,0,25,25
1668069907134,CSE 290,D00,102427,Pevzner; Pavel Arkadjevich,0,0,0,0
1668069907134,CSE 290,E00,102429,Zhao; Jishen,0,0,0,0
1668069907134,CSE 290,F00,102436,Tullsen; Dean Michael,0,0,0,0
1668069907134,CSE 290,G00,102440,Christensen; Henrik I,0,0,20,20
1668069907569,CSE 291,A00,102443,Su; Hao,0,0,0,0
1668069907569,CSE 291,B00,102448,Polikarpova; Nadezhda,0,0,0,0
1668069907569,CSE 291,C00,102453,Vaccaro; Kristen Marie,0,0,0,0
1668069907569,CSE 291,D00,111343,Savage; Stefan,0,0,0,0
1668069907569,CSE 291,E00,116474,Claffy; Kimberly Claire,0,0,0,0
1668069907569,CSE 291,F00,116479,Pasquale; Joseph,0,0,0,0
1668069908018,CSE 293,001,119111,Bafna; Vineet,9999,0,9999,0
1668069908018,CSE 293,002,119118,Bellare; Mihir,9999,0,9999,0
1668069908018,CSE 293,003,119122,Berg-Kirkpatrick; Taylor D,9999,0,9999,0
1668069908018,CSE 293,004,119135,Christensen; Henrik I,9999,0,9999,0
1668069908018,CSE 293,005,119142,Cottrell; Garrison W,9999,0,9999,0
1668069908018,CSE 293,006,119146,Deutsch; Alin Bernard,9999,0,9999,0
1668069908018,CSE 293,007,119159,Esmaeilzadeh; Hadi,9999,0,9999,0
1668069908018,CSE 293,008,119166,Freund; Yoav,9999,0,9999,0
1668069908018,CSE 293,009,119170,Griswold; William G.,9999,0,9999,0
1668069908018,CSE 293,010,119183,Gymrek; Melissa Ann,9999,0,9999,0
1668069908018,CSE 293,011,119190,Heninger; Nadia A,9999,0,9999,0
1668069908018,CSE 293,012,119230,Impagliazzo; Russell,9999,0,9999,0
1668069908018,CSE 293,013,119232,Jhala; Ranjit,9999,0,9999,0
1668069908018,CSE 293,014,119233,Kahng; Andrew Byun,9999,0,9999,0
1668069908018,CSE 293,015,119298,Kane; Daniel Mertz,9999,0,9999,0
1668069908018,CSE 293,016,119299,Kriegman; David J,9999,0,9999,0
1668069908018,CSE 293,017,119300,Kumar; Arun Kumar,9999,0,9999,0
1668069908018,CSE 293,018,119301,Lerner; Sorin,9999,0,9999,0
1668069908018,CSE 293,019,119302,Lovett; Shachar,9999,0,9999,0
1668069908018,CSE 293,020,119303,McAuley; Julian John,9999,0,9999,0
1668069908018,CSE 293,021,119304,Micciancio; Daniele,9999,0,9999,0
1668069908018,CSE 293,022,119367,Orailoglu; Alex,9999,0,9999,0
1668069908018,CSE 293,023,119382,Paturi; Ramamohan,9999,0,9999,0
1668069908018,CSE 293,024,119404,Polikarpova; Nadezhda,9999,0,9999,0
1668069908018,CSE 293,025,119406,Politz; Joseph Gibbs,9999,0,9999,0
1668069908018,CSE 293,026,119411,Porter; George M,9999,0,9999,0
1668069908018,CSE 293,027,119414,Porter; Leonard Emerson,9999,0,9999,0
1668069908018,CSE 293,028,119416,Ramamoorthi; Ravi,9999,0,9999,0
1668069908018,CSE 293,029,119417,Sahoo; Debashis,9999,0,9999,0
1668069908018,CSE 293,030,119420,Saul; Lawrence,9999,0,9999,0
1668069908018,CSE 293,031,119421,Savage; Stefan,9999,0,9999,0
1668069908018,CSE 293,032,119425,Schulze; Jurgen P.,9999,0,9999,0
1668069908018,CSE 293,033,119426,Snoeren; Alex C.,9999,0,9999,0
1668069908018,CSE 293,034,119428,Shang; Jingbo,9999,0,9999,0
1668069908018,CSE 293,035,119430,Stefan; Deian,9999,0,9999,0
1668069908018,CSE 293,036,119431,Su; Hao,9999,0,9999,0
1668069908018,CSE 293,037,119433,Swanson; Steven James,9999,0,9999,0
1668069908018,CSE 293,038,119435,Tullsen; Dean Michael,9999,0,9999,0
1668069908018,CSE 293,039,119483,Voelker; Geoffrey M.,9999,0,9999,0
1668069908018,CSE 293,040,119537,Zhao; Jishen,9999,0,9999,0
1668069908018,CSE 293,041,119538,Zhou; Yuan-Yuan,9999,0,9999,0
1668069908018,CSE 293,042,119539,Gao; Sicun,9999,0,9999,0
1668069908018,CSE 293,043,119540,Weibel; Nadir,9999,0,9999,0
1668069908018,CSE 293,044,119541,Gupta; Rajesh K.,9999,0,9999,0
1668069908018,CSE 293,045,126410,Vaccaro; Kristen Marie,9999,0,9999,0
1668069908018,CSE 293,046,126411,Klemke; Richard,9999,0,9999,0
1668069908452,CSE 294,A00,102459,Voelker; Geoffrey M.,0,0,0,0
1668069908452,CSE 294,B00,111322,Orailoglu; Alex,0,0,0,0
1668069908885,DSE 201,A00,096914,Deutsch; Alin Bernard,30,0,30,0
1668069909308,DSE 210,A00,096915,Dasgupta; Sanjoy,30,0,30,0
1668069909733,DSE 260A,A00,096916,Altintas De Callaf; Ilkay,30,0,30,0
1668069910335,ECE 200,001,103586,Antipa; Nicholas A,9999,0,9999,0
1668069910335,ECE 200,002,103587,Atanasov; Nikolay A.,9999,0,9999,0
1668069910335,ECE 200,003,103588,Bharadia; Dinesh,9999,0,9999,0
1668069910335,ECE 200,004,103589,Cheng; Chung Kuan,9999,0,9999,0
1668069910335,ECE 200,005,103590,Cosman; Pamela C.,9999,0,9999,0
1668069910335,ECE 200,006,103591,Dayeh; Shadi Ahmad,9999,0,9999,0
1668069910335,ECE 200,007,103592,Fainman; Yeshaiahu,9999,0,9999,0
1668069910335,ECE 200,008,103593,Ford; Joseph Earl,9999,0,9999,0
1668069910335,ECE 200,009,103594,Franceschetti; Massimo,9999,0,9999,0
1668069910335,ECE 200,010,103595,Fullerton; Eric E,9999,0,9999,0
1668069910335,ECE 200,011,103596,Galton; Ian A,9999,0,9999,0
1668069910335,ECE 200,012,103597,Gilja; Vikash,9999,0,9999,0
1668069910335,ECE 200,013,103598,Hall; Drew A.,9999,0,9999,0
1668069910335,ECE 200,014,103599,Hsueh; Tzu-Chien,9999,0,9999,0
1668069910335,ECE 200,015,103600,Javidi; Tara,9999,0,9999,0
1668069910335,ECE 200,016,103601,Kahng; Andrew Byun,9999,0,9999,0
1668069910335,ECE 200,017,103602,Kim; Young-Han,9999,0,9999,0
1668069910335,ECE 200,018,103603,Koushanfar; Farinaz,9999,0,9999,0
1668069910335,ECE 200,019,103604,Kuzum; Duygu,9999,0,9999,0
1668069910335,ECE 200,020,103605,Le; Hanh-Phuc,9999,0,9999,0
1668069910335,ECE 200,021,103606,Lin; Bill,9999,0,9999,0
1668069910335,ECE 200,022,103607,Liu; Zhaowei,9998,0,9999,1
1668069910335,ECE 200,023,103608,Lo; Yu-Hwa,9999,0,9999,0
1668069910335,ECE 200,024,103609,Lomakin; Vitaliy,9999,0,9999,0
1668069910335,ECE 200,025,103610,Mercier; Patrick Philip,9999,0,9999,0
1668069910335,ECE 200,026,103611,Meyer; Florian,9999,0,9999,0
1668069910335,ECE 200,027,103612,Milstein; Laurence B.,9999,0,9999,0
1668069910335,ECE 200,028,103613,Mir Arabbaygi; Siavash,9999,0,9999,0
1668069910335,ECE 200,029,103614,Mookherjea; Shayan,9999,0,9999,0
1668069910335,ECE 200,030,103615,Morris; Karcher William,9999,0,9999,0
1668069910335,ECE 200,031,103616,Ng; Tse Nga,9999,0,9999,0
1668069910335,ECE 200,032,103617,Nguyen; Truong Quang,9999,0,9999,0
1668069910335,ECE 200,033,103618,Nomura; Kenji,9999,0,9999,0
1668069910335,ECE 200,034,103619,Orlitsky; Alon,9999,0,9999,0
1668069910335,ECE 200,035,103620,Pal; Piya,9999,0,9999,0
1668069910335,ECE 200,036,103621,Papen; George C.,9999,0,9999,0
1668069910335,ECE 200,037,103622,Radic; Stojan,9999,0,9999,0
1668069910335,ECE 200,038,103623,Rao; Bhaskar D.,9999,0,9999,0
1668069910335,ECE 200,039,103624,Rao; Ramesh R,9999,0,9999,0
1668069910335,ECE 200,040,103625,Rebeiz; Gabriel,9999,0,9999,0
1668069910335,ECE 200,041,103626,Sanford; John R,9999,0,9999,0
1668069910335,ECE 200,042,103627,Siegel; Paul H.,9999,0,9999,0
1668069910335,ECE 200,043,103628,Sievenpiper; Daniel F.,9999,0,9999,0
1668069910335,ECE 200,044,103629,Sworder; David D.,9999,0,9999,0
1668069910335,ECE 200,045,103630,Taur; Yuan,9999,0,9999,0
1668069910335,ECE 200,046,103631,Touri; Behrouz,9999,0,9999,0
1668069910335,ECE 200,047,103632,Trivedi; Mohan M.,9999,0,9999,0
1668069910335,ECE 200,048,103633,Vasconcelos; Nuno,9999,0,9999,0
1668069910335,ECE 200,049,103634,Wang; Xiaolong,9999,0,9999,0
1668069910335,ECE 200,050,103635,Xie; Pengtao,9999,0,9999,0
1668069910335,ECE 200,051,103636,Yip; Michael,9999,0,9999,0
1668069910335,ECE 200,052,103637,Zeger; Kenneth A.,999,0,999,0
1668069910335,ECE 200,053,103638,Zhang; Xinyu,9999,0,9999,0
1668069910335,ECE 200,054,103639,Turakhia; Yatish Girish,9999,0,9999,0
1668069910335,ECE 200,055,103640,Kang; Mingu,9999,0,9999,0
1668069910335,ECE 200,056,103641,Shi; Yuanyuan,9999,0,9999,0
1668069910335,ECE 200,057,103642,Wang; Edward Jay,9999,0,9999,0
1668069910335,ECE 200,058,103643,Zheng; Yang,9999,0,9999,0
1668069910763,ECE 202,A00,103644,Kuzum; Duygu,0,0,0,0
1668069911191,ECE 212BN,A00,103646,Ng; Tse Nga,0,0,0,0
1668069911615,ECE 221,A00,111493,Staff,0,0,0,0
1668069912044,ECE 222B,A00,103647,Lomakin; Vitaliy,0,0,0,0
1668069912468,ECE 230B,A00,103648,Taur; Yuan,0,0,0,0
1668069912893,ECE 238B,A00,103649,Garay; Javier,0,0,0,0
1668069913317,ECE 240B,A00,112900,Fainman; Yeshaiahu,0,0,0,0
1668069913745,ECE 247A,A00,103650,Jokerst; Jesse Vincent,0,0,0,0
1668069914173,ECE 247B,A00,103651,Wang; Joseph,0,0,0,0
1668069914601,ECE 250,A00,103652,Siegel; Paul H.,0,0,0,0
1668069915031,ECE 251A,A00,103654,Rao; Bhaskar D.,0,0,0,0
1668069915458,ECE 257B,A00,103655,Bharadia; Dinesh,0,0,0,0
1668069915883,ECE 258A,A00,103656,Milstein; Laurence B.,0,0,0,0
1668069916310,ECE 260B,A00,103658,Kang; Mingu,0,0,0,0
1668069916736,ECE 264A,A00,103659,Galton; Ian A,0,0,0,0
1668069917160,ECE 265A,A00,103661,Gudem; Prasad S.S.,0,0,0,0
1668069917582,ECE 265D,A00,103662,Gudem; Prasad S.S.,0,0,0,0
1668069918006,ECE 268,A00,103663,Koushanfar; Farinaz,0,0,0,0
1668069918434,ECE 269,A01,103665,Pal; Piya,0,0,0,0
1668069918858,ECE 271B,A00,103666,Vasconcelos; Manuela,0,0,0,0
1668069919286,ECE 276A,A00,103667,Atanasov; Nikolay A.,0,0,0,0
1668069919717,ECE 277,A00,103668,An; Cheolhong,0,0,0,0
1668069920144,ECE 279,A00,117947,Hall; Drew A.,0,0,0,0
1668069921010,ECE 283,A00,103670,Hsueh; Tzu-Chien,0,0,0,0
1668069921436,ECE 284,A00,103671,Turakhia; Yatish Girish,0,0,0,0
1668069921861,ECE 285,A00,103672,Zheng; Yang,0,0,0,0
1668069921861,ECE 285,B00,103673,Sworder; David D.,0,0,0,0
1668069922284,ECE 287,A00,103676,Javidi; Tara,0,0,0,0
1668069922708,MATH 200B,A00,098023,Salehi Golsefidy; Alireza,13,0,15,2
1668069923137,MATH 202B,A00,098024,Rhoades; Brendon Patrick,9,0,15,6
1668069923566,MATH 203B,A00,098025,Oprea; Dragos N.,10,0,15,5
1668069923990,MATH 204B,A00,098026,Sorensen; Claus M,13,0,15,2
1668069924418,MATH 208,A00,098027,Izadi; Elham,7,0,10,3
1668069924843,MATH 209,A00,098028,Pollack; Aaron,10,0,10,0
1668069925283,MATH 211A,A00,112919,Rogalski; Daniel,9,0,10,1
1668069925708,MATH 211B,A00,112920,Seward; Brandon M.,9,0,10,1
1668069926135,MATH 218,A00,098029,Li; Bo,10,0,10,0
1668069926560,MATH 220B,A00,098030,Novak; Jonathan I,12,0,15,3
1668069926983,MATH 221A,A00,098031,Ebenfelt; Peter F,13,0,15,2
1668069927411,MATH 231B,A00,098032,Zlatos; Andrej,12,0,15,3
1668069927846,MATH 240B,A00,098033,Ni; Lei,9,0,15,6
1668069928270,MATH 243,A00,098034,Jekel; David Andrew,10,0,10,0
1668069928795,MATH 245A,A00,098035,Nie; Jiawang,0,0,15,16
1668069929218,MATH 248,A00,098036,Bejenaru; Ioan,10,0,10,0
1668069929644,MATH 250B,A00,098037,Spolaor; Luca,14,0,15,1
1668069930069,MATH 258,A00,098038,Ni; Lei,10,0,10,0
1668069930496,MATH 264B,A00,098041,Rhoades; Brendon Patrick,10,0,15,5
1668069930931,MATH 268,A00,098042,Buss; Samuel R,10,0,10,0
1668069931359,MATH 269,A00,098043,Rhoades; Brendon Patrick,10,0,10,0
1668069931782,MATH 270B,A00,098044,Li; Bo,11,0,15,4
1668069932209,MATH 272B,A00,098045,Holst; Michael J,13,0,15,2
1668069932633,MATH 273A,A00,098046,Tian; Xiaochuan,10,0,15,5
1668069933056,MATH 275,A01,098048,Tian; Xiaochuan,6,0,10,4
1668069933484,MATH 278A,A00,098049,Holst; Michael J,8,0,10,2
1668069933907,MATH 278B,A00,098050,Cloninger; Alexander,10,0,10,0
1668069934333,MATH 278C,A00,098051,Nie; Jiawang,7,0,10,3
1668069934758,MATH 280B,A00,098052,Zheng; Tianyi,10,0,15,5
1668069935189,MATH 281B,A00,098053,Bradic; Jelena,3,0,15,12
1668069935623,MATH 282B,A00,098054,Arias-Castro; Ery,0,0,15,15
1668069936050,MATH 285,A00,098055,Fitzsimmons; Patrick J,0,0,15,17
1668069936473,MATH 287B,A00,098056,Arias-Castro; Ery,3,0,15,12
1668069936923,MATH 288,A00,098057,Agarwal; Pooja,9,0,10,1
1668069936923,MATH 288,B00,098058,Zhang; Danna,8,0,10,2
1668069936923,MATH 288,C00,098059,Williams; Ruth J,10,0,10,0
1668069937363,MATH 290B,A00,098060,Roberts; Justin Deritter,13,0,15,2
1668069937794,MATH 292,A00,098061,Belmont; Eva Kinoshita,10,0,10,0
1668069938218,MATH 295,A00,098062,Suk; Andrew Hoon,48,0,50,2
1668069938644,MATH 296,A00,098063,Novak; Jonathan I,20,0,20,0
1668069939070,MATH 297,001,098064,Gamst; Anthony Collins,9997,0,9999,2
1668070442953,COGS 205,A00,101395,Chiba; Andrea,19,0,20,1
1668070443379,COGS 210B,001,101404,Greene; Deanna Jacquelyn,9998,0,9999,1
1668070443379,COGS 210B,002,101417,Xia; Haijun,9999,0,9999,0
1668070443379,COGS 210B,003,101422,Nitz; Douglas A.,9999,0,9999,0
1668070443379,COGS 210B,004,101423,Hollan; James D.,9998,0,9999,1
1668070443379,COGS 210B,005,101424,Deak; Gedeon O.,9998,0,9999,1
1668070443379,COGS 210B,006,101425,Rossano; Federico,9999,0,9999,0
1668070443803,COGS 211B,A00,101427,Coulson; Seana M,9996,0,9999,3
1668070444226,COGS 220,A00,101428,Hollan; James D.,0,0,25,25
1668070444652,COGS 229,A00,101429,Dow; Steven P,18,0,25,7
1668070445089,COGS 230,A00,101430,Klemmer; Scott R,13,0,17,4
1668070445525,COGS 234,A00,101431,Xia; Haijun,3,0,25,22
1668070445952,COGS 260,A00,101432,Kiyonaga; Anastasia,19,0,25,6
1668070445952,COGS 260,B00,101433,Kirsh; David Joel,16,0,25,9
1668070446380,CSE 202,A00,102371,Impagliazzo; Russell,0,0,0,0
1668070446808,CSE 203B,A01,102373,Cheng; Chung Kuan,0,0,0,0
1668070447232,CSE 208,A00,102374,Micciancio; Daniele,0,0,0,0
1668070447662,CSE 209A,A00,112895,Impagliazzo; Russell,0,0,15,15
1668070448103,CSE 209B,A00,108005,Bellare; Mihir,0,0,0,0
1668070448533,CSE 210,A00,113163,Coblenz; Michael J,0,0,0,0
1668070448971,CSE 219,A00,106111,Dow; Steven P,0,0,20,20
1668070449396,CSE 221,A00,102376,Voelker; Geoffrey M.,0,0,0,0
1668070449821,CSE 224,A01,102378,Porter; George M,0,0,0,0
1668070450251,CSE 229A,A00,102379,Savage; Stefan,0,0,0,0
1668070450678,CSE 229C,A00,102380,Munyaka; Imani N. S.,0,0,0,0
1668070451106,CSE 232B,A00,102382,Deutsch; Alin Bernard,0,0,0,0
1668070451541,CSE 234,A01,112904,Kumar; Arun Kumar,0,0,0,0
1668070451967,CSE 237A,A00,102383,Rosing; Tajana Simunic,0,0,0,0
1668070452394,CSE 239A,A00,102384,Deutsch; Alin Bernard,0,0,0,0
1668070452831,CSE 239B,A00,102385,Polikarpova; Nadezhda,0,0,0,0
1668070453266,CSE 240A,A00,102386,Pannuto; Patrick William,0,0,0,0
1668070453690,CSE 240B,A00,102387,Zhao; Jishen,0,0,0,0
1668070454118,CSE 241A,A00,106406,Kang; Mingu,0,0,0,0
1668070454548,CSE 249B,A00,102388,Kahng; Andrew Byun,0,0,8,8
1668070454973,CSE 251B,A01,102392,Cottrell; Garrison W,0,0,0,0
1668070454973,CSE 251B,A02,102393,Cottrell; Garrison W,0,0,0,0
1668070455403,CSE 252B,A00,102394,Ochoa; Benjamin Lawrence,0,0,0,0
1668070455832,CSE 257,A01,102396,Gao; Sicun,0,0,0,0
1668070456256,CSE 272,A00,102397,Li; Tzumao,0,0,0,0
1668070456748,CSE 274,A00,111323,Chern; Albert Ren-Haur,0,0,0,0
1668070457184,CSE 282,A00,102398,Pevzner; Pavel Arkadjevich,0,0,0,0
1668070457613,CSE 284,A00,114175,Gymrek; Melissa Ann,0,0,0,0
1668070458039,CSE 290,A00,102399,Chandraker; Manmohan Krishna,0,0,0,0
1668070458039,CSE 290,B00,102400,Vaccaro; Kristen Marie,0,0,25,25
1668070458039,CSE 290,C00,102414,Pannuto; Patrick William,0,0,25,25
1668070458039,CSE 290,D00,102427,Pevzner; Pavel Arkadjevich,0,0,0,0
1668070458039,CSE 290,E00,102429,Zhao; Jishen,0,0,0,0
1668070458039,CSE 290,F00,102436,Tullsen; Dean Michael,0,0,0,0
1668070458039,CSE 290,G00,102440,Christensen; Henrik I,0,0,20,20
1668070458478,CSE 291,A00,102443,Su; Hao,0,0,0,0
1668070458478,CSE 291,B00,102448,Polikarpova; Nadezhda,0,0,0,0
1668070458478,CSE 291,C00,102453,Vaccaro; Kristen Marie,0,0,0,0
1668070458478,CSE 291,D00,111343,Savage; Stefan,0,0,0,0
1668070458478,CSE 291,E00,116474,Claffy; Kimberly Claire,0,0,0,0
1668070458478,CSE 291,F00,116479,Pasquale; Joseph,0,0,0,0
1668070458919,CSE 293,001,119111,Bafna; Vineet,9999,0,9999,0
1668070458919,CSE 293,002,119118,Bellare; Mihir,9999,0,9999,0
1668070458919,CSE 293,003,119122,Berg-Kirkpatrick; Taylor D,9999,0,9999,0
1668070458919,CSE 293,004,119135,Christensen; Henrik I,9999,0,9999,0
1668070458919,CSE 293,005,119142,Cottrell; Garrison W,9999,0,9999,0
1668070458919,CSE 293,006,119146,Deutsch; Alin Bernard,9999,0,9999,0
1668070458919,CSE 293,007,119159,Esmaeilzadeh; Hadi,9999,0,9999,0
1668070458919,CSE 293,008,119166,Freund; Yoav,9999,0,9999,0
1668070458919,CSE 293,009,119170,Griswold; William G.,9999,0,9999,0
1668070458919,CSE 293,010,119183,Gymrek; Melissa Ann,9999,0,9999,0
1668070458919,CSE 293,011,119190,Heninger; Nadia A,9999,0,9999,0
1668070458919,CSE 293,012,119230,Impagliazzo; Russell,9999,0,9999,0
1668070458919,CSE 293,013,119232,Jhala; Ranjit,9999,0,9999,0
1668070458919,CSE 293,014,119233,Kahng; Andrew Byun,9999,0,9999,0
1668070458919,CSE 293,015,119298,Kane; Daniel Mertz,9999,0,9999,0
1668070458919,CSE 293,016,119299,Kriegman; David J,9999,0,9999,0
1668070458919,CSE 293,017,119300,Kumar; Arun Kumar,9999,0,9999,0
1668070458919,CSE 293,018,119301,Lerner; Sorin,9999,0,9999,0
1668070458919,CSE 293,019,119302,Lovett; Shachar,9999,0,9999,0
1668070458919,CSE 293,020,119303,McAuley; Julian John,9999,0,9999,0
1668070458919,CSE 293,021,119304,Micciancio; Daniele,9999,0,9999,0
1668070458919,CSE 293,022,119367,Orailoglu; Alex,9999,0,9999,0
1668070458919,CSE 293,023,119382,Paturi; Ramamohan,9999,0,9999,0
1668070458919,CSE 293,024,119404,Polikarpova; Nadezhda,9999,0,9999,0
1668070458919,CSE 293,025,119406,Politz; Joseph Gibbs,9999,0,9999,0
1668070458919,CSE 293,026,119411,Porter; George M,9999,0,9999,0
1668070458919,CSE 293,027,119414,Porter; Leonard Emerson,9999,0,9999,0
1668070458919,CSE 293,028,119416,Ramamoorthi; Ravi,9999,0,9999,0
1668070458919,CSE 293,029,119417,Sahoo; Debashis,9999,0,9999,0
1668070458919,CSE 293,030,119420,Saul; Lawrence,9999,0,9999,0
1668070458919,CSE 293,031,119421,Savage; Stefan,9999,0,9999,0
1668070458919,CSE 293,032,119425,Schulze; Jurgen P.,9999,0,9999,0
1668070458919,CSE 293,033,119426,Snoeren; Alex C.,9999,0,9999,0
1668070458919,CSE 293,034,119428,Shang; Jingbo,9999,0,9999,0
1668070458919,CSE 293,035,119430,Stefan; Deian,9999,0,9999,0
1668070458919,CSE 293,036,119431,Su; Hao,9999,0,9999,0
1668070458919,CSE 293,037,119433,Swanson; Steven James,9999,0,9999,0
1668070458919,CSE 293,038,119435,Tullsen; Dean Michael,9999,0,9999,0
1668070458919,CSE 293,039,119483,Voelker; Geoffrey M.,9999,0,9999,0
1668070458919,CSE 293,040,119537,Zhao; Jishen,9999,0,9999,0
1668070458919,CSE 293,041,119538,Zhou; Yuan-Yuan,9999,0,9999,0
1668070458919,CSE 293,042,119539,Gao; Sicun,9999,0,9999,0
1668070458919,CSE 293,043,119540,Weibel; Nadir,9999,0,9999,0
1668070458919,CSE 293,044,119541,Gupta; Rajesh K.,9999,0,9999,0
1668070458919,CSE 293,045,126410,Vaccaro; Kristen Marie,9999,0,9999,0
1668070458919,CSE 293,046,126411,Klemke; Richard,9999,0,9999,0
1668070459345,CSE 294,A00,102459,Voelker; Geoffrey M.,0,0,0,0
1668070459345,CSE 294,B00,111322,Orailoglu; Alex,0,0,0,0
1668070459773,DSE 201,A00,096914,Deutsch; Alin Bernard,30,0,30,0
1668070460198,DSE 210,A00,096915,Dasgupta; Sanjoy,30,0,30,0
1668070460623,DSE 260A,A00,096916,Altintas De Callaf; Ilkay,30,0,30,0
1668070461072,ECE 200,001,103586,Antipa; Nicholas A,9999,0,9999,0
1668070461072,ECE 200,002,103587,Atanasov; Nikolay A.,9999,0,9999,0
1668070461072,ECE 200,003,103588,Bharadia; Dinesh,9999,0,9999,0
1668070461072,ECE 200,004,103589,Cheng; Chung Kuan,9999,0,9999,0
1668070461072,ECE 200,005,103590,Cosman; Pamela C.,9999,0,9999,0
1668070461072,ECE 200,006,103591,Dayeh; Shadi Ahmad,9999,0,9999,0
1668070461072,ECE 200,007,103592,Fainman; Yeshaiahu,9999,0,9999,0
1668070461072,ECE 200,008,103593,Ford; Joseph Earl,9999,0,9999,0
1668070461072,ECE 200,009,103594,Franceschetti; Massimo,9999,0,9999,0
1668070461072,ECE 200,010,103595,Fullerton; Eric E,9999,0,9999,0
1668070461072,ECE 200,011,103596,Galton; Ian A,9999,0,9999,0
1668070461072,ECE 200,012,103597,Gilja; Vikash,9999,0,9999,0
1668070461072,ECE 200,013,103598,Hall; Drew A.,9999,0,9999,0
1668070461072,ECE 200,014,103599,Hsueh; Tzu-Chien,9999,0,9999,0
1668070461072,ECE 200,015,103600,Javidi; Tara,9999,0,9999,0
1668070461072,ECE 200,016,103601,Kahng; Andrew Byun,9999,0,9999,0
1668070461072,ECE 200,017,103602,Kim; Young-Han,9999,0,9999,0
1668070461072,ECE 200,018,103603,Koushanfar; Farinaz,9999,0,9999,0
1668070461072,ECE 200,019,103604,Kuzum; Duygu,9999,0,9999,0
1668070461072,ECE 200,020,103605,Le; Hanh-Phuc,9999,0,9999,0
1668070461072,ECE 200,021,103606,Lin; Bill,9999,0,9999,0
1668070461072,ECE 200,022,103607,Liu; Zhaowei,9998,0,9999,1
1668070461072,ECE 200,023,103608,Lo; Yu-Hwa,9999,0,9999,0
1668070461072,ECE 200,024,103609,Lomakin; Vitaliy,9999,0,9999,0
1668070461072,ECE 200,025,103610,Mercier; Patrick Philip,9999,0,9999,0
1668070461072,ECE 200,026,103611,Meyer; Florian,9999,0,9999,0
1668070461072,ECE 200,027,103612,Milstein; Laurence B.,9999,0,9999,0
1668070461072,ECE 200,028,103613,Mir Arabbaygi; Siavash,9999,0,9999,0
1668070461072,ECE 200,029,103614,Mookherjea; Shayan,9999,0,9999,0
1668070461072,ECE 200,030,103615,Morris; Karcher William,9999,0,9999,0
1668070461072,ECE 200,031,103616,Ng; Tse Nga,9999,0,9999,0
1668070461072,ECE 200,032,103617,Nguyen; Truong Quang,9999,0,9999,0
1668070461072,ECE 200,033,103618,Nomura; Kenji,9999,0,9999,0
1668070461072,ECE 200,034,103619,Orlitsky; Alon,9999,0,9999,0
1668070461072,ECE 200,035,103620,Pal; Piya,9999,0,9999,0
1668070461072,ECE 200,036,103621,Papen; George C.,9999,0,9999,0
1668070461072,ECE 200,037,103622,Radic; Stojan,9999,0,9999,0
1668070461072,ECE 200,038,103623,Rao; Bhaskar D.,9999,0,9999,0
1668070461072,ECE 200,039,103624,Rao; Ramesh R,9999,0,9999,0
1668070461072,ECE 200,040,103625,Rebeiz; Gabriel,9999,0,9999,0
1668070461072,ECE 200,041,103626,Sanford; John R,9999,0,9999,0
1668070461072,ECE 200,042,103627,Siegel; Paul H.,9999,0,9999,0
1668070461072,ECE 200,043,103628,Sievenpiper; Daniel F.,9999,0,9999,0
1668070461072,ECE 200,044,103629,Sworder; David D.,9999,0,9999,0
1668070461072,ECE 200,045,103630,Taur; Yuan,9999,0,9999,0
1668070461072,ECE 200,046,103631,Touri; Behrouz,9999,0,9999,0
1668070461072,ECE 200,047,103632,Trivedi; Mohan M.,9999,0,9999,0
1668070461072,ECE 200,048,103633,Vasconcelos; Nuno,9999,0,9999,0
1668070461072,ECE 200,049,103634,Wang; Xiaolong,9999,0,9999,0
1668070461072,ECE 200,050,103635,Xie; Pengtao,9999,0,9999,0
1668070461072,ECE 200,051,103636,Yip; Michael,9999,0,9999,0
1668070461072,ECE 200,052,103637,Zeger; Kenneth A.,999,0,999,0
1668070461072,ECE 200,053,103638,Zhang; Xinyu,9999,0,9999,0
1668070461072,ECE 200,054,103639,Turakhia; Yatish Girish,9999,0,9999,0
1668070461072,ECE 200,055,103640,Kang; Mingu,9999,0,9999,0
1668070461072,ECE 200,056,103641,Shi; Yuanyuan,9999,0,9999,0
1668070461072,ECE 200,057,103642,Wang; Edward Jay,9999,0,9999,0
1668070461072,ECE 200,058,103643,Zheng; Yang,9999,0,9999,0
1668070461507,ECE 202,A00,103644,Kuzum; Duygu,0,0,0,0
1668070461942,ECE 212BN,A00,103646,Ng; Tse Nga,0,0,0,0
1668070462374,ECE 221,A00,111493,Staff,0,0,0,0
1668070462799,ECE 222B,A00,103647,Lomakin; Vitaliy,0,0,0,0
1668070463227,ECE 230B,A00,103648,Taur; Yuan,0,0,0,0
1668070463652,ECE 238B,A00,103649,Garay; Javier,0,0,0,0
1668070464082,ECE 240B,A00,112900,Fainman; Yeshaiahu,0,0,0,0
1668070464508,ECE 247A,A00,103650,Jokerst; Jesse Vincent,0,0,0,0
1668070464935,ECE 247B,A00,103651,Wang; Joseph,0,0,0,0
1668070465360,ECE 250,A00,103652,Siegel; Paul H.,0,0,0,0
1668070465789,ECE 251A,A00,103654,Rao; Bhaskar D.,0,0,0,0
1668070466211,ECE 257B,A00,103655,Bharadia; Dinesh,0,0,0,0
1668070466639,ECE 258A,A00,103656,Milstein; Laurence B.,0,0,0,0
1668070467063,ECE 260B,A00,103658,Kang; Mingu,0,0,0,0
1668070467498,ECE 264A,A00,103659,Galton; Ian A,0,0,0,0
1668070467921,ECE 265A,A00,103661,Gudem; Prasad S.S.,0,0,0,0
1668070468345,ECE 265D,A00,103662,Gudem; Prasad S.S.,0,0,0,0
1668070468775,ECE 268,A00,103663,Koushanfar; Farinaz,0,0,0,0
1668070469200,ECE 269,A01,103665,Pal; Piya,0,0,0,0
1668070469636,ECE 271B,A00,103666,Vasconcelos; Manuela,0,0,0,0
1668070470073,ECE 276A,A00,103667,Atanasov; Nikolay A.,0,0,0,0
1668070470497,ECE 277,A00,103668,An; Cheolhong,0,0,0,0
1668070470925,ECE 279,A00,117947,Hall; Drew A.,0,0,0,0
1668070471783,ECE 283,A00,103670,Hsueh; Tzu-Chien,0,0,0,0
1668070472216,ECE 284,A00,103671,Turakhia; Yatish Girish,0,0,0,0
1668070472727,ECE 285,A00,103672,Zheng; Yang,0,0,0,0
1668070472727,ECE 285,B00,103673,Sworder; David D.,0,0,0,0
1668070473153,ECE 287,A00,103676,Javidi; Tara,0,0,0,0
1668070473584,MATH 200B,A00,098023,Salehi Golsefidy; Alireza,13,0,15,2
1668070474013,MATH 202B,A00,098024,Rhoades; Brendon Patrick,9,0,15,6
1668070474438,MATH 203B,A00,098025,Oprea; Dragos N.,10,0,15,5
1668070474866,MATH 204B,A00,098026,Sorensen; Claus M,13,0,15,2
1668070475305,MATH 208,A00,098027,Izadi; Elham,7,0,10,3
1668070475729,MATH 209,A00,098028,Pollack; Aaron,10,0,10,0
1668070476152,MATH 211A,A00,112919,Rogalski; Daniel,9,0,10,1
1668070476575,MATH 211B,A00,112920,Seward; Brandon M.,9,0,10,1
1668070477000,MATH 218,A00,098029,Li; Bo,10,0,10,0
1668070477425,MATH 220B,A00,098030,Novak; Jonathan I,12,0,15,3
1668070477963,MATH 221A,A00,098031,Ebenfelt; Peter F,13,0,15,2
1668070478387,MATH 231B,A00,098032,Zlatos; Andrej,12,0,15,3
1668070478813,MATH 240B,A00,098033,Ni; Lei,9,0,15,6
1668070479250,MATH 243,A00,098034,Jekel; David Andrew,10,0,10,0
1668070479684,MATH 245A,A00,098035,Nie; Jiawang,0,0,15,16
1668070480112,MATH 248,A00,098036,Bejenaru; Ioan,10,0,10,0
1668070480538,MATH 250B,A00,098037,Spolaor; Luca,14,0,15,1
1668070480965,MATH 258,A00,098038,Ni; Lei,10,0,10,0
1668070481393,MATH 264B,A00,098041,Rhoades; Brendon Patrick,10,0,15,5
1668070481818,MATH 268,A00,098042,Buss; Samuel R,10,0,10,0
1668070482245,MATH 269,A00,098043,Rhoades; Brendon Patrick,10,0,10,0
1668070482669,MATH 270B,A00,098044,Li; Bo,11,0,15,4
1668070483095,MATH 272B,A00,098045,Holst; Michael J,13,0,15,2
1668070483525,MATH 273A,A00,098046,Tian; Xiaochuan,10,0,15,5
1668070483949,MATH 275,A01,098048,Tian; Xiaochuan,6,0,10,4
1668070484374,MATH 278A,A00,098049,Holst; Michael J,8,0,10,2
1668070484805,MATH 278B,A00,098050,Cloninger; Alexander,10,0,10,0
1668070485232,MATH 278C,A00,098051,Nie; Jiawang,7,0,10,3
1668070485656,MATH 280B,A00,098052,Zheng; Tianyi,10,0,15,5
1668070486081,MATH 281B,A00,098053,Bradic; Jelena,3,0,15,12
1668070486511,MATH 282B,A00,098054,Arias-Castro; Ery,0,0,15,15
1668070486937,MATH 285,A00,098055,Fitzsimmons; Patrick J,0,0,15,17
1668070487362,MATH 287B,A00,098056,Arias-Castro; Ery,3,0,15,12
1668070487787,MATH 288,A00,098057,Agarwal; Pooja,9,0,10,1
1668070487787,MATH 288,B00,098058,Zhang; Danna,8,0,10,2
1668070487787,MATH 288,C00,098059,Williams; Ruth J,10,0,10,0
1668070488211,MATH 290B,A00,098060,Roberts; Justin Deritter,13,0,15,2
1668070488641,MATH 292,A00,098061,Belmont; Eva Kinoshita,10,0,10,0
1668070489063,MATH 295,A00,098062,Suk; Andrew Hoon,48,0,50,2
1668070489488,MATH 296,A00,098063,Novak; Jonathan I,20,0,20,0
1668070489916,MATH 297,001,098064,Gamst; Anthony Collins,9997,0,9999,2
1668070993045,COGS 205,A00,101395,Chiba; Andrea,19,0,20,1
1668070993476,COGS 210B,001,101404,Greene; Deanna Jacquelyn,9998,0,9999,1
1668070993476,COGS 210B,002,101417,Xia; Haijun,9999,0,9999,0
1668070993476,COGS 210B,003,101422,Nitz; Douglas A.,9999,0,9999,0
1668070993476,COGS 210B,004,101423,Hollan; James D.,9998,0,9999,1
1668070993476,COGS 210B,005,101424,Deak; Gedeon O.,9998,0,9999,1
1668070993476,COGS 210B,006,101425,Rossano; Federico,9999,0,9999,0
1668070993903,COGS 211B,A00,101427,Coulson; Seana M,9996,0,9999,3
1668070994325,COGS 220,A00,101428,Hollan; James D.,0,0,25,25
1668070994756,COGS 229,A00,101429,Dow; Steven P,18,0,25,7
1668070995182,COGS 230,A00,101430,Klemmer; Scott R,13,0,17,4
1668070995607,COGS 234,A00,101431,Xia; Haijun,3,0,25,22
1668070996030,COGS 260,A00,101432,Kiyonaga; Anastasia,19,0,25,6
1668070996030,COGS 260,B00,101433,Kirsh; David Joel,16,0,25,9
1668070996460,CSE 202,A00,102371,Impagliazzo; Russell,0,0,0,0
1668070996892,CSE 203B,A01,102373,Cheng; Chung Kuan,0,0,0,0
1668070997319,CSE 208,A00,102374,Micciancio; Daniele,0,0,0,0
1668070997742,CSE 209A,A00,112895,Impagliazzo; Russell,0,0,15,15
1668070998169,CSE 209B,A00,108005,Bellare; Mihir,0,0,0,0
1668070998594,CSE 210,A00,113163,Coblenz; Michael J,0,0,0,0
1668070999021,CSE 219,A00,106111,Dow; Steven P,0,0,20,20
1668070999448,CSE 221,A00,102376,Voelker; Geoffrey M.,0,0,0,0
1668070999877,CSE 224,A01,102378,Porter; George M,0,0,0,0
1668071000300,CSE 229A,A00,102379,Savage; Stefan,0,0,0,0
1668071000731,CSE 229C,A00,102380,Munyaka; Imani N. S.,0,0,0,0
1668071001245,CSE 232B,A00,102382,Deutsch; Alin Bernard,0,0,0,0
1668071001671,CSE 234,A01,112904,Kumar; Arun Kumar,0,0,0,0
1668071002096,CSE 237A,A00,102383,Rosing; Tajana Simunic,0,0,0,0
1668071002522,CSE 239A,A00,102384,Deutsch; Alin Bernard,0,0,0,0
1668071002948,CSE 239B,A00,102385,Polikarpova; Nadezhda,0,0,0,0
1668071003373,CSE 240A,A00,102386,Pannuto; Patrick William,0,0,0,0
1668071003799,CSE 240B,A00,102387,Zhao; Jishen,0,0,0,0
1668071004228,CSE 241A,A00,106406,Kang; Mingu,0,0,0,0
1668071004652,CSE 249B,A00,102388,Kahng; Andrew Byun,0,0,8,8
1668071005081,CSE 251B,A01,102392,Cottrell; Garrison W,0,0,0,0
1668071005081,CSE 251B,A02,102393,Cottrell; Garrison W,0,0,0,0
1668071005507,CSE 252B,A00,102394,Ochoa; Benjamin Lawrence,0,0,0,0
1668071005935,CSE 257,A01,102396,Gao; Sicun,0,0,0,0
1668071006359,CSE 272,A00,102397,Li; Tzumao,0,0,0,0
1668071006785,CSE 274,A00,111323,Chern; Albert Ren-Haur,0,0,0,0
1668071007209,CSE 282,A00,102398,Pevzner; Pavel Arkadjevich,0,0,0,0
1668071007637,CSE 284,A00,114175,Gymrek; Melissa Ann,0,0,0,0
1668071008060,CSE 290,A00,102399,Chandraker; Manmohan Krishna,0,0,0,0
1668071008060,CSE 290,B00,102400,Vaccaro; Kristen Marie,0,0,25,25
1668071008060,CSE 290,C00,102414,Pannuto; Patrick William,0,0,25,25
1668071008060,CSE 290,D00,102427,Pevzner; Pavel Arkadjevich,0,0,0,0
1668071008060,CSE 290,E00,102429,Zhao; Jishen,0,0,0,0
1668071008060,CSE 290,F00,102436,Tullsen; Dean Michael,0,0,0,0
1668071008060,CSE 290,G00,102440,Christensen; Henrik I,0,0,20,20
1668071008485,CSE 291,A00,102443,Su; Hao,0,0,0,0
1668071008485,CSE 291,B00,102448,Polikarpova; Nadezhda,0,0,0,0
1668071008485,CSE 291,C00,102453,Vaccaro; Kristen Marie,0,0,0,0
1668071008485,CSE 291,D00,111343,Savage; Stefan,0,0,0,0
1668071008485,CSE 291,E00,116474,Claffy; Kimberly Claire,0,0,0,0
1668071008485,CSE 291,F00,116479,Pasquale; Joseph,0,0,0,0
1668071008923,CSE 293,001,119111,Bafna; Vineet,9999,0,9999,0
1668071008923,CSE 293,002,119118,Bellare; Mihir,9999,0,9999,0
1668071008923,CSE 293,003,119122,Berg-Kirkpatrick; Taylor D,9999,0,9999,0
1668071008923,CSE 293,004,119135,Christensen; Henrik I,9999,0,9999,0
1668071008923,CSE 293,005,119142,Cottrell; Garrison W,9999,0,9999,0
1668071008923,CSE 293,006,119146,Deutsch; Alin Bernard,9999,0,9999,0
1668071008923,CSE 293,007,119159,Esmaeilzadeh; Hadi,9999,0,9999,0
1668071008923,CSE 293,008,119166,Freund; Yoav,9999,0,9999,0
1668071008923,CSE 293,009,119170,Griswold; William G.,9999,0,9999,0
1668071008923,CSE 293,010,119183,Gymrek; Melissa Ann,9999,0,9999,0
1668071008923,CSE 293,011,119190,Heninger; Nadia A,9999,0,9999,0
1668071008923,CSE 293,012,119230,Impagliazzo; Russell,9999,0,9999,0
1668071008923,CSE 293,013,119232,Jhala; Ranjit,9999,0,9999,0
1668071008923,CSE 293,014,119233,Kahng; Andrew Byun,9999,0,9999,0
1668071008923,CSE 293,015,119298,Kane; Daniel Mertz,9999,0,9999,0
1668071008923,CSE 293,016,119299,Kriegman; David J,9999,0,9999,0
1668071008923,CSE 293,017,119300,Kumar; Arun Kumar,9999,0,9999,0
1668071008923,CSE 293,018,119301,Lerner; Sorin,9999,0,9999,0
1668071008923,CSE 293,019,119302,Lovett; Shachar,9999,0,9999,0
1668071008923,CSE 293,020,119303,McAuley; Julian John,9999,0,9999,0
1668071008923,CSE 293,021,119304,Micciancio; Daniele,9999,0,9999,0
1668071008923,CSE 293,022,119367,Orailoglu; Alex,9999,0,9999,0
1668071008923,CSE 293,023,119382,Paturi; Ramamohan,9999,0,9999,0
1668071008923,CSE 293,024,119404,Polikarpova; Nadezhda,9999,0,9999,0
1668071008923,CSE 293,025,119406,Politz; Joseph Gibbs,9999,0,9999,0
1668071008923,CSE 293,026,119411,Porter; George M,9999,0,9999,0
1668071008923,CSE 293,027,119414,Porter; Leonard Emerson,9999,0,9999,0
1668071008923,CSE 293,028,119416,Ramamoorthi; Ravi,9999,0,9999,0
1668071008923,CSE 293,029,119417,Sahoo; Debashis,9999,0,9999,0
1668071008923,CSE 293,030,119420,Saul; Lawrence,9999,0,9999,0
1668071008923,CSE 293,031,119421,Savage; Stefan,9999,0,9999,0
1668071008923,CSE 293,032,119425,Schulze; Jurgen P.,9999,0,9999,0
1668071008923,CSE 293,033,119426,Snoeren; Alex C.,9999,0,9999,0
1668071008923,CSE 293,034,119428,Shang; Jingbo,9999,0,9999,0
1668071008923,CSE 293,035,119430,Stefan; Deian,9999,0,9999,0
1668071008923,CSE 293,036,119431,Su; Hao,9999,0,9999,0
1668071008923,CSE 293,037,119433,Swanson; Steven James,9999,0,9999,0
1668071008923,CSE 293,038,119435,Tullsen; Dean Michael,9999,0,9999,0
1668071008923,CSE 293,039,119483,Voelker; Geoffrey M.,9999,0,9999,0
1668071008923,CSE 293,040,119537,Zhao; Jishen,9999,0,9999,0
1668071008923,CSE 293,041,119538,Zhou; Yuan-Yuan,9999,0,9999,0
1668071008923,CSE 293,042,119539,Gao; Sicun,9999,0,9999,0
1668071008923,CSE 293,043,119540,Weibel; Nadir,9999,0,9999,0
1668071008923,CSE 293,044,119541,Gupta; Rajesh K.,9999,0,9999,0
1668071008923,CSE 293,045,126410,Vaccaro; Kristen Marie,9999,0,9999,0
1668071008923,CSE 293,046,126411,Klemke; Richard,9999,0,9999,0
1668071009356,CSE 294,A00,102459,Voelker; Geoffrey M.,0,0,0,0
1668071009356,CSE 294,B00,111322,Orailoglu; Alex,0,0,0,0
1668071009789,DSE 201,A00,096914,Deutsch; Alin Bernard,30,0,30,0
1668071010225,DSE 210,A00,096915,Dasgupta; Sanjoy,30,0,30,0
1668071010653,DSE 260A,A00,096916,Altintas De Callaf; Ilkay,30,0,30,0
1668071011159,ECE 200,001,103586,Antipa; Nicholas A,9999,0,9999,0
1668071011159,ECE 200,002,103587,Atanasov; Nikolay A.,9999,0,9999,0
1668071011159,ECE 200,003,103588,Bharadia; Dinesh,9999,0,9999,0
1668071011159,ECE 200,004,103589,Cheng; Chung Kuan,9999,0,9999,0
1668071011159,ECE 200,005,103590,Cosman; Pamela C.,9999,0,9999,0
1668071011159,ECE 200,006,103591,Dayeh; Shadi Ahmad,9999,0,9999,0
1668071011159,ECE 200,007,103592,Fainman; Yeshaiahu,9999,0,9999,0
1668071011159,ECE 200,008,103593,Ford; Joseph Earl,9999,0,9999,0
1668071011159,ECE 200,009,103594,Franceschetti; Massimo,9999,0,9999,0
1668071011159,ECE 200,010,103595,Fullerton; Eric E,9999,0,9999,0
1668071011159,ECE 200,011,103596,Galton; Ian A,9999,0,9999,0
1668071011159,ECE 200,012,103597,Gilja; Vikash,9999,0,9999,0
1668071011159,ECE 200,013,103598,Hall; Drew A.,9999,0,9999,0
1668071011159,ECE 200,014,103599,Hsueh; Tzu-Chien,9999,0,9999,0
1668071011159,ECE 200,015,103600,Javidi; Tara,9999,0,9999,0
1668071011159,ECE 200,016,103601,Kahng; Andrew Byun,9999,0,9999,0
1668071011159,ECE 200,017,103602,Kim; Young-Han,9999,0,9999,0
1668071011159,ECE 200,018,103603,Koushanfar; Farinaz,9999,0,9999,0
1668071011159,ECE 200,019,103604,Kuzum; Duygu,9999,0,9999,0
1668071011159,ECE 200,020,103605,Le; Hanh-Phuc,9999,0,9999,0
1668071011159,ECE 200,021,103606,Lin; Bill,9999,0,9999,0
1668071011159,ECE 200,022,103607,Liu; Zhaowei,9998,0,9999,1
1668071011159,ECE 200,023,103608,Lo; Yu-Hwa,9999,0,9999,0
1668071011159,ECE 200,024,103609,Lomakin; Vitaliy,9999,0,9999,0
1668071011159,ECE 200,025,103610,Mercier; Patrick Philip,9999,0,9999,0
1668071011159,ECE 200,026,103611,Meyer; Florian,9999,0,9999,0
1668071011159,ECE 200,027,103612,Milstein; Laurence B.,9999,0,9999,0
1668071011159,ECE 200,028,103613,Mir Arabbaygi; Siavash,9999,0,9999,0
1668071011159,ECE 200,029,103614,Mookherjea; Shayan,9999,0,9999,0
1668071011159,ECE 200,030,103615,Morris; Karcher William,9999,0,9999,0
1668071011159,ECE 200,031,103616,Ng; Tse Nga,9999,0,9999,0
1668071011159,ECE 200,032,103617,Nguyen; Truong Quang,9999,0,9999,0
1668071011159,ECE 200,033,103618,Nomura; Kenji,9999,0,9999,0
1668071011159,ECE 200,034,103619,Orlitsky; Alon,9999,0,9999,0
1668071011159,ECE 200,035,103620,Pal; Piya,9999,0,9999,0
1668071011159,ECE 200,036,103621,Papen; George C.,9999,0,9999,0
1668071011159,ECE 200,037,103622,Radic; Stojan,9999,0,9999,0
1668071011159,ECE 200,038,103623,Rao; Bhaskar D.,9999,0,9999,0
1668071011159,ECE 200,039,103624,Rao; Ramesh R,9999,0,9999,0
1668071011159,ECE 200,040,103625,Rebeiz; Gabriel,9999,0,9999,0
1668071011159,ECE 200,041,103626,Sanford; John R,9999,0,9999,0
1668071011159,ECE 200,042,103627,Siegel; Paul H.,9999,0,9999,0
1668071011159,ECE 200,043,103628,Sievenpiper; Daniel F.,9999,0,9999,0
1668071011159,ECE 200,044,103629,Sworder; David D.,9999,0,9999,0
1668071011159,ECE 200,045,103630,Taur; Yuan,9999,0,9999,0
1668071011159,ECE 200,046,103631,Touri; Behrouz,9999,0,9999,0
1668071011159,ECE 200,047,103632,Trivedi; Mohan M.,9999,0,9999,0
1668071011159,ECE 200,048,103633,Vasconcelos; Nuno,9999,0,9999,0
1668071011159,ECE 200,049,103634,Wang; Xiaolong,9999,0,9999,0
1668071011159,ECE 200,050,103635,Xie; Pengtao,9999,0,9999,0
1668071011159,ECE 200,051,103636,Yip; Michael,9999,0,9999,0
1668071011159,ECE 200,052,103637,Zeger; Kenneth A.,999,0,999,0
1668071011159,ECE 200,053,103638,Zhang; Xinyu,9999,0,9999,0
1668071011159,ECE 200,054,103639,Turakhia; Yatish Girish,9999,0,9999,0
1668071011159,ECE 200,055,103640,Kang; Mingu,9999,0,9999,0
1668071011159,ECE 200,056,103641,Shi; Yuanyuan,9999,0,9999,0
1668071011159,ECE 200,057,103642,Wang; Edward Jay,9999,0,9999,0
1668071011159,ECE 200,058,103643,Zheng; Yang,9999,0,9999,0
1668071011600,ECE 202,A00,103644,Kuzum; Duygu,0,0,0,0
1668071012023,ECE 212BN,A00,103646,Ng; Tse Nga,0,0,0,0
1668071012446,ECE 221,A00,111493,Staff,0,0,0,0
1668071012871,ECE 222B,A00,103647,Lomakin; Vitaliy,0,0,0,0
1668071013309,ECE 230B,A00,103648,Taur; Yuan,0,0,0,0
1668071013735,ECE 238B,A00,103649,Garay; Javier,0,0,0,0
1668071014159,ECE 240B,A00,112900,Fainman; Yeshaiahu,0,0,0,0
1668071014582,ECE 247A,A00,103650,Jokerst; Jesse Vincent,0,0,0,0
1668071015007,ECE 247B,A00,103651,Wang; Joseph,0,0,0,0
1668071015452,ECE 250,A00,103652,Siegel; Paul H.,0,0,0,0
1668071015882,ECE 251A,A00,103654,Rao; Bhaskar D.,0,0,0,0
1668071016307,ECE 257B,A00,103655,Bharadia; Dinesh,0,0,0,0
1668071016734,ECE 258A,A00,103656,Milstein; Laurence B.,0,0,0,0
1668071017175,ECE 260B,A00,103658,Kang; Mingu,0,0,0,0
1668071017603,ECE 264A,A00,103659,Galton; Ian A,0,0,0,0
1668071018026,ECE 265A,A00,103661,Gudem; Prasad S.S.,0,0,0,0
1668071018451,ECE 265D,A00,103662,Gudem; Prasad S.S.,0,0,0,0
1668071018877,ECE 268,A00,103663,Koushanfar; Farinaz,0,0,0,0
1668071019300,ECE 269,A01,103665,Pal; Piya,0,0,0,0
1668071019724,ECE 271B,A00,103666,Vasconcelos; Manuela,0,0,0,0
1668071020148,ECE 276A,A00,103667,Atanasov; Nikolay A.,0,0,0,0
1668071020572,ECE 277,A00,103668,An; Cheolhong,0,0,0,0
1668071020995,ECE 279,A00,117947,Hall; Drew A.,0,0,0,0
1668071021846,ECE 283,A00,103670,Hsueh; Tzu-Chien,0,0,0,0
1668071022282,ECE 284,A00,103671,Turakhia; Yatish Girish,0,0,0,0
1668071022720,ECE 285,A00,103672,Zheng; Yang,0,0,0,0
1668071022720,ECE 285,B00,103673,Sworder; David D.,0,0,0,0
1668071023149,ECE 287,A00,103676,Javidi; Tara,0,0,0,0
1668071023583,MATH 200B,A00,098023,Salehi Golsefidy; Alireza,13,0,15,2
1668071024008,MATH 202B,A00,098024,Rhoades; Brendon Patrick,9,0,15,6
1668071024436,MATH 203B,A00,098025,Oprea; Dragos N.,10,0,15,5
1668071024870,MATH 204B,A00,098026,Sorensen; Claus M,13,0,15,2
1668071025293,MATH 208,A00,098027,Izadi; Elham,7,0,10,3
1668071025714,MATH 209,A00,098028,Pollack; Aaron,10,0,10,0
1668071026139,MATH 211A,A00,112919,Rogalski; Daniel,9,0,10,1
1668071026567,MATH 211B,A00,112920,Seward; Brandon M.,9,0,10,1
1668071026991,MATH 218,A00,098029,Li; Bo,10,0,10,0
1668071027427,MATH 220B,A00,098030,Novak; Jonathan I,12,0,15,3
1668071027852,MATH 221A,A00,098031,Ebenfelt; Peter F,13,0,15,2
1668071028278,MATH 231B,A00,098032,Zlatos; Andrej,12,0,15,3
1668071028707,MATH 240B,A00,098033,Ni; Lei,9,0,15,6
1668071029134,MATH 243,A00,098034,Jekel; David Andrew,10,0,10,0
1668071029563,MATH 245A,A00,098035,Nie; Jiawang,0,0,15,16
1668071029988,MATH 248,A00,098036,Bejenaru; Ioan,10,0,10,0
1668071030419,MATH 250B,A00,098037,Spolaor; Luca,14,0,15,1
1668071030843,MATH 258,A00,098038,Ni; Lei,10,0,10,0
1668071031269,MATH 264B,A00,098041,Rhoades; Brendon Patrick,10,0,15,5
1668071031693,MATH 268,A00,098042,Buss; Samuel R,10,0,10,0
1668071032119,MATH 269,A00,098043,Rhoades; Brendon Patrick,10,0,10,0
1668071032555,MATH 270B,A00,098044,Li; Bo,11,0,15,4
1668071032983,MATH 272B,A00,098045,Holst; Michael J,13,0,15,2
1668071033410,MATH 273A,A00,098046,Tian; Xiaochuan,10,0,15,5
1668071033834,MATH 275,A01,098048,Tian; Xiaochuan,6,0,10,4
1668071034259,MATH 278A,A00,098049,Holst; Michael J,8,0,10,2
1668071034687,MATH 278B,A00,098050,Cloninger; Alexander,10,0,10,0
1668071035111,MATH 278C,A00,098051,Nie; Jiawang,7,0,10,3
1668071035534,MATH 280B,A00,098052,Zheng; Tianyi,10,0,15,5
1668071035963,MATH 281B,A00,098053,Bradic; Jelena,3,0,15,12
1668071036388,MATH 282B,A00,098054,Arias-Castro; Ery,0,0,15,15
1668071036819,MATH 285,A00,098055,Fitzsimmons; Patrick J,0,0,15,17
1668071037242,MATH 287B,A00,098056,Arias-Castro; Ery,3,0,15,12
1668071037666,MATH 288,A00,098057,Agarwal; Pooja,9,0,10,1
1668071037666,MATH 288,B00,098058,Zhang; Danna,8,0,10,2
1668071037666,MATH 288,C00,098059,Williams; Ruth J,10,0,10,0
1668071038096,MATH 290B,A00,098060,Roberts; Justin Deritter,13,0,15,2
1668071038521,MATH 292,A00,098061,Belmont; Eva Kinoshita,10,0,10,0
1668071038954,MATH 295,A00,098062,Suk; Andrew Hoon,48,0,50,2
1668071039378,MATH 296,A00,098063,Novak; Jonathan I,20,0,20,0
1668071039806,MATH 297,001,098064,Gamst; Anthony Collins,9997,0,9999,2
1668071542149,COGS 205,A00,101395,Chiba; Andrea,19,0,20,1
1668071542591,COGS 210B,001,101404,Greene; Deanna Jacquelyn,9998,0,9999,1
1668071542591,COGS 210B,002,101417,Xia; Haijun,9999,0,9999,0
1668071542591,COGS 210B,003,101422,Nitz; Douglas A.,9999,0,9999,0
1668071542591,COGS 210B,004,101423,Hollan; James D.,9998,0,9999,1
1668071542591,COGS 210B,005,101424,Deak; Gedeon O.,9998,0,9999,1
1668071542591,COGS 210B,006,101425,Rossano; Federico,9999,0,9999,0
1668071543042,COGS 211B,A00,101427,Coulson; Seana M,9996,0,9999,3
1668071543467,COGS 220,A00,101428,Hollan; James D.,0,0,25,25
1668071543893,COGS 229,A00,101429,Dow; Steven P,18,0,25,7
1668071544331,COGS 230,A00,101430,Klemmer; Scott R,13,0,17,4
1668071544757,COGS 234,A00,101431,Xia; Haijun,3,0,25,22
1668071545185,COGS 260,A00,101432,Kiyonaga; Anastasia,19,0,25,6
1668071545185,COGS 260,B00,101433,Kirsh; David Joel,16,0,25,9
1668071545608,CSE 202,A00,102371,Impagliazzo; Russell,0,0,0,0
1668071546047,CSE 203B,A01,102373,Cheng; Chung Kuan,0,0,0,0
1668071546486,CSE 208,A00,102374,Micciancio; Daniele,0,0,0,0
1668071546920,CSE 209A,A00,112895,Impagliazzo; Russell,0,0,15,15
1668071547354,CSE 209B,A00,108005,Bellare; Mihir,0,0,0,0
1668071547780,CSE 210,A00,113163,Coblenz; Michael J,0,0,0,0
1668071548223,CSE 219,A00,106111,Dow; Steven P,0,0,20,20
1668071548647,CSE 221,A00,102376,Voelker; Geoffrey M.,0,0,0,0
1668071549080,CSE 224,A01,102378,Porter; George M,0,0,0,0
1668071549504,CSE 229A,A00,102379,Savage; Stefan,0,0,0,0
1668071549931,CSE 229C,A00,102380,Munyaka; Imani N. S.,0,0,0,0
1668071550361,CSE 232B,A00,102382,Deutsch; Alin Bernard,0,0,0,0
1668071550805,CSE 234,A01,112904,Kumar; Arun Kumar,0,0,0,0
1668071551247,CSE 237A,A00,102383,Rosing; Tajana Simunic,0,0,0,0
1668071551680,CSE 239A,A00,102384,Deutsch; Alin Bernard,0,0,0,0
1668071552108,CSE 239B,A00,102385,Polikarpova; Nadezhda,0,0,0,0
1668071552543,CSE 240A,A00,102386,Pannuto; Patrick William,0,0,0,0
1668071552969,CSE 240B,A00,102387,Zhao; Jishen,0,0,0,0
1668071553408,CSE 241A,A00,106406,Kang; Mingu,0,0,0,0
1668071553835,CSE 249B,A00,102388,Kahng; Andrew Byun,0,0,8,8
1668071554269,CSE 251B,A01,102392,Cottrell; Garrison W,0,0,0,0
1668071554269,CSE 251B,A02,102393,Cottrell; Garrison W,0,0,0,0
1668071554694,CSE 252B,A00,102394,Ochoa; Benjamin Lawrence,0,0,0,0
1668071555122,CSE 257,A01,102396,Gao; Sicun,0,0,0,0
1668071555545,CSE 272,A00,102397,Li; Tzumao,0,0,0,0
1668071555971,CSE 274,A00,111323,Chern; Albert Ren-Haur,0,0,0,0
1668071556396,CSE 282,A00,102398,Pevzner; Pavel Arkadjevich,0,0,0,0
1668071556821,CSE 284,A00,114175,Gymrek; Melissa Ann,0,0,0,0
1668071557253,CSE 290,A00,102399,Chandraker; Manmohan Krishna,0,0,0,0
1668071557253,CSE 290,B00,102400,Vaccaro; Kristen Marie,0,0,25,25
1668071557253,CSE 290,C00,102414,Pannuto; Patrick William,0,0,25,25
1668071557253,CSE 290,D00,102427,Pevzner; Pavel Arkadjevich,0,0,0,0
1668071557253,CSE 290,E00,102429,Zhao; Jishen,0,0,0,0
1668071557253,CSE 290,F00,102436,Tullsen; Dean Michael,0,0,0,0
1668071557253,CSE 290,G00,102440,Christensen; Henrik I,0,0,20,20
1668071557689,CSE 291,A00,102443,Su; Hao,0,0,0,0
1668071557689,CSE 291,B00,102448,Polikarpova; Nadezhda,0,0,0,0
1668071557689,CSE 291,C00,102453,Vaccaro; Kristen Marie,0,0,0,0
1668071557689,CSE 291,D00,111343,Savage; Stefan,0,0,0,0
1668071557689,CSE 291,E00,116474,Claffy; Kimberly Claire,0,0,0,0
1668071557689,CSE 291,F00,116479,Pasquale; Joseph,0,0,0,0
1668071558196,CSE 293,001,119111,Bafna; Vineet,9999,0,9999,0
1668071558196,CSE 293,002,119118,Bellare; Mihir,9999,0,9999,0
1668071558196,CSE 293,003,119122,Berg-Kirkpatrick; Taylor D,9999,0,9999,0
1668071558196,CSE 293,004,119135,Christensen; Henrik I,9999,0,9999,0
1668071558196,CSE 293,005,119142,Cottrell; Garrison W,9999,0,9999,0
1668071558196,CSE 293,006,119146,Deutsch; Alin Bernard,9999,0,9999,0
1668071558196,CSE 293,007,119159,Esmaeilzadeh; Hadi,9999,0,9999,0
1668071558196,CSE 293,008,119166,Freund; Yoav,9999,0,9999,0
1668071558196,CSE 293,009,119170,Griswold; William G.,9999,0,9999,0
1668071558196,CSE 293,010,119183,Gymrek; Melissa Ann,9999,0,9999,0
1668071558196,CSE 293,011,119190,Heninger; Nadia A,9999,0,9999,0
1668071558196,CSE 293,012,119230,Impagliazzo; Russell,9999,0,9999,0
1668071558196,CSE 293,013,119232,Jhala; Ranjit,9999,0,9999,0
1668071558196,CSE 293,014,119233,Kahng; Andrew Byun,9999,0,9999,0
1668071558196,CSE 293,015,119298,Kane; Daniel Mertz,9999,0,9999,0
1668071558196,CSE 293,016,119299,Kriegman; David J,9999,0,9999,0
1668071558196,CSE 293,017,119300,Kumar; Arun Kumar,9999,0,9999,0
1668071558196,CSE 293,018,119301,Lerner; Sorin,9999,0,9999,0
1668071558196,CSE 293,019,119302,Lovett; Shachar,9999,0,9999,0
1668071558196,CSE 293,020,119303,McAuley; Julian John,9999,0,9999,0
1668071558196,CSE 293,021,119304,Micciancio; Daniele,9999,0,9999,0
1668071558196,CSE 293,022,119367,Orailoglu; Alex,9999,0,9999,0
1668071558196,CSE 293,023,119382,Paturi; Ramamohan,9999,0,9999,0
1668071558196,CSE 293,024,119404,Polikarpova; Nadezhda,9999,0,9999,0
1668071558196,CSE 293,025,119406,Politz; Joseph Gibbs,9999,0,9999,0
1668071558196,CSE 293,026,119411,Porter; George M,9999,0,9999,0
1668071558196,CSE 293,027,119414,Porter; Leonard Emerson,9999,0,9999,0
1668071558196,CSE 293,028,119416,Ramamoorthi; Ravi,9999,0,9999,0
1668071558196,CSE 293,029,119417,Sahoo; Debashis,9999,0,9999,0
1668071558196,CSE 293,030,119420,Saul; Lawrence,9999,0,9999,0
1668071558196,CSE 293,031,119421,Savage; Stefan,9999,0,9999,0
1668071558196,CSE 293,032,119425,Schulze; Jurgen P.,9999,0,9999,0
1668071558196,CSE 293,033,119426,Snoeren; Alex C.,9999,0,9999,0
1668071558196,CSE 293,034,119428,Shang; Jingbo,9999,0,9999,0
1668071558196,CSE 293,035,119430,Stefan; Deian,9999,0,9999,0
1668071558196,CSE 293,036,119431,Su; Hao,9999,0,9999,0
1668071558196,CSE 293,037,119433,Swanson; Steven James,9999,0,9999,0
1668071558196,CSE 293,038,119435,Tullsen; Dean Michael,9999,0,9999,0
1668071558196,CSE 293,039,119483,Voelker; Geoffrey M.,9999,0,9999,0
1668071558196,CSE 293,040,119537,Zhao; Jishen,9999,0,9999,0
1668071558196,CSE 293,041,119538,Zhou; Yuan-Yuan,9999,0,9999,0
1668071558196,CSE 293,042,119539,Gao; Sicun,9999,0,9999,0
1668071558196,CSE 293,043,119540,Weibel; Nadir,9999,0,9999,0
1668071558196,CSE 293,044,119541,Gupta; Rajesh K.,9999,0,9999,0
1668071558196,CSE 293,045,126410,Vaccaro; Kristen Marie,9999,0,9999,0
1668071558196,CSE 293,046,126411,Klemke; Richard,9999,0,9999,0
1668071558620,CSE 294,A00,102459,Voelker; Geoffrey M.,0,0,0,0
1668071558620,CSE 294,B00,111322,Orailoglu; Alex,0,0,0,0
1668071559063,DSE 201,A00,096914,Deutsch; Alin Bernard,30,0,30,0
1668071559487,DSE 210,A00,096915,Dasgupta; Sanjoy,30,0,30,0
1668071559912,DSE 260A,A00,096916,Altintas De Callaf; Ilkay,30,0,30,0
1668071560442,ECE 200,001,103586,Antipa; Nicholas A,9999,0,9999,0
1668071560442,ECE 200,002,103587,Atanasov; Nikolay A.,9999,0,9999,0
1668071560442,ECE 200,003,103588,Bharadia; Dinesh,9999,0,9999,0
1668071560442,ECE 200,004,103589,Cheng; Chung Kuan,9999,0,9999,0
1668071560442,ECE 200,005,103590,Cosman; Pamela C.,9999,0,9999,0
1668071560442,ECE 200,006,103591,Dayeh; Shadi Ahmad,9999,0,9999,0
1668071560442,ECE 200,007,103592,Fainman; Yeshaiahu,9999,0,9999,0
1668071560442,ECE 200,008,103593,Ford; Joseph Earl,9999,0,9999,0
1668071560442,ECE 200,009,103594,Franceschetti; Massimo,9999,0,9999,0
1668071560442,ECE 200,010,103595,Fullerton; Eric E,9999,0,9999,0
1668071560442,ECE 200,011,103596,Galton; Ian A,9999,0,9999,0
1668071560442,ECE 200,012,103597,Gilja; Vikash,9999,0,9999,0
1668071560442,ECE 200,013,103598,Hall; Drew A.,9999,0,9999,0
1668071560442,ECE 200,014,103599,Hsueh; Tzu-Chien,9999,0,9999,0
1668071560442,ECE 200,015,103600,Javidi; Tara,9999,0,9999,0
1668071560442,ECE 200,016,103601,Kahng; Andrew Byun,9999,0,9999,0
1668071560442,ECE 200,017,103602,Kim; Young-Han,9999,0,9999,0
1668071560442,ECE 200,018,103603,Koushanfar; Farinaz,9999,0,9999,0
1668071560442,ECE 200,019,103604,Kuzum; Duygu,9999,0,9999,0
1668071560442,ECE 200,020,103605,Le; Hanh-Phuc,9999,0,9999,0
1668071560442,ECE 200,021,103606,Lin; Bill,9999,0,9999,0
1668071560442,ECE 200,022,103607,Liu; Zhaowei,9998,0,9999,1
1668071560442,ECE 200,023,103608,Lo; Yu-Hwa,9999,0,9999,0
1668071560442,ECE 200,024,103609,Lomakin; Vitaliy,9999,0,9999,0
1668071560442,ECE 200,025,103610,Mercier; Patrick Philip,9999,0,9999,0
1668071560442,ECE 200,026,103611,Meyer; Florian,9999,0,9999,0
1668071560442,ECE 200,027,103612,Milstein; Laurence B.,9999,0,9999,0
1668071560442,ECE 200,028,103613,Mir Arabbaygi; Siavash,9999,0,9999,0
1668071560442,ECE 200,029,103614,Mookherjea; Shayan,9999,0,9999,0
1668071560442,ECE 200,030,103615,Morris; Karcher William,9999,0,9999,0
1668071560442,ECE 200,031,103616,Ng; Tse Nga,9999,0,9999,0
1668071560442,ECE 200,032,103617,Nguyen; Truong Quang,9999,0,9999,0
1668071560442,ECE 200,033,103618,Nomura; Kenji,9999,0,9999,0
1668071560442,ECE 200,034,103619,Orlitsky; Alon,9999,0,9999,0
1668071560442,ECE 200,035,103620,Pal; Piya,9999,0,9999,0
1668071560442,ECE 200,036,103621,Papen; George C.,9999,0,9999,0
1668071560442,ECE 200,037,103622,Radic; Stojan,9999,0,9999,0
1668071560442,ECE 200,038,103623,Rao; Bhaskar D.,9999,0,9999,0
1668071560442,ECE 200,039,103624,Rao; Ramesh R,9999,0,9999,0
1668071560442,ECE 200,040,103625,Rebeiz; Gabriel,9999,0,9999,0
1668071560442,ECE 200,041,103626,Sanford; John R,9999,0,9999,0
1668071560442,ECE 200,042,103627,Siegel; Paul H.,9999,0,9999,0
1668071560442,ECE 200,043,103628,Sievenpiper; Daniel F.,9999,0,9999,0
1668071560442,ECE 200,044,103629,Sworder; David D.,9999,0,9999,0
1668071560442,ECE 200,045,103630,Taur; Yuan,9999,0,9999,0
1668071560442,ECE 200,046,103631,Touri; Behrouz,9999,0,9999,0
1668071560442,ECE 200,047,103632,Trivedi; Mohan M.,9999,0,9999,0
1668071560442,ECE 200,048,103633,Vasconcelos; Nuno,9999,0,9999,0
1668071560442,ECE 200,049,103634,Wang; Xiaolong,9999,0,9999,0
1668071560442,ECE 200,050,103635,Xie; Pengtao,9999,0,9999,0
1668071560442,ECE 200,051,103636,Yip; Michael,9999,0,9999,0
1668071560442,ECE 200,052,103637,Zeger; Kenneth A.,999,0,999,0
1668071560442,ECE 200,053,103638,Zhang; Xinyu,9999,0,9999,0
1668071560442,ECE 200,054,103639,Turakhia; Yatish Girish,9999,0,9999,0
1668071560442,ECE 200,055,103640,Kang; Mingu,9999,0,9999,0
1668071560442,ECE 200,056,103641,Shi; Yuanyuan,9999,0,9999,0
1668071560442,ECE 200,057,103642,Wang; Edward Jay,9999,0,9999,0
1668071560442,ECE 200,058,103643,Zheng; Yang,9999,0,9999,0
1668071560872,ECE 202,A00,103644,Kuzum; Duygu,0,0,0,0
1668071561298,ECE 212BN,A00,103646,Ng; Tse Nga,0,0,0,0
1668071561723,ECE 221,A00,111493,Staff,0,0,0,0
1668071562146,ECE 222B,A00,103647,Lomakin; Vitaliy,0,0,0,0
1668071562574,ECE 230B,A00,103648,Taur; Yuan,0,0,0,0
1668071563007,ECE 238B,A00,103649,Garay; Javier,0,0,0,0
1668071563431,ECE 240B,A00,112900,Fainman; Yeshaiahu,0,0,0,0
1668071563865,ECE 247A,A00,103650,Jokerst; Jesse Vincent,0,0,0,0
1668071564298,ECE 247B,A00,103651,Wang; Joseph,0,0,0,0
1668071564736,ECE 250,A00,103652,Siegel; Paul H.,0,0,0,0
1668071565179,ECE 251A,A00,103654,Rao; Bhaskar D.,0,0,0,0
1668071565608,ECE 257B,A00,103655,Bharadia; Dinesh,0,0,0,0
1668071566033,ECE 258A,A00,103656,Milstein; Laurence B.,0,0,0,0
1668071566485,ECE 260B,A00,103658,Kang; Mingu,0,0,0,0
1668071566938,ECE 264A,A00,103659,Galton; Ian A,0,0,0,0
1668071567456,ECE 265A,A00,103661,Gudem; Prasad S.S.,0,0,0,0
1668071567880,ECE 265D,A00,103662,Gudem; Prasad S.S.,0,0,0,0
1668071568315,ECE 268,A00,103663,Koushanfar; Farinaz,0,0,0,0
1668071568738,ECE 269,A01,103665,Pal; Piya,0,0,0,0
1668071569164,ECE 271B,A00,103666,Vasconcelos; Manuela,0,0,0,0
1668071569587,ECE 276A,A00,103667,Atanasov; Nikolay A.,0,0,0,0
1668071570011,ECE 277,A00,103668,An; Cheolhong,0,0,0,0
1668071570443,ECE 279,A00,117947,Hall; Drew A.,0,0,0,0
1668071571295,ECE 283,A00,103670,Hsueh; Tzu-Chien,0,0,0,0
1668071571729,ECE 284,A00,103671,Turakhia; Yatish Girish,0,0,0,0
1668071572163,ECE 285,A00,103672,Zheng; Yang,0,0,0,0
1668071572163,ECE 285,B00,103673,Sworder; David D.,0,0,0,0
1668071572591,ECE 287,A00,103676,Javidi; Tara,0,0,0,0
1668071573021,MATH 200B,A00,098023,Salehi Golsefidy; Alireza,13,0,15,2
1668071573445,MATH 202B,A00,098024,Rhoades; Brendon Patrick,9,0,15,6
1668071573875,MATH 203B,A00,098025,Oprea; Dragos N.,10,0,15,5
1668071574305,MATH 204B,A00,098026,Sorensen; Claus M,13,0,15,2
1668071574740,MATH 208,A00,098027,Izadi; Elham,7,0,10,3
1668071575164,MATH 209,A00,098028,Pollack; Aaron,10,0,10,0
1668071575593,MATH 211A,A00,112919,Rogalski; Daniel,9,0,10,1
1668071576015,MATH 211B,A00,112920,Seward; Brandon M.,9,0,10,1
1668071576455,MATH 218,A00,098029,Li; Bo,10,0,10,0
1668071576894,MATH 220B,A00,098030,Novak; Jonathan I,12,0,15,3
1668071577342,MATH 221A,A00,098031,Ebenfelt; Peter F,13,0,15,2
1668071577766,MATH 231B,A00,098032,Zlatos; Andrej,12,0,15,3
1668071578190,MATH 240B,A00,098033,Ni; Lei,9,0,15,6
1668071578616,MATH 243,A00,098034,Jekel; David Andrew,10,0,10,0
1668071579054,MATH 245A,A00,098035,Nie; Jiawang,0,0,15,16
1668071579481,MATH 248,A00,098036,Bejenaru; Ioan,10,0,10,0
1668071579910,MATH 250B,A00,098037,Spolaor; Luca,14,0,15,1
1668071580343,MATH 258,A00,098038,Ni; Lei,10,0,10,0
1668071580770,MATH 264B,A00,098041,Rhoades; Brendon Patrick,10,0,15,5
1668071581195,MATH 268,A00,098042,Buss; Samuel R,10,0,10,0
1668071581625,MATH 269,A00,098043,Rhoades; Brendon Patrick,10,0,10,0
1668071582053,MATH 270B,A00,098044,Li; Bo,11,0,15,4
1668071582487,MATH 272B,A00,098045,Holst; Michael J,13,0,15,2
1668071582913,MATH 273A,A00,098046,Tian; Xiaochuan,10,0,15,5
1668071583345,MATH 275,A01,098048,Tian; Xiaochuan,6,0,10,4
1668071583771,MATH 278A,A00,098049,Holst; Michael J,8,0,10,2
1668071584205,MATH 278B,A00,098050,Cloninger; Alexander,10,0,10,0
1668071584630,MATH 278C,A00,098051,Nie; Jiawang,7,0,10,3
1668071585057,MATH 280B,A00,098052,Zheng; Tianyi,10,0,15,5
1668071585481,MATH 281B,A00,098053,Bradic; Jelena,3,0,15,12
1668071585905,MATH 282B,A00,098054,Arias-Castro; Ery,0,0,15,15
1668071586331,MATH 285,A00,098055,Fitzsimmons; Patrick J,0,0,15,17
1668071586762,MATH 287B,A00,098056,Arias-Castro; Ery,3,0,15,12
1668071587192,MATH 288,A00,098057,Agarwal; Pooja,9,0,10,1
1668071587192,MATH 288,B00,098058,Zhang; Danna,8,0,10,2
1668071587192,MATH 288,C00,098059,Williams; Ruth J,10,0,10,0
1668071587625,MATH 290B,A00,098060,Roberts; Justin Deritter,13,0,15,2
1668071588048,MATH 292,A00,098061,Belmont; Eva Kinoshita,10,0,10,0
1668071588475,MATH 295,A00,098062,Suk; Andrew Hoon,48,0,50,2
1668071588903,MATH 296,A00,098063,Novak; Jonathan I,20,0,20,0
1668071589329,MATH 297,001,098064,Gamst; Anthony Collins,9997,0,9999,2
1668072103491,COGS 205,A00,101395,Chiba; Andrea,19,0,20,1
1668072103922,COGS 210B,001,101404,Greene; Deanna Jacquelyn,9998,0,9999,1
1668072103922,COGS 210B,002,101417,Xia; Haijun,9999,0,9999,0
1668072103922,COGS 210B,003,101422,Nitz; Douglas A.,9999,0,9999,0
1668072103922,COGS 210B,004,101423,Hollan; James D.,9998,0,9999,1
1668072103922,COGS 210B,005,101424,Deak; Gedeon O.,9998,0,9999,1
1668072103922,COGS 210B,006,101425,Rossano; Federico,9999,0,9999,0
1668072104349,COGS 211B,A00,101427,Coulson; Seana M,9996,0,9999,3
1668072104770,COGS 220,A00,101428,Hollan; James D.,0,0,25,25
1668072105197,COGS 229,A00,101429,Dow; Steven P,18,0,25,7
1668072105621,COGS 230,A00,101430,Klemmer; Scott R,13,0,17,4
1668072106056,COGS 234,A00,101431,Xia; Haijun,3,0,25,22
1668072106493,COGS 260,A00,101432,Kiyonaga; Anastasia,19,0,25,6
1668072106493,COGS 260,B00,101433,Kirsh; David Joel,16,0,25,9
1668072106930,CSE 202,A00,102371,Impagliazzo; Russell,0,0,0,0
1668072107359,CSE 203B,A01,102373,Cheng; Chung Kuan,0,0,0,0
1668072107791,CSE 208,A00,102374,Micciancio; Daniele,0,0,0,0
1668072108215,CSE 209A,A00,112895,Impagliazzo; Russell,0,0,15,15
1668072108647,CSE 209B,A00,108005,Bellare; Mihir,0,0,0,0
1668072109082,CSE 210,A00,113163,Coblenz; Michael J,0,0,0,0
1668072109507,CSE 219,A00,106111,Dow; Steven P,0,0,20,20
1668072109943,CSE 221,A00,102376,Voelker; Geoffrey M.,0,0,0,0
1668072110376,CSE 224,A01,102378,Porter; George M,0,0,0,0
1668072110802,CSE 229A,A00,102379,Savage; Stefan,0,0,0,0
1668072111229,CSE 229C,A00,102380,Munyaka; Imani N. S.,0,0,0,0
1668072111656,CSE 232B,A00,102382,Deutsch; Alin Bernard,0,0,0,0
1668072112081,CSE 234,A01,112904,Kumar; Arun Kumar,0,0,0,0
1668072112515,CSE 237A,A00,102383,Rosing; Tajana Simunic,0,0,0,0
1668072112951,CSE 239A,A00,102384,Deutsch; Alin Bernard,0,0,0,0
1668072113376,CSE 239B,A00,102385,Polikarpova; Nadezhda,0,0,0,0
1668072113804,CSE 240A,A00,102386,Pannuto; Patrick William,0,0,0,0
1668072114241,CSE 240B,A00,102387,Zhao; Jishen,0,0,0,0
1668072114666,CSE 241A,A00,106406,Kang; Mingu,0,0,0,0
1668072115088,CSE 249B,A00,102388,Kahng; Andrew Byun,0,0,8,8
1668072115520,CSE 251B,A01,102392,Cottrell; Garrison W,0,0,0,0
1668072115520,CSE 251B,A02,102393,Cottrell; Garrison W,0,0,0,0
1668072115944,CSE 252B,A00,102394,Ochoa; Benjamin Lawrence,0,0,0,0
1668072116370,CSE 257,A01,102396,Gao; Sicun,0,0,0,0
1668072116795,CSE 272,A00,102397,Li; Tzumao,0,0,0,0
1668072117220,CSE 274,A00,111323,Chern; Albert Ren-Haur,0,0,0,0
1668072117645,CSE 282,A00,102398,Pevzner; Pavel Arkadjevich,0,0,0,0
1668072118068,CSE 284,A00,114175,Gymrek; Melissa Ann,0,0,0,0
1668072118511,CSE 290,A00,102399,Chandraker; Manmohan Krishna,0,0,0,0
1668072118511,CSE 290,B00,102400,Vaccaro; Kristen Marie,0,0,25,25
1668072118511,CSE 290,C00,102414,Pannuto; Patrick William,0,0,25,25
1668072118511,CSE 290,D00,102427,Pevzner; Pavel Arkadjevich,0,0,0,0
1668072118511,CSE 290,E00,102429,Zhao; Jishen,0,0,0,0
1668072118511,CSE 290,F00,102436,Tullsen; Dean Michael,0,0,0,0
1668072118511,CSE 290,G00,102440,Christensen; Henrik I,0,0,20,20
1668072118940,CSE 291,A00,102443,Su; Hao,0,0,0,0
1668072118940,CSE 291,B00,102448,Polikarpova; Nadezhda,0,0,0,0
1668072118940,CSE 291,C00,102453,Vaccaro; Kristen Marie,0,0,0,0
1668072118940,CSE 291,D00,111343,Savage; Stefan,0,0,0,0
1668072118940,CSE 291,E00,116474,Claffy; Kimberly Claire,0,0,0,0
1668072118940,CSE 291,F00,116479,Pasquale; Joseph,0,0,0,0
1668072119406,CSE 293,001,119111,Bafna; Vineet,9999,0,9999,0
1668072119406,CSE 293,002,119118,Bellare; Mihir,9999,0,9999,0
1668072119406,CSE 293,003,119122,Berg-Kirkpatrick; Taylor D,9999,0,9999,0
1668072119406,CSE 293,004,119135,Christensen; Henrik I,9999,0,9999,0
1668072119406,CSE 293,005,119142,Cottrell; Garrison W,9999,0,9999,0
1668072119406,CSE 293,006,119146,Deutsch; Alin Bernard,9999,0,9999,0
1668072119406,CSE 293,007,119159,Esmaeilzadeh; Hadi,9999,0,9999,0
1668072119406,CSE 293,008,119166,Freund; Yoav,9999,0,9999,0
1668072119406,CSE 293,009,119170,Griswold; William G.,9999,0,9999,0
1668072119406,CSE 293,010,119183,Gymrek; Melissa Ann,9999,0,9999,0
1668072119406,CSE 293,011,119190,Heninger; Nadia A,9999,0,9999,0
1668072119406,CSE 293,012,119230,Impagliazzo; Russell,9999,0,9999,0
1668072119406,CSE 293,013,119232,Jhala; Ranjit,9999,0,9999,0
1668072119406,CSE 293,014,119233,Kahng; Andrew Byun,9999,0,9999,0
1668072119406,CSE 293,015,119298,Kane; Daniel Mertz,9999,0,9999,0
1668072119406,CSE 293,016,119299,Kriegman; David J,9999,0,9999,0
1668072119406,CSE 293,017,119300,Kumar; Arun Kumar,9999,0,9999,0
1668072119406,CSE 293,018,119301,Lerner; Sorin,9999,0,9999,0
1668072119406,CSE 293,019,119302,Lovett; Shachar,9999,0,9999,0
1668072119406,CSE 293,020,119303,McAuley; Julian John,9999,0,9999,0
1668072119406,CSE 293,021,119304,Micciancio; Daniele,9999,0,9999,0
1668072119406,CSE 293,022,119367,Orailoglu; Alex,9999,0,9999,0
1668072119406,CSE 293,023,119382,Paturi; Ramamohan,9999,0,9999,0
1668072119406,CSE 293,024,119404,Polikarpova; Nadezhda,9999,0,9999,0
1668072119406,CSE 293,025,119406,Politz; Joseph Gibbs,9999,0,9999,0
1668072119406,CSE 293,026,119411,Porter; George M,9999,0,9999,0
1668072119406,CSE 293,027,119414,Porter; Leonard Emerson,9999,0,9999,0
1668072119406,CSE 293,028,119416,Ramamoorthi; Ravi,9999,0,9999,0
1668072119406,CSE 293,029,119417,Sahoo; Debashis,9999,0,9999,0
1668072119406,CSE 293,030,119420,Saul; Lawrence,9999,0,9999,0
1668072119406,CSE 293,031,119421,Savage; Stefan,9999,0,9999,0
1668072119406,CSE 293,032,119425,Schulze; Jurgen P.,9999,0,9999,0
1668072119406,CSE 293,033,119426,Snoeren; Alex C.,9999,0,9999,0
1668072119406,CSE 293,034,119428,Shang; Jingbo,9999,0,9999,0
1668072119406,CSE 293,035,119430,Stefan; Deian,9999,0,9999,0
1668072119406,CSE 293,036,119431,Su; Hao,9999,0,9999,0
1668072119406,CSE 293,037,119433,Swanson; Steven James,9999,0,9999,0
1668072119406,CSE 293,038,119435,Tullsen; Dean Michael,9999,0,9999,0
1668072119406,CSE 293,039,119483,Voelker; Geoffrey M.,9999,0,9999,0
1668072119406,CSE 293,040,119537,Zhao; Jishen,9999,0,9999,0
1668072119406,CSE 293,041,119538,Zhou; Yuan-Yuan,9999,0,9999,0
1668072119406,CSE 293,042,119539,Gao; Sicun,9999,0,9999,0
1668072119406,CSE 293,043,119540,Weibel; Nadir,9999,0,9999,0
1668072119406,CSE 293,044,119541,Gupta; Rajesh K.,9999,0,9999,0
1668072119406,CSE 293,045,126410,Vaccaro; Kristen Marie,9999,0,9999,0
1668072119406,CSE 293,046,126411,Klemke; Richard,9999,0,9999,0
1668072119831,CSE 294,A00,102459,Voelker; Geoffrey M.,0,0,0,0
1668072119831,CSE 294,B00,111322,Orailoglu; Alex,0,0,0,0
1668072120260,DSE 201,A00,096914,Deutsch; Alin Bernard,30,0,30,0
1668072120685,DSE 210,A00,096915,Dasgupta; Sanjoy,30,0,30,0
1668072121108,DSE 260A,A00,096916,Altintas De Callaf; Ilkay,30,0,30,0
1668072121581,ECE 200,001,103586,Antipa; Nicholas A,9999,0,9999,0
1668072121581,ECE 200,002,103587,Atanasov; Nikolay A.,9999,0,9999,0
1668072121581,ECE 200,003,103588,Bharadia; Dinesh,9999,0,9999,0
1668072121581,ECE 200,004,103589,Cheng; Chung Kuan,9999,0,9999,0
1668072121581,ECE 200,005,103590,Cosman; Pamela C.,9999,0,9999,0
1668072121581,ECE 200,006,103591,Dayeh; Shadi Ahmad,9999,0,9999,0
1668072121581,ECE 200,007,103592,Fainman; Yeshaiahu,9999,0,9999,0
1668072121581,ECE 200,008,103593,Ford; Joseph Earl,9999,0,9999,0
1668072121581,ECE 200,009,103594,Franceschetti; Massimo,9999,0,9999,0
1668072121581,ECE 200,010,103595,Fullerton; Eric E,9999,0,9999,0
1668072121581,ECE 200,011,103596,Galton; Ian A,9999,0,9999,0
1668072121581,ECE 200,012,103597,Gilja; Vikash,9999,0,9999,0
1668072121581,ECE 200,013,103598,Hall; Drew A.,9999,0,9999,0
1668072121581,ECE 200,014,103599,Hsueh; Tzu-Chien,9999,0,9999,0
1668072121581,ECE 200,015,103600,Javidi; Tara,9999,0,9999,0
1668072121581,ECE 200,016,103601,Kahng; Andrew Byun,9999,0,9999,0
1668072121581,ECE 200,017,103602,Kim; Young-Han,9999,0,9999,0
1668072121581,ECE 200,018,103603,Koushanfar; Farinaz,9999,0,9999,0
1668072121581,ECE 200,019,103604,Kuzum; Duygu,9999,0,9999,0
1668072121581,ECE 200,020,103605,Le; Hanh-Phuc,9999,0,9999,0
1668072121581,ECE 200,021,103606,Lin; Bill,9999,0,9999,0
1668072121581,ECE 200,022,103607,Liu; Zhaowei,9998,0,9999,1
1668072121581,ECE 200,023,103608,Lo; Yu-Hwa,9999,0,9999,0
1668072121581,ECE 200,024,103609,Lomakin; Vitaliy,9999,0,9999,0
1668072121581,ECE 200,025,103610,Mercier; Patrick Philip,9999,0,9999,0
1668072121581,ECE 200,026,103611,Meyer; Florian,9999,0,9999,0
1668072121581,ECE 200,027,103612,Milstein; Laurence B.,9999,0,9999,0
1668072121581,ECE 200,028,103613,Mir Arabbaygi; Siavash,9999,0,9999,0
1668072121581,ECE 200,029,103614,Mookherjea; Shayan,9999,0,9999,0
1668072121581,ECE 200,030,103615,Morris; Karcher William,9999,0,9999,0
1668072121581,ECE 200,031,103616,Ng; Tse Nga,9999,0,9999,0
1668072121581,ECE 200,032,103617,Nguyen; Truong Quang,9999,0,9999,0
1668072121581,ECE 200,033,103618,Nomura; Kenji,9999,0,9999,0
1668072121581,ECE 200,034,103619,Orlitsky; Alon,9999,0,9999,0
1668072121581,ECE 200,035,103620,Pal; Piya,9999,0,9999,0
1668072121581,ECE 200,036,103621,Papen; George C.,9999,0,9999,0
1668072121581,ECE 200,037,103622,Radic; Stojan,9999,0,9999,0
1668072121581,ECE 200,038,103623,Rao; Bhaskar D.,9999,0,9999,0
1668072121581,ECE 200,039,103624,Rao; Ramesh R,9999,0,9999,0
1668072121581,ECE 200,040,103625,Rebeiz; Gabriel,9999,0,9999,0
1668072121581,ECE 200,041,103626,Sanford; John R,9999,0,9999,0
1668072121581,ECE 200,042,103627,Siegel; Paul H.,9999,0,9999,0
1668072121581,ECE 200,043,103628,Sievenpiper; Daniel F.,9999,0,9999,0
1668072121581,ECE 200,044,103629,Sworder; David D.,9999,0,9999,0
1668072121581,ECE 200,045,103630,Taur; Yuan,9999,0,9999,0
1668072121581,ECE 200,046,103631,Touri; Behrouz,9999,0,9999,0
1668072121581,ECE 200,047,103632,Trivedi; Mohan M.,9999,0,9999,0
1668072121581,ECE 200,048,103633,Vasconcelos; Nuno,9999,0,9999,0
1668072121581,ECE 200,049,103634,Wang; Xiaolong,9999,0,9999,0
1668072121581,ECE 200,050,103635,Xie; Pengtao,9999,0,9999,0
1668072121581,ECE 200,051,103636,Yip; Michael,9999,0,9999,0
1668072121581,ECE 200,052,103637,Zeger; Kenneth A.,999,0,999,0
1668072121581,ECE 200,053,103638,Zhang; Xinyu,9999,0,9999,0
1668072121581,ECE 200,054,103639,Turakhia; Yatish Girish,9999,0,9999,0
1668072121581,ECE 200,055,103640,Kang; Mingu,9999,0,9999,0
1668072121581,ECE 200,056,103641,Shi; Yuanyuan,9999,0,9999,0
1668072121581,ECE 200,057,103642,Wang; Edward Jay,9999,0,9999,0
1668072121581,ECE 200,058,103643,Zheng; Yang,9999,0,9999,0
1668072122036,ECE 202,A00,103644,Kuzum; Duygu,0,0,0,0
1668072122471,ECE 212BN,A00,103646,Ng; Tse Nga,0,0,0,0
1668072122896,ECE 221,A00,111493,Staff,0,0,0,0
1668072123325,ECE 222B,A00,103647,Lomakin; Vitaliy,0,0,0,0
1668072123764,ECE 230B,A00,103648,Taur; Yuan,0,0,0,0
1668072124202,ECE 238B,A00,103649,Garay; Javier,0,0,0,0
1668072124639,ECE 240B,A00,112900,Fainman; Yeshaiahu,0,0,0,0
1668072125063,ECE 247A,A00,103650,Jokerst; Jesse Vincent,0,0,0,0
1668072125513,ECE 247B,A00,103651,Wang; Joseph,0,0,0,0
1668072125939,ECE 250,A00,103652,Siegel; Paul H.,0,0,0,0
1668072126367,ECE 251A,A00,103654,Rao; Bhaskar D.,0,0,0,0
1668072126791,ECE 257B,A00,103655,Bharadia; Dinesh,0,0,0,0
1668072127224,ECE 258A,A00,103656,Milstein; Laurence B.,0,0,0,0
1668072127649,ECE 260B,A00,103658,Kang; Mingu,0,0,0,0
1668072128080,ECE 264A,A00,103659,Galton; Ian A,0,0,0,0
1668072128507,ECE 265A,A00,103661,Gudem; Prasad S.S.,0,0,0,0
1668072128932,ECE 265D,A00,103662,Gudem; Prasad S.S.,0,0,0,0
1668072129358,ECE 268,A00,103663,Koushanfar; Farinaz,0,0,0,0
1668072129786,ECE 269,A01,103665,Pal; Piya,0,0,0,0
1668072130214,ECE 271B,A00,103666,Vasconcelos; Manuela,0,0,0,0
1668072130641,ECE 276A,A00,103667,Atanasov; Nikolay A.,0,0,0,0
1668072131069,ECE 277,A00,103668,An; Cheolhong,0,0,0,0
1668072131498,ECE 279,A00,117947,Hall; Drew A.,0,0,0,0
1668072132352,ECE 283,A00,103670,Hsueh; Tzu-Chien,0,0,0,0
1668072132787,ECE 284,A00,103671,Turakhia; Yatish Girish,0,0,0,0
1668072133231,ECE 285,A00,103672,Zheng; Yang,0,0,0,0
1668072133231,ECE 285,B00,103673,Sworder; David D.,0,0,0,0
1668072133660,ECE 287,A00,103676,Javidi; Tara,0,0,0,0
1668072134088,MATH 200B,A00,098023,Salehi Golsefidy; Alireza,13,0,15,2
1668072134516,MATH 202B,A00,098024,Rhoades; Brendon Patrick,9,0,15,6
1668072134941,MATH 203B,A00,098025,Oprea; Dragos N.,10,0,15,5
1668072135364,MATH 204B,A00,098026,Sorensen; Claus M,13,0,15,2
1668072135791,MATH 208,A00,098027,Izadi; Elham,7,0,10,3
1668072136220,MATH 209,A00,098028,Pollack; Aaron,10,0,10,0
1668072136644,MATH 211A,A00,112919,Rogalski; Daniel,9,0,10,1
1668072137072,MATH 211B,A00,112920,Seward; Brandon M.,9,0,10,1
1668072137513,MATH 218,A00,098029,Li; Bo,10,0,10,0
1668072137937,MATH 220B,A00,098030,Novak; Jonathan I,12,0,15,3
1668072138372,MATH 221A,A00,098031,Ebenfelt; Peter F,13,0,15,2
1668072138801,MATH 231B,A00,098032,Zlatos; Andrej,12,0,15,3
1668072139227,MATH 240B,A00,098033,Ni; Lei,9,0,15,6
1668072139653,MATH 243,A00,098034,Jekel; David Andrew,10,0,10,0
1668072140083,MATH 245A,A00,098035,Nie; Jiawang,0,0,15,16
1668072140511,MATH 248,A00,098036,Bejenaru; Ioan,10,0,10,0
1668072140945,MATH 250B,A00,098037,Spolaor; Luca,14,0,15,1
1668072141370,MATH 258,A00,098038,Ni; Lei,10,0,10,0
1668072141798,MATH 264B,A00,098041,Rhoades; Brendon Patrick,10,0,15,5
1668072142224,MATH 268,A00,098042,Buss; Samuel R,10,0,10,0
1668072142649,MATH 269,A00,098043,Rhoades; Brendon Patrick,10,0,10,0
1668072143072,MATH 270B,A00,098044,Li; Bo,11,0,15,4
1668072143497,MATH 272B,A00,098045,Holst; Michael J,13,0,15,2
1668072143934,MATH 273A,A00,098046,Tian; Xiaochuan,10,0,15,5
1668072144363,MATH 275,A01,098048,Tian; Xiaochuan,6,0,10,4
1668072144793,MATH 278A,A00,098049,Holst; Michael J,8,0,10,2
1668072145311,MATH 278B,A00,098050,Cloninger; Alexander,10,0,10,0
1668072145741,MATH 278C,A00,098051,Nie; Jiawang,7,0,10,3
1668072146171,MATH 280B,A00,098052,Zheng; Tianyi,10,0,15,5
1668072146594,MATH 281B,A00,098053,Bradic; Jelena,3,0,15,12
1668072147021,MATH 282B,A00,098054,Arias-Castro; Ery,0,0,15,15
1668072147448,MATH 285,A00,098055,Fitzsimmons; Patrick J,0,0,15,17
1668072147872,MATH 287B,A00,098056,Arias-Castro; Ery,3,0,15,12
1668072148298,MATH 288,A00,098057,Agarwal; Pooja,9,0,10,1
1668072148298,MATH 288,B00,098058,Zhang; Danna,8,0,10,2
1668072148298,MATH 288,C00,098059,Williams; Ruth J,10,0,10,0
1668072148723,MATH 290B,A00,098060,Roberts; Justin Deritter,13,0,15,2
1668072149148,MATH 292,A00,098061,Belmont; Eva Kinoshita,10,0,10,0
1668072149577,MATH 295,A00,098062,Suk; Andrew Hoon,48,0,50,2
1668072150000,MATH 296,A00,098063,Novak; Jonathan I,20,0,20,0
1668072150427,MATH 297,001,098064,Gamst; Anthony Collins,9997,0,9999,2
1668072653227,COGS 205,A00,101395,Chiba; Andrea,19,0,20,1
1668072653654,COGS 210B,001,101404,Greene; Deanna Jacquelyn,9998,0,9999,1
1668072653654,COGS 210B,002,101417,Xia; Haijun,9999,0,9999,0
1668072653654,COGS 210B,003,101422,Nitz; Douglas A.,9999,0,9999,0
1668072653654,COGS 210B,004,101423,Hollan; James D.,9998,0,9999,1
1668072653654,COGS 210B,005,101424,Deak; Gedeon O.,9998,0,9999,1
1668072653654,COGS 210B,006,101425,Rossano; Federico,9999,0,9999,0
1668072654093,COGS 211B,A00,101427,Coulson; Seana M,9996,0,9999,3
1668072654526,COGS 220,A00,101428,Hollan; James D.,0,0,25,25
1668072654952,COGS 229,A00,101429,Dow; Steven P,18,0,25,7
1668072655392,COGS 230,A00,101430,Klemmer; Scott R,13,0,17,4
1668072655815,COGS 234,A00,101431,Xia; Haijun,3,0,25,22
1668072656246,COGS 260,A00,101432,Kiyonaga; Anastasia,19,0,25,6
1668072656246,COGS 260,B00,101433,Kirsh; David Joel,16,0,25,9
1668072656670,CSE 202,A00,102371,Impagliazzo; Russell,0,0,0,0
1668072657094,CSE 203B,A01,102373,Cheng; Chung Kuan,0,0,0,0
1668072657522,CSE 208,A00,102374,Micciancio; Daniele,0,0,0,0
1668072657945,CSE 209A,A00,112895,Impagliazzo; Russell,0,0,15,15
1668072658371,CSE 209B,A00,108005,Bellare; Mihir,0,0,0,0
1668072658796,CSE 210,A00,113163,Coblenz; Michael J,0,0,0,0
1668072659225,CSE 219,A00,106111,Dow; Steven P,0,0,20,20
1668072659650,CSE 221,A00,102376,Voelker; Geoffrey M.,0,0,0,0
1668072660076,CSE 224,A01,102378,Porter; George M,0,0,0,0
1668072660501,CSE 229A,A00,102379,Savage; Stefan,0,0,0,0
1668072660926,CSE 229C,A00,102380,Munyaka; Imani N. S.,0,0,0,0
1668072661351,CSE 232B,A00,102382,Deutsch; Alin Bernard,0,0,0,0
1668072661778,CSE 234,A01,112904,Kumar; Arun Kumar,0,0,0,0
1668072662201,CSE 237A,A00,102383,Rosing; Tajana Simunic,0,0,0,0
1668072662627,CSE 239A,A00,102384,Deutsch; Alin Bernard,0,0,0,0
1668072663052,CSE 239B,A00,102385,Polikarpova; Nadezhda,0,0,0,0
1668072663482,CSE 240A,A00,102386,Pannuto; Patrick William,0,0,0,0
1668072663907,CSE 240B,A00,102387,Zhao; Jishen,0,0,0,0
1668072664332,CSE 241A,A00,106406,Kang; Mingu,0,0,0,0
1668072664757,CSE 249B,A00,102388,Kahng; Andrew Byun,0,0,8,8
1668072665182,CSE 251B,A01,102392,Cottrell; Garrison W,0,0,0,0
1668072665182,CSE 251B,A02,102393,Cottrell; Garrison W,0,0,0,0
1668072665610,CSE 252B,A00,102394,Ochoa; Benjamin Lawrence,0,0,0,0
1668072666037,CSE 257,A01,102396,Gao; Sicun,0,0,0,0
1668072666474,CSE 272,A00,102397,Li; Tzumao,0,0,0,0
1668072666902,CSE 274,A00,111323,Chern; Albert Ren-Haur,0,0,0,0
1668072667331,CSE 282,A00,102398,Pevzner; Pavel Arkadjevich,0,0,0,0
1668072667756,CSE 284,A00,114175,Gymrek; Melissa Ann,0,0,0,0
1668072668301,CSE 290,A00,102399,Chandraker; Manmohan Krishna,0,0,0,0
1668072668301,CSE 290,B00,102400,Vaccaro; Kristen Marie,0,0,25,25
1668072668301,CSE 290,C00,102414,Pannuto; Patrick William,0,0,25,25
1668072668301,CSE 290,D00,102427,Pevzner; Pavel Arkadjevich,0,0,0,0
1668072668301,CSE 290,E00,102429,Zhao; Jishen,0,0,0,0
1668072668301,CSE 290,F00,102436,Tullsen; Dean Michael,0,0,0,0
1668072668301,CSE 290,G00,102440,Christensen; Henrik I,0,0,20,20
1668072668727,CSE 291,A00,102443,Su; Hao,0,0,0,0
1668072668727,CSE 291,B00,102448,Polikarpova; Nadezhda,0,0,0,0
1668072668727,CSE 291,C00,102453,Vaccaro; Kristen Marie,0,0,0,0
1668072668727,CSE 291,D00,111343,Savage; Stefan,0,0,0,0
1668072668727,CSE 291,E00,116474,Claffy; Kimberly Claire,0,0,0,0
1668072668727,CSE 291,F00,116479,Pasquale; Joseph,0,0,0,0
1668072669173,CSE 293,001,119111,Bafna; Vineet,9999,0,9999,0
1668072669173,CSE 293,002,119118,Bellare; Mihir,9999,0,9999,0
1668072669173,CSE 293,003,119122,Berg-Kirkpatrick; Taylor D,9999,0,9999,0
1668072669173,CSE 293,004,119135,Christensen; Henrik I,9999,0,9999,0
1668072669173,CSE 293,005,119142,Cottrell; Garrison W,9999,0,9999,0
1668072669173,CSE 293,006,119146,Deutsch; Alin Bernard,9999,0,9999,0
1668072669173,CSE 293,007,119159,Esmaeilzadeh; Hadi,9999,0,9999,0
1668072669173,CSE 293,008,119166,Freund; Yoav,9999,0,9999,0
1668072669173,CSE 293,009,119170,Griswold; William G.,9999,0,9999,0
1668072669173,CSE 293,010,119183,Gymrek; Melissa Ann,9999,0,9999,0
1668072669173,CSE 293,011,119190,Heninger; Nadia A,9999,0,9999,0
1668072669173,CSE 293,012,119230,Impagliazzo; Russell,9999,0,9999,0
1668072669173,CSE 293,013,119232,Jhala; Ranjit,9999,0,9999,0
1668072669173,CSE 293,014,119233,Kahng; Andrew Byun,9999,0,9999,0
1668072669173,CSE 293,015,119298,Kane; Daniel Mertz,9999,0,9999,0
1668072669173,CSE 293,016,119299,Kriegman; David J,9999,0,9999,0
1668072669173,CSE 293,017,119300,Kumar; Arun Kumar,9999,0,9999,0
1668072669173,CSE 293,018,119301,Lerner; Sorin,9999,0,9999,0
1668072669173,CSE 293,019,119302,Lovett; Shachar,9999,0,9999,0
1668072669173,CSE 293,020,119303,McAuley; Julian John,9999,0,9999,0
1668072669173,CSE 293,021,119304,Micciancio; Daniele,9999,0,9999,0
1668072669173,CSE 293,022,119367,Orailoglu; Alex,9999,0,9999,0
1668072669173,CSE 293,023,119382,Paturi; Ramamohan,9999,0,9999,0
1668072669173,CSE 293,024,119404,Polikarpova; Nadezhda,9999,0,9999,0
1668072669173,CSE 293,025,119406,Politz; Joseph Gibbs,9999,0,9999,0
1668072669173,CSE 293,026,119411,Porter; George M,9999,0,9999,0
1668072669173,CSE 293,027,119414,Porter; Leonard Emerson,9999,0,9999,0
1668072669173,CSE 293,028,119416,Ramamoorthi; Ravi,9999,0,9999,0
1668072669173,CSE 293,029,119417,Sahoo; Debashis,9999,0,9999,0
1668072669173,CSE 293,030,119420,Saul; Lawrence,9999,0,9999,0
1668072669173,CSE 293,031,119421,Savage; Stefan,9999,0,9999,0
1668072669173,CSE 293,032,119425,Schulze; Jurgen P.,9999,0,9999,0
1668072669173,CSE 293,033,119426,Snoeren; Alex C.,9999,0,9999,0
1668072669173,CSE 293,034,119428,Shang; Jingbo,9999,0,9999,0
1668072669173,CSE 293,035,119430,Stefan; Deian,9999,0,9999,0
1668072669173,CSE 293,036,119431,Su; Hao,9999,0,9999,0
1668072669173,CSE 293,037,119433,Swanson; Steven James,9999,0,9999,0
1668072669173,CSE 293,038,119435,Tullsen; Dean Michael,9999,0,9999,0
1668072669173,CSE 293,039,119483,Voelker; Geoffrey M.,9999,0,9999,0
1668072669173,CSE 293,040,119537,Zhao; Jishen,9999,0,9999,0
1668072669173,CSE 293,041,119538,Zhou; Yuan-Yuan,9999,0,9999,0
1668072669173,CSE 293,042,119539,Gao; Sicun,9999,0,9999,0
1668072669173,CSE 293,043,119540,Weibel; Nadir,9999,0,9999,0
1668072669173,CSE 293,044,119541,Gupta; Rajesh K.,9999,0,9999,0
1668072669173,CSE 293,045,126410,Vaccaro; Kristen Marie,9999,0,9999,0
1668072669173,CSE 293,046,126411,Klemke; Richard,9999,0,9999,0
1668072669624,CSE 294,A00,102459,Voelker; Geoffrey M.,0,0,0,0
1668072669624,CSE 294,B00,111322,Orailoglu; Alex,0,0,0,0
1668072670050,DSE 201,A00,096914,Deutsch; Alin Bernard,30,0,30,0
1668072670474,DSE 210,A00,096915,Dasgupta; Sanjoy,30,0,30,0
1668072670912,DSE 260A,A00,096916,Altintas De Callaf; Ilkay,30,0,30,0
1668072671392,ECE 200,001,103586,Antipa; Nicholas A,9999,0,9999,0
1668072671392,ECE 200,002,103587,Atanasov; Nikolay A.,9999,0,9999,0
1668072671392,ECE 200,003,103588,Bharadia; Dinesh,9999,0,9999,0
1668072671392,ECE 200,004,103589,Cheng; Chung Kuan,9999,0,9999,0
1668072671392,ECE 200,005,103590,Cosman; Pamela C.,9999,0,9999,0
1668072671392,ECE 200,006,103591,Dayeh; Shadi Ahmad,9999,0,9999,0
1668072671392,ECE 200,007,103592,Fainman; Yeshaiahu,9999,0,9999,0
1668072671392,ECE 200,008,103593,Ford; Joseph Earl,9999,0,9999,0
1668072671392,ECE 200,009,103594,Franceschetti; Massimo,9999,0,9999,0
1668072671392,ECE 200,010,103595,Fullerton; Eric E,9999,0,9999,0
1668072671392,ECE 200,011,103596,Galton; Ian A,9999,0,9999,0
1668072671392,ECE 200,012,103597,Gilja; Vikash,9999,0,9999,0
1668072671392,ECE 200,013,103598,Hall; Drew A.,9999,0,9999,0
1668072671392,ECE 200,014,103599,Hsueh; Tzu-Chien,9999,0,9999,0
1668072671392,ECE 200,015,103600,Javidi; Tara,9999,0,9999,0
1668072671392,ECE 200,016,103601,Kahng; Andrew Byun,9999,0,9999,0
1668072671392,ECE 200,017,103602,Kim; Young-Han,9999,0,9999,0
1668072671392,ECE 200,018,103603,Koushanfar; Farinaz,9999,0,9999,0
1668072671392,ECE 200,019,103604,Kuzum; Duygu,9999,0,9999,0
1668072671392,ECE 200,020,103605,Le; Hanh-Phuc,9999,0,9999,0
1668072671392,ECE 200,021,103606,Lin; Bill,9999,0,9999,0
1668072671392,ECE 200,022,103607,Liu; Zhaowei,9998,0,9999,1
1668072671392,ECE 200,023,103608,Lo; Yu-Hwa,9999,0,9999,0
1668072671392,ECE 200,024,103609,Lomakin; Vitaliy,9999,0,9999,0
1668072671392,ECE 200,025,103610,Mercier; Patrick Philip,9999,0,9999,0
1668072671392,ECE 200,026,103611,Meyer; Florian,9999,0,9999,0
1668072671392,ECE 200,027,103612,Milstein; Laurence B.,9999,0,9999,0
1668072671392,ECE 200,028,103613,Mir Arabbaygi; Siavash,9999,0,9999,0
1668072671392,ECE 200,029,103614,Mookherjea; Shayan,9999,0,9999,0
1668072671392,ECE 200,030,103615,Morris; Karcher William,9999,0,9999,0
1668072671392,ECE 200,031,103616,Ng; Tse Nga,9999,0,9999,0
1668072671392,ECE 200,032,103617,Nguyen; Truong Quang,9999,0,9999,0
1668072671392,ECE 200,033,103618,Nomura; Kenji,9999,0,9999,0
1668072671392,ECE 200,034,103619,Orlitsky; Alon,9999,0,9999,0
1668072671392,ECE 200,035,103620,Pal; Piya,9999,0,9999,0
1668072671392,ECE 200,036,103621,Papen; George C.,9999,0,9999,0
1668072671392,ECE 200,037,103622,Radic; Stojan,9999,0,9999,0
1668072671392,ECE 200,038,103623,Rao; Bhaskar D.,9999,0,9999,0
1668072671392,ECE 200,039,103624,Rao; Ramesh R,9999,0,9999,0
1668072671392,ECE 200,040,103625,Rebeiz; Gabriel,9999,0,9999,0
1668072671392,ECE 200,041,103626,Sanford; John R,9999,0,9999,0
1668072671392,ECE 200,042,103627,Siegel; Paul H.,9999,0,9999,0
1668072671392,ECE 200,043,103628,Sievenpiper; Daniel F.,9999,0,9999,0
1668072671392,ECE 200,044,103629,Sworder; David D.,9999,0,9999,0
1668072671392,ECE 200,045,103630,Taur; Yuan,9999,0,9999,0
1668072671392,ECE 200,046,103631,Touri; Behrouz,9999,0,9999,0
1668072671392,ECE 200,047,103632,Trivedi; Mohan M.,9999,0,9999,0
1668072671392,ECE 200,048,103633,Vasconcelos; Nuno,9999,0,9999,0
1668072671392,ECE 200,049,103634,Wang; Xiaolong,9999,0,9999,0
1668072671392,ECE 200,050,103635,Xie; Pengtao,9999,0,9999,0
1668072671392,ECE 200,051,103636,Yip; Michael,9999,0,9999,0
1668072671392,ECE 200,052,103637,Zeger; Kenneth A.,999,0,999,0
1668072671392,ECE 200,053,103638,Zhang; Xinyu,9999,0,9999,0
1668072671392,ECE 200,054,103639,Turakhia; Yatish Girish,9999,0,9999,0
1668072671392,ECE 200,055,103640,Kang; Mingu,9999,0,9999,0
1668072671392,ECE 200,056,103641,Shi; Yuanyuan,9999,0,9999,0
1668072671392,ECE 200,057,103642,Wang; Edward Jay,9999,0,9999,0
1668072671392,ECE 200,058,103643,Zheng; Yang,9999,0,9999,0
1668072671831,ECE 202,A00,103644,Kuzum; Duygu,0,0,0,0
1668072672266,ECE 212BN,A00,103646,Ng; Tse Nga,0,0,0,0
1668072672691,ECE 221,A00,111493,Staff,0,0,0,0
1668072673118,ECE 222B,A00,103647,Lomakin; Vitaliy,0,0,0,0
1668072673544,ECE 230B,A00,103648,Taur; Yuan,0,0,0,0
1668072673971,ECE 238B,A00,103649,Garay; Javier,0,0,0,0
1668072674398,ECE 240B,A00,112900,Fainman; Yeshaiahu,0,0,0,0
1668072674832,ECE 247A,A00,103650,Jokerst; Jesse Vincent,0,0,0,0
1668072675261,ECE 247B,A00,103651,Wang; Joseph,0,0,0,0
1668072675684,ECE 250,A00,103652,Siegel; Paul H.,0,0,0,0
1668072676121,ECE 251A,A00,103654,Rao; Bhaskar D.,0,0,0,0
1668072676544,ECE 257B,A00,103655,Bharadia; Dinesh,0,0,0,0
1668072676971,ECE 258A,A00,103656,Milstein; Laurence B.,0,0,0,0
1668072677395,ECE 260B,A00,103658,Kang; Mingu,0,0,0,0
1668072677823,ECE 264A,A00,103659,Galton; Ian A,0,0,0,0
1668072678246,ECE 265A,A00,103661,Gudem; Prasad S.S.,0,0,0,0
1668072678671,ECE 265D,A00,103662,Gudem; Prasad S.S.,0,0,0,0
1668072679108,ECE 268,A00,103663,Koushanfar; Farinaz,0,0,0,0
1668072679539,ECE 269,A01,103665,Pal; Piya,0,0,0,0
1668072679965,ECE 271B,A00,103666,Vasconcelos; Manuela,0,0,0,0
1668072680393,ECE 276A,A00,103667,Atanasov; Nikolay A.,0,0,0,0
1668072680822,ECE 277,A00,103668,An; Cheolhong,0,0,0,0
1668072681245,ECE 279,A00,117947,Hall; Drew A.,0,0,0,0
1668072682100,ECE 283,A00,103670,Hsueh; Tzu-Chien,0,0,0,0
1668072682526,ECE 284,A00,103671,Turakhia; Yatish Girish,0,0,0,0
1668072682952,ECE 285,A00,103672,Zheng; Yang,0,0,0,0
1668072682952,ECE 285,B00,103673,Sworder; David D.,0,0,0,0
1668072683380,ECE 287,A00,103676,Javidi; Tara,0,0,0,0
1668072683818,MATH 200B,A00,098023,Salehi Golsefidy; Alireza,13,0,15,2
1668072684254,MATH 202B,A00,098024,Rhoades; Brendon Patrick,9,0,15,6
1668072684686,MATH 203B,A00,098025,Oprea; Dragos N.,10,0,15,5
1668072685121,MATH 204B,A00,098026,Sorensen; Claus M,13,0,15,2
1668072685547,MATH 208,A00,098027,Izadi; Elham,7,0,10,3
1668072685973,MATH 209,A00,098028,Pollack; Aaron,10,0,10,0
1668072686413,MATH 211A,A00,112919,Rogalski; Daniel,9,0,10,1
1668072686838,MATH 211B,A00,112920,Seward; Brandon M.,9,0,10,1
1668072687261,MATH 218,A00,098029,Li; Bo,10,0,10,0
1668072687686,MATH 220B,A00,098030,Novak; Jonathan I,12,0,15,3
1668072688135,MATH 221A,A00,098031,Ebenfelt; Peter F,13,0,15,2
1668072688564,MATH 231B,A00,098032,Zlatos; Andrej,12,0,15,3
1668072688991,MATH 240B,A00,098033,Ni; Lei,9,0,15,6
1668072689416,MATH 243,A00,098034,Jekel; David Andrew,10,0,10,0
1668072689845,MATH 245A,A00,098035,Nie; Jiawang,0,0,15,16
1668072690272,MATH 248,A00,098036,Bejenaru; Ioan,10,0,10,0
1668072690700,MATH 250B,A00,098037,Spolaor; Luca,14,0,15,1
1668072691128,MATH 258,A00,098038,Ni; Lei,10,0,10,0
1668072691557,MATH 264B,A00,098041,Rhoades; Brendon Patrick,10,0,15,5
1668072691980,MATH 268,A00,098042,Buss; Samuel R,10,0,10,0
1668072692403,MATH 269,A00,098043,Rhoades; Brendon Patrick,10,0,10,0
1668072692836,MATH 270B,A00,098044,Li; Bo,11,0,15,4
1668072693262,MATH 272B,A00,098045,Holst; Michael J,13,0,15,2
1668072693705,MATH 273A,A00,098046,Tian; Xiaochuan,10,0,15,5
1668072694146,MATH 275,A01,098048,Tian; Xiaochuan,6,0,10,4
1668072694571,MATH 278A,A00,098049,Holst; Michael J,8,0,10,2
1668072694997,MATH 278B,A00,098050,Cloninger; Alexander,10,0,10,0
1668072695426,MATH 278C,A00,098051,Nie; Jiawang,7,0,10,3
1668072695851,MATH 280B,A00,098052,Zheng; Tianyi,10,0,15,5
1668072696280,MATH 281B,A00,098053,Bradic; Jelena,3,0,15,12
1668072696719,MATH 282B,A00,098054,Arias-Castro; Ery,0,0,15,15
1668072697147,MATH 285,A00,098055,Fitzsimmons; Patrick J,0,0,15,17
1668072697578,MATH 287B,A00,098056,Arias-Castro; Ery,3,0,15,12
1668072698007,MATH 288,A00,098057,Agarwal; Pooja,9,0,10,1
1668072698007,MATH 288,B00,098058,Zhang; Danna,8,0,10,2
1668072698007,MATH 288,C00,098059,Williams; Ruth J,10,0,10,0
1668072698435,MATH 290B,A00,098060,Roberts; Justin Deritter,13,0,15,2
1668072698860,MATH 292,A00,098061,Belmont; Eva Kinoshita,10,0,10,0
1668072699291,MATH 295,A00,098062,Suk; Andrew Hoon,48,0,50,2
1668072699716,MATH 296,A00,098063,Novak; Jonathan I,20,0,20,0
1668072700144,MATH 297,001,098064,Gamst; Anthony Collins,9997,0,9999,2
1668073203340,COGS 205,A00,101395,Chiba; Andrea,19,0,20,1
1668073203773,COGS 210B,001,101404,Greene; Deanna Jacquelyn,9998,0,9999,1
1668073203773,COGS 210B,002,101417,Xia; Haijun,9999,0,9999,0
1668073203773,COGS 210B,003,101422,Nitz; Douglas A.,9999,0,9999,0
1668073203773,COGS 210B,004,101423,Hollan; James D.,9998,0,9999,1
1668073203773,COGS 210B,005,101424,Deak; Gedeon O.,9998,0,9999,1
1668073203773,COGS 210B,006,101425,Rossano; Federico,9999,0,9999,0
1668073204198,COGS 211B,A00,101427,Coulson; Seana M,9996,0,9999,3
1668073204622,COGS 220,A00,101428,Hollan; James D.,0,0,25,25
1668073205050,COGS 229,A00,101429,Dow; Steven P,18,0,25,7
1668073205479,COGS 230,A00,101430,Klemmer; Scott R,13,0,17,4
1668073205904,COGS 234,A00,101431,Xia; Haijun,3,0,25,22
1668073206329,COGS 260,A00,101432,Kiyonaga; Anastasia,19,0,25,6
1668073206329,COGS 260,B00,101433,Kirsh; David Joel,16,0,25,9
1668073206762,CSE 202,A00,102371,Impagliazzo; Russell,0,0,0,0
1668073207194,CSE 203B,A01,102373,Cheng; Chung Kuan,0,0,0,0
1668073207618,CSE 208,A00,102374,Micciancio; Daniele,0,0,0,0
1668073208045,CSE 209A,A00,112895,Impagliazzo; Russell,0,0,15,15
1668073208471,CSE 209B,A00,108005,Bellare; Mihir,0,0,0,0
1668073208898,CSE 210,A00,113163,Coblenz; Michael J,0,0,0,0
1668073209323,CSE 219,A00,106111,Dow; Steven P,0,0,20,20
1668073209751,CSE 221,A00,102376,Voelker; Geoffrey M.,0,0,0,0
1668073210188,CSE 224,A01,102378,Porter; George M,0,0,0,0
1668073210619,CSE 229A,A00,102379,Savage; Stefan,0,0,0,0
1668073211047,CSE 229C,A00,102380,Munyaka; Imani N. S.,0,0,0,0
1668073211474,CSE 232B,A00,102382,Deutsch; Alin Bernard,0,0,0,0
1668073211903,CSE 234,A01,112904,Kumar; Arun Kumar,0,0,0,0
1668073212331,CSE 237A,A00,102383,Rosing; Tajana Simunic,0,0,0,0
1668073212761,CSE 239A,A00,102384,Deutsch; Alin Bernard,0,0,0,0
1668073213200,CSE 239B,A00,102385,Polikarpova; Nadezhda,0,0,0,0
1668073213637,CSE 240A,A00,102386,Pannuto; Patrick William,0,0,0,0
1668073214066,CSE 240B,A00,102387,Zhao; Jishen,0,0,0,0
1668073214525,CSE 241A,A00,106406,Kang; Mingu,0,0,0,0
1668073214968,CSE 249B,A00,102388,Kahng; Andrew Byun,0,0,8,8
1668073215407,CSE 251B,A01,102392,Cottrell; Garrison W,0,0,0,0
1668073215407,CSE 251B,A02,102393,Cottrell; Garrison W,0,0,0,0
1668073215834,CSE 252B,A00,102394,Ochoa; Benjamin Lawrence,0,0,0,0
1668073216267,CSE 257,A01,102396,Gao; Sicun,0,0,0,0
1668073216703,CSE 272,A00,102397,Li; Tzumao,0,0,0,0
1668073217128,CSE 274,A00,111323,Chern; Albert Ren-Haur,0,0,0,0
1668073217553,CSE 282,A00,102398,Pevzner; Pavel Arkadjevich,0,0,0,0
1668073217979,CSE 284,A00,114175,Gymrek; Melissa Ann,0,0,0,0
1668073218416,CSE 290,A00,102399,Chandraker; Manmohan Krishna,0,0,0,0
1668073218416,CSE 290,B00,102400,Vaccaro; Kristen Marie,0,0,25,25
1668073218416,CSE 290,C00,102414,Pannuto; Patrick William,0,0,25,25
1668073218416,CSE 290,D00,102427,Pevzner; Pavel Arkadjevich,0,0,0,0
1668073218416,CSE 290,E00,102429,Zhao; Jishen,0,0,0,0
1668073218416,CSE 290,F00,102436,Tullsen; Dean Michael,0,0,0,0
1668073218416,CSE 290,G00,102440,Christensen; Henrik I,0,0,20,20
1668073218855,CSE 291,A00,102443,Su; Hao,0,0,0,0
1668073218855,CSE 291,B00,102448,Polikarpova; Nadezhda,0,0,0,0
1668073218855,CSE 291,C00,102453,Vaccaro; Kristen Marie,0,0,0,0
1668073218855,CSE 291,D00,111343,Savage; Stefan,0,0,0,0
1668073218855,CSE 291,E00,116474,Claffy; Kimberly Claire,0,0,0,0
1668073218855,CSE 291,F00,116479,Pasquale; Joseph,0,0,0,0
1668073219345,CSE 293,001,119111,Bafna; Vineet,9999,0,9999,0
1668073219345,CSE 293,002,119118,Bellare; Mihir,9999,0,9999,0
1668073219345,CSE 293,003,119122,Berg-Kirkpatrick; Taylor D,9999,0,9999,0
1668073219345,CSE 293,004,119135,Christensen; Henrik I,9999,0,9999,0
1668073219345,CSE 293,005,119142,Cottrell; Garrison W,9999,0,9999,0
1668073219345,CSE 293,006,119146,Deutsch; Alin Bernard,9999,0,9999,0
1668073219345,CSE 293,007,119159,Esmaeilzadeh; Hadi,9999,0,9999,0
1668073219345,CSE 293,008,119166,Freund; Yoav,9999,0,9999,0
1668073219345,CSE 293,009,119170,Griswold; William G.,9999,0,9999,0
1668073219345,CSE 293,010,119183,Gymrek; Melissa Ann,9999,0,9999,0
1668073219345,CSE 293,011,119190,Heninger; Nadia A,9999,0,9999,0
1668073219345,CSE 293,012,119230,Impagliazzo; Russell,9999,0,9999,0
1668073219345,CSE 293,013,119232,Jhala; Ranjit,9999,0,9999,0
1668073219345,CSE 293,014,119233,Kahng; Andrew Byun,9999,0,9999,0
1668073219345,CSE 293,015,119298,Kane; Daniel Mertz,9999,0,9999,0
1668073219345,CSE 293,016,119299,Kriegman; David J,9999,0,9999,0
1668073219345,CSE 293,017,119300,Kumar; Arun Kumar,9999,0,9999,0
1668073219345,CSE 293,018,119301,Lerner; Sorin,9999,0,9999,0
1668073219345,CSE 293,019,119302,Lovett; Shachar,9999,0,9999,0
1668073219345,CSE 293,020,119303,McAuley; Julian John,9999,0,9999,0
1668073219345,CSE 293,021,119304,Micciancio; Daniele,9999,0,9999,0
1668073219345,CSE 293,022,119367,Orailoglu; Alex,9999,0,9999,0
1668073219345,CSE 293,023,119382,Paturi; Ramamohan,9999,0,9999,0
1668073219345,CSE 293,024,119404,Polikarpova; Nadezhda,9999,0,9999,0
1668073219345,CSE 293,025,119406,Politz; Joseph Gibbs,9999,0,9999,0
1668073219345,CSE 293,026,119411,Porter; George M,9999,0,9999,0
1668073219345,CSE 293,027,119414,Porter; Leonard Emerson,9999,0,9999,0
1668073219345,CSE 293,028,119416,Ramamoorthi; Ravi,9999,0,9999,0
1668073219345,CSE 293,029,119417,Sahoo; Debashis,9999,0,9999,0
1668073219345,CSE 293,030,119420,Saul; Lawrence,9999,0,9999,0
1668073219345,CSE 293,031,119421,Savage; Stefan,9999,0,9999,0
1668073219345,CSE 293,032,119425,Schulze; Jurgen P.,9999,0,9999,0
1668073219345,CSE 293,033,119426,Snoeren; Alex C.,9999,0,9999,0
1668073219345,CSE 293,034,119428,Shang; Jingbo,9999,0,9999,0
1668073219345,CSE 293,035,119430,Stefan; Deian,9999,0,9999,0
1668073219345,CSE 293,036,119431,Su; Hao,9999,0,9999,0
1668073219345,CSE 293,037,119433,Swanson; Steven James,9999,0,9999,0
1668073219345,CSE 293,038,119435,Tullsen; Dean Michael,9999,0,9999,0
1668073219345,CSE 293,039,119483,Voelker; Geoffrey M.,9999,0,9999,0
1668073219345,CSE 293,040,119537,Zhao; Jishen,9999,0,9999,0
1668073219345,CSE 293,041,119538,Zhou; Yuan-Yuan,9999,0,9999,0
1668073219345,CSE 293,042,119539,Gao; Sicun,9999,0,9999,0
1668073219345,CSE 293,043,119540,Weibel; Nadir,9999,0,9999,0
1668073219345,CSE 293,044,119541,Gupta; Rajesh K.,9999,0,9999,0
1668073219345,CSE 293,045,126410,Vaccaro; Kristen Marie,9999,0,9999,0
1668073219345,CSE 293,046,126411,Klemke; Richard,9999,0,9999,0
1668073219775,CSE 294,A00,102459,Voelker; Geoffrey M.,0,0,0,0
1668073219775,CSE 294,B00,111322,Orailoglu; Alex,0,0,0,0
1668073220200,DSE 201,A00,096914,Deutsch; Alin Bernard,30,0,30,0
1668073220625,DSE 210,A00,096915,Dasgupta; Sanjoy,30,0,30,0
1668073221054,DSE 260A,A00,096916,Altintas De Callaf; Ilkay,30,0,30,0
1668073221555,ECE 200,001,103586,Antipa; Nicholas A,9999,0,9999,0
1668073221555,ECE 200,002,103587,Atanasov; Nikolay A.,9999,0,9999,0
1668073221555,ECE 200,003,103588,Bharadia; Dinesh,9999,0,9999,0
1668073221555,ECE 200,004,103589,Cheng; Chung Kuan,9999,0,9999,0
1668073221555,ECE 200,005,103590,Cosman; Pamela C.,9999,0,9999,0
1668073221555,ECE 200,006,103591,Dayeh; Shadi Ahmad,9999,0,9999,0
1668073221555,ECE 200,007,103592,Fainman; Yeshaiahu,9999,0,9999,0
1668073221555,ECE 200,008,103593,Ford; Joseph Earl,9999,0,9999,0
1668073221555,ECE 200,009,103594,Franceschetti; Massimo,9999,0,9999,0
1668073221555,ECE 200,010,103595,Fullerton; Eric E,9999,0,9999,0
1668073221555,ECE 200,011,103596,Galton; Ian A,9999,0,9999,0
1668073221555,ECE 200,012,103597,Gilja; Vikash,9999,0,9999,0
1668073221555,ECE 200,013,103598,Hall; Drew A.,9999,0,9999,0
1668073221555,ECE 200,014,103599,Hsueh; Tzu-Chien,9999,0,9999,0
1668073221555,ECE 200,015,103600,Javidi; Tara,9999,0,9999,0
1668073221555,ECE 200,016,103601,Kahng; Andrew Byun,9999,0,9999,0
1668073221555,ECE 200,017,103602,Kim; Young-Han,9999,0,9999,0
1668073221555,ECE 200,018,103603,Koushanfar; Farinaz,9999,0,9999,0
1668073221555,ECE 200,019,103604,Kuzum; Duygu,9999,0,9999,0
1668073221555,ECE 200,020,103605,Le; Hanh-Phuc,9999,0,9999,0
1668073221555,ECE 200,021,103606,Lin; Bill,9999,0,9999,0
1668073221555,ECE 200,022,103607,Liu; Zhaowei,9998,0,9999,1
1668073221555,ECE 200,023,103608,Lo; Yu-Hwa,9999,0,9999,0
1668073221555,ECE 200,024,103609,Lomakin; Vitaliy,9999,0,9999,0
1668073221555,ECE 200,025,103610,Mercier; Patrick Philip,9999,0,9999,0
1668073221555,ECE 200,026,103611,Meyer; Florian,9999,0,9999,0
1668073221555,ECE 200,027,103612,Milstein; Laurence B.,9999,0,9999,0
1668073221555,ECE 200,028,103613,Mir Arabbaygi; Siavash,9999,0,9999,0
1668073221555,ECE 200,029,103614,Mookherjea; Shayan,9999,0,9999,0
1668073221555,ECE 200,030,103615,Morris; Karcher William,9999,0,9999,0
1668073221555,ECE 200,031,103616,Ng; Tse Nga,9999,0,9999,0
1668073221555,ECE 200,032,103617,Nguyen; Truong Quang,9999,0,9999,0
1668073221555,ECE 200,033,103618,Nomura; Kenji,9999,0,9999,0
1668073221555,ECE 200,034,103619,Orlitsky; Alon,9999,0,9999,0
1668073221555,ECE 200,035,103620,Pal; Piya,9999,0,9999,0
1668073221555,ECE 200,036,103621,Papen; George C.,9999,0,9999,0
1668073221555,ECE 200,037,103622,Radic; Stojan,9999,0,9999,0
1668073221555,ECE 200,038,103623,Rao; Bhaskar D.,9999,0,9999,0
1668073221555,ECE 200,039,103624,Rao; Ramesh R,9999,0,9999,0
1668073221555,ECE 200,040,103625,Rebeiz; Gabriel,9999,0,9999,0
1668073221555,ECE 200,041,103626,Sanford; John R,9999,0,9999,0
1668073221555,ECE 200,042,103627,Siegel; Paul H.,9999,0,9999,0
1668073221555,ECE 200,043,103628,Sievenpiper; Daniel F.,9999,0,9999,0
1668073221555,ECE 200,044,103629,Sworder; David D.,9999,0,9999,0
1668073221555,ECE 200,045,103630,Taur; Yuan,9999,0,9999,0
1668073221555,ECE 200,046,103631,Touri; Behrouz,9999,0,9999,0
1668073221555,ECE 200,047,103632,Trivedi; Mohan M.,9999,0,9999,0
1668073221555,ECE 200,048,103633,Vasconcelos; Nuno,9999,0,9999,0
1668073221555,ECE 200,049,103634,Wang; Xiaolong,9999,0,9999,0
1668073221555,ECE 200,050,103635,Xie; Pengtao,9999,0,9999,0
1668073221555,ECE 200,051,103636,Yip; Michael,9999,0,9999,0
1668073221555,ECE 200,052,103637,Zeger; Kenneth A.,999,0,999,0
1668073221555,ECE 200,053,103638,Zhang; Xinyu,9999,0,9999,0
1668073221555,ECE 200,054,103639,Turakhia; Yatish Girish,9999,0,9999,0
1668073221555,ECE 200,055,103640,Kang; Mingu,9999,0,9999,0
1668073221555,ECE 200,056,103641,Shi; Yuanyuan,9999,0,9999,0
1668073221555,ECE 200,057,103642,Wang; Edward Jay,9999,0,9999,0
1668073221555,ECE 200,058,103643,Zheng; Yang,9999,0,9999,0
1668073221984,ECE 202,A00,103644,Kuzum; Duygu,0,0,0,0
1668073222416,ECE 212BN,A00,103646,Ng; Tse Nga,0,0,0,0
1668073222843,ECE 221,A00,111493,Staff,0,0,0,0
1668073223276,ECE 222B,A00,103647,Lomakin; Vitaliy,0,0,0,0
1668073223701,ECE 230B,A00,103648,Taur; Yuan,0,0,0,0
1668073224127,ECE 238B,A00,103649,Garay; Javier,0,0,0,0
1668073224558,ECE 240B,A00,112900,Fainman; Yeshaiahu,0,0,0,0
1668073224987,ECE 247A,A00,103650,Jokerst; Jesse Vincent,0,0,0,0
1668073225417,ECE 247B,A00,103651,Wang; Joseph,0,0,0,0
1668073225849,ECE 250,A00,103652,Siegel; Paul H.,0,0,0,0
1668073226278,ECE 251A,A00,103654,Rao; Bhaskar D.,0,0,0,0
1668073226706,ECE 257B,A00,103655,Bharadia; Dinesh,0,0,0,0
1668073227130,ECE 258A,A00,103656,Milstein; Laurence B.,0,0,0,0
1668073227568,ECE 260B,A00,103658,Kang; Mingu,0,0,0,0
1668073227995,ECE 264A,A00,103659,Galton; Ian A,0,0,0,0
1668073228426,ECE 265A,A00,103661,Gudem; Prasad S.S.,0,0,0,0
1668073228865,ECE 265D,A00,103662,Gudem; Prasad S.S.,0,0,0,0
1668073229296,ECE 268,A00,103663,Koushanfar; Farinaz,0,0,0,0
1668073229732,ECE 269,A01,103665,Pal; Piya,0,0,0,0
1668073230157,ECE 271B,A00,103666,Vasconcelos; Manuela,0,0,0,0
1668073230582,ECE 276A,A00,103667,Atanasov; Nikolay A.,0,0,0,0
1668073231015,ECE 277,A00,103668,An; Cheolhong,0,0,0,0
1668073231439,ECE 279,A00,117947,Hall; Drew A.,0,0,0,0
1668073232292,ECE 283,A00,103670,Hsueh; Tzu-Chien,0,0,0,0
1668073232719,ECE 284,A00,103671,Turakhia; Yatish Girish,0,0,0,0
1668073233148,ECE 285,A00,103672,Zheng; Yang,0,0,0,0
1668073233148,ECE 285,B00,103673,Sworder; David D.,0,0,0,0
1668073233574,ECE 287,A00,103676,Javidi; Tara,0,0,0,0
1668073233999,MATH 200B,A00,098023,Salehi Golsefidy; Alireza,13,0,15,2
1668073234424,MATH 202B,A00,098024,Rhoades; Brendon Patrick,9,0,15,6
1668073234849,MATH 203B,A00,098025,Oprea; Dragos N.,10,0,15,5
1668073235366,MATH 204B,A00,098026,Sorensen; Claus M,13,0,15,2
1668073235795,MATH 208,A00,098027,Izadi; Elham,7,0,10,3
1668073236221,MATH 209,A00,098028,Pollack; Aaron,10,0,10,0
1668073236651,MATH 211A,A00,112919,Rogalski; Daniel,9,0,10,1
1668073237084,MATH 211B,A00,112920,Seward; Brandon M.,9,0,10,1
1668073237516,MATH 218,A00,098029,Li; Bo,10,0,10,0
1668073237942,MATH 220B,A00,098030,Novak; Jonathan I,12,0,15,3
1668073238375,MATH 221A,A00,098031,Ebenfelt; Peter F,13,0,15,2
1668073238805,MATH 231B,A00,098032,Zlatos; Andrej,12,0,15,3
1668073239242,MATH 240B,A00,098033,Ni; Lei,9,0,15,6
1668073239665,MATH 243,A00,098034,Jekel; David Andrew,10,0,10,0
1668073240103,MATH 245A,A00,098035,Nie; Jiawang,0,0,15,16
1668073240534,MATH 248,A00,098036,Bejenaru; Ioan,10,0,10,0
1668073240967,MATH 250B,A00,098037,Spolaor; Luca,14,0,15,1
1668073241415,MATH 258,A00,098038,Ni; Lei,10,0,10,0
1668073241854,MATH 264B,A00,098041,Rhoades; Brendon Patrick,10,0,15,5
1668073242279,MATH 268,A00,098042,Buss; Samuel R,10,0,10,0
1668073242705,MATH 269,A00,098043,Rhoades; Brendon Patrick,10,0,10,0
1668073243131,MATH 270B,A00,098044,Li; Bo,11,0,15,4
1668073243565,MATH 272B,A00,098045,Holst; Michael J,13,0,15,2
1668073243991,MATH 273A,A00,098046,Tian; Xiaochuan,10,0,15,5
1668073244426,MATH 275,A01,098048,Tian; Xiaochuan,6,0,10,4
1668073244851,MATH 278A,A00,098049,Holst; Michael J,8,0,10,2
1668073245287,MATH 278B,A00,098050,Cloninger; Alexander,10,0,10,0
1668073245753,MATH 278C,A00,098051,Nie; Jiawang,7,0,10,3
1668073246178,MATH 280B,A00,098052,Zheng; Tianyi,10,0,15,5
1668073246602,MATH 281B,A00,098053,Bradic; Jelena,3,0,15,12
1668073247031,MATH 282B,A00,098054,Arias-Castro; Ery,0,0,15,15
1668073247456,MATH 285,A00,098055,Fitzsimmons; Patrick J,0,0,15,17
1668073247881,MATH 287B,A00,098056,Arias-Castro; Ery,3,0,15,12
1668073248307,MATH 288,A00,098057,Agarwal; Pooja,9,0,10,1
1668073248307,MATH 288,B00,098058,Zhang; Danna,8,0,10,2
1668073248307,MATH 288,C00,098059,Williams; Ruth J,10,0,10,0
1668073248733,MATH 290B,A00,098060,Roberts; Justin Deritter,13,0,15,2
1668073249163,MATH 292,A00,098061,Belmont; Eva Kinoshita,10,0,10,0
1668073249592,MATH 295,A00,098062,Suk; Andrew Hoon,48,0,50,2
1668073250015,MATH 296,A00,098063,Novak; Jonathan I,20,0,20,0
1668073250439,MATH 297,001,098064,Gamst; Anthony Collins,9997,0,9999,2
1668073752862,COGS 205,A00,101395,Chiba; Andrea,19,0,20,1
1668073753292,COGS 210B,001,101404,Greene; Deanna Jacquelyn,9998,0,9999,1
1668073753292,COGS 210B,002,101417,Xia; Haijun,9999,0,9999,0
1668073753292,COGS 210B,003,101422,Nitz; Douglas A.,9999,0,9999,0
1668073753292,COGS 210B,004,101423,Hollan; James D.,9998,0,9999,1
1668073753292,COGS 210B,005,101424,Deak; Gedeon O.,9998,0,9999,1
1668073753292,COGS 210B,006,101425,Rossano; Federico,9999,0,9999,0
1668073753719,COGS 211B,A00,101427,Coulson; Seana M,9996,0,9999,3
1668073754142,COGS 220,A00,101428,Hollan; James D.,0,0,25,25
1668073754565,COGS 229,A00,101429,Dow; Steven P,18,0,25,7
1668073754991,COGS 230,A00,101430,Klemmer; Scott R,13,0,17,4
1668073755418,COGS 234,A00,101431,Xia; Haijun,3,0,25,22
1668073755844,COGS 260,A00,101432,Kiyonaga; Anastasia,19,0,25,6
1668073755844,COGS 260,B00,101433,Kirsh; David Joel,16,0,25,9
1668073756274,CSE 202,A00,102371,Impagliazzo; Russell,0,0,0,0
1668073756708,CSE 203B,A01,102373,Cheng; Chung Kuan,0,0,0,0
1668073757131,CSE 208,A00,102374,Micciancio; Daniele,0,0,0,0
1668073757560,CSE 209A,A00,112895,Impagliazzo; Russell,0,0,15,15
1668073758082,CSE 209B,A00,108005,Bellare; Mihir,0,0,0,0
1668073758508,CSE 210,A00,113163,Coblenz; Michael J,0,0,0,0
1668073758944,CSE 219,A00,106111,Dow; Steven P,0,0,20,20
1668073759378,CSE 221,A00,102376,Voelker; Geoffrey M.,0,0,0,0
1668073759808,CSE 224,A01,102378,Porter; George M,0,0,0,0
1668073760238,CSE 229A,A00,102379,Savage; Stefan,0,0,0,0
1668073760668,CSE 229C,A00,102380,Munyaka; Imani N. S.,0,0,0,0
1668073761105,CSE 232B,A00,102382,Deutsch; Alin Bernard,0,0,0,0
1668073761531,CSE 234,A01,112904,Kumar; Arun Kumar,0,0,0,0
1668073761956,CSE 237A,A00,102383,Rosing; Tajana Simunic,0,0,0,0
1668073762382,CSE 239A,A00,102384,Deutsch; Alin Bernard,0,0,0,0
1668073762805,CSE 239B,A00,102385,Polikarpova; Nadezhda,0,0,0,0
1668073763231,CSE 240A,A00,102386,Pannuto; Patrick William,0,0,0,0
1668073763658,CSE 240B,A00,102387,Zhao; Jishen,0,0,0,0
1668073764086,CSE 241A,A00,106406,Kang; Mingu,0,0,0,0
1668073764510,CSE 249B,A00,102388,Kahng; Andrew Byun,0,0,8,8
1668073764939,CSE 251B,A01,102392,Cottrell; Garrison W,0,0,0,0
1668073764939,CSE 251B,A02,102393,Cottrell; Garrison W,0,0,0,0
1668073765378,CSE 252B,A00,102394,Ochoa; Benjamin Lawrence,0,0,0,0
1668073765800,CSE 257,A01,102396,Gao; Sicun,0,0,0,0
1668073766253,CSE 272,A00,102397,Li; Tzumao,0,0,0,0
1668073766679,CSE 274,A00,111323,Chern; Albert Ren-Haur,0,0,0,0
1668073767108,CSE 282,A00,102398,Pevzner; Pavel Arkadjevich,0,0,0,0
1668073767541,CSE 284,A00,114175,Gymrek; Melissa Ann,0,0,0,0
1668073767966,CSE 290,A00,102399,Chandraker; Manmohan Krishna,0,0,0,0
1668073767966,CSE 290,B00,102400,Vaccaro; Kristen Marie,0,0,25,25
1668073767966,CSE 290,C00,102414,Pannuto; Patrick William,0,0,25,25
1668073767966,CSE 290,D00,102427,Pevzner; Pavel Arkadjevich,0,0,0,0
1668073767966,CSE 290,E00,102429,Zhao; Jishen,0,0,0,0
1668073767966,CSE 290,F00,102436,Tullsen; Dean Michael,0,0,0,0
1668073767966,CSE 290,G00,102440,Christensen; Henrik I,0,0,20,20
1668073768407,CSE 291,A00,102443,Su; Hao,0,0,0,0
1668073768407,CSE 291,B00,102448,Polikarpova; Nadezhda,0,0,0,0
1668073768407,CSE 291,C00,102453,Vaccaro; Kristen Marie,0,0,0,0
1668073768407,CSE 291,D00,111343,Savage; Stefan,0,0,0,0
1668073768407,CSE 291,E00,116474,Claffy; Kimberly Claire,0,0,0,0
1668073768407,CSE 291,F00,116479,Pasquale; Joseph,0,0,0,0
1668073768875,CSE 293,001,119111,Bafna; Vineet,9999,0,9999,0
1668073768875,CSE 293,002,119118,Bellare; Mihir,9999,0,9999,0
1668073768875,CSE 293,003,119122,Berg-Kirkpatrick; Taylor D,9999,0,9999,0
1668073768875,CSE 293,004,119135,Christensen; Henrik I,9999,0,9999,0
1668073768875,CSE 293,005,119142,Cottrell; Garrison W,9999,0,9999,0
1668073768875,CSE 293,006,119146,Deutsch; Alin Bernard,9999,0,9999,0
1668073768875,CSE 293,007,119159,Esmaeilzadeh; Hadi,9999,0,9999,0
1668073768875,CSE 293,008,119166,Freund; Yoav,9999,0,9999,0
1668073768875,CSE 293,009,119170,Griswold; William G.,9999,0,9999,0
1668073768875,CSE 293,010,119183,Gymrek; Melissa Ann,9999,0,9999,0
1668073768875,CSE 293,011,119190,Heninger; Nadia A,9999,0,9999,0
1668073768875,CSE 293,012,119230,Impagliazzo; Russell,9999,0,9999,0
1668073768875,CSE 293,013,119232,Jhala; Ranjit,9999,0,9999,0
1668073768875,CSE 293,014,119233,Kahng; Andrew Byun,9999,0,9999,0
1668073768875,CSE 293,015,119298,Kane; Daniel Mertz,9999,0,9999,0
1668073768875,CSE 293,016,119299,Kriegman; David J,9999,0,9999,0
1668073768875,CSE 293,017,119300,Kumar; Arun Kumar,9999,0,9999,0
1668073768875,CSE 293,018,119301,Lerner; Sorin,9999,0,9999,0
1668073768875,CSE 293,019,119302,Lovett; Shachar,9999,0,9999,0
1668073768875,CSE 293,020,119303,McAuley; Julian John,9999,0,9999,0
1668073768875,CSE 293,021,119304,Micciancio; Daniele,9999,0,9999,0
1668073768875,CSE 293,022,119367,Orailoglu; Alex,9999,0,9999,0
1668073768875,CSE 293,023,119382,Paturi; Ramamohan,9999,0,9999,0
1668073768875,CSE 293,024,119404,Polikarpova; Nadezhda,9999,0,9999,0
1668073768875,CSE 293,025,119406,Politz; Joseph Gibbs,9999,0,9999,0
1668073768875,CSE 293,026,119411,Porter; George M,9999,0,9999,0
1668073768875,CSE 293,027,119414,Porter; Leonard Emerson,9999,0,9999,0
1668073768875,CSE 293,028,119416,Ramamoorthi; Ravi,9999,0,9999,0
1668073768875,CSE 293,029,119417,Sahoo; Debashis,9999,0,9999,0
1668073768875,CSE 293,030,119420,Saul; Lawrence,9999,0,9999,0
1668073768875,CSE 293,031,119421,Savage; Stefan,9999,0,9999,0
1668073768875,CSE 293,032,119425,Schulze; Jurgen P.,9999,0,9999,0
1668073768875,CSE 293,033,119426,Snoeren; Alex C.,9999,0,9999,0
1668073768875,CSE 293,034,119428,Shang; Jingbo,9999,0,9999,0
1668073768875,CSE 293,035,119430,Stefan; Deian,9999,0,9999,0
1668073768875,CSE 293,036,119431,Su; Hao,9999,0,9999,0
1668073768875,CSE 293,037,119433,Swanson; Steven James,9999,0,9999,0
1668073768875,CSE 293,038,119435,Tullsen; Dean Michael,9999,0,9999,0
1668073768875,CSE 293,039,119483,Voelker; Geoffrey M.,9999,0,9999,0
1668073768875,CSE 293,040,119537,Zhao; Jishen,9999,0,9999,0
1668073768875,CSE 293,041,119538,Zhou; Yuan-Yuan,9999,0,9999,0
1668073768875,CSE 293,042,119539,Gao; Sicun,9999,0,9999,0
1668073768875,CSE 293,043,119540,Weibel; Nadir,9999,0,9999,0
1668073768875,CSE 293,044,119541,Gupta; Rajesh K.,9999,0,9999,0
1668073768875,CSE 293,045,126410,Vaccaro; Kristen Marie,9999,0,9999,0
1668073768875,CSE 293,046,126411,Klemke; Richard,9999,0,9999,0
1668073769299,CSE 294,A00,102459,Voelker; Geoffrey M.,0,0,0,0
1668073769299,CSE 294,B00,111322,Orailoglu; Alex,0,0,0,0
1668073769724,DSE 201,A00,096914,Deutsch; Alin Bernard,30,0,30,0
1668073770148,DSE 210,A00,096915,Dasgupta; Sanjoy,30,0,30,0
1668073770574,DSE 260A,A00,096916,Altintas De Callaf; Ilkay,30,0,30,0
1668073771058,ECE 200,001,103586,Antipa; Nicholas A,9999,0,9999,0
1668073771058,ECE 200,002,103587,Atanasov; Nikolay A.,9999,0,9999,0
1668073771058,ECE 200,003,103588,Bharadia; Dinesh,9999,0,9999,0
1668073771058,ECE 200,004,103589,Cheng; Chung Kuan,9999,0,9999,0
1668073771058,ECE 200,005,103590,Cosman; Pamela C.,9999,0,9999,0
1668073771058,ECE 200,006,103591,Dayeh; Shadi Ahmad,9999,0,9999,0
1668073771058,ECE 200,007,103592,Fainman; Yeshaiahu,9999,0,9999,0
1668073771058,ECE 200,008,103593,Ford; Joseph Earl,9999,0,9999,0
1668073771058,ECE 200,009,103594,Franceschetti; Massimo,9999,0,9999,0
1668073771058,ECE 200,010,103595,Fullerton; Eric E,9999,0,9999,0
1668073771058,ECE 200,011,103596,Galton; Ian A,9999,0,9999,0
1668073771058,ECE 200,012,103597,Gilja; Vikash,9999,0,9999,0
1668073771058,ECE 200,013,103598,Hall; Drew A.,9999,0,9999,0
1668073771058,ECE 200,014,103599,Hsueh; Tzu-Chien,9999,0,9999,0
1668073771058,ECE 200,015,103600,Javidi; Tara,9999,0,9999,0
1668073771058,ECE 200,016,103601,Kahng; Andrew Byun,9999,0,9999,0
1668073771058,ECE 200,017,103602,Kim; Young-Han,9999,0,9999,0
1668073771058,ECE 200,018,103603,Koushanfar; Farinaz,9999,0,9999,0
1668073771058,ECE 200,019,103604,Kuzum; Duygu,9999,0,9999,0
1668073771058,ECE 200,020,103605,Le; Hanh-Phuc,9999,0,9999,0
1668073771058,ECE 200,021,103606,Lin; Bill,9999,0,9999,0
1668073771058,ECE 200,022,103607,Liu; Zhaowei,9998,0,9999,1
1668073771058,ECE 200,023,103608,Lo; Yu-Hwa,9999,0,9999,0
1668073771058,ECE 200,024,103609,Lomakin; Vitaliy,9999,0,9999,0
1668073771058,ECE 200,025,103610,Mercier; Patrick Philip,9999,0,9999,0
1668073771058,ECE 200,026,103611,Meyer; Florian,9999,0,9999,0
1668073771058,ECE 200,027,103612,Milstein; Laurence B.,9999,0,9999,0
1668073771058,ECE 200,028,103613,Mir Arabbaygi; Siavash,9999,0,9999,0
1668073771058,ECE 200,029,103614,Mookherjea; Shayan,9999,0,9999,0
1668073771058,ECE 200,030,103615,Morris; Karcher William,9999,0,9999,0
1668073771058,ECE 200,031,103616,Ng; Tse Nga,9999,0,9999,0
1668073771058,ECE 200,032,103617,Nguyen; Truong Quang,9999,0,9999,0
1668073771058,ECE 200,033,103618,Nomura; Kenji,9999,0,9999,0
1668073771058,ECE 200,034,103619,Orlitsky; Alon,9999,0,9999,0
1668073771058,ECE 200,035,103620,Pal; Piya,9999,0,9999,0
1668073771058,ECE 200,036,103621,Papen; George C.,9999,0,9999,0
1668073771058,ECE 200,037,103622,Radic; Stojan,9999,0,9999,0
1668073771058,ECE 200,038,103623,Rao; Bhaskar D.,9999,0,9999,0
1668073771058,ECE 200,039,103624,Rao; Ramesh R,9999,0,9999,0
1668073771058,ECE 200,040,103625,Rebeiz; Gabriel,9999,0,9999,0
1668073771058,ECE 200,041,103626,Sanford; John R,9999,0,9999,0
1668073771058,ECE 200,042,103627,Siegel; Paul H.,9999,0,9999,0
1668073771058,ECE 200,043,103628,Sievenpiper; Daniel F.,9999,0,9999,0
1668073771058,ECE 200,044,103629,Sworder; David D.,9999,0,9999,0
1668073771058,ECE 200,045,103630,Taur; Yuan,9999,0,9999,0
1668073771058,ECE 200,046,103631,Touri; Behrouz,9999,0,9999,0
1668073771058,ECE 200,047,103632,Trivedi; Mohan M.,9999,0,9999,0
1668073771058,ECE 200,048,103633,Vasconcelos; Nuno,9999,0,9999,0
1668073771058,ECE 200,049,103634,Wang; Xiaolong,9999,0,9999,0
1668073771058,ECE 200,050,103635,Xie; Pengtao,9999,0,9999,0
1668073771058,ECE 200,051,103636,Yip; Michael,9999,0,9999,0
1668073771058,ECE 200,052,103637,Zeger; Kenneth A.,999,0,999,0
1668073771058,ECE 200,053,103638,Zhang; Xinyu,9999,0,9999,0
1668073771058,ECE 200,054,103639,Turakhia; Yatish Girish,9999,0,9999,0
1668073771058,ECE 200,055,103640,Kang; Mingu,9999,0,9999,0
1668073771058,ECE 200,056,103641,Shi; Yuanyuan,9999,0,9999,0
1668073771058,ECE 200,057,103642,Wang; Edward Jay,9999,0,9999,0
1668073771058,ECE 200,058,103643,Zheng; Yang,9999,0,9999,0
1668073771481,ECE 202,A00,103644,Kuzum; Duygu,0,0,0,0
1668073771905,ECE 212BN,A00,103646,Ng; Tse Nga,0,0,0,0
1668073772328,ECE 221,A00,111493,Staff,0,0,0,0
1668073772755,ECE 222B,A00,103647,Lomakin; Vitaliy,0,0,0,0
1668073773187,ECE 230B,A00,103648,Taur; Yuan,0,0,0,0
1668073773613,ECE 238B,A00,103649,Garay; Javier,0,0,0,0
1668073774043,ECE 240B,A00,112900,Fainman; Yeshaiahu,0,0,0,0
1668073774468,ECE 247A,A00,103650,Jokerst; Jesse Vincent,0,0,0,0
1668073774897,ECE 247B,A00,103651,Wang; Joseph,0,0,0,0
1668073775335,ECE 250,A00,103652,Siegel; Paul H.,0,0,0,0
1668073775763,ECE 251A,A00,103654,Rao; Bhaskar D.,0,0,0,0
1668073776192,ECE 257B,A00,103655,Bharadia; Dinesh,0,0,0,0
1668073776625,ECE 258A,A00,103656,Milstein; Laurence B.,0,0,0,0
1668073777053,ECE 260B,A00,103658,Kang; Mingu,0,0,0,0
1668073777493,ECE 264A,A00,103659,Galton; Ian A,0,0,0,0
1668073777921,ECE 265A,A00,103661,Gudem; Prasad S.S.,0,0,0,0
1668073778349,ECE 265D,A00,103662,Gudem; Prasad S.S.,0,0,0,0
1668073778775,ECE 268,A00,103663,Koushanfar; Farinaz,0,0,0,0
1668073779205,ECE 269,A01,103665,Pal; Piya,0,0,0,0
1668073779636,ECE 271B,A00,103666,Vasconcelos; Manuela,0,0,0,0
1668073780069,ECE 276A,A00,103667,Atanasov; Nikolay A.,0,0,0,0
1668073780503,ECE 277,A00,103668,An; Cheolhong,0,0,0,0
1668073780928,ECE 279,A00,117947,Hall; Drew A.,0,0,0,0
1668073781776,ECE 283,A00,103670,Hsueh; Tzu-Chien,0,0,0,0
1668073782201,ECE 284,A00,103671,Turakhia; Yatish Girish,0,0,0,0
1668073782633,ECE 285,A00,103672,Zheng; Yang,0,0,0,0
1668073782633,ECE 285,B00,103673,Sworder; David D.,0,0,0,0
1668073783058,ECE 287,A00,103676,Javidi; Tara,0,0,0,0
1668073783495,MATH 200B,A00,098023,Salehi Golsefidy; Alireza,13,0,15,2
1668073783930,MATH 202B,A00,098024,Rhoades; Brendon Patrick,9,0,15,6
1668073784354,MATH 203B,A00,098025,Oprea; Dragos N.,10,0,15,5
1668073784777,MATH 204B,A00,098026,Sorensen; Claus M,13,0,15,2
1668073785205,MATH 208,A00,098027,Izadi; Elham,7,0,10,3
1668073785630,MATH 209,A00,098028,Pollack; Aaron,10,0,10,0
1668073786055,MATH 211A,A00,112919,Rogalski; Daniel,9,0,10,1
1668073786484,MATH 211B,A00,112920,Seward; Brandon M.,9,0,10,1
1668073786919,MATH 218,A00,098029,Li; Bo,10,0,10,0
1668073787346,MATH 220B,A00,098030,Novak; Jonathan I,12,0,15,3
1668073787770,MATH 221A,A00,098031,Ebenfelt; Peter F,13,0,15,2
1668073788192,MATH 231B,A00,098032,Zlatos; Andrej,12,0,15,3
1668073788619,MATH 240B,A00,098033,Ni; Lei,9,0,15,6
1668073789043,MATH 243,A00,098034,Jekel; David Andrew,10,0,10,0
1668073789466,MATH 245A,A00,098035,Nie; Jiawang,0,0,15,16
1668073789892,MATH 248,A00,098036,Bejenaru; Ioan,10,0,10,0
1668073790320,MATH 250B,A00,098037,Spolaor; Luca,14,0,15,1
1668073790744,MATH 258,A00,098038,Ni; Lei,10,0,10,0
1668073791172,MATH 264B,A00,098041,Rhoades; Brendon Patrick,10,0,15,5
1668073791596,MATH 268,A00,098042,Buss; Samuel R,10,0,10,0
1668073792032,MATH 269,A00,098043,Rhoades; Brendon Patrick,10,0,10,0
1668073792458,MATH 270B,A00,098044,Li; Bo,11,0,15,4
1668073792885,MATH 272B,A00,098045,Holst; Michael J,13,0,15,2
1668073793308,MATH 273A,A00,098046,Tian; Xiaochuan,10,0,15,5
1668073793732,MATH 275,A01,098048,Tian; Xiaochuan,6,0,10,4
1668073794158,MATH 278A,A00,098049,Holst; Michael J,8,0,10,2
1668073794593,MATH 278B,A00,098050,Cloninger; Alexander,10,0,10,0
1668073795027,MATH 278C,A00,098051,Nie; Jiawang,7,0,10,3
1668073795453,MATH 280B,A00,098052,Zheng; Tianyi,10,0,15,5
1668073795877,MATH 281B,A00,098053,Bradic; Jelena,3,0,15,12
1668073796307,MATH 282B,A00,098054,Arias-Castro; Ery,0,0,15,15
1668073796744,MATH 285,A00,098055,Fitzsimmons; Patrick J,0,0,15,17
1668073797181,MATH 287B,A00,098056,Arias-Castro; Ery,3,0,15,12
1668073797622,MATH 288,A00,098057,Agarwal; Pooja,9,0,10,1
1668073797622,MATH 288,B00,098058,Zhang; Danna,8,0,10,2
1668073797622,MATH 288,C00,098059,Williams; Ruth J,10,0,10,0
1668073798046,MATH 290B,A00,098060,Roberts; Justin Deritter,13,0,15,2
1668073798471,MATH 292,A00,098061,Belmont; Eva Kinoshita,10,0,10,0
1668073798894,MATH 295,A00,098062,Suk; Andrew Hoon,48,0,50,2
1668073799318,MATH 296,A00,098063,Novak; Jonathan I,20,0,20,0
1668073799741,MATH 297,001,098064,Gamst; Anthony Collins,9997,0,9999,2
1668074301697,COGS 205,A00,101395,Chiba; Andrea,19,0,20,1
1668074302124,COGS 210B,001,101404,Greene; Deanna Jacquelyn,9998,0,9999,1
1668074302124,COGS 210B,002,101417,Xia; Haijun,9999,0,9999,0
1668074302124,COGS 210B,003,101422,Nitz; Douglas A.,9999,0,9999,0
1668074302124,COGS 210B,004,101423,Hollan; James D.,9998,0,9999,1
1668074302124,COGS 210B,005,101424,Deak; Gedeon O.,9998,0,9999,1
1668074302124,COGS 210B,006,101425,Rossano; Federico,9999,0,9999,0
1668074302552,COGS 211B,A00,101427,Coulson; Seana M,9996,0,9999,3
1668074302976,COGS 220,A00,101428,Hollan; James D.,0,0,25,25
1668074303402,COGS 229,A00,101429,Dow; Steven P,18,0,25,7
1668074303826,COGS 230,A00,101430,Klemmer; Scott R,13,0,17,4
1668074304249,COGS 234,A00,101431,Xia; Haijun,3,0,25,22
1668074304678,COGS 260,A00,101432,Kiyonaga; Anastasia,19,0,25,6
1668074304678,COGS 260,B00,101433,Kirsh; David Joel,16,0,25,9
1668074305104,CSE 202,A00,102371,Impagliazzo; Russell,0,0,0,0
1668074305531,CSE 203B,A01,102373,Cheng; Chung Kuan,0,0,0,0
1668074305956,CSE 208,A00,102374,Micciancio; Daniele,0,0,0,0
1668074306381,CSE 209A,A00,112895,Impagliazzo; Russell,0,0,15,15
1668074306806,CSE 209B,A00,108005,Bellare; Mihir,0,0,0,0
1668074307234,CSE 210,A00,113163,Coblenz; Michael J,0,0,0,0
1668074307657,CSE 219,A00,106111,Dow; Steven P,0,0,20,20
1668074308085,CSE 221,A00,102376,Voelker; Geoffrey M.,0,0,0,0
1668074308509,CSE 224,A01,102378,Porter; George M,0,0,0,0
1668074308937,CSE 229A,A00,102379,Savage; Stefan,0,0,0,0
1668074309361,CSE 229C,A00,102380,Munyaka; Imani N. S.,0,0,0,0
1668074309786,CSE 232B,A00,102382,Deutsch; Alin Bernard,0,0,0,0
1668074310214,CSE 234,A01,112904,Kumar; Arun Kumar,0,0,0,0
1668074310647,CSE 237A,A00,102383,Rosing; Tajana Simunic,0,0,0,0
1668074311080,CSE 239A,A00,102384,Deutsch; Alin Bernard,0,0,0,0
1668074311503,CSE 239B,A00,102385,Polikarpova; Nadezhda,0,0,0,0
1668074311942,CSE 240A,A00,102386,Pannuto; Patrick William,0,0,0,0
1668074312376,CSE 240B,A00,102387,Zhao; Jishen,0,0,0,0
1668074312806,CSE 241A,A00,106406,Kang; Mingu,0,0,0,0
1668074313236,CSE 249B,A00,102388,Kahng; Andrew Byun,0,0,8,8
1668074313660,CSE 251B,A01,102392,Cottrell; Garrison W,0,0,0,0
1668074313660,CSE 251B,A02,102393,Cottrell; Garrison W,0,0,0,0
1668074314084,CSE 252B,A00,102394,Ochoa; Benjamin Lawrence,0,0,0,0
1668074314521,CSE 257,A01,102396,Gao; Sicun,0,0,0,0
1668074314955,CSE 272,A00,102397,Li; Tzumao,0,0,0,0
1668074315379,CSE 274,A00,111323,Chern; Albert Ren-Haur,0,0,0,0
1668074315802,CSE 282,A00,102398,Pevzner; Pavel Arkadjevich,0,0,0,0
1668074316227,CSE 284,A00,114175,Gymrek; Melissa Ann,0,0,0,0
1668074316655,CSE 290,A00,102399,Chandraker; Manmohan Krishna,0,0,0,0
1668074316655,CSE 290,B00,102400,Vaccaro; Kristen Marie,0,0,25,25
1668074316655,CSE 290,C00,102414,Pannuto; Patrick William,0,0,25,25
1668074316655,CSE 290,D00,102427,Pevzner; Pavel Arkadjevich,0,0,0,0
1668074316655,CSE 290,E00,102429,Zhao; Jishen,0,0,0,0
1668074316655,CSE 290,F00,102436,Tullsen; Dean Michael,0,0,0,0
1668074316655,CSE 290,G00,102440,Christensen; Henrik I,0,0,20,20
1668074317079,CSE 291,A00,102443,Su; Hao,0,0,0,0
1668074317079,CSE 291,B00,102448,Polikarpova; Nadezhda,0,0,0,0
1668074317079,CSE 291,C00,102453,Vaccaro; Kristen Marie,0,0,0,0
1668074317079,CSE 291,D00,111343,Savage; Stefan,0,0,0,0
1668074317079,CSE 291,E00,116474,Claffy; Kimberly Claire,0,0,0,0
1668074317079,CSE 291,F00,116479,Pasquale; Joseph,0,0,0,0
1668074317514,CSE 293,001,119111,Bafna; Vineet,9999,0,9999,0
1668074317514,CSE 293,002,119118,Bellare; Mihir,9999,0,9999,0
1668074317514,CSE 293,003,119122,Berg-Kirkpatrick; Taylor D,9999,0,9999,0
1668074317514,CSE 293,004,119135,Christensen; Henrik I,9999,0,9999,0
1668074317514,CSE 293,005,119142,Cottrell; Garrison W,9999,0,9999,0
1668074317514,CSE 293,006,119146,Deutsch; Alin Bernard,9999,0,9999,0
1668074317514,CSE 293,007,119159,Esmaeilzadeh; Hadi,9999,0,9999,0
1668074317514,CSE 293,008,119166,Freund; Yoav,9999,0,9999,0
1668074317514,CSE 293,009,119170,Griswold; William G.,9999,0,9999,0
1668074317514,CSE 293,010,119183,Gymrek; Melissa Ann,9999,0,9999,0
1668074317514,CSE 293,011,119190,Heninger; Nadia A,9999,0,9999,0
1668074317514,CSE 293,012,119230,Impagliazzo; Russell,9999,0,9999,0
1668074317514,CSE 293,013,119232,Jhala; Ranjit,9999,0,9999,0
1668074317514,CSE 293,014,119233,Kahng; Andrew Byun,9999,0,9999,0
1668074317514,CSE 293,015,119298,Kane; Daniel Mertz,9999,0,9999,0
1668074317514,CSE 293,016,119299,Kriegman; David J,9999,0,9999,0
1668074317514,CSE 293,017,119300,Kumar; Arun Kumar,9999,0,9999,0
1668074317514,CSE 293,018,119301,Lerner; Sorin,9999,0,9999,0
1668074317514,CSE 293,019,119302,Lovett; Shachar,9999,0,9999,0
1668074317514,CSE 293,020,119303,McAuley; Julian John,9999,0,9999,0
1668074317514,CSE 293,021,119304,Micciancio; Daniele,9999,0,9999,0
1668074317514,CSE 293,022,119367,Orailoglu; Alex,9999,0,9999,0
1668074317514,CSE 293,023,119382,Paturi; Ramamohan,9999,0,9999,0
1668074317514,CSE 293,024,119404,Polikarpova; Nadezhda,9999,0,9999,0
1668074317514,CSE 293,025,119406,Politz; Joseph Gibbs,9999,0,9999,0
1668074317514,CSE 293,026,119411,Porter; George M,9999,0,9999,0
1668074317514,CSE 293,027,119414,Porter; Leonard Emerson,9999,0,9999,0
1668074317514,CSE 293,028,119416,Ramamoorthi; Ravi,9999,0,9999,0
1668074317514,CSE 293,029,119417,Sahoo; Debashis,9999,0,9999,0
1668074317514,CSE 293,030,119420,Saul; Lawrence,9999,0,9999,0
1668074317514,CSE 293,031,119421,Savage; Stefan,9999,0,9999,0
1668074317514,CSE 293,032,119425,Schulze; Jurgen P.,9999,0,9999,0
1668074317514,CSE 293,033,119426,Snoeren; Alex C.,9999,0,9999,0
1668074317514,CSE 293,034,119428,Shang; Jingbo,9999,0,9999,0
1668074317514,CSE 293,035,119430,Stefan; Deian,9999,0,9999,0
1668074317514,CSE 293,036,119431,Su; Hao,9999,0,9999,0
1668074317514,CSE 293,037,119433,Swanson; Steven James,9999,0,9999,0
1668074317514,CSE 293,038,119435,Tullsen; Dean Michael,9999,0,9999,0
1668074317514,CSE 293,039,119483,Voelker; Geoffrey M.,9999,0,9999,0
1668074317514,CSE 293,040,119537,Zhao; Jishen,9999,0,9999,0
1668074317514,CSE 293,041,119538,Zhou; Yuan-Yuan,9999,0,9999,0
1668074317514,CSE 293,042,119539,Gao; Sicun,9999,0,9999,0
1668074317514,CSE 293,043,119540,Weibel; Nadir,9999,0,9999,0
1668074317514,CSE 293,044,119541,Gupta; Rajesh K.,9999,0,9999,0
1668074317514,CSE 293,045,126410,Vaccaro; Kristen Marie,9999,0,9999,0
1668074317514,CSE 293,046,126411,Klemke; Richard,9999,0,9999,0
1668074317939,CSE 294,A00,102459,Voelker; Geoffrey M.,0,0,0,0
1668074317939,CSE 294,B00,111322,Orailoglu; Alex,0,0,0,0
1668074318366,DSE 201,A00,096914,Deutsch; Alin Bernard,30,0,30,0
1668074318800,DSE 210,A00,096915,Dasgupta; Sanjoy,30,0,30,0
1668074319232,DSE 260A,A00,096916,Altintas De Callaf; Ilkay,30,0,30,0
1668074319681,ECE 200,001,103586,Antipa; Nicholas A,9999,0,9999,0
1668074319681,ECE 200,002,103587,Atanasov; Nikolay A.,9999,0,9999,0
1668074319681,ECE 200,003,103588,Bharadia; Dinesh,9999,0,9999,0
1668074319681,ECE 200,004,103589,Cheng; Chung Kuan,9999,0,9999,0
1668074319681,ECE 200,005,103590,Cosman; Pamela C.,9999,0,9999,0
1668074319681,ECE 200,006,103591,Dayeh; Shadi Ahmad,9999,0,9999,0
1668074319681,ECE 200,007,103592,Fainman; Yeshaiahu,9999,0,9999,0
1668074319681,ECE 200,008,103593,Ford; Joseph Earl,9999,0,9999,0
1668074319681,ECE 200,009,103594,Franceschetti; Massimo,9999,0,9999,0
1668074319681,ECE 200,010,103595,Fullerton; Eric E,9999,0,9999,0
1668074319681,ECE 200,011,103596,Galton; Ian A,9999,0,9999,0
1668074319681,ECE 200,012,103597,Gilja; Vikash,9999,0,9999,0
1668074319681,ECE 200,013,103598,Hall; Drew A.,9999,0,9999,0
1668074319681,ECE 200,014,103599,Hsueh; Tzu-Chien,9999,0,9999,0
1668074319681,ECE 200,015,103600,Javidi; Tara,9999,0,9999,0
1668074319681,ECE 200,016,103601,Kahng; Andrew Byun,9999,0,9999,0
1668074319681,ECE 200,017,103602,Kim; Young-Han,9999,0,9999,0
1668074319681,ECE 200,018,103603,Koushanfar; Farinaz,9999,0,9999,0
1668074319681,ECE 200,019,103604,Kuzum; Duygu,9999,0,9999,0
1668074319681,ECE 200,020,103605,Le; Hanh-Phuc,9999,0,9999,0
1668074319681,ECE 200,021,103606,Lin; Bill,9999,0,9999,0
1668074319681,ECE 200,022,103607,Liu; Zhaowei,9998,0,9999,1
1668074319681,ECE 200,023,103608,Lo; Yu-Hwa,9999,0,9999,0
1668074319681,ECE 200,024,103609,Lomakin; Vitaliy,9999,0,9999,0
1668074319681,ECE 200,025,103610,Mercier; Patrick Philip,9999,0,9999,0
1668074319681,ECE 200,026,103611,Meyer; Florian,9999,0,9999,0
1668074319681,ECE 200,027,103612,Milstein; Laurence B.,9999,0,9999,0
1668074319681,ECE 200,028,103613,Mir Arabbaygi; Siavash,9999,0,9999,0
1668074319681,ECE 200,029,103614,Mookherjea; Shayan,9999,0,9999,0
1668074319681,ECE 200,030,103615,Morris; Karcher William,9999,0,9999,0
1668074319681,ECE 200,031,103616,Ng; Tse Nga,9999,0,9999,0
1668074319681,ECE 200,032,103617,Nguyen; Truong Quang,9999,0,9999,0
1668074319681,ECE 200,033,103618,Nomura; Kenji,9999,0,9999,0
1668074319681,ECE 200,034,103619,Orlitsky; Alon,9999,0,9999,0
1668074319681,ECE 200,035,103620,Pal; Piya,9999,0,9999,0
1668074319681,ECE 200,036,103621,Papen; George C.,9999,0,9999,0
1668074319681,ECE 200,037,103622,Radic; Stojan,9999,0,9999,0
1668074319681,ECE 200,038,103623,Rao; Bhaskar D.,9999,0,9999,0
1668074319681,ECE 200,039,103624,Rao; Ramesh R,9999,0,9999,0
1668074319681,ECE 200,040,103625,Rebeiz; Gabriel,9999,0,9999,0
1668074319681,ECE 200,041,103626,Sanford; John R,9999,0,9999,0
1668074319681,ECE 200,042,103627,Siegel; Paul H.,9999,0,9999,0
1668074319681,ECE 200,043,103628,Sievenpiper; Daniel F.,9999,0,9999,0
1668074319681,ECE 200,044,103629,Sworder; David D.,9999,0,9999,0
1668074319681,ECE 200,045,103630,Taur; Yuan,9999,0,9999,0
1668074319681,ECE 200,046,103631,Touri; Behrouz,9999,0,9999,0
1668074319681,ECE 200,047,103632,Trivedi; Mohan M.,9999,0,9999,0
1668074319681,ECE 200,048,103633,Vasconcelos; Nuno,9999,0,9999,0
1668074319681,ECE 200,049,103634,Wang; Xiaolong,9999,0,9999,0
1668074319681,ECE 200,050,103635,Xie; Pengtao,9999,0,9999,0
1668074319681,ECE 200,051,103636,Yip; Michael,9999,0,9999,0
1668074319681,ECE 200,052,103637,Zeger; Kenneth A.,999,0,999,0
1668074319681,ECE 200,053,103638,Zhang; Xinyu,9999,0,9999,0
1668074319681,ECE 200,054,103639,Turakhia; Yatish Girish,9999,0,9999,0
1668074319681,ECE 200,055,103640,Kang; Mingu,9999,0,9999,0
1668074319681,ECE 200,056,103641,Shi; Yuanyuan,9999,0,9999,0
1668074319681,ECE 200,057,103642,Wang; Edward Jay,9999,0,9999,0
1668074319681,ECE 200,058,103643,Zheng; Yang,9999,0,9999,0
1668074320109,ECE 202,A00,103644,Kuzum; Duygu,0,0,0,0
1668074320542,ECE 212BN,A00,103646,Ng; Tse Nga,0,0,0,0
1668074320974,ECE 221,A00,111493,Staff,0,0,0,0
1668074321409,ECE 222B,A00,103647,Lomakin; Vitaliy,0,0,0,0
1668074321852,ECE 230B,A00,103648,Taur; Yuan,0,0,0,0
1668074322280,ECE 238B,A00,103649,Garay; Javier,0,0,0,0
1668074322715,ECE 240B,A00,112900,Fainman; Yeshaiahu,0,0,0,0
1668074323153,ECE 247A,A00,103650,Jokerst; Jesse Vincent,0,0,0,0
1668074323657,ECE 247B,A00,103651,Wang; Joseph,0,0,0,0
1668074324081,ECE 250,A00,103652,Siegel; Paul H.,0,0,0,0
1668074324506,ECE 251A,A00,103654,Rao; Bhaskar D.,0,0,0,0
1668074324931,ECE 257B,A00,103655,Bharadia; Dinesh,0,0,0,0
1668074325355,ECE 258A,A00,103656,Milstein; Laurence B.,0,0,0,0
1668074325782,ECE 260B,A00,103658,Kang; Mingu,0,0,0,0
1668074326206,ECE 264A,A00,103659,Galton; Ian A,0,0,0,0
1668074326629,ECE 265A,A00,103661,Gudem; Prasad S.S.,0,0,0,0
1668074327054,ECE 265D,A00,103662,Gudem; Prasad S.S.,0,0,0,0
1668074327477,ECE 268,A00,103663,Koushanfar; Farinaz,0,0,0,0
1668074327902,ECE 269,A01,103665,Pal; Piya,0,0,0,0
1668074328326,ECE 271B,A00,103666,Vasconcelos; Manuela,0,0,0,0
1668074328761,ECE 276A,A00,103667,Atanasov; Nikolay A.,0,0,0,0
1668074329192,ECE 277,A00,103668,An; Cheolhong,0,0,0,0
1668074329630,ECE 279,A00,117947,Hall; Drew A.,0,0,0,0
1668074330512,ECE 283,A00,103670,Hsueh; Tzu-Chien,0,0,0,0
1668074330937,ECE 284,A00,103671,Turakhia; Yatish Girish,0,0,0,0
1668074331367,ECE 285,A00,103672,Zheng; Yang,0,0,0,0
1668074331367,ECE 285,B00,103673,Sworder; David D.,0,0,0,0
1668074331794,ECE 287,A00,103676,Javidi; Tara,0,0,0,0
1668074332220,MATH 200B,A00,098023,Salehi Golsefidy; Alireza,13,0,15,2
1668074332649,MATH 202B,A00,098024,Rhoades; Brendon Patrick,9,0,15,6
1668074333073,MATH 203B,A00,098025,Oprea; Dragos N.,10,0,15,5
1668074333502,MATH 204B,A00,098026,Sorensen; Claus M,13,0,15,2
1668074333928,MATH 208,A00,098027,Izadi; Elham,7,0,10,3
1668074334357,MATH 209,A00,098028,Pollack; Aaron,10,0,10,0
1668074334782,MATH 211A,A00,112919,Rogalski; Daniel,9,0,10,1
1668074335205,MATH 211B,A00,112920,Seward; Brandon M.,9,0,10,1
1668074335633,MATH 218,A00,098029,Li; Bo,10,0,10,0
1668074336059,MATH 220B,A00,098030,Novak; Jonathan I,12,0,15,3
1668074336482,MATH 221A,A00,098031,Ebenfelt; Peter F,13,0,15,2
1668074336909,MATH 231B,A00,098032,Zlatos; Andrej,12,0,15,3
1668074337334,MATH 240B,A00,098033,Ni; Lei,9,0,15,6
1668074337761,MATH 243,A00,098034,Jekel; David Andrew,10,0,10,0
1668074338184,MATH 245A,A00,098035,Nie; Jiawang,0,0,15,16
1668074338612,MATH 248,A00,098036,Bejenaru; Ioan,10,0,10,0
1668074339039,MATH 250B,A00,098037,Spolaor; Luca,14,0,15,1
1668074339467,MATH 258,A00,098038,Ni; Lei,10,0,10,0
1668074339893,MATH 264B,A00,098041,Rhoades; Brendon Patrick,10,0,15,5
1668074340336,MATH 268,A00,098042,Buss; Samuel R,10,0,10,0
1668074340760,MATH 269,A00,098043,Rhoades; Brendon Patrick,10,0,10,0
1668074341184,MATH 270B,A00,098044,Li; Bo,11,0,15,4
1668074341613,MATH 272B,A00,098045,Holst; Michael J,13,0,15,2
1668074342038,MATH 273A,A00,098046,Tian; Xiaochuan,10,0,15,5
1668074342461,MATH 275,A01,098048,Tian; Xiaochuan,6,0,10,4
1668074342888,MATH 278A,A00,098049,Holst; Michael J,8,0,10,2
1668074343313,MATH 278B,A00,098050,Cloninger; Alexander,10,0,10,0
1668074343742,MATH 278C,A00,098051,Nie; Jiawang,7,0,10,3
1668074344171,MATH 280B,A00,098052,Zheng; Tianyi,10,0,15,5
1668074344595,MATH 281B,A00,098053,Bradic; Jelena,3,0,15,12
1668074345020,MATH 282B,A00,098054,Arias-Castro; Ery,0,0,15,15
1668074345444,MATH 285,A00,098055,Fitzsimmons; Patrick J,0,0,15,17
1668074345876,MATH 287B,A00,098056,Arias-Castro; Ery,3,0,15,12
1668074346304,MATH 288,A00,098057,Agarwal; Pooja,9,0,10,1
1668074346304,MATH 288,B00,098058,Zhang; Danna,8,0,10,2
1668074346304,MATH 288,C00,098059,Williams; Ruth J,10,0,10,0
1668074346731,MATH 290B,A00,098060,Roberts; Justin Deritter,13,0,15,2
1668074347154,MATH 292,A00,098061,Belmont; Eva Kinoshita,10,0,10,0
1668074347577,MATH 295,A00,098062,Suk; Andrew Hoon,48,0,50,2
1668074348001,MATH 296,A00,098063,Novak; Jonathan I,20,0,20,0
1668074348423,MATH 297,001,098064,Gamst; Anthony Collins,9997,0,9999,2
1668074850388,COGS 205,A00,101395,Chiba; Andrea,19,0,20,1
1668074850825,COGS 210B,001,101404,Greene; Deanna Jacquelyn,9998,0,9999,1
1668074850825,COGS 210B,002,101417,Xia; Haijun,9999,0,9999,0
1668074850825,COGS 210B,003,101422,Nitz; Douglas A.,9999,0,9999,0
1668074850825,COGS 210B,004,101423,Hollan; James D.,9998,0,9999,1
1668074850825,COGS 210B,005,101424,Deak; Gedeon O.,9998,0,9999,1
1668074850825,COGS 210B,006,101425,Rossano; Federico,9999,0,9999,0
1668074851249,COGS 211B,A00,101427,Coulson; Seana M,9996,0,9999,3
1668074851676,COGS 220,A00,101428,Hollan; James D.,0,0,25,25
1668074852106,COGS 229,A00,101429,Dow; Steven P,18,0,25,7
1668074852528,COGS 230,A00,101430,Klemmer; Scott R,13,0,17,4
1668074852953,COGS 234,A00,101431,Xia; Haijun,3,0,25,22
1668074853388,COGS 260,A00,101432,Kiyonaga; Anastasia,19,0,25,6
1668074853388,COGS 260,B00,101433,Kirsh; David Joel,16,0,25,9
1668074853828,CSE 202,A00,102371,Impagliazzo; Russell,0,0,0,0
1668074854254,CSE 203B,A01,102373,Cheng; Chung Kuan,0,0,0,0
1668074854678,CSE 208,A00,102374,Micciancio; Daniele,0,0,0,0
1668074855103,CSE 209A,A00,112895,Impagliazzo; Russell,0,0,15,15
1668074855527,CSE 209B,A00,108005,Bellare; Mihir,0,0,0,0
1668074855954,CSE 210,A00,113163,Coblenz; Michael J,0,0,0,0
1668074856383,CSE 219,A00,106111,Dow; Steven P,0,0,20,20
1668074856810,CSE 221,A00,102376,Voelker; Geoffrey M.,0,0,0,0
1668074857240,CSE 224,A01,102378,Porter; George M,0,0,0,0
1668074857667,CSE 229A,A00,102379,Savage; Stefan,0,0,0,0
1668074858096,CSE 229C,A00,102380,Munyaka; Imani N. S.,0,0,0,0
1668074858520,CSE 232B,A00,102382,Deutsch; Alin Bernard,0,0,0,0
1668074858945,CSE 234,A01,112904,Kumar; Arun Kumar,0,0,0,0
1668074859372,CSE 237A,A00,102383,Rosing; Tajana Simunic,0,0,0,0
1668074859797,CSE 239A,A00,102384,Deutsch; Alin Bernard,0,0,0,0
1668074860221,CSE 239B,A00,102385,Polikarpova; Nadezhda,0,0,0,0
1668074860646,CSE 240A,A00,102386,Pannuto; Patrick William,0,0,0,0
1668074861073,CSE 240B,A00,102387,Zhao; Jishen,0,0,0,0
1668074861495,CSE 241A,A00,106406,Kang; Mingu,0,0,0,0
1668074861931,CSE 249B,A00,102388,Kahng; Andrew Byun,0,0,8,8
1668074862358,CSE 251B,A01,102392,Cottrell; Garrison W,0,0,0,0
1668074862358,CSE 251B,A02,102393,Cottrell; Garrison W,0,0,0,0
1668074862786,CSE 252B,A00,102394,Ochoa; Benjamin Lawrence,0,0,0,0
1668074863210,CSE 257,A01,102396,Gao; Sicun,0,0,0,0
1668074863637,CSE 272,A00,102397,Li; Tzumao,0,0,0,0
1668074864064,CSE 274,A00,111323,Chern; Albert Ren-Haur,0,0,0,0
1668074864489,CSE 282,A00,102398,Pevzner; Pavel Arkadjevich,0,0,0,0
1668074864921,CSE 284,A00,114175,Gymrek; Melissa Ann,0,0,0,0
1668074865347,CSE 290,A00,102399,Chandraker; Manmohan Krishna,0,0,0,0
1668074865347,CSE 290,B00,102400,Vaccaro; Kristen Marie,0,0,25,25
1668074865347,CSE 290,C00,102414,Pannuto; Patrick William,0,0,25,25
1668074865347,CSE 290,D00,102427,Pevzner; Pavel Arkadjevich,0,0,0,0
1668074865347,CSE 290,E00,102429,Zhao; Jishen,0,0,0,0
1668074865347,CSE 290,F00,102436,Tullsen; Dean Michael,0,0,0,0
1668074865347,CSE 290,G00,102440,Christensen; Henrik I,0,0,20,20
1668074865785,CSE 291,A00,102443,Su; Hao,0,0,0,0
1668074865785,CSE 291,B00,102448,Polikarpova; Nadezhda,0,0,0,0
1668074865785,CSE 291,C00,102453,Vaccaro; Kristen Marie,0,0,0,0
1668074865785,CSE 291,D00,111343,Savage; Stefan,0,0,0,0
1668074865785,CSE 291,E00,116474,Claffy; Kimberly Claire,0,0,0,0
1668074865785,CSE 291,F00,116479,Pasquale; Joseph,0,0,0,0
1668074866249,CSE 293,001,119111,Bafna; Vineet,9999,0,9999,0
1668074866249,CSE 293,002,119118,Bellare; Mihir,9999,0,9999,0
1668074866249,CSE 293,003,119122,Berg-Kirkpatrick; Taylor D,9999,0,9999,0
1668074866249,CSE 293,004,119135,Christensen; Henrik I,9999,0,9999,0
1668074866249,CSE 293,005,119142,Cottrell; Garrison W,9999,0,9999,0
1668074866249,CSE 293,006,119146,Deutsch; Alin Bernard,9999,0,9999,0
1668074866249,CSE 293,007,119159,Esmaeilzadeh; Hadi,9999,0,9999,0
1668074866249,CSE 293,008,119166,Freund; Yoav,9999,0,9999,0
1668074866249,CSE 293,009,119170,Griswold; William G.,9999,0,9999,0
1668074866249,CSE 293,010,119183,Gymrek; Melissa Ann,9999,0,9999,0
1668074866249,CSE 293,011,119190,Heninger; Nadia A,9999,0,9999,0
1668074866249,CSE 293,012,119230,Impagliazzo; Russell,9999,0,9999,0
1668074866249,CSE 293,013,119232,Jhala; Ranjit,9999,0,9999,0
1668074866249,CSE 293,014,119233,Kahng; Andrew Byun,9999,0,9999,0
1668074866249,CSE 293,015,119298,Kane; Daniel Mertz,9999,0,9999,0
1668074866249,CSE 293,016,119299,Kriegman; David J,9999,0,9999,0
1668074866249,CSE 293,017,119300,Kumar; Arun Kumar,9999,0,9999,0
1668074866249,CSE 293,018,119301,Lerner; Sorin,9999,0,9999,0
1668074866249,CSE 293,019,119302,Lovett; Shachar,9999,0,9999,0
1668074866249,CSE 293,020,119303,McAuley; Julian John,9999,0,9999,0
1668074866249,CSE 293,021,119304,Micciancio; Daniele,9999,0,9999,0
1668074866249,CSE 293,022,119367,Orailoglu; Alex,9999,0,9999,0
1668074866249,CSE 293,023,119382,Paturi; Ramamohan,9999,0,9999,0
1668074866249,CSE 293,024,119404,Polikarpova; Nadezhda,9999,0,9999,0
1668074866249,CSE 293,025,119406,Politz; Joseph Gibbs,9999,0,9999,0
1668074866249,CSE 293,026,119411,Porter; George M,9999,0,9999,0
1668074866249,CSE 293,027,119414,Porter; Leonard Emerson,9999,0,9999,0
1668074866249,CSE 293,028,119416,Ramamoorthi; Ravi,9999,0,9999,0
1668074866249,CSE 293,029,119417,Sahoo; Debashis,9999,0,9999,0
1668074866249,CSE 293,030,119420,Saul; Lawrence,9999,0,9999,0
1668074866249,CSE 293,031,119421,Savage; Stefan,9999,0,9999,0
1668074866249,CSE 293,032,119425,Schulze; Jurgen P.,9999,0,9999,0
1668074866249,CSE 293,033,119426,Snoeren; Alex C.,9999,0,9999,0
1668074866249,CSE 293,034,119428,Shang; Jingbo,9999,0,9999,0
1668074866249,CSE 293,035,119430,Stefan; Deian,9999,0,9999,0
1668074866249,CSE 293,036,119431,Su; Hao,9999,0,9999,0
1668074866249,CSE 293,037,119433,Swanson; Steven James,9999,0,9999,0
1668074866249,CSE 293,038,119435,Tullsen; Dean Michael,9999,0,9999,0
1668074866249,CSE 293,039,119483,Voelker; Geoffrey M.,9999,0,9999,0
1668074866249,CSE 293,040,119537,Zhao; Jishen,9999,0,9999,0
1668074866249,CSE 293,041,119538,Zhou; Yuan-Yuan,9999,0,9999,0
1668074866249,CSE 293,042,119539,Gao; Sicun,9999,0,9999,0
1668074866249,CSE 293,043,119540,Weibel; Nadir,9999,0,9999,0
1668074866249,CSE 293,044,119541,Gupta; Rajesh K.,9999,0,9999,0
1668074866249,CSE 293,045,126410,Vaccaro; Kristen Marie,9999,0,9999,0
1668074866249,CSE 293,046,126411,Klemke; Richard,9999,0,9999,0
1668074866679,CSE 294,A00,102459,Voelker; Geoffrey M.,0,0,0,0
1668074866679,CSE 294,B00,111322,Orailoglu; Alex,0,0,0,0
1668074867104,DSE 201,A00,096914,Deutsch; Alin Bernard,30,0,30,0
1668074867541,DSE 210,A00,096915,Dasgupta; Sanjoy,30,0,30,0
1668074867979,DSE 260A,A00,096916,Altintas De Callaf; Ilkay,30,0,30,0
1668074868467,ECE 200,001,103586,Antipa; Nicholas A,9999,0,9999,0
1668074868467,ECE 200,002,103587,Atanasov; Nikolay A.,9999,0,9999,0
1668074868467,ECE 200,003,103588,Bharadia; Dinesh,9999,0,9999,0
1668074868467,ECE 200,004,103589,Cheng; Chung Kuan,9999,0,9999,0
1668074868467,ECE 200,005,103590,Cosman; Pamela C.,9999,0,9999,0
1668074868467,ECE 200,006,103591,Dayeh; Shadi Ahmad,9999,0,9999,0
1668074868467,ECE 200,007,103592,Fainman; Yeshaiahu,9999,0,9999,0
1668074868467,ECE 200,008,103593,Ford; Joseph Earl,9999,0,9999,0
1668074868467,ECE 200,009,103594,Franceschetti; Massimo,9999,0,9999,0
1668074868467,ECE 200,010,103595,Fullerton; Eric E,9999,0,9999,0
1668074868467,ECE 200,011,103596,Galton; Ian A,9999,0,9999,0
1668074868467,ECE 200,012,103597,Gilja; Vikash,9999,0,9999,0
1668074868467,ECE 200,013,103598,Hall; Drew A.,9999,0,9999,0
1668074868467,ECE 200,014,103599,Hsueh; Tzu-Chien,9999,0,9999,0
1668074868467,ECE 200,015,103600,Javidi; Tara,9999,0,9999,0
1668074868467,ECE 200,016,103601,Kahng; Andrew Byun,9999,0,9999,0
1668074868467,ECE 200,017,103602,Kim; Young-Han,9999,0,9999,0
1668074868467,ECE 200,018,103603,Koushanfar; Farinaz,9999,0,9999,0
1668074868467,ECE 200,019,103604,Kuzum; Duygu,9999,0,9999,0
1668074868467,ECE 200,020,103605,Le; Hanh-Phuc,9999,0,9999,0
1668074868467,ECE 200,021,103606,Lin; Bill,9999,0,9999,0
1668074868467,ECE 200,022,103607,Liu; Zhaowei,9998,0,9999,1
1668074868467,ECE 200,023,103608,Lo; Yu-Hwa,9999,0,9999,0
1668074868467,ECE 200,024,103609,Lomakin; Vitaliy,9999,0,9999,0
1668074868467,ECE 200,025,103610,Mercier; Patrick Philip,9999,0,9999,0
1668074868467,ECE 200,026,103611,Meyer; Florian,9999,0,9999,0
1668074868467,ECE 200,027,103612,Milstein; Laurence B.,9999,0,9999,0
1668074868467,ECE 200,028,103613,Mir Arabbaygi; Siavash,9999,0,9999,0
1668074868467,ECE 200,029,103614,Mookherjea; Shayan,9999,0,9999,0
1668074868467,ECE 200,030,103615,Morris; Karcher William,9999,0,9999,0
1668074868467,ECE 200,031,103616,Ng; Tse Nga,9999,0,9999,0
1668074868467,ECE 200,032,103617,Nguyen; Truong Quang,9999,0,9999,0
1668074868467,ECE 200,033,103618,Nomura; Kenji,9999,0,9999,0
1668074868467,ECE 200,034,103619,Orlitsky; Alon,9999,0,9999,0
1668074868467,ECE 200,035,103620,Pal; Piya,9999,0,9999,0
1668074868467,ECE 200,036,103621,Papen; George C.,9999,0,9999,0
1668074868467,ECE 200,037,103622,Radic; Stojan,9999,0,9999,0
1668074868467,ECE 200,038,103623,Rao; Bhaskar D.,9999,0,9999,0
1668074868467,ECE 200,039,103624,Rao; Ramesh R,9999,0,9999,0
1668074868467,ECE 200,040,103625,Rebeiz; Gabriel,9999,0,9999,0
1668074868467,ECE 200,041,103626,Sanford; John R,9999,0,9999,0
1668074868467,ECE 200,042,103627,Siegel; Paul H.,9999,0,9999,0
1668074868467,ECE 200,043,103628,Sievenpiper; Daniel F.,9999,0,9999,0
1668074868467,ECE 200,044,103629,Sworder; David D.,9999,0,9999,0
1668074868467,ECE 200,045,103630,Taur; Yuan,9999,0,9999,0
1668074868467,ECE 200,046,103631,Touri; Behrouz,9999,0,9999,0
1668074868467,ECE 200,047,103632,Trivedi; Mohan M.,9999,0,9999,0
1668074868467,ECE 200,048,103633,Vasconcelos; Nuno,9999,0,9999,0
1668074868467,ECE 200,049,103634,Wang; Xiaolong,9999,0,9999,0
1668074868467,ECE 200,050,103635,Xie; Pengtao,9999,0,9999,0
1668074868467,ECE 200,051,103636,Yip; Michael,9999,0,9999,0
1668074868467,ECE 200,052,103637,Zeger; Kenneth A.,999,0,999,0
1668074868467,ECE 200,053,103638,Zhang; Xinyu,9999,0,9999,0
1668074868467,ECE 200,054,103639,Turakhia; Yatish Girish,9999,0,9999,0
1668074868467,ECE 200,055,103640,Kang; Mingu,9999,0,9999,0
1668074868467,ECE 200,056,103641,Shi; Yuanyuan,9999,0,9999,0
1668074868467,ECE 200,057,103642,Wang; Edward Jay,9999,0,9999,0
1668074868467,ECE 200,058,103643,Zheng; Yang,9999,0,9999,0
1668074868892,ECE 202,A00,103644,Kuzum; Duygu,0,0,0,0
1668074869317,ECE 212BN,A00,103646,Ng; Tse Nga,0,0,0,0
1668074869743,ECE 221,A00,111493,Staff,0,0,0,0
1668074870178,ECE 222B,A00,103647,Lomakin; Vitaliy,0,0,0,0
1668074870600,ECE 230B,A00,103648,Taur; Yuan,0,0,0,0
1668074871024,ECE 238B,A00,103649,Garay; Javier,0,0,0,0
1668074871449,ECE 240B,A00,112900,Fainman; Yeshaiahu,0,0,0,0
1668074871874,ECE 247A,A00,103650,Jokerst; Jesse Vincent,0,0,0,0
1668074872309,ECE 247B,A00,103651,Wang; Joseph,0,0,0,0
1668074872736,ECE 250,A00,103652,Siegel; Paul H.,0,0,0,0
1668074873164,ECE 251A,A00,103654,Rao; Bhaskar D.,0,0,0,0
1668074873587,ECE 257B,A00,103655,Bharadia; Dinesh,0,0,0,0
1668074874012,ECE 258A,A00,103656,Milstein; Laurence B.,0,0,0,0
1668074874440,ECE 260B,A00,103658,Kang; Mingu,0,0,0,0
1668074874869,ECE 264A,A00,103659,Galton; Ian A,0,0,0,0
1668074875293,ECE 265A,A00,103661,Gudem; Prasad S.S.,0,0,0,0
1668074875720,ECE 265D,A00,103662,Gudem; Prasad S.S.,0,0,0,0
1668074876144,ECE 268,A00,103663,Koushanfar; Farinaz,0,0,0,0
1668074876571,ECE 269,A01,103665,Pal; Piya,0,0,0,0
1668074876996,ECE 271B,A00,103666,Vasconcelos; Manuela,0,0,0,0
1668074877426,ECE 276A,A00,103667,Atanasov; Nikolay A.,0,0,0,0
1668074877849,ECE 277,A00,103668,An; Cheolhong,0,0,0,0
1668074878291,ECE 279,A00,117947,Hall; Drew A.,0,0,0,0
1668074879154,ECE 283,A00,103670,Hsueh; Tzu-Chien,0,0,0,0
1668074879589,ECE 284,A00,103671,Turakhia; Yatish Girish,0,0,0,0
1668074880027,ECE 285,A00,103672,Zheng; Yang,0,0,0,0
1668074880027,ECE 285,B00,103673,Sworder; David D.,0,0,0,0
1668074880465,ECE 287,A00,103676,Javidi; Tara,0,0,0,0
1668074880894,MATH 200B,A00,098023,Salehi Golsefidy; Alireza,13,0,15,2
1668074881319,MATH 202B,A00,098024,Rhoades; Brendon Patrick,9,0,15,6
1668074881745,MATH 203B,A00,098025,Oprea; Dragos N.,10,0,15,5
1668074882169,MATH 204B,A00,098026,Sorensen; Claus M,13,0,15,2
1668074882604,MATH 208,A00,098027,Izadi; Elham,7,0,10,3
1668074883029,MATH 209,A00,098028,Pollack; Aaron,10,0,10,0
1668074883451,MATH 211A,A00,112919,Rogalski; Daniel,9,0,10,1
1668074883873,MATH 211B,A00,112920,Seward; Brandon M.,9,0,10,1
1668074884295,MATH 218,A00,098029,Li; Bo,10,0,10,0
1668074884719,MATH 220B,A00,098030,Novak; Jonathan I,12,0,15,3
1668074885143,MATH 221A,A00,098031,Ebenfelt; Peter F,13,0,15,2
1668074885567,MATH 231B,A00,098032,Zlatos; Andrej,12,0,15,3
1668074885992,MATH 240B,A00,098033,Ni; Lei,9,0,15,6
1668074886416,MATH 243,A00,098034,Jekel; David Andrew,10,0,10,0
1668074886843,MATH 245A,A00,098035,Nie; Jiawang,0,0,15,16
1668074887268,MATH 248,A00,098036,Bejenaru; Ioan,10,0,10,0
1668074887694,MATH 250B,A00,098037,Spolaor; Luca,14,0,15,1
1668074888120,MATH 258,A00,098038,Ni; Lei,10,0,10,0
1668074888543,MATH 264B,A00,098041,Rhoades; Brendon Patrick,10,0,15,5
1668074889068,MATH 268,A00,098042,Buss; Samuel R,10,0,10,0
1668074889492,MATH 269,A00,098043,Rhoades; Brendon Patrick,10,0,10,0
1668074889917,MATH 270B,A00,098044,Li; Bo,11,0,15,4
1668074890340,MATH 272B,A00,098045,Holst; Michael J,13,0,15,2
1668074890765,MATH 273A,A00,098046,Tian; Xiaochuan,10,0,15,5
1668074891189,MATH 275,A01,098048,Tian; Xiaochuan,6,0,10,4
1668074891616,MATH 278A,A00,098049,Holst; Michael J,8,0,10,2
1668074892043,MATH 278B,A00,098050,Cloninger; Alexander,10,0,10,0
1668074892468,MATH 278C,A00,098051,Nie; Jiawang,7,0,10,3
1668074892892,MATH 280B,A00,098052,Zheng; Tianyi,10,0,15,5
1668074893315,MATH 281B,A00,098053,Bradic; Jelena,3,0,15,12
1668074893742,MATH 282B,A00,098054,Arias-Castro; Ery,0,0,15,15
1668074894183,MATH 285,A00,098055,Fitzsimmons; Patrick J,0,0,15,17
1668074894610,MATH 287B,A00,098056,Arias-Castro; Ery,3,0,15,12
1668074895041,MATH 288,A00,098057,Agarwal; Pooja,9,0,10,1
1668074895041,MATH 288,B00,098058,Zhang; Danna,8,0,10,2
1668074895041,MATH 288,C00,098059,Williams; Ruth J,10,0,10,0
1668074895481,MATH 290B,A00,098060,Roberts; Justin Deritter,13,0,15,2
1668074895909,MATH 292,A00,098061,Belmont; Eva Kinoshita,10,0,10,0
1668074896339,MATH 295,A00,098062,Suk; Andrew Hoon,48,0,50,2
1668074896777,MATH 296,A00,098063,Novak; Jonathan I,20,0,20,0
1668074897205,MATH 297,001,098064,Gamst; Anthony Collins,9997,0,9999,2
1668075397993,COGS 205,A00,101395,Chiba; Andrea,19,0,20,1
1668075398421,COGS 210B,001,101404,Greene; Deanna Jacquelyn,9998,0,9999,1
1668075398421,COGS 210B,002,101417,Xia; Haijun,9999,0,9999,0
1668075398421,COGS 210B,003,101422,Nitz; Douglas A.,9999,0,9999,0
1668075398421,COGS 210B,004,101423,Hollan; James D.,9998,0,9999,1
1668075398421,COGS 210B,005,101424,Deak; Gedeon O.,9998,0,9999,1
1668075398421,COGS 210B,006,101425,Rossano; Federico,9999,0,9999,0
1668075398848,COGS 211B,A00,101427,Coulson; Seana M,9996,0,9999,3
1668075399271,COGS 220,A00,101428,Hollan; James D.,0,0,25,25
1668075399697,COGS 229,A00,101429,Dow; Steven P,18,0,25,7
1668075400129,COGS 230,A00,101430,Klemmer; Scott R,13,0,17,4
1668075400561,COGS 234,A00,101431,Xia; Haijun,3,0,25,22
1668075400988,COGS 260,A00,101432,Kiyonaga; Anastasia,19,0,25,6
1668075400988,COGS 260,B00,101433,Kirsh; David Joel,16,0,25,9
1668075401415,CSE 202,A00,102371,Impagliazzo; Russell,0,0,0,0
1668075401843,CSE 203B,A01,102373,Cheng; Chung Kuan,0,0,0,0
1668075402270,CSE 208,A00,102374,Micciancio; Daniele,0,0,0,0
1668075402694,CSE 209A,A00,112895,Impagliazzo; Russell,0,0,15,15
1668075403118,CSE 209B,A00,108005,Bellare; Mihir,0,0,0,0
1668075403546,CSE 210,A00,113163,Coblenz; Michael J,0,0,0,0
1668075403970,CSE 219,A00,106111,Dow; Steven P,0,0,20,20
1668075404399,CSE 221,A00,102376,Voelker; Geoffrey M.,0,0,0,0
1668075404821,CSE 224,A01,102378,Porter; George M,0,0,0,0
1668075405248,CSE 229A,A00,102379,Savage; Stefan,0,0,0,0
1668075405671,CSE 229C,A00,102380,Munyaka; Imani N. S.,0,0,0,0
1668075406095,CSE 232B,A00,102382,Deutsch; Alin Bernard,0,0,0,0
1668075406538,CSE 234,A01,112904,Kumar; Arun Kumar,0,0,0,0
1668075406962,CSE 237A,A00,102383,Rosing; Tajana Simunic,0,0,0,0
1668075407387,CSE 239A,A00,102384,Deutsch; Alin Bernard,0,0,0,0
1668075407810,CSE 239B,A00,102385,Polikarpova; Nadezhda,0,0,0,0
1668075408233,CSE 240A,A00,102386,Pannuto; Patrick William,0,0,0,0
1668075408666,CSE 240B,A00,102387,Zhao; Jishen,0,0,0,0
1668075409089,CSE 241A,A00,106406,Kang; Mingu,0,0,0,0
1668075409516,CSE 249B,A00,102388,Kahng; Andrew Byun,0,0,8,8
1668075410034,CSE 251B,A01,102392,Cottrell; Garrison W,0,0,0,0
1668075410034,CSE 251B,A02,102393,Cottrell; Garrison W,0,0,0,0
1668075410461,CSE 252B,A00,102394,Ochoa; Benjamin Lawrence,0,0,0,0
1668075410894,CSE 257,A01,102396,Gao; Sicun,0,0,0,0
1668075411318,CSE 272,A00,102397,Li; Tzumao,0,0,0,0
1668075411743,CSE 274,A00,111323,Chern; Albert Ren-Haur,0,0,0,0
1668075412166,CSE 282,A00,102398,Pevzner; Pavel Arkadjevich,0,0,0,0
1668075412591,CSE 284,A00,114175,Gymrek; Melissa Ann,0,0,0,0
1668075413016,CSE 290,A00,102399,Chandraker; Manmohan Krishna,0,0,0,0
1668075413016,CSE 290,B00,102400,Vaccaro; Kristen Marie,0,0,25,25
1668075413016,CSE 290,C00,102414,Pannuto; Patrick William,0,0,25,25
1668075413016,CSE 290,D00,102427,Pevzner; Pavel Arkadjevich,0,0,0,0
1668075413016,CSE 290,E00,102429,Zhao; Jishen,0,0,0,0
1668075413016,CSE 290,F00,102436,Tullsen; Dean Michael,0,0,0,0
1668075413016,CSE 290,G00,102440,Christensen; Henrik I,0,0,20,20
1668075413446,CSE 291,A00,102443,Su; Hao,0,0,0,0
1668075413446,CSE 291,B00,102448,Polikarpova; Nadezhda,0,0,0,0
1668075413446,CSE 291,C00,102453,Vaccaro; Kristen Marie,0,0,0,0
1668075413446,CSE 291,D00,111343,Savage; Stefan,0,0,0,0
1668075413446,CSE 291,E00,116474,Claffy; Kimberly Claire,0,0,0,0
1668075413446,CSE 291,F00,116479,Pasquale; Joseph,0,0,0,0
1668075413879,CSE 293,001,119111,Bafna; Vineet,9999,0,9999,0
1668075413879,CSE 293,002,119118,Bellare; Mihir,9999,0,9999,0
1668075413879,CSE 293,003,119122,Berg-Kirkpatrick; Taylor D,9999,0,9999,0
1668075413879,CSE 293,004,119135,Christensen; Henrik I,9999,0,9999,0
1668075413879,CSE 293,005,119142,Cottrell; Garrison W,9999,0,9999,0
1668075413879,CSE 293,006,119146,Deutsch; Alin Bernard,9999,0,9999,0
1668075413879,CSE 293,007,119159,Esmaeilzadeh; Hadi,9999,0,9999,0
1668075413879,CSE 293,008,119166,Freund; Yoav,9999,0,9999,0
1668075413879,CSE 293,009,119170,Griswold; William G.,9999,0,9999,0
1668075413879,CSE 293,010,119183,Gymrek; Melissa Ann,9999,0,9999,0
1668075413879,CSE 293,011,119190,Heninger; Nadia A,9999,0,9999,0
1668075413879,CSE 293,012,119230,Impagliazzo; Russell,9999,0,9999,0
1668075413879,CSE 293,013,119232,Jhala; Ranjit,9999,0,9999,0
1668075413879,CSE 293,014,119233,Kahng; Andrew Byun,9999,0,9999,0
1668075413879,CSE 293,015,119298,Kane; Daniel Mertz,9999,0,9999,0
1668075413879,CSE 293,016,119299,Kriegman; David J,9999,0,9999,0
1668075413879,CSE 293,017,119300,Kumar; Arun Kumar,9999,0,9999,0
1668075413879,CSE 293,018,119301,Lerner; Sorin,9999,0,9999,0
1668075413879,CSE 293,019,119302,Lovett; Shachar,9999,0,9999,0
1668075413879,CSE 293,020,119303,McAuley; Julian John,9999,0,9999,0
1668075413879,CSE 293,021,119304,Micciancio; Daniele,9999,0,9999,0
1668075413879,CSE 293,022,119367,Orailoglu; Alex,9999,0,9999,0
1668075413879,CSE 293,023,119382,Paturi; Ramamohan,9999,0,9999,0
1668075413879,CSE 293,024,119404,Polikarpova; Nadezhda,9999,0,9999,0
1668075413879,CSE 293,025,119406,Politz; Joseph Gibbs,9999,0,9999,0
1668075413879,CSE 293,026,119411,Porter; George M,9999,0,9999,0
1668075413879,CSE 293,027,119414,Porter; Leonard Emerson,9999,0,9999,0
1668075413879,CSE 293,028,119416,Ramamoorthi; Ravi,9999,0,9999,0
1668075413879,CSE 293,029,119417,Sahoo; Debashis,9999,0,9999,0
1668075413879,CSE 293,030,119420,Saul; Lawrence,9999,0,9999,0
1668075413879,CSE 293,031,119421,Savage; Stefan,9999,0,9999,0
1668075413879,CSE 293,032,119425,Schulze; Jurgen P.,9999,0,9999,0
1668075413879,CSE 293,033,119426,Snoeren; Alex C.,9999,0,9999,0
1668075413879,CSE 293,034,119428,Shang; Jingbo,9999,0,9999,0
1668075413879,CSE 293,035,119430,Stefan; Deian,9999,0,9999,0
1668075413879,CSE 293,036,119431,Su; Hao,9999,0,9999,0
1668075413879,CSE 293,037,119433,Swanson; Steven James,9999,0,9999,0
1668075413879,CSE 293,038,119435,Tullsen; Dean Michael,9999,0,9999,0
1668075413879,CSE 293,039,119483,Voelker; Geoffrey M.,9999,0,9999,0
1668075413879,CSE 293,040,119537,Zhao; Jishen,9999,0,9999,0
1668075413879,CSE 293,041,119538,Zhou; Yuan-Yuan,9999,0,9999,0
1668075413879,CSE 293,042,119539,Gao; Sicun,9999,0,9999,0
1668075413879,CSE 293,043,119540,Weibel; Nadir,9999,0,9999,0
1668075413879,CSE 293,044,119541,Gupta; Rajesh K.,9999,0,9999,0
1668075413879,CSE 293,045,126410,Vaccaro; Kristen Marie,9999,0,9999,0
1668075413879,CSE 293,046,126411,Klemke; Richard,9999,0,9999,0
1668075414306,CSE 294,A00,102459,Voelker; Geoffrey M.,0,0,0,0
1668075414306,CSE 294,B00,111322,Orailoglu; Alex,0,0,0,0
1668075414733,DSE 201,A00,096914,Deutsch; Alin Bernard,30,0,30,0
1668075415163,DSE 210,A00,096915,Dasgupta; Sanjoy,30,0,30,0
1668075415588,DSE 260A,A00,096916,Altintas De Callaf; Ilkay,30,0,30,0
1668075416017,ECE 200,001,103586,Antipa; Nicholas A,9999,0,9999,0
1668075416017,ECE 200,002,103587,Atanasov; Nikolay A.,9999,0,9999,0
1668075416017,ECE 200,003,103588,Bharadia; Dinesh,9999,0,9999,0
1668075416017,ECE 200,004,103589,Cheng; Chung Kuan,9999,0,9999,0
1668075416017,ECE 200,005,103590,Cosman; Pamela C.,9999,0,9999,0
1668075416017,ECE 200,006,103591,Dayeh; Shadi Ahmad,9999,0,9999,0
1668075416017,ECE 200,007,103592,Fainman; Yeshaiahu,9999,0,9999,0
1668075416017,ECE 200,008,103593,Ford; Joseph Earl,9999,0,9999,0
1668075416017,ECE 200,009,103594,Franceschetti; Massimo,9999,0,9999,0
1668075416017,ECE 200,010,103595,Fullerton; Eric E,9999,0,9999,0
1668075416017,ECE 200,011,103596,Galton; Ian A,9999,0,9999,0
1668075416017,ECE 200,012,103597,Gilja; Vikash,9999,0,9999,0
1668075416017,ECE 200,013,103598,Hall; Drew A.,9999,0,9999,0
1668075416017,ECE 200,014,103599,Hsueh; Tzu-Chien,9999,0,9999,0
1668075416017,ECE 200,015,103600,Javidi; Tara,9999,0,9999,0
1668075416017,ECE 200,016,103601,Kahng; Andrew Byun,9999,0,9999,0
1668075416017,ECE 200,017,103602,Kim; Young-Han,9999,0,9999,0
1668075416017,ECE 200,018,103603,Koushanfar; Farinaz,9999,0,9999,0
1668075416017,ECE 200,019,103604,Kuzum; Duygu,9999,0,9999,0
1668075416017,ECE 200,020,103605,Le; Hanh-Phuc,9999,0,9999,0
1668075416017,ECE 200,021,103606,Lin; Bill,9999,0,9999,0
1668075416017,ECE 200,022,103607,Liu; Zhaowei,9998,0,9999,1
1668075416017,ECE 200,023,103608,Lo; Yu-Hwa,9999,0,9999,0
1668075416017,ECE 200,024,103609,Lomakin; Vitaliy,9999,0,9999,0
1668075416017,ECE 200,025,103610,Mercier; Patrick Philip,9999,0,9999,0
1668075416017,ECE 200,026,103611,Meyer; Florian,9999,0,9999,0
1668075416017,ECE 200,027,103612,Milstein; Laurence B.,9999,0,9999,0
1668075416017,ECE 200,028,103613,Mir Arabbaygi; Siavash,9999,0,9999,0
1668075416017,ECE 200,029,103614,Mookherjea; Shayan,9999,0,9999,0
1668075416017,ECE 200,030,103615,Morris; Karcher William,9999,0,9999,0
1668075416017,ECE 200,031,103616,Ng; Tse Nga,9999,0,9999,0
1668075416017,ECE 200,032,103617,Nguyen; Truong Quang,9999,0,9999,0
1668075416017,ECE 200,033,103618,Nomura; Kenji,9999,0,9999,0
1668075416017,ECE 200,034,103619,Orlitsky; Alon,9999,0,9999,0
1668075416017,ECE 200,035,103620,Pal; Piya,9999,0,9999,0
1668075416017,ECE 200,036,103621,Papen; George C.,9999,0,9999,0
1668075416017,ECE 200,037,103622,Radic; Stojan,9999,0,9999,0
1668075416017,ECE 200,038,103623,Rao; Bhaskar D.,9999,0,9999,0
1668075416017,ECE 200,039,103624,Rao; Ramesh R,9999,0,9999,0
1668075416017,ECE 200,040,103625,Rebeiz; Gabriel,9999,0,9999,0
1668075416017,ECE 200,041,103626,Sanford; John R,9999,0,9999,0
1668075416017,ECE 200,042,103627,Siegel; Paul H.,9999,0,9999,0
1668075416017,ECE 200,043,103628,Sievenpiper; Daniel F.,9999,0,9999,0
1668075416017,ECE 200,044,103629,Sworder; David D.,9999,0,9999,0
1668075416017,ECE 200,045,103630,Taur; Yuan,9999,0,9999,0
1668075416017,ECE 200,046,103631,Touri; Behrouz,9999,0,9999,0
1668075416017,ECE 200,047,103632,Trivedi; Mohan M.,9999,0,9999,0
1668075416017,ECE 200,048,103633,Vasconcelos; Nuno,9999,0,9999,0
1668075416017,ECE 200,049,103634,Wang; Xiaolong,9999,0,9999,0
1668075416017,ECE 200,050,103635,Xie; Pengtao,9999,0,9999,0
1668075416017,ECE 200,051,103636,Yip; Michael,9999,0,9999,0
1668075416017,ECE 200,052,103637,Zeger; Kenneth A.,999,0,999,0
1668075416017,ECE 200,053,103638,Zhang; Xinyu,9999,0,9999,0
1668075416017,ECE 200,054,103639,Turakhia; Yatish Girish,9999,0,9999,0
1668075416017,ECE 200,055,103640,Kang; Mingu,9999,0,9999,0
1668075416017,ECE 200,056,103641,Shi; Yuanyuan,9999,0,9999,0
1668075416017,ECE 200,057,103642,Wang; Edward Jay,9999,0,9999,0
1668075416017,ECE 200,058,103643,Zheng; Yang,9999,0,9999,0
1668075416441,ECE 202,A00,103644,Kuzum; Duygu,0,0,0,0
1668075416864,ECE 212BN,A00,103646,Ng; Tse Nga,0,0,0,0
1668075417290,ECE 221,A00,111493,Staff,0,0,0,0
1668075417713,ECE 222B,A00,103647,Lomakin; Vitaliy,0,0,0,0
1668075418140,ECE 230B,A00,103648,Taur; Yuan,0,0,0,0
1668075418567,ECE 238B,A00,103649,Garay; Javier,0,0,0,0
1668075418994,ECE 240B,A00,112900,Fainman; Yeshaiahu,0,0,0,0
1668075419421,ECE 247A,A00,103650,Jokerst; Jesse Vincent,0,0,0,0
1668075419845,ECE 247B,A00,103651,Wang; Joseph,0,0,0,0
1668075420274,ECE 250,A00,103652,Siegel; Paul H.,0,0,0,0
1668075420700,ECE 251A,A00,103654,Rao; Bhaskar D.,0,0,0,0
1668075421123,ECE 257B,A00,103655,Bharadia; Dinesh,0,0,0,0
1668075421548,ECE 258A,A00,103656,Milstein; Laurence B.,0,0,0,0
1668075421975,ECE 260B,A00,103658,Kang; Mingu,0,0,0,0
1668075422409,ECE 264A,A00,103659,Galton; Ian A,0,0,0,0
1668075422834,ECE 265A,A00,103661,Gudem; Prasad S.S.,0,0,0,0
1668075423259,ECE 265D,A00,103662,Gudem; Prasad S.S.,0,0,0,0
1668075423683,ECE 268,A00,103663,Koushanfar; Farinaz,0,0,0,0
1668075424108,ECE 269,A01,103665,Pal; Piya,0,0,0,0
1668075424532,ECE 271B,A00,103666,Vasconcelos; Manuela,0,0,0,0
1668075424961,ECE 276A,A00,103667,Atanasov; Nikolay A.,0,0,0,0
1668075425384,ECE 277,A00,103668,An; Cheolhong,0,0,0,0
1668075425811,ECE 279,A00,117947,Hall; Drew A.,0,0,0,0
1668075426667,ECE 283,A00,103670,Hsueh; Tzu-Chien,0,0,0,0
1668075427092,ECE 284,A00,103671,Turakhia; Yatish Girish,0,0,0,0
1668075427518,ECE 285,A00,103672,Zheng; Yang,0,0,0,0
1668075427518,ECE 285,B00,103673,Sworder; David D.,0,0,0,0
1668075427945,ECE 287,A00,103676,Javidi; Tara,0,0,0,0
1668075428370,MATH 200B,A00,098023,Salehi Golsefidy; Alireza,13,0,15,2
1668075428794,MATH 202B,A00,098024,Rhoades; Brendon Patrick,9,0,15,6
1668075429218,MATH 203B,A00,098025,Oprea; Dragos N.,10,0,15,5
1668075429641,MATH 204B,A00,098026,Sorensen; Claus M,13,0,15,2
1668075430069,MATH 208,A00,098027,Izadi; Elham,7,0,10,3
1668075430491,MATH 209,A00,098028,Pollack; Aaron,10,0,10,0
1668075430913,MATH 211A,A00,112919,Rogalski; Daniel,9,0,10,1
1668075431340,MATH 211B,A00,112920,Seward; Brandon M.,9,0,10,1
1668075431769,MATH 218,A00,098029,Li; Bo,10,0,10,0
1668075432194,MATH 220B,A00,098030,Novak; Jonathan I,12,0,15,3
1668075432619,MATH 221A,A00,098031,Ebenfelt; Peter F,13,0,15,2
1668075433049,MATH 231B,A00,098032,Zlatos; Andrej,12,0,15,3
1668075433475,MATH 240B,A00,098033,Ni; Lei,9,0,15,6
1668075433900,MATH 243,A00,098034,Jekel; David Andrew,10,0,10,0
1668075434324,MATH 245A,A00,098035,Nie; Jiawang,0,0,15,16
1668075434750,MATH 248,A00,098036,Bejenaru; Ioan,10,0,10,0
1668075435177,MATH 250B,A00,098037,Spolaor; Luca,14,0,15,1
1668075435599,MATH 258,A00,098038,Ni; Lei,10,0,10,0
1668075436024,MATH 264B,A00,098041,Rhoades; Brendon Patrick,10,0,15,5
1668075436453,MATH 268,A00,098042,Buss; Samuel R,10,0,10,0
1668075436879,MATH 269,A00,098043,Rhoades; Brendon Patrick,10,0,10,0
1668075437305,MATH 270B,A00,098044,Li; Bo,11,0,15,4
1668075437733,MATH 272B,A00,098045,Holst; Michael J,13,0,15,2
1668075438158,MATH 273A,A00,098046,Tian; Xiaochuan,10,0,15,5
1668075438586,MATH 275,A01,098048,Tian; Xiaochuan,6,0,10,4
1668075439016,MATH 278A,A00,098049,Holst; Michael J,8,0,10,2
1668075439439,MATH 278B,A00,098050,Cloninger; Alexander,10,0,10,0
1668075439868,MATH 278C,A00,098051,Nie; Jiawang,7,0,10,3
1668075440295,MATH 280B,A00,098052,Zheng; Tianyi,10,0,15,5
1668075440721,MATH 281B,A00,098053,Bradic; Jelena,3,0,15,12
1668075441146,MATH 282B,A00,098054,Arias-Castro; Ery,0,0,15,15
1668075441572,MATH 285,A00,098055,Fitzsimmons; Patrick J,0,0,15,17
1668075441997,MATH 287B,A00,098056,Arias-Castro; Ery,3,0,15,12
1668075442422,MATH 288,A00,098057,Agarwal; Pooja,9,0,10,1
1668075442422,MATH 288,B00,098058,Zhang; Danna,8,0,10,2
1668075442422,MATH 288,C00,098059,Williams; Ruth J,10,0,10,0
1668075442851,MATH 290B,A00,098060,Roberts; Justin Deritter,13,0,15,2
1668075443285,MATH 292,A00,098061,Belmont; Eva Kinoshita,10,0,10,0
1668075443724,MATH 295,A00,098062,Suk; Andrew Hoon,48,0,50,2
1668075444150,MATH 296,A00,098063,Novak; Jonathan I,20,0,20,0
1668075444581,MATH 297,001,098064,Gamst; Anthony Collins,9997,0,9999,2
1668075944982,COGS 205,A00,101395,Chiba; Andrea,19,0,20,1
1668075945418,COGS 210B,001,101404,Greene; Deanna Jacquelyn,9998,0,9999,1
1668075945418,COGS 210B,002,101417,Xia; Haijun,9999,0,9999,0
1668075945418,COGS 210B,003,101422,Nitz; Douglas A.,9999,0,9999,0
1668075945418,COGS 210B,004,101423,Hollan; James D.,9998,0,9999,1
1668075945418,COGS 210B,005,101424,Deak; Gedeon O.,9998,0,9999,1
1668075945418,COGS 210B,006,101425,Rossano; Federico,9999,0,9999,0
1668075945844,COGS 211B,A00,101427,Coulson; Seana M,9996,0,9999,3
1668075946268,COGS 220,A00,101428,Hollan; James D.,0,0,25,25
1668075946691,COGS 229,A00,101429,Dow; Steven P,18,0,25,7
1668075947117,COGS 230,A00,101430,Klemmer; Scott R,13,0,17,4
1668075947542,COGS 234,A00,101431,Xia; Haijun,3,0,25,22
1668075947971,COGS 260,A00,101432,Kiyonaga; Anastasia,19,0,25,6
1668075947971,COGS 260,B00,101433,Kirsh; David Joel,16,0,25,9
1668075948396,CSE 202,A00,102371,Impagliazzo; Russell,0,0,0,0
1668075948819,CSE 203B,A01,102373,Cheng; Chung Kuan,0,0,0,0
1668075949245,CSE 208,A00,102374,Micciancio; Daniele,0,0,0,0
1668075949668,CSE 209A,A00,112895,Impagliazzo; Russell,0,0,15,15
1668075950094,CSE 209B,A00,108005,Bellare; Mihir,0,0,0,0
1668075950521,CSE 210,A00,113163,Coblenz; Michael J,0,0,0,0
1668075950949,CSE 219,A00,106111,Dow; Steven P,0,0,20,20
1668075951374,CSE 221,A00,102376,Voelker; Geoffrey M.,0,0,0,0
1668075951803,CSE 224,A01,102378,Porter; George M,0,0,0,0
1668075952231,CSE 229A,A00,102379,Savage; Stefan,0,0,0,0
1668075952665,CSE 229C,A00,102380,Munyaka; Imani N. S.,0,0,0,0
1668075953087,CSE 232B,A00,102382,Deutsch; Alin Bernard,0,0,0,0
1668075953511,CSE 234,A01,112904,Kumar; Arun Kumar,0,0,0,0
1668075953938,CSE 237A,A00,102383,Rosing; Tajana Simunic,0,0,0,0
1668075954362,CSE 239A,A00,102384,Deutsch; Alin Bernard,0,0,0,0
1668075954787,CSE 239B,A00,102385,Polikarpova; Nadezhda,0,0,0,0
1668075955210,CSE 240A,A00,102386,Pannuto; Patrick William,0,0,0,0
1668075955637,CSE 240B,A00,102387,Zhao; Jishen,0,0,0,0
1668075956064,CSE 241A,A00,106406,Kang; Mingu,0,0,0,0
1668075956512,CSE 249B,A00,102388,Kahng; Andrew Byun,0,0,8,8
1668075956947,CSE 251B,A01,102392,Cottrell; Garrison W,0,0,0,0
1668075956947,CSE 251B,A02,102393,Cottrell; Garrison W,0,0,0,0
1668075957373,CSE 252B,A00,102394,Ochoa; Benjamin Lawrence,0,0,0,0
1668075957797,CSE 257,A01,102396,Gao; Sicun,0,0,0,0
1668075958221,CSE 272,A00,102397,Li; Tzumao,0,0,0,0
1668075958647,CSE 274,A00,111323,Chern; Albert Ren-Haur,0,0,0,0
1668075959070,CSE 282,A00,102398,Pevzner; Pavel Arkadjevich,0,0,0,0
1668075959499,CSE 284,A00,114175,Gymrek; Melissa Ann,0,0,0,0
1668075959923,CSE 290,A00,102399,Chandraker; Manmohan Krishna,0,0,0,0
1668075959923,CSE 290,B00,102400,Vaccaro; Kristen Marie,0,0,25,25
1668075959923,CSE 290,C00,102414,Pannuto; Patrick William,0,0,25,25
1668075959923,CSE 290,D00,102427,Pevzner; Pavel Arkadjevich,0,0,0,0
1668075959923,CSE 290,E00,102429,Zhao; Jishen,0,0,0,0
1668075959923,CSE 290,F00,102436,Tullsen; Dean Michael,0,0,0,0
1668075959923,CSE 290,G00,102440,Christensen; Henrik I,0,0,20,20
1668075960349,CSE 291,A00,102443,Su; Hao,0,0,0,0
1668075960349,CSE 291,B00,102448,Polikarpova; Nadezhda,0,0,0,0
1668075960349,CSE 291,C00,102453,Vaccaro; Kristen Marie,0,0,0,0
1668075960349,CSE 291,D00,111343,Savage; Stefan,0,0,0,0
1668075960349,CSE 291,E00,116474,Claffy; Kimberly Claire,0,0,0,0
1668075960349,CSE 291,F00,116479,Pasquale; Joseph,0,0,0,0
1668075960780,CSE 293,001,119111,Bafna; Vineet,9999,0,9999,0
1668075960780,CSE 293,002,119118,Bellare; Mihir,9999,0,9999,0
1668075960780,CSE 293,003,119122,Berg-Kirkpatrick; Taylor D,9999,0,9999,0
1668075960780,CSE 293,004,119135,Christensen; Henrik I,9999,0,9999,0
1668075960780,CSE 293,005,119142,Cottrell; Garrison W,9999,0,9999,0
1668075960780,CSE 293,006,119146,Deutsch; Alin Bernard,9999,0,9999,0
1668075960780,CSE 293,007,119159,Esmaeilzadeh; Hadi,9999,0,9999,0
1668075960780,CSE 293,008,119166,Freund; Yoav,9999,0,9999,0
1668075960780,CSE 293,009,119170,Griswold; William G.,9999,0,9999,0
1668075960780,CSE 293,010,119183,Gymrek; Melissa Ann,9999,0,9999,0
1668075960780,CSE 293,011,119190,Heninger; Nadia A,9999,0,9999,0
1668075960780,CSE 293,012,119230,Impagliazzo; Russell,9999,0,9999,0
1668075960780,CSE 293,013,119232,Jhala; Ranjit,9999,0,9999,0
1668075960780,CSE 293,014,119233,Kahng; Andrew Byun,9999,0,9999,0
1668075960780,CSE 293,015,119298,Kane; Daniel Mertz,9999,0,9999,0
1668075960780,CSE 293,016,119299,Kriegman; David J,9999,0,9999,0
1668075960780,CSE 293,017,119300,Kumar; Arun Kumar,9999,0,9999,0
1668075960780,CSE 293,018,119301,Lerner; Sorin,9999,0,9999,0
1668075960780,CSE 293,019,119302,Lovett; Shachar,9999,0,9999,0
1668075960780,CSE 293,020,119303,McAuley; Julian John,9999,0,9999,0
1668075960780,CSE 293,021,119304,Micciancio; Daniele,9999,0,9999,0
1668075960780,CSE 293,022,119367,Orailoglu; Alex,9999,0,9999,0
1668075960780,CSE 293,023,119382,Paturi; Ramamohan,9999,0,9999,0
1668075960780,CSE 293,024,119404,Polikarpova; Nadezhda,9999,0,9999,0
1668075960780,CSE 293,025,119406,Politz; Joseph Gibbs,9999,0,9999,0
1668075960780,CSE 293,026,119411,Porter; George M,9999,0,9999,0
1668075960780,CSE 293,027,119414,Porter; Leonard Emerson,9999,0,9999,0
1668075960780,CSE 293,028,119416,Ramamoorthi; Ravi,9999,0,9999,0
1668075960780,CSE 293,029,119417,Sahoo; Debashis,9999,0,9999,0
1668075960780,CSE 293,030,119420,Saul; Lawrence,9999,0,9999,0
1668075960780,CSE 293,031,119421,Savage; Stefan,9999,0,9999,0
1668075960780,CSE 293,032,119425,Schulze; Jurgen P.,9999,0,9999,0
1668075960780,CSE 293,033,119426,Snoeren; Alex C.,9999,0,9999,0
1668075960780,CSE 293,034,119428,Shang; Jingbo,9999,0,9999,0
1668075960780,CSE 293,035,119430,Stefan; Deian,9999,0,9999,0
1668075960780,CSE 293,036,119431,Su; Hao,9999,0,9999,0
1668075960780,CSE 293,037,119433,Swanson; Steven James,9999,0,9999,0
1668075960780,CSE 293,038,119435,Tullsen; Dean Michael,9999,0,9999,0
1668075960780,CSE 293,039,119483,Voelker; Geoffrey M.,9999,0,9999,0
1668075960780,CSE 293,040,119537,Zhao; Jishen,9999,0,9999,0
1668075960780,CSE 293,041,119538,Zhou; Yuan-Yuan,9999,0,9999,0
1668075960780,CSE 293,042,119539,Gao; Sicun,9999,0,9999,0
1668075960780,CSE 293,043,119540,Weibel; Nadir,9999,0,9999,0
1668075960780,CSE 293,044,119541,Gupta; Rajesh K.,9999,0,9999,0
1668075960780,CSE 293,045,126410,Vaccaro; Kristen Marie,9999,0,9999,0
1668075960780,CSE 293,046,126411,Klemke; Richard,9999,0,9999,0
1668075961202,CSE 294,A00,102459,Voelker; Geoffrey M.,0,0,0,0
1668075961202,CSE 294,B00,111322,Orailoglu; Alex,0,0,0,0
1668075961630,DSE 201,A00,096914,Deutsch; Alin Bernard,30,0,30,0
1668075962058,DSE 210,A00,096915,Dasgupta; Sanjoy,30,0,30,0
1668075962483,DSE 260A,A00,096916,Altintas De Callaf; Ilkay,30,0,30,0
1668075962924,ECE 200,001,103586,Antipa; Nicholas A,9999,0,9999,0
1668075962924,ECE 200,002,103587,Atanasov; Nikolay A.,9999,0,9999,0
1668075962924,ECE 200,003,103588,Bharadia; Dinesh,9999,0,9999,0
1668075962924,ECE 200,004,103589,Cheng; Chung Kuan,9999,0,9999,0
1668075962924,ECE 200,005,103590,Cosman; Pamela C.,9999,0,9999,0
1668075962924,ECE 200,006,103591,Dayeh; Shadi Ahmad,9999,0,9999,0
1668075962924,ECE 200,007,103592,Fainman; Yeshaiahu,9999,0,9999,0
1668075962924,ECE 200,008,103593,Ford; Joseph Earl,9999,0,9999,0
1668075962924,ECE 200,009,103594,Franceschetti; Massimo,9999,0,9999,0
1668075962924,ECE 200,010,103595,Fullerton; Eric E,9999,0,9999,0
1668075962924,ECE 200,011,103596,Galton; Ian A,9999,0,9999,0
1668075962924,ECE 200,012,103597,Gilja; Vikash,9999,0,9999,0
1668075962924,ECE 200,013,103598,Hall; Drew A.,9999,0,9999,0
1668075962924,ECE 200,014,103599,Hsueh; Tzu-Chien,9999,0,9999,0
1668075962924,ECE 200,015,103600,Javidi; Tara,9999,0,9999,0
1668075962924,ECE 200,016,103601,Kahng; Andrew Byun,9999,0,9999,0
1668075962924,ECE 200,017,103602,Kim; Young-Han,9999,0,9999,0
1668075962924,ECE 200,018,103603,Koushanfar; Farinaz,9999,0,9999,0
1668075962924,ECE 200,019,103604,Kuzum; Duygu,9999,0,9999,0
1668075962924,ECE 200,020,103605,Le; Hanh-Phuc,9999,0,9999,0
1668075962924,ECE 200,021,103606,Lin; Bill,9999,0,9999,0
1668075962924,ECE 200,022,103607,Liu; Zhaowei,9998,0,9999,1
1668075962924,ECE 200,023,103608,Lo; Yu-Hwa,9999,0,9999,0
1668075962924,ECE 200,024,103609,Lomakin; Vitaliy,9999,0,9999,0
1668075962924,ECE 200,025,103610,Mercier; Patrick Philip,9999,0,9999,0
1668075962924,ECE 200,026,103611,Meyer; Florian,9999,0,9999,0
1668075962924,ECE 200,027,103612,Milstein; Laurence B.,9999,0,9999,0
1668075962924,ECE 200,028,103613,Mir Arabbaygi; Siavash,9999,0,9999,0
1668075962924,ECE 200,029,103614,Mookherjea; Shayan,9999,0,9999,0
1668075962924,ECE 200,030,103615,Morris; Karcher William,9999,0,9999,0
1668075962924,ECE 200,031,103616,Ng; Tse Nga,9999,0,9999,0
1668075962924,ECE 200,032,103617,Nguyen; Truong Quang,9999,0,9999,0
1668075962924,ECE 200,033,103618,Nomura; Kenji,9999,0,9999,0
1668075962924,ECE 200,034,103619,Orlitsky; Alon,9999,0,9999,0
1668075962924,ECE 200,035,103620,Pal; Piya,9999,0,9999,0
1668075962924,ECE 200,036,103621,Papen; George C.,9999,0,9999,0
1668075962924,ECE 200,037,103622,Radic; Stojan,9999,0,9999,0
1668075962924,ECE 200,038,103623,Rao; Bhaskar D.,9999,0,9999,0
1668075962924,ECE 200,039,103624,Rao; Ramesh R,9999,0,9999,0
1668075962924,ECE 200,040,103625,Rebeiz; Gabriel,9999,0,9999,0
1668075962924,ECE 200,041,103626,Sanford; John R,9999,0,9999,0
1668075962924,ECE 200,042,103627,Siegel; Paul H.,9999,0,9999,0
1668075962924,ECE 200,043,103628,Sievenpiper; Daniel F.,9999,0,9999,0
1668075962924,ECE 200,044,103629,Sworder; David D.,9999,0,9999,0
1668075962924,ECE 200,045,103630,Taur; Yuan,9999,0,9999,0
1668075962924,ECE 200,046,103631,Touri; Behrouz,9999,0,9999,0
1668075962924,ECE 200,047,103632,Trivedi; Mohan M.,9999,0,9999,0
1668075962924,ECE 200,048,103633,Vasconcelos; Nuno,9999,0,9999,0
1668075962924,ECE 200,049,103634,Wang; Xiaolong,9999,0,9999,0
1668075962924,ECE 200,050,103635,Xie; Pengtao,9999,0,9999,0
1668075962924,ECE 200,051,103636,Yip; Michael,9999,0,9999,0
1668075962924,ECE 200,052,103637,Zeger; Kenneth A.,999,0,999,0
1668075962924,ECE 200,053,103638,Zhang; Xinyu,9999,0,9999,0
1668075962924,ECE 200,054,103639,Turakhia; Yatish Girish,9999,0,9999,0
1668075962924,ECE 200,055,103640,Kang; Mingu,9999,0,9999,0
1668075962924,ECE 200,056,103641,Shi; Yuanyuan,9999,0,9999,0
1668075962924,ECE 200,057,103642,Wang; Edward Jay,9999,0,9999,0
1668075962924,ECE 200,058,103643,Zheng; Yang,9999,0,9999,0
1668075963350,ECE 202,A00,103644,Kuzum; Duygu,0,0,0,0
1668075963774,ECE 212BN,A00,103646,Ng; Tse Nga,0,0,0,0
1668075964199,ECE 221,A00,111493,Staff,0,0,0,0
1668075964622,ECE 222B,A00,103647,Lomakin; Vitaliy,0,0,0,0
1668075965050,ECE 230B,A00,103648,Taur; Yuan,0,0,0,0
1668075965472,ECE 238B,A00,103649,Garay; Javier,0,0,0,0
1668075965900,ECE 240B,A00,112900,Fainman; Yeshaiahu,0,0,0,0
1668075966323,ECE 247A,A00,103650,Jokerst; Jesse Vincent,0,0,0,0
1668075966748,ECE 247B,A00,103651,Wang; Joseph,0,0,0,0
1668075967171,ECE 250,A00,103652,Siegel; Paul H.,0,0,0,0
1668075967594,ECE 251A,A00,103654,Rao; Bhaskar D.,0,0,0,0
1668075968023,ECE 257B,A00,103655,Bharadia; Dinesh,0,0,0,0
1668075968447,ECE 258A,A00,103656,Milstein; Laurence B.,0,0,0,0
1668075968874,ECE 260B,A00,103658,Kang; Mingu,0,0,0,0
1668075969299,ECE 264A,A00,103659,Galton; Ian A,0,0,0,0
1668075969724,ECE 265A,A00,103661,Gudem; Prasad S.S.,0,0,0,0
1668075970149,ECE 265D,A00,103662,Gudem; Prasad S.S.,0,0,0,0
1668075970576,ECE 268,A00,103663,Koushanfar; Farinaz,0,0,0,0
1668075971007,ECE 269,A01,103665,Pal; Piya,0,0,0,0
1668075971434,ECE 271B,A00,103666,Vasconcelos; Manuela,0,0,0,0
1668075971859,ECE 276A,A00,103667,Atanasov; Nikolay A.,0,0,0,0
1668075972285,ECE 277,A00,103668,An; Cheolhong,0,0,0,0
1668075972712,ECE 279,A00,117947,Hall; Drew A.,0,0,0,0
1668075973637,ECE 283,A00,103670,Hsueh; Tzu-Chien,0,0,0,0
1668075974059,ECE 284,A00,103671,Turakhia; Yatish Girish,0,0,0,0
1668075974483,ECE 285,A00,103672,Zheng; Yang,0,0,0,0
1668075974483,ECE 285,B00,103673,Sworder; David D.,0,0,0,0
1668075974908,ECE 287,A00,103676,Javidi; Tara,0,0,0,0
1668075975333,MATH 200B,A00,098023,Salehi Golsefidy; Alireza,13,0,15,2
1668075975756,MATH 202B,A00,098024,Rhoades; Brendon Patrick,9,0,15,6
1668075976182,MATH 203B,A00,098025,Oprea; Dragos N.,10,0,15,5
1668075976608,MATH 204B,A00,098026,Sorensen; Claus M,13,0,15,2
1668075977032,MATH 208,A00,098027,Izadi; Elham,7,0,10,3
1668075977455,MATH 209,A00,098028,Pollack; Aaron,10,0,10,0
1668075977878,MATH 211A,A00,112919,Rogalski; Daniel,9,0,10,1
1668075978305,MATH 211B,A00,112920,Seward; Brandon M.,9,0,10,1
1668075978730,MATH 218,A00,098029,Li; Bo,10,0,10,0
1668075979157,MATH 220B,A00,098030,Novak; Jonathan I,12,0,15,3
1668075979584,MATH 221A,A00,098031,Ebenfelt; Peter F,13,0,15,2
1668075980012,MATH 231B,A00,098032,Zlatos; Andrej,12,0,15,3
1668075980437,MATH 240B,A00,098033,Ni; Lei,9,0,15,6
1668075980866,MATH 243,A00,098034,Jekel; David Andrew,10,0,10,0
1668075981295,MATH 245A,A00,098035,Nie; Jiawang,0,0,15,16
1668075981724,MATH 248,A00,098036,Bejenaru; Ioan,10,0,10,0
1668075982147,MATH 250B,A00,098037,Spolaor; Luca,14,0,15,1
1668075982571,MATH 258,A00,098038,Ni; Lei,10,0,10,0
1668075982994,MATH 264B,A00,098041,Rhoades; Brendon Patrick,10,0,15,5
1668075983417,MATH 268,A00,098042,Buss; Samuel R,10,0,10,0
1668075983842,MATH 269,A00,098043,Rhoades; Brendon Patrick,10,0,10,0
1668075984273,MATH 270B,A00,098044,Li; Bo,11,0,15,4
1668075984699,MATH 272B,A00,098045,Holst; Michael J,13,0,15,2
1668075985124,MATH 273A,A00,098046,Tian; Xiaochuan,10,0,15,5
1668075985550,MATH 275,A01,098048,Tian; Xiaochuan,6,0,10,4
1668075985975,MATH 278A,A00,098049,Holst; Michael J,8,0,10,2
1668075986398,MATH 278B,A00,098050,Cloninger; Alexander,10,0,10,0
1668075986824,MATH 278C,A00,098051,Nie; Jiawang,7,0,10,3
1668075987252,MATH 280B,A00,098052,Zheng; Tianyi,10,0,15,5
1668075987679,MATH 281B,A00,098053,Bradic; Jelena,3,0,15,12
1668075988103,MATH 282B,A00,098054,Arias-Castro; Ery,0,0,15,15
1668075988530,MATH 285,A00,098055,Fitzsimmons; Patrick J,0,0,15,17
1668075988956,MATH 287B,A00,098056,Arias-Castro; Ery,3,0,15,12
1668075989381,MATH 288,A00,098057,Agarwal; Pooja,9,0,10,1
1668075989381,MATH 288,B00,098058,Zhang; Danna,8,0,10,2
1668075989381,MATH 288,C00,098059,Williams; Ruth J,10,0,10,0
1668075989805,MATH 290B,A00,098060,Roberts; Justin Deritter,13,0,15,2
1668075990232,MATH 292,A00,098061,Belmont; Eva Kinoshita,10,0,10,0
1668075990654,MATH 295,A00,098062,Suk; Andrew Hoon,48,0,50,2
1668075991080,MATH 296,A00,098063,Novak; Jonathan I,20,0,20,0
1668075991504,MATH 297,001,098064,Gamst; Anthony Collins,9997,0,9999,2
1668076496663,COGS 205,A00,101395,Chiba; Andrea,19,0,20,1
1668076497094,COGS 210B,001,101404,Greene; Deanna Jacquelyn,9998,0,9999,1
1668076497094,COGS 210B,002,101417,Xia; Haijun,9999,0,9999,0
1668076497094,COGS 210B,003,101422,Nitz; Douglas A.,9999,0,9999,0
1668076497094,COGS 210B,004,101423,Hollan; James D.,9998,0,9999,1
1668076497094,COGS 210B,005,101424,Deak; Gedeon O.,9998,0,9999,1
1668076497094,COGS 210B,006,101425,Rossano; Federico,9999,0,9999,0
1668076497521,COGS 211B,A00,101427,Coulson; Seana M,9996,0,9999,3
1668076497948,COGS 220,A00,101428,Hollan; James D.,0,0,25,25
1668076498373,COGS 229,A00,101429,Dow; Steven P,18,0,25,7
1668076498877,COGS 230,A00,101430,Klemmer; Scott R,13,0,17,4
1668076499302,COGS 234,A00,101431,Xia; Haijun,3,0,25,22
1668076499733,COGS 260,A00,101432,Kiyonaga; Anastasia,19,0,25,6
1668076499733,COGS 260,B00,101433,Kirsh; David Joel,16,0,25,9
1668076500163,CSE 202,A00,102371,Impagliazzo; Russell,0,0,0,0
1668076500593,CSE 203B,A01,102373,Cheng; Chung Kuan,0,0,0,0
1668076501018,CSE 208,A00,102374,Micciancio; Daniele,0,0,0,0
1668076501443,CSE 209A,A00,112895,Impagliazzo; Russell,0,0,15,15
1668076501873,CSE 209B,A00,108005,Bellare; Mihir,0,0,0,0
1668076502300,CSE 210,A00,113163,Coblenz; Michael J,0,0,0,0
1668076502734,CSE 219,A00,106111,Dow; Steven P,0,0,20,20
1668076503170,CSE 221,A00,102376,Voelker; Geoffrey M.,0,0,0,0
1668076503597,CSE 224,A01,102378,Porter; George M,0,0,0,0
1668076504026,CSE 229A,A00,102379,Savage; Stefan,0,0,0,0
1668076504452,CSE 229C,A00,102380,Munyaka; Imani N. S.,0,0,0,0
1668076504877,CSE 232B,A00,102382,Deutsch; Alin Bernard,0,0,0,0
1668076505308,CSE 234,A01,112904,Kumar; Arun Kumar,0,0,0,0
1668076505736,CSE 237A,A00,102383,Rosing; Tajana Simunic,0,0,0,0
1668076506163,CSE 239A,A00,102384,Deutsch; Alin Bernard,0,0,0,0
1668076506587,CSE 239B,A00,102385,Polikarpova; Nadezhda,0,0,0,0
1668076507029,CSE 240A,A00,102386,Pannuto; Patrick William,0,0,0,0
1668076507457,CSE 240B,A00,102387,Zhao; Jishen,0,0,0,0
1668076507883,CSE 241A,A00,106406,Kang; Mingu,0,0,0,0
1668076508311,CSE 249B,A00,102388,Kahng; Andrew Byun,0,0,8,8
1668076508736,CSE 251B,A01,102392,Cottrell; Garrison W,0,0,0,0
1668076508736,CSE 251B,A02,102393,Cottrell; Garrison W,0,0,0,0
1668076509167,CSE 252B,A00,102394,Ochoa; Benjamin Lawrence,0,0,0,0
1668076509592,CSE 257,A01,102396,Gao; Sicun,0,0,0,0
1668076510022,CSE 272,A00,102397,Li; Tzumao,0,0,0,0
1668076510445,CSE 274,A00,111323,Chern; Albert Ren-Haur,0,0,0,0
1668076510873,CSE 282,A00,102398,Pevzner; Pavel Arkadjevich,0,0,0,0
1668076511299,CSE 284,A00,114175,Gymrek; Melissa Ann,0,0,0,0
1668076511735,CSE 290,A00,102399,Chandraker; Manmohan Krishna,0,0,0,0
1668076511735,CSE 290,B00,102400,Vaccaro; Kristen Marie,0,0,25,25
1668076511735,CSE 290,C00,102414,Pannuto; Patrick William,0,0,25,25
1668076511735,CSE 290,D00,102427,Pevzner; Pavel Arkadjevich,0,0,0,0
1668076511735,CSE 290,E00,102429,Zhao; Jishen,0,0,0,0
1668076511735,CSE 290,F00,102436,Tullsen; Dean Michael,0,0,0,0
1668076511735,CSE 290,G00,102440,Christensen; Henrik I,0,0,20,20
1668076512173,CSE 291,A00,102443,Su; Hao,0,0,0,0
1668076512173,CSE 291,B00,102448,Polikarpova; Nadezhda,0,0,0,0
1668076512173,CSE 291,C00,102453,Vaccaro; Kristen Marie,0,0,0,0
1668076512173,CSE 291,D00,111343,Savage; Stefan,0,0,0,0
1668076512173,CSE 291,E00,116474,Claffy; Kimberly Claire,0,0,0,0
1668076512173,CSE 291,F00,116479,Pasquale; Joseph,0,0,0,0
1668076512644,CSE 293,001,119111,Bafna; Vineet,9999,0,9999,0
1668076512644,CSE 293,002,119118,Bellare; Mihir,9999,0,9999,0
1668076512644,CSE 293,003,119122,Berg-Kirkpatrick; Taylor D,9999,0,9999,0
1668076512644,CSE 293,004,119135,Christensen; Henrik I,9999,0,9999,0
1668076512644,CSE 293,005,119142,Cottrell; Garrison W,9999,0,9999,0
1668076512644,CSE 293,006,119146,Deutsch; Alin Bernard,9999,0,9999,0
1668076512644,CSE 293,007,119159,Esmaeilzadeh; Hadi,9999,0,9999,0
1668076512644,CSE 293,008,119166,Freund; Yoav,9999,0,9999,0
1668076512644,CSE 293,009,119170,Griswold; William G.,9999,0,9999,0
1668076512644,CSE 293,010,119183,Gymrek; Melissa Ann,9999,0,9999,0
1668076512644,CSE 293,011,119190,Heninger; Nadia A,9999,0,9999,0
1668076512644,CSE 293,012,119230,Impagliazzo; Russell,9999,0,9999,0
1668076512644,CSE 293,013,119232,Jhala; Ranjit,9999,0,9999,0
1668076512644,CSE 293,014,119233,Kahng; Andrew Byun,9999,0,9999,0
1668076512644,CSE 293,015,119298,Kane; Daniel Mertz,9999,0,9999,0
1668076512644,CSE 293,016,119299,Kriegman; David J,9999,0,9999,0
1668076512644,CSE 293,017,119300,Kumar; Arun Kumar,9999,0,9999,0
1668076512644,CSE 293,018,119301,Lerner; Sorin,9999,0,9999,0
1668076512644,CSE 293,019,119302,Lovett; Shachar,9999,0,9999,0
1668076512644,CSE 293,020,119303,McAuley; Julian John,9999,0,9999,0
1668076512644,CSE 293,021,119304,Micciancio; Daniele,9999,0,9999,0
1668076512644,CSE 293,022,119367,Orailoglu; Alex,9999,0,9999,0
1668076512644,CSE 293,023,119382,Paturi; Ramamohan,9999,0,9999,0
1668076512644,CSE 293,024,119404,Polikarpova; Nadezhda,9999,0,9999,0
1668076512644,CSE 293,025,119406,Politz; Joseph Gibbs,9999,0,9999,0
1668076512644,CSE 293,026,119411,Porter; George M,9999,0,9999,0
1668076512644,CSE 293,027,119414,Porter; Leonard Emerson,9999,0,9999,0
1668076512644,CSE 293,028,119416,Ramamoorthi; Ravi,9999,0,9999,0
1668076512644,CSE 293,029,119417,Sahoo; Debashis,9999,0,9999,0
1668076512644,CSE 293,030,119420,Saul; Lawrence,9999,0,9999,0
1668076512644,CSE 293,031,119421,Savage; Stefan,9999,0,9999,0
1668076512644,CSE 293,032,119425,Schulze; Jurgen P.,9999,0,9999,0
1668076512644,CSE 293,033,119426,Snoeren; Alex C.,9999,0,9999,0
1668076512644,CSE 293,034,119428,Shang; Jingbo,9999,0,9999,0
1668076512644,CSE 293,035,119430,Stefan; Deian,9999,0,9999,0
1668076512644,CSE 293,036,119431,Su; Hao,9999,0,9999,0
1668076512644,CSE 293,037,119433,Swanson; Steven James,9999,0,9999,0
1668076512644,CSE 293,038,119435,Tullsen; Dean Michael,9999,0,9999,0
1668076512644,CSE 293,039,119483,Voelker; Geoffrey M.,9999,0,9999,0
1668076512644,CSE 293,040,119537,Zhao; Jishen,9999,0,9999,0
1668076512644,CSE 293,041,119538,Zhou; Yuan-Yuan,9999,0,9999,0
1668076512644,CSE 293,042,119539,Gao; Sicun,9999,0,9999,0
1668076512644,CSE 293,043,119540,Weibel; Nadir,9999,0,9999,0
1668076512644,CSE 293,044,119541,Gupta; Rajesh K.,9999,0,9999,0
1668076512644,CSE 293,045,126410,Vaccaro; Kristen Marie,9999,0,9999,0
1668076512644,CSE 293,046,126411,Klemke; Richard,9999,0,9999,0
1668076513073,CSE 294,A00,102459,Voelker; Geoffrey M.,0,0,0,0
1668076513073,CSE 294,B00,111322,Orailoglu; Alex,0,0,0,0
1668076513504,DSE 201,A00,096914,Deutsch; Alin Bernard,30,0,30,0
1668076513932,DSE 210,A00,096915,Dasgupta; Sanjoy,30,0,30,0
1668076514358,DSE 260A,A00,096916,Altintas De Callaf; Ilkay,30,0,30,0
1668076514809,ECE 200,001,103586,Antipa; Nicholas A,9999,0,9999,0
1668076514809,ECE 200,002,103587,Atanasov; Nikolay A.,9999,0,9999,0
1668076514809,ECE 200,003,103588,Bharadia; Dinesh,9999,0,9999,0
1668076514809,ECE 200,004,103589,Cheng; Chung Kuan,9999,0,9999,0
1668076514809,ECE 200,005,103590,Cosman; Pamela C.,9999,0,9999,0
1668076514809,ECE 200,006,103591,Dayeh; Shadi Ahmad,9999,0,9999,0
1668076514809,ECE 200,007,103592,Fainman; Yeshaiahu,9999,0,9999,0
1668076514809,ECE 200,008,103593,Ford; Joseph Earl,9999,0,9999,0
1668076514809,ECE 200,009,103594,Franceschetti; Massimo,9999,0,9999,0
1668076514809,ECE 200,010,103595,Fullerton; Eric E,9999,0,9999,0
1668076514809,ECE 200,011,103596,Galton; Ian A,9999,0,9999,0
1668076514809,ECE 200,012,103597,Gilja; Vikash,9999,0,9999,0
1668076514809,ECE 200,013,103598,Hall; Drew A.,9999,0,9999,0
1668076514809,ECE 200,014,103599,Hsueh; Tzu-Chien,9999,0,9999,0
1668076514809,ECE 200,015,103600,Javidi; Tara,9999,0,9999,0
1668076514809,ECE 200,016,103601,Kahng; Andrew Byun,9999,0,9999,0
1668076514809,ECE 200,017,103602,Kim; Young-Han,9999,0,9999,0
1668076514809,ECE 200,018,103603,Koushanfar; Farinaz,9999,0,9999,0
1668076514809,ECE 200,019,103604,Kuzum; Duygu,9999,0,9999,0
1668076514809,ECE 200,020,103605,Le; Hanh-Phuc,9999,0,9999,0
1668076514809,ECE 200,021,103606,Lin; Bill,9999,0,9999,0
1668076514809,ECE 200,022,103607,Liu; Zhaowei,9998,0,9999,1
1668076514809,ECE 200,023,103608,Lo; Yu-Hwa,9999,0,9999,0
1668076514809,ECE 200,024,103609,Lomakin; Vitaliy,9999,0,9999,0
1668076514809,ECE 200,025,103610,Mercier; Patrick Philip,9999,0,9999,0
1668076514809,ECE 200,026,103611,Meyer; Florian,9999,0,9999,0
1668076514809,ECE 200,027,103612,Milstein; Laurence B.,9999,0,9999,0
1668076514809,ECE 200,028,103613,Mir Arabbaygi; Siavash,9999,0,9999,0
1668076514809,ECE 200,029,103614,Mookherjea; Shayan,9999,0,9999,0
1668076514809,ECE 200,030,103615,Morris; Karcher William,9999,0,9999,0
1668076514809,ECE 200,031,103616,Ng; Tse Nga,9999,0,9999,0
1668076514809,ECE 200,032,103617,Nguyen; Truong Quang,9999,0,9999,0
1668076514809,ECE 200,033,103618,Nomura; Kenji,9999,0,9999,0
1668076514809,ECE 200,034,103619,Orlitsky; Alon,9999,0,9999,0
1668076514809,ECE 200,035,103620,Pal; Piya,9999,0,9999,0
1668076514809,ECE 200,036,103621,Papen; George C.,9999,0,9999,0
1668076514809,ECE 200,037,103622,Radic; Stojan,9999,0,9999,0
1668076514809,ECE 200,038,103623,Rao; Bhaskar D.,9999,0,9999,0
1668076514809,ECE 200,039,103624,Rao; Ramesh R,9999,0,9999,0
1668076514809,ECE 200,040,103625,Rebeiz; Gabriel,9999,0,9999,0
1668076514809,ECE 200,041,103626,Sanford; John R,9999,0,9999,0
1668076514809,ECE 200,042,103627,Siegel; Paul H.,9999,0,9999,0
1668076514809,ECE 200,043,103628,Sievenpiper; Daniel F.,9999,0,9999,0
1668076514809,ECE 200,044,103629,Sworder; David D.,9999,0,9999,0
1668076514809,ECE 200,045,103630,Taur; Yuan,9999,0,9999,0
1668076514809,ECE 200,046,103631,Touri; Behrouz,9999,0,9999,0
1668076514809,ECE 200,047,103632,Trivedi; Mohan M.,9999,0,9999,0
1668076514809,ECE 200,048,103633,Vasconcelos; Nuno,9999,0,9999,0
1668076514809,ECE 200,049,103634,Wang; Xiaolong,9999,0,9999,0
1668076514809,ECE 200,050,103635,Xie; Pengtao,9999,0,9999,0
1668076514809,ECE 200,051,103636,Yip; Michael,9999,0,9999,0
1668076514809,ECE 200,052,103637,Zeger; Kenneth A.,999,0,999,0
1668076514809,ECE 200,053,103638,Zhang; Xinyu,9999,0,9999,0
1668076514809,ECE 200,054,103639,Turakhia; Yatish Girish,9999,0,9999,0
1668076514809,ECE 200,055,103640,Kang; Mingu,9999,0,9999,0
1668076514809,ECE 200,056,103641,Shi; Yuanyuan,9999,0,9999,0
1668076514809,ECE 200,057,103642,Wang; Edward Jay,9999,0,9999,0
1668076514809,ECE 200,058,103643,Zheng; Yang,9999,0,9999,0
1668076515236,ECE 202,A00,103644,Kuzum; Duygu,0,0,0,0
1668076515664,ECE 212BN,A00,103646,Ng; Tse Nga,0,0,0,0
1668076516090,ECE 221,A00,111493,Staff,0,0,0,0
1668076516515,ECE 222B,A00,103647,Lomakin; Vitaliy,0,0,0,0
1668076516939,ECE 230B,A00,103648,Taur; Yuan,0,0,0,0
1668076517369,ECE 238B,A00,103649,Garay; Javier,0,0,0,0
1668076517794,ECE 240B,A00,112900,Fainman; Yeshaiahu,0,0,0,0
1668076518220,ECE 247A,A00,103650,Jokerst; Jesse Vincent,0,0,0,0
1668076518643,ECE 247B,A00,103651,Wang; Joseph,0,0,0,0
1668076519068,ECE 250,A00,103652,Siegel; Paul H.,0,0,0,0
1668076519493,ECE 251A,A00,103654,Rao; Bhaskar D.,0,0,0,0
1668076519918,ECE 257B,A00,103655,Bharadia; Dinesh,0,0,0,0
1668076520346,ECE 258A,A00,103656,Milstein; Laurence B.,0,0,0,0
1668076520774,ECE 260B,A00,103658,Kang; Mingu,0,0,0,0
1668076521199,ECE 264A,A00,103659,Galton; Ian A,0,0,0,0
1668076521622,ECE 265A,A00,103661,Gudem; Prasad S.S.,0,0,0,0
1668076522045,ECE 265D,A00,103662,Gudem; Prasad S.S.,0,0,0,0
1668076522470,ECE 268,A00,103663,Koushanfar; Farinaz,0,0,0,0
1668076522894,ECE 269,A01,103665,Pal; Piya,0,0,0,0
1668076523321,ECE 271B,A00,103666,Vasconcelos; Manuela,0,0,0,0
1668076523745,ECE 276A,A00,103667,Atanasov; Nikolay A.,0,0,0,0
1668076524176,ECE 277,A00,103668,An; Cheolhong,0,0,0,0
1668076524598,ECE 279,A00,117947,Hall; Drew A.,0,0,0,0
1668076525461,ECE 283,A00,103670,Hsueh; Tzu-Chien,0,0,0,0
1668076525889,ECE 284,A00,103671,Turakhia; Yatish Girish,0,0,0,0
1668076526318,ECE 285,A00,103672,Zheng; Yang,0,0,0,0
1668076526318,ECE 285,B00,103673,Sworder; David D.,0,0,0,0
1668076526748,ECE 287,A00,103676,Javidi; Tara,0,0,0,0
1668076527177,MATH 200B,A00,098023,Salehi Golsefidy; Alireza,13,0,15,2
1668076527607,MATH 202B,A00,098024,Rhoades; Brendon Patrick,9,0,15,6
1668076528032,MATH 203B,A00,098025,Oprea; Dragos N.,10,0,15,5
1668076528469,MATH 204B,A00,098026,Sorensen; Claus M,13,0,15,2
1668076528893,MATH 208,A00,098027,Izadi; Elham,7,0,10,3
1668076529323,MATH 209,A00,098028,Pollack; Aaron,10,0,10,0
1668076529753,MATH 211A,A00,112919,Rogalski; Daniel,9,0,10,1
1668076530181,MATH 211B,A00,112920,Seward; Brandon M.,9,0,10,1
1668076530604,MATH 218,A00,098029,Li; Bo,10,0,10,0
1668076531031,MATH 220B,A00,098030,Novak; Jonathan I,12,0,15,3
1668076531461,MATH 221A,A00,098031,Ebenfelt; Peter F,13,0,15,2
1668076531886,MATH 231B,A00,098032,Zlatos; Andrej,12,0,15,3
1668076532321,MATH 240B,A00,098033,Ni; Lei,9,0,15,6
1668076532745,MATH 243,A00,098034,Jekel; David Andrew,10,0,10,0
1668076533169,MATH 245A,A00,098035,Nie; Jiawang,0,0,15,16
1668076533594,MATH 248,A00,098036,Bejenaru; Ioan,10,0,10,0
1668076534021,MATH 250B,A00,098037,Spolaor; Luca,14,0,15,1
1668076534445,MATH 258,A00,098038,Ni; Lei,10,0,10,0
1668076534871,MATH 264B,A00,098041,Rhoades; Brendon Patrick,10,0,15,5
1668076535295,MATH 268,A00,098042,Buss; Samuel R,10,0,10,0
1668076535720,MATH 269,A00,098043,Rhoades; Brendon Patrick,10,0,10,0
1668076536145,MATH 270B,A00,098044,Li; Bo,11,0,15,4
1668076536570,MATH 272B,A00,098045,Holst; Michael J,13,0,15,2
1668076536999,MATH 273A,A00,098046,Tian; Xiaochuan,10,0,15,5
1668076537425,MATH 275,A01,098048,Tian; Xiaochuan,6,0,10,4
1668076537848,MATH 278A,A00,098049,Holst; Michael J,8,0,10,2
1668076538277,MATH 278B,A00,098050,Cloninger; Alexander,10,0,10,0
1668076538710,MATH 278C,A00,098051,Nie; Jiawang,7,0,10,3
1668076539145,MATH 280B,A00,098052,Zheng; Tianyi,10,0,15,5
1668076539573,MATH 281B,A00,098053,Bradic; Jelena,3,0,15,12
1668076540001,MATH 282B,A00,098054,Arias-Castro; Ery,0,0,15,15
1668076540428,MATH 285,A00,098055,Fitzsimmons; Patrick J,0,0,15,17
1668076540853,MATH 287B,A00,098056,Arias-Castro; Ery,3,0,15,12
1668076541279,MATH 288,A00,098057,Agarwal; Pooja,9,0,10,1
1668076541279,MATH 288,B00,098058,Zhang; Danna,8,0,10,2
1668076541279,MATH 288,C00,098059,Williams; Ruth J,10,0,10,0
1668076541704,MATH 290B,A00,098060,Roberts; Justin Deritter,13,0,15,2
1668076542223,MATH 292,A00,098061,Belmont; Eva Kinoshita,10,0,10,0
1668076542649,MATH 295,A00,098062,Suk; Andrew Hoon,48,0,50,2
1668076543073,MATH 296,A00,098063,Novak; Jonathan I,20,0,20,0
1668076543505,MATH 297,001,098064,Gamst; Anthony Collins,9997,0,9999,2
1668077045175,COGS 205,A00,101395,Chiba; Andrea,19,0,20,1
1668077045614,COGS 210B,001,101404,Greene; Deanna Jacquelyn,9998,0,9999,1
1668077045614,COGS 210B,002,101417,Xia; Haijun,9999,0,9999,0
1668077045614,COGS 210B,003,101422,Nitz; Douglas A.,9999,0,9999,0
1668077045614,COGS 210B,004,101423,Hollan; James D.,9998,0,9999,1
1668077045614,COGS 210B,005,101424,Deak; Gedeon O.,9998,0,9999,1
1668077045614,COGS 210B,006,101425,Rossano; Federico,9999,0,9999,0
1668077046042,COGS 211B,A00,101427,Coulson; Seana M,9996,0,9999,3
1668077046469,COGS 220,A00,101428,Hollan; James D.,0,0,25,25
1668077046895,COGS 229,A00,101429,Dow; Steven P,18,0,25,7
1668077047321,COGS 230,A00,101430,Klemmer; Scott R,13,0,17,4
1668077047751,COGS 234,A00,101431,Xia; Haijun,3,0,25,22
1668077048178,COGS 260,A00,101432,Kiyonaga; Anastasia,19,0,25,6
1668077048178,COGS 260,B00,101433,Kirsh; David Joel,16,0,25,9
1668077048604,CSE 202,A00,102371,Impagliazzo; Russell,0,0,0,0
1668077049028,CSE 203B,A01,102373,Cheng; Chung Kuan,0,0,0,0
1668077049460,CSE 208,A00,102374,Micciancio; Daniele,0,0,0,0
1668077049887,CSE 209A,A00,112895,Impagliazzo; Russell,0,0,15,15
1668077050312,CSE 209B,A00,108005,Bellare; Mihir,0,0,0,0
1668077050743,CSE 210,A00,113163,Coblenz; Michael J,0,0,0,0
1668077051193,CSE 219,A00,106111,Dow; Steven P,0,0,20,20
1668077051618,CSE 221,A00,102376,Voelker; Geoffrey M.,0,0,0,0
1668077052042,CSE 224,A01,102378,Porter; George M,0,0,0,0
1668077052473,CSE 229A,A00,102379,Savage; Stefan,0,0,0,0
1668077052900,CSE 229C,A00,102380,Munyaka; Imani N. S.,0,0,0,0
1668077053329,CSE 232B,A00,102382,Deutsch; Alin Bernard,0,0,0,0
1668077053755,CSE 234,A01,112904,Kumar; Arun Kumar,0,0,0,0
1668077054182,CSE 237A,A00,102383,Rosing; Tajana Simunic,0,0,0,0
1668077054613,CSE 239A,A00,102384,Deutsch; Alin Bernard,0,0,0,0
1668077055040,CSE 239B,A00,102385,Polikarpova; Nadezhda,0,0,0,0
1668077055463,CSE 240A,A00,102386,Pannuto; Patrick William,0,0,0,0
1668077055887,CSE 240B,A00,102387,Zhao; Jishen,0,0,0,0
1668077056313,CSE 241A,A00,106406,Kang; Mingu,0,0,0,0
1668077056740,CSE 249B,A00,102388,Kahng; Andrew Byun,0,0,8,8
1668077057165,CSE 251B,A01,102392,Cottrell; Garrison W,0,0,0,0
1668077057165,CSE 251B,A02,102393,Cottrell; Garrison W,0,0,0,0
1668077057590,CSE 252B,A00,102394,Ochoa; Benjamin Lawrence,0,0,0,0
1668077058016,CSE 257,A01,102396,Gao; Sicun,0,0,0,0
1668077058440,CSE 272,A00,102397,Li; Tzumao,0,0,0,0
1668077058864,CSE 274,A00,111323,Chern; Albert Ren-Haur,0,0,0,0
1668077059294,CSE 282,A00,102398,Pevzner; Pavel Arkadjevich,0,0,0,0
1668077059727,CSE 284,A00,114175,Gymrek; Melissa Ann,0,0,0,0
1668077060157,CSE 290,A00,102399,Chandraker; Manmohan Krishna,0,0,0,0
1668077060157,CSE 290,B00,102400,Vaccaro; Kristen Marie,0,0,25,25
1668077060157,CSE 290,C00,102414,Pannuto; Patrick William,0,0,25,25
1668077060157,CSE 290,D00,102427,Pevzner; Pavel Arkadjevich,0,0,0,0
1668077060157,CSE 290,E00,102429,Zhao; Jishen,0,0,0,0
1668077060157,CSE 290,F00,102436,Tullsen; Dean Michael,0,0,0,0
1668077060157,CSE 290,G00,102440,Christensen; Henrik I,0,0,20,20
1668077060583,CSE 291,A00,102443,Su; Hao,0,0,0,0
1668077060583,CSE 291,B00,102448,Polikarpova; Nadezhda,0,0,0,0
1668077060583,CSE 291,C00,102453,Vaccaro; Kristen Marie,0,0,0,0
1668077060583,CSE 291,D00,111343,Savage; Stefan,0,0,0,0
1668077060583,CSE 291,E00,116474,Claffy; Kimberly Claire,0,0,0,0
1668077060583,CSE 291,F00,116479,Pasquale; Joseph,0,0,0,0
1668077061018,CSE 293,001,119111,Bafna; Vineet,9999,0,9999,0
1668077061018,CSE 293,002,119118,Bellare; Mihir,9999,0,9999,0
1668077061018,CSE 293,003,119122,Berg-Kirkpatrick; Taylor D,9999,0,9999,0
1668077061018,CSE 293,004,119135,Christensen; Henrik I,9999,0,9999,0
1668077061018,CSE 293,005,119142,Cottrell; Garrison W,9999,0,9999,0
1668077061018,CSE 293,006,119146,Deutsch; Alin Bernard,9999,0,9999,0
1668077061018,CSE 293,007,119159,Esmaeilzadeh; Hadi,9999,0,9999,0
1668077061018,CSE 293,008,119166,Freund; Yoav,9999,0,9999,0
1668077061018,CSE 293,009,119170,Griswold; William G.,9999,0,9999,0
1668077061018,CSE 293,010,119183,Gymrek; Melissa Ann,9999,0,9999,0
1668077061018,CSE 293,011,119190,Heninger; Nadia A,9999,0,9999,0
1668077061018,CSE 293,012,119230,Impagliazzo; Russell,9999,0,9999,0
1668077061018,CSE 293,013,119232,Jhala; Ranjit,9999,0,9999,0
1668077061018,CSE 293,014,119233,Kahng; Andrew Byun,9999,0,9999,0
1668077061018,CSE 293,015,119298,Kane; Daniel Mertz,9999,0,9999,0
1668077061018,CSE 293,016,119299,Kriegman; David J,9999,0,9999,0
1668077061018,CSE 293,017,119300,Kumar; Arun Kumar,9999,0,9999,0
1668077061018,CSE 293,018,119301,Lerner; Sorin,9999,0,9999,0
1668077061018,CSE 293,019,119302,Lovett; Shachar,9999,0,9999,0
1668077061018,CSE 293,020,119303,McAuley; Julian John,9999,0,9999,0
1668077061018,CSE 293,021,119304,Micciancio; Daniele,9999,0,9999,0
1668077061018,CSE 293,022,119367,Orailoglu; Alex,9999,0,9999,0
1668077061018,CSE 293,023,119382,Paturi; Ramamohan,9999,0,9999,0
1668077061018,CSE 293,024,119404,Polikarpova; Nadezhda,9999,0,9999,0
1668077061018,CSE 293,025,119406,Politz; Joseph Gibbs,9999,0,9999,0
1668077061018,CSE 293,026,119411,Porter; George M,9999,0,9999,0
1668077061018,CSE 293,027,119414,Porter; Leonard Emerson,9999,0,9999,0
1668077061018,CSE 293,028,119416,Ramamoorthi; Ravi,9999,0,9999,0
1668077061018,CSE 293,029,119417,Sahoo; Debashis,9999,0,9999,0
1668077061018,CSE 293,030,119420,Saul; Lawrence,9999,0,9999,0
1668077061018,CSE 293,031,119421,Savage; Stefan,9999,0,9999,0
1668077061018,CSE 293,032,119425,Schulze; Jurgen P.,9999,0,9999,0
1668077061018,CSE 293,033,119426,Snoeren; Alex C.,9999,0,9999,0
1668077061018,CSE 293,034,119428,Shang; Jingbo,9999,0,9999,0
1668077061018,CSE 293,035,119430,Stefan; Deian,9999,0,9999,0
1668077061018,CSE 293,036,119431,Su; Hao,9999,0,9999,0
1668077061018,CSE 293,037,119433,Swanson; Steven James,9999,0,9999,0
1668077061018,CSE 293,038,119435,Tullsen; Dean Michael,9999,0,9999,0
1668077061018,CSE 293,039,119483,Voelker; Geoffrey M.,9999,0,9999,0
1668077061018,CSE 293,040,119537,Zhao; Jishen,9999,0,9999,0
1668077061018,CSE 293,041,119538,Zhou; Yuan-Yuan,9999,0,9999,0
1668077061018,CSE 293,042,119539,Gao; Sicun,9999,0,9999,0
1668077061018,CSE 293,043,119540,Weibel; Nadir,9999,0,9999,0
1668077061018,CSE 293,044,119541,Gupta; Rajesh K.,9999,0,9999,0
1668077061018,CSE 293,045,126410,Vaccaro; Kristen Marie,9999,0,9999,0
1668077061018,CSE 293,046,126411,Klemke; Richard,9999,0,9999,0
1668077061442,CSE 294,A00,102459,Voelker; Geoffrey M.,0,0,0,0
1668077061442,CSE 294,B00,111322,Orailoglu; Alex,0,0,0,0
1668077061869,DSE 201,A00,096914,Deutsch; Alin Bernard,30,0,30,0
1668077062299,DSE 210,A00,096915,Dasgupta; Sanjoy,30,0,30,0
1668077062723,DSE 260A,A00,096916,Altintas De Callaf; Ilkay,30,0,30,0
1668077063173,ECE 200,001,103586,Antipa; Nicholas A,9999,0,9999,0
1668077063173,ECE 200,002,103587,Atanasov; Nikolay A.,9999,0,9999,0
1668077063173,ECE 200,003,103588,Bharadia; Dinesh,9999,0,9999,0
1668077063173,ECE 200,004,103589,Cheng; Chung Kuan,9999,0,9999,0
1668077063173,ECE 200,005,103590,Cosman; Pamela C.,9999,0,9999,0
1668077063173,ECE 200,006,103591,Dayeh; Shadi Ahmad,9999,0,9999,0
1668077063173,ECE 200,007,103592,Fainman; Yeshaiahu,9999,0,9999,0
1668077063173,ECE 200,008,103593,Ford; Joseph Earl,9999,0,9999,0
1668077063173,ECE 200,009,103594,Franceschetti; Massimo,9999,0,9999,0
1668077063173,ECE 200,010,103595,Fullerton; Eric E,9999,0,9999,0
1668077063173,ECE 200,011,103596,Galton; Ian A,9999,0,9999,0
1668077063173,ECE 200,012,103597,Gilja; Vikash,9999,0,9999,0
1668077063173,ECE 200,013,103598,Hall; Drew A.,9999,0,9999,0
1668077063173,ECE 200,014,103599,Hsueh; Tzu-Chien,9999,0,9999,0
1668077063173,ECE 200,015,103600,Javidi; Tara,9999,0,9999,0
1668077063173,ECE 200,016,103601,Kahng; Andrew Byun,9999,0,9999,0
1668077063173,ECE 200,017,103602,Kim; Young-Han,9999,0,9999,0
1668077063173,ECE 200,018,103603,Koushanfar; Farinaz,9999,0,9999,0
1668077063173,ECE 200,019,103604,Kuzum; Duygu,9999,0,9999,0
1668077063173,ECE 200,020,103605,Le; Hanh-Phuc,9999,0,9999,0
1668077063173,ECE 200,021,103606,Lin; Bill,9999,0,9999,0
1668077063173,ECE 200,022,103607,Liu; Zhaowei,9998,0,9999,1
1668077063173,ECE 200,023,103608,Lo; Yu-Hwa,9999,0,9999,0
1668077063173,ECE 200,024,103609,Lomakin; Vitaliy,9999,0,9999,0
1668077063173,ECE 200,025,103610,Mercier; Patrick Philip,9999,0,9999,0
1668077063173,ECE 200,026,103611,Meyer; Florian,9999,0,9999,0
1668077063173,ECE 200,027,103612,Milstein; Laurence B.,9999,0,9999,0
1668077063173,ECE 200,028,103613,Mir Arabbaygi; Siavash,9999,0,9999,0
1668077063173,ECE 200,029,103614,Mookherjea; Shayan,9999,0,9999,0
1668077063173,ECE 200,030,103615,Morris; Karcher William,9999,0,9999,0
1668077063173,ECE 200,031,103616,Ng; Tse Nga,9999,0,9999,0
1668077063173,ECE 200,032,103617,Nguyen; Truong Quang,9999,0,9999,0
1668077063173,ECE 200,033,103618,Nomura; Kenji,9999,0,9999,0
1668077063173,ECE 200,034,103619,Orlitsky; Alon,9999,0,9999,0
1668077063173,ECE 200,035,103620,Pal; Piya,9999,0,9999,0
1668077063173,ECE 200,036,103621,Papen; George C.,9999,0,9999,0
1668077063173,ECE 200,037,103622,Radic; Stojan,9999,0,9999,0
1668077063173,ECE 200,038,103623,Rao; Bhaskar D.,9999,0,9999,0
1668077063173,ECE 200,039,103624,Rao; Ramesh R,9999,0,9999,0
1668077063173,ECE 200,040,103625,Rebeiz; Gabriel,9999,0,9999,0
1668077063173,ECE 200,041,103626,Sanford; John R,9999,0,9999,0
1668077063173,ECE 200,042,103627,Siegel; Paul H.,9999,0,9999,0
1668077063173,ECE 200,043,103628,Sievenpiper; Daniel F.,9999,0,9999,0
1668077063173,ECE 200,044,103629,Sworder; David D.,9999,0,9999,0
1668077063173,ECE 200,045,103630,Taur; Yuan,9999,0,9999,0
1668077063173,ECE 200,046,103631,Touri; Behrouz,9999,0,9999,0
1668077063173,ECE 200,047,103632,Trivedi; Mohan M.,9999,0,9999,0
1668077063173,ECE 200,048,103633,Vasconcelos; Nuno,9999,0,9999,0
1668077063173,ECE 200,049,103634,Wang; Xiaolong,9999,0,9999,0
1668077063173,ECE 200,050,103635,Xie; Pengtao,9999,0,9999,0
1668077063173,ECE 200,051,103636,Yip; Michael,9999,0,9999,0
1668077063173,ECE 200,052,103637,Zeger; Kenneth A.,999,0,999,0
1668077063173,ECE 200,053,103638,Zhang; Xinyu,9999,0,9999,0
1668077063173,ECE 200,054,103639,Turakhia; Yatish Girish,9999,0,9999,0
1668077063173,ECE 200,055,103640,Kang; Mingu,9999,0,9999,0
1668077063173,ECE 200,056,103641,Shi; Yuanyuan,9999,0,9999,0
1668077063173,ECE 200,057,103642,Wang; Edward Jay,9999,0,9999,0
1668077063173,ECE 200,058,103643,Zheng; Yang,9999,0,9999,0
1668077063597,ECE 202,A00,103644,Kuzum; Duygu,0,0,0,0
1668077064125,ECE 212BN,A00,103646,Ng; Tse Nga,0,0,0,0
1668077064549,ECE 221,A00,111493,Staff,0,0,0,0
1668077064973,ECE 222B,A00,103647,Lomakin; Vitaliy,0,0,0,0
1668077065398,ECE 230B,A00,103648,Taur; Yuan,0,0,0,0
1668077065823,ECE 238B,A00,103649,Garay; Javier,0,0,0,0
1668077066249,ECE 240B,A00,112900,Fainman; Yeshaiahu,0,0,0,0
1668077066679,ECE 247A,A00,103650,Jokerst; Jesse Vincent,0,0,0,0
1668077067104,ECE 247B,A00,103651,Wang; Joseph,0,0,0,0
1668077067526,ECE 250,A00,103652,Siegel; Paul H.,0,0,0,0
1668077067952,ECE 251A,A00,103654,Rao; Bhaskar D.,0,0,0,0
1668077068378,ECE 257B,A00,103655,Bharadia; Dinesh,0,0,0,0
1668077068807,ECE 258A,A00,103656,Milstein; Laurence B.,0,0,0,0
1668077069232,ECE 260B,A00,103658,Kang; Mingu,0,0,0,0
1668077069657,ECE 264A,A00,103659,Galton; Ian A,0,0,0,0
1668077070088,ECE 265A,A00,103661,Gudem; Prasad S.S.,0,0,0,0
1668077070512,ECE 265D,A00,103662,Gudem; Prasad S.S.,0,0,0,0
1668077070936,ECE 268,A00,103663,Koushanfar; Farinaz,0,0,0,0
1668077071363,ECE 269,A01,103665,Pal; Piya,0,0,0,0
1668077071793,ECE 271B,A00,103666,Vasconcelos; Manuela,0,0,0,0
1668077072217,ECE 276A,A00,103667,Atanasov; Nikolay A.,0,0,0,0
1668077072643,ECE 277,A00,103668,An; Cheolhong,0,0,0,0
1668077073069,ECE 279,A00,117947,Hall; Drew A.,0,0,0,0
1668077073921,ECE 283,A00,103670,Hsueh; Tzu-Chien,0,0,0,0
1668077074344,ECE 284,A00,103671,Turakhia; Yatish Girish,0,0,0,0
1668077074774,ECE 285,A00,103672,Zheng; Yang,0,0,0,0
1668077074774,ECE 285,B00,103673,Sworder; David D.,0,0,0,0
1668077075198,ECE 287,A00,103676,Javidi; Tara,0,0,0,0
1668077075628,MATH 200B,A00,098023,Salehi Golsefidy; Alireza,13,0,15,2
1668077076051,MATH 202B,A00,098024,Rhoades; Brendon Patrick,9,0,15,6
1668077076475,MATH 203B,A00,098025,Oprea; Dragos N.,10,0,15,5
1668077076901,MATH 204B,A00,098026,Sorensen; Claus M,13,0,15,2
1668077077326,MATH 208,A00,098027,Izadi; Elham,7,0,10,3
1668077077754,MATH 209,A00,098028,Pollack; Aaron,10,0,10,0
1668077078182,MATH 211A,A00,112919,Rogalski; Daniel,9,0,10,1
1668077078606,MATH 211B,A00,112920,Seward; Brandon M.,9,0,10,1
1668077079034,MATH 218,A00,098029,Li; Bo,10,0,10,0
1668077079463,MATH 220B,A00,098030,Novak; Jonathan I,12,0,15,3
1668077079893,MATH 221A,A00,098031,Ebenfelt; Peter F,13,0,15,2
1668077080320,MATH 231B,A00,098032,Zlatos; Andrej,12,0,15,3
1668077080744,MATH 240B,A00,098033,Ni; Lei,9,0,15,6
1668077081174,MATH 243,A00,098034,Jekel; David Andrew,10,0,10,0
1668077081605,MATH 245A,A00,098035,Nie; Jiawang,0,0,15,16
1668077082035,MATH 248,A00,098036,Bejenaru; Ioan,10,0,10,0
1668077082460,MATH 250B,A00,098037,Spolaor; Luca,14,0,15,1
1668077082888,MATH 258,A00,098038,Ni; Lei,10,0,10,0
1668077083313,MATH 264B,A00,098041,Rhoades; Brendon Patrick,10,0,15,5
1668077083738,MATH 268,A00,098042,Buss; Samuel R,10,0,10,0
1668077084164,MATH 269,A00,098043,Rhoades; Brendon Patrick,10,0,10,0
1668077084599,MATH 270B,A00,098044,Li; Bo,11,0,15,4
1668077085031,MATH 272B,A00,098045,Holst; Michael J,13,0,15,2
1668077085473,MATH 273A,A00,098046,Tian; Xiaochuan,10,0,15,5
1668077085899,MATH 275,A01,098048,Tian; Xiaochuan,6,0,10,4
1668077086322,MATH 278A,A00,098049,Holst; Michael J,8,0,10,2
1668077086744,MATH 278B,A00,098050,Cloninger; Alexander,10,0,10,0
1668077087170,MATH 278C,A00,098051,Nie; Jiawang,7,0,10,3
1668077087595,MATH 280B,A00,098052,Zheng; Tianyi,10,0,15,5
1668077088034,MATH 281B,A00,098053,Bradic; Jelena,3,0,15,12
1668077088457,MATH 282B,A00,098054,Arias-Castro; Ery,0,0,15,15
1668077088889,MATH 285,A00,098055,Fitzsimmons; Patrick J,0,0,15,17
1668077089312,MATH 287B,A00,098056,Arias-Castro; Ery,3,0,15,12
1668077089737,MATH 288,A00,098057,Agarwal; Pooja,9,0,10,1
1668077089737,MATH 288,B00,098058,Zhang; Danna,8,0,10,2
1668077089737,MATH 288,C00,098059,Williams; Ruth J,10,0,10,0
1668077090165,MATH 290B,A00,098060,Roberts; Justin Deritter,13,0,15,2
1668077090590,MATH 292,A00,098061,Belmont; Eva Kinoshita,10,0,10,0
1668077091016,MATH 295,A00,098062,Suk; Andrew Hoon,48,0,50,2
1668077091455,MATH 296,A00,098063,Novak; Jonathan I,20,0,20,0
1668077091881,MATH 297,001,098064,Gamst; Anthony Collins,9997,0,9999,2
1668077593368,COGS 205,A00,101395,Chiba; Andrea,19,0,20,1
1668077593800,COGS 210B,001,101404,Greene; Deanna Jacquelyn,9998,0,9999,1
1668077593800,COGS 210B,002,101417,Xia; Haijun,9999,0,9999,0
1668077593800,COGS 210B,003,101422,Nitz; Douglas A.,9999,0,9999,0
1668077593800,COGS 210B,004,101423,Hollan; James D.,9998,0,9999,1
1668077593800,COGS 210B,005,101424,Deak; Gedeon O.,9998,0,9999,1
1668077593800,COGS 210B,006,101425,Rossano; Federico,9999,0,9999,0
1668077594229,COGS 211B,A00,101427,Coulson; Seana M,9996,0,9999,3
1668077594652,COGS 220,A00,101428,Hollan; James D.,0,0,25,25
1668077595078,COGS 229,A00,101429,Dow; Steven P,18,0,25,7
1668077595509,COGS 230,A00,101430,Klemmer; Scott R,13,0,17,4
1668077595942,COGS 234,A00,101431,Xia; Haijun,3,0,25,22
1668077596374,COGS 260,A00,101432,Kiyonaga; Anastasia,19,0,25,6
1668077596374,COGS 260,B00,101433,Kirsh; David Joel,16,0,25,9
1668077596801,CSE 202,A00,102371,Impagliazzo; Russell,0,0,0,0
1668077597234,CSE 203B,A01,102373,Cheng; Chung Kuan,0,0,0,0
1668077597667,CSE 208,A00,102374,Micciancio; Daniele,0,0,0,0
1668077598096,CSE 209A,A00,112895,Impagliazzo; Russell,0,0,15,15
1668077598522,CSE 209B,A00,108005,Bellare; Mihir,0,0,0,0
1668077598947,CSE 210,A00,113163,Coblenz; Michael J,0,0,0,0
1668077599372,CSE 219,A00,106111,Dow; Steven P,0,0,20,20
1668077599812,CSE 221,A00,102376,Voelker; Geoffrey M.,0,0,0,0
1668077600239,CSE 224,A01,102378,Porter; George M,0,0,0,0
1668077600666,CSE 229A,A00,102379,Savage; Stefan,0,0,0,0
1668077601091,CSE 229C,A00,102380,Munyaka; Imani N. S.,0,0,0,0
1668077601515,CSE 232B,A00,102382,Deutsch; Alin Bernard,0,0,0,0
1668077601943,CSE 234,A01,112904,Kumar; Arun Kumar,0,0,0,0
1668077602368,CSE 237A,A00,102383,Rosing; Tajana Simunic,0,0,0,0
1668077602795,CSE 239A,A00,102384,Deutsch; Alin Bernard,0,0,0,0
1668077603219,CSE 239B,A00,102385,Polikarpova; Nadezhda,0,0,0,0
1668077603650,CSE 240A,A00,102386,Pannuto; Patrick William,0,0,0,0
1668077604073,CSE 240B,A00,102387,Zhao; Jishen,0,0,0,0
1668077604498,CSE 241A,A00,106406,Kang; Mingu,0,0,0,0
1668077604927,CSE 249B,A00,102388,Kahng; Andrew Byun,0,0,8,8
1668077605354,CSE 251B,A01,102392,Cottrell; Garrison W,0,0,0,0
1668077605354,CSE 251B,A02,102393,Cottrell; Garrison W,0,0,0,0
1668077605779,CSE 252B,A00,102394,Ochoa; Benjamin Lawrence,0,0,0,0
1668077606204,CSE 257,A01,102396,Gao; Sicun,0,0,0,0
1668077606630,CSE 272,A00,102397,Li; Tzumao,0,0,0,0
1668077607055,CSE 274,A00,111323,Chern; Albert Ren-Haur,0,0,0,0
1668077607478,CSE 282,A00,102398,Pevzner; Pavel Arkadjevich,0,0,0,0
1668077607904,CSE 284,A00,114175,Gymrek; Melissa Ann,0,0,0,0
1668077608333,CSE 290,A00,102399,Chandraker; Manmohan Krishna,0,0,0,0
1668077608333,CSE 290,B00,102400,Vaccaro; Kristen Marie,0,0,25,25
1668077608333,CSE 290,C00,102414,Pannuto; Patrick William,0,0,25,25
1668077608333,CSE 290,D00,102427,Pevzner; Pavel Arkadjevich,0,0,0,0
1668077608333,CSE 290,E00,102429,Zhao; Jishen,0,0,0,0
1668077608333,CSE 290,F00,102436,Tullsen; Dean Michael,0,0,0,0
1668077608333,CSE 290,G00,102440,Christensen; Henrik I,0,0,20,20
1668077608767,CSE 291,A00,102443,Su; Hao,0,0,0,0
1668077608767,CSE 291,B00,102448,Polikarpova; Nadezhda,0,0,0,0
1668077608767,CSE 291,C00,102453,Vaccaro; Kristen Marie,0,0,0,0
1668077608767,CSE 291,D00,111343,Savage; Stefan,0,0,0,0
1668077608767,CSE 291,E00,116474,Claffy; Kimberly Claire,0,0,0,0
1668077608767,CSE 291,F00,116479,Pasquale; Joseph,0,0,0,0
1668077609224,CSE 293,001,119111,Bafna; Vineet,9999,0,9999,0
1668077609224,CSE 293,002,119118,Bellare; Mihir,9999,0,9999,0
1668077609224,CSE 293,003,119122,Berg-Kirkpatrick; Taylor D,9999,0,9999,0
1668077609224,CSE 293,004,119135,Christensen; Henrik I,9999,0,9999,0
1668077609224,CSE 293,005,119142,Cottrell; Garrison W,9999,0,9999,0
1668077609224,CSE 293,006,119146,Deutsch; Alin Bernard,9999,0,9999,0
1668077609224,CSE 293,007,119159,Esmaeilzadeh; Hadi,9999,0,9999,0
1668077609224,CSE 293,008,119166,Freund; Yoav,9999,0,9999,0
1668077609224,CSE 293,009,119170,Griswold; William G.,9999,0,9999,0
1668077609224,CSE 293,010,119183,Gymrek; Melissa Ann,9999,0,9999,0
1668077609224,CSE 293,011,119190,Heninger; Nadia A,9999,0,9999,0
1668077609224,CSE 293,012,119230,Impagliazzo; Russell,9999,0,9999,0
1668077609224,CSE 293,013,119232,Jhala; Ranjit,9999,0,9999,0
1668077609224,CSE 293,014,119233,Kahng; Andrew Byun,9999,0,9999,0
1668077609224,CSE 293,015,119298,Kane; Daniel Mertz,9999,0,9999,0
1668077609224,CSE 293,016,119299,Kriegman; David J,9999,0,9999,0
1668077609224,CSE 293,017,119300,Kumar; Arun Kumar,9999,0,9999,0
1668077609224,CSE 293,018,119301,Lerner; Sorin,9999,0,9999,0
1668077609224,CSE 293,019,119302,Lovett; Shachar,9999,0,9999,0
1668077609224,CSE 293,020,119303,McAuley; Julian John,9999,0,9999,0
1668077609224,CSE 293,021,119304,Micciancio; Daniele,9999,0,9999,0
1668077609224,CSE 293,022,119367,Orailoglu; Alex,9999,0,9999,0
1668077609224,CSE 293,023,119382,Paturi; Ramamohan,9999,0,9999,0
1668077609224,CSE 293,024,119404,Polikarpova; Nadezhda,9999,0,9999,0
1668077609224,CSE 293,025,119406,Politz; Joseph Gibbs,9999,0,9999,0
1668077609224,CSE 293,026,119411,Porter; George M,9999,0,9999,0
1668077609224,CSE 293,027,119414,Porter; Leonard Emerson,9999,0,9999,0
1668077609224,CSE 293,028,119416,Ramamoorthi; Ravi,9999,0,9999,0
1668077609224,CSE 293,029,119417,Sahoo; Debashis,9999,0,9999,0
1668077609224,CSE 293,030,119420,Saul; Lawrence,9999,0,9999,0
1668077609224,CSE 293,031,119421,Savage; Stefan,9999,0,9999,0
1668077609224,CSE 293,032,119425,Schulze; Jurgen P.,9999,0,9999,0
1668077609224,CSE 293,033,119426,Snoeren; Alex C.,9999,0,9999,0
1668077609224,CSE 293,034,119428,Shang; Jingbo,9999,0,9999,0
1668077609224,CSE 293,035,119430,Stefan; Deian,9999,0,9999,0
1668077609224,CSE 293,036,119431,Su; Hao,9999,0,9999,0
1668077609224,CSE 293,037,119433,Swanson; Steven James,9999,0,9999,0
1668077609224,CSE 293,038,119435,Tullsen; Dean Michael,9999,0,9999,0
1668077609224,CSE 293,039,119483,Voelker; Geoffrey M.,9999,0,9999,0
1668077609224,CSE 293,040,119537,Zhao; Jishen,9999,0,9999,0
1668077609224,CSE 293,041,119538,Zhou; Yuan-Yuan,9999,0,9999,0
1668077609224,CSE 293,042,119539,Gao; Sicun,9999,0,9999,0
1668077609224,CSE 293,043,119540,Weibel; Nadir,9999,0,9999,0
1668077609224,CSE 293,044,119541,Gupta; Rajesh K.,9999,0,9999,0
1668077609224,CSE 293,045,126410,Vaccaro; Kristen Marie,9999,0,9999,0
1668077609224,CSE 293,046,126411,Klemke; Richard,9999,0,9999,0
1668077609648,CSE 294,A00,102459,Voelker; Geoffrey M.,0,0,0,0
1668077609648,CSE 294,B00,111322,Orailoglu; Alex,0,0,0,0
1668077610077,DSE 201,A00,096914,Deutsch; Alin Bernard,30,0,30,0
1668077610503,DSE 210,A00,096915,Dasgupta; Sanjoy,30,0,30,0
1668077610929,DSE 260A,A00,096916,Altintas De Callaf; Ilkay,30,0,30,0
1668077611375,ECE 200,001,103586,Antipa; Nicholas A,9999,0,9999,0
1668077611375,ECE 200,002,103587,Atanasov; Nikolay A.,9999,0,9999,0
1668077611375,ECE 200,003,103588,Bharadia; Dinesh,9999,0,9999,0
1668077611375,ECE 200,004,103589,Cheng; Chung Kuan,9999,0,9999,0
1668077611375,ECE 200,005,103590,Cosman; Pamela C.,9999,0,9999,0
1668077611375,ECE 200,006,103591,Dayeh; Shadi Ahmad,9999,0,9999,0
1668077611375,ECE 200,007,103592,Fainman; Yeshaiahu,9999,0,9999,0
1668077611375,ECE 200,008,103593,Ford; Joseph Earl,9999,0,9999,0
1668077611375,ECE 200,009,103594,Franceschetti; Massimo,9999,0,9999,0
1668077611375,ECE 200,010,103595,Fullerton; Eric E,9999,0,9999,0
1668077611375,ECE 200,011,103596,Galton; Ian A,9999,0,9999,0
1668077611375,ECE 200,012,103597,Gilja; Vikash,9999,0,9999,0
1668077611375,ECE 200,013,103598,Hall; Drew A.,9999,0,9999,0
1668077611375,ECE 200,014,103599,Hsueh; Tzu-Chien,9999,0,9999,0
1668077611375,ECE 200,015,103600,Javidi; Tara,9999,0,9999,0
1668077611375,ECE 200,016,103601,Kahng; Andrew Byun,9999,0,9999,0
1668077611375,ECE 200,017,103602,Kim; Young-Han,9999,0,9999,0
1668077611375,ECE 200,018,103603,Koushanfar; Farinaz,9999,0,9999,0
1668077611375,ECE 200,019,103604,Kuzum; Duygu,9999,0,9999,0
1668077611375,ECE 200,020,103605,Le; Hanh-Phuc,9999,0,9999,0
1668077611375,ECE 200,021,103606,Lin; Bill,9999,0,9999,0
1668077611375,ECE 200,022,103607,Liu; Zhaowei,9998,0,9999,1
1668077611375,ECE 200,023,103608,Lo; Yu-Hwa,9999,0,9999,0
1668077611375,ECE 200,024,103609,Lomakin; Vitaliy,9999,0,9999,0
1668077611375,ECE 200,025,103610,Mercier; Patrick Philip,9999,0,9999,0
1668077611375,ECE 200,026,103611,Meyer; Florian,9999,0,9999,0
1668077611375,ECE 200,027,103612,Milstein; Laurence B.,9999,0,9999,0
1668077611375,ECE 200,028,103613,Mir Arabbaygi; Siavash,9999,0,9999,0
1668077611375,ECE 200,029,103614,Mookherjea; Shayan,9999,0,9999,0
1668077611375,ECE 200,030,103615,Morris; Karcher William,9999,0,9999,0
1668077611375,ECE 200,031,103616,Ng; Tse Nga,9999,0,9999,0
1668077611375,ECE 200,032,103617,Nguyen; Truong Quang,9999,0,9999,0
1668077611375,ECE 200,033,103618,Nomura; Kenji,9999,0,9999,0
1668077611375,ECE 200,034,103619,Orlitsky; Alon,9999,0,9999,0
1668077611375,ECE 200,035,103620,Pal; Piya,9999,0,9999,0
1668077611375,ECE 200,036,103621,Papen; George C.,9999,0,9999,0
1668077611375,ECE 200,037,103622,Radic; Stojan,9999,0,9999,0
1668077611375,ECE 200,038,103623,Rao; Bhaskar D.,9999,0,9999,0
1668077611375,ECE 200,039,103624,Rao; Ramesh R,9999,0,9999,0
1668077611375,ECE 200,040,103625,Rebeiz; Gabriel,9999,0,9999,0
1668077611375,ECE 200,041,103626,Sanford; John R,9999,0,9999,0
1668077611375,ECE 200,042,103627,Siegel; Paul H.,9999,0,9999,0
1668077611375,ECE 200,043,103628,Sievenpiper; Daniel F.,9999,0,9999,0
1668077611375,ECE 200,044,103629,Sworder; David D.,9999,0,9999,0
1668077611375,ECE 200,045,103630,Taur; Yuan,9999,0,9999,0
1668077611375,ECE 200,046,103631,Touri; Behrouz,9999,0,9999,0
1668077611375,ECE 200,047,103632,Trivedi; Mohan M.,9999,0,9999,0
1668077611375,ECE 200,048,103633,Vasconcelos; Nuno,9999,0,9999,0
1668077611375,ECE 200,049,103634,Wang; Xiaolong,9999,0,9999,0
1668077611375,ECE 200,050,103635,Xie; Pengtao,9999,0,9999,0
1668077611375,ECE 200,051,103636,Yip; Michael,9999,0,9999,0
1668077611375,ECE 200,052,103637,Zeger; Kenneth A.,999,0,999,0
1668077611375,ECE 200,053,103638,Zhang; Xinyu,9999,0,9999,0
1668077611375,ECE 200,054,103639,Turakhia; Yatish Girish,9999,0,9999,0
1668077611375,ECE 200,055,103640,Kang; Mingu,9999,0,9999,0
1668077611375,ECE 200,056,103641,Shi; Yuanyuan,9999,0,9999,0
1668077611375,ECE 200,057,103642,Wang; Edward Jay,9999,0,9999,0
1668077611375,ECE 200,058,103643,Zheng; Yang,9999,0,9999,0
1668077611802,ECE 202,A00,103644,Kuzum; Duygu,0,0,0,0
1668077612241,ECE 212BN,A00,103646,Ng; Tse Nga,0,0,0,0
1668077612665,ECE 221,A00,111493,Staff,0,0,0,0
1668077613092,ECE 222B,A00,103647,Lomakin; Vitaliy,0,0,0,0
1668077613517,ECE 230B,A00,103648,Taur; Yuan,0,0,0,0
1668077613943,ECE 238B,A00,103649,Garay; Javier,0,0,0,0
1668077614376,ECE 240B,A00,112900,Fainman; Yeshaiahu,0,0,0,0
1668077614802,ECE 247A,A00,103650,Jokerst; Jesse Vincent,0,0,0,0
1668077615227,ECE 247B,A00,103651,Wang; Joseph,0,0,0,0
1668077615651,ECE 250,A00,103652,Siegel; Paul H.,0,0,0,0
1668077616075,ECE 251A,A00,103654,Rao; Bhaskar D.,0,0,0,0
1668077616500,ECE 257B,A00,103655,Bharadia; Dinesh,0,0,0,0
1668077616927,ECE 258A,A00,103656,Milstein; Laurence B.,0,0,0,0
1668077617352,ECE 260B,A00,103658,Kang; Mingu,0,0,0,0
1668077617779,ECE 264A,A00,103659,Galton; Ian A,0,0,0,0
1668077618207,ECE 265A,A00,103661,Gudem; Prasad S.S.,0,0,0,0
1668077618633,ECE 265D,A00,103662,Gudem; Prasad S.S.,0,0,0,0
1668077619061,ECE 268,A00,103663,Koushanfar; Farinaz,0,0,0,0
1668077619488,ECE 269,A01,103665,Pal; Piya,0,0,0,0
1668077619920,ECE 271B,A00,103666,Vasconcelos; Manuela,0,0,0,0
1668077620344,ECE 276A,A00,103667,Atanasov; Nikolay A.,0,0,0,0
1668077620773,ECE 277,A00,103668,An; Cheolhong,0,0,0,0
1668077621196,ECE 279,A00,117947,Hall; Drew A.,0,0,0,0
1668077622047,ECE 283,A00,103670,Hsueh; Tzu-Chien,0,0,0,0
1668077622475,ECE 284,A00,103671,Turakhia; Yatish Girish,0,0,0,0
1668077622903,ECE 285,A00,103672,Zheng; Yang,0,0,0,0
1668077622903,ECE 285,B00,103673,Sworder; David D.,0,0,0,0
1668077623329,ECE 287,A00,103676,Javidi; Tara,0,0,0,0
1668077623757,MATH 200B,A00,098023,Salehi Golsefidy; Alireza,13,0,15,2
1668077624180,MATH 202B,A00,098024,Rhoades; Brendon Patrick,9,0,15,6
1668077624605,MATH 203B,A00,098025,Oprea; Dragos N.,10,0,15,5
1668077625031,MATH 204B,A00,098026,Sorensen; Claus M,13,0,15,2
1668077625459,MATH 208,A00,098027,Izadi; Elham,7,0,10,3
1668077625886,MATH 209,A00,098028,Pollack; Aaron,10,0,10,0
1668077626312,MATH 211A,A00,112919,Rogalski; Daniel,9,0,10,1
1668077626737,MATH 211B,A00,112920,Seward; Brandon M.,9,0,10,1
1668077627163,MATH 218,A00,098029,Li; Bo,10,0,10,0
1668077627594,MATH 220B,A00,098030,Novak; Jonathan I,12,0,15,3
1668077628022,MATH 221A,A00,098031,Ebenfelt; Peter F,13,0,15,2
1668077628445,MATH 231B,A00,098032,Zlatos; Andrej,12,0,15,3
1668077628950,MATH 240B,A00,098033,Ni; Lei,9,0,15,6
1668077629375,MATH 243,A00,098034,Jekel; David Andrew,10,0,10,0
1668077629804,MATH 245A,A00,098035,Nie; Jiawang,0,0,15,16
1668077630235,MATH 248,A00,098036,Bejenaru; Ioan,10,0,10,0
1668077630662,MATH 250B,A00,098037,Spolaor; Luca,14,0,15,1
1668077631085,MATH 258,A00,098038,Ni; Lei,10,0,10,0
1668077631522,MATH 264B,A00,098041,Rhoades; Brendon Patrick,10,0,15,5
1668077631946,MATH 268,A00,098042,Buss; Samuel R,10,0,10,0
1668077632369,MATH 269,A00,098043,Rhoades; Brendon Patrick,10,0,10,0
1668077632798,MATH 270B,A00,098044,Li; Bo,11,0,15,4
1668077633222,MATH 272B,A00,098045,Holst; Michael J,13,0,15,2
1668077633645,MATH 273A,A00,098046,Tian; Xiaochuan,10,0,15,5
1668077634072,MATH 275,A01,098048,Tian; Xiaochuan,6,0,10,4
1668077634498,MATH 278A,A00,098049,Holst; Michael J,8,0,10,2
1668077634922,MATH 278B,A00,098050,Cloninger; Alexander,10,0,10,0
1668077635350,MATH 278C,A00,098051,Nie; Jiawang,7,0,10,3
1668077635773,MATH 280B,A00,098052,Zheng; Tianyi,10,0,15,5
1668077636199,MATH 281B,A00,098053,Bradic; Jelena,3,0,15,12
1668077636628,MATH 282B,A00,098054,Arias-Castro; Ery,0,0,15,15
1668077637057,MATH 285,A00,098055,Fitzsimmons; Patrick J,0,0,15,17
1668077637485,MATH 287B,A00,098056,Arias-Castro; Ery,3,0,15,12
1668077637918,MATH 288,A00,098057,Agarwal; Pooja,9,0,10,1
1668077637918,MATH 288,B00,098058,Zhang; Danna,8,0,10,2
1668077637918,MATH 288,C00,098059,Williams; Ruth J,10,0,10,0
1668077638346,MATH 290B,A00,098060,Roberts; Justin Deritter,13,0,15,2
1668077638772,MATH 292,A00,098061,Belmont; Eva Kinoshita,10,0,10,0
1668077639197,MATH 295,A00,098062,Suk; Andrew Hoon,48,0,50,2
1668077639628,MATH 296,A00,098063,Novak; Jonathan I,20,0,20,0
1668077640061,MATH 297,001,098064,Gamst; Anthony Collins,9997,0,9999,2
1668078141161,COGS 205,A00,101395,Chiba; Andrea,19,0,20,1
1668078141588,COGS 210B,001,101404,Greene; Deanna Jacquelyn,9998,0,9999,1
1668078141588,COGS 210B,002,101417,Xia; Haijun,9999,0,9999,0
1668078141588,COGS 210B,003,101422,Nitz; Douglas A.,9999,0,9999,0
1668078141588,COGS 210B,004,101423,Hollan; James D.,9998,0,9999,1
1668078141588,COGS 210B,005,101424,Deak; Gedeon O.,9998,0,9999,1
1668078141588,COGS 210B,006,101425,Rossano; Federico,9999,0,9999,0
1668078142017,COGS 211B,A00,101427,Coulson; Seana M,9996,0,9999,3
1668078142445,COGS 220,A00,101428,Hollan; James D.,0,0,25,25
1668078142871,COGS 229,A00,101429,Dow; Steven P,18,0,25,7
1668078143297,COGS 230,A00,101430,Klemmer; Scott R,13,0,17,4
1668078143726,COGS 234,A00,101431,Xia; Haijun,3,0,25,22
1668078144150,COGS 260,A00,101432,Kiyonaga; Anastasia,19,0,25,6
1668078144150,COGS 260,B00,101433,Kirsh; David Joel,16,0,25,9
1668078144572,CSE 202,A00,102371,Impagliazzo; Russell,0,0,0,0
1668078145002,CSE 203B,A01,102373,Cheng; Chung Kuan,0,0,0,0
1668078145426,CSE 208,A00,102374,Micciancio; Daniele,0,0,0,0
1668078145857,CSE 209A,A00,112895,Impagliazzo; Russell,0,0,15,15
1668078146289,CSE 209B,A00,108005,Bellare; Mihir,0,0,0,0
1668078146719,CSE 210,A00,113163,Coblenz; Michael J,0,0,0,0
1668078147143,CSE 219,A00,106111,Dow; Steven P,0,0,20,20
1668078147571,CSE 221,A00,102376,Voelker; Geoffrey M.,0,0,0,0
1668078147998,CSE 224,A01,102378,Porter; George M,0,0,0,0
1668078148422,CSE 229A,A00,102379,Savage; Stefan,0,0,0,0
1668078148849,CSE 229C,A00,102380,Munyaka; Imani N. S.,0,0,0,0
1668078149278,CSE 232B,A00,102382,Deutsch; Alin Bernard,0,0,0,0
1668078149702,CSE 234,A01,112904,Kumar; Arun Kumar,0,0,0,0
1668078150211,CSE 237A,A00,102383,Rosing; Tajana Simunic,0,0,0,0
1668078150634,CSE 239A,A00,102384,Deutsch; Alin Bernard,0,0,0,0
1668078151058,CSE 239B,A00,102385,Polikarpova; Nadezhda,0,0,0,0
1668078151482,CSE 240A,A00,102386,Pannuto; Patrick William,0,0,0,0
1668078151910,CSE 240B,A00,102387,Zhao; Jishen,0,0,0,0
1668078152338,CSE 241A,A00,106406,Kang; Mingu,0,0,0,0
1668078152764,CSE 249B,A00,102388,Kahng; Andrew Byun,0,0,8,8
1668078153196,CSE 251B,A01,102392,Cottrell; Garrison W,0,0,0,0
1668078153196,CSE 251B,A02,102393,Cottrell; Garrison W,0,0,0,0
1668078153626,CSE 252B,A00,102394,Ochoa; Benjamin Lawrence,0,0,0,0
1668078154052,CSE 257,A01,102396,Gao; Sicun,0,0,0,0
1668078154480,CSE 272,A00,102397,Li; Tzumao,0,0,0,0
1668078154911,CSE 274,A00,111323,Chern; Albert Ren-Haur,0,0,0,0
1668078155337,CSE 282,A00,102398,Pevzner; Pavel Arkadjevich,0,0,0,0
1668078155761,CSE 284,A00,114175,Gymrek; Melissa Ann,0,0,0,0
1668078156193,CSE 290,A00,102399,Chandraker; Manmohan Krishna,0,0,0,0
1668078156193,CSE 290,B00,102400,Vaccaro; Kristen Marie,0,0,25,25
1668078156193,CSE 290,C00,102414,Pannuto; Patrick William,0,0,25,25
1668078156193,CSE 290,D00,102427,Pevzner; Pavel Arkadjevich,0,0,0,0
1668078156193,CSE 290,E00,102429,Zhao; Jishen,0,0,0,0
1668078156193,CSE 290,F00,102436,Tullsen; Dean Michael,0,0,0,0
1668078156193,CSE 290,G00,102440,Christensen; Henrik I,0,0,20,20
1668078156622,CSE 291,A00,102443,Su; Hao,0,0,0,0
1668078156622,CSE 291,B00,102448,Polikarpova; Nadezhda,0,0,0,0
1668078156622,CSE 291,C00,102453,Vaccaro; Kristen Marie,0,0,0,0
1668078156622,CSE 291,D00,111343,Savage; Stefan,0,0,0,0
1668078156622,CSE 291,E00,116474,Claffy; Kimberly Claire,0,0,0,0
1668078156622,CSE 291,F00,116479,Pasquale; Joseph,0,0,0,0
1668078157066,CSE 293,001,119111,Bafna; Vineet,9999,0,9999,0
1668078157066,CSE 293,002,119118,Bellare; Mihir,9999,0,9999,0
1668078157066,CSE 293,003,119122,Berg-Kirkpatrick; Taylor D,9999,0,9999,0
1668078157066,CSE 293,004,119135,Christensen; Henrik I,9999,0,9999,0
1668078157066,CSE 293,005,119142,Cottrell; Garrison W,9999,0,9999,0
1668078157066,CSE 293,006,119146,Deutsch; Alin Bernard,9999,0,9999,0
1668078157066,CSE 293,007,119159,Esmaeilzadeh; Hadi,9999,0,9999,0
1668078157066,CSE 293,008,119166,Freund; Yoav,9999,0,9999,0
1668078157066,CSE 293,009,119170,Griswold; William G.,9999,0,9999,0
1668078157066,CSE 293,010,119183,Gymrek; Melissa Ann,9999,0,9999,0
1668078157066,CSE 293,011,119190,Heninger; Nadia A,9999,0,9999,0
1668078157066,CSE 293,012,119230,Impagliazzo; Russell,9999,0,9999,0
1668078157066,CSE 293,013,119232,Jhala; Ranjit,9999,0,9999,0
1668078157066,CSE 293,014,119233,Kahng; Andrew Byun,9999,0,9999,0
1668078157066,CSE 293,015,119298,Kane; Daniel Mertz,9999,0,9999,0
1668078157066,CSE 293,016,119299,Kriegman; David J,9999,0,9999,0
1668078157066,CSE 293,017,119300,Kumar; Arun Kumar,9999,0,9999,0
1668078157066,CSE 293,018,119301,Lerner; Sorin,9999,0,9999,0
1668078157066,CSE 293,019,119302,Lovett; Shachar,9999,0,9999,0
1668078157066,CSE 293,020,119303,McAuley; Julian John,9999,0,9999,0
1668078157066,CSE 293,021,119304,Micciancio; Daniele,9999,0,9999,0
1668078157066,CSE 293,022,119367,Orailoglu; Alex,9999,0,9999,0
1668078157066,CSE 293,023,119382,Paturi; Ramamohan,9999,0,9999,0
1668078157066,CSE 293,024,119404,Polikarpova; Nadezhda,9999,0,9999,0
1668078157066,CSE 293,025,119406,Politz; Joseph Gibbs,9999,0,9999,0
1668078157066,CSE 293,026,119411,Porter; George M,9999,0,9999,0
1668078157066,CSE 293,027,119414,Porter; Leonard Emerson,9999,0,9999,0
1668078157066,CSE 293,028,119416,Ramamoorthi; Ravi,9999,0,9999,0
1668078157066,CSE 293,029,119417,Sahoo; Debashis,9999,0,9999,0
1668078157066,CSE 293,030,119420,Saul; Lawrence,9999,0,9999,0
1668078157066,CSE 293,031,119421,Savage; Stefan,9999,0,9999,0
1668078157066,CSE 293,032,119425,Schulze; Jurgen P.,9999,0,9999,0
1668078157066,CSE 293,033,119426,Snoeren; Alex C.,9999,0,9999,0
1668078157066,CSE 293,034,119428,Shang; Jingbo,9999,0,9999,0
1668078157066,CSE 293,035,119430,Stefan; Deian,9999,0,9999,0
1668078157066,CSE 293,036,119431,Su; Hao,9999,0,9999,0
1668078157066,CSE 293,037,119433,Swanson; Steven James,9999,0,9999,0
1668078157066,CSE 293,038,119435,Tullsen; Dean Michael,9999,0,9999,0
1668078157066,CSE 293,039,119483,Voelker; Geoffrey M.,9999,0,9999,0
1668078157066,CSE 293,040,119537,Zhao; Jishen,9999,0,9999,0
1668078157066,CSE 293,041,119538,Zhou; Yuan-Yuan,9999,0,9999,0
1668078157066,CSE 293,042,119539,Gao; Sicun,9999,0,9999,0
1668078157066,CSE 293,043,119540,Weibel; Nadir,9999,0,9999,0
1668078157066,CSE 293,044,119541,Gupta; Rajesh K.,9999,0,9999,0
1668078157066,CSE 293,045,126410,Vaccaro; Kristen Marie,9999,0,9999,0
1668078157066,CSE 293,046,126411,Klemke; Richard,9999,0,9999,0
1668078157492,CSE 294,A00,102459,Voelker; Geoffrey M.,0,0,0,0
1668078157492,CSE 294,B00,111322,Orailoglu; Alex,0,0,0,0
1668078157916,DSE 201,A00,096914,Deutsch; Alin Bernard,30,0,30,0
1668078158343,DSE 210,A00,096915,Dasgupta; Sanjoy,30,0,30,0
1668078158776,DSE 260A,A00,096916,Altintas De Callaf; Ilkay,30,0,30,0
1668078159220,ECE 200,001,103586,Antipa; Nicholas A,9999,0,9999,0
1668078159220,ECE 200,002,103587,Atanasov; Nikolay A.,9999,0,9999,0
1668078159220,ECE 200,003,103588,Bharadia; Dinesh,9999,0,9999,0
1668078159220,ECE 200,004,103589,Cheng; Chung Kuan,9999,0,9999,0
1668078159220,ECE 200,005,103590,Cosman; Pamela C.,9999,0,9999,0
1668078159220,ECE 200,006,103591,Dayeh; Shadi Ahmad,9999,0,9999,0
1668078159220,ECE 200,007,103592,Fainman; Yeshaiahu,9999,0,9999,0
1668078159220,ECE 200,008,103593,Ford; Joseph Earl,9999,0,9999,0
1668078159220,ECE 200,009,103594,Franceschetti; Massimo,9999,0,9999,0
1668078159220,ECE 200,010,103595,Fullerton; Eric E,9999,0,9999,0
1668078159220,ECE 200,011,103596,Galton; Ian A,9999,0,9999,0
1668078159220,ECE 200,012,103597,Gilja; Vikash,9999,0,9999,0
1668078159220,ECE 200,013,103598,Hall; Drew A.,9999,0,9999,0
1668078159220,ECE 200,014,103599,Hsueh; Tzu-Chien,9999,0,9999,0
1668078159220,ECE 200,015,103600,Javidi; Tara,9999,0,9999,0
1668078159220,ECE 200,016,103601,Kahng; Andrew Byun,9999,0,9999,0
1668078159220,ECE 200,017,103602,Kim; Young-Han,9999,0,9999,0
1668078159220,ECE 200,018,103603,Koushanfar; Farinaz,9999,0,9999,0
1668078159220,ECE 200,019,103604,Kuzum; Duygu,9999,0,9999,0
1668078159220,ECE 200,020,103605,Le; Hanh-Phuc,9999,0,9999,0
1668078159220,ECE 200,021,103606,Lin; Bill,9999,0,9999,0
1668078159220,ECE 200,022,103607,Liu; Zhaowei,9998,0,9999,1
1668078159220,ECE 200,023,103608,Lo; Yu-Hwa,9999,0,9999,0
1668078159220,ECE 200,024,103609,Lomakin; Vitaliy,9999,0,9999,0
1668078159220,ECE 200,025,103610,Mercier; Patrick Philip,9999,0,9999,0
1668078159220,ECE 200,026,103611,Meyer; Florian,9999,0,9999,0
1668078159220,ECE 200,027,103612,Milstein; Laurence B.,9999,0,9999,0
1668078159220,ECE 200,028,103613,Mir Arabbaygi; Siavash,9999,0,9999,0
1668078159220,ECE 200,029,103614,Mookherjea; Shayan,9999,0,9999,0
1668078159220,ECE 200,030,103615,Morris; Karcher William,9999,0,9999,0
1668078159220,ECE 200,031,103616,Ng; Tse Nga,9999,0,9999,0
1668078159220,ECE 200,032,103617,Nguyen; Truong Quang,9999,0,9999,0
1668078159220,ECE 200,033,103618,Nomura; Kenji,9999,0,9999,0
1668078159220,ECE 200,034,103619,Orlitsky; Alon,9999,0,9999,0
1668078159220,ECE 200,035,103620,Pal; Piya,9999,0,9999,0
1668078159220,ECE 200,036,103621,Papen; George C.,9999,0,9999,0
1668078159220,ECE 200,037,103622,Radic; Stojan,9999,0,9999,0
1668078159220,ECE 200,038,103623,Rao; Bhaskar D.,9999,0,9999,0
1668078159220,ECE 200,039,103624,Rao; Ramesh R,9999,0,9999,0
1668078159220,ECE 200,040,103625,Rebeiz; Gabriel,9999,0,9999,0
1668078159220,ECE 200,041,103626,Sanford; John R,9999,0,9999,0
1668078159220,ECE 200,042,103627,Siegel; Paul H.,9999,0,9999,0
1668078159220,ECE 200,043,103628,Sievenpiper; Daniel F.,9999,0,9999,0
1668078159220,ECE 200,044,103629,Sworder; David D.,9999,0,9999,0
1668078159220,ECE 200,045,103630,Taur; Yuan,9999,0,9999,0
1668078159220,ECE 200,046,103631,Touri; Behrouz,9999,0,9999,0
1668078159220,ECE 200,047,103632,Trivedi; Mohan M.,9999,0,9999,0
1668078159220,ECE 200,048,103633,Vasconcelos; Nuno,9999,0,9999,0
1668078159220,ECE 200,049,103634,Wang; Xiaolong,9999,0,9999,0
1668078159220,ECE 200,050,103635,Xie; Pengtao,9999,0,9999,0
1668078159220,ECE 200,051,103636,Yip; Michael,9999,0,9999,0
1668078159220,ECE 200,052,103637,Zeger; Kenneth A.,999,0,999,0
1668078159220,ECE 200,053,103638,Zhang; Xinyu,9999,0,9999,0
1668078159220,ECE 200,054,103639,Turakhia; Yatish Girish,9999,0,9999,0
1668078159220,ECE 200,055,103640,Kang; Mingu,9999,0,9999,0
1668078159220,ECE 200,056,103641,Shi; Yuanyuan,9999,0,9999,0
1668078159220,ECE 200,057,103642,Wang; Edward Jay,9999,0,9999,0
1668078159220,ECE 200,058,103643,Zheng; Yang,9999,0,9999,0
1668078159643,ECE 202,A00,103644,Kuzum; Duygu,0,0,0,0
1668078160077,ECE 212BN,A00,103646,Ng; Tse Nga,0,0,0,0
1668078160505,ECE 221,A00,111493,Staff,0,0,0,0
1668078160929,ECE 222B,A00,103647,Lomakin; Vitaliy,0,0,0,0
1668078161357,ECE 230B,A00,103648,Taur; Yuan,0,0,0,0
1668078161783,ECE 238B,A00,103649,Garay; Javier,0,0,0,0
1668078162211,ECE 240B,A00,112900,Fainman; Yeshaiahu,0,0,0,0
1668078162635,ECE 247A,A00,103650,Jokerst; Jesse Vincent,0,0,0,0
1668078163061,ECE 247B,A00,103651,Wang; Joseph,0,0,0,0
1668078163491,ECE 250,A00,103652,Siegel; Paul H.,0,0,0,0
1668078163916,ECE 251A,A00,103654,Rao; Bhaskar D.,0,0,0,0
1668078164341,ECE 257B,A00,103655,Bharadia; Dinesh,0,0,0,0
1668078164768,ECE 258A,A00,103656,Milstein; Laurence B.,0,0,0,0
1668078165202,ECE 260B,A00,103658,Kang; Mingu,0,0,0,0
1668078165625,ECE 264A,A00,103659,Galton; Ian A,0,0,0,0
1668078166051,ECE 265A,A00,103661,Gudem; Prasad S.S.,0,0,0,0
1668078166477,ECE 265D,A00,103662,Gudem; Prasad S.S.,0,0,0,0
1668078166903,ECE 268,A00,103663,Koushanfar; Farinaz,0,0,0,0
1668078167329,ECE 269,A01,103665,Pal; Piya,0,0,0,0
1668078167757,ECE 271B,A00,103666,Vasconcelos; Manuela,0,0,0,0
1668078168183,ECE 276A,A00,103667,Atanasov; Nikolay A.,0,0,0,0
1668078168613,ECE 277,A00,103668,An; Cheolhong,0,0,0,0
1668078169050,ECE 279,A00,117947,Hall; Drew A.,0,0,0,0
1668078169907,ECE 283,A00,103670,Hsueh; Tzu-Chien,0,0,0,0
1668078170334,ECE 284,A00,103671,Turakhia; Yatish Girish,0,0,0,0
1668078170758,ECE 285,A00,103672,Zheng; Yang,0,0,0,0
1668078170758,ECE 285,B00,103673,Sworder; David D.,0,0,0,0
1668078171190,ECE 287,A00,103676,Javidi; Tara,0,0,0,0
1668078171619,MATH 200B,A00,098023,Salehi Golsefidy; Alireza,13,0,15,2
1668078172045,MATH 202B,A00,098024,Rhoades; Brendon Patrick,9,0,15,6
1668078172469,MATH 203B,A00,098025,Oprea; Dragos N.,10,0,15,5
1668078172897,MATH 204B,A00,098026,Sorensen; Claus M,13,0,15,2
1668078173344,MATH 208,A00,098027,Izadi; Elham,7,0,10,3
1668078173771,MATH 209,A00,098028,Pollack; Aaron,10,0,10,0
1668078174195,MATH 211A,A00,112919,Rogalski; Daniel,9,0,10,1
1668078174620,MATH 211B,A00,112920,Seward; Brandon M.,9,0,10,1
1668078175047,MATH 218,A00,098029,Li; Bo,10,0,10,0
1668078175475,MATH 220B,A00,098030,Novak; Jonathan I,12,0,15,3
1668078175905,MATH 221A,A00,098031,Ebenfelt; Peter F,13,0,15,2
1668078176340,MATH 231B,A00,098032,Zlatos; Andrej,12,0,15,3
1668078176766,MATH 240B,A00,098033,Ni; Lei,9,0,15,6
1668078177189,MATH 243,A00,098034,Jekel; David Andrew,10,0,10,0
1668078177620,MATH 245A,A00,098035,Nie; Jiawang,0,0,15,16
1668078178042,MATH 248,A00,098036,Bejenaru; Ioan,10,0,10,0
1668078178469,MATH 250B,A00,098037,Spolaor; Luca,14,0,15,1
1668078178906,MATH 258,A00,098038,Ni; Lei,10,0,10,0
1668078179336,MATH 264B,A00,098041,Rhoades; Brendon Patrick,10,0,15,5
1668078179760,MATH 268,A00,098042,Buss; Samuel R,10,0,10,0
1668078180192,MATH 269,A00,098043,Rhoades; Brendon Patrick,10,0,10,0
1668078180616,MATH 270B,A00,098044,Li; Bo,11,0,15,4
1668078181041,MATH 272B,A00,098045,Holst; Michael J,13,0,15,2
1668078181466,MATH 273A,A00,098046,Tian; Xiaochuan,10,0,15,5
1668078181890,MATH 275,A01,098048,Tian; Xiaochuan,6,0,10,4
1668078182316,MATH 278A,A00,098049,Holst; Michael J,8,0,10,2
1668078182737,MATH 278B,A00,098050,Cloninger; Alexander,10,0,10,0
1668078183167,MATH 278C,A00,098051,Nie; Jiawang,7,0,10,3
1668078183596,MATH 280B,A00,098052,Zheng; Tianyi,10,0,15,5
1668078184024,MATH 281B,A00,098053,Bradic; Jelena,3,0,15,12
1668078184448,MATH 282B,A00,098054,Arias-Castro; Ery,0,0,15,15
1668078184873,MATH 285,A00,098055,Fitzsimmons; Patrick J,0,0,15,17
1668078185301,MATH 287B,A00,098056,Arias-Castro; Ery,3,0,15,12
1668078185727,MATH 288,A00,098057,Agarwal; Pooja,9,0,10,1
1668078185727,MATH 288,B00,098058,Zhang; Danna,8,0,10,2
1668078185727,MATH 288,C00,098059,Williams; Ruth J,10,0,10,0
1668078186156,MATH 290B,A00,098060,Roberts; Justin Deritter,13,0,15,2
1668078186581,MATH 292,A00,098061,Belmont; Eva Kinoshita,10,0,10,0
1668078187008,MATH 295,A00,098062,Suk; Andrew Hoon,48,0,50,2
1668078187434,MATH 296,A00,098063,Novak; Jonathan I,20,0,20,0
1668078187866,MATH 297,001,098064,Gamst; Anthony Collins,9997,0,9999,2
1668078688734,COGS 205,A00,101395,Chiba; Andrea,19,0,20,1
1668078689163,COGS 210B,001,101404,Greene; Deanna Jacquelyn,9998,0,9999,1
1668078689163,COGS 210B,002,101417,Xia; Haijun,9999,0,9999,0
1668078689163,COGS 210B,003,101422,Nitz; Douglas A.,9999,0,9999,0
1668078689163,COGS 210B,004,101423,Hollan; James D.,9998,0,9999,1
1668078689163,COGS 210B,005,101424,Deak; Gedeon O.,9998,0,9999,1
1668078689163,COGS 210B,006,101425,Rossano; Federico,9999,0,9999,0
1668078689591,COGS 211B,A00,101427,Coulson; Seana M,9996,0,9999,3
1668078690017,COGS 220,A00,101428,Hollan; James D.,0,0,25,25
1668078690442,COGS 229,A00,101429,Dow; Steven P,18,0,25,7
1668078690869,COGS 230,A00,101430,Klemmer; Scott R,13,0,17,4
1668078691294,COGS 234,A00,101431,Xia; Haijun,3,0,25,22
1668078691730,COGS 260,A00,101432,Kiyonaga; Anastasia,19,0,25,6
1668078691730,COGS 260,B00,101433,Kirsh; David Joel,16,0,25,9
1668078692154,CSE 202,A00,102371,Impagliazzo; Russell,0,0,0,0
1668078692578,CSE 203B,A01,102373,Cheng; Chung Kuan,0,0,0,0
1668078693003,CSE 208,A00,102374,Micciancio; Daniele,0,0,0,0
1668078693426,CSE 209A,A00,112895,Impagliazzo; Russell,0,0,15,15
1668078693849,CSE 209B,A00,108005,Bellare; Mihir,0,0,0,0
1668078694273,CSE 210,A00,113163,Coblenz; Michael J,0,0,0,0
1668078694718,CSE 219,A00,106111,Dow; Steven P,0,0,20,20
1668078695147,CSE 221,A00,102376,Voelker; Geoffrey M.,0,0,0,0
1668078695575,CSE 224,A01,102378,Porter; George M,0,0,0,0
1668078696003,CSE 229A,A00,102379,Savage; Stefan,0,0,0,0
1668078696427,CSE 229C,A00,102380,Munyaka; Imani N. S.,0,0,0,0
1668078696856,CSE 232B,A00,102382,Deutsch; Alin Bernard,0,0,0,0
1668078697284,CSE 234,A01,112904,Kumar; Arun Kumar,0,0,0,0
1668078697713,CSE 237A,A00,102383,Rosing; Tajana Simunic,0,0,0,0
1668078698141,CSE 239A,A00,102384,Deutsch; Alin Bernard,0,0,0,0
1668078698565,CSE 239B,A00,102385,Polikarpova; Nadezhda,0,0,0,0
1668078698993,CSE 240A,A00,102386,Pannuto; Patrick William,0,0,0,0
1668078699420,CSE 240B,A00,102387,Zhao; Jishen,0,0,0,0
1668078699844,CSE 241A,A00,106406,Kang; Mingu,0,0,0,0
1668078700271,CSE 249B,A00,102388,Kahng; Andrew Byun,0,0,8,8
1668078700698,CSE 251B,A01,102392,Cottrell; Garrison W,0,0,0,0
1668078700698,CSE 251B,A02,102393,Cottrell; Garrison W,0,0,0,0
1668078701123,CSE 252B,A00,102394,Ochoa; Benjamin Lawrence,0,0,0,0
1668078701551,CSE 257,A01,102396,Gao; Sicun,0,0,0,0
1668078701980,CSE 272,A00,102397,Li; Tzumao,0,0,0,0
1668078702404,CSE 274,A00,111323,Chern; Albert Ren-Haur,0,0,0,0
1668078702846,CSE 282,A00,102398,Pevzner; Pavel Arkadjevich,0,0,0,0
1668078703277,CSE 284,A00,114175,Gymrek; Melissa Ann,0,0,0,0
1668078703703,CSE 290,A00,102399,Chandraker; Manmohan Krishna,0,0,0,0
1668078703703,CSE 290,B00,102400,Vaccaro; Kristen Marie,0,0,25,25
1668078703703,CSE 290,C00,102414,Pannuto; Patrick William,0,0,25,25
1668078703703,CSE 290,D00,102427,Pevzner; Pavel Arkadjevich,0,0,0,0
1668078703703,CSE 290,E00,102429,Zhao; Jishen,0,0,0,0
1668078703703,CSE 290,F00,102436,Tullsen; Dean Michael,0,0,0,0
1668078703703,CSE 290,G00,102440,Christensen; Henrik I,0,0,20,20
1668078704136,CSE 291,A00,102443,Su; Hao,0,0,0,0
1668078704136,CSE 291,B00,102448,Polikarpova; Nadezhda,0,0,0,0
1668078704136,CSE 291,C00,102453,Vaccaro; Kristen Marie,0,0,0,0
1668078704136,CSE 291,D00,111343,Savage; Stefan,0,0,0,0
1668078704136,CSE 291,E00,116474,Claffy; Kimberly Claire,0,0,0,0
1668078704136,CSE 291,F00,116479,Pasquale; Joseph,0,0,0,0
1668078704577,CSE 293,001,119111,Bafna; Vineet,9999,0,9999,0
1668078704577,CSE 293,002,119118,Bellare; Mihir,9999,0,9999,0
1668078704577,CSE 293,003,119122,Berg-Kirkpatrick; Taylor D,9999,0,9999,0
1668078704577,CSE 293,004,119135,Christensen; Henrik I,9999,0,9999,0
1668078704577,CSE 293,005,119142,Cottrell; Garrison W,9999,0,9999,0
1668078704577,CSE 293,006,119146,Deutsch; Alin Bernard,9999,0,9999,0
1668078704577,CSE 293,007,119159,Esmaeilzadeh; Hadi,9999,0,9999,0
1668078704577,CSE 293,008,119166,Freund; Yoav,9999,0,9999,0
1668078704577,CSE 293,009,119170,Griswold; William G.,9999,0,9999,0
1668078704577,CSE 293,010,119183,Gymrek; Melissa Ann,9999,0,9999,0
1668078704577,CSE 293,011,119190,Heninger; Nadia A,9999,0,9999,0
1668078704577,CSE 293,012,119230,Impagliazzo; Russell,9999,0,9999,0
1668078704577,CSE 293,013,119232,Jhala; Ranjit,9999,0,9999,0
1668078704577,CSE 293,014,119233,Kahng; Andrew Byun,9999,0,9999,0
1668078704577,CSE 293,015,119298,Kane; Daniel Mertz,9999,0,9999,0
1668078704577,CSE 293,016,119299,Kriegman; David J,9999,0,9999,0
1668078704577,CSE 293,017,119300,Kumar; Arun Kumar,9999,0,9999,0
1668078704577,CSE 293,018,119301,Lerner; Sorin,9999,0,9999,0
1668078704577,CSE 293,019,119302,Lovett; Shachar,9999,0,9999,0
1668078704577,CSE 293,020,119303,McAuley; Julian John,9999,0,9999,0
1668078704577,CSE 293,021,119304,Micciancio; Daniele,9999,0,9999,0
1668078704577,CSE 293,022,119367,Orailoglu; Alex,9999,0,9999,0
1668078704577,CSE 293,023,119382,Paturi; Ramamohan,9999,0,9999,0
1668078704577,CSE 293,024,119404,Polikarpova; Nadezhda,9999,0,9999,0
1668078704577,CSE 293,025,119406,Politz; Joseph Gibbs,9999,0,9999,0
1668078704577,CSE 293,026,119411,Porter; George M,9999,0,9999,0
1668078704577,CSE 293,027,119414,Porter; Leonard Emerson,9999,0,9999,0
1668078704577,CSE 293,028,119416,Ramamoorthi; Ravi,9999,0,9999,0
1668078704577,CSE 293,029,119417,Sahoo; Debashis,9999,0,9999,0
1668078704577,CSE 293,030,119420,Saul; Lawrence,9999,0,9999,0
1668078704577,CSE 293,031,119421,Savage; Stefan,9999,0,9999,0
1668078704577,CSE 293,032,119425,Schulze; Jurgen P.,9999,0,9999,0
1668078704577,CSE 293,033,119426,Snoeren; Alex C.,9999,0,9999,0
1668078704577,CSE 293,034,119428,Shang; Jingbo,9999,0,9999,0
1668078704577,CSE 293,035,119430,Stefan; Deian,9999,0,9999,0
1668078704577,CSE 293,036,119431,Su; Hao,9999,0,9999,0
1668078704577,CSE 293,037,119433,Swanson; Steven James,9999,0,9999,0
1668078704577,CSE 293,038,119435,Tullsen; Dean Michael,9999,0,9999,0
1668078704577,CSE 293,039,119483,Voelker; Geoffrey M.,9999,0,9999,0
1668078704577,CSE 293,040,119537,Zhao; Jishen,9999,0,9999,0
1668078704577,CSE 293,041,119538,Zhou; Yuan-Yuan,9999,0,9999,0
1668078704577,CSE 293,042,119539,Gao; Sicun,9999,0,9999,0
1668078704577,CSE 293,043,119540,Weibel; Nadir,9999,0,9999,0
1668078704577,CSE 293,044,119541,Gupta; Rajesh K.,9999,0,9999,0
1668078704577,CSE 293,045,126410,Vaccaro; Kristen Marie,9999,0,9999,0
1668078704577,CSE 293,046,126411,Klemke; Richard,9999,0,9999,0
1668078705006,CSE 294,A00,102459,Voelker; Geoffrey M.,0,0,0,0
1668078705006,CSE 294,B00,111322,Orailoglu; Alex,0,0,0,0
1668078705431,DSE 201,A00,096914,Deutsch; Alin Bernard,30,0,30,0
1668078705859,DSE 210,A00,096915,Dasgupta; Sanjoy,30,0,30,0
1668078706282,DSE 260A,A00,096916,Altintas De Callaf; Ilkay,30,0,30,0
1668078706733,ECE 200,001,103586,Antipa; Nicholas A,9999,0,9999,0
1668078706733,ECE 200,002,103587,Atanasov; Nikolay A.,9999,0,9999,0
1668078706733,ECE 200,003,103588,Bharadia; Dinesh,9999,0,9999,0
1668078706733,ECE 200,004,103589,Cheng; Chung Kuan,9999,0,9999,0
1668078706733,ECE 200,005,103590,Cosman; Pamela C.,9999,0,9999,0
1668078706733,ECE 200,006,103591,Dayeh; Shadi Ahmad,9999,0,9999,0
1668078706733,ECE 200,007,103592,Fainman; Yeshaiahu,9999,0,9999,0
1668078706733,ECE 200,008,103593,Ford; Joseph Earl,9999,0,9999,0
1668078706733,ECE 200,009,103594,Franceschetti; Massimo,9999,0,9999,0
1668078706733,ECE 200,010,103595,Fullerton; Eric E,9999,0,9999,0
1668078706733,ECE 200,011,103596,Galton; Ian A,9999,0,9999,0
1668078706733,ECE 200,012,103597,Gilja; Vikash,9999,0,9999,0
1668078706733,ECE 200,013,103598,Hall; Drew A.,9999,0,9999,0
1668078706733,ECE 200,014,103599,Hsueh; Tzu-Chien,9999,0,9999,0
1668078706733,ECE 200,015,103600,Javidi; Tara,9999,0,9999,0
1668078706733,ECE 200,016,103601,Kahng; Andrew Byun,9999,0,9999,0
1668078706733,ECE 200,017,103602,Kim; Young-Han,9999,0,9999,0
1668078706733,ECE 200,018,103603,Koushanfar; Farinaz,9999,0,9999,0
1668078706733,ECE 200,019,103604,Kuzum; Duygu,9999,0,9999,0
1668078706733,ECE 200,020,103605,Le; Hanh-Phuc,9999,0,9999,0
1668078706733,ECE 200,021,103606,Lin; Bill,9999,0,9999,0
1668078706733,ECE 200,022,103607,Liu; Zhaowei,9998,0,9999,1
1668078706733,ECE 200,023,103608,Lo; Yu-Hwa,9999,0,9999,0
1668078706733,ECE 200,024,103609,Lomakin; Vitaliy,9999,0,9999,0
1668078706733,ECE 200,025,103610,Mercier; Patrick Philip,9999,0,9999,0
1668078706733,ECE 200,026,103611,Meyer; Florian,9999,0,9999,0
1668078706733,ECE 200,027,103612,Milstein; Laurence B.,9999,0,9999,0
1668078706733,ECE 200,028,103613,Mir Arabbaygi; Siavash,9999,0,9999,0
1668078706733,ECE 200,029,103614,Mookherjea; Shayan,9999,0,9999,0
1668078706733,ECE 200,030,103615,Morris; Karcher William,9999,0,9999,0
1668078706733,ECE 200,031,103616,Ng; Tse Nga,9999,0,9999,0
1668078706733,ECE 200,032,103617,Nguyen; Truong Quang,9999,0,9999,0
1668078706733,ECE 200,033,103618,Nomura; Kenji,9999,0,9999,0
1668078706733,ECE 200,034,103619,Orlitsky; Alon,9999,0,9999,0
1668078706733,ECE 200,035,103620,Pal; Piya,9999,0,9999,0
1668078706733,ECE 200,036,103621,Papen; George C.,9999,0,9999,0
1668078706733,ECE 200,037,103622,Radic; Stojan,9999,0,9999,0
1668078706733,ECE 200,038,103623,Rao; Bhaskar D.,9999,0,9999,0
1668078706733,ECE 200,039,103624,Rao; Ramesh R,9999,0,9999,0
1668078706733,ECE 200,040,103625,Rebeiz; Gabriel,9999,0,9999,0
1668078706733,ECE 200,041,103626,Sanford; John R,9999,0,9999,0
1668078706733,ECE 200,042,103627,Siegel; Paul H.,9999,0,9999,0
1668078706733,ECE 200,043,103628,Sievenpiper; Daniel F.,9999,0,9999,0
1668078706733,ECE 200,044,103629,Sworder; David D.,9999,0,9999,0
1668078706733,ECE 200,045,103630,Taur; Yuan,9999,0,9999,0
1668078706733,ECE 200,046,103631,Touri; Behrouz,9999,0,9999,0
1668078706733,ECE 200,047,103632,Trivedi; Mohan M.,9999,0,9999,0
1668078706733,ECE 200,048,103633,Vasconcelos; Nuno,9999,0,9999,0
1668078706733,ECE 200,049,103634,Wang; Xiaolong,9999,0,9999,0
1668078706733,ECE 200,050,103635,Xie; Pengtao,9999,0,9999,0
1668078706733,ECE 200,051,103636,Yip; Michael,9999,0,9999,0
1668078706733,ECE 200,052,103637,Zeger; Kenneth A.,999,0,999,0
1668078706733,ECE 200,053,103638,Zhang; Xinyu,9999,0,9999,0
1668078706733,ECE 200,054,103639,Turakhia; Yatish Girish,9999,0,9999,0
1668078706733,ECE 200,055,103640,Kang; Mingu,9999,0,9999,0
1668078706733,ECE 200,056,103641,Shi; Yuanyuan,9999,0,9999,0
1668078706733,ECE 200,057,103642,Wang; Edward Jay,9999,0,9999,0
1668078706733,ECE 200,058,103643,Zheng; Yang,9999,0,9999,0
1668078707159,ECE 202,A00,103644,Kuzum; Duygu,0,0,0,0
1668078707582,ECE 212BN,A00,103646,Ng; Tse Nga,0,0,0,0
1668078708008,ECE 221,A00,111493,Staff,0,0,0,0
1668078708436,ECE 222B,A00,103647,Lomakin; Vitaliy,0,0,0,0
1668078708860,ECE 230B,A00,103648,Taur; Yuan,0,0,0,0
1668078709284,ECE 238B,A00,103649,Garay; Javier,0,0,0,0
1668078709708,ECE 240B,A00,112900,Fainman; Yeshaiahu,0,0,0,0
1668078710132,ECE 247A,A00,103650,Jokerst; Jesse Vincent,0,0,0,0
1668078710558,ECE 247B,A00,103651,Wang; Joseph,0,0,0,0
1668078710982,ECE 250,A00,103652,Siegel; Paul H.,0,0,0,0
1668078711409,ECE 251A,A00,103654,Rao; Bhaskar D.,0,0,0,0
1668078711834,ECE 257B,A00,103655,Bharadia; Dinesh,0,0,0,0
1668078712263,ECE 258A,A00,103656,Milstein; Laurence B.,0,0,0,0
1668078712699,ECE 260B,A00,103658,Kang; Mingu,0,0,0,0
1668078713135,ECE 264A,A00,103659,Galton; Ian A,0,0,0,0
1668078713560,ECE 265A,A00,103661,Gudem; Prasad S.S.,0,0,0,0
1668078713987,ECE 265D,A00,103662,Gudem; Prasad S.S.,0,0,0,0
1668078714500,ECE 268,A00,103663,Koushanfar; Farinaz,0,0,0,0
1668078714924,ECE 269,A01,103665,Pal; Piya,0,0,0,0
1668078715350,ECE 271B,A00,103666,Vasconcelos; Manuela,0,0,0,0
1668078715777,ECE 276A,A00,103667,Atanasov; Nikolay A.,0,0,0,0
1668078716203,ECE 277,A00,103668,An; Cheolhong,0,0,0,0
1668078716629,ECE 279,A00,117947,Hall; Drew A.,0,0,0,0
1668078717485,ECE 283,A00,103670,Hsueh; Tzu-Chien,0,0,0,0
1668078717914,ECE 284,A00,103671,Turakhia; Yatish Girish,0,0,0,0
1668078718342,ECE 285,A00,103672,Zheng; Yang,0,0,0,0
1668078718342,ECE 285,B00,103673,Sworder; David D.,0,0,0,0
1668078718765,ECE 287,A00,103676,Javidi; Tara,0,0,0,0
1668078719189,MATH 200B,A00,098023,Salehi Golsefidy; Alireza,13,0,15,2
1668078719618,MATH 202B,A00,098024,Rhoades; Brendon Patrick,9,0,15,6
1668078720044,MATH 203B,A00,098025,Oprea; Dragos N.,10,0,15,5
1668078720467,MATH 204B,A00,098026,Sorensen; Claus M,13,0,15,2
1668078720892,MATH 208,A00,098027,Izadi; Elham,7,0,10,3
1668078721315,MATH 209,A00,098028,Pollack; Aaron,10,0,10,0
1668078721744,MATH 211A,A00,112919,Rogalski; Daniel,9,0,10,1
1668078722172,MATH 211B,A00,112920,Seward; Brandon M.,9,0,10,1
1668078722596,MATH 218,A00,098029,Li; Bo,10,0,10,0
1668078723024,MATH 220B,A00,098030,Novak; Jonathan I,12,0,15,3
1668078723449,MATH 221A,A00,098031,Ebenfelt; Peter F,13,0,15,2
1668078723872,MATH 231B,A00,098032,Zlatos; Andrej,12,0,15,3
1668078724297,MATH 240B,A00,098033,Ni; Lei,9,0,15,6
1668078724721,MATH 243,A00,098034,Jekel; David Andrew,10,0,10,0
1668078725146,MATH 245A,A00,098035,Nie; Jiawang,0,0,15,16
1668078725569,MATH 248,A00,098036,Bejenaru; Ioan,10,0,10,0
1668078725997,MATH 250B,A00,098037,Spolaor; Luca,14,0,15,1
1668078726420,MATH 258,A00,098038,Ni; Lei,10,0,10,0
1668078726846,MATH 264B,A00,098041,Rhoades; Brendon Patrick,10,0,15,5
1668078727272,MATH 268,A00,098042,Buss; Samuel R,10,0,10,0
1668078727697,MATH 269,A00,098043,Rhoades; Brendon Patrick,10,0,10,0
1668078728123,MATH 270B,A00,098044,Li; Bo,11,0,15,4
1668078728557,MATH 272B,A00,098045,Holst; Michael J,13,0,15,2
1668078728982,MATH 273A,A00,098046,Tian; Xiaochuan,10,0,15,5
1668078729412,MATH 275,A01,098048,Tian; Xiaochuan,6,0,10,4
1668078729835,MATH 278A,A00,098049,Holst; Michael J,8,0,10,2
1668078730271,MATH 278B,A00,098050,Cloninger; Alexander,10,0,10,0
1668078730696,MATH 278C,A00,098051,Nie; Jiawang,7,0,10,3
1668078731120,MATH 280B,A00,098052,Zheng; Tianyi,10,0,15,5
1668078731555,MATH 281B,A00,098053,Bradic; Jelena,3,0,15,12
1668078731996,MATH 282B,A00,098054,Arias-Castro; Ery,0,0,15,15
1668078732427,MATH 285,A00,098055,Fitzsimmons; Patrick J,0,0,15,17
1668078732856,MATH 287B,A00,098056,Arias-Castro; Ery,3,0,15,12
1668078733282,MATH 288,A00,098057,Agarwal; Pooja,9,0,10,1
1668078733282,MATH 288,B00,098058,Zhang; Danna,8,0,10,2
1668078733282,MATH 288,C00,098059,Williams; Ruth J,10,0,10,0
1668078733713,MATH 290B,A00,098060,Roberts; Justin Deritter,13,0,15,2
1668078734138,MATH 292,A00,098061,Belmont; Eva Kinoshita,10,0,10,0
1668078734563,MATH 295,A00,098062,Suk; Andrew Hoon,48,0,50,2
1668078734989,MATH 296,A00,098063,Novak; Jonathan I,20,0,20,0
1668078735416,MATH 297,001,098064,Gamst; Anthony Collins,9997,0,9999,2
1668079235090,COGS 205,A00,101395,Chiba; Andrea,19,0,20,1
1668079235517,COGS 210B,001,101404,Greene; Deanna Jacquelyn,9998,0,9999,1
1668079235517,COGS 210B,002,101417,Xia; Haijun,9999,0,9999,0
1668079235517,COGS 210B,003,101422,Nitz; Douglas A.,9999,0,9999,0
1668079235517,COGS 210B,004,101423,Hollan; James D.,9998,0,9999,1
1668079235517,COGS 210B,005,101424,Deak; Gedeon O.,9998,0,9999,1
1668079235517,COGS 210B,006,101425,Rossano; Federico,9999,0,9999,0
1668079235942,COGS 211B,A00,101427,Coulson; Seana M,9996,0,9999,3
1668079236369,COGS 220,A00,101428,Hollan; James D.,0,0,25,25
1668079236792,COGS 229,A00,101429,Dow; Steven P,18,0,25,7
1668079237222,COGS 230,A00,101430,Klemmer; Scott R,13,0,17,4
1668079237652,COGS 234,A00,101431,Xia; Haijun,3,0,25,22
1668079238076,COGS 260,A00,101432,Kiyonaga; Anastasia,19,0,25,6
1668079238076,COGS 260,B00,101433,Kirsh; David Joel,16,0,25,9
1668079238502,CSE 202,A00,102371,Impagliazzo; Russell,0,0,0,0
1668079238932,CSE 203B,A01,102373,Cheng; Chung Kuan,0,0,0,0
1668079239355,CSE 208,A00,102374,Micciancio; Daniele,0,0,0,0
1668079239782,CSE 209A,A00,112895,Impagliazzo; Russell,0,0,15,15
1668079240206,CSE 209B,A00,108005,Bellare; Mihir,0,0,0,0
1668079240630,CSE 210,A00,113163,Coblenz; Michael J,0,0,0,0
1668079241054,CSE 219,A00,106111,Dow; Steven P,0,0,20,20
1668079241478,CSE 221,A00,102376,Voelker; Geoffrey M.,0,0,0,0
1668079241904,CSE 224,A01,102378,Porter; George M,0,0,0,0
1668079242329,CSE 229A,A00,102379,Savage; Stefan,0,0,0,0
1668079242753,CSE 229C,A00,102380,Munyaka; Imani N. S.,0,0,0,0
1668079243179,CSE 232B,A00,102382,Deutsch; Alin Bernard,0,0,0,0
1668079243606,CSE 234,A01,112904,Kumar; Arun Kumar,0,0,0,0
1668079244028,CSE 237A,A00,102383,Rosing; Tajana Simunic,0,0,0,0
1668079244453,CSE 239A,A00,102384,Deutsch; Alin Bernard,0,0,0,0
1668079244876,CSE 239B,A00,102385,Polikarpova; Nadezhda,0,0,0,0
1668079245300,CSE 240A,A00,102386,Pannuto; Patrick William,0,0,0,0
1668079245726,CSE 240B,A00,102387,Zhao; Jishen,0,0,0,0
1668079246153,CSE 241A,A00,106406,Kang; Mingu,0,0,0,0
1668079246577,CSE 249B,A00,102388,Kahng; Andrew Byun,0,0,8,8
1668079247001,CSE 251B,A01,102392,Cottrell; Garrison W,0,0,0,0
1668079247001,CSE 251B,A02,102393,Cottrell; Garrison W,0,0,0,0
1668079247425,CSE 252B,A00,102394,Ochoa; Benjamin Lawrence,0,0,0,0
1668079247854,CSE 257,A01,102396,Gao; Sicun,0,0,0,0
1668079248278,CSE 272,A00,102397,Li; Tzumao,0,0,0,0
1668079248713,CSE 274,A00,111323,Chern; Albert Ren-Haur,0,0,0,0
1668079249140,CSE 282,A00,102398,Pevzner; Pavel Arkadjevich,0,0,0,0
1668079249563,CSE 284,A00,114175,Gymrek; Melissa Ann,0,0,0,0
1668079249991,CSE 290,A00,102399,Chandraker; Manmohan Krishna,0,0,0,0
1668079249991,CSE 290,B00,102400,Vaccaro; Kristen Marie,0,0,25,25
1668079249991,CSE 290,C00,102414,Pannuto; Patrick William,0,0,25,25
1668079249991,CSE 290,D00,102427,Pevzner; Pavel Arkadjevich,0,0,0,0
1668079249991,CSE 290,E00,102429,Zhao; Jishen,0,0,0,0
1668079249991,CSE 290,F00,102436,Tullsen; Dean Michael,0,0,0,0
1668079249991,CSE 290,G00,102440,Christensen; Henrik I,0,0,20,20
1668079250420,CSE 291,A00,102443,Su; Hao,0,0,0,0
1668079250420,CSE 291,B00,102448,Polikarpova; Nadezhda,0,0,0,0
1668079250420,CSE 291,C00,102453,Vaccaro; Kristen Marie,0,0,0,0
1668079250420,CSE 291,D00,111343,Savage; Stefan,0,0,0,0
1668079250420,CSE 291,E00,116474,Claffy; Kimberly Claire,0,0,0,0
1668079250420,CSE 291,F00,116479,Pasquale; Joseph,0,0,0,0
1668079250855,CSE 293,001,119111,Bafna; Vineet,9999,0,9999,0
1668079250855,CSE 293,002,119118,Bellare; Mihir,9999,0,9999,0
1668079250855,CSE 293,003,119122,Berg-Kirkpatrick; Taylor D,9999,0,9999,0
1668079250855,CSE 293,004,119135,Christensen; Henrik I,9999,0,9999,0
1668079250855,CSE 293,005,119142,Cottrell; Garrison W,9999,0,9999,0
1668079250855,CSE 293,006,119146,Deutsch; Alin Bernard,9999,0,9999,0
1668079250855,CSE 293,007,119159,Esmaeilzadeh; Hadi,9999,0,9999,0
1668079250855,CSE 293,008,119166,Freund; Yoav,9999,0,9999,0
1668079250855,CSE 293,009,119170,Griswold; William G.,9999,0,9999,0
1668079250855,CSE 293,010,119183,Gymrek; Melissa Ann,9999,0,9999,0
1668079250855,CSE 293,011,119190,Heninger; Nadia A,9999,0,9999,0
1668079250855,CSE 293,012,119230,Impagliazzo; Russell,9999,0,9999,0
1668079250855,CSE 293,013,119232,Jhala; Ranjit,9999,0,9999,0
1668079250855,CSE 293,014,119233,Kahng; Andrew Byun,9999,0,9999,0
1668079250855,CSE 293,015,119298,Kane; Daniel Mertz,9999,0,9999,0
1668079250855,CSE 293,016,119299,Kriegman; David J,9999,0,9999,0
1668079250855,CSE 293,017,119300,Kumar; Arun Kumar,9999,0,9999,0
1668079250855,CSE 293,018,119301,Lerner; Sorin,9999,0,9999,0
1668079250855,CSE 293,019,119302,Lovett; Shachar,9999,0,9999,0
1668079250855,CSE 293,020,119303,McAuley; Julian John,9999,0,9999,0
1668079250855,CSE 293,021,119304,Micciancio; Daniele,9999,0,9999,0
1668079250855,CSE 293,022,119367,Orailoglu; Alex,9999,0,9999,0
1668079250855,CSE 293,023,119382,Paturi; Ramamohan,9999,0,9999,0
1668079250855,CSE 293,024,119404,Polikarpova; Nadezhda,9999,0,9999,0
1668079250855,CSE 293,025,119406,Politz; Joseph Gibbs,9999,0,9999,0
1668079250855,CSE 293,026,119411,Porter; George M,9999,0,9999,0
1668079250855,CSE 293,027,119414,Porter; Leonard Emerson,9999,0,9999,0
1668079250855,CSE 293,028,119416,Ramamoorthi; Ravi,9999,0,9999,0
1668079250855,CSE 293,029,119417,Sahoo; Debashis,9999,0,9999,0
1668079250855,CSE 293,030,119420,Saul; Lawrence,9999,0,9999,0
1668079250855,CSE 293,031,119421,Savage; Stefan,9999,0,9999,0
1668079250855,CSE 293,032,119425,Schulze; Jurgen P.,9999,0,9999,0
1668079250855,CSE 293,033,119426,Snoeren; Alex C.,9999,0,9999,0
1668079250855,CSE 293,034,119428,Shang; Jingbo,9999,0,9999,0
1668079250855,CSE 293,035,119430,Stefan; Deian,9999,0,9999,0
1668079250855,CSE 293,036,119431,Su; Hao,9999,0,9999,0
1668079250855,CSE 293,037,119433,Swanson; Steven James,9999,0,9999,0
1668079250855,CSE 293,038,119435,Tullsen; Dean Michael,9999,0,9999,0
1668079250855,CSE 293,039,119483,Voelker; Geoffrey M.,9999,0,9999,0
1668079250855,CSE 293,040,119537,Zhao; Jishen,9999,0,9999,0
1668079250855,CSE 293,041,119538,Zhou; Yuan-Yuan,9999,0,9999,0
1668079250855,CSE 293,042,119539,Gao; Sicun,9999,0,9999,0
1668079250855,CSE 293,043,119540,Weibel; Nadir,9999,0,9999,0
1668079250855,CSE 293,044,119541,Gupta; Rajesh K.,9999,0,9999,0
1668079250855,CSE 293,045,126410,Vaccaro; Kristen Marie,9999,0,9999,0
1668079250855,CSE 293,046,126411,Klemke; Richard,9999,0,9999,0
1668079251280,CSE 294,A00,102459,Voelker; Geoffrey M.,0,0,0,0
1668079251280,CSE 294,B00,111322,Orailoglu; Alex,0,0,0,0
1668079251704,DSE 201,A00,096914,Deutsch; Alin Bernard,30,0,30,0
1668079252130,DSE 210,A00,096915,Dasgupta; Sanjoy,30,0,30,0
1668079252555,DSE 260A,A00,096916,Altintas De Callaf; Ilkay,30,0,30,0
1668079252990,ECE 200,001,103586,Antipa; Nicholas A,9999,0,9999,0
1668079252990,ECE 200,002,103587,Atanasov; Nikolay A.,9999,0,9999,0
1668079252990,ECE 200,003,103588,Bharadia; Dinesh,9999,0,9999,0
1668079252990,ECE 200,004,103589,Cheng; Chung Kuan,9999,0,9999,0
1668079252990,ECE 200,005,103590,Cosman; Pamela C.,9999,0,9999,0
1668079252990,ECE 200,006,103591,Dayeh; Shadi Ahmad,9999,0,9999,0
1668079252990,ECE 200,007,103592,Fainman; Yeshaiahu,9999,0,9999,0
1668079252990,ECE 200,008,103593,Ford; Joseph Earl,9999,0,9999,0
1668079252990,ECE 200,009,103594,Franceschetti; Massimo,9999,0,9999,0
1668079252990,ECE 200,010,103595,Fullerton; Eric E,9999,0,9999,0
1668079252990,ECE 200,011,103596,Galton; Ian A,9999,0,9999,0
1668079252990,ECE 200,012,103597,Gilja; Vikash,9999,0,9999,0
1668079252990,ECE 200,013,103598,Hall; Drew A.,9999,0,9999,0
1668079252990,ECE 200,014,103599,Hsueh; Tzu-Chien,9999,0,9999,0
1668079252990,ECE 200,015,103600,Javidi; Tara,9999,0,9999,0
1668079252990,ECE 200,016,103601,Kahng; Andrew Byun,9999,0,9999,0
1668079252990,ECE 200,017,103602,Kim; Young-Han,9999,0,9999,0
1668079252990,ECE 200,018,103603,Koushanfar; Farinaz,9999,0,9999,0
1668079252990,ECE 200,019,103604,Kuzum; Duygu,9999,0,9999,0
1668079252990,ECE 200,020,103605,Le; Hanh-Phuc,9999,0,9999,0
1668079252990,ECE 200,021,103606,Lin; Bill,9999,0,9999,0
1668079252990,ECE 200,022,103607,Liu; Zhaowei,9998,0,9999,1
1668079252990,ECE 200,023,103608,Lo; Yu-Hwa,9999,0,9999,0
1668079252990,ECE 200,024,103609,Lomakin; Vitaliy,9999,0,9999,0
1668079252990,ECE 200,025,103610,Mercier; Patrick Philip,9999,0,9999,0
1668079252990,ECE 200,026,103611,Meyer; Florian,9999,0,9999,0
1668079252990,ECE 200,027,103612,Milstein; Laurence B.,9999,0,9999,0
1668079252990,ECE 200,028,103613,Mir Arabbaygi; Siavash,9999,0,9999,0
1668079252990,ECE 200,029,103614,Mookherjea; Shayan,9999,0,9999,0
1668079252990,ECE 200,030,103615,Morris; Karcher William,9999,0,9999,0
1668079252990,ECE 200,031,103616,Ng; Tse Nga,9999,0,9999,0
1668079252990,ECE 200,032,103617,Nguyen; Truong Quang,9999,0,9999,0
1668079252990,ECE 200,033,103618,Nomura; Kenji,9999,0,9999,0
1668079252990,ECE 200,034,103619,Orlitsky; Alon,9999,0,9999,0
1668079252990,ECE 200,035,103620,Pal; Piya,9999,0,9999,0
1668079252990,ECE 200,036,103621,Papen; George C.,9999,0,9999,0
1668079252990,ECE 200,037,103622,Radic; Stojan,9999,0,9999,0
1668079252990,ECE 200,038,103623,Rao; Bhaskar D.,9999,0,9999,0
1668079252990,ECE 200,039,103624,Rao; Ramesh R,9999,0,9999,0
1668079252990,ECE 200,040,103625,Rebeiz; Gabriel,9999,0,9999,0
1668079252990,ECE 200,041,103626,Sanford; John R,9999,0,9999,0
1668079252990,ECE 200,042,103627,Siegel; Paul H.,9999,0,9999,0
1668079252990,ECE 200,043,103628,Sievenpiper; Daniel F.,9999,0,9999,0
1668079252990,ECE 200,044,103629,Sworder; David D.,9999,0,9999,0
1668079252990,ECE 200,045,103630,Taur; Yuan,9999,0,9999,0
1668079252990,ECE 200,046,103631,Touri; Behrouz,9999,0,9999,0
1668079252990,ECE 200,047,103632,Trivedi; Mohan M.,9999,0,9999,0
1668079252990,ECE 200,048,103633,Vasconcelos; Nuno,9999,0,9999,0
1668079252990,ECE 200,049,103634,Wang; Xiaolong,9999,0,9999,0
1668079252990,ECE 200,050,103635,Xie; Pengtao,9999,0,9999,0
1668079252990,ECE 200,051,103636,Yip; Michael,9999,0,9999,0
1668079252990,ECE 200,052,103637,Zeger; Kenneth A.,999,0,999,0
1668079252990,ECE 200,053,103638,Zhang; Xinyu,9999,0,9999,0
1668079252990,ECE 200,054,103639,Turakhia; Yatish Girish,9999,0,9999,0
1668079252990,ECE 200,055,103640,Kang; Mingu,9999,0,9999,0
1668079252990,ECE 200,056,103641,Shi; Yuanyuan,9999,0,9999,0
1668079252990,ECE 200,057,103642,Wang; Edward Jay,9999,0,9999,0
1668079252990,ECE 200,058,103643,Zheng; Yang,9999,0,9999,0
1668079253417,ECE 202,A00,103644,Kuzum; Duygu,0,0,0,0
1668079253839,ECE 212BN,A00,103646,Ng; Tse Nga,0,0,0,0
1668079254263,ECE 221,A00,111493,Staff,0,0,0,0
1668079254686,ECE 222B,A00,103647,Lomakin; Vitaliy,0,0,0,0
1668079255111,ECE 230B,A00,103648,Taur; Yuan,0,0,0,0
1668079255537,ECE 238B,A00,103649,Garay; Javier,0,0,0,0
1668079255962,ECE 240B,A00,112900,Fainman; Yeshaiahu,0,0,0,0
1668079256390,ECE 247A,A00,103650,Jokerst; Jesse Vincent,0,0,0,0
1668079256814,ECE 247B,A00,103651,Wang; Joseph,0,0,0,0
1668079257240,ECE 250,A00,103652,Siegel; Paul H.,0,0,0,0
1668079257666,ECE 251A,A00,103654,Rao; Bhaskar D.,0,0,0,0
1668079258093,ECE 257B,A00,103655,Bharadia; Dinesh,0,0,0,0
1668079258523,ECE 258A,A00,103656,Milstein; Laurence B.,0,0,0,0
1668079258947,ECE 260B,A00,103658,Kang; Mingu,0,0,0,0
1668079259372,ECE 264A,A00,103659,Galton; Ian A,0,0,0,0
1668079259802,ECE 265A,A00,103661,Gudem; Prasad S.S.,0,0,0,0
1668079260227,ECE 265D,A00,103662,Gudem; Prasad S.S.,0,0,0,0
1668079260651,ECE 268,A00,103663,Koushanfar; Farinaz,0,0,0,0
1668079261074,ECE 269,A01,103665,Pal; Piya,0,0,0,0
1668079261511,ECE 271B,A00,103666,Vasconcelos; Manuela,0,0,0,0
1668079261951,ECE 276A,A00,103667,Atanasov; Nikolay A.,0,0,0,0
1668079262375,ECE 277,A00,103668,An; Cheolhong,0,0,0,0
1668079262798,ECE 279,A00,117947,Hall; Drew A.,0,0,0,0
1668079263652,ECE 283,A00,103670,Hsueh; Tzu-Chien,0,0,0,0
1668079264077,ECE 284,A00,103671,Turakhia; Yatish Girish,0,0,0,0
1668079264507,ECE 285,A00,103672,Zheng; Yang,0,0,0,0
1668079264507,ECE 285,B00,103673,Sworder; David D.,0,0,0,0
1668079264934,ECE 287,A00,103676,Javidi; Tara,0,0,0,0
1668079265358,MATH 200B,A00,098023,Salehi Golsefidy; Alireza,13,0,15,2
1668079265783,MATH 202B,A00,098024,Rhoades; Brendon Patrick,9,0,15,6
1668079266206,MATH 203B,A00,098025,Oprea; Dragos N.,10,0,15,5
1668079266628,MATH 204B,A00,098026,Sorensen; Claus M,13,0,15,2
1668079267051,MATH 208,A00,098027,Izadi; Elham,7,0,10,3
1668079267477,MATH 209,A00,098028,Pollack; Aaron,10,0,10,0
1668079267902,MATH 211A,A00,112919,Rogalski; Daniel,9,0,10,1
1668079268323,MATH 211B,A00,112920,Seward; Brandon M.,9,0,10,1
1668079268755,MATH 218,A00,098029,Li; Bo,10,0,10,0
1668079269179,MATH 220B,A00,098030,Novak; Jonathan I,12,0,15,3
1668079269608,MATH 221A,A00,098031,Ebenfelt; Peter F,13,0,15,2
1668079270034,MATH 231B,A00,098032,Zlatos; Andrej,12,0,15,3
1668079270459,MATH 240B,A00,098033,Ni; Lei,9,0,15,6
1668079270882,MATH 243,A00,098034,Jekel; David Andrew,10,0,10,0
1668079271314,MATH 245A,A00,098035,Nie; Jiawang,0,0,15,16
1668079271738,MATH 248,A00,098036,Bejenaru; Ioan,10,0,10,0
1668079272162,MATH 250B,A00,098037,Spolaor; Luca,14,0,15,1
1668079272587,MATH 258,A00,098038,Ni; Lei,10,0,10,0
1668079273026,MATH 264B,A00,098041,Rhoades; Brendon Patrick,10,0,15,5
1668079273452,MATH 268,A00,098042,Buss; Samuel R,10,0,10,0
1668079273884,MATH 269,A00,098043,Rhoades; Brendon Patrick,10,0,10,0
1668079274310,MATH 270B,A00,098044,Li; Bo,11,0,15,4
1668079274746,MATH 272B,A00,098045,Holst; Michael J,13,0,15,2
1668079275170,MATH 273A,A00,098046,Tian; Xiaochuan,10,0,15,5
1668079275592,MATH 275,A01,098048,Tian; Xiaochuan,6,0,10,4
1668079276017,MATH 278A,A00,098049,Holst; Michael J,8,0,10,2
1668079276444,MATH 278B,A00,098050,Cloninger; Alexander,10,0,10,0
1668079276877,MATH 278C,A00,098051,Nie; Jiawang,7,0,10,3
1668079277378,MATH 280B,A00,098052,Zheng; Tianyi,10,0,15,5
1668079277801,MATH 281B,A00,098053,Bradic; Jelena,3,0,15,12
1668079278232,MATH 282B,A00,098054,Arias-Castro; Ery,0,0,15,15
1668079278660,MATH 285,A00,098055,Fitzsimmons; Patrick J,0,0,15,17
1668079279087,MATH 287B,A00,098056,Arias-Castro; Ery,3,0,15,12
1668079279513,MATH 288,A00,098057,Agarwal; Pooja,9,0,10,1
1668079279513,MATH 288,B00,098058,Zhang; Danna,8,0,10,2
1668079279513,MATH 288,C00,098059,Williams; Ruth J,10,0,10,0
1668079279943,MATH 290B,A00,098060,Roberts; Justin Deritter,13,0,15,2
1668079280372,MATH 292,A00,098061,Belmont; Eva Kinoshita,10,0,10,0
1668079280799,MATH 295,A00,098062,Suk; Andrew Hoon,48,0,50,2
1668079281220,MATH 296,A00,098063,Novak; Jonathan I,20,0,20,0
1668079281655,MATH 297,001,098064,Gamst; Anthony Collins,9997,0,9999,2
1668079781915,COGS 205,A00,101395,Chiba; Andrea,19,0,20,1
1668079782350,COGS 210B,001,101404,Greene; Deanna Jacquelyn,9998,0,9999,1
1668079782350,COGS 210B,002,101417,Xia; Haijun,9999,0,9999,0
1668079782350,COGS 210B,003,101422,Nitz; Douglas A.,9999,0,9999,0
1668079782350,COGS 210B,004,101423,Hollan; James D.,9998,0,9999,1
1668079782350,COGS 210B,005,101424,Deak; Gedeon O.,9998,0,9999,1
1668079782350,COGS 210B,006,101425,Rossano; Federico,9999,0,9999,0
1668079782773,COGS 211B,A00,101427,Coulson; Seana M,9996,0,9999,3
1668079783200,COGS 220,A00,101428,Hollan; James D.,0,0,25,25
1668079783628,COGS 229,A00,101429,Dow; Steven P,18,0,25,7
1668079784055,COGS 230,A00,101430,Klemmer; Scott R,13,0,17,4
1668079784479,COGS 234,A00,101431,Xia; Haijun,3,0,25,22
1668079784904,COGS 260,A00,101432,Kiyonaga; Anastasia,19,0,25,6
1668079784904,COGS 260,B00,101433,Kirsh; David Joel,16,0,25,9
1668079785329,CSE 202,A00,102371,Impagliazzo; Russell,0,0,0,0
1668079785756,CSE 203B,A01,102373,Cheng; Chung Kuan,0,0,0,0
1668079786186,CSE 208,A00,102374,Micciancio; Daniele,0,0,0,0
1668079786610,CSE 209A,A00,112895,Impagliazzo; Russell,0,0,15,15
1668079787038,CSE 209B,A00,108005,Bellare; Mihir,0,0,0,0
1668079787462,CSE 210,A00,113163,Coblenz; Michael J,0,0,0,0
1668079787887,CSE 219,A00,106111,Dow; Steven P,0,0,20,20
1668079788315,CSE 221,A00,102376,Voelker; Geoffrey M.,0,0,0,0
1668079788738,CSE 224,A01,102378,Porter; George M,0,0,0,0
1668079789163,CSE 229A,A00,102379,Savage; Stefan,0,0,0,0
1668079789587,CSE 229C,A00,102380,Munyaka; Imani N. S.,0,0,0,0
1668079790012,CSE 232B,A00,102382,Deutsch; Alin Bernard,0,0,0,0
1668079790440,CSE 234,A01,112904,Kumar; Arun Kumar,0,0,0,0
1668079790867,CSE 237A,A00,102383,Rosing; Tajana Simunic,0,0,0,0
1668079791294,CSE 239A,A00,102384,Deutsch; Alin Bernard,0,0,0,0
1668079791722,CSE 239B,A00,102385,Polikarpova; Nadezhda,0,0,0,0
1668079792148,CSE 240A,A00,102386,Pannuto; Patrick William,0,0,0,0
1668079792580,CSE 240B,A00,102387,Zhao; Jishen,0,0,0,0
1668079793011,CSE 241A,A00,106406,Kang; Mingu,0,0,0,0
1668079793437,CSE 249B,A00,102388,Kahng; Andrew Byun,0,0,8,8
1668079793874,CSE 251B,A01,102392,Cottrell; Garrison W,0,0,0,0
1668079793874,CSE 251B,A02,102393,Cottrell; Garrison W,0,0,0,0
1668079794302,CSE 252B,A00,102394,Ochoa; Benjamin Lawrence,0,0,0,0
1668079794728,CSE 257,A01,102396,Gao; Sicun,0,0,0,0
1668079795152,CSE 272,A00,102397,Li; Tzumao,0,0,0,0
1668079795576,CSE 274,A00,111323,Chern; Albert Ren-Haur,0,0,0,0
1668079796005,CSE 282,A00,102398,Pevzner; Pavel Arkadjevich,0,0,0,0
1668079796438,CSE 284,A00,114175,Gymrek; Melissa Ann,0,0,0,0
1668079796865,CSE 290,A00,102399,Chandraker; Manmohan Krishna,0,0,0,0
1668079796865,CSE 290,B00,102400,Vaccaro; Kristen Marie,0,0,25,25
1668079796865,CSE 290,C00,102414,Pannuto; Patrick William,0,0,25,25
1668079796865,CSE 290,D00,102427,Pevzner; Pavel Arkadjevich,0,0,0,0
1668079796865,CSE 290,E00,102429,Zhao; Jishen,0,0,0,0
1668079796865,CSE 290,F00,102436,Tullsen; Dean Michael,0,0,0,0
1668079796865,CSE 290,G00,102440,Christensen; Henrik I,0,0,20,20
1668079797290,CSE 291,A00,102443,Su; Hao,0,0,0,0
1668079797290,CSE 291,B00,102448,Polikarpova; Nadezhda,0,0,0,0
1668079797290,CSE 291,C00,102453,Vaccaro; Kristen Marie,0,0,0,0
1668079797290,CSE 291,D00,111343,Savage; Stefan,0,0,0,0
1668079797290,CSE 291,E00,116474,Claffy; Kimberly Claire,0,0,0,0
1668079797290,CSE 291,F00,116479,Pasquale; Joseph,0,0,0,0
1668079797808,CSE 293,001,119111,Bafna; Vineet,9999,0,9999,0
1668079797808,CSE 293,002,119118,Bellare; Mihir,9999,0,9999,0
1668079797808,CSE 293,003,119122,Berg-Kirkpatrick; Taylor D,9999,0,9999,0
1668079797808,CSE 293,004,119135,Christensen; Henrik I,9999,0,9999,0
1668079797808,CSE 293,005,119142,Cottrell; Garrison W,9999,0,9999,0
1668079797808,CSE 293,006,119146,Deutsch; Alin Bernard,9999,0,9999,0
1668079797808,CSE 293,007,119159,Esmaeilzadeh; Hadi,9999,0,9999,0
1668079797808,CSE 293,008,119166,Freund; Yoav,9999,0,9999,0
1668079797808,CSE 293,009,119170,Griswold; William G.,9999,0,9999,0
1668079797808,CSE 293,010,119183,Gymrek; Melissa Ann,9999,0,9999,0
1668079797808,CSE 293,011,119190,Heninger; Nadia A,9999,0,9999,0
1668079797808,CSE 293,012,119230,Impagliazzo; Russell,9999,0,9999,0
1668079797808,CSE 293,013,119232,Jhala; Ranjit,9999,0,9999,0
1668079797808,CSE 293,014,119233,Kahng; Andrew Byun,9999,0,9999,0
1668079797808,CSE 293,015,119298,Kane; Daniel Mertz,9999,0,9999,0
1668079797808,CSE 293,016,119299,Kriegman; David J,9999,0,9999,0
1668079797808,CSE 293,017,119300,Kumar; Arun Kumar,9999,0,9999,0
1668079797808,CSE 293,018,119301,Lerner; Sorin,9999,0,9999,0
1668079797808,CSE 293,019,119302,Lovett; Shachar,9999,0,9999,0
1668079797808,CSE 293,020,119303,McAuley; Julian John,9999,0,9999,0
1668079797808,CSE 293,021,119304,Micciancio; Daniele,9999,0,9999,0
1668079797808,CSE 293,022,119367,Orailoglu; Alex,9999,0,9999,0
1668079797808,CSE 293,023,119382,Paturi; Ramamohan,9999,0,9999,0
1668079797808,CSE 293,024,119404,Polikarpova; Nadezhda,9999,0,9999,0
1668079797808,CSE 293,025,119406,Politz; Joseph Gibbs,9999,0,9999,0
1668079797808,CSE 293,026,119411,Porter; George M,9999,0,9999,0
1668079797808,CSE 293,027,119414,Porter; Leonard Emerson,9999,0,9999,0
1668079797808,CSE 293,028,119416,Ramamoorthi; Ravi,9999,0,9999,0
1668079797808,CSE 293,029,119417,Sahoo; Debashis,9999,0,9999,0
1668079797808,CSE 293,030,119420,Saul; Lawrence,9999,0,9999,0
1668079797808,CSE 293,031,119421,Savage; Stefan,9999,0,9999,0
1668079797808,CSE 293,032,119425,Schulze; Jurgen P.,9999,0,9999,0
1668079797808,CSE 293,033,119426,Snoeren; Alex C.,9999,0,9999,0
1668079797808,CSE 293,034,119428,Shang; Jingbo,9999,0,9999,0
1668079797808,CSE 293,035,119430,Stefan; Deian,9999,0,9999,0
1668079797808,CSE 293,036,119431,Su; Hao,9999,0,9999,0
1668079797808,CSE 293,037,119433,Swanson; Steven James,9999,0,9999,0
1668079797808,CSE 293,038,119435,Tullsen; Dean Michael,9999,0,9999,0
1668079797808,CSE 293,039,119483,Voelker; Geoffrey M.,9999,0,9999,0
1668079797808,CSE 293,040,119537,Zhao; Jishen,9999,0,9999,0
1668079797808,CSE 293,041,119538,Zhou; Yuan-Yuan,9999,0,9999,0
1668079797808,CSE 293,042,119539,Gao; Sicun,9999,0,9999,0
1668079797808,CSE 293,043,119540,Weibel; Nadir,9999,0,9999,0
1668079797808,CSE 293,044,119541,Gupta; Rajesh K.,9999,0,9999,0
1668079797808,CSE 293,045,126410,Vaccaro; Kristen Marie,9999,0,9999,0
1668079797808,CSE 293,046,126411,Klemke; Richard,9999,0,9999,0
1668079798237,CSE 294,A00,102459,Voelker; Geoffrey M.,0,0,0,0
1668079798237,CSE 294,B00,111322,Orailoglu; Alex,0,0,0,0
1668079798664,DSE 201,A00,096914,Deutsch; Alin Bernard,30,0,30,0
1668079799091,DSE 210,A00,096915,Dasgupta; Sanjoy,30,0,30,0
1668079799529,DSE 260A,A00,096916,Altintas De Callaf; Ilkay,30,0,30,0
1668079799966,ECE 200,001,103586,Antipa; Nicholas A,9999,0,9999,0
1668079799966,ECE 200,002,103587,Atanasov; Nikolay A.,9999,0,9999,0
1668079799966,ECE 200,003,103588,Bharadia; Dinesh,9999,0,9999,0
1668079799966,ECE 200,004,103589,Cheng; Chung Kuan,9999,0,9999,0
1668079799966,ECE 200,005,103590,Cosman; Pamela C.,9999,0,9999,0
1668079799966,ECE 200,006,103591,Dayeh; Shadi Ahmad,9999,0,9999,0
1668079799966,ECE 200,007,103592,Fainman; Yeshaiahu,9999,0,9999,0
1668079799966,ECE 200,008,103593,Ford; Joseph Earl,9999,0,9999,0
1668079799966,ECE 200,009,103594,Franceschetti; Massimo,9999,0,9999,0
1668079799966,ECE 200,010,103595,Fullerton; Eric E,9999,0,9999,0
1668079799966,ECE 200,011,103596,Galton; Ian A,9999,0,9999,0
1668079799966,ECE 200,012,103597,Gilja; Vikash,9999,0,9999,0
1668079799966,ECE 200,013,103598,Hall; Drew A.,9999,0,9999,0
1668079799966,ECE 200,014,103599,Hsueh; Tzu-Chien,9999,0,9999,0
1668079799966,ECE 200,015,103600,Javidi; Tara,9999,0,9999,0
1668079799966,ECE 200,016,103601,Kahng; Andrew Byun,9999,0,9999,0
1668079799966,ECE 200,017,103602,Kim; Young-Han,9999,0,9999,0
1668079799966,ECE 200,018,103603,Koushanfar; Farinaz,9999,0,9999,0
1668079799966,ECE 200,019,103604,Kuzum; Duygu,9999,0,9999,0
1668079799966,ECE 200,020,103605,Le; Hanh-Phuc,9999,0,9999,0
1668079799966,ECE 200,021,103606,Lin; Bill,9999,0,9999,0
1668079799966,ECE 200,022,103607,Liu; Zhaowei,9998,0,9999,1
1668079799966,ECE 200,023,103608,Lo; Yu-Hwa,9999,0,9999,0
1668079799966,ECE 200,024,103609,Lomakin; Vitaliy,9999,0,9999,0
1668079799966,ECE 200,025,103610,Mercier; Patrick Philip,9999,0,9999,0
1668079799966,ECE 200,026,103611,Meyer; Florian,9999,0,9999,0
1668079799966,ECE 200,027,103612,Milstein; Laurence B.,9999,0,9999,0
1668079799966,ECE 200,028,103613,Mir Arabbaygi; Siavash,9999,0,9999,0
1668079799966,ECE 200,029,103614,Mookherjea; Shayan,9999,0,9999,0
1668079799966,ECE 200,030,103615,Morris; Karcher William,9999,0,9999,0
1668079799966,ECE 200,031,103616,Ng; Tse Nga,9999,0,9999,0
1668079799966,ECE 200,032,103617,Nguyen; Truong Quang,9999,0,9999,0
1668079799966,ECE 200,033,103618,Nomura; Kenji,9999,0,9999,0
1668079799966,ECE 200,034,103619,Orlitsky; Alon,9999,0,9999,0
1668079799966,ECE 200,035,103620,Pal; Piya,9999,0,9999,0
1668079799966,ECE 200,036,103621,Papen; George C.,9999,0,9999,0
1668079799966,ECE 200,037,103622,Radic; Stojan,9999,0,9999,0
1668079799966,ECE 200,038,103623,Rao; Bhaskar D.,9999,0,9999,0
1668079799966,ECE 200,039,103624,Rao; Ramesh R,9999,0,9999,0
1668079799966,ECE 200,040,103625,Rebeiz; Gabriel,9999,0,9999,0
1668079799966,ECE 200,041,103626,Sanford; John R,9999,0,9999,0
1668079799966,ECE 200,042,103627,Siegel; Paul H.,9999,0,9999,0
1668079799966,ECE 200,043,103628,Sievenpiper; Daniel F.,9999,0,9999,0
1668079799966,ECE 200,044,103629,Sworder; David D.,9999,0,9999,0
1668079799966,ECE 200,045,103630,Taur; Yuan,9999,0,9999,0
1668079799966,ECE 200,046,103631,Touri; Behrouz,9999,0,9999,0
1668079799966,ECE 200,047,103632,Trivedi; Mohan M.,9999,0,9999,0
1668079799966,ECE 200,048,103633,Vasconcelos; Nuno,9999,0,9999,0
1668079799966,ECE 200,049,103634,Wang; Xiaolong,9999,0,9999,0
1668079799966,ECE 200,050,103635,Xie; Pengtao,9999,0,9999,0
1668079799966,ECE 200,051,103636,Yip; Michael,9999,0,9999,0
1668079799966,ECE 200,052,103637,Zeger; Kenneth A.,999,0,999,0
1668079799966,ECE 200,053,103638,Zhang; Xinyu,9999,0,9999,0
1668079799966,ECE 200,054,103639,Turakhia; Yatish Girish,9999,0,9999,0
1668079799966,ECE 200,055,103640,Kang; Mingu,9999,0,9999,0
1668079799966,ECE 200,056,103641,Shi; Yuanyuan,9999,0,9999,0
1668079799966,ECE 200,057,103642,Wang; Edward Jay,9999,0,9999,0
1668079799966,ECE 200,058,103643,Zheng; Yang,9999,0,9999,0
1668079800393,ECE 202,A00,103644,Kuzum; Duygu,0,0,0,0
1668079800816,ECE 212BN,A00,103646,Ng; Tse Nga,0,0,0,0
1668079801245,ECE 221,A00,111493,Staff,0,0,0,0
1668079801675,ECE 222B,A00,103647,Lomakin; Vitaliy,0,0,0,0
1668079802099,ECE 230B,A00,103648,Taur; Yuan,0,0,0,0
1668079802523,ECE 238B,A00,103649,Garay; Javier,0,0,0,0
1668079802948,ECE 240B,A00,112900,Fainman; Yeshaiahu,0,0,0,0
1668079803380,ECE 247A,A00,103650,Jokerst; Jesse Vincent,0,0,0,0
1668079803804,ECE 247B,A00,103651,Wang; Joseph,0,0,0,0
1668079804227,ECE 250,A00,103652,Siegel; Paul H.,0,0,0,0
1668079804664,ECE 251A,A00,103654,Rao; Bhaskar D.,0,0,0,0
1668079805091,ECE 257B,A00,103655,Bharadia; Dinesh,0,0,0,0
1668079805514,ECE 258A,A00,103656,Milstein; Laurence B.,0,0,0,0
1668079805940,ECE 260B,A00,103658,Kang; Mingu,0,0,0,0
1668079806370,ECE 264A,A00,103659,Galton; Ian A,0,0,0,0
1668079806796,ECE 265A,A00,103661,Gudem; Prasad S.S.,0,0,0,0
1668079807223,ECE 265D,A00,103662,Gudem; Prasad S.S.,0,0,0,0
1668079807650,ECE 268,A00,103663,Koushanfar; Farinaz,0,0,0,0
1668079808076,ECE 269,A01,103665,Pal; Piya,0,0,0,0
1668079808502,ECE 271B,A00,103666,Vasconcelos; Manuela,0,0,0,0
1668079808924,ECE 276A,A00,103667,Atanasov; Nikolay A.,0,0,0,0
1668079809348,ECE 277,A00,103668,An; Cheolhong,0,0,0,0
1668079809775,ECE 279,A00,117947,Hall; Drew A.,0,0,0,0
1668079810622,ECE 283,A00,103670,Hsueh; Tzu-Chien,0,0,0,0
1668079811045,ECE 284,A00,103671,Turakhia; Yatish Girish,0,0,0,0
1668079811474,ECE 285,A00,103672,Zheng; Yang,0,0,0,0
1668079811474,ECE 285,B00,103673,Sworder; David D.,0,0,0,0
1668079811900,ECE 287,A00,103676,Javidi; Tara,0,0,0,0
1668079812328,MATH 200B,A00,098023,Salehi Golsefidy; Alireza,13,0,15,2
1668079812752,MATH 202B,A00,098024,Rhoades; Brendon Patrick,9,0,15,6
1668079813180,MATH 203B,A00,098025,Oprea; Dragos N.,10,0,15,5
1668079813608,MATH 204B,A00,098026,Sorensen; Claus M,13,0,15,2
1668079814036,MATH 208,A00,098027,Izadi; Elham,7,0,10,3
1668079814462,MATH 209,A00,098028,Pollack; Aaron,10,0,10,0
1668079814889,MATH 211A,A00,112919,Rogalski; Daniel,9,0,10,1
1668079815314,MATH 211B,A00,112920,Seward; Brandon M.,9,0,10,1
1668079815742,MATH 218,A00,098029,Li; Bo,10,0,10,0
1668079816167,MATH 220B,A00,098030,Novak; Jonathan I,12,0,15,3
1668079816592,MATH 221A,A00,098031,Ebenfelt; Peter F,13,0,15,2
1668079817019,MATH 231B,A00,098032,Zlatos; Andrej,12,0,15,3
1668079817450,MATH 240B,A00,098033,Ni; Lei,9,0,15,6
1668079817874,MATH 243,A00,098034,Jekel; David Andrew,10,0,10,0
1668079818312,MATH 245A,A00,098035,Nie; Jiawang,0,0,15,16
1668079818743,MATH 248,A00,098036,Bejenaru; Ioan,10,0,10,0
1668079819171,MATH 250B,A00,098037,Spolaor; Luca,14,0,15,1
1668079819594,MATH 258,A00,098038,Ni; Lei,10,0,10,0
1668079820019,MATH 264B,A00,098041,Rhoades; Brendon Patrick,10,0,15,5
1668079820448,MATH 268,A00,098042,Buss; Samuel R,10,0,10,0
1668079820878,MATH 269,A00,098043,Rhoades; Brendon Patrick,10,0,10,0
1668079821307,MATH 270B,A00,098044,Li; Bo,11,0,15,4
1668079821731,MATH 272B,A00,098045,Holst; Michael J,13,0,15,2
1668079822155,MATH 273A,A00,098046,Tian; Xiaochuan,10,0,15,5
1668079822582,MATH 275,A01,098048,Tian; Xiaochuan,6,0,10,4
1668079823005,MATH 278A,A00,098049,Holst; Michael J,8,0,10,2
1668079823428,MATH 278B,A00,098050,Cloninger; Alexander,10,0,10,0
1668079823853,MATH 278C,A00,098051,Nie; Jiawang,7,0,10,3
1668079824280,MATH 280B,A00,098052,Zheng; Tianyi,10,0,15,5
1668079824704,MATH 281B,A00,098053,Bradic; Jelena,3,0,15,12
1668079825130,MATH 282B,A00,098054,Arias-Castro; Ery,0,0,15,15
1668079825555,MATH 285,A00,098055,Fitzsimmons; Patrick J,0,0,15,17
1668079825979,MATH 287B,A00,098056,Arias-Castro; Ery,3,0,15,12
1668079826407,MATH 288,A00,098057,Agarwal; Pooja,9,0,10,1
1668079826407,MATH 288,B00,098058,Zhang; Danna,8,0,10,2
1668079826407,MATH 288,C00,098059,Williams; Ruth J,10,0,10,0
1668079826833,MATH 290B,A00,098060,Roberts; Justin Deritter,13,0,15,2
1668079827261,MATH 292,A00,098061,Belmont; Eva Kinoshita,10,0,10,0
1668079827686,MATH 295,A00,098062,Suk; Andrew Hoon,48,0,50,2
1668079828111,MATH 296,A00,098063,Novak; Jonathan I,20,0,20,0
1668079828536,MATH 297,001,098064,Gamst; Anthony Collins,9997,0,9999,2
1668080329895,COGS 205,A00,101395,Chiba; Andrea,19,0,20,1
1668080330335,COGS 210B,001,101404,Greene; Deanna Jacquelyn,9998,0,9999,1
1668080330335,COGS 210B,002,101417,Xia; Haijun,9999,0,9999,0
1668080330335,COGS 210B,003,101422,Nitz; Douglas A.,9999,0,9999,0
1668080330335,COGS 210B,004,101423,Hollan; James D.,9998,0,9999,1
1668080330335,COGS 210B,005,101424,Deak; Gedeon O.,9998,0,9999,1
1668080330335,COGS 210B,006,101425,Rossano; Federico,9999,0,9999,0
1668080330760,COGS 211B,A00,101427,Coulson; Seana M,9996,0,9999,3
1668080331190,COGS 220,A00,101428,Hollan; James D.,0,0,25,25
1668080331612,COGS 229,A00,101429,Dow; Steven P,18,0,25,7
1668080332037,COGS 230,A00,101430,Klemmer; Scott R,13,0,17,4
1668080332464,COGS 234,A00,101431,Xia; Haijun,3,0,25,22
1668080332888,COGS 260,A00,101432,Kiyonaga; Anastasia,19,0,25,6
1668080332888,COGS 260,B00,101433,Kirsh; David Joel,16,0,25,9
1668080333315,CSE 202,A00,102371,Impagliazzo; Russell,0,0,0,0
1668080333746,CSE 203B,A01,102373,Cheng; Chung Kuan,0,0,0,0
1668080334175,CSE 208,A00,102374,Micciancio; Daniele,0,0,0,0
1668080334599,CSE 209A,A00,112895,Impagliazzo; Russell,0,0,15,15
1668080335030,CSE 209B,A00,108005,Bellare; Mihir,0,0,0,0
1668080335455,CSE 210,A00,113163,Coblenz; Michael J,0,0,0,0
1668080335880,CSE 219,A00,106111,Dow; Steven P,0,0,20,20
1668080336305,CSE 221,A00,102376,Voelker; Geoffrey M.,0,0,0,0
1668080336729,CSE 224,A01,102378,Porter; George M,0,0,0,0
1668080337158,CSE 229A,A00,102379,Savage; Stefan,0,0,0,0
1668080337585,CSE 229C,A00,102380,Munyaka; Imani N. S.,0,0,0,0
1668080338008,CSE 232B,A00,102382,Deutsch; Alin Bernard,0,0,0,0
1668080338435,CSE 234,A01,112904,Kumar; Arun Kumar,0,0,0,0
1668080338858,CSE 237A,A00,102383,Rosing; Tajana Simunic,0,0,0,0
1668080339290,CSE 239A,A00,102384,Deutsch; Alin Bernard,0,0,0,0
1668080339719,CSE 239B,A00,102385,Polikarpova; Nadezhda,0,0,0,0
1668080340143,CSE 240A,A00,102386,Pannuto; Patrick William,0,0,0,0
1668080340574,CSE 240B,A00,102387,Zhao; Jishen,0,0,0,0
1668080340999,CSE 241A,A00,106406,Kang; Mingu,0,0,0,0
1668080341423,CSE 249B,A00,102388,Kahng; Andrew Byun,0,0,8,8
1668080341852,CSE 251B,A01,102392,Cottrell; Garrison W,0,0,0,0
1668080341852,CSE 251B,A02,102393,Cottrell; Garrison W,0,0,0,0
1668080342276,CSE 252B,A00,102394,Ochoa; Benjamin Lawrence,0,0,0,0
1668080342703,CSE 257,A01,102396,Gao; Sicun,0,0,0,0
1668080343143,CSE 272,A00,102397,Li; Tzumao,0,0,0,0
1668080343567,CSE 274,A00,111323,Chern; Albert Ren-Haur,0,0,0,0
1668080343998,CSE 282,A00,102398,Pevzner; Pavel Arkadjevich,0,0,0,0
1668080344430,CSE 284,A00,114175,Gymrek; Melissa Ann,0,0,0,0
1668080344861,CSE 290,A00,102399,Chandraker; Manmohan Krishna,0,0,0,0
1668080344861,CSE 290,B00,102400,Vaccaro; Kristen Marie,0,0,25,25
1668080344861,CSE 290,C00,102414,Pannuto; Patrick William,0,0,25,25
1668080344861,CSE 290,D00,102427,Pevzner; Pavel Arkadjevich,0,0,0,0
1668080344861,CSE 290,E00,102429,Zhao; Jishen,0,0,0,0
1668080344861,CSE 290,F00,102436,Tullsen; Dean Michael,0,0,0,0
1668080344861,CSE 290,G00,102440,Christensen; Henrik I,0,0,20,20
1668080345297,CSE 291,A00,102443,Su; Hao,0,0,0,0
1668080345297,CSE 291,B00,102448,Polikarpova; Nadezhda,0,0,0,0
1668080345297,CSE 291,C00,102453,Vaccaro; Kristen Marie,0,0,0,0
1668080345297,CSE 291,D00,111343,Savage; Stefan,0,0,0,0
1668080345297,CSE 291,E00,116474,Claffy; Kimberly Claire,0,0,0,0
1668080345297,CSE 291,F00,116479,Pasquale; Joseph,0,0,0,0
1668080345744,CSE 293,001,119111,Bafna; Vineet,9999,0,9999,0
1668080345744,CSE 293,002,119118,Bellare; Mihir,9999,0,9999,0
1668080345744,CSE 293,003,119122,Berg-Kirkpatrick; Taylor D,9999,0,9999,0
1668080345744,CSE 293,004,119135,Christensen; Henrik I,9999,0,9999,0
1668080345744,CSE 293,005,119142,Cottrell; Garrison W,9999,0,9999,0
1668080345744,CSE 293,006,119146,Deutsch; Alin Bernard,9999,0,9999,0
1668080345744,CSE 293,007,119159,Esmaeilzadeh; Hadi,9999,0,9999,0
1668080345744,CSE 293,008,119166,Freund; Yoav,9999,0,9999,0
1668080345744,CSE 293,009,119170,Griswold; William G.,9999,0,9999,0
1668080345744,CSE 293,010,119183,Gymrek; Melissa Ann,9999,0,9999,0
1668080345744,CSE 293,011,119190,Heninger; Nadia A,9999,0,9999,0
1668080345744,CSE 293,012,119230,Impagliazzo; Russell,9999,0,9999,0
1668080345744,CSE 293,013,119232,Jhala; Ranjit,9999,0,9999,0
1668080345744,CSE 293,014,119233,Kahng; Andrew Byun,9999,0,9999,0
1668080345744,CSE 293,015,119298,Kane; Daniel Mertz,9999,0,9999,0
1668080345744,CSE 293,016,119299,Kriegman; David J,9999,0,9999,0
1668080345744,CSE 293,017,119300,Kumar; Arun Kumar,9999,0,9999,0
1668080345744,CSE 293,018,119301,Lerner; Sorin,9999,0,9999,0
1668080345744,CSE 293,019,119302,Lovett; Shachar,9999,0,9999,0
1668080345744,CSE 293,020,119303,McAuley; Julian John,9999,0,9999,0
1668080345744,CSE 293,021,119304,Micciancio; Daniele,9999,0,9999,0
1668080345744,CSE 293,022,119367,Orailoglu; Alex,9999,0,9999,0
1668080345744,CSE 293,023,119382,Paturi; Ramamohan,9999,0,9999,0
1668080345744,CSE 293,024,119404,Polikarpova; Nadezhda,9999,0,9999,0
1668080345744,CSE 293,025,119406,Politz; Joseph Gibbs,9999,0,9999,0
1668080345744,CSE 293,026,119411,Porter; George M,9999,0,9999,0
1668080345744,CSE 293,027,119414,Porter; Leonard Emerson,9999,0,9999,0
1668080345744,CSE 293,028,119416,Ramamoorthi; Ravi,9999,0,9999,0
1668080345744,CSE 293,029,119417,Sahoo; Debashis,9999,0,9999,0
1668080345744,CSE 293,030,119420,Saul; Lawrence,9999,0,9999,0
1668080345744,CSE 293,031,119421,Savage; Stefan,9999,0,9999,0
1668080345744,CSE 293,032,119425,Schulze; Jurgen P.,9999,0,9999,0
1668080345744,CSE 293,033,119426,Snoeren; Alex C.,9999,0,9999,0
1668080345744,CSE 293,034,119428,Shang; Jingbo,9999,0,9999,0
1668080345744,CSE 293,035,119430,Stefan; Deian,9999,0,9999,0
1668080345744,CSE 293,036,119431,Su; Hao,9999,0,9999,0
1668080345744,CSE 293,037,119433,Swanson; Steven James,9999,0,9999,0
1668080345744,CSE 293,038,119435,Tullsen; Dean Michael,9999,0,9999,0
1668080345744,CSE 293,039,119483,Voelker; Geoffrey M.,9999,0,9999,0
1668080345744,CSE 293,040,119537,Zhao; Jishen,9999,0,9999,0
1668080345744,CSE 293,041,119538,Zhou; Yuan-Yuan,9999,0,9999,0
1668080345744,CSE 293,042,119539,Gao; Sicun,9999,0,9999,0
1668080345744,CSE 293,043,119540,Weibel; Nadir,9999,0,9999,0
1668080345744,CSE 293,044,119541,Gupta; Rajesh K.,9999,0,9999,0
1668080345744,CSE 293,045,126410,Vaccaro; Kristen Marie,9999,0,9999,0
1668080345744,CSE 293,046,126411,Klemke; Richard,9999,0,9999,0
1668080346168,CSE 294,A00,102459,Voelker; Geoffrey M.,0,0,0,0
1668080346168,CSE 294,B00,111322,Orailoglu; Alex,0,0,0,0
1668080346598,DSE 201,A00,096914,Deutsch; Alin Bernard,30,0,30,0
1668080347021,DSE 210,A00,096915,Dasgupta; Sanjoy,30,0,30,0
1668080347453,DSE 260A,A00,096916,Altintas De Callaf; Ilkay,30,0,30,0
1668080347954,ECE 200,001,103586,Antipa; Nicholas A,9999,0,9999,0
1668080347954,ECE 200,002,103587,Atanasov; Nikolay A.,9999,0,9999,0
1668080347954,ECE 200,003,103588,Bharadia; Dinesh,9999,0,9999,0
1668080347954,ECE 200,004,103589,Cheng; Chung Kuan,9999,0,9999,0
1668080347954,ECE 200,005,103590,Cosman; Pamela C.,9999,0,9999,0
1668080347954,ECE 200,006,103591,Dayeh; Shadi Ahmad,9999,0,9999,0
1668080347954,ECE 200,007,103592,Fainman; Yeshaiahu,9999,0,9999,0
1668080347954,ECE 200,008,103593,Ford; Joseph Earl,9999,0,9999,0
1668080347954,ECE 200,009,103594,Franceschetti; Massimo,9999,0,9999,0
1668080347954,ECE 200,010,103595,Fullerton; Eric E,9999,0,9999,0
1668080347954,ECE 200,011,103596,Galton; Ian A,9999,0,9999,0
1668080347954,ECE 200,012,103597,Gilja; Vikash,9999,0,9999,0
1668080347954,ECE 200,013,103598,Hall; Drew A.,9999,0,9999,0
1668080347954,ECE 200,014,103599,Hsueh; Tzu-Chien,9999,0,9999,0
1668080347954,ECE 200,015,103600,Javidi; Tara,9999,0,9999,0
1668080347954,ECE 200,016,103601,Kahng; Andrew Byun,9999,0,9999,0
1668080347954,ECE 200,017,103602,Kim; Young-Han,9999,0,9999,0
1668080347954,ECE 200,018,103603,Koushanfar; Farinaz,9999,0,9999,0
1668080347954,ECE 200,019,103604,Kuzum; Duygu,9999,0,9999,0
1668080347954,ECE 200,020,103605,Le; Hanh-Phuc,9999,0,9999,0
1668080347954,ECE 200,021,103606,Lin; Bill,9999,0,9999,0
1668080347954,ECE 200,022,103607,Liu; Zhaowei,9998,0,9999,1
1668080347954,ECE 200,023,103608,Lo; Yu-Hwa,9999,0,9999,0
1668080347954,ECE 200,024,103609,Lomakin; Vitaliy,9999,0,9999,0
1668080347954,ECE 200,025,103610,Mercier; Patrick Philip,9999,0,9999,0
1668080347954,ECE 200,026,103611,Meyer; Florian,9999,0,9999,0
1668080347954,ECE 200,027,103612,Milstein; Laurence B.,9999,0,9999,0
1668080347954,ECE 200,028,103613,Mir Arabbaygi; Siavash,9999,0,9999,0
1668080347954,ECE 200,029,103614,Mookherjea; Shayan,9999,0,9999,0
1668080347954,ECE 200,030,103615,Morris; Karcher William,9999,0,9999,0
1668080347954,ECE 200,031,103616,Ng; Tse Nga,9999,0,9999,0
1668080347954,ECE 200,032,103617,Nguyen; Truong Quang,9999,0,9999,0
1668080347954,ECE 200,033,103618,Nomura; Kenji,9999,0,9999,0
1668080347954,ECE 200,034,103619,Orlitsky; Alon,9999,0,9999,0
1668080347954,ECE 200,035,103620,Pal; Piya,9999,0,9999,0
1668080347954,ECE 200,036,103621,Papen; George C.,9999,0,9999,0
1668080347954,ECE 200,037,103622,Radic; Stojan,9999,0,9999,0
1668080347954,ECE 200,038,103623,Rao; Bhaskar D.,9999,0,9999,0
1668080347954,ECE 200,039,103624,Rao; Ramesh R,9999,0,9999,0
1668080347954,ECE 200,040,103625,Rebeiz; Gabriel,9999,0,9999,0
1668080347954,ECE 200,041,103626,Sanford; John R,9999,0,9999,0
1668080347954,ECE 200,042,103627,Siegel; Paul H.,9999,0,9999,0
1668080347954,ECE 200,043,103628,Sievenpiper; Daniel F.,9999,0,9999,0
1668080347954,ECE 200,044,103629,Sworder; David D.,9999,0,9999,0
1668080347954,ECE 200,045,103630,Taur; Yuan,9999,0,9999,0
1668080347954,ECE 200,046,103631,Touri; Behrouz,9999,0,9999,0
1668080347954,ECE 200,047,103632,Trivedi; Mohan M.,9999,0,9999,0
1668080347954,ECE 200,048,103633,Vasconcelos; Nuno,9999,0,9999,0
1668080347954,ECE 200,049,103634,Wang; Xiaolong,9999,0,9999,0
1668080347954,ECE 200,050,103635,Xie; Pengtao,9999,0,9999,0
1668080347954,ECE 200,051,103636,Yip; Michael,9999,0,9999,0
1668080347954,ECE 200,052,103637,Zeger; Kenneth A.,999,0,999,0
1668080347954,ECE 200,053,103638,Zhang; Xinyu,9999,0,9999,0
1668080347954,ECE 200,054,103639,Turakhia; Yatish Girish,9999,0,9999,0
1668080347954,ECE 200,055,103640,Kang; Mingu,9999,0,9999,0
1668080347954,ECE 200,056,103641,Shi; Yuanyuan,9999,0,9999,0
1668080347954,ECE 200,057,103642,Wang; Edward Jay,9999,0,9999,0
1668080347954,ECE 200,058,103643,Zheng; Yang,9999,0,9999,0
1668080348379,ECE 202,A00,103644,Kuzum; Duygu,0,0,0,0
1668080348804,ECE 212BN,A00,103646,Ng; Tse Nga,0,0,0,0
1668080349232,ECE 221,A00,111493,Staff,0,0,0,0
1668080349655,ECE 222B,A00,103647,Lomakin; Vitaliy,0,0,0,0
1668080350080,ECE 230B,A00,103648,Taur; Yuan,0,0,0,0
1668080350513,ECE 238B,A00,103649,Garay; Javier,0,0,0,0
1668080350941,ECE 240B,A00,112900,Fainman; Yeshaiahu,0,0,0,0
1668080351366,ECE 247A,A00,103650,Jokerst; Jesse Vincent,0,0,0,0
1668080351790,ECE 247B,A00,103651,Wang; Joseph,0,0,0,0
1668080352215,ECE 250,A00,103652,Siegel; Paul H.,0,0,0,0
1668080352645,ECE 251A,A00,103654,Rao; Bhaskar D.,0,0,0,0
1668080353074,ECE 257B,A00,103655,Bharadia; Dinesh,0,0,0,0
1668080353496,ECE 258A,A00,103656,Milstein; Laurence B.,0,0,0,0
1668080353922,ECE 260B,A00,103658,Kang; Mingu,0,0,0,0
1668080354345,ECE 264A,A00,103659,Galton; Ian A,0,0,0,0
1668080354772,ECE 265A,A00,103661,Gudem; Prasad S.S.,0,0,0,0
1668080355200,ECE 265D,A00,103662,Gudem; Prasad S.S.,0,0,0,0
1668080355625,ECE 268,A00,103663,Koushanfar; Farinaz,0,0,0,0
1668080356051,ECE 269,A01,103665,Pal; Piya,0,0,0,0
1668080356479,ECE 271B,A00,103666,Vasconcelos; Manuela,0,0,0,0
1668080356903,ECE 276A,A00,103667,Atanasov; Nikolay A.,0,0,0,0
1668080357327,ECE 277,A00,103668,An; Cheolhong,0,0,0,0
1668080357753,ECE 279,A00,117947,Hall; Drew A.,0,0,0,0
1668080358605,ECE 283,A00,103670,Hsueh; Tzu-Chien,0,0,0,0
1668080359031,ECE 284,A00,103671,Turakhia; Yatish Girish,0,0,0,0
1668080359456,ECE 285,A00,103672,Zheng; Yang,0,0,0,0
1668080359456,ECE 285,B00,103673,Sworder; David D.,0,0,0,0
1668080359882,ECE 287,A00,103676,Javidi; Tara,0,0,0,0
1668080360309,MATH 200B,A00,098023,Salehi Golsefidy; Alireza,13,0,15,2
1668080360739,MATH 202B,A00,098024,Rhoades; Brendon Patrick,9,0,15,6
1668080361164,MATH 203B,A00,098025,Oprea; Dragos N.,10,0,15,5
1668080361595,MATH 204B,A00,098026,Sorensen; Claus M,13,0,15,2
1668080362022,MATH 208,A00,098027,Izadi; Elham,7,0,10,3
1668080362524,MATH 209,A00,098028,Pollack; Aaron,10,0,10,0
1668080362955,MATH 211A,A00,112919,Rogalski; Daniel,9,0,10,1
1668080363381,MATH 211B,A00,112920,Seward; Brandon M.,9,0,10,1
1668080363808,MATH 218,A00,098029,Li; Bo,10,0,10,0
1668080364234,MATH 220B,A00,098030,Novak; Jonathan I,12,0,15,3
1668080364658,MATH 221A,A00,098031,Ebenfelt; Peter F,13,0,15,2
1668080365088,MATH 231B,A00,098032,Zlatos; Andrej,12,0,15,3
1668080365515,MATH 240B,A00,098033,Ni; Lei,9,0,15,6
1668080365942,MATH 243,A00,098034,Jekel; David Andrew,10,0,10,0
1668080366377,MATH 245A,A00,098035,Nie; Jiawang,0,0,15,16
1668080366808,MATH 248,A00,098036,Bejenaru; Ioan,10,0,10,0
1668080367236,MATH 250B,A00,098037,Spolaor; Luca,14,0,15,1
1668080367658,MATH 258,A00,098038,Ni; Lei,10,0,10,0
1668080368084,MATH 264B,A00,098041,Rhoades; Brendon Patrick,10,0,15,5
1668080368527,MATH 268,A00,098042,Buss; Samuel R,10,0,10,0
1668080368955,MATH 269,A00,098043,Rhoades; Brendon Patrick,10,0,10,0
1668080369381,MATH 270B,A00,098044,Li; Bo,11,0,15,4
1668080369810,MATH 272B,A00,098045,Holst; Michael J,13,0,15,2
1668080370237,MATH 273A,A00,098046,Tian; Xiaochuan,10,0,15,5
1668080370670,MATH 275,A01,098048,Tian; Xiaochuan,6,0,10,4
1668080371101,MATH 278A,A00,098049,Holst; Michael J,8,0,10,2
1668080371526,MATH 278B,A00,098050,Cloninger; Alexander,10,0,10,0
1668080371951,MATH 278C,A00,098051,Nie; Jiawang,7,0,10,3
1668080372377,MATH 280B,A00,098052,Zheng; Tianyi,10,0,15,5
1668080372801,MATH 281B,A00,098053,Bradic; Jelena,3,0,15,12
1668080373231,MATH 282B,A00,098054,Arias-Castro; Ery,0,0,15,15
1668080373660,MATH 285,A00,098055,Fitzsimmons; Patrick J,0,0,15,17
1668080374085,MATH 287B,A00,098056,Arias-Castro; Ery,3,0,15,12
1668080374511,MATH 288,A00,098057,Agarwal; Pooja,9,0,10,1
1668080374511,MATH 288,B00,098058,Zhang; Danna,8,0,10,2
1668080374511,MATH 288,C00,098059,Williams; Ruth J,10,0,10,0
1668080374935,MATH 290B,A00,098060,Roberts; Justin Deritter,13,0,15,2
1668080375364,MATH 292,A00,098061,Belmont; Eva Kinoshita,10,0,10,0
1668080375789,MATH 295,A00,098062,Suk; Andrew Hoon,48,0,50,2
1668080376212,MATH 296,A00,098063,Novak; Jonathan I,20,0,20,0
1668080376636,MATH 297,001,098064,Gamst; Anthony Collins,9997,0,9999,2
1668080877852,COGS 205,A00,101395,Chiba; Andrea,19,0,20,1
1668080878288,COGS 210B,001,101404,Greene; Deanna Jacquelyn,9998,0,9999,1
1668080878288,COGS 210B,002,101417,Xia; Haijun,9999,0,9999,0
1668080878288,COGS 210B,003,101422,Nitz; Douglas A.,9999,0,9999,0
1668080878288,COGS 210B,004,101423,Hollan; James D.,9998,0,9999,1
1668080878288,COGS 210B,005,101424,Deak; Gedeon O.,9998,0,9999,1
1668080878288,COGS 210B,006,101425,Rossano; Federico,9999,0,9999,0
1668080878719,COGS 211B,A00,101427,Coulson; Seana M,9996,0,9999,3
1668080879144,COGS 220,A00,101428,Hollan; James D.,0,0,25,25
1668080879572,COGS 229,A00,101429,Dow; Steven P,18,0,25,7
1668080879996,COGS 230,A00,101430,Klemmer; Scott R,13,0,17,4
1668080880421,COGS 234,A00,101431,Xia; Haijun,3,0,25,22
1668080880847,COGS 260,A00,101432,Kiyonaga; Anastasia,19,0,25,6
1668080880847,COGS 260,B00,101433,Kirsh; David Joel,16,0,25,9
1668080881278,CSE 202,A00,102371,Impagliazzo; Russell,0,0,0,0
1668080881707,CSE 203B,A01,102373,Cheng; Chung Kuan,0,0,0,0
1668080882144,CSE 208,A00,102374,Micciancio; Daniele,0,0,0,0
1668080882574,CSE 209A,A00,112895,Impagliazzo; Russell,0,0,15,15
1668080883005,CSE 209B,A00,108005,Bellare; Mihir,0,0,0,0
1668080883438,CSE 210,A00,113163,Coblenz; Michael J,0,0,0,0
1668080883943,CSE 219,A00,106111,Dow; Steven P,0,0,20,20
1668080884377,CSE 221,A00,102376,Voelker; Geoffrey M.,0,0,0,0
1668080884801,CSE 224,A01,102378,Porter; George M,0,0,0,0
1668080885233,CSE 229A,A00,102379,Savage; Stefan,0,0,0,0
1668080885669,CSE 229C,A00,102380,Munyaka; Imani N. S.,0,0,0,0
1668080886094,CSE 232B,A00,102382,Deutsch; Alin Bernard,0,0,0,0
1668080886516,CSE 234,A01,112904,Kumar; Arun Kumar,0,0,0,0
1668080886946,CSE 237A,A00,102383,Rosing; Tajana Simunic,0,0,0,0
1668080887370,CSE 239A,A00,102384,Deutsch; Alin Bernard,0,0,0,0
1668080887794,CSE 239B,A00,102385,Polikarpova; Nadezhda,0,0,0,0
1668080888219,CSE 240A,A00,102386,Pannuto; Patrick William,0,0,0,0
1668080888648,CSE 240B,A00,102387,Zhao; Jishen,0,0,0,0
1668080889079,CSE 241A,A00,106406,Kang; Mingu,0,0,0,0
1668080889503,CSE 249B,A00,102388,Kahng; Andrew Byun,0,0,8,8
1668080889928,CSE 251B,A01,102392,Cottrell; Garrison W,0,0,0,0
1668080889928,CSE 251B,A02,102393,Cottrell; Garrison W,0,0,0,0
1668080890351,CSE 252B,A00,102394,Ochoa; Benjamin Lawrence,0,0,0,0
1668080890776,CSE 257,A01,102396,Gao; Sicun,0,0,0,0
1668080891206,CSE 272,A00,102397,Li; Tzumao,0,0,0,0
1668080891635,CSE 274,A00,111323,Chern; Albert Ren-Haur,0,0,0,0
1668080892060,CSE 282,A00,102398,Pevzner; Pavel Arkadjevich,0,0,0,0
1668080892489,CSE 284,A00,114175,Gymrek; Melissa Ann,0,0,0,0
1668080892915,CSE 290,A00,102399,Chandraker; Manmohan Krishna,0,0,0,0
1668080892915,CSE 290,B00,102400,Vaccaro; Kristen Marie,0,0,25,25
1668080892915,CSE 290,C00,102414,Pannuto; Patrick William,0,0,25,25
1668080892915,CSE 290,D00,102427,Pevzner; Pavel Arkadjevich,0,0,0,0
1668080892915,CSE 290,E00,102429,Zhao; Jishen,0,0,0,0
1668080892915,CSE 290,F00,102436,Tullsen; Dean Michael,0,0,0,0
1668080892915,CSE 290,G00,102440,Christensen; Henrik I,0,0,20,20
1668080893344,CSE 291,A00,102443,Su; Hao,0,0,0,0
1668080893344,CSE 291,B00,102448,Polikarpova; Nadezhda,0,0,0,0
1668080893344,CSE 291,C00,102453,Vaccaro; Kristen Marie,0,0,0,0
1668080893344,CSE 291,D00,111343,Savage; Stefan,0,0,0,0
1668080893344,CSE 291,E00,116474,Claffy; Kimberly Claire,0,0,0,0
1668080893344,CSE 291,F00,116479,Pasquale; Joseph,0,0,0,0
1668080893795,CSE 293,001,119111,Bafna; Vineet,9999,0,9999,0
1668080893795,CSE 293,002,119118,Bellare; Mihir,9999,0,9999,0
1668080893795,CSE 293,003,119122,Berg-Kirkpatrick; Taylor D,9999,0,9999,0
1668080893795,CSE 293,004,119135,Christensen; Henrik I,9999,0,9999,0
1668080893795,CSE 293,005,119142,Cottrell; Garrison W,9999,0,9999,0
1668080893795,CSE 293,006,119146,Deutsch; Alin Bernard,9999,0,9999,0
1668080893795,CSE 293,007,119159,Esmaeilzadeh; Hadi,9999,0,9999,0
1668080893795,CSE 293,008,119166,Freund; Yoav,9999,0,9999,0
1668080893795,CSE 293,009,119170,Griswold; William G.,9999,0,9999,0
1668080893795,CSE 293,010,119183,Gymrek; Melissa Ann,9999,0,9999,0
1668080893795,CSE 293,011,119190,Heninger; Nadia A,9999,0,9999,0
1668080893795,CSE 293,012,119230,Impagliazzo; Russell,9999,0,9999,0
1668080893795,CSE 293,013,119232,Jhala; Ranjit,9999,0,9999,0
1668080893795,CSE 293,014,119233,Kahng; Andrew Byun,9999,0,9999,0
1668080893795,CSE 293,015,119298,Kane; Daniel Mertz,9999,0,9999,0
1668080893795,CSE 293,016,119299,Kriegman; David J,9999,0,9999,0
1668080893795,CSE 293,017,119300,Kumar; Arun Kumar,9999,0,9999,0
1668080893795,CSE 293,018,119301,Lerner; Sorin,9999,0,9999,0
1668080893795,CSE 293,019,119302,Lovett; Shachar,9999,0,9999,0
1668080893795,CSE 293,020,119303,McAuley; Julian John,9999,0,9999,0
1668080893795,CSE 293,021,119304,Micciancio; Daniele,9999,0,9999,0
1668080893795,CSE 293,022,119367,Orailoglu; Alex,9999,0,9999,0
1668080893795,CSE 293,023,119382,Paturi; Ramamohan,9999,0,9999,0
1668080893795,CSE 293,024,119404,Polikarpova; Nadezhda,9999,0,9999,0
1668080893795,CSE 293,025,119406,Politz; Joseph Gibbs,9999,0,9999,0
1668080893795,CSE 293,026,119411,Porter; George M,9999,0,9999,0
1668080893795,CSE 293,027,119414,Porter; Leonard Emerson,9999,0,9999,0
1668080893795,CSE 293,028,119416,Ramamoorthi; Ravi,9999,0,9999,0
1668080893795,CSE 293,029,119417,Sahoo; Debashis,9999,0,9999,0
1668080893795,CSE 293,030,119420,Saul; Lawrence,9999,0,9999,0
1668080893795,CSE 293,031,119421,Savage; Stefan,9999,0,9999,0
1668080893795,CSE 293,032,119425,Schulze; Jurgen P.,9999,0,9999,0
1668080893795,CSE 293,033,119426,Snoeren; Alex C.,9999,0,9999,0
1668080893795,CSE 293,034,119428,Shang; Jingbo,9999,0,9999,0
1668080893795,CSE 293,035,119430,Stefan; Deian,9999,0,9999,0
1668080893795,CSE 293,036,119431,Su; Hao,9999,0,9999,0
1668080893795,CSE 293,037,119433,Swanson; Steven James,9999,0,9999,0
1668080893795,CSE 293,038,119435,Tullsen; Dean Michael,9999,0,9999,0
1668080893795,CSE 293,039,119483,Voelker; Geoffrey M.,9999,0,9999,0
1668080893795,CSE 293,040,119537,Zhao; Jishen,9999,0,9999,0
1668080893795,CSE 293,041,119538,Zhou; Yuan-Yuan,9999,0,9999,0
1668080893795,CSE 293,042,119539,Gao; Sicun,9999,0,9999,0
1668080893795,CSE 293,043,119540,Weibel; Nadir,9999,0,9999,0
1668080893795,CSE 293,044,119541,Gupta; Rajesh K.,9999,0,9999,0
1668080893795,CSE 293,045,126410,Vaccaro; Kristen Marie,9999,0,9999,0
1668080893795,CSE 293,046,126411,Klemke; Richard,9999,0,9999,0
1668080894223,CSE 294,A00,102459,Voelker; Geoffrey M.,0,0,0,0
1668080894223,CSE 294,B00,111322,Orailoglu; Alex,0,0,0,0
1668080894651,DSE 201,A00,096914,Deutsch; Alin Bernard,30,0,30,0
1668080895078,DSE 210,A00,096915,Dasgupta; Sanjoy,30,0,30,0
1668080895502,DSE 260A,A00,096916,Altintas De Callaf; Ilkay,30,0,30,0
1668080895959,ECE 200,001,103586,Antipa; Nicholas A,9999,0,9999,0
1668080895959,ECE 200,002,103587,Atanasov; Nikolay A.,9999,0,9999,0
1668080895959,ECE 200,003,103588,Bharadia; Dinesh,9999,0,9999,0
1668080895959,ECE 200,004,103589,Cheng; Chung Kuan,9999,0,9999,0
1668080895959,ECE 200,005,103590,Cosman; Pamela C.,9999,0,9999,0
1668080895959,ECE 200,006,103591,Dayeh; Shadi Ahmad,9999,0,9999,0
1668080895959,ECE 200,007,103592,Fainman; Yeshaiahu,9999,0,9999,0
1668080895959,ECE 200,008,103593,Ford; Joseph Earl,9999,0,9999,0
1668080895959,ECE 200,009,103594,Franceschetti; Massimo,9999,0,9999,0
1668080895959,ECE 200,010,103595,Fullerton; Eric E,9999,0,9999,0
1668080895959,ECE 200,011,103596,Galton; Ian A,9999,0,9999,0
1668080895959,ECE 200,012,103597,Gilja; Vikash,9999,0,9999,0
1668080895959,ECE 200,013,103598,Hall; Drew A.,9999,0,9999,0
1668080895959,ECE 200,014,103599,Hsueh; Tzu-Chien,9999,0,9999,0
1668080895959,ECE 200,015,103600,Javidi; Tara,9999,0,9999,0
1668080895959,ECE 200,016,103601,Kahng; Andrew Byun,9999,0,9999,0
1668080895959,ECE 200,017,103602,Kim; Young-Han,9999,0,9999,0
1668080895959,ECE 200,018,103603,Koushanfar; Farinaz,9999,0,9999,0
1668080895959,ECE 200,019,103604,Kuzum; Duygu,9999,0,9999,0
1668080895959,ECE 200,020,103605,Le; Hanh-Phuc,9999,0,9999,0
1668080895959,ECE 200,021,103606,Lin; Bill,9999,0,9999,0
1668080895959,ECE 200,022,103607,Liu; Zhaowei,9998,0,9999,1
1668080895959,ECE 200,023,103608,Lo; Yu-Hwa,9999,0,9999,0
1668080895959,ECE 200,024,103609,Lomakin; Vitaliy,9999,0,9999,0
1668080895959,ECE 200,025,103610,Mercier; Patrick Philip,9999,0,9999,0
1668080895959,ECE 200,026,103611,Meyer; Florian,9999,0,9999,0
1668080895959,ECE 200,027,103612,Milstein; Laurence B.,9999,0,9999,0
1668080895959,ECE 200,028,103613,Mir Arabbaygi; Siavash,9999,0,9999,0
1668080895959,ECE 200,029,103614,Mookherjea; Shayan,9999,0,9999,0
1668080895959,ECE 200,030,103615,Morris; Karcher William,9999,0,9999,0
1668080895959,ECE 200,031,103616,Ng; Tse Nga,9999,0,9999,0
1668080895959,ECE 200,032,103617,Nguyen; Truong Quang,9999,0,9999,0
1668080895959,ECE 200,033,103618,Nomura; Kenji,9999,0,9999,0
1668080895959,ECE 200,034,103619,Orlitsky; Alon,9999,0,9999,0
1668080895959,ECE 200,035,103620,Pal; Piya,9999,0,9999,0
1668080895959,ECE 200,036,103621,Papen; George C.,9999,0,9999,0
1668080895959,ECE 200,037,103622,Radic; Stojan,9999,0,9999,0
1668080895959,ECE 200,038,103623,Rao; Bhaskar D.,9999,0,9999,0
1668080895959,ECE 200,039,103624,Rao; Ramesh R,9999,0,9999,0
1668080895959,ECE 200,040,103625,Rebeiz; Gabriel,9999,0,9999,0
1668080895959,ECE 200,041,103626,Sanford; John R,9999,0,9999,0
1668080895959,ECE 200,042,103627,Siegel; Paul H.,9999,0,9999,0
1668080895959,ECE 200,043,103628,Sievenpiper; Daniel F.,9999,0,9999,0
1668080895959,ECE 200,044,103629,Sworder; David D.,9999,0,9999,0
1668080895959,ECE 200,045,103630,Taur; Yuan,9999,0,9999,0
1668080895959,ECE 200,046,103631,Touri; Behrouz,9999,0,9999,0
1668080895959,ECE 200,047,103632,Trivedi; Mohan M.,9999,0,9999,0
1668080895959,ECE 200,048,103633,Vasconcelos; Nuno,9999,0,9999,0
1668080895959,ECE 200,049,103634,Wang; Xiaolong,9999,0,9999,0
1668080895959,ECE 200,050,103635,Xie; Pengtao,9999,0,9999,0
1668080895959,ECE 200,051,103636,Yip; Michael,9999,0,9999,0
1668080895959,ECE 200,052,103637,Zeger; Kenneth A.,999,0,999,0
1668080895959,ECE 200,053,103638,Zhang; Xinyu,9999,0,9999,0
1668080895959,ECE 200,054,103639,Turakhia; Yatish Girish,9999,0,9999,0
1668080895959,ECE 200,055,103640,Kang; Mingu,9999,0,9999,0
1668080895959,ECE 200,056,103641,Shi; Yuanyuan,9999,0,9999,0
1668080895959,ECE 200,057,103642,Wang; Edward Jay,9999,0,9999,0
1668080895959,ECE 200,058,103643,Zheng; Yang,9999,0,9999,0
1668080896385,ECE 202,A00,103644,Kuzum; Duygu,0,0,0,0
1668080896813,ECE 212BN,A00,103646,Ng; Tse Nga,0,0,0,0
1668080897240,ECE 221,A00,111493,Staff,0,0,0,0
1668080897664,ECE 222B,A00,103647,Lomakin; Vitaliy,0,0,0,0
1668080898088,ECE 230B,A00,103648,Taur; Yuan,0,0,0,0
1668080898514,ECE 238B,A00,103649,Garay; Javier,0,0,0,0
1668080898942,ECE 240B,A00,112900,Fainman; Yeshaiahu,0,0,0,0
1668080899367,ECE 247A,A00,103650,Jokerst; Jesse Vincent,0,0,0,0
1668080899793,ECE 247B,A00,103651,Wang; Joseph,0,0,0,0
1668080900217,ECE 250,A00,103652,Siegel; Paul H.,0,0,0,0
1668080900641,ECE 251A,A00,103654,Rao; Bhaskar D.,0,0,0,0
1668080901069,ECE 257B,A00,103655,Bharadia; Dinesh,0,0,0,0
1668080901499,ECE 258A,A00,103656,Milstein; Laurence B.,0,0,0,0
1668080901921,ECE 260B,A00,103658,Kang; Mingu,0,0,0,0
1668080902347,ECE 264A,A00,103659,Galton; Ian A,0,0,0,0
1668080902773,ECE 265A,A00,103661,Gudem; Prasad S.S.,0,0,0,0
1668080903199,ECE 265D,A00,103662,Gudem; Prasad S.S.,0,0,0,0
1668080903635,ECE 268,A00,103663,Koushanfar; Farinaz,0,0,0,0
1668080904060,ECE 269,A01,103665,Pal; Piya,0,0,0,0
1668080904486,ECE 271B,A00,103666,Vasconcelos; Manuela,0,0,0,0
1668080904912,ECE 276A,A00,103667,Atanasov; Nikolay A.,0,0,0,0
1668080905340,ECE 277,A00,103668,An; Cheolhong,0,0,0,0
1668080905768,ECE 279,A00,117947,Hall; Drew A.,0,0,0,0
1668080906618,ECE 283,A00,103670,Hsueh; Tzu-Chien,0,0,0,0
1668080907041,ECE 284,A00,103671,Turakhia; Yatish Girish,0,0,0,0
1668080907466,ECE 285,A00,103672,Zheng; Yang,0,0,0,0
1668080907466,ECE 285,B00,103673,Sworder; David D.,0,0,0,0
1668080907891,ECE 287,A00,103676,Javidi; Tara,0,0,0,0
1668080908326,MATH 200B,A00,098023,Salehi Golsefidy; Alireza,13,0,15,2
1668080908757,MATH 202B,A00,098024,Rhoades; Brendon Patrick,9,0,15,6
1668080909205,MATH 203B,A00,098025,Oprea; Dragos N.,10,0,15,5
1668080909631,MATH 204B,A00,098026,Sorensen; Claus M,13,0,15,2
1668080910053,MATH 208,A00,098027,Izadi; Elham,7,0,10,3
1668080910481,MATH 209,A00,098028,Pollack; Aaron,10,0,10,0
1668080910917,MATH 211A,A00,112919,Rogalski; Daniel,9,0,10,1
1668080911342,MATH 211B,A00,112920,Seward; Brandon M.,9,0,10,1
1668080911765,MATH 218,A00,098029,Li; Bo,10,0,10,0
1668080912190,MATH 220B,A00,098030,Novak; Jonathan I,12,0,15,3
1668080912626,MATH 221A,A00,098031,Ebenfelt; Peter F,13,0,15,2
1668080913050,MATH 231B,A00,098032,Zlatos; Andrej,12,0,15,3
1668080913482,MATH 240B,A00,098033,Ni; Lei,9,0,15,6
1668080913907,MATH 243,A00,098034,Jekel; David Andrew,10,0,10,0
1668080914337,MATH 245A,A00,098035,Nie; Jiawang,0,0,15,16
1668080914763,MATH 248,A00,098036,Bejenaru; Ioan,10,0,10,0
1668080915194,MATH 250B,A00,098037,Spolaor; Luca,14,0,15,1
1668080915621,MATH 258,A00,098038,Ni; Lei,10,0,10,0
1668080916045,MATH 264B,A00,098041,Rhoades; Brendon Patrick,10,0,15,5
1668080916472,MATH 268,A00,098042,Buss; Samuel R,10,0,10,0
1668080916897,MATH 269,A00,098043,Rhoades; Brendon Patrick,10,0,10,0
1668080917321,MATH 270B,A00,098044,Li; Bo,11,0,15,4
1668080917745,MATH 272B,A00,098045,Holst; Michael J,13,0,15,2
1668080918181,MATH 273A,A00,098046,Tian; Xiaochuan,10,0,15,5
1668080918610,MATH 275,A01,098048,Tian; Xiaochuan,6,0,10,4
1668080919036,MATH 278A,A00,098049,Holst; Michael J,8,0,10,2
1668080919464,MATH 278B,A00,098050,Cloninger; Alexander,10,0,10,0
1668080919889,MATH 278C,A00,098051,Nie; Jiawang,7,0,10,3
1668080920316,MATH 280B,A00,098052,Zheng; Tianyi,10,0,15,5
1668080920748,MATH 281B,A00,098053,Bradic; Jelena,3,0,15,12
1668080921172,MATH 282B,A00,098054,Arias-Castro; Ery,0,0,15,15
1668080921606,MATH 285,A00,098055,Fitzsimmons; Patrick J,0,0,15,17
1668080922033,MATH 287B,A00,098056,Arias-Castro; Ery,3,0,15,12
1668080922460,MATH 288,A00,098057,Agarwal; Pooja,9,0,10,1
1668080922460,MATH 288,B00,098058,Zhang; Danna,8,0,10,2
1668080922460,MATH 288,C00,098059,Williams; Ruth J,10,0,10,0
1668080922885,MATH 290B,A00,098060,Roberts; Justin Deritter,13,0,15,2
1668080923314,MATH 292,A00,098061,Belmont; Eva Kinoshita,10,0,10,0
1668080923743,MATH 295,A00,098062,Suk; Andrew Hoon,48,0,50,2
1668080924170,MATH 296,A00,098063,Novak; Jonathan I,20,0,20,0
1668080924595,MATH 297,001,098064,Gamst; Anthony Collins,9997,0,9999,2
1668081426172,COGS 205,A00,101395,Chiba; Andrea,19,0,20,1
1668081426620,COGS 210B,001,101404,Greene; Deanna Jacquelyn,9998,0,9999,1
1668081426620,COGS 210B,002,101417,Xia; Haijun,9999,0,9999,0
1668081426620,COGS 210B,003,101422,Nitz; Douglas A.,9999,0,9999,0
1668081426620,COGS 210B,004,101423,Hollan; James D.,9998,0,9999,1
1668081426620,COGS 210B,005,101424,Deak; Gedeon O.,9998,0,9999,1
1668081426620,COGS 210B,006,101425,Rossano; Federico,9999,0,9999,0
1668081427050,COGS 211B,A00,101427,Coulson; Seana M,9996,0,9999,3
1668081427489,COGS 220,A00,101428,Hollan; James D.,0,0,25,25
1668081427911,COGS 229,A00,101429,Dow; Steven P,18,0,25,7
1668081428339,COGS 230,A00,101430,Klemmer; Scott R,13,0,17,4
1668081428762,COGS 234,A00,101431,Xia; Haijun,3,0,25,22
1668081429196,COGS 260,A00,101432,Kiyonaga; Anastasia,19,0,25,6
1668081429196,COGS 260,B00,101433,Kirsh; David Joel,16,0,25,9
1668081429626,CSE 202,A00,102371,Impagliazzo; Russell,0,0,0,0
1668081430058,CSE 203B,A01,102373,Cheng; Chung Kuan,0,0,0,0
1668081430483,CSE 208,A00,102374,Micciancio; Daniele,0,0,0,0
1668081430912,CSE 209A,A00,112895,Impagliazzo; Russell,0,0,15,15
1668081431339,CSE 209B,A00,108005,Bellare; Mihir,0,0,0,0
1668081431765,CSE 210,A00,113163,Coblenz; Michael J,0,0,0,0
1668081432191,CSE 219,A00,106111,Dow; Steven P,0,0,20,20
1668081432626,CSE 221,A00,102376,Voelker; Geoffrey M.,0,0,0,0
1668081433057,CSE 224,A01,102378,Porter; George M,0,0,0,0
1668081433483,CSE 229A,A00,102379,Savage; Stefan,0,0,0,0
1668081433908,CSE 229C,A00,102380,Munyaka; Imani N. S.,0,0,0,0
1668081434331,CSE 232B,A00,102382,Deutsch; Alin Bernard,0,0,0,0
1668081434756,CSE 234,A01,112904,Kumar; Arun Kumar,0,0,0,0
1668081435180,CSE 237A,A00,102383,Rosing; Tajana Simunic,0,0,0,0
1668081435606,CSE 239A,A00,102384,Deutsch; Alin Bernard,0,0,0,0
1668081436035,CSE 239B,A00,102385,Polikarpova; Nadezhda,0,0,0,0
1668081436460,CSE 240A,A00,102386,Pannuto; Patrick William,0,0,0,0
1668081436907,CSE 240B,A00,102387,Zhao; Jishen,0,0,0,0
1668081437333,CSE 241A,A00,106406,Kang; Mingu,0,0,0,0
1668081437758,CSE 249B,A00,102388,Kahng; Andrew Byun,0,0,8,8
1668081438187,CSE 251B,A01,102392,Cottrell; Garrison W,0,0,0,0
1668081438187,CSE 251B,A02,102393,Cottrell; Garrison W,0,0,0,0
1668081438611,CSE 252B,A00,102394,Ochoa; Benjamin Lawrence,0,0,0,0
1668081439036,CSE 257,A01,102396,Gao; Sicun,0,0,0,0
1668081439462,CSE 272,A00,102397,Li; Tzumao,0,0,0,0
1668081439886,CSE 274,A00,111323,Chern; Albert Ren-Haur,0,0,0,0
1668081440317,CSE 282,A00,102398,Pevzner; Pavel Arkadjevich,0,0,0,0
1668081440746,CSE 284,A00,114175,Gymrek; Melissa Ann,0,0,0,0
1668081441180,CSE 290,A00,102399,Chandraker; Manmohan Krishna,0,0,0,0
1668081441180,CSE 290,B00,102400,Vaccaro; Kristen Marie,0,0,25,25
1668081441180,CSE 290,C00,102414,Pannuto; Patrick William,0,0,25,25
1668081441180,CSE 290,D00,102427,Pevzner; Pavel Arkadjevich,0,0,0,0
1668081441180,CSE 290,E00,102429,Zhao; Jishen,0,0,0,0
1668081441180,CSE 290,F00,102436,Tullsen; Dean Michael,0,0,0,0
1668081441180,CSE 290,G00,102440,Christensen; Henrik I,0,0,20,20
1668081441608,CSE 291,A00,102443,Su; Hao,0,0,0,0
1668081441608,CSE 291,B00,102448,Polikarpova; Nadezhda,0,0,0,0
1668081441608,CSE 291,C00,102453,Vaccaro; Kristen Marie,0,0,0,0
1668081441608,CSE 291,D00,111343,Savage; Stefan,0,0,0,0
1668081441608,CSE 291,E00,116474,Claffy; Kimberly Claire,0,0,0,0
1668081441608,CSE 291,F00,116479,Pasquale; Joseph,0,0,0,0
1668081442057,CSE 293,001,119111,Bafna; Vineet,9999,0,9999,0
1668081442057,CSE 293,002,119118,Bellare; Mihir,9999,0,9999,0
1668081442057,CSE 293,003,119122,Berg-Kirkpatrick; Taylor D,9999,0,9999,0
1668081442057,CSE 293,004,119135,Christensen; Henrik I,9999,0,9999,0
1668081442057,CSE 293,005,119142,Cottrell; Garrison W,9999,0,9999,0
1668081442057,CSE 293,006,119146,Deutsch; Alin Bernard,9999,0,9999,0
1668081442057,CSE 293,007,119159,Esmaeilzadeh; Hadi,9999,0,9999,0
1668081442057,CSE 293,008,119166,Freund; Yoav,9999,0,9999,0
1668081442057,CSE 293,009,119170,Griswold; William G.,9999,0,9999,0
1668081442057,CSE 293,010,119183,Gymrek; Melissa Ann,9999,0,9999,0
1668081442057,CSE 293,011,119190,Heninger; Nadia A,9999,0,9999,0
1668081442057,CSE 293,012,119230,Impagliazzo; Russell,9999,0,9999,0
1668081442057,CSE 293,013,119232,Jhala; Ranjit,9999,0,9999,0
1668081442057,CSE 293,014,119233,Kahng; Andrew Byun,9999,0,9999,0
1668081442057,CSE 293,015,119298,Kane; Daniel Mertz,9999,0,9999,0
1668081442057,CSE 293,016,119299,Kriegman; David J,9999,0,9999,0
1668081442057,CSE 293,017,119300,Kumar; Arun Kumar,9999,0,9999,0
1668081442057,CSE 293,018,119301,Lerner; Sorin,9999,0,9999,0
1668081442057,CSE 293,019,119302,Lovett; Shachar,9999,0,9999,0
1668081442057,CSE 293,020,119303,McAuley; Julian John,9999,0,9999,0
1668081442057,CSE 293,021,119304,Micciancio; Daniele,9999,0,9999,0
1668081442057,CSE 293,022,119367,Orailoglu; Alex,9999,0,9999,0
1668081442057,CSE 293,023,119382,Paturi; Ramamohan,9999,0,9999,0
1668081442057,CSE 293,024,119404,Polikarpova; Nadezhda,9999,0,9999,0
1668081442057,CSE 293,025,119406,Politz; Joseph Gibbs,9999,0,9999,0
1668081442057,CSE 293,026,119411,Porter; George M,9999,0,9999,0
1668081442057,CSE 293,027,119414,Porter; Leonard Emerson,9999,0,9999,0
1668081442057,CSE 293,028,119416,Ramamoorthi; Ravi,9999,0,9999,0
1668081442057,CSE 293,029,119417,Sahoo; Debashis,9999,0,9999,0
1668081442057,CSE 293,030,119420,Saul; Lawrence,9999,0,9999,0
1668081442057,CSE 293,031,119421,Savage; Stefan,9999,0,9999,0
1668081442057,CSE 293,032,119425,Schulze; Jurgen P.,9999,0,9999,0
1668081442057,CSE 293,033,119426,Snoeren; Alex C.,9999,0,9999,0
1668081442057,CSE 293,034,119428,Shang; Jingbo,9999,0,9999,0
1668081442057,CSE 293,035,119430,Stefan; Deian,9999,0,9999,0
1668081442057,CSE 293,036,119431,Su; Hao,9999,0,9999,0
1668081442057,CSE 293,037,119433,Swanson; Steven James,9999,0,9999,0
1668081442057,CSE 293,038,119435,Tullsen; Dean Michael,9999,0,9999,0
1668081442057,CSE 293,039,119483,Voelker; Geoffrey M.,9999,0,9999,0
1668081442057,CSE 293,040,119537,Zhao; Jishen,9999,0,9999,0
1668081442057,CSE 293,041,119538,Zhou; Yuan-Yuan,9999,0,9999,0
1668081442057,CSE 293,042,119539,Gao; Sicun,9999,0,9999,0
1668081442057,CSE 293,043,119540,Weibel; Nadir,9999,0,9999,0
1668081442057,CSE 293,044,119541,Gupta; Rajesh K.,9999,0,9999,0
1668081442057,CSE 293,045,126410,Vaccaro; Kristen Marie,9999,0,9999,0
1668081442057,CSE 293,046,126411,Klemke; Richard,9999,0,9999,0
1668081442480,CSE 294,A00,102459,Voelker; Geoffrey M.,0,0,0,0
1668081442480,CSE 294,B00,111322,Orailoglu; Alex,0,0,0,0
1668081442906,DSE 201,A00,096914,Deutsch; Alin Bernard,30,0,30,0
1668081443335,DSE 210,A00,096915,Dasgupta; Sanjoy,30,0,30,0
1668081443760,DSE 260A,A00,096916,Altintas De Callaf; Ilkay,30,0,30,0
1668081444219,ECE 200,001,103586,Antipa; Nicholas A,9999,0,9999,0
1668081444219,ECE 200,002,103587,Atanasov; Nikolay A.,9999,0,9999,0
1668081444219,ECE 200,003,103588,Bharadia; Dinesh,9999,0,9999,0
1668081444219,ECE 200,004,103589,Cheng; Chung Kuan,9999,0,9999,0
1668081444219,ECE 200,005,103590,Cosman; Pamela C.,9999,0,9999,0
1668081444219,ECE 200,006,103591,Dayeh; Shadi Ahmad,9999,0,9999,0
1668081444219,ECE 200,007,103592,Fainman; Yeshaiahu,9999,0,9999,0
1668081444219,ECE 200,008,103593,Ford; Joseph Earl,9999,0,9999,0
1668081444219,ECE 200,009,103594,Franceschetti; Massimo,9999,0,9999,0
1668081444219,ECE 200,010,103595,Fullerton; Eric E,9999,0,9999,0
1668081444219,ECE 200,011,103596,Galton; Ian A,9999,0,9999,0
1668081444219,ECE 200,012,103597,Gilja; Vikash,9999,0,9999,0
1668081444219,ECE 200,013,103598,Hall; Drew A.,9999,0,9999,0
1668081444219,ECE 200,014,103599,Hsueh; Tzu-Chien,9999,0,9999,0
1668081444219,ECE 200,015,103600,Javidi; Tara,9999,0,9999,0
1668081444219,ECE 200,016,103601,Kahng; Andrew Byun,9999,0,9999,0
1668081444219,ECE 200,017,103602,Kim; Young-Han,9999,0,9999,0
1668081444219,ECE 200,018,103603,Koushanfar; Farinaz,9999,0,9999,0
1668081444219,ECE 200,019,103604,Kuzum; Duygu,9999,0,9999,0
1668081444219,ECE 200,020,103605,Le; Hanh-Phuc,9999,0,9999,0
1668081444219,ECE 200,021,103606,Lin; Bill,9999,0,9999,0
1668081444219,ECE 200,022,103607,Liu; Zhaowei,9998,0,9999,1
1668081444219,ECE 200,023,103608,Lo; Yu-Hwa,9999,0,9999,0
1668081444219,ECE 200,024,103609,Lomakin; Vitaliy,9999,0,9999,0
1668081444219,ECE 200,025,103610,Mercier; Patrick Philip,9999,0,9999,0
1668081444219,ECE 200,026,103611,Meyer; Florian,9999,0,9999,0
1668081444219,ECE 200,027,103612,Milstein; Laurence B.,9999,0,9999,0
1668081444219,ECE 200,028,103613,Mir Arabbaygi; Siavash,9999,0,9999,0
1668081444219,ECE 200,029,103614,Mookherjea; Shayan,9999,0,9999,0
1668081444219,ECE 200,030,103615,Morris; Karcher William,9999,0,9999,0
1668081444219,ECE 200,031,103616,Ng; Tse Nga,9999,0,9999,0
1668081444219,ECE 200,032,103617,Nguyen; Truong Quang,9999,0,9999,0
1668081444219,ECE 200,033,103618,Nomura; Kenji,9999,0,9999,0
1668081444219,ECE 200,034,103619,Orlitsky; Alon,9999,0,9999,0
1668081444219,ECE 200,035,103620,Pal; Piya,9999,0,9999,0
1668081444219,ECE 200,036,103621,Papen; George C.,9999,0,9999,0
1668081444219,ECE 200,037,103622,Radic; Stojan,9999,0,9999,0
1668081444219,ECE 200,038,103623,Rao; Bhaskar D.,9999,0,9999,0
1668081444219,ECE 200,039,103624,Rao; Ramesh R,9999,0,9999,0
1668081444219,ECE 200,040,103625,Rebeiz; Gabriel,9999,0,9999,0
1668081444219,ECE 200,041,103626,Sanford; John R,9999,0,9999,0
1668081444219,ECE 200,042,103627,Siegel; Paul H.,9999,0,9999,0
1668081444219,ECE 200,043,103628,Sievenpiper; Daniel F.,9999,0,9999,0
1668081444219,ECE 200,044,103629,Sworder; David D.,9999,0,9999,0
1668081444219,ECE 200,045,103630,Taur; Yuan,9999,0,9999,0
1668081444219,ECE 200,046,103631,Touri; Behrouz,9999,0,9999,0
1668081444219,ECE 200,047,103632,Trivedi; Mohan M.,9999,0,9999,0
1668081444219,ECE 200,048,103633,Vasconcelos; Nuno,9999,0,9999,0
1668081444219,ECE 200,049,103634,Wang; Xiaolong,9999,0,9999,0
1668081444219,ECE 200,050,103635,Xie; Pengtao,9999,0,9999,0
1668081444219,ECE 200,051,103636,Yip; Michael,9999,0,9999,0
1668081444219,ECE 200,052,103637,Zeger; Kenneth A.,999,0,999,0
1668081444219,ECE 200,053,103638,Zhang; Xinyu,9999,0,9999,0
1668081444219,ECE 200,054,103639,Turakhia; Yatish Girish,9999,0,9999,0
1668081444219,ECE 200,055,103640,Kang; Mingu,9999,0,9999,0
1668081444219,ECE 200,056,103641,Shi; Yuanyuan,9999,0,9999,0
1668081444219,ECE 200,057,103642,Wang; Edward Jay,9999,0,9999,0
1668081444219,ECE 200,058,103643,Zheng; Yang,9999,0,9999,0
1668081444644,ECE 202,A00,103644,Kuzum; Duygu,0,0,0,0
1668081445068,ECE 212BN,A00,103646,Ng; Tse Nga,0,0,0,0
1668081445497,ECE 221,A00,111493,Staff,0,0,0,0
1668081445924,ECE 222B,A00,103647,Lomakin; Vitaliy,0,0,0,0
1668081446349,ECE 230B,A00,103648,Taur; Yuan,0,0,0,0
1668081446774,ECE 238B,A00,103649,Garay; Javier,0,0,0,0
1668081447199,ECE 240B,A00,112900,Fainman; Yeshaiahu,0,0,0,0
1668081447623,ECE 247A,A00,103650,Jokerst; Jesse Vincent,0,0,0,0
1668081448049,ECE 247B,A00,103651,Wang; Joseph,0,0,0,0
1668081448483,ECE 250,A00,103652,Siegel; Paul H.,0,0,0,0
1668081448986,ECE 251A,A00,103654,Rao; Bhaskar D.,0,0,0,0
1668081449409,ECE 257B,A00,103655,Bharadia; Dinesh,0,0,0,0
1668081449834,ECE 258A,A00,103656,Milstein; Laurence B.,0,0,0,0
1668081450261,ECE 260B,A00,103658,Kang; Mingu,0,0,0,0
1668081450685,ECE 264A,A00,103659,Galton; Ian A,0,0,0,0
1668081451124,ECE 265A,A00,103661,Gudem; Prasad S.S.,0,0,0,0
1668081451552,ECE 265D,A00,103662,Gudem; Prasad S.S.,0,0,0,0
1668081451980,ECE 268,A00,103663,Koushanfar; Farinaz,0,0,0,0
1668081452403,ECE 269,A01,103665,Pal; Piya,0,0,0,0
1668081452831,ECE 271B,A00,103666,Vasconcelos; Manuela,0,0,0,0
1668081453266,ECE 276A,A00,103667,Atanasov; Nikolay A.,0,0,0,0
1668081453693,ECE 277,A00,103668,An; Cheolhong,0,0,0,0
1668081454122,ECE 279,A00,117947,Hall; Drew A.,0,0,0,0
1668081454978,ECE 283,A00,103670,Hsueh; Tzu-Chien,0,0,0,0
1668081455404,ECE 284,A00,103671,Turakhia; Yatish Girish,0,0,0,0
1668081455833,ECE 285,A00,103672,Zheng; Yang,0,0,0,0
1668081455833,ECE 285,B00,103673,Sworder; David D.,0,0,0,0
1668081456258,ECE 287,A00,103676,Javidi; Tara,0,0,0,0
1668081456684,MATH 200B,A00,098023,Salehi Golsefidy; Alireza,13,0,15,2
1668081457110,MATH 202B,A00,098024,Rhoades; Brendon Patrick,9,0,15,6
1668081457539,MATH 203B,A00,098025,Oprea; Dragos N.,10,0,15,5
1668081457968,MATH 204B,A00,098026,Sorensen; Claus M,13,0,15,2
1668081458392,MATH 208,A00,098027,Izadi; Elham,7,0,10,3
1668081458817,MATH 209,A00,098028,Pollack; Aaron,10,0,10,0
1668081459242,MATH 211A,A00,112919,Rogalski; Daniel,9,0,10,1
1668081459665,MATH 211B,A00,112920,Seward; Brandon M.,9,0,10,1
1668081460093,MATH 218,A00,098029,Li; Bo,10,0,10,0
1668081460522,MATH 220B,A00,098030,Novak; Jonathan I,12,0,15,3
1668081460950,MATH 221A,A00,098031,Ebenfelt; Peter F,13,0,15,2
1668081461378,MATH 231B,A00,098032,Zlatos; Andrej,12,0,15,3
1668081461805,MATH 240B,A00,098033,Ni; Lei,9,0,15,6
1668081462229,MATH 243,A00,098034,Jekel; David Andrew,10,0,10,0
1668081462663,MATH 245A,A00,098035,Nie; Jiawang,0,0,15,16
1668081463091,MATH 248,A00,098036,Bejenaru; Ioan,10,0,10,0
1668081463515,MATH 250B,A00,098037,Spolaor; Luca,14,0,15,1
1668081463943,MATH 258,A00,098038,Ni; Lei,10,0,10,0
1668081464372,MATH 264B,A00,098041,Rhoades; Brendon Patrick,10,0,15,5
1668081464797,MATH 268,A00,098042,Buss; Samuel R,10,0,10,0
1668081465227,MATH 269,A00,098043,Rhoades; Brendon Patrick,10,0,10,0
1668081465653,MATH 270B,A00,098044,Li; Bo,11,0,15,4
1668081466084,MATH 272B,A00,098045,Holst; Michael J,13,0,15,2
1668081466509,MATH 273A,A00,098046,Tian; Xiaochuan,10,0,15,5
1668081466934,MATH 275,A01,098048,Tian; Xiaochuan,6,0,10,4
1668081467358,MATH 278A,A00,098049,Holst; Michael J,8,0,10,2
1668081467787,MATH 278B,A00,098050,Cloninger; Alexander,10,0,10,0
1668081468211,MATH 278C,A00,098051,Nie; Jiawang,7,0,10,3
1668081468634,MATH 280B,A00,098052,Zheng; Tianyi,10,0,15,5
1668081469064,MATH 281B,A00,098053,Bradic; Jelena,3,0,15,12
1668081469493,MATH 282B,A00,098054,Arias-Castro; Ery,0,0,15,15
1668081469933,MATH 285,A00,098055,Fitzsimmons; Patrick J,0,0,15,17
1668081470358,MATH 287B,A00,098056,Arias-Castro; Ery,3,0,15,12
1668081470798,MATH 288,A00,098057,Agarwal; Pooja,9,0,10,1
1668081470798,MATH 288,B00,098058,Zhang; Danna,8,0,10,2
1668081470798,MATH 288,C00,098059,Williams; Ruth J,10,0,10,0
1668081471226,MATH 290B,A00,098060,Roberts; Justin Deritter,13,0,15,2
1668081471651,MATH 292,A00,098061,Belmont; Eva Kinoshita,10,0,10,0
1668081472080,MATH 295,A00,098062,Suk; Andrew Hoon,48,0,50,2
1668081472506,MATH 296,A00,098063,Novak; Jonathan I,20,0,20,0
1668081472932,MATH 297,001,098064,Gamst; Anthony Collins,9997,0,9999,2
1668081974051,COGS 205,A00,101395,Chiba; Andrea,19,0,20,1
1668081974477,COGS 210B,001,101404,Greene; Deanna Jacquelyn,9998,0,9999,1
1668081974477,COGS 210B,002,101417,Xia; Haijun,9999,0,9999,0
1668081974477,COGS 210B,003,101422,Nitz; Douglas A.,9999,0,9999,0
1668081974477,COGS 210B,004,101423,Hollan; James D.,9998,0,9999,1
1668081974477,COGS 210B,005,101424,Deak; Gedeon O.,9998,0,9999,1
1668081974477,COGS 210B,006,101425,Rossano; Federico,9999,0,9999,0
1668081974903,COGS 211B,A00,101427,Coulson; Seana M,9996,0,9999,3
1668081975333,COGS 220,A00,101428,Hollan; James D.,0,0,25,25
1668081975757,COGS 229,A00,101429,Dow; Steven P,18,0,25,7
1668081976186,COGS 230,A00,101430,Klemmer; Scott R,13,0,17,4
1668081976613,COGS 234,A00,101431,Xia; Haijun,3,0,25,22
1668081977039,COGS 260,A00,101432,Kiyonaga; Anastasia,19,0,25,6
1668081977039,COGS 260,B00,101433,Kirsh; David Joel,16,0,25,9
1668081977466,CSE 202,A00,102371,Impagliazzo; Russell,0,0,0,0
1668081977891,CSE 203B,A01,102373,Cheng; Chung Kuan,0,0,0,0
1668081978317,CSE 208,A00,102374,Micciancio; Daniele,0,0,0,0
1668081978739,CSE 209A,A00,112895,Impagliazzo; Russell,0,0,15,15
1668081979169,CSE 209B,A00,108005,Bellare; Mihir,0,0,0,0
1668081979602,CSE 210,A00,113163,Coblenz; Michael J,0,0,0,0
1668081980027,CSE 219,A00,106111,Dow; Steven P,0,0,20,20
1668081980456,CSE 221,A00,102376,Voelker; Geoffrey M.,0,0,0,0
1668081980886,CSE 224,A01,102378,Porter; George M,0,0,0,0
1668081981311,CSE 229A,A00,102379,Savage; Stefan,0,0,0,0
1668081981734,CSE 229C,A00,102380,Munyaka; Imani N. S.,0,0,0,0
1668081982163,CSE 232B,A00,102382,Deutsch; Alin Bernard,0,0,0,0
1668081982592,CSE 234,A01,112904,Kumar; Arun Kumar,0,0,0,0
1668081983017,CSE 237A,A00,102383,Rosing; Tajana Simunic,0,0,0,0
1668081983445,CSE 239A,A00,102384,Deutsch; Alin Bernard,0,0,0,0
1668081983869,CSE 239B,A00,102385,Polikarpova; Nadezhda,0,0,0,0
1668081984296,CSE 240A,A00,102386,Pannuto; Patrick William,0,0,0,0
1668081984720,CSE 240B,A00,102387,Zhao; Jishen,0,0,0,0
1668081985153,CSE 241A,A00,106406,Kang; Mingu,0,0,0,0
1668081985577,CSE 249B,A00,102388,Kahng; Andrew Byun,0,0,8,8
1668081986005,CSE 251B,A01,102392,Cottrell; Garrison W,0,0,0,0
1668081986005,CSE 251B,A02,102393,Cottrell; Garrison W,0,0,0,0
1668081986429,CSE 252B,A00,102394,Ochoa; Benjamin Lawrence,0,0,0,0
1668081986856,CSE 257,A01,102396,Gao; Sicun,0,0,0,0
1668081987287,CSE 272,A00,102397,Li; Tzumao,0,0,0,0
1668081987710,CSE 274,A00,111323,Chern; Albert Ren-Haur,0,0,0,0
1668081988135,CSE 282,A00,102398,Pevzner; Pavel Arkadjevich,0,0,0,0
1668081988566,CSE 284,A00,114175,Gymrek; Melissa Ann,0,0,0,0
1668081988995,CSE 290,A00,102399,Chandraker; Manmohan Krishna,0,0,0,0
1668081988995,CSE 290,B00,102400,Vaccaro; Kristen Marie,0,0,25,25
1668081988995,CSE 290,C00,102414,Pannuto; Patrick William,0,0,25,25
1668081988995,CSE 290,D00,102427,Pevzner; Pavel Arkadjevich,0,0,0,0
1668081988995,CSE 290,E00,102429,Zhao; Jishen,0,0,0,0
1668081988995,CSE 290,F00,102436,Tullsen; Dean Michael,0,0,0,0
1668081988995,CSE 290,G00,102440,Christensen; Henrik I,0,0,20,20
1668081989429,CSE 291,A00,102443,Su; Hao,0,0,0,0
1668081989429,CSE 291,B00,102448,Polikarpova; Nadezhda,0,0,0,0
1668081989429,CSE 291,C00,102453,Vaccaro; Kristen Marie,0,0,0,0
1668081989429,CSE 291,D00,111343,Savage; Stefan,0,0,0,0
1668081989429,CSE 291,E00,116474,Claffy; Kimberly Claire,0,0,0,0
1668081989429,CSE 291,F00,116479,Pasquale; Joseph,0,0,0,0
1668081989873,CSE 293,001,119111,Bafna; Vineet,9999,0,9999,0
1668081989873,CSE 293,002,119118,Bellare; Mihir,9999,0,9999,0
1668081989873,CSE 293,003,119122,Berg-Kirkpatrick; Taylor D,9999,0,9999,0
1668081989873,CSE 293,004,119135,Christensen; Henrik I,9999,0,9999,0
1668081989873,CSE 293,005,119142,Cottrell; Garrison W,9999,0,9999,0
1668081989873,CSE 293,006,119146,Deutsch; Alin Bernard,9999,0,9999,0
1668081989873,CSE 293,007,119159,Esmaeilzadeh; Hadi,9999,0,9999,0
1668081989873,CSE 293,008,119166,Freund; Yoav,9999,0,9999,0
1668081989873,CSE 293,009,119170,Griswold; William G.,9999,0,9999,0
1668081989873,CSE 293,010,119183,Gymrek; Melissa Ann,9999,0,9999,0
1668081989873,CSE 293,011,119190,Heninger; Nadia A,9999,0,9999,0
1668081989873,CSE 293,012,119230,Impagliazzo; Russell,9999,0,9999,0
1668081989873,CSE 293,013,119232,Jhala; Ranjit,9999,0,9999,0
1668081989873,CSE 293,014,119233,Kahng; Andrew Byun,9999,0,9999,0
1668081989873,CSE 293,015,119298,Kane; Daniel Mertz,9999,0,9999,0
1668081989873,CSE 293,016,119299,Kriegman; David J,9999,0,9999,0
1668081989873,CSE 293,017,119300,Kumar; Arun Kumar,9999,0,9999,0
1668081989873,CSE 293,018,119301,Lerner; Sorin,9999,0,9999,0
1668081989873,CSE 293,019,119302,Lovett; Shachar,9999,0,9999,0
1668081989873,CSE 293,020,119303,McAuley; Julian John,9999,0,9999,0
1668081989873,CSE 293,021,119304,Micciancio; Daniele,9999,0,9999,0
1668081989873,CSE 293,022,119367,Orailoglu; Alex,9999,0,9999,0
1668081989873,CSE 293,023,119382,Paturi; Ramamohan,9999,0,9999,0
1668081989873,CSE 293,024,119404,Polikarpova; Nadezhda,9999,0,9999,0
1668081989873,CSE 293,025,119406,Politz; Joseph Gibbs,9999,0,9999,0
1668081989873,CSE 293,026,119411,Porter; George M,9999,0,9999,0
1668081989873,CSE 293,027,119414,Porter; Leonard Emerson,9999,0,9999,0
1668081989873,CSE 293,028,119416,Ramamoorthi; Ravi,9999,0,9999,0
1668081989873,CSE 293,029,119417,Sahoo; Debashis,9999,0,9999,0
1668081989873,CSE 293,030,119420,Saul; Lawrence,9999,0,9999,0
1668081989873,CSE 293,031,119421,Savage; Stefan,9999,0,9999,0
1668081989873,CSE 293,032,119425,Schulze; Jurgen P.,9999,0,9999,0
1668081989873,CSE 293,033,119426,Snoeren; Alex C.,9999,0,9999,0
1668081989873,CSE 293,034,119428,Shang; Jingbo,9999,0,9999,0
1668081989873,CSE 293,035,119430,Stefan; Deian,9999,0,9999,0
1668081989873,CSE 293,036,119431,Su; Hao,9999,0,9999,0
1668081989873,CSE 293,037,119433,Swanson; Steven James,9999,0,9999,0
1668081989873,CSE 293,038,119435,Tullsen; Dean Michael,9999,0,9999,0
1668081989873,CSE 293,039,119483,Voelker; Geoffrey M.,9999,0,9999,0
1668081989873,CSE 293,040,119537,Zhao; Jishen,9999,0,9999,0
1668081989873,CSE 293,041,119538,Zhou; Yuan-Yuan,9999,0,9999,0
1668081989873,CSE 293,042,119539,Gao; Sicun,9999,0,9999,0
1668081989873,CSE 293,043,119540,Weibel; Nadir,9999,0,9999,0
1668081989873,CSE 293,044,119541,Gupta; Rajesh K.,9999,0,9999,0
1668081989873,CSE 293,045,126410,Vaccaro; Kristen Marie,9999,0,9999,0
1668081989873,CSE 293,046,126411,Klemke; Richard,9999,0,9999,0
1668081990303,CSE 294,A00,102459,Voelker; Geoffrey M.,0,0,0,0
1668081990303,CSE 294,B00,111322,Orailoglu; Alex,0,0,0,0
1668081990729,DSE 201,A00,096914,Deutsch; Alin Bernard,30,0,30,0
1668081991156,DSE 210,A00,096915,Dasgupta; Sanjoy,30,0,30,0
1668081991579,DSE 260A,A00,096916,Altintas De Callaf; Ilkay,30,0,30,0
1668081992054,ECE 200,001,103586,Antipa; Nicholas A,9999,0,9999,0
1668081992054,ECE 200,002,103587,Atanasov; Nikolay A.,9999,0,9999,0
1668081992054,ECE 200,003,103588,Bharadia; Dinesh,9999,0,9999,0
1668081992054,ECE 200,004,103589,Cheng; Chung Kuan,9999,0,9999,0
1668081992054,ECE 200,005,103590,Cosman; Pamela C.,9999,0,9999,0
1668081992054,ECE 200,006,103591,Dayeh; Shadi Ahmad,9999,0,9999,0
1668081992054,ECE 200,007,103592,Fainman; Yeshaiahu,9999,0,9999,0
1668081992054,ECE 200,008,103593,Ford; Joseph Earl,9999,0,9999,0
1668081992054,ECE 200,009,103594,Franceschetti; Massimo,9999,0,9999,0
1668081992054,ECE 200,010,103595,Fullerton; Eric E,9999,0,9999,0
1668081992054,ECE 200,011,103596,Galton; Ian A,9999,0,9999,0
1668081992054,ECE 200,012,103597,Gilja; Vikash,9999,0,9999,0
1668081992054,ECE 200,013,103598,Hall; Drew A.,9999,0,9999,0
1668081992054,ECE 200,014,103599,Hsueh; Tzu-Chien,9999,0,9999,0
1668081992054,ECE 200,015,103600,Javidi; Tara,9999,0,9999,0
1668081992054,ECE 200,016,103601,Kahng; Andrew Byun,9999,0,9999,0
1668081992054,ECE 200,017,103602,Kim; Young-Han,9999,0,9999,0
1668081992054,ECE 200,018,103603,Koushanfar; Farinaz,9999,0,9999,0
1668081992054,ECE 200,019,103604,Kuzum; Duygu,9999,0,9999,0
1668081992054,ECE 200,020,103605,Le; Hanh-Phuc,9999,0,9999,0
1668081992054,ECE 200,021,103606,Lin; Bill,9999,0,9999,0
1668081992054,ECE 200,022,103607,Liu; Zhaowei,9998,0,9999,1
1668081992054,ECE 200,023,103608,Lo; Yu-Hwa,9999,0,9999,0
1668081992054,ECE 200,024,103609,Lomakin; Vitaliy,9999,0,9999,0
1668081992054,ECE 200,025,103610,Mercier; Patrick Philip,9999,0,9999,0
1668081992054,ECE 200,026,103611,Meyer; Florian,9999,0,9999,0
1668081992054,ECE 200,027,103612,Milstein; Laurence B.,9999,0,9999,0
1668081992054,ECE 200,028,103613,Mir Arabbaygi; Siavash,9999,0,9999,0
1668081992054,ECE 200,029,103614,Mookherjea; Shayan,9999,0,9999,0
1668081992054,ECE 200,030,103615,Morris; Karcher William,9999,0,9999,0
1668081992054,ECE 200,031,103616,Ng; Tse Nga,9999,0,9999,0
1668081992054,ECE 200,032,103617,Nguyen; Truong Quang,9999,0,9999,0
1668081992054,ECE 200,033,103618,Nomura; Kenji,9999,0,9999,0
1668081992054,ECE 200,034,103619,Orlitsky; Alon,9999,0,9999,0
1668081992054,ECE 200,035,103620,Pal; Piya,9999,0,9999,0
1668081992054,ECE 200,036,103621,Papen; George C.,9999,0,9999,0
1668081992054,ECE 200,037,103622,Radic; Stojan,9999,0,9999,0
1668081992054,ECE 200,038,103623,Rao; Bhaskar D.,9999,0,9999,0
1668081992054,ECE 200,039,103624,Rao; Ramesh R,9999,0,9999,0
1668081992054,ECE 200,040,103625,Rebeiz; Gabriel,9999,0,9999,0
1668081992054,ECE 200,041,103626,Sanford; John R,9999,0,9999,0
1668081992054,ECE 200,042,103627,Siegel; Paul H.,9999,0,9999,0
1668081992054,ECE 200,043,103628,Sievenpiper; Daniel F.,9999,0,9999,0
1668081992054,ECE 200,044,103629,Sworder; David D.,9999,0,9999,0
1668081992054,ECE 200,045,103630,Taur; Yuan,9999,0,9999,0
1668081992054,ECE 200,046,103631,Touri; Behrouz,9999,0,9999,0
1668081992054,ECE 200,047,103632,Trivedi; Mohan M.,9999,0,9999,0
1668081992054,ECE 200,048,103633,Vasconcelos; Nuno,9999,0,9999,0
1668081992054,ECE 200,049,103634,Wang; Xiaolong,9999,0,9999,0
1668081992054,ECE 200,050,103635,Xie; Pengtao,9999,0,9999,0
1668081992054,ECE 200,051,103636,Yip; Michael,9999,0,9999,0
1668081992054,ECE 200,052,103637,Zeger; Kenneth A.,999,0,999,0
1668081992054,ECE 200,053,103638,Zhang; Xinyu,9999,0,9999,0
1668081992054,ECE 200,054,103639,Turakhia; Yatish Girish,9999,0,9999,0
1668081992054,ECE 200,055,103640,Kang; Mingu,9999,0,9999,0
1668081992054,ECE 200,056,103641,Shi; Yuanyuan,9999,0,9999,0
1668081992054,ECE 200,057,103642,Wang; Edward Jay,9999,0,9999,0
1668081992054,ECE 200,058,103643,Zheng; Yang,9999,0,9999,0
1668081992484,ECE 202,A00,103644,Kuzum; Duygu,0,0,0,0
1668081992908,ECE 212BN,A00,103646,Ng; Tse Nga,0,0,0,0
1668081993335,ECE 221,A00,111493,Staff,0,0,0,0
1668081993759,ECE 222B,A00,103647,Lomakin; Vitaliy,0,0,0,0
1668081994189,ECE 230B,A00,103648,Taur; Yuan,0,0,0,0
1668081994617,ECE 238B,A00,103649,Garay; Javier,0,0,0,0
1668081995041,ECE 240B,A00,112900,Fainman; Yeshaiahu,0,0,0,0
1668081995467,ECE 247A,A00,103650,Jokerst; Jesse Vincent,0,0,0,0
1668081995900,ECE 247B,A00,103651,Wang; Joseph,0,0,0,0
1668081996324,ECE 250,A00,103652,Siegel; Paul H.,0,0,0,0
1668081996750,ECE 251A,A00,103654,Rao; Bhaskar D.,0,0,0,0
1668081997176,ECE 257B,A00,103655,Bharadia; Dinesh,0,0,0,0
1668081997604,ECE 258A,A00,103656,Milstein; Laurence B.,0,0,0,0
1668081998027,ECE 260B,A00,103658,Kang; Mingu,0,0,0,0
1668081998451,ECE 264A,A00,103659,Galton; Ian A,0,0,0,0
1668081998881,ECE 265A,A00,103661,Gudem; Prasad S.S.,0,0,0,0
1668081999310,ECE 265D,A00,103662,Gudem; Prasad S.S.,0,0,0,0
1668081999734,ECE 268,A00,103663,Koushanfar; Farinaz,0,0,0,0
1668082000159,ECE 269,A01,103665,Pal; Piya,0,0,0,0
1668082000583,ECE 271B,A00,103666,Vasconcelos; Manuela,0,0,0,0
1668082001008,ECE 276A,A00,103667,Atanasov; Nikolay A.,0,0,0,0
1668082001432,ECE 277,A00,103668,An; Cheolhong,0,0,0,0
1668082001861,ECE 279,A00,117947,Hall; Drew A.,0,0,0,0
1668082002712,ECE 283,A00,103670,Hsueh; Tzu-Chien,0,0,0,0
1668082003141,ECE 284,A00,103671,Turakhia; Yatish Girish,0,0,0,0
1668082003565,ECE 285,A00,103672,Zheng; Yang,0,0,0,0
1668082003565,ECE 285,B00,103673,Sworder; David D.,0,0,0,0
1668082003987,ECE 287,A00,103676,Javidi; Tara,0,0,0,0
1668082004414,MATH 200B,A00,098023,Salehi Golsefidy; Alireza,13,0,15,2
1668082004839,MATH 202B,A00,098024,Rhoades; Brendon Patrick,9,0,15,6
1668082005270,MATH 203B,A00,098025,Oprea; Dragos N.,10,0,15,5
1668082005696,MATH 204B,A00,098026,Sorensen; Claus M,13,0,15,2
1668082006119,MATH 208,A00,098027,Izadi; Elham,7,0,10,3
1668082006544,MATH 209,A00,098028,Pollack; Aaron,10,0,10,0
1668082006971,MATH 211A,A00,112919,Rogalski; Daniel,9,0,10,1
1668082007395,MATH 211B,A00,112920,Seward; Brandon M.,9,0,10,1
1668082007827,MATH 218,A00,098029,Li; Bo,10,0,10,0
1668082008255,MATH 220B,A00,098030,Novak; Jonathan I,12,0,15,3
1668082008684,MATH 221A,A00,098031,Ebenfelt; Peter F,13,0,15,2
1668082009109,MATH 231B,A00,098032,Zlatos; Andrej,12,0,15,3
1668082009537,MATH 240B,A00,098033,Ni; Lei,9,0,15,6
1668082009961,MATH 243,A00,098034,Jekel; David Andrew,10,0,10,0
1668082010391,MATH 245A,A00,098035,Nie; Jiawang,0,0,15,16
1668082010817,MATH 248,A00,098036,Bejenaru; Ioan,10,0,10,0
1668082011264,MATH 250B,A00,098037,Spolaor; Luca,14,0,15,1
1668082011687,MATH 258,A00,098038,Ni; Lei,10,0,10,0
1668082012112,MATH 264B,A00,098041,Rhoades; Brendon Patrick,10,0,15,5
1668082012535,MATH 268,A00,098042,Buss; Samuel R,10,0,10,0
1668082012959,MATH 269,A00,098043,Rhoades; Brendon Patrick,10,0,10,0
1668082013472,MATH 270B,A00,098044,Li; Bo,11,0,15,4
1668082013900,MATH 272B,A00,098045,Holst; Michael J,13,0,15,2
1668082014324,MATH 273A,A00,098046,Tian; Xiaochuan,10,0,15,5
1668082014752,MATH 275,A01,098048,Tian; Xiaochuan,6,0,10,4
1668082015178,MATH 278A,A00,098049,Holst; Michael J,8,0,10,2
1668082015603,MATH 278B,A00,098050,Cloninger; Alexander,10,0,10,0
1668082016031,MATH 278C,A00,098051,Nie; Jiawang,7,0,10,3
1668082016459,MATH 280B,A00,098052,Zheng; Tianyi,10,0,15,5
1668082016883,MATH 281B,A00,098053,Bradic; Jelena,3,0,15,12
1668082017313,MATH 282B,A00,098054,Arias-Castro; Ery,0,0,15,15
1668082017739,MATH 285,A00,098055,Fitzsimmons; Patrick J,0,0,15,17
1668082018161,MATH 287B,A00,098056,Arias-Castro; Ery,3,0,15,12
1668082018586,MATH 288,A00,098057,Agarwal; Pooja,9,0,10,1
1668082018586,MATH 288,B00,098058,Zhang; Danna,8,0,10,2
1668082018586,MATH 288,C00,098059,Williams; Ruth J,10,0,10,0
1668082019015,MATH 290B,A00,098060,Roberts; Justin Deritter,13,0,15,2
1668082019443,MATH 292,A00,098061,Belmont; Eva Kinoshita,10,0,10,0
1668082019870,MATH 295,A00,098062,Suk; Andrew Hoon,48,0,50,2
1668082020296,MATH 296,A00,098063,Novak; Jonathan I,20,0,20,0
1668082020719,MATH 297,001,098064,Gamst; Anthony Collins,9997,0,9999,2
