time,subj_course_id,sec_code,sec_id,prof,available,waitlist,total,enrolled_ct
1668169530272,COGS 205,A00,101395,Chiba; Andrea,19,0,20,1
1668169530703,COGS 210B,001,101404,Greene; Deanna Jacquelyn,9998,0,9999,1
1668169530703,COGS 210B,002,101417,Xia; Haijun,9999,0,9999,0
1668169530703,COGS 210B,003,101422,Nitz; Douglas A.,9999,0,9999,0
1668169530703,COGS 210B,004,101423,Hollan; James D.,9998,0,9999,1
1668169530703,COGS 210B,005,101424,Deak; Gedeon O.,9998,0,9999,1
1668169530703,COGS 210B,006,101425,Rossano; Federico,9999,0,9999,0
1668169531130,COGS 211B,A00,101427,Coulson; Seana M,9996,0,9999,3
1668169531556,COGS 220,A00,101428,Hollan; James D.,0,0,25,25
1668169531984,COGS 229,A00,101429,Dow; Steven P,18,0,25,7
1668169532414,COGS 230,A00,101430,Klemmer; Scott R,12,0,17,5
1668169532839,COGS 234,A00,101431,Xia; Haijun,3,0,25,22
1668169533271,COGS 260,A00,101432,Kiyonaga; Anastasia,20,0,25,5
1668169533271,COGS 260,B00,101433,Kirsh; David Joel,16,0,25,9
1668169533697,CSE 202,A00,102371,Impagliazzo; Russell,0,0,0,0
1668169534127,CSE 203B,A01,102373,Cheng; Chung Kuan,0,0,0,0
1668169534558,CSE 208,A00,102374,Micciancio; Daniele,0,0,0,0
1668169534984,CSE 209A,A00,112895,Impagliazzo; Russell,0,0,15,15
1668169535411,CSE 209B,A00,108005,Bellare; Mihir,0,0,0,0
1668169535842,CSE 210,A00,113163,Coblenz; Michael J,0,0,0,0
1668169536271,CSE 219,A00,106111,Dow; Steven P,0,0,20,20
1668169536696,CSE 221,A00,102376,Voelker; Geoffrey M.,0,0,0,0
1668169537127,CSE 224,A01,102378,Porter; George M,0,0,0,0
1668169537557,CSE 229A,A00,102379,Savage; Stefan,0,0,0,0
1668169537982,CSE 229C,A00,102380,Munyaka; Imani N. S.,0,0,0,0
1668169538414,CSE 232B,A00,102382,Deutsch; Alin Bernard,0,0,0,0
1668169538844,CSE 234,A01,112904,Kumar; Arun Kumar,0,0,0,0
1668169539270,CSE 237A,A00,102383,Rosing; Tajana Simunic,0,0,0,0
1668169539699,CSE 239A,A00,102384,Deutsch; Alin Bernard,0,0,0,0
1668169540128,CSE 239B,A00,102385,Polikarpova; Nadezhda,0,0,0,0
1668169540555,CSE 240A,A00,102386,Pannuto; Patrick William,0,0,0,0
1668169540982,CSE 240B,A00,102387,Zhao; Jishen,0,0,0,0
1668169541408,CSE 241A,A00,106406,Kang; Mingu,0,0,0,0
1668169541834,CSE 249B,A00,102388,Kahng; Andrew Byun,0,0,8,8
1668169542262,CSE 251B,A01,102392,Cottrell; Garrison W,0,0,0,0
1668169542262,CSE 251B,A02,102393,Cottrell; Garrison W,0,0,0,0
1668169542688,CSE 252B,A00,102394,Ochoa; Benjamin Lawrence,0,0,0,0
1668169543114,CSE 257,A01,102396,Gao; Sicun,0,0,0,0
1668169543539,CSE 272,A00,102397,Li; Tzumao,0,0,0,0
1668169543966,CSE 274,A00,111323,Chern; Albert Ren-Haur,0,0,0,0
1668169544394,CSE 282,A00,102398,Pevzner; Pavel Arkadjevich,0,0,0,0
1668169544821,CSE 284,A00,114175,Gymrek; Melissa Ann,0,0,0,0
1668169545262,CSE 290,A00,102399,Chandraker; Manmohan Krishna,0,0,0,0
1668169545262,CSE 290,B00,102400,Vaccaro; Kristen Marie,0,0,25,25
1668169545262,CSE 290,C00,102414,Pannuto; Patrick William,0,0,25,25
1668169545262,CSE 290,D00,102427,Pevzner; Pavel Arkadjevich,0,0,0,0
1668169545262,CSE 290,E00,102429,Zhao; Jishen,0,0,0,0
1668169545262,CSE 290,F00,102436,Tullsen; Dean Michael,0,0,0,0
1668169545262,CSE 290,G00,102440,Christensen; Henrik I,0,0,20,20
1668169545698,CSE 291,A00,102443,Su; Hao,0,0,0,0
1668169545698,CSE 291,B00,102448,Polikarpova; Nadezhda,0,0,0,0
1668169545698,CSE 291,C00,102453,Vaccaro; Kristen Marie,0,0,0,0
1668169545698,CSE 291,D00,111343,Savage; Stefan,0,0,0,0
1668169545698,CSE 291,E00,116474,Claffy; Kimberly Claire,0,0,0,0
1668169545698,CSE 291,F00,116479,Pasquale; Joseph,0,0,0,0
1668169546165,CSE 293,001,119111,Bafna; Vineet,9999,0,9999,0
1668169546165,CSE 293,002,119118,Bellare; Mihir,9999,0,9999,0
1668169546165,CSE 293,003,119122,Berg-Kirkpatrick; Taylor D,9999,0,9999,0
1668169546165,CSE 293,004,119135,Christensen; Henrik I,9999,0,9999,0
1668169546165,CSE 293,005,119142,Cottrell; Garrison W,9999,0,9999,0
1668169546165,CSE 293,006,119146,Deutsch; Alin Bernard,9999,0,9999,0
1668169546165,CSE 293,007,119159,Esmaeilzadeh; Hadi,9999,0,9999,0
1668169546165,CSE 293,008,119166,Freund; Yoav,9999,0,9999,0
1668169546165,CSE 293,009,119170,Griswold; William G.,9999,0,9999,0
1668169546165,CSE 293,010,119183,Gymrek; Melissa Ann,9999,0,9999,0
1668169546165,CSE 293,011,119190,Heninger; Nadia A,9999,0,9999,0
1668169546165,CSE 293,012,119230,Impagliazzo; Russell,9999,0,9999,0
1668169546165,CSE 293,013,119232,Jhala; Ranjit,9999,0,9999,0
1668169546165,CSE 293,014,119233,Kahng; Andrew Byun,9999,0,9999,0
1668169546165,CSE 293,015,119298,Kane; Daniel Mertz,9999,0,9999,0
1668169546165,CSE 293,016,119299,Kriegman; David J,9999,0,9999,0
1668169546165,CSE 293,017,119300,Kumar; Arun Kumar,9999,0,9999,0
1668169546165,CSE 293,018,119301,Lerner; Sorin,9999,0,9999,0
1668169546165,CSE 293,019,119302,Lovett; Shachar,9999,0,9999,0
1668169546165,CSE 293,020,119303,McAuley; Julian John,9999,0,9999,0
1668169546165,CSE 293,021,119304,Micciancio; Daniele,9999,0,9999,0
1668169546165,CSE 293,022,119367,Orailoglu; Alex,9999,0,9999,0
1668169546165,CSE 293,023,119382,Paturi; Ramamohan,9999,0,9999,0
1668169546165,CSE 293,024,119404,Polikarpova; Nadezhda,9999,0,9999,0
1668169546165,CSE 293,025,119406,Politz; Joseph Gibbs,9999,0,9999,0
1668169546165,CSE 293,026,119411,Porter; George M,9999,0,9999,0
1668169546165,CSE 293,027,119414,Porter; Leonard Emerson,9999,0,9999,0
1668169546165,CSE 293,028,119416,Ramamoorthi; Ravi,9999,0,9999,0
1668169546165,CSE 293,029,119417,Sahoo; Debashis,9999,0,9999,0
1668169546165,CSE 293,030,119420,Saul; Lawrence,9999,0,9999,0
1668169546165,CSE 293,031,119421,Savage; Stefan,9999,0,9999,0
1668169546165,CSE 293,032,119425,Schulze; Jurgen P.,9999,0,9999,0
1668169546165,CSE 293,033,119426,Snoeren; Alex C.,9999,0,9999,0
1668169546165,CSE 293,034,119428,Shang; Jingbo,9999,0,9999,0
1668169546165,CSE 293,035,119430,Stefan; Deian,9999,0,9999,0
1668169546165,CSE 293,036,119431,Su; Hao,9999,0,9999,0
1668169546165,CSE 293,037,119433,Swanson; Steven James,9999,0,9999,0
1668169546165,CSE 293,038,119435,Tullsen; Dean Michael,9999,0,9999,0
1668169546165,CSE 293,039,119483,Voelker; Geoffrey M.,9999,0,9999,0
1668169546165,CSE 293,040,119537,Zhao; Jishen,9999,0,9999,0
1668169546165,CSE 293,041,119538,Zhou; Yuan-Yuan,9999,0,9999,0
1668169546165,CSE 293,042,119539,Gao; Sicun,9999,0,9999,0
1668169546165,CSE 293,043,119540,Weibel; Nadir,9999,0,9999,0
1668169546165,CSE 293,044,119541,Gupta; Rajesh K.,9999,0,9999,0
1668169546165,CSE 293,045,126410,Vaccaro; Kristen Marie,9999,0,9999,0
1668169546165,CSE 293,046,126411,Klemke; Richard,9999,0,9999,0
1668169546594,CSE 294,A00,102459,Voelker; Geoffrey M.,0,0,0,0
1668169546594,CSE 294,B00,111322,Orailoglu; Alex,0,0,0,0
1668169547022,DSE 201,A00,096914,Deutsch; Alin Bernard,30,0,30,0
1668169547448,DSE 210,A00,096915,Dasgupta; Sanjoy,30,0,30,0
1668169547874,DSE 260A,A00,096916,Altintas De Callaf; Ilkay,30,0,30,0
1668169548336,ECE 200,001,103586,Antipa; Nicholas A,9999,0,9999,0
1668169548336,ECE 200,002,103587,Atanasov; Nikolay A.,9999,0,9999,0
1668169548336,ECE 200,003,103588,Bharadia; Dinesh,9999,0,9999,0
1668169548336,ECE 200,004,103589,Cheng; Chung Kuan,9999,0,9999,0
1668169548336,ECE 200,005,103590,Cosman; Pamela C.,9999,0,9999,0
1668169548336,ECE 200,006,103591,Dayeh; Shadi Ahmad,9999,0,9999,0
1668169548336,ECE 200,007,103592,Fainman; Yeshaiahu,9999,0,9999,0
1668169548336,ECE 200,008,103593,Ford; Joseph Earl,9999,0,9999,0
1668169548336,ECE 200,009,103594,Franceschetti; Massimo,9999,0,9999,0
1668169548336,ECE 200,010,103595,Fullerton; Eric E,9999,0,9999,0
1668169548336,ECE 200,011,103596,Galton; Ian A,9999,0,9999,0
1668169548336,ECE 200,012,103597,Gilja; Vikash,9999,0,9999,0
1668169548336,ECE 200,013,103598,Hall; Drew A.,9999,0,9999,0
1668169548336,ECE 200,014,103599,Hsueh; Tzu-Chien,9999,0,9999,0
1668169548336,ECE 200,015,103600,Javidi; Tara,9999,0,9999,0
1668169548336,ECE 200,016,103601,Kahng; Andrew Byun,9999,0,9999,0
1668169548336,ECE 200,017,103602,Kim; Young-Han,9999,0,9999,0
1668169548336,ECE 200,018,103603,Koushanfar; Farinaz,9999,0,9999,0
1668169548336,ECE 200,019,103604,Kuzum; Duygu,9999,0,9999,0
1668169548336,ECE 200,020,103605,Le; Hanh-Phuc,9999,0,9999,0
1668169548336,ECE 200,021,103606,Lin; Bill,9999,0,9999,0
1668169548336,ECE 200,022,103607,Liu; Zhaowei,9998,0,9999,1
1668169548336,ECE 200,023,103608,Lo; Yu-Hwa,9999,0,9999,0
1668169548336,ECE 200,024,103609,Lomakin; Vitaliy,9999,0,9999,0
1668169548336,ECE 200,025,103610,Mercier; Patrick Philip,9999,0,9999,0
1668169548336,ECE 200,026,103611,Meyer; Florian,9999,0,9999,0
1668169548336,ECE 200,027,103612,Milstein; Laurence B.,9999,0,9999,0
1668169548336,ECE 200,028,103613,Mir Arabbaygi; Siavash,9999,0,9999,0
1668169548336,ECE 200,029,103614,Mookherjea; Shayan,9999,0,9999,0
1668169548336,ECE 200,030,103615,Morris; Karcher William,9999,0,9999,0
1668169548336,ECE 200,031,103616,Ng; Tse Nga,9999,0,9999,0
1668169548336,ECE 200,032,103617,Nguyen; Truong Quang,9999,0,9999,0
1668169548336,ECE 200,033,103618,Nomura; Kenji,9999,0,9999,0
1668169548336,ECE 200,034,103619,Orlitsky; Alon,9999,0,9999,0
1668169548336,ECE 200,035,103620,Pal; Piya,9999,0,9999,0
1668169548336,ECE 200,036,103621,Papen; George C.,9999,0,9999,0
1668169548336,ECE 200,037,103622,Radic; Stojan,9999,0,9999,0
1668169548336,ECE 200,038,103623,Rao; Bhaskar D.,9999,0,9999,0
1668169548336,ECE 200,039,103624,Rao; Ramesh R,9999,0,9999,0
1668169548336,ECE 200,040,103625,Rebeiz; Gabriel,9999,0,9999,0
1668169548336,ECE 200,041,103626,Sanford; John R,9999,0,9999,0
1668169548336,ECE 200,042,103627,Siegel; Paul H.,9999,0,9999,0
1668169548336,ECE 200,043,103628,Sievenpiper; Daniel F.,9999,0,9999,0
1668169548336,ECE 200,044,103629,Sworder; David D.,9999,0,9999,0
1668169548336,ECE 200,045,103630,Taur; Yuan,9999,0,9999,0
1668169548336,ECE 200,046,103631,Touri; Behrouz,9999,0,9999,0
1668169548336,ECE 200,047,103632,Trivedi; Mohan M.,9999,0,9999,0
1668169548336,ECE 200,048,103633,Vasconcelos; Nuno,9999,0,9999,0
1668169548336,ECE 200,049,103634,Wang; Xiaolong,9999,0,9999,0
1668169548336,ECE 200,050,103635,Xie; Pengtao,9999,0,9999,0
1668169548336,ECE 200,051,103636,Yip; Michael,9999,0,9999,0
1668169548336,ECE 200,052,103637,Zeger; Kenneth A.,999,0,999,0
1668169548336,ECE 200,053,103638,Zhang; Xinyu,9999,0,9999,0
1668169548336,ECE 200,054,103639,Turakhia; Yatish Girish,9999,0,9999,0
1668169548336,ECE 200,055,103640,Kang; Mingu,9999,0,9999,0
1668169548336,ECE 200,056,103641,Shi; Yuanyuan,9999,0,9999,0
1668169548336,ECE 200,057,103642,Wang; Edward Jay,9999,0,9999,0
1668169548336,ECE 200,058,103643,Zheng; Yang,9999,0,9999,0
1668169548764,ECE 202,A00,103644,Kuzum; Duygu,0,0,0,0
1668169549194,ECE 212BN,A00,103646,Ng; Tse Nga,0,0,0,0
1668169549728,ECE 221,A00,111493,Staff,0,0,0,0
1668169550156,ECE 222B,A00,103647,Lomakin; Vitaliy,0,0,0,0
1668169550581,ECE 230B,A00,103648,Taur; Yuan,0,0,0,0
1668169551020,ECE 238B,A00,103649,Garay; Javier,0,0,0,0
1668169551445,ECE 240B,A00,112900,Fainman; Yeshaiahu,0,0,0,0
1668169551873,ECE 247A,A00,103650,Jokerst; Jesse Vincent,0,0,0,0
1668169552306,ECE 247B,A00,103651,Wang; Joseph,0,0,0,0
1668169552737,ECE 250,A00,103652,Siegel; Paul H.,0,0,0,0
1668169553163,ECE 251A,A00,103654,Rao; Bhaskar D.,0,0,0,0
1668169553589,ECE 257B,A00,103655,Bharadia; Dinesh,0,0,0,0
1668169554019,ECE 258A,A00,103656,Milstein; Laurence B.,0,0,0,0
1668169554444,ECE 260B,A00,103658,Kang; Mingu,0,0,0,0
1668169554868,ECE 264A,A00,103659,Galton; Ian A,0,0,0,0
1668169555293,ECE 265A,A00,103661,Gudem; Prasad S.S.,0,0,0,0
1668169555718,ECE 265D,A00,103662,Gudem; Prasad S.S.,0,0,0,0
1668169556146,ECE 268,A00,103663,Koushanfar; Farinaz,0,0,0,0
1668169556576,ECE 269,A01,103665,Pal; Piya,0,0,0,0
1668169557008,ECE 271B,A00,103666,Vasconcelos; Manuela,0,0,0,0
1668169557433,ECE 276A,A00,103667,Atanasov; Nikolay A.,0,0,0,0
1668169557859,ECE 277,A00,103668,An; Cheolhong,0,0,0,0
1668169558287,ECE 279,A00,117947,Hall; Drew A.,0,0,0,0
1668169559141,ECE 283,A00,103670,Hsueh; Tzu-Chien,0,0,0,0
1668169559569,ECE 284,A00,103671,Turakhia; Yatish Girish,0,0,0,0
1668169559997,ECE 285,A00,103672,Zheng; Yang,0,0,0,0
1668169559997,ECE 285,B00,103673,Sworder; David D.,0,0,0,0
1668169560423,ECE 287,A00,103676,Javidi; Tara,0,0,0,0
1668169560850,MATH 200B,A00,098023,Salehi Golsefidy; Alireza,12,0,15,3
1668169561277,MATH 202B,A00,098024,Rhoades; Brendon Patrick,9,0,15,6
1668169561705,MATH 203B,A00,098025,Oprea; Dragos N.,10,0,15,5
1668169562131,MATH 204B,A00,098026,Sorensen; Claus M,13,0,15,2
1668169562562,MATH 208,A00,098027,Izadi; Elham,7,0,10,3
1668169562989,MATH 209,A00,098028,Pollack; Aaron,10,0,10,0
1668169563426,MATH 211A,A00,112919,Rogalski; Daniel,9,0,10,1
1668169563851,MATH 211B,A00,112920,Seward; Brandon M.,9,0,10,1
1668169564278,MATH 218,A00,098029,Li; Bo,10,0,10,0
1668169564707,MATH 220B,A00,098030,Novak; Jonathan I,11,0,15,4
1668169565133,MATH 221A,A00,098031,Ebenfelt; Peter F,13,0,15,2
1668169565562,MATH 231B,A00,098032,Zlatos; Andrej,12,0,15,3
1668169565989,MATH 240B,A00,098033,Ni; Lei,9,0,15,6
1668169566414,MATH 243,A00,098034,Jekel; David Andrew,10,0,10,0
1668169566845,MATH 245A,A00,098035,Nie; Jiawang,0,0,15,16
1668169567273,MATH 248,A00,098036,Bejenaru; Ioan,10,0,10,0
1668169567699,MATH 250B,A00,098037,Spolaor; Luca,14,0,15,1
1668169568128,MATH 258,A00,098038,Ni; Lei,10,0,10,0
1668169568575,MATH 264B,A00,098041,Rhoades; Brendon Patrick,9,0,15,6
1668169569001,MATH 268,A00,098042,Buss; Samuel R,10,0,10,0
1668169569427,MATH 269,A00,098043,Rhoades; Brendon Patrick,10,0,10,0
1668169569855,MATH 270B,A00,098044,Li; Bo,10,0,15,5
1668169570282,MATH 272B,A00,098045,Holst; Michael J,13,0,15,2
1668169570710,MATH 273A,A00,098046,Tian; Xiaochuan,10,0,15,5
1668169571137,MATH 275,A01,098048,Tian; Xiaochuan,6,0,10,4
1668169571561,MATH 278A,A00,098049,Holst; Michael J,8,0,10,2
1668169571988,MATH 278B,A00,098050,Cloninger; Alexander,10,0,10,0
1668169572413,MATH 278C,A00,098051,Nie; Jiawang,7,0,10,3
1668169572837,MATH 280B,A00,098052,Zheng; Tianyi,10,0,15,5
1668169573266,MATH 281B,A00,098053,Bradic; Jelena,2,0,15,13
1668169573702,MATH 282B,A00,098054,Arias-Castro; Ery,0,0,15,15
1668169574133,MATH 285,A00,098055,Fitzsimmons; Patrick J,0,0,15,17
1668169574561,MATH 287B,A00,098056,Arias-Castro; Ery,2,0,15,13
1668169574989,MATH 288,A00,098057,Agarwal; Pooja,9,0,10,1
1668169574989,MATH 288,B00,098058,Zhang; Danna,8,0,10,2
1668169574989,MATH 288,C00,098059,Williams; Ruth J,10,0,10,0
1668169575417,MATH 290B,A00,098060,Roberts; Justin Deritter,13,0,15,2
1668169575844,MATH 292,A00,098061,Belmont; Eva Kinoshita,10,0,10,0
1668169576270,MATH 295,A00,098062,Suk; Andrew Hoon,48,0,50,2
1668169576695,MATH 296,A00,098063,Novak; Jonathan I,20,0,20,0
1668169577121,MATH 297,001,098064,Gamst; Anthony Collins,9997,0,9999,2
1668170079039,COGS 205,A00,101395,Chiba; Andrea,19,0,20,1
1668170079466,COGS 210B,001,101404,Greene; Deanna Jacquelyn,9998,0,9999,1
1668170079466,COGS 210B,002,101417,Xia; Haijun,9999,0,9999,0
1668170079466,COGS 210B,003,101422,Nitz; Douglas A.,9999,0,9999,0
1668170079466,COGS 210B,004,101423,Hollan; James D.,9998,0,9999,1
1668170079466,COGS 210B,005,101424,Deak; Gedeon O.,9998,0,9999,1
1668170079466,COGS 210B,006,101425,Rossano; Federico,9999,0,9999,0
1668170079895,COGS 211B,A00,101427,Coulson; Seana M,9996,0,9999,3
1668170080319,COGS 220,A00,101428,Hollan; James D.,0,0,25,25
1668170080744,COGS 229,A00,101429,Dow; Steven P,18,0,25,7
1668170081168,COGS 230,A00,101430,Klemmer; Scott R,12,0,17,5
1668170081593,COGS 234,A00,101431,Xia; Haijun,3,0,25,22
1668170082021,COGS 260,A00,101432,Kiyonaga; Anastasia,20,0,25,5
1668170082021,COGS 260,B00,101433,Kirsh; David Joel,16,0,25,9
1668170082452,CSE 202,A00,102371,Impagliazzo; Russell,0,0,0,0
1668170082881,CSE 203B,A01,102373,Cheng; Chung Kuan,0,0,0,0
1668170083307,CSE 208,A00,102374,Micciancio; Daniele,0,0,0,0
1668170083732,CSE 209A,A00,112895,Impagliazzo; Russell,0,0,15,15
1668170084162,CSE 209B,A00,108005,Bellare; Mihir,0,0,0,0
1668170084587,CSE 210,A00,113163,Coblenz; Michael J,0,0,0,0
1668170085016,CSE 219,A00,106111,Dow; Steven P,0,0,20,20
1668170085447,CSE 221,A00,102376,Voelker; Geoffrey M.,0,0,0,0
1668170085871,CSE 224,A01,102378,Porter; George M,0,0,0,0
1668170086296,CSE 229A,A00,102379,Savage; Stefan,0,0,0,0
1668170086721,CSE 229C,A00,102380,Munyaka; Imani N. S.,0,0,0,0
1668170087153,CSE 232B,A00,102382,Deutsch; Alin Bernard,0,0,0,0
1668170087584,CSE 234,A01,112904,Kumar; Arun Kumar,0,0,0,0
1668170088008,CSE 237A,A00,102383,Rosing; Tajana Simunic,0,0,0,0
1668170088434,CSE 239A,A00,102384,Deutsch; Alin Bernard,0,0,0,0
1668170088858,CSE 239B,A00,102385,Polikarpova; Nadezhda,0,0,0,0
1668170089287,CSE 240A,A00,102386,Pannuto; Patrick William,0,0,0,0
1668170089711,CSE 240B,A00,102387,Zhao; Jishen,0,0,0,0
1668170090141,CSE 241A,A00,106406,Kang; Mingu,0,0,0,0
1668170090566,CSE 249B,A00,102388,Kahng; Andrew Byun,0,0,8,8
1668170090995,CSE 251B,A01,102392,Cottrell; Garrison W,0,0,0,0
1668170090995,CSE 251B,A02,102393,Cottrell; Garrison W,0,0,0,0
1668170091424,CSE 252B,A00,102394,Ochoa; Benjamin Lawrence,0,0,0,0
1668170091859,CSE 257,A01,102396,Gao; Sicun,0,0,0,0
1668170092291,CSE 272,A00,102397,Li; Tzumao,0,0,0,0
1668170092718,CSE 274,A00,111323,Chern; Albert Ren-Haur,0,0,0,0
1668170093143,CSE 282,A00,102398,Pevzner; Pavel Arkadjevich,0,0,0,0
1668170093568,CSE 284,A00,114175,Gymrek; Melissa Ann,0,0,0,0
1668170094006,CSE 290,A00,102399,Chandraker; Manmohan Krishna,0,0,0,0
1668170094006,CSE 290,B00,102400,Vaccaro; Kristen Marie,0,0,25,25
1668170094006,CSE 290,C00,102414,Pannuto; Patrick William,0,0,25,25
1668170094006,CSE 290,D00,102427,Pevzner; Pavel Arkadjevich,0,0,0,0
1668170094006,CSE 290,E00,102429,Zhao; Jishen,0,0,0,0
1668170094006,CSE 290,F00,102436,Tullsen; Dean Michael,0,0,0,0
1668170094006,CSE 290,G00,102440,Christensen; Henrik I,0,0,20,20
1668170094434,CSE 291,A00,102443,Su; Hao,0,0,0,0
1668170094434,CSE 291,B00,102448,Polikarpova; Nadezhda,0,0,0,0
1668170094434,CSE 291,C00,102453,Vaccaro; Kristen Marie,0,0,0,0
1668170094434,CSE 291,D00,111343,Savage; Stefan,0,0,0,0
1668170094434,CSE 291,E00,116474,Claffy; Kimberly Claire,0,0,0,0
1668170094434,CSE 291,F00,116479,Pasquale; Joseph,0,0,0,0
1668170094906,CSE 293,001,119111,Bafna; Vineet,9999,0,9999,0
1668170094906,CSE 293,002,119118,Bellare; Mihir,9999,0,9999,0
1668170094906,CSE 293,003,119122,Berg-Kirkpatrick; Taylor D,9999,0,9999,0
1668170094906,CSE 293,004,119135,Christensen; Henrik I,9999,0,9999,0
1668170094906,CSE 293,005,119142,Cottrell; Garrison W,9999,0,9999,0
1668170094906,CSE 293,006,119146,Deutsch; Alin Bernard,9999,0,9999,0
1668170094906,CSE 293,007,119159,Esmaeilzadeh; Hadi,9999,0,9999,0
1668170094906,CSE 293,008,119166,Freund; Yoav,9999,0,9999,0
1668170094906,CSE 293,009,119170,Griswold; William G.,9999,0,9999,0
1668170094906,CSE 293,010,119183,Gymrek; Melissa Ann,9999,0,9999,0
1668170094906,CSE 293,011,119190,Heninger; Nadia A,9999,0,9999,0
1668170094906,CSE 293,012,119230,Impagliazzo; Russell,9999,0,9999,0
1668170094906,CSE 293,013,119232,Jhala; Ranjit,9999,0,9999,0
1668170094906,CSE 293,014,119233,Kahng; Andrew Byun,9999,0,9999,0
1668170094906,CSE 293,015,119298,Kane; Daniel Mertz,9999,0,9999,0
1668170094906,CSE 293,016,119299,Kriegman; David J,9999,0,9999,0
1668170094906,CSE 293,017,119300,Kumar; Arun Kumar,9999,0,9999,0
1668170094906,CSE 293,018,119301,Lerner; Sorin,9999,0,9999,0
1668170094906,CSE 293,019,119302,Lovett; Shachar,9999,0,9999,0
1668170094906,CSE 293,020,119303,McAuley; Julian John,9999,0,9999,0
1668170094906,CSE 293,021,119304,Micciancio; Daniele,9999,0,9999,0
1668170094906,CSE 293,022,119367,Orailoglu; Alex,9999,0,9999,0
1668170094906,CSE 293,023,119382,Paturi; Ramamohan,9999,0,9999,0
1668170094906,CSE 293,024,119404,Polikarpova; Nadezhda,9999,0,9999,0
1668170094906,CSE 293,025,119406,Politz; Joseph Gibbs,9999,0,9999,0
1668170094906,CSE 293,026,119411,Porter; George M,9999,0,9999,0
1668170094906,CSE 293,027,119414,Porter; Leonard Emerson,9999,0,9999,0
1668170094906,CSE 293,028,119416,Ramamoorthi; Ravi,9999,0,9999,0
1668170094906,CSE 293,029,119417,Sahoo; Debashis,9999,0,9999,0
1668170094906,CSE 293,030,119420,Saul; Lawrence,9999,0,9999,0
1668170094906,CSE 293,031,119421,Savage; Stefan,9999,0,9999,0
1668170094906,CSE 293,032,119425,Schulze; Jurgen P.,9999,0,9999,0
1668170094906,CSE 293,033,119426,Snoeren; Alex C.,9999,0,9999,0
1668170094906,CSE 293,034,119428,Shang; Jingbo,9999,0,9999,0
1668170094906,CSE 293,035,119430,Stefan; Deian,9999,0,9999,0
1668170094906,CSE 293,036,119431,Su; Hao,9999,0,9999,0
1668170094906,CSE 293,037,119433,Swanson; Steven James,9999,0,9999,0
1668170094906,CSE 293,038,119435,Tullsen; Dean Michael,9999,0,9999,0
1668170094906,CSE 293,039,119483,Voelker; Geoffrey M.,9999,0,9999,0
1668170094906,CSE 293,040,119537,Zhao; Jishen,9999,0,9999,0
1668170094906,CSE 293,041,119538,Zhou; Yuan-Yuan,9999,0,9999,0
1668170094906,CSE 293,042,119539,Gao; Sicun,9999,0,9999,0
1668170094906,CSE 293,043,119540,Weibel; Nadir,9999,0,9999,0
1668170094906,CSE 293,044,119541,Gupta; Rajesh K.,9999,0,9999,0
1668170094906,CSE 293,045,126410,Vaccaro; Kristen Marie,9999,0,9999,0
1668170094906,CSE 293,046,126411,Klemke; Richard,9999,0,9999,0
1668170095331,CSE 294,A00,102459,Voelker; Geoffrey M.,0,0,0,0
1668170095331,CSE 294,B00,111322,Orailoglu; Alex,0,0,0,0
1668170095760,DSE 201,A00,096914,Deutsch; Alin Bernard,30,0,30,0
1668170096191,DSE 210,A00,096915,Dasgupta; Sanjoy,30,0,30,0
1668170096617,DSE 260A,A00,096916,Altintas De Callaf; Ilkay,30,0,30,0
1668170097075,ECE 200,001,103586,Antipa; Nicholas A,9999,0,9999,0
1668170097075,ECE 200,002,103587,Atanasov; Nikolay A.,9999,0,9999,0
1668170097075,ECE 200,003,103588,Bharadia; Dinesh,9999,0,9999,0
1668170097075,ECE 200,004,103589,Cheng; Chung Kuan,9999,0,9999,0
1668170097075,ECE 200,005,103590,Cosman; Pamela C.,9999,0,9999,0
1668170097075,ECE 200,006,103591,Dayeh; Shadi Ahmad,9999,0,9999,0
1668170097075,ECE 200,007,103592,Fainman; Yeshaiahu,9999,0,9999,0
1668170097075,ECE 200,008,103593,Ford; Joseph Earl,9999,0,9999,0
1668170097075,ECE 200,009,103594,Franceschetti; Massimo,9999,0,9999,0
1668170097075,ECE 200,010,103595,Fullerton; Eric E,9999,0,9999,0
1668170097075,ECE 200,011,103596,Galton; Ian A,9999,0,9999,0
1668170097075,ECE 200,012,103597,Gilja; Vikash,9999,0,9999,0
1668170097075,ECE 200,013,103598,Hall; Drew A.,9999,0,9999,0
1668170097075,ECE 200,014,103599,Hsueh; Tzu-Chien,9999,0,9999,0
1668170097075,ECE 200,015,103600,Javidi; Tara,9999,0,9999,0
1668170097075,ECE 200,016,103601,Kahng; Andrew Byun,9999,0,9999,0
1668170097075,ECE 200,017,103602,Kim; Young-Han,9999,0,9999,0
1668170097075,ECE 200,018,103603,Koushanfar; Farinaz,9999,0,9999,0
1668170097075,ECE 200,019,103604,Kuzum; Duygu,9999,0,9999,0
1668170097075,ECE 200,020,103605,Le; Hanh-Phuc,9999,0,9999,0
1668170097075,ECE 200,021,103606,Lin; Bill,9999,0,9999,0
1668170097075,ECE 200,022,103607,Liu; Zhaowei,9998,0,9999,1
1668170097075,ECE 200,023,103608,Lo; Yu-Hwa,9999,0,9999,0
1668170097075,ECE 200,024,103609,Lomakin; Vitaliy,9999,0,9999,0
1668170097075,ECE 200,025,103610,Mercier; Patrick Philip,9999,0,9999,0
1668170097075,ECE 200,026,103611,Meyer; Florian,9999,0,9999,0
1668170097075,ECE 200,027,103612,Milstein; Laurence B.,9999,0,9999,0
1668170097075,ECE 200,028,103613,Mir Arabbaygi; Siavash,9999,0,9999,0
1668170097075,ECE 200,029,103614,Mookherjea; Shayan,9999,0,9999,0
1668170097075,ECE 200,030,103615,Morris; Karcher William,9999,0,9999,0
1668170097075,ECE 200,031,103616,Ng; Tse Nga,9999,0,9999,0
1668170097075,ECE 200,032,103617,Nguyen; Truong Quang,9999,0,9999,0
1668170097075,ECE 200,033,103618,Nomura; Kenji,9999,0,9999,0
1668170097075,ECE 200,034,103619,Orlitsky; Alon,9999,0,9999,0
1668170097075,ECE 200,035,103620,Pal; Piya,9999,0,9999,0
1668170097075,ECE 200,036,103621,Papen; George C.,9999,0,9999,0
1668170097075,ECE 200,037,103622,Radic; Stojan,9999,0,9999,0
1668170097075,ECE 200,038,103623,Rao; Bhaskar D.,9999,0,9999,0
1668170097075,ECE 200,039,103624,Rao; Ramesh R,9999,0,9999,0
1668170097075,ECE 200,040,103625,Rebeiz; Gabriel,9999,0,9999,0
1668170097075,ECE 200,041,103626,Sanford; John R,9999,0,9999,0
1668170097075,ECE 200,042,103627,Siegel; Paul H.,9999,0,9999,0
1668170097075,ECE 200,043,103628,Sievenpiper; Daniel F.,9999,0,9999,0
1668170097075,ECE 200,044,103629,Sworder; David D.,9999,0,9999,0
1668170097075,ECE 200,045,103630,Taur; Yuan,9999,0,9999,0
1668170097075,ECE 200,046,103631,Touri; Behrouz,9999,0,9999,0
1668170097075,ECE 200,047,103632,Trivedi; Mohan M.,9999,0,9999,0
1668170097075,ECE 200,048,103633,Vasconcelos; Nuno,9999,0,9999,0
1668170097075,ECE 200,049,103634,Wang; Xiaolong,9999,0,9999,0
1668170097075,ECE 200,050,103635,Xie; Pengtao,9999,0,9999,0
1668170097075,ECE 200,051,103636,Yip; Michael,9999,0,9999,0
1668170097075,ECE 200,052,103637,Zeger; Kenneth A.,999,0,999,0
1668170097075,ECE 200,053,103638,Zhang; Xinyu,9999,0,9999,0
1668170097075,ECE 200,054,103639,Turakhia; Yatish Girish,9999,0,9999,0
1668170097075,ECE 200,055,103640,Kang; Mingu,9999,0,9999,0
1668170097075,ECE 200,056,103641,Shi; Yuanyuan,9999,0,9999,0
1668170097075,ECE 200,057,103642,Wang; Edward Jay,9999,0,9999,0
1668170097075,ECE 200,058,103643,Zheng; Yang,9999,0,9999,0
1668170097499,ECE 202,A00,103644,Kuzum; Duygu,0,0,0,0
1668170097922,ECE 212BN,A00,103646,Ng; Tse Nga,0,0,0,0
1668170098347,ECE 221,A00,111493,Staff,0,0,0,0
1668170098776,ECE 222B,A00,103647,Lomakin; Vitaliy,0,0,0,0
1668170099206,ECE 230B,A00,103648,Taur; Yuan,0,0,0,0
1668170099637,ECE 238B,A00,103649,Garay; Javier,0,0,0,0
1668170100065,ECE 240B,A00,112900,Fainman; Yeshaiahu,0,0,0,0
1668170100490,ECE 247A,A00,103650,Jokerst; Jesse Vincent,0,0,0,0
1668170100915,ECE 247B,A00,103651,Wang; Joseph,0,0,0,0
1668170101347,ECE 250,A00,103652,Siegel; Paul H.,0,0,0,0
1668170101782,ECE 251A,A00,103654,Rao; Bhaskar D.,0,0,0,0
1668170102207,ECE 257B,A00,103655,Bharadia; Dinesh,0,0,0,0
1668170102637,ECE 258A,A00,103656,Milstein; Laurence B.,0,0,0,0
1668170103062,ECE 260B,A00,103658,Kang; Mingu,0,0,0,0
1668170103492,ECE 264A,A00,103659,Galton; Ian A,0,0,0,0
1668170103918,ECE 265A,A00,103661,Gudem; Prasad S.S.,0,0,0,0
1668170104342,ECE 265D,A00,103662,Gudem; Prasad S.S.,0,0,0,0
1668170104766,ECE 268,A00,103663,Koushanfar; Farinaz,0,0,0,0
1668170105191,ECE 269,A01,103665,Pal; Piya,0,0,0,0
1668170105616,ECE 271B,A00,103666,Vasconcelos; Manuela,0,0,0,0
1668170106045,ECE 276A,A00,103667,Atanasov; Nikolay A.,0,0,0,0
1668170106473,ECE 277,A00,103668,An; Cheolhong,0,0,0,0
1668170106898,ECE 279,A00,117947,Hall; Drew A.,0,0,0,0
1668170107749,ECE 283,A00,103670,Hsueh; Tzu-Chien,0,0,0,0
1668170108174,ECE 284,A00,103671,Turakhia; Yatish Girish,0,0,0,0
1668170108600,ECE 285,A00,103672,Zheng; Yang,0,0,0,0
1668170108600,ECE 285,B00,103673,Sworder; David D.,0,0,0,0
1668170109029,ECE 287,A00,103676,Javidi; Tara,0,0,0,0
1668170109457,MATH 200B,A00,098023,Salehi Golsefidy; Alireza,12,0,15,3
1668170109882,MATH 202B,A00,098024,Rhoades; Brendon Patrick,9,0,15,6
1668170110306,MATH 203B,A00,098025,Oprea; Dragos N.,10,0,15,5
1668170110732,MATH 204B,A00,098026,Sorensen; Claus M,13,0,15,2
1668170111158,MATH 208,A00,098027,Izadi; Elham,7,0,10,3
1668170111585,MATH 209,A00,098028,Pollack; Aaron,10,0,10,0
1668170112014,MATH 211A,A00,112919,Rogalski; Daniel,9,0,10,1
1668170112445,MATH 211B,A00,112920,Seward; Brandon M.,9,0,10,1
1668170112872,MATH 218,A00,098029,Li; Bo,10,0,10,0
1668170113296,MATH 220B,A00,098030,Novak; Jonathan I,11,0,15,4
1668170113720,MATH 221A,A00,098031,Ebenfelt; Peter F,13,0,15,2
1668170114147,MATH 231B,A00,098032,Zlatos; Andrej,12,0,15,3
1668170114577,MATH 240B,A00,098033,Ni; Lei,9,0,15,6
1668170115086,MATH 243,A00,098034,Jekel; David Andrew,10,0,10,0
1668170115511,MATH 245A,A00,098035,Nie; Jiawang,0,0,15,16
1668170115935,MATH 248,A00,098036,Bejenaru; Ioan,10,0,10,0
1668170116361,MATH 250B,A00,098037,Spolaor; Luca,14,0,15,1
1668170116789,MATH 258,A00,098038,Ni; Lei,10,0,10,0
1668170117214,MATH 264B,A00,098041,Rhoades; Brendon Patrick,9,0,15,6
1668170117642,MATH 268,A00,098042,Buss; Samuel R,10,0,10,0
1668170118066,MATH 269,A00,098043,Rhoades; Brendon Patrick,10,0,10,0
1668170118492,MATH 270B,A00,098044,Li; Bo,10,0,15,5
1668170118923,MATH 272B,A00,098045,Holst; Michael J,13,0,15,2
1668170119349,MATH 273A,A00,098046,Tian; Xiaochuan,10,0,15,5
1668170119775,MATH 275,A01,098048,Tian; Xiaochuan,6,0,10,4
1668170120200,MATH 278A,A00,098049,Holst; Michael J,8,0,10,2
1668170120623,MATH 278B,A00,098050,Cloninger; Alexander,10,0,10,0
1668170121047,MATH 278C,A00,098051,Nie; Jiawang,7,0,10,3
1668170121473,MATH 280B,A00,098052,Zheng; Tianyi,10,0,15,5
1668170121907,MATH 281B,A00,098053,Bradic; Jelena,2,0,15,13
1668170122333,MATH 282B,A00,098054,Arias-Castro; Ery,0,0,15,15
1668170122759,MATH 285,A00,098055,Fitzsimmons; Patrick J,0,0,15,17
1668170123184,MATH 287B,A00,098056,Arias-Castro; Ery,2,0,15,13
1668170123610,MATH 288,A00,098057,Agarwal; Pooja,9,0,10,1
1668170123610,MATH 288,B00,098058,Zhang; Danna,8,0,10,2
1668170123610,MATH 288,C00,098059,Williams; Ruth J,10,0,10,0
1668170124045,MATH 290B,A00,098060,Roberts; Justin Deritter,13,0,15,2
1668170124473,MATH 292,A00,098061,Belmont; Eva Kinoshita,10,0,10,0
1668170124899,MATH 295,A00,098062,Suk; Andrew Hoon,48,0,50,2
1668170125322,MATH 296,A00,098063,Novak; Jonathan I,20,0,20,0
1668170125750,MATH 297,001,098064,Gamst; Anthony Collins,9997,0,9999,2
1668170627827,COGS 205,A00,101395,Chiba; Andrea,19,0,20,1
1668170628256,COGS 210B,001,101404,Greene; Deanna Jacquelyn,9998,0,9999,1
1668170628256,COGS 210B,002,101417,Xia; Haijun,9999,0,9999,0
1668170628256,COGS 210B,003,101422,Nitz; Douglas A.,9999,0,9999,0
1668170628256,COGS 210B,004,101423,Hollan; James D.,9998,0,9999,1
1668170628256,COGS 210B,005,101424,Deak; Gedeon O.,9998,0,9999,1
1668170628256,COGS 210B,006,101425,Rossano; Federico,9999,0,9999,0
1668170628680,COGS 211B,A00,101427,Coulson; Seana M,9996,0,9999,3
1668170629103,COGS 220,A00,101428,Hollan; James D.,0,0,25,25
1668170629527,COGS 229,A00,101429,Dow; Steven P,18,0,25,7
1668170629950,COGS 230,A00,101430,Klemmer; Scott R,12,0,17,5
1668170630376,COGS 234,A00,101431,Xia; Haijun,3,0,25,22
1668170630806,COGS 260,A00,101432,Kiyonaga; Anastasia,20,0,25,5
1668170630806,COGS 260,B00,101433,Kirsh; David Joel,16,0,25,9
1668170631234,CSE 202,A00,102371,Impagliazzo; Russell,0,0,0,0
1668170631660,CSE 203B,A01,102373,Cheng; Chung Kuan,0,0,0,0
1668170632089,CSE 208,A00,102374,Micciancio; Daniele,0,0,0,0
1668170632515,CSE 209A,A00,112895,Impagliazzo; Russell,0,0,15,15
1668170632940,CSE 209B,A00,108005,Bellare; Mihir,0,0,0,0
1668170633369,CSE 210,A00,113163,Coblenz; Michael J,0,0,0,0
1668170633794,CSE 219,A00,106111,Dow; Steven P,0,0,20,20
1668170634217,CSE 221,A00,102376,Voelker; Geoffrey M.,0,0,0,0
1668170634647,CSE 224,A01,102378,Porter; George M,0,0,0,0
1668170635072,CSE 229A,A00,102379,Savage; Stefan,0,0,0,0
1668170635497,CSE 229C,A00,102380,Munyaka; Imani N. S.,0,0,0,0
1668170635921,CSE 232B,A00,102382,Deutsch; Alin Bernard,0,0,0,0
1668170636362,CSE 234,A01,112904,Kumar; Arun Kumar,0,0,0,0
1668170636787,CSE 237A,A00,102383,Rosing; Tajana Simunic,0,0,0,0
1668170637285,CSE 239A,A00,102384,Deutsch; Alin Bernard,0,0,0,0
1668170637711,CSE 239B,A00,102385,Polikarpova; Nadezhda,0,0,0,0
1668170638136,CSE 240A,A00,102386,Pannuto; Patrick William,0,0,0,0
1668170638562,CSE 240B,A00,102387,Zhao; Jishen,0,0,0,0
1668170638993,CSE 241A,A00,106406,Kang; Mingu,0,0,0,0
1668170639420,CSE 249B,A00,102388,Kahng; Andrew Byun,0,0,8,8
1668170639850,CSE 251B,A01,102392,Cottrell; Garrison W,0,0,0,0
1668170639850,CSE 251B,A02,102393,Cottrell; Garrison W,0,0,0,0
1668170640279,CSE 252B,A00,102394,Ochoa; Benjamin Lawrence,0,0,0,0
1668170640704,CSE 257,A01,102396,Gao; Sicun,0,0,0,0
1668170641143,CSE 272,A00,102397,Li; Tzumao,0,0,0,0
1668170641569,CSE 274,A00,111323,Chern; Albert Ren-Haur,0,0,0,0
1668170641998,CSE 282,A00,102398,Pevzner; Pavel Arkadjevich,0,0,0,0
1668170642424,CSE 284,A00,114175,Gymrek; Melissa Ann,0,0,0,0
1668170642857,CSE 290,A00,102399,Chandraker; Manmohan Krishna,0,0,0,0
1668170642857,CSE 290,B00,102400,Vaccaro; Kristen Marie,0,0,25,25
1668170642857,CSE 290,C00,102414,Pannuto; Patrick William,0,0,25,25
1668170642857,CSE 290,D00,102427,Pevzner; Pavel Arkadjevich,0,0,0,0
1668170642857,CSE 290,E00,102429,Zhao; Jishen,0,0,0,0
1668170642857,CSE 290,F00,102436,Tullsen; Dean Michael,0,0,0,0
1668170642857,CSE 290,G00,102440,Christensen; Henrik I,0,0,20,20
1668170643286,CSE 291,A00,102443,Su; Hao,0,0,0,0
1668170643286,CSE 291,B00,102448,Polikarpova; Nadezhda,0,0,0,0
1668170643286,CSE 291,C00,102453,Vaccaro; Kristen Marie,0,0,0,0
1668170643286,CSE 291,D00,111343,Savage; Stefan,0,0,0,0
1668170643286,CSE 291,E00,116474,Claffy; Kimberly Claire,0,0,0,0
1668170643286,CSE 291,F00,116479,Pasquale; Joseph,0,0,0,0
1668170643738,CSE 293,001,119111,Bafna; Vineet,9999,0,9999,0
1668170643738,CSE 293,002,119118,Bellare; Mihir,9999,0,9999,0
1668170643738,CSE 293,003,119122,Berg-Kirkpatrick; Taylor D,9999,0,9999,0
1668170643738,CSE 293,004,119135,Christensen; Henrik I,9999,0,9999,0
1668170643738,CSE 293,005,119142,Cottrell; Garrison W,9999,0,9999,0
1668170643738,CSE 293,006,119146,Deutsch; Alin Bernard,9999,0,9999,0
1668170643738,CSE 293,007,119159,Esmaeilzadeh; Hadi,9999,0,9999,0
1668170643738,CSE 293,008,119166,Freund; Yoav,9999,0,9999,0
1668170643738,CSE 293,009,119170,Griswold; William G.,9999,0,9999,0
1668170643738,CSE 293,010,119183,Gymrek; Melissa Ann,9999,0,9999,0
1668170643738,CSE 293,011,119190,Heninger; Nadia A,9999,0,9999,0
1668170643738,CSE 293,012,119230,Impagliazzo; Russell,9999,0,9999,0
1668170643738,CSE 293,013,119232,Jhala; Ranjit,9999,0,9999,0
1668170643738,CSE 293,014,119233,Kahng; Andrew Byun,9999,0,9999,0
1668170643738,CSE 293,015,119298,Kane; Daniel Mertz,9999,0,9999,0
1668170643738,CSE 293,016,119299,Kriegman; David J,9999,0,9999,0
1668170643738,CSE 293,017,119300,Kumar; Arun Kumar,9999,0,9999,0
1668170643738,CSE 293,018,119301,Lerner; Sorin,9999,0,9999,0
1668170643738,CSE 293,019,119302,Lovett; Shachar,9999,0,9999,0
1668170643738,CSE 293,020,119303,McAuley; Julian John,9999,0,9999,0
1668170643738,CSE 293,021,119304,Micciancio; Daniele,9999,0,9999,0
1668170643738,CSE 293,022,119367,Orailoglu; Alex,9999,0,9999,0
1668170643738,CSE 293,023,119382,Paturi; Ramamohan,9999,0,9999,0
1668170643738,CSE 293,024,119404,Polikarpova; Nadezhda,9999,0,9999,0
1668170643738,CSE 293,025,119406,Politz; Joseph Gibbs,9999,0,9999,0
1668170643738,CSE 293,026,119411,Porter; George M,9999,0,9999,0
1668170643738,CSE 293,027,119414,Porter; Leonard Emerson,9999,0,9999,0
1668170643738,CSE 293,028,119416,Ramamoorthi; Ravi,9999,0,9999,0
1668170643738,CSE 293,029,119417,Sahoo; Debashis,9999,0,9999,0
1668170643738,CSE 293,030,119420,Saul; Lawrence,9999,0,9999,0
1668170643738,CSE 293,031,119421,Savage; Stefan,9999,0,9999,0
1668170643738,CSE 293,032,119425,Schulze; Jurgen P.,9999,0,9999,0
1668170643738,CSE 293,033,119426,Snoeren; Alex C.,9999,0,9999,0
1668170643738,CSE 293,034,119428,Shang; Jingbo,9999,0,9999,0
1668170643738,CSE 293,035,119430,Stefan; Deian,9999,0,9999,0
1668170643738,CSE 293,036,119431,Su; Hao,9999,0,9999,0
1668170643738,CSE 293,037,119433,Swanson; Steven James,9999,0,9999,0
1668170643738,CSE 293,038,119435,Tullsen; Dean Michael,9999,0,9999,0
1668170643738,CSE 293,039,119483,Voelker; Geoffrey M.,9999,0,9999,0
1668170643738,CSE 293,040,119537,Zhao; Jishen,9999,0,9999,0
1668170643738,CSE 293,041,119538,Zhou; Yuan-Yuan,9999,0,9999,0
1668170643738,CSE 293,042,119539,Gao; Sicun,9999,0,9999,0
1668170643738,CSE 293,043,119540,Weibel; Nadir,9999,0,9999,0
1668170643738,CSE 293,044,119541,Gupta; Rajesh K.,9999,0,9999,0
1668170643738,CSE 293,045,126410,Vaccaro; Kristen Marie,9999,0,9999,0
1668170643738,CSE 293,046,126411,Klemke; Richard,9999,0,9999,0
1668170644167,CSE 294,A00,102459,Voelker; Geoffrey M.,0,0,0,0
1668170644167,CSE 294,B00,111322,Orailoglu; Alex,0,0,0,0
1668170644600,DSE 201,A00,096914,Deutsch; Alin Bernard,30,0,30,0
1668170645025,DSE 210,A00,096915,Dasgupta; Sanjoy,30,0,30,0
1668170645449,DSE 260A,A00,096916,Altintas De Callaf; Ilkay,30,0,30,0
1668170645933,ECE 200,001,103586,Antipa; Nicholas A,9999,0,9999,0
1668170645933,ECE 200,002,103587,Atanasov; Nikolay A.,9999,0,9999,0
1668170645933,ECE 200,003,103588,Bharadia; Dinesh,9999,0,9999,0
1668170645933,ECE 200,004,103589,Cheng; Chung Kuan,9999,0,9999,0
1668170645933,ECE 200,005,103590,Cosman; Pamela C.,9999,0,9999,0
1668170645933,ECE 200,006,103591,Dayeh; Shadi Ahmad,9999,0,9999,0
1668170645933,ECE 200,007,103592,Fainman; Yeshaiahu,9999,0,9999,0
1668170645933,ECE 200,008,103593,Ford; Joseph Earl,9999,0,9999,0
1668170645933,ECE 200,009,103594,Franceschetti; Massimo,9999,0,9999,0
1668170645933,ECE 200,010,103595,Fullerton; Eric E,9999,0,9999,0
1668170645933,ECE 200,011,103596,Galton; Ian A,9999,0,9999,0
1668170645933,ECE 200,012,103597,Gilja; Vikash,9999,0,9999,0
1668170645933,ECE 200,013,103598,Hall; Drew A.,9999,0,9999,0
1668170645933,ECE 200,014,103599,Hsueh; Tzu-Chien,9999,0,9999,0
1668170645933,ECE 200,015,103600,Javidi; Tara,9999,0,9999,0
1668170645933,ECE 200,016,103601,Kahng; Andrew Byun,9999,0,9999,0
1668170645933,ECE 200,017,103602,Kim; Young-Han,9999,0,9999,0
1668170645933,ECE 200,018,103603,Koushanfar; Farinaz,9999,0,9999,0
1668170645933,ECE 200,019,103604,Kuzum; Duygu,9999,0,9999,0
1668170645933,ECE 200,020,103605,Le; Hanh-Phuc,9999,0,9999,0
1668170645933,ECE 200,021,103606,Lin; Bill,9999,0,9999,0
1668170645933,ECE 200,022,103607,Liu; Zhaowei,9998,0,9999,1
1668170645933,ECE 200,023,103608,Lo; Yu-Hwa,9999,0,9999,0
1668170645933,ECE 200,024,103609,Lomakin; Vitaliy,9999,0,9999,0
1668170645933,ECE 200,025,103610,Mercier; Patrick Philip,9999,0,9999,0
1668170645933,ECE 200,026,103611,Meyer; Florian,9999,0,9999,0
1668170645933,ECE 200,027,103612,Milstein; Laurence B.,9999,0,9999,0
1668170645933,ECE 200,028,103613,Mir Arabbaygi; Siavash,9999,0,9999,0
1668170645933,ECE 200,029,103614,Mookherjea; Shayan,9999,0,9999,0
1668170645933,ECE 200,030,103615,Morris; Karcher William,9999,0,9999,0
1668170645933,ECE 200,031,103616,Ng; Tse Nga,9999,0,9999,0
1668170645933,ECE 200,032,103617,Nguyen; Truong Quang,9999,0,9999,0
1668170645933,ECE 200,033,103618,Nomura; Kenji,9999,0,9999,0
1668170645933,ECE 200,034,103619,Orlitsky; Alon,9999,0,9999,0
1668170645933,ECE 200,035,103620,Pal; Piya,9999,0,9999,0
1668170645933,ECE 200,036,103621,Papen; George C.,9999,0,9999,0
1668170645933,ECE 200,037,103622,Radic; Stojan,9999,0,9999,0
1668170645933,ECE 200,038,103623,Rao; Bhaskar D.,9999,0,9999,0
1668170645933,ECE 200,039,103624,Rao; Ramesh R,9999,0,9999,0
1668170645933,ECE 200,040,103625,Rebeiz; Gabriel,9999,0,9999,0
1668170645933,ECE 200,041,103626,Sanford; John R,9999,0,9999,0
1668170645933,ECE 200,042,103627,Siegel; Paul H.,9999,0,9999,0
1668170645933,ECE 200,043,103628,Sievenpiper; Daniel F.,9999,0,9999,0
1668170645933,ECE 200,044,103629,Sworder; David D.,9999,0,9999,0
1668170645933,ECE 200,045,103630,Taur; Yuan,9999,0,9999,0
1668170645933,ECE 200,046,103631,Touri; Behrouz,9999,0,9999,0
1668170645933,ECE 200,047,103632,Trivedi; Mohan M.,9999,0,9999,0
1668170645933,ECE 200,048,103633,Vasconcelos; Nuno,9999,0,9999,0
1668170645933,ECE 200,049,103634,Wang; Xiaolong,9999,0,9999,0
1668170645933,ECE 200,050,103635,Xie; Pengtao,9999,0,9999,0
1668170645933,ECE 200,051,103636,Yip; Michael,9999,0,9999,0
1668170645933,ECE 200,052,103637,Zeger; Kenneth A.,999,0,999,0
1668170645933,ECE 200,053,103638,Zhang; Xinyu,9999,0,9999,0
1668170645933,ECE 200,054,103639,Turakhia; Yatish Girish,9999,0,9999,0
1668170645933,ECE 200,055,103640,Kang; Mingu,9999,0,9999,0
1668170645933,ECE 200,056,103641,Shi; Yuanyuan,9999,0,9999,0
1668170645933,ECE 200,057,103642,Wang; Edward Jay,9999,0,9999,0
1668170645933,ECE 200,058,103643,Zheng; Yang,9999,0,9999,0
1668170646359,ECE 202,A00,103644,Kuzum; Duygu,0,0,0,0
1668170646787,ECE 212BN,A00,103646,Ng; Tse Nga,0,0,0,0
1668170647211,ECE 221,A00,111493,Staff,0,0,0,0
1668170647640,ECE 222B,A00,103647,Lomakin; Vitaliy,0,0,0,0
1668170648064,ECE 230B,A00,103648,Taur; Yuan,0,0,0,0
1668170648503,ECE 238B,A00,103649,Garay; Javier,0,0,0,0
1668170648932,ECE 240B,A00,112900,Fainman; Yeshaiahu,0,0,0,0
1668170649360,ECE 247A,A00,103650,Jokerst; Jesse Vincent,0,0,0,0
1668170649785,ECE 247B,A00,103651,Wang; Joseph,0,0,0,0
1668170650212,ECE 250,A00,103652,Siegel; Paul H.,0,0,0,0
1668170650639,ECE 251A,A00,103654,Rao; Bhaskar D.,0,0,0,0
1668170651084,ECE 257B,A00,103655,Bharadia; Dinesh,0,0,0,0
1668170651513,ECE 258A,A00,103656,Milstein; Laurence B.,0,0,0,0
1668170651941,ECE 260B,A00,103658,Kang; Mingu,0,0,0,0
1668170652366,ECE 264A,A00,103659,Galton; Ian A,0,0,0,0
1668170652791,ECE 265A,A00,103661,Gudem; Prasad S.S.,0,0,0,0
1668170653219,ECE 265D,A00,103662,Gudem; Prasad S.S.,0,0,0,0
1668170653647,ECE 268,A00,103663,Koushanfar; Farinaz,0,0,0,0
1668170654072,ECE 269,A01,103665,Pal; Piya,0,0,0,0
1668170654497,ECE 271B,A00,103666,Vasconcelos; Manuela,0,0,0,0
1668170654920,ECE 276A,A00,103667,Atanasov; Nikolay A.,0,0,0,0
1668170655354,ECE 277,A00,103668,An; Cheolhong,0,0,0,0
1668170655781,ECE 279,A00,117947,Hall; Drew A.,0,0,0,0
1668170656634,ECE 283,A00,103670,Hsueh; Tzu-Chien,0,0,0,0
1668170657062,ECE 284,A00,103671,Turakhia; Yatish Girish,0,0,0,0
1668170657488,ECE 285,A00,103672,Zheng; Yang,0,0,0,0
1668170657488,ECE 285,B00,103673,Sworder; David D.,0,0,0,0
1668170657914,ECE 287,A00,103676,Javidi; Tara,0,0,0,0
1668170658339,MATH 200B,A00,098023,Salehi Golsefidy; Alireza,12,0,15,3
1668170658771,MATH 202B,A00,098024,Rhoades; Brendon Patrick,9,0,15,6
1668170659202,MATH 203B,A00,098025,Oprea; Dragos N.,10,0,15,5
1668170659630,MATH 204B,A00,098026,Sorensen; Claus M,13,0,15,2
1668170660058,MATH 208,A00,098027,Izadi; Elham,7,0,10,3
1668170660481,MATH 209,A00,098028,Pollack; Aaron,10,0,10,0
1668170660905,MATH 211A,A00,112919,Rogalski; Daniel,9,0,10,1
1668170661333,MATH 211B,A00,112920,Seward; Brandon M.,9,0,10,1
1668170672747,MATH 218,A00,098029,Li; Bo,10,0,10,0
1668170673176,MATH 220B,A00,098030,Novak; Jonathan I,11,0,15,4
1668170673605,MATH 221A,A00,098031,Ebenfelt; Peter F,13,0,15,2
1668170674035,MATH 231B,A00,098032,Zlatos; Andrej,12,0,15,3
1668170674543,MATH 240B,A00,098033,Ni; Lei,9,0,15,6
1668170674981,MATH 243,A00,098034,Jekel; David Andrew,10,0,10,0
1668170675428,MATH 245A,A00,098035,Nie; Jiawang,0,0,15,16
1668170675865,MATH 248,A00,098036,Bejenaru; Ioan,10,0,10,0
1668170676311,MATH 250B,A00,098037,Spolaor; Luca,14,0,15,1
1668170676740,MATH 258,A00,098038,Ni; Lei,10,0,10,0
1668170677165,MATH 264B,A00,098041,Rhoades; Brendon Patrick,9,0,15,6
1668170677595,MATH 268,A00,098042,Buss; Samuel R,10,0,10,0
1668170678021,MATH 269,A00,098043,Rhoades; Brendon Patrick,10,0,10,0
1668170678456,MATH 270B,A00,098044,Li; Bo,10,0,15,5
1668170678890,MATH 272B,A00,098045,Holst; Michael J,13,0,15,2
1668170679320,MATH 273A,A00,098046,Tian; Xiaochuan,10,0,15,5
1668170679748,MATH 275,A01,098048,Tian; Xiaochuan,6,0,10,4
1668170680173,MATH 278A,A00,098049,Holst; Michael J,8,0,10,2
1668170680601,MATH 278B,A00,098050,Cloninger; Alexander,10,0,10,0
1668170681038,MATH 278C,A00,098051,Nie; Jiawang,7,0,10,3
1668170681470,MATH 280B,A00,098052,Zheng; Tianyi,10,0,15,5
1668170681914,MATH 281B,A00,098053,Bradic; Jelena,2,0,15,13
1668170682347,MATH 282B,A00,098054,Arias-Castro; Ery,0,0,15,15
1668170682772,MATH 285,A00,098055,Fitzsimmons; Patrick J,0,0,15,17
1668170694305,MATH 287B,A00,098056,Arias-Castro; Ery,2,0,15,13
1668170694740,MATH 288,A00,098057,Agarwal; Pooja,9,0,10,1
1668170694740,MATH 288,B00,098058,Zhang; Danna,8,0,10,2
1668170694740,MATH 288,C00,098059,Williams; Ruth J,10,0,10,0
1668170695181,MATH 290B,A00,098060,Roberts; Justin Deritter,13,0,15,2
1668170695619,MATH 292,A00,098061,Belmont; Eva Kinoshita,10,0,10,0
1668170696046,MATH 295,A00,098062,Suk; Andrew Hoon,48,0,50,2
1668170696475,MATH 296,A00,098063,Novak; Jonathan I,20,0,20,0
1668170696905,MATH 297,001,098064,Gamst; Anthony Collins,9997,0,9999,2
1668171278789,COGS 205,A00,101395,Chiba; Andrea,19,0,20,1
1668171279225,COGS 210B,001,101404,Greene; Deanna Jacquelyn,9998,0,9999,1
1668171279225,COGS 210B,002,101417,Xia; Haijun,9999,0,9999,0
1668171279225,COGS 210B,003,101422,Nitz; Douglas A.,9999,0,9999,0
1668171279225,COGS 210B,004,101423,Hollan; James D.,9998,0,9999,1
1668171279225,COGS 210B,005,101424,Deak; Gedeon O.,9998,0,9999,1
1668171279225,COGS 210B,006,101425,Rossano; Federico,9999,0,9999,0
1668171279650,COGS 211B,A00,101427,Coulson; Seana M,9996,0,9999,3
1668171280078,COGS 220,A00,101428,Hollan; James D.,0,0,25,25
1668171280504,COGS 229,A00,101429,Dow; Steven P,18,0,25,7
1668171280936,COGS 230,A00,101430,Klemmer; Scott R,12,0,17,5
1668171281363,COGS 234,A00,101431,Xia; Haijun,3,0,25,22
1668171281791,COGS 260,A00,101432,Kiyonaga; Anastasia,20,0,25,5
1668171281791,COGS 260,B00,101433,Kirsh; David Joel,16,0,25,9
1668171282219,CSE 202,A00,102371,Impagliazzo; Russell,0,0,0,0
1668171282650,CSE 203B,A01,102373,Cheng; Chung Kuan,0,0,0,0
1668171283075,CSE 208,A00,102374,Micciancio; Daniele,0,0,0,0
1668171283504,CSE 209A,A00,112895,Impagliazzo; Russell,0,0,15,15
1668171283934,CSE 209B,A00,108005,Bellare; Mihir,0,0,0,0
1668171284361,CSE 210,A00,113163,Coblenz; Michael J,0,0,0,0
1668171284789,CSE 219,A00,106111,Dow; Steven P,0,0,20,20
1668171285215,CSE 221,A00,102376,Voelker; Geoffrey M.,0,0,0,0
1668171285642,CSE 224,A01,102378,Porter; George M,0,0,0,0
1668171286067,CSE 229A,A00,102379,Savage; Stefan,0,0,0,0
1668171286490,CSE 229C,A00,102380,Munyaka; Imani N. S.,0,0,0,0
1668171286919,CSE 232B,A00,102382,Deutsch; Alin Bernard,0,0,0,0
1668171287344,CSE 234,A01,112904,Kumar; Arun Kumar,0,0,0,0
1668171287772,CSE 237A,A00,102383,Rosing; Tajana Simunic,0,0,0,0
1668171288197,CSE 239A,A00,102384,Deutsch; Alin Bernard,0,0,0,0
1668171288622,CSE 239B,A00,102385,Polikarpova; Nadezhda,0,0,0,0
1668171289052,CSE 240A,A00,102386,Pannuto; Patrick William,0,0,0,0
1668171289478,CSE 240B,A00,102387,Zhao; Jishen,0,0,0,0
1668171289907,CSE 241A,A00,106406,Kang; Mingu,0,0,0,0
1668171290331,CSE 249B,A00,102388,Kahng; Andrew Byun,0,0,8,8
1668171290762,CSE 251B,A01,102392,Cottrell; Garrison W,0,0,0,0
1668171290762,CSE 251B,A02,102393,Cottrell; Garrison W,0,0,0,0
1668171291196,CSE 252B,A00,102394,Ochoa; Benjamin Lawrence,0,0,0,0
1668171291621,CSE 257,A01,102396,Gao; Sicun,0,0,0,0
1668171292045,CSE 272,A00,102397,Li; Tzumao,0,0,0,0
1668171292472,CSE 274,A00,111323,Chern; Albert Ren-Haur,0,0,0,0
1668171292902,CSE 282,A00,102398,Pevzner; Pavel Arkadjevich,0,0,0,0
1668171293328,CSE 284,A00,114175,Gymrek; Melissa Ann,0,0,0,0
1668171293760,CSE 290,A00,102399,Chandraker; Manmohan Krishna,0,0,0,0
1668171293760,CSE 290,B00,102400,Vaccaro; Kristen Marie,0,0,25,25
1668171293760,CSE 290,C00,102414,Pannuto; Patrick William,0,0,25,25
1668171293760,CSE 290,D00,102427,Pevzner; Pavel Arkadjevich,0,0,0,0
1668171293760,CSE 290,E00,102429,Zhao; Jishen,0,0,0,0
1668171293760,CSE 290,F00,102436,Tullsen; Dean Michael,0,0,0,0
1668171293760,CSE 290,G00,102440,Christensen; Henrik I,0,0,20,20
1668171294188,CSE 291,A00,102443,Su; Hao,0,0,0,0
1668171294188,CSE 291,B00,102448,Polikarpova; Nadezhda,0,0,0,0
1668171294188,CSE 291,C00,102453,Vaccaro; Kristen Marie,0,0,0,0
1668171294188,CSE 291,D00,111343,Savage; Stefan,0,0,0,0
1668171294188,CSE 291,E00,116474,Claffy; Kimberly Claire,0,0,0,0
1668171294188,CSE 291,F00,116479,Pasquale; Joseph,0,0,0,0
1668171294631,CSE 293,001,119111,Bafna; Vineet,9999,0,9999,0
1668171294631,CSE 293,002,119118,Bellare; Mihir,9999,0,9999,0
1668171294631,CSE 293,003,119122,Berg-Kirkpatrick; Taylor D,9999,0,9999,0
1668171294631,CSE 293,004,119135,Christensen; Henrik I,9999,0,9999,0
1668171294631,CSE 293,005,119142,Cottrell; Garrison W,9999,0,9999,0
1668171294631,CSE 293,006,119146,Deutsch; Alin Bernard,9999,0,9999,0
1668171294631,CSE 293,007,119159,Esmaeilzadeh; Hadi,9999,0,9999,0
1668171294631,CSE 293,008,119166,Freund; Yoav,9999,0,9999,0
1668171294631,CSE 293,009,119170,Griswold; William G.,9999,0,9999,0
1668171294631,CSE 293,010,119183,Gymrek; Melissa Ann,9999,0,9999,0
1668171294631,CSE 293,011,119190,Heninger; Nadia A,9999,0,9999,0
1668171294631,CSE 293,012,119230,Impagliazzo; Russell,9999,0,9999,0
1668171294631,CSE 293,013,119232,Jhala; Ranjit,9999,0,9999,0
1668171294631,CSE 293,014,119233,Kahng; Andrew Byun,9999,0,9999,0
1668171294631,CSE 293,015,119298,Kane; Daniel Mertz,9999,0,9999,0
1668171294631,CSE 293,016,119299,Kriegman; David J,9999,0,9999,0
1668171294631,CSE 293,017,119300,Kumar; Arun Kumar,9999,0,9999,0
1668171294631,CSE 293,018,119301,Lerner; Sorin,9999,0,9999,0
1668171294631,CSE 293,019,119302,Lovett; Shachar,9999,0,9999,0
1668171294631,CSE 293,020,119303,McAuley; Julian John,9999,0,9999,0
1668171294631,CSE 293,021,119304,Micciancio; Daniele,9999,0,9999,0
1668171294631,CSE 293,022,119367,Orailoglu; Alex,9999,0,9999,0
1668171294631,CSE 293,023,119382,Paturi; Ramamohan,9999,0,9999,0
1668171294631,CSE 293,024,119404,Polikarpova; Nadezhda,9999,0,9999,0
1668171294631,CSE 293,025,119406,Politz; Joseph Gibbs,9999,0,9999,0
1668171294631,CSE 293,026,119411,Porter; George M,9999,0,9999,0
1668171294631,CSE 293,027,119414,Porter; Leonard Emerson,9999,0,9999,0
1668171294631,CSE 293,028,119416,Ramamoorthi; Ravi,9999,0,9999,0
1668171294631,CSE 293,029,119417,Sahoo; Debashis,9999,0,9999,0
1668171294631,CSE 293,030,119420,Saul; Lawrence,9999,0,9999,0
1668171294631,CSE 293,031,119421,Savage; Stefan,9999,0,9999,0
1668171294631,CSE 293,032,119425,Schulze; Jurgen P.,9999,0,9999,0
1668171294631,CSE 293,033,119426,Snoeren; Alex C.,9999,0,9999,0
1668171294631,CSE 293,034,119428,Shang; Jingbo,9999,0,9999,0
1668171294631,CSE 293,035,119430,Stefan; Deian,9999,0,9999,0
1668171294631,CSE 293,036,119431,Su; Hao,9999,0,9999,0
1668171294631,CSE 293,037,119433,Swanson; Steven James,9999,0,9999,0
1668171294631,CSE 293,038,119435,Tullsen; Dean Michael,9999,0,9999,0
1668171294631,CSE 293,039,119483,Voelker; Geoffrey M.,9999,0,9999,0
1668171294631,CSE 293,040,119537,Zhao; Jishen,9999,0,9999,0
1668171294631,CSE 293,041,119538,Zhou; Yuan-Yuan,9999,0,9999,0
1668171294631,CSE 293,042,119539,Gao; Sicun,9999,0,9999,0
1668171294631,CSE 293,043,119540,Weibel; Nadir,9999,0,9999,0
1668171294631,CSE 293,044,119541,Gupta; Rajesh K.,9999,0,9999,0
1668171294631,CSE 293,045,126410,Vaccaro; Kristen Marie,9999,0,9999,0
1668171294631,CSE 293,046,126411,Klemke; Richard,9999,0,9999,0
1668171295060,CSE 294,A00,102459,Voelker; Geoffrey M.,0,0,0,0
1668171295060,CSE 294,B00,111322,Orailoglu; Alex,0,0,0,0
1668171295487,DSE 201,A00,096914,Deutsch; Alin Bernard,30,0,30,0
1668171295914,DSE 210,A00,096915,Dasgupta; Sanjoy,30,0,30,0
1668171296339,DSE 260A,A00,096916,Altintas De Callaf; Ilkay,30,0,30,0
1668171296824,ECE 200,001,103586,Antipa; Nicholas A,9999,0,9999,0
1668171296824,ECE 200,002,103587,Atanasov; Nikolay A.,9999,0,9999,0
1668171296824,ECE 200,003,103588,Bharadia; Dinesh,9999,0,9999,0
1668171296824,ECE 200,004,103589,Cheng; Chung Kuan,9999,0,9999,0
1668171296824,ECE 200,005,103590,Cosman; Pamela C.,9999,0,9999,0
1668171296824,ECE 200,006,103591,Dayeh; Shadi Ahmad,9999,0,9999,0
1668171296824,ECE 200,007,103592,Fainman; Yeshaiahu,9999,0,9999,0
1668171296824,ECE 200,008,103593,Ford; Joseph Earl,9999,0,9999,0
1668171296824,ECE 200,009,103594,Franceschetti; Massimo,9999,0,9999,0
1668171296824,ECE 200,010,103595,Fullerton; Eric E,9999,0,9999,0
1668171296824,ECE 200,011,103596,Galton; Ian A,9999,0,9999,0
1668171296824,ECE 200,012,103597,Gilja; Vikash,9999,0,9999,0
1668171296824,ECE 200,013,103598,Hall; Drew A.,9999,0,9999,0
1668171296824,ECE 200,014,103599,Hsueh; Tzu-Chien,9999,0,9999,0
1668171296824,ECE 200,015,103600,Javidi; Tara,9999,0,9999,0
1668171296824,ECE 200,016,103601,Kahng; Andrew Byun,9999,0,9999,0
1668171296824,ECE 200,017,103602,Kim; Young-Han,9999,0,9999,0
1668171296824,ECE 200,018,103603,Koushanfar; Farinaz,9999,0,9999,0
1668171296824,ECE 200,019,103604,Kuzum; Duygu,9999,0,9999,0
1668171296824,ECE 200,020,103605,Le; Hanh-Phuc,9999,0,9999,0
1668171296824,ECE 200,021,103606,Lin; Bill,9999,0,9999,0
1668171296824,ECE 200,022,103607,Liu; Zhaowei,9998,0,9999,1
1668171296824,ECE 200,023,103608,Lo; Yu-Hwa,9999,0,9999,0
1668171296824,ECE 200,024,103609,Lomakin; Vitaliy,9999,0,9999,0
1668171296824,ECE 200,025,103610,Mercier; Patrick Philip,9999,0,9999,0
1668171296824,ECE 200,026,103611,Meyer; Florian,9999,0,9999,0
1668171296824,ECE 200,027,103612,Milstein; Laurence B.,9999,0,9999,0
1668171296824,ECE 200,028,103613,Mir Arabbaygi; Siavash,9999,0,9999,0
1668171296824,ECE 200,029,103614,Mookherjea; Shayan,9999,0,9999,0
1668171296824,ECE 200,030,103615,Morris; Karcher William,9999,0,9999,0
1668171296824,ECE 200,031,103616,Ng; Tse Nga,9999,0,9999,0
1668171296824,ECE 200,032,103617,Nguyen; Truong Quang,9999,0,9999,0
1668171296824,ECE 200,033,103618,Nomura; Kenji,9999,0,9999,0
1668171296824,ECE 200,034,103619,Orlitsky; Alon,9999,0,9999,0
1668171296824,ECE 200,035,103620,Pal; Piya,9999,0,9999,0
1668171296824,ECE 200,036,103621,Papen; George C.,9999,0,9999,0
1668171296824,ECE 200,037,103622,Radic; Stojan,9999,0,9999,0
1668171296824,ECE 200,038,103623,Rao; Bhaskar D.,9999,0,9999,0
1668171296824,ECE 200,039,103624,Rao; Ramesh R,9999,0,9999,0
1668171296824,ECE 200,040,103625,Rebeiz; Gabriel,9999,0,9999,0
1668171296824,ECE 200,041,103626,Sanford; John R,9999,0,9999,0
1668171296824,ECE 200,042,103627,Siegel; Paul H.,9999,0,9999,0
1668171296824,ECE 200,043,103628,Sievenpiper; Daniel F.,9999,0,9999,0
1668171296824,ECE 200,044,103629,Sworder; David D.,9999,0,9999,0
1668171296824,ECE 200,045,103630,Taur; Yuan,9999,0,9999,0
1668171296824,ECE 200,046,103631,Touri; Behrouz,9999,0,9999,0
1668171296824,ECE 200,047,103632,Trivedi; Mohan M.,9999,0,9999,0
1668171296824,ECE 200,048,103633,Vasconcelos; Nuno,9999,0,9999,0
1668171296824,ECE 200,049,103634,Wang; Xiaolong,9999,0,9999,0
1668171296824,ECE 200,050,103635,Xie; Pengtao,9999,0,9999,0
1668171296824,ECE 200,051,103636,Yip; Michael,9999,0,9999,0
1668171296824,ECE 200,052,103637,Zeger; Kenneth A.,999,0,999,0
1668171296824,ECE 200,053,103638,Zhang; Xinyu,9999,0,9999,0
1668171296824,ECE 200,054,103639,Turakhia; Yatish Girish,9999,0,9999,0
1668171296824,ECE 200,055,103640,Kang; Mingu,9999,0,9999,0
1668171296824,ECE 200,056,103641,Shi; Yuanyuan,9999,0,9999,0
1668171296824,ECE 200,057,103642,Wang; Edward Jay,9999,0,9999,0
1668171296824,ECE 200,058,103643,Zheng; Yang,9999,0,9999,0
1668171297253,ECE 202,A00,103644,Kuzum; Duygu,0,0,0,0
1668171297693,ECE 212BN,A00,103646,Ng; Tse Nga,0,0,0,0
1668171298121,ECE 221,A00,111493,Staff,0,0,0,0
1668171298547,ECE 222B,A00,103647,Lomakin; Vitaliy,0,0,0,0
1668171298970,ECE 230B,A00,103648,Taur; Yuan,0,0,0,0
1668171299401,ECE 238B,A00,103649,Garay; Javier,0,0,0,0
1668171299828,ECE 240B,A00,112900,Fainman; Yeshaiahu,0,0,0,0
1668171300255,ECE 247A,A00,103650,Jokerst; Jesse Vincent,0,0,0,0
1668171300686,ECE 247B,A00,103651,Wang; Joseph,0,0,0,0
1668171301116,ECE 250,A00,103652,Siegel; Paul H.,0,0,0,0
1668171301546,ECE 251A,A00,103654,Rao; Bhaskar D.,0,0,0,0
1668171301970,ECE 257B,A00,103655,Bharadia; Dinesh,0,0,0,0
1668171302404,ECE 258A,A00,103656,Milstein; Laurence B.,0,0,0,0
1668171302827,ECE 260B,A00,103658,Kang; Mingu,0,0,0,0
1668171303251,ECE 264A,A00,103659,Galton; Ian A,0,0,0,0
1668171303685,ECE 265A,A00,103661,Gudem; Prasad S.S.,0,0,0,0
1668171304110,ECE 265D,A00,103662,Gudem; Prasad S.S.,0,0,0,0
1668171304534,ECE 268,A00,103663,Koushanfar; Farinaz,0,0,0,0
1668171305035,ECE 269,A01,103665,Pal; Piya,0,0,0,0
1668171305457,ECE 271B,A00,103666,Vasconcelos; Manuela,0,0,0,0
1668171305881,ECE 276A,A00,103667,Atanasov; Nikolay A.,0,0,0,0
1668171306310,ECE 277,A00,103668,An; Cheolhong,0,0,0,0
1668171306734,ECE 279,A00,117947,Hall; Drew A.,0,0,0,0
1668171307587,ECE 283,A00,103670,Hsueh; Tzu-Chien,0,0,0,0
1668171308014,ECE 284,A00,103671,Turakhia; Yatish Girish,0,0,0,0
1668171308437,ECE 285,A00,103672,Zheng; Yang,0,0,0,0
1668171308437,ECE 285,B00,103673,Sworder; David D.,0,0,0,0
1668171308859,ECE 287,A00,103676,Javidi; Tara,0,0,0,0
1668171309296,MATH 200B,A00,098023,Salehi Golsefidy; Alireza,12,0,15,3
1668171309728,MATH 202B,A00,098024,Rhoades; Brendon Patrick,9,0,15,6
1668171310159,MATH 203B,A00,098025,Oprea; Dragos N.,10,0,15,5
1668171310588,MATH 204B,A00,098026,Sorensen; Claus M,13,0,15,2
1668171311012,MATH 208,A00,098027,Izadi; Elham,7,0,10,3
1668171311436,MATH 209,A00,098028,Pollack; Aaron,10,0,10,0
1668171311861,MATH 211A,A00,112919,Rogalski; Daniel,9,0,10,1
1668171312296,MATH 211B,A00,112920,Seward; Brandon M.,9,0,10,1
1668171312719,MATH 218,A00,098029,Li; Bo,10,0,10,0
1668171313147,MATH 220B,A00,098030,Novak; Jonathan I,11,0,15,4
1668171313582,MATH 221A,A00,098031,Ebenfelt; Peter F,13,0,15,2
1668171314014,MATH 231B,A00,098032,Zlatos; Andrej,12,0,15,3
1668171314439,MATH 240B,A00,098033,Ni; Lei,9,0,15,6
1668171314879,MATH 243,A00,098034,Jekel; David Andrew,10,0,10,0
1668171315306,MATH 245A,A00,098035,Nie; Jiawang,0,0,15,16
1668171315733,MATH 248,A00,098036,Bejenaru; Ioan,10,0,10,0
1668171316159,MATH 250B,A00,098037,Spolaor; Luca,14,0,15,1
1668171316583,MATH 258,A00,098038,Ni; Lei,10,0,10,0
1668171317012,MATH 264B,A00,098041,Rhoades; Brendon Patrick,9,0,15,6
1668171317441,MATH 268,A00,098042,Buss; Samuel R,10,0,10,0
1668171317876,MATH 269,A00,098043,Rhoades; Brendon Patrick,10,0,10,0
1668171318306,MATH 270B,A00,098044,Li; Bo,10,0,15,5
1668171318732,MATH 272B,A00,098045,Holst; Michael J,13,0,15,2
1668171319158,MATH 273A,A00,098046,Tian; Xiaochuan,10,0,15,5
1668171319586,MATH 275,A01,098048,Tian; Xiaochuan,6,0,10,4
1668171320014,MATH 278A,A00,098049,Holst; Michael J,8,0,10,2
1668171320448,MATH 278B,A00,098050,Cloninger; Alexander,10,0,10,0
1668171320879,MATH 278C,A00,098051,Nie; Jiawang,7,0,10,3
1668171321305,MATH 280B,A00,098052,Zheng; Tianyi,10,0,15,5
1668171321730,MATH 281B,A00,098053,Bradic; Jelena,2,0,15,13
1668171322156,MATH 282B,A00,098054,Arias-Castro; Ery,0,0,15,15
1668171322584,MATH 285,A00,098055,Fitzsimmons; Patrick J,0,0,15,17
1668171323013,MATH 287B,A00,098056,Arias-Castro; Ery,2,0,15,13
1668171323462,MATH 288,A00,098057,Agarwal; Pooja,9,0,10,1
1668171323462,MATH 288,B00,098058,Zhang; Danna,8,0,10,2
1668171323462,MATH 288,C00,098059,Williams; Ruth J,10,0,10,0
1668171323892,MATH 290B,A00,098060,Roberts; Justin Deritter,13,0,15,2
1668171324325,MATH 292,A00,098061,Belmont; Eva Kinoshita,10,0,10,0
1668171324754,MATH 295,A00,098062,Suk; Andrew Hoon,48,0,50,2
1668171325181,MATH 296,A00,098063,Novak; Jonathan I,20,0,20,0
1668171325605,MATH 297,001,098064,Gamst; Anthony Collins,9997,0,9999,2
1668171828544,COGS 205,A00,101395,Chiba; Andrea,19,0,20,1
1668171828970,COGS 210B,001,101404,Greene; Deanna Jacquelyn,9998,0,9999,1
1668171828970,COGS 210B,002,101417,Xia; Haijun,9999,0,9999,0
1668171828970,COGS 210B,003,101422,Nitz; Douglas A.,9999,0,9999,0
1668171828970,COGS 210B,004,101423,Hollan; James D.,9998,0,9999,1
1668171828970,COGS 210B,005,101424,Deak; Gedeon O.,9998,0,9999,1
1668171828970,COGS 210B,006,101425,Rossano; Federico,9999,0,9999,0
1668171829396,COGS 211B,A00,101427,Coulson; Seana M,9996,0,9999,3
1668171829826,COGS 220,A00,101428,Hollan; James D.,0,0,25,25
1668171830258,COGS 229,A00,101429,Dow; Steven P,18,0,25,7
1668171830686,COGS 230,A00,101430,Klemmer; Scott R,12,0,17,5
1668171831112,COGS 234,A00,101431,Xia; Haijun,3,0,25,22
1668171831535,COGS 260,A00,101432,Kiyonaga; Anastasia,20,0,25,5
1668171831535,COGS 260,B00,101433,Kirsh; David Joel,16,0,25,9
1668171831960,CSE 202,A00,102371,Impagliazzo; Russell,0,0,0,0
1668171832387,CSE 203B,A01,102373,Cheng; Chung Kuan,0,0,0,0
1668171832813,CSE 208,A00,102374,Micciancio; Daniele,0,0,0,0
1668171833238,CSE 209A,A00,112895,Impagliazzo; Russell,0,0,15,15
1668171833662,CSE 209B,A00,108005,Bellare; Mihir,0,0,0,0
1668171834092,CSE 210,A00,113163,Coblenz; Michael J,0,0,0,0
1668171834521,CSE 219,A00,106111,Dow; Steven P,0,0,20,20
1668171834945,CSE 221,A00,102376,Voelker; Geoffrey M.,0,0,0,0
1668171835370,CSE 224,A01,102378,Porter; George M,0,0,0,0
1668171835795,CSE 229A,A00,102379,Savage; Stefan,0,0,0,0
1668171836222,CSE 229C,A00,102380,Munyaka; Imani N. S.,0,0,0,0
1668171836647,CSE 232B,A00,102382,Deutsch; Alin Bernard,0,0,0,0
1668171837078,CSE 234,A01,112904,Kumar; Arun Kumar,0,0,0,0
1668171837504,CSE 237A,A00,102383,Rosing; Tajana Simunic,0,0,0,0
1668171837931,CSE 239A,A00,102384,Deutsch; Alin Bernard,0,0,0,0
1668171838355,CSE 239B,A00,102385,Polikarpova; Nadezhda,0,0,0,0
1668171838779,CSE 240A,A00,102386,Pannuto; Patrick William,0,0,0,0
1668171839216,CSE 240B,A00,102387,Zhao; Jishen,0,0,0,0
1668171839643,CSE 241A,A00,106406,Kang; Mingu,0,0,0,0
1668171840071,CSE 249B,A00,102388,Kahng; Andrew Byun,0,0,8,8
1668171840500,CSE 251B,A01,102392,Cottrell; Garrison W,0,0,0,0
1668171840500,CSE 251B,A02,102393,Cottrell; Garrison W,0,0,0,0
1668171840927,CSE 252B,A00,102394,Ochoa; Benjamin Lawrence,0,0,0,0
1668171841351,CSE 257,A01,102396,Gao; Sicun,0,0,0,0
1668171841775,CSE 272,A00,102397,Li; Tzumao,0,0,0,0
1668171842203,CSE 274,A00,111323,Chern; Albert Ren-Haur,0,0,0,0
1668171842627,CSE 282,A00,102398,Pevzner; Pavel Arkadjevich,0,0,0,0
1668171843053,CSE 284,A00,114175,Gymrek; Melissa Ann,0,0,0,0
1668171843482,CSE 290,A00,102399,Chandraker; Manmohan Krishna,0,0,0,0
1668171843482,CSE 290,B00,102400,Vaccaro; Kristen Marie,0,0,25,25
1668171843482,CSE 290,C00,102414,Pannuto; Patrick William,0,0,25,25
1668171843482,CSE 290,D00,102427,Pevzner; Pavel Arkadjevich,0,0,0,0
1668171843482,CSE 290,E00,102429,Zhao; Jishen,0,0,0,0
1668171843482,CSE 290,F00,102436,Tullsen; Dean Michael,0,0,0,0
1668171843482,CSE 290,G00,102440,Christensen; Henrik I,0,0,20,20
1668171843912,CSE 291,A00,102443,Su; Hao,0,0,0,0
1668171843912,CSE 291,B00,102448,Polikarpova; Nadezhda,0,0,0,0
1668171843912,CSE 291,C00,102453,Vaccaro; Kristen Marie,0,0,0,0
1668171843912,CSE 291,D00,111343,Savage; Stefan,0,0,0,0
1668171843912,CSE 291,E00,116474,Claffy; Kimberly Claire,0,0,0,0
1668171843912,CSE 291,F00,116479,Pasquale; Joseph,0,0,0,0
1668171844349,CSE 293,001,119111,Bafna; Vineet,9999,0,9999,0
1668171844349,CSE 293,002,119118,Bellare; Mihir,9999,0,9999,0
1668171844349,CSE 293,003,119122,Berg-Kirkpatrick; Taylor D,9999,0,9999,0
1668171844349,CSE 293,004,119135,Christensen; Henrik I,9999,0,9999,0
1668171844349,CSE 293,005,119142,Cottrell; Garrison W,9999,0,9999,0
1668171844349,CSE 293,006,119146,Deutsch; Alin Bernard,9999,0,9999,0
1668171844349,CSE 293,007,119159,Esmaeilzadeh; Hadi,9999,0,9999,0
1668171844349,CSE 293,008,119166,Freund; Yoav,9999,0,9999,0
1668171844349,CSE 293,009,119170,Griswold; William G.,9999,0,9999,0
1668171844349,CSE 293,010,119183,Gymrek; Melissa Ann,9999,0,9999,0
1668171844349,CSE 293,011,119190,Heninger; Nadia A,9999,0,9999,0
1668171844349,CSE 293,012,119230,Impagliazzo; Russell,9999,0,9999,0
1668171844349,CSE 293,013,119232,Jhala; Ranjit,9999,0,9999,0
1668171844349,CSE 293,014,119233,Kahng; Andrew Byun,9999,0,9999,0
1668171844349,CSE 293,015,119298,Kane; Daniel Mertz,9999,0,9999,0
1668171844349,CSE 293,016,119299,Kriegman; David J,9999,0,9999,0
1668171844349,CSE 293,017,119300,Kumar; Arun Kumar,9999,0,9999,0
1668171844349,CSE 293,018,119301,Lerner; Sorin,9999,0,9999,0
1668171844349,CSE 293,019,119302,Lovett; Shachar,9999,0,9999,0
1668171844349,CSE 293,020,119303,McAuley; Julian John,9999,0,9999,0
1668171844349,CSE 293,021,119304,Micciancio; Daniele,9999,0,9999,0
1668171844349,CSE 293,022,119367,Orailoglu; Alex,9999,0,9999,0
1668171844349,CSE 293,023,119382,Paturi; Ramamohan,9999,0,9999,0
1668171844349,CSE 293,024,119404,Polikarpova; Nadezhda,9999,0,9999,0
1668171844349,CSE 293,025,119406,Politz; Joseph Gibbs,9999,0,9999,0
1668171844349,CSE 293,026,119411,Porter; George M,9999,0,9999,0
1668171844349,CSE 293,027,119414,Porter; Leonard Emerson,9999,0,9999,0
1668171844349,CSE 293,028,119416,Ramamoorthi; Ravi,9999,0,9999,0
1668171844349,CSE 293,029,119417,Sahoo; Debashis,9999,0,9999,0
1668171844349,CSE 293,030,119420,Saul; Lawrence,9999,0,9999,0
1668171844349,CSE 293,031,119421,Savage; Stefan,9999,0,9999,0
1668171844349,CSE 293,032,119425,Schulze; Jurgen P.,9999,0,9999,0
1668171844349,CSE 293,033,119426,Snoeren; Alex C.,9999,0,9999,0
1668171844349,CSE 293,034,119428,Shang; Jingbo,9999,0,9999,0
1668171844349,CSE 293,035,119430,Stefan; Deian,9999,0,9999,0
1668171844349,CSE 293,036,119431,Su; Hao,9999,0,9999,0
1668171844349,CSE 293,037,119433,Swanson; Steven James,9999,0,9999,0
1668171844349,CSE 293,038,119435,Tullsen; Dean Michael,9999,0,9999,0
1668171844349,CSE 293,039,119483,Voelker; Geoffrey M.,9999,0,9999,0
1668171844349,CSE 293,040,119537,Zhao; Jishen,9999,0,9999,0
1668171844349,CSE 293,041,119538,Zhou; Yuan-Yuan,9999,0,9999,0
1668171844349,CSE 293,042,119539,Gao; Sicun,9999,0,9999,0
1668171844349,CSE 293,043,119540,Weibel; Nadir,9999,0,9999,0
1668171844349,CSE 293,044,119541,Gupta; Rajesh K.,9999,0,9999,0
1668171844349,CSE 293,045,126410,Vaccaro; Kristen Marie,9999,0,9999,0
1668171844349,CSE 293,046,126411,Klemke; Richard,9999,0,9999,0
1668171844774,CSE 294,A00,102459,Voelker; Geoffrey M.,0,0,0,0
1668171844774,CSE 294,B00,111322,Orailoglu; Alex,0,0,0,0
1668171845202,DSE 201,A00,096914,Deutsch; Alin Bernard,30,0,30,0
1668171845625,DSE 210,A00,096915,Dasgupta; Sanjoy,30,0,30,0
1668171846050,DSE 260A,A00,096916,Altintas De Callaf; Ilkay,30,0,30,0
1668171846477,ECE 200,001,103586,Antipa; Nicholas A,9999,0,9999,0
1668171846477,ECE 200,002,103587,Atanasov; Nikolay A.,9999,0,9999,0
1668171846477,ECE 200,003,103588,Bharadia; Dinesh,9999,0,9999,0
1668171846477,ECE 200,004,103589,Cheng; Chung Kuan,9999,0,9999,0
1668171846477,ECE 200,005,103590,Cosman; Pamela C.,9999,0,9999,0
1668171846477,ECE 200,006,103591,Dayeh; Shadi Ahmad,9999,0,9999,0
1668171846477,ECE 200,007,103592,Fainman; Yeshaiahu,9999,0,9999,0
1668171846477,ECE 200,008,103593,Ford; Joseph Earl,9999,0,9999,0
1668171846477,ECE 200,009,103594,Franceschetti; Massimo,9999,0,9999,0
1668171846477,ECE 200,010,103595,Fullerton; Eric E,9999,0,9999,0
1668171846477,ECE 200,011,103596,Galton; Ian A,9999,0,9999,0
1668171846477,ECE 200,012,103597,Gilja; Vikash,9999,0,9999,0
1668171846477,ECE 200,013,103598,Hall; Drew A.,9999,0,9999,0
1668171846477,ECE 200,014,103599,Hsueh; Tzu-Chien,9999,0,9999,0
1668171846477,ECE 200,015,103600,Javidi; Tara,9999,0,9999,0
1668171846477,ECE 200,016,103601,Kahng; Andrew Byun,9999,0,9999,0
1668171846477,ECE 200,017,103602,Kim; Young-Han,9999,0,9999,0
1668171846477,ECE 200,018,103603,Koushanfar; Farinaz,9999,0,9999,0
1668171846477,ECE 200,019,103604,Kuzum; Duygu,9999,0,9999,0
1668171846477,ECE 200,020,103605,Le; Hanh-Phuc,9999,0,9999,0
1668171846477,ECE 200,021,103606,Lin; Bill,9999,0,9999,0
1668171846477,ECE 200,022,103607,Liu; Zhaowei,9998,0,9999,1
1668171846477,ECE 200,023,103608,Lo; Yu-Hwa,9999,0,9999,0
1668171846477,ECE 200,024,103609,Lomakin; Vitaliy,9999,0,9999,0
1668171846477,ECE 200,025,103610,Mercier; Patrick Philip,9999,0,9999,0
1668171846477,ECE 200,026,103611,Meyer; Florian,9999,0,9999,0
1668171846477,ECE 200,027,103612,Milstein; Laurence B.,9999,0,9999,0
1668171846477,ECE 200,028,103613,Mir Arabbaygi; Siavash,9999,0,9999,0
1668171846477,ECE 200,029,103614,Mookherjea; Shayan,9999,0,9999,0
1668171846477,ECE 200,030,103615,Morris; Karcher William,9999,0,9999,0
1668171846477,ECE 200,031,103616,Ng; Tse Nga,9999,0,9999,0
1668171846477,ECE 200,032,103617,Nguyen; Truong Quang,9999,0,9999,0
1668171846477,ECE 200,033,103618,Nomura; Kenji,9999,0,9999,0
1668171846477,ECE 200,034,103619,Orlitsky; Alon,9999,0,9999,0
1668171846477,ECE 200,035,103620,Pal; Piya,9999,0,9999,0
1668171846477,ECE 200,036,103621,Papen; George C.,9999,0,9999,0
1668171846477,ECE 200,037,103622,Radic; Stojan,9999,0,9999,0
1668171846477,ECE 200,038,103623,Rao; Bhaskar D.,9999,0,9999,0
1668171846477,ECE 200,039,103624,Rao; Ramesh R,9999,0,9999,0
1668171846477,ECE 200,040,103625,Rebeiz; Gabriel,9999,0,9999,0
1668171846477,ECE 200,041,103626,Sanford; John R,9999,0,9999,0
1668171846477,ECE 200,042,103627,Siegel; Paul H.,9999,0,9999,0
1668171846477,ECE 200,043,103628,Sievenpiper; Daniel F.,9999,0,9999,0
1668171846477,ECE 200,044,103629,Sworder; David D.,9999,0,9999,0
1668171846477,ECE 200,045,103630,Taur; Yuan,9999,0,9999,0
1668171846477,ECE 200,046,103631,Touri; Behrouz,9999,0,9999,0
1668171846477,ECE 200,047,103632,Trivedi; Mohan M.,9999,0,9999,0
1668171846477,ECE 200,048,103633,Vasconcelos; Nuno,9999,0,9999,0
1668171846477,ECE 200,049,103634,Wang; Xiaolong,9999,0,9999,0
1668171846477,ECE 200,050,103635,Xie; Pengtao,9999,0,9999,0
1668171846477,ECE 200,051,103636,Yip; Michael,9999,0,9999,0
1668171846477,ECE 200,052,103637,Zeger; Kenneth A.,999,0,999,0
1668171846477,ECE 200,053,103638,Zhang; Xinyu,9999,0,9999,0
1668171846477,ECE 200,054,103639,Turakhia; Yatish Girish,9999,0,9999,0
1668171846477,ECE 200,055,103640,Kang; Mingu,9999,0,9999,0
1668171846477,ECE 200,056,103641,Shi; Yuanyuan,9999,0,9999,0
1668171846477,ECE 200,057,103642,Wang; Edward Jay,9999,0,9999,0
1668171846477,ECE 200,058,103643,Zheng; Yang,9999,0,9999,0
1668171846902,ECE 202,A00,103644,Kuzum; Duygu,0,0,0,0
1668171847329,ECE 212BN,A00,103646,Ng; Tse Nga,0,0,0,0
1668171847758,ECE 221,A00,111493,Staff,0,0,0,0
1668171848182,ECE 222B,A00,103647,Lomakin; Vitaliy,0,0,0,0
1668171848607,ECE 230B,A00,103648,Taur; Yuan,0,0,0,0
1668171849037,ECE 238B,A00,103649,Garay; Javier,0,0,0,0
1668171849465,ECE 240B,A00,112900,Fainman; Yeshaiahu,0,0,0,0
1668171849893,ECE 247A,A00,103650,Jokerst; Jesse Vincent,0,0,0,0
1668171850321,ECE 247B,A00,103651,Wang; Joseph,0,0,0,0
1668171850748,ECE 250,A00,103652,Siegel; Paul H.,0,0,0,0
1668171851173,ECE 251A,A00,103654,Rao; Bhaskar D.,0,0,0,0
1668171851609,ECE 257B,A00,103655,Bharadia; Dinesh,0,0,0,0
1668171852037,ECE 258A,A00,103656,Milstein; Laurence B.,0,0,0,0
1668171852466,ECE 260B,A00,103658,Kang; Mingu,0,0,0,0
1668171852894,ECE 264A,A00,103659,Galton; Ian A,0,0,0,0
1668171853318,ECE 265A,A00,103661,Gudem; Prasad S.S.,0,0,0,0
1668171853746,ECE 265D,A00,103662,Gudem; Prasad S.S.,0,0,0,0
1668171854171,ECE 268,A00,103663,Koushanfar; Farinaz,0,0,0,0
1668171854597,ECE 269,A01,103665,Pal; Piya,0,0,0,0
1668171855020,ECE 271B,A00,103666,Vasconcelos; Manuela,0,0,0,0
1668171855442,ECE 276A,A00,103667,Atanasov; Nikolay A.,0,0,0,0
1668171855866,ECE 277,A00,103668,An; Cheolhong,0,0,0,0
1668171856292,ECE 279,A00,117947,Hall; Drew A.,0,0,0,0
1668171857146,ECE 283,A00,103670,Hsueh; Tzu-Chien,0,0,0,0
1668171857571,ECE 284,A00,103671,Turakhia; Yatish Girish,0,0,0,0
1668171857996,ECE 285,A00,103672,Zheng; Yang,0,0,0,0
1668171857996,ECE 285,B00,103673,Sworder; David D.,0,0,0,0
1668171858420,ECE 287,A00,103676,Javidi; Tara,0,0,0,0
1668171858845,MATH 200B,A00,098023,Salehi Golsefidy; Alireza,12,0,15,3
1668171859273,MATH 202B,A00,098024,Rhoades; Brendon Patrick,9,0,15,6
1668171859698,MATH 203B,A00,098025,Oprea; Dragos N.,10,0,15,5
1668171860133,MATH 204B,A00,098026,Sorensen; Claus M,13,0,15,2
1668171860561,MATH 208,A00,098027,Izadi; Elham,7,0,10,3
1668171860988,MATH 209,A00,098028,Pollack; Aaron,10,0,10,0
1668171861413,MATH 211A,A00,112919,Rogalski; Daniel,9,0,10,1
1668171861837,MATH 211B,A00,112920,Seward; Brandon M.,9,0,10,1
1668171862263,MATH 218,A00,098029,Li; Bo,10,0,10,0
1668171862687,MATH 220B,A00,098030,Novak; Jonathan I,11,0,15,4
1668171863110,MATH 221A,A00,098031,Ebenfelt; Peter F,13,0,15,2
1668171863547,MATH 231B,A00,098032,Zlatos; Andrej,12,0,15,3
1668171863971,MATH 240B,A00,098033,Ni; Lei,9,0,15,6
1668171864395,MATH 243,A00,098034,Jekel; David Andrew,10,0,10,0
1668171864818,MATH 245A,A00,098035,Nie; Jiawang,0,0,15,16
1668171865246,MATH 248,A00,098036,Bejenaru; Ioan,10,0,10,0
1668171865670,MATH 250B,A00,098037,Spolaor; Luca,14,0,15,1
1668171866101,MATH 258,A00,098038,Ni; Lei,10,0,10,0
1668171866525,MATH 264B,A00,098041,Rhoades; Brendon Patrick,9,0,15,6
1668171866952,MATH 268,A00,098042,Buss; Samuel R,10,0,10,0
1668171867374,MATH 269,A00,098043,Rhoades; Brendon Patrick,10,0,10,0
1668171867810,MATH 270B,A00,098044,Li; Bo,10,0,15,5
1668171868235,MATH 272B,A00,098045,Holst; Michael J,13,0,15,2
1668171868659,MATH 273A,A00,098046,Tian; Xiaochuan,10,0,15,5
1668171869086,MATH 275,A01,098048,Tian; Xiaochuan,6,0,10,4
1668171869509,MATH 278A,A00,098049,Holst; Michael J,8,0,10,2
1668171869932,MATH 278B,A00,098050,Cloninger; Alexander,10,0,10,0
1668171870357,MATH 278C,A00,098051,Nie; Jiawang,7,0,10,3
1668171870782,MATH 280B,A00,098052,Zheng; Tianyi,10,0,15,5
1668171871310,MATH 281B,A00,098053,Bradic; Jelena,2,0,15,13
1668171871738,MATH 282B,A00,098054,Arias-Castro; Ery,0,0,15,15
1668171872167,MATH 285,A00,098055,Fitzsimmons; Patrick J,0,0,15,17
1668171872591,MATH 287B,A00,098056,Arias-Castro; Ery,2,0,15,13
1668171873016,MATH 288,A00,098057,Agarwal; Pooja,9,0,10,1
1668171873016,MATH 288,B00,098058,Zhang; Danna,8,0,10,2
1668171873016,MATH 288,C00,098059,Williams; Ruth J,10,0,10,0
1668171873441,MATH 290B,A00,098060,Roberts; Justin Deritter,13,0,15,2
1668171873869,MATH 292,A00,098061,Belmont; Eva Kinoshita,10,0,10,0
1668171874292,MATH 295,A00,098062,Suk; Andrew Hoon,48,0,50,2
1668171874718,MATH 296,A00,098063,Novak; Jonathan I,20,0,20,0
1668171875148,MATH 297,001,098064,Gamst; Anthony Collins,9997,0,9999,2
1668172377164,COGS 205,A00,101395,Chiba; Andrea,19,0,20,1
1668172377594,COGS 210B,001,101404,Greene; Deanna Jacquelyn,9998,0,9999,1
1668172377594,COGS 210B,002,101417,Xia; Haijun,9999,0,9999,0
1668172377594,COGS 210B,003,101422,Nitz; Douglas A.,9999,0,9999,0
1668172377594,COGS 210B,004,101423,Hollan; James D.,9998,0,9999,1
1668172377594,COGS 210B,005,101424,Deak; Gedeon O.,9998,0,9999,1
1668172377594,COGS 210B,006,101425,Rossano; Federico,9999,0,9999,0
1668172378019,COGS 211B,A00,101427,Coulson; Seana M,9996,0,9999,3
1668172378445,COGS 220,A00,101428,Hollan; James D.,0,0,25,25
1668172378869,COGS 229,A00,101429,Dow; Steven P,18,0,25,7
1668172379294,COGS 230,A00,101430,Klemmer; Scott R,12,0,17,5
1668172379721,COGS 234,A00,101431,Xia; Haijun,3,0,25,22
1668172380146,COGS 260,A00,101432,Kiyonaga; Anastasia,20,0,25,5
1668172380146,COGS 260,B00,101433,Kirsh; David Joel,16,0,25,9
1668172380575,CSE 202,A00,102371,Impagliazzo; Russell,0,0,0,0
1668172381006,CSE 203B,A01,102373,Cheng; Chung Kuan,0,0,0,0
1668172381431,CSE 208,A00,102374,Micciancio; Daniele,0,0,0,0
1668172381859,CSE 209A,A00,112895,Impagliazzo; Russell,0,0,15,15
1668172382285,CSE 209B,A00,108005,Bellare; Mihir,0,0,0,0
1668172382724,CSE 210,A00,113163,Coblenz; Michael J,0,0,0,0
1668172383147,CSE 219,A00,106111,Dow; Steven P,0,0,20,20
1668172383575,CSE 221,A00,102376,Voelker; Geoffrey M.,0,0,0,0
1668172384000,CSE 224,A01,102378,Porter; George M,0,0,0,0
1668172384425,CSE 229A,A00,102379,Savage; Stefan,0,0,0,0
1668172384852,CSE 229C,A00,102380,Munyaka; Imani N. S.,0,0,0,0
1668172385280,CSE 232B,A00,102382,Deutsch; Alin Bernard,0,0,0,0
1668172385708,CSE 234,A01,112904,Kumar; Arun Kumar,0,0,0,0
1668172386134,CSE 237A,A00,102383,Rosing; Tajana Simunic,0,0,0,0
1668172386563,CSE 239A,A00,102384,Deutsch; Alin Bernard,0,0,0,0
1668172386987,CSE 239B,A00,102385,Polikarpova; Nadezhda,0,0,0,0
1668172387414,CSE 240A,A00,102386,Pannuto; Patrick William,0,0,0,0
1668172387851,CSE 240B,A00,102387,Zhao; Jishen,0,0,0,0
1668172388275,CSE 241A,A00,106406,Kang; Mingu,0,0,0,0
1668172388700,CSE 249B,A00,102388,Kahng; Andrew Byun,0,0,8,8
1668172389141,CSE 251B,A01,102392,Cottrell; Garrison W,0,0,0,0
1668172389141,CSE 251B,A02,102393,Cottrell; Garrison W,0,0,0,0
1668172389567,CSE 252B,A00,102394,Ochoa; Benjamin Lawrence,0,0,0,0
1668172389995,CSE 257,A01,102396,Gao; Sicun,0,0,0,0
1668172390420,CSE 272,A00,102397,Li; Tzumao,0,0,0,0
1668172390845,CSE 274,A00,111323,Chern; Albert Ren-Haur,0,0,0,0
1668172391283,CSE 282,A00,102398,Pevzner; Pavel Arkadjevich,0,0,0,0
1668172391713,CSE 284,A00,114175,Gymrek; Melissa Ann,0,0,0,0
1668172392141,CSE 290,A00,102399,Chandraker; Manmohan Krishna,0,0,0,0
1668172392141,CSE 290,B00,102400,Vaccaro; Kristen Marie,0,0,25,25
1668172392141,CSE 290,C00,102414,Pannuto; Patrick William,0,0,25,25
1668172392141,CSE 290,D00,102427,Pevzner; Pavel Arkadjevich,0,0,0,0
1668172392141,CSE 290,E00,102429,Zhao; Jishen,0,0,0,0
1668172392141,CSE 290,F00,102436,Tullsen; Dean Michael,0,0,0,0
1668172392141,CSE 290,G00,102440,Christensen; Henrik I,0,0,20,20
1668172392568,CSE 291,A00,102443,Su; Hao,0,0,0,0
1668172392568,CSE 291,B00,102448,Polikarpova; Nadezhda,0,0,0,0
1668172392568,CSE 291,C00,102453,Vaccaro; Kristen Marie,0,0,0,0
1668172392568,CSE 291,D00,111343,Savage; Stefan,0,0,0,0
1668172392568,CSE 291,E00,116474,Claffy; Kimberly Claire,0,0,0,0
1668172392568,CSE 291,F00,116479,Pasquale; Joseph,0,0,0,0
1668172393017,CSE 293,001,119111,Bafna; Vineet,9999,0,9999,0
1668172393017,CSE 293,002,119118,Bellare; Mihir,9999,0,9999,0
1668172393017,CSE 293,003,119122,Berg-Kirkpatrick; Taylor D,9999,0,9999,0
1668172393017,CSE 293,004,119135,Christensen; Henrik I,9999,0,9999,0
1668172393017,CSE 293,005,119142,Cottrell; Garrison W,9999,0,9999,0
1668172393017,CSE 293,006,119146,Deutsch; Alin Bernard,9999,0,9999,0
1668172393017,CSE 293,007,119159,Esmaeilzadeh; Hadi,9999,0,9999,0
1668172393017,CSE 293,008,119166,Freund; Yoav,9999,0,9999,0
1668172393017,CSE 293,009,119170,Griswold; William G.,9999,0,9999,0
1668172393017,CSE 293,010,119183,Gymrek; Melissa Ann,9999,0,9999,0
1668172393017,CSE 293,011,119190,Heninger; Nadia A,9999,0,9999,0
1668172393017,CSE 293,012,119230,Impagliazzo; Russell,9999,0,9999,0
1668172393017,CSE 293,013,119232,Jhala; Ranjit,9999,0,9999,0
1668172393017,CSE 293,014,119233,Kahng; Andrew Byun,9999,0,9999,0
1668172393017,CSE 293,015,119298,Kane; Daniel Mertz,9999,0,9999,0
1668172393017,CSE 293,016,119299,Kriegman; David J,9999,0,9999,0
1668172393017,CSE 293,017,119300,Kumar; Arun Kumar,9999,0,9999,0
1668172393017,CSE 293,018,119301,Lerner; Sorin,9999,0,9999,0
1668172393017,CSE 293,019,119302,Lovett; Shachar,9999,0,9999,0
1668172393017,CSE 293,020,119303,McAuley; Julian John,9999,0,9999,0
1668172393017,CSE 293,021,119304,Micciancio; Daniele,9999,0,9999,0
1668172393017,CSE 293,022,119367,Orailoglu; Alex,9999,0,9999,0
1668172393017,CSE 293,023,119382,Paturi; Ramamohan,9999,0,9999,0
1668172393017,CSE 293,024,119404,Polikarpova; Nadezhda,9999,0,9999,0
1668172393017,CSE 293,025,119406,Politz; Joseph Gibbs,9999,0,9999,0
1668172393017,CSE 293,026,119411,Porter; George M,9999,0,9999,0
1668172393017,CSE 293,027,119414,Porter; Leonard Emerson,9999,0,9999,0
1668172393017,CSE 293,028,119416,Ramamoorthi; Ravi,9999,0,9999,0
1668172393017,CSE 293,029,119417,Sahoo; Debashis,9999,0,9999,0
1668172393017,CSE 293,030,119420,Saul; Lawrence,9999,0,9999,0
1668172393017,CSE 293,031,119421,Savage; Stefan,9999,0,9999,0
1668172393017,CSE 293,032,119425,Schulze; Jurgen P.,9999,0,9999,0
1668172393017,CSE 293,033,119426,Snoeren; Alex C.,9999,0,9999,0
1668172393017,CSE 293,034,119428,Shang; Jingbo,9999,0,9999,0
1668172393017,CSE 293,035,119430,Stefan; Deian,9999,0,9999,0
1668172393017,CSE 293,036,119431,Su; Hao,9999,0,9999,0
1668172393017,CSE 293,037,119433,Swanson; Steven James,9999,0,9999,0
1668172393017,CSE 293,038,119435,Tullsen; Dean Michael,9999,0,9999,0
1668172393017,CSE 293,039,119483,Voelker; Geoffrey M.,9999,0,9999,0
1668172393017,CSE 293,040,119537,Zhao; Jishen,9999,0,9999,0
1668172393017,CSE 293,041,119538,Zhou; Yuan-Yuan,9999,0,9999,0
1668172393017,CSE 293,042,119539,Gao; Sicun,9999,0,9999,0
1668172393017,CSE 293,043,119540,Weibel; Nadir,9999,0,9999,0
1668172393017,CSE 293,044,119541,Gupta; Rajesh K.,9999,0,9999,0
1668172393017,CSE 293,045,126410,Vaccaro; Kristen Marie,9999,0,9999,0
1668172393017,CSE 293,046,126411,Klemke; Richard,9999,0,9999,0
1668172393532,CSE 294,A00,102459,Voelker; Geoffrey M.,0,0,0,0
1668172393532,CSE 294,B00,111322,Orailoglu; Alex,0,0,0,0
1668172393966,DSE 201,A00,096914,Deutsch; Alin Bernard,30,0,30,0
1668172394391,DSE 210,A00,096915,Dasgupta; Sanjoy,30,0,30,0
1668172394814,DSE 260A,A00,096916,Altintas De Callaf; Ilkay,30,0,30,0
1668172395292,ECE 200,001,103586,Antipa; Nicholas A,9999,0,9999,0
1668172395292,ECE 200,002,103587,Atanasov; Nikolay A.,9999,0,9999,0
1668172395292,ECE 200,003,103588,Bharadia; Dinesh,9999,0,9999,0
1668172395292,ECE 200,004,103589,Cheng; Chung Kuan,9999,0,9999,0
1668172395292,ECE 200,005,103590,Cosman; Pamela C.,9999,0,9999,0
1668172395292,ECE 200,006,103591,Dayeh; Shadi Ahmad,9999,0,9999,0
1668172395292,ECE 200,007,103592,Fainman; Yeshaiahu,9999,0,9999,0
1668172395292,ECE 200,008,103593,Ford; Joseph Earl,9999,0,9999,0
1668172395292,ECE 200,009,103594,Franceschetti; Massimo,9999,0,9999,0
1668172395292,ECE 200,010,103595,Fullerton; Eric E,9999,0,9999,0
1668172395292,ECE 200,011,103596,Galton; Ian A,9999,0,9999,0
1668172395292,ECE 200,012,103597,Gilja; Vikash,9999,0,9999,0
1668172395292,ECE 200,013,103598,Hall; Drew A.,9999,0,9999,0
1668172395292,ECE 200,014,103599,Hsueh; Tzu-Chien,9999,0,9999,0
1668172395292,ECE 200,015,103600,Javidi; Tara,9999,0,9999,0
1668172395292,ECE 200,016,103601,Kahng; Andrew Byun,9999,0,9999,0
1668172395292,ECE 200,017,103602,Kim; Young-Han,9999,0,9999,0
1668172395292,ECE 200,018,103603,Koushanfar; Farinaz,9999,0,9999,0
1668172395292,ECE 200,019,103604,Kuzum; Duygu,9999,0,9999,0
1668172395292,ECE 200,020,103605,Le; Hanh-Phuc,9999,0,9999,0
1668172395292,ECE 200,021,103606,Lin; Bill,9999,0,9999,0
1668172395292,ECE 200,022,103607,Liu; Zhaowei,9998,0,9999,1
1668172395292,ECE 200,023,103608,Lo; Yu-Hwa,9999,0,9999,0
1668172395292,ECE 200,024,103609,Lomakin; Vitaliy,9999,0,9999,0
1668172395292,ECE 200,025,103610,Mercier; Patrick Philip,9999,0,9999,0
1668172395292,ECE 200,026,103611,Meyer; Florian,9999,0,9999,0
1668172395292,ECE 200,027,103612,Milstein; Laurence B.,9999,0,9999,0
1668172395292,ECE 200,028,103613,Mir Arabbaygi; Siavash,9999,0,9999,0
1668172395292,ECE 200,029,103614,Mookherjea; Shayan,9999,0,9999,0
1668172395292,ECE 200,030,103615,Morris; Karcher William,9999,0,9999,0
1668172395292,ECE 200,031,103616,Ng; Tse Nga,9999,0,9999,0
1668172395292,ECE 200,032,103617,Nguyen; Truong Quang,9999,0,9999,0
1668172395292,ECE 200,033,103618,Nomura; Kenji,9999,0,9999,0
1668172395292,ECE 200,034,103619,Orlitsky; Alon,9999,0,9999,0
1668172395292,ECE 200,035,103620,Pal; Piya,9999,0,9999,0
1668172395292,ECE 200,036,103621,Papen; George C.,9999,0,9999,0
1668172395292,ECE 200,037,103622,Radic; Stojan,9999,0,9999,0
1668172395292,ECE 200,038,103623,Rao; Bhaskar D.,9999,0,9999,0
1668172395292,ECE 200,039,103624,Rao; Ramesh R,9999,0,9999,0
1668172395292,ECE 200,040,103625,Rebeiz; Gabriel,9999,0,9999,0
1668172395292,ECE 200,041,103626,Sanford; John R,9999,0,9999,0
1668172395292,ECE 200,042,103627,Siegel; Paul H.,9999,0,9999,0
1668172395292,ECE 200,043,103628,Sievenpiper; Daniel F.,9999,0,9999,0
1668172395292,ECE 200,044,103629,Sworder; David D.,9999,0,9999,0
1668172395292,ECE 200,045,103630,Taur; Yuan,9999,0,9999,0
1668172395292,ECE 200,046,103631,Touri; Behrouz,9999,0,9999,0
1668172395292,ECE 200,047,103632,Trivedi; Mohan M.,9999,0,9999,0
1668172395292,ECE 200,048,103633,Vasconcelos; Nuno,9999,0,9999,0
1668172395292,ECE 200,049,103634,Wang; Xiaolong,9999,0,9999,0
1668172395292,ECE 200,050,103635,Xie; Pengtao,9999,0,9999,0
1668172395292,ECE 200,051,103636,Yip; Michael,9999,0,9999,0
1668172395292,ECE 200,052,103637,Zeger; Kenneth A.,999,0,999,0
1668172395292,ECE 200,053,103638,Zhang; Xinyu,9999,0,9999,0
1668172395292,ECE 200,054,103639,Turakhia; Yatish Girish,9999,0,9999,0
1668172395292,ECE 200,055,103640,Kang; Mingu,9999,0,9999,0
1668172395292,ECE 200,056,103641,Shi; Yuanyuan,9999,0,9999,0
1668172395292,ECE 200,057,103642,Wang; Edward Jay,9999,0,9999,0
1668172395292,ECE 200,058,103643,Zheng; Yang,9999,0,9999,0
1668172395727,ECE 202,A00,103644,Kuzum; Duygu,0,0,0,0
1668172396169,ECE 212BN,A00,103646,Ng; Tse Nga,0,0,0,0
1668172396598,ECE 221,A00,111493,Staff,0,0,0,0
1668172397024,ECE 222B,A00,103647,Lomakin; Vitaliy,0,0,0,0
1668172397451,ECE 230B,A00,103648,Taur; Yuan,0,0,0,0
1668172397874,ECE 238B,A00,103649,Garay; Javier,0,0,0,0
1668172398298,ECE 240B,A00,112900,Fainman; Yeshaiahu,0,0,0,0
1668172398731,ECE 247A,A00,103650,Jokerst; Jesse Vincent,0,0,0,0
1668172399156,ECE 247B,A00,103651,Wang; Joseph,0,0,0,0
1668172399582,ECE 250,A00,103652,Siegel; Paul H.,0,0,0,0
1668172400007,ECE 251A,A00,103654,Rao; Bhaskar D.,0,0,0,0
1668172400432,ECE 257B,A00,103655,Bharadia; Dinesh,0,0,0,0
1668172400856,ECE 258A,A00,103656,Milstein; Laurence B.,0,0,0,0
1668172401285,ECE 260B,A00,103658,Kang; Mingu,0,0,0,0
1668172401709,ECE 264A,A00,103659,Galton; Ian A,0,0,0,0
1668172402137,ECE 265A,A00,103661,Gudem; Prasad S.S.,0,0,0,0
1668172402564,ECE 265D,A00,103662,Gudem; Prasad S.S.,0,0,0,0
1668172402988,ECE 268,A00,103663,Koushanfar; Farinaz,0,0,0,0
1668172403410,ECE 269,A01,103665,Pal; Piya,0,0,0,0
1668172403842,ECE 271B,A00,103666,Vasconcelos; Manuela,0,0,0,0
1668172404266,ECE 276A,A00,103667,Atanasov; Nikolay A.,0,0,0,0
1668172404693,ECE 277,A00,103668,An; Cheolhong,0,0,0,0
1668172405120,ECE 279,A00,117947,Hall; Drew A.,0,0,0,0
1668172405978,ECE 283,A00,103670,Hsueh; Tzu-Chien,0,0,0,0
1668172406404,ECE 284,A00,103671,Turakhia; Yatish Girish,0,0,0,0
1668172406830,ECE 285,A00,103672,Zheng; Yang,0,0,0,0
1668172406830,ECE 285,B00,103673,Sworder; David D.,0,0,0,0
1668172407254,ECE 287,A00,103676,Javidi; Tara,0,0,0,0
1668172407687,MATH 200B,A00,098023,Salehi Golsefidy; Alireza,12,0,15,3
1668172408112,MATH 202B,A00,098024,Rhoades; Brendon Patrick,9,0,15,6
1668172408541,MATH 203B,A00,098025,Oprea; Dragos N.,10,0,15,5
1668172408965,MATH 204B,A00,098026,Sorensen; Claus M,13,0,15,2
1668172409401,MATH 208,A00,098027,Izadi; Elham,7,0,10,3
1668172409825,MATH 209,A00,098028,Pollack; Aaron,10,0,10,0
1668172410252,MATH 211A,A00,112919,Rogalski; Daniel,9,0,10,1
1668172410676,MATH 211B,A00,112920,Seward; Brandon M.,9,0,10,1
1668172411102,MATH 218,A00,098029,Li; Bo,10,0,10,0
1668172411526,MATH 220B,A00,098030,Novak; Jonathan I,11,0,15,4
1668172411951,MATH 221A,A00,098031,Ebenfelt; Peter F,13,0,15,2
1668172412375,MATH 231B,A00,098032,Zlatos; Andrej,12,0,15,3
1668172412809,MATH 240B,A00,098033,Ni; Lei,9,0,15,6
1668172413233,MATH 243,A00,098034,Jekel; David Andrew,10,0,10,0
1668172413661,MATH 245A,A00,098035,Nie; Jiawang,0,0,15,16
1668172414090,MATH 248,A00,098036,Bejenaru; Ioan,10,0,10,0
1668172414519,MATH 250B,A00,098037,Spolaor; Luca,14,0,15,1
1668172414944,MATH 258,A00,098038,Ni; Lei,10,0,10,0
1668172415371,MATH 264B,A00,098041,Rhoades; Brendon Patrick,9,0,15,6
1668172415797,MATH 268,A00,098042,Buss; Samuel R,10,0,10,0
1668172416225,MATH 269,A00,098043,Rhoades; Brendon Patrick,10,0,10,0
1668172416649,MATH 270B,A00,098044,Li; Bo,10,0,15,5
1668172417079,MATH 272B,A00,098045,Holst; Michael J,13,0,15,2
1668172417506,MATH 273A,A00,098046,Tian; Xiaochuan,10,0,15,5
1668172417935,MATH 275,A01,098048,Tian; Xiaochuan,6,0,10,4
1668172418363,MATH 278A,A00,098049,Holst; Michael J,8,0,10,2
1668172418790,MATH 278B,A00,098050,Cloninger; Alexander,10,0,10,0
1668172419218,MATH 278C,A00,098051,Nie; Jiawang,7,0,10,3
1668172419642,MATH 280B,A00,098052,Zheng; Tianyi,10,0,15,5
1668172420067,MATH 281B,A00,098053,Bradic; Jelena,2,0,15,13
1668172420495,MATH 282B,A00,098054,Arias-Castro; Ery,0,0,15,15
1668172420926,MATH 285,A00,098055,Fitzsimmons; Patrick J,0,0,15,17
1668172421350,MATH 287B,A00,098056,Arias-Castro; Ery,2,0,15,13
1668172421781,MATH 288,A00,098057,Agarwal; Pooja,9,0,10,1
1668172421781,MATH 288,B00,098058,Zhang; Danna,8,0,10,2
1668172421781,MATH 288,C00,098059,Williams; Ruth J,10,0,10,0
1668172422206,MATH 290B,A00,098060,Roberts; Justin Deritter,13,0,15,2
1668172422630,MATH 292,A00,098061,Belmont; Eva Kinoshita,10,0,10,0
1668172423054,MATH 295,A00,098062,Suk; Andrew Hoon,48,0,50,2
1668172423481,MATH 296,A00,098063,Novak; Jonathan I,20,0,20,0
1668172423905,MATH 297,001,098064,Gamst; Anthony Collins,9997,0,9999,2
1668172979981,COGS 205,A00,101395,Chiba; Andrea,19,0,20,1
1668172980413,COGS 210B,001,101404,Greene; Deanna Jacquelyn,9998,0,9999,1
1668172980413,COGS 210B,002,101417,Xia; Haijun,9999,0,9999,0
1668172980413,COGS 210B,003,101422,Nitz; Douglas A.,9999,0,9999,0
1668172980413,COGS 210B,004,101423,Hollan; James D.,9998,0,9999,1
1668172980413,COGS 210B,005,101424,Deak; Gedeon O.,9998,0,9999,1
1668172980413,COGS 210B,006,101425,Rossano; Federico,9999,0,9999,0
1668172980841,COGS 211B,A00,101427,Coulson; Seana M,9996,0,9999,3
1668172981265,COGS 220,A00,101428,Hollan; James D.,0,0,25,25
1668172981691,COGS 229,A00,101429,Dow; Steven P,18,0,25,7
1668172982116,COGS 230,A00,101430,Klemmer; Scott R,12,0,17,5
1668172982545,COGS 234,A00,101431,Xia; Haijun,3,0,25,22
1668172982976,COGS 260,A00,101432,Kiyonaga; Anastasia,20,0,25,5
1668172982976,COGS 260,B00,101433,Kirsh; David Joel,16,0,25,9
1668172983410,CSE 202,A00,102371,Impagliazzo; Russell,0,0,0,0
1668172983838,CSE 203B,A01,102373,Cheng; Chung Kuan,0,0,0,0
1668172984265,CSE 208,A00,102374,Micciancio; Daniele,0,0,0,0
1668172984692,CSE 209A,A00,112895,Impagliazzo; Russell,0,0,15,15
1668172985118,CSE 209B,A00,108005,Bellare; Mihir,0,0,0,0
1668172985545,CSE 210,A00,113163,Coblenz; Michael J,0,0,0,0
1668172985975,CSE 219,A00,106111,Dow; Steven P,0,0,20,20
1668172986404,CSE 221,A00,102376,Voelker; Geoffrey M.,0,0,0,0
1668172986828,CSE 224,A01,102378,Porter; George M,0,0,0,0
1668172987253,CSE 229A,A00,102379,Savage; Stefan,0,0,0,0
1668172987681,CSE 229C,A00,102380,Munyaka; Imani N. S.,0,0,0,0
1668172988105,CSE 232B,A00,102382,Deutsch; Alin Bernard,0,0,0,0
1668172988532,CSE 234,A01,112904,Kumar; Arun Kumar,0,0,0,0
1668172988960,CSE 237A,A00,102383,Rosing; Tajana Simunic,0,0,0,0
1668172989388,CSE 239A,A00,102384,Deutsch; Alin Bernard,0,0,0,0
1668172989815,CSE 239B,A00,102385,Polikarpova; Nadezhda,0,0,0,0
1668172990239,CSE 240A,A00,102386,Pannuto; Patrick William,0,0,0,0
1668172990664,CSE 240B,A00,102387,Zhao; Jishen,0,0,0,0
1668172991091,CSE 241A,A00,106406,Kang; Mingu,0,0,0,0
1668172991522,CSE 249B,A00,102388,Kahng; Andrew Byun,0,0,8,8
1668172991952,CSE 251B,A01,102392,Cottrell; Garrison W,0,0,0,0
1668172991952,CSE 251B,A02,102393,Cottrell; Garrison W,0,0,0,0
1668172992380,CSE 252B,A00,102394,Ochoa; Benjamin Lawrence,0,0,0,0
1668172992802,CSE 257,A01,102396,Gao; Sicun,0,0,0,0
1668172993232,CSE 272,A00,102397,Li; Tzumao,0,0,0,0
1668172993657,CSE 274,A00,111323,Chern; Albert Ren-Haur,0,0,0,0
1668172994081,CSE 282,A00,102398,Pevzner; Pavel Arkadjevich,0,0,0,0
1668172994507,CSE 284,A00,114175,Gymrek; Melissa Ann,0,0,0,0
1668172994938,CSE 290,A00,102399,Chandraker; Manmohan Krishna,0,0,0,0
1668172994938,CSE 290,B00,102400,Vaccaro; Kristen Marie,0,0,25,25
1668172994938,CSE 290,C00,102414,Pannuto; Patrick William,0,0,25,25
1668172994938,CSE 290,D00,102427,Pevzner; Pavel Arkadjevich,0,0,0,0
1668172994938,CSE 290,E00,102429,Zhao; Jishen,0,0,0,0
1668172994938,CSE 290,F00,102436,Tullsen; Dean Michael,0,0,0,0
1668172994938,CSE 290,G00,102440,Christensen; Henrik I,0,0,20,20
1668172995370,CSE 291,A00,102443,Su; Hao,0,0,0,0
1668172995370,CSE 291,B00,102448,Polikarpova; Nadezhda,0,0,0,0
1668172995370,CSE 291,C00,102453,Vaccaro; Kristen Marie,0,0,0,0
1668172995370,CSE 291,D00,111343,Savage; Stefan,0,0,0,0
1668172995370,CSE 291,E00,116474,Claffy; Kimberly Claire,0,0,0,0
1668172995370,CSE 291,F00,116479,Pasquale; Joseph,0,0,0,0
1668172995805,CSE 293,001,119111,Bafna; Vineet,9999,0,9999,0
1668172995805,CSE 293,002,119118,Bellare; Mihir,9999,0,9999,0
1668172995805,CSE 293,003,119122,Berg-Kirkpatrick; Taylor D,9999,0,9999,0
1668172995805,CSE 293,004,119135,Christensen; Henrik I,9999,0,9999,0
1668172995805,CSE 293,005,119142,Cottrell; Garrison W,9999,0,9999,0
1668172995805,CSE 293,006,119146,Deutsch; Alin Bernard,9999,0,9999,0
1668172995805,CSE 293,007,119159,Esmaeilzadeh; Hadi,9999,0,9999,0
1668172995805,CSE 293,008,119166,Freund; Yoav,9999,0,9999,0
1668172995805,CSE 293,009,119170,Griswold; William G.,9999,0,9999,0
1668172995805,CSE 293,010,119183,Gymrek; Melissa Ann,9999,0,9999,0
1668172995805,CSE 293,011,119190,Heninger; Nadia A,9999,0,9999,0
1668172995805,CSE 293,012,119230,Impagliazzo; Russell,9999,0,9999,0
1668172995805,CSE 293,013,119232,Jhala; Ranjit,9999,0,9999,0
1668172995805,CSE 293,014,119233,Kahng; Andrew Byun,9999,0,9999,0
1668172995805,CSE 293,015,119298,Kane; Daniel Mertz,9999,0,9999,0
1668172995805,CSE 293,016,119299,Kriegman; David J,9999,0,9999,0
1668172995805,CSE 293,017,119300,Kumar; Arun Kumar,9999,0,9999,0
1668172995805,CSE 293,018,119301,Lerner; Sorin,9999,0,9999,0
1668172995805,CSE 293,019,119302,Lovett; Shachar,9999,0,9999,0
1668172995805,CSE 293,020,119303,McAuley; Julian John,9999,0,9999,0
1668172995805,CSE 293,021,119304,Micciancio; Daniele,9999,0,9999,0
1668172995805,CSE 293,022,119367,Orailoglu; Alex,9999,0,9999,0
1668172995805,CSE 293,023,119382,Paturi; Ramamohan,9999,0,9999,0
1668172995805,CSE 293,024,119404,Polikarpova; Nadezhda,9999,0,9999,0
1668172995805,CSE 293,025,119406,Politz; Joseph Gibbs,9999,0,9999,0
1668172995805,CSE 293,026,119411,Porter; George M,9999,0,9999,0
1668172995805,CSE 293,027,119414,Porter; Leonard Emerson,9999,0,9999,0
1668172995805,CSE 293,028,119416,Ramamoorthi; Ravi,9999,0,9999,0
1668172995805,CSE 293,029,119417,Sahoo; Debashis,9999,0,9999,0
1668172995805,CSE 293,030,119420,Saul; Lawrence,9999,0,9999,0
1668172995805,CSE 293,031,119421,Savage; Stefan,9999,0,9999,0
1668172995805,CSE 293,032,119425,Schulze; Jurgen P.,9999,0,9999,0
1668172995805,CSE 293,033,119426,Snoeren; Alex C.,9999,0,9999,0
1668172995805,CSE 293,034,119428,Shang; Jingbo,9999,0,9999,0
1668172995805,CSE 293,035,119430,Stefan; Deian,9999,0,9999,0
1668172995805,CSE 293,036,119431,Su; Hao,9999,0,9999,0
1668172995805,CSE 293,037,119433,Swanson; Steven James,9999,0,9999,0
1668172995805,CSE 293,038,119435,Tullsen; Dean Michael,9999,0,9999,0
1668172995805,CSE 293,039,119483,Voelker; Geoffrey M.,9999,0,9999,0
1668172995805,CSE 293,040,119537,Zhao; Jishen,9999,0,9999,0
1668172995805,CSE 293,041,119538,Zhou; Yuan-Yuan,9999,0,9999,0
1668172995805,CSE 293,042,119539,Gao; Sicun,9999,0,9999,0
1668172995805,CSE 293,043,119540,Weibel; Nadir,9999,0,9999,0
1668172995805,CSE 293,044,119541,Gupta; Rajesh K.,9999,0,9999,0
1668172995805,CSE 293,045,126410,Vaccaro; Kristen Marie,9999,0,9999,0
1668172995805,CSE 293,046,126411,Klemke; Richard,9999,0,9999,0
1668172996234,CSE 294,A00,102459,Voelker; Geoffrey M.,0,0,0,0
1668172996234,CSE 294,B00,111322,Orailoglu; Alex,0,0,0,0
1668172996658,DSE 201,A00,096914,Deutsch; Alin Bernard,30,0,30,0
1668172997083,DSE 210,A00,096915,Dasgupta; Sanjoy,30,0,30,0
1668172997508,DSE 260A,A00,096916,Altintas De Callaf; Ilkay,30,0,30,0
1668172997952,ECE 200,001,103586,Antipa; Nicholas A,9999,0,9999,0
1668172997952,ECE 200,002,103587,Atanasov; Nikolay A.,9999,0,9999,0
1668172997952,ECE 200,003,103588,Bharadia; Dinesh,9999,0,9999,0
1668172997952,ECE 200,004,103589,Cheng; Chung Kuan,9999,0,9999,0
1668172997952,ECE 200,005,103590,Cosman; Pamela C.,9999,0,9999,0
1668172997952,ECE 200,006,103591,Dayeh; Shadi Ahmad,9999,0,9999,0
1668172997952,ECE 200,007,103592,Fainman; Yeshaiahu,9999,0,9999,0
1668172997952,ECE 200,008,103593,Ford; Joseph Earl,9999,0,9999,0
1668172997952,ECE 200,009,103594,Franceschetti; Massimo,9999,0,9999,0
1668172997952,ECE 200,010,103595,Fullerton; Eric E,9999,0,9999,0
1668172997952,ECE 200,011,103596,Galton; Ian A,9999,0,9999,0
1668172997952,ECE 200,012,103597,Gilja; Vikash,9999,0,9999,0
1668172997952,ECE 200,013,103598,Hall; Drew A.,9999,0,9999,0
1668172997952,ECE 200,014,103599,Hsueh; Tzu-Chien,9999,0,9999,0
1668172997952,ECE 200,015,103600,Javidi; Tara,9999,0,9999,0
1668172997952,ECE 200,016,103601,Kahng; Andrew Byun,9999,0,9999,0
1668172997952,ECE 200,017,103602,Kim; Young-Han,9999,0,9999,0
1668172997952,ECE 200,018,103603,Koushanfar; Farinaz,9999,0,9999,0
1668172997952,ECE 200,019,103604,Kuzum; Duygu,9999,0,9999,0
1668172997952,ECE 200,020,103605,Le; Hanh-Phuc,9999,0,9999,0
1668172997952,ECE 200,021,103606,Lin; Bill,9999,0,9999,0
1668172997952,ECE 200,022,103607,Liu; Zhaowei,9998,0,9999,1
1668172997952,ECE 200,023,103608,Lo; Yu-Hwa,9999,0,9999,0
1668172997952,ECE 200,024,103609,Lomakin; Vitaliy,9999,0,9999,0
1668172997952,ECE 200,025,103610,Mercier; Patrick Philip,9999,0,9999,0
1668172997952,ECE 200,026,103611,Meyer; Florian,9999,0,9999,0
1668172997952,ECE 200,027,103612,Milstein; Laurence B.,9999,0,9999,0
1668172997952,ECE 200,028,103613,Mir Arabbaygi; Siavash,9999,0,9999,0
1668172997952,ECE 200,029,103614,Mookherjea; Shayan,9999,0,9999,0
1668172997952,ECE 200,030,103615,Morris; Karcher William,9999,0,9999,0
1668172997952,ECE 200,031,103616,Ng; Tse Nga,9999,0,9999,0
1668172997952,ECE 200,032,103617,Nguyen; Truong Quang,9999,0,9999,0
1668172997952,ECE 200,033,103618,Nomura; Kenji,9999,0,9999,0
1668172997952,ECE 200,034,103619,Orlitsky; Alon,9999,0,9999,0
1668172997952,ECE 200,035,103620,Pal; Piya,9999,0,9999,0
1668172997952,ECE 200,036,103621,Papen; George C.,9999,0,9999,0
1668172997952,ECE 200,037,103622,Radic; Stojan,9999,0,9999,0
1668172997952,ECE 200,038,103623,Rao; Bhaskar D.,9999,0,9999,0
1668172997952,ECE 200,039,103624,Rao; Ramesh R,9999,0,9999,0
1668172997952,ECE 200,040,103625,Rebeiz; Gabriel,9999,0,9999,0
1668172997952,ECE 200,041,103626,Sanford; John R,9999,0,9999,0
1668172997952,ECE 200,042,103627,Siegel; Paul H.,9999,0,9999,0
1668172997952,ECE 200,043,103628,Sievenpiper; Daniel F.,9999,0,9999,0
1668172997952,ECE 200,044,103629,Sworder; David D.,9999,0,9999,0
1668172997952,ECE 200,045,103630,Taur; Yuan,9999,0,9999,0
1668172997952,ECE 200,046,103631,Touri; Behrouz,9999,0,9999,0
1668172997952,ECE 200,047,103632,Trivedi; Mohan M.,9999,0,9999,0
1668172997952,ECE 200,048,103633,Vasconcelos; Nuno,9999,0,9999,0
1668172997952,ECE 200,049,103634,Wang; Xiaolong,9999,0,9999,0
1668172997952,ECE 200,050,103635,Xie; Pengtao,9999,0,9999,0
1668172997952,ECE 200,051,103636,Yip; Michael,9999,0,9999,0
1668172997952,ECE 200,052,103637,Zeger; Kenneth A.,999,0,999,0
1668172997952,ECE 200,053,103638,Zhang; Xinyu,9999,0,9999,0
1668172997952,ECE 200,054,103639,Turakhia; Yatish Girish,9999,0,9999,0
1668172997952,ECE 200,055,103640,Kang; Mingu,9999,0,9999,0
1668172997952,ECE 200,056,103641,Shi; Yuanyuan,9999,0,9999,0
1668172997952,ECE 200,057,103642,Wang; Edward Jay,9999,0,9999,0
1668172997952,ECE 200,058,103643,Zheng; Yang,9999,0,9999,0
1668172998378,ECE 202,A00,103644,Kuzum; Duygu,0,0,0,0
1668172998801,ECE 212BN,A00,103646,Ng; Tse Nga,0,0,0,0
1668172999232,ECE 221,A00,111493,Staff,0,0,0,0
1668172999659,ECE 222B,A00,103647,Lomakin; Vitaliy,0,0,0,0
1668173000083,ECE 230B,A00,103648,Taur; Yuan,0,0,0,0
1668173000508,ECE 238B,A00,103649,Garay; Javier,0,0,0,0
1668173000931,ECE 240B,A00,112900,Fainman; Yeshaiahu,0,0,0,0
1668173001356,ECE 247A,A00,103650,Jokerst; Jesse Vincent,0,0,0,0
1668173001780,ECE 247B,A00,103651,Wang; Joseph,0,0,0,0
1668173002205,ECE 250,A00,103652,Siegel; Paul H.,0,0,0,0
1668173002635,ECE 251A,A00,103654,Rao; Bhaskar D.,0,0,0,0
1668173003062,ECE 257B,A00,103655,Bharadia; Dinesh,0,0,0,0
1668173003487,ECE 258A,A00,103656,Milstein; Laurence B.,0,0,0,0
1668173003913,ECE 260B,A00,103658,Kang; Mingu,0,0,0,0
1668173004339,ECE 264A,A00,103659,Galton; Ian A,0,0,0,0
1668173004768,ECE 265A,A00,103661,Gudem; Prasad S.S.,0,0,0,0
1668173005192,ECE 265D,A00,103662,Gudem; Prasad S.S.,0,0,0,0
1668173005621,ECE 268,A00,103663,Koushanfar; Farinaz,0,0,0,0
1668173006045,ECE 269,A01,103665,Pal; Piya,0,0,0,0
1668173006470,ECE 271B,A00,103666,Vasconcelos; Manuela,0,0,0,0
1668173006894,ECE 276A,A00,103667,Atanasov; Nikolay A.,0,0,0,0
1668173007319,ECE 277,A00,103668,An; Cheolhong,0,0,0,0
1668173007754,ECE 279,A00,117947,Hall; Drew A.,0,0,0,0
1668173008612,ECE 283,A00,103670,Hsueh; Tzu-Chien,0,0,0,0
1668173009038,ECE 284,A00,103671,Turakhia; Yatish Girish,0,0,0,0
1668173009465,ECE 285,A00,103672,Zheng; Yang,0,0,0,0
1668173009465,ECE 285,B00,103673,Sworder; David D.,0,0,0,0
1668173009889,ECE 287,A00,103676,Javidi; Tara,0,0,0,0
1668173010316,MATH 200B,A00,098023,Salehi Golsefidy; Alireza,12,0,15,3
1668173010739,MATH 202B,A00,098024,Rhoades; Brendon Patrick,9,0,15,6
1668173011168,MATH 203B,A00,098025,Oprea; Dragos N.,10,0,15,5
1668173011592,MATH 204B,A00,098026,Sorensen; Claus M,13,0,15,2
1668173012018,MATH 208,A00,098027,Izadi; Elham,7,0,10,3
1668173012442,MATH 209,A00,098028,Pollack; Aaron,10,0,10,0
1668173012997,MATH 211A,A00,112919,Rogalski; Daniel,9,0,10,1
1668173013422,MATH 211B,A00,112920,Seward; Brandon M.,9,0,10,1
1668173013846,MATH 218,A00,098029,Li; Bo,10,0,10,0
1668173014275,MATH 220B,A00,098030,Novak; Jonathan I,11,0,15,4
1668173014702,MATH 221A,A00,098031,Ebenfelt; Peter F,13,0,15,2
1668173015126,MATH 231B,A00,098032,Zlatos; Andrej,12,0,15,3
1668173015550,MATH 240B,A00,098033,Ni; Lei,9,0,15,6
1668173015975,MATH 243,A00,098034,Jekel; David Andrew,10,0,10,0
1668173016401,MATH 245A,A00,098035,Nie; Jiawang,0,0,15,16
1668173016824,MATH 248,A00,098036,Bejenaru; Ioan,10,0,10,0
1668173017253,MATH 250B,A00,098037,Spolaor; Luca,14,0,15,1
1668173017680,MATH 258,A00,098038,Ni; Lei,10,0,10,0
1668173018106,MATH 264B,A00,098041,Rhoades; Brendon Patrick,9,0,15,6
1668173018534,MATH 268,A00,098042,Buss; Samuel R,10,0,10,0
1668173018958,MATH 269,A00,098043,Rhoades; Brendon Patrick,10,0,10,0
1668173019381,MATH 270B,A00,098044,Li; Bo,10,0,15,5
1668173019808,MATH 272B,A00,098045,Holst; Michael J,13,0,15,2
1668173020238,MATH 273A,A00,098046,Tian; Xiaochuan,10,0,15,5
1668173020666,MATH 275,A01,098048,Tian; Xiaochuan,6,0,10,4
1668173021092,MATH 278A,A00,098049,Holst; Michael J,8,0,10,2
1668173021519,MATH 278B,A00,098050,Cloninger; Alexander,10,0,10,0
1668173021942,MATH 278C,A00,098051,Nie; Jiawang,7,0,10,3
1668173022367,MATH 280B,A00,098052,Zheng; Tianyi,10,0,15,5
1668173022791,MATH 281B,A00,098053,Bradic; Jelena,2,0,15,13
1668173023218,MATH 282B,A00,098054,Arias-Castro; Ery,0,0,15,15
1668173023648,MATH 285,A00,098055,Fitzsimmons; Patrick J,0,0,15,17
1668173024070,MATH 287B,A00,098056,Arias-Castro; Ery,2,0,15,13
1668173024498,MATH 288,A00,098057,Agarwal; Pooja,9,0,10,1
1668173024498,MATH 288,B00,098058,Zhang; Danna,8,0,10,2
1668173024498,MATH 288,C00,098059,Williams; Ruth J,10,0,10,0
1668173024927,MATH 290B,A00,098060,Roberts; Justin Deritter,13,0,15,2
1668173025351,MATH 292,A00,098061,Belmont; Eva Kinoshita,10,0,10,0
1668173025776,MATH 295,A00,098062,Suk; Andrew Hoon,48,0,50,2
1668173026203,MATH 296,A00,098063,Novak; Jonathan I,20,0,20,0
1668173026630,MATH 297,001,098064,Gamst; Anthony Collins,9997,0,9999,2
1668173614188,COGS 205,A00,101395,Chiba; Andrea,19,0,20,1
1668173614646,COGS 210B,001,101404,Greene; Deanna Jacquelyn,9998,0,9999,1
1668173614646,COGS 210B,002,101417,Xia; Haijun,9999,0,9999,0
1668173614646,COGS 210B,003,101422,Nitz; Douglas A.,9999,0,9999,0
1668173614646,COGS 210B,004,101423,Hollan; James D.,9998,0,9999,1
1668173614646,COGS 210B,005,101424,Deak; Gedeon O.,9998,0,9999,1
1668173614646,COGS 210B,006,101425,Rossano; Federico,9999,0,9999,0
1668173615105,COGS 211B,A00,101427,Coulson; Seana M,9996,0,9999,3
1668173615558,COGS 220,A00,101428,Hollan; James D.,0,0,25,25
1668173616008,COGS 229,A00,101429,Dow; Steven P,18,0,25,7
1668173617061,COGS 230,A00,101430,Klemmer; Scott R,12,0,17,5
1668173617716,COGS 234,A00,101431,Xia; Haijun,3,0,25,22
1668173618169,COGS 260,A00,101432,Kiyonaga; Anastasia,20,0,25,5
1668173618169,COGS 260,B00,101433,Kirsh; David Joel,16,0,25,9
1668173618620,CSE 202,A00,102371,Impagliazzo; Russell,0,0,0,0
1668173619070,CSE 203B,A01,102373,Cheng; Chung Kuan,0,0,0,0
1668173619523,CSE 208,A00,102374,Micciancio; Daniele,0,0,0,0
1668173620172,CSE 209A,A00,112895,Impagliazzo; Russell,0,0,15,15
1668173620622,CSE 209B,A00,108005,Bellare; Mihir,0,0,0,0
1668173621079,CSE 210,A00,113163,Coblenz; Michael J,0,0,0,0
1668173621529,CSE 219,A00,106111,Dow; Steven P,0,0,20,20
1668173622146,CSE 221,A00,102376,Voelker; Geoffrey M.,0,0,0,0
1668173622801,CSE 224,A01,102378,Porter; George M,0,0,0,0
1668173623252,CSE 229A,A00,102379,Savage; Stefan,0,0,0,0
1668173623701,CSE 229C,A00,102380,Munyaka; Imani N. S.,0,0,0,0
1668173624148,CSE 232B,A00,102382,Deutsch; Alin Bernard,0,0,0,0
1668173624604,CSE 234,A01,112904,Kumar; Arun Kumar,0,0,0,0
1668173625053,CSE 237A,A00,102383,Rosing; Tajana Simunic,0,0,0,0
1668173625502,CSE 239A,A00,102384,Deutsch; Alin Bernard,0,0,0,0
1668173626152,CSE 239B,A00,102385,Polikarpova; Nadezhda,0,0,0,0
1668173626605,CSE 240A,A00,102386,Pannuto; Patrick William,0,0,0,0
1668173627062,CSE 240B,A00,102387,Zhao; Jishen,0,0,0,0
1668173627515,CSE 241A,A00,106406,Kang; Mingu,0,0,0,0
1668173628595,CSE 249B,A00,102388,Kahng; Andrew Byun,0,0,8,8
1668173629124,CSE 251B,A01,102392,Cottrell; Garrison W,0,0,0,0
1668173629124,CSE 251B,A02,102393,Cottrell; Garrison W,0,0,0,0
1668173629570,CSE 252B,A00,102394,Ochoa; Benjamin Lawrence,0,0,0,0
1668173630023,CSE 257,A01,102396,Gao; Sicun,0,0,0,0
1668173630475,CSE 272,A00,102397,Li; Tzumao,0,0,0,0
1668173630926,CSE 274,A00,111323,Chern; Albert Ren-Haur,0,0,0,0
1668173631378,CSE 282,A00,102398,Pevzner; Pavel Arkadjevich,0,0,0,0
1668173631831,CSE 284,A00,114175,Gymrek; Melissa Ann,0,0,0,0
1668173633155,CSE 290,A00,102399,Chandraker; Manmohan Krishna,0,0,0,0
1668173633155,CSE 290,B00,102400,Vaccaro; Kristen Marie,0,0,25,25
1668173633155,CSE 290,C00,102414,Pannuto; Patrick William,0,0,25,25
1668173633155,CSE 290,D00,102427,Pevzner; Pavel Arkadjevich,0,0,0,0
1668173633155,CSE 290,E00,102429,Zhao; Jishen,0,0,0,0
1668173633155,CSE 290,F00,102436,Tullsen; Dean Michael,0,0,0,0
1668173633155,CSE 290,G00,102440,Christensen; Henrik I,0,0,20,20
1668173633724,CSE 291,A00,102443,Su; Hao,0,0,0,0
1668173633724,CSE 291,B00,102448,Polikarpova; Nadezhda,0,0,0,0
1668173633724,CSE 291,C00,102453,Vaccaro; Kristen Marie,0,0,0,0
1668173633724,CSE 291,D00,111343,Savage; Stefan,0,0,0,0
1668173633724,CSE 291,E00,116474,Claffy; Kimberly Claire,0,0,0,0
1668173633724,CSE 291,F00,116479,Pasquale; Joseph,0,0,0,0
1668173634528,CSE 293,001,119111,Bafna; Vineet,9999,0,9999,0
1668173634528,CSE 293,002,119118,Bellare; Mihir,9999,0,9999,0
1668173634528,CSE 293,003,119122,Berg-Kirkpatrick; Taylor D,9999,0,9999,0
1668173634528,CSE 293,004,119135,Christensen; Henrik I,9999,0,9999,0
1668173634528,CSE 293,005,119142,Cottrell; Garrison W,9999,0,9999,0
1668173634528,CSE 293,006,119146,Deutsch; Alin Bernard,9999,0,9999,0
1668173634528,CSE 293,007,119159,Esmaeilzadeh; Hadi,9999,0,9999,0
1668173634528,CSE 293,008,119166,Freund; Yoav,9999,0,9999,0
1668173634528,CSE 293,009,119170,Griswold; William G.,9999,0,9999,0
1668173634528,CSE 293,010,119183,Gymrek; Melissa Ann,9999,0,9999,0
1668173634528,CSE 293,011,119190,Heninger; Nadia A,9999,0,9999,0
1668173634528,CSE 293,012,119230,Impagliazzo; Russell,9999,0,9999,0
1668173634528,CSE 293,013,119232,Jhala; Ranjit,9999,0,9999,0
1668173634528,CSE 293,014,119233,Kahng; Andrew Byun,9999,0,9999,0
1668173634528,CSE 293,015,119298,Kane; Daniel Mertz,9999,0,9999,0
1668173634528,CSE 293,016,119299,Kriegman; David J,9999,0,9999,0
1668173634528,CSE 293,017,119300,Kumar; Arun Kumar,9999,0,9999,0
1668173634528,CSE 293,018,119301,Lerner; Sorin,9999,0,9999,0
1668173634528,CSE 293,019,119302,Lovett; Shachar,9999,0,9999,0
1668173634528,CSE 293,020,119303,McAuley; Julian John,9999,0,9999,0
1668173634528,CSE 293,021,119304,Micciancio; Daniele,9999,0,9999,0
1668173634528,CSE 293,022,119367,Orailoglu; Alex,9999,0,9999,0
1668173634528,CSE 293,023,119382,Paturi; Ramamohan,9999,0,9999,0
1668173634528,CSE 293,024,119404,Polikarpova; Nadezhda,9999,0,9999,0
1668173634528,CSE 293,025,119406,Politz; Joseph Gibbs,9999,0,9999,0
1668173634528,CSE 293,026,119411,Porter; George M,9999,0,9999,0
1668173634528,CSE 293,027,119414,Porter; Leonard Emerson,9999,0,9999,0
1668173634528,CSE 293,028,119416,Ramamoorthi; Ravi,9999,0,9999,0
1668173634528,CSE 293,029,119417,Sahoo; Debashis,9999,0,9999,0
1668173634528,CSE 293,030,119420,Saul; Lawrence,9999,0,9999,0
1668173634528,CSE 293,031,119421,Savage; Stefan,9999,0,9999,0
1668173634528,CSE 293,032,119425,Schulze; Jurgen P.,9999,0,9999,0
1668173634528,CSE 293,033,119426,Snoeren; Alex C.,9999,0,9999,0
1668173634528,CSE 293,034,119428,Shang; Jingbo,9999,0,9999,0
1668173634528,CSE 293,035,119430,Stefan; Deian,9999,0,9999,0
1668173634528,CSE 293,036,119431,Su; Hao,9999,0,9999,0
1668173634528,CSE 293,037,119433,Swanson; Steven James,9999,0,9999,0
1668173634528,CSE 293,038,119435,Tullsen; Dean Michael,9999,0,9999,0
1668173634528,CSE 293,039,119483,Voelker; Geoffrey M.,9999,0,9999,0
1668173634528,CSE 293,040,119537,Zhao; Jishen,9999,0,9999,0
1668173634528,CSE 293,041,119538,Zhou; Yuan-Yuan,9999,0,9999,0
1668173634528,CSE 293,042,119539,Gao; Sicun,9999,0,9999,0
1668173634528,CSE 293,043,119540,Weibel; Nadir,9999,0,9999,0
1668173634528,CSE 293,044,119541,Gupta; Rajesh K.,9999,0,9999,0
1668173634528,CSE 293,045,126410,Vaccaro; Kristen Marie,9999,0,9999,0
1668173634528,CSE 293,046,126411,Klemke; Richard,9999,0,9999,0
1668173634977,CSE 294,A00,102459,Voelker; Geoffrey M.,0,0,0,0
1668173634977,CSE 294,B00,111322,Orailoglu; Alex,0,0,0,0
1668173635432,DSE 201,A00,096914,Deutsch; Alin Bernard,30,0,30,0
1668173636083,DSE 210,A00,096915,Dasgupta; Sanjoy,30,0,30,0
1668173636536,DSE 260A,A00,096916,Altintas De Callaf; Ilkay,30,0,30,0
1668173638362,ECE 200,001,103586,Antipa; Nicholas A,9999,0,9999,0
1668173638362,ECE 200,002,103587,Atanasov; Nikolay A.,9999,0,9999,0
1668173638362,ECE 200,003,103588,Bharadia; Dinesh,9999,0,9999,0
1668173638362,ECE 200,004,103589,Cheng; Chung Kuan,9999,0,9999,0
1668173638362,ECE 200,005,103590,Cosman; Pamela C.,9999,0,9999,0
1668173638362,ECE 200,006,103591,Dayeh; Shadi Ahmad,9999,0,9999,0
1668173638362,ECE 200,007,103592,Fainman; Yeshaiahu,9999,0,9999,0
1668173638362,ECE 200,008,103593,Ford; Joseph Earl,9999,0,9999,0
1668173638362,ECE 200,009,103594,Franceschetti; Massimo,9999,0,9999,0
1668173638362,ECE 200,010,103595,Fullerton; Eric E,9999,0,9999,0
1668173638362,ECE 200,011,103596,Galton; Ian A,9999,0,9999,0
1668173638362,ECE 200,012,103597,Gilja; Vikash,9999,0,9999,0
1668173638362,ECE 200,013,103598,Hall; Drew A.,9999,0,9999,0
1668173638362,ECE 200,014,103599,Hsueh; Tzu-Chien,9999,0,9999,0
1668173638362,ECE 200,015,103600,Javidi; Tara,9999,0,9999,0
1668173638362,ECE 200,016,103601,Kahng; Andrew Byun,9999,0,9999,0
1668173638362,ECE 200,017,103602,Kim; Young-Han,9999,0,9999,0
1668173638362,ECE 200,018,103603,Koushanfar; Farinaz,9999,0,9999,0
1668173638362,ECE 200,019,103604,Kuzum; Duygu,9999,0,9999,0
1668173638362,ECE 200,020,103605,Le; Hanh-Phuc,9999,0,9999,0
1668173638362,ECE 200,021,103606,Lin; Bill,9999,0,9999,0
1668173638362,ECE 200,022,103607,Liu; Zhaowei,9998,0,9999,1
1668173638362,ECE 200,023,103608,Lo; Yu-Hwa,9999,0,9999,0
1668173638362,ECE 200,024,103609,Lomakin; Vitaliy,9999,0,9999,0
1668173638362,ECE 200,025,103610,Mercier; Patrick Philip,9999,0,9999,0
1668173638362,ECE 200,026,103611,Meyer; Florian,9999,0,9999,0
1668173638362,ECE 200,027,103612,Milstein; Laurence B.,9999,0,9999,0
1668173638362,ECE 200,028,103613,Mir Arabbaygi; Siavash,9999,0,9999,0
1668173638362,ECE 200,029,103614,Mookherjea; Shayan,9999,0,9999,0
1668173638362,ECE 200,030,103615,Morris; Karcher William,9999,0,9999,0
1668173638362,ECE 200,031,103616,Ng; Tse Nga,9999,0,9999,0
1668173638362,ECE 200,032,103617,Nguyen; Truong Quang,9999,0,9999,0
1668173638362,ECE 200,033,103618,Nomura; Kenji,9999,0,9999,0
1668173638362,ECE 200,034,103619,Orlitsky; Alon,9999,0,9999,0
1668173638362,ECE 200,035,103620,Pal; Piya,9999,0,9999,0
1668173638362,ECE 200,036,103621,Papen; George C.,9999,0,9999,0
1668173638362,ECE 200,037,103622,Radic; Stojan,9999,0,9999,0
1668173638362,ECE 200,038,103623,Rao; Bhaskar D.,9999,0,9999,0
1668173638362,ECE 200,039,103624,Rao; Ramesh R,9999,0,9999,0
1668173638362,ECE 200,040,103625,Rebeiz; Gabriel,9999,0,9999,0
1668173638362,ECE 200,041,103626,Sanford; John R,9999,0,9999,0
1668173638362,ECE 200,042,103627,Siegel; Paul H.,9999,0,9999,0
1668173638362,ECE 200,043,103628,Sievenpiper; Daniel F.,9999,0,9999,0
1668173638362,ECE 200,044,103629,Sworder; David D.,9999,0,9999,0
1668173638362,ECE 200,045,103630,Taur; Yuan,9999,0,9999,0
1668173638362,ECE 200,046,103631,Touri; Behrouz,9999,0,9999,0
1668173638362,ECE 200,047,103632,Trivedi; Mohan M.,9999,0,9999,0
1668173638362,ECE 200,048,103633,Vasconcelos; Nuno,9999,0,9999,0
1668173638362,ECE 200,049,103634,Wang; Xiaolong,9999,0,9999,0
1668173638362,ECE 200,050,103635,Xie; Pengtao,9999,0,9999,0
1668173638362,ECE 200,051,103636,Yip; Michael,9999,0,9999,0
1668173638362,ECE 200,052,103637,Zeger; Kenneth A.,999,0,999,0
1668173638362,ECE 200,053,103638,Zhang; Xinyu,9999,0,9999,0
1668173638362,ECE 200,054,103639,Turakhia; Yatish Girish,9999,0,9999,0
1668173638362,ECE 200,055,103640,Kang; Mingu,9999,0,9999,0
1668173638362,ECE 200,056,103641,Shi; Yuanyuan,9999,0,9999,0
1668173638362,ECE 200,057,103642,Wang; Edward Jay,9999,0,9999,0
1668173638362,ECE 200,058,103643,Zheng; Yang,9999,0,9999,0
1668173638815,ECE 202,A00,103644,Kuzum; Duygu,0,0,0,0
1668173639266,ECE 212BN,A00,103646,Ng; Tse Nga,0,0,0,0
1668173639722,ECE 221,A00,111493,Staff,0,0,0,0
1668173640176,ECE 222B,A00,103647,Lomakin; Vitaliy,0,0,0,0
1668173641660,ECE 230B,A00,103648,Taur; Yuan,0,0,0,0
1668173642118,ECE 238B,A00,103649,Garay; Javier,0,0,0,0
1668173642566,ECE 240B,A00,112900,Fainman; Yeshaiahu,0,0,0,0
1668173643025,ECE 247A,A00,103650,Jokerst; Jesse Vincent,0,0,0,0
1668173643480,ECE 247B,A00,103651,Wang; Joseph,0,0,0,0
1668173643930,ECE 250,A00,103652,Siegel; Paul H.,0,0,0,0
1668173644380,ECE 251A,A00,103654,Rao; Bhaskar D.,0,0,0,0
1668173644833,ECE 257B,A00,103655,Bharadia; Dinesh,0,0,0,0
1668173645280,ECE 258A,A00,103656,Milstein; Laurence B.,0,0,0,0
1668173645729,ECE 260B,A00,103658,Kang; Mingu,0,0,0,0
1668173646182,ECE 264A,A00,103659,Galton; Ian A,0,0,0,0
1668173646635,ECE 265A,A00,103661,Gudem; Prasad S.S.,0,0,0,0
1668173647391,ECE 265D,A00,103662,Gudem; Prasad S.S.,0,0,0,0
1668173647840,ECE 268,A00,103663,Koushanfar; Farinaz,0,0,0,0
1668173648290,ECE 269,A01,103665,Pal; Piya,0,0,0,0
1668173648944,ECE 271B,A00,103666,Vasconcelos; Manuela,0,0,0,0
1668173649393,ECE 276A,A00,103667,Atanasov; Nikolay A.,0,0,0,0
1668173649840,ECE 277,A00,103668,An; Cheolhong,0,0,0,0
1668173650290,ECE 279,A00,117947,Hall; Drew A.,0,0,0,0
1668173651190,ECE 283,A00,103670,Hsueh; Tzu-Chien,0,0,0,0
1668173651639,ECE 284,A00,103671,Turakhia; Yatish Girish,0,0,0,0
1668173652095,ECE 285,A00,103672,Zheng; Yang,0,0,0,0
1668173652095,ECE 285,B00,103673,Sworder; David D.,0,0,0,0
1668173652544,ECE 287,A00,103676,Javidi; Tara,0,0,0,0
1668173652999,MATH 200B,A00,098023,Salehi Golsefidy; Alireza,12,0,15,3
1668173653448,MATH 202B,A00,098024,Rhoades; Brendon Patrick,9,0,15,6
1668173653900,MATH 203B,A00,098025,Oprea; Dragos N.,10,0,15,5
1668173654555,MATH 204B,A00,098026,Sorensen; Claus M,13,0,15,2
1668173655005,MATH 208,A00,098027,Izadi; Elham,7,0,10,3
1668173655454,MATH 209,A00,098028,Pollack; Aaron,10,0,10,0
1668173655903,MATH 211A,A00,112919,Rogalski; Daniel,9,0,10,1
1668173656555,MATH 211B,A00,112920,Seward; Brandon M.,9,0,10,1
1668173657006,MATH 218,A00,098029,Li; Bo,10,0,10,0
1668173657456,MATH 220B,A00,098030,Novak; Jonathan I,11,0,15,4
1668173658115,MATH 221A,A00,098031,Ebenfelt; Peter F,13,0,15,2
1668173658562,MATH 231B,A00,098032,Zlatos; Andrej,12,0,15,3
1668173659016,MATH 240B,A00,098033,Ni; Lei,9,0,15,6
1668173659462,MATH 243,A00,098034,Jekel; David Andrew,10,0,10,0
1668173659915,MATH 245A,A00,098035,Nie; Jiawang,0,0,15,16
1668173660645,MATH 248,A00,098036,Bejenaru; Ioan,10,0,10,0
1668173661094,MATH 250B,A00,098037,Spolaor; Luca,14,0,15,1
1668173661547,MATH 258,A00,098038,Ni; Lei,10,0,10,0
1668173661997,MATH 264B,A00,098041,Rhoades; Brendon Patrick,9,0,15,6
1668173662448,MATH 268,A00,098042,Buss; Samuel R,10,0,10,0
1668173662897,MATH 269,A00,098043,Rhoades; Brendon Patrick,10,0,10,0
1668173663346,MATH 270B,A00,098044,Li; Bo,10,0,15,5
1668173664000,MATH 272B,A00,098045,Holst; Michael J,13,0,15,2
1668173664652,MATH 273A,A00,098046,Tian; Xiaochuan,10,0,15,5
1668173666020,MATH 275,A01,098048,Tian; Xiaochuan,6,0,10,4
1668173666474,MATH 278A,A00,098049,Holst; Michael J,8,0,10,2
1668173666925,MATH 278B,A00,098050,Cloninger; Alexander,10,0,10,0
1668173667373,MATH 278C,A00,098051,Nie; Jiawang,7,0,10,3
1668173668028,MATH 280B,A00,098052,Zheng; Tianyi,10,0,15,5
1668173668478,MATH 281B,A00,098053,Bradic; Jelena,2,0,15,13
1668173668929,MATH 282B,A00,098054,Arias-Castro; Ery,0,0,15,15
1668173669390,MATH 285,A00,098055,Fitzsimmons; Patrick J,0,0,15,17
1668173669838,MATH 287B,A00,098056,Arias-Castro; Ery,2,0,15,13
1668173670291,MATH 288,A00,098057,Agarwal; Pooja,9,0,10,1
1668173670291,MATH 288,B00,098058,Zhang; Danna,8,0,10,2
1668173670291,MATH 288,C00,098059,Williams; Ruth J,10,0,10,0
1668173670740,MATH 290B,A00,098060,Roberts; Justin Deritter,13,0,15,2
1668173671187,MATH 292,A00,098061,Belmont; Eva Kinoshita,10,0,10,0
1668173671634,MATH 295,A00,098062,Suk; Andrew Hoon,48,0,50,2
1668173672082,MATH 296,A00,098063,Novak; Jonathan I,20,0,20,0
1668173672540,MATH 297,001,098064,Gamst; Anthony Collins,9997,0,9999,2
1668174194155,COGS 205,A00,101395,Chiba; Andrea,19,0,20,1
1668174194589,COGS 210B,001,101404,Greene; Deanna Jacquelyn,9998,0,9999,1
1668174194589,COGS 210B,002,101417,Xia; Haijun,9999,0,9999,0
1668174194589,COGS 210B,003,101422,Nitz; Douglas A.,9999,0,9999,0
1668174194589,COGS 210B,004,101423,Hollan; James D.,9998,0,9999,1
1668174194589,COGS 210B,005,101424,Deak; Gedeon O.,9998,0,9999,1
1668174194589,COGS 210B,006,101425,Rossano; Federico,9999,0,9999,0
1668174195022,COGS 211B,A00,101427,Coulson; Seana M,9996,0,9999,3
1668174195447,COGS 220,A00,101428,Hollan; James D.,0,0,25,25
1668174195869,COGS 229,A00,101429,Dow; Steven P,18,0,25,7
1668174196295,COGS 230,A00,101430,Klemmer; Scott R,12,0,17,5
1668174196723,COGS 234,A00,101431,Xia; Haijun,3,0,25,22
1668174197157,COGS 260,A00,101432,Kiyonaga; Anastasia,20,0,25,5
1668174197157,COGS 260,B00,101433,Kirsh; David Joel,16,0,25,9
1668174197586,CSE 202,A00,102371,Impagliazzo; Russell,0,0,0,0
1668174198011,CSE 203B,A01,102373,Cheng; Chung Kuan,0,0,0,0
1668174198436,CSE 208,A00,102374,Micciancio; Daniele,0,0,0,0
1668174198861,CSE 209A,A00,112895,Impagliazzo; Russell,0,0,15,15
1668174199284,CSE 209B,A00,108005,Bellare; Mihir,0,0,0,0
1668174199717,CSE 210,A00,113163,Coblenz; Michael J,0,0,0,0
1668174200144,CSE 219,A00,106111,Dow; Steven P,0,0,20,20
1668174200576,CSE 221,A00,102376,Voelker; Geoffrey M.,0,0,0,0
1668174201007,CSE 224,A01,102378,Porter; George M,0,0,0,0
1668174201431,CSE 229A,A00,102379,Savage; Stefan,0,0,0,0
1668174201856,CSE 229C,A00,102380,Munyaka; Imani N. S.,0,0,0,0
1668174202285,CSE 232B,A00,102382,Deutsch; Alin Bernard,0,0,0,0
1668174202714,CSE 234,A01,112904,Kumar; Arun Kumar,0,0,0,0
1668174203154,CSE 237A,A00,102383,Rosing; Tajana Simunic,0,0,0,0
1668174203577,CSE 239A,A00,102384,Deutsch; Alin Bernard,0,0,0,0
1668174204003,CSE 239B,A00,102385,Polikarpova; Nadezhda,0,0,0,0
1668174204427,CSE 240A,A00,102386,Pannuto; Patrick William,0,0,0,0
1668174204858,CSE 240B,A00,102387,Zhao; Jishen,0,0,0,0
1668174205284,CSE 241A,A00,106406,Kang; Mingu,0,0,0,0
1668174205710,CSE 249B,A00,102388,Kahng; Andrew Byun,0,0,8,8
1668174206137,CSE 251B,A01,102392,Cottrell; Garrison W,0,0,0,0
1668174206137,CSE 251B,A02,102393,Cottrell; Garrison W,0,0,0,0
1668174206562,CSE 252B,A00,102394,Ochoa; Benjamin Lawrence,0,0,0,0
1668174206990,CSE 257,A01,102396,Gao; Sicun,0,0,0,0
1668174207417,CSE 272,A00,102397,Li; Tzumao,0,0,0,0
1668174207841,CSE 274,A00,111323,Chern; Albert Ren-Haur,0,0,0,0
1668174208267,CSE 282,A00,102398,Pevzner; Pavel Arkadjevich,0,0,0,0
1668174208692,CSE 284,A00,114175,Gymrek; Melissa Ann,0,0,0,0
1668174209122,CSE 290,A00,102399,Chandraker; Manmohan Krishna,0,0,0,0
1668174209122,CSE 290,B00,102400,Vaccaro; Kristen Marie,0,0,25,25
1668174209122,CSE 290,C00,102414,Pannuto; Patrick William,0,0,25,25
1668174209122,CSE 290,D00,102427,Pevzner; Pavel Arkadjevich,0,0,0,0
1668174209122,CSE 290,E00,102429,Zhao; Jishen,0,0,0,0
1668174209122,CSE 290,F00,102436,Tullsen; Dean Michael,0,0,0,0
1668174209122,CSE 290,G00,102440,Christensen; Henrik I,0,0,20,20
1668174209549,CSE 291,A00,102443,Su; Hao,0,0,0,0
1668174209549,CSE 291,B00,102448,Polikarpova; Nadezhda,0,0,0,0
1668174209549,CSE 291,C00,102453,Vaccaro; Kristen Marie,0,0,0,0
1668174209549,CSE 291,D00,111343,Savage; Stefan,0,0,0,0
1668174209549,CSE 291,E00,116474,Claffy; Kimberly Claire,0,0,0,0
1668174209549,CSE 291,F00,116479,Pasquale; Joseph,0,0,0,0
1668174210037,CSE 293,001,119111,Bafna; Vineet,9999,0,9999,0
1668174210037,CSE 293,002,119118,Bellare; Mihir,9999,0,9999,0
1668174210037,CSE 293,003,119122,Berg-Kirkpatrick; Taylor D,9999,0,9999,0
1668174210037,CSE 293,004,119135,Christensen; Henrik I,9999,0,9999,0
1668174210037,CSE 293,005,119142,Cottrell; Garrison W,9999,0,9999,0
1668174210037,CSE 293,006,119146,Deutsch; Alin Bernard,9999,0,9999,0
1668174210037,CSE 293,007,119159,Esmaeilzadeh; Hadi,9999,0,9999,0
1668174210037,CSE 293,008,119166,Freund; Yoav,9999,0,9999,0
1668174210037,CSE 293,009,119170,Griswold; William G.,9999,0,9999,0
1668174210037,CSE 293,010,119183,Gymrek; Melissa Ann,9999,0,9999,0
1668174210037,CSE 293,011,119190,Heninger; Nadia A,9999,0,9999,0
1668174210037,CSE 293,012,119230,Impagliazzo; Russell,9999,0,9999,0
1668174210037,CSE 293,013,119232,Jhala; Ranjit,9999,0,9999,0
1668174210037,CSE 293,014,119233,Kahng; Andrew Byun,9999,0,9999,0
1668174210037,CSE 293,015,119298,Kane; Daniel Mertz,9999,0,9999,0
1668174210037,CSE 293,016,119299,Kriegman; David J,9999,0,9999,0
1668174210037,CSE 293,017,119300,Kumar; Arun Kumar,9999,0,9999,0
1668174210037,CSE 293,018,119301,Lerner; Sorin,9999,0,9999,0
1668174210037,CSE 293,019,119302,Lovett; Shachar,9999,0,9999,0
1668174210037,CSE 293,020,119303,McAuley; Julian John,9999,0,9999,0
1668174210037,CSE 293,021,119304,Micciancio; Daniele,9999,0,9999,0
1668174210037,CSE 293,022,119367,Orailoglu; Alex,9999,0,9999,0
1668174210037,CSE 293,023,119382,Paturi; Ramamohan,9999,0,9999,0
1668174210037,CSE 293,024,119404,Polikarpova; Nadezhda,9999,0,9999,0
1668174210037,CSE 293,025,119406,Politz; Joseph Gibbs,9999,0,9999,0
1668174210037,CSE 293,026,119411,Porter; George M,9999,0,9999,0
1668174210037,CSE 293,027,119414,Porter; Leonard Emerson,9999,0,9999,0
1668174210037,CSE 293,028,119416,Ramamoorthi; Ravi,9999,0,9999,0
1668174210037,CSE 293,029,119417,Sahoo; Debashis,9999,0,9999,0
1668174210037,CSE 293,030,119420,Saul; Lawrence,9999,0,9999,0
1668174210037,CSE 293,031,119421,Savage; Stefan,9999,0,9999,0
1668174210037,CSE 293,032,119425,Schulze; Jurgen P.,9999,0,9999,0
1668174210037,CSE 293,033,119426,Snoeren; Alex C.,9999,0,9999,0
1668174210037,CSE 293,034,119428,Shang; Jingbo,9999,0,9999,0
1668174210037,CSE 293,035,119430,Stefan; Deian,9999,0,9999,0
1668174210037,CSE 293,036,119431,Su; Hao,9999,0,9999,0
1668174210037,CSE 293,037,119433,Swanson; Steven James,9999,0,9999,0
1668174210037,CSE 293,038,119435,Tullsen; Dean Michael,9999,0,9999,0
1668174210037,CSE 293,039,119483,Voelker; Geoffrey M.,9999,0,9999,0
1668174210037,CSE 293,040,119537,Zhao; Jishen,9999,0,9999,0
1668174210037,CSE 293,041,119538,Zhou; Yuan-Yuan,9999,0,9999,0
1668174210037,CSE 293,042,119539,Gao; Sicun,9999,0,9999,0
1668174210037,CSE 293,043,119540,Weibel; Nadir,9999,0,9999,0
1668174210037,CSE 293,044,119541,Gupta; Rajesh K.,9999,0,9999,0
1668174210037,CSE 293,045,126410,Vaccaro; Kristen Marie,9999,0,9999,0
1668174210037,CSE 293,046,126411,Klemke; Richard,9999,0,9999,0
1668174210478,CSE 294,A00,102459,Voelker; Geoffrey M.,0,0,0,0
1668174210478,CSE 294,B00,111322,Orailoglu; Alex,0,0,0,0
1668174210903,DSE 201,A00,096914,Deutsch; Alin Bernard,30,0,30,0
1668174211327,DSE 210,A00,096915,Dasgupta; Sanjoy,30,0,30,0
1668174211751,DSE 260A,A00,096916,Altintas De Callaf; Ilkay,30,0,30,0
1668174212208,ECE 200,001,103586,Antipa; Nicholas A,9999,0,9999,0
1668174212208,ECE 200,002,103587,Atanasov; Nikolay A.,9999,0,9999,0
1668174212208,ECE 200,003,103588,Bharadia; Dinesh,9999,0,9999,0
1668174212208,ECE 200,004,103589,Cheng; Chung Kuan,9999,0,9999,0
1668174212208,ECE 200,005,103590,Cosman; Pamela C.,9999,0,9999,0
1668174212208,ECE 200,006,103591,Dayeh; Shadi Ahmad,9999,0,9999,0
1668174212208,ECE 200,007,103592,Fainman; Yeshaiahu,9999,0,9999,0
1668174212208,ECE 200,008,103593,Ford; Joseph Earl,9999,0,9999,0
1668174212208,ECE 200,009,103594,Franceschetti; Massimo,9999,0,9999,0
1668174212208,ECE 200,010,103595,Fullerton; Eric E,9999,0,9999,0
1668174212208,ECE 200,011,103596,Galton; Ian A,9999,0,9999,0
1668174212208,ECE 200,012,103597,Gilja; Vikash,9999,0,9999,0
1668174212208,ECE 200,013,103598,Hall; Drew A.,9999,0,9999,0
1668174212208,ECE 200,014,103599,Hsueh; Tzu-Chien,9999,0,9999,0
1668174212208,ECE 200,015,103600,Javidi; Tara,9999,0,9999,0
1668174212208,ECE 200,016,103601,Kahng; Andrew Byun,9999,0,9999,0
1668174212208,ECE 200,017,103602,Kim; Young-Han,9999,0,9999,0
1668174212208,ECE 200,018,103603,Koushanfar; Farinaz,9999,0,9999,0
1668174212208,ECE 200,019,103604,Kuzum; Duygu,9999,0,9999,0
1668174212208,ECE 200,020,103605,Le; Hanh-Phuc,9999,0,9999,0
1668174212208,ECE 200,021,103606,Lin; Bill,9999,0,9999,0
1668174212208,ECE 200,022,103607,Liu; Zhaowei,9998,0,9999,1
1668174212208,ECE 200,023,103608,Lo; Yu-Hwa,9999,0,9999,0
1668174212208,ECE 200,024,103609,Lomakin; Vitaliy,9999,0,9999,0
1668174212208,ECE 200,025,103610,Mercier; Patrick Philip,9999,0,9999,0
1668174212208,ECE 200,026,103611,Meyer; Florian,9999,0,9999,0
1668174212208,ECE 200,027,103612,Milstein; Laurence B.,9999,0,9999,0
1668174212208,ECE 200,028,103613,Mir Arabbaygi; Siavash,9999,0,9999,0
1668174212208,ECE 200,029,103614,Mookherjea; Shayan,9999,0,9999,0
1668174212208,ECE 200,030,103615,Morris; Karcher William,9999,0,9999,0
1668174212208,ECE 200,031,103616,Ng; Tse Nga,9999,0,9999,0
1668174212208,ECE 200,032,103617,Nguyen; Truong Quang,9999,0,9999,0
1668174212208,ECE 200,033,103618,Nomura; Kenji,9999,0,9999,0
1668174212208,ECE 200,034,103619,Orlitsky; Alon,9999,0,9999,0
1668174212208,ECE 200,035,103620,Pal; Piya,9999,0,9999,0
1668174212208,ECE 200,036,103621,Papen; George C.,9999,0,9999,0
1668174212208,ECE 200,037,103622,Radic; Stojan,9999,0,9999,0
1668174212208,ECE 200,038,103623,Rao; Bhaskar D.,9999,0,9999,0
1668174212208,ECE 200,039,103624,Rao; Ramesh R,9999,0,9999,0
1668174212208,ECE 200,040,103625,Rebeiz; Gabriel,9999,0,9999,0
1668174212208,ECE 200,041,103626,Sanford; John R,9999,0,9999,0
1668174212208,ECE 200,042,103627,Siegel; Paul H.,9999,0,9999,0
1668174212208,ECE 200,043,103628,Sievenpiper; Daniel F.,9999,0,9999,0
1668174212208,ECE 200,044,103629,Sworder; David D.,9999,0,9999,0
1668174212208,ECE 200,045,103630,Taur; Yuan,9999,0,9999,0
1668174212208,ECE 200,046,103631,Touri; Behrouz,9999,0,9999,0
1668174212208,ECE 200,047,103632,Trivedi; Mohan M.,9999,0,9999,0
1668174212208,ECE 200,048,103633,Vasconcelos; Nuno,9999,0,9999,0
1668174212208,ECE 200,049,103634,Wang; Xiaolong,9999,0,9999,0
1668174212208,ECE 200,050,103635,Xie; Pengtao,9999,0,9999,0
1668174212208,ECE 200,051,103636,Yip; Michael,9999,0,9999,0
1668174212208,ECE 200,052,103637,Zeger; Kenneth A.,999,0,999,0
1668174212208,ECE 200,053,103638,Zhang; Xinyu,9999,0,9999,0
1668174212208,ECE 200,054,103639,Turakhia; Yatish Girish,9999,0,9999,0
1668174212208,ECE 200,055,103640,Kang; Mingu,9999,0,9999,0
1668174212208,ECE 200,056,103641,Shi; Yuanyuan,9999,0,9999,0
1668174212208,ECE 200,057,103642,Wang; Edward Jay,9999,0,9999,0
1668174212208,ECE 200,058,103643,Zheng; Yang,9999,0,9999,0
1668174212636,ECE 202,A00,103644,Kuzum; Duygu,0,0,0,0
1668174213063,ECE 212BN,A00,103646,Ng; Tse Nga,0,0,0,0
1668174213492,ECE 221,A00,111493,Staff,0,0,0,0
1668174213918,ECE 222B,A00,103647,Lomakin; Vitaliy,0,0,0,0
1668174214348,ECE 230B,A00,103648,Taur; Yuan,0,0,0,0
1668174214774,ECE 238B,A00,103649,Garay; Javier,0,0,0,0
1668174215201,ECE 240B,A00,112900,Fainman; Yeshaiahu,0,0,0,0
1668174215627,ECE 247A,A00,103650,Jokerst; Jesse Vincent,0,0,0,0
1668174216057,ECE 247B,A00,103651,Wang; Joseph,0,0,0,0
1668174216486,ECE 250,A00,103652,Siegel; Paul H.,0,0,0,0
1668174216911,ECE 251A,A00,103654,Rao; Bhaskar D.,0,0,0,0
1668174217428,ECE 257B,A00,103655,Bharadia; Dinesh,0,0,0,0
1668174217853,ECE 258A,A00,103656,Milstein; Laurence B.,0,0,0,0
1668174218280,ECE 260B,A00,103658,Kang; Mingu,0,0,0,0
1668174218709,ECE 264A,A00,103659,Galton; Ian A,0,0,0,0
1668174219134,ECE 265A,A00,103661,Gudem; Prasad S.S.,0,0,0,0
1668174219558,ECE 265D,A00,103662,Gudem; Prasad S.S.,0,0,0,0
1668174219982,ECE 268,A00,103663,Koushanfar; Farinaz,0,0,0,0
1668174220406,ECE 269,A01,103665,Pal; Piya,0,0,0,0
1668174220829,ECE 271B,A00,103666,Vasconcelos; Manuela,0,0,0,0
1668174221259,ECE 276A,A00,103667,Atanasov; Nikolay A.,0,0,0,0
1668174221689,ECE 277,A00,103668,An; Cheolhong,0,0,0,0
1668174222118,ECE 279,A00,117947,Hall; Drew A.,0,0,0,0
1668174222969,ECE 283,A00,103670,Hsueh; Tzu-Chien,0,0,0,0
1668174223393,ECE 284,A00,103671,Turakhia; Yatish Girish,0,0,0,0
1668174223822,ECE 285,A00,103672,Zheng; Yang,0,0,0,0
1668174223822,ECE 285,B00,103673,Sworder; David D.,0,0,0,0
1668174224254,ECE 287,A00,103676,Javidi; Tara,0,0,0,0
1668174224680,MATH 200B,A00,098023,Salehi Golsefidy; Alireza,12,0,15,3
1668174225118,MATH 202B,A00,098024,Rhoades; Brendon Patrick,9,0,15,6
1668174225540,MATH 203B,A00,098025,Oprea; Dragos N.,10,0,15,5
1668174225970,MATH 204B,A00,098026,Sorensen; Claus M,13,0,15,2
1668174226397,MATH 208,A00,098027,Izadi; Elham,7,0,10,3
1668174226822,MATH 209,A00,098028,Pollack; Aaron,10,0,10,0
1668174227246,MATH 211A,A00,112919,Rogalski; Daniel,9,0,10,1
1668174227672,MATH 211B,A00,112920,Seward; Brandon M.,9,0,10,1
1668174228099,MATH 218,A00,098029,Li; Bo,10,0,10,0
1668174228525,MATH 220B,A00,098030,Novak; Jonathan I,11,0,15,4
1668174228953,MATH 221A,A00,098031,Ebenfelt; Peter F,13,0,15,2
1668174229381,MATH 231B,A00,098032,Zlatos; Andrej,12,0,15,3
1668174229807,MATH 240B,A00,098033,Ni; Lei,9,0,15,6
1668174230236,MATH 243,A00,098034,Jekel; David Andrew,10,0,10,0
1668174230669,MATH 245A,A00,098035,Nie; Jiawang,0,0,15,16
1668174231095,MATH 248,A00,098036,Bejenaru; Ioan,10,0,10,0
1668174231525,MATH 250B,A00,098037,Spolaor; Luca,14,0,15,1
1668174231951,MATH 258,A00,098038,Ni; Lei,10,0,10,0
1668174232375,MATH 264B,A00,098041,Rhoades; Brendon Patrick,9,0,15,6
1668174232797,MATH 268,A00,098042,Buss; Samuel R,10,0,10,0
1668174233224,MATH 269,A00,098043,Rhoades; Brendon Patrick,10,0,10,0
1668174233648,MATH 270B,A00,098044,Li; Bo,10,0,15,5
1668174234078,MATH 272B,A00,098045,Holst; Michael J,13,0,15,2
1668174234509,MATH 273A,A00,098046,Tian; Xiaochuan,10,0,15,5
1668174234933,MATH 275,A01,098048,Tian; Xiaochuan,6,0,10,4
1668174235357,MATH 278A,A00,098049,Holst; Michael J,8,0,10,2
1668174235783,MATH 278B,A00,098050,Cloninger; Alexander,10,0,10,0
1668174236212,MATH 278C,A00,098051,Nie; Jiawang,7,0,10,3
1668174236641,MATH 280B,A00,098052,Zheng; Tianyi,10,0,15,5
1668174237067,MATH 281B,A00,098053,Bradic; Jelena,2,0,15,13
1668174237491,MATH 282B,A00,098054,Arias-Castro; Ery,0,0,15,15
1668174237915,MATH 285,A00,098055,Fitzsimmons; Patrick J,0,0,15,17
1668174238339,MATH 287B,A00,098056,Arias-Castro; Ery,2,0,15,13
1668174238765,MATH 288,A00,098057,Agarwal; Pooja,9,0,10,1
1668174238765,MATH 288,B00,098058,Zhang; Danna,8,0,10,2
1668174238765,MATH 288,C00,098059,Williams; Ruth J,10,0,10,0
1668174239191,MATH 290B,A00,098060,Roberts; Justin Deritter,13,0,15,2
1668174239615,MATH 292,A00,098061,Belmont; Eva Kinoshita,10,0,10,0
1668174240041,MATH 295,A00,098062,Suk; Andrew Hoon,48,0,50,2
1668174240475,MATH 296,A00,098063,Novak; Jonathan I,20,0,20,0
1668174240915,MATH 297,001,098064,Gamst; Anthony Collins,9997,0,9999,2
1668174742605,COGS 205,A00,101395,Chiba; Andrea,19,0,20,1
1668174743037,COGS 210B,001,101404,Greene; Deanna Jacquelyn,9998,0,9999,1
1668174743037,COGS 210B,002,101417,Xia; Haijun,9999,0,9999,0
1668174743037,COGS 210B,003,101422,Nitz; Douglas A.,9999,0,9999,0
1668174743037,COGS 210B,004,101423,Hollan; James D.,9998,0,9999,1
1668174743037,COGS 210B,005,101424,Deak; Gedeon O.,9998,0,9999,1
1668174743037,COGS 210B,006,101425,Rossano; Federico,9999,0,9999,0
1668174743462,COGS 211B,A00,101427,Coulson; Seana M,9996,0,9999,3
1668174743890,COGS 220,A00,101428,Hollan; James D.,0,0,25,25
1668174744315,COGS 229,A00,101429,Dow; Steven P,18,0,25,7
1668174744738,COGS 230,A00,101430,Klemmer; Scott R,12,0,17,5
1668174745162,COGS 234,A00,101431,Xia; Haijun,3,0,25,22
1668174745589,COGS 260,A00,101432,Kiyonaga; Anastasia,20,0,25,5
1668174745589,COGS 260,B00,101433,Kirsh; David Joel,16,0,25,9
1668174746019,CSE 202,A00,102371,Impagliazzo; Russell,0,0,0,0
1668174746448,CSE 203B,A01,102373,Cheng; Chung Kuan,0,0,0,0
1668174746875,CSE 208,A00,102374,Micciancio; Daniele,0,0,0,0
1668174747299,CSE 209A,A00,112895,Impagliazzo; Russell,0,0,15,15
1668174747734,CSE 209B,A00,108005,Bellare; Mihir,0,0,0,0
1668174748170,CSE 210,A00,113163,Coblenz; Michael J,0,0,0,0
1668174748601,CSE 219,A00,106111,Dow; Steven P,0,0,20,20
1668174749026,CSE 221,A00,102376,Voelker; Geoffrey M.,0,0,0,0
1668174749455,CSE 224,A01,102378,Porter; George M,0,0,0,0
1668174749885,CSE 229A,A00,102379,Savage; Stefan,0,0,0,0
1668174750326,CSE 229C,A00,102380,Munyaka; Imani N. S.,0,0,0,0
1668174750757,CSE 232B,A00,102382,Deutsch; Alin Bernard,0,0,0,0
1668174751181,CSE 234,A01,112904,Kumar; Arun Kumar,0,0,0,0
1668174751604,CSE 237A,A00,102383,Rosing; Tajana Simunic,0,0,0,0
1668174752028,CSE 239A,A00,102384,Deutsch; Alin Bernard,0,0,0,0
1668174752455,CSE 239B,A00,102385,Polikarpova; Nadezhda,0,0,0,0
1668174752884,CSE 240A,A00,102386,Pannuto; Patrick William,0,0,0,0
1668174753308,CSE 240B,A00,102387,Zhao; Jishen,0,0,0,0
1668174753747,CSE 241A,A00,106406,Kang; Mingu,0,0,0,0
1668174754174,CSE 249B,A00,102388,Kahng; Andrew Byun,0,0,8,8
1668174754599,CSE 251B,A01,102392,Cottrell; Garrison W,0,0,0,0
1668174754599,CSE 251B,A02,102393,Cottrell; Garrison W,0,0,0,0
1668174755024,CSE 252B,A00,102394,Ochoa; Benjamin Lawrence,0,0,0,0
1668174755451,CSE 257,A01,102396,Gao; Sicun,0,0,0,0
1668174755889,CSE 272,A00,102397,Li; Tzumao,0,0,0,0
1668174756314,CSE 274,A00,111323,Chern; Albert Ren-Haur,0,0,0,0
1668174756740,CSE 282,A00,102398,Pevzner; Pavel Arkadjevich,0,0,0,0
1668174757165,CSE 284,A00,114175,Gymrek; Melissa Ann,0,0,0,0
1668174757591,CSE 290,A00,102399,Chandraker; Manmohan Krishna,0,0,0,0
1668174757591,CSE 290,B00,102400,Vaccaro; Kristen Marie,0,0,25,25
1668174757591,CSE 290,C00,102414,Pannuto; Patrick William,0,0,25,25
1668174757591,CSE 290,D00,102427,Pevzner; Pavel Arkadjevich,0,0,0,0
1668174757591,CSE 290,E00,102429,Zhao; Jishen,0,0,0,0
1668174757591,CSE 290,F00,102436,Tullsen; Dean Michael,0,0,0,0
1668174757591,CSE 290,G00,102440,Christensen; Henrik I,0,0,20,20
1668174758018,CSE 291,A00,102443,Su; Hao,0,0,0,0
1668174758018,CSE 291,B00,102448,Polikarpova; Nadezhda,0,0,0,0
1668174758018,CSE 291,C00,102453,Vaccaro; Kristen Marie,0,0,0,0
1668174758018,CSE 291,D00,111343,Savage; Stefan,0,0,0,0
1668174758018,CSE 291,E00,116474,Claffy; Kimberly Claire,0,0,0,0
1668174758018,CSE 291,F00,116479,Pasquale; Joseph,0,0,0,0
1668174758490,CSE 293,001,119111,Bafna; Vineet,9999,0,9999,0
1668174758490,CSE 293,002,119118,Bellare; Mihir,9999,0,9999,0
1668174758490,CSE 293,003,119122,Berg-Kirkpatrick; Taylor D,9999,0,9999,0
1668174758490,CSE 293,004,119135,Christensen; Henrik I,9999,0,9999,0
1668174758490,CSE 293,005,119142,Cottrell; Garrison W,9999,0,9999,0
1668174758490,CSE 293,006,119146,Deutsch; Alin Bernard,9999,0,9999,0
1668174758490,CSE 293,007,119159,Esmaeilzadeh; Hadi,9999,0,9999,0
1668174758490,CSE 293,008,119166,Freund; Yoav,9999,0,9999,0
1668174758490,CSE 293,009,119170,Griswold; William G.,9999,0,9999,0
1668174758490,CSE 293,010,119183,Gymrek; Melissa Ann,9999,0,9999,0
1668174758490,CSE 293,011,119190,Heninger; Nadia A,9999,0,9999,0
1668174758490,CSE 293,012,119230,Impagliazzo; Russell,9999,0,9999,0
1668174758490,CSE 293,013,119232,Jhala; Ranjit,9999,0,9999,0
1668174758490,CSE 293,014,119233,Kahng; Andrew Byun,9999,0,9999,0
1668174758490,CSE 293,015,119298,Kane; Daniel Mertz,9999,0,9999,0
1668174758490,CSE 293,016,119299,Kriegman; David J,9999,0,9999,0
1668174758490,CSE 293,017,119300,Kumar; Arun Kumar,9999,0,9999,0
1668174758490,CSE 293,018,119301,Lerner; Sorin,9999,0,9999,0
1668174758490,CSE 293,019,119302,Lovett; Shachar,9999,0,9999,0
1668174758490,CSE 293,020,119303,McAuley; Julian John,9999,0,9999,0
1668174758490,CSE 293,021,119304,Micciancio; Daniele,9999,0,9999,0
1668174758490,CSE 293,022,119367,Orailoglu; Alex,9999,0,9999,0
1668174758490,CSE 293,023,119382,Paturi; Ramamohan,9999,0,9999,0
1668174758490,CSE 293,024,119404,Polikarpova; Nadezhda,9999,0,9999,0
1668174758490,CSE 293,025,119406,Politz; Joseph Gibbs,9999,0,9999,0
1668174758490,CSE 293,026,119411,Porter; George M,9999,0,9999,0
1668174758490,CSE 293,027,119414,Porter; Leonard Emerson,9999,0,9999,0
1668174758490,CSE 293,028,119416,Ramamoorthi; Ravi,9999,0,9999,0
1668174758490,CSE 293,029,119417,Sahoo; Debashis,9999,0,9999,0
1668174758490,CSE 293,030,119420,Saul; Lawrence,9999,0,9999,0
1668174758490,CSE 293,031,119421,Savage; Stefan,9999,0,9999,0
1668174758490,CSE 293,032,119425,Schulze; Jurgen P.,9999,0,9999,0
1668174758490,CSE 293,033,119426,Snoeren; Alex C.,9999,0,9999,0
1668174758490,CSE 293,034,119428,Shang; Jingbo,9999,0,9999,0
1668174758490,CSE 293,035,119430,Stefan; Deian,9999,0,9999,0
1668174758490,CSE 293,036,119431,Su; Hao,9999,0,9999,0
1668174758490,CSE 293,037,119433,Swanson; Steven James,9999,0,9999,0
1668174758490,CSE 293,038,119435,Tullsen; Dean Michael,9999,0,9999,0
1668174758490,CSE 293,039,119483,Voelker; Geoffrey M.,9999,0,9999,0
1668174758490,CSE 293,040,119537,Zhao; Jishen,9999,0,9999,0
1668174758490,CSE 293,041,119538,Zhou; Yuan-Yuan,9999,0,9999,0
1668174758490,CSE 293,042,119539,Gao; Sicun,9999,0,9999,0
1668174758490,CSE 293,043,119540,Weibel; Nadir,9999,0,9999,0
1668174758490,CSE 293,044,119541,Gupta; Rajesh K.,9999,0,9999,0
1668174758490,CSE 293,045,126410,Vaccaro; Kristen Marie,9999,0,9999,0
1668174758490,CSE 293,046,126411,Klemke; Richard,9999,0,9999,0
1668174758916,CSE 294,A00,102459,Voelker; Geoffrey M.,0,0,0,0
1668174758916,CSE 294,B00,111322,Orailoglu; Alex,0,0,0,0
1668174759341,DSE 201,A00,096914,Deutsch; Alin Bernard,30,0,30,0
1668174759764,DSE 210,A00,096915,Dasgupta; Sanjoy,30,0,30,0
1668174760199,DSE 260A,A00,096916,Altintas De Callaf; Ilkay,30,0,30,0
1668174760700,ECE 200,001,103586,Antipa; Nicholas A,9999,0,9999,0
1668174760700,ECE 200,002,103587,Atanasov; Nikolay A.,9999,0,9999,0
1668174760700,ECE 200,003,103588,Bharadia; Dinesh,9999,0,9999,0
1668174760700,ECE 200,004,103589,Cheng; Chung Kuan,9999,0,9999,0
1668174760700,ECE 200,005,103590,Cosman; Pamela C.,9999,0,9999,0
1668174760700,ECE 200,006,103591,Dayeh; Shadi Ahmad,9999,0,9999,0
1668174760700,ECE 200,007,103592,Fainman; Yeshaiahu,9999,0,9999,0
1668174760700,ECE 200,008,103593,Ford; Joseph Earl,9999,0,9999,0
1668174760700,ECE 200,009,103594,Franceschetti; Massimo,9999,0,9999,0
1668174760700,ECE 200,010,103595,Fullerton; Eric E,9999,0,9999,0
1668174760700,ECE 200,011,103596,Galton; Ian A,9999,0,9999,0
1668174760700,ECE 200,012,103597,Gilja; Vikash,9999,0,9999,0
1668174760700,ECE 200,013,103598,Hall; Drew A.,9999,0,9999,0
1668174760700,ECE 200,014,103599,Hsueh; Tzu-Chien,9999,0,9999,0
1668174760700,ECE 200,015,103600,Javidi; Tara,9999,0,9999,0
1668174760700,ECE 200,016,103601,Kahng; Andrew Byun,9999,0,9999,0
1668174760700,ECE 200,017,103602,Kim; Young-Han,9999,0,9999,0
1668174760700,ECE 200,018,103603,Koushanfar; Farinaz,9999,0,9999,0
1668174760700,ECE 200,019,103604,Kuzum; Duygu,9999,0,9999,0
1668174760700,ECE 200,020,103605,Le; Hanh-Phuc,9999,0,9999,0
1668174760700,ECE 200,021,103606,Lin; Bill,9999,0,9999,0
1668174760700,ECE 200,022,103607,Liu; Zhaowei,9998,0,9999,1
1668174760700,ECE 200,023,103608,Lo; Yu-Hwa,9999,0,9999,0
1668174760700,ECE 200,024,103609,Lomakin; Vitaliy,9999,0,9999,0
1668174760700,ECE 200,025,103610,Mercier; Patrick Philip,9999,0,9999,0
1668174760700,ECE 200,026,103611,Meyer; Florian,9999,0,9999,0
1668174760700,ECE 200,027,103612,Milstein; Laurence B.,9999,0,9999,0
1668174760700,ECE 200,028,103613,Mir Arabbaygi; Siavash,9999,0,9999,0
1668174760700,ECE 200,029,103614,Mookherjea; Shayan,9999,0,9999,0
1668174760700,ECE 200,030,103615,Morris; Karcher William,9999,0,9999,0
1668174760700,ECE 200,031,103616,Ng; Tse Nga,9999,0,9999,0
1668174760700,ECE 200,032,103617,Nguyen; Truong Quang,9999,0,9999,0
1668174760700,ECE 200,033,103618,Nomura; Kenji,9999,0,9999,0
1668174760700,ECE 200,034,103619,Orlitsky; Alon,9999,0,9999,0
1668174760700,ECE 200,035,103620,Pal; Piya,9999,0,9999,0
1668174760700,ECE 200,036,103621,Papen; George C.,9999,0,9999,0
1668174760700,ECE 200,037,103622,Radic; Stojan,9999,0,9999,0
1668174760700,ECE 200,038,103623,Rao; Bhaskar D.,9999,0,9999,0
1668174760700,ECE 200,039,103624,Rao; Ramesh R,9999,0,9999,0
1668174760700,ECE 200,040,103625,Rebeiz; Gabriel,9999,0,9999,0
1668174760700,ECE 200,041,103626,Sanford; John R,9999,0,9999,0
1668174760700,ECE 200,042,103627,Siegel; Paul H.,9999,0,9999,0
1668174760700,ECE 200,043,103628,Sievenpiper; Daniel F.,9999,0,9999,0
1668174760700,ECE 200,044,103629,Sworder; David D.,9999,0,9999,0
1668174760700,ECE 200,045,103630,Taur; Yuan,9999,0,9999,0
1668174760700,ECE 200,046,103631,Touri; Behrouz,9999,0,9999,0
1668174760700,ECE 200,047,103632,Trivedi; Mohan M.,9999,0,9999,0
1668174760700,ECE 200,048,103633,Vasconcelos; Nuno,9999,0,9999,0
1668174760700,ECE 200,049,103634,Wang; Xiaolong,9999,0,9999,0
1668174760700,ECE 200,050,103635,Xie; Pengtao,9999,0,9999,0
1668174760700,ECE 200,051,103636,Yip; Michael,9999,0,9999,0
1668174760700,ECE 200,052,103637,Zeger; Kenneth A.,999,0,999,0
1668174760700,ECE 200,053,103638,Zhang; Xinyu,9999,0,9999,0
1668174760700,ECE 200,054,103639,Turakhia; Yatish Girish,9999,0,9999,0
1668174760700,ECE 200,055,103640,Kang; Mingu,9999,0,9999,0
1668174760700,ECE 200,056,103641,Shi; Yuanyuan,9999,0,9999,0
1668174760700,ECE 200,057,103642,Wang; Edward Jay,9999,0,9999,0
1668174760700,ECE 200,058,103643,Zheng; Yang,9999,0,9999,0
1668174761127,ECE 202,A00,103644,Kuzum; Duygu,0,0,0,0
1668174761568,ECE 212BN,A00,103646,Ng; Tse Nga,0,0,0,0
1668174761997,ECE 221,A00,111493,Staff,0,0,0,0
1668174762420,ECE 222B,A00,103647,Lomakin; Vitaliy,0,0,0,0
1668174762844,ECE 230B,A00,103648,Taur; Yuan,0,0,0,0
1668174763274,ECE 238B,A00,103649,Garay; Javier,0,0,0,0
1668174763709,ECE 240B,A00,112900,Fainman; Yeshaiahu,0,0,0,0
1668174764134,ECE 247A,A00,103650,Jokerst; Jesse Vincent,0,0,0,0
1668174764558,ECE 247B,A00,103651,Wang; Joseph,0,0,0,0
1668174764986,ECE 250,A00,103652,Siegel; Paul H.,0,0,0,0
1668174765410,ECE 251A,A00,103654,Rao; Bhaskar D.,0,0,0,0
1668174765836,ECE 257B,A00,103655,Bharadia; Dinesh,0,0,0,0
1668174766264,ECE 258A,A00,103656,Milstein; Laurence B.,0,0,0,0
1668174766689,ECE 260B,A00,103658,Kang; Mingu,0,0,0,0
1668174767113,ECE 264A,A00,103659,Galton; Ian A,0,0,0,0
1668174767539,ECE 265A,A00,103661,Gudem; Prasad S.S.,0,0,0,0
1668174767974,ECE 265D,A00,103662,Gudem; Prasad S.S.,0,0,0,0
1668174768400,ECE 268,A00,103663,Koushanfar; Farinaz,0,0,0,0
1668174768829,ECE 269,A01,103665,Pal; Piya,0,0,0,0
1668174769263,ECE 271B,A00,103666,Vasconcelos; Manuela,0,0,0,0
1668174769687,ECE 276A,A00,103667,Atanasov; Nikolay A.,0,0,0,0
1668174770113,ECE 277,A00,103668,An; Cheolhong,0,0,0,0
1668174770538,ECE 279,A00,117947,Hall; Drew A.,0,0,0,0
1668174771419,ECE 283,A00,103670,Hsueh; Tzu-Chien,0,0,0,0
1668174771845,ECE 284,A00,103671,Turakhia; Yatish Girish,0,0,0,0
1668174772274,ECE 285,A00,103672,Zheng; Yang,0,0,0,0
1668174772274,ECE 285,B00,103673,Sworder; David D.,0,0,0,0
1668174772700,ECE 287,A00,103676,Javidi; Tara,0,0,0,0
1668174773124,MATH 200B,A00,098023,Salehi Golsefidy; Alireza,12,0,15,3
1668174773551,MATH 202B,A00,098024,Rhoades; Brendon Patrick,9,0,15,6
1668174773977,MATH 203B,A00,098025,Oprea; Dragos N.,10,0,15,5
1668174774405,MATH 204B,A00,098026,Sorensen; Claus M,13,0,15,2
1668174774833,MATH 208,A00,098027,Izadi; Elham,7,0,10,3
1668174775257,MATH 209,A00,098028,Pollack; Aaron,10,0,10,0
1668174775681,MATH 211A,A00,112919,Rogalski; Daniel,9,0,10,1
1668174776106,MATH 211B,A00,112920,Seward; Brandon M.,9,0,10,1
1668174776530,MATH 218,A00,098029,Li; Bo,10,0,10,0
1668174776955,MATH 220B,A00,098030,Novak; Jonathan I,11,0,15,4
1668174777382,MATH 221A,A00,098031,Ebenfelt; Peter F,13,0,15,2
1668174777821,MATH 231B,A00,098032,Zlatos; Andrej,12,0,15,3
1668174778246,MATH 240B,A00,098033,Ni; Lei,9,0,15,6
1668174778671,MATH 243,A00,098034,Jekel; David Andrew,10,0,10,0
1668174779095,MATH 245A,A00,098035,Nie; Jiawang,0,0,15,16
1668174779519,MATH 248,A00,098036,Bejenaru; Ioan,10,0,10,0
1668174779945,MATH 250B,A00,098037,Spolaor; Luca,14,0,15,1
1668174780372,MATH 258,A00,098038,Ni; Lei,10,0,10,0
1668174780799,MATH 264B,A00,098041,Rhoades; Brendon Patrick,9,0,15,6
1668174781225,MATH 268,A00,098042,Buss; Samuel R,10,0,10,0
1668174781650,MATH 269,A00,098043,Rhoades; Brendon Patrick,10,0,10,0
1668174782079,MATH 270B,A00,098044,Li; Bo,10,0,15,5
1668174782590,MATH 272B,A00,098045,Holst; Michael J,13,0,15,2
1668174783016,MATH 273A,A00,098046,Tian; Xiaochuan,10,0,15,5
1668174783442,MATH 275,A01,098048,Tian; Xiaochuan,6,0,10,4
1668174783865,MATH 278A,A00,098049,Holst; Michael J,8,0,10,2
1668174784291,MATH 278B,A00,098050,Cloninger; Alexander,10,0,10,0
1668174784724,MATH 278C,A00,098051,Nie; Jiawang,7,0,10,3
1668174785150,MATH 280B,A00,098052,Zheng; Tianyi,10,0,15,5
1668174785587,MATH 281B,A00,098053,Bradic; Jelena,2,0,15,13
1668174786013,MATH 282B,A00,098054,Arias-Castro; Ery,0,0,15,15
1668174786437,MATH 285,A00,098055,Fitzsimmons; Patrick J,0,0,15,17
1668174786860,MATH 287B,A00,098056,Arias-Castro; Ery,2,0,15,13
1668174787285,MATH 288,A00,098057,Agarwal; Pooja,9,0,10,1
1668174787285,MATH 288,B00,098058,Zhang; Danna,8,0,10,2
1668174787285,MATH 288,C00,098059,Williams; Ruth J,10,0,10,0
1668174787720,MATH 290B,A00,098060,Roberts; Justin Deritter,13,0,15,2
1668174788151,MATH 292,A00,098061,Belmont; Eva Kinoshita,10,0,10,0
1668174788578,MATH 295,A00,098062,Suk; Andrew Hoon,48,0,50,2
1668174789003,MATH 296,A00,098063,Novak; Jonathan I,20,0,20,0
1668174789427,MATH 297,001,098064,Gamst; Anthony Collins,9997,0,9999,2
1668175291457,COGS 205,A00,101395,Chiba; Andrea,19,0,20,1
1668175291884,COGS 210B,001,101404,Greene; Deanna Jacquelyn,9998,0,9999,1
1668175291884,COGS 210B,002,101417,Xia; Haijun,9999,0,9999,0
1668175291884,COGS 210B,003,101422,Nitz; Douglas A.,9999,0,9999,0
1668175291884,COGS 210B,004,101423,Hollan; James D.,9998,0,9999,1
1668175291884,COGS 210B,005,101424,Deak; Gedeon O.,9998,0,9999,1
1668175291884,COGS 210B,006,101425,Rossano; Federico,9999,0,9999,0
1668175292312,COGS 211B,A00,101427,Coulson; Seana M,9996,0,9999,3
1668175292738,COGS 220,A00,101428,Hollan; James D.,0,0,25,25
1668175293165,COGS 229,A00,101429,Dow; Steven P,18,0,25,7
1668175293589,COGS 230,A00,101430,Klemmer; Scott R,12,0,17,5
1668175294014,COGS 234,A00,101431,Xia; Haijun,3,0,25,22
1668175294447,COGS 260,A00,101432,Kiyonaga; Anastasia,20,0,25,5
1668175294447,COGS 260,B00,101433,Kirsh; David Joel,16,0,25,9
1668175294879,CSE 202,A00,102371,Impagliazzo; Russell,0,0,0,0
1668175295306,CSE 203B,A01,102373,Cheng; Chung Kuan,0,0,0,0
1668175295731,CSE 208,A00,102374,Micciancio; Daniele,0,0,0,0
1668175296162,CSE 209A,A00,112895,Impagliazzo; Russell,0,0,15,15
1668175296586,CSE 209B,A00,108005,Bellare; Mihir,0,0,0,0
1668175297016,CSE 210,A00,113163,Coblenz; Michael J,0,0,0,0
1668175297440,CSE 219,A00,106111,Dow; Steven P,0,0,20,20
1668175297868,CSE 221,A00,102376,Voelker; Geoffrey M.,0,0,0,0
1668175298294,CSE 224,A01,102378,Porter; George M,0,0,0,0
1668175298736,CSE 229A,A00,102379,Savage; Stefan,0,0,0,0
1668175299161,CSE 229C,A00,102380,Munyaka; Imani N. S.,0,0,0,0
1668175299586,CSE 232B,A00,102382,Deutsch; Alin Bernard,0,0,0,0
1668175300014,CSE 234,A01,112904,Kumar; Arun Kumar,0,0,0,0
1668175300443,CSE 237A,A00,102383,Rosing; Tajana Simunic,0,0,0,0
1668175300867,CSE 239A,A00,102384,Deutsch; Alin Bernard,0,0,0,0
1668175301294,CSE 239B,A00,102385,Polikarpova; Nadezhda,0,0,0,0
1668175301719,CSE 240A,A00,102386,Pannuto; Patrick William,0,0,0,0
1668175302153,CSE 240B,A00,102387,Zhao; Jishen,0,0,0,0
1668175302586,CSE 241A,A00,106406,Kang; Mingu,0,0,0,0
1668175303013,CSE 249B,A00,102388,Kahng; Andrew Byun,0,0,8,8
1668175303442,CSE 251B,A01,102392,Cottrell; Garrison W,0,0,0,0
1668175303442,CSE 251B,A02,102393,Cottrell; Garrison W,0,0,0,0
1668175303871,CSE 252B,A00,102394,Ochoa; Benjamin Lawrence,0,0,0,0
1668175304298,CSE 257,A01,102396,Gao; Sicun,0,0,0,0
1668175304797,CSE 272,A00,102397,Li; Tzumao,0,0,0,0
1668175305221,CSE 274,A00,111323,Chern; Albert Ren-Haur,0,0,0,0
1668175305645,CSE 282,A00,102398,Pevzner; Pavel Arkadjevich,0,0,0,0
1668175306072,CSE 284,A00,114175,Gymrek; Melissa Ann,0,0,0,0
1668175306499,CSE 290,A00,102399,Chandraker; Manmohan Krishna,0,0,0,0
1668175306499,CSE 290,B00,102400,Vaccaro; Kristen Marie,0,0,25,25
1668175306499,CSE 290,C00,102414,Pannuto; Patrick William,0,0,25,25
1668175306499,CSE 290,D00,102427,Pevzner; Pavel Arkadjevich,0,0,0,0
1668175306499,CSE 290,E00,102429,Zhao; Jishen,0,0,0,0
1668175306499,CSE 290,F00,102436,Tullsen; Dean Michael,0,0,0,0
1668175306499,CSE 290,G00,102440,Christensen; Henrik I,0,0,20,20
1668175306925,CSE 291,A00,102443,Su; Hao,0,0,0,0
1668175306925,CSE 291,B00,102448,Polikarpova; Nadezhda,0,0,0,0
1668175306925,CSE 291,C00,102453,Vaccaro; Kristen Marie,0,0,0,0
1668175306925,CSE 291,D00,111343,Savage; Stefan,0,0,0,0
1668175306925,CSE 291,E00,116474,Claffy; Kimberly Claire,0,0,0,0
1668175306925,CSE 291,F00,116479,Pasquale; Joseph,0,0,0,0
1668175307393,CSE 293,001,119111,Bafna; Vineet,9999,0,9999,0
1668175307393,CSE 293,002,119118,Bellare; Mihir,9999,0,9999,0
1668175307393,CSE 293,003,119122,Berg-Kirkpatrick; Taylor D,9999,0,9999,0
1668175307393,CSE 293,004,119135,Christensen; Henrik I,9999,0,9999,0
1668175307393,CSE 293,005,119142,Cottrell; Garrison W,9999,0,9999,0
1668175307393,CSE 293,006,119146,Deutsch; Alin Bernard,9999,0,9999,0
1668175307393,CSE 293,007,119159,Esmaeilzadeh; Hadi,9999,0,9999,0
1668175307393,CSE 293,008,119166,Freund; Yoav,9999,0,9999,0
1668175307393,CSE 293,009,119170,Griswold; William G.,9999,0,9999,0
1668175307393,CSE 293,010,119183,Gymrek; Melissa Ann,9999,0,9999,0
1668175307393,CSE 293,011,119190,Heninger; Nadia A,9999,0,9999,0
1668175307393,CSE 293,012,119230,Impagliazzo; Russell,9999,0,9999,0
1668175307393,CSE 293,013,119232,Jhala; Ranjit,9999,0,9999,0
1668175307393,CSE 293,014,119233,Kahng; Andrew Byun,9999,0,9999,0
1668175307393,CSE 293,015,119298,Kane; Daniel Mertz,9999,0,9999,0
1668175307393,CSE 293,016,119299,Kriegman; David J,9999,0,9999,0
1668175307393,CSE 293,017,119300,Kumar; Arun Kumar,9999,0,9999,0
1668175307393,CSE 293,018,119301,Lerner; Sorin,9999,0,9999,0
1668175307393,CSE 293,019,119302,Lovett; Shachar,9999,0,9999,0
1668175307393,CSE 293,020,119303,McAuley; Julian John,9999,0,9999,0
1668175307393,CSE 293,021,119304,Micciancio; Daniele,9999,0,9999,0
1668175307393,CSE 293,022,119367,Orailoglu; Alex,9999,0,9999,0
1668175307393,CSE 293,023,119382,Paturi; Ramamohan,9999,0,9999,0
1668175307393,CSE 293,024,119404,Polikarpova; Nadezhda,9999,0,9999,0
1668175307393,CSE 293,025,119406,Politz; Joseph Gibbs,9999,0,9999,0
1668175307393,CSE 293,026,119411,Porter; George M,9999,0,9999,0
1668175307393,CSE 293,027,119414,Porter; Leonard Emerson,9999,0,9999,0
1668175307393,CSE 293,028,119416,Ramamoorthi; Ravi,9999,0,9999,0
1668175307393,CSE 293,029,119417,Sahoo; Debashis,9999,0,9999,0
1668175307393,CSE 293,030,119420,Saul; Lawrence,9999,0,9999,0
1668175307393,CSE 293,031,119421,Savage; Stefan,9999,0,9999,0
1668175307393,CSE 293,032,119425,Schulze; Jurgen P.,9999,0,9999,0
1668175307393,CSE 293,033,119426,Snoeren; Alex C.,9999,0,9999,0
1668175307393,CSE 293,034,119428,Shang; Jingbo,9999,0,9999,0
1668175307393,CSE 293,035,119430,Stefan; Deian,9999,0,9999,0
1668175307393,CSE 293,036,119431,Su; Hao,9999,0,9999,0
1668175307393,CSE 293,037,119433,Swanson; Steven James,9999,0,9999,0
1668175307393,CSE 293,038,119435,Tullsen; Dean Michael,9999,0,9999,0
1668175307393,CSE 293,039,119483,Voelker; Geoffrey M.,9999,0,9999,0
1668175307393,CSE 293,040,119537,Zhao; Jishen,9999,0,9999,0
1668175307393,CSE 293,041,119538,Zhou; Yuan-Yuan,9999,0,9999,0
1668175307393,CSE 293,042,119539,Gao; Sicun,9999,0,9999,0
1668175307393,CSE 293,043,119540,Weibel; Nadir,9999,0,9999,0
1668175307393,CSE 293,044,119541,Gupta; Rajesh K.,9999,0,9999,0
1668175307393,CSE 293,045,126410,Vaccaro; Kristen Marie,9999,0,9999,0
1668175307393,CSE 293,046,126411,Klemke; Richard,9999,0,9999,0
1668175307818,CSE 294,A00,102459,Voelker; Geoffrey M.,0,0,0,0
1668175307818,CSE 294,B00,111322,Orailoglu; Alex,0,0,0,0
1668175308252,DSE 201,A00,096914,Deutsch; Alin Bernard,30,0,30,0
1668175308678,DSE 210,A00,096915,Dasgupta; Sanjoy,30,0,30,0
1668175309107,DSE 260A,A00,096916,Altintas De Callaf; Ilkay,30,0,30,0
1668175309564,ECE 200,001,103586,Antipa; Nicholas A,9999,0,9999,0
1668175309564,ECE 200,002,103587,Atanasov; Nikolay A.,9999,0,9999,0
1668175309564,ECE 200,003,103588,Bharadia; Dinesh,9999,0,9999,0
1668175309564,ECE 200,004,103589,Cheng; Chung Kuan,9999,0,9999,0
1668175309564,ECE 200,005,103590,Cosman; Pamela C.,9999,0,9999,0
1668175309564,ECE 200,006,103591,Dayeh; Shadi Ahmad,9999,0,9999,0
1668175309564,ECE 200,007,103592,Fainman; Yeshaiahu,9999,0,9999,0
1668175309564,ECE 200,008,103593,Ford; Joseph Earl,9999,0,9999,0
1668175309564,ECE 200,009,103594,Franceschetti; Massimo,9999,0,9999,0
1668175309564,ECE 200,010,103595,Fullerton; Eric E,9999,0,9999,0
1668175309564,ECE 200,011,103596,Galton; Ian A,9999,0,9999,0
1668175309564,ECE 200,012,103597,Gilja; Vikash,9999,0,9999,0
1668175309564,ECE 200,013,103598,Hall; Drew A.,9999,0,9999,0
1668175309564,ECE 200,014,103599,Hsueh; Tzu-Chien,9999,0,9999,0
1668175309564,ECE 200,015,103600,Javidi; Tara,9999,0,9999,0
1668175309564,ECE 200,016,103601,Kahng; Andrew Byun,9999,0,9999,0
1668175309564,ECE 200,017,103602,Kim; Young-Han,9999,0,9999,0
1668175309564,ECE 200,018,103603,Koushanfar; Farinaz,9999,0,9999,0
1668175309564,ECE 200,019,103604,Kuzum; Duygu,9999,0,9999,0
1668175309564,ECE 200,020,103605,Le; Hanh-Phuc,9999,0,9999,0
1668175309564,ECE 200,021,103606,Lin; Bill,9999,0,9999,0
1668175309564,ECE 200,022,103607,Liu; Zhaowei,9998,0,9999,1
1668175309564,ECE 200,023,103608,Lo; Yu-Hwa,9999,0,9999,0
1668175309564,ECE 200,024,103609,Lomakin; Vitaliy,9999,0,9999,0
1668175309564,ECE 200,025,103610,Mercier; Patrick Philip,9999,0,9999,0
1668175309564,ECE 200,026,103611,Meyer; Florian,9999,0,9999,0
1668175309564,ECE 200,027,103612,Milstein; Laurence B.,9999,0,9999,0
1668175309564,ECE 200,028,103613,Mir Arabbaygi; Siavash,9999,0,9999,0
1668175309564,ECE 200,029,103614,Mookherjea; Shayan,9999,0,9999,0
1668175309564,ECE 200,030,103615,Morris; Karcher William,9999,0,9999,0
1668175309564,ECE 200,031,103616,Ng; Tse Nga,9999,0,9999,0
1668175309564,ECE 200,032,103617,Nguyen; Truong Quang,9999,0,9999,0
1668175309564,ECE 200,033,103618,Nomura; Kenji,9999,0,9999,0
1668175309564,ECE 200,034,103619,Orlitsky; Alon,9999,0,9999,0
1668175309564,ECE 200,035,103620,Pal; Piya,9999,0,9999,0
1668175309564,ECE 200,036,103621,Papen; George C.,9999,0,9999,0
1668175309564,ECE 200,037,103622,Radic; Stojan,9999,0,9999,0
1668175309564,ECE 200,038,103623,Rao; Bhaskar D.,9999,0,9999,0
1668175309564,ECE 200,039,103624,Rao; Ramesh R,9999,0,9999,0
1668175309564,ECE 200,040,103625,Rebeiz; Gabriel,9999,0,9999,0
1668175309564,ECE 200,041,103626,Sanford; John R,9999,0,9999,0
1668175309564,ECE 200,042,103627,Siegel; Paul H.,9999,0,9999,0
1668175309564,ECE 200,043,103628,Sievenpiper; Daniel F.,9999,0,9999,0
1668175309564,ECE 200,044,103629,Sworder; David D.,9999,0,9999,0
1668175309564,ECE 200,045,103630,Taur; Yuan,9999,0,9999,0
1668175309564,ECE 200,046,103631,Touri; Behrouz,9999,0,9999,0
1668175309564,ECE 200,047,103632,Trivedi; Mohan M.,9999,0,9999,0
1668175309564,ECE 200,048,103633,Vasconcelos; Nuno,9999,0,9999,0
1668175309564,ECE 200,049,103634,Wang; Xiaolong,9999,0,9999,0
1668175309564,ECE 200,050,103635,Xie; Pengtao,9999,0,9999,0
1668175309564,ECE 200,051,103636,Yip; Michael,9999,0,9999,0
1668175309564,ECE 200,052,103637,Zeger; Kenneth A.,999,0,999,0
1668175309564,ECE 200,053,103638,Zhang; Xinyu,9999,0,9999,0
1668175309564,ECE 200,054,103639,Turakhia; Yatish Girish,9999,0,9999,0
1668175309564,ECE 200,055,103640,Kang; Mingu,9999,0,9999,0
1668175309564,ECE 200,056,103641,Shi; Yuanyuan,9999,0,9999,0
1668175309564,ECE 200,057,103642,Wang; Edward Jay,9999,0,9999,0
1668175309564,ECE 200,058,103643,Zheng; Yang,9999,0,9999,0
1668175309994,ECE 202,A00,103644,Kuzum; Duygu,0,0,0,0
1668175310417,ECE 212BN,A00,103646,Ng; Tse Nga,0,0,0,0
1668175310845,ECE 221,A00,111493,Staff,0,0,0,0
1668175311272,ECE 222B,A00,103647,Lomakin; Vitaliy,0,0,0,0
1668175311708,ECE 230B,A00,103648,Taur; Yuan,0,0,0,0
1668175312133,ECE 238B,A00,103649,Garay; Javier,0,0,0,0
1668175312562,ECE 240B,A00,112900,Fainman; Yeshaiahu,0,0,0,0
1668175312997,ECE 247A,A00,103650,Jokerst; Jesse Vincent,0,0,0,0
1668175313421,ECE 247B,A00,103651,Wang; Joseph,0,0,0,0
1668175313850,ECE 250,A00,103652,Siegel; Paul H.,0,0,0,0
1668175314278,ECE 251A,A00,103654,Rao; Bhaskar D.,0,0,0,0
1668175314701,ECE 257B,A00,103655,Bharadia; Dinesh,0,0,0,0
1668175315127,ECE 258A,A00,103656,Milstein; Laurence B.,0,0,0,0
1668175315552,ECE 260B,A00,103658,Kang; Mingu,0,0,0,0
1668175315977,ECE 264A,A00,103659,Galton; Ian A,0,0,0,0
1668175316422,ECE 265A,A00,103661,Gudem; Prasad S.S.,0,0,0,0
1668175316858,ECE 265D,A00,103662,Gudem; Prasad S.S.,0,0,0,0
1668175317287,ECE 268,A00,103663,Koushanfar; Farinaz,0,0,0,0
1668175317713,ECE 269,A01,103665,Pal; Piya,0,0,0,0
1668175318138,ECE 271B,A00,103666,Vasconcelos; Manuela,0,0,0,0
1668175318566,ECE 276A,A00,103667,Atanasov; Nikolay A.,0,0,0,0
1668175318995,ECE 277,A00,103668,An; Cheolhong,0,0,0,0
1668175319421,ECE 279,A00,117947,Hall; Drew A.,0,0,0,0
1668175320274,ECE 283,A00,103670,Hsueh; Tzu-Chien,0,0,0,0
1668175320729,ECE 284,A00,103671,Turakhia; Yatish Girish,0,0,0,0
1668175321157,ECE 285,A00,103672,Zheng; Yang,0,0,0,0
1668175321157,ECE 285,B00,103673,Sworder; David D.,0,0,0,0
1668175321581,ECE 287,A00,103676,Javidi; Tara,0,0,0,0
1668175322017,MATH 200B,A00,098023,Salehi Golsefidy; Alireza,12,0,15,3
1668175322445,MATH 202B,A00,098024,Rhoades; Brendon Patrick,9,0,15,6
1668175322883,MATH 203B,A00,098025,Oprea; Dragos N.,10,0,15,5
1668175323311,MATH 204B,A00,098026,Sorensen; Claus M,13,0,15,2
1668175323737,MATH 208,A00,098027,Izadi; Elham,7,0,10,3
1668175324165,MATH 209,A00,098028,Pollack; Aaron,10,0,10,0
1668175324593,MATH 211A,A00,112919,Rogalski; Daniel,9,0,10,1
1668175325021,MATH 211B,A00,112920,Seward; Brandon M.,9,0,10,1
1668175325447,MATH 218,A00,098029,Li; Bo,10,0,10,0
1668175325876,MATH 220B,A00,098030,Novak; Jonathan I,11,0,15,4
1668175326309,MATH 221A,A00,098031,Ebenfelt; Peter F,13,0,15,2
1668175326734,MATH 231B,A00,098032,Zlatos; Andrej,12,0,15,3
1668175327164,MATH 240B,A00,098033,Ni; Lei,9,0,15,6
1668175327593,MATH 243,A00,098034,Jekel; David Andrew,10,0,10,0
1668175328018,MATH 245A,A00,098035,Nie; Jiawang,0,0,15,16
1668175328444,MATH 248,A00,098036,Bejenaru; Ioan,10,0,10,0
1668175328874,MATH 250B,A00,098037,Spolaor; Luca,14,0,15,1
1668175329299,MATH 258,A00,098038,Ni; Lei,10,0,10,0
1668175329727,MATH 264B,A00,098041,Rhoades; Brendon Patrick,9,0,15,6
1668175330153,MATH 268,A00,098042,Buss; Samuel R,10,0,10,0
1668175330581,MATH 269,A00,098043,Rhoades; Brendon Patrick,10,0,10,0
1668175331010,MATH 270B,A00,098044,Li; Bo,10,0,15,5
1668175331434,MATH 272B,A00,098045,Holst; Michael J,13,0,15,2
1668175331863,MATH 273A,A00,098046,Tian; Xiaochuan,10,0,15,5
1668175332287,MATH 275,A01,098048,Tian; Xiaochuan,6,0,10,4
1668175332713,MATH 278A,A00,098049,Holst; Michael J,8,0,10,2
1668175333141,MATH 278B,A00,098050,Cloninger; Alexander,10,0,10,0
1668175333571,MATH 278C,A00,098051,Nie; Jiawang,7,0,10,3
1668175334007,MATH 280B,A00,098052,Zheng; Tianyi,10,0,15,5
1668175334436,MATH 281B,A00,098053,Bradic; Jelena,2,0,15,13
1668175334862,MATH 282B,A00,098054,Arias-Castro; Ery,0,0,15,15
1668175335297,MATH 285,A00,098055,Fitzsimmons; Patrick J,0,0,15,17
1668175335721,MATH 287B,A00,098056,Arias-Castro; Ery,2,0,15,13
1668175336146,MATH 288,A00,098057,Agarwal; Pooja,9,0,10,1
1668175336146,MATH 288,B00,098058,Zhang; Danna,8,0,10,2
1668175336146,MATH 288,C00,098059,Williams; Ruth J,10,0,10,0
1668175336574,MATH 290B,A00,098060,Roberts; Justin Deritter,13,0,15,2
1668175337000,MATH 292,A00,098061,Belmont; Eva Kinoshita,10,0,10,0
1668175337428,MATH 295,A00,098062,Suk; Andrew Hoon,48,0,50,2
1668175337861,MATH 296,A00,098063,Novak; Jonathan I,20,0,20,0
1668175338289,MATH 297,001,098064,Gamst; Anthony Collins,9997,0,9999,2
1668175843005,COGS 205,A00,101395,Chiba; Andrea,19,0,20,1
1668175843442,COGS 210B,001,101404,Greene; Deanna Jacquelyn,9998,0,9999,1
1668175843442,COGS 210B,002,101417,Xia; Haijun,9999,0,9999,0
1668175843442,COGS 210B,003,101422,Nitz; Douglas A.,9999,0,9999,0
1668175843442,COGS 210B,004,101423,Hollan; James D.,9998,0,9999,1
1668175843442,COGS 210B,005,101424,Deak; Gedeon O.,9998,0,9999,1
1668175843442,COGS 210B,006,101425,Rossano; Federico,9999,0,9999,0
1668175843867,COGS 211B,A00,101427,Coulson; Seana M,9996,0,9999,3
1668175844306,COGS 220,A00,101428,Hollan; James D.,0,0,25,25
1668175844733,COGS 229,A00,101429,Dow; Steven P,18,0,25,7
1668175845161,COGS 230,A00,101430,Klemmer; Scott R,12,0,17,5
1668175845585,COGS 234,A00,101431,Xia; Haijun,3,0,25,22
1668175846011,COGS 260,A00,101432,Kiyonaga; Anastasia,20,0,25,5
1668175846011,COGS 260,B00,101433,Kirsh; David Joel,16,0,25,9
1668175846444,CSE 202,A00,102371,Impagliazzo; Russell,0,0,0,0
1668175846875,CSE 203B,A01,102373,Cheng; Chung Kuan,0,0,0,0
1668175847304,CSE 208,A00,102374,Micciancio; Daniele,0,0,0,0
1668175847734,CSE 209A,A00,112895,Impagliazzo; Russell,0,0,15,15
1668175848161,CSE 209B,A00,108005,Bellare; Mihir,0,0,0,0
1668175848586,CSE 210,A00,113163,Coblenz; Michael J,0,0,0,0
1668175849014,CSE 219,A00,106111,Dow; Steven P,0,0,20,20
1668175849439,CSE 221,A00,102376,Voelker; Geoffrey M.,0,0,0,0
1668175849862,CSE 224,A01,102378,Porter; George M,0,0,0,0
1668175850295,CSE 229A,A00,102379,Savage; Stefan,0,0,0,0
1668175850720,CSE 229C,A00,102380,Munyaka; Imani N. S.,0,0,0,0
1668175851149,CSE 232B,A00,102382,Deutsch; Alin Bernard,0,0,0,0
1668175851575,CSE 234,A01,112904,Kumar; Arun Kumar,0,0,0,0
1668175852000,CSE 237A,A00,102383,Rosing; Tajana Simunic,0,0,0,0
1668175852426,CSE 239A,A00,102384,Deutsch; Alin Bernard,0,0,0,0
1668175852862,CSE 239B,A00,102385,Polikarpova; Nadezhda,0,0,0,0
1668175853289,CSE 240A,A00,102386,Pannuto; Patrick William,0,0,0,0
1668175853726,CSE 240B,A00,102387,Zhao; Jishen,0,0,0,0
1668175854156,CSE 241A,A00,106406,Kang; Mingu,0,0,0,0
1668175854582,CSE 249B,A00,102388,Kahng; Andrew Byun,0,0,8,8
1668175855008,CSE 251B,A01,102392,Cottrell; Garrison W,0,0,0,0
1668175855008,CSE 251B,A02,102393,Cottrell; Garrison W,0,0,0,0
1668175855433,CSE 252B,A00,102394,Ochoa; Benjamin Lawrence,0,0,0,0
1668175855861,CSE 257,A01,102396,Gao; Sicun,0,0,0,0
1668175856290,CSE 272,A00,102397,Li; Tzumao,0,0,0,0
1668175856717,CSE 274,A00,111323,Chern; Albert Ren-Haur,0,0,0,0
1668175857142,CSE 282,A00,102398,Pevzner; Pavel Arkadjevich,0,0,0,0
1668175857571,CSE 284,A00,114175,Gymrek; Melissa Ann,0,0,0,0
1668175858004,CSE 290,A00,102399,Chandraker; Manmohan Krishna,0,0,0,0
1668175858004,CSE 290,B00,102400,Vaccaro; Kristen Marie,0,0,25,25
1668175858004,CSE 290,C00,102414,Pannuto; Patrick William,0,0,25,25
1668175858004,CSE 290,D00,102427,Pevzner; Pavel Arkadjevich,0,0,0,0
1668175858004,CSE 290,E00,102429,Zhao; Jishen,0,0,0,0
1668175858004,CSE 290,F00,102436,Tullsen; Dean Michael,0,0,0,0
1668175858004,CSE 290,G00,102440,Christensen; Henrik I,0,0,20,20
1668175858438,CSE 291,A00,102443,Su; Hao,0,0,0,0
1668175858438,CSE 291,B00,102448,Polikarpova; Nadezhda,0,0,0,0
1668175858438,CSE 291,C00,102453,Vaccaro; Kristen Marie,0,0,0,0
1668175858438,CSE 291,D00,111343,Savage; Stefan,0,0,0,0
1668175858438,CSE 291,E00,116474,Claffy; Kimberly Claire,0,0,0,0
1668175858438,CSE 291,F00,116479,Pasquale; Joseph,0,0,0,0
1668175858906,CSE 293,001,119111,Bafna; Vineet,9999,0,9999,0
1668175858906,CSE 293,002,119118,Bellare; Mihir,9999,0,9999,0
1668175858906,CSE 293,003,119122,Berg-Kirkpatrick; Taylor D,9999,0,9999,0
1668175858906,CSE 293,004,119135,Christensen; Henrik I,9999,0,9999,0
1668175858906,CSE 293,005,119142,Cottrell; Garrison W,9999,0,9999,0
1668175858906,CSE 293,006,119146,Deutsch; Alin Bernard,9999,0,9999,0
1668175858906,CSE 293,007,119159,Esmaeilzadeh; Hadi,9999,0,9999,0
1668175858906,CSE 293,008,119166,Freund; Yoav,9999,0,9999,0
1668175858906,CSE 293,009,119170,Griswold; William G.,9999,0,9999,0
1668175858906,CSE 293,010,119183,Gymrek; Melissa Ann,9999,0,9999,0
1668175858906,CSE 293,011,119190,Heninger; Nadia A,9999,0,9999,0
1668175858906,CSE 293,012,119230,Impagliazzo; Russell,9999,0,9999,0
1668175858906,CSE 293,013,119232,Jhala; Ranjit,9999,0,9999,0
1668175858906,CSE 293,014,119233,Kahng; Andrew Byun,9999,0,9999,0
1668175858906,CSE 293,015,119298,Kane; Daniel Mertz,9999,0,9999,0
1668175858906,CSE 293,016,119299,Kriegman; David J,9999,0,9999,0
1668175858906,CSE 293,017,119300,Kumar; Arun Kumar,9999,0,9999,0
1668175858906,CSE 293,018,119301,Lerner; Sorin,9999,0,9999,0
1668175858906,CSE 293,019,119302,Lovett; Shachar,9999,0,9999,0
1668175858906,CSE 293,020,119303,McAuley; Julian John,9999,0,9999,0
1668175858906,CSE 293,021,119304,Micciancio; Daniele,9999,0,9999,0
1668175858906,CSE 293,022,119367,Orailoglu; Alex,9999,0,9999,0
1668175858906,CSE 293,023,119382,Paturi; Ramamohan,9999,0,9999,0
1668175858906,CSE 293,024,119404,Polikarpova; Nadezhda,9999,0,9999,0
1668175858906,CSE 293,025,119406,Politz; Joseph Gibbs,9999,0,9999,0
1668175858906,CSE 293,026,119411,Porter; George M,9999,0,9999,0
1668175858906,CSE 293,027,119414,Porter; Leonard Emerson,9999,0,9999,0
1668175858906,CSE 293,028,119416,Ramamoorthi; Ravi,9999,0,9999,0
1668175858906,CSE 293,029,119417,Sahoo; Debashis,9999,0,9999,0
1668175858906,CSE 293,030,119420,Saul; Lawrence,9999,0,9999,0
1668175858906,CSE 293,031,119421,Savage; Stefan,9999,0,9999,0
1668175858906,CSE 293,032,119425,Schulze; Jurgen P.,9999,0,9999,0
1668175858906,CSE 293,033,119426,Snoeren; Alex C.,9999,0,9999,0
1668175858906,CSE 293,034,119428,Shang; Jingbo,9999,0,9999,0
1668175858906,CSE 293,035,119430,Stefan; Deian,9999,0,9999,0
1668175858906,CSE 293,036,119431,Su; Hao,9999,0,9999,0
1668175858906,CSE 293,037,119433,Swanson; Steven James,9999,0,9999,0
1668175858906,CSE 293,038,119435,Tullsen; Dean Michael,9999,0,9999,0
1668175858906,CSE 293,039,119483,Voelker; Geoffrey M.,9999,0,9999,0
1668175858906,CSE 293,040,119537,Zhao; Jishen,9999,0,9999,0
1668175858906,CSE 293,041,119538,Zhou; Yuan-Yuan,9999,0,9999,0
1668175858906,CSE 293,042,119539,Gao; Sicun,9999,0,9999,0
1668175858906,CSE 293,043,119540,Weibel; Nadir,9999,0,9999,0
1668175858906,CSE 293,044,119541,Gupta; Rajesh K.,9999,0,9999,0
1668175858906,CSE 293,045,126410,Vaccaro; Kristen Marie,9999,0,9999,0
1668175858906,CSE 293,046,126411,Klemke; Richard,9999,0,9999,0
1668175859333,CSE 294,A00,102459,Voelker; Geoffrey M.,0,0,0,0
1668175859333,CSE 294,B00,111322,Orailoglu; Alex,0,0,0,0
1668175859759,DSE 201,A00,096914,Deutsch; Alin Bernard,30,0,30,0
1668175860183,DSE 210,A00,096915,Dasgupta; Sanjoy,30,0,30,0
1668175860610,DSE 260A,A00,096916,Altintas De Callaf; Ilkay,30,0,30,0
1668175861070,ECE 200,001,103586,Antipa; Nicholas A,9999,0,9999,0
1668175861070,ECE 200,002,103587,Atanasov; Nikolay A.,9999,0,9999,0
1668175861070,ECE 200,003,103588,Bharadia; Dinesh,9999,0,9999,0
1668175861070,ECE 200,004,103589,Cheng; Chung Kuan,9999,0,9999,0
1668175861070,ECE 200,005,103590,Cosman; Pamela C.,9999,0,9999,0
1668175861070,ECE 200,006,103591,Dayeh; Shadi Ahmad,9999,0,9999,0
1668175861070,ECE 200,007,103592,Fainman; Yeshaiahu,9999,0,9999,0
1668175861070,ECE 200,008,103593,Ford; Joseph Earl,9999,0,9999,0
1668175861070,ECE 200,009,103594,Franceschetti; Massimo,9999,0,9999,0
1668175861070,ECE 200,010,103595,Fullerton; Eric E,9999,0,9999,0
1668175861070,ECE 200,011,103596,Galton; Ian A,9999,0,9999,0
1668175861070,ECE 200,012,103597,Gilja; Vikash,9999,0,9999,0
1668175861070,ECE 200,013,103598,Hall; Drew A.,9999,0,9999,0
1668175861070,ECE 200,014,103599,Hsueh; Tzu-Chien,9999,0,9999,0
1668175861070,ECE 200,015,103600,Javidi; Tara,9999,0,9999,0
1668175861070,ECE 200,016,103601,Kahng; Andrew Byun,9999,0,9999,0
1668175861070,ECE 200,017,103602,Kim; Young-Han,9999,0,9999,0
1668175861070,ECE 200,018,103603,Koushanfar; Farinaz,9999,0,9999,0
1668175861070,ECE 200,019,103604,Kuzum; Duygu,9999,0,9999,0
1668175861070,ECE 200,020,103605,Le; Hanh-Phuc,9999,0,9999,0
1668175861070,ECE 200,021,103606,Lin; Bill,9999,0,9999,0
1668175861070,ECE 200,022,103607,Liu; Zhaowei,9998,0,9999,1
1668175861070,ECE 200,023,103608,Lo; Yu-Hwa,9999,0,9999,0
1668175861070,ECE 200,024,103609,Lomakin; Vitaliy,9999,0,9999,0
1668175861070,ECE 200,025,103610,Mercier; Patrick Philip,9999,0,9999,0
1668175861070,ECE 200,026,103611,Meyer; Florian,9999,0,9999,0
1668175861070,ECE 200,027,103612,Milstein; Laurence B.,9999,0,9999,0
1668175861070,ECE 200,028,103613,Mir Arabbaygi; Siavash,9999,0,9999,0
1668175861070,ECE 200,029,103614,Mookherjea; Shayan,9999,0,9999,0
1668175861070,ECE 200,030,103615,Morris; Karcher William,9999,0,9999,0
1668175861070,ECE 200,031,103616,Ng; Tse Nga,9999,0,9999,0
1668175861070,ECE 200,032,103617,Nguyen; Truong Quang,9999,0,9999,0
1668175861070,ECE 200,033,103618,Nomura; Kenji,9999,0,9999,0
1668175861070,ECE 200,034,103619,Orlitsky; Alon,9999,0,9999,0
1668175861070,ECE 200,035,103620,Pal; Piya,9999,0,9999,0
1668175861070,ECE 200,036,103621,Papen; George C.,9999,0,9999,0
1668175861070,ECE 200,037,103622,Radic; Stojan,9999,0,9999,0
1668175861070,ECE 200,038,103623,Rao; Bhaskar D.,9999,0,9999,0
1668175861070,ECE 200,039,103624,Rao; Ramesh R,9999,0,9999,0
1668175861070,ECE 200,040,103625,Rebeiz; Gabriel,9999,0,9999,0
1668175861070,ECE 200,041,103626,Sanford; John R,9999,0,9999,0
1668175861070,ECE 200,042,103627,Siegel; Paul H.,9999,0,9999,0
1668175861070,ECE 200,043,103628,Sievenpiper; Daniel F.,9999,0,9999,0
1668175861070,ECE 200,044,103629,Sworder; David D.,9999,0,9999,0
1668175861070,ECE 200,045,103630,Taur; Yuan,9999,0,9999,0
1668175861070,ECE 200,046,103631,Touri; Behrouz,9999,0,9999,0
1668175861070,ECE 200,047,103632,Trivedi; Mohan M.,9999,0,9999,0
1668175861070,ECE 200,048,103633,Vasconcelos; Nuno,9999,0,9999,0
1668175861070,ECE 200,049,103634,Wang; Xiaolong,9999,0,9999,0
1668175861070,ECE 200,050,103635,Xie; Pengtao,9999,0,9999,0
1668175861070,ECE 200,051,103636,Yip; Michael,9999,0,9999,0
1668175861070,ECE 200,052,103637,Zeger; Kenneth A.,999,0,999,0
1668175861070,ECE 200,053,103638,Zhang; Xinyu,9999,0,9999,0
1668175861070,ECE 200,054,103639,Turakhia; Yatish Girish,9999,0,9999,0
1668175861070,ECE 200,055,103640,Kang; Mingu,9999,0,9999,0
1668175861070,ECE 200,056,103641,Shi; Yuanyuan,9999,0,9999,0
1668175861070,ECE 200,057,103642,Wang; Edward Jay,9999,0,9999,0
1668175861070,ECE 200,058,103643,Zheng; Yang,9999,0,9999,0
1668175861498,ECE 202,A00,103644,Kuzum; Duygu,0,0,0,0
1668175861926,ECE 212BN,A00,103646,Ng; Tse Nga,0,0,0,0
1668175862355,ECE 221,A00,111493,Staff,0,0,0,0
1668175862790,ECE 222B,A00,103647,Lomakin; Vitaliy,0,0,0,0
1668175863214,ECE 230B,A00,103648,Taur; Yuan,0,0,0,0
1668175863639,ECE 238B,A00,103649,Garay; Javier,0,0,0,0
1668175864068,ECE 240B,A00,112900,Fainman; Yeshaiahu,0,0,0,0
1668175864495,ECE 247A,A00,103650,Jokerst; Jesse Vincent,0,0,0,0
1668175864922,ECE 247B,A00,103651,Wang; Joseph,0,0,0,0
1668175865347,ECE 250,A00,103652,Siegel; Paul H.,0,0,0,0
1668175865773,ECE 251A,A00,103654,Rao; Bhaskar D.,0,0,0,0
1668175866202,ECE 257B,A00,103655,Bharadia; Dinesh,0,0,0,0
1668175866642,ECE 258A,A00,103656,Milstein; Laurence B.,0,0,0,0
1668175867065,ECE 260B,A00,103658,Kang; Mingu,0,0,0,0
1668175867490,ECE 264A,A00,103659,Galton; Ian A,0,0,0,0
1668175867915,ECE 265A,A00,103661,Gudem; Prasad S.S.,0,0,0,0
1668175868338,ECE 265D,A00,103662,Gudem; Prasad S.S.,0,0,0,0
1668175868766,ECE 268,A00,103663,Koushanfar; Farinaz,0,0,0,0
1668175869198,ECE 269,A01,103665,Pal; Piya,0,0,0,0
1668175869634,ECE 271B,A00,103666,Vasconcelos; Manuela,0,0,0,0
1668175870061,ECE 276A,A00,103667,Atanasov; Nikolay A.,0,0,0,0
1668175870486,ECE 277,A00,103668,An; Cheolhong,0,0,0,0
1668175870914,ECE 279,A00,117947,Hall; Drew A.,0,0,0,0
1668175871775,ECE 283,A00,103670,Hsueh; Tzu-Chien,0,0,0,0
1668175872202,ECE 284,A00,103671,Turakhia; Yatish Girish,0,0,0,0
1668175872626,ECE 285,A00,103672,Zheng; Yang,0,0,0,0
1668175872626,ECE 285,B00,103673,Sworder; David D.,0,0,0,0
1668175873134,ECE 287,A00,103676,Javidi; Tara,0,0,0,0
1668175873564,MATH 200B,A00,098023,Salehi Golsefidy; Alireza,12,0,15,3
1668175873993,MATH 202B,A00,098024,Rhoades; Brendon Patrick,9,0,15,6
1668175874423,MATH 203B,A00,098025,Oprea; Dragos N.,10,0,15,5
1668175874847,MATH 204B,A00,098026,Sorensen; Claus M,13,0,15,2
1668175875271,MATH 208,A00,098027,Izadi; Elham,7,0,10,3
1668175875695,MATH 209,A00,098028,Pollack; Aaron,10,0,10,0
1668175876125,MATH 211A,A00,112919,Rogalski; Daniel,9,0,10,1
1668175876547,MATH 211B,A00,112920,Seward; Brandon M.,9,0,10,1
1668175876972,MATH 218,A00,098029,Li; Bo,10,0,10,0
1668175877399,MATH 220B,A00,098030,Novak; Jonathan I,11,0,15,4
1668175877825,MATH 221A,A00,098031,Ebenfelt; Peter F,13,0,15,2
1668175878261,MATH 231B,A00,098032,Zlatos; Andrej,12,0,15,3
1668175878688,MATH 240B,A00,098033,Ni; Lei,9,0,15,6
1668175879116,MATH 243,A00,098034,Jekel; David Andrew,10,0,10,0
1668175879545,MATH 245A,A00,098035,Nie; Jiawang,0,0,15,16
1668175879974,MATH 248,A00,098036,Bejenaru; Ioan,10,0,10,0
1668175880407,MATH 250B,A00,098037,Spolaor; Luca,14,0,15,1
1668175880840,MATH 258,A00,098038,Ni; Lei,10,0,10,0
1668175881275,MATH 264B,A00,098041,Rhoades; Brendon Patrick,9,0,15,6
1668175881702,MATH 268,A00,098042,Buss; Samuel R,10,0,10,0
1668175882134,MATH 269,A00,098043,Rhoades; Brendon Patrick,10,0,10,0
1668175882558,MATH 270B,A00,098044,Li; Bo,10,0,15,5
1668175882991,MATH 272B,A00,098045,Holst; Michael J,13,0,15,2
1668175883420,MATH 273A,A00,098046,Tian; Xiaochuan,10,0,15,5
1668175883855,MATH 275,A01,098048,Tian; Xiaochuan,6,0,10,4
1668175884290,MATH 278A,A00,098049,Holst; Michael J,8,0,10,2
1668175884725,MATH 278B,A00,098050,Cloninger; Alexander,10,0,10,0
1668175885153,MATH 278C,A00,098051,Nie; Jiawang,7,0,10,3
1668175885586,MATH 280B,A00,098052,Zheng; Tianyi,10,0,15,5
1668175886020,MATH 281B,A00,098053,Bradic; Jelena,2,0,15,13
1668175886445,MATH 282B,A00,098054,Arias-Castro; Ery,0,0,15,15
1668175886873,MATH 285,A00,098055,Fitzsimmons; Patrick J,0,0,15,17
1668175887307,MATH 287B,A00,098056,Arias-Castro; Ery,2,0,15,13
1668175887743,MATH 288,A00,098057,Agarwal; Pooja,9,0,10,1
1668175887743,MATH 288,B00,098058,Zhang; Danna,8,0,10,2
1668175887743,MATH 288,C00,098059,Williams; Ruth J,10,0,10,0
1668175888179,MATH 290B,A00,098060,Roberts; Justin Deritter,13,0,15,2
1668175888606,MATH 292,A00,098061,Belmont; Eva Kinoshita,10,0,10,0
1668175889032,MATH 295,A00,098062,Suk; Andrew Hoon,48,0,50,2
1668175889463,MATH 296,A00,098063,Novak; Jonathan I,20,0,20,0
1668175889900,MATH 297,001,098064,Gamst; Anthony Collins,9997,0,9999,2
1668176391943,COGS 205,A00,101395,Chiba; Andrea,19,0,20,1
1668176392375,COGS 210B,001,101404,Greene; Deanna Jacquelyn,9998,0,9999,1
1668176392375,COGS 210B,002,101417,Xia; Haijun,9999,0,9999,0
1668176392375,COGS 210B,003,101422,Nitz; Douglas A.,9999,0,9999,0
1668176392375,COGS 210B,004,101423,Hollan; James D.,9998,0,9999,1
1668176392375,COGS 210B,005,101424,Deak; Gedeon O.,9998,0,9999,1
1668176392375,COGS 210B,006,101425,Rossano; Federico,9999,0,9999,0
1668176392801,COGS 211B,A00,101427,Coulson; Seana M,9996,0,9999,3
1668176393227,COGS 220,A00,101428,Hollan; James D.,0,0,25,25
1668176393654,COGS 229,A00,101429,Dow; Steven P,18,0,25,7
1668176394087,COGS 230,A00,101430,Klemmer; Scott R,12,0,17,5
1668176394511,COGS 234,A00,101431,Xia; Haijun,3,0,25,22
1668176394937,COGS 260,A00,101432,Kiyonaga; Anastasia,20,0,25,5
1668176394937,COGS 260,B00,101433,Kirsh; David Joel,16,0,25,9
1668176395463,CSE 202,A00,102371,Impagliazzo; Russell,0,0,0,0
1668176395893,CSE 203B,A01,102373,Cheng; Chung Kuan,0,0,0,0
1668176396322,CSE 208,A00,102374,Micciancio; Daniele,0,0,0,0
1668176396748,CSE 209A,A00,112895,Impagliazzo; Russell,0,0,15,15
1668176397173,CSE 209B,A00,108005,Bellare; Mihir,0,0,0,0
1668176397599,CSE 210,A00,113163,Coblenz; Michael J,0,0,0,0
1668176398024,CSE 219,A00,106111,Dow; Steven P,0,0,20,20
1668176398450,CSE 221,A00,102376,Voelker; Geoffrey M.,0,0,0,0
1668176398877,CSE 224,A01,102378,Porter; George M,0,0,0,0
1668176399301,CSE 229A,A00,102379,Savage; Stefan,0,0,0,0
1668176399727,CSE 229C,A00,102380,Munyaka; Imani N. S.,0,0,0,0
1668176400155,CSE 232B,A00,102382,Deutsch; Alin Bernard,0,0,0,0
1668176400587,CSE 234,A01,112904,Kumar; Arun Kumar,0,0,0,0
1668176401026,CSE 237A,A00,102383,Rosing; Tajana Simunic,0,0,0,0
1668176401450,CSE 239A,A00,102384,Deutsch; Alin Bernard,0,0,0,0
1668176401879,CSE 239B,A00,102385,Polikarpova; Nadezhda,0,0,0,0
1668176402315,CSE 240A,A00,102386,Pannuto; Patrick William,0,0,0,0
1668176402744,CSE 240B,A00,102387,Zhao; Jishen,0,0,0,0
1668176403170,CSE 241A,A00,106406,Kang; Mingu,0,0,0,0
1668176403597,CSE 249B,A00,102388,Kahng; Andrew Byun,0,0,8,8
1668176404026,CSE 251B,A01,102392,Cottrell; Garrison W,0,0,0,0
1668176404026,CSE 251B,A02,102393,Cottrell; Garrison W,0,0,0,0
1668176404455,CSE 252B,A00,102394,Ochoa; Benjamin Lawrence,0,0,0,0
1668176404880,CSE 257,A01,102396,Gao; Sicun,0,0,0,0
1668176405308,CSE 272,A00,102397,Li; Tzumao,0,0,0,0
1668176405731,CSE 274,A00,111323,Chern; Albert Ren-Haur,0,0,0,0
1668176406157,CSE 282,A00,102398,Pevzner; Pavel Arkadjevich,0,0,0,0
1668176406586,CSE 284,A00,114175,Gymrek; Melissa Ann,0,0,0,0
1668176407018,CSE 290,A00,102399,Chandraker; Manmohan Krishna,0,0,0,0
1668176407018,CSE 290,B00,102400,Vaccaro; Kristen Marie,0,0,25,25
1668176407018,CSE 290,C00,102414,Pannuto; Patrick William,0,0,25,25
1668176407018,CSE 290,D00,102427,Pevzner; Pavel Arkadjevich,0,0,0,0
1668176407018,CSE 290,E00,102429,Zhao; Jishen,0,0,0,0
1668176407018,CSE 290,F00,102436,Tullsen; Dean Michael,0,0,0,0
1668176407018,CSE 290,G00,102440,Christensen; Henrik I,0,0,20,20
1668176407447,CSE 291,A00,102443,Su; Hao,0,0,0,0
1668176407447,CSE 291,B00,102448,Polikarpova; Nadezhda,0,0,0,0
1668176407447,CSE 291,C00,102453,Vaccaro; Kristen Marie,0,0,0,0
1668176407447,CSE 291,D00,111343,Savage; Stefan,0,0,0,0
1668176407447,CSE 291,E00,116474,Claffy; Kimberly Claire,0,0,0,0
1668176407447,CSE 291,F00,116479,Pasquale; Joseph,0,0,0,0
1668176407887,CSE 293,001,119111,Bafna; Vineet,9999,0,9999,0
1668176407887,CSE 293,002,119118,Bellare; Mihir,9999,0,9999,0
1668176407887,CSE 293,003,119122,Berg-Kirkpatrick; Taylor D,9999,0,9999,0
1668176407887,CSE 293,004,119135,Christensen; Henrik I,9999,0,9999,0
1668176407887,CSE 293,005,119142,Cottrell; Garrison W,9999,0,9999,0
1668176407887,CSE 293,006,119146,Deutsch; Alin Bernard,9999,0,9999,0
1668176407887,CSE 293,007,119159,Esmaeilzadeh; Hadi,9999,0,9999,0
1668176407887,CSE 293,008,119166,Freund; Yoav,9999,0,9999,0
1668176407887,CSE 293,009,119170,Griswold; William G.,9999,0,9999,0
1668176407887,CSE 293,010,119183,Gymrek; Melissa Ann,9999,0,9999,0
1668176407887,CSE 293,011,119190,Heninger; Nadia A,9999,0,9999,0
1668176407887,CSE 293,012,119230,Impagliazzo; Russell,9999,0,9999,0
1668176407887,CSE 293,013,119232,Jhala; Ranjit,9999,0,9999,0
1668176407887,CSE 293,014,119233,Kahng; Andrew Byun,9999,0,9999,0
1668176407887,CSE 293,015,119298,Kane; Daniel Mertz,9999,0,9999,0
1668176407887,CSE 293,016,119299,Kriegman; David J,9999,0,9999,0
1668176407887,CSE 293,017,119300,Kumar; Arun Kumar,9999,0,9999,0
1668176407887,CSE 293,018,119301,Lerner; Sorin,9999,0,9999,0
1668176407887,CSE 293,019,119302,Lovett; Shachar,9999,0,9999,0
1668176407887,CSE 293,020,119303,McAuley; Julian John,9999,0,9999,0
1668176407887,CSE 293,021,119304,Micciancio; Daniele,9999,0,9999,0
1668176407887,CSE 293,022,119367,Orailoglu; Alex,9999,0,9999,0
1668176407887,CSE 293,023,119382,Paturi; Ramamohan,9999,0,9999,0
1668176407887,CSE 293,024,119404,Polikarpova; Nadezhda,9999,0,9999,0
1668176407887,CSE 293,025,119406,Politz; Joseph Gibbs,9999,0,9999,0
1668176407887,CSE 293,026,119411,Porter; George M,9999,0,9999,0
1668176407887,CSE 293,027,119414,Porter; Leonard Emerson,9999,0,9999,0
1668176407887,CSE 293,028,119416,Ramamoorthi; Ravi,9999,0,9999,0
1668176407887,CSE 293,029,119417,Sahoo; Debashis,9999,0,9999,0
1668176407887,CSE 293,030,119420,Saul; Lawrence,9999,0,9999,0
1668176407887,CSE 293,031,119421,Savage; Stefan,9999,0,9999,0
1668176407887,CSE 293,032,119425,Schulze; Jurgen P.,9999,0,9999,0
1668176407887,CSE 293,033,119426,Snoeren; Alex C.,9999,0,9999,0
1668176407887,CSE 293,034,119428,Shang; Jingbo,9999,0,9999,0
1668176407887,CSE 293,035,119430,Stefan; Deian,9999,0,9999,0
1668176407887,CSE 293,036,119431,Su; Hao,9999,0,9999,0
1668176407887,CSE 293,037,119433,Swanson; Steven James,9999,0,9999,0
1668176407887,CSE 293,038,119435,Tullsen; Dean Michael,9999,0,9999,0
1668176407887,CSE 293,039,119483,Voelker; Geoffrey M.,9999,0,9999,0
1668176407887,CSE 293,040,119537,Zhao; Jishen,9999,0,9999,0
1668176407887,CSE 293,041,119538,Zhou; Yuan-Yuan,9999,0,9999,0
1668176407887,CSE 293,042,119539,Gao; Sicun,9999,0,9999,0
1668176407887,CSE 293,043,119540,Weibel; Nadir,9999,0,9999,0
1668176407887,CSE 293,044,119541,Gupta; Rajesh K.,9999,0,9999,0
1668176407887,CSE 293,045,126410,Vaccaro; Kristen Marie,9999,0,9999,0
1668176407887,CSE 293,046,126411,Klemke; Richard,9999,0,9999,0
1668176408316,CSE 294,A00,102459,Voelker; Geoffrey M.,0,0,0,0
1668176408316,CSE 294,B00,111322,Orailoglu; Alex,0,0,0,0
1668176408745,DSE 201,A00,096914,Deutsch; Alin Bernard,30,0,30,0
1668176409185,DSE 210,A00,096915,Dasgupta; Sanjoy,30,0,30,0
1668176409610,DSE 260A,A00,096916,Altintas De Callaf; Ilkay,30,0,30,0
1668176410119,ECE 200,001,103586,Antipa; Nicholas A,9999,0,9999,0
1668176410119,ECE 200,002,103587,Atanasov; Nikolay A.,9999,0,9999,0
1668176410119,ECE 200,003,103588,Bharadia; Dinesh,9999,0,9999,0
1668176410119,ECE 200,004,103589,Cheng; Chung Kuan,9999,0,9999,0
1668176410119,ECE 200,005,103590,Cosman; Pamela C.,9999,0,9999,0
1668176410119,ECE 200,006,103591,Dayeh; Shadi Ahmad,9999,0,9999,0
1668176410119,ECE 200,007,103592,Fainman; Yeshaiahu,9999,0,9999,0
1668176410119,ECE 200,008,103593,Ford; Joseph Earl,9999,0,9999,0
1668176410119,ECE 200,009,103594,Franceschetti; Massimo,9999,0,9999,0
1668176410119,ECE 200,010,103595,Fullerton; Eric E,9999,0,9999,0
1668176410119,ECE 200,011,103596,Galton; Ian A,9999,0,9999,0
1668176410119,ECE 200,012,103597,Gilja; Vikash,9999,0,9999,0
1668176410119,ECE 200,013,103598,Hall; Drew A.,9999,0,9999,0
1668176410119,ECE 200,014,103599,Hsueh; Tzu-Chien,9999,0,9999,0
1668176410119,ECE 200,015,103600,Javidi; Tara,9999,0,9999,0
1668176410119,ECE 200,016,103601,Kahng; Andrew Byun,9999,0,9999,0
1668176410119,ECE 200,017,103602,Kim; Young-Han,9999,0,9999,0
1668176410119,ECE 200,018,103603,Koushanfar; Farinaz,9999,0,9999,0
1668176410119,ECE 200,019,103604,Kuzum; Duygu,9999,0,9999,0
1668176410119,ECE 200,020,103605,Le; Hanh-Phuc,9999,0,9999,0
1668176410119,ECE 200,021,103606,Lin; Bill,9999,0,9999,0
1668176410119,ECE 200,022,103607,Liu; Zhaowei,9998,0,9999,1
1668176410119,ECE 200,023,103608,Lo; Yu-Hwa,9999,0,9999,0
1668176410119,ECE 200,024,103609,Lomakin; Vitaliy,9999,0,9999,0
1668176410119,ECE 200,025,103610,Mercier; Patrick Philip,9999,0,9999,0
1668176410119,ECE 200,026,103611,Meyer; Florian,9999,0,9999,0
1668176410119,ECE 200,027,103612,Milstein; Laurence B.,9999,0,9999,0
1668176410119,ECE 200,028,103613,Mir Arabbaygi; Siavash,9999,0,9999,0
1668176410119,ECE 200,029,103614,Mookherjea; Shayan,9999,0,9999,0
1668176410119,ECE 200,030,103615,Morris; Karcher William,9999,0,9999,0
1668176410119,ECE 200,031,103616,Ng; Tse Nga,9999,0,9999,0
1668176410119,ECE 200,032,103617,Nguyen; Truong Quang,9999,0,9999,0
1668176410119,ECE 200,033,103618,Nomura; Kenji,9999,0,9999,0
1668176410119,ECE 200,034,103619,Orlitsky; Alon,9999,0,9999,0
1668176410119,ECE 200,035,103620,Pal; Piya,9999,0,9999,0
1668176410119,ECE 200,036,103621,Papen; George C.,9999,0,9999,0
1668176410119,ECE 200,037,103622,Radic; Stojan,9999,0,9999,0
1668176410119,ECE 200,038,103623,Rao; Bhaskar D.,9999,0,9999,0
1668176410119,ECE 200,039,103624,Rao; Ramesh R,9999,0,9999,0
1668176410119,ECE 200,040,103625,Rebeiz; Gabriel,9999,0,9999,0
1668176410119,ECE 200,041,103626,Sanford; John R,9999,0,9999,0
1668176410119,ECE 200,042,103627,Siegel; Paul H.,9999,0,9999,0
1668176410119,ECE 200,043,103628,Sievenpiper; Daniel F.,9999,0,9999,0
1668176410119,ECE 200,044,103629,Sworder; David D.,9999,0,9999,0
1668176410119,ECE 200,045,103630,Taur; Yuan,9999,0,9999,0
1668176410119,ECE 200,046,103631,Touri; Behrouz,9999,0,9999,0
1668176410119,ECE 200,047,103632,Trivedi; Mohan M.,9999,0,9999,0
1668176410119,ECE 200,048,103633,Vasconcelos; Nuno,9999,0,9999,0
1668176410119,ECE 200,049,103634,Wang; Xiaolong,9999,0,9999,0
1668176410119,ECE 200,050,103635,Xie; Pengtao,9999,0,9999,0
1668176410119,ECE 200,051,103636,Yip; Michael,9999,0,9999,0
1668176410119,ECE 200,052,103637,Zeger; Kenneth A.,999,0,999,0
1668176410119,ECE 200,053,103638,Zhang; Xinyu,9999,0,9999,0
1668176410119,ECE 200,054,103639,Turakhia; Yatish Girish,9999,0,9999,0
1668176410119,ECE 200,055,103640,Kang; Mingu,9999,0,9999,0
1668176410119,ECE 200,056,103641,Shi; Yuanyuan,9999,0,9999,0
1668176410119,ECE 200,057,103642,Wang; Edward Jay,9999,0,9999,0
1668176410119,ECE 200,058,103643,Zheng; Yang,9999,0,9999,0
1668176410545,ECE 202,A00,103644,Kuzum; Duygu,0,0,0,0
1668176410970,ECE 212BN,A00,103646,Ng; Tse Nga,0,0,0,0
1668176411398,ECE 221,A00,111493,Staff,0,0,0,0
1668176411824,ECE 222B,A00,103647,Lomakin; Vitaliy,0,0,0,0
1668176412251,ECE 230B,A00,103648,Taur; Yuan,0,0,0,0
1668176412677,ECE 238B,A00,103649,Garay; Javier,0,0,0,0
1668176413103,ECE 240B,A00,112900,Fainman; Yeshaiahu,0,0,0,0
1668176413536,ECE 247A,A00,103650,Jokerst; Jesse Vincent,0,0,0,0
1668176413964,ECE 247B,A00,103651,Wang; Joseph,0,0,0,0
1668176414390,ECE 250,A00,103652,Siegel; Paul H.,0,0,0,0
1668176414817,ECE 251A,A00,103654,Rao; Bhaskar D.,0,0,0,0
1668176415248,ECE 257B,A00,103655,Bharadia; Dinesh,0,0,0,0
1668176415675,ECE 258A,A00,103656,Milstein; Laurence B.,0,0,0,0
1668176416101,ECE 260B,A00,103658,Kang; Mingu,0,0,0,0
1668176416525,ECE 264A,A00,103659,Galton; Ian A,0,0,0,0
1668176416953,ECE 265A,A00,103661,Gudem; Prasad S.S.,0,0,0,0
1668176417377,ECE 265D,A00,103662,Gudem; Prasad S.S.,0,0,0,0
1668176417805,ECE 268,A00,103663,Koushanfar; Farinaz,0,0,0,0
1668176418233,ECE 269,A01,103665,Pal; Piya,0,0,0,0
1668176418658,ECE 271B,A00,103666,Vasconcelos; Manuela,0,0,0,0
1668176419084,ECE 276A,A00,103667,Atanasov; Nikolay A.,0,0,0,0
1668176419510,ECE 277,A00,103668,An; Cheolhong,0,0,0,0
1668176419941,ECE 279,A00,117947,Hall; Drew A.,0,0,0,0
1668176420805,ECE 283,A00,103670,Hsueh; Tzu-Chien,0,0,0,0
1668176421253,ECE 284,A00,103671,Turakhia; Yatish Girish,0,0,0,0
1668176421679,ECE 285,A00,103672,Zheng; Yang,0,0,0,0
1668176421679,ECE 285,B00,103673,Sworder; David D.,0,0,0,0
1668176422103,ECE 287,A00,103676,Javidi; Tara,0,0,0,0
1668176422530,MATH 200B,A00,098023,Salehi Golsefidy; Alireza,12,0,15,3
1668176422955,MATH 202B,A00,098024,Rhoades; Brendon Patrick,9,0,15,6
1668176423381,MATH 203B,A00,098025,Oprea; Dragos N.,10,0,15,5
1668176423817,MATH 204B,A00,098026,Sorensen; Claus M,13,0,15,2
1668176424252,MATH 208,A00,098027,Izadi; Elham,7,0,10,3
1668176424681,MATH 209,A00,098028,Pollack; Aaron,10,0,10,0
1668176425106,MATH 211A,A00,112919,Rogalski; Daniel,9,0,10,1
1668176425546,MATH 211B,A00,112920,Seward; Brandon M.,9,0,10,1
1668176425974,MATH 218,A00,098029,Li; Bo,10,0,10,0
1668176426399,MATH 220B,A00,098030,Novak; Jonathan I,11,0,15,4
1668176426832,MATH 221A,A00,098031,Ebenfelt; Peter F,13,0,15,2
1668176427259,MATH 231B,A00,098032,Zlatos; Andrej,12,0,15,3
1668176427684,MATH 240B,A00,098033,Ni; Lei,9,0,15,6
1668176428108,MATH 243,A00,098034,Jekel; David Andrew,10,0,10,0
1668176428534,MATH 245A,A00,098035,Nie; Jiawang,0,0,15,16
1668176428959,MATH 248,A00,098036,Bejenaru; Ioan,10,0,10,0
1668176429389,MATH 250B,A00,098037,Spolaor; Luca,14,0,15,1
1668176429815,MATH 258,A00,098038,Ni; Lei,10,0,10,0
1668176430239,MATH 264B,A00,098041,Rhoades; Brendon Patrick,9,0,15,6
1668176430675,MATH 268,A00,098042,Buss; Samuel R,10,0,10,0
1668176431109,MATH 269,A00,098043,Rhoades; Brendon Patrick,10,0,10,0
1668176431535,MATH 270B,A00,098044,Li; Bo,10,0,15,5
1668176431958,MATH 272B,A00,098045,Holst; Michael J,13,0,15,2
1668176432383,MATH 273A,A00,098046,Tian; Xiaochuan,10,0,15,5
1668176432812,MATH 275,A01,098048,Tian; Xiaochuan,6,0,10,4
1668176433238,MATH 278A,A00,098049,Holst; Michael J,8,0,10,2
1668176433664,MATH 278B,A00,098050,Cloninger; Alexander,10,0,10,0
1668176434092,MATH 278C,A00,098051,Nie; Jiawang,7,0,10,3
1668176434517,MATH 280B,A00,098052,Zheng; Tianyi,10,0,15,5
1668176434945,MATH 281B,A00,098053,Bradic; Jelena,2,0,15,13
1668176435373,MATH 282B,A00,098054,Arias-Castro; Ery,0,0,15,15
1668176435800,MATH 285,A00,098055,Fitzsimmons; Patrick J,0,0,15,17
1668176436226,MATH 287B,A00,098056,Arias-Castro; Ery,2,0,15,13
1668176436658,MATH 288,A00,098057,Agarwal; Pooja,9,0,10,1
1668176436658,MATH 288,B00,098058,Zhang; Danna,8,0,10,2
1668176436658,MATH 288,C00,098059,Williams; Ruth J,10,0,10,0
1668176437081,MATH 290B,A00,098060,Roberts; Justin Deritter,13,0,15,2
1668176437508,MATH 292,A00,098061,Belmont; Eva Kinoshita,10,0,10,0
1668176437934,MATH 295,A00,098062,Suk; Andrew Hoon,48,0,50,2
1668176438361,MATH 296,A00,098063,Novak; Jonathan I,20,0,20,0
1668176438874,MATH 297,001,098064,Gamst; Anthony Collins,9997,0,9999,2
1668176942238,COGS 205,A00,101395,Chiba; Andrea,19,0,20,1
1668176942672,COGS 210B,001,101404,Greene; Deanna Jacquelyn,9998,0,9999,1
1668176942672,COGS 210B,002,101417,Xia; Haijun,9999,0,9999,0
1668176942672,COGS 210B,003,101422,Nitz; Douglas A.,9999,0,9999,0
1668176942672,COGS 210B,004,101423,Hollan; James D.,9998,0,9999,1
1668176942672,COGS 210B,005,101424,Deak; Gedeon O.,9998,0,9999,1
1668176942672,COGS 210B,006,101425,Rossano; Federico,9999,0,9999,0
1668176943100,COGS 211B,A00,101427,Coulson; Seana M,9996,0,9999,3
1668176943525,COGS 220,A00,101428,Hollan; James D.,0,0,25,25
1668176943953,COGS 229,A00,101429,Dow; Steven P,18,0,25,7
1668176944385,COGS 230,A00,101430,Klemmer; Scott R,12,0,17,5
1668176944810,COGS 234,A00,101431,Xia; Haijun,3,0,25,22
1668176945237,COGS 260,A00,101432,Kiyonaga; Anastasia,20,0,25,5
1668176945237,COGS 260,B00,101433,Kirsh; David Joel,16,0,25,9
1668176945666,CSE 202,A00,102371,Impagliazzo; Russell,0,0,0,0
1668176946094,CSE 203B,A01,102373,Cheng; Chung Kuan,0,0,0,0
1668176946521,CSE 208,A00,102374,Micciancio; Daniele,0,0,0,0
1668176946949,CSE 209A,A00,112895,Impagliazzo; Russell,0,0,15,15
1668176947375,CSE 209B,A00,108005,Bellare; Mihir,0,0,0,0
1668176947805,CSE 210,A00,113163,Coblenz; Michael J,0,0,0,0
1668176948230,CSE 219,A00,106111,Dow; Steven P,0,0,20,20
1668176948667,CSE 221,A00,102376,Voelker; Geoffrey M.,0,0,0,0
1668176949092,CSE 224,A01,102378,Porter; George M,0,0,0,0
1668176949515,CSE 229A,A00,102379,Savage; Stefan,0,0,0,0
1668176949944,CSE 229C,A00,102380,Munyaka; Imani N. S.,0,0,0,0
1668176950375,CSE 232B,A00,102382,Deutsch; Alin Bernard,0,0,0,0
1668176950810,CSE 234,A01,112904,Kumar; Arun Kumar,0,0,0,0
1668176951239,CSE 237A,A00,102383,Rosing; Tajana Simunic,0,0,0,0
1668176951666,CSE 239A,A00,102384,Deutsch; Alin Bernard,0,0,0,0
1668176952092,CSE 239B,A00,102385,Polikarpova; Nadezhda,0,0,0,0
1668176952517,CSE 240A,A00,102386,Pannuto; Patrick William,0,0,0,0
1668176952942,CSE 240B,A00,102387,Zhao; Jishen,0,0,0,0
1668176953373,CSE 241A,A00,106406,Kang; Mingu,0,0,0,0
1668176953803,CSE 249B,A00,102388,Kahng; Andrew Byun,0,0,8,8
1668176954247,CSE 251B,A01,102392,Cottrell; Garrison W,0,0,0,0
1668176954247,CSE 251B,A02,102393,Cottrell; Garrison W,0,0,0,0
1668176954686,CSE 252B,A00,102394,Ochoa; Benjamin Lawrence,0,0,0,0
1668176955117,CSE 257,A01,102396,Gao; Sicun,0,0,0,0
1668176955541,CSE 272,A00,102397,Li; Tzumao,0,0,0,0
1668176955966,CSE 274,A00,111323,Chern; Albert Ren-Haur,0,0,0,0
1668176956390,CSE 282,A00,102398,Pevzner; Pavel Arkadjevich,0,0,0,0
1668176956815,CSE 284,A00,114175,Gymrek; Melissa Ann,0,0,0,0
1668176957247,CSE 290,A00,102399,Chandraker; Manmohan Krishna,0,0,0,0
1668176957247,CSE 290,B00,102400,Vaccaro; Kristen Marie,0,0,25,25
1668176957247,CSE 290,C00,102414,Pannuto; Patrick William,0,0,25,25
1668176957247,CSE 290,D00,102427,Pevzner; Pavel Arkadjevich,0,0,0,0
1668176957247,CSE 290,E00,102429,Zhao; Jishen,0,0,0,0
1668176957247,CSE 290,F00,102436,Tullsen; Dean Michael,0,0,0,0
1668176957247,CSE 290,G00,102440,Christensen; Henrik I,0,0,20,20
1668176957674,CSE 291,A00,102443,Su; Hao,0,0,0,0
1668176957674,CSE 291,B00,102448,Polikarpova; Nadezhda,0,0,0,0
1668176957674,CSE 291,C00,102453,Vaccaro; Kristen Marie,0,0,0,0
1668176957674,CSE 291,D00,111343,Savage; Stefan,0,0,0,0
1668176957674,CSE 291,E00,116474,Claffy; Kimberly Claire,0,0,0,0
1668176957674,CSE 291,F00,116479,Pasquale; Joseph,0,0,0,0
1668176958117,CSE 293,001,119111,Bafna; Vineet,9999,0,9999,0
1668176958117,CSE 293,002,119118,Bellare; Mihir,9999,0,9999,0
1668176958117,CSE 293,003,119122,Berg-Kirkpatrick; Taylor D,9999,0,9999,0
1668176958117,CSE 293,004,119135,Christensen; Henrik I,9999,0,9999,0
1668176958117,CSE 293,005,119142,Cottrell; Garrison W,9999,0,9999,0
1668176958117,CSE 293,006,119146,Deutsch; Alin Bernard,9999,0,9999,0
1668176958117,CSE 293,007,119159,Esmaeilzadeh; Hadi,9999,0,9999,0
1668176958117,CSE 293,008,119166,Freund; Yoav,9999,0,9999,0
1668176958117,CSE 293,009,119170,Griswold; William G.,9999,0,9999,0
1668176958117,CSE 293,010,119183,Gymrek; Melissa Ann,9999,0,9999,0
1668176958117,CSE 293,011,119190,Heninger; Nadia A,9999,0,9999,0
1668176958117,CSE 293,012,119230,Impagliazzo; Russell,9999,0,9999,0
1668176958117,CSE 293,013,119232,Jhala; Ranjit,9999,0,9999,0
1668176958117,CSE 293,014,119233,Kahng; Andrew Byun,9999,0,9999,0
1668176958117,CSE 293,015,119298,Kane; Daniel Mertz,9999,0,9999,0
1668176958117,CSE 293,016,119299,Kriegman; David J,9999,0,9999,0
1668176958117,CSE 293,017,119300,Kumar; Arun Kumar,9999,0,9999,0
1668176958117,CSE 293,018,119301,Lerner; Sorin,9999,0,9999,0
1668176958117,CSE 293,019,119302,Lovett; Shachar,9999,0,9999,0
1668176958117,CSE 293,020,119303,McAuley; Julian John,9999,0,9999,0
1668176958117,CSE 293,021,119304,Micciancio; Daniele,9999,0,9999,0
1668176958117,CSE 293,022,119367,Orailoglu; Alex,9999,0,9999,0
1668176958117,CSE 293,023,119382,Paturi; Ramamohan,9999,0,9999,0
1668176958117,CSE 293,024,119404,Polikarpova; Nadezhda,9999,0,9999,0
1668176958117,CSE 293,025,119406,Politz; Joseph Gibbs,9999,0,9999,0
1668176958117,CSE 293,026,119411,Porter; George M,9999,0,9999,0
1668176958117,CSE 293,027,119414,Porter; Leonard Emerson,9999,0,9999,0
1668176958117,CSE 293,028,119416,Ramamoorthi; Ravi,9999,0,9999,0
1668176958117,CSE 293,029,119417,Sahoo; Debashis,9999,0,9999,0
1668176958117,CSE 293,030,119420,Saul; Lawrence,9999,0,9999,0
1668176958117,CSE 293,031,119421,Savage; Stefan,9999,0,9999,0
1668176958117,CSE 293,032,119425,Schulze; Jurgen P.,9999,0,9999,0
1668176958117,CSE 293,033,119426,Snoeren; Alex C.,9999,0,9999,0
1668176958117,CSE 293,034,119428,Shang; Jingbo,9999,0,9999,0
1668176958117,CSE 293,035,119430,Stefan; Deian,9999,0,9999,0
1668176958117,CSE 293,036,119431,Su; Hao,9999,0,9999,0
1668176958117,CSE 293,037,119433,Swanson; Steven James,9999,0,9999,0
1668176958117,CSE 293,038,119435,Tullsen; Dean Michael,9999,0,9999,0
1668176958117,CSE 293,039,119483,Voelker; Geoffrey M.,9999,0,9999,0
1668176958117,CSE 293,040,119537,Zhao; Jishen,9999,0,9999,0
1668176958117,CSE 293,041,119538,Zhou; Yuan-Yuan,9999,0,9999,0
1668176958117,CSE 293,042,119539,Gao; Sicun,9999,0,9999,0
1668176958117,CSE 293,043,119540,Weibel; Nadir,9999,0,9999,0
1668176958117,CSE 293,044,119541,Gupta; Rajesh K.,9999,0,9999,0
1668176958117,CSE 293,045,126410,Vaccaro; Kristen Marie,9999,0,9999,0
1668176958117,CSE 293,046,126411,Klemke; Richard,9999,0,9999,0
1668176958546,CSE 294,A00,102459,Voelker; Geoffrey M.,0,0,0,0
1668176958546,CSE 294,B00,111322,Orailoglu; Alex,0,0,0,0
1668176958973,DSE 201,A00,096914,Deutsch; Alin Bernard,30,0,30,0
1668176959400,DSE 210,A00,096915,Dasgupta; Sanjoy,30,0,30,0
1668176959824,DSE 260A,A00,096916,Altintas De Callaf; Ilkay,30,0,30,0
1668176960283,ECE 200,001,103586,Antipa; Nicholas A,9999,0,9999,0
1668176960283,ECE 200,002,103587,Atanasov; Nikolay A.,9999,0,9999,0
1668176960283,ECE 200,003,103588,Bharadia; Dinesh,9999,0,9999,0
1668176960283,ECE 200,004,103589,Cheng; Chung Kuan,9999,0,9999,0
1668176960283,ECE 200,005,103590,Cosman; Pamela C.,9999,0,9999,0
1668176960283,ECE 200,006,103591,Dayeh; Shadi Ahmad,9999,0,9999,0
1668176960283,ECE 200,007,103592,Fainman; Yeshaiahu,9999,0,9999,0
1668176960283,ECE 200,008,103593,Ford; Joseph Earl,9999,0,9999,0
1668176960283,ECE 200,009,103594,Franceschetti; Massimo,9999,0,9999,0
1668176960283,ECE 200,010,103595,Fullerton; Eric E,9999,0,9999,0
1668176960283,ECE 200,011,103596,Galton; Ian A,9999,0,9999,0
1668176960283,ECE 200,012,103597,Gilja; Vikash,9999,0,9999,0
1668176960283,ECE 200,013,103598,Hall; Drew A.,9999,0,9999,0
1668176960283,ECE 200,014,103599,Hsueh; Tzu-Chien,9999,0,9999,0
1668176960283,ECE 200,015,103600,Javidi; Tara,9999,0,9999,0
1668176960283,ECE 200,016,103601,Kahng; Andrew Byun,9999,0,9999,0
1668176960283,ECE 200,017,103602,Kim; Young-Han,9999,0,9999,0
1668176960283,ECE 200,018,103603,Koushanfar; Farinaz,9999,0,9999,0
1668176960283,ECE 200,019,103604,Kuzum; Duygu,9999,0,9999,0
1668176960283,ECE 200,020,103605,Le; Hanh-Phuc,9999,0,9999,0
1668176960283,ECE 200,021,103606,Lin; Bill,9999,0,9999,0
1668176960283,ECE 200,022,103607,Liu; Zhaowei,9998,0,9999,1
1668176960283,ECE 200,023,103608,Lo; Yu-Hwa,9999,0,9999,0
1668176960283,ECE 200,024,103609,Lomakin; Vitaliy,9999,0,9999,0
1668176960283,ECE 200,025,103610,Mercier; Patrick Philip,9999,0,9999,0
1668176960283,ECE 200,026,103611,Meyer; Florian,9999,0,9999,0
1668176960283,ECE 200,027,103612,Milstein; Laurence B.,9999,0,9999,0
1668176960283,ECE 200,028,103613,Mir Arabbaygi; Siavash,9999,0,9999,0
1668176960283,ECE 200,029,103614,Mookherjea; Shayan,9999,0,9999,0
1668176960283,ECE 200,030,103615,Morris; Karcher William,9999,0,9999,0
1668176960283,ECE 200,031,103616,Ng; Tse Nga,9999,0,9999,0
1668176960283,ECE 200,032,103617,Nguyen; Truong Quang,9999,0,9999,0
1668176960283,ECE 200,033,103618,Nomura; Kenji,9999,0,9999,0
1668176960283,ECE 200,034,103619,Orlitsky; Alon,9999,0,9999,0
1668176960283,ECE 200,035,103620,Pal; Piya,9999,0,9999,0
1668176960283,ECE 200,036,103621,Papen; George C.,9999,0,9999,0
1668176960283,ECE 200,037,103622,Radic; Stojan,9999,0,9999,0
1668176960283,ECE 200,038,103623,Rao; Bhaskar D.,9999,0,9999,0
1668176960283,ECE 200,039,103624,Rao; Ramesh R,9999,0,9999,0
1668176960283,ECE 200,040,103625,Rebeiz; Gabriel,9999,0,9999,0
1668176960283,ECE 200,041,103626,Sanford; John R,9999,0,9999,0
1668176960283,ECE 200,042,103627,Siegel; Paul H.,9999,0,9999,0
1668176960283,ECE 200,043,103628,Sievenpiper; Daniel F.,9999,0,9999,0
1668176960283,ECE 200,044,103629,Sworder; David D.,9999,0,9999,0
1668176960283,ECE 200,045,103630,Taur; Yuan,9999,0,9999,0
1668176960283,ECE 200,046,103631,Touri; Behrouz,9999,0,9999,0
1668176960283,ECE 200,047,103632,Trivedi; Mohan M.,9999,0,9999,0
1668176960283,ECE 200,048,103633,Vasconcelos; Nuno,9999,0,9999,0
1668176960283,ECE 200,049,103634,Wang; Xiaolong,9999,0,9999,0
1668176960283,ECE 200,050,103635,Xie; Pengtao,9999,0,9999,0
1668176960283,ECE 200,051,103636,Yip; Michael,9999,0,9999,0
1668176960283,ECE 200,052,103637,Zeger; Kenneth A.,999,0,999,0
1668176960283,ECE 200,053,103638,Zhang; Xinyu,9999,0,9999,0
1668176960283,ECE 200,054,103639,Turakhia; Yatish Girish,9999,0,9999,0
1668176960283,ECE 200,055,103640,Kang; Mingu,9999,0,9999,0
1668176960283,ECE 200,056,103641,Shi; Yuanyuan,9999,0,9999,0
1668176960283,ECE 200,057,103642,Wang; Edward Jay,9999,0,9999,0
1668176960283,ECE 200,058,103643,Zheng; Yang,9999,0,9999,0
1668176960710,ECE 202,A00,103644,Kuzum; Duygu,0,0,0,0
1668176961135,ECE 212BN,A00,103646,Ng; Tse Nga,0,0,0,0
1668176961562,ECE 221,A00,111493,Staff,0,0,0,0
1668176961989,ECE 222B,A00,103647,Lomakin; Vitaliy,0,0,0,0
1668176962488,ECE 230B,A00,103648,Taur; Yuan,0,0,0,0
1668176962914,ECE 238B,A00,103649,Garay; Javier,0,0,0,0
1668176963338,ECE 240B,A00,112900,Fainman; Yeshaiahu,0,0,0,0
1668176963762,ECE 247A,A00,103650,Jokerst; Jesse Vincent,0,0,0,0
1668176964188,ECE 247B,A00,103651,Wang; Joseph,0,0,0,0
1668176964618,ECE 250,A00,103652,Siegel; Paul H.,0,0,0,0
1668176965045,ECE 251A,A00,103654,Rao; Bhaskar D.,0,0,0,0
1668176965469,ECE 257B,A00,103655,Bharadia; Dinesh,0,0,0,0
1668176965893,ECE 258A,A00,103656,Milstein; Laurence B.,0,0,0,0
1668176966333,ECE 260B,A00,103658,Kang; Mingu,0,0,0,0
1668176966765,ECE 264A,A00,103659,Galton; Ian A,0,0,0,0
1668176967194,ECE 265A,A00,103661,Gudem; Prasad S.S.,0,0,0,0
1668176967616,ECE 265D,A00,103662,Gudem; Prasad S.S.,0,0,0,0
1668176968042,ECE 268,A00,103663,Koushanfar; Farinaz,0,0,0,0
1668176968467,ECE 269,A01,103665,Pal; Piya,0,0,0,0
1668176968896,ECE 271B,A00,103666,Vasconcelos; Manuela,0,0,0,0
1668176969320,ECE 276A,A00,103667,Atanasov; Nikolay A.,0,0,0,0
1668176969747,ECE 277,A00,103668,An; Cheolhong,0,0,0,0
1668176970174,ECE 279,A00,117947,Hall; Drew A.,0,0,0,0
1668176971038,ECE 283,A00,103670,Hsueh; Tzu-Chien,0,0,0,0
1668176971465,ECE 284,A00,103671,Turakhia; Yatish Girish,0,0,0,0
1668176971901,ECE 285,A00,103672,Zheng; Yang,0,0,0,0
1668176971901,ECE 285,B00,103673,Sworder; David D.,0,0,0,0
1668176972337,ECE 287,A00,103676,Javidi; Tara,0,0,0,0
1668176972769,MATH 200B,A00,098023,Salehi Golsefidy; Alireza,12,0,15,3
1668176973195,MATH 202B,A00,098024,Rhoades; Brendon Patrick,9,0,15,6
1668176973620,MATH 203B,A00,098025,Oprea; Dragos N.,10,0,15,5
1668176974062,MATH 204B,A00,098026,Sorensen; Claus M,13,0,15,2
1668176974499,MATH 208,A00,098027,Izadi; Elham,7,0,10,3
1668176974927,MATH 209,A00,098028,Pollack; Aaron,10,0,10,0
1668176975354,MATH 211A,A00,112919,Rogalski; Daniel,9,0,10,1
1668176975778,MATH 211B,A00,112920,Seward; Brandon M.,9,0,10,1
1668176976204,MATH 218,A00,098029,Li; Bo,10,0,10,0
1668176976629,MATH 220B,A00,098030,Novak; Jonathan I,11,0,15,4
1668176977053,MATH 221A,A00,098031,Ebenfelt; Peter F,13,0,15,2
1668176977480,MATH 231B,A00,098032,Zlatos; Andrej,12,0,15,3
1668176977906,MATH 240B,A00,098033,Ni; Lei,9,0,15,6
1668176978334,MATH 243,A00,098034,Jekel; David Andrew,10,0,10,0
1668176978758,MATH 245A,A00,098035,Nie; Jiawang,0,0,15,16
1668176979184,MATH 248,A00,098036,Bejenaru; Ioan,10,0,10,0
1668176979616,MATH 250B,A00,098037,Spolaor; Luca,14,0,15,1
1668176980046,MATH 258,A00,098038,Ni; Lei,10,0,10,0
1668176980470,MATH 264B,A00,098041,Rhoades; Brendon Patrick,9,0,15,6
1668176980894,MATH 268,A00,098042,Buss; Samuel R,10,0,10,0
1668176981322,MATH 269,A00,098043,Rhoades; Brendon Patrick,10,0,10,0
1668176981761,MATH 270B,A00,098044,Li; Bo,10,0,15,5
1668176982190,MATH 272B,A00,098045,Holst; Michael J,13,0,15,2
1668176982614,MATH 273A,A00,098046,Tian; Xiaochuan,10,0,15,5
1668176983043,MATH 275,A01,098048,Tian; Xiaochuan,6,0,10,4
1668176983476,MATH 278A,A00,098049,Holst; Michael J,8,0,10,2
1668176983901,MATH 278B,A00,098050,Cloninger; Alexander,10,0,10,0
1668176984325,MATH 278C,A00,098051,Nie; Jiawang,7,0,10,3
1668176984750,MATH 280B,A00,098052,Zheng; Tianyi,10,0,15,5
1668176985177,MATH 281B,A00,098053,Bradic; Jelena,2,0,15,13
1668176985603,MATH 282B,A00,098054,Arias-Castro; Ery,0,0,15,15
1668176986032,MATH 285,A00,098055,Fitzsimmons; Patrick J,0,0,15,17
1668176986459,MATH 287B,A00,098056,Arias-Castro; Ery,2,0,15,13
1668176986888,MATH 288,A00,098057,Agarwal; Pooja,9,0,10,1
1668176986888,MATH 288,B00,098058,Zhang; Danna,8,0,10,2
1668176986888,MATH 288,C00,098059,Williams; Ruth J,10,0,10,0
1668176987320,MATH 290B,A00,098060,Roberts; Justin Deritter,13,0,15,2
1668176987745,MATH 292,A00,098061,Belmont; Eva Kinoshita,10,0,10,0
1668176988172,MATH 295,A00,098062,Suk; Andrew Hoon,48,0,50,2
1668176988595,MATH 296,A00,098063,Novak; Jonathan I,20,0,20,0
1668176989022,MATH 297,001,098064,Gamst; Anthony Collins,9997,0,9999,2
1668177490986,COGS 205,A00,101395,Chiba; Andrea,19,0,20,1
1668177491426,COGS 210B,001,101404,Greene; Deanna Jacquelyn,9998,0,9999,1
1668177491426,COGS 210B,002,101417,Xia; Haijun,9999,0,9999,0
1668177491426,COGS 210B,003,101422,Nitz; Douglas A.,9999,0,9999,0
1668177491426,COGS 210B,004,101423,Hollan; James D.,9998,0,9999,1
1668177491426,COGS 210B,005,101424,Deak; Gedeon O.,9998,0,9999,1
1668177491426,COGS 210B,006,101425,Rossano; Federico,9999,0,9999,0
1668177491856,COGS 211B,A00,101427,Coulson; Seana M,9996,0,9999,3
1668177492287,COGS 220,A00,101428,Hollan; James D.,0,0,25,25
1668177492713,COGS 229,A00,101429,Dow; Steven P,18,0,25,7
1668177493141,COGS 230,A00,101430,Klemmer; Scott R,12,0,17,5
1668177493563,COGS 234,A00,101431,Xia; Haijun,3,0,25,22
1668177493989,COGS 260,A00,101432,Kiyonaga; Anastasia,20,0,25,5
1668177493989,COGS 260,B00,101433,Kirsh; David Joel,16,0,25,9
1668177494417,CSE 202,A00,102371,Impagliazzo; Russell,0,0,0,0
1668177494845,CSE 203B,A01,102373,Cheng; Chung Kuan,0,0,0,0
1668177495271,CSE 208,A00,102374,Micciancio; Daniele,0,0,0,0
1668177495705,CSE 209A,A00,112895,Impagliazzo; Russell,0,0,15,15
1668177496130,CSE 209B,A00,108005,Bellare; Mihir,0,0,0,0
1668177496554,CSE 210,A00,113163,Coblenz; Michael J,0,0,0,0
1668177496980,CSE 219,A00,106111,Dow; Steven P,0,0,20,20
1668177497406,CSE 221,A00,102376,Voelker; Geoffrey M.,0,0,0,0
1668177497833,CSE 224,A01,102378,Porter; George M,0,0,0,0
1668177498257,CSE 229A,A00,102379,Savage; Stefan,0,0,0,0
1668177498681,CSE 229C,A00,102380,Munyaka; Imani N. S.,0,0,0,0
1668177499111,CSE 232B,A00,102382,Deutsch; Alin Bernard,0,0,0,0
1668177499534,CSE 234,A01,112904,Kumar; Arun Kumar,0,0,0,0
1668177499961,CSE 237A,A00,102383,Rosing; Tajana Simunic,0,0,0,0
1668177500384,CSE 239A,A00,102384,Deutsch; Alin Bernard,0,0,0,0
1668177500827,CSE 239B,A00,102385,Polikarpova; Nadezhda,0,0,0,0
1668177501261,CSE 240A,A00,102386,Pannuto; Patrick William,0,0,0,0
1668177501685,CSE 240B,A00,102387,Zhao; Jishen,0,0,0,0
1668177502115,CSE 241A,A00,106406,Kang; Mingu,0,0,0,0
1668177502541,CSE 249B,A00,102388,Kahng; Andrew Byun,0,0,8,8
1668177502970,CSE 251B,A01,102392,Cottrell; Garrison W,0,0,0,0
1668177502970,CSE 251B,A02,102393,Cottrell; Garrison W,0,0,0,0
1668177503398,CSE 252B,A00,102394,Ochoa; Benjamin Lawrence,0,0,0,0
1668177503825,CSE 257,A01,102396,Gao; Sicun,0,0,0,0
1668177504254,CSE 272,A00,102397,Li; Tzumao,0,0,0,0
1668177504677,CSE 274,A00,111323,Chern; Albert Ren-Haur,0,0,0,0
1668177505104,CSE 282,A00,102398,Pevzner; Pavel Arkadjevich,0,0,0,0
1668177505529,CSE 284,A00,114175,Gymrek; Melissa Ann,0,0,0,0
1668177505962,CSE 290,A00,102399,Chandraker; Manmohan Krishna,0,0,0,0
1668177505962,CSE 290,B00,102400,Vaccaro; Kristen Marie,0,0,25,25
1668177505962,CSE 290,C00,102414,Pannuto; Patrick William,0,0,25,25
1668177505962,CSE 290,D00,102427,Pevzner; Pavel Arkadjevich,0,0,0,0
1668177505962,CSE 290,E00,102429,Zhao; Jishen,0,0,0,0
1668177505962,CSE 290,F00,102436,Tullsen; Dean Michael,0,0,0,0
1668177505962,CSE 290,G00,102440,Christensen; Henrik I,0,0,20,20
1668177506389,CSE 291,A00,102443,Su; Hao,0,0,0,0
1668177506389,CSE 291,B00,102448,Polikarpova; Nadezhda,0,0,0,0
1668177506389,CSE 291,C00,102453,Vaccaro; Kristen Marie,0,0,0,0
1668177506389,CSE 291,D00,111343,Savage; Stefan,0,0,0,0
1668177506389,CSE 291,E00,116474,Claffy; Kimberly Claire,0,0,0,0
1668177506389,CSE 291,F00,116479,Pasquale; Joseph,0,0,0,0
1668177506834,CSE 293,001,119111,Bafna; Vineet,9999,0,9999,0
1668177506834,CSE 293,002,119118,Bellare; Mihir,9999,0,9999,0
1668177506834,CSE 293,003,119122,Berg-Kirkpatrick; Taylor D,9999,0,9999,0
1668177506834,CSE 293,004,119135,Christensen; Henrik I,9999,0,9999,0
1668177506834,CSE 293,005,119142,Cottrell; Garrison W,9999,0,9999,0
1668177506834,CSE 293,006,119146,Deutsch; Alin Bernard,9999,0,9999,0
1668177506834,CSE 293,007,119159,Esmaeilzadeh; Hadi,9999,0,9999,0
1668177506834,CSE 293,008,119166,Freund; Yoav,9999,0,9999,0
1668177506834,CSE 293,009,119170,Griswold; William G.,9999,0,9999,0
1668177506834,CSE 293,010,119183,Gymrek; Melissa Ann,9999,0,9999,0
1668177506834,CSE 293,011,119190,Heninger; Nadia A,9999,0,9999,0
1668177506834,CSE 293,012,119230,Impagliazzo; Russell,9999,0,9999,0
1668177506834,CSE 293,013,119232,Jhala; Ranjit,9999,0,9999,0
1668177506834,CSE 293,014,119233,Kahng; Andrew Byun,9999,0,9999,0
1668177506834,CSE 293,015,119298,Kane; Daniel Mertz,9999,0,9999,0
1668177506834,CSE 293,016,119299,Kriegman; David J,9999,0,9999,0
1668177506834,CSE 293,017,119300,Kumar; Arun Kumar,9999,0,9999,0
1668177506834,CSE 293,018,119301,Lerner; Sorin,9999,0,9999,0
1668177506834,CSE 293,019,119302,Lovett; Shachar,9999,0,9999,0
1668177506834,CSE 293,020,119303,McAuley; Julian John,9999,0,9999,0
1668177506834,CSE 293,021,119304,Micciancio; Daniele,9999,0,9999,0
1668177506834,CSE 293,022,119367,Orailoglu; Alex,9999,0,9999,0
1668177506834,CSE 293,023,119382,Paturi; Ramamohan,9999,0,9999,0
1668177506834,CSE 293,024,119404,Polikarpova; Nadezhda,9999,0,9999,0
1668177506834,CSE 293,025,119406,Politz; Joseph Gibbs,9999,0,9999,0
1668177506834,CSE 293,026,119411,Porter; George M,9999,0,9999,0
1668177506834,CSE 293,027,119414,Porter; Leonard Emerson,9999,0,9999,0
1668177506834,CSE 293,028,119416,Ramamoorthi; Ravi,9999,0,9999,0
1668177506834,CSE 293,029,119417,Sahoo; Debashis,9999,0,9999,0
1668177506834,CSE 293,030,119420,Saul; Lawrence,9999,0,9999,0
1668177506834,CSE 293,031,119421,Savage; Stefan,9999,0,9999,0
1668177506834,CSE 293,032,119425,Schulze; Jurgen P.,9999,0,9999,0
1668177506834,CSE 293,033,119426,Snoeren; Alex C.,9999,0,9999,0
1668177506834,CSE 293,034,119428,Shang; Jingbo,9999,0,9999,0
1668177506834,CSE 293,035,119430,Stefan; Deian,9999,0,9999,0
1668177506834,CSE 293,036,119431,Su; Hao,9999,0,9999,0
1668177506834,CSE 293,037,119433,Swanson; Steven James,9999,0,9999,0
1668177506834,CSE 293,038,119435,Tullsen; Dean Michael,9999,0,9999,0
1668177506834,CSE 293,039,119483,Voelker; Geoffrey M.,9999,0,9999,0
1668177506834,CSE 293,040,119537,Zhao; Jishen,9999,0,9999,0
1668177506834,CSE 293,041,119538,Zhou; Yuan-Yuan,9999,0,9999,0
1668177506834,CSE 293,042,119539,Gao; Sicun,9999,0,9999,0
1668177506834,CSE 293,043,119540,Weibel; Nadir,9999,0,9999,0
1668177506834,CSE 293,044,119541,Gupta; Rajesh K.,9999,0,9999,0
1668177506834,CSE 293,045,126410,Vaccaro; Kristen Marie,9999,0,9999,0
1668177506834,CSE 293,046,126411,Klemke; Richard,9999,0,9999,0
1668177507263,CSE 294,A00,102459,Voelker; Geoffrey M.,0,0,0,0
1668177507263,CSE 294,B00,111322,Orailoglu; Alex,0,0,0,0
1668177507693,DSE 201,A00,096914,Deutsch; Alin Bernard,30,0,30,0
1668177508117,DSE 210,A00,096915,Dasgupta; Sanjoy,30,0,30,0
1668177508544,DSE 260A,A00,096916,Altintas De Callaf; Ilkay,30,0,30,0
1668177509031,ECE 200,001,103586,Antipa; Nicholas A,9999,0,9999,0
1668177509031,ECE 200,002,103587,Atanasov; Nikolay A.,9999,0,9999,0
1668177509031,ECE 200,003,103588,Bharadia; Dinesh,9999,0,9999,0
1668177509031,ECE 200,004,103589,Cheng; Chung Kuan,9999,0,9999,0
1668177509031,ECE 200,005,103590,Cosman; Pamela C.,9999,0,9999,0
1668177509031,ECE 200,006,103591,Dayeh; Shadi Ahmad,9999,0,9999,0
1668177509031,ECE 200,007,103592,Fainman; Yeshaiahu,9999,0,9999,0
1668177509031,ECE 200,008,103593,Ford; Joseph Earl,9999,0,9999,0
1668177509031,ECE 200,009,103594,Franceschetti; Massimo,9999,0,9999,0
1668177509031,ECE 200,010,103595,Fullerton; Eric E,9999,0,9999,0
1668177509031,ECE 200,011,103596,Galton; Ian A,9999,0,9999,0
1668177509031,ECE 200,012,103597,Gilja; Vikash,9999,0,9999,0
1668177509031,ECE 200,013,103598,Hall; Drew A.,9999,0,9999,0
1668177509031,ECE 200,014,103599,Hsueh; Tzu-Chien,9999,0,9999,0
1668177509031,ECE 200,015,103600,Javidi; Tara,9999,0,9999,0
1668177509031,ECE 200,016,103601,Kahng; Andrew Byun,9999,0,9999,0
1668177509031,ECE 200,017,103602,Kim; Young-Han,9999,0,9999,0
1668177509031,ECE 200,018,103603,Koushanfar; Farinaz,9999,0,9999,0
1668177509031,ECE 200,019,103604,Kuzum; Duygu,9999,0,9999,0
1668177509031,ECE 200,020,103605,Le; Hanh-Phuc,9999,0,9999,0
1668177509031,ECE 200,021,103606,Lin; Bill,9999,0,9999,0
1668177509031,ECE 200,022,103607,Liu; Zhaowei,9998,0,9999,1
1668177509031,ECE 200,023,103608,Lo; Yu-Hwa,9999,0,9999,0
1668177509031,ECE 200,024,103609,Lomakin; Vitaliy,9999,0,9999,0
1668177509031,ECE 200,025,103610,Mercier; Patrick Philip,9999,0,9999,0
1668177509031,ECE 200,026,103611,Meyer; Florian,9999,0,9999,0
1668177509031,ECE 200,027,103612,Milstein; Laurence B.,9999,0,9999,0
1668177509031,ECE 200,028,103613,Mir Arabbaygi; Siavash,9999,0,9999,0
1668177509031,ECE 200,029,103614,Mookherjea; Shayan,9999,0,9999,0
1668177509031,ECE 200,030,103615,Morris; Karcher William,9999,0,9999,0
1668177509031,ECE 200,031,103616,Ng; Tse Nga,9999,0,9999,0
1668177509031,ECE 200,032,103617,Nguyen; Truong Quang,9999,0,9999,0
1668177509031,ECE 200,033,103618,Nomura; Kenji,9999,0,9999,0
1668177509031,ECE 200,034,103619,Orlitsky; Alon,9999,0,9999,0
1668177509031,ECE 200,035,103620,Pal; Piya,9999,0,9999,0
1668177509031,ECE 200,036,103621,Papen; George C.,9999,0,9999,0
1668177509031,ECE 200,037,103622,Radic; Stojan,9999,0,9999,0
1668177509031,ECE 200,038,103623,Rao; Bhaskar D.,9999,0,9999,0
1668177509031,ECE 200,039,103624,Rao; Ramesh R,9999,0,9999,0
1668177509031,ECE 200,040,103625,Rebeiz; Gabriel,9999,0,9999,0
1668177509031,ECE 200,041,103626,Sanford; John R,9999,0,9999,0
1668177509031,ECE 200,042,103627,Siegel; Paul H.,9999,0,9999,0
1668177509031,ECE 200,043,103628,Sievenpiper; Daniel F.,9999,0,9999,0
1668177509031,ECE 200,044,103629,Sworder; David D.,9999,0,9999,0
1668177509031,ECE 200,045,103630,Taur; Yuan,9999,0,9999,0
1668177509031,ECE 200,046,103631,Touri; Behrouz,9999,0,9999,0
1668177509031,ECE 200,047,103632,Trivedi; Mohan M.,9999,0,9999,0
1668177509031,ECE 200,048,103633,Vasconcelos; Nuno,9999,0,9999,0
1668177509031,ECE 200,049,103634,Wang; Xiaolong,9999,0,9999,0
1668177509031,ECE 200,050,103635,Xie; Pengtao,9999,0,9999,0
1668177509031,ECE 200,051,103636,Yip; Michael,9999,0,9999,0
1668177509031,ECE 200,052,103637,Zeger; Kenneth A.,999,0,999,0
1668177509031,ECE 200,053,103638,Zhang; Xinyu,9999,0,9999,0
1668177509031,ECE 200,054,103639,Turakhia; Yatish Girish,9999,0,9999,0
1668177509031,ECE 200,055,103640,Kang; Mingu,9999,0,9999,0
1668177509031,ECE 200,056,103641,Shi; Yuanyuan,9999,0,9999,0
1668177509031,ECE 200,057,103642,Wang; Edward Jay,9999,0,9999,0
1668177509031,ECE 200,058,103643,Zheng; Yang,9999,0,9999,0
1668177509458,ECE 202,A00,103644,Kuzum; Duygu,0,0,0,0
1668177509883,ECE 212BN,A00,103646,Ng; Tse Nga,0,0,0,0
1668177510308,ECE 221,A00,111493,Staff,0,0,0,0
1668177510733,ECE 222B,A00,103647,Lomakin; Vitaliy,0,0,0,0
1668177511166,ECE 230B,A00,103648,Taur; Yuan,0,0,0,0
1668177511590,ECE 238B,A00,103649,Garay; Javier,0,0,0,0
1668177512028,ECE 240B,A00,112900,Fainman; Yeshaiahu,0,0,0,0
1668177512454,ECE 247A,A00,103650,Jokerst; Jesse Vincent,0,0,0,0
1668177512885,ECE 247B,A00,103651,Wang; Joseph,0,0,0,0
1668177513333,ECE 250,A00,103652,Siegel; Paul H.,0,0,0,0
1668177513757,ECE 251A,A00,103654,Rao; Bhaskar D.,0,0,0,0
1668177514184,ECE 257B,A00,103655,Bharadia; Dinesh,0,0,0,0
1668177514618,ECE 258A,A00,103656,Milstein; Laurence B.,0,0,0,0
1668177515044,ECE 260B,A00,103658,Kang; Mingu,0,0,0,0
1668177515470,ECE 264A,A00,103659,Galton; Ian A,0,0,0,0
1668177515906,ECE 265A,A00,103661,Gudem; Prasad S.S.,0,0,0,0
1668177516334,ECE 265D,A00,103662,Gudem; Prasad S.S.,0,0,0,0
1668177516757,ECE 268,A00,103663,Koushanfar; Farinaz,0,0,0,0
1668177517194,ECE 269,A01,103665,Pal; Piya,0,0,0,0
1668177517621,ECE 271B,A00,103666,Vasconcelos; Manuela,0,0,0,0
1668177518046,ECE 276A,A00,103667,Atanasov; Nikolay A.,0,0,0,0
1668177518475,ECE 277,A00,103668,An; Cheolhong,0,0,0,0
1668177518899,ECE 279,A00,117947,Hall; Drew A.,0,0,0,0
1668177519749,ECE 283,A00,103670,Hsueh; Tzu-Chien,0,0,0,0
1668177520177,ECE 284,A00,103671,Turakhia; Yatish Girish,0,0,0,0
1668177520605,ECE 285,A00,103672,Zheng; Yang,0,0,0,0
1668177520605,ECE 285,B00,103673,Sworder; David D.,0,0,0,0
1668177521030,ECE 287,A00,103676,Javidi; Tara,0,0,0,0
1668177521455,MATH 200B,A00,098023,Salehi Golsefidy; Alireza,12,0,15,3
1668177521885,MATH 202B,A00,098024,Rhoades; Brendon Patrick,9,0,15,6
1668177522309,MATH 203B,A00,098025,Oprea; Dragos N.,10,0,15,5
1668177522743,MATH 204B,A00,098026,Sorensen; Claus M,13,0,15,2
1668177523166,MATH 208,A00,098027,Izadi; Elham,7,0,10,3
1668177523593,MATH 209,A00,098028,Pollack; Aaron,10,0,10,0
1668177524017,MATH 211A,A00,112919,Rogalski; Daniel,9,0,10,1
1668177524448,MATH 211B,A00,112920,Seward; Brandon M.,9,0,10,1
1668177524883,MATH 218,A00,098029,Li; Bo,10,0,10,0
1668177525322,MATH 220B,A00,098030,Novak; Jonathan I,11,0,15,4
1668177525751,MATH 221A,A00,098031,Ebenfelt; Peter F,13,0,15,2
1668177526181,MATH 231B,A00,098032,Zlatos; Andrej,12,0,15,3
1668177526610,MATH 240B,A00,098033,Ni; Lei,9,0,15,6
1668177527044,MATH 243,A00,098034,Jekel; David Andrew,10,0,10,0
1668177527473,MATH 245A,A00,098035,Nie; Jiawang,0,0,15,16
1668177527992,MATH 248,A00,098036,Bejenaru; Ioan,10,0,10,0
1668177528420,MATH 250B,A00,098037,Spolaor; Luca,14,0,15,1
1668177528857,MATH 258,A00,098038,Ni; Lei,10,0,10,0
1668177529290,MATH 264B,A00,098041,Rhoades; Brendon Patrick,9,0,15,6
1668177529716,MATH 268,A00,098042,Buss; Samuel R,10,0,10,0
1668177530147,MATH 269,A00,098043,Rhoades; Brendon Patrick,10,0,10,0
1668177530574,MATH 270B,A00,098044,Li; Bo,10,0,15,5
1668177531004,MATH 272B,A00,098045,Holst; Michael J,13,0,15,2
1668177531440,MATH 273A,A00,098046,Tian; Xiaochuan,10,0,15,5
1668177531866,MATH 275,A01,098048,Tian; Xiaochuan,6,0,10,4
1668177532289,MATH 278A,A00,098049,Holst; Michael J,8,0,10,2
1668177532717,MATH 278B,A00,098050,Cloninger; Alexander,10,0,10,0
1668177533142,MATH 278C,A00,098051,Nie; Jiawang,7,0,10,3
1668177533570,MATH 280B,A00,098052,Zheng; Tianyi,10,0,15,5
1668177533998,MATH 281B,A00,098053,Bradic; Jelena,2,0,15,13
1668177534425,MATH 282B,A00,098054,Arias-Castro; Ery,0,0,15,15
1668177534849,MATH 285,A00,098055,Fitzsimmons; Patrick J,0,0,15,17
1668177535274,MATH 287B,A00,098056,Arias-Castro; Ery,2,0,15,13
1668177535700,MATH 288,A00,098057,Agarwal; Pooja,9,0,10,1
1668177535700,MATH 288,B00,098058,Zhang; Danna,8,0,10,2
1668177535700,MATH 288,C00,098059,Williams; Ruth J,10,0,10,0
1668177536125,MATH 290B,A00,098060,Roberts; Justin Deritter,13,0,15,2
1668177536547,MATH 292,A00,098061,Belmont; Eva Kinoshita,10,0,10,0
1668177536977,MATH 295,A00,098062,Suk; Andrew Hoon,48,0,50,2
1668177537402,MATH 296,A00,098063,Novak; Jonathan I,20,0,20,0
1668177537825,MATH 297,001,098064,Gamst; Anthony Collins,9997,0,9999,2
1668178040285,COGS 205,A00,101395,Chiba; Andrea,19,0,20,1
1668178040726,COGS 210B,001,101404,Greene; Deanna Jacquelyn,9998,0,9999,1
1668178040726,COGS 210B,002,101417,Xia; Haijun,9999,0,9999,0
1668178040726,COGS 210B,003,101422,Nitz; Douglas A.,9999,0,9999,0
1668178040726,COGS 210B,004,101423,Hollan; James D.,9998,0,9999,1
1668178040726,COGS 210B,005,101424,Deak; Gedeon O.,9998,0,9999,1
1668178040726,COGS 210B,006,101425,Rossano; Federico,9999,0,9999,0
1668178041155,COGS 211B,A00,101427,Coulson; Seana M,9996,0,9999,3
1668178041580,COGS 220,A00,101428,Hollan; James D.,0,0,25,25
1668178042007,COGS 229,A00,101429,Dow; Steven P,18,0,25,7
1668178042431,COGS 230,A00,101430,Klemmer; Scott R,12,0,17,5
1668178042867,COGS 234,A00,101431,Xia; Haijun,3,0,25,22
1668178043300,COGS 260,A00,101432,Kiyonaga; Anastasia,20,0,25,5
1668178043300,COGS 260,B00,101433,Kirsh; David Joel,16,0,25,9
1668178043732,CSE 202,A00,102371,Impagliazzo; Russell,0,0,0,0
1668178044161,CSE 203B,A01,102373,Cheng; Chung Kuan,0,0,0,0
1668178044587,CSE 208,A00,102374,Micciancio; Daniele,0,0,0,0
1668178045010,CSE 209A,A00,112895,Impagliazzo; Russell,0,0,15,15
1668178045436,CSE 209B,A00,108005,Bellare; Mihir,0,0,0,0
1668178045865,CSE 210,A00,113163,Coblenz; Michael J,0,0,0,0
1668178046294,CSE 219,A00,106111,Dow; Steven P,0,0,20,20
1668178046720,CSE 221,A00,102376,Voelker; Geoffrey M.,0,0,0,0
1668178047146,CSE 224,A01,102378,Porter; George M,0,0,0,0
1668178047574,CSE 229A,A00,102379,Savage; Stefan,0,0,0,0
1668178048005,CSE 229C,A00,102380,Munyaka; Imani N. S.,0,0,0,0
1668178048429,CSE 232B,A00,102382,Deutsch; Alin Bernard,0,0,0,0
1668178048857,CSE 234,A01,112904,Kumar; Arun Kumar,0,0,0,0
1668178049281,CSE 237A,A00,102383,Rosing; Tajana Simunic,0,0,0,0
1668178049706,CSE 239A,A00,102384,Deutsch; Alin Bernard,0,0,0,0
1668178050131,CSE 239B,A00,102385,Polikarpova; Nadezhda,0,0,0,0
1668178050647,CSE 240A,A00,102386,Pannuto; Patrick William,0,0,0,0
1668178051071,CSE 240B,A00,102387,Zhao; Jishen,0,0,0,0
1668178051501,CSE 241A,A00,106406,Kang; Mingu,0,0,0,0
1668178051925,CSE 249B,A00,102388,Kahng; Andrew Byun,0,0,8,8
1668178052350,CSE 251B,A01,102392,Cottrell; Garrison W,0,0,0,0
1668178052350,CSE 251B,A02,102393,Cottrell; Garrison W,0,0,0,0
1668178052779,CSE 252B,A00,102394,Ochoa; Benjamin Lawrence,0,0,0,0
1668178053206,CSE 257,A01,102396,Gao; Sicun,0,0,0,0
1668178053630,CSE 272,A00,102397,Li; Tzumao,0,0,0,0
1668178054066,CSE 274,A00,111323,Chern; Albert Ren-Haur,0,0,0,0
1668178054498,CSE 282,A00,102398,Pevzner; Pavel Arkadjevich,0,0,0,0
1668178054926,CSE 284,A00,114175,Gymrek; Melissa Ann,0,0,0,0
1668178055352,CSE 290,A00,102399,Chandraker; Manmohan Krishna,0,0,0,0
1668178055352,CSE 290,B00,102400,Vaccaro; Kristen Marie,0,0,25,25
1668178055352,CSE 290,C00,102414,Pannuto; Patrick William,0,0,25,25
1668178055352,CSE 290,D00,102427,Pevzner; Pavel Arkadjevich,0,0,0,0
1668178055352,CSE 290,E00,102429,Zhao; Jishen,0,0,0,0
1668178055352,CSE 290,F00,102436,Tullsen; Dean Michael,0,0,0,0
1668178055352,CSE 290,G00,102440,Christensen; Henrik I,0,0,20,20
1668178055785,CSE 291,A00,102443,Su; Hao,0,0,0,0
1668178055785,CSE 291,B00,102448,Polikarpova; Nadezhda,0,0,0,0
1668178055785,CSE 291,C00,102453,Vaccaro; Kristen Marie,0,0,0,0
1668178055785,CSE 291,D00,111343,Savage; Stefan,0,0,0,0
1668178055785,CSE 291,E00,116474,Claffy; Kimberly Claire,0,0,0,0
1668178055785,CSE 291,F00,116479,Pasquale; Joseph,0,0,0,0
1668178056230,CSE 293,001,119111,Bafna; Vineet,9999,0,9999,0
1668178056230,CSE 293,002,119118,Bellare; Mihir,9999,0,9999,0
1668178056230,CSE 293,003,119122,Berg-Kirkpatrick; Taylor D,9999,0,9999,0
1668178056230,CSE 293,004,119135,Christensen; Henrik I,9999,0,9999,0
1668178056230,CSE 293,005,119142,Cottrell; Garrison W,9999,0,9999,0
1668178056230,CSE 293,006,119146,Deutsch; Alin Bernard,9999,0,9999,0
1668178056230,CSE 293,007,119159,Esmaeilzadeh; Hadi,9999,0,9999,0
1668178056230,CSE 293,008,119166,Freund; Yoav,9999,0,9999,0
1668178056230,CSE 293,009,119170,Griswold; William G.,9999,0,9999,0
1668178056230,CSE 293,010,119183,Gymrek; Melissa Ann,9999,0,9999,0
1668178056230,CSE 293,011,119190,Heninger; Nadia A,9999,0,9999,0
1668178056230,CSE 293,012,119230,Impagliazzo; Russell,9999,0,9999,0
1668178056230,CSE 293,013,119232,Jhala; Ranjit,9999,0,9999,0
1668178056230,CSE 293,014,119233,Kahng; Andrew Byun,9999,0,9999,0
1668178056230,CSE 293,015,119298,Kane; Daniel Mertz,9999,0,9999,0
1668178056230,CSE 293,016,119299,Kriegman; David J,9999,0,9999,0
1668178056230,CSE 293,017,119300,Kumar; Arun Kumar,9999,0,9999,0
1668178056230,CSE 293,018,119301,Lerner; Sorin,9999,0,9999,0
1668178056230,CSE 293,019,119302,Lovett; Shachar,9999,0,9999,0
1668178056230,CSE 293,020,119303,McAuley; Julian John,9999,0,9999,0
1668178056230,CSE 293,021,119304,Micciancio; Daniele,9999,0,9999,0
1668178056230,CSE 293,022,119367,Orailoglu; Alex,9999,0,9999,0
1668178056230,CSE 293,023,119382,Paturi; Ramamohan,9999,0,9999,0
1668178056230,CSE 293,024,119404,Polikarpova; Nadezhda,9999,0,9999,0
1668178056230,CSE 293,025,119406,Politz; Joseph Gibbs,9999,0,9999,0
1668178056230,CSE 293,026,119411,Porter; George M,9999,0,9999,0
1668178056230,CSE 293,027,119414,Porter; Leonard Emerson,9999,0,9999,0
1668178056230,CSE 293,028,119416,Ramamoorthi; Ravi,9999,0,9999,0
1668178056230,CSE 293,029,119417,Sahoo; Debashis,9999,0,9999,0
1668178056230,CSE 293,030,119420,Saul; Lawrence,9999,0,9999,0
1668178056230,CSE 293,031,119421,Savage; Stefan,9999,0,9999,0
1668178056230,CSE 293,032,119425,Schulze; Jurgen P.,9999,0,9999,0
1668178056230,CSE 293,033,119426,Snoeren; Alex C.,9999,0,9999,0
1668178056230,CSE 293,034,119428,Shang; Jingbo,9999,0,9999,0
1668178056230,CSE 293,035,119430,Stefan; Deian,9999,0,9999,0
1668178056230,CSE 293,036,119431,Su; Hao,9999,0,9999,0
1668178056230,CSE 293,037,119433,Swanson; Steven James,9999,0,9999,0
1668178056230,CSE 293,038,119435,Tullsen; Dean Michael,9999,0,9999,0
1668178056230,CSE 293,039,119483,Voelker; Geoffrey M.,9999,0,9999,0
1668178056230,CSE 293,040,119537,Zhao; Jishen,9999,0,9999,0
1668178056230,CSE 293,041,119538,Zhou; Yuan-Yuan,9999,0,9999,0
1668178056230,CSE 293,042,119539,Gao; Sicun,9999,0,9999,0
1668178056230,CSE 293,043,119540,Weibel; Nadir,9999,0,9999,0
1668178056230,CSE 293,044,119541,Gupta; Rajesh K.,9999,0,9999,0
1668178056230,CSE 293,045,126410,Vaccaro; Kristen Marie,9999,0,9999,0
1668178056230,CSE 293,046,126411,Klemke; Richard,9999,0,9999,0
1668178056654,CSE 294,A00,102459,Voelker; Geoffrey M.,0,0,0,0
1668178056654,CSE 294,B00,111322,Orailoglu; Alex,0,0,0,0
1668178057079,DSE 201,A00,096914,Deutsch; Alin Bernard,30,0,30,0
1668178057504,DSE 210,A00,096915,Dasgupta; Sanjoy,30,0,30,0
1668178057939,DSE 260A,A00,096916,Altintas De Callaf; Ilkay,30,0,30,0
1668178058395,ECE 200,001,103586,Antipa; Nicholas A,9999,0,9999,0
1668178058395,ECE 200,002,103587,Atanasov; Nikolay A.,9999,0,9999,0
1668178058395,ECE 200,003,103588,Bharadia; Dinesh,9999,0,9999,0
1668178058395,ECE 200,004,103589,Cheng; Chung Kuan,9999,0,9999,0
1668178058395,ECE 200,005,103590,Cosman; Pamela C.,9999,0,9999,0
1668178058395,ECE 200,006,103591,Dayeh; Shadi Ahmad,9999,0,9999,0
1668178058395,ECE 200,007,103592,Fainman; Yeshaiahu,9999,0,9999,0
1668178058395,ECE 200,008,103593,Ford; Joseph Earl,9999,0,9999,0
1668178058395,ECE 200,009,103594,Franceschetti; Massimo,9999,0,9999,0
1668178058395,ECE 200,010,103595,Fullerton; Eric E,9999,0,9999,0
1668178058395,ECE 200,011,103596,Galton; Ian A,9999,0,9999,0
1668178058395,ECE 200,012,103597,Gilja; Vikash,9999,0,9999,0
1668178058395,ECE 200,013,103598,Hall; Drew A.,9999,0,9999,0
1668178058395,ECE 200,014,103599,Hsueh; Tzu-Chien,9999,0,9999,0
1668178058395,ECE 200,015,103600,Javidi; Tara,9999,0,9999,0
1668178058395,ECE 200,016,103601,Kahng; Andrew Byun,9999,0,9999,0
1668178058395,ECE 200,017,103602,Kim; Young-Han,9999,0,9999,0
1668178058395,ECE 200,018,103603,Koushanfar; Farinaz,9999,0,9999,0
1668178058395,ECE 200,019,103604,Kuzum; Duygu,9999,0,9999,0
1668178058395,ECE 200,020,103605,Le; Hanh-Phuc,9999,0,9999,0
1668178058395,ECE 200,021,103606,Lin; Bill,9999,0,9999,0
1668178058395,ECE 200,022,103607,Liu; Zhaowei,9998,0,9999,1
1668178058395,ECE 200,023,103608,Lo; Yu-Hwa,9999,0,9999,0
1668178058395,ECE 200,024,103609,Lomakin; Vitaliy,9999,0,9999,0
1668178058395,ECE 200,025,103610,Mercier; Patrick Philip,9999,0,9999,0
1668178058395,ECE 200,026,103611,Meyer; Florian,9999,0,9999,0
1668178058395,ECE 200,027,103612,Milstein; Laurence B.,9999,0,9999,0
1668178058395,ECE 200,028,103613,Mir Arabbaygi; Siavash,9999,0,9999,0
1668178058395,ECE 200,029,103614,Mookherjea; Shayan,9999,0,9999,0
1668178058395,ECE 200,030,103615,Morris; Karcher William,9999,0,9999,0
1668178058395,ECE 200,031,103616,Ng; Tse Nga,9999,0,9999,0
1668178058395,ECE 200,032,103617,Nguyen; Truong Quang,9999,0,9999,0
1668178058395,ECE 200,033,103618,Nomura; Kenji,9999,0,9999,0
1668178058395,ECE 200,034,103619,Orlitsky; Alon,9999,0,9999,0
1668178058395,ECE 200,035,103620,Pal; Piya,9999,0,9999,0
1668178058395,ECE 200,036,103621,Papen; George C.,9999,0,9999,0
1668178058395,ECE 200,037,103622,Radic; Stojan,9999,0,9999,0
1668178058395,ECE 200,038,103623,Rao; Bhaskar D.,9999,0,9999,0
1668178058395,ECE 200,039,103624,Rao; Ramesh R,9999,0,9999,0
1668178058395,ECE 200,040,103625,Rebeiz; Gabriel,9999,0,9999,0
1668178058395,ECE 200,041,103626,Sanford; John R,9999,0,9999,0
1668178058395,ECE 200,042,103627,Siegel; Paul H.,9999,0,9999,0
1668178058395,ECE 200,043,103628,Sievenpiper; Daniel F.,9999,0,9999,0
1668178058395,ECE 200,044,103629,Sworder; David D.,9999,0,9999,0
1668178058395,ECE 200,045,103630,Taur; Yuan,9999,0,9999,0
1668178058395,ECE 200,046,103631,Touri; Behrouz,9999,0,9999,0
1668178058395,ECE 200,047,103632,Trivedi; Mohan M.,9999,0,9999,0
1668178058395,ECE 200,048,103633,Vasconcelos; Nuno,9999,0,9999,0
1668178058395,ECE 200,049,103634,Wang; Xiaolong,9999,0,9999,0
1668178058395,ECE 200,050,103635,Xie; Pengtao,9999,0,9999,0
1668178058395,ECE 200,051,103636,Yip; Michael,9999,0,9999,0
1668178058395,ECE 200,052,103637,Zeger; Kenneth A.,999,0,999,0
1668178058395,ECE 200,053,103638,Zhang; Xinyu,9999,0,9999,0
1668178058395,ECE 200,054,103639,Turakhia; Yatish Girish,9999,0,9999,0
1668178058395,ECE 200,055,103640,Kang; Mingu,9999,0,9999,0
1668178058395,ECE 200,056,103641,Shi; Yuanyuan,9999,0,9999,0
1668178058395,ECE 200,057,103642,Wang; Edward Jay,9999,0,9999,0
1668178058395,ECE 200,058,103643,Zheng; Yang,9999,0,9999,0
1668178058823,ECE 202,A00,103644,Kuzum; Duygu,0,0,0,0
1668178059248,ECE 212BN,A00,103646,Ng; Tse Nga,0,0,0,0
1668178059674,ECE 221,A00,111493,Staff,0,0,0,0
1668178060102,ECE 222B,A00,103647,Lomakin; Vitaliy,0,0,0,0
1668178060530,ECE 230B,A00,103648,Taur; Yuan,0,0,0,0
1668178060958,ECE 238B,A00,103649,Garay; Javier,0,0,0,0
1668178061384,ECE 240B,A00,112900,Fainman; Yeshaiahu,0,0,0,0
1668178061809,ECE 247A,A00,103650,Jokerst; Jesse Vincent,0,0,0,0
1668178062238,ECE 247B,A00,103651,Wang; Joseph,0,0,0,0
1668178062665,ECE 250,A00,103652,Siegel; Paul H.,0,0,0,0
1668178063093,ECE 251A,A00,103654,Rao; Bhaskar D.,0,0,0,0
1668178063523,ECE 257B,A00,103655,Bharadia; Dinesh,0,0,0,0
1668178063955,ECE 258A,A00,103656,Milstein; Laurence B.,0,0,0,0
1668178064382,ECE 260B,A00,103658,Kang; Mingu,0,0,0,0
1668178064809,ECE 264A,A00,103659,Galton; Ian A,0,0,0,0
1668178065234,ECE 265A,A00,103661,Gudem; Prasad S.S.,0,0,0,0
1668178065657,ECE 265D,A00,103662,Gudem; Prasad S.S.,0,0,0,0
1668178066081,ECE 268,A00,103663,Koushanfar; Farinaz,0,0,0,0
1668178066507,ECE 269,A01,103665,Pal; Piya,0,0,0,0
1668178066933,ECE 271B,A00,103666,Vasconcelos; Manuela,0,0,0,0
1668178067362,ECE 276A,A00,103667,Atanasov; Nikolay A.,0,0,0,0
1668178067790,ECE 277,A00,103668,An; Cheolhong,0,0,0,0
1668178068216,ECE 279,A00,117947,Hall; Drew A.,0,0,0,0
1668178069067,ECE 283,A00,103670,Hsueh; Tzu-Chien,0,0,0,0
1668178069495,ECE 284,A00,103671,Turakhia; Yatish Girish,0,0,0,0
1668178069921,ECE 285,A00,103672,Zheng; Yang,0,0,0,0
1668178069921,ECE 285,B00,103673,Sworder; David D.,0,0,0,0
1668178070346,ECE 287,A00,103676,Javidi; Tara,0,0,0,0
1668178070779,MATH 200B,A00,098023,Salehi Golsefidy; Alireza,12,0,15,3
1668178071206,MATH 202B,A00,098024,Rhoades; Brendon Patrick,9,0,15,6
1668178071634,MATH 203B,A00,098025,Oprea; Dragos N.,10,0,15,5
1668178072063,MATH 204B,A00,098026,Sorensen; Claus M,13,0,15,2
1668178072488,MATH 208,A00,098027,Izadi; Elham,7,0,10,3
1668178072915,MATH 209,A00,098028,Pollack; Aaron,10,0,10,0
1668178073343,MATH 211A,A00,112919,Rogalski; Daniel,9,0,10,1
1668178073766,MATH 211B,A00,112920,Seward; Brandon M.,9,0,10,1
1668178074200,MATH 218,A00,098029,Li; Bo,10,0,10,0
1668178074630,MATH 220B,A00,098030,Novak; Jonathan I,11,0,15,4
1668178075062,MATH 221A,A00,098031,Ebenfelt; Peter F,13,0,15,2
1668178075494,MATH 231B,A00,098032,Zlatos; Andrej,12,0,15,3
1668178075919,MATH 240B,A00,098033,Ni; Lei,9,0,15,6
1668178076347,MATH 243,A00,098034,Jekel; David Andrew,10,0,10,0
1668178076775,MATH 245A,A00,098035,Nie; Jiawang,0,0,15,16
1668178077201,MATH 248,A00,098036,Bejenaru; Ioan,10,0,10,0
1668178077624,MATH 250B,A00,098037,Spolaor; Luca,14,0,15,1
1668178078048,MATH 258,A00,098038,Ni; Lei,10,0,10,0
1668178078473,MATH 264B,A00,098041,Rhoades; Brendon Patrick,9,0,15,6
1668178078901,MATH 268,A00,098042,Buss; Samuel R,10,0,10,0
1668178079326,MATH 269,A00,098043,Rhoades; Brendon Patrick,10,0,10,0
1668178079751,MATH 270B,A00,098044,Li; Bo,10,0,15,5
1668178080180,MATH 272B,A00,098045,Holst; Michael J,13,0,15,2
1668178080610,MATH 273A,A00,098046,Tian; Xiaochuan,10,0,15,5
1668178081043,MATH 275,A01,098048,Tian; Xiaochuan,6,0,10,4
1668178081467,MATH 278A,A00,098049,Holst; Michael J,8,0,10,2
1668178081889,MATH 278B,A00,098050,Cloninger; Alexander,10,0,10,0
1668178082321,MATH 278C,A00,098051,Nie; Jiawang,7,0,10,3
1668178082763,MATH 280B,A00,098052,Zheng; Tianyi,10,0,15,5
1668178083188,MATH 281B,A00,098053,Bradic; Jelena,2,0,15,13
1668178083612,MATH 282B,A00,098054,Arias-Castro; Ery,0,0,15,15
1668178084035,MATH 285,A00,098055,Fitzsimmons; Patrick J,0,0,15,17
1668178084459,MATH 287B,A00,098056,Arias-Castro; Ery,2,0,15,13
1668178084895,MATH 288,A00,098057,Agarwal; Pooja,9,0,10,1
1668178084895,MATH 288,B00,098058,Zhang; Danna,8,0,10,2
1668178084895,MATH 288,C00,098059,Williams; Ruth J,10,0,10,0
1668178085325,MATH 290B,A00,098060,Roberts; Justin Deritter,13,0,15,2
1668178085753,MATH 292,A00,098061,Belmont; Eva Kinoshita,10,0,10,0
1668178086177,MATH 295,A00,098062,Suk; Andrew Hoon,48,0,50,2
1668178086601,MATH 296,A00,098063,Novak; Jonathan I,20,0,20,0
1668178087025,MATH 297,001,098064,Gamst; Anthony Collins,9997,0,9999,2
1668178589545,COGS 205,A00,101395,Chiba; Andrea,19,0,20,1
1668178589971,COGS 210B,001,101404,Greene; Deanna Jacquelyn,9998,0,9999,1
1668178589971,COGS 210B,002,101417,Xia; Haijun,9999,0,9999,0
1668178589971,COGS 210B,003,101422,Nitz; Douglas A.,9999,0,9999,0
1668178589971,COGS 210B,004,101423,Hollan; James D.,9998,0,9999,1
1668178589971,COGS 210B,005,101424,Deak; Gedeon O.,9998,0,9999,1
1668178589971,COGS 210B,006,101425,Rossano; Federico,9999,0,9999,0
1668178590396,COGS 211B,A00,101427,Coulson; Seana M,9996,0,9999,3
1668178590822,COGS 220,A00,101428,Hollan; James D.,0,0,25,25
1668178591246,COGS 229,A00,101429,Dow; Steven P,18,0,25,7
1668178591673,COGS 230,A00,101430,Klemmer; Scott R,12,0,17,5
1668178592099,COGS 234,A00,101431,Xia; Haijun,3,0,25,22
1668178592524,COGS 260,A00,101432,Kiyonaga; Anastasia,20,0,25,5
1668178592524,COGS 260,B00,101433,Kirsh; David Joel,16,0,25,9
1668178592950,CSE 202,A00,102371,Impagliazzo; Russell,0,0,0,0
1668178593383,CSE 203B,A01,102373,Cheng; Chung Kuan,0,0,0,0
1668178593808,CSE 208,A00,102374,Micciancio; Daniele,0,0,0,0
1668178594244,CSE 209A,A00,112895,Impagliazzo; Russell,0,0,15,15
1668178594683,CSE 209B,A00,108005,Bellare; Mihir,0,0,0,0
1668178595118,CSE 210,A00,113163,Coblenz; Michael J,0,0,0,0
1668178595551,CSE 219,A00,106111,Dow; Steven P,0,0,20,20
1668178595977,CSE 221,A00,102376,Voelker; Geoffrey M.,0,0,0,0
1668178596416,CSE 224,A01,102378,Porter; George M,0,0,0,0
1668178596847,CSE 229A,A00,102379,Savage; Stefan,0,0,0,0
1668178597272,CSE 229C,A00,102380,Munyaka; Imani N. S.,0,0,0,0
1668178597702,CSE 232B,A00,102382,Deutsch; Alin Bernard,0,0,0,0
1668178598129,CSE 234,A01,112904,Kumar; Arun Kumar,0,0,0,0
1668178598555,CSE 237A,A00,102383,Rosing; Tajana Simunic,0,0,0,0
1668178598980,CSE 239A,A00,102384,Deutsch; Alin Bernard,0,0,0,0
1668178599403,CSE 239B,A00,102385,Polikarpova; Nadezhda,0,0,0,0
1668178599829,CSE 240A,A00,102386,Pannuto; Patrick William,0,0,0,0
1668178600253,CSE 240B,A00,102387,Zhao; Jishen,0,0,0,0
1668178600689,CSE 241A,A00,106406,Kang; Mingu,0,0,0,0
1668178601114,CSE 249B,A00,102388,Kahng; Andrew Byun,0,0,8,8
1668178601546,CSE 251B,A01,102392,Cottrell; Garrison W,0,0,0,0
1668178601546,CSE 251B,A02,102393,Cottrell; Garrison W,0,0,0,0
1668178601971,CSE 252B,A00,102394,Ochoa; Benjamin Lawrence,0,0,0,0
1668178602395,CSE 257,A01,102396,Gao; Sicun,0,0,0,0
1668178602818,CSE 272,A00,102397,Li; Tzumao,0,0,0,0
1668178603245,CSE 274,A00,111323,Chern; Albert Ren-Haur,0,0,0,0
1668178603681,CSE 282,A00,102398,Pevzner; Pavel Arkadjevich,0,0,0,0
1668178604112,CSE 284,A00,114175,Gymrek; Melissa Ann,0,0,0,0
1668178604542,CSE 290,A00,102399,Chandraker; Manmohan Krishna,0,0,0,0
1668178604542,CSE 290,B00,102400,Vaccaro; Kristen Marie,0,0,25,25
1668178604542,CSE 290,C00,102414,Pannuto; Patrick William,0,0,25,25
1668178604542,CSE 290,D00,102427,Pevzner; Pavel Arkadjevich,0,0,0,0
1668178604542,CSE 290,E00,102429,Zhao; Jishen,0,0,0,0
1668178604542,CSE 290,F00,102436,Tullsen; Dean Michael,0,0,0,0
1668178604542,CSE 290,G00,102440,Christensen; Henrik I,0,0,20,20
1668178604978,CSE 291,A00,102443,Su; Hao,0,0,0,0
1668178604978,CSE 291,B00,102448,Polikarpova; Nadezhda,0,0,0,0
1668178604978,CSE 291,C00,102453,Vaccaro; Kristen Marie,0,0,0,0
1668178604978,CSE 291,D00,111343,Savage; Stefan,0,0,0,0
1668178604978,CSE 291,E00,116474,Claffy; Kimberly Claire,0,0,0,0
1668178604978,CSE 291,F00,116479,Pasquale; Joseph,0,0,0,0
1668178605436,CSE 293,001,119111,Bafna; Vineet,9999,0,9999,0
1668178605436,CSE 293,002,119118,Bellare; Mihir,9999,0,9999,0
1668178605436,CSE 293,003,119122,Berg-Kirkpatrick; Taylor D,9999,0,9999,0
1668178605436,CSE 293,004,119135,Christensen; Henrik I,9999,0,9999,0
1668178605436,CSE 293,005,119142,Cottrell; Garrison W,9999,0,9999,0
1668178605436,CSE 293,006,119146,Deutsch; Alin Bernard,9999,0,9999,0
1668178605436,CSE 293,007,119159,Esmaeilzadeh; Hadi,9999,0,9999,0
1668178605436,CSE 293,008,119166,Freund; Yoav,9999,0,9999,0
1668178605436,CSE 293,009,119170,Griswold; William G.,9999,0,9999,0
1668178605436,CSE 293,010,119183,Gymrek; Melissa Ann,9999,0,9999,0
1668178605436,CSE 293,011,119190,Heninger; Nadia A,9999,0,9999,0
1668178605436,CSE 293,012,119230,Impagliazzo; Russell,9999,0,9999,0
1668178605436,CSE 293,013,119232,Jhala; Ranjit,9999,0,9999,0
1668178605436,CSE 293,014,119233,Kahng; Andrew Byun,9999,0,9999,0
1668178605436,CSE 293,015,119298,Kane; Daniel Mertz,9999,0,9999,0
1668178605436,CSE 293,016,119299,Kriegman; David J,9999,0,9999,0
1668178605436,CSE 293,017,119300,Kumar; Arun Kumar,9999,0,9999,0
1668178605436,CSE 293,018,119301,Lerner; Sorin,9999,0,9999,0
1668178605436,CSE 293,019,119302,Lovett; Shachar,9999,0,9999,0
1668178605436,CSE 293,020,119303,McAuley; Julian John,9999,0,9999,0
1668178605436,CSE 293,021,119304,Micciancio; Daniele,9999,0,9999,0
1668178605436,CSE 293,022,119367,Orailoglu; Alex,9999,0,9999,0
1668178605436,CSE 293,023,119382,Paturi; Ramamohan,9999,0,9999,0
1668178605436,CSE 293,024,119404,Polikarpova; Nadezhda,9999,0,9999,0
1668178605436,CSE 293,025,119406,Politz; Joseph Gibbs,9999,0,9999,0
1668178605436,CSE 293,026,119411,Porter; George M,9999,0,9999,0
1668178605436,CSE 293,027,119414,Porter; Leonard Emerson,9999,0,9999,0
1668178605436,CSE 293,028,119416,Ramamoorthi; Ravi,9999,0,9999,0
1668178605436,CSE 293,029,119417,Sahoo; Debashis,9999,0,9999,0
1668178605436,CSE 293,030,119420,Saul; Lawrence,9999,0,9999,0
1668178605436,CSE 293,031,119421,Savage; Stefan,9999,0,9999,0
1668178605436,CSE 293,032,119425,Schulze; Jurgen P.,9999,0,9999,0
1668178605436,CSE 293,033,119426,Snoeren; Alex C.,9999,0,9999,0
1668178605436,CSE 293,034,119428,Shang; Jingbo,9999,0,9999,0
1668178605436,CSE 293,035,119430,Stefan; Deian,9999,0,9999,0
1668178605436,CSE 293,036,119431,Su; Hao,9999,0,9999,0
1668178605436,CSE 293,037,119433,Swanson; Steven James,9999,0,9999,0
1668178605436,CSE 293,038,119435,Tullsen; Dean Michael,9999,0,9999,0
1668178605436,CSE 293,039,119483,Voelker; Geoffrey M.,9999,0,9999,0
1668178605436,CSE 293,040,119537,Zhao; Jishen,9999,0,9999,0
1668178605436,CSE 293,041,119538,Zhou; Yuan-Yuan,9999,0,9999,0
1668178605436,CSE 293,042,119539,Gao; Sicun,9999,0,9999,0
1668178605436,CSE 293,043,119540,Weibel; Nadir,9999,0,9999,0
1668178605436,CSE 293,044,119541,Gupta; Rajesh K.,9999,0,9999,0
1668178605436,CSE 293,045,126410,Vaccaro; Kristen Marie,9999,0,9999,0
1668178605436,CSE 293,046,126411,Klemke; Richard,9999,0,9999,0
1668178605862,CSE 294,A00,102459,Voelker; Geoffrey M.,0,0,0,0
1668178605862,CSE 294,B00,111322,Orailoglu; Alex,0,0,0,0
1668178606290,DSE 201,A00,096914,Deutsch; Alin Bernard,30,0,30,0
1668178606723,DSE 210,A00,096915,Dasgupta; Sanjoy,30,0,30,0
1668178607153,DSE 260A,A00,096916,Altintas De Callaf; Ilkay,30,0,30,0
1668178607605,ECE 200,001,103586,Antipa; Nicholas A,9999,0,9999,0
1668178607605,ECE 200,002,103587,Atanasov; Nikolay A.,9999,0,9999,0
1668178607605,ECE 200,003,103588,Bharadia; Dinesh,9999,0,9999,0
1668178607605,ECE 200,004,103589,Cheng; Chung Kuan,9999,0,9999,0
1668178607605,ECE 200,005,103590,Cosman; Pamela C.,9999,0,9999,0
1668178607605,ECE 200,006,103591,Dayeh; Shadi Ahmad,9999,0,9999,0
1668178607605,ECE 200,007,103592,Fainman; Yeshaiahu,9999,0,9999,0
1668178607605,ECE 200,008,103593,Ford; Joseph Earl,9999,0,9999,0
1668178607605,ECE 200,009,103594,Franceschetti; Massimo,9999,0,9999,0
1668178607605,ECE 200,010,103595,Fullerton; Eric E,9999,0,9999,0
1668178607605,ECE 200,011,103596,Galton; Ian A,9999,0,9999,0
1668178607605,ECE 200,012,103597,Gilja; Vikash,9999,0,9999,0
1668178607605,ECE 200,013,103598,Hall; Drew A.,9999,0,9999,0
1668178607605,ECE 200,014,103599,Hsueh; Tzu-Chien,9999,0,9999,0
1668178607605,ECE 200,015,103600,Javidi; Tara,9999,0,9999,0
1668178607605,ECE 200,016,103601,Kahng; Andrew Byun,9999,0,9999,0
1668178607605,ECE 200,017,103602,Kim; Young-Han,9999,0,9999,0
1668178607605,ECE 200,018,103603,Koushanfar; Farinaz,9999,0,9999,0
1668178607605,ECE 200,019,103604,Kuzum; Duygu,9999,0,9999,0
1668178607605,ECE 200,020,103605,Le; Hanh-Phuc,9999,0,9999,0
1668178607605,ECE 200,021,103606,Lin; Bill,9999,0,9999,0
1668178607605,ECE 200,022,103607,Liu; Zhaowei,9998,0,9999,1
1668178607605,ECE 200,023,103608,Lo; Yu-Hwa,9999,0,9999,0
1668178607605,ECE 200,024,103609,Lomakin; Vitaliy,9999,0,9999,0
1668178607605,ECE 200,025,103610,Mercier; Patrick Philip,9999,0,9999,0
1668178607605,ECE 200,026,103611,Meyer; Florian,9999,0,9999,0
1668178607605,ECE 200,027,103612,Milstein; Laurence B.,9999,0,9999,0
1668178607605,ECE 200,028,103613,Mir Arabbaygi; Siavash,9999,0,9999,0
1668178607605,ECE 200,029,103614,Mookherjea; Shayan,9999,0,9999,0
1668178607605,ECE 200,030,103615,Morris; Karcher William,9999,0,9999,0
1668178607605,ECE 200,031,103616,Ng; Tse Nga,9999,0,9999,0
1668178607605,ECE 200,032,103617,Nguyen; Truong Quang,9999,0,9999,0
1668178607605,ECE 200,033,103618,Nomura; Kenji,9999,0,9999,0
1668178607605,ECE 200,034,103619,Orlitsky; Alon,9999,0,9999,0
1668178607605,ECE 200,035,103620,Pal; Piya,9999,0,9999,0
1668178607605,ECE 200,036,103621,Papen; George C.,9999,0,9999,0
1668178607605,ECE 200,037,103622,Radic; Stojan,9999,0,9999,0
1668178607605,ECE 200,038,103623,Rao; Bhaskar D.,9999,0,9999,0
1668178607605,ECE 200,039,103624,Rao; Ramesh R,9999,0,9999,0
1668178607605,ECE 200,040,103625,Rebeiz; Gabriel,9999,0,9999,0
1668178607605,ECE 200,041,103626,Sanford; John R,9999,0,9999,0
1668178607605,ECE 200,042,103627,Siegel; Paul H.,9999,0,9999,0
1668178607605,ECE 200,043,103628,Sievenpiper; Daniel F.,9999,0,9999,0
1668178607605,ECE 200,044,103629,Sworder; David D.,9999,0,9999,0
1668178607605,ECE 200,045,103630,Taur; Yuan,9999,0,9999,0
1668178607605,ECE 200,046,103631,Touri; Behrouz,9999,0,9999,0
1668178607605,ECE 200,047,103632,Trivedi; Mohan M.,9999,0,9999,0
1668178607605,ECE 200,048,103633,Vasconcelos; Nuno,9999,0,9999,0
1668178607605,ECE 200,049,103634,Wang; Xiaolong,9999,0,9999,0
1668178607605,ECE 200,050,103635,Xie; Pengtao,9999,0,9999,0
1668178607605,ECE 200,051,103636,Yip; Michael,9999,0,9999,0
1668178607605,ECE 200,052,103637,Zeger; Kenneth A.,999,0,999,0
1668178607605,ECE 200,053,103638,Zhang; Xinyu,9999,0,9999,0
1668178607605,ECE 200,054,103639,Turakhia; Yatish Girish,9999,0,9999,0
1668178607605,ECE 200,055,103640,Kang; Mingu,9999,0,9999,0
1668178607605,ECE 200,056,103641,Shi; Yuanyuan,9999,0,9999,0
1668178607605,ECE 200,057,103642,Wang; Edward Jay,9999,0,9999,0
1668178607605,ECE 200,058,103643,Zheng; Yang,9999,0,9999,0
1668178608039,ECE 202,A00,103644,Kuzum; Duygu,0,0,0,0
1668178608476,ECE 212BN,A00,103646,Ng; Tse Nga,0,0,0,0
1668178608901,ECE 221,A00,111493,Staff,0,0,0,0
1668178609325,ECE 222B,A00,103647,Lomakin; Vitaliy,0,0,0,0
1668178609753,ECE 230B,A00,103648,Taur; Yuan,0,0,0,0
1668178610183,ECE 238B,A00,103649,Garay; Javier,0,0,0,0
1668178610609,ECE 240B,A00,112900,Fainman; Yeshaiahu,0,0,0,0
1668178611034,ECE 247A,A00,103650,Jokerst; Jesse Vincent,0,0,0,0
1668178611458,ECE 247B,A00,103651,Wang; Joseph,0,0,0,0
1668178611883,ECE 250,A00,103652,Siegel; Paul H.,0,0,0,0
1668178612309,ECE 251A,A00,103654,Rao; Bhaskar D.,0,0,0,0
1668178612733,ECE 257B,A00,103655,Bharadia; Dinesh,0,0,0,0
1668178613161,ECE 258A,A00,103656,Milstein; Laurence B.,0,0,0,0
1668178613588,ECE 260B,A00,103658,Kang; Mingu,0,0,0,0
1668178614013,ECE 264A,A00,103659,Galton; Ian A,0,0,0,0
1668178614437,ECE 265A,A00,103661,Gudem; Prasad S.S.,0,0,0,0
1668178614862,ECE 265D,A00,103662,Gudem; Prasad S.S.,0,0,0,0
1668178615287,ECE 268,A00,103663,Koushanfar; Farinaz,0,0,0,0
1668178615713,ECE 269,A01,103665,Pal; Piya,0,0,0,0
1668178616144,ECE 271B,A00,103666,Vasconcelos; Manuela,0,0,0,0
1668178616643,ECE 276A,A00,103667,Atanasov; Nikolay A.,0,0,0,0
1668178617066,ECE 277,A00,103668,An; Cheolhong,0,0,0,0
1668178617493,ECE 279,A00,117947,Hall; Drew A.,0,0,0,0
1668178618344,ECE 283,A00,103670,Hsueh; Tzu-Chien,0,0,0,0
1668178618768,ECE 284,A00,103671,Turakhia; Yatish Girish,0,0,0,0
1668178619193,ECE 285,A00,103672,Zheng; Yang,0,0,0,0
1668178619193,ECE 285,B00,103673,Sworder; David D.,0,0,0,0
1668178619616,ECE 287,A00,103676,Javidi; Tara,0,0,0,0
1668178620039,MATH 200B,A00,098023,Salehi Golsefidy; Alireza,12,0,15,3
1668178620471,MATH 202B,A00,098024,Rhoades; Brendon Patrick,9,0,15,6
1668178620905,MATH 203B,A00,098025,Oprea; Dragos N.,10,0,15,5
1668178621336,MATH 204B,A00,098026,Sorensen; Claus M,13,0,15,2
1668178621769,MATH 208,A00,098027,Izadi; Elham,7,0,10,3
1668178622193,MATH 209,A00,098028,Pollack; Aaron,10,0,10,0
1668178622623,MATH 211A,A00,112919,Rogalski; Daniel,9,0,10,1
1668178623059,MATH 211B,A00,112920,Seward; Brandon M.,9,0,10,1
1668178623485,MATH 218,A00,098029,Li; Bo,10,0,10,0
1668178623909,MATH 220B,A00,098030,Novak; Jonathan I,11,0,15,4
1668178624332,MATH 221A,A00,098031,Ebenfelt; Peter F,13,0,15,2
1668178624762,MATH 231B,A00,098032,Zlatos; Andrej,12,0,15,3
1668178625194,MATH 240B,A00,098033,Ni; Lei,9,0,15,6
1668178625619,MATH 243,A00,098034,Jekel; David Andrew,10,0,10,0
1668178626055,MATH 245A,A00,098035,Nie; Jiawang,0,0,15,16
1668178626480,MATH 248,A00,098036,Bejenaru; Ioan,10,0,10,0
1668178626902,MATH 250B,A00,098037,Spolaor; Luca,14,0,15,1
1668178627330,MATH 258,A00,098038,Ni; Lei,10,0,10,0
1668178627753,MATH 264B,A00,098041,Rhoades; Brendon Patrick,9,0,15,6
1668178628180,MATH 268,A00,098042,Buss; Samuel R,10,0,10,0
1668178628606,MATH 269,A00,098043,Rhoades; Brendon Patrick,10,0,10,0
1668178629034,MATH 270B,A00,098044,Li; Bo,10,0,15,5
1668178629457,MATH 272B,A00,098045,Holst; Michael J,13,0,15,2
1668178629881,MATH 273A,A00,098046,Tian; Xiaochuan,10,0,15,5
1668178630305,MATH 275,A01,098048,Tian; Xiaochuan,6,0,10,4
1668178630737,MATH 278A,A00,098049,Holst; Michael J,8,0,10,2
1668178631164,MATH 278B,A00,098050,Cloninger; Alexander,10,0,10,0
1668178631589,MATH 278C,A00,098051,Nie; Jiawang,7,0,10,3
1668178632013,MATH 280B,A00,098052,Zheng; Tianyi,10,0,15,5
1668178632436,MATH 281B,A00,098053,Bradic; Jelena,2,0,15,13
1668178632906,MATH 282B,A00,098054,Arias-Castro; Ery,0,0,15,15
1668178633330,MATH 285,A00,098055,Fitzsimmons; Patrick J,0,0,15,17
1668178633765,MATH 287B,A00,098056,Arias-Castro; Ery,2,0,15,13
1668178634190,MATH 288,A00,098057,Agarwal; Pooja,9,0,10,1
1668178634190,MATH 288,B00,098058,Zhang; Danna,8,0,10,2
1668178634190,MATH 288,C00,098059,Williams; Ruth J,10,0,10,0
1668178634623,MATH 290B,A00,098060,Roberts; Justin Deritter,13,0,15,2
1668178635059,MATH 292,A00,098061,Belmont; Eva Kinoshita,10,0,10,0
1668178635482,MATH 295,A00,098062,Suk; Andrew Hoon,48,0,50,2
1668178635905,MATH 296,A00,098063,Novak; Jonathan I,20,0,20,0
1668178636330,MATH 297,001,098064,Gamst; Anthony Collins,9997,0,9999,2
1668179141450,COGS 205,A00,101395,Chiba; Andrea,19,0,20,1
1668179141952,COGS 210B,001,101404,Greene; Deanna Jacquelyn,9998,0,9999,1
1668179141952,COGS 210B,002,101417,Xia; Haijun,9999,0,9999,0
1668179141952,COGS 210B,003,101422,Nitz; Douglas A.,9999,0,9999,0
1668179141952,COGS 210B,004,101423,Hollan; James D.,9998,0,9999,1
1668179141952,COGS 210B,005,101424,Deak; Gedeon O.,9998,0,9999,1
1668179141952,COGS 210B,006,101425,Rossano; Federico,9999,0,9999,0
1668179142388,COGS 211B,A00,101427,Coulson; Seana M,9996,0,9999,3
1668179142812,COGS 220,A00,101428,Hollan; James D.,0,0,25,25
1668179143238,COGS 229,A00,101429,Dow; Steven P,18,0,25,7
1668179143670,COGS 230,A00,101430,Klemmer; Scott R,12,0,17,5
1668179144097,COGS 234,A00,101431,Xia; Haijun,3,0,25,22
1668179144521,COGS 260,A00,101432,Kiyonaga; Anastasia,20,0,25,5
1668179144521,COGS 260,B00,101433,Kirsh; David Joel,16,0,25,9
1668179144957,CSE 202,A00,102371,Impagliazzo; Russell,0,0,0,0
1668179145385,CSE 203B,A01,102373,Cheng; Chung Kuan,0,0,0,0
1668179145818,CSE 208,A00,102374,Micciancio; Daniele,0,0,0,0
1668179146248,CSE 209A,A00,112895,Impagliazzo; Russell,0,0,15,15
1668179146671,CSE 209B,A00,108005,Bellare; Mihir,0,0,0,0
1668179147108,CSE 210,A00,113163,Coblenz; Michael J,0,0,0,0
1668179147533,CSE 219,A00,106111,Dow; Steven P,0,0,20,20
1668179147962,CSE 221,A00,102376,Voelker; Geoffrey M.,0,0,0,0
1668179148388,CSE 224,A01,102378,Porter; George M,0,0,0,0
1668179148811,CSE 229A,A00,102379,Savage; Stefan,0,0,0,0
1668179149237,CSE 229C,A00,102380,Munyaka; Imani N. S.,0,0,0,0
1668179149659,CSE 232B,A00,102382,Deutsch; Alin Bernard,0,0,0,0
1668179150088,CSE 234,A01,112904,Kumar; Arun Kumar,0,0,0,0
1668179150511,CSE 237A,A00,102383,Rosing; Tajana Simunic,0,0,0,0
1668179150933,CSE 239A,A00,102384,Deutsch; Alin Bernard,0,0,0,0
1668179151358,CSE 239B,A00,102385,Polikarpova; Nadezhda,0,0,0,0
1668179151784,CSE 240A,A00,102386,Pannuto; Patrick William,0,0,0,0
1668179152213,CSE 240B,A00,102387,Zhao; Jishen,0,0,0,0
1668179152636,CSE 241A,A00,106406,Kang; Mingu,0,0,0,0
1668179153068,CSE 249B,A00,102388,Kahng; Andrew Byun,0,0,8,8
1668179153497,CSE 251B,A01,102392,Cottrell; Garrison W,0,0,0,0
1668179153497,CSE 251B,A02,102393,Cottrell; Garrison W,0,0,0,0
1668179153920,CSE 252B,A00,102394,Ochoa; Benjamin Lawrence,0,0,0,0
1668179154347,CSE 257,A01,102396,Gao; Sicun,0,0,0,0
1668179154780,CSE 272,A00,102397,Li; Tzumao,0,0,0,0
1668179155217,CSE 274,A00,111323,Chern; Albert Ren-Haur,0,0,0,0
1668179155646,CSE 282,A00,102398,Pevzner; Pavel Arkadjevich,0,0,0,0
1668179156080,CSE 284,A00,114175,Gymrek; Melissa Ann,0,0,0,0
1668179156509,CSE 290,A00,102399,Chandraker; Manmohan Krishna,0,0,0,0
1668179156509,CSE 290,B00,102400,Vaccaro; Kristen Marie,0,0,25,25
1668179156509,CSE 290,C00,102414,Pannuto; Patrick William,0,0,25,25
1668179156509,CSE 290,D00,102427,Pevzner; Pavel Arkadjevich,0,0,0,0
1668179156509,CSE 290,E00,102429,Zhao; Jishen,0,0,0,0
1668179156509,CSE 290,F00,102436,Tullsen; Dean Michael,0,0,0,0
1668179156509,CSE 290,G00,102440,Christensen; Henrik I,0,0,20,20
1668179156937,CSE 291,A00,102443,Su; Hao,0,0,0,0
1668179156937,CSE 291,B00,102448,Polikarpova; Nadezhda,0,0,0,0
1668179156937,CSE 291,C00,102453,Vaccaro; Kristen Marie,0,0,0,0
1668179156937,CSE 291,D00,111343,Savage; Stefan,0,0,0,0
1668179156937,CSE 291,E00,116474,Claffy; Kimberly Claire,0,0,0,0
1668179156937,CSE 291,F00,116479,Pasquale; Joseph,0,0,0,0
1668179157378,CSE 293,001,119111,Bafna; Vineet,9999,0,9999,0
1668179157378,CSE 293,002,119118,Bellare; Mihir,9999,0,9999,0
1668179157378,CSE 293,003,119122,Berg-Kirkpatrick; Taylor D,9999,0,9999,0
1668179157378,CSE 293,004,119135,Christensen; Henrik I,9999,0,9999,0
1668179157378,CSE 293,005,119142,Cottrell; Garrison W,9999,0,9999,0
1668179157378,CSE 293,006,119146,Deutsch; Alin Bernard,9999,0,9999,0
1668179157378,CSE 293,007,119159,Esmaeilzadeh; Hadi,9999,0,9999,0
1668179157378,CSE 293,008,119166,Freund; Yoav,9999,0,9999,0
1668179157378,CSE 293,009,119170,Griswold; William G.,9999,0,9999,0
1668179157378,CSE 293,010,119183,Gymrek; Melissa Ann,9999,0,9999,0
1668179157378,CSE 293,011,119190,Heninger; Nadia A,9999,0,9999,0
1668179157378,CSE 293,012,119230,Impagliazzo; Russell,9999,0,9999,0
1668179157378,CSE 293,013,119232,Jhala; Ranjit,9999,0,9999,0
1668179157378,CSE 293,014,119233,Kahng; Andrew Byun,9999,0,9999,0
1668179157378,CSE 293,015,119298,Kane; Daniel Mertz,9999,0,9999,0
1668179157378,CSE 293,016,119299,Kriegman; David J,9999,0,9999,0
1668179157378,CSE 293,017,119300,Kumar; Arun Kumar,9999,0,9999,0
1668179157378,CSE 293,018,119301,Lerner; Sorin,9999,0,9999,0
1668179157378,CSE 293,019,119302,Lovett; Shachar,9999,0,9999,0
1668179157378,CSE 293,020,119303,McAuley; Julian John,9999,0,9999,0
1668179157378,CSE 293,021,119304,Micciancio; Daniele,9999,0,9999,0
1668179157378,CSE 293,022,119367,Orailoglu; Alex,9999,0,9999,0
1668179157378,CSE 293,023,119382,Paturi; Ramamohan,9999,0,9999,0
1668179157378,CSE 293,024,119404,Polikarpova; Nadezhda,9999,0,9999,0
1668179157378,CSE 293,025,119406,Politz; Joseph Gibbs,9999,0,9999,0
1668179157378,CSE 293,026,119411,Porter; George M,9999,0,9999,0
1668179157378,CSE 293,027,119414,Porter; Leonard Emerson,9999,0,9999,0
1668179157378,CSE 293,028,119416,Ramamoorthi; Ravi,9999,0,9999,0
1668179157378,CSE 293,029,119417,Sahoo; Debashis,9999,0,9999,0
1668179157378,CSE 293,030,119420,Saul; Lawrence,9999,0,9999,0
1668179157378,CSE 293,031,119421,Savage; Stefan,9999,0,9999,0
1668179157378,CSE 293,032,119425,Schulze; Jurgen P.,9999,0,9999,0
1668179157378,CSE 293,033,119426,Snoeren; Alex C.,9999,0,9999,0
1668179157378,CSE 293,034,119428,Shang; Jingbo,9999,0,9999,0
1668179157378,CSE 293,035,119430,Stefan; Deian,9999,0,9999,0
1668179157378,CSE 293,036,119431,Su; Hao,9999,0,9999,0
1668179157378,CSE 293,037,119433,Swanson; Steven James,9999,0,9999,0
1668179157378,CSE 293,038,119435,Tullsen; Dean Michael,9999,0,9999,0
1668179157378,CSE 293,039,119483,Voelker; Geoffrey M.,9999,0,9999,0
1668179157378,CSE 293,040,119537,Zhao; Jishen,9999,0,9999,0
1668179157378,CSE 293,041,119538,Zhou; Yuan-Yuan,9999,0,9999,0
1668179157378,CSE 293,042,119539,Gao; Sicun,9999,0,9999,0
1668179157378,CSE 293,043,119540,Weibel; Nadir,9999,0,9999,0
1668179157378,CSE 293,044,119541,Gupta; Rajesh K.,9999,0,9999,0
1668179157378,CSE 293,045,126410,Vaccaro; Kristen Marie,9999,0,9999,0
1668179157378,CSE 293,046,126411,Klemke; Richard,9999,0,9999,0
1668179157803,CSE 294,A00,102459,Voelker; Geoffrey M.,0,0,0,0
1668179157803,CSE 294,B00,111322,Orailoglu; Alex,0,0,0,0
1668179158227,DSE 201,A00,096914,Deutsch; Alin Bernard,30,0,30,0
1668179158670,DSE 210,A00,096915,Dasgupta; Sanjoy,30,0,30,0
1668179159094,DSE 260A,A00,096916,Altintas De Callaf; Ilkay,30,0,30,0
1668179159549,ECE 200,001,103586,Antipa; Nicholas A,9999,0,9999,0
1668179159549,ECE 200,002,103587,Atanasov; Nikolay A.,9999,0,9999,0
1668179159549,ECE 200,003,103588,Bharadia; Dinesh,9999,0,9999,0
1668179159549,ECE 200,004,103589,Cheng; Chung Kuan,9999,0,9999,0
1668179159549,ECE 200,005,103590,Cosman; Pamela C.,9999,0,9999,0
1668179159549,ECE 200,006,103591,Dayeh; Shadi Ahmad,9999,0,9999,0
1668179159549,ECE 200,007,103592,Fainman; Yeshaiahu,9999,0,9999,0
1668179159549,ECE 200,008,103593,Ford; Joseph Earl,9999,0,9999,0
1668179159549,ECE 200,009,103594,Franceschetti; Massimo,9999,0,9999,0
1668179159549,ECE 200,010,103595,Fullerton; Eric E,9999,0,9999,0
1668179159549,ECE 200,011,103596,Galton; Ian A,9999,0,9999,0
1668179159549,ECE 200,012,103597,Gilja; Vikash,9999,0,9999,0
1668179159549,ECE 200,013,103598,Hall; Drew A.,9999,0,9999,0
1668179159549,ECE 200,014,103599,Hsueh; Tzu-Chien,9999,0,9999,0
1668179159549,ECE 200,015,103600,Javidi; Tara,9999,0,9999,0
1668179159549,ECE 200,016,103601,Kahng; Andrew Byun,9999,0,9999,0
1668179159549,ECE 200,017,103602,Kim; Young-Han,9999,0,9999,0
1668179159549,ECE 200,018,103603,Koushanfar; Farinaz,9999,0,9999,0
1668179159549,ECE 200,019,103604,Kuzum; Duygu,9999,0,9999,0
1668179159549,ECE 200,020,103605,Le; Hanh-Phuc,9999,0,9999,0
1668179159549,ECE 200,021,103606,Lin; Bill,9999,0,9999,0
1668179159549,ECE 200,022,103607,Liu; Zhaowei,9998,0,9999,1
1668179159549,ECE 200,023,103608,Lo; Yu-Hwa,9999,0,9999,0
1668179159549,ECE 200,024,103609,Lomakin; Vitaliy,9999,0,9999,0
1668179159549,ECE 200,025,103610,Mercier; Patrick Philip,9999,0,9999,0
1668179159549,ECE 200,026,103611,Meyer; Florian,9999,0,9999,0
1668179159549,ECE 200,027,103612,Milstein; Laurence B.,9999,0,9999,0
1668179159549,ECE 200,028,103613,Mir Arabbaygi; Siavash,9999,0,9999,0
1668179159549,ECE 200,029,103614,Mookherjea; Shayan,9999,0,9999,0
1668179159549,ECE 200,030,103615,Morris; Karcher William,9999,0,9999,0
1668179159549,ECE 200,031,103616,Ng; Tse Nga,9999,0,9999,0
1668179159549,ECE 200,032,103617,Nguyen; Truong Quang,9999,0,9999,0
1668179159549,ECE 200,033,103618,Nomura; Kenji,9999,0,9999,0
1668179159549,ECE 200,034,103619,Orlitsky; Alon,9999,0,9999,0
1668179159549,ECE 200,035,103620,Pal; Piya,9999,0,9999,0
1668179159549,ECE 200,036,103621,Papen; George C.,9999,0,9999,0
1668179159549,ECE 200,037,103622,Radic; Stojan,9999,0,9999,0
1668179159549,ECE 200,038,103623,Rao; Bhaskar D.,9999,0,9999,0
1668179159549,ECE 200,039,103624,Rao; Ramesh R,9999,0,9999,0
1668179159549,ECE 200,040,103625,Rebeiz; Gabriel,9999,0,9999,0
1668179159549,ECE 200,041,103626,Sanford; John R,9999,0,9999,0
1668179159549,ECE 200,042,103627,Siegel; Paul H.,9999,0,9999,0
1668179159549,ECE 200,043,103628,Sievenpiper; Daniel F.,9999,0,9999,0
1668179159549,ECE 200,044,103629,Sworder; David D.,9999,0,9999,0
1668179159549,ECE 200,045,103630,Taur; Yuan,9999,0,9999,0
1668179159549,ECE 200,046,103631,Touri; Behrouz,9999,0,9999,0
1668179159549,ECE 200,047,103632,Trivedi; Mohan M.,9999,0,9999,0
1668179159549,ECE 200,048,103633,Vasconcelos; Nuno,9999,0,9999,0
1668179159549,ECE 200,049,103634,Wang; Xiaolong,9999,0,9999,0
1668179159549,ECE 200,050,103635,Xie; Pengtao,9999,0,9999,0
1668179159549,ECE 200,051,103636,Yip; Michael,9999,0,9999,0
1668179159549,ECE 200,052,103637,Zeger; Kenneth A.,999,0,999,0
1668179159549,ECE 200,053,103638,Zhang; Xinyu,9999,0,9999,0
1668179159549,ECE 200,054,103639,Turakhia; Yatish Girish,9999,0,9999,0
1668179159549,ECE 200,055,103640,Kang; Mingu,9999,0,9999,0
1668179159549,ECE 200,056,103641,Shi; Yuanyuan,9999,0,9999,0
1668179159549,ECE 200,057,103642,Wang; Edward Jay,9999,0,9999,0
1668179159549,ECE 200,058,103643,Zheng; Yang,9999,0,9999,0
1668179159973,ECE 202,A00,103644,Kuzum; Duygu,0,0,0,0
1668179160407,ECE 212BN,A00,103646,Ng; Tse Nga,0,0,0,0
1668179160836,ECE 221,A00,111493,Staff,0,0,0,0
1668179161287,ECE 222B,A00,103647,Lomakin; Vitaliy,0,0,0,0
1668179161710,ECE 230B,A00,103648,Taur; Yuan,0,0,0,0
1668179162140,ECE 238B,A00,103649,Garay; Javier,0,0,0,0
1668179162565,ECE 240B,A00,112900,Fainman; Yeshaiahu,0,0,0,0
1668179162991,ECE 247A,A00,103650,Jokerst; Jesse Vincent,0,0,0,0
1668179163419,ECE 247B,A00,103651,Wang; Joseph,0,0,0,0
1668179163857,ECE 250,A00,103652,Siegel; Paul H.,0,0,0,0
1668179164288,ECE 251A,A00,103654,Rao; Bhaskar D.,0,0,0,0
1668179164712,ECE 257B,A00,103655,Bharadia; Dinesh,0,0,0,0
1668179165137,ECE 258A,A00,103656,Milstein; Laurence B.,0,0,0,0
1668179165566,ECE 260B,A00,103658,Kang; Mingu,0,0,0,0
1668179165992,ECE 264A,A00,103659,Galton; Ian A,0,0,0,0
1668179166430,ECE 265A,A00,103661,Gudem; Prasad S.S.,0,0,0,0
1668179166859,ECE 265D,A00,103662,Gudem; Prasad S.S.,0,0,0,0
1668179167295,ECE 268,A00,103663,Koushanfar; Farinaz,0,0,0,0
1668179167725,ECE 269,A01,103665,Pal; Piya,0,0,0,0
1668179168153,ECE 271B,A00,103666,Vasconcelos; Manuela,0,0,0,0
1668179168577,ECE 276A,A00,103667,Atanasov; Nikolay A.,0,0,0,0
1668179169001,ECE 277,A00,103668,An; Cheolhong,0,0,0,0
1668179169424,ECE 279,A00,117947,Hall; Drew A.,0,0,0,0
1668179170286,ECE 283,A00,103670,Hsueh; Tzu-Chien,0,0,0,0
1668179170711,ECE 284,A00,103671,Turakhia; Yatish Girish,0,0,0,0
1668179171141,ECE 285,A00,103672,Zheng; Yang,0,0,0,0
1668179171141,ECE 285,B00,103673,Sworder; David D.,0,0,0,0
1668179171566,ECE 287,A00,103676,Javidi; Tara,0,0,0,0
1668179172001,MATH 200B,A00,098023,Salehi Golsefidy; Alireza,12,0,15,3
1668179172426,MATH 202B,A00,098024,Rhoades; Brendon Patrick,9,0,15,6
1668179172851,MATH 203B,A00,098025,Oprea; Dragos N.,10,0,15,5
1668179173291,MATH 204B,A00,098026,Sorensen; Claus M,13,0,15,2
1668179173719,MATH 208,A00,098027,Izadi; Elham,7,0,10,3
1668179174147,MATH 209,A00,098028,Pollack; Aaron,10,0,10,0
1668179174571,MATH 211A,A00,112919,Rogalski; Daniel,9,0,10,1
1668179175003,MATH 211B,A00,112920,Seward; Brandon M.,9,0,10,1
1668179175432,MATH 218,A00,098029,Li; Bo,10,0,10,0
1668179175855,MATH 220B,A00,098030,Novak; Jonathan I,11,0,15,4
1668179176281,MATH 221A,A00,098031,Ebenfelt; Peter F,13,0,15,2
1668179176709,MATH 231B,A00,098032,Zlatos; Andrej,12,0,15,3
1668179177135,MATH 240B,A00,098033,Ni; Lei,9,0,15,6
1668179177562,MATH 243,A00,098034,Jekel; David Andrew,10,0,10,0
1668179178001,MATH 245A,A00,098035,Nie; Jiawang,0,0,15,16
1668179178434,MATH 248,A00,098036,Bejenaru; Ioan,10,0,10,0
1668179178860,MATH 250B,A00,098037,Spolaor; Luca,14,0,15,1
1668179179288,MATH 258,A00,098038,Ni; Lei,10,0,10,0
1668179179712,MATH 264B,A00,098041,Rhoades; Brendon Patrick,9,0,15,6
1668179180158,MATH 268,A00,098042,Buss; Samuel R,10,0,10,0
1668179180593,MATH 269,A00,098043,Rhoades; Brendon Patrick,10,0,10,0
1668179181022,MATH 270B,A00,098044,Li; Bo,10,0,15,5
1668179181449,MATH 272B,A00,098045,Holst; Michael J,13,0,15,2
1668179181884,MATH 273A,A00,098046,Tian; Xiaochuan,10,0,15,5
1668179182313,MATH 275,A01,098048,Tian; Xiaochuan,6,0,10,4
1668179182738,MATH 278A,A00,098049,Holst; Michael J,8,0,10,2
1668179183177,MATH 278B,A00,098050,Cloninger; Alexander,10,0,10,0
1668179183602,MATH 278C,A00,098051,Nie; Jiawang,7,0,10,3
1668179184041,MATH 280B,A00,098052,Zheng; Tianyi,10,0,15,5
1668179184466,MATH 281B,A00,098053,Bradic; Jelena,2,0,15,13
1668179184894,MATH 282B,A00,098054,Arias-Castro; Ery,0,0,15,15
1668179185394,MATH 285,A00,098055,Fitzsimmons; Patrick J,0,0,15,17
1668179185820,MATH 287B,A00,098056,Arias-Castro; Ery,2,0,15,13
1668179186248,MATH 288,A00,098057,Agarwal; Pooja,9,0,10,1
1668179186248,MATH 288,B00,098058,Zhang; Danna,8,0,10,2
1668179186248,MATH 288,C00,098059,Williams; Ruth J,10,0,10,0
1668179186687,MATH 290B,A00,098060,Roberts; Justin Deritter,13,0,15,2
1668179187120,MATH 292,A00,098061,Belmont; Eva Kinoshita,10,0,10,0
1668179187545,MATH 295,A00,098062,Suk; Andrew Hoon,48,0,50,2
1668179187970,MATH 296,A00,098063,Novak; Jonathan I,20,0,20,0
1668179188394,MATH 297,001,098064,Gamst; Anthony Collins,9997,0,9999,2
1668179690701,COGS 205,A00,101395,Chiba; Andrea,19,0,20,1
1668179691128,COGS 210B,001,101404,Greene; Deanna Jacquelyn,9998,0,9999,1
1668179691128,COGS 210B,002,101417,Xia; Haijun,9999,0,9999,0
1668179691128,COGS 210B,003,101422,Nitz; Douglas A.,9999,0,9999,0
1668179691128,COGS 210B,004,101423,Hollan; James D.,9998,0,9999,1
1668179691128,COGS 210B,005,101424,Deak; Gedeon O.,9998,0,9999,1
1668179691128,COGS 210B,006,101425,Rossano; Federico,9999,0,9999,0
1668179691555,COGS 211B,A00,101427,Coulson; Seana M,9996,0,9999,3
1668179691978,COGS 220,A00,101428,Hollan; James D.,0,0,25,25
1668179692402,COGS 229,A00,101429,Dow; Steven P,18,0,25,7
1668179692825,COGS 230,A00,101430,Klemmer; Scott R,12,0,17,5
1668179693254,COGS 234,A00,101431,Xia; Haijun,3,0,25,22
1668179693679,COGS 260,A00,101432,Kiyonaga; Anastasia,20,0,25,5
1668179693679,COGS 260,B00,101433,Kirsh; David Joel,16,0,25,9
1668179694109,CSE 202,A00,102371,Impagliazzo; Russell,0,0,0,0
1668179694542,CSE 203B,A01,102373,Cheng; Chung Kuan,0,0,0,0
1668179694983,CSE 208,A00,102374,Micciancio; Daniele,0,0,0,0
1668179695409,CSE 209A,A00,112895,Impagliazzo; Russell,0,0,15,15
1668179695836,CSE 209B,A00,108005,Bellare; Mihir,0,0,0,0
1668179696262,CSE 210,A00,113163,Coblenz; Michael J,0,0,0,0
1668179696686,CSE 219,A00,106111,Dow; Steven P,0,0,20,20
1668179697111,CSE 221,A00,102376,Voelker; Geoffrey M.,0,0,0,0
1668179697548,CSE 224,A01,102378,Porter; George M,0,0,0,0
1668179697973,CSE 229A,A00,102379,Savage; Stefan,0,0,0,0
1668179698408,CSE 229C,A00,102380,Munyaka; Imani N. S.,0,0,0,0
1668179698834,CSE 232B,A00,102382,Deutsch; Alin Bernard,0,0,0,0
1668179699258,CSE 234,A01,112904,Kumar; Arun Kumar,0,0,0,0
1668179699685,CSE 237A,A00,102383,Rosing; Tajana Simunic,0,0,0,0
1668179700119,CSE 239A,A00,102384,Deutsch; Alin Bernard,0,0,0,0
1668179700549,CSE 239B,A00,102385,Polikarpova; Nadezhda,0,0,0,0
1668179700983,CSE 240A,A00,102386,Pannuto; Patrick William,0,0,0,0
1668179701419,CSE 240B,A00,102387,Zhao; Jishen,0,0,0,0
1668179701850,CSE 241A,A00,106406,Kang; Mingu,0,0,0,0
1668179702283,CSE 249B,A00,102388,Kahng; Andrew Byun,0,0,8,8
1668179702725,CSE 251B,A01,102392,Cottrell; Garrison W,0,0,0,0
1668179702725,CSE 251B,A02,102393,Cottrell; Garrison W,0,0,0,0
1668179703151,CSE 252B,A00,102394,Ochoa; Benjamin Lawrence,0,0,0,0
1668179703573,CSE 257,A01,102396,Gao; Sicun,0,0,0,0
1668179703999,CSE 272,A00,102397,Li; Tzumao,0,0,0,0
1668179704423,CSE 274,A00,111323,Chern; Albert Ren-Haur,0,0,0,0
1668179704848,CSE 282,A00,102398,Pevzner; Pavel Arkadjevich,0,0,0,0
1668179705273,CSE 284,A00,114175,Gymrek; Melissa Ann,0,0,0,0
1668179705701,CSE 290,A00,102399,Chandraker; Manmohan Krishna,0,0,0,0
1668179705701,CSE 290,B00,102400,Vaccaro; Kristen Marie,0,0,25,25
1668179705701,CSE 290,C00,102414,Pannuto; Patrick William,0,0,25,25
1668179705701,CSE 290,D00,102427,Pevzner; Pavel Arkadjevich,0,0,0,0
1668179705701,CSE 290,E00,102429,Zhao; Jishen,0,0,0,0
1668179705701,CSE 290,F00,102436,Tullsen; Dean Michael,0,0,0,0
1668179705701,CSE 290,G00,102440,Christensen; Henrik I,0,0,20,20
1668179706129,CSE 291,A00,102443,Su; Hao,0,0,0,0
1668179706129,CSE 291,B00,102448,Polikarpova; Nadezhda,0,0,0,0
1668179706129,CSE 291,C00,102453,Vaccaro; Kristen Marie,0,0,0,0
1668179706129,CSE 291,D00,111343,Savage; Stefan,0,0,0,0
1668179706129,CSE 291,E00,116474,Claffy; Kimberly Claire,0,0,0,0
1668179706129,CSE 291,F00,116479,Pasquale; Joseph,0,0,0,0
1668179706569,CSE 293,001,119111,Bafna; Vineet,9999,0,9999,0
1668179706569,CSE 293,002,119118,Bellare; Mihir,9999,0,9999,0
1668179706569,CSE 293,003,119122,Berg-Kirkpatrick; Taylor D,9999,0,9999,0
1668179706569,CSE 293,004,119135,Christensen; Henrik I,9999,0,9999,0
1668179706569,CSE 293,005,119142,Cottrell; Garrison W,9999,0,9999,0
1668179706569,CSE 293,006,119146,Deutsch; Alin Bernard,9999,0,9999,0
1668179706569,CSE 293,007,119159,Esmaeilzadeh; Hadi,9999,0,9999,0
1668179706569,CSE 293,008,119166,Freund; Yoav,9999,0,9999,0
1668179706569,CSE 293,009,119170,Griswold; William G.,9999,0,9999,0
1668179706569,CSE 293,010,119183,Gymrek; Melissa Ann,9999,0,9999,0
1668179706569,CSE 293,011,119190,Heninger; Nadia A,9999,0,9999,0
1668179706569,CSE 293,012,119230,Impagliazzo; Russell,9999,0,9999,0
1668179706569,CSE 293,013,119232,Jhala; Ranjit,9999,0,9999,0
1668179706569,CSE 293,014,119233,Kahng; Andrew Byun,9999,0,9999,0
1668179706569,CSE 293,015,119298,Kane; Daniel Mertz,9999,0,9999,0
1668179706569,CSE 293,016,119299,Kriegman; David J,9999,0,9999,0
1668179706569,CSE 293,017,119300,Kumar; Arun Kumar,9999,0,9999,0
1668179706569,CSE 293,018,119301,Lerner; Sorin,9999,0,9999,0
1668179706569,CSE 293,019,119302,Lovett; Shachar,9999,0,9999,0
1668179706569,CSE 293,020,119303,McAuley; Julian John,9999,0,9999,0
1668179706569,CSE 293,021,119304,Micciancio; Daniele,9999,0,9999,0
1668179706569,CSE 293,022,119367,Orailoglu; Alex,9999,0,9999,0
1668179706569,CSE 293,023,119382,Paturi; Ramamohan,9999,0,9999,0
1668179706569,CSE 293,024,119404,Polikarpova; Nadezhda,9999,0,9999,0
1668179706569,CSE 293,025,119406,Politz; Joseph Gibbs,9999,0,9999,0
1668179706569,CSE 293,026,119411,Porter; George M,9999,0,9999,0
1668179706569,CSE 293,027,119414,Porter; Leonard Emerson,9999,0,9999,0
1668179706569,CSE 293,028,119416,Ramamoorthi; Ravi,9999,0,9999,0
1668179706569,CSE 293,029,119417,Sahoo; Debashis,9999,0,9999,0
1668179706569,CSE 293,030,119420,Saul; Lawrence,9999,0,9999,0
1668179706569,CSE 293,031,119421,Savage; Stefan,9999,0,9999,0
1668179706569,CSE 293,032,119425,Schulze; Jurgen P.,9999,0,9999,0
1668179706569,CSE 293,033,119426,Snoeren; Alex C.,9999,0,9999,0
1668179706569,CSE 293,034,119428,Shang; Jingbo,9999,0,9999,0
1668179706569,CSE 293,035,119430,Stefan; Deian,9999,0,9999,0
1668179706569,CSE 293,036,119431,Su; Hao,9999,0,9999,0
1668179706569,CSE 293,037,119433,Swanson; Steven James,9999,0,9999,0
1668179706569,CSE 293,038,119435,Tullsen; Dean Michael,9999,0,9999,0
1668179706569,CSE 293,039,119483,Voelker; Geoffrey M.,9999,0,9999,0
1668179706569,CSE 293,040,119537,Zhao; Jishen,9999,0,9999,0
1668179706569,CSE 293,041,119538,Zhou; Yuan-Yuan,9999,0,9999,0
1668179706569,CSE 293,042,119539,Gao; Sicun,9999,0,9999,0
1668179706569,CSE 293,043,119540,Weibel; Nadir,9999,0,9999,0
1668179706569,CSE 293,044,119541,Gupta; Rajesh K.,9999,0,9999,0
1668179706569,CSE 293,045,126410,Vaccaro; Kristen Marie,9999,0,9999,0
1668179706569,CSE 293,046,126411,Klemke; Richard,9999,0,9999,0
1668179706992,CSE 294,A00,102459,Voelker; Geoffrey M.,0,0,0,0
1668179706992,CSE 294,B00,111322,Orailoglu; Alex,0,0,0,0
1668179707417,DSE 201,A00,096914,Deutsch; Alin Bernard,30,0,30,0
1668179707939,DSE 210,A00,096915,Dasgupta; Sanjoy,30,0,30,0
1668179708364,DSE 260A,A00,096916,Altintas De Callaf; Ilkay,30,0,30,0
1668179708876,ECE 200,001,103586,Antipa; Nicholas A,9999,0,9999,0
1668179708876,ECE 200,002,103587,Atanasov; Nikolay A.,9999,0,9999,0
1668179708876,ECE 200,003,103588,Bharadia; Dinesh,9999,0,9999,0
1668179708876,ECE 200,004,103589,Cheng; Chung Kuan,9999,0,9999,0
1668179708876,ECE 200,005,103590,Cosman; Pamela C.,9999,0,9999,0
1668179708876,ECE 200,006,103591,Dayeh; Shadi Ahmad,9999,0,9999,0
1668179708876,ECE 200,007,103592,Fainman; Yeshaiahu,9999,0,9999,0
1668179708876,ECE 200,008,103593,Ford; Joseph Earl,9999,0,9999,0
1668179708876,ECE 200,009,103594,Franceschetti; Massimo,9999,0,9999,0
1668179708876,ECE 200,010,103595,Fullerton; Eric E,9999,0,9999,0
1668179708876,ECE 200,011,103596,Galton; Ian A,9999,0,9999,0
1668179708876,ECE 200,012,103597,Gilja; Vikash,9999,0,9999,0
1668179708876,ECE 200,013,103598,Hall; Drew A.,9999,0,9999,0
1668179708876,ECE 200,014,103599,Hsueh; Tzu-Chien,9999,0,9999,0
1668179708876,ECE 200,015,103600,Javidi; Tara,9999,0,9999,0
1668179708876,ECE 200,016,103601,Kahng; Andrew Byun,9999,0,9999,0
1668179708876,ECE 200,017,103602,Kim; Young-Han,9999,0,9999,0
1668179708876,ECE 200,018,103603,Koushanfar; Farinaz,9999,0,9999,0
1668179708876,ECE 200,019,103604,Kuzum; Duygu,9999,0,9999,0
1668179708876,ECE 200,020,103605,Le; Hanh-Phuc,9999,0,9999,0
1668179708876,ECE 200,021,103606,Lin; Bill,9999,0,9999,0
1668179708876,ECE 200,022,103607,Liu; Zhaowei,9998,0,9999,1
1668179708876,ECE 200,023,103608,Lo; Yu-Hwa,9999,0,9999,0
1668179708876,ECE 200,024,103609,Lomakin; Vitaliy,9999,0,9999,0
1668179708876,ECE 200,025,103610,Mercier; Patrick Philip,9999,0,9999,0
1668179708876,ECE 200,026,103611,Meyer; Florian,9999,0,9999,0
1668179708876,ECE 200,027,103612,Milstein; Laurence B.,9999,0,9999,0
1668179708876,ECE 200,028,103613,Mir Arabbaygi; Siavash,9999,0,9999,0
1668179708876,ECE 200,029,103614,Mookherjea; Shayan,9999,0,9999,0
1668179708876,ECE 200,030,103615,Morris; Karcher William,9999,0,9999,0
1668179708876,ECE 200,031,103616,Ng; Tse Nga,9999,0,9999,0
1668179708876,ECE 200,032,103617,Nguyen; Truong Quang,9999,0,9999,0
1668179708876,ECE 200,033,103618,Nomura; Kenji,9999,0,9999,0
1668179708876,ECE 200,034,103619,Orlitsky; Alon,9999,0,9999,0
1668179708876,ECE 200,035,103620,Pal; Piya,9999,0,9999,0
1668179708876,ECE 200,036,103621,Papen; George C.,9999,0,9999,0
1668179708876,ECE 200,037,103622,Radic; Stojan,9999,0,9999,0
1668179708876,ECE 200,038,103623,Rao; Bhaskar D.,9999,0,9999,0
1668179708876,ECE 200,039,103624,Rao; Ramesh R,9999,0,9999,0
1668179708876,ECE 200,040,103625,Rebeiz; Gabriel,9999,0,9999,0
1668179708876,ECE 200,041,103626,Sanford; John R,9999,0,9999,0
1668179708876,ECE 200,042,103627,Siegel; Paul H.,9999,0,9999,0
1668179708876,ECE 200,043,103628,Sievenpiper; Daniel F.,9999,0,9999,0
1668179708876,ECE 200,044,103629,Sworder; David D.,9999,0,9999,0
1668179708876,ECE 200,045,103630,Taur; Yuan,9999,0,9999,0
1668179708876,ECE 200,046,103631,Touri; Behrouz,9999,0,9999,0
1668179708876,ECE 200,047,103632,Trivedi; Mohan M.,9999,0,9999,0
1668179708876,ECE 200,048,103633,Vasconcelos; Nuno,9999,0,9999,0
1668179708876,ECE 200,049,103634,Wang; Xiaolong,9999,0,9999,0
1668179708876,ECE 200,050,103635,Xie; Pengtao,9999,0,9999,0
1668179708876,ECE 200,051,103636,Yip; Michael,9999,0,9999,0
1668179708876,ECE 200,052,103637,Zeger; Kenneth A.,999,0,999,0
1668179708876,ECE 200,053,103638,Zhang; Xinyu,9999,0,9999,0
1668179708876,ECE 200,054,103639,Turakhia; Yatish Girish,9999,0,9999,0
1668179708876,ECE 200,055,103640,Kang; Mingu,9999,0,9999,0
1668179708876,ECE 200,056,103641,Shi; Yuanyuan,9999,0,9999,0
1668179708876,ECE 200,057,103642,Wang; Edward Jay,9999,0,9999,0
1668179708876,ECE 200,058,103643,Zheng; Yang,9999,0,9999,0
1668179709302,ECE 202,A00,103644,Kuzum; Duygu,0,0,0,0
1668179709739,ECE 212BN,A00,103646,Ng; Tse Nga,0,0,0,0
1668179710167,ECE 221,A00,111493,Staff,0,0,0,0
1668179710598,ECE 222B,A00,103647,Lomakin; Vitaliy,0,0,0,0
1668179711023,ECE 230B,A00,103648,Taur; Yuan,0,0,0,0
1668179711451,ECE 238B,A00,103649,Garay; Javier,0,0,0,0
1668179711875,ECE 240B,A00,112900,Fainman; Yeshaiahu,0,0,0,0
1668179712301,ECE 247A,A00,103650,Jokerst; Jesse Vincent,0,0,0,0
1668179712725,ECE 247B,A00,103651,Wang; Joseph,0,0,0,0
1668179713150,ECE 250,A00,103652,Siegel; Paul H.,0,0,0,0
1668179713577,ECE 251A,A00,103654,Rao; Bhaskar D.,0,0,0,0
1668179714002,ECE 257B,A00,103655,Bharadia; Dinesh,0,0,0,0
1668179714427,ECE 258A,A00,103656,Milstein; Laurence B.,0,0,0,0
1668179714856,ECE 260B,A00,103658,Kang; Mingu,0,0,0,0
1668179715281,ECE 264A,A00,103659,Galton; Ian A,0,0,0,0
1668179715705,ECE 265A,A00,103661,Gudem; Prasad S.S.,0,0,0,0
1668179716135,ECE 265D,A00,103662,Gudem; Prasad S.S.,0,0,0,0
1668179716558,ECE 268,A00,103663,Koushanfar; Farinaz,0,0,0,0
1668179716986,ECE 269,A01,103665,Pal; Piya,0,0,0,0
1668179717414,ECE 271B,A00,103666,Vasconcelos; Manuela,0,0,0,0
1668179717839,ECE 276A,A00,103667,Atanasov; Nikolay A.,0,0,0,0
1668179718277,ECE 277,A00,103668,An; Cheolhong,0,0,0,0
1668179718707,ECE 279,A00,117947,Hall; Drew A.,0,0,0,0
1668179719561,ECE 283,A00,103670,Hsueh; Tzu-Chien,0,0,0,0
1668179719986,ECE 284,A00,103671,Turakhia; Yatish Girish,0,0,0,0
1668179720417,ECE 285,A00,103672,Zheng; Yang,0,0,0,0
1668179720417,ECE 285,B00,103673,Sworder; David D.,0,0,0,0
1668179720843,ECE 287,A00,103676,Javidi; Tara,0,0,0,0
1668179721278,MATH 200B,A00,098023,Salehi Golsefidy; Alireza,12,0,15,3
1668179721702,MATH 202B,A00,098024,Rhoades; Brendon Patrick,9,0,15,6
1668179722126,MATH 203B,A00,098025,Oprea; Dragos N.,10,0,15,5
1668179722552,MATH 204B,A00,098026,Sorensen; Claus M,13,0,15,2
1668179722975,MATH 208,A00,098027,Izadi; Elham,7,0,10,3
1668179723417,MATH 209,A00,098028,Pollack; Aaron,10,0,10,0
1668179723844,MATH 211A,A00,112919,Rogalski; Daniel,9,0,10,1
1668179724277,MATH 211B,A00,112920,Seward; Brandon M.,9,0,10,1
1668179724710,MATH 218,A00,098029,Li; Bo,10,0,10,0
1668179725144,MATH 220B,A00,098030,Novak; Jonathan I,11,0,15,4
1668179725571,MATH 221A,A00,098031,Ebenfelt; Peter F,13,0,15,2
1668179725995,MATH 231B,A00,098032,Zlatos; Andrej,12,0,15,3
1668179726425,MATH 240B,A00,098033,Ni; Lei,9,0,15,6
1668179726849,MATH 243,A00,098034,Jekel; David Andrew,10,0,10,0
1668179727278,MATH 245A,A00,098035,Nie; Jiawang,0,0,15,16
1668179727706,MATH 248,A00,098036,Bejenaru; Ioan,10,0,10,0
1668179728135,MATH 250B,A00,098037,Spolaor; Luca,14,0,15,1
1668179728568,MATH 258,A00,098038,Ni; Lei,10,0,10,0
1668179728995,MATH 264B,A00,098041,Rhoades; Brendon Patrick,9,0,15,6
1668179729429,MATH 268,A00,098042,Buss; Samuel R,10,0,10,0
1668179729856,MATH 269,A00,098043,Rhoades; Brendon Patrick,10,0,10,0
1668179730293,MATH 270B,A00,098044,Li; Bo,10,0,15,5
1668179730715,MATH 272B,A00,098045,Holst; Michael J,13,0,15,2
1668179731155,MATH 273A,A00,098046,Tian; Xiaochuan,10,0,15,5
1668179731580,MATH 275,A01,098048,Tian; Xiaochuan,6,0,10,4
1668179732003,MATH 278A,A00,098049,Holst; Michael J,8,0,10,2
1668179732430,MATH 278B,A00,098050,Cloninger; Alexander,10,0,10,0
1668179732858,MATH 278C,A00,098051,Nie; Jiawang,7,0,10,3
1668179733285,MATH 280B,A00,098052,Zheng; Tianyi,10,0,15,5
1668179733707,MATH 281B,A00,098053,Bradic; Jelena,2,0,15,13
1668179734132,MATH 282B,A00,098054,Arias-Castro; Ery,0,0,15,15
1668179734562,MATH 285,A00,098055,Fitzsimmons; Patrick J,0,0,15,17
1668179734987,MATH 287B,A00,098056,Arias-Castro; Ery,2,0,15,13
1668179735417,MATH 288,A00,098057,Agarwal; Pooja,9,0,10,1
1668179735417,MATH 288,B00,098058,Zhang; Danna,8,0,10,2
1668179735417,MATH 288,C00,098059,Williams; Ruth J,10,0,10,0
1668179735843,MATH 290B,A00,098060,Roberts; Justin Deritter,13,0,15,2
1668179736270,MATH 292,A00,098061,Belmont; Eva Kinoshita,10,0,10,0
1668179736696,MATH 295,A00,098062,Suk; Andrew Hoon,48,0,50,2
1668179737118,MATH 296,A00,098063,Novak; Jonathan I,20,0,20,0
1668179737553,MATH 297,001,098064,Gamst; Anthony Collins,9997,0,9999,2
1668180242193,COGS 205,A00,101395,Chiba; Andrea,19,0,20,1
1668180242624,COGS 210B,001,101404,Greene; Deanna Jacquelyn,9998,0,9999,1
1668180242624,COGS 210B,002,101417,Xia; Haijun,9999,0,9999,0
1668180242624,COGS 210B,003,101422,Nitz; Douglas A.,9999,0,9999,0
1668180242624,COGS 210B,004,101423,Hollan; James D.,9998,0,9999,1
1668180242624,COGS 210B,005,101424,Deak; Gedeon O.,9998,0,9999,1
1668180242624,COGS 210B,006,101425,Rossano; Federico,9999,0,9999,0
1668180243054,COGS 211B,A00,101427,Coulson; Seana M,9996,0,9999,3
1668180243479,COGS 220,A00,101428,Hollan; James D.,0,0,25,25
1668180243906,COGS 229,A00,101429,Dow; Steven P,18,0,25,7
1668180244336,COGS 230,A00,101430,Klemmer; Scott R,12,0,17,5
1668180244768,COGS 234,A00,101431,Xia; Haijun,3,0,25,22
1668180245198,COGS 260,A00,101432,Kiyonaga; Anastasia,20,0,25,5
1668180245198,COGS 260,B00,101433,Kirsh; David Joel,16,0,25,9
1668180245623,CSE 202,A00,102371,Impagliazzo; Russell,0,0,0,0
1668180246052,CSE 203B,A01,102373,Cheng; Chung Kuan,0,0,0,0
1668180246478,CSE 208,A00,102374,Micciancio; Daniele,0,0,0,0
1668180246903,CSE 209A,A00,112895,Impagliazzo; Russell,0,0,15,15
1668180247331,CSE 209B,A00,108005,Bellare; Mihir,0,0,0,0
1668180247755,CSE 210,A00,113163,Coblenz; Michael J,0,0,0,0
1668180248189,CSE 219,A00,106111,Dow; Steven P,0,0,20,20
1668180248616,CSE 221,A00,102376,Voelker; Geoffrey M.,0,0,0,0
1668180249043,CSE 224,A01,102378,Porter; George M,0,0,0,0
1668180249468,CSE 229A,A00,102379,Savage; Stefan,0,0,0,0
1668180249905,CSE 229C,A00,102380,Munyaka; Imani N. S.,0,0,0,0
1668180250330,CSE 232B,A00,102382,Deutsch; Alin Bernard,0,0,0,0
1668180250755,CSE 234,A01,112904,Kumar; Arun Kumar,0,0,0,0
1668180251179,CSE 237A,A00,102383,Rosing; Tajana Simunic,0,0,0,0
1668180251608,CSE 239A,A00,102384,Deutsch; Alin Bernard,0,0,0,0
1668180252033,CSE 239B,A00,102385,Polikarpova; Nadezhda,0,0,0,0
1668180252473,CSE 240A,A00,102386,Pannuto; Patrick William,0,0,0,0
1668180252901,CSE 240B,A00,102387,Zhao; Jishen,0,0,0,0
1668180253344,CSE 241A,A00,106406,Kang; Mingu,0,0,0,0
1668180253771,CSE 249B,A00,102388,Kahng; Andrew Byun,0,0,8,8
1668180254204,CSE 251B,A01,102392,Cottrell; Garrison W,0,0,0,0
1668180254204,CSE 251B,A02,102393,Cottrell; Garrison W,0,0,0,0
1668180254632,CSE 252B,A00,102394,Ochoa; Benjamin Lawrence,0,0,0,0
1668180255055,CSE 257,A01,102396,Gao; Sicun,0,0,0,0
1668180255487,CSE 272,A00,102397,Li; Tzumao,0,0,0,0
1668180255915,CSE 274,A00,111323,Chern; Albert Ren-Haur,0,0,0,0
1668180256340,CSE 282,A00,102398,Pevzner; Pavel Arkadjevich,0,0,0,0
1668180256766,CSE 284,A00,114175,Gymrek; Melissa Ann,0,0,0,0
1668180257194,CSE 290,A00,102399,Chandraker; Manmohan Krishna,0,0,0,0
1668180257194,CSE 290,B00,102400,Vaccaro; Kristen Marie,0,0,25,25
1668180257194,CSE 290,C00,102414,Pannuto; Patrick William,0,0,25,25
1668180257194,CSE 290,D00,102427,Pevzner; Pavel Arkadjevich,0,0,0,0
1668180257194,CSE 290,E00,102429,Zhao; Jishen,0,0,0,0
1668180257194,CSE 290,F00,102436,Tullsen; Dean Michael,0,0,0,0
1668180257194,CSE 290,G00,102440,Christensen; Henrik I,0,0,20,20
1668180257619,CSE 291,A00,102443,Su; Hao,0,0,0,0
1668180257619,CSE 291,B00,102448,Polikarpova; Nadezhda,0,0,0,0
1668180257619,CSE 291,C00,102453,Vaccaro; Kristen Marie,0,0,0,0
1668180257619,CSE 291,D00,111343,Savage; Stefan,0,0,0,0
1668180257619,CSE 291,E00,116474,Claffy; Kimberly Claire,0,0,0,0
1668180257619,CSE 291,F00,116479,Pasquale; Joseph,0,0,0,0
1668180258059,CSE 293,001,119111,Bafna; Vineet,9999,0,9999,0
1668180258059,CSE 293,002,119118,Bellare; Mihir,9999,0,9999,0
1668180258059,CSE 293,003,119122,Berg-Kirkpatrick; Taylor D,9999,0,9999,0
1668180258059,CSE 293,004,119135,Christensen; Henrik I,9999,0,9999,0
1668180258059,CSE 293,005,119142,Cottrell; Garrison W,9999,0,9999,0
1668180258059,CSE 293,006,119146,Deutsch; Alin Bernard,9999,0,9999,0
1668180258059,CSE 293,007,119159,Esmaeilzadeh; Hadi,9999,0,9999,0
1668180258059,CSE 293,008,119166,Freund; Yoav,9999,0,9999,0
1668180258059,CSE 293,009,119170,Griswold; William G.,9999,0,9999,0
1668180258059,CSE 293,010,119183,Gymrek; Melissa Ann,9999,0,9999,0
1668180258059,CSE 293,011,119190,Heninger; Nadia A,9999,0,9999,0
1668180258059,CSE 293,012,119230,Impagliazzo; Russell,9999,0,9999,0
1668180258059,CSE 293,013,119232,Jhala; Ranjit,9999,0,9999,0
1668180258059,CSE 293,014,119233,Kahng; Andrew Byun,9999,0,9999,0
1668180258059,CSE 293,015,119298,Kane; Daniel Mertz,9999,0,9999,0
1668180258059,CSE 293,016,119299,Kriegman; David J,9999,0,9999,0
1668180258059,CSE 293,017,119300,Kumar; Arun Kumar,9999,0,9999,0
1668180258059,CSE 293,018,119301,Lerner; Sorin,9999,0,9999,0
1668180258059,CSE 293,019,119302,Lovett; Shachar,9999,0,9999,0
1668180258059,CSE 293,020,119303,McAuley; Julian John,9999,0,9999,0
1668180258059,CSE 293,021,119304,Micciancio; Daniele,9999,0,9999,0
1668180258059,CSE 293,022,119367,Orailoglu; Alex,9999,0,9999,0
1668180258059,CSE 293,023,119382,Paturi; Ramamohan,9999,0,9999,0
1668180258059,CSE 293,024,119404,Polikarpova; Nadezhda,9999,0,9999,0
1668180258059,CSE 293,025,119406,Politz; Joseph Gibbs,9999,0,9999,0
1668180258059,CSE 293,026,119411,Porter; George M,9999,0,9999,0
1668180258059,CSE 293,027,119414,Porter; Leonard Emerson,9999,0,9999,0
1668180258059,CSE 293,028,119416,Ramamoorthi; Ravi,9999,0,9999,0
1668180258059,CSE 293,029,119417,Sahoo; Debashis,9999,0,9999,0
1668180258059,CSE 293,030,119420,Saul; Lawrence,9999,0,9999,0
1668180258059,CSE 293,031,119421,Savage; Stefan,9999,0,9999,0
1668180258059,CSE 293,032,119425,Schulze; Jurgen P.,9999,0,9999,0
1668180258059,CSE 293,033,119426,Snoeren; Alex C.,9999,0,9999,0
1668180258059,CSE 293,034,119428,Shang; Jingbo,9999,0,9999,0
1668180258059,CSE 293,035,119430,Stefan; Deian,9999,0,9999,0
1668180258059,CSE 293,036,119431,Su; Hao,9999,0,9999,0
1668180258059,CSE 293,037,119433,Swanson; Steven James,9999,0,9999,0
1668180258059,CSE 293,038,119435,Tullsen; Dean Michael,9999,0,9999,0
1668180258059,CSE 293,039,119483,Voelker; Geoffrey M.,9999,0,9999,0
1668180258059,CSE 293,040,119537,Zhao; Jishen,9999,0,9999,0
1668180258059,CSE 293,041,119538,Zhou; Yuan-Yuan,9999,0,9999,0
1668180258059,CSE 293,042,119539,Gao; Sicun,9999,0,9999,0
1668180258059,CSE 293,043,119540,Weibel; Nadir,9999,0,9999,0
1668180258059,CSE 293,044,119541,Gupta; Rajesh K.,9999,0,9999,0
1668180258059,CSE 293,045,126410,Vaccaro; Kristen Marie,9999,0,9999,0
1668180258059,CSE 293,046,126411,Klemke; Richard,9999,0,9999,0
1668180258483,CSE 294,A00,102459,Voelker; Geoffrey M.,0,0,0,0
1668180258483,CSE 294,B00,111322,Orailoglu; Alex,0,0,0,0
1668180258911,DSE 201,A00,096914,Deutsch; Alin Bernard,30,0,30,0
1668180259335,DSE 210,A00,096915,Dasgupta; Sanjoy,30,0,30,0
1668180259786,DSE 260A,A00,096916,Altintas De Callaf; Ilkay,30,0,30,0
1668180260236,ECE 200,001,103586,Antipa; Nicholas A,9999,0,9999,0
1668180260236,ECE 200,002,103587,Atanasov; Nikolay A.,9999,0,9999,0
1668180260236,ECE 200,003,103588,Bharadia; Dinesh,9999,0,9999,0
1668180260236,ECE 200,004,103589,Cheng; Chung Kuan,9999,0,9999,0
1668180260236,ECE 200,005,103590,Cosman; Pamela C.,9999,0,9999,0
1668180260236,ECE 200,006,103591,Dayeh; Shadi Ahmad,9999,0,9999,0
1668180260236,ECE 200,007,103592,Fainman; Yeshaiahu,9999,0,9999,0
1668180260236,ECE 200,008,103593,Ford; Joseph Earl,9999,0,9999,0
1668180260236,ECE 200,009,103594,Franceschetti; Massimo,9999,0,9999,0
1668180260236,ECE 200,010,103595,Fullerton; Eric E,9999,0,9999,0
1668180260236,ECE 200,011,103596,Galton; Ian A,9999,0,9999,0
1668180260236,ECE 200,012,103597,Gilja; Vikash,9999,0,9999,0
1668180260236,ECE 200,013,103598,Hall; Drew A.,9999,0,9999,0
1668180260236,ECE 200,014,103599,Hsueh; Tzu-Chien,9999,0,9999,0
1668180260236,ECE 200,015,103600,Javidi; Tara,9999,0,9999,0
1668180260236,ECE 200,016,103601,Kahng; Andrew Byun,9999,0,9999,0
1668180260236,ECE 200,017,103602,Kim; Young-Han,9999,0,9999,0
1668180260236,ECE 200,018,103603,Koushanfar; Farinaz,9999,0,9999,0
1668180260236,ECE 200,019,103604,Kuzum; Duygu,9999,0,9999,0
1668180260236,ECE 200,020,103605,Le; Hanh-Phuc,9999,0,9999,0
1668180260236,ECE 200,021,103606,Lin; Bill,9999,0,9999,0
1668180260236,ECE 200,022,103607,Liu; Zhaowei,9998,0,9999,1
1668180260236,ECE 200,023,103608,Lo; Yu-Hwa,9999,0,9999,0
1668180260236,ECE 200,024,103609,Lomakin; Vitaliy,9999,0,9999,0
1668180260236,ECE 200,025,103610,Mercier; Patrick Philip,9999,0,9999,0
1668180260236,ECE 200,026,103611,Meyer; Florian,9999,0,9999,0
1668180260236,ECE 200,027,103612,Milstein; Laurence B.,9999,0,9999,0
1668180260236,ECE 200,028,103613,Mir Arabbaygi; Siavash,9999,0,9999,0
1668180260236,ECE 200,029,103614,Mookherjea; Shayan,9999,0,9999,0
1668180260236,ECE 200,030,103615,Morris; Karcher William,9999,0,9999,0
1668180260236,ECE 200,031,103616,Ng; Tse Nga,9999,0,9999,0
1668180260236,ECE 200,032,103617,Nguyen; Truong Quang,9999,0,9999,0
1668180260236,ECE 200,033,103618,Nomura; Kenji,9999,0,9999,0
1668180260236,ECE 200,034,103619,Orlitsky; Alon,9999,0,9999,0
1668180260236,ECE 200,035,103620,Pal; Piya,9999,0,9999,0
1668180260236,ECE 200,036,103621,Papen; George C.,9999,0,9999,0
1668180260236,ECE 200,037,103622,Radic; Stojan,9999,0,9999,0
1668180260236,ECE 200,038,103623,Rao; Bhaskar D.,9999,0,9999,0
1668180260236,ECE 200,039,103624,Rao; Ramesh R,9999,0,9999,0
1668180260236,ECE 200,040,103625,Rebeiz; Gabriel,9999,0,9999,0
1668180260236,ECE 200,041,103626,Sanford; John R,9999,0,9999,0
1668180260236,ECE 200,042,103627,Siegel; Paul H.,9999,0,9999,0
1668180260236,ECE 200,043,103628,Sievenpiper; Daniel F.,9999,0,9999,0
1668180260236,ECE 200,044,103629,Sworder; David D.,9999,0,9999,0
1668180260236,ECE 200,045,103630,Taur; Yuan,9999,0,9999,0
1668180260236,ECE 200,046,103631,Touri; Behrouz,9999,0,9999,0
1668180260236,ECE 200,047,103632,Trivedi; Mohan M.,9999,0,9999,0
1668180260236,ECE 200,048,103633,Vasconcelos; Nuno,9999,0,9999,0
1668180260236,ECE 200,049,103634,Wang; Xiaolong,9999,0,9999,0
1668180260236,ECE 200,050,103635,Xie; Pengtao,9999,0,9999,0
1668180260236,ECE 200,051,103636,Yip; Michael,9999,0,9999,0
1668180260236,ECE 200,052,103637,Zeger; Kenneth A.,999,0,999,0
1668180260236,ECE 200,053,103638,Zhang; Xinyu,9999,0,9999,0
1668180260236,ECE 200,054,103639,Turakhia; Yatish Girish,9999,0,9999,0
1668180260236,ECE 200,055,103640,Kang; Mingu,9999,0,9999,0
1668180260236,ECE 200,056,103641,Shi; Yuanyuan,9999,0,9999,0
1668180260236,ECE 200,057,103642,Wang; Edward Jay,9999,0,9999,0
1668180260236,ECE 200,058,103643,Zheng; Yang,9999,0,9999,0
1668180260661,ECE 202,A00,103644,Kuzum; Duygu,0,0,0,0
1668180261096,ECE 212BN,A00,103646,Ng; Tse Nga,0,0,0,0
1668180261519,ECE 221,A00,111493,Staff,0,0,0,0
1668180261949,ECE 222B,A00,103647,Lomakin; Vitaliy,0,0,0,0
1668180262382,ECE 230B,A00,103648,Taur; Yuan,0,0,0,0
1668180262808,ECE 238B,A00,103649,Garay; Javier,0,0,0,0
1668180263257,ECE 240B,A00,112900,Fainman; Yeshaiahu,0,0,0,0
1668180263700,ECE 247A,A00,103650,Jokerst; Jesse Vincent,0,0,0,0
1668180264126,ECE 247B,A00,103651,Wang; Joseph,0,0,0,0
1668180264549,ECE 250,A00,103652,Siegel; Paul H.,0,0,0,0
1668180264983,ECE 251A,A00,103654,Rao; Bhaskar D.,0,0,0,0
1668180265406,ECE 257B,A00,103655,Bharadia; Dinesh,0,0,0,0
1668180265833,ECE 258A,A00,103656,Milstein; Laurence B.,0,0,0,0
1668180266258,ECE 260B,A00,103658,Kang; Mingu,0,0,0,0
1668180266683,ECE 264A,A00,103659,Galton; Ian A,0,0,0,0
1668180267109,ECE 265A,A00,103661,Gudem; Prasad S.S.,0,0,0,0
1668180267532,ECE 265D,A00,103662,Gudem; Prasad S.S.,0,0,0,0
1668180267958,ECE 268,A00,103663,Koushanfar; Farinaz,0,0,0,0
1668180268392,ECE 269,A01,103665,Pal; Piya,0,0,0,0
1668180268829,ECE 271B,A00,103666,Vasconcelos; Manuela,0,0,0,0
1668180269253,ECE 276A,A00,103667,Atanasov; Nikolay A.,0,0,0,0
1668180269686,ECE 277,A00,103668,An; Cheolhong,0,0,0,0
1668180270127,ECE 279,A00,117947,Hall; Drew A.,0,0,0,0
1668180270975,ECE 283,A00,103670,Hsueh; Tzu-Chien,0,0,0,0
1668180271400,ECE 284,A00,103671,Turakhia; Yatish Girish,0,0,0,0
1668180271836,ECE 285,A00,103672,Zheng; Yang,0,0,0,0
1668180271836,ECE 285,B00,103673,Sworder; David D.,0,0,0,0
1668180272263,ECE 287,A00,103676,Javidi; Tara,0,0,0,0
1668180272687,MATH 200B,A00,098023,Salehi Golsefidy; Alireza,12,0,15,3
1668180273117,MATH 202B,A00,098024,Rhoades; Brendon Patrick,9,0,15,6
1668180273545,MATH 203B,A00,098025,Oprea; Dragos N.,10,0,15,5
1668180273977,MATH 204B,A00,098026,Sorensen; Claus M,13,0,15,2
1668180274400,MATH 208,A00,098027,Izadi; Elham,7,0,10,3
1668180274826,MATH 209,A00,098028,Pollack; Aaron,10,0,10,0
1668180275260,MATH 211A,A00,112919,Rogalski; Daniel,9,0,10,1
1668180275687,MATH 211B,A00,112920,Seward; Brandon M.,9,0,10,1
1668180276206,MATH 218,A00,098029,Li; Bo,10,0,10,0
1668180276632,MATH 220B,A00,098030,Novak; Jonathan I,11,0,15,4
1668180277061,MATH 221A,A00,098031,Ebenfelt; Peter F,13,0,15,2
1668180277489,MATH 231B,A00,098032,Zlatos; Andrej,12,0,15,3
1668180277915,MATH 240B,A00,098033,Ni; Lei,9,0,15,6
1668180278341,MATH 243,A00,098034,Jekel; David Andrew,10,0,10,0
1668180278765,MATH 245A,A00,098035,Nie; Jiawang,0,0,15,16
1668180279194,MATH 248,A00,098036,Bejenaru; Ioan,10,0,10,0
1668180279617,MATH 250B,A00,098037,Spolaor; Luca,14,0,15,1
1668180280045,MATH 258,A00,098038,Ni; Lei,10,0,10,0
1668180280470,MATH 264B,A00,098041,Rhoades; Brendon Patrick,9,0,15,6
1668180280912,MATH 268,A00,098042,Buss; Samuel R,10,0,10,0
1668180281336,MATH 269,A00,098043,Rhoades; Brendon Patrick,10,0,10,0
1668180281783,MATH 270B,A00,098044,Li; Bo,10,0,15,5
1668180282211,MATH 272B,A00,098045,Holst; Michael J,13,0,15,2
1668180282643,MATH 273A,A00,098046,Tian; Xiaochuan,10,0,15,5
1668180283067,MATH 275,A01,098048,Tian; Xiaochuan,6,0,10,4
1668180283502,MATH 278A,A00,098049,Holst; Michael J,8,0,10,2
1668180283925,MATH 278B,A00,098050,Cloninger; Alexander,10,0,10,0
1668180284353,MATH 278C,A00,098051,Nie; Jiawang,7,0,10,3
1668180284777,MATH 280B,A00,098052,Zheng; Tianyi,10,0,15,5
1668180285201,MATH 281B,A00,098053,Bradic; Jelena,2,0,15,13
1668180285623,MATH 282B,A00,098054,Arias-Castro; Ery,0,0,15,15
1668180286056,MATH 285,A00,098055,Fitzsimmons; Patrick J,0,0,15,17
1668180286481,MATH 287B,A00,098056,Arias-Castro; Ery,2,0,15,13
1668180286911,MATH 288,A00,098057,Agarwal; Pooja,9,0,10,1
1668180286911,MATH 288,B00,098058,Zhang; Danna,8,0,10,2
1668180286911,MATH 288,C00,098059,Williams; Ruth J,10,0,10,0
1668180287336,MATH 290B,A00,098060,Roberts; Justin Deritter,13,0,15,2
1668180287766,MATH 292,A00,098061,Belmont; Eva Kinoshita,10,0,10,0
1668180288194,MATH 295,A00,098062,Suk; Andrew Hoon,48,0,50,2
1668180288617,MATH 296,A00,098063,Novak; Jonathan I,20,0,20,0
1668180289041,MATH 297,001,098064,Gamst; Anthony Collins,9997,0,9999,2
1668180792959,COGS 205,A00,101395,Chiba; Andrea,19,0,20,1
1668180793385,COGS 210B,001,101404,Greene; Deanna Jacquelyn,9998,0,9999,1
1668180793385,COGS 210B,002,101417,Xia; Haijun,9999,0,9999,0
1668180793385,COGS 210B,003,101422,Nitz; Douglas A.,9999,0,9999,0
1668180793385,COGS 210B,004,101423,Hollan; James D.,9998,0,9999,1
1668180793385,COGS 210B,005,101424,Deak; Gedeon O.,9998,0,9999,1
1668180793385,COGS 210B,006,101425,Rossano; Federico,9999,0,9999,0
1668180793815,COGS 211B,A00,101427,Coulson; Seana M,9996,0,9999,3
1668180794240,COGS 220,A00,101428,Hollan; James D.,0,0,25,25
1668180794678,COGS 229,A00,101429,Dow; Steven P,18,0,25,7
1668180795106,COGS 230,A00,101430,Klemmer; Scott R,12,0,17,5
1668180795531,COGS 234,A00,101431,Xia; Haijun,3,0,25,22
1668180795957,COGS 260,A00,101432,Kiyonaga; Anastasia,20,0,25,5
1668180795957,COGS 260,B00,101433,Kirsh; David Joel,16,0,25,9
1668180796383,CSE 202,A00,102371,Impagliazzo; Russell,0,0,0,0
1668180796811,CSE 203B,A01,102373,Cheng; Chung Kuan,0,0,0,0
1668180797244,CSE 208,A00,102374,Micciancio; Daniele,0,0,0,0
1668180797672,CSE 209A,A00,112895,Impagliazzo; Russell,0,0,15,15
1668180798107,CSE 209B,A00,108005,Bellare; Mihir,0,0,0,0
1668180798540,CSE 210,A00,113163,Coblenz; Michael J,0,0,0,0
1668180798967,CSE 219,A00,106111,Dow; Steven P,0,0,20,20
1668180799404,CSE 221,A00,102376,Voelker; Geoffrey M.,0,0,0,0
1668180799832,CSE 224,A01,102378,Porter; George M,0,0,0,0
1668180800359,CSE 229A,A00,102379,Savage; Stefan,0,0,0,0
1668180800785,CSE 229C,A00,102380,Munyaka; Imani N. S.,0,0,0,0
1668180801211,CSE 232B,A00,102382,Deutsch; Alin Bernard,0,0,0,0
1668180801639,CSE 234,A01,112904,Kumar; Arun Kumar,0,0,0,0
1668180802065,CSE 237A,A00,102383,Rosing; Tajana Simunic,0,0,0,0
1668180802489,CSE 239A,A00,102384,Deutsch; Alin Bernard,0,0,0,0
1668180802927,CSE 239B,A00,102385,Polikarpova; Nadezhda,0,0,0,0
1668180803351,CSE 240A,A00,102386,Pannuto; Patrick William,0,0,0,0
1668180803775,CSE 240B,A00,102387,Zhao; Jishen,0,0,0,0
1668180804209,CSE 241A,A00,106406,Kang; Mingu,0,0,0,0
1668180804634,CSE 249B,A00,102388,Kahng; Andrew Byun,0,0,8,8
1668180805061,CSE 251B,A01,102392,Cottrell; Garrison W,0,0,0,0
1668180805061,CSE 251B,A02,102393,Cottrell; Garrison W,0,0,0,0
1668180805490,CSE 252B,A00,102394,Ochoa; Benjamin Lawrence,0,0,0,0
1668180805918,CSE 257,A01,102396,Gao; Sicun,0,0,0,0
1668180806343,CSE 272,A00,102397,Li; Tzumao,0,0,0,0
1668180806772,CSE 274,A00,111323,Chern; Albert Ren-Haur,0,0,0,0
1668180807201,CSE 282,A00,102398,Pevzner; Pavel Arkadjevich,0,0,0,0
1668180807628,CSE 284,A00,114175,Gymrek; Melissa Ann,0,0,0,0
1668180808056,CSE 290,A00,102399,Chandraker; Manmohan Krishna,0,0,0,0
1668180808056,CSE 290,B00,102400,Vaccaro; Kristen Marie,0,0,25,25
1668180808056,CSE 290,C00,102414,Pannuto; Patrick William,0,0,25,25
1668180808056,CSE 290,D00,102427,Pevzner; Pavel Arkadjevich,0,0,0,0
1668180808056,CSE 290,E00,102429,Zhao; Jishen,0,0,0,0
1668180808056,CSE 290,F00,102436,Tullsen; Dean Michael,0,0,0,0
1668180808056,CSE 290,G00,102440,Christensen; Henrik I,0,0,20,20
1668180808481,CSE 291,A00,102443,Su; Hao,0,0,0,0
1668180808481,CSE 291,B00,102448,Polikarpova; Nadezhda,0,0,0,0
1668180808481,CSE 291,C00,102453,Vaccaro; Kristen Marie,0,0,0,0
1668180808481,CSE 291,D00,111343,Savage; Stefan,0,0,0,0
1668180808481,CSE 291,E00,116474,Claffy; Kimberly Claire,0,0,0,0
1668180808481,CSE 291,F00,116479,Pasquale; Joseph,0,0,0,0
1668180808913,CSE 293,001,119111,Bafna; Vineet,9999,0,9999,0
1668180808913,CSE 293,002,119118,Bellare; Mihir,9999,0,9999,0
1668180808913,CSE 293,003,119122,Berg-Kirkpatrick; Taylor D,9999,0,9999,0
1668180808913,CSE 293,004,119135,Christensen; Henrik I,9999,0,9999,0
1668180808913,CSE 293,005,119142,Cottrell; Garrison W,9999,0,9999,0
1668180808913,CSE 293,006,119146,Deutsch; Alin Bernard,9999,0,9999,0
1668180808913,CSE 293,007,119159,Esmaeilzadeh; Hadi,9999,0,9999,0
1668180808913,CSE 293,008,119166,Freund; Yoav,9999,0,9999,0
1668180808913,CSE 293,009,119170,Griswold; William G.,9999,0,9999,0
1668180808913,CSE 293,010,119183,Gymrek; Melissa Ann,9999,0,9999,0
1668180808913,CSE 293,011,119190,Heninger; Nadia A,9999,0,9999,0
1668180808913,CSE 293,012,119230,Impagliazzo; Russell,9999,0,9999,0
1668180808913,CSE 293,013,119232,Jhala; Ranjit,9999,0,9999,0
1668180808913,CSE 293,014,119233,Kahng; Andrew Byun,9999,0,9999,0
1668180808913,CSE 293,015,119298,Kane; Daniel Mertz,9999,0,9999,0
1668180808913,CSE 293,016,119299,Kriegman; David J,9999,0,9999,0
1668180808913,CSE 293,017,119300,Kumar; Arun Kumar,9999,0,9999,0
1668180808913,CSE 293,018,119301,Lerner; Sorin,9999,0,9999,0
1668180808913,CSE 293,019,119302,Lovett; Shachar,9999,0,9999,0
1668180808913,CSE 293,020,119303,McAuley; Julian John,9999,0,9999,0
1668180808913,CSE 293,021,119304,Micciancio; Daniele,9999,0,9999,0
1668180808913,CSE 293,022,119367,Orailoglu; Alex,9999,0,9999,0
1668180808913,CSE 293,023,119382,Paturi; Ramamohan,9999,0,9999,0
1668180808913,CSE 293,024,119404,Polikarpova; Nadezhda,9999,0,9999,0
1668180808913,CSE 293,025,119406,Politz; Joseph Gibbs,9999,0,9999,0
1668180808913,CSE 293,026,119411,Porter; George M,9999,0,9999,0
1668180808913,CSE 293,027,119414,Porter; Leonard Emerson,9999,0,9999,0
1668180808913,CSE 293,028,119416,Ramamoorthi; Ravi,9999,0,9999,0
1668180808913,CSE 293,029,119417,Sahoo; Debashis,9999,0,9999,0
1668180808913,CSE 293,030,119420,Saul; Lawrence,9999,0,9999,0
1668180808913,CSE 293,031,119421,Savage; Stefan,9999,0,9999,0
1668180808913,CSE 293,032,119425,Schulze; Jurgen P.,9999,0,9999,0
1668180808913,CSE 293,033,119426,Snoeren; Alex C.,9999,0,9999,0
1668180808913,CSE 293,034,119428,Shang; Jingbo,9999,0,9999,0
1668180808913,CSE 293,035,119430,Stefan; Deian,9999,0,9999,0
1668180808913,CSE 293,036,119431,Su; Hao,9999,0,9999,0
1668180808913,CSE 293,037,119433,Swanson; Steven James,9999,0,9999,0
1668180808913,CSE 293,038,119435,Tullsen; Dean Michael,9999,0,9999,0
1668180808913,CSE 293,039,119483,Voelker; Geoffrey M.,9999,0,9999,0
1668180808913,CSE 293,040,119537,Zhao; Jishen,9999,0,9999,0
1668180808913,CSE 293,041,119538,Zhou; Yuan-Yuan,9999,0,9999,0
1668180808913,CSE 293,042,119539,Gao; Sicun,9999,0,9999,0
1668180808913,CSE 293,043,119540,Weibel; Nadir,9999,0,9999,0
1668180808913,CSE 293,044,119541,Gupta; Rajesh K.,9999,0,9999,0
1668180808913,CSE 293,045,126410,Vaccaro; Kristen Marie,9999,0,9999,0
1668180808913,CSE 293,046,126411,Klemke; Richard,9999,0,9999,0
1668180809337,CSE 294,A00,102459,Voelker; Geoffrey M.,0,0,0,0
1668180809337,CSE 294,B00,111322,Orailoglu; Alex,0,0,0,0
1668180809768,DSE 201,A00,096914,Deutsch; Alin Bernard,30,0,30,0
1668180810195,DSE 210,A00,096915,Dasgupta; Sanjoy,30,0,30,0
1668180810624,DSE 260A,A00,096916,Altintas De Callaf; Ilkay,30,0,30,0
1668180811099,ECE 200,001,103586,Antipa; Nicholas A,9999,0,9999,0
1668180811099,ECE 200,002,103587,Atanasov; Nikolay A.,9999,0,9999,0
1668180811099,ECE 200,003,103588,Bharadia; Dinesh,9999,0,9999,0
1668180811099,ECE 200,004,103589,Cheng; Chung Kuan,9999,0,9999,0
1668180811099,ECE 200,005,103590,Cosman; Pamela C.,9999,0,9999,0
1668180811099,ECE 200,006,103591,Dayeh; Shadi Ahmad,9999,0,9999,0
1668180811099,ECE 200,007,103592,Fainman; Yeshaiahu,9999,0,9999,0
1668180811099,ECE 200,008,103593,Ford; Joseph Earl,9999,0,9999,0
1668180811099,ECE 200,009,103594,Franceschetti; Massimo,9999,0,9999,0
1668180811099,ECE 200,010,103595,Fullerton; Eric E,9999,0,9999,0
1668180811099,ECE 200,011,103596,Galton; Ian A,9999,0,9999,0
1668180811099,ECE 200,012,103597,Gilja; Vikash,9999,0,9999,0
1668180811099,ECE 200,013,103598,Hall; Drew A.,9999,0,9999,0
1668180811099,ECE 200,014,103599,Hsueh; Tzu-Chien,9999,0,9999,0
1668180811099,ECE 200,015,103600,Javidi; Tara,9999,0,9999,0
1668180811099,ECE 200,016,103601,Kahng; Andrew Byun,9999,0,9999,0
1668180811099,ECE 200,017,103602,Kim; Young-Han,9999,0,9999,0
1668180811099,ECE 200,018,103603,Koushanfar; Farinaz,9999,0,9999,0
1668180811099,ECE 200,019,103604,Kuzum; Duygu,9999,0,9999,0
1668180811099,ECE 200,020,103605,Le; Hanh-Phuc,9999,0,9999,0
1668180811099,ECE 200,021,103606,Lin; Bill,9999,0,9999,0
1668180811099,ECE 200,022,103607,Liu; Zhaowei,9998,0,9999,1
1668180811099,ECE 200,023,103608,Lo; Yu-Hwa,9999,0,9999,0
1668180811099,ECE 200,024,103609,Lomakin; Vitaliy,9999,0,9999,0
1668180811099,ECE 200,025,103610,Mercier; Patrick Philip,9999,0,9999,0
1668180811099,ECE 200,026,103611,Meyer; Florian,9999,0,9999,0
1668180811099,ECE 200,027,103612,Milstein; Laurence B.,9999,0,9999,0
1668180811099,ECE 200,028,103613,Mir Arabbaygi; Siavash,9999,0,9999,0
1668180811099,ECE 200,029,103614,Mookherjea; Shayan,9999,0,9999,0
1668180811099,ECE 200,030,103615,Morris; Karcher William,9999,0,9999,0
1668180811099,ECE 200,031,103616,Ng; Tse Nga,9999,0,9999,0
1668180811099,ECE 200,032,103617,Nguyen; Truong Quang,9999,0,9999,0
1668180811099,ECE 200,033,103618,Nomura; Kenji,9999,0,9999,0
1668180811099,ECE 200,034,103619,Orlitsky; Alon,9999,0,9999,0
1668180811099,ECE 200,035,103620,Pal; Piya,9999,0,9999,0
1668180811099,ECE 200,036,103621,Papen; George C.,9999,0,9999,0
1668180811099,ECE 200,037,103622,Radic; Stojan,9999,0,9999,0
1668180811099,ECE 200,038,103623,Rao; Bhaskar D.,9999,0,9999,0
1668180811099,ECE 200,039,103624,Rao; Ramesh R,9999,0,9999,0
1668180811099,ECE 200,040,103625,Rebeiz; Gabriel,9999,0,9999,0
1668180811099,ECE 200,041,103626,Sanford; John R,9999,0,9999,0
1668180811099,ECE 200,042,103627,Siegel; Paul H.,9999,0,9999,0
1668180811099,ECE 200,043,103628,Sievenpiper; Daniel F.,9999,0,9999,0
1668180811099,ECE 200,044,103629,Sworder; David D.,9999,0,9999,0
1668180811099,ECE 200,045,103630,Taur; Yuan,9999,0,9999,0
1668180811099,ECE 200,046,103631,Touri; Behrouz,9999,0,9999,0
1668180811099,ECE 200,047,103632,Trivedi; Mohan M.,9999,0,9999,0
1668180811099,ECE 200,048,103633,Vasconcelos; Nuno,9999,0,9999,0
1668180811099,ECE 200,049,103634,Wang; Xiaolong,9999,0,9999,0
1668180811099,ECE 200,050,103635,Xie; Pengtao,9999,0,9999,0
1668180811099,ECE 200,051,103636,Yip; Michael,9999,0,9999,0
1668180811099,ECE 200,052,103637,Zeger; Kenneth A.,999,0,999,0
1668180811099,ECE 200,053,103638,Zhang; Xinyu,9999,0,9999,0
1668180811099,ECE 200,054,103639,Turakhia; Yatish Girish,9999,0,9999,0
1668180811099,ECE 200,055,103640,Kang; Mingu,9999,0,9999,0
1668180811099,ECE 200,056,103641,Shi; Yuanyuan,9999,0,9999,0
1668180811099,ECE 200,057,103642,Wang; Edward Jay,9999,0,9999,0
1668180811099,ECE 200,058,103643,Zheng; Yang,9999,0,9999,0
1668180811525,ECE 202,A00,103644,Kuzum; Duygu,0,0,0,0
1668180811979,ECE 212BN,A00,103646,Ng; Tse Nga,0,0,0,0
1668180812406,ECE 221,A00,111493,Staff,0,0,0,0
1668180812832,ECE 222B,A00,103647,Lomakin; Vitaliy,0,0,0,0
1668180813258,ECE 230B,A00,103648,Taur; Yuan,0,0,0,0
1668180813698,ECE 238B,A00,103649,Garay; Javier,0,0,0,0
1668180814123,ECE 240B,A00,112900,Fainman; Yeshaiahu,0,0,0,0
1668180814561,ECE 247A,A00,103650,Jokerst; Jesse Vincent,0,0,0,0
1668180814992,ECE 247B,A00,103651,Wang; Joseph,0,0,0,0
1668180815418,ECE 250,A00,103652,Siegel; Paul H.,0,0,0,0
1668180815845,ECE 251A,A00,103654,Rao; Bhaskar D.,0,0,0,0
1668180816274,ECE 257B,A00,103655,Bharadia; Dinesh,0,0,0,0
1668180816699,ECE 258A,A00,103656,Milstein; Laurence B.,0,0,0,0
1668180817132,ECE 260B,A00,103658,Kang; Mingu,0,0,0,0
1668180817555,ECE 264A,A00,103659,Galton; Ian A,0,0,0,0
1668180817985,ECE 265A,A00,103661,Gudem; Prasad S.S.,0,0,0,0
1668180818409,ECE 265D,A00,103662,Gudem; Prasad S.S.,0,0,0,0
1668180818835,ECE 268,A00,103663,Koushanfar; Farinaz,0,0,0,0
1668180819260,ECE 269,A01,103665,Pal; Piya,0,0,0,0
1668180819688,ECE 271B,A00,103666,Vasconcelos; Manuela,0,0,0,0
1668180820115,ECE 276A,A00,103667,Atanasov; Nikolay A.,0,0,0,0
1668180820543,ECE 277,A00,103668,An; Cheolhong,0,0,0,0
1668180820971,ECE 279,A00,117947,Hall; Drew A.,0,0,0,0
1668180821837,ECE 283,A00,103670,Hsueh; Tzu-Chien,0,0,0,0
1668180822261,ECE 284,A00,103671,Turakhia; Yatish Girish,0,0,0,0
1668180822685,ECE 285,A00,103672,Zheng; Yang,0,0,0,0
1668180822685,ECE 285,B00,103673,Sworder; David D.,0,0,0,0
1668180823113,ECE 287,A00,103676,Javidi; Tara,0,0,0,0
1668180823538,MATH 200B,A00,098023,Salehi Golsefidy; Alireza,12,0,15,3
1668180823971,MATH 202B,A00,098024,Rhoades; Brendon Patrick,9,0,15,6
1668180824396,MATH 203B,A00,098025,Oprea; Dragos N.,10,0,15,5
1668180824831,MATH 204B,A00,098026,Sorensen; Claus M,13,0,15,2
1668180825260,MATH 208,A00,098027,Izadi; Elham,7,0,10,3
1668180825683,MATH 209,A00,098028,Pollack; Aaron,10,0,10,0
1668180826120,MATH 211A,A00,112919,Rogalski; Daniel,9,0,10,1
1668180826543,MATH 211B,A00,112920,Seward; Brandon M.,9,0,10,1
1668180826981,MATH 218,A00,098029,Li; Bo,10,0,10,0
1668180827415,MATH 220B,A00,098030,Novak; Jonathan I,11,0,15,4
1668180827839,MATH 221A,A00,098031,Ebenfelt; Peter F,13,0,15,2
1668180828263,MATH 231B,A00,098032,Zlatos; Andrej,12,0,15,3
1668180828698,MATH 240B,A00,098033,Ni; Lei,9,0,15,6
1668180829127,MATH 243,A00,098034,Jekel; David Andrew,10,0,10,0
1668180829554,MATH 245A,A00,098035,Nie; Jiawang,0,0,15,16
1668180829977,MATH 248,A00,098036,Bejenaru; Ioan,10,0,10,0
1668180830402,MATH 250B,A00,098037,Spolaor; Luca,14,0,15,1
1668180830827,MATH 258,A00,098038,Ni; Lei,10,0,10,0
1668180831254,MATH 264B,A00,098041,Rhoades; Brendon Patrick,9,0,15,6
1668180831677,MATH 268,A00,098042,Buss; Samuel R,10,0,10,0
1668180832119,MATH 269,A00,098043,Rhoades; Brendon Patrick,10,0,10,0
1668180832545,MATH 270B,A00,098044,Li; Bo,10,0,15,5
1668180832974,MATH 272B,A00,098045,Holst; Michael J,13,0,15,2
1668180833398,MATH 273A,A00,098046,Tian; Xiaochuan,10,0,15,5
1668180833823,MATH 275,A01,098048,Tian; Xiaochuan,6,0,10,4
1668180834247,MATH 278A,A00,098049,Holst; Michael J,8,0,10,2
1668180834672,MATH 278B,A00,098050,Cloninger; Alexander,10,0,10,0
1668180835105,MATH 278C,A00,098051,Nie; Jiawang,7,0,10,3
1668180835531,MATH 280B,A00,098052,Zheng; Tianyi,10,0,15,5
1668180835954,MATH 281B,A00,098053,Bradic; Jelena,2,0,15,13
1668180836383,MATH 282B,A00,098054,Arias-Castro; Ery,0,0,15,15
1668180836811,MATH 285,A00,098055,Fitzsimmons; Patrick J,0,0,15,17
1668180837235,MATH 287B,A00,098056,Arias-Castro; Ery,2,0,15,13
1668180837667,MATH 288,A00,098057,Agarwal; Pooja,9,0,10,1
1668180837667,MATH 288,B00,098058,Zhang; Danna,8,0,10,2
1668180837667,MATH 288,C00,098059,Williams; Ruth J,10,0,10,0
1668180838092,MATH 290B,A00,098060,Roberts; Justin Deritter,13,0,15,2
1668180838525,MATH 292,A00,098061,Belmont; Eva Kinoshita,10,0,10,0
1668180838953,MATH 295,A00,098062,Suk; Andrew Hoon,48,0,50,2
1668180839379,MATH 296,A00,098063,Novak; Jonathan I,20,0,20,0
1668180839805,MATH 297,001,098064,Gamst; Anthony Collins,9997,0,9999,2
1668181343028,COGS 205,A00,101395,Chiba; Andrea,19,0,20,1
1668181343456,COGS 210B,001,101404,Greene; Deanna Jacquelyn,9998,0,9999,1
1668181343456,COGS 210B,002,101417,Xia; Haijun,9999,0,9999,0
1668181343456,COGS 210B,003,101422,Nitz; Douglas A.,9999,0,9999,0
1668181343456,COGS 210B,004,101423,Hollan; James D.,9998,0,9999,1
1668181343456,COGS 210B,005,101424,Deak; Gedeon O.,9998,0,9999,1
1668181343456,COGS 210B,006,101425,Rossano; Federico,9999,0,9999,0
1668181343881,COGS 211B,A00,101427,Coulson; Seana M,9996,0,9999,3
1668181344307,COGS 220,A00,101428,Hollan; James D.,0,0,25,25
1668181344728,COGS 229,A00,101429,Dow; Steven P,18,0,25,7
1668181345162,COGS 230,A00,101430,Klemmer; Scott R,12,0,17,5
1668181345585,COGS 234,A00,101431,Xia; Haijun,3,0,25,22
1668181346014,COGS 260,A00,101432,Kiyonaga; Anastasia,20,0,25,5
1668181346014,COGS 260,B00,101433,Kirsh; David Joel,16,0,25,9
1668181346449,CSE 202,A00,102371,Impagliazzo; Russell,0,0,0,0
1668181346874,CSE 203B,A01,102373,Cheng; Chung Kuan,0,0,0,0
1668181347298,CSE 208,A00,102374,Micciancio; Daniele,0,0,0,0
1668181347724,CSE 209A,A00,112895,Impagliazzo; Russell,0,0,15,15
1668181348153,CSE 209B,A00,108005,Bellare; Mihir,0,0,0,0
1668181348597,CSE 210,A00,113163,Coblenz; Michael J,0,0,0,0
1668181349022,CSE 219,A00,106111,Dow; Steven P,0,0,20,20
1668181349448,CSE 221,A00,102376,Voelker; Geoffrey M.,0,0,0,0
1668181349872,CSE 224,A01,102378,Porter; George M,0,0,0,0
1668181350298,CSE 229A,A00,102379,Savage; Stefan,0,0,0,0
1668181350724,CSE 229C,A00,102380,Munyaka; Imani N. S.,0,0,0,0
1668181351158,CSE 232B,A00,102382,Deutsch; Alin Bernard,0,0,0,0
1668181351583,CSE 234,A01,112904,Kumar; Arun Kumar,0,0,0,0
1668181352008,CSE 237A,A00,102383,Rosing; Tajana Simunic,0,0,0,0
1668181352434,CSE 239A,A00,102384,Deutsch; Alin Bernard,0,0,0,0
1668181352857,CSE 239B,A00,102385,Polikarpova; Nadezhda,0,0,0,0
1668181353280,CSE 240A,A00,102386,Pannuto; Patrick William,0,0,0,0
1668181353704,CSE 240B,A00,102387,Zhao; Jishen,0,0,0,0
1668181354127,CSE 241A,A00,106406,Kang; Mingu,0,0,0,0
1668181354552,CSE 249B,A00,102388,Kahng; Andrew Byun,0,0,8,8
1668181354978,CSE 251B,A01,102392,Cottrell; Garrison W,0,0,0,0
1668181354978,CSE 251B,A02,102393,Cottrell; Garrison W,0,0,0,0
1668181355441,CSE 252B,A00,102394,Ochoa; Benjamin Lawrence,0,0,0,0
1668181355869,CSE 257,A01,102396,Gao; Sicun,0,0,0,0
1668181356307,CSE 272,A00,102397,Li; Tzumao,0,0,0,0
1668181356734,CSE 274,A00,111323,Chern; Albert Ren-Haur,0,0,0,0
1668181357166,CSE 282,A00,102398,Pevzner; Pavel Arkadjevich,0,0,0,0
1668181357590,CSE 284,A00,114175,Gymrek; Melissa Ann,0,0,0,0
1668181358021,CSE 290,A00,102399,Chandraker; Manmohan Krishna,0,0,0,0
1668181358021,CSE 290,B00,102400,Vaccaro; Kristen Marie,0,0,25,25
1668181358021,CSE 290,C00,102414,Pannuto; Patrick William,0,0,25,25
1668181358021,CSE 290,D00,102427,Pevzner; Pavel Arkadjevich,0,0,0,0
1668181358021,CSE 290,E00,102429,Zhao; Jishen,0,0,0,0
1668181358021,CSE 290,F00,102436,Tullsen; Dean Michael,0,0,0,0
1668181358021,CSE 290,G00,102440,Christensen; Henrik I,0,0,20,20
1668181358447,CSE 291,A00,102443,Su; Hao,0,0,0,0
1668181358447,CSE 291,B00,102448,Polikarpova; Nadezhda,0,0,0,0
1668181358447,CSE 291,C00,102453,Vaccaro; Kristen Marie,0,0,0,0
1668181358447,CSE 291,D00,111343,Savage; Stefan,0,0,0,0
1668181358447,CSE 291,E00,116474,Claffy; Kimberly Claire,0,0,0,0
1668181358447,CSE 291,F00,116479,Pasquale; Joseph,0,0,0,0
1668181358882,CSE 293,001,119111,Bafna; Vineet,9999,0,9999,0
1668181358882,CSE 293,002,119118,Bellare; Mihir,9999,0,9999,0
1668181358882,CSE 293,003,119122,Berg-Kirkpatrick; Taylor D,9999,0,9999,0
1668181358882,CSE 293,004,119135,Christensen; Henrik I,9999,0,9999,0
1668181358882,CSE 293,005,119142,Cottrell; Garrison W,9999,0,9999,0
1668181358882,CSE 293,006,119146,Deutsch; Alin Bernard,9999,0,9999,0
1668181358882,CSE 293,007,119159,Esmaeilzadeh; Hadi,9999,0,9999,0
1668181358882,CSE 293,008,119166,Freund; Yoav,9999,0,9999,0
1668181358882,CSE 293,009,119170,Griswold; William G.,9999,0,9999,0
1668181358882,CSE 293,010,119183,Gymrek; Melissa Ann,9999,0,9999,0
1668181358882,CSE 293,011,119190,Heninger; Nadia A,9999,0,9999,0
1668181358882,CSE 293,012,119230,Impagliazzo; Russell,9999,0,9999,0
1668181358882,CSE 293,013,119232,Jhala; Ranjit,9999,0,9999,0
1668181358882,CSE 293,014,119233,Kahng; Andrew Byun,9999,0,9999,0
1668181358882,CSE 293,015,119298,Kane; Daniel Mertz,9999,0,9999,0
1668181358882,CSE 293,016,119299,Kriegman; David J,9999,0,9999,0
1668181358882,CSE 293,017,119300,Kumar; Arun Kumar,9999,0,9999,0
1668181358882,CSE 293,018,119301,Lerner; Sorin,9999,0,9999,0
1668181358882,CSE 293,019,119302,Lovett; Shachar,9999,0,9999,0
1668181358882,CSE 293,020,119303,McAuley; Julian John,9999,0,9999,0
1668181358882,CSE 293,021,119304,Micciancio; Daniele,9999,0,9999,0
1668181358882,CSE 293,022,119367,Orailoglu; Alex,9999,0,9999,0
1668181358882,CSE 293,023,119382,Paturi; Ramamohan,9999,0,9999,0
1668181358882,CSE 293,024,119404,Polikarpova; Nadezhda,9999,0,9999,0
1668181358882,CSE 293,025,119406,Politz; Joseph Gibbs,9999,0,9999,0
1668181358882,CSE 293,026,119411,Porter; George M,9999,0,9999,0
1668181358882,CSE 293,027,119414,Porter; Leonard Emerson,9999,0,9999,0
1668181358882,CSE 293,028,119416,Ramamoorthi; Ravi,9999,0,9999,0
1668181358882,CSE 293,029,119417,Sahoo; Debashis,9999,0,9999,0
1668181358882,CSE 293,030,119420,Saul; Lawrence,9999,0,9999,0
1668181358882,CSE 293,031,119421,Savage; Stefan,9999,0,9999,0
1668181358882,CSE 293,032,119425,Schulze; Jurgen P.,9999,0,9999,0
1668181358882,CSE 293,033,119426,Snoeren; Alex C.,9999,0,9999,0
1668181358882,CSE 293,034,119428,Shang; Jingbo,9999,0,9999,0
1668181358882,CSE 293,035,119430,Stefan; Deian,9999,0,9999,0
1668181358882,CSE 293,036,119431,Su; Hao,9999,0,9999,0
1668181358882,CSE 293,037,119433,Swanson; Steven James,9999,0,9999,0
1668181358882,CSE 293,038,119435,Tullsen; Dean Michael,9999,0,9999,0
1668181358882,CSE 293,039,119483,Voelker; Geoffrey M.,9999,0,9999,0
1668181358882,CSE 293,040,119537,Zhao; Jishen,9999,0,9999,0
1668181358882,CSE 293,041,119538,Zhou; Yuan-Yuan,9999,0,9999,0
1668181358882,CSE 293,042,119539,Gao; Sicun,9999,0,9999,0
1668181358882,CSE 293,043,119540,Weibel; Nadir,9999,0,9999,0
1668181358882,CSE 293,044,119541,Gupta; Rajesh K.,9999,0,9999,0
1668181358882,CSE 293,045,126410,Vaccaro; Kristen Marie,9999,0,9999,0
1668181358882,CSE 293,046,126411,Klemke; Richard,9999,0,9999,0
1668181359308,CSE 294,A00,102459,Voelker; Geoffrey M.,0,0,0,0
1668181359308,CSE 294,B00,111322,Orailoglu; Alex,0,0,0,0
1668181359733,DSE 201,A00,096914,Deutsch; Alin Bernard,30,0,30,0
1668181360157,DSE 210,A00,096915,Dasgupta; Sanjoy,30,0,30,0
1668181360592,DSE 260A,A00,096916,Altintas De Callaf; Ilkay,30,0,30,0
1668181361024,ECE 200,001,103586,Antipa; Nicholas A,9999,0,9999,0
1668181361024,ECE 200,002,103587,Atanasov; Nikolay A.,9999,0,9999,0
1668181361024,ECE 200,003,103588,Bharadia; Dinesh,9999,0,9999,0
1668181361024,ECE 200,004,103589,Cheng; Chung Kuan,9999,0,9999,0
1668181361024,ECE 200,005,103590,Cosman; Pamela C.,9999,0,9999,0
1668181361024,ECE 200,006,103591,Dayeh; Shadi Ahmad,9999,0,9999,0
1668181361024,ECE 200,007,103592,Fainman; Yeshaiahu,9999,0,9999,0
1668181361024,ECE 200,008,103593,Ford; Joseph Earl,9999,0,9999,0
1668181361024,ECE 200,009,103594,Franceschetti; Massimo,9999,0,9999,0
1668181361024,ECE 200,010,103595,Fullerton; Eric E,9999,0,9999,0
1668181361024,ECE 200,011,103596,Galton; Ian A,9999,0,9999,0
1668181361024,ECE 200,012,103597,Gilja; Vikash,9999,0,9999,0
1668181361024,ECE 200,013,103598,Hall; Drew A.,9999,0,9999,0
1668181361024,ECE 200,014,103599,Hsueh; Tzu-Chien,9999,0,9999,0
1668181361024,ECE 200,015,103600,Javidi; Tara,9999,0,9999,0
1668181361024,ECE 200,016,103601,Kahng; Andrew Byun,9999,0,9999,0
1668181361024,ECE 200,017,103602,Kim; Young-Han,9999,0,9999,0
1668181361024,ECE 200,018,103603,Koushanfar; Farinaz,9999,0,9999,0
1668181361024,ECE 200,019,103604,Kuzum; Duygu,9999,0,9999,0
1668181361024,ECE 200,020,103605,Le; Hanh-Phuc,9999,0,9999,0
1668181361024,ECE 200,021,103606,Lin; Bill,9999,0,9999,0
1668181361024,ECE 200,022,103607,Liu; Zhaowei,9998,0,9999,1
1668181361024,ECE 200,023,103608,Lo; Yu-Hwa,9999,0,9999,0
1668181361024,ECE 200,024,103609,Lomakin; Vitaliy,9999,0,9999,0
1668181361024,ECE 200,025,103610,Mercier; Patrick Philip,9999,0,9999,0
1668181361024,ECE 200,026,103611,Meyer; Florian,9999,0,9999,0
1668181361024,ECE 200,027,103612,Milstein; Laurence B.,9999,0,9999,0
1668181361024,ECE 200,028,103613,Mir Arabbaygi; Siavash,9999,0,9999,0
1668181361024,ECE 200,029,103614,Mookherjea; Shayan,9999,0,9999,0
1668181361024,ECE 200,030,103615,Morris; Karcher William,9999,0,9999,0
1668181361024,ECE 200,031,103616,Ng; Tse Nga,9999,0,9999,0
1668181361024,ECE 200,032,103617,Nguyen; Truong Quang,9999,0,9999,0
1668181361024,ECE 200,033,103618,Nomura; Kenji,9999,0,9999,0
1668181361024,ECE 200,034,103619,Orlitsky; Alon,9999,0,9999,0
1668181361024,ECE 200,035,103620,Pal; Piya,9999,0,9999,0
1668181361024,ECE 200,036,103621,Papen; George C.,9999,0,9999,0
1668181361024,ECE 200,037,103622,Radic; Stojan,9999,0,9999,0
1668181361024,ECE 200,038,103623,Rao; Bhaskar D.,9999,0,9999,0
1668181361024,ECE 200,039,103624,Rao; Ramesh R,9999,0,9999,0
1668181361024,ECE 200,040,103625,Rebeiz; Gabriel,9999,0,9999,0
1668181361024,ECE 200,041,103626,Sanford; John R,9999,0,9999,0
1668181361024,ECE 200,042,103627,Siegel; Paul H.,9999,0,9999,0
1668181361024,ECE 200,043,103628,Sievenpiper; Daniel F.,9999,0,9999,0
1668181361024,ECE 200,044,103629,Sworder; David D.,9999,0,9999,0
1668181361024,ECE 200,045,103630,Taur; Yuan,9999,0,9999,0
1668181361024,ECE 200,046,103631,Touri; Behrouz,9999,0,9999,0
1668181361024,ECE 200,047,103632,Trivedi; Mohan M.,9999,0,9999,0
1668181361024,ECE 200,048,103633,Vasconcelos; Nuno,9999,0,9999,0
1668181361024,ECE 200,049,103634,Wang; Xiaolong,9999,0,9999,0
1668181361024,ECE 200,050,103635,Xie; Pengtao,9999,0,9999,0
1668181361024,ECE 200,051,103636,Yip; Michael,9999,0,9999,0
1668181361024,ECE 200,052,103637,Zeger; Kenneth A.,999,0,999,0
1668181361024,ECE 200,053,103638,Zhang; Xinyu,9999,0,9999,0
1668181361024,ECE 200,054,103639,Turakhia; Yatish Girish,9999,0,9999,0
1668181361024,ECE 200,055,103640,Kang; Mingu,9999,0,9999,0
1668181361024,ECE 200,056,103641,Shi; Yuanyuan,9999,0,9999,0
1668181361024,ECE 200,057,103642,Wang; Edward Jay,9999,0,9999,0
1668181361024,ECE 200,058,103643,Zheng; Yang,9999,0,9999,0
1668181361450,ECE 202,A00,103644,Kuzum; Duygu,0,0,0,0
1668181361877,ECE 212BN,A00,103646,Ng; Tse Nga,0,0,0,0
1668181362302,ECE 221,A00,111493,Staff,0,0,0,0
1668181362735,ECE 222B,A00,103647,Lomakin; Vitaliy,0,0,0,0
1668181363160,ECE 230B,A00,103648,Taur; Yuan,0,0,0,0
1668181363588,ECE 238B,A00,103649,Garay; Javier,0,0,0,0
1668181364011,ECE 240B,A00,112900,Fainman; Yeshaiahu,0,0,0,0
1668181364438,ECE 247A,A00,103650,Jokerst; Jesse Vincent,0,0,0,0
1668181364863,ECE 247B,A00,103651,Wang; Joseph,0,0,0,0
1668181365288,ECE 250,A00,103652,Siegel; Paul H.,0,0,0,0
1668181365715,ECE 251A,A00,103654,Rao; Bhaskar D.,0,0,0,0
1668181366139,ECE 257B,A00,103655,Bharadia; Dinesh,0,0,0,0
1668181366566,ECE 258A,A00,103656,Milstein; Laurence B.,0,0,0,0
1668181367073,ECE 260B,A00,103658,Kang; Mingu,0,0,0,0
1668181367500,ECE 264A,A00,103659,Galton; Ian A,0,0,0,0
1668181367931,ECE 265A,A00,103661,Gudem; Prasad S.S.,0,0,0,0
1668181368356,ECE 265D,A00,103662,Gudem; Prasad S.S.,0,0,0,0
1668181368783,ECE 268,A00,103663,Koushanfar; Farinaz,0,0,0,0
1668181369214,ECE 269,A01,103665,Pal; Piya,0,0,0,0
1668181369640,ECE 271B,A00,103666,Vasconcelos; Manuela,0,0,0,0
1668181370069,ECE 276A,A00,103667,Atanasov; Nikolay A.,0,0,0,0
1668181370491,ECE 277,A00,103668,An; Cheolhong,0,0,0,0
1668181370929,ECE 279,A00,117947,Hall; Drew A.,0,0,0,0
1668181371779,ECE 283,A00,103670,Hsueh; Tzu-Chien,0,0,0,0
1668181372215,ECE 284,A00,103671,Turakhia; Yatish Girish,0,0,0,0
1668181372641,ECE 285,A00,103672,Zheng; Yang,0,0,0,0
1668181372641,ECE 285,B00,103673,Sworder; David D.,0,0,0,0
1668181373066,ECE 287,A00,103676,Javidi; Tara,0,0,0,0
1668181373493,MATH 200B,A00,098023,Salehi Golsefidy; Alireza,12,0,15,3
1668181373925,MATH 202B,A00,098024,Rhoades; Brendon Patrick,9,0,15,6
1668181374354,MATH 203B,A00,098025,Oprea; Dragos N.,10,0,15,5
1668181374775,MATH 204B,A00,098026,Sorensen; Claus M,13,0,15,2
1668181375216,MATH 208,A00,098027,Izadi; Elham,7,0,10,3
1668181375640,MATH 209,A00,098028,Pollack; Aaron,10,0,10,0
1668181376067,MATH 211A,A00,112919,Rogalski; Daniel,9,0,10,1
1668181376492,MATH 211B,A00,112920,Seward; Brandon M.,9,0,10,1
1668181376926,MATH 218,A00,098029,Li; Bo,10,0,10,0
1668181377355,MATH 220B,A00,098030,Novak; Jonathan I,11,0,15,4
1668181377780,MATH 221A,A00,098031,Ebenfelt; Peter F,13,0,15,2
1668181378210,MATH 231B,A00,098032,Zlatos; Andrej,12,0,15,3
1668181378637,MATH 240B,A00,098033,Ni; Lei,9,0,15,6
1668181379065,MATH 243,A00,098034,Jekel; David Andrew,10,0,10,0
1668181379490,MATH 245A,A00,098035,Nie; Jiawang,0,0,15,16
1668181379922,MATH 248,A00,098036,Bejenaru; Ioan,10,0,10,0
1668181380348,MATH 250B,A00,098037,Spolaor; Luca,14,0,15,1
1668181380777,MATH 258,A00,098038,Ni; Lei,10,0,10,0
1668181381201,MATH 264B,A00,098041,Rhoades; Brendon Patrick,9,0,15,6
1668181381625,MATH 268,A00,098042,Buss; Samuel R,10,0,10,0
1668181382052,MATH 269,A00,098043,Rhoades; Brendon Patrick,10,0,10,0
1668181382483,MATH 270B,A00,098044,Li; Bo,10,0,15,5
1668181382909,MATH 272B,A00,098045,Holst; Michael J,13,0,15,2
1668181383333,MATH 273A,A00,098046,Tian; Xiaochuan,10,0,15,5
1668181383767,MATH 275,A01,098048,Tian; Xiaochuan,6,0,10,4
1668181384193,MATH 278A,A00,098049,Holst; Michael J,8,0,10,2
1668181384626,MATH 278B,A00,098050,Cloninger; Alexander,10,0,10,0
1668181385055,MATH 278C,A00,098051,Nie; Jiawang,7,0,10,3
1668181385478,MATH 280B,A00,098052,Zheng; Tianyi,10,0,15,5
1668181385904,MATH 281B,A00,098053,Bradic; Jelena,2,0,15,13
1668181386338,MATH 282B,A00,098054,Arias-Castro; Ery,0,0,15,15
1668181386764,MATH 285,A00,098055,Fitzsimmons; Patrick J,0,0,15,17
1668181387194,MATH 287B,A00,098056,Arias-Castro; Ery,2,0,15,13
1668181387618,MATH 288,A00,098057,Agarwal; Pooja,9,0,10,1
1668181387618,MATH 288,B00,098058,Zhang; Danna,8,0,10,2
1668181387618,MATH 288,C00,098059,Williams; Ruth J,10,0,10,0
1668181388044,MATH 290B,A00,098060,Roberts; Justin Deritter,13,0,15,2
1668181388478,MATH 292,A00,098061,Belmont; Eva Kinoshita,10,0,10,0
1668181388916,MATH 295,A00,098062,Suk; Andrew Hoon,48,0,50,2
1668181389340,MATH 296,A00,098063,Novak; Jonathan I,20,0,20,0
1668181389766,MATH 297,001,098064,Gamst; Anthony Collins,9997,0,9999,2
1668181895310,COGS 205,A00,101395,Chiba; Andrea,19,0,20,1
1668181895740,COGS 210B,001,101404,Greene; Deanna Jacquelyn,9998,0,9999,1
1668181895740,COGS 210B,002,101417,Xia; Haijun,9999,0,9999,0
1668181895740,COGS 210B,003,101422,Nitz; Douglas A.,9999,0,9999,0
1668181895740,COGS 210B,004,101423,Hollan; James D.,9998,0,9999,1
1668181895740,COGS 210B,005,101424,Deak; Gedeon O.,9998,0,9999,1
1668181895740,COGS 210B,006,101425,Rossano; Federico,9999,0,9999,0
1668181896167,COGS 211B,A00,101427,Coulson; Seana M,9996,0,9999,3
1668181896594,COGS 220,A00,101428,Hollan; James D.,0,0,25,25
1668181897018,COGS 229,A00,101429,Dow; Steven P,18,0,25,7
1668181897442,COGS 230,A00,101430,Klemmer; Scott R,12,0,17,5
1668181897871,COGS 234,A00,101431,Xia; Haijun,3,0,25,22
1668181898308,COGS 260,A00,101432,Kiyonaga; Anastasia,20,0,25,5
1668181898308,COGS 260,B00,101433,Kirsh; David Joel,16,0,25,9
1668181898730,CSE 202,A00,102371,Impagliazzo; Russell,0,0,0,0
1668181899153,CSE 203B,A01,102373,Cheng; Chung Kuan,0,0,0,0
1668181899584,CSE 208,A00,102374,Micciancio; Daniele,0,0,0,0
1668181900012,CSE 209A,A00,112895,Impagliazzo; Russell,0,0,15,15
1668181900454,CSE 209B,A00,108005,Bellare; Mihir,0,0,0,0
1668181900876,CSE 210,A00,113163,Coblenz; Michael J,0,0,0,0
1668181901300,CSE 219,A00,106111,Dow; Steven P,0,0,20,20
1668181901726,CSE 221,A00,102376,Voelker; Geoffrey M.,0,0,0,0
1668181902154,CSE 224,A01,102378,Porter; George M,0,0,0,0
1668181902581,CSE 229A,A00,102379,Savage; Stefan,0,0,0,0
1668181903015,CSE 229C,A00,102380,Munyaka; Imani N. S.,0,0,0,0
1668181903451,CSE 232B,A00,102382,Deutsch; Alin Bernard,0,0,0,0
1668181903874,CSE 234,A01,112904,Kumar; Arun Kumar,0,0,0,0
1668181904299,CSE 237A,A00,102383,Rosing; Tajana Simunic,0,0,0,0
1668181904736,CSE 239A,A00,102384,Deutsch; Alin Bernard,0,0,0,0
1668181905162,CSE 239B,A00,102385,Polikarpova; Nadezhda,0,0,0,0
1668181905584,CSE 240A,A00,102386,Pannuto; Patrick William,0,0,0,0
1668181906010,CSE 240B,A00,102387,Zhao; Jishen,0,0,0,0
1668181906436,CSE 241A,A00,106406,Kang; Mingu,0,0,0,0
1668181906861,CSE 249B,A00,102388,Kahng; Andrew Byun,0,0,8,8
1668181907285,CSE 251B,A01,102392,Cottrell; Garrison W,0,0,0,0
1668181907285,CSE 251B,A02,102393,Cottrell; Garrison W,0,0,0,0
1668181907718,CSE 252B,A00,102394,Ochoa; Benjamin Lawrence,0,0,0,0
1668181908143,CSE 257,A01,102396,Gao; Sicun,0,0,0,0
1668181908569,CSE 272,A00,102397,Li; Tzumao,0,0,0,0
1668181909003,CSE 274,A00,111323,Chern; Albert Ren-Haur,0,0,0,0
1668181909426,CSE 282,A00,102398,Pevzner; Pavel Arkadjevich,0,0,0,0
1668181909853,CSE 284,A00,114175,Gymrek; Melissa Ann,0,0,0,0
1668181910275,CSE 290,A00,102399,Chandraker; Manmohan Krishna,0,0,0,0
1668181910275,CSE 290,B00,102400,Vaccaro; Kristen Marie,0,0,25,25
1668181910275,CSE 290,C00,102414,Pannuto; Patrick William,0,0,25,25
1668181910275,CSE 290,D00,102427,Pevzner; Pavel Arkadjevich,0,0,0,0
1668181910275,CSE 290,E00,102429,Zhao; Jishen,0,0,0,0
1668181910275,CSE 290,F00,102436,Tullsen; Dean Michael,0,0,0,0
1668181910275,CSE 290,G00,102440,Christensen; Henrik I,0,0,20,20
1668181910718,CSE 291,A00,102443,Su; Hao,0,0,0,0
1668181910718,CSE 291,B00,102448,Polikarpova; Nadezhda,0,0,0,0
1668181910718,CSE 291,C00,102453,Vaccaro; Kristen Marie,0,0,0,0
1668181910718,CSE 291,D00,111343,Savage; Stefan,0,0,0,0
1668181910718,CSE 291,E00,116474,Claffy; Kimberly Claire,0,0,0,0
1668181910718,CSE 291,F00,116479,Pasquale; Joseph,0,0,0,0
1668181911144,CSE 293,001,119111,Bafna; Vineet,9999,0,9999,0
1668181911144,CSE 293,002,119118,Bellare; Mihir,9999,0,9999,0
1668181911144,CSE 293,003,119122,Berg-Kirkpatrick; Taylor D,9999,0,9999,0
1668181911144,CSE 293,004,119135,Christensen; Henrik I,9999,0,9999,0
1668181911144,CSE 293,005,119142,Cottrell; Garrison W,9999,0,9999,0
1668181911144,CSE 293,006,119146,Deutsch; Alin Bernard,9999,0,9999,0
1668181911144,CSE 293,007,119159,Esmaeilzadeh; Hadi,9999,0,9999,0
1668181911144,CSE 293,008,119166,Freund; Yoav,9999,0,9999,0
1668181911144,CSE 293,009,119170,Griswold; William G.,9999,0,9999,0
1668181911144,CSE 293,010,119183,Gymrek; Melissa Ann,9999,0,9999,0
1668181911144,CSE 293,011,119190,Heninger; Nadia A,9999,0,9999,0
1668181911144,CSE 293,012,119230,Impagliazzo; Russell,9999,0,9999,0
1668181911144,CSE 293,013,119232,Jhala; Ranjit,9999,0,9999,0
1668181911144,CSE 293,014,119233,Kahng; Andrew Byun,9999,0,9999,0
1668181911144,CSE 293,015,119298,Kane; Daniel Mertz,9999,0,9999,0
1668181911144,CSE 293,016,119299,Kriegman; David J,9999,0,9999,0
1668181911144,CSE 293,017,119300,Kumar; Arun Kumar,9999,0,9999,0
1668181911144,CSE 293,018,119301,Lerner; Sorin,9999,0,9999,0
1668181911144,CSE 293,019,119302,Lovett; Shachar,9999,0,9999,0
1668181911144,CSE 293,020,119303,McAuley; Julian John,9999,0,9999,0
1668181911144,CSE 293,021,119304,Micciancio; Daniele,9999,0,9999,0
1668181911144,CSE 293,022,119367,Orailoglu; Alex,9999,0,9999,0
1668181911144,CSE 293,023,119382,Paturi; Ramamohan,9999,0,9999,0
1668181911144,CSE 293,024,119404,Polikarpova; Nadezhda,9999,0,9999,0
1668181911144,CSE 293,025,119406,Politz; Joseph Gibbs,9999,0,9999,0
1668181911144,CSE 293,026,119411,Porter; George M,9999,0,9999,0
1668181911144,CSE 293,027,119414,Porter; Leonard Emerson,9999,0,9999,0
1668181911144,CSE 293,028,119416,Ramamoorthi; Ravi,9999,0,9999,0
1668181911144,CSE 293,029,119417,Sahoo; Debashis,9999,0,9999,0
1668181911144,CSE 293,030,119420,Saul; Lawrence,9999,0,9999,0
1668181911144,CSE 293,031,119421,Savage; Stefan,9999,0,9999,0
1668181911144,CSE 293,032,119425,Schulze; Jurgen P.,9999,0,9999,0
1668181911144,CSE 293,033,119426,Snoeren; Alex C.,9999,0,9999,0
1668181911144,CSE 293,034,119428,Shang; Jingbo,9999,0,9999,0
1668181911144,CSE 293,035,119430,Stefan; Deian,9999,0,9999,0
1668181911144,CSE 293,036,119431,Su; Hao,9999,0,9999,0
1668181911144,CSE 293,037,119433,Swanson; Steven James,9999,0,9999,0
1668181911144,CSE 293,038,119435,Tullsen; Dean Michael,9999,0,9999,0
1668181911144,CSE 293,039,119483,Voelker; Geoffrey M.,9999,0,9999,0
1668181911144,CSE 293,040,119537,Zhao; Jishen,9999,0,9999,0
1668181911144,CSE 293,041,119538,Zhou; Yuan-Yuan,9999,0,9999,0
1668181911144,CSE 293,042,119539,Gao; Sicun,9999,0,9999,0
1668181911144,CSE 293,043,119540,Weibel; Nadir,9999,0,9999,0
1668181911144,CSE 293,044,119541,Gupta; Rajesh K.,9999,0,9999,0
1668181911144,CSE 293,045,126410,Vaccaro; Kristen Marie,9999,0,9999,0
1668181911144,CSE 293,046,126411,Klemke; Richard,9999,0,9999,0
1668181911578,CSE 294,A00,102459,Voelker; Geoffrey M.,0,0,0,0
1668181911578,CSE 294,B00,111322,Orailoglu; Alex,0,0,0,0
1668181912003,DSE 201,A00,096914,Deutsch; Alin Bernard,30,0,30,0
1668181912438,DSE 210,A00,096915,Dasgupta; Sanjoy,30,0,30,0
1668181912861,DSE 260A,A00,096916,Altintas De Callaf; Ilkay,30,0,30,0
1668181913293,ECE 200,001,103586,Antipa; Nicholas A,9999,0,9999,0
1668181913293,ECE 200,002,103587,Atanasov; Nikolay A.,9999,0,9999,0
1668181913293,ECE 200,003,103588,Bharadia; Dinesh,9999,0,9999,0
1668181913293,ECE 200,004,103589,Cheng; Chung Kuan,9999,0,9999,0
1668181913293,ECE 200,005,103590,Cosman; Pamela C.,9999,0,9999,0
1668181913293,ECE 200,006,103591,Dayeh; Shadi Ahmad,9999,0,9999,0
1668181913293,ECE 200,007,103592,Fainman; Yeshaiahu,9999,0,9999,0
1668181913293,ECE 200,008,103593,Ford; Joseph Earl,9999,0,9999,0
1668181913293,ECE 200,009,103594,Franceschetti; Massimo,9999,0,9999,0
1668181913293,ECE 200,010,103595,Fullerton; Eric E,9999,0,9999,0
1668181913293,ECE 200,011,103596,Galton; Ian A,9999,0,9999,0
1668181913293,ECE 200,012,103597,Gilja; Vikash,9999,0,9999,0
1668181913293,ECE 200,013,103598,Hall; Drew A.,9999,0,9999,0
1668181913293,ECE 200,014,103599,Hsueh; Tzu-Chien,9999,0,9999,0
1668181913293,ECE 200,015,103600,Javidi; Tara,9999,0,9999,0
1668181913293,ECE 200,016,103601,Kahng; Andrew Byun,9999,0,9999,0
1668181913293,ECE 200,017,103602,Kim; Young-Han,9999,0,9999,0
1668181913293,ECE 200,018,103603,Koushanfar; Farinaz,9999,0,9999,0
1668181913293,ECE 200,019,103604,Kuzum; Duygu,9999,0,9999,0
1668181913293,ECE 200,020,103605,Le; Hanh-Phuc,9999,0,9999,0
1668181913293,ECE 200,021,103606,Lin; Bill,9999,0,9999,0
1668181913293,ECE 200,022,103607,Liu; Zhaowei,9998,0,9999,1
1668181913293,ECE 200,023,103608,Lo; Yu-Hwa,9999,0,9999,0
1668181913293,ECE 200,024,103609,Lomakin; Vitaliy,9999,0,9999,0
1668181913293,ECE 200,025,103610,Mercier; Patrick Philip,9999,0,9999,0
1668181913293,ECE 200,026,103611,Meyer; Florian,9999,0,9999,0
1668181913293,ECE 200,027,103612,Milstein; Laurence B.,9999,0,9999,0
1668181913293,ECE 200,028,103613,Mir Arabbaygi; Siavash,9999,0,9999,0
1668181913293,ECE 200,029,103614,Mookherjea; Shayan,9999,0,9999,0
1668181913293,ECE 200,030,103615,Morris; Karcher William,9999,0,9999,0
1668181913293,ECE 200,031,103616,Ng; Tse Nga,9999,0,9999,0
1668181913293,ECE 200,032,103617,Nguyen; Truong Quang,9999,0,9999,0
1668181913293,ECE 200,033,103618,Nomura; Kenji,9999,0,9999,0
1668181913293,ECE 200,034,103619,Orlitsky; Alon,9999,0,9999,0
1668181913293,ECE 200,035,103620,Pal; Piya,9999,0,9999,0
1668181913293,ECE 200,036,103621,Papen; George C.,9999,0,9999,0
1668181913293,ECE 200,037,103622,Radic; Stojan,9999,0,9999,0
1668181913293,ECE 200,038,103623,Rao; Bhaskar D.,9999,0,9999,0
1668181913293,ECE 200,039,103624,Rao; Ramesh R,9999,0,9999,0
1668181913293,ECE 200,040,103625,Rebeiz; Gabriel,9999,0,9999,0
1668181913293,ECE 200,041,103626,Sanford; John R,9999,0,9999,0
1668181913293,ECE 200,042,103627,Siegel; Paul H.,9999,0,9999,0
1668181913293,ECE 200,043,103628,Sievenpiper; Daniel F.,9999,0,9999,0
1668181913293,ECE 200,044,103629,Sworder; David D.,9999,0,9999,0
1668181913293,ECE 200,045,103630,Taur; Yuan,9999,0,9999,0
1668181913293,ECE 200,046,103631,Touri; Behrouz,9999,0,9999,0
1668181913293,ECE 200,047,103632,Trivedi; Mohan M.,9999,0,9999,0
1668181913293,ECE 200,048,103633,Vasconcelos; Nuno,9999,0,9999,0
1668181913293,ECE 200,049,103634,Wang; Xiaolong,9999,0,9999,0
1668181913293,ECE 200,050,103635,Xie; Pengtao,9999,0,9999,0
1668181913293,ECE 200,051,103636,Yip; Michael,9999,0,9999,0
1668181913293,ECE 200,052,103637,Zeger; Kenneth A.,999,0,999,0
1668181913293,ECE 200,053,103638,Zhang; Xinyu,9999,0,9999,0
1668181913293,ECE 200,054,103639,Turakhia; Yatish Girish,9999,0,9999,0
1668181913293,ECE 200,055,103640,Kang; Mingu,9999,0,9999,0
1668181913293,ECE 200,056,103641,Shi; Yuanyuan,9999,0,9999,0
1668181913293,ECE 200,057,103642,Wang; Edward Jay,9999,0,9999,0
1668181913293,ECE 200,058,103643,Zheng; Yang,9999,0,9999,0
1668181913719,ECE 202,A00,103644,Kuzum; Duygu,0,0,0,0
1668181914144,ECE 212BN,A00,103646,Ng; Tse Nga,0,0,0,0
1668181914571,ECE 221,A00,111493,Staff,0,0,0,0
1668181914996,ECE 222B,A00,103647,Lomakin; Vitaliy,0,0,0,0
1668181915419,ECE 230B,A00,103648,Taur; Yuan,0,0,0,0
1668181915844,ECE 238B,A00,103649,Garay; Javier,0,0,0,0
1668181916267,ECE 240B,A00,112900,Fainman; Yeshaiahu,0,0,0,0
1668181916691,ECE 247A,A00,103650,Jokerst; Jesse Vincent,0,0,0,0
1668181917118,ECE 247B,A00,103651,Wang; Joseph,0,0,0,0
1668181917539,ECE 250,A00,103652,Siegel; Paul H.,0,0,0,0
1668181917974,ECE 251A,A00,103654,Rao; Bhaskar D.,0,0,0,0
1668181918399,ECE 257B,A00,103655,Bharadia; Dinesh,0,0,0,0
1668181918828,ECE 258A,A00,103656,Milstein; Laurence B.,0,0,0,0
1668181919255,ECE 260B,A00,103658,Kang; Mingu,0,0,0,0
1668181919679,ECE 264A,A00,103659,Galton; Ian A,0,0,0,0
1668181920107,ECE 265A,A00,103661,Gudem; Prasad S.S.,0,0,0,0
1668181920530,ECE 265D,A00,103662,Gudem; Prasad S.S.,0,0,0,0
1668181920963,ECE 268,A00,103663,Koushanfar; Farinaz,0,0,0,0
1668181921389,ECE 269,A01,103665,Pal; Piya,0,0,0,0
1668181921815,ECE 271B,A00,103666,Vasconcelos; Manuela,0,0,0,0
1668181922254,ECE 276A,A00,103667,Atanasov; Nikolay A.,0,0,0,0
1668181922679,ECE 277,A00,103668,An; Cheolhong,0,0,0,0
1668181923102,ECE 279,A00,117947,Hall; Drew A.,0,0,0,0
1668181923973,ECE 283,A00,103670,Hsueh; Tzu-Chien,0,0,0,0
1668181924399,ECE 284,A00,103671,Turakhia; Yatish Girish,0,0,0,0
1668181924826,ECE 285,A00,103672,Zheng; Yang,0,0,0,0
1668181924826,ECE 285,B00,103673,Sworder; David D.,0,0,0,0
1668181925250,ECE 287,A00,103676,Javidi; Tara,0,0,0,0
1668181925683,MATH 200B,A00,098023,Salehi Golsefidy; Alireza,12,0,15,3
1668181926106,MATH 202B,A00,098024,Rhoades; Brendon Patrick,9,0,15,6
1668181926529,MATH 203B,A00,098025,Oprea; Dragos N.,10,0,15,5
1668181926951,MATH 204B,A00,098026,Sorensen; Claus M,13,0,15,2
1668181927378,MATH 208,A00,098027,Izadi; Elham,7,0,10,3
1668181927802,MATH 209,A00,098028,Pollack; Aaron,10,0,10,0
1668181928236,MATH 211A,A00,112919,Rogalski; Daniel,9,0,10,1
1668181928670,MATH 211B,A00,112920,Seward; Brandon M.,9,0,10,1
1668181929095,MATH 218,A00,098029,Li; Bo,10,0,10,0
1668181929518,MATH 220B,A00,098030,Novak; Jonathan I,11,0,15,4
1668181929942,MATH 221A,A00,098031,Ebenfelt; Peter F,13,0,15,2
1668181930367,MATH 231B,A00,098032,Zlatos; Andrej,12,0,15,3
1668181930790,MATH 240B,A00,098033,Ni; Lei,9,0,15,6
1668181931226,MATH 243,A00,098034,Jekel; David Andrew,10,0,10,0
1668181931662,MATH 245A,A00,098035,Nie; Jiawang,0,0,15,16
1668181932088,MATH 248,A00,098036,Bejenaru; Ioan,10,0,10,0
1668181932519,MATH 250B,A00,098037,Spolaor; Luca,14,0,15,1
1668181932956,MATH 258,A00,098038,Ni; Lei,10,0,10,0
1668181933381,MATH 264B,A00,098041,Rhoades; Brendon Patrick,9,0,15,6
1668181933812,MATH 268,A00,098042,Buss; Samuel R,10,0,10,0
1668181934238,MATH 269,A00,098043,Rhoades; Brendon Patrick,10,0,10,0
1668181934665,MATH 270B,A00,098044,Li; Bo,10,0,15,5
1668181935088,MATH 272B,A00,098045,Holst; Michael J,13,0,15,2
1668181935523,MATH 273A,A00,098046,Tian; Xiaochuan,10,0,15,5
1668181936049,MATH 275,A01,098048,Tian; Xiaochuan,6,0,10,4
1668181936470,MATH 278A,A00,098049,Holst; Michael J,8,0,10,2
1668181936899,MATH 278B,A00,098050,Cloninger; Alexander,10,0,10,0
1668181937329,MATH 278C,A00,098051,Nie; Jiawang,7,0,10,3
1668181937758,MATH 280B,A00,098052,Zheng; Tianyi,10,0,15,5
1668181938186,MATH 281B,A00,098053,Bradic; Jelena,2,0,15,13
1668181938611,MATH 282B,A00,098054,Arias-Castro; Ery,0,0,15,15
1668181939035,MATH 285,A00,098055,Fitzsimmons; Patrick J,0,0,15,17
1668181939467,MATH 287B,A00,098056,Arias-Castro; Ery,2,0,15,13
1668181939894,MATH 288,A00,098057,Agarwal; Pooja,9,0,10,1
1668181939894,MATH 288,B00,098058,Zhang; Danna,8,0,10,2
1668181939894,MATH 288,C00,098059,Williams; Ruth J,10,0,10,0
1668181940322,MATH 290B,A00,098060,Roberts; Justin Deritter,13,0,15,2
1668181940745,MATH 292,A00,098061,Belmont; Eva Kinoshita,10,0,10,0
1668181941171,MATH 295,A00,098062,Suk; Andrew Hoon,48,0,50,2
1668181941606,MATH 296,A00,098063,Novak; Jonathan I,20,0,20,0
1668181942028,MATH 297,001,098064,Gamst; Anthony Collins,9997,0,9999,2
1668182444409,COGS 205,A00,101395,Chiba; Andrea,19,0,20,1
1668182444833,COGS 210B,001,101404,Greene; Deanna Jacquelyn,9998,0,9999,1
1668182444833,COGS 210B,002,101417,Xia; Haijun,9999,0,9999,0
1668182444833,COGS 210B,003,101422,Nitz; Douglas A.,9999,0,9999,0
1668182444833,COGS 210B,004,101423,Hollan; James D.,9998,0,9999,1
1668182444833,COGS 210B,005,101424,Deak; Gedeon O.,9998,0,9999,1
1668182444833,COGS 210B,006,101425,Rossano; Federico,9999,0,9999,0
1668182445258,COGS 211B,A00,101427,Coulson; Seana M,9996,0,9999,3
1668182445680,COGS 220,A00,101428,Hollan; James D.,0,0,25,25
1668182446104,COGS 229,A00,101429,Dow; Steven P,18,0,25,7
1668182446529,COGS 230,A00,101430,Klemmer; Scott R,12,0,17,5
1668182446954,COGS 234,A00,101431,Xia; Haijun,3,0,25,22
1668182447378,COGS 260,A00,101432,Kiyonaga; Anastasia,20,0,25,5
1668182447378,COGS 260,B00,101433,Kirsh; David Joel,16,0,25,9
1668182447805,CSE 202,A00,102371,Impagliazzo; Russell,0,0,0,0
1668182448231,CSE 203B,A01,102373,Cheng; Chung Kuan,0,0,0,0
1668182448663,CSE 208,A00,102374,Micciancio; Daniele,0,0,0,0
1668182449086,CSE 209A,A00,112895,Impagliazzo; Russell,0,0,15,15
1668182449512,CSE 209B,A00,108005,Bellare; Mihir,0,0,0,0
1668182449937,CSE 210,A00,113163,Coblenz; Michael J,0,0,0,0
1668182450365,CSE 219,A00,106111,Dow; Steven P,0,0,20,20
1668182450793,CSE 221,A00,102376,Voelker; Geoffrey M.,0,0,0,0
1668182451219,CSE 224,A01,102378,Porter; George M,0,0,0,0
1668182451663,CSE 229A,A00,102379,Savage; Stefan,0,0,0,0
1668182452097,CSE 229C,A00,102380,Munyaka; Imani N. S.,0,0,0,0
1668182452522,CSE 232B,A00,102382,Deutsch; Alin Bernard,0,0,0,0
1668182452945,CSE 234,A01,112904,Kumar; Arun Kumar,0,0,0,0
1668182453366,CSE 237A,A00,102383,Rosing; Tajana Simunic,0,0,0,0
1668182453802,CSE 239A,A00,102384,Deutsch; Alin Bernard,0,0,0,0
1668182454229,CSE 239B,A00,102385,Polikarpova; Nadezhda,0,0,0,0
1668182454655,CSE 240A,A00,102386,Pannuto; Patrick William,0,0,0,0
1668182455082,CSE 240B,A00,102387,Zhao; Jishen,0,0,0,0
1668182455506,CSE 241A,A00,106406,Kang; Mingu,0,0,0,0
1668182455933,CSE 249B,A00,102388,Kahng; Andrew Byun,0,0,8,8
1668182456365,CSE 251B,A01,102392,Cottrell; Garrison W,0,0,0,0
1668182456365,CSE 251B,A02,102393,Cottrell; Garrison W,0,0,0,0
1668182456801,CSE 252B,A00,102394,Ochoa; Benjamin Lawrence,0,0,0,0
1668182457226,CSE 257,A01,102396,Gao; Sicun,0,0,0,0
1668182457650,CSE 272,A00,102397,Li; Tzumao,0,0,0,0
1668182458082,CSE 274,A00,111323,Chern; Albert Ren-Haur,0,0,0,0
1668182458614,CSE 282,A00,102398,Pevzner; Pavel Arkadjevich,0,0,0,0
1668182459039,CSE 284,A00,114175,Gymrek; Melissa Ann,0,0,0,0
1668182459476,CSE 290,A00,102399,Chandraker; Manmohan Krishna,0,0,0,0
1668182459476,CSE 290,B00,102400,Vaccaro; Kristen Marie,0,0,25,25
1668182459476,CSE 290,C00,102414,Pannuto; Patrick William,0,0,25,25
1668182459476,CSE 290,D00,102427,Pevzner; Pavel Arkadjevich,0,0,0,0
1668182459476,CSE 290,E00,102429,Zhao; Jishen,0,0,0,0
1668182459476,CSE 290,F00,102436,Tullsen; Dean Michael,0,0,0,0
1668182459476,CSE 290,G00,102440,Christensen; Henrik I,0,0,20,20
1668182459922,CSE 291,A00,102443,Su; Hao,0,0,0,0
1668182459922,CSE 291,B00,102448,Polikarpova; Nadezhda,0,0,0,0
1668182459922,CSE 291,C00,102453,Vaccaro; Kristen Marie,0,0,0,0
1668182459922,CSE 291,D00,111343,Savage; Stefan,0,0,0,0
1668182459922,CSE 291,E00,116474,Claffy; Kimberly Claire,0,0,0,0
1668182459922,CSE 291,F00,116479,Pasquale; Joseph,0,0,0,0
1668182460347,CSE 293,001,119111,Bafna; Vineet,9999,0,9999,0
1668182460347,CSE 293,002,119118,Bellare; Mihir,9999,0,9999,0
1668182460347,CSE 293,003,119122,Berg-Kirkpatrick; Taylor D,9999,0,9999,0
1668182460347,CSE 293,004,119135,Christensen; Henrik I,9999,0,9999,0
1668182460347,CSE 293,005,119142,Cottrell; Garrison W,9999,0,9999,0
1668182460347,CSE 293,006,119146,Deutsch; Alin Bernard,9999,0,9999,0
1668182460347,CSE 293,007,119159,Esmaeilzadeh; Hadi,9999,0,9999,0
1668182460347,CSE 293,008,119166,Freund; Yoav,9999,0,9999,0
1668182460347,CSE 293,009,119170,Griswold; William G.,9999,0,9999,0
1668182460347,CSE 293,010,119183,Gymrek; Melissa Ann,9999,0,9999,0
1668182460347,CSE 293,011,119190,Heninger; Nadia A,9999,0,9999,0
1668182460347,CSE 293,012,119230,Impagliazzo; Russell,9999,0,9999,0
1668182460347,CSE 293,013,119232,Jhala; Ranjit,9999,0,9999,0
1668182460347,CSE 293,014,119233,Kahng; Andrew Byun,9999,0,9999,0
1668182460347,CSE 293,015,119298,Kane; Daniel Mertz,9999,0,9999,0
1668182460347,CSE 293,016,119299,Kriegman; David J,9999,0,9999,0
1668182460347,CSE 293,017,119300,Kumar; Arun Kumar,9999,0,9999,0
1668182460347,CSE 293,018,119301,Lerner; Sorin,9999,0,9999,0
1668182460347,CSE 293,019,119302,Lovett; Shachar,9999,0,9999,0
1668182460347,CSE 293,020,119303,McAuley; Julian John,9999,0,9999,0
1668182460347,CSE 293,021,119304,Micciancio; Daniele,9999,0,9999,0
1668182460347,CSE 293,022,119367,Orailoglu; Alex,9999,0,9999,0
1668182460347,CSE 293,023,119382,Paturi; Ramamohan,9999,0,9999,0
1668182460347,CSE 293,024,119404,Polikarpova; Nadezhda,9999,0,9999,0
1668182460347,CSE 293,025,119406,Politz; Joseph Gibbs,9999,0,9999,0
1668182460347,CSE 293,026,119411,Porter; George M,9999,0,9999,0
1668182460347,CSE 293,027,119414,Porter; Leonard Emerson,9999,0,9999,0
1668182460347,CSE 293,028,119416,Ramamoorthi; Ravi,9999,0,9999,0
1668182460347,CSE 293,029,119417,Sahoo; Debashis,9999,0,9999,0
1668182460347,CSE 293,030,119420,Saul; Lawrence,9999,0,9999,0
1668182460347,CSE 293,031,119421,Savage; Stefan,9999,0,9999,0
1668182460347,CSE 293,032,119425,Schulze; Jurgen P.,9999,0,9999,0
1668182460347,CSE 293,033,119426,Snoeren; Alex C.,9999,0,9999,0
1668182460347,CSE 293,034,119428,Shang; Jingbo,9999,0,9999,0
1668182460347,CSE 293,035,119430,Stefan; Deian,9999,0,9999,0
1668182460347,CSE 293,036,119431,Su; Hao,9999,0,9999,0
1668182460347,CSE 293,037,119433,Swanson; Steven James,9999,0,9999,0
1668182460347,CSE 293,038,119435,Tullsen; Dean Michael,9999,0,9999,0
1668182460347,CSE 293,039,119483,Voelker; Geoffrey M.,9999,0,9999,0
1668182460347,CSE 293,040,119537,Zhao; Jishen,9999,0,9999,0
1668182460347,CSE 293,041,119538,Zhou; Yuan-Yuan,9999,0,9999,0
1668182460347,CSE 293,042,119539,Gao; Sicun,9999,0,9999,0
1668182460347,CSE 293,043,119540,Weibel; Nadir,9999,0,9999,0
1668182460347,CSE 293,044,119541,Gupta; Rajesh K.,9999,0,9999,0
1668182460347,CSE 293,045,126410,Vaccaro; Kristen Marie,9999,0,9999,0
1668182460347,CSE 293,046,126411,Klemke; Richard,9999,0,9999,0
1668182460783,CSE 294,A00,102459,Voelker; Geoffrey M.,0,0,0,0
1668182460783,CSE 294,B00,111322,Orailoglu; Alex,0,0,0,0
1668182461210,DSE 201,A00,096914,Deutsch; Alin Bernard,30,0,30,0
1668182461634,DSE 210,A00,096915,Dasgupta; Sanjoy,30,0,30,0
1668182462059,DSE 260A,A00,096916,Altintas De Callaf; Ilkay,30,0,30,0
1668182462504,ECE 200,001,103586,Antipa; Nicholas A,9999,0,9999,0
1668182462504,ECE 200,002,103587,Atanasov; Nikolay A.,9999,0,9999,0
1668182462504,ECE 200,003,103588,Bharadia; Dinesh,9999,0,9999,0
1668182462504,ECE 200,004,103589,Cheng; Chung Kuan,9999,0,9999,0
1668182462504,ECE 200,005,103590,Cosman; Pamela C.,9999,0,9999,0
1668182462504,ECE 200,006,103591,Dayeh; Shadi Ahmad,9999,0,9999,0
1668182462504,ECE 200,007,103592,Fainman; Yeshaiahu,9999,0,9999,0
1668182462504,ECE 200,008,103593,Ford; Joseph Earl,9999,0,9999,0
1668182462504,ECE 200,009,103594,Franceschetti; Massimo,9999,0,9999,0
1668182462504,ECE 200,010,103595,Fullerton; Eric E,9999,0,9999,0
1668182462504,ECE 200,011,103596,Galton; Ian A,9999,0,9999,0
1668182462504,ECE 200,012,103597,Gilja; Vikash,9999,0,9999,0
1668182462504,ECE 200,013,103598,Hall; Drew A.,9999,0,9999,0
1668182462504,ECE 200,014,103599,Hsueh; Tzu-Chien,9999,0,9999,0
1668182462504,ECE 200,015,103600,Javidi; Tara,9999,0,9999,0
1668182462504,ECE 200,016,103601,Kahng; Andrew Byun,9999,0,9999,0
1668182462504,ECE 200,017,103602,Kim; Young-Han,9999,0,9999,0
1668182462504,ECE 200,018,103603,Koushanfar; Farinaz,9999,0,9999,0
1668182462504,ECE 200,019,103604,Kuzum; Duygu,9999,0,9999,0
1668182462504,ECE 200,020,103605,Le; Hanh-Phuc,9999,0,9999,0
1668182462504,ECE 200,021,103606,Lin; Bill,9999,0,9999,0
1668182462504,ECE 200,022,103607,Liu; Zhaowei,9998,0,9999,1
1668182462504,ECE 200,023,103608,Lo; Yu-Hwa,9999,0,9999,0
1668182462504,ECE 200,024,103609,Lomakin; Vitaliy,9999,0,9999,0
1668182462504,ECE 200,025,103610,Mercier; Patrick Philip,9999,0,9999,0
1668182462504,ECE 200,026,103611,Meyer; Florian,9999,0,9999,0
1668182462504,ECE 200,027,103612,Milstein; Laurence B.,9999,0,9999,0
1668182462504,ECE 200,028,103613,Mir Arabbaygi; Siavash,9999,0,9999,0
1668182462504,ECE 200,029,103614,Mookherjea; Shayan,9999,0,9999,0
1668182462504,ECE 200,030,103615,Morris; Karcher William,9999,0,9999,0
1668182462504,ECE 200,031,103616,Ng; Tse Nga,9999,0,9999,0
1668182462504,ECE 200,032,103617,Nguyen; Truong Quang,9999,0,9999,0
1668182462504,ECE 200,033,103618,Nomura; Kenji,9999,0,9999,0
1668182462504,ECE 200,034,103619,Orlitsky; Alon,9999,0,9999,0
1668182462504,ECE 200,035,103620,Pal; Piya,9999,0,9999,0
1668182462504,ECE 200,036,103621,Papen; George C.,9999,0,9999,0
1668182462504,ECE 200,037,103622,Radic; Stojan,9999,0,9999,0
1668182462504,ECE 200,038,103623,Rao; Bhaskar D.,9999,0,9999,0
1668182462504,ECE 200,039,103624,Rao; Ramesh R,9999,0,9999,0
1668182462504,ECE 200,040,103625,Rebeiz; Gabriel,9999,0,9999,0
1668182462504,ECE 200,041,103626,Sanford; John R,9999,0,9999,0
1668182462504,ECE 200,042,103627,Siegel; Paul H.,9999,0,9999,0
1668182462504,ECE 200,043,103628,Sievenpiper; Daniel F.,9999,0,9999,0
1668182462504,ECE 200,044,103629,Sworder; David D.,9999,0,9999,0
1668182462504,ECE 200,045,103630,Taur; Yuan,9999,0,9999,0
1668182462504,ECE 200,046,103631,Touri; Behrouz,9999,0,9999,0
1668182462504,ECE 200,047,103632,Trivedi; Mohan M.,9999,0,9999,0
1668182462504,ECE 200,048,103633,Vasconcelos; Nuno,9999,0,9999,0
1668182462504,ECE 200,049,103634,Wang; Xiaolong,9999,0,9999,0
1668182462504,ECE 200,050,103635,Xie; Pengtao,9999,0,9999,0
1668182462504,ECE 200,051,103636,Yip; Michael,9999,0,9999,0
1668182462504,ECE 200,052,103637,Zeger; Kenneth A.,999,0,999,0
1668182462504,ECE 200,053,103638,Zhang; Xinyu,9999,0,9999,0
1668182462504,ECE 200,054,103639,Turakhia; Yatish Girish,9999,0,9999,0
1668182462504,ECE 200,055,103640,Kang; Mingu,9999,0,9999,0
1668182462504,ECE 200,056,103641,Shi; Yuanyuan,9999,0,9999,0
1668182462504,ECE 200,057,103642,Wang; Edward Jay,9999,0,9999,0
1668182462504,ECE 200,058,103643,Zheng; Yang,9999,0,9999,0
1668182462932,ECE 202,A00,103644,Kuzum; Duygu,0,0,0,0
1668182463360,ECE 212BN,A00,103646,Ng; Tse Nga,0,0,0,0
1668182463787,ECE 221,A00,111493,Staff,0,0,0,0
1668182464218,ECE 222B,A00,103647,Lomakin; Vitaliy,0,0,0,0
1668182464647,ECE 230B,A00,103648,Taur; Yuan,0,0,0,0
1668182465073,ECE 238B,A00,103649,Garay; Javier,0,0,0,0
1668182465499,ECE 240B,A00,112900,Fainman; Yeshaiahu,0,0,0,0
1668182465926,ECE 247A,A00,103650,Jokerst; Jesse Vincent,0,0,0,0
1668182466349,ECE 247B,A00,103651,Wang; Joseph,0,0,0,0
1668182466772,ECE 250,A00,103652,Siegel; Paul H.,0,0,0,0
1668182467195,ECE 251A,A00,103654,Rao; Bhaskar D.,0,0,0,0
1668182467621,ECE 257B,A00,103655,Bharadia; Dinesh,0,0,0,0
1668182468058,ECE 258A,A00,103656,Milstein; Laurence B.,0,0,0,0
1668182468509,ECE 260B,A00,103658,Kang; Mingu,0,0,0,0
1668182468936,ECE 264A,A00,103659,Galton; Ian A,0,0,0,0
1668182469360,ECE 265A,A00,103661,Gudem; Prasad S.S.,0,0,0,0
1668182469801,ECE 265D,A00,103662,Gudem; Prasad S.S.,0,0,0,0
1668182470224,ECE 268,A00,103663,Koushanfar; Farinaz,0,0,0,0
1668182470648,ECE 269,A01,103665,Pal; Piya,0,0,0,0
1668182471072,ECE 271B,A00,103666,Vasconcelos; Manuela,0,0,0,0
1668182471496,ECE 276A,A00,103667,Atanasov; Nikolay A.,0,0,0,0
1668182471929,ECE 277,A00,103668,An; Cheolhong,0,0,0,0
1668182472355,ECE 279,A00,117947,Hall; Drew A.,0,0,0,0
1668182473210,ECE 283,A00,103670,Hsueh; Tzu-Chien,0,0,0,0
1668182473632,ECE 284,A00,103671,Turakhia; Yatish Girish,0,0,0,0
1668182474059,ECE 285,A00,103672,Zheng; Yang,0,0,0,0
1668182474059,ECE 285,B00,103673,Sworder; David D.,0,0,0,0
1668182474486,ECE 287,A00,103676,Javidi; Tara,0,0,0,0
1668182474912,MATH 200B,A00,098023,Salehi Golsefidy; Alireza,12,0,15,3
1668182475339,MATH 202B,A00,098024,Rhoades; Brendon Patrick,9,0,15,6
1668182475770,MATH 203B,A00,098025,Oprea; Dragos N.,10,0,15,5
1668182476193,MATH 204B,A00,098026,Sorensen; Claus M,13,0,15,2
1668182476620,MATH 208,A00,098027,Izadi; Elham,7,0,10,3
1668182477043,MATH 209,A00,098028,Pollack; Aaron,10,0,10,0
1668182477473,MATH 211A,A00,112919,Rogalski; Daniel,9,0,10,1
1668182477902,MATH 211B,A00,112920,Seward; Brandon M.,9,0,10,1
1668182478325,MATH 218,A00,098029,Li; Bo,10,0,10,0
1668182478761,MATH 220B,A00,098030,Novak; Jonathan I,11,0,15,4
1668182479187,MATH 221A,A00,098031,Ebenfelt; Peter F,13,0,15,2
1668182479611,MATH 231B,A00,098032,Zlatos; Andrej,12,0,15,3
1668182480041,MATH 240B,A00,098033,Ni; Lei,9,0,15,6
1668182480463,MATH 243,A00,098034,Jekel; David Andrew,10,0,10,0
1668182480887,MATH 245A,A00,098035,Nie; Jiawang,0,0,15,16
1668182481311,MATH 248,A00,098036,Bejenaru; Ioan,10,0,10,0
1668182481734,MATH 250B,A00,098037,Spolaor; Luca,14,0,15,1
1668182482164,MATH 258,A00,098038,Ni; Lei,10,0,10,0
1668182482588,MATH 264B,A00,098041,Rhoades; Brendon Patrick,9,0,15,6
1668182483013,MATH 268,A00,098042,Buss; Samuel R,10,0,10,0
1668182483439,MATH 269,A00,098043,Rhoades; Brendon Patrick,10,0,10,0
1668182483870,MATH 270B,A00,098044,Li; Bo,10,0,15,5
1668182484295,MATH 272B,A00,098045,Holst; Michael J,13,0,15,2
1668182484723,MATH 273A,A00,098046,Tian; Xiaochuan,10,0,15,5
1668182485158,MATH 275,A01,098048,Tian; Xiaochuan,6,0,10,4
1668182485582,MATH 278A,A00,098049,Holst; Michael J,8,0,10,2
1668182486012,MATH 278B,A00,098050,Cloninger; Alexander,10,0,10,0
1668182486435,MATH 278C,A00,098051,Nie; Jiawang,7,0,10,3
1668182486861,MATH 280B,A00,098052,Zheng; Tianyi,10,0,15,5
1668182487287,MATH 281B,A00,098053,Bradic; Jelena,2,0,15,13
1668182487714,MATH 282B,A00,098054,Arias-Castro; Ery,0,0,15,15
1668182488137,MATH 285,A00,098055,Fitzsimmons; Patrick J,0,0,15,17
1668182488560,MATH 287B,A00,098056,Arias-Castro; Ery,2,0,15,13
1668182488983,MATH 288,A00,098057,Agarwal; Pooja,9,0,10,1
1668182488983,MATH 288,B00,098058,Zhang; Danna,8,0,10,2
1668182488983,MATH 288,C00,098059,Williams; Ruth J,10,0,10,0
1668182489408,MATH 290B,A00,098060,Roberts; Justin Deritter,13,0,15,2
1668182489832,MATH 292,A00,098061,Belmont; Eva Kinoshita,10,0,10,0
1668182490267,MATH 295,A00,098062,Suk; Andrew Hoon,48,0,50,2
1668182490691,MATH 296,A00,098063,Novak; Jonathan I,20,0,20,0
1668182491116,MATH 297,001,098064,Gamst; Anthony Collins,9997,0,9999,2
1668182992878,COGS 205,A00,101395,Chiba; Andrea,19,0,20,1
1668182993304,COGS 210B,001,101404,Greene; Deanna Jacquelyn,9998,0,9999,1
1668182993304,COGS 210B,002,101417,Xia; Haijun,9999,0,9999,0
1668182993304,COGS 210B,003,101422,Nitz; Douglas A.,9999,0,9999,0
1668182993304,COGS 210B,004,101423,Hollan; James D.,9998,0,9999,1
1668182993304,COGS 210B,005,101424,Deak; Gedeon O.,9998,0,9999,1
1668182993304,COGS 210B,006,101425,Rossano; Federico,9999,0,9999,0
1668182993730,COGS 211B,A00,101427,Coulson; Seana M,9996,0,9999,3
1668182994153,COGS 220,A00,101428,Hollan; James D.,0,0,25,25
1668182994584,COGS 229,A00,101429,Dow; Steven P,18,0,25,7
1668182995016,COGS 230,A00,101430,Klemmer; Scott R,12,0,17,5
1668182995440,COGS 234,A00,101431,Xia; Haijun,3,0,25,22
1668182995865,COGS 260,A00,101432,Kiyonaga; Anastasia,20,0,25,5
1668182995865,COGS 260,B00,101433,Kirsh; David Joel,16,0,25,9
1668182996304,CSE 202,A00,102371,Impagliazzo; Russell,0,0,0,0
1668182996730,CSE 203B,A01,102373,Cheng; Chung Kuan,0,0,0,0
1668182997166,CSE 208,A00,102374,Micciancio; Daniele,0,0,0,0
1668182997588,CSE 209A,A00,112895,Impagliazzo; Russell,0,0,15,15
1668182998016,CSE 209B,A00,108005,Bellare; Mihir,0,0,0,0
1668182998449,CSE 210,A00,113163,Coblenz; Michael J,0,0,0,0
1668182998872,CSE 219,A00,106111,Dow; Steven P,0,0,20,20
1668182999310,CSE 221,A00,102376,Voelker; Geoffrey M.,0,0,0,0
1668182999739,CSE 224,A01,102378,Porter; George M,0,0,0,0
1668183000163,CSE 229A,A00,102379,Savage; Stefan,0,0,0,0
1668183000589,CSE 229C,A00,102380,Munyaka; Imani N. S.,0,0,0,0
1668183001015,CSE 232B,A00,102382,Deutsch; Alin Bernard,0,0,0,0
1668183001441,CSE 234,A01,112904,Kumar; Arun Kumar,0,0,0,0
1668183001882,CSE 237A,A00,102383,Rosing; Tajana Simunic,0,0,0,0
1668183002312,CSE 239A,A00,102384,Deutsch; Alin Bernard,0,0,0,0
1668183002740,CSE 239B,A00,102385,Polikarpova; Nadezhda,0,0,0,0
1668183003171,CSE 240A,A00,102386,Pannuto; Patrick William,0,0,0,0
1668183003595,CSE 240B,A00,102387,Zhao; Jishen,0,0,0,0
1668183004018,CSE 241A,A00,106406,Kang; Mingu,0,0,0,0
1668183004443,CSE 249B,A00,102388,Kahng; Andrew Byun,0,0,8,8
1668183004873,CSE 251B,A01,102392,Cottrell; Garrison W,0,0,0,0
1668183004873,CSE 251B,A02,102393,Cottrell; Garrison W,0,0,0,0
1668183005308,CSE 252B,A00,102394,Ochoa; Benjamin Lawrence,0,0,0,0
1668183005732,CSE 257,A01,102396,Gao; Sicun,0,0,0,0
1668183006156,CSE 272,A00,102397,Li; Tzumao,0,0,0,0
1668183006583,CSE 274,A00,111323,Chern; Albert Ren-Haur,0,0,0,0
1668183007010,CSE 282,A00,102398,Pevzner; Pavel Arkadjevich,0,0,0,0
1668183007446,CSE 284,A00,114175,Gymrek; Melissa Ann,0,0,0,0
1668183007873,CSE 290,A00,102399,Chandraker; Manmohan Krishna,0,0,0,0
1668183007873,CSE 290,B00,102400,Vaccaro; Kristen Marie,0,0,25,25
1668183007873,CSE 290,C00,102414,Pannuto; Patrick William,0,0,25,25
1668183007873,CSE 290,D00,102427,Pevzner; Pavel Arkadjevich,0,0,0,0
1668183007873,CSE 290,E00,102429,Zhao; Jishen,0,0,0,0
1668183007873,CSE 290,F00,102436,Tullsen; Dean Michael,0,0,0,0
1668183007873,CSE 290,G00,102440,Christensen; Henrik I,0,0,20,20
1668183008299,CSE 291,A00,102443,Su; Hao,0,0,0,0
1668183008299,CSE 291,B00,102448,Polikarpova; Nadezhda,0,0,0,0
1668183008299,CSE 291,C00,102453,Vaccaro; Kristen Marie,0,0,0,0
1668183008299,CSE 291,D00,111343,Savage; Stefan,0,0,0,0
1668183008299,CSE 291,E00,116474,Claffy; Kimberly Claire,0,0,0,0
1668183008299,CSE 291,F00,116479,Pasquale; Joseph,0,0,0,0
1668183008779,CSE 293,001,119111,Bafna; Vineet,9999,0,9999,0
1668183008779,CSE 293,002,119118,Bellare; Mihir,9999,0,9999,0
1668183008779,CSE 293,003,119122,Berg-Kirkpatrick; Taylor D,9999,0,9999,0
1668183008779,CSE 293,004,119135,Christensen; Henrik I,9999,0,9999,0
1668183008779,CSE 293,005,119142,Cottrell; Garrison W,9999,0,9999,0
1668183008779,CSE 293,006,119146,Deutsch; Alin Bernard,9999,0,9999,0
1668183008779,CSE 293,007,119159,Esmaeilzadeh; Hadi,9999,0,9999,0
1668183008779,CSE 293,008,119166,Freund; Yoav,9999,0,9999,0
1668183008779,CSE 293,009,119170,Griswold; William G.,9999,0,9999,0
1668183008779,CSE 293,010,119183,Gymrek; Melissa Ann,9999,0,9999,0
1668183008779,CSE 293,011,119190,Heninger; Nadia A,9999,0,9999,0
1668183008779,CSE 293,012,119230,Impagliazzo; Russell,9999,0,9999,0
1668183008779,CSE 293,013,119232,Jhala; Ranjit,9999,0,9999,0
1668183008779,CSE 293,014,119233,Kahng; Andrew Byun,9999,0,9999,0
1668183008779,CSE 293,015,119298,Kane; Daniel Mertz,9999,0,9999,0
1668183008779,CSE 293,016,119299,Kriegman; David J,9999,0,9999,0
1668183008779,CSE 293,017,119300,Kumar; Arun Kumar,9999,0,9999,0
1668183008779,CSE 293,018,119301,Lerner; Sorin,9999,0,9999,0
1668183008779,CSE 293,019,119302,Lovett; Shachar,9999,0,9999,0
1668183008779,CSE 293,020,119303,McAuley; Julian John,9999,0,9999,0
1668183008779,CSE 293,021,119304,Micciancio; Daniele,9999,0,9999,0
1668183008779,CSE 293,022,119367,Orailoglu; Alex,9999,0,9999,0
1668183008779,CSE 293,023,119382,Paturi; Ramamohan,9999,0,9999,0
1668183008779,CSE 293,024,119404,Polikarpova; Nadezhda,9999,0,9999,0
1668183008779,CSE 293,025,119406,Politz; Joseph Gibbs,9999,0,9999,0
1668183008779,CSE 293,026,119411,Porter; George M,9999,0,9999,0
1668183008779,CSE 293,027,119414,Porter; Leonard Emerson,9999,0,9999,0
1668183008779,CSE 293,028,119416,Ramamoorthi; Ravi,9999,0,9999,0
1668183008779,CSE 293,029,119417,Sahoo; Debashis,9999,0,9999,0
1668183008779,CSE 293,030,119420,Saul; Lawrence,9999,0,9999,0
1668183008779,CSE 293,031,119421,Savage; Stefan,9999,0,9999,0
1668183008779,CSE 293,032,119425,Schulze; Jurgen P.,9999,0,9999,0
1668183008779,CSE 293,033,119426,Snoeren; Alex C.,9999,0,9999,0
1668183008779,CSE 293,034,119428,Shang; Jingbo,9999,0,9999,0
1668183008779,CSE 293,035,119430,Stefan; Deian,9999,0,9999,0
1668183008779,CSE 293,036,119431,Su; Hao,9999,0,9999,0
1668183008779,CSE 293,037,119433,Swanson; Steven James,9999,0,9999,0
1668183008779,CSE 293,038,119435,Tullsen; Dean Michael,9999,0,9999,0
1668183008779,CSE 293,039,119483,Voelker; Geoffrey M.,9999,0,9999,0
1668183008779,CSE 293,040,119537,Zhao; Jishen,9999,0,9999,0
1668183008779,CSE 293,041,119538,Zhou; Yuan-Yuan,9999,0,9999,0
1668183008779,CSE 293,042,119539,Gao; Sicun,9999,0,9999,0
1668183008779,CSE 293,043,119540,Weibel; Nadir,9999,0,9999,0
1668183008779,CSE 293,044,119541,Gupta; Rajesh K.,9999,0,9999,0
1668183008779,CSE 293,045,126410,Vaccaro; Kristen Marie,9999,0,9999,0
1668183008779,CSE 293,046,126411,Klemke; Richard,9999,0,9999,0
1668183009202,CSE 294,A00,102459,Voelker; Geoffrey M.,0,0,0,0
1668183009202,CSE 294,B00,111322,Orailoglu; Alex,0,0,0,0
1668183009631,DSE 201,A00,096914,Deutsch; Alin Bernard,30,0,30,0
1668183010064,DSE 210,A00,096915,Dasgupta; Sanjoy,30,0,30,0
1668183010494,DSE 260A,A00,096916,Altintas De Callaf; Ilkay,30,0,30,0
1668183010989,ECE 200,001,103586,Antipa; Nicholas A,9999,0,9999,0
1668183010989,ECE 200,002,103587,Atanasov; Nikolay A.,9999,0,9999,0
1668183010989,ECE 200,003,103588,Bharadia; Dinesh,9999,0,9999,0
1668183010989,ECE 200,004,103589,Cheng; Chung Kuan,9999,0,9999,0
1668183010989,ECE 200,005,103590,Cosman; Pamela C.,9999,0,9999,0
1668183010989,ECE 200,006,103591,Dayeh; Shadi Ahmad,9999,0,9999,0
1668183010989,ECE 200,007,103592,Fainman; Yeshaiahu,9999,0,9999,0
1668183010989,ECE 200,008,103593,Ford; Joseph Earl,9999,0,9999,0
1668183010989,ECE 200,009,103594,Franceschetti; Massimo,9999,0,9999,0
1668183010989,ECE 200,010,103595,Fullerton; Eric E,9999,0,9999,0
1668183010989,ECE 200,011,103596,Galton; Ian A,9999,0,9999,0
1668183010989,ECE 200,012,103597,Gilja; Vikash,9999,0,9999,0
1668183010989,ECE 200,013,103598,Hall; Drew A.,9999,0,9999,0
1668183010989,ECE 200,014,103599,Hsueh; Tzu-Chien,9999,0,9999,0
1668183010989,ECE 200,015,103600,Javidi; Tara,9999,0,9999,0
1668183010989,ECE 200,016,103601,Kahng; Andrew Byun,9999,0,9999,0
1668183010989,ECE 200,017,103602,Kim; Young-Han,9999,0,9999,0
1668183010989,ECE 200,018,103603,Koushanfar; Farinaz,9999,0,9999,0
1668183010989,ECE 200,019,103604,Kuzum; Duygu,9999,0,9999,0
1668183010989,ECE 200,020,103605,Le; Hanh-Phuc,9999,0,9999,0
1668183010989,ECE 200,021,103606,Lin; Bill,9999,0,9999,0
1668183010989,ECE 200,022,103607,Liu; Zhaowei,9998,0,9999,1
1668183010989,ECE 200,023,103608,Lo; Yu-Hwa,9999,0,9999,0
1668183010989,ECE 200,024,103609,Lomakin; Vitaliy,9999,0,9999,0
1668183010989,ECE 200,025,103610,Mercier; Patrick Philip,9999,0,9999,0
1668183010989,ECE 200,026,103611,Meyer; Florian,9999,0,9999,0
1668183010989,ECE 200,027,103612,Milstein; Laurence B.,9999,0,9999,0
1668183010989,ECE 200,028,103613,Mir Arabbaygi; Siavash,9999,0,9999,0
1668183010989,ECE 200,029,103614,Mookherjea; Shayan,9999,0,9999,0
1668183010989,ECE 200,030,103615,Morris; Karcher William,9999,0,9999,0
1668183010989,ECE 200,031,103616,Ng; Tse Nga,9999,0,9999,0
1668183010989,ECE 200,032,103617,Nguyen; Truong Quang,9999,0,9999,0
1668183010989,ECE 200,033,103618,Nomura; Kenji,9999,0,9999,0
1668183010989,ECE 200,034,103619,Orlitsky; Alon,9999,0,9999,0
1668183010989,ECE 200,035,103620,Pal; Piya,9999,0,9999,0
1668183010989,ECE 200,036,103621,Papen; George C.,9999,0,9999,0
1668183010989,ECE 200,037,103622,Radic; Stojan,9999,0,9999,0
1668183010989,ECE 200,038,103623,Rao; Bhaskar D.,9999,0,9999,0
1668183010989,ECE 200,039,103624,Rao; Ramesh R,9999,0,9999,0
1668183010989,ECE 200,040,103625,Rebeiz; Gabriel,9999,0,9999,0
1668183010989,ECE 200,041,103626,Sanford; John R,9999,0,9999,0
1668183010989,ECE 200,042,103627,Siegel; Paul H.,9999,0,9999,0
1668183010989,ECE 200,043,103628,Sievenpiper; Daniel F.,9999,0,9999,0
1668183010989,ECE 200,044,103629,Sworder; David D.,9999,0,9999,0
1668183010989,ECE 200,045,103630,Taur; Yuan,9999,0,9999,0
1668183010989,ECE 200,046,103631,Touri; Behrouz,9999,0,9999,0
1668183010989,ECE 200,047,103632,Trivedi; Mohan M.,9999,0,9999,0
1668183010989,ECE 200,048,103633,Vasconcelos; Nuno,9999,0,9999,0
1668183010989,ECE 200,049,103634,Wang; Xiaolong,9999,0,9999,0
1668183010989,ECE 200,050,103635,Xie; Pengtao,9999,0,9999,0
1668183010989,ECE 200,051,103636,Yip; Michael,9999,0,9999,0
1668183010989,ECE 200,052,103637,Zeger; Kenneth A.,999,0,999,0
1668183010989,ECE 200,053,103638,Zhang; Xinyu,9999,0,9999,0
1668183010989,ECE 200,054,103639,Turakhia; Yatish Girish,9999,0,9999,0
1668183010989,ECE 200,055,103640,Kang; Mingu,9999,0,9999,0
1668183010989,ECE 200,056,103641,Shi; Yuanyuan,9999,0,9999,0
1668183010989,ECE 200,057,103642,Wang; Edward Jay,9999,0,9999,0
1668183010989,ECE 200,058,103643,Zheng; Yang,9999,0,9999,0
1668183011416,ECE 202,A00,103644,Kuzum; Duygu,0,0,0,0
1668183011842,ECE 212BN,A00,103646,Ng; Tse Nga,0,0,0,0
1668183012268,ECE 221,A00,111493,Staff,0,0,0,0
1668183012691,ECE 222B,A00,103647,Lomakin; Vitaliy,0,0,0,0
1668183013118,ECE 230B,A00,103648,Taur; Yuan,0,0,0,0
1668183013544,ECE 238B,A00,103649,Garay; Javier,0,0,0,0
1668183013980,ECE 240B,A00,112900,Fainman; Yeshaiahu,0,0,0,0
1668183014405,ECE 247A,A00,103650,Jokerst; Jesse Vincent,0,0,0,0
1668183014829,ECE 247B,A00,103651,Wang; Joseph,0,0,0,0
1668183015253,ECE 250,A00,103652,Siegel; Paul H.,0,0,0,0
1668183015684,ECE 251A,A00,103654,Rao; Bhaskar D.,0,0,0,0
1668183016112,ECE 257B,A00,103655,Bharadia; Dinesh,0,0,0,0
1668183016536,ECE 258A,A00,103656,Milstein; Laurence B.,0,0,0,0
1668183016969,ECE 260B,A00,103658,Kang; Mingu,0,0,0,0
1668183017400,ECE 264A,A00,103659,Galton; Ian A,0,0,0,0
1668183017824,ECE 265A,A00,103661,Gudem; Prasad S.S.,0,0,0,0
1668183018247,ECE 265D,A00,103662,Gudem; Prasad S.S.,0,0,0,0
1668183018672,ECE 268,A00,103663,Koushanfar; Farinaz,0,0,0,0
1668183019109,ECE 269,A01,103665,Pal; Piya,0,0,0,0
1668183019540,ECE 271B,A00,103666,Vasconcelos; Manuela,0,0,0,0
1668183019965,ECE 276A,A00,103667,Atanasov; Nikolay A.,0,0,0,0
1668183020388,ECE 277,A00,103668,An; Cheolhong,0,0,0,0
1668183020814,ECE 279,A00,117947,Hall; Drew A.,0,0,0,0
1668183021672,ECE 283,A00,103670,Hsueh; Tzu-Chien,0,0,0,0
1668183022098,ECE 284,A00,103671,Turakhia; Yatish Girish,0,0,0,0
1668183022522,ECE 285,A00,103672,Zheng; Yang,0,0,0,0
1668183022522,ECE 285,B00,103673,Sworder; David D.,0,0,0,0
1668183022956,ECE 287,A00,103676,Javidi; Tara,0,0,0,0
1668183023387,MATH 200B,A00,098023,Salehi Golsefidy; Alireza,12,0,15,3
1668183023901,MATH 202B,A00,098024,Rhoades; Brendon Patrick,9,0,15,6
1668183024330,MATH 203B,A00,098025,Oprea; Dragos N.,10,0,15,5
1668183024758,MATH 204B,A00,098026,Sorensen; Claus M,13,0,15,2
1668183025183,MATH 208,A00,098027,Izadi; Elham,7,0,10,3
1668183025606,MATH 209,A00,098028,Pollack; Aaron,10,0,10,0
1668183026029,MATH 211A,A00,112919,Rogalski; Daniel,9,0,10,1
1668183026452,MATH 211B,A00,112920,Seward; Brandon M.,9,0,10,1
1668183026874,MATH 218,A00,098029,Li; Bo,10,0,10,0
1668183027297,MATH 220B,A00,098030,Novak; Jonathan I,11,0,15,4
1668183027727,MATH 221A,A00,098031,Ebenfelt; Peter F,13,0,15,2
1668183028155,MATH 231B,A00,098032,Zlatos; Andrej,12,0,15,3
1668183028583,MATH 240B,A00,098033,Ni; Lei,9,0,15,6
1668183029017,MATH 243,A00,098034,Jekel; David Andrew,10,0,10,0
1668183029442,MATH 245A,A00,098035,Nie; Jiawang,0,0,15,16
1668183029880,MATH 248,A00,098036,Bejenaru; Ioan,10,0,10,0
1668183030306,MATH 250B,A00,098037,Spolaor; Luca,14,0,15,1
1668183030732,MATH 258,A00,098038,Ni; Lei,10,0,10,0
1668183031155,MATH 264B,A00,098041,Rhoades; Brendon Patrick,9,0,15,6
1668183031595,MATH 268,A00,098042,Buss; Samuel R,10,0,10,0
1668183032020,MATH 269,A00,098043,Rhoades; Brendon Patrick,10,0,10,0
1668183032448,MATH 270B,A00,098044,Li; Bo,10,0,15,5
1668183032877,MATH 272B,A00,098045,Holst; Michael J,13,0,15,2
1668183033313,MATH 273A,A00,098046,Tian; Xiaochuan,10,0,15,5
1668183033739,MATH 275,A01,098048,Tian; Xiaochuan,6,0,10,4
1668183034163,MATH 278A,A00,098049,Holst; Michael J,8,0,10,2
1668183034588,MATH 278B,A00,098050,Cloninger; Alexander,10,0,10,0
1668183035015,MATH 278C,A00,098051,Nie; Jiawang,7,0,10,3
1668183035441,MATH 280B,A00,098052,Zheng; Tianyi,10,0,15,5
1668183035870,MATH 281B,A00,098053,Bradic; Jelena,2,0,15,13
1668183036295,MATH 282B,A00,098054,Arias-Castro; Ery,0,0,15,15
1668183036719,MATH 285,A00,098055,Fitzsimmons; Patrick J,0,0,15,17
1668183037150,MATH 287B,A00,098056,Arias-Castro; Ery,2,0,15,13
1668183037575,MATH 288,A00,098057,Agarwal; Pooja,9,0,10,1
1668183037575,MATH 288,B00,098058,Zhang; Danna,8,0,10,2
1668183037575,MATH 288,C00,098059,Williams; Ruth J,10,0,10,0
1668183038012,MATH 290B,A00,098060,Roberts; Justin Deritter,13,0,15,2
1668183038437,MATH 292,A00,098061,Belmont; Eva Kinoshita,10,0,10,0
1668183038861,MATH 295,A00,098062,Suk; Andrew Hoon,48,0,50,2
1668183039289,MATH 296,A00,098063,Novak; Jonathan I,20,0,20,0
1668183039725,MATH 297,001,098064,Gamst; Anthony Collins,9997,0,9999,2
1668183541724,COGS 205,A00,101395,Chiba; Andrea,19,0,20,1
1668183542155,COGS 210B,001,101404,Greene; Deanna Jacquelyn,9998,0,9999,1
1668183542155,COGS 210B,002,101417,Xia; Haijun,9999,0,9999,0
1668183542155,COGS 210B,003,101422,Nitz; Douglas A.,9999,0,9999,0
1668183542155,COGS 210B,004,101423,Hollan; James D.,9998,0,9999,1
1668183542155,COGS 210B,005,101424,Deak; Gedeon O.,9998,0,9999,1
1668183542155,COGS 210B,006,101425,Rossano; Federico,9999,0,9999,0
1668183542582,COGS 211B,A00,101427,Coulson; Seana M,9996,0,9999,3
1668183543017,COGS 220,A00,101428,Hollan; James D.,0,0,25,25
1668183543442,COGS 229,A00,101429,Dow; Steven P,18,0,25,7
1668183543871,COGS 230,A00,101430,Klemmer; Scott R,12,0,17,5
1668183544301,COGS 234,A00,101431,Xia; Haijun,3,0,25,22
1668183544726,COGS 260,A00,101432,Kiyonaga; Anastasia,20,0,25,5
1668183544726,COGS 260,B00,101433,Kirsh; David Joel,16,0,25,9
1668183545150,CSE 202,A00,102371,Impagliazzo; Russell,0,0,0,0
1668183545577,CSE 203B,A01,102373,Cheng; Chung Kuan,0,0,0,0
1668183546095,CSE 208,A00,102374,Micciancio; Daniele,0,0,0,0
1668183546527,CSE 209A,A00,112895,Impagliazzo; Russell,0,0,15,15
1668183546949,CSE 209B,A00,108005,Bellare; Mihir,0,0,0,0
1668183547382,CSE 210,A00,113163,Coblenz; Michael J,0,0,0,0
1668183547806,CSE 219,A00,106111,Dow; Steven P,0,0,20,20
1668183548234,CSE 221,A00,102376,Voelker; Geoffrey M.,0,0,0,0
1668183548669,CSE 224,A01,102378,Porter; George M,0,0,0,0
1668183549104,CSE 229A,A00,102379,Savage; Stefan,0,0,0,0
1668183549530,CSE 229C,A00,102380,Munyaka; Imani N. S.,0,0,0,0
1668183549959,CSE 232B,A00,102382,Deutsch; Alin Bernard,0,0,0,0
1668183550390,CSE 234,A01,112904,Kumar; Arun Kumar,0,0,0,0
1668183550817,CSE 237A,A00,102383,Rosing; Tajana Simunic,0,0,0,0
1668183551243,CSE 239A,A00,102384,Deutsch; Alin Bernard,0,0,0,0
1668183551672,CSE 239B,A00,102385,Polikarpova; Nadezhda,0,0,0,0
1668183552101,CSE 240A,A00,102386,Pannuto; Patrick William,0,0,0,0
1668183552527,CSE 240B,A00,102387,Zhao; Jishen,0,0,0,0
1668183552954,CSE 241A,A00,106406,Kang; Mingu,0,0,0,0
1668183553377,CSE 249B,A00,102388,Kahng; Andrew Byun,0,0,8,8
1668183553807,CSE 251B,A01,102392,Cottrell; Garrison W,0,0,0,0
1668183553807,CSE 251B,A02,102393,Cottrell; Garrison W,0,0,0,0
1668183554235,CSE 252B,A00,102394,Ochoa; Benjamin Lawrence,0,0,0,0
1668183554663,CSE 257,A01,102396,Gao; Sicun,0,0,0,0
1668183555090,CSE 272,A00,102397,Li; Tzumao,0,0,0,0
1668183555514,CSE 274,A00,111323,Chern; Albert Ren-Haur,0,0,0,0
1668183555942,CSE 282,A00,102398,Pevzner; Pavel Arkadjevich,0,0,0,0
1668183556376,CSE 284,A00,114175,Gymrek; Melissa Ann,0,0,0,0
1668183556801,CSE 290,A00,102399,Chandraker; Manmohan Krishna,0,0,0,0
1668183556801,CSE 290,B00,102400,Vaccaro; Kristen Marie,0,0,25,25
1668183556801,CSE 290,C00,102414,Pannuto; Patrick William,0,0,25,25
1668183556801,CSE 290,D00,102427,Pevzner; Pavel Arkadjevich,0,0,0,0
1668183556801,CSE 290,E00,102429,Zhao; Jishen,0,0,0,0
1668183556801,CSE 290,F00,102436,Tullsen; Dean Michael,0,0,0,0
1668183556801,CSE 290,G00,102440,Christensen; Henrik I,0,0,20,20
1668183557238,CSE 291,A00,102443,Su; Hao,0,0,0,0
1668183557238,CSE 291,B00,102448,Polikarpova; Nadezhda,0,0,0,0
1668183557238,CSE 291,C00,102453,Vaccaro; Kristen Marie,0,0,0,0
1668183557238,CSE 291,D00,111343,Savage; Stefan,0,0,0,0
1668183557238,CSE 291,E00,116474,Claffy; Kimberly Claire,0,0,0,0
1668183557238,CSE 291,F00,116479,Pasquale; Joseph,0,0,0,0
1668183557711,CSE 293,001,119111,Bafna; Vineet,9999,0,9999,0
1668183557711,CSE 293,002,119118,Bellare; Mihir,9999,0,9999,0
1668183557711,CSE 293,003,119122,Berg-Kirkpatrick; Taylor D,9999,0,9999,0
1668183557711,CSE 293,004,119135,Christensen; Henrik I,9999,0,9999,0
1668183557711,CSE 293,005,119142,Cottrell; Garrison W,9999,0,9999,0
1668183557711,CSE 293,006,119146,Deutsch; Alin Bernard,9999,0,9999,0
1668183557711,CSE 293,007,119159,Esmaeilzadeh; Hadi,9999,0,9999,0
1668183557711,CSE 293,008,119166,Freund; Yoav,9999,0,9999,0
1668183557711,CSE 293,009,119170,Griswold; William G.,9999,0,9999,0
1668183557711,CSE 293,010,119183,Gymrek; Melissa Ann,9999,0,9999,0
1668183557711,CSE 293,011,119190,Heninger; Nadia A,9999,0,9999,0
1668183557711,CSE 293,012,119230,Impagliazzo; Russell,9999,0,9999,0
1668183557711,CSE 293,013,119232,Jhala; Ranjit,9999,0,9999,0
1668183557711,CSE 293,014,119233,Kahng; Andrew Byun,9999,0,9999,0
1668183557711,CSE 293,015,119298,Kane; Daniel Mertz,9999,0,9999,0
1668183557711,CSE 293,016,119299,Kriegman; David J,9999,0,9999,0
1668183557711,CSE 293,017,119300,Kumar; Arun Kumar,9999,0,9999,0
1668183557711,CSE 293,018,119301,Lerner; Sorin,9999,0,9999,0
1668183557711,CSE 293,019,119302,Lovett; Shachar,9999,0,9999,0
1668183557711,CSE 293,020,119303,McAuley; Julian John,9999,0,9999,0
1668183557711,CSE 293,021,119304,Micciancio; Daniele,9999,0,9999,0
1668183557711,CSE 293,022,119367,Orailoglu; Alex,9999,0,9999,0
1668183557711,CSE 293,023,119382,Paturi; Ramamohan,9999,0,9999,0
1668183557711,CSE 293,024,119404,Polikarpova; Nadezhda,9999,0,9999,0
1668183557711,CSE 293,025,119406,Politz; Joseph Gibbs,9999,0,9999,0
1668183557711,CSE 293,026,119411,Porter; George M,9999,0,9999,0
1668183557711,CSE 293,027,119414,Porter; Leonard Emerson,9999,0,9999,0
1668183557711,CSE 293,028,119416,Ramamoorthi; Ravi,9999,0,9999,0
1668183557711,CSE 293,029,119417,Sahoo; Debashis,9999,0,9999,0
1668183557711,CSE 293,030,119420,Saul; Lawrence,9999,0,9999,0
1668183557711,CSE 293,031,119421,Savage; Stefan,9999,0,9999,0
1668183557711,CSE 293,032,119425,Schulze; Jurgen P.,9999,0,9999,0
1668183557711,CSE 293,033,119426,Snoeren; Alex C.,9999,0,9999,0
1668183557711,CSE 293,034,119428,Shang; Jingbo,9999,0,9999,0
1668183557711,CSE 293,035,119430,Stefan; Deian,9999,0,9999,0
1668183557711,CSE 293,036,119431,Su; Hao,9999,0,9999,0
1668183557711,CSE 293,037,119433,Swanson; Steven James,9999,0,9999,0
1668183557711,CSE 293,038,119435,Tullsen; Dean Michael,9999,0,9999,0
1668183557711,CSE 293,039,119483,Voelker; Geoffrey M.,9999,0,9999,0
1668183557711,CSE 293,040,119537,Zhao; Jishen,9999,0,9999,0
1668183557711,CSE 293,041,119538,Zhou; Yuan-Yuan,9999,0,9999,0
1668183557711,CSE 293,042,119539,Gao; Sicun,9999,0,9999,0
1668183557711,CSE 293,043,119540,Weibel; Nadir,9999,0,9999,0
1668183557711,CSE 293,044,119541,Gupta; Rajesh K.,9999,0,9999,0
1668183557711,CSE 293,045,126410,Vaccaro; Kristen Marie,9999,0,9999,0
1668183557711,CSE 293,046,126411,Klemke; Richard,9999,0,9999,0
1668183558136,CSE 294,A00,102459,Voelker; Geoffrey M.,0,0,0,0
1668183558136,CSE 294,B00,111322,Orailoglu; Alex,0,0,0,0
1668183558574,DSE 201,A00,096914,Deutsch; Alin Bernard,30,0,30,0
1668183558998,DSE 210,A00,096915,Dasgupta; Sanjoy,30,0,30,0
1668183559432,DSE 260A,A00,096916,Altintas De Callaf; Ilkay,30,0,30,0
1668183559879,ECE 200,001,103586,Antipa; Nicholas A,9999,0,9999,0
1668183559879,ECE 200,002,103587,Atanasov; Nikolay A.,9999,0,9999,0
1668183559879,ECE 200,003,103588,Bharadia; Dinesh,9999,0,9999,0
1668183559879,ECE 200,004,103589,Cheng; Chung Kuan,9999,0,9999,0
1668183559879,ECE 200,005,103590,Cosman; Pamela C.,9999,0,9999,0
1668183559879,ECE 200,006,103591,Dayeh; Shadi Ahmad,9999,0,9999,0
1668183559879,ECE 200,007,103592,Fainman; Yeshaiahu,9999,0,9999,0
1668183559879,ECE 200,008,103593,Ford; Joseph Earl,9999,0,9999,0
1668183559879,ECE 200,009,103594,Franceschetti; Massimo,9999,0,9999,0
1668183559879,ECE 200,010,103595,Fullerton; Eric E,9999,0,9999,0
1668183559879,ECE 200,011,103596,Galton; Ian A,9999,0,9999,0
1668183559879,ECE 200,012,103597,Gilja; Vikash,9999,0,9999,0
1668183559879,ECE 200,013,103598,Hall; Drew A.,9999,0,9999,0
1668183559879,ECE 200,014,103599,Hsueh; Tzu-Chien,9999,0,9999,0
1668183559879,ECE 200,015,103600,Javidi; Tara,9999,0,9999,0
1668183559879,ECE 200,016,103601,Kahng; Andrew Byun,9999,0,9999,0
1668183559879,ECE 200,017,103602,Kim; Young-Han,9999,0,9999,0
1668183559879,ECE 200,018,103603,Koushanfar; Farinaz,9999,0,9999,0
1668183559879,ECE 200,019,103604,Kuzum; Duygu,9999,0,9999,0
1668183559879,ECE 200,020,103605,Le; Hanh-Phuc,9999,0,9999,0
1668183559879,ECE 200,021,103606,Lin; Bill,9999,0,9999,0
1668183559879,ECE 200,022,103607,Liu; Zhaowei,9998,0,9999,1
1668183559879,ECE 200,023,103608,Lo; Yu-Hwa,9999,0,9999,0
1668183559879,ECE 200,024,103609,Lomakin; Vitaliy,9999,0,9999,0
1668183559879,ECE 200,025,103610,Mercier; Patrick Philip,9999,0,9999,0
1668183559879,ECE 200,026,103611,Meyer; Florian,9999,0,9999,0
1668183559879,ECE 200,027,103612,Milstein; Laurence B.,9999,0,9999,0
1668183559879,ECE 200,028,103613,Mir Arabbaygi; Siavash,9999,0,9999,0
1668183559879,ECE 200,029,103614,Mookherjea; Shayan,9999,0,9999,0
1668183559879,ECE 200,030,103615,Morris; Karcher William,9999,0,9999,0
1668183559879,ECE 200,031,103616,Ng; Tse Nga,9999,0,9999,0
1668183559879,ECE 200,032,103617,Nguyen; Truong Quang,9999,0,9999,0
1668183559879,ECE 200,033,103618,Nomura; Kenji,9999,0,9999,0
1668183559879,ECE 200,034,103619,Orlitsky; Alon,9999,0,9999,0
1668183559879,ECE 200,035,103620,Pal; Piya,9999,0,9999,0
1668183559879,ECE 200,036,103621,Papen; George C.,9999,0,9999,0
1668183559879,ECE 200,037,103622,Radic; Stojan,9999,0,9999,0
1668183559879,ECE 200,038,103623,Rao; Bhaskar D.,9999,0,9999,0
1668183559879,ECE 200,039,103624,Rao; Ramesh R,9999,0,9999,0
1668183559879,ECE 200,040,103625,Rebeiz; Gabriel,9999,0,9999,0
1668183559879,ECE 200,041,103626,Sanford; John R,9999,0,9999,0
1668183559879,ECE 200,042,103627,Siegel; Paul H.,9999,0,9999,0
1668183559879,ECE 200,043,103628,Sievenpiper; Daniel F.,9999,0,9999,0
1668183559879,ECE 200,044,103629,Sworder; David D.,9999,0,9999,0
1668183559879,ECE 200,045,103630,Taur; Yuan,9999,0,9999,0
1668183559879,ECE 200,046,103631,Touri; Behrouz,9999,0,9999,0
1668183559879,ECE 200,047,103632,Trivedi; Mohan M.,9999,0,9999,0
1668183559879,ECE 200,048,103633,Vasconcelos; Nuno,9999,0,9999,0
1668183559879,ECE 200,049,103634,Wang; Xiaolong,9999,0,9999,0
1668183559879,ECE 200,050,103635,Xie; Pengtao,9999,0,9999,0
1668183559879,ECE 200,051,103636,Yip; Michael,9999,0,9999,0
1668183559879,ECE 200,052,103637,Zeger; Kenneth A.,999,0,999,0
1668183559879,ECE 200,053,103638,Zhang; Xinyu,9999,0,9999,0
1668183559879,ECE 200,054,103639,Turakhia; Yatish Girish,9999,0,9999,0
1668183559879,ECE 200,055,103640,Kang; Mingu,9999,0,9999,0
1668183559879,ECE 200,056,103641,Shi; Yuanyuan,9999,0,9999,0
1668183559879,ECE 200,057,103642,Wang; Edward Jay,9999,0,9999,0
1668183559879,ECE 200,058,103643,Zheng; Yang,9999,0,9999,0
1668183560305,ECE 202,A00,103644,Kuzum; Duygu,0,0,0,0
1668183560741,ECE 212BN,A00,103646,Ng; Tse Nga,0,0,0,0
1668183561171,ECE 221,A00,111493,Staff,0,0,0,0
1668183561596,ECE 222B,A00,103647,Lomakin; Vitaliy,0,0,0,0
1668183562020,ECE 230B,A00,103648,Taur; Yuan,0,0,0,0
1668183562449,ECE 238B,A00,103649,Garay; Javier,0,0,0,0
1668183562876,ECE 240B,A00,112900,Fainman; Yeshaiahu,0,0,0,0
1668183563302,ECE 247A,A00,103650,Jokerst; Jesse Vincent,0,0,0,0
1668183563725,ECE 247B,A00,103651,Wang; Joseph,0,0,0,0
1668183564157,ECE 250,A00,103652,Siegel; Paul H.,0,0,0,0
1668183564592,ECE 251A,A00,103654,Rao; Bhaskar D.,0,0,0,0
1668183565026,ECE 257B,A00,103655,Bharadia; Dinesh,0,0,0,0
1668183565449,ECE 258A,A00,103656,Milstein; Laurence B.,0,0,0,0
1668183565873,ECE 260B,A00,103658,Kang; Mingu,0,0,0,0
1668183566299,ECE 264A,A00,103659,Galton; Ian A,0,0,0,0
1668183566727,ECE 265A,A00,103661,Gudem; Prasad S.S.,0,0,0,0
1668183567152,ECE 265D,A00,103662,Gudem; Prasad S.S.,0,0,0,0
1668183567578,ECE 268,A00,103663,Koushanfar; Farinaz,0,0,0,0
1668183568003,ECE 269,A01,103665,Pal; Piya,0,0,0,0
1668183568439,ECE 271B,A00,103666,Vasconcelos; Manuela,0,0,0,0
1668183568874,ECE 276A,A00,103667,Atanasov; Nikolay A.,0,0,0,0
1668183569300,ECE 277,A00,103668,An; Cheolhong,0,0,0,0
1668183569725,ECE 279,A00,117947,Hall; Drew A.,0,0,0,0
1668183570577,ECE 283,A00,103670,Hsueh; Tzu-Chien,0,0,0,0
1668183571011,ECE 284,A00,103671,Turakhia; Yatish Girish,0,0,0,0
1668183571440,ECE 285,A00,103672,Zheng; Yang,0,0,0,0
1668183571440,ECE 285,B00,103673,Sworder; David D.,0,0,0,0
1668183571864,ECE 287,A00,103676,Javidi; Tara,0,0,0,0
1668183572302,MATH 200B,A00,098023,Salehi Golsefidy; Alireza,12,0,15,3
1668183572729,MATH 202B,A00,098024,Rhoades; Brendon Patrick,9,0,15,6
1668183573154,MATH 203B,A00,098025,Oprea; Dragos N.,10,0,15,5
1668183573579,MATH 204B,A00,098026,Sorensen; Claus M,13,0,15,2
1668183574005,MATH 208,A00,098027,Izadi; Elham,7,0,10,3
1668183574429,MATH 209,A00,098028,Pollack; Aaron,10,0,10,0
1668183574856,MATH 211A,A00,112919,Rogalski; Daniel,9,0,10,1
1668183575280,MATH 211B,A00,112920,Seward; Brandon M.,9,0,10,1
1668183575708,MATH 218,A00,098029,Li; Bo,10,0,10,0
1668183576132,MATH 220B,A00,098030,Novak; Jonathan I,11,0,15,4
1668183576560,MATH 221A,A00,098031,Ebenfelt; Peter F,13,0,15,2
1668183576989,MATH 231B,A00,098032,Zlatos; Andrej,12,0,15,3
1668183577412,MATH 240B,A00,098033,Ni; Lei,9,0,15,6
1668183577853,MATH 243,A00,098034,Jekel; David Andrew,10,0,10,0
1668183578279,MATH 245A,A00,098035,Nie; Jiawang,0,0,15,16
1668183578701,MATH 248,A00,098036,Bejenaru; Ioan,10,0,10,0
1668183579141,MATH 250B,A00,098037,Spolaor; Luca,14,0,15,1
1668183579564,MATH 258,A00,098038,Ni; Lei,10,0,10,0
1668183579996,MATH 264B,A00,098041,Rhoades; Brendon Patrick,9,0,15,6
1668183580424,MATH 268,A00,098042,Buss; Samuel R,10,0,10,0
1668183580851,MATH 269,A00,098043,Rhoades; Brendon Patrick,10,0,10,0
1668183581277,MATH 270B,A00,098044,Li; Bo,10,0,15,5
1668183581715,MATH 272B,A00,098045,Holst; Michael J,13,0,15,2
1668183582138,MATH 273A,A00,098046,Tian; Xiaochuan,10,0,15,5
1668183582579,MATH 275,A01,098048,Tian; Xiaochuan,6,0,10,4
1668183583006,MATH 278A,A00,098049,Holst; Michael J,8,0,10,2
1668183583434,MATH 278B,A00,098050,Cloninger; Alexander,10,0,10,0
1668183583859,MATH 278C,A00,098051,Nie; Jiawang,7,0,10,3
1668183584280,MATH 280B,A00,098052,Zheng; Tianyi,10,0,15,5
1668183584706,MATH 281B,A00,098053,Bradic; Jelena,2,0,15,13
1668183585136,MATH 282B,A00,098054,Arias-Castro; Ery,0,0,15,15
1668183585560,MATH 285,A00,098055,Fitzsimmons; Patrick J,0,0,15,17
1668183585987,MATH 287B,A00,098056,Arias-Castro; Ery,2,0,15,13
1668183586410,MATH 288,A00,098057,Agarwal; Pooja,9,0,10,1
1668183586410,MATH 288,B00,098058,Zhang; Danna,8,0,10,2
1668183586410,MATH 288,C00,098059,Williams; Ruth J,10,0,10,0
1668183586836,MATH 290B,A00,098060,Roberts; Justin Deritter,13,0,15,2
1668183587261,MATH 292,A00,098061,Belmont; Eva Kinoshita,10,0,10,0
1668183587684,MATH 295,A00,098062,Suk; Andrew Hoon,48,0,50,2
1668183588115,MATH 296,A00,098063,Novak; Jonathan I,20,0,20,0
1668183588537,MATH 297,001,098064,Gamst; Anthony Collins,9997,0,9999,2
1668184090691,COGS 205,A00,101395,Chiba; Andrea,19,0,20,1
1668184091116,COGS 210B,001,101404,Greene; Deanna Jacquelyn,9998,0,9999,1
1668184091116,COGS 210B,002,101417,Xia; Haijun,9999,0,9999,0
1668184091116,COGS 210B,003,101422,Nitz; Douglas A.,9999,0,9999,0
1668184091116,COGS 210B,004,101423,Hollan; James D.,9998,0,9999,1
1668184091116,COGS 210B,005,101424,Deak; Gedeon O.,9998,0,9999,1
1668184091116,COGS 210B,006,101425,Rossano; Federico,9999,0,9999,0
1668184091545,COGS 211B,A00,101427,Coulson; Seana M,9996,0,9999,3
1668184091976,COGS 220,A00,101428,Hollan; James D.,0,0,25,25
1668184092405,COGS 229,A00,101429,Dow; Steven P,18,0,25,7
1668184092843,COGS 230,A00,101430,Klemmer; Scott R,12,0,17,5
1668184093267,COGS 234,A00,101431,Xia; Haijun,3,0,25,22
1668184093694,COGS 260,A00,101432,Kiyonaga; Anastasia,20,0,25,5
1668184093694,COGS 260,B00,101433,Kirsh; David Joel,16,0,25,9
1668184094151,CSE 202,A00,102371,Impagliazzo; Russell,0,0,0,0
1668184094587,CSE 203B,A01,102373,Cheng; Chung Kuan,0,0,0,0
1668184095015,CSE 208,A00,102374,Micciancio; Daniele,0,0,0,0
1668184095455,CSE 209A,A00,112895,Impagliazzo; Russell,0,0,15,15
1668184095880,CSE 209B,A00,108005,Bellare; Mihir,0,0,0,0
1668184096317,CSE 210,A00,113163,Coblenz; Michael J,0,0,0,0
1668184096744,CSE 219,A00,106111,Dow; Steven P,0,0,20,20
1668184097175,CSE 221,A00,102376,Voelker; Geoffrey M.,0,0,0,0
1668184097618,CSE 224,A01,102378,Porter; George M,0,0,0,0
1668184098043,CSE 229A,A00,102379,Savage; Stefan,0,0,0,0
1668184098468,CSE 229C,A00,102380,Munyaka; Imani N. S.,0,0,0,0
1668184098907,CSE 232B,A00,102382,Deutsch; Alin Bernard,0,0,0,0
1668184099330,CSE 234,A01,112904,Kumar; Arun Kumar,0,0,0,0
1668184099754,CSE 237A,A00,102383,Rosing; Tajana Simunic,0,0,0,0
1668184100181,CSE 239A,A00,102384,Deutsch; Alin Bernard,0,0,0,0
1668184100604,CSE 239B,A00,102385,Polikarpova; Nadezhda,0,0,0,0
1668184101029,CSE 240A,A00,102386,Pannuto; Patrick William,0,0,0,0
1668184101456,CSE 240B,A00,102387,Zhao; Jishen,0,0,0,0
1668184101881,CSE 241A,A00,106406,Kang; Mingu,0,0,0,0
1668184102308,CSE 249B,A00,102388,Kahng; Andrew Byun,0,0,8,8
1668184102731,CSE 251B,A01,102392,Cottrell; Garrison W,0,0,0,0
1668184102731,CSE 251B,A02,102393,Cottrell; Garrison W,0,0,0,0
1668184103155,CSE 252B,A00,102394,Ochoa; Benjamin Lawrence,0,0,0,0
1668184103582,CSE 257,A01,102396,Gao; Sicun,0,0,0,0
1668184104013,CSE 272,A00,102397,Li; Tzumao,0,0,0,0
1668184104444,CSE 274,A00,111323,Chern; Albert Ren-Haur,0,0,0,0
1668184104883,CSE 282,A00,102398,Pevzner; Pavel Arkadjevich,0,0,0,0
1668184105322,CSE 284,A00,114175,Gymrek; Melissa Ann,0,0,0,0
1668184105759,CSE 290,A00,102399,Chandraker; Manmohan Krishna,0,0,0,0
1668184105759,CSE 290,B00,102400,Vaccaro; Kristen Marie,0,0,25,25
1668184105759,CSE 290,C00,102414,Pannuto; Patrick William,0,0,25,25
1668184105759,CSE 290,D00,102427,Pevzner; Pavel Arkadjevich,0,0,0,0
1668184105759,CSE 290,E00,102429,Zhao; Jishen,0,0,0,0
1668184105759,CSE 290,F00,102436,Tullsen; Dean Michael,0,0,0,0
1668184105759,CSE 290,G00,102440,Christensen; Henrik I,0,0,20,20
1668184106185,CSE 291,A00,102443,Su; Hao,0,0,0,0
1668184106185,CSE 291,B00,102448,Polikarpova; Nadezhda,0,0,0,0
1668184106185,CSE 291,C00,102453,Vaccaro; Kristen Marie,0,0,0,0
1668184106185,CSE 291,D00,111343,Savage; Stefan,0,0,0,0
1668184106185,CSE 291,E00,116474,Claffy; Kimberly Claire,0,0,0,0
1668184106185,CSE 291,F00,116479,Pasquale; Joseph,0,0,0,0
1668184106646,CSE 293,001,119111,Bafna; Vineet,9999,0,9999,0
1668184106646,CSE 293,002,119118,Bellare; Mihir,9999,0,9999,0
1668184106646,CSE 293,003,119122,Berg-Kirkpatrick; Taylor D,9999,0,9999,0
1668184106646,CSE 293,004,119135,Christensen; Henrik I,9999,0,9999,0
1668184106646,CSE 293,005,119142,Cottrell; Garrison W,9999,0,9999,0
1668184106646,CSE 293,006,119146,Deutsch; Alin Bernard,9999,0,9999,0
1668184106646,CSE 293,007,119159,Esmaeilzadeh; Hadi,9999,0,9999,0
1668184106646,CSE 293,008,119166,Freund; Yoav,9999,0,9999,0
1668184106646,CSE 293,009,119170,Griswold; William G.,9999,0,9999,0
1668184106646,CSE 293,010,119183,Gymrek; Melissa Ann,9999,0,9999,0
1668184106646,CSE 293,011,119190,Heninger; Nadia A,9999,0,9999,0
1668184106646,CSE 293,012,119230,Impagliazzo; Russell,9999,0,9999,0
1668184106646,CSE 293,013,119232,Jhala; Ranjit,9999,0,9999,0
1668184106646,CSE 293,014,119233,Kahng; Andrew Byun,9999,0,9999,0
1668184106646,CSE 293,015,119298,Kane; Daniel Mertz,9999,0,9999,0
1668184106646,CSE 293,016,119299,Kriegman; David J,9999,0,9999,0
1668184106646,CSE 293,017,119300,Kumar; Arun Kumar,9999,0,9999,0
1668184106646,CSE 293,018,119301,Lerner; Sorin,9999,0,9999,0
1668184106646,CSE 293,019,119302,Lovett; Shachar,9999,0,9999,0
1668184106646,CSE 293,020,119303,McAuley; Julian John,9999,0,9999,0
1668184106646,CSE 293,021,119304,Micciancio; Daniele,9999,0,9999,0
1668184106646,CSE 293,022,119367,Orailoglu; Alex,9999,0,9999,0
1668184106646,CSE 293,023,119382,Paturi; Ramamohan,9999,0,9999,0
1668184106646,CSE 293,024,119404,Polikarpova; Nadezhda,9999,0,9999,0
1668184106646,CSE 293,025,119406,Politz; Joseph Gibbs,9999,0,9999,0
1668184106646,CSE 293,026,119411,Porter; George M,9999,0,9999,0
1668184106646,CSE 293,027,119414,Porter; Leonard Emerson,9999,0,9999,0
1668184106646,CSE 293,028,119416,Ramamoorthi; Ravi,9999,0,9999,0
1668184106646,CSE 293,029,119417,Sahoo; Debashis,9999,0,9999,0
1668184106646,CSE 293,030,119420,Saul; Lawrence,9999,0,9999,0
1668184106646,CSE 293,031,119421,Savage; Stefan,9999,0,9999,0
1668184106646,CSE 293,032,119425,Schulze; Jurgen P.,9999,0,9999,0
1668184106646,CSE 293,033,119426,Snoeren; Alex C.,9999,0,9999,0
1668184106646,CSE 293,034,119428,Shang; Jingbo,9999,0,9999,0
1668184106646,CSE 293,035,119430,Stefan; Deian,9999,0,9999,0
1668184106646,CSE 293,036,119431,Su; Hao,9999,0,9999,0
1668184106646,CSE 293,037,119433,Swanson; Steven James,9999,0,9999,0
1668184106646,CSE 293,038,119435,Tullsen; Dean Michael,9999,0,9999,0
1668184106646,CSE 293,039,119483,Voelker; Geoffrey M.,9999,0,9999,0
1668184106646,CSE 293,040,119537,Zhao; Jishen,9999,0,9999,0
1668184106646,CSE 293,041,119538,Zhou; Yuan-Yuan,9999,0,9999,0
1668184106646,CSE 293,042,119539,Gao; Sicun,9999,0,9999,0
1668184106646,CSE 293,043,119540,Weibel; Nadir,9999,0,9999,0
1668184106646,CSE 293,044,119541,Gupta; Rajesh K.,9999,0,9999,0
1668184106646,CSE 293,045,126410,Vaccaro; Kristen Marie,9999,0,9999,0
1668184106646,CSE 293,046,126411,Klemke; Richard,9999,0,9999,0
1668184107076,CSE 294,A00,102459,Voelker; Geoffrey M.,0,0,0,0
1668184107076,CSE 294,B00,111322,Orailoglu; Alex,0,0,0,0
1668184107503,DSE 201,A00,096914,Deutsch; Alin Bernard,30,0,30,0
1668184107927,DSE 210,A00,096915,Dasgupta; Sanjoy,30,0,30,0
1668184108353,DSE 260A,A00,096916,Altintas De Callaf; Ilkay,30,0,30,0
1668184108821,ECE 200,001,103586,Antipa; Nicholas A,9999,0,9999,0
1668184108821,ECE 200,002,103587,Atanasov; Nikolay A.,9999,0,9999,0
1668184108821,ECE 200,003,103588,Bharadia; Dinesh,9999,0,9999,0
1668184108821,ECE 200,004,103589,Cheng; Chung Kuan,9999,0,9999,0
1668184108821,ECE 200,005,103590,Cosman; Pamela C.,9999,0,9999,0
1668184108821,ECE 200,006,103591,Dayeh; Shadi Ahmad,9999,0,9999,0
1668184108821,ECE 200,007,103592,Fainman; Yeshaiahu,9999,0,9999,0
1668184108821,ECE 200,008,103593,Ford; Joseph Earl,9999,0,9999,0
1668184108821,ECE 200,009,103594,Franceschetti; Massimo,9999,0,9999,0
1668184108821,ECE 200,010,103595,Fullerton; Eric E,9999,0,9999,0
1668184108821,ECE 200,011,103596,Galton; Ian A,9999,0,9999,0
1668184108821,ECE 200,012,103597,Gilja; Vikash,9999,0,9999,0
1668184108821,ECE 200,013,103598,Hall; Drew A.,9999,0,9999,0
1668184108821,ECE 200,014,103599,Hsueh; Tzu-Chien,9999,0,9999,0
1668184108821,ECE 200,015,103600,Javidi; Tara,9999,0,9999,0
1668184108821,ECE 200,016,103601,Kahng; Andrew Byun,9999,0,9999,0
1668184108821,ECE 200,017,103602,Kim; Young-Han,9999,0,9999,0
1668184108821,ECE 200,018,103603,Koushanfar; Farinaz,9999,0,9999,0
1668184108821,ECE 200,019,103604,Kuzum; Duygu,9999,0,9999,0
1668184108821,ECE 200,020,103605,Le; Hanh-Phuc,9999,0,9999,0
1668184108821,ECE 200,021,103606,Lin; Bill,9999,0,9999,0
1668184108821,ECE 200,022,103607,Liu; Zhaowei,9998,0,9999,1
1668184108821,ECE 200,023,103608,Lo; Yu-Hwa,9999,0,9999,0
1668184108821,ECE 200,024,103609,Lomakin; Vitaliy,9999,0,9999,0
1668184108821,ECE 200,025,103610,Mercier; Patrick Philip,9999,0,9999,0
1668184108821,ECE 200,026,103611,Meyer; Florian,9999,0,9999,0
1668184108821,ECE 200,027,103612,Milstein; Laurence B.,9999,0,9999,0
1668184108821,ECE 200,028,103613,Mir Arabbaygi; Siavash,9999,0,9999,0
1668184108821,ECE 200,029,103614,Mookherjea; Shayan,9999,0,9999,0
1668184108821,ECE 200,030,103615,Morris; Karcher William,9999,0,9999,0
1668184108821,ECE 200,031,103616,Ng; Tse Nga,9999,0,9999,0
1668184108821,ECE 200,032,103617,Nguyen; Truong Quang,9999,0,9999,0
1668184108821,ECE 200,033,103618,Nomura; Kenji,9999,0,9999,0
1668184108821,ECE 200,034,103619,Orlitsky; Alon,9999,0,9999,0
1668184108821,ECE 200,035,103620,Pal; Piya,9999,0,9999,0
1668184108821,ECE 200,036,103621,Papen; George C.,9999,0,9999,0
1668184108821,ECE 200,037,103622,Radic; Stojan,9999,0,9999,0
1668184108821,ECE 200,038,103623,Rao; Bhaskar D.,9999,0,9999,0
1668184108821,ECE 200,039,103624,Rao; Ramesh R,9999,0,9999,0
1668184108821,ECE 200,040,103625,Rebeiz; Gabriel,9999,0,9999,0
1668184108821,ECE 200,041,103626,Sanford; John R,9999,0,9999,0
1668184108821,ECE 200,042,103627,Siegel; Paul H.,9999,0,9999,0
1668184108821,ECE 200,043,103628,Sievenpiper; Daniel F.,9999,0,9999,0
1668184108821,ECE 200,044,103629,Sworder; David D.,9999,0,9999,0
1668184108821,ECE 200,045,103630,Taur; Yuan,9999,0,9999,0
1668184108821,ECE 200,046,103631,Touri; Behrouz,9999,0,9999,0
1668184108821,ECE 200,047,103632,Trivedi; Mohan M.,9999,0,9999,0
1668184108821,ECE 200,048,103633,Vasconcelos; Nuno,9999,0,9999,0
1668184108821,ECE 200,049,103634,Wang; Xiaolong,9999,0,9999,0
1668184108821,ECE 200,050,103635,Xie; Pengtao,9999,0,9999,0
1668184108821,ECE 200,051,103636,Yip; Michael,9999,0,9999,0
1668184108821,ECE 200,052,103637,Zeger; Kenneth A.,999,0,999,0
1668184108821,ECE 200,053,103638,Zhang; Xinyu,9999,0,9999,0
1668184108821,ECE 200,054,103639,Turakhia; Yatish Girish,9999,0,9999,0
1668184108821,ECE 200,055,103640,Kang; Mingu,9999,0,9999,0
1668184108821,ECE 200,056,103641,Shi; Yuanyuan,9999,0,9999,0
1668184108821,ECE 200,057,103642,Wang; Edward Jay,9999,0,9999,0
1668184108821,ECE 200,058,103643,Zheng; Yang,9999,0,9999,0
1668184109244,ECE 202,A00,103644,Kuzum; Duygu,0,0,0,0
1668184109672,ECE 212BN,A00,103646,Ng; Tse Nga,0,0,0,0
1668184110095,ECE 221,A00,111493,Staff,0,0,0,0
1668184110521,ECE 222B,A00,103647,Lomakin; Vitaliy,0,0,0,0
1668184110950,ECE 230B,A00,103648,Taur; Yuan,0,0,0,0
1668184111394,ECE 238B,A00,103649,Garay; Javier,0,0,0,0
1668184111899,ECE 240B,A00,112900,Fainman; Yeshaiahu,0,0,0,0
1668184112322,ECE 247A,A00,103650,Jokerst; Jesse Vincent,0,0,0,0
1668184112759,ECE 247B,A00,103651,Wang; Joseph,0,0,0,0
1668184113183,ECE 250,A00,103652,Siegel; Paul H.,0,0,0,0
1668184113609,ECE 251A,A00,103654,Rao; Bhaskar D.,0,0,0,0
1668184114031,ECE 257B,A00,103655,Bharadia; Dinesh,0,0,0,0
1668184114466,ECE 258A,A00,103656,Milstein; Laurence B.,0,0,0,0
1668184114893,ECE 260B,A00,103658,Kang; Mingu,0,0,0,0
1668184115321,ECE 264A,A00,103659,Galton; Ian A,0,0,0,0
1668184115744,ECE 265A,A00,103661,Gudem; Prasad S.S.,0,0,0,0
1668184116169,ECE 265D,A00,103662,Gudem; Prasad S.S.,0,0,0,0
1668184116596,ECE 268,A00,103663,Koushanfar; Farinaz,0,0,0,0
1668184117024,ECE 269,A01,103665,Pal; Piya,0,0,0,0
1668184117447,ECE 271B,A00,103666,Vasconcelos; Manuela,0,0,0,0
1668184117883,ECE 276A,A00,103667,Atanasov; Nikolay A.,0,0,0,0
1668184118307,ECE 277,A00,103668,An; Cheolhong,0,0,0,0
1668184118737,ECE 279,A00,117947,Hall; Drew A.,0,0,0,0
1668184119585,ECE 283,A00,103670,Hsueh; Tzu-Chien,0,0,0,0
1668184120008,ECE 284,A00,103671,Turakhia; Yatish Girish,0,0,0,0
1668184120437,ECE 285,A00,103672,Zheng; Yang,0,0,0,0
1668184120437,ECE 285,B00,103673,Sworder; David D.,0,0,0,0
1668184120860,ECE 287,A00,103676,Javidi; Tara,0,0,0,0
1668184121286,MATH 200B,A00,098023,Salehi Golsefidy; Alireza,12,0,15,3
1668184121711,MATH 202B,A00,098024,Rhoades; Brendon Patrick,9,0,15,6
1668184122138,MATH 203B,A00,098025,Oprea; Dragos N.,10,0,15,5
1668184122575,MATH 204B,A00,098026,Sorensen; Claus M,13,0,15,2
1668184122999,MATH 208,A00,098027,Izadi; Elham,7,0,10,3
1668184123436,MATH 209,A00,098028,Pollack; Aaron,10,0,10,0
1668184123881,MATH 211A,A00,112919,Rogalski; Daniel,9,0,10,1
1668184124305,MATH 211B,A00,112920,Seward; Brandon M.,9,0,10,1
1668184124730,MATH 218,A00,098029,Li; Bo,10,0,10,0
1668184125157,MATH 220B,A00,098030,Novak; Jonathan I,11,0,15,4
1668184125580,MATH 221A,A00,098031,Ebenfelt; Peter F,13,0,15,2
1668184126003,MATH 231B,A00,098032,Zlatos; Andrej,12,0,15,3
1668184126427,MATH 240B,A00,098033,Ni; Lei,9,0,15,6
1668184126852,MATH 243,A00,098034,Jekel; David Andrew,10,0,10,0
1668184127280,MATH 245A,A00,098035,Nie; Jiawang,0,0,15,16
1668184127704,MATH 248,A00,098036,Bejenaru; Ioan,10,0,10,0
1668184128128,MATH 250B,A00,098037,Spolaor; Luca,14,0,15,1
1668184128551,MATH 258,A00,098038,Ni; Lei,10,0,10,0
1668184128985,MATH 264B,A00,098041,Rhoades; Brendon Patrick,9,0,15,6
1668184129409,MATH 268,A00,098042,Buss; Samuel R,10,0,10,0
1668184129839,MATH 269,A00,098043,Rhoades; Brendon Patrick,10,0,10,0
1668184130264,MATH 270B,A00,098044,Li; Bo,10,0,15,5
1668184130688,MATH 272B,A00,098045,Holst; Michael J,13,0,15,2
1668184131119,MATH 273A,A00,098046,Tian; Xiaochuan,10,0,15,5
1668184131542,MATH 275,A01,098048,Tian; Xiaochuan,6,0,10,4
1668184131974,MATH 278A,A00,098049,Holst; Michael J,8,0,10,2
1668184132407,MATH 278B,A00,098050,Cloninger; Alexander,10,0,10,0
1668184132835,MATH 278C,A00,098051,Nie; Jiawang,7,0,10,3
1668184133259,MATH 280B,A00,098052,Zheng; Tianyi,10,0,15,5
1668184133686,MATH 281B,A00,098053,Bradic; Jelena,2,0,15,13
1668184134123,MATH 282B,A00,098054,Arias-Castro; Ery,0,0,15,15
1668184134554,MATH 285,A00,098055,Fitzsimmons; Patrick J,0,0,15,17
1668184134990,MATH 287B,A00,098056,Arias-Castro; Ery,2,0,15,13
1668184135417,MATH 288,A00,098057,Agarwal; Pooja,9,0,10,1
1668184135417,MATH 288,B00,098058,Zhang; Danna,8,0,10,2
1668184135417,MATH 288,C00,098059,Williams; Ruth J,10,0,10,0
1668184135845,MATH 290B,A00,098060,Roberts; Justin Deritter,13,0,15,2
1668184136278,MATH 292,A00,098061,Belmont; Eva Kinoshita,10,0,10,0
1668184136711,MATH 295,A00,098062,Suk; Andrew Hoon,48,0,50,2
1668184137135,MATH 296,A00,098063,Novak; Jonathan I,20,0,20,0
1668184137563,MATH 297,001,098064,Gamst; Anthony Collins,9997,0,9999,2
1668184639834,COGS 205,A00,101395,Chiba; Andrea,19,0,20,1
1668184640267,COGS 210B,001,101404,Greene; Deanna Jacquelyn,9998,0,9999,1
1668184640267,COGS 210B,002,101417,Xia; Haijun,9999,0,9999,0
1668184640267,COGS 210B,003,101422,Nitz; Douglas A.,9999,0,9999,0
1668184640267,COGS 210B,004,101423,Hollan; James D.,9998,0,9999,1
1668184640267,COGS 210B,005,101424,Deak; Gedeon O.,9998,0,9999,1
1668184640267,COGS 210B,006,101425,Rossano; Federico,9999,0,9999,0
1668184640695,COGS 211B,A00,101427,Coulson; Seana M,9996,0,9999,3
1668184641126,COGS 220,A00,101428,Hollan; James D.,0,0,25,25
1668184641557,COGS 229,A00,101429,Dow; Steven P,18,0,25,7
1668184641981,COGS 230,A00,101430,Klemmer; Scott R,12,0,17,5
1668184642408,COGS 234,A00,101431,Xia; Haijun,3,0,25,22
1668184642833,COGS 260,A00,101432,Kiyonaga; Anastasia,20,0,25,5
1668184642833,COGS 260,B00,101433,Kirsh; David Joel,16,0,25,9
1668184643268,CSE 202,A00,102371,Impagliazzo; Russell,0,0,0,0
1668184643698,CSE 203B,A01,102373,Cheng; Chung Kuan,0,0,0,0
1668184644126,CSE 208,A00,102374,Micciancio; Daniele,0,0,0,0
1668184644552,CSE 209A,A00,112895,Impagliazzo; Russell,0,0,15,15
1668184644978,CSE 209B,A00,108005,Bellare; Mihir,0,0,0,0
1668184645402,CSE 210,A00,113163,Coblenz; Michael J,0,0,0,0
1668184645829,CSE 219,A00,106111,Dow; Steven P,0,0,20,20
1668184646254,CSE 221,A00,102376,Voelker; Geoffrey M.,0,0,0,0
1668184646677,CSE 224,A01,102378,Porter; George M,0,0,0,0
1668184647105,CSE 229A,A00,102379,Savage; Stefan,0,0,0,0
1668184647529,CSE 229C,A00,102380,Munyaka; Imani N. S.,0,0,0,0
1668184647959,CSE 232B,A00,102382,Deutsch; Alin Bernard,0,0,0,0
1668184648383,CSE 234,A01,112904,Kumar; Arun Kumar,0,0,0,0
1668184648807,CSE 237A,A00,102383,Rosing; Tajana Simunic,0,0,0,0
1668184649233,CSE 239A,A00,102384,Deutsch; Alin Bernard,0,0,0,0
1668184649665,CSE 239B,A00,102385,Polikarpova; Nadezhda,0,0,0,0
1668184650094,CSE 240A,A00,102386,Pannuto; Patrick William,0,0,0,0
1668184650526,CSE 240B,A00,102387,Zhao; Jishen,0,0,0,0
1668184650948,CSE 241A,A00,106406,Kang; Mingu,0,0,0,0
1668184651370,CSE 249B,A00,102388,Kahng; Andrew Byun,0,0,8,8
1668184651795,CSE 251B,A01,102392,Cottrell; Garrison W,0,0,0,0
1668184651795,CSE 251B,A02,102393,Cottrell; Garrison W,0,0,0,0
1668184652222,CSE 252B,A00,102394,Ochoa; Benjamin Lawrence,0,0,0,0
1668184652646,CSE 257,A01,102396,Gao; Sicun,0,0,0,0
1668184653071,CSE 272,A00,102397,Li; Tzumao,0,0,0,0
1668184653494,CSE 274,A00,111323,Chern; Albert Ren-Haur,0,0,0,0
1668184653924,CSE 282,A00,102398,Pevzner; Pavel Arkadjevich,0,0,0,0
1668184654349,CSE 284,A00,114175,Gymrek; Melissa Ann,0,0,0,0
1668184654774,CSE 290,A00,102399,Chandraker; Manmohan Krishna,0,0,0,0
1668184654774,CSE 290,B00,102400,Vaccaro; Kristen Marie,0,0,25,25
1668184654774,CSE 290,C00,102414,Pannuto; Patrick William,0,0,25,25
1668184654774,CSE 290,D00,102427,Pevzner; Pavel Arkadjevich,0,0,0,0
1668184654774,CSE 290,E00,102429,Zhao; Jishen,0,0,0,0
1668184654774,CSE 290,F00,102436,Tullsen; Dean Michael,0,0,0,0
1668184654774,CSE 290,G00,102440,Christensen; Henrik I,0,0,20,20
1668184655214,CSE 291,A00,102443,Su; Hao,0,0,0,0
1668184655214,CSE 291,B00,102448,Polikarpova; Nadezhda,0,0,0,0
1668184655214,CSE 291,C00,102453,Vaccaro; Kristen Marie,0,0,0,0
1668184655214,CSE 291,D00,111343,Savage; Stefan,0,0,0,0
1668184655214,CSE 291,E00,116474,Claffy; Kimberly Claire,0,0,0,0
1668184655214,CSE 291,F00,116479,Pasquale; Joseph,0,0,0,0
1668184655652,CSE 293,001,119111,Bafna; Vineet,9999,0,9999,0
1668184655652,CSE 293,002,119118,Bellare; Mihir,9999,0,9999,0
1668184655652,CSE 293,003,119122,Berg-Kirkpatrick; Taylor D,9999,0,9999,0
1668184655652,CSE 293,004,119135,Christensen; Henrik I,9999,0,9999,0
1668184655652,CSE 293,005,119142,Cottrell; Garrison W,9999,0,9999,0
1668184655652,CSE 293,006,119146,Deutsch; Alin Bernard,9999,0,9999,0
1668184655652,CSE 293,007,119159,Esmaeilzadeh; Hadi,9999,0,9999,0
1668184655652,CSE 293,008,119166,Freund; Yoav,9999,0,9999,0
1668184655652,CSE 293,009,119170,Griswold; William G.,9999,0,9999,0
1668184655652,CSE 293,010,119183,Gymrek; Melissa Ann,9999,0,9999,0
1668184655652,CSE 293,011,119190,Heninger; Nadia A,9999,0,9999,0
1668184655652,CSE 293,012,119230,Impagliazzo; Russell,9999,0,9999,0
1668184655652,CSE 293,013,119232,Jhala; Ranjit,9999,0,9999,0
1668184655652,CSE 293,014,119233,Kahng; Andrew Byun,9999,0,9999,0
1668184655652,CSE 293,015,119298,Kane; Daniel Mertz,9999,0,9999,0
1668184655652,CSE 293,016,119299,Kriegman; David J,9999,0,9999,0
1668184655652,CSE 293,017,119300,Kumar; Arun Kumar,9999,0,9999,0
1668184655652,CSE 293,018,119301,Lerner; Sorin,9999,0,9999,0
1668184655652,CSE 293,019,119302,Lovett; Shachar,9999,0,9999,0
1668184655652,CSE 293,020,119303,McAuley; Julian John,9999,0,9999,0
1668184655652,CSE 293,021,119304,Micciancio; Daniele,9999,0,9999,0
1668184655652,CSE 293,022,119367,Orailoglu; Alex,9999,0,9999,0
1668184655652,CSE 293,023,119382,Paturi; Ramamohan,9999,0,9999,0
1668184655652,CSE 293,024,119404,Polikarpova; Nadezhda,9999,0,9999,0
1668184655652,CSE 293,025,119406,Politz; Joseph Gibbs,9999,0,9999,0
1668184655652,CSE 293,026,119411,Porter; George M,9999,0,9999,0
1668184655652,CSE 293,027,119414,Porter; Leonard Emerson,9999,0,9999,0
1668184655652,CSE 293,028,119416,Ramamoorthi; Ravi,9999,0,9999,0
1668184655652,CSE 293,029,119417,Sahoo; Debashis,9999,0,9999,0
1668184655652,CSE 293,030,119420,Saul; Lawrence,9999,0,9999,0
1668184655652,CSE 293,031,119421,Savage; Stefan,9999,0,9999,0
1668184655652,CSE 293,032,119425,Schulze; Jurgen P.,9999,0,9999,0
1668184655652,CSE 293,033,119426,Snoeren; Alex C.,9999,0,9999,0
1668184655652,CSE 293,034,119428,Shang; Jingbo,9999,0,9999,0
1668184655652,CSE 293,035,119430,Stefan; Deian,9999,0,9999,0
1668184655652,CSE 293,036,119431,Su; Hao,9999,0,9999,0
1668184655652,CSE 293,037,119433,Swanson; Steven James,9999,0,9999,0
1668184655652,CSE 293,038,119435,Tullsen; Dean Michael,9999,0,9999,0
1668184655652,CSE 293,039,119483,Voelker; Geoffrey M.,9999,0,9999,0
1668184655652,CSE 293,040,119537,Zhao; Jishen,9999,0,9999,0
1668184655652,CSE 293,041,119538,Zhou; Yuan-Yuan,9999,0,9999,0
1668184655652,CSE 293,042,119539,Gao; Sicun,9999,0,9999,0
1668184655652,CSE 293,043,119540,Weibel; Nadir,9999,0,9999,0
1668184655652,CSE 293,044,119541,Gupta; Rajesh K.,9999,0,9999,0
1668184655652,CSE 293,045,126410,Vaccaro; Kristen Marie,9999,0,9999,0
1668184655652,CSE 293,046,126411,Klemke; Richard,9999,0,9999,0
1668184656087,CSE 294,A00,102459,Voelker; Geoffrey M.,0,0,0,0
1668184656087,CSE 294,B00,111322,Orailoglu; Alex,0,0,0,0
1668184656526,DSE 201,A00,096914,Deutsch; Alin Bernard,30,0,30,0
1668184656952,DSE 210,A00,096915,Dasgupta; Sanjoy,30,0,30,0
1668184657382,DSE 260A,A00,096916,Altintas De Callaf; Ilkay,30,0,30,0
1668184657825,ECE 200,001,103586,Antipa; Nicholas A,9999,0,9999,0
1668184657825,ECE 200,002,103587,Atanasov; Nikolay A.,9999,0,9999,0
1668184657825,ECE 200,003,103588,Bharadia; Dinesh,9999,0,9999,0
1668184657825,ECE 200,004,103589,Cheng; Chung Kuan,9999,0,9999,0
1668184657825,ECE 200,005,103590,Cosman; Pamela C.,9999,0,9999,0
1668184657825,ECE 200,006,103591,Dayeh; Shadi Ahmad,9999,0,9999,0
1668184657825,ECE 200,007,103592,Fainman; Yeshaiahu,9999,0,9999,0
1668184657825,ECE 200,008,103593,Ford; Joseph Earl,9999,0,9999,0
1668184657825,ECE 200,009,103594,Franceschetti; Massimo,9999,0,9999,0
1668184657825,ECE 200,010,103595,Fullerton; Eric E,9999,0,9999,0
1668184657825,ECE 200,011,103596,Galton; Ian A,9999,0,9999,0
1668184657825,ECE 200,012,103597,Gilja; Vikash,9999,0,9999,0
1668184657825,ECE 200,013,103598,Hall; Drew A.,9999,0,9999,0
1668184657825,ECE 200,014,103599,Hsueh; Tzu-Chien,9999,0,9999,0
1668184657825,ECE 200,015,103600,Javidi; Tara,9999,0,9999,0
1668184657825,ECE 200,016,103601,Kahng; Andrew Byun,9999,0,9999,0
1668184657825,ECE 200,017,103602,Kim; Young-Han,9999,0,9999,0
1668184657825,ECE 200,018,103603,Koushanfar; Farinaz,9999,0,9999,0
1668184657825,ECE 200,019,103604,Kuzum; Duygu,9999,0,9999,0
1668184657825,ECE 200,020,103605,Le; Hanh-Phuc,9999,0,9999,0
1668184657825,ECE 200,021,103606,Lin; Bill,9999,0,9999,0
1668184657825,ECE 200,022,103607,Liu; Zhaowei,9998,0,9999,1
1668184657825,ECE 200,023,103608,Lo; Yu-Hwa,9999,0,9999,0
1668184657825,ECE 200,024,103609,Lomakin; Vitaliy,9999,0,9999,0
1668184657825,ECE 200,025,103610,Mercier; Patrick Philip,9999,0,9999,0
1668184657825,ECE 200,026,103611,Meyer; Florian,9999,0,9999,0
1668184657825,ECE 200,027,103612,Milstein; Laurence B.,9999,0,9999,0
1668184657825,ECE 200,028,103613,Mir Arabbaygi; Siavash,9999,0,9999,0
1668184657825,ECE 200,029,103614,Mookherjea; Shayan,9999,0,9999,0
1668184657825,ECE 200,030,103615,Morris; Karcher William,9999,0,9999,0
1668184657825,ECE 200,031,103616,Ng; Tse Nga,9999,0,9999,0
1668184657825,ECE 200,032,103617,Nguyen; Truong Quang,9999,0,9999,0
1668184657825,ECE 200,033,103618,Nomura; Kenji,9999,0,9999,0
1668184657825,ECE 200,034,103619,Orlitsky; Alon,9999,0,9999,0
1668184657825,ECE 200,035,103620,Pal; Piya,9999,0,9999,0
1668184657825,ECE 200,036,103621,Papen; George C.,9999,0,9999,0
1668184657825,ECE 200,037,103622,Radic; Stojan,9999,0,9999,0
1668184657825,ECE 200,038,103623,Rao; Bhaskar D.,9999,0,9999,0
1668184657825,ECE 200,039,103624,Rao; Ramesh R,9999,0,9999,0
1668184657825,ECE 200,040,103625,Rebeiz; Gabriel,9999,0,9999,0
1668184657825,ECE 200,041,103626,Sanford; John R,9999,0,9999,0
1668184657825,ECE 200,042,103627,Siegel; Paul H.,9999,0,9999,0
1668184657825,ECE 200,043,103628,Sievenpiper; Daniel F.,9999,0,9999,0
1668184657825,ECE 200,044,103629,Sworder; David D.,9999,0,9999,0
1668184657825,ECE 200,045,103630,Taur; Yuan,9999,0,9999,0
1668184657825,ECE 200,046,103631,Touri; Behrouz,9999,0,9999,0
1668184657825,ECE 200,047,103632,Trivedi; Mohan M.,9999,0,9999,0
1668184657825,ECE 200,048,103633,Vasconcelos; Nuno,9999,0,9999,0
1668184657825,ECE 200,049,103634,Wang; Xiaolong,9999,0,9999,0
1668184657825,ECE 200,050,103635,Xie; Pengtao,9999,0,9999,0
1668184657825,ECE 200,051,103636,Yip; Michael,9999,0,9999,0
1668184657825,ECE 200,052,103637,Zeger; Kenneth A.,999,0,999,0
1668184657825,ECE 200,053,103638,Zhang; Xinyu,9999,0,9999,0
1668184657825,ECE 200,054,103639,Turakhia; Yatish Girish,9999,0,9999,0
1668184657825,ECE 200,055,103640,Kang; Mingu,9999,0,9999,0
1668184657825,ECE 200,056,103641,Shi; Yuanyuan,9999,0,9999,0
1668184657825,ECE 200,057,103642,Wang; Edward Jay,9999,0,9999,0
1668184657825,ECE 200,058,103643,Zheng; Yang,9999,0,9999,0
1668184658258,ECE 202,A00,103644,Kuzum; Duygu,0,0,0,0
1668184658684,ECE 212BN,A00,103646,Ng; Tse Nga,0,0,0,0
1668184659106,ECE 221,A00,111493,Staff,0,0,0,0
1668184659531,ECE 222B,A00,103647,Lomakin; Vitaliy,0,0,0,0
1668184659956,ECE 230B,A00,103648,Taur; Yuan,0,0,0,0
1668184660382,ECE 238B,A00,103649,Garay; Javier,0,0,0,0
1668184660805,ECE 240B,A00,112900,Fainman; Yeshaiahu,0,0,0,0
1668184661237,ECE 247A,A00,103650,Jokerst; Jesse Vincent,0,0,0,0
1668184661664,ECE 247B,A00,103651,Wang; Joseph,0,0,0,0
1668184662087,ECE 250,A00,103652,Siegel; Paul H.,0,0,0,0
1668184662512,ECE 251A,A00,103654,Rao; Bhaskar D.,0,0,0,0
1668184662941,ECE 257B,A00,103655,Bharadia; Dinesh,0,0,0,0
1668184663377,ECE 258A,A00,103656,Milstein; Laurence B.,0,0,0,0
1668184663830,ECE 260B,A00,103658,Kang; Mingu,0,0,0,0
1668184664255,ECE 264A,A00,103659,Galton; Ian A,0,0,0,0
1668184664679,ECE 265A,A00,103661,Gudem; Prasad S.S.,0,0,0,0
1668184665114,ECE 265D,A00,103662,Gudem; Prasad S.S.,0,0,0,0
1668184665537,ECE 268,A00,103663,Koushanfar; Farinaz,0,0,0,0
1668184665965,ECE 269,A01,103665,Pal; Piya,0,0,0,0
1668184666394,ECE 271B,A00,103666,Vasconcelos; Manuela,0,0,0,0
1668184666821,ECE 276A,A00,103667,Atanasov; Nikolay A.,0,0,0,0
1668184667246,ECE 277,A00,103668,An; Cheolhong,0,0,0,0
1668184667671,ECE 279,A00,117947,Hall; Drew A.,0,0,0,0
1668184668522,ECE 283,A00,103670,Hsueh; Tzu-Chien,0,0,0,0
1668184668955,ECE 284,A00,103671,Turakhia; Yatish Girish,0,0,0,0
1668184669384,ECE 285,A00,103672,Zheng; Yang,0,0,0,0
1668184669384,ECE 285,B00,103673,Sworder; David D.,0,0,0,0
1668184669811,ECE 287,A00,103676,Javidi; Tara,0,0,0,0
1668184670235,MATH 200B,A00,098023,Salehi Golsefidy; Alireza,12,0,15,3
1668184670665,MATH 202B,A00,098024,Rhoades; Brendon Patrick,9,0,15,6
1668184671092,MATH 203B,A00,098025,Oprea; Dragos N.,10,0,15,5
1668184671515,MATH 204B,A00,098026,Sorensen; Claus M,13,0,15,2
1668184671939,MATH 208,A00,098027,Izadi; Elham,7,0,10,3
1668184672364,MATH 209,A00,098028,Pollack; Aaron,10,0,10,0
1668184672790,MATH 211A,A00,112919,Rogalski; Daniel,9,0,10,1
1668184673212,MATH 211B,A00,112920,Seward; Brandon M.,9,0,10,1
1668184673641,MATH 218,A00,098029,Li; Bo,10,0,10,0
1668184674077,MATH 220B,A00,098030,Novak; Jonathan I,11,0,15,4
1668184674503,MATH 221A,A00,098031,Ebenfelt; Peter F,13,0,15,2
1668184674928,MATH 231B,A00,098032,Zlatos; Andrej,12,0,15,3
1668184675355,MATH 240B,A00,098033,Ni; Lei,9,0,15,6
1668184675779,MATH 243,A00,098034,Jekel; David Andrew,10,0,10,0
1668184676207,MATH 245A,A00,098035,Nie; Jiawang,0,0,15,16
1668184676631,MATH 248,A00,098036,Bejenaru; Ioan,10,0,10,0
1668184677057,MATH 250B,A00,098037,Spolaor; Luca,14,0,15,1
1668184677592,MATH 258,A00,098038,Ni; Lei,10,0,10,0
1668184678014,MATH 264B,A00,098041,Rhoades; Brendon Patrick,9,0,15,6
1668184678443,MATH 268,A00,098042,Buss; Samuel R,10,0,10,0
1668184678873,MATH 269,A00,098043,Rhoades; Brendon Patrick,10,0,10,0
1668184679302,MATH 270B,A00,098044,Li; Bo,10,0,15,5
1668184679731,MATH 272B,A00,098045,Holst; Michael J,13,0,15,2
1668184680160,MATH 273A,A00,098046,Tian; Xiaochuan,10,0,15,5
1668184680596,MATH 275,A01,098048,Tian; Xiaochuan,6,0,10,4
1668184681024,MATH 278A,A00,098049,Holst; Michael J,8,0,10,2
1668184681461,MATH 278B,A00,098050,Cloninger; Alexander,10,0,10,0
1668184681893,MATH 278C,A00,098051,Nie; Jiawang,7,0,10,3
1668184682317,MATH 280B,A00,098052,Zheng; Tianyi,10,0,15,5
1668184682744,MATH 281B,A00,098053,Bradic; Jelena,2,0,15,13
1668184683169,MATH 282B,A00,098054,Arias-Castro; Ery,0,0,15,15
1668184683599,MATH 285,A00,098055,Fitzsimmons; Patrick J,0,0,15,17
1668184684032,MATH 287B,A00,098056,Arias-Castro; Ery,2,0,15,13
1668184684461,MATH 288,A00,098057,Agarwal; Pooja,9,0,10,1
1668184684461,MATH 288,B00,098058,Zhang; Danna,8,0,10,2
1668184684461,MATH 288,C00,098059,Williams; Ruth J,10,0,10,0
1668184684892,MATH 290B,A00,098060,Roberts; Justin Deritter,13,0,15,2
1668184685316,MATH 292,A00,098061,Belmont; Eva Kinoshita,10,0,10,0
1668184685742,MATH 295,A00,098062,Suk; Andrew Hoon,48,0,50,2
1668184686167,MATH 296,A00,098063,Novak; Jonathan I,20,0,20,0
1668184686592,MATH 297,001,098064,Gamst; Anthony Collins,9997,0,9999,2
1668185188673,COGS 205,A00,101395,Chiba; Andrea,19,0,20,1
1668185189097,COGS 210B,001,101404,Greene; Deanna Jacquelyn,9998,0,9999,1
1668185189097,COGS 210B,002,101417,Xia; Haijun,9999,0,9999,0
1668185189097,COGS 210B,003,101422,Nitz; Douglas A.,9999,0,9999,0
1668185189097,COGS 210B,004,101423,Hollan; James D.,9998,0,9999,1
1668185189097,COGS 210B,005,101424,Deak; Gedeon O.,9998,0,9999,1
1668185189097,COGS 210B,006,101425,Rossano; Federico,9999,0,9999,0
1668185189532,COGS 211B,A00,101427,Coulson; Seana M,9996,0,9999,3
1668185189965,COGS 220,A00,101428,Hollan; James D.,0,0,25,25
1668185190402,COGS 229,A00,101429,Dow; Steven P,18,0,25,7
1668185190828,COGS 230,A00,101430,Klemmer; Scott R,12,0,17,5
1668185191253,COGS 234,A00,101431,Xia; Haijun,3,0,25,22
1668185191680,COGS 260,A00,101432,Kiyonaga; Anastasia,20,0,25,5
1668185191680,COGS 260,B00,101433,Kirsh; David Joel,16,0,25,9
1668185192106,CSE 202,A00,102371,Impagliazzo; Russell,0,0,0,0
1668185192530,CSE 203B,A01,102373,Cheng; Chung Kuan,0,0,0,0
1668185192957,CSE 208,A00,102374,Micciancio; Daniele,0,0,0,0
1668185193390,CSE 209A,A00,112895,Impagliazzo; Russell,0,0,15,15
1668185193816,CSE 209B,A00,108005,Bellare; Mihir,0,0,0,0
1668185194245,CSE 210,A00,113163,Coblenz; Michael J,0,0,0,0
1668185194672,CSE 219,A00,106111,Dow; Steven P,0,0,20,20
1668185195096,CSE 221,A00,102376,Voelker; Geoffrey M.,0,0,0,0
1668185195525,CSE 224,A01,102378,Porter; George M,0,0,0,0
1668185195950,CSE 229A,A00,102379,Savage; Stefan,0,0,0,0
1668185196378,CSE 229C,A00,102380,Munyaka; Imani N. S.,0,0,0,0
1668185196803,CSE 232B,A00,102382,Deutsch; Alin Bernard,0,0,0,0
1668185197233,CSE 234,A01,112904,Kumar; Arun Kumar,0,0,0,0
1668185197660,CSE 237A,A00,102383,Rosing; Tajana Simunic,0,0,0,0
1668185198087,CSE 239A,A00,102384,Deutsch; Alin Bernard,0,0,0,0
1668185198520,CSE 239B,A00,102385,Polikarpova; Nadezhda,0,0,0,0
1668185198951,CSE 240A,A00,102386,Pannuto; Patrick William,0,0,0,0
1668185199383,CSE 240B,A00,102387,Zhao; Jishen,0,0,0,0
1668185200012,CSE 241A,A00,106406,Kang; Mingu,0,0,0,0
1668185200440,CSE 249B,A00,102388,Kahng; Andrew Byun,0,0,8,8
1668185200867,CSE 251B,A01,102392,Cottrell; Garrison W,0,0,0,0
1668185200867,CSE 251B,A02,102393,Cottrell; Garrison W,0,0,0,0
1668185201292,CSE 252B,A00,102394,Ochoa; Benjamin Lawrence,0,0,0,0
1668185201728,CSE 257,A01,102396,Gao; Sicun,0,0,0,0
1668185202154,CSE 272,A00,102397,Li; Tzumao,0,0,0,0
1668185202578,CSE 274,A00,111323,Chern; Albert Ren-Haur,0,0,0,0
1668185203001,CSE 282,A00,102398,Pevzner; Pavel Arkadjevich,0,0,0,0
1668185203424,CSE 284,A00,114175,Gymrek; Melissa Ann,0,0,0,0
1668185203849,CSE 290,A00,102399,Chandraker; Manmohan Krishna,0,0,0,0
1668185203849,CSE 290,B00,102400,Vaccaro; Kristen Marie,0,0,25,25
1668185203849,CSE 290,C00,102414,Pannuto; Patrick William,0,0,25,25
1668185203849,CSE 290,D00,102427,Pevzner; Pavel Arkadjevich,0,0,0,0
1668185203849,CSE 290,E00,102429,Zhao; Jishen,0,0,0,0
1668185203849,CSE 290,F00,102436,Tullsen; Dean Michael,0,0,0,0
1668185203849,CSE 290,G00,102440,Christensen; Henrik I,0,0,20,20
1668185204280,CSE 291,A00,102443,Su; Hao,0,0,0,0
1668185204280,CSE 291,B00,102448,Polikarpova; Nadezhda,0,0,0,0
1668185204280,CSE 291,C00,102453,Vaccaro; Kristen Marie,0,0,0,0
1668185204280,CSE 291,D00,111343,Savage; Stefan,0,0,0,0
1668185204280,CSE 291,E00,116474,Claffy; Kimberly Claire,0,0,0,0
1668185204280,CSE 291,F00,116479,Pasquale; Joseph,0,0,0,0
1668185204725,CSE 293,001,119111,Bafna; Vineet,9999,0,9999,0
1668185204725,CSE 293,002,119118,Bellare; Mihir,9999,0,9999,0
1668185204725,CSE 293,003,119122,Berg-Kirkpatrick; Taylor D,9999,0,9999,0
1668185204725,CSE 293,004,119135,Christensen; Henrik I,9999,0,9999,0
1668185204725,CSE 293,005,119142,Cottrell; Garrison W,9999,0,9999,0
1668185204725,CSE 293,006,119146,Deutsch; Alin Bernard,9999,0,9999,0
1668185204725,CSE 293,007,119159,Esmaeilzadeh; Hadi,9999,0,9999,0
1668185204725,CSE 293,008,119166,Freund; Yoav,9999,0,9999,0
1668185204725,CSE 293,009,119170,Griswold; William G.,9999,0,9999,0
1668185204725,CSE 293,010,119183,Gymrek; Melissa Ann,9999,0,9999,0
1668185204725,CSE 293,011,119190,Heninger; Nadia A,9999,0,9999,0
1668185204725,CSE 293,012,119230,Impagliazzo; Russell,9999,0,9999,0
1668185204725,CSE 293,013,119232,Jhala; Ranjit,9999,0,9999,0
1668185204725,CSE 293,014,119233,Kahng; Andrew Byun,9999,0,9999,0
1668185204725,CSE 293,015,119298,Kane; Daniel Mertz,9999,0,9999,0
1668185204725,CSE 293,016,119299,Kriegman; David J,9999,0,9999,0
1668185204725,CSE 293,017,119300,Kumar; Arun Kumar,9999,0,9999,0
1668185204725,CSE 293,018,119301,Lerner; Sorin,9999,0,9999,0
1668185204725,CSE 293,019,119302,Lovett; Shachar,9999,0,9999,0
1668185204725,CSE 293,020,119303,McAuley; Julian John,9999,0,9999,0
1668185204725,CSE 293,021,119304,Micciancio; Daniele,9999,0,9999,0
1668185204725,CSE 293,022,119367,Orailoglu; Alex,9999,0,9999,0
1668185204725,CSE 293,023,119382,Paturi; Ramamohan,9999,0,9999,0
1668185204725,CSE 293,024,119404,Polikarpova; Nadezhda,9999,0,9999,0
1668185204725,CSE 293,025,119406,Politz; Joseph Gibbs,9999,0,9999,0
1668185204725,CSE 293,026,119411,Porter; George M,9999,0,9999,0
1668185204725,CSE 293,027,119414,Porter; Leonard Emerson,9999,0,9999,0
1668185204725,CSE 293,028,119416,Ramamoorthi; Ravi,9999,0,9999,0
1668185204725,CSE 293,029,119417,Sahoo; Debashis,9999,0,9999,0
1668185204725,CSE 293,030,119420,Saul; Lawrence,9999,0,9999,0
1668185204725,CSE 293,031,119421,Savage; Stefan,9999,0,9999,0
1668185204725,CSE 293,032,119425,Schulze; Jurgen P.,9999,0,9999,0
1668185204725,CSE 293,033,119426,Snoeren; Alex C.,9999,0,9999,0
1668185204725,CSE 293,034,119428,Shang; Jingbo,9999,0,9999,0
1668185204725,CSE 293,035,119430,Stefan; Deian,9999,0,9999,0
1668185204725,CSE 293,036,119431,Su; Hao,9999,0,9999,0
1668185204725,CSE 293,037,119433,Swanson; Steven James,9999,0,9999,0
1668185204725,CSE 293,038,119435,Tullsen; Dean Michael,9999,0,9999,0
1668185204725,CSE 293,039,119483,Voelker; Geoffrey M.,9999,0,9999,0
1668185204725,CSE 293,040,119537,Zhao; Jishen,9999,0,9999,0
1668185204725,CSE 293,041,119538,Zhou; Yuan-Yuan,9999,0,9999,0
1668185204725,CSE 293,042,119539,Gao; Sicun,9999,0,9999,0
1668185204725,CSE 293,043,119540,Weibel; Nadir,9999,0,9999,0
1668185204725,CSE 293,044,119541,Gupta; Rajesh K.,9999,0,9999,0
1668185204725,CSE 293,045,126410,Vaccaro; Kristen Marie,9999,0,9999,0
1668185204725,CSE 293,046,126411,Klemke; Richard,9999,0,9999,0
1668185205161,CSE 294,A00,102459,Voelker; Geoffrey M.,0,0,0,0
1668185205161,CSE 294,B00,111322,Orailoglu; Alex,0,0,0,0
1668185205596,DSE 201,A00,096914,Deutsch; Alin Bernard,30,0,30,0
1668185206027,DSE 210,A00,096915,Dasgupta; Sanjoy,30,0,30,0
1668185206454,DSE 260A,A00,096916,Altintas De Callaf; Ilkay,30,0,30,0
1668185206900,ECE 200,001,103586,Antipa; Nicholas A,9999,0,9999,0
1668185206900,ECE 200,002,103587,Atanasov; Nikolay A.,9999,0,9999,0
1668185206900,ECE 200,003,103588,Bharadia; Dinesh,9999,0,9999,0
1668185206900,ECE 200,004,103589,Cheng; Chung Kuan,9999,0,9999,0
1668185206900,ECE 200,005,103590,Cosman; Pamela C.,9999,0,9999,0
1668185206900,ECE 200,006,103591,Dayeh; Shadi Ahmad,9999,0,9999,0
1668185206900,ECE 200,007,103592,Fainman; Yeshaiahu,9999,0,9999,0
1668185206900,ECE 200,008,103593,Ford; Joseph Earl,9999,0,9999,0
1668185206900,ECE 200,009,103594,Franceschetti; Massimo,9999,0,9999,0
1668185206900,ECE 200,010,103595,Fullerton; Eric E,9999,0,9999,0
1668185206900,ECE 200,011,103596,Galton; Ian A,9999,0,9999,0
1668185206900,ECE 200,012,103597,Gilja; Vikash,9999,0,9999,0
1668185206900,ECE 200,013,103598,Hall; Drew A.,9999,0,9999,0
1668185206900,ECE 200,014,103599,Hsueh; Tzu-Chien,9999,0,9999,0
1668185206900,ECE 200,015,103600,Javidi; Tara,9999,0,9999,0
1668185206900,ECE 200,016,103601,Kahng; Andrew Byun,9999,0,9999,0
1668185206900,ECE 200,017,103602,Kim; Young-Han,9999,0,9999,0
1668185206900,ECE 200,018,103603,Koushanfar; Farinaz,9999,0,9999,0
1668185206900,ECE 200,019,103604,Kuzum; Duygu,9999,0,9999,0
1668185206900,ECE 200,020,103605,Le; Hanh-Phuc,9999,0,9999,0
1668185206900,ECE 200,021,103606,Lin; Bill,9999,0,9999,0
1668185206900,ECE 200,022,103607,Liu; Zhaowei,9998,0,9999,1
1668185206900,ECE 200,023,103608,Lo; Yu-Hwa,9999,0,9999,0
1668185206900,ECE 200,024,103609,Lomakin; Vitaliy,9999,0,9999,0
1668185206900,ECE 200,025,103610,Mercier; Patrick Philip,9999,0,9999,0
1668185206900,ECE 200,026,103611,Meyer; Florian,9999,0,9999,0
1668185206900,ECE 200,027,103612,Milstein; Laurence B.,9999,0,9999,0
1668185206900,ECE 200,028,103613,Mir Arabbaygi; Siavash,9999,0,9999,0
1668185206900,ECE 200,029,103614,Mookherjea; Shayan,9999,0,9999,0
1668185206900,ECE 200,030,103615,Morris; Karcher William,9999,0,9999,0
1668185206900,ECE 200,031,103616,Ng; Tse Nga,9999,0,9999,0
1668185206900,ECE 200,032,103617,Nguyen; Truong Quang,9999,0,9999,0
1668185206900,ECE 200,033,103618,Nomura; Kenji,9999,0,9999,0
1668185206900,ECE 200,034,103619,Orlitsky; Alon,9999,0,9999,0
1668185206900,ECE 200,035,103620,Pal; Piya,9999,0,9999,0
1668185206900,ECE 200,036,103621,Papen; George C.,9999,0,9999,0
1668185206900,ECE 200,037,103622,Radic; Stojan,9999,0,9999,0
1668185206900,ECE 200,038,103623,Rao; Bhaskar D.,9999,0,9999,0
1668185206900,ECE 200,039,103624,Rao; Ramesh R,9999,0,9999,0
1668185206900,ECE 200,040,103625,Rebeiz; Gabriel,9999,0,9999,0
1668185206900,ECE 200,041,103626,Sanford; John R,9999,0,9999,0
1668185206900,ECE 200,042,103627,Siegel; Paul H.,9999,0,9999,0
1668185206900,ECE 200,043,103628,Sievenpiper; Daniel F.,9999,0,9999,0
1668185206900,ECE 200,044,103629,Sworder; David D.,9999,0,9999,0
1668185206900,ECE 200,045,103630,Taur; Yuan,9999,0,9999,0
1668185206900,ECE 200,046,103631,Touri; Behrouz,9999,0,9999,0
1668185206900,ECE 200,047,103632,Trivedi; Mohan M.,9999,0,9999,0
1668185206900,ECE 200,048,103633,Vasconcelos; Nuno,9999,0,9999,0
1668185206900,ECE 200,049,103634,Wang; Xiaolong,9999,0,9999,0
1668185206900,ECE 200,050,103635,Xie; Pengtao,9999,0,9999,0
1668185206900,ECE 200,051,103636,Yip; Michael,9999,0,9999,0
1668185206900,ECE 200,052,103637,Zeger; Kenneth A.,999,0,999,0
1668185206900,ECE 200,053,103638,Zhang; Xinyu,9999,0,9999,0
1668185206900,ECE 200,054,103639,Turakhia; Yatish Girish,9999,0,9999,0
1668185206900,ECE 200,055,103640,Kang; Mingu,9999,0,9999,0
1668185206900,ECE 200,056,103641,Shi; Yuanyuan,9999,0,9999,0
1668185206900,ECE 200,057,103642,Wang; Edward Jay,9999,0,9999,0
1668185206900,ECE 200,058,103643,Zheng; Yang,9999,0,9999,0
1668185207329,ECE 202,A00,103644,Kuzum; Duygu,0,0,0,0
1668185207753,ECE 212BN,A00,103646,Ng; Tse Nga,0,0,0,0
1668185208194,ECE 221,A00,111493,Staff,0,0,0,0
1668185208621,ECE 222B,A00,103647,Lomakin; Vitaliy,0,0,0,0
1668185209051,ECE 230B,A00,103648,Taur; Yuan,0,0,0,0
1668185209476,ECE 238B,A00,103649,Garay; Javier,0,0,0,0
1668185209902,ECE 240B,A00,112900,Fainman; Yeshaiahu,0,0,0,0
1668185210326,ECE 247A,A00,103650,Jokerst; Jesse Vincent,0,0,0,0
1668185210750,ECE 247B,A00,103651,Wang; Joseph,0,0,0,0
1668185211173,ECE 250,A00,103652,Siegel; Paul H.,0,0,0,0
1668185211596,ECE 251A,A00,103654,Rao; Bhaskar D.,0,0,0,0
1668185212019,ECE 257B,A00,103655,Bharadia; Dinesh,0,0,0,0
1668185212444,ECE 258A,A00,103656,Milstein; Laurence B.,0,0,0,0
1668185212872,ECE 260B,A00,103658,Kang; Mingu,0,0,0,0
1668185213294,ECE 264A,A00,103659,Galton; Ian A,0,0,0,0
1668185213717,ECE 265A,A00,103661,Gudem; Prasad S.S.,0,0,0,0
1668185214142,ECE 265D,A00,103662,Gudem; Prasad S.S.,0,0,0,0
1668185214568,ECE 268,A00,103663,Koushanfar; Farinaz,0,0,0,0
1668185214999,ECE 269,A01,103665,Pal; Piya,0,0,0,0
1668185215422,ECE 271B,A00,103666,Vasconcelos; Manuela,0,0,0,0
1668185215848,ECE 276A,A00,103667,Atanasov; Nikolay A.,0,0,0,0
1668185216285,ECE 277,A00,103668,An; Cheolhong,0,0,0,0
1668185216713,ECE 279,A00,117947,Hall; Drew A.,0,0,0,0
1668185217568,ECE 283,A00,103670,Hsueh; Tzu-Chien,0,0,0,0
1668185217990,ECE 284,A00,103671,Turakhia; Yatish Girish,0,0,0,0
1668185218419,ECE 285,A00,103672,Zheng; Yang,0,0,0,0
1668185218419,ECE 285,B00,103673,Sworder; David D.,0,0,0,0
1668185218850,ECE 287,A00,103676,Javidi; Tara,0,0,0,0
1668185219275,MATH 200B,A00,098023,Salehi Golsefidy; Alireza,12,0,15,3
1668185219703,MATH 202B,A00,098024,Rhoades; Brendon Patrick,9,0,15,6
1668185220143,MATH 203B,A00,098025,Oprea; Dragos N.,10,0,15,5
1668185220574,MATH 204B,A00,098026,Sorensen; Claus M,13,0,15,2
1668185221004,MATH 208,A00,098027,Izadi; Elham,7,0,10,3
1668185221427,MATH 209,A00,098028,Pollack; Aaron,10,0,10,0
1668185221851,MATH 211A,A00,112919,Rogalski; Daniel,9,0,10,1
1668185222277,MATH 211B,A00,112920,Seward; Brandon M.,9,0,10,1
1668185222699,MATH 218,A00,098029,Li; Bo,10,0,10,0
1668185223132,MATH 220B,A00,098030,Novak; Jonathan I,11,0,15,4
1668185223560,MATH 221A,A00,098031,Ebenfelt; Peter F,13,0,15,2
1668185223983,MATH 231B,A00,098032,Zlatos; Andrej,12,0,15,3
1668185224410,MATH 240B,A00,098033,Ni; Lei,9,0,15,6
1668185224832,MATH 243,A00,098034,Jekel; David Andrew,10,0,10,0
1668185225260,MATH 245A,A00,098035,Nie; Jiawang,0,0,15,16
1668185225687,MATH 248,A00,098036,Bejenaru; Ioan,10,0,10,0
1668185226110,MATH 250B,A00,098037,Spolaor; Luca,14,0,15,1
1668185226534,MATH 258,A00,098038,Ni; Lei,10,0,10,0
1668185226957,MATH 264B,A00,098041,Rhoades; Brendon Patrick,9,0,15,6
1668185227390,MATH 268,A00,098042,Buss; Samuel R,10,0,10,0
1668185227814,MATH 269,A00,098043,Rhoades; Brendon Patrick,10,0,10,0
1668185228240,MATH 270B,A00,098044,Li; Bo,10,0,15,5
1668185228664,MATH 272B,A00,098045,Holst; Michael J,13,0,15,2
1668185229090,MATH 273A,A00,098046,Tian; Xiaochuan,10,0,15,5
1668185229512,MATH 275,A01,098048,Tian; Xiaochuan,6,0,10,4
1668185229935,MATH 278A,A00,098049,Holst; Michael J,8,0,10,2
1668185230366,MATH 278B,A00,098050,Cloninger; Alexander,10,0,10,0
1668185230791,MATH 278C,A00,098051,Nie; Jiawang,7,0,10,3
1668185231215,MATH 280B,A00,098052,Zheng; Tianyi,10,0,15,5
1668185231649,MATH 281B,A00,098053,Bradic; Jelena,2,0,15,13
1668185232075,MATH 282B,A00,098054,Arias-Castro; Ery,0,0,15,15
1668185232498,MATH 285,A00,098055,Fitzsimmons; Patrick J,0,0,15,17
1668185232921,MATH 287B,A00,098056,Arias-Castro; Ery,2,0,15,13
1668185233362,MATH 288,A00,098057,Agarwal; Pooja,9,0,10,1
1668185233362,MATH 288,B00,098058,Zhang; Danna,8,0,10,2
1668185233362,MATH 288,C00,098059,Williams; Ruth J,10,0,10,0
1668185233787,MATH 290B,A00,098060,Roberts; Justin Deritter,13,0,15,2
1668185234208,MATH 292,A00,098061,Belmont; Eva Kinoshita,10,0,10,0
1668185234633,MATH 295,A00,098062,Suk; Andrew Hoon,48,0,50,2
1668185235056,MATH 296,A00,098063,Novak; Jonathan I,20,0,20,0
1668185235480,MATH 297,001,098064,Gamst; Anthony Collins,9997,0,9999,2
1668185736764,COGS 205,A00,101395,Chiba; Andrea,19,0,20,1
1668185737200,COGS 210B,001,101404,Greene; Deanna Jacquelyn,9998,0,9999,1
1668185737200,COGS 210B,002,101417,Xia; Haijun,9999,0,9999,0
1668185737200,COGS 210B,003,101422,Nitz; Douglas A.,9999,0,9999,0
1668185737200,COGS 210B,004,101423,Hollan; James D.,9998,0,9999,1
1668185737200,COGS 210B,005,101424,Deak; Gedeon O.,9998,0,9999,1
1668185737200,COGS 210B,006,101425,Rossano; Federico,9999,0,9999,0
1668185737622,COGS 211B,A00,101427,Coulson; Seana M,9996,0,9999,3
1668185738048,COGS 220,A00,101428,Hollan; James D.,0,0,25,25
1668185738474,COGS 229,A00,101429,Dow; Steven P,18,0,25,7
1668185738903,COGS 230,A00,101430,Klemmer; Scott R,12,0,17,5
1668185739331,COGS 234,A00,101431,Xia; Haijun,3,0,25,22
1668185739758,COGS 260,A00,101432,Kiyonaga; Anastasia,20,0,25,5
1668185739758,COGS 260,B00,101433,Kirsh; David Joel,16,0,25,9
1668185740187,CSE 202,A00,102371,Impagliazzo; Russell,0,0,0,0
1668185740616,CSE 203B,A01,102373,Cheng; Chung Kuan,0,0,0,0
1668185741040,CSE 208,A00,102374,Micciancio; Daniele,0,0,0,0
1668185741467,CSE 209A,A00,112895,Impagliazzo; Russell,0,0,15,15
1668185741897,CSE 209B,A00,108005,Bellare; Mihir,0,0,0,0
1668185742325,CSE 210,A00,113163,Coblenz; Michael J,0,0,0,0
1668185742752,CSE 219,A00,106111,Dow; Steven P,0,0,20,20
1668185743175,CSE 221,A00,102376,Voelker; Geoffrey M.,0,0,0,0
1668185743598,CSE 224,A01,102378,Porter; George M,0,0,0,0
1668185744025,CSE 229A,A00,102379,Savage; Stefan,0,0,0,0
1668185744449,CSE 229C,A00,102380,Munyaka; Imani N. S.,0,0,0,0
1668185744873,CSE 232B,A00,102382,Deutsch; Alin Bernard,0,0,0,0
1668185745299,CSE 234,A01,112904,Kumar; Arun Kumar,0,0,0,0
1668185745724,CSE 237A,A00,102383,Rosing; Tajana Simunic,0,0,0,0
1668185746146,CSE 239A,A00,102384,Deutsch; Alin Bernard,0,0,0,0
1668185746574,CSE 239B,A00,102385,Polikarpova; Nadezhda,0,0,0,0
1668185747004,CSE 240A,A00,102386,Pannuto; Patrick William,0,0,0,0
1668185747435,CSE 240B,A00,102387,Zhao; Jishen,0,0,0,0
1668185747858,CSE 241A,A00,106406,Kang; Mingu,0,0,0,0
1668185748281,CSE 249B,A00,102388,Kahng; Andrew Byun,0,0,8,8
1668185748714,CSE 251B,A01,102392,Cottrell; Garrison W,0,0,0,0
1668185748714,CSE 251B,A02,102393,Cottrell; Garrison W,0,0,0,0
1668185749139,CSE 252B,A00,102394,Ochoa; Benjamin Lawrence,0,0,0,0
1668185749566,CSE 257,A01,102396,Gao; Sicun,0,0,0,0
1668185749992,CSE 272,A00,102397,Li; Tzumao,0,0,0,0
1668185750444,CSE 274,A00,111323,Chern; Albert Ren-Haur,0,0,0,0
1668185750867,CSE 282,A00,102398,Pevzner; Pavel Arkadjevich,0,0,0,0
1668185751292,CSE 284,A00,114175,Gymrek; Melissa Ann,0,0,0,0
1668185751730,CSE 290,A00,102399,Chandraker; Manmohan Krishna,0,0,0,0
1668185751730,CSE 290,B00,102400,Vaccaro; Kristen Marie,0,0,25,25
1668185751730,CSE 290,C00,102414,Pannuto; Patrick William,0,0,25,25
1668185751730,CSE 290,D00,102427,Pevzner; Pavel Arkadjevich,0,0,0,0
1668185751730,CSE 290,E00,102429,Zhao; Jishen,0,0,0,0
1668185751730,CSE 290,F00,102436,Tullsen; Dean Michael,0,0,0,0
1668185751730,CSE 290,G00,102440,Christensen; Henrik I,0,0,20,20
1668185752164,CSE 291,A00,102443,Su; Hao,0,0,0,0
1668185752164,CSE 291,B00,102448,Polikarpova; Nadezhda,0,0,0,0
1668185752164,CSE 291,C00,102453,Vaccaro; Kristen Marie,0,0,0,0
1668185752164,CSE 291,D00,111343,Savage; Stefan,0,0,0,0
1668185752164,CSE 291,E00,116474,Claffy; Kimberly Claire,0,0,0,0
1668185752164,CSE 291,F00,116479,Pasquale; Joseph,0,0,0,0
1668185752609,CSE 293,001,119111,Bafna; Vineet,9999,0,9999,0
1668185752609,CSE 293,002,119118,Bellare; Mihir,9999,0,9999,0
1668185752609,CSE 293,003,119122,Berg-Kirkpatrick; Taylor D,9999,0,9999,0
1668185752609,CSE 293,004,119135,Christensen; Henrik I,9999,0,9999,0
1668185752609,CSE 293,005,119142,Cottrell; Garrison W,9999,0,9999,0
1668185752609,CSE 293,006,119146,Deutsch; Alin Bernard,9999,0,9999,0
1668185752609,CSE 293,007,119159,Esmaeilzadeh; Hadi,9999,0,9999,0
1668185752609,CSE 293,008,119166,Freund; Yoav,9999,0,9999,0
1668185752609,CSE 293,009,119170,Griswold; William G.,9999,0,9999,0
1668185752609,CSE 293,010,119183,Gymrek; Melissa Ann,9999,0,9999,0
1668185752609,CSE 293,011,119190,Heninger; Nadia A,9999,0,9999,0
1668185752609,CSE 293,012,119230,Impagliazzo; Russell,9999,0,9999,0
1668185752609,CSE 293,013,119232,Jhala; Ranjit,9999,0,9999,0
1668185752609,CSE 293,014,119233,Kahng; Andrew Byun,9999,0,9999,0
1668185752609,CSE 293,015,119298,Kane; Daniel Mertz,9999,0,9999,0
1668185752609,CSE 293,016,119299,Kriegman; David J,9999,0,9999,0
1668185752609,CSE 293,017,119300,Kumar; Arun Kumar,9999,0,9999,0
1668185752609,CSE 293,018,119301,Lerner; Sorin,9999,0,9999,0
1668185752609,CSE 293,019,119302,Lovett; Shachar,9999,0,9999,0
1668185752609,CSE 293,020,119303,McAuley; Julian John,9999,0,9999,0
1668185752609,CSE 293,021,119304,Micciancio; Daniele,9999,0,9999,0
1668185752609,CSE 293,022,119367,Orailoglu; Alex,9999,0,9999,0
1668185752609,CSE 293,023,119382,Paturi; Ramamohan,9999,0,9999,0
1668185752609,CSE 293,024,119404,Polikarpova; Nadezhda,9999,0,9999,0
1668185752609,CSE 293,025,119406,Politz; Joseph Gibbs,9999,0,9999,0
1668185752609,CSE 293,026,119411,Porter; George M,9999,0,9999,0
1668185752609,CSE 293,027,119414,Porter; Leonard Emerson,9999,0,9999,0
1668185752609,CSE 293,028,119416,Ramamoorthi; Ravi,9999,0,9999,0
1668185752609,CSE 293,029,119417,Sahoo; Debashis,9999,0,9999,0
1668185752609,CSE 293,030,119420,Saul; Lawrence,9999,0,9999,0
1668185752609,CSE 293,031,119421,Savage; Stefan,9999,0,9999,0
1668185752609,CSE 293,032,119425,Schulze; Jurgen P.,9999,0,9999,0
1668185752609,CSE 293,033,119426,Snoeren; Alex C.,9999,0,9999,0
1668185752609,CSE 293,034,119428,Shang; Jingbo,9999,0,9999,0
1668185752609,CSE 293,035,119430,Stefan; Deian,9999,0,9999,0
1668185752609,CSE 293,036,119431,Su; Hao,9999,0,9999,0
1668185752609,CSE 293,037,119433,Swanson; Steven James,9999,0,9999,0
1668185752609,CSE 293,038,119435,Tullsen; Dean Michael,9999,0,9999,0
1668185752609,CSE 293,039,119483,Voelker; Geoffrey M.,9999,0,9999,0
1668185752609,CSE 293,040,119537,Zhao; Jishen,9999,0,9999,0
1668185752609,CSE 293,041,119538,Zhou; Yuan-Yuan,9999,0,9999,0
1668185752609,CSE 293,042,119539,Gao; Sicun,9999,0,9999,0
1668185752609,CSE 293,043,119540,Weibel; Nadir,9999,0,9999,0
1668185752609,CSE 293,044,119541,Gupta; Rajesh K.,9999,0,9999,0
1668185752609,CSE 293,045,126410,Vaccaro; Kristen Marie,9999,0,9999,0
1668185752609,CSE 293,046,126411,Klemke; Richard,9999,0,9999,0
1668185753034,CSE 294,A00,102459,Voelker; Geoffrey M.,0,0,0,0
1668185753034,CSE 294,B00,111322,Orailoglu; Alex,0,0,0,0
1668185753459,DSE 201,A00,096914,Deutsch; Alin Bernard,30,0,30,0
1668185753883,DSE 210,A00,096915,Dasgupta; Sanjoy,30,0,30,0
1668185754306,DSE 260A,A00,096916,Altintas De Callaf; Ilkay,30,0,30,0
1668185754752,ECE 200,001,103586,Antipa; Nicholas A,9999,0,9999,0
1668185754752,ECE 200,002,103587,Atanasov; Nikolay A.,9999,0,9999,0
1668185754752,ECE 200,003,103588,Bharadia; Dinesh,9999,0,9999,0
1668185754752,ECE 200,004,103589,Cheng; Chung Kuan,9999,0,9999,0
1668185754752,ECE 200,005,103590,Cosman; Pamela C.,9999,0,9999,0
1668185754752,ECE 200,006,103591,Dayeh; Shadi Ahmad,9999,0,9999,0
1668185754752,ECE 200,007,103592,Fainman; Yeshaiahu,9999,0,9999,0
1668185754752,ECE 200,008,103593,Ford; Joseph Earl,9999,0,9999,0
1668185754752,ECE 200,009,103594,Franceschetti; Massimo,9999,0,9999,0
1668185754752,ECE 200,010,103595,Fullerton; Eric E,9999,0,9999,0
1668185754752,ECE 200,011,103596,Galton; Ian A,9999,0,9999,0
1668185754752,ECE 200,012,103597,Gilja; Vikash,9999,0,9999,0
1668185754752,ECE 200,013,103598,Hall; Drew A.,9999,0,9999,0
1668185754752,ECE 200,014,103599,Hsueh; Tzu-Chien,9999,0,9999,0
1668185754752,ECE 200,015,103600,Javidi; Tara,9999,0,9999,0
1668185754752,ECE 200,016,103601,Kahng; Andrew Byun,9999,0,9999,0
1668185754752,ECE 200,017,103602,Kim; Young-Han,9999,0,9999,0
1668185754752,ECE 200,018,103603,Koushanfar; Farinaz,9999,0,9999,0
1668185754752,ECE 200,019,103604,Kuzum; Duygu,9999,0,9999,0
1668185754752,ECE 200,020,103605,Le; Hanh-Phuc,9999,0,9999,0
1668185754752,ECE 200,021,103606,Lin; Bill,9999,0,9999,0
1668185754752,ECE 200,022,103607,Liu; Zhaowei,9998,0,9999,1
1668185754752,ECE 200,023,103608,Lo; Yu-Hwa,9999,0,9999,0
1668185754752,ECE 200,024,103609,Lomakin; Vitaliy,9999,0,9999,0
1668185754752,ECE 200,025,103610,Mercier; Patrick Philip,9999,0,9999,0
1668185754752,ECE 200,026,103611,Meyer; Florian,9999,0,9999,0
1668185754752,ECE 200,027,103612,Milstein; Laurence B.,9999,0,9999,0
1668185754752,ECE 200,028,103613,Mir Arabbaygi; Siavash,9999,0,9999,0
1668185754752,ECE 200,029,103614,Mookherjea; Shayan,9999,0,9999,0
1668185754752,ECE 200,030,103615,Morris; Karcher William,9999,0,9999,0
1668185754752,ECE 200,031,103616,Ng; Tse Nga,9999,0,9999,0
1668185754752,ECE 200,032,103617,Nguyen; Truong Quang,9999,0,9999,0
1668185754752,ECE 200,033,103618,Nomura; Kenji,9999,0,9999,0
1668185754752,ECE 200,034,103619,Orlitsky; Alon,9999,0,9999,0
1668185754752,ECE 200,035,103620,Pal; Piya,9999,0,9999,0
1668185754752,ECE 200,036,103621,Papen; George C.,9999,0,9999,0
1668185754752,ECE 200,037,103622,Radic; Stojan,9999,0,9999,0
1668185754752,ECE 200,038,103623,Rao; Bhaskar D.,9999,0,9999,0
1668185754752,ECE 200,039,103624,Rao; Ramesh R,9999,0,9999,0
1668185754752,ECE 200,040,103625,Rebeiz; Gabriel,9999,0,9999,0
1668185754752,ECE 200,041,103626,Sanford; John R,9999,0,9999,0
1668185754752,ECE 200,042,103627,Siegel; Paul H.,9999,0,9999,0
1668185754752,ECE 200,043,103628,Sievenpiper; Daniel F.,9999,0,9999,0
1668185754752,ECE 200,044,103629,Sworder; David D.,9999,0,9999,0
1668185754752,ECE 200,045,103630,Taur; Yuan,9999,0,9999,0
1668185754752,ECE 200,046,103631,Touri; Behrouz,9999,0,9999,0
1668185754752,ECE 200,047,103632,Trivedi; Mohan M.,9999,0,9999,0
1668185754752,ECE 200,048,103633,Vasconcelos; Nuno,9999,0,9999,0
1668185754752,ECE 200,049,103634,Wang; Xiaolong,9999,0,9999,0
1668185754752,ECE 200,050,103635,Xie; Pengtao,9999,0,9999,0
1668185754752,ECE 200,051,103636,Yip; Michael,9999,0,9999,0
1668185754752,ECE 200,052,103637,Zeger; Kenneth A.,999,0,999,0
1668185754752,ECE 200,053,103638,Zhang; Xinyu,9999,0,9999,0
1668185754752,ECE 200,054,103639,Turakhia; Yatish Girish,9999,0,9999,0
1668185754752,ECE 200,055,103640,Kang; Mingu,9999,0,9999,0
1668185754752,ECE 200,056,103641,Shi; Yuanyuan,9999,0,9999,0
1668185754752,ECE 200,057,103642,Wang; Edward Jay,9999,0,9999,0
1668185754752,ECE 200,058,103643,Zheng; Yang,9999,0,9999,0
1668185755179,ECE 202,A00,103644,Kuzum; Duygu,0,0,0,0
1668185755612,ECE 212BN,A00,103646,Ng; Tse Nga,0,0,0,0
1668185756043,ECE 221,A00,111493,Staff,0,0,0,0
1668185756485,ECE 222B,A00,103647,Lomakin; Vitaliy,0,0,0,0
1668185756922,ECE 230B,A00,103648,Taur; Yuan,0,0,0,0
1668185757357,ECE 238B,A00,103649,Garay; Javier,0,0,0,0
1668185757792,ECE 240B,A00,112900,Fainman; Yeshaiahu,0,0,0,0
1668185758217,ECE 247A,A00,103650,Jokerst; Jesse Vincent,0,0,0,0
1668185758642,ECE 247B,A00,103651,Wang; Joseph,0,0,0,0
1668185759069,ECE 250,A00,103652,Siegel; Paul H.,0,0,0,0
1668185759504,ECE 251A,A00,103654,Rao; Bhaskar D.,0,0,0,0
1668185759930,ECE 257B,A00,103655,Bharadia; Dinesh,0,0,0,0
1668185760355,ECE 258A,A00,103656,Milstein; Laurence B.,0,0,0,0
1668185760779,ECE 260B,A00,103658,Kang; Mingu,0,0,0,0
1668185761207,ECE 264A,A00,103659,Galton; Ian A,0,0,0,0
1668185761631,ECE 265A,A00,103661,Gudem; Prasad S.S.,0,0,0,0
1668185762058,ECE 265D,A00,103662,Gudem; Prasad S.S.,0,0,0,0
1668185762481,ECE 268,A00,103663,Koushanfar; Farinaz,0,0,0,0
1668185762910,ECE 269,A01,103665,Pal; Piya,0,0,0,0
1668185763337,ECE 271B,A00,103666,Vasconcelos; Manuela,0,0,0,0
1668185763761,ECE 276A,A00,103667,Atanasov; Nikolay A.,0,0,0,0
1668185764198,ECE 277,A00,103668,An; Cheolhong,0,0,0,0
1668185764735,ECE 279,A00,117947,Hall; Drew A.,0,0,0,0
1668185765596,ECE 283,A00,103670,Hsueh; Tzu-Chien,0,0,0,0
1668185766020,ECE 284,A00,103671,Turakhia; Yatish Girish,0,0,0,0
1668185766443,ECE 285,A00,103672,Zheng; Yang,0,0,0,0
1668185766443,ECE 285,B00,103673,Sworder; David D.,0,0,0,0
1668185766873,ECE 287,A00,103676,Javidi; Tara,0,0,0,0
1668185767299,MATH 200B,A00,098023,Salehi Golsefidy; Alireza,12,0,15,3
1668185767725,MATH 202B,A00,098024,Rhoades; Brendon Patrick,9,0,15,6
1668185768150,MATH 203B,A00,098025,Oprea; Dragos N.,10,0,15,5
1668185768586,MATH 204B,A00,098026,Sorensen; Claus M,13,0,15,2
1668185769014,MATH 208,A00,098027,Izadi; Elham,7,0,10,3
1668185769438,MATH 209,A00,098028,Pollack; Aaron,10,0,10,0
1668185769863,MATH 211A,A00,112919,Rogalski; Daniel,9,0,10,1
1668185770288,MATH 211B,A00,112920,Seward; Brandon M.,9,0,10,1
1668185770718,MATH 218,A00,098029,Li; Bo,10,0,10,0
1668185771154,MATH 220B,A00,098030,Novak; Jonathan I,11,0,15,4
1668185771579,MATH 221A,A00,098031,Ebenfelt; Peter F,13,0,15,2
1668185772003,MATH 231B,A00,098032,Zlatos; Andrej,12,0,15,3
1668185772438,MATH 240B,A00,098033,Ni; Lei,9,0,15,6
1668185772871,MATH 243,A00,098034,Jekel; David Andrew,10,0,10,0
1668185773313,MATH 245A,A00,098035,Nie; Jiawang,0,0,15,16
1668185773747,MATH 248,A00,098036,Bejenaru; Ioan,10,0,10,0
1668185774175,MATH 250B,A00,098037,Spolaor; Luca,14,0,15,1
1668185774599,MATH 258,A00,098038,Ni; Lei,10,0,10,0
1668185775034,MATH 264B,A00,098041,Rhoades; Brendon Patrick,9,0,15,6
1668185775456,MATH 268,A00,098042,Buss; Samuel R,10,0,10,0
1668185775886,MATH 269,A00,098043,Rhoades; Brendon Patrick,10,0,10,0
1668185776311,MATH 270B,A00,098044,Li; Bo,10,0,15,5
1668185776735,MATH 272B,A00,098045,Holst; Michael J,13,0,15,2
1668185777171,MATH 273A,A00,098046,Tian; Xiaochuan,10,0,15,5
1668185777594,MATH 275,A01,098048,Tian; Xiaochuan,6,0,10,4
1668185778017,MATH 278A,A00,098049,Holst; Michael J,8,0,10,2
1668185778446,MATH 278B,A00,098050,Cloninger; Alexander,10,0,10,0
1668185778870,MATH 278C,A00,098051,Nie; Jiawang,7,0,10,3
1668185779305,MATH 280B,A00,098052,Zheng; Tianyi,10,0,15,5
1668185779743,MATH 281B,A00,098053,Bradic; Jelena,2,0,15,13
1668185780166,MATH 282B,A00,098054,Arias-Castro; Ery,0,0,15,15
1668185780595,MATH 285,A00,098055,Fitzsimmons; Patrick J,0,0,15,17
1668185781019,MATH 287B,A00,098056,Arias-Castro; Ery,2,0,15,13
1668185781442,MATH 288,A00,098057,Agarwal; Pooja,9,0,10,1
1668185781442,MATH 288,B00,098058,Zhang; Danna,8,0,10,2
1668185781442,MATH 288,C00,098059,Williams; Ruth J,10,0,10,0
1668185781875,MATH 290B,A00,098060,Roberts; Justin Deritter,13,0,15,2
1668185782298,MATH 292,A00,098061,Belmont; Eva Kinoshita,10,0,10,0
1668185782722,MATH 295,A00,098062,Suk; Andrew Hoon,48,0,50,2
1668185783146,MATH 296,A00,098063,Novak; Jonathan I,20,0,20,0
1668185783569,MATH 297,001,098064,Gamst; Anthony Collins,9997,0,9999,2
1668186285475,COGS 205,A00,101395,Chiba; Andrea,19,0,20,1
1668186285916,COGS 210B,001,101404,Greene; Deanna Jacquelyn,9998,0,9999,1
1668186285916,COGS 210B,002,101417,Xia; Haijun,9999,0,9999,0
1668186285916,COGS 210B,003,101422,Nitz; Douglas A.,9999,0,9999,0
1668186285916,COGS 210B,004,101423,Hollan; James D.,9998,0,9999,1
1668186285916,COGS 210B,005,101424,Deak; Gedeon O.,9998,0,9999,1
1668186285916,COGS 210B,006,101425,Rossano; Federico,9999,0,9999,0
1668186286343,COGS 211B,A00,101427,Coulson; Seana M,9996,0,9999,3
1668186286868,COGS 220,A00,101428,Hollan; James D.,0,0,25,25
1668186287298,COGS 229,A00,101429,Dow; Steven P,18,0,25,7
1668186287732,COGS 230,A00,101430,Klemmer; Scott R,12,0,17,5
1668186288158,COGS 234,A00,101431,Xia; Haijun,3,0,25,22
1668186288582,COGS 260,A00,101432,Kiyonaga; Anastasia,20,0,25,5
1668186288582,COGS 260,B00,101433,Kirsh; David Joel,16,0,25,9
1668186289011,CSE 202,A00,102371,Impagliazzo; Russell,0,0,0,0
1668186289439,CSE 203B,A01,102373,Cheng; Chung Kuan,0,0,0,0
1668186289865,CSE 208,A00,102374,Micciancio; Daniele,0,0,0,0
1668186290292,CSE 209A,A00,112895,Impagliazzo; Russell,0,0,15,15
1668186290717,CSE 209B,A00,108005,Bellare; Mihir,0,0,0,0
1668186291147,CSE 210,A00,113163,Coblenz; Michael J,0,0,0,0
1668186291568,CSE 219,A00,106111,Dow; Steven P,0,0,20,20
1668186291991,CSE 221,A00,102376,Voelker; Geoffrey M.,0,0,0,0
1668186292423,CSE 224,A01,102378,Porter; George M,0,0,0,0
1668186292846,CSE 229A,A00,102379,Savage; Stefan,0,0,0,0
1668186293272,CSE 229C,A00,102380,Munyaka; Imani N. S.,0,0,0,0
1668186293704,CSE 232B,A00,102382,Deutsch; Alin Bernard,0,0,0,0
1668186294140,CSE 234,A01,112904,Kumar; Arun Kumar,0,0,0,0
1668186294576,CSE 237A,A00,102383,Rosing; Tajana Simunic,0,0,0,0
1668186295001,CSE 239A,A00,102384,Deutsch; Alin Bernard,0,0,0,0
1668186295428,CSE 239B,A00,102385,Polikarpova; Nadezhda,0,0,0,0
1668186295853,CSE 240A,A00,102386,Pannuto; Patrick William,0,0,0,0
1668186296283,CSE 240B,A00,102387,Zhao; Jishen,0,0,0,0
1668186296706,CSE 241A,A00,106406,Kang; Mingu,0,0,0,0
1668186297135,CSE 249B,A00,102388,Kahng; Andrew Byun,0,0,8,8
1668186297568,CSE 251B,A01,102392,Cottrell; Garrison W,0,0,0,0
1668186297568,CSE 251B,A02,102393,Cottrell; Garrison W,0,0,0,0
1668186297990,CSE 252B,A00,102394,Ochoa; Benjamin Lawrence,0,0,0,0
1668186298414,CSE 257,A01,102396,Gao; Sicun,0,0,0,0
1668186298842,CSE 272,A00,102397,Li; Tzumao,0,0,0,0
1668186299270,CSE 274,A00,111323,Chern; Albert Ren-Haur,0,0,0,0
1668186299701,CSE 282,A00,102398,Pevzner; Pavel Arkadjevich,0,0,0,0
1668186300124,CSE 284,A00,114175,Gymrek; Melissa Ann,0,0,0,0
1668186300558,CSE 290,A00,102399,Chandraker; Manmohan Krishna,0,0,0,0
1668186300558,CSE 290,B00,102400,Vaccaro; Kristen Marie,0,0,25,25
1668186300558,CSE 290,C00,102414,Pannuto; Patrick William,0,0,25,25
1668186300558,CSE 290,D00,102427,Pevzner; Pavel Arkadjevich,0,0,0,0
1668186300558,CSE 290,E00,102429,Zhao; Jishen,0,0,0,0
1668186300558,CSE 290,F00,102436,Tullsen; Dean Michael,0,0,0,0
1668186300558,CSE 290,G00,102440,Christensen; Henrik I,0,0,20,20
1668186300983,CSE 291,A00,102443,Su; Hao,0,0,0,0
1668186300983,CSE 291,B00,102448,Polikarpova; Nadezhda,0,0,0,0
1668186300983,CSE 291,C00,102453,Vaccaro; Kristen Marie,0,0,0,0
1668186300983,CSE 291,D00,111343,Savage; Stefan,0,0,0,0
1668186300983,CSE 291,E00,116474,Claffy; Kimberly Claire,0,0,0,0
1668186300983,CSE 291,F00,116479,Pasquale; Joseph,0,0,0,0
1668186301485,CSE 293,001,119111,Bafna; Vineet,9999,0,9999,0
1668186301485,CSE 293,002,119118,Bellare; Mihir,9999,0,9999,0
1668186301485,CSE 293,003,119122,Berg-Kirkpatrick; Taylor D,9999,0,9999,0
1668186301485,CSE 293,004,119135,Christensen; Henrik I,9999,0,9999,0
1668186301485,CSE 293,005,119142,Cottrell; Garrison W,9999,0,9999,0
1668186301485,CSE 293,006,119146,Deutsch; Alin Bernard,9999,0,9999,0
1668186301485,CSE 293,007,119159,Esmaeilzadeh; Hadi,9999,0,9999,0
1668186301485,CSE 293,008,119166,Freund; Yoav,9999,0,9999,0
1668186301485,CSE 293,009,119170,Griswold; William G.,9999,0,9999,0
1668186301485,CSE 293,010,119183,Gymrek; Melissa Ann,9999,0,9999,0
1668186301485,CSE 293,011,119190,Heninger; Nadia A,9999,0,9999,0
1668186301485,CSE 293,012,119230,Impagliazzo; Russell,9999,0,9999,0
1668186301485,CSE 293,013,119232,Jhala; Ranjit,9999,0,9999,0
1668186301485,CSE 293,014,119233,Kahng; Andrew Byun,9999,0,9999,0
1668186301485,CSE 293,015,119298,Kane; Daniel Mertz,9999,0,9999,0
1668186301485,CSE 293,016,119299,Kriegman; David J,9999,0,9999,0
1668186301485,CSE 293,017,119300,Kumar; Arun Kumar,9999,0,9999,0
1668186301485,CSE 293,018,119301,Lerner; Sorin,9999,0,9999,0
1668186301485,CSE 293,019,119302,Lovett; Shachar,9999,0,9999,0
1668186301485,CSE 293,020,119303,McAuley; Julian John,9999,0,9999,0
1668186301485,CSE 293,021,119304,Micciancio; Daniele,9999,0,9999,0
1668186301485,CSE 293,022,119367,Orailoglu; Alex,9999,0,9999,0
1668186301485,CSE 293,023,119382,Paturi; Ramamohan,9999,0,9999,0
1668186301485,CSE 293,024,119404,Polikarpova; Nadezhda,9999,0,9999,0
1668186301485,CSE 293,025,119406,Politz; Joseph Gibbs,9999,0,9999,0
1668186301485,CSE 293,026,119411,Porter; George M,9999,0,9999,0
1668186301485,CSE 293,027,119414,Porter; Leonard Emerson,9999,0,9999,0
1668186301485,CSE 293,028,119416,Ramamoorthi; Ravi,9999,0,9999,0
1668186301485,CSE 293,029,119417,Sahoo; Debashis,9999,0,9999,0
1668186301485,CSE 293,030,119420,Saul; Lawrence,9999,0,9999,0
1668186301485,CSE 293,031,119421,Savage; Stefan,9999,0,9999,0
1668186301485,CSE 293,032,119425,Schulze; Jurgen P.,9999,0,9999,0
1668186301485,CSE 293,033,119426,Snoeren; Alex C.,9999,0,9999,0
1668186301485,CSE 293,034,119428,Shang; Jingbo,9999,0,9999,0
1668186301485,CSE 293,035,119430,Stefan; Deian,9999,0,9999,0
1668186301485,CSE 293,036,119431,Su; Hao,9999,0,9999,0
1668186301485,CSE 293,037,119433,Swanson; Steven James,9999,0,9999,0
1668186301485,CSE 293,038,119435,Tullsen; Dean Michael,9999,0,9999,0
1668186301485,CSE 293,039,119483,Voelker; Geoffrey M.,9999,0,9999,0
1668186301485,CSE 293,040,119537,Zhao; Jishen,9999,0,9999,0
1668186301485,CSE 293,041,119538,Zhou; Yuan-Yuan,9999,0,9999,0
1668186301485,CSE 293,042,119539,Gao; Sicun,9999,0,9999,0
1668186301485,CSE 293,043,119540,Weibel; Nadir,9999,0,9999,0
1668186301485,CSE 293,044,119541,Gupta; Rajesh K.,9999,0,9999,0
1668186301485,CSE 293,045,126410,Vaccaro; Kristen Marie,9999,0,9999,0
1668186301485,CSE 293,046,126411,Klemke; Richard,9999,0,9999,0
1668186301923,CSE 294,A00,102459,Voelker; Geoffrey M.,0,0,0,0
1668186301923,CSE 294,B00,111322,Orailoglu; Alex,0,0,0,0
1668186302347,DSE 201,A00,096914,Deutsch; Alin Bernard,30,0,30,0
1668186302781,DSE 210,A00,096915,Dasgupta; Sanjoy,30,0,30,0
1668186303203,DSE 260A,A00,096916,Altintas De Callaf; Ilkay,30,0,30,0
1668186303639,ECE 200,001,103586,Antipa; Nicholas A,9999,0,9999,0
1668186303639,ECE 200,002,103587,Atanasov; Nikolay A.,9999,0,9999,0
1668186303639,ECE 200,003,103588,Bharadia; Dinesh,9999,0,9999,0
1668186303639,ECE 200,004,103589,Cheng; Chung Kuan,9999,0,9999,0
1668186303639,ECE 200,005,103590,Cosman; Pamela C.,9999,0,9999,0
1668186303639,ECE 200,006,103591,Dayeh; Shadi Ahmad,9999,0,9999,0
1668186303639,ECE 200,007,103592,Fainman; Yeshaiahu,9999,0,9999,0
1668186303639,ECE 200,008,103593,Ford; Joseph Earl,9999,0,9999,0
1668186303639,ECE 200,009,103594,Franceschetti; Massimo,9999,0,9999,0
1668186303639,ECE 200,010,103595,Fullerton; Eric E,9999,0,9999,0
1668186303639,ECE 200,011,103596,Galton; Ian A,9999,0,9999,0
1668186303639,ECE 200,012,103597,Gilja; Vikash,9999,0,9999,0
1668186303639,ECE 200,013,103598,Hall; Drew A.,9999,0,9999,0
1668186303639,ECE 200,014,103599,Hsueh; Tzu-Chien,9999,0,9999,0
1668186303639,ECE 200,015,103600,Javidi; Tara,9999,0,9999,0
1668186303639,ECE 200,016,103601,Kahng; Andrew Byun,9999,0,9999,0
1668186303639,ECE 200,017,103602,Kim; Young-Han,9999,0,9999,0
1668186303639,ECE 200,018,103603,Koushanfar; Farinaz,9999,0,9999,0
1668186303639,ECE 200,019,103604,Kuzum; Duygu,9999,0,9999,0
1668186303639,ECE 200,020,103605,Le; Hanh-Phuc,9999,0,9999,0
1668186303639,ECE 200,021,103606,Lin; Bill,9999,0,9999,0
1668186303639,ECE 200,022,103607,Liu; Zhaowei,9998,0,9999,1
1668186303639,ECE 200,023,103608,Lo; Yu-Hwa,9999,0,9999,0
1668186303639,ECE 200,024,103609,Lomakin; Vitaliy,9999,0,9999,0
1668186303639,ECE 200,025,103610,Mercier; Patrick Philip,9999,0,9999,0
1668186303639,ECE 200,026,103611,Meyer; Florian,9999,0,9999,0
1668186303639,ECE 200,027,103612,Milstein; Laurence B.,9999,0,9999,0
1668186303639,ECE 200,028,103613,Mir Arabbaygi; Siavash,9999,0,9999,0
1668186303639,ECE 200,029,103614,Mookherjea; Shayan,9999,0,9999,0
1668186303639,ECE 200,030,103615,Morris; Karcher William,9999,0,9999,0
1668186303639,ECE 200,031,103616,Ng; Tse Nga,9999,0,9999,0
1668186303639,ECE 200,032,103617,Nguyen; Truong Quang,9999,0,9999,0
1668186303639,ECE 200,033,103618,Nomura; Kenji,9999,0,9999,0
1668186303639,ECE 200,034,103619,Orlitsky; Alon,9999,0,9999,0
1668186303639,ECE 200,035,103620,Pal; Piya,9999,0,9999,0
1668186303639,ECE 200,036,103621,Papen; George C.,9999,0,9999,0
1668186303639,ECE 200,037,103622,Radic; Stojan,9999,0,9999,0
1668186303639,ECE 200,038,103623,Rao; Bhaskar D.,9999,0,9999,0
1668186303639,ECE 200,039,103624,Rao; Ramesh R,9999,0,9999,0
1668186303639,ECE 200,040,103625,Rebeiz; Gabriel,9999,0,9999,0
1668186303639,ECE 200,041,103626,Sanford; John R,9999,0,9999,0
1668186303639,ECE 200,042,103627,Siegel; Paul H.,9999,0,9999,0
1668186303639,ECE 200,043,103628,Sievenpiper; Daniel F.,9999,0,9999,0
1668186303639,ECE 200,044,103629,Sworder; David D.,9999,0,9999,0
1668186303639,ECE 200,045,103630,Taur; Yuan,9999,0,9999,0
1668186303639,ECE 200,046,103631,Touri; Behrouz,9999,0,9999,0
1668186303639,ECE 200,047,103632,Trivedi; Mohan M.,9999,0,9999,0
1668186303639,ECE 200,048,103633,Vasconcelos; Nuno,9999,0,9999,0
1668186303639,ECE 200,049,103634,Wang; Xiaolong,9999,0,9999,0
1668186303639,ECE 200,050,103635,Xie; Pengtao,9999,0,9999,0
1668186303639,ECE 200,051,103636,Yip; Michael,9999,0,9999,0
1668186303639,ECE 200,052,103637,Zeger; Kenneth A.,999,0,999,0
1668186303639,ECE 200,053,103638,Zhang; Xinyu,9999,0,9999,0
1668186303639,ECE 200,054,103639,Turakhia; Yatish Girish,9999,0,9999,0
1668186303639,ECE 200,055,103640,Kang; Mingu,9999,0,9999,0
1668186303639,ECE 200,056,103641,Shi; Yuanyuan,9999,0,9999,0
1668186303639,ECE 200,057,103642,Wang; Edward Jay,9999,0,9999,0
1668186303639,ECE 200,058,103643,Zheng; Yang,9999,0,9999,0
1668186304066,ECE 202,A00,103644,Kuzum; Duygu,0,0,0,0
1668186304489,ECE 212BN,A00,103646,Ng; Tse Nga,0,0,0,0
1668186304914,ECE 221,A00,111493,Staff,0,0,0,0
1668186305337,ECE 222B,A00,103647,Lomakin; Vitaliy,0,0,0,0
1668186305765,ECE 230B,A00,103648,Taur; Yuan,0,0,0,0
1668186306186,ECE 238B,A00,103649,Garay; Javier,0,0,0,0
1668186306611,ECE 240B,A00,112900,Fainman; Yeshaiahu,0,0,0,0
1668186307036,ECE 247A,A00,103650,Jokerst; Jesse Vincent,0,0,0,0
1668186307470,ECE 247B,A00,103651,Wang; Joseph,0,0,0,0
1668186307895,ECE 250,A00,103652,Siegel; Paul H.,0,0,0,0
1668186308320,ECE 251A,A00,103654,Rao; Bhaskar D.,0,0,0,0
1668186308744,ECE 257B,A00,103655,Bharadia; Dinesh,0,0,0,0
1668186309169,ECE 258A,A00,103656,Milstein; Laurence B.,0,0,0,0
1668186309597,ECE 260B,A00,103658,Kang; Mingu,0,0,0,0
1668186310022,ECE 264A,A00,103659,Galton; Ian A,0,0,0,0
1668186310444,ECE 265A,A00,103661,Gudem; Prasad S.S.,0,0,0,0
1668186310874,ECE 265D,A00,103662,Gudem; Prasad S.S.,0,0,0,0
1668186311296,ECE 268,A00,103663,Koushanfar; Farinaz,0,0,0,0
1668186311732,ECE 269,A01,103665,Pal; Piya,0,0,0,0
1668186312161,ECE 271B,A00,103666,Vasconcelos; Manuela,0,0,0,0
1668186312587,ECE 276A,A00,103667,Atanasov; Nikolay A.,0,0,0,0
1668186313012,ECE 277,A00,103668,An; Cheolhong,0,0,0,0
1668186313436,ECE 279,A00,117947,Hall; Drew A.,0,0,0,0
1668186314288,ECE 283,A00,103670,Hsueh; Tzu-Chien,0,0,0,0
1668186314712,ECE 284,A00,103671,Turakhia; Yatish Girish,0,0,0,0
1668186315134,ECE 285,A00,103672,Zheng; Yang,0,0,0,0
1668186315134,ECE 285,B00,103673,Sworder; David D.,0,0,0,0
1668186315556,ECE 287,A00,103676,Javidi; Tara,0,0,0,0
1668186315981,MATH 200B,A00,098023,Salehi Golsefidy; Alireza,12,0,15,3
1668186316405,MATH 202B,A00,098024,Rhoades; Brendon Patrick,9,0,15,6
1668186316829,MATH 203B,A00,098025,Oprea; Dragos N.,10,0,15,5
1668186317254,MATH 204B,A00,098026,Sorensen; Claus M,13,0,15,2
1668186317678,MATH 208,A00,098027,Izadi; Elham,7,0,10,3
1668186318102,MATH 209,A00,098028,Pollack; Aaron,10,0,10,0
1668186318527,MATH 211A,A00,112919,Rogalski; Daniel,9,0,10,1
1668186318949,MATH 211B,A00,112920,Seward; Brandon M.,9,0,10,1
1668186319376,MATH 218,A00,098029,Li; Bo,10,0,10,0
1668186319801,MATH 220B,A00,098030,Novak; Jonathan I,11,0,15,4
1668186320223,MATH 221A,A00,098031,Ebenfelt; Peter F,13,0,15,2
1668186320652,MATH 231B,A00,098032,Zlatos; Andrej,12,0,15,3
1668186321077,MATH 240B,A00,098033,Ni; Lei,9,0,15,6
1668186321502,MATH 243,A00,098034,Jekel; David Andrew,10,0,10,0
1668186321935,MATH 245A,A00,098035,Nie; Jiawang,0,0,15,16
1668186322361,MATH 248,A00,098036,Bejenaru; Ioan,10,0,10,0
1668186322788,MATH 250B,A00,098037,Spolaor; Luca,14,0,15,1
1668186323214,MATH 258,A00,098038,Ni; Lei,10,0,10,0
1668186323637,MATH 264B,A00,098041,Rhoades; Brendon Patrick,9,0,15,6
1668186324062,MATH 268,A00,098042,Buss; Samuel R,10,0,10,0
1668186324499,MATH 269,A00,098043,Rhoades; Brendon Patrick,10,0,10,0
1668186324933,MATH 270B,A00,098044,Li; Bo,10,0,15,5
1668186325356,MATH 272B,A00,098045,Holst; Michael J,13,0,15,2
1668186325781,MATH 273A,A00,098046,Tian; Xiaochuan,10,0,15,5
1668186326205,MATH 275,A01,098048,Tian; Xiaochuan,6,0,10,4
1668186326634,MATH 278A,A00,098049,Holst; Michael J,8,0,10,2
1668186327060,MATH 278B,A00,098050,Cloninger; Alexander,10,0,10,0
1668186327483,MATH 278C,A00,098051,Nie; Jiawang,7,0,10,3
1668186327906,MATH 280B,A00,098052,Zheng; Tianyi,10,0,15,5
1668186328341,MATH 281B,A00,098053,Bradic; Jelena,2,0,15,13
1668186328771,MATH 282B,A00,098054,Arias-Castro; Ery,0,0,15,15
1668186329194,MATH 285,A00,098055,Fitzsimmons; Patrick J,0,0,15,17
1668186329629,MATH 287B,A00,098056,Arias-Castro; Ery,2,0,15,13
1668186330138,MATH 288,A00,098057,Agarwal; Pooja,9,0,10,1
1668186330138,MATH 288,B00,098058,Zhang; Danna,8,0,10,2
1668186330138,MATH 288,C00,098059,Williams; Ruth J,10,0,10,0
1668186330564,MATH 290B,A00,098060,Roberts; Justin Deritter,13,0,15,2
1668186330988,MATH 292,A00,098061,Belmont; Eva Kinoshita,10,0,10,0
1668186331412,MATH 295,A00,098062,Suk; Andrew Hoon,48,0,50,2
1668186331835,MATH 296,A00,098063,Novak; Jonathan I,20,0,20,0
1668186332260,MATH 297,001,098064,Gamst; Anthony Collins,9997,0,9999,2
1668186835396,COGS 205,A00,101395,Chiba; Andrea,19,0,20,1
1668186835821,COGS 210B,001,101404,Greene; Deanna Jacquelyn,9998,0,9999,1
1668186835821,COGS 210B,002,101417,Xia; Haijun,9999,0,9999,0
1668186835821,COGS 210B,003,101422,Nitz; Douglas A.,9999,0,9999,0
1668186835821,COGS 210B,004,101423,Hollan; James D.,9998,0,9999,1
1668186835821,COGS 210B,005,101424,Deak; Gedeon O.,9998,0,9999,1
1668186835821,COGS 210B,006,101425,Rossano; Federico,9999,0,9999,0
1668186836251,COGS 211B,A00,101427,Coulson; Seana M,9996,0,9999,3
1668186836678,COGS 220,A00,101428,Hollan; James D.,0,0,25,25
1668186837115,COGS 229,A00,101429,Dow; Steven P,18,0,25,7
1668186837540,COGS 230,A00,101430,Klemmer; Scott R,12,0,17,5
1668186837962,COGS 234,A00,101431,Xia; Haijun,3,0,25,22
1668186838394,COGS 260,A00,101432,Kiyonaga; Anastasia,20,0,25,5
1668186838394,COGS 260,B00,101433,Kirsh; David Joel,16,0,25,9
1668186838817,CSE 202,A00,102371,Impagliazzo; Russell,0,0,0,0
1668186839246,CSE 203B,A01,102373,Cheng; Chung Kuan,0,0,0,0
1668186839677,CSE 208,A00,102374,Micciancio; Daniele,0,0,0,0
1668186840189,CSE 209A,A00,112895,Impagliazzo; Russell,0,0,15,15
1668186840626,CSE 209B,A00,108005,Bellare; Mihir,0,0,0,0
1668186841055,CSE 210,A00,113163,Coblenz; Michael J,0,0,0,0
1668186841489,CSE 219,A00,106111,Dow; Steven P,0,0,20,20
1668186841912,CSE 221,A00,102376,Voelker; Geoffrey M.,0,0,0,0
1668186842338,CSE 224,A01,102378,Porter; George M,0,0,0,0
1668186842767,CSE 229A,A00,102379,Savage; Stefan,0,0,0,0
1668186843190,CSE 229C,A00,102380,Munyaka; Imani N. S.,0,0,0,0
1668186843641,CSE 232B,A00,102382,Deutsch; Alin Bernard,0,0,0,0
1668186844063,CSE 234,A01,112904,Kumar; Arun Kumar,0,0,0,0
1668186844490,CSE 237A,A00,102383,Rosing; Tajana Simunic,0,0,0,0
1668186844917,CSE 239A,A00,102384,Deutsch; Alin Bernard,0,0,0,0
1668186845343,CSE 239B,A00,102385,Polikarpova; Nadezhda,0,0,0,0
1668186845767,CSE 240A,A00,102386,Pannuto; Patrick William,0,0,0,0
1668186846190,CSE 240B,A00,102387,Zhao; Jishen,0,0,0,0
1668186846624,CSE 241A,A00,106406,Kang; Mingu,0,0,0,0
1668186847048,CSE 249B,A00,102388,Kahng; Andrew Byun,0,0,8,8
1668186847471,CSE 251B,A01,102392,Cottrell; Garrison W,0,0,0,0
1668186847471,CSE 251B,A02,102393,Cottrell; Garrison W,0,0,0,0
1668186847895,CSE 252B,A00,102394,Ochoa; Benjamin Lawrence,0,0,0,0
1668186848321,CSE 257,A01,102396,Gao; Sicun,0,0,0,0
1668186848749,CSE 272,A00,102397,Li; Tzumao,0,0,0,0
1668186849175,CSE 274,A00,111323,Chern; Albert Ren-Haur,0,0,0,0
1668186849613,CSE 282,A00,102398,Pevzner; Pavel Arkadjevich,0,0,0,0
1668186850060,CSE 284,A00,114175,Gymrek; Melissa Ann,0,0,0,0
1668186850503,CSE 290,A00,102399,Chandraker; Manmohan Krishna,0,0,0,0
1668186850503,CSE 290,B00,102400,Vaccaro; Kristen Marie,0,0,25,25
1668186850503,CSE 290,C00,102414,Pannuto; Patrick William,0,0,25,25
1668186850503,CSE 290,D00,102427,Pevzner; Pavel Arkadjevich,0,0,0,0
1668186850503,CSE 290,E00,102429,Zhao; Jishen,0,0,0,0
1668186850503,CSE 290,F00,102436,Tullsen; Dean Michael,0,0,0,0
1668186850503,CSE 290,G00,102440,Christensen; Henrik I,0,0,20,20
1668186850946,CSE 291,A00,102443,Su; Hao,0,0,0,0
1668186850946,CSE 291,B00,102448,Polikarpova; Nadezhda,0,0,0,0
1668186850946,CSE 291,C00,102453,Vaccaro; Kristen Marie,0,0,0,0
1668186850946,CSE 291,D00,111343,Savage; Stefan,0,0,0,0
1668186850946,CSE 291,E00,116474,Claffy; Kimberly Claire,0,0,0,0
1668186850946,CSE 291,F00,116479,Pasquale; Joseph,0,0,0,0
1668186851400,CSE 293,001,119111,Bafna; Vineet,9999,0,9999,0
1668186851400,CSE 293,002,119118,Bellare; Mihir,9999,0,9999,0
1668186851400,CSE 293,003,119122,Berg-Kirkpatrick; Taylor D,9999,0,9999,0
1668186851400,CSE 293,004,119135,Christensen; Henrik I,9999,0,9999,0
1668186851400,CSE 293,005,119142,Cottrell; Garrison W,9999,0,9999,0
1668186851400,CSE 293,006,119146,Deutsch; Alin Bernard,9999,0,9999,0
1668186851400,CSE 293,007,119159,Esmaeilzadeh; Hadi,9999,0,9999,0
1668186851400,CSE 293,008,119166,Freund; Yoav,9999,0,9999,0
1668186851400,CSE 293,009,119170,Griswold; William G.,9999,0,9999,0
1668186851400,CSE 293,010,119183,Gymrek; Melissa Ann,9999,0,9999,0
1668186851400,CSE 293,011,119190,Heninger; Nadia A,9999,0,9999,0
1668186851400,CSE 293,012,119230,Impagliazzo; Russell,9999,0,9999,0
1668186851400,CSE 293,013,119232,Jhala; Ranjit,9999,0,9999,0
1668186851400,CSE 293,014,119233,Kahng; Andrew Byun,9999,0,9999,0
1668186851400,CSE 293,015,119298,Kane; Daniel Mertz,9999,0,9999,0
1668186851400,CSE 293,016,119299,Kriegman; David J,9999,0,9999,0
1668186851400,CSE 293,017,119300,Kumar; Arun Kumar,9999,0,9999,0
1668186851400,CSE 293,018,119301,Lerner; Sorin,9999,0,9999,0
1668186851400,CSE 293,019,119302,Lovett; Shachar,9999,0,9999,0
1668186851400,CSE 293,020,119303,McAuley; Julian John,9999,0,9999,0
1668186851400,CSE 293,021,119304,Micciancio; Daniele,9999,0,9999,0
1668186851400,CSE 293,022,119367,Orailoglu; Alex,9999,0,9999,0
1668186851400,CSE 293,023,119382,Paturi; Ramamohan,9999,0,9999,0
1668186851400,CSE 293,024,119404,Polikarpova; Nadezhda,9999,0,9999,0
1668186851400,CSE 293,025,119406,Politz; Joseph Gibbs,9999,0,9999,0
1668186851400,CSE 293,026,119411,Porter; George M,9999,0,9999,0
1668186851400,CSE 293,027,119414,Porter; Leonard Emerson,9999,0,9999,0
1668186851400,CSE 293,028,119416,Ramamoorthi; Ravi,9999,0,9999,0
1668186851400,CSE 293,029,119417,Sahoo; Debashis,9999,0,9999,0
1668186851400,CSE 293,030,119420,Saul; Lawrence,9999,0,9999,0
1668186851400,CSE 293,031,119421,Savage; Stefan,9999,0,9999,0
1668186851400,CSE 293,032,119425,Schulze; Jurgen P.,9999,0,9999,0
1668186851400,CSE 293,033,119426,Snoeren; Alex C.,9999,0,9999,0
1668186851400,CSE 293,034,119428,Shang; Jingbo,9999,0,9999,0
1668186851400,CSE 293,035,119430,Stefan; Deian,9999,0,9999,0
1668186851400,CSE 293,036,119431,Su; Hao,9999,0,9999,0
1668186851400,CSE 293,037,119433,Swanson; Steven James,9999,0,9999,0
1668186851400,CSE 293,038,119435,Tullsen; Dean Michael,9999,0,9999,0
1668186851400,CSE 293,039,119483,Voelker; Geoffrey M.,9999,0,9999,0
1668186851400,CSE 293,040,119537,Zhao; Jishen,9999,0,9999,0
1668186851400,CSE 293,041,119538,Zhou; Yuan-Yuan,9999,0,9999,0
1668186851400,CSE 293,042,119539,Gao; Sicun,9999,0,9999,0
1668186851400,CSE 293,043,119540,Weibel; Nadir,9999,0,9999,0
1668186851400,CSE 293,044,119541,Gupta; Rajesh K.,9999,0,9999,0
1668186851400,CSE 293,045,126410,Vaccaro; Kristen Marie,9999,0,9999,0
1668186851400,CSE 293,046,126411,Klemke; Richard,9999,0,9999,0
1668186851826,CSE 294,A00,102459,Voelker; Geoffrey M.,0,0,0,0
1668186851826,CSE 294,B00,111322,Orailoglu; Alex,0,0,0,0
1668186852252,DSE 201,A00,096914,Deutsch; Alin Bernard,30,0,30,0
1668186852682,DSE 210,A00,096915,Dasgupta; Sanjoy,30,0,30,0
1668186853105,DSE 260A,A00,096916,Altintas De Callaf; Ilkay,30,0,30,0
1668186853626,ECE 200,001,103586,Antipa; Nicholas A,9999,0,9999,0
1668186853626,ECE 200,002,103587,Atanasov; Nikolay A.,9999,0,9999,0
1668186853626,ECE 200,003,103588,Bharadia; Dinesh,9999,0,9999,0
1668186853626,ECE 200,004,103589,Cheng; Chung Kuan,9999,0,9999,0
1668186853626,ECE 200,005,103590,Cosman; Pamela C.,9999,0,9999,0
1668186853626,ECE 200,006,103591,Dayeh; Shadi Ahmad,9999,0,9999,0
1668186853626,ECE 200,007,103592,Fainman; Yeshaiahu,9999,0,9999,0
1668186853626,ECE 200,008,103593,Ford; Joseph Earl,9999,0,9999,0
1668186853626,ECE 200,009,103594,Franceschetti; Massimo,9999,0,9999,0
1668186853626,ECE 200,010,103595,Fullerton; Eric E,9999,0,9999,0
1668186853626,ECE 200,011,103596,Galton; Ian A,9999,0,9999,0
1668186853626,ECE 200,012,103597,Gilja; Vikash,9999,0,9999,0
1668186853626,ECE 200,013,103598,Hall; Drew A.,9999,0,9999,0
1668186853626,ECE 200,014,103599,Hsueh; Tzu-Chien,9999,0,9999,0
1668186853626,ECE 200,015,103600,Javidi; Tara,9999,0,9999,0
1668186853626,ECE 200,016,103601,Kahng; Andrew Byun,9999,0,9999,0
1668186853626,ECE 200,017,103602,Kim; Young-Han,9999,0,9999,0
1668186853626,ECE 200,018,103603,Koushanfar; Farinaz,9999,0,9999,0
1668186853626,ECE 200,019,103604,Kuzum; Duygu,9999,0,9999,0
1668186853626,ECE 200,020,103605,Le; Hanh-Phuc,9999,0,9999,0
1668186853626,ECE 200,021,103606,Lin; Bill,9999,0,9999,0
1668186853626,ECE 200,022,103607,Liu; Zhaowei,9998,0,9999,1
1668186853626,ECE 200,023,103608,Lo; Yu-Hwa,9999,0,9999,0
1668186853626,ECE 200,024,103609,Lomakin; Vitaliy,9999,0,9999,0
1668186853626,ECE 200,025,103610,Mercier; Patrick Philip,9999,0,9999,0
1668186853626,ECE 200,026,103611,Meyer; Florian,9999,0,9999,0
1668186853626,ECE 200,027,103612,Milstein; Laurence B.,9999,0,9999,0
1668186853626,ECE 200,028,103613,Mir Arabbaygi; Siavash,9999,0,9999,0
1668186853626,ECE 200,029,103614,Mookherjea; Shayan,9999,0,9999,0
1668186853626,ECE 200,030,103615,Morris; Karcher William,9999,0,9999,0
1668186853626,ECE 200,031,103616,Ng; Tse Nga,9999,0,9999,0
1668186853626,ECE 200,032,103617,Nguyen; Truong Quang,9999,0,9999,0
1668186853626,ECE 200,033,103618,Nomura; Kenji,9999,0,9999,0
1668186853626,ECE 200,034,103619,Orlitsky; Alon,9999,0,9999,0
1668186853626,ECE 200,035,103620,Pal; Piya,9999,0,9999,0
1668186853626,ECE 200,036,103621,Papen; George C.,9999,0,9999,0
1668186853626,ECE 200,037,103622,Radic; Stojan,9999,0,9999,0
1668186853626,ECE 200,038,103623,Rao; Bhaskar D.,9999,0,9999,0
1668186853626,ECE 200,039,103624,Rao; Ramesh R,9999,0,9999,0
1668186853626,ECE 200,040,103625,Rebeiz; Gabriel,9999,0,9999,0
1668186853626,ECE 200,041,103626,Sanford; John R,9999,0,9999,0
1668186853626,ECE 200,042,103627,Siegel; Paul H.,9999,0,9999,0
1668186853626,ECE 200,043,103628,Sievenpiper; Daniel F.,9999,0,9999,0
1668186853626,ECE 200,044,103629,Sworder; David D.,9999,0,9999,0
1668186853626,ECE 200,045,103630,Taur; Yuan,9999,0,9999,0
1668186853626,ECE 200,046,103631,Touri; Behrouz,9999,0,9999,0
1668186853626,ECE 200,047,103632,Trivedi; Mohan M.,9999,0,9999,0
1668186853626,ECE 200,048,103633,Vasconcelos; Nuno,9999,0,9999,0
1668186853626,ECE 200,049,103634,Wang; Xiaolong,9999,0,9999,0
1668186853626,ECE 200,050,103635,Xie; Pengtao,9999,0,9999,0
1668186853626,ECE 200,051,103636,Yip; Michael,9999,0,9999,0
1668186853626,ECE 200,052,103637,Zeger; Kenneth A.,999,0,999,0
1668186853626,ECE 200,053,103638,Zhang; Xinyu,9999,0,9999,0
1668186853626,ECE 200,054,103639,Turakhia; Yatish Girish,9999,0,9999,0
1668186853626,ECE 200,055,103640,Kang; Mingu,9999,0,9999,0
1668186853626,ECE 200,056,103641,Shi; Yuanyuan,9999,0,9999,0
1668186853626,ECE 200,057,103642,Wang; Edward Jay,9999,0,9999,0
1668186853626,ECE 200,058,103643,Zheng; Yang,9999,0,9999,0
1668186854049,ECE 202,A00,103644,Kuzum; Duygu,0,0,0,0
1668186854474,ECE 212BN,A00,103646,Ng; Tse Nga,0,0,0,0
1668186854897,ECE 221,A00,111493,Staff,0,0,0,0
1668186855320,ECE 222B,A00,103647,Lomakin; Vitaliy,0,0,0,0
1668186855760,ECE 230B,A00,103648,Taur; Yuan,0,0,0,0
1668186856192,ECE 238B,A00,103649,Garay; Javier,0,0,0,0
1668186856614,ECE 240B,A00,112900,Fainman; Yeshaiahu,0,0,0,0
1668186857055,ECE 247A,A00,103650,Jokerst; Jesse Vincent,0,0,0,0
1668186857484,ECE 247B,A00,103651,Wang; Joseph,0,0,0,0
1668186857912,ECE 250,A00,103652,Siegel; Paul H.,0,0,0,0
1668186858340,ECE 251A,A00,103654,Rao; Bhaskar D.,0,0,0,0
1668186858765,ECE 257B,A00,103655,Bharadia; Dinesh,0,0,0,0
1668186859195,ECE 258A,A00,103656,Milstein; Laurence B.,0,0,0,0
1668186859630,ECE 260B,A00,103658,Kang; Mingu,0,0,0,0
1668186860077,ECE 264A,A00,103659,Galton; Ian A,0,0,0,0
1668186860517,ECE 265A,A00,103661,Gudem; Prasad S.S.,0,0,0,0
1668186860943,ECE 265D,A00,103662,Gudem; Prasad S.S.,0,0,0,0
1668186861384,ECE 268,A00,103663,Koushanfar; Farinaz,0,0,0,0
1668186861808,ECE 269,A01,103665,Pal; Piya,0,0,0,0
1668186862239,ECE 271B,A00,103666,Vasconcelos; Manuela,0,0,0,0
1668186862662,ECE 276A,A00,103667,Atanasov; Nikolay A.,0,0,0,0
1668186863099,ECE 277,A00,103668,An; Cheolhong,0,0,0,0
1668186863551,ECE 279,A00,117947,Hall; Drew A.,0,0,0,0
1668186864427,ECE 283,A00,103670,Hsueh; Tzu-Chien,0,0,0,0
1668186864858,ECE 284,A00,103671,Turakhia; Yatish Girish,0,0,0,0
1668186865293,ECE 285,A00,103672,Zheng; Yang,0,0,0,0
1668186865293,ECE 285,B00,103673,Sworder; David D.,0,0,0,0
1668186865731,ECE 287,A00,103676,Javidi; Tara,0,0,0,0
1668186866168,MATH 200B,A00,098023,Salehi Golsefidy; Alireza,12,0,15,3
1668186866607,MATH 202B,A00,098024,Rhoades; Brendon Patrick,9,0,15,6
1668186867037,MATH 203B,A00,098025,Oprea; Dragos N.,10,0,15,5
1668186867469,MATH 204B,A00,098026,Sorensen; Claus M,13,0,15,2
1668186867900,MATH 208,A00,098027,Izadi; Elham,7,0,10,3
1668186868335,MATH 209,A00,098028,Pollack; Aaron,10,0,10,0
1668186868765,MATH 211A,A00,112919,Rogalski; Daniel,9,0,10,1
1668186869205,MATH 211B,A00,112920,Seward; Brandon M.,9,0,10,1
1668186869630,MATH 218,A00,098029,Li; Bo,10,0,10,0
1668186870055,MATH 220B,A00,098030,Novak; Jonathan I,11,0,15,4
1668186870480,MATH 221A,A00,098031,Ebenfelt; Peter F,13,0,15,2
1668186870909,MATH 231B,A00,098032,Zlatos; Andrej,12,0,15,3
1668186871332,MATH 240B,A00,098033,Ni; Lei,9,0,15,6
1668186871755,MATH 243,A00,098034,Jekel; David Andrew,10,0,10,0
1668186872178,MATH 245A,A00,098035,Nie; Jiawang,0,0,15,16
1668186872603,MATH 248,A00,098036,Bejenaru; Ioan,10,0,10,0
1668186873032,MATH 250B,A00,098037,Spolaor; Luca,14,0,15,1
1668186873460,MATH 258,A00,098038,Ni; Lei,10,0,10,0
1668186873895,MATH 264B,A00,098041,Rhoades; Brendon Patrick,9,0,15,6
1668186874327,MATH 268,A00,098042,Buss; Samuel R,10,0,10,0
1668186874752,MATH 269,A00,098043,Rhoades; Brendon Patrick,10,0,10,0
1668186875182,MATH 270B,A00,098044,Li; Bo,10,0,15,5
1668186875605,MATH 272B,A00,098045,Holst; Michael J,13,0,15,2
1668186876030,MATH 273A,A00,098046,Tian; Xiaochuan,10,0,15,5
1668186876454,MATH 275,A01,098048,Tian; Xiaochuan,6,0,10,4
1668186876892,MATH 278A,A00,098049,Holst; Michael J,8,0,10,2
1668186877317,MATH 278B,A00,098050,Cloninger; Alexander,10,0,10,0
1668186877739,MATH 278C,A00,098051,Nie; Jiawang,7,0,10,3
1668186878165,MATH 280B,A00,098052,Zheng; Tianyi,10,0,15,5
1668186878605,MATH 281B,A00,098053,Bradic; Jelena,2,0,15,13
1668186879031,MATH 282B,A00,098054,Arias-Castro; Ery,0,0,15,15
1668186879453,MATH 285,A00,098055,Fitzsimmons; Patrick J,0,0,15,17
1668186879880,MATH 287B,A00,098056,Arias-Castro; Ery,2,0,15,13
1668186880322,MATH 288,A00,098057,Agarwal; Pooja,9,0,10,1
1668186880322,MATH 288,B00,098058,Zhang; Danna,8,0,10,2
1668186880322,MATH 288,C00,098059,Williams; Ruth J,10,0,10,0
1668186880750,MATH 290B,A00,098060,Roberts; Justin Deritter,13,0,15,2
1668186881176,MATH 292,A00,098061,Belmont; Eva Kinoshita,10,0,10,0
1668186881602,MATH 295,A00,098062,Suk; Andrew Hoon,48,0,50,2
1668186882026,MATH 296,A00,098063,Novak; Jonathan I,20,0,20,0
1668186882451,MATH 297,001,098064,Gamst; Anthony Collins,9997,0,9999,2
1668187401485,COGS 205,A00,101395,Chiba; Andrea,19,0,20,1
1668187401907,COGS 210B,001,101404,Greene; Deanna Jacquelyn,9998,0,9999,1
1668187401907,COGS 210B,002,101417,Xia; Haijun,9999,0,9999,0
1668187401907,COGS 210B,003,101422,Nitz; Douglas A.,9999,0,9999,0
1668187401907,COGS 210B,004,101423,Hollan; James D.,9998,0,9999,1
1668187401907,COGS 210B,005,101424,Deak; Gedeon O.,9998,0,9999,1
1668187401907,COGS 210B,006,101425,Rossano; Federico,9999,0,9999,0
1668187402330,COGS 211B,A00,101427,Coulson; Seana M,9996,0,9999,3
1668187402751,COGS 220,A00,101428,Hollan; James D.,0,0,25,25
1668187403184,COGS 229,A00,101429,Dow; Steven P,18,0,25,7
1668187403609,COGS 230,A00,101430,Klemmer; Scott R,12,0,17,5
1668187404032,COGS 234,A00,101431,Xia; Haijun,3,0,25,22
1668187404459,COGS 260,A00,101432,Kiyonaga; Anastasia,20,0,25,5
1668187404459,COGS 260,B00,101433,Kirsh; David Joel,16,0,25,9
1668187404884,CSE 202,A00,102371,Impagliazzo; Russell,0,0,0,0
1668187405306,CSE 203B,A01,102373,Cheng; Chung Kuan,0,0,0,0
1668187405732,CSE 208,A00,102374,Micciancio; Daniele,0,0,0,0
1668187406162,CSE 209A,A00,112895,Impagliazzo; Russell,0,0,15,15
1668187406588,CSE 209B,A00,108005,Bellare; Mihir,0,0,0,0
1668187407015,CSE 210,A00,113163,Coblenz; Michael J,0,0,0,0
1668187407438,CSE 219,A00,106111,Dow; Steven P,0,0,20,20
1668187407864,CSE 221,A00,102376,Voelker; Geoffrey M.,0,0,0,0
1668187408290,CSE 224,A01,102378,Porter; George M,0,0,0,0
1668187408722,CSE 229A,A00,102379,Savage; Stefan,0,0,0,0
1668187409152,CSE 229C,A00,102380,Munyaka; Imani N. S.,0,0,0,0
1668187409581,CSE 232B,A00,102382,Deutsch; Alin Bernard,0,0,0,0
1668187410010,CSE 234,A01,112904,Kumar; Arun Kumar,0,0,0,0
1668187410446,CSE 237A,A00,102383,Rosing; Tajana Simunic,0,0,0,0
1668187410869,CSE 239A,A00,102384,Deutsch; Alin Bernard,0,0,0,0
1668187411294,CSE 239B,A00,102385,Polikarpova; Nadezhda,0,0,0,0
1668187411720,CSE 240A,A00,102386,Pannuto; Patrick William,0,0,0,0
1668187412143,CSE 240B,A00,102387,Zhao; Jishen,0,0,0,0
1668187412565,CSE 241A,A00,106406,Kang; Mingu,0,0,0,0
1668187412991,CSE 249B,A00,102388,Kahng; Andrew Byun,0,0,8,8
1668187413414,CSE 251B,A01,102392,Cottrell; Garrison W,0,0,0,0
1668187413414,CSE 251B,A02,102393,Cottrell; Garrison W,0,0,0,0
1668187413837,CSE 252B,A00,102394,Ochoa; Benjamin Lawrence,0,0,0,0
1668187414265,CSE 257,A01,102396,Gao; Sicun,0,0,0,0
1668187414688,CSE 272,A00,102397,Li; Tzumao,0,0,0,0
1668187415117,CSE 274,A00,111323,Chern; Albert Ren-Haur,0,0,0,0
1668187415555,CSE 282,A00,102398,Pevzner; Pavel Arkadjevich,0,0,0,0
1668187415981,CSE 284,A00,114175,Gymrek; Melissa Ann,0,0,0,0
1668187416419,CSE 290,A00,102399,Chandraker; Manmohan Krishna,0,0,0,0
1668187416419,CSE 290,B00,102400,Vaccaro; Kristen Marie,0,0,25,25
1668187416419,CSE 290,C00,102414,Pannuto; Patrick William,0,0,25,25
1668187416419,CSE 290,D00,102427,Pevzner; Pavel Arkadjevich,0,0,0,0
1668187416419,CSE 290,E00,102429,Zhao; Jishen,0,0,0,0
1668187416419,CSE 290,F00,102436,Tullsen; Dean Michael,0,0,0,0
1668187416419,CSE 290,G00,102440,Christensen; Henrik I,0,0,20,20
1668187416847,CSE 291,A00,102443,Su; Hao,0,0,0,0
1668187416847,CSE 291,B00,102448,Polikarpova; Nadezhda,0,0,0,0
1668187416847,CSE 291,C00,102453,Vaccaro; Kristen Marie,0,0,0,0
1668187416847,CSE 291,D00,111343,Savage; Stefan,0,0,0,0
1668187416847,CSE 291,E00,116474,Claffy; Kimberly Claire,0,0,0,0
1668187416847,CSE 291,F00,116479,Pasquale; Joseph,0,0,0,0
1668187417286,CSE 293,001,119111,Bafna; Vineet,9999,0,9999,0
1668187417286,CSE 293,002,119118,Bellare; Mihir,9999,0,9999,0
1668187417286,CSE 293,003,119122,Berg-Kirkpatrick; Taylor D,9999,0,9999,0
1668187417286,CSE 293,004,119135,Christensen; Henrik I,9999,0,9999,0
1668187417286,CSE 293,005,119142,Cottrell; Garrison W,9999,0,9999,0
1668187417286,CSE 293,006,119146,Deutsch; Alin Bernard,9999,0,9999,0
1668187417286,CSE 293,007,119159,Esmaeilzadeh; Hadi,9999,0,9999,0
1668187417286,CSE 293,008,119166,Freund; Yoav,9999,0,9999,0
1668187417286,CSE 293,009,119170,Griswold; William G.,9999,0,9999,0
1668187417286,CSE 293,010,119183,Gymrek; Melissa Ann,9999,0,9999,0
1668187417286,CSE 293,011,119190,Heninger; Nadia A,9999,0,9999,0
1668187417286,CSE 293,012,119230,Impagliazzo; Russell,9999,0,9999,0
1668187417286,CSE 293,013,119232,Jhala; Ranjit,9999,0,9999,0
1668187417286,CSE 293,014,119233,Kahng; Andrew Byun,9999,0,9999,0
1668187417286,CSE 293,015,119298,Kane; Daniel Mertz,9999,0,9999,0
1668187417286,CSE 293,016,119299,Kriegman; David J,9999,0,9999,0
1668187417286,CSE 293,017,119300,Kumar; Arun Kumar,9999,0,9999,0
1668187417286,CSE 293,018,119301,Lerner; Sorin,9999,0,9999,0
1668187417286,CSE 293,019,119302,Lovett; Shachar,9999,0,9999,0
1668187417286,CSE 293,020,119303,McAuley; Julian John,9999,0,9999,0
1668187417286,CSE 293,021,119304,Micciancio; Daniele,9999,0,9999,0
1668187417286,CSE 293,022,119367,Orailoglu; Alex,9999,0,9999,0
1668187417286,CSE 293,023,119382,Paturi; Ramamohan,9999,0,9999,0
1668187417286,CSE 293,024,119404,Polikarpova; Nadezhda,9999,0,9999,0
1668187417286,CSE 293,025,119406,Politz; Joseph Gibbs,9999,0,9999,0
1668187417286,CSE 293,026,119411,Porter; George M,9999,0,9999,0
1668187417286,CSE 293,027,119414,Porter; Leonard Emerson,9999,0,9999,0
1668187417286,CSE 293,028,119416,Ramamoorthi; Ravi,9999,0,9999,0
1668187417286,CSE 293,029,119417,Sahoo; Debashis,9999,0,9999,0
1668187417286,CSE 293,030,119420,Saul; Lawrence,9999,0,9999,0
1668187417286,CSE 293,031,119421,Savage; Stefan,9999,0,9999,0
1668187417286,CSE 293,032,119425,Schulze; Jurgen P.,9999,0,9999,0
1668187417286,CSE 293,033,119426,Snoeren; Alex C.,9999,0,9999,0
1668187417286,CSE 293,034,119428,Shang; Jingbo,9999,0,9999,0
1668187417286,CSE 293,035,119430,Stefan; Deian,9999,0,9999,0
1668187417286,CSE 293,036,119431,Su; Hao,9999,0,9999,0
1668187417286,CSE 293,037,119433,Swanson; Steven James,9999,0,9999,0
1668187417286,CSE 293,038,119435,Tullsen; Dean Michael,9999,0,9999,0
1668187417286,CSE 293,039,119483,Voelker; Geoffrey M.,9999,0,9999,0
1668187417286,CSE 293,040,119537,Zhao; Jishen,9999,0,9999,0
1668187417286,CSE 293,041,119538,Zhou; Yuan-Yuan,9999,0,9999,0
1668187417286,CSE 293,042,119539,Gao; Sicun,9999,0,9999,0
1668187417286,CSE 293,043,119540,Weibel; Nadir,9999,0,9999,0
1668187417286,CSE 293,044,119541,Gupta; Rajesh K.,9999,0,9999,0
1668187417286,CSE 293,045,126410,Vaccaro; Kristen Marie,9999,0,9999,0
1668187417286,CSE 293,046,126411,Klemke; Richard,9999,0,9999,0
1668187417712,CSE 294,A00,102459,Voelker; Geoffrey M.,0,0,0,0
1668187417712,CSE 294,B00,111322,Orailoglu; Alex,0,0,0,0
1668187418143,DSE 201,A00,096914,Deutsch; Alin Bernard,30,0,30,0
1668187418587,DSE 210,A00,096915,Dasgupta; Sanjoy,30,0,30,0
1668187419012,DSE 260A,A00,096916,Altintas De Callaf; Ilkay,30,0,30,0
1668187419444,ECE 200,001,103586,Antipa; Nicholas A,9999,0,9999,0
1668187419444,ECE 200,002,103587,Atanasov; Nikolay A.,9999,0,9999,0
1668187419444,ECE 200,003,103588,Bharadia; Dinesh,9999,0,9999,0
1668187419444,ECE 200,004,103589,Cheng; Chung Kuan,9999,0,9999,0
1668187419444,ECE 200,005,103590,Cosman; Pamela C.,9999,0,9999,0
1668187419444,ECE 200,006,103591,Dayeh; Shadi Ahmad,9999,0,9999,0
1668187419444,ECE 200,007,103592,Fainman; Yeshaiahu,9999,0,9999,0
1668187419444,ECE 200,008,103593,Ford; Joseph Earl,9999,0,9999,0
1668187419444,ECE 200,009,103594,Franceschetti; Massimo,9999,0,9999,0
1668187419444,ECE 200,010,103595,Fullerton; Eric E,9999,0,9999,0
1668187419444,ECE 200,011,103596,Galton; Ian A,9999,0,9999,0
1668187419444,ECE 200,012,103597,Gilja; Vikash,9999,0,9999,0
1668187419444,ECE 200,013,103598,Hall; Drew A.,9999,0,9999,0
1668187419444,ECE 200,014,103599,Hsueh; Tzu-Chien,9999,0,9999,0
1668187419444,ECE 200,015,103600,Javidi; Tara,9999,0,9999,0
1668187419444,ECE 200,016,103601,Kahng; Andrew Byun,9999,0,9999,0
1668187419444,ECE 200,017,103602,Kim; Young-Han,9999,0,9999,0
1668187419444,ECE 200,018,103603,Koushanfar; Farinaz,9999,0,9999,0
1668187419444,ECE 200,019,103604,Kuzum; Duygu,9999,0,9999,0
1668187419444,ECE 200,020,103605,Le; Hanh-Phuc,9999,0,9999,0
1668187419444,ECE 200,021,103606,Lin; Bill,9999,0,9999,0
1668187419444,ECE 200,022,103607,Liu; Zhaowei,9998,0,9999,1
1668187419444,ECE 200,023,103608,Lo; Yu-Hwa,9999,0,9999,0
1668187419444,ECE 200,024,103609,Lomakin; Vitaliy,9999,0,9999,0
1668187419444,ECE 200,025,103610,Mercier; Patrick Philip,9999,0,9999,0
1668187419444,ECE 200,026,103611,Meyer; Florian,9999,0,9999,0
1668187419444,ECE 200,027,103612,Milstein; Laurence B.,9999,0,9999,0
1668187419444,ECE 200,028,103613,Mir Arabbaygi; Siavash,9999,0,9999,0
1668187419444,ECE 200,029,103614,Mookherjea; Shayan,9999,0,9999,0
1668187419444,ECE 200,030,103615,Morris; Karcher William,9999,0,9999,0
1668187419444,ECE 200,031,103616,Ng; Tse Nga,9999,0,9999,0
1668187419444,ECE 200,032,103617,Nguyen; Truong Quang,9999,0,9999,0
1668187419444,ECE 200,033,103618,Nomura; Kenji,9999,0,9999,0
1668187419444,ECE 200,034,103619,Orlitsky; Alon,9999,0,9999,0
1668187419444,ECE 200,035,103620,Pal; Piya,9999,0,9999,0
1668187419444,ECE 200,036,103621,Papen; George C.,9999,0,9999,0
1668187419444,ECE 200,037,103622,Radic; Stojan,9999,0,9999,0
1668187419444,ECE 200,038,103623,Rao; Bhaskar D.,9999,0,9999,0
1668187419444,ECE 200,039,103624,Rao; Ramesh R,9999,0,9999,0
1668187419444,ECE 200,040,103625,Rebeiz; Gabriel,9999,0,9999,0
1668187419444,ECE 200,041,103626,Sanford; John R,9999,0,9999,0
1668187419444,ECE 200,042,103627,Siegel; Paul H.,9999,0,9999,0
1668187419444,ECE 200,043,103628,Sievenpiper; Daniel F.,9999,0,9999,0
1668187419444,ECE 200,044,103629,Sworder; David D.,9999,0,9999,0
1668187419444,ECE 200,045,103630,Taur; Yuan,9999,0,9999,0
1668187419444,ECE 200,046,103631,Touri; Behrouz,9999,0,9999,0
1668187419444,ECE 200,047,103632,Trivedi; Mohan M.,9999,0,9999,0
1668187419444,ECE 200,048,103633,Vasconcelos; Nuno,9999,0,9999,0
1668187419444,ECE 200,049,103634,Wang; Xiaolong,9999,0,9999,0
1668187419444,ECE 200,050,103635,Xie; Pengtao,9999,0,9999,0
1668187419444,ECE 200,051,103636,Yip; Michael,9999,0,9999,0
1668187419444,ECE 200,052,103637,Zeger; Kenneth A.,999,0,999,0
1668187419444,ECE 200,053,103638,Zhang; Xinyu,9999,0,9999,0
1668187419444,ECE 200,054,103639,Turakhia; Yatish Girish,9999,0,9999,0
1668187419444,ECE 200,055,103640,Kang; Mingu,9999,0,9999,0
1668187419444,ECE 200,056,103641,Shi; Yuanyuan,9999,0,9999,0
1668187419444,ECE 200,057,103642,Wang; Edward Jay,9999,0,9999,0
1668187419444,ECE 200,058,103643,Zheng; Yang,9999,0,9999,0
1668187419880,ECE 202,A00,103644,Kuzum; Duygu,0,0,0,0
1668187420306,ECE 212BN,A00,103646,Ng; Tse Nga,0,0,0,0
1668187420729,ECE 221,A00,111493,Staff,0,0,0,0
1668187421152,ECE 222B,A00,103647,Lomakin; Vitaliy,0,0,0,0
1668187421574,ECE 230B,A00,103648,Taur; Yuan,0,0,0,0
1668187421998,ECE 238B,A00,103649,Garay; Javier,0,0,0,0
1668187422423,ECE 240B,A00,112900,Fainman; Yeshaiahu,0,0,0,0
1668187422849,ECE 247A,A00,103650,Jokerst; Jesse Vincent,0,0,0,0
1668187423272,ECE 247B,A00,103651,Wang; Joseph,0,0,0,0
1668187423699,ECE 250,A00,103652,Siegel; Paul H.,0,0,0,0
1668187424121,ECE 251A,A00,103654,Rao; Bhaskar D.,0,0,0,0
1668187424545,ECE 257B,A00,103655,Bharadia; Dinesh,0,0,0,0
1668187424981,ECE 258A,A00,103656,Milstein; Laurence B.,0,0,0,0
1668187425407,ECE 260B,A00,103658,Kang; Mingu,0,0,0,0
1668187425834,ECE 264A,A00,103659,Galton; Ian A,0,0,0,0
1668187426263,ECE 265A,A00,103661,Gudem; Prasad S.S.,0,0,0,0
1668187426687,ECE 265D,A00,103662,Gudem; Prasad S.S.,0,0,0,0
1668187427111,ECE 268,A00,103663,Koushanfar; Farinaz,0,0,0,0
1668187427539,ECE 269,A01,103665,Pal; Piya,0,0,0,0
1668187427962,ECE 271B,A00,103666,Vasconcelos; Manuela,0,0,0,0
1668187428386,ECE 276A,A00,103667,Atanasov; Nikolay A.,0,0,0,0
1668187428825,ECE 277,A00,103668,An; Cheolhong,0,0,0,0
1668187429256,ECE 279,A00,117947,Hall; Drew A.,0,0,0,0
1668187430118,ECE 283,A00,103670,Hsueh; Tzu-Chien,0,0,0,0
1668187430541,ECE 284,A00,103671,Turakhia; Yatish Girish,0,0,0,0
1668187430966,ECE 285,A00,103672,Zheng; Yang,0,0,0,0
1668187430966,ECE 285,B00,103673,Sworder; David D.,0,0,0,0
1668187431389,ECE 287,A00,103676,Javidi; Tara,0,0,0,0
1668187431818,MATH 200B,A00,098023,Salehi Golsefidy; Alireza,12,0,15,3
1668187432241,MATH 202B,A00,098024,Rhoades; Brendon Patrick,9,0,15,6
1668187432677,MATH 203B,A00,098025,Oprea; Dragos N.,10,0,15,5
1668187433103,MATH 204B,A00,098026,Sorensen; Claus M,13,0,15,2
1668187433530,MATH 208,A00,098027,Izadi; Elham,7,0,10,3
1668187433954,MATH 209,A00,098028,Pollack; Aaron,10,0,10,0
1668187434382,MATH 211A,A00,112919,Rogalski; Daniel,9,0,10,1
1668187434806,MATH 211B,A00,112920,Seward; Brandon M.,9,0,10,1
1668187435231,MATH 218,A00,098029,Li; Bo,10,0,10,0
1668187435656,MATH 220B,A00,098030,Novak; Jonathan I,11,0,15,4
1668187436180,MATH 221A,A00,098031,Ebenfelt; Peter F,13,0,15,2
1668187436615,MATH 231B,A00,098032,Zlatos; Andrej,12,0,15,3
1668187437046,MATH 240B,A00,098033,Ni; Lei,9,0,15,6
1668187437484,MATH 243,A00,098034,Jekel; David Andrew,10,0,10,0
1668187437916,MATH 245A,A00,098035,Nie; Jiawang,0,0,15,16
1668187438337,MATH 248,A00,098036,Bejenaru; Ioan,10,0,10,0
1668187438763,MATH 250B,A00,098037,Spolaor; Luca,14,0,15,1
1668187439185,MATH 258,A00,098038,Ni; Lei,10,0,10,0
1668187439607,MATH 264B,A00,098041,Rhoades; Brendon Patrick,9,0,15,6
1668187440037,MATH 268,A00,098042,Buss; Samuel R,10,0,10,0
1668187440459,MATH 269,A00,098043,Rhoades; Brendon Patrick,10,0,10,0
1668187440882,MATH 270B,A00,098044,Li; Bo,10,0,15,5
1668187441305,MATH 272B,A00,098045,Holst; Michael J,13,0,15,2
1668187441731,MATH 273A,A00,098046,Tian; Xiaochuan,10,0,15,5
1668187442164,MATH 275,A01,098048,Tian; Xiaochuan,6,0,10,4
1668187442590,MATH 278A,A00,098049,Holst; Michael J,8,0,10,2
1668187443026,MATH 278B,A00,098050,Cloninger; Alexander,10,0,10,0
1668187443453,MATH 278C,A00,098051,Nie; Jiawang,7,0,10,3
1668187443889,MATH 280B,A00,098052,Zheng; Tianyi,10,0,15,5
1668187444321,MATH 281B,A00,098053,Bradic; Jelena,2,0,15,13
1668187444756,MATH 282B,A00,098054,Arias-Castro; Ery,0,0,15,15
1668187445192,MATH 285,A00,098055,Fitzsimmons; Patrick J,0,0,15,17
1668187445627,MATH 287B,A00,098056,Arias-Castro; Ery,2,0,15,13
1668187446056,MATH 288,A00,098057,Agarwal; Pooja,9,0,10,1
1668187446056,MATH 288,B00,098058,Zhang; Danna,8,0,10,2
1668187446056,MATH 288,C00,098059,Williams; Ruth J,10,0,10,0
1668187446481,MATH 290B,A00,098060,Roberts; Justin Deritter,13,0,15,2
1668187446922,MATH 292,A00,098061,Belmont; Eva Kinoshita,10,0,10,0
1668187447354,MATH 295,A00,098062,Suk; Andrew Hoon,48,0,50,2
1668187447778,MATH 296,A00,098063,Novak; Jonathan I,20,0,20,0
1668187448201,MATH 297,001,098064,Gamst; Anthony Collins,9997,0,9999,2
1668187949632,COGS 205,A00,101395,Chiba; Andrea,19,0,20,1
1668187950056,COGS 210B,001,101404,Greene; Deanna Jacquelyn,9998,0,9999,1
1668187950056,COGS 210B,002,101417,Xia; Haijun,9999,0,9999,0
1668187950056,COGS 210B,003,101422,Nitz; Douglas A.,9999,0,9999,0
1668187950056,COGS 210B,004,101423,Hollan; James D.,9998,0,9999,1
1668187950056,COGS 210B,005,101424,Deak; Gedeon O.,9998,0,9999,1
1668187950056,COGS 210B,006,101425,Rossano; Federico,9999,0,9999,0
1668187950493,COGS 211B,A00,101427,Coulson; Seana M,9996,0,9999,3
1668187950917,COGS 220,A00,101428,Hollan; James D.,0,0,25,25
1668187951339,COGS 229,A00,101429,Dow; Steven P,18,0,25,7
1668187951762,COGS 230,A00,101430,Klemmer; Scott R,12,0,17,5
1668187952196,COGS 234,A00,101431,Xia; Haijun,3,0,25,22
1668187952632,COGS 260,A00,101432,Kiyonaga; Anastasia,20,0,25,5
1668187952632,COGS 260,B00,101433,Kirsh; David Joel,16,0,25,9
1668187953055,CSE 202,A00,102371,Impagliazzo; Russell,0,0,0,0
1668187953489,CSE 203B,A01,102373,Cheng; Chung Kuan,0,0,0,0
1668187953915,CSE 208,A00,102374,Micciancio; Daniele,0,0,0,0
1668187954339,CSE 209A,A00,112895,Impagliazzo; Russell,0,0,15,15
1668187954763,CSE 209B,A00,108005,Bellare; Mihir,0,0,0,0
1668187955198,CSE 210,A00,113163,Coblenz; Michael J,0,0,0,0
1668187955629,CSE 219,A00,106111,Dow; Steven P,0,0,20,20
1668187956056,CSE 221,A00,102376,Voelker; Geoffrey M.,0,0,0,0
1668187956481,CSE 224,A01,102378,Porter; George M,0,0,0,0
1668187956921,CSE 229A,A00,102379,Savage; Stefan,0,0,0,0
1668187957347,CSE 229C,A00,102380,Munyaka; Imani N. S.,0,0,0,0
1668187957882,CSE 232B,A00,102382,Deutsch; Alin Bernard,0,0,0,0
1668187958314,CSE 234,A01,112904,Kumar; Arun Kumar,0,0,0,0
1668187958740,CSE 237A,A00,102383,Rosing; Tajana Simunic,0,0,0,0
1668187959163,CSE 239A,A00,102384,Deutsch; Alin Bernard,0,0,0,0
1668187959589,CSE 239B,A00,102385,Polikarpova; Nadezhda,0,0,0,0
1668187960022,CSE 240A,A00,102386,Pannuto; Patrick William,0,0,0,0
1668187960447,CSE 240B,A00,102387,Zhao; Jishen,0,0,0,0
1668187960869,CSE 241A,A00,106406,Kang; Mingu,0,0,0,0
1668187961294,CSE 249B,A00,102388,Kahng; Andrew Byun,0,0,8,8
1668187961731,CSE 251B,A01,102392,Cottrell; Garrison W,0,0,0,0
1668187961731,CSE 251B,A02,102393,Cottrell; Garrison W,0,0,0,0
1668187962171,CSE 252B,A00,102394,Ochoa; Benjamin Lawrence,0,0,0,0
1668187962593,CSE 257,A01,102396,Gao; Sicun,0,0,0,0
1668187963020,CSE 272,A00,102397,Li; Tzumao,0,0,0,0
1668187963446,CSE 274,A00,111323,Chern; Albert Ren-Haur,0,0,0,0
1668187963872,CSE 282,A00,102398,Pevzner; Pavel Arkadjevich,0,0,0,0
1668187964296,CSE 284,A00,114175,Gymrek; Melissa Ann,0,0,0,0
1668187964719,CSE 290,A00,102399,Chandraker; Manmohan Krishna,0,0,0,0
1668187964719,CSE 290,B00,102400,Vaccaro; Kristen Marie,0,0,25,25
1668187964719,CSE 290,C00,102414,Pannuto; Patrick William,0,0,25,25
1668187964719,CSE 290,D00,102427,Pevzner; Pavel Arkadjevich,0,0,0,0
1668187964719,CSE 290,E00,102429,Zhao; Jishen,0,0,0,0
1668187964719,CSE 290,F00,102436,Tullsen; Dean Michael,0,0,0,0
1668187964719,CSE 290,G00,102440,Christensen; Henrik I,0,0,20,20
1668187965143,CSE 291,A00,102443,Su; Hao,0,0,0,0
1668187965143,CSE 291,B00,102448,Polikarpova; Nadezhda,0,0,0,0
1668187965143,CSE 291,C00,102453,Vaccaro; Kristen Marie,0,0,0,0
1668187965143,CSE 291,D00,111343,Savage; Stefan,0,0,0,0
1668187965143,CSE 291,E00,116474,Claffy; Kimberly Claire,0,0,0,0
1668187965143,CSE 291,F00,116479,Pasquale; Joseph,0,0,0,0
1668187965574,CSE 293,001,119111,Bafna; Vineet,9999,0,9999,0
1668187965574,CSE 293,002,119118,Bellare; Mihir,9999,0,9999,0
1668187965574,CSE 293,003,119122,Berg-Kirkpatrick; Taylor D,9999,0,9999,0
1668187965574,CSE 293,004,119135,Christensen; Henrik I,9999,0,9999,0
1668187965574,CSE 293,005,119142,Cottrell; Garrison W,9999,0,9999,0
1668187965574,CSE 293,006,119146,Deutsch; Alin Bernard,9999,0,9999,0
1668187965574,CSE 293,007,119159,Esmaeilzadeh; Hadi,9999,0,9999,0
1668187965574,CSE 293,008,119166,Freund; Yoav,9999,0,9999,0
1668187965574,CSE 293,009,119170,Griswold; William G.,9999,0,9999,0
1668187965574,CSE 293,010,119183,Gymrek; Melissa Ann,9999,0,9999,0
1668187965574,CSE 293,011,119190,Heninger; Nadia A,9999,0,9999,0
1668187965574,CSE 293,012,119230,Impagliazzo; Russell,9999,0,9999,0
1668187965574,CSE 293,013,119232,Jhala; Ranjit,9999,0,9999,0
1668187965574,CSE 293,014,119233,Kahng; Andrew Byun,9999,0,9999,0
1668187965574,CSE 293,015,119298,Kane; Daniel Mertz,9999,0,9999,0
1668187965574,CSE 293,016,119299,Kriegman; David J,9999,0,9999,0
1668187965574,CSE 293,017,119300,Kumar; Arun Kumar,9999,0,9999,0
1668187965574,CSE 293,018,119301,Lerner; Sorin,9999,0,9999,0
1668187965574,CSE 293,019,119302,Lovett; Shachar,9999,0,9999,0
1668187965574,CSE 293,020,119303,McAuley; Julian John,9999,0,9999,0
1668187965574,CSE 293,021,119304,Micciancio; Daniele,9999,0,9999,0
1668187965574,CSE 293,022,119367,Orailoglu; Alex,9999,0,9999,0
1668187965574,CSE 293,023,119382,Paturi; Ramamohan,9999,0,9999,0
1668187965574,CSE 293,024,119404,Polikarpova; Nadezhda,9999,0,9999,0
1668187965574,CSE 293,025,119406,Politz; Joseph Gibbs,9999,0,9999,0
1668187965574,CSE 293,026,119411,Porter; George M,9999,0,9999,0
1668187965574,CSE 293,027,119414,Porter; Leonard Emerson,9999,0,9999,0
1668187965574,CSE 293,028,119416,Ramamoorthi; Ravi,9999,0,9999,0
1668187965574,CSE 293,029,119417,Sahoo; Debashis,9999,0,9999,0
1668187965574,CSE 293,030,119420,Saul; Lawrence,9999,0,9999,0
1668187965574,CSE 293,031,119421,Savage; Stefan,9999,0,9999,0
1668187965574,CSE 293,032,119425,Schulze; Jurgen P.,9999,0,9999,0
1668187965574,CSE 293,033,119426,Snoeren; Alex C.,9999,0,9999,0
1668187965574,CSE 293,034,119428,Shang; Jingbo,9999,0,9999,0
1668187965574,CSE 293,035,119430,Stefan; Deian,9999,0,9999,0
1668187965574,CSE 293,036,119431,Su; Hao,9999,0,9999,0
1668187965574,CSE 293,037,119433,Swanson; Steven James,9999,0,9999,0
1668187965574,CSE 293,038,119435,Tullsen; Dean Michael,9999,0,9999,0
1668187965574,CSE 293,039,119483,Voelker; Geoffrey M.,9999,0,9999,0
1668187965574,CSE 293,040,119537,Zhao; Jishen,9999,0,9999,0
1668187965574,CSE 293,041,119538,Zhou; Yuan-Yuan,9999,0,9999,0
1668187965574,CSE 293,042,119539,Gao; Sicun,9999,0,9999,0
1668187965574,CSE 293,043,119540,Weibel; Nadir,9999,0,9999,0
1668187965574,CSE 293,044,119541,Gupta; Rajesh K.,9999,0,9999,0
1668187965574,CSE 293,045,126410,Vaccaro; Kristen Marie,9999,0,9999,0
1668187965574,CSE 293,046,126411,Klemke; Richard,9999,0,9999,0
1668187966000,CSE 294,A00,102459,Voelker; Geoffrey M.,0,0,0,0
1668187966000,CSE 294,B00,111322,Orailoglu; Alex,0,0,0,0
1668187966425,DSE 201,A00,096914,Deutsch; Alin Bernard,30,0,30,0
1668187966849,DSE 210,A00,096915,Dasgupta; Sanjoy,30,0,30,0
1668187967279,DSE 260A,A00,096916,Altintas De Callaf; Ilkay,30,0,30,0
1668187967708,ECE 200,001,103586,Antipa; Nicholas A,9999,0,9999,0
1668187967708,ECE 200,002,103587,Atanasov; Nikolay A.,9999,0,9999,0
1668187967708,ECE 200,003,103588,Bharadia; Dinesh,9999,0,9999,0
1668187967708,ECE 200,004,103589,Cheng; Chung Kuan,9999,0,9999,0
1668187967708,ECE 200,005,103590,Cosman; Pamela C.,9999,0,9999,0
1668187967708,ECE 200,006,103591,Dayeh; Shadi Ahmad,9999,0,9999,0
1668187967708,ECE 200,007,103592,Fainman; Yeshaiahu,9999,0,9999,0
1668187967708,ECE 200,008,103593,Ford; Joseph Earl,9999,0,9999,0
1668187967708,ECE 200,009,103594,Franceschetti; Massimo,9999,0,9999,0
1668187967708,ECE 200,010,103595,Fullerton; Eric E,9999,0,9999,0
1668187967708,ECE 200,011,103596,Galton; Ian A,9999,0,9999,0
1668187967708,ECE 200,012,103597,Gilja; Vikash,9999,0,9999,0
1668187967708,ECE 200,013,103598,Hall; Drew A.,9999,0,9999,0
1668187967708,ECE 200,014,103599,Hsueh; Tzu-Chien,9999,0,9999,0
1668187967708,ECE 200,015,103600,Javidi; Tara,9999,0,9999,0
1668187967708,ECE 200,016,103601,Kahng; Andrew Byun,9999,0,9999,0
1668187967708,ECE 200,017,103602,Kim; Young-Han,9999,0,9999,0
1668187967708,ECE 200,018,103603,Koushanfar; Farinaz,9999,0,9999,0
1668187967708,ECE 200,019,103604,Kuzum; Duygu,9999,0,9999,0
1668187967708,ECE 200,020,103605,Le; Hanh-Phuc,9999,0,9999,0
1668187967708,ECE 200,021,103606,Lin; Bill,9999,0,9999,0
1668187967708,ECE 200,022,103607,Liu; Zhaowei,9998,0,9999,1
1668187967708,ECE 200,023,103608,Lo; Yu-Hwa,9999,0,9999,0
1668187967708,ECE 200,024,103609,Lomakin; Vitaliy,9999,0,9999,0
1668187967708,ECE 200,025,103610,Mercier; Patrick Philip,9999,0,9999,0
1668187967708,ECE 200,026,103611,Meyer; Florian,9999,0,9999,0
1668187967708,ECE 200,027,103612,Milstein; Laurence B.,9999,0,9999,0
1668187967708,ECE 200,028,103613,Mir Arabbaygi; Siavash,9999,0,9999,0
1668187967708,ECE 200,029,103614,Mookherjea; Shayan,9999,0,9999,0
1668187967708,ECE 200,030,103615,Morris; Karcher William,9999,0,9999,0
1668187967708,ECE 200,031,103616,Ng; Tse Nga,9999,0,9999,0
1668187967708,ECE 200,032,103617,Nguyen; Truong Quang,9999,0,9999,0
1668187967708,ECE 200,033,103618,Nomura; Kenji,9999,0,9999,0
1668187967708,ECE 200,034,103619,Orlitsky; Alon,9999,0,9999,0
1668187967708,ECE 200,035,103620,Pal; Piya,9999,0,9999,0
1668187967708,ECE 200,036,103621,Papen; George C.,9999,0,9999,0
1668187967708,ECE 200,037,103622,Radic; Stojan,9999,0,9999,0
1668187967708,ECE 200,038,103623,Rao; Bhaskar D.,9999,0,9999,0
1668187967708,ECE 200,039,103624,Rao; Ramesh R,9999,0,9999,0
1668187967708,ECE 200,040,103625,Rebeiz; Gabriel,9999,0,9999,0
1668187967708,ECE 200,041,103626,Sanford; John R,9999,0,9999,0
1668187967708,ECE 200,042,103627,Siegel; Paul H.,9999,0,9999,0
1668187967708,ECE 200,043,103628,Sievenpiper; Daniel F.,9999,0,9999,0
1668187967708,ECE 200,044,103629,Sworder; David D.,9999,0,9999,0
1668187967708,ECE 200,045,103630,Taur; Yuan,9999,0,9999,0
1668187967708,ECE 200,046,103631,Touri; Behrouz,9999,0,9999,0
1668187967708,ECE 200,047,103632,Trivedi; Mohan M.,9999,0,9999,0
1668187967708,ECE 200,048,103633,Vasconcelos; Nuno,9999,0,9999,0
1668187967708,ECE 200,049,103634,Wang; Xiaolong,9999,0,9999,0
1668187967708,ECE 200,050,103635,Xie; Pengtao,9999,0,9999,0
1668187967708,ECE 200,051,103636,Yip; Michael,9999,0,9999,0
1668187967708,ECE 200,052,103637,Zeger; Kenneth A.,999,0,999,0
1668187967708,ECE 200,053,103638,Zhang; Xinyu,9999,0,9999,0
1668187967708,ECE 200,054,103639,Turakhia; Yatish Girish,9999,0,9999,0
1668187967708,ECE 200,055,103640,Kang; Mingu,9999,0,9999,0
1668187967708,ECE 200,056,103641,Shi; Yuanyuan,9999,0,9999,0
1668187967708,ECE 200,057,103642,Wang; Edward Jay,9999,0,9999,0
1668187967708,ECE 200,058,103643,Zheng; Yang,9999,0,9999,0
1668187968144,ECE 202,A00,103644,Kuzum; Duygu,0,0,0,0
1668187968572,ECE 212BN,A00,103646,Ng; Tse Nga,0,0,0,0
1668187968996,ECE 221,A00,111493,Staff,0,0,0,0
1668187969421,ECE 222B,A00,103647,Lomakin; Vitaliy,0,0,0,0
1668187969844,ECE 230B,A00,103648,Taur; Yuan,0,0,0,0
1668187970275,ECE 238B,A00,103649,Garay; Javier,0,0,0,0
1668187970700,ECE 240B,A00,112900,Fainman; Yeshaiahu,0,0,0,0
1668187971122,ECE 247A,A00,103650,Jokerst; Jesse Vincent,0,0,0,0
1668187971544,ECE 247B,A00,103651,Wang; Joseph,0,0,0,0
1668187971974,ECE 250,A00,103652,Siegel; Paul H.,0,0,0,0
1668187972401,ECE 251A,A00,103654,Rao; Bhaskar D.,0,0,0,0
1668187972823,ECE 257B,A00,103655,Bharadia; Dinesh,0,0,0,0
1668187973255,ECE 258A,A00,103656,Milstein; Laurence B.,0,0,0,0
1668187973680,ECE 260B,A00,103658,Kang; Mingu,0,0,0,0
1668187974104,ECE 264A,A00,103659,Galton; Ian A,0,0,0,0
1668187974526,ECE 265A,A00,103661,Gudem; Prasad S.S.,0,0,0,0
1668187974950,ECE 265D,A00,103662,Gudem; Prasad S.S.,0,0,0,0
1668187975380,ECE 268,A00,103663,Koushanfar; Farinaz,0,0,0,0
1668187975802,ECE 269,A01,103665,Pal; Piya,0,0,0,0
1668187976232,ECE 271B,A00,103666,Vasconcelos; Manuela,0,0,0,0
1668187976657,ECE 276A,A00,103667,Atanasov; Nikolay A.,0,0,0,0
1668187977082,ECE 277,A00,103668,An; Cheolhong,0,0,0,0
1668187977504,ECE 279,A00,117947,Hall; Drew A.,0,0,0,0
1668187978357,ECE 283,A00,103670,Hsueh; Tzu-Chien,0,0,0,0
1668187978783,ECE 284,A00,103671,Turakhia; Yatish Girish,0,0,0,0
1668187979210,ECE 285,A00,103672,Zheng; Yang,0,0,0,0
1668187979210,ECE 285,B00,103673,Sworder; David D.,0,0,0,0
1668187979633,ECE 287,A00,103676,Javidi; Tara,0,0,0,0
1668187980056,MATH 200B,A00,098023,Salehi Golsefidy; Alireza,12,0,15,3
1668187980479,MATH 202B,A00,098024,Rhoades; Brendon Patrick,9,0,15,6
1668187980904,MATH 203B,A00,098025,Oprea; Dragos N.,10,0,15,5
1668187981328,MATH 204B,A00,098026,Sorensen; Claus M,13,0,15,2
1668187981749,MATH 208,A00,098027,Izadi; Elham,7,0,10,3
1668187982174,MATH 209,A00,098028,Pollack; Aaron,10,0,10,0
1668187982602,MATH 211A,A00,112919,Rogalski; Daniel,9,0,10,1
1668187983032,MATH 211B,A00,112920,Seward; Brandon M.,9,0,10,1
1668187983454,MATH 218,A00,098029,Li; Bo,10,0,10,0
1668187983878,MATH 220B,A00,098030,Novak; Jonathan I,11,0,15,4
1668187984308,MATH 221A,A00,098031,Ebenfelt; Peter F,13,0,15,2
1668187984747,MATH 231B,A00,098032,Zlatos; Andrej,12,0,15,3
1668187985175,MATH 240B,A00,098033,Ni; Lei,9,0,15,6
1668187985601,MATH 243,A00,098034,Jekel; David Andrew,10,0,10,0
1668187986026,MATH 245A,A00,098035,Nie; Jiawang,0,0,15,16
1668187986452,MATH 248,A00,098036,Bejenaru; Ioan,10,0,10,0
1668187986878,MATH 250B,A00,098037,Spolaor; Luca,14,0,15,1
1668187987302,MATH 258,A00,098038,Ni; Lei,10,0,10,0
1668187987727,MATH 264B,A00,098041,Rhoades; Brendon Patrick,9,0,15,6
1668187988154,MATH 268,A00,098042,Buss; Samuel R,10,0,10,0
1668187988590,MATH 269,A00,098043,Rhoades; Brendon Patrick,10,0,10,0
1668187989034,MATH 270B,A00,098044,Li; Bo,10,0,15,5
1668187989457,MATH 272B,A00,098045,Holst; Michael J,13,0,15,2
1668187989886,MATH 273A,A00,098046,Tian; Xiaochuan,10,0,15,5
1668187990309,MATH 275,A01,098048,Tian; Xiaochuan,6,0,10,4
1668187990733,MATH 278A,A00,098049,Holst; Michael J,8,0,10,2
1668187991157,MATH 278B,A00,098050,Cloninger; Alexander,10,0,10,0
1668187991579,MATH 278C,A00,098051,Nie; Jiawang,7,0,10,3
1668187992008,MATH 280B,A00,098052,Zheng; Tianyi,10,0,15,5
1668187992432,MATH 281B,A00,098053,Bradic; Jelena,2,0,15,13
1668187992854,MATH 282B,A00,098054,Arias-Castro; Ery,0,0,15,15
1668187993278,MATH 285,A00,098055,Fitzsimmons; Patrick J,0,0,15,17
1668187993700,MATH 287B,A00,098056,Arias-Castro; Ery,2,0,15,13
1668187994123,MATH 288,A00,098057,Agarwal; Pooja,9,0,10,1
1668187994123,MATH 288,B00,098058,Zhang; Danna,8,0,10,2
1668187994123,MATH 288,C00,098059,Williams; Ruth J,10,0,10,0
1668187994555,MATH 290B,A00,098060,Roberts; Justin Deritter,13,0,15,2
1668187994992,MATH 292,A00,098061,Belmont; Eva Kinoshita,10,0,10,0
1668187995416,MATH 295,A00,098062,Suk; Andrew Hoon,48,0,50,2
1668187995842,MATH 296,A00,098063,Novak; Jonathan I,20,0,20,0
1668187996266,MATH 297,001,098064,Gamst; Anthony Collins,9997,0,9999,2
1668188797786,COGS 205,A00,101395,Chiba; Andrea,19,0,20,1
1668188798213,COGS 210B,001,101404,Greene; Deanna Jacquelyn,9998,0,9999,1
1668188798213,COGS 210B,002,101417,Xia; Haijun,9999,0,9999,0
1668188798213,COGS 210B,003,101422,Nitz; Douglas A.,9999,0,9999,0
1668188798213,COGS 210B,004,101423,Hollan; James D.,9998,0,9999,1
1668188798213,COGS 210B,005,101424,Deak; Gedeon O.,9998,0,9999,1
1668188798213,COGS 210B,006,101425,Rossano; Federico,9999,0,9999,0
1668188798635,COGS 211B,A00,101427,Coulson; Seana M,9996,0,9999,3
1668188799057,COGS 220,A00,101428,Hollan; James D.,0,0,25,25
1668188799479,COGS 229,A00,101429,Dow; Steven P,18,0,25,7
1668188799910,COGS 230,A00,101430,Klemmer; Scott R,12,0,17,5
1668188800346,COGS 234,A00,101431,Xia; Haijun,3,0,25,22
1668188800785,COGS 260,A00,101432,Kiyonaga; Anastasia,20,0,25,5
1668188800785,COGS 260,B00,101433,Kirsh; David Joel,16,0,25,9
1668188801210,CSE 202,A00,102371,Impagliazzo; Russell,0,0,0,0
1668188801643,CSE 203B,A01,102373,Cheng; Chung Kuan,0,0,0,0
1668188802066,CSE 208,A00,102374,Micciancio; Daniele,0,0,0,0
1668188802489,CSE 209A,A00,112895,Impagliazzo; Russell,0,0,15,15
1668188802914,CSE 209B,A00,108005,Bellare; Mihir,0,0,0,0
1668188803339,CSE 210,A00,113163,Coblenz; Michael J,0,0,0,0
1668188803764,CSE 219,A00,106111,Dow; Steven P,0,0,20,20
1668188804190,CSE 221,A00,102376,Voelker; Geoffrey M.,0,0,0,0
1668188804613,CSE 224,A01,102378,Porter; George M,0,0,0,0
1668188805041,CSE 229A,A00,102379,Savage; Stefan,0,0,0,0
1668188805465,CSE 229C,A00,102380,Munyaka; Imani N. S.,0,0,0,0
1668188805888,CSE 232B,A00,102382,Deutsch; Alin Bernard,0,0,0,0
1668188806315,CSE 234,A01,112904,Kumar; Arun Kumar,0,0,0,0
1668188806748,CSE 237A,A00,102383,Rosing; Tajana Simunic,0,0,0,0
1668188807174,CSE 239A,A00,102384,Deutsch; Alin Bernard,0,0,0,0
1668188807605,CSE 239B,A00,102385,Polikarpova; Nadezhda,0,0,0,0
1668188808030,CSE 240A,A00,102386,Pannuto; Patrick William,0,0,0,0
1668188808452,CSE 240B,A00,102387,Zhao; Jishen,0,0,0,0
1668188808875,CSE 241A,A00,106406,Kang; Mingu,0,0,0,0
1668188809299,CSE 249B,A00,102388,Kahng; Andrew Byun,0,0,8,8
1668188809722,CSE 251B,A01,102392,Cottrell; Garrison W,0,0,0,0
1668188809722,CSE 251B,A02,102393,Cottrell; Garrison W,0,0,0,0
1668188810154,CSE 252B,A00,102394,Ochoa; Benjamin Lawrence,0,0,0,0
1668188810592,CSE 257,A01,102396,Gao; Sicun,0,0,0,0
1668188811021,CSE 272,A00,102397,Li; Tzumao,0,0,0,0
1668188811445,CSE 274,A00,111323,Chern; Albert Ren-Haur,0,0,0,0
1668188811871,CSE 282,A00,102398,Pevzner; Pavel Arkadjevich,0,0,0,0
1668188812296,CSE 284,A00,114175,Gymrek; Melissa Ann,0,0,0,0
1668188812726,CSE 290,A00,102399,Chandraker; Manmohan Krishna,0,0,0,0
1668188812726,CSE 290,B00,102400,Vaccaro; Kristen Marie,0,0,25,25
1668188812726,CSE 290,C00,102414,Pannuto; Patrick William,0,0,25,25
1668188812726,CSE 290,D00,102427,Pevzner; Pavel Arkadjevich,0,0,0,0
1668188812726,CSE 290,E00,102429,Zhao; Jishen,0,0,0,0
1668188812726,CSE 290,F00,102436,Tullsen; Dean Michael,0,0,0,0
1668188812726,CSE 290,G00,102440,Christensen; Henrik I,0,0,20,20
1668188813152,CSE 291,A00,102443,Su; Hao,0,0,0,0
1668188813152,CSE 291,B00,102448,Polikarpova; Nadezhda,0,0,0,0
1668188813152,CSE 291,C00,102453,Vaccaro; Kristen Marie,0,0,0,0
1668188813152,CSE 291,D00,111343,Savage; Stefan,0,0,0,0
1668188813152,CSE 291,E00,116474,Claffy; Kimberly Claire,0,0,0,0
1668188813152,CSE 291,F00,116479,Pasquale; Joseph,0,0,0,0
1668188813580,CSE 293,001,119111,Bafna; Vineet,9999,0,9999,0
1668188813580,CSE 293,002,119118,Bellare; Mihir,9999,0,9999,0
1668188813580,CSE 293,003,119122,Berg-Kirkpatrick; Taylor D,9999,0,9999,0
1668188813580,CSE 293,004,119135,Christensen; Henrik I,9999,0,9999,0
1668188813580,CSE 293,005,119142,Cottrell; Garrison W,9999,0,9999,0
1668188813580,CSE 293,006,119146,Deutsch; Alin Bernard,9999,0,9999,0
1668188813580,CSE 293,007,119159,Esmaeilzadeh; Hadi,9999,0,9999,0
1668188813580,CSE 293,008,119166,Freund; Yoav,9999,0,9999,0
1668188813580,CSE 293,009,119170,Griswold; William G.,9999,0,9999,0
1668188813580,CSE 293,010,119183,Gymrek; Melissa Ann,9999,0,9999,0
1668188813580,CSE 293,011,119190,Heninger; Nadia A,9999,0,9999,0
1668188813580,CSE 293,012,119230,Impagliazzo; Russell,9999,0,9999,0
1668188813580,CSE 293,013,119232,Jhala; Ranjit,9999,0,9999,0
1668188813580,CSE 293,014,119233,Kahng; Andrew Byun,9999,0,9999,0
1668188813580,CSE 293,015,119298,Kane; Daniel Mertz,9999,0,9999,0
1668188813580,CSE 293,016,119299,Kriegman; David J,9999,0,9999,0
1668188813580,CSE 293,017,119300,Kumar; Arun Kumar,9999,0,9999,0
1668188813580,CSE 293,018,119301,Lerner; Sorin,9999,0,9999,0
1668188813580,CSE 293,019,119302,Lovett; Shachar,9999,0,9999,0
1668188813580,CSE 293,020,119303,McAuley; Julian John,9999,0,9999,0
1668188813580,CSE 293,021,119304,Micciancio; Daniele,9999,0,9999,0
1668188813580,CSE 293,022,119367,Orailoglu; Alex,9999,0,9999,0
1668188813580,CSE 293,023,119382,Paturi; Ramamohan,9999,0,9999,0
1668188813580,CSE 293,024,119404,Polikarpova; Nadezhda,9999,0,9999,0
1668188813580,CSE 293,025,119406,Politz; Joseph Gibbs,9999,0,9999,0
1668188813580,CSE 293,026,119411,Porter; George M,9999,0,9999,0
1668188813580,CSE 293,027,119414,Porter; Leonard Emerson,9999,0,9999,0
1668188813580,CSE 293,028,119416,Ramamoorthi; Ravi,9999,0,9999,0
1668188813580,CSE 293,029,119417,Sahoo; Debashis,9999,0,9999,0
1668188813580,CSE 293,030,119420,Saul; Lawrence,9999,0,9999,0
1668188813580,CSE 293,031,119421,Savage; Stefan,9999,0,9999,0
1668188813580,CSE 293,032,119425,Schulze; Jurgen P.,9999,0,9999,0
1668188813580,CSE 293,033,119426,Snoeren; Alex C.,9999,0,9999,0
1668188813580,CSE 293,034,119428,Shang; Jingbo,9999,0,9999,0
1668188813580,CSE 293,035,119430,Stefan; Deian,9999,0,9999,0
1668188813580,CSE 293,036,119431,Su; Hao,9999,0,9999,0
1668188813580,CSE 293,037,119433,Swanson; Steven James,9999,0,9999,0
1668188813580,CSE 293,038,119435,Tullsen; Dean Michael,9999,0,9999,0
1668188813580,CSE 293,039,119483,Voelker; Geoffrey M.,9999,0,9999,0
1668188813580,CSE 293,040,119537,Zhao; Jishen,9999,0,9999,0
1668188813580,CSE 293,041,119538,Zhou; Yuan-Yuan,9999,0,9999,0
1668188813580,CSE 293,042,119539,Gao; Sicun,9999,0,9999,0
1668188813580,CSE 293,043,119540,Weibel; Nadir,9999,0,9999,0
1668188813580,CSE 293,044,119541,Gupta; Rajesh K.,9999,0,9999,0
1668188813580,CSE 293,045,126410,Vaccaro; Kristen Marie,9999,0,9999,0
1668188813580,CSE 293,046,126411,Klemke; Richard,9999,0,9999,0
1668188814003,CSE 294,A00,102459,Voelker; Geoffrey M.,0,0,0,0
1668188814003,CSE 294,B00,111322,Orailoglu; Alex,0,0,0,0
1668188814430,DSE 201,A00,096914,Deutsch; Alin Bernard,30,0,30,0
1668188814854,DSE 210,A00,096915,Dasgupta; Sanjoy,30,0,30,0
1668188815286,DSE 260A,A00,096916,Altintas De Callaf; Ilkay,30,0,30,0
1668188815712,ECE 200,001,103586,Antipa; Nicholas A,9999,0,9999,0
1668188815712,ECE 200,002,103587,Atanasov; Nikolay A.,9999,0,9999,0
1668188815712,ECE 200,003,103588,Bharadia; Dinesh,9999,0,9999,0
1668188815712,ECE 200,004,103589,Cheng; Chung Kuan,9999,0,9999,0
1668188815712,ECE 200,005,103590,Cosman; Pamela C.,9999,0,9999,0
1668188815712,ECE 200,006,103591,Dayeh; Shadi Ahmad,9999,0,9999,0
1668188815712,ECE 200,007,103592,Fainman; Yeshaiahu,9999,0,9999,0
1668188815712,ECE 200,008,103593,Ford; Joseph Earl,9999,0,9999,0
1668188815712,ECE 200,009,103594,Franceschetti; Massimo,9999,0,9999,0
1668188815712,ECE 200,010,103595,Fullerton; Eric E,9999,0,9999,0
1668188815712,ECE 200,011,103596,Galton; Ian A,9999,0,9999,0
1668188815712,ECE 200,012,103597,Gilja; Vikash,9999,0,9999,0
1668188815712,ECE 200,013,103598,Hall; Drew A.,9999,0,9999,0
1668188815712,ECE 200,014,103599,Hsueh; Tzu-Chien,9999,0,9999,0
1668188815712,ECE 200,015,103600,Javidi; Tara,9999,0,9999,0
1668188815712,ECE 200,016,103601,Kahng; Andrew Byun,9999,0,9999,0
1668188815712,ECE 200,017,103602,Kim; Young-Han,9999,0,9999,0
1668188815712,ECE 200,018,103603,Koushanfar; Farinaz,9999,0,9999,0
1668188815712,ECE 200,019,103604,Kuzum; Duygu,9999,0,9999,0
1668188815712,ECE 200,020,103605,Le; Hanh-Phuc,9999,0,9999,0
1668188815712,ECE 200,021,103606,Lin; Bill,9999,0,9999,0
1668188815712,ECE 200,022,103607,Liu; Zhaowei,9998,0,9999,1
1668188815712,ECE 200,023,103608,Lo; Yu-Hwa,9999,0,9999,0
1668188815712,ECE 200,024,103609,Lomakin; Vitaliy,9999,0,9999,0
1668188815712,ECE 200,025,103610,Mercier; Patrick Philip,9999,0,9999,0
1668188815712,ECE 200,026,103611,Meyer; Florian,9999,0,9999,0
1668188815712,ECE 200,027,103612,Milstein; Laurence B.,9999,0,9999,0
1668188815712,ECE 200,028,103613,Mir Arabbaygi; Siavash,9999,0,9999,0
1668188815712,ECE 200,029,103614,Mookherjea; Shayan,9999,0,9999,0
1668188815712,ECE 200,030,103615,Morris; Karcher William,9999,0,9999,0
1668188815712,ECE 200,031,103616,Ng; Tse Nga,9999,0,9999,0
1668188815712,ECE 200,032,103617,Nguyen; Truong Quang,9999,0,9999,0
1668188815712,ECE 200,033,103618,Nomura; Kenji,9999,0,9999,0
1668188815712,ECE 200,034,103619,Orlitsky; Alon,9999,0,9999,0
1668188815712,ECE 200,035,103620,Pal; Piya,9999,0,9999,0
1668188815712,ECE 200,036,103621,Papen; George C.,9999,0,9999,0
1668188815712,ECE 200,037,103622,Radic; Stojan,9999,0,9999,0
1668188815712,ECE 200,038,103623,Rao; Bhaskar D.,9999,0,9999,0
1668188815712,ECE 200,039,103624,Rao; Ramesh R,9999,0,9999,0
1668188815712,ECE 200,040,103625,Rebeiz; Gabriel,9999,0,9999,0
1668188815712,ECE 200,041,103626,Sanford; John R,9999,0,9999,0
1668188815712,ECE 200,042,103627,Siegel; Paul H.,9999,0,9999,0
1668188815712,ECE 200,043,103628,Sievenpiper; Daniel F.,9999,0,9999,0
1668188815712,ECE 200,044,103629,Sworder; David D.,9999,0,9999,0
1668188815712,ECE 200,045,103630,Taur; Yuan,9999,0,9999,0
1668188815712,ECE 200,046,103631,Touri; Behrouz,9999,0,9999,0
1668188815712,ECE 200,047,103632,Trivedi; Mohan M.,9999,0,9999,0
1668188815712,ECE 200,048,103633,Vasconcelos; Nuno,9999,0,9999,0
1668188815712,ECE 200,049,103634,Wang; Xiaolong,9999,0,9999,0
1668188815712,ECE 200,050,103635,Xie; Pengtao,9999,0,9999,0
1668188815712,ECE 200,051,103636,Yip; Michael,9999,0,9999,0
1668188815712,ECE 200,052,103637,Zeger; Kenneth A.,999,0,999,0
1668188815712,ECE 200,053,103638,Zhang; Xinyu,9999,0,9999,0
1668188815712,ECE 200,054,103639,Turakhia; Yatish Girish,9999,0,9999,0
1668188815712,ECE 200,055,103640,Kang; Mingu,9999,0,9999,0
1668188815712,ECE 200,056,103641,Shi; Yuanyuan,9999,0,9999,0
1668188815712,ECE 200,057,103642,Wang; Edward Jay,9999,0,9999,0
1668188815712,ECE 200,058,103643,Zheng; Yang,9999,0,9999,0
1668188816139,ECE 202,A00,103644,Kuzum; Duygu,0,0,0,0
1668188816562,ECE 212BN,A00,103646,Ng; Tse Nga,0,0,0,0
1668188816991,ECE 221,A00,111493,Staff,0,0,0,0
1668188817415,ECE 222B,A00,103647,Lomakin; Vitaliy,0,0,0,0
1668188817845,ECE 230B,A00,103648,Taur; Yuan,0,0,0,0
1668188818271,ECE 238B,A00,103649,Garay; Javier,0,0,0,0
1668188818695,ECE 240B,A00,112900,Fainman; Yeshaiahu,0,0,0,0
1668188819117,ECE 247A,A00,103650,Jokerst; Jesse Vincent,0,0,0,0
1668188819546,ECE 247B,A00,103651,Wang; Joseph,0,0,0,0
1668188819970,ECE 250,A00,103652,Siegel; Paul H.,0,0,0,0
1668188820403,ECE 251A,A00,103654,Rao; Bhaskar D.,0,0,0,0
1668188820830,ECE 257B,A00,103655,Bharadia; Dinesh,0,0,0,0
1668188821266,ECE 258A,A00,103656,Milstein; Laurence B.,0,0,0,0
1668188821703,ECE 260B,A00,103658,Kang; Mingu,0,0,0,0
1668188822145,ECE 264A,A00,103659,Galton; Ian A,0,0,0,0
1668188822583,ECE 265A,A00,103661,Gudem; Prasad S.S.,0,0,0,0
1668188823015,ECE 265D,A00,103662,Gudem; Prasad S.S.,0,0,0,0
1668188823443,ECE 268,A00,103663,Koushanfar; Farinaz,0,0,0,0
1668188823866,ECE 269,A01,103665,Pal; Piya,0,0,0,0
1668188824294,ECE 271B,A00,103666,Vasconcelos; Manuela,0,0,0,0
1668188824723,ECE 276A,A00,103667,Atanasov; Nikolay A.,0,0,0,0
1668188825154,ECE 277,A00,103668,An; Cheolhong,0,0,0,0
1668188825584,ECE 279,A00,117947,Hall; Drew A.,0,0,0,0
1668188826433,ECE 283,A00,103670,Hsueh; Tzu-Chien,0,0,0,0
1668188826866,ECE 284,A00,103671,Turakhia; Yatish Girish,0,0,0,0
1668188827382,ECE 285,A00,103672,Zheng; Yang,0,0,0,0
1668188827382,ECE 285,B00,103673,Sworder; David D.,0,0,0,0
1668188827805,ECE 287,A00,103676,Javidi; Tara,0,0,0,0
1668188828229,MATH 200B,A00,098023,Salehi Golsefidy; Alireza,12,0,15,3
1668188828654,MATH 202B,A00,098024,Rhoades; Brendon Patrick,9,0,15,6
1668188829077,MATH 203B,A00,098025,Oprea; Dragos N.,10,0,15,5
1668188829502,MATH 204B,A00,098026,Sorensen; Claus M,13,0,15,2
1668188829942,MATH 208,A00,098027,Izadi; Elham,7,0,10,3
1668188830373,MATH 209,A00,098028,Pollack; Aaron,10,0,10,0
1668188830797,MATH 211A,A00,112919,Rogalski; Daniel,9,0,10,1
1668188831219,MATH 211B,A00,112920,Seward; Brandon M.,9,0,10,1
1668188831645,MATH 218,A00,098029,Li; Bo,10,0,10,0
1668188832069,MATH 220B,A00,098030,Novak; Jonathan I,11,0,15,4
1668188832493,MATH 221A,A00,098031,Ebenfelt; Peter F,13,0,15,2
1668188832918,MATH 231B,A00,098032,Zlatos; Andrej,12,0,15,3
1668188833342,MATH 240B,A00,098033,Ni; Lei,9,0,15,6
1668188833771,MATH 243,A00,098034,Jekel; David Andrew,10,0,10,0
1668188834194,MATH 245A,A00,098035,Nie; Jiawang,0,0,15,16
1668188834620,MATH 248,A00,098036,Bejenaru; Ioan,10,0,10,0
1668188835047,MATH 250B,A00,098037,Spolaor; Luca,14,0,15,1
1668188835481,MATH 258,A00,098038,Ni; Lei,10,0,10,0
1668188835912,MATH 264B,A00,098041,Rhoades; Brendon Patrick,9,0,15,6
1668188836339,MATH 268,A00,098042,Buss; Samuel R,10,0,10,0
1668188836764,MATH 269,A00,098043,Rhoades; Brendon Patrick,10,0,10,0
1668188837187,MATH 270B,A00,098044,Li; Bo,10,0,15,5
1668188837610,MATH 272B,A00,098045,Holst; Michael J,13,0,15,2
1668188838034,MATH 273A,A00,098046,Tian; Xiaochuan,10,0,15,5
1668188838460,MATH 275,A01,098048,Tian; Xiaochuan,6,0,10,4
1668188838881,MATH 278A,A00,098049,Holst; Michael J,8,0,10,2
1668188839305,MATH 278B,A00,098050,Cloninger; Alexander,10,0,10,0
1668188839734,MATH 278C,A00,098051,Nie; Jiawang,7,0,10,3
1668188840168,MATH 280B,A00,098052,Zheng; Tianyi,10,0,15,5
1668188840602,MATH 281B,A00,098053,Bradic; Jelena,2,0,15,13
1668188841028,MATH 282B,A00,098054,Arias-Castro; Ery,0,0,15,15
1668188841455,MATH 285,A00,098055,Fitzsimmons; Patrick J,0,0,15,17
1668188841883,MATH 287B,A00,098056,Arias-Castro; Ery,2,0,15,13
1668188842321,MATH 288,A00,098057,Agarwal; Pooja,9,0,10,1
1668188842321,MATH 288,B00,098058,Zhang; Danna,8,0,10,2
1668188842321,MATH 288,C00,098059,Williams; Ruth J,10,0,10,0
1668188842750,MATH 290B,A00,098060,Roberts; Justin Deritter,13,0,15,2
1668188843177,MATH 292,A00,098061,Belmont; Eva Kinoshita,10,0,10,0
1668188843601,MATH 295,A00,098062,Suk; Andrew Hoon,48,0,50,2
1668188844027,MATH 296,A00,098063,Novak; Jonathan I,20,0,20,0
1668188844449,MATH 297,001,098064,Gamst; Anthony Collins,9997,0,9999,2
1668189345976,COGS 205,A00,101395,Chiba; Andrea,19,0,20,1
1668189346400,COGS 210B,001,101404,Greene; Deanna Jacquelyn,9998,0,9999,1
1668189346400,COGS 210B,002,101417,Xia; Haijun,9999,0,9999,0
1668189346400,COGS 210B,003,101422,Nitz; Douglas A.,9999,0,9999,0
1668189346400,COGS 210B,004,101423,Hollan; James D.,9998,0,9999,1
1668189346400,COGS 210B,005,101424,Deak; Gedeon O.,9998,0,9999,1
1668189346400,COGS 210B,006,101425,Rossano; Federico,9999,0,9999,0
1668189346823,COGS 211B,A00,101427,Coulson; Seana M,9996,0,9999,3
1668189347250,COGS 220,A00,101428,Hollan; James D.,0,0,25,25
1668189347674,COGS 229,A00,101429,Dow; Steven P,18,0,25,7
1668189348098,COGS 230,A00,101430,Klemmer; Scott R,12,0,17,5
1668189348533,COGS 234,A00,101431,Xia; Haijun,3,0,25,22
1668189349041,COGS 260,A00,101432,Kiyonaga; Anastasia,20,0,25,5
1668189349041,COGS 260,B00,101433,Kirsh; David Joel,16,0,25,9
1668189349465,CSE 202,A00,102371,Impagliazzo; Russell,0,0,0,0
1668189349894,CSE 203B,A01,102373,Cheng; Chung Kuan,0,0,0,0
1668189350316,CSE 208,A00,102374,Micciancio; Daniele,0,0,0,0
1668189350738,CSE 209A,A00,112895,Impagliazzo; Russell,0,0,15,15
1668189351163,CSE 209B,A00,108005,Bellare; Mihir,0,0,0,0
1668189351583,CSE 210,A00,113163,Coblenz; Michael J,0,0,0,0
1668189352006,CSE 219,A00,106111,Dow; Steven P,0,0,20,20
1668189352430,CSE 221,A00,102376,Voelker; Geoffrey M.,0,0,0,0
1668189352853,CSE 224,A01,102378,Porter; George M,0,0,0,0
1668189353275,CSE 229A,A00,102379,Savage; Stefan,0,0,0,0
1668189353698,CSE 229C,A00,102380,Munyaka; Imani N. S.,0,0,0,0
1668189354119,CSE 232B,A00,102382,Deutsch; Alin Bernard,0,0,0,0
1668189354547,CSE 234,A01,112904,Kumar; Arun Kumar,0,0,0,0
1668189354971,CSE 237A,A00,102383,Rosing; Tajana Simunic,0,0,0,0
1668189355400,CSE 239A,A00,102384,Deutsch; Alin Bernard,0,0,0,0
1668189355825,CSE 239B,A00,102385,Polikarpova; Nadezhda,0,0,0,0
1668189356249,CSE 240A,A00,102386,Pannuto; Patrick William,0,0,0,0
1668189356673,CSE 240B,A00,102387,Zhao; Jishen,0,0,0,0
1668189357097,CSE 241A,A00,106406,Kang; Mingu,0,0,0,0
1668189357522,CSE 249B,A00,102388,Kahng; Andrew Byun,0,0,8,8
1668189357955,CSE 251B,A01,102392,Cottrell; Garrison W,0,0,0,0
1668189357955,CSE 251B,A02,102393,Cottrell; Garrison W,0,0,0,0
1668189358378,CSE 252B,A00,102394,Ochoa; Benjamin Lawrence,0,0,0,0
1668189358801,CSE 257,A01,102396,Gao; Sicun,0,0,0,0
1668189359226,CSE 272,A00,102397,Li; Tzumao,0,0,0,0
1668189359659,CSE 274,A00,111323,Chern; Albert Ren-Haur,0,0,0,0
1668189360085,CSE 282,A00,102398,Pevzner; Pavel Arkadjevich,0,0,0,0
1668189360511,CSE 284,A00,114175,Gymrek; Melissa Ann,0,0,0,0
1668189360944,CSE 290,A00,102399,Chandraker; Manmohan Krishna,0,0,0,0
1668189360944,CSE 290,B00,102400,Vaccaro; Kristen Marie,0,0,25,25
1668189360944,CSE 290,C00,102414,Pannuto; Patrick William,0,0,25,25
1668189360944,CSE 290,D00,102427,Pevzner; Pavel Arkadjevich,0,0,0,0
1668189360944,CSE 290,E00,102429,Zhao; Jishen,0,0,0,0
1668189360944,CSE 290,F00,102436,Tullsen; Dean Michael,0,0,0,0
1668189360944,CSE 290,G00,102440,Christensen; Henrik I,0,0,20,20
1668189361376,CSE 291,A00,102443,Su; Hao,0,0,0,0
1668189361376,CSE 291,B00,102448,Polikarpova; Nadezhda,0,0,0,0
1668189361376,CSE 291,C00,102453,Vaccaro; Kristen Marie,0,0,0,0
1668189361376,CSE 291,D00,111343,Savage; Stefan,0,0,0,0
1668189361376,CSE 291,E00,116474,Claffy; Kimberly Claire,0,0,0,0
1668189361376,CSE 291,F00,116479,Pasquale; Joseph,0,0,0,0
1668189361822,CSE 293,001,119111,Bafna; Vineet,9999,0,9999,0
1668189361822,CSE 293,002,119118,Bellare; Mihir,9999,0,9999,0
1668189361822,CSE 293,003,119122,Berg-Kirkpatrick; Taylor D,9999,0,9999,0
1668189361822,CSE 293,004,119135,Christensen; Henrik I,9999,0,9999,0
1668189361822,CSE 293,005,119142,Cottrell; Garrison W,9999,0,9999,0
1668189361822,CSE 293,006,119146,Deutsch; Alin Bernard,9999,0,9999,0
1668189361822,CSE 293,007,119159,Esmaeilzadeh; Hadi,9999,0,9999,0
1668189361822,CSE 293,008,119166,Freund; Yoav,9999,0,9999,0
1668189361822,CSE 293,009,119170,Griswold; William G.,9999,0,9999,0
1668189361822,CSE 293,010,119183,Gymrek; Melissa Ann,9999,0,9999,0
1668189361822,CSE 293,011,119190,Heninger; Nadia A,9999,0,9999,0
1668189361822,CSE 293,012,119230,Impagliazzo; Russell,9999,0,9999,0
1668189361822,CSE 293,013,119232,Jhala; Ranjit,9999,0,9999,0
1668189361822,CSE 293,014,119233,Kahng; Andrew Byun,9999,0,9999,0
1668189361822,CSE 293,015,119298,Kane; Daniel Mertz,9999,0,9999,0
1668189361822,CSE 293,016,119299,Kriegman; David J,9999,0,9999,0
1668189361822,CSE 293,017,119300,Kumar; Arun Kumar,9999,0,9999,0
1668189361822,CSE 293,018,119301,Lerner; Sorin,9999,0,9999,0
1668189361822,CSE 293,019,119302,Lovett; Shachar,9999,0,9999,0
1668189361822,CSE 293,020,119303,McAuley; Julian John,9999,0,9999,0
1668189361822,CSE 293,021,119304,Micciancio; Daniele,9999,0,9999,0
1668189361822,CSE 293,022,119367,Orailoglu; Alex,9999,0,9999,0
1668189361822,CSE 293,023,119382,Paturi; Ramamohan,9999,0,9999,0
1668189361822,CSE 293,024,119404,Polikarpova; Nadezhda,9999,0,9999,0
1668189361822,CSE 293,025,119406,Politz; Joseph Gibbs,9999,0,9999,0
1668189361822,CSE 293,026,119411,Porter; George M,9999,0,9999,0
1668189361822,CSE 293,027,119414,Porter; Leonard Emerson,9999,0,9999,0
1668189361822,CSE 293,028,119416,Ramamoorthi; Ravi,9999,0,9999,0
1668189361822,CSE 293,029,119417,Sahoo; Debashis,9999,0,9999,0
1668189361822,CSE 293,030,119420,Saul; Lawrence,9999,0,9999,0
1668189361822,CSE 293,031,119421,Savage; Stefan,9999,0,9999,0
1668189361822,CSE 293,032,119425,Schulze; Jurgen P.,9999,0,9999,0
1668189361822,CSE 293,033,119426,Snoeren; Alex C.,9999,0,9999,0
1668189361822,CSE 293,034,119428,Shang; Jingbo,9999,0,9999,0
1668189361822,CSE 293,035,119430,Stefan; Deian,9999,0,9999,0
1668189361822,CSE 293,036,119431,Su; Hao,9999,0,9999,0
1668189361822,CSE 293,037,119433,Swanson; Steven James,9999,0,9999,0
1668189361822,CSE 293,038,119435,Tullsen; Dean Michael,9999,0,9999,0
1668189361822,CSE 293,039,119483,Voelker; Geoffrey M.,9999,0,9999,0
1668189361822,CSE 293,040,119537,Zhao; Jishen,9999,0,9999,0
1668189361822,CSE 293,041,119538,Zhou; Yuan-Yuan,9999,0,9999,0
1668189361822,CSE 293,042,119539,Gao; Sicun,9999,0,9999,0
1668189361822,CSE 293,043,119540,Weibel; Nadir,9999,0,9999,0
1668189361822,CSE 293,044,119541,Gupta; Rajesh K.,9999,0,9999,0
1668189361822,CSE 293,045,126410,Vaccaro; Kristen Marie,9999,0,9999,0
1668189361822,CSE 293,046,126411,Klemke; Richard,9999,0,9999,0
1668189362251,CSE 294,A00,102459,Voelker; Geoffrey M.,0,0,0,0
1668189362251,CSE 294,B00,111322,Orailoglu; Alex,0,0,0,0
1668189362675,DSE 201,A00,096914,Deutsch; Alin Bernard,30,0,30,0
1668189363103,DSE 210,A00,096915,Dasgupta; Sanjoy,30,0,30,0
1668189363528,DSE 260A,A00,096916,Altintas De Callaf; Ilkay,30,0,30,0
1668189363983,ECE 200,001,103586,Antipa; Nicholas A,9999,0,9999,0
1668189363983,ECE 200,002,103587,Atanasov; Nikolay A.,9999,0,9999,0
1668189363983,ECE 200,003,103588,Bharadia; Dinesh,9999,0,9999,0
1668189363983,ECE 200,004,103589,Cheng; Chung Kuan,9999,0,9999,0
1668189363983,ECE 200,005,103590,Cosman; Pamela C.,9999,0,9999,0
1668189363983,ECE 200,006,103591,Dayeh; Shadi Ahmad,9999,0,9999,0
1668189363983,ECE 200,007,103592,Fainman; Yeshaiahu,9999,0,9999,0
1668189363983,ECE 200,008,103593,Ford; Joseph Earl,9999,0,9999,0
1668189363983,ECE 200,009,103594,Franceschetti; Massimo,9999,0,9999,0
1668189363983,ECE 200,010,103595,Fullerton; Eric E,9999,0,9999,0
1668189363983,ECE 200,011,103596,Galton; Ian A,9999,0,9999,0
1668189363983,ECE 200,012,103597,Gilja; Vikash,9999,0,9999,0
1668189363983,ECE 200,013,103598,Hall; Drew A.,9999,0,9999,0
1668189363983,ECE 200,014,103599,Hsueh; Tzu-Chien,9999,0,9999,0
1668189363983,ECE 200,015,103600,Javidi; Tara,9999,0,9999,0
1668189363983,ECE 200,016,103601,Kahng; Andrew Byun,9999,0,9999,0
1668189363983,ECE 200,017,103602,Kim; Young-Han,9999,0,9999,0
1668189363983,ECE 200,018,103603,Koushanfar; Farinaz,9999,0,9999,0
1668189363983,ECE 200,019,103604,Kuzum; Duygu,9999,0,9999,0
1668189363983,ECE 200,020,103605,Le; Hanh-Phuc,9999,0,9999,0
1668189363983,ECE 200,021,103606,Lin; Bill,9999,0,9999,0
1668189363983,ECE 200,022,103607,Liu; Zhaowei,9998,0,9999,1
1668189363983,ECE 200,023,103608,Lo; Yu-Hwa,9999,0,9999,0
1668189363983,ECE 200,024,103609,Lomakin; Vitaliy,9999,0,9999,0
1668189363983,ECE 200,025,103610,Mercier; Patrick Philip,9999,0,9999,0
1668189363983,ECE 200,026,103611,Meyer; Florian,9999,0,9999,0
1668189363983,ECE 200,027,103612,Milstein; Laurence B.,9999,0,9999,0
1668189363983,ECE 200,028,103613,Mir Arabbaygi; Siavash,9999,0,9999,0
1668189363983,ECE 200,029,103614,Mookherjea; Shayan,9999,0,9999,0
1668189363983,ECE 200,030,103615,Morris; Karcher William,9999,0,9999,0
1668189363983,ECE 200,031,103616,Ng; Tse Nga,9999,0,9999,0
1668189363983,ECE 200,032,103617,Nguyen; Truong Quang,9999,0,9999,0
1668189363983,ECE 200,033,103618,Nomura; Kenji,9999,0,9999,0
1668189363983,ECE 200,034,103619,Orlitsky; Alon,9999,0,9999,0
1668189363983,ECE 200,035,103620,Pal; Piya,9999,0,9999,0
1668189363983,ECE 200,036,103621,Papen; George C.,9999,0,9999,0
1668189363983,ECE 200,037,103622,Radic; Stojan,9999,0,9999,0
1668189363983,ECE 200,038,103623,Rao; Bhaskar D.,9999,0,9999,0
1668189363983,ECE 200,039,103624,Rao; Ramesh R,9999,0,9999,0
1668189363983,ECE 200,040,103625,Rebeiz; Gabriel,9999,0,9999,0
1668189363983,ECE 200,041,103626,Sanford; John R,9999,0,9999,0
1668189363983,ECE 200,042,103627,Siegel; Paul H.,9999,0,9999,0
1668189363983,ECE 200,043,103628,Sievenpiper; Daniel F.,9999,0,9999,0
1668189363983,ECE 200,044,103629,Sworder; David D.,9999,0,9999,0
1668189363983,ECE 200,045,103630,Taur; Yuan,9999,0,9999,0
1668189363983,ECE 200,046,103631,Touri; Behrouz,9999,0,9999,0
1668189363983,ECE 200,047,103632,Trivedi; Mohan M.,9999,0,9999,0
1668189363983,ECE 200,048,103633,Vasconcelos; Nuno,9999,0,9999,0
1668189363983,ECE 200,049,103634,Wang; Xiaolong,9999,0,9999,0
1668189363983,ECE 200,050,103635,Xie; Pengtao,9999,0,9999,0
1668189363983,ECE 200,051,103636,Yip; Michael,9999,0,9999,0
1668189363983,ECE 200,052,103637,Zeger; Kenneth A.,999,0,999,0
1668189363983,ECE 200,053,103638,Zhang; Xinyu,9999,0,9999,0
1668189363983,ECE 200,054,103639,Turakhia; Yatish Girish,9999,0,9999,0
1668189363983,ECE 200,055,103640,Kang; Mingu,9999,0,9999,0
1668189363983,ECE 200,056,103641,Shi; Yuanyuan,9999,0,9999,0
1668189363983,ECE 200,057,103642,Wang; Edward Jay,9999,0,9999,0
1668189363983,ECE 200,058,103643,Zheng; Yang,9999,0,9999,0
1668189364418,ECE 202,A00,103644,Kuzum; Duygu,0,0,0,0
1668189364850,ECE 212BN,A00,103646,Ng; Tse Nga,0,0,0,0
1668189365273,ECE 221,A00,111493,Staff,0,0,0,0
1668189365699,ECE 222B,A00,103647,Lomakin; Vitaliy,0,0,0,0
1668189366124,ECE 230B,A00,103648,Taur; Yuan,0,0,0,0
1668189366548,ECE 238B,A00,103649,Garay; Javier,0,0,0,0
1668189366974,ECE 240B,A00,112900,Fainman; Yeshaiahu,0,0,0,0
1668189367403,ECE 247A,A00,103650,Jokerst; Jesse Vincent,0,0,0,0
1668189367832,ECE 247B,A00,103651,Wang; Joseph,0,0,0,0
1668189368256,ECE 250,A00,103652,Siegel; Paul H.,0,0,0,0
1668189368687,ECE 251A,A00,103654,Rao; Bhaskar D.,0,0,0,0
1668189369136,ECE 257B,A00,103655,Bharadia; Dinesh,0,0,0,0
1668189369565,ECE 258A,A00,103656,Milstein; Laurence B.,0,0,0,0
1668189369990,ECE 260B,A00,103658,Kang; Mingu,0,0,0,0
1668189370430,ECE 264A,A00,103659,Galton; Ian A,0,0,0,0
1668189370864,ECE 265A,A00,103661,Gudem; Prasad S.S.,0,0,0,0
1668189371287,ECE 265D,A00,103662,Gudem; Prasad S.S.,0,0,0,0
1668189371709,ECE 268,A00,103663,Koushanfar; Farinaz,0,0,0,0
1668189372133,ECE 269,A01,103665,Pal; Piya,0,0,0,0
1668189372573,ECE 271B,A00,103666,Vasconcelos; Manuela,0,0,0,0
1668189372999,ECE 276A,A00,103667,Atanasov; Nikolay A.,0,0,0,0
1668189373425,ECE 277,A00,103668,An; Cheolhong,0,0,0,0
1668189373849,ECE 279,A00,117947,Hall; Drew A.,0,0,0,0
1668189374698,ECE 283,A00,103670,Hsueh; Tzu-Chien,0,0,0,0
1668189375125,ECE 284,A00,103671,Turakhia; Yatish Girish,0,0,0,0
1668189375549,ECE 285,A00,103672,Zheng; Yang,0,0,0,0
1668189375549,ECE 285,B00,103673,Sworder; David D.,0,0,0,0
1668189375974,ECE 287,A00,103676,Javidi; Tara,0,0,0,0
1668189376411,MATH 200B,A00,098023,Salehi Golsefidy; Alireza,12,0,15,3
1668189376850,MATH 202B,A00,098024,Rhoades; Brendon Patrick,9,0,15,6
1668189377274,MATH 203B,A00,098025,Oprea; Dragos N.,10,0,15,5
1668189377698,MATH 204B,A00,098026,Sorensen; Claus M,13,0,15,2
1668189378124,MATH 208,A00,098027,Izadi; Elham,7,0,10,3
1668189378549,MATH 209,A00,098028,Pollack; Aaron,10,0,10,0
1668189378978,MATH 211A,A00,112919,Rogalski; Daniel,9,0,10,1
1668189379403,MATH 211B,A00,112920,Seward; Brandon M.,9,0,10,1
1668189379829,MATH 218,A00,098029,Li; Bo,10,0,10,0
1668189380256,MATH 220B,A00,098030,Novak; Jonathan I,11,0,15,4
1668189380681,MATH 221A,A00,098031,Ebenfelt; Peter F,13,0,15,2
1668189381106,MATH 231B,A00,098032,Zlatos; Andrej,12,0,15,3
1668189381533,MATH 240B,A00,098033,Ni; Lei,9,0,15,6
1668189381959,MATH 243,A00,098034,Jekel; David Andrew,10,0,10,0
1668189382385,MATH 245A,A00,098035,Nie; Jiawang,0,0,15,16
1668189382806,MATH 248,A00,098036,Bejenaru; Ioan,10,0,10,0
1668189383229,MATH 250B,A00,098037,Spolaor; Luca,14,0,15,1
1668189383655,MATH 258,A00,098038,Ni; Lei,10,0,10,0
1668189384078,MATH 264B,A00,098041,Rhoades; Brendon Patrick,9,0,15,6
1668189384501,MATH 268,A00,098042,Buss; Samuel R,10,0,10,0
1668189384927,MATH 269,A00,098043,Rhoades; Brendon Patrick,10,0,10,0
1668189385349,MATH 270B,A00,098044,Li; Bo,10,0,15,5
1668189385771,MATH 272B,A00,098045,Holst; Michael J,13,0,15,2
1668189386199,MATH 273A,A00,098046,Tian; Xiaochuan,10,0,15,5
1668189386639,MATH 275,A01,098048,Tian; Xiaochuan,6,0,10,4
1668189387075,MATH 278A,A00,098049,Holst; Michael J,8,0,10,2
1668189387504,MATH 278B,A00,098050,Cloninger; Alexander,10,0,10,0
1668189387929,MATH 278C,A00,098051,Nie; Jiawang,7,0,10,3
1668189388355,MATH 280B,A00,098052,Zheng; Tianyi,10,0,15,5
1668189388779,MATH 281B,A00,098053,Bradic; Jelena,2,0,15,13
1668189389201,MATH 282B,A00,098054,Arias-Castro; Ery,0,0,15,15
1668189389625,MATH 285,A00,098055,Fitzsimmons; Patrick J,0,0,15,17
1668189390050,MATH 287B,A00,098056,Arias-Castro; Ery,2,0,15,13
1668189390476,MATH 288,A00,098057,Agarwal; Pooja,9,0,10,1
1668189390476,MATH 288,B00,098058,Zhang; Danna,8,0,10,2
1668189390476,MATH 288,C00,098059,Williams; Ruth J,10,0,10,0
1668189390902,MATH 290B,A00,098060,Roberts; Justin Deritter,13,0,15,2
1668189391331,MATH 292,A00,098061,Belmont; Eva Kinoshita,10,0,10,0
1668189391757,MATH 295,A00,098062,Suk; Andrew Hoon,48,0,50,2
1668189392299,MATH 296,A00,098063,Novak; Jonathan I,20,0,20,0
1668189392721,MATH 297,001,098064,Gamst; Anthony Collins,9997,0,9999,2
1668189894694,COGS 205,A00,101395,Chiba; Andrea,19,0,20,1
1668189895118,COGS 210B,001,101404,Greene; Deanna Jacquelyn,9998,0,9999,1
1668189895118,COGS 210B,002,101417,Xia; Haijun,9999,0,9999,0
1668189895118,COGS 210B,003,101422,Nitz; Douglas A.,9999,0,9999,0
1668189895118,COGS 210B,004,101423,Hollan; James D.,9998,0,9999,1
1668189895118,COGS 210B,005,101424,Deak; Gedeon O.,9998,0,9999,1
1668189895118,COGS 210B,006,101425,Rossano; Federico,9999,0,9999,0
1668189895550,COGS 211B,A00,101427,Coulson; Seana M,9996,0,9999,3
1668189895972,COGS 220,A00,101428,Hollan; James D.,0,0,25,25
1668189896413,COGS 229,A00,101429,Dow; Steven P,18,0,25,7
1668189896845,COGS 230,A00,101430,Klemmer; Scott R,12,0,17,5
1668189897269,COGS 234,A00,101431,Xia; Haijun,3,0,25,22
1668189897692,COGS 260,A00,101432,Kiyonaga; Anastasia,20,0,25,5
1668189897692,COGS 260,B00,101433,Kirsh; David Joel,16,0,25,9
1668189898120,CSE 202,A00,102371,Impagliazzo; Russell,0,0,0,0
1668189898544,CSE 203B,A01,102373,Cheng; Chung Kuan,0,0,0,0
1668189898968,CSE 208,A00,102374,Micciancio; Daniele,0,0,0,0
1668189899416,CSE 209A,A00,112895,Impagliazzo; Russell,0,0,15,15
1668189899841,CSE 209B,A00,108005,Bellare; Mihir,0,0,0,0
1668189900268,CSE 210,A00,113163,Coblenz; Michael J,0,0,0,0
1668189900690,CSE 219,A00,106111,Dow; Steven P,0,0,20,20
1668189901117,CSE 221,A00,102376,Voelker; Geoffrey M.,0,0,0,0
1668189901540,CSE 224,A01,102378,Porter; George M,0,0,0,0
1668189901969,CSE 229A,A00,102379,Savage; Stefan,0,0,0,0
1668189902394,CSE 229C,A00,102380,Munyaka; Imani N. S.,0,0,0,0
1668189902818,CSE 232B,A00,102382,Deutsch; Alin Bernard,0,0,0,0
1668189903241,CSE 234,A01,112904,Kumar; Arun Kumar,0,0,0,0
1668189903668,CSE 237A,A00,102383,Rosing; Tajana Simunic,0,0,0,0
1668189904090,CSE 239A,A00,102384,Deutsch; Alin Bernard,0,0,0,0
1668189904516,CSE 239B,A00,102385,Polikarpova; Nadezhda,0,0,0,0
1668189904948,CSE 240A,A00,102386,Pannuto; Patrick William,0,0,0,0
1668189905373,CSE 240B,A00,102387,Zhao; Jishen,0,0,0,0
1668189905806,CSE 241A,A00,106406,Kang; Mingu,0,0,0,0
1668189906234,CSE 249B,A00,102388,Kahng; Andrew Byun,0,0,8,8
1668189906657,CSE 251B,A01,102392,Cottrell; Garrison W,0,0,0,0
1668189906657,CSE 251B,A02,102393,Cottrell; Garrison W,0,0,0,0
1668189907079,CSE 252B,A00,102394,Ochoa; Benjamin Lawrence,0,0,0,0
1668189907504,CSE 257,A01,102396,Gao; Sicun,0,0,0,0
1668189907929,CSE 272,A00,102397,Li; Tzumao,0,0,0,0
1668189908350,CSE 274,A00,111323,Chern; Albert Ren-Haur,0,0,0,0
1668189908782,CSE 282,A00,102398,Pevzner; Pavel Arkadjevich,0,0,0,0
1668189909208,CSE 284,A00,114175,Gymrek; Melissa Ann,0,0,0,0
1668189909639,CSE 290,A00,102399,Chandraker; Manmohan Krishna,0,0,0,0
1668189909639,CSE 290,B00,102400,Vaccaro; Kristen Marie,0,0,25,25
1668189909639,CSE 290,C00,102414,Pannuto; Patrick William,0,0,25,25
1668189909639,CSE 290,D00,102427,Pevzner; Pavel Arkadjevich,0,0,0,0
1668189909639,CSE 290,E00,102429,Zhao; Jishen,0,0,0,0
1668189909639,CSE 290,F00,102436,Tullsen; Dean Michael,0,0,0,0
1668189909639,CSE 290,G00,102440,Christensen; Henrik I,0,0,20,20
1668189910098,CSE 291,A00,102443,Su; Hao,0,0,0,0
1668189910098,CSE 291,B00,102448,Polikarpova; Nadezhda,0,0,0,0
1668189910098,CSE 291,C00,102453,Vaccaro; Kristen Marie,0,0,0,0
1668189910098,CSE 291,D00,111343,Savage; Stefan,0,0,0,0
1668189910098,CSE 291,E00,116474,Claffy; Kimberly Claire,0,0,0,0
1668189910098,CSE 291,F00,116479,Pasquale; Joseph,0,0,0,0
1668189910563,CSE 293,001,119111,Bafna; Vineet,9999,0,9999,0
1668189910563,CSE 293,002,119118,Bellare; Mihir,9999,0,9999,0
1668189910563,CSE 293,003,119122,Berg-Kirkpatrick; Taylor D,9999,0,9999,0
1668189910563,CSE 293,004,119135,Christensen; Henrik I,9999,0,9999,0
1668189910563,CSE 293,005,119142,Cottrell; Garrison W,9999,0,9999,0
1668189910563,CSE 293,006,119146,Deutsch; Alin Bernard,9999,0,9999,0
1668189910563,CSE 293,007,119159,Esmaeilzadeh; Hadi,9999,0,9999,0
1668189910563,CSE 293,008,119166,Freund; Yoav,9999,0,9999,0
1668189910563,CSE 293,009,119170,Griswold; William G.,9999,0,9999,0
1668189910563,CSE 293,010,119183,Gymrek; Melissa Ann,9999,0,9999,0
1668189910563,CSE 293,011,119190,Heninger; Nadia A,9999,0,9999,0
1668189910563,CSE 293,012,119230,Impagliazzo; Russell,9999,0,9999,0
1668189910563,CSE 293,013,119232,Jhala; Ranjit,9999,0,9999,0
1668189910563,CSE 293,014,119233,Kahng; Andrew Byun,9999,0,9999,0
1668189910563,CSE 293,015,119298,Kane; Daniel Mertz,9999,0,9999,0
1668189910563,CSE 293,016,119299,Kriegman; David J,9999,0,9999,0
1668189910563,CSE 293,017,119300,Kumar; Arun Kumar,9999,0,9999,0
1668189910563,CSE 293,018,119301,Lerner; Sorin,9999,0,9999,0
1668189910563,CSE 293,019,119302,Lovett; Shachar,9999,0,9999,0
1668189910563,CSE 293,020,119303,McAuley; Julian John,9999,0,9999,0
1668189910563,CSE 293,021,119304,Micciancio; Daniele,9999,0,9999,0
1668189910563,CSE 293,022,119367,Orailoglu; Alex,9999,0,9999,0
1668189910563,CSE 293,023,119382,Paturi; Ramamohan,9999,0,9999,0
1668189910563,CSE 293,024,119404,Polikarpova; Nadezhda,9999,0,9999,0
1668189910563,CSE 293,025,119406,Politz; Joseph Gibbs,9999,0,9999,0
1668189910563,CSE 293,026,119411,Porter; George M,9999,0,9999,0
1668189910563,CSE 293,027,119414,Porter; Leonard Emerson,9999,0,9999,0
1668189910563,CSE 293,028,119416,Ramamoorthi; Ravi,9999,0,9999,0
1668189910563,CSE 293,029,119417,Sahoo; Debashis,9999,0,9999,0
1668189910563,CSE 293,030,119420,Saul; Lawrence,9999,0,9999,0
1668189910563,CSE 293,031,119421,Savage; Stefan,9999,0,9999,0
1668189910563,CSE 293,032,119425,Schulze; Jurgen P.,9999,0,9999,0
1668189910563,CSE 293,033,119426,Snoeren; Alex C.,9999,0,9999,0
1668189910563,CSE 293,034,119428,Shang; Jingbo,9999,0,9999,0
1668189910563,CSE 293,035,119430,Stefan; Deian,9999,0,9999,0
1668189910563,CSE 293,036,119431,Su; Hao,9999,0,9999,0
1668189910563,CSE 293,037,119433,Swanson; Steven James,9999,0,9999,0
1668189910563,CSE 293,038,119435,Tullsen; Dean Michael,9999,0,9999,0
1668189910563,CSE 293,039,119483,Voelker; Geoffrey M.,9999,0,9999,0
1668189910563,CSE 293,040,119537,Zhao; Jishen,9999,0,9999,0
1668189910563,CSE 293,041,119538,Zhou; Yuan-Yuan,9999,0,9999,0
1668189910563,CSE 293,042,119539,Gao; Sicun,9999,0,9999,0
1668189910563,CSE 293,043,119540,Weibel; Nadir,9999,0,9999,0
1668189910563,CSE 293,044,119541,Gupta; Rajesh K.,9999,0,9999,0
1668189910563,CSE 293,045,126410,Vaccaro; Kristen Marie,9999,0,9999,0
1668189910563,CSE 293,046,126411,Klemke; Richard,9999,0,9999,0
1668189910999,CSE 294,A00,102459,Voelker; Geoffrey M.,0,0,0,0
1668189910999,CSE 294,B00,111322,Orailoglu; Alex,0,0,0,0
1668189911425,DSE 201,A00,096914,Deutsch; Alin Bernard,30,0,30,0
1668189911851,DSE 210,A00,096915,Dasgupta; Sanjoy,30,0,30,0
1668189912276,DSE 260A,A00,096916,Altintas De Callaf; Ilkay,30,0,30,0
1668189912721,ECE 200,001,103586,Antipa; Nicholas A,9999,0,9999,0
1668189912721,ECE 200,002,103587,Atanasov; Nikolay A.,9999,0,9999,0
1668189912721,ECE 200,003,103588,Bharadia; Dinesh,9999,0,9999,0
1668189912721,ECE 200,004,103589,Cheng; Chung Kuan,9999,0,9999,0
1668189912721,ECE 200,005,103590,Cosman; Pamela C.,9999,0,9999,0
1668189912721,ECE 200,006,103591,Dayeh; Shadi Ahmad,9999,0,9999,0
1668189912721,ECE 200,007,103592,Fainman; Yeshaiahu,9999,0,9999,0
1668189912721,ECE 200,008,103593,Ford; Joseph Earl,9999,0,9999,0
1668189912721,ECE 200,009,103594,Franceschetti; Massimo,9999,0,9999,0
1668189912721,ECE 200,010,103595,Fullerton; Eric E,9999,0,9999,0
1668189912721,ECE 200,011,103596,Galton; Ian A,9999,0,9999,0
1668189912721,ECE 200,012,103597,Gilja; Vikash,9999,0,9999,0
1668189912721,ECE 200,013,103598,Hall; Drew A.,9999,0,9999,0
1668189912721,ECE 200,014,103599,Hsueh; Tzu-Chien,9999,0,9999,0
1668189912721,ECE 200,015,103600,Javidi; Tara,9999,0,9999,0
1668189912721,ECE 200,016,103601,Kahng; Andrew Byun,9999,0,9999,0
1668189912721,ECE 200,017,103602,Kim; Young-Han,9999,0,9999,0
1668189912721,ECE 200,018,103603,Koushanfar; Farinaz,9999,0,9999,0
1668189912721,ECE 200,019,103604,Kuzum; Duygu,9999,0,9999,0
1668189912721,ECE 200,020,103605,Le; Hanh-Phuc,9999,0,9999,0
1668189912721,ECE 200,021,103606,Lin; Bill,9999,0,9999,0
1668189912721,ECE 200,022,103607,Liu; Zhaowei,9998,0,9999,1
1668189912721,ECE 200,023,103608,Lo; Yu-Hwa,9999,0,9999,0
1668189912721,ECE 200,024,103609,Lomakin; Vitaliy,9999,0,9999,0
1668189912721,ECE 200,025,103610,Mercier; Patrick Philip,9999,0,9999,0
1668189912721,ECE 200,026,103611,Meyer; Florian,9999,0,9999,0
1668189912721,ECE 200,027,103612,Milstein; Laurence B.,9999,0,9999,0
1668189912721,ECE 200,028,103613,Mir Arabbaygi; Siavash,9999,0,9999,0
1668189912721,ECE 200,029,103614,Mookherjea; Shayan,9999,0,9999,0
1668189912721,ECE 200,030,103615,Morris; Karcher William,9999,0,9999,0
1668189912721,ECE 200,031,103616,Ng; Tse Nga,9999,0,9999,0
1668189912721,ECE 200,032,103617,Nguyen; Truong Quang,9999,0,9999,0
1668189912721,ECE 200,033,103618,Nomura; Kenji,9999,0,9999,0
1668189912721,ECE 200,034,103619,Orlitsky; Alon,9999,0,9999,0
1668189912721,ECE 200,035,103620,Pal; Piya,9999,0,9999,0
1668189912721,ECE 200,036,103621,Papen; George C.,9999,0,9999,0
1668189912721,ECE 200,037,103622,Radic; Stojan,9999,0,9999,0
1668189912721,ECE 200,038,103623,Rao; Bhaskar D.,9999,0,9999,0
1668189912721,ECE 200,039,103624,Rao; Ramesh R,9999,0,9999,0
1668189912721,ECE 200,040,103625,Rebeiz; Gabriel,9999,0,9999,0
1668189912721,ECE 200,041,103626,Sanford; John R,9999,0,9999,0
1668189912721,ECE 200,042,103627,Siegel; Paul H.,9999,0,9999,0
1668189912721,ECE 200,043,103628,Sievenpiper; Daniel F.,9999,0,9999,0
1668189912721,ECE 200,044,103629,Sworder; David D.,9999,0,9999,0
1668189912721,ECE 200,045,103630,Taur; Yuan,9999,0,9999,0
1668189912721,ECE 200,046,103631,Touri; Behrouz,9999,0,9999,0
1668189912721,ECE 200,047,103632,Trivedi; Mohan M.,9999,0,9999,0
1668189912721,ECE 200,048,103633,Vasconcelos; Nuno,9999,0,9999,0
1668189912721,ECE 200,049,103634,Wang; Xiaolong,9999,0,9999,0
1668189912721,ECE 200,050,103635,Xie; Pengtao,9999,0,9999,0
1668189912721,ECE 200,051,103636,Yip; Michael,9999,0,9999,0
1668189912721,ECE 200,052,103637,Zeger; Kenneth A.,999,0,999,0
1668189912721,ECE 200,053,103638,Zhang; Xinyu,9999,0,9999,0
1668189912721,ECE 200,054,103639,Turakhia; Yatish Girish,9999,0,9999,0
1668189912721,ECE 200,055,103640,Kang; Mingu,9999,0,9999,0
1668189912721,ECE 200,056,103641,Shi; Yuanyuan,9999,0,9999,0
1668189912721,ECE 200,057,103642,Wang; Edward Jay,9999,0,9999,0
1668189912721,ECE 200,058,103643,Zheng; Yang,9999,0,9999,0
1668189913144,ECE 202,A00,103644,Kuzum; Duygu,0,0,0,0
1668189913569,ECE 212BN,A00,103646,Ng; Tse Nga,0,0,0,0
1668189913993,ECE 221,A00,111493,Staff,0,0,0,0
1668189914504,ECE 222B,A00,103647,Lomakin; Vitaliy,0,0,0,0
1668189914928,ECE 230B,A00,103648,Taur; Yuan,0,0,0,0
1668189915357,ECE 238B,A00,103649,Garay; Javier,0,0,0,0
1668189915787,ECE 240B,A00,112900,Fainman; Yeshaiahu,0,0,0,0
1668189916214,ECE 247A,A00,103650,Jokerst; Jesse Vincent,0,0,0,0
1668189916641,ECE 247B,A00,103651,Wang; Joseph,0,0,0,0
1668189917073,ECE 250,A00,103652,Siegel; Paul H.,0,0,0,0
1668189917502,ECE 251A,A00,103654,Rao; Bhaskar D.,0,0,0,0
1668189917925,ECE 257B,A00,103655,Bharadia; Dinesh,0,0,0,0
1668189918361,ECE 258A,A00,103656,Milstein; Laurence B.,0,0,0,0
1668189918787,ECE 260B,A00,103658,Kang; Mingu,0,0,0,0
1668189919210,ECE 264A,A00,103659,Galton; Ian A,0,0,0,0
1668189919647,ECE 265A,A00,103661,Gudem; Prasad S.S.,0,0,0,0
1668189920071,ECE 265D,A00,103662,Gudem; Prasad S.S.,0,0,0,0
1668189920495,ECE 268,A00,103663,Koushanfar; Farinaz,0,0,0,0
1668189920919,ECE 269,A01,103665,Pal; Piya,0,0,0,0
1668189921341,ECE 271B,A00,103666,Vasconcelos; Manuela,0,0,0,0
1668189921764,ECE 276A,A00,103667,Atanasov; Nikolay A.,0,0,0,0
1668189922193,ECE 277,A00,103668,An; Cheolhong,0,0,0,0
1668189922639,ECE 279,A00,117947,Hall; Drew A.,0,0,0,0
1668189923487,ECE 283,A00,103670,Hsueh; Tzu-Chien,0,0,0,0
1668189923909,ECE 284,A00,103671,Turakhia; Yatish Girish,0,0,0,0
1668189924334,ECE 285,A00,103672,Zheng; Yang,0,0,0,0
1668189924334,ECE 285,B00,103673,Sworder; David D.,0,0,0,0
1668189924758,ECE 287,A00,103676,Javidi; Tara,0,0,0,0
1668189925182,MATH 200B,A00,098023,Salehi Golsefidy; Alireza,12,0,15,3
1668189925612,MATH 202B,A00,098024,Rhoades; Brendon Patrick,9,0,15,6
1668189926044,MATH 203B,A00,098025,Oprea; Dragos N.,10,0,15,5
1668189926467,MATH 204B,A00,098026,Sorensen; Claus M,13,0,15,2
1668189926891,MATH 208,A00,098027,Izadi; Elham,7,0,10,3
1668189927315,MATH 209,A00,098028,Pollack; Aaron,10,0,10,0
1668189927739,MATH 211A,A00,112919,Rogalski; Daniel,9,0,10,1
1668189928164,MATH 211B,A00,112920,Seward; Brandon M.,9,0,10,1
1668189928588,MATH 218,A00,098029,Li; Bo,10,0,10,0
1668189929011,MATH 220B,A00,098030,Novak; Jonathan I,11,0,15,4
1668189929439,MATH 221A,A00,098031,Ebenfelt; Peter F,13,0,15,2
1668189929874,MATH 231B,A00,098032,Zlatos; Andrej,12,0,15,3
1668189930306,MATH 240B,A00,098033,Ni; Lei,9,0,15,6
1668189930729,MATH 243,A00,098034,Jekel; David Andrew,10,0,10,0
1668189931158,MATH 245A,A00,098035,Nie; Jiawang,0,0,15,16
1668189931597,MATH 248,A00,098036,Bejenaru; Ioan,10,0,10,0
1668189932026,MATH 250B,A00,098037,Spolaor; Luca,14,0,15,1
1668189932461,MATH 258,A00,098038,Ni; Lei,10,0,10,0
1668189932889,MATH 264B,A00,098041,Rhoades; Brendon Patrick,9,0,15,6
1668189933326,MATH 268,A00,098042,Buss; Samuel R,10,0,10,0
1668189933749,MATH 269,A00,098043,Rhoades; Brendon Patrick,10,0,10,0
1668189934172,MATH 270B,A00,098044,Li; Bo,10,0,15,5
1668189934598,MATH 272B,A00,098045,Holst; Michael J,13,0,15,2
1668189935023,MATH 273A,A00,098046,Tian; Xiaochuan,10,0,15,5
1668189935446,MATH 275,A01,098048,Tian; Xiaochuan,6,0,10,4
1668189935875,MATH 278A,A00,098049,Holst; Michael J,8,0,10,2
1668189936303,MATH 278B,A00,098050,Cloninger; Alexander,10,0,10,0
1668189936728,MATH 278C,A00,098051,Nie; Jiawang,7,0,10,3
1668189937156,MATH 280B,A00,098052,Zheng; Tianyi,10,0,15,5
1668189937593,MATH 281B,A00,098053,Bradic; Jelena,2,0,15,13
1668189938015,MATH 282B,A00,098054,Arias-Castro; Ery,0,0,15,15
1668189938442,MATH 285,A00,098055,Fitzsimmons; Patrick J,0,0,15,17
1668189938868,MATH 287B,A00,098056,Arias-Castro; Ery,2,0,15,13
1668189939301,MATH 288,A00,098057,Agarwal; Pooja,9,0,10,1
1668189939301,MATH 288,B00,098058,Zhang; Danna,8,0,10,2
1668189939301,MATH 288,C00,098059,Williams; Ruth J,10,0,10,0
1668189939730,MATH 290B,A00,098060,Roberts; Justin Deritter,13,0,15,2
1668189940155,MATH 292,A00,098061,Belmont; Eva Kinoshita,10,0,10,0
1668189940580,MATH 295,A00,098062,Suk; Andrew Hoon,48,0,50,2
1668189941010,MATH 296,A00,098063,Novak; Jonathan I,20,0,20,0
1668189941436,MATH 297,001,098064,Gamst; Anthony Collins,9997,0,9999,2
1668190443747,COGS 205,A00,101395,Chiba; Andrea,19,0,20,1
1668190444178,COGS 210B,001,101404,Greene; Deanna Jacquelyn,9998,0,9999,1
1668190444178,COGS 210B,002,101417,Xia; Haijun,9999,0,9999,0
1668190444178,COGS 210B,003,101422,Nitz; Douglas A.,9999,0,9999,0
1668190444178,COGS 210B,004,101423,Hollan; James D.,9998,0,9999,1
1668190444178,COGS 210B,005,101424,Deak; Gedeon O.,9998,0,9999,1
1668190444178,COGS 210B,006,101425,Rossano; Federico,9999,0,9999,0
1668190444606,COGS 211B,A00,101427,Coulson; Seana M,9996,0,9999,3
1668190445029,COGS 220,A00,101428,Hollan; James D.,0,0,25,25
1668190445465,COGS 229,A00,101429,Dow; Steven P,18,0,25,7
1668190445900,COGS 230,A00,101430,Klemmer; Scott R,12,0,17,5
1668190446329,COGS 234,A00,101431,Xia; Haijun,3,0,25,22
1668190446753,COGS 260,A00,101432,Kiyonaga; Anastasia,20,0,25,5
1668190446753,COGS 260,B00,101433,Kirsh; David Joel,16,0,25,9
1668190447186,CSE 202,A00,102371,Impagliazzo; Russell,0,0,0,0
1668190447609,CSE 203B,A01,102373,Cheng; Chung Kuan,0,0,0,0
1668190448040,CSE 208,A00,102374,Micciancio; Daniele,0,0,0,0
1668190448464,CSE 209A,A00,112895,Impagliazzo; Russell,0,0,15,15
1668190448887,CSE 209B,A00,108005,Bellare; Mihir,0,0,0,0
1668190449317,CSE 210,A00,113163,Coblenz; Michael J,0,0,0,0
1668190449749,CSE 219,A00,106111,Dow; Steven P,0,0,20,20
1668190450174,CSE 221,A00,102376,Voelker; Geoffrey M.,0,0,0,0
1668190450606,CSE 224,A01,102378,Porter; George M,0,0,0,0
1668190451028,CSE 229A,A00,102379,Savage; Stefan,0,0,0,0
1668190451452,CSE 229C,A00,102380,Munyaka; Imani N. S.,0,0,0,0
1668190451883,CSE 232B,A00,102382,Deutsch; Alin Bernard,0,0,0,0
1668190452318,CSE 234,A01,112904,Kumar; Arun Kumar,0,0,0,0
1668190452749,CSE 237A,A00,102383,Rosing; Tajana Simunic,0,0,0,0
1668190453174,CSE 239A,A00,102384,Deutsch; Alin Bernard,0,0,0,0
1668190453596,CSE 239B,A00,102385,Polikarpova; Nadezhda,0,0,0,0
1668190454020,CSE 240A,A00,102386,Pannuto; Patrick William,0,0,0,0
1668190454446,CSE 240B,A00,102387,Zhao; Jishen,0,0,0,0
1668190454872,CSE 241A,A00,106406,Kang; Mingu,0,0,0,0
1668190455296,CSE 249B,A00,102388,Kahng; Andrew Byun,0,0,8,8
1668190455719,CSE 251B,A01,102392,Cottrell; Garrison W,0,0,0,0
1668190455719,CSE 251B,A02,102393,Cottrell; Garrison W,0,0,0,0
1668190456167,CSE 252B,A00,102394,Ochoa; Benjamin Lawrence,0,0,0,0
1668190456589,CSE 257,A01,102396,Gao; Sicun,0,0,0,0
1668190457013,CSE 272,A00,102397,Li; Tzumao,0,0,0,0
1668190457442,CSE 274,A00,111323,Chern; Albert Ren-Haur,0,0,0,0
1668190457867,CSE 282,A00,102398,Pevzner; Pavel Arkadjevich,0,0,0,0
1668190458290,CSE 284,A00,114175,Gymrek; Melissa Ann,0,0,0,0
1668190458729,CSE 290,A00,102399,Chandraker; Manmohan Krishna,0,0,0,0
1668190458729,CSE 290,B00,102400,Vaccaro; Kristen Marie,0,0,25,25
1668190458729,CSE 290,C00,102414,Pannuto; Patrick William,0,0,25,25
1668190458729,CSE 290,D00,102427,Pevzner; Pavel Arkadjevich,0,0,0,0
1668190458729,CSE 290,E00,102429,Zhao; Jishen,0,0,0,0
1668190458729,CSE 290,F00,102436,Tullsen; Dean Michael,0,0,0,0
1668190458729,CSE 290,G00,102440,Christensen; Henrik I,0,0,20,20
1668190459156,CSE 291,A00,102443,Su; Hao,0,0,0,0
1668190459156,CSE 291,B00,102448,Polikarpova; Nadezhda,0,0,0,0
1668190459156,CSE 291,C00,102453,Vaccaro; Kristen Marie,0,0,0,0
1668190459156,CSE 291,D00,111343,Savage; Stefan,0,0,0,0
1668190459156,CSE 291,E00,116474,Claffy; Kimberly Claire,0,0,0,0
1668190459156,CSE 291,F00,116479,Pasquale; Joseph,0,0,0,0
1668190459595,CSE 293,001,119111,Bafna; Vineet,9999,0,9999,0
1668190459595,CSE 293,002,119118,Bellare; Mihir,9999,0,9999,0
1668190459595,CSE 293,003,119122,Berg-Kirkpatrick; Taylor D,9999,0,9999,0
1668190459595,CSE 293,004,119135,Christensen; Henrik I,9999,0,9999,0
1668190459595,CSE 293,005,119142,Cottrell; Garrison W,9999,0,9999,0
1668190459595,CSE 293,006,119146,Deutsch; Alin Bernard,9999,0,9999,0
1668190459595,CSE 293,007,119159,Esmaeilzadeh; Hadi,9999,0,9999,0
1668190459595,CSE 293,008,119166,Freund; Yoav,9999,0,9999,0
1668190459595,CSE 293,009,119170,Griswold; William G.,9999,0,9999,0
1668190459595,CSE 293,010,119183,Gymrek; Melissa Ann,9999,0,9999,0
1668190459595,CSE 293,011,119190,Heninger; Nadia A,9999,0,9999,0
1668190459595,CSE 293,012,119230,Impagliazzo; Russell,9999,0,9999,0
1668190459595,CSE 293,013,119232,Jhala; Ranjit,9999,0,9999,0
1668190459595,CSE 293,014,119233,Kahng; Andrew Byun,9999,0,9999,0
1668190459595,CSE 293,015,119298,Kane; Daniel Mertz,9999,0,9999,0
1668190459595,CSE 293,016,119299,Kriegman; David J,9999,0,9999,0
1668190459595,CSE 293,017,119300,Kumar; Arun Kumar,9999,0,9999,0
1668190459595,CSE 293,018,119301,Lerner; Sorin,9999,0,9999,0
1668190459595,CSE 293,019,119302,Lovett; Shachar,9999,0,9999,0
1668190459595,CSE 293,020,119303,McAuley; Julian John,9999,0,9999,0
1668190459595,CSE 293,021,119304,Micciancio; Daniele,9999,0,9999,0
1668190459595,CSE 293,022,119367,Orailoglu; Alex,9999,0,9999,0
1668190459595,CSE 293,023,119382,Paturi; Ramamohan,9999,0,9999,0
1668190459595,CSE 293,024,119404,Polikarpova; Nadezhda,9999,0,9999,0
1668190459595,CSE 293,025,119406,Politz; Joseph Gibbs,9999,0,9999,0
1668190459595,CSE 293,026,119411,Porter; George M,9999,0,9999,0
1668190459595,CSE 293,027,119414,Porter; Leonard Emerson,9999,0,9999,0
1668190459595,CSE 293,028,119416,Ramamoorthi; Ravi,9999,0,9999,0
1668190459595,CSE 293,029,119417,Sahoo; Debashis,9999,0,9999,0
1668190459595,CSE 293,030,119420,Saul; Lawrence,9999,0,9999,0
1668190459595,CSE 293,031,119421,Savage; Stefan,9999,0,9999,0
1668190459595,CSE 293,032,119425,Schulze; Jurgen P.,9999,0,9999,0
1668190459595,CSE 293,033,119426,Snoeren; Alex C.,9999,0,9999,0
1668190459595,CSE 293,034,119428,Shang; Jingbo,9999,0,9999,0
1668190459595,CSE 293,035,119430,Stefan; Deian,9999,0,9999,0
1668190459595,CSE 293,036,119431,Su; Hao,9999,0,9999,0
1668190459595,CSE 293,037,119433,Swanson; Steven James,9999,0,9999,0
1668190459595,CSE 293,038,119435,Tullsen; Dean Michael,9999,0,9999,0
1668190459595,CSE 293,039,119483,Voelker; Geoffrey M.,9999,0,9999,0
1668190459595,CSE 293,040,119537,Zhao; Jishen,9999,0,9999,0
1668190459595,CSE 293,041,119538,Zhou; Yuan-Yuan,9999,0,9999,0
1668190459595,CSE 293,042,119539,Gao; Sicun,9999,0,9999,0
1668190459595,CSE 293,043,119540,Weibel; Nadir,9999,0,9999,0
1668190459595,CSE 293,044,119541,Gupta; Rajesh K.,9999,0,9999,0
1668190459595,CSE 293,045,126410,Vaccaro; Kristen Marie,9999,0,9999,0
1668190459595,CSE 293,046,126411,Klemke; Richard,9999,0,9999,0
1668190460018,CSE 294,A00,102459,Voelker; Geoffrey M.,0,0,0,0
1668190460018,CSE 294,B00,111322,Orailoglu; Alex,0,0,0,0
1668190460446,DSE 201,A00,096914,Deutsch; Alin Bernard,30,0,30,0
1668190460869,DSE 210,A00,096915,Dasgupta; Sanjoy,30,0,30,0
1668190461299,DSE 260A,A00,096916,Altintas De Callaf; Ilkay,30,0,30,0
1668190461726,ECE 200,001,103586,Antipa; Nicholas A,9999,0,9999,0
1668190461726,ECE 200,002,103587,Atanasov; Nikolay A.,9999,0,9999,0
1668190461726,ECE 200,003,103588,Bharadia; Dinesh,9999,0,9999,0
1668190461726,ECE 200,004,103589,Cheng; Chung Kuan,9999,0,9999,0
1668190461726,ECE 200,005,103590,Cosman; Pamela C.,9999,0,9999,0
1668190461726,ECE 200,006,103591,Dayeh; Shadi Ahmad,9999,0,9999,0
1668190461726,ECE 200,007,103592,Fainman; Yeshaiahu,9999,0,9999,0
1668190461726,ECE 200,008,103593,Ford; Joseph Earl,9999,0,9999,0
1668190461726,ECE 200,009,103594,Franceschetti; Massimo,9999,0,9999,0
1668190461726,ECE 200,010,103595,Fullerton; Eric E,9999,0,9999,0
1668190461726,ECE 200,011,103596,Galton; Ian A,9999,0,9999,0
1668190461726,ECE 200,012,103597,Gilja; Vikash,9999,0,9999,0
1668190461726,ECE 200,013,103598,Hall; Drew A.,9999,0,9999,0
1668190461726,ECE 200,014,103599,Hsueh; Tzu-Chien,9999,0,9999,0
1668190461726,ECE 200,015,103600,Javidi; Tara,9999,0,9999,0
1668190461726,ECE 200,016,103601,Kahng; Andrew Byun,9999,0,9999,0
1668190461726,ECE 200,017,103602,Kim; Young-Han,9999,0,9999,0
1668190461726,ECE 200,018,103603,Koushanfar; Farinaz,9999,0,9999,0
1668190461726,ECE 200,019,103604,Kuzum; Duygu,9999,0,9999,0
1668190461726,ECE 200,020,103605,Le; Hanh-Phuc,9999,0,9999,0
1668190461726,ECE 200,021,103606,Lin; Bill,9999,0,9999,0
1668190461726,ECE 200,022,103607,Liu; Zhaowei,9998,0,9999,1
1668190461726,ECE 200,023,103608,Lo; Yu-Hwa,9999,0,9999,0
1668190461726,ECE 200,024,103609,Lomakin; Vitaliy,9999,0,9999,0
1668190461726,ECE 200,025,103610,Mercier; Patrick Philip,9999,0,9999,0
1668190461726,ECE 200,026,103611,Meyer; Florian,9999,0,9999,0
1668190461726,ECE 200,027,103612,Milstein; Laurence B.,9999,0,9999,0
1668190461726,ECE 200,028,103613,Mir Arabbaygi; Siavash,9999,0,9999,0
1668190461726,ECE 200,029,103614,Mookherjea; Shayan,9999,0,9999,0
1668190461726,ECE 200,030,103615,Morris; Karcher William,9999,0,9999,0
1668190461726,ECE 200,031,103616,Ng; Tse Nga,9999,0,9999,0
1668190461726,ECE 200,032,103617,Nguyen; Truong Quang,9999,0,9999,0
1668190461726,ECE 200,033,103618,Nomura; Kenji,9999,0,9999,0
1668190461726,ECE 200,034,103619,Orlitsky; Alon,9999,0,9999,0
1668190461726,ECE 200,035,103620,Pal; Piya,9999,0,9999,0
1668190461726,ECE 200,036,103621,Papen; George C.,9999,0,9999,0
1668190461726,ECE 200,037,103622,Radic; Stojan,9999,0,9999,0
1668190461726,ECE 200,038,103623,Rao; Bhaskar D.,9999,0,9999,0
1668190461726,ECE 200,039,103624,Rao; Ramesh R,9999,0,9999,0
1668190461726,ECE 200,040,103625,Rebeiz; Gabriel,9999,0,9999,0
1668190461726,ECE 200,041,103626,Sanford; John R,9999,0,9999,0
1668190461726,ECE 200,042,103627,Siegel; Paul H.,9999,0,9999,0
1668190461726,ECE 200,043,103628,Sievenpiper; Daniel F.,9999,0,9999,0
1668190461726,ECE 200,044,103629,Sworder; David D.,9999,0,9999,0
1668190461726,ECE 200,045,103630,Taur; Yuan,9999,0,9999,0
1668190461726,ECE 200,046,103631,Touri; Behrouz,9999,0,9999,0
1668190461726,ECE 200,047,103632,Trivedi; Mohan M.,9999,0,9999,0
1668190461726,ECE 200,048,103633,Vasconcelos; Nuno,9999,0,9999,0
1668190461726,ECE 200,049,103634,Wang; Xiaolong,9999,0,9999,0
1668190461726,ECE 200,050,103635,Xie; Pengtao,9999,0,9999,0
1668190461726,ECE 200,051,103636,Yip; Michael,9999,0,9999,0
1668190461726,ECE 200,052,103637,Zeger; Kenneth A.,999,0,999,0
1668190461726,ECE 200,053,103638,Zhang; Xinyu,9999,0,9999,0
1668190461726,ECE 200,054,103639,Turakhia; Yatish Girish,9999,0,9999,0
1668190461726,ECE 200,055,103640,Kang; Mingu,9999,0,9999,0
1668190461726,ECE 200,056,103641,Shi; Yuanyuan,9999,0,9999,0
1668190461726,ECE 200,057,103642,Wang; Edward Jay,9999,0,9999,0
1668190461726,ECE 200,058,103643,Zheng; Yang,9999,0,9999,0
1668190462150,ECE 202,A00,103644,Kuzum; Duygu,0,0,0,0
1668190462583,ECE 212BN,A00,103646,Ng; Tse Nga,0,0,0,0
1668190463005,ECE 221,A00,111493,Staff,0,0,0,0
1668190463436,ECE 222B,A00,103647,Lomakin; Vitaliy,0,0,0,0
1668190463862,ECE 230B,A00,103648,Taur; Yuan,0,0,0,0
1668190464283,ECE 238B,A00,103649,Garay; Javier,0,0,0,0
1668190464707,ECE 240B,A00,112900,Fainman; Yeshaiahu,0,0,0,0
1668190465134,ECE 247A,A00,103650,Jokerst; Jesse Vincent,0,0,0,0
1668190465556,ECE 247B,A00,103651,Wang; Joseph,0,0,0,0
1668190465979,ECE 250,A00,103652,Siegel; Paul H.,0,0,0,0
1668190466407,ECE 251A,A00,103654,Rao; Bhaskar D.,0,0,0,0
1668190466836,ECE 257B,A00,103655,Bharadia; Dinesh,0,0,0,0
1668190467259,ECE 258A,A00,103656,Milstein; Laurence B.,0,0,0,0
1668190467692,ECE 260B,A00,103658,Kang; Mingu,0,0,0,0
1668190468118,ECE 264A,A00,103659,Galton; Ian A,0,0,0,0
1668190468543,ECE 265A,A00,103661,Gudem; Prasad S.S.,0,0,0,0
1668190468965,ECE 265D,A00,103662,Gudem; Prasad S.S.,0,0,0,0
1668190469388,ECE 268,A00,103663,Koushanfar; Farinaz,0,0,0,0
1668190469814,ECE 269,A01,103665,Pal; Piya,0,0,0,0
1668190470238,ECE 271B,A00,103666,Vasconcelos; Manuela,0,0,0,0
1668190470666,ECE 276A,A00,103667,Atanasov; Nikolay A.,0,0,0,0
1668190471087,ECE 277,A00,103668,An; Cheolhong,0,0,0,0
1668190471521,ECE 279,A00,117947,Hall; Drew A.,0,0,0,0
1668190472393,ECE 283,A00,103670,Hsueh; Tzu-Chien,0,0,0,0
1668190472817,ECE 284,A00,103671,Turakhia; Yatish Girish,0,0,0,0
1668190473248,ECE 285,A00,103672,Zheng; Yang,0,0,0,0
1668190473248,ECE 285,B00,103673,Sworder; David D.,0,0,0,0
1668190473680,ECE 287,A00,103676,Javidi; Tara,0,0,0,0
1668190474132,MATH 200B,A00,098023,Salehi Golsefidy; Alireza,12,0,15,3
1668190474554,MATH 202B,A00,098024,Rhoades; Brendon Patrick,9,0,15,6
1668190474978,MATH 203B,A00,098025,Oprea; Dragos N.,10,0,15,5
1668190475405,MATH 204B,A00,098026,Sorensen; Claus M,13,0,15,2
1668190475828,MATH 208,A00,098027,Izadi; Elham,7,0,10,3
1668190476262,MATH 209,A00,098028,Pollack; Aaron,10,0,10,0
1668190476684,MATH 211A,A00,112919,Rogalski; Daniel,9,0,10,1
1668190477120,MATH 211B,A00,112920,Seward; Brandon M.,9,0,10,1
1668190477542,MATH 218,A00,098029,Li; Bo,10,0,10,0
1668190477979,MATH 220B,A00,098030,Novak; Jonathan I,11,0,15,4
1668190478414,MATH 221A,A00,098031,Ebenfelt; Peter F,13,0,15,2
1668190478840,MATH 231B,A00,098032,Zlatos; Andrej,12,0,15,3
1668190479263,MATH 240B,A00,098033,Ni; Lei,9,0,15,6
1668190479706,MATH 243,A00,098034,Jekel; David Andrew,10,0,10,0
1668190480207,MATH 245A,A00,098035,Nie; Jiawang,0,0,15,16
1668190480634,MATH 248,A00,098036,Bejenaru; Ioan,10,0,10,0
1668190481068,MATH 250B,A00,098037,Spolaor; Luca,14,0,15,1
1668190481490,MATH 258,A00,098038,Ni; Lei,10,0,10,0
1668190481914,MATH 264B,A00,098041,Rhoades; Brendon Patrick,9,0,15,6
1668190482345,MATH 268,A00,098042,Buss; Samuel R,10,0,10,0
1668190482768,MATH 269,A00,098043,Rhoades; Brendon Patrick,10,0,10,0
1668190483191,MATH 270B,A00,098044,Li; Bo,10,0,15,5
1668190483614,MATH 272B,A00,098045,Holst; Michael J,13,0,15,2
1668190484042,MATH 273A,A00,098046,Tian; Xiaochuan,10,0,15,5
1668190484465,MATH 275,A01,098048,Tian; Xiaochuan,6,0,10,4
1668190484890,MATH 278A,A00,098049,Holst; Michael J,8,0,10,2
1668190485313,MATH 278B,A00,098050,Cloninger; Alexander,10,0,10,0
1668190485736,MATH 278C,A00,098051,Nie; Jiawang,7,0,10,3
1668190486159,MATH 280B,A00,098052,Zheng; Tianyi,10,0,15,5
1668190486582,MATH 281B,A00,098053,Bradic; Jelena,2,0,15,13
1668190487007,MATH 282B,A00,098054,Arias-Castro; Ery,0,0,15,15
1668190487438,MATH 285,A00,098055,Fitzsimmons; Patrick J,0,0,15,17
1668190487861,MATH 287B,A00,098056,Arias-Castro; Ery,2,0,15,13
1668190488286,MATH 288,A00,098057,Agarwal; Pooja,9,0,10,1
1668190488286,MATH 288,B00,098058,Zhang; Danna,8,0,10,2
1668190488286,MATH 288,C00,098059,Williams; Ruth J,10,0,10,0
1668190488707,MATH 290B,A00,098060,Roberts; Justin Deritter,13,0,15,2
1668190489132,MATH 292,A00,098061,Belmont; Eva Kinoshita,10,0,10,0
1668190489558,MATH 295,A00,098062,Suk; Andrew Hoon,48,0,50,2
1668190489983,MATH 296,A00,098063,Novak; Jonathan I,20,0,20,0
1668190490407,MATH 297,001,098064,Gamst; Anthony Collins,9997,0,9999,2
1668190991835,COGS 205,A00,101395,Chiba; Andrea,19,0,20,1
1668190992259,COGS 210B,001,101404,Greene; Deanna Jacquelyn,9998,0,9999,1
1668190992259,COGS 210B,002,101417,Xia; Haijun,9999,0,9999,0
1668190992259,COGS 210B,003,101422,Nitz; Douglas A.,9999,0,9999,0
1668190992259,COGS 210B,004,101423,Hollan; James D.,9998,0,9999,1
1668190992259,COGS 210B,005,101424,Deak; Gedeon O.,9998,0,9999,1
1668190992259,COGS 210B,006,101425,Rossano; Federico,9999,0,9999,0
1668190992683,COGS 211B,A00,101427,Coulson; Seana M,9996,0,9999,3
1668190993107,COGS 220,A00,101428,Hollan; James D.,0,0,25,25
1668190993538,COGS 229,A00,101429,Dow; Steven P,18,0,25,7
1668190993969,COGS 230,A00,101430,Klemmer; Scott R,12,0,17,5
1668190994403,COGS 234,A00,101431,Xia; Haijun,3,0,25,22
1668190994826,COGS 260,A00,101432,Kiyonaga; Anastasia,20,0,25,5
1668190994826,COGS 260,B00,101433,Kirsh; David Joel,16,0,25,9
1668190995248,CSE 202,A00,102371,Impagliazzo; Russell,0,0,0,0
1668190995673,CSE 203B,A01,102373,Cheng; Chung Kuan,0,0,0,0
1668190996111,CSE 208,A00,102374,Micciancio; Daniele,0,0,0,0
1668190996543,CSE 209A,A00,112895,Impagliazzo; Russell,0,0,15,15
1668190996976,CSE 209B,A00,108005,Bellare; Mihir,0,0,0,0
1668190997414,CSE 210,A00,113163,Coblenz; Michael J,0,0,0,0
1668190997837,CSE 219,A00,106111,Dow; Steven P,0,0,20,20
1668190998260,CSE 221,A00,102376,Voelker; Geoffrey M.,0,0,0,0
1668190998686,CSE 224,A01,102378,Porter; George M,0,0,0,0
1668190999117,CSE 229A,A00,102379,Savage; Stefan,0,0,0,0
1668190999542,CSE 229C,A00,102380,Munyaka; Imani N. S.,0,0,0,0
1668190999968,CSE 232B,A00,102382,Deutsch; Alin Bernard,0,0,0,0
1668191000408,CSE 234,A01,112904,Kumar; Arun Kumar,0,0,0,0
1668191000840,CSE 237A,A00,102383,Rosing; Tajana Simunic,0,0,0,0
1668191001264,CSE 239A,A00,102384,Deutsch; Alin Bernard,0,0,0,0
1668191001762,CSE 239B,A00,102385,Polikarpova; Nadezhda,0,0,0,0
1668191002186,CSE 240A,A00,102386,Pannuto; Patrick William,0,0,0,0
1668191002621,CSE 240B,A00,102387,Zhao; Jishen,0,0,0,0
1668191003045,CSE 241A,A00,106406,Kang; Mingu,0,0,0,0
1668191003482,CSE 249B,A00,102388,Kahng; Andrew Byun,0,0,8,8
1668191003908,CSE 251B,A01,102392,Cottrell; Garrison W,0,0,0,0
1668191003908,CSE 251B,A02,102393,Cottrell; Garrison W,0,0,0,0
1668191004332,CSE 252B,A00,102394,Ochoa; Benjamin Lawrence,0,0,0,0
1668191004754,CSE 257,A01,102396,Gao; Sicun,0,0,0,0
1668191005179,CSE 272,A00,102397,Li; Tzumao,0,0,0,0
1668191005609,CSE 274,A00,111323,Chern; Albert Ren-Haur,0,0,0,0
1668191006033,CSE 282,A00,102398,Pevzner; Pavel Arkadjevich,0,0,0,0
1668191006461,CSE 284,A00,114175,Gymrek; Melissa Ann,0,0,0,0
1668191006890,CSE 290,A00,102399,Chandraker; Manmohan Krishna,0,0,0,0
1668191006890,CSE 290,B00,102400,Vaccaro; Kristen Marie,0,0,25,25
1668191006890,CSE 290,C00,102414,Pannuto; Patrick William,0,0,25,25
1668191006890,CSE 290,D00,102427,Pevzner; Pavel Arkadjevich,0,0,0,0
1668191006890,CSE 290,E00,102429,Zhao; Jishen,0,0,0,0
1668191006890,CSE 290,F00,102436,Tullsen; Dean Michael,0,0,0,0
1668191006890,CSE 290,G00,102440,Christensen; Henrik I,0,0,20,20
1668191007315,CSE 291,A00,102443,Su; Hao,0,0,0,0
1668191007315,CSE 291,B00,102448,Polikarpova; Nadezhda,0,0,0,0
1668191007315,CSE 291,C00,102453,Vaccaro; Kristen Marie,0,0,0,0
1668191007315,CSE 291,D00,111343,Savage; Stefan,0,0,0,0
1668191007315,CSE 291,E00,116474,Claffy; Kimberly Claire,0,0,0,0
1668191007315,CSE 291,F00,116479,Pasquale; Joseph,0,0,0,0
1668191007750,CSE 293,001,119111,Bafna; Vineet,9999,0,9999,0
1668191007750,CSE 293,002,119118,Bellare; Mihir,9999,0,9999,0
1668191007750,CSE 293,003,119122,Berg-Kirkpatrick; Taylor D,9999,0,9999,0
1668191007750,CSE 293,004,119135,Christensen; Henrik I,9999,0,9999,0
1668191007750,CSE 293,005,119142,Cottrell; Garrison W,9999,0,9999,0
1668191007750,CSE 293,006,119146,Deutsch; Alin Bernard,9999,0,9999,0
1668191007750,CSE 293,007,119159,Esmaeilzadeh; Hadi,9999,0,9999,0
1668191007750,CSE 293,008,119166,Freund; Yoav,9999,0,9999,0
1668191007750,CSE 293,009,119170,Griswold; William G.,9999,0,9999,0
1668191007750,CSE 293,010,119183,Gymrek; Melissa Ann,9999,0,9999,0
1668191007750,CSE 293,011,119190,Heninger; Nadia A,9999,0,9999,0
1668191007750,CSE 293,012,119230,Impagliazzo; Russell,9999,0,9999,0
1668191007750,CSE 293,013,119232,Jhala; Ranjit,9999,0,9999,0
1668191007750,CSE 293,014,119233,Kahng; Andrew Byun,9999,0,9999,0
1668191007750,CSE 293,015,119298,Kane; Daniel Mertz,9999,0,9999,0
1668191007750,CSE 293,016,119299,Kriegman; David J,9999,0,9999,0
1668191007750,CSE 293,017,119300,Kumar; Arun Kumar,9999,0,9999,0
1668191007750,CSE 293,018,119301,Lerner; Sorin,9999,0,9999,0
1668191007750,CSE 293,019,119302,Lovett; Shachar,9999,0,9999,0
1668191007750,CSE 293,020,119303,McAuley; Julian John,9999,0,9999,0
1668191007750,CSE 293,021,119304,Micciancio; Daniele,9999,0,9999,0
1668191007750,CSE 293,022,119367,Orailoglu; Alex,9999,0,9999,0
1668191007750,CSE 293,023,119382,Paturi; Ramamohan,9999,0,9999,0
1668191007750,CSE 293,024,119404,Polikarpova; Nadezhda,9999,0,9999,0
1668191007750,CSE 293,025,119406,Politz; Joseph Gibbs,9999,0,9999,0
1668191007750,CSE 293,026,119411,Porter; George M,9999,0,9999,0
1668191007750,CSE 293,027,119414,Porter; Leonard Emerson,9999,0,9999,0
1668191007750,CSE 293,028,119416,Ramamoorthi; Ravi,9999,0,9999,0
1668191007750,CSE 293,029,119417,Sahoo; Debashis,9999,0,9999,0
1668191007750,CSE 293,030,119420,Saul; Lawrence,9999,0,9999,0
1668191007750,CSE 293,031,119421,Savage; Stefan,9999,0,9999,0
1668191007750,CSE 293,032,119425,Schulze; Jurgen P.,9999,0,9999,0
1668191007750,CSE 293,033,119426,Snoeren; Alex C.,9999,0,9999,0
1668191007750,CSE 293,034,119428,Shang; Jingbo,9999,0,9999,0
1668191007750,CSE 293,035,119430,Stefan; Deian,9999,0,9999,0
1668191007750,CSE 293,036,119431,Su; Hao,9999,0,9999,0
1668191007750,CSE 293,037,119433,Swanson; Steven James,9999,0,9999,0
1668191007750,CSE 293,038,119435,Tullsen; Dean Michael,9999,0,9999,0
1668191007750,CSE 293,039,119483,Voelker; Geoffrey M.,9999,0,9999,0
1668191007750,CSE 293,040,119537,Zhao; Jishen,9999,0,9999,0
1668191007750,CSE 293,041,119538,Zhou; Yuan-Yuan,9999,0,9999,0
1668191007750,CSE 293,042,119539,Gao; Sicun,9999,0,9999,0
1668191007750,CSE 293,043,119540,Weibel; Nadir,9999,0,9999,0
1668191007750,CSE 293,044,119541,Gupta; Rajesh K.,9999,0,9999,0
1668191007750,CSE 293,045,126410,Vaccaro; Kristen Marie,9999,0,9999,0
1668191007750,CSE 293,046,126411,Klemke; Richard,9999,0,9999,0
1668191008175,CSE 294,A00,102459,Voelker; Geoffrey M.,0,0,0,0
1668191008175,CSE 294,B00,111322,Orailoglu; Alex,0,0,0,0
1668191008608,DSE 201,A00,096914,Deutsch; Alin Bernard,30,0,30,0
1668191009039,DSE 210,A00,096915,Dasgupta; Sanjoy,30,0,30,0
1668191009472,DSE 260A,A00,096916,Altintas De Callaf; Ilkay,30,0,30,0
1668191009901,ECE 200,001,103586,Antipa; Nicholas A,9999,0,9999,0
1668191009901,ECE 200,002,103587,Atanasov; Nikolay A.,9999,0,9999,0
1668191009901,ECE 200,003,103588,Bharadia; Dinesh,9999,0,9999,0
1668191009901,ECE 200,004,103589,Cheng; Chung Kuan,9999,0,9999,0
1668191009901,ECE 200,005,103590,Cosman; Pamela C.,9999,0,9999,0
1668191009901,ECE 200,006,103591,Dayeh; Shadi Ahmad,9999,0,9999,0
1668191009901,ECE 200,007,103592,Fainman; Yeshaiahu,9999,0,9999,0
1668191009901,ECE 200,008,103593,Ford; Joseph Earl,9999,0,9999,0
1668191009901,ECE 200,009,103594,Franceschetti; Massimo,9999,0,9999,0
1668191009901,ECE 200,010,103595,Fullerton; Eric E,9999,0,9999,0
1668191009901,ECE 200,011,103596,Galton; Ian A,9999,0,9999,0
1668191009901,ECE 200,012,103597,Gilja; Vikash,9999,0,9999,0
1668191009901,ECE 200,013,103598,Hall; Drew A.,9999,0,9999,0
1668191009901,ECE 200,014,103599,Hsueh; Tzu-Chien,9999,0,9999,0
1668191009901,ECE 200,015,103600,Javidi; Tara,9999,0,9999,0
1668191009901,ECE 200,016,103601,Kahng; Andrew Byun,9999,0,9999,0
1668191009901,ECE 200,017,103602,Kim; Young-Han,9999,0,9999,0
1668191009901,ECE 200,018,103603,Koushanfar; Farinaz,9999,0,9999,0
1668191009901,ECE 200,019,103604,Kuzum; Duygu,9999,0,9999,0
1668191009901,ECE 200,020,103605,Le; Hanh-Phuc,9999,0,9999,0
1668191009901,ECE 200,021,103606,Lin; Bill,9999,0,9999,0
1668191009901,ECE 200,022,103607,Liu; Zhaowei,9998,0,9999,1
1668191009901,ECE 200,023,103608,Lo; Yu-Hwa,9999,0,9999,0
1668191009901,ECE 200,024,103609,Lomakin; Vitaliy,9999,0,9999,0
1668191009901,ECE 200,025,103610,Mercier; Patrick Philip,9999,0,9999,0
1668191009901,ECE 200,026,103611,Meyer; Florian,9999,0,9999,0
1668191009901,ECE 200,027,103612,Milstein; Laurence B.,9999,0,9999,0
1668191009901,ECE 200,028,103613,Mir Arabbaygi; Siavash,9999,0,9999,0
1668191009901,ECE 200,029,103614,Mookherjea; Shayan,9999,0,9999,0
1668191009901,ECE 200,030,103615,Morris; Karcher William,9999,0,9999,0
1668191009901,ECE 200,031,103616,Ng; Tse Nga,9999,0,9999,0
1668191009901,ECE 200,032,103617,Nguyen; Truong Quang,9999,0,9999,0
1668191009901,ECE 200,033,103618,Nomura; Kenji,9999,0,9999,0
1668191009901,ECE 200,034,103619,Orlitsky; Alon,9999,0,9999,0
1668191009901,ECE 200,035,103620,Pal; Piya,9999,0,9999,0
1668191009901,ECE 200,036,103621,Papen; George C.,9999,0,9999,0
1668191009901,ECE 200,037,103622,Radic; Stojan,9999,0,9999,0
1668191009901,ECE 200,038,103623,Rao; Bhaskar D.,9999,0,9999,0
1668191009901,ECE 200,039,103624,Rao; Ramesh R,9999,0,9999,0
1668191009901,ECE 200,040,103625,Rebeiz; Gabriel,9999,0,9999,0
1668191009901,ECE 200,041,103626,Sanford; John R,9999,0,9999,0
1668191009901,ECE 200,042,103627,Siegel; Paul H.,9999,0,9999,0
1668191009901,ECE 200,043,103628,Sievenpiper; Daniel F.,9999,0,9999,0
1668191009901,ECE 200,044,103629,Sworder; David D.,9999,0,9999,0
1668191009901,ECE 200,045,103630,Taur; Yuan,9999,0,9999,0
1668191009901,ECE 200,046,103631,Touri; Behrouz,9999,0,9999,0
1668191009901,ECE 200,047,103632,Trivedi; Mohan M.,9999,0,9999,0
1668191009901,ECE 200,048,103633,Vasconcelos; Nuno,9999,0,9999,0
1668191009901,ECE 200,049,103634,Wang; Xiaolong,9999,0,9999,0
1668191009901,ECE 200,050,103635,Xie; Pengtao,9999,0,9999,0
1668191009901,ECE 200,051,103636,Yip; Michael,9999,0,9999,0
1668191009901,ECE 200,052,103637,Zeger; Kenneth A.,999,0,999,0
1668191009901,ECE 200,053,103638,Zhang; Xinyu,9999,0,9999,0
1668191009901,ECE 200,054,103639,Turakhia; Yatish Girish,9999,0,9999,0
1668191009901,ECE 200,055,103640,Kang; Mingu,9999,0,9999,0
1668191009901,ECE 200,056,103641,Shi; Yuanyuan,9999,0,9999,0
1668191009901,ECE 200,057,103642,Wang; Edward Jay,9999,0,9999,0
1668191009901,ECE 200,058,103643,Zheng; Yang,9999,0,9999,0
1668191010332,ECE 202,A00,103644,Kuzum; Duygu,0,0,0,0
1668191010754,ECE 212BN,A00,103646,Ng; Tse Nga,0,0,0,0
1668191011176,ECE 221,A00,111493,Staff,0,0,0,0
1668191011602,ECE 222B,A00,103647,Lomakin; Vitaliy,0,0,0,0
1668191012023,ECE 230B,A00,103648,Taur; Yuan,0,0,0,0
1668191012446,ECE 238B,A00,103649,Garay; Javier,0,0,0,0
1668191012870,ECE 240B,A00,112900,Fainman; Yeshaiahu,0,0,0,0
1668191013295,ECE 247A,A00,103650,Jokerst; Jesse Vincent,0,0,0,0
1668191013717,ECE 247B,A00,103651,Wang; Joseph,0,0,0,0
1668191014140,ECE 250,A00,103652,Siegel; Paul H.,0,0,0,0
1668191014563,ECE 251A,A00,103654,Rao; Bhaskar D.,0,0,0,0
1668191014985,ECE 257B,A00,103655,Bharadia; Dinesh,0,0,0,0
1668191015410,ECE 258A,A00,103656,Milstein; Laurence B.,0,0,0,0
1668191015832,ECE 260B,A00,103658,Kang; Mingu,0,0,0,0
1668191016267,ECE 264A,A00,103659,Galton; Ian A,0,0,0,0
1668191016692,ECE 265A,A00,103661,Gudem; Prasad S.S.,0,0,0,0
1668191017115,ECE 265D,A00,103662,Gudem; Prasad S.S.,0,0,0,0
1668191017538,ECE 268,A00,103663,Koushanfar; Farinaz,0,0,0,0
1668191017976,ECE 269,A01,103665,Pal; Piya,0,0,0,0
1668191018401,ECE 271B,A00,103666,Vasconcelos; Manuela,0,0,0,0
1668191018825,ECE 276A,A00,103667,Atanasov; Nikolay A.,0,0,0,0
1668191019265,ECE 277,A00,103668,An; Cheolhong,0,0,0,0
1668191019701,ECE 279,A00,117947,Hall; Drew A.,0,0,0,0
1668191020552,ECE 283,A00,103670,Hsueh; Tzu-Chien,0,0,0,0
1668191020975,ECE 284,A00,103671,Turakhia; Yatish Girish,0,0,0,0
1668191021406,ECE 285,A00,103672,Zheng; Yang,0,0,0,0
1668191021406,ECE 285,B00,103673,Sworder; David D.,0,0,0,0
1668191021858,ECE 287,A00,103676,Javidi; Tara,0,0,0,0
1668191022297,MATH 200B,A00,098023,Salehi Golsefidy; Alireza,12,0,15,3
1668191022723,MATH 202B,A00,098024,Rhoades; Brendon Patrick,9,0,15,6
1668191023146,MATH 203B,A00,098025,Oprea; Dragos N.,10,0,15,5
1668191023580,MATH 204B,A00,098026,Sorensen; Claus M,13,0,15,2
1668191024002,MATH 208,A00,098027,Izadi; Elham,7,0,10,3
1668191024424,MATH 209,A00,098028,Pollack; Aaron,10,0,10,0
1668191024849,MATH 211A,A00,112919,Rogalski; Daniel,9,0,10,1
1668191025273,MATH 211B,A00,112920,Seward; Brandon M.,9,0,10,1
1668191025695,MATH 218,A00,098029,Li; Bo,10,0,10,0
1668191026119,MATH 220B,A00,098030,Novak; Jonathan I,11,0,15,4
1668191026542,MATH 221A,A00,098031,Ebenfelt; Peter F,13,0,15,2
1668191026969,MATH 231B,A00,098032,Zlatos; Andrej,12,0,15,3
1668191027392,MATH 240B,A00,098033,Ni; Lei,9,0,15,6
1668191027829,MATH 243,A00,098034,Jekel; David Andrew,10,0,10,0
1668191028269,MATH 245A,A00,098035,Nie; Jiawang,0,0,15,16
1668191028696,MATH 248,A00,098036,Bejenaru; Ioan,10,0,10,0
1668191029122,MATH 250B,A00,098037,Spolaor; Luca,14,0,15,1
1668191029554,MATH 258,A00,098038,Ni; Lei,10,0,10,0
1668191029978,MATH 264B,A00,098041,Rhoades; Brendon Patrick,9,0,15,6
1668191030414,MATH 268,A00,098042,Buss; Samuel R,10,0,10,0
1668191030843,MATH 269,A00,098043,Rhoades; Brendon Patrick,10,0,10,0
1668191031274,MATH 270B,A00,098044,Li; Bo,10,0,15,5
1668191031698,MATH 272B,A00,098045,Holst; Michael J,13,0,15,2
1668191032123,MATH 273A,A00,098046,Tian; Xiaochuan,10,0,15,5
1668191032548,MATH 275,A01,098048,Tian; Xiaochuan,6,0,10,4
1668191032972,MATH 278A,A00,098049,Holst; Michael J,8,0,10,2
1668191033398,MATH 278B,A00,098050,Cloninger; Alexander,10,0,10,0
1668191033820,MATH 278C,A00,098051,Nie; Jiawang,7,0,10,3
1668191034246,MATH 280B,A00,098052,Zheng; Tianyi,10,0,15,5
1668191034676,MATH 281B,A00,098053,Bradic; Jelena,2,0,15,13
1668191035108,MATH 282B,A00,098054,Arias-Castro; Ery,0,0,15,15
1668191035532,MATH 285,A00,098055,Fitzsimmons; Patrick J,0,0,15,17
1668191035962,MATH 287B,A00,098056,Arias-Castro; Ery,2,0,15,13
1668191036390,MATH 288,A00,098057,Agarwal; Pooja,9,0,10,1
1668191036390,MATH 288,B00,098058,Zhang; Danna,8,0,10,2
1668191036390,MATH 288,C00,098059,Williams; Ruth J,10,0,10,0
1668191036814,MATH 290B,A00,098060,Roberts; Justin Deritter,13,0,15,2
1668191037242,MATH 292,A00,098061,Belmont; Eva Kinoshita,10,0,10,0
1668191037676,MATH 295,A00,098062,Suk; Andrew Hoon,48,0,50,2
1668191038104,MATH 296,A00,098063,Novak; Jonathan I,20,0,20,0
1668191038534,MATH 297,001,098064,Gamst; Anthony Collins,9997,0,9999,2
1668191540077,COGS 205,A00,101395,Chiba; Andrea,19,0,20,1
1668191540514,COGS 210B,001,101404,Greene; Deanna Jacquelyn,9998,0,9999,1
1668191540514,COGS 210B,002,101417,Xia; Haijun,9999,0,9999,0
1668191540514,COGS 210B,003,101422,Nitz; Douglas A.,9999,0,9999,0
1668191540514,COGS 210B,004,101423,Hollan; James D.,9998,0,9999,1
1668191540514,COGS 210B,005,101424,Deak; Gedeon O.,9998,0,9999,1
1668191540514,COGS 210B,006,101425,Rossano; Federico,9999,0,9999,0
1668191540943,COGS 211B,A00,101427,Coulson; Seana M,9996,0,9999,3
1668191541369,COGS 220,A00,101428,Hollan; James D.,0,0,25,25
1668191541793,COGS 229,A00,101429,Dow; Steven P,18,0,25,7
1668191542223,COGS 230,A00,101430,Klemmer; Scott R,12,0,17,5
1668191542651,COGS 234,A00,101431,Xia; Haijun,3,0,25,22
1668191543079,COGS 260,A00,101432,Kiyonaga; Anastasia,20,0,25,5
1668191543079,COGS 260,B00,101433,Kirsh; David Joel,16,0,25,9
1668191543505,CSE 202,A00,102371,Impagliazzo; Russell,0,0,0,0
1668191543930,CSE 203B,A01,102373,Cheng; Chung Kuan,0,0,0,0
1668191544353,CSE 208,A00,102374,Micciancio; Daniele,0,0,0,0
1668191544778,CSE 209A,A00,112895,Impagliazzo; Russell,0,0,15,15
1668191545205,CSE 209B,A00,108005,Bellare; Mihir,0,0,0,0
1668191545628,CSE 210,A00,113163,Coblenz; Michael J,0,0,0,0
1668191546050,CSE 219,A00,106111,Dow; Steven P,0,0,20,20
1668191546471,CSE 221,A00,102376,Voelker; Geoffrey M.,0,0,0,0
1668191546904,CSE 224,A01,102378,Porter; George M,0,0,0,0
1668191547328,CSE 229A,A00,102379,Savage; Stefan,0,0,0,0
1668191547759,CSE 229C,A00,102380,Munyaka; Imani N. S.,0,0,0,0
1668191548190,CSE 232B,A00,102382,Deutsch; Alin Bernard,0,0,0,0
1668191548616,CSE 234,A01,112904,Kumar; Arun Kumar,0,0,0,0
1668191549039,CSE 237A,A00,102383,Rosing; Tajana Simunic,0,0,0,0
1668191549464,CSE 239A,A00,102384,Deutsch; Alin Bernard,0,0,0,0
1668191549894,CSE 239B,A00,102385,Polikarpova; Nadezhda,0,0,0,0
1668191550316,CSE 240A,A00,102386,Pannuto; Patrick William,0,0,0,0
1668191550738,CSE 240B,A00,102387,Zhao; Jishen,0,0,0,0
1668191551164,CSE 241A,A00,106406,Kang; Mingu,0,0,0,0
1668191551589,CSE 249B,A00,102388,Kahng; Andrew Byun,0,0,8,8
1668191552010,CSE 251B,A01,102392,Cottrell; Garrison W,0,0,0,0
1668191552010,CSE 251B,A02,102393,Cottrell; Garrison W,0,0,0,0
1668191552434,CSE 252B,A00,102394,Ochoa; Benjamin Lawrence,0,0,0,0
1668191552865,CSE 257,A01,102396,Gao; Sicun,0,0,0,0
1668191553293,CSE 272,A00,102397,Li; Tzumao,0,0,0,0
1668191553721,CSE 274,A00,111323,Chern; Albert Ren-Haur,0,0,0,0
1668191554144,CSE 282,A00,102398,Pevzner; Pavel Arkadjevich,0,0,0,0
1668191554569,CSE 284,A00,114175,Gymrek; Melissa Ann,0,0,0,0
1668191554998,CSE 290,A00,102399,Chandraker; Manmohan Krishna,0,0,0,0
1668191554998,CSE 290,B00,102400,Vaccaro; Kristen Marie,0,0,25,25
1668191554998,CSE 290,C00,102414,Pannuto; Patrick William,0,0,25,25
1668191554998,CSE 290,D00,102427,Pevzner; Pavel Arkadjevich,0,0,0,0
1668191554998,CSE 290,E00,102429,Zhao; Jishen,0,0,0,0
1668191554998,CSE 290,F00,102436,Tullsen; Dean Michael,0,0,0,0
1668191554998,CSE 290,G00,102440,Christensen; Henrik I,0,0,20,20
1668191555428,CSE 291,A00,102443,Su; Hao,0,0,0,0
1668191555428,CSE 291,B00,102448,Polikarpova; Nadezhda,0,0,0,0
1668191555428,CSE 291,C00,102453,Vaccaro; Kristen Marie,0,0,0,0
1668191555428,CSE 291,D00,111343,Savage; Stefan,0,0,0,0
1668191555428,CSE 291,E00,116474,Claffy; Kimberly Claire,0,0,0,0
1668191555428,CSE 291,F00,116479,Pasquale; Joseph,0,0,0,0
1668191555865,CSE 293,001,119111,Bafna; Vineet,9999,0,9999,0
1668191555865,CSE 293,002,119118,Bellare; Mihir,9999,0,9999,0
1668191555865,CSE 293,003,119122,Berg-Kirkpatrick; Taylor D,9999,0,9999,0
1668191555865,CSE 293,004,119135,Christensen; Henrik I,9999,0,9999,0
1668191555865,CSE 293,005,119142,Cottrell; Garrison W,9999,0,9999,0
1668191555865,CSE 293,006,119146,Deutsch; Alin Bernard,9999,0,9999,0
1668191555865,CSE 293,007,119159,Esmaeilzadeh; Hadi,9999,0,9999,0
1668191555865,CSE 293,008,119166,Freund; Yoav,9999,0,9999,0
1668191555865,CSE 293,009,119170,Griswold; William G.,9999,0,9999,0
1668191555865,CSE 293,010,119183,Gymrek; Melissa Ann,9999,0,9999,0
1668191555865,CSE 293,011,119190,Heninger; Nadia A,9999,0,9999,0
1668191555865,CSE 293,012,119230,Impagliazzo; Russell,9999,0,9999,0
1668191555865,CSE 293,013,119232,Jhala; Ranjit,9999,0,9999,0
1668191555865,CSE 293,014,119233,Kahng; Andrew Byun,9999,0,9999,0
1668191555865,CSE 293,015,119298,Kane; Daniel Mertz,9999,0,9999,0
1668191555865,CSE 293,016,119299,Kriegman; David J,9999,0,9999,0
1668191555865,CSE 293,017,119300,Kumar; Arun Kumar,9999,0,9999,0
1668191555865,CSE 293,018,119301,Lerner; Sorin,9999,0,9999,0
1668191555865,CSE 293,019,119302,Lovett; Shachar,9999,0,9999,0
1668191555865,CSE 293,020,119303,McAuley; Julian John,9999,0,9999,0
1668191555865,CSE 293,021,119304,Micciancio; Daniele,9999,0,9999,0
1668191555865,CSE 293,022,119367,Orailoglu; Alex,9999,0,9999,0
1668191555865,CSE 293,023,119382,Paturi; Ramamohan,9999,0,9999,0
1668191555865,CSE 293,024,119404,Polikarpova; Nadezhda,9999,0,9999,0
1668191555865,CSE 293,025,119406,Politz; Joseph Gibbs,9999,0,9999,0
1668191555865,CSE 293,026,119411,Porter; George M,9999,0,9999,0
1668191555865,CSE 293,027,119414,Porter; Leonard Emerson,9999,0,9999,0
1668191555865,CSE 293,028,119416,Ramamoorthi; Ravi,9999,0,9999,0
1668191555865,CSE 293,029,119417,Sahoo; Debashis,9999,0,9999,0
1668191555865,CSE 293,030,119420,Saul; Lawrence,9999,0,9999,0
1668191555865,CSE 293,031,119421,Savage; Stefan,9999,0,9999,0
1668191555865,CSE 293,032,119425,Schulze; Jurgen P.,9999,0,9999,0
1668191555865,CSE 293,033,119426,Snoeren; Alex C.,9999,0,9999,0
1668191555865,CSE 293,034,119428,Shang; Jingbo,9999,0,9999,0
1668191555865,CSE 293,035,119430,Stefan; Deian,9999,0,9999,0
1668191555865,CSE 293,036,119431,Su; Hao,9999,0,9999,0
1668191555865,CSE 293,037,119433,Swanson; Steven James,9999,0,9999,0
1668191555865,CSE 293,038,119435,Tullsen; Dean Michael,9999,0,9999,0
1668191555865,CSE 293,039,119483,Voelker; Geoffrey M.,9999,0,9999,0
1668191555865,CSE 293,040,119537,Zhao; Jishen,9999,0,9999,0
1668191555865,CSE 293,041,119538,Zhou; Yuan-Yuan,9999,0,9999,0
1668191555865,CSE 293,042,119539,Gao; Sicun,9999,0,9999,0
1668191555865,CSE 293,043,119540,Weibel; Nadir,9999,0,9999,0
1668191555865,CSE 293,044,119541,Gupta; Rajesh K.,9999,0,9999,0
1668191555865,CSE 293,045,126410,Vaccaro; Kristen Marie,9999,0,9999,0
1668191555865,CSE 293,046,126411,Klemke; Richard,9999,0,9999,0
1668191556286,CSE 294,A00,102459,Voelker; Geoffrey M.,0,0,0,0
1668191556286,CSE 294,B00,111322,Orailoglu; Alex,0,0,0,0
1668191556710,DSE 201,A00,096914,Deutsch; Alin Bernard,30,0,30,0
1668191557134,DSE 210,A00,096915,Dasgupta; Sanjoy,30,0,30,0
1668191557570,DSE 260A,A00,096916,Altintas De Callaf; Ilkay,30,0,30,0
1668191557996,ECE 200,001,103586,Antipa; Nicholas A,9999,0,9999,0
1668191557996,ECE 200,002,103587,Atanasov; Nikolay A.,9999,0,9999,0
1668191557996,ECE 200,003,103588,Bharadia; Dinesh,9999,0,9999,0
1668191557996,ECE 200,004,103589,Cheng; Chung Kuan,9999,0,9999,0
1668191557996,ECE 200,005,103590,Cosman; Pamela C.,9999,0,9999,0
1668191557996,ECE 200,006,103591,Dayeh; Shadi Ahmad,9999,0,9999,0
1668191557996,ECE 200,007,103592,Fainman; Yeshaiahu,9999,0,9999,0
1668191557996,ECE 200,008,103593,Ford; Joseph Earl,9999,0,9999,0
1668191557996,ECE 200,009,103594,Franceschetti; Massimo,9999,0,9999,0
1668191557996,ECE 200,010,103595,Fullerton; Eric E,9999,0,9999,0
1668191557996,ECE 200,011,103596,Galton; Ian A,9999,0,9999,0
1668191557996,ECE 200,012,103597,Gilja; Vikash,9999,0,9999,0
1668191557996,ECE 200,013,103598,Hall; Drew A.,9999,0,9999,0
1668191557996,ECE 200,014,103599,Hsueh; Tzu-Chien,9999,0,9999,0
1668191557996,ECE 200,015,103600,Javidi; Tara,9999,0,9999,0
1668191557996,ECE 200,016,103601,Kahng; Andrew Byun,9999,0,9999,0
1668191557996,ECE 200,017,103602,Kim; Young-Han,9999,0,9999,0
1668191557996,ECE 200,018,103603,Koushanfar; Farinaz,9999,0,9999,0
1668191557996,ECE 200,019,103604,Kuzum; Duygu,9999,0,9999,0
1668191557996,ECE 200,020,103605,Le; Hanh-Phuc,9999,0,9999,0
1668191557996,ECE 200,021,103606,Lin; Bill,9999,0,9999,0
1668191557996,ECE 200,022,103607,Liu; Zhaowei,9998,0,9999,1
1668191557996,ECE 200,023,103608,Lo; Yu-Hwa,9999,0,9999,0
1668191557996,ECE 200,024,103609,Lomakin; Vitaliy,9999,0,9999,0
1668191557996,ECE 200,025,103610,Mercier; Patrick Philip,9999,0,9999,0
1668191557996,ECE 200,026,103611,Meyer; Florian,9999,0,9999,0
1668191557996,ECE 200,027,103612,Milstein; Laurence B.,9999,0,9999,0
1668191557996,ECE 200,028,103613,Mir Arabbaygi; Siavash,9999,0,9999,0
1668191557996,ECE 200,029,103614,Mookherjea; Shayan,9999,0,9999,0
1668191557996,ECE 200,030,103615,Morris; Karcher William,9999,0,9999,0
1668191557996,ECE 200,031,103616,Ng; Tse Nga,9999,0,9999,0
1668191557996,ECE 200,032,103617,Nguyen; Truong Quang,9999,0,9999,0
1668191557996,ECE 200,033,103618,Nomura; Kenji,9999,0,9999,0
1668191557996,ECE 200,034,103619,Orlitsky; Alon,9999,0,9999,0
1668191557996,ECE 200,035,103620,Pal; Piya,9999,0,9999,0
1668191557996,ECE 200,036,103621,Papen; George C.,9999,0,9999,0
1668191557996,ECE 200,037,103622,Radic; Stojan,9999,0,9999,0
1668191557996,ECE 200,038,103623,Rao; Bhaskar D.,9999,0,9999,0
1668191557996,ECE 200,039,103624,Rao; Ramesh R,9999,0,9999,0
1668191557996,ECE 200,040,103625,Rebeiz; Gabriel,9999,0,9999,0
1668191557996,ECE 200,041,103626,Sanford; John R,9999,0,9999,0
1668191557996,ECE 200,042,103627,Siegel; Paul H.,9999,0,9999,0
1668191557996,ECE 200,043,103628,Sievenpiper; Daniel F.,9999,0,9999,0
1668191557996,ECE 200,044,103629,Sworder; David D.,9999,0,9999,0
1668191557996,ECE 200,045,103630,Taur; Yuan,9999,0,9999,0
1668191557996,ECE 200,046,103631,Touri; Behrouz,9999,0,9999,0
1668191557996,ECE 200,047,103632,Trivedi; Mohan M.,9999,0,9999,0
1668191557996,ECE 200,048,103633,Vasconcelos; Nuno,9999,0,9999,0
1668191557996,ECE 200,049,103634,Wang; Xiaolong,9999,0,9999,0
1668191557996,ECE 200,050,103635,Xie; Pengtao,9999,0,9999,0
1668191557996,ECE 200,051,103636,Yip; Michael,9999,0,9999,0
1668191557996,ECE 200,052,103637,Zeger; Kenneth A.,999,0,999,0
1668191557996,ECE 200,053,103638,Zhang; Xinyu,9999,0,9999,0
1668191557996,ECE 200,054,103639,Turakhia; Yatish Girish,9999,0,9999,0
1668191557996,ECE 200,055,103640,Kang; Mingu,9999,0,9999,0
1668191557996,ECE 200,056,103641,Shi; Yuanyuan,9999,0,9999,0
1668191557996,ECE 200,057,103642,Wang; Edward Jay,9999,0,9999,0
1668191557996,ECE 200,058,103643,Zheng; Yang,9999,0,9999,0
1668191558419,ECE 202,A00,103644,Kuzum; Duygu,0,0,0,0
1668191558846,ECE 212BN,A00,103646,Ng; Tse Nga,0,0,0,0
1668191559272,ECE 221,A00,111493,Staff,0,0,0,0
1668191559696,ECE 222B,A00,103647,Lomakin; Vitaliy,0,0,0,0
1668191560118,ECE 230B,A00,103648,Taur; Yuan,0,0,0,0
1668191560543,ECE 238B,A00,103649,Garay; Javier,0,0,0,0
1668191560968,ECE 240B,A00,112900,Fainman; Yeshaiahu,0,0,0,0
1668191561392,ECE 247A,A00,103650,Jokerst; Jesse Vincent,0,0,0,0
1668191561816,ECE 247B,A00,103651,Wang; Joseph,0,0,0,0
1668191562241,ECE 250,A00,103652,Siegel; Paul H.,0,0,0,0
1668191562662,ECE 251A,A00,103654,Rao; Bhaskar D.,0,0,0,0
1668191563087,ECE 257B,A00,103655,Bharadia; Dinesh,0,0,0,0
1668191563510,ECE 258A,A00,103656,Milstein; Laurence B.,0,0,0,0
1668191563935,ECE 260B,A00,103658,Kang; Mingu,0,0,0,0
1668191564359,ECE 264A,A00,103659,Galton; Ian A,0,0,0,0
1668191564783,ECE 265A,A00,103661,Gudem; Prasad S.S.,0,0,0,0
1668191565331,ECE 265D,A00,103662,Gudem; Prasad S.S.,0,0,0,0
1668191565763,ECE 268,A00,103663,Koushanfar; Farinaz,0,0,0,0
1668191566198,ECE 269,A01,103665,Pal; Piya,0,0,0,0
1668191566709,ECE 271B,A00,103666,Vasconcelos; Manuela,0,0,0,0
1668191567135,ECE 276A,A00,103667,Atanasov; Nikolay A.,0,0,0,0
1668191567559,ECE 277,A00,103668,An; Cheolhong,0,0,0,0
1668191567992,ECE 279,A00,117947,Hall; Drew A.,0,0,0,0
1668191568841,ECE 283,A00,103670,Hsueh; Tzu-Chien,0,0,0,0
1668191569266,ECE 284,A00,103671,Turakhia; Yatish Girish,0,0,0,0
1668191569690,ECE 285,A00,103672,Zheng; Yang,0,0,0,0
1668191569690,ECE 285,B00,103673,Sworder; David D.,0,0,0,0
1668191570126,ECE 287,A00,103676,Javidi; Tara,0,0,0,0
1668191570565,MATH 200B,A00,098023,Salehi Golsefidy; Alireza,12,0,15,3
1668191570987,MATH 202B,A00,098024,Rhoades; Brendon Patrick,9,0,15,6
1668191571414,MATH 203B,A00,098025,Oprea; Dragos N.,10,0,15,5
1668191571849,MATH 204B,A00,098026,Sorensen; Claus M,13,0,15,2
1668191572274,MATH 208,A00,098027,Izadi; Elham,7,0,10,3
1668191572697,MATH 209,A00,098028,Pollack; Aaron,10,0,10,0
1668191573128,MATH 211A,A00,112919,Rogalski; Daniel,9,0,10,1
1668191573551,MATH 211B,A00,112920,Seward; Brandon M.,9,0,10,1
1668191573976,MATH 218,A00,098029,Li; Bo,10,0,10,0
1668191574398,MATH 220B,A00,098030,Novak; Jonathan I,11,0,15,4
1668191574822,MATH 221A,A00,098031,Ebenfelt; Peter F,13,0,15,2
1668191575247,MATH 231B,A00,098032,Zlatos; Andrej,12,0,15,3
1668191575673,MATH 240B,A00,098033,Ni; Lei,9,0,15,6
1668191576099,MATH 243,A00,098034,Jekel; David Andrew,10,0,10,0
1668191576523,MATH 245A,A00,098035,Nie; Jiawang,0,0,15,16
1668191576946,MATH 248,A00,098036,Bejenaru; Ioan,10,0,10,0
1668191577376,MATH 250B,A00,098037,Spolaor; Luca,14,0,15,1
1668191577798,MATH 258,A00,098038,Ni; Lei,10,0,10,0
1668191578226,MATH 264B,A00,098041,Rhoades; Brendon Patrick,9,0,15,6
1668191578650,MATH 268,A00,098042,Buss; Samuel R,10,0,10,0
1668191579074,MATH 269,A00,098043,Rhoades; Brendon Patrick,10,0,10,0
1668191579497,MATH 270B,A00,098044,Li; Bo,10,0,15,5
1668191579923,MATH 272B,A00,098045,Holst; Michael J,13,0,15,2
1668191580357,MATH 273A,A00,098046,Tian; Xiaochuan,10,0,15,5
1668191580793,MATH 275,A01,098048,Tian; Xiaochuan,6,0,10,4
1668191581228,MATH 278A,A00,098049,Holst; Michael J,8,0,10,2
1668191581651,MATH 278B,A00,098050,Cloninger; Alexander,10,0,10,0
1668191582076,MATH 278C,A00,098051,Nie; Jiawang,7,0,10,3
1668191582505,MATH 280B,A00,098052,Zheng; Tianyi,10,0,15,5
1668191582932,MATH 281B,A00,098053,Bradic; Jelena,2,0,15,13
1668191583359,MATH 282B,A00,098054,Arias-Castro; Ery,0,0,15,15
1668191583782,MATH 285,A00,098055,Fitzsimmons; Patrick J,0,0,15,17
1668191584223,MATH 287B,A00,098056,Arias-Castro; Ery,2,0,15,13
1668191584654,MATH 288,A00,098057,Agarwal; Pooja,9,0,10,1
1668191584654,MATH 288,B00,098058,Zhang; Danna,8,0,10,2
1668191584654,MATH 288,C00,098059,Williams; Ruth J,10,0,10,0
1668191585080,MATH 290B,A00,098060,Roberts; Justin Deritter,13,0,15,2
1668191585505,MATH 292,A00,098061,Belmont; Eva Kinoshita,10,0,10,0
1668191585930,MATH 295,A00,098062,Suk; Andrew Hoon,48,0,50,2
1668191586353,MATH 296,A00,098063,Novak; Jonathan I,20,0,20,0
1668191586777,MATH 297,001,098064,Gamst; Anthony Collins,9997,0,9999,2
1668192089329,COGS 205,A00,101395,Chiba; Andrea,19,0,20,1
1668192089753,COGS 210B,001,101404,Greene; Deanna Jacquelyn,9998,0,9999,1
1668192089753,COGS 210B,002,101417,Xia; Haijun,9999,0,9999,0
1668192089753,COGS 210B,003,101422,Nitz; Douglas A.,9999,0,9999,0
1668192089753,COGS 210B,004,101423,Hollan; James D.,9998,0,9999,1
1668192089753,COGS 210B,005,101424,Deak; Gedeon O.,9998,0,9999,1
1668192089753,COGS 210B,006,101425,Rossano; Federico,9999,0,9999,0
1668192090179,COGS 211B,A00,101427,Coulson; Seana M,9996,0,9999,3
1668192090616,COGS 220,A00,101428,Hollan; James D.,0,0,25,25
1668192091041,COGS 229,A00,101429,Dow; Steven P,18,0,25,7
1668192091474,COGS 230,A00,101430,Klemmer; Scott R,12,0,17,5
1668192091901,COGS 234,A00,101431,Xia; Haijun,3,0,25,22
1668192092339,COGS 260,A00,101432,Kiyonaga; Anastasia,20,0,25,5
1668192092339,COGS 260,B00,101433,Kirsh; David Joel,16,0,25,9
1668192092764,CSE 202,A00,102371,Impagliazzo; Russell,0,0,0,0
1668192093186,CSE 203B,A01,102373,Cheng; Chung Kuan,0,0,0,0
1668192093621,CSE 208,A00,102374,Micciancio; Daniele,0,0,0,0
1668192094065,CSE 209A,A00,112895,Impagliazzo; Russell,0,0,15,15
1668192094496,CSE 209B,A00,108005,Bellare; Mihir,0,0,0,0
1668192094918,CSE 210,A00,113163,Coblenz; Michael J,0,0,0,0
1668192095341,CSE 219,A00,106111,Dow; Steven P,0,0,20,20
1668192095766,CSE 221,A00,102376,Voelker; Geoffrey M.,0,0,0,0
1668192096188,CSE 224,A01,102378,Porter; George M,0,0,0,0
1668192096616,CSE 229A,A00,102379,Savage; Stefan,0,0,0,0
1668192097040,CSE 229C,A00,102380,Munyaka; Imani N. S.,0,0,0,0
1668192097461,CSE 232B,A00,102382,Deutsch; Alin Bernard,0,0,0,0
1668192097885,CSE 234,A01,112904,Kumar; Arun Kumar,0,0,0,0
1668192098309,CSE 237A,A00,102383,Rosing; Tajana Simunic,0,0,0,0
1668192098731,CSE 239A,A00,102384,Deutsch; Alin Bernard,0,0,0,0
1668192099162,CSE 239B,A00,102385,Polikarpova; Nadezhda,0,0,0,0
1668192099594,CSE 240A,A00,102386,Pannuto; Patrick William,0,0,0,0
1668192100020,CSE 240B,A00,102387,Zhao; Jishen,0,0,0,0
1668192100454,CSE 241A,A00,106406,Kang; Mingu,0,0,0,0
1668192100894,CSE 249B,A00,102388,Kahng; Andrew Byun,0,0,8,8
1668192101320,CSE 251B,A01,102392,Cottrell; Garrison W,0,0,0,0
1668192101320,CSE 251B,A02,102393,Cottrell; Garrison W,0,0,0,0
1668192101746,CSE 252B,A00,102394,Ochoa; Benjamin Lawrence,0,0,0,0
1668192102168,CSE 257,A01,102396,Gao; Sicun,0,0,0,0
1668192102592,CSE 272,A00,102397,Li; Tzumao,0,0,0,0
1668192103016,CSE 274,A00,111323,Chern; Albert Ren-Haur,0,0,0,0
1668192103440,CSE 282,A00,102398,Pevzner; Pavel Arkadjevich,0,0,0,0
1668192103868,CSE 284,A00,114175,Gymrek; Melissa Ann,0,0,0,0
1668192104293,CSE 290,A00,102399,Chandraker; Manmohan Krishna,0,0,0,0
1668192104293,CSE 290,B00,102400,Vaccaro; Kristen Marie,0,0,25,25
1668192104293,CSE 290,C00,102414,Pannuto; Patrick William,0,0,25,25
1668192104293,CSE 290,D00,102427,Pevzner; Pavel Arkadjevich,0,0,0,0
1668192104293,CSE 290,E00,102429,Zhao; Jishen,0,0,0,0
1668192104293,CSE 290,F00,102436,Tullsen; Dean Michael,0,0,0,0
1668192104293,CSE 290,G00,102440,Christensen; Henrik I,0,0,20,20
1668192104717,CSE 291,A00,102443,Su; Hao,0,0,0,0
1668192104717,CSE 291,B00,102448,Polikarpova; Nadezhda,0,0,0,0
1668192104717,CSE 291,C00,102453,Vaccaro; Kristen Marie,0,0,0,0
1668192104717,CSE 291,D00,111343,Savage; Stefan,0,0,0,0
1668192104717,CSE 291,E00,116474,Claffy; Kimberly Claire,0,0,0,0
1668192104717,CSE 291,F00,116479,Pasquale; Joseph,0,0,0,0
1668192105151,CSE 293,001,119111,Bafna; Vineet,9999,0,9999,0
1668192105151,CSE 293,002,119118,Bellare; Mihir,9999,0,9999,0
1668192105151,CSE 293,003,119122,Berg-Kirkpatrick; Taylor D,9999,0,9999,0
1668192105151,CSE 293,004,119135,Christensen; Henrik I,9999,0,9999,0
1668192105151,CSE 293,005,119142,Cottrell; Garrison W,9999,0,9999,0
1668192105151,CSE 293,006,119146,Deutsch; Alin Bernard,9999,0,9999,0
1668192105151,CSE 293,007,119159,Esmaeilzadeh; Hadi,9999,0,9999,0
1668192105151,CSE 293,008,119166,Freund; Yoav,9999,0,9999,0
1668192105151,CSE 293,009,119170,Griswold; William G.,9999,0,9999,0
1668192105151,CSE 293,010,119183,Gymrek; Melissa Ann,9999,0,9999,0
1668192105151,CSE 293,011,119190,Heninger; Nadia A,9999,0,9999,0
1668192105151,CSE 293,012,119230,Impagliazzo; Russell,9999,0,9999,0
1668192105151,CSE 293,013,119232,Jhala; Ranjit,9999,0,9999,0
1668192105151,CSE 293,014,119233,Kahng; Andrew Byun,9999,0,9999,0
1668192105151,CSE 293,015,119298,Kane; Daniel Mertz,9999,0,9999,0
1668192105151,CSE 293,016,119299,Kriegman; David J,9999,0,9999,0
1668192105151,CSE 293,017,119300,Kumar; Arun Kumar,9999,0,9999,0
1668192105151,CSE 293,018,119301,Lerner; Sorin,9999,0,9999,0
1668192105151,CSE 293,019,119302,Lovett; Shachar,9999,0,9999,0
1668192105151,CSE 293,020,119303,McAuley; Julian John,9999,0,9999,0
1668192105151,CSE 293,021,119304,Micciancio; Daniele,9999,0,9999,0
1668192105151,CSE 293,022,119367,Orailoglu; Alex,9999,0,9999,0
1668192105151,CSE 293,023,119382,Paturi; Ramamohan,9999,0,9999,0
1668192105151,CSE 293,024,119404,Polikarpova; Nadezhda,9999,0,9999,0
1668192105151,CSE 293,025,119406,Politz; Joseph Gibbs,9999,0,9999,0
1668192105151,CSE 293,026,119411,Porter; George M,9999,0,9999,0
1668192105151,CSE 293,027,119414,Porter; Leonard Emerson,9999,0,9999,0
1668192105151,CSE 293,028,119416,Ramamoorthi; Ravi,9999,0,9999,0
1668192105151,CSE 293,029,119417,Sahoo; Debashis,9999,0,9999,0
1668192105151,CSE 293,030,119420,Saul; Lawrence,9999,0,9999,0
1668192105151,CSE 293,031,119421,Savage; Stefan,9999,0,9999,0
1668192105151,CSE 293,032,119425,Schulze; Jurgen P.,9999,0,9999,0
1668192105151,CSE 293,033,119426,Snoeren; Alex C.,9999,0,9999,0
1668192105151,CSE 293,034,119428,Shang; Jingbo,9999,0,9999,0
1668192105151,CSE 293,035,119430,Stefan; Deian,9999,0,9999,0
1668192105151,CSE 293,036,119431,Su; Hao,9999,0,9999,0
1668192105151,CSE 293,037,119433,Swanson; Steven James,9999,0,9999,0
1668192105151,CSE 293,038,119435,Tullsen; Dean Michael,9999,0,9999,0
1668192105151,CSE 293,039,119483,Voelker; Geoffrey M.,9999,0,9999,0
1668192105151,CSE 293,040,119537,Zhao; Jishen,9999,0,9999,0
1668192105151,CSE 293,041,119538,Zhou; Yuan-Yuan,9999,0,9999,0
1668192105151,CSE 293,042,119539,Gao; Sicun,9999,0,9999,0
1668192105151,CSE 293,043,119540,Weibel; Nadir,9999,0,9999,0
1668192105151,CSE 293,044,119541,Gupta; Rajesh K.,9999,0,9999,0
1668192105151,CSE 293,045,126410,Vaccaro; Kristen Marie,9999,0,9999,0
1668192105151,CSE 293,046,126411,Klemke; Richard,9999,0,9999,0
1668192105579,CSE 294,A00,102459,Voelker; Geoffrey M.,0,0,0,0
1668192105579,CSE 294,B00,111322,Orailoglu; Alex,0,0,0,0
1668192106002,DSE 201,A00,096914,Deutsch; Alin Bernard,30,0,30,0
1668192106426,DSE 210,A00,096915,Dasgupta; Sanjoy,30,0,30,0
1668192106848,DSE 260A,A00,096916,Altintas De Callaf; Ilkay,30,0,30,0
1668192107279,ECE 200,001,103586,Antipa; Nicholas A,9999,0,9999,0
1668192107279,ECE 200,002,103587,Atanasov; Nikolay A.,9999,0,9999,0
1668192107279,ECE 200,003,103588,Bharadia; Dinesh,9999,0,9999,0
1668192107279,ECE 200,004,103589,Cheng; Chung Kuan,9999,0,9999,0
1668192107279,ECE 200,005,103590,Cosman; Pamela C.,9999,0,9999,0
1668192107279,ECE 200,006,103591,Dayeh; Shadi Ahmad,9999,0,9999,0
1668192107279,ECE 200,007,103592,Fainman; Yeshaiahu,9999,0,9999,0
1668192107279,ECE 200,008,103593,Ford; Joseph Earl,9999,0,9999,0
1668192107279,ECE 200,009,103594,Franceschetti; Massimo,9999,0,9999,0
1668192107279,ECE 200,010,103595,Fullerton; Eric E,9999,0,9999,0
1668192107279,ECE 200,011,103596,Galton; Ian A,9999,0,9999,0
1668192107279,ECE 200,012,103597,Gilja; Vikash,9999,0,9999,0
1668192107279,ECE 200,013,103598,Hall; Drew A.,9999,0,9999,0
1668192107279,ECE 200,014,103599,Hsueh; Tzu-Chien,9999,0,9999,0
1668192107279,ECE 200,015,103600,Javidi; Tara,9999,0,9999,0
1668192107279,ECE 200,016,103601,Kahng; Andrew Byun,9999,0,9999,0
1668192107279,ECE 200,017,103602,Kim; Young-Han,9999,0,9999,0
1668192107279,ECE 200,018,103603,Koushanfar; Farinaz,9999,0,9999,0
1668192107279,ECE 200,019,103604,Kuzum; Duygu,9999,0,9999,0
1668192107279,ECE 200,020,103605,Le; Hanh-Phuc,9999,0,9999,0
1668192107279,ECE 200,021,103606,Lin; Bill,9999,0,9999,0
1668192107279,ECE 200,022,103607,Liu; Zhaowei,9998,0,9999,1
1668192107279,ECE 200,023,103608,Lo; Yu-Hwa,9999,0,9999,0
1668192107279,ECE 200,024,103609,Lomakin; Vitaliy,9999,0,9999,0
1668192107279,ECE 200,025,103610,Mercier; Patrick Philip,9999,0,9999,0
1668192107279,ECE 200,026,103611,Meyer; Florian,9999,0,9999,0
1668192107279,ECE 200,027,103612,Milstein; Laurence B.,9999,0,9999,0
1668192107279,ECE 200,028,103613,Mir Arabbaygi; Siavash,9999,0,9999,0
1668192107279,ECE 200,029,103614,Mookherjea; Shayan,9999,0,9999,0
1668192107279,ECE 200,030,103615,Morris; Karcher William,9999,0,9999,0
1668192107279,ECE 200,031,103616,Ng; Tse Nga,9999,0,9999,0
1668192107279,ECE 200,032,103617,Nguyen; Truong Quang,9999,0,9999,0
1668192107279,ECE 200,033,103618,Nomura; Kenji,9999,0,9999,0
1668192107279,ECE 200,034,103619,Orlitsky; Alon,9999,0,9999,0
1668192107279,ECE 200,035,103620,Pal; Piya,9999,0,9999,0
1668192107279,ECE 200,036,103621,Papen; George C.,9999,0,9999,0
1668192107279,ECE 200,037,103622,Radic; Stojan,9999,0,9999,0
1668192107279,ECE 200,038,103623,Rao; Bhaskar D.,9999,0,9999,0
1668192107279,ECE 200,039,103624,Rao; Ramesh R,9999,0,9999,0
1668192107279,ECE 200,040,103625,Rebeiz; Gabriel,9999,0,9999,0
1668192107279,ECE 200,041,103626,Sanford; John R,9999,0,9999,0
1668192107279,ECE 200,042,103627,Siegel; Paul H.,9999,0,9999,0
1668192107279,ECE 200,043,103628,Sievenpiper; Daniel F.,9999,0,9999,0
1668192107279,ECE 200,044,103629,Sworder; David D.,9999,0,9999,0
1668192107279,ECE 200,045,103630,Taur; Yuan,9999,0,9999,0
1668192107279,ECE 200,046,103631,Touri; Behrouz,9999,0,9999,0
1668192107279,ECE 200,047,103632,Trivedi; Mohan M.,9999,0,9999,0
1668192107279,ECE 200,048,103633,Vasconcelos; Nuno,9999,0,9999,0
1668192107279,ECE 200,049,103634,Wang; Xiaolong,9999,0,9999,0
1668192107279,ECE 200,050,103635,Xie; Pengtao,9999,0,9999,0
1668192107279,ECE 200,051,103636,Yip; Michael,9999,0,9999,0
1668192107279,ECE 200,052,103637,Zeger; Kenneth A.,999,0,999,0
1668192107279,ECE 200,053,103638,Zhang; Xinyu,9999,0,9999,0
1668192107279,ECE 200,054,103639,Turakhia; Yatish Girish,9999,0,9999,0
1668192107279,ECE 200,055,103640,Kang; Mingu,9999,0,9999,0
1668192107279,ECE 200,056,103641,Shi; Yuanyuan,9999,0,9999,0
1668192107279,ECE 200,057,103642,Wang; Edward Jay,9999,0,9999,0
1668192107279,ECE 200,058,103643,Zheng; Yang,9999,0,9999,0
1668192107706,ECE 202,A00,103644,Kuzum; Duygu,0,0,0,0
1668192108135,ECE 212BN,A00,103646,Ng; Tse Nga,0,0,0,0
1668192108563,ECE 221,A00,111493,Staff,0,0,0,0
1668192108988,ECE 222B,A00,103647,Lomakin; Vitaliy,0,0,0,0
1668192109431,ECE 230B,A00,103648,Taur; Yuan,0,0,0,0
1668192109868,ECE 238B,A00,103649,Garay; Javier,0,0,0,0
1668192110304,ECE 240B,A00,112900,Fainman; Yeshaiahu,0,0,0,0
1668192110730,ECE 247A,A00,103650,Jokerst; Jesse Vincent,0,0,0,0
1668192111159,ECE 247B,A00,103651,Wang; Joseph,0,0,0,0
1668192111581,ECE 250,A00,103652,Siegel; Paul H.,0,0,0,0
1668192112005,ECE 251A,A00,103654,Rao; Bhaskar D.,0,0,0,0
1668192112427,ECE 257B,A00,103655,Bharadia; Dinesh,0,0,0,0
1668192112864,ECE 258A,A00,103656,Milstein; Laurence B.,0,0,0,0
1668192113287,ECE 260B,A00,103658,Kang; Mingu,0,0,0,0
1668192113716,ECE 264A,A00,103659,Galton; Ian A,0,0,0,0
1668192114146,ECE 265A,A00,103661,Gudem; Prasad S.S.,0,0,0,0
1668192114569,ECE 265D,A00,103662,Gudem; Prasad S.S.,0,0,0,0
1668192114995,ECE 268,A00,103663,Koushanfar; Farinaz,0,0,0,0
1668192115431,ECE 269,A01,103665,Pal; Piya,0,0,0,0
1668192115854,ECE 271B,A00,103666,Vasconcelos; Manuela,0,0,0,0
1668192116286,ECE 276A,A00,103667,Atanasov; Nikolay A.,0,0,0,0
1668192116716,ECE 277,A00,103668,An; Cheolhong,0,0,0,0
1668192117166,ECE 279,A00,117947,Hall; Drew A.,0,0,0,0
1668192118022,ECE 283,A00,103670,Hsueh; Tzu-Chien,0,0,0,0
1668192118447,ECE 284,A00,103671,Turakhia; Yatish Girish,0,0,0,0
1668192118879,ECE 285,A00,103672,Zheng; Yang,0,0,0,0
1668192118879,ECE 285,B00,103673,Sworder; David D.,0,0,0,0
1668192119310,ECE 287,A00,103676,Javidi; Tara,0,0,0,0
1668192119742,MATH 200B,A00,098023,Salehi Golsefidy; Alireza,12,0,15,3
1668192120168,MATH 202B,A00,098024,Rhoades; Brendon Patrick,9,0,15,6
1668192120662,MATH 203B,A00,098025,Oprea; Dragos N.,10,0,15,5
1668192121091,MATH 204B,A00,098026,Sorensen; Claus M,13,0,15,2
1668192121520,MATH 208,A00,098027,Izadi; Elham,7,0,10,3
1668192121942,MATH 209,A00,098028,Pollack; Aaron,10,0,10,0
1668192122368,MATH 211A,A00,112919,Rogalski; Daniel,9,0,10,1
1668192122793,MATH 211B,A00,112920,Seward; Brandon M.,9,0,10,1
1668192123215,MATH 218,A00,098029,Li; Bo,10,0,10,0
1668192123644,MATH 220B,A00,098030,Novak; Jonathan I,11,0,15,4
1668192124068,MATH 221A,A00,098031,Ebenfelt; Peter F,13,0,15,2
1668192124493,MATH 231B,A00,098032,Zlatos; Andrej,12,0,15,3
1668192124973,MATH 240B,A00,098033,Ni; Lei,9,0,15,6
1668192125411,MATH 243,A00,098034,Jekel; David Andrew,10,0,10,0
1668192125840,MATH 245A,A00,098035,Nie; Jiawang,0,0,15,16
1668192126266,MATH 248,A00,098036,Bejenaru; Ioan,10,0,10,0
1668192126699,MATH 250B,A00,098037,Spolaor; Luca,14,0,15,1
1668192127131,MATH 258,A00,098038,Ni; Lei,10,0,10,0
1668192127558,MATH 264B,A00,098041,Rhoades; Brendon Patrick,9,0,15,6
1668192127981,MATH 268,A00,098042,Buss; Samuel R,10,0,10,0
1668192128404,MATH 269,A00,098043,Rhoades; Brendon Patrick,10,0,10,0
1668192128846,MATH 270B,A00,098044,Li; Bo,10,0,15,5
1668192129269,MATH 272B,A00,098045,Holst; Michael J,13,0,15,2
1668192129698,MATH 273A,A00,098046,Tian; Xiaochuan,10,0,15,5
1668192130140,MATH 275,A01,098048,Tian; Xiaochuan,6,0,10,4
1668192130561,MATH 278A,A00,098049,Holst; Michael J,8,0,10,2
1668192130985,MATH 278B,A00,098050,Cloninger; Alexander,10,0,10,0
1668192131410,MATH 278C,A00,098051,Nie; Jiawang,7,0,10,3
1668192131833,MATH 280B,A00,098052,Zheng; Tianyi,10,0,15,5
1668192132258,MATH 281B,A00,098053,Bradic; Jelena,2,0,15,13
1668192132783,MATH 282B,A00,098054,Arias-Castro; Ery,0,0,15,15
1668192133208,MATH 285,A00,098055,Fitzsimmons; Patrick J,0,0,15,17
1668192133631,MATH 287B,A00,098056,Arias-Castro; Ery,2,0,15,13
1668192134055,MATH 288,A00,098057,Agarwal; Pooja,9,0,10,1
1668192134055,MATH 288,B00,098058,Zhang; Danna,8,0,10,2
1668192134055,MATH 288,C00,098059,Williams; Ruth J,10,0,10,0
1668192134479,MATH 290B,A00,098060,Roberts; Justin Deritter,13,0,15,2
1668192134922,MATH 292,A00,098061,Belmont; Eva Kinoshita,10,0,10,0
1668192135345,MATH 295,A00,098062,Suk; Andrew Hoon,48,0,50,2
1668192135773,MATH 296,A00,098063,Novak; Jonathan I,20,0,20,0
1668192136195,MATH 297,001,098064,Gamst; Anthony Collins,9997,0,9999,2
1668192646837,COGS 205,A00,101395,Chiba; Andrea,19,0,20,1
1668192647261,COGS 210B,001,101404,Greene; Deanna Jacquelyn,9998,0,9999,1
1668192647261,COGS 210B,002,101417,Xia; Haijun,9999,0,9999,0
1668192647261,COGS 210B,003,101422,Nitz; Douglas A.,9999,0,9999,0
1668192647261,COGS 210B,004,101423,Hollan; James D.,9998,0,9999,1
1668192647261,COGS 210B,005,101424,Deak; Gedeon O.,9998,0,9999,1
1668192647261,COGS 210B,006,101425,Rossano; Federico,9999,0,9999,0
1668192647685,COGS 211B,A00,101427,Coulson; Seana M,9996,0,9999,3
1668192648110,COGS 220,A00,101428,Hollan; James D.,0,0,25,25
1668192648536,COGS 229,A00,101429,Dow; Steven P,18,0,25,7
1668192648962,COGS 230,A00,101430,Klemmer; Scott R,12,0,17,5
1668192649384,COGS 234,A00,101431,Xia; Haijun,3,0,25,22
1668192649809,COGS 260,A00,101432,Kiyonaga; Anastasia,20,0,25,5
1668192649809,COGS 260,B00,101433,Kirsh; David Joel,16,0,25,9
1668192650234,CSE 202,A00,102371,Impagliazzo; Russell,0,0,0,0
1668192650657,CSE 203B,A01,102373,Cheng; Chung Kuan,0,0,0,0
1668192651091,CSE 208,A00,102374,Micciancio; Daniele,0,0,0,0
1668192651528,CSE 209A,A00,112895,Impagliazzo; Russell,0,0,15,15
1668192651951,CSE 209B,A00,108005,Bellare; Mihir,0,0,0,0
1668192652375,CSE 210,A00,113163,Coblenz; Michael J,0,0,0,0
1668192652800,CSE 219,A00,106111,Dow; Steven P,0,0,20,20
1668192653226,CSE 221,A00,102376,Voelker; Geoffrey M.,0,0,0,0
1668192653656,CSE 224,A01,102378,Porter; George M,0,0,0,0
1668192654082,CSE 229A,A00,102379,Savage; Stefan,0,0,0,0
1668192654504,CSE 229C,A00,102380,Munyaka; Imani N. S.,0,0,0,0
1668192654926,CSE 232B,A00,102382,Deutsch; Alin Bernard,0,0,0,0
1668192655353,CSE 234,A01,112904,Kumar; Arun Kumar,0,0,0,0
1668192655802,CSE 237A,A00,102383,Rosing; Tajana Simunic,0,0,0,0
1668192656235,CSE 239A,A00,102384,Deutsch; Alin Bernard,0,0,0,0
1668192656666,CSE 239B,A00,102385,Polikarpova; Nadezhda,0,0,0,0
1668192657088,CSE 240A,A00,102386,Pannuto; Patrick William,0,0,0,0
1668192657510,CSE 240B,A00,102387,Zhao; Jishen,0,0,0,0
1668192657933,CSE 241A,A00,106406,Kang; Mingu,0,0,0,0
1668192658358,CSE 249B,A00,102388,Kahng; Andrew Byun,0,0,8,8
1668192658787,CSE 251B,A01,102392,Cottrell; Garrison W,0,0,0,0
1668192658787,CSE 251B,A02,102393,Cottrell; Garrison W,0,0,0,0
1668192659210,CSE 252B,A00,102394,Ochoa; Benjamin Lawrence,0,0,0,0
1668192659636,CSE 257,A01,102396,Gao; Sicun,0,0,0,0
1668192660066,CSE 272,A00,102397,Li; Tzumao,0,0,0,0
1668192660493,CSE 274,A00,111323,Chern; Albert Ren-Haur,0,0,0,0
1668192660926,CSE 282,A00,102398,Pevzner; Pavel Arkadjevich,0,0,0,0
1668192661352,CSE 284,A00,114175,Gymrek; Melissa Ann,0,0,0,0
1668192661776,CSE 290,A00,102399,Chandraker; Manmohan Krishna,0,0,0,0
1668192661776,CSE 290,B00,102400,Vaccaro; Kristen Marie,0,0,25,25
1668192661776,CSE 290,C00,102414,Pannuto; Patrick William,0,0,25,25
1668192661776,CSE 290,D00,102427,Pevzner; Pavel Arkadjevich,0,0,0,0
1668192661776,CSE 290,E00,102429,Zhao; Jishen,0,0,0,0
1668192661776,CSE 290,F00,102436,Tullsen; Dean Michael,0,0,0,0
1668192661776,CSE 290,G00,102440,Christensen; Henrik I,0,0,20,20
1668192662202,CSE 291,A00,102443,Su; Hao,0,0,0,0
1668192662202,CSE 291,B00,102448,Polikarpova; Nadezhda,0,0,0,0
1668192662202,CSE 291,C00,102453,Vaccaro; Kristen Marie,0,0,0,0
1668192662202,CSE 291,D00,111343,Savage; Stefan,0,0,0,0
1668192662202,CSE 291,E00,116474,Claffy; Kimberly Claire,0,0,0,0
1668192662202,CSE 291,F00,116479,Pasquale; Joseph,0,0,0,0
1668192662651,CSE 293,001,119111,Bafna; Vineet,9999,0,9999,0
1668192662651,CSE 293,002,119118,Bellare; Mihir,9999,0,9999,0
1668192662651,CSE 293,003,119122,Berg-Kirkpatrick; Taylor D,9999,0,9999,0
1668192662651,CSE 293,004,119135,Christensen; Henrik I,9999,0,9999,0
1668192662651,CSE 293,005,119142,Cottrell; Garrison W,9999,0,9999,0
1668192662651,CSE 293,006,119146,Deutsch; Alin Bernard,9999,0,9999,0
1668192662651,CSE 293,007,119159,Esmaeilzadeh; Hadi,9999,0,9999,0
1668192662651,CSE 293,008,119166,Freund; Yoav,9999,0,9999,0
1668192662651,CSE 293,009,119170,Griswold; William G.,9999,0,9999,0
1668192662651,CSE 293,010,119183,Gymrek; Melissa Ann,9999,0,9999,0
1668192662651,CSE 293,011,119190,Heninger; Nadia A,9999,0,9999,0
1668192662651,CSE 293,012,119230,Impagliazzo; Russell,9999,0,9999,0
1668192662651,CSE 293,013,119232,Jhala; Ranjit,9999,0,9999,0
1668192662651,CSE 293,014,119233,Kahng; Andrew Byun,9999,0,9999,0
1668192662651,CSE 293,015,119298,Kane; Daniel Mertz,9999,0,9999,0
1668192662651,CSE 293,016,119299,Kriegman; David J,9999,0,9999,0
1668192662651,CSE 293,017,119300,Kumar; Arun Kumar,9999,0,9999,0
1668192662651,CSE 293,018,119301,Lerner; Sorin,9999,0,9999,0
1668192662651,CSE 293,019,119302,Lovett; Shachar,9999,0,9999,0
1668192662651,CSE 293,020,119303,McAuley; Julian John,9999,0,9999,0
1668192662651,CSE 293,021,119304,Micciancio; Daniele,9999,0,9999,0
1668192662651,CSE 293,022,119367,Orailoglu; Alex,9999,0,9999,0
1668192662651,CSE 293,023,119382,Paturi; Ramamohan,9999,0,9999,0
1668192662651,CSE 293,024,119404,Polikarpova; Nadezhda,9999,0,9999,0
1668192662651,CSE 293,025,119406,Politz; Joseph Gibbs,9999,0,9999,0
1668192662651,CSE 293,026,119411,Porter; George M,9999,0,9999,0
1668192662651,CSE 293,027,119414,Porter; Leonard Emerson,9999,0,9999,0
1668192662651,CSE 293,028,119416,Ramamoorthi; Ravi,9999,0,9999,0
1668192662651,CSE 293,029,119417,Sahoo; Debashis,9999,0,9999,0
1668192662651,CSE 293,030,119420,Saul; Lawrence,9999,0,9999,0
1668192662651,CSE 293,031,119421,Savage; Stefan,9999,0,9999,0
1668192662651,CSE 293,032,119425,Schulze; Jurgen P.,9999,0,9999,0
1668192662651,CSE 293,033,119426,Snoeren; Alex C.,9999,0,9999,0
1668192662651,CSE 293,034,119428,Shang; Jingbo,9999,0,9999,0
1668192662651,CSE 293,035,119430,Stefan; Deian,9999,0,9999,0
1668192662651,CSE 293,036,119431,Su; Hao,9999,0,9999,0
1668192662651,CSE 293,037,119433,Swanson; Steven James,9999,0,9999,0
1668192662651,CSE 293,038,119435,Tullsen; Dean Michael,9999,0,9999,0
1668192662651,CSE 293,039,119483,Voelker; Geoffrey M.,9999,0,9999,0
1668192662651,CSE 293,040,119537,Zhao; Jishen,9999,0,9999,0
1668192662651,CSE 293,041,119538,Zhou; Yuan-Yuan,9999,0,9999,0
1668192662651,CSE 293,042,119539,Gao; Sicun,9999,0,9999,0
1668192662651,CSE 293,043,119540,Weibel; Nadir,9999,0,9999,0
1668192662651,CSE 293,044,119541,Gupta; Rajesh K.,9999,0,9999,0
1668192662651,CSE 293,045,126410,Vaccaro; Kristen Marie,9999,0,9999,0
1668192662651,CSE 293,046,126411,Klemke; Richard,9999,0,9999,0
1668192663077,CSE 294,A00,102459,Voelker; Geoffrey M.,0,0,0,0
1668192663077,CSE 294,B00,111322,Orailoglu; Alex,0,0,0,0
1668192663573,DSE 201,A00,096914,Deutsch; Alin Bernard,30,0,30,0
1668192663995,DSE 210,A00,096915,Dasgupta; Sanjoy,30,0,30,0
1668192664420,DSE 260A,A00,096916,Altintas De Callaf; Ilkay,30,0,30,0
1668192664887,ECE 200,001,103586,Antipa; Nicholas A,9999,0,9999,0
1668192664887,ECE 200,002,103587,Atanasov; Nikolay A.,9999,0,9999,0
1668192664887,ECE 200,003,103588,Bharadia; Dinesh,9999,0,9999,0
1668192664887,ECE 200,004,103589,Cheng; Chung Kuan,9999,0,9999,0
1668192664887,ECE 200,005,103590,Cosman; Pamela C.,9999,0,9999,0
1668192664887,ECE 200,006,103591,Dayeh; Shadi Ahmad,9999,0,9999,0
1668192664887,ECE 200,007,103592,Fainman; Yeshaiahu,9999,0,9999,0
1668192664887,ECE 200,008,103593,Ford; Joseph Earl,9999,0,9999,0
1668192664887,ECE 200,009,103594,Franceschetti; Massimo,9999,0,9999,0
1668192664887,ECE 200,010,103595,Fullerton; Eric E,9999,0,9999,0
1668192664887,ECE 200,011,103596,Galton; Ian A,9999,0,9999,0
1668192664887,ECE 200,012,103597,Gilja; Vikash,9999,0,9999,0
1668192664887,ECE 200,013,103598,Hall; Drew A.,9999,0,9999,0
1668192664887,ECE 200,014,103599,Hsueh; Tzu-Chien,9999,0,9999,0
1668192664887,ECE 200,015,103600,Javidi; Tara,9999,0,9999,0
1668192664887,ECE 200,016,103601,Kahng; Andrew Byun,9999,0,9999,0
1668192664887,ECE 200,017,103602,Kim; Young-Han,9999,0,9999,0
1668192664887,ECE 200,018,103603,Koushanfar; Farinaz,9999,0,9999,0
1668192664887,ECE 200,019,103604,Kuzum; Duygu,9999,0,9999,0
1668192664887,ECE 200,020,103605,Le; Hanh-Phuc,9999,0,9999,0
1668192664887,ECE 200,021,103606,Lin; Bill,9999,0,9999,0
1668192664887,ECE 200,022,103607,Liu; Zhaowei,9998,0,9999,1
1668192664887,ECE 200,023,103608,Lo; Yu-Hwa,9999,0,9999,0
1668192664887,ECE 200,024,103609,Lomakin; Vitaliy,9999,0,9999,0
1668192664887,ECE 200,025,103610,Mercier; Patrick Philip,9999,0,9999,0
1668192664887,ECE 200,026,103611,Meyer; Florian,9999,0,9999,0
1668192664887,ECE 200,027,103612,Milstein; Laurence B.,9999,0,9999,0
1668192664887,ECE 200,028,103613,Mir Arabbaygi; Siavash,9999,0,9999,0
1668192664887,ECE 200,029,103614,Mookherjea; Shayan,9999,0,9999,0
1668192664887,ECE 200,030,103615,Morris; Karcher William,9999,0,9999,0
1668192664887,ECE 200,031,103616,Ng; Tse Nga,9999,0,9999,0
1668192664887,ECE 200,032,103617,Nguyen; Truong Quang,9999,0,9999,0
1668192664887,ECE 200,033,103618,Nomura; Kenji,9999,0,9999,0
1668192664887,ECE 200,034,103619,Orlitsky; Alon,9999,0,9999,0
1668192664887,ECE 200,035,103620,Pal; Piya,9999,0,9999,0
1668192664887,ECE 200,036,103621,Papen; George C.,9999,0,9999,0
1668192664887,ECE 200,037,103622,Radic; Stojan,9999,0,9999,0
1668192664887,ECE 200,038,103623,Rao; Bhaskar D.,9999,0,9999,0
1668192664887,ECE 200,039,103624,Rao; Ramesh R,9999,0,9999,0
1668192664887,ECE 200,040,103625,Rebeiz; Gabriel,9999,0,9999,0
1668192664887,ECE 200,041,103626,Sanford; John R,9999,0,9999,0
1668192664887,ECE 200,042,103627,Siegel; Paul H.,9999,0,9999,0
1668192664887,ECE 200,043,103628,Sievenpiper; Daniel F.,9999,0,9999,0
1668192664887,ECE 200,044,103629,Sworder; David D.,9999,0,9999,0
1668192664887,ECE 200,045,103630,Taur; Yuan,9999,0,9999,0
1668192664887,ECE 200,046,103631,Touri; Behrouz,9999,0,9999,0
1668192664887,ECE 200,047,103632,Trivedi; Mohan M.,9999,0,9999,0
1668192664887,ECE 200,048,103633,Vasconcelos; Nuno,9999,0,9999,0
1668192664887,ECE 200,049,103634,Wang; Xiaolong,9999,0,9999,0
1668192664887,ECE 200,050,103635,Xie; Pengtao,9999,0,9999,0
1668192664887,ECE 200,051,103636,Yip; Michael,9999,0,9999,0
1668192664887,ECE 200,052,103637,Zeger; Kenneth A.,999,0,999,0
1668192664887,ECE 200,053,103638,Zhang; Xinyu,9999,0,9999,0
1668192664887,ECE 200,054,103639,Turakhia; Yatish Girish,9999,0,9999,0
1668192664887,ECE 200,055,103640,Kang; Mingu,9999,0,9999,0
1668192664887,ECE 200,056,103641,Shi; Yuanyuan,9999,0,9999,0
1668192664887,ECE 200,057,103642,Wang; Edward Jay,9999,0,9999,0
1668192664887,ECE 200,058,103643,Zheng; Yang,9999,0,9999,0
1668192665321,ECE 202,A00,103644,Kuzum; Duygu,0,0,0,0
1668192665746,ECE 212BN,A00,103646,Ng; Tse Nga,0,0,0,0
1668192666187,ECE 221,A00,111493,Staff,0,0,0,0
1668192666609,ECE 222B,A00,103647,Lomakin; Vitaliy,0,0,0,0
1668192667031,ECE 230B,A00,103648,Taur; Yuan,0,0,0,0
1668192667455,ECE 238B,A00,103649,Garay; Javier,0,0,0,0
1668192667886,ECE 240B,A00,112900,Fainman; Yeshaiahu,0,0,0,0
1668192668311,ECE 247A,A00,103650,Jokerst; Jesse Vincent,0,0,0,0
1668192668746,ECE 247B,A00,103651,Wang; Joseph,0,0,0,0
1668192669168,ECE 250,A00,103652,Siegel; Paul H.,0,0,0,0
1668192669597,ECE 251A,A00,103654,Rao; Bhaskar D.,0,0,0,0
1668192670021,ECE 257B,A00,103655,Bharadia; Dinesh,0,0,0,0
1668192670448,ECE 258A,A00,103656,Milstein; Laurence B.,0,0,0,0
1668192670872,ECE 260B,A00,103658,Kang; Mingu,0,0,0,0
1668192671296,ECE 264A,A00,103659,Galton; Ian A,0,0,0,0
1668192671718,ECE 265A,A00,103661,Gudem; Prasad S.S.,0,0,0,0
1668192672141,ECE 265D,A00,103662,Gudem; Prasad S.S.,0,0,0,0
1668192672567,ECE 268,A00,103663,Koushanfar; Farinaz,0,0,0,0
1668192672999,ECE 269,A01,103665,Pal; Piya,0,0,0,0
1668192673423,ECE 271B,A00,103666,Vasconcelos; Manuela,0,0,0,0
1668192673846,ECE 276A,A00,103667,Atanasov; Nikolay A.,0,0,0,0
1668192674270,ECE 277,A00,103668,An; Cheolhong,0,0,0,0
1668192674691,ECE 279,A00,117947,Hall; Drew A.,0,0,0,0
1668192675567,ECE 283,A00,103670,Hsueh; Tzu-Chien,0,0,0,0
1668192675993,ECE 284,A00,103671,Turakhia; Yatish Girish,0,0,0,0
1668192676428,ECE 285,A00,103672,Zheng; Yang,0,0,0,0
1668192676428,ECE 285,B00,103673,Sworder; David D.,0,0,0,0
1668192676855,ECE 287,A00,103676,Javidi; Tara,0,0,0,0
1668192677281,MATH 200B,A00,098023,Salehi Golsefidy; Alireza,12,0,15,3
1668192677703,MATH 202B,A00,098024,Rhoades; Brendon Patrick,9,0,15,6
1668192678134,MATH 203B,A00,098025,Oprea; Dragos N.,10,0,15,5
1668192678556,MATH 204B,A00,098026,Sorensen; Claus M,13,0,15,2
1668192678980,MATH 208,A00,098027,Izadi; Elham,7,0,10,3
1668192679404,MATH 209,A00,098028,Pollack; Aaron,10,0,10,0
1668192679828,MATH 211A,A00,112919,Rogalski; Daniel,9,0,10,1
1668192680253,MATH 211B,A00,112920,Seward; Brandon M.,9,0,10,1
1668192680675,MATH 218,A00,098029,Li; Bo,10,0,10,0
1668192681104,MATH 220B,A00,098030,Novak; Jonathan I,11,0,15,4
1668192681528,MATH 221A,A00,098031,Ebenfelt; Peter F,13,0,15,2
1668192681952,MATH 231B,A00,098032,Zlatos; Andrej,12,0,15,3
1668192682375,MATH 240B,A00,098033,Ni; Lei,9,0,15,6
1668192682807,MATH 243,A00,098034,Jekel; David Andrew,10,0,10,0
1668192683229,MATH 245A,A00,098035,Nie; Jiawang,0,0,15,16
1668192683654,MATH 248,A00,098036,Bejenaru; Ioan,10,0,10,0
1668192684080,MATH 250B,A00,098037,Spolaor; Luca,14,0,15,1
1668192684503,MATH 258,A00,098038,Ni; Lei,10,0,10,0
1668192684927,MATH 264B,A00,098041,Rhoades; Brendon Patrick,9,0,15,6
1668192685352,MATH 268,A00,098042,Buss; Samuel R,10,0,10,0
1668192685780,MATH 269,A00,098043,Rhoades; Brendon Patrick,10,0,10,0
1668192686208,MATH 270B,A00,098044,Li; Bo,10,0,15,5
1668192686631,MATH 272B,A00,098045,Holst; Michael J,13,0,15,2
1668192687068,MATH 273A,A00,098046,Tian; Xiaochuan,10,0,15,5
1668192687499,MATH 275,A01,098048,Tian; Xiaochuan,6,0,10,4
1668192687921,MATH 278A,A00,098049,Holst; Michael J,8,0,10,2
1668192688348,MATH 278B,A00,098050,Cloninger; Alexander,10,0,10,0
1668192688770,MATH 278C,A00,098051,Nie; Jiawang,7,0,10,3
1668192689194,MATH 280B,A00,098052,Zheng; Tianyi,10,0,15,5
1668192689616,MATH 281B,A00,098053,Bradic; Jelena,2,0,15,13
1668192690038,MATH 282B,A00,098054,Arias-Castro; Ery,0,0,15,15
1668192690473,MATH 285,A00,098055,Fitzsimmons; Patrick J,0,0,15,17
1668192690899,MATH 287B,A00,098056,Arias-Castro; Ery,2,0,15,13
1668192691338,MATH 288,A00,098057,Agarwal; Pooja,9,0,10,1
1668192691338,MATH 288,B00,098058,Zhang; Danna,8,0,10,2
1668192691338,MATH 288,C00,098059,Williams; Ruth J,10,0,10,0
1668192691776,MATH 290B,A00,098060,Roberts; Justin Deritter,13,0,15,2
1668192692208,MATH 292,A00,098061,Belmont; Eva Kinoshita,10,0,10,0
1668192692643,MATH 295,A00,098062,Suk; Andrew Hoon,48,0,50,2
1668192693067,MATH 296,A00,098063,Novak; Jonathan I,20,0,20,0
1668192693491,MATH 297,001,098064,Gamst; Anthony Collins,9997,0,9999,2
1668193195097,COGS 205,A00,101395,Chiba; Andrea,19,0,20,1
1668193195521,COGS 210B,001,101404,Greene; Deanna Jacquelyn,9998,0,9999,1
1668193195521,COGS 210B,002,101417,Xia; Haijun,9999,0,9999,0
1668193195521,COGS 210B,003,101422,Nitz; Douglas A.,9999,0,9999,0
1668193195521,COGS 210B,004,101423,Hollan; James D.,9998,0,9999,1
1668193195521,COGS 210B,005,101424,Deak; Gedeon O.,9998,0,9999,1
1668193195521,COGS 210B,006,101425,Rossano; Federico,9999,0,9999,0
1668193195945,COGS 211B,A00,101427,Coulson; Seana M,9996,0,9999,3
1668193196434,COGS 220,A00,101428,Hollan; James D.,0,0,25,25
1668193196856,COGS 229,A00,101429,Dow; Steven P,18,0,25,7
1668193197287,COGS 230,A00,101430,Klemmer; Scott R,12,0,17,5
1668193197713,COGS 234,A00,101431,Xia; Haijun,3,0,25,22
1668193198150,COGS 260,A00,101432,Kiyonaga; Anastasia,20,0,25,5
1668193198150,COGS 260,B00,101433,Kirsh; David Joel,16,0,25,9
1668193198579,CSE 202,A00,102371,Impagliazzo; Russell,0,0,0,0
1668193199003,CSE 203B,A01,102373,Cheng; Chung Kuan,0,0,0,0
1668193199429,CSE 208,A00,102374,Micciancio; Daniele,0,0,0,0
1668193199861,CSE 209A,A00,112895,Impagliazzo; Russell,0,0,15,15
1668193200286,CSE 209B,A00,108005,Bellare; Mihir,0,0,0,0
1668193201134,CSE 210,A00,113163,Coblenz; Michael J,0,0,0,0
1668193201555,CSE 219,A00,106111,Dow; Steven P,0,0,20,20
1668193201994,CSE 221,A00,102376,Voelker; Geoffrey M.,0,0,0,0
1668193202426,CSE 224,A01,102378,Porter; George M,0,0,0,0
1668193202853,CSE 229A,A00,102379,Savage; Stefan,0,0,0,0
1668193203295,CSE 229C,A00,102380,Munyaka; Imani N. S.,0,0,0,0
1668193203718,CSE 232B,A00,102382,Deutsch; Alin Bernard,0,0,0,0
1668193204149,CSE 234,A01,112904,Kumar; Arun Kumar,0,0,0,0
1668193204572,CSE 237A,A00,102383,Rosing; Tajana Simunic,0,0,0,0
1668193205004,CSE 239A,A00,102384,Deutsch; Alin Bernard,0,0,0,0
1668193205455,CSE 239B,A00,102385,Polikarpova; Nadezhda,0,0,0,0
1668193205890,CSE 240A,A00,102386,Pannuto; Patrick William,0,0,0,0
1668193206335,CSE 240B,A00,102387,Zhao; Jishen,0,0,0,0
1668193206759,CSE 241A,A00,106406,Kang; Mingu,0,0,0,0
1668193207190,CSE 249B,A00,102388,Kahng; Andrew Byun,0,0,8,8
1668193207636,CSE 251B,A01,102392,Cottrell; Garrison W,0,0,0,0
1668193207636,CSE 251B,A02,102393,Cottrell; Garrison W,0,0,0,0
1668193208087,CSE 252B,A00,102394,Ochoa; Benjamin Lawrence,0,0,0,0
1668193208513,CSE 257,A01,102396,Gao; Sicun,0,0,0,0
1668193208948,CSE 272,A00,102397,Li; Tzumao,0,0,0,0
1668193209374,CSE 274,A00,111323,Chern; Albert Ren-Haur,0,0,0,0
1668193209798,CSE 282,A00,102398,Pevzner; Pavel Arkadjevich,0,0,0,0
1668193210225,CSE 284,A00,114175,Gymrek; Melissa Ann,0,0,0,0
1668193210649,CSE 290,A00,102399,Chandraker; Manmohan Krishna,0,0,0,0
1668193210649,CSE 290,B00,102400,Vaccaro; Kristen Marie,0,0,25,25
1668193210649,CSE 290,C00,102414,Pannuto; Patrick William,0,0,25,25
1668193210649,CSE 290,D00,102427,Pevzner; Pavel Arkadjevich,0,0,0,0
1668193210649,CSE 290,E00,102429,Zhao; Jishen,0,0,0,0
1668193210649,CSE 290,F00,102436,Tullsen; Dean Michael,0,0,0,0
1668193210649,CSE 290,G00,102440,Christensen; Henrik I,0,0,20,20
1668193211095,CSE 291,A00,102443,Su; Hao,0,0,0,0
1668193211095,CSE 291,B00,102448,Polikarpova; Nadezhda,0,0,0,0
1668193211095,CSE 291,C00,102453,Vaccaro; Kristen Marie,0,0,0,0
1668193211095,CSE 291,D00,111343,Savage; Stefan,0,0,0,0
1668193211095,CSE 291,E00,116474,Claffy; Kimberly Claire,0,0,0,0
1668193211095,CSE 291,F00,116479,Pasquale; Joseph,0,0,0,0
1668193211569,CSE 293,001,119111,Bafna; Vineet,9999,0,9999,0
1668193211569,CSE 293,002,119118,Bellare; Mihir,9999,0,9999,0
1668193211569,CSE 293,003,119122,Berg-Kirkpatrick; Taylor D,9999,0,9999,0
1668193211569,CSE 293,004,119135,Christensen; Henrik I,9999,0,9999,0
1668193211569,CSE 293,005,119142,Cottrell; Garrison W,9999,0,9999,0
1668193211569,CSE 293,006,119146,Deutsch; Alin Bernard,9999,0,9999,0
1668193211569,CSE 293,007,119159,Esmaeilzadeh; Hadi,9999,0,9999,0
1668193211569,CSE 293,008,119166,Freund; Yoav,9999,0,9999,0
1668193211569,CSE 293,009,119170,Griswold; William G.,9999,0,9999,0
1668193211569,CSE 293,010,119183,Gymrek; Melissa Ann,9999,0,9999,0
1668193211569,CSE 293,011,119190,Heninger; Nadia A,9999,0,9999,0
1668193211569,CSE 293,012,119230,Impagliazzo; Russell,9999,0,9999,0
1668193211569,CSE 293,013,119232,Jhala; Ranjit,9999,0,9999,0
1668193211569,CSE 293,014,119233,Kahng; Andrew Byun,9999,0,9999,0
1668193211569,CSE 293,015,119298,Kane; Daniel Mertz,9999,0,9999,0
1668193211569,CSE 293,016,119299,Kriegman; David J,9999,0,9999,0
1668193211569,CSE 293,017,119300,Kumar; Arun Kumar,9999,0,9999,0
1668193211569,CSE 293,018,119301,Lerner; Sorin,9999,0,9999,0
1668193211569,CSE 293,019,119302,Lovett; Shachar,9999,0,9999,0
1668193211569,CSE 293,020,119303,McAuley; Julian John,9999,0,9999,0
1668193211569,CSE 293,021,119304,Micciancio; Daniele,9999,0,9999,0
1668193211569,CSE 293,022,119367,Orailoglu; Alex,9999,0,9999,0
1668193211569,CSE 293,023,119382,Paturi; Ramamohan,9999,0,9999,0
1668193211569,CSE 293,024,119404,Polikarpova; Nadezhda,9999,0,9999,0
1668193211569,CSE 293,025,119406,Politz; Joseph Gibbs,9999,0,9999,0
1668193211569,CSE 293,026,119411,Porter; George M,9999,0,9999,0
1668193211569,CSE 293,027,119414,Porter; Leonard Emerson,9999,0,9999,0
1668193211569,CSE 293,028,119416,Ramamoorthi; Ravi,9999,0,9999,0
1668193211569,CSE 293,029,119417,Sahoo; Debashis,9999,0,9999,0
1668193211569,CSE 293,030,119420,Saul; Lawrence,9999,0,9999,0
1668193211569,CSE 293,031,119421,Savage; Stefan,9999,0,9999,0
1668193211569,CSE 293,032,119425,Schulze; Jurgen P.,9999,0,9999,0
1668193211569,CSE 293,033,119426,Snoeren; Alex C.,9999,0,9999,0
1668193211569,CSE 293,034,119428,Shang; Jingbo,9999,0,9999,0
1668193211569,CSE 293,035,119430,Stefan; Deian,9999,0,9999,0
1668193211569,CSE 293,036,119431,Su; Hao,9999,0,9999,0
1668193211569,CSE 293,037,119433,Swanson; Steven James,9999,0,9999,0
1668193211569,CSE 293,038,119435,Tullsen; Dean Michael,9999,0,9999,0
1668193211569,CSE 293,039,119483,Voelker; Geoffrey M.,9999,0,9999,0
1668193211569,CSE 293,040,119537,Zhao; Jishen,9999,0,9999,0
1668193211569,CSE 293,041,119538,Zhou; Yuan-Yuan,9999,0,9999,0
1668193211569,CSE 293,042,119539,Gao; Sicun,9999,0,9999,0
1668193211569,CSE 293,043,119540,Weibel; Nadir,9999,0,9999,0
1668193211569,CSE 293,044,119541,Gupta; Rajesh K.,9999,0,9999,0
1668193211569,CSE 293,045,126410,Vaccaro; Kristen Marie,9999,0,9999,0
1668193211569,CSE 293,046,126411,Klemke; Richard,9999,0,9999,0
1668193211993,CSE 294,A00,102459,Voelker; Geoffrey M.,0,0,0,0
1668193211993,CSE 294,B00,111322,Orailoglu; Alex,0,0,0,0
1668193212435,DSE 201,A00,096914,Deutsch; Alin Bernard,30,0,30,0
1668193212867,DSE 210,A00,096915,Dasgupta; Sanjoy,30,0,30,0
1668193213301,DSE 260A,A00,096916,Altintas De Callaf; Ilkay,30,0,30,0
1668193213734,ECE 200,001,103586,Antipa; Nicholas A,9999,0,9999,0
1668193213734,ECE 200,002,103587,Atanasov; Nikolay A.,9999,0,9999,0
1668193213734,ECE 200,003,103588,Bharadia; Dinesh,9999,0,9999,0
1668193213734,ECE 200,004,103589,Cheng; Chung Kuan,9999,0,9999,0
1668193213734,ECE 200,005,103590,Cosman; Pamela C.,9999,0,9999,0
1668193213734,ECE 200,006,103591,Dayeh; Shadi Ahmad,9999,0,9999,0
1668193213734,ECE 200,007,103592,Fainman; Yeshaiahu,9999,0,9999,0
1668193213734,ECE 200,008,103593,Ford; Joseph Earl,9999,0,9999,0
1668193213734,ECE 200,009,103594,Franceschetti; Massimo,9999,0,9999,0
1668193213734,ECE 200,010,103595,Fullerton; Eric E,9999,0,9999,0
1668193213734,ECE 200,011,103596,Galton; Ian A,9999,0,9999,0
1668193213734,ECE 200,012,103597,Gilja; Vikash,9999,0,9999,0
1668193213734,ECE 200,013,103598,Hall; Drew A.,9999,0,9999,0
1668193213734,ECE 200,014,103599,Hsueh; Tzu-Chien,9999,0,9999,0
1668193213734,ECE 200,015,103600,Javidi; Tara,9999,0,9999,0
1668193213734,ECE 200,016,103601,Kahng; Andrew Byun,9999,0,9999,0
1668193213734,ECE 200,017,103602,Kim; Young-Han,9999,0,9999,0
1668193213734,ECE 200,018,103603,Koushanfar; Farinaz,9999,0,9999,0
1668193213734,ECE 200,019,103604,Kuzum; Duygu,9999,0,9999,0
1668193213734,ECE 200,020,103605,Le; Hanh-Phuc,9999,0,9999,0
1668193213734,ECE 200,021,103606,Lin; Bill,9999,0,9999,0
1668193213734,ECE 200,022,103607,Liu; Zhaowei,9998,0,9999,1
1668193213734,ECE 200,023,103608,Lo; Yu-Hwa,9999,0,9999,0
1668193213734,ECE 200,024,103609,Lomakin; Vitaliy,9999,0,9999,0
1668193213734,ECE 200,025,103610,Mercier; Patrick Philip,9999,0,9999,0
1668193213734,ECE 200,026,103611,Meyer; Florian,9999,0,9999,0
1668193213734,ECE 200,027,103612,Milstein; Laurence B.,9999,0,9999,0
1668193213734,ECE 200,028,103613,Mir Arabbaygi; Siavash,9999,0,9999,0
1668193213734,ECE 200,029,103614,Mookherjea; Shayan,9999,0,9999,0
1668193213734,ECE 200,030,103615,Morris; Karcher William,9999,0,9999,0
1668193213734,ECE 200,031,103616,Ng; Tse Nga,9999,0,9999,0
1668193213734,ECE 200,032,103617,Nguyen; Truong Quang,9999,0,9999,0
1668193213734,ECE 200,033,103618,Nomura; Kenji,9999,0,9999,0
1668193213734,ECE 200,034,103619,Orlitsky; Alon,9999,0,9999,0
1668193213734,ECE 200,035,103620,Pal; Piya,9999,0,9999,0
1668193213734,ECE 200,036,103621,Papen; George C.,9999,0,9999,0
1668193213734,ECE 200,037,103622,Radic; Stojan,9999,0,9999,0
1668193213734,ECE 200,038,103623,Rao; Bhaskar D.,9999,0,9999,0
1668193213734,ECE 200,039,103624,Rao; Ramesh R,9999,0,9999,0
1668193213734,ECE 200,040,103625,Rebeiz; Gabriel,9999,0,9999,0
1668193213734,ECE 200,041,103626,Sanford; John R,9999,0,9999,0
1668193213734,ECE 200,042,103627,Siegel; Paul H.,9999,0,9999,0
1668193213734,ECE 200,043,103628,Sievenpiper; Daniel F.,9999,0,9999,0
1668193213734,ECE 200,044,103629,Sworder; David D.,9999,0,9999,0
1668193213734,ECE 200,045,103630,Taur; Yuan,9999,0,9999,0
1668193213734,ECE 200,046,103631,Touri; Behrouz,9999,0,9999,0
1668193213734,ECE 200,047,103632,Trivedi; Mohan M.,9999,0,9999,0
1668193213734,ECE 200,048,103633,Vasconcelos; Nuno,9999,0,9999,0
1668193213734,ECE 200,049,103634,Wang; Xiaolong,9999,0,9999,0
1668193213734,ECE 200,050,103635,Xie; Pengtao,9999,0,9999,0
1668193213734,ECE 200,051,103636,Yip; Michael,9999,0,9999,0
1668193213734,ECE 200,052,103637,Zeger; Kenneth A.,999,0,999,0
1668193213734,ECE 200,053,103638,Zhang; Xinyu,9999,0,9999,0
1668193213734,ECE 200,054,103639,Turakhia; Yatish Girish,9999,0,9999,0
1668193213734,ECE 200,055,103640,Kang; Mingu,9999,0,9999,0
1668193213734,ECE 200,056,103641,Shi; Yuanyuan,9999,0,9999,0
1668193213734,ECE 200,057,103642,Wang; Edward Jay,9999,0,9999,0
1668193213734,ECE 200,058,103643,Zheng; Yang,9999,0,9999,0
1668193214165,ECE 202,A00,103644,Kuzum; Duygu,0,0,0,0
1668193214589,ECE 212BN,A00,103646,Ng; Tse Nga,0,0,0,0
1668193215027,ECE 221,A00,111493,Staff,0,0,0,0
1668193215466,ECE 222B,A00,103647,Lomakin; Vitaliy,0,0,0,0
1668193215893,ECE 230B,A00,103648,Taur; Yuan,0,0,0,0
1668193216337,ECE 238B,A00,103649,Garay; Javier,0,0,0,0
1668193216767,ECE 240B,A00,112900,Fainman; Yeshaiahu,0,0,0,0
1668193217190,ECE 247A,A00,103650,Jokerst; Jesse Vincent,0,0,0,0
1668193217619,ECE 247B,A00,103651,Wang; Joseph,0,0,0,0
1668193218044,ECE 250,A00,103652,Siegel; Paul H.,0,0,0,0
1668193218470,ECE 251A,A00,103654,Rao; Bhaskar D.,0,0,0,0
1668193218893,ECE 257B,A00,103655,Bharadia; Dinesh,0,0,0,0
1668193219316,ECE 258A,A00,103656,Milstein; Laurence B.,0,0,0,0
1668193219742,ECE 260B,A00,103658,Kang; Mingu,0,0,0,0
1668193220172,ECE 264A,A00,103659,Galton; Ian A,0,0,0,0
1668193220605,ECE 265A,A00,103661,Gudem; Prasad S.S.,0,0,0,0
1668193221028,ECE 265D,A00,103662,Gudem; Prasad S.S.,0,0,0,0
1668193221483,ECE 268,A00,103663,Koushanfar; Farinaz,0,0,0,0
1668193221922,ECE 269,A01,103665,Pal; Piya,0,0,0,0
1668193222355,ECE 271B,A00,103666,Vasconcelos; Manuela,0,0,0,0
1668193222787,ECE 276A,A00,103667,Atanasov; Nikolay A.,0,0,0,0
1668193223221,ECE 277,A00,103668,An; Cheolhong,0,0,0,0
1668193223642,ECE 279,A00,117947,Hall; Drew A.,0,0,0,0
1668193224495,ECE 283,A00,103670,Hsueh; Tzu-Chien,0,0,0,0
1668193224930,ECE 284,A00,103671,Turakhia; Yatish Girish,0,0,0,0
1668193225369,ECE 285,A00,103672,Zheng; Yang,0,0,0,0
1668193225369,ECE 285,B00,103673,Sworder; David D.,0,0,0,0
1668193225800,ECE 287,A00,103676,Javidi; Tara,0,0,0,0
1668193226233,MATH 200B,A00,098023,Salehi Golsefidy; Alireza,12,0,15,3
1668193226676,MATH 202B,A00,098024,Rhoades; Brendon Patrick,9,0,15,6
1668193227099,MATH 203B,A00,098025,Oprea; Dragos N.,10,0,15,5
1668193227531,MATH 204B,A00,098026,Sorensen; Claus M,13,0,15,2
1668193227956,MATH 208,A00,098027,Izadi; Elham,7,0,10,3
1668193228381,MATH 209,A00,098028,Pollack; Aaron,10,0,10,0
1668193228807,MATH 211A,A00,112919,Rogalski; Daniel,9,0,10,1
1668193229306,MATH 211B,A00,112920,Seward; Brandon M.,9,0,10,1
1668193229733,MATH 218,A00,098029,Li; Bo,10,0,10,0
1668193230158,MATH 220B,A00,098030,Novak; Jonathan I,11,0,15,4
1668193230582,MATH 221A,A00,098031,Ebenfelt; Peter F,13,0,15,2
1668193231011,MATH 231B,A00,098032,Zlatos; Andrej,12,0,15,3
1668193231437,MATH 240B,A00,098033,Ni; Lei,9,0,15,6
1668193231870,MATH 243,A00,098034,Jekel; David Andrew,10,0,10,0
1668193232299,MATH 245A,A00,098035,Nie; Jiawang,0,0,15,16
1668193232728,MATH 248,A00,098036,Bejenaru; Ioan,10,0,10,0
1668193233158,MATH 250B,A00,098037,Spolaor; Luca,14,0,15,1
1668193233594,MATH 258,A00,098038,Ni; Lei,10,0,10,0
1668193234024,MATH 264B,A00,098041,Rhoades; Brendon Patrick,9,0,15,6
1668193234452,MATH 268,A00,098042,Buss; Samuel R,10,0,10,0
1668193234877,MATH 269,A00,098043,Rhoades; Brendon Patrick,10,0,10,0
1668193235307,MATH 270B,A00,098044,Li; Bo,10,0,15,5
1668193235735,MATH 272B,A00,098045,Holst; Michael J,13,0,15,2
1668193236172,MATH 273A,A00,098046,Tian; Xiaochuan,10,0,15,5
1668193236610,MATH 275,A01,098048,Tian; Xiaochuan,6,0,10,4
1668193237036,MATH 278A,A00,098049,Holst; Michael J,8,0,10,2
1668193237459,MATH 278B,A00,098050,Cloninger; Alexander,10,0,10,0
1668193237887,MATH 278C,A00,098051,Nie; Jiawang,7,0,10,3
1668193238316,MATH 280B,A00,098052,Zheng; Tianyi,10,0,15,5
1668193238771,MATH 281B,A00,098053,Bradic; Jelena,2,0,15,13
1668193239207,MATH 282B,A00,098054,Arias-Castro; Ery,0,0,15,15
1668193239634,MATH 285,A00,098055,Fitzsimmons; Patrick J,0,0,15,17
1668193240061,MATH 287B,A00,098056,Arias-Castro; Ery,2,0,15,13
1668193240492,MATH 288,A00,098057,Agarwal; Pooja,9,0,10,1
1668193240492,MATH 288,B00,098058,Zhang; Danna,8,0,10,2
1668193240492,MATH 288,C00,098059,Williams; Ruth J,10,0,10,0
1668193240924,MATH 290B,A00,098060,Roberts; Justin Deritter,13,0,15,2
1668193241351,MATH 292,A00,098061,Belmont; Eva Kinoshita,10,0,10,0
1668193241775,MATH 295,A00,098062,Suk; Andrew Hoon,48,0,50,2
1668193242211,MATH 296,A00,098063,Novak; Jonathan I,20,0,20,0
1668193242637,MATH 297,001,098064,Gamst; Anthony Collins,9997,0,9999,2
1668193744246,COGS 205,A00,101395,Chiba; Andrea,19,0,20,1
1668193744674,COGS 210B,001,101404,Greene; Deanna Jacquelyn,9998,0,9999,1
1668193744674,COGS 210B,002,101417,Xia; Haijun,9999,0,9999,0
1668193744674,COGS 210B,003,101422,Nitz; Douglas A.,9999,0,9999,0
1668193744674,COGS 210B,004,101423,Hollan; James D.,9998,0,9999,1
1668193744674,COGS 210B,005,101424,Deak; Gedeon O.,9998,0,9999,1
1668193744674,COGS 210B,006,101425,Rossano; Federico,9999,0,9999,0
1668193745098,COGS 211B,A00,101427,Coulson; Seana M,9996,0,9999,3
1668193745523,COGS 220,A00,101428,Hollan; James D.,0,0,25,25
1668193745947,COGS 229,A00,101429,Dow; Steven P,18,0,25,7
1668193746370,COGS 230,A00,101430,Klemmer; Scott R,12,0,17,5
1668193746793,COGS 234,A00,101431,Xia; Haijun,3,0,25,22
1668193747221,COGS 260,A00,101432,Kiyonaga; Anastasia,20,0,25,5
1668193747221,COGS 260,B00,101433,Kirsh; David Joel,16,0,25,9
1668193747647,CSE 202,A00,102371,Impagliazzo; Russell,0,0,0,0
1668193748093,CSE 203B,A01,102373,Cheng; Chung Kuan,0,0,0,0
1668193748520,CSE 208,A00,102374,Micciancio; Daniele,0,0,0,0
1668193748954,CSE 209A,A00,112895,Impagliazzo; Russell,0,0,15,15
1668193749378,CSE 209B,A00,108005,Bellare; Mihir,0,0,0,0
1668193749803,CSE 210,A00,113163,Coblenz; Michael J,0,0,0,0
1668193750227,CSE 219,A00,106111,Dow; Steven P,0,0,20,20
1668193750652,CSE 221,A00,102376,Voelker; Geoffrey M.,0,0,0,0
1668193751170,CSE 224,A01,102378,Porter; George M,0,0,0,0
1668193751595,CSE 229A,A00,102379,Savage; Stefan,0,0,0,0
1668193752027,CSE 229C,A00,102380,Munyaka; Imani N. S.,0,0,0,0
1668193752450,CSE 232B,A00,102382,Deutsch; Alin Bernard,0,0,0,0
1668193752884,CSE 234,A01,112904,Kumar; Arun Kumar,0,0,0,0
1668193753314,CSE 237A,A00,102383,Rosing; Tajana Simunic,0,0,0,0
1668193753741,CSE 239A,A00,102384,Deutsch; Alin Bernard,0,0,0,0
1668193754175,CSE 239B,A00,102385,Polikarpova; Nadezhda,0,0,0,0
1668193754601,CSE 240A,A00,102386,Pannuto; Patrick William,0,0,0,0
1668193755025,CSE 240B,A00,102387,Zhao; Jishen,0,0,0,0
1668193755448,CSE 241A,A00,106406,Kang; Mingu,0,0,0,0
1668193755874,CSE 249B,A00,102388,Kahng; Andrew Byun,0,0,8,8
1668193756298,CSE 251B,A01,102392,Cottrell; Garrison W,0,0,0,0
1668193756298,CSE 251B,A02,102393,Cottrell; Garrison W,0,0,0,0
1668193756723,CSE 252B,A00,102394,Ochoa; Benjamin Lawrence,0,0,0,0
1668193757149,CSE 257,A01,102396,Gao; Sicun,0,0,0,0
1668193757574,CSE 272,A00,102397,Li; Tzumao,0,0,0,0
1668193757998,CSE 274,A00,111323,Chern; Albert Ren-Haur,0,0,0,0
1668193758437,CSE 282,A00,102398,Pevzner; Pavel Arkadjevich,0,0,0,0
1668193758861,CSE 284,A00,114175,Gymrek; Melissa Ann,0,0,0,0
1668193759285,CSE 290,A00,102399,Chandraker; Manmohan Krishna,0,0,0,0
1668193759285,CSE 290,B00,102400,Vaccaro; Kristen Marie,0,0,25,25
1668193759285,CSE 290,C00,102414,Pannuto; Patrick William,0,0,25,25
1668193759285,CSE 290,D00,102427,Pevzner; Pavel Arkadjevich,0,0,0,0
1668193759285,CSE 290,E00,102429,Zhao; Jishen,0,0,0,0
1668193759285,CSE 290,F00,102436,Tullsen; Dean Michael,0,0,0,0
1668193759285,CSE 290,G00,102440,Christensen; Henrik I,0,0,20,20
1668193759710,CSE 291,A00,102443,Su; Hao,0,0,0,0
1668193759710,CSE 291,B00,102448,Polikarpova; Nadezhda,0,0,0,0
1668193759710,CSE 291,C00,102453,Vaccaro; Kristen Marie,0,0,0,0
1668193759710,CSE 291,D00,111343,Savage; Stefan,0,0,0,0
1668193759710,CSE 291,E00,116474,Claffy; Kimberly Claire,0,0,0,0
1668193759710,CSE 291,F00,116479,Pasquale; Joseph,0,0,0,0
1668193760136,CSE 293,001,119111,Bafna; Vineet,9999,0,9999,0
1668193760136,CSE 293,002,119118,Bellare; Mihir,9999,0,9999,0
1668193760136,CSE 293,003,119122,Berg-Kirkpatrick; Taylor D,9999,0,9999,0
1668193760136,CSE 293,004,119135,Christensen; Henrik I,9999,0,9999,0
1668193760136,CSE 293,005,119142,Cottrell; Garrison W,9999,0,9999,0
1668193760136,CSE 293,006,119146,Deutsch; Alin Bernard,9999,0,9999,0
1668193760136,CSE 293,007,119159,Esmaeilzadeh; Hadi,9999,0,9999,0
1668193760136,CSE 293,008,119166,Freund; Yoav,9999,0,9999,0
1668193760136,CSE 293,009,119170,Griswold; William G.,9999,0,9999,0
1668193760136,CSE 293,010,119183,Gymrek; Melissa Ann,9999,0,9999,0
1668193760136,CSE 293,011,119190,Heninger; Nadia A,9999,0,9999,0
1668193760136,CSE 293,012,119230,Impagliazzo; Russell,9999,0,9999,0
1668193760136,CSE 293,013,119232,Jhala; Ranjit,9999,0,9999,0
1668193760136,CSE 293,014,119233,Kahng; Andrew Byun,9999,0,9999,0
1668193760136,CSE 293,015,119298,Kane; Daniel Mertz,9999,0,9999,0
1668193760136,CSE 293,016,119299,Kriegman; David J,9999,0,9999,0
1668193760136,CSE 293,017,119300,Kumar; Arun Kumar,9999,0,9999,0
1668193760136,CSE 293,018,119301,Lerner; Sorin,9999,0,9999,0
1668193760136,CSE 293,019,119302,Lovett; Shachar,9999,0,9999,0
1668193760136,CSE 293,020,119303,McAuley; Julian John,9999,0,9999,0
1668193760136,CSE 293,021,119304,Micciancio; Daniele,9999,0,9999,0
1668193760136,CSE 293,022,119367,Orailoglu; Alex,9999,0,9999,0
1668193760136,CSE 293,023,119382,Paturi; Ramamohan,9999,0,9999,0
1668193760136,CSE 293,024,119404,Polikarpova; Nadezhda,9999,0,9999,0
1668193760136,CSE 293,025,119406,Politz; Joseph Gibbs,9999,0,9999,0
1668193760136,CSE 293,026,119411,Porter; George M,9999,0,9999,0
1668193760136,CSE 293,027,119414,Porter; Leonard Emerson,9999,0,9999,0
1668193760136,CSE 293,028,119416,Ramamoorthi; Ravi,9999,0,9999,0
1668193760136,CSE 293,029,119417,Sahoo; Debashis,9999,0,9999,0
1668193760136,CSE 293,030,119420,Saul; Lawrence,9999,0,9999,0
1668193760136,CSE 293,031,119421,Savage; Stefan,9999,0,9999,0
1668193760136,CSE 293,032,119425,Schulze; Jurgen P.,9999,0,9999,0
1668193760136,CSE 293,033,119426,Snoeren; Alex C.,9999,0,9999,0
1668193760136,CSE 293,034,119428,Shang; Jingbo,9999,0,9999,0
1668193760136,CSE 293,035,119430,Stefan; Deian,9999,0,9999,0
1668193760136,CSE 293,036,119431,Su; Hao,9999,0,9999,0
1668193760136,CSE 293,037,119433,Swanson; Steven James,9999,0,9999,0
1668193760136,CSE 293,038,119435,Tullsen; Dean Michael,9999,0,9999,0
1668193760136,CSE 293,039,119483,Voelker; Geoffrey M.,9999,0,9999,0
1668193760136,CSE 293,040,119537,Zhao; Jishen,9999,0,9999,0
1668193760136,CSE 293,041,119538,Zhou; Yuan-Yuan,9999,0,9999,0
1668193760136,CSE 293,042,119539,Gao; Sicun,9999,0,9999,0
1668193760136,CSE 293,043,119540,Weibel; Nadir,9999,0,9999,0
1668193760136,CSE 293,044,119541,Gupta; Rajesh K.,9999,0,9999,0
1668193760136,CSE 293,045,126410,Vaccaro; Kristen Marie,9999,0,9999,0
1668193760136,CSE 293,046,126411,Klemke; Richard,9999,0,9999,0
1668193760560,CSE 294,A00,102459,Voelker; Geoffrey M.,0,0,0,0
1668193760560,CSE 294,B00,111322,Orailoglu; Alex,0,0,0,0
1668193760990,DSE 201,A00,096914,Deutsch; Alin Bernard,30,0,30,0
1668193761418,DSE 210,A00,096915,Dasgupta; Sanjoy,30,0,30,0
1668193761843,DSE 260A,A00,096916,Altintas De Callaf; Ilkay,30,0,30,0
1668193762278,ECE 200,001,103586,Antipa; Nicholas A,9999,0,9999,0
1668193762278,ECE 200,002,103587,Atanasov; Nikolay A.,9999,0,9999,0
1668193762278,ECE 200,003,103588,Bharadia; Dinesh,9999,0,9999,0
1668193762278,ECE 200,004,103589,Cheng; Chung Kuan,9999,0,9999,0
1668193762278,ECE 200,005,103590,Cosman; Pamela C.,9999,0,9999,0
1668193762278,ECE 200,006,103591,Dayeh; Shadi Ahmad,9999,0,9999,0
1668193762278,ECE 200,007,103592,Fainman; Yeshaiahu,9999,0,9999,0
1668193762278,ECE 200,008,103593,Ford; Joseph Earl,9999,0,9999,0
1668193762278,ECE 200,009,103594,Franceschetti; Massimo,9999,0,9999,0
1668193762278,ECE 200,010,103595,Fullerton; Eric E,9999,0,9999,0
1668193762278,ECE 200,011,103596,Galton; Ian A,9999,0,9999,0
1668193762278,ECE 200,012,103597,Gilja; Vikash,9999,0,9999,0
1668193762278,ECE 200,013,103598,Hall; Drew A.,9999,0,9999,0
1668193762278,ECE 200,014,103599,Hsueh; Tzu-Chien,9999,0,9999,0
1668193762278,ECE 200,015,103600,Javidi; Tara,9999,0,9999,0
1668193762278,ECE 200,016,103601,Kahng; Andrew Byun,9999,0,9999,0
1668193762278,ECE 200,017,103602,Kim; Young-Han,9999,0,9999,0
1668193762278,ECE 200,018,103603,Koushanfar; Farinaz,9999,0,9999,0
1668193762278,ECE 200,019,103604,Kuzum; Duygu,9999,0,9999,0
1668193762278,ECE 200,020,103605,Le; Hanh-Phuc,9999,0,9999,0
1668193762278,ECE 200,021,103606,Lin; Bill,9999,0,9999,0
1668193762278,ECE 200,022,103607,Liu; Zhaowei,9998,0,9999,1
1668193762278,ECE 200,023,103608,Lo; Yu-Hwa,9999,0,9999,0
1668193762278,ECE 200,024,103609,Lomakin; Vitaliy,9999,0,9999,0
1668193762278,ECE 200,025,103610,Mercier; Patrick Philip,9999,0,9999,0
1668193762278,ECE 200,026,103611,Meyer; Florian,9999,0,9999,0
1668193762278,ECE 200,027,103612,Milstein; Laurence B.,9999,0,9999,0
1668193762278,ECE 200,028,103613,Mir Arabbaygi; Siavash,9999,0,9999,0
1668193762278,ECE 200,029,103614,Mookherjea; Shayan,9999,0,9999,0
1668193762278,ECE 200,030,103615,Morris; Karcher William,9999,0,9999,0
1668193762278,ECE 200,031,103616,Ng; Tse Nga,9999,0,9999,0
1668193762278,ECE 200,032,103617,Nguyen; Truong Quang,9999,0,9999,0
1668193762278,ECE 200,033,103618,Nomura; Kenji,9999,0,9999,0
1668193762278,ECE 200,034,103619,Orlitsky; Alon,9999,0,9999,0
1668193762278,ECE 200,035,103620,Pal; Piya,9999,0,9999,0
1668193762278,ECE 200,036,103621,Papen; George C.,9999,0,9999,0
1668193762278,ECE 200,037,103622,Radic; Stojan,9999,0,9999,0
1668193762278,ECE 200,038,103623,Rao; Bhaskar D.,9999,0,9999,0
1668193762278,ECE 200,039,103624,Rao; Ramesh R,9999,0,9999,0
1668193762278,ECE 200,040,103625,Rebeiz; Gabriel,9999,0,9999,0
1668193762278,ECE 200,041,103626,Sanford; John R,9999,0,9999,0
1668193762278,ECE 200,042,103627,Siegel; Paul H.,9999,0,9999,0
1668193762278,ECE 200,043,103628,Sievenpiper; Daniel F.,9999,0,9999,0
1668193762278,ECE 200,044,103629,Sworder; David D.,9999,0,9999,0
1668193762278,ECE 200,045,103630,Taur; Yuan,9999,0,9999,0
1668193762278,ECE 200,046,103631,Touri; Behrouz,9999,0,9999,0
1668193762278,ECE 200,047,103632,Trivedi; Mohan M.,9999,0,9999,0
1668193762278,ECE 200,048,103633,Vasconcelos; Nuno,9999,0,9999,0
1668193762278,ECE 200,049,103634,Wang; Xiaolong,9999,0,9999,0
1668193762278,ECE 200,050,103635,Xie; Pengtao,9999,0,9999,0
1668193762278,ECE 200,051,103636,Yip; Michael,9999,0,9999,0
1668193762278,ECE 200,052,103637,Zeger; Kenneth A.,999,0,999,0
1668193762278,ECE 200,053,103638,Zhang; Xinyu,9999,0,9999,0
1668193762278,ECE 200,054,103639,Turakhia; Yatish Girish,9999,0,9999,0
1668193762278,ECE 200,055,103640,Kang; Mingu,9999,0,9999,0
1668193762278,ECE 200,056,103641,Shi; Yuanyuan,9999,0,9999,0
1668193762278,ECE 200,057,103642,Wang; Edward Jay,9999,0,9999,0
1668193762278,ECE 200,058,103643,Zheng; Yang,9999,0,9999,0
1668193762710,ECE 202,A00,103644,Kuzum; Duygu,0,0,0,0
1668193763132,ECE 212BN,A00,103646,Ng; Tse Nga,0,0,0,0
1668193763559,ECE 221,A00,111493,Staff,0,0,0,0
1668193763991,ECE 222B,A00,103647,Lomakin; Vitaliy,0,0,0,0
1668193764417,ECE 230B,A00,103648,Taur; Yuan,0,0,0,0
1668193764842,ECE 238B,A00,103649,Garay; Javier,0,0,0,0
1668193765268,ECE 240B,A00,112900,Fainman; Yeshaiahu,0,0,0,0
1668193765698,ECE 247A,A00,103650,Jokerst; Jesse Vincent,0,0,0,0
1668193766122,ECE 247B,A00,103651,Wang; Joseph,0,0,0,0
1668193766559,ECE 250,A00,103652,Siegel; Paul H.,0,0,0,0
1668193766983,ECE 251A,A00,103654,Rao; Bhaskar D.,0,0,0,0
1668193767410,ECE 257B,A00,103655,Bharadia; Dinesh,0,0,0,0
1668193767841,ECE 258A,A00,103656,Milstein; Laurence B.,0,0,0,0
1668193768270,ECE 260B,A00,103658,Kang; Mingu,0,0,0,0
1668193768706,ECE 264A,A00,103659,Galton; Ian A,0,0,0,0
1668193769133,ECE 265A,A00,103661,Gudem; Prasad S.S.,0,0,0,0
1668193769556,ECE 265D,A00,103662,Gudem; Prasad S.S.,0,0,0,0
1668193769980,ECE 268,A00,103663,Koushanfar; Farinaz,0,0,0,0
1668193770406,ECE 269,A01,103665,Pal; Piya,0,0,0,0
1668193770829,ECE 271B,A00,103666,Vasconcelos; Manuela,0,0,0,0
1668193771257,ECE 276A,A00,103667,Atanasov; Nikolay A.,0,0,0,0
1668193771686,ECE 277,A00,103668,An; Cheolhong,0,0,0,0
1668193772110,ECE 279,A00,117947,Hall; Drew A.,0,0,0,0
1668193772963,ECE 283,A00,103670,Hsueh; Tzu-Chien,0,0,0,0
1668193773392,ECE 284,A00,103671,Turakhia; Yatish Girish,0,0,0,0
1668193773818,ECE 285,A00,103672,Zheng; Yang,0,0,0,0
1668193773818,ECE 285,B00,103673,Sworder; David D.,0,0,0,0
1668193774240,ECE 287,A00,103676,Javidi; Tara,0,0,0,0
1668193774662,MATH 200B,A00,098023,Salehi Golsefidy; Alireza,12,0,15,3
1668193775086,MATH 202B,A00,098024,Rhoades; Brendon Patrick,9,0,15,6
1668193775512,MATH 203B,A00,098025,Oprea; Dragos N.,10,0,15,5
1668193775935,MATH 204B,A00,098026,Sorensen; Claus M,13,0,15,2
1668193776360,MATH 208,A00,098027,Izadi; Elham,7,0,10,3
1668193776787,MATH 209,A00,098028,Pollack; Aaron,10,0,10,0
1668193777214,MATH 211A,A00,112919,Rogalski; Daniel,9,0,10,1
1668193777649,MATH 211B,A00,112920,Seward; Brandon M.,9,0,10,1
1668193778080,MATH 218,A00,098029,Li; Bo,10,0,10,0
1668193778515,MATH 220B,A00,098030,Novak; Jonathan I,11,0,15,4
1668193778941,MATH 221A,A00,098031,Ebenfelt; Peter F,13,0,15,2
1668193779366,MATH 231B,A00,098032,Zlatos; Andrej,12,0,15,3
1668193779793,MATH 240B,A00,098033,Ni; Lei,9,0,15,6
1668193780216,MATH 243,A00,098034,Jekel; David Andrew,10,0,10,0
1668193780643,MATH 245A,A00,098035,Nie; Jiawang,0,0,15,16
1668193781077,MATH 248,A00,098036,Bejenaru; Ioan,10,0,10,0
1668193781501,MATH 250B,A00,098037,Spolaor; Luca,14,0,15,1
1668193781923,MATH 258,A00,098038,Ni; Lei,10,0,10,0
1668193782349,MATH 264B,A00,098041,Rhoades; Brendon Patrick,9,0,15,6
1668193782771,MATH 268,A00,098042,Buss; Samuel R,10,0,10,0
1668193783201,MATH 269,A00,098043,Rhoades; Brendon Patrick,10,0,10,0
1668193783627,MATH 270B,A00,098044,Li; Bo,10,0,15,5
1668193784049,MATH 272B,A00,098045,Holst; Michael J,13,0,15,2
1668193784474,MATH 273A,A00,098046,Tian; Xiaochuan,10,0,15,5
1668193784898,MATH 275,A01,098048,Tian; Xiaochuan,6,0,10,4
1668193785328,MATH 278A,A00,098049,Holst; Michael J,8,0,10,2
1668193785764,MATH 278B,A00,098050,Cloninger; Alexander,10,0,10,0
1668193786198,MATH 278C,A00,098051,Nie; Jiawang,7,0,10,3
1668193786620,MATH 280B,A00,098052,Zheng; Tianyi,10,0,15,5
1668193787046,MATH 281B,A00,098053,Bradic; Jelena,2,0,15,13
1668193787475,MATH 282B,A00,098054,Arias-Castro; Ery,0,0,15,15
1668193787899,MATH 285,A00,098055,Fitzsimmons; Patrick J,0,0,15,17
1668193788334,MATH 287B,A00,098056,Arias-Castro; Ery,2,0,15,13
1668193788764,MATH 288,A00,098057,Agarwal; Pooja,9,0,10,1
1668193788764,MATH 288,B00,098058,Zhang; Danna,8,0,10,2
1668193788764,MATH 288,C00,098059,Williams; Ruth J,10,0,10,0
1668193789190,MATH 290B,A00,098060,Roberts; Justin Deritter,13,0,15,2
1668193789620,MATH 292,A00,098061,Belmont; Eva Kinoshita,10,0,10,0
1668193790044,MATH 295,A00,098062,Suk; Andrew Hoon,48,0,50,2
1668193790487,MATH 296,A00,098063,Novak; Jonathan I,20,0,20,0
1668193790909,MATH 297,001,098064,Gamst; Anthony Collins,9997,0,9999,2
1668194293376,COGS 205,A00,101395,Chiba; Andrea,19,0,20,1
1668194293810,COGS 210B,001,101404,Greene; Deanna Jacquelyn,9998,0,9999,1
1668194293810,COGS 210B,002,101417,Xia; Haijun,9999,0,9999,0
1668194293810,COGS 210B,003,101422,Nitz; Douglas A.,9999,0,9999,0
1668194293810,COGS 210B,004,101423,Hollan; James D.,9998,0,9999,1
1668194293810,COGS 210B,005,101424,Deak; Gedeon O.,9998,0,9999,1
1668194293810,COGS 210B,006,101425,Rossano; Federico,9999,0,9999,0
1668194294243,COGS 211B,A00,101427,Coulson; Seana M,9996,0,9999,3
1668194294676,COGS 220,A00,101428,Hollan; James D.,0,0,25,25
1668194295100,COGS 229,A00,101429,Dow; Steven P,18,0,25,7
1668194295525,COGS 230,A00,101430,Klemmer; Scott R,12,0,17,5
1668194295951,COGS 234,A00,101431,Xia; Haijun,3,0,25,22
1668194296376,COGS 260,A00,101432,Kiyonaga; Anastasia,20,0,25,5
1668194296376,COGS 260,B00,101433,Kirsh; David Joel,16,0,25,9
1668194296810,CSE 202,A00,102371,Impagliazzo; Russell,0,0,0,0
1668194297247,CSE 203B,A01,102373,Cheng; Chung Kuan,0,0,0,0
1668194297669,CSE 208,A00,102374,Micciancio; Daniele,0,0,0,0
1668194298093,CSE 209A,A00,112895,Impagliazzo; Russell,0,0,15,15
1668194298520,CSE 209B,A00,108005,Bellare; Mihir,0,0,0,0
1668194298947,CSE 210,A00,113163,Coblenz; Michael J,0,0,0,0
1668194299387,CSE 219,A00,106111,Dow; Steven P,0,0,20,20
1668194299810,CSE 221,A00,102376,Voelker; Geoffrey M.,0,0,0,0
1668194300240,CSE 224,A01,102378,Porter; George M,0,0,0,0
1668194300664,CSE 229A,A00,102379,Savage; Stefan,0,0,0,0
1668194301108,CSE 229C,A00,102380,Munyaka; Imani N. S.,0,0,0,0
1668194301536,CSE 232B,A00,102382,Deutsch; Alin Bernard,0,0,0,0
1668194301971,CSE 234,A01,112904,Kumar; Arun Kumar,0,0,0,0
1668194302406,CSE 237A,A00,102383,Rosing; Tajana Simunic,0,0,0,0
1668194302828,CSE 239A,A00,102384,Deutsch; Alin Bernard,0,0,0,0
1668194303252,CSE 239B,A00,102385,Polikarpova; Nadezhda,0,0,0,0
1668194303678,CSE 240A,A00,102386,Pannuto; Patrick William,0,0,0,0
1668194304104,CSE 240B,A00,102387,Zhao; Jishen,0,0,0,0
1668194304528,CSE 241A,A00,106406,Kang; Mingu,0,0,0,0
1668194304950,CSE 249B,A00,102388,Kahng; Andrew Byun,0,0,8,8
1668194305378,CSE 251B,A01,102392,Cottrell; Garrison W,0,0,0,0
1668194305378,CSE 251B,A02,102393,Cottrell; Garrison W,0,0,0,0
1668194305800,CSE 252B,A00,102394,Ochoa; Benjamin Lawrence,0,0,0,0
1668194306223,CSE 257,A01,102396,Gao; Sicun,0,0,0,0
1668194306653,CSE 272,A00,102397,Li; Tzumao,0,0,0,0
1668194307085,CSE 274,A00,111323,Chern; Albert Ren-Haur,0,0,0,0
1668194307509,CSE 282,A00,102398,Pevzner; Pavel Arkadjevich,0,0,0,0
1668194307942,CSE 284,A00,114175,Gymrek; Melissa Ann,0,0,0,0
1668194308381,CSE 290,A00,102399,Chandraker; Manmohan Krishna,0,0,0,0
1668194308381,CSE 290,B00,102400,Vaccaro; Kristen Marie,0,0,25,25
1668194308381,CSE 290,C00,102414,Pannuto; Patrick William,0,0,25,25
1668194308381,CSE 290,D00,102427,Pevzner; Pavel Arkadjevich,0,0,0,0
1668194308381,CSE 290,E00,102429,Zhao; Jishen,0,0,0,0
1668194308381,CSE 290,F00,102436,Tullsen; Dean Michael,0,0,0,0
1668194308381,CSE 290,G00,102440,Christensen; Henrik I,0,0,20,20
1668194308810,CSE 291,A00,102443,Su; Hao,0,0,0,0
1668194308810,CSE 291,B00,102448,Polikarpova; Nadezhda,0,0,0,0
1668194308810,CSE 291,C00,102453,Vaccaro; Kristen Marie,0,0,0,0
1668194308810,CSE 291,D00,111343,Savage; Stefan,0,0,0,0
1668194308810,CSE 291,E00,116474,Claffy; Kimberly Claire,0,0,0,0
1668194308810,CSE 291,F00,116479,Pasquale; Joseph,0,0,0,0
1668194309243,CSE 293,001,119111,Bafna; Vineet,9999,0,9999,0
1668194309243,CSE 293,002,119118,Bellare; Mihir,9999,0,9999,0
1668194309243,CSE 293,003,119122,Berg-Kirkpatrick; Taylor D,9999,0,9999,0
1668194309243,CSE 293,004,119135,Christensen; Henrik I,9999,0,9999,0
1668194309243,CSE 293,005,119142,Cottrell; Garrison W,9999,0,9999,0
1668194309243,CSE 293,006,119146,Deutsch; Alin Bernard,9999,0,9999,0
1668194309243,CSE 293,007,119159,Esmaeilzadeh; Hadi,9999,0,9999,0
1668194309243,CSE 293,008,119166,Freund; Yoav,9999,0,9999,0
1668194309243,CSE 293,009,119170,Griswold; William G.,9999,0,9999,0
1668194309243,CSE 293,010,119183,Gymrek; Melissa Ann,9999,0,9999,0
1668194309243,CSE 293,011,119190,Heninger; Nadia A,9999,0,9999,0
1668194309243,CSE 293,012,119230,Impagliazzo; Russell,9999,0,9999,0
1668194309243,CSE 293,013,119232,Jhala; Ranjit,9999,0,9999,0
1668194309243,CSE 293,014,119233,Kahng; Andrew Byun,9999,0,9999,0
1668194309243,CSE 293,015,119298,Kane; Daniel Mertz,9999,0,9999,0
1668194309243,CSE 293,016,119299,Kriegman; David J,9999,0,9999,0
1668194309243,CSE 293,017,119300,Kumar; Arun Kumar,9999,0,9999,0
1668194309243,CSE 293,018,119301,Lerner; Sorin,9999,0,9999,0
1668194309243,CSE 293,019,119302,Lovett; Shachar,9999,0,9999,0
1668194309243,CSE 293,020,119303,McAuley; Julian John,9999,0,9999,0
1668194309243,CSE 293,021,119304,Micciancio; Daniele,9999,0,9999,0
1668194309243,CSE 293,022,119367,Orailoglu; Alex,9999,0,9999,0
1668194309243,CSE 293,023,119382,Paturi; Ramamohan,9999,0,9999,0
1668194309243,CSE 293,024,119404,Polikarpova; Nadezhda,9999,0,9999,0
1668194309243,CSE 293,025,119406,Politz; Joseph Gibbs,9999,0,9999,0
1668194309243,CSE 293,026,119411,Porter; George M,9999,0,9999,0
1668194309243,CSE 293,027,119414,Porter; Leonard Emerson,9999,0,9999,0
1668194309243,CSE 293,028,119416,Ramamoorthi; Ravi,9999,0,9999,0
1668194309243,CSE 293,029,119417,Sahoo; Debashis,9999,0,9999,0
1668194309243,CSE 293,030,119420,Saul; Lawrence,9999,0,9999,0
1668194309243,CSE 293,031,119421,Savage; Stefan,9999,0,9999,0
1668194309243,CSE 293,032,119425,Schulze; Jurgen P.,9999,0,9999,0
1668194309243,CSE 293,033,119426,Snoeren; Alex C.,9999,0,9999,0
1668194309243,CSE 293,034,119428,Shang; Jingbo,9999,0,9999,0
1668194309243,CSE 293,035,119430,Stefan; Deian,9999,0,9999,0
1668194309243,CSE 293,036,119431,Su; Hao,9999,0,9999,0
1668194309243,CSE 293,037,119433,Swanson; Steven James,9999,0,9999,0
1668194309243,CSE 293,038,119435,Tullsen; Dean Michael,9999,0,9999,0
1668194309243,CSE 293,039,119483,Voelker; Geoffrey M.,9999,0,9999,0
1668194309243,CSE 293,040,119537,Zhao; Jishen,9999,0,9999,0
1668194309243,CSE 293,041,119538,Zhou; Yuan-Yuan,9999,0,9999,0
1668194309243,CSE 293,042,119539,Gao; Sicun,9999,0,9999,0
1668194309243,CSE 293,043,119540,Weibel; Nadir,9999,0,9999,0
1668194309243,CSE 293,044,119541,Gupta; Rajesh K.,9999,0,9999,0
1668194309243,CSE 293,045,126410,Vaccaro; Kristen Marie,9999,0,9999,0
1668194309243,CSE 293,046,126411,Klemke; Richard,9999,0,9999,0
1668194309669,CSE 294,A00,102459,Voelker; Geoffrey M.,0,0,0,0
1668194309669,CSE 294,B00,111322,Orailoglu; Alex,0,0,0,0
1668194310094,DSE 201,A00,096914,Deutsch; Alin Bernard,30,0,30,0
1668194310520,DSE 210,A00,096915,Dasgupta; Sanjoy,30,0,30,0
1668194310943,DSE 260A,A00,096916,Altintas De Callaf; Ilkay,30,0,30,0
1668194311395,ECE 200,001,103586,Antipa; Nicholas A,9999,0,9999,0
1668194311395,ECE 200,002,103587,Atanasov; Nikolay A.,9999,0,9999,0
1668194311395,ECE 200,003,103588,Bharadia; Dinesh,9999,0,9999,0
1668194311395,ECE 200,004,103589,Cheng; Chung Kuan,9999,0,9999,0
1668194311395,ECE 200,005,103590,Cosman; Pamela C.,9999,0,9999,0
1668194311395,ECE 200,006,103591,Dayeh; Shadi Ahmad,9999,0,9999,0
1668194311395,ECE 200,007,103592,Fainman; Yeshaiahu,9999,0,9999,0
1668194311395,ECE 200,008,103593,Ford; Joseph Earl,9999,0,9999,0
1668194311395,ECE 200,009,103594,Franceschetti; Massimo,9999,0,9999,0
1668194311395,ECE 200,010,103595,Fullerton; Eric E,9999,0,9999,0
1668194311395,ECE 200,011,103596,Galton; Ian A,9999,0,9999,0
1668194311395,ECE 200,012,103597,Gilja; Vikash,9999,0,9999,0
1668194311395,ECE 200,013,103598,Hall; Drew A.,9999,0,9999,0
1668194311395,ECE 200,014,103599,Hsueh; Tzu-Chien,9999,0,9999,0
1668194311395,ECE 200,015,103600,Javidi; Tara,9999,0,9999,0
1668194311395,ECE 200,016,103601,Kahng; Andrew Byun,9999,0,9999,0
1668194311395,ECE 200,017,103602,Kim; Young-Han,9999,0,9999,0
1668194311395,ECE 200,018,103603,Koushanfar; Farinaz,9999,0,9999,0
1668194311395,ECE 200,019,103604,Kuzum; Duygu,9999,0,9999,0
1668194311395,ECE 200,020,103605,Le; Hanh-Phuc,9999,0,9999,0
1668194311395,ECE 200,021,103606,Lin; Bill,9999,0,9999,0
1668194311395,ECE 200,022,103607,Liu; Zhaowei,9998,0,9999,1
1668194311395,ECE 200,023,103608,Lo; Yu-Hwa,9999,0,9999,0
1668194311395,ECE 200,024,103609,Lomakin; Vitaliy,9999,0,9999,0
1668194311395,ECE 200,025,103610,Mercier; Patrick Philip,9999,0,9999,0
1668194311395,ECE 200,026,103611,Meyer; Florian,9999,0,9999,0
1668194311395,ECE 200,027,103612,Milstein; Laurence B.,9999,0,9999,0
1668194311395,ECE 200,028,103613,Mir Arabbaygi; Siavash,9999,0,9999,0
1668194311395,ECE 200,029,103614,Mookherjea; Shayan,9999,0,9999,0
1668194311395,ECE 200,030,103615,Morris; Karcher William,9999,0,9999,0
1668194311395,ECE 200,031,103616,Ng; Tse Nga,9999,0,9999,0
1668194311395,ECE 200,032,103617,Nguyen; Truong Quang,9999,0,9999,0
1668194311395,ECE 200,033,103618,Nomura; Kenji,9999,0,9999,0
1668194311395,ECE 200,034,103619,Orlitsky; Alon,9999,0,9999,0
1668194311395,ECE 200,035,103620,Pal; Piya,9999,0,9999,0
1668194311395,ECE 200,036,103621,Papen; George C.,9999,0,9999,0
1668194311395,ECE 200,037,103622,Radic; Stojan,9999,0,9999,0
1668194311395,ECE 200,038,103623,Rao; Bhaskar D.,9999,0,9999,0
1668194311395,ECE 200,039,103624,Rao; Ramesh R,9999,0,9999,0
1668194311395,ECE 200,040,103625,Rebeiz; Gabriel,9999,0,9999,0
1668194311395,ECE 200,041,103626,Sanford; John R,9999,0,9999,0
1668194311395,ECE 200,042,103627,Siegel; Paul H.,9999,0,9999,0
1668194311395,ECE 200,043,103628,Sievenpiper; Daniel F.,9999,0,9999,0
1668194311395,ECE 200,044,103629,Sworder; David D.,9999,0,9999,0
1668194311395,ECE 200,045,103630,Taur; Yuan,9999,0,9999,0
1668194311395,ECE 200,046,103631,Touri; Behrouz,9999,0,9999,0
1668194311395,ECE 200,047,103632,Trivedi; Mohan M.,9999,0,9999,0
1668194311395,ECE 200,048,103633,Vasconcelos; Nuno,9999,0,9999,0
1668194311395,ECE 200,049,103634,Wang; Xiaolong,9999,0,9999,0
1668194311395,ECE 200,050,103635,Xie; Pengtao,9999,0,9999,0
1668194311395,ECE 200,051,103636,Yip; Michael,9999,0,9999,0
1668194311395,ECE 200,052,103637,Zeger; Kenneth A.,999,0,999,0
1668194311395,ECE 200,053,103638,Zhang; Xinyu,9999,0,9999,0
1668194311395,ECE 200,054,103639,Turakhia; Yatish Girish,9999,0,9999,0
1668194311395,ECE 200,055,103640,Kang; Mingu,9999,0,9999,0
1668194311395,ECE 200,056,103641,Shi; Yuanyuan,9999,0,9999,0
1668194311395,ECE 200,057,103642,Wang; Edward Jay,9999,0,9999,0
1668194311395,ECE 200,058,103643,Zheng; Yang,9999,0,9999,0
1668194311821,ECE 202,A00,103644,Kuzum; Duygu,0,0,0,0
1668194312250,ECE 212BN,A00,103646,Ng; Tse Nga,0,0,0,0
1668194312682,ECE 221,A00,111493,Staff,0,0,0,0
1668194313122,ECE 222B,A00,103647,Lomakin; Vitaliy,0,0,0,0
1668194313548,ECE 230B,A00,103648,Taur; Yuan,0,0,0,0
1668194313972,ECE 238B,A00,103649,Garay; Javier,0,0,0,0
1668194314399,ECE 240B,A00,112900,Fainman; Yeshaiahu,0,0,0,0
1668194314824,ECE 247A,A00,103650,Jokerst; Jesse Vincent,0,0,0,0
1668194315246,ECE 247B,A00,103651,Wang; Joseph,0,0,0,0
1668194315673,ECE 250,A00,103652,Siegel; Paul H.,0,0,0,0
1668194316099,ECE 251A,A00,103654,Rao; Bhaskar D.,0,0,0,0
1668194316525,ECE 257B,A00,103655,Bharadia; Dinesh,0,0,0,0
1668194317040,ECE 258A,A00,103656,Milstein; Laurence B.,0,0,0,0
1668194317473,ECE 260B,A00,103658,Kang; Mingu,0,0,0,0
1668194317905,ECE 264A,A00,103659,Galton; Ian A,0,0,0,0
1668194318328,ECE 265A,A00,103661,Gudem; Prasad S.S.,0,0,0,0
1668194318754,ECE 265D,A00,103662,Gudem; Prasad S.S.,0,0,0,0
1668194319180,ECE 268,A00,103663,Koushanfar; Farinaz,0,0,0,0
1668194319606,ECE 269,A01,103665,Pal; Piya,0,0,0,0
1668194320056,ECE 271B,A00,103666,Vasconcelos; Manuela,0,0,0,0
1668194320549,ECE 276A,A00,103667,Atanasov; Nikolay A.,0,0,0,0
1668194320975,ECE 277,A00,103668,An; Cheolhong,0,0,0,0
1668194321406,ECE 279,A00,117947,Hall; Drew A.,0,0,0,0
1668194322252,ECE 283,A00,103670,Hsueh; Tzu-Chien,0,0,0,0
1668194322677,ECE 284,A00,103671,Turakhia; Yatish Girish,0,0,0,0
1668194323099,ECE 285,A00,103672,Zheng; Yang,0,0,0,0
1668194323099,ECE 285,B00,103673,Sworder; David D.,0,0,0,0
1668194323520,ECE 287,A00,103676,Javidi; Tara,0,0,0,0
1668194323949,MATH 200B,A00,098023,Salehi Golsefidy; Alireza,12,0,15,3
1668194324385,MATH 202B,A00,098024,Rhoades; Brendon Patrick,9,0,15,6
1668194324832,MATH 203B,A00,098025,Oprea; Dragos N.,10,0,15,5
1668194325260,MATH 204B,A00,098026,Sorensen; Claus M,13,0,15,2
1668194325683,MATH 208,A00,098027,Izadi; Elham,7,0,10,3
1668194326105,MATH 209,A00,098028,Pollack; Aaron,10,0,10,0
1668194326526,MATH 211A,A00,112919,Rogalski; Daniel,9,0,10,1
1668194326949,MATH 211B,A00,112920,Seward; Brandon M.,9,0,10,1
1668194327381,MATH 218,A00,098029,Li; Bo,10,0,10,0
1668194327817,MATH 220B,A00,098030,Novak; Jonathan I,11,0,15,4
1668194328251,MATH 221A,A00,098031,Ebenfelt; Peter F,13,0,15,2
1668194328688,MATH 231B,A00,098032,Zlatos; Andrej,12,0,15,3
1668194329115,MATH 240B,A00,098033,Ni; Lei,9,0,15,6
1668194329541,MATH 243,A00,098034,Jekel; David Andrew,10,0,10,0
1668194329971,MATH 245A,A00,098035,Nie; Jiawang,0,0,15,16
1668194330399,MATH 248,A00,098036,Bejenaru; Ioan,10,0,10,0
1668194330826,MATH 250B,A00,098037,Spolaor; Luca,14,0,15,1
1668194331249,MATH 258,A00,098038,Ni; Lei,10,0,10,0
1668194331683,MATH 264B,A00,098041,Rhoades; Brendon Patrick,9,0,15,6
1668194332106,MATH 268,A00,098042,Buss; Samuel R,10,0,10,0
1668194332527,MATH 269,A00,098043,Rhoades; Brendon Patrick,10,0,10,0
1668194332951,MATH 270B,A00,098044,Li; Bo,10,0,15,5
1668194333378,MATH 272B,A00,098045,Holst; Michael J,13,0,15,2
1668194333802,MATH 273A,A00,098046,Tian; Xiaochuan,10,0,15,5
1668194334230,MATH 275,A01,098048,Tian; Xiaochuan,6,0,10,4
1668194334656,MATH 278A,A00,098049,Holst; Michael J,8,0,10,2
1668194335084,MATH 278B,A00,098050,Cloninger; Alexander,10,0,10,0
1668194335507,MATH 278C,A00,098051,Nie; Jiawang,7,0,10,3
1668194335932,MATH 280B,A00,098052,Zheng; Tianyi,10,0,15,5
1668194336368,MATH 281B,A00,098053,Bradic; Jelena,2,0,15,13
1668194336799,MATH 282B,A00,098054,Arias-Castro; Ery,0,0,15,15
1668194337244,MATH 285,A00,098055,Fitzsimmons; Patrick J,0,0,15,17
1668194337670,MATH 287B,A00,098056,Arias-Castro; Ery,2,0,15,13
1668194338092,MATH 288,A00,098057,Agarwal; Pooja,9,0,10,1
1668194338092,MATH 288,B00,098058,Zhang; Danna,8,0,10,2
1668194338092,MATH 288,C00,098059,Williams; Ruth J,10,0,10,0
1668194338515,MATH 290B,A00,098060,Roberts; Justin Deritter,13,0,15,2
1668194338937,MATH 292,A00,098061,Belmont; Eva Kinoshita,10,0,10,0
1668194339387,MATH 295,A00,098062,Suk; Andrew Hoon,48,0,50,2
1668194339809,MATH 296,A00,098063,Novak; Jonathan I,20,0,20,0
1668194340234,MATH 297,001,098064,Gamst; Anthony Collins,9997,0,9999,2
1668194842297,COGS 205,A00,101395,Chiba; Andrea,19,0,20,1
1668194842728,COGS 210B,001,101404,Greene; Deanna Jacquelyn,9998,0,9999,1
1668194842728,COGS 210B,002,101417,Xia; Haijun,9999,0,9999,0
1668194842728,COGS 210B,003,101422,Nitz; Douglas A.,9999,0,9999,0
1668194842728,COGS 210B,004,101423,Hollan; James D.,9998,0,9999,1
1668194842728,COGS 210B,005,101424,Deak; Gedeon O.,9998,0,9999,1
1668194842728,COGS 210B,006,101425,Rossano; Federico,9999,0,9999,0
1668194843156,COGS 211B,A00,101427,Coulson; Seana M,9996,0,9999,3
1668194843586,COGS 220,A00,101428,Hollan; James D.,0,0,25,25
1668194844010,COGS 229,A00,101429,Dow; Steven P,18,0,25,7
1668194844433,COGS 230,A00,101430,Klemmer; Scott R,12,0,17,5
1668194844856,COGS 234,A00,101431,Xia; Haijun,3,0,25,22
1668194845279,COGS 260,A00,101432,Kiyonaga; Anastasia,20,0,25,5
1668194845279,COGS 260,B00,101433,Kirsh; David Joel,16,0,25,9
1668194845702,CSE 202,A00,102371,Impagliazzo; Russell,0,0,0,0
1668194846124,CSE 203B,A01,102373,Cheng; Chung Kuan,0,0,0,0
1668194846551,CSE 208,A00,102374,Micciancio; Daniele,0,0,0,0
1668194846976,CSE 209A,A00,112895,Impagliazzo; Russell,0,0,15,15
1668194847401,CSE 209B,A00,108005,Bellare; Mihir,0,0,0,0
1668194847828,CSE 210,A00,113163,Coblenz; Michael J,0,0,0,0
1668194848252,CSE 219,A00,106111,Dow; Steven P,0,0,20,20
1668194848681,CSE 221,A00,102376,Voelker; Geoffrey M.,0,0,0,0
1668194849105,CSE 224,A01,102378,Porter; George M,0,0,0,0
1668194849544,CSE 229A,A00,102379,Savage; Stefan,0,0,0,0
1668194849970,CSE 229C,A00,102380,Munyaka; Imani N. S.,0,0,0,0
1668194850405,CSE 232B,A00,102382,Deutsch; Alin Bernard,0,0,0,0
1668194850829,CSE 234,A01,112904,Kumar; Arun Kumar,0,0,0,0
1668194851252,CSE 237A,A00,102383,Rosing; Tajana Simunic,0,0,0,0
1668194851675,CSE 239A,A00,102384,Deutsch; Alin Bernard,0,0,0,0
1668194852112,CSE 239B,A00,102385,Polikarpova; Nadezhda,0,0,0,0
1668194852538,CSE 240A,A00,102386,Pannuto; Patrick William,0,0,0,0
1668194852963,CSE 240B,A00,102387,Zhao; Jishen,0,0,0,0
1668194853395,CSE 241A,A00,106406,Kang; Mingu,0,0,0,0
1668194853830,CSE 249B,A00,102388,Kahng; Andrew Byun,0,0,8,8
1668194854256,CSE 251B,A01,102392,Cottrell; Garrison W,0,0,0,0
1668194854256,CSE 251B,A02,102393,Cottrell; Garrison W,0,0,0,0
1668194854689,CSE 252B,A00,102394,Ochoa; Benjamin Lawrence,0,0,0,0
1668194855121,CSE 257,A01,102396,Gao; Sicun,0,0,0,0
1668194855550,CSE 272,A00,102397,Li; Tzumao,0,0,0,0
1668194855983,CSE 274,A00,111323,Chern; Albert Ren-Haur,0,0,0,0
1668194856407,CSE 282,A00,102398,Pevzner; Pavel Arkadjevich,0,0,0,0
1668194856829,CSE 284,A00,114175,Gymrek; Melissa Ann,0,0,0,0
1668194857253,CSE 290,A00,102399,Chandraker; Manmohan Krishna,0,0,0,0
1668194857253,CSE 290,B00,102400,Vaccaro; Kristen Marie,0,0,25,25
1668194857253,CSE 290,C00,102414,Pannuto; Patrick William,0,0,25,25
1668194857253,CSE 290,D00,102427,Pevzner; Pavel Arkadjevich,0,0,0,0
1668194857253,CSE 290,E00,102429,Zhao; Jishen,0,0,0,0
1668194857253,CSE 290,F00,102436,Tullsen; Dean Michael,0,0,0,0
1668194857253,CSE 290,G00,102440,Christensen; Henrik I,0,0,20,20
1668194857678,CSE 291,A00,102443,Su; Hao,0,0,0,0
1668194857678,CSE 291,B00,102448,Polikarpova; Nadezhda,0,0,0,0
1668194857678,CSE 291,C00,102453,Vaccaro; Kristen Marie,0,0,0,0
1668194857678,CSE 291,D00,111343,Savage; Stefan,0,0,0,0
1668194857678,CSE 291,E00,116474,Claffy; Kimberly Claire,0,0,0,0
1668194857678,CSE 291,F00,116479,Pasquale; Joseph,0,0,0,0
1668194858104,CSE 293,001,119111,Bafna; Vineet,9999,0,9999,0
1668194858104,CSE 293,002,119118,Bellare; Mihir,9999,0,9999,0
1668194858104,CSE 293,003,119122,Berg-Kirkpatrick; Taylor D,9999,0,9999,0
1668194858104,CSE 293,004,119135,Christensen; Henrik I,9999,0,9999,0
1668194858104,CSE 293,005,119142,Cottrell; Garrison W,9999,0,9999,0
1668194858104,CSE 293,006,119146,Deutsch; Alin Bernard,9999,0,9999,0
1668194858104,CSE 293,007,119159,Esmaeilzadeh; Hadi,9999,0,9999,0
1668194858104,CSE 293,008,119166,Freund; Yoav,9999,0,9999,0
1668194858104,CSE 293,009,119170,Griswold; William G.,9999,0,9999,0
1668194858104,CSE 293,010,119183,Gymrek; Melissa Ann,9999,0,9999,0
1668194858104,CSE 293,011,119190,Heninger; Nadia A,9999,0,9999,0
1668194858104,CSE 293,012,119230,Impagliazzo; Russell,9999,0,9999,0
1668194858104,CSE 293,013,119232,Jhala; Ranjit,9999,0,9999,0
1668194858104,CSE 293,014,119233,Kahng; Andrew Byun,9999,0,9999,0
1668194858104,CSE 293,015,119298,Kane; Daniel Mertz,9999,0,9999,0
1668194858104,CSE 293,016,119299,Kriegman; David J,9999,0,9999,0
1668194858104,CSE 293,017,119300,Kumar; Arun Kumar,9999,0,9999,0
1668194858104,CSE 293,018,119301,Lerner; Sorin,9999,0,9999,0
1668194858104,CSE 293,019,119302,Lovett; Shachar,9999,0,9999,0
1668194858104,CSE 293,020,119303,McAuley; Julian John,9999,0,9999,0
1668194858104,CSE 293,021,119304,Micciancio; Daniele,9999,0,9999,0
1668194858104,CSE 293,022,119367,Orailoglu; Alex,9999,0,9999,0
1668194858104,CSE 293,023,119382,Paturi; Ramamohan,9999,0,9999,0
1668194858104,CSE 293,024,119404,Polikarpova; Nadezhda,9999,0,9999,0
1668194858104,CSE 293,025,119406,Politz; Joseph Gibbs,9999,0,9999,0
1668194858104,CSE 293,026,119411,Porter; George M,9999,0,9999,0
1668194858104,CSE 293,027,119414,Porter; Leonard Emerson,9999,0,9999,0
1668194858104,CSE 293,028,119416,Ramamoorthi; Ravi,9999,0,9999,0
1668194858104,CSE 293,029,119417,Sahoo; Debashis,9999,0,9999,0
1668194858104,CSE 293,030,119420,Saul; Lawrence,9999,0,9999,0
1668194858104,CSE 293,031,119421,Savage; Stefan,9999,0,9999,0
1668194858104,CSE 293,032,119425,Schulze; Jurgen P.,9999,0,9999,0
1668194858104,CSE 293,033,119426,Snoeren; Alex C.,9999,0,9999,0
1668194858104,CSE 293,034,119428,Shang; Jingbo,9999,0,9999,0
1668194858104,CSE 293,035,119430,Stefan; Deian,9999,0,9999,0
1668194858104,CSE 293,036,119431,Su; Hao,9999,0,9999,0
1668194858104,CSE 293,037,119433,Swanson; Steven James,9999,0,9999,0
1668194858104,CSE 293,038,119435,Tullsen; Dean Michael,9999,0,9999,0
1668194858104,CSE 293,039,119483,Voelker; Geoffrey M.,9999,0,9999,0
1668194858104,CSE 293,040,119537,Zhao; Jishen,9999,0,9999,0
1668194858104,CSE 293,041,119538,Zhou; Yuan-Yuan,9999,0,9999,0
1668194858104,CSE 293,042,119539,Gao; Sicun,9999,0,9999,0
1668194858104,CSE 293,043,119540,Weibel; Nadir,9999,0,9999,0
1668194858104,CSE 293,044,119541,Gupta; Rajesh K.,9999,0,9999,0
1668194858104,CSE 293,045,126410,Vaccaro; Kristen Marie,9999,0,9999,0
1668194858104,CSE 293,046,126411,Klemke; Richard,9999,0,9999,0
1668194858532,CSE 294,A00,102459,Voelker; Geoffrey M.,0,0,0,0
1668194858532,CSE 294,B00,111322,Orailoglu; Alex,0,0,0,0
1668194858952,DSE 201,A00,096914,Deutsch; Alin Bernard,30,0,30,0
1668194859377,DSE 210,A00,096915,Dasgupta; Sanjoy,30,0,30,0
1668194859809,DSE 260A,A00,096916,Altintas De Callaf; Ilkay,30,0,30,0
1668194860234,ECE 200,001,103586,Antipa; Nicholas A,9999,0,9999,0
1668194860234,ECE 200,002,103587,Atanasov; Nikolay A.,9999,0,9999,0
1668194860234,ECE 200,003,103588,Bharadia; Dinesh,9999,0,9999,0
1668194860234,ECE 200,004,103589,Cheng; Chung Kuan,9999,0,9999,0
1668194860234,ECE 200,005,103590,Cosman; Pamela C.,9999,0,9999,0
1668194860234,ECE 200,006,103591,Dayeh; Shadi Ahmad,9999,0,9999,0
1668194860234,ECE 200,007,103592,Fainman; Yeshaiahu,9999,0,9999,0
1668194860234,ECE 200,008,103593,Ford; Joseph Earl,9999,0,9999,0
1668194860234,ECE 200,009,103594,Franceschetti; Massimo,9999,0,9999,0
1668194860234,ECE 200,010,103595,Fullerton; Eric E,9999,0,9999,0
1668194860234,ECE 200,011,103596,Galton; Ian A,9999,0,9999,0
1668194860234,ECE 200,012,103597,Gilja; Vikash,9999,0,9999,0
1668194860234,ECE 200,013,103598,Hall; Drew A.,9999,0,9999,0
1668194860234,ECE 200,014,103599,Hsueh; Tzu-Chien,9999,0,9999,0
1668194860234,ECE 200,015,103600,Javidi; Tara,9999,0,9999,0
1668194860234,ECE 200,016,103601,Kahng; Andrew Byun,9999,0,9999,0
1668194860234,ECE 200,017,103602,Kim; Young-Han,9999,0,9999,0
1668194860234,ECE 200,018,103603,Koushanfar; Farinaz,9999,0,9999,0
1668194860234,ECE 200,019,103604,Kuzum; Duygu,9999,0,9999,0
1668194860234,ECE 200,020,103605,Le; Hanh-Phuc,9999,0,9999,0
1668194860234,ECE 200,021,103606,Lin; Bill,9999,0,9999,0
1668194860234,ECE 200,022,103607,Liu; Zhaowei,9998,0,9999,1
1668194860234,ECE 200,023,103608,Lo; Yu-Hwa,9999,0,9999,0
1668194860234,ECE 200,024,103609,Lomakin; Vitaliy,9999,0,9999,0
1668194860234,ECE 200,025,103610,Mercier; Patrick Philip,9999,0,9999,0
1668194860234,ECE 200,026,103611,Meyer; Florian,9999,0,9999,0
1668194860234,ECE 200,027,103612,Milstein; Laurence B.,9999,0,9999,0
1668194860234,ECE 200,028,103613,Mir Arabbaygi; Siavash,9999,0,9999,0
1668194860234,ECE 200,029,103614,Mookherjea; Shayan,9999,0,9999,0
1668194860234,ECE 200,030,103615,Morris; Karcher William,9999,0,9999,0
1668194860234,ECE 200,031,103616,Ng; Tse Nga,9999,0,9999,0
1668194860234,ECE 200,032,103617,Nguyen; Truong Quang,9999,0,9999,0
1668194860234,ECE 200,033,103618,Nomura; Kenji,9999,0,9999,0
1668194860234,ECE 200,034,103619,Orlitsky; Alon,9999,0,9999,0
1668194860234,ECE 200,035,103620,Pal; Piya,9999,0,9999,0
1668194860234,ECE 200,036,103621,Papen; George C.,9999,0,9999,0
1668194860234,ECE 200,037,103622,Radic; Stojan,9999,0,9999,0
1668194860234,ECE 200,038,103623,Rao; Bhaskar D.,9999,0,9999,0
1668194860234,ECE 200,039,103624,Rao; Ramesh R,9999,0,9999,0
1668194860234,ECE 200,040,103625,Rebeiz; Gabriel,9999,0,9999,0
1668194860234,ECE 200,041,103626,Sanford; John R,9999,0,9999,0
1668194860234,ECE 200,042,103627,Siegel; Paul H.,9999,0,9999,0
1668194860234,ECE 200,043,103628,Sievenpiper; Daniel F.,9999,0,9999,0
1668194860234,ECE 200,044,103629,Sworder; David D.,9999,0,9999,0
1668194860234,ECE 200,045,103630,Taur; Yuan,9999,0,9999,0
1668194860234,ECE 200,046,103631,Touri; Behrouz,9999,0,9999,0
1668194860234,ECE 200,047,103632,Trivedi; Mohan M.,9999,0,9999,0
1668194860234,ECE 200,048,103633,Vasconcelos; Nuno,9999,0,9999,0
1668194860234,ECE 200,049,103634,Wang; Xiaolong,9999,0,9999,0
1668194860234,ECE 200,050,103635,Xie; Pengtao,9999,0,9999,0
1668194860234,ECE 200,051,103636,Yip; Michael,9999,0,9999,0
1668194860234,ECE 200,052,103637,Zeger; Kenneth A.,999,0,999,0
1668194860234,ECE 200,053,103638,Zhang; Xinyu,9999,0,9999,0
1668194860234,ECE 200,054,103639,Turakhia; Yatish Girish,9999,0,9999,0
1668194860234,ECE 200,055,103640,Kang; Mingu,9999,0,9999,0
1668194860234,ECE 200,056,103641,Shi; Yuanyuan,9999,0,9999,0
1668194860234,ECE 200,057,103642,Wang; Edward Jay,9999,0,9999,0
1668194860234,ECE 200,058,103643,Zheng; Yang,9999,0,9999,0
1668194860658,ECE 202,A00,103644,Kuzum; Duygu,0,0,0,0
1668194861086,ECE 212BN,A00,103646,Ng; Tse Nga,0,0,0,0
1668194861510,ECE 221,A00,111493,Staff,0,0,0,0
1668194861938,ECE 222B,A00,103647,Lomakin; Vitaliy,0,0,0,0
1668194862364,ECE 230B,A00,103648,Taur; Yuan,0,0,0,0
1668194862788,ECE 238B,A00,103649,Garay; Javier,0,0,0,0
1668194863211,ECE 240B,A00,112900,Fainman; Yeshaiahu,0,0,0,0
1668194863633,ECE 247A,A00,103650,Jokerst; Jesse Vincent,0,0,0,0
1668194864065,ECE 247B,A00,103651,Wang; Joseph,0,0,0,0
1668194864492,ECE 250,A00,103652,Siegel; Paul H.,0,0,0,0
1668194864917,ECE 251A,A00,103654,Rao; Bhaskar D.,0,0,0,0
1668194865349,ECE 257B,A00,103655,Bharadia; Dinesh,0,0,0,0
1668194865781,ECE 258A,A00,103656,Milstein; Laurence B.,0,0,0,0
1668194866203,ECE 260B,A00,103658,Kang; Mingu,0,0,0,0
1668194866626,ECE 264A,A00,103659,Galton; Ian A,0,0,0,0
1668194867053,ECE 265A,A00,103661,Gudem; Prasad S.S.,0,0,0,0
1668194867480,ECE 265D,A00,103662,Gudem; Prasad S.S.,0,0,0,0
1668194867905,ECE 268,A00,103663,Koushanfar; Farinaz,0,0,0,0
1668194868331,ECE 269,A01,103665,Pal; Piya,0,0,0,0
1668194868760,ECE 271B,A00,103666,Vasconcelos; Manuela,0,0,0,0
1668194869185,ECE 276A,A00,103667,Atanasov; Nikolay A.,0,0,0,0
1668194869609,ECE 277,A00,103668,An; Cheolhong,0,0,0,0
1668194870034,ECE 279,A00,117947,Hall; Drew A.,0,0,0,0
1668194870896,ECE 283,A00,103670,Hsueh; Tzu-Chien,0,0,0,0
1668194871323,ECE 284,A00,103671,Turakhia; Yatish Girish,0,0,0,0
1668194871745,ECE 285,A00,103672,Zheng; Yang,0,0,0,0
1668194871745,ECE 285,B00,103673,Sworder; David D.,0,0,0,0
1668194872171,ECE 287,A00,103676,Javidi; Tara,0,0,0,0
1668194872600,MATH 200B,A00,098023,Salehi Golsefidy; Alireza,12,0,15,3
1668194873032,MATH 202B,A00,098024,Rhoades; Brendon Patrick,9,0,15,6
1668194873454,MATH 203B,A00,098025,Oprea; Dragos N.,10,0,15,5
1668194873876,MATH 204B,A00,098026,Sorensen; Claus M,13,0,15,2
1668194874303,MATH 208,A00,098027,Izadi; Elham,7,0,10,3
1668194874734,MATH 209,A00,098028,Pollack; Aaron,10,0,10,0
1668194875160,MATH 211A,A00,112919,Rogalski; Daniel,9,0,10,1
1668194875583,MATH 211B,A00,112920,Seward; Brandon M.,9,0,10,1
1668194876007,MATH 218,A00,098029,Li; Bo,10,0,10,0
1668194876430,MATH 220B,A00,098030,Novak; Jonathan I,11,0,15,4
1668194876856,MATH 221A,A00,098031,Ebenfelt; Peter F,13,0,15,2
1668194877290,MATH 231B,A00,098032,Zlatos; Andrej,12,0,15,3
1668194877713,MATH 240B,A00,098033,Ni; Lei,9,0,15,6
1668194878135,MATH 243,A00,098034,Jekel; David Andrew,10,0,10,0
1668194878563,MATH 245A,A00,098035,Nie; Jiawang,0,0,15,16
1668194878986,MATH 248,A00,098036,Bejenaru; Ioan,10,0,10,0
1668194879411,MATH 250B,A00,098037,Spolaor; Luca,14,0,15,1
1668194879834,MATH 258,A00,098038,Ni; Lei,10,0,10,0
1668194880260,MATH 264B,A00,098041,Rhoades; Brendon Patrick,9,0,15,6
1668194880690,MATH 268,A00,098042,Buss; Samuel R,10,0,10,0
1668194881114,MATH 269,A00,098043,Rhoades; Brendon Patrick,10,0,10,0
1668194881550,MATH 270B,A00,098044,Li; Bo,10,0,15,5
1668194881972,MATH 272B,A00,098045,Holst; Michael J,13,0,15,2
1668194882488,MATH 273A,A00,098046,Tian; Xiaochuan,10,0,15,5
1668194882913,MATH 275,A01,098048,Tian; Xiaochuan,6,0,10,4
1668194883337,MATH 278A,A00,098049,Holst; Michael J,8,0,10,2
1668194883766,MATH 278B,A00,098050,Cloninger; Alexander,10,0,10,0
1668194884188,MATH 278C,A00,098051,Nie; Jiawang,7,0,10,3
1668194884613,MATH 280B,A00,098052,Zheng; Tianyi,10,0,15,5
1668194885046,MATH 281B,A00,098053,Bradic; Jelena,2,0,15,13
1668194885475,MATH 282B,A00,098054,Arias-Castro; Ery,0,0,15,15
1668194885907,MATH 285,A00,098055,Fitzsimmons; Patrick J,0,0,15,17
1668194886335,MATH 287B,A00,098056,Arias-Castro; Ery,2,0,15,13
1668194886758,MATH 288,A00,098057,Agarwal; Pooja,9,0,10,1
1668194886758,MATH 288,B00,098058,Zhang; Danna,8,0,10,2
1668194886758,MATH 288,C00,098059,Williams; Ruth J,10,0,10,0
1668194887187,MATH 290B,A00,098060,Roberts; Justin Deritter,13,0,15,2
1668194887619,MATH 292,A00,098061,Belmont; Eva Kinoshita,10,0,10,0
1668194888044,MATH 295,A00,098062,Suk; Andrew Hoon,48,0,50,2
1668194888467,MATH 296,A00,098063,Novak; Jonathan I,20,0,20,0
1668194888899,MATH 297,001,098064,Gamst; Anthony Collins,9997,0,9999,2
1668195409353,COGS 205,A00,101395,Chiba; Andrea,19,0,20,1
1668195409779,COGS 210B,001,101404,Greene; Deanna Jacquelyn,9998,0,9999,1
1668195409779,COGS 210B,002,101417,Xia; Haijun,9999,0,9999,0
1668195409779,COGS 210B,003,101422,Nitz; Douglas A.,9999,0,9999,0
1668195409779,COGS 210B,004,101423,Hollan; James D.,9998,0,9999,1
1668195409779,COGS 210B,005,101424,Deak; Gedeon O.,9998,0,9999,1
1668195409779,COGS 210B,006,101425,Rossano; Federico,9999,0,9999,0
1668195410214,COGS 211B,A00,101427,Coulson; Seana M,9996,0,9999,3
1668195410641,COGS 220,A00,101428,Hollan; James D.,0,0,25,25
1668195411066,COGS 229,A00,101429,Dow; Steven P,18,0,25,7
1668195411509,COGS 230,A00,101430,Klemmer; Scott R,12,0,17,5
1668195411930,COGS 234,A00,101431,Xia; Haijun,3,0,25,22
1668195412357,COGS 260,A00,101432,Kiyonaga; Anastasia,20,0,25,5
1668195412357,COGS 260,B00,101433,Kirsh; David Joel,16,0,25,9
1668195412782,CSE 202,A00,102371,Impagliazzo; Russell,0,0,0,0
1668195413204,CSE 203B,A01,102373,Cheng; Chung Kuan,0,0,0,0
1668195413638,CSE 208,A00,102374,Micciancio; Daniele,0,0,0,0
1668195414060,CSE 209A,A00,112895,Impagliazzo; Russell,0,0,15,15
1668195414489,CSE 209B,A00,108005,Bellare; Mihir,0,0,0,0
1668195414910,CSE 210,A00,113163,Coblenz; Michael J,0,0,0,0
1668195415335,CSE 219,A00,106111,Dow; Steven P,0,0,20,20
1668195415759,CSE 221,A00,102376,Voelker; Geoffrey M.,0,0,0,0
1668195416183,CSE 224,A01,102378,Porter; George M,0,0,0,0
1668195416608,CSE 229A,A00,102379,Savage; Stefan,0,0,0,0
1668195417032,CSE 229C,A00,102380,Munyaka; Imani N. S.,0,0,0,0
1668195417454,CSE 232B,A00,102382,Deutsch; Alin Bernard,0,0,0,0
1668195417880,CSE 234,A01,112904,Kumar; Arun Kumar,0,0,0,0
1668195418304,CSE 237A,A00,102383,Rosing; Tajana Simunic,0,0,0,0
1668195418738,CSE 239A,A00,102384,Deutsch; Alin Bernard,0,0,0,0
1668195419173,CSE 239B,A00,102385,Polikarpova; Nadezhda,0,0,0,0
1668195419596,CSE 240A,A00,102386,Pannuto; Patrick William,0,0,0,0
1668195420025,CSE 240B,A00,102387,Zhao; Jishen,0,0,0,0
1668195420456,CSE 241A,A00,106406,Kang; Mingu,0,0,0,0
1668195420887,CSE 249B,A00,102388,Kahng; Andrew Byun,0,0,8,8
1668195421318,CSE 251B,A01,102392,Cottrell; Garrison W,0,0,0,0
1668195421318,CSE 251B,A02,102393,Cottrell; Garrison W,0,0,0,0
1668195421742,CSE 252B,A00,102394,Ochoa; Benjamin Lawrence,0,0,0,0
1668195422164,CSE 257,A01,102396,Gao; Sicun,0,0,0,0
1668195422587,CSE 272,A00,102397,Li; Tzumao,0,0,0,0
1668195423110,CSE 274,A00,111323,Chern; Albert Ren-Haur,0,0,0,0
1668195423534,CSE 282,A00,102398,Pevzner; Pavel Arkadjevich,0,0,0,0
1668195423960,CSE 284,A00,114175,Gymrek; Melissa Ann,0,0,0,0
1668195424389,CSE 290,A00,102399,Chandraker; Manmohan Krishna,0,0,0,0
1668195424389,CSE 290,B00,102400,Vaccaro; Kristen Marie,0,0,25,25
1668195424389,CSE 290,C00,102414,Pannuto; Patrick William,0,0,25,25
1668195424389,CSE 290,D00,102427,Pevzner; Pavel Arkadjevich,0,0,0,0
1668195424389,CSE 290,E00,102429,Zhao; Jishen,0,0,0,0
1668195424389,CSE 290,F00,102436,Tullsen; Dean Michael,0,0,0,0
1668195424389,CSE 290,G00,102440,Christensen; Henrik I,0,0,20,20
1668195424828,CSE 291,A00,102443,Su; Hao,0,0,0,0
1668195424828,CSE 291,B00,102448,Polikarpova; Nadezhda,0,0,0,0
1668195424828,CSE 291,C00,102453,Vaccaro; Kristen Marie,0,0,0,0
1668195424828,CSE 291,D00,111343,Savage; Stefan,0,0,0,0
1668195424828,CSE 291,E00,116474,Claffy; Kimberly Claire,0,0,0,0
1668195424828,CSE 291,F00,116479,Pasquale; Joseph,0,0,0,0
1668195425254,CSE 293,001,119111,Bafna; Vineet,9999,0,9999,0
1668195425254,CSE 293,002,119118,Bellare; Mihir,9999,0,9999,0
1668195425254,CSE 293,003,119122,Berg-Kirkpatrick; Taylor D,9999,0,9999,0
1668195425254,CSE 293,004,119135,Christensen; Henrik I,9999,0,9999,0
1668195425254,CSE 293,005,119142,Cottrell; Garrison W,9999,0,9999,0
1668195425254,CSE 293,006,119146,Deutsch; Alin Bernard,9999,0,9999,0
1668195425254,CSE 293,007,119159,Esmaeilzadeh; Hadi,9999,0,9999,0
1668195425254,CSE 293,008,119166,Freund; Yoav,9999,0,9999,0
1668195425254,CSE 293,009,119170,Griswold; William G.,9999,0,9999,0
1668195425254,CSE 293,010,119183,Gymrek; Melissa Ann,9999,0,9999,0
1668195425254,CSE 293,011,119190,Heninger; Nadia A,9999,0,9999,0
1668195425254,CSE 293,012,119230,Impagliazzo; Russell,9999,0,9999,0
1668195425254,CSE 293,013,119232,Jhala; Ranjit,9999,0,9999,0
1668195425254,CSE 293,014,119233,Kahng; Andrew Byun,9999,0,9999,0
1668195425254,CSE 293,015,119298,Kane; Daniel Mertz,9999,0,9999,0
1668195425254,CSE 293,016,119299,Kriegman; David J,9999,0,9999,0
1668195425254,CSE 293,017,119300,Kumar; Arun Kumar,9999,0,9999,0
1668195425254,CSE 293,018,119301,Lerner; Sorin,9999,0,9999,0
1668195425254,CSE 293,019,119302,Lovett; Shachar,9999,0,9999,0
1668195425254,CSE 293,020,119303,McAuley; Julian John,9999,0,9999,0
1668195425254,CSE 293,021,119304,Micciancio; Daniele,9999,0,9999,0
1668195425254,CSE 293,022,119367,Orailoglu; Alex,9999,0,9999,0
1668195425254,CSE 293,023,119382,Paturi; Ramamohan,9999,0,9999,0
1668195425254,CSE 293,024,119404,Polikarpova; Nadezhda,9999,0,9999,0
1668195425254,CSE 293,025,119406,Politz; Joseph Gibbs,9999,0,9999,0
1668195425254,CSE 293,026,119411,Porter; George M,9999,0,9999,0
1668195425254,CSE 293,027,119414,Porter; Leonard Emerson,9999,0,9999,0
1668195425254,CSE 293,028,119416,Ramamoorthi; Ravi,9999,0,9999,0
1668195425254,CSE 293,029,119417,Sahoo; Debashis,9999,0,9999,0
1668195425254,CSE 293,030,119420,Saul; Lawrence,9999,0,9999,0
1668195425254,CSE 293,031,119421,Savage; Stefan,9999,0,9999,0
1668195425254,CSE 293,032,119425,Schulze; Jurgen P.,9999,0,9999,0
1668195425254,CSE 293,033,119426,Snoeren; Alex C.,9999,0,9999,0
1668195425254,CSE 293,034,119428,Shang; Jingbo,9999,0,9999,0
1668195425254,CSE 293,035,119430,Stefan; Deian,9999,0,9999,0
1668195425254,CSE 293,036,119431,Su; Hao,9999,0,9999,0
1668195425254,CSE 293,037,119433,Swanson; Steven James,9999,0,9999,0
1668195425254,CSE 293,038,119435,Tullsen; Dean Michael,9999,0,9999,0
1668195425254,CSE 293,039,119483,Voelker; Geoffrey M.,9999,0,9999,0
1668195425254,CSE 293,040,119537,Zhao; Jishen,9999,0,9999,0
1668195425254,CSE 293,041,119538,Zhou; Yuan-Yuan,9999,0,9999,0
1668195425254,CSE 293,042,119539,Gao; Sicun,9999,0,9999,0
1668195425254,CSE 293,043,119540,Weibel; Nadir,9999,0,9999,0
1668195425254,CSE 293,044,119541,Gupta; Rajesh K.,9999,0,9999,0
1668195425254,CSE 293,045,126410,Vaccaro; Kristen Marie,9999,0,9999,0
1668195425254,CSE 293,046,126411,Klemke; Richard,9999,0,9999,0
1668195425678,CSE 294,A00,102459,Voelker; Geoffrey M.,0,0,0,0
1668195425678,CSE 294,B00,111322,Orailoglu; Alex,0,0,0,0
1668195426103,DSE 201,A00,096914,Deutsch; Alin Bernard,30,0,30,0
1668195426543,DSE 210,A00,096915,Dasgupta; Sanjoy,30,0,30,0
1668195426980,DSE 260A,A00,096916,Altintas De Callaf; Ilkay,30,0,30,0
1668195427447,ECE 200,001,103586,Antipa; Nicholas A,9999,0,9999,0
1668195427447,ECE 200,002,103587,Atanasov; Nikolay A.,9999,0,9999,0
1668195427447,ECE 200,003,103588,Bharadia; Dinesh,9999,0,9999,0
1668195427447,ECE 200,004,103589,Cheng; Chung Kuan,9999,0,9999,0
1668195427447,ECE 200,005,103590,Cosman; Pamela C.,9999,0,9999,0
1668195427447,ECE 200,006,103591,Dayeh; Shadi Ahmad,9999,0,9999,0
1668195427447,ECE 200,007,103592,Fainman; Yeshaiahu,9999,0,9999,0
1668195427447,ECE 200,008,103593,Ford; Joseph Earl,9999,0,9999,0
1668195427447,ECE 200,009,103594,Franceschetti; Massimo,9999,0,9999,0
1668195427447,ECE 200,010,103595,Fullerton; Eric E,9999,0,9999,0
1668195427447,ECE 200,011,103596,Galton; Ian A,9999,0,9999,0
1668195427447,ECE 200,012,103597,Gilja; Vikash,9999,0,9999,0
1668195427447,ECE 200,013,103598,Hall; Drew A.,9999,0,9999,0
1668195427447,ECE 200,014,103599,Hsueh; Tzu-Chien,9999,0,9999,0
1668195427447,ECE 200,015,103600,Javidi; Tara,9999,0,9999,0
1668195427447,ECE 200,016,103601,Kahng; Andrew Byun,9999,0,9999,0
1668195427447,ECE 200,017,103602,Kim; Young-Han,9999,0,9999,0
1668195427447,ECE 200,018,103603,Koushanfar; Farinaz,9999,0,9999,0
1668195427447,ECE 200,019,103604,Kuzum; Duygu,9999,0,9999,0
1668195427447,ECE 200,020,103605,Le; Hanh-Phuc,9999,0,9999,0
1668195427447,ECE 200,021,103606,Lin; Bill,9999,0,9999,0
1668195427447,ECE 200,022,103607,Liu; Zhaowei,9998,0,9999,1
1668195427447,ECE 200,023,103608,Lo; Yu-Hwa,9999,0,9999,0
1668195427447,ECE 200,024,103609,Lomakin; Vitaliy,9999,0,9999,0
1668195427447,ECE 200,025,103610,Mercier; Patrick Philip,9999,0,9999,0
1668195427447,ECE 200,026,103611,Meyer; Florian,9999,0,9999,0
1668195427447,ECE 200,027,103612,Milstein; Laurence B.,9999,0,9999,0
1668195427447,ECE 200,028,103613,Mir Arabbaygi; Siavash,9999,0,9999,0
1668195427447,ECE 200,029,103614,Mookherjea; Shayan,9999,0,9999,0
1668195427447,ECE 200,030,103615,Morris; Karcher William,9999,0,9999,0
1668195427447,ECE 200,031,103616,Ng; Tse Nga,9999,0,9999,0
1668195427447,ECE 200,032,103617,Nguyen; Truong Quang,9999,0,9999,0
1668195427447,ECE 200,033,103618,Nomura; Kenji,9999,0,9999,0
1668195427447,ECE 200,034,103619,Orlitsky; Alon,9999,0,9999,0
1668195427447,ECE 200,035,103620,Pal; Piya,9999,0,9999,0
1668195427447,ECE 200,036,103621,Papen; George C.,9999,0,9999,0
1668195427447,ECE 200,037,103622,Radic; Stojan,9999,0,9999,0
1668195427447,ECE 200,038,103623,Rao; Bhaskar D.,9999,0,9999,0
1668195427447,ECE 200,039,103624,Rao; Ramesh R,9999,0,9999,0
1668195427447,ECE 200,040,103625,Rebeiz; Gabriel,9999,0,9999,0
1668195427447,ECE 200,041,103626,Sanford; John R,9999,0,9999,0
1668195427447,ECE 200,042,103627,Siegel; Paul H.,9999,0,9999,0
1668195427447,ECE 200,043,103628,Sievenpiper; Daniel F.,9999,0,9999,0
1668195427447,ECE 200,044,103629,Sworder; David D.,9999,0,9999,0
1668195427447,ECE 200,045,103630,Taur; Yuan,9999,0,9999,0
1668195427447,ECE 200,046,103631,Touri; Behrouz,9999,0,9999,0
1668195427447,ECE 200,047,103632,Trivedi; Mohan M.,9999,0,9999,0
1668195427447,ECE 200,048,103633,Vasconcelos; Nuno,9999,0,9999,0
1668195427447,ECE 200,049,103634,Wang; Xiaolong,9999,0,9999,0
1668195427447,ECE 200,050,103635,Xie; Pengtao,9999,0,9999,0
1668195427447,ECE 200,051,103636,Yip; Michael,9999,0,9999,0
1668195427447,ECE 200,052,103637,Zeger; Kenneth A.,999,0,999,0
1668195427447,ECE 200,053,103638,Zhang; Xinyu,9999,0,9999,0
1668195427447,ECE 200,054,103639,Turakhia; Yatish Girish,9999,0,9999,0
1668195427447,ECE 200,055,103640,Kang; Mingu,9999,0,9999,0
1668195427447,ECE 200,056,103641,Shi; Yuanyuan,9999,0,9999,0
1668195427447,ECE 200,057,103642,Wang; Edward Jay,9999,0,9999,0
1668195427447,ECE 200,058,103643,Zheng; Yang,9999,0,9999,0
1668195427872,ECE 202,A00,103644,Kuzum; Duygu,0,0,0,0
1668195428300,ECE 212BN,A00,103646,Ng; Tse Nga,0,0,0,0
1668195428731,ECE 221,A00,111493,Staff,0,0,0,0
1668195429155,ECE 222B,A00,103647,Lomakin; Vitaliy,0,0,0,0
1668195429580,ECE 230B,A00,103648,Taur; Yuan,0,0,0,0
1668195430002,ECE 238B,A00,103649,Garay; Javier,0,0,0,0
1668195430426,ECE 240B,A00,112900,Fainman; Yeshaiahu,0,0,0,0
1668195430858,ECE 247A,A00,103650,Jokerst; Jesse Vincent,0,0,0,0
1668195431286,ECE 247B,A00,103651,Wang; Joseph,0,0,0,0
1668195431710,ECE 250,A00,103652,Siegel; Paul H.,0,0,0,0
1668195432137,ECE 251A,A00,103654,Rao; Bhaskar D.,0,0,0,0
1668195432558,ECE 257B,A00,103655,Bharadia; Dinesh,0,0,0,0
1668195432985,ECE 258A,A00,103656,Milstein; Laurence B.,0,0,0,0
1668195433407,ECE 260B,A00,103658,Kang; Mingu,0,0,0,0
1668195433830,ECE 264A,A00,103659,Galton; Ian A,0,0,0,0
1668195434255,ECE 265A,A00,103661,Gudem; Prasad S.S.,0,0,0,0
1668195434681,ECE 265D,A00,103662,Gudem; Prasad S.S.,0,0,0,0
1668195435114,ECE 268,A00,103663,Koushanfar; Farinaz,0,0,0,0
1668195435536,ECE 269,A01,103665,Pal; Piya,0,0,0,0
1668195435971,ECE 271B,A00,103666,Vasconcelos; Manuela,0,0,0,0
1668195436396,ECE 276A,A00,103667,Atanasov; Nikolay A.,0,0,0,0
1668195436823,ECE 277,A00,103668,An; Cheolhong,0,0,0,0
1668195437260,ECE 279,A00,117947,Hall; Drew A.,0,0,0,0
1668195438107,ECE 283,A00,103670,Hsueh; Tzu-Chien,0,0,0,0
1668195438528,ECE 284,A00,103671,Turakhia; Yatish Girish,0,0,0,0
1668195438959,ECE 285,A00,103672,Zheng; Yang,0,0,0,0
1668195438959,ECE 285,B00,103673,Sworder; David D.,0,0,0,0
1668195439393,ECE 287,A00,103676,Javidi; Tara,0,0,0,0
1668195439829,MATH 200B,A00,098023,Salehi Golsefidy; Alireza,12,0,15,3
1668195440254,MATH 202B,A00,098024,Rhoades; Brendon Patrick,9,0,15,6
1668195440678,MATH 203B,A00,098025,Oprea; Dragos N.,10,0,15,5
1668195441104,MATH 204B,A00,098026,Sorensen; Claus M,13,0,15,2
1668195441526,MATH 208,A00,098027,Izadi; Elham,7,0,10,3
1668195441950,MATH 209,A00,098028,Pollack; Aaron,10,0,10,0
1668195442379,MATH 211A,A00,112919,Rogalski; Daniel,9,0,10,1
1668195442801,MATH 211B,A00,112920,Seward; Brandon M.,9,0,10,1
1668195443236,MATH 218,A00,098029,Li; Bo,10,0,10,0
1668195443659,MATH 220B,A00,098030,Novak; Jonathan I,11,0,15,4
1668195444082,MATH 221A,A00,098031,Ebenfelt; Peter F,13,0,15,2
1668195444508,MATH 231B,A00,098032,Zlatos; Andrej,12,0,15,3
1668195444939,MATH 240B,A00,098033,Ni; Lei,9,0,15,6
1668195445362,MATH 243,A00,098034,Jekel; David Andrew,10,0,10,0
1668195445783,MATH 245A,A00,098035,Nie; Jiawang,0,0,15,16
1668195446224,MATH 248,A00,098036,Bejenaru; Ioan,10,0,10,0
1668195446658,MATH 250B,A00,098037,Spolaor; Luca,14,0,15,1
1668195447080,MATH 258,A00,098038,Ni; Lei,10,0,10,0
1668195447504,MATH 264B,A00,098041,Rhoades; Brendon Patrick,9,0,15,6
1668195447927,MATH 268,A00,098042,Buss; Samuel R,10,0,10,0
1668195448349,MATH 269,A00,098043,Rhoades; Brendon Patrick,10,0,10,0
1668195448786,MATH 270B,A00,098044,Li; Bo,10,0,15,5
1668195449212,MATH 272B,A00,098045,Holst; Michael J,13,0,15,2
1668195449644,MATH 273A,A00,098046,Tian; Xiaochuan,10,0,15,5
1668195450066,MATH 275,A01,098048,Tian; Xiaochuan,6,0,10,4
1668195450500,MATH 278A,A00,098049,Holst; Michael J,8,0,10,2
1668195450930,MATH 278B,A00,098050,Cloninger; Alexander,10,0,10,0
1668195451357,MATH 278C,A00,098051,Nie; Jiawang,7,0,10,3
1668195451789,MATH 280B,A00,098052,Zheng; Tianyi,10,0,15,5
1668195452219,MATH 281B,A00,098053,Bradic; Jelena,2,0,15,13
1668195452653,MATH 282B,A00,098054,Arias-Castro; Ery,0,0,15,15
1668195453084,MATH 285,A00,098055,Fitzsimmons; Patrick J,0,0,15,17
1668195453508,MATH 287B,A00,098056,Arias-Castro; Ery,2,0,15,13
1668195453933,MATH 288,A00,098057,Agarwal; Pooja,9,0,10,1
1668195453933,MATH 288,B00,098058,Zhang; Danna,8,0,10,2
1668195453933,MATH 288,C00,098059,Williams; Ruth J,10,0,10,0
1668195454356,MATH 290B,A00,098060,Roberts; Justin Deritter,13,0,15,2
1668195454794,MATH 292,A00,098061,Belmont; Eva Kinoshita,10,0,10,0
1668195455218,MATH 295,A00,098062,Suk; Andrew Hoon,48,0,50,2
1668195455653,MATH 296,A00,098063,Novak; Jonathan I,20,0,20,0
1668195456077,MATH 297,001,098064,Gamst; Anthony Collins,9997,0,9999,2
1668195959072,COGS 205,A00,101395,Chiba; Andrea,19,0,20,1
1668195959501,COGS 210B,001,101404,Greene; Deanna Jacquelyn,9998,0,9999,1
1668195959501,COGS 210B,002,101417,Xia; Haijun,9999,0,9999,0
1668195959501,COGS 210B,003,101422,Nitz; Douglas A.,9999,0,9999,0
1668195959501,COGS 210B,004,101423,Hollan; James D.,9998,0,9999,1
1668195959501,COGS 210B,005,101424,Deak; Gedeon O.,9998,0,9999,1
1668195959501,COGS 210B,006,101425,Rossano; Federico,9999,0,9999,0
1668195959924,COGS 211B,A00,101427,Coulson; Seana M,9996,0,9999,3
1668195960346,COGS 220,A00,101428,Hollan; James D.,0,0,25,25
1668195960768,COGS 229,A00,101429,Dow; Steven P,18,0,25,7
1668195961201,COGS 230,A00,101430,Klemmer; Scott R,12,0,17,5
1668195961624,COGS 234,A00,101431,Xia; Haijun,3,0,25,22
1668195962046,COGS 260,A00,101432,Kiyonaga; Anastasia,20,0,25,5
1668195962046,COGS 260,B00,101433,Kirsh; David Joel,16,0,25,9
1668195962468,CSE 202,A00,102371,Impagliazzo; Russell,0,0,0,0
1668195962890,CSE 203B,A01,102373,Cheng; Chung Kuan,0,0,0,0
1668195963312,CSE 208,A00,102374,Micciancio; Daniele,0,0,0,0
1668195963736,CSE 209A,A00,112895,Impagliazzo; Russell,0,0,15,15
1668195964163,CSE 209B,A00,108005,Bellare; Mihir,0,0,0,0
1668195964594,CSE 210,A00,113163,Coblenz; Michael J,0,0,0,0
1668195965017,CSE 219,A00,106111,Dow; Steven P,0,0,20,20
1668195965588,CSE 221,A00,102376,Voelker; Geoffrey M.,0,0,0,0
1668195966012,CSE 224,A01,102378,Porter; George M,0,0,0,0
1668195966448,CSE 229A,A00,102379,Savage; Stefan,0,0,0,0
1668195966878,CSE 229C,A00,102380,Munyaka; Imani N. S.,0,0,0,0
1668195967300,CSE 232B,A00,102382,Deutsch; Alin Bernard,0,0,0,0
1668195967723,CSE 234,A01,112904,Kumar; Arun Kumar,0,0,0,0
1668195968145,CSE 237A,A00,102383,Rosing; Tajana Simunic,0,0,0,0
1668195968585,CSE 239A,A00,102384,Deutsch; Alin Bernard,0,0,0,0
1668195969008,CSE 239B,A00,102385,Polikarpova; Nadezhda,0,0,0,0
1668195969433,CSE 240A,A00,102386,Pannuto; Patrick William,0,0,0,0
1668195969859,CSE 240B,A00,102387,Zhao; Jishen,0,0,0,0
1668195970286,CSE 241A,A00,106406,Kang; Mingu,0,0,0,0
1668195970711,CSE 249B,A00,102388,Kahng; Andrew Byun,0,0,8,8
1668195971139,CSE 251B,A01,102392,Cottrell; Garrison W,0,0,0,0
1668195971139,CSE 251B,A02,102393,Cottrell; Garrison W,0,0,0,0
1668195971564,CSE 252B,A00,102394,Ochoa; Benjamin Lawrence,0,0,0,0
1668195971988,CSE 257,A01,102396,Gao; Sicun,0,0,0,0
1668195972410,CSE 272,A00,102397,Li; Tzumao,0,0,0,0
1668195972834,CSE 274,A00,111323,Chern; Albert Ren-Haur,0,0,0,0
1668195973257,CSE 282,A00,102398,Pevzner; Pavel Arkadjevich,0,0,0,0
1668195973690,CSE 284,A00,114175,Gymrek; Melissa Ann,0,0,0,0
1668195974125,CSE 290,A00,102399,Chandraker; Manmohan Krishna,0,0,0,0
1668195974125,CSE 290,B00,102400,Vaccaro; Kristen Marie,0,0,25,25
1668195974125,CSE 290,C00,102414,Pannuto; Patrick William,0,0,25,25
1668195974125,CSE 290,D00,102427,Pevzner; Pavel Arkadjevich,0,0,0,0
1668195974125,CSE 290,E00,102429,Zhao; Jishen,0,0,0,0
1668195974125,CSE 290,F00,102436,Tullsen; Dean Michael,0,0,0,0
1668195974125,CSE 290,G00,102440,Christensen; Henrik I,0,0,20,20
1668195974565,CSE 291,A00,102443,Su; Hao,0,0,0,0
1668195974565,CSE 291,B00,102448,Polikarpova; Nadezhda,0,0,0,0
1668195974565,CSE 291,C00,102453,Vaccaro; Kristen Marie,0,0,0,0
1668195974565,CSE 291,D00,111343,Savage; Stefan,0,0,0,0
1668195974565,CSE 291,E00,116474,Claffy; Kimberly Claire,0,0,0,0
1668195974565,CSE 291,F00,116479,Pasquale; Joseph,0,0,0,0
1668195975014,CSE 293,001,119111,Bafna; Vineet,9999,0,9999,0
1668195975014,CSE 293,002,119118,Bellare; Mihir,9999,0,9999,0
1668195975014,CSE 293,003,119122,Berg-Kirkpatrick; Taylor D,9999,0,9999,0
1668195975014,CSE 293,004,119135,Christensen; Henrik I,9999,0,9999,0
1668195975014,CSE 293,005,119142,Cottrell; Garrison W,9999,0,9999,0
1668195975014,CSE 293,006,119146,Deutsch; Alin Bernard,9999,0,9999,0
1668195975014,CSE 293,007,119159,Esmaeilzadeh; Hadi,9999,0,9999,0
1668195975014,CSE 293,008,119166,Freund; Yoav,9999,0,9999,0
1668195975014,CSE 293,009,119170,Griswold; William G.,9999,0,9999,0
1668195975014,CSE 293,010,119183,Gymrek; Melissa Ann,9999,0,9999,0
1668195975014,CSE 293,011,119190,Heninger; Nadia A,9999,0,9999,0
1668195975014,CSE 293,012,119230,Impagliazzo; Russell,9999,0,9999,0
1668195975014,CSE 293,013,119232,Jhala; Ranjit,9999,0,9999,0
1668195975014,CSE 293,014,119233,Kahng; Andrew Byun,9999,0,9999,0
1668195975014,CSE 293,015,119298,Kane; Daniel Mertz,9999,0,9999,0
1668195975014,CSE 293,016,119299,Kriegman; David J,9999,0,9999,0
1668195975014,CSE 293,017,119300,Kumar; Arun Kumar,9999,0,9999,0
1668195975014,CSE 293,018,119301,Lerner; Sorin,9999,0,9999,0
1668195975014,CSE 293,019,119302,Lovett; Shachar,9999,0,9999,0
1668195975014,CSE 293,020,119303,McAuley; Julian John,9999,0,9999,0
1668195975014,CSE 293,021,119304,Micciancio; Daniele,9999,0,9999,0
1668195975014,CSE 293,022,119367,Orailoglu; Alex,9999,0,9999,0
1668195975014,CSE 293,023,119382,Paturi; Ramamohan,9999,0,9999,0
1668195975014,CSE 293,024,119404,Polikarpova; Nadezhda,9999,0,9999,0
1668195975014,CSE 293,025,119406,Politz; Joseph Gibbs,9999,0,9999,0
1668195975014,CSE 293,026,119411,Porter; George M,9999,0,9999,0
1668195975014,CSE 293,027,119414,Porter; Leonard Emerson,9999,0,9999,0
1668195975014,CSE 293,028,119416,Ramamoorthi; Ravi,9999,0,9999,0
1668195975014,CSE 293,029,119417,Sahoo; Debashis,9999,0,9999,0
1668195975014,CSE 293,030,119420,Saul; Lawrence,9999,0,9999,0
1668195975014,CSE 293,031,119421,Savage; Stefan,9999,0,9999,0
1668195975014,CSE 293,032,119425,Schulze; Jurgen P.,9999,0,9999,0
1668195975014,CSE 293,033,119426,Snoeren; Alex C.,9999,0,9999,0
1668195975014,CSE 293,034,119428,Shang; Jingbo,9999,0,9999,0
1668195975014,CSE 293,035,119430,Stefan; Deian,9999,0,9999,0
1668195975014,CSE 293,036,119431,Su; Hao,9999,0,9999,0
1668195975014,CSE 293,037,119433,Swanson; Steven James,9999,0,9999,0
1668195975014,CSE 293,038,119435,Tullsen; Dean Michael,9999,0,9999,0
1668195975014,CSE 293,039,119483,Voelker; Geoffrey M.,9999,0,9999,0
1668195975014,CSE 293,040,119537,Zhao; Jishen,9999,0,9999,0
1668195975014,CSE 293,041,119538,Zhou; Yuan-Yuan,9999,0,9999,0
1668195975014,CSE 293,042,119539,Gao; Sicun,9999,0,9999,0
1668195975014,CSE 293,043,119540,Weibel; Nadir,9999,0,9999,0
1668195975014,CSE 293,044,119541,Gupta; Rajesh K.,9999,0,9999,0
1668195975014,CSE 293,045,126410,Vaccaro; Kristen Marie,9999,0,9999,0
1668195975014,CSE 293,046,126411,Klemke; Richard,9999,0,9999,0
1668195975446,CSE 294,A00,102459,Voelker; Geoffrey M.,0,0,0,0
1668195975446,CSE 294,B00,111322,Orailoglu; Alex,0,0,0,0
1668195975882,DSE 201,A00,096914,Deutsch; Alin Bernard,30,0,30,0
1668195976319,DSE 210,A00,096915,Dasgupta; Sanjoy,30,0,30,0
1668195976751,DSE 260A,A00,096916,Altintas De Callaf; Ilkay,30,0,30,0
1668195977187,ECE 200,001,103586,Antipa; Nicholas A,9999,0,9999,0
1668195977187,ECE 200,002,103587,Atanasov; Nikolay A.,9999,0,9999,0
1668195977187,ECE 200,003,103588,Bharadia; Dinesh,9999,0,9999,0
1668195977187,ECE 200,004,103589,Cheng; Chung Kuan,9999,0,9999,0
1668195977187,ECE 200,005,103590,Cosman; Pamela C.,9999,0,9999,0
1668195977187,ECE 200,006,103591,Dayeh; Shadi Ahmad,9999,0,9999,0
1668195977187,ECE 200,007,103592,Fainman; Yeshaiahu,9999,0,9999,0
1668195977187,ECE 200,008,103593,Ford; Joseph Earl,9999,0,9999,0
1668195977187,ECE 200,009,103594,Franceschetti; Massimo,9999,0,9999,0
1668195977187,ECE 200,010,103595,Fullerton; Eric E,9999,0,9999,0
1668195977187,ECE 200,011,103596,Galton; Ian A,9999,0,9999,0
1668195977187,ECE 200,012,103597,Gilja; Vikash,9999,0,9999,0
1668195977187,ECE 200,013,103598,Hall; Drew A.,9999,0,9999,0
1668195977187,ECE 200,014,103599,Hsueh; Tzu-Chien,9999,0,9999,0
1668195977187,ECE 200,015,103600,Javidi; Tara,9999,0,9999,0
1668195977187,ECE 200,016,103601,Kahng; Andrew Byun,9999,0,9999,0
1668195977187,ECE 200,017,103602,Kim; Young-Han,9999,0,9999,0
1668195977187,ECE 200,018,103603,Koushanfar; Farinaz,9999,0,9999,0
1668195977187,ECE 200,019,103604,Kuzum; Duygu,9999,0,9999,0
1668195977187,ECE 200,020,103605,Le; Hanh-Phuc,9999,0,9999,0
1668195977187,ECE 200,021,103606,Lin; Bill,9999,0,9999,0
1668195977187,ECE 200,022,103607,Liu; Zhaowei,9998,0,9999,1
1668195977187,ECE 200,023,103608,Lo; Yu-Hwa,9999,0,9999,0
1668195977187,ECE 200,024,103609,Lomakin; Vitaliy,9999,0,9999,0
1668195977187,ECE 200,025,103610,Mercier; Patrick Philip,9999,0,9999,0
1668195977187,ECE 200,026,103611,Meyer; Florian,9999,0,9999,0
1668195977187,ECE 200,027,103612,Milstein; Laurence B.,9999,0,9999,0
1668195977187,ECE 200,028,103613,Mir Arabbaygi; Siavash,9999,0,9999,0
1668195977187,ECE 200,029,103614,Mookherjea; Shayan,9999,0,9999,0
1668195977187,ECE 200,030,103615,Morris; Karcher William,9999,0,9999,0
1668195977187,ECE 200,031,103616,Ng; Tse Nga,9999,0,9999,0
1668195977187,ECE 200,032,103617,Nguyen; Truong Quang,9999,0,9999,0
1668195977187,ECE 200,033,103618,Nomura; Kenji,9999,0,9999,0
1668195977187,ECE 200,034,103619,Orlitsky; Alon,9999,0,9999,0
1668195977187,ECE 200,035,103620,Pal; Piya,9999,0,9999,0
1668195977187,ECE 200,036,103621,Papen; George C.,9999,0,9999,0
1668195977187,ECE 200,037,103622,Radic; Stojan,9999,0,9999,0
1668195977187,ECE 200,038,103623,Rao; Bhaskar D.,9999,0,9999,0
1668195977187,ECE 200,039,103624,Rao; Ramesh R,9999,0,9999,0
1668195977187,ECE 200,040,103625,Rebeiz; Gabriel,9999,0,9999,0
1668195977187,ECE 200,041,103626,Sanford; John R,9999,0,9999,0
1668195977187,ECE 200,042,103627,Siegel; Paul H.,9999,0,9999,0
1668195977187,ECE 200,043,103628,Sievenpiper; Daniel F.,9999,0,9999,0
1668195977187,ECE 200,044,103629,Sworder; David D.,9999,0,9999,0
1668195977187,ECE 200,045,103630,Taur; Yuan,9999,0,9999,0
1668195977187,ECE 200,046,103631,Touri; Behrouz,9999,0,9999,0
1668195977187,ECE 200,047,103632,Trivedi; Mohan M.,9999,0,9999,0
1668195977187,ECE 200,048,103633,Vasconcelos; Nuno,9999,0,9999,0
1668195977187,ECE 200,049,103634,Wang; Xiaolong,9999,0,9999,0
1668195977187,ECE 200,050,103635,Xie; Pengtao,9999,0,9999,0
1668195977187,ECE 200,051,103636,Yip; Michael,9999,0,9999,0
1668195977187,ECE 200,052,103637,Zeger; Kenneth A.,999,0,999,0
1668195977187,ECE 200,053,103638,Zhang; Xinyu,9999,0,9999,0
1668195977187,ECE 200,054,103639,Turakhia; Yatish Girish,9999,0,9999,0
1668195977187,ECE 200,055,103640,Kang; Mingu,9999,0,9999,0
1668195977187,ECE 200,056,103641,Shi; Yuanyuan,9999,0,9999,0
1668195977187,ECE 200,057,103642,Wang; Edward Jay,9999,0,9999,0
1668195977187,ECE 200,058,103643,Zheng; Yang,9999,0,9999,0
1668195977621,ECE 202,A00,103644,Kuzum; Duygu,0,0,0,0
1668195978055,ECE 212BN,A00,103646,Ng; Tse Nga,0,0,0,0
1668195978478,ECE 221,A00,111493,Staff,0,0,0,0
1668195978909,ECE 222B,A00,103647,Lomakin; Vitaliy,0,0,0,0
1668195979335,ECE 230B,A00,103648,Taur; Yuan,0,0,0,0
1668195979759,ECE 238B,A00,103649,Garay; Javier,0,0,0,0
1668195980190,ECE 240B,A00,112900,Fainman; Yeshaiahu,0,0,0,0
1668195980615,ECE 247A,A00,103650,Jokerst; Jesse Vincent,0,0,0,0
1668195981041,ECE 247B,A00,103651,Wang; Joseph,0,0,0,0
1668195981466,ECE 250,A00,103652,Siegel; Paul H.,0,0,0,0
1668195981888,ECE 251A,A00,103654,Rao; Bhaskar D.,0,0,0,0
1668195982313,ECE 257B,A00,103655,Bharadia; Dinesh,0,0,0,0
1668195982737,ECE 258A,A00,103656,Milstein; Laurence B.,0,0,0,0
1668195983162,ECE 260B,A00,103658,Kang; Mingu,0,0,0,0
1668195983598,ECE 264A,A00,103659,Galton; Ian A,0,0,0,0
1668195984045,ECE 265A,A00,103661,Gudem; Prasad S.S.,0,0,0,0
1668195984471,ECE 265D,A00,103662,Gudem; Prasad S.S.,0,0,0,0
1668195984893,ECE 268,A00,103663,Koushanfar; Farinaz,0,0,0,0
1668195985316,ECE 269,A01,103665,Pal; Piya,0,0,0,0
1668195985742,ECE 271B,A00,103666,Vasconcelos; Manuela,0,0,0,0
1668195986164,ECE 276A,A00,103667,Atanasov; Nikolay A.,0,0,0,0
1668195986604,ECE 277,A00,103668,An; Cheolhong,0,0,0,0
1668195987029,ECE 279,A00,117947,Hall; Drew A.,0,0,0,0
1668195987894,ECE 283,A00,103670,Hsueh; Tzu-Chien,0,0,0,0
1668195988326,ECE 284,A00,103671,Turakhia; Yatish Girish,0,0,0,0
1668195988766,ECE 285,A00,103672,Zheng; Yang,0,0,0,0
1668195988766,ECE 285,B00,103673,Sworder; David D.,0,0,0,0
1668195989190,ECE 287,A00,103676,Javidi; Tara,0,0,0,0
1668195989690,MATH 200B,A00,098023,Salehi Golsefidy; Alireza,12,0,15,3
1668195990125,MATH 202B,A00,098024,Rhoades; Brendon Patrick,9,0,15,6
1668195990556,MATH 203B,A00,098025,Oprea; Dragos N.,10,0,15,5
1668195990979,MATH 204B,A00,098026,Sorensen; Claus M,13,0,15,2
1668195991406,MATH 208,A00,098027,Izadi; Elham,7,0,10,3
1668195991839,MATH 209,A00,098028,Pollack; Aaron,10,0,10,0
1668195992280,MATH 211A,A00,112919,Rogalski; Daniel,9,0,10,1
1668195992711,MATH 211B,A00,112920,Seward; Brandon M.,9,0,10,1
1668195993134,MATH 218,A00,098029,Li; Bo,10,0,10,0
1668195993558,MATH 220B,A00,098030,Novak; Jonathan I,11,0,15,4
1668195993982,MATH 221A,A00,098031,Ebenfelt; Peter F,13,0,15,2
1668195994419,MATH 231B,A00,098032,Zlatos; Andrej,12,0,15,3
1668195994846,MATH 240B,A00,098033,Ni; Lei,9,0,15,6
1668195995270,MATH 243,A00,098034,Jekel; David Andrew,10,0,10,0
1668195995693,MATH 245A,A00,098035,Nie; Jiawang,0,0,15,16
1668195996116,MATH 248,A00,098036,Bejenaru; Ioan,10,0,10,0
1668195996538,MATH 250B,A00,098037,Spolaor; Luca,14,0,15,1
1668195996961,MATH 258,A00,098038,Ni; Lei,10,0,10,0
1668195997386,MATH 264B,A00,098041,Rhoades; Brendon Patrick,9,0,15,6
1668195997815,MATH 268,A00,098042,Buss; Samuel R,10,0,10,0
1668195998240,MATH 269,A00,098043,Rhoades; Brendon Patrick,10,0,10,0
1668195998664,MATH 270B,A00,098044,Li; Bo,10,0,15,5
1668195999101,MATH 272B,A00,098045,Holst; Michael J,13,0,15,2
1668195999526,MATH 273A,A00,098046,Tian; Xiaochuan,10,0,15,5
1668195999948,MATH 275,A01,098048,Tian; Xiaochuan,6,0,10,4
1668196000371,MATH 278A,A00,098049,Holst; Michael J,8,0,10,2
1668196000798,MATH 278B,A00,098050,Cloninger; Alexander,10,0,10,0
1668196001223,MATH 278C,A00,098051,Nie; Jiawang,7,0,10,3
1668196001650,MATH 280B,A00,098052,Zheng; Tianyi,10,0,15,5
1668196002073,MATH 281B,A00,098053,Bradic; Jelena,2,0,15,13
1668196002500,MATH 282B,A00,098054,Arias-Castro; Ery,0,0,15,15
1668196002923,MATH 285,A00,098055,Fitzsimmons; Patrick J,0,0,15,17
1668196003347,MATH 287B,A00,098056,Arias-Castro; Ery,2,0,15,13
1668196003771,MATH 288,A00,098057,Agarwal; Pooja,9,0,10,1
1668196003771,MATH 288,B00,098058,Zhang; Danna,8,0,10,2
1668196003771,MATH 288,C00,098059,Williams; Ruth J,10,0,10,0
1668196004194,MATH 290B,A00,098060,Roberts; Justin Deritter,13,0,15,2
1668196004621,MATH 292,A00,098061,Belmont; Eva Kinoshita,10,0,10,0
1668196005042,MATH 295,A00,098062,Suk; Andrew Hoon,48,0,50,2
1668196005482,MATH 296,A00,098063,Novak; Jonathan I,20,0,20,0
1668196005907,MATH 297,001,098064,Gamst; Anthony Collins,9997,0,9999,2
1668196507946,COGS 205,A00,101395,Chiba; Andrea,19,0,20,1
1668196508381,COGS 210B,001,101404,Greene; Deanna Jacquelyn,9998,0,9999,1
1668196508381,COGS 210B,002,101417,Xia; Haijun,9999,0,9999,0
1668196508381,COGS 210B,003,101422,Nitz; Douglas A.,9999,0,9999,0
1668196508381,COGS 210B,004,101423,Hollan; James D.,9998,0,9999,1
1668196508381,COGS 210B,005,101424,Deak; Gedeon O.,9998,0,9999,1
1668196508381,COGS 210B,006,101425,Rossano; Federico,9999,0,9999,0
1668196508803,COGS 211B,A00,101427,Coulson; Seana M,9996,0,9999,3
1668196509226,COGS 220,A00,101428,Hollan; James D.,0,0,25,25
1668196509651,COGS 229,A00,101429,Dow; Steven P,18,0,25,7
1668196510088,COGS 230,A00,101430,Klemmer; Scott R,12,0,17,5
1668196510518,COGS 234,A00,101431,Xia; Haijun,3,0,25,22
1668196510939,COGS 260,A00,101432,Kiyonaga; Anastasia,20,0,25,5
1668196510939,COGS 260,B00,101433,Kirsh; David Joel,16,0,25,9
1668196511363,CSE 202,A00,102371,Impagliazzo; Russell,0,0,0,0
1668196511867,CSE 203B,A01,102373,Cheng; Chung Kuan,0,0,0,0
1668196512310,CSE 208,A00,102374,Micciancio; Daniele,0,0,0,0
1668196512733,CSE 209A,A00,112895,Impagliazzo; Russell,0,0,15,15
1668196513162,CSE 209B,A00,108005,Bellare; Mihir,0,0,0,0
1668196513584,CSE 210,A00,113163,Coblenz; Michael J,0,0,0,0
1668196514010,CSE 219,A00,106111,Dow; Steven P,0,0,20,20
1668196514432,CSE 221,A00,102376,Voelker; Geoffrey M.,0,0,0,0
1668196514859,CSE 224,A01,102378,Porter; George M,0,0,0,0
1668196515285,CSE 229A,A00,102379,Savage; Stefan,0,0,0,0
1668196515708,CSE 229C,A00,102380,Munyaka; Imani N. S.,0,0,0,0
1668196516137,CSE 232B,A00,102382,Deutsch; Alin Bernard,0,0,0,0
1668196516569,CSE 234,A01,112904,Kumar; Arun Kumar,0,0,0,0
1668196516993,CSE 237A,A00,102383,Rosing; Tajana Simunic,0,0,0,0
1668196517435,CSE 239A,A00,102384,Deutsch; Alin Bernard,0,0,0,0
1668196517869,CSE 239B,A00,102385,Polikarpova; Nadezhda,0,0,0,0
1668196518301,CSE 240A,A00,102386,Pannuto; Patrick William,0,0,0,0
1668196518728,CSE 240B,A00,102387,Zhao; Jishen,0,0,0,0
1668196519165,CSE 241A,A00,106406,Kang; Mingu,0,0,0,0
1668196519616,CSE 249B,A00,102388,Kahng; Andrew Byun,0,0,8,8
1668196520043,CSE 251B,A01,102392,Cottrell; Garrison W,0,0,0,0
1668196520043,CSE 251B,A02,102393,Cottrell; Garrison W,0,0,0,0
1668196520464,CSE 252B,A00,102394,Ochoa; Benjamin Lawrence,0,0,0,0
1668196520889,CSE 257,A01,102396,Gao; Sicun,0,0,0,0
1668196521314,CSE 272,A00,102397,Li; Tzumao,0,0,0,0
1668196521737,CSE 274,A00,111323,Chern; Albert Ren-Haur,0,0,0,0
1668196522174,CSE 282,A00,102398,Pevzner; Pavel Arkadjevich,0,0,0,0
1668196522598,CSE 284,A00,114175,Gymrek; Melissa Ann,0,0,0,0
1668196523022,CSE 290,A00,102399,Chandraker; Manmohan Krishna,0,0,0,0
1668196523022,CSE 290,B00,102400,Vaccaro; Kristen Marie,0,0,25,25
1668196523022,CSE 290,C00,102414,Pannuto; Patrick William,0,0,25,25
1668196523022,CSE 290,D00,102427,Pevzner; Pavel Arkadjevich,0,0,0,0
1668196523022,CSE 290,E00,102429,Zhao; Jishen,0,0,0,0
1668196523022,CSE 290,F00,102436,Tullsen; Dean Michael,0,0,0,0
1668196523022,CSE 290,G00,102440,Christensen; Henrik I,0,0,20,20
1668196523452,CSE 291,A00,102443,Su; Hao,0,0,0,0
1668196523452,CSE 291,B00,102448,Polikarpova; Nadezhda,0,0,0,0
1668196523452,CSE 291,C00,102453,Vaccaro; Kristen Marie,0,0,0,0
1668196523452,CSE 291,D00,111343,Savage; Stefan,0,0,0,0
1668196523452,CSE 291,E00,116474,Claffy; Kimberly Claire,0,0,0,0
1668196523452,CSE 291,F00,116479,Pasquale; Joseph,0,0,0,0
1668196523879,CSE 293,001,119111,Bafna; Vineet,9999,0,9999,0
1668196523879,CSE 293,002,119118,Bellare; Mihir,9999,0,9999,0
1668196523879,CSE 293,003,119122,Berg-Kirkpatrick; Taylor D,9999,0,9999,0
1668196523879,CSE 293,004,119135,Christensen; Henrik I,9999,0,9999,0
1668196523879,CSE 293,005,119142,Cottrell; Garrison W,9999,0,9999,0
1668196523879,CSE 293,006,119146,Deutsch; Alin Bernard,9999,0,9999,0
1668196523879,CSE 293,007,119159,Esmaeilzadeh; Hadi,9999,0,9999,0
1668196523879,CSE 293,008,119166,Freund; Yoav,9999,0,9999,0
1668196523879,CSE 293,009,119170,Griswold; William G.,9999,0,9999,0
1668196523879,CSE 293,010,119183,Gymrek; Melissa Ann,9999,0,9999,0
1668196523879,CSE 293,011,119190,Heninger; Nadia A,9999,0,9999,0
1668196523879,CSE 293,012,119230,Impagliazzo; Russell,9999,0,9999,0
1668196523879,CSE 293,013,119232,Jhala; Ranjit,9999,0,9999,0
1668196523879,CSE 293,014,119233,Kahng; Andrew Byun,9999,0,9999,0
1668196523879,CSE 293,015,119298,Kane; Daniel Mertz,9999,0,9999,0
1668196523879,CSE 293,016,119299,Kriegman; David J,9999,0,9999,0
1668196523879,CSE 293,017,119300,Kumar; Arun Kumar,9999,0,9999,0
1668196523879,CSE 293,018,119301,Lerner; Sorin,9999,0,9999,0
1668196523879,CSE 293,019,119302,Lovett; Shachar,9999,0,9999,0
1668196523879,CSE 293,020,119303,McAuley; Julian John,9999,0,9999,0
1668196523879,CSE 293,021,119304,Micciancio; Daniele,9999,0,9999,0
1668196523879,CSE 293,022,119367,Orailoglu; Alex,9999,0,9999,0
1668196523879,CSE 293,023,119382,Paturi; Ramamohan,9999,0,9999,0
1668196523879,CSE 293,024,119404,Polikarpova; Nadezhda,9999,0,9999,0
1668196523879,CSE 293,025,119406,Politz; Joseph Gibbs,9999,0,9999,0
1668196523879,CSE 293,026,119411,Porter; George M,9999,0,9999,0
1668196523879,CSE 293,027,119414,Porter; Leonard Emerson,9999,0,9999,0
1668196523879,CSE 293,028,119416,Ramamoorthi; Ravi,9999,0,9999,0
1668196523879,CSE 293,029,119417,Sahoo; Debashis,9999,0,9999,0
1668196523879,CSE 293,030,119420,Saul; Lawrence,9999,0,9999,0
1668196523879,CSE 293,031,119421,Savage; Stefan,9999,0,9999,0
1668196523879,CSE 293,032,119425,Schulze; Jurgen P.,9999,0,9999,0
1668196523879,CSE 293,033,119426,Snoeren; Alex C.,9999,0,9999,0
1668196523879,CSE 293,034,119428,Shang; Jingbo,9999,0,9999,0
1668196523879,CSE 293,035,119430,Stefan; Deian,9999,0,9999,0
1668196523879,CSE 293,036,119431,Su; Hao,9999,0,9999,0
1668196523879,CSE 293,037,119433,Swanson; Steven James,9999,0,9999,0
1668196523879,CSE 293,038,119435,Tullsen; Dean Michael,9999,0,9999,0
1668196523879,CSE 293,039,119483,Voelker; Geoffrey M.,9999,0,9999,0
1668196523879,CSE 293,040,119537,Zhao; Jishen,9999,0,9999,0
1668196523879,CSE 293,041,119538,Zhou; Yuan-Yuan,9999,0,9999,0
1668196523879,CSE 293,042,119539,Gao; Sicun,9999,0,9999,0
1668196523879,CSE 293,043,119540,Weibel; Nadir,9999,0,9999,0
1668196523879,CSE 293,044,119541,Gupta; Rajesh K.,9999,0,9999,0
1668196523879,CSE 293,045,126410,Vaccaro; Kristen Marie,9999,0,9999,0
1668196523879,CSE 293,046,126411,Klemke; Richard,9999,0,9999,0
1668196524305,CSE 294,A00,102459,Voelker; Geoffrey M.,0,0,0,0
1668196524305,CSE 294,B00,111322,Orailoglu; Alex,0,0,0,0
1668196524728,DSE 201,A00,096914,Deutsch; Alin Bernard,30,0,30,0
1668196525149,DSE 210,A00,096915,Dasgupta; Sanjoy,30,0,30,0
1668196525573,DSE 260A,A00,096916,Altintas De Callaf; Ilkay,30,0,30,0
1668196526010,ECE 200,001,103586,Antipa; Nicholas A,9999,0,9999,0
1668196526010,ECE 200,002,103587,Atanasov; Nikolay A.,9999,0,9999,0
1668196526010,ECE 200,003,103588,Bharadia; Dinesh,9999,0,9999,0
1668196526010,ECE 200,004,103589,Cheng; Chung Kuan,9999,0,9999,0
1668196526010,ECE 200,005,103590,Cosman; Pamela C.,9999,0,9999,0
1668196526010,ECE 200,006,103591,Dayeh; Shadi Ahmad,9999,0,9999,0
1668196526010,ECE 200,007,103592,Fainman; Yeshaiahu,9999,0,9999,0
1668196526010,ECE 200,008,103593,Ford; Joseph Earl,9999,0,9999,0
1668196526010,ECE 200,009,103594,Franceschetti; Massimo,9999,0,9999,0
1668196526010,ECE 200,010,103595,Fullerton; Eric E,9999,0,9999,0
1668196526010,ECE 200,011,103596,Galton; Ian A,9999,0,9999,0
1668196526010,ECE 200,012,103597,Gilja; Vikash,9999,0,9999,0
1668196526010,ECE 200,013,103598,Hall; Drew A.,9999,0,9999,0
1668196526010,ECE 200,014,103599,Hsueh; Tzu-Chien,9999,0,9999,0
1668196526010,ECE 200,015,103600,Javidi; Tara,9999,0,9999,0
1668196526010,ECE 200,016,103601,Kahng; Andrew Byun,9999,0,9999,0
1668196526010,ECE 200,017,103602,Kim; Young-Han,9999,0,9999,0
1668196526010,ECE 200,018,103603,Koushanfar; Farinaz,9999,0,9999,0
1668196526010,ECE 200,019,103604,Kuzum; Duygu,9999,0,9999,0
1668196526010,ECE 200,020,103605,Le; Hanh-Phuc,9999,0,9999,0
1668196526010,ECE 200,021,103606,Lin; Bill,9999,0,9999,0
1668196526010,ECE 200,022,103607,Liu; Zhaowei,9998,0,9999,1
1668196526010,ECE 200,023,103608,Lo; Yu-Hwa,9999,0,9999,0
1668196526010,ECE 200,024,103609,Lomakin; Vitaliy,9999,0,9999,0
1668196526010,ECE 200,025,103610,Mercier; Patrick Philip,9999,0,9999,0
1668196526010,ECE 200,026,103611,Meyer; Florian,9999,0,9999,0
1668196526010,ECE 200,027,103612,Milstein; Laurence B.,9999,0,9999,0
1668196526010,ECE 200,028,103613,Mir Arabbaygi; Siavash,9999,0,9999,0
1668196526010,ECE 200,029,103614,Mookherjea; Shayan,9999,0,9999,0
1668196526010,ECE 200,030,103615,Morris; Karcher William,9999,0,9999,0
1668196526010,ECE 200,031,103616,Ng; Tse Nga,9999,0,9999,0
1668196526010,ECE 200,032,103617,Nguyen; Truong Quang,9999,0,9999,0
1668196526010,ECE 200,033,103618,Nomura; Kenji,9999,0,9999,0
1668196526010,ECE 200,034,103619,Orlitsky; Alon,9999,0,9999,0
1668196526010,ECE 200,035,103620,Pal; Piya,9999,0,9999,0
1668196526010,ECE 200,036,103621,Papen; George C.,9999,0,9999,0
1668196526010,ECE 200,037,103622,Radic; Stojan,9999,0,9999,0
1668196526010,ECE 200,038,103623,Rao; Bhaskar D.,9999,0,9999,0
1668196526010,ECE 200,039,103624,Rao; Ramesh R,9999,0,9999,0
1668196526010,ECE 200,040,103625,Rebeiz; Gabriel,9999,0,9999,0
1668196526010,ECE 200,041,103626,Sanford; John R,9999,0,9999,0
1668196526010,ECE 200,042,103627,Siegel; Paul H.,9999,0,9999,0
1668196526010,ECE 200,043,103628,Sievenpiper; Daniel F.,9999,0,9999,0
1668196526010,ECE 200,044,103629,Sworder; David D.,9999,0,9999,0
1668196526010,ECE 200,045,103630,Taur; Yuan,9999,0,9999,0
1668196526010,ECE 200,046,103631,Touri; Behrouz,9999,0,9999,0
1668196526010,ECE 200,047,103632,Trivedi; Mohan M.,9999,0,9999,0
1668196526010,ECE 200,048,103633,Vasconcelos; Nuno,9999,0,9999,0
1668196526010,ECE 200,049,103634,Wang; Xiaolong,9999,0,9999,0
1668196526010,ECE 200,050,103635,Xie; Pengtao,9999,0,9999,0
1668196526010,ECE 200,051,103636,Yip; Michael,9999,0,9999,0
1668196526010,ECE 200,052,103637,Zeger; Kenneth A.,999,0,999,0
1668196526010,ECE 200,053,103638,Zhang; Xinyu,9999,0,9999,0
1668196526010,ECE 200,054,103639,Turakhia; Yatish Girish,9999,0,9999,0
1668196526010,ECE 200,055,103640,Kang; Mingu,9999,0,9999,0
1668196526010,ECE 200,056,103641,Shi; Yuanyuan,9999,0,9999,0
1668196526010,ECE 200,057,103642,Wang; Edward Jay,9999,0,9999,0
1668196526010,ECE 200,058,103643,Zheng; Yang,9999,0,9999,0
1668196526448,ECE 202,A00,103644,Kuzum; Duygu,0,0,0,0
1668196526872,ECE 212BN,A00,103646,Ng; Tse Nga,0,0,0,0
1668196527305,ECE 221,A00,111493,Staff,0,0,0,0
1668196527734,ECE 222B,A00,103647,Lomakin; Vitaliy,0,0,0,0
1668196528162,ECE 230B,A00,103648,Taur; Yuan,0,0,0,0
1668196528585,ECE 238B,A00,103649,Garay; Javier,0,0,0,0
1668196529031,ECE 240B,A00,112900,Fainman; Yeshaiahu,0,0,0,0
1668196529456,ECE 247A,A00,103650,Jokerst; Jesse Vincent,0,0,0,0
1668196529880,ECE 247B,A00,103651,Wang; Joseph,0,0,0,0
1668196530315,ECE 250,A00,103652,Siegel; Paul H.,0,0,0,0
1668196530741,ECE 251A,A00,103654,Rao; Bhaskar D.,0,0,0,0
1668196531173,ECE 257B,A00,103655,Bharadia; Dinesh,0,0,0,0
1668196531600,ECE 258A,A00,103656,Milstein; Laurence B.,0,0,0,0
1668196532027,ECE 260B,A00,103658,Kang; Mingu,0,0,0,0
1668196532451,ECE 264A,A00,103659,Galton; Ian A,0,0,0,0
1668196532885,ECE 265A,A00,103661,Gudem; Prasad S.S.,0,0,0,0
1668196533314,ECE 265D,A00,103662,Gudem; Prasad S.S.,0,0,0,0
1668196533740,ECE 268,A00,103663,Koushanfar; Farinaz,0,0,0,0
1668196534182,ECE 269,A01,103665,Pal; Piya,0,0,0,0
1668196534606,ECE 271B,A00,103666,Vasconcelos; Manuela,0,0,0,0
1668196535036,ECE 276A,A00,103667,Atanasov; Nikolay A.,0,0,0,0
1668196535463,ECE 277,A00,103668,An; Cheolhong,0,0,0,0
1668196535891,ECE 279,A00,117947,Hall; Drew A.,0,0,0,0
1668196536746,ECE 283,A00,103670,Hsueh; Tzu-Chien,0,0,0,0
1668196537173,ECE 284,A00,103671,Turakhia; Yatish Girish,0,0,0,0
1668196537597,ECE 285,A00,103672,Zheng; Yang,0,0,0,0
1668196537597,ECE 285,B00,103673,Sworder; David D.,0,0,0,0
1668196538020,ECE 287,A00,103676,Javidi; Tara,0,0,0,0
1668196538458,MATH 200B,A00,098023,Salehi Golsefidy; Alireza,12,0,15,3
1668196538883,MATH 202B,A00,098024,Rhoades; Brendon Patrick,9,0,15,6
1668196539305,MATH 203B,A00,098025,Oprea; Dragos N.,10,0,15,5
1668196539735,MATH 204B,A00,098026,Sorensen; Claus M,13,0,15,2
1668196540166,MATH 208,A00,098027,Izadi; Elham,7,0,10,3
1668196540607,MATH 209,A00,098028,Pollack; Aaron,10,0,10,0
1668196541029,MATH 211A,A00,112919,Rogalski; Daniel,9,0,10,1
1668196541449,MATH 211B,A00,112920,Seward; Brandon M.,9,0,10,1
1668196541889,MATH 218,A00,098029,Li; Bo,10,0,10,0
1668196542315,MATH 220B,A00,098030,Novak; Jonathan I,11,0,15,4
1668196542738,MATH 221A,A00,098031,Ebenfelt; Peter F,13,0,15,2
1668196543175,MATH 231B,A00,098032,Zlatos; Andrej,12,0,15,3
1668196543600,MATH 240B,A00,098033,Ni; Lei,9,0,15,6
1668196544026,MATH 243,A00,098034,Jekel; David Andrew,10,0,10,0
1668196544452,MATH 245A,A00,098035,Nie; Jiawang,0,0,15,16
1668196544886,MATH 248,A00,098036,Bejenaru; Ioan,10,0,10,0
1668196545310,MATH 250B,A00,098037,Spolaor; Luca,14,0,15,1
1668196545730,MATH 258,A00,098038,Ni; Lei,10,0,10,0
1668196546156,MATH 264B,A00,098041,Rhoades; Brendon Patrick,9,0,15,6
1668196546585,MATH 268,A00,098042,Buss; Samuel R,10,0,10,0
1668196547009,MATH 269,A00,098043,Rhoades; Brendon Patrick,10,0,10,0
1668196547435,MATH 270B,A00,098044,Li; Bo,10,0,15,5
1668196547860,MATH 272B,A00,098045,Holst; Michael J,13,0,15,2
1668196548283,MATH 273A,A00,098046,Tian; Xiaochuan,10,0,15,5
1668196548706,MATH 275,A01,098048,Tian; Xiaochuan,6,0,10,4
1668196549135,MATH 278A,A00,098049,Holst; Michael J,8,0,10,2
1668196549560,MATH 278B,A00,098050,Cloninger; Alexander,10,0,10,0
1668196549986,MATH 278C,A00,098051,Nie; Jiawang,7,0,10,3
1668196550413,MATH 280B,A00,098052,Zheng; Tianyi,10,0,15,5
1668196550839,MATH 281B,A00,098053,Bradic; Jelena,2,0,15,13
1668196551262,MATH 282B,A00,098054,Arias-Castro; Ery,0,0,15,15
1668196551686,MATH 285,A00,098055,Fitzsimmons; Patrick J,0,0,15,17
1668196552114,MATH 287B,A00,098056,Arias-Castro; Ery,2,0,15,13
1668196552539,MATH 288,A00,098057,Agarwal; Pooja,9,0,10,1
1668196552539,MATH 288,B00,098058,Zhang; Danna,8,0,10,2
1668196552539,MATH 288,C00,098059,Williams; Ruth J,10,0,10,0
1668196552962,MATH 290B,A00,098060,Roberts; Justin Deritter,13,0,15,2
1668196553391,MATH 292,A00,098061,Belmont; Eva Kinoshita,10,0,10,0
1668196553813,MATH 295,A00,098062,Suk; Andrew Hoon,48,0,50,2
1668196554239,MATH 296,A00,098063,Novak; Jonathan I,20,0,20,0
1668196554662,MATH 297,001,098064,Gamst; Anthony Collins,9997,0,9999,2
1668197058546,COGS 205,A00,101395,Chiba; Andrea,19,0,20,1
1668197058990,COGS 210B,001,101404,Greene; Deanna Jacquelyn,9998,0,9999,1
1668197058990,COGS 210B,002,101417,Xia; Haijun,9999,0,9999,0
1668197058990,COGS 210B,003,101422,Nitz; Douglas A.,9999,0,9999,0
1668197058990,COGS 210B,004,101423,Hollan; James D.,9998,0,9999,1
1668197058990,COGS 210B,005,101424,Deak; Gedeon O.,9998,0,9999,1
1668197058990,COGS 210B,006,101425,Rossano; Federico,9999,0,9999,0
1668197059413,COGS 211B,A00,101427,Coulson; Seana M,9996,0,9999,3
1668197059835,COGS 220,A00,101428,Hollan; James D.,0,0,25,25
1668197060261,COGS 229,A00,101429,Dow; Steven P,18,0,25,7
1668197060685,COGS 230,A00,101430,Klemmer; Scott R,12,0,17,5
1668197061107,COGS 234,A00,101431,Xia; Haijun,3,0,25,22
1668197061533,COGS 260,A00,101432,Kiyonaga; Anastasia,20,0,25,5
1668197061533,COGS 260,B00,101433,Kirsh; David Joel,16,0,25,9
1668197061959,CSE 202,A00,102371,Impagliazzo; Russell,0,0,0,0
1668197062384,CSE 203B,A01,102373,Cheng; Chung Kuan,0,0,0,0
1668197062809,CSE 208,A00,102374,Micciancio; Daniele,0,0,0,0
1668197063232,CSE 209A,A00,112895,Impagliazzo; Russell,0,0,15,15
1668197063679,CSE 209B,A00,108005,Bellare; Mihir,0,0,0,0
1668197064103,CSE 210,A00,113163,Coblenz; Michael J,0,0,0,0
1668197064531,CSE 219,A00,106111,Dow; Steven P,0,0,20,20
1668197064956,CSE 221,A00,102376,Voelker; Geoffrey M.,0,0,0,0
1668197065382,CSE 224,A01,102378,Porter; George M,0,0,0,0
1668197065807,CSE 229A,A00,102379,Savage; Stefan,0,0,0,0
1668197066246,CSE 229C,A00,102380,Munyaka; Imani N. S.,0,0,0,0
1668197066670,CSE 232B,A00,102382,Deutsch; Alin Bernard,0,0,0,0
1668197067106,CSE 234,A01,112904,Kumar; Arun Kumar,0,0,0,0
1668197067529,CSE 237A,A00,102383,Rosing; Tajana Simunic,0,0,0,0
1668197067954,CSE 239A,A00,102384,Deutsch; Alin Bernard,0,0,0,0
1668197068407,CSE 239B,A00,102385,Polikarpova; Nadezhda,0,0,0,0
1668197068837,CSE 240A,A00,102386,Pannuto; Patrick William,0,0,0,0
1668197069283,CSE 240B,A00,102387,Zhao; Jishen,0,0,0,0
1668197069706,CSE 241A,A00,106406,Kang; Mingu,0,0,0,0
1668197070142,CSE 249B,A00,102388,Kahng; Andrew Byun,0,0,8,8
1668197070566,CSE 251B,A01,102392,Cottrell; Garrison W,0,0,0,0
1668197070566,CSE 251B,A02,102393,Cottrell; Garrison W,0,0,0,0
1668197070992,CSE 252B,A00,102394,Ochoa; Benjamin Lawrence,0,0,0,0
1668197071420,CSE 257,A01,102396,Gao; Sicun,0,0,0,0
1668197071844,CSE 272,A00,102397,Li; Tzumao,0,0,0,0
1668197072268,CSE 274,A00,111323,Chern; Albert Ren-Haur,0,0,0,0
1668197072695,CSE 282,A00,102398,Pevzner; Pavel Arkadjevich,0,0,0,0
1668197073123,CSE 284,A00,114175,Gymrek; Melissa Ann,0,0,0,0
1668197073550,CSE 290,A00,102399,Chandraker; Manmohan Krishna,0,0,0,0
1668197073550,CSE 290,B00,102400,Vaccaro; Kristen Marie,0,0,25,25
1668197073550,CSE 290,C00,102414,Pannuto; Patrick William,0,0,25,25
1668197073550,CSE 290,D00,102427,Pevzner; Pavel Arkadjevich,0,0,0,0
1668197073550,CSE 290,E00,102429,Zhao; Jishen,0,0,0,0
1668197073550,CSE 290,F00,102436,Tullsen; Dean Michael,0,0,0,0
1668197073550,CSE 290,G00,102440,Christensen; Henrik I,0,0,20,20
1668197073982,CSE 291,A00,102443,Su; Hao,0,0,0,0
1668197073982,CSE 291,B00,102448,Polikarpova; Nadezhda,0,0,0,0
1668197073982,CSE 291,C00,102453,Vaccaro; Kristen Marie,0,0,0,0
1668197073982,CSE 291,D00,111343,Savage; Stefan,0,0,0,0
1668197073982,CSE 291,E00,116474,Claffy; Kimberly Claire,0,0,0,0
1668197073982,CSE 291,F00,116479,Pasquale; Joseph,0,0,0,0
1668197074419,CSE 293,001,119111,Bafna; Vineet,9999,0,9999,0
1668197074419,CSE 293,002,119118,Bellare; Mihir,9999,0,9999,0
1668197074419,CSE 293,003,119122,Berg-Kirkpatrick; Taylor D,9999,0,9999,0
1668197074419,CSE 293,004,119135,Christensen; Henrik I,9999,0,9999,0
1668197074419,CSE 293,005,119142,Cottrell; Garrison W,9999,0,9999,0
1668197074419,CSE 293,006,119146,Deutsch; Alin Bernard,9999,0,9999,0
1668197074419,CSE 293,007,119159,Esmaeilzadeh; Hadi,9999,0,9999,0
1668197074419,CSE 293,008,119166,Freund; Yoav,9999,0,9999,0
1668197074419,CSE 293,009,119170,Griswold; William G.,9999,0,9999,0
1668197074419,CSE 293,010,119183,Gymrek; Melissa Ann,9999,0,9999,0
1668197074419,CSE 293,011,119190,Heninger; Nadia A,9999,0,9999,0
1668197074419,CSE 293,012,119230,Impagliazzo; Russell,9999,0,9999,0
1668197074419,CSE 293,013,119232,Jhala; Ranjit,9999,0,9999,0
1668197074419,CSE 293,014,119233,Kahng; Andrew Byun,9999,0,9999,0
1668197074419,CSE 293,015,119298,Kane; Daniel Mertz,9999,0,9999,0
1668197074419,CSE 293,016,119299,Kriegman; David J,9999,0,9999,0
1668197074419,CSE 293,017,119300,Kumar; Arun Kumar,9999,0,9999,0
1668197074419,CSE 293,018,119301,Lerner; Sorin,9999,0,9999,0
1668197074419,CSE 293,019,119302,Lovett; Shachar,9999,0,9999,0
1668197074419,CSE 293,020,119303,McAuley; Julian John,9999,0,9999,0
1668197074419,CSE 293,021,119304,Micciancio; Daniele,9999,0,9999,0
1668197074419,CSE 293,022,119367,Orailoglu; Alex,9999,0,9999,0
1668197074419,CSE 293,023,119382,Paturi; Ramamohan,9999,0,9999,0
1668197074419,CSE 293,024,119404,Polikarpova; Nadezhda,9999,0,9999,0
1668197074419,CSE 293,025,119406,Politz; Joseph Gibbs,9999,0,9999,0
1668197074419,CSE 293,026,119411,Porter; George M,9999,0,9999,0
1668197074419,CSE 293,027,119414,Porter; Leonard Emerson,9999,0,9999,0
1668197074419,CSE 293,028,119416,Ramamoorthi; Ravi,9999,0,9999,0
1668197074419,CSE 293,029,119417,Sahoo; Debashis,9999,0,9999,0
1668197074419,CSE 293,030,119420,Saul; Lawrence,9999,0,9999,0
1668197074419,CSE 293,031,119421,Savage; Stefan,9999,0,9999,0
1668197074419,CSE 293,032,119425,Schulze; Jurgen P.,9999,0,9999,0
1668197074419,CSE 293,033,119426,Snoeren; Alex C.,9999,0,9999,0
1668197074419,CSE 293,034,119428,Shang; Jingbo,9999,0,9999,0
1668197074419,CSE 293,035,119430,Stefan; Deian,9999,0,9999,0
1668197074419,CSE 293,036,119431,Su; Hao,9999,0,9999,0
1668197074419,CSE 293,037,119433,Swanson; Steven James,9999,0,9999,0
1668197074419,CSE 293,038,119435,Tullsen; Dean Michael,9999,0,9999,0
1668197074419,CSE 293,039,119483,Voelker; Geoffrey M.,9999,0,9999,0
1668197074419,CSE 293,040,119537,Zhao; Jishen,9999,0,9999,0
1668197074419,CSE 293,041,119538,Zhou; Yuan-Yuan,9999,0,9999,0
1668197074419,CSE 293,042,119539,Gao; Sicun,9999,0,9999,0
1668197074419,CSE 293,043,119540,Weibel; Nadir,9999,0,9999,0
1668197074419,CSE 293,044,119541,Gupta; Rajesh K.,9999,0,9999,0
1668197074419,CSE 293,045,126410,Vaccaro; Kristen Marie,9999,0,9999,0
1668197074419,CSE 293,046,126411,Klemke; Richard,9999,0,9999,0
1668197074842,CSE 294,A00,102459,Voelker; Geoffrey M.,0,0,0,0
1668197074842,CSE 294,B00,111322,Orailoglu; Alex,0,0,0,0
1668197075264,DSE 201,A00,096914,Deutsch; Alin Bernard,30,0,30,0
1668197075694,DSE 210,A00,096915,Dasgupta; Sanjoy,30,0,30,0
1668197076124,DSE 260A,A00,096916,Altintas De Callaf; Ilkay,30,0,30,0
1668197076553,ECE 200,001,103586,Antipa; Nicholas A,9999,0,9999,0
1668197076553,ECE 200,002,103587,Atanasov; Nikolay A.,9999,0,9999,0
1668197076553,ECE 200,003,103588,Bharadia; Dinesh,9999,0,9999,0
1668197076553,ECE 200,004,103589,Cheng; Chung Kuan,9999,0,9999,0
1668197076553,ECE 200,005,103590,Cosman; Pamela C.,9999,0,9999,0
1668197076553,ECE 200,006,103591,Dayeh; Shadi Ahmad,9999,0,9999,0
1668197076553,ECE 200,007,103592,Fainman; Yeshaiahu,9999,0,9999,0
1668197076553,ECE 200,008,103593,Ford; Joseph Earl,9999,0,9999,0
1668197076553,ECE 200,009,103594,Franceschetti; Massimo,9999,0,9999,0
1668197076553,ECE 200,010,103595,Fullerton; Eric E,9999,0,9999,0
1668197076553,ECE 200,011,103596,Galton; Ian A,9999,0,9999,0
1668197076553,ECE 200,012,103597,Gilja; Vikash,9999,0,9999,0
1668197076553,ECE 200,013,103598,Hall; Drew A.,9999,0,9999,0
1668197076553,ECE 200,014,103599,Hsueh; Tzu-Chien,9999,0,9999,0
1668197076553,ECE 200,015,103600,Javidi; Tara,9999,0,9999,0
1668197076553,ECE 200,016,103601,Kahng; Andrew Byun,9999,0,9999,0
1668197076553,ECE 200,017,103602,Kim; Young-Han,9999,0,9999,0
1668197076553,ECE 200,018,103603,Koushanfar; Farinaz,9999,0,9999,0
1668197076553,ECE 200,019,103604,Kuzum; Duygu,9999,0,9999,0
1668197076553,ECE 200,020,103605,Le; Hanh-Phuc,9999,0,9999,0
1668197076553,ECE 200,021,103606,Lin; Bill,9999,0,9999,0
1668197076553,ECE 200,022,103607,Liu; Zhaowei,9998,0,9999,1
1668197076553,ECE 200,023,103608,Lo; Yu-Hwa,9999,0,9999,0
1668197076553,ECE 200,024,103609,Lomakin; Vitaliy,9999,0,9999,0
1668197076553,ECE 200,025,103610,Mercier; Patrick Philip,9999,0,9999,0
1668197076553,ECE 200,026,103611,Meyer; Florian,9999,0,9999,0
1668197076553,ECE 200,027,103612,Milstein; Laurence B.,9999,0,9999,0
1668197076553,ECE 200,028,103613,Mir Arabbaygi; Siavash,9999,0,9999,0
1668197076553,ECE 200,029,103614,Mookherjea; Shayan,9999,0,9999,0
1668197076553,ECE 200,030,103615,Morris; Karcher William,9999,0,9999,0
1668197076553,ECE 200,031,103616,Ng; Tse Nga,9999,0,9999,0
1668197076553,ECE 200,032,103617,Nguyen; Truong Quang,9999,0,9999,0
1668197076553,ECE 200,033,103618,Nomura; Kenji,9999,0,9999,0
1668197076553,ECE 200,034,103619,Orlitsky; Alon,9999,0,9999,0
1668197076553,ECE 200,035,103620,Pal; Piya,9999,0,9999,0
1668197076553,ECE 200,036,103621,Papen; George C.,9999,0,9999,0
1668197076553,ECE 200,037,103622,Radic; Stojan,9999,0,9999,0
1668197076553,ECE 200,038,103623,Rao; Bhaskar D.,9999,0,9999,0
1668197076553,ECE 200,039,103624,Rao; Ramesh R,9999,0,9999,0
1668197076553,ECE 200,040,103625,Rebeiz; Gabriel,9999,0,9999,0
1668197076553,ECE 200,041,103626,Sanford; John R,9999,0,9999,0
1668197076553,ECE 200,042,103627,Siegel; Paul H.,9999,0,9999,0
1668197076553,ECE 200,043,103628,Sievenpiper; Daniel F.,9999,0,9999,0
1668197076553,ECE 200,044,103629,Sworder; David D.,9999,0,9999,0
1668197076553,ECE 200,045,103630,Taur; Yuan,9999,0,9999,0
1668197076553,ECE 200,046,103631,Touri; Behrouz,9999,0,9999,0
1668197076553,ECE 200,047,103632,Trivedi; Mohan M.,9999,0,9999,0
1668197076553,ECE 200,048,103633,Vasconcelos; Nuno,9999,0,9999,0
1668197076553,ECE 200,049,103634,Wang; Xiaolong,9999,0,9999,0
1668197076553,ECE 200,050,103635,Xie; Pengtao,9999,0,9999,0
1668197076553,ECE 200,051,103636,Yip; Michael,9999,0,9999,0
1668197076553,ECE 200,052,103637,Zeger; Kenneth A.,999,0,999,0
1668197076553,ECE 200,053,103638,Zhang; Xinyu,9999,0,9999,0
1668197076553,ECE 200,054,103639,Turakhia; Yatish Girish,9999,0,9999,0
1668197076553,ECE 200,055,103640,Kang; Mingu,9999,0,9999,0
1668197076553,ECE 200,056,103641,Shi; Yuanyuan,9999,0,9999,0
1668197076553,ECE 200,057,103642,Wang; Edward Jay,9999,0,9999,0
1668197076553,ECE 200,058,103643,Zheng; Yang,9999,0,9999,0
1668197076977,ECE 202,A00,103644,Kuzum; Duygu,0,0,0,0
1668197077399,ECE 212BN,A00,103646,Ng; Tse Nga,0,0,0,0
1668197077823,ECE 221,A00,111493,Staff,0,0,0,0
1668197078247,ECE 222B,A00,103647,Lomakin; Vitaliy,0,0,0,0
1668197078682,ECE 230B,A00,103648,Taur; Yuan,0,0,0,0
1668197079204,ECE 238B,A00,103649,Garay; Javier,0,0,0,0
1668197079629,ECE 240B,A00,112900,Fainman; Yeshaiahu,0,0,0,0
1668197080053,ECE 247A,A00,103650,Jokerst; Jesse Vincent,0,0,0,0
1668197080483,ECE 247B,A00,103651,Wang; Joseph,0,0,0,0
1668197080910,ECE 250,A00,103652,Siegel; Paul H.,0,0,0,0
1668197081353,ECE 251A,A00,103654,Rao; Bhaskar D.,0,0,0,0
1668197081776,ECE 257B,A00,103655,Bharadia; Dinesh,0,0,0,0
1668197082204,ECE 258A,A00,103656,Milstein; Laurence B.,0,0,0,0
1668197082628,ECE 260B,A00,103658,Kang; Mingu,0,0,0,0
1668197083057,ECE 264A,A00,103659,Galton; Ian A,0,0,0,0
1668197083484,ECE 265A,A00,103661,Gudem; Prasad S.S.,0,0,0,0
1668197083911,ECE 265D,A00,103662,Gudem; Prasad S.S.,0,0,0,0
1668197084370,ECE 268,A00,103663,Koushanfar; Farinaz,0,0,0,0
1668197084806,ECE 269,A01,103665,Pal; Piya,0,0,0,0
1668197085229,ECE 271B,A00,103666,Vasconcelos; Manuela,0,0,0,0
1668197085652,ECE 276A,A00,103667,Atanasov; Nikolay A.,0,0,0,0
1668197086074,ECE 277,A00,103668,An; Cheolhong,0,0,0,0
1668197086512,ECE 279,A00,117947,Hall; Drew A.,0,0,0,0
1668197087371,ECE 283,A00,103670,Hsueh; Tzu-Chien,0,0,0,0
1668197087798,ECE 284,A00,103671,Turakhia; Yatish Girish,0,0,0,0
1668197088224,ECE 285,A00,103672,Zheng; Yang,0,0,0,0
1668197088224,ECE 285,B00,103673,Sworder; David D.,0,0,0,0
1668197088656,ECE 287,A00,103676,Javidi; Tara,0,0,0,0
1668197089083,MATH 200B,A00,098023,Salehi Golsefidy; Alireza,12,0,15,3
1668197089534,MATH 202B,A00,098024,Rhoades; Brendon Patrick,9,0,15,6
1668197089959,MATH 203B,A00,098025,Oprea; Dragos N.,10,0,15,5
1668197090392,MATH 204B,A00,098026,Sorensen; Claus M,13,0,15,2
1668197090817,MATH 208,A00,098027,Izadi; Elham,7,0,10,3
1668197091243,MATH 209,A00,098028,Pollack; Aaron,10,0,10,0
1668197091664,MATH 211A,A00,112919,Rogalski; Daniel,9,0,10,1
1668197092109,MATH 211B,A00,112920,Seward; Brandon M.,9,0,10,1
1668197092532,MATH 218,A00,098029,Li; Bo,10,0,10,0
1668197092959,MATH 220B,A00,098030,Novak; Jonathan I,11,0,15,4
1668197093386,MATH 221A,A00,098031,Ebenfelt; Peter F,13,0,15,2
1668197093811,MATH 231B,A00,098032,Zlatos; Andrej,12,0,15,3
1668197094247,MATH 240B,A00,098033,Ni; Lei,9,0,15,6
1668197094670,MATH 243,A00,098034,Jekel; David Andrew,10,0,10,0
1668197095092,MATH 245A,A00,098035,Nie; Jiawang,0,0,15,16
1668197095520,MATH 248,A00,098036,Bejenaru; Ioan,10,0,10,0
1668197095959,MATH 250B,A00,098037,Spolaor; Luca,14,0,15,1
1668197096408,MATH 258,A00,098038,Ni; Lei,10,0,10,0
1668197096835,MATH 264B,A00,098041,Rhoades; Brendon Patrick,9,0,15,6
1668197097261,MATH 268,A00,098042,Buss; Samuel R,10,0,10,0
1668197097685,MATH 269,A00,098043,Rhoades; Brendon Patrick,10,0,10,0
1668197098108,MATH 270B,A00,098044,Li; Bo,10,0,15,5
1668197098539,MATH 272B,A00,098045,Holst; Michael J,13,0,15,2
1668197098974,MATH 273A,A00,098046,Tian; Xiaochuan,10,0,15,5
1668197099398,MATH 275,A01,098048,Tian; Xiaochuan,6,0,10,4
1668197099824,MATH 278A,A00,098049,Holst; Michael J,8,0,10,2
1668197100247,MATH 278B,A00,098050,Cloninger; Alexander,10,0,10,0
1668197100678,MATH 278C,A00,098051,Nie; Jiawang,7,0,10,3
1668197101100,MATH 280B,A00,098052,Zheng; Tianyi,10,0,15,5
1668197101524,MATH 281B,A00,098053,Bradic; Jelena,2,0,15,13
1668197101955,MATH 282B,A00,098054,Arias-Castro; Ery,0,0,15,15
1668197102395,MATH 285,A00,098055,Fitzsimmons; Patrick J,0,0,15,17
1668197102822,MATH 287B,A00,098056,Arias-Castro; Ery,2,0,15,13
1668197103245,MATH 288,A00,098057,Agarwal; Pooja,9,0,10,1
1668197103245,MATH 288,B00,098058,Zhang; Danna,8,0,10,2
1668197103245,MATH 288,C00,098059,Williams; Ruth J,10,0,10,0
1668197103671,MATH 290B,A00,098060,Roberts; Justin Deritter,13,0,15,2
1668197104106,MATH 292,A00,098061,Belmont; Eva Kinoshita,10,0,10,0
1668197104529,MATH 295,A00,098062,Suk; Andrew Hoon,48,0,50,2
1668197104954,MATH 296,A00,098063,Novak; Jonathan I,20,0,20,0
1668197105398,MATH 297,001,098064,Gamst; Anthony Collins,9997,0,9999,2
1668197608204,COGS 205,A00,101395,Chiba; Andrea,19,0,20,1
1668197608631,COGS 210B,001,101404,Greene; Deanna Jacquelyn,9998,0,9999,1
1668197608631,COGS 210B,002,101417,Xia; Haijun,9999,0,9999,0
1668197608631,COGS 210B,003,101422,Nitz; Douglas A.,9999,0,9999,0
1668197608631,COGS 210B,004,101423,Hollan; James D.,9998,0,9999,1
1668197608631,COGS 210B,005,101424,Deak; Gedeon O.,9998,0,9999,1
1668197608631,COGS 210B,006,101425,Rossano; Federico,9999,0,9999,0
1668197609056,COGS 211B,A00,101427,Coulson; Seana M,9996,0,9999,3
1668197609488,COGS 220,A00,101428,Hollan; James D.,0,0,25,25
1668197609926,COGS 229,A00,101429,Dow; Steven P,18,0,25,7
1668197610353,COGS 230,A00,101430,Klemmer; Scott R,12,0,17,5
1668197610774,COGS 234,A00,101431,Xia; Haijun,3,0,25,22
1668197611200,COGS 260,A00,101432,Kiyonaga; Anastasia,20,0,25,5
1668197611200,COGS 260,B00,101433,Kirsh; David Joel,16,0,25,9
1668197611629,CSE 202,A00,102371,Impagliazzo; Russell,0,0,0,0
1668197612058,CSE 203B,A01,102373,Cheng; Chung Kuan,0,0,0,0
1668197612485,CSE 208,A00,102374,Micciancio; Daniele,0,0,0,0
1668197612922,CSE 209A,A00,112895,Impagliazzo; Russell,0,0,15,15
1668197613352,CSE 209B,A00,108005,Bellare; Mihir,0,0,0,0
1668197613777,CSE 210,A00,113163,Coblenz; Michael J,0,0,0,0
1668197614199,CSE 219,A00,106111,Dow; Steven P,0,0,20,20
1668197614633,CSE 221,A00,102376,Voelker; Geoffrey M.,0,0,0,0
1668197615075,CSE 224,A01,102378,Porter; George M,0,0,0,0
1668197615503,CSE 229A,A00,102379,Savage; Stefan,0,0,0,0
1668197615929,CSE 229C,A00,102380,Munyaka; Imani N. S.,0,0,0,0
1668197616355,CSE 232B,A00,102382,Deutsch; Alin Bernard,0,0,0,0
1668197616776,CSE 234,A01,112904,Kumar; Arun Kumar,0,0,0,0
1668197617198,CSE 237A,A00,102383,Rosing; Tajana Simunic,0,0,0,0
1668197617623,CSE 239A,A00,102384,Deutsch; Alin Bernard,0,0,0,0
1668197618056,CSE 239B,A00,102385,Polikarpova; Nadezhda,0,0,0,0
1668197618483,CSE 240A,A00,102386,Pannuto; Patrick William,0,0,0,0
1668197618921,CSE 240B,A00,102387,Zhao; Jishen,0,0,0,0
1668197619357,CSE 241A,A00,106406,Kang; Mingu,0,0,0,0
1668197619779,CSE 249B,A00,102388,Kahng; Andrew Byun,0,0,8,8
1668197620205,CSE 251B,A01,102392,Cottrell; Garrison W,0,0,0,0
1668197620205,CSE 251B,A02,102393,Cottrell; Garrison W,0,0,0,0
1668197620635,CSE 252B,A00,102394,Ochoa; Benjamin Lawrence,0,0,0,0
1668197621058,CSE 257,A01,102396,Gao; Sicun,0,0,0,0
1668197621481,CSE 272,A00,102397,Li; Tzumao,0,0,0,0
1668197621911,CSE 274,A00,111323,Chern; Albert Ren-Haur,0,0,0,0
1668197622342,CSE 282,A00,102398,Pevzner; Pavel Arkadjevich,0,0,0,0
1668197622764,CSE 284,A00,114175,Gymrek; Melissa Ann,0,0,0,0
1668197623189,CSE 290,A00,102399,Chandraker; Manmohan Krishna,0,0,0,0
1668197623189,CSE 290,B00,102400,Vaccaro; Kristen Marie,0,0,25,25
1668197623189,CSE 290,C00,102414,Pannuto; Patrick William,0,0,25,25
1668197623189,CSE 290,D00,102427,Pevzner; Pavel Arkadjevich,0,0,0,0
1668197623189,CSE 290,E00,102429,Zhao; Jishen,0,0,0,0
1668197623189,CSE 290,F00,102436,Tullsen; Dean Michael,0,0,0,0
1668197623189,CSE 290,G00,102440,Christensen; Henrik I,0,0,20,20
1668197623632,CSE 291,A00,102443,Su; Hao,0,0,0,0
1668197623632,CSE 291,B00,102448,Polikarpova; Nadezhda,0,0,0,0
1668197623632,CSE 291,C00,102453,Vaccaro; Kristen Marie,0,0,0,0
1668197623632,CSE 291,D00,111343,Savage; Stefan,0,0,0,0
1668197623632,CSE 291,E00,116474,Claffy; Kimberly Claire,0,0,0,0
1668197623632,CSE 291,F00,116479,Pasquale; Joseph,0,0,0,0
1668197624058,CSE 293,001,119111,Bafna; Vineet,9999,0,9999,0
1668197624058,CSE 293,002,119118,Bellare; Mihir,9999,0,9999,0
1668197624058,CSE 293,003,119122,Berg-Kirkpatrick; Taylor D,9999,0,9999,0
1668197624058,CSE 293,004,119135,Christensen; Henrik I,9999,0,9999,0
1668197624058,CSE 293,005,119142,Cottrell; Garrison W,9999,0,9999,0
1668197624058,CSE 293,006,119146,Deutsch; Alin Bernard,9999,0,9999,0
1668197624058,CSE 293,007,119159,Esmaeilzadeh; Hadi,9999,0,9999,0
1668197624058,CSE 293,008,119166,Freund; Yoav,9999,0,9999,0
1668197624058,CSE 293,009,119170,Griswold; William G.,9999,0,9999,0
1668197624058,CSE 293,010,119183,Gymrek; Melissa Ann,9999,0,9999,0
1668197624058,CSE 293,011,119190,Heninger; Nadia A,9999,0,9999,0
1668197624058,CSE 293,012,119230,Impagliazzo; Russell,9999,0,9999,0
1668197624058,CSE 293,013,119232,Jhala; Ranjit,9999,0,9999,0
1668197624058,CSE 293,014,119233,Kahng; Andrew Byun,9999,0,9999,0
1668197624058,CSE 293,015,119298,Kane; Daniel Mertz,9999,0,9999,0
1668197624058,CSE 293,016,119299,Kriegman; David J,9999,0,9999,0
1668197624058,CSE 293,017,119300,Kumar; Arun Kumar,9999,0,9999,0
1668197624058,CSE 293,018,119301,Lerner; Sorin,9999,0,9999,0
1668197624058,CSE 293,019,119302,Lovett; Shachar,9999,0,9999,0
1668197624058,CSE 293,020,119303,McAuley; Julian John,9999,0,9999,0
1668197624058,CSE 293,021,119304,Micciancio; Daniele,9999,0,9999,0
1668197624058,CSE 293,022,119367,Orailoglu; Alex,9999,0,9999,0
1668197624058,CSE 293,023,119382,Paturi; Ramamohan,9999,0,9999,0
1668197624058,CSE 293,024,119404,Polikarpova; Nadezhda,9999,0,9999,0
1668197624058,CSE 293,025,119406,Politz; Joseph Gibbs,9999,0,9999,0
1668197624058,CSE 293,026,119411,Porter; George M,9999,0,9999,0
1668197624058,CSE 293,027,119414,Porter; Leonard Emerson,9999,0,9999,0
1668197624058,CSE 293,028,119416,Ramamoorthi; Ravi,9999,0,9999,0
1668197624058,CSE 293,029,119417,Sahoo; Debashis,9999,0,9999,0
1668197624058,CSE 293,030,119420,Saul; Lawrence,9999,0,9999,0
1668197624058,CSE 293,031,119421,Savage; Stefan,9999,0,9999,0
1668197624058,CSE 293,032,119425,Schulze; Jurgen P.,9999,0,9999,0
1668197624058,CSE 293,033,119426,Snoeren; Alex C.,9999,0,9999,0
1668197624058,CSE 293,034,119428,Shang; Jingbo,9999,0,9999,0
1668197624058,CSE 293,035,119430,Stefan; Deian,9999,0,9999,0
1668197624058,CSE 293,036,119431,Su; Hao,9999,0,9999,0
1668197624058,CSE 293,037,119433,Swanson; Steven James,9999,0,9999,0
1668197624058,CSE 293,038,119435,Tullsen; Dean Michael,9999,0,9999,0
1668197624058,CSE 293,039,119483,Voelker; Geoffrey M.,9999,0,9999,0
1668197624058,CSE 293,040,119537,Zhao; Jishen,9999,0,9999,0
1668197624058,CSE 293,041,119538,Zhou; Yuan-Yuan,9999,0,9999,0
1668197624058,CSE 293,042,119539,Gao; Sicun,9999,0,9999,0
1668197624058,CSE 293,043,119540,Weibel; Nadir,9999,0,9999,0
1668197624058,CSE 293,044,119541,Gupta; Rajesh K.,9999,0,9999,0
1668197624058,CSE 293,045,126410,Vaccaro; Kristen Marie,9999,0,9999,0
1668197624058,CSE 293,046,126411,Klemke; Richard,9999,0,9999,0
1668197624483,CSE 294,A00,102459,Voelker; Geoffrey M.,0,0,0,0
1668197624483,CSE 294,B00,111322,Orailoglu; Alex,0,0,0,0
1668197624912,DSE 201,A00,096914,Deutsch; Alin Bernard,30,0,30,0
1668197625339,DSE 210,A00,096915,Dasgupta; Sanjoy,30,0,30,0
1668197625763,DSE 260A,A00,096916,Altintas De Callaf; Ilkay,30,0,30,0
1668197626192,ECE 200,001,103586,Antipa; Nicholas A,9999,0,9999,0
1668197626192,ECE 200,002,103587,Atanasov; Nikolay A.,9999,0,9999,0
1668197626192,ECE 200,003,103588,Bharadia; Dinesh,9999,0,9999,0
1668197626192,ECE 200,004,103589,Cheng; Chung Kuan,9999,0,9999,0
1668197626192,ECE 200,005,103590,Cosman; Pamela C.,9999,0,9999,0
1668197626192,ECE 200,006,103591,Dayeh; Shadi Ahmad,9999,0,9999,0
1668197626192,ECE 200,007,103592,Fainman; Yeshaiahu,9999,0,9999,0
1668197626192,ECE 200,008,103593,Ford; Joseph Earl,9999,0,9999,0
1668197626192,ECE 200,009,103594,Franceschetti; Massimo,9999,0,9999,0
1668197626192,ECE 200,010,103595,Fullerton; Eric E,9999,0,9999,0
1668197626192,ECE 200,011,103596,Galton; Ian A,9999,0,9999,0
1668197626192,ECE 200,012,103597,Gilja; Vikash,9999,0,9999,0
1668197626192,ECE 200,013,103598,Hall; Drew A.,9999,0,9999,0
1668197626192,ECE 200,014,103599,Hsueh; Tzu-Chien,9999,0,9999,0
1668197626192,ECE 200,015,103600,Javidi; Tara,9999,0,9999,0
1668197626192,ECE 200,016,103601,Kahng; Andrew Byun,9999,0,9999,0
1668197626192,ECE 200,017,103602,Kim; Young-Han,9999,0,9999,0
1668197626192,ECE 200,018,103603,Koushanfar; Farinaz,9999,0,9999,0
1668197626192,ECE 200,019,103604,Kuzum; Duygu,9999,0,9999,0
1668197626192,ECE 200,020,103605,Le; Hanh-Phuc,9999,0,9999,0
1668197626192,ECE 200,021,103606,Lin; Bill,9999,0,9999,0
1668197626192,ECE 200,022,103607,Liu; Zhaowei,9998,0,9999,1
1668197626192,ECE 200,023,103608,Lo; Yu-Hwa,9999,0,9999,0
1668197626192,ECE 200,024,103609,Lomakin; Vitaliy,9999,0,9999,0
1668197626192,ECE 200,025,103610,Mercier; Patrick Philip,9999,0,9999,0
1668197626192,ECE 200,026,103611,Meyer; Florian,9999,0,9999,0
1668197626192,ECE 200,027,103612,Milstein; Laurence B.,9999,0,9999,0
1668197626192,ECE 200,028,103613,Mir Arabbaygi; Siavash,9999,0,9999,0
1668197626192,ECE 200,029,103614,Mookherjea; Shayan,9999,0,9999,0
1668197626192,ECE 200,030,103615,Morris; Karcher William,9999,0,9999,0
1668197626192,ECE 200,031,103616,Ng; Tse Nga,9999,0,9999,0
1668197626192,ECE 200,032,103617,Nguyen; Truong Quang,9999,0,9999,0
1668197626192,ECE 200,033,103618,Nomura; Kenji,9999,0,9999,0
1668197626192,ECE 200,034,103619,Orlitsky; Alon,9999,0,9999,0
1668197626192,ECE 200,035,103620,Pal; Piya,9999,0,9999,0
1668197626192,ECE 200,036,103621,Papen; George C.,9999,0,9999,0
1668197626192,ECE 200,037,103622,Radic; Stojan,9999,0,9999,0
1668197626192,ECE 200,038,103623,Rao; Bhaskar D.,9999,0,9999,0
1668197626192,ECE 200,039,103624,Rao; Ramesh R,9999,0,9999,0
1668197626192,ECE 200,040,103625,Rebeiz; Gabriel,9999,0,9999,0
1668197626192,ECE 200,041,103626,Sanford; John R,9999,0,9999,0
1668197626192,ECE 200,042,103627,Siegel; Paul H.,9999,0,9999,0
1668197626192,ECE 200,043,103628,Sievenpiper; Daniel F.,9999,0,9999,0
1668197626192,ECE 200,044,103629,Sworder; David D.,9999,0,9999,0
1668197626192,ECE 200,045,103630,Taur; Yuan,9999,0,9999,0
1668197626192,ECE 200,046,103631,Touri; Behrouz,9999,0,9999,0
1668197626192,ECE 200,047,103632,Trivedi; Mohan M.,9999,0,9999,0
1668197626192,ECE 200,048,103633,Vasconcelos; Nuno,9999,0,9999,0
1668197626192,ECE 200,049,103634,Wang; Xiaolong,9999,0,9999,0
1668197626192,ECE 200,050,103635,Xie; Pengtao,9999,0,9999,0
1668197626192,ECE 200,051,103636,Yip; Michael,9999,0,9999,0
1668197626192,ECE 200,052,103637,Zeger; Kenneth A.,999,0,999,0
1668197626192,ECE 200,053,103638,Zhang; Xinyu,9999,0,9999,0
1668197626192,ECE 200,054,103639,Turakhia; Yatish Girish,9999,0,9999,0
1668197626192,ECE 200,055,103640,Kang; Mingu,9999,0,9999,0
1668197626192,ECE 200,056,103641,Shi; Yuanyuan,9999,0,9999,0
1668197626192,ECE 200,057,103642,Wang; Edward Jay,9999,0,9999,0
1668197626192,ECE 200,058,103643,Zheng; Yang,9999,0,9999,0
1668197626616,ECE 202,A00,103644,Kuzum; Duygu,0,0,0,0
1668197627038,ECE 212BN,A00,103646,Ng; Tse Nga,0,0,0,0
1668197627464,ECE 221,A00,111493,Staff,0,0,0,0
1668197627897,ECE 222B,A00,103647,Lomakin; Vitaliy,0,0,0,0
1668197628319,ECE 230B,A00,103648,Taur; Yuan,0,0,0,0
1668197628758,ECE 238B,A00,103649,Garay; Javier,0,0,0,0
1668197629183,ECE 240B,A00,112900,Fainman; Yeshaiahu,0,0,0,0
1668197629614,ECE 247A,A00,103650,Jokerst; Jesse Vincent,0,0,0,0
1668197630049,ECE 247B,A00,103651,Wang; Joseph,0,0,0,0
1668197630476,ECE 250,A00,103652,Siegel; Paul H.,0,0,0,0
1668197630902,ECE 251A,A00,103654,Rao; Bhaskar D.,0,0,0,0
1668197631325,ECE 257B,A00,103655,Bharadia; Dinesh,0,0,0,0
1668197631750,ECE 258A,A00,103656,Milstein; Laurence B.,0,0,0,0
1668197632176,ECE 260B,A00,103658,Kang; Mingu,0,0,0,0
1668197632601,ECE 264A,A00,103659,Galton; Ian A,0,0,0,0
1668197633024,ECE 265A,A00,103661,Gudem; Prasad S.S.,0,0,0,0
1668197633454,ECE 265D,A00,103662,Gudem; Prasad S.S.,0,0,0,0
1668197633884,ECE 268,A00,103663,Koushanfar; Farinaz,0,0,0,0
1668197634309,ECE 269,A01,103665,Pal; Piya,0,0,0,0
1668197634730,ECE 271B,A00,103666,Vasconcelos; Manuela,0,0,0,0
1668197635155,ECE 276A,A00,103667,Atanasov; Nikolay A.,0,0,0,0
1668197635581,ECE 277,A00,103668,An; Cheolhong,0,0,0,0
1668197636009,ECE 279,A00,117947,Hall; Drew A.,0,0,0,0
1668197636857,ECE 283,A00,103670,Hsueh; Tzu-Chien,0,0,0,0
1668197637280,ECE 284,A00,103671,Turakhia; Yatish Girish,0,0,0,0
1668197637713,ECE 285,A00,103672,Zheng; Yang,0,0,0,0
1668197637713,ECE 285,B00,103673,Sworder; David D.,0,0,0,0
1668197638139,ECE 287,A00,103676,Javidi; Tara,0,0,0,0
1668197638562,MATH 200B,A00,098023,Salehi Golsefidy; Alireza,12,0,15,3
1668197638997,MATH 202B,A00,098024,Rhoades; Brendon Patrick,9,0,15,6
1668197639422,MATH 203B,A00,098025,Oprea; Dragos N.,10,0,15,5
1668197639855,MATH 204B,A00,098026,Sorensen; Claus M,13,0,15,2
1668197640286,MATH 208,A00,098027,Izadi; Elham,7,0,10,3
1668197640708,MATH 209,A00,098028,Pollack; Aaron,10,0,10,0
1668197641131,MATH 211A,A00,112919,Rogalski; Daniel,9,0,10,1
1668197641554,MATH 211B,A00,112920,Seward; Brandon M.,9,0,10,1
1668197641979,MATH 218,A00,098029,Li; Bo,10,0,10,0
1668197642402,MATH 220B,A00,098030,Novak; Jonathan I,11,0,15,4
1668197642831,MATH 221A,A00,098031,Ebenfelt; Peter F,13,0,15,2
1668197643270,MATH 231B,A00,098032,Zlatos; Andrej,12,0,15,3
1668197643698,MATH 240B,A00,098033,Ni; Lei,9,0,15,6
1668197644131,MATH 243,A00,098034,Jekel; David Andrew,10,0,10,0
1668197644554,MATH 245A,A00,098035,Nie; Jiawang,0,0,15,16
1668197644990,MATH 248,A00,098036,Bejenaru; Ioan,10,0,10,0
1668197645500,MATH 250B,A00,098037,Spolaor; Luca,14,0,15,1
1668197645925,MATH 258,A00,098038,Ni; Lei,10,0,10,0
1668197646352,MATH 264B,A00,098041,Rhoades; Brendon Patrick,9,0,15,6
1668197646776,MATH 268,A00,098042,Buss; Samuel R,10,0,10,0
1668197647204,MATH 269,A00,098043,Rhoades; Brendon Patrick,10,0,10,0
1668197647638,MATH 270B,A00,098044,Li; Bo,10,0,15,5
1668197648070,MATH 272B,A00,098045,Holst; Michael J,13,0,15,2
1668197648502,MATH 273A,A00,098046,Tian; Xiaochuan,10,0,15,5
1668197648927,MATH 275,A01,098048,Tian; Xiaochuan,6,0,10,4
1668197649350,MATH 278A,A00,098049,Holst; Michael J,8,0,10,2
1668197649779,MATH 278B,A00,098050,Cloninger; Alexander,10,0,10,0
1668197650204,MATH 278C,A00,098051,Nie; Jiawang,7,0,10,3
1668197650631,MATH 280B,A00,098052,Zheng; Tianyi,10,0,15,5
1668197651057,MATH 281B,A00,098053,Bradic; Jelena,2,0,15,13
1668197651485,MATH 282B,A00,098054,Arias-Castro; Ery,0,0,15,15
1668197651924,MATH 285,A00,098055,Fitzsimmons; Patrick J,0,0,15,17
1668197652347,MATH 287B,A00,098056,Arias-Castro; Ery,2,0,15,13
1668197652769,MATH 288,A00,098057,Agarwal; Pooja,9,0,10,1
1668197652769,MATH 288,B00,098058,Zhang; Danna,8,0,10,2
1668197652769,MATH 288,C00,098059,Williams; Ruth J,10,0,10,0
1668197653196,MATH 290B,A00,098060,Roberts; Justin Deritter,13,0,15,2
1668197653625,MATH 292,A00,098061,Belmont; Eva Kinoshita,10,0,10,0
1668197654051,MATH 295,A00,098062,Suk; Andrew Hoon,48,0,50,2
1668197654476,MATH 296,A00,098063,Novak; Jonathan I,20,0,20,0
1668197654917,MATH 297,001,098064,Gamst; Anthony Collins,9997,0,9999,2
1668198157239,COGS 205,A00,101395,Chiba; Andrea,19,0,20,1
1668198157661,COGS 210B,001,101404,Greene; Deanna Jacquelyn,9998,0,9999,1
1668198157661,COGS 210B,002,101417,Xia; Haijun,9999,0,9999,0
1668198157661,COGS 210B,003,101422,Nitz; Douglas A.,9999,0,9999,0
1668198157661,COGS 210B,004,101423,Hollan; James D.,9998,0,9999,1
1668198157661,COGS 210B,005,101424,Deak; Gedeon O.,9998,0,9999,1
1668198157661,COGS 210B,006,101425,Rossano; Federico,9999,0,9999,0
1668198158084,COGS 211B,A00,101427,Coulson; Seana M,9996,0,9999,3
1668198158506,COGS 220,A00,101428,Hollan; James D.,0,0,25,25
1668198158941,COGS 229,A00,101429,Dow; Steven P,18,0,25,7
1668198159363,COGS 230,A00,101430,Klemmer; Scott R,12,0,17,5
1668198159788,COGS 234,A00,101431,Xia; Haijun,3,0,25,22
1668198160218,COGS 260,A00,101432,Kiyonaga; Anastasia,20,0,25,5
1668198160218,COGS 260,B00,101433,Kirsh; David Joel,16,0,25,9
1668198160650,CSE 202,A00,102371,Impagliazzo; Russell,0,0,0,0
1668198161081,CSE 203B,A01,102373,Cheng; Chung Kuan,0,0,0,0
1668198161508,CSE 208,A00,102374,Micciancio; Daniele,0,0,0,0
1668198161938,CSE 209A,A00,112895,Impagliazzo; Russell,0,0,15,15
1668198162367,CSE 209B,A00,108005,Bellare; Mihir,0,0,0,0
1668198162800,CSE 210,A00,113163,Coblenz; Michael J,0,0,0,0
1668198163239,CSE 219,A00,106111,Dow; Steven P,0,0,20,20
1668198163670,CSE 221,A00,102376,Voelker; Geoffrey M.,0,0,0,0
1668198164095,CSE 224,A01,102378,Porter; George M,0,0,0,0
1668198164518,CSE 229A,A00,102379,Savage; Stefan,0,0,0,0
1668198164964,CSE 229C,A00,102380,Munyaka; Imani N. S.,0,0,0,0
1668198165389,CSE 232B,A00,102382,Deutsch; Alin Bernard,0,0,0,0
1668198165816,CSE 234,A01,112904,Kumar; Arun Kumar,0,0,0,0
1668198166241,CSE 237A,A00,102383,Rosing; Tajana Simunic,0,0,0,0
1668198166663,CSE 239A,A00,102384,Deutsch; Alin Bernard,0,0,0,0
1668198167087,CSE 239B,A00,102385,Polikarpova; Nadezhda,0,0,0,0
1668198167510,CSE 240A,A00,102386,Pannuto; Patrick William,0,0,0,0
1668198168017,CSE 240B,A00,102387,Zhao; Jishen,0,0,0,0
1668198168442,CSE 241A,A00,106406,Kang; Mingu,0,0,0,0
1668198168864,CSE 249B,A00,102388,Kahng; Andrew Byun,0,0,8,8
1668198169292,CSE 251B,A01,102392,Cottrell; Garrison W,0,0,0,0
1668198169292,CSE 251B,A02,102393,Cottrell; Garrison W,0,0,0,0
1668198169728,CSE 252B,A00,102394,Ochoa; Benjamin Lawrence,0,0,0,0
1668198170155,CSE 257,A01,102396,Gao; Sicun,0,0,0,0
1668198170579,CSE 272,A00,102397,Li; Tzumao,0,0,0,0
1668198171002,CSE 274,A00,111323,Chern; Albert Ren-Haur,0,0,0,0
1668198171425,CSE 282,A00,102398,Pevzner; Pavel Arkadjevich,0,0,0,0
1668198171855,CSE 284,A00,114175,Gymrek; Melissa Ann,0,0,0,0
1668198172280,CSE 290,A00,102399,Chandraker; Manmohan Krishna,0,0,0,0
1668198172280,CSE 290,B00,102400,Vaccaro; Kristen Marie,0,0,25,25
1668198172280,CSE 290,C00,102414,Pannuto; Patrick William,0,0,25,25
1668198172280,CSE 290,D00,102427,Pevzner; Pavel Arkadjevich,0,0,0,0
1668198172280,CSE 290,E00,102429,Zhao; Jishen,0,0,0,0
1668198172280,CSE 290,F00,102436,Tullsen; Dean Michael,0,0,0,0
1668198172280,CSE 290,G00,102440,Christensen; Henrik I,0,0,20,20
1668198172709,CSE 291,A00,102443,Su; Hao,0,0,0,0
1668198172709,CSE 291,B00,102448,Polikarpova; Nadezhda,0,0,0,0
1668198172709,CSE 291,C00,102453,Vaccaro; Kristen Marie,0,0,0,0
1668198172709,CSE 291,D00,111343,Savage; Stefan,0,0,0,0
1668198172709,CSE 291,E00,116474,Claffy; Kimberly Claire,0,0,0,0
1668198172709,CSE 291,F00,116479,Pasquale; Joseph,0,0,0,0
1668198173167,CSE 293,001,119111,Bafna; Vineet,9999,0,9999,0
1668198173167,CSE 293,002,119118,Bellare; Mihir,9999,0,9999,0
1668198173167,CSE 293,003,119122,Berg-Kirkpatrick; Taylor D,9999,0,9999,0
1668198173167,CSE 293,004,119135,Christensen; Henrik I,9999,0,9999,0
1668198173167,CSE 293,005,119142,Cottrell; Garrison W,9999,0,9999,0
1668198173167,CSE 293,006,119146,Deutsch; Alin Bernard,9999,0,9999,0
1668198173167,CSE 293,007,119159,Esmaeilzadeh; Hadi,9999,0,9999,0
1668198173167,CSE 293,008,119166,Freund; Yoav,9999,0,9999,0
1668198173167,CSE 293,009,119170,Griswold; William G.,9999,0,9999,0
1668198173167,CSE 293,010,119183,Gymrek; Melissa Ann,9999,0,9999,0
1668198173167,CSE 293,011,119190,Heninger; Nadia A,9999,0,9999,0
1668198173167,CSE 293,012,119230,Impagliazzo; Russell,9999,0,9999,0
1668198173167,CSE 293,013,119232,Jhala; Ranjit,9999,0,9999,0
1668198173167,CSE 293,014,119233,Kahng; Andrew Byun,9999,0,9999,0
1668198173167,CSE 293,015,119298,Kane; Daniel Mertz,9999,0,9999,0
1668198173167,CSE 293,016,119299,Kriegman; David J,9999,0,9999,0
1668198173167,CSE 293,017,119300,Kumar; Arun Kumar,9999,0,9999,0
1668198173167,CSE 293,018,119301,Lerner; Sorin,9999,0,9999,0
1668198173167,CSE 293,019,119302,Lovett; Shachar,9999,0,9999,0
1668198173167,CSE 293,020,119303,McAuley; Julian John,9999,0,9999,0
1668198173167,CSE 293,021,119304,Micciancio; Daniele,9999,0,9999,0
1668198173167,CSE 293,022,119367,Orailoglu; Alex,9999,0,9999,0
1668198173167,CSE 293,023,119382,Paturi; Ramamohan,9999,0,9999,0
1668198173167,CSE 293,024,119404,Polikarpova; Nadezhda,9999,0,9999,0
1668198173167,CSE 293,025,119406,Politz; Joseph Gibbs,9999,0,9999,0
1668198173167,CSE 293,026,119411,Porter; George M,9999,0,9999,0
1668198173167,CSE 293,027,119414,Porter; Leonard Emerson,9999,0,9999,0
1668198173167,CSE 293,028,119416,Ramamoorthi; Ravi,9999,0,9999,0
1668198173167,CSE 293,029,119417,Sahoo; Debashis,9999,0,9999,0
1668198173167,CSE 293,030,119420,Saul; Lawrence,9999,0,9999,0
1668198173167,CSE 293,031,119421,Savage; Stefan,9999,0,9999,0
1668198173167,CSE 293,032,119425,Schulze; Jurgen P.,9999,0,9999,0
1668198173167,CSE 293,033,119426,Snoeren; Alex C.,9999,0,9999,0
1668198173167,CSE 293,034,119428,Shang; Jingbo,9999,0,9999,0
1668198173167,CSE 293,035,119430,Stefan; Deian,9999,0,9999,0
1668198173167,CSE 293,036,119431,Su; Hao,9999,0,9999,0
1668198173167,CSE 293,037,119433,Swanson; Steven James,9999,0,9999,0
1668198173167,CSE 293,038,119435,Tullsen; Dean Michael,9999,0,9999,0
1668198173167,CSE 293,039,119483,Voelker; Geoffrey M.,9999,0,9999,0
1668198173167,CSE 293,040,119537,Zhao; Jishen,9999,0,9999,0
1668198173167,CSE 293,041,119538,Zhou; Yuan-Yuan,9999,0,9999,0
1668198173167,CSE 293,042,119539,Gao; Sicun,9999,0,9999,0
1668198173167,CSE 293,043,119540,Weibel; Nadir,9999,0,9999,0
1668198173167,CSE 293,044,119541,Gupta; Rajesh K.,9999,0,9999,0
1668198173167,CSE 293,045,126410,Vaccaro; Kristen Marie,9999,0,9999,0
1668198173167,CSE 293,046,126411,Klemke; Richard,9999,0,9999,0
1668198173590,CSE 294,A00,102459,Voelker; Geoffrey M.,0,0,0,0
1668198173590,CSE 294,B00,111322,Orailoglu; Alex,0,0,0,0
1668198174017,DSE 201,A00,096914,Deutsch; Alin Bernard,30,0,30,0
1668198174440,DSE 210,A00,096915,Dasgupta; Sanjoy,30,0,30,0
1668198174863,DSE 260A,A00,096916,Altintas De Callaf; Ilkay,30,0,30,0
1668198175291,ECE 200,001,103586,Antipa; Nicholas A,9999,0,9999,0
1668198175291,ECE 200,002,103587,Atanasov; Nikolay A.,9999,0,9999,0
1668198175291,ECE 200,003,103588,Bharadia; Dinesh,9999,0,9999,0
1668198175291,ECE 200,004,103589,Cheng; Chung Kuan,9999,0,9999,0
1668198175291,ECE 200,005,103590,Cosman; Pamela C.,9999,0,9999,0
1668198175291,ECE 200,006,103591,Dayeh; Shadi Ahmad,9999,0,9999,0
1668198175291,ECE 200,007,103592,Fainman; Yeshaiahu,9999,0,9999,0
1668198175291,ECE 200,008,103593,Ford; Joseph Earl,9999,0,9999,0
1668198175291,ECE 200,009,103594,Franceschetti; Massimo,9999,0,9999,0
1668198175291,ECE 200,010,103595,Fullerton; Eric E,9999,0,9999,0
1668198175291,ECE 200,011,103596,Galton; Ian A,9999,0,9999,0
1668198175291,ECE 200,012,103597,Gilja; Vikash,9999,0,9999,0
1668198175291,ECE 200,013,103598,Hall; Drew A.,9999,0,9999,0
1668198175291,ECE 200,014,103599,Hsueh; Tzu-Chien,9999,0,9999,0
1668198175291,ECE 200,015,103600,Javidi; Tara,9999,0,9999,0
1668198175291,ECE 200,016,103601,Kahng; Andrew Byun,9999,0,9999,0
1668198175291,ECE 200,017,103602,Kim; Young-Han,9999,0,9999,0
1668198175291,ECE 200,018,103603,Koushanfar; Farinaz,9999,0,9999,0
1668198175291,ECE 200,019,103604,Kuzum; Duygu,9999,0,9999,0
1668198175291,ECE 200,020,103605,Le; Hanh-Phuc,9999,0,9999,0
1668198175291,ECE 200,021,103606,Lin; Bill,9999,0,9999,0
1668198175291,ECE 200,022,103607,Liu; Zhaowei,9998,0,9999,1
1668198175291,ECE 200,023,103608,Lo; Yu-Hwa,9999,0,9999,0
1668198175291,ECE 200,024,103609,Lomakin; Vitaliy,9999,0,9999,0
1668198175291,ECE 200,025,103610,Mercier; Patrick Philip,9999,0,9999,0
1668198175291,ECE 200,026,103611,Meyer; Florian,9999,0,9999,0
1668198175291,ECE 200,027,103612,Milstein; Laurence B.,9999,0,9999,0
1668198175291,ECE 200,028,103613,Mir Arabbaygi; Siavash,9999,0,9999,0
1668198175291,ECE 200,029,103614,Mookherjea; Shayan,9999,0,9999,0
1668198175291,ECE 200,030,103615,Morris; Karcher William,9999,0,9999,0
1668198175291,ECE 200,031,103616,Ng; Tse Nga,9999,0,9999,0
1668198175291,ECE 200,032,103617,Nguyen; Truong Quang,9999,0,9999,0
1668198175291,ECE 200,033,103618,Nomura; Kenji,9999,0,9999,0
1668198175291,ECE 200,034,103619,Orlitsky; Alon,9999,0,9999,0
1668198175291,ECE 200,035,103620,Pal; Piya,9999,0,9999,0
1668198175291,ECE 200,036,103621,Papen; George C.,9999,0,9999,0
1668198175291,ECE 200,037,103622,Radic; Stojan,9999,0,9999,0
1668198175291,ECE 200,038,103623,Rao; Bhaskar D.,9999,0,9999,0
1668198175291,ECE 200,039,103624,Rao; Ramesh R,9999,0,9999,0
1668198175291,ECE 200,040,103625,Rebeiz; Gabriel,9999,0,9999,0
1668198175291,ECE 200,041,103626,Sanford; John R,9999,0,9999,0
1668198175291,ECE 200,042,103627,Siegel; Paul H.,9999,0,9999,0
1668198175291,ECE 200,043,103628,Sievenpiper; Daniel F.,9999,0,9999,0
1668198175291,ECE 200,044,103629,Sworder; David D.,9999,0,9999,0
1668198175291,ECE 200,045,103630,Taur; Yuan,9999,0,9999,0
1668198175291,ECE 200,046,103631,Touri; Behrouz,9999,0,9999,0
1668198175291,ECE 200,047,103632,Trivedi; Mohan M.,9999,0,9999,0
1668198175291,ECE 200,048,103633,Vasconcelos; Nuno,9999,0,9999,0
1668198175291,ECE 200,049,103634,Wang; Xiaolong,9999,0,9999,0
1668198175291,ECE 200,050,103635,Xie; Pengtao,9999,0,9999,0
1668198175291,ECE 200,051,103636,Yip; Michael,9999,0,9999,0
1668198175291,ECE 200,052,103637,Zeger; Kenneth A.,999,0,999,0
1668198175291,ECE 200,053,103638,Zhang; Xinyu,9999,0,9999,0
1668198175291,ECE 200,054,103639,Turakhia; Yatish Girish,9999,0,9999,0
1668198175291,ECE 200,055,103640,Kang; Mingu,9999,0,9999,0
1668198175291,ECE 200,056,103641,Shi; Yuanyuan,9999,0,9999,0
1668198175291,ECE 200,057,103642,Wang; Edward Jay,9999,0,9999,0
1668198175291,ECE 200,058,103643,Zheng; Yang,9999,0,9999,0
1668198175728,ECE 202,A00,103644,Kuzum; Duygu,0,0,0,0
1668198176151,ECE 212BN,A00,103646,Ng; Tse Nga,0,0,0,0
1668198176573,ECE 221,A00,111493,Staff,0,0,0,0
1668198176994,ECE 222B,A00,103647,Lomakin; Vitaliy,0,0,0,0
1668198177419,ECE 230B,A00,103648,Taur; Yuan,0,0,0,0
1668198177846,ECE 238B,A00,103649,Garay; Javier,0,0,0,0
1668198178270,ECE 240B,A00,112900,Fainman; Yeshaiahu,0,0,0,0
1668198178696,ECE 247A,A00,103650,Jokerst; Jesse Vincent,0,0,0,0
1668198179123,ECE 247B,A00,103651,Wang; Joseph,0,0,0,0
1668198179558,ECE 250,A00,103652,Siegel; Paul H.,0,0,0,0
1668198179991,ECE 251A,A00,103654,Rao; Bhaskar D.,0,0,0,0
1668198180416,ECE 257B,A00,103655,Bharadia; Dinesh,0,0,0,0
1668198180839,ECE 258A,A00,103656,Milstein; Laurence B.,0,0,0,0
1668198181262,ECE 260B,A00,103658,Kang; Mingu,0,0,0,0
1668198181685,ECE 264A,A00,103659,Galton; Ian A,0,0,0,0
1668198182109,ECE 265A,A00,103661,Gudem; Prasad S.S.,0,0,0,0
1668198182533,ECE 265D,A00,103662,Gudem; Prasad S.S.,0,0,0,0
1668198182959,ECE 268,A00,103663,Koushanfar; Farinaz,0,0,0,0
1668198183382,ECE 269,A01,103665,Pal; Piya,0,0,0,0
1668198183817,ECE 271B,A00,103666,Vasconcelos; Manuela,0,0,0,0
1668198184240,ECE 276A,A00,103667,Atanasov; Nikolay A.,0,0,0,0
1668198184671,ECE 277,A00,103668,An; Cheolhong,0,0,0,0
1668198185103,ECE 279,A00,117947,Hall; Drew A.,0,0,0,0
1668198185957,ECE 283,A00,103670,Hsueh; Tzu-Chien,0,0,0,0
1668198186385,ECE 284,A00,103671,Turakhia; Yatish Girish,0,0,0,0
1668198186820,ECE 285,A00,103672,Zheng; Yang,0,0,0,0
1668198186820,ECE 285,B00,103673,Sworder; David D.,0,0,0,0
1668198187255,ECE 287,A00,103676,Javidi; Tara,0,0,0,0
1668198187678,MATH 200B,A00,098023,Salehi Golsefidy; Alireza,12,0,15,3
1668198188109,MATH 202B,A00,098024,Rhoades; Brendon Patrick,9,0,15,6
1668198188531,MATH 203B,A00,098025,Oprea; Dragos N.,10,0,15,5
1668198188966,MATH 204B,A00,098026,Sorensen; Claus M,13,0,15,2
1668198189399,MATH 208,A00,098027,Izadi; Elham,7,0,10,3
1668198189821,MATH 209,A00,098028,Pollack; Aaron,10,0,10,0
1668198190245,MATH 211A,A00,112919,Rogalski; Daniel,9,0,10,1
1668198190676,MATH 211B,A00,112920,Seward; Brandon M.,9,0,10,1
1668198191114,MATH 218,A00,098029,Li; Bo,10,0,10,0
1668198191541,MATH 220B,A00,098030,Novak; Jonathan I,11,0,15,4
1668198191964,MATH 221A,A00,098031,Ebenfelt; Peter F,13,0,15,2
1668198192391,MATH 231B,A00,098032,Zlatos; Andrej,12,0,15,3
1668198192815,MATH 240B,A00,098033,Ni; Lei,9,0,15,6
1668198193253,MATH 243,A00,098034,Jekel; David Andrew,10,0,10,0
1668198193688,MATH 245A,A00,098035,Nie; Jiawang,0,0,15,16
1668198194114,MATH 248,A00,098036,Bejenaru; Ioan,10,0,10,0
1668198194544,MATH 250B,A00,098037,Spolaor; Luca,14,0,15,1
1668198194970,MATH 258,A00,098038,Ni; Lei,10,0,10,0
1668198195399,MATH 264B,A00,098041,Rhoades; Brendon Patrick,9,0,15,6
1668198195824,MATH 268,A00,098042,Buss; Samuel R,10,0,10,0
1668198196258,MATH 269,A00,098043,Rhoades; Brendon Patrick,10,0,10,0
1668198196680,MATH 270B,A00,098044,Li; Bo,10,0,15,5
1668198197105,MATH 272B,A00,098045,Holst; Michael J,13,0,15,2
1668198197532,MATH 273A,A00,098046,Tian; Xiaochuan,10,0,15,5
1668198197958,MATH 275,A01,098048,Tian; Xiaochuan,6,0,10,4
1668198198381,MATH 278A,A00,098049,Holst; Michael J,8,0,10,2
1668198198809,MATH 278B,A00,098050,Cloninger; Alexander,10,0,10,0
1668198199231,MATH 278C,A00,098051,Nie; Jiawang,7,0,10,3
1668198199657,MATH 280B,A00,098052,Zheng; Tianyi,10,0,15,5
1668198200081,MATH 281B,A00,098053,Bradic; Jelena,2,0,15,13
1668198200507,MATH 282B,A00,098054,Arias-Castro; Ery,0,0,15,15
1668198200932,MATH 285,A00,098055,Fitzsimmons; Patrick J,0,0,15,17
1668198201357,MATH 287B,A00,098056,Arias-Castro; Ery,2,0,15,13
1668198201783,MATH 288,A00,098057,Agarwal; Pooja,9,0,10,1
1668198201783,MATH 288,B00,098058,Zhang; Danna,8,0,10,2
1668198201783,MATH 288,C00,098059,Williams; Ruth J,10,0,10,0
1668198202208,MATH 290B,A00,098060,Roberts; Justin Deritter,13,0,15,2
1668198202638,MATH 292,A00,098061,Belmont; Eva Kinoshita,10,0,10,0
1668198203062,MATH 295,A00,098062,Suk; Andrew Hoon,48,0,50,2
1668198203486,MATH 296,A00,098063,Novak; Jonathan I,20,0,20,0
1668198203916,MATH 297,001,098064,Gamst; Anthony Collins,9997,0,9999,2
1668198708839,COGS 205,A00,101395,Chiba; Andrea,19,0,20,1
1668198709265,COGS 210B,001,101404,Greene; Deanna Jacquelyn,9998,0,9999,1
1668198709265,COGS 210B,002,101417,Xia; Haijun,9999,0,9999,0
1668198709265,COGS 210B,003,101422,Nitz; Douglas A.,9999,0,9999,0
1668198709265,COGS 210B,004,101423,Hollan; James D.,9998,0,9999,1
1668198709265,COGS 210B,005,101424,Deak; Gedeon O.,9998,0,9999,1
1668198709265,COGS 210B,006,101425,Rossano; Federico,9999,0,9999,0
1668198709689,COGS 211B,A00,101427,Coulson; Seana M,9996,0,9999,3
1668198710120,COGS 220,A00,101428,Hollan; James D.,0,0,25,25
1668198710556,COGS 229,A00,101429,Dow; Steven P,18,0,25,7
1668198710981,COGS 230,A00,101430,Klemmer; Scott R,12,0,17,5
1668198711404,COGS 234,A00,101431,Xia; Haijun,3,0,25,22
1668198711828,COGS 260,A00,101432,Kiyonaga; Anastasia,20,0,25,5
1668198711828,COGS 260,B00,101433,Kirsh; David Joel,16,0,25,9
1668198712253,CSE 202,A00,102371,Impagliazzo; Russell,0,0,0,0
1668198712676,CSE 203B,A01,102373,Cheng; Chung Kuan,0,0,0,0
1668198713103,CSE 208,A00,102374,Micciancio; Daniele,0,0,0,0
1668198713525,CSE 209A,A00,112895,Impagliazzo; Russell,0,0,15,15
1668198713949,CSE 209B,A00,108005,Bellare; Mihir,0,0,0,0
1668198714375,CSE 210,A00,113163,Coblenz; Michael J,0,0,0,0
1668198714817,CSE 219,A00,106111,Dow; Steven P,0,0,20,20
1668198715251,CSE 221,A00,102376,Voelker; Geoffrey M.,0,0,0,0
1668198715676,CSE 224,A01,102378,Porter; George M,0,0,0,0
1668198716099,CSE 229A,A00,102379,Savage; Stefan,0,0,0,0
1668198716532,CSE 229C,A00,102380,Munyaka; Imani N. S.,0,0,0,0
1668198716955,CSE 232B,A00,102382,Deutsch; Alin Bernard,0,0,0,0
1668198717377,CSE 234,A01,112904,Kumar; Arun Kumar,0,0,0,0
1668198717812,CSE 237A,A00,102383,Rosing; Tajana Simunic,0,0,0,0
1668198718239,CSE 239A,A00,102384,Deutsch; Alin Bernard,0,0,0,0
1668198718663,CSE 239B,A00,102385,Polikarpova; Nadezhda,0,0,0,0
1668198719093,CSE 240A,A00,102386,Pannuto; Patrick William,0,0,0,0
1668198719521,CSE 240B,A00,102387,Zhao; Jishen,0,0,0,0
1668198719958,CSE 241A,A00,106406,Kang; Mingu,0,0,0,0
1668198720386,CSE 249B,A00,102388,Kahng; Andrew Byun,0,0,8,8
1668198720809,CSE 251B,A01,102392,Cottrell; Garrison W,0,0,0,0
1668198720809,CSE 251B,A02,102393,Cottrell; Garrison W,0,0,0,0
1668198721243,CSE 252B,A00,102394,Ochoa; Benjamin Lawrence,0,0,0,0
1668198721668,CSE 257,A01,102396,Gao; Sicun,0,0,0,0
1668198722099,CSE 272,A00,102397,Li; Tzumao,0,0,0,0
1668198722521,CSE 274,A00,111323,Chern; Albert Ren-Haur,0,0,0,0
1668198722943,CSE 282,A00,102398,Pevzner; Pavel Arkadjevich,0,0,0,0
1668198723373,CSE 284,A00,114175,Gymrek; Melissa Ann,0,0,0,0
1668198723810,CSE 290,A00,102399,Chandraker; Manmohan Krishna,0,0,0,0
1668198723810,CSE 290,B00,102400,Vaccaro; Kristen Marie,0,0,25,25
1668198723810,CSE 290,C00,102414,Pannuto; Patrick William,0,0,25,25
1668198723810,CSE 290,D00,102427,Pevzner; Pavel Arkadjevich,0,0,0,0
1668198723810,CSE 290,E00,102429,Zhao; Jishen,0,0,0,0
1668198723810,CSE 290,F00,102436,Tullsen; Dean Michael,0,0,0,0
1668198723810,CSE 290,G00,102440,Christensen; Henrik I,0,0,20,20
1668198724240,CSE 291,A00,102443,Su; Hao,0,0,0,0
1668198724240,CSE 291,B00,102448,Polikarpova; Nadezhda,0,0,0,0
1668198724240,CSE 291,C00,102453,Vaccaro; Kristen Marie,0,0,0,0
1668198724240,CSE 291,D00,111343,Savage; Stefan,0,0,0,0
1668198724240,CSE 291,E00,116474,Claffy; Kimberly Claire,0,0,0,0
1668198724240,CSE 291,F00,116479,Pasquale; Joseph,0,0,0,0
1668198724704,CSE 293,001,119111,Bafna; Vineet,9999,0,9999,0
1668198724704,CSE 293,002,119118,Bellare; Mihir,9999,0,9999,0
1668198724704,CSE 293,003,119122,Berg-Kirkpatrick; Taylor D,9999,0,9999,0
1668198724704,CSE 293,004,119135,Christensen; Henrik I,9999,0,9999,0
1668198724704,CSE 293,005,119142,Cottrell; Garrison W,9999,0,9999,0
1668198724704,CSE 293,006,119146,Deutsch; Alin Bernard,9999,0,9999,0
1668198724704,CSE 293,007,119159,Esmaeilzadeh; Hadi,9999,0,9999,0
1668198724704,CSE 293,008,119166,Freund; Yoav,9999,0,9999,0
1668198724704,CSE 293,009,119170,Griswold; William G.,9999,0,9999,0
1668198724704,CSE 293,010,119183,Gymrek; Melissa Ann,9999,0,9999,0
1668198724704,CSE 293,011,119190,Heninger; Nadia A,9999,0,9999,0
1668198724704,CSE 293,012,119230,Impagliazzo; Russell,9999,0,9999,0
1668198724704,CSE 293,013,119232,Jhala; Ranjit,9999,0,9999,0
1668198724704,CSE 293,014,119233,Kahng; Andrew Byun,9999,0,9999,0
1668198724704,CSE 293,015,119298,Kane; Daniel Mertz,9999,0,9999,0
1668198724704,CSE 293,016,119299,Kriegman; David J,9999,0,9999,0
1668198724704,CSE 293,017,119300,Kumar; Arun Kumar,9999,0,9999,0
1668198724704,CSE 293,018,119301,Lerner; Sorin,9999,0,9999,0
1668198724704,CSE 293,019,119302,Lovett; Shachar,9999,0,9999,0
1668198724704,CSE 293,020,119303,McAuley; Julian John,9999,0,9999,0
1668198724704,CSE 293,021,119304,Micciancio; Daniele,9999,0,9999,0
1668198724704,CSE 293,022,119367,Orailoglu; Alex,9999,0,9999,0
1668198724704,CSE 293,023,119382,Paturi; Ramamohan,9999,0,9999,0
1668198724704,CSE 293,024,119404,Polikarpova; Nadezhda,9999,0,9999,0
1668198724704,CSE 293,025,119406,Politz; Joseph Gibbs,9999,0,9999,0
1668198724704,CSE 293,026,119411,Porter; George M,9999,0,9999,0
1668198724704,CSE 293,027,119414,Porter; Leonard Emerson,9999,0,9999,0
1668198724704,CSE 293,028,119416,Ramamoorthi; Ravi,9999,0,9999,0
1668198724704,CSE 293,029,119417,Sahoo; Debashis,9999,0,9999,0
1668198724704,CSE 293,030,119420,Saul; Lawrence,9999,0,9999,0
1668198724704,CSE 293,031,119421,Savage; Stefan,9999,0,9999,0
1668198724704,CSE 293,032,119425,Schulze; Jurgen P.,9999,0,9999,0
1668198724704,CSE 293,033,119426,Snoeren; Alex C.,9999,0,9999,0
1668198724704,CSE 293,034,119428,Shang; Jingbo,9999,0,9999,0
1668198724704,CSE 293,035,119430,Stefan; Deian,9999,0,9999,0
1668198724704,CSE 293,036,119431,Su; Hao,9999,0,9999,0
1668198724704,CSE 293,037,119433,Swanson; Steven James,9999,0,9999,0
1668198724704,CSE 293,038,119435,Tullsen; Dean Michael,9999,0,9999,0
1668198724704,CSE 293,039,119483,Voelker; Geoffrey M.,9999,0,9999,0
1668198724704,CSE 293,040,119537,Zhao; Jishen,9999,0,9999,0
1668198724704,CSE 293,041,119538,Zhou; Yuan-Yuan,9999,0,9999,0
1668198724704,CSE 293,042,119539,Gao; Sicun,9999,0,9999,0
1668198724704,CSE 293,043,119540,Weibel; Nadir,9999,0,9999,0
1668198724704,CSE 293,044,119541,Gupta; Rajesh K.,9999,0,9999,0
1668198724704,CSE 293,045,126410,Vaccaro; Kristen Marie,9999,0,9999,0
1668198724704,CSE 293,046,126411,Klemke; Richard,9999,0,9999,0
1668198725141,CSE 294,A00,102459,Voelker; Geoffrey M.,0,0,0,0
1668198725141,CSE 294,B00,111322,Orailoglu; Alex,0,0,0,0
1668198725565,DSE 201,A00,096914,Deutsch; Alin Bernard,30,0,30,0
1668198725989,DSE 210,A00,096915,Dasgupta; Sanjoy,30,0,30,0
1668198726428,DSE 260A,A00,096916,Altintas De Callaf; Ilkay,30,0,30,0
1668198726896,ECE 200,001,103586,Antipa; Nicholas A,9999,0,9999,0
1668198726896,ECE 200,002,103587,Atanasov; Nikolay A.,9999,0,9999,0
1668198726896,ECE 200,003,103588,Bharadia; Dinesh,9999,0,9999,0
1668198726896,ECE 200,004,103589,Cheng; Chung Kuan,9999,0,9999,0
1668198726896,ECE 200,005,103590,Cosman; Pamela C.,9999,0,9999,0
1668198726896,ECE 200,006,103591,Dayeh; Shadi Ahmad,9999,0,9999,0
1668198726896,ECE 200,007,103592,Fainman; Yeshaiahu,9999,0,9999,0
1668198726896,ECE 200,008,103593,Ford; Joseph Earl,9999,0,9999,0
1668198726896,ECE 200,009,103594,Franceschetti; Massimo,9999,0,9999,0
1668198726896,ECE 200,010,103595,Fullerton; Eric E,9999,0,9999,0
1668198726896,ECE 200,011,103596,Galton; Ian A,9999,0,9999,0
1668198726896,ECE 200,012,103597,Gilja; Vikash,9999,0,9999,0
1668198726896,ECE 200,013,103598,Hall; Drew A.,9999,0,9999,0
1668198726896,ECE 200,014,103599,Hsueh; Tzu-Chien,9999,0,9999,0
1668198726896,ECE 200,015,103600,Javidi; Tara,9999,0,9999,0
1668198726896,ECE 200,016,103601,Kahng; Andrew Byun,9999,0,9999,0
1668198726896,ECE 200,017,103602,Kim; Young-Han,9999,0,9999,0
1668198726896,ECE 200,018,103603,Koushanfar; Farinaz,9999,0,9999,0
1668198726896,ECE 200,019,103604,Kuzum; Duygu,9999,0,9999,0
1668198726896,ECE 200,020,103605,Le; Hanh-Phuc,9999,0,9999,0
1668198726896,ECE 200,021,103606,Lin; Bill,9999,0,9999,0
1668198726896,ECE 200,022,103607,Liu; Zhaowei,9998,0,9999,1
1668198726896,ECE 200,023,103608,Lo; Yu-Hwa,9999,0,9999,0
1668198726896,ECE 200,024,103609,Lomakin; Vitaliy,9999,0,9999,0
1668198726896,ECE 200,025,103610,Mercier; Patrick Philip,9999,0,9999,0
1668198726896,ECE 200,026,103611,Meyer; Florian,9999,0,9999,0
1668198726896,ECE 200,027,103612,Milstein; Laurence B.,9999,0,9999,0
1668198726896,ECE 200,028,103613,Mir Arabbaygi; Siavash,9999,0,9999,0
1668198726896,ECE 200,029,103614,Mookherjea; Shayan,9999,0,9999,0
1668198726896,ECE 200,030,103615,Morris; Karcher William,9999,0,9999,0
1668198726896,ECE 200,031,103616,Ng; Tse Nga,9999,0,9999,0
1668198726896,ECE 200,032,103617,Nguyen; Truong Quang,9999,0,9999,0
1668198726896,ECE 200,033,103618,Nomura; Kenji,9999,0,9999,0
1668198726896,ECE 200,034,103619,Orlitsky; Alon,9999,0,9999,0
1668198726896,ECE 200,035,103620,Pal; Piya,9999,0,9999,0
1668198726896,ECE 200,036,103621,Papen; George C.,9999,0,9999,0
1668198726896,ECE 200,037,103622,Radic; Stojan,9999,0,9999,0
1668198726896,ECE 200,038,103623,Rao; Bhaskar D.,9999,0,9999,0
1668198726896,ECE 200,039,103624,Rao; Ramesh R,9999,0,9999,0
1668198726896,ECE 200,040,103625,Rebeiz; Gabriel,9999,0,9999,0
1668198726896,ECE 200,041,103626,Sanford; John R,9999,0,9999,0
1668198726896,ECE 200,042,103627,Siegel; Paul H.,9999,0,9999,0
1668198726896,ECE 200,043,103628,Sievenpiper; Daniel F.,9999,0,9999,0
1668198726896,ECE 200,044,103629,Sworder; David D.,9999,0,9999,0
1668198726896,ECE 200,045,103630,Taur; Yuan,9999,0,9999,0
1668198726896,ECE 200,046,103631,Touri; Behrouz,9999,0,9999,0
1668198726896,ECE 200,047,103632,Trivedi; Mohan M.,9999,0,9999,0
1668198726896,ECE 200,048,103633,Vasconcelos; Nuno,9999,0,9999,0
1668198726896,ECE 200,049,103634,Wang; Xiaolong,9999,0,9999,0
1668198726896,ECE 200,050,103635,Xie; Pengtao,9999,0,9999,0
1668198726896,ECE 200,051,103636,Yip; Michael,9999,0,9999,0
1668198726896,ECE 200,052,103637,Zeger; Kenneth A.,999,0,999,0
1668198726896,ECE 200,053,103638,Zhang; Xinyu,9999,0,9999,0
1668198726896,ECE 200,054,103639,Turakhia; Yatish Girish,9999,0,9999,0
1668198726896,ECE 200,055,103640,Kang; Mingu,9999,0,9999,0
1668198726896,ECE 200,056,103641,Shi; Yuanyuan,9999,0,9999,0
1668198726896,ECE 200,057,103642,Wang; Edward Jay,9999,0,9999,0
1668198726896,ECE 200,058,103643,Zheng; Yang,9999,0,9999,0
1668198727351,ECE 202,A00,103644,Kuzum; Duygu,0,0,0,0
1668198727784,ECE 212BN,A00,103646,Ng; Tse Nga,0,0,0,0
1668198728229,ECE 221,A00,111493,Staff,0,0,0,0
1668198728668,ECE 222B,A00,103647,Lomakin; Vitaliy,0,0,0,0
1668198729098,ECE 230B,A00,103648,Taur; Yuan,0,0,0,0
1668198729522,ECE 238B,A00,103649,Garay; Javier,0,0,0,0
1668198729948,ECE 240B,A00,112900,Fainman; Yeshaiahu,0,0,0,0
1668198730376,ECE 247A,A00,103650,Jokerst; Jesse Vincent,0,0,0,0
1668198730801,ECE 247B,A00,103651,Wang; Joseph,0,0,0,0
1668198731222,ECE 250,A00,103652,Siegel; Paul H.,0,0,0,0
1668198731653,ECE 251A,A00,103654,Rao; Bhaskar D.,0,0,0,0
1668198732082,ECE 257B,A00,103655,Bharadia; Dinesh,0,0,0,0
1668198732503,ECE 258A,A00,103656,Milstein; Laurence B.,0,0,0,0
1668198732941,ECE 260B,A00,103658,Kang; Mingu,0,0,0,0
1668198733362,ECE 264A,A00,103659,Galton; Ian A,0,0,0,0
1668198733786,ECE 265A,A00,103661,Gudem; Prasad S.S.,0,0,0,0
1668198734209,ECE 265D,A00,103662,Gudem; Prasad S.S.,0,0,0,0
1668198734642,ECE 268,A00,103663,Koushanfar; Farinaz,0,0,0,0
1668198735074,ECE 269,A01,103665,Pal; Piya,0,0,0,0
1668198735503,ECE 271B,A00,103666,Vasconcelos; Manuela,0,0,0,0
1668198735925,ECE 276A,A00,103667,Atanasov; Nikolay A.,0,0,0,0
1668198736438,ECE 277,A00,103668,An; Cheolhong,0,0,0,0
1668198736869,ECE 279,A00,117947,Hall; Drew A.,0,0,0,0
1668198737731,ECE 283,A00,103670,Hsueh; Tzu-Chien,0,0,0,0
1668198738161,ECE 284,A00,103671,Turakhia; Yatish Girish,0,0,0,0
1668198738585,ECE 285,A00,103672,Zheng; Yang,0,0,0,0
1668198738585,ECE 285,B00,103673,Sworder; David D.,0,0,0,0
1668198739007,ECE 287,A00,103676,Javidi; Tara,0,0,0,0
1668198739433,MATH 200B,A00,098023,Salehi Golsefidy; Alireza,12,0,15,3
1668198739857,MATH 202B,A00,098024,Rhoades; Brendon Patrick,9,0,15,6
1668198740287,MATH 203B,A00,098025,Oprea; Dragos N.,10,0,15,5
1668198740721,MATH 204B,A00,098026,Sorensen; Claus M,13,0,15,2
1668198741158,MATH 208,A00,098027,Izadi; Elham,7,0,10,3
1668198741581,MATH 209,A00,098028,Pollack; Aaron,10,0,10,0
1668198742011,MATH 211A,A00,112919,Rogalski; Daniel,9,0,10,1
1668198742439,MATH 211B,A00,112920,Seward; Brandon M.,9,0,10,1
1668198742862,MATH 218,A00,098029,Li; Bo,10,0,10,0
1668198743285,MATH 220B,A00,098030,Novak; Jonathan I,11,0,15,4
1668198743709,MATH 221A,A00,098031,Ebenfelt; Peter F,13,0,15,2
1668198744131,MATH 231B,A00,098032,Zlatos; Andrej,12,0,15,3
1668198744560,MATH 240B,A00,098033,Ni; Lei,9,0,15,6
1668198744984,MATH 243,A00,098034,Jekel; David Andrew,10,0,10,0
1668198745406,MATH 245A,A00,098035,Nie; Jiawang,0,0,15,16
1668198745833,MATH 248,A00,098036,Bejenaru; Ioan,10,0,10,0
1668198746259,MATH 250B,A00,098037,Spolaor; Luca,14,0,15,1
1668198746685,MATH 258,A00,098038,Ni; Lei,10,0,10,0
1668198747114,MATH 264B,A00,098041,Rhoades; Brendon Patrick,9,0,15,6
1668198747597,MATH 268,A00,098042,Buss; Samuel R,10,0,10,0
1668198748019,MATH 269,A00,098043,Rhoades; Brendon Patrick,10,0,10,0
1668198748442,MATH 270B,A00,098044,Li; Bo,10,0,15,5
1668198748868,MATH 272B,A00,098045,Holst; Michael J,13,0,15,2
1668198749306,MATH 273A,A00,098046,Tian; Xiaochuan,10,0,15,5
1668198749739,MATH 275,A01,098048,Tian; Xiaochuan,6,0,10,4
1668198750163,MATH 278A,A00,098049,Holst; Michael J,8,0,10,2
1668198750588,MATH 278B,A00,098050,Cloninger; Alexander,10,0,10,0
1668198751024,MATH 278C,A00,098051,Nie; Jiawang,7,0,10,3
1668198751458,MATH 280B,A00,098052,Zheng; Tianyi,10,0,15,5
1668198751893,MATH 281B,A00,098053,Bradic; Jelena,2,0,15,13
1668198752320,MATH 282B,A00,098054,Arias-Castro; Ery,0,0,15,15
1668198752759,MATH 285,A00,098055,Fitzsimmons; Patrick J,0,0,15,17
1668198753186,MATH 287B,A00,098056,Arias-Castro; Ery,2,0,15,13
1668198753623,MATH 288,A00,098057,Agarwal; Pooja,9,0,10,1
1668198753623,MATH 288,B00,098058,Zhang; Danna,8,0,10,2
1668198753623,MATH 288,C00,098059,Williams; Ruth J,10,0,10,0
1668198754049,MATH 290B,A00,098060,Roberts; Justin Deritter,13,0,15,2
1668198754477,MATH 292,A00,098061,Belmont; Eva Kinoshita,10,0,10,0
1668198754901,MATH 295,A00,098062,Suk; Andrew Hoon,48,0,50,2
1668198755326,MATH 296,A00,098063,Novak; Jonathan I,20,0,20,0
1668198755748,MATH 297,001,098064,Gamst; Anthony Collins,9997,0,9999,2
1668199267281,COGS 205,A00,101395,Chiba; Andrea,19,0,20,1
1668199267709,COGS 210B,001,101404,Greene; Deanna Jacquelyn,9998,0,9999,1
1668199267709,COGS 210B,002,101417,Xia; Haijun,9999,0,9999,0
1668199267709,COGS 210B,003,101422,Nitz; Douglas A.,9999,0,9999,0
1668199267709,COGS 210B,004,101423,Hollan; James D.,9998,0,9999,1
1668199267709,COGS 210B,005,101424,Deak; Gedeon O.,9998,0,9999,1
1668199267709,COGS 210B,006,101425,Rossano; Federico,9999,0,9999,0
1668199268223,COGS 211B,A00,101427,Coulson; Seana M,9996,0,9999,3
1668199268645,COGS 220,A00,101428,Hollan; James D.,0,0,25,25
1668199269069,COGS 229,A00,101429,Dow; Steven P,18,0,25,7
1668199269493,COGS 230,A00,101430,Klemmer; Scott R,12,0,17,5
1668199269919,COGS 234,A00,101431,Xia; Haijun,3,0,25,22
1668199270343,COGS 260,A00,101432,Kiyonaga; Anastasia,20,0,25,5
1668199270343,COGS 260,B00,101433,Kirsh; David Joel,16,0,25,9
1668199270765,CSE 202,A00,102371,Impagliazzo; Russell,0,0,0,0
1668199271199,CSE 203B,A01,102373,Cheng; Chung Kuan,0,0,0,0
1668199271629,CSE 208,A00,102374,Micciancio; Daniele,0,0,0,0
1668199272051,CSE 209A,A00,112895,Impagliazzo; Russell,0,0,15,15
1668199272475,CSE 209B,A00,108005,Bellare; Mihir,0,0,0,0
1668199272900,CSE 210,A00,113163,Coblenz; Michael J,0,0,0,0
1668199273330,CSE 219,A00,106111,Dow; Steven P,0,0,20,20
1668199273754,CSE 221,A00,102376,Voelker; Geoffrey M.,0,0,0,0
1668199274176,CSE 224,A01,102378,Porter; George M,0,0,0,0
1668199274600,CSE 229A,A00,102379,Savage; Stefan,0,0,0,0
1668199275025,CSE 229C,A00,102380,Munyaka; Imani N. S.,0,0,0,0
1668199275446,CSE 232B,A00,102382,Deutsch; Alin Bernard,0,0,0,0
1668199275872,CSE 234,A01,112904,Kumar; Arun Kumar,0,0,0,0
1668199276300,CSE 237A,A00,102383,Rosing; Tajana Simunic,0,0,0,0
1668199276726,CSE 239A,A00,102384,Deutsch; Alin Bernard,0,0,0,0
1668199277155,CSE 239B,A00,102385,Polikarpova; Nadezhda,0,0,0,0
1668199277586,CSE 240A,A00,102386,Pannuto; Patrick William,0,0,0,0
1668199278010,CSE 240B,A00,102387,Zhao; Jishen,0,0,0,0
1668199278434,CSE 241A,A00,106406,Kang; Mingu,0,0,0,0
1668199278858,CSE 249B,A00,102388,Kahng; Andrew Byun,0,0,8,8
1668199279283,CSE 251B,A01,102392,Cottrell; Garrison W,0,0,0,0
1668199279283,CSE 251B,A02,102393,Cottrell; Garrison W,0,0,0,0
1668199279705,CSE 252B,A00,102394,Ochoa; Benjamin Lawrence,0,0,0,0
1668199280137,CSE 257,A01,102396,Gao; Sicun,0,0,0,0
1668199280563,CSE 272,A00,102397,Li; Tzumao,0,0,0,0
1668199280985,CSE 274,A00,111323,Chern; Albert Ren-Haur,0,0,0,0
1668199281412,CSE 282,A00,102398,Pevzner; Pavel Arkadjevich,0,0,0,0
1668199281837,CSE 284,A00,114175,Gymrek; Melissa Ann,0,0,0,0
1668199282263,CSE 290,A00,102399,Chandraker; Manmohan Krishna,0,0,0,0
1668199282263,CSE 290,B00,102400,Vaccaro; Kristen Marie,0,0,25,25
1668199282263,CSE 290,C00,102414,Pannuto; Patrick William,0,0,25,25
1668199282263,CSE 290,D00,102427,Pevzner; Pavel Arkadjevich,0,0,0,0
1668199282263,CSE 290,E00,102429,Zhao; Jishen,0,0,0,0
1668199282263,CSE 290,F00,102436,Tullsen; Dean Michael,0,0,0,0
1668199282263,CSE 290,G00,102440,Christensen; Henrik I,0,0,20,20
1668199282697,CSE 291,A00,102443,Su; Hao,0,0,0,0
1668199282697,CSE 291,B00,102448,Polikarpova; Nadezhda,0,0,0,0
1668199282697,CSE 291,C00,102453,Vaccaro; Kristen Marie,0,0,0,0
1668199282697,CSE 291,D00,111343,Savage; Stefan,0,0,0,0
1668199282697,CSE 291,E00,116474,Claffy; Kimberly Claire,0,0,0,0
1668199282697,CSE 291,F00,116479,Pasquale; Joseph,0,0,0,0
1668199283131,CSE 293,001,119111,Bafna; Vineet,9999,0,9999,0
1668199283131,CSE 293,002,119118,Bellare; Mihir,9999,0,9999,0
1668199283131,CSE 293,003,119122,Berg-Kirkpatrick; Taylor D,9999,0,9999,0
1668199283131,CSE 293,004,119135,Christensen; Henrik I,9999,0,9999,0
1668199283131,CSE 293,005,119142,Cottrell; Garrison W,9999,0,9999,0
1668199283131,CSE 293,006,119146,Deutsch; Alin Bernard,9999,0,9999,0
1668199283131,CSE 293,007,119159,Esmaeilzadeh; Hadi,9999,0,9999,0
1668199283131,CSE 293,008,119166,Freund; Yoav,9999,0,9999,0
1668199283131,CSE 293,009,119170,Griswold; William G.,9999,0,9999,0
1668199283131,CSE 293,010,119183,Gymrek; Melissa Ann,9999,0,9999,0
1668199283131,CSE 293,011,119190,Heninger; Nadia A,9999,0,9999,0
1668199283131,CSE 293,012,119230,Impagliazzo; Russell,9999,0,9999,0
1668199283131,CSE 293,013,119232,Jhala; Ranjit,9999,0,9999,0
1668199283131,CSE 293,014,119233,Kahng; Andrew Byun,9999,0,9999,0
1668199283131,CSE 293,015,119298,Kane; Daniel Mertz,9999,0,9999,0
1668199283131,CSE 293,016,119299,Kriegman; David J,9999,0,9999,0
1668199283131,CSE 293,017,119300,Kumar; Arun Kumar,9999,0,9999,0
1668199283131,CSE 293,018,119301,Lerner; Sorin,9999,0,9999,0
1668199283131,CSE 293,019,119302,Lovett; Shachar,9999,0,9999,0
1668199283131,CSE 293,020,119303,McAuley; Julian John,9999,0,9999,0
1668199283131,CSE 293,021,119304,Micciancio; Daniele,9999,0,9999,0
1668199283131,CSE 293,022,119367,Orailoglu; Alex,9999,0,9999,0
1668199283131,CSE 293,023,119382,Paturi; Ramamohan,9999,0,9999,0
1668199283131,CSE 293,024,119404,Polikarpova; Nadezhda,9999,0,9999,0
1668199283131,CSE 293,025,119406,Politz; Joseph Gibbs,9999,0,9999,0
1668199283131,CSE 293,026,119411,Porter; George M,9999,0,9999,0
1668199283131,CSE 293,027,119414,Porter; Leonard Emerson,9999,0,9999,0
1668199283131,CSE 293,028,119416,Ramamoorthi; Ravi,9999,0,9999,0
1668199283131,CSE 293,029,119417,Sahoo; Debashis,9999,0,9999,0
1668199283131,CSE 293,030,119420,Saul; Lawrence,9999,0,9999,0
1668199283131,CSE 293,031,119421,Savage; Stefan,9999,0,9999,0
1668199283131,CSE 293,032,119425,Schulze; Jurgen P.,9999,0,9999,0
1668199283131,CSE 293,033,119426,Snoeren; Alex C.,9999,0,9999,0
1668199283131,CSE 293,034,119428,Shang; Jingbo,9999,0,9999,0
1668199283131,CSE 293,035,119430,Stefan; Deian,9999,0,9999,0
1668199283131,CSE 293,036,119431,Su; Hao,9999,0,9999,0
1668199283131,CSE 293,037,119433,Swanson; Steven James,9999,0,9999,0
1668199283131,CSE 293,038,119435,Tullsen; Dean Michael,9999,0,9999,0
1668199283131,CSE 293,039,119483,Voelker; Geoffrey M.,9999,0,9999,0
1668199283131,CSE 293,040,119537,Zhao; Jishen,9999,0,9999,0
1668199283131,CSE 293,041,119538,Zhou; Yuan-Yuan,9999,0,9999,0
1668199283131,CSE 293,042,119539,Gao; Sicun,9999,0,9999,0
1668199283131,CSE 293,043,119540,Weibel; Nadir,9999,0,9999,0
1668199283131,CSE 293,044,119541,Gupta; Rajesh K.,9999,0,9999,0
1668199283131,CSE 293,045,126410,Vaccaro; Kristen Marie,9999,0,9999,0
1668199283131,CSE 293,046,126411,Klemke; Richard,9999,0,9999,0
1668199283553,CSE 294,A00,102459,Voelker; Geoffrey M.,0,0,0,0
1668199283553,CSE 294,B00,111322,Orailoglu; Alex,0,0,0,0
1668199283984,DSE 201,A00,096914,Deutsch; Alin Bernard,30,0,30,0
1668199284409,DSE 210,A00,096915,Dasgupta; Sanjoy,30,0,30,0
1668199284834,DSE 260A,A00,096916,Altintas De Callaf; Ilkay,30,0,30,0
1668199285264,ECE 200,001,103586,Antipa; Nicholas A,9999,0,9999,0
1668199285264,ECE 200,002,103587,Atanasov; Nikolay A.,9999,0,9999,0
1668199285264,ECE 200,003,103588,Bharadia; Dinesh,9999,0,9999,0
1668199285264,ECE 200,004,103589,Cheng; Chung Kuan,9999,0,9999,0
1668199285264,ECE 200,005,103590,Cosman; Pamela C.,9999,0,9999,0
1668199285264,ECE 200,006,103591,Dayeh; Shadi Ahmad,9999,0,9999,0
1668199285264,ECE 200,007,103592,Fainman; Yeshaiahu,9999,0,9999,0
1668199285264,ECE 200,008,103593,Ford; Joseph Earl,9999,0,9999,0
1668199285264,ECE 200,009,103594,Franceschetti; Massimo,9999,0,9999,0
1668199285264,ECE 200,010,103595,Fullerton; Eric E,9999,0,9999,0
1668199285264,ECE 200,011,103596,Galton; Ian A,9999,0,9999,0
1668199285264,ECE 200,012,103597,Gilja; Vikash,9999,0,9999,0
1668199285264,ECE 200,013,103598,Hall; Drew A.,9999,0,9999,0
1668199285264,ECE 200,014,103599,Hsueh; Tzu-Chien,9999,0,9999,0
1668199285264,ECE 200,015,103600,Javidi; Tara,9999,0,9999,0
1668199285264,ECE 200,016,103601,Kahng; Andrew Byun,9999,0,9999,0
1668199285264,ECE 200,017,103602,Kim; Young-Han,9999,0,9999,0
1668199285264,ECE 200,018,103603,Koushanfar; Farinaz,9999,0,9999,0
1668199285264,ECE 200,019,103604,Kuzum; Duygu,9999,0,9999,0
1668199285264,ECE 200,020,103605,Le; Hanh-Phuc,9999,0,9999,0
1668199285264,ECE 200,021,103606,Lin; Bill,9999,0,9999,0
1668199285264,ECE 200,022,103607,Liu; Zhaowei,9998,0,9999,1
1668199285264,ECE 200,023,103608,Lo; Yu-Hwa,9999,0,9999,0
1668199285264,ECE 200,024,103609,Lomakin; Vitaliy,9999,0,9999,0
1668199285264,ECE 200,025,103610,Mercier; Patrick Philip,9999,0,9999,0
1668199285264,ECE 200,026,103611,Meyer; Florian,9999,0,9999,0
1668199285264,ECE 200,027,103612,Milstein; Laurence B.,9999,0,9999,0
1668199285264,ECE 200,028,103613,Mir Arabbaygi; Siavash,9999,0,9999,0
1668199285264,ECE 200,029,103614,Mookherjea; Shayan,9999,0,9999,0
1668199285264,ECE 200,030,103615,Morris; Karcher William,9999,0,9999,0
1668199285264,ECE 200,031,103616,Ng; Tse Nga,9999,0,9999,0
1668199285264,ECE 200,032,103617,Nguyen; Truong Quang,9999,0,9999,0
1668199285264,ECE 200,033,103618,Nomura; Kenji,9999,0,9999,0
1668199285264,ECE 200,034,103619,Orlitsky; Alon,9999,0,9999,0
1668199285264,ECE 200,035,103620,Pal; Piya,9999,0,9999,0
1668199285264,ECE 200,036,103621,Papen; George C.,9999,0,9999,0
1668199285264,ECE 200,037,103622,Radic; Stojan,9999,0,9999,0
1668199285264,ECE 200,038,103623,Rao; Bhaskar D.,9999,0,9999,0
1668199285264,ECE 200,039,103624,Rao; Ramesh R,9999,0,9999,0
1668199285264,ECE 200,040,103625,Rebeiz; Gabriel,9999,0,9999,0
1668199285264,ECE 200,041,103626,Sanford; John R,9999,0,9999,0
1668199285264,ECE 200,042,103627,Siegel; Paul H.,9999,0,9999,0
1668199285264,ECE 200,043,103628,Sievenpiper; Daniel F.,9999,0,9999,0
1668199285264,ECE 200,044,103629,Sworder; David D.,9999,0,9999,0
1668199285264,ECE 200,045,103630,Taur; Yuan,9999,0,9999,0
1668199285264,ECE 200,046,103631,Touri; Behrouz,9999,0,9999,0
1668199285264,ECE 200,047,103632,Trivedi; Mohan M.,9999,0,9999,0
1668199285264,ECE 200,048,103633,Vasconcelos; Nuno,9999,0,9999,0
1668199285264,ECE 200,049,103634,Wang; Xiaolong,9999,0,9999,0
1668199285264,ECE 200,050,103635,Xie; Pengtao,9999,0,9999,0
1668199285264,ECE 200,051,103636,Yip; Michael,9999,0,9999,0
1668199285264,ECE 200,052,103637,Zeger; Kenneth A.,999,0,999,0
1668199285264,ECE 200,053,103638,Zhang; Xinyu,9999,0,9999,0
1668199285264,ECE 200,054,103639,Turakhia; Yatish Girish,9999,0,9999,0
1668199285264,ECE 200,055,103640,Kang; Mingu,9999,0,9999,0
1668199285264,ECE 200,056,103641,Shi; Yuanyuan,9999,0,9999,0
1668199285264,ECE 200,057,103642,Wang; Edward Jay,9999,0,9999,0
1668199285264,ECE 200,058,103643,Zheng; Yang,9999,0,9999,0
1668199285696,ECE 202,A00,103644,Kuzum; Duygu,0,0,0,0
1668199286117,ECE 212BN,A00,103646,Ng; Tse Nga,0,0,0,0
1668199286542,ECE 221,A00,111493,Staff,0,0,0,0
1668199286969,ECE 222B,A00,103647,Lomakin; Vitaliy,0,0,0,0
1668199287393,ECE 230B,A00,103648,Taur; Yuan,0,0,0,0
1668199287817,ECE 238B,A00,103649,Garay; Javier,0,0,0,0
1668199288241,ECE 240B,A00,112900,Fainman; Yeshaiahu,0,0,0,0
1668199288679,ECE 247A,A00,103650,Jokerst; Jesse Vincent,0,0,0,0
1668199289119,ECE 247B,A00,103651,Wang; Joseph,0,0,0,0
1668199289546,ECE 250,A00,103652,Siegel; Paul H.,0,0,0,0
1668199289972,ECE 251A,A00,103654,Rao; Bhaskar D.,0,0,0,0
1668199290402,ECE 257B,A00,103655,Bharadia; Dinesh,0,0,0,0
1668199290840,ECE 258A,A00,103656,Milstein; Laurence B.,0,0,0,0
1668199291263,ECE 260B,A00,103658,Kang; Mingu,0,0,0,0
1668199291689,ECE 264A,A00,103659,Galton; Ian A,0,0,0,0
1668199292114,ECE 265A,A00,103661,Gudem; Prasad S.S.,0,0,0,0
1668199292539,ECE 265D,A00,103662,Gudem; Prasad S.S.,0,0,0,0
1668199292968,ECE 268,A00,103663,Koushanfar; Farinaz,0,0,0,0
1668199293403,ECE 269,A01,103665,Pal; Piya,0,0,0,0
1668199293832,ECE 271B,A00,103666,Vasconcelos; Manuela,0,0,0,0
1668199294257,ECE 276A,A00,103667,Atanasov; Nikolay A.,0,0,0,0
1668199294683,ECE 277,A00,103668,An; Cheolhong,0,0,0,0
1668199295110,ECE 279,A00,117947,Hall; Drew A.,0,0,0,0
1668199295973,ECE 283,A00,103670,Hsueh; Tzu-Chien,0,0,0,0
1668199296397,ECE 284,A00,103671,Turakhia; Yatish Girish,0,0,0,0
1668199296828,ECE 285,A00,103672,Zheng; Yang,0,0,0,0
1668199296828,ECE 285,B00,103673,Sworder; David D.,0,0,0,0
1668199297250,ECE 287,A00,103676,Javidi; Tara,0,0,0,0
1668199297682,MATH 200B,A00,098023,Salehi Golsefidy; Alireza,12,0,15,3
1668199298106,MATH 202B,A00,098024,Rhoades; Brendon Patrick,9,0,15,6
1668199298531,MATH 203B,A00,098025,Oprea; Dragos N.,10,0,15,5
1668199298955,MATH 204B,A00,098026,Sorensen; Claus M,13,0,15,2
1668199299377,MATH 208,A00,098027,Izadi; Elham,7,0,10,3
1668199299806,MATH 209,A00,098028,Pollack; Aaron,10,0,10,0
1668199300230,MATH 211A,A00,112919,Rogalski; Daniel,9,0,10,1
1668199300660,MATH 211B,A00,112920,Seward; Brandon M.,9,0,10,1
1668199301083,MATH 218,A00,098029,Li; Bo,10,0,10,0
1668199301507,MATH 220B,A00,098030,Novak; Jonathan I,11,0,15,4
1668199301934,MATH 221A,A00,098031,Ebenfelt; Peter F,13,0,15,2
1668199302364,MATH 231B,A00,098032,Zlatos; Andrej,12,0,15,3
1668199302793,MATH 240B,A00,098033,Ni; Lei,9,0,15,6
1668199303215,MATH 243,A00,098034,Jekel; David Andrew,10,0,10,0
1668199303641,MATH 245A,A00,098035,Nie; Jiawang,0,0,15,16
1668199304064,MATH 248,A00,098036,Bejenaru; Ioan,10,0,10,0
1668199304492,MATH 250B,A00,098037,Spolaor; Luca,14,0,15,1
1668199304919,MATH 258,A00,098038,Ni; Lei,10,0,10,0
1668199305342,MATH 264B,A00,098041,Rhoades; Brendon Patrick,9,0,15,6
1668199305773,MATH 268,A00,098042,Buss; Samuel R,10,0,10,0
1668199306195,MATH 269,A00,098043,Rhoades; Brendon Patrick,10,0,10,0
1668199306620,MATH 270B,A00,098044,Li; Bo,10,0,15,5
1668199307041,MATH 272B,A00,098045,Holst; Michael J,13,0,15,2
1668199307464,MATH 273A,A00,098046,Tian; Xiaochuan,10,0,15,5
1668199307901,MATH 275,A01,098048,Tian; Xiaochuan,6,0,10,4
1668199308323,MATH 278A,A00,098049,Holst; Michael J,8,0,10,2
1668199308747,MATH 278B,A00,098050,Cloninger; Alexander,10,0,10,0
1668199309171,MATH 278C,A00,098051,Nie; Jiawang,7,0,10,3
1668199309593,MATH 280B,A00,098052,Zheng; Tianyi,10,0,15,5
1668199310019,MATH 281B,A00,098053,Bradic; Jelena,2,0,15,13
1668199310445,MATH 282B,A00,098054,Arias-Castro; Ery,0,0,15,15
1668199310882,MATH 285,A00,098055,Fitzsimmons; Patrick J,0,0,15,17
1668199311386,MATH 287B,A00,098056,Arias-Castro; Ery,2,0,15,13
1668199311809,MATH 288,A00,098057,Agarwal; Pooja,9,0,10,1
1668199311809,MATH 288,B00,098058,Zhang; Danna,8,0,10,2
1668199311809,MATH 288,C00,098059,Williams; Ruth J,10,0,10,0
1668199312233,MATH 290B,A00,098060,Roberts; Justin Deritter,13,0,15,2
1668199312659,MATH 292,A00,098061,Belmont; Eva Kinoshita,10,0,10,0
1668199313088,MATH 295,A00,098062,Suk; Andrew Hoon,48,0,50,2
1668199313528,MATH 296,A00,098063,Novak; Jonathan I,20,0,20,0
1668199313950,MATH 297,001,098064,Gamst; Anthony Collins,9997,0,9999,2
1668199815549,COGS 205,A00,101395,Chiba; Andrea,19,0,20,1
1668199815976,COGS 210B,001,101404,Greene; Deanna Jacquelyn,9998,0,9999,1
1668199815976,COGS 210B,002,101417,Xia; Haijun,9999,0,9999,0
1668199815976,COGS 210B,003,101422,Nitz; Douglas A.,9999,0,9999,0
1668199815976,COGS 210B,004,101423,Hollan; James D.,9998,0,9999,1
1668199815976,COGS 210B,005,101424,Deak; Gedeon O.,9998,0,9999,1
1668199815976,COGS 210B,006,101425,Rossano; Federico,9999,0,9999,0
1668199816401,COGS 211B,A00,101427,Coulson; Seana M,9996,0,9999,3
1668199816834,COGS 220,A00,101428,Hollan; James D.,0,0,25,25
1668199817258,COGS 229,A00,101429,Dow; Steven P,18,0,25,7
1668199817680,COGS 230,A00,101430,Klemmer; Scott R,12,0,17,5
1668199818103,COGS 234,A00,101431,Xia; Haijun,3,0,25,22
1668199818536,COGS 260,A00,101432,Kiyonaga; Anastasia,21,0,25,4
1668199818536,COGS 260,B00,101433,Kirsh; David Joel,16,0,25,9
1668199818972,CSE 202,A00,102371,Impagliazzo; Russell,0,0,0,0
1668199819401,CSE 203B,A01,102373,Cheng; Chung Kuan,0,0,0,0
1668199819823,CSE 208,A00,102374,Micciancio; Daniele,0,0,0,0
1668199820247,CSE 209A,A00,112895,Impagliazzo; Russell,0,0,15,15
1668199820679,CSE 209B,A00,108005,Bellare; Mihir,0,0,0,0
1668199821101,CSE 210,A00,113163,Coblenz; Michael J,0,0,0,0
1668199821523,CSE 219,A00,106111,Dow; Steven P,0,0,20,20
1668199821956,CSE 221,A00,102376,Voelker; Geoffrey M.,0,0,0,0
1668199822380,CSE 224,A01,102378,Porter; George M,0,0,0,0
1668199822803,CSE 229A,A00,102379,Savage; Stefan,0,0,0,0
1668199823226,CSE 229C,A00,102380,Munyaka; Imani N. S.,0,0,0,0
1668199823647,CSE 232B,A00,102382,Deutsch; Alin Bernard,0,0,0,0
1668199824073,CSE 234,A01,112904,Kumar; Arun Kumar,0,0,0,0
1668199824499,CSE 237A,A00,102383,Rosing; Tajana Simunic,0,0,0,0
1668199824924,CSE 239A,A00,102384,Deutsch; Alin Bernard,0,0,0,0
1668199825352,CSE 239B,A00,102385,Polikarpova; Nadezhda,0,0,0,0
1668199825789,CSE 240A,A00,102386,Pannuto; Patrick William,0,0,0,0
1668199826211,CSE 240B,A00,102387,Zhao; Jishen,0,0,0,0
1668199826639,CSE 241A,A00,106406,Kang; Mingu,0,0,0,0
1668199827062,CSE 249B,A00,102388,Kahng; Andrew Byun,0,0,8,8
1668199827487,CSE 251B,A01,102392,Cottrell; Garrison W,0,0,0,0
1668199827487,CSE 251B,A02,102393,Cottrell; Garrison W,0,0,0,0
1668199827909,CSE 252B,A00,102394,Ochoa; Benjamin Lawrence,0,0,0,0
1668199828333,CSE 257,A01,102396,Gao; Sicun,0,0,0,0
1668199828764,CSE 272,A00,102397,Li; Tzumao,0,0,0,0
1668199829188,CSE 274,A00,111323,Chern; Albert Ren-Haur,0,0,0,0
1668199829621,CSE 282,A00,102398,Pevzner; Pavel Arkadjevich,0,0,0,0
1668199830043,CSE 284,A00,114175,Gymrek; Melissa Ann,0,0,0,0
1668199830466,CSE 290,A00,102399,Chandraker; Manmohan Krishna,0,0,0,0
1668199830466,CSE 290,B00,102400,Vaccaro; Kristen Marie,0,0,25,25
1668199830466,CSE 290,C00,102414,Pannuto; Patrick William,0,0,25,25
1668199830466,CSE 290,D00,102427,Pevzner; Pavel Arkadjevich,0,0,0,0
1668199830466,CSE 290,E00,102429,Zhao; Jishen,0,0,0,0
1668199830466,CSE 290,F00,102436,Tullsen; Dean Michael,0,0,0,0
1668199830466,CSE 290,G00,102440,Christensen; Henrik I,0,0,20,20
1668199830889,CSE 291,A00,102443,Su; Hao,0,0,0,0
1668199830889,CSE 291,B00,102448,Polikarpova; Nadezhda,0,0,0,0
1668199830889,CSE 291,C00,102453,Vaccaro; Kristen Marie,0,0,0,0
1668199830889,CSE 291,D00,111343,Savage; Stefan,0,0,0,0
1668199830889,CSE 291,E00,116474,Claffy; Kimberly Claire,0,0,0,0
1668199830889,CSE 291,F00,116479,Pasquale; Joseph,0,0,0,0
1668199831329,CSE 293,001,119111,Bafna; Vineet,9999,0,9999,0
1668199831329,CSE 293,002,119118,Bellare; Mihir,9999,0,9999,0
1668199831329,CSE 293,003,119122,Berg-Kirkpatrick; Taylor D,9999,0,9999,0
1668199831329,CSE 293,004,119135,Christensen; Henrik I,9999,0,9999,0
1668199831329,CSE 293,005,119142,Cottrell; Garrison W,9999,0,9999,0
1668199831329,CSE 293,006,119146,Deutsch; Alin Bernard,9999,0,9999,0
1668199831329,CSE 293,007,119159,Esmaeilzadeh; Hadi,9999,0,9999,0
1668199831329,CSE 293,008,119166,Freund; Yoav,9999,0,9999,0
1668199831329,CSE 293,009,119170,Griswold; William G.,9999,0,9999,0
1668199831329,CSE 293,010,119183,Gymrek; Melissa Ann,9999,0,9999,0
1668199831329,CSE 293,011,119190,Heninger; Nadia A,9999,0,9999,0
1668199831329,CSE 293,012,119230,Impagliazzo; Russell,9999,0,9999,0
1668199831329,CSE 293,013,119232,Jhala; Ranjit,9999,0,9999,0
1668199831329,CSE 293,014,119233,Kahng; Andrew Byun,9999,0,9999,0
1668199831329,CSE 293,015,119298,Kane; Daniel Mertz,9999,0,9999,0
1668199831329,CSE 293,016,119299,Kriegman; David J,9999,0,9999,0
1668199831329,CSE 293,017,119300,Kumar; Arun Kumar,9999,0,9999,0
1668199831329,CSE 293,018,119301,Lerner; Sorin,9999,0,9999,0
1668199831329,CSE 293,019,119302,Lovett; Shachar,9999,0,9999,0
1668199831329,CSE 293,020,119303,McAuley; Julian John,9999,0,9999,0
1668199831329,CSE 293,021,119304,Micciancio; Daniele,9999,0,9999,0
1668199831329,CSE 293,022,119367,Orailoglu; Alex,9999,0,9999,0
1668199831329,CSE 293,023,119382,Paturi; Ramamohan,9999,0,9999,0
1668199831329,CSE 293,024,119404,Polikarpova; Nadezhda,9999,0,9999,0
1668199831329,CSE 293,025,119406,Politz; Joseph Gibbs,9999,0,9999,0
1668199831329,CSE 293,026,119411,Porter; George M,9999,0,9999,0
1668199831329,CSE 293,027,119414,Porter; Leonard Emerson,9999,0,9999,0
1668199831329,CSE 293,028,119416,Ramamoorthi; Ravi,9999,0,9999,0
1668199831329,CSE 293,029,119417,Sahoo; Debashis,9999,0,9999,0
1668199831329,CSE 293,030,119420,Saul; Lawrence,9999,0,9999,0
1668199831329,CSE 293,031,119421,Savage; Stefan,9999,0,9999,0
1668199831329,CSE 293,032,119425,Schulze; Jurgen P.,9999,0,9999,0
1668199831329,CSE 293,033,119426,Snoeren; Alex C.,9999,0,9999,0
1668199831329,CSE 293,034,119428,Shang; Jingbo,9999,0,9999,0
1668199831329,CSE 293,035,119430,Stefan; Deian,9999,0,9999,0
1668199831329,CSE 293,036,119431,Su; Hao,9999,0,9999,0
1668199831329,CSE 293,037,119433,Swanson; Steven James,9999,0,9999,0
1668199831329,CSE 293,038,119435,Tullsen; Dean Michael,9999,0,9999,0
1668199831329,CSE 293,039,119483,Voelker; Geoffrey M.,9999,0,9999,0
1668199831329,CSE 293,040,119537,Zhao; Jishen,9999,0,9999,0
1668199831329,CSE 293,041,119538,Zhou; Yuan-Yuan,9999,0,9999,0
1668199831329,CSE 293,042,119539,Gao; Sicun,9999,0,9999,0
1668199831329,CSE 293,043,119540,Weibel; Nadir,9999,0,9999,0
1668199831329,CSE 293,044,119541,Gupta; Rajesh K.,9999,0,9999,0
1668199831329,CSE 293,045,126410,Vaccaro; Kristen Marie,9999,0,9999,0
1668199831329,CSE 293,046,126411,Klemke; Richard,9999,0,9999,0
1668199831752,CSE 294,A00,102459,Voelker; Geoffrey M.,0,0,0,0
1668199831752,CSE 294,B00,111322,Orailoglu; Alex,0,0,0,0
1668199832174,DSE 201,A00,096914,Deutsch; Alin Bernard,30,0,30,0
1668199832600,DSE 210,A00,096915,Dasgupta; Sanjoy,30,0,30,0
1668199833112,DSE 260A,A00,096916,Altintas De Callaf; Ilkay,30,0,30,0
1668199833555,ECE 200,001,103586,Antipa; Nicholas A,9999,0,9999,0
1668199833555,ECE 200,002,103587,Atanasov; Nikolay A.,9999,0,9999,0
1668199833555,ECE 200,003,103588,Bharadia; Dinesh,9999,0,9999,0
1668199833555,ECE 200,004,103589,Cheng; Chung Kuan,9999,0,9999,0
1668199833555,ECE 200,005,103590,Cosman; Pamela C.,9999,0,9999,0
1668199833555,ECE 200,006,103591,Dayeh; Shadi Ahmad,9999,0,9999,0
1668199833555,ECE 200,007,103592,Fainman; Yeshaiahu,9999,0,9999,0
1668199833555,ECE 200,008,103593,Ford; Joseph Earl,9999,0,9999,0
1668199833555,ECE 200,009,103594,Franceschetti; Massimo,9999,0,9999,0
1668199833555,ECE 200,010,103595,Fullerton; Eric E,9999,0,9999,0
1668199833555,ECE 200,011,103596,Galton; Ian A,9999,0,9999,0
1668199833555,ECE 200,012,103597,Gilja; Vikash,9999,0,9999,0
1668199833555,ECE 200,013,103598,Hall; Drew A.,9999,0,9999,0
1668199833555,ECE 200,014,103599,Hsueh; Tzu-Chien,9999,0,9999,0
1668199833555,ECE 200,015,103600,Javidi; Tara,9999,0,9999,0
1668199833555,ECE 200,016,103601,Kahng; Andrew Byun,9999,0,9999,0
1668199833555,ECE 200,017,103602,Kim; Young-Han,9999,0,9999,0
1668199833555,ECE 200,018,103603,Koushanfar; Farinaz,9999,0,9999,0
1668199833555,ECE 200,019,103604,Kuzum; Duygu,9999,0,9999,0
1668199833555,ECE 200,020,103605,Le; Hanh-Phuc,9999,0,9999,0
1668199833555,ECE 200,021,103606,Lin; Bill,9999,0,9999,0
1668199833555,ECE 200,022,103607,Liu; Zhaowei,9998,0,9999,1
1668199833555,ECE 200,023,103608,Lo; Yu-Hwa,9999,0,9999,0
1668199833555,ECE 200,024,103609,Lomakin; Vitaliy,9999,0,9999,0
1668199833555,ECE 200,025,103610,Mercier; Patrick Philip,9999,0,9999,0
1668199833555,ECE 200,026,103611,Meyer; Florian,9999,0,9999,0
1668199833555,ECE 200,027,103612,Milstein; Laurence B.,9999,0,9999,0
1668199833555,ECE 200,028,103613,Mir Arabbaygi; Siavash,9999,0,9999,0
1668199833555,ECE 200,029,103614,Mookherjea; Shayan,9999,0,9999,0
1668199833555,ECE 200,030,103615,Morris; Karcher William,9999,0,9999,0
1668199833555,ECE 200,031,103616,Ng; Tse Nga,9999,0,9999,0
1668199833555,ECE 200,032,103617,Nguyen; Truong Quang,9999,0,9999,0
1668199833555,ECE 200,033,103618,Nomura; Kenji,9999,0,9999,0
1668199833555,ECE 200,034,103619,Orlitsky; Alon,9999,0,9999,0
1668199833555,ECE 200,035,103620,Pal; Piya,9999,0,9999,0
1668199833555,ECE 200,036,103621,Papen; George C.,9999,0,9999,0
1668199833555,ECE 200,037,103622,Radic; Stojan,9999,0,9999,0
1668199833555,ECE 200,038,103623,Rao; Bhaskar D.,9999,0,9999,0
1668199833555,ECE 200,039,103624,Rao; Ramesh R,9999,0,9999,0
1668199833555,ECE 200,040,103625,Rebeiz; Gabriel,9999,0,9999,0
1668199833555,ECE 200,041,103626,Sanford; John R,9999,0,9999,0
1668199833555,ECE 200,042,103627,Siegel; Paul H.,9999,0,9999,0
1668199833555,ECE 200,043,103628,Sievenpiper; Daniel F.,9999,0,9999,0
1668199833555,ECE 200,044,103629,Sworder; David D.,9999,0,9999,0
1668199833555,ECE 200,045,103630,Taur; Yuan,9999,0,9999,0
1668199833555,ECE 200,046,103631,Touri; Behrouz,9999,0,9999,0
1668199833555,ECE 200,047,103632,Trivedi; Mohan M.,9999,0,9999,0
1668199833555,ECE 200,048,103633,Vasconcelos; Nuno,9999,0,9999,0
1668199833555,ECE 200,049,103634,Wang; Xiaolong,9999,0,9999,0
1668199833555,ECE 200,050,103635,Xie; Pengtao,9999,0,9999,0
1668199833555,ECE 200,051,103636,Yip; Michael,9999,0,9999,0
1668199833555,ECE 200,052,103637,Zeger; Kenneth A.,999,0,999,0
1668199833555,ECE 200,053,103638,Zhang; Xinyu,9999,0,9999,0
1668199833555,ECE 200,054,103639,Turakhia; Yatish Girish,9999,0,9999,0
1668199833555,ECE 200,055,103640,Kang; Mingu,9999,0,9999,0
1668199833555,ECE 200,056,103641,Shi; Yuanyuan,9999,0,9999,0
1668199833555,ECE 200,057,103642,Wang; Edward Jay,9999,0,9999,0
1668199833555,ECE 200,058,103643,Zheng; Yang,9999,0,9999,0
1668199833983,ECE 202,A00,103644,Kuzum; Duygu,0,0,0,0
1668199834406,ECE 212BN,A00,103646,Ng; Tse Nga,0,0,0,0
1668199834827,ECE 221,A00,111493,Staff,0,0,0,0
1668199835252,ECE 222B,A00,103647,Lomakin; Vitaliy,0,0,0,0
1668199835680,ECE 230B,A00,103648,Taur; Yuan,0,0,0,0
1668199836121,ECE 238B,A00,103649,Garay; Javier,0,0,0,0
1668199836561,ECE 240B,A00,112900,Fainman; Yeshaiahu,0,0,0,0
1668199836984,ECE 247A,A00,103650,Jokerst; Jesse Vincent,0,0,0,0
1668199837408,ECE 247B,A00,103651,Wang; Joseph,0,0,0,0
1668199837839,ECE 250,A00,103652,Siegel; Paul H.,0,0,0,0
1668199838281,ECE 251A,A00,103654,Rao; Bhaskar D.,0,0,0,0
1668199838709,ECE 257B,A00,103655,Bharadia; Dinesh,0,0,0,0
1668199839134,ECE 258A,A00,103656,Milstein; Laurence B.,0,0,0,0
1668199839573,ECE 260B,A00,103658,Kang; Mingu,0,0,0,0
1668199839994,ECE 264A,A00,103659,Galton; Ian A,0,0,0,0
1668199840416,ECE 265A,A00,103661,Gudem; Prasad S.S.,0,0,0,0
1668199840840,ECE 265D,A00,103662,Gudem; Prasad S.S.,0,0,0,0
1668199841262,ECE 268,A00,103663,Koushanfar; Farinaz,0,0,0,0
1668199841689,ECE 269,A01,103665,Pal; Piya,0,0,0,0
1668199842115,ECE 271B,A00,103666,Vasconcelos; Manuela,0,0,0,0
1668199842538,ECE 276A,A00,103667,Atanasov; Nikolay A.,0,0,0,0
1668199842980,ECE 277,A00,103668,An; Cheolhong,0,0,0,0
1668199843404,ECE 279,A00,117947,Hall; Drew A.,0,0,0,0
1668199844255,ECE 283,A00,103670,Hsueh; Tzu-Chien,0,0,0,0
1668199844677,ECE 284,A00,103671,Turakhia; Yatish Girish,0,0,0,0
1668199845102,ECE 285,A00,103672,Zheng; Yang,0,0,0,0
1668199845102,ECE 285,B00,103673,Sworder; David D.,0,0,0,0
1668199845535,ECE 287,A00,103676,Javidi; Tara,0,0,0,0
1668199845967,MATH 200B,A00,098023,Salehi Golsefidy; Alireza,12,0,15,3
1668199846393,MATH 202B,A00,098024,Rhoades; Brendon Patrick,9,0,15,6
1668199846817,MATH 203B,A00,098025,Oprea; Dragos N.,10,0,15,5
1668199847243,MATH 204B,A00,098026,Sorensen; Claus M,13,0,15,2
1668199847679,MATH 208,A00,098027,Izadi; Elham,7,0,10,3
1668199848103,MATH 209,A00,098028,Pollack; Aaron,10,0,10,0
1668199848527,MATH 211A,A00,112919,Rogalski; Daniel,9,0,10,1
1668199848963,MATH 211B,A00,112920,Seward; Brandon M.,9,0,10,1
1668199849388,MATH 218,A00,098029,Li; Bo,10,0,10,0
1668199849824,MATH 220B,A00,098030,Novak; Jonathan I,11,0,15,4
1668199850250,MATH 221A,A00,098031,Ebenfelt; Peter F,13,0,15,2
1668199850674,MATH 231B,A00,098032,Zlatos; Andrej,12,0,15,3
1668199851101,MATH 240B,A00,098033,Ni; Lei,9,0,15,6
1668199851532,MATH 243,A00,098034,Jekel; David Andrew,10,0,10,0
1668199851968,MATH 245A,A00,098035,Nie; Jiawang,0,0,15,16
1668199852390,MATH 248,A00,098036,Bejenaru; Ioan,10,0,10,0
1668199852814,MATH 250B,A00,098037,Spolaor; Luca,14,0,15,1
1668199853237,MATH 258,A00,098038,Ni; Lei,10,0,10,0
1668199853663,MATH 264B,A00,098041,Rhoades; Brendon Patrick,9,0,15,6
1668199854087,MATH 268,A00,098042,Buss; Samuel R,10,0,10,0
1668199854517,MATH 269,A00,098043,Rhoades; Brendon Patrick,10,0,10,0
1668199854942,MATH 270B,A00,098044,Li; Bo,10,0,15,5
1668199855369,MATH 272B,A00,098045,Holst; Michael J,13,0,15,2
1668199855793,MATH 273A,A00,098046,Tian; Xiaochuan,10,0,15,5
1668199856228,MATH 275,A01,098048,Tian; Xiaochuan,6,0,10,4
1668199856660,MATH 278A,A00,098049,Holst; Michael J,8,0,10,2
1668199857101,MATH 278B,A00,098050,Cloninger; Alexander,10,0,10,0
1668199857524,MATH 278C,A00,098051,Nie; Jiawang,7,0,10,3
1668199857949,MATH 280B,A00,098052,Zheng; Tianyi,10,0,15,5
1668199858371,MATH 281B,A00,098053,Bradic; Jelena,2,0,15,13
1668199858810,MATH 282B,A00,098054,Arias-Castro; Ery,0,0,15,15
1668199859237,MATH 285,A00,098055,Fitzsimmons; Patrick J,0,0,15,17
1668199859663,MATH 287B,A00,098056,Arias-Castro; Ery,2,0,15,13
1668199860093,MATH 288,A00,098057,Agarwal; Pooja,9,0,10,1
1668199860093,MATH 288,B00,098058,Zhang; Danna,8,0,10,2
1668199860093,MATH 288,C00,098059,Williams; Ruth J,10,0,10,0
1668199860518,MATH 290B,A00,098060,Roberts; Justin Deritter,13,0,15,2
1668199860945,MATH 292,A00,098061,Belmont; Eva Kinoshita,10,0,10,0
1668199861369,MATH 295,A00,098062,Suk; Andrew Hoon,48,0,50,2
1668199861793,MATH 296,A00,098063,Novak; Jonathan I,20,0,20,0
1668199862215,MATH 297,001,098064,Gamst; Anthony Collins,9997,0,9999,2
1668200363649,COGS 205,A00,101395,Chiba; Andrea,19,0,20,1
1668200364073,COGS 210B,001,101404,Greene; Deanna Jacquelyn,9998,0,9999,1
1668200364073,COGS 210B,002,101417,Xia; Haijun,9999,0,9999,0
1668200364073,COGS 210B,003,101422,Nitz; Douglas A.,9999,0,9999,0
1668200364073,COGS 210B,004,101423,Hollan; James D.,9998,0,9999,1
1668200364073,COGS 210B,005,101424,Deak; Gedeon O.,9998,0,9999,1
1668200364073,COGS 210B,006,101425,Rossano; Federico,9999,0,9999,0
1668200364511,COGS 211B,A00,101427,Coulson; Seana M,9996,0,9999,3
1668200364933,COGS 220,A00,101428,Hollan; James D.,0,0,25,25
1668200365364,COGS 229,A00,101429,Dow; Steven P,18,0,25,7
1668200365795,COGS 230,A00,101430,Klemmer; Scott R,12,0,17,5
1668200366219,COGS 234,A00,101431,Xia; Haijun,2,0,25,23
1668200366642,COGS 260,A00,101432,Kiyonaga; Anastasia,21,0,25,4
1668200366642,COGS 260,B00,101433,Kirsh; David Joel,16,0,25,9
1668200367077,CSE 202,A00,102371,Impagliazzo; Russell,0,0,0,0
1668200367499,CSE 203B,A01,102373,Cheng; Chung Kuan,0,0,0,0
1668200367926,CSE 208,A00,102374,Micciancio; Daniele,0,0,0,0
1668200368347,CSE 209A,A00,112895,Impagliazzo; Russell,0,0,15,15
1668200368770,CSE 209B,A00,108005,Bellare; Mihir,0,0,0,0
1668200369200,CSE 210,A00,113163,Coblenz; Michael J,0,0,0,0
1668200369633,CSE 219,A00,106111,Dow; Steven P,0,0,20,20
1668200370058,CSE 221,A00,102376,Voelker; Geoffrey M.,0,0,0,0
1668200370483,CSE 224,A01,102378,Porter; George M,0,0,0,0
1668200370908,CSE 229A,A00,102379,Savage; Stefan,0,0,0,0
1668200371338,CSE 229C,A00,102380,Munyaka; Imani N. S.,0,0,0,0
1668200371764,CSE 232B,A00,102382,Deutsch; Alin Bernard,0,0,0,0
1668200372187,CSE 234,A01,112904,Kumar; Arun Kumar,0,0,0,0
1668200372613,CSE 237A,A00,102383,Rosing; Tajana Simunic,0,0,0,0
1668200373037,CSE 239A,A00,102384,Deutsch; Alin Bernard,0,0,0,0
1668200373464,CSE 239B,A00,102385,Polikarpova; Nadezhda,0,0,0,0
1668200373888,CSE 240A,A00,102386,Pannuto; Patrick William,0,0,0,0
1668200374317,CSE 240B,A00,102387,Zhao; Jishen,0,0,0,0
1668200374742,CSE 241A,A00,106406,Kang; Mingu,0,0,0,0
1668200375164,CSE 249B,A00,102388,Kahng; Andrew Byun,0,0,8,8
1668200375586,CSE 251B,A01,102392,Cottrell; Garrison W,0,0,0,0
1668200375586,CSE 251B,A02,102393,Cottrell; Garrison W,0,0,0,0
1668200376009,CSE 252B,A00,102394,Ochoa; Benjamin Lawrence,0,0,0,0
1668200376432,CSE 257,A01,102396,Gao; Sicun,0,0,0,0
1668200376869,CSE 272,A00,102397,Li; Tzumao,0,0,0,0
1668200377291,CSE 274,A00,111323,Chern; Albert Ren-Haur,0,0,0,0
1668200377714,CSE 282,A00,102398,Pevzner; Pavel Arkadjevich,0,0,0,0
1668200378140,CSE 284,A00,114175,Gymrek; Melissa Ann,0,0,0,0
1668200378568,CSE 290,A00,102399,Chandraker; Manmohan Krishna,0,0,0,0
1668200378568,CSE 290,B00,102400,Vaccaro; Kristen Marie,0,0,25,25
1668200378568,CSE 290,C00,102414,Pannuto; Patrick William,0,0,25,25
1668200378568,CSE 290,D00,102427,Pevzner; Pavel Arkadjevich,0,0,0,0
1668200378568,CSE 290,E00,102429,Zhao; Jishen,0,0,0,0
1668200378568,CSE 290,F00,102436,Tullsen; Dean Michael,0,0,0,0
1668200378568,CSE 290,G00,102440,Christensen; Henrik I,0,0,20,20
1668200378998,CSE 291,A00,102443,Su; Hao,0,0,0,0
1668200378998,CSE 291,B00,102448,Polikarpova; Nadezhda,0,0,0,0
1668200378998,CSE 291,C00,102453,Vaccaro; Kristen Marie,0,0,0,0
1668200378998,CSE 291,D00,111343,Savage; Stefan,0,0,0,0
1668200378998,CSE 291,E00,116474,Claffy; Kimberly Claire,0,0,0,0
1668200378998,CSE 291,F00,116479,Pasquale; Joseph,0,0,0,0
1668200379426,CSE 293,001,119111,Bafna; Vineet,9999,0,9999,0
1668200379426,CSE 293,002,119118,Bellare; Mihir,9999,0,9999,0
1668200379426,CSE 293,003,119122,Berg-Kirkpatrick; Taylor D,9999,0,9999,0
1668200379426,CSE 293,004,119135,Christensen; Henrik I,9999,0,9999,0
1668200379426,CSE 293,005,119142,Cottrell; Garrison W,9999,0,9999,0
1668200379426,CSE 293,006,119146,Deutsch; Alin Bernard,9999,0,9999,0
1668200379426,CSE 293,007,119159,Esmaeilzadeh; Hadi,9999,0,9999,0
1668200379426,CSE 293,008,119166,Freund; Yoav,9999,0,9999,0
1668200379426,CSE 293,009,119170,Griswold; William G.,9999,0,9999,0
1668200379426,CSE 293,010,119183,Gymrek; Melissa Ann,9999,0,9999,0
1668200379426,CSE 293,011,119190,Heninger; Nadia A,9999,0,9999,0
1668200379426,CSE 293,012,119230,Impagliazzo; Russell,9999,0,9999,0
1668200379426,CSE 293,013,119232,Jhala; Ranjit,9999,0,9999,0
1668200379426,CSE 293,014,119233,Kahng; Andrew Byun,9999,0,9999,0
1668200379426,CSE 293,015,119298,Kane; Daniel Mertz,9999,0,9999,0
1668200379426,CSE 293,016,119299,Kriegman; David J,9999,0,9999,0
1668200379426,CSE 293,017,119300,Kumar; Arun Kumar,9999,0,9999,0
1668200379426,CSE 293,018,119301,Lerner; Sorin,9999,0,9999,0
1668200379426,CSE 293,019,119302,Lovett; Shachar,9999,0,9999,0
1668200379426,CSE 293,020,119303,McAuley; Julian John,9999,0,9999,0
1668200379426,CSE 293,021,119304,Micciancio; Daniele,9999,0,9999,0
1668200379426,CSE 293,022,119367,Orailoglu; Alex,9999,0,9999,0
1668200379426,CSE 293,023,119382,Paturi; Ramamohan,9999,0,9999,0
1668200379426,CSE 293,024,119404,Polikarpova; Nadezhda,9999,0,9999,0
1668200379426,CSE 293,025,119406,Politz; Joseph Gibbs,9999,0,9999,0
1668200379426,CSE 293,026,119411,Porter; George M,9999,0,9999,0
1668200379426,CSE 293,027,119414,Porter; Leonard Emerson,9999,0,9999,0
1668200379426,CSE 293,028,119416,Ramamoorthi; Ravi,9999,0,9999,0
1668200379426,CSE 293,029,119417,Sahoo; Debashis,9999,0,9999,0
1668200379426,CSE 293,030,119420,Saul; Lawrence,9999,0,9999,0
1668200379426,CSE 293,031,119421,Savage; Stefan,9999,0,9999,0
1668200379426,CSE 293,032,119425,Schulze; Jurgen P.,9999,0,9999,0
1668200379426,CSE 293,033,119426,Snoeren; Alex C.,9999,0,9999,0
1668200379426,CSE 293,034,119428,Shang; Jingbo,9999,0,9999,0
1668200379426,CSE 293,035,119430,Stefan; Deian,9999,0,9999,0
1668200379426,CSE 293,036,119431,Su; Hao,9999,0,9999,0
1668200379426,CSE 293,037,119433,Swanson; Steven James,9999,0,9999,0
1668200379426,CSE 293,038,119435,Tullsen; Dean Michael,9999,0,9999,0
1668200379426,CSE 293,039,119483,Voelker; Geoffrey M.,9999,0,9999,0
1668200379426,CSE 293,040,119537,Zhao; Jishen,9999,0,9999,0
1668200379426,CSE 293,041,119538,Zhou; Yuan-Yuan,9999,0,9999,0
1668200379426,CSE 293,042,119539,Gao; Sicun,9999,0,9999,0
1668200379426,CSE 293,043,119540,Weibel; Nadir,9999,0,9999,0
1668200379426,CSE 293,044,119541,Gupta; Rajesh K.,9999,0,9999,0
1668200379426,CSE 293,045,126410,Vaccaro; Kristen Marie,9999,0,9999,0
1668200379426,CSE 293,046,126411,Klemke; Richard,9999,0,9999,0
1668200379853,CSE 294,A00,102459,Voelker; Geoffrey M.,0,0,0,0
1668200379853,CSE 294,B00,111322,Orailoglu; Alex,0,0,0,0
1668200380277,DSE 201,A00,096914,Deutsch; Alin Bernard,30,0,30,0
1668200380704,DSE 210,A00,096915,Dasgupta; Sanjoy,30,0,30,0
1668200381134,DSE 260A,A00,096916,Altintas De Callaf; Ilkay,30,0,30,0
1668200381564,ECE 200,001,103586,Antipa; Nicholas A,9999,0,9999,0
1668200381564,ECE 200,002,103587,Atanasov; Nikolay A.,9999,0,9999,0
1668200381564,ECE 200,003,103588,Bharadia; Dinesh,9999,0,9999,0
1668200381564,ECE 200,004,103589,Cheng; Chung Kuan,9999,0,9999,0
1668200381564,ECE 200,005,103590,Cosman; Pamela C.,9999,0,9999,0
1668200381564,ECE 200,006,103591,Dayeh; Shadi Ahmad,9999,0,9999,0
1668200381564,ECE 200,007,103592,Fainman; Yeshaiahu,9999,0,9999,0
1668200381564,ECE 200,008,103593,Ford; Joseph Earl,9999,0,9999,0
1668200381564,ECE 200,009,103594,Franceschetti; Massimo,9999,0,9999,0
1668200381564,ECE 200,010,103595,Fullerton; Eric E,9999,0,9999,0
1668200381564,ECE 200,011,103596,Galton; Ian A,9999,0,9999,0
1668200381564,ECE 200,012,103597,Gilja; Vikash,9999,0,9999,0
1668200381564,ECE 200,013,103598,Hall; Drew A.,9999,0,9999,0
1668200381564,ECE 200,014,103599,Hsueh; Tzu-Chien,9999,0,9999,0
1668200381564,ECE 200,015,103600,Javidi; Tara,9999,0,9999,0
1668200381564,ECE 200,016,103601,Kahng; Andrew Byun,9999,0,9999,0
1668200381564,ECE 200,017,103602,Kim; Young-Han,9999,0,9999,0
1668200381564,ECE 200,018,103603,Koushanfar; Farinaz,9999,0,9999,0
1668200381564,ECE 200,019,103604,Kuzum; Duygu,9999,0,9999,0
1668200381564,ECE 200,020,103605,Le; Hanh-Phuc,9999,0,9999,0
1668200381564,ECE 200,021,103606,Lin; Bill,9999,0,9999,0
1668200381564,ECE 200,022,103607,Liu; Zhaowei,9998,0,9999,1
1668200381564,ECE 200,023,103608,Lo; Yu-Hwa,9999,0,9999,0
1668200381564,ECE 200,024,103609,Lomakin; Vitaliy,9999,0,9999,0
1668200381564,ECE 200,025,103610,Mercier; Patrick Philip,9999,0,9999,0
1668200381564,ECE 200,026,103611,Meyer; Florian,9999,0,9999,0
1668200381564,ECE 200,027,103612,Milstein; Laurence B.,9999,0,9999,0
1668200381564,ECE 200,028,103613,Mir Arabbaygi; Siavash,9999,0,9999,0
1668200381564,ECE 200,029,103614,Mookherjea; Shayan,9999,0,9999,0
1668200381564,ECE 200,030,103615,Morris; Karcher William,9999,0,9999,0
1668200381564,ECE 200,031,103616,Ng; Tse Nga,9999,0,9999,0
1668200381564,ECE 200,032,103617,Nguyen; Truong Quang,9999,0,9999,0
1668200381564,ECE 200,033,103618,Nomura; Kenji,9999,0,9999,0
1668200381564,ECE 200,034,103619,Orlitsky; Alon,9999,0,9999,0
1668200381564,ECE 200,035,103620,Pal; Piya,9999,0,9999,0
1668200381564,ECE 200,036,103621,Papen; George C.,9999,0,9999,0
1668200381564,ECE 200,037,103622,Radic; Stojan,9999,0,9999,0
1668200381564,ECE 200,038,103623,Rao; Bhaskar D.,9999,0,9999,0
1668200381564,ECE 200,039,103624,Rao; Ramesh R,9999,0,9999,0
1668200381564,ECE 200,040,103625,Rebeiz; Gabriel,9999,0,9999,0
1668200381564,ECE 200,041,103626,Sanford; John R,9999,0,9999,0
1668200381564,ECE 200,042,103627,Siegel; Paul H.,9999,0,9999,0
1668200381564,ECE 200,043,103628,Sievenpiper; Daniel F.,9999,0,9999,0
1668200381564,ECE 200,044,103629,Sworder; David D.,9999,0,9999,0
1668200381564,ECE 200,045,103630,Taur; Yuan,9999,0,9999,0
1668200381564,ECE 200,046,103631,Touri; Behrouz,9999,0,9999,0
1668200381564,ECE 200,047,103632,Trivedi; Mohan M.,9999,0,9999,0
1668200381564,ECE 200,048,103633,Vasconcelos; Nuno,9999,0,9999,0
1668200381564,ECE 200,049,103634,Wang; Xiaolong,9999,0,9999,0
1668200381564,ECE 200,050,103635,Xie; Pengtao,9999,0,9999,0
1668200381564,ECE 200,051,103636,Yip; Michael,9999,0,9999,0
1668200381564,ECE 200,052,103637,Zeger; Kenneth A.,999,0,999,0
1668200381564,ECE 200,053,103638,Zhang; Xinyu,9999,0,9999,0
1668200381564,ECE 200,054,103639,Turakhia; Yatish Girish,9999,0,9999,0
1668200381564,ECE 200,055,103640,Kang; Mingu,9999,0,9999,0
1668200381564,ECE 200,056,103641,Shi; Yuanyuan,9999,0,9999,0
1668200381564,ECE 200,057,103642,Wang; Edward Jay,9999,0,9999,0
1668200381564,ECE 200,058,103643,Zheng; Yang,9999,0,9999,0
1668200381989,ECE 202,A00,103644,Kuzum; Duygu,0,0,0,0
1668200382418,ECE 212BN,A00,103646,Ng; Tse Nga,0,0,0,0
1668200382845,ECE 221,A00,111493,Staff,0,0,0,0
1668200383270,ECE 222B,A00,103647,Lomakin; Vitaliy,0,0,0,0
1668200383700,ECE 230B,A00,103648,Taur; Yuan,0,0,0,0
1668200384125,ECE 238B,A00,103649,Garay; Javier,0,0,0,0
1668200384546,ECE 240B,A00,112900,Fainman; Yeshaiahu,0,0,0,0
1668200384973,ECE 247A,A00,103650,Jokerst; Jesse Vincent,0,0,0,0
1668200385395,ECE 247B,A00,103651,Wang; Joseph,0,0,0,0
1668200385829,ECE 250,A00,103652,Siegel; Paul H.,0,0,0,0
1668200386254,ECE 251A,A00,103654,Rao; Bhaskar D.,0,0,0,0
1668200386678,ECE 257B,A00,103655,Bharadia; Dinesh,0,0,0,0
1668200387103,ECE 258A,A00,103656,Milstein; Laurence B.,0,0,0,0
1668200387527,ECE 260B,A00,103658,Kang; Mingu,0,0,0,0
1668200387951,ECE 264A,A00,103659,Galton; Ian A,0,0,0,0
1668200388382,ECE 265A,A00,103661,Gudem; Prasad S.S.,0,0,0,0
1668200388806,ECE 265D,A00,103662,Gudem; Prasad S.S.,0,0,0,0
1668200389248,ECE 268,A00,103663,Koushanfar; Farinaz,0,0,0,0
1668200389699,ECE 269,A01,103665,Pal; Piya,0,0,0,0
1668200390123,ECE 271B,A00,103666,Vasconcelos; Manuela,0,0,0,0
1668200390552,ECE 276A,A00,103667,Atanasov; Nikolay A.,0,0,0,0
1668200390975,ECE 277,A00,103668,An; Cheolhong,0,0,0,0
1668200391412,ECE 279,A00,117947,Hall; Drew A.,0,0,0,0
1668200392271,ECE 283,A00,103670,Hsueh; Tzu-Chien,0,0,0,0
1668200392695,ECE 284,A00,103671,Turakhia; Yatish Girish,0,0,0,0
1668200393119,ECE 285,A00,103672,Zheng; Yang,0,0,0,0
1668200393119,ECE 285,B00,103673,Sworder; David D.,0,0,0,0
1668200393544,ECE 287,A00,103676,Javidi; Tara,0,0,0,0
1668200393973,MATH 200B,A00,098023,Salehi Golsefidy; Alireza,12,0,15,3
1668200394407,MATH 202B,A00,098024,Rhoades; Brendon Patrick,9,0,15,6
1668200394831,MATH 203B,A00,098025,Oprea; Dragos N.,10,0,15,5
1668200395257,MATH 204B,A00,098026,Sorensen; Claus M,13,0,15,2
1668200395682,MATH 208,A00,098027,Izadi; Elham,7,0,10,3
1668200396105,MATH 209,A00,098028,Pollack; Aaron,10,0,10,0
1668200396529,MATH 211A,A00,112919,Rogalski; Daniel,9,0,10,1
1668200396956,MATH 211B,A00,112920,Seward; Brandon M.,9,0,10,1
1668200397383,MATH 218,A00,098029,Li; Bo,10,0,10,0
1668200397898,MATH 220B,A00,098030,Novak; Jonathan I,11,0,15,4
1668200398322,MATH 221A,A00,098031,Ebenfelt; Peter F,13,0,15,2
1668200398749,MATH 231B,A00,098032,Zlatos; Andrej,12,0,15,3
1668200399174,MATH 240B,A00,098033,Ni; Lei,9,0,15,6
1668200399601,MATH 243,A00,098034,Jekel; David Andrew,10,0,10,0
1668200400029,MATH 245A,A00,098035,Nie; Jiawang,0,0,15,16
1668200401608,MATH 248,A00,098036,Bejenaru; Ioan,10,0,10,0
1668200402048,MATH 250B,A00,098037,Spolaor; Luca,14,0,15,1
1668200402478,MATH 258,A00,098038,Ni; Lei,10,0,10,0
1668200402899,MATH 264B,A00,098041,Rhoades; Brendon Patrick,9,0,15,6
1668200403334,MATH 268,A00,098042,Buss; Samuel R,10,0,10,0
1668200403764,MATH 269,A00,098043,Rhoades; Brendon Patrick,10,0,10,0
1668200404189,MATH 270B,A00,098044,Li; Bo,10,0,15,5
1668200404615,MATH 272B,A00,098045,Holst; Michael J,13,0,15,2
1668200405037,MATH 273A,A00,098046,Tian; Xiaochuan,10,0,15,5
1668200405460,MATH 275,A01,098048,Tian; Xiaochuan,6,0,10,4
1668200405887,MATH 278A,A00,098049,Holst; Michael J,8,0,10,2
1668200406310,MATH 278B,A00,098050,Cloninger; Alexander,10,0,10,0
1668200406731,MATH 278C,A00,098051,Nie; Jiawang,7,0,10,3
1668200407156,MATH 280B,A00,098052,Zheng; Tianyi,10,0,15,5
1668200407579,MATH 281B,A00,098053,Bradic; Jelena,2,0,15,13
1668200408010,MATH 282B,A00,098054,Arias-Castro; Ery,0,0,15,15
1668200408462,MATH 285,A00,098055,Fitzsimmons; Patrick J,0,0,15,17
1668200408893,MATH 287B,A00,098056,Arias-Castro; Ery,2,0,15,13
1668200409332,MATH 288,A00,098057,Agarwal; Pooja,9,0,10,1
1668200409332,MATH 288,B00,098058,Zhang; Danna,8,0,10,2
1668200409332,MATH 288,C00,098059,Williams; Ruth J,10,0,10,0
1668200409756,MATH 290B,A00,098060,Roberts; Justin Deritter,13,0,15,2
1668200410189,MATH 292,A00,098061,Belmont; Eva Kinoshita,10,0,10,0
1668200410611,MATH 295,A00,098062,Suk; Andrew Hoon,48,0,50,2
1668200411046,MATH 296,A00,098063,Novak; Jonathan I,20,0,20,0
1668200411476,MATH 297,001,098064,Gamst; Anthony Collins,9997,0,9999,2
1668200913808,COGS 205,A00,101395,Chiba; Andrea,19,0,20,1
1668200914232,COGS 210B,001,101404,Greene; Deanna Jacquelyn,9998,0,9999,1
1668200914232,COGS 210B,002,101417,Xia; Haijun,9999,0,9999,0
1668200914232,COGS 210B,003,101422,Nitz; Douglas A.,9999,0,9999,0
1668200914232,COGS 210B,004,101423,Hollan; James D.,9998,0,9999,1
1668200914232,COGS 210B,005,101424,Deak; Gedeon O.,9998,0,9999,1
1668200914232,COGS 210B,006,101425,Rossano; Federico,9999,0,9999,0
1668200914658,COGS 211B,A00,101427,Coulson; Seana M,9996,0,9999,3
1668200915085,COGS 220,A00,101428,Hollan; James D.,0,0,25,25
1668200915509,COGS 229,A00,101429,Dow; Steven P,18,0,25,7
1668200915932,COGS 230,A00,101430,Klemmer; Scott R,12,0,17,5
1668200916358,COGS 234,A00,101431,Xia; Haijun,2,0,25,23
1668200916781,COGS 260,A00,101432,Kiyonaga; Anastasia,21,0,25,4
1668200916781,COGS 260,B00,101433,Kirsh; David Joel,16,0,25,9
1668200917205,CSE 202,A00,102371,Impagliazzo; Russell,0,0,0,0
1668200917628,CSE 203B,A01,102373,Cheng; Chung Kuan,0,0,0,0
1668200918054,CSE 208,A00,102374,Micciancio; Daniele,0,0,0,0
1668200918499,CSE 209A,A00,112895,Impagliazzo; Russell,0,0,15,15
1668200918936,CSE 209B,A00,108005,Bellare; Mihir,0,0,0,0
1668200919359,CSE 210,A00,113163,Coblenz; Michael J,0,0,0,0
1668200919783,CSE 219,A00,106111,Dow; Steven P,0,0,20,20
1668200920208,CSE 221,A00,102376,Voelker; Geoffrey M.,0,0,0,0
1668200920635,CSE 224,A01,102378,Porter; George M,0,0,0,0
1668200921060,CSE 229A,A00,102379,Savage; Stefan,0,0,0,0
1668200921578,CSE 229C,A00,102380,Munyaka; Imani N. S.,0,0,0,0
1668200922002,CSE 232B,A00,102382,Deutsch; Alin Bernard,0,0,0,0
1668200922430,CSE 234,A01,112904,Kumar; Arun Kumar,0,0,0,0
1668200922856,CSE 237A,A00,102383,Rosing; Tajana Simunic,0,0,0,0
1668200923282,CSE 239A,A00,102384,Deutsch; Alin Bernard,0,0,0,0
1668200923706,CSE 239B,A00,102385,Polikarpova; Nadezhda,0,0,0,0
1668200924132,CSE 240A,A00,102386,Pannuto; Patrick William,0,0,0,0
1668200924561,CSE 240B,A00,102387,Zhao; Jishen,0,0,0,0
1668200924986,CSE 241A,A00,106406,Kang; Mingu,0,0,0,0
1668200925418,CSE 249B,A00,102388,Kahng; Andrew Byun,0,0,8,8
1668200925845,CSE 251B,A01,102392,Cottrell; Garrison W,0,0,0,0
1668200925845,CSE 251B,A02,102393,Cottrell; Garrison W,0,0,0,0
1668200926271,CSE 252B,A00,102394,Ochoa; Benjamin Lawrence,0,0,0,0
1668200926695,CSE 257,A01,102396,Gao; Sicun,0,0,0,0
1668200927122,CSE 272,A00,102397,Li; Tzumao,0,0,0,0
1668200927548,CSE 274,A00,111323,Chern; Albert Ren-Haur,0,0,0,0
1668200927970,CSE 282,A00,102398,Pevzner; Pavel Arkadjevich,0,0,0,0
1668200928404,CSE 284,A00,114175,Gymrek; Melissa Ann,0,0,0,0
1668200928828,CSE 290,A00,102399,Chandraker; Manmohan Krishna,0,0,0,0
1668200928828,CSE 290,B00,102400,Vaccaro; Kristen Marie,0,0,25,25
1668200928828,CSE 290,C00,102414,Pannuto; Patrick William,0,0,25,25
1668200928828,CSE 290,D00,102427,Pevzner; Pavel Arkadjevich,0,0,0,0
1668200928828,CSE 290,E00,102429,Zhao; Jishen,0,0,0,0
1668200928828,CSE 290,F00,102436,Tullsen; Dean Michael,0,0,0,0
1668200928828,CSE 290,G00,102440,Christensen; Henrik I,0,0,20,20
1668200929254,CSE 291,A00,102443,Su; Hao,0,0,0,0
1668200929254,CSE 291,B00,102448,Polikarpova; Nadezhda,0,0,0,0
1668200929254,CSE 291,C00,102453,Vaccaro; Kristen Marie,0,0,0,0
1668200929254,CSE 291,D00,111343,Savage; Stefan,0,0,0,0
1668200929254,CSE 291,E00,116474,Claffy; Kimberly Claire,0,0,0,0
1668200929254,CSE 291,F00,116479,Pasquale; Joseph,0,0,0,0
1668200929686,CSE 293,001,119111,Bafna; Vineet,9999,0,9999,0
1668200929686,CSE 293,002,119118,Bellare; Mihir,9999,0,9999,0
1668200929686,CSE 293,003,119122,Berg-Kirkpatrick; Taylor D,9999,0,9999,0
1668200929686,CSE 293,004,119135,Christensen; Henrik I,9999,0,9999,0
1668200929686,CSE 293,005,119142,Cottrell; Garrison W,9999,0,9999,0
1668200929686,CSE 293,006,119146,Deutsch; Alin Bernard,9999,0,9999,0
1668200929686,CSE 293,007,119159,Esmaeilzadeh; Hadi,9999,0,9999,0
1668200929686,CSE 293,008,119166,Freund; Yoav,9999,0,9999,0
1668200929686,CSE 293,009,119170,Griswold; William G.,9999,0,9999,0
1668200929686,CSE 293,010,119183,Gymrek; Melissa Ann,9999,0,9999,0
1668200929686,CSE 293,011,119190,Heninger; Nadia A,9999,0,9999,0
1668200929686,CSE 293,012,119230,Impagliazzo; Russell,9999,0,9999,0
1668200929686,CSE 293,013,119232,Jhala; Ranjit,9999,0,9999,0
1668200929686,CSE 293,014,119233,Kahng; Andrew Byun,9999,0,9999,0
1668200929686,CSE 293,015,119298,Kane; Daniel Mertz,9999,0,9999,0
1668200929686,CSE 293,016,119299,Kriegman; David J,9999,0,9999,0
1668200929686,CSE 293,017,119300,Kumar; Arun Kumar,9999,0,9999,0
1668200929686,CSE 293,018,119301,Lerner; Sorin,9999,0,9999,0
1668200929686,CSE 293,019,119302,Lovett; Shachar,9999,0,9999,0
1668200929686,CSE 293,020,119303,McAuley; Julian John,9999,0,9999,0
1668200929686,CSE 293,021,119304,Micciancio; Daniele,9999,0,9999,0
1668200929686,CSE 293,022,119367,Orailoglu; Alex,9999,0,9999,0
1668200929686,CSE 293,023,119382,Paturi; Ramamohan,9999,0,9999,0
1668200929686,CSE 293,024,119404,Polikarpova; Nadezhda,9999,0,9999,0
1668200929686,CSE 293,025,119406,Politz; Joseph Gibbs,9999,0,9999,0
1668200929686,CSE 293,026,119411,Porter; George M,9999,0,9999,0
1668200929686,CSE 293,027,119414,Porter; Leonard Emerson,9999,0,9999,0
1668200929686,CSE 293,028,119416,Ramamoorthi; Ravi,9999,0,9999,0
1668200929686,CSE 293,029,119417,Sahoo; Debashis,9999,0,9999,0
1668200929686,CSE 293,030,119420,Saul; Lawrence,9999,0,9999,0
1668200929686,CSE 293,031,119421,Savage; Stefan,9999,0,9999,0
1668200929686,CSE 293,032,119425,Schulze; Jurgen P.,9999,0,9999,0
1668200929686,CSE 293,033,119426,Snoeren; Alex C.,9999,0,9999,0
1668200929686,CSE 293,034,119428,Shang; Jingbo,9999,0,9999,0
1668200929686,CSE 293,035,119430,Stefan; Deian,9999,0,9999,0
1668200929686,CSE 293,036,119431,Su; Hao,9999,0,9999,0
1668200929686,CSE 293,037,119433,Swanson; Steven James,9999,0,9999,0
1668200929686,CSE 293,038,119435,Tullsen; Dean Michael,9999,0,9999,0
1668200929686,CSE 293,039,119483,Voelker; Geoffrey M.,9999,0,9999,0
1668200929686,CSE 293,040,119537,Zhao; Jishen,9999,0,9999,0
1668200929686,CSE 293,041,119538,Zhou; Yuan-Yuan,9999,0,9999,0
1668200929686,CSE 293,042,119539,Gao; Sicun,9999,0,9999,0
1668200929686,CSE 293,043,119540,Weibel; Nadir,9999,0,9999,0
1668200929686,CSE 293,044,119541,Gupta; Rajesh K.,9999,0,9999,0
1668200929686,CSE 293,045,126410,Vaccaro; Kristen Marie,9999,0,9999,0
1668200929686,CSE 293,046,126411,Klemke; Richard,9999,0,9999,0
1668200930110,CSE 294,A00,102459,Voelker; Geoffrey M.,0,0,0,0
1668200930110,CSE 294,B00,111322,Orailoglu; Alex,0,0,0,0
1668200930544,DSE 201,A00,096914,Deutsch; Alin Bernard,30,0,30,0
1668200930968,DSE 210,A00,096915,Dasgupta; Sanjoy,30,0,30,0
1668200931391,DSE 260A,A00,096916,Altintas De Callaf; Ilkay,30,0,30,0
1668200931857,ECE 200,001,103586,Antipa; Nicholas A,9999,0,9999,0
1668200931857,ECE 200,002,103587,Atanasov; Nikolay A.,9999,0,9999,0
1668200931857,ECE 200,003,103588,Bharadia; Dinesh,9999,0,9999,0
1668200931857,ECE 200,004,103589,Cheng; Chung Kuan,9999,0,9999,0
1668200931857,ECE 200,005,103590,Cosman; Pamela C.,9999,0,9999,0
1668200931857,ECE 200,006,103591,Dayeh; Shadi Ahmad,9999,0,9999,0
1668200931857,ECE 200,007,103592,Fainman; Yeshaiahu,9999,0,9999,0
1668200931857,ECE 200,008,103593,Ford; Joseph Earl,9999,0,9999,0
1668200931857,ECE 200,009,103594,Franceschetti; Massimo,9999,0,9999,0
1668200931857,ECE 200,010,103595,Fullerton; Eric E,9999,0,9999,0
1668200931857,ECE 200,011,103596,Galton; Ian A,9999,0,9999,0
1668200931857,ECE 200,012,103597,Gilja; Vikash,9999,0,9999,0
1668200931857,ECE 200,013,103598,Hall; Drew A.,9999,0,9999,0
1668200931857,ECE 200,014,103599,Hsueh; Tzu-Chien,9999,0,9999,0
1668200931857,ECE 200,015,103600,Javidi; Tara,9999,0,9999,0
1668200931857,ECE 200,016,103601,Kahng; Andrew Byun,9999,0,9999,0
1668200931857,ECE 200,017,103602,Kim; Young-Han,9999,0,9999,0
1668200931857,ECE 200,018,103603,Koushanfar; Farinaz,9999,0,9999,0
1668200931857,ECE 200,019,103604,Kuzum; Duygu,9999,0,9999,0
1668200931857,ECE 200,020,103605,Le; Hanh-Phuc,9999,0,9999,0
1668200931857,ECE 200,021,103606,Lin; Bill,9999,0,9999,0
1668200931857,ECE 200,022,103607,Liu; Zhaowei,9998,0,9999,1
1668200931857,ECE 200,023,103608,Lo; Yu-Hwa,9999,0,9999,0
1668200931857,ECE 200,024,103609,Lomakin; Vitaliy,9999,0,9999,0
1668200931857,ECE 200,025,103610,Mercier; Patrick Philip,9999,0,9999,0
1668200931857,ECE 200,026,103611,Meyer; Florian,9999,0,9999,0
1668200931857,ECE 200,027,103612,Milstein; Laurence B.,9999,0,9999,0
1668200931857,ECE 200,028,103613,Mir Arabbaygi; Siavash,9999,0,9999,0
1668200931857,ECE 200,029,103614,Mookherjea; Shayan,9999,0,9999,0
1668200931857,ECE 200,030,103615,Morris; Karcher William,9999,0,9999,0
1668200931857,ECE 200,031,103616,Ng; Tse Nga,9999,0,9999,0
1668200931857,ECE 200,032,103617,Nguyen; Truong Quang,9999,0,9999,0
1668200931857,ECE 200,033,103618,Nomura; Kenji,9999,0,9999,0
1668200931857,ECE 200,034,103619,Orlitsky; Alon,9999,0,9999,0
1668200931857,ECE 200,035,103620,Pal; Piya,9999,0,9999,0
1668200931857,ECE 200,036,103621,Papen; George C.,9999,0,9999,0
1668200931857,ECE 200,037,103622,Radic; Stojan,9999,0,9999,0
1668200931857,ECE 200,038,103623,Rao; Bhaskar D.,9999,0,9999,0
1668200931857,ECE 200,039,103624,Rao; Ramesh R,9999,0,9999,0
1668200931857,ECE 200,040,103625,Rebeiz; Gabriel,9999,0,9999,0
1668200931857,ECE 200,041,103626,Sanford; John R,9999,0,9999,0
1668200931857,ECE 200,042,103627,Siegel; Paul H.,9999,0,9999,0
1668200931857,ECE 200,043,103628,Sievenpiper; Daniel F.,9999,0,9999,0
1668200931857,ECE 200,044,103629,Sworder; David D.,9999,0,9999,0
1668200931857,ECE 200,045,103630,Taur; Yuan,9999,0,9999,0
1668200931857,ECE 200,046,103631,Touri; Behrouz,9999,0,9999,0
1668200931857,ECE 200,047,103632,Trivedi; Mohan M.,9999,0,9999,0
1668200931857,ECE 200,048,103633,Vasconcelos; Nuno,9999,0,9999,0
1668200931857,ECE 200,049,103634,Wang; Xiaolong,9999,0,9999,0
1668200931857,ECE 200,050,103635,Xie; Pengtao,9999,0,9999,0
1668200931857,ECE 200,051,103636,Yip; Michael,9999,0,9999,0
1668200931857,ECE 200,052,103637,Zeger; Kenneth A.,999,0,999,0
1668200931857,ECE 200,053,103638,Zhang; Xinyu,9999,0,9999,0
1668200931857,ECE 200,054,103639,Turakhia; Yatish Girish,9999,0,9999,0
1668200931857,ECE 200,055,103640,Kang; Mingu,9999,0,9999,0
1668200931857,ECE 200,056,103641,Shi; Yuanyuan,9999,0,9999,0
1668200931857,ECE 200,057,103642,Wang; Edward Jay,9999,0,9999,0
1668200931857,ECE 200,058,103643,Zheng; Yang,9999,0,9999,0
1668200932282,ECE 202,A00,103644,Kuzum; Duygu,0,0,0,0
1668200932706,ECE 212BN,A00,103646,Ng; Tse Nga,0,0,0,0
1668200933131,ECE 221,A00,111493,Staff,0,0,0,0
1668200933554,ECE 222B,A00,103647,Lomakin; Vitaliy,0,0,0,0
1668200933976,ECE 230B,A00,103648,Taur; Yuan,0,0,0,0
1668200934404,ECE 238B,A00,103649,Garay; Javier,0,0,0,0
1668200934837,ECE 240B,A00,112900,Fainman; Yeshaiahu,0,0,0,0
1668200935265,ECE 247A,A00,103650,Jokerst; Jesse Vincent,0,0,0,0
1668200935688,ECE 247B,A00,103651,Wang; Joseph,0,0,0,0
1668200936123,ECE 250,A00,103652,Siegel; Paul H.,0,0,0,0
1668200936546,ECE 251A,A00,103654,Rao; Bhaskar D.,0,0,0,0
1668200936970,ECE 257B,A00,103655,Bharadia; Dinesh,0,0,0,0
1668200937397,ECE 258A,A00,103656,Milstein; Laurence B.,0,0,0,0
1668200937819,ECE 260B,A00,103658,Kang; Mingu,0,0,0,0
1668200938244,ECE 264A,A00,103659,Galton; Ian A,0,0,0,0
1668200938666,ECE 265A,A00,103661,Gudem; Prasad S.S.,0,0,0,0
1668200939097,ECE 265D,A00,103662,Gudem; Prasad S.S.,0,0,0,0
1668200939525,ECE 268,A00,103663,Koushanfar; Farinaz,0,0,0,0
1668200939957,ECE 269,A01,103665,Pal; Piya,0,0,0,0
1668200940388,ECE 271B,A00,103666,Vasconcelos; Manuela,0,0,0,0
1668200940820,ECE 276A,A00,103667,Atanasov; Nikolay A.,0,0,0,0
1668200941245,ECE 277,A00,103668,An; Cheolhong,0,0,0,0
1668200941671,ECE 279,A00,117947,Hall; Drew A.,0,0,0,0
1668200942522,ECE 283,A00,103670,Hsueh; Tzu-Chien,0,0,0,0
1668200942954,ECE 284,A00,103671,Turakhia; Yatish Girish,0,0,0,0
1668200943378,ECE 285,A00,103672,Zheng; Yang,0,0,0,0
1668200943378,ECE 285,B00,103673,Sworder; David D.,0,0,0,0
1668200943799,ECE 287,A00,103676,Javidi; Tara,0,0,0,0
1668200944224,MATH 200B,A00,098023,Salehi Golsefidy; Alireza,12,0,15,3
1668200944650,MATH 202B,A00,098024,Rhoades; Brendon Patrick,9,0,15,6
1668200945080,MATH 203B,A00,098025,Oprea; Dragos N.,10,0,15,5
1668200945514,MATH 204B,A00,098026,Sorensen; Claus M,13,0,15,2
1668200945939,MATH 208,A00,098027,Izadi; Elham,7,0,10,3
1668200946382,MATH 209,A00,098028,Pollack; Aaron,10,0,10,0
1668200946805,MATH 211A,A00,112919,Rogalski; Daniel,9,0,10,1
1668200947229,MATH 211B,A00,112920,Seward; Brandon M.,9,0,10,1
1668200947653,MATH 218,A00,098029,Li; Bo,10,0,10,0
1668200948077,MATH 220B,A00,098030,Novak; Jonathan I,11,0,15,4
1668200948509,MATH 221A,A00,098031,Ebenfelt; Peter F,13,0,15,2
1668200948935,MATH 231B,A00,098032,Zlatos; Andrej,12,0,15,3
1668200949380,MATH 240B,A00,098033,Ni; Lei,9,0,15,6
1668200949802,MATH 243,A00,098034,Jekel; David Andrew,10,0,10,0
1668200950226,MATH 245A,A00,098035,Nie; Jiawang,0,0,15,16
1668200950650,MATH 248,A00,098036,Bejenaru; Ioan,10,0,10,0
1668200951079,MATH 250B,A00,098037,Spolaor; Luca,14,0,15,1
1668200951504,MATH 258,A00,098038,Ni; Lei,10,0,10,0
1668200951929,MATH 264B,A00,098041,Rhoades; Brendon Patrick,9,0,15,6
1668200952354,MATH 268,A00,098042,Buss; Samuel R,10,0,10,0
1668200952790,MATH 269,A00,098043,Rhoades; Brendon Patrick,10,0,10,0
1668200953214,MATH 270B,A00,098044,Li; Bo,10,0,15,5
1668200953640,MATH 272B,A00,098045,Holst; Michael J,13,0,15,2
1668200954063,MATH 273A,A00,098046,Tian; Xiaochuan,10,0,15,5
1668200954486,MATH 275,A01,098048,Tian; Xiaochuan,6,0,10,4
1668200954912,MATH 278A,A00,098049,Holst; Michael J,8,0,10,2
1668200955336,MATH 278B,A00,098050,Cloninger; Alexander,10,0,10,0
1668200955758,MATH 278C,A00,098051,Nie; Jiawang,7,0,10,3
1668200956182,MATH 280B,A00,098052,Zheng; Tianyi,10,0,15,5
1668200956609,MATH 281B,A00,098053,Bradic; Jelena,2,0,15,13
1668200957031,MATH 282B,A00,098054,Arias-Castro; Ery,0,0,15,15
1668200957458,MATH 285,A00,098055,Fitzsimmons; Patrick J,0,0,15,17
1668200957883,MATH 287B,A00,098056,Arias-Castro; Ery,2,0,15,13
1668200958308,MATH 288,A00,098057,Agarwal; Pooja,9,0,10,1
1668200958308,MATH 288,B00,098058,Zhang; Danna,8,0,10,2
1668200958308,MATH 288,C00,098059,Williams; Ruth J,10,0,10,0
1668200958733,MATH 290B,A00,098060,Roberts; Justin Deritter,13,0,15,2
1668200959157,MATH 292,A00,098061,Belmont; Eva Kinoshita,10,0,10,0
1668200959582,MATH 295,A00,098062,Suk; Andrew Hoon,48,0,50,2
1668200960003,MATH 296,A00,098063,Novak; Jonathan I,20,0,20,0
1668200960430,MATH 297,001,098064,Gamst; Anthony Collins,9997,0,9999,2
1668201462459,COGS 205,A00,101395,Chiba; Andrea,19,0,20,1
1668201462882,COGS 210B,001,101404,Greene; Deanna Jacquelyn,9998,0,9999,1
1668201462882,COGS 210B,002,101417,Xia; Haijun,9999,0,9999,0
1668201462882,COGS 210B,003,101422,Nitz; Douglas A.,9999,0,9999,0
1668201462882,COGS 210B,004,101423,Hollan; James D.,9998,0,9999,1
1668201462882,COGS 210B,005,101424,Deak; Gedeon O.,9998,0,9999,1
1668201462882,COGS 210B,006,101425,Rossano; Federico,9999,0,9999,0
1668201463320,COGS 211B,A00,101427,Coulson; Seana M,9996,0,9999,3
1668201463743,COGS 220,A00,101428,Hollan; James D.,0,0,25,25
1668201464166,COGS 229,A00,101429,Dow; Steven P,18,0,25,7
1668201464593,COGS 230,A00,101430,Klemmer; Scott R,12,0,17,5
1668201465016,COGS 234,A00,101431,Xia; Haijun,2,0,25,23
1668201465439,COGS 260,A00,101432,Kiyonaga; Anastasia,21,0,25,4
1668201465439,COGS 260,B00,101433,Kirsh; David Joel,16,0,25,9
1668201465874,CSE 202,A00,102371,Impagliazzo; Russell,0,0,0,0
1668201466301,CSE 203B,A01,102373,Cheng; Chung Kuan,0,0,0,0
1668201466738,CSE 208,A00,102374,Micciancio; Daniele,0,0,0,0
1668201467167,CSE 209A,A00,112895,Impagliazzo; Russell,0,0,15,15
1668201467589,CSE 209B,A00,108005,Bellare; Mihir,0,0,0,0
1668201468015,CSE 210,A00,113163,Coblenz; Michael J,0,0,0,0
1668201468440,CSE 219,A00,106111,Dow; Steven P,0,0,20,20
1668201468862,CSE 221,A00,102376,Voelker; Geoffrey M.,0,0,0,0
1668201469289,CSE 224,A01,102378,Porter; George M,0,0,0,0
1668201469717,CSE 229A,A00,102379,Savage; Stefan,0,0,0,0
1668201470144,CSE 229C,A00,102380,Munyaka; Imani N. S.,0,0,0,0
1668201470567,CSE 232B,A00,102382,Deutsch; Alin Bernard,0,0,0,0
1668201470992,CSE 234,A01,112904,Kumar; Arun Kumar,0,0,0,0
1668201471435,CSE 237A,A00,102383,Rosing; Tajana Simunic,0,0,0,0
1668201471864,CSE 239A,A00,102384,Deutsch; Alin Bernard,0,0,0,0
1668201472288,CSE 239B,A00,102385,Polikarpova; Nadezhda,0,0,0,0
1668201472714,CSE 240A,A00,102386,Pannuto; Patrick William,0,0,0,0
1668201473137,CSE 240B,A00,102387,Zhao; Jishen,0,0,0,0
1668201473578,CSE 241A,A00,106406,Kang; Mingu,0,0,0,0
1668201473999,CSE 249B,A00,102388,Kahng; Andrew Byun,0,0,8,8
1668201474435,CSE 251B,A01,102392,Cottrell; Garrison W,0,0,0,0
1668201474435,CSE 251B,A02,102393,Cottrell; Garrison W,0,0,0,0
1668201474872,CSE 252B,A00,102394,Ochoa; Benjamin Lawrence,0,0,0,0
1668201475299,CSE 257,A01,102396,Gao; Sicun,0,0,0,0
1668201475724,CSE 272,A00,102397,Li; Tzumao,0,0,0,0
1668201476147,CSE 274,A00,111323,Chern; Albert Ren-Haur,0,0,0,0
1668201476583,CSE 282,A00,102398,Pevzner; Pavel Arkadjevich,0,0,0,0
1668201477009,CSE 284,A00,114175,Gymrek; Melissa Ann,0,0,0,0
1668201477433,CSE 290,A00,102399,Chandraker; Manmohan Krishna,0,0,0,0
1668201477433,CSE 290,B00,102400,Vaccaro; Kristen Marie,0,0,25,25
1668201477433,CSE 290,C00,102414,Pannuto; Patrick William,0,0,25,25
1668201477433,CSE 290,D00,102427,Pevzner; Pavel Arkadjevich,0,0,0,0
1668201477433,CSE 290,E00,102429,Zhao; Jishen,0,0,0,0
1668201477433,CSE 290,F00,102436,Tullsen; Dean Michael,0,0,0,0
1668201477433,CSE 290,G00,102440,Christensen; Henrik I,0,0,20,20
1668201477857,CSE 291,A00,102443,Su; Hao,0,0,0,0
1668201477857,CSE 291,B00,102448,Polikarpova; Nadezhda,0,0,0,0
1668201477857,CSE 291,C00,102453,Vaccaro; Kristen Marie,0,0,0,0
1668201477857,CSE 291,D00,111343,Savage; Stefan,0,0,0,0
1668201477857,CSE 291,E00,116474,Claffy; Kimberly Claire,0,0,0,0
1668201477857,CSE 291,F00,116479,Pasquale; Joseph,0,0,0,0
1668201478282,CSE 293,001,119111,Bafna; Vineet,9999,0,9999,0
1668201478282,CSE 293,002,119118,Bellare; Mihir,9999,0,9999,0
1668201478282,CSE 293,003,119122,Berg-Kirkpatrick; Taylor D,9999,0,9999,0
1668201478282,CSE 293,004,119135,Christensen; Henrik I,9999,0,9999,0
1668201478282,CSE 293,005,119142,Cottrell; Garrison W,9999,0,9999,0
1668201478282,CSE 293,006,119146,Deutsch; Alin Bernard,9999,0,9999,0
1668201478282,CSE 293,007,119159,Esmaeilzadeh; Hadi,9999,0,9999,0
1668201478282,CSE 293,008,119166,Freund; Yoav,9999,0,9999,0
1668201478282,CSE 293,009,119170,Griswold; William G.,9999,0,9999,0
1668201478282,CSE 293,010,119183,Gymrek; Melissa Ann,9999,0,9999,0
1668201478282,CSE 293,011,119190,Heninger; Nadia A,9999,0,9999,0
1668201478282,CSE 293,012,119230,Impagliazzo; Russell,9999,0,9999,0
1668201478282,CSE 293,013,119232,Jhala; Ranjit,9999,0,9999,0
1668201478282,CSE 293,014,119233,Kahng; Andrew Byun,9999,0,9999,0
1668201478282,CSE 293,015,119298,Kane; Daniel Mertz,9999,0,9999,0
1668201478282,CSE 293,016,119299,Kriegman; David J,9999,0,9999,0
1668201478282,CSE 293,017,119300,Kumar; Arun Kumar,9999,0,9999,0
1668201478282,CSE 293,018,119301,Lerner; Sorin,9999,0,9999,0
1668201478282,CSE 293,019,119302,Lovett; Shachar,9999,0,9999,0
1668201478282,CSE 293,020,119303,McAuley; Julian John,9999,0,9999,0
1668201478282,CSE 293,021,119304,Micciancio; Daniele,9999,0,9999,0
1668201478282,CSE 293,022,119367,Orailoglu; Alex,9999,0,9999,0
1668201478282,CSE 293,023,119382,Paturi; Ramamohan,9999,0,9999,0
1668201478282,CSE 293,024,119404,Polikarpova; Nadezhda,9999,0,9999,0
1668201478282,CSE 293,025,119406,Politz; Joseph Gibbs,9999,0,9999,0
1668201478282,CSE 293,026,119411,Porter; George M,9999,0,9999,0
1668201478282,CSE 293,027,119414,Porter; Leonard Emerson,9999,0,9999,0
1668201478282,CSE 293,028,119416,Ramamoorthi; Ravi,9999,0,9999,0
1668201478282,CSE 293,029,119417,Sahoo; Debashis,9999,0,9999,0
1668201478282,CSE 293,030,119420,Saul; Lawrence,9999,0,9999,0
1668201478282,CSE 293,031,119421,Savage; Stefan,9999,0,9999,0
1668201478282,CSE 293,032,119425,Schulze; Jurgen P.,9999,0,9999,0
1668201478282,CSE 293,033,119426,Snoeren; Alex C.,9999,0,9999,0
1668201478282,CSE 293,034,119428,Shang; Jingbo,9999,0,9999,0
1668201478282,CSE 293,035,119430,Stefan; Deian,9999,0,9999,0
1668201478282,CSE 293,036,119431,Su; Hao,9999,0,9999,0
1668201478282,CSE 293,037,119433,Swanson; Steven James,9999,0,9999,0
1668201478282,CSE 293,038,119435,Tullsen; Dean Michael,9999,0,9999,0
1668201478282,CSE 293,039,119483,Voelker; Geoffrey M.,9999,0,9999,0
1668201478282,CSE 293,040,119537,Zhao; Jishen,9999,0,9999,0
1668201478282,CSE 293,041,119538,Zhou; Yuan-Yuan,9999,0,9999,0
1668201478282,CSE 293,042,119539,Gao; Sicun,9999,0,9999,0
1668201478282,CSE 293,043,119540,Weibel; Nadir,9999,0,9999,0
1668201478282,CSE 293,044,119541,Gupta; Rajesh K.,9999,0,9999,0
1668201478282,CSE 293,045,126410,Vaccaro; Kristen Marie,9999,0,9999,0
1668201478282,CSE 293,046,126411,Klemke; Richard,9999,0,9999,0
1668201478711,CSE 294,A00,102459,Voelker; Geoffrey M.,0,0,0,0
1668201478711,CSE 294,B00,111322,Orailoglu; Alex,0,0,0,0
1668201479135,DSE 201,A00,096914,Deutsch; Alin Bernard,30,0,30,0
1668201479560,DSE 210,A00,096915,Dasgupta; Sanjoy,30,0,30,0
1668201479996,DSE 260A,A00,096916,Altintas De Callaf; Ilkay,30,0,30,0
1668201480441,ECE 200,001,103586,Antipa; Nicholas A,9999,0,9999,0
1668201480441,ECE 200,002,103587,Atanasov; Nikolay A.,9999,0,9999,0
1668201480441,ECE 200,003,103588,Bharadia; Dinesh,9999,0,9999,0
1668201480441,ECE 200,004,103589,Cheng; Chung Kuan,9999,0,9999,0
1668201480441,ECE 200,005,103590,Cosman; Pamela C.,9999,0,9999,0
1668201480441,ECE 200,006,103591,Dayeh; Shadi Ahmad,9999,0,9999,0
1668201480441,ECE 200,007,103592,Fainman; Yeshaiahu,9999,0,9999,0
1668201480441,ECE 200,008,103593,Ford; Joseph Earl,9999,0,9999,0
1668201480441,ECE 200,009,103594,Franceschetti; Massimo,9999,0,9999,0
1668201480441,ECE 200,010,103595,Fullerton; Eric E,9999,0,9999,0
1668201480441,ECE 200,011,103596,Galton; Ian A,9999,0,9999,0
1668201480441,ECE 200,012,103597,Gilja; Vikash,9999,0,9999,0
1668201480441,ECE 200,013,103598,Hall; Drew A.,9999,0,9999,0
1668201480441,ECE 200,014,103599,Hsueh; Tzu-Chien,9999,0,9999,0
1668201480441,ECE 200,015,103600,Javidi; Tara,9999,0,9999,0
1668201480441,ECE 200,016,103601,Kahng; Andrew Byun,9999,0,9999,0
1668201480441,ECE 200,017,103602,Kim; Young-Han,9999,0,9999,0
1668201480441,ECE 200,018,103603,Koushanfar; Farinaz,9999,0,9999,0
1668201480441,ECE 200,019,103604,Kuzum; Duygu,9999,0,9999,0
1668201480441,ECE 200,020,103605,Le; Hanh-Phuc,9999,0,9999,0
1668201480441,ECE 200,021,103606,Lin; Bill,9999,0,9999,0
1668201480441,ECE 200,022,103607,Liu; Zhaowei,9998,0,9999,1
1668201480441,ECE 200,023,103608,Lo; Yu-Hwa,9999,0,9999,0
1668201480441,ECE 200,024,103609,Lomakin; Vitaliy,9999,0,9999,0
1668201480441,ECE 200,025,103610,Mercier; Patrick Philip,9999,0,9999,0
1668201480441,ECE 200,026,103611,Meyer; Florian,9999,0,9999,0
1668201480441,ECE 200,027,103612,Milstein; Laurence B.,9999,0,9999,0
1668201480441,ECE 200,028,103613,Mir Arabbaygi; Siavash,9999,0,9999,0
1668201480441,ECE 200,029,103614,Mookherjea; Shayan,9999,0,9999,0
1668201480441,ECE 200,030,103615,Morris; Karcher William,9999,0,9999,0
1668201480441,ECE 200,031,103616,Ng; Tse Nga,9999,0,9999,0
1668201480441,ECE 200,032,103617,Nguyen; Truong Quang,9999,0,9999,0
1668201480441,ECE 200,033,103618,Nomura; Kenji,9999,0,9999,0
1668201480441,ECE 200,034,103619,Orlitsky; Alon,9999,0,9999,0
1668201480441,ECE 200,035,103620,Pal; Piya,9999,0,9999,0
1668201480441,ECE 200,036,103621,Papen; George C.,9999,0,9999,0
1668201480441,ECE 200,037,103622,Radic; Stojan,9999,0,9999,0
1668201480441,ECE 200,038,103623,Rao; Bhaskar D.,9999,0,9999,0
1668201480441,ECE 200,039,103624,Rao; Ramesh R,9999,0,9999,0
1668201480441,ECE 200,040,103625,Rebeiz; Gabriel,9999,0,9999,0
1668201480441,ECE 200,041,103626,Sanford; John R,9999,0,9999,0
1668201480441,ECE 200,042,103627,Siegel; Paul H.,9999,0,9999,0
1668201480441,ECE 200,043,103628,Sievenpiper; Daniel F.,9999,0,9999,0
1668201480441,ECE 200,044,103629,Sworder; David D.,9999,0,9999,0
1668201480441,ECE 200,045,103630,Taur; Yuan,9999,0,9999,0
1668201480441,ECE 200,046,103631,Touri; Behrouz,9999,0,9999,0
1668201480441,ECE 200,047,103632,Trivedi; Mohan M.,9999,0,9999,0
1668201480441,ECE 200,048,103633,Vasconcelos; Nuno,9999,0,9999,0
1668201480441,ECE 200,049,103634,Wang; Xiaolong,9999,0,9999,0
1668201480441,ECE 200,050,103635,Xie; Pengtao,9999,0,9999,0
1668201480441,ECE 200,051,103636,Yip; Michael,9999,0,9999,0
1668201480441,ECE 200,052,103637,Zeger; Kenneth A.,999,0,999,0
1668201480441,ECE 200,053,103638,Zhang; Xinyu,9999,0,9999,0
1668201480441,ECE 200,054,103639,Turakhia; Yatish Girish,9999,0,9999,0
1668201480441,ECE 200,055,103640,Kang; Mingu,9999,0,9999,0
1668201480441,ECE 200,056,103641,Shi; Yuanyuan,9999,0,9999,0
1668201480441,ECE 200,057,103642,Wang; Edward Jay,9999,0,9999,0
1668201480441,ECE 200,058,103643,Zheng; Yang,9999,0,9999,0
1668201480865,ECE 202,A00,103644,Kuzum; Duygu,0,0,0,0
1668201481295,ECE 212BN,A00,103646,Ng; Tse Nga,0,0,0,0
1668201481723,ECE 221,A00,111493,Staff,0,0,0,0
1668201482147,ECE 222B,A00,103647,Lomakin; Vitaliy,0,0,0,0
1668201482572,ECE 230B,A00,103648,Taur; Yuan,0,0,0,0
1668201483003,ECE 238B,A00,103649,Garay; Javier,0,0,0,0
1668201483434,ECE 240B,A00,112900,Fainman; Yeshaiahu,0,0,0,0
1668201483858,ECE 247A,A00,103650,Jokerst; Jesse Vincent,0,0,0,0
1668201484282,ECE 247B,A00,103651,Wang; Joseph,0,0,0,0
1668201484709,ECE 250,A00,103652,Siegel; Paul H.,0,0,0,0
1668201485131,ECE 251A,A00,103654,Rao; Bhaskar D.,0,0,0,0
1668201485563,ECE 257B,A00,103655,Bharadia; Dinesh,0,0,0,0
1668201485989,ECE 258A,A00,103656,Milstein; Laurence B.,0,0,0,0
1668201486413,ECE 260B,A00,103658,Kang; Mingu,0,0,0,0
1668201486908,ECE 264A,A00,103659,Galton; Ian A,0,0,0,0
1668201487334,ECE 265A,A00,103661,Gudem; Prasad S.S.,0,0,0,0
1668201487759,ECE 265D,A00,103662,Gudem; Prasad S.S.,0,0,0,0
1668201488192,ECE 268,A00,103663,Koushanfar; Farinaz,0,0,0,0
1668201488619,ECE 269,A01,103665,Pal; Piya,0,0,0,0
1668201489044,ECE 271B,A00,103666,Vasconcelos; Manuela,0,0,0,0
1668201489465,ECE 276A,A00,103667,Atanasov; Nikolay A.,0,0,0,0
1668201489895,ECE 277,A00,103668,An; Cheolhong,0,0,0,0
1668201490325,ECE 279,A00,117947,Hall; Drew A.,0,0,0,0
1668201491180,ECE 283,A00,103670,Hsueh; Tzu-Chien,0,0,0,0
1668201491605,ECE 284,A00,103671,Turakhia; Yatish Girish,0,0,0,0
1668201492027,ECE 285,A00,103672,Zheng; Yang,0,0,0,0
1668201492027,ECE 285,B00,103673,Sworder; David D.,0,0,0,0
1668201492449,ECE 287,A00,103676,Javidi; Tara,0,0,0,0
1668201492879,MATH 200B,A00,098023,Salehi Golsefidy; Alireza,12,0,15,3
1668201493311,MATH 202B,A00,098024,Rhoades; Brendon Patrick,9,0,15,6
1668201493732,MATH 203B,A00,098025,Oprea; Dragos N.,10,0,15,5
1668201494156,MATH 204B,A00,098026,Sorensen; Claus M,13,0,15,2
1668201494579,MATH 208,A00,098027,Izadi; Elham,7,0,10,3
1668201495005,MATH 209,A00,098028,Pollack; Aaron,10,0,10,0
1668201495430,MATH 211A,A00,112919,Rogalski; Daniel,9,0,10,1
1668201495853,MATH 211B,A00,112920,Seward; Brandon M.,9,0,10,1
1668201496278,MATH 218,A00,098029,Li; Bo,10,0,10,0
1668201496706,MATH 220B,A00,098030,Novak; Jonathan I,11,0,15,4
1668201497130,MATH 221A,A00,098031,Ebenfelt; Peter F,13,0,15,2
1668201497555,MATH 231B,A00,098032,Zlatos; Andrej,12,0,15,3
1668201497991,MATH 240B,A00,098033,Ni; Lei,9,0,15,6
1668201498414,MATH 243,A00,098034,Jekel; David Andrew,10,0,10,0
1668201498839,MATH 245A,A00,098035,Nie; Jiawang,0,0,15,16
1668201499274,MATH 248,A00,098036,Bejenaru; Ioan,10,0,10,0
1668201499700,MATH 250B,A00,098037,Spolaor; Luca,14,0,15,1
1668201500124,MATH 258,A00,098038,Ni; Lei,10,0,10,0
1668201500548,MATH 264B,A00,098041,Rhoades; Brendon Patrick,9,0,15,6
1668201500973,MATH 268,A00,098042,Buss; Samuel R,10,0,10,0
1668201501398,MATH 269,A00,098043,Rhoades; Brendon Patrick,10,0,10,0
1668201501822,MATH 270B,A00,098044,Li; Bo,10,0,15,5
1668201502251,MATH 272B,A00,098045,Holst; Michael J,13,0,15,2
1668201502674,MATH 273A,A00,098046,Tian; Xiaochuan,10,0,15,5
1668201503096,MATH 275,A01,098048,Tian; Xiaochuan,6,0,10,4
1668201503521,MATH 278A,A00,098049,Holst; Michael J,8,0,10,2
1668201503946,MATH 278B,A00,098050,Cloninger; Alexander,10,0,10,0
1668201504368,MATH 278C,A00,098051,Nie; Jiawang,7,0,10,3
1668201504796,MATH 280B,A00,098052,Zheng; Tianyi,10,0,15,5
1668201505229,MATH 281B,A00,098053,Bradic; Jelena,2,0,15,13
1668201505662,MATH 282B,A00,098054,Arias-Castro; Ery,0,0,15,15
1668201506083,MATH 285,A00,098055,Fitzsimmons; Patrick J,0,0,15,17
1668201506508,MATH 287B,A00,098056,Arias-Castro; Ery,2,0,15,13
1668201506941,MATH 288,A00,098057,Agarwal; Pooja,9,0,10,1
1668201506941,MATH 288,B00,098058,Zhang; Danna,8,0,10,2
1668201506941,MATH 288,C00,098059,Williams; Ruth J,10,0,10,0
1668201507365,MATH 290B,A00,098060,Roberts; Justin Deritter,13,0,15,2
1668201507788,MATH 292,A00,098061,Belmont; Eva Kinoshita,10,0,10,0
1668201508210,MATH 295,A00,098062,Suk; Andrew Hoon,48,0,50,2
1668201508644,MATH 296,A00,098063,Novak; Jonathan I,20,0,20,0
1668201509086,MATH 297,001,098064,Gamst; Anthony Collins,9997,0,9999,2
1668202021632,COGS 205,A00,101395,Chiba; Andrea,19,0,20,1
1668202022065,COGS 210B,001,101404,Greene; Deanna Jacquelyn,9998,0,9999,1
1668202022065,COGS 210B,002,101417,Xia; Haijun,9999,0,9999,0
1668202022065,COGS 210B,003,101422,Nitz; Douglas A.,9999,0,9999,0
1668202022065,COGS 210B,004,101423,Hollan; James D.,9998,0,9999,1
1668202022065,COGS 210B,005,101424,Deak; Gedeon O.,9998,0,9999,1
1668202022065,COGS 210B,006,101425,Rossano; Federico,9999,0,9999,0
1668202022492,COGS 211B,A00,101427,Coulson; Seana M,9996,0,9999,3
1668202022917,COGS 220,A00,101428,Hollan; James D.,0,0,25,25
1668202023349,COGS 229,A00,101429,Dow; Steven P,18,0,25,7
1668202023773,COGS 230,A00,101430,Klemmer; Scott R,12,0,17,5
1668202024197,COGS 234,A00,101431,Xia; Haijun,2,0,25,23
1668202024619,COGS 260,A00,101432,Kiyonaga; Anastasia,21,0,25,4
1668202024619,COGS 260,B00,101433,Kirsh; David Joel,16,0,25,9
1668202025044,CSE 202,A00,102371,Impagliazzo; Russell,0,0,0,0
1668202025469,CSE 203B,A01,102373,Cheng; Chung Kuan,0,0,0,0
1668202025891,CSE 208,A00,102374,Micciancio; Daniele,0,0,0,0
1668202026314,CSE 209A,A00,112895,Impagliazzo; Russell,0,0,15,15
1668202026735,CSE 209B,A00,108005,Bellare; Mihir,0,0,0,0
1668202027180,CSE 210,A00,113163,Coblenz; Michael J,0,0,0,0
1668202027621,CSE 219,A00,106111,Dow; Steven P,0,0,20,20
1668202028055,CSE 221,A00,102376,Voelker; Geoffrey M.,0,0,0,0
1668202028483,CSE 224,A01,102378,Porter; George M,0,0,0,0
1668202028928,CSE 229A,A00,102379,Savage; Stefan,0,0,0,0
1668202029359,CSE 229C,A00,102380,Munyaka; Imani N. S.,0,0,0,0
1668202029794,CSE 232B,A00,102382,Deutsch; Alin Bernard,0,0,0,0
1668202030225,CSE 234,A01,112904,Kumar; Arun Kumar,0,0,0,0
1668202030649,CSE 237A,A00,102383,Rosing; Tajana Simunic,0,0,0,0
1668202031078,CSE 239A,A00,102384,Deutsch; Alin Bernard,0,0,0,0
1668202031506,CSE 239B,A00,102385,Polikarpova; Nadezhda,0,0,0,0
1668202031928,CSE 240A,A00,102386,Pannuto; Patrick William,0,0,0,0
1668202032353,CSE 240B,A00,102387,Zhao; Jishen,0,0,0,0
1668202032782,CSE 241A,A00,106406,Kang; Mingu,0,0,0,0
1668202033204,CSE 249B,A00,102388,Kahng; Andrew Byun,0,0,8,8
1668202033631,CSE 251B,A01,102392,Cottrell; Garrison W,0,0,0,0
1668202033631,CSE 251B,A02,102393,Cottrell; Garrison W,0,0,0,0
1668202034061,CSE 252B,A00,102394,Ochoa; Benjamin Lawrence,0,0,0,0
1668202034495,CSE 257,A01,102396,Gao; Sicun,0,0,0,0
1668202034918,CSE 272,A00,102397,Li; Tzumao,0,0,0,0
1668202035343,CSE 274,A00,111323,Chern; Albert Ren-Haur,0,0,0,0
1668202035855,CSE 282,A00,102398,Pevzner; Pavel Arkadjevich,0,0,0,0
1668202036282,CSE 284,A00,114175,Gymrek; Melissa Ann,0,0,0,0
1668202036714,CSE 290,A00,102399,Chandraker; Manmohan Krishna,0,0,0,0
1668202036714,CSE 290,B00,102400,Vaccaro; Kristen Marie,0,0,25,25
1668202036714,CSE 290,C00,102414,Pannuto; Patrick William,0,0,25,25
1668202036714,CSE 290,D00,102427,Pevzner; Pavel Arkadjevich,0,0,0,0
1668202036714,CSE 290,E00,102429,Zhao; Jishen,0,0,0,0
1668202036714,CSE 290,F00,102436,Tullsen; Dean Michael,0,0,0,0
1668202036714,CSE 290,G00,102440,Christensen; Henrik I,0,0,20,20
1668202037145,CSE 291,A00,102443,Su; Hao,0,0,0,0
1668202037145,CSE 291,B00,102448,Polikarpova; Nadezhda,0,0,0,0
1668202037145,CSE 291,C00,102453,Vaccaro; Kristen Marie,0,0,0,0
1668202037145,CSE 291,D00,111343,Savage; Stefan,0,0,0,0
1668202037145,CSE 291,E00,116474,Claffy; Kimberly Claire,0,0,0,0
1668202037145,CSE 291,F00,116479,Pasquale; Joseph,0,0,0,0
1668202037572,CSE 293,001,119111,Bafna; Vineet,9999,0,9999,0
1668202037572,CSE 293,002,119118,Bellare; Mihir,9999,0,9999,0
1668202037572,CSE 293,003,119122,Berg-Kirkpatrick; Taylor D,9999,0,9999,0
1668202037572,CSE 293,004,119135,Christensen; Henrik I,9999,0,9999,0
1668202037572,CSE 293,005,119142,Cottrell; Garrison W,9999,0,9999,0
1668202037572,CSE 293,006,119146,Deutsch; Alin Bernard,9999,0,9999,0
1668202037572,CSE 293,007,119159,Esmaeilzadeh; Hadi,9999,0,9999,0
1668202037572,CSE 293,008,119166,Freund; Yoav,9999,0,9999,0
1668202037572,CSE 293,009,119170,Griswold; William G.,9999,0,9999,0
1668202037572,CSE 293,010,119183,Gymrek; Melissa Ann,9999,0,9999,0
1668202037572,CSE 293,011,119190,Heninger; Nadia A,9999,0,9999,0
1668202037572,CSE 293,012,119230,Impagliazzo; Russell,9999,0,9999,0
1668202037572,CSE 293,013,119232,Jhala; Ranjit,9999,0,9999,0
1668202037572,CSE 293,014,119233,Kahng; Andrew Byun,9999,0,9999,0
1668202037572,CSE 293,015,119298,Kane; Daniel Mertz,9999,0,9999,0
1668202037572,CSE 293,016,119299,Kriegman; David J,9999,0,9999,0
1668202037572,CSE 293,017,119300,Kumar; Arun Kumar,9999,0,9999,0
1668202037572,CSE 293,018,119301,Lerner; Sorin,9999,0,9999,0
1668202037572,CSE 293,019,119302,Lovett; Shachar,9999,0,9999,0
1668202037572,CSE 293,020,119303,McAuley; Julian John,9999,0,9999,0
1668202037572,CSE 293,021,119304,Micciancio; Daniele,9999,0,9999,0
1668202037572,CSE 293,022,119367,Orailoglu; Alex,9999,0,9999,0
1668202037572,CSE 293,023,119382,Paturi; Ramamohan,9999,0,9999,0
1668202037572,CSE 293,024,119404,Polikarpova; Nadezhda,9999,0,9999,0
1668202037572,CSE 293,025,119406,Politz; Joseph Gibbs,9999,0,9999,0
1668202037572,CSE 293,026,119411,Porter; George M,9999,0,9999,0
1668202037572,CSE 293,027,119414,Porter; Leonard Emerson,9999,0,9999,0
1668202037572,CSE 293,028,119416,Ramamoorthi; Ravi,9999,0,9999,0
1668202037572,CSE 293,029,119417,Sahoo; Debashis,9999,0,9999,0
1668202037572,CSE 293,030,119420,Saul; Lawrence,9999,0,9999,0
1668202037572,CSE 293,031,119421,Savage; Stefan,9999,0,9999,0
1668202037572,CSE 293,032,119425,Schulze; Jurgen P.,9999,0,9999,0
1668202037572,CSE 293,033,119426,Snoeren; Alex C.,9999,0,9999,0
1668202037572,CSE 293,034,119428,Shang; Jingbo,9999,0,9999,0
1668202037572,CSE 293,035,119430,Stefan; Deian,9999,0,9999,0
1668202037572,CSE 293,036,119431,Su; Hao,9999,0,9999,0
1668202037572,CSE 293,037,119433,Swanson; Steven James,9999,0,9999,0
1668202037572,CSE 293,038,119435,Tullsen; Dean Michael,9999,0,9999,0
1668202037572,CSE 293,039,119483,Voelker; Geoffrey M.,9999,0,9999,0
1668202037572,CSE 293,040,119537,Zhao; Jishen,9999,0,9999,0
1668202037572,CSE 293,041,119538,Zhou; Yuan-Yuan,9999,0,9999,0
1668202037572,CSE 293,042,119539,Gao; Sicun,9999,0,9999,0
1668202037572,CSE 293,043,119540,Weibel; Nadir,9999,0,9999,0
1668202037572,CSE 293,044,119541,Gupta; Rajesh K.,9999,0,9999,0
1668202037572,CSE 293,045,126410,Vaccaro; Kristen Marie,9999,0,9999,0
1668202037572,CSE 293,046,126411,Klemke; Richard,9999,0,9999,0
1668202037996,CSE 294,A00,102459,Voelker; Geoffrey M.,0,0,0,0
1668202037996,CSE 294,B00,111322,Orailoglu; Alex,0,0,0,0
1668202038420,DSE 201,A00,096914,Deutsch; Alin Bernard,30,0,30,0
1668202038853,DSE 210,A00,096915,Dasgupta; Sanjoy,30,0,30,0
1668202039275,DSE 260A,A00,096916,Altintas De Callaf; Ilkay,30,0,30,0
1668202039714,ECE 200,001,103586,Antipa; Nicholas A,9999,0,9999,0
1668202039714,ECE 200,002,103587,Atanasov; Nikolay A.,9999,0,9999,0
1668202039714,ECE 200,003,103588,Bharadia; Dinesh,9999,0,9999,0
1668202039714,ECE 200,004,103589,Cheng; Chung Kuan,9999,0,9999,0
1668202039714,ECE 200,005,103590,Cosman; Pamela C.,9999,0,9999,0
1668202039714,ECE 200,006,103591,Dayeh; Shadi Ahmad,9999,0,9999,0
1668202039714,ECE 200,007,103592,Fainman; Yeshaiahu,9999,0,9999,0
1668202039714,ECE 200,008,103593,Ford; Joseph Earl,9999,0,9999,0
1668202039714,ECE 200,009,103594,Franceschetti; Massimo,9999,0,9999,0
1668202039714,ECE 200,010,103595,Fullerton; Eric E,9999,0,9999,0
1668202039714,ECE 200,011,103596,Galton; Ian A,9999,0,9999,0
1668202039714,ECE 200,012,103597,Gilja; Vikash,9999,0,9999,0
1668202039714,ECE 200,013,103598,Hall; Drew A.,9999,0,9999,0
1668202039714,ECE 200,014,103599,Hsueh; Tzu-Chien,9999,0,9999,0
1668202039714,ECE 200,015,103600,Javidi; Tara,9999,0,9999,0
1668202039714,ECE 200,016,103601,Kahng; Andrew Byun,9999,0,9999,0
1668202039714,ECE 200,017,103602,Kim; Young-Han,9999,0,9999,0
1668202039714,ECE 200,018,103603,Koushanfar; Farinaz,9999,0,9999,0
1668202039714,ECE 200,019,103604,Kuzum; Duygu,9999,0,9999,0
1668202039714,ECE 200,020,103605,Le; Hanh-Phuc,9999,0,9999,0
1668202039714,ECE 200,021,103606,Lin; Bill,9999,0,9999,0
1668202039714,ECE 200,022,103607,Liu; Zhaowei,9998,0,9999,1
1668202039714,ECE 200,023,103608,Lo; Yu-Hwa,9999,0,9999,0
1668202039714,ECE 200,024,103609,Lomakin; Vitaliy,9999,0,9999,0
1668202039714,ECE 200,025,103610,Mercier; Patrick Philip,9999,0,9999,0
1668202039714,ECE 200,026,103611,Meyer; Florian,9999,0,9999,0
1668202039714,ECE 200,027,103612,Milstein; Laurence B.,9999,0,9999,0
1668202039714,ECE 200,028,103613,Mir Arabbaygi; Siavash,9999,0,9999,0
1668202039714,ECE 200,029,103614,Mookherjea; Shayan,9999,0,9999,0
1668202039714,ECE 200,030,103615,Morris; Karcher William,9999,0,9999,0
1668202039714,ECE 200,031,103616,Ng; Tse Nga,9999,0,9999,0
1668202039714,ECE 200,032,103617,Nguyen; Truong Quang,9999,0,9999,0
1668202039714,ECE 200,033,103618,Nomura; Kenji,9999,0,9999,0
1668202039714,ECE 200,034,103619,Orlitsky; Alon,9999,0,9999,0
1668202039714,ECE 200,035,103620,Pal; Piya,9999,0,9999,0
1668202039714,ECE 200,036,103621,Papen; George C.,9999,0,9999,0
1668202039714,ECE 200,037,103622,Radic; Stojan,9999,0,9999,0
1668202039714,ECE 200,038,103623,Rao; Bhaskar D.,9999,0,9999,0
1668202039714,ECE 200,039,103624,Rao; Ramesh R,9999,0,9999,0
1668202039714,ECE 200,040,103625,Rebeiz; Gabriel,9999,0,9999,0
1668202039714,ECE 200,041,103626,Sanford; John R,9999,0,9999,0
1668202039714,ECE 200,042,103627,Siegel; Paul H.,9999,0,9999,0
1668202039714,ECE 200,043,103628,Sievenpiper; Daniel F.,9999,0,9999,0
1668202039714,ECE 200,044,103629,Sworder; David D.,9999,0,9999,0
1668202039714,ECE 200,045,103630,Taur; Yuan,9999,0,9999,0
1668202039714,ECE 200,046,103631,Touri; Behrouz,9999,0,9999,0
1668202039714,ECE 200,047,103632,Trivedi; Mohan M.,9999,0,9999,0
1668202039714,ECE 200,048,103633,Vasconcelos; Nuno,9999,0,9999,0
1668202039714,ECE 200,049,103634,Wang; Xiaolong,9999,0,9999,0
1668202039714,ECE 200,050,103635,Xie; Pengtao,9999,0,9999,0
1668202039714,ECE 200,051,103636,Yip; Michael,9999,0,9999,0
1668202039714,ECE 200,052,103637,Zeger; Kenneth A.,999,0,999,0
1668202039714,ECE 200,053,103638,Zhang; Xinyu,9999,0,9999,0
1668202039714,ECE 200,054,103639,Turakhia; Yatish Girish,9999,0,9999,0
1668202039714,ECE 200,055,103640,Kang; Mingu,9999,0,9999,0
1668202039714,ECE 200,056,103641,Shi; Yuanyuan,9999,0,9999,0
1668202039714,ECE 200,057,103642,Wang; Edward Jay,9999,0,9999,0
1668202039714,ECE 200,058,103643,Zheng; Yang,9999,0,9999,0
1668202040137,ECE 202,A00,103644,Kuzum; Duygu,0,0,0,0
1668202040563,ECE 212BN,A00,103646,Ng; Tse Nga,0,0,0,0
1668202040989,ECE 221,A00,111493,Staff,0,0,0,0
1668202041413,ECE 222B,A00,103647,Lomakin; Vitaliy,0,0,0,0
1668202041838,ECE 230B,A00,103648,Taur; Yuan,0,0,0,0
1668202042265,ECE 238B,A00,103649,Garay; Javier,0,0,0,0
1668202042689,ECE 240B,A00,112900,Fainman; Yeshaiahu,0,0,0,0
1668202043126,ECE 247A,A00,103650,Jokerst; Jesse Vincent,0,0,0,0
1668202043549,ECE 247B,A00,103651,Wang; Joseph,0,0,0,0
1668202043977,ECE 250,A00,103652,Siegel; Paul H.,0,0,0,0
1668202044400,ECE 251A,A00,103654,Rao; Bhaskar D.,0,0,0,0
1668202044824,ECE 257B,A00,103655,Bharadia; Dinesh,0,0,0,0
1668202045255,ECE 258A,A00,103656,Milstein; Laurence B.,0,0,0,0
1668202045677,ECE 260B,A00,103658,Kang; Mingu,0,0,0,0
1668202046100,ECE 264A,A00,103659,Galton; Ian A,0,0,0,0
1668202046525,ECE 265A,A00,103661,Gudem; Prasad S.S.,0,0,0,0
1668202046950,ECE 265D,A00,103662,Gudem; Prasad S.S.,0,0,0,0
1668202047374,ECE 268,A00,103663,Koushanfar; Farinaz,0,0,0,0
1668202047795,ECE 269,A01,103665,Pal; Piya,0,0,0,0
1668202048229,ECE 271B,A00,103666,Vasconcelos; Manuela,0,0,0,0
1668202048652,ECE 276A,A00,103667,Atanasov; Nikolay A.,0,0,0,0
1668202049075,ECE 277,A00,103668,An; Cheolhong,0,0,0,0
1668202049498,ECE 279,A00,117947,Hall; Drew A.,0,0,0,0
1668202050342,ECE 283,A00,103670,Hsueh; Tzu-Chien,0,0,0,0
1668202050764,ECE 284,A00,103671,Turakhia; Yatish Girish,0,0,0,0
1668202051187,ECE 285,A00,103672,Zheng; Yang,0,0,0,0
1668202051187,ECE 285,B00,103673,Sworder; David D.,0,0,0,0
1668202051614,ECE 287,A00,103676,Javidi; Tara,0,0,0,0
1668202052037,MATH 200B,A00,098023,Salehi Golsefidy; Alireza,12,0,15,3
1668202052460,MATH 202B,A00,098024,Rhoades; Brendon Patrick,9,0,15,6
1668202052886,MATH 203B,A00,098025,Oprea; Dragos N.,10,0,15,5
1668202053309,MATH 204B,A00,098026,Sorensen; Claus M,13,0,15,2
1668202053739,MATH 208,A00,098027,Izadi; Elham,7,0,10,3
1668202054173,MATH 209,A00,098028,Pollack; Aaron,10,0,10,0
1668202054598,MATH 211A,A00,112919,Rogalski; Daniel,9,0,10,1
1668202055023,MATH 211B,A00,112920,Seward; Brandon M.,9,0,10,1
1668202055448,MATH 218,A00,098029,Li; Bo,10,0,10,0
1668202055877,MATH 220B,A00,098030,Novak; Jonathan I,11,0,15,4
1668202056301,MATH 221A,A00,098031,Ebenfelt; Peter F,13,0,15,2
1668202056729,MATH 231B,A00,098032,Zlatos; Andrej,12,0,15,3
1668202057166,MATH 240B,A00,098033,Ni; Lei,9,0,15,6
1668202057595,MATH 243,A00,098034,Jekel; David Andrew,10,0,10,0
1668202058020,MATH 245A,A00,098035,Nie; Jiawang,0,0,15,16
1668202058442,MATH 248,A00,098036,Bejenaru; Ioan,10,0,10,0
1668202058871,MATH 250B,A00,098037,Spolaor; Luca,14,0,15,1
1668202059298,MATH 258,A00,098038,Ni; Lei,10,0,10,0
1668202059726,MATH 264B,A00,098041,Rhoades; Brendon Patrick,9,0,15,6
1668202060150,MATH 268,A00,098042,Buss; Samuel R,10,0,10,0
1668202060577,MATH 269,A00,098043,Rhoades; Brendon Patrick,10,0,10,0
1668202061010,MATH 270B,A00,098044,Li; Bo,10,0,15,5
1668202061434,MATH 272B,A00,098045,Holst; Michael J,13,0,15,2
1668202061867,MATH 273A,A00,098046,Tian; Xiaochuan,10,0,15,5
1668202062291,MATH 275,A01,098048,Tian; Xiaochuan,6,0,10,4
1668202062813,MATH 278A,A00,098049,Holst; Michael J,8,0,10,2
1668202063251,MATH 278B,A00,098050,Cloninger; Alexander,10,0,10,0
1668202063685,MATH 278C,A00,098051,Nie; Jiawang,7,0,10,3
1668202064108,MATH 280B,A00,098052,Zheng; Tianyi,10,0,15,5
1668202064532,MATH 281B,A00,098053,Bradic; Jelena,2,0,15,13
1668202064976,MATH 282B,A00,098054,Arias-Castro; Ery,0,0,15,15
1668202065402,MATH 285,A00,098055,Fitzsimmons; Patrick J,0,0,15,17
1668202065838,MATH 287B,A00,098056,Arias-Castro; Ery,2,0,15,13
1668202066271,MATH 288,A00,098057,Agarwal; Pooja,9,0,10,1
1668202066271,MATH 288,B00,098058,Zhang; Danna,8,0,10,2
1668202066271,MATH 288,C00,098059,Williams; Ruth J,10,0,10,0
1668202066701,MATH 290B,A00,098060,Roberts; Justin Deritter,13,0,15,2
1668202067122,MATH 292,A00,098061,Belmont; Eva Kinoshita,10,0,10,0
1668202067548,MATH 295,A00,098062,Suk; Andrew Hoon,48,0,50,2
1668202067981,MATH 296,A00,098063,Novak; Jonathan I,20,0,20,0
1668202068411,MATH 297,001,098064,Gamst; Anthony Collins,9997,0,9999,2
1668202570156,COGS 205,A00,101395,Chiba; Andrea,19,0,20,1
1668202570578,COGS 210B,001,101404,Greene; Deanna Jacquelyn,9998,0,9999,1
1668202570578,COGS 210B,002,101417,Xia; Haijun,9999,0,9999,0
1668202570578,COGS 210B,003,101422,Nitz; Douglas A.,9999,0,9999,0
1668202570578,COGS 210B,004,101423,Hollan; James D.,9998,0,9999,1
1668202570578,COGS 210B,005,101424,Deak; Gedeon O.,9998,0,9999,1
1668202570578,COGS 210B,006,101425,Rossano; Federico,9999,0,9999,0
1668202571006,COGS 211B,A00,101427,Coulson; Seana M,9996,0,9999,3
1668202571428,COGS 220,A00,101428,Hollan; James D.,0,0,25,25
1668202571851,COGS 229,A00,101429,Dow; Steven P,18,0,25,7
1668202572273,COGS 230,A00,101430,Klemmer; Scott R,12,0,17,5
1668202572697,COGS 234,A00,101431,Xia; Haijun,2,0,25,23
1668202573119,COGS 260,A00,101432,Kiyonaga; Anastasia,21,0,25,4
1668202573119,COGS 260,B00,101433,Kirsh; David Joel,16,0,25,9
1668202573544,CSE 202,A00,102371,Impagliazzo; Russell,0,0,0,0
1668202573969,CSE 203B,A01,102373,Cheng; Chung Kuan,0,0,0,0
1668202574391,CSE 208,A00,102374,Micciancio; Daniele,0,0,0,0
1668202574824,CSE 209A,A00,112895,Impagliazzo; Russell,0,0,15,15
1668202575251,CSE 209B,A00,108005,Bellare; Mihir,0,0,0,0
1668202575677,CSE 210,A00,113163,Coblenz; Michael J,0,0,0,0
1668202576099,CSE 219,A00,106111,Dow; Steven P,0,0,20,20
1668202576522,CSE 221,A00,102376,Voelker; Geoffrey M.,0,0,0,0
1668202576946,CSE 224,A01,102378,Porter; George M,0,0,0,0
1668202577381,CSE 229A,A00,102379,Savage; Stefan,0,0,0,0
1668202577807,CSE 229C,A00,102380,Munyaka; Imani N. S.,0,0,0,0
1668202578232,CSE 232B,A00,102382,Deutsch; Alin Bernard,0,0,0,0
1668202578656,CSE 234,A01,112904,Kumar; Arun Kumar,0,0,0,0
1668202579085,CSE 237A,A00,102383,Rosing; Tajana Simunic,0,0,0,0
1668202579512,CSE 239A,A00,102384,Deutsch; Alin Bernard,0,0,0,0
1668202579936,CSE 239B,A00,102385,Polikarpova; Nadezhda,0,0,0,0
1668202580367,CSE 240A,A00,102386,Pannuto; Patrick William,0,0,0,0
1668202580793,CSE 240B,A00,102387,Zhao; Jishen,0,0,0,0
1668202581223,CSE 241A,A00,106406,Kang; Mingu,0,0,0,0
1668202581644,CSE 249B,A00,102388,Kahng; Andrew Byun,0,0,8,8
1668202582071,CSE 251B,A01,102392,Cottrell; Garrison W,0,0,0,0
1668202582071,CSE 251B,A02,102393,Cottrell; Garrison W,0,0,0,0
1668202582505,CSE 252B,A00,102394,Ochoa; Benjamin Lawrence,0,0,0,0
1668202582938,CSE 257,A01,102396,Gao; Sicun,0,0,0,0
1668202583367,CSE 272,A00,102397,Li; Tzumao,0,0,0,0
1668202583791,CSE 274,A00,111323,Chern; Albert Ren-Haur,0,0,0,0
1668202584218,CSE 282,A00,102398,Pevzner; Pavel Arkadjevich,0,0,0,0
1668202584728,CSE 284,A00,114175,Gymrek; Melissa Ann,0,0,0,0
1668202585164,CSE 290,A00,102399,Chandraker; Manmohan Krishna,0,0,0,0
1668202585164,CSE 290,B00,102400,Vaccaro; Kristen Marie,0,0,25,25
1668202585164,CSE 290,C00,102414,Pannuto; Patrick William,0,0,25,25
1668202585164,CSE 290,D00,102427,Pevzner; Pavel Arkadjevich,0,0,0,0
1668202585164,CSE 290,E00,102429,Zhao; Jishen,0,0,0,0
1668202585164,CSE 290,F00,102436,Tullsen; Dean Michael,0,0,0,0
1668202585164,CSE 290,G00,102440,Christensen; Henrik I,0,0,20,20
1668202585602,CSE 291,A00,102443,Su; Hao,0,0,0,0
1668202585602,CSE 291,B00,102448,Polikarpova; Nadezhda,0,0,0,0
1668202585602,CSE 291,C00,102453,Vaccaro; Kristen Marie,0,0,0,0
1668202585602,CSE 291,D00,111343,Savage; Stefan,0,0,0,0
1668202585602,CSE 291,E00,116474,Claffy; Kimberly Claire,0,0,0,0
1668202585602,CSE 291,F00,116479,Pasquale; Joseph,0,0,0,0
1668202586082,CSE 293,001,119111,Bafna; Vineet,9999,0,9999,0
1668202586082,CSE 293,002,119118,Bellare; Mihir,9999,0,9999,0
1668202586082,CSE 293,003,119122,Berg-Kirkpatrick; Taylor D,9999,0,9999,0
1668202586082,CSE 293,004,119135,Christensen; Henrik I,9999,0,9999,0
1668202586082,CSE 293,005,119142,Cottrell; Garrison W,9999,0,9999,0
1668202586082,CSE 293,006,119146,Deutsch; Alin Bernard,9999,0,9999,0
1668202586082,CSE 293,007,119159,Esmaeilzadeh; Hadi,9999,0,9999,0
1668202586082,CSE 293,008,119166,Freund; Yoav,9999,0,9999,0
1668202586082,CSE 293,009,119170,Griswold; William G.,9999,0,9999,0
1668202586082,CSE 293,010,119183,Gymrek; Melissa Ann,9999,0,9999,0
1668202586082,CSE 293,011,119190,Heninger; Nadia A,9999,0,9999,0
1668202586082,CSE 293,012,119230,Impagliazzo; Russell,9999,0,9999,0
1668202586082,CSE 293,013,119232,Jhala; Ranjit,9999,0,9999,0
1668202586082,CSE 293,014,119233,Kahng; Andrew Byun,9999,0,9999,0
1668202586082,CSE 293,015,119298,Kane; Daniel Mertz,9999,0,9999,0
1668202586082,CSE 293,016,119299,Kriegman; David J,9999,0,9999,0
1668202586082,CSE 293,017,119300,Kumar; Arun Kumar,9999,0,9999,0
1668202586082,CSE 293,018,119301,Lerner; Sorin,9999,0,9999,0
1668202586082,CSE 293,019,119302,Lovett; Shachar,9999,0,9999,0
1668202586082,CSE 293,020,119303,McAuley; Julian John,9999,0,9999,0
1668202586082,CSE 293,021,119304,Micciancio; Daniele,9999,0,9999,0
1668202586082,CSE 293,022,119367,Orailoglu; Alex,9999,0,9999,0
1668202586082,CSE 293,023,119382,Paturi; Ramamohan,9999,0,9999,0
1668202586082,CSE 293,024,119404,Polikarpova; Nadezhda,9999,0,9999,0
1668202586082,CSE 293,025,119406,Politz; Joseph Gibbs,9999,0,9999,0
1668202586082,CSE 293,026,119411,Porter; George M,9999,0,9999,0
1668202586082,CSE 293,027,119414,Porter; Leonard Emerson,9999,0,9999,0
1668202586082,CSE 293,028,119416,Ramamoorthi; Ravi,9999,0,9999,0
1668202586082,CSE 293,029,119417,Sahoo; Debashis,9999,0,9999,0
1668202586082,CSE 293,030,119420,Saul; Lawrence,9999,0,9999,0
1668202586082,CSE 293,031,119421,Savage; Stefan,9999,0,9999,0
1668202586082,CSE 293,032,119425,Schulze; Jurgen P.,9999,0,9999,0
1668202586082,CSE 293,033,119426,Snoeren; Alex C.,9999,0,9999,0
1668202586082,CSE 293,034,119428,Shang; Jingbo,9999,0,9999,0
1668202586082,CSE 293,035,119430,Stefan; Deian,9999,0,9999,0
1668202586082,CSE 293,036,119431,Su; Hao,9999,0,9999,0
1668202586082,CSE 293,037,119433,Swanson; Steven James,9999,0,9999,0
1668202586082,CSE 293,038,119435,Tullsen; Dean Michael,9999,0,9999,0
1668202586082,CSE 293,039,119483,Voelker; Geoffrey M.,9999,0,9999,0
1668202586082,CSE 293,040,119537,Zhao; Jishen,9999,0,9999,0
1668202586082,CSE 293,041,119538,Zhou; Yuan-Yuan,9999,0,9999,0
1668202586082,CSE 293,042,119539,Gao; Sicun,9999,0,9999,0
1668202586082,CSE 293,043,119540,Weibel; Nadir,9999,0,9999,0
1668202586082,CSE 293,044,119541,Gupta; Rajesh K.,9999,0,9999,0
1668202586082,CSE 293,045,126410,Vaccaro; Kristen Marie,9999,0,9999,0
1668202586082,CSE 293,046,126411,Klemke; Richard,9999,0,9999,0
1668202586513,CSE 294,A00,102459,Voelker; Geoffrey M.,0,0,0,0
1668202586513,CSE 294,B00,111322,Orailoglu; Alex,0,0,0,0
1668202586949,DSE 201,A00,096914,Deutsch; Alin Bernard,30,0,30,0
1668202587370,DSE 210,A00,096915,Dasgupta; Sanjoy,30,0,30,0
1668202587791,DSE 260A,A00,096916,Altintas De Callaf; Ilkay,30,0,30,0
1668202588218,ECE 200,001,103586,Antipa; Nicholas A,9999,0,9999,0
1668202588218,ECE 200,002,103587,Atanasov; Nikolay A.,9999,0,9999,0
1668202588218,ECE 200,003,103588,Bharadia; Dinesh,9999,0,9999,0
1668202588218,ECE 200,004,103589,Cheng; Chung Kuan,9999,0,9999,0
1668202588218,ECE 200,005,103590,Cosman; Pamela C.,9999,0,9999,0
1668202588218,ECE 200,006,103591,Dayeh; Shadi Ahmad,9999,0,9999,0
1668202588218,ECE 200,007,103592,Fainman; Yeshaiahu,9999,0,9999,0
1668202588218,ECE 200,008,103593,Ford; Joseph Earl,9999,0,9999,0
1668202588218,ECE 200,009,103594,Franceschetti; Massimo,9999,0,9999,0
1668202588218,ECE 200,010,103595,Fullerton; Eric E,9999,0,9999,0
1668202588218,ECE 200,011,103596,Galton; Ian A,9999,0,9999,0
1668202588218,ECE 200,012,103597,Gilja; Vikash,9999,0,9999,0
1668202588218,ECE 200,013,103598,Hall; Drew A.,9999,0,9999,0
1668202588218,ECE 200,014,103599,Hsueh; Tzu-Chien,9999,0,9999,0
1668202588218,ECE 200,015,103600,Javidi; Tara,9999,0,9999,0
1668202588218,ECE 200,016,103601,Kahng; Andrew Byun,9999,0,9999,0
1668202588218,ECE 200,017,103602,Kim; Young-Han,9999,0,9999,0
1668202588218,ECE 200,018,103603,Koushanfar; Farinaz,9999,0,9999,0
1668202588218,ECE 200,019,103604,Kuzum; Duygu,9999,0,9999,0
1668202588218,ECE 200,020,103605,Le; Hanh-Phuc,9999,0,9999,0
1668202588218,ECE 200,021,103606,Lin; Bill,9999,0,9999,0
1668202588218,ECE 200,022,103607,Liu; Zhaowei,9998,0,9999,1
1668202588218,ECE 200,023,103608,Lo; Yu-Hwa,9999,0,9999,0
1668202588218,ECE 200,024,103609,Lomakin; Vitaliy,9999,0,9999,0
1668202588218,ECE 200,025,103610,Mercier; Patrick Philip,9999,0,9999,0
1668202588218,ECE 200,026,103611,Meyer; Florian,9999,0,9999,0
1668202588218,ECE 200,027,103612,Milstein; Laurence B.,9999,0,9999,0
1668202588218,ECE 200,028,103613,Mir Arabbaygi; Siavash,9999,0,9999,0
1668202588218,ECE 200,029,103614,Mookherjea; Shayan,9999,0,9999,0
1668202588218,ECE 200,030,103615,Morris; Karcher William,9999,0,9999,0
1668202588218,ECE 200,031,103616,Ng; Tse Nga,9999,0,9999,0
1668202588218,ECE 200,032,103617,Nguyen; Truong Quang,9999,0,9999,0
1668202588218,ECE 200,033,103618,Nomura; Kenji,9999,0,9999,0
1668202588218,ECE 200,034,103619,Orlitsky; Alon,9999,0,9999,0
1668202588218,ECE 200,035,103620,Pal; Piya,9999,0,9999,0
1668202588218,ECE 200,036,103621,Papen; George C.,9999,0,9999,0
1668202588218,ECE 200,037,103622,Radic; Stojan,9999,0,9999,0
1668202588218,ECE 200,038,103623,Rao; Bhaskar D.,9999,0,9999,0
1668202588218,ECE 200,039,103624,Rao; Ramesh R,9999,0,9999,0
1668202588218,ECE 200,040,103625,Rebeiz; Gabriel,9999,0,9999,0
1668202588218,ECE 200,041,103626,Sanford; John R,9999,0,9999,0
1668202588218,ECE 200,042,103627,Siegel; Paul H.,9999,0,9999,0
1668202588218,ECE 200,043,103628,Sievenpiper; Daniel F.,9999,0,9999,0
1668202588218,ECE 200,044,103629,Sworder; David D.,9999,0,9999,0
1668202588218,ECE 200,045,103630,Taur; Yuan,9999,0,9999,0
1668202588218,ECE 200,046,103631,Touri; Behrouz,9999,0,9999,0
1668202588218,ECE 200,047,103632,Trivedi; Mohan M.,9999,0,9999,0
1668202588218,ECE 200,048,103633,Vasconcelos; Nuno,9999,0,9999,0
1668202588218,ECE 200,049,103634,Wang; Xiaolong,9999,0,9999,0
1668202588218,ECE 200,050,103635,Xie; Pengtao,9999,0,9999,0
1668202588218,ECE 200,051,103636,Yip; Michael,9999,0,9999,0
1668202588218,ECE 200,052,103637,Zeger; Kenneth A.,999,0,999,0
1668202588218,ECE 200,053,103638,Zhang; Xinyu,9999,0,9999,0
1668202588218,ECE 200,054,103639,Turakhia; Yatish Girish,9999,0,9999,0
1668202588218,ECE 200,055,103640,Kang; Mingu,9999,0,9999,0
1668202588218,ECE 200,056,103641,Shi; Yuanyuan,9999,0,9999,0
1668202588218,ECE 200,057,103642,Wang; Edward Jay,9999,0,9999,0
1668202588218,ECE 200,058,103643,Zheng; Yang,9999,0,9999,0
1668202588642,ECE 202,A00,103644,Kuzum; Duygu,0,0,0,0
1668202589065,ECE 212BN,A00,103646,Ng; Tse Nga,0,0,0,0
1668202589494,ECE 221,A00,111493,Staff,0,0,0,0
1668202589919,ECE 222B,A00,103647,Lomakin; Vitaliy,0,0,0,0
1668202590346,ECE 230B,A00,103648,Taur; Yuan,0,0,0,0
1668202590778,ECE 238B,A00,103649,Garay; Javier,0,0,0,0
1668202591203,ECE 240B,A00,112900,Fainman; Yeshaiahu,0,0,0,0
1668202591627,ECE 247A,A00,103650,Jokerst; Jesse Vincent,0,0,0,0
1668202592052,ECE 247B,A00,103651,Wang; Joseph,0,0,0,0
1668202592478,ECE 250,A00,103652,Siegel; Paul H.,0,0,0,0
1668202592906,ECE 251A,A00,103654,Rao; Bhaskar D.,0,0,0,0
1668202593327,ECE 257B,A00,103655,Bharadia; Dinesh,0,0,0,0
1668202593762,ECE 258A,A00,103656,Milstein; Laurence B.,0,0,0,0
1668202594184,ECE 260B,A00,103658,Kang; Mingu,0,0,0,0
1668202594609,ECE 264A,A00,103659,Galton; Ian A,0,0,0,0
1668202595048,ECE 265A,A00,103661,Gudem; Prasad S.S.,0,0,0,0
1668202595483,ECE 265D,A00,103662,Gudem; Prasad S.S.,0,0,0,0
1668202595916,ECE 268,A00,103663,Koushanfar; Farinaz,0,0,0,0
1668202596347,ECE 269,A01,103665,Pal; Piya,0,0,0,0
1668202596773,ECE 271B,A00,103666,Vasconcelos; Manuela,0,0,0,0
1668202597195,ECE 276A,A00,103667,Atanasov; Nikolay A.,0,0,0,0
1668202597621,ECE 277,A00,103668,An; Cheolhong,0,0,0,0
1668202598046,ECE 279,A00,117947,Hall; Drew A.,0,0,0,0
1668202598891,ECE 283,A00,103670,Hsueh; Tzu-Chien,0,0,0,0
1668202599313,ECE 284,A00,103671,Turakhia; Yatish Girish,0,0,0,0
1668202599736,ECE 285,A00,103672,Zheng; Yang,0,0,0,0
1668202599736,ECE 285,B00,103673,Sworder; David D.,0,0,0,0
1668202600158,ECE 287,A00,103676,Javidi; Tara,0,0,0,0
1668202600585,MATH 200B,A00,098023,Salehi Golsefidy; Alireza,12,0,15,3
1668202601010,MATH 202B,A00,098024,Rhoades; Brendon Patrick,9,0,15,6
1668202601446,MATH 203B,A00,098025,Oprea; Dragos N.,10,0,15,5
1668202601869,MATH 204B,A00,098026,Sorensen; Claus M,13,0,15,2
1668202602291,MATH 208,A00,098027,Izadi; Elham,7,0,10,3
1668202602721,MATH 209,A00,098028,Pollack; Aaron,10,0,10,0
1668202603143,MATH 211A,A00,112919,Rogalski; Daniel,9,0,10,1
1668202603568,MATH 211B,A00,112920,Seward; Brandon M.,9,0,10,1
1668202603996,MATH 218,A00,098029,Li; Bo,10,0,10,0
1668202604425,MATH 220B,A00,098030,Novak; Jonathan I,11,0,15,4
1668202604848,MATH 221A,A00,098031,Ebenfelt; Peter F,13,0,15,2
1668202605271,MATH 231B,A00,098032,Zlatos; Andrej,12,0,15,3
1668202605692,MATH 240B,A00,098033,Ni; Lei,9,0,15,6
1668202606116,MATH 243,A00,098034,Jekel; David Andrew,10,0,10,0
1668202606555,MATH 245A,A00,098035,Nie; Jiawang,0,0,15,16
1668202606981,MATH 248,A00,098036,Bejenaru; Ioan,10,0,10,0
1668202607413,MATH 250B,A00,098037,Spolaor; Luca,14,0,15,1
1668202607844,MATH 258,A00,098038,Ni; Lei,10,0,10,0
1668202608269,MATH 264B,A00,098041,Rhoades; Brendon Patrick,9,0,15,6
1668202608691,MATH 268,A00,098042,Buss; Samuel R,10,0,10,0
1668202609117,MATH 269,A00,098043,Rhoades; Brendon Patrick,10,0,10,0
1668202609539,MATH 270B,A00,098044,Li; Bo,10,0,15,5
1668202609962,MATH 272B,A00,098045,Holst; Michael J,13,0,15,2
1668202610385,MATH 273A,A00,098046,Tian; Xiaochuan,10,0,15,5
1668202610812,MATH 275,A01,098048,Tian; Xiaochuan,6,0,10,4
1668202611235,MATH 278A,A00,098049,Holst; Michael J,8,0,10,2
1668202611657,MATH 278B,A00,098050,Cloninger; Alexander,10,0,10,0
1668202612083,MATH 278C,A00,098051,Nie; Jiawang,7,0,10,3
1668202612505,MATH 280B,A00,098052,Zheng; Tianyi,10,0,15,5
1668202612930,MATH 281B,A00,098053,Bradic; Jelena,2,0,15,13
1668202613360,MATH 282B,A00,098054,Arias-Castro; Ery,0,0,15,15
1668202613792,MATH 285,A00,098055,Fitzsimmons; Patrick J,0,0,15,17
1668202614217,MATH 287B,A00,098056,Arias-Castro; Ery,2,0,15,13
1668202614640,MATH 288,A00,098057,Agarwal; Pooja,9,0,10,1
1668202614640,MATH 288,B00,098058,Zhang; Danna,8,0,10,2
1668202614640,MATH 288,C00,098059,Williams; Ruth J,10,0,10,0
1668202615065,MATH 290B,A00,098060,Roberts; Justin Deritter,13,0,15,2
1668202615497,MATH 292,A00,098061,Belmont; Eva Kinoshita,10,0,10,0
1668202615922,MATH 295,A00,098062,Suk; Andrew Hoon,48,0,50,2
1668202616346,MATH 296,A00,098063,Novak; Jonathan I,20,0,20,0
1668202616779,MATH 297,001,098064,Gamst; Anthony Collins,9997,0,9999,2
1668203118854,COGS 205,A00,101395,Chiba; Andrea,19,0,20,1
1668203119277,COGS 210B,001,101404,Greene; Deanna Jacquelyn,9998,0,9999,1
1668203119277,COGS 210B,002,101417,Xia; Haijun,9999,0,9999,0
1668203119277,COGS 210B,003,101422,Nitz; Douglas A.,9999,0,9999,0
1668203119277,COGS 210B,004,101423,Hollan; James D.,9998,0,9999,1
1668203119277,COGS 210B,005,101424,Deak; Gedeon O.,9998,0,9999,1
1668203119277,COGS 210B,006,101425,Rossano; Federico,9999,0,9999,0
1668203119705,COGS 211B,A00,101427,Coulson; Seana M,9996,0,9999,3
1668203120130,COGS 220,A00,101428,Hollan; James D.,0,0,25,25
1668203120569,COGS 229,A00,101429,Dow; Steven P,18,0,25,7
1668203121002,COGS 230,A00,101430,Klemmer; Scott R,12,0,17,5
1668203121432,COGS 234,A00,101431,Xia; Haijun,2,0,25,23
1668203121857,COGS 260,A00,101432,Kiyonaga; Anastasia,21,0,25,4
1668203121857,COGS 260,B00,101433,Kirsh; David Joel,16,0,25,9
1668203122282,CSE 202,A00,102371,Impagliazzo; Russell,0,0,0,0
1668203122706,CSE 203B,A01,102373,Cheng; Chung Kuan,0,0,0,0
1668203123130,CSE 208,A00,102374,Micciancio; Daniele,0,0,0,0
1668203123551,CSE 209A,A00,112895,Impagliazzo; Russell,0,0,15,15
1668203123982,CSE 209B,A00,108005,Bellare; Mihir,0,0,0,0
1668203124420,CSE 210,A00,113163,Coblenz; Michael J,0,0,0,0
1668203124845,CSE 219,A00,106111,Dow; Steven P,0,0,20,20
1668203125266,CSE 221,A00,102376,Voelker; Geoffrey M.,0,0,0,0
1668203125689,CSE 224,A01,102378,Porter; George M,0,0,0,0
1668203126120,CSE 229A,A00,102379,Savage; Stefan,0,0,0,0
1668203126545,CSE 229C,A00,102380,Munyaka; Imani N. S.,0,0,0,0
1668203126968,CSE 232B,A00,102382,Deutsch; Alin Bernard,0,0,0,0
1668203127389,CSE 234,A01,112904,Kumar; Arun Kumar,0,0,0,0
1668203127816,CSE 237A,A00,102383,Rosing; Tajana Simunic,0,0,0,0
1668203128238,CSE 239A,A00,102384,Deutsch; Alin Bernard,0,0,0,0
1668203128665,CSE 239B,A00,102385,Polikarpova; Nadezhda,0,0,0,0
1668203129087,CSE 240A,A00,102386,Pannuto; Patrick William,0,0,0,0
1668203129508,CSE 240B,A00,102387,Zhao; Jishen,0,0,0,0
1668203129934,CSE 241A,A00,106406,Kang; Mingu,0,0,0,0
1668203130357,CSE 249B,A00,102388,Kahng; Andrew Byun,0,0,8,8
1668203130783,CSE 251B,A01,102392,Cottrell; Garrison W,0,0,0,0
1668203130783,CSE 251B,A02,102393,Cottrell; Garrison W,0,0,0,0
1668203131207,CSE 252B,A00,102394,Ochoa; Benjamin Lawrence,0,0,0,0
1668203131636,CSE 257,A01,102396,Gao; Sicun,0,0,0,0
1668203132058,CSE 272,A00,102397,Li; Tzumao,0,0,0,0
1668203132482,CSE 274,A00,111323,Chern; Albert Ren-Haur,0,0,0,0
1668203132914,CSE 282,A00,102398,Pevzner; Pavel Arkadjevich,0,0,0,0
1668203133338,CSE 284,A00,114175,Gymrek; Melissa Ann,0,0,0,0
1668203133771,CSE 290,A00,102399,Chandraker; Manmohan Krishna,0,0,0,0
1668203133771,CSE 290,B00,102400,Vaccaro; Kristen Marie,0,0,25,25
1668203133771,CSE 290,C00,102414,Pannuto; Patrick William,0,0,25,25
1668203133771,CSE 290,D00,102427,Pevzner; Pavel Arkadjevich,0,0,0,0
1668203133771,CSE 290,E00,102429,Zhao; Jishen,0,0,0,0
1668203133771,CSE 290,F00,102436,Tullsen; Dean Michael,0,0,0,0
1668203133771,CSE 290,G00,102440,Christensen; Henrik I,0,0,20,20
1668203134194,CSE 291,A00,102443,Su; Hao,0,0,0,0
1668203134194,CSE 291,B00,102448,Polikarpova; Nadezhda,0,0,0,0
1668203134194,CSE 291,C00,102453,Vaccaro; Kristen Marie,0,0,0,0
1668203134194,CSE 291,D00,111343,Savage; Stefan,0,0,0,0
1668203134194,CSE 291,E00,116474,Claffy; Kimberly Claire,0,0,0,0
1668203134194,CSE 291,F00,116479,Pasquale; Joseph,0,0,0,0
1668203134641,CSE 293,001,119111,Bafna; Vineet,9999,0,9999,0
1668203134641,CSE 293,002,119118,Bellare; Mihir,9999,0,9999,0
1668203134641,CSE 293,003,119122,Berg-Kirkpatrick; Taylor D,9999,0,9999,0
1668203134641,CSE 293,004,119135,Christensen; Henrik I,9999,0,9999,0
1668203134641,CSE 293,005,119142,Cottrell; Garrison W,9999,0,9999,0
1668203134641,CSE 293,006,119146,Deutsch; Alin Bernard,9999,0,9999,0
1668203134641,CSE 293,007,119159,Esmaeilzadeh; Hadi,9999,0,9999,0
1668203134641,CSE 293,008,119166,Freund; Yoav,9999,0,9999,0
1668203134641,CSE 293,009,119170,Griswold; William G.,9999,0,9999,0
1668203134641,CSE 293,010,119183,Gymrek; Melissa Ann,9999,0,9999,0
1668203134641,CSE 293,011,119190,Heninger; Nadia A,9999,0,9999,0
1668203134641,CSE 293,012,119230,Impagliazzo; Russell,9999,0,9999,0
1668203134641,CSE 293,013,119232,Jhala; Ranjit,9999,0,9999,0
1668203134641,CSE 293,014,119233,Kahng; Andrew Byun,9999,0,9999,0
1668203134641,CSE 293,015,119298,Kane; Daniel Mertz,9999,0,9999,0
1668203134641,CSE 293,016,119299,Kriegman; David J,9999,0,9999,0
1668203134641,CSE 293,017,119300,Kumar; Arun Kumar,9999,0,9999,0
1668203134641,CSE 293,018,119301,Lerner; Sorin,9999,0,9999,0
1668203134641,CSE 293,019,119302,Lovett; Shachar,9999,0,9999,0
1668203134641,CSE 293,020,119303,McAuley; Julian John,9999,0,9999,0
1668203134641,CSE 293,021,119304,Micciancio; Daniele,9999,0,9999,0
1668203134641,CSE 293,022,119367,Orailoglu; Alex,9999,0,9999,0
1668203134641,CSE 293,023,119382,Paturi; Ramamohan,9999,0,9999,0
1668203134641,CSE 293,024,119404,Polikarpova; Nadezhda,9999,0,9999,0
1668203134641,CSE 293,025,119406,Politz; Joseph Gibbs,9999,0,9999,0
1668203134641,CSE 293,026,119411,Porter; George M,9999,0,9999,0
1668203134641,CSE 293,027,119414,Porter; Leonard Emerson,9999,0,9999,0
1668203134641,CSE 293,028,119416,Ramamoorthi; Ravi,9999,0,9999,0
1668203134641,CSE 293,029,119417,Sahoo; Debashis,9999,0,9999,0
1668203134641,CSE 293,030,119420,Saul; Lawrence,9999,0,9999,0
1668203134641,CSE 293,031,119421,Savage; Stefan,9999,0,9999,0
1668203134641,CSE 293,032,119425,Schulze; Jurgen P.,9999,0,9999,0
1668203134641,CSE 293,033,119426,Snoeren; Alex C.,9999,0,9999,0
1668203134641,CSE 293,034,119428,Shang; Jingbo,9999,0,9999,0
1668203134641,CSE 293,035,119430,Stefan; Deian,9999,0,9999,0
1668203134641,CSE 293,036,119431,Su; Hao,9999,0,9999,0
1668203134641,CSE 293,037,119433,Swanson; Steven James,9999,0,9999,0
1668203134641,CSE 293,038,119435,Tullsen; Dean Michael,9999,0,9999,0
1668203134641,CSE 293,039,119483,Voelker; Geoffrey M.,9999,0,9999,0
1668203134641,CSE 293,040,119537,Zhao; Jishen,9999,0,9999,0
1668203134641,CSE 293,041,119538,Zhou; Yuan-Yuan,9999,0,9999,0
1668203134641,CSE 293,042,119539,Gao; Sicun,9999,0,9999,0
1668203134641,CSE 293,043,119540,Weibel; Nadir,9999,0,9999,0
1668203134641,CSE 293,044,119541,Gupta; Rajesh K.,9999,0,9999,0
1668203134641,CSE 293,045,126410,Vaccaro; Kristen Marie,9999,0,9999,0
1668203134641,CSE 293,046,126411,Klemke; Richard,9999,0,9999,0
1668203135077,CSE 294,A00,102459,Voelker; Geoffrey M.,0,0,0,0
1668203135077,CSE 294,B00,111322,Orailoglu; Alex,0,0,0,0
1668203135499,DSE 201,A00,096914,Deutsch; Alin Bernard,30,0,30,0
1668203135923,DSE 210,A00,096915,Dasgupta; Sanjoy,30,0,30,0
1668203136347,DSE 260A,A00,096916,Altintas De Callaf; Ilkay,30,0,30,0
1668203136774,ECE 200,001,103586,Antipa; Nicholas A,9999,0,9999,0
1668203136774,ECE 200,002,103587,Atanasov; Nikolay A.,9999,0,9999,0
1668203136774,ECE 200,003,103588,Bharadia; Dinesh,9999,0,9999,0
1668203136774,ECE 200,004,103589,Cheng; Chung Kuan,9999,0,9999,0
1668203136774,ECE 200,005,103590,Cosman; Pamela C.,9999,0,9999,0
1668203136774,ECE 200,006,103591,Dayeh; Shadi Ahmad,9999,0,9999,0
1668203136774,ECE 200,007,103592,Fainman; Yeshaiahu,9999,0,9999,0
1668203136774,ECE 200,008,103593,Ford; Joseph Earl,9999,0,9999,0
1668203136774,ECE 200,009,103594,Franceschetti; Massimo,9999,0,9999,0
1668203136774,ECE 200,010,103595,Fullerton; Eric E,9999,0,9999,0
1668203136774,ECE 200,011,103596,Galton; Ian A,9999,0,9999,0
1668203136774,ECE 200,012,103597,Gilja; Vikash,9999,0,9999,0
1668203136774,ECE 200,013,103598,Hall; Drew A.,9999,0,9999,0
1668203136774,ECE 200,014,103599,Hsueh; Tzu-Chien,9999,0,9999,0
1668203136774,ECE 200,015,103600,Javidi; Tara,9999,0,9999,0
1668203136774,ECE 200,016,103601,Kahng; Andrew Byun,9999,0,9999,0
1668203136774,ECE 200,017,103602,Kim; Young-Han,9999,0,9999,0
1668203136774,ECE 200,018,103603,Koushanfar; Farinaz,9999,0,9999,0
1668203136774,ECE 200,019,103604,Kuzum; Duygu,9999,0,9999,0
1668203136774,ECE 200,020,103605,Le; Hanh-Phuc,9999,0,9999,0
1668203136774,ECE 200,021,103606,Lin; Bill,9999,0,9999,0
1668203136774,ECE 200,022,103607,Liu; Zhaowei,9998,0,9999,1
1668203136774,ECE 200,023,103608,Lo; Yu-Hwa,9999,0,9999,0
1668203136774,ECE 200,024,103609,Lomakin; Vitaliy,9999,0,9999,0
1668203136774,ECE 200,025,103610,Mercier; Patrick Philip,9999,0,9999,0
1668203136774,ECE 200,026,103611,Meyer; Florian,9999,0,9999,0
1668203136774,ECE 200,027,103612,Milstein; Laurence B.,9999,0,9999,0
1668203136774,ECE 200,028,103613,Mir Arabbaygi; Siavash,9999,0,9999,0
1668203136774,ECE 200,029,103614,Mookherjea; Shayan,9999,0,9999,0
1668203136774,ECE 200,030,103615,Morris; Karcher William,9999,0,9999,0
1668203136774,ECE 200,031,103616,Ng; Tse Nga,9999,0,9999,0
1668203136774,ECE 200,032,103617,Nguyen; Truong Quang,9999,0,9999,0
1668203136774,ECE 200,033,103618,Nomura; Kenji,9999,0,9999,0
1668203136774,ECE 200,034,103619,Orlitsky; Alon,9999,0,9999,0
1668203136774,ECE 200,035,103620,Pal; Piya,9999,0,9999,0
1668203136774,ECE 200,036,103621,Papen; George C.,9999,0,9999,0
1668203136774,ECE 200,037,103622,Radic; Stojan,9999,0,9999,0
1668203136774,ECE 200,038,103623,Rao; Bhaskar D.,9999,0,9999,0
1668203136774,ECE 200,039,103624,Rao; Ramesh R,9999,0,9999,0
1668203136774,ECE 200,040,103625,Rebeiz; Gabriel,9999,0,9999,0
1668203136774,ECE 200,041,103626,Sanford; John R,9999,0,9999,0
1668203136774,ECE 200,042,103627,Siegel; Paul H.,9999,0,9999,0
1668203136774,ECE 200,043,103628,Sievenpiper; Daniel F.,9999,0,9999,0
1668203136774,ECE 200,044,103629,Sworder; David D.,9999,0,9999,0
1668203136774,ECE 200,045,103630,Taur; Yuan,9999,0,9999,0
1668203136774,ECE 200,046,103631,Touri; Behrouz,9999,0,9999,0
1668203136774,ECE 200,047,103632,Trivedi; Mohan M.,9999,0,9999,0
1668203136774,ECE 200,048,103633,Vasconcelos; Nuno,9999,0,9999,0
1668203136774,ECE 200,049,103634,Wang; Xiaolong,9999,0,9999,0
1668203136774,ECE 200,050,103635,Xie; Pengtao,9999,0,9999,0
1668203136774,ECE 200,051,103636,Yip; Michael,9999,0,9999,0
1668203136774,ECE 200,052,103637,Zeger; Kenneth A.,999,0,999,0
1668203136774,ECE 200,053,103638,Zhang; Xinyu,9999,0,9999,0
1668203136774,ECE 200,054,103639,Turakhia; Yatish Girish,9999,0,9999,0
1668203136774,ECE 200,055,103640,Kang; Mingu,9999,0,9999,0
1668203136774,ECE 200,056,103641,Shi; Yuanyuan,9999,0,9999,0
1668203136774,ECE 200,057,103642,Wang; Edward Jay,9999,0,9999,0
1668203136774,ECE 200,058,103643,Zheng; Yang,9999,0,9999,0
1668203137204,ECE 202,A00,103644,Kuzum; Duygu,0,0,0,0
1668203137628,ECE 212BN,A00,103646,Ng; Tse Nga,0,0,0,0
1668203138062,ECE 221,A00,111493,Staff,0,0,0,0
1668203138485,ECE 222B,A00,103647,Lomakin; Vitaliy,0,0,0,0
1668203138915,ECE 230B,A00,103648,Taur; Yuan,0,0,0,0
1668203139360,ECE 238B,A00,103649,Garay; Javier,0,0,0,0
1668203139786,ECE 240B,A00,112900,Fainman; Yeshaiahu,0,0,0,0
1668203140211,ECE 247A,A00,103650,Jokerst; Jesse Vincent,0,0,0,0
1668203140639,ECE 247B,A00,103651,Wang; Joseph,0,0,0,0
1668203141078,ECE 250,A00,103652,Siegel; Paul H.,0,0,0,0
1668203141507,ECE 251A,A00,103654,Rao; Bhaskar D.,0,0,0,0
1668203141932,ECE 257B,A00,103655,Bharadia; Dinesh,0,0,0,0
1668203142354,ECE 258A,A00,103656,Milstein; Laurence B.,0,0,0,0
1668203142778,ECE 260B,A00,103658,Kang; Mingu,0,0,0,0
1668203143201,ECE 264A,A00,103659,Galton; Ian A,0,0,0,0
1668203143627,ECE 265A,A00,103661,Gudem; Prasad S.S.,0,0,0,0
1668203144051,ECE 265D,A00,103662,Gudem; Prasad S.S.,0,0,0,0
1668203144484,ECE 268,A00,103663,Koushanfar; Farinaz,0,0,0,0
1668203144909,ECE 269,A01,103665,Pal; Piya,0,0,0,0
1668203145341,ECE 271B,A00,103666,Vasconcelos; Manuela,0,0,0,0
1668203145766,ECE 276A,A00,103667,Atanasov; Nikolay A.,0,0,0,0
1668203146189,ECE 277,A00,103668,An; Cheolhong,0,0,0,0
1668203146622,ECE 279,A00,117947,Hall; Drew A.,0,0,0,0
1668203147468,ECE 283,A00,103670,Hsueh; Tzu-Chien,0,0,0,0
1668203147892,ECE 284,A00,103671,Turakhia; Yatish Girish,0,0,0,0
1668203148315,ECE 285,A00,103672,Zheng; Yang,0,0,0,0
1668203148315,ECE 285,B00,103673,Sworder; David D.,0,0,0,0
1668203148737,ECE 287,A00,103676,Javidi; Tara,0,0,0,0
1668203149173,MATH 200B,A00,098023,Salehi Golsefidy; Alireza,12,0,15,3
1668203149607,MATH 202B,A00,098024,Rhoades; Brendon Patrick,9,0,15,6
1668203150108,MATH 203B,A00,098025,Oprea; Dragos N.,10,0,15,5
1668203150530,MATH 204B,A00,098026,Sorensen; Claus M,13,0,15,2
1668203150962,MATH 208,A00,098027,Izadi; Elham,7,0,10,3
1668203151386,MATH 209,A00,098028,Pollack; Aaron,10,0,10,0
1668203151814,MATH 211A,A00,112919,Rogalski; Daniel,9,0,10,1
1668203152240,MATH 211B,A00,112920,Seward; Brandon M.,9,0,10,1
1668203152672,MATH 218,A00,098029,Li; Bo,10,0,10,0
1668203153100,MATH 220B,A00,098030,Novak; Jonathan I,11,0,15,4
1668203153536,MATH 221A,A00,098031,Ebenfelt; Peter F,13,0,15,2
1668203153963,MATH 231B,A00,098032,Zlatos; Andrej,12,0,15,3
1668203154389,MATH 240B,A00,098033,Ni; Lei,9,0,15,6
1668203154813,MATH 243,A00,098034,Jekel; David Andrew,10,0,10,0
1668203155245,MATH 245A,A00,098035,Nie; Jiawang,0,0,15,16
1668203155668,MATH 248,A00,098036,Bejenaru; Ioan,10,0,10,0
1668203156098,MATH 250B,A00,098037,Spolaor; Luca,14,0,15,1
1668203156520,MATH 258,A00,098038,Ni; Lei,10,0,10,0
1668203156942,MATH 264B,A00,098041,Rhoades; Brendon Patrick,9,0,15,6
1668203157369,MATH 268,A00,098042,Buss; Samuel R,10,0,10,0
1668203157796,MATH 269,A00,098043,Rhoades; Brendon Patrick,10,0,10,0
1668203158218,MATH 270B,A00,098044,Li; Bo,10,0,15,5
1668203158655,MATH 272B,A00,098045,Holst; Michael J,13,0,15,2
1668203159082,MATH 273A,A00,098046,Tian; Xiaochuan,10,0,15,5
1668203159512,MATH 275,A01,098048,Tian; Xiaochuan,6,0,10,4
1668203159935,MATH 278A,A00,098049,Holst; Michael J,8,0,10,2
1668203160365,MATH 278B,A00,098050,Cloninger; Alexander,10,0,10,0
1668203160790,MATH 278C,A00,098051,Nie; Jiawang,7,0,10,3
1668203161212,MATH 280B,A00,098052,Zheng; Tianyi,10,0,15,5
1668203161635,MATH 281B,A00,098053,Bradic; Jelena,2,0,15,13
1668203162063,MATH 282B,A00,098054,Arias-Castro; Ery,0,0,15,15
1668203162486,MATH 285,A00,098055,Fitzsimmons; Patrick J,0,0,15,17
1668203162909,MATH 287B,A00,098056,Arias-Castro; Ery,2,0,15,13
1668203163343,MATH 288,A00,098057,Agarwal; Pooja,9,0,10,1
1668203163343,MATH 288,B00,098058,Zhang; Danna,8,0,10,2
1668203163343,MATH 288,C00,098059,Williams; Ruth J,10,0,10,0
1668203163766,MATH 290B,A00,098060,Roberts; Justin Deritter,13,0,15,2
1668203164192,MATH 292,A00,098061,Belmont; Eva Kinoshita,10,0,10,0
1668203164617,MATH 295,A00,098062,Suk; Andrew Hoon,48,0,50,2
1668203165041,MATH 296,A00,098063,Novak; Jonathan I,20,0,20,0
1668203165465,MATH 297,001,098064,Gamst; Anthony Collins,9997,0,9999,2
1668203667887,COGS 205,A00,101395,Chiba; Andrea,19,0,20,1
1668203668313,COGS 210B,001,101404,Greene; Deanna Jacquelyn,9998,0,9999,1
1668203668313,COGS 210B,002,101417,Xia; Haijun,9999,0,9999,0
1668203668313,COGS 210B,003,101422,Nitz; Douglas A.,9999,0,9999,0
1668203668313,COGS 210B,004,101423,Hollan; James D.,9998,0,9999,1
1668203668313,COGS 210B,005,101424,Deak; Gedeon O.,9998,0,9999,1
1668203668313,COGS 210B,006,101425,Rossano; Federico,9999,0,9999,0
1668203668754,COGS 211B,A00,101427,Coulson; Seana M,9996,0,9999,3
1668203669186,COGS 220,A00,101428,Hollan; James D.,0,0,25,25
1668203669611,COGS 229,A00,101429,Dow; Steven P,18,0,25,7
1668203670033,COGS 230,A00,101430,Klemmer; Scott R,12,0,17,5
1668203670454,COGS 234,A00,101431,Xia; Haijun,2,0,25,23
1668203670876,COGS 260,A00,101432,Kiyonaga; Anastasia,21,0,25,4
1668203670876,COGS 260,B00,101433,Kirsh; David Joel,16,0,25,9
1668203671297,CSE 202,A00,102371,Impagliazzo; Russell,0,0,0,0
1668203671721,CSE 203B,A01,102373,Cheng; Chung Kuan,0,0,0,0
1668203672147,CSE 208,A00,102374,Micciancio; Daniele,0,0,0,0
1668203672653,CSE 209A,A00,112895,Impagliazzo; Russell,0,0,15,15
1668203673081,CSE 209B,A00,108005,Bellare; Mihir,0,0,0,0
1668203673506,CSE 210,A00,113163,Coblenz; Michael J,0,0,0,0
1668203673932,CSE 219,A00,106111,Dow; Steven P,0,0,20,20
1668203674359,CSE 221,A00,102376,Voelker; Geoffrey M.,0,0,0,0
1668203674789,CSE 224,A01,102378,Porter; George M,0,0,0,0
1668203675224,CSE 229A,A00,102379,Savage; Stefan,0,0,0,0
1668203675653,CSE 229C,A00,102380,Munyaka; Imani N. S.,0,0,0,0
1668203676079,CSE 232B,A00,102382,Deutsch; Alin Bernard,0,0,0,0
1668203676506,CSE 234,A01,112904,Kumar; Arun Kumar,0,0,0,0
1668203676942,CSE 237A,A00,102383,Rosing; Tajana Simunic,0,0,0,0
1668203677376,CSE 239A,A00,102384,Deutsch; Alin Bernard,0,0,0,0
1668203677799,CSE 239B,A00,102385,Polikarpova; Nadezhda,0,0,0,0
1668203678225,CSE 240A,A00,102386,Pannuto; Patrick William,0,0,0,0
1668203678648,CSE 240B,A00,102387,Zhao; Jishen,0,0,0,0
1668203679083,CSE 241A,A00,106406,Kang; Mingu,0,0,0,0
1668203679510,CSE 249B,A00,102388,Kahng; Andrew Byun,0,0,8,8
1668203679938,CSE 251B,A01,102392,Cottrell; Garrison W,0,0,0,0
1668203679938,CSE 251B,A02,102393,Cottrell; Garrison W,0,0,0,0
1668203680360,CSE 252B,A00,102394,Ochoa; Benjamin Lawrence,0,0,0,0
1668203680786,CSE 257,A01,102396,Gao; Sicun,0,0,0,0
1668203681222,CSE 272,A00,102397,Li; Tzumao,0,0,0,0
1668203681647,CSE 274,A00,111323,Chern; Albert Ren-Haur,0,0,0,0
1668203682072,CSE 282,A00,102398,Pevzner; Pavel Arkadjevich,0,0,0,0
1668203682501,CSE 284,A00,114175,Gymrek; Melissa Ann,0,0,0,0
1668203682938,CSE 290,A00,102399,Chandraker; Manmohan Krishna,0,0,0,0
1668203682938,CSE 290,B00,102400,Vaccaro; Kristen Marie,0,0,25,25
1668203682938,CSE 290,C00,102414,Pannuto; Patrick William,0,0,25,25
1668203682938,CSE 290,D00,102427,Pevzner; Pavel Arkadjevich,0,0,0,0
1668203682938,CSE 290,E00,102429,Zhao; Jishen,0,0,0,0
1668203682938,CSE 290,F00,102436,Tullsen; Dean Michael,0,0,0,0
1668203682938,CSE 290,G00,102440,Christensen; Henrik I,0,0,20,20
1668203683372,CSE 291,A00,102443,Su; Hao,0,0,0,0
1668203683372,CSE 291,B00,102448,Polikarpova; Nadezhda,0,0,0,0
1668203683372,CSE 291,C00,102453,Vaccaro; Kristen Marie,0,0,0,0
1668203683372,CSE 291,D00,111343,Savage; Stefan,0,0,0,0
1668203683372,CSE 291,E00,116474,Claffy; Kimberly Claire,0,0,0,0
1668203683372,CSE 291,F00,116479,Pasquale; Joseph,0,0,0,0
1668203683817,CSE 293,001,119111,Bafna; Vineet,9999,0,9999,0
1668203683817,CSE 293,002,119118,Bellare; Mihir,9999,0,9999,0
1668203683817,CSE 293,003,119122,Berg-Kirkpatrick; Taylor D,9999,0,9999,0
1668203683817,CSE 293,004,119135,Christensen; Henrik I,9999,0,9999,0
1668203683817,CSE 293,005,119142,Cottrell; Garrison W,9999,0,9999,0
1668203683817,CSE 293,006,119146,Deutsch; Alin Bernard,9999,0,9999,0
1668203683817,CSE 293,007,119159,Esmaeilzadeh; Hadi,9999,0,9999,0
1668203683817,CSE 293,008,119166,Freund; Yoav,9999,0,9999,0
1668203683817,CSE 293,009,119170,Griswold; William G.,9999,0,9999,0
1668203683817,CSE 293,010,119183,Gymrek; Melissa Ann,9999,0,9999,0
1668203683817,CSE 293,011,119190,Heninger; Nadia A,9999,0,9999,0
1668203683817,CSE 293,012,119230,Impagliazzo; Russell,9999,0,9999,0
1668203683817,CSE 293,013,119232,Jhala; Ranjit,9999,0,9999,0
1668203683817,CSE 293,014,119233,Kahng; Andrew Byun,9999,0,9999,0
1668203683817,CSE 293,015,119298,Kane; Daniel Mertz,9999,0,9999,0
1668203683817,CSE 293,016,119299,Kriegman; David J,9999,0,9999,0
1668203683817,CSE 293,017,119300,Kumar; Arun Kumar,9999,0,9999,0
1668203683817,CSE 293,018,119301,Lerner; Sorin,9999,0,9999,0
1668203683817,CSE 293,019,119302,Lovett; Shachar,9999,0,9999,0
1668203683817,CSE 293,020,119303,McAuley; Julian John,9999,0,9999,0
1668203683817,CSE 293,021,119304,Micciancio; Daniele,9999,0,9999,0
1668203683817,CSE 293,022,119367,Orailoglu; Alex,9999,0,9999,0
1668203683817,CSE 293,023,119382,Paturi; Ramamohan,9999,0,9999,0
1668203683817,CSE 293,024,119404,Polikarpova; Nadezhda,9999,0,9999,0
1668203683817,CSE 293,025,119406,Politz; Joseph Gibbs,9999,0,9999,0
1668203683817,CSE 293,026,119411,Porter; George M,9999,0,9999,0
1668203683817,CSE 293,027,119414,Porter; Leonard Emerson,9999,0,9999,0
1668203683817,CSE 293,028,119416,Ramamoorthi; Ravi,9999,0,9999,0
1668203683817,CSE 293,029,119417,Sahoo; Debashis,9999,0,9999,0
1668203683817,CSE 293,030,119420,Saul; Lawrence,9999,0,9999,0
1668203683817,CSE 293,031,119421,Savage; Stefan,9999,0,9999,0
1668203683817,CSE 293,032,119425,Schulze; Jurgen P.,9999,0,9999,0
1668203683817,CSE 293,033,119426,Snoeren; Alex C.,9999,0,9999,0
1668203683817,CSE 293,034,119428,Shang; Jingbo,9999,0,9999,0
1668203683817,CSE 293,035,119430,Stefan; Deian,9999,0,9999,0
1668203683817,CSE 293,036,119431,Su; Hao,9999,0,9999,0
1668203683817,CSE 293,037,119433,Swanson; Steven James,9999,0,9999,0
1668203683817,CSE 293,038,119435,Tullsen; Dean Michael,9999,0,9999,0
1668203683817,CSE 293,039,119483,Voelker; Geoffrey M.,9999,0,9999,0
1668203683817,CSE 293,040,119537,Zhao; Jishen,9999,0,9999,0
1668203683817,CSE 293,041,119538,Zhou; Yuan-Yuan,9999,0,9999,0
1668203683817,CSE 293,042,119539,Gao; Sicun,9999,0,9999,0
1668203683817,CSE 293,043,119540,Weibel; Nadir,9999,0,9999,0
1668203683817,CSE 293,044,119541,Gupta; Rajesh K.,9999,0,9999,0
1668203683817,CSE 293,045,126410,Vaccaro; Kristen Marie,9999,0,9999,0
1668203683817,CSE 293,046,126411,Klemke; Richard,9999,0,9999,0
1668203684238,CSE 294,A00,102459,Voelker; Geoffrey M.,0,0,0,0
1668203684238,CSE 294,B00,111322,Orailoglu; Alex,0,0,0,0
1668203684661,DSE 201,A00,096914,Deutsch; Alin Bernard,30,0,30,0
1668203685087,DSE 210,A00,096915,Dasgupta; Sanjoy,30,0,30,0
1668203685519,DSE 260A,A00,096916,Altintas De Callaf; Ilkay,30,0,30,0
1668203685988,ECE 200,001,103586,Antipa; Nicholas A,9999,0,9999,0
1668203685988,ECE 200,002,103587,Atanasov; Nikolay A.,9999,0,9999,0
1668203685988,ECE 200,003,103588,Bharadia; Dinesh,9999,0,9999,0
1668203685988,ECE 200,004,103589,Cheng; Chung Kuan,9999,0,9999,0
1668203685988,ECE 200,005,103590,Cosman; Pamela C.,9999,0,9999,0
1668203685988,ECE 200,006,103591,Dayeh; Shadi Ahmad,9999,0,9999,0
1668203685988,ECE 200,007,103592,Fainman; Yeshaiahu,9999,0,9999,0
1668203685988,ECE 200,008,103593,Ford; Joseph Earl,9999,0,9999,0
1668203685988,ECE 200,009,103594,Franceschetti; Massimo,9999,0,9999,0
1668203685988,ECE 200,010,103595,Fullerton; Eric E,9999,0,9999,0
1668203685988,ECE 200,011,103596,Galton; Ian A,9999,0,9999,0
1668203685988,ECE 200,012,103597,Gilja; Vikash,9999,0,9999,0
1668203685988,ECE 200,013,103598,Hall; Drew A.,9999,0,9999,0
1668203685988,ECE 200,014,103599,Hsueh; Tzu-Chien,9999,0,9999,0
1668203685988,ECE 200,015,103600,Javidi; Tara,9999,0,9999,0
1668203685988,ECE 200,016,103601,Kahng; Andrew Byun,9999,0,9999,0
1668203685988,ECE 200,017,103602,Kim; Young-Han,9999,0,9999,0
1668203685988,ECE 200,018,103603,Koushanfar; Farinaz,9999,0,9999,0
1668203685988,ECE 200,019,103604,Kuzum; Duygu,9999,0,9999,0
1668203685988,ECE 200,020,103605,Le; Hanh-Phuc,9999,0,9999,0
1668203685988,ECE 200,021,103606,Lin; Bill,9999,0,9999,0
1668203685988,ECE 200,022,103607,Liu; Zhaowei,9998,0,9999,1
1668203685988,ECE 200,023,103608,Lo; Yu-Hwa,9999,0,9999,0
1668203685988,ECE 200,024,103609,Lomakin; Vitaliy,9999,0,9999,0
1668203685988,ECE 200,025,103610,Mercier; Patrick Philip,9999,0,9999,0
1668203685988,ECE 200,026,103611,Meyer; Florian,9999,0,9999,0
1668203685988,ECE 200,027,103612,Milstein; Laurence B.,9999,0,9999,0
1668203685988,ECE 200,028,103613,Mir Arabbaygi; Siavash,9999,0,9999,0
1668203685988,ECE 200,029,103614,Mookherjea; Shayan,9999,0,9999,0
1668203685988,ECE 200,030,103615,Morris; Karcher William,9999,0,9999,0
1668203685988,ECE 200,031,103616,Ng; Tse Nga,9999,0,9999,0
1668203685988,ECE 200,032,103617,Nguyen; Truong Quang,9999,0,9999,0
1668203685988,ECE 200,033,103618,Nomura; Kenji,9999,0,9999,0
1668203685988,ECE 200,034,103619,Orlitsky; Alon,9999,0,9999,0
1668203685988,ECE 200,035,103620,Pal; Piya,9999,0,9999,0
1668203685988,ECE 200,036,103621,Papen; George C.,9999,0,9999,0
1668203685988,ECE 200,037,103622,Radic; Stojan,9999,0,9999,0
1668203685988,ECE 200,038,103623,Rao; Bhaskar D.,9999,0,9999,0
1668203685988,ECE 200,039,103624,Rao; Ramesh R,9999,0,9999,0
1668203685988,ECE 200,040,103625,Rebeiz; Gabriel,9999,0,9999,0
1668203685988,ECE 200,041,103626,Sanford; John R,9999,0,9999,0
1668203685988,ECE 200,042,103627,Siegel; Paul H.,9999,0,9999,0
1668203685988,ECE 200,043,103628,Sievenpiper; Daniel F.,9999,0,9999,0
1668203685988,ECE 200,044,103629,Sworder; David D.,9999,0,9999,0
1668203685988,ECE 200,045,103630,Taur; Yuan,9999,0,9999,0
1668203685988,ECE 200,046,103631,Touri; Behrouz,9999,0,9999,0
1668203685988,ECE 200,047,103632,Trivedi; Mohan M.,9999,0,9999,0
1668203685988,ECE 200,048,103633,Vasconcelos; Nuno,9999,0,9999,0
1668203685988,ECE 200,049,103634,Wang; Xiaolong,9999,0,9999,0
1668203685988,ECE 200,050,103635,Xie; Pengtao,9999,0,9999,0
1668203685988,ECE 200,051,103636,Yip; Michael,9999,0,9999,0
1668203685988,ECE 200,052,103637,Zeger; Kenneth A.,999,0,999,0
1668203685988,ECE 200,053,103638,Zhang; Xinyu,9999,0,9999,0
1668203685988,ECE 200,054,103639,Turakhia; Yatish Girish,9999,0,9999,0
1668203685988,ECE 200,055,103640,Kang; Mingu,9999,0,9999,0
1668203685988,ECE 200,056,103641,Shi; Yuanyuan,9999,0,9999,0
1668203685988,ECE 200,057,103642,Wang; Edward Jay,9999,0,9999,0
1668203685988,ECE 200,058,103643,Zheng; Yang,9999,0,9999,0
1668203686412,ECE 202,A00,103644,Kuzum; Duygu,0,0,0,0
1668203686835,ECE 212BN,A00,103646,Ng; Tse Nga,0,0,0,0
1668203687257,ECE 221,A00,111493,Staff,0,0,0,0
1668203687679,ECE 222B,A00,103647,Lomakin; Vitaliy,0,0,0,0
1668203688106,ECE 230B,A00,103648,Taur; Yuan,0,0,0,0
1668203688541,ECE 238B,A00,103649,Garay; Javier,0,0,0,0
1668203688965,ECE 240B,A00,112900,Fainman; Yeshaiahu,0,0,0,0
1668203689390,ECE 247A,A00,103650,Jokerst; Jesse Vincent,0,0,0,0
1668203689816,ECE 247B,A00,103651,Wang; Joseph,0,0,0,0
1668203690237,ECE 250,A00,103652,Siegel; Paul H.,0,0,0,0
1668203690666,ECE 251A,A00,103654,Rao; Bhaskar D.,0,0,0,0
1668203691090,ECE 257B,A00,103655,Bharadia; Dinesh,0,0,0,0
1668203691519,ECE 258A,A00,103656,Milstein; Laurence B.,0,0,0,0
1668203691941,ECE 260B,A00,103658,Kang; Mingu,0,0,0,0
1668203692363,ECE 264A,A00,103659,Galton; Ian A,0,0,0,0
1668203692796,ECE 265A,A00,103661,Gudem; Prasad S.S.,0,0,0,0
1668203693231,ECE 265D,A00,103662,Gudem; Prasad S.S.,0,0,0,0
1668203693655,ECE 268,A00,103663,Koushanfar; Farinaz,0,0,0,0
1668203694082,ECE 269,A01,103665,Pal; Piya,0,0,0,0
1668203694503,ECE 271B,A00,103666,Vasconcelos; Manuela,0,0,0,0
1668203694929,ECE 276A,A00,103667,Atanasov; Nikolay A.,0,0,0,0
1668203695365,ECE 277,A00,103668,An; Cheolhong,0,0,0,0
1668203695789,ECE 279,A00,117947,Hall; Drew A.,0,0,0,0
1668203696638,ECE 283,A00,103670,Hsueh; Tzu-Chien,0,0,0,0
1668203697061,ECE 284,A00,103671,Turakhia; Yatish Girish,0,0,0,0
1668203697488,ECE 285,A00,103672,Zheng; Yang,0,0,0,0
1668203697488,ECE 285,B00,103673,Sworder; David D.,0,0,0,0
1668203697924,ECE 287,A00,103676,Javidi; Tara,0,0,0,0
1668203698349,MATH 200B,A00,098023,Salehi Golsefidy; Alireza,12,0,15,3
1668203698773,MATH 202B,A00,098024,Rhoades; Brendon Patrick,9,0,15,6
1668203699197,MATH 203B,A00,098025,Oprea; Dragos N.,10,0,15,5
1668203699627,MATH 204B,A00,098026,Sorensen; Claus M,13,0,15,2
1668203700053,MATH 208,A00,098027,Izadi; Elham,7,0,10,3
1668203700478,MATH 209,A00,098028,Pollack; Aaron,10,0,10,0
1668203700902,MATH 211A,A00,112919,Rogalski; Daniel,9,0,10,1
1668203701330,MATH 211B,A00,112920,Seward; Brandon M.,9,0,10,1
1668203701755,MATH 218,A00,098029,Li; Bo,10,0,10,0
1668203702179,MATH 220B,A00,098030,Novak; Jonathan I,11,0,15,4
1668203702602,MATH 221A,A00,098031,Ebenfelt; Peter F,13,0,15,2
1668203703027,MATH 231B,A00,098032,Zlatos; Andrej,12,0,15,3
1668203703448,MATH 240B,A00,098033,Ni; Lei,9,0,15,6
1668203703873,MATH 243,A00,098034,Jekel; David Andrew,10,0,10,0
1668203704298,MATH 245A,A00,098035,Nie; Jiawang,0,0,15,16
1668203704729,MATH 248,A00,098036,Bejenaru; Ioan,10,0,10,0
1668203705164,MATH 250B,A00,098037,Spolaor; Luca,14,0,15,1
1668203705589,MATH 258,A00,098038,Ni; Lei,10,0,10,0
1668203706014,MATH 264B,A00,098041,Rhoades; Brendon Patrick,9,0,15,6
1668203706437,MATH 268,A00,098042,Buss; Samuel R,10,0,10,0
1668203706868,MATH 269,A00,098043,Rhoades; Brendon Patrick,10,0,10,0
1668203707305,MATH 270B,A00,098044,Li; Bo,10,0,15,5
1668203707753,MATH 272B,A00,098045,Holst; Michael J,13,0,15,2
1668203708181,MATH 273A,A00,098046,Tian; Xiaochuan,10,0,15,5
1668203708606,MATH 275,A01,098048,Tian; Xiaochuan,6,0,10,4
1668203709045,MATH 278A,A00,098049,Holst; Michael J,8,0,10,2
1668203709482,MATH 278B,A00,098050,Cloninger; Alexander,10,0,10,0
1668203709910,MATH 278C,A00,098051,Nie; Jiawang,7,0,10,3
1668203710353,MATH 280B,A00,098052,Zheng; Tianyi,10,0,15,5
1668203710792,MATH 281B,A00,098053,Bradic; Jelena,2,0,15,13
1668203711223,MATH 282B,A00,098054,Arias-Castro; Ery,0,0,15,15
1668203711645,MATH 285,A00,098055,Fitzsimmons; Patrick J,0,0,15,17
1668203712069,MATH 287B,A00,098056,Arias-Castro; Ery,2,0,15,13
1668203712497,MATH 288,A00,098057,Agarwal; Pooja,9,0,10,1
1668203712497,MATH 288,B00,098058,Zhang; Danna,8,0,10,2
1668203712497,MATH 288,C00,098059,Williams; Ruth J,10,0,10,0
1668203712921,MATH 290B,A00,098060,Roberts; Justin Deritter,13,0,15,2
1668203713343,MATH 292,A00,098061,Belmont; Eva Kinoshita,10,0,10,0
1668203713770,MATH 295,A00,098062,Suk; Andrew Hoon,48,0,50,2
1668203714201,MATH 296,A00,098063,Novak; Jonathan I,20,0,20,0
1668203714630,MATH 297,001,098064,Gamst; Anthony Collins,9997,0,9999,2
1668204216282,COGS 205,A00,101395,Chiba; Andrea,19,0,20,1
1668204216716,COGS 210B,001,101404,Greene; Deanna Jacquelyn,9998,0,9999,1
1668204216716,COGS 210B,002,101417,Xia; Haijun,9999,0,9999,0
1668204216716,COGS 210B,003,101422,Nitz; Douglas A.,9999,0,9999,0
1668204216716,COGS 210B,004,101423,Hollan; James D.,9998,0,9999,1
1668204216716,COGS 210B,005,101424,Deak; Gedeon O.,9998,0,9999,1
1668204216716,COGS 210B,006,101425,Rossano; Federico,9999,0,9999,0
1668204217146,COGS 211B,A00,101427,Coulson; Seana M,9996,0,9999,3
1668204217571,COGS 220,A00,101428,Hollan; James D.,0,0,25,25
1668204218000,COGS 229,A00,101429,Dow; Steven P,18,0,25,7
1668204218424,COGS 230,A00,101430,Klemmer; Scott R,12,0,17,5
1668204218851,COGS 234,A00,101431,Xia; Haijun,2,0,25,23
1668204219278,COGS 260,A00,101432,Kiyonaga; Anastasia,21,0,25,4
1668204219278,COGS 260,B00,101433,Kirsh; David Joel,16,0,25,9
1668204219709,CSE 202,A00,102371,Impagliazzo; Russell,0,0,0,0
1668204220137,CSE 203B,A01,102373,Cheng; Chung Kuan,0,0,0,0
1668204220572,CSE 208,A00,102374,Micciancio; Daniele,0,0,0,0
1668204221002,CSE 209A,A00,112895,Impagliazzo; Russell,0,0,15,15
1668204221433,CSE 209B,A00,108005,Bellare; Mihir,0,0,0,0
1668204221874,CSE 210,A00,113163,Coblenz; Michael J,0,0,0,0
1668204222311,CSE 219,A00,106111,Dow; Steven P,0,0,20,20
1668204222747,CSE 221,A00,102376,Voelker; Geoffrey M.,0,0,0,0
1668204223175,CSE 224,A01,102378,Porter; George M,0,0,0,0
1668204223598,CSE 229A,A00,102379,Savage; Stefan,0,0,0,0
1668204224022,CSE 229C,A00,102380,Munyaka; Imani N. S.,0,0,0,0
1668204224452,CSE 232B,A00,102382,Deutsch; Alin Bernard,0,0,0,0
1668204224875,CSE 234,A01,112904,Kumar; Arun Kumar,0,0,0,0
1668204225299,CSE 237A,A00,102383,Rosing; Tajana Simunic,0,0,0,0
1668204225729,CSE 239A,A00,102384,Deutsch; Alin Bernard,0,0,0,0
1668204226160,CSE 239B,A00,102385,Polikarpova; Nadezhda,0,0,0,0
1668204226582,CSE 240A,A00,102386,Pannuto; Patrick William,0,0,0,0
1668204227005,CSE 240B,A00,102387,Zhao; Jishen,0,0,0,0
1668204227439,CSE 241A,A00,106406,Kang; Mingu,0,0,0,0
1668204227864,CSE 249B,A00,102388,Kahng; Andrew Byun,0,0,8,8
1668204228286,CSE 251B,A01,102392,Cottrell; Garrison W,0,0,0,0
1668204228286,CSE 251B,A02,102393,Cottrell; Garrison W,0,0,0,0
1668204228715,CSE 252B,A00,102394,Ochoa; Benjamin Lawrence,0,0,0,0
1668204229142,CSE 257,A01,102396,Gao; Sicun,0,0,0,0
1668204229575,CSE 272,A00,102397,Li; Tzumao,0,0,0,0
1668204229997,CSE 274,A00,111323,Chern; Albert Ren-Haur,0,0,0,0
1668204230419,CSE 282,A00,102398,Pevzner; Pavel Arkadjevich,0,0,0,0
1668204230845,CSE 284,A00,114175,Gymrek; Melissa Ann,0,0,0,0
1668204231269,CSE 290,A00,102399,Chandraker; Manmohan Krishna,0,0,0,0
1668204231269,CSE 290,B00,102400,Vaccaro; Kristen Marie,0,0,25,25
1668204231269,CSE 290,C00,102414,Pannuto; Patrick William,0,0,25,25
1668204231269,CSE 290,D00,102427,Pevzner; Pavel Arkadjevich,0,0,0,0
1668204231269,CSE 290,E00,102429,Zhao; Jishen,0,0,0,0
1668204231269,CSE 290,F00,102436,Tullsen; Dean Michael,0,0,0,0
1668204231269,CSE 290,G00,102440,Christensen; Henrik I,0,0,20,20
1668204231694,CSE 291,A00,102443,Su; Hao,0,0,0,0
1668204231694,CSE 291,B00,102448,Polikarpova; Nadezhda,0,0,0,0
1668204231694,CSE 291,C00,102453,Vaccaro; Kristen Marie,0,0,0,0
1668204231694,CSE 291,D00,111343,Savage; Stefan,0,0,0,0
1668204231694,CSE 291,E00,116474,Claffy; Kimberly Claire,0,0,0,0
1668204231694,CSE 291,F00,116479,Pasquale; Joseph,0,0,0,0
1668204232141,CSE 293,001,119111,Bafna; Vineet,9999,0,9999,0
1668204232141,CSE 293,002,119118,Bellare; Mihir,9999,0,9999,0
1668204232141,CSE 293,003,119122,Berg-Kirkpatrick; Taylor D,9999,0,9999,0
1668204232141,CSE 293,004,119135,Christensen; Henrik I,9999,0,9999,0
1668204232141,CSE 293,005,119142,Cottrell; Garrison W,9999,0,9999,0
1668204232141,CSE 293,006,119146,Deutsch; Alin Bernard,9999,0,9999,0
1668204232141,CSE 293,007,119159,Esmaeilzadeh; Hadi,9999,0,9999,0
1668204232141,CSE 293,008,119166,Freund; Yoav,9999,0,9999,0
1668204232141,CSE 293,009,119170,Griswold; William G.,9999,0,9999,0
1668204232141,CSE 293,010,119183,Gymrek; Melissa Ann,9999,0,9999,0
1668204232141,CSE 293,011,119190,Heninger; Nadia A,9999,0,9999,0
1668204232141,CSE 293,012,119230,Impagliazzo; Russell,9999,0,9999,0
1668204232141,CSE 293,013,119232,Jhala; Ranjit,9999,0,9999,0
1668204232141,CSE 293,014,119233,Kahng; Andrew Byun,9999,0,9999,0
1668204232141,CSE 293,015,119298,Kane; Daniel Mertz,9999,0,9999,0
1668204232141,CSE 293,016,119299,Kriegman; David J,9999,0,9999,0
1668204232141,CSE 293,017,119300,Kumar; Arun Kumar,9999,0,9999,0
1668204232141,CSE 293,018,119301,Lerner; Sorin,9999,0,9999,0
1668204232141,CSE 293,019,119302,Lovett; Shachar,9999,0,9999,0
1668204232141,CSE 293,020,119303,McAuley; Julian John,9999,0,9999,0
1668204232141,CSE 293,021,119304,Micciancio; Daniele,9999,0,9999,0
1668204232141,CSE 293,022,119367,Orailoglu; Alex,9999,0,9999,0
1668204232141,CSE 293,023,119382,Paturi; Ramamohan,9999,0,9999,0
1668204232141,CSE 293,024,119404,Polikarpova; Nadezhda,9999,0,9999,0
1668204232141,CSE 293,025,119406,Politz; Joseph Gibbs,9999,0,9999,0
1668204232141,CSE 293,026,119411,Porter; George M,9999,0,9999,0
1668204232141,CSE 293,027,119414,Porter; Leonard Emerson,9999,0,9999,0
1668204232141,CSE 293,028,119416,Ramamoorthi; Ravi,9999,0,9999,0
1668204232141,CSE 293,029,119417,Sahoo; Debashis,9999,0,9999,0
1668204232141,CSE 293,030,119420,Saul; Lawrence,9999,0,9999,0
1668204232141,CSE 293,031,119421,Savage; Stefan,9999,0,9999,0
1668204232141,CSE 293,032,119425,Schulze; Jurgen P.,9999,0,9999,0
1668204232141,CSE 293,033,119426,Snoeren; Alex C.,9999,0,9999,0
1668204232141,CSE 293,034,119428,Shang; Jingbo,9999,0,9999,0
1668204232141,CSE 293,035,119430,Stefan; Deian,9999,0,9999,0
1668204232141,CSE 293,036,119431,Su; Hao,9999,0,9999,0
1668204232141,CSE 293,037,119433,Swanson; Steven James,9999,0,9999,0
1668204232141,CSE 293,038,119435,Tullsen; Dean Michael,9999,0,9999,0
1668204232141,CSE 293,039,119483,Voelker; Geoffrey M.,9999,0,9999,0
1668204232141,CSE 293,040,119537,Zhao; Jishen,9999,0,9999,0
1668204232141,CSE 293,041,119538,Zhou; Yuan-Yuan,9999,0,9999,0
1668204232141,CSE 293,042,119539,Gao; Sicun,9999,0,9999,0
1668204232141,CSE 293,043,119540,Weibel; Nadir,9999,0,9999,0
1668204232141,CSE 293,044,119541,Gupta; Rajesh K.,9999,0,9999,0
1668204232141,CSE 293,045,126410,Vaccaro; Kristen Marie,9999,0,9999,0
1668204232141,CSE 293,046,126411,Klemke; Richard,9999,0,9999,0
1668204232584,CSE 294,A00,102459,Voelker; Geoffrey M.,0,0,0,0
1668204232584,CSE 294,B00,111322,Orailoglu; Alex,0,0,0,0
1668204233006,DSE 201,A00,096914,Deutsch; Alin Bernard,30,0,30,0
1668204233434,DSE 210,A00,096915,Dasgupta; Sanjoy,30,0,30,0
1668204233856,DSE 260A,A00,096916,Altintas De Callaf; Ilkay,30,0,30,0
1668204234298,ECE 200,001,103586,Antipa; Nicholas A,9999,0,9999,0
1668204234298,ECE 200,002,103587,Atanasov; Nikolay A.,9999,0,9999,0
1668204234298,ECE 200,003,103588,Bharadia; Dinesh,9999,0,9999,0
1668204234298,ECE 200,004,103589,Cheng; Chung Kuan,9999,0,9999,0
1668204234298,ECE 200,005,103590,Cosman; Pamela C.,9999,0,9999,0
1668204234298,ECE 200,006,103591,Dayeh; Shadi Ahmad,9999,0,9999,0
1668204234298,ECE 200,007,103592,Fainman; Yeshaiahu,9999,0,9999,0
1668204234298,ECE 200,008,103593,Ford; Joseph Earl,9999,0,9999,0
1668204234298,ECE 200,009,103594,Franceschetti; Massimo,9999,0,9999,0
1668204234298,ECE 200,010,103595,Fullerton; Eric E,9999,0,9999,0
1668204234298,ECE 200,011,103596,Galton; Ian A,9999,0,9999,0
1668204234298,ECE 200,012,103597,Gilja; Vikash,9999,0,9999,0
1668204234298,ECE 200,013,103598,Hall; Drew A.,9999,0,9999,0
1668204234298,ECE 200,014,103599,Hsueh; Tzu-Chien,9999,0,9999,0
1668204234298,ECE 200,015,103600,Javidi; Tara,9999,0,9999,0
1668204234298,ECE 200,016,103601,Kahng; Andrew Byun,9999,0,9999,0
1668204234298,ECE 200,017,103602,Kim; Young-Han,9999,0,9999,0
1668204234298,ECE 200,018,103603,Koushanfar; Farinaz,9999,0,9999,0
1668204234298,ECE 200,019,103604,Kuzum; Duygu,9999,0,9999,0
1668204234298,ECE 200,020,103605,Le; Hanh-Phuc,9999,0,9999,0
1668204234298,ECE 200,021,103606,Lin; Bill,9999,0,9999,0
1668204234298,ECE 200,022,103607,Liu; Zhaowei,9998,0,9999,1
1668204234298,ECE 200,023,103608,Lo; Yu-Hwa,9999,0,9999,0
1668204234298,ECE 200,024,103609,Lomakin; Vitaliy,9999,0,9999,0
1668204234298,ECE 200,025,103610,Mercier; Patrick Philip,9999,0,9999,0
1668204234298,ECE 200,026,103611,Meyer; Florian,9999,0,9999,0
1668204234298,ECE 200,027,103612,Milstein; Laurence B.,9999,0,9999,0
1668204234298,ECE 200,028,103613,Mir Arabbaygi; Siavash,9999,0,9999,0
1668204234298,ECE 200,029,103614,Mookherjea; Shayan,9999,0,9999,0
1668204234298,ECE 200,030,103615,Morris; Karcher William,9999,0,9999,0
1668204234298,ECE 200,031,103616,Ng; Tse Nga,9999,0,9999,0
1668204234298,ECE 200,032,103617,Nguyen; Truong Quang,9999,0,9999,0
1668204234298,ECE 200,033,103618,Nomura; Kenji,9999,0,9999,0
1668204234298,ECE 200,034,103619,Orlitsky; Alon,9999,0,9999,0
1668204234298,ECE 200,035,103620,Pal; Piya,9999,0,9999,0
1668204234298,ECE 200,036,103621,Papen; George C.,9999,0,9999,0
1668204234298,ECE 200,037,103622,Radic; Stojan,9999,0,9999,0
1668204234298,ECE 200,038,103623,Rao; Bhaskar D.,9999,0,9999,0
1668204234298,ECE 200,039,103624,Rao; Ramesh R,9999,0,9999,0
1668204234298,ECE 200,040,103625,Rebeiz; Gabriel,9999,0,9999,0
1668204234298,ECE 200,041,103626,Sanford; John R,9999,0,9999,0
1668204234298,ECE 200,042,103627,Siegel; Paul H.,9999,0,9999,0
1668204234298,ECE 200,043,103628,Sievenpiper; Daniel F.,9999,0,9999,0
1668204234298,ECE 200,044,103629,Sworder; David D.,9999,0,9999,0
1668204234298,ECE 200,045,103630,Taur; Yuan,9999,0,9999,0
1668204234298,ECE 200,046,103631,Touri; Behrouz,9999,0,9999,0
1668204234298,ECE 200,047,103632,Trivedi; Mohan M.,9999,0,9999,0
1668204234298,ECE 200,048,103633,Vasconcelos; Nuno,9999,0,9999,0
1668204234298,ECE 200,049,103634,Wang; Xiaolong,9999,0,9999,0
1668204234298,ECE 200,050,103635,Xie; Pengtao,9999,0,9999,0
1668204234298,ECE 200,051,103636,Yip; Michael,9999,0,9999,0
1668204234298,ECE 200,052,103637,Zeger; Kenneth A.,999,0,999,0
1668204234298,ECE 200,053,103638,Zhang; Xinyu,9999,0,9999,0
1668204234298,ECE 200,054,103639,Turakhia; Yatish Girish,9999,0,9999,0
1668204234298,ECE 200,055,103640,Kang; Mingu,9999,0,9999,0
1668204234298,ECE 200,056,103641,Shi; Yuanyuan,9999,0,9999,0
1668204234298,ECE 200,057,103642,Wang; Edward Jay,9999,0,9999,0
1668204234298,ECE 200,058,103643,Zheng; Yang,9999,0,9999,0
1668204234722,ECE 202,A00,103644,Kuzum; Duygu,0,0,0,0
1668204235144,ECE 212BN,A00,103646,Ng; Tse Nga,0,0,0,0
1668204235583,ECE 221,A00,111493,Staff,0,0,0,0
1668204236007,ECE 222B,A00,103647,Lomakin; Vitaliy,0,0,0,0
1668204236433,ECE 230B,A00,103648,Taur; Yuan,0,0,0,0
1668204236859,ECE 238B,A00,103649,Garay; Javier,0,0,0,0
1668204237284,ECE 240B,A00,112900,Fainman; Yeshaiahu,0,0,0,0
1668204237796,ECE 247A,A00,103650,Jokerst; Jesse Vincent,0,0,0,0
1668204238220,ECE 247B,A00,103651,Wang; Joseph,0,0,0,0
1668204238645,ECE 250,A00,103652,Siegel; Paul H.,0,0,0,0
1668204239069,ECE 251A,A00,103654,Rao; Bhaskar D.,0,0,0,0
1668204239493,ECE 257B,A00,103655,Bharadia; Dinesh,0,0,0,0
1668204239916,ECE 258A,A00,103656,Milstein; Laurence B.,0,0,0,0
1668204240358,ECE 260B,A00,103658,Kang; Mingu,0,0,0,0
1668204240780,ECE 264A,A00,103659,Galton; Ian A,0,0,0,0
1668204241205,ECE 265A,A00,103661,Gudem; Prasad S.S.,0,0,0,0
1668204241633,ECE 265D,A00,103662,Gudem; Prasad S.S.,0,0,0,0
1668204242065,ECE 268,A00,103663,Koushanfar; Farinaz,0,0,0,0
1668204242491,ECE 269,A01,103665,Pal; Piya,0,0,0,0
1668204242916,ECE 271B,A00,103666,Vasconcelos; Manuela,0,0,0,0
1668204243341,ECE 276A,A00,103667,Atanasov; Nikolay A.,0,0,0,0
1668204243766,ECE 277,A00,103668,An; Cheolhong,0,0,0,0
1668204244194,ECE 279,A00,117947,Hall; Drew A.,0,0,0,0
1668204245040,ECE 283,A00,103670,Hsueh; Tzu-Chien,0,0,0,0
1668204245464,ECE 284,A00,103671,Turakhia; Yatish Girish,0,0,0,0
1668204245888,ECE 285,A00,103672,Zheng; Yang,0,0,0,0
1668204245888,ECE 285,B00,103673,Sworder; David D.,0,0,0,0
1668204246311,ECE 287,A00,103676,Javidi; Tara,0,0,0,0
1668204246734,MATH 200B,A00,098023,Salehi Golsefidy; Alireza,12,0,15,3
1668204247158,MATH 202B,A00,098024,Rhoades; Brendon Patrick,9,0,15,6
1668204247593,MATH 203B,A00,098025,Oprea; Dragos N.,10,0,15,5
1668204248021,MATH 204B,A00,098026,Sorensen; Claus M,13,0,15,2
1668204248449,MATH 208,A00,098027,Izadi; Elham,7,0,10,3
1668204248872,MATH 209,A00,098028,Pollack; Aaron,10,0,10,0
1668204249299,MATH 211A,A00,112919,Rogalski; Daniel,9,0,10,1
1668204249720,MATH 211B,A00,112920,Seward; Brandon M.,9,0,10,1
1668204250142,MATH 218,A00,098029,Li; Bo,10,0,10,0
1668204250564,MATH 220B,A00,098030,Novak; Jonathan I,11,0,15,4
1668204250990,MATH 221A,A00,098031,Ebenfelt; Peter F,13,0,15,2
1668204251417,MATH 231B,A00,098032,Zlatos; Andrej,12,0,15,3
1668204251842,MATH 240B,A00,098033,Ni; Lei,9,0,15,6
1668204252269,MATH 243,A00,098034,Jekel; David Andrew,10,0,10,0
1668204252695,MATH 245A,A00,098035,Nie; Jiawang,0,0,15,16
1668204253129,MATH 248,A00,098036,Bejenaru; Ioan,10,0,10,0
1668204253554,MATH 250B,A00,098037,Spolaor; Luca,14,0,15,1
1668204253990,MATH 258,A00,098038,Ni; Lei,10,0,10,0
1668204254422,MATH 264B,A00,098041,Rhoades; Brendon Patrick,9,0,15,6
1668204254850,MATH 268,A00,098042,Buss; Samuel R,10,0,10,0
1668204255276,MATH 269,A00,098043,Rhoades; Brendon Patrick,10,0,10,0
1668204255717,MATH 270B,A00,098044,Li; Bo,10,0,15,5
1668204256150,MATH 272B,A00,098045,Holst; Michael J,13,0,15,2
1668204256576,MATH 273A,A00,098046,Tian; Xiaochuan,10,0,15,5
1668204257000,MATH 275,A01,098048,Tian; Xiaochuan,6,0,10,4
1668204257433,MATH 278A,A00,098049,Holst; Michael J,8,0,10,2
1668204257865,MATH 278B,A00,098050,Cloninger; Alexander,10,0,10,0
1668204258291,MATH 278C,A00,098051,Nie; Jiawang,7,0,10,3
1668204258717,MATH 280B,A00,098052,Zheng; Tianyi,10,0,15,5
1668204259143,MATH 281B,A00,098053,Bradic; Jelena,2,0,15,13
1668204259567,MATH 282B,A00,098054,Arias-Castro; Ery,0,0,15,15
1668204259992,MATH 285,A00,098055,Fitzsimmons; Patrick J,0,0,15,17
1668204260415,MATH 287B,A00,098056,Arias-Castro; Ery,2,0,15,13
1668204260842,MATH 288,A00,098057,Agarwal; Pooja,9,0,10,1
1668204260842,MATH 288,B00,098058,Zhang; Danna,8,0,10,2
1668204260842,MATH 288,C00,098059,Williams; Ruth J,10,0,10,0
1668204261265,MATH 290B,A00,098060,Roberts; Justin Deritter,13,0,15,2
1668204261688,MATH 292,A00,098061,Belmont; Eva Kinoshita,10,0,10,0
1668204262115,MATH 295,A00,098062,Suk; Andrew Hoon,48,0,50,2
1668204262542,MATH 296,A00,098063,Novak; Jonathan I,20,0,20,0
1668204262964,MATH 297,001,098064,Gamst; Anthony Collins,9997,0,9999,2
1668204784748,COGS 205,A00,101395,Chiba; Andrea,19,0,20,1
1668204785176,COGS 210B,001,101404,Greene; Deanna Jacquelyn,9998,0,9999,1
1668204785176,COGS 210B,002,101417,Xia; Haijun,9999,0,9999,0
1668204785176,COGS 210B,003,101422,Nitz; Douglas A.,9999,0,9999,0
1668204785176,COGS 210B,004,101423,Hollan; James D.,9998,0,9999,1
1668204785176,COGS 210B,005,101424,Deak; Gedeon O.,9998,0,9999,1
1668204785176,COGS 210B,006,101425,Rossano; Federico,9999,0,9999,0
1668204785617,COGS 211B,A00,101427,Coulson; Seana M,9996,0,9999,3
1668204786050,COGS 220,A00,101428,Hollan; James D.,0,0,25,25
1668204786472,COGS 229,A00,101429,Dow; Steven P,18,0,25,7
1668204786903,COGS 230,A00,101430,Klemmer; Scott R,12,0,17,5
1668204787327,COGS 234,A00,101431,Xia; Haijun,2,0,25,23
1668204787750,COGS 260,A00,101432,Kiyonaga; Anastasia,21,0,25,4
1668204787750,COGS 260,B00,101433,Kirsh; David Joel,16,0,25,9
1668204788176,CSE 202,A00,102371,Impagliazzo; Russell,0,0,0,0
1668204788601,CSE 203B,A01,102373,Cheng; Chung Kuan,0,0,0,0
1668204789029,CSE 208,A00,102374,Micciancio; Daniele,0,0,0,0
1668204789453,CSE 209A,A00,112895,Impagliazzo; Russell,0,0,15,15
1668204790045,CSE 209B,A00,108005,Bellare; Mihir,0,0,0,0
1668204790472,CSE 210,A00,113163,Coblenz; Michael J,0,0,0,0
1668204790897,CSE 219,A00,106111,Dow; Steven P,0,0,20,20
1668204791321,CSE 221,A00,102376,Voelker; Geoffrey M.,0,0,0,0
1668204791748,CSE 224,A01,102378,Porter; George M,0,0,0,0
1668204792174,CSE 229A,A00,102379,Savage; Stefan,0,0,0,0
1668204792598,CSE 229C,A00,102380,Munyaka; Imani N. S.,0,0,0,0
1668204793020,CSE 232B,A00,102382,Deutsch; Alin Bernard,0,0,0,0
1668204793449,CSE 234,A01,112904,Kumar; Arun Kumar,0,0,0,0
1668204793877,CSE 237A,A00,102383,Rosing; Tajana Simunic,0,0,0,0
1668204794303,CSE 239A,A00,102384,Deutsch; Alin Bernard,0,0,0,0
1668204794732,CSE 239B,A00,102385,Polikarpova; Nadezhda,0,0,0,0
1668204795155,CSE 240A,A00,102386,Pannuto; Patrick William,0,0,0,0
1668204795590,CSE 240B,A00,102387,Zhao; Jishen,0,0,0,0
1668204796015,CSE 241A,A00,106406,Kang; Mingu,0,0,0,0
1668204796438,CSE 249B,A00,102388,Kahng; Andrew Byun,0,0,8,8
1668204796872,CSE 251B,A01,102392,Cottrell; Garrison W,0,0,0,0
1668204796872,CSE 251B,A02,102393,Cottrell; Garrison W,0,0,0,0
1668204797299,CSE 252B,A00,102394,Ochoa; Benjamin Lawrence,0,0,0,0
1668204797726,CSE 257,A01,102396,Gao; Sicun,0,0,0,0
1668204798159,CSE 272,A00,102397,Li; Tzumao,0,0,0,0
1668204798598,CSE 274,A00,111323,Chern; Albert Ren-Haur,0,0,0,0
1668204799025,CSE 282,A00,102398,Pevzner; Pavel Arkadjevich,0,0,0,0
1668204799449,CSE 284,A00,114175,Gymrek; Melissa Ann,0,0,0,0
1668204799871,CSE 290,A00,102399,Chandraker; Manmohan Krishna,0,0,0,0
1668204799871,CSE 290,B00,102400,Vaccaro; Kristen Marie,0,0,25,25
1668204799871,CSE 290,C00,102414,Pannuto; Patrick William,0,0,25,25
1668204799871,CSE 290,D00,102427,Pevzner; Pavel Arkadjevich,0,0,0,0
1668204799871,CSE 290,E00,102429,Zhao; Jishen,0,0,0,0
1668204799871,CSE 290,F00,102436,Tullsen; Dean Michael,0,0,0,0
1668204799871,CSE 290,G00,102440,Christensen; Henrik I,0,0,20,20
1668204800302,CSE 291,A00,102443,Su; Hao,0,0,0,0
1668204800302,CSE 291,B00,102448,Polikarpova; Nadezhda,0,0,0,0
1668204800302,CSE 291,C00,102453,Vaccaro; Kristen Marie,0,0,0,0
1668204800302,CSE 291,D00,111343,Savage; Stefan,0,0,0,0
1668204800302,CSE 291,E00,116474,Claffy; Kimberly Claire,0,0,0,0
1668204800302,CSE 291,F00,116479,Pasquale; Joseph,0,0,0,0
1668204800743,CSE 293,001,119111,Bafna; Vineet,9999,0,9999,0
1668204800743,CSE 293,002,119118,Bellare; Mihir,9999,0,9999,0
1668204800743,CSE 293,003,119122,Berg-Kirkpatrick; Taylor D,9999,0,9999,0
1668204800743,CSE 293,004,119135,Christensen; Henrik I,9999,0,9999,0
1668204800743,CSE 293,005,119142,Cottrell; Garrison W,9999,0,9999,0
1668204800743,CSE 293,006,119146,Deutsch; Alin Bernard,9999,0,9999,0
1668204800743,CSE 293,007,119159,Esmaeilzadeh; Hadi,9999,0,9999,0
1668204800743,CSE 293,008,119166,Freund; Yoav,9999,0,9999,0
1668204800743,CSE 293,009,119170,Griswold; William G.,9999,0,9999,0
1668204800743,CSE 293,010,119183,Gymrek; Melissa Ann,9999,0,9999,0
1668204800743,CSE 293,011,119190,Heninger; Nadia A,9999,0,9999,0
1668204800743,CSE 293,012,119230,Impagliazzo; Russell,9999,0,9999,0
1668204800743,CSE 293,013,119232,Jhala; Ranjit,9999,0,9999,0
1668204800743,CSE 293,014,119233,Kahng; Andrew Byun,9999,0,9999,0
1668204800743,CSE 293,015,119298,Kane; Daniel Mertz,9999,0,9999,0
1668204800743,CSE 293,016,119299,Kriegman; David J,9999,0,9999,0
1668204800743,CSE 293,017,119300,Kumar; Arun Kumar,9999,0,9999,0
1668204800743,CSE 293,018,119301,Lerner; Sorin,9999,0,9999,0
1668204800743,CSE 293,019,119302,Lovett; Shachar,9999,0,9999,0
1668204800743,CSE 293,020,119303,McAuley; Julian John,9999,0,9999,0
1668204800743,CSE 293,021,119304,Micciancio; Daniele,9999,0,9999,0
1668204800743,CSE 293,022,119367,Orailoglu; Alex,9999,0,9999,0
1668204800743,CSE 293,023,119382,Paturi; Ramamohan,9999,0,9999,0
1668204800743,CSE 293,024,119404,Polikarpova; Nadezhda,9999,0,9999,0
1668204800743,CSE 293,025,119406,Politz; Joseph Gibbs,9999,0,9999,0
1668204800743,CSE 293,026,119411,Porter; George M,9999,0,9999,0
1668204800743,CSE 293,027,119414,Porter; Leonard Emerson,9999,0,9999,0
1668204800743,CSE 293,028,119416,Ramamoorthi; Ravi,9999,0,9999,0
1668204800743,CSE 293,029,119417,Sahoo; Debashis,9999,0,9999,0
1668204800743,CSE 293,030,119420,Saul; Lawrence,9999,0,9999,0
1668204800743,CSE 293,031,119421,Savage; Stefan,9999,0,9999,0
1668204800743,CSE 293,032,119425,Schulze; Jurgen P.,9999,0,9999,0
1668204800743,CSE 293,033,119426,Snoeren; Alex C.,9999,0,9999,0
1668204800743,CSE 293,034,119428,Shang; Jingbo,9999,0,9999,0
1668204800743,CSE 293,035,119430,Stefan; Deian,9999,0,9999,0
1668204800743,CSE 293,036,119431,Su; Hao,9999,0,9999,0
1668204800743,CSE 293,037,119433,Swanson; Steven James,9999,0,9999,0
1668204800743,CSE 293,038,119435,Tullsen; Dean Michael,9999,0,9999,0
1668204800743,CSE 293,039,119483,Voelker; Geoffrey M.,9999,0,9999,0
1668204800743,CSE 293,040,119537,Zhao; Jishen,9999,0,9999,0
1668204800743,CSE 293,041,119538,Zhou; Yuan-Yuan,9999,0,9999,0
1668204800743,CSE 293,042,119539,Gao; Sicun,9999,0,9999,0
1668204800743,CSE 293,043,119540,Weibel; Nadir,9999,0,9999,0
1668204800743,CSE 293,044,119541,Gupta; Rajesh K.,9999,0,9999,0
1668204800743,CSE 293,045,126410,Vaccaro; Kristen Marie,9999,0,9999,0
1668204800743,CSE 293,046,126411,Klemke; Richard,9999,0,9999,0
1668204801167,CSE 294,A00,102459,Voelker; Geoffrey M.,0,0,0,0
1668204801167,CSE 294,B00,111322,Orailoglu; Alex,0,0,0,0
1668204801591,DSE 201,A00,096914,Deutsch; Alin Bernard,30,0,30,0
1668204802016,DSE 210,A00,096915,Dasgupta; Sanjoy,30,0,30,0
1668204802442,DSE 260A,A00,096916,Altintas De Callaf; Ilkay,30,0,30,0
1668204802879,ECE 200,001,103586,Antipa; Nicholas A,9999,0,9999,0
1668204802879,ECE 200,002,103587,Atanasov; Nikolay A.,9999,0,9999,0
1668204802879,ECE 200,003,103588,Bharadia; Dinesh,9999,0,9999,0
1668204802879,ECE 200,004,103589,Cheng; Chung Kuan,9999,0,9999,0
1668204802879,ECE 200,005,103590,Cosman; Pamela C.,9999,0,9999,0
1668204802879,ECE 200,006,103591,Dayeh; Shadi Ahmad,9999,0,9999,0
1668204802879,ECE 200,007,103592,Fainman; Yeshaiahu,9999,0,9999,0
1668204802879,ECE 200,008,103593,Ford; Joseph Earl,9999,0,9999,0
1668204802879,ECE 200,009,103594,Franceschetti; Massimo,9999,0,9999,0
1668204802879,ECE 200,010,103595,Fullerton; Eric E,9999,0,9999,0
1668204802879,ECE 200,011,103596,Galton; Ian A,9999,0,9999,0
1668204802879,ECE 200,012,103597,Gilja; Vikash,9999,0,9999,0
1668204802879,ECE 200,013,103598,Hall; Drew A.,9999,0,9999,0
1668204802879,ECE 200,014,103599,Hsueh; Tzu-Chien,9999,0,9999,0
1668204802879,ECE 200,015,103600,Javidi; Tara,9999,0,9999,0
1668204802879,ECE 200,016,103601,Kahng; Andrew Byun,9999,0,9999,0
1668204802879,ECE 200,017,103602,Kim; Young-Han,9999,0,9999,0
1668204802879,ECE 200,018,103603,Koushanfar; Farinaz,9999,0,9999,0
1668204802879,ECE 200,019,103604,Kuzum; Duygu,9999,0,9999,0
1668204802879,ECE 200,020,103605,Le; Hanh-Phuc,9999,0,9999,0
1668204802879,ECE 200,021,103606,Lin; Bill,9999,0,9999,0
1668204802879,ECE 200,022,103607,Liu; Zhaowei,9998,0,9999,1
1668204802879,ECE 200,023,103608,Lo; Yu-Hwa,9999,0,9999,0
1668204802879,ECE 200,024,103609,Lomakin; Vitaliy,9999,0,9999,0
1668204802879,ECE 200,025,103610,Mercier; Patrick Philip,9999,0,9999,0
1668204802879,ECE 200,026,103611,Meyer; Florian,9999,0,9999,0
1668204802879,ECE 200,027,103612,Milstein; Laurence B.,9999,0,9999,0
1668204802879,ECE 200,028,103613,Mir Arabbaygi; Siavash,9999,0,9999,0
1668204802879,ECE 200,029,103614,Mookherjea; Shayan,9999,0,9999,0
1668204802879,ECE 200,030,103615,Morris; Karcher William,9999,0,9999,0
1668204802879,ECE 200,031,103616,Ng; Tse Nga,9999,0,9999,0
1668204802879,ECE 200,032,103617,Nguyen; Truong Quang,9999,0,9999,0
1668204802879,ECE 200,033,103618,Nomura; Kenji,9999,0,9999,0
1668204802879,ECE 200,034,103619,Orlitsky; Alon,9999,0,9999,0
1668204802879,ECE 200,035,103620,Pal; Piya,9999,0,9999,0
1668204802879,ECE 200,036,103621,Papen; George C.,9999,0,9999,0
1668204802879,ECE 200,037,103622,Radic; Stojan,9999,0,9999,0
1668204802879,ECE 200,038,103623,Rao; Bhaskar D.,9999,0,9999,0
1668204802879,ECE 200,039,103624,Rao; Ramesh R,9999,0,9999,0
1668204802879,ECE 200,040,103625,Rebeiz; Gabriel,9999,0,9999,0
1668204802879,ECE 200,041,103626,Sanford; John R,9999,0,9999,0
1668204802879,ECE 200,042,103627,Siegel; Paul H.,9999,0,9999,0
1668204802879,ECE 200,043,103628,Sievenpiper; Daniel F.,9999,0,9999,0
1668204802879,ECE 200,044,103629,Sworder; David D.,9999,0,9999,0
1668204802879,ECE 200,045,103630,Taur; Yuan,9999,0,9999,0
1668204802879,ECE 200,046,103631,Touri; Behrouz,9999,0,9999,0
1668204802879,ECE 200,047,103632,Trivedi; Mohan M.,9999,0,9999,0
1668204802879,ECE 200,048,103633,Vasconcelos; Nuno,9999,0,9999,0
1668204802879,ECE 200,049,103634,Wang; Xiaolong,9999,0,9999,0
1668204802879,ECE 200,050,103635,Xie; Pengtao,9999,0,9999,0
1668204802879,ECE 200,051,103636,Yip; Michael,9999,0,9999,0
1668204802879,ECE 200,052,103637,Zeger; Kenneth A.,999,0,999,0
1668204802879,ECE 200,053,103638,Zhang; Xinyu,9999,0,9999,0
1668204802879,ECE 200,054,103639,Turakhia; Yatish Girish,9999,0,9999,0
1668204802879,ECE 200,055,103640,Kang; Mingu,9999,0,9999,0
1668204802879,ECE 200,056,103641,Shi; Yuanyuan,9999,0,9999,0
1668204802879,ECE 200,057,103642,Wang; Edward Jay,9999,0,9999,0
1668204802879,ECE 200,058,103643,Zheng; Yang,9999,0,9999,0
1668204803310,ECE 202,A00,103644,Kuzum; Duygu,0,0,0,0
1668204803743,ECE 212BN,A00,103646,Ng; Tse Nga,0,0,0,0
1668204804165,ECE 221,A00,111493,Staff,0,0,0,0
1668204804602,ECE 222B,A00,103647,Lomakin; Vitaliy,0,0,0,0
1668204805029,ECE 230B,A00,103648,Taur; Yuan,0,0,0,0
1668204805453,ECE 238B,A00,103649,Garay; Javier,0,0,0,0
1668204805883,ECE 240B,A00,112900,Fainman; Yeshaiahu,0,0,0,0
1668204806305,ECE 247A,A00,103650,Jokerst; Jesse Vincent,0,0,0,0
1668204806731,ECE 247B,A00,103651,Wang; Joseph,0,0,0,0
1668204807154,ECE 250,A00,103652,Siegel; Paul H.,0,0,0,0
1668204807576,ECE 251A,A00,103654,Rao; Bhaskar D.,0,0,0,0
1668204808001,ECE 257B,A00,103655,Bharadia; Dinesh,0,0,0,0
1668204808426,ECE 258A,A00,103656,Milstein; Laurence B.,0,0,0,0
1668204808855,ECE 260B,A00,103658,Kang; Mingu,0,0,0,0
1668204809276,ECE 264A,A00,103659,Galton; Ian A,0,0,0,0
1668204809702,ECE 265A,A00,103661,Gudem; Prasad S.S.,0,0,0,0
1668204810129,ECE 265D,A00,103662,Gudem; Prasad S.S.,0,0,0,0
1668204810556,ECE 268,A00,103663,Koushanfar; Farinaz,0,0,0,0
1668204810980,ECE 269,A01,103665,Pal; Piya,0,0,0,0
1668204811418,ECE 271B,A00,103666,Vasconcelos; Manuela,0,0,0,0
1668204811988,ECE 276A,A00,103667,Atanasov; Nikolay A.,0,0,0,0
1668204812424,ECE 277,A00,103668,An; Cheolhong,0,0,0,0
1668204812846,ECE 279,A00,117947,Hall; Drew A.,0,0,0,0
1668204813693,ECE 283,A00,103670,Hsueh; Tzu-Chien,0,0,0,0
1668204814119,ECE 284,A00,103671,Turakhia; Yatish Girish,0,0,0,0
1668204814543,ECE 285,A00,103672,Zheng; Yang,0,0,0,0
1668204814543,ECE 285,B00,103673,Sworder; David D.,0,0,0,0
1668204814967,ECE 287,A00,103676,Javidi; Tara,0,0,0,0
1668204815390,MATH 200B,A00,098023,Salehi Golsefidy; Alireza,12,0,15,3
1668204815812,MATH 202B,A00,098024,Rhoades; Brendon Patrick,9,0,15,6
1668204816243,MATH 203B,A00,098025,Oprea; Dragos N.,10,0,15,5
1668204816678,MATH 204B,A00,098026,Sorensen; Claus M,13,0,15,2
1668204817108,MATH 208,A00,098027,Izadi; Elham,7,0,10,3
1668204817539,MATH 209,A00,098028,Pollack; Aaron,10,0,10,0
1668204817964,MATH 211A,A00,112919,Rogalski; Daniel,9,0,10,1
1668204818400,MATH 211B,A00,112920,Seward; Brandon M.,9,0,10,1
1668204818827,MATH 218,A00,098029,Li; Bo,10,0,10,0
1668204819253,MATH 220B,A00,098030,Novak; Jonathan I,11,0,15,4
1668204819682,MATH 221A,A00,098031,Ebenfelt; Peter F,13,0,15,2
1668204820105,MATH 231B,A00,098032,Zlatos; Andrej,12,0,15,3
1668204820532,MATH 240B,A00,098033,Ni; Lei,9,0,15,6
1668204820955,MATH 243,A00,098034,Jekel; David Andrew,10,0,10,0
1668204821387,MATH 245A,A00,098035,Nie; Jiawang,0,0,15,16
1668204821809,MATH 248,A00,098036,Bejenaru; Ioan,10,0,10,0
1668204822237,MATH 250B,A00,098037,Spolaor; Luca,14,0,15,1
1668204822668,MATH 258,A00,098038,Ni; Lei,10,0,10,0
1668204823172,MATH 264B,A00,098041,Rhoades; Brendon Patrick,9,0,15,6
1668204823598,MATH 268,A00,098042,Buss; Samuel R,10,0,10,0
1668204824022,MATH 269,A00,098043,Rhoades; Brendon Patrick,10,0,10,0
1668204824445,MATH 270B,A00,098044,Li; Bo,10,0,15,5
1668204824869,MATH 272B,A00,098045,Holst; Michael J,13,0,15,2
1668204825294,MATH 273A,A00,098046,Tian; Xiaochuan,10,0,15,5
1668204825716,MATH 275,A01,098048,Tian; Xiaochuan,6,0,10,4
1668204826140,MATH 278A,A00,098049,Holst; Michael J,8,0,10,2
1668204826566,MATH 278B,A00,098050,Cloninger; Alexander,10,0,10,0
1668204826996,MATH 278C,A00,098051,Nie; Jiawang,7,0,10,3
1668204827421,MATH 280B,A00,098052,Zheng; Tianyi,10,0,15,5
1668204827849,MATH 281B,A00,098053,Bradic; Jelena,2,0,15,13
1668204828273,MATH 282B,A00,098054,Arias-Castro; Ery,0,0,15,15
1668204828699,MATH 285,A00,098055,Fitzsimmons; Patrick J,0,0,15,17
1668204829125,MATH 287B,A00,098056,Arias-Castro; Ery,2,0,15,13
1668204829549,MATH 288,A00,098057,Agarwal; Pooja,9,0,10,1
1668204829549,MATH 288,B00,098058,Zhang; Danna,8,0,10,2
1668204829549,MATH 288,C00,098059,Williams; Ruth J,10,0,10,0
1668204829975,MATH 290B,A00,098060,Roberts; Justin Deritter,13,0,15,2
1668204830404,MATH 292,A00,098061,Belmont; Eva Kinoshita,10,0,10,0
1668204830831,MATH 295,A00,098062,Suk; Andrew Hoon,48,0,50,2
1668204831260,MATH 296,A00,098063,Novak; Jonathan I,20,0,20,0
1668204831686,MATH 297,001,098064,Gamst; Anthony Collins,9997,0,9999,2
1668205333292,COGS 205,A00,101395,Chiba; Andrea,19,0,20,1
1668205333714,COGS 210B,001,101404,Greene; Deanna Jacquelyn,9998,0,9999,1
1668205333714,COGS 210B,002,101417,Xia; Haijun,9999,0,9999,0
1668205333714,COGS 210B,003,101422,Nitz; Douglas A.,9999,0,9999,0
1668205333714,COGS 210B,004,101423,Hollan; James D.,9998,0,9999,1
1668205333714,COGS 210B,005,101424,Deak; Gedeon O.,9998,0,9999,1
1668205333714,COGS 210B,006,101425,Rossano; Federico,9999,0,9999,0
1668205334139,COGS 211B,A00,101427,Coulson; Seana M,9996,0,9999,3
1668205334570,COGS 220,A00,101428,Hollan; James D.,0,0,25,25
1668205334992,COGS 229,A00,101429,Dow; Steven P,18,0,25,7
1668205335420,COGS 230,A00,101430,Klemmer; Scott R,12,0,17,5
1668205335857,COGS 234,A00,101431,Xia; Haijun,2,0,25,23
1668205336300,COGS 260,A00,101432,Kiyonaga; Anastasia,21,0,25,4
1668205336300,COGS 260,B00,101433,Kirsh; David Joel,16,0,25,9
1668205336721,CSE 202,A00,102371,Impagliazzo; Russell,0,0,0,0
1668205337152,CSE 203B,A01,102373,Cheng; Chung Kuan,0,0,0,0
1668205337581,CSE 208,A00,102374,Micciancio; Daniele,0,0,0,0
1668205338004,CSE 209A,A00,112895,Impagliazzo; Russell,0,0,15,15
1668205338428,CSE 209B,A00,108005,Bellare; Mihir,0,0,0,0
1668205338854,CSE 210,A00,113163,Coblenz; Michael J,0,0,0,0
1668205339292,CSE 219,A00,106111,Dow; Steven P,0,0,20,20
1668205339714,CSE 221,A00,102376,Voelker; Geoffrey M.,0,0,0,0
1668205340136,CSE 224,A01,102378,Porter; George M,0,0,0,0
1668205340577,CSE 229A,A00,102379,Savage; Stefan,0,0,0,0
1668205341005,CSE 229C,A00,102380,Munyaka; Imani N. S.,0,0,0,0
1668205341439,CSE 232B,A00,102382,Deutsch; Alin Bernard,0,0,0,0
1668205341862,CSE 234,A01,112904,Kumar; Arun Kumar,0,0,0,0
1668205342285,CSE 237A,A00,102383,Rosing; Tajana Simunic,0,0,0,0
1668205342709,CSE 239A,A00,102384,Deutsch; Alin Bernard,0,0,0,0
1668205343131,CSE 239B,A00,102385,Polikarpova; Nadezhda,0,0,0,0
1668205343557,CSE 240A,A00,102386,Pannuto; Patrick William,0,0,0,0
1668205343994,CSE 240B,A00,102387,Zhao; Jishen,0,0,0,0
1668205344419,CSE 241A,A00,106406,Kang; Mingu,0,0,0,0
1668205344945,CSE 249B,A00,102388,Kahng; Andrew Byun,0,0,8,8
1668205345377,CSE 251B,A01,102392,Cottrell; Garrison W,0,0,0,0
1668205345377,CSE 251B,A02,102393,Cottrell; Garrison W,0,0,0,0
1668205345804,CSE 252B,A00,102394,Ochoa; Benjamin Lawrence,0,0,0,0
1668205346228,CSE 257,A01,102396,Gao; Sicun,0,0,0,0
1668205346649,CSE 272,A00,102397,Li; Tzumao,0,0,0,0
1668205347072,CSE 274,A00,111323,Chern; Albert Ren-Haur,0,0,0,0
1668205347502,CSE 282,A00,102398,Pevzner; Pavel Arkadjevich,0,0,0,0
1668205347925,CSE 284,A00,114175,Gymrek; Melissa Ann,0,0,0,0
1668205348352,CSE 290,A00,102399,Chandraker; Manmohan Krishna,0,0,0,0
1668205348352,CSE 290,B00,102400,Vaccaro; Kristen Marie,0,0,25,25
1668205348352,CSE 290,C00,102414,Pannuto; Patrick William,0,0,25,25
1668205348352,CSE 290,D00,102427,Pevzner; Pavel Arkadjevich,0,0,0,0
1668205348352,CSE 290,E00,102429,Zhao; Jishen,0,0,0,0
1668205348352,CSE 290,F00,102436,Tullsen; Dean Michael,0,0,0,0
1668205348352,CSE 290,G00,102440,Christensen; Henrik I,0,0,20,20
1668205348779,CSE 291,A00,102443,Su; Hao,0,0,0,0
1668205348779,CSE 291,B00,102448,Polikarpova; Nadezhda,0,0,0,0
1668205348779,CSE 291,C00,102453,Vaccaro; Kristen Marie,0,0,0,0
1668205348779,CSE 291,D00,111343,Savage; Stefan,0,0,0,0
1668205348779,CSE 291,E00,116474,Claffy; Kimberly Claire,0,0,0,0
1668205348779,CSE 291,F00,116479,Pasquale; Joseph,0,0,0,0
1668205349231,CSE 293,001,119111,Bafna; Vineet,9999,0,9999,0
1668205349231,CSE 293,002,119118,Bellare; Mihir,9999,0,9999,0
1668205349231,CSE 293,003,119122,Berg-Kirkpatrick; Taylor D,9999,0,9999,0
1668205349231,CSE 293,004,119135,Christensen; Henrik I,9999,0,9999,0
1668205349231,CSE 293,005,119142,Cottrell; Garrison W,9999,0,9999,0
1668205349231,CSE 293,006,119146,Deutsch; Alin Bernard,9999,0,9999,0
1668205349231,CSE 293,007,119159,Esmaeilzadeh; Hadi,9999,0,9999,0
1668205349231,CSE 293,008,119166,Freund; Yoav,9999,0,9999,0
1668205349231,CSE 293,009,119170,Griswold; William G.,9999,0,9999,0
1668205349231,CSE 293,010,119183,Gymrek; Melissa Ann,9999,0,9999,0
1668205349231,CSE 293,011,119190,Heninger; Nadia A,9999,0,9999,0
1668205349231,CSE 293,012,119230,Impagliazzo; Russell,9999,0,9999,0
1668205349231,CSE 293,013,119232,Jhala; Ranjit,9999,0,9999,0
1668205349231,CSE 293,014,119233,Kahng; Andrew Byun,9999,0,9999,0
1668205349231,CSE 293,015,119298,Kane; Daniel Mertz,9999,0,9999,0
1668205349231,CSE 293,016,119299,Kriegman; David J,9999,0,9999,0
1668205349231,CSE 293,017,119300,Kumar; Arun Kumar,9999,0,9999,0
1668205349231,CSE 293,018,119301,Lerner; Sorin,9999,0,9999,0
1668205349231,CSE 293,019,119302,Lovett; Shachar,9999,0,9999,0
1668205349231,CSE 293,020,119303,McAuley; Julian John,9999,0,9999,0
1668205349231,CSE 293,021,119304,Micciancio; Daniele,9999,0,9999,0
1668205349231,CSE 293,022,119367,Orailoglu; Alex,9999,0,9999,0
1668205349231,CSE 293,023,119382,Paturi; Ramamohan,9999,0,9999,0
1668205349231,CSE 293,024,119404,Polikarpova; Nadezhda,9999,0,9999,0
1668205349231,CSE 293,025,119406,Politz; Joseph Gibbs,9999,0,9999,0
1668205349231,CSE 293,026,119411,Porter; George M,9999,0,9999,0
1668205349231,CSE 293,027,119414,Porter; Leonard Emerson,9999,0,9999,0
1668205349231,CSE 293,028,119416,Ramamoorthi; Ravi,9999,0,9999,0
1668205349231,CSE 293,029,119417,Sahoo; Debashis,9999,0,9999,0
1668205349231,CSE 293,030,119420,Saul; Lawrence,9999,0,9999,0
1668205349231,CSE 293,031,119421,Savage; Stefan,9999,0,9999,0
1668205349231,CSE 293,032,119425,Schulze; Jurgen P.,9999,0,9999,0
1668205349231,CSE 293,033,119426,Snoeren; Alex C.,9999,0,9999,0
1668205349231,CSE 293,034,119428,Shang; Jingbo,9999,0,9999,0
1668205349231,CSE 293,035,119430,Stefan; Deian,9999,0,9999,0
1668205349231,CSE 293,036,119431,Su; Hao,9999,0,9999,0
1668205349231,CSE 293,037,119433,Swanson; Steven James,9999,0,9999,0
1668205349231,CSE 293,038,119435,Tullsen; Dean Michael,9999,0,9999,0
1668205349231,CSE 293,039,119483,Voelker; Geoffrey M.,9999,0,9999,0
1668205349231,CSE 293,040,119537,Zhao; Jishen,9999,0,9999,0
1668205349231,CSE 293,041,119538,Zhou; Yuan-Yuan,9999,0,9999,0
1668205349231,CSE 293,042,119539,Gao; Sicun,9999,0,9999,0
1668205349231,CSE 293,043,119540,Weibel; Nadir,9999,0,9999,0
1668205349231,CSE 293,044,119541,Gupta; Rajesh K.,9999,0,9999,0
1668205349231,CSE 293,045,126410,Vaccaro; Kristen Marie,9999,0,9999,0
1668205349231,CSE 293,046,126411,Klemke; Richard,9999,0,9999,0
1668205349661,CSE 294,A00,102459,Voelker; Geoffrey M.,0,0,0,0
1668205349661,CSE 294,B00,111322,Orailoglu; Alex,0,0,0,0
1668205350087,DSE 201,A00,096914,Deutsch; Alin Bernard,30,0,30,0
1668205350525,DSE 210,A00,096915,Dasgupta; Sanjoy,30,0,30,0
1668205351115,DSE 260A,A00,096916,Altintas De Callaf; Ilkay,30,0,30,0
1668205351545,ECE 200,001,103586,Antipa; Nicholas A,9999,0,9999,0
1668205351545,ECE 200,002,103587,Atanasov; Nikolay A.,9999,0,9999,0
1668205351545,ECE 200,003,103588,Bharadia; Dinesh,9999,0,9999,0
1668205351545,ECE 200,004,103589,Cheng; Chung Kuan,9999,0,9999,0
1668205351545,ECE 200,005,103590,Cosman; Pamela C.,9999,0,9999,0
1668205351545,ECE 200,006,103591,Dayeh; Shadi Ahmad,9999,0,9999,0
1668205351545,ECE 200,007,103592,Fainman; Yeshaiahu,9999,0,9999,0
1668205351545,ECE 200,008,103593,Ford; Joseph Earl,9999,0,9999,0
1668205351545,ECE 200,009,103594,Franceschetti; Massimo,9999,0,9999,0
1668205351545,ECE 200,010,103595,Fullerton; Eric E,9999,0,9999,0
1668205351545,ECE 200,011,103596,Galton; Ian A,9999,0,9999,0
1668205351545,ECE 200,012,103597,Gilja; Vikash,9999,0,9999,0
1668205351545,ECE 200,013,103598,Hall; Drew A.,9999,0,9999,0
1668205351545,ECE 200,014,103599,Hsueh; Tzu-Chien,9999,0,9999,0
1668205351545,ECE 200,015,103600,Javidi; Tara,9999,0,9999,0
1668205351545,ECE 200,016,103601,Kahng; Andrew Byun,9999,0,9999,0
1668205351545,ECE 200,017,103602,Kim; Young-Han,9999,0,9999,0
1668205351545,ECE 200,018,103603,Koushanfar; Farinaz,9999,0,9999,0
1668205351545,ECE 200,019,103604,Kuzum; Duygu,9999,0,9999,0
1668205351545,ECE 200,020,103605,Le; Hanh-Phuc,9999,0,9999,0
1668205351545,ECE 200,021,103606,Lin; Bill,9999,0,9999,0
1668205351545,ECE 200,022,103607,Liu; Zhaowei,9998,0,9999,1
1668205351545,ECE 200,023,103608,Lo; Yu-Hwa,9999,0,9999,0
1668205351545,ECE 200,024,103609,Lomakin; Vitaliy,9999,0,9999,0
1668205351545,ECE 200,025,103610,Mercier; Patrick Philip,9999,0,9999,0
1668205351545,ECE 200,026,103611,Meyer; Florian,9999,0,9999,0
1668205351545,ECE 200,027,103612,Milstein; Laurence B.,9999,0,9999,0
1668205351545,ECE 200,028,103613,Mir Arabbaygi; Siavash,9999,0,9999,0
1668205351545,ECE 200,029,103614,Mookherjea; Shayan,9999,0,9999,0
1668205351545,ECE 200,030,103615,Morris; Karcher William,9999,0,9999,0
1668205351545,ECE 200,031,103616,Ng; Tse Nga,9999,0,9999,0
1668205351545,ECE 200,032,103617,Nguyen; Truong Quang,9999,0,9999,0
1668205351545,ECE 200,033,103618,Nomura; Kenji,9999,0,9999,0
1668205351545,ECE 200,034,103619,Orlitsky; Alon,9999,0,9999,0
1668205351545,ECE 200,035,103620,Pal; Piya,9999,0,9999,0
1668205351545,ECE 200,036,103621,Papen; George C.,9999,0,9999,0
1668205351545,ECE 200,037,103622,Radic; Stojan,9999,0,9999,0
1668205351545,ECE 200,038,103623,Rao; Bhaskar D.,9999,0,9999,0
1668205351545,ECE 200,039,103624,Rao; Ramesh R,9999,0,9999,0
1668205351545,ECE 200,040,103625,Rebeiz; Gabriel,9999,0,9999,0
1668205351545,ECE 200,041,103626,Sanford; John R,9999,0,9999,0
1668205351545,ECE 200,042,103627,Siegel; Paul H.,9999,0,9999,0
1668205351545,ECE 200,043,103628,Sievenpiper; Daniel F.,9999,0,9999,0
1668205351545,ECE 200,044,103629,Sworder; David D.,9999,0,9999,0
1668205351545,ECE 200,045,103630,Taur; Yuan,9999,0,9999,0
1668205351545,ECE 200,046,103631,Touri; Behrouz,9999,0,9999,0
1668205351545,ECE 200,047,103632,Trivedi; Mohan M.,9999,0,9999,0
1668205351545,ECE 200,048,103633,Vasconcelos; Nuno,9999,0,9999,0
1668205351545,ECE 200,049,103634,Wang; Xiaolong,9999,0,9999,0
1668205351545,ECE 200,050,103635,Xie; Pengtao,9999,0,9999,0
1668205351545,ECE 200,051,103636,Yip; Michael,9999,0,9999,0
1668205351545,ECE 200,052,103637,Zeger; Kenneth A.,999,0,999,0
1668205351545,ECE 200,053,103638,Zhang; Xinyu,9999,0,9999,0
1668205351545,ECE 200,054,103639,Turakhia; Yatish Girish,9999,0,9999,0
1668205351545,ECE 200,055,103640,Kang; Mingu,9999,0,9999,0
1668205351545,ECE 200,056,103641,Shi; Yuanyuan,9999,0,9999,0
1668205351545,ECE 200,057,103642,Wang; Edward Jay,9999,0,9999,0
1668205351545,ECE 200,058,103643,Zheng; Yang,9999,0,9999,0
1668205351975,ECE 202,A00,103644,Kuzum; Duygu,0,0,0,0
1668205352402,ECE 212BN,A00,103646,Ng; Tse Nga,0,0,0,0
1668205352834,ECE 221,A00,111493,Staff,0,0,0,0
1668205353256,ECE 222B,A00,103647,Lomakin; Vitaliy,0,0,0,0
1668205353679,ECE 230B,A00,103648,Taur; Yuan,0,0,0,0
1668205354103,ECE 238B,A00,103649,Garay; Javier,0,0,0,0
1668205354525,ECE 240B,A00,112900,Fainman; Yeshaiahu,0,0,0,0
1668205354951,ECE 247A,A00,103650,Jokerst; Jesse Vincent,0,0,0,0
1668205355378,ECE 247B,A00,103651,Wang; Joseph,0,0,0,0
1668205355802,ECE 250,A00,103652,Siegel; Paul H.,0,0,0,0
1668205356238,ECE 251A,A00,103654,Rao; Bhaskar D.,0,0,0,0
1668205356666,ECE 257B,A00,103655,Bharadia; Dinesh,0,0,0,0
1668205357090,ECE 258A,A00,103656,Milstein; Laurence B.,0,0,0,0
1668205357516,ECE 260B,A00,103658,Kang; Mingu,0,0,0,0
1668205357948,ECE 264A,A00,103659,Galton; Ian A,0,0,0,0
1668205358383,ECE 265A,A00,103661,Gudem; Prasad S.S.,0,0,0,0
1668205358818,ECE 265D,A00,103662,Gudem; Prasad S.S.,0,0,0,0
1668205359247,ECE 268,A00,103663,Koushanfar; Farinaz,0,0,0,0
1668205359675,ECE 269,A01,103665,Pal; Piya,0,0,0,0
1668205360097,ECE 271B,A00,103666,Vasconcelos; Manuela,0,0,0,0
1668205360534,ECE 276A,A00,103667,Atanasov; Nikolay A.,0,0,0,0
1668205360954,ECE 277,A00,103668,An; Cheolhong,0,0,0,0
1668205361378,ECE 279,A00,117947,Hall; Drew A.,0,0,0,0
1668205362224,ECE 283,A00,103670,Hsueh; Tzu-Chien,0,0,0,0
1668205362653,ECE 284,A00,103671,Turakhia; Yatish Girish,0,0,0,0
1668205363087,ECE 285,A00,103672,Zheng; Yang,0,0,0,0
1668205363087,ECE 285,B00,103673,Sworder; David D.,0,0,0,0
1668205363524,ECE 287,A00,103676,Javidi; Tara,0,0,0,0
1668205363961,MATH 200B,A00,098023,Salehi Golsefidy; Alireza,12,0,15,3
1668205364385,MATH 202B,A00,098024,Rhoades; Brendon Patrick,9,0,15,6
1668205364809,MATH 203B,A00,098025,Oprea; Dragos N.,10,0,15,5
1668205365236,MATH 204B,A00,098026,Sorensen; Claus M,13,0,15,2
1668205365658,MATH 208,A00,098027,Izadi; Elham,7,0,10,3
1668205366086,MATH 209,A00,098028,Pollack; Aaron,10,0,10,0
1668205366520,MATH 211A,A00,112919,Rogalski; Daniel,9,0,10,1
1668205366942,MATH 211B,A00,112920,Seward; Brandon M.,9,0,10,1
1668205367378,MATH 218,A00,098029,Li; Bo,10,0,10,0
1668205367813,MATH 220B,A00,098030,Novak; Jonathan I,11,0,15,4
1668205368246,MATH 221A,A00,098031,Ebenfelt; Peter F,13,0,15,2
1668205368687,MATH 231B,A00,098032,Zlatos; Andrej,12,0,15,3
1668205369114,MATH 240B,A00,098033,Ni; Lei,9,0,15,6
1668205369542,MATH 243,A00,098034,Jekel; David Andrew,10,0,10,0
1668205369972,MATH 245A,A00,098035,Nie; Jiawang,0,0,15,16
1668205370394,MATH 248,A00,098036,Bejenaru; Ioan,10,0,10,0
1668205370986,MATH 250B,A00,098037,Spolaor; Luca,14,0,15,1
1668205371419,MATH 258,A00,098038,Ni; Lei,10,0,10,0
1668205371841,MATH 264B,A00,098041,Rhoades; Brendon Patrick,9,0,15,6
1668205372267,MATH 268,A00,098042,Buss; Samuel R,10,0,10,0
1668205372690,MATH 269,A00,098043,Rhoades; Brendon Patrick,10,0,10,0
1668205373118,MATH 270B,A00,098044,Li; Bo,10,0,15,5
1668205373547,MATH 272B,A00,098045,Holst; Michael J,13,0,15,2
1668205373969,MATH 273A,A00,098046,Tian; Xiaochuan,10,0,15,5
1668205374390,MATH 275,A01,098048,Tian; Xiaochuan,6,0,10,4
1668205374882,MATH 278A,A00,098049,Holst; Michael J,8,0,10,2
1668205375308,MATH 278B,A00,098050,Cloninger; Alexander,10,0,10,0
1668205375740,MATH 278C,A00,098051,Nie; Jiawang,7,0,10,3
1668205376169,MATH 280B,A00,098052,Zheng; Tianyi,10,0,15,5
1668205376590,MATH 281B,A00,098053,Bradic; Jelena,2,0,15,13
1668205377021,MATH 282B,A00,098054,Arias-Castro; Ery,0,0,15,15
1668205377449,MATH 285,A00,098055,Fitzsimmons; Patrick J,0,0,15,17
1668205377879,MATH 287B,A00,098056,Arias-Castro; Ery,2,0,15,13
1668205378302,MATH 288,A00,098057,Agarwal; Pooja,9,0,10,1
1668205378302,MATH 288,B00,098058,Zhang; Danna,8,0,10,2
1668205378302,MATH 288,C00,098059,Williams; Ruth J,10,0,10,0
1668205378724,MATH 290B,A00,098060,Roberts; Justin Deritter,13,0,15,2
1668205379158,MATH 292,A00,098061,Belmont; Eva Kinoshita,10,0,10,0
1668205379582,MATH 295,A00,098062,Suk; Andrew Hoon,48,0,50,2
1668205380008,MATH 296,A00,098063,Novak; Jonathan I,20,0,20,0
1668205380433,MATH 297,001,098064,Gamst; Anthony Collins,9997,0,9999,2
1668205882257,COGS 205,A00,101395,Chiba; Andrea,19,0,20,1
1668205882694,COGS 210B,001,101404,Greene; Deanna Jacquelyn,9998,0,9999,1
1668205882694,COGS 210B,002,101417,Xia; Haijun,9999,0,9999,0
1668205882694,COGS 210B,003,101422,Nitz; Douglas A.,9999,0,9999,0
1668205882694,COGS 210B,004,101423,Hollan; James D.,9998,0,9999,1
1668205882694,COGS 210B,005,101424,Deak; Gedeon O.,9998,0,9999,1
1668205882694,COGS 210B,006,101425,Rossano; Federico,9999,0,9999,0
1668205883115,COGS 211B,A00,101427,Coulson; Seana M,9996,0,9999,3
1668205883539,COGS 220,A00,101428,Hollan; James D.,0,0,25,25
1668205883964,COGS 229,A00,101429,Dow; Steven P,18,0,25,7
1668205884390,COGS 230,A00,101430,Klemmer; Scott R,12,0,17,5
1668205884826,COGS 234,A00,101431,Xia; Haijun,2,0,25,23
1668205885256,COGS 260,A00,101432,Kiyonaga; Anastasia,21,0,25,4
1668205885256,COGS 260,B00,101433,Kirsh; David Joel,16,0,25,9
1668205885683,CSE 202,A00,102371,Impagliazzo; Russell,0,0,0,0
1668205886111,CSE 203B,A01,102373,Cheng; Chung Kuan,0,0,0,0
1668205886538,CSE 208,A00,102374,Micciancio; Daniele,0,0,0,0
1668205886961,CSE 209A,A00,112895,Impagliazzo; Russell,0,0,15,15
1668205887386,CSE 209B,A00,108005,Bellare; Mihir,0,0,0,0
1668205887814,CSE 210,A00,113163,Coblenz; Michael J,0,0,0,0
1668205888242,CSE 219,A00,106111,Dow; Steven P,0,0,20,20
1668205888673,CSE 221,A00,102376,Voelker; Geoffrey M.,0,0,0,0
1668205889104,CSE 224,A01,102378,Porter; George M,0,0,0,0
1668205889701,CSE 229A,A00,102379,Savage; Stefan,0,0,0,0
1668205890126,CSE 229C,A00,102380,Munyaka; Imani N. S.,0,0,0,0
1668205890550,CSE 232B,A00,102382,Deutsch; Alin Bernard,0,0,0,0
1668205890980,CSE 234,A01,112904,Kumar; Arun Kumar,0,0,0,0
1668205891407,CSE 237A,A00,102383,Rosing; Tajana Simunic,0,0,0,0
1668205891828,CSE 239A,A00,102384,Deutsch; Alin Bernard,0,0,0,0
1668205892261,CSE 239B,A00,102385,Polikarpova; Nadezhda,0,0,0,0
1668205892686,CSE 240A,A00,102386,Pannuto; Patrick William,0,0,0,0
1668205893110,CSE 240B,A00,102387,Zhao; Jishen,0,0,0,0
1668205893535,CSE 241A,A00,106406,Kang; Mingu,0,0,0,0
1668205893956,CSE 249B,A00,102388,Kahng; Andrew Byun,0,0,8,8
1668205894380,CSE 251B,A01,102392,Cottrell; Garrison W,0,0,0,0
1668205894380,CSE 251B,A02,102393,Cottrell; Garrison W,0,0,0,0
1668205894804,CSE 252B,A00,102394,Ochoa; Benjamin Lawrence,0,0,0,0
1668205895238,CSE 257,A01,102396,Gao; Sicun,0,0,0,0
1668205895674,CSE 272,A00,102397,Li; Tzumao,0,0,0,0
1668205896104,CSE 274,A00,111323,Chern; Albert Ren-Haur,0,0,0,0
1668205896527,CSE 282,A00,102398,Pevzner; Pavel Arkadjevich,0,0,0,0
1668205896949,CSE 284,A00,114175,Gymrek; Melissa Ann,0,0,0,0
1668205897371,CSE 290,A00,102399,Chandraker; Manmohan Krishna,0,0,0,0
1668205897371,CSE 290,B00,102400,Vaccaro; Kristen Marie,0,0,25,25
1668205897371,CSE 290,C00,102414,Pannuto; Patrick William,0,0,25,25
1668205897371,CSE 290,D00,102427,Pevzner; Pavel Arkadjevich,0,0,0,0
1668205897371,CSE 290,E00,102429,Zhao; Jishen,0,0,0,0
1668205897371,CSE 290,F00,102436,Tullsen; Dean Michael,0,0,0,0
1668205897371,CSE 290,G00,102440,Christensen; Henrik I,0,0,20,20
1668205897797,CSE 291,A00,102443,Su; Hao,0,0,0,0
1668205897797,CSE 291,B00,102448,Polikarpova; Nadezhda,0,0,0,0
1668205897797,CSE 291,C00,102453,Vaccaro; Kristen Marie,0,0,0,0
1668205897797,CSE 291,D00,111343,Savage; Stefan,0,0,0,0
1668205897797,CSE 291,E00,116474,Claffy; Kimberly Claire,0,0,0,0
1668205897797,CSE 291,F00,116479,Pasquale; Joseph,0,0,0,0
1668205898256,CSE 293,001,119111,Bafna; Vineet,9999,0,9999,0
1668205898256,CSE 293,002,119118,Bellare; Mihir,9999,0,9999,0
1668205898256,CSE 293,003,119122,Berg-Kirkpatrick; Taylor D,9999,0,9999,0
1668205898256,CSE 293,004,119135,Christensen; Henrik I,9999,0,9999,0
1668205898256,CSE 293,005,119142,Cottrell; Garrison W,9999,0,9999,0
1668205898256,CSE 293,006,119146,Deutsch; Alin Bernard,9999,0,9999,0
1668205898256,CSE 293,007,119159,Esmaeilzadeh; Hadi,9999,0,9999,0
1668205898256,CSE 293,008,119166,Freund; Yoav,9999,0,9999,0
1668205898256,CSE 293,009,119170,Griswold; William G.,9999,0,9999,0
1668205898256,CSE 293,010,119183,Gymrek; Melissa Ann,9999,0,9999,0
1668205898256,CSE 293,011,119190,Heninger; Nadia A,9999,0,9999,0
1668205898256,CSE 293,012,119230,Impagliazzo; Russell,9999,0,9999,0
1668205898256,CSE 293,013,119232,Jhala; Ranjit,9999,0,9999,0
1668205898256,CSE 293,014,119233,Kahng; Andrew Byun,9999,0,9999,0
1668205898256,CSE 293,015,119298,Kane; Daniel Mertz,9999,0,9999,0
1668205898256,CSE 293,016,119299,Kriegman; David J,9999,0,9999,0
1668205898256,CSE 293,017,119300,Kumar; Arun Kumar,9999,0,9999,0
1668205898256,CSE 293,018,119301,Lerner; Sorin,9999,0,9999,0
1668205898256,CSE 293,019,119302,Lovett; Shachar,9999,0,9999,0
1668205898256,CSE 293,020,119303,McAuley; Julian John,9999,0,9999,0
1668205898256,CSE 293,021,119304,Micciancio; Daniele,9999,0,9999,0
1668205898256,CSE 293,022,119367,Orailoglu; Alex,9999,0,9999,0
1668205898256,CSE 293,023,119382,Paturi; Ramamohan,9999,0,9999,0
1668205898256,CSE 293,024,119404,Polikarpova; Nadezhda,9999,0,9999,0
1668205898256,CSE 293,025,119406,Politz; Joseph Gibbs,9999,0,9999,0
1668205898256,CSE 293,026,119411,Porter; George M,9999,0,9999,0
1668205898256,CSE 293,027,119414,Porter; Leonard Emerson,9999,0,9999,0
1668205898256,CSE 293,028,119416,Ramamoorthi; Ravi,9999,0,9999,0
1668205898256,CSE 293,029,119417,Sahoo; Debashis,9999,0,9999,0
1668205898256,CSE 293,030,119420,Saul; Lawrence,9999,0,9999,0
1668205898256,CSE 293,031,119421,Savage; Stefan,9999,0,9999,0
1668205898256,CSE 293,032,119425,Schulze; Jurgen P.,9999,0,9999,0
1668205898256,CSE 293,033,119426,Snoeren; Alex C.,9999,0,9999,0
1668205898256,CSE 293,034,119428,Shang; Jingbo,9999,0,9999,0
1668205898256,CSE 293,035,119430,Stefan; Deian,9999,0,9999,0
1668205898256,CSE 293,036,119431,Su; Hao,9999,0,9999,0
1668205898256,CSE 293,037,119433,Swanson; Steven James,9999,0,9999,0
1668205898256,CSE 293,038,119435,Tullsen; Dean Michael,9999,0,9999,0
1668205898256,CSE 293,039,119483,Voelker; Geoffrey M.,9999,0,9999,0
1668205898256,CSE 293,040,119537,Zhao; Jishen,9999,0,9999,0
1668205898256,CSE 293,041,119538,Zhou; Yuan-Yuan,9999,0,9999,0
1668205898256,CSE 293,042,119539,Gao; Sicun,9999,0,9999,0
1668205898256,CSE 293,043,119540,Weibel; Nadir,9999,0,9999,0
1668205898256,CSE 293,044,119541,Gupta; Rajesh K.,9999,0,9999,0
1668205898256,CSE 293,045,126410,Vaccaro; Kristen Marie,9999,0,9999,0
1668205898256,CSE 293,046,126411,Klemke; Richard,9999,0,9999,0
1668205898679,CSE 294,A00,102459,Voelker; Geoffrey M.,0,0,0,0
1668205898679,CSE 294,B00,111322,Orailoglu; Alex,0,0,0,0
1668205899108,DSE 201,A00,096914,Deutsch; Alin Bernard,30,0,30,0
1668205899533,DSE 210,A00,096915,Dasgupta; Sanjoy,30,0,30,0
1668205899959,DSE 260A,A00,096916,Altintas De Callaf; Ilkay,30,0,30,0
1668205900395,ECE 200,001,103586,Antipa; Nicholas A,9999,0,9999,0
1668205900395,ECE 200,002,103587,Atanasov; Nikolay A.,9999,0,9999,0
1668205900395,ECE 200,003,103588,Bharadia; Dinesh,9999,0,9999,0
1668205900395,ECE 200,004,103589,Cheng; Chung Kuan,9999,0,9999,0
1668205900395,ECE 200,005,103590,Cosman; Pamela C.,9999,0,9999,0
1668205900395,ECE 200,006,103591,Dayeh; Shadi Ahmad,9999,0,9999,0
1668205900395,ECE 200,007,103592,Fainman; Yeshaiahu,9999,0,9999,0
1668205900395,ECE 200,008,103593,Ford; Joseph Earl,9999,0,9999,0
1668205900395,ECE 200,009,103594,Franceschetti; Massimo,9999,0,9999,0
1668205900395,ECE 200,010,103595,Fullerton; Eric E,9999,0,9999,0
1668205900395,ECE 200,011,103596,Galton; Ian A,9999,0,9999,0
1668205900395,ECE 200,012,103597,Gilja; Vikash,9999,0,9999,0
1668205900395,ECE 200,013,103598,Hall; Drew A.,9999,0,9999,0
1668205900395,ECE 200,014,103599,Hsueh; Tzu-Chien,9999,0,9999,0
1668205900395,ECE 200,015,103600,Javidi; Tara,9999,0,9999,0
1668205900395,ECE 200,016,103601,Kahng; Andrew Byun,9999,0,9999,0
1668205900395,ECE 200,017,103602,Kim; Young-Han,9999,0,9999,0
1668205900395,ECE 200,018,103603,Koushanfar; Farinaz,9999,0,9999,0
1668205900395,ECE 200,019,103604,Kuzum; Duygu,9999,0,9999,0
1668205900395,ECE 200,020,103605,Le; Hanh-Phuc,9999,0,9999,0
1668205900395,ECE 200,021,103606,Lin; Bill,9999,0,9999,0
1668205900395,ECE 200,022,103607,Liu; Zhaowei,9998,0,9999,1
1668205900395,ECE 200,023,103608,Lo; Yu-Hwa,9999,0,9999,0
1668205900395,ECE 200,024,103609,Lomakin; Vitaliy,9999,0,9999,0
1668205900395,ECE 200,025,103610,Mercier; Patrick Philip,9999,0,9999,0
1668205900395,ECE 200,026,103611,Meyer; Florian,9999,0,9999,0
1668205900395,ECE 200,027,103612,Milstein; Laurence B.,9999,0,9999,0
1668205900395,ECE 200,028,103613,Mir Arabbaygi; Siavash,9999,0,9999,0
1668205900395,ECE 200,029,103614,Mookherjea; Shayan,9999,0,9999,0
1668205900395,ECE 200,030,103615,Morris; Karcher William,9999,0,9999,0
1668205900395,ECE 200,031,103616,Ng; Tse Nga,9999,0,9999,0
1668205900395,ECE 200,032,103617,Nguyen; Truong Quang,9999,0,9999,0
1668205900395,ECE 200,033,103618,Nomura; Kenji,9999,0,9999,0
1668205900395,ECE 200,034,103619,Orlitsky; Alon,9999,0,9999,0
1668205900395,ECE 200,035,103620,Pal; Piya,9999,0,9999,0
1668205900395,ECE 200,036,103621,Papen; George C.,9999,0,9999,0
1668205900395,ECE 200,037,103622,Radic; Stojan,9999,0,9999,0
1668205900395,ECE 200,038,103623,Rao; Bhaskar D.,9999,0,9999,0
1668205900395,ECE 200,039,103624,Rao; Ramesh R,9999,0,9999,0
1668205900395,ECE 200,040,103625,Rebeiz; Gabriel,9999,0,9999,0
1668205900395,ECE 200,041,103626,Sanford; John R,9999,0,9999,0
1668205900395,ECE 200,042,103627,Siegel; Paul H.,9999,0,9999,0
1668205900395,ECE 200,043,103628,Sievenpiper; Daniel F.,9999,0,9999,0
1668205900395,ECE 200,044,103629,Sworder; David D.,9999,0,9999,0
1668205900395,ECE 200,045,103630,Taur; Yuan,9999,0,9999,0
1668205900395,ECE 200,046,103631,Touri; Behrouz,9999,0,9999,0
1668205900395,ECE 200,047,103632,Trivedi; Mohan M.,9999,0,9999,0
1668205900395,ECE 200,048,103633,Vasconcelos; Nuno,9999,0,9999,0
1668205900395,ECE 200,049,103634,Wang; Xiaolong,9999,0,9999,0
1668205900395,ECE 200,050,103635,Xie; Pengtao,9999,0,9999,0
1668205900395,ECE 200,051,103636,Yip; Michael,9999,0,9999,0
1668205900395,ECE 200,052,103637,Zeger; Kenneth A.,999,0,999,0
1668205900395,ECE 200,053,103638,Zhang; Xinyu,9999,0,9999,0
1668205900395,ECE 200,054,103639,Turakhia; Yatish Girish,9999,0,9999,0
1668205900395,ECE 200,055,103640,Kang; Mingu,9999,0,9999,0
1668205900395,ECE 200,056,103641,Shi; Yuanyuan,9999,0,9999,0
1668205900395,ECE 200,057,103642,Wang; Edward Jay,9999,0,9999,0
1668205900395,ECE 200,058,103643,Zheng; Yang,9999,0,9999,0
1668205900819,ECE 202,A00,103644,Kuzum; Duygu,0,0,0,0
1668205901250,ECE 212BN,A00,103646,Ng; Tse Nga,0,0,0,0
1668205901672,ECE 221,A00,111493,Staff,0,0,0,0
1668205902123,ECE 222B,A00,103647,Lomakin; Vitaliy,0,0,0,0
1668205902548,ECE 230B,A00,103648,Taur; Yuan,0,0,0,0
1668205902972,ECE 238B,A00,103649,Garay; Javier,0,0,0,0
1668205903398,ECE 240B,A00,112900,Fainman; Yeshaiahu,0,0,0,0
1668205903829,ECE 247A,A00,103650,Jokerst; Jesse Vincent,0,0,0,0
1668205904260,ECE 247B,A00,103651,Wang; Joseph,0,0,0,0
1668205904682,ECE 250,A00,103652,Siegel; Paul H.,0,0,0,0
1668205905112,ECE 251A,A00,103654,Rao; Bhaskar D.,0,0,0,0
1668205905535,ECE 257B,A00,103655,Bharadia; Dinesh,0,0,0,0
1668205905960,ECE 258A,A00,103656,Milstein; Laurence B.,0,0,0,0
1668205906385,ECE 260B,A00,103658,Kang; Mingu,0,0,0,0
1668205906809,ECE 264A,A00,103659,Galton; Ian A,0,0,0,0
1668205907234,ECE 265A,A00,103661,Gudem; Prasad S.S.,0,0,0,0
1668205907659,ECE 265D,A00,103662,Gudem; Prasad S.S.,0,0,0,0
1668205908085,ECE 268,A00,103663,Koushanfar; Farinaz,0,0,0,0
1668205908512,ECE 269,A01,103665,Pal; Piya,0,0,0,0
1668205908938,ECE 271B,A00,103666,Vasconcelos; Manuela,0,0,0,0
1668205909371,ECE 276A,A00,103667,Atanasov; Nikolay A.,0,0,0,0
1668205909794,ECE 277,A00,103668,An; Cheolhong,0,0,0,0
1668205910222,ECE 279,A00,117947,Hall; Drew A.,0,0,0,0
1668205911155,ECE 283,A00,103670,Hsueh; Tzu-Chien,0,0,0,0
1668205911587,ECE 284,A00,103671,Turakhia; Yatish Girish,0,0,0,0
1668205912022,ECE 285,A00,103672,Zheng; Yang,0,0,0,0
1668205912022,ECE 285,B00,103673,Sworder; David D.,0,0,0,0
1668205912444,ECE 287,A00,103676,Javidi; Tara,0,0,0,0
1668205912868,MATH 200B,A00,098023,Salehi Golsefidy; Alireza,12,0,15,3
1668205913292,MATH 202B,A00,098024,Rhoades; Brendon Patrick,9,0,15,6
1668205913716,MATH 203B,A00,098025,Oprea; Dragos N.,10,0,15,5
1668205914149,MATH 204B,A00,098026,Sorensen; Claus M,13,0,15,2
1668205914734,MATH 208,A00,098027,Izadi; Elham,7,0,10,3
1668205915162,MATH 209,A00,098028,Pollack; Aaron,10,0,10,0
1668205915585,MATH 211A,A00,112919,Rogalski; Daniel,9,0,10,1
1668205916014,MATH 211B,A00,112920,Seward; Brandon M.,9,0,10,1
1668205916438,MATH 218,A00,098029,Li; Bo,10,0,10,0
1668205916862,MATH 220B,A00,098030,Novak; Jonathan I,11,0,15,4
1668205917285,MATH 221A,A00,098031,Ebenfelt; Peter F,13,0,15,2
1668205917709,MATH 231B,A00,098032,Zlatos; Andrej,12,0,15,3
1668205918141,MATH 240B,A00,098033,Ni; Lei,9,0,15,6
1668205918566,MATH 243,A00,098034,Jekel; David Andrew,10,0,10,0
1668205918988,MATH 245A,A00,098035,Nie; Jiawang,0,0,15,16
1668205919418,MATH 248,A00,098036,Bejenaru; Ioan,10,0,10,0
1668205919845,MATH 250B,A00,098037,Spolaor; Luca,14,0,15,1
1668205920287,MATH 258,A00,098038,Ni; Lei,10,0,10,0
1668205920712,MATH 264B,A00,098041,Rhoades; Brendon Patrick,9,0,15,6
1668205921150,MATH 268,A00,098042,Buss; Samuel R,10,0,10,0
1668205921572,MATH 269,A00,098043,Rhoades; Brendon Patrick,10,0,10,0
1668205922009,MATH 270B,A00,098044,Li; Bo,10,0,15,5
1668205922447,MATH 272B,A00,098045,Holst; Michael J,13,0,15,2
1668205922879,MATH 273A,A00,098046,Tian; Xiaochuan,10,0,15,5
1668205923303,MATH 275,A01,098048,Tian; Xiaochuan,6,0,10,4
1668205923728,MATH 278A,A00,098049,Holst; Michael J,8,0,10,2
1668205924163,MATH 278B,A00,098050,Cloninger; Alexander,10,0,10,0
1668205924587,MATH 278C,A00,098051,Nie; Jiawang,7,0,10,3
1668205925014,MATH 280B,A00,098052,Zheng; Tianyi,10,0,15,5
1668205925446,MATH 281B,A00,098053,Bradic; Jelena,2,0,15,13
1668205925879,MATH 282B,A00,098054,Arias-Castro; Ery,0,0,15,15
1668205926307,MATH 285,A00,098055,Fitzsimmons; Patrick J,0,0,15,17
1668205926730,MATH 287B,A00,098056,Arias-Castro; Ery,2,0,15,13
1668205927163,MATH 288,A00,098057,Agarwal; Pooja,9,0,10,1
1668205927163,MATH 288,B00,098058,Zhang; Danna,8,0,10,2
1668205927163,MATH 288,C00,098059,Williams; Ruth J,10,0,10,0
1668205927586,MATH 290B,A00,098060,Roberts; Justin Deritter,13,0,15,2
1668205928012,MATH 292,A00,098061,Belmont; Eva Kinoshita,10,0,10,0
1668205928440,MATH 295,A00,098062,Suk; Andrew Hoon,48,0,50,2
1668205928868,MATH 296,A00,098063,Novak; Jonathan I,20,0,20,0
1668205929292,MATH 297,001,098064,Gamst; Anthony Collins,9997,0,9999,2
1668206431589,COGS 205,A00,101395,Chiba; Andrea,19,0,20,1
1668206432017,COGS 210B,001,101404,Greene; Deanna Jacquelyn,9998,0,9999,1
1668206432017,COGS 210B,002,101417,Xia; Haijun,9999,0,9999,0
1668206432017,COGS 210B,003,101422,Nitz; Douglas A.,9999,0,9999,0
1668206432017,COGS 210B,004,101423,Hollan; James D.,9998,0,9999,1
1668206432017,COGS 210B,005,101424,Deak; Gedeon O.,9998,0,9999,1
1668206432017,COGS 210B,006,101425,Rossano; Federico,9999,0,9999,0
1668206432443,COGS 211B,A00,101427,Coulson; Seana M,9996,0,9999,3
1668206432867,COGS 220,A00,101428,Hollan; James D.,0,0,25,25
1668206433364,COGS 229,A00,101429,Dow; Steven P,18,0,25,7
1668206433788,COGS 230,A00,101430,Klemmer; Scott R,12,0,17,5
1668206434214,COGS 234,A00,101431,Xia; Haijun,2,0,25,23
1668206434641,COGS 260,A00,101432,Kiyonaga; Anastasia,21,0,25,4
1668206434641,COGS 260,B00,101433,Kirsh; David Joel,16,0,25,9
1668206435066,CSE 202,A00,102371,Impagliazzo; Russell,0,0,0,0
1668206435491,CSE 203B,A01,102373,Cheng; Chung Kuan,0,0,0,0
1668206435918,CSE 208,A00,102374,Micciancio; Daniele,0,0,0,0
1668206436348,CSE 209A,A00,112895,Impagliazzo; Russell,0,0,15,15
1668206436772,CSE 209B,A00,108005,Bellare; Mihir,0,0,0,0
1668206437203,CSE 210,A00,113163,Coblenz; Michael J,0,0,0,0
1668206437625,CSE 219,A00,106111,Dow; Steven P,0,0,20,20
1668206438064,CSE 221,A00,102376,Voelker; Geoffrey M.,0,0,0,0
1668206438490,CSE 224,A01,102378,Porter; George M,0,0,0,0
1668206438919,CSE 229A,A00,102379,Savage; Stefan,0,0,0,0
1668206439341,CSE 229C,A00,102380,Munyaka; Imani N. S.,0,0,0,0
1668206439764,CSE 232B,A00,102382,Deutsch; Alin Bernard,0,0,0,0
1668206440186,CSE 234,A01,112904,Kumar; Arun Kumar,0,0,0,0
1668206440610,CSE 237A,A00,102383,Rosing; Tajana Simunic,0,0,0,0
1668206441035,CSE 239A,A00,102384,Deutsch; Alin Bernard,0,0,0,0
1668206441463,CSE 239B,A00,102385,Polikarpova; Nadezhda,0,0,0,0
1668206441887,CSE 240A,A00,102386,Pannuto; Patrick William,0,0,0,0
1668206442313,CSE 240B,A00,102387,Zhao; Jishen,0,0,0,0
1668206442738,CSE 241A,A00,106406,Kang; Mingu,0,0,0,0
1668206443160,CSE 249B,A00,102388,Kahng; Andrew Byun,0,0,8,8
1668206443594,CSE 251B,A01,102392,Cottrell; Garrison W,0,0,0,0
1668206443594,CSE 251B,A02,102393,Cottrell; Garrison W,0,0,0,0
1668206444020,CSE 252B,A00,102394,Ochoa; Benjamin Lawrence,0,0,0,0
1668206444459,CSE 257,A01,102396,Gao; Sicun,0,0,0,0
1668206444882,CSE 272,A00,102397,Li; Tzumao,0,0,0,0
1668206445306,CSE 274,A00,111323,Chern; Albert Ren-Haur,0,0,0,0
1668206445729,CSE 282,A00,102398,Pevzner; Pavel Arkadjevich,0,0,0,0
1668206446155,CSE 284,A00,114175,Gymrek; Melissa Ann,0,0,0,0
1668206446579,CSE 290,A00,102399,Chandraker; Manmohan Krishna,0,0,0,0
1668206446579,CSE 290,B00,102400,Vaccaro; Kristen Marie,0,0,25,25
1668206446579,CSE 290,C00,102414,Pannuto; Patrick William,0,0,25,25
1668206446579,CSE 290,D00,102427,Pevzner; Pavel Arkadjevich,0,0,0,0
1668206446579,CSE 290,E00,102429,Zhao; Jishen,0,0,0,0
1668206446579,CSE 290,F00,102436,Tullsen; Dean Michael,0,0,0,0
1668206446579,CSE 290,G00,102440,Christensen; Henrik I,0,0,20,20
1668206447007,CSE 291,A00,102443,Su; Hao,0,0,0,0
1668206447007,CSE 291,B00,102448,Polikarpova; Nadezhda,0,0,0,0
1668206447007,CSE 291,C00,102453,Vaccaro; Kristen Marie,0,0,0,0
1668206447007,CSE 291,D00,111343,Savage; Stefan,0,0,0,0
1668206447007,CSE 291,E00,116474,Claffy; Kimberly Claire,0,0,0,0
1668206447007,CSE 291,F00,116479,Pasquale; Joseph,0,0,0,0
1668206447464,CSE 293,001,119111,Bafna; Vineet,9999,0,9999,0
1668206447464,CSE 293,002,119118,Bellare; Mihir,9999,0,9999,0
1668206447464,CSE 293,003,119122,Berg-Kirkpatrick; Taylor D,9999,0,9999,0
1668206447464,CSE 293,004,119135,Christensen; Henrik I,9999,0,9999,0
1668206447464,CSE 293,005,119142,Cottrell; Garrison W,9999,0,9999,0
1668206447464,CSE 293,006,119146,Deutsch; Alin Bernard,9999,0,9999,0
1668206447464,CSE 293,007,119159,Esmaeilzadeh; Hadi,9999,0,9999,0
1668206447464,CSE 293,008,119166,Freund; Yoav,9999,0,9999,0
1668206447464,CSE 293,009,119170,Griswold; William G.,9999,0,9999,0
1668206447464,CSE 293,010,119183,Gymrek; Melissa Ann,9999,0,9999,0
1668206447464,CSE 293,011,119190,Heninger; Nadia A,9999,0,9999,0
1668206447464,CSE 293,012,119230,Impagliazzo; Russell,9999,0,9999,0
1668206447464,CSE 293,013,119232,Jhala; Ranjit,9999,0,9999,0
1668206447464,CSE 293,014,119233,Kahng; Andrew Byun,9999,0,9999,0
1668206447464,CSE 293,015,119298,Kane; Daniel Mertz,9999,0,9999,0
1668206447464,CSE 293,016,119299,Kriegman; David J,9999,0,9999,0
1668206447464,CSE 293,017,119300,Kumar; Arun Kumar,9999,0,9999,0
1668206447464,CSE 293,018,119301,Lerner; Sorin,9999,0,9999,0
1668206447464,CSE 293,019,119302,Lovett; Shachar,9999,0,9999,0
1668206447464,CSE 293,020,119303,McAuley; Julian John,9999,0,9999,0
1668206447464,CSE 293,021,119304,Micciancio; Daniele,9999,0,9999,0
1668206447464,CSE 293,022,119367,Orailoglu; Alex,9999,0,9999,0
1668206447464,CSE 293,023,119382,Paturi; Ramamohan,9999,0,9999,0
1668206447464,CSE 293,024,119404,Polikarpova; Nadezhda,9999,0,9999,0
1668206447464,CSE 293,025,119406,Politz; Joseph Gibbs,9999,0,9999,0
1668206447464,CSE 293,026,119411,Porter; George M,9999,0,9999,0
1668206447464,CSE 293,027,119414,Porter; Leonard Emerson,9999,0,9999,0
1668206447464,CSE 293,028,119416,Ramamoorthi; Ravi,9999,0,9999,0
1668206447464,CSE 293,029,119417,Sahoo; Debashis,9999,0,9999,0
1668206447464,CSE 293,030,119420,Saul; Lawrence,9999,0,9999,0
1668206447464,CSE 293,031,119421,Savage; Stefan,9999,0,9999,0
1668206447464,CSE 293,032,119425,Schulze; Jurgen P.,9999,0,9999,0
1668206447464,CSE 293,033,119426,Snoeren; Alex C.,9999,0,9999,0
1668206447464,CSE 293,034,119428,Shang; Jingbo,9999,0,9999,0
1668206447464,CSE 293,035,119430,Stefan; Deian,9999,0,9999,0
1668206447464,CSE 293,036,119431,Su; Hao,9999,0,9999,0
1668206447464,CSE 293,037,119433,Swanson; Steven James,9999,0,9999,0
1668206447464,CSE 293,038,119435,Tullsen; Dean Michael,9999,0,9999,0
1668206447464,CSE 293,039,119483,Voelker; Geoffrey M.,9999,0,9999,0
1668206447464,CSE 293,040,119537,Zhao; Jishen,9999,0,9999,0
1668206447464,CSE 293,041,119538,Zhou; Yuan-Yuan,9999,0,9999,0
1668206447464,CSE 293,042,119539,Gao; Sicun,9999,0,9999,0
1668206447464,CSE 293,043,119540,Weibel; Nadir,9999,0,9999,0
1668206447464,CSE 293,044,119541,Gupta; Rajesh K.,9999,0,9999,0
1668206447464,CSE 293,045,126410,Vaccaro; Kristen Marie,9999,0,9999,0
1668206447464,CSE 293,046,126411,Klemke; Richard,9999,0,9999,0
1668206447894,CSE 294,A00,102459,Voelker; Geoffrey M.,0,0,0,0
1668206447894,CSE 294,B00,111322,Orailoglu; Alex,0,0,0,0
1668206448317,DSE 201,A00,096914,Deutsch; Alin Bernard,30,0,30,0
1668206448740,DSE 210,A00,096915,Dasgupta; Sanjoy,30,0,30,0
1668206449164,DSE 260A,A00,096916,Altintas De Callaf; Ilkay,30,0,30,0
1668206449589,ECE 200,001,103586,Antipa; Nicholas A,9999,0,9999,0
1668206449589,ECE 200,002,103587,Atanasov; Nikolay A.,9999,0,9999,0
1668206449589,ECE 200,003,103588,Bharadia; Dinesh,9999,0,9999,0
1668206449589,ECE 200,004,103589,Cheng; Chung Kuan,9999,0,9999,0
1668206449589,ECE 200,005,103590,Cosman; Pamela C.,9999,0,9999,0
1668206449589,ECE 200,006,103591,Dayeh; Shadi Ahmad,9999,0,9999,0
1668206449589,ECE 200,007,103592,Fainman; Yeshaiahu,9999,0,9999,0
1668206449589,ECE 200,008,103593,Ford; Joseph Earl,9999,0,9999,0
1668206449589,ECE 200,009,103594,Franceschetti; Massimo,9999,0,9999,0
1668206449589,ECE 200,010,103595,Fullerton; Eric E,9999,0,9999,0
1668206449589,ECE 200,011,103596,Galton; Ian A,9999,0,9999,0
1668206449589,ECE 200,012,103597,Gilja; Vikash,9999,0,9999,0
1668206449589,ECE 200,013,103598,Hall; Drew A.,9999,0,9999,0
1668206449589,ECE 200,014,103599,Hsueh; Tzu-Chien,9999,0,9999,0
1668206449589,ECE 200,015,103600,Javidi; Tara,9999,0,9999,0
1668206449589,ECE 200,016,103601,Kahng; Andrew Byun,9999,0,9999,0
1668206449589,ECE 200,017,103602,Kim; Young-Han,9999,0,9999,0
1668206449589,ECE 200,018,103603,Koushanfar; Farinaz,9999,0,9999,0
1668206449589,ECE 200,019,103604,Kuzum; Duygu,9999,0,9999,0
1668206449589,ECE 200,020,103605,Le; Hanh-Phuc,9999,0,9999,0
1668206449589,ECE 200,021,103606,Lin; Bill,9999,0,9999,0
1668206449589,ECE 200,022,103607,Liu; Zhaowei,9998,0,9999,1
1668206449589,ECE 200,023,103608,Lo; Yu-Hwa,9999,0,9999,0
1668206449589,ECE 200,024,103609,Lomakin; Vitaliy,9999,0,9999,0
1668206449589,ECE 200,025,103610,Mercier; Patrick Philip,9999,0,9999,0
1668206449589,ECE 200,026,103611,Meyer; Florian,9999,0,9999,0
1668206449589,ECE 200,027,103612,Milstein; Laurence B.,9999,0,9999,0
1668206449589,ECE 200,028,103613,Mir Arabbaygi; Siavash,9999,0,9999,0
1668206449589,ECE 200,029,103614,Mookherjea; Shayan,9999,0,9999,0
1668206449589,ECE 200,030,103615,Morris; Karcher William,9999,0,9999,0
1668206449589,ECE 200,031,103616,Ng; Tse Nga,9999,0,9999,0
1668206449589,ECE 200,032,103617,Nguyen; Truong Quang,9999,0,9999,0
1668206449589,ECE 200,033,103618,Nomura; Kenji,9999,0,9999,0
1668206449589,ECE 200,034,103619,Orlitsky; Alon,9999,0,9999,0
1668206449589,ECE 200,035,103620,Pal; Piya,9999,0,9999,0
1668206449589,ECE 200,036,103621,Papen; George C.,9999,0,9999,0
1668206449589,ECE 200,037,103622,Radic; Stojan,9999,0,9999,0
1668206449589,ECE 200,038,103623,Rao; Bhaskar D.,9999,0,9999,0
1668206449589,ECE 200,039,103624,Rao; Ramesh R,9999,0,9999,0
1668206449589,ECE 200,040,103625,Rebeiz; Gabriel,9999,0,9999,0
1668206449589,ECE 200,041,103626,Sanford; John R,9999,0,9999,0
1668206449589,ECE 200,042,103627,Siegel; Paul H.,9999,0,9999,0
1668206449589,ECE 200,043,103628,Sievenpiper; Daniel F.,9999,0,9999,0
1668206449589,ECE 200,044,103629,Sworder; David D.,9999,0,9999,0
1668206449589,ECE 200,045,103630,Taur; Yuan,9999,0,9999,0
1668206449589,ECE 200,046,103631,Touri; Behrouz,9999,0,9999,0
1668206449589,ECE 200,047,103632,Trivedi; Mohan M.,9999,0,9999,0
1668206449589,ECE 200,048,103633,Vasconcelos; Nuno,9999,0,9999,0
1668206449589,ECE 200,049,103634,Wang; Xiaolong,9999,0,9999,0
1668206449589,ECE 200,050,103635,Xie; Pengtao,9999,0,9999,0
1668206449589,ECE 200,051,103636,Yip; Michael,9999,0,9999,0
1668206449589,ECE 200,052,103637,Zeger; Kenneth A.,999,0,999,0
1668206449589,ECE 200,053,103638,Zhang; Xinyu,9999,0,9999,0
1668206449589,ECE 200,054,103639,Turakhia; Yatish Girish,9999,0,9999,0
1668206449589,ECE 200,055,103640,Kang; Mingu,9999,0,9999,0
1668206449589,ECE 200,056,103641,Shi; Yuanyuan,9999,0,9999,0
1668206449589,ECE 200,057,103642,Wang; Edward Jay,9999,0,9999,0
1668206449589,ECE 200,058,103643,Zheng; Yang,9999,0,9999,0
1668206450015,ECE 202,A00,103644,Kuzum; Duygu,0,0,0,0
1668206450440,ECE 212BN,A00,103646,Ng; Tse Nga,0,0,0,0
1668206450868,ECE 221,A00,111493,Staff,0,0,0,0
1668206451290,ECE 222B,A00,103647,Lomakin; Vitaliy,0,0,0,0
1668206451715,ECE 230B,A00,103648,Taur; Yuan,0,0,0,0
1668206452139,ECE 238B,A00,103649,Garay; Javier,0,0,0,0
1668206452561,ECE 240B,A00,112900,Fainman; Yeshaiahu,0,0,0,0
1668206452996,ECE 247A,A00,103650,Jokerst; Jesse Vincent,0,0,0,0
1668206453430,ECE 247B,A00,103651,Wang; Joseph,0,0,0,0
1668206453856,ECE 250,A00,103652,Siegel; Paul H.,0,0,0,0
1668206454278,ECE 251A,A00,103654,Rao; Bhaskar D.,0,0,0,0
1668206454701,ECE 257B,A00,103655,Bharadia; Dinesh,0,0,0,0
1668206455134,ECE 258A,A00,103656,Milstein; Laurence B.,0,0,0,0
1668206455566,ECE 260B,A00,103658,Kang; Mingu,0,0,0,0
1668206455999,ECE 264A,A00,103659,Galton; Ian A,0,0,0,0
1668206456425,ECE 265A,A00,103661,Gudem; Prasad S.S.,0,0,0,0
1668206456848,ECE 265D,A00,103662,Gudem; Prasad S.S.,0,0,0,0
1668206457271,ECE 268,A00,103663,Koushanfar; Farinaz,0,0,0,0
1668206457692,ECE 269,A01,103665,Pal; Piya,0,0,0,0
1668206458116,ECE 271B,A00,103666,Vasconcelos; Manuela,0,0,0,0
1668206458546,ECE 276A,A00,103667,Atanasov; Nikolay A.,0,0,0,0
1668206458975,ECE 277,A00,103668,An; Cheolhong,0,0,0,0
1668206459399,ECE 279,A00,117947,Hall; Drew A.,0,0,0,0
1668206460254,ECE 283,A00,103670,Hsueh; Tzu-Chien,0,0,0,0
1668206460678,ECE 284,A00,103671,Turakhia; Yatish Girish,0,0,0,0
1668206461105,ECE 285,A00,103672,Zheng; Yang,0,0,0,0
1668206461105,ECE 285,B00,103673,Sworder; David D.,0,0,0,0
1668206461530,ECE 287,A00,103676,Javidi; Tara,0,0,0,0
1668206461956,MATH 200B,A00,098023,Salehi Golsefidy; Alireza,12,0,15,3
1668206462393,MATH 202B,A00,098024,Rhoades; Brendon Patrick,9,0,15,6
1668206462819,MATH 203B,A00,098025,Oprea; Dragos N.,10,0,15,5
1668206463248,MATH 204B,A00,098026,Sorensen; Claus M,13,0,15,2
1668206463674,MATH 208,A00,098027,Izadi; Elham,7,0,10,3
1668206464096,MATH 209,A00,098028,Pollack; Aaron,10,0,10,0
1668206464519,MATH 211A,A00,112919,Rogalski; Daniel,9,0,10,1
1668206464943,MATH 211B,A00,112920,Seward; Brandon M.,9,0,10,1
1668206465365,MATH 218,A00,098029,Li; Bo,10,0,10,0
1668206465788,MATH 220B,A00,098030,Novak; Jonathan I,11,0,15,4
1668206466212,MATH 221A,A00,098031,Ebenfelt; Peter F,13,0,15,2
1668206466639,MATH 231B,A00,098032,Zlatos; Andrej,12,0,15,3
1668206467069,MATH 240B,A00,098033,Ni; Lei,9,0,15,6
1668206467494,MATH 243,A00,098034,Jekel; David Andrew,10,0,10,0
1668206467923,MATH 245A,A00,098035,Nie; Jiawang,0,0,15,16
1668206468353,MATH 248,A00,098036,Bejenaru; Ioan,10,0,10,0
1668206468775,MATH 250B,A00,098037,Spolaor; Luca,14,0,15,1
1668206469200,MATH 258,A00,098038,Ni; Lei,10,0,10,0
1668206469623,MATH 264B,A00,098041,Rhoades; Brendon Patrick,9,0,15,6
1668206470049,MATH 268,A00,098042,Buss; Samuel R,10,0,10,0
1668206470490,MATH 269,A00,098043,Rhoades; Brendon Patrick,10,0,10,0
1668206470921,MATH 270B,A00,098044,Li; Bo,10,0,15,5
1668206471352,MATH 272B,A00,098045,Holst; Michael J,13,0,15,2
1668206471775,MATH 273A,A00,098046,Tian; Xiaochuan,10,0,15,5
1668206472205,MATH 275,A01,098048,Tian; Xiaochuan,6,0,10,4
1668206472627,MATH 278A,A00,098049,Holst; Michael J,8,0,10,2
1668206473051,MATH 278B,A00,098050,Cloninger; Alexander,10,0,10,0
1668206473476,MATH 278C,A00,098051,Nie; Jiawang,7,0,10,3
1668206473900,MATH 280B,A00,098052,Zheng; Tianyi,10,0,15,5
1668206474329,MATH 281B,A00,098053,Bradic; Jelena,2,0,15,13
1668206474761,MATH 282B,A00,098054,Arias-Castro; Ery,0,0,15,15
1668206475195,MATH 285,A00,098055,Fitzsimmons; Patrick J,0,0,15,17
1668206475625,MATH 287B,A00,098056,Arias-Castro; Ery,2,0,15,13
1668206476048,MATH 288,A00,098057,Agarwal; Pooja,9,0,10,1
1668206476048,MATH 288,B00,098058,Zhang; Danna,8,0,10,2
1668206476048,MATH 288,C00,098059,Williams; Ruth J,10,0,10,0
1668206476586,MATH 290B,A00,098060,Roberts; Justin Deritter,13,0,15,2
1668206477010,MATH 292,A00,098061,Belmont; Eva Kinoshita,10,0,10,0
1668206477439,MATH 295,A00,098062,Suk; Andrew Hoon,48,0,50,2
1668206477874,MATH 296,A00,098063,Novak; Jonathan I,20,0,20,0
1668206478305,MATH 297,001,098064,Gamst; Anthony Collins,9997,0,9999,2
1668206980288,COGS 205,A00,101395,Chiba; Andrea,19,0,20,1
1668206980714,COGS 210B,001,101404,Greene; Deanna Jacquelyn,9998,0,9999,1
1668206980714,COGS 210B,002,101417,Xia; Haijun,9999,0,9999,0
1668206980714,COGS 210B,003,101422,Nitz; Douglas A.,9999,0,9999,0
1668206980714,COGS 210B,004,101423,Hollan; James D.,9998,0,9999,1
1668206980714,COGS 210B,005,101424,Deak; Gedeon O.,9998,0,9999,1
1668206980714,COGS 210B,006,101425,Rossano; Federico,9999,0,9999,0
1668206981137,COGS 211B,A00,101427,Coulson; Seana M,9996,0,9999,3
1668206981559,COGS 220,A00,101428,Hollan; James D.,0,0,25,25
1668206981984,COGS 229,A00,101429,Dow; Steven P,18,0,25,7
1668206982408,COGS 230,A00,101430,Klemmer; Scott R,12,0,17,5
1668206982832,COGS 234,A00,101431,Xia; Haijun,2,0,25,23
1668206983264,COGS 260,A00,101432,Kiyonaga; Anastasia,21,0,25,4
1668206983264,COGS 260,B00,101433,Kirsh; David Joel,16,0,25,9
1668206983686,CSE 202,A00,102371,Impagliazzo; Russell,0,0,0,0
1668206984114,CSE 203B,A01,102373,Cheng; Chung Kuan,0,0,0,0
1668206984538,CSE 208,A00,102374,Micciancio; Daniele,0,0,0,0
1668206984962,CSE 209A,A00,112895,Impagliazzo; Russell,0,0,15,15
1668206985388,CSE 209B,A00,108005,Bellare; Mihir,0,0,0,0
1668206985812,CSE 210,A00,113163,Coblenz; Michael J,0,0,0,0
1668206986251,CSE 219,A00,106111,Dow; Steven P,0,0,20,20
1668206986673,CSE 221,A00,102376,Voelker; Geoffrey M.,0,0,0,0
1668206987099,CSE 224,A01,102378,Porter; George M,0,0,0,0
1668206987537,CSE 229A,A00,102379,Savage; Stefan,0,0,0,0
1668206987959,CSE 229C,A00,102380,Munyaka; Imani N. S.,0,0,0,0
1668206988383,CSE 232B,A00,102382,Deutsch; Alin Bernard,0,0,0,0
1668206988805,CSE 234,A01,112904,Kumar; Arun Kumar,0,0,0,0
1668206989226,CSE 237A,A00,102383,Rosing; Tajana Simunic,0,0,0,0
1668206989650,CSE 239A,A00,102384,Deutsch; Alin Bernard,0,0,0,0
1668206990074,CSE 239B,A00,102385,Polikarpova; Nadezhda,0,0,0,0
1668206990500,CSE 240A,A00,102386,Pannuto; Patrick William,0,0,0,0
1668206990923,CSE 240B,A00,102387,Zhao; Jishen,0,0,0,0
1668206991352,CSE 241A,A00,106406,Kang; Mingu,0,0,0,0
1668206991773,CSE 249B,A00,102388,Kahng; Andrew Byun,0,0,8,8
1668206992197,CSE 251B,A01,102392,Cottrell; Garrison W,0,0,0,0
1668206992197,CSE 251B,A02,102393,Cottrell; Garrison W,0,0,0,0
1668206992622,CSE 252B,A00,102394,Ochoa; Benjamin Lawrence,0,0,0,0
1668206993047,CSE 257,A01,102396,Gao; Sicun,0,0,0,0
1668206993472,CSE 272,A00,102397,Li; Tzumao,0,0,0,0
1668206993898,CSE 274,A00,111323,Chern; Albert Ren-Haur,0,0,0,0
1668206994323,CSE 282,A00,102398,Pevzner; Pavel Arkadjevich,0,0,0,0
1668206994745,CSE 284,A00,114175,Gymrek; Melissa Ann,0,0,0,0
1668206995173,CSE 290,A00,102399,Chandraker; Manmohan Krishna,0,0,0,0
1668206995173,CSE 290,B00,102400,Vaccaro; Kristen Marie,0,0,25,25
1668206995173,CSE 290,C00,102414,Pannuto; Patrick William,0,0,25,25
1668206995173,CSE 290,D00,102427,Pevzner; Pavel Arkadjevich,0,0,0,0
1668206995173,CSE 290,E00,102429,Zhao; Jishen,0,0,0,0
1668206995173,CSE 290,F00,102436,Tullsen; Dean Michael,0,0,0,0
1668206995173,CSE 290,G00,102440,Christensen; Henrik I,0,0,20,20
1668206995598,CSE 291,A00,102443,Su; Hao,0,0,0,0
1668206995598,CSE 291,B00,102448,Polikarpova; Nadezhda,0,0,0,0
1668206995598,CSE 291,C00,102453,Vaccaro; Kristen Marie,0,0,0,0
1668206995598,CSE 291,D00,111343,Savage; Stefan,0,0,0,0
1668206995598,CSE 291,E00,116474,Claffy; Kimberly Claire,0,0,0,0
1668206995598,CSE 291,F00,116479,Pasquale; Joseph,0,0,0,0
1668206996024,CSE 293,001,119111,Bafna; Vineet,9999,0,9999,0
1668206996024,CSE 293,002,119118,Bellare; Mihir,9999,0,9999,0
1668206996024,CSE 293,003,119122,Berg-Kirkpatrick; Taylor D,9999,0,9999,0
1668206996024,CSE 293,004,119135,Christensen; Henrik I,9999,0,9999,0
1668206996024,CSE 293,005,119142,Cottrell; Garrison W,9999,0,9999,0
1668206996024,CSE 293,006,119146,Deutsch; Alin Bernard,9999,0,9999,0
1668206996024,CSE 293,007,119159,Esmaeilzadeh; Hadi,9999,0,9999,0
1668206996024,CSE 293,008,119166,Freund; Yoav,9999,0,9999,0
1668206996024,CSE 293,009,119170,Griswold; William G.,9999,0,9999,0
1668206996024,CSE 293,010,119183,Gymrek; Melissa Ann,9999,0,9999,0
1668206996024,CSE 293,011,119190,Heninger; Nadia A,9999,0,9999,0
1668206996024,CSE 293,012,119230,Impagliazzo; Russell,9999,0,9999,0
1668206996024,CSE 293,013,119232,Jhala; Ranjit,9999,0,9999,0
1668206996024,CSE 293,014,119233,Kahng; Andrew Byun,9999,0,9999,0
1668206996024,CSE 293,015,119298,Kane; Daniel Mertz,9999,0,9999,0
1668206996024,CSE 293,016,119299,Kriegman; David J,9999,0,9999,0
1668206996024,CSE 293,017,119300,Kumar; Arun Kumar,9999,0,9999,0
1668206996024,CSE 293,018,119301,Lerner; Sorin,9999,0,9999,0
1668206996024,CSE 293,019,119302,Lovett; Shachar,9999,0,9999,0
1668206996024,CSE 293,020,119303,McAuley; Julian John,9999,0,9999,0
1668206996024,CSE 293,021,119304,Micciancio; Daniele,9999,0,9999,0
1668206996024,CSE 293,022,119367,Orailoglu; Alex,9999,0,9999,0
1668206996024,CSE 293,023,119382,Paturi; Ramamohan,9999,0,9999,0
1668206996024,CSE 293,024,119404,Polikarpova; Nadezhda,9999,0,9999,0
1668206996024,CSE 293,025,119406,Politz; Joseph Gibbs,9999,0,9999,0
1668206996024,CSE 293,026,119411,Porter; George M,9999,0,9999,0
1668206996024,CSE 293,027,119414,Porter; Leonard Emerson,9999,0,9999,0
1668206996024,CSE 293,028,119416,Ramamoorthi; Ravi,9999,0,9999,0
1668206996024,CSE 293,029,119417,Sahoo; Debashis,9999,0,9999,0
1668206996024,CSE 293,030,119420,Saul; Lawrence,9999,0,9999,0
1668206996024,CSE 293,031,119421,Savage; Stefan,9999,0,9999,0
1668206996024,CSE 293,032,119425,Schulze; Jurgen P.,9999,0,9999,0
1668206996024,CSE 293,033,119426,Snoeren; Alex C.,9999,0,9999,0
1668206996024,CSE 293,034,119428,Shang; Jingbo,9999,0,9999,0
1668206996024,CSE 293,035,119430,Stefan; Deian,9999,0,9999,0
1668206996024,CSE 293,036,119431,Su; Hao,9999,0,9999,0
1668206996024,CSE 293,037,119433,Swanson; Steven James,9999,0,9999,0
1668206996024,CSE 293,038,119435,Tullsen; Dean Michael,9999,0,9999,0
1668206996024,CSE 293,039,119483,Voelker; Geoffrey M.,9999,0,9999,0
1668206996024,CSE 293,040,119537,Zhao; Jishen,9999,0,9999,0
1668206996024,CSE 293,041,119538,Zhou; Yuan-Yuan,9999,0,9999,0
1668206996024,CSE 293,042,119539,Gao; Sicun,9999,0,9999,0
1668206996024,CSE 293,043,119540,Weibel; Nadir,9999,0,9999,0
1668206996024,CSE 293,044,119541,Gupta; Rajesh K.,9999,0,9999,0
1668206996024,CSE 293,045,126410,Vaccaro; Kristen Marie,9999,0,9999,0
1668206996024,CSE 293,046,126411,Klemke; Richard,9999,0,9999,0
1668206996448,CSE 294,A00,102459,Voelker; Geoffrey M.,0,0,0,0
1668206996448,CSE 294,B00,111322,Orailoglu; Alex,0,0,0,0
1668206996874,DSE 201,A00,096914,Deutsch; Alin Bernard,30,0,30,0
1668206997300,DSE 210,A00,096915,Dasgupta; Sanjoy,30,0,30,0
1668206997723,DSE 260A,A00,096916,Altintas De Callaf; Ilkay,30,0,30,0
1668206998161,ECE 200,001,103586,Antipa; Nicholas A,9999,0,9999,0
1668206998161,ECE 200,002,103587,Atanasov; Nikolay A.,9999,0,9999,0
1668206998161,ECE 200,003,103588,Bharadia; Dinesh,9999,0,9999,0
1668206998161,ECE 200,004,103589,Cheng; Chung Kuan,9999,0,9999,0
1668206998161,ECE 200,005,103590,Cosman; Pamela C.,9999,0,9999,0
1668206998161,ECE 200,006,103591,Dayeh; Shadi Ahmad,9999,0,9999,0
1668206998161,ECE 200,007,103592,Fainman; Yeshaiahu,9999,0,9999,0
1668206998161,ECE 200,008,103593,Ford; Joseph Earl,9999,0,9999,0
1668206998161,ECE 200,009,103594,Franceschetti; Massimo,9999,0,9999,0
1668206998161,ECE 200,010,103595,Fullerton; Eric E,9999,0,9999,0
1668206998161,ECE 200,011,103596,Galton; Ian A,9999,0,9999,0
1668206998161,ECE 200,012,103597,Gilja; Vikash,9999,0,9999,0
1668206998161,ECE 200,013,103598,Hall; Drew A.,9999,0,9999,0
1668206998161,ECE 200,014,103599,Hsueh; Tzu-Chien,9999,0,9999,0
1668206998161,ECE 200,015,103600,Javidi; Tara,9999,0,9999,0
1668206998161,ECE 200,016,103601,Kahng; Andrew Byun,9999,0,9999,0
1668206998161,ECE 200,017,103602,Kim; Young-Han,9999,0,9999,0
1668206998161,ECE 200,018,103603,Koushanfar; Farinaz,9999,0,9999,0
1668206998161,ECE 200,019,103604,Kuzum; Duygu,9999,0,9999,0
1668206998161,ECE 200,020,103605,Le; Hanh-Phuc,9999,0,9999,0
1668206998161,ECE 200,021,103606,Lin; Bill,9999,0,9999,0
1668206998161,ECE 200,022,103607,Liu; Zhaowei,9998,0,9999,1
1668206998161,ECE 200,023,103608,Lo; Yu-Hwa,9999,0,9999,0
1668206998161,ECE 200,024,103609,Lomakin; Vitaliy,9999,0,9999,0
1668206998161,ECE 200,025,103610,Mercier; Patrick Philip,9999,0,9999,0
1668206998161,ECE 200,026,103611,Meyer; Florian,9999,0,9999,0
1668206998161,ECE 200,027,103612,Milstein; Laurence B.,9999,0,9999,0
1668206998161,ECE 200,028,103613,Mir Arabbaygi; Siavash,9999,0,9999,0
1668206998161,ECE 200,029,103614,Mookherjea; Shayan,9999,0,9999,0
1668206998161,ECE 200,030,103615,Morris; Karcher William,9999,0,9999,0
1668206998161,ECE 200,031,103616,Ng; Tse Nga,9999,0,9999,0
1668206998161,ECE 200,032,103617,Nguyen; Truong Quang,9999,0,9999,0
1668206998161,ECE 200,033,103618,Nomura; Kenji,9999,0,9999,0
1668206998161,ECE 200,034,103619,Orlitsky; Alon,9999,0,9999,0
1668206998161,ECE 200,035,103620,Pal; Piya,9999,0,9999,0
1668206998161,ECE 200,036,103621,Papen; George C.,9999,0,9999,0
1668206998161,ECE 200,037,103622,Radic; Stojan,9999,0,9999,0
1668206998161,ECE 200,038,103623,Rao; Bhaskar D.,9999,0,9999,0
1668206998161,ECE 200,039,103624,Rao; Ramesh R,9999,0,9999,0
1668206998161,ECE 200,040,103625,Rebeiz; Gabriel,9999,0,9999,0
1668206998161,ECE 200,041,103626,Sanford; John R,9999,0,9999,0
1668206998161,ECE 200,042,103627,Siegel; Paul H.,9999,0,9999,0
1668206998161,ECE 200,043,103628,Sievenpiper; Daniel F.,9999,0,9999,0
1668206998161,ECE 200,044,103629,Sworder; David D.,9999,0,9999,0
1668206998161,ECE 200,045,103630,Taur; Yuan,9999,0,9999,0
1668206998161,ECE 200,046,103631,Touri; Behrouz,9999,0,9999,0
1668206998161,ECE 200,047,103632,Trivedi; Mohan M.,9999,0,9999,0
1668206998161,ECE 200,048,103633,Vasconcelos; Nuno,9999,0,9999,0
1668206998161,ECE 200,049,103634,Wang; Xiaolong,9999,0,9999,0
1668206998161,ECE 200,050,103635,Xie; Pengtao,9999,0,9999,0
1668206998161,ECE 200,051,103636,Yip; Michael,9999,0,9999,0
1668206998161,ECE 200,052,103637,Zeger; Kenneth A.,999,0,999,0
1668206998161,ECE 200,053,103638,Zhang; Xinyu,9999,0,9999,0
1668206998161,ECE 200,054,103639,Turakhia; Yatish Girish,9999,0,9999,0
1668206998161,ECE 200,055,103640,Kang; Mingu,9999,0,9999,0
1668206998161,ECE 200,056,103641,Shi; Yuanyuan,9999,0,9999,0
1668206998161,ECE 200,057,103642,Wang; Edward Jay,9999,0,9999,0
1668206998161,ECE 200,058,103643,Zheng; Yang,9999,0,9999,0
1668206998679,ECE 202,A00,103644,Kuzum; Duygu,0,0,0,0
1668206999103,ECE 212BN,A00,103646,Ng; Tse Nga,0,0,0,0
1668206999525,ECE 221,A00,111493,Staff,0,0,0,0
1668206999949,ECE 222B,A00,103647,Lomakin; Vitaliy,0,0,0,0
1668207001294,ECE 230B,A00,103648,Taur; Yuan,0,0,0,0
1668207001725,ECE 238B,A00,103649,Garay; Javier,0,0,0,0
1668207002150,ECE 240B,A00,112900,Fainman; Yeshaiahu,0,0,0,0
1668207002577,ECE 247A,A00,103650,Jokerst; Jesse Vincent,0,0,0,0
1668207003002,ECE 247B,A00,103651,Wang; Joseph,0,0,0,0
1668207003426,ECE 250,A00,103652,Siegel; Paul H.,0,0,0,0
1668207003856,ECE 251A,A00,103654,Rao; Bhaskar D.,0,0,0,0
1668207004281,ECE 257B,A00,103655,Bharadia; Dinesh,0,0,0,0
1668207004718,ECE 258A,A00,103656,Milstein; Laurence B.,0,0,0,0
1668207005142,ECE 260B,A00,103658,Kang; Mingu,0,0,0,0
1668207005566,ECE 264A,A00,103659,Galton; Ian A,0,0,0,0
1668207005990,ECE 265A,A00,103661,Gudem; Prasad S.S.,0,0,0,0
1668207006419,ECE 265D,A00,103662,Gudem; Prasad S.S.,0,0,0,0
1668207006842,ECE 268,A00,103663,Koushanfar; Farinaz,0,0,0,0
1668207007271,ECE 269,A01,103665,Pal; Piya,0,0,0,0
1668207007700,ECE 271B,A00,103666,Vasconcelos; Manuela,0,0,0,0
1668207008124,ECE 276A,A00,103667,Atanasov; Nikolay A.,0,0,0,0
1668207008553,ECE 277,A00,103668,An; Cheolhong,0,0,0,0
1668207008977,ECE 279,A00,117947,Hall; Drew A.,0,0,0,0
1668207009826,ECE 283,A00,103670,Hsueh; Tzu-Chien,0,0,0,0
1668207010252,ECE 284,A00,103671,Turakhia; Yatish Girish,0,0,0,0
1668207010683,ECE 285,A00,103672,Zheng; Yang,0,0,0,0
1668207010683,ECE 285,B00,103673,Sworder; David D.,0,0,0,0
1668207011108,ECE 287,A00,103676,Javidi; Tara,0,0,0,0
1668207011533,MATH 200B,A00,098023,Salehi Golsefidy; Alireza,12,0,15,3
1668207011958,MATH 202B,A00,098024,Rhoades; Brendon Patrick,9,0,15,6
1668207012382,MATH 203B,A00,098025,Oprea; Dragos N.,10,0,15,5
1668207012804,MATH 204B,A00,098026,Sorensen; Claus M,13,0,15,2
1668207013227,MATH 208,A00,098027,Izadi; Elham,7,0,10,3
1668207013650,MATH 209,A00,098028,Pollack; Aaron,10,0,10,0
1668207014073,MATH 211A,A00,112919,Rogalski; Daniel,9,0,10,1
1668207014625,MATH 211B,A00,112920,Seward; Brandon M.,9,0,10,1
1668207015050,MATH 218,A00,098029,Li; Bo,10,0,10,0
1668207015480,MATH 220B,A00,098030,Novak; Jonathan I,11,0,15,4
1668207015909,MATH 221A,A00,098031,Ebenfelt; Peter F,13,0,15,2
1668207016333,MATH 231B,A00,098032,Zlatos; Andrej,12,0,15,3
1668207016769,MATH 240B,A00,098033,Ni; Lei,9,0,15,6
1668207017193,MATH 243,A00,098034,Jekel; David Andrew,10,0,10,0
1668207017615,MATH 245A,A00,098035,Nie; Jiawang,0,0,15,16
1668207018042,MATH 248,A00,098036,Bejenaru; Ioan,10,0,10,0
1668207018467,MATH 250B,A00,098037,Spolaor; Luca,14,0,15,1
1668207018891,MATH 258,A00,098038,Ni; Lei,10,0,10,0
1668207019323,MATH 264B,A00,098041,Rhoades; Brendon Patrick,9,0,15,6
1668207019747,MATH 268,A00,098042,Buss; Samuel R,10,0,10,0
1668207020174,MATH 269,A00,098043,Rhoades; Brendon Patrick,10,0,10,0
1668207020599,MATH 270B,A00,098044,Li; Bo,10,0,15,5
1668207021026,MATH 272B,A00,098045,Holst; Michael J,13,0,15,2
1668207021448,MATH 273A,A00,098046,Tian; Xiaochuan,10,0,15,5
1668207021879,MATH 275,A01,098048,Tian; Xiaochuan,6,0,10,4
1668207022303,MATH 278A,A00,098049,Holst; Michael J,8,0,10,2
1668207022740,MATH 278B,A00,098050,Cloninger; Alexander,10,0,10,0
1668207023166,MATH 278C,A00,098051,Nie; Jiawang,7,0,10,3
1668207023592,MATH 280B,A00,098052,Zheng; Tianyi,10,0,15,5
1668207024016,MATH 281B,A00,098053,Bradic; Jelena,2,0,15,13
1668207024439,MATH 282B,A00,098054,Arias-Castro; Ery,0,0,15,15
1668207024867,MATH 285,A00,098055,Fitzsimmons; Patrick J,0,0,15,17
1668207025293,MATH 287B,A00,098056,Arias-Castro; Ery,2,0,15,13
1668207025716,MATH 288,A00,098057,Agarwal; Pooja,9,0,10,1
1668207025716,MATH 288,B00,098058,Zhang; Danna,8,0,10,2
1668207025716,MATH 288,C00,098059,Williams; Ruth J,10,0,10,0
1668207026141,MATH 290B,A00,098060,Roberts; Justin Deritter,13,0,15,2
1668207026570,MATH 292,A00,098061,Belmont; Eva Kinoshita,10,0,10,0
1668207027000,MATH 295,A00,098062,Suk; Andrew Hoon,48,0,50,2
1668207027426,MATH 296,A00,098063,Novak; Jonathan I,20,0,20,0
1668207027853,MATH 297,001,098064,Gamst; Anthony Collins,9997,0,9999,2
1668207538636,COGS 205,A00,101395,Chiba; Andrea,19,0,20,1
1668207539067,COGS 210B,001,101404,Greene; Deanna Jacquelyn,9998,0,9999,1
1668207539067,COGS 210B,002,101417,Xia; Haijun,9999,0,9999,0
1668207539067,COGS 210B,003,101422,Nitz; Douglas A.,9999,0,9999,0
1668207539067,COGS 210B,004,101423,Hollan; James D.,9998,0,9999,1
1668207539067,COGS 210B,005,101424,Deak; Gedeon O.,9998,0,9999,1
1668207539067,COGS 210B,006,101425,Rossano; Federico,9999,0,9999,0
1668207539493,COGS 211B,A00,101427,Coulson; Seana M,9996,0,9999,3
1668207539918,COGS 220,A00,101428,Hollan; James D.,0,0,25,25
1668207540349,COGS 229,A00,101429,Dow; Steven P,18,0,25,7
1668207540783,COGS 230,A00,101430,Klemmer; Scott R,12,0,17,5
1668207541216,COGS 234,A00,101431,Xia; Haijun,2,0,25,23
1668207541650,COGS 260,A00,101432,Kiyonaga; Anastasia,21,0,25,4
1668207541650,COGS 260,B00,101433,Kirsh; David Joel,16,0,25,9
1668207542076,CSE 202,A00,102371,Impagliazzo; Russell,0,0,0,0
1668207542501,CSE 203B,A01,102373,Cheng; Chung Kuan,0,0,0,0
1668207542926,CSE 208,A00,102374,Micciancio; Daniele,0,0,0,0
1668207543352,CSE 209A,A00,112895,Impagliazzo; Russell,0,0,15,15
1668207543774,CSE 209B,A00,108005,Bellare; Mihir,0,0,0,0
1668207544199,CSE 210,A00,113163,Coblenz; Michael J,0,0,0,0
1668207544627,CSE 219,A00,106111,Dow; Steven P,0,0,20,20
1668207545065,CSE 221,A00,102376,Voelker; Geoffrey M.,0,0,0,0
1668207545487,CSE 224,A01,102378,Porter; George M,0,0,0,0
1668207545912,CSE 229A,A00,102379,Savage; Stefan,0,0,0,0
1668207546347,CSE 229C,A00,102380,Munyaka; Imani N. S.,0,0,0,0
1668207546779,CSE 232B,A00,102382,Deutsch; Alin Bernard,0,0,0,0
1668207547206,CSE 234,A01,112904,Kumar; Arun Kumar,0,0,0,0
1668207547633,CSE 237A,A00,102383,Rosing; Tajana Simunic,0,0,0,0
1668207548059,CSE 239A,A00,102384,Deutsch; Alin Bernard,0,0,0,0
1668207548482,CSE 239B,A00,102385,Polikarpova; Nadezhda,0,0,0,0
1668207548904,CSE 240A,A00,102386,Pannuto; Patrick William,0,0,0,0
1668207549329,CSE 240B,A00,102387,Zhao; Jishen,0,0,0,0
1668207549754,CSE 241A,A00,106406,Kang; Mingu,0,0,0,0
1668207550178,CSE 249B,A00,102388,Kahng; Andrew Byun,0,0,8,8
1668207550611,CSE 251B,A01,102392,Cottrell; Garrison W,0,0,0,0
1668207550611,CSE 251B,A02,102393,Cottrell; Garrison W,0,0,0,0
1668207551046,CSE 252B,A00,102394,Ochoa; Benjamin Lawrence,0,0,0,0
1668207551482,CSE 257,A01,102396,Gao; Sicun,0,0,0,0
1668207551910,CSE 272,A00,102397,Li; Tzumao,0,0,0,0
1668207552337,CSE 274,A00,111323,Chern; Albert Ren-Haur,0,0,0,0
1668207552761,CSE 282,A00,102398,Pevzner; Pavel Arkadjevich,0,0,0,0
1668207553187,CSE 284,A00,114175,Gymrek; Melissa Ann,0,0,0,0
1668207553620,CSE 290,A00,102399,Chandraker; Manmohan Krishna,0,0,0,0
1668207553620,CSE 290,B00,102400,Vaccaro; Kristen Marie,0,0,25,25
1668207553620,CSE 290,C00,102414,Pannuto; Patrick William,0,0,25,25
1668207553620,CSE 290,D00,102427,Pevzner; Pavel Arkadjevich,0,0,0,0
1668207553620,CSE 290,E00,102429,Zhao; Jishen,0,0,0,0
1668207553620,CSE 290,F00,102436,Tullsen; Dean Michael,0,0,0,0
1668207553620,CSE 290,G00,102440,Christensen; Henrik I,0,0,20,20
1668207554043,CSE 291,A00,102443,Su; Hao,0,0,0,0
1668207554043,CSE 291,B00,102448,Polikarpova; Nadezhda,0,0,0,0
1668207554043,CSE 291,C00,102453,Vaccaro; Kristen Marie,0,0,0,0
1668207554043,CSE 291,D00,111343,Savage; Stefan,0,0,0,0
1668207554043,CSE 291,E00,116474,Claffy; Kimberly Claire,0,0,0,0
1668207554043,CSE 291,F00,116479,Pasquale; Joseph,0,0,0,0
1668207554469,CSE 293,001,119111,Bafna; Vineet,9999,0,9999,0
1668207554469,CSE 293,002,119118,Bellare; Mihir,9999,0,9999,0
1668207554469,CSE 293,003,119122,Berg-Kirkpatrick; Taylor D,9999,0,9999,0
1668207554469,CSE 293,004,119135,Christensen; Henrik I,9999,0,9999,0
1668207554469,CSE 293,005,119142,Cottrell; Garrison W,9999,0,9999,0
1668207554469,CSE 293,006,119146,Deutsch; Alin Bernard,9999,0,9999,0
1668207554469,CSE 293,007,119159,Esmaeilzadeh; Hadi,9999,0,9999,0
1668207554469,CSE 293,008,119166,Freund; Yoav,9999,0,9999,0
1668207554469,CSE 293,009,119170,Griswold; William G.,9999,0,9999,0
1668207554469,CSE 293,010,119183,Gymrek; Melissa Ann,9999,0,9999,0
1668207554469,CSE 293,011,119190,Heninger; Nadia A,9999,0,9999,0
1668207554469,CSE 293,012,119230,Impagliazzo; Russell,9999,0,9999,0
1668207554469,CSE 293,013,119232,Jhala; Ranjit,9999,0,9999,0
1668207554469,CSE 293,014,119233,Kahng; Andrew Byun,9999,0,9999,0
1668207554469,CSE 293,015,119298,Kane; Daniel Mertz,9999,0,9999,0
1668207554469,CSE 293,016,119299,Kriegman; David J,9999,0,9999,0
1668207554469,CSE 293,017,119300,Kumar; Arun Kumar,9999,0,9999,0
1668207554469,CSE 293,018,119301,Lerner; Sorin,9999,0,9999,0
1668207554469,CSE 293,019,119302,Lovett; Shachar,9999,0,9999,0
1668207554469,CSE 293,020,119303,McAuley; Julian John,9999,0,9999,0
1668207554469,CSE 293,021,119304,Micciancio; Daniele,9999,0,9999,0
1668207554469,CSE 293,022,119367,Orailoglu; Alex,9999,0,9999,0
1668207554469,CSE 293,023,119382,Paturi; Ramamohan,9999,0,9999,0
1668207554469,CSE 293,024,119404,Polikarpova; Nadezhda,9999,0,9999,0
1668207554469,CSE 293,025,119406,Politz; Joseph Gibbs,9999,0,9999,0
1668207554469,CSE 293,026,119411,Porter; George M,9999,0,9999,0
1668207554469,CSE 293,027,119414,Porter; Leonard Emerson,9999,0,9999,0
1668207554469,CSE 293,028,119416,Ramamoorthi; Ravi,9999,0,9999,0
1668207554469,CSE 293,029,119417,Sahoo; Debashis,9999,0,9999,0
1668207554469,CSE 293,030,119420,Saul; Lawrence,9999,0,9999,0
1668207554469,CSE 293,031,119421,Savage; Stefan,9999,0,9999,0
1668207554469,CSE 293,032,119425,Schulze; Jurgen P.,9999,0,9999,0
1668207554469,CSE 293,033,119426,Snoeren; Alex C.,9999,0,9999,0
1668207554469,CSE 293,034,119428,Shang; Jingbo,9999,0,9999,0
1668207554469,CSE 293,035,119430,Stefan; Deian,9999,0,9999,0
1668207554469,CSE 293,036,119431,Su; Hao,9999,0,9999,0
1668207554469,CSE 293,037,119433,Swanson; Steven James,9999,0,9999,0
1668207554469,CSE 293,038,119435,Tullsen; Dean Michael,9999,0,9999,0
1668207554469,CSE 293,039,119483,Voelker; Geoffrey M.,9999,0,9999,0
1668207554469,CSE 293,040,119537,Zhao; Jishen,9999,0,9999,0
1668207554469,CSE 293,041,119538,Zhou; Yuan-Yuan,9999,0,9999,0
1668207554469,CSE 293,042,119539,Gao; Sicun,9999,0,9999,0
1668207554469,CSE 293,043,119540,Weibel; Nadir,9999,0,9999,0
1668207554469,CSE 293,044,119541,Gupta; Rajesh K.,9999,0,9999,0
1668207554469,CSE 293,045,126410,Vaccaro; Kristen Marie,9999,0,9999,0
1668207554469,CSE 293,046,126411,Klemke; Richard,9999,0,9999,0
1668207554898,CSE 294,A00,102459,Voelker; Geoffrey M.,0,0,0,0
1668207554898,CSE 294,B00,111322,Orailoglu; Alex,0,0,0,0
1668207555325,DSE 201,A00,096914,Deutsch; Alin Bernard,30,0,30,0
1668207555747,DSE 210,A00,096915,Dasgupta; Sanjoy,30,0,30,0
1668207556187,DSE 260A,A00,096916,Altintas De Callaf; Ilkay,30,0,30,0
1668207556645,ECE 200,001,103586,Antipa; Nicholas A,9999,0,9999,0
1668207556645,ECE 200,002,103587,Atanasov; Nikolay A.,9999,0,9999,0
1668207556645,ECE 200,003,103588,Bharadia; Dinesh,9999,0,9999,0
1668207556645,ECE 200,004,103589,Cheng; Chung Kuan,9999,0,9999,0
1668207556645,ECE 200,005,103590,Cosman; Pamela C.,9999,0,9999,0
1668207556645,ECE 200,006,103591,Dayeh; Shadi Ahmad,9999,0,9999,0
1668207556645,ECE 200,007,103592,Fainman; Yeshaiahu,9999,0,9999,0
1668207556645,ECE 200,008,103593,Ford; Joseph Earl,9999,0,9999,0
1668207556645,ECE 200,009,103594,Franceschetti; Massimo,9999,0,9999,0
1668207556645,ECE 200,010,103595,Fullerton; Eric E,9999,0,9999,0
1668207556645,ECE 200,011,103596,Galton; Ian A,9999,0,9999,0
1668207556645,ECE 200,012,103597,Gilja; Vikash,9999,0,9999,0
1668207556645,ECE 200,013,103598,Hall; Drew A.,9999,0,9999,0
1668207556645,ECE 200,014,103599,Hsueh; Tzu-Chien,9999,0,9999,0
1668207556645,ECE 200,015,103600,Javidi; Tara,9999,0,9999,0
1668207556645,ECE 200,016,103601,Kahng; Andrew Byun,9999,0,9999,0
1668207556645,ECE 200,017,103602,Kim; Young-Han,9999,0,9999,0
1668207556645,ECE 200,018,103603,Koushanfar; Farinaz,9999,0,9999,0
1668207556645,ECE 200,019,103604,Kuzum; Duygu,9999,0,9999,0
1668207556645,ECE 200,020,103605,Le; Hanh-Phuc,9999,0,9999,0
1668207556645,ECE 200,021,103606,Lin; Bill,9999,0,9999,0
1668207556645,ECE 200,022,103607,Liu; Zhaowei,9998,0,9999,1
1668207556645,ECE 200,023,103608,Lo; Yu-Hwa,9999,0,9999,0
1668207556645,ECE 200,024,103609,Lomakin; Vitaliy,9999,0,9999,0
1668207556645,ECE 200,025,103610,Mercier; Patrick Philip,9999,0,9999,0
1668207556645,ECE 200,026,103611,Meyer; Florian,9999,0,9999,0
1668207556645,ECE 200,027,103612,Milstein; Laurence B.,9999,0,9999,0
1668207556645,ECE 200,028,103613,Mir Arabbaygi; Siavash,9999,0,9999,0
1668207556645,ECE 200,029,103614,Mookherjea; Shayan,9999,0,9999,0
1668207556645,ECE 200,030,103615,Morris; Karcher William,9999,0,9999,0
1668207556645,ECE 200,031,103616,Ng; Tse Nga,9999,0,9999,0
1668207556645,ECE 200,032,103617,Nguyen; Truong Quang,9999,0,9999,0
1668207556645,ECE 200,033,103618,Nomura; Kenji,9999,0,9999,0
1668207556645,ECE 200,034,103619,Orlitsky; Alon,9999,0,9999,0
1668207556645,ECE 200,035,103620,Pal; Piya,9999,0,9999,0
1668207556645,ECE 200,036,103621,Papen; George C.,9999,0,9999,0
1668207556645,ECE 200,037,103622,Radic; Stojan,9999,0,9999,0
1668207556645,ECE 200,038,103623,Rao; Bhaskar D.,9999,0,9999,0
1668207556645,ECE 200,039,103624,Rao; Ramesh R,9999,0,9999,0
1668207556645,ECE 200,040,103625,Rebeiz; Gabriel,9999,0,9999,0
1668207556645,ECE 200,041,103626,Sanford; John R,9999,0,9999,0
1668207556645,ECE 200,042,103627,Siegel; Paul H.,9999,0,9999,0
1668207556645,ECE 200,043,103628,Sievenpiper; Daniel F.,9999,0,9999,0
1668207556645,ECE 200,044,103629,Sworder; David D.,9999,0,9999,0
1668207556645,ECE 200,045,103630,Taur; Yuan,9999,0,9999,0
1668207556645,ECE 200,046,103631,Touri; Behrouz,9999,0,9999,0
1668207556645,ECE 200,047,103632,Trivedi; Mohan M.,9999,0,9999,0
1668207556645,ECE 200,048,103633,Vasconcelos; Nuno,9999,0,9999,0
1668207556645,ECE 200,049,103634,Wang; Xiaolong,9999,0,9999,0
1668207556645,ECE 200,050,103635,Xie; Pengtao,9999,0,9999,0
1668207556645,ECE 200,051,103636,Yip; Michael,9999,0,9999,0
1668207556645,ECE 200,052,103637,Zeger; Kenneth A.,999,0,999,0
1668207556645,ECE 200,053,103638,Zhang; Xinyu,9999,0,9999,0
1668207556645,ECE 200,054,103639,Turakhia; Yatish Girish,9999,0,9999,0
1668207556645,ECE 200,055,103640,Kang; Mingu,9999,0,9999,0
1668207556645,ECE 200,056,103641,Shi; Yuanyuan,9999,0,9999,0
1668207556645,ECE 200,057,103642,Wang; Edward Jay,9999,0,9999,0
1668207556645,ECE 200,058,103643,Zheng; Yang,9999,0,9999,0
1668207557072,ECE 202,A00,103644,Kuzum; Duygu,0,0,0,0
1668207557496,ECE 212BN,A00,103646,Ng; Tse Nga,0,0,0,0
1668207557931,ECE 221,A00,111493,Staff,0,0,0,0
1668207558353,ECE 222B,A00,103647,Lomakin; Vitaliy,0,0,0,0
1668207558779,ECE 230B,A00,103648,Taur; Yuan,0,0,0,0
1668207559202,ECE 238B,A00,103649,Garay; Javier,0,0,0,0
1668207559632,ECE 240B,A00,112900,Fainman; Yeshaiahu,0,0,0,0
1668207560054,ECE 247A,A00,103650,Jokerst; Jesse Vincent,0,0,0,0
1668207560479,ECE 247B,A00,103651,Wang; Joseph,0,0,0,0
1668207560905,ECE 250,A00,103652,Siegel; Paul H.,0,0,0,0
1668207561337,ECE 251A,A00,103654,Rao; Bhaskar D.,0,0,0,0
1668207561761,ECE 257B,A00,103655,Bharadia; Dinesh,0,0,0,0
1668207562183,ECE 258A,A00,103656,Milstein; Laurence B.,0,0,0,0
1668207562610,ECE 260B,A00,103658,Kang; Mingu,0,0,0,0
1668207563037,ECE 264A,A00,103659,Galton; Ian A,0,0,0,0
1668207563468,ECE 265A,A00,103661,Gudem; Prasad S.S.,0,0,0,0
1668207563889,ECE 265D,A00,103662,Gudem; Prasad S.S.,0,0,0,0
1668207564311,ECE 268,A00,103663,Koushanfar; Farinaz,0,0,0,0
1668207564737,ECE 269,A01,103665,Pal; Piya,0,0,0,0
1668207565160,ECE 271B,A00,103666,Vasconcelos; Manuela,0,0,0,0
1668207565586,ECE 276A,A00,103667,Atanasov; Nikolay A.,0,0,0,0
1668207566009,ECE 277,A00,103668,An; Cheolhong,0,0,0,0
1668207566436,ECE 279,A00,117947,Hall; Drew A.,0,0,0,0
1668207567285,ECE 283,A00,103670,Hsueh; Tzu-Chien,0,0,0,0
1668207567709,ECE 284,A00,103671,Turakhia; Yatish Girish,0,0,0,0
1668207568247,ECE 285,A00,103672,Zheng; Yang,0,0,0,0
1668207568247,ECE 285,B00,103673,Sworder; David D.,0,0,0,0
1668207568678,ECE 287,A00,103676,Javidi; Tara,0,0,0,0
1668207569104,MATH 200B,A00,098023,Salehi Golsefidy; Alireza,12,0,15,3
1668207569528,MATH 202B,A00,098024,Rhoades; Brendon Patrick,9,0,15,6
1668207569954,MATH 203B,A00,098025,Oprea; Dragos N.,10,0,15,5
1668207570379,MATH 204B,A00,098026,Sorensen; Claus M,13,0,15,2
1668207570802,MATH 208,A00,098027,Izadi; Elham,7,0,10,3
1668207571227,MATH 209,A00,098028,Pollack; Aaron,10,0,10,0
1668207571650,MATH 211A,A00,112919,Rogalski; Daniel,9,0,10,1
1668207572076,MATH 211B,A00,112920,Seward; Brandon M.,9,0,10,1
1668207572500,MATH 218,A00,098029,Li; Bo,10,0,10,0
1668207572933,MATH 220B,A00,098030,Novak; Jonathan I,11,0,15,4
1668207573358,MATH 221A,A00,098031,Ebenfelt; Peter F,13,0,15,2
1668207573856,MATH 231B,A00,098032,Zlatos; Andrej,12,0,15,3
1668207574281,MATH 240B,A00,098033,Ni; Lei,9,0,15,6
1668207574712,MATH 243,A00,098034,Jekel; David Andrew,10,0,10,0
1668207575136,MATH 245A,A00,098035,Nie; Jiawang,0,0,15,16
1668207575558,MATH 248,A00,098036,Bejenaru; Ioan,10,0,10,0
1668207575982,MATH 250B,A00,098037,Spolaor; Luca,14,0,15,1
1668207576408,MATH 258,A00,098038,Ni; Lei,10,0,10,0
1668207576840,MATH 264B,A00,098041,Rhoades; Brendon Patrick,9,0,15,6
1668207577270,MATH 268,A00,098042,Buss; Samuel R,10,0,10,0
1668207577700,MATH 269,A00,098043,Rhoades; Brendon Patrick,10,0,10,0
1668207578122,MATH 270B,A00,098044,Li; Bo,10,0,15,5
1668207578547,MATH 272B,A00,098045,Holst; Michael J,13,0,15,2
1668207578981,MATH 273A,A00,098046,Tian; Xiaochuan,10,0,15,5
1668207579406,MATH 275,A01,098048,Tian; Xiaochuan,6,0,10,4
1668207579829,MATH 278A,A00,098049,Holst; Michael J,8,0,10,2
1668207580255,MATH 278B,A00,098050,Cloninger; Alexander,10,0,10,0
1668207580687,MATH 278C,A00,098051,Nie; Jiawang,7,0,10,3
1668207581111,MATH 280B,A00,098052,Zheng; Tianyi,10,0,15,5
1668207581540,MATH 281B,A00,098053,Bradic; Jelena,2,0,15,13
1668207581972,MATH 282B,A00,098054,Arias-Castro; Ery,0,0,15,15
1668207582393,MATH 285,A00,098055,Fitzsimmons; Patrick J,0,0,15,17
1668207582832,MATH 287B,A00,098056,Arias-Castro; Ery,2,0,15,13
1668207583259,MATH 288,A00,098057,Agarwal; Pooja,9,0,10,1
1668207583259,MATH 288,B00,098058,Zhang; Danna,8,0,10,2
1668207583259,MATH 288,C00,098059,Williams; Ruth J,10,0,10,0
1668207583682,MATH 290B,A00,098060,Roberts; Justin Deritter,13,0,15,2
1668207584105,MATH 292,A00,098061,Belmont; Eva Kinoshita,10,0,10,0
1668207584528,MATH 295,A00,098062,Suk; Andrew Hoon,48,0,50,2
1668207584954,MATH 296,A00,098063,Novak; Jonathan I,20,0,20,0
1668207585379,MATH 297,001,098064,Gamst; Anthony Collins,9997,0,9999,2
1668208087601,COGS 205,A00,101395,Chiba; Andrea,19,0,20,1
1668208088029,COGS 210B,001,101404,Greene; Deanna Jacquelyn,9998,0,9999,1
1668208088029,COGS 210B,002,101417,Xia; Haijun,9999,0,9999,0
1668208088029,COGS 210B,003,101422,Nitz; Douglas A.,9999,0,9999,0
1668208088029,COGS 210B,004,101423,Hollan; James D.,9998,0,9999,1
1668208088029,COGS 210B,005,101424,Deak; Gedeon O.,9998,0,9999,1
1668208088029,COGS 210B,006,101425,Rossano; Federico,9999,0,9999,0
1668208088452,COGS 211B,A00,101427,Coulson; Seana M,9996,0,9999,3
1668208088877,COGS 220,A00,101428,Hollan; James D.,0,0,25,25
1668208089315,COGS 229,A00,101429,Dow; Steven P,18,0,25,7
1668208089738,COGS 230,A00,101430,Klemmer; Scott R,12,0,17,5
1668208090171,COGS 234,A00,101431,Xia; Haijun,2,0,25,23
1668208090596,COGS 260,A00,101432,Kiyonaga; Anastasia,21,0,25,4
1668208090596,COGS 260,B00,101433,Kirsh; David Joel,16,0,25,9
1668208091022,CSE 202,A00,102371,Impagliazzo; Russell,0,0,0,0
1668208091457,CSE 203B,A01,102373,Cheng; Chung Kuan,0,0,0,0
1668208091883,CSE 208,A00,102374,Micciancio; Daniele,0,0,0,0
1668208092329,CSE 209A,A00,112895,Impagliazzo; Russell,0,0,15,15
1668208092751,CSE 209B,A00,108005,Bellare; Mihir,0,0,0,0
1668208093176,CSE 210,A00,113163,Coblenz; Michael J,0,0,0,0
1668208093601,CSE 219,A00,106111,Dow; Steven P,0,0,20,20
1668208094024,CSE 221,A00,102376,Voelker; Geoffrey M.,0,0,0,0
1668208094448,CSE 224,A01,102378,Porter; George M,0,0,0,0
1668208094874,CSE 229A,A00,102379,Savage; Stefan,0,0,0,0
1668208095309,CSE 229C,A00,102380,Munyaka; Imani N. S.,0,0,0,0
1668208095731,CSE 232B,A00,102382,Deutsch; Alin Bernard,0,0,0,0
1668208096241,CSE 234,A01,112904,Kumar; Arun Kumar,0,0,0,0
1668208096665,CSE 237A,A00,102383,Rosing; Tajana Simunic,0,0,0,0
1668208097086,CSE 239A,A00,102384,Deutsch; Alin Bernard,0,0,0,0
1668208097509,CSE 239B,A00,102385,Polikarpova; Nadezhda,0,0,0,0
1668208097938,CSE 240A,A00,102386,Pannuto; Patrick William,0,0,0,0
1668208098373,CSE 240B,A00,102387,Zhao; Jishen,0,0,0,0
1668208098801,CSE 241A,A00,106406,Kang; Mingu,0,0,0,0
1668208099227,CSE 249B,A00,102388,Kahng; Andrew Byun,0,0,8,8
1668208099654,CSE 251B,A01,102392,Cottrell; Garrison W,0,0,0,0
1668208099654,CSE 251B,A02,102393,Cottrell; Garrison W,0,0,0,0
1668208100084,CSE 252B,A00,102394,Ochoa; Benjamin Lawrence,0,0,0,0
1668208100517,CSE 257,A01,102396,Gao; Sicun,0,0,0,0
1668208100951,CSE 272,A00,102397,Li; Tzumao,0,0,0,0
1668208101383,CSE 274,A00,111323,Chern; Albert Ren-Haur,0,0,0,0
1668208101804,CSE 282,A00,102398,Pevzner; Pavel Arkadjevich,0,0,0,0
1668208102227,CSE 284,A00,114175,Gymrek; Melissa Ann,0,0,0,0
1668208102652,CSE 290,A00,102399,Chandraker; Manmohan Krishna,0,0,0,0
1668208102652,CSE 290,B00,102400,Vaccaro; Kristen Marie,0,0,25,25
1668208102652,CSE 290,C00,102414,Pannuto; Patrick William,0,0,25,25
1668208102652,CSE 290,D00,102427,Pevzner; Pavel Arkadjevich,0,0,0,0
1668208102652,CSE 290,E00,102429,Zhao; Jishen,0,0,0,0
1668208102652,CSE 290,F00,102436,Tullsen; Dean Michael,0,0,0,0
1668208102652,CSE 290,G00,102440,Christensen; Henrik I,0,0,20,20
1668208103094,CSE 291,A00,102443,Su; Hao,0,0,0,0
1668208103094,CSE 291,B00,102448,Polikarpova; Nadezhda,0,0,0,0
1668208103094,CSE 291,C00,102453,Vaccaro; Kristen Marie,0,0,0,0
1668208103094,CSE 291,D00,111343,Savage; Stefan,0,0,0,0
1668208103094,CSE 291,E00,116474,Claffy; Kimberly Claire,0,0,0,0
1668208103094,CSE 291,F00,116479,Pasquale; Joseph,0,0,0,0
1668208103542,CSE 293,001,119111,Bafna; Vineet,9999,0,9999,0
1668208103542,CSE 293,002,119118,Bellare; Mihir,9999,0,9999,0
1668208103542,CSE 293,003,119122,Berg-Kirkpatrick; Taylor D,9999,0,9999,0
1668208103542,CSE 293,004,119135,Christensen; Henrik I,9999,0,9999,0
1668208103542,CSE 293,005,119142,Cottrell; Garrison W,9999,0,9999,0
1668208103542,CSE 293,006,119146,Deutsch; Alin Bernard,9999,0,9999,0
1668208103542,CSE 293,007,119159,Esmaeilzadeh; Hadi,9999,0,9999,0
1668208103542,CSE 293,008,119166,Freund; Yoav,9999,0,9999,0
1668208103542,CSE 293,009,119170,Griswold; William G.,9999,0,9999,0
1668208103542,CSE 293,010,119183,Gymrek; Melissa Ann,9999,0,9999,0
1668208103542,CSE 293,011,119190,Heninger; Nadia A,9999,0,9999,0
1668208103542,CSE 293,012,119230,Impagliazzo; Russell,9999,0,9999,0
1668208103542,CSE 293,013,119232,Jhala; Ranjit,9999,0,9999,0
1668208103542,CSE 293,014,119233,Kahng; Andrew Byun,9999,0,9999,0
1668208103542,CSE 293,015,119298,Kane; Daniel Mertz,9999,0,9999,0
1668208103542,CSE 293,016,119299,Kriegman; David J,9999,0,9999,0
1668208103542,CSE 293,017,119300,Kumar; Arun Kumar,9999,0,9999,0
1668208103542,CSE 293,018,119301,Lerner; Sorin,9999,0,9999,0
1668208103542,CSE 293,019,119302,Lovett; Shachar,9999,0,9999,0
1668208103542,CSE 293,020,119303,McAuley; Julian John,9999,0,9999,0
1668208103542,CSE 293,021,119304,Micciancio; Daniele,9999,0,9999,0
1668208103542,CSE 293,022,119367,Orailoglu; Alex,9999,0,9999,0
1668208103542,CSE 293,023,119382,Paturi; Ramamohan,9999,0,9999,0
1668208103542,CSE 293,024,119404,Polikarpova; Nadezhda,9999,0,9999,0
1668208103542,CSE 293,025,119406,Politz; Joseph Gibbs,9999,0,9999,0
1668208103542,CSE 293,026,119411,Porter; George M,9999,0,9999,0
1668208103542,CSE 293,027,119414,Porter; Leonard Emerson,9999,0,9999,0
1668208103542,CSE 293,028,119416,Ramamoorthi; Ravi,9999,0,9999,0
1668208103542,CSE 293,029,119417,Sahoo; Debashis,9999,0,9999,0
1668208103542,CSE 293,030,119420,Saul; Lawrence,9999,0,9999,0
1668208103542,CSE 293,031,119421,Savage; Stefan,9999,0,9999,0
1668208103542,CSE 293,032,119425,Schulze; Jurgen P.,9999,0,9999,0
1668208103542,CSE 293,033,119426,Snoeren; Alex C.,9999,0,9999,0
1668208103542,CSE 293,034,119428,Shang; Jingbo,9999,0,9999,0
1668208103542,CSE 293,035,119430,Stefan; Deian,9999,0,9999,0
1668208103542,CSE 293,036,119431,Su; Hao,9999,0,9999,0
1668208103542,CSE 293,037,119433,Swanson; Steven James,9999,0,9999,0
1668208103542,CSE 293,038,119435,Tullsen; Dean Michael,9999,0,9999,0
1668208103542,CSE 293,039,119483,Voelker; Geoffrey M.,9999,0,9999,0
1668208103542,CSE 293,040,119537,Zhao; Jishen,9999,0,9999,0
1668208103542,CSE 293,041,119538,Zhou; Yuan-Yuan,9999,0,9999,0
1668208103542,CSE 293,042,119539,Gao; Sicun,9999,0,9999,0
1668208103542,CSE 293,043,119540,Weibel; Nadir,9999,0,9999,0
1668208103542,CSE 293,044,119541,Gupta; Rajesh K.,9999,0,9999,0
1668208103542,CSE 293,045,126410,Vaccaro; Kristen Marie,9999,0,9999,0
1668208103542,CSE 293,046,126411,Klemke; Richard,9999,0,9999,0
1668208103966,CSE 294,A00,102459,Voelker; Geoffrey M.,0,0,0,0
1668208103966,CSE 294,B00,111322,Orailoglu; Alex,0,0,0,0
1668208104392,DSE 201,A00,096914,Deutsch; Alin Bernard,30,0,30,0
1668208104826,DSE 210,A00,096915,Dasgupta; Sanjoy,30,0,30,0
1668208105250,DSE 260A,A00,096916,Altintas De Callaf; Ilkay,30,0,30,0
1668208105678,ECE 200,001,103586,Antipa; Nicholas A,9999,0,9999,0
1668208105678,ECE 200,002,103587,Atanasov; Nikolay A.,9999,0,9999,0
1668208105678,ECE 200,003,103588,Bharadia; Dinesh,9999,0,9999,0
1668208105678,ECE 200,004,103589,Cheng; Chung Kuan,9999,0,9999,0
1668208105678,ECE 200,005,103590,Cosman; Pamela C.,9999,0,9999,0
1668208105678,ECE 200,006,103591,Dayeh; Shadi Ahmad,9999,0,9999,0
1668208105678,ECE 200,007,103592,Fainman; Yeshaiahu,9999,0,9999,0
1668208105678,ECE 200,008,103593,Ford; Joseph Earl,9999,0,9999,0
1668208105678,ECE 200,009,103594,Franceschetti; Massimo,9999,0,9999,0
1668208105678,ECE 200,010,103595,Fullerton; Eric E,9999,0,9999,0
1668208105678,ECE 200,011,103596,Galton; Ian A,9999,0,9999,0
1668208105678,ECE 200,012,103597,Gilja; Vikash,9999,0,9999,0
1668208105678,ECE 200,013,103598,Hall; Drew A.,9999,0,9999,0
1668208105678,ECE 200,014,103599,Hsueh; Tzu-Chien,9999,0,9999,0
1668208105678,ECE 200,015,103600,Javidi; Tara,9999,0,9999,0
1668208105678,ECE 200,016,103601,Kahng; Andrew Byun,9999,0,9999,0
1668208105678,ECE 200,017,103602,Kim; Young-Han,9999,0,9999,0
1668208105678,ECE 200,018,103603,Koushanfar; Farinaz,9999,0,9999,0
1668208105678,ECE 200,019,103604,Kuzum; Duygu,9999,0,9999,0
1668208105678,ECE 200,020,103605,Le; Hanh-Phuc,9999,0,9999,0
1668208105678,ECE 200,021,103606,Lin; Bill,9999,0,9999,0
1668208105678,ECE 200,022,103607,Liu; Zhaowei,9998,0,9999,1
1668208105678,ECE 200,023,103608,Lo; Yu-Hwa,9999,0,9999,0
1668208105678,ECE 200,024,103609,Lomakin; Vitaliy,9999,0,9999,0
1668208105678,ECE 200,025,103610,Mercier; Patrick Philip,9999,0,9999,0
1668208105678,ECE 200,026,103611,Meyer; Florian,9999,0,9999,0
1668208105678,ECE 200,027,103612,Milstein; Laurence B.,9999,0,9999,0
1668208105678,ECE 200,028,103613,Mir Arabbaygi; Siavash,9999,0,9999,0
1668208105678,ECE 200,029,103614,Mookherjea; Shayan,9999,0,9999,0
1668208105678,ECE 200,030,103615,Morris; Karcher William,9999,0,9999,0
1668208105678,ECE 200,031,103616,Ng; Tse Nga,9999,0,9999,0
1668208105678,ECE 200,032,103617,Nguyen; Truong Quang,9999,0,9999,0
1668208105678,ECE 200,033,103618,Nomura; Kenji,9999,0,9999,0
1668208105678,ECE 200,034,103619,Orlitsky; Alon,9999,0,9999,0
1668208105678,ECE 200,035,103620,Pal; Piya,9999,0,9999,0
1668208105678,ECE 200,036,103621,Papen; George C.,9999,0,9999,0
1668208105678,ECE 200,037,103622,Radic; Stojan,9999,0,9999,0
1668208105678,ECE 200,038,103623,Rao; Bhaskar D.,9999,0,9999,0
1668208105678,ECE 200,039,103624,Rao; Ramesh R,9999,0,9999,0
1668208105678,ECE 200,040,103625,Rebeiz; Gabriel,9999,0,9999,0
1668208105678,ECE 200,041,103626,Sanford; John R,9999,0,9999,0
1668208105678,ECE 200,042,103627,Siegel; Paul H.,9999,0,9999,0
1668208105678,ECE 200,043,103628,Sievenpiper; Daniel F.,9999,0,9999,0
1668208105678,ECE 200,044,103629,Sworder; David D.,9999,0,9999,0
1668208105678,ECE 200,045,103630,Taur; Yuan,9999,0,9999,0
1668208105678,ECE 200,046,103631,Touri; Behrouz,9999,0,9999,0
1668208105678,ECE 200,047,103632,Trivedi; Mohan M.,9999,0,9999,0
1668208105678,ECE 200,048,103633,Vasconcelos; Nuno,9999,0,9999,0
1668208105678,ECE 200,049,103634,Wang; Xiaolong,9999,0,9999,0
1668208105678,ECE 200,050,103635,Xie; Pengtao,9999,0,9999,0
1668208105678,ECE 200,051,103636,Yip; Michael,9999,0,9999,0
1668208105678,ECE 200,052,103637,Zeger; Kenneth A.,999,0,999,0
1668208105678,ECE 200,053,103638,Zhang; Xinyu,9999,0,9999,0
1668208105678,ECE 200,054,103639,Turakhia; Yatish Girish,9999,0,9999,0
1668208105678,ECE 200,055,103640,Kang; Mingu,9999,0,9999,0
1668208105678,ECE 200,056,103641,Shi; Yuanyuan,9999,0,9999,0
1668208105678,ECE 200,057,103642,Wang; Edward Jay,9999,0,9999,0
1668208105678,ECE 200,058,103643,Zheng; Yang,9999,0,9999,0
1668208106106,ECE 202,A00,103644,Kuzum; Duygu,0,0,0,0
1668208106532,ECE 212BN,A00,103646,Ng; Tse Nga,0,0,0,0
1668208106959,ECE 221,A00,111493,Staff,0,0,0,0
1668208107383,ECE 222B,A00,103647,Lomakin; Vitaliy,0,0,0,0
1668208107810,ECE 230B,A00,103648,Taur; Yuan,0,0,0,0
1668208108234,ECE 238B,A00,103649,Garay; Javier,0,0,0,0
1668208108662,ECE 240B,A00,112900,Fainman; Yeshaiahu,0,0,0,0
1668208109093,ECE 247A,A00,103650,Jokerst; Jesse Vincent,0,0,0,0
1668208109519,ECE 247B,A00,103651,Wang; Joseph,0,0,0,0
1668208109954,ECE 250,A00,103652,Siegel; Paul H.,0,0,0,0
1668208110384,ECE 251A,A00,103654,Rao; Bhaskar D.,0,0,0,0
1668208110805,ECE 257B,A00,103655,Bharadia; Dinesh,0,0,0,0
1668208111228,ECE 258A,A00,103656,Milstein; Laurence B.,0,0,0,0
1668208111673,ECE 260B,A00,103658,Kang; Mingu,0,0,0,0
1668208112099,ECE 264A,A00,103659,Galton; Ian A,0,0,0,0
1668208112534,ECE 265A,A00,103661,Gudem; Prasad S.S.,0,0,0,0
1668208112961,ECE 265D,A00,103662,Gudem; Prasad S.S.,0,0,0,0
1668208113388,ECE 268,A00,103663,Koushanfar; Farinaz,0,0,0,0
1668208113815,ECE 269,A01,103665,Pal; Piya,0,0,0,0
1668208114243,ECE 271B,A00,103666,Vasconcelos; Manuela,0,0,0,0
1668208114678,ECE 276A,A00,103667,Atanasov; Nikolay A.,0,0,0,0
1668208115103,ECE 277,A00,103668,An; Cheolhong,0,0,0,0
1668208115527,ECE 279,A00,117947,Hall; Drew A.,0,0,0,0
1668208116378,ECE 283,A00,103670,Hsueh; Tzu-Chien,0,0,0,0
1668208116813,ECE 284,A00,103671,Turakhia; Yatish Girish,0,0,0,0
1668208117236,ECE 285,A00,103672,Zheng; Yang,0,0,0,0
1668208117236,ECE 285,B00,103673,Sworder; David D.,0,0,0,0
1668208117663,ECE 287,A00,103676,Javidi; Tara,0,0,0,0
1668208118103,MATH 200B,A00,098023,Salehi Golsefidy; Alireza,12,0,15,3
1668208118535,MATH 202B,A00,098024,Rhoades; Brendon Patrick,9,0,15,6
1668208118972,MATH 203B,A00,098025,Oprea; Dragos N.,10,0,15,5
1668208119406,MATH 204B,A00,098026,Sorensen; Claus M,13,0,15,2
1668208119829,MATH 208,A00,098027,Izadi; Elham,7,0,10,3
1668208120255,MATH 209,A00,098028,Pollack; Aaron,10,0,10,0
1668208120695,MATH 211A,A00,112919,Rogalski; Daniel,9,0,10,1
1668208121119,MATH 211B,A00,112920,Seward; Brandon M.,9,0,10,1
1668208121542,MATH 218,A00,098029,Li; Bo,10,0,10,0
1668208121973,MATH 220B,A00,098030,Novak; Jonathan I,11,0,15,4
1668208122398,MATH 221A,A00,098031,Ebenfelt; Peter F,13,0,15,2
1668208122821,MATH 231B,A00,098032,Zlatos; Andrej,12,0,15,3
1668208123251,MATH 240B,A00,098033,Ni; Lei,9,0,15,6
1668208123675,MATH 243,A00,098034,Jekel; David Andrew,10,0,10,0
1668208124099,MATH 245A,A00,098035,Nie; Jiawang,0,0,15,16
1668208124525,MATH 248,A00,098036,Bejenaru; Ioan,10,0,10,0
1668208124947,MATH 250B,A00,098037,Spolaor; Luca,14,0,15,1
1668208125383,MATH 258,A00,098038,Ni; Lei,10,0,10,0
1668208125809,MATH 264B,A00,098041,Rhoades; Brendon Patrick,9,0,15,6
1668208126233,MATH 268,A00,098042,Buss; Samuel R,10,0,10,0
1668208126659,MATH 269,A00,098043,Rhoades; Brendon Patrick,10,0,10,0
1668208127083,MATH 270B,A00,098044,Li; Bo,10,0,15,5
1668208127511,MATH 272B,A00,098045,Holst; Michael J,13,0,15,2
1668208127938,MATH 273A,A00,098046,Tian; Xiaochuan,10,0,15,5
1668208128365,MATH 275,A01,098048,Tian; Xiaochuan,6,0,10,4
1668208128924,MATH 278A,A00,098049,Holst; Michael J,8,0,10,2
1668208129351,MATH 278B,A00,098050,Cloninger; Alexander,10,0,10,0
1668208129781,MATH 278C,A00,098051,Nie; Jiawang,7,0,10,3
1668208130204,MATH 280B,A00,098052,Zheng; Tianyi,10,0,15,5
1668208130628,MATH 281B,A00,098053,Bradic; Jelena,2,0,15,13
1668208131051,MATH 282B,A00,098054,Arias-Castro; Ery,0,0,15,15
1668208131473,MATH 285,A00,098055,Fitzsimmons; Patrick J,0,0,15,17
1668208131896,MATH 287B,A00,098056,Arias-Castro; Ery,2,0,15,13
1668208132322,MATH 288,A00,098057,Agarwal; Pooja,9,0,10,1
1668208132322,MATH 288,B00,098058,Zhang; Danna,8,0,10,2
1668208132322,MATH 288,C00,098059,Williams; Ruth J,10,0,10,0
1668208132749,MATH 290B,A00,098060,Roberts; Justin Deritter,13,0,15,2
1668208133172,MATH 292,A00,098061,Belmont; Eva Kinoshita,10,0,10,0
1668208133594,MATH 295,A00,098062,Suk; Andrew Hoon,48,0,50,2
1668208134021,MATH 296,A00,098063,Novak; Jonathan I,20,0,20,0
1668208134443,MATH 297,001,098064,Gamst; Anthony Collins,9997,0,9999,2
1668208637664,COGS 205,A00,101395,Chiba; Andrea,19,0,20,1
1668208638098,COGS 210B,001,101404,Greene; Deanna Jacquelyn,9998,0,9999,1
1668208638098,COGS 210B,002,101417,Xia; Haijun,9999,0,9999,0
1668208638098,COGS 210B,003,101422,Nitz; Douglas A.,9999,0,9999,0
1668208638098,COGS 210B,004,101423,Hollan; James D.,9998,0,9999,1
1668208638098,COGS 210B,005,101424,Deak; Gedeon O.,9998,0,9999,1
1668208638098,COGS 210B,006,101425,Rossano; Federico,9999,0,9999,0
1668208638523,COGS 211B,A00,101427,Coulson; Seana M,9996,0,9999,3
1668208638945,COGS 220,A00,101428,Hollan; James D.,0,0,25,25
1668208639368,COGS 229,A00,101429,Dow; Steven P,18,0,25,7
1668208639793,COGS 230,A00,101430,Klemmer; Scott R,12,0,17,5
1668208640219,COGS 234,A00,101431,Xia; Haijun,2,0,25,23
1668208640651,COGS 260,A00,101432,Kiyonaga; Anastasia,21,0,25,4
1668208640651,COGS 260,B00,101433,Kirsh; David Joel,16,0,25,9
1668208641073,CSE 202,A00,102371,Impagliazzo; Russell,0,0,0,0
1668208641495,CSE 203B,A01,102373,Cheng; Chung Kuan,0,0,0,0
1668208641919,CSE 208,A00,102374,Micciancio; Daniele,0,0,0,0
1668208642352,CSE 209A,A00,112895,Impagliazzo; Russell,0,0,15,15
1668208642778,CSE 209B,A00,108005,Bellare; Mihir,0,0,0,0
1668208643206,CSE 210,A00,113163,Coblenz; Michael J,0,0,0,0
1668208643634,CSE 219,A00,106111,Dow; Steven P,0,0,20,20
1668208644061,CSE 221,A00,102376,Voelker; Geoffrey M.,0,0,0,0
1668208644488,CSE 224,A01,102378,Porter; George M,0,0,0,0
1668208644918,CSE 229A,A00,102379,Savage; Stefan,0,0,0,0
1668208645344,CSE 229C,A00,102380,Munyaka; Imani N. S.,0,0,0,0
1668208645768,CSE 232B,A00,102382,Deutsch; Alin Bernard,0,0,0,0
1668208646194,CSE 234,A01,112904,Kumar; Arun Kumar,0,0,0,0
1668208646618,CSE 237A,A00,102383,Rosing; Tajana Simunic,0,0,0,0
1668208647042,CSE 239A,A00,102384,Deutsch; Alin Bernard,0,0,0,0
1668208647464,CSE 239B,A00,102385,Polikarpova; Nadezhda,0,0,0,0
1668208647888,CSE 240A,A00,102386,Pannuto; Patrick William,0,0,0,0
1668208648314,CSE 240B,A00,102387,Zhao; Jishen,0,0,0,0
1668208648740,CSE 241A,A00,106406,Kang; Mingu,0,0,0,0
1668208649165,CSE 249B,A00,102388,Kahng; Andrew Byun,0,0,8,8
1668208649594,CSE 251B,A01,102392,Cottrell; Garrison W,0,0,0,0
1668208649594,CSE 251B,A02,102393,Cottrell; Garrison W,0,0,0,0
1668208650022,CSE 252B,A00,102394,Ochoa; Benjamin Lawrence,0,0,0,0
1668208650466,CSE 257,A01,102396,Gao; Sicun,0,0,0,0
1668208650891,CSE 272,A00,102397,Li; Tzumao,0,0,0,0
1668208651318,CSE 274,A00,111323,Chern; Albert Ren-Haur,0,0,0,0
1668208651750,CSE 282,A00,102398,Pevzner; Pavel Arkadjevich,0,0,0,0
1668208652173,CSE 284,A00,114175,Gymrek; Melissa Ann,0,0,0,0
1668208652605,CSE 290,A00,102399,Chandraker; Manmohan Krishna,0,0,0,0
1668208652605,CSE 290,B00,102400,Vaccaro; Kristen Marie,0,0,25,25
1668208652605,CSE 290,C00,102414,Pannuto; Patrick William,0,0,25,25
1668208652605,CSE 290,D00,102427,Pevzner; Pavel Arkadjevich,0,0,0,0
1668208652605,CSE 290,E00,102429,Zhao; Jishen,0,0,0,0
1668208652605,CSE 290,F00,102436,Tullsen; Dean Michael,0,0,0,0
1668208652605,CSE 290,G00,102440,Christensen; Henrik I,0,0,20,20
1668208653033,CSE 291,A00,102443,Su; Hao,0,0,0,0
1668208653033,CSE 291,B00,102448,Polikarpova; Nadezhda,0,0,0,0
1668208653033,CSE 291,C00,102453,Vaccaro; Kristen Marie,0,0,0,0
1668208653033,CSE 291,D00,111343,Savage; Stefan,0,0,0,0
1668208653033,CSE 291,E00,116474,Claffy; Kimberly Claire,0,0,0,0
1668208653033,CSE 291,F00,116479,Pasquale; Joseph,0,0,0,0
1668208653458,CSE 293,001,119111,Bafna; Vineet,9999,0,9999,0
1668208653458,CSE 293,002,119118,Bellare; Mihir,9999,0,9999,0
1668208653458,CSE 293,003,119122,Berg-Kirkpatrick; Taylor D,9999,0,9999,0
1668208653458,CSE 293,004,119135,Christensen; Henrik I,9999,0,9999,0
1668208653458,CSE 293,005,119142,Cottrell; Garrison W,9999,0,9999,0
1668208653458,CSE 293,006,119146,Deutsch; Alin Bernard,9999,0,9999,0
1668208653458,CSE 293,007,119159,Esmaeilzadeh; Hadi,9999,0,9999,0
1668208653458,CSE 293,008,119166,Freund; Yoav,9999,0,9999,0
1668208653458,CSE 293,009,119170,Griswold; William G.,9999,0,9999,0
1668208653458,CSE 293,010,119183,Gymrek; Melissa Ann,9999,0,9999,0
1668208653458,CSE 293,011,119190,Heninger; Nadia A,9999,0,9999,0
1668208653458,CSE 293,012,119230,Impagliazzo; Russell,9999,0,9999,0
1668208653458,CSE 293,013,119232,Jhala; Ranjit,9999,0,9999,0
1668208653458,CSE 293,014,119233,Kahng; Andrew Byun,9999,0,9999,0
1668208653458,CSE 293,015,119298,Kane; Daniel Mertz,9999,0,9999,0
1668208653458,CSE 293,016,119299,Kriegman; David J,9999,0,9999,0
1668208653458,CSE 293,017,119300,Kumar; Arun Kumar,9999,0,9999,0
1668208653458,CSE 293,018,119301,Lerner; Sorin,9999,0,9999,0
1668208653458,CSE 293,019,119302,Lovett; Shachar,9999,0,9999,0
1668208653458,CSE 293,020,119303,McAuley; Julian John,9999,0,9999,0
1668208653458,CSE 293,021,119304,Micciancio; Daniele,9999,0,9999,0
1668208653458,CSE 293,022,119367,Orailoglu; Alex,9999,0,9999,0
1668208653458,CSE 293,023,119382,Paturi; Ramamohan,9999,0,9999,0
1668208653458,CSE 293,024,119404,Polikarpova; Nadezhda,9999,0,9999,0
1668208653458,CSE 293,025,119406,Politz; Joseph Gibbs,9999,0,9999,0
1668208653458,CSE 293,026,119411,Porter; George M,9999,0,9999,0
1668208653458,CSE 293,027,119414,Porter; Leonard Emerson,9999,0,9999,0
1668208653458,CSE 293,028,119416,Ramamoorthi; Ravi,9999,0,9999,0
1668208653458,CSE 293,029,119417,Sahoo; Debashis,9999,0,9999,0
1668208653458,CSE 293,030,119420,Saul; Lawrence,9999,0,9999,0
1668208653458,CSE 293,031,119421,Savage; Stefan,9999,0,9999,0
1668208653458,CSE 293,032,119425,Schulze; Jurgen P.,9999,0,9999,0
1668208653458,CSE 293,033,119426,Snoeren; Alex C.,9999,0,9999,0
1668208653458,CSE 293,034,119428,Shang; Jingbo,9999,0,9999,0
1668208653458,CSE 293,035,119430,Stefan; Deian,9999,0,9999,0
1668208653458,CSE 293,036,119431,Su; Hao,9999,0,9999,0
1668208653458,CSE 293,037,119433,Swanson; Steven James,9999,0,9999,0
1668208653458,CSE 293,038,119435,Tullsen; Dean Michael,9999,0,9999,0
1668208653458,CSE 293,039,119483,Voelker; Geoffrey M.,9999,0,9999,0
1668208653458,CSE 293,040,119537,Zhao; Jishen,9999,0,9999,0
1668208653458,CSE 293,041,119538,Zhou; Yuan-Yuan,9999,0,9999,0
1668208653458,CSE 293,042,119539,Gao; Sicun,9999,0,9999,0
1668208653458,CSE 293,043,119540,Weibel; Nadir,9999,0,9999,0
1668208653458,CSE 293,044,119541,Gupta; Rajesh K.,9999,0,9999,0
1668208653458,CSE 293,045,126410,Vaccaro; Kristen Marie,9999,0,9999,0
1668208653458,CSE 293,046,126411,Klemke; Richard,9999,0,9999,0
1668208653883,CSE 294,A00,102459,Voelker; Geoffrey M.,0,0,0,0
1668208653883,CSE 294,B00,111322,Orailoglu; Alex,0,0,0,0
1668208654305,DSE 201,A00,096914,Deutsch; Alin Bernard,30,0,30,0
1668208654728,DSE 210,A00,096915,Dasgupta; Sanjoy,30,0,30,0
1668208655174,DSE 260A,A00,096916,Altintas De Callaf; Ilkay,30,0,30,0
1668208655646,ECE 200,001,103586,Antipa; Nicholas A,9999,0,9999,0
1668208655646,ECE 200,002,103587,Atanasov; Nikolay A.,9999,0,9999,0
1668208655646,ECE 200,003,103588,Bharadia; Dinesh,9999,0,9999,0
1668208655646,ECE 200,004,103589,Cheng; Chung Kuan,9999,0,9999,0
1668208655646,ECE 200,005,103590,Cosman; Pamela C.,9999,0,9999,0
1668208655646,ECE 200,006,103591,Dayeh; Shadi Ahmad,9999,0,9999,0
1668208655646,ECE 200,007,103592,Fainman; Yeshaiahu,9999,0,9999,0
1668208655646,ECE 200,008,103593,Ford; Joseph Earl,9999,0,9999,0
1668208655646,ECE 200,009,103594,Franceschetti; Massimo,9999,0,9999,0
1668208655646,ECE 200,010,103595,Fullerton; Eric E,9999,0,9999,0
1668208655646,ECE 200,011,103596,Galton; Ian A,9999,0,9999,0
1668208655646,ECE 200,012,103597,Gilja; Vikash,9999,0,9999,0
1668208655646,ECE 200,013,103598,Hall; Drew A.,9999,0,9999,0
1668208655646,ECE 200,014,103599,Hsueh; Tzu-Chien,9999,0,9999,0
1668208655646,ECE 200,015,103600,Javidi; Tara,9999,0,9999,0
1668208655646,ECE 200,016,103601,Kahng; Andrew Byun,9999,0,9999,0
1668208655646,ECE 200,017,103602,Kim; Young-Han,9999,0,9999,0
1668208655646,ECE 200,018,103603,Koushanfar; Farinaz,9999,0,9999,0
1668208655646,ECE 200,019,103604,Kuzum; Duygu,9999,0,9999,0
1668208655646,ECE 200,020,103605,Le; Hanh-Phuc,9999,0,9999,0
1668208655646,ECE 200,021,103606,Lin; Bill,9999,0,9999,0
1668208655646,ECE 200,022,103607,Liu; Zhaowei,9998,0,9999,1
1668208655646,ECE 200,023,103608,Lo; Yu-Hwa,9999,0,9999,0
1668208655646,ECE 200,024,103609,Lomakin; Vitaliy,9999,0,9999,0
1668208655646,ECE 200,025,103610,Mercier; Patrick Philip,9999,0,9999,0
1668208655646,ECE 200,026,103611,Meyer; Florian,9999,0,9999,0
1668208655646,ECE 200,027,103612,Milstein; Laurence B.,9999,0,9999,0
1668208655646,ECE 200,028,103613,Mir Arabbaygi; Siavash,9999,0,9999,0
1668208655646,ECE 200,029,103614,Mookherjea; Shayan,9999,0,9999,0
1668208655646,ECE 200,030,103615,Morris; Karcher William,9999,0,9999,0
1668208655646,ECE 200,031,103616,Ng; Tse Nga,9999,0,9999,0
1668208655646,ECE 200,032,103617,Nguyen; Truong Quang,9999,0,9999,0
1668208655646,ECE 200,033,103618,Nomura; Kenji,9999,0,9999,0
1668208655646,ECE 200,034,103619,Orlitsky; Alon,9999,0,9999,0
1668208655646,ECE 200,035,103620,Pal; Piya,9999,0,9999,0
1668208655646,ECE 200,036,103621,Papen; George C.,9999,0,9999,0
1668208655646,ECE 200,037,103622,Radic; Stojan,9999,0,9999,0
1668208655646,ECE 200,038,103623,Rao; Bhaskar D.,9999,0,9999,0
1668208655646,ECE 200,039,103624,Rao; Ramesh R,9999,0,9999,0
1668208655646,ECE 200,040,103625,Rebeiz; Gabriel,9999,0,9999,0
1668208655646,ECE 200,041,103626,Sanford; John R,9999,0,9999,0
1668208655646,ECE 200,042,103627,Siegel; Paul H.,9999,0,9999,0
1668208655646,ECE 200,043,103628,Sievenpiper; Daniel F.,9999,0,9999,0
1668208655646,ECE 200,044,103629,Sworder; David D.,9999,0,9999,0
1668208655646,ECE 200,045,103630,Taur; Yuan,9999,0,9999,0
1668208655646,ECE 200,046,103631,Touri; Behrouz,9999,0,9999,0
1668208655646,ECE 200,047,103632,Trivedi; Mohan M.,9999,0,9999,0
1668208655646,ECE 200,048,103633,Vasconcelos; Nuno,9999,0,9999,0
1668208655646,ECE 200,049,103634,Wang; Xiaolong,9999,0,9999,0
1668208655646,ECE 200,050,103635,Xie; Pengtao,9999,0,9999,0
1668208655646,ECE 200,051,103636,Yip; Michael,9999,0,9999,0
1668208655646,ECE 200,052,103637,Zeger; Kenneth A.,999,0,999,0
1668208655646,ECE 200,053,103638,Zhang; Xinyu,9999,0,9999,0
1668208655646,ECE 200,054,103639,Turakhia; Yatish Girish,9999,0,9999,0
1668208655646,ECE 200,055,103640,Kang; Mingu,9999,0,9999,0
1668208655646,ECE 200,056,103641,Shi; Yuanyuan,9999,0,9999,0
1668208655646,ECE 200,057,103642,Wang; Edward Jay,9999,0,9999,0
1668208655646,ECE 200,058,103643,Zheng; Yang,9999,0,9999,0
1668208656071,ECE 202,A00,103644,Kuzum; Duygu,0,0,0,0
1668208656496,ECE 212BN,A00,103646,Ng; Tse Nga,0,0,0,0
1668208656930,ECE 221,A00,111493,Staff,0,0,0,0
1668208657356,ECE 222B,A00,103647,Lomakin; Vitaliy,0,0,0,0
1668208657783,ECE 230B,A00,103648,Taur; Yuan,0,0,0,0
1668208658214,ECE 238B,A00,103649,Garay; Javier,0,0,0,0
1668208658637,ECE 240B,A00,112900,Fainman; Yeshaiahu,0,0,0,0
1668208659060,ECE 247A,A00,103650,Jokerst; Jesse Vincent,0,0,0,0
1668208659494,ECE 247B,A00,103651,Wang; Joseph,0,0,0,0
1668208659919,ECE 250,A00,103652,Siegel; Paul H.,0,0,0,0
1668208660346,ECE 251A,A00,103654,Rao; Bhaskar D.,0,0,0,0
1668208660774,ECE 257B,A00,103655,Bharadia; Dinesh,0,0,0,0
1668208661197,ECE 258A,A00,103656,Milstein; Laurence B.,0,0,0,0
1668208661621,ECE 260B,A00,103658,Kang; Mingu,0,0,0,0
1668208662046,ECE 264A,A00,103659,Galton; Ian A,0,0,0,0
1668208662472,ECE 265A,A00,103661,Gudem; Prasad S.S.,0,0,0,0
1668208663009,ECE 265D,A00,103662,Gudem; Prasad S.S.,0,0,0,0
1668208663441,ECE 268,A00,103663,Koushanfar; Farinaz,0,0,0,0
1668208663870,ECE 269,A01,103665,Pal; Piya,0,0,0,0
1668208664294,ECE 271B,A00,103666,Vasconcelos; Manuela,0,0,0,0
1668208664716,ECE 276A,A00,103667,Atanasov; Nikolay A.,0,0,0,0
1668208665141,ECE 277,A00,103668,An; Cheolhong,0,0,0,0
1668208665576,ECE 279,A00,117947,Hall; Drew A.,0,0,0,0
1668208666440,ECE 283,A00,103670,Hsueh; Tzu-Chien,0,0,0,0
1668208666862,ECE 284,A00,103671,Turakhia; Yatish Girish,0,0,0,0
1668208667290,ECE 285,A00,103672,Zheng; Yang,0,0,0,0
1668208667290,ECE 285,B00,103673,Sworder; David D.,0,0,0,0
1668208667714,ECE 287,A00,103676,Javidi; Tara,0,0,0,0
1668208668141,MATH 200B,A00,098023,Salehi Golsefidy; Alireza,12,0,15,3
1668208668565,MATH 202B,A00,098024,Rhoades; Brendon Patrick,9,0,15,6
1668208668987,MATH 203B,A00,098025,Oprea; Dragos N.,10,0,15,5
1668208669411,MATH 204B,A00,098026,Sorensen; Claus M,13,0,15,2
1668208669838,MATH 208,A00,098027,Izadi; Elham,7,0,10,3
1668208670262,MATH 209,A00,098028,Pollack; Aaron,10,0,10,0
1668208670687,MATH 211A,A00,112919,Rogalski; Daniel,9,0,10,1
1668208671111,MATH 211B,A00,112920,Seward; Brandon M.,9,0,10,1
1668208671535,MATH 218,A00,098029,Li; Bo,10,0,10,0
1668208671963,MATH 220B,A00,098030,Novak; Jonathan I,11,0,15,4
1668208672389,MATH 221A,A00,098031,Ebenfelt; Peter F,13,0,15,2
1668208672813,MATH 231B,A00,098032,Zlatos; Andrej,12,0,15,3
1668208673234,MATH 240B,A00,098033,Ni; Lei,9,0,15,6
1668208673662,MATH 243,A00,098034,Jekel; David Andrew,10,0,10,0
1668208674089,MATH 245A,A00,098035,Nie; Jiawang,0,0,15,16
1668208674509,MATH 248,A00,098036,Bejenaru; Ioan,10,0,10,0
1668208674937,MATH 250B,A00,098037,Spolaor; Luca,14,0,15,1
1668208675367,MATH 258,A00,098038,Ni; Lei,10,0,10,0
1668208675807,MATH 264B,A00,098041,Rhoades; Brendon Patrick,9,0,15,6
1668208676233,MATH 268,A00,098042,Buss; Samuel R,10,0,10,0
1668208676663,MATH 269,A00,098043,Rhoades; Brendon Patrick,10,0,10,0
1668208677098,MATH 270B,A00,098044,Li; Bo,10,0,15,5
1668208677519,MATH 272B,A00,098045,Holst; Michael J,13,0,15,2
1668208677953,MATH 273A,A00,098046,Tian; Xiaochuan,10,0,15,5
1668208678377,MATH 275,A01,098048,Tian; Xiaochuan,6,0,10,4
1668208678800,MATH 278A,A00,098049,Holst; Michael J,8,0,10,2
1668208679235,MATH 278B,A00,098050,Cloninger; Alexander,10,0,10,0
1668208679669,MATH 278C,A00,098051,Nie; Jiawang,7,0,10,3
1668208680101,MATH 280B,A00,098052,Zheng; Tianyi,10,0,15,5
1668208680528,MATH 281B,A00,098053,Bradic; Jelena,2,0,15,13
1668208680951,MATH 282B,A00,098054,Arias-Castro; Ery,0,0,15,15
1668208681380,MATH 285,A00,098055,Fitzsimmons; Patrick J,0,0,15,17
1668208681821,MATH 287B,A00,098056,Arias-Castro; Ery,2,0,15,13
1668208682242,MATH 288,A00,098057,Agarwal; Pooja,9,0,10,1
1668208682242,MATH 288,B00,098058,Zhang; Danna,8,0,10,2
1668208682242,MATH 288,C00,098059,Williams; Ruth J,10,0,10,0
1668208682673,MATH 290B,A00,098060,Roberts; Justin Deritter,13,0,15,2
1668208683097,MATH 292,A00,098061,Belmont; Eva Kinoshita,10,0,10,0
1668208683523,MATH 295,A00,098062,Suk; Andrew Hoon,48,0,50,2
1668208683958,MATH 296,A00,098063,Novak; Jonathan I,20,0,20,0
1668208684384,MATH 297,001,098064,Gamst; Anthony Collins,9997,0,9999,2
1668209187836,COGS 205,A00,101395,Chiba; Andrea,19,0,20,1
1668209188265,COGS 210B,001,101404,Greene; Deanna Jacquelyn,9998,0,9999,1
1668209188265,COGS 210B,002,101417,Xia; Haijun,9999,0,9999,0
1668209188265,COGS 210B,003,101422,Nitz; Douglas A.,9999,0,9999,0
1668209188265,COGS 210B,004,101423,Hollan; James D.,9998,0,9999,1
1668209188265,COGS 210B,005,101424,Deak; Gedeon O.,9998,0,9999,1
1668209188265,COGS 210B,006,101425,Rossano; Federico,9999,0,9999,0
1668209188686,COGS 211B,A00,101427,Coulson; Seana M,9996,0,9999,3
1668209189110,COGS 220,A00,101428,Hollan; James D.,0,0,25,25
1668209189548,COGS 229,A00,101429,Dow; Steven P,18,0,25,7
1668209189979,COGS 230,A00,101430,Klemmer; Scott R,12,0,17,5
1668209190404,COGS 234,A00,101431,Xia; Haijun,2,0,25,23
1668209190828,COGS 260,A00,101432,Kiyonaga; Anastasia,21,0,25,4
1668209190828,COGS 260,B00,101433,Kirsh; David Joel,16,0,25,9
1668209191256,CSE 202,A00,102371,Impagliazzo; Russell,0,0,0,0
1668209191678,CSE 203B,A01,102373,Cheng; Chung Kuan,0,0,0,0
1668209192112,CSE 208,A00,102374,Micciancio; Daniele,0,0,0,0
1668209192544,CSE 209A,A00,112895,Impagliazzo; Russell,0,0,15,15
1668209192971,CSE 209B,A00,108005,Bellare; Mihir,0,0,0,0
1668209193401,CSE 210,A00,113163,Coblenz; Michael J,0,0,0,0
1668209193823,CSE 219,A00,106111,Dow; Steven P,0,0,20,20
1668209194247,CSE 221,A00,102376,Voelker; Geoffrey M.,0,0,0,0
1668209194673,CSE 224,A01,102378,Porter; George M,0,0,0,0
1668209195097,CSE 229A,A00,102379,Savage; Stefan,0,0,0,0
1668209195518,CSE 229C,A00,102380,Munyaka; Imani N. S.,0,0,0,0
1668209195951,CSE 232B,A00,102382,Deutsch; Alin Bernard,0,0,0,0
1668209196373,CSE 234,A01,112904,Kumar; Arun Kumar,0,0,0,0
1668209196795,CSE 237A,A00,102383,Rosing; Tajana Simunic,0,0,0,0
1668209197216,CSE 239A,A00,102384,Deutsch; Alin Bernard,0,0,0,0
1668209197640,CSE 239B,A00,102385,Polikarpova; Nadezhda,0,0,0,0
1668209198068,CSE 240A,A00,102386,Pannuto; Patrick William,0,0,0,0
1668209198492,CSE 240B,A00,102387,Zhao; Jishen,0,0,0,0
1668209198914,CSE 241A,A00,106406,Kang; Mingu,0,0,0,0
1668209199336,CSE 249B,A00,102388,Kahng; Andrew Byun,0,0,8,8
1668209199763,CSE 251B,A01,102392,Cottrell; Garrison W,0,0,0,0
1668209199763,CSE 251B,A02,102393,Cottrell; Garrison W,0,0,0,0
1668209200186,CSE 252B,A00,102394,Ochoa; Benjamin Lawrence,0,0,0,0
1668209200617,CSE 257,A01,102396,Gao; Sicun,0,0,0,0
1668209201041,CSE 272,A00,102397,Li; Tzumao,0,0,0,0
1668209201466,CSE 274,A00,111323,Chern; Albert Ren-Haur,0,0,0,0
1668209201898,CSE 282,A00,102398,Pevzner; Pavel Arkadjevich,0,0,0,0
1668209202321,CSE 284,A00,114175,Gymrek; Melissa Ann,0,0,0,0
1668209202744,CSE 290,A00,102399,Chandraker; Manmohan Krishna,0,0,0,0
1668209202744,CSE 290,B00,102400,Vaccaro; Kristen Marie,0,0,25,25
1668209202744,CSE 290,C00,102414,Pannuto; Patrick William,0,0,25,25
1668209202744,CSE 290,D00,102427,Pevzner; Pavel Arkadjevich,0,0,0,0
1668209202744,CSE 290,E00,102429,Zhao; Jishen,0,0,0,0
1668209202744,CSE 290,F00,102436,Tullsen; Dean Michael,0,0,0,0
1668209202744,CSE 290,G00,102440,Christensen; Henrik I,0,0,20,20
1668209203173,CSE 291,A00,102443,Su; Hao,0,0,0,0
1668209203173,CSE 291,B00,102448,Polikarpova; Nadezhda,0,0,0,0
1668209203173,CSE 291,C00,102453,Vaccaro; Kristen Marie,0,0,0,0
1668209203173,CSE 291,D00,111343,Savage; Stefan,0,0,0,0
1668209203173,CSE 291,E00,116474,Claffy; Kimberly Claire,0,0,0,0
1668209203173,CSE 291,F00,116479,Pasquale; Joseph,0,0,0,0
1668209203601,CSE 293,001,119111,Bafna; Vineet,9999,0,9999,0
1668209203601,CSE 293,002,119118,Bellare; Mihir,9999,0,9999,0
1668209203601,CSE 293,003,119122,Berg-Kirkpatrick; Taylor D,9999,0,9999,0
1668209203601,CSE 293,004,119135,Christensen; Henrik I,9999,0,9999,0
1668209203601,CSE 293,005,119142,Cottrell; Garrison W,9999,0,9999,0
1668209203601,CSE 293,006,119146,Deutsch; Alin Bernard,9999,0,9999,0
1668209203601,CSE 293,007,119159,Esmaeilzadeh; Hadi,9999,0,9999,0
1668209203601,CSE 293,008,119166,Freund; Yoav,9999,0,9999,0
1668209203601,CSE 293,009,119170,Griswold; William G.,9999,0,9999,0
1668209203601,CSE 293,010,119183,Gymrek; Melissa Ann,9999,0,9999,0
1668209203601,CSE 293,011,119190,Heninger; Nadia A,9999,0,9999,0
1668209203601,CSE 293,012,119230,Impagliazzo; Russell,9999,0,9999,0
1668209203601,CSE 293,013,119232,Jhala; Ranjit,9999,0,9999,0
1668209203601,CSE 293,014,119233,Kahng; Andrew Byun,9999,0,9999,0
1668209203601,CSE 293,015,119298,Kane; Daniel Mertz,9999,0,9999,0
1668209203601,CSE 293,016,119299,Kriegman; David J,9999,0,9999,0
1668209203601,CSE 293,017,119300,Kumar; Arun Kumar,9999,0,9999,0
1668209203601,CSE 293,018,119301,Lerner; Sorin,9999,0,9999,0
1668209203601,CSE 293,019,119302,Lovett; Shachar,9999,0,9999,0
1668209203601,CSE 293,020,119303,McAuley; Julian John,9999,0,9999,0
1668209203601,CSE 293,021,119304,Micciancio; Daniele,9999,0,9999,0
1668209203601,CSE 293,022,119367,Orailoglu; Alex,9999,0,9999,0
1668209203601,CSE 293,023,119382,Paturi; Ramamohan,9999,0,9999,0
1668209203601,CSE 293,024,119404,Polikarpova; Nadezhda,9999,0,9999,0
1668209203601,CSE 293,025,119406,Politz; Joseph Gibbs,9999,0,9999,0
1668209203601,CSE 293,026,119411,Porter; George M,9999,0,9999,0
1668209203601,CSE 293,027,119414,Porter; Leonard Emerson,9999,0,9999,0
1668209203601,CSE 293,028,119416,Ramamoorthi; Ravi,9999,0,9999,0
1668209203601,CSE 293,029,119417,Sahoo; Debashis,9999,0,9999,0
1668209203601,CSE 293,030,119420,Saul; Lawrence,9999,0,9999,0
1668209203601,CSE 293,031,119421,Savage; Stefan,9999,0,9999,0
1668209203601,CSE 293,032,119425,Schulze; Jurgen P.,9999,0,9999,0
1668209203601,CSE 293,033,119426,Snoeren; Alex C.,9999,0,9999,0
1668209203601,CSE 293,034,119428,Shang; Jingbo,9999,0,9999,0
1668209203601,CSE 293,035,119430,Stefan; Deian,9999,0,9999,0
1668209203601,CSE 293,036,119431,Su; Hao,9999,0,9999,0
1668209203601,CSE 293,037,119433,Swanson; Steven James,9999,0,9999,0
1668209203601,CSE 293,038,119435,Tullsen; Dean Michael,9999,0,9999,0
1668209203601,CSE 293,039,119483,Voelker; Geoffrey M.,9999,0,9999,0
1668209203601,CSE 293,040,119537,Zhao; Jishen,9999,0,9999,0
1668209203601,CSE 293,041,119538,Zhou; Yuan-Yuan,9999,0,9999,0
1668209203601,CSE 293,042,119539,Gao; Sicun,9999,0,9999,0
1668209203601,CSE 293,043,119540,Weibel; Nadir,9999,0,9999,0
1668209203601,CSE 293,044,119541,Gupta; Rajesh K.,9999,0,9999,0
1668209203601,CSE 293,045,126410,Vaccaro; Kristen Marie,9999,0,9999,0
1668209203601,CSE 293,046,126411,Klemke; Richard,9999,0,9999,0
1668209204027,CSE 294,A00,102459,Voelker; Geoffrey M.,0,0,0,0
1668209204027,CSE 294,B00,111322,Orailoglu; Alex,0,0,0,0
1668209204451,DSE 201,A00,096914,Deutsch; Alin Bernard,30,0,30,0
1668209204876,DSE 210,A00,096915,Dasgupta; Sanjoy,30,0,30,0
1668209205300,DSE 260A,A00,096916,Altintas De Callaf; Ilkay,30,0,30,0
1668209205727,ECE 200,001,103586,Antipa; Nicholas A,9999,0,9999,0
1668209205727,ECE 200,002,103587,Atanasov; Nikolay A.,9999,0,9999,0
1668209205727,ECE 200,003,103588,Bharadia; Dinesh,9999,0,9999,0
1668209205727,ECE 200,004,103589,Cheng; Chung Kuan,9999,0,9999,0
1668209205727,ECE 200,005,103590,Cosman; Pamela C.,9999,0,9999,0
1668209205727,ECE 200,006,103591,Dayeh; Shadi Ahmad,9999,0,9999,0
1668209205727,ECE 200,007,103592,Fainman; Yeshaiahu,9999,0,9999,0
1668209205727,ECE 200,008,103593,Ford; Joseph Earl,9999,0,9999,0
1668209205727,ECE 200,009,103594,Franceschetti; Massimo,9999,0,9999,0
1668209205727,ECE 200,010,103595,Fullerton; Eric E,9999,0,9999,0
1668209205727,ECE 200,011,103596,Galton; Ian A,9999,0,9999,0
1668209205727,ECE 200,012,103597,Gilja; Vikash,9999,0,9999,0
1668209205727,ECE 200,013,103598,Hall; Drew A.,9999,0,9999,0
1668209205727,ECE 200,014,103599,Hsueh; Tzu-Chien,9999,0,9999,0
1668209205727,ECE 200,015,103600,Javidi; Tara,9999,0,9999,0
1668209205727,ECE 200,016,103601,Kahng; Andrew Byun,9999,0,9999,0
1668209205727,ECE 200,017,103602,Kim; Young-Han,9999,0,9999,0
1668209205727,ECE 200,018,103603,Koushanfar; Farinaz,9999,0,9999,0
1668209205727,ECE 200,019,103604,Kuzum; Duygu,9999,0,9999,0
1668209205727,ECE 200,020,103605,Le; Hanh-Phuc,9999,0,9999,0
1668209205727,ECE 200,021,103606,Lin; Bill,9999,0,9999,0
1668209205727,ECE 200,022,103607,Liu; Zhaowei,9998,0,9999,1
1668209205727,ECE 200,023,103608,Lo; Yu-Hwa,9999,0,9999,0
1668209205727,ECE 200,024,103609,Lomakin; Vitaliy,9999,0,9999,0
1668209205727,ECE 200,025,103610,Mercier; Patrick Philip,9999,0,9999,0
1668209205727,ECE 200,026,103611,Meyer; Florian,9999,0,9999,0
1668209205727,ECE 200,027,103612,Milstein; Laurence B.,9999,0,9999,0
1668209205727,ECE 200,028,103613,Mir Arabbaygi; Siavash,9999,0,9999,0
1668209205727,ECE 200,029,103614,Mookherjea; Shayan,9999,0,9999,0
1668209205727,ECE 200,030,103615,Morris; Karcher William,9999,0,9999,0
1668209205727,ECE 200,031,103616,Ng; Tse Nga,9999,0,9999,0
1668209205727,ECE 200,032,103617,Nguyen; Truong Quang,9999,0,9999,0
1668209205727,ECE 200,033,103618,Nomura; Kenji,9999,0,9999,0
1668209205727,ECE 200,034,103619,Orlitsky; Alon,9999,0,9999,0
1668209205727,ECE 200,035,103620,Pal; Piya,9999,0,9999,0
1668209205727,ECE 200,036,103621,Papen; George C.,9999,0,9999,0
1668209205727,ECE 200,037,103622,Radic; Stojan,9999,0,9999,0
1668209205727,ECE 200,038,103623,Rao; Bhaskar D.,9999,0,9999,0
1668209205727,ECE 200,039,103624,Rao; Ramesh R,9999,0,9999,0
1668209205727,ECE 200,040,103625,Rebeiz; Gabriel,9999,0,9999,0
1668209205727,ECE 200,041,103626,Sanford; John R,9999,0,9999,0
1668209205727,ECE 200,042,103627,Siegel; Paul H.,9999,0,9999,0
1668209205727,ECE 200,043,103628,Sievenpiper; Daniel F.,9999,0,9999,0
1668209205727,ECE 200,044,103629,Sworder; David D.,9999,0,9999,0
1668209205727,ECE 200,045,103630,Taur; Yuan,9999,0,9999,0
1668209205727,ECE 200,046,103631,Touri; Behrouz,9999,0,9999,0
1668209205727,ECE 200,047,103632,Trivedi; Mohan M.,9999,0,9999,0
1668209205727,ECE 200,048,103633,Vasconcelos; Nuno,9999,0,9999,0
1668209205727,ECE 200,049,103634,Wang; Xiaolong,9999,0,9999,0
1668209205727,ECE 200,050,103635,Xie; Pengtao,9999,0,9999,0
1668209205727,ECE 200,051,103636,Yip; Michael,9999,0,9999,0
1668209205727,ECE 200,052,103637,Zeger; Kenneth A.,999,0,999,0
1668209205727,ECE 200,053,103638,Zhang; Xinyu,9999,0,9999,0
1668209205727,ECE 200,054,103639,Turakhia; Yatish Girish,9999,0,9999,0
1668209205727,ECE 200,055,103640,Kang; Mingu,9999,0,9999,0
1668209205727,ECE 200,056,103641,Shi; Yuanyuan,9999,0,9999,0
1668209205727,ECE 200,057,103642,Wang; Edward Jay,9999,0,9999,0
1668209205727,ECE 200,058,103643,Zheng; Yang,9999,0,9999,0
1668209206151,ECE 202,A00,103644,Kuzum; Duygu,0,0,0,0
1668209206580,ECE 212BN,A00,103646,Ng; Tse Nga,0,0,0,0
1668209207007,ECE 221,A00,111493,Staff,0,0,0,0
1668209207439,ECE 222B,A00,103647,Lomakin; Vitaliy,0,0,0,0
1668209207862,ECE 230B,A00,103648,Taur; Yuan,0,0,0,0
1668209208285,ECE 238B,A00,103649,Garay; Javier,0,0,0,0
1668209208715,ECE 240B,A00,112900,Fainman; Yeshaiahu,0,0,0,0
1668209209140,ECE 247A,A00,103650,Jokerst; Jesse Vincent,0,0,0,0
1668209209578,ECE 247B,A00,103651,Wang; Joseph,0,0,0,0
1668209210001,ECE 250,A00,103652,Siegel; Paul H.,0,0,0,0
1668209210428,ECE 251A,A00,103654,Rao; Bhaskar D.,0,0,0,0
1668209210872,ECE 257B,A00,103655,Bharadia; Dinesh,0,0,0,0
1668209211302,ECE 258A,A00,103656,Milstein; Laurence B.,0,0,0,0
1668209211725,ECE 260B,A00,103658,Kang; Mingu,0,0,0,0
1668209212147,ECE 264A,A00,103659,Galton; Ian A,0,0,0,0
1668209212570,ECE 265A,A00,103661,Gudem; Prasad S.S.,0,0,0,0
1668209213005,ECE 265D,A00,103662,Gudem; Prasad S.S.,0,0,0,0
1668209213431,ECE 268,A00,103663,Koushanfar; Farinaz,0,0,0,0
1668209213853,ECE 269,A01,103665,Pal; Piya,0,0,0,0
1668209214279,ECE 271B,A00,103666,Vasconcelos; Manuela,0,0,0,0
1668209214703,ECE 276A,A00,103667,Atanasov; Nikolay A.,0,0,0,0
1668209215126,ECE 277,A00,103668,An; Cheolhong,0,0,0,0
1668209215551,ECE 279,A00,117947,Hall; Drew A.,0,0,0,0
1668209216401,ECE 283,A00,103670,Hsueh; Tzu-Chien,0,0,0,0
1668209216832,ECE 284,A00,103671,Turakhia; Yatish Girish,0,0,0,0
1668209217255,ECE 285,A00,103672,Zheng; Yang,0,0,0,0
1668209217255,ECE 285,B00,103673,Sworder; David D.,0,0,0,0
1668209217681,ECE 287,A00,103676,Javidi; Tara,0,0,0,0
1668209218104,MATH 200B,A00,098023,Salehi Golsefidy; Alireza,12,0,15,3
1668209218527,MATH 202B,A00,098024,Rhoades; Brendon Patrick,9,0,15,6
1668209218949,MATH 203B,A00,098025,Oprea; Dragos N.,10,0,15,5
1668209219381,MATH 204B,A00,098026,Sorensen; Claus M,13,0,15,2
1668209219805,MATH 208,A00,098027,Izadi; Elham,7,0,10,3
1668209220239,MATH 209,A00,098028,Pollack; Aaron,10,0,10,0
1668209220660,MATH 211A,A00,112919,Rogalski; Daniel,9,0,10,1
1668209221084,MATH 211B,A00,112920,Seward; Brandon M.,9,0,10,1
1668209221511,MATH 218,A00,098029,Li; Bo,10,0,10,0
1668209221933,MATH 220B,A00,098030,Novak; Jonathan I,11,0,15,4
1668209222358,MATH 221A,A00,098031,Ebenfelt; Peter F,13,0,15,2
1668209222786,MATH 231B,A00,098032,Zlatos; Andrej,12,0,15,3
1668209223210,MATH 240B,A00,098033,Ni; Lei,9,0,15,6
1668209223633,MATH 243,A00,098034,Jekel; David Andrew,10,0,10,0
1668209224064,MATH 245A,A00,098035,Nie; Jiawang,0,0,15,16
1668209224495,MATH 248,A00,098036,Bejenaru; Ioan,10,0,10,0
1668209224931,MATH 250B,A00,098037,Spolaor; Luca,14,0,15,1
1668209225353,MATH 258,A00,098038,Ni; Lei,10,0,10,0
1668209225776,MATH 264B,A00,098041,Rhoades; Brendon Patrick,9,0,15,6
1668209226206,MATH 268,A00,098042,Buss; Samuel R,10,0,10,0
1668209226628,MATH 269,A00,098043,Rhoades; Brendon Patrick,10,0,10,0
1668209227063,MATH 270B,A00,098044,Li; Bo,10,0,15,5
1668209227486,MATH 272B,A00,098045,Holst; Michael J,13,0,15,2
1668209227919,MATH 273A,A00,098046,Tian; Xiaochuan,10,0,15,5
1668209228352,MATH 275,A01,098048,Tian; Xiaochuan,6,0,10,4
1668209228778,MATH 278A,A00,098049,Holst; Michael J,8,0,10,2
1668209229202,MATH 278B,A00,098050,Cloninger; Alexander,10,0,10,0
1668209229705,MATH 278C,A00,098051,Nie; Jiawang,7,0,10,3
1668209230139,MATH 280B,A00,098052,Zheng; Tianyi,10,0,15,5
1668209230564,MATH 281B,A00,098053,Bradic; Jelena,2,0,15,13
1668209230996,MATH 282B,A00,098054,Arias-Castro; Ery,0,0,15,15
1668209231421,MATH 285,A00,098055,Fitzsimmons; Patrick J,0,0,15,17
1668209231845,MATH 287B,A00,098056,Arias-Castro; Ery,2,0,15,13
1668209232272,MATH 288,A00,098057,Agarwal; Pooja,9,0,10,1
1668209232272,MATH 288,B00,098058,Zhang; Danna,8,0,10,2
1668209232272,MATH 288,C00,098059,Williams; Ruth J,10,0,10,0
1668209232710,MATH 290B,A00,098060,Roberts; Justin Deritter,13,0,15,2
1668209233133,MATH 292,A00,098061,Belmont; Eva Kinoshita,10,0,10,0
1668209233558,MATH 295,A00,098062,Suk; Andrew Hoon,48,0,50,2
1668209233980,MATH 296,A00,098063,Novak; Jonathan I,20,0,20,0
1668209234407,MATH 297,001,098064,Gamst; Anthony Collins,9997,0,9999,2
1668209735991,COGS 205,A00,101395,Chiba; Andrea,19,0,20,1
1668209736422,COGS 210B,001,101404,Greene; Deanna Jacquelyn,9998,0,9999,1
1668209736422,COGS 210B,002,101417,Xia; Haijun,9999,0,9999,0
1668209736422,COGS 210B,003,101422,Nitz; Douglas A.,9999,0,9999,0
1668209736422,COGS 210B,004,101423,Hollan; James D.,9998,0,9999,1
1668209736422,COGS 210B,005,101424,Deak; Gedeon O.,9998,0,9999,1
1668209736422,COGS 210B,006,101425,Rossano; Federico,9999,0,9999,0
1668209736847,COGS 211B,A00,101427,Coulson; Seana M,9996,0,9999,3
1668209737280,COGS 220,A00,101428,Hollan; James D.,0,0,25,25
1668209737717,COGS 229,A00,101429,Dow; Steven P,18,0,25,7
1668209738144,COGS 230,A00,101430,Klemmer; Scott R,12,0,17,5
1668209738579,COGS 234,A00,101431,Xia; Haijun,2,0,25,23
1668209739001,COGS 260,A00,101432,Kiyonaga; Anastasia,21,0,25,4
1668209739001,COGS 260,B00,101433,Kirsh; David Joel,15,0,25,10
1668209739426,CSE 202,A00,102371,Impagliazzo; Russell,0,0,0,0
1668209739849,CSE 203B,A01,102373,Cheng; Chung Kuan,0,0,0,0
1668209740273,CSE 208,A00,102374,Micciancio; Daniele,0,0,0,0
1668209740697,CSE 209A,A00,112895,Impagliazzo; Russell,0,0,15,15
1668209741119,CSE 209B,A00,108005,Bellare; Mihir,0,0,0,0
1668209741552,CSE 210,A00,113163,Coblenz; Michael J,0,0,0,0
1668209741986,CSE 219,A00,106111,Dow; Steven P,0,0,20,20
1668209742410,CSE 221,A00,102376,Voelker; Geoffrey M.,0,0,0,0
1668209742832,CSE 224,A01,102378,Porter; George M,0,0,0,0
1668209743255,CSE 229A,A00,102379,Savage; Stefan,0,0,0,0
1668209743691,CSE 229C,A00,102380,Munyaka; Imani N. S.,0,0,0,0
1668209744125,CSE 232B,A00,102382,Deutsch; Alin Bernard,0,0,0,0
1668209744550,CSE 234,A01,112904,Kumar; Arun Kumar,0,0,0,0
1668209744973,CSE 237A,A00,102383,Rosing; Tajana Simunic,0,0,0,0
1668209745399,CSE 239A,A00,102384,Deutsch; Alin Bernard,0,0,0,0
1668209745823,CSE 239B,A00,102385,Polikarpova; Nadezhda,0,0,0,0
1668209746251,CSE 240A,A00,102386,Pannuto; Patrick William,0,0,0,0
1668209746676,CSE 240B,A00,102387,Zhao; Jishen,0,0,0,0
1668209747105,CSE 241A,A00,106406,Kang; Mingu,0,0,0,0
1668209747530,CSE 249B,A00,102388,Kahng; Andrew Byun,0,0,8,8
1668209747959,CSE 251B,A01,102392,Cottrell; Garrison W,0,0,0,0
1668209747959,CSE 251B,A02,102393,Cottrell; Garrison W,0,0,0,0
1668209748390,CSE 252B,A00,102394,Ochoa; Benjamin Lawrence,0,0,0,0
1668209748816,CSE 257,A01,102396,Gao; Sicun,0,0,0,0
1668209749239,CSE 272,A00,102397,Li; Tzumao,0,0,0,0
1668209749666,CSE 274,A00,111323,Chern; Albert Ren-Haur,0,0,0,0
1668209750092,CSE 282,A00,102398,Pevzner; Pavel Arkadjevich,0,0,0,0
1668209750516,CSE 284,A00,114175,Gymrek; Melissa Ann,0,0,0,0
1668209750952,CSE 290,A00,102399,Chandraker; Manmohan Krishna,0,0,0,0
1668209750952,CSE 290,B00,102400,Vaccaro; Kristen Marie,0,0,25,25
1668209750952,CSE 290,C00,102414,Pannuto; Patrick William,0,0,25,25
1668209750952,CSE 290,D00,102427,Pevzner; Pavel Arkadjevich,0,0,0,0
1668209750952,CSE 290,E00,102429,Zhao; Jishen,0,0,0,0
1668209750952,CSE 290,F00,102436,Tullsen; Dean Michael,0,0,0,0
1668209750952,CSE 290,G00,102440,Christensen; Henrik I,0,0,20,20
1668209751456,CSE 291,A00,102443,Su; Hao,0,0,0,0
1668209751456,CSE 291,B00,102448,Polikarpova; Nadezhda,0,0,0,0
1668209751456,CSE 291,C00,102453,Vaccaro; Kristen Marie,0,0,0,0
1668209751456,CSE 291,D00,111343,Savage; Stefan,0,0,0,0
1668209751456,CSE 291,E00,116474,Claffy; Kimberly Claire,0,0,0,0
1668209751456,CSE 291,F00,116479,Pasquale; Joseph,0,0,0,0
1668209751915,CSE 293,001,119111,Bafna; Vineet,9999,0,9999,0
1668209751915,CSE 293,002,119118,Bellare; Mihir,9999,0,9999,0
1668209751915,CSE 293,003,119122,Berg-Kirkpatrick; Taylor D,9999,0,9999,0
1668209751915,CSE 293,004,119135,Christensen; Henrik I,9999,0,9999,0
1668209751915,CSE 293,005,119142,Cottrell; Garrison W,9999,0,9999,0
1668209751915,CSE 293,006,119146,Deutsch; Alin Bernard,9999,0,9999,0
1668209751915,CSE 293,007,119159,Esmaeilzadeh; Hadi,9999,0,9999,0
1668209751915,CSE 293,008,119166,Freund; Yoav,9999,0,9999,0
1668209751915,CSE 293,009,119170,Griswold; William G.,9999,0,9999,0
1668209751915,CSE 293,010,119183,Gymrek; Melissa Ann,9999,0,9999,0
1668209751915,CSE 293,011,119190,Heninger; Nadia A,9999,0,9999,0
1668209751915,CSE 293,012,119230,Impagliazzo; Russell,9999,0,9999,0
1668209751915,CSE 293,013,119232,Jhala; Ranjit,9999,0,9999,0
1668209751915,CSE 293,014,119233,Kahng; Andrew Byun,9999,0,9999,0
1668209751915,CSE 293,015,119298,Kane; Daniel Mertz,9999,0,9999,0
1668209751915,CSE 293,016,119299,Kriegman; David J,9999,0,9999,0
1668209751915,CSE 293,017,119300,Kumar; Arun Kumar,9999,0,9999,0
1668209751915,CSE 293,018,119301,Lerner; Sorin,9999,0,9999,0
1668209751915,CSE 293,019,119302,Lovett; Shachar,9999,0,9999,0
1668209751915,CSE 293,020,119303,McAuley; Julian John,9999,0,9999,0
1668209751915,CSE 293,021,119304,Micciancio; Daniele,9999,0,9999,0
1668209751915,CSE 293,022,119367,Orailoglu; Alex,9999,0,9999,0
1668209751915,CSE 293,023,119382,Paturi; Ramamohan,9999,0,9999,0
1668209751915,CSE 293,024,119404,Polikarpova; Nadezhda,9999,0,9999,0
1668209751915,CSE 293,025,119406,Politz; Joseph Gibbs,9999,0,9999,0
1668209751915,CSE 293,026,119411,Porter; George M,9999,0,9999,0
1668209751915,CSE 293,027,119414,Porter; Leonard Emerson,9999,0,9999,0
1668209751915,CSE 293,028,119416,Ramamoorthi; Ravi,9999,0,9999,0
1668209751915,CSE 293,029,119417,Sahoo; Debashis,9999,0,9999,0
1668209751915,CSE 293,030,119420,Saul; Lawrence,9999,0,9999,0
1668209751915,CSE 293,031,119421,Savage; Stefan,9999,0,9999,0
1668209751915,CSE 293,032,119425,Schulze; Jurgen P.,9999,0,9999,0
1668209751915,CSE 293,033,119426,Snoeren; Alex C.,9999,0,9999,0
1668209751915,CSE 293,034,119428,Shang; Jingbo,9999,0,9999,0
1668209751915,CSE 293,035,119430,Stefan; Deian,9999,0,9999,0
1668209751915,CSE 293,036,119431,Su; Hao,9999,0,9999,0
1668209751915,CSE 293,037,119433,Swanson; Steven James,9999,0,9999,0
1668209751915,CSE 293,038,119435,Tullsen; Dean Michael,9999,0,9999,0
1668209751915,CSE 293,039,119483,Voelker; Geoffrey M.,9999,0,9999,0
1668209751915,CSE 293,040,119537,Zhao; Jishen,9999,0,9999,0
1668209751915,CSE 293,041,119538,Zhou; Yuan-Yuan,9999,0,9999,0
1668209751915,CSE 293,042,119539,Gao; Sicun,9999,0,9999,0
1668209751915,CSE 293,043,119540,Weibel; Nadir,9999,0,9999,0
1668209751915,CSE 293,044,119541,Gupta; Rajesh K.,9999,0,9999,0
1668209751915,CSE 293,045,126410,Vaccaro; Kristen Marie,9999,0,9999,0
1668209751915,CSE 293,046,126411,Klemke; Richard,9999,0,9999,0
1668209752339,CSE 294,A00,102459,Voelker; Geoffrey M.,0,0,0,0
1668209752339,CSE 294,B00,111322,Orailoglu; Alex,0,0,0,0
1668209752771,DSE 201,A00,096914,Deutsch; Alin Bernard,30,0,30,0
1668209753209,DSE 210,A00,096915,Dasgupta; Sanjoy,30,0,30,0
1668209753638,DSE 260A,A00,096916,Altintas De Callaf; Ilkay,30,0,30,0
1668209754073,ECE 200,001,103586,Antipa; Nicholas A,9999,0,9999,0
1668209754073,ECE 200,002,103587,Atanasov; Nikolay A.,9999,0,9999,0
1668209754073,ECE 200,003,103588,Bharadia; Dinesh,9999,0,9999,0
1668209754073,ECE 200,004,103589,Cheng; Chung Kuan,9999,0,9999,0
1668209754073,ECE 200,005,103590,Cosman; Pamela C.,9999,0,9999,0
1668209754073,ECE 200,006,103591,Dayeh; Shadi Ahmad,9999,0,9999,0
1668209754073,ECE 200,007,103592,Fainman; Yeshaiahu,9999,0,9999,0
1668209754073,ECE 200,008,103593,Ford; Joseph Earl,9999,0,9999,0
1668209754073,ECE 200,009,103594,Franceschetti; Massimo,9999,0,9999,0
1668209754073,ECE 200,010,103595,Fullerton; Eric E,9999,0,9999,0
1668209754073,ECE 200,011,103596,Galton; Ian A,9999,0,9999,0
1668209754073,ECE 200,012,103597,Gilja; Vikash,9999,0,9999,0
1668209754073,ECE 200,013,103598,Hall; Drew A.,9999,0,9999,0
1668209754073,ECE 200,014,103599,Hsueh; Tzu-Chien,9999,0,9999,0
1668209754073,ECE 200,015,103600,Javidi; Tara,9999,0,9999,0
1668209754073,ECE 200,016,103601,Kahng; Andrew Byun,9999,0,9999,0
1668209754073,ECE 200,017,103602,Kim; Young-Han,9999,0,9999,0
1668209754073,ECE 200,018,103603,Koushanfar; Farinaz,9999,0,9999,0
1668209754073,ECE 200,019,103604,Kuzum; Duygu,9999,0,9999,0
1668209754073,ECE 200,020,103605,Le; Hanh-Phuc,9999,0,9999,0
1668209754073,ECE 200,021,103606,Lin; Bill,9999,0,9999,0
1668209754073,ECE 200,022,103607,Liu; Zhaowei,9998,0,9999,1
1668209754073,ECE 200,023,103608,Lo; Yu-Hwa,9999,0,9999,0
1668209754073,ECE 200,024,103609,Lomakin; Vitaliy,9999,0,9999,0
1668209754073,ECE 200,025,103610,Mercier; Patrick Philip,9999,0,9999,0
1668209754073,ECE 200,026,103611,Meyer; Florian,9999,0,9999,0
1668209754073,ECE 200,027,103612,Milstein; Laurence B.,9999,0,9999,0
1668209754073,ECE 200,028,103613,Mir Arabbaygi; Siavash,9999,0,9999,0
1668209754073,ECE 200,029,103614,Mookherjea; Shayan,9999,0,9999,0
1668209754073,ECE 200,030,103615,Morris; Karcher William,9999,0,9999,0
1668209754073,ECE 200,031,103616,Ng; Tse Nga,9999,0,9999,0
1668209754073,ECE 200,032,103617,Nguyen; Truong Quang,9999,0,9999,0
1668209754073,ECE 200,033,103618,Nomura; Kenji,9999,0,9999,0
1668209754073,ECE 200,034,103619,Orlitsky; Alon,9999,0,9999,0
1668209754073,ECE 200,035,103620,Pal; Piya,9999,0,9999,0
1668209754073,ECE 200,036,103621,Papen; George C.,9999,0,9999,0
1668209754073,ECE 200,037,103622,Radic; Stojan,9999,0,9999,0
1668209754073,ECE 200,038,103623,Rao; Bhaskar D.,9999,0,9999,0
1668209754073,ECE 200,039,103624,Rao; Ramesh R,9999,0,9999,0
1668209754073,ECE 200,040,103625,Rebeiz; Gabriel,9999,0,9999,0
1668209754073,ECE 200,041,103626,Sanford; John R,9999,0,9999,0
1668209754073,ECE 200,042,103627,Siegel; Paul H.,9999,0,9999,0
1668209754073,ECE 200,043,103628,Sievenpiper; Daniel F.,9999,0,9999,0
1668209754073,ECE 200,044,103629,Sworder; David D.,9999,0,9999,0
1668209754073,ECE 200,045,103630,Taur; Yuan,9999,0,9999,0
1668209754073,ECE 200,046,103631,Touri; Behrouz,9999,0,9999,0
1668209754073,ECE 200,047,103632,Trivedi; Mohan M.,9999,0,9999,0
1668209754073,ECE 200,048,103633,Vasconcelos; Nuno,9999,0,9999,0
1668209754073,ECE 200,049,103634,Wang; Xiaolong,9999,0,9999,0
1668209754073,ECE 200,050,103635,Xie; Pengtao,9999,0,9999,0
1668209754073,ECE 200,051,103636,Yip; Michael,9999,0,9999,0
1668209754073,ECE 200,052,103637,Zeger; Kenneth A.,999,0,999,0
1668209754073,ECE 200,053,103638,Zhang; Xinyu,9999,0,9999,0
1668209754073,ECE 200,054,103639,Turakhia; Yatish Girish,9999,0,9999,0
1668209754073,ECE 200,055,103640,Kang; Mingu,9999,0,9999,0
1668209754073,ECE 200,056,103641,Shi; Yuanyuan,9999,0,9999,0
1668209754073,ECE 200,057,103642,Wang; Edward Jay,9999,0,9999,0
1668209754073,ECE 200,058,103643,Zheng; Yang,9999,0,9999,0
1668209754497,ECE 202,A00,103644,Kuzum; Duygu,0,0,0,0
1668209754920,ECE 212BN,A00,103646,Ng; Tse Nga,0,0,0,0
1668209755345,ECE 221,A00,111493,Staff,0,0,0,0
1668209755775,ECE 222B,A00,103647,Lomakin; Vitaliy,0,0,0,0
1668209756196,ECE 230B,A00,103648,Taur; Yuan,0,0,0,0
1668209756629,ECE 238B,A00,103649,Garay; Javier,0,0,0,0
1668209757053,ECE 240B,A00,112900,Fainman; Yeshaiahu,0,0,0,0
1668209757477,ECE 247A,A00,103650,Jokerst; Jesse Vincent,0,0,0,0
1668209757899,ECE 247B,A00,103651,Wang; Joseph,0,0,0,0
1668209758325,ECE 250,A00,103652,Siegel; Paul H.,0,0,0,0
1668209758754,ECE 251A,A00,103654,Rao; Bhaskar D.,0,0,0,0
1668209759184,ECE 257B,A00,103655,Bharadia; Dinesh,0,0,0,0
1668209759608,ECE 258A,A00,103656,Milstein; Laurence B.,0,0,0,0
1668209760041,ECE 260B,A00,103658,Kang; Mingu,0,0,0,0
1668209760480,ECE 264A,A00,103659,Galton; Ian A,0,0,0,0
1668209760904,ECE 265A,A00,103661,Gudem; Prasad S.S.,0,0,0,0
1668209761328,ECE 265D,A00,103662,Gudem; Prasad S.S.,0,0,0,0
1668209761781,ECE 268,A00,103663,Koushanfar; Farinaz,0,0,0,0
1668209762215,ECE 269,A01,103665,Pal; Piya,0,0,0,0
1668209762640,ECE 271B,A00,103666,Vasconcelos; Manuela,0,0,0,0
1668209763079,ECE 276A,A00,103667,Atanasov; Nikolay A.,0,0,0,0
1668209763505,ECE 277,A00,103668,An; Cheolhong,0,0,0,0
1668209763944,ECE 279,A00,117947,Hall; Drew A.,0,0,0,0
1668209764795,ECE 283,A00,103670,Hsueh; Tzu-Chien,0,0,0,0
1668209765220,ECE 284,A00,103671,Turakhia; Yatish Girish,0,0,0,0
1668209765647,ECE 285,A00,103672,Zheng; Yang,0,0,0,0
1668209765647,ECE 285,B00,103673,Sworder; David D.,0,0,0,0
1668209766071,ECE 287,A00,103676,Javidi; Tara,0,0,0,0
1668209766511,MATH 200B,A00,098023,Salehi Golsefidy; Alireza,12,0,15,3
1668209766936,MATH 202B,A00,098024,Rhoades; Brendon Patrick,9,0,15,6
1668209767359,MATH 203B,A00,098025,Oprea; Dragos N.,10,0,15,5
1668209767789,MATH 204B,A00,098026,Sorensen; Claus M,13,0,15,2
1668209768213,MATH 208,A00,098027,Izadi; Elham,7,0,10,3
1668209768644,MATH 209,A00,098028,Pollack; Aaron,10,0,10,0
1668209769067,MATH 211A,A00,112919,Rogalski; Daniel,9,0,10,1
1668209769493,MATH 211B,A00,112920,Seward; Brandon M.,9,0,10,1
1668209769918,MATH 218,A00,098029,Li; Bo,10,0,10,0
1668209770349,MATH 220B,A00,098030,Novak; Jonathan I,11,0,15,4
1668209770781,MATH 221A,A00,098031,Ebenfelt; Peter F,13,0,15,2
1668209771202,MATH 231B,A00,098032,Zlatos; Andrej,12,0,15,3
1668209771629,MATH 240B,A00,098033,Ni; Lei,9,0,15,6
1668209772055,MATH 243,A00,098034,Jekel; David Andrew,10,0,10,0
1668209772482,MATH 245A,A00,098035,Nie; Jiawang,0,0,15,16
1668209772910,MATH 248,A00,098036,Bejenaru; Ioan,10,0,10,0
1668209773335,MATH 250B,A00,098037,Spolaor; Luca,14,0,15,1
1668209773757,MATH 258,A00,098038,Ni; Lei,10,0,10,0
1668209774184,MATH 264B,A00,098041,Rhoades; Brendon Patrick,9,0,15,6
1668209774606,MATH 268,A00,098042,Buss; Samuel R,10,0,10,0
1668209775030,MATH 269,A00,098043,Rhoades; Brendon Patrick,10,0,10,0
1668209775463,MATH 270B,A00,098044,Li; Bo,10,0,15,5
1668209775889,MATH 272B,A00,098045,Holst; Michael J,13,0,15,2
1668209776315,MATH 273A,A00,098046,Tian; Xiaochuan,10,0,15,5
1668209776741,MATH 275,A01,098048,Tian; Xiaochuan,6,0,10,4
1668209777168,MATH 278A,A00,098049,Holst; Michael J,8,0,10,2
1668209777595,MATH 278B,A00,098050,Cloninger; Alexander,10,0,10,0
1668209778021,MATH 278C,A00,098051,Nie; Jiawang,7,0,10,3
1668209778443,MATH 280B,A00,098052,Zheng; Tianyi,10,0,15,5
1668209778865,MATH 281B,A00,098053,Bradic; Jelena,2,0,15,13
1668209779289,MATH 282B,A00,098054,Arias-Castro; Ery,0,0,15,15
1668209779712,MATH 285,A00,098055,Fitzsimmons; Patrick J,0,0,15,17
1668209780136,MATH 287B,A00,098056,Arias-Castro; Ery,2,0,15,13
1668209780563,MATH 288,A00,098057,Agarwal; Pooja,9,0,10,1
1668209780563,MATH 288,B00,098058,Zhang; Danna,8,0,10,2
1668209780563,MATH 288,C00,098059,Williams; Ruth J,10,0,10,0
1668209780984,MATH 290B,A00,098060,Roberts; Justin Deritter,13,0,15,2
1668209781407,MATH 292,A00,098061,Belmont; Eva Kinoshita,10,0,10,0
1668209781846,MATH 295,A00,098062,Suk; Andrew Hoon,48,0,50,2
1668209782271,MATH 296,A00,098063,Novak; Jonathan I,20,0,20,0
1668209782694,MATH 297,001,098064,Gamst; Anthony Collins,9997,0,9999,2
1668210302540,COGS 205,A00,101395,Chiba; Andrea,19,0,20,1
1668210302968,COGS 210B,001,101404,Greene; Deanna Jacquelyn,9998,0,9999,1
1668210302968,COGS 210B,002,101417,Xia; Haijun,9999,0,9999,0
1668210302968,COGS 210B,003,101422,Nitz; Douglas A.,9999,0,9999,0
1668210302968,COGS 210B,004,101423,Hollan; James D.,9998,0,9999,1
1668210302968,COGS 210B,005,101424,Deak; Gedeon O.,9998,0,9999,1
1668210302968,COGS 210B,006,101425,Rossano; Federico,9999,0,9999,0
1668210303394,COGS 211B,A00,101427,Coulson; Seana M,9996,0,9999,3
1668210303817,COGS 220,A00,101428,Hollan; James D.,0,0,25,25
1668210304244,COGS 229,A00,101429,Dow; Steven P,18,0,25,7
1668210304680,COGS 230,A00,101430,Klemmer; Scott R,12,0,17,5
1668210305107,COGS 234,A00,101431,Xia; Haijun,2,0,25,23
1668210305540,COGS 260,A00,101432,Kiyonaga; Anastasia,21,0,25,4
1668210305540,COGS 260,B00,101433,Kirsh; David Joel,15,0,25,10
1668210305965,CSE 202,A00,102371,Impagliazzo; Russell,0,0,0,0
1668210306392,CSE 203B,A01,102373,Cheng; Chung Kuan,0,0,0,0
1668210306823,CSE 208,A00,102374,Micciancio; Daniele,0,0,0,0
1668210307248,CSE 209A,A00,112895,Impagliazzo; Russell,0,0,15,15
1668210307677,CSE 209B,A00,108005,Bellare; Mihir,0,0,0,0
1668210308103,CSE 210,A00,113163,Coblenz; Michael J,0,0,0,0
1668210308530,CSE 219,A00,106111,Dow; Steven P,0,0,20,20
1668210308954,CSE 221,A00,102376,Voelker; Geoffrey M.,0,0,0,0
1668210309388,CSE 224,A01,102378,Porter; George M,0,0,0,0
1668210309821,CSE 229A,A00,102379,Savage; Stefan,0,0,0,0
1668210310247,CSE 229C,A00,102380,Munyaka; Imani N. S.,0,0,0,0
1668210310673,CSE 232B,A00,102382,Deutsch; Alin Bernard,0,0,0,0
1668210311108,CSE 234,A01,112904,Kumar; Arun Kumar,0,0,0,0
1668210311530,CSE 237A,A00,102383,Rosing; Tajana Simunic,0,0,0,0
1668210311954,CSE 239A,A00,102384,Deutsch; Alin Bernard,0,0,0,0
1668210312380,CSE 239B,A00,102385,Polikarpova; Nadezhda,0,0,0,0
1668210312801,CSE 240A,A00,102386,Pannuto; Patrick William,0,0,0,0
1668210313228,CSE 240B,A00,102387,Zhao; Jishen,0,0,0,0
1668210313656,CSE 241A,A00,106406,Kang; Mingu,0,0,0,0
1668210314094,CSE 249B,A00,102388,Kahng; Andrew Byun,0,0,8,8
1668210314516,CSE 251B,A01,102392,Cottrell; Garrison W,0,0,0,0
1668210314516,CSE 251B,A02,102393,Cottrell; Garrison W,0,0,0,0
1668210314941,CSE 252B,A00,102394,Ochoa; Benjamin Lawrence,0,0,0,0
1668210315374,CSE 257,A01,102396,Gao; Sicun,0,0,0,0
1668210315805,CSE 272,A00,102397,Li; Tzumao,0,0,0,0
1668210316228,CSE 274,A00,111323,Chern; Albert Ren-Haur,0,0,0,0
1668210316660,CSE 282,A00,102398,Pevzner; Pavel Arkadjevich,0,0,0,0
1668210317083,CSE 284,A00,114175,Gymrek; Melissa Ann,0,0,0,0
1668210317507,CSE 290,A00,102399,Chandraker; Manmohan Krishna,0,0,0,0
1668210317507,CSE 290,B00,102400,Vaccaro; Kristen Marie,0,0,25,25
1668210317507,CSE 290,C00,102414,Pannuto; Patrick William,0,0,25,25
1668210317507,CSE 290,D00,102427,Pevzner; Pavel Arkadjevich,0,0,0,0
1668210317507,CSE 290,E00,102429,Zhao; Jishen,0,0,0,0
1668210317507,CSE 290,F00,102436,Tullsen; Dean Michael,0,0,0,0
1668210317507,CSE 290,G00,102440,Christensen; Henrik I,0,0,20,20
1668210317931,CSE 291,A00,102443,Su; Hao,0,0,0,0
1668210317931,CSE 291,B00,102448,Polikarpova; Nadezhda,0,0,0,0
1668210317931,CSE 291,C00,102453,Vaccaro; Kristen Marie,0,0,0,0
1668210317931,CSE 291,D00,111343,Savage; Stefan,0,0,0,0
1668210317931,CSE 291,E00,116474,Claffy; Kimberly Claire,0,0,0,0
1668210317931,CSE 291,F00,116479,Pasquale; Joseph,0,0,0,0
1668210318373,CSE 293,001,119111,Bafna; Vineet,9999,0,9999,0
1668210318373,CSE 293,002,119118,Bellare; Mihir,9999,0,9999,0
1668210318373,CSE 293,003,119122,Berg-Kirkpatrick; Taylor D,9999,0,9999,0
1668210318373,CSE 293,004,119135,Christensen; Henrik I,9999,0,9999,0
1668210318373,CSE 293,005,119142,Cottrell; Garrison W,9999,0,9999,0
1668210318373,CSE 293,006,119146,Deutsch; Alin Bernard,9999,0,9999,0
1668210318373,CSE 293,007,119159,Esmaeilzadeh; Hadi,9999,0,9999,0
1668210318373,CSE 293,008,119166,Freund; Yoav,9999,0,9999,0
1668210318373,CSE 293,009,119170,Griswold; William G.,9999,0,9999,0
1668210318373,CSE 293,010,119183,Gymrek; Melissa Ann,9999,0,9999,0
1668210318373,CSE 293,011,119190,Heninger; Nadia A,9999,0,9999,0
1668210318373,CSE 293,012,119230,Impagliazzo; Russell,9999,0,9999,0
1668210318373,CSE 293,013,119232,Jhala; Ranjit,9999,0,9999,0
1668210318373,CSE 293,014,119233,Kahng; Andrew Byun,9999,0,9999,0
1668210318373,CSE 293,015,119298,Kane; Daniel Mertz,9999,0,9999,0
1668210318373,CSE 293,016,119299,Kriegman; David J,9999,0,9999,0
1668210318373,CSE 293,017,119300,Kumar; Arun Kumar,9999,0,9999,0
1668210318373,CSE 293,018,119301,Lerner; Sorin,9999,0,9999,0
1668210318373,CSE 293,019,119302,Lovett; Shachar,9999,0,9999,0
1668210318373,CSE 293,020,119303,McAuley; Julian John,9999,0,9999,0
1668210318373,CSE 293,021,119304,Micciancio; Daniele,9999,0,9999,0
1668210318373,CSE 293,022,119367,Orailoglu; Alex,9999,0,9999,0
1668210318373,CSE 293,023,119382,Paturi; Ramamohan,9999,0,9999,0
1668210318373,CSE 293,024,119404,Polikarpova; Nadezhda,9999,0,9999,0
1668210318373,CSE 293,025,119406,Politz; Joseph Gibbs,9999,0,9999,0
1668210318373,CSE 293,026,119411,Porter; George M,9999,0,9999,0
1668210318373,CSE 293,027,119414,Porter; Leonard Emerson,9999,0,9999,0
1668210318373,CSE 293,028,119416,Ramamoorthi; Ravi,9999,0,9999,0
1668210318373,CSE 293,029,119417,Sahoo; Debashis,9999,0,9999,0
1668210318373,CSE 293,030,119420,Saul; Lawrence,9999,0,9999,0
1668210318373,CSE 293,031,119421,Savage; Stefan,9999,0,9999,0
1668210318373,CSE 293,032,119425,Schulze; Jurgen P.,9999,0,9999,0
1668210318373,CSE 293,033,119426,Snoeren; Alex C.,9999,0,9999,0
1668210318373,CSE 293,034,119428,Shang; Jingbo,9999,0,9999,0
1668210318373,CSE 293,035,119430,Stefan; Deian,9999,0,9999,0
1668210318373,CSE 293,036,119431,Su; Hao,9999,0,9999,0
1668210318373,CSE 293,037,119433,Swanson; Steven James,9999,0,9999,0
1668210318373,CSE 293,038,119435,Tullsen; Dean Michael,9999,0,9999,0
1668210318373,CSE 293,039,119483,Voelker; Geoffrey M.,9999,0,9999,0
1668210318373,CSE 293,040,119537,Zhao; Jishen,9999,0,9999,0
1668210318373,CSE 293,041,119538,Zhou; Yuan-Yuan,9999,0,9999,0
1668210318373,CSE 293,042,119539,Gao; Sicun,9999,0,9999,0
1668210318373,CSE 293,043,119540,Weibel; Nadir,9999,0,9999,0
1668210318373,CSE 293,044,119541,Gupta; Rajesh K.,9999,0,9999,0
1668210318373,CSE 293,045,126410,Vaccaro; Kristen Marie,9999,0,9999,0
1668210318373,CSE 293,046,126411,Klemke; Richard,9999,0,9999,0
1668210318816,CSE 294,A00,102459,Voelker; Geoffrey M.,0,0,0,0
1668210318816,CSE 294,B00,111322,Orailoglu; Alex,0,0,0,0
1668210319242,DSE 201,A00,096914,Deutsch; Alin Bernard,30,0,30,0
1668210319663,DSE 210,A00,096915,Dasgupta; Sanjoy,30,0,30,0
1668210320090,DSE 260A,A00,096916,Altintas De Callaf; Ilkay,30,0,30,0
1668210320521,ECE 200,001,103586,Antipa; Nicholas A,9999,0,9999,0
1668210320521,ECE 200,002,103587,Atanasov; Nikolay A.,9999,0,9999,0
1668210320521,ECE 200,003,103588,Bharadia; Dinesh,9999,0,9999,0
1668210320521,ECE 200,004,103589,Cheng; Chung Kuan,9999,0,9999,0
1668210320521,ECE 200,005,103590,Cosman; Pamela C.,9999,0,9999,0
1668210320521,ECE 200,006,103591,Dayeh; Shadi Ahmad,9999,0,9999,0
1668210320521,ECE 200,007,103592,Fainman; Yeshaiahu,9999,0,9999,0
1668210320521,ECE 200,008,103593,Ford; Joseph Earl,9999,0,9999,0
1668210320521,ECE 200,009,103594,Franceschetti; Massimo,9999,0,9999,0
1668210320521,ECE 200,010,103595,Fullerton; Eric E,9999,0,9999,0
1668210320521,ECE 200,011,103596,Galton; Ian A,9999,0,9999,0
1668210320521,ECE 200,012,103597,Gilja; Vikash,9999,0,9999,0
1668210320521,ECE 200,013,103598,Hall; Drew A.,9999,0,9999,0
1668210320521,ECE 200,014,103599,Hsueh; Tzu-Chien,9999,0,9999,0
1668210320521,ECE 200,015,103600,Javidi; Tara,9999,0,9999,0
1668210320521,ECE 200,016,103601,Kahng; Andrew Byun,9999,0,9999,0
1668210320521,ECE 200,017,103602,Kim; Young-Han,9999,0,9999,0
1668210320521,ECE 200,018,103603,Koushanfar; Farinaz,9999,0,9999,0
1668210320521,ECE 200,019,103604,Kuzum; Duygu,9999,0,9999,0
1668210320521,ECE 200,020,103605,Le; Hanh-Phuc,9999,0,9999,0
1668210320521,ECE 200,021,103606,Lin; Bill,9999,0,9999,0
1668210320521,ECE 200,022,103607,Liu; Zhaowei,9998,0,9999,1
1668210320521,ECE 200,023,103608,Lo; Yu-Hwa,9999,0,9999,0
1668210320521,ECE 200,024,103609,Lomakin; Vitaliy,9999,0,9999,0
1668210320521,ECE 200,025,103610,Mercier; Patrick Philip,9999,0,9999,0
1668210320521,ECE 200,026,103611,Meyer; Florian,9999,0,9999,0
1668210320521,ECE 200,027,103612,Milstein; Laurence B.,9999,0,9999,0
1668210320521,ECE 200,028,103613,Mir Arabbaygi; Siavash,9999,0,9999,0
1668210320521,ECE 200,029,103614,Mookherjea; Shayan,9999,0,9999,0
1668210320521,ECE 200,030,103615,Morris; Karcher William,9999,0,9999,0
1668210320521,ECE 200,031,103616,Ng; Tse Nga,9999,0,9999,0
1668210320521,ECE 200,032,103617,Nguyen; Truong Quang,9999,0,9999,0
1668210320521,ECE 200,033,103618,Nomura; Kenji,9999,0,9999,0
1668210320521,ECE 200,034,103619,Orlitsky; Alon,9999,0,9999,0
1668210320521,ECE 200,035,103620,Pal; Piya,9999,0,9999,0
1668210320521,ECE 200,036,103621,Papen; George C.,9999,0,9999,0
1668210320521,ECE 200,037,103622,Radic; Stojan,9999,0,9999,0
1668210320521,ECE 200,038,103623,Rao; Bhaskar D.,9999,0,9999,0
1668210320521,ECE 200,039,103624,Rao; Ramesh R,9999,0,9999,0
1668210320521,ECE 200,040,103625,Rebeiz; Gabriel,9999,0,9999,0
1668210320521,ECE 200,041,103626,Sanford; John R,9999,0,9999,0
1668210320521,ECE 200,042,103627,Siegel; Paul H.,9999,0,9999,0
1668210320521,ECE 200,043,103628,Sievenpiper; Daniel F.,9999,0,9999,0
1668210320521,ECE 200,044,103629,Sworder; David D.,9999,0,9999,0
1668210320521,ECE 200,045,103630,Taur; Yuan,9999,0,9999,0
1668210320521,ECE 200,046,103631,Touri; Behrouz,9999,0,9999,0
1668210320521,ECE 200,047,103632,Trivedi; Mohan M.,9999,0,9999,0
1668210320521,ECE 200,048,103633,Vasconcelos; Nuno,9999,0,9999,0
1668210320521,ECE 200,049,103634,Wang; Xiaolong,9999,0,9999,0
1668210320521,ECE 200,050,103635,Xie; Pengtao,9999,0,9999,0
1668210320521,ECE 200,051,103636,Yip; Michael,9999,0,9999,0
1668210320521,ECE 200,052,103637,Zeger; Kenneth A.,999,0,999,0
1668210320521,ECE 200,053,103638,Zhang; Xinyu,9999,0,9999,0
1668210320521,ECE 200,054,103639,Turakhia; Yatish Girish,9999,0,9999,0
1668210320521,ECE 200,055,103640,Kang; Mingu,9999,0,9999,0
1668210320521,ECE 200,056,103641,Shi; Yuanyuan,9999,0,9999,0
1668210320521,ECE 200,057,103642,Wang; Edward Jay,9999,0,9999,0
1668210320521,ECE 200,058,103643,Zheng; Yang,9999,0,9999,0
1668210320949,ECE 202,A00,103644,Kuzum; Duygu,0,0,0,0
1668210321372,ECE 212BN,A00,103646,Ng; Tse Nga,0,0,0,0
1668210321795,ECE 221,A00,111493,Staff,0,0,0,0
1668210322230,ECE 222B,A00,103647,Lomakin; Vitaliy,0,0,0,0
1668210322665,ECE 230B,A00,103648,Taur; Yuan,0,0,0,0
1668210323095,ECE 238B,A00,103649,Garay; Javier,0,0,0,0
1668210323520,ECE 240B,A00,112900,Fainman; Yeshaiahu,0,0,0,0
1668210323946,ECE 247A,A00,103650,Jokerst; Jesse Vincent,0,0,0,0
1668210324374,ECE 247B,A00,103651,Wang; Joseph,0,0,0,0
1668210324815,ECE 250,A00,103652,Siegel; Paul H.,0,0,0,0
1668210325249,ECE 251A,A00,103654,Rao; Bhaskar D.,0,0,0,0
1668210325670,ECE 257B,A00,103655,Bharadia; Dinesh,0,0,0,0
1668210326109,ECE 258A,A00,103656,Milstein; Laurence B.,0,0,0,0
1668210326542,ECE 260B,A00,103658,Kang; Mingu,0,0,0,0
1668210326978,ECE 264A,A00,103659,Galton; Ian A,0,0,0,0
1668210327405,ECE 265A,A00,103661,Gudem; Prasad S.S.,0,0,0,0
1668210327829,ECE 265D,A00,103662,Gudem; Prasad S.S.,0,0,0,0
1668210328256,ECE 268,A00,103663,Koushanfar; Farinaz,0,0,0,0
1668210328678,ECE 269,A01,103665,Pal; Piya,0,0,0,0
1668210329101,ECE 271B,A00,103666,Vasconcelos; Manuela,0,0,0,0
1668210329530,ECE 276A,A00,103667,Atanasov; Nikolay A.,0,0,0,0
1668210329959,ECE 277,A00,103668,An; Cheolhong,0,0,0,0
1668210330384,ECE 279,A00,117947,Hall; Drew A.,0,0,0,0
1668210331235,ECE 283,A00,103670,Hsueh; Tzu-Chien,0,0,0,0
1668210331665,ECE 284,A00,103671,Turakhia; Yatish Girish,0,0,0,0
1668210332089,ECE 285,A00,103672,Zheng; Yang,0,0,0,0
1668210332089,ECE 285,B00,103673,Sworder; David D.,0,0,0,0
1668210332515,ECE 287,A00,103676,Javidi; Tara,0,0,0,0
1668210332945,MATH 200B,A00,098023,Salehi Golsefidy; Alireza,12,0,15,3
1668210333371,MATH 202B,A00,098024,Rhoades; Brendon Patrick,9,0,15,6
1668210333793,MATH 203B,A00,098025,Oprea; Dragos N.,10,0,15,5
1668210334218,MATH 204B,A00,098026,Sorensen; Claus M,13,0,15,2
1668210334714,MATH 208,A00,098027,Izadi; Elham,7,0,10,3
1668210335152,MATH 209,A00,098028,Pollack; Aaron,10,0,10,0
1668210335579,MATH 211A,A00,112919,Rogalski; Daniel,9,0,10,1
1668210336008,MATH 211B,A00,112920,Seward; Brandon M.,9,0,10,1
1668210336432,MATH 218,A00,098029,Li; Bo,10,0,10,0
1668210336854,MATH 220B,A00,098030,Novak; Jonathan I,11,0,15,4
1668210337290,MATH 221A,A00,098031,Ebenfelt; Peter F,13,0,15,2
1668210337720,MATH 231B,A00,098032,Zlatos; Andrej,12,0,15,3
1668210338143,MATH 240B,A00,098033,Ni; Lei,9,0,15,6
1668210338579,MATH 243,A00,098034,Jekel; David Andrew,10,0,10,0
1668210339003,MATH 245A,A00,098035,Nie; Jiawang,0,0,15,16
1668210339428,MATH 248,A00,098036,Bejenaru; Ioan,10,0,10,0
1668210339850,MATH 250B,A00,098037,Spolaor; Luca,14,0,15,1
1668210340274,MATH 258,A00,098038,Ni; Lei,10,0,10,0
1668210340701,MATH 264B,A00,098041,Rhoades; Brendon Patrick,9,0,15,6
1668210341128,MATH 268,A00,098042,Buss; Samuel R,10,0,10,0
1668210341550,MATH 269,A00,098043,Rhoades; Brendon Patrick,10,0,10,0
1668210341979,MATH 270B,A00,098044,Li; Bo,10,0,15,5
1668210342403,MATH 272B,A00,098045,Holst; Michael J,13,0,15,2
1668210342829,MATH 273A,A00,098046,Tian; Xiaochuan,10,0,15,5
1668210343260,MATH 275,A01,098048,Tian; Xiaochuan,6,0,10,4
1668210343683,MATH 278A,A00,098049,Holst; Michael J,8,0,10,2
1668210344106,MATH 278B,A00,098050,Cloninger; Alexander,10,0,10,0
1668210344529,MATH 278C,A00,098051,Nie; Jiawang,7,0,10,3
1668210344971,MATH 280B,A00,098052,Zheng; Tianyi,10,0,15,5
1668210345403,MATH 281B,A00,098053,Bradic; Jelena,2,0,15,13
1668210345837,MATH 282B,A00,098054,Arias-Castro; Ery,0,0,15,15
1668210346267,MATH 285,A00,098055,Fitzsimmons; Patrick J,0,0,15,17
1668210346711,MATH 287B,A00,098056,Arias-Castro; Ery,2,0,15,13
1668210347139,MATH 288,A00,098057,Agarwal; Pooja,9,0,10,1
1668210347139,MATH 288,B00,098058,Zhang; Danna,8,0,10,2
1668210347139,MATH 288,C00,098059,Williams; Ruth J,10,0,10,0
1668210347560,MATH 290B,A00,098060,Roberts; Justin Deritter,13,0,15,2
1668210347986,MATH 292,A00,098061,Belmont; Eva Kinoshita,10,0,10,0
1668210348412,MATH 295,A00,098062,Suk; Andrew Hoon,48,0,50,2
1668210348836,MATH 296,A00,098063,Novak; Jonathan I,20,0,20,0
1668210349262,MATH 297,001,098064,Gamst; Anthony Collins,9997,0,9999,2
1668210850959,COGS 205,A00,101395,Chiba; Andrea,19,0,20,1
1668210851396,COGS 210B,001,101404,Greene; Deanna Jacquelyn,9998,0,9999,1
1668210851396,COGS 210B,002,101417,Xia; Haijun,9999,0,9999,0
1668210851396,COGS 210B,003,101422,Nitz; Douglas A.,9999,0,9999,0
1668210851396,COGS 210B,004,101423,Hollan; James D.,9998,0,9999,1
1668210851396,COGS 210B,005,101424,Deak; Gedeon O.,9998,0,9999,1
1668210851396,COGS 210B,006,101425,Rossano; Federico,9999,0,9999,0
1668210851831,COGS 211B,A00,101427,Coulson; Seana M,9996,0,9999,3
1668210852253,COGS 220,A00,101428,Hollan; James D.,0,0,25,25
1668210852676,COGS 229,A00,101429,Dow; Steven P,18,0,25,7
1668210853101,COGS 230,A00,101430,Klemmer; Scott R,12,0,17,5
1668210853527,COGS 234,A00,101431,Xia; Haijun,2,0,25,23
1668210853953,COGS 260,A00,101432,Kiyonaga; Anastasia,21,0,25,4
1668210853953,COGS 260,B00,101433,Kirsh; David Joel,15,0,25,10
1668210854387,CSE 202,A00,102371,Impagliazzo; Russell,0,0,0,0
1668210854814,CSE 203B,A01,102373,Cheng; Chung Kuan,0,0,0,0
1668210855239,CSE 208,A00,102374,Micciancio; Daniele,0,0,0,0
1668210855660,CSE 209A,A00,112895,Impagliazzo; Russell,0,0,15,15
1668210856084,CSE 209B,A00,108005,Bellare; Mihir,0,0,0,0
1668210856581,CSE 210,A00,113163,Coblenz; Michael J,0,0,0,0
1668210857005,CSE 219,A00,106111,Dow; Steven P,0,0,20,20
1668210857435,CSE 221,A00,102376,Voelker; Geoffrey M.,0,0,0,0
1668210857864,CSE 224,A01,102378,Porter; George M,0,0,0,0
1668210858290,CSE 229A,A00,102379,Savage; Stefan,0,0,0,0
1668210858722,CSE 229C,A00,102380,Munyaka; Imani N. S.,0,0,0,0
1668210859151,CSE 232B,A00,102382,Deutsch; Alin Bernard,0,0,0,0
1668210859587,CSE 234,A01,112904,Kumar; Arun Kumar,0,0,0,0
1668210860015,CSE 237A,A00,102383,Rosing; Tajana Simunic,0,0,0,0
1668210860448,CSE 239A,A00,102384,Deutsch; Alin Bernard,0,0,0,0
1668210860871,CSE 239B,A00,102385,Polikarpova; Nadezhda,0,0,0,0
1668210861295,CSE 240A,A00,102386,Pannuto; Patrick William,0,0,0,0
1668210861717,CSE 240B,A00,102387,Zhao; Jishen,0,0,0,0
1668210862144,CSE 241A,A00,106406,Kang; Mingu,0,0,0,0
1668210862567,CSE 249B,A00,102388,Kahng; Andrew Byun,0,0,8,8
1668210862994,CSE 251B,A01,102392,Cottrell; Garrison W,0,0,0,0
1668210862994,CSE 251B,A02,102393,Cottrell; Garrison W,0,0,0,0
1668210863424,CSE 252B,A00,102394,Ochoa; Benjamin Lawrence,0,0,0,0
1668210863845,CSE 257,A01,102396,Gao; Sicun,0,0,0,0
1668210864279,CSE 272,A00,102397,Li; Tzumao,0,0,0,0
1668210864703,CSE 274,A00,111323,Chern; Albert Ren-Haur,0,0,0,0
1668210865129,CSE 282,A00,102398,Pevzner; Pavel Arkadjevich,0,0,0,0
1668210865554,CSE 284,A00,114175,Gymrek; Melissa Ann,0,0,0,0
1668210865979,CSE 290,A00,102399,Chandraker; Manmohan Krishna,0,0,0,0
1668210865979,CSE 290,B00,102400,Vaccaro; Kristen Marie,0,0,25,25
1668210865979,CSE 290,C00,102414,Pannuto; Patrick William,0,0,25,25
1668210865979,CSE 290,D00,102427,Pevzner; Pavel Arkadjevich,0,0,0,0
1668210865979,CSE 290,E00,102429,Zhao; Jishen,0,0,0,0
1668210865979,CSE 290,F00,102436,Tullsen; Dean Michael,0,0,0,0
1668210865979,CSE 290,G00,102440,Christensen; Henrik I,0,0,20,20
1668210866404,CSE 291,A00,102443,Su; Hao,0,0,0,0
1668210866404,CSE 291,B00,102448,Polikarpova; Nadezhda,0,0,0,0
1668210866404,CSE 291,C00,102453,Vaccaro; Kristen Marie,0,0,0,0
1668210866404,CSE 291,D00,111343,Savage; Stefan,0,0,0,0
1668210866404,CSE 291,E00,116474,Claffy; Kimberly Claire,0,0,0,0
1668210866404,CSE 291,F00,116479,Pasquale; Joseph,0,0,0,0
1668210866833,CSE 293,001,119111,Bafna; Vineet,9999,0,9999,0
1668210866833,CSE 293,002,119118,Bellare; Mihir,9999,0,9999,0
1668210866833,CSE 293,003,119122,Berg-Kirkpatrick; Taylor D,9999,0,9999,0
1668210866833,CSE 293,004,119135,Christensen; Henrik I,9999,0,9999,0
1668210866833,CSE 293,005,119142,Cottrell; Garrison W,9999,0,9999,0
1668210866833,CSE 293,006,119146,Deutsch; Alin Bernard,9999,0,9999,0
1668210866833,CSE 293,007,119159,Esmaeilzadeh; Hadi,9999,0,9999,0
1668210866833,CSE 293,008,119166,Freund; Yoav,9999,0,9999,0
1668210866833,CSE 293,009,119170,Griswold; William G.,9999,0,9999,0
1668210866833,CSE 293,010,119183,Gymrek; Melissa Ann,9999,0,9999,0
1668210866833,CSE 293,011,119190,Heninger; Nadia A,9999,0,9999,0
1668210866833,CSE 293,012,119230,Impagliazzo; Russell,9999,0,9999,0
1668210866833,CSE 293,013,119232,Jhala; Ranjit,9999,0,9999,0
1668210866833,CSE 293,014,119233,Kahng; Andrew Byun,9999,0,9999,0
1668210866833,CSE 293,015,119298,Kane; Daniel Mertz,9999,0,9999,0
1668210866833,CSE 293,016,119299,Kriegman; David J,9999,0,9999,0
1668210866833,CSE 293,017,119300,Kumar; Arun Kumar,9999,0,9999,0
1668210866833,CSE 293,018,119301,Lerner; Sorin,9999,0,9999,0
1668210866833,CSE 293,019,119302,Lovett; Shachar,9999,0,9999,0
1668210866833,CSE 293,020,119303,McAuley; Julian John,9999,0,9999,0
1668210866833,CSE 293,021,119304,Micciancio; Daniele,9999,0,9999,0
1668210866833,CSE 293,022,119367,Orailoglu; Alex,9999,0,9999,0
1668210866833,CSE 293,023,119382,Paturi; Ramamohan,9999,0,9999,0
1668210866833,CSE 293,024,119404,Polikarpova; Nadezhda,9999,0,9999,0
1668210866833,CSE 293,025,119406,Politz; Joseph Gibbs,9999,0,9999,0
1668210866833,CSE 293,026,119411,Porter; George M,9999,0,9999,0
1668210866833,CSE 293,027,119414,Porter; Leonard Emerson,9999,0,9999,0
1668210866833,CSE 293,028,119416,Ramamoorthi; Ravi,9999,0,9999,0
1668210866833,CSE 293,029,119417,Sahoo; Debashis,9999,0,9999,0
1668210866833,CSE 293,030,119420,Saul; Lawrence,9999,0,9999,0
1668210866833,CSE 293,031,119421,Savage; Stefan,9999,0,9999,0
1668210866833,CSE 293,032,119425,Schulze; Jurgen P.,9999,0,9999,0
1668210866833,CSE 293,033,119426,Snoeren; Alex C.,9999,0,9999,0
1668210866833,CSE 293,034,119428,Shang; Jingbo,9999,0,9999,0
1668210866833,CSE 293,035,119430,Stefan; Deian,9999,0,9999,0
1668210866833,CSE 293,036,119431,Su; Hao,9999,0,9999,0
1668210866833,CSE 293,037,119433,Swanson; Steven James,9999,0,9999,0
1668210866833,CSE 293,038,119435,Tullsen; Dean Michael,9999,0,9999,0
1668210866833,CSE 293,039,119483,Voelker; Geoffrey M.,9999,0,9999,0
1668210866833,CSE 293,040,119537,Zhao; Jishen,9999,0,9999,0
1668210866833,CSE 293,041,119538,Zhou; Yuan-Yuan,9999,0,9999,0
1668210866833,CSE 293,042,119539,Gao; Sicun,9999,0,9999,0
1668210866833,CSE 293,043,119540,Weibel; Nadir,9999,0,9999,0
1668210866833,CSE 293,044,119541,Gupta; Rajesh K.,9999,0,9999,0
1668210866833,CSE 293,045,126410,Vaccaro; Kristen Marie,9999,0,9999,0
1668210866833,CSE 293,046,126411,Klemke; Richard,9999,0,9999,0
1668210867263,CSE 294,A00,102459,Voelker; Geoffrey M.,0,0,0,0
1668210867263,CSE 294,B00,111322,Orailoglu; Alex,0,0,0,0
1668210867687,DSE 201,A00,096914,Deutsch; Alin Bernard,30,0,30,0
1668210868114,DSE 210,A00,096915,Dasgupta; Sanjoy,30,0,30,0
1668210868538,DSE 260A,A00,096916,Altintas De Callaf; Ilkay,30,0,30,0
1668210868966,ECE 200,001,103586,Antipa; Nicholas A,9999,0,9999,0
1668210868966,ECE 200,002,103587,Atanasov; Nikolay A.,9999,0,9999,0
1668210868966,ECE 200,003,103588,Bharadia; Dinesh,9999,0,9999,0
1668210868966,ECE 200,004,103589,Cheng; Chung Kuan,9999,0,9999,0
1668210868966,ECE 200,005,103590,Cosman; Pamela C.,9999,0,9999,0
1668210868966,ECE 200,006,103591,Dayeh; Shadi Ahmad,9999,0,9999,0
1668210868966,ECE 200,007,103592,Fainman; Yeshaiahu,9999,0,9999,0
1668210868966,ECE 200,008,103593,Ford; Joseph Earl,9999,0,9999,0
1668210868966,ECE 200,009,103594,Franceschetti; Massimo,9999,0,9999,0
1668210868966,ECE 200,010,103595,Fullerton; Eric E,9999,0,9999,0
1668210868966,ECE 200,011,103596,Galton; Ian A,9999,0,9999,0
1668210868966,ECE 200,012,103597,Gilja; Vikash,9999,0,9999,0
1668210868966,ECE 200,013,103598,Hall; Drew A.,9999,0,9999,0
1668210868966,ECE 200,014,103599,Hsueh; Tzu-Chien,9999,0,9999,0
1668210868966,ECE 200,015,103600,Javidi; Tara,9999,0,9999,0
1668210868966,ECE 200,016,103601,Kahng; Andrew Byun,9999,0,9999,0
1668210868966,ECE 200,017,103602,Kim; Young-Han,9999,0,9999,0
1668210868966,ECE 200,018,103603,Koushanfar; Farinaz,9999,0,9999,0
1668210868966,ECE 200,019,103604,Kuzum; Duygu,9999,0,9999,0
1668210868966,ECE 200,020,103605,Le; Hanh-Phuc,9999,0,9999,0
1668210868966,ECE 200,021,103606,Lin; Bill,9999,0,9999,0
1668210868966,ECE 200,022,103607,Liu; Zhaowei,9998,0,9999,1
1668210868966,ECE 200,023,103608,Lo; Yu-Hwa,9999,0,9999,0
1668210868966,ECE 200,024,103609,Lomakin; Vitaliy,9999,0,9999,0
1668210868966,ECE 200,025,103610,Mercier; Patrick Philip,9999,0,9999,0
1668210868966,ECE 200,026,103611,Meyer; Florian,9999,0,9999,0
1668210868966,ECE 200,027,103612,Milstein; Laurence B.,9999,0,9999,0
1668210868966,ECE 200,028,103613,Mir Arabbaygi; Siavash,9999,0,9999,0
1668210868966,ECE 200,029,103614,Mookherjea; Shayan,9999,0,9999,0
1668210868966,ECE 200,030,103615,Morris; Karcher William,9999,0,9999,0
1668210868966,ECE 200,031,103616,Ng; Tse Nga,9999,0,9999,0
1668210868966,ECE 200,032,103617,Nguyen; Truong Quang,9999,0,9999,0
1668210868966,ECE 200,033,103618,Nomura; Kenji,9999,0,9999,0
1668210868966,ECE 200,034,103619,Orlitsky; Alon,9999,0,9999,0
1668210868966,ECE 200,035,103620,Pal; Piya,9999,0,9999,0
1668210868966,ECE 200,036,103621,Papen; George C.,9999,0,9999,0
1668210868966,ECE 200,037,103622,Radic; Stojan,9999,0,9999,0
1668210868966,ECE 200,038,103623,Rao; Bhaskar D.,9999,0,9999,0
1668210868966,ECE 200,039,103624,Rao; Ramesh R,9999,0,9999,0
1668210868966,ECE 200,040,103625,Rebeiz; Gabriel,9999,0,9999,0
1668210868966,ECE 200,041,103626,Sanford; John R,9999,0,9999,0
1668210868966,ECE 200,042,103627,Siegel; Paul H.,9999,0,9999,0
1668210868966,ECE 200,043,103628,Sievenpiper; Daniel F.,9999,0,9999,0
1668210868966,ECE 200,044,103629,Sworder; David D.,9999,0,9999,0
1668210868966,ECE 200,045,103630,Taur; Yuan,9999,0,9999,0
1668210868966,ECE 200,046,103631,Touri; Behrouz,9999,0,9999,0
1668210868966,ECE 200,047,103632,Trivedi; Mohan M.,9999,0,9999,0
1668210868966,ECE 200,048,103633,Vasconcelos; Nuno,9999,0,9999,0
1668210868966,ECE 200,049,103634,Wang; Xiaolong,9999,0,9999,0
1668210868966,ECE 200,050,103635,Xie; Pengtao,9999,0,9999,0
1668210868966,ECE 200,051,103636,Yip; Michael,9999,0,9999,0
1668210868966,ECE 200,052,103637,Zeger; Kenneth A.,999,0,999,0
1668210868966,ECE 200,053,103638,Zhang; Xinyu,9999,0,9999,0
1668210868966,ECE 200,054,103639,Turakhia; Yatish Girish,9999,0,9999,0
1668210868966,ECE 200,055,103640,Kang; Mingu,9999,0,9999,0
1668210868966,ECE 200,056,103641,Shi; Yuanyuan,9999,0,9999,0
1668210868966,ECE 200,057,103642,Wang; Edward Jay,9999,0,9999,0
1668210868966,ECE 200,058,103643,Zheng; Yang,9999,0,9999,0
1668210869399,ECE 202,A00,103644,Kuzum; Duygu,0,0,0,0
1668210869825,ECE 212BN,A00,103646,Ng; Tse Nga,0,0,0,0
1668210870253,ECE 221,A00,111493,Staff,0,0,0,0
1668210870677,ECE 222B,A00,103647,Lomakin; Vitaliy,0,0,0,0
1668210871108,ECE 230B,A00,103648,Taur; Yuan,0,0,0,0
1668210871533,ECE 238B,A00,103649,Garay; Javier,0,0,0,0
1668210871965,ECE 240B,A00,112900,Fainman; Yeshaiahu,0,0,0,0
1668210872390,ECE 247A,A00,103650,Jokerst; Jesse Vincent,0,0,0,0
1668210872817,ECE 247B,A00,103651,Wang; Joseph,0,0,0,0
1668210873239,ECE 250,A00,103652,Siegel; Paul H.,0,0,0,0
1668210873667,ECE 251A,A00,103654,Rao; Bhaskar D.,0,0,0,0
1668210874107,ECE 257B,A00,103655,Bharadia; Dinesh,0,0,0,0
1668210874528,ECE 258A,A00,103656,Milstein; Laurence B.,0,0,0,0
1668210874952,ECE 260B,A00,103658,Kang; Mingu,0,0,0,0
1668210875375,ECE 264A,A00,103659,Galton; Ian A,0,0,0,0
1668210875799,ECE 265A,A00,103661,Gudem; Prasad S.S.,0,0,0,0
1668210876227,ECE 265D,A00,103662,Gudem; Prasad S.S.,0,0,0,0
1668210876650,ECE 268,A00,103663,Koushanfar; Farinaz,0,0,0,0
1668210877089,ECE 269,A01,103665,Pal; Piya,0,0,0,0
1668210877512,ECE 271B,A00,103666,Vasconcelos; Manuela,0,0,0,0
1668210877959,ECE 276A,A00,103667,Atanasov; Nikolay A.,0,0,0,0
1668210878383,ECE 277,A00,103668,An; Cheolhong,0,0,0,0
1668210878810,ECE 279,A00,117947,Hall; Drew A.,0,0,0,0
1668210879660,ECE 283,A00,103670,Hsueh; Tzu-Chien,0,0,0,0
1668210880090,ECE 284,A00,103671,Turakhia; Yatish Girish,0,0,0,0
1668210880524,ECE 285,A00,103672,Zheng; Yang,0,0,0,0
1668210880524,ECE 285,B00,103673,Sworder; David D.,0,0,0,0
1668210880954,ECE 287,A00,103676,Javidi; Tara,0,0,0,0
1668210881378,MATH 200B,A00,098023,Salehi Golsefidy; Alireza,12,0,15,3
1668210881804,MATH 202B,A00,098024,Rhoades; Brendon Patrick,9,0,15,6
1668210882231,MATH 203B,A00,098025,Oprea; Dragos N.,10,0,15,5
1668210882658,MATH 204B,A00,098026,Sorensen; Claus M,13,0,15,2
1668210883089,MATH 208,A00,098027,Izadi; Elham,7,0,10,3
1668210883519,MATH 209,A00,098028,Pollack; Aaron,10,0,10,0
1668210883944,MATH 211A,A00,112919,Rogalski; Daniel,9,0,10,1
1668210884371,MATH 211B,A00,112920,Seward; Brandon M.,9,0,10,1
1668210884809,MATH 218,A00,098029,Li; Bo,10,0,10,0
1668210885238,MATH 220B,A00,098030,Novak; Jonathan I,11,0,15,4
1668210885660,MATH 221A,A00,098031,Ebenfelt; Peter F,13,0,15,2
1668210886082,MATH 231B,A00,098032,Zlatos; Andrej,12,0,15,3
1668210886504,MATH 240B,A00,098033,Ni; Lei,9,0,15,6
1668210886931,MATH 243,A00,098034,Jekel; David Andrew,10,0,10,0
1668210887366,MATH 245A,A00,098035,Nie; Jiawang,0,0,15,16
1668210887792,MATH 248,A00,098036,Bejenaru; Ioan,10,0,10,0
1668210888214,MATH 250B,A00,098037,Spolaor; Luca,14,0,15,1
1668210888642,MATH 258,A00,098038,Ni; Lei,10,0,10,0
1668210889073,MATH 264B,A00,098041,Rhoades; Brendon Patrick,9,0,15,6
1668210889498,MATH 268,A00,098042,Buss; Samuel R,10,0,10,0
1668210889927,MATH 269,A00,098043,Rhoades; Brendon Patrick,10,0,10,0
1668210890360,MATH 270B,A00,098044,Li; Bo,10,0,15,5
1668210890783,MATH 272B,A00,098045,Holst; Michael J,13,0,15,2
1668210891212,MATH 273A,A00,098046,Tian; Xiaochuan,10,0,15,5
1668210891634,MATH 275,A01,098048,Tian; Xiaochuan,6,0,10,4
1668210892139,MATH 278A,A00,098049,Holst; Michael J,8,0,10,2
1668210892562,MATH 278B,A00,098050,Cloninger; Alexander,10,0,10,0
1668210892993,MATH 278C,A00,098051,Nie; Jiawang,7,0,10,3
1668210893420,MATH 280B,A00,098052,Zheng; Tianyi,10,0,15,5
1668210893847,MATH 281B,A00,098053,Bradic; Jelena,2,0,15,13
1668210894274,MATH 282B,A00,098054,Arias-Castro; Ery,0,0,15,15
1668210894700,MATH 285,A00,098055,Fitzsimmons; Patrick J,0,0,15,17
1668210895123,MATH 287B,A00,098056,Arias-Castro; Ery,2,0,15,13
1668210895549,MATH 288,A00,098057,Agarwal; Pooja,9,0,10,1
1668210895549,MATH 288,B00,098058,Zhang; Danna,8,0,10,2
1668210895549,MATH 288,C00,098059,Williams; Ruth J,10,0,10,0
1668210895975,MATH 290B,A00,098060,Roberts; Justin Deritter,13,0,15,2
1668210896396,MATH 292,A00,098061,Belmont; Eva Kinoshita,10,0,10,0
1668210896828,MATH 295,A00,098062,Suk; Andrew Hoon,48,0,50,2
1668210897257,MATH 296,A00,098063,Novak; Jonathan I,20,0,20,0
1668210897679,MATH 297,001,098064,Gamst; Anthony Collins,9997,0,9999,2
1668211399057,COGS 205,A00,101395,Chiba; Andrea,19,0,20,1
1668211399490,COGS 210B,001,101404,Greene; Deanna Jacquelyn,9998,0,9999,1
1668211399490,COGS 210B,002,101417,Xia; Haijun,9999,0,9999,0
1668211399490,COGS 210B,003,101422,Nitz; Douglas A.,9999,0,9999,0
1668211399490,COGS 210B,004,101423,Hollan; James D.,9998,0,9999,1
1668211399490,COGS 210B,005,101424,Deak; Gedeon O.,9998,0,9999,1
1668211399490,COGS 210B,006,101425,Rossano; Federico,9999,0,9999,0
1668211399921,COGS 211B,A00,101427,Coulson; Seana M,9996,0,9999,3
1668211400352,COGS 220,A00,101428,Hollan; James D.,0,0,25,25
1668211400788,COGS 229,A00,101429,Dow; Steven P,18,0,25,7
1668211401213,COGS 230,A00,101430,Klemmer; Scott R,12,0,17,5
1668211401634,COGS 234,A00,101431,Xia; Haijun,2,0,25,23
1668211402058,COGS 260,A00,101432,Kiyonaga; Anastasia,21,0,25,4
1668211402058,COGS 260,B00,101433,Kirsh; David Joel,15,0,25,10
1668211402480,CSE 202,A00,102371,Impagliazzo; Russell,0,0,0,0
1668211402909,CSE 203B,A01,102373,Cheng; Chung Kuan,0,0,0,0
1668211403332,CSE 208,A00,102374,Micciancio; Daniele,0,0,0,0
1668211403757,CSE 209A,A00,112895,Impagliazzo; Russell,0,0,15,15
1668211404180,CSE 209B,A00,108005,Bellare; Mihir,0,0,0,0
1668211404609,CSE 210,A00,113163,Coblenz; Michael J,0,0,0,0
1668211405033,CSE 219,A00,106111,Dow; Steven P,0,0,20,20
1668211405461,CSE 221,A00,102376,Voelker; Geoffrey M.,0,0,0,0
1668211405886,CSE 224,A01,102378,Porter; George M,0,0,0,0
1668211406311,CSE 229A,A00,102379,Savage; Stefan,0,0,0,0
1668211406737,CSE 229C,A00,102380,Munyaka; Imani N. S.,0,0,0,0
1668211407165,CSE 232B,A00,102382,Deutsch; Alin Bernard,0,0,0,0
1668211407590,CSE 234,A01,112904,Kumar; Arun Kumar,0,0,0,0
1668211408016,CSE 237A,A00,102383,Rosing; Tajana Simunic,0,0,0,0
1668211408445,CSE 239A,A00,102384,Deutsch; Alin Bernard,0,0,0,0
1668211408869,CSE 239B,A00,102385,Polikarpova; Nadezhda,0,0,0,0
1668211409292,CSE 240A,A00,102386,Pannuto; Patrick William,0,0,0,0
1668211409725,CSE 240B,A00,102387,Zhao; Jishen,0,0,0,0
1668211410151,CSE 241A,A00,106406,Kang; Mingu,0,0,0,0
1668211410576,CSE 249B,A00,102388,Kahng; Andrew Byun,0,0,8,8
1668211411010,CSE 251B,A01,102392,Cottrell; Garrison W,0,0,0,0
1668211411010,CSE 251B,A02,102393,Cottrell; Garrison W,0,0,0,0
1668211411437,CSE 252B,A00,102394,Ochoa; Benjamin Lawrence,0,0,0,0
1668211411861,CSE 257,A01,102396,Gao; Sicun,0,0,0,0
1668211412291,CSE 272,A00,102397,Li; Tzumao,0,0,0,0
1668211412716,CSE 274,A00,111323,Chern; Albert Ren-Haur,0,0,0,0
1668211413144,CSE 282,A00,102398,Pevzner; Pavel Arkadjevich,0,0,0,0
1668211413570,CSE 284,A00,114175,Gymrek; Melissa Ann,0,0,0,0
1668211414000,CSE 290,A00,102399,Chandraker; Manmohan Krishna,0,0,0,0
1668211414000,CSE 290,B00,102400,Vaccaro; Kristen Marie,0,0,25,25
1668211414000,CSE 290,C00,102414,Pannuto; Patrick William,0,0,25,25
1668211414000,CSE 290,D00,102427,Pevzner; Pavel Arkadjevich,0,0,0,0
1668211414000,CSE 290,E00,102429,Zhao; Jishen,0,0,0,0
1668211414000,CSE 290,F00,102436,Tullsen; Dean Michael,0,0,0,0
1668211414000,CSE 290,G00,102440,Christensen; Henrik I,0,0,20,20
1668211414433,CSE 291,A00,102443,Su; Hao,0,0,0,0
1668211414433,CSE 291,B00,102448,Polikarpova; Nadezhda,0,0,0,0
1668211414433,CSE 291,C00,102453,Vaccaro; Kristen Marie,0,0,0,0
1668211414433,CSE 291,D00,111343,Savage; Stefan,0,0,0,0
1668211414433,CSE 291,E00,116474,Claffy; Kimberly Claire,0,0,0,0
1668211414433,CSE 291,F00,116479,Pasquale; Joseph,0,0,0,0
1668211414869,CSE 293,001,119111,Bafna; Vineet,9999,0,9999,0
1668211414869,CSE 293,002,119118,Bellare; Mihir,9999,0,9999,0
1668211414869,CSE 293,003,119122,Berg-Kirkpatrick; Taylor D,9999,0,9999,0
1668211414869,CSE 293,004,119135,Christensen; Henrik I,9999,0,9999,0
1668211414869,CSE 293,005,119142,Cottrell; Garrison W,9999,0,9999,0
1668211414869,CSE 293,006,119146,Deutsch; Alin Bernard,9999,0,9999,0
1668211414869,CSE 293,007,119159,Esmaeilzadeh; Hadi,9999,0,9999,0
1668211414869,CSE 293,008,119166,Freund; Yoav,9999,0,9999,0
1668211414869,CSE 293,009,119170,Griswold; William G.,9999,0,9999,0
1668211414869,CSE 293,010,119183,Gymrek; Melissa Ann,9999,0,9999,0
1668211414869,CSE 293,011,119190,Heninger; Nadia A,9999,0,9999,0
1668211414869,CSE 293,012,119230,Impagliazzo; Russell,9999,0,9999,0
1668211414869,CSE 293,013,119232,Jhala; Ranjit,9999,0,9999,0
1668211414869,CSE 293,014,119233,Kahng; Andrew Byun,9999,0,9999,0
1668211414869,CSE 293,015,119298,Kane; Daniel Mertz,9999,0,9999,0
1668211414869,CSE 293,016,119299,Kriegman; David J,9999,0,9999,0
1668211414869,CSE 293,017,119300,Kumar; Arun Kumar,9999,0,9999,0
1668211414869,CSE 293,018,119301,Lerner; Sorin,9999,0,9999,0
1668211414869,CSE 293,019,119302,Lovett; Shachar,9999,0,9999,0
1668211414869,CSE 293,020,119303,McAuley; Julian John,9999,0,9999,0
1668211414869,CSE 293,021,119304,Micciancio; Daniele,9999,0,9999,0
1668211414869,CSE 293,022,119367,Orailoglu; Alex,9999,0,9999,0
1668211414869,CSE 293,023,119382,Paturi; Ramamohan,9999,0,9999,0
1668211414869,CSE 293,024,119404,Polikarpova; Nadezhda,9999,0,9999,0
1668211414869,CSE 293,025,119406,Politz; Joseph Gibbs,9999,0,9999,0
1668211414869,CSE 293,026,119411,Porter; George M,9999,0,9999,0
1668211414869,CSE 293,027,119414,Porter; Leonard Emerson,9999,0,9999,0
1668211414869,CSE 293,028,119416,Ramamoorthi; Ravi,9999,0,9999,0
1668211414869,CSE 293,029,119417,Sahoo; Debashis,9999,0,9999,0
1668211414869,CSE 293,030,119420,Saul; Lawrence,9999,0,9999,0
1668211414869,CSE 293,031,119421,Savage; Stefan,9999,0,9999,0
1668211414869,CSE 293,032,119425,Schulze; Jurgen P.,9999,0,9999,0
1668211414869,CSE 293,033,119426,Snoeren; Alex C.,9999,0,9999,0
1668211414869,CSE 293,034,119428,Shang; Jingbo,9999,0,9999,0
1668211414869,CSE 293,035,119430,Stefan; Deian,9999,0,9999,0
1668211414869,CSE 293,036,119431,Su; Hao,9999,0,9999,0
1668211414869,CSE 293,037,119433,Swanson; Steven James,9999,0,9999,0
1668211414869,CSE 293,038,119435,Tullsen; Dean Michael,9999,0,9999,0
1668211414869,CSE 293,039,119483,Voelker; Geoffrey M.,9999,0,9999,0
1668211414869,CSE 293,040,119537,Zhao; Jishen,9999,0,9999,0
1668211414869,CSE 293,041,119538,Zhou; Yuan-Yuan,9999,0,9999,0
1668211414869,CSE 293,042,119539,Gao; Sicun,9999,0,9999,0
1668211414869,CSE 293,043,119540,Weibel; Nadir,9999,0,9999,0
1668211414869,CSE 293,044,119541,Gupta; Rajesh K.,9999,0,9999,0
1668211414869,CSE 293,045,126410,Vaccaro; Kristen Marie,9999,0,9999,0
1668211414869,CSE 293,046,126411,Klemke; Richard,9999,0,9999,0
1668211415294,CSE 294,A00,102459,Voelker; Geoffrey M.,0,0,0,0
1668211415294,CSE 294,B00,111322,Orailoglu; Alex,0,0,0,0
1668211415716,DSE 201,A00,096914,Deutsch; Alin Bernard,30,0,30,0
1668211416149,DSE 210,A00,096915,Dasgupta; Sanjoy,30,0,30,0
1668211416579,DSE 260A,A00,096916,Altintas De Callaf; Ilkay,30,0,30,0
1668211417020,ECE 200,001,103586,Antipa; Nicholas A,9999,0,9999,0
1668211417020,ECE 200,002,103587,Atanasov; Nikolay A.,9999,0,9999,0
1668211417020,ECE 200,003,103588,Bharadia; Dinesh,9999,0,9999,0
1668211417020,ECE 200,004,103589,Cheng; Chung Kuan,9999,0,9999,0
1668211417020,ECE 200,005,103590,Cosman; Pamela C.,9999,0,9999,0
1668211417020,ECE 200,006,103591,Dayeh; Shadi Ahmad,9999,0,9999,0
1668211417020,ECE 200,007,103592,Fainman; Yeshaiahu,9999,0,9999,0
1668211417020,ECE 200,008,103593,Ford; Joseph Earl,9999,0,9999,0
1668211417020,ECE 200,009,103594,Franceschetti; Massimo,9999,0,9999,0
1668211417020,ECE 200,010,103595,Fullerton; Eric E,9999,0,9999,0
1668211417020,ECE 200,011,103596,Galton; Ian A,9999,0,9999,0
1668211417020,ECE 200,012,103597,Gilja; Vikash,9999,0,9999,0
1668211417020,ECE 200,013,103598,Hall; Drew A.,9999,0,9999,0
1668211417020,ECE 200,014,103599,Hsueh; Tzu-Chien,9999,0,9999,0
1668211417020,ECE 200,015,103600,Javidi; Tara,9999,0,9999,0
1668211417020,ECE 200,016,103601,Kahng; Andrew Byun,9999,0,9999,0
1668211417020,ECE 200,017,103602,Kim; Young-Han,9999,0,9999,0
1668211417020,ECE 200,018,103603,Koushanfar; Farinaz,9999,0,9999,0
1668211417020,ECE 200,019,103604,Kuzum; Duygu,9999,0,9999,0
1668211417020,ECE 200,020,103605,Le; Hanh-Phuc,9999,0,9999,0
1668211417020,ECE 200,021,103606,Lin; Bill,9999,0,9999,0
1668211417020,ECE 200,022,103607,Liu; Zhaowei,9998,0,9999,1
1668211417020,ECE 200,023,103608,Lo; Yu-Hwa,9999,0,9999,0
1668211417020,ECE 200,024,103609,Lomakin; Vitaliy,9999,0,9999,0
1668211417020,ECE 200,025,103610,Mercier; Patrick Philip,9999,0,9999,0
1668211417020,ECE 200,026,103611,Meyer; Florian,9999,0,9999,0
1668211417020,ECE 200,027,103612,Milstein; Laurence B.,9999,0,9999,0
1668211417020,ECE 200,028,103613,Mir Arabbaygi; Siavash,9999,0,9999,0
1668211417020,ECE 200,029,103614,Mookherjea; Shayan,9999,0,9999,0
1668211417020,ECE 200,030,103615,Morris; Karcher William,9999,0,9999,0
1668211417020,ECE 200,031,103616,Ng; Tse Nga,9999,0,9999,0
1668211417020,ECE 200,032,103617,Nguyen; Truong Quang,9999,0,9999,0
1668211417020,ECE 200,033,103618,Nomura; Kenji,9999,0,9999,0
1668211417020,ECE 200,034,103619,Orlitsky; Alon,9999,0,9999,0
1668211417020,ECE 200,035,103620,Pal; Piya,9999,0,9999,0
1668211417020,ECE 200,036,103621,Papen; George C.,9999,0,9999,0
1668211417020,ECE 200,037,103622,Radic; Stojan,9999,0,9999,0
1668211417020,ECE 200,038,103623,Rao; Bhaskar D.,9999,0,9999,0
1668211417020,ECE 200,039,103624,Rao; Ramesh R,9999,0,9999,0
1668211417020,ECE 200,040,103625,Rebeiz; Gabriel,9999,0,9999,0
1668211417020,ECE 200,041,103626,Sanford; John R,9999,0,9999,0
1668211417020,ECE 200,042,103627,Siegel; Paul H.,9999,0,9999,0
1668211417020,ECE 200,043,103628,Sievenpiper; Daniel F.,9999,0,9999,0
1668211417020,ECE 200,044,103629,Sworder; David D.,9999,0,9999,0
1668211417020,ECE 200,045,103630,Taur; Yuan,9999,0,9999,0
1668211417020,ECE 200,046,103631,Touri; Behrouz,9999,0,9999,0
1668211417020,ECE 200,047,103632,Trivedi; Mohan M.,9999,0,9999,0
1668211417020,ECE 200,048,103633,Vasconcelos; Nuno,9999,0,9999,0
1668211417020,ECE 200,049,103634,Wang; Xiaolong,9999,0,9999,0
1668211417020,ECE 200,050,103635,Xie; Pengtao,9999,0,9999,0
1668211417020,ECE 200,051,103636,Yip; Michael,9999,0,9999,0
1668211417020,ECE 200,052,103637,Zeger; Kenneth A.,999,0,999,0
1668211417020,ECE 200,053,103638,Zhang; Xinyu,9999,0,9999,0
1668211417020,ECE 200,054,103639,Turakhia; Yatish Girish,9999,0,9999,0
1668211417020,ECE 200,055,103640,Kang; Mingu,9999,0,9999,0
1668211417020,ECE 200,056,103641,Shi; Yuanyuan,9999,0,9999,0
1668211417020,ECE 200,057,103642,Wang; Edward Jay,9999,0,9999,0
1668211417020,ECE 200,058,103643,Zheng; Yang,9999,0,9999,0
1668211417458,ECE 202,A00,103644,Kuzum; Duygu,0,0,0,0
1668211417884,ECE 212BN,A00,103646,Ng; Tse Nga,0,0,0,0
1668211418324,ECE 221,A00,111493,Staff,0,0,0,0
1668211418750,ECE 222B,A00,103647,Lomakin; Vitaliy,0,0,0,0
1668211419174,ECE 230B,A00,103648,Taur; Yuan,0,0,0,0
1668211419600,ECE 238B,A00,103649,Garay; Javier,0,0,0,0
1668211420022,ECE 240B,A00,112900,Fainman; Yeshaiahu,0,0,0,0
1668211420446,ECE 247A,A00,103650,Jokerst; Jesse Vincent,0,0,0,0
1668211420869,ECE 247B,A00,103651,Wang; Joseph,0,0,0,0
1668211421394,ECE 250,A00,103652,Siegel; Paul H.,0,0,0,0
1668211421825,ECE 251A,A00,103654,Rao; Bhaskar D.,0,0,0,0
1668211422247,ECE 257B,A00,103655,Bharadia; Dinesh,0,0,0,0
1668211422670,ECE 258A,A00,103656,Milstein; Laurence B.,0,0,0,0
1668211423094,ECE 260B,A00,103658,Kang; Mingu,0,0,0,0
1668211423517,ECE 264A,A00,103659,Galton; Ian A,0,0,0,0
1668211423941,ECE 265A,A00,103661,Gudem; Prasad S.S.,0,0,0,0
1668211424368,ECE 265D,A00,103662,Gudem; Prasad S.S.,0,0,0,0
1668211424790,ECE 268,A00,103663,Koushanfar; Farinaz,0,0,0,0
1668211425214,ECE 269,A01,103665,Pal; Piya,0,0,0,0
1668211425639,ECE 271B,A00,103666,Vasconcelos; Manuela,0,0,0,0
1668211426064,ECE 276A,A00,103667,Atanasov; Nikolay A.,0,0,0,0
1668211426486,ECE 277,A00,103668,An; Cheolhong,0,0,0,0
1668211426912,ECE 279,A00,117947,Hall; Drew A.,0,0,0,0
1668211427770,ECE 283,A00,103670,Hsueh; Tzu-Chien,0,0,0,0
1668211428197,ECE 284,A00,103671,Turakhia; Yatish Girish,0,0,0,0
1668211428620,ECE 285,A00,103672,Zheng; Yang,0,0,0,0
1668211428620,ECE 285,B00,103673,Sworder; David D.,0,0,0,0
1668211429062,ECE 287,A00,103676,Javidi; Tara,0,0,0,0
1668211429493,MATH 200B,A00,098023,Salehi Golsefidy; Alireza,12,0,15,3
1668211429924,MATH 202B,A00,098024,Rhoades; Brendon Patrick,9,0,15,6
1668211430348,MATH 203B,A00,098025,Oprea; Dragos N.,10,0,15,5
1668211430774,MATH 204B,A00,098026,Sorensen; Claus M,13,0,15,2
1668211431198,MATH 208,A00,098027,Izadi; Elham,7,0,10,3
1668211431624,MATH 209,A00,098028,Pollack; Aaron,10,0,10,0
1668211432070,MATH 211A,A00,112919,Rogalski; Daniel,9,0,10,1
1668211432496,MATH 211B,A00,112920,Seward; Brandon M.,9,0,10,1
1668211432926,MATH 218,A00,098029,Li; Bo,10,0,10,0
1668211433349,MATH 220B,A00,098030,Novak; Jonathan I,11,0,15,4
1668211433775,MATH 221A,A00,098031,Ebenfelt; Peter F,13,0,15,2
1668211434203,MATH 231B,A00,098032,Zlatos; Andrej,12,0,15,3
1668211434632,MATH 240B,A00,098033,Ni; Lei,9,0,15,6
1668211435069,MATH 243,A00,098034,Jekel; David Andrew,10,0,10,0
1668211435495,MATH 245A,A00,098035,Nie; Jiawang,0,0,15,16
1668211435918,MATH 248,A00,098036,Bejenaru; Ioan,10,0,10,0
1668211436340,MATH 250B,A00,098037,Spolaor; Luca,14,0,15,1
1668211436768,MATH 258,A00,098038,Ni; Lei,10,0,10,0
1668211437191,MATH 264B,A00,098041,Rhoades; Brendon Patrick,9,0,15,6
1668211437619,MATH 268,A00,098042,Buss; Samuel R,10,0,10,0
1668211438044,MATH 269,A00,098043,Rhoades; Brendon Patrick,10,0,10,0
1668211438473,MATH 270B,A00,098044,Li; Bo,10,0,15,5
1668211438898,MATH 272B,A00,098045,Holst; Michael J,13,0,15,2
1668211439322,MATH 273A,A00,098046,Tian; Xiaochuan,10,0,15,5
1668211439747,MATH 275,A01,098048,Tian; Xiaochuan,6,0,10,4
1668211440172,MATH 278A,A00,098049,Holst; Michael J,8,0,10,2
1668211440613,MATH 278B,A00,098050,Cloninger; Alexander,10,0,10,0
1668211441037,MATH 278C,A00,098051,Nie; Jiawang,7,0,10,3
1668211441465,MATH 280B,A00,098052,Zheng; Tianyi,10,0,15,5
1668211441890,MATH 281B,A00,098053,Bradic; Jelena,2,0,15,13
1668211442317,MATH 282B,A00,098054,Arias-Castro; Ery,0,0,15,15
1668211442740,MATH 285,A00,098055,Fitzsimmons; Patrick J,0,0,15,17
1668211443165,MATH 287B,A00,098056,Arias-Castro; Ery,2,0,15,13
1668211443601,MATH 288,A00,098057,Agarwal; Pooja,9,0,10,1
1668211443601,MATH 288,B00,098058,Zhang; Danna,8,0,10,2
1668211443601,MATH 288,C00,098059,Williams; Ruth J,10,0,10,0
1668211444024,MATH 290B,A00,098060,Roberts; Justin Deritter,13,0,15,2
1668211444456,MATH 292,A00,098061,Belmont; Eva Kinoshita,10,0,10,0
1668211444880,MATH 295,A00,098062,Suk; Andrew Hoon,48,0,50,2
1668211445305,MATH 296,A00,098063,Novak; Jonathan I,20,0,20,0
1668211445731,MATH 297,001,098064,Gamst; Anthony Collins,9997,0,9999,2
1668211947543,COGS 205,A00,101395,Chiba; Andrea,19,0,20,1
1668211947970,COGS 210B,001,101404,Greene; Deanna Jacquelyn,9998,0,9999,1
1668211947970,COGS 210B,002,101417,Xia; Haijun,9999,0,9999,0
1668211947970,COGS 210B,003,101422,Nitz; Douglas A.,9999,0,9999,0
1668211947970,COGS 210B,004,101423,Hollan; James D.,9998,0,9999,1
1668211947970,COGS 210B,005,101424,Deak; Gedeon O.,9998,0,9999,1
1668211947970,COGS 210B,006,101425,Rossano; Federico,9999,0,9999,0
1668211948403,COGS 211B,A00,101427,Coulson; Seana M,9996,0,9999,3
1668211948965,COGS 220,A00,101428,Hollan; James D.,0,0,25,25
1668211949390,COGS 229,A00,101429,Dow; Steven P,18,0,25,7
1668211949821,COGS 230,A00,101430,Klemmer; Scott R,12,0,17,5
1668211950245,COGS 234,A00,101431,Xia; Haijun,2,0,25,23
1668211950667,COGS 260,A00,101432,Kiyonaga; Anastasia,21,0,25,4
1668211950667,COGS 260,B00,101433,Kirsh; David Joel,15,0,25,10
1668211951090,CSE 202,A00,102371,Impagliazzo; Russell,0,0,0,0
1668211951514,CSE 203B,A01,102373,Cheng; Chung Kuan,0,0,0,0
1668211951939,CSE 208,A00,102374,Micciancio; Daniele,0,0,0,0
1668211952364,CSE 209A,A00,112895,Impagliazzo; Russell,0,0,15,15
1668211952800,CSE 209B,A00,108005,Bellare; Mihir,0,0,0,0
1668211953222,CSE 210,A00,113163,Coblenz; Michael J,0,0,0,0
1668211953660,CSE 219,A00,106111,Dow; Steven P,0,0,20,20
1668211954098,CSE 221,A00,102376,Voelker; Geoffrey M.,0,0,0,0
1668211954521,CSE 224,A01,102378,Porter; George M,0,0,0,0
1668211954944,CSE 229A,A00,102379,Savage; Stefan,0,0,0,0
1668211955365,CSE 229C,A00,102380,Munyaka; Imani N. S.,0,0,0,0
1668211955793,CSE 232B,A00,102382,Deutsch; Alin Bernard,0,0,0,0
1668211956221,CSE 234,A01,112904,Kumar; Arun Kumar,0,0,0,0
1668211956644,CSE 237A,A00,102383,Rosing; Tajana Simunic,0,0,0,0
1668211957073,CSE 239A,A00,102384,Deutsch; Alin Bernard,0,0,0,0
1668211957497,CSE 239B,A00,102385,Polikarpova; Nadezhda,0,0,0,0
1668211957920,CSE 240A,A00,102386,Pannuto; Patrick William,0,0,0,0
1668211958347,CSE 240B,A00,102387,Zhao; Jishen,0,0,0,0
1668211958773,CSE 241A,A00,106406,Kang; Mingu,0,0,0,0
1668211959205,CSE 249B,A00,102388,Kahng; Andrew Byun,0,0,8,8
1668211959628,CSE 251B,A01,102392,Cottrell; Garrison W,0,0,0,0
1668211959628,CSE 251B,A02,102393,Cottrell; Garrison W,0,0,0,0
1668211960052,CSE 252B,A00,102394,Ochoa; Benjamin Lawrence,0,0,0,0
1668211960475,CSE 257,A01,102396,Gao; Sicun,0,0,0,0
1668211960899,CSE 272,A00,102397,Li; Tzumao,0,0,0,0
1668211961335,CSE 274,A00,111323,Chern; Albert Ren-Haur,0,0,0,0
1668211961766,CSE 282,A00,102398,Pevzner; Pavel Arkadjevich,0,0,0,0
1668211962191,CSE 284,A00,114175,Gymrek; Melissa Ann,0,0,0,0
1668211962617,CSE 290,A00,102399,Chandraker; Manmohan Krishna,0,0,0,0
1668211962617,CSE 290,B00,102400,Vaccaro; Kristen Marie,0,0,25,25
1668211962617,CSE 290,C00,102414,Pannuto; Patrick William,0,0,25,25
1668211962617,CSE 290,D00,102427,Pevzner; Pavel Arkadjevich,0,0,0,0
1668211962617,CSE 290,E00,102429,Zhao; Jishen,0,0,0,0
1668211962617,CSE 290,F00,102436,Tullsen; Dean Michael,0,0,0,0
1668211962617,CSE 290,G00,102440,Christensen; Henrik I,0,0,20,20
1668211963045,CSE 291,A00,102443,Su; Hao,0,0,0,0
1668211963045,CSE 291,B00,102448,Polikarpova; Nadezhda,0,0,0,0
1668211963045,CSE 291,C00,102453,Vaccaro; Kristen Marie,0,0,0,0
1668211963045,CSE 291,D00,111343,Savage; Stefan,0,0,0,0
1668211963045,CSE 291,E00,116474,Claffy; Kimberly Claire,0,0,0,0
1668211963045,CSE 291,F00,116479,Pasquale; Joseph,0,0,0,0
1668211963473,CSE 293,001,119111,Bafna; Vineet,9999,0,9999,0
1668211963473,CSE 293,002,119118,Bellare; Mihir,9999,0,9999,0
1668211963473,CSE 293,003,119122,Berg-Kirkpatrick; Taylor D,9999,0,9999,0
1668211963473,CSE 293,004,119135,Christensen; Henrik I,9999,0,9999,0
1668211963473,CSE 293,005,119142,Cottrell; Garrison W,9999,0,9999,0
1668211963473,CSE 293,006,119146,Deutsch; Alin Bernard,9999,0,9999,0
1668211963473,CSE 293,007,119159,Esmaeilzadeh; Hadi,9999,0,9999,0
1668211963473,CSE 293,008,119166,Freund; Yoav,9999,0,9999,0
1668211963473,CSE 293,009,119170,Griswold; William G.,9999,0,9999,0
1668211963473,CSE 293,010,119183,Gymrek; Melissa Ann,9999,0,9999,0
1668211963473,CSE 293,011,119190,Heninger; Nadia A,9999,0,9999,0
1668211963473,CSE 293,012,119230,Impagliazzo; Russell,9999,0,9999,0
1668211963473,CSE 293,013,119232,Jhala; Ranjit,9999,0,9999,0
1668211963473,CSE 293,014,119233,Kahng; Andrew Byun,9999,0,9999,0
1668211963473,CSE 293,015,119298,Kane; Daniel Mertz,9999,0,9999,0
1668211963473,CSE 293,016,119299,Kriegman; David J,9999,0,9999,0
1668211963473,CSE 293,017,119300,Kumar; Arun Kumar,9999,0,9999,0
1668211963473,CSE 293,018,119301,Lerner; Sorin,9999,0,9999,0
1668211963473,CSE 293,019,119302,Lovett; Shachar,9999,0,9999,0
1668211963473,CSE 293,020,119303,McAuley; Julian John,9999,0,9999,0
1668211963473,CSE 293,021,119304,Micciancio; Daniele,9999,0,9999,0
1668211963473,CSE 293,022,119367,Orailoglu; Alex,9999,0,9999,0
1668211963473,CSE 293,023,119382,Paturi; Ramamohan,9999,0,9999,0
1668211963473,CSE 293,024,119404,Polikarpova; Nadezhda,9999,0,9999,0
1668211963473,CSE 293,025,119406,Politz; Joseph Gibbs,9999,0,9999,0
1668211963473,CSE 293,026,119411,Porter; George M,9999,0,9999,0
1668211963473,CSE 293,027,119414,Porter; Leonard Emerson,9999,0,9999,0
1668211963473,CSE 293,028,119416,Ramamoorthi; Ravi,9999,0,9999,0
1668211963473,CSE 293,029,119417,Sahoo; Debashis,9999,0,9999,0
1668211963473,CSE 293,030,119420,Saul; Lawrence,9999,0,9999,0
1668211963473,CSE 293,031,119421,Savage; Stefan,9999,0,9999,0
1668211963473,CSE 293,032,119425,Schulze; Jurgen P.,9999,0,9999,0
1668211963473,CSE 293,033,119426,Snoeren; Alex C.,9999,0,9999,0
1668211963473,CSE 293,034,119428,Shang; Jingbo,9999,0,9999,0
1668211963473,CSE 293,035,119430,Stefan; Deian,9999,0,9999,0
1668211963473,CSE 293,036,119431,Su; Hao,9999,0,9999,0
1668211963473,CSE 293,037,119433,Swanson; Steven James,9999,0,9999,0
1668211963473,CSE 293,038,119435,Tullsen; Dean Michael,9999,0,9999,0
1668211963473,CSE 293,039,119483,Voelker; Geoffrey M.,9999,0,9999,0
1668211963473,CSE 293,040,119537,Zhao; Jishen,9999,0,9999,0
1668211963473,CSE 293,041,119538,Zhou; Yuan-Yuan,9999,0,9999,0
1668211963473,CSE 293,042,119539,Gao; Sicun,9999,0,9999,0
1668211963473,CSE 293,043,119540,Weibel; Nadir,9999,0,9999,0
1668211963473,CSE 293,044,119541,Gupta; Rajesh K.,9999,0,9999,0
1668211963473,CSE 293,045,126410,Vaccaro; Kristen Marie,9999,0,9999,0
1668211963473,CSE 293,046,126411,Klemke; Richard,9999,0,9999,0
1668211963897,CSE 294,A00,102459,Voelker; Geoffrey M.,0,0,0,0
1668211963897,CSE 294,B00,111322,Orailoglu; Alex,0,0,0,0
1668211964321,DSE 201,A00,096914,Deutsch; Alin Bernard,30,0,30,0
1668211964745,DSE 210,A00,096915,Dasgupta; Sanjoy,30,0,30,0
1668211965168,DSE 260A,A00,096916,Altintas De Callaf; Ilkay,30,0,30,0
1668211965620,ECE 200,001,103586,Antipa; Nicholas A,9999,0,9999,0
1668211965620,ECE 200,002,103587,Atanasov; Nikolay A.,9999,0,9999,0
1668211965620,ECE 200,003,103588,Bharadia; Dinesh,9999,0,9999,0
1668211965620,ECE 200,004,103589,Cheng; Chung Kuan,9999,0,9999,0
1668211965620,ECE 200,005,103590,Cosman; Pamela C.,9999,0,9999,0
1668211965620,ECE 200,006,103591,Dayeh; Shadi Ahmad,9999,0,9999,0
1668211965620,ECE 200,007,103592,Fainman; Yeshaiahu,9999,0,9999,0
1668211965620,ECE 200,008,103593,Ford; Joseph Earl,9999,0,9999,0
1668211965620,ECE 200,009,103594,Franceschetti; Massimo,9999,0,9999,0
1668211965620,ECE 200,010,103595,Fullerton; Eric E,9999,0,9999,0
1668211965620,ECE 200,011,103596,Galton; Ian A,9999,0,9999,0
1668211965620,ECE 200,012,103597,Gilja; Vikash,9999,0,9999,0
1668211965620,ECE 200,013,103598,Hall; Drew A.,9999,0,9999,0
1668211965620,ECE 200,014,103599,Hsueh; Tzu-Chien,9999,0,9999,0
1668211965620,ECE 200,015,103600,Javidi; Tara,9999,0,9999,0
1668211965620,ECE 200,016,103601,Kahng; Andrew Byun,9999,0,9999,0
1668211965620,ECE 200,017,103602,Kim; Young-Han,9999,0,9999,0
1668211965620,ECE 200,018,103603,Koushanfar; Farinaz,9999,0,9999,0
1668211965620,ECE 200,019,103604,Kuzum; Duygu,9999,0,9999,0
1668211965620,ECE 200,020,103605,Le; Hanh-Phuc,9999,0,9999,0
1668211965620,ECE 200,021,103606,Lin; Bill,9999,0,9999,0
1668211965620,ECE 200,022,103607,Liu; Zhaowei,9998,0,9999,1
1668211965620,ECE 200,023,103608,Lo; Yu-Hwa,9999,0,9999,0
1668211965620,ECE 200,024,103609,Lomakin; Vitaliy,9999,0,9999,0
1668211965620,ECE 200,025,103610,Mercier; Patrick Philip,9999,0,9999,0
1668211965620,ECE 200,026,103611,Meyer; Florian,9999,0,9999,0
1668211965620,ECE 200,027,103612,Milstein; Laurence B.,9999,0,9999,0
1668211965620,ECE 200,028,103613,Mir Arabbaygi; Siavash,9999,0,9999,0
1668211965620,ECE 200,029,103614,Mookherjea; Shayan,9999,0,9999,0
1668211965620,ECE 200,030,103615,Morris; Karcher William,9999,0,9999,0
1668211965620,ECE 200,031,103616,Ng; Tse Nga,9999,0,9999,0
1668211965620,ECE 200,032,103617,Nguyen; Truong Quang,9999,0,9999,0
1668211965620,ECE 200,033,103618,Nomura; Kenji,9999,0,9999,0
1668211965620,ECE 200,034,103619,Orlitsky; Alon,9999,0,9999,0
1668211965620,ECE 200,035,103620,Pal; Piya,9999,0,9999,0
1668211965620,ECE 200,036,103621,Papen; George C.,9999,0,9999,0
1668211965620,ECE 200,037,103622,Radic; Stojan,9999,0,9999,0
1668211965620,ECE 200,038,103623,Rao; Bhaskar D.,9999,0,9999,0
1668211965620,ECE 200,039,103624,Rao; Ramesh R,9999,0,9999,0
1668211965620,ECE 200,040,103625,Rebeiz; Gabriel,9999,0,9999,0
1668211965620,ECE 200,041,103626,Sanford; John R,9999,0,9999,0
1668211965620,ECE 200,042,103627,Siegel; Paul H.,9999,0,9999,0
1668211965620,ECE 200,043,103628,Sievenpiper; Daniel F.,9999,0,9999,0
1668211965620,ECE 200,044,103629,Sworder; David D.,9999,0,9999,0
1668211965620,ECE 200,045,103630,Taur; Yuan,9999,0,9999,0
1668211965620,ECE 200,046,103631,Touri; Behrouz,9999,0,9999,0
1668211965620,ECE 200,047,103632,Trivedi; Mohan M.,9999,0,9999,0
1668211965620,ECE 200,048,103633,Vasconcelos; Nuno,9999,0,9999,0
1668211965620,ECE 200,049,103634,Wang; Xiaolong,9999,0,9999,0
1668211965620,ECE 200,050,103635,Xie; Pengtao,9999,0,9999,0
1668211965620,ECE 200,051,103636,Yip; Michael,9999,0,9999,0
1668211965620,ECE 200,052,103637,Zeger; Kenneth A.,999,0,999,0
1668211965620,ECE 200,053,103638,Zhang; Xinyu,9999,0,9999,0
1668211965620,ECE 200,054,103639,Turakhia; Yatish Girish,9999,0,9999,0
1668211965620,ECE 200,055,103640,Kang; Mingu,9999,0,9999,0
1668211965620,ECE 200,056,103641,Shi; Yuanyuan,9999,0,9999,0
1668211965620,ECE 200,057,103642,Wang; Edward Jay,9999,0,9999,0
1668211965620,ECE 200,058,103643,Zheng; Yang,9999,0,9999,0
1668211966051,ECE 202,A00,103644,Kuzum; Duygu,0,0,0,0
1668211966475,ECE 212BN,A00,103646,Ng; Tse Nga,0,0,0,0
1668211966897,ECE 221,A00,111493,Staff,0,0,0,0
1668211967323,ECE 222B,A00,103647,Lomakin; Vitaliy,0,0,0,0
1668211967745,ECE 230B,A00,103648,Taur; Yuan,0,0,0,0
1668211968170,ECE 238B,A00,103649,Garay; Javier,0,0,0,0
1668211968595,ECE 240B,A00,112900,Fainman; Yeshaiahu,0,0,0,0
1668211969032,ECE 247A,A00,103650,Jokerst; Jesse Vincent,0,0,0,0
1668211969466,ECE 247B,A00,103651,Wang; Joseph,0,0,0,0
1668211969904,ECE 250,A00,103652,Siegel; Paul H.,0,0,0,0
1668211970339,ECE 251A,A00,103654,Rao; Bhaskar D.,0,0,0,0
1668211970761,ECE 257B,A00,103655,Bharadia; Dinesh,0,0,0,0
1668211971184,ECE 258A,A00,103656,Milstein; Laurence B.,0,0,0,0
1668211971610,ECE 260B,A00,103658,Kang; Mingu,0,0,0,0
1668211972031,ECE 264A,A00,103659,Galton; Ian A,0,0,0,0
1668211972455,ECE 265A,A00,103661,Gudem; Prasad S.S.,0,0,0,0
1668211972877,ECE 265D,A00,103662,Gudem; Prasad S.S.,0,0,0,0
1668211973304,ECE 268,A00,103663,Koushanfar; Farinaz,0,0,0,0
1668211973735,ECE 269,A01,103665,Pal; Piya,0,0,0,0
1668211974159,ECE 271B,A00,103666,Vasconcelos; Manuela,0,0,0,0
1668211974581,ECE 276A,A00,103667,Atanasov; Nikolay A.,0,0,0,0
1668211975003,ECE 277,A00,103668,An; Cheolhong,0,0,0,0
1668211975429,ECE 279,A00,117947,Hall; Drew A.,0,0,0,0
1668211976283,ECE 283,A00,103670,Hsueh; Tzu-Chien,0,0,0,0
1668211976708,ECE 284,A00,103671,Turakhia; Yatish Girish,0,0,0,0
1668211977139,ECE 285,A00,103672,Zheng; Yang,0,0,0,0
1668211977139,ECE 285,B00,103673,Sworder; David D.,0,0,0,0
1668211977573,ECE 287,A00,103676,Javidi; Tara,0,0,0,0
1668211978007,MATH 200B,A00,098023,Salehi Golsefidy; Alireza,12,0,15,3
1668211978428,MATH 202B,A00,098024,Rhoades; Brendon Patrick,9,0,15,6
1668211978855,MATH 203B,A00,098025,Oprea; Dragos N.,10,0,15,5
1668211979282,MATH 204B,A00,098026,Sorensen; Claus M,13,0,15,2
1668211979706,MATH 208,A00,098027,Izadi; Elham,7,0,10,3
1668211980128,MATH 209,A00,098028,Pollack; Aaron,10,0,10,0
1668211980551,MATH 211A,A00,112919,Rogalski; Daniel,9,0,10,1
1668211980974,MATH 211B,A00,112920,Seward; Brandon M.,9,0,10,1
1668211981397,MATH 218,A00,098029,Li; Bo,10,0,10,0
1668211981832,MATH 220B,A00,098030,Novak; Jonathan I,11,0,15,4
1668211982254,MATH 221A,A00,098031,Ebenfelt; Peter F,13,0,15,2
1668211982689,MATH 231B,A00,098032,Zlatos; Andrej,12,0,15,3
1668211983115,MATH 240B,A00,098033,Ni; Lei,9,0,15,6
1668211983538,MATH 243,A00,098034,Jekel; David Andrew,10,0,10,0
1668211983965,MATH 245A,A00,098035,Nie; Jiawang,0,0,15,16
1668211984388,MATH 248,A00,098036,Bejenaru; Ioan,10,0,10,0
1668211984812,MATH 250B,A00,098037,Spolaor; Luca,14,0,15,1
1668211985236,MATH 258,A00,098038,Ni; Lei,10,0,10,0
1668211985667,MATH 264B,A00,098041,Rhoades; Brendon Patrick,9,0,15,6
1668211986094,MATH 268,A00,098042,Buss; Samuel R,10,0,10,0
1668211986616,MATH 269,A00,098043,Rhoades; Brendon Patrick,10,0,10,0
1668211987040,MATH 270B,A00,098044,Li; Bo,10,0,15,5
1668211987474,MATH 272B,A00,098045,Holst; Michael J,13,0,15,2
1668211987897,MATH 273A,A00,098046,Tian; Xiaochuan,10,0,15,5
1668211988321,MATH 275,A01,098048,Tian; Xiaochuan,6,0,10,4
1668211988746,MATH 278A,A00,098049,Holst; Michael J,8,0,10,2
1668211989182,MATH 278B,A00,098050,Cloninger; Alexander,10,0,10,0
1668211989610,MATH 278C,A00,098051,Nie; Jiawang,7,0,10,3
1668211990036,MATH 280B,A00,098052,Zheng; Tianyi,10,0,15,5
1668211990471,MATH 281B,A00,098053,Bradic; Jelena,2,0,15,13
1668211990898,MATH 282B,A00,098054,Arias-Castro; Ery,0,0,15,15
1668211991322,MATH 285,A00,098055,Fitzsimmons; Patrick J,0,0,15,17
1668211991744,MATH 287B,A00,098056,Arias-Castro; Ery,2,0,15,13
1668211992170,MATH 288,A00,098057,Agarwal; Pooja,9,0,10,1
1668211992170,MATH 288,B00,098058,Zhang; Danna,8,0,10,2
1668211992170,MATH 288,C00,098059,Williams; Ruth J,10,0,10,0
1668211992593,MATH 290B,A00,098060,Roberts; Justin Deritter,13,0,15,2
1668211993017,MATH 292,A00,098061,Belmont; Eva Kinoshita,10,0,10,0
1668211993444,MATH 295,A00,098062,Suk; Andrew Hoon,48,0,50,2
1668211993869,MATH 296,A00,098063,Novak; Jonathan I,20,0,20,0
1668211994292,MATH 297,001,098064,Gamst; Anthony Collins,9997,0,9999,2
1668212496407,COGS 205,A00,101395,Chiba; Andrea,19,0,20,1
1668212496829,COGS 210B,001,101404,Greene; Deanna Jacquelyn,9998,0,9999,1
1668212496829,COGS 210B,002,101417,Xia; Haijun,9999,0,9999,0
1668212496829,COGS 210B,003,101422,Nitz; Douglas A.,9999,0,9999,0
1668212496829,COGS 210B,004,101423,Hollan; James D.,9998,0,9999,1
1668212496829,COGS 210B,005,101424,Deak; Gedeon O.,9998,0,9999,1
1668212496829,COGS 210B,006,101425,Rossano; Federico,9999,0,9999,0
1668212497254,COGS 211B,A00,101427,Coulson; Seana M,9996,0,9999,3
1668212497679,COGS 220,A00,101428,Hollan; James D.,0,0,25,25
1668212498104,COGS 229,A00,101429,Dow; Steven P,18,0,25,7
1668212498530,COGS 230,A00,101430,Klemmer; Scott R,12,0,17,5
1668212498961,COGS 234,A00,101431,Xia; Haijun,2,0,25,23
1668212499389,COGS 260,A00,101432,Kiyonaga; Anastasia,21,0,25,4
1668212499389,COGS 260,B00,101433,Kirsh; David Joel,15,0,25,10
1668212499813,CSE 202,A00,102371,Impagliazzo; Russell,0,0,0,0
1668212500235,CSE 203B,A01,102373,Cheng; Chung Kuan,0,0,0,0
1668212500660,CSE 208,A00,102374,Micciancio; Daniele,0,0,0,0
1668212501084,CSE 209A,A00,112895,Impagliazzo; Russell,0,0,15,15
1668212501508,CSE 209B,A00,108005,Bellare; Mihir,0,0,0,0
1668212501932,CSE 210,A00,113163,Coblenz; Michael J,0,0,0,0
1668212502356,CSE 219,A00,106111,Dow; Steven P,0,0,20,20
1668212502782,CSE 221,A00,102376,Voelker; Geoffrey M.,0,0,0,0
1668212503207,CSE 224,A01,102378,Porter; George M,0,0,0,0
1668212503632,CSE 229A,A00,102379,Savage; Stefan,0,0,0,0
1668212504055,CSE 229C,A00,102380,Munyaka; Imani N. S.,0,0,0,0
1668212504481,CSE 232B,A00,102382,Deutsch; Alin Bernard,0,0,0,0
1668212504906,CSE 234,A01,112904,Kumar; Arun Kumar,0,0,0,0
1668212505331,CSE 237A,A00,102383,Rosing; Tajana Simunic,0,0,0,0
1668212505765,CSE 239A,A00,102384,Deutsch; Alin Bernard,0,0,0,0
1668212506188,CSE 239B,A00,102385,Polikarpova; Nadezhda,0,0,0,0
1668212506616,CSE 240A,A00,102386,Pannuto; Patrick William,0,0,0,0
1668212507039,CSE 240B,A00,102387,Zhao; Jishen,0,0,0,0
1668212507465,CSE 241A,A00,106406,Kang; Mingu,0,0,0,0
1668212507889,CSE 249B,A00,102388,Kahng; Andrew Byun,0,0,8,8
1668212508319,CSE 251B,A01,102392,Cottrell; Garrison W,0,0,0,0
1668212508319,CSE 251B,A02,102393,Cottrell; Garrison W,0,0,0,0
1668212508848,CSE 252B,A00,102394,Ochoa; Benjamin Lawrence,0,0,0,0
1668212509285,CSE 257,A01,102396,Gao; Sicun,0,0,0,0
1668212509707,CSE 272,A00,102397,Li; Tzumao,0,0,0,0
1668212510135,CSE 274,A00,111323,Chern; Albert Ren-Haur,0,0,0,0
1668212510560,CSE 282,A00,102398,Pevzner; Pavel Arkadjevich,0,0,0,0
1668212510991,CSE 284,A00,114175,Gymrek; Melissa Ann,0,0,0,0
1668212511430,CSE 290,A00,102399,Chandraker; Manmohan Krishna,0,0,0,0
1668212511430,CSE 290,B00,102400,Vaccaro; Kristen Marie,0,0,25,25
1668212511430,CSE 290,C00,102414,Pannuto; Patrick William,0,0,25,25
1668212511430,CSE 290,D00,102427,Pevzner; Pavel Arkadjevich,0,0,0,0
1668212511430,CSE 290,E00,102429,Zhao; Jishen,0,0,0,0
1668212511430,CSE 290,F00,102436,Tullsen; Dean Michael,0,0,0,0
1668212511430,CSE 290,G00,102440,Christensen; Henrik I,0,0,20,20
1668212511854,CSE 291,A00,102443,Su; Hao,0,0,0,0
1668212511854,CSE 291,B00,102448,Polikarpova; Nadezhda,0,0,0,0
1668212511854,CSE 291,C00,102453,Vaccaro; Kristen Marie,0,0,0,0
1668212511854,CSE 291,D00,111343,Savage; Stefan,0,0,0,0
1668212511854,CSE 291,E00,116474,Claffy; Kimberly Claire,0,0,0,0
1668212511854,CSE 291,F00,116479,Pasquale; Joseph,0,0,0,0
1668212512300,CSE 293,001,119111,Bafna; Vineet,9999,0,9999,0
1668212512300,CSE 293,002,119118,Bellare; Mihir,9999,0,9999,0
1668212512300,CSE 293,003,119122,Berg-Kirkpatrick; Taylor D,9999,0,9999,0
1668212512300,CSE 293,004,119135,Christensen; Henrik I,9999,0,9999,0
1668212512300,CSE 293,005,119142,Cottrell; Garrison W,9999,0,9999,0
1668212512300,CSE 293,006,119146,Deutsch; Alin Bernard,9999,0,9999,0
1668212512300,CSE 293,007,119159,Esmaeilzadeh; Hadi,9999,0,9999,0
1668212512300,CSE 293,008,119166,Freund; Yoav,9999,0,9999,0
1668212512300,CSE 293,009,119170,Griswold; William G.,9999,0,9999,0
1668212512300,CSE 293,010,119183,Gymrek; Melissa Ann,9999,0,9999,0
1668212512300,CSE 293,011,119190,Heninger; Nadia A,9999,0,9999,0
1668212512300,CSE 293,012,119230,Impagliazzo; Russell,9999,0,9999,0
1668212512300,CSE 293,013,119232,Jhala; Ranjit,9999,0,9999,0
1668212512300,CSE 293,014,119233,Kahng; Andrew Byun,9999,0,9999,0
1668212512300,CSE 293,015,119298,Kane; Daniel Mertz,9999,0,9999,0
1668212512300,CSE 293,016,119299,Kriegman; David J,9999,0,9999,0
1668212512300,CSE 293,017,119300,Kumar; Arun Kumar,9999,0,9999,0
1668212512300,CSE 293,018,119301,Lerner; Sorin,9999,0,9999,0
1668212512300,CSE 293,019,119302,Lovett; Shachar,9999,0,9999,0
1668212512300,CSE 293,020,119303,McAuley; Julian John,9999,0,9999,0
1668212512300,CSE 293,021,119304,Micciancio; Daniele,9999,0,9999,0
1668212512300,CSE 293,022,119367,Orailoglu; Alex,9999,0,9999,0
1668212512300,CSE 293,023,119382,Paturi; Ramamohan,9999,0,9999,0
1668212512300,CSE 293,024,119404,Polikarpova; Nadezhda,9999,0,9999,0
1668212512300,CSE 293,025,119406,Politz; Joseph Gibbs,9999,0,9999,0
1668212512300,CSE 293,026,119411,Porter; George M,9999,0,9999,0
1668212512300,CSE 293,027,119414,Porter; Leonard Emerson,9999,0,9999,0
1668212512300,CSE 293,028,119416,Ramamoorthi; Ravi,9999,0,9999,0
1668212512300,CSE 293,029,119417,Sahoo; Debashis,9999,0,9999,0
1668212512300,CSE 293,030,119420,Saul; Lawrence,9999,0,9999,0
1668212512300,CSE 293,031,119421,Savage; Stefan,9999,0,9999,0
1668212512300,CSE 293,032,119425,Schulze; Jurgen P.,9999,0,9999,0
1668212512300,CSE 293,033,119426,Snoeren; Alex C.,9999,0,9999,0
1668212512300,CSE 293,034,119428,Shang; Jingbo,9999,0,9999,0
1668212512300,CSE 293,035,119430,Stefan; Deian,9999,0,9999,0
1668212512300,CSE 293,036,119431,Su; Hao,9999,0,9999,0
1668212512300,CSE 293,037,119433,Swanson; Steven James,9999,0,9999,0
1668212512300,CSE 293,038,119435,Tullsen; Dean Michael,9999,0,9999,0
1668212512300,CSE 293,039,119483,Voelker; Geoffrey M.,9999,0,9999,0
1668212512300,CSE 293,040,119537,Zhao; Jishen,9999,0,9999,0
1668212512300,CSE 293,041,119538,Zhou; Yuan-Yuan,9999,0,9999,0
1668212512300,CSE 293,042,119539,Gao; Sicun,9999,0,9999,0
1668212512300,CSE 293,043,119540,Weibel; Nadir,9999,0,9999,0
1668212512300,CSE 293,044,119541,Gupta; Rajesh K.,9999,0,9999,0
1668212512300,CSE 293,045,126410,Vaccaro; Kristen Marie,9999,0,9999,0
1668212512300,CSE 293,046,126411,Klemke; Richard,9999,0,9999,0
1668212512737,CSE 294,A00,102459,Voelker; Geoffrey M.,0,0,0,0
1668212512737,CSE 294,B00,111322,Orailoglu; Alex,0,0,0,0
1668212513174,DSE 201,A00,096914,Deutsch; Alin Bernard,30,0,30,0
1668212513597,DSE 210,A00,096915,Dasgupta; Sanjoy,30,0,30,0
1668212514024,DSE 260A,A00,096916,Altintas De Callaf; Ilkay,30,0,30,0
1668212514453,ECE 200,001,103586,Antipa; Nicholas A,9999,0,9999,0
1668212514453,ECE 200,002,103587,Atanasov; Nikolay A.,9999,0,9999,0
1668212514453,ECE 200,003,103588,Bharadia; Dinesh,9999,0,9999,0
1668212514453,ECE 200,004,103589,Cheng; Chung Kuan,9999,0,9999,0
1668212514453,ECE 200,005,103590,Cosman; Pamela C.,9999,0,9999,0
1668212514453,ECE 200,006,103591,Dayeh; Shadi Ahmad,9999,0,9999,0
1668212514453,ECE 200,007,103592,Fainman; Yeshaiahu,9999,0,9999,0
1668212514453,ECE 200,008,103593,Ford; Joseph Earl,9999,0,9999,0
1668212514453,ECE 200,009,103594,Franceschetti; Massimo,9999,0,9999,0
1668212514453,ECE 200,010,103595,Fullerton; Eric E,9999,0,9999,0
1668212514453,ECE 200,011,103596,Galton; Ian A,9999,0,9999,0
1668212514453,ECE 200,012,103597,Gilja; Vikash,9999,0,9999,0
1668212514453,ECE 200,013,103598,Hall; Drew A.,9999,0,9999,0
1668212514453,ECE 200,014,103599,Hsueh; Tzu-Chien,9999,0,9999,0
1668212514453,ECE 200,015,103600,Javidi; Tara,9999,0,9999,0
1668212514453,ECE 200,016,103601,Kahng; Andrew Byun,9999,0,9999,0
1668212514453,ECE 200,017,103602,Kim; Young-Han,9999,0,9999,0
1668212514453,ECE 200,018,103603,Koushanfar; Farinaz,9999,0,9999,0
1668212514453,ECE 200,019,103604,Kuzum; Duygu,9999,0,9999,0
1668212514453,ECE 200,020,103605,Le; Hanh-Phuc,9999,0,9999,0
1668212514453,ECE 200,021,103606,Lin; Bill,9999,0,9999,0
1668212514453,ECE 200,022,103607,Liu; Zhaowei,9998,0,9999,1
1668212514453,ECE 200,023,103608,Lo; Yu-Hwa,9999,0,9999,0
1668212514453,ECE 200,024,103609,Lomakin; Vitaliy,9999,0,9999,0
1668212514453,ECE 200,025,103610,Mercier; Patrick Philip,9999,0,9999,0
1668212514453,ECE 200,026,103611,Meyer; Florian,9999,0,9999,0
1668212514453,ECE 200,027,103612,Milstein; Laurence B.,9999,0,9999,0
1668212514453,ECE 200,028,103613,Mir Arabbaygi; Siavash,9999,0,9999,0
1668212514453,ECE 200,029,103614,Mookherjea; Shayan,9999,0,9999,0
1668212514453,ECE 200,030,103615,Morris; Karcher William,9999,0,9999,0
1668212514453,ECE 200,031,103616,Ng; Tse Nga,9999,0,9999,0
1668212514453,ECE 200,032,103617,Nguyen; Truong Quang,9999,0,9999,0
1668212514453,ECE 200,033,103618,Nomura; Kenji,9999,0,9999,0
1668212514453,ECE 200,034,103619,Orlitsky; Alon,9999,0,9999,0
1668212514453,ECE 200,035,103620,Pal; Piya,9999,0,9999,0
1668212514453,ECE 200,036,103621,Papen; George C.,9999,0,9999,0
1668212514453,ECE 200,037,103622,Radic; Stojan,9999,0,9999,0
1668212514453,ECE 200,038,103623,Rao; Bhaskar D.,9999,0,9999,0
1668212514453,ECE 200,039,103624,Rao; Ramesh R,9999,0,9999,0
1668212514453,ECE 200,040,103625,Rebeiz; Gabriel,9999,0,9999,0
1668212514453,ECE 200,041,103626,Sanford; John R,9999,0,9999,0
1668212514453,ECE 200,042,103627,Siegel; Paul H.,9999,0,9999,0
1668212514453,ECE 200,043,103628,Sievenpiper; Daniel F.,9999,0,9999,0
1668212514453,ECE 200,044,103629,Sworder; David D.,9999,0,9999,0
1668212514453,ECE 200,045,103630,Taur; Yuan,9999,0,9999,0
1668212514453,ECE 200,046,103631,Touri; Behrouz,9999,0,9999,0
1668212514453,ECE 200,047,103632,Trivedi; Mohan M.,9999,0,9999,0
1668212514453,ECE 200,048,103633,Vasconcelos; Nuno,9999,0,9999,0
1668212514453,ECE 200,049,103634,Wang; Xiaolong,9999,0,9999,0
1668212514453,ECE 200,050,103635,Xie; Pengtao,9999,0,9999,0
1668212514453,ECE 200,051,103636,Yip; Michael,9999,0,9999,0
1668212514453,ECE 200,052,103637,Zeger; Kenneth A.,999,0,999,0
1668212514453,ECE 200,053,103638,Zhang; Xinyu,9999,0,9999,0
1668212514453,ECE 200,054,103639,Turakhia; Yatish Girish,9999,0,9999,0
1668212514453,ECE 200,055,103640,Kang; Mingu,9999,0,9999,0
1668212514453,ECE 200,056,103641,Shi; Yuanyuan,9999,0,9999,0
1668212514453,ECE 200,057,103642,Wang; Edward Jay,9999,0,9999,0
1668212514453,ECE 200,058,103643,Zheng; Yang,9999,0,9999,0
1668212514876,ECE 202,A00,103644,Kuzum; Duygu,0,0,0,0
1668212515300,ECE 212BN,A00,103646,Ng; Tse Nga,0,0,0,0
1668212515725,ECE 221,A00,111493,Staff,0,0,0,0
1668212516150,ECE 222B,A00,103647,Lomakin; Vitaliy,0,0,0,0
1668212516574,ECE 230B,A00,103648,Taur; Yuan,0,0,0,0
1668212516998,ECE 238B,A00,103649,Garay; Javier,0,0,0,0
1668212517421,ECE 240B,A00,112900,Fainman; Yeshaiahu,0,0,0,0
1668212517857,ECE 247A,A00,103650,Jokerst; Jesse Vincent,0,0,0,0
1668212518282,ECE 247B,A00,103651,Wang; Joseph,0,0,0,0
1668212518709,ECE 250,A00,103652,Siegel; Paul H.,0,0,0,0
1668212519134,ECE 251A,A00,103654,Rao; Bhaskar D.,0,0,0,0
1668212519564,ECE 257B,A00,103655,Bharadia; Dinesh,0,0,0,0
1668212519989,ECE 258A,A00,103656,Milstein; Laurence B.,0,0,0,0
1668212520412,ECE 260B,A00,103658,Kang; Mingu,0,0,0,0
1668212520836,ECE 264A,A00,103659,Galton; Ian A,0,0,0,0
1668212521273,ECE 265A,A00,103661,Gudem; Prasad S.S.,0,0,0,0
1668212521703,ECE 265D,A00,103662,Gudem; Prasad S.S.,0,0,0,0
1668212522129,ECE 268,A00,103663,Koushanfar; Farinaz,0,0,0,0
1668212522553,ECE 269,A01,103665,Pal; Piya,0,0,0,0
1668212522980,ECE 271B,A00,103666,Vasconcelos; Manuela,0,0,0,0
1668212523407,ECE 276A,A00,103667,Atanasov; Nikolay A.,0,0,0,0
1668212523834,ECE 277,A00,103668,An; Cheolhong,0,0,0,0
1668212524259,ECE 279,A00,117947,Hall; Drew A.,0,0,0,0
1668212525111,ECE 283,A00,103670,Hsueh; Tzu-Chien,0,0,0,0
1668212525539,ECE 284,A00,103671,Turakhia; Yatish Girish,0,0,0,0
1668212525967,ECE 285,A00,103672,Zheng; Yang,0,0,0,0
1668212525967,ECE 285,B00,103673,Sworder; David D.,0,0,0,0
1668212526399,ECE 287,A00,103676,Javidi; Tara,0,0,0,0
1668212526824,MATH 200B,A00,098023,Salehi Golsefidy; Alireza,12,0,15,3
1668212527249,MATH 202B,A00,098024,Rhoades; Brendon Patrick,9,0,15,6
1668212527677,MATH 203B,A00,098025,Oprea; Dragos N.,10,0,15,5
1668212528101,MATH 204B,A00,098026,Sorensen; Claus M,13,0,15,2
1668212528525,MATH 208,A00,098027,Izadi; Elham,7,0,10,3
1668212528951,MATH 209,A00,098028,Pollack; Aaron,10,0,10,0
1668212529376,MATH 211A,A00,112919,Rogalski; Daniel,9,0,10,1
1668212529806,MATH 211B,A00,112920,Seward; Brandon M.,9,0,10,1
1668212530232,MATH 218,A00,098029,Li; Bo,10,0,10,0
1668212530657,MATH 220B,A00,098030,Novak; Jonathan I,11,0,15,4
1668212531094,MATH 221A,A00,098031,Ebenfelt; Peter F,13,0,15,2
1668212531520,MATH 231B,A00,098032,Zlatos; Andrej,12,0,15,3
1668212531944,MATH 240B,A00,098033,Ni; Lei,9,0,15,6
1668212532370,MATH 243,A00,098034,Jekel; David Andrew,10,0,10,0
1668212532793,MATH 245A,A00,098035,Nie; Jiawang,0,0,15,16
1668212533217,MATH 248,A00,098036,Bejenaru; Ioan,10,0,10,0
1668212533645,MATH 250B,A00,098037,Spolaor; Luca,14,0,15,1
1668212534076,MATH 258,A00,098038,Ni; Lei,10,0,10,0
1668212534498,MATH 264B,A00,098041,Rhoades; Brendon Patrick,9,0,15,6
1668212534921,MATH 268,A00,098042,Buss; Samuel R,10,0,10,0
1668212535344,MATH 269,A00,098043,Rhoades; Brendon Patrick,10,0,10,0
1668212535779,MATH 270B,A00,098044,Li; Bo,10,0,15,5
1668212536204,MATH 272B,A00,098045,Holst; Michael J,13,0,15,2
1668212536630,MATH 273A,A00,098046,Tian; Xiaochuan,10,0,15,5
1668212537053,MATH 275,A01,098048,Tian; Xiaochuan,6,0,10,4
1668212537477,MATH 278A,A00,098049,Holst; Michael J,8,0,10,2
1668212537905,MATH 278B,A00,098050,Cloninger; Alexander,10,0,10,0
1668212538332,MATH 278C,A00,098051,Nie; Jiawang,7,0,10,3
1668212538755,MATH 280B,A00,098052,Zheng; Tianyi,10,0,15,5
1668212539178,MATH 281B,A00,098053,Bradic; Jelena,2,0,15,13
1668212539619,MATH 282B,A00,098054,Arias-Castro; Ery,0,0,15,15
1668212540060,MATH 285,A00,098055,Fitzsimmons; Patrick J,0,0,15,17
1668212540488,MATH 287B,A00,098056,Arias-Castro; Ery,2,0,15,13
1668212540923,MATH 288,A00,098057,Agarwal; Pooja,9,0,10,1
1668212540923,MATH 288,B00,098058,Zhang; Danna,8,0,10,2
1668212540923,MATH 288,C00,098059,Williams; Ruth J,10,0,10,0
1668212541346,MATH 290B,A00,098060,Roberts; Justin Deritter,13,0,15,2
1668212541771,MATH 292,A00,098061,Belmont; Eva Kinoshita,10,0,10,0
1668212542198,MATH 295,A00,098062,Suk; Andrew Hoon,48,0,50,2
1668212542624,MATH 296,A00,098063,Novak; Jonathan I,20,0,20,0
1668212543050,MATH 297,001,098064,Gamst; Anthony Collins,9997,0,9999,2
1668213044470,COGS 205,A00,101395,Chiba; Andrea,19,0,20,1
1668213044898,COGS 210B,001,101404,Greene; Deanna Jacquelyn,9998,0,9999,1
1668213044898,COGS 210B,002,101417,Xia; Haijun,9999,0,9999,0
1668213044898,COGS 210B,003,101422,Nitz; Douglas A.,9999,0,9999,0
1668213044898,COGS 210B,004,101423,Hollan; James D.,9998,0,9999,1
1668213044898,COGS 210B,005,101424,Deak; Gedeon O.,9998,0,9999,1
1668213044898,COGS 210B,006,101425,Rossano; Federico,9999,0,9999,0
1668213045324,COGS 211B,A00,101427,Coulson; Seana M,9996,0,9999,3
1668213045749,COGS 220,A00,101428,Hollan; James D.,0,0,25,25
1668213046172,COGS 229,A00,101429,Dow; Steven P,18,0,25,7
1668213046607,COGS 230,A00,101430,Klemmer; Scott R,12,0,17,5
1668213047030,COGS 234,A00,101431,Xia; Haijun,2,0,25,23
1668213047477,COGS 260,A00,101432,Kiyonaga; Anastasia,21,0,25,4
1668213047477,COGS 260,B00,101433,Kirsh; David Joel,15,0,25,10
1668213047904,CSE 202,A00,102371,Impagliazzo; Russell,0,0,0,0
1668213048332,CSE 203B,A01,102373,Cheng; Chung Kuan,0,0,0,0
1668213048767,CSE 208,A00,102374,Micciancio; Daniele,0,0,0,0
1668213049190,CSE 209A,A00,112895,Impagliazzo; Russell,0,0,15,15
1668213049613,CSE 209B,A00,108005,Bellare; Mihir,0,0,0,0
1668213050038,CSE 210,A00,113163,Coblenz; Michael J,0,0,0,0
1668213050461,CSE 219,A00,106111,Dow; Steven P,0,0,20,20
1668213050886,CSE 221,A00,102376,Voelker; Geoffrey M.,0,0,0,0
1668213051310,CSE 224,A01,102378,Porter; George M,0,0,0,0
1668213051736,CSE 229A,A00,102379,Savage; Stefan,0,0,0,0
1668213052163,CSE 229C,A00,102380,Munyaka; Imani N. S.,0,0,0,0
1668213052588,CSE 232B,A00,102382,Deutsch; Alin Bernard,0,0,0,0
1668213053016,CSE 234,A01,112904,Kumar; Arun Kumar,0,0,0,0
1668213053442,CSE 237A,A00,102383,Rosing; Tajana Simunic,0,0,0,0
1668213053869,CSE 239A,A00,102384,Deutsch; Alin Bernard,0,0,0,0
1668213054291,CSE 239B,A00,102385,Polikarpova; Nadezhda,0,0,0,0
1668213054718,CSE 240A,A00,102386,Pannuto; Patrick William,0,0,0,0
1668213055142,CSE 240B,A00,102387,Zhao; Jishen,0,0,0,0
1668213055571,CSE 241A,A00,106406,Kang; Mingu,0,0,0,0
1668213055999,CSE 249B,A00,102388,Kahng; Andrew Byun,0,0,8,8
1668213056422,CSE 251B,A01,102392,Cottrell; Garrison W,0,0,0,0
1668213056422,CSE 251B,A02,102393,Cottrell; Garrison W,0,0,0,0
1668213056849,CSE 252B,A00,102394,Ochoa; Benjamin Lawrence,0,0,0,0
1668213057276,CSE 257,A01,102396,Gao; Sicun,0,0,0,0
1668213057703,CSE 272,A00,102397,Li; Tzumao,0,0,0,0
1668213058129,CSE 274,A00,111323,Chern; Albert Ren-Haur,0,0,0,0
1668213058561,CSE 282,A00,102398,Pevzner; Pavel Arkadjevich,0,0,0,0
1668213058990,CSE 284,A00,114175,Gymrek; Melissa Ann,0,0,0,0
1668213059421,CSE 290,A00,102399,Chandraker; Manmohan Krishna,0,0,0,0
1668213059421,CSE 290,B00,102400,Vaccaro; Kristen Marie,0,0,25,25
1668213059421,CSE 290,C00,102414,Pannuto; Patrick William,0,0,25,25
1668213059421,CSE 290,D00,102427,Pevzner; Pavel Arkadjevich,0,0,0,0
1668213059421,CSE 290,E00,102429,Zhao; Jishen,0,0,0,0
1668213059421,CSE 290,F00,102436,Tullsen; Dean Michael,0,0,0,0
1668213059421,CSE 290,G00,102440,Christensen; Henrik I,0,0,20,20
1668213059851,CSE 291,A00,102443,Su; Hao,0,0,0,0
1668213059851,CSE 291,B00,102448,Polikarpova; Nadezhda,0,0,0,0
1668213059851,CSE 291,C00,102453,Vaccaro; Kristen Marie,0,0,0,0
1668213059851,CSE 291,D00,111343,Savage; Stefan,0,0,0,0
1668213059851,CSE 291,E00,116474,Claffy; Kimberly Claire,0,0,0,0
1668213059851,CSE 291,F00,116479,Pasquale; Joseph,0,0,0,0
1668213060278,CSE 293,001,119111,Bafna; Vineet,9999,0,9999,0
1668213060278,CSE 293,002,119118,Bellare; Mihir,9999,0,9999,0
1668213060278,CSE 293,003,119122,Berg-Kirkpatrick; Taylor D,9999,0,9999,0
1668213060278,CSE 293,004,119135,Christensen; Henrik I,9999,0,9999,0
1668213060278,CSE 293,005,119142,Cottrell; Garrison W,9999,0,9999,0
1668213060278,CSE 293,006,119146,Deutsch; Alin Bernard,9999,0,9999,0
1668213060278,CSE 293,007,119159,Esmaeilzadeh; Hadi,9999,0,9999,0
1668213060278,CSE 293,008,119166,Freund; Yoav,9999,0,9999,0
1668213060278,CSE 293,009,119170,Griswold; William G.,9999,0,9999,0
1668213060278,CSE 293,010,119183,Gymrek; Melissa Ann,9999,0,9999,0
1668213060278,CSE 293,011,119190,Heninger; Nadia A,9999,0,9999,0
1668213060278,CSE 293,012,119230,Impagliazzo; Russell,9999,0,9999,0
1668213060278,CSE 293,013,119232,Jhala; Ranjit,9999,0,9999,0
1668213060278,CSE 293,014,119233,Kahng; Andrew Byun,9999,0,9999,0
1668213060278,CSE 293,015,119298,Kane; Daniel Mertz,9999,0,9999,0
1668213060278,CSE 293,016,119299,Kriegman; David J,9999,0,9999,0
1668213060278,CSE 293,017,119300,Kumar; Arun Kumar,9999,0,9999,0
1668213060278,CSE 293,018,119301,Lerner; Sorin,9999,0,9999,0
1668213060278,CSE 293,019,119302,Lovett; Shachar,9999,0,9999,0
1668213060278,CSE 293,020,119303,McAuley; Julian John,9999,0,9999,0
1668213060278,CSE 293,021,119304,Micciancio; Daniele,9999,0,9999,0
1668213060278,CSE 293,022,119367,Orailoglu; Alex,9999,0,9999,0
1668213060278,CSE 293,023,119382,Paturi; Ramamohan,9999,0,9999,0
1668213060278,CSE 293,024,119404,Polikarpova; Nadezhda,9999,0,9999,0
1668213060278,CSE 293,025,119406,Politz; Joseph Gibbs,9999,0,9999,0
1668213060278,CSE 293,026,119411,Porter; George M,9999,0,9999,0
1668213060278,CSE 293,027,119414,Porter; Leonard Emerson,9999,0,9999,0
1668213060278,CSE 293,028,119416,Ramamoorthi; Ravi,9999,0,9999,0
1668213060278,CSE 293,029,119417,Sahoo; Debashis,9999,0,9999,0
1668213060278,CSE 293,030,119420,Saul; Lawrence,9999,0,9999,0
1668213060278,CSE 293,031,119421,Savage; Stefan,9999,0,9999,0
1668213060278,CSE 293,032,119425,Schulze; Jurgen P.,9999,0,9999,0
1668213060278,CSE 293,033,119426,Snoeren; Alex C.,9999,0,9999,0
1668213060278,CSE 293,034,119428,Shang; Jingbo,9999,0,9999,0
1668213060278,CSE 293,035,119430,Stefan; Deian,9999,0,9999,0
1668213060278,CSE 293,036,119431,Su; Hao,9999,0,9999,0
1668213060278,CSE 293,037,119433,Swanson; Steven James,9999,0,9999,0
1668213060278,CSE 293,038,119435,Tullsen; Dean Michael,9999,0,9999,0
1668213060278,CSE 293,039,119483,Voelker; Geoffrey M.,9999,0,9999,0
1668213060278,CSE 293,040,119537,Zhao; Jishen,9999,0,9999,0
1668213060278,CSE 293,041,119538,Zhou; Yuan-Yuan,9999,0,9999,0
1668213060278,CSE 293,042,119539,Gao; Sicun,9999,0,9999,0
1668213060278,CSE 293,043,119540,Weibel; Nadir,9999,0,9999,0
1668213060278,CSE 293,044,119541,Gupta; Rajesh K.,9999,0,9999,0
1668213060278,CSE 293,045,126410,Vaccaro; Kristen Marie,9999,0,9999,0
1668213060278,CSE 293,046,126411,Klemke; Richard,9999,0,9999,0
1668213060700,CSE 294,A00,102459,Voelker; Geoffrey M.,0,0,0,0
1668213060700,CSE 294,B00,111322,Orailoglu; Alex,0,0,0,0
1668213061125,DSE 201,A00,096914,Deutsch; Alin Bernard,30,0,30,0
1668213061549,DSE 210,A00,096915,Dasgupta; Sanjoy,30,0,30,0
1668213061977,DSE 260A,A00,096916,Altintas De Callaf; Ilkay,30,0,30,0
1668213062429,ECE 200,001,103586,Antipa; Nicholas A,9999,0,9999,0
1668213062429,ECE 200,002,103587,Atanasov; Nikolay A.,9999,0,9999,0
1668213062429,ECE 200,003,103588,Bharadia; Dinesh,9999,0,9999,0
1668213062429,ECE 200,004,103589,Cheng; Chung Kuan,9999,0,9999,0
1668213062429,ECE 200,005,103590,Cosman; Pamela C.,9999,0,9999,0
1668213062429,ECE 200,006,103591,Dayeh; Shadi Ahmad,9999,0,9999,0
1668213062429,ECE 200,007,103592,Fainman; Yeshaiahu,9999,0,9999,0
1668213062429,ECE 200,008,103593,Ford; Joseph Earl,9999,0,9999,0
1668213062429,ECE 200,009,103594,Franceschetti; Massimo,9999,0,9999,0
1668213062429,ECE 200,010,103595,Fullerton; Eric E,9999,0,9999,0
1668213062429,ECE 200,011,103596,Galton; Ian A,9999,0,9999,0
1668213062429,ECE 200,012,103597,Gilja; Vikash,9999,0,9999,0
1668213062429,ECE 200,013,103598,Hall; Drew A.,9999,0,9999,0
1668213062429,ECE 200,014,103599,Hsueh; Tzu-Chien,9999,0,9999,0
1668213062429,ECE 200,015,103600,Javidi; Tara,9999,0,9999,0
1668213062429,ECE 200,016,103601,Kahng; Andrew Byun,9999,0,9999,0
1668213062429,ECE 200,017,103602,Kim; Young-Han,9999,0,9999,0
1668213062429,ECE 200,018,103603,Koushanfar; Farinaz,9999,0,9999,0
1668213062429,ECE 200,019,103604,Kuzum; Duygu,9999,0,9999,0
1668213062429,ECE 200,020,103605,Le; Hanh-Phuc,9999,0,9999,0
1668213062429,ECE 200,021,103606,Lin; Bill,9999,0,9999,0
1668213062429,ECE 200,022,103607,Liu; Zhaowei,9998,0,9999,1
1668213062429,ECE 200,023,103608,Lo; Yu-Hwa,9999,0,9999,0
1668213062429,ECE 200,024,103609,Lomakin; Vitaliy,9999,0,9999,0
1668213062429,ECE 200,025,103610,Mercier; Patrick Philip,9999,0,9999,0
1668213062429,ECE 200,026,103611,Meyer; Florian,9999,0,9999,0
1668213062429,ECE 200,027,103612,Milstein; Laurence B.,9999,0,9999,0
1668213062429,ECE 200,028,103613,Mir Arabbaygi; Siavash,9999,0,9999,0
1668213062429,ECE 200,029,103614,Mookherjea; Shayan,9999,0,9999,0
1668213062429,ECE 200,030,103615,Morris; Karcher William,9999,0,9999,0
1668213062429,ECE 200,031,103616,Ng; Tse Nga,9999,0,9999,0
1668213062429,ECE 200,032,103617,Nguyen; Truong Quang,9999,0,9999,0
1668213062429,ECE 200,033,103618,Nomura; Kenji,9999,0,9999,0
1668213062429,ECE 200,034,103619,Orlitsky; Alon,9999,0,9999,0
1668213062429,ECE 200,035,103620,Pal; Piya,9999,0,9999,0
1668213062429,ECE 200,036,103621,Papen; George C.,9999,0,9999,0
1668213062429,ECE 200,037,103622,Radic; Stojan,9999,0,9999,0
1668213062429,ECE 200,038,103623,Rao; Bhaskar D.,9999,0,9999,0
1668213062429,ECE 200,039,103624,Rao; Ramesh R,9999,0,9999,0
1668213062429,ECE 200,040,103625,Rebeiz; Gabriel,9999,0,9999,0
1668213062429,ECE 200,041,103626,Sanford; John R,9999,0,9999,0
1668213062429,ECE 200,042,103627,Siegel; Paul H.,9999,0,9999,0
1668213062429,ECE 200,043,103628,Sievenpiper; Daniel F.,9999,0,9999,0
1668213062429,ECE 200,044,103629,Sworder; David D.,9999,0,9999,0
1668213062429,ECE 200,045,103630,Taur; Yuan,9999,0,9999,0
1668213062429,ECE 200,046,103631,Touri; Behrouz,9999,0,9999,0
1668213062429,ECE 200,047,103632,Trivedi; Mohan M.,9999,0,9999,0
1668213062429,ECE 200,048,103633,Vasconcelos; Nuno,9999,0,9999,0
1668213062429,ECE 200,049,103634,Wang; Xiaolong,9999,0,9999,0
1668213062429,ECE 200,050,103635,Xie; Pengtao,9999,0,9999,0
1668213062429,ECE 200,051,103636,Yip; Michael,9999,0,9999,0
1668213062429,ECE 200,052,103637,Zeger; Kenneth A.,999,0,999,0
1668213062429,ECE 200,053,103638,Zhang; Xinyu,9999,0,9999,0
1668213062429,ECE 200,054,103639,Turakhia; Yatish Girish,9999,0,9999,0
1668213062429,ECE 200,055,103640,Kang; Mingu,9999,0,9999,0
1668213062429,ECE 200,056,103641,Shi; Yuanyuan,9999,0,9999,0
1668213062429,ECE 200,057,103642,Wang; Edward Jay,9999,0,9999,0
1668213062429,ECE 200,058,103643,Zheng; Yang,9999,0,9999,0
1668213062852,ECE 202,A00,103644,Kuzum; Duygu,0,0,0,0
1668213063275,ECE 212BN,A00,103646,Ng; Tse Nga,0,0,0,0
1668213063700,ECE 221,A00,111493,Staff,0,0,0,0
1668213064123,ECE 222B,A00,103647,Lomakin; Vitaliy,0,0,0,0
1668213064546,ECE 230B,A00,103648,Taur; Yuan,0,0,0,0
1668213064970,ECE 238B,A00,103649,Garay; Javier,0,0,0,0
1668213065395,ECE 240B,A00,112900,Fainman; Yeshaiahu,0,0,0,0
1668213065825,ECE 247A,A00,103650,Jokerst; Jesse Vincent,0,0,0,0
1668213066259,ECE 247B,A00,103651,Wang; Joseph,0,0,0,0
1668213066694,ECE 250,A00,103652,Siegel; Paul H.,0,0,0,0
1668213067134,ECE 251A,A00,103654,Rao; Bhaskar D.,0,0,0,0
1668213067574,ECE 257B,A00,103655,Bharadia; Dinesh,0,0,0,0
1668213068001,ECE 258A,A00,103656,Milstein; Laurence B.,0,0,0,0
1668213068429,ECE 260B,A00,103658,Kang; Mingu,0,0,0,0
1668213068854,ECE 264A,A00,103659,Galton; Ian A,0,0,0,0
1668213069280,ECE 265A,A00,103661,Gudem; Prasad S.S.,0,0,0,0
1668213069706,ECE 265D,A00,103662,Gudem; Prasad S.S.,0,0,0,0
1668213070142,ECE 268,A00,103663,Koushanfar; Farinaz,0,0,0,0
1668213070569,ECE 269,A01,103665,Pal; Piya,0,0,0,0
1668213070999,ECE 271B,A00,103666,Vasconcelos; Manuela,0,0,0,0
1668213071428,ECE 276A,A00,103667,Atanasov; Nikolay A.,0,0,0,0
1668213071850,ECE 277,A00,103668,An; Cheolhong,0,0,0,0
1668213072274,ECE 279,A00,117947,Hall; Drew A.,0,0,0,0
1668213073148,ECE 283,A00,103670,Hsueh; Tzu-Chien,0,0,0,0
1668213073673,ECE 284,A00,103671,Turakhia; Yatish Girish,0,0,0,0
1668213074104,ECE 285,A00,103672,Zheng; Yang,0,0,0,0
1668213074104,ECE 285,B00,103673,Sworder; David D.,0,0,0,0
1668213074527,ECE 287,A00,103676,Javidi; Tara,0,0,0,0
1668213074950,MATH 200B,A00,098023,Salehi Golsefidy; Alireza,12,0,15,3
1668213075374,MATH 202B,A00,098024,Rhoades; Brendon Patrick,9,0,15,6
1668213075803,MATH 203B,A00,098025,Oprea; Dragos N.,10,0,15,5
1668213076247,MATH 204B,A00,098026,Sorensen; Claus M,13,0,15,2
1668213076671,MATH 208,A00,098027,Izadi; Elham,7,0,10,3
1668213077095,MATH 209,A00,098028,Pollack; Aaron,10,0,10,0
1668213077520,MATH 211A,A00,112919,Rogalski; Daniel,9,0,10,1
1668213077945,MATH 211B,A00,112920,Seward; Brandon M.,9,0,10,1
1668213078454,MATH 218,A00,098029,Li; Bo,10,0,10,0
1668213078890,MATH 220B,A00,098030,Novak; Jonathan I,11,0,15,4
1668213079318,MATH 221A,A00,098031,Ebenfelt; Peter F,13,0,15,2
1668213079742,MATH 231B,A00,098032,Zlatos; Andrej,12,0,15,3
1668213080166,MATH 240B,A00,098033,Ni; Lei,9,0,15,6
1668213080593,MATH 243,A00,098034,Jekel; David Andrew,10,0,10,0
1668213081019,MATH 245A,A00,098035,Nie; Jiawang,0,0,15,16
1668213081442,MATH 248,A00,098036,Bejenaru; Ioan,10,0,10,0
1668213081866,MATH 250B,A00,098037,Spolaor; Luca,14,0,15,1
1668213082298,MATH 258,A00,098038,Ni; Lei,10,0,10,0
1668213082724,MATH 264B,A00,098041,Rhoades; Brendon Patrick,9,0,15,6
1668213083148,MATH 268,A00,098042,Buss; Samuel R,10,0,10,0
1668213083577,MATH 269,A00,098043,Rhoades; Brendon Patrick,10,0,10,0
1668213084015,MATH 270B,A00,098044,Li; Bo,10,0,15,5
1668213084439,MATH 272B,A00,098045,Holst; Michael J,13,0,15,2
1668213084867,MATH 273A,A00,098046,Tian; Xiaochuan,10,0,15,5
1668213085292,MATH 275,A01,098048,Tian; Xiaochuan,6,0,10,4
1668213085717,MATH 278A,A00,098049,Holst; Michael J,8,0,10,2
1668213086140,MATH 278B,A00,098050,Cloninger; Alexander,10,0,10,0
1668213086565,MATH 278C,A00,098051,Nie; Jiawang,7,0,10,3
1668213086989,MATH 280B,A00,098052,Zheng; Tianyi,10,0,15,5
1668213087414,MATH 281B,A00,098053,Bradic; Jelena,2,0,15,13
1668213087836,MATH 282B,A00,098054,Arias-Castro; Ery,0,0,15,15
1668213088259,MATH 285,A00,098055,Fitzsimmons; Patrick J,0,0,15,17
1668213088690,MATH 287B,A00,098056,Arias-Castro; Ery,2,0,15,13
1668213089114,MATH 288,A00,098057,Agarwal; Pooja,9,0,10,1
1668213089114,MATH 288,B00,098058,Zhang; Danna,8,0,10,2
1668213089114,MATH 288,C00,098059,Williams; Ruth J,10,0,10,0
1668213089541,MATH 290B,A00,098060,Roberts; Justin Deritter,13,0,15,2
1668213089965,MATH 292,A00,098061,Belmont; Eva Kinoshita,10,0,10,0
1668213090396,MATH 295,A00,098062,Suk; Andrew Hoon,48,0,50,2
1668213090820,MATH 296,A00,098063,Novak; Jonathan I,20,0,20,0
1668213091252,MATH 297,001,098064,Gamst; Anthony Collins,9997,0,9999,2
1668213592034,COGS 205,A00,101395,Chiba; Andrea,19,0,20,1
1668213592457,COGS 210B,001,101404,Greene; Deanna Jacquelyn,9998,0,9999,1
1668213592457,COGS 210B,002,101417,Xia; Haijun,9999,0,9999,0
1668213592457,COGS 210B,003,101422,Nitz; Douglas A.,9999,0,9999,0
1668213592457,COGS 210B,004,101423,Hollan; James D.,9998,0,9999,1
1668213592457,COGS 210B,005,101424,Deak; Gedeon O.,9998,0,9999,1
1668213592457,COGS 210B,006,101425,Rossano; Federico,9999,0,9999,0
1668213592882,COGS 211B,A00,101427,Coulson; Seana M,9996,0,9999,3
1668213593317,COGS 220,A00,101428,Hollan; James D.,0,0,25,25
1668213593741,COGS 229,A00,101429,Dow; Steven P,18,0,25,7
1668213594163,COGS 230,A00,101430,Klemmer; Scott R,12,0,17,5
1668213594678,COGS 234,A00,101431,Xia; Haijun,2,0,25,23
1668213595113,COGS 260,A00,101432,Kiyonaga; Anastasia,21,0,25,4
1668213595113,COGS 260,B00,101433,Kirsh; David Joel,15,0,25,10
1668213595538,CSE 202,A00,102371,Impagliazzo; Russell,0,0,0,0
1668213595976,CSE 203B,A01,102373,Cheng; Chung Kuan,0,0,0,0
1668213596401,CSE 208,A00,102374,Micciancio; Daniele,0,0,0,0
1668213596823,CSE 209A,A00,112895,Impagliazzo; Russell,0,0,15,15
1668213597252,CSE 209B,A00,108005,Bellare; Mihir,0,0,0,0
1668213597678,CSE 210,A00,113163,Coblenz; Michael J,0,0,0,0
1668213598103,CSE 219,A00,106111,Dow; Steven P,0,0,20,20
1668213598527,CSE 221,A00,102376,Voelker; Geoffrey M.,0,0,0,0
1668213598953,CSE 224,A01,102378,Porter; George M,0,0,0,0
1668213599386,CSE 229A,A00,102379,Savage; Stefan,0,0,0,0
1668213599811,CSE 229C,A00,102380,Munyaka; Imani N. S.,0,0,0,0
1668213600235,CSE 232B,A00,102382,Deutsch; Alin Bernard,0,0,0,0
1668213601087,CSE 234,A01,112904,Kumar; Arun Kumar,0,0,0,0
1668213601711,CSE 237A,A00,102383,Rosing; Tajana Simunic,0,0,0,0
1668213602155,CSE 239A,A00,102384,Deutsch; Alin Bernard,0,0,0,0
1668213602780,CSE 239B,A00,102385,Polikarpova; Nadezhda,0,0,0,0
1668213603211,CSE 240A,A00,102386,Pannuto; Patrick William,0,0,0,0
1668213603639,CSE 240B,A00,102387,Zhao; Jishen,0,0,0,0
1668213604071,CSE 241A,A00,106406,Kang; Mingu,0,0,0,0
1668213604495,CSE 249B,A00,102388,Kahng; Andrew Byun,0,0,8,8
1668213604922,CSE 251B,A01,102392,Cottrell; Garrison W,0,0,0,0
1668213604922,CSE 251B,A02,102393,Cottrell; Garrison W,0,0,0,0
1668213605343,CSE 252B,A00,102394,Ochoa; Benjamin Lawrence,0,0,0,0
1668213605770,CSE 257,A01,102396,Gao; Sicun,0,0,0,0
1668213606201,CSE 272,A00,102397,Li; Tzumao,0,0,0,0
1668213606623,CSE 274,A00,111323,Chern; Albert Ren-Haur,0,0,0,0
1668213607050,CSE 282,A00,102398,Pevzner; Pavel Arkadjevich,0,0,0,0
1668213607474,CSE 284,A00,114175,Gymrek; Melissa Ann,0,0,0,0
1668213607911,CSE 290,A00,102399,Chandraker; Manmohan Krishna,0,0,0,0
1668213607911,CSE 290,B00,102400,Vaccaro; Kristen Marie,0,0,25,25
1668213607911,CSE 290,C00,102414,Pannuto; Patrick William,0,0,25,25
1668213607911,CSE 290,D00,102427,Pevzner; Pavel Arkadjevich,0,0,0,0
1668213607911,CSE 290,E00,102429,Zhao; Jishen,0,0,0,0
1668213607911,CSE 290,F00,102436,Tullsen; Dean Michael,0,0,0,0
1668213607911,CSE 290,G00,102440,Christensen; Henrik I,0,0,20,20
1668213608336,CSE 291,A00,102443,Su; Hao,0,0,0,0
1668213608336,CSE 291,B00,102448,Polikarpova; Nadezhda,0,0,0,0
1668213608336,CSE 291,C00,102453,Vaccaro; Kristen Marie,0,0,0,0
1668213608336,CSE 291,D00,111343,Savage; Stefan,0,0,0,0
1668213608336,CSE 291,E00,116474,Claffy; Kimberly Claire,0,0,0,0
1668213608336,CSE 291,F00,116479,Pasquale; Joseph,0,0,0,0
1668213608793,CSE 293,001,119111,Bafna; Vineet,9999,0,9999,0
1668213608793,CSE 293,002,119118,Bellare; Mihir,9999,0,9999,0
1668213608793,CSE 293,003,119122,Berg-Kirkpatrick; Taylor D,9999,0,9999,0
1668213608793,CSE 293,004,119135,Christensen; Henrik I,9999,0,9999,0
1668213608793,CSE 293,005,119142,Cottrell; Garrison W,9999,0,9999,0
1668213608793,CSE 293,006,119146,Deutsch; Alin Bernard,9999,0,9999,0
1668213608793,CSE 293,007,119159,Esmaeilzadeh; Hadi,9999,0,9999,0
1668213608793,CSE 293,008,119166,Freund; Yoav,9999,0,9999,0
1668213608793,CSE 293,009,119170,Griswold; William G.,9999,0,9999,0
1668213608793,CSE 293,010,119183,Gymrek; Melissa Ann,9999,0,9999,0
1668213608793,CSE 293,011,119190,Heninger; Nadia A,9999,0,9999,0
1668213608793,CSE 293,012,119230,Impagliazzo; Russell,9999,0,9999,0
1668213608793,CSE 293,013,119232,Jhala; Ranjit,9999,0,9999,0
1668213608793,CSE 293,014,119233,Kahng; Andrew Byun,9999,0,9999,0
1668213608793,CSE 293,015,119298,Kane; Daniel Mertz,9999,0,9999,0
1668213608793,CSE 293,016,119299,Kriegman; David J,9999,0,9999,0
1668213608793,CSE 293,017,119300,Kumar; Arun Kumar,9999,0,9999,0
1668213608793,CSE 293,018,119301,Lerner; Sorin,9999,0,9999,0
1668213608793,CSE 293,019,119302,Lovett; Shachar,9999,0,9999,0
1668213608793,CSE 293,020,119303,McAuley; Julian John,9999,0,9999,0
1668213608793,CSE 293,021,119304,Micciancio; Daniele,9999,0,9999,0
1668213608793,CSE 293,022,119367,Orailoglu; Alex,9999,0,9999,0
1668213608793,CSE 293,023,119382,Paturi; Ramamohan,9999,0,9999,0
1668213608793,CSE 293,024,119404,Polikarpova; Nadezhda,9999,0,9999,0
1668213608793,CSE 293,025,119406,Politz; Joseph Gibbs,9999,0,9999,0
1668213608793,CSE 293,026,119411,Porter; George M,9999,0,9999,0
1668213608793,CSE 293,027,119414,Porter; Leonard Emerson,9999,0,9999,0
1668213608793,CSE 293,028,119416,Ramamoorthi; Ravi,9999,0,9999,0
1668213608793,CSE 293,029,119417,Sahoo; Debashis,9999,0,9999,0
1668213608793,CSE 293,030,119420,Saul; Lawrence,9999,0,9999,0
1668213608793,CSE 293,031,119421,Savage; Stefan,9999,0,9999,0
1668213608793,CSE 293,032,119425,Schulze; Jurgen P.,9999,0,9999,0
1668213608793,CSE 293,033,119426,Snoeren; Alex C.,9999,0,9999,0
1668213608793,CSE 293,034,119428,Shang; Jingbo,9999,0,9999,0
1668213608793,CSE 293,035,119430,Stefan; Deian,9999,0,9999,0
1668213608793,CSE 293,036,119431,Su; Hao,9999,0,9999,0
1668213608793,CSE 293,037,119433,Swanson; Steven James,9999,0,9999,0
1668213608793,CSE 293,038,119435,Tullsen; Dean Michael,9999,0,9999,0
1668213608793,CSE 293,039,119483,Voelker; Geoffrey M.,9999,0,9999,0
1668213608793,CSE 293,040,119537,Zhao; Jishen,9999,0,9999,0
1668213608793,CSE 293,041,119538,Zhou; Yuan-Yuan,9999,0,9999,0
1668213608793,CSE 293,042,119539,Gao; Sicun,9999,0,9999,0
1668213608793,CSE 293,043,119540,Weibel; Nadir,9999,0,9999,0
1668213608793,CSE 293,044,119541,Gupta; Rajesh K.,9999,0,9999,0
1668213608793,CSE 293,045,126410,Vaccaro; Kristen Marie,9999,0,9999,0
1668213608793,CSE 293,046,126411,Klemke; Richard,9999,0,9999,0
1668213609229,CSE 294,A00,102459,Voelker; Geoffrey M.,0,0,0,0
1668213609229,CSE 294,B00,111322,Orailoglu; Alex,0,0,0,0
1668213609650,DSE 201,A00,096914,Deutsch; Alin Bernard,30,0,30,0
1668213610084,DSE 210,A00,096915,Dasgupta; Sanjoy,30,0,30,0
1668213610507,DSE 260A,A00,096916,Altintas De Callaf; Ilkay,30,0,30,0
1668213611069,ECE 200,001,103586,Antipa; Nicholas A,9999,0,9999,0
1668213611069,ECE 200,002,103587,Atanasov; Nikolay A.,9999,0,9999,0
1668213611069,ECE 200,003,103588,Bharadia; Dinesh,9999,0,9999,0
1668213611069,ECE 200,004,103589,Cheng; Chung Kuan,9999,0,9999,0
1668213611069,ECE 200,005,103590,Cosman; Pamela C.,9999,0,9999,0
1668213611069,ECE 200,006,103591,Dayeh; Shadi Ahmad,9999,0,9999,0
1668213611069,ECE 200,007,103592,Fainman; Yeshaiahu,9999,0,9999,0
1668213611069,ECE 200,008,103593,Ford; Joseph Earl,9999,0,9999,0
1668213611069,ECE 200,009,103594,Franceschetti; Massimo,9999,0,9999,0
1668213611069,ECE 200,010,103595,Fullerton; Eric E,9999,0,9999,0
1668213611069,ECE 200,011,103596,Galton; Ian A,9999,0,9999,0
1668213611069,ECE 200,012,103597,Gilja; Vikash,9999,0,9999,0
1668213611069,ECE 200,013,103598,Hall; Drew A.,9999,0,9999,0
1668213611069,ECE 200,014,103599,Hsueh; Tzu-Chien,9999,0,9999,0
1668213611069,ECE 200,015,103600,Javidi; Tara,9999,0,9999,0
1668213611069,ECE 200,016,103601,Kahng; Andrew Byun,9999,0,9999,0
1668213611069,ECE 200,017,103602,Kim; Young-Han,9999,0,9999,0
1668213611069,ECE 200,018,103603,Koushanfar; Farinaz,9999,0,9999,0
1668213611069,ECE 200,019,103604,Kuzum; Duygu,9999,0,9999,0
1668213611069,ECE 200,020,103605,Le; Hanh-Phuc,9999,0,9999,0
1668213611069,ECE 200,021,103606,Lin; Bill,9999,0,9999,0
1668213611069,ECE 200,022,103607,Liu; Zhaowei,9998,0,9999,1
1668213611069,ECE 200,023,103608,Lo; Yu-Hwa,9999,0,9999,0
1668213611069,ECE 200,024,103609,Lomakin; Vitaliy,9999,0,9999,0
1668213611069,ECE 200,025,103610,Mercier; Patrick Philip,9999,0,9999,0
1668213611069,ECE 200,026,103611,Meyer; Florian,9999,0,9999,0
1668213611069,ECE 200,027,103612,Milstein; Laurence B.,9999,0,9999,0
1668213611069,ECE 200,028,103613,Mir Arabbaygi; Siavash,9999,0,9999,0
1668213611069,ECE 200,029,103614,Mookherjea; Shayan,9999,0,9999,0
1668213611069,ECE 200,030,103615,Morris; Karcher William,9999,0,9999,0
1668213611069,ECE 200,031,103616,Ng; Tse Nga,9999,0,9999,0
1668213611069,ECE 200,032,103617,Nguyen; Truong Quang,9999,0,9999,0
1668213611069,ECE 200,033,103618,Nomura; Kenji,9999,0,9999,0
1668213611069,ECE 200,034,103619,Orlitsky; Alon,9999,0,9999,0
1668213611069,ECE 200,035,103620,Pal; Piya,9999,0,9999,0
1668213611069,ECE 200,036,103621,Papen; George C.,9999,0,9999,0
1668213611069,ECE 200,037,103622,Radic; Stojan,9999,0,9999,0
1668213611069,ECE 200,038,103623,Rao; Bhaskar D.,9999,0,9999,0
1668213611069,ECE 200,039,103624,Rao; Ramesh R,9999,0,9999,0
1668213611069,ECE 200,040,103625,Rebeiz; Gabriel,9999,0,9999,0
1668213611069,ECE 200,041,103626,Sanford; John R,9999,0,9999,0
1668213611069,ECE 200,042,103627,Siegel; Paul H.,9999,0,9999,0
1668213611069,ECE 200,043,103628,Sievenpiper; Daniel F.,9999,0,9999,0
1668213611069,ECE 200,044,103629,Sworder; David D.,9999,0,9999,0
1668213611069,ECE 200,045,103630,Taur; Yuan,9999,0,9999,0
1668213611069,ECE 200,046,103631,Touri; Behrouz,9999,0,9999,0
1668213611069,ECE 200,047,103632,Trivedi; Mohan M.,9999,0,9999,0
1668213611069,ECE 200,048,103633,Vasconcelos; Nuno,9999,0,9999,0
1668213611069,ECE 200,049,103634,Wang; Xiaolong,9999,0,9999,0
1668213611069,ECE 200,050,103635,Xie; Pengtao,9999,0,9999,0
1668213611069,ECE 200,051,103636,Yip; Michael,9999,0,9999,0
1668213611069,ECE 200,052,103637,Zeger; Kenneth A.,999,0,999,0
1668213611069,ECE 200,053,103638,Zhang; Xinyu,9999,0,9999,0
1668213611069,ECE 200,054,103639,Turakhia; Yatish Girish,9999,0,9999,0
1668213611069,ECE 200,055,103640,Kang; Mingu,9999,0,9999,0
1668213611069,ECE 200,056,103641,Shi; Yuanyuan,9999,0,9999,0
1668213611069,ECE 200,057,103642,Wang; Edward Jay,9999,0,9999,0
1668213611069,ECE 200,058,103643,Zheng; Yang,9999,0,9999,0
1668213611491,ECE 202,A00,103644,Kuzum; Duygu,0,0,0,0
1668213611915,ECE 212BN,A00,103646,Ng; Tse Nga,0,0,0,0
1668213612337,ECE 221,A00,111493,Staff,0,0,0,0
1668213612780,ECE 222B,A00,103647,Lomakin; Vitaliy,0,0,0,0
1668213613207,ECE 230B,A00,103648,Taur; Yuan,0,0,0,0
1668213613631,ECE 238B,A00,103649,Garay; Javier,0,0,0,0
1668213614063,ECE 240B,A00,112900,Fainman; Yeshaiahu,0,0,0,0
1668213614490,ECE 247A,A00,103650,Jokerst; Jesse Vincent,0,0,0,0
1668213614923,ECE 247B,A00,103651,Wang; Joseph,0,0,0,0
1668213615346,ECE 250,A00,103652,Siegel; Paul H.,0,0,0,0
1668213615773,ECE 251A,A00,103654,Rao; Bhaskar D.,0,0,0,0
1668213616203,ECE 257B,A00,103655,Bharadia; Dinesh,0,0,0,0
1668213616624,ECE 258A,A00,103656,Milstein; Laurence B.,0,0,0,0
1668213617060,ECE 260B,A00,103658,Kang; Mingu,0,0,0,0
1668213617495,ECE 264A,A00,103659,Galton; Ian A,0,0,0,0
1668213617924,ECE 265A,A00,103661,Gudem; Prasad S.S.,0,0,0,0
1668213618349,ECE 265D,A00,103662,Gudem; Prasad S.S.,0,0,0,0
1668213618774,ECE 268,A00,103663,Koushanfar; Farinaz,0,0,0,0
1668213619198,ECE 269,A01,103665,Pal; Piya,0,0,0,0
1668213619623,ECE 271B,A00,103666,Vasconcelos; Manuela,0,0,0,0
1668213620046,ECE 276A,A00,103667,Atanasov; Nikolay A.,0,0,0,0
1668213620471,ECE 277,A00,103668,An; Cheolhong,0,0,0,0
1668213620893,ECE 279,A00,117947,Hall; Drew A.,0,0,0,0
1668213621740,ECE 283,A00,103670,Hsueh; Tzu-Chien,0,0,0,0
1668213622173,ECE 284,A00,103671,Turakhia; Yatish Girish,0,0,0,0
1668213622597,ECE 285,A00,103672,Zheng; Yang,0,0,0,0
1668213622597,ECE 285,B00,103673,Sworder; David D.,0,0,0,0
1668213623031,ECE 287,A00,103676,Javidi; Tara,0,0,0,0
1668213623456,MATH 200B,A00,098023,Salehi Golsefidy; Alireza,12,0,15,3
1668213623890,MATH 202B,A00,098024,Rhoades; Brendon Patrick,9,0,15,6
1668213624314,MATH 203B,A00,098025,Oprea; Dragos N.,10,0,15,5
1668213624738,MATH 204B,A00,098026,Sorensen; Claus M,13,0,15,2
1668213625159,MATH 208,A00,098027,Izadi; Elham,7,0,10,3
1668213625587,MATH 209,A00,098028,Pollack; Aaron,10,0,10,0
1668213626011,MATH 211A,A00,112919,Rogalski; Daniel,9,0,10,1
1668213626434,MATH 211B,A00,112920,Seward; Brandon M.,9,0,10,1
1668213626859,MATH 218,A00,098029,Li; Bo,10,0,10,0
1668213627284,MATH 220B,A00,098030,Novak; Jonathan I,11,0,15,4
1668213627710,MATH 221A,A00,098031,Ebenfelt; Peter F,13,0,15,2
1668213628138,MATH 231B,A00,098032,Zlatos; Andrej,12,0,15,3
1668213628562,MATH 240B,A00,098033,Ni; Lei,9,0,15,6
1668213628986,MATH 243,A00,098034,Jekel; David Andrew,10,0,10,0
1668213629409,MATH 245A,A00,098035,Nie; Jiawang,0,0,15,16
1668213629834,MATH 248,A00,098036,Bejenaru; Ioan,10,0,10,0
1668213630259,MATH 250B,A00,098037,Spolaor; Luca,14,0,15,1
1668213630689,MATH 258,A00,098038,Ni; Lei,10,0,10,0
1668213631114,MATH 264B,A00,098041,Rhoades; Brendon Patrick,9,0,15,6
1668213631544,MATH 268,A00,098042,Buss; Samuel R,10,0,10,0
1668213631965,MATH 269,A00,098043,Rhoades; Brendon Patrick,10,0,10,0
1668213632390,MATH 270B,A00,098044,Li; Bo,10,0,15,5
1668213632812,MATH 272B,A00,098045,Holst; Michael J,13,0,15,2
1668213633233,MATH 273A,A00,098046,Tian; Xiaochuan,10,0,15,5
1668213633657,MATH 275,A01,098048,Tian; Xiaochuan,6,0,10,4
1668213634085,MATH 278A,A00,098049,Holst; Michael J,8,0,10,2
1668213634520,MATH 278B,A00,098050,Cloninger; Alexander,10,0,10,0
1668213634955,MATH 278C,A00,098051,Nie; Jiawang,7,0,10,3
1668213635379,MATH 280B,A00,098052,Zheng; Tianyi,10,0,15,5
1668213635814,MATH 281B,A00,098053,Bradic; Jelena,2,0,15,13
1668213636239,MATH 282B,A00,098054,Arias-Castro; Ery,0,0,15,15
1668213636664,MATH 285,A00,098055,Fitzsimmons; Patrick J,0,0,15,17
1668213637089,MATH 287B,A00,098056,Arias-Castro; Ery,2,0,15,13
1668213637512,MATH 288,A00,098057,Agarwal; Pooja,9,0,10,1
1668213637512,MATH 288,B00,098058,Zhang; Danna,8,0,10,2
1668213637512,MATH 288,C00,098059,Williams; Ruth J,10,0,10,0
1668213637941,MATH 290B,A00,098060,Roberts; Justin Deritter,13,0,15,2
1668213638370,MATH 292,A00,098061,Belmont; Eva Kinoshita,10,0,10,0
1668213638884,MATH 295,A00,098062,Suk; Andrew Hoon,48,0,50,2
1668213639312,MATH 296,A00,098063,Novak; Jonathan I,20,0,20,0
1668213639737,MATH 297,001,098064,Gamst; Anthony Collins,9997,0,9999,2
1668214140849,COGS 205,A00,101395,Chiba; Andrea,19,0,20,1
1668214141284,COGS 210B,001,101404,Greene; Deanna Jacquelyn,9998,0,9999,1
1668214141284,COGS 210B,002,101417,Xia; Haijun,9999,0,9999,0
1668214141284,COGS 210B,003,101422,Nitz; Douglas A.,9999,0,9999,0
1668214141284,COGS 210B,004,101423,Hollan; James D.,9998,0,9999,1
1668214141284,COGS 210B,005,101424,Deak; Gedeon O.,9998,0,9999,1
1668214141284,COGS 210B,006,101425,Rossano; Federico,9999,0,9999,0
1668214141719,COGS 211B,A00,101427,Coulson; Seana M,9996,0,9999,3
1668214142148,COGS 220,A00,101428,Hollan; James D.,0,0,25,25
1668214142583,COGS 229,A00,101429,Dow; Steven P,18,0,25,7
1668214143010,COGS 230,A00,101430,Klemmer; Scott R,12,0,17,5
1668214143446,COGS 234,A00,101431,Xia; Haijun,2,0,25,23
1668214143873,COGS 260,A00,101432,Kiyonaga; Anastasia,21,0,25,4
1668214143873,COGS 260,B00,101433,Kirsh; David Joel,15,0,25,10
1668214144304,CSE 202,A00,102371,Impagliazzo; Russell,0,0,0,0
1668214144729,CSE 203B,A01,102373,Cheng; Chung Kuan,0,0,0,0
1668214145160,CSE 208,A00,102374,Micciancio; Daniele,0,0,0,0
1668214145597,CSE 209A,A00,112895,Impagliazzo; Russell,0,0,15,15
1668214146031,CSE 209B,A00,108005,Bellare; Mihir,0,0,0,0
1668214146454,CSE 210,A00,113163,Coblenz; Michael J,0,0,0,0
1668214146877,CSE 219,A00,106111,Dow; Steven P,0,0,20,20
1668214147308,CSE 221,A00,102376,Voelker; Geoffrey M.,0,0,0,0
1668214147745,CSE 224,A01,102378,Porter; George M,0,0,0,0
1668214148168,CSE 229A,A00,102379,Savage; Stefan,0,0,0,0
1668214148590,CSE 229C,A00,102380,Munyaka; Imani N. S.,0,0,0,0
1668214149026,CSE 232B,A00,102382,Deutsch; Alin Bernard,0,0,0,0
1668214149456,CSE 234,A01,112904,Kumar; Arun Kumar,0,0,0,0
1668214149881,CSE 237A,A00,102383,Rosing; Tajana Simunic,0,0,0,0
1668214150317,CSE 239A,A00,102384,Deutsch; Alin Bernard,0,0,0,0
1668214150758,CSE 239B,A00,102385,Polikarpova; Nadezhda,0,0,0,0
1668214151191,CSE 240A,A00,102386,Pannuto; Patrick William,0,0,0,0
1668214151615,CSE 240B,A00,102387,Zhao; Jishen,0,0,0,0
1668214152037,CSE 241A,A00,106406,Kang; Mingu,0,0,0,0
1668214152464,CSE 249B,A00,102388,Kahng; Andrew Byun,0,0,8,8
1668214152887,CSE 251B,A01,102392,Cottrell; Garrison W,0,0,0,0
1668214152887,CSE 251B,A02,102393,Cottrell; Garrison W,0,0,0,0
1668214153310,CSE 252B,A00,102394,Ochoa; Benjamin Lawrence,0,0,0,0
1668214153733,CSE 257,A01,102396,Gao; Sicun,0,0,0,0
1668214154159,CSE 272,A00,102397,Li; Tzumao,0,0,0,0
1668214154585,CSE 274,A00,111323,Chern; Albert Ren-Haur,0,0,0,0
1668214155009,CSE 282,A00,102398,Pevzner; Pavel Arkadjevich,0,0,0,0
1668214155442,CSE 284,A00,114175,Gymrek; Melissa Ann,0,0,0,0
1668214155883,CSE 290,A00,102399,Chandraker; Manmohan Krishna,0,0,0,0
1668214155883,CSE 290,B00,102400,Vaccaro; Kristen Marie,0,0,25,25
1668214155883,CSE 290,C00,102414,Pannuto; Patrick William,0,0,25,25
1668214155883,CSE 290,D00,102427,Pevzner; Pavel Arkadjevich,0,0,0,0
1668214155883,CSE 290,E00,102429,Zhao; Jishen,0,0,0,0
1668214155883,CSE 290,F00,102436,Tullsen; Dean Michael,0,0,0,0
1668214155883,CSE 290,G00,102440,Christensen; Henrik I,0,0,20,20
1668214156308,CSE 291,A00,102443,Su; Hao,0,0,0,0
1668214156308,CSE 291,B00,102448,Polikarpova; Nadezhda,0,0,0,0
1668214156308,CSE 291,C00,102453,Vaccaro; Kristen Marie,0,0,0,0
1668214156308,CSE 291,D00,111343,Savage; Stefan,0,0,0,0
1668214156308,CSE 291,E00,116474,Claffy; Kimberly Claire,0,0,0,0
1668214156308,CSE 291,F00,116479,Pasquale; Joseph,0,0,0,0
1668214156739,CSE 293,001,119111,Bafna; Vineet,9999,0,9999,0
1668214156739,CSE 293,002,119118,Bellare; Mihir,9999,0,9999,0
1668214156739,CSE 293,003,119122,Berg-Kirkpatrick; Taylor D,9999,0,9999,0
1668214156739,CSE 293,004,119135,Christensen; Henrik I,9999,0,9999,0
1668214156739,CSE 293,005,119142,Cottrell; Garrison W,9999,0,9999,0
1668214156739,CSE 293,006,119146,Deutsch; Alin Bernard,9999,0,9999,0
1668214156739,CSE 293,007,119159,Esmaeilzadeh; Hadi,9999,0,9999,0
1668214156739,CSE 293,008,119166,Freund; Yoav,9999,0,9999,0
1668214156739,CSE 293,009,119170,Griswold; William G.,9999,0,9999,0
1668214156739,CSE 293,010,119183,Gymrek; Melissa Ann,9999,0,9999,0
1668214156739,CSE 293,011,119190,Heninger; Nadia A,9999,0,9999,0
1668214156739,CSE 293,012,119230,Impagliazzo; Russell,9999,0,9999,0
1668214156739,CSE 293,013,119232,Jhala; Ranjit,9999,0,9999,0
1668214156739,CSE 293,014,119233,Kahng; Andrew Byun,9999,0,9999,0
1668214156739,CSE 293,015,119298,Kane; Daniel Mertz,9999,0,9999,0
1668214156739,CSE 293,016,119299,Kriegman; David J,9999,0,9999,0
1668214156739,CSE 293,017,119300,Kumar; Arun Kumar,9999,0,9999,0
1668214156739,CSE 293,018,119301,Lerner; Sorin,9999,0,9999,0
1668214156739,CSE 293,019,119302,Lovett; Shachar,9999,0,9999,0
1668214156739,CSE 293,020,119303,McAuley; Julian John,9999,0,9999,0
1668214156739,CSE 293,021,119304,Micciancio; Daniele,9999,0,9999,0
1668214156739,CSE 293,022,119367,Orailoglu; Alex,9999,0,9999,0
1668214156739,CSE 293,023,119382,Paturi; Ramamohan,9999,0,9999,0
1668214156739,CSE 293,024,119404,Polikarpova; Nadezhda,9999,0,9999,0
1668214156739,CSE 293,025,119406,Politz; Joseph Gibbs,9999,0,9999,0
1668214156739,CSE 293,026,119411,Porter; George M,9999,0,9999,0
1668214156739,CSE 293,027,119414,Porter; Leonard Emerson,9999,0,9999,0
1668214156739,CSE 293,028,119416,Ramamoorthi; Ravi,9999,0,9999,0
1668214156739,CSE 293,029,119417,Sahoo; Debashis,9999,0,9999,0
1668214156739,CSE 293,030,119420,Saul; Lawrence,9999,0,9999,0
1668214156739,CSE 293,031,119421,Savage; Stefan,9999,0,9999,0
1668214156739,CSE 293,032,119425,Schulze; Jurgen P.,9999,0,9999,0
1668214156739,CSE 293,033,119426,Snoeren; Alex C.,9999,0,9999,0
1668214156739,CSE 293,034,119428,Shang; Jingbo,9999,0,9999,0
1668214156739,CSE 293,035,119430,Stefan; Deian,9999,0,9999,0
1668214156739,CSE 293,036,119431,Su; Hao,9999,0,9999,0
1668214156739,CSE 293,037,119433,Swanson; Steven James,9999,0,9999,0
1668214156739,CSE 293,038,119435,Tullsen; Dean Michael,9999,0,9999,0
1668214156739,CSE 293,039,119483,Voelker; Geoffrey M.,9999,0,9999,0
1668214156739,CSE 293,040,119537,Zhao; Jishen,9999,0,9999,0
1668214156739,CSE 293,041,119538,Zhou; Yuan-Yuan,9999,0,9999,0
1668214156739,CSE 293,042,119539,Gao; Sicun,9999,0,9999,0
1668214156739,CSE 293,043,119540,Weibel; Nadir,9999,0,9999,0
1668214156739,CSE 293,044,119541,Gupta; Rajesh K.,9999,0,9999,0
1668214156739,CSE 293,045,126410,Vaccaro; Kristen Marie,9999,0,9999,0
1668214156739,CSE 293,046,126411,Klemke; Richard,9999,0,9999,0
1668214157165,CSE 294,A00,102459,Voelker; Geoffrey M.,0,0,0,0
1668214157165,CSE 294,B00,111322,Orailoglu; Alex,0,0,0,0
1668214157587,DSE 201,A00,096914,Deutsch; Alin Bernard,30,0,30,0
1668214158016,DSE 210,A00,096915,Dasgupta; Sanjoy,30,0,30,0
1668214158439,DSE 260A,A00,096916,Altintas De Callaf; Ilkay,30,0,30,0
1668214158873,ECE 200,001,103586,Antipa; Nicholas A,9999,0,9999,0
1668214158873,ECE 200,002,103587,Atanasov; Nikolay A.,9999,0,9999,0
1668214158873,ECE 200,003,103588,Bharadia; Dinesh,9999,0,9999,0
1668214158873,ECE 200,004,103589,Cheng; Chung Kuan,9999,0,9999,0
1668214158873,ECE 200,005,103590,Cosman; Pamela C.,9999,0,9999,0
1668214158873,ECE 200,006,103591,Dayeh; Shadi Ahmad,9999,0,9999,0
1668214158873,ECE 200,007,103592,Fainman; Yeshaiahu,9999,0,9999,0
1668214158873,ECE 200,008,103593,Ford; Joseph Earl,9999,0,9999,0
1668214158873,ECE 200,009,103594,Franceschetti; Massimo,9999,0,9999,0
1668214158873,ECE 200,010,103595,Fullerton; Eric E,9999,0,9999,0
1668214158873,ECE 200,011,103596,Galton; Ian A,9999,0,9999,0
1668214158873,ECE 200,012,103597,Gilja; Vikash,9999,0,9999,0
1668214158873,ECE 200,013,103598,Hall; Drew A.,9999,0,9999,0
1668214158873,ECE 200,014,103599,Hsueh; Tzu-Chien,9999,0,9999,0
1668214158873,ECE 200,015,103600,Javidi; Tara,9999,0,9999,0
1668214158873,ECE 200,016,103601,Kahng; Andrew Byun,9999,0,9999,0
1668214158873,ECE 200,017,103602,Kim; Young-Han,9999,0,9999,0
1668214158873,ECE 200,018,103603,Koushanfar; Farinaz,9999,0,9999,0
1668214158873,ECE 200,019,103604,Kuzum; Duygu,9999,0,9999,0
1668214158873,ECE 200,020,103605,Le; Hanh-Phuc,9999,0,9999,0
1668214158873,ECE 200,021,103606,Lin; Bill,9999,0,9999,0
1668214158873,ECE 200,022,103607,Liu; Zhaowei,9998,0,9999,1
1668214158873,ECE 200,023,103608,Lo; Yu-Hwa,9999,0,9999,0
1668214158873,ECE 200,024,103609,Lomakin; Vitaliy,9999,0,9999,0
1668214158873,ECE 200,025,103610,Mercier; Patrick Philip,9999,0,9999,0
1668214158873,ECE 200,026,103611,Meyer; Florian,9999,0,9999,0
1668214158873,ECE 200,027,103612,Milstein; Laurence B.,9999,0,9999,0
1668214158873,ECE 200,028,103613,Mir Arabbaygi; Siavash,9999,0,9999,0
1668214158873,ECE 200,029,103614,Mookherjea; Shayan,9999,0,9999,0
1668214158873,ECE 200,030,103615,Morris; Karcher William,9999,0,9999,0
1668214158873,ECE 200,031,103616,Ng; Tse Nga,9999,0,9999,0
1668214158873,ECE 200,032,103617,Nguyen; Truong Quang,9999,0,9999,0
1668214158873,ECE 200,033,103618,Nomura; Kenji,9999,0,9999,0
1668214158873,ECE 200,034,103619,Orlitsky; Alon,9999,0,9999,0
1668214158873,ECE 200,035,103620,Pal; Piya,9999,0,9999,0
1668214158873,ECE 200,036,103621,Papen; George C.,9999,0,9999,0
1668214158873,ECE 200,037,103622,Radic; Stojan,9999,0,9999,0
1668214158873,ECE 200,038,103623,Rao; Bhaskar D.,9999,0,9999,0
1668214158873,ECE 200,039,103624,Rao; Ramesh R,9999,0,9999,0
1668214158873,ECE 200,040,103625,Rebeiz; Gabriel,9999,0,9999,0
1668214158873,ECE 200,041,103626,Sanford; John R,9999,0,9999,0
1668214158873,ECE 200,042,103627,Siegel; Paul H.,9999,0,9999,0
1668214158873,ECE 200,043,103628,Sievenpiper; Daniel F.,9999,0,9999,0
1668214158873,ECE 200,044,103629,Sworder; David D.,9999,0,9999,0
1668214158873,ECE 200,045,103630,Taur; Yuan,9999,0,9999,0
1668214158873,ECE 200,046,103631,Touri; Behrouz,9999,0,9999,0
1668214158873,ECE 200,047,103632,Trivedi; Mohan M.,9999,0,9999,0
1668214158873,ECE 200,048,103633,Vasconcelos; Nuno,9999,0,9999,0
1668214158873,ECE 200,049,103634,Wang; Xiaolong,9999,0,9999,0
1668214158873,ECE 200,050,103635,Xie; Pengtao,9999,0,9999,0
1668214158873,ECE 200,051,103636,Yip; Michael,9999,0,9999,0
1668214158873,ECE 200,052,103637,Zeger; Kenneth A.,999,0,999,0
1668214158873,ECE 200,053,103638,Zhang; Xinyu,9999,0,9999,0
1668214158873,ECE 200,054,103639,Turakhia; Yatish Girish,9999,0,9999,0
1668214158873,ECE 200,055,103640,Kang; Mingu,9999,0,9999,0
1668214158873,ECE 200,056,103641,Shi; Yuanyuan,9999,0,9999,0
1668214158873,ECE 200,057,103642,Wang; Edward Jay,9999,0,9999,0
1668214158873,ECE 200,058,103643,Zheng; Yang,9999,0,9999,0
1668214159304,ECE 202,A00,103644,Kuzum; Duygu,0,0,0,0
1668214159731,ECE 212BN,A00,103646,Ng; Tse Nga,0,0,0,0
1668214160249,ECE 221,A00,111493,Staff,0,0,0,0
1668214160675,ECE 222B,A00,103647,Lomakin; Vitaliy,0,0,0,0
1668214161097,ECE 230B,A00,103648,Taur; Yuan,0,0,0,0
1668214161521,ECE 238B,A00,103649,Garay; Javier,0,0,0,0
1668214161965,ECE 240B,A00,112900,Fainman; Yeshaiahu,0,0,0,0
1668214162387,ECE 247A,A00,103650,Jokerst; Jesse Vincent,0,0,0,0
1668214162809,ECE 247B,A00,103651,Wang; Joseph,0,0,0,0
1668214163239,ECE 250,A00,103652,Siegel; Paul H.,0,0,0,0
1668214163671,ECE 251A,A00,103654,Rao; Bhaskar D.,0,0,0,0
1668214164094,ECE 257B,A00,103655,Bharadia; Dinesh,0,0,0,0
1668214164519,ECE 258A,A00,103656,Milstein; Laurence B.,0,0,0,0
1668214164942,ECE 260B,A00,103658,Kang; Mingu,0,0,0,0
1668214165368,ECE 264A,A00,103659,Galton; Ian A,0,0,0,0
1668214165791,ECE 265A,A00,103661,Gudem; Prasad S.S.,0,0,0,0
1668214166230,ECE 265D,A00,103662,Gudem; Prasad S.S.,0,0,0,0
1668214166665,ECE 268,A00,103663,Koushanfar; Farinaz,0,0,0,0
1668214167091,ECE 269,A01,103665,Pal; Piya,0,0,0,0
1668214167515,ECE 271B,A00,103666,Vasconcelos; Manuela,0,0,0,0
1668214167938,ECE 276A,A00,103667,Atanasov; Nikolay A.,0,0,0,0
1668214168363,ECE 277,A00,103668,An; Cheolhong,0,0,0,0
1668214168788,ECE 279,A00,117947,Hall; Drew A.,0,0,0,0
1668214169634,ECE 283,A00,103670,Hsueh; Tzu-Chien,0,0,0,0
1668214170060,ECE 284,A00,103671,Turakhia; Yatish Girish,0,0,0,0
1668214170487,ECE 285,A00,103672,Zheng; Yang,0,0,0,0
1668214170487,ECE 285,B00,103673,Sworder; David D.,0,0,0,0
1668214170913,ECE 287,A00,103676,Javidi; Tara,0,0,0,0
1668214171338,MATH 200B,A00,098023,Salehi Golsefidy; Alireza,12,0,15,3
1668214171760,MATH 202B,A00,098024,Rhoades; Brendon Patrick,9,0,15,6
1668214172199,MATH 203B,A00,098025,Oprea; Dragos N.,10,0,15,5
1668214172623,MATH 204B,A00,098026,Sorensen; Claus M,13,0,15,2
1668214173049,MATH 208,A00,098027,Izadi; Elham,7,0,10,3
1668214173472,MATH 209,A00,098028,Pollack; Aaron,10,0,10,0
1668214173895,MATH 211A,A00,112919,Rogalski; Daniel,9,0,10,1
1668214174318,MATH 211B,A00,112920,Seward; Brandon M.,9,0,10,1
1668214174747,MATH 218,A00,098029,Li; Bo,10,0,10,0
1668214175174,MATH 220B,A00,098030,Novak; Jonathan I,11,0,15,4
1668214175601,MATH 221A,A00,098031,Ebenfelt; Peter F,13,0,15,2
1668214176035,MATH 231B,A00,098032,Zlatos; Andrej,12,0,15,3
1668214176464,MATH 240B,A00,098033,Ni; Lei,9,0,15,6
1668214176886,MATH 243,A00,098034,Jekel; David Andrew,10,0,10,0
1668214177312,MATH 245A,A00,098035,Nie; Jiawang,0,0,15,16
1668214177745,MATH 248,A00,098036,Bejenaru; Ioan,10,0,10,0
1668214178171,MATH 250B,A00,098037,Spolaor; Luca,14,0,15,1
1668214178593,MATH 258,A00,098038,Ni; Lei,10,0,10,0
1668214179016,MATH 264B,A00,098041,Rhoades; Brendon Patrick,9,0,15,6
1668214179440,MATH 268,A00,098042,Buss; Samuel R,10,0,10,0
1668214179869,MATH 269,A00,098043,Rhoades; Brendon Patrick,10,0,10,0
1668214180292,MATH 270B,A00,098044,Li; Bo,10,0,15,5
1668214180716,MATH 272B,A00,098045,Holst; Michael J,13,0,15,2
1668214181144,MATH 273A,A00,098046,Tian; Xiaochuan,10,0,15,5
1668214181574,MATH 275,A01,098048,Tian; Xiaochuan,6,0,10,4
1668214181996,MATH 278A,A00,098049,Holst; Michael J,8,0,10,2
1668214182419,MATH 278B,A00,098050,Cloninger; Alexander,10,0,10,0
1668214182841,MATH 278C,A00,098051,Nie; Jiawang,7,0,10,3
1668214183271,MATH 280B,A00,098052,Zheng; Tianyi,10,0,15,5
1668214183696,MATH 281B,A00,098053,Bradic; Jelena,2,0,15,13
1668214184130,MATH 282B,A00,098054,Arias-Castro; Ery,0,0,15,15
1668214184553,MATH 285,A00,098055,Fitzsimmons; Patrick J,0,0,15,17
1668214184979,MATH 287B,A00,098056,Arias-Castro; Ery,2,0,15,13
1668214185406,MATH 288,A00,098057,Agarwal; Pooja,9,0,10,1
1668214185406,MATH 288,B00,098058,Zhang; Danna,8,0,10,2
1668214185406,MATH 288,C00,098059,Williams; Ruth J,10,0,10,0
1668214185830,MATH 290B,A00,098060,Roberts; Justin Deritter,13,0,15,2
1668214186258,MATH 292,A00,098061,Belmont; Eva Kinoshita,10,0,10,0
1668214186683,MATH 295,A00,098062,Suk; Andrew Hoon,48,0,50,2
1668214187106,MATH 296,A00,098063,Novak; Jonathan I,20,0,20,0
1668214187532,MATH 297,001,098064,Gamst; Anthony Collins,9997,0,9999,2
1668214699076,COGS 205,A00,101395,Chiba; Andrea,19,0,20,1
1668214699500,COGS 210B,001,101404,Greene; Deanna Jacquelyn,9998,0,9999,1
1668214699500,COGS 210B,002,101417,Xia; Haijun,9999,0,9999,0
1668214699500,COGS 210B,003,101422,Nitz; Douglas A.,9999,0,9999,0
1668214699500,COGS 210B,004,101423,Hollan; James D.,9998,0,9999,1
1668214699500,COGS 210B,005,101424,Deak; Gedeon O.,9998,0,9999,1
1668214699500,COGS 210B,006,101425,Rossano; Federico,9999,0,9999,0
1668214699927,COGS 211B,A00,101427,Coulson; Seana M,9996,0,9999,3
1668214700349,COGS 220,A00,101428,Hollan; James D.,0,0,25,25
1668214700773,COGS 229,A00,101429,Dow; Steven P,18,0,25,7
1668214701198,COGS 230,A00,101430,Klemmer; Scott R,12,0,17,5
1668214701621,COGS 234,A00,101431,Xia; Haijun,2,0,25,23
1668214702045,COGS 260,A00,101432,Kiyonaga; Anastasia,21,0,25,4
1668214702045,COGS 260,B00,101433,Kirsh; David Joel,15,0,25,10
1668214702469,CSE 202,A00,102371,Impagliazzo; Russell,0,0,0,0
1668214702907,CSE 203B,A01,102373,Cheng; Chung Kuan,0,0,0,0
1668214703331,CSE 208,A00,102374,Micciancio; Daniele,0,0,0,0
1668214703754,CSE 209A,A00,112895,Impagliazzo; Russell,0,0,15,15
1668214704181,CSE 209B,A00,108005,Bellare; Mihir,0,0,0,0
1668214704606,CSE 210,A00,113163,Coblenz; Michael J,0,0,0,0
1668214705030,CSE 219,A00,106111,Dow; Steven P,0,0,20,20
1668214705461,CSE 221,A00,102376,Voelker; Geoffrey M.,0,0,0,0
1668214705887,CSE 224,A01,102378,Porter; George M,0,0,0,0
1668214706314,CSE 229A,A00,102379,Savage; Stefan,0,0,0,0
1668214706736,CSE 229C,A00,102380,Munyaka; Imani N. S.,0,0,0,0
1668214707159,CSE 232B,A00,102382,Deutsch; Alin Bernard,0,0,0,0
1668214707587,CSE 234,A01,112904,Kumar; Arun Kumar,0,0,0,0
1668214708017,CSE 237A,A00,102383,Rosing; Tajana Simunic,0,0,0,0
1668214708440,CSE 239A,A00,102384,Deutsch; Alin Bernard,0,0,0,0
1668214708867,CSE 239B,A00,102385,Polikarpova; Nadezhda,0,0,0,0
1668214709292,CSE 240A,A00,102386,Pannuto; Patrick William,0,0,0,0
1668214709715,CSE 240B,A00,102387,Zhao; Jishen,0,0,0,0
1668214710148,CSE 241A,A00,106406,Kang; Mingu,0,0,0,0
1668214710572,CSE 249B,A00,102388,Kahng; Andrew Byun,0,0,8,8
1668214711007,CSE 251B,A01,102392,Cottrell; Garrison W,0,0,0,0
1668214711007,CSE 251B,A02,102393,Cottrell; Garrison W,0,0,0,0
1668214711430,CSE 252B,A00,102394,Ochoa; Benjamin Lawrence,0,0,0,0
1668214711857,CSE 257,A01,102396,Gao; Sicun,0,0,0,0
1668214712281,CSE 272,A00,102397,Li; Tzumao,0,0,0,0
1668214712707,CSE 274,A00,111323,Chern; Albert Ren-Haur,0,0,0,0
1668214713139,CSE 282,A00,102398,Pevzner; Pavel Arkadjevich,0,0,0,0
1668214713562,CSE 284,A00,114175,Gymrek; Melissa Ann,0,0,0,0
1668214713990,CSE 290,A00,102399,Chandraker; Manmohan Krishna,0,0,0,0
1668214713990,CSE 290,B00,102400,Vaccaro; Kristen Marie,0,0,25,25
1668214713990,CSE 290,C00,102414,Pannuto; Patrick William,0,0,25,25
1668214713990,CSE 290,D00,102427,Pevzner; Pavel Arkadjevich,0,0,0,0
1668214713990,CSE 290,E00,102429,Zhao; Jishen,0,0,0,0
1668214713990,CSE 290,F00,102436,Tullsen; Dean Michael,0,0,0,0
1668214713990,CSE 290,G00,102440,Christensen; Henrik I,0,0,20,20
1668214714413,CSE 291,A00,102443,Su; Hao,0,0,0,0
1668214714413,CSE 291,B00,102448,Polikarpova; Nadezhda,0,0,0,0
1668214714413,CSE 291,C00,102453,Vaccaro; Kristen Marie,0,0,0,0
1668214714413,CSE 291,D00,111343,Savage; Stefan,0,0,0,0
1668214714413,CSE 291,E00,116474,Claffy; Kimberly Claire,0,0,0,0
1668214714413,CSE 291,F00,116479,Pasquale; Joseph,0,0,0,0
1668214714850,CSE 293,001,119111,Bafna; Vineet,9999,0,9999,0
1668214714850,CSE 293,002,119118,Bellare; Mihir,9999,0,9999,0
1668214714850,CSE 293,003,119122,Berg-Kirkpatrick; Taylor D,9999,0,9999,0
1668214714850,CSE 293,004,119135,Christensen; Henrik I,9999,0,9999,0
1668214714850,CSE 293,005,119142,Cottrell; Garrison W,9999,0,9999,0
1668214714850,CSE 293,006,119146,Deutsch; Alin Bernard,9999,0,9999,0
1668214714850,CSE 293,007,119159,Esmaeilzadeh; Hadi,9999,0,9999,0
1668214714850,CSE 293,008,119166,Freund; Yoav,9999,0,9999,0
1668214714850,CSE 293,009,119170,Griswold; William G.,9999,0,9999,0
1668214714850,CSE 293,010,119183,Gymrek; Melissa Ann,9999,0,9999,0
1668214714850,CSE 293,011,119190,Heninger; Nadia A,9999,0,9999,0
1668214714850,CSE 293,012,119230,Impagliazzo; Russell,9999,0,9999,0
1668214714850,CSE 293,013,119232,Jhala; Ranjit,9999,0,9999,0
1668214714850,CSE 293,014,119233,Kahng; Andrew Byun,9999,0,9999,0
1668214714850,CSE 293,015,119298,Kane; Daniel Mertz,9999,0,9999,0
1668214714850,CSE 293,016,119299,Kriegman; David J,9999,0,9999,0
1668214714850,CSE 293,017,119300,Kumar; Arun Kumar,9999,0,9999,0
1668214714850,CSE 293,018,119301,Lerner; Sorin,9999,0,9999,0
1668214714850,CSE 293,019,119302,Lovett; Shachar,9999,0,9999,0
1668214714850,CSE 293,020,119303,McAuley; Julian John,9999,0,9999,0
1668214714850,CSE 293,021,119304,Micciancio; Daniele,9999,0,9999,0
1668214714850,CSE 293,022,119367,Orailoglu; Alex,9999,0,9999,0
1668214714850,CSE 293,023,119382,Paturi; Ramamohan,9999,0,9999,0
1668214714850,CSE 293,024,119404,Polikarpova; Nadezhda,9999,0,9999,0
1668214714850,CSE 293,025,119406,Politz; Joseph Gibbs,9999,0,9999,0
1668214714850,CSE 293,026,119411,Porter; George M,9999,0,9999,0
1668214714850,CSE 293,027,119414,Porter; Leonard Emerson,9999,0,9999,0
1668214714850,CSE 293,028,119416,Ramamoorthi; Ravi,9999,0,9999,0
1668214714850,CSE 293,029,119417,Sahoo; Debashis,9999,0,9999,0
1668214714850,CSE 293,030,119420,Saul; Lawrence,9999,0,9999,0
1668214714850,CSE 293,031,119421,Savage; Stefan,9999,0,9999,0
1668214714850,CSE 293,032,119425,Schulze; Jurgen P.,9999,0,9999,0
1668214714850,CSE 293,033,119426,Snoeren; Alex C.,9999,0,9999,0
1668214714850,CSE 293,034,119428,Shang; Jingbo,9999,0,9999,0
1668214714850,CSE 293,035,119430,Stefan; Deian,9999,0,9999,0
1668214714850,CSE 293,036,119431,Su; Hao,9999,0,9999,0
1668214714850,CSE 293,037,119433,Swanson; Steven James,9999,0,9999,0
1668214714850,CSE 293,038,119435,Tullsen; Dean Michael,9999,0,9999,0
1668214714850,CSE 293,039,119483,Voelker; Geoffrey M.,9999,0,9999,0
1668214714850,CSE 293,040,119537,Zhao; Jishen,9999,0,9999,0
1668214714850,CSE 293,041,119538,Zhou; Yuan-Yuan,9999,0,9999,0
1668214714850,CSE 293,042,119539,Gao; Sicun,9999,0,9999,0
1668214714850,CSE 293,043,119540,Weibel; Nadir,9999,0,9999,0
1668214714850,CSE 293,044,119541,Gupta; Rajesh K.,9999,0,9999,0
1668214714850,CSE 293,045,126410,Vaccaro; Kristen Marie,9999,0,9999,0
1668214714850,CSE 293,046,126411,Klemke; Richard,9999,0,9999,0
1668214715282,CSE 294,A00,102459,Voelker; Geoffrey M.,0,0,0,0
1668214715282,CSE 294,B00,111322,Orailoglu; Alex,0,0,0,0
1668214715705,DSE 201,A00,096914,Deutsch; Alin Bernard,30,0,30,0
1668214716133,DSE 210,A00,096915,Dasgupta; Sanjoy,30,0,30,0
1668214716563,DSE 260A,A00,096916,Altintas De Callaf; Ilkay,30,0,30,0
1668214716995,ECE 200,001,103586,Antipa; Nicholas A,9999,0,9999,0
1668214716995,ECE 200,002,103587,Atanasov; Nikolay A.,9999,0,9999,0
1668214716995,ECE 200,003,103588,Bharadia; Dinesh,9999,0,9999,0
1668214716995,ECE 200,004,103589,Cheng; Chung Kuan,9999,0,9999,0
1668214716995,ECE 200,005,103590,Cosman; Pamela C.,9999,0,9999,0
1668214716995,ECE 200,006,103591,Dayeh; Shadi Ahmad,9999,0,9999,0
1668214716995,ECE 200,007,103592,Fainman; Yeshaiahu,9999,0,9999,0
1668214716995,ECE 200,008,103593,Ford; Joseph Earl,9999,0,9999,0
1668214716995,ECE 200,009,103594,Franceschetti; Massimo,9999,0,9999,0
1668214716995,ECE 200,010,103595,Fullerton; Eric E,9999,0,9999,0
1668214716995,ECE 200,011,103596,Galton; Ian A,9999,0,9999,0
1668214716995,ECE 200,012,103597,Gilja; Vikash,9999,0,9999,0
1668214716995,ECE 200,013,103598,Hall; Drew A.,9999,0,9999,0
1668214716995,ECE 200,014,103599,Hsueh; Tzu-Chien,9999,0,9999,0
1668214716995,ECE 200,015,103600,Javidi; Tara,9999,0,9999,0
1668214716995,ECE 200,016,103601,Kahng; Andrew Byun,9999,0,9999,0
1668214716995,ECE 200,017,103602,Kim; Young-Han,9999,0,9999,0
1668214716995,ECE 200,018,103603,Koushanfar; Farinaz,9999,0,9999,0
1668214716995,ECE 200,019,103604,Kuzum; Duygu,9999,0,9999,0
1668214716995,ECE 200,020,103605,Le; Hanh-Phuc,9999,0,9999,0
1668214716995,ECE 200,021,103606,Lin; Bill,9999,0,9999,0
1668214716995,ECE 200,022,103607,Liu; Zhaowei,9998,0,9999,1
1668214716995,ECE 200,023,103608,Lo; Yu-Hwa,9999,0,9999,0
1668214716995,ECE 200,024,103609,Lomakin; Vitaliy,9999,0,9999,0
1668214716995,ECE 200,025,103610,Mercier; Patrick Philip,9999,0,9999,0
1668214716995,ECE 200,026,103611,Meyer; Florian,9999,0,9999,0
1668214716995,ECE 200,027,103612,Milstein; Laurence B.,9999,0,9999,0
1668214716995,ECE 200,028,103613,Mir Arabbaygi; Siavash,9999,0,9999,0
1668214716995,ECE 200,029,103614,Mookherjea; Shayan,9999,0,9999,0
1668214716995,ECE 200,030,103615,Morris; Karcher William,9999,0,9999,0
1668214716995,ECE 200,031,103616,Ng; Tse Nga,9999,0,9999,0
1668214716995,ECE 200,032,103617,Nguyen; Truong Quang,9999,0,9999,0
1668214716995,ECE 200,033,103618,Nomura; Kenji,9999,0,9999,0
1668214716995,ECE 200,034,103619,Orlitsky; Alon,9999,0,9999,0
1668214716995,ECE 200,035,103620,Pal; Piya,9999,0,9999,0
1668214716995,ECE 200,036,103621,Papen; George C.,9999,0,9999,0
1668214716995,ECE 200,037,103622,Radic; Stojan,9999,0,9999,0
1668214716995,ECE 200,038,103623,Rao; Bhaskar D.,9999,0,9999,0
1668214716995,ECE 200,039,103624,Rao; Ramesh R,9999,0,9999,0
1668214716995,ECE 200,040,103625,Rebeiz; Gabriel,9999,0,9999,0
1668214716995,ECE 200,041,103626,Sanford; John R,9999,0,9999,0
1668214716995,ECE 200,042,103627,Siegel; Paul H.,9999,0,9999,0
1668214716995,ECE 200,043,103628,Sievenpiper; Daniel F.,9999,0,9999,0
1668214716995,ECE 200,044,103629,Sworder; David D.,9999,0,9999,0
1668214716995,ECE 200,045,103630,Taur; Yuan,9999,0,9999,0
1668214716995,ECE 200,046,103631,Touri; Behrouz,9999,0,9999,0
1668214716995,ECE 200,047,103632,Trivedi; Mohan M.,9999,0,9999,0
1668214716995,ECE 200,048,103633,Vasconcelos; Nuno,9999,0,9999,0
1668214716995,ECE 200,049,103634,Wang; Xiaolong,9999,0,9999,0
1668214716995,ECE 200,050,103635,Xie; Pengtao,9999,0,9999,0
1668214716995,ECE 200,051,103636,Yip; Michael,9999,0,9999,0
1668214716995,ECE 200,052,103637,Zeger; Kenneth A.,999,0,999,0
1668214716995,ECE 200,053,103638,Zhang; Xinyu,9999,0,9999,0
1668214716995,ECE 200,054,103639,Turakhia; Yatish Girish,9999,0,9999,0
1668214716995,ECE 200,055,103640,Kang; Mingu,9999,0,9999,0
1668214716995,ECE 200,056,103641,Shi; Yuanyuan,9999,0,9999,0
1668214716995,ECE 200,057,103642,Wang; Edward Jay,9999,0,9999,0
1668214716995,ECE 200,058,103643,Zheng; Yang,9999,0,9999,0
1668214717423,ECE 202,A00,103644,Kuzum; Duygu,0,0,0,0
1668214717845,ECE 212BN,A00,103646,Ng; Tse Nga,0,0,0,0
1668214718270,ECE 221,A00,111493,Staff,0,0,0,0
1668214718694,ECE 222B,A00,103647,Lomakin; Vitaliy,0,0,0,0
1668214719121,ECE 230B,A00,103648,Taur; Yuan,0,0,0,0
1668214719545,ECE 238B,A00,103649,Garay; Javier,0,0,0,0
1668214719974,ECE 240B,A00,112900,Fainman; Yeshaiahu,0,0,0,0
1668214720398,ECE 247A,A00,103650,Jokerst; Jesse Vincent,0,0,0,0
1668214720822,ECE 247B,A00,103651,Wang; Joseph,0,0,0,0
1668214721248,ECE 250,A00,103652,Siegel; Paul H.,0,0,0,0
1668214721670,ECE 251A,A00,103654,Rao; Bhaskar D.,0,0,0,0
1668214722097,ECE 257B,A00,103655,Bharadia; Dinesh,0,0,0,0
1668214722525,ECE 258A,A00,103656,Milstein; Laurence B.,0,0,0,0
1668214722949,ECE 260B,A00,103658,Kang; Mingu,0,0,0,0
1668214723377,ECE 264A,A00,103659,Galton; Ian A,0,0,0,0
1668214723808,ECE 265A,A00,103661,Gudem; Prasad S.S.,0,0,0,0
1668214724247,ECE 265D,A00,103662,Gudem; Prasad S.S.,0,0,0,0
1668214724675,ECE 268,A00,103663,Koushanfar; Farinaz,0,0,0,0
1668214725099,ECE 269,A01,103665,Pal; Piya,0,0,0,0
1668214725528,ECE 271B,A00,103666,Vasconcelos; Manuela,0,0,0,0
1668214725961,ECE 276A,A00,103667,Atanasov; Nikolay A.,0,0,0,0
1668214726384,ECE 277,A00,103668,An; Cheolhong,0,0,0,0
1668214726815,ECE 279,A00,117947,Hall; Drew A.,0,0,0,0
1668214727678,ECE 283,A00,103670,Hsueh; Tzu-Chien,0,0,0,0
1668214728107,ECE 284,A00,103671,Turakhia; Yatish Girish,0,0,0,0
1668214728544,ECE 285,A00,103672,Zheng; Yang,0,0,0,0
1668214728544,ECE 285,B00,103673,Sworder; David D.,0,0,0,0
1668214728967,ECE 287,A00,103676,Javidi; Tara,0,0,0,0
1668214729399,MATH 200B,A00,098023,Salehi Golsefidy; Alireza,12,0,15,3
1668214729824,MATH 202B,A00,098024,Rhoades; Brendon Patrick,9,0,15,6
1668214730251,MATH 203B,A00,098025,Oprea; Dragos N.,10,0,15,5
1668214730681,MATH 204B,A00,098026,Sorensen; Claus M,13,0,15,2
1668214731107,MATH 208,A00,098027,Izadi; Elham,7,0,10,3
1668214731533,MATH 209,A00,098028,Pollack; Aaron,10,0,10,0
1668214731961,MATH 211A,A00,112919,Rogalski; Daniel,9,0,10,1
1668214732383,MATH 211B,A00,112920,Seward; Brandon M.,9,0,10,1
1668214732809,MATH 218,A00,098029,Li; Bo,10,0,10,0
1668214733234,MATH 220B,A00,098030,Novak; Jonathan I,11,0,15,4
1668214733666,MATH 221A,A00,098031,Ebenfelt; Peter F,13,0,15,2
1668214734093,MATH 231B,A00,098032,Zlatos; Andrej,12,0,15,3
1668214734532,MATH 240B,A00,098033,Ni; Lei,9,0,15,6
1668214735035,MATH 243,A00,098034,Jekel; David Andrew,10,0,10,0
1668214735459,MATH 245A,A00,098035,Nie; Jiawang,0,0,15,16
1668214735883,MATH 248,A00,098036,Bejenaru; Ioan,10,0,10,0
1668214736306,MATH 250B,A00,098037,Spolaor; Luca,14,0,15,1
1668214736729,MATH 258,A00,098038,Ni; Lei,10,0,10,0
1668214737154,MATH 264B,A00,098041,Rhoades; Brendon Patrick,9,0,15,6
1668214737580,MATH 268,A00,098042,Buss; Samuel R,10,0,10,0
1668214738004,MATH 269,A00,098043,Rhoades; Brendon Patrick,10,0,10,0
1668214738432,MATH 270B,A00,098044,Li; Bo,10,0,15,5
1668214738862,MATH 272B,A00,098045,Holst; Michael J,13,0,15,2
1668214739286,MATH 273A,A00,098046,Tian; Xiaochuan,10,0,15,5
1668214739710,MATH 275,A01,098048,Tian; Xiaochuan,6,0,10,4
1668214740135,MATH 278A,A00,098049,Holst; Michael J,8,0,10,2
1668214740559,MATH 278B,A00,098050,Cloninger; Alexander,10,0,10,0
1668214740989,MATH 278C,A00,098051,Nie; Jiawang,7,0,10,3
1668214741412,MATH 280B,A00,098052,Zheng; Tianyi,10,0,15,5
1668214741837,MATH 281B,A00,098053,Bradic; Jelena,2,0,15,13
1668214742261,MATH 282B,A00,098054,Arias-Castro; Ery,0,0,15,15
1668214742685,MATH 285,A00,098055,Fitzsimmons; Patrick J,0,0,15,17
1668214743115,MATH 287B,A00,098056,Arias-Castro; Ery,2,0,15,13
1668214743543,MATH 288,A00,098057,Agarwal; Pooja,9,0,10,1
1668214743543,MATH 288,B00,098058,Zhang; Danna,8,0,10,2
1668214743543,MATH 288,C00,098059,Williams; Ruth J,10,0,10,0
1668214743970,MATH 290B,A00,098060,Roberts; Justin Deritter,13,0,15,2
1668214744392,MATH 292,A00,098061,Belmont; Eva Kinoshita,10,0,10,0
1668214744816,MATH 295,A00,098062,Suk; Andrew Hoon,48,0,50,2
1668214745250,MATH 296,A00,098063,Novak; Jonathan I,20,0,20,0
1668214745675,MATH 297,001,098064,Gamst; Anthony Collins,9997,0,9999,2
1668215247701,COGS 205,A00,101395,Chiba; Andrea,19,0,20,1
1668215248140,COGS 210B,001,101404,Greene; Deanna Jacquelyn,9998,0,9999,1
1668215248140,COGS 210B,002,101417,Xia; Haijun,9999,0,9999,0
1668215248140,COGS 210B,003,101422,Nitz; Douglas A.,9999,0,9999,0
1668215248140,COGS 210B,004,101423,Hollan; James D.,9998,0,9999,1
1668215248140,COGS 210B,005,101424,Deak; Gedeon O.,9998,0,9999,1
1668215248140,COGS 210B,006,101425,Rossano; Federico,9999,0,9999,0
1668215248576,COGS 211B,A00,101427,Coulson; Seana M,9996,0,9999,3
1668215249004,COGS 220,A00,101428,Hollan; James D.,0,0,25,25
1668215249427,COGS 229,A00,101429,Dow; Steven P,18,0,25,7
1668215249863,COGS 230,A00,101430,Klemmer; Scott R,12,0,17,5
1668215250287,COGS 234,A00,101431,Xia; Haijun,2,0,25,23
1668215250713,COGS 260,A00,101432,Kiyonaga; Anastasia,21,0,25,4
1668215250713,COGS 260,B00,101433,Kirsh; David Joel,15,0,25,10
1668215251139,CSE 202,A00,102371,Impagliazzo; Russell,0,0,0,0
1668215251566,CSE 203B,A01,102373,Cheng; Chung Kuan,0,0,0,0
1668215252000,CSE 208,A00,102374,Micciancio; Daniele,0,0,0,0
1668215252425,CSE 209A,A00,112895,Impagliazzo; Russell,0,0,15,15
1668215252849,CSE 209B,A00,108005,Bellare; Mihir,0,0,0,0
1668215253278,CSE 210,A00,113163,Coblenz; Michael J,0,0,0,0
1668215253713,CSE 219,A00,106111,Dow; Steven P,0,0,20,20
1668215254142,CSE 221,A00,102376,Voelker; Geoffrey M.,0,0,0,0
1668215254579,CSE 224,A01,102378,Porter; George M,0,0,0,0
1668215255003,CSE 229A,A00,102379,Savage; Stefan,0,0,0,0
1668215255435,CSE 229C,A00,102380,Munyaka; Imani N. S.,0,0,0,0
1668215255861,CSE 232B,A00,102382,Deutsch; Alin Bernard,0,0,0,0
1668215256284,CSE 234,A01,112904,Kumar; Arun Kumar,0,0,0,0
1668215256707,CSE 237A,A00,102383,Rosing; Tajana Simunic,0,0,0,0
1668215257211,CSE 239A,A00,102384,Deutsch; Alin Bernard,0,0,0,0
1668215257633,CSE 239B,A00,102385,Polikarpova; Nadezhda,0,0,0,0
1668215258057,CSE 240A,A00,102386,Pannuto; Patrick William,0,0,0,0
1668215258481,CSE 240B,A00,102387,Zhao; Jishen,0,0,0,0
1668215258903,CSE 241A,A00,106406,Kang; Mingu,0,0,0,0
1668215259325,CSE 249B,A00,102388,Kahng; Andrew Byun,0,0,8,8
1668215259748,CSE 251B,A01,102392,Cottrell; Garrison W,0,0,0,0
1668215259748,CSE 251B,A02,102393,Cottrell; Garrison W,0,0,0,0
1668215260172,CSE 252B,A00,102394,Ochoa; Benjamin Lawrence,0,0,0,0
1668215260595,CSE 257,A01,102396,Gao; Sicun,0,0,0,0
1668215261027,CSE 272,A00,102397,Li; Tzumao,0,0,0,0
1668215261451,CSE 274,A00,111323,Chern; Albert Ren-Haur,0,0,0,0
1668215261888,CSE 282,A00,102398,Pevzner; Pavel Arkadjevich,0,0,0,0
1668215262315,CSE 284,A00,114175,Gymrek; Melissa Ann,0,0,0,0
1668215262744,CSE 290,A00,102399,Chandraker; Manmohan Krishna,0,0,0,0
1668215262744,CSE 290,B00,102400,Vaccaro; Kristen Marie,0,0,25,25
1668215262744,CSE 290,C00,102414,Pannuto; Patrick William,0,0,25,25
1668215262744,CSE 290,D00,102427,Pevzner; Pavel Arkadjevich,0,0,0,0
1668215262744,CSE 290,E00,102429,Zhao; Jishen,0,0,0,0
1668215262744,CSE 290,F00,102436,Tullsen; Dean Michael,0,0,0,0
1668215262744,CSE 290,G00,102440,Christensen; Henrik I,0,0,20,20
1668215263172,CSE 291,A00,102443,Su; Hao,0,0,0,0
1668215263172,CSE 291,B00,102448,Polikarpova; Nadezhda,0,0,0,0
1668215263172,CSE 291,C00,102453,Vaccaro; Kristen Marie,0,0,0,0
1668215263172,CSE 291,D00,111343,Savage; Stefan,0,0,0,0
1668215263172,CSE 291,E00,116474,Claffy; Kimberly Claire,0,0,0,0
1668215263172,CSE 291,F00,116479,Pasquale; Joseph,0,0,0,0
1668215263606,CSE 293,001,119111,Bafna; Vineet,9999,0,9999,0
1668215263606,CSE 293,002,119118,Bellare; Mihir,9999,0,9999,0
1668215263606,CSE 293,003,119122,Berg-Kirkpatrick; Taylor D,9999,0,9999,0
1668215263606,CSE 293,004,119135,Christensen; Henrik I,9999,0,9999,0
1668215263606,CSE 293,005,119142,Cottrell; Garrison W,9999,0,9999,0
1668215263606,CSE 293,006,119146,Deutsch; Alin Bernard,9999,0,9999,0
1668215263606,CSE 293,007,119159,Esmaeilzadeh; Hadi,9999,0,9999,0
1668215263606,CSE 293,008,119166,Freund; Yoav,9999,0,9999,0
1668215263606,CSE 293,009,119170,Griswold; William G.,9999,0,9999,0
1668215263606,CSE 293,010,119183,Gymrek; Melissa Ann,9999,0,9999,0
1668215263606,CSE 293,011,119190,Heninger; Nadia A,9999,0,9999,0
1668215263606,CSE 293,012,119230,Impagliazzo; Russell,9999,0,9999,0
1668215263606,CSE 293,013,119232,Jhala; Ranjit,9999,0,9999,0
1668215263606,CSE 293,014,119233,Kahng; Andrew Byun,9999,0,9999,0
1668215263606,CSE 293,015,119298,Kane; Daniel Mertz,9999,0,9999,0
1668215263606,CSE 293,016,119299,Kriegman; David J,9999,0,9999,0
1668215263606,CSE 293,017,119300,Kumar; Arun Kumar,9999,0,9999,0
1668215263606,CSE 293,018,119301,Lerner; Sorin,9999,0,9999,0
1668215263606,CSE 293,019,119302,Lovett; Shachar,9999,0,9999,0
1668215263606,CSE 293,020,119303,McAuley; Julian John,9999,0,9999,0
1668215263606,CSE 293,021,119304,Micciancio; Daniele,9999,0,9999,0
1668215263606,CSE 293,022,119367,Orailoglu; Alex,9999,0,9999,0
1668215263606,CSE 293,023,119382,Paturi; Ramamohan,9999,0,9999,0
1668215263606,CSE 293,024,119404,Polikarpova; Nadezhda,9999,0,9999,0
1668215263606,CSE 293,025,119406,Politz; Joseph Gibbs,9999,0,9999,0
1668215263606,CSE 293,026,119411,Porter; George M,9999,0,9999,0
1668215263606,CSE 293,027,119414,Porter; Leonard Emerson,9999,0,9999,0
1668215263606,CSE 293,028,119416,Ramamoorthi; Ravi,9999,0,9999,0
1668215263606,CSE 293,029,119417,Sahoo; Debashis,9999,0,9999,0
1668215263606,CSE 293,030,119420,Saul; Lawrence,9999,0,9999,0
1668215263606,CSE 293,031,119421,Savage; Stefan,9999,0,9999,0
1668215263606,CSE 293,032,119425,Schulze; Jurgen P.,9999,0,9999,0
1668215263606,CSE 293,033,119426,Snoeren; Alex C.,9999,0,9999,0
1668215263606,CSE 293,034,119428,Shang; Jingbo,9999,0,9999,0
1668215263606,CSE 293,035,119430,Stefan; Deian,9999,0,9999,0
1668215263606,CSE 293,036,119431,Su; Hao,9999,0,9999,0
1668215263606,CSE 293,037,119433,Swanson; Steven James,9999,0,9999,0
1668215263606,CSE 293,038,119435,Tullsen; Dean Michael,9999,0,9999,0
1668215263606,CSE 293,039,119483,Voelker; Geoffrey M.,9999,0,9999,0
1668215263606,CSE 293,040,119537,Zhao; Jishen,9999,0,9999,0
1668215263606,CSE 293,041,119538,Zhou; Yuan-Yuan,9999,0,9999,0
1668215263606,CSE 293,042,119539,Gao; Sicun,9999,0,9999,0
1668215263606,CSE 293,043,119540,Weibel; Nadir,9999,0,9999,0
1668215263606,CSE 293,044,119541,Gupta; Rajesh K.,9999,0,9999,0
1668215263606,CSE 293,045,126410,Vaccaro; Kristen Marie,9999,0,9999,0
1668215263606,CSE 293,046,126411,Klemke; Richard,9999,0,9999,0
1668215264031,CSE 294,A00,102459,Voelker; Geoffrey M.,0,0,0,0
1668215264031,CSE 294,B00,111322,Orailoglu; Alex,0,0,0,0
1668215264459,DSE 201,A00,096914,Deutsch; Alin Bernard,30,0,30,0
1668215264890,DSE 210,A00,096915,Dasgupta; Sanjoy,30,0,30,0
1668215265322,DSE 260A,A00,096916,Altintas De Callaf; Ilkay,30,0,30,0
1668215265805,ECE 200,001,103586,Antipa; Nicholas A,9999,0,9999,0
1668215265805,ECE 200,002,103587,Atanasov; Nikolay A.,9999,0,9999,0
1668215265805,ECE 200,003,103588,Bharadia; Dinesh,9999,0,9999,0
1668215265805,ECE 200,004,103589,Cheng; Chung Kuan,9999,0,9999,0
1668215265805,ECE 200,005,103590,Cosman; Pamela C.,9999,0,9999,0
1668215265805,ECE 200,006,103591,Dayeh; Shadi Ahmad,9999,0,9999,0
1668215265805,ECE 200,007,103592,Fainman; Yeshaiahu,9999,0,9999,0
1668215265805,ECE 200,008,103593,Ford; Joseph Earl,9999,0,9999,0
1668215265805,ECE 200,009,103594,Franceschetti; Massimo,9999,0,9999,0
1668215265805,ECE 200,010,103595,Fullerton; Eric E,9999,0,9999,0
1668215265805,ECE 200,011,103596,Galton; Ian A,9999,0,9999,0
1668215265805,ECE 200,012,103597,Gilja; Vikash,9999,0,9999,0
1668215265805,ECE 200,013,103598,Hall; Drew A.,9999,0,9999,0
1668215265805,ECE 200,014,103599,Hsueh; Tzu-Chien,9999,0,9999,0
1668215265805,ECE 200,015,103600,Javidi; Tara,9999,0,9999,0
1668215265805,ECE 200,016,103601,Kahng; Andrew Byun,9999,0,9999,0
1668215265805,ECE 200,017,103602,Kim; Young-Han,9999,0,9999,0
1668215265805,ECE 200,018,103603,Koushanfar; Farinaz,9999,0,9999,0
1668215265805,ECE 200,019,103604,Kuzum; Duygu,9999,0,9999,0
1668215265805,ECE 200,020,103605,Le; Hanh-Phuc,9999,0,9999,0
1668215265805,ECE 200,021,103606,Lin; Bill,9999,0,9999,0
1668215265805,ECE 200,022,103607,Liu; Zhaowei,9998,0,9999,1
1668215265805,ECE 200,023,103608,Lo; Yu-Hwa,9999,0,9999,0
1668215265805,ECE 200,024,103609,Lomakin; Vitaliy,9999,0,9999,0
1668215265805,ECE 200,025,103610,Mercier; Patrick Philip,9999,0,9999,0
1668215265805,ECE 200,026,103611,Meyer; Florian,9999,0,9999,0
1668215265805,ECE 200,027,103612,Milstein; Laurence B.,9999,0,9999,0
1668215265805,ECE 200,028,103613,Mir Arabbaygi; Siavash,9999,0,9999,0
1668215265805,ECE 200,029,103614,Mookherjea; Shayan,9999,0,9999,0
1668215265805,ECE 200,030,103615,Morris; Karcher William,9999,0,9999,0
1668215265805,ECE 200,031,103616,Ng; Tse Nga,9999,0,9999,0
1668215265805,ECE 200,032,103617,Nguyen; Truong Quang,9999,0,9999,0
1668215265805,ECE 200,033,103618,Nomura; Kenji,9999,0,9999,0
1668215265805,ECE 200,034,103619,Orlitsky; Alon,9999,0,9999,0
1668215265805,ECE 200,035,103620,Pal; Piya,9999,0,9999,0
1668215265805,ECE 200,036,103621,Papen; George C.,9999,0,9999,0
1668215265805,ECE 200,037,103622,Radic; Stojan,9999,0,9999,0
1668215265805,ECE 200,038,103623,Rao; Bhaskar D.,9999,0,9999,0
1668215265805,ECE 200,039,103624,Rao; Ramesh R,9999,0,9999,0
1668215265805,ECE 200,040,103625,Rebeiz; Gabriel,9999,0,9999,0
1668215265805,ECE 200,041,103626,Sanford; John R,9999,0,9999,0
1668215265805,ECE 200,042,103627,Siegel; Paul H.,9999,0,9999,0
1668215265805,ECE 200,043,103628,Sievenpiper; Daniel F.,9999,0,9999,0
1668215265805,ECE 200,044,103629,Sworder; David D.,9999,0,9999,0
1668215265805,ECE 200,045,103630,Taur; Yuan,9999,0,9999,0
1668215265805,ECE 200,046,103631,Touri; Behrouz,9999,0,9999,0
1668215265805,ECE 200,047,103632,Trivedi; Mohan M.,9999,0,9999,0
1668215265805,ECE 200,048,103633,Vasconcelos; Nuno,9999,0,9999,0
1668215265805,ECE 200,049,103634,Wang; Xiaolong,9999,0,9999,0
1668215265805,ECE 200,050,103635,Xie; Pengtao,9999,0,9999,0
1668215265805,ECE 200,051,103636,Yip; Michael,9999,0,9999,0
1668215265805,ECE 200,052,103637,Zeger; Kenneth A.,999,0,999,0
1668215265805,ECE 200,053,103638,Zhang; Xinyu,9999,0,9999,0
1668215265805,ECE 200,054,103639,Turakhia; Yatish Girish,9999,0,9999,0
1668215265805,ECE 200,055,103640,Kang; Mingu,9999,0,9999,0
1668215265805,ECE 200,056,103641,Shi; Yuanyuan,9999,0,9999,0
1668215265805,ECE 200,057,103642,Wang; Edward Jay,9999,0,9999,0
1668215265805,ECE 200,058,103643,Zheng; Yang,9999,0,9999,0
1668215266229,ECE 202,A00,103644,Kuzum; Duygu,0,0,0,0
1668215266659,ECE 212BN,A00,103646,Ng; Tse Nga,0,0,0,0
1668215267084,ECE 221,A00,111493,Staff,0,0,0,0
1668215267522,ECE 222B,A00,103647,Lomakin; Vitaliy,0,0,0,0
1668215267949,ECE 230B,A00,103648,Taur; Yuan,0,0,0,0
1668215268376,ECE 238B,A00,103649,Garay; Javier,0,0,0,0
1668215268810,ECE 240B,A00,112900,Fainman; Yeshaiahu,0,0,0,0
1668215269232,ECE 247A,A00,103650,Jokerst; Jesse Vincent,0,0,0,0
1668215269656,ECE 247B,A00,103651,Wang; Joseph,0,0,0,0
1668215270147,ECE 250,A00,103652,Siegel; Paul H.,0,0,0,0
1668215270573,ECE 251A,A00,103654,Rao; Bhaskar D.,0,0,0,0
1668215270995,ECE 257B,A00,103655,Bharadia; Dinesh,0,0,0,0
1668215271431,ECE 258A,A00,103656,Milstein; Laurence B.,0,0,0,0
1668215271865,ECE 260B,A00,103658,Kang; Mingu,0,0,0,0
1668215272299,ECE 264A,A00,103659,Galton; Ian A,0,0,0,0
1668215272737,ECE 265A,A00,103661,Gudem; Prasad S.S.,0,0,0,0
1668215273167,ECE 265D,A00,103662,Gudem; Prasad S.S.,0,0,0,0
1668215273591,ECE 268,A00,103663,Koushanfar; Farinaz,0,0,0,0
1668215274014,ECE 269,A01,103665,Pal; Piya,0,0,0,0
1668215274447,ECE 271B,A00,103666,Vasconcelos; Manuela,0,0,0,0
1668215274887,ECE 276A,A00,103667,Atanasov; Nikolay A.,0,0,0,0
1668215275317,ECE 277,A00,103668,An; Cheolhong,0,0,0,0
1668215275743,ECE 279,A00,117947,Hall; Drew A.,0,0,0,0
1668215276602,ECE 283,A00,103670,Hsueh; Tzu-Chien,0,0,0,0
1668215277027,ECE 284,A00,103671,Turakhia; Yatish Girish,0,0,0,0
1668215277466,ECE 285,A00,103672,Zheng; Yang,0,0,0,0
1668215277466,ECE 285,B00,103673,Sworder; David D.,0,0,0,0
1668215277891,ECE 287,A00,103676,Javidi; Tara,0,0,0,0
1668215278313,MATH 200B,A00,098023,Salehi Golsefidy; Alireza,12,0,15,3
1668215278740,MATH 202B,A00,098024,Rhoades; Brendon Patrick,9,0,15,6
1668215279179,MATH 203B,A00,098025,Oprea; Dragos N.,10,0,15,5
1668215279603,MATH 204B,A00,098026,Sorensen; Claus M,13,0,15,2
1668215280028,MATH 208,A00,098027,Izadi; Elham,7,0,10,3
1668215280461,MATH 209,A00,098028,Pollack; Aaron,10,0,10,0
1668215280885,MATH 211A,A00,112919,Rogalski; Daniel,9,0,10,1
1668215281312,MATH 211B,A00,112920,Seward; Brandon M.,9,0,10,1
1668215281742,MATH 218,A00,098029,Li; Bo,10,0,10,0
1668215282174,MATH 220B,A00,098030,Novak; Jonathan I,11,0,15,4
1668215282596,MATH 221A,A00,098031,Ebenfelt; Peter F,13,0,15,2
1668215283023,MATH 231B,A00,098032,Zlatos; Andrej,12,0,15,3
1668215283458,MATH 240B,A00,098033,Ni; Lei,9,0,15,6
1668215283885,MATH 243,A00,098034,Jekel; David Andrew,10,0,10,0
1668215284310,MATH 245A,A00,098035,Nie; Jiawang,0,0,15,16
1668215284735,MATH 248,A00,098036,Bejenaru; Ioan,10,0,10,0
1668215285169,MATH 250B,A00,098037,Spolaor; Luca,14,0,15,1
1668215285598,MATH 258,A00,098038,Ni; Lei,10,0,10,0
1668215286024,MATH 264B,A00,098041,Rhoades; Brendon Patrick,9,0,15,6
1668215286449,MATH 268,A00,098042,Buss; Samuel R,10,0,10,0
1668215286871,MATH 269,A00,098043,Rhoades; Brendon Patrick,10,0,10,0
1668215287297,MATH 270B,A00,098044,Li; Bo,10,0,15,5
1668215287720,MATH 272B,A00,098045,Holst; Michael J,13,0,15,2
1668215288146,MATH 273A,A00,098046,Tian; Xiaochuan,10,0,15,5
1668215288584,MATH 275,A01,098048,Tian; Xiaochuan,6,0,10,4
1668215289014,MATH 278A,A00,098049,Holst; Michael J,8,0,10,2
1668215289443,MATH 278B,A00,098050,Cloninger; Alexander,10,0,10,0
1668215289870,MATH 278C,A00,098051,Nie; Jiawang,7,0,10,3
1668215290294,MATH 280B,A00,098052,Zheng; Tianyi,10,0,15,5
1668215290718,MATH 281B,A00,098053,Bradic; Jelena,2,0,15,13
1668215291207,MATH 282B,A00,098054,Arias-Castro; Ery,0,0,15,15
1668215291638,MATH 285,A00,098055,Fitzsimmons; Patrick J,0,0,15,17
1668215292070,MATH 287B,A00,098056,Arias-Castro; Ery,2,0,15,13
1668215292495,MATH 288,A00,098057,Agarwal; Pooja,9,0,10,1
1668215292495,MATH 288,B00,098058,Zhang; Danna,8,0,10,2
1668215292495,MATH 288,C00,098059,Williams; Ruth J,10,0,10,0
1668215292925,MATH 290B,A00,098060,Roberts; Justin Deritter,13,0,15,2
1668215293348,MATH 292,A00,098061,Belmont; Eva Kinoshita,10,0,10,0
1668215293775,MATH 295,A00,098062,Suk; Andrew Hoon,48,0,50,2
1668215294206,MATH 296,A00,098063,Novak; Jonathan I,20,0,20,0
1668215294637,MATH 297,001,098064,Gamst; Anthony Collins,9997,0,9999,2
1668215799066,COGS 205,A00,101395,Chiba; Andrea,19,0,20,1
1668215799491,COGS 210B,001,101404,Greene; Deanna Jacquelyn,9998,0,9999,1
1668215799491,COGS 210B,002,101417,Xia; Haijun,9999,0,9999,0
1668215799491,COGS 210B,003,101422,Nitz; Douglas A.,9999,0,9999,0
1668215799491,COGS 210B,004,101423,Hollan; James D.,9998,0,9999,1
1668215799491,COGS 210B,005,101424,Deak; Gedeon O.,9998,0,9999,1
1668215799491,COGS 210B,006,101425,Rossano; Federico,9999,0,9999,0
1668215799913,COGS 211B,A00,101427,Coulson; Seana M,9996,0,9999,3
1668215800345,COGS 220,A00,101428,Hollan; James D.,0,0,25,25
1668215800767,COGS 229,A00,101429,Dow; Steven P,18,0,25,7
1668215801193,COGS 230,A00,101430,Klemmer; Scott R,12,0,17,5
1668215801615,COGS 234,A00,101431,Xia; Haijun,2,0,25,23
1668215802041,COGS 260,A00,101432,Kiyonaga; Anastasia,21,0,25,4
1668215802041,COGS 260,B00,101433,Kirsh; David Joel,15,0,25,10
1668215802471,CSE 202,A00,102371,Impagliazzo; Russell,0,0,0,0
1668215802909,CSE 203B,A01,102373,Cheng; Chung Kuan,0,0,0,0
1668215803331,CSE 208,A00,102374,Micciancio; Daniele,0,0,0,0
1668215803757,CSE 209A,A00,112895,Impagliazzo; Russell,0,0,15,15
1668215804186,CSE 209B,A00,108005,Bellare; Mihir,0,0,0,0
1668215804610,CSE 210,A00,113163,Coblenz; Michael J,0,0,0,0
1668215805046,CSE 219,A00,106111,Dow; Steven P,0,0,20,20
1668215805470,CSE 221,A00,102376,Voelker; Geoffrey M.,0,0,0,0
1668215805897,CSE 224,A01,102378,Porter; George M,0,0,0,0
1668215806325,CSE 229A,A00,102379,Savage; Stefan,0,0,0,0
1668215806749,CSE 229C,A00,102380,Munyaka; Imani N. S.,0,0,0,0
1668215807172,CSE 232B,A00,102382,Deutsch; Alin Bernard,0,0,0,0
1668215807613,CSE 234,A01,112904,Kumar; Arun Kumar,0,0,0,0
1668215808036,CSE 237A,A00,102383,Rosing; Tajana Simunic,0,0,0,0
1668215808461,CSE 239A,A00,102384,Deutsch; Alin Bernard,0,0,0,0
1668215808885,CSE 239B,A00,102385,Polikarpova; Nadezhda,0,0,0,0
1668215809308,CSE 240A,A00,102386,Pannuto; Patrick William,0,0,0,0
1668215809736,CSE 240B,A00,102387,Zhao; Jishen,0,0,0,0
1668215810159,CSE 241A,A00,106406,Kang; Mingu,0,0,0,0
1668215810595,CSE 249B,A00,102388,Kahng; Andrew Byun,0,0,8,8
1668215811018,CSE 251B,A01,102392,Cottrell; Garrison W,0,0,0,0
1668215811018,CSE 251B,A02,102393,Cottrell; Garrison W,0,0,0,0
1668215811442,CSE 252B,A00,102394,Ochoa; Benjamin Lawrence,0,0,0,0
1668215811866,CSE 257,A01,102396,Gao; Sicun,0,0,0,0
1668215812290,CSE 272,A00,102397,Li; Tzumao,0,0,0,0
1668215812712,CSE 274,A00,111323,Chern; Albert Ren-Haur,0,0,0,0
1668215813139,CSE 282,A00,102398,Pevzner; Pavel Arkadjevich,0,0,0,0
1668215813563,CSE 284,A00,114175,Gymrek; Melissa Ann,0,0,0,0
1668215813989,CSE 290,A00,102399,Chandraker; Manmohan Krishna,0,0,0,0
1668215813989,CSE 290,B00,102400,Vaccaro; Kristen Marie,0,0,25,25
1668215813989,CSE 290,C00,102414,Pannuto; Patrick William,0,0,25,25
1668215813989,CSE 290,D00,102427,Pevzner; Pavel Arkadjevich,0,0,0,0
1668215813989,CSE 290,E00,102429,Zhao; Jishen,0,0,0,0
1668215813989,CSE 290,F00,102436,Tullsen; Dean Michael,0,0,0,0
1668215813989,CSE 290,G00,102440,Christensen; Henrik I,0,0,20,20
1668215814418,CSE 291,A00,102443,Su; Hao,0,0,0,0
1668215814418,CSE 291,B00,102448,Polikarpova; Nadezhda,0,0,0,0
1668215814418,CSE 291,C00,102453,Vaccaro; Kristen Marie,0,0,0,0
1668215814418,CSE 291,D00,111343,Savage; Stefan,0,0,0,0
1668215814418,CSE 291,E00,116474,Claffy; Kimberly Claire,0,0,0,0
1668215814418,CSE 291,F00,116479,Pasquale; Joseph,0,0,0,0
1668215814873,CSE 293,001,119111,Bafna; Vineet,9999,0,9999,0
1668215814873,CSE 293,002,119118,Bellare; Mihir,9999,0,9999,0
1668215814873,CSE 293,003,119122,Berg-Kirkpatrick; Taylor D,9999,0,9999,0
1668215814873,CSE 293,004,119135,Christensen; Henrik I,9999,0,9999,0
1668215814873,CSE 293,005,119142,Cottrell; Garrison W,9999,0,9999,0
1668215814873,CSE 293,006,119146,Deutsch; Alin Bernard,9999,0,9999,0
1668215814873,CSE 293,007,119159,Esmaeilzadeh; Hadi,9999,0,9999,0
1668215814873,CSE 293,008,119166,Freund; Yoav,9999,0,9999,0
1668215814873,CSE 293,009,119170,Griswold; William G.,9999,0,9999,0
1668215814873,CSE 293,010,119183,Gymrek; Melissa Ann,9999,0,9999,0
1668215814873,CSE 293,011,119190,Heninger; Nadia A,9999,0,9999,0
1668215814873,CSE 293,012,119230,Impagliazzo; Russell,9999,0,9999,0
1668215814873,CSE 293,013,119232,Jhala; Ranjit,9999,0,9999,0
1668215814873,CSE 293,014,119233,Kahng; Andrew Byun,9999,0,9999,0
1668215814873,CSE 293,015,119298,Kane; Daniel Mertz,9999,0,9999,0
1668215814873,CSE 293,016,119299,Kriegman; David J,9999,0,9999,0
1668215814873,CSE 293,017,119300,Kumar; Arun Kumar,9999,0,9999,0
1668215814873,CSE 293,018,119301,Lerner; Sorin,9999,0,9999,0
1668215814873,CSE 293,019,119302,Lovett; Shachar,9999,0,9999,0
1668215814873,CSE 293,020,119303,McAuley; Julian John,9999,0,9999,0
1668215814873,CSE 293,021,119304,Micciancio; Daniele,9999,0,9999,0
1668215814873,CSE 293,022,119367,Orailoglu; Alex,9999,0,9999,0
1668215814873,CSE 293,023,119382,Paturi; Ramamohan,9999,0,9999,0
1668215814873,CSE 293,024,119404,Polikarpova; Nadezhda,9999,0,9999,0
1668215814873,CSE 293,025,119406,Politz; Joseph Gibbs,9999,0,9999,0
1668215814873,CSE 293,026,119411,Porter; George M,9999,0,9999,0
1668215814873,CSE 293,027,119414,Porter; Leonard Emerson,9999,0,9999,0
1668215814873,CSE 293,028,119416,Ramamoorthi; Ravi,9999,0,9999,0
1668215814873,CSE 293,029,119417,Sahoo; Debashis,9999,0,9999,0
1668215814873,CSE 293,030,119420,Saul; Lawrence,9999,0,9999,0
1668215814873,CSE 293,031,119421,Savage; Stefan,9999,0,9999,0
1668215814873,CSE 293,032,119425,Schulze; Jurgen P.,9999,0,9999,0
1668215814873,CSE 293,033,119426,Snoeren; Alex C.,9999,0,9999,0
1668215814873,CSE 293,034,119428,Shang; Jingbo,9999,0,9999,0
1668215814873,CSE 293,035,119430,Stefan; Deian,9999,0,9999,0
1668215814873,CSE 293,036,119431,Su; Hao,9999,0,9999,0
1668215814873,CSE 293,037,119433,Swanson; Steven James,9999,0,9999,0
1668215814873,CSE 293,038,119435,Tullsen; Dean Michael,9999,0,9999,0
1668215814873,CSE 293,039,119483,Voelker; Geoffrey M.,9999,0,9999,0
1668215814873,CSE 293,040,119537,Zhao; Jishen,9999,0,9999,0
1668215814873,CSE 293,041,119538,Zhou; Yuan-Yuan,9999,0,9999,0
1668215814873,CSE 293,042,119539,Gao; Sicun,9999,0,9999,0
1668215814873,CSE 293,043,119540,Weibel; Nadir,9999,0,9999,0
1668215814873,CSE 293,044,119541,Gupta; Rajesh K.,9999,0,9999,0
1668215814873,CSE 293,045,126410,Vaccaro; Kristen Marie,9999,0,9999,0
1668215814873,CSE 293,046,126411,Klemke; Richard,9999,0,9999,0
1668215815295,CSE 294,A00,102459,Voelker; Geoffrey M.,0,0,0,0
1668215815295,CSE 294,B00,111322,Orailoglu; Alex,0,0,0,0
1668215815719,DSE 201,A00,096914,Deutsch; Alin Bernard,30,0,30,0
1668215816143,DSE 210,A00,096915,Dasgupta; Sanjoy,30,0,30,0
1668215816568,DSE 260A,A00,096916,Altintas De Callaf; Ilkay,30,0,30,0
1668215817007,ECE 200,001,103586,Antipa; Nicholas A,9999,0,9999,0
1668215817007,ECE 200,002,103587,Atanasov; Nikolay A.,9999,0,9999,0
1668215817007,ECE 200,003,103588,Bharadia; Dinesh,9999,0,9999,0
1668215817007,ECE 200,004,103589,Cheng; Chung Kuan,9999,0,9999,0
1668215817007,ECE 200,005,103590,Cosman; Pamela C.,9999,0,9999,0
1668215817007,ECE 200,006,103591,Dayeh; Shadi Ahmad,9999,0,9999,0
1668215817007,ECE 200,007,103592,Fainman; Yeshaiahu,9999,0,9999,0
1668215817007,ECE 200,008,103593,Ford; Joseph Earl,9999,0,9999,0
1668215817007,ECE 200,009,103594,Franceschetti; Massimo,9999,0,9999,0
1668215817007,ECE 200,010,103595,Fullerton; Eric E,9999,0,9999,0
1668215817007,ECE 200,011,103596,Galton; Ian A,9999,0,9999,0
1668215817007,ECE 200,012,103597,Gilja; Vikash,9999,0,9999,0
1668215817007,ECE 200,013,103598,Hall; Drew A.,9999,0,9999,0
1668215817007,ECE 200,014,103599,Hsueh; Tzu-Chien,9999,0,9999,0
1668215817007,ECE 200,015,103600,Javidi; Tara,9999,0,9999,0
1668215817007,ECE 200,016,103601,Kahng; Andrew Byun,9999,0,9999,0
1668215817007,ECE 200,017,103602,Kim; Young-Han,9999,0,9999,0
1668215817007,ECE 200,018,103603,Koushanfar; Farinaz,9999,0,9999,0
1668215817007,ECE 200,019,103604,Kuzum; Duygu,9999,0,9999,0
1668215817007,ECE 200,020,103605,Le; Hanh-Phuc,9999,0,9999,0
1668215817007,ECE 200,021,103606,Lin; Bill,9999,0,9999,0
1668215817007,ECE 200,022,103607,Liu; Zhaowei,9998,0,9999,1
1668215817007,ECE 200,023,103608,Lo; Yu-Hwa,9999,0,9999,0
1668215817007,ECE 200,024,103609,Lomakin; Vitaliy,9999,0,9999,0
1668215817007,ECE 200,025,103610,Mercier; Patrick Philip,9999,0,9999,0
1668215817007,ECE 200,026,103611,Meyer; Florian,9999,0,9999,0
1668215817007,ECE 200,027,103612,Milstein; Laurence B.,9999,0,9999,0
1668215817007,ECE 200,028,103613,Mir Arabbaygi; Siavash,9999,0,9999,0
1668215817007,ECE 200,029,103614,Mookherjea; Shayan,9999,0,9999,0
1668215817007,ECE 200,030,103615,Morris; Karcher William,9999,0,9999,0
1668215817007,ECE 200,031,103616,Ng; Tse Nga,9999,0,9999,0
1668215817007,ECE 200,032,103617,Nguyen; Truong Quang,9999,0,9999,0
1668215817007,ECE 200,033,103618,Nomura; Kenji,9999,0,9999,0
1668215817007,ECE 200,034,103619,Orlitsky; Alon,9999,0,9999,0
1668215817007,ECE 200,035,103620,Pal; Piya,9999,0,9999,0
1668215817007,ECE 200,036,103621,Papen; George C.,9999,0,9999,0
1668215817007,ECE 200,037,103622,Radic; Stojan,9999,0,9999,0
1668215817007,ECE 200,038,103623,Rao; Bhaskar D.,9999,0,9999,0
1668215817007,ECE 200,039,103624,Rao; Ramesh R,9999,0,9999,0
1668215817007,ECE 200,040,103625,Rebeiz; Gabriel,9999,0,9999,0
1668215817007,ECE 200,041,103626,Sanford; John R,9999,0,9999,0
1668215817007,ECE 200,042,103627,Siegel; Paul H.,9999,0,9999,0
1668215817007,ECE 200,043,103628,Sievenpiper; Daniel F.,9999,0,9999,0
1668215817007,ECE 200,044,103629,Sworder; David D.,9999,0,9999,0
1668215817007,ECE 200,045,103630,Taur; Yuan,9999,0,9999,0
1668215817007,ECE 200,046,103631,Touri; Behrouz,9999,0,9999,0
1668215817007,ECE 200,047,103632,Trivedi; Mohan M.,9999,0,9999,0
1668215817007,ECE 200,048,103633,Vasconcelos; Nuno,9999,0,9999,0
1668215817007,ECE 200,049,103634,Wang; Xiaolong,9999,0,9999,0
1668215817007,ECE 200,050,103635,Xie; Pengtao,9999,0,9999,0
1668215817007,ECE 200,051,103636,Yip; Michael,9999,0,9999,0
1668215817007,ECE 200,052,103637,Zeger; Kenneth A.,999,0,999,0
1668215817007,ECE 200,053,103638,Zhang; Xinyu,9999,0,9999,0
1668215817007,ECE 200,054,103639,Turakhia; Yatish Girish,9999,0,9999,0
1668215817007,ECE 200,055,103640,Kang; Mingu,9999,0,9999,0
1668215817007,ECE 200,056,103641,Shi; Yuanyuan,9999,0,9999,0
1668215817007,ECE 200,057,103642,Wang; Edward Jay,9999,0,9999,0
1668215817007,ECE 200,058,103643,Zheng; Yang,9999,0,9999,0
1668215817429,ECE 202,A00,103644,Kuzum; Duygu,0,0,0,0
1668215817853,ECE 212BN,A00,103646,Ng; Tse Nga,0,0,0,0
1668215818279,ECE 221,A00,111493,Staff,0,0,0,0
1668215818703,ECE 222B,A00,103647,Lomakin; Vitaliy,0,0,0,0
1668215819130,ECE 230B,A00,103648,Taur; Yuan,0,0,0,0
1668215819555,ECE 238B,A00,103649,Garay; Javier,0,0,0,0
1668215819980,ECE 240B,A00,112900,Fainman; Yeshaiahu,0,0,0,0
1668215820406,ECE 247A,A00,103650,Jokerst; Jesse Vincent,0,0,0,0
1668215820832,ECE 247B,A00,103651,Wang; Joseph,0,0,0,0
1668215821258,ECE 250,A00,103652,Siegel; Paul H.,0,0,0,0
1668215821681,ECE 251A,A00,103654,Rao; Bhaskar D.,0,0,0,0
1668215822104,ECE 257B,A00,103655,Bharadia; Dinesh,0,0,0,0
1668215822534,ECE 258A,A00,103656,Milstein; Laurence B.,0,0,0,0
1668215822960,ECE 260B,A00,103658,Kang; Mingu,0,0,0,0
1668215823385,ECE 264A,A00,103659,Galton; Ian A,0,0,0,0
1668215823808,ECE 265A,A00,103661,Gudem; Prasad S.S.,0,0,0,0
1668215824231,ECE 265D,A00,103662,Gudem; Prasad S.S.,0,0,0,0
1668215824664,ECE 268,A00,103663,Koushanfar; Farinaz,0,0,0,0
1668215825182,ECE 269,A01,103665,Pal; Piya,0,0,0,0
1668215825615,ECE 271B,A00,103666,Vasconcelos; Manuela,0,0,0,0
1668215826042,ECE 276A,A00,103667,Atanasov; Nikolay A.,0,0,0,0
1668215826469,ECE 277,A00,103668,An; Cheolhong,0,0,0,0
1668215826903,ECE 279,A00,117947,Hall; Drew A.,0,0,0,0
1668215827753,ECE 283,A00,103670,Hsueh; Tzu-Chien,0,0,0,0
1668215828178,ECE 284,A00,103671,Turakhia; Yatish Girish,0,0,0,0
1668215828601,ECE 285,A00,103672,Zheng; Yang,0,0,0,0
1668215828601,ECE 285,B00,103673,Sworder; David D.,0,0,0,0
1668215829024,ECE 287,A00,103676,Javidi; Tara,0,0,0,0
1668215829446,MATH 200B,A00,098023,Salehi Golsefidy; Alireza,12,0,15,3
1668215829871,MATH 202B,A00,098024,Rhoades; Brendon Patrick,9,0,15,6
1668215830297,MATH 203B,A00,098025,Oprea; Dragos N.,10,0,15,5
1668215830722,MATH 204B,A00,098026,Sorensen; Claus M,13,0,15,2
1668215831146,MATH 208,A00,098027,Izadi; Elham,7,0,10,3
1668215831574,MATH 209,A00,098028,Pollack; Aaron,10,0,10,0
1668215831997,MATH 211A,A00,112919,Rogalski; Daniel,9,0,10,1
1668215832425,MATH 211B,A00,112920,Seward; Brandon M.,9,0,10,1
1668215832851,MATH 218,A00,098029,Li; Bo,10,0,10,0
1668215833280,MATH 220B,A00,098030,Novak; Jonathan I,11,0,15,4
1668215833705,MATH 221A,A00,098031,Ebenfelt; Peter F,13,0,15,2
1668215834131,MATH 231B,A00,098032,Zlatos; Andrej,12,0,15,3
1668215834558,MATH 240B,A00,098033,Ni; Lei,9,0,15,6
1668215834980,MATH 243,A00,098034,Jekel; David Andrew,10,0,10,0
1668215835408,MATH 245A,A00,098035,Nie; Jiawang,0,0,15,16
1668215835831,MATH 248,A00,098036,Bejenaru; Ioan,10,0,10,0
1668215836261,MATH 250B,A00,098037,Spolaor; Luca,14,0,15,1
1668215836691,MATH 258,A00,098038,Ni; Lei,10,0,10,0
1668215837128,MATH 264B,A00,098041,Rhoades; Brendon Patrick,9,0,15,6
1668215837559,MATH 268,A00,098042,Buss; Samuel R,10,0,10,0
1668215837984,MATH 269,A00,098043,Rhoades; Brendon Patrick,10,0,10,0
1668215838409,MATH 270B,A00,098044,Li; Bo,10,0,15,5
1668215838833,MATH 272B,A00,098045,Holst; Michael J,13,0,15,2
1668215839255,MATH 273A,A00,098046,Tian; Xiaochuan,10,0,15,5
1668215839683,MATH 275,A01,098048,Tian; Xiaochuan,6,0,10,4
1668215840105,MATH 278A,A00,098049,Holst; Michael J,8,0,10,2
1668215840536,MATH 278B,A00,098050,Cloninger; Alexander,10,0,10,0
1668215840961,MATH 278C,A00,098051,Nie; Jiawang,7,0,10,3
1668215841385,MATH 280B,A00,098052,Zheng; Tianyi,10,0,15,5
1668215841813,MATH 281B,A00,098053,Bradic; Jelena,2,0,15,13
1668215842243,MATH 282B,A00,098054,Arias-Castro; Ery,0,0,15,15
1668215842668,MATH 285,A00,098055,Fitzsimmons; Patrick J,0,0,15,17
1668215843091,MATH 287B,A00,098056,Arias-Castro; Ery,2,0,15,13
1668215843514,MATH 288,A00,098057,Agarwal; Pooja,9,0,10,1
1668215843514,MATH 288,B00,098058,Zhang; Danna,8,0,10,2
1668215843514,MATH 288,C00,098059,Williams; Ruth J,10,0,10,0
1668215843936,MATH 290B,A00,098060,Roberts; Justin Deritter,13,0,15,2
1668215844363,MATH 292,A00,098061,Belmont; Eva Kinoshita,10,0,10,0
1668215844790,MATH 295,A00,098062,Suk; Andrew Hoon,48,0,50,2
1668215845217,MATH 296,A00,098063,Novak; Jonathan I,20,0,20,0
1668215845640,MATH 297,001,098064,Gamst; Anthony Collins,9997,0,9999,2
1668216348561,COGS 205,A00,101395,Chiba; Andrea,19,0,20,1
1668216348992,COGS 210B,001,101404,Greene; Deanna Jacquelyn,9998,0,9999,1
1668216348992,COGS 210B,002,101417,Xia; Haijun,9999,0,9999,0
1668216348992,COGS 210B,003,101422,Nitz; Douglas A.,9999,0,9999,0
1668216348992,COGS 210B,004,101423,Hollan; James D.,9998,0,9999,1
1668216348992,COGS 210B,005,101424,Deak; Gedeon O.,9998,0,9999,1
1668216348992,COGS 210B,006,101425,Rossano; Federico,9999,0,9999,0
1668216349423,COGS 211B,A00,101427,Coulson; Seana M,9996,0,9999,3
1668216349845,COGS 220,A00,101428,Hollan; James D.,0,0,25,25
1668216350269,COGS 229,A00,101429,Dow; Steven P,18,0,25,7
1668216350692,COGS 230,A00,101430,Klemmer; Scott R,12,0,17,5
1668216351123,COGS 234,A00,101431,Xia; Haijun,2,0,25,23
1668216351547,COGS 260,A00,101432,Kiyonaga; Anastasia,21,0,25,4
1668216351547,COGS 260,B00,101433,Kirsh; David Joel,15,0,25,10
1668216351973,CSE 202,A00,102371,Impagliazzo; Russell,0,0,0,0
1668216352409,CSE 203B,A01,102373,Cheng; Chung Kuan,0,0,0,0
1668216352838,CSE 208,A00,102374,Micciancio; Daniele,0,0,0,0
1668216353262,CSE 209A,A00,112895,Impagliazzo; Russell,0,0,15,15
1668216353687,CSE 209B,A00,108005,Bellare; Mihir,0,0,0,0
1668216354114,CSE 210,A00,113163,Coblenz; Michael J,0,0,0,0
1668216354537,CSE 219,A00,106111,Dow; Steven P,0,0,20,20
1668216354962,CSE 221,A00,102376,Voelker; Geoffrey M.,0,0,0,0
1668216355385,CSE 224,A01,102378,Porter; George M,0,0,0,0
1668216355809,CSE 229A,A00,102379,Savage; Stefan,0,0,0,0
1668216356232,CSE 229C,A00,102380,Munyaka; Imani N. S.,0,0,0,0
1668216356660,CSE 232B,A00,102382,Deutsch; Alin Bernard,0,0,0,0
1668216357081,CSE 234,A01,112904,Kumar; Arun Kumar,0,0,0,0
1668216357508,CSE 237A,A00,102383,Rosing; Tajana Simunic,0,0,0,0
1668216357929,CSE 239A,A00,102384,Deutsch; Alin Bernard,0,0,0,0
1668216358353,CSE 239B,A00,102385,Polikarpova; Nadezhda,0,0,0,0
1668216358776,CSE 240A,A00,102386,Pannuto; Patrick William,0,0,0,0
1668216359203,CSE 240B,A00,102387,Zhao; Jishen,0,0,0,0
1668216359630,CSE 241A,A00,106406,Kang; Mingu,0,0,0,0
1668216360053,CSE 249B,A00,102388,Kahng; Andrew Byun,0,0,8,8
1668216360474,CSE 251B,A01,102392,Cottrell; Garrison W,0,0,0,0
1668216360474,CSE 251B,A02,102393,Cottrell; Garrison W,0,0,0,0
1668216360897,CSE 252B,A00,102394,Ochoa; Benjamin Lawrence,0,0,0,0
1668216361322,CSE 257,A01,102396,Gao; Sicun,0,0,0,0
1668216361747,CSE 272,A00,102397,Li; Tzumao,0,0,0,0
1668216362171,CSE 274,A00,111323,Chern; Albert Ren-Haur,0,0,0,0
1668216362596,CSE 282,A00,102398,Pevzner; Pavel Arkadjevich,0,0,0,0
1668216363019,CSE 284,A00,114175,Gymrek; Melissa Ann,0,0,0,0
1668216363446,CSE 290,A00,102399,Chandraker; Manmohan Krishna,0,0,0,0
1668216363446,CSE 290,B00,102400,Vaccaro; Kristen Marie,0,0,25,25
1668216363446,CSE 290,C00,102414,Pannuto; Patrick William,0,0,25,25
1668216363446,CSE 290,D00,102427,Pevzner; Pavel Arkadjevich,0,0,0,0
1668216363446,CSE 290,E00,102429,Zhao; Jishen,0,0,0,0
1668216363446,CSE 290,F00,102436,Tullsen; Dean Michael,0,0,0,0
1668216363446,CSE 290,G00,102440,Christensen; Henrik I,0,0,20,20
1668216363871,CSE 291,A00,102443,Su; Hao,0,0,0,0
1668216363871,CSE 291,B00,102448,Polikarpova; Nadezhda,0,0,0,0
1668216363871,CSE 291,C00,102453,Vaccaro; Kristen Marie,0,0,0,0
1668216363871,CSE 291,D00,111343,Savage; Stefan,0,0,0,0
1668216363871,CSE 291,E00,116474,Claffy; Kimberly Claire,0,0,0,0
1668216363871,CSE 291,F00,116479,Pasquale; Joseph,0,0,0,0
1668216364308,CSE 293,001,119111,Bafna; Vineet,9999,0,9999,0
1668216364308,CSE 293,002,119118,Bellare; Mihir,9999,0,9999,0
1668216364308,CSE 293,003,119122,Berg-Kirkpatrick; Taylor D,9999,0,9999,0
1668216364308,CSE 293,004,119135,Christensen; Henrik I,9999,0,9999,0
1668216364308,CSE 293,005,119142,Cottrell; Garrison W,9999,0,9999,0
1668216364308,CSE 293,006,119146,Deutsch; Alin Bernard,9999,0,9999,0
1668216364308,CSE 293,007,119159,Esmaeilzadeh; Hadi,9999,0,9999,0
1668216364308,CSE 293,008,119166,Freund; Yoav,9999,0,9999,0
1668216364308,CSE 293,009,119170,Griswold; William G.,9999,0,9999,0
1668216364308,CSE 293,010,119183,Gymrek; Melissa Ann,9999,0,9999,0
1668216364308,CSE 293,011,119190,Heninger; Nadia A,9999,0,9999,0
1668216364308,CSE 293,012,119230,Impagliazzo; Russell,9999,0,9999,0
1668216364308,CSE 293,013,119232,Jhala; Ranjit,9999,0,9999,0
1668216364308,CSE 293,014,119233,Kahng; Andrew Byun,9999,0,9999,0
1668216364308,CSE 293,015,119298,Kane; Daniel Mertz,9999,0,9999,0
1668216364308,CSE 293,016,119299,Kriegman; David J,9999,0,9999,0
1668216364308,CSE 293,017,119300,Kumar; Arun Kumar,9999,0,9999,0
1668216364308,CSE 293,018,119301,Lerner; Sorin,9999,0,9999,0
1668216364308,CSE 293,019,119302,Lovett; Shachar,9999,0,9999,0
1668216364308,CSE 293,020,119303,McAuley; Julian John,9999,0,9999,0
1668216364308,CSE 293,021,119304,Micciancio; Daniele,9999,0,9999,0
1668216364308,CSE 293,022,119367,Orailoglu; Alex,9999,0,9999,0
1668216364308,CSE 293,023,119382,Paturi; Ramamohan,9999,0,9999,0
1668216364308,CSE 293,024,119404,Polikarpova; Nadezhda,9999,0,9999,0
1668216364308,CSE 293,025,119406,Politz; Joseph Gibbs,9999,0,9999,0
1668216364308,CSE 293,026,119411,Porter; George M,9999,0,9999,0
1668216364308,CSE 293,027,119414,Porter; Leonard Emerson,9999,0,9999,0
1668216364308,CSE 293,028,119416,Ramamoorthi; Ravi,9999,0,9999,0
1668216364308,CSE 293,029,119417,Sahoo; Debashis,9999,0,9999,0
1668216364308,CSE 293,030,119420,Saul; Lawrence,9999,0,9999,0
1668216364308,CSE 293,031,119421,Savage; Stefan,9999,0,9999,0
1668216364308,CSE 293,032,119425,Schulze; Jurgen P.,9999,0,9999,0
1668216364308,CSE 293,033,119426,Snoeren; Alex C.,9999,0,9999,0
1668216364308,CSE 293,034,119428,Shang; Jingbo,9999,0,9999,0
1668216364308,CSE 293,035,119430,Stefan; Deian,9999,0,9999,0
1668216364308,CSE 293,036,119431,Su; Hao,9999,0,9999,0
1668216364308,CSE 293,037,119433,Swanson; Steven James,9999,0,9999,0
1668216364308,CSE 293,038,119435,Tullsen; Dean Michael,9999,0,9999,0
1668216364308,CSE 293,039,119483,Voelker; Geoffrey M.,9999,0,9999,0
1668216364308,CSE 293,040,119537,Zhao; Jishen,9999,0,9999,0
1668216364308,CSE 293,041,119538,Zhou; Yuan-Yuan,9999,0,9999,0
1668216364308,CSE 293,042,119539,Gao; Sicun,9999,0,9999,0
1668216364308,CSE 293,043,119540,Weibel; Nadir,9999,0,9999,0
1668216364308,CSE 293,044,119541,Gupta; Rajesh K.,9999,0,9999,0
1668216364308,CSE 293,045,126410,Vaccaro; Kristen Marie,9999,0,9999,0
1668216364308,CSE 293,046,126411,Klemke; Richard,9999,0,9999,0
1668216364736,CSE 294,A00,102459,Voelker; Geoffrey M.,0,0,0,0
1668216364736,CSE 294,B00,111322,Orailoglu; Alex,0,0,0,0
1668216365160,DSE 201,A00,096914,Deutsch; Alin Bernard,30,0,30,0
1668216365585,DSE 210,A00,096915,Dasgupta; Sanjoy,30,0,30,0
1668216366010,DSE 260A,A00,096916,Altintas De Callaf; Ilkay,30,0,30,0
1668216366453,ECE 200,001,103586,Antipa; Nicholas A,9999,0,9999,0
1668216366453,ECE 200,002,103587,Atanasov; Nikolay A.,9999,0,9999,0
1668216366453,ECE 200,003,103588,Bharadia; Dinesh,9999,0,9999,0
1668216366453,ECE 200,004,103589,Cheng; Chung Kuan,9999,0,9999,0
1668216366453,ECE 200,005,103590,Cosman; Pamela C.,9999,0,9999,0
1668216366453,ECE 200,006,103591,Dayeh; Shadi Ahmad,9999,0,9999,0
1668216366453,ECE 200,007,103592,Fainman; Yeshaiahu,9999,0,9999,0
1668216366453,ECE 200,008,103593,Ford; Joseph Earl,9999,0,9999,0
1668216366453,ECE 200,009,103594,Franceschetti; Massimo,9999,0,9999,0
1668216366453,ECE 200,010,103595,Fullerton; Eric E,9999,0,9999,0
1668216366453,ECE 200,011,103596,Galton; Ian A,9999,0,9999,0
1668216366453,ECE 200,012,103597,Gilja; Vikash,9999,0,9999,0
1668216366453,ECE 200,013,103598,Hall; Drew A.,9999,0,9999,0
1668216366453,ECE 200,014,103599,Hsueh; Tzu-Chien,9999,0,9999,0
1668216366453,ECE 200,015,103600,Javidi; Tara,9999,0,9999,0
1668216366453,ECE 200,016,103601,Kahng; Andrew Byun,9999,0,9999,0
1668216366453,ECE 200,017,103602,Kim; Young-Han,9999,0,9999,0
1668216366453,ECE 200,018,103603,Koushanfar; Farinaz,9999,0,9999,0
1668216366453,ECE 200,019,103604,Kuzum; Duygu,9999,0,9999,0
1668216366453,ECE 200,020,103605,Le; Hanh-Phuc,9999,0,9999,0
1668216366453,ECE 200,021,103606,Lin; Bill,9999,0,9999,0
1668216366453,ECE 200,022,103607,Liu; Zhaowei,9998,0,9999,1
1668216366453,ECE 200,023,103608,Lo; Yu-Hwa,9999,0,9999,0
1668216366453,ECE 200,024,103609,Lomakin; Vitaliy,9999,0,9999,0
1668216366453,ECE 200,025,103610,Mercier; Patrick Philip,9999,0,9999,0
1668216366453,ECE 200,026,103611,Meyer; Florian,9999,0,9999,0
1668216366453,ECE 200,027,103612,Milstein; Laurence B.,9999,0,9999,0
1668216366453,ECE 200,028,103613,Mir Arabbaygi; Siavash,9999,0,9999,0
1668216366453,ECE 200,029,103614,Mookherjea; Shayan,9999,0,9999,0
1668216366453,ECE 200,030,103615,Morris; Karcher William,9999,0,9999,0
1668216366453,ECE 200,031,103616,Ng; Tse Nga,9999,0,9999,0
1668216366453,ECE 200,032,103617,Nguyen; Truong Quang,9999,0,9999,0
1668216366453,ECE 200,033,103618,Nomura; Kenji,9999,0,9999,0
1668216366453,ECE 200,034,103619,Orlitsky; Alon,9999,0,9999,0
1668216366453,ECE 200,035,103620,Pal; Piya,9999,0,9999,0
1668216366453,ECE 200,036,103621,Papen; George C.,9999,0,9999,0
1668216366453,ECE 200,037,103622,Radic; Stojan,9999,0,9999,0
1668216366453,ECE 200,038,103623,Rao; Bhaskar D.,9999,0,9999,0
1668216366453,ECE 200,039,103624,Rao; Ramesh R,9999,0,9999,0
1668216366453,ECE 200,040,103625,Rebeiz; Gabriel,9999,0,9999,0
1668216366453,ECE 200,041,103626,Sanford; John R,9999,0,9999,0
1668216366453,ECE 200,042,103627,Siegel; Paul H.,9999,0,9999,0
1668216366453,ECE 200,043,103628,Sievenpiper; Daniel F.,9999,0,9999,0
1668216366453,ECE 200,044,103629,Sworder; David D.,9999,0,9999,0
1668216366453,ECE 200,045,103630,Taur; Yuan,9999,0,9999,0
1668216366453,ECE 200,046,103631,Touri; Behrouz,9999,0,9999,0
1668216366453,ECE 200,047,103632,Trivedi; Mohan M.,9999,0,9999,0
1668216366453,ECE 200,048,103633,Vasconcelos; Nuno,9999,0,9999,0
1668216366453,ECE 200,049,103634,Wang; Xiaolong,9999,0,9999,0
1668216366453,ECE 200,050,103635,Xie; Pengtao,9999,0,9999,0
1668216366453,ECE 200,051,103636,Yip; Michael,9999,0,9999,0
1668216366453,ECE 200,052,103637,Zeger; Kenneth A.,999,0,999,0
1668216366453,ECE 200,053,103638,Zhang; Xinyu,9999,0,9999,0
1668216366453,ECE 200,054,103639,Turakhia; Yatish Girish,9999,0,9999,0
1668216366453,ECE 200,055,103640,Kang; Mingu,9999,0,9999,0
1668216366453,ECE 200,056,103641,Shi; Yuanyuan,9999,0,9999,0
1668216366453,ECE 200,057,103642,Wang; Edward Jay,9999,0,9999,0
1668216366453,ECE 200,058,103643,Zheng; Yang,9999,0,9999,0
1668216366888,ECE 202,A00,103644,Kuzum; Duygu,0,0,0,0
1668216367312,ECE 212BN,A00,103646,Ng; Tse Nga,0,0,0,0
1668216367736,ECE 221,A00,111493,Staff,0,0,0,0
1668216368160,ECE 222B,A00,103647,Lomakin; Vitaliy,0,0,0,0
1668216368583,ECE 230B,A00,103648,Taur; Yuan,0,0,0,0
1668216369006,ECE 238B,A00,103649,Garay; Javier,0,0,0,0
1668216369435,ECE 240B,A00,112900,Fainman; Yeshaiahu,0,0,0,0
1668216369857,ECE 247A,A00,103650,Jokerst; Jesse Vincent,0,0,0,0
1668216370283,ECE 247B,A00,103651,Wang; Joseph,0,0,0,0
1668216370707,ECE 250,A00,103652,Siegel; Paul H.,0,0,0,0
1668216371130,ECE 251A,A00,103654,Rao; Bhaskar D.,0,0,0,0
1668216371556,ECE 257B,A00,103655,Bharadia; Dinesh,0,0,0,0
1668216371992,ECE 258A,A00,103656,Milstein; Laurence B.,0,0,0,0
1668216372421,ECE 260B,A00,103658,Kang; Mingu,0,0,0,0
1668216372855,ECE 264A,A00,103659,Galton; Ian A,0,0,0,0
1668216373278,ECE 265A,A00,103661,Gudem; Prasad S.S.,0,0,0,0
1668216373702,ECE 265D,A00,103662,Gudem; Prasad S.S.,0,0,0,0
1668216374124,ECE 268,A00,103663,Koushanfar; Farinaz,0,0,0,0
1668216374558,ECE 269,A01,103665,Pal; Piya,0,0,0,0
1668216374981,ECE 271B,A00,103666,Vasconcelos; Manuela,0,0,0,0
1668216375404,ECE 276A,A00,103667,Atanasov; Nikolay A.,0,0,0,0
1668216375828,ECE 277,A00,103668,An; Cheolhong,0,0,0,0
1668216376251,ECE 279,A00,117947,Hall; Drew A.,0,0,0,0
1668216377105,ECE 283,A00,103670,Hsueh; Tzu-Chien,0,0,0,0
1668216377528,ECE 284,A00,103671,Turakhia; Yatish Girish,0,0,0,0
1668216377952,ECE 285,A00,103672,Zheng; Yang,0,0,0,0
1668216377952,ECE 285,B00,103673,Sworder; David D.,0,0,0,0
1668216378377,ECE 287,A00,103676,Javidi; Tara,0,0,0,0
1668216378809,MATH 200B,A00,098023,Salehi Golsefidy; Alireza,12,0,15,3
1668216379231,MATH 202B,A00,098024,Rhoades; Brendon Patrick,9,0,15,6
1668216379658,MATH 203B,A00,098025,Oprea; Dragos N.,10,0,15,5
1668216380079,MATH 204B,A00,098026,Sorensen; Claus M,13,0,15,2
1668216380505,MATH 208,A00,098027,Izadi; Elham,7,0,10,3
1668216380929,MATH 209,A00,098028,Pollack; Aaron,10,0,10,0
1668216381351,MATH 211A,A00,112919,Rogalski; Daniel,9,0,10,1
1668216381781,MATH 211B,A00,112920,Seward; Brandon M.,9,0,10,1
1668216382215,MATH 218,A00,098029,Li; Bo,10,0,10,0
1668216382653,MATH 220B,A00,098030,Novak; Jonathan I,11,0,15,4
1668216383076,MATH 221A,A00,098031,Ebenfelt; Peter F,13,0,15,2
1668216383505,MATH 231B,A00,098032,Zlatos; Andrej,12,0,15,3
1668216383931,MATH 240B,A00,098033,Ni; Lei,9,0,15,6
1668216384356,MATH 243,A00,098034,Jekel; David Andrew,10,0,10,0
1668216384779,MATH 245A,A00,098035,Nie; Jiawang,0,0,15,16
1668216385201,MATH 248,A00,098036,Bejenaru; Ioan,10,0,10,0
1668216385631,MATH 250B,A00,098037,Spolaor; Luca,14,0,15,1
1668216386063,MATH 258,A00,098038,Ni; Lei,10,0,10,0
1668216386489,MATH 264B,A00,098041,Rhoades; Brendon Patrick,9,0,15,6
1668216386912,MATH 268,A00,098042,Buss; Samuel R,10,0,10,0
1668216387335,MATH 269,A00,098043,Rhoades; Brendon Patrick,10,0,10,0
1668216387761,MATH 270B,A00,098044,Li; Bo,10,0,15,5
1668216388194,MATH 272B,A00,098045,Holst; Michael J,13,0,15,2
1668216388620,MATH 273A,A00,098046,Tian; Xiaochuan,10,0,15,5
1668216389045,MATH 275,A01,098048,Tian; Xiaochuan,6,0,10,4
1668216389471,MATH 278A,A00,098049,Holst; Michael J,8,0,10,2
1668216389901,MATH 278B,A00,098050,Cloninger; Alexander,10,0,10,0
1668216390327,MATH 278C,A00,098051,Nie; Jiawang,7,0,10,3
1668216390749,MATH 280B,A00,098052,Zheng; Tianyi,10,0,15,5
1668216391257,MATH 281B,A00,098053,Bradic; Jelena,2,0,15,13
1668216391685,MATH 282B,A00,098054,Arias-Castro; Ery,0,0,15,15
1668216392125,MATH 285,A00,098055,Fitzsimmons; Patrick J,0,0,15,17
1668216392567,MATH 287B,A00,098056,Arias-Castro; Ery,2,0,15,13
1668216392993,MATH 288,A00,098057,Agarwal; Pooja,9,0,10,1
1668216392993,MATH 288,B00,098058,Zhang; Danna,8,0,10,2
1668216392993,MATH 288,C00,098059,Williams; Ruth J,10,0,10,0
1668216393424,MATH 290B,A00,098060,Roberts; Justin Deritter,13,0,15,2
1668216393847,MATH 292,A00,098061,Belmont; Eva Kinoshita,10,0,10,0
1668216394283,MATH 295,A00,098062,Suk; Andrew Hoon,48,0,50,2
1668216394707,MATH 296,A00,098063,Novak; Jonathan I,20,0,20,0
1668216395133,MATH 297,001,098064,Gamst; Anthony Collins,9997,0,9999,2
1668216897559,COGS 205,A00,101395,Chiba; Andrea,19,0,20,1
1668216897985,COGS 210B,001,101404,Greene; Deanna Jacquelyn,9998,0,9999,1
1668216897985,COGS 210B,002,101417,Xia; Haijun,9999,0,9999,0
1668216897985,COGS 210B,003,101422,Nitz; Douglas A.,9999,0,9999,0
1668216897985,COGS 210B,004,101423,Hollan; James D.,9998,0,9999,1
1668216897985,COGS 210B,005,101424,Deak; Gedeon O.,9998,0,9999,1
1668216897985,COGS 210B,006,101425,Rossano; Federico,9999,0,9999,0
1668216898409,COGS 211B,A00,101427,Coulson; Seana M,9996,0,9999,3
1668216898835,COGS 220,A00,101428,Hollan; James D.,0,0,25,25
1668216899257,COGS 229,A00,101429,Dow; Steven P,18,0,25,7
1668216899684,COGS 230,A00,101430,Klemmer; Scott R,12,0,17,5
1668216900106,COGS 234,A00,101431,Xia; Haijun,2,0,25,23
1668216900531,COGS 260,A00,101432,Kiyonaga; Anastasia,21,0,25,4
1668216900531,COGS 260,B00,101433,Kirsh; David Joel,15,0,25,10
1668216900963,CSE 202,A00,102371,Impagliazzo; Russell,0,0,0,0
1668216901395,CSE 203B,A01,102373,Cheng; Chung Kuan,0,0,0,0
1668216901823,CSE 208,A00,102374,Micciancio; Daniele,0,0,0,0
1668216902254,CSE 209A,A00,112895,Impagliazzo; Russell,0,0,15,15
1668216902678,CSE 209B,A00,108005,Bellare; Mihir,0,0,0,0
1668216903106,CSE 210,A00,113163,Coblenz; Michael J,0,0,0,0
1668216903531,CSE 219,A00,106111,Dow; Steven P,0,0,20,20
1668216903962,CSE 221,A00,102376,Voelker; Geoffrey M.,0,0,0,0
1668216904389,CSE 224,A01,102378,Porter; George M,0,0,0,0
1668216904814,CSE 229A,A00,102379,Savage; Stefan,0,0,0,0
1668216905239,CSE 229C,A00,102380,Munyaka; Imani N. S.,0,0,0,0
1668216905661,CSE 232B,A00,102382,Deutsch; Alin Bernard,0,0,0,0
1668216906098,CSE 234,A01,112904,Kumar; Arun Kumar,0,0,0,0
1668216906520,CSE 237A,A00,102383,Rosing; Tajana Simunic,0,0,0,0
1668216906960,CSE 239A,A00,102384,Deutsch; Alin Bernard,0,0,0,0
1668216907391,CSE 239B,A00,102385,Polikarpova; Nadezhda,0,0,0,0
1668216907816,CSE 240A,A00,102386,Pannuto; Patrick William,0,0,0,0
1668216908239,CSE 240B,A00,102387,Zhao; Jishen,0,0,0,0
1668216908662,CSE 241A,A00,106406,Kang; Mingu,0,0,0,0
1668216909087,CSE 249B,A00,102388,Kahng; Andrew Byun,0,0,8,8
1668216909510,CSE 251B,A01,102392,Cottrell; Garrison W,0,0,0,0
1668216909510,CSE 251B,A02,102393,Cottrell; Garrison W,0,0,0,0
1668216909949,CSE 252B,A00,102394,Ochoa; Benjamin Lawrence,0,0,0,0
1668216910381,CSE 257,A01,102396,Gao; Sicun,0,0,0,0
1668216910818,CSE 272,A00,102397,Li; Tzumao,0,0,0,0
1668216911245,CSE 274,A00,111323,Chern; Albert Ren-Haur,0,0,0,0
1668216911688,CSE 282,A00,102398,Pevzner; Pavel Arkadjevich,0,0,0,0
1668216912114,CSE 284,A00,114175,Gymrek; Melissa Ann,0,0,0,0
1668216912540,CSE 290,A00,102399,Chandraker; Manmohan Krishna,0,0,0,0
1668216912540,CSE 290,B00,102400,Vaccaro; Kristen Marie,0,0,25,25
1668216912540,CSE 290,C00,102414,Pannuto; Patrick William,0,0,25,25
1668216912540,CSE 290,D00,102427,Pevzner; Pavel Arkadjevich,0,0,0,0
1668216912540,CSE 290,E00,102429,Zhao; Jishen,0,0,0,0
1668216912540,CSE 290,F00,102436,Tullsen; Dean Michael,0,0,0,0
1668216912540,CSE 290,G00,102440,Christensen; Henrik I,0,0,20,20
1668216912983,CSE 291,A00,102443,Su; Hao,0,0,0,0
1668216912983,CSE 291,B00,102448,Polikarpova; Nadezhda,0,0,0,0
1668216912983,CSE 291,C00,102453,Vaccaro; Kristen Marie,0,0,0,0
1668216912983,CSE 291,D00,111343,Savage; Stefan,0,0,0,0
1668216912983,CSE 291,E00,116474,Claffy; Kimberly Claire,0,0,0,0
1668216912983,CSE 291,F00,116479,Pasquale; Joseph,0,0,0,0
1668216913412,CSE 293,001,119111,Bafna; Vineet,9999,0,9999,0
1668216913412,CSE 293,002,119118,Bellare; Mihir,9999,0,9999,0
1668216913412,CSE 293,003,119122,Berg-Kirkpatrick; Taylor D,9999,0,9999,0
1668216913412,CSE 293,004,119135,Christensen; Henrik I,9999,0,9999,0
1668216913412,CSE 293,005,119142,Cottrell; Garrison W,9999,0,9999,0
1668216913412,CSE 293,006,119146,Deutsch; Alin Bernard,9999,0,9999,0
1668216913412,CSE 293,007,119159,Esmaeilzadeh; Hadi,9999,0,9999,0
1668216913412,CSE 293,008,119166,Freund; Yoav,9999,0,9999,0
1668216913412,CSE 293,009,119170,Griswold; William G.,9999,0,9999,0
1668216913412,CSE 293,010,119183,Gymrek; Melissa Ann,9999,0,9999,0
1668216913412,CSE 293,011,119190,Heninger; Nadia A,9999,0,9999,0
1668216913412,CSE 293,012,119230,Impagliazzo; Russell,9999,0,9999,0
1668216913412,CSE 293,013,119232,Jhala; Ranjit,9999,0,9999,0
1668216913412,CSE 293,014,119233,Kahng; Andrew Byun,9999,0,9999,0
1668216913412,CSE 293,015,119298,Kane; Daniel Mertz,9999,0,9999,0
1668216913412,CSE 293,016,119299,Kriegman; David J,9999,0,9999,0
1668216913412,CSE 293,017,119300,Kumar; Arun Kumar,9999,0,9999,0
1668216913412,CSE 293,018,119301,Lerner; Sorin,9999,0,9999,0
1668216913412,CSE 293,019,119302,Lovett; Shachar,9999,0,9999,0
1668216913412,CSE 293,020,119303,McAuley; Julian John,9999,0,9999,0
1668216913412,CSE 293,021,119304,Micciancio; Daniele,9999,0,9999,0
1668216913412,CSE 293,022,119367,Orailoglu; Alex,9999,0,9999,0
1668216913412,CSE 293,023,119382,Paturi; Ramamohan,9999,0,9999,0
1668216913412,CSE 293,024,119404,Polikarpova; Nadezhda,9999,0,9999,0
1668216913412,CSE 293,025,119406,Politz; Joseph Gibbs,9999,0,9999,0
1668216913412,CSE 293,026,119411,Porter; George M,9999,0,9999,0
1668216913412,CSE 293,027,119414,Porter; Leonard Emerson,9999,0,9999,0
1668216913412,CSE 293,028,119416,Ramamoorthi; Ravi,9999,0,9999,0
1668216913412,CSE 293,029,119417,Sahoo; Debashis,9999,0,9999,0
1668216913412,CSE 293,030,119420,Saul; Lawrence,9999,0,9999,0
1668216913412,CSE 293,031,119421,Savage; Stefan,9999,0,9999,0
1668216913412,CSE 293,032,119425,Schulze; Jurgen P.,9999,0,9999,0
1668216913412,CSE 293,033,119426,Snoeren; Alex C.,9999,0,9999,0
1668216913412,CSE 293,034,119428,Shang; Jingbo,9999,0,9999,0
1668216913412,CSE 293,035,119430,Stefan; Deian,9999,0,9999,0
1668216913412,CSE 293,036,119431,Su; Hao,9999,0,9999,0
1668216913412,CSE 293,037,119433,Swanson; Steven James,9999,0,9999,0
1668216913412,CSE 293,038,119435,Tullsen; Dean Michael,9999,0,9999,0
1668216913412,CSE 293,039,119483,Voelker; Geoffrey M.,9999,0,9999,0
1668216913412,CSE 293,040,119537,Zhao; Jishen,9999,0,9999,0
1668216913412,CSE 293,041,119538,Zhou; Yuan-Yuan,9999,0,9999,0
1668216913412,CSE 293,042,119539,Gao; Sicun,9999,0,9999,0
1668216913412,CSE 293,043,119540,Weibel; Nadir,9999,0,9999,0
1668216913412,CSE 293,044,119541,Gupta; Rajesh K.,9999,0,9999,0
1668216913412,CSE 293,045,126410,Vaccaro; Kristen Marie,9999,0,9999,0
1668216913412,CSE 293,046,126411,Klemke; Richard,9999,0,9999,0
1668216913978,CSE 294,A00,102459,Voelker; Geoffrey M.,0,0,0,0
1668216913978,CSE 294,B00,111322,Orailoglu; Alex,0,0,0,0
1668216914423,DSE 201,A00,096914,Deutsch; Alin Bernard,30,0,30,0
1668216914858,DSE 210,A00,096915,Dasgupta; Sanjoy,30,0,30,0
1668216915284,DSE 260A,A00,096916,Altintas De Callaf; Ilkay,30,0,30,0
1668216915730,ECE 200,001,103586,Antipa; Nicholas A,9999,0,9999,0
1668216915730,ECE 200,002,103587,Atanasov; Nikolay A.,9999,0,9999,0
1668216915730,ECE 200,003,103588,Bharadia; Dinesh,9999,0,9999,0
1668216915730,ECE 200,004,103589,Cheng; Chung Kuan,9999,0,9999,0
1668216915730,ECE 200,005,103590,Cosman; Pamela C.,9999,0,9999,0
1668216915730,ECE 200,006,103591,Dayeh; Shadi Ahmad,9999,0,9999,0
1668216915730,ECE 200,007,103592,Fainman; Yeshaiahu,9999,0,9999,0
1668216915730,ECE 200,008,103593,Ford; Joseph Earl,9999,0,9999,0
1668216915730,ECE 200,009,103594,Franceschetti; Massimo,9999,0,9999,0
1668216915730,ECE 200,010,103595,Fullerton; Eric E,9999,0,9999,0
1668216915730,ECE 200,011,103596,Galton; Ian A,9999,0,9999,0
1668216915730,ECE 200,012,103597,Gilja; Vikash,9999,0,9999,0
1668216915730,ECE 200,013,103598,Hall; Drew A.,9999,0,9999,0
1668216915730,ECE 200,014,103599,Hsueh; Tzu-Chien,9999,0,9999,0
1668216915730,ECE 200,015,103600,Javidi; Tara,9999,0,9999,0
1668216915730,ECE 200,016,103601,Kahng; Andrew Byun,9999,0,9999,0
1668216915730,ECE 200,017,103602,Kim; Young-Han,9999,0,9999,0
1668216915730,ECE 200,018,103603,Koushanfar; Farinaz,9999,0,9999,0
1668216915730,ECE 200,019,103604,Kuzum; Duygu,9999,0,9999,0
1668216915730,ECE 200,020,103605,Le; Hanh-Phuc,9999,0,9999,0
1668216915730,ECE 200,021,103606,Lin; Bill,9999,0,9999,0
1668216915730,ECE 200,022,103607,Liu; Zhaowei,9998,0,9999,1
1668216915730,ECE 200,023,103608,Lo; Yu-Hwa,9999,0,9999,0
1668216915730,ECE 200,024,103609,Lomakin; Vitaliy,9999,0,9999,0
1668216915730,ECE 200,025,103610,Mercier; Patrick Philip,9999,0,9999,0
1668216915730,ECE 200,026,103611,Meyer; Florian,9999,0,9999,0
1668216915730,ECE 200,027,103612,Milstein; Laurence B.,9999,0,9999,0
1668216915730,ECE 200,028,103613,Mir Arabbaygi; Siavash,9999,0,9999,0
1668216915730,ECE 200,029,103614,Mookherjea; Shayan,9999,0,9999,0
1668216915730,ECE 200,030,103615,Morris; Karcher William,9999,0,9999,0
1668216915730,ECE 200,031,103616,Ng; Tse Nga,9999,0,9999,0
1668216915730,ECE 200,032,103617,Nguyen; Truong Quang,9999,0,9999,0
1668216915730,ECE 200,033,103618,Nomura; Kenji,9999,0,9999,0
1668216915730,ECE 200,034,103619,Orlitsky; Alon,9999,0,9999,0
1668216915730,ECE 200,035,103620,Pal; Piya,9999,0,9999,0
1668216915730,ECE 200,036,103621,Papen; George C.,9999,0,9999,0
1668216915730,ECE 200,037,103622,Radic; Stojan,9999,0,9999,0
1668216915730,ECE 200,038,103623,Rao; Bhaskar D.,9999,0,9999,0
1668216915730,ECE 200,039,103624,Rao; Ramesh R,9999,0,9999,0
1668216915730,ECE 200,040,103625,Rebeiz; Gabriel,9999,0,9999,0
1668216915730,ECE 200,041,103626,Sanford; John R,9999,0,9999,0
1668216915730,ECE 200,042,103627,Siegel; Paul H.,9999,0,9999,0
1668216915730,ECE 200,043,103628,Sievenpiper; Daniel F.,9999,0,9999,0
1668216915730,ECE 200,044,103629,Sworder; David D.,9999,0,9999,0
1668216915730,ECE 200,045,103630,Taur; Yuan,9999,0,9999,0
1668216915730,ECE 200,046,103631,Touri; Behrouz,9999,0,9999,0
1668216915730,ECE 200,047,103632,Trivedi; Mohan M.,9999,0,9999,0
1668216915730,ECE 200,048,103633,Vasconcelos; Nuno,9999,0,9999,0
1668216915730,ECE 200,049,103634,Wang; Xiaolong,9999,0,9999,0
1668216915730,ECE 200,050,103635,Xie; Pengtao,9999,0,9999,0
1668216915730,ECE 200,051,103636,Yip; Michael,9999,0,9999,0
1668216915730,ECE 200,052,103637,Zeger; Kenneth A.,999,0,999,0
1668216915730,ECE 200,053,103638,Zhang; Xinyu,9999,0,9999,0
1668216915730,ECE 200,054,103639,Turakhia; Yatish Girish,9999,0,9999,0
1668216915730,ECE 200,055,103640,Kang; Mingu,9999,0,9999,0
1668216915730,ECE 200,056,103641,Shi; Yuanyuan,9999,0,9999,0
1668216915730,ECE 200,057,103642,Wang; Edward Jay,9999,0,9999,0
1668216915730,ECE 200,058,103643,Zheng; Yang,9999,0,9999,0
1668216916153,ECE 202,A00,103644,Kuzum; Duygu,0,0,0,0
1668216916581,ECE 212BN,A00,103646,Ng; Tse Nga,0,0,0,0
1668216917004,ECE 221,A00,111493,Staff,0,0,0,0
1668216917431,ECE 222B,A00,103647,Lomakin; Vitaliy,0,0,0,0
1668216917853,ECE 230B,A00,103648,Taur; Yuan,0,0,0,0
1668216918279,ECE 238B,A00,103649,Garay; Javier,0,0,0,0
1668216918704,ECE 240B,A00,112900,Fainman; Yeshaiahu,0,0,0,0
1668216919139,ECE 247A,A00,103650,Jokerst; Jesse Vincent,0,0,0,0
1668216919568,ECE 247B,A00,103651,Wang; Joseph,0,0,0,0
1668216920007,ECE 250,A00,103652,Siegel; Paul H.,0,0,0,0
1668216920437,ECE 251A,A00,103654,Rao; Bhaskar D.,0,0,0,0
1668216920867,ECE 257B,A00,103655,Bharadia; Dinesh,0,0,0,0
1668216921297,ECE 258A,A00,103656,Milstein; Laurence B.,0,0,0,0
1668216921722,ECE 260B,A00,103658,Kang; Mingu,0,0,0,0
1668216922144,ECE 264A,A00,103659,Galton; Ian A,0,0,0,0
1668216922570,ECE 265A,A00,103661,Gudem; Prasad S.S.,0,0,0,0
1668216922993,ECE 265D,A00,103662,Gudem; Prasad S.S.,0,0,0,0
1668216923421,ECE 268,A00,103663,Koushanfar; Farinaz,0,0,0,0
1668216923847,ECE 269,A01,103665,Pal; Piya,0,0,0,0
1668216924271,ECE 271B,A00,103666,Vasconcelos; Manuela,0,0,0,0
1668216924700,ECE 276A,A00,103667,Atanasov; Nikolay A.,0,0,0,0
1668216925125,ECE 277,A00,103668,An; Cheolhong,0,0,0,0
1668216925549,ECE 279,A00,117947,Hall; Drew A.,0,0,0,0
1668216926398,ECE 283,A00,103670,Hsueh; Tzu-Chien,0,0,0,0
1668216926823,ECE 284,A00,103671,Turakhia; Yatish Girish,0,0,0,0
1668216927246,ECE 285,A00,103672,Zheng; Yang,0,0,0,0
1668216927246,ECE 285,B00,103673,Sworder; David D.,0,0,0,0
1668216927670,ECE 287,A00,103676,Javidi; Tara,0,0,0,0
1668216928093,MATH 200B,A00,098023,Salehi Golsefidy; Alireza,12,0,15,3
1668216928527,MATH 202B,A00,098024,Rhoades; Brendon Patrick,9,0,15,6
1668216928952,MATH 203B,A00,098025,Oprea; Dragos N.,10,0,15,5
1668216929379,MATH 204B,A00,098026,Sorensen; Claus M,13,0,15,2
1668216929817,MATH 208,A00,098027,Izadi; Elham,7,0,10,3
1668216930241,MATH 209,A00,098028,Pollack; Aaron,10,0,10,0
1668216930663,MATH 211A,A00,112919,Rogalski; Daniel,9,0,10,1
1668216931087,MATH 211B,A00,112920,Seward; Brandon M.,9,0,10,1
1668216931521,MATH 218,A00,098029,Li; Bo,10,0,10,0
1668216931949,MATH 220B,A00,098030,Novak; Jonathan I,11,0,15,4
1668216932372,MATH 221A,A00,098031,Ebenfelt; Peter F,13,0,15,2
1668216932804,MATH 231B,A00,098032,Zlatos; Andrej,12,0,15,3
1668216933232,MATH 240B,A00,098033,Ni; Lei,9,0,15,6
1668216933657,MATH 243,A00,098034,Jekel; David Andrew,10,0,10,0
1668216934086,MATH 245A,A00,098035,Nie; Jiawang,0,0,15,16
1668216934520,MATH 248,A00,098036,Bejenaru; Ioan,10,0,10,0
1668216934942,MATH 250B,A00,098037,Spolaor; Luca,14,0,15,1
1668216935373,MATH 258,A00,098038,Ni; Lei,10,0,10,0
1668216935800,MATH 264B,A00,098041,Rhoades; Brendon Patrick,9,0,15,6
1668216936223,MATH 268,A00,098042,Buss; Samuel R,10,0,10,0
1668216936646,MATH 269,A00,098043,Rhoades; Brendon Patrick,10,0,10,0
1668216937075,MATH 270B,A00,098044,Li; Bo,10,0,15,5
1668216937505,MATH 272B,A00,098045,Holst; Michael J,13,0,15,2
1668216937932,MATH 273A,A00,098046,Tian; Xiaochuan,10,0,15,5
1668216938356,MATH 275,A01,098048,Tian; Xiaochuan,6,0,10,4
1668216938783,MATH 278A,A00,098049,Holst; Michael J,8,0,10,2
1668216939209,MATH 278B,A00,098050,Cloninger; Alexander,10,0,10,0
1668216939647,MATH 278C,A00,098051,Nie; Jiawang,7,0,10,3
1668216940075,MATH 280B,A00,098052,Zheng; Tianyi,10,0,15,5
1668216940511,MATH 281B,A00,098053,Bradic; Jelena,2,0,15,13
1668216940935,MATH 282B,A00,098054,Arias-Castro; Ery,0,0,15,15
1668216941361,MATH 285,A00,098055,Fitzsimmons; Patrick J,0,0,15,17
1668216941789,MATH 287B,A00,098056,Arias-Castro; Ery,2,0,15,13
1668216942216,MATH 288,A00,098057,Agarwal; Pooja,9,0,10,1
1668216942216,MATH 288,B00,098058,Zhang; Danna,8,0,10,2
1668216942216,MATH 288,C00,098059,Williams; Ruth J,10,0,10,0
1668216942639,MATH 290B,A00,098060,Roberts; Justin Deritter,13,0,15,2
1668216943064,MATH 292,A00,098061,Belmont; Eva Kinoshita,10,0,10,0
1668216943488,MATH 295,A00,098062,Suk; Andrew Hoon,48,0,50,2
1668216943912,MATH 296,A00,098063,Novak; Jonathan I,20,0,20,0
1668216944337,MATH 297,001,098064,Gamst; Anthony Collins,9997,0,9999,2
1668217446207,COGS 205,A00,101395,Chiba; Andrea,19,0,20,1
1668217446641,COGS 210B,001,101404,Greene; Deanna Jacquelyn,9998,0,9999,1
1668217446641,COGS 210B,002,101417,Xia; Haijun,9999,0,9999,0
1668217446641,COGS 210B,003,101422,Nitz; Douglas A.,9999,0,9999,0
1668217446641,COGS 210B,004,101423,Hollan; James D.,9998,0,9999,1
1668217446641,COGS 210B,005,101424,Deak; Gedeon O.,9998,0,9999,1
1668217446641,COGS 210B,006,101425,Rossano; Federico,9999,0,9999,0
1668217447069,COGS 211B,A00,101427,Coulson; Seana M,9996,0,9999,3
1668217447494,COGS 220,A00,101428,Hollan; James D.,0,0,25,25
1668217447919,COGS 229,A00,101429,Dow; Steven P,18,0,25,7
1668217448358,COGS 230,A00,101430,Klemmer; Scott R,12,0,17,5
1668217448780,COGS 234,A00,101431,Xia; Haijun,2,0,25,23
1668217449207,COGS 260,A00,101432,Kiyonaga; Anastasia,21,0,25,4
1668217449207,COGS 260,B00,101433,Kirsh; David Joel,15,0,25,10
1668217449630,CSE 202,A00,102371,Impagliazzo; Russell,0,0,0,0
1668217450062,CSE 203B,A01,102373,Cheng; Chung Kuan,0,0,0,0
1668217450489,CSE 208,A00,102374,Micciancio; Daniele,0,0,0,0
1668217450913,CSE 209A,A00,112895,Impagliazzo; Russell,0,0,15,15
1668217451337,CSE 209B,A00,108005,Bellare; Mihir,0,0,0,0
1668217451759,CSE 210,A00,113163,Coblenz; Michael J,0,0,0,0
1668217452185,CSE 219,A00,106111,Dow; Steven P,0,0,20,20
1668217452608,CSE 221,A00,102376,Voelker; Geoffrey M.,0,0,0,0
1668217453041,CSE 224,A01,102378,Porter; George M,0,0,0,0
1668217453469,CSE 229A,A00,102379,Savage; Stefan,0,0,0,0
1668217453896,CSE 229C,A00,102380,Munyaka; Imani N. S.,0,0,0,0
1668217454322,CSE 232B,A00,102382,Deutsch; Alin Bernard,0,0,0,0
1668217454746,CSE 234,A01,112904,Kumar; Arun Kumar,0,0,0,0
1668217455184,CSE 237A,A00,102383,Rosing; Tajana Simunic,0,0,0,0
1668217455612,CSE 239A,A00,102384,Deutsch; Alin Bernard,0,0,0,0
1668217456036,CSE 239B,A00,102385,Polikarpova; Nadezhda,0,0,0,0
1668217456462,CSE 240A,A00,102386,Pannuto; Patrick William,0,0,0,0
1668217456890,CSE 240B,A00,102387,Zhao; Jishen,0,0,0,0
1668217457328,CSE 241A,A00,106406,Kang; Mingu,0,0,0,0
1668217457763,CSE 249B,A00,102388,Kahng; Andrew Byun,0,0,8,8
1668217458199,CSE 251B,A01,102392,Cottrell; Garrison W,0,0,0,0
1668217458199,CSE 251B,A02,102393,Cottrell; Garrison W,0,0,0,0
1668217458623,CSE 252B,A00,102394,Ochoa; Benjamin Lawrence,0,0,0,0
1668217459047,CSE 257,A01,102396,Gao; Sicun,0,0,0,0
1668217459473,CSE 272,A00,102397,Li; Tzumao,0,0,0,0
1668217459898,CSE 274,A00,111323,Chern; Albert Ren-Haur,0,0,0,0
1668217460320,CSE 282,A00,102398,Pevzner; Pavel Arkadjevich,0,0,0,0
1668217460745,CSE 284,A00,114175,Gymrek; Melissa Ann,0,0,0,0
1668217461170,CSE 290,A00,102399,Chandraker; Manmohan Krishna,0,0,0,0
1668217461170,CSE 290,B00,102400,Vaccaro; Kristen Marie,0,0,25,25
1668217461170,CSE 290,C00,102414,Pannuto; Patrick William,0,0,25,25
1668217461170,CSE 290,D00,102427,Pevzner; Pavel Arkadjevich,0,0,0,0
1668217461170,CSE 290,E00,102429,Zhao; Jishen,0,0,0,0
1668217461170,CSE 290,F00,102436,Tullsen; Dean Michael,0,0,0,0
1668217461170,CSE 290,G00,102440,Christensen; Henrik I,0,0,20,20
1668217461601,CSE 291,A00,102443,Su; Hao,0,0,0,0
1668217461601,CSE 291,B00,102448,Polikarpova; Nadezhda,0,0,0,0
1668217461601,CSE 291,C00,102453,Vaccaro; Kristen Marie,0,0,0,0
1668217461601,CSE 291,D00,111343,Savage; Stefan,0,0,0,0
1668217461601,CSE 291,E00,116474,Claffy; Kimberly Claire,0,0,0,0
1668217461601,CSE 291,F00,116479,Pasquale; Joseph,0,0,0,0
1668217462042,CSE 293,001,119111,Bafna; Vineet,9999,0,9999,0
1668217462042,CSE 293,002,119118,Bellare; Mihir,9999,0,9999,0
1668217462042,CSE 293,003,119122,Berg-Kirkpatrick; Taylor D,9999,0,9999,0
1668217462042,CSE 293,004,119135,Christensen; Henrik I,9999,0,9999,0
1668217462042,CSE 293,005,119142,Cottrell; Garrison W,9999,0,9999,0
1668217462042,CSE 293,006,119146,Deutsch; Alin Bernard,9999,0,9999,0
1668217462042,CSE 293,007,119159,Esmaeilzadeh; Hadi,9999,0,9999,0
1668217462042,CSE 293,008,119166,Freund; Yoav,9999,0,9999,0
1668217462042,CSE 293,009,119170,Griswold; William G.,9999,0,9999,0
1668217462042,CSE 293,010,119183,Gymrek; Melissa Ann,9999,0,9999,0
1668217462042,CSE 293,011,119190,Heninger; Nadia A,9999,0,9999,0
1668217462042,CSE 293,012,119230,Impagliazzo; Russell,9999,0,9999,0
1668217462042,CSE 293,013,119232,Jhala; Ranjit,9999,0,9999,0
1668217462042,CSE 293,014,119233,Kahng; Andrew Byun,9999,0,9999,0
1668217462042,CSE 293,015,119298,Kane; Daniel Mertz,9999,0,9999,0
1668217462042,CSE 293,016,119299,Kriegman; David J,9999,0,9999,0
1668217462042,CSE 293,017,119300,Kumar; Arun Kumar,9999,0,9999,0
1668217462042,CSE 293,018,119301,Lerner; Sorin,9999,0,9999,0
1668217462042,CSE 293,019,119302,Lovett; Shachar,9999,0,9999,0
1668217462042,CSE 293,020,119303,McAuley; Julian John,9999,0,9999,0
1668217462042,CSE 293,021,119304,Micciancio; Daniele,9999,0,9999,0
1668217462042,CSE 293,022,119367,Orailoglu; Alex,9999,0,9999,0
1668217462042,CSE 293,023,119382,Paturi; Ramamohan,9999,0,9999,0
1668217462042,CSE 293,024,119404,Polikarpova; Nadezhda,9999,0,9999,0
1668217462042,CSE 293,025,119406,Politz; Joseph Gibbs,9999,0,9999,0
1668217462042,CSE 293,026,119411,Porter; George M,9999,0,9999,0
1668217462042,CSE 293,027,119414,Porter; Leonard Emerson,9999,0,9999,0
1668217462042,CSE 293,028,119416,Ramamoorthi; Ravi,9999,0,9999,0
1668217462042,CSE 293,029,119417,Sahoo; Debashis,9999,0,9999,0
1668217462042,CSE 293,030,119420,Saul; Lawrence,9999,0,9999,0
1668217462042,CSE 293,031,119421,Savage; Stefan,9999,0,9999,0
1668217462042,CSE 293,032,119425,Schulze; Jurgen P.,9999,0,9999,0
1668217462042,CSE 293,033,119426,Snoeren; Alex C.,9999,0,9999,0
1668217462042,CSE 293,034,119428,Shang; Jingbo,9999,0,9999,0
1668217462042,CSE 293,035,119430,Stefan; Deian,9999,0,9999,0
1668217462042,CSE 293,036,119431,Su; Hao,9999,0,9999,0
1668217462042,CSE 293,037,119433,Swanson; Steven James,9999,0,9999,0
1668217462042,CSE 293,038,119435,Tullsen; Dean Michael,9999,0,9999,0
1668217462042,CSE 293,039,119483,Voelker; Geoffrey M.,9999,0,9999,0
1668217462042,CSE 293,040,119537,Zhao; Jishen,9999,0,9999,0
1668217462042,CSE 293,041,119538,Zhou; Yuan-Yuan,9999,0,9999,0
1668217462042,CSE 293,042,119539,Gao; Sicun,9999,0,9999,0
1668217462042,CSE 293,043,119540,Weibel; Nadir,9999,0,9999,0
1668217462042,CSE 293,044,119541,Gupta; Rajesh K.,9999,0,9999,0
1668217462042,CSE 293,045,126410,Vaccaro; Kristen Marie,9999,0,9999,0
1668217462042,CSE 293,046,126411,Klemke; Richard,9999,0,9999,0
1668217462465,CSE 294,A00,102459,Voelker; Geoffrey M.,0,0,0,0
1668217462465,CSE 294,B00,111322,Orailoglu; Alex,0,0,0,0
1668217462887,DSE 201,A00,096914,Deutsch; Alin Bernard,30,0,30,0
1668217463318,DSE 210,A00,096915,Dasgupta; Sanjoy,30,0,30,0
1668217463743,DSE 260A,A00,096916,Altintas De Callaf; Ilkay,30,0,30,0
1668217464173,ECE 200,001,103586,Antipa; Nicholas A,9999,0,9999,0
1668217464173,ECE 200,002,103587,Atanasov; Nikolay A.,9999,0,9999,0
1668217464173,ECE 200,003,103588,Bharadia; Dinesh,9999,0,9999,0
1668217464173,ECE 200,004,103589,Cheng; Chung Kuan,9999,0,9999,0
1668217464173,ECE 200,005,103590,Cosman; Pamela C.,9999,0,9999,0
1668217464173,ECE 200,006,103591,Dayeh; Shadi Ahmad,9999,0,9999,0
1668217464173,ECE 200,007,103592,Fainman; Yeshaiahu,9999,0,9999,0
1668217464173,ECE 200,008,103593,Ford; Joseph Earl,9999,0,9999,0
1668217464173,ECE 200,009,103594,Franceschetti; Massimo,9999,0,9999,0
1668217464173,ECE 200,010,103595,Fullerton; Eric E,9999,0,9999,0
1668217464173,ECE 200,011,103596,Galton; Ian A,9999,0,9999,0
1668217464173,ECE 200,012,103597,Gilja; Vikash,9999,0,9999,0
1668217464173,ECE 200,013,103598,Hall; Drew A.,9999,0,9999,0
1668217464173,ECE 200,014,103599,Hsueh; Tzu-Chien,9999,0,9999,0
1668217464173,ECE 200,015,103600,Javidi; Tara,9999,0,9999,0
1668217464173,ECE 200,016,103601,Kahng; Andrew Byun,9999,0,9999,0
1668217464173,ECE 200,017,103602,Kim; Young-Han,9999,0,9999,0
1668217464173,ECE 200,018,103603,Koushanfar; Farinaz,9999,0,9999,0
1668217464173,ECE 200,019,103604,Kuzum; Duygu,9999,0,9999,0
1668217464173,ECE 200,020,103605,Le; Hanh-Phuc,9999,0,9999,0
1668217464173,ECE 200,021,103606,Lin; Bill,9999,0,9999,0
1668217464173,ECE 200,022,103607,Liu; Zhaowei,9998,0,9999,1
1668217464173,ECE 200,023,103608,Lo; Yu-Hwa,9999,0,9999,0
1668217464173,ECE 200,024,103609,Lomakin; Vitaliy,9999,0,9999,0
1668217464173,ECE 200,025,103610,Mercier; Patrick Philip,9999,0,9999,0
1668217464173,ECE 200,026,103611,Meyer; Florian,9999,0,9999,0
1668217464173,ECE 200,027,103612,Milstein; Laurence B.,9999,0,9999,0
1668217464173,ECE 200,028,103613,Mir Arabbaygi; Siavash,9999,0,9999,0
1668217464173,ECE 200,029,103614,Mookherjea; Shayan,9999,0,9999,0
1668217464173,ECE 200,030,103615,Morris; Karcher William,9999,0,9999,0
1668217464173,ECE 200,031,103616,Ng; Tse Nga,9999,0,9999,0
1668217464173,ECE 200,032,103617,Nguyen; Truong Quang,9999,0,9999,0
1668217464173,ECE 200,033,103618,Nomura; Kenji,9999,0,9999,0
1668217464173,ECE 200,034,103619,Orlitsky; Alon,9999,0,9999,0
1668217464173,ECE 200,035,103620,Pal; Piya,9999,0,9999,0
1668217464173,ECE 200,036,103621,Papen; George C.,9999,0,9999,0
1668217464173,ECE 200,037,103622,Radic; Stojan,9999,0,9999,0
1668217464173,ECE 200,038,103623,Rao; Bhaskar D.,9999,0,9999,0
1668217464173,ECE 200,039,103624,Rao; Ramesh R,9999,0,9999,0
1668217464173,ECE 200,040,103625,Rebeiz; Gabriel,9999,0,9999,0
1668217464173,ECE 200,041,103626,Sanford; John R,9999,0,9999,0
1668217464173,ECE 200,042,103627,Siegel; Paul H.,9999,0,9999,0
1668217464173,ECE 200,043,103628,Sievenpiper; Daniel F.,9999,0,9999,0
1668217464173,ECE 200,044,103629,Sworder; David D.,9999,0,9999,0
1668217464173,ECE 200,045,103630,Taur; Yuan,9999,0,9999,0
1668217464173,ECE 200,046,103631,Touri; Behrouz,9999,0,9999,0
1668217464173,ECE 200,047,103632,Trivedi; Mohan M.,9999,0,9999,0
1668217464173,ECE 200,048,103633,Vasconcelos; Nuno,9999,0,9999,0
1668217464173,ECE 200,049,103634,Wang; Xiaolong,9999,0,9999,0
1668217464173,ECE 200,050,103635,Xie; Pengtao,9999,0,9999,0
1668217464173,ECE 200,051,103636,Yip; Michael,9999,0,9999,0
1668217464173,ECE 200,052,103637,Zeger; Kenneth A.,999,0,999,0
1668217464173,ECE 200,053,103638,Zhang; Xinyu,9999,0,9999,0
1668217464173,ECE 200,054,103639,Turakhia; Yatish Girish,9999,0,9999,0
1668217464173,ECE 200,055,103640,Kang; Mingu,9999,0,9999,0
1668217464173,ECE 200,056,103641,Shi; Yuanyuan,9999,0,9999,0
1668217464173,ECE 200,057,103642,Wang; Edward Jay,9999,0,9999,0
1668217464173,ECE 200,058,103643,Zheng; Yang,9999,0,9999,0
1668217464611,ECE 202,A00,103644,Kuzum; Duygu,0,0,0,0
1668217465047,ECE 212BN,A00,103646,Ng; Tse Nga,0,0,0,0
1668217465471,ECE 221,A00,111493,Staff,0,0,0,0
1668217465896,ECE 222B,A00,103647,Lomakin; Vitaliy,0,0,0,0
1668217466324,ECE 230B,A00,103648,Taur; Yuan,0,0,0,0
1668217466748,ECE 238B,A00,103649,Garay; Javier,0,0,0,0
1668217467174,ECE 240B,A00,112900,Fainman; Yeshaiahu,0,0,0,0
1668217467597,ECE 247A,A00,103650,Jokerst; Jesse Vincent,0,0,0,0
1668217468020,ECE 247B,A00,103651,Wang; Joseph,0,0,0,0
1668217468448,ECE 250,A00,103652,Siegel; Paul H.,0,0,0,0
1668217468872,ECE 251A,A00,103654,Rao; Bhaskar D.,0,0,0,0
1668217469302,ECE 257B,A00,103655,Bharadia; Dinesh,0,0,0,0
1668217469726,ECE 258A,A00,103656,Milstein; Laurence B.,0,0,0,0
1668217470151,ECE 260B,A00,103658,Kang; Mingu,0,0,0,0
1668217470579,ECE 264A,A00,103659,Galton; Ian A,0,0,0,0
1668217471032,ECE 265A,A00,103661,Gudem; Prasad S.S.,0,0,0,0
1668217471458,ECE 265D,A00,103662,Gudem; Prasad S.S.,0,0,0,0
1668217471885,ECE 268,A00,103663,Koushanfar; Farinaz,0,0,0,0
1668217472315,ECE 269,A01,103665,Pal; Piya,0,0,0,0
1668217472744,ECE 271B,A00,103666,Vasconcelos; Manuela,0,0,0,0
1668217473169,ECE 276A,A00,103667,Atanasov; Nikolay A.,0,0,0,0
1668217473592,ECE 277,A00,103668,An; Cheolhong,0,0,0,0
1668217474016,ECE 279,A00,117947,Hall; Drew A.,0,0,0,0
1668217474882,ECE 283,A00,103670,Hsueh; Tzu-Chien,0,0,0,0
1668217475319,ECE 284,A00,103671,Turakhia; Yatish Girish,0,0,0,0
1668217475755,ECE 285,A00,103672,Zheng; Yang,0,0,0,0
1668217475755,ECE 285,B00,103673,Sworder; David D.,0,0,0,0
1668217476181,ECE 287,A00,103676,Javidi; Tara,0,0,0,0
1668217476604,MATH 200B,A00,098023,Salehi Golsefidy; Alireza,12,0,15,3
1668217477029,MATH 202B,A00,098024,Rhoades; Brendon Patrick,9,0,15,6
1668217477459,MATH 203B,A00,098025,Oprea; Dragos N.,10,0,15,5
1668217477884,MATH 204B,A00,098026,Sorensen; Claus M,13,0,15,2
1668217478309,MATH 208,A00,098027,Izadi; Elham,7,0,10,3
1668217478734,MATH 209,A00,098028,Pollack; Aaron,10,0,10,0
1668217479231,MATH 211A,A00,112919,Rogalski; Daniel,9,0,10,1
1668217479658,MATH 211B,A00,112920,Seward; Brandon M.,9,0,10,1
1668217480082,MATH 218,A00,098029,Li; Bo,10,0,10,0
1668217480511,MATH 220B,A00,098030,Novak; Jonathan I,11,0,15,4
1668217480939,MATH 221A,A00,098031,Ebenfelt; Peter F,13,0,15,2
1668217481371,MATH 231B,A00,098032,Zlatos; Andrej,12,0,15,3
1668217481797,MATH 240B,A00,098033,Ni; Lei,9,0,15,6
1668217482227,MATH 243,A00,098034,Jekel; David Andrew,10,0,10,0
1668217482653,MATH 245A,A00,098035,Nie; Jiawang,0,0,15,16
1668217483078,MATH 248,A00,098036,Bejenaru; Ioan,10,0,10,0
1668217483505,MATH 250B,A00,098037,Spolaor; Luca,14,0,15,1
1668217483931,MATH 258,A00,098038,Ni; Lei,10,0,10,0
1668217484354,MATH 264B,A00,098041,Rhoades; Brendon Patrick,9,0,15,6
1668217484777,MATH 268,A00,098042,Buss; Samuel R,10,0,10,0
1668217485201,MATH 269,A00,098043,Rhoades; Brendon Patrick,10,0,10,0
1668217485622,MATH 270B,A00,098044,Li; Bo,10,0,15,5
1668217486050,MATH 272B,A00,098045,Holst; Michael J,13,0,15,2
1668217486473,MATH 273A,A00,098046,Tian; Xiaochuan,10,0,15,5
1668217486899,MATH 275,A01,098048,Tian; Xiaochuan,6,0,10,4
1668217487321,MATH 278A,A00,098049,Holst; Michael J,8,0,10,2
1668217487750,MATH 278B,A00,098050,Cloninger; Alexander,10,0,10,0
1668217488177,MATH 278C,A00,098051,Nie; Jiawang,7,0,10,3
1668217488600,MATH 280B,A00,098052,Zheng; Tianyi,10,0,15,5
1668217489034,MATH 281B,A00,098053,Bradic; Jelena,2,0,15,13
1668217489457,MATH 282B,A00,098054,Arias-Castro; Ery,0,0,15,15
1668217489883,MATH 285,A00,098055,Fitzsimmons; Patrick J,0,0,15,17
1668217490310,MATH 287B,A00,098056,Arias-Castro; Ery,2,0,15,13
1668217490734,MATH 288,A00,098057,Agarwal; Pooja,9,0,10,1
1668217490734,MATH 288,B00,098058,Zhang; Danna,8,0,10,2
1668217490734,MATH 288,C00,098059,Williams; Ruth J,10,0,10,0
1668217491159,MATH 290B,A00,098060,Roberts; Justin Deritter,13,0,15,2
1668217491582,MATH 292,A00,098061,Belmont; Eva Kinoshita,10,0,10,0
1668217492008,MATH 295,A00,098062,Suk; Andrew Hoon,48,0,50,2
1668217492430,MATH 296,A00,098063,Novak; Jonathan I,20,0,20,0
1668217492853,MATH 297,001,098064,Gamst; Anthony Collins,9997,0,9999,2
1668218014234,COGS 205,A00,101395,Chiba; Andrea,19,0,20,1
1668218014658,COGS 210B,001,101404,Greene; Deanna Jacquelyn,9998,0,9999,1
1668218014658,COGS 210B,002,101417,Xia; Haijun,9999,0,9999,0
1668218014658,COGS 210B,003,101422,Nitz; Douglas A.,9999,0,9999,0
1668218014658,COGS 210B,004,101423,Hollan; James D.,9998,0,9999,1
1668218014658,COGS 210B,005,101424,Deak; Gedeon O.,9998,0,9999,1
1668218014658,COGS 210B,006,101425,Rossano; Federico,9999,0,9999,0
1668218015084,COGS 211B,A00,101427,Coulson; Seana M,9996,0,9999,3
1668218015512,COGS 220,A00,101428,Hollan; James D.,0,0,25,25
1668218015942,COGS 229,A00,101429,Dow; Steven P,18,0,25,7
1668218016367,COGS 230,A00,101430,Klemmer; Scott R,12,0,17,5
1668218016793,COGS 234,A00,101431,Xia; Haijun,2,0,25,23
1668218017218,COGS 260,A00,101432,Kiyonaga; Anastasia,21,0,25,4
1668218017218,COGS 260,B00,101433,Kirsh; David Joel,15,0,25,10
1668218017662,CSE 202,A00,102371,Impagliazzo; Russell,0,0,0,0
1668218018087,CSE 203B,A01,102373,Cheng; Chung Kuan,0,0,0,0
1668218018526,CSE 208,A00,102374,Micciancio; Daniele,0,0,0,0
1668218018951,CSE 209A,A00,112895,Impagliazzo; Russell,0,0,15,15
1668218019373,CSE 209B,A00,108005,Bellare; Mihir,0,0,0,0
1668218019794,CSE 210,A00,113163,Coblenz; Michael J,0,0,0,0
1668218020222,CSE 219,A00,106111,Dow; Steven P,0,0,20,20
1668218020739,CSE 221,A00,102376,Voelker; Geoffrey M.,0,0,0,0
1668218021163,CSE 224,A01,102378,Porter; George M,0,0,0,0
1668218021595,CSE 229A,A00,102379,Savage; Stefan,0,0,0,0
1668218022021,CSE 229C,A00,102380,Munyaka; Imani N. S.,0,0,0,0
1668218022447,CSE 232B,A00,102382,Deutsch; Alin Bernard,0,0,0,0
1668218022874,CSE 234,A01,112904,Kumar; Arun Kumar,0,0,0,0
1668218023298,CSE 237A,A00,102383,Rosing; Tajana Simunic,0,0,0,0
1668218023722,CSE 239A,A00,102384,Deutsch; Alin Bernard,0,0,0,0
1668218024147,CSE 239B,A00,102385,Polikarpova; Nadezhda,0,0,0,0
1668218024570,CSE 240A,A00,102386,Pannuto; Patrick William,0,0,0,0
1668218024991,CSE 240B,A00,102387,Zhao; Jishen,0,0,0,0
1668218025416,CSE 241A,A00,106406,Kang; Mingu,0,0,0,0
1668218025855,CSE 249B,A00,102388,Kahng; Andrew Byun,0,0,8,8
1668218026287,CSE 251B,A01,102392,Cottrell; Garrison W,0,0,0,0
1668218026287,CSE 251B,A02,102393,Cottrell; Garrison W,0,0,0,0
1668218026717,CSE 252B,A00,102394,Ochoa; Benjamin Lawrence,0,0,0,0
1668218027141,CSE 257,A01,102396,Gao; Sicun,0,0,0,0
1668218027569,CSE 272,A00,102397,Li; Tzumao,0,0,0,0
1668218027994,CSE 274,A00,111323,Chern; Albert Ren-Haur,0,0,0,0
1668218028417,CSE 282,A00,102398,Pevzner; Pavel Arkadjevich,0,0,0,0
1668218028846,CSE 284,A00,114175,Gymrek; Melissa Ann,0,0,0,0
1668218029273,CSE 290,A00,102399,Chandraker; Manmohan Krishna,0,0,0,0
1668218029273,CSE 290,B00,102400,Vaccaro; Kristen Marie,0,0,25,25
1668218029273,CSE 290,C00,102414,Pannuto; Patrick William,0,0,25,25
1668218029273,CSE 290,D00,102427,Pevzner; Pavel Arkadjevich,0,0,0,0
1668218029273,CSE 290,E00,102429,Zhao; Jishen,0,0,0,0
1668218029273,CSE 290,F00,102436,Tullsen; Dean Michael,0,0,0,0
1668218029273,CSE 290,G00,102440,Christensen; Henrik I,0,0,20,20
1668218029698,CSE 291,A00,102443,Su; Hao,0,0,0,0
1668218029698,CSE 291,B00,102448,Polikarpova; Nadezhda,0,0,0,0
1668218029698,CSE 291,C00,102453,Vaccaro; Kristen Marie,0,0,0,0
1668218029698,CSE 291,D00,111343,Savage; Stefan,0,0,0,0
1668218029698,CSE 291,E00,116474,Claffy; Kimberly Claire,0,0,0,0
1668218029698,CSE 291,F00,116479,Pasquale; Joseph,0,0,0,0
1668218030153,CSE 293,001,119111,Bafna; Vineet,9999,0,9999,0
1668218030153,CSE 293,002,119118,Bellare; Mihir,9999,0,9999,0
1668218030153,CSE 293,003,119122,Berg-Kirkpatrick; Taylor D,9999,0,9999,0
1668218030153,CSE 293,004,119135,Christensen; Henrik I,9999,0,9999,0
1668218030153,CSE 293,005,119142,Cottrell; Garrison W,9999,0,9999,0
1668218030153,CSE 293,006,119146,Deutsch; Alin Bernard,9999,0,9999,0
1668218030153,CSE 293,007,119159,Esmaeilzadeh; Hadi,9999,0,9999,0
1668218030153,CSE 293,008,119166,Freund; Yoav,9999,0,9999,0
1668218030153,CSE 293,009,119170,Griswold; William G.,9999,0,9999,0
1668218030153,CSE 293,010,119183,Gymrek; Melissa Ann,9999,0,9999,0
1668218030153,CSE 293,011,119190,Heninger; Nadia A,9999,0,9999,0
1668218030153,CSE 293,012,119230,Impagliazzo; Russell,9999,0,9999,0
1668218030153,CSE 293,013,119232,Jhala; Ranjit,9999,0,9999,0
1668218030153,CSE 293,014,119233,Kahng; Andrew Byun,9999,0,9999,0
1668218030153,CSE 293,015,119298,Kane; Daniel Mertz,9999,0,9999,0
1668218030153,CSE 293,016,119299,Kriegman; David J,9999,0,9999,0
1668218030153,CSE 293,017,119300,Kumar; Arun Kumar,9999,0,9999,0
1668218030153,CSE 293,018,119301,Lerner; Sorin,9999,0,9999,0
1668218030153,CSE 293,019,119302,Lovett; Shachar,9999,0,9999,0
1668218030153,CSE 293,020,119303,McAuley; Julian John,9999,0,9999,0
1668218030153,CSE 293,021,119304,Micciancio; Daniele,9999,0,9999,0
1668218030153,CSE 293,022,119367,Orailoglu; Alex,9999,0,9999,0
1668218030153,CSE 293,023,119382,Paturi; Ramamohan,9999,0,9999,0
1668218030153,CSE 293,024,119404,Polikarpova; Nadezhda,9999,0,9999,0
1668218030153,CSE 293,025,119406,Politz; Joseph Gibbs,9999,0,9999,0
1668218030153,CSE 293,026,119411,Porter; George M,9999,0,9999,0
1668218030153,CSE 293,027,119414,Porter; Leonard Emerson,9999,0,9999,0
1668218030153,CSE 293,028,119416,Ramamoorthi; Ravi,9999,0,9999,0
1668218030153,CSE 293,029,119417,Sahoo; Debashis,9999,0,9999,0
1668218030153,CSE 293,030,119420,Saul; Lawrence,9999,0,9999,0
1668218030153,CSE 293,031,119421,Savage; Stefan,9999,0,9999,0
1668218030153,CSE 293,032,119425,Schulze; Jurgen P.,9999,0,9999,0
1668218030153,CSE 293,033,119426,Snoeren; Alex C.,9999,0,9999,0
1668218030153,CSE 293,034,119428,Shang; Jingbo,9999,0,9999,0
1668218030153,CSE 293,035,119430,Stefan; Deian,9999,0,9999,0
1668218030153,CSE 293,036,119431,Su; Hao,9999,0,9999,0
1668218030153,CSE 293,037,119433,Swanson; Steven James,9999,0,9999,0
1668218030153,CSE 293,038,119435,Tullsen; Dean Michael,9999,0,9999,0
1668218030153,CSE 293,039,119483,Voelker; Geoffrey M.,9999,0,9999,0
1668218030153,CSE 293,040,119537,Zhao; Jishen,9999,0,9999,0
1668218030153,CSE 293,041,119538,Zhou; Yuan-Yuan,9999,0,9999,0
1668218030153,CSE 293,042,119539,Gao; Sicun,9999,0,9999,0
1668218030153,CSE 293,043,119540,Weibel; Nadir,9999,0,9999,0
1668218030153,CSE 293,044,119541,Gupta; Rajesh K.,9999,0,9999,0
1668218030153,CSE 293,045,126410,Vaccaro; Kristen Marie,9999,0,9999,0
1668218030153,CSE 293,046,126411,Klemke; Richard,9999,0,9999,0
1668218030575,CSE 294,A00,102459,Voelker; Geoffrey M.,0,0,0,0
1668218030575,CSE 294,B00,111322,Orailoglu; Alex,0,0,0,0
1668218030999,DSE 201,A00,096914,Deutsch; Alin Bernard,30,0,30,0
1668218031429,DSE 210,A00,096915,Dasgupta; Sanjoy,30,0,30,0
1668218031863,DSE 260A,A00,096916,Altintas De Callaf; Ilkay,30,0,30,0
1668218032308,ECE 200,001,103586,Antipa; Nicholas A,9999,0,9999,0
1668218032308,ECE 200,002,103587,Atanasov; Nikolay A.,9999,0,9999,0
1668218032308,ECE 200,003,103588,Bharadia; Dinesh,9999,0,9999,0
1668218032308,ECE 200,004,103589,Cheng; Chung Kuan,9999,0,9999,0
1668218032308,ECE 200,005,103590,Cosman; Pamela C.,9999,0,9999,0
1668218032308,ECE 200,006,103591,Dayeh; Shadi Ahmad,9999,0,9999,0
1668218032308,ECE 200,007,103592,Fainman; Yeshaiahu,9999,0,9999,0
1668218032308,ECE 200,008,103593,Ford; Joseph Earl,9999,0,9999,0
1668218032308,ECE 200,009,103594,Franceschetti; Massimo,9999,0,9999,0
1668218032308,ECE 200,010,103595,Fullerton; Eric E,9999,0,9999,0
1668218032308,ECE 200,011,103596,Galton; Ian A,9999,0,9999,0
1668218032308,ECE 200,012,103597,Gilja; Vikash,9999,0,9999,0
1668218032308,ECE 200,013,103598,Hall; Drew A.,9999,0,9999,0
1668218032308,ECE 200,014,103599,Hsueh; Tzu-Chien,9999,0,9999,0
1668218032308,ECE 200,015,103600,Javidi; Tara,9999,0,9999,0
1668218032308,ECE 200,016,103601,Kahng; Andrew Byun,9999,0,9999,0
1668218032308,ECE 200,017,103602,Kim; Young-Han,9999,0,9999,0
1668218032308,ECE 200,018,103603,Koushanfar; Farinaz,9999,0,9999,0
1668218032308,ECE 200,019,103604,Kuzum; Duygu,9999,0,9999,0
1668218032308,ECE 200,020,103605,Le; Hanh-Phuc,9999,0,9999,0
1668218032308,ECE 200,021,103606,Lin; Bill,9999,0,9999,0
1668218032308,ECE 200,022,103607,Liu; Zhaowei,9998,0,9999,1
1668218032308,ECE 200,023,103608,Lo; Yu-Hwa,9999,0,9999,0
1668218032308,ECE 200,024,103609,Lomakin; Vitaliy,9999,0,9999,0
1668218032308,ECE 200,025,103610,Mercier; Patrick Philip,9999,0,9999,0
1668218032308,ECE 200,026,103611,Meyer; Florian,9999,0,9999,0
1668218032308,ECE 200,027,103612,Milstein; Laurence B.,9999,0,9999,0
1668218032308,ECE 200,028,103613,Mir Arabbaygi; Siavash,9999,0,9999,0
1668218032308,ECE 200,029,103614,Mookherjea; Shayan,9999,0,9999,0
1668218032308,ECE 200,030,103615,Morris; Karcher William,9999,0,9999,0
1668218032308,ECE 200,031,103616,Ng; Tse Nga,9999,0,9999,0
1668218032308,ECE 200,032,103617,Nguyen; Truong Quang,9999,0,9999,0
1668218032308,ECE 200,033,103618,Nomura; Kenji,9999,0,9999,0
1668218032308,ECE 200,034,103619,Orlitsky; Alon,9999,0,9999,0
1668218032308,ECE 200,035,103620,Pal; Piya,9999,0,9999,0
1668218032308,ECE 200,036,103621,Papen; George C.,9999,0,9999,0
1668218032308,ECE 200,037,103622,Radic; Stojan,9999,0,9999,0
1668218032308,ECE 200,038,103623,Rao; Bhaskar D.,9999,0,9999,0
1668218032308,ECE 200,039,103624,Rao; Ramesh R,9999,0,9999,0
1668218032308,ECE 200,040,103625,Rebeiz; Gabriel,9999,0,9999,0
1668218032308,ECE 200,041,103626,Sanford; John R,9999,0,9999,0
1668218032308,ECE 200,042,103627,Siegel; Paul H.,9999,0,9999,0
1668218032308,ECE 200,043,103628,Sievenpiper; Daniel F.,9999,0,9999,0
1668218032308,ECE 200,044,103629,Sworder; David D.,9999,0,9999,0
1668218032308,ECE 200,045,103630,Taur; Yuan,9999,0,9999,0
1668218032308,ECE 200,046,103631,Touri; Behrouz,9999,0,9999,0
1668218032308,ECE 200,047,103632,Trivedi; Mohan M.,9999,0,9999,0
1668218032308,ECE 200,048,103633,Vasconcelos; Nuno,9999,0,9999,0
1668218032308,ECE 200,049,103634,Wang; Xiaolong,9999,0,9999,0
1668218032308,ECE 200,050,103635,Xie; Pengtao,9999,0,9999,0
1668218032308,ECE 200,051,103636,Yip; Michael,9999,0,9999,0
1668218032308,ECE 200,052,103637,Zeger; Kenneth A.,999,0,999,0
1668218032308,ECE 200,053,103638,Zhang; Xinyu,9999,0,9999,0
1668218032308,ECE 200,054,103639,Turakhia; Yatish Girish,9999,0,9999,0
1668218032308,ECE 200,055,103640,Kang; Mingu,9999,0,9999,0
1668218032308,ECE 200,056,103641,Shi; Yuanyuan,9999,0,9999,0
1668218032308,ECE 200,057,103642,Wang; Edward Jay,9999,0,9999,0
1668218032308,ECE 200,058,103643,Zheng; Yang,9999,0,9999,0
1668218032742,ECE 202,A00,103644,Kuzum; Duygu,0,0,0,0
1668218033171,ECE 212BN,A00,103646,Ng; Tse Nga,0,0,0,0
1668218033598,ECE 221,A00,111493,Staff,0,0,0,0
1668218034028,ECE 222B,A00,103647,Lomakin; Vitaliy,0,0,0,0
1668218034454,ECE 230B,A00,103648,Taur; Yuan,0,0,0,0
1668218034890,ECE 238B,A00,103649,Garay; Javier,0,0,0,0
1668218035316,ECE 240B,A00,112900,Fainman; Yeshaiahu,0,0,0,0
1668218035740,ECE 247A,A00,103650,Jokerst; Jesse Vincent,0,0,0,0
1668218036169,ECE 247B,A00,103651,Wang; Joseph,0,0,0,0
1668218036594,ECE 250,A00,103652,Siegel; Paul H.,0,0,0,0
1668218037018,ECE 251A,A00,103654,Rao; Bhaskar D.,0,0,0,0
1668218037454,ECE 257B,A00,103655,Bharadia; Dinesh,0,0,0,0
1668218037878,ECE 258A,A00,103656,Milstein; Laurence B.,0,0,0,0
1668218038306,ECE 260B,A00,103658,Kang; Mingu,0,0,0,0
1668218038730,ECE 264A,A00,103659,Galton; Ian A,0,0,0,0
1668218039155,ECE 265A,A00,103661,Gudem; Prasad S.S.,0,0,0,0
1668218039579,ECE 265D,A00,103662,Gudem; Prasad S.S.,0,0,0,0
1668218040003,ECE 268,A00,103663,Koushanfar; Farinaz,0,0,0,0
1668218040445,ECE 269,A01,103665,Pal; Piya,0,0,0,0
1668218040875,ECE 271B,A00,103666,Vasconcelos; Manuela,0,0,0,0
1668218041297,ECE 276A,A00,103667,Atanasov; Nikolay A.,0,0,0,0
1668218041721,ECE 277,A00,103668,An; Cheolhong,0,0,0,0
1668218042151,ECE 279,A00,117947,Hall; Drew A.,0,0,0,0
1668218043007,ECE 283,A00,103670,Hsueh; Tzu-Chien,0,0,0,0
1668218043444,ECE 284,A00,103671,Turakhia; Yatish Girish,0,0,0,0
1668218043869,ECE 285,A00,103672,Zheng; Yang,0,0,0,0
1668218043869,ECE 285,B00,103673,Sworder; David D.,0,0,0,0
1668218044292,ECE 287,A00,103676,Javidi; Tara,0,0,0,0
1668218044717,MATH 200B,A00,098023,Salehi Golsefidy; Alireza,12,0,15,3
1668218045144,MATH 202B,A00,098024,Rhoades; Brendon Patrick,9,0,15,6
1668218045565,MATH 203B,A00,098025,Oprea; Dragos N.,10,0,15,5
1668218045997,MATH 204B,A00,098026,Sorensen; Claus M,13,0,15,2
1668218046424,MATH 208,A00,098027,Izadi; Elham,7,0,10,3
1668218046855,MATH 209,A00,098028,Pollack; Aaron,10,0,10,0
1668218047279,MATH 211A,A00,112919,Rogalski; Daniel,9,0,10,1
1668218047725,MATH 211B,A00,112920,Seward; Brandon M.,9,0,10,1
1668218048150,MATH 218,A00,098029,Li; Bo,10,0,10,0
1668218048582,MATH 220B,A00,098030,Novak; Jonathan I,11,0,15,4
1668218049009,MATH 221A,A00,098031,Ebenfelt; Peter F,13,0,15,2
1668218049434,MATH 231B,A00,098032,Zlatos; Andrej,12,0,15,3
1668218049861,MATH 240B,A00,098033,Ni; Lei,9,0,15,6
1668218050287,MATH 243,A00,098034,Jekel; David Andrew,10,0,10,0
1668218050715,MATH 245A,A00,098035,Nie; Jiawang,0,0,15,16
1668218051139,MATH 248,A00,098036,Bejenaru; Ioan,10,0,10,0
1668218051562,MATH 250B,A00,098037,Spolaor; Luca,14,0,15,1
1668218051991,MATH 258,A00,098038,Ni; Lei,10,0,10,0
1668218052417,MATH 264B,A00,098041,Rhoades; Brendon Patrick,9,0,15,6
1668218052847,MATH 268,A00,098042,Buss; Samuel R,10,0,10,0
1668218053272,MATH 269,A00,098043,Rhoades; Brendon Patrick,10,0,10,0
1668218053699,MATH 270B,A00,098044,Li; Bo,10,0,15,5
1668218054123,MATH 272B,A00,098045,Holst; Michael J,13,0,15,2
1668218054549,MATH 273A,A00,098046,Tian; Xiaochuan,10,0,15,5
1668218054982,MATH 275,A01,098048,Tian; Xiaochuan,6,0,10,4
1668218055407,MATH 278A,A00,098049,Holst; Michael J,8,0,10,2
1668218055830,MATH 278B,A00,098050,Cloninger; Alexander,10,0,10,0
1668218056255,MATH 278C,A00,098051,Nie; Jiawang,7,0,10,3
1668218056680,MATH 280B,A00,098052,Zheng; Tianyi,10,0,15,5
1668218057103,MATH 281B,A00,098053,Bradic; Jelena,2,0,15,13
1668218057536,MATH 282B,A00,098054,Arias-Castro; Ery,0,0,15,15
1668218057965,MATH 285,A00,098055,Fitzsimmons; Patrick J,0,0,15,17
1668218058392,MATH 287B,A00,098056,Arias-Castro; Ery,2,0,15,13
1668218058819,MATH 288,A00,098057,Agarwal; Pooja,9,0,10,1
1668218058819,MATH 288,B00,098058,Zhang; Danna,8,0,10,2
1668218058819,MATH 288,C00,098059,Williams; Ruth J,10,0,10,0
1668218059245,MATH 290B,A00,098060,Roberts; Justin Deritter,13,0,15,2
1668218059673,MATH 292,A00,098061,Belmont; Eva Kinoshita,10,0,10,0
1668218060097,MATH 295,A00,098062,Suk; Andrew Hoon,48,0,50,2
1668218060534,MATH 296,A00,098063,Novak; Jonathan I,20,0,20,0
1668218060967,MATH 297,001,098064,Gamst; Anthony Collins,9997,0,9999,2
1668218564757,COGS 205,A00,101395,Chiba; Andrea,19,0,20,1
1668218565185,COGS 210B,001,101404,Greene; Deanna Jacquelyn,9998,0,9999,1
1668218565185,COGS 210B,002,101417,Xia; Haijun,9999,0,9999,0
1668218565185,COGS 210B,003,101422,Nitz; Douglas A.,9999,0,9999,0
1668218565185,COGS 210B,004,101423,Hollan; James D.,9998,0,9999,1
1668218565185,COGS 210B,005,101424,Deak; Gedeon O.,9998,0,9999,1
1668218565185,COGS 210B,006,101425,Rossano; Federico,9999,0,9999,0
1668218565610,COGS 211B,A00,101427,Coulson; Seana M,9996,0,9999,3
1668218566034,COGS 220,A00,101428,Hollan; James D.,0,0,25,25
1668218566464,COGS 229,A00,101429,Dow; Steven P,18,0,25,7
1668218566891,COGS 230,A00,101430,Klemmer; Scott R,12,0,17,5
1668218567316,COGS 234,A00,101431,Xia; Haijun,2,0,25,23
1668218567740,COGS 260,A00,101432,Kiyonaga; Anastasia,21,0,25,4
1668218567740,COGS 260,B00,101433,Kirsh; David Joel,15,0,25,10
1668218568167,CSE 202,A00,102371,Impagliazzo; Russell,0,0,0,0
1668218568601,CSE 203B,A01,102373,Cheng; Chung Kuan,0,0,0,0
1668218569025,CSE 208,A00,102374,Micciancio; Daniele,0,0,0,0
1668218569451,CSE 209A,A00,112895,Impagliazzo; Russell,0,0,15,15
1668218569873,CSE 209B,A00,108005,Bellare; Mihir,0,0,0,0
1668218570305,CSE 210,A00,113163,Coblenz; Michael J,0,0,0,0
1668218570730,CSE 219,A00,106111,Dow; Steven P,0,0,20,20
1668218571165,CSE 221,A00,102376,Voelker; Geoffrey M.,0,0,0,0
1668218571592,CSE 224,A01,102378,Porter; George M,0,0,0,0
1668218572018,CSE 229A,A00,102379,Savage; Stefan,0,0,0,0
1668218572446,CSE 229C,A00,102380,Munyaka; Imani N. S.,0,0,0,0
1668218572880,CSE 232B,A00,102382,Deutsch; Alin Bernard,0,0,0,0
1668218573303,CSE 234,A01,112904,Kumar; Arun Kumar,0,0,0,0
1668218573728,CSE 237A,A00,102383,Rosing; Tajana Simunic,0,0,0,0
1668218574156,CSE 239A,A00,102384,Deutsch; Alin Bernard,0,0,0,0
1668218574581,CSE 239B,A00,102385,Polikarpova; Nadezhda,0,0,0,0
1668218575014,CSE 240A,A00,102386,Pannuto; Patrick William,0,0,0,0
1668218575448,CSE 240B,A00,102387,Zhao; Jishen,0,0,0,0
1668218575881,CSE 241A,A00,106406,Kang; Mingu,0,0,0,0
1668218576305,CSE 249B,A00,102388,Kahng; Andrew Byun,0,0,8,8
1668218576728,CSE 251B,A01,102392,Cottrell; Garrison W,0,0,0,0
1668218576728,CSE 251B,A02,102393,Cottrell; Garrison W,0,0,0,0
1668218577157,CSE 252B,A00,102394,Ochoa; Benjamin Lawrence,0,0,0,0
1668218577594,CSE 257,A01,102396,Gao; Sicun,0,0,0,0
1668218578032,CSE 272,A00,102397,Li; Tzumao,0,0,0,0
1668218578475,CSE 274,A00,111323,Chern; Albert Ren-Haur,0,0,0,0
1668218578918,CSE 282,A00,102398,Pevzner; Pavel Arkadjevich,0,0,0,0
1668218579348,CSE 284,A00,114175,Gymrek; Melissa Ann,0,0,0,0
1668218579781,CSE 290,A00,102399,Chandraker; Manmohan Krishna,0,0,0,0
1668218579781,CSE 290,B00,102400,Vaccaro; Kristen Marie,0,0,25,25
1668218579781,CSE 290,C00,102414,Pannuto; Patrick William,0,0,25,25
1668218579781,CSE 290,D00,102427,Pevzner; Pavel Arkadjevich,0,0,0,0
1668218579781,CSE 290,E00,102429,Zhao; Jishen,0,0,0,0
1668218579781,CSE 290,F00,102436,Tullsen; Dean Michael,0,0,0,0
1668218579781,CSE 290,G00,102440,Christensen; Henrik I,0,0,20,20
1668218580205,CSE 291,A00,102443,Su; Hao,0,0,0,0
1668218580205,CSE 291,B00,102448,Polikarpova; Nadezhda,0,0,0,0
1668218580205,CSE 291,C00,102453,Vaccaro; Kristen Marie,0,0,0,0
1668218580205,CSE 291,D00,111343,Savage; Stefan,0,0,0,0
1668218580205,CSE 291,E00,116474,Claffy; Kimberly Claire,0,0,0,0
1668218580205,CSE 291,F00,116479,Pasquale; Joseph,0,0,0,0
1668218580640,CSE 293,001,119111,Bafna; Vineet,9999,0,9999,0
1668218580640,CSE 293,002,119118,Bellare; Mihir,9999,0,9999,0
1668218580640,CSE 293,003,119122,Berg-Kirkpatrick; Taylor D,9999,0,9999,0
1668218580640,CSE 293,004,119135,Christensen; Henrik I,9999,0,9999,0
1668218580640,CSE 293,005,119142,Cottrell; Garrison W,9999,0,9999,0
1668218580640,CSE 293,006,119146,Deutsch; Alin Bernard,9999,0,9999,0
1668218580640,CSE 293,007,119159,Esmaeilzadeh; Hadi,9999,0,9999,0
1668218580640,CSE 293,008,119166,Freund; Yoav,9999,0,9999,0
1668218580640,CSE 293,009,119170,Griswold; William G.,9999,0,9999,0
1668218580640,CSE 293,010,119183,Gymrek; Melissa Ann,9999,0,9999,0
1668218580640,CSE 293,011,119190,Heninger; Nadia A,9999,0,9999,0
1668218580640,CSE 293,012,119230,Impagliazzo; Russell,9999,0,9999,0
1668218580640,CSE 293,013,119232,Jhala; Ranjit,9999,0,9999,0
1668218580640,CSE 293,014,119233,Kahng; Andrew Byun,9999,0,9999,0
1668218580640,CSE 293,015,119298,Kane; Daniel Mertz,9999,0,9999,0
1668218580640,CSE 293,016,119299,Kriegman; David J,9999,0,9999,0
1668218580640,CSE 293,017,119300,Kumar; Arun Kumar,9999,0,9999,0
1668218580640,CSE 293,018,119301,Lerner; Sorin,9999,0,9999,0
1668218580640,CSE 293,019,119302,Lovett; Shachar,9999,0,9999,0
1668218580640,CSE 293,020,119303,McAuley; Julian John,9999,0,9999,0
1668218580640,CSE 293,021,119304,Micciancio; Daniele,9999,0,9999,0
1668218580640,CSE 293,022,119367,Orailoglu; Alex,9999,0,9999,0
1668218580640,CSE 293,023,119382,Paturi; Ramamohan,9999,0,9999,0
1668218580640,CSE 293,024,119404,Polikarpova; Nadezhda,9999,0,9999,0
1668218580640,CSE 293,025,119406,Politz; Joseph Gibbs,9999,0,9999,0
1668218580640,CSE 293,026,119411,Porter; George M,9999,0,9999,0
1668218580640,CSE 293,027,119414,Porter; Leonard Emerson,9999,0,9999,0
1668218580640,CSE 293,028,119416,Ramamoorthi; Ravi,9999,0,9999,0
1668218580640,CSE 293,029,119417,Sahoo; Debashis,9999,0,9999,0
1668218580640,CSE 293,030,119420,Saul; Lawrence,9999,0,9999,0
1668218580640,CSE 293,031,119421,Savage; Stefan,9999,0,9999,0
1668218580640,CSE 293,032,119425,Schulze; Jurgen P.,9999,0,9999,0
1668218580640,CSE 293,033,119426,Snoeren; Alex C.,9999,0,9999,0
1668218580640,CSE 293,034,119428,Shang; Jingbo,9999,0,9999,0
1668218580640,CSE 293,035,119430,Stefan; Deian,9999,0,9999,0
1668218580640,CSE 293,036,119431,Su; Hao,9999,0,9999,0
1668218580640,CSE 293,037,119433,Swanson; Steven James,9999,0,9999,0
1668218580640,CSE 293,038,119435,Tullsen; Dean Michael,9999,0,9999,0
1668218580640,CSE 293,039,119483,Voelker; Geoffrey M.,9999,0,9999,0
1668218580640,CSE 293,040,119537,Zhao; Jishen,9999,0,9999,0
1668218580640,CSE 293,041,119538,Zhou; Yuan-Yuan,9999,0,9999,0
1668218580640,CSE 293,042,119539,Gao; Sicun,9999,0,9999,0
1668218580640,CSE 293,043,119540,Weibel; Nadir,9999,0,9999,0
1668218580640,CSE 293,044,119541,Gupta; Rajesh K.,9999,0,9999,0
1668218580640,CSE 293,045,126410,Vaccaro; Kristen Marie,9999,0,9999,0
1668218580640,CSE 293,046,126411,Klemke; Richard,9999,0,9999,0
1668218581069,CSE 294,A00,102459,Voelker; Geoffrey M.,0,0,0,0
1668218581069,CSE 294,B00,111322,Orailoglu; Alex,0,0,0,0
1668218581502,DSE 201,A00,096914,Deutsch; Alin Bernard,30,0,30,0
1668218581934,DSE 210,A00,096915,Dasgupta; Sanjoy,30,0,30,0
1668218582374,DSE 260A,A00,096916,Altintas De Callaf; Ilkay,30,0,30,0
1668218582805,ECE 200,001,103586,Antipa; Nicholas A,9999,0,9999,0
1668218582805,ECE 200,002,103587,Atanasov; Nikolay A.,9999,0,9999,0
1668218582805,ECE 200,003,103588,Bharadia; Dinesh,9999,0,9999,0
1668218582805,ECE 200,004,103589,Cheng; Chung Kuan,9999,0,9999,0
1668218582805,ECE 200,005,103590,Cosman; Pamela C.,9999,0,9999,0
1668218582805,ECE 200,006,103591,Dayeh; Shadi Ahmad,9999,0,9999,0
1668218582805,ECE 200,007,103592,Fainman; Yeshaiahu,9999,0,9999,0
1668218582805,ECE 200,008,103593,Ford; Joseph Earl,9999,0,9999,0
1668218582805,ECE 200,009,103594,Franceschetti; Massimo,9999,0,9999,0
1668218582805,ECE 200,010,103595,Fullerton; Eric E,9999,0,9999,0
1668218582805,ECE 200,011,103596,Galton; Ian A,9999,0,9999,0
1668218582805,ECE 200,012,103597,Gilja; Vikash,9999,0,9999,0
1668218582805,ECE 200,013,103598,Hall; Drew A.,9999,0,9999,0
1668218582805,ECE 200,014,103599,Hsueh; Tzu-Chien,9999,0,9999,0
1668218582805,ECE 200,015,103600,Javidi; Tara,9999,0,9999,0
1668218582805,ECE 200,016,103601,Kahng; Andrew Byun,9999,0,9999,0
1668218582805,ECE 200,017,103602,Kim; Young-Han,9999,0,9999,0
1668218582805,ECE 200,018,103603,Koushanfar; Farinaz,9999,0,9999,0
1668218582805,ECE 200,019,103604,Kuzum; Duygu,9999,0,9999,0
1668218582805,ECE 200,020,103605,Le; Hanh-Phuc,9999,0,9999,0
1668218582805,ECE 200,021,103606,Lin; Bill,9999,0,9999,0
1668218582805,ECE 200,022,103607,Liu; Zhaowei,9998,0,9999,1
1668218582805,ECE 200,023,103608,Lo; Yu-Hwa,9999,0,9999,0
1668218582805,ECE 200,024,103609,Lomakin; Vitaliy,9999,0,9999,0
1668218582805,ECE 200,025,103610,Mercier; Patrick Philip,9999,0,9999,0
1668218582805,ECE 200,026,103611,Meyer; Florian,9999,0,9999,0
1668218582805,ECE 200,027,103612,Milstein; Laurence B.,9999,0,9999,0
1668218582805,ECE 200,028,103613,Mir Arabbaygi; Siavash,9999,0,9999,0
1668218582805,ECE 200,029,103614,Mookherjea; Shayan,9999,0,9999,0
1668218582805,ECE 200,030,103615,Morris; Karcher William,9999,0,9999,0
1668218582805,ECE 200,031,103616,Ng; Tse Nga,9999,0,9999,0
1668218582805,ECE 200,032,103617,Nguyen; Truong Quang,9999,0,9999,0
1668218582805,ECE 200,033,103618,Nomura; Kenji,9999,0,9999,0
1668218582805,ECE 200,034,103619,Orlitsky; Alon,9999,0,9999,0
1668218582805,ECE 200,035,103620,Pal; Piya,9999,0,9999,0
1668218582805,ECE 200,036,103621,Papen; George C.,9999,0,9999,0
1668218582805,ECE 200,037,103622,Radic; Stojan,9999,0,9999,0
1668218582805,ECE 200,038,103623,Rao; Bhaskar D.,9999,0,9999,0
1668218582805,ECE 200,039,103624,Rao; Ramesh R,9999,0,9999,0
1668218582805,ECE 200,040,103625,Rebeiz; Gabriel,9999,0,9999,0
1668218582805,ECE 200,041,103626,Sanford; John R,9999,0,9999,0
1668218582805,ECE 200,042,103627,Siegel; Paul H.,9999,0,9999,0
1668218582805,ECE 200,043,103628,Sievenpiper; Daniel F.,9999,0,9999,0
1668218582805,ECE 200,044,103629,Sworder; David D.,9999,0,9999,0
1668218582805,ECE 200,045,103630,Taur; Yuan,9999,0,9999,0
1668218582805,ECE 200,046,103631,Touri; Behrouz,9999,0,9999,0
1668218582805,ECE 200,047,103632,Trivedi; Mohan M.,9999,0,9999,0
1668218582805,ECE 200,048,103633,Vasconcelos; Nuno,9999,0,9999,0
1668218582805,ECE 200,049,103634,Wang; Xiaolong,9999,0,9999,0
1668218582805,ECE 200,050,103635,Xie; Pengtao,9999,0,9999,0
1668218582805,ECE 200,051,103636,Yip; Michael,9999,0,9999,0
1668218582805,ECE 200,052,103637,Zeger; Kenneth A.,999,0,999,0
1668218582805,ECE 200,053,103638,Zhang; Xinyu,9999,0,9999,0
1668218582805,ECE 200,054,103639,Turakhia; Yatish Girish,9999,0,9999,0
1668218582805,ECE 200,055,103640,Kang; Mingu,9999,0,9999,0
1668218582805,ECE 200,056,103641,Shi; Yuanyuan,9999,0,9999,0
1668218582805,ECE 200,057,103642,Wang; Edward Jay,9999,0,9999,0
1668218582805,ECE 200,058,103643,Zheng; Yang,9999,0,9999,0
1668218583231,ECE 202,A00,103644,Kuzum; Duygu,0,0,0,0
1668218583665,ECE 212BN,A00,103646,Ng; Tse Nga,0,0,0,0
1668218584088,ECE 221,A00,111493,Staff,0,0,0,0
1668218584511,ECE 222B,A00,103647,Lomakin; Vitaliy,0,0,0,0
1668218584941,ECE 230B,A00,103648,Taur; Yuan,0,0,0,0
1668218585366,ECE 238B,A00,103649,Garay; Javier,0,0,0,0
1668218585791,ECE 240B,A00,112900,Fainman; Yeshaiahu,0,0,0,0
1668218586224,ECE 247A,A00,103650,Jokerst; Jesse Vincent,0,0,0,0
1668218586647,ECE 247B,A00,103651,Wang; Joseph,0,0,0,0
1668218587074,ECE 250,A00,103652,Siegel; Paul H.,0,0,0,0
1668218587498,ECE 251A,A00,103654,Rao; Bhaskar D.,0,0,0,0
1668218587996,ECE 257B,A00,103655,Bharadia; Dinesh,0,0,0,0
1668218588423,ECE 258A,A00,103656,Milstein; Laurence B.,0,0,0,0
1668218588848,ECE 260B,A00,103658,Kang; Mingu,0,0,0,0
1668218589273,ECE 264A,A00,103659,Galton; Ian A,0,0,0,0
1668218589699,ECE 265A,A00,103661,Gudem; Prasad S.S.,0,0,0,0
1668218590137,ECE 265D,A00,103662,Gudem; Prasad S.S.,0,0,0,0
1668218590561,ECE 268,A00,103663,Koushanfar; Farinaz,0,0,0,0
1668218590997,ECE 269,A01,103665,Pal; Piya,0,0,0,0
1668218591423,ECE 271B,A00,103666,Vasconcelos; Manuela,0,0,0,0
1668218591847,ECE 276A,A00,103667,Atanasov; Nikolay A.,0,0,0,0
1668218592273,ECE 277,A00,103668,An; Cheolhong,0,0,0,0
1668218592694,ECE 279,A00,117947,Hall; Drew A.,0,0,0,0
1668218593565,ECE 283,A00,103670,Hsueh; Tzu-Chien,0,0,0,0
1668218594001,ECE 284,A00,103671,Turakhia; Yatish Girish,0,0,0,0
1668218594431,ECE 285,A00,103672,Zheng; Yang,0,0,0,0
1668218594431,ECE 285,B00,103673,Sworder; David D.,0,0,0,0
1668218594879,ECE 287,A00,103676,Javidi; Tara,0,0,0,0
1668218595311,MATH 200B,A00,098023,Salehi Golsefidy; Alireza,12,0,15,3
1668218595742,MATH 202B,A00,098024,Rhoades; Brendon Patrick,9,0,15,6
1668218596173,MATH 203B,A00,098025,Oprea; Dragos N.,10,0,15,5
1668218596598,MATH 204B,A00,098026,Sorensen; Claus M,13,0,15,2
1668218597034,MATH 208,A00,098027,Izadi; Elham,7,0,10,3
1668218597455,MATH 209,A00,098028,Pollack; Aaron,10,0,10,0
1668218597883,MATH 211A,A00,112919,Rogalski; Daniel,9,0,10,1
1668218598320,MATH 211B,A00,112920,Seward; Brandon M.,9,0,10,1
1668218598746,MATH 218,A00,098029,Li; Bo,10,0,10,0
1668218599191,MATH 220B,A00,098030,Novak; Jonathan I,11,0,15,4
1668218599616,MATH 221A,A00,098031,Ebenfelt; Peter F,13,0,15,2
1668218600039,MATH 231B,A00,098032,Zlatos; Andrej,12,0,15,3
1668218600474,MATH 240B,A00,098033,Ni; Lei,9,0,15,6
1668218600897,MATH 243,A00,098034,Jekel; David Andrew,10,0,10,0
1668218601341,MATH 245A,A00,098035,Nie; Jiawang,0,0,15,16
1668218601771,MATH 248,A00,098036,Bejenaru; Ioan,10,0,10,0
1668218602199,MATH 250B,A00,098037,Spolaor; Luca,14,0,15,1
1668218602622,MATH 258,A00,098038,Ni; Lei,10,0,10,0
1668218603049,MATH 264B,A00,098041,Rhoades; Brendon Patrick,9,0,15,6
1668218603484,MATH 268,A00,098042,Buss; Samuel R,10,0,10,0
1668218603907,MATH 269,A00,098043,Rhoades; Brendon Patrick,10,0,10,0
1668218604338,MATH 270B,A00,098044,Li; Bo,10,0,15,5
1668218604764,MATH 272B,A00,098045,Holst; Michael J,13,0,15,2
1668218605189,MATH 273A,A00,098046,Tian; Xiaochuan,10,0,15,5
1668218605615,MATH 275,A01,098048,Tian; Xiaochuan,6,0,10,4
1668218606039,MATH 278A,A00,098049,Holst; Michael J,8,0,10,2
1668218606463,MATH 278B,A00,098050,Cloninger; Alexander,10,0,10,0
1668218606903,MATH 278C,A00,098051,Nie; Jiawang,7,0,10,3
1668218607328,MATH 280B,A00,098052,Zheng; Tianyi,10,0,15,5
1668218607752,MATH 281B,A00,098053,Bradic; Jelena,2,0,15,13
1668218608180,MATH 282B,A00,098054,Arias-Castro; Ery,0,0,15,15
1668218608619,MATH 285,A00,098055,Fitzsimmons; Patrick J,0,0,15,17
1668218609051,MATH 287B,A00,098056,Arias-Castro; Ery,2,0,15,13
1668218609479,MATH 288,A00,098057,Agarwal; Pooja,9,0,10,1
1668218609479,MATH 288,B00,098058,Zhang; Danna,8,0,10,2
1668218609479,MATH 288,C00,098059,Williams; Ruth J,10,0,10,0
1668218609901,MATH 290B,A00,098060,Roberts; Justin Deritter,13,0,15,2
1668218610337,MATH 292,A00,098061,Belmont; Eva Kinoshita,10,0,10,0
1668218610763,MATH 295,A00,098062,Suk; Andrew Hoon,48,0,50,2
1668218611187,MATH 296,A00,098063,Novak; Jonathan I,20,0,20,0
1668218611612,MATH 297,001,098064,Gamst; Anthony Collins,9997,0,9999,2
1668219116597,COGS 205,A00,101395,Chiba; Andrea,19,0,20,1
1668219117020,COGS 210B,001,101404,Greene; Deanna Jacquelyn,9998,0,9999,1
1668219117020,COGS 210B,002,101417,Xia; Haijun,9999,0,9999,0
1668219117020,COGS 210B,003,101422,Nitz; Douglas A.,9999,0,9999,0
1668219117020,COGS 210B,004,101423,Hollan; James D.,9998,0,9999,1
1668219117020,COGS 210B,005,101424,Deak; Gedeon O.,9998,0,9999,1
1668219117020,COGS 210B,006,101425,Rossano; Federico,9999,0,9999,0
1668219117454,COGS 211B,A00,101427,Coulson; Seana M,9996,0,9999,3
1668219117884,COGS 220,A00,101428,Hollan; James D.,0,0,25,25
1668219118329,COGS 229,A00,101429,Dow; Steven P,18,0,25,7
1668219118767,COGS 230,A00,101430,Klemmer; Scott R,12,0,17,5
1668219119189,COGS 234,A00,101431,Xia; Haijun,2,0,25,23
1668219119614,COGS 260,A00,101432,Kiyonaga; Anastasia,21,0,25,4
1668219119614,COGS 260,B00,101433,Kirsh; David Joel,15,0,25,10
1668219120050,CSE 202,A00,102371,Impagliazzo; Russell,0,0,0,0
1668219120488,CSE 203B,A01,102373,Cheng; Chung Kuan,0,0,0,0
1668219120912,CSE 208,A00,102374,Micciancio; Daniele,0,0,0,0
1668219121348,CSE 209A,A00,112895,Impagliazzo; Russell,0,0,15,15
1668219121785,CSE 209B,A00,108005,Bellare; Mihir,0,0,0,0
1668219122219,CSE 210,A00,113163,Coblenz; Michael J,0,0,0,0
1668219122643,CSE 219,A00,106111,Dow; Steven P,0,0,20,20
1668219123072,CSE 221,A00,102376,Voelker; Geoffrey M.,0,0,0,0
1668219123497,CSE 224,A01,102378,Porter; George M,0,0,0,0
1668219123922,CSE 229A,A00,102379,Savage; Stefan,0,0,0,0
1668219124355,CSE 229C,A00,102380,Munyaka; Imani N. S.,0,0,0,0
1668219124822,CSE 232B,A00,102382,Deutsch; Alin Bernard,0,0,0,0
1668219125255,CSE 234,A01,112904,Kumar; Arun Kumar,0,0,0,0
1668219125677,CSE 237A,A00,102383,Rosing; Tajana Simunic,0,0,0,0
1668219126112,CSE 239A,A00,102384,Deutsch; Alin Bernard,0,0,0,0
1668219126546,CSE 239B,A00,102385,Polikarpova; Nadezhda,0,0,0,0
1668219126984,CSE 240A,A00,102386,Pannuto; Patrick William,0,0,0,0
1668219127406,CSE 240B,A00,102387,Zhao; Jishen,0,0,0,0
1668219127831,CSE 241A,A00,106406,Kang; Mingu,0,0,0,0
1668219128263,CSE 249B,A00,102388,Kahng; Andrew Byun,0,0,8,8
1668219128686,CSE 251B,A01,102392,Cottrell; Garrison W,0,0,0,0
1668219128686,CSE 251B,A02,102393,Cottrell; Garrison W,0,0,0,0
1668219129112,CSE 252B,A00,102394,Ochoa; Benjamin Lawrence,0,0,0,0
1668219129543,CSE 257,A01,102396,Gao; Sicun,0,0,0,0
1668219129967,CSE 272,A00,102397,Li; Tzumao,0,0,0,0
1668219130392,CSE 274,A00,111323,Chern; Albert Ren-Haur,0,0,0,0
1668219130817,CSE 282,A00,102398,Pevzner; Pavel Arkadjevich,0,0,0,0
1668219131245,CSE 284,A00,114175,Gymrek; Melissa Ann,0,0,0,0
1668219131670,CSE 290,A00,102399,Chandraker; Manmohan Krishna,0,0,0,0
1668219131670,CSE 290,B00,102400,Vaccaro; Kristen Marie,0,0,25,25
1668219131670,CSE 290,C00,102414,Pannuto; Patrick William,0,0,25,25
1668219131670,CSE 290,D00,102427,Pevzner; Pavel Arkadjevich,0,0,0,0
1668219131670,CSE 290,E00,102429,Zhao; Jishen,0,0,0,0
1668219131670,CSE 290,F00,102436,Tullsen; Dean Michael,0,0,0,0
1668219131670,CSE 290,G00,102440,Christensen; Henrik I,0,0,20,20
1668219132103,CSE 291,A00,102443,Su; Hao,0,0,0,0
1668219132103,CSE 291,B00,102448,Polikarpova; Nadezhda,0,0,0,0
1668219132103,CSE 291,C00,102453,Vaccaro; Kristen Marie,0,0,0,0
1668219132103,CSE 291,D00,111343,Savage; Stefan,0,0,0,0
1668219132103,CSE 291,E00,116474,Claffy; Kimberly Claire,0,0,0,0
1668219132103,CSE 291,F00,116479,Pasquale; Joseph,0,0,0,0
1668219132532,CSE 293,001,119111,Bafna; Vineet,9999,0,9999,0
1668219132532,CSE 293,002,119118,Bellare; Mihir,9999,0,9999,0
1668219132532,CSE 293,003,119122,Berg-Kirkpatrick; Taylor D,9999,0,9999,0
1668219132532,CSE 293,004,119135,Christensen; Henrik I,9999,0,9999,0
1668219132532,CSE 293,005,119142,Cottrell; Garrison W,9999,0,9999,0
1668219132532,CSE 293,006,119146,Deutsch; Alin Bernard,9999,0,9999,0
1668219132532,CSE 293,007,119159,Esmaeilzadeh; Hadi,9999,0,9999,0
1668219132532,CSE 293,008,119166,Freund; Yoav,9999,0,9999,0
1668219132532,CSE 293,009,119170,Griswold; William G.,9999,0,9999,0
1668219132532,CSE 293,010,119183,Gymrek; Melissa Ann,9999,0,9999,0
1668219132532,CSE 293,011,119190,Heninger; Nadia A,9999,0,9999,0
1668219132532,CSE 293,012,119230,Impagliazzo; Russell,9999,0,9999,0
1668219132532,CSE 293,013,119232,Jhala; Ranjit,9999,0,9999,0
1668219132532,CSE 293,014,119233,Kahng; Andrew Byun,9999,0,9999,0
1668219132532,CSE 293,015,119298,Kane; Daniel Mertz,9999,0,9999,0
1668219132532,CSE 293,016,119299,Kriegman; David J,9999,0,9999,0
1668219132532,CSE 293,017,119300,Kumar; Arun Kumar,9999,0,9999,0
1668219132532,CSE 293,018,119301,Lerner; Sorin,9999,0,9999,0
1668219132532,CSE 293,019,119302,Lovett; Shachar,9999,0,9999,0
1668219132532,CSE 293,020,119303,McAuley; Julian John,9999,0,9999,0
1668219132532,CSE 293,021,119304,Micciancio; Daniele,9999,0,9999,0
1668219132532,CSE 293,022,119367,Orailoglu; Alex,9999,0,9999,0
1668219132532,CSE 293,023,119382,Paturi; Ramamohan,9999,0,9999,0
1668219132532,CSE 293,024,119404,Polikarpova; Nadezhda,9999,0,9999,0
1668219132532,CSE 293,025,119406,Politz; Joseph Gibbs,9999,0,9999,0
1668219132532,CSE 293,026,119411,Porter; George M,9999,0,9999,0
1668219132532,CSE 293,027,119414,Porter; Leonard Emerson,9999,0,9999,0
1668219132532,CSE 293,028,119416,Ramamoorthi; Ravi,9999,0,9999,0
1668219132532,CSE 293,029,119417,Sahoo; Debashis,9999,0,9999,0
1668219132532,CSE 293,030,119420,Saul; Lawrence,9999,0,9999,0
1668219132532,CSE 293,031,119421,Savage; Stefan,9999,0,9999,0
1668219132532,CSE 293,032,119425,Schulze; Jurgen P.,9999,0,9999,0
1668219132532,CSE 293,033,119426,Snoeren; Alex C.,9999,0,9999,0
1668219132532,CSE 293,034,119428,Shang; Jingbo,9999,0,9999,0
1668219132532,CSE 293,035,119430,Stefan; Deian,9999,0,9999,0
1668219132532,CSE 293,036,119431,Su; Hao,9999,0,9999,0
1668219132532,CSE 293,037,119433,Swanson; Steven James,9999,0,9999,0
1668219132532,CSE 293,038,119435,Tullsen; Dean Michael,9999,0,9999,0
1668219132532,CSE 293,039,119483,Voelker; Geoffrey M.,9999,0,9999,0
1668219132532,CSE 293,040,119537,Zhao; Jishen,9999,0,9999,0
1668219132532,CSE 293,041,119538,Zhou; Yuan-Yuan,9999,0,9999,0
1668219132532,CSE 293,042,119539,Gao; Sicun,9999,0,9999,0
1668219132532,CSE 293,043,119540,Weibel; Nadir,9999,0,9999,0
1668219132532,CSE 293,044,119541,Gupta; Rajesh K.,9999,0,9999,0
1668219132532,CSE 293,045,126410,Vaccaro; Kristen Marie,9999,0,9999,0
1668219132532,CSE 293,046,126411,Klemke; Richard,9999,0,9999,0
1668219132960,CSE 294,A00,102459,Voelker; Geoffrey M.,0,0,0,0
1668219132960,CSE 294,B00,111322,Orailoglu; Alex,0,0,0,0
1668219133397,DSE 201,A00,096914,Deutsch; Alin Bernard,30,0,30,0
1668219133831,DSE 210,A00,096915,Dasgupta; Sanjoy,30,0,30,0
1668219134255,DSE 260A,A00,096916,Altintas De Callaf; Ilkay,30,0,30,0
1668219134709,ECE 200,001,103586,Antipa; Nicholas A,9999,0,9999,0
1668219134709,ECE 200,002,103587,Atanasov; Nikolay A.,9999,0,9999,0
1668219134709,ECE 200,003,103588,Bharadia; Dinesh,9999,0,9999,0
1668219134709,ECE 200,004,103589,Cheng; Chung Kuan,9999,0,9999,0
1668219134709,ECE 200,005,103590,Cosman; Pamela C.,9999,0,9999,0
1668219134709,ECE 200,006,103591,Dayeh; Shadi Ahmad,9999,0,9999,0
1668219134709,ECE 200,007,103592,Fainman; Yeshaiahu,9999,0,9999,0
1668219134709,ECE 200,008,103593,Ford; Joseph Earl,9999,0,9999,0
1668219134709,ECE 200,009,103594,Franceschetti; Massimo,9999,0,9999,0
1668219134709,ECE 200,010,103595,Fullerton; Eric E,9999,0,9999,0
1668219134709,ECE 200,011,103596,Galton; Ian A,9999,0,9999,0
1668219134709,ECE 200,012,103597,Gilja; Vikash,9999,0,9999,0
1668219134709,ECE 200,013,103598,Hall; Drew A.,9999,0,9999,0
1668219134709,ECE 200,014,103599,Hsueh; Tzu-Chien,9999,0,9999,0
1668219134709,ECE 200,015,103600,Javidi; Tara,9999,0,9999,0
1668219134709,ECE 200,016,103601,Kahng; Andrew Byun,9999,0,9999,0
1668219134709,ECE 200,017,103602,Kim; Young-Han,9999,0,9999,0
1668219134709,ECE 200,018,103603,Koushanfar; Farinaz,9999,0,9999,0
1668219134709,ECE 200,019,103604,Kuzum; Duygu,9999,0,9999,0
1668219134709,ECE 200,020,103605,Le; Hanh-Phuc,9999,0,9999,0
1668219134709,ECE 200,021,103606,Lin; Bill,9999,0,9999,0
1668219134709,ECE 200,022,103607,Liu; Zhaowei,9998,0,9999,1
1668219134709,ECE 200,023,103608,Lo; Yu-Hwa,9999,0,9999,0
1668219134709,ECE 200,024,103609,Lomakin; Vitaliy,9999,0,9999,0
1668219134709,ECE 200,025,103610,Mercier; Patrick Philip,9999,0,9999,0
1668219134709,ECE 200,026,103611,Meyer; Florian,9999,0,9999,0
1668219134709,ECE 200,027,103612,Milstein; Laurence B.,9999,0,9999,0
1668219134709,ECE 200,028,103613,Mir Arabbaygi; Siavash,9999,0,9999,0
1668219134709,ECE 200,029,103614,Mookherjea; Shayan,9999,0,9999,0
1668219134709,ECE 200,030,103615,Morris; Karcher William,9999,0,9999,0
1668219134709,ECE 200,031,103616,Ng; Tse Nga,9999,0,9999,0
1668219134709,ECE 200,032,103617,Nguyen; Truong Quang,9999,0,9999,0
1668219134709,ECE 200,033,103618,Nomura; Kenji,9999,0,9999,0
1668219134709,ECE 200,034,103619,Orlitsky; Alon,9999,0,9999,0
1668219134709,ECE 200,035,103620,Pal; Piya,9999,0,9999,0
1668219134709,ECE 200,036,103621,Papen; George C.,9999,0,9999,0
1668219134709,ECE 200,037,103622,Radic; Stojan,9999,0,9999,0
1668219134709,ECE 200,038,103623,Rao; Bhaskar D.,9999,0,9999,0
1668219134709,ECE 200,039,103624,Rao; Ramesh R,9999,0,9999,0
1668219134709,ECE 200,040,103625,Rebeiz; Gabriel,9999,0,9999,0
1668219134709,ECE 200,041,103626,Sanford; John R,9999,0,9999,0
1668219134709,ECE 200,042,103627,Siegel; Paul H.,9999,0,9999,0
1668219134709,ECE 200,043,103628,Sievenpiper; Daniel F.,9999,0,9999,0
1668219134709,ECE 200,044,103629,Sworder; David D.,9999,0,9999,0
1668219134709,ECE 200,045,103630,Taur; Yuan,9999,0,9999,0
1668219134709,ECE 200,046,103631,Touri; Behrouz,9999,0,9999,0
1668219134709,ECE 200,047,103632,Trivedi; Mohan M.,9999,0,9999,0
1668219134709,ECE 200,048,103633,Vasconcelos; Nuno,9999,0,9999,0
1668219134709,ECE 200,049,103634,Wang; Xiaolong,9999,0,9999,0
1668219134709,ECE 200,050,103635,Xie; Pengtao,9999,0,9999,0
1668219134709,ECE 200,051,103636,Yip; Michael,9999,0,9999,0
1668219134709,ECE 200,052,103637,Zeger; Kenneth A.,999,0,999,0
1668219134709,ECE 200,053,103638,Zhang; Xinyu,9999,0,9999,0
1668219134709,ECE 200,054,103639,Turakhia; Yatish Girish,9999,0,9999,0
1668219134709,ECE 200,055,103640,Kang; Mingu,9999,0,9999,0
1668219134709,ECE 200,056,103641,Shi; Yuanyuan,9999,0,9999,0
1668219134709,ECE 200,057,103642,Wang; Edward Jay,9999,0,9999,0
1668219134709,ECE 200,058,103643,Zheng; Yang,9999,0,9999,0
1668219135136,ECE 202,A00,103644,Kuzum; Duygu,0,0,0,0
1668219135566,ECE 212BN,A00,103646,Ng; Tse Nga,0,0,0,0
1668219135990,ECE 221,A00,111493,Staff,0,0,0,0
1668219136414,ECE 222B,A00,103647,Lomakin; Vitaliy,0,0,0,0
1668219136847,ECE 230B,A00,103648,Taur; Yuan,0,0,0,0
1668219137276,ECE 238B,A00,103649,Garay; Javier,0,0,0,0
1668219137700,ECE 240B,A00,112900,Fainman; Yeshaiahu,0,0,0,0
1668219138131,ECE 247A,A00,103650,Jokerst; Jesse Vincent,0,0,0,0
1668219138565,ECE 247B,A00,103651,Wang; Joseph,0,0,0,0
1668219138999,ECE 250,A00,103652,Siegel; Paul H.,0,0,0,0
1668219139425,ECE 251A,A00,103654,Rao; Bhaskar D.,0,0,0,0
1668219139850,ECE 257B,A00,103655,Bharadia; Dinesh,0,0,0,0
1668219140278,ECE 258A,A00,103656,Milstein; Laurence B.,0,0,0,0
1668219140716,ECE 260B,A00,103658,Kang; Mingu,0,0,0,0
1668219141141,ECE 264A,A00,103659,Galton; Ian A,0,0,0,0
1668219141576,ECE 265A,A00,103661,Gudem; Prasad S.S.,0,0,0,0
1668219142002,ECE 265D,A00,103662,Gudem; Prasad S.S.,0,0,0,0
1668219142440,ECE 268,A00,103663,Koushanfar; Farinaz,0,0,0,0
1668219142865,ECE 269,A01,103665,Pal; Piya,0,0,0,0
1668219143296,ECE 271B,A00,103666,Vasconcelos; Manuela,0,0,0,0
1668219143724,ECE 276A,A00,103667,Atanasov; Nikolay A.,0,0,0,0
1668219144151,ECE 277,A00,103668,An; Cheolhong,0,0,0,0
1668219144578,ECE 279,A00,117947,Hall; Drew A.,0,0,0,0
1668219145444,ECE 283,A00,103670,Hsueh; Tzu-Chien,0,0,0,0
1668219145877,ECE 284,A00,103671,Turakhia; Yatish Girish,0,0,0,0
1668219146309,ECE 285,A00,103672,Zheng; Yang,0,0,0,0
1668219146309,ECE 285,B00,103673,Sworder; David D.,0,0,0,0
1668219146735,ECE 287,A00,103676,Javidi; Tara,0,0,0,0
1668219147158,MATH 200B,A00,098023,Salehi Golsefidy; Alireza,12,0,15,3
1668219147589,MATH 202B,A00,098024,Rhoades; Brendon Patrick,9,0,15,6
1668219148024,MATH 203B,A00,098025,Oprea; Dragos N.,10,0,15,5
1668219148449,MATH 204B,A00,098026,Sorensen; Claus M,13,0,15,2
1668219148879,MATH 208,A00,098027,Izadi; Elham,7,0,10,3
1668219149308,MATH 209,A00,098028,Pollack; Aaron,10,0,10,0
1668219149735,MATH 211A,A00,112919,Rogalski; Daniel,9,0,10,1
1668219150163,MATH 211B,A00,112920,Seward; Brandon M.,9,0,10,1
1668219150599,MATH 218,A00,098029,Li; Bo,10,0,10,0
1668219151027,MATH 220B,A00,098030,Novak; Jonathan I,11,0,15,4
1668219151465,MATH 221A,A00,098031,Ebenfelt; Peter F,13,0,15,2
1668219151889,MATH 231B,A00,098032,Zlatos; Andrej,12,0,15,3
1668219152319,MATH 240B,A00,098033,Ni; Lei,9,0,15,6
1668219152741,MATH 243,A00,098034,Jekel; David Andrew,10,0,10,0
1668219153169,MATH 245A,A00,098035,Nie; Jiawang,0,0,15,16
1668219153593,MATH 248,A00,098036,Bejenaru; Ioan,10,0,10,0
1668219154030,MATH 250B,A00,098037,Spolaor; Luca,14,0,15,1
1668219154456,MATH 258,A00,098038,Ni; Lei,10,0,10,0
1668219154883,MATH 264B,A00,098041,Rhoades; Brendon Patrick,9,0,15,6
1668219155307,MATH 268,A00,098042,Buss; Samuel R,10,0,10,0
1668219155729,MATH 269,A00,098043,Rhoades; Brendon Patrick,10,0,10,0
1668219156156,MATH 270B,A00,098044,Li; Bo,10,0,15,5
1668219156659,MATH 272B,A00,098045,Holst; Michael J,13,0,15,2
1668219157084,MATH 273A,A00,098046,Tian; Xiaochuan,10,0,15,5
1668219157510,MATH 275,A01,098048,Tian; Xiaochuan,6,0,10,4
1668219157932,MATH 278A,A00,098049,Holst; Michael J,8,0,10,2
1668219158360,MATH 278B,A00,098050,Cloninger; Alexander,10,0,10,0
1668219158785,MATH 278C,A00,098051,Nie; Jiawang,7,0,10,3
1668219159210,MATH 280B,A00,098052,Zheng; Tianyi,10,0,15,5
1668219159637,MATH 281B,A00,098053,Bradic; Jelena,2,0,15,13
1668219160060,MATH 282B,A00,098054,Arias-Castro; Ery,0,0,15,15
1668219160495,MATH 285,A00,098055,Fitzsimmons; Patrick J,0,0,15,17
1668219160919,MATH 287B,A00,098056,Arias-Castro; Ery,2,0,15,13
1668219161345,MATH 288,A00,098057,Agarwal; Pooja,9,0,10,1
1668219161345,MATH 288,B00,098058,Zhang; Danna,8,0,10,2
1668219161345,MATH 288,C00,098059,Williams; Ruth J,10,0,10,0
1668219161770,MATH 290B,A00,098060,Roberts; Justin Deritter,13,0,15,2
1668219162194,MATH 292,A00,098061,Belmont; Eva Kinoshita,10,0,10,0
1668219162623,MATH 295,A00,098062,Suk; Andrew Hoon,48,0,50,2
1668219163047,MATH 296,A00,098063,Novak; Jonathan I,20,0,20,0
1668219163469,MATH 297,001,098064,Gamst; Anthony Collins,9997,0,9999,2
1668219669612,COGS 205,A00,101395,Chiba; Andrea,19,0,20,1
1668219670049,COGS 210B,001,101404,Greene; Deanna Jacquelyn,9998,0,9999,1
1668219670049,COGS 210B,002,101417,Xia; Haijun,9999,0,9999,0
1668219670049,COGS 210B,003,101422,Nitz; Douglas A.,9999,0,9999,0
1668219670049,COGS 210B,004,101423,Hollan; James D.,9998,0,9999,1
1668219670049,COGS 210B,005,101424,Deak; Gedeon O.,9998,0,9999,1
1668219670049,COGS 210B,006,101425,Rossano; Federico,9999,0,9999,0
1668219670515,COGS 211B,A00,101427,Coulson; Seana M,9996,0,9999,3
1668219670944,COGS 220,A00,101428,Hollan; James D.,0,0,25,25
1668219671368,COGS 229,A00,101429,Dow; Steven P,18,0,25,7
1668219671792,COGS 230,A00,101430,Klemmer; Scott R,12,0,17,5
1668219672216,COGS 234,A00,101431,Xia; Haijun,2,0,25,23
1668219672639,COGS 260,A00,101432,Kiyonaga; Anastasia,21,0,25,4
1668219672639,COGS 260,B00,101433,Kirsh; David Joel,15,0,25,10
1668219673066,CSE 202,A00,102371,Impagliazzo; Russell,0,0,0,0
1668219673504,CSE 203B,A01,102373,Cheng; Chung Kuan,0,0,0,0
1668219673931,CSE 208,A00,102374,Micciancio; Daniele,0,0,0,0
1668219674356,CSE 209A,A00,112895,Impagliazzo; Russell,0,0,15,15
1668219674782,CSE 209B,A00,108005,Bellare; Mihir,0,0,0,0
1668219675211,CSE 210,A00,113163,Coblenz; Michael J,0,0,0,0
1668219675647,CSE 219,A00,106111,Dow; Steven P,0,0,20,20
1668219676081,CSE 221,A00,102376,Voelker; Geoffrey M.,0,0,0,0
1668219676645,CSE 224,A01,102378,Porter; George M,0,0,0,0
1668219677078,CSE 229A,A00,102379,Savage; Stefan,0,0,0,0
1668219677511,CSE 229C,A00,102380,Munyaka; Imani N. S.,0,0,0,0
1668219677935,CSE 232B,A00,102382,Deutsch; Alin Bernard,0,0,0,0
1668219678359,CSE 234,A01,112904,Kumar; Arun Kumar,0,0,0,0
1668219678782,CSE 237A,A00,102383,Rosing; Tajana Simunic,0,0,0,0
1668219679219,CSE 239A,A00,102384,Deutsch; Alin Bernard,0,0,0,0
1668219679643,CSE 239B,A00,102385,Polikarpova; Nadezhda,0,0,0,0
1668219680066,CSE 240A,A00,102386,Pannuto; Patrick William,0,0,0,0
1668219680491,CSE 240B,A00,102387,Zhao; Jishen,0,0,0,0
1668219680939,CSE 241A,A00,106406,Kang; Mingu,0,0,0,0
1668219681372,CSE 249B,A00,102388,Kahng; Andrew Byun,0,0,8,8
1668219681798,CSE 251B,A01,102392,Cottrell; Garrison W,0,0,0,0
1668219681798,CSE 251B,A02,102393,Cottrell; Garrison W,0,0,0,0
1668219682219,CSE 252B,A00,102394,Ochoa; Benjamin Lawrence,0,0,0,0
1668219682649,CSE 257,A01,102396,Gao; Sicun,0,0,0,0
1668219683170,CSE 272,A00,102397,Li; Tzumao,0,0,0,0
1668219683599,CSE 274,A00,111323,Chern; Albert Ren-Haur,0,0,0,0
1668219684036,CSE 282,A00,102398,Pevzner; Pavel Arkadjevich,0,0,0,0
1668219684466,CSE 284,A00,114175,Gymrek; Melissa Ann,0,0,0,0
1668219684894,CSE 290,A00,102399,Chandraker; Manmohan Krishna,0,0,0,0
1668219684894,CSE 290,B00,102400,Vaccaro; Kristen Marie,0,0,25,25
1668219684894,CSE 290,C00,102414,Pannuto; Patrick William,0,0,25,25
1668219684894,CSE 290,D00,102427,Pevzner; Pavel Arkadjevich,0,0,0,0
1668219684894,CSE 290,E00,102429,Zhao; Jishen,0,0,0,0
1668219684894,CSE 290,F00,102436,Tullsen; Dean Michael,0,0,0,0
1668219684894,CSE 290,G00,102440,Christensen; Henrik I,0,0,20,20
1668219685324,CSE 291,A00,102443,Su; Hao,0,0,0,0
1668219685324,CSE 291,B00,102448,Polikarpova; Nadezhda,0,0,0,0
1668219685324,CSE 291,C00,102453,Vaccaro; Kristen Marie,0,0,0,0
1668219685324,CSE 291,D00,111343,Savage; Stefan,0,0,0,0
1668219685324,CSE 291,E00,116474,Claffy; Kimberly Claire,0,0,0,0
1668219685324,CSE 291,F00,116479,Pasquale; Joseph,0,0,0,0
1668219685760,CSE 293,001,119111,Bafna; Vineet,9999,0,9999,0
1668219685760,CSE 293,002,119118,Bellare; Mihir,9999,0,9999,0
1668219685760,CSE 293,003,119122,Berg-Kirkpatrick; Taylor D,9999,0,9999,0
1668219685760,CSE 293,004,119135,Christensen; Henrik I,9999,0,9999,0
1668219685760,CSE 293,005,119142,Cottrell; Garrison W,9999,0,9999,0
1668219685760,CSE 293,006,119146,Deutsch; Alin Bernard,9999,0,9999,0
1668219685760,CSE 293,007,119159,Esmaeilzadeh; Hadi,9999,0,9999,0
1668219685760,CSE 293,008,119166,Freund; Yoav,9999,0,9999,0
1668219685760,CSE 293,009,119170,Griswold; William G.,9999,0,9999,0
1668219685760,CSE 293,010,119183,Gymrek; Melissa Ann,9999,0,9999,0
1668219685760,CSE 293,011,119190,Heninger; Nadia A,9999,0,9999,0
1668219685760,CSE 293,012,119230,Impagliazzo; Russell,9999,0,9999,0
1668219685760,CSE 293,013,119232,Jhala; Ranjit,9999,0,9999,0
1668219685760,CSE 293,014,119233,Kahng; Andrew Byun,9999,0,9999,0
1668219685760,CSE 293,015,119298,Kane; Daniel Mertz,9999,0,9999,0
1668219685760,CSE 293,016,119299,Kriegman; David J,9999,0,9999,0
1668219685760,CSE 293,017,119300,Kumar; Arun Kumar,9999,0,9999,0
1668219685760,CSE 293,018,119301,Lerner; Sorin,9999,0,9999,0
1668219685760,CSE 293,019,119302,Lovett; Shachar,9999,0,9999,0
1668219685760,CSE 293,020,119303,McAuley; Julian John,9999,0,9999,0
1668219685760,CSE 293,021,119304,Micciancio; Daniele,9999,0,9999,0
1668219685760,CSE 293,022,119367,Orailoglu; Alex,9999,0,9999,0
1668219685760,CSE 293,023,119382,Paturi; Ramamohan,9999,0,9999,0
1668219685760,CSE 293,024,119404,Polikarpova; Nadezhda,9999,0,9999,0
1668219685760,CSE 293,025,119406,Politz; Joseph Gibbs,9999,0,9999,0
1668219685760,CSE 293,026,119411,Porter; George M,9999,0,9999,0
1668219685760,CSE 293,027,119414,Porter; Leonard Emerson,9999,0,9999,0
1668219685760,CSE 293,028,119416,Ramamoorthi; Ravi,9999,0,9999,0
1668219685760,CSE 293,029,119417,Sahoo; Debashis,9999,0,9999,0
1668219685760,CSE 293,030,119420,Saul; Lawrence,9999,0,9999,0
1668219685760,CSE 293,031,119421,Savage; Stefan,9999,0,9999,0
1668219685760,CSE 293,032,119425,Schulze; Jurgen P.,9999,0,9999,0
1668219685760,CSE 293,033,119426,Snoeren; Alex C.,9999,0,9999,0
1668219685760,CSE 293,034,119428,Shang; Jingbo,9999,0,9999,0
1668219685760,CSE 293,035,119430,Stefan; Deian,9999,0,9999,0
1668219685760,CSE 293,036,119431,Su; Hao,9999,0,9999,0
1668219685760,CSE 293,037,119433,Swanson; Steven James,9999,0,9999,0
1668219685760,CSE 293,038,119435,Tullsen; Dean Michael,9999,0,9999,0
1668219685760,CSE 293,039,119483,Voelker; Geoffrey M.,9999,0,9999,0
1668219685760,CSE 293,040,119537,Zhao; Jishen,9999,0,9999,0
1668219685760,CSE 293,041,119538,Zhou; Yuan-Yuan,9999,0,9999,0
1668219685760,CSE 293,042,119539,Gao; Sicun,9999,0,9999,0
1668219685760,CSE 293,043,119540,Weibel; Nadir,9999,0,9999,0
1668219685760,CSE 293,044,119541,Gupta; Rajesh K.,9999,0,9999,0
1668219685760,CSE 293,045,126410,Vaccaro; Kristen Marie,9999,0,9999,0
1668219685760,CSE 293,046,126411,Klemke; Richard,9999,0,9999,0
1668219686197,CSE 294,A00,102459,Voelker; Geoffrey M.,0,0,0,0
1668219686197,CSE 294,B00,111322,Orailoglu; Alex,0,0,0,0
1668219686631,DSE 201,A00,096914,Deutsch; Alin Bernard,30,0,30,0
1668219687059,DSE 210,A00,096915,Dasgupta; Sanjoy,30,0,30,0
1668219687489,DSE 260A,A00,096916,Altintas De Callaf; Ilkay,30,0,30,0
1668219687951,ECE 200,001,103586,Antipa; Nicholas A,9999,0,9999,0
1668219687951,ECE 200,002,103587,Atanasov; Nikolay A.,9999,0,9999,0
1668219687951,ECE 200,003,103588,Bharadia; Dinesh,9999,0,9999,0
1668219687951,ECE 200,004,103589,Cheng; Chung Kuan,9999,0,9999,0
1668219687951,ECE 200,005,103590,Cosman; Pamela C.,9999,0,9999,0
1668219687951,ECE 200,006,103591,Dayeh; Shadi Ahmad,9999,0,9999,0
1668219687951,ECE 200,007,103592,Fainman; Yeshaiahu,9999,0,9999,0
1668219687951,ECE 200,008,103593,Ford; Joseph Earl,9999,0,9999,0
1668219687951,ECE 200,009,103594,Franceschetti; Massimo,9999,0,9999,0
1668219687951,ECE 200,010,103595,Fullerton; Eric E,9999,0,9999,0
1668219687951,ECE 200,011,103596,Galton; Ian A,9999,0,9999,0
1668219687951,ECE 200,012,103597,Gilja; Vikash,9999,0,9999,0
1668219687951,ECE 200,013,103598,Hall; Drew A.,9999,0,9999,0
1668219687951,ECE 200,014,103599,Hsueh; Tzu-Chien,9999,0,9999,0
1668219687951,ECE 200,015,103600,Javidi; Tara,9999,0,9999,0
1668219687951,ECE 200,016,103601,Kahng; Andrew Byun,9999,0,9999,0
1668219687951,ECE 200,017,103602,Kim; Young-Han,9999,0,9999,0
1668219687951,ECE 200,018,103603,Koushanfar; Farinaz,9999,0,9999,0
1668219687951,ECE 200,019,103604,Kuzum; Duygu,9999,0,9999,0
1668219687951,ECE 200,020,103605,Le; Hanh-Phuc,9999,0,9999,0
1668219687951,ECE 200,021,103606,Lin; Bill,9999,0,9999,0
1668219687951,ECE 200,022,103607,Liu; Zhaowei,9998,0,9999,1
1668219687951,ECE 200,023,103608,Lo; Yu-Hwa,9999,0,9999,0
1668219687951,ECE 200,024,103609,Lomakin; Vitaliy,9999,0,9999,0
1668219687951,ECE 200,025,103610,Mercier; Patrick Philip,9999,0,9999,0
1668219687951,ECE 200,026,103611,Meyer; Florian,9999,0,9999,0
1668219687951,ECE 200,027,103612,Milstein; Laurence B.,9999,0,9999,0
1668219687951,ECE 200,028,103613,Mir Arabbaygi; Siavash,9999,0,9999,0
1668219687951,ECE 200,029,103614,Mookherjea; Shayan,9999,0,9999,0
1668219687951,ECE 200,030,103615,Morris; Karcher William,9999,0,9999,0
1668219687951,ECE 200,031,103616,Ng; Tse Nga,9999,0,9999,0
1668219687951,ECE 200,032,103617,Nguyen; Truong Quang,9999,0,9999,0
1668219687951,ECE 200,033,103618,Nomura; Kenji,9999,0,9999,0
1668219687951,ECE 200,034,103619,Orlitsky; Alon,9999,0,9999,0
1668219687951,ECE 200,035,103620,Pal; Piya,9999,0,9999,0
1668219687951,ECE 200,036,103621,Papen; George C.,9999,0,9999,0
1668219687951,ECE 200,037,103622,Radic; Stojan,9999,0,9999,0
1668219687951,ECE 200,038,103623,Rao; Bhaskar D.,9999,0,9999,0
1668219687951,ECE 200,039,103624,Rao; Ramesh R,9999,0,9999,0
1668219687951,ECE 200,040,103625,Rebeiz; Gabriel,9999,0,9999,0
1668219687951,ECE 200,041,103626,Sanford; John R,9999,0,9999,0
1668219687951,ECE 200,042,103627,Siegel; Paul H.,9999,0,9999,0
1668219687951,ECE 200,043,103628,Sievenpiper; Daniel F.,9999,0,9999,0
1668219687951,ECE 200,044,103629,Sworder; David D.,9999,0,9999,0
1668219687951,ECE 200,045,103630,Taur; Yuan,9999,0,9999,0
1668219687951,ECE 200,046,103631,Touri; Behrouz,9999,0,9999,0
1668219687951,ECE 200,047,103632,Trivedi; Mohan M.,9999,0,9999,0
1668219687951,ECE 200,048,103633,Vasconcelos; Nuno,9999,0,9999,0
1668219687951,ECE 200,049,103634,Wang; Xiaolong,9999,0,9999,0
1668219687951,ECE 200,050,103635,Xie; Pengtao,9999,0,9999,0
1668219687951,ECE 200,051,103636,Yip; Michael,9999,0,9999,0
1668219687951,ECE 200,052,103637,Zeger; Kenneth A.,999,0,999,0
1668219687951,ECE 200,053,103638,Zhang; Xinyu,9999,0,9999,0
1668219687951,ECE 200,054,103639,Turakhia; Yatish Girish,9999,0,9999,0
1668219687951,ECE 200,055,103640,Kang; Mingu,9999,0,9999,0
1668219687951,ECE 200,056,103641,Shi; Yuanyuan,9999,0,9999,0
1668219687951,ECE 200,057,103642,Wang; Edward Jay,9999,0,9999,0
1668219687951,ECE 200,058,103643,Zheng; Yang,9999,0,9999,0
1668219688377,ECE 202,A00,103644,Kuzum; Duygu,0,0,0,0
1668219688805,ECE 212BN,A00,103646,Ng; Tse Nga,0,0,0,0
1668219689233,ECE 221,A00,111493,Staff,0,0,0,0
1668219689661,ECE 222B,A00,103647,Lomakin; Vitaliy,0,0,0,0
1668219690098,ECE 230B,A00,103648,Taur; Yuan,0,0,0,0
1668219690527,ECE 238B,A00,103649,Garay; Javier,0,0,0,0
1668219690971,ECE 240B,A00,112900,Fainman; Yeshaiahu,0,0,0,0
1668219691399,ECE 247A,A00,103650,Jokerst; Jesse Vincent,0,0,0,0
1668219691823,ECE 247B,A00,103651,Wang; Joseph,0,0,0,0
1668219692245,ECE 250,A00,103652,Siegel; Paul H.,0,0,0,0
1668219692668,ECE 251A,A00,103654,Rao; Bhaskar D.,0,0,0,0
1668219693110,ECE 257B,A00,103655,Bharadia; Dinesh,0,0,0,0
1668219693535,ECE 258A,A00,103656,Milstein; Laurence B.,0,0,0,0
1668219693962,ECE 260B,A00,103658,Kang; Mingu,0,0,0,0
1668219694443,ECE 264A,A00,103659,Galton; Ian A,0,0,0,0
1668219694866,ECE 265A,A00,103661,Gudem; Prasad S.S.,0,0,0,0
1668219695297,ECE 265D,A00,103662,Gudem; Prasad S.S.,0,0,0,0
1668219695732,ECE 268,A00,103663,Koushanfar; Farinaz,0,0,0,0
1668219696167,ECE 269,A01,103665,Pal; Piya,0,0,0,0
1668219696604,ECE 271B,A00,103666,Vasconcelos; Manuela,0,0,0,0
1668219697034,ECE 276A,A00,103667,Atanasov; Nikolay A.,0,0,0,0
1668219697467,ECE 277,A00,103668,An; Cheolhong,0,0,0,0
1668219697924,ECE 279,A00,117947,Hall; Drew A.,0,0,0,0
1668219698877,ECE 283,A00,103670,Hsueh; Tzu-Chien,0,0,0,0
1668219699316,ECE 284,A00,103671,Turakhia; Yatish Girish,0,0,0,0
1668219699757,ECE 285,A00,103672,Zheng; Yang,0,0,0,0
1668219699757,ECE 285,B00,103673,Sworder; David D.,0,0,0,0
1668219700187,ECE 287,A00,103676,Javidi; Tara,0,0,0,0
1668219700615,MATH 200B,A00,098023,Salehi Golsefidy; Alireza,12,0,15,3
1668219701043,MATH 202B,A00,098024,Rhoades; Brendon Patrick,9,0,15,6
1668219701472,MATH 203B,A00,098025,Oprea; Dragos N.,10,0,15,5
1668219701899,MATH 204B,A00,098026,Sorensen; Claus M,13,0,15,2
1668219702327,MATH 208,A00,098027,Izadi; Elham,7,0,10,3
1668219702756,MATH 209,A00,098028,Pollack; Aaron,10,0,10,0
1668219703181,MATH 211A,A00,112919,Rogalski; Daniel,9,0,10,1
1668219703607,MATH 211B,A00,112920,Seward; Brandon M.,9,0,10,1
1668219704033,MATH 218,A00,098029,Li; Bo,10,0,10,0
1668219704459,MATH 220B,A00,098030,Novak; Jonathan I,11,0,15,4
1668219704884,MATH 221A,A00,098031,Ebenfelt; Peter F,13,0,15,2
1668219705308,MATH 231B,A00,098032,Zlatos; Andrej,12,0,15,3
1668219705739,MATH 240B,A00,098033,Ni; Lei,9,0,15,6
1668219706175,MATH 243,A00,098034,Jekel; David Andrew,10,0,10,0
1668219706600,MATH 245A,A00,098035,Nie; Jiawang,0,0,15,16
1668219707028,MATH 248,A00,098036,Bejenaru; Ioan,10,0,10,0
1668219707452,MATH 250B,A00,098037,Spolaor; Luca,14,0,15,1
1668219707881,MATH 258,A00,098038,Ni; Lei,10,0,10,0
1668219708305,MATH 264B,A00,098041,Rhoades; Brendon Patrick,9,0,15,6
1668219708728,MATH 268,A00,098042,Buss; Samuel R,10,0,10,0
1668219709152,MATH 269,A00,098043,Rhoades; Brendon Patrick,10,0,10,0
1668219709575,MATH 270B,A00,098044,Li; Bo,10,0,15,5
1668219710003,MATH 272B,A00,098045,Holst; Michael J,13,0,15,2
1668219710428,MATH 273A,A00,098046,Tian; Xiaochuan,10,0,15,5
1668219710865,MATH 275,A01,098048,Tian; Xiaochuan,6,0,10,4
1668219711301,MATH 278A,A00,098049,Holst; Michael J,8,0,10,2
1668219711734,MATH 278B,A00,098050,Cloninger; Alexander,10,0,10,0
1668219712165,MATH 278C,A00,098051,Nie; Jiawang,7,0,10,3
1668219712595,MATH 280B,A00,098052,Zheng; Tianyi,10,0,15,5
1668219713031,MATH 281B,A00,098053,Bradic; Jelena,2,0,15,13
1668219713469,MATH 282B,A00,098054,Arias-Castro; Ery,0,0,15,15
1668219713909,MATH 285,A00,098055,Fitzsimmons; Patrick J,0,0,15,17
1668219714334,MATH 287B,A00,098056,Arias-Castro; Ery,2,0,15,13
1668219714760,MATH 288,A00,098057,Agarwal; Pooja,9,0,10,1
1668219714760,MATH 288,B00,098058,Zhang; Danna,8,0,10,2
1668219714760,MATH 288,C00,098059,Williams; Ruth J,10,0,10,0
1668219715196,MATH 290B,A00,098060,Roberts; Justin Deritter,13,0,15,2
1668219715623,MATH 292,A00,098061,Belmont; Eva Kinoshita,10,0,10,0
1668219716073,MATH 295,A00,098062,Suk; Andrew Hoon,48,0,50,2
1668219716501,MATH 296,A00,098063,Novak; Jonathan I,20,0,20,0
1668219716941,MATH 297,001,098064,Gamst; Anthony Collins,9997,0,9999,2
1668220223650,COGS 205,A00,101395,Chiba; Andrea,19,0,20,1
1668220224096,COGS 210B,001,101404,Greene; Deanna Jacquelyn,9998,0,9999,1
1668220224096,COGS 210B,002,101417,Xia; Haijun,9999,0,9999,0
1668220224096,COGS 210B,003,101422,Nitz; Douglas A.,9999,0,9999,0
1668220224096,COGS 210B,004,101423,Hollan; James D.,9998,0,9999,1
1668220224096,COGS 210B,005,101424,Deak; Gedeon O.,9998,0,9999,1
1668220224096,COGS 210B,006,101425,Rossano; Federico,9999,0,9999,0
1668220224533,COGS 211B,A00,101427,Coulson; Seana M,9996,0,9999,3
1668220224969,COGS 220,A00,101428,Hollan; James D.,0,0,25,25
1668220225394,COGS 229,A00,101429,Dow; Steven P,18,0,25,7
1668220225818,COGS 230,A00,101430,Klemmer; Scott R,12,0,17,5
1668220226247,COGS 234,A00,101431,Xia; Haijun,2,0,25,23
1668220226670,COGS 260,A00,101432,Kiyonaga; Anastasia,21,0,25,4
1668220226670,COGS 260,B00,101433,Kirsh; David Joel,15,0,25,10
1668220227094,CSE 202,A00,102371,Impagliazzo; Russell,0,0,0,0
1668220227527,CSE 203B,A01,102373,Cheng; Chung Kuan,0,0,0,0
1668220227975,CSE 208,A00,102374,Micciancio; Daniele,0,0,0,0
1668220228398,CSE 209A,A00,112895,Impagliazzo; Russell,0,0,15,15
1668220228828,CSE 209B,A00,108005,Bellare; Mihir,0,0,0,0
1668220229251,CSE 210,A00,113163,Coblenz; Michael J,0,0,0,0
1668220229683,CSE 219,A00,106111,Dow; Steven P,0,0,20,20
1668220230114,CSE 221,A00,102376,Voelker; Geoffrey M.,0,0,0,0
1668220230539,CSE 224,A01,102378,Porter; George M,0,0,0,0
1668220230970,CSE 229A,A00,102379,Savage; Stefan,0,0,0,0
1668220231426,CSE 229C,A00,102380,Munyaka; Imani N. S.,0,0,0,0
1668220231850,CSE 232B,A00,102382,Deutsch; Alin Bernard,0,0,0,0
1668220232274,CSE 234,A01,112904,Kumar; Arun Kumar,0,0,0,0
1668220232706,CSE 237A,A00,102383,Rosing; Tajana Simunic,0,0,0,0
1668220233136,CSE 239A,A00,102384,Deutsch; Alin Bernard,0,0,0,0
1668220233561,CSE 239B,A00,102385,Polikarpova; Nadezhda,0,0,0,0
1668220233991,CSE 240A,A00,102386,Pannuto; Patrick William,0,0,0,0
1668220234417,CSE 240B,A00,102387,Zhao; Jishen,0,0,0,0
1668220234851,CSE 241A,A00,106406,Kang; Mingu,0,0,0,0
1668220235282,CSE 249B,A00,102388,Kahng; Andrew Byun,0,0,8,8
1668220235708,CSE 251B,A01,102392,Cottrell; Garrison W,0,0,0,0
1668220235708,CSE 251B,A02,102393,Cottrell; Garrison W,0,0,0,0
1668220236146,CSE 252B,A00,102394,Ochoa; Benjamin Lawrence,0,0,0,0
1668220236585,CSE 257,A01,102396,Gao; Sicun,0,0,0,0
1668220237009,CSE 272,A00,102397,Li; Tzumao,0,0,0,0
1668220237435,CSE 274,A00,111323,Chern; Albert Ren-Haur,0,0,0,0
1668220237880,CSE 282,A00,102398,Pevzner; Pavel Arkadjevich,0,0,0,0
1668220238327,CSE 284,A00,114175,Gymrek; Melissa Ann,0,0,0,0
1668220238755,CSE 290,A00,102399,Chandraker; Manmohan Krishna,0,0,0,0
1668220238755,CSE 290,B00,102400,Vaccaro; Kristen Marie,0,0,25,25
1668220238755,CSE 290,C00,102414,Pannuto; Patrick William,0,0,25,25
1668220238755,CSE 290,D00,102427,Pevzner; Pavel Arkadjevich,0,0,0,0
1668220238755,CSE 290,E00,102429,Zhao; Jishen,0,0,0,0
1668220238755,CSE 290,F00,102436,Tullsen; Dean Michael,0,0,0,0
1668220238755,CSE 290,G00,102440,Christensen; Henrik I,0,0,20,20
1668220239181,CSE 291,A00,102443,Su; Hao,0,0,0,0
1668220239181,CSE 291,B00,102448,Polikarpova; Nadezhda,0,0,0,0
1668220239181,CSE 291,C00,102453,Vaccaro; Kristen Marie,0,0,0,0
1668220239181,CSE 291,D00,111343,Savage; Stefan,0,0,0,0
1668220239181,CSE 291,E00,116474,Claffy; Kimberly Claire,0,0,0,0
1668220239181,CSE 291,F00,116479,Pasquale; Joseph,0,0,0,0
1668220239640,CSE 293,001,119111,Bafna; Vineet,9999,0,9999,0
1668220239640,CSE 293,002,119118,Bellare; Mihir,9999,0,9999,0
1668220239640,CSE 293,003,119122,Berg-Kirkpatrick; Taylor D,9999,0,9999,0
1668220239640,CSE 293,004,119135,Christensen; Henrik I,9999,0,9999,0
1668220239640,CSE 293,005,119142,Cottrell; Garrison W,9999,0,9999,0
1668220239640,CSE 293,006,119146,Deutsch; Alin Bernard,9999,0,9999,0
1668220239640,CSE 293,007,119159,Esmaeilzadeh; Hadi,9999,0,9999,0
1668220239640,CSE 293,008,119166,Freund; Yoav,9999,0,9999,0
1668220239640,CSE 293,009,119170,Griswold; William G.,9999,0,9999,0
1668220239640,CSE 293,010,119183,Gymrek; Melissa Ann,9999,0,9999,0
1668220239640,CSE 293,011,119190,Heninger; Nadia A,9999,0,9999,0
1668220239640,CSE 293,012,119230,Impagliazzo; Russell,9999,0,9999,0
1668220239640,CSE 293,013,119232,Jhala; Ranjit,9999,0,9999,0
1668220239640,CSE 293,014,119233,Kahng; Andrew Byun,9999,0,9999,0
1668220239640,CSE 293,015,119298,Kane; Daniel Mertz,9999,0,9999,0
1668220239640,CSE 293,016,119299,Kriegman; David J,9999,0,9999,0
1668220239640,CSE 293,017,119300,Kumar; Arun Kumar,9999,0,9999,0
1668220239640,CSE 293,018,119301,Lerner; Sorin,9999,0,9999,0
1668220239640,CSE 293,019,119302,Lovett; Shachar,9999,0,9999,0
1668220239640,CSE 293,020,119303,McAuley; Julian John,9999,0,9999,0
1668220239640,CSE 293,021,119304,Micciancio; Daniele,9999,0,9999,0
1668220239640,CSE 293,022,119367,Orailoglu; Alex,9999,0,9999,0
1668220239640,CSE 293,023,119382,Paturi; Ramamohan,9999,0,9999,0
1668220239640,CSE 293,024,119404,Polikarpova; Nadezhda,9999,0,9999,0
1668220239640,CSE 293,025,119406,Politz; Joseph Gibbs,9999,0,9999,0
1668220239640,CSE 293,026,119411,Porter; George M,9999,0,9999,0
1668220239640,CSE 293,027,119414,Porter; Leonard Emerson,9999,0,9999,0
1668220239640,CSE 293,028,119416,Ramamoorthi; Ravi,9999,0,9999,0
1668220239640,CSE 293,029,119417,Sahoo; Debashis,9999,0,9999,0
1668220239640,CSE 293,030,119420,Saul; Lawrence,9999,0,9999,0
1668220239640,CSE 293,031,119421,Savage; Stefan,9999,0,9999,0
1668220239640,CSE 293,032,119425,Schulze; Jurgen P.,9999,0,9999,0
1668220239640,CSE 293,033,119426,Snoeren; Alex C.,9999,0,9999,0
1668220239640,CSE 293,034,119428,Shang; Jingbo,9999,0,9999,0
1668220239640,CSE 293,035,119430,Stefan; Deian,9999,0,9999,0
1668220239640,CSE 293,036,119431,Su; Hao,9999,0,9999,0
1668220239640,CSE 293,037,119433,Swanson; Steven James,9999,0,9999,0
1668220239640,CSE 293,038,119435,Tullsen; Dean Michael,9999,0,9999,0
1668220239640,CSE 293,039,119483,Voelker; Geoffrey M.,9999,0,9999,0
1668220239640,CSE 293,040,119537,Zhao; Jishen,9999,0,9999,0
1668220239640,CSE 293,041,119538,Zhou; Yuan-Yuan,9999,0,9999,0
1668220239640,CSE 293,042,119539,Gao; Sicun,9999,0,9999,0
1668220239640,CSE 293,043,119540,Weibel; Nadir,9999,0,9999,0
1668220239640,CSE 293,044,119541,Gupta; Rajesh K.,9999,0,9999,0
1668220239640,CSE 293,045,126410,Vaccaro; Kristen Marie,9999,0,9999,0
1668220239640,CSE 293,046,126411,Klemke; Richard,9999,0,9999,0
1668220240067,CSE 294,A00,102459,Voelker; Geoffrey M.,0,0,0,0
1668220240067,CSE 294,B00,111322,Orailoglu; Alex,0,0,0,0
1668220240495,DSE 201,A00,096914,Deutsch; Alin Bernard,30,0,30,0
1668220240920,DSE 210,A00,096915,Dasgupta; Sanjoy,30,0,30,0
1668220241344,DSE 260A,A00,096916,Altintas De Callaf; Ilkay,30,0,30,0
1668220241784,ECE 200,001,103586,Antipa; Nicholas A,9999,0,9999,0
1668220241784,ECE 200,002,103587,Atanasov; Nikolay A.,9999,0,9999,0
1668220241784,ECE 200,003,103588,Bharadia; Dinesh,9999,0,9999,0
1668220241784,ECE 200,004,103589,Cheng; Chung Kuan,9999,0,9999,0
1668220241784,ECE 200,005,103590,Cosman; Pamela C.,9999,0,9999,0
1668220241784,ECE 200,006,103591,Dayeh; Shadi Ahmad,9999,0,9999,0
1668220241784,ECE 200,007,103592,Fainman; Yeshaiahu,9999,0,9999,0
1668220241784,ECE 200,008,103593,Ford; Joseph Earl,9999,0,9999,0
1668220241784,ECE 200,009,103594,Franceschetti; Massimo,9999,0,9999,0
1668220241784,ECE 200,010,103595,Fullerton; Eric E,9999,0,9999,0
1668220241784,ECE 200,011,103596,Galton; Ian A,9999,0,9999,0
1668220241784,ECE 200,012,103597,Gilja; Vikash,9999,0,9999,0
1668220241784,ECE 200,013,103598,Hall; Drew A.,9999,0,9999,0
1668220241784,ECE 200,014,103599,Hsueh; Tzu-Chien,9999,0,9999,0
1668220241784,ECE 200,015,103600,Javidi; Tara,9999,0,9999,0
1668220241784,ECE 200,016,103601,Kahng; Andrew Byun,9999,0,9999,0
1668220241784,ECE 200,017,103602,Kim; Young-Han,9999,0,9999,0
1668220241784,ECE 200,018,103603,Koushanfar; Farinaz,9999,0,9999,0
1668220241784,ECE 200,019,103604,Kuzum; Duygu,9999,0,9999,0
1668220241784,ECE 200,020,103605,Le; Hanh-Phuc,9999,0,9999,0
1668220241784,ECE 200,021,103606,Lin; Bill,9999,0,9999,0
1668220241784,ECE 200,022,103607,Liu; Zhaowei,9998,0,9999,1
1668220241784,ECE 200,023,103608,Lo; Yu-Hwa,9999,0,9999,0
1668220241784,ECE 200,024,103609,Lomakin; Vitaliy,9999,0,9999,0
1668220241784,ECE 200,025,103610,Mercier; Patrick Philip,9999,0,9999,0
1668220241784,ECE 200,026,103611,Meyer; Florian,9999,0,9999,0
1668220241784,ECE 200,027,103612,Milstein; Laurence B.,9999,0,9999,0
1668220241784,ECE 200,028,103613,Mir Arabbaygi; Siavash,9999,0,9999,0
1668220241784,ECE 200,029,103614,Mookherjea; Shayan,9999,0,9999,0
1668220241784,ECE 200,030,103615,Morris; Karcher William,9999,0,9999,0
1668220241784,ECE 200,031,103616,Ng; Tse Nga,9999,0,9999,0
1668220241784,ECE 200,032,103617,Nguyen; Truong Quang,9999,0,9999,0
1668220241784,ECE 200,033,103618,Nomura; Kenji,9999,0,9999,0
1668220241784,ECE 200,034,103619,Orlitsky; Alon,9999,0,9999,0
1668220241784,ECE 200,035,103620,Pal; Piya,9999,0,9999,0
1668220241784,ECE 200,036,103621,Papen; George C.,9999,0,9999,0
1668220241784,ECE 200,037,103622,Radic; Stojan,9999,0,9999,0
1668220241784,ECE 200,038,103623,Rao; Bhaskar D.,9999,0,9999,0
1668220241784,ECE 200,039,103624,Rao; Ramesh R,9999,0,9999,0
1668220241784,ECE 200,040,103625,Rebeiz; Gabriel,9999,0,9999,0
1668220241784,ECE 200,041,103626,Sanford; John R,9999,0,9999,0
1668220241784,ECE 200,042,103627,Siegel; Paul H.,9999,0,9999,0
1668220241784,ECE 200,043,103628,Sievenpiper; Daniel F.,9999,0,9999,0
1668220241784,ECE 200,044,103629,Sworder; David D.,9999,0,9999,0
1668220241784,ECE 200,045,103630,Taur; Yuan,9999,0,9999,0
1668220241784,ECE 200,046,103631,Touri; Behrouz,9999,0,9999,0
1668220241784,ECE 200,047,103632,Trivedi; Mohan M.,9999,0,9999,0
1668220241784,ECE 200,048,103633,Vasconcelos; Nuno,9999,0,9999,0
1668220241784,ECE 200,049,103634,Wang; Xiaolong,9999,0,9999,0
1668220241784,ECE 200,050,103635,Xie; Pengtao,9999,0,9999,0
1668220241784,ECE 200,051,103636,Yip; Michael,9999,0,9999,0
1668220241784,ECE 200,052,103637,Zeger; Kenneth A.,999,0,999,0
1668220241784,ECE 200,053,103638,Zhang; Xinyu,9999,0,9999,0
1668220241784,ECE 200,054,103639,Turakhia; Yatish Girish,9999,0,9999,0
1668220241784,ECE 200,055,103640,Kang; Mingu,9999,0,9999,0
1668220241784,ECE 200,056,103641,Shi; Yuanyuan,9999,0,9999,0
1668220241784,ECE 200,057,103642,Wang; Edward Jay,9999,0,9999,0
1668220241784,ECE 200,058,103643,Zheng; Yang,9999,0,9999,0
1668220242211,ECE 202,A00,103644,Kuzum; Duygu,0,0,0,0
1668220242641,ECE 212BN,A00,103646,Ng; Tse Nga,0,0,0,0
1668220243064,ECE 221,A00,111493,Staff,0,0,0,0
1668220243492,ECE 222B,A00,103647,Lomakin; Vitaliy,0,0,0,0
1668220243924,ECE 230B,A00,103648,Taur; Yuan,0,0,0,0
1668220244353,ECE 238B,A00,103649,Garay; Javier,0,0,0,0
1668220244784,ECE 240B,A00,112900,Fainman; Yeshaiahu,0,0,0,0
1668220245206,ECE 247A,A00,103650,Jokerst; Jesse Vincent,0,0,0,0
1668220245645,ECE 247B,A00,103651,Wang; Joseph,0,0,0,0
1668220246071,ECE 250,A00,103652,Siegel; Paul H.,0,0,0,0
1668220246493,ECE 251A,A00,103654,Rao; Bhaskar D.,0,0,0,0
1668220246930,ECE 257B,A00,103655,Bharadia; Dinesh,0,0,0,0
1668220247352,ECE 258A,A00,103656,Milstein; Laurence B.,0,0,0,0
1668220247775,ECE 260B,A00,103658,Kang; Mingu,0,0,0,0
1668220248201,ECE 264A,A00,103659,Galton; Ian A,0,0,0,0
1668220248628,ECE 265A,A00,103661,Gudem; Prasad S.S.,0,0,0,0
1668220249053,ECE 265D,A00,103662,Gudem; Prasad S.S.,0,0,0,0
1668220249479,ECE 268,A00,103663,Koushanfar; Farinaz,0,0,0,0
1668220249906,ECE 269,A01,103665,Pal; Piya,0,0,0,0
1668220250331,ECE 271B,A00,103666,Vasconcelos; Manuela,0,0,0,0
1668220250755,ECE 276A,A00,103667,Atanasov; Nikolay A.,0,0,0,0
1668220251178,ECE 277,A00,103668,An; Cheolhong,0,0,0,0
1668220251620,ECE 279,A00,117947,Hall; Drew A.,0,0,0,0
1668220252485,ECE 283,A00,103670,Hsueh; Tzu-Chien,0,0,0,0
1668220252918,ECE 284,A00,103671,Turakhia; Yatish Girish,0,0,0,0
1668220253367,ECE 285,A00,103672,Zheng; Yang,0,0,0,0
1668220253367,ECE 285,B00,103673,Sworder; David D.,0,0,0,0
1668220253905,ECE 287,A00,103676,Javidi; Tara,0,0,0,0
1668220254335,MATH 200B,A00,098023,Salehi Golsefidy; Alireza,12,0,15,3
1668220254767,MATH 202B,A00,098024,Rhoades; Brendon Patrick,9,0,15,6
1668220255191,MATH 203B,A00,098025,Oprea; Dragos N.,10,0,15,5
1668220255623,MATH 204B,A00,098026,Sorensen; Claus M,13,0,15,2
1668220256048,MATH 208,A00,098027,Izadi; Elham,7,0,10,3
1668220256478,MATH 209,A00,098028,Pollack; Aaron,10,0,10,0
1668220256913,MATH 211A,A00,112919,Rogalski; Daniel,9,0,10,1
1668220257336,MATH 211B,A00,112920,Seward; Brandon M.,9,0,10,1
1668220257760,MATH 218,A00,098029,Li; Bo,10,0,10,0
1668220258185,MATH 220B,A00,098030,Novak; Jonathan I,11,0,15,4
1668220258607,MATH 221A,A00,098031,Ebenfelt; Peter F,13,0,15,2
1668220259031,MATH 231B,A00,098032,Zlatos; Andrej,12,0,15,3
1668220259468,MATH 240B,A00,098033,Ni; Lei,9,0,15,6
1668220259899,MATH 243,A00,098034,Jekel; David Andrew,10,0,10,0
1668220260329,MATH 245A,A00,098035,Nie; Jiawang,0,0,15,16
1668220260801,MATH 248,A00,098036,Bejenaru; Ioan,10,0,10,0
1668220261229,MATH 250B,A00,098037,Spolaor; Luca,14,0,15,1
1668220261860,MATH 258,A00,098038,Ni; Lei,10,0,10,0
1668220262286,MATH 264B,A00,098041,Rhoades; Brendon Patrick,9,0,15,6
1668220262720,MATH 268,A00,098042,Buss; Samuel R,10,0,10,0
1668220263146,MATH 269,A00,098043,Rhoades; Brendon Patrick,10,0,10,0
1668220263572,MATH 270B,A00,098044,Li; Bo,10,0,15,5
1668220264008,MATH 272B,A00,098045,Holst; Michael J,13,0,15,2
1668220264441,MATH 273A,A00,098046,Tian; Xiaochuan,10,0,15,5
1668220264868,MATH 275,A01,098048,Tian; Xiaochuan,6,0,10,4
1668220265293,MATH 278A,A00,098049,Holst; Michael J,8,0,10,2
1668220265718,MATH 278B,A00,098050,Cloninger; Alexander,10,0,10,0
1668220266165,MATH 278C,A00,098051,Nie; Jiawang,7,0,10,3
1668220266589,MATH 280B,A00,098052,Zheng; Tianyi,10,0,15,5
1668220267025,MATH 281B,A00,098053,Bradic; Jelena,2,0,15,13
1668220267450,MATH 282B,A00,098054,Arias-Castro; Ery,0,0,15,15
1668220267873,MATH 285,A00,098055,Fitzsimmons; Patrick J,0,0,15,17
1668220268299,MATH 287B,A00,098056,Arias-Castro; Ery,2,0,15,13
1668220268727,MATH 288,A00,098057,Agarwal; Pooja,9,0,10,1
1668220268727,MATH 288,B00,098058,Zhang; Danna,8,0,10,2
1668220268727,MATH 288,C00,098059,Williams; Ruth J,10,0,10,0
1668220269151,MATH 290B,A00,098060,Roberts; Justin Deritter,13,0,15,2
1668220269579,MATH 292,A00,098061,Belmont; Eva Kinoshita,10,0,10,0
1668220270005,MATH 295,A00,098062,Suk; Andrew Hoon,48,0,50,2
1668220270429,MATH 296,A00,098063,Novak; Jonathan I,20,0,20,0
1668220270851,MATH 297,001,098064,Gamst; Anthony Collins,9997,0,9999,2
1668220774770,COGS 205,A00,101395,Chiba; Andrea,19,0,20,1
1668220775199,COGS 210B,001,101404,Greene; Deanna Jacquelyn,9998,0,9999,1
1668220775199,COGS 210B,002,101417,Xia; Haijun,9999,0,9999,0
1668220775199,COGS 210B,003,101422,Nitz; Douglas A.,9999,0,9999,0
1668220775199,COGS 210B,004,101423,Hollan; James D.,9998,0,9999,1
1668220775199,COGS 210B,005,101424,Deak; Gedeon O.,9998,0,9999,1
1668220775199,COGS 210B,006,101425,Rossano; Federico,9999,0,9999,0
1668220775624,COGS 211B,A00,101427,Coulson; Seana M,9996,0,9999,3
1668220776046,COGS 220,A00,101428,Hollan; James D.,0,0,25,25
1668220776480,COGS 229,A00,101429,Dow; Steven P,18,0,25,7
1668220776912,COGS 230,A00,101430,Klemmer; Scott R,12,0,17,5
1668220777343,COGS 234,A00,101431,Xia; Haijun,2,0,25,23
1668220777767,COGS 260,A00,101432,Kiyonaga; Anastasia,21,0,25,4
1668220777767,COGS 260,B00,101433,Kirsh; David Joel,15,0,25,10
1668220778274,CSE 202,A00,102371,Impagliazzo; Russell,0,0,0,0
1668220778706,CSE 203B,A01,102373,Cheng; Chung Kuan,0,0,0,0
1668220779129,CSE 208,A00,102374,Micciancio; Daniele,0,0,0,0
1668220779554,CSE 209A,A00,112895,Impagliazzo; Russell,0,0,15,15
1668220779980,CSE 209B,A00,108005,Bellare; Mihir,0,0,0,0
1668220780410,CSE 210,A00,113163,Coblenz; Michael J,0,0,0,0
1668220780834,CSE 219,A00,106111,Dow; Steven P,0,0,20,20
1668220781263,CSE 221,A00,102376,Voelker; Geoffrey M.,0,0,0,0
1668220781695,CSE 224,A01,102378,Porter; George M,0,0,0,0
1668220782123,CSE 229A,A00,102379,Savage; Stefan,0,0,0,0
1668220782553,CSE 229C,A00,102380,Munyaka; Imani N. S.,0,0,0,0
1668220782981,CSE 232B,A00,102382,Deutsch; Alin Bernard,0,0,0,0
1668220783414,CSE 234,A01,112904,Kumar; Arun Kumar,0,0,0,0
1668220783856,CSE 237A,A00,102383,Rosing; Tajana Simunic,0,0,0,0
1668220784290,CSE 239A,A00,102384,Deutsch; Alin Bernard,0,0,0,0
1668220784712,CSE 239B,A00,102385,Polikarpova; Nadezhda,0,0,0,0
1668220785147,CSE 240A,A00,102386,Pannuto; Patrick William,0,0,0,0
1668220785573,CSE 240B,A00,102387,Zhao; Jishen,0,0,0,0
1668220785997,CSE 241A,A00,106406,Kang; Mingu,0,0,0,0
1668220786421,CSE 249B,A00,102388,Kahng; Andrew Byun,0,0,8,8
1668220786858,CSE 251B,A01,102392,Cottrell; Garrison W,0,0,0,0
1668220786858,CSE 251B,A02,102393,Cottrell; Garrison W,0,0,0,0
1668220787282,CSE 252B,A00,102394,Ochoa; Benjamin Lawrence,0,0,0,0
1668220787715,CSE 257,A01,102396,Gao; Sicun,0,0,0,0
1668220788151,CSE 272,A00,102397,Li; Tzumao,0,0,0,0
1668220788584,CSE 274,A00,111323,Chern; Albert Ren-Haur,0,0,0,0
1668220789007,CSE 282,A00,102398,Pevzner; Pavel Arkadjevich,0,0,0,0
1668220789429,CSE 284,A00,114175,Gymrek; Melissa Ann,0,0,0,0
1668220789858,CSE 290,A00,102399,Chandraker; Manmohan Krishna,0,0,0,0
1668220789858,CSE 290,B00,102400,Vaccaro; Kristen Marie,0,0,25,25
1668220789858,CSE 290,C00,102414,Pannuto; Patrick William,0,0,25,25
1668220789858,CSE 290,D00,102427,Pevzner; Pavel Arkadjevich,0,0,0,0
1668220789858,CSE 290,E00,102429,Zhao; Jishen,0,0,0,0
1668220789858,CSE 290,F00,102436,Tullsen; Dean Michael,0,0,0,0
1668220789858,CSE 290,G00,102440,Christensen; Henrik I,0,0,20,20
1668220790292,CSE 291,A00,102443,Su; Hao,0,0,0,0
1668220790292,CSE 291,B00,102448,Polikarpova; Nadezhda,0,0,0,0
1668220790292,CSE 291,C00,102453,Vaccaro; Kristen Marie,0,0,0,0
1668220790292,CSE 291,D00,111343,Savage; Stefan,0,0,0,0
1668220790292,CSE 291,E00,116474,Claffy; Kimberly Claire,0,0,0,0
1668220790292,CSE 291,F00,116479,Pasquale; Joseph,0,0,0,0
1668220790728,CSE 293,001,119111,Bafna; Vineet,9999,0,9999,0
1668220790728,CSE 293,002,119118,Bellare; Mihir,9999,0,9999,0
1668220790728,CSE 293,003,119122,Berg-Kirkpatrick; Taylor D,9999,0,9999,0
1668220790728,CSE 293,004,119135,Christensen; Henrik I,9999,0,9999,0
1668220790728,CSE 293,005,119142,Cottrell; Garrison W,9999,0,9999,0
1668220790728,CSE 293,006,119146,Deutsch; Alin Bernard,9999,0,9999,0
1668220790728,CSE 293,007,119159,Esmaeilzadeh; Hadi,9999,0,9999,0
1668220790728,CSE 293,008,119166,Freund; Yoav,9999,0,9999,0
1668220790728,CSE 293,009,119170,Griswold; William G.,9999,0,9999,0
1668220790728,CSE 293,010,119183,Gymrek; Melissa Ann,9999,0,9999,0
1668220790728,CSE 293,011,119190,Heninger; Nadia A,9999,0,9999,0
1668220790728,CSE 293,012,119230,Impagliazzo; Russell,9999,0,9999,0
1668220790728,CSE 293,013,119232,Jhala; Ranjit,9999,0,9999,0
1668220790728,CSE 293,014,119233,Kahng; Andrew Byun,9999,0,9999,0
1668220790728,CSE 293,015,119298,Kane; Daniel Mertz,9999,0,9999,0
1668220790728,CSE 293,016,119299,Kriegman; David J,9999,0,9999,0
1668220790728,CSE 293,017,119300,Kumar; Arun Kumar,9999,0,9999,0
1668220790728,CSE 293,018,119301,Lerner; Sorin,9999,0,9999,0
1668220790728,CSE 293,019,119302,Lovett; Shachar,9999,0,9999,0
1668220790728,CSE 293,020,119303,McAuley; Julian John,9999,0,9999,0
1668220790728,CSE 293,021,119304,Micciancio; Daniele,9999,0,9999,0
1668220790728,CSE 293,022,119367,Orailoglu; Alex,9999,0,9999,0
1668220790728,CSE 293,023,119382,Paturi; Ramamohan,9999,0,9999,0
1668220790728,CSE 293,024,119404,Polikarpova; Nadezhda,9999,0,9999,0
1668220790728,CSE 293,025,119406,Politz; Joseph Gibbs,9999,0,9999,0
1668220790728,CSE 293,026,119411,Porter; George M,9999,0,9999,0
1668220790728,CSE 293,027,119414,Porter; Leonard Emerson,9999,0,9999,0
1668220790728,CSE 293,028,119416,Ramamoorthi; Ravi,9999,0,9999,0
1668220790728,CSE 293,029,119417,Sahoo; Debashis,9999,0,9999,0
1668220790728,CSE 293,030,119420,Saul; Lawrence,9999,0,9999,0
1668220790728,CSE 293,031,119421,Savage; Stefan,9999,0,9999,0
1668220790728,CSE 293,032,119425,Schulze; Jurgen P.,9999,0,9999,0
1668220790728,CSE 293,033,119426,Snoeren; Alex C.,9999,0,9999,0
1668220790728,CSE 293,034,119428,Shang; Jingbo,9999,0,9999,0
1668220790728,CSE 293,035,119430,Stefan; Deian,9999,0,9999,0
1668220790728,CSE 293,036,119431,Su; Hao,9999,0,9999,0
1668220790728,CSE 293,037,119433,Swanson; Steven James,9999,0,9999,0
1668220790728,CSE 293,038,119435,Tullsen; Dean Michael,9999,0,9999,0
1668220790728,CSE 293,039,119483,Voelker; Geoffrey M.,9999,0,9999,0
1668220790728,CSE 293,040,119537,Zhao; Jishen,9999,0,9999,0
1668220790728,CSE 293,041,119538,Zhou; Yuan-Yuan,9999,0,9999,0
1668220790728,CSE 293,042,119539,Gao; Sicun,9999,0,9999,0
1668220790728,CSE 293,043,119540,Weibel; Nadir,9999,0,9999,0
1668220790728,CSE 293,044,119541,Gupta; Rajesh K.,9999,0,9999,0
1668220790728,CSE 293,045,126410,Vaccaro; Kristen Marie,9999,0,9999,0
1668220790728,CSE 293,046,126411,Klemke; Richard,9999,0,9999,0
1668220791151,CSE 294,A00,102459,Voelker; Geoffrey M.,0,0,0,0
1668220791151,CSE 294,B00,111322,Orailoglu; Alex,0,0,0,0
1668220791578,DSE 201,A00,096914,Deutsch; Alin Bernard,30,0,30,0
1668220792017,DSE 210,A00,096915,Dasgupta; Sanjoy,30,0,30,0
1668220792450,DSE 260A,A00,096916,Altintas De Callaf; Ilkay,30,0,30,0
1668220792880,ECE 200,001,103586,Antipa; Nicholas A,9999,0,9999,0
1668220792880,ECE 200,002,103587,Atanasov; Nikolay A.,9999,0,9999,0
1668220792880,ECE 200,003,103588,Bharadia; Dinesh,9999,0,9999,0
1668220792880,ECE 200,004,103589,Cheng; Chung Kuan,9999,0,9999,0
1668220792880,ECE 200,005,103590,Cosman; Pamela C.,9999,0,9999,0
1668220792880,ECE 200,006,103591,Dayeh; Shadi Ahmad,9999,0,9999,0
1668220792880,ECE 200,007,103592,Fainman; Yeshaiahu,9999,0,9999,0
1668220792880,ECE 200,008,103593,Ford; Joseph Earl,9999,0,9999,0
1668220792880,ECE 200,009,103594,Franceschetti; Massimo,9999,0,9999,0
1668220792880,ECE 200,010,103595,Fullerton; Eric E,9999,0,9999,0
1668220792880,ECE 200,011,103596,Galton; Ian A,9999,0,9999,0
1668220792880,ECE 200,012,103597,Gilja; Vikash,9999,0,9999,0
1668220792880,ECE 200,013,103598,Hall; Drew A.,9999,0,9999,0
1668220792880,ECE 200,014,103599,Hsueh; Tzu-Chien,9999,0,9999,0
1668220792880,ECE 200,015,103600,Javidi; Tara,9999,0,9999,0
1668220792880,ECE 200,016,103601,Kahng; Andrew Byun,9999,0,9999,0
1668220792880,ECE 200,017,103602,Kim; Young-Han,9999,0,9999,0
1668220792880,ECE 200,018,103603,Koushanfar; Farinaz,9999,0,9999,0
1668220792880,ECE 200,019,103604,Kuzum; Duygu,9999,0,9999,0
1668220792880,ECE 200,020,103605,Le; Hanh-Phuc,9999,0,9999,0
1668220792880,ECE 200,021,103606,Lin; Bill,9999,0,9999,0
1668220792880,ECE 200,022,103607,Liu; Zhaowei,9998,0,9999,1
1668220792880,ECE 200,023,103608,Lo; Yu-Hwa,9999,0,9999,0
1668220792880,ECE 200,024,103609,Lomakin; Vitaliy,9999,0,9999,0
1668220792880,ECE 200,025,103610,Mercier; Patrick Philip,9999,0,9999,0
1668220792880,ECE 200,026,103611,Meyer; Florian,9999,0,9999,0
1668220792880,ECE 200,027,103612,Milstein; Laurence B.,9999,0,9999,0
1668220792880,ECE 200,028,103613,Mir Arabbaygi; Siavash,9999,0,9999,0
1668220792880,ECE 200,029,103614,Mookherjea; Shayan,9999,0,9999,0
1668220792880,ECE 200,030,103615,Morris; Karcher William,9999,0,9999,0
1668220792880,ECE 200,031,103616,Ng; Tse Nga,9999,0,9999,0
1668220792880,ECE 200,032,103617,Nguyen; Truong Quang,9999,0,9999,0
1668220792880,ECE 200,033,103618,Nomura; Kenji,9999,0,9999,0
1668220792880,ECE 200,034,103619,Orlitsky; Alon,9999,0,9999,0
1668220792880,ECE 200,035,103620,Pal; Piya,9999,0,9999,0
1668220792880,ECE 200,036,103621,Papen; George C.,9999,0,9999,0
1668220792880,ECE 200,037,103622,Radic; Stojan,9999,0,9999,0
1668220792880,ECE 200,038,103623,Rao; Bhaskar D.,9999,0,9999,0
1668220792880,ECE 200,039,103624,Rao; Ramesh R,9999,0,9999,0
1668220792880,ECE 200,040,103625,Rebeiz; Gabriel,9999,0,9999,0
1668220792880,ECE 200,041,103626,Sanford; John R,9999,0,9999,0
1668220792880,ECE 200,042,103627,Siegel; Paul H.,9999,0,9999,0
1668220792880,ECE 200,043,103628,Sievenpiper; Daniel F.,9999,0,9999,0
1668220792880,ECE 200,044,103629,Sworder; David D.,9999,0,9999,0
1668220792880,ECE 200,045,103630,Taur; Yuan,9999,0,9999,0
1668220792880,ECE 200,046,103631,Touri; Behrouz,9999,0,9999,0
1668220792880,ECE 200,047,103632,Trivedi; Mohan M.,9999,0,9999,0
1668220792880,ECE 200,048,103633,Vasconcelos; Nuno,9999,0,9999,0
1668220792880,ECE 200,049,103634,Wang; Xiaolong,9999,0,9999,0
1668220792880,ECE 200,050,103635,Xie; Pengtao,9999,0,9999,0
1668220792880,ECE 200,051,103636,Yip; Michael,9999,0,9999,0
1668220792880,ECE 200,052,103637,Zeger; Kenneth A.,999,0,999,0
1668220792880,ECE 200,053,103638,Zhang; Xinyu,9999,0,9999,0
1668220792880,ECE 200,054,103639,Turakhia; Yatish Girish,9999,0,9999,0
1668220792880,ECE 200,055,103640,Kang; Mingu,9999,0,9999,0
1668220792880,ECE 200,056,103641,Shi; Yuanyuan,9999,0,9999,0
1668220792880,ECE 200,057,103642,Wang; Edward Jay,9999,0,9999,0
1668220792880,ECE 200,058,103643,Zheng; Yang,9999,0,9999,0
1668220793313,ECE 202,A00,103644,Kuzum; Duygu,0,0,0,0
1668220793738,ECE 212BN,A00,103646,Ng; Tse Nga,0,0,0,0
1668220794160,ECE 221,A00,111493,Staff,0,0,0,0
1668220794589,ECE 222B,A00,103647,Lomakin; Vitaliy,0,0,0,0
1668220795014,ECE 230B,A00,103648,Taur; Yuan,0,0,0,0
1668220795451,ECE 238B,A00,103649,Garay; Javier,0,0,0,0
1668220795872,ECE 240B,A00,112900,Fainman; Yeshaiahu,0,0,0,0
1668220796311,ECE 247A,A00,103650,Jokerst; Jesse Vincent,0,0,0,0
1668220796736,ECE 247B,A00,103651,Wang; Joseph,0,0,0,0
1668220797163,ECE 250,A00,103652,Siegel; Paul H.,0,0,0,0
1668220797587,ECE 251A,A00,103654,Rao; Bhaskar D.,0,0,0,0
1668220798012,ECE 257B,A00,103655,Bharadia; Dinesh,0,0,0,0
1668220798435,ECE 258A,A00,103656,Milstein; Laurence B.,0,0,0,0
1668220798866,ECE 260B,A00,103658,Kang; Mingu,0,0,0,0
1668220799291,ECE 264A,A00,103659,Galton; Ian A,0,0,0,0
1668220799714,ECE 265A,A00,103661,Gudem; Prasad S.S.,0,0,0,0
1668220800158,ECE 265D,A00,103662,Gudem; Prasad S.S.,0,0,0,0
1668220800588,ECE 268,A00,103663,Koushanfar; Farinaz,0,0,0,0
1668220801779,ECE 269,A01,103665,Pal; Piya,0,0,0,0
1668220802410,ECE 271B,A00,103666,Vasconcelos; Manuela,0,0,0,0
1668220802881,ECE 276A,A00,103667,Atanasov; Nikolay A.,0,0,0,0
1668220803305,ECE 277,A00,103668,An; Cheolhong,0,0,0,0
1668220803741,ECE 279,A00,117947,Hall; Drew A.,0,0,0,0
1668220815159,ECE 283,A00,103670,Hsueh; Tzu-Chien,0,0,0,0
1668220815587,ECE 284,A00,103671,Turakhia; Yatish Girish,0,0,0,0
1668220816010,ECE 285,A00,103672,Zheng; Yang,0,0,0,0
1668220816010,ECE 285,B00,103673,Sworder; David D.,0,0,0,0
1668220816432,ECE 287,A00,103676,Javidi; Tara,0,0,0,0
1668220816857,MATH 200B,A00,098023,Salehi Golsefidy; Alireza,12,0,15,3
1668220817283,MATH 202B,A00,098024,Rhoades; Brendon Patrick,9,0,15,6
1668220817752,MATH 203B,A00,098025,Oprea; Dragos N.,10,0,15,5
1668220818183,MATH 204B,A00,098026,Sorensen; Claus M,13,0,15,2
1668220818606,MATH 208,A00,098027,Izadi; Elham,7,0,10,3
1668220819046,MATH 209,A00,098028,Pollack; Aaron,10,0,10,0
1668220819468,MATH 211A,A00,112919,Rogalski; Daniel,9,0,10,1
1668220819895,MATH 211B,A00,112920,Seward; Brandon M.,9,0,10,1
1668220820320,MATH 218,A00,098029,Li; Bo,10,0,10,0
1668220820744,MATH 220B,A00,098030,Novak; Jonathan I,11,0,15,4
1668220821172,MATH 221A,A00,098031,Ebenfelt; Peter F,13,0,15,2
1668220821597,MATH 231B,A00,098032,Zlatos; Andrej,12,0,15,3
1668220822030,MATH 240B,A00,098033,Ni; Lei,9,0,15,6
1668220822455,MATH 243,A00,098034,Jekel; David Andrew,10,0,10,0
1668220822877,MATH 245A,A00,098035,Nie; Jiawang,0,0,15,16
1668220823307,MATH 248,A00,098036,Bejenaru; Ioan,10,0,10,0
1668220823732,MATH 250B,A00,098037,Spolaor; Luca,14,0,15,1
1668220824180,MATH 258,A00,098038,Ni; Lei,10,0,10,0
1668220824608,MATH 264B,A00,098041,Rhoades; Brendon Patrick,9,0,15,6
1668220825037,MATH 268,A00,098042,Buss; Samuel R,10,0,10,0
1668220825461,MATH 269,A00,098043,Rhoades; Brendon Patrick,10,0,10,0
1668220825895,MATH 270B,A00,098044,Li; Bo,10,0,15,5
1668220826321,MATH 272B,A00,098045,Holst; Michael J,13,0,15,2
1668220826757,MATH 273A,A00,098046,Tian; Xiaochuan,10,0,15,5
1668220827197,MATH 275,A01,098048,Tian; Xiaochuan,6,0,10,4
1668220827618,MATH 278A,A00,098049,Holst; Michael J,8,0,10,2
1668220828045,MATH 278B,A00,098050,Cloninger; Alexander,10,0,10,0
1668220828469,MATH 278C,A00,098051,Nie; Jiawang,7,0,10,3
1668220828892,MATH 280B,A00,098052,Zheng; Tianyi,10,0,15,5
1668220829316,MATH 281B,A00,098053,Bradic; Jelena,2,0,15,13
1668220829740,MATH 282B,A00,098054,Arias-Castro; Ery,0,0,15,15
1668220830188,MATH 285,A00,098055,Fitzsimmons; Patrick J,0,0,15,17
1668220830618,MATH 287B,A00,098056,Arias-Castro; Ery,2,0,15,13
1668220831046,MATH 288,A00,098057,Agarwal; Pooja,9,0,10,1
1668220831046,MATH 288,B00,098058,Zhang; Danna,8,0,10,2
1668220831046,MATH 288,C00,098059,Williams; Ruth J,10,0,10,0
1668220831467,MATH 290B,A00,098060,Roberts; Justin Deritter,13,0,15,2
1668220831912,MATH 292,A00,098061,Belmont; Eva Kinoshita,10,0,10,0
1668220832341,MATH 295,A00,098062,Suk; Andrew Hoon,48,0,50,2
1668220832770,MATH 296,A00,098063,Novak; Jonathan I,20,0,20,0
1668220833298,MATH 297,001,098064,Gamst; Anthony Collins,9997,0,9999,2
1668221335911,COGS 205,A00,101395,Chiba; Andrea,19,0,20,1
1668221336344,COGS 210B,001,101404,Greene; Deanna Jacquelyn,9998,0,9999,1
1668221336344,COGS 210B,002,101417,Xia; Haijun,9999,0,9999,0
1668221336344,COGS 210B,003,101422,Nitz; Douglas A.,9999,0,9999,0
1668221336344,COGS 210B,004,101423,Hollan; James D.,9998,0,9999,1
1668221336344,COGS 210B,005,101424,Deak; Gedeon O.,9998,0,9999,1
1668221336344,COGS 210B,006,101425,Rossano; Federico,9999,0,9999,0
1668221336769,COGS 211B,A00,101427,Coulson; Seana M,9996,0,9999,3
1668221337192,COGS 220,A00,101428,Hollan; James D.,0,0,25,25
1668221337614,COGS 229,A00,101429,Dow; Steven P,18,0,25,7
1668221338037,COGS 230,A00,101430,Klemmer; Scott R,12,0,17,5
1668221338460,COGS 234,A00,101431,Xia; Haijun,2,0,25,23
1668221338900,COGS 260,A00,101432,Kiyonaga; Anastasia,21,0,25,4
1668221338900,COGS 260,B00,101433,Kirsh; David Joel,15,0,25,10
1668221339333,CSE 202,A00,102371,Impagliazzo; Russell,0,0,0,0
1668221339758,CSE 203B,A01,102373,Cheng; Chung Kuan,0,0,0,0
1668221340183,CSE 208,A00,102374,Micciancio; Daniele,0,0,0,0
1668221340612,CSE 209A,A00,112895,Impagliazzo; Russell,0,0,15,15
1668221341041,CSE 209B,A00,108005,Bellare; Mihir,0,0,0,0
1668221341471,CSE 210,A00,113163,Coblenz; Michael J,0,0,0,0
1668221341910,CSE 219,A00,106111,Dow; Steven P,0,0,20,20
1668221342336,CSE 221,A00,102376,Voelker; Geoffrey M.,0,0,0,0
1668221342761,CSE 224,A01,102378,Porter; George M,0,0,0,0
1668221343182,CSE 229A,A00,102379,Savage; Stefan,0,0,0,0
1668221343607,CSE 229C,A00,102380,Munyaka; Imani N. S.,0,0,0,0
1668221344029,CSE 232B,A00,102382,Deutsch; Alin Bernard,0,0,0,0
1668221344460,CSE 234,A01,112904,Kumar; Arun Kumar,0,0,0,0
1668221344896,CSE 237A,A00,102383,Rosing; Tajana Simunic,0,0,0,0
1668221345333,CSE 239A,A00,102384,Deutsch; Alin Bernard,0,0,0,0
1668221345760,CSE 239B,A00,102385,Polikarpova; Nadezhda,0,0,0,0
1668221346186,CSE 240A,A00,102386,Pannuto; Patrick William,0,0,0,0
1668221346609,CSE 240B,A00,102387,Zhao; Jishen,0,0,0,0
1668221347036,CSE 241A,A00,106406,Kang; Mingu,0,0,0,0
1668221347460,CSE 249B,A00,102388,Kahng; Andrew Byun,0,0,8,8
1668221347886,CSE 251B,A01,102392,Cottrell; Garrison W,0,0,0,0
1668221347886,CSE 251B,A02,102393,Cottrell; Garrison W,0,0,0,0
1668221348311,CSE 252B,A00,102394,Ochoa; Benjamin Lawrence,0,0,0,0
1668221348737,CSE 257,A01,102396,Gao; Sicun,0,0,0,0
1668221349161,CSE 272,A00,102397,Li; Tzumao,0,0,0,0
1668221349586,CSE 274,A00,111323,Chern; Albert Ren-Haur,0,0,0,0
1668221350013,CSE 282,A00,102398,Pevzner; Pavel Arkadjevich,0,0,0,0
1668221350440,CSE 284,A00,114175,Gymrek; Melissa Ann,0,0,0,0
1668221350865,CSE 290,A00,102399,Chandraker; Manmohan Krishna,0,0,0,0
1668221350865,CSE 290,B00,102400,Vaccaro; Kristen Marie,0,0,25,25
1668221350865,CSE 290,C00,102414,Pannuto; Patrick William,0,0,25,25
1668221350865,CSE 290,D00,102427,Pevzner; Pavel Arkadjevich,0,0,0,0
1668221350865,CSE 290,E00,102429,Zhao; Jishen,0,0,0,0
1668221350865,CSE 290,F00,102436,Tullsen; Dean Michael,0,0,0,0
1668221350865,CSE 290,G00,102440,Christensen; Henrik I,0,0,20,20
1668221351293,CSE 291,A00,102443,Su; Hao,0,0,0,0
1668221351293,CSE 291,B00,102448,Polikarpova; Nadezhda,0,0,0,0
1668221351293,CSE 291,C00,102453,Vaccaro; Kristen Marie,0,0,0,0
1668221351293,CSE 291,D00,111343,Savage; Stefan,0,0,0,0
1668221351293,CSE 291,E00,116474,Claffy; Kimberly Claire,0,0,0,0
1668221351293,CSE 291,F00,116479,Pasquale; Joseph,0,0,0,0
1668221351735,CSE 293,001,119111,Bafna; Vineet,9999,0,9999,0
1668221351735,CSE 293,002,119118,Bellare; Mihir,9999,0,9999,0
1668221351735,CSE 293,003,119122,Berg-Kirkpatrick; Taylor D,9999,0,9999,0
1668221351735,CSE 293,004,119135,Christensen; Henrik I,9999,0,9999,0
1668221351735,CSE 293,005,119142,Cottrell; Garrison W,9999,0,9999,0
1668221351735,CSE 293,006,119146,Deutsch; Alin Bernard,9999,0,9999,0
1668221351735,CSE 293,007,119159,Esmaeilzadeh; Hadi,9999,0,9999,0
1668221351735,CSE 293,008,119166,Freund; Yoav,9999,0,9999,0
1668221351735,CSE 293,009,119170,Griswold; William G.,9999,0,9999,0
1668221351735,CSE 293,010,119183,Gymrek; Melissa Ann,9999,0,9999,0
1668221351735,CSE 293,011,119190,Heninger; Nadia A,9999,0,9999,0
1668221351735,CSE 293,012,119230,Impagliazzo; Russell,9999,0,9999,0
1668221351735,CSE 293,013,119232,Jhala; Ranjit,9999,0,9999,0
1668221351735,CSE 293,014,119233,Kahng; Andrew Byun,9999,0,9999,0
1668221351735,CSE 293,015,119298,Kane; Daniel Mertz,9999,0,9999,0
1668221351735,CSE 293,016,119299,Kriegman; David J,9999,0,9999,0
1668221351735,CSE 293,017,119300,Kumar; Arun Kumar,9999,0,9999,0
1668221351735,CSE 293,018,119301,Lerner; Sorin,9999,0,9999,0
1668221351735,CSE 293,019,119302,Lovett; Shachar,9999,0,9999,0
1668221351735,CSE 293,020,119303,McAuley; Julian John,9999,0,9999,0
1668221351735,CSE 293,021,119304,Micciancio; Daniele,9999,0,9999,0
1668221351735,CSE 293,022,119367,Orailoglu; Alex,9999,0,9999,0
1668221351735,CSE 293,023,119382,Paturi; Ramamohan,9999,0,9999,0
1668221351735,CSE 293,024,119404,Polikarpova; Nadezhda,9999,0,9999,0
1668221351735,CSE 293,025,119406,Politz; Joseph Gibbs,9999,0,9999,0
1668221351735,CSE 293,026,119411,Porter; George M,9999,0,9999,0
1668221351735,CSE 293,027,119414,Porter; Leonard Emerson,9999,0,9999,0
1668221351735,CSE 293,028,119416,Ramamoorthi; Ravi,9999,0,9999,0
1668221351735,CSE 293,029,119417,Sahoo; Debashis,9999,0,9999,0
1668221351735,CSE 293,030,119420,Saul; Lawrence,9999,0,9999,0
1668221351735,CSE 293,031,119421,Savage; Stefan,9999,0,9999,0
1668221351735,CSE 293,032,119425,Schulze; Jurgen P.,9999,0,9999,0
1668221351735,CSE 293,033,119426,Snoeren; Alex C.,9999,0,9999,0
1668221351735,CSE 293,034,119428,Shang; Jingbo,9999,0,9999,0
1668221351735,CSE 293,035,119430,Stefan; Deian,9999,0,9999,0
1668221351735,CSE 293,036,119431,Su; Hao,9999,0,9999,0
1668221351735,CSE 293,037,119433,Swanson; Steven James,9999,0,9999,0
1668221351735,CSE 293,038,119435,Tullsen; Dean Michael,9999,0,9999,0
1668221351735,CSE 293,039,119483,Voelker; Geoffrey M.,9999,0,9999,0
1668221351735,CSE 293,040,119537,Zhao; Jishen,9999,0,9999,0
1668221351735,CSE 293,041,119538,Zhou; Yuan-Yuan,9999,0,9999,0
1668221351735,CSE 293,042,119539,Gao; Sicun,9999,0,9999,0
1668221351735,CSE 293,043,119540,Weibel; Nadir,9999,0,9999,0
1668221351735,CSE 293,044,119541,Gupta; Rajesh K.,9999,0,9999,0
1668221351735,CSE 293,045,126410,Vaccaro; Kristen Marie,9999,0,9999,0
1668221351735,CSE 293,046,126411,Klemke; Richard,9999,0,9999,0
1668221352158,CSE 294,A00,102459,Voelker; Geoffrey M.,0,0,0,0
1668221352158,CSE 294,B00,111322,Orailoglu; Alex,0,0,0,0
1668221352587,DSE 201,A00,096914,Deutsch; Alin Bernard,30,0,30,0
1668221353012,DSE 210,A00,096915,Dasgupta; Sanjoy,30,0,30,0
1668221353448,DSE 260A,A00,096916,Altintas De Callaf; Ilkay,30,0,30,0
1668221353883,ECE 200,001,103586,Antipa; Nicholas A,9999,0,9999,0
1668221353883,ECE 200,002,103587,Atanasov; Nikolay A.,9999,0,9999,0
1668221353883,ECE 200,003,103588,Bharadia; Dinesh,9999,0,9999,0
1668221353883,ECE 200,004,103589,Cheng; Chung Kuan,9999,0,9999,0
1668221353883,ECE 200,005,103590,Cosman; Pamela C.,9999,0,9999,0
1668221353883,ECE 200,006,103591,Dayeh; Shadi Ahmad,9999,0,9999,0
1668221353883,ECE 200,007,103592,Fainman; Yeshaiahu,9999,0,9999,0
1668221353883,ECE 200,008,103593,Ford; Joseph Earl,9999,0,9999,0
1668221353883,ECE 200,009,103594,Franceschetti; Massimo,9999,0,9999,0
1668221353883,ECE 200,010,103595,Fullerton; Eric E,9999,0,9999,0
1668221353883,ECE 200,011,103596,Galton; Ian A,9999,0,9999,0
1668221353883,ECE 200,012,103597,Gilja; Vikash,9999,0,9999,0
1668221353883,ECE 200,013,103598,Hall; Drew A.,9999,0,9999,0
1668221353883,ECE 200,014,103599,Hsueh; Tzu-Chien,9999,0,9999,0
1668221353883,ECE 200,015,103600,Javidi; Tara,9999,0,9999,0
1668221353883,ECE 200,016,103601,Kahng; Andrew Byun,9999,0,9999,0
1668221353883,ECE 200,017,103602,Kim; Young-Han,9999,0,9999,0
1668221353883,ECE 200,018,103603,Koushanfar; Farinaz,9999,0,9999,0
1668221353883,ECE 200,019,103604,Kuzum; Duygu,9999,0,9999,0
1668221353883,ECE 200,020,103605,Le; Hanh-Phuc,9999,0,9999,0
1668221353883,ECE 200,021,103606,Lin; Bill,9999,0,9999,0
1668221353883,ECE 200,022,103607,Liu; Zhaowei,9998,0,9999,1
1668221353883,ECE 200,023,103608,Lo; Yu-Hwa,9999,0,9999,0
1668221353883,ECE 200,024,103609,Lomakin; Vitaliy,9999,0,9999,0
1668221353883,ECE 200,025,103610,Mercier; Patrick Philip,9999,0,9999,0
1668221353883,ECE 200,026,103611,Meyer; Florian,9999,0,9999,0
1668221353883,ECE 200,027,103612,Milstein; Laurence B.,9999,0,9999,0
1668221353883,ECE 200,028,103613,Mir Arabbaygi; Siavash,9999,0,9999,0
1668221353883,ECE 200,029,103614,Mookherjea; Shayan,9999,0,9999,0
1668221353883,ECE 200,030,103615,Morris; Karcher William,9999,0,9999,0
1668221353883,ECE 200,031,103616,Ng; Tse Nga,9999,0,9999,0
1668221353883,ECE 200,032,103617,Nguyen; Truong Quang,9999,0,9999,0
1668221353883,ECE 200,033,103618,Nomura; Kenji,9999,0,9999,0
1668221353883,ECE 200,034,103619,Orlitsky; Alon,9999,0,9999,0
1668221353883,ECE 200,035,103620,Pal; Piya,9999,0,9999,0
1668221353883,ECE 200,036,103621,Papen; George C.,9999,0,9999,0
1668221353883,ECE 200,037,103622,Radic; Stojan,9999,0,9999,0
1668221353883,ECE 200,038,103623,Rao; Bhaskar D.,9999,0,9999,0
1668221353883,ECE 200,039,103624,Rao; Ramesh R,9999,0,9999,0
1668221353883,ECE 200,040,103625,Rebeiz; Gabriel,9999,0,9999,0
1668221353883,ECE 200,041,103626,Sanford; John R,9999,0,9999,0
1668221353883,ECE 200,042,103627,Siegel; Paul H.,9999,0,9999,0
1668221353883,ECE 200,043,103628,Sievenpiper; Daniel F.,9999,0,9999,0
1668221353883,ECE 200,044,103629,Sworder; David D.,9999,0,9999,0
1668221353883,ECE 200,045,103630,Taur; Yuan,9999,0,9999,0
1668221353883,ECE 200,046,103631,Touri; Behrouz,9999,0,9999,0
1668221353883,ECE 200,047,103632,Trivedi; Mohan M.,9999,0,9999,0
1668221353883,ECE 200,048,103633,Vasconcelos; Nuno,9999,0,9999,0
1668221353883,ECE 200,049,103634,Wang; Xiaolong,9999,0,9999,0
1668221353883,ECE 200,050,103635,Xie; Pengtao,9999,0,9999,0
1668221353883,ECE 200,051,103636,Yip; Michael,9999,0,9999,0
1668221353883,ECE 200,052,103637,Zeger; Kenneth A.,999,0,999,0
1668221353883,ECE 200,053,103638,Zhang; Xinyu,9999,0,9999,0
1668221353883,ECE 200,054,103639,Turakhia; Yatish Girish,9999,0,9999,0
1668221353883,ECE 200,055,103640,Kang; Mingu,9999,0,9999,0
1668221353883,ECE 200,056,103641,Shi; Yuanyuan,9999,0,9999,0
1668221353883,ECE 200,057,103642,Wang; Edward Jay,9999,0,9999,0
1668221353883,ECE 200,058,103643,Zheng; Yang,9999,0,9999,0
1668221354305,ECE 202,A00,103644,Kuzum; Duygu,0,0,0,0
1668221354731,ECE 212BN,A00,103646,Ng; Tse Nga,0,0,0,0
1668221355164,ECE 221,A00,111493,Staff,0,0,0,0
1668221355613,ECE 222B,A00,103647,Lomakin; Vitaliy,0,0,0,0
1668221356127,ECE 230B,A00,103648,Taur; Yuan,0,0,0,0
1668221356553,ECE 238B,A00,103649,Garay; Javier,0,0,0,0
1668221356975,ECE 240B,A00,112900,Fainman; Yeshaiahu,0,0,0,0
1668221357399,ECE 247A,A00,103650,Jokerst; Jesse Vincent,0,0,0,0
1668221357825,ECE 247B,A00,103651,Wang; Joseph,0,0,0,0
1668221358252,ECE 250,A00,103652,Siegel; Paul H.,0,0,0,0
1668221358674,ECE 251A,A00,103654,Rao; Bhaskar D.,0,0,0,0
1668221359115,ECE 257B,A00,103655,Bharadia; Dinesh,0,0,0,0
1668221359539,ECE 258A,A00,103656,Milstein; Laurence B.,0,0,0,0
1668221359963,ECE 260B,A00,103658,Kang; Mingu,0,0,0,0
1668221360391,ECE 264A,A00,103659,Galton; Ian A,0,0,0,0
1668221360815,ECE 265A,A00,103661,Gudem; Prasad S.S.,0,0,0,0
1668221361250,ECE 265D,A00,103662,Gudem; Prasad S.S.,0,0,0,0
1668221361712,ECE 268,A00,103663,Koushanfar; Farinaz,0,0,0,0
1668221362152,ECE 269,A01,103665,Pal; Piya,0,0,0,0
1668221362579,ECE 271B,A00,103666,Vasconcelos; Manuela,0,0,0,0
1668221363006,ECE 276A,A00,103667,Atanasov; Nikolay A.,0,0,0,0
1668221363432,ECE 277,A00,103668,An; Cheolhong,0,0,0,0
1668221363856,ECE 279,A00,117947,Hall; Drew A.,0,0,0,0
1668221364709,ECE 283,A00,103670,Hsueh; Tzu-Chien,0,0,0,0
1668221365134,ECE 284,A00,103671,Turakhia; Yatish Girish,0,0,0,0
1668221365558,ECE 285,A00,103672,Zheng; Yang,0,0,0,0
1668221365558,ECE 285,B00,103673,Sworder; David D.,0,0,0,0
1668221365990,ECE 287,A00,103676,Javidi; Tara,0,0,0,0
1668221366413,MATH 200B,A00,098023,Salehi Golsefidy; Alireza,12,0,15,3
1668221366841,MATH 202B,A00,098024,Rhoades; Brendon Patrick,9,0,15,6
1668221367265,MATH 203B,A00,098025,Oprea; Dragos N.,10,0,15,5
1668221367690,MATH 204B,A00,098026,Sorensen; Claus M,13,0,15,2
1668221368122,MATH 208,A00,098027,Izadi; Elham,7,0,10,3
1668221368545,MATH 209,A00,098028,Pollack; Aaron,10,0,10,0
1668221368970,MATH 211A,A00,112919,Rogalski; Daniel,9,0,10,1
1668221369395,MATH 211B,A00,112920,Seward; Brandon M.,9,0,10,1
1668221369819,MATH 218,A00,098029,Li; Bo,10,0,10,0
1668221370254,MATH 220B,A00,098030,Novak; Jonathan I,11,0,15,4
1668221370677,MATH 221A,A00,098031,Ebenfelt; Peter F,13,0,15,2
1668221371099,MATH 231B,A00,098032,Zlatos; Andrej,12,0,15,3
1668221371523,MATH 240B,A00,098033,Ni; Lei,9,0,15,6
1668221371944,MATH 243,A00,098034,Jekel; David Andrew,10,0,10,0
1668221372369,MATH 245A,A00,098035,Nie; Jiawang,0,0,15,16
1668221372801,MATH 248,A00,098036,Bejenaru; Ioan,10,0,10,0
1668221373227,MATH 250B,A00,098037,Spolaor; Luca,14,0,15,1
1668221373655,MATH 258,A00,098038,Ni; Lei,10,0,10,0
1668221374079,MATH 264B,A00,098041,Rhoades; Brendon Patrick,9,0,15,6
1668221374506,MATH 268,A00,098042,Buss; Samuel R,10,0,10,0
1668221374930,MATH 269,A00,098043,Rhoades; Brendon Patrick,10,0,10,0
1668221375355,MATH 270B,A00,098044,Li; Bo,10,0,15,5
1668221375778,MATH 272B,A00,098045,Holst; Michael J,13,0,15,2
1668221376202,MATH 273A,A00,098046,Tian; Xiaochuan,10,0,15,5
1668221376627,MATH 275,A01,098048,Tian; Xiaochuan,6,0,10,4
1668221377050,MATH 278A,A00,098049,Holst; Michael J,8,0,10,2
1668221377478,MATH 278B,A00,098050,Cloninger; Alexander,10,0,10,0
1668221377903,MATH 278C,A00,098051,Nie; Jiawang,7,0,10,3
1668221378328,MATH 280B,A00,098052,Zheng; Tianyi,10,0,15,5
1668221378752,MATH 281B,A00,098053,Bradic; Jelena,2,0,15,13
1668221379190,MATH 282B,A00,098054,Arias-Castro; Ery,0,0,15,15
1668221379614,MATH 285,A00,098055,Fitzsimmons; Patrick J,0,0,15,17
1668221380043,MATH 287B,A00,098056,Arias-Castro; Ery,2,0,15,13
1668221380469,MATH 288,A00,098057,Agarwal; Pooja,9,0,10,1
1668221380469,MATH 288,B00,098058,Zhang; Danna,8,0,10,2
1668221380469,MATH 288,C00,098059,Williams; Ruth J,10,0,10,0
1668221380902,MATH 290B,A00,098060,Roberts; Justin Deritter,13,0,15,2
1668221381333,MATH 292,A00,098061,Belmont; Eva Kinoshita,10,0,10,0
1668221381759,MATH 295,A00,098062,Suk; Andrew Hoon,48,0,50,2
1668221382188,MATH 296,A00,098063,Novak; Jonathan I,20,0,20,0
1668221382615,MATH 297,001,098064,Gamst; Anthony Collins,9997,0,9999,2
1668221885749,COGS 205,A00,101395,Chiba; Andrea,19,0,20,1
1668221886180,COGS 210B,001,101404,Greene; Deanna Jacquelyn,9998,0,9999,1
1668221886180,COGS 210B,002,101417,Xia; Haijun,9999,0,9999,0
1668221886180,COGS 210B,003,101422,Nitz; Douglas A.,9999,0,9999,0
1668221886180,COGS 210B,004,101423,Hollan; James D.,9998,0,9999,1
1668221886180,COGS 210B,005,101424,Deak; Gedeon O.,9998,0,9999,1
1668221886180,COGS 210B,006,101425,Rossano; Federico,9999,0,9999,0
1668221886614,COGS 211B,A00,101427,Coulson; Seana M,9996,0,9999,3
1668221887041,COGS 220,A00,101428,Hollan; James D.,0,0,25,25
1668221887464,COGS 229,A00,101429,Dow; Steven P,18,0,25,7
1668221887889,COGS 230,A00,101430,Klemmer; Scott R,12,0,17,5
1668221888312,COGS 234,A00,101431,Xia; Haijun,2,0,25,23
1668221888736,COGS 260,A00,101432,Kiyonaga; Anastasia,21,0,25,4
1668221888736,COGS 260,B00,101433,Kirsh; David Joel,15,0,25,10
1668221889158,CSE 202,A00,102371,Impagliazzo; Russell,0,0,0,0
1668221889584,CSE 203B,A01,102373,Cheng; Chung Kuan,0,0,0,0
1668221890008,CSE 208,A00,102374,Micciancio; Daniele,0,0,0,0
1668221890439,CSE 209A,A00,112895,Impagliazzo; Russell,0,0,15,15
1668221890870,CSE 209B,A00,108005,Bellare; Mihir,0,0,0,0
1668221891299,CSE 210,A00,113163,Coblenz; Michael J,0,0,0,0
1668221891721,CSE 219,A00,106111,Dow; Steven P,0,0,20,20
1668221892144,CSE 221,A00,102376,Voelker; Geoffrey M.,0,0,0,0
1668221892567,CSE 224,A01,102378,Porter; George M,0,0,0,0
1668221892994,CSE 229A,A00,102379,Savage; Stefan,0,0,0,0
1668221893417,CSE 229C,A00,102380,Munyaka; Imani N. S.,0,0,0,0
1668221893843,CSE 232B,A00,102382,Deutsch; Alin Bernard,0,0,0,0
1668221894266,CSE 234,A01,112904,Kumar; Arun Kumar,0,0,0,0
1668221894689,CSE 237A,A00,102383,Rosing; Tajana Simunic,0,0,0,0
1668221895119,CSE 239A,A00,102384,Deutsch; Alin Bernard,0,0,0,0
1668221895541,CSE 239B,A00,102385,Polikarpova; Nadezhda,0,0,0,0
1668221895973,CSE 240A,A00,102386,Pannuto; Patrick William,0,0,0,0
1668221896400,CSE 240B,A00,102387,Zhao; Jishen,0,0,0,0
1668221896823,CSE 241A,A00,106406,Kang; Mingu,0,0,0,0
1668221897245,CSE 249B,A00,102388,Kahng; Andrew Byun,0,0,8,8
1668221897668,CSE 251B,A01,102392,Cottrell; Garrison W,0,0,0,0
1668221897668,CSE 251B,A02,102393,Cottrell; Garrison W,0,0,0,0
1668221898097,CSE 252B,A00,102394,Ochoa; Benjamin Lawrence,0,0,0,0
1668221898519,CSE 257,A01,102396,Gao; Sicun,0,0,0,0
1668221898950,CSE 272,A00,102397,Li; Tzumao,0,0,0,0
1668221899374,CSE 274,A00,111323,Chern; Albert Ren-Haur,0,0,0,0
1668221899801,CSE 282,A00,102398,Pevzner; Pavel Arkadjevich,0,0,0,0
1668221900224,CSE 284,A00,114175,Gymrek; Melissa Ann,0,0,0,0
1668221900651,CSE 290,A00,102399,Chandraker; Manmohan Krishna,0,0,0,0
1668221900651,CSE 290,B00,102400,Vaccaro; Kristen Marie,0,0,25,25
1668221900651,CSE 290,C00,102414,Pannuto; Patrick William,0,0,25,25
1668221900651,CSE 290,D00,102427,Pevzner; Pavel Arkadjevich,0,0,0,0
1668221900651,CSE 290,E00,102429,Zhao; Jishen,0,0,0,0
1668221900651,CSE 290,F00,102436,Tullsen; Dean Michael,0,0,0,0
1668221900651,CSE 290,G00,102440,Christensen; Henrik I,0,0,20,20
1668221901075,CSE 291,A00,102443,Su; Hao,0,0,0,0
1668221901075,CSE 291,B00,102448,Polikarpova; Nadezhda,0,0,0,0
1668221901075,CSE 291,C00,102453,Vaccaro; Kristen Marie,0,0,0,0
1668221901075,CSE 291,D00,111343,Savage; Stefan,0,0,0,0
1668221901075,CSE 291,E00,116474,Claffy; Kimberly Claire,0,0,0,0
1668221901075,CSE 291,F00,116479,Pasquale; Joseph,0,0,0,0
1668221901534,CSE 293,001,119111,Bafna; Vineet,9999,0,9999,0
1668221901534,CSE 293,002,119118,Bellare; Mihir,9999,0,9999,0
1668221901534,CSE 293,003,119122,Berg-Kirkpatrick; Taylor D,9999,0,9999,0
1668221901534,CSE 293,004,119135,Christensen; Henrik I,9999,0,9999,0
1668221901534,CSE 293,005,119142,Cottrell; Garrison W,9999,0,9999,0
1668221901534,CSE 293,006,119146,Deutsch; Alin Bernard,9999,0,9999,0
1668221901534,CSE 293,007,119159,Esmaeilzadeh; Hadi,9999,0,9999,0
1668221901534,CSE 293,008,119166,Freund; Yoav,9999,0,9999,0
1668221901534,CSE 293,009,119170,Griswold; William G.,9999,0,9999,0
1668221901534,CSE 293,010,119183,Gymrek; Melissa Ann,9999,0,9999,0
1668221901534,CSE 293,011,119190,Heninger; Nadia A,9999,0,9999,0
1668221901534,CSE 293,012,119230,Impagliazzo; Russell,9999,0,9999,0
1668221901534,CSE 293,013,119232,Jhala; Ranjit,9999,0,9999,0
1668221901534,CSE 293,014,119233,Kahng; Andrew Byun,9999,0,9999,0
1668221901534,CSE 293,015,119298,Kane; Daniel Mertz,9999,0,9999,0
1668221901534,CSE 293,016,119299,Kriegman; David J,9999,0,9999,0
1668221901534,CSE 293,017,119300,Kumar; Arun Kumar,9999,0,9999,0
1668221901534,CSE 293,018,119301,Lerner; Sorin,9999,0,9999,0
1668221901534,CSE 293,019,119302,Lovett; Shachar,9999,0,9999,0
1668221901534,CSE 293,020,119303,McAuley; Julian John,9999,0,9999,0
1668221901534,CSE 293,021,119304,Micciancio; Daniele,9999,0,9999,0
1668221901534,CSE 293,022,119367,Orailoglu; Alex,9999,0,9999,0
1668221901534,CSE 293,023,119382,Paturi; Ramamohan,9999,0,9999,0
1668221901534,CSE 293,024,119404,Polikarpova; Nadezhda,9999,0,9999,0
1668221901534,CSE 293,025,119406,Politz; Joseph Gibbs,9999,0,9999,0
1668221901534,CSE 293,026,119411,Porter; George M,9999,0,9999,0
1668221901534,CSE 293,027,119414,Porter; Leonard Emerson,9999,0,9999,0
1668221901534,CSE 293,028,119416,Ramamoorthi; Ravi,9999,0,9999,0
1668221901534,CSE 293,029,119417,Sahoo; Debashis,9999,0,9999,0
1668221901534,CSE 293,030,119420,Saul; Lawrence,9999,0,9999,0
1668221901534,CSE 293,031,119421,Savage; Stefan,9999,0,9999,0
1668221901534,CSE 293,032,119425,Schulze; Jurgen P.,9999,0,9999,0
1668221901534,CSE 293,033,119426,Snoeren; Alex C.,9999,0,9999,0
1668221901534,CSE 293,034,119428,Shang; Jingbo,9999,0,9999,0
1668221901534,CSE 293,035,119430,Stefan; Deian,9999,0,9999,0
1668221901534,CSE 293,036,119431,Su; Hao,9999,0,9999,0
1668221901534,CSE 293,037,119433,Swanson; Steven James,9999,0,9999,0
1668221901534,CSE 293,038,119435,Tullsen; Dean Michael,9999,0,9999,0
1668221901534,CSE 293,039,119483,Voelker; Geoffrey M.,9999,0,9999,0
1668221901534,CSE 293,040,119537,Zhao; Jishen,9999,0,9999,0
1668221901534,CSE 293,041,119538,Zhou; Yuan-Yuan,9999,0,9999,0
1668221901534,CSE 293,042,119539,Gao; Sicun,9999,0,9999,0
1668221901534,CSE 293,043,119540,Weibel; Nadir,9999,0,9999,0
1668221901534,CSE 293,044,119541,Gupta; Rajesh K.,9999,0,9999,0
1668221901534,CSE 293,045,126410,Vaccaro; Kristen Marie,9999,0,9999,0
1668221901534,CSE 293,046,126411,Klemke; Richard,9999,0,9999,0
1668221901956,CSE 294,A00,102459,Voelker; Geoffrey M.,0,0,0,0
1668221901956,CSE 294,B00,111322,Orailoglu; Alex,0,0,0,0
1668221902381,DSE 201,A00,096914,Deutsch; Alin Bernard,30,0,30,0
1668221902811,DSE 210,A00,096915,Dasgupta; Sanjoy,30,0,30,0
1668221903233,DSE 260A,A00,096916,Altintas De Callaf; Ilkay,30,0,30,0
1668221903663,ECE 200,001,103586,Antipa; Nicholas A,9999,0,9999,0
1668221903663,ECE 200,002,103587,Atanasov; Nikolay A.,9999,0,9999,0
1668221903663,ECE 200,003,103588,Bharadia; Dinesh,9999,0,9999,0
1668221903663,ECE 200,004,103589,Cheng; Chung Kuan,9999,0,9999,0
1668221903663,ECE 200,005,103590,Cosman; Pamela C.,9999,0,9999,0
1668221903663,ECE 200,006,103591,Dayeh; Shadi Ahmad,9999,0,9999,0
1668221903663,ECE 200,007,103592,Fainman; Yeshaiahu,9999,0,9999,0
1668221903663,ECE 200,008,103593,Ford; Joseph Earl,9999,0,9999,0
1668221903663,ECE 200,009,103594,Franceschetti; Massimo,9999,0,9999,0
1668221903663,ECE 200,010,103595,Fullerton; Eric E,9999,0,9999,0
1668221903663,ECE 200,011,103596,Galton; Ian A,9999,0,9999,0
1668221903663,ECE 200,012,103597,Gilja; Vikash,9999,0,9999,0
1668221903663,ECE 200,013,103598,Hall; Drew A.,9999,0,9999,0
1668221903663,ECE 200,014,103599,Hsueh; Tzu-Chien,9999,0,9999,0
1668221903663,ECE 200,015,103600,Javidi; Tara,9999,0,9999,0
1668221903663,ECE 200,016,103601,Kahng; Andrew Byun,9999,0,9999,0
1668221903663,ECE 200,017,103602,Kim; Young-Han,9999,0,9999,0
1668221903663,ECE 200,018,103603,Koushanfar; Farinaz,9999,0,9999,0
1668221903663,ECE 200,019,103604,Kuzum; Duygu,9999,0,9999,0
1668221903663,ECE 200,020,103605,Le; Hanh-Phuc,9999,0,9999,0
1668221903663,ECE 200,021,103606,Lin; Bill,9999,0,9999,0
1668221903663,ECE 200,022,103607,Liu; Zhaowei,9998,0,9999,1
1668221903663,ECE 200,023,103608,Lo; Yu-Hwa,9999,0,9999,0
1668221903663,ECE 200,024,103609,Lomakin; Vitaliy,9999,0,9999,0
1668221903663,ECE 200,025,103610,Mercier; Patrick Philip,9999,0,9999,0
1668221903663,ECE 200,026,103611,Meyer; Florian,9999,0,9999,0
1668221903663,ECE 200,027,103612,Milstein; Laurence B.,9999,0,9999,0
1668221903663,ECE 200,028,103613,Mir Arabbaygi; Siavash,9999,0,9999,0
1668221903663,ECE 200,029,103614,Mookherjea; Shayan,9999,0,9999,0
1668221903663,ECE 200,030,103615,Morris; Karcher William,9999,0,9999,0
1668221903663,ECE 200,031,103616,Ng; Tse Nga,9999,0,9999,0
1668221903663,ECE 200,032,103617,Nguyen; Truong Quang,9999,0,9999,0
1668221903663,ECE 200,033,103618,Nomura; Kenji,9999,0,9999,0
1668221903663,ECE 200,034,103619,Orlitsky; Alon,9999,0,9999,0
1668221903663,ECE 200,035,103620,Pal; Piya,9999,0,9999,0
1668221903663,ECE 200,036,103621,Papen; George C.,9999,0,9999,0
1668221903663,ECE 200,037,103622,Radic; Stojan,9999,0,9999,0
1668221903663,ECE 200,038,103623,Rao; Bhaskar D.,9999,0,9999,0
1668221903663,ECE 200,039,103624,Rao; Ramesh R,9999,0,9999,0
1668221903663,ECE 200,040,103625,Rebeiz; Gabriel,9999,0,9999,0
1668221903663,ECE 200,041,103626,Sanford; John R,9999,0,9999,0
1668221903663,ECE 200,042,103627,Siegel; Paul H.,9999,0,9999,0
1668221903663,ECE 200,043,103628,Sievenpiper; Daniel F.,9999,0,9999,0
1668221903663,ECE 200,044,103629,Sworder; David D.,9999,0,9999,0
1668221903663,ECE 200,045,103630,Taur; Yuan,9999,0,9999,0
1668221903663,ECE 200,046,103631,Touri; Behrouz,9999,0,9999,0
1668221903663,ECE 200,047,103632,Trivedi; Mohan M.,9999,0,9999,0
1668221903663,ECE 200,048,103633,Vasconcelos; Nuno,9999,0,9999,0
1668221903663,ECE 200,049,103634,Wang; Xiaolong,9999,0,9999,0
1668221903663,ECE 200,050,103635,Xie; Pengtao,9999,0,9999,0
1668221903663,ECE 200,051,103636,Yip; Michael,9999,0,9999,0
1668221903663,ECE 200,052,103637,Zeger; Kenneth A.,999,0,999,0
1668221903663,ECE 200,053,103638,Zhang; Xinyu,9999,0,9999,0
1668221903663,ECE 200,054,103639,Turakhia; Yatish Girish,9999,0,9999,0
1668221903663,ECE 200,055,103640,Kang; Mingu,9999,0,9999,0
1668221903663,ECE 200,056,103641,Shi; Yuanyuan,9999,0,9999,0
1668221903663,ECE 200,057,103642,Wang; Edward Jay,9999,0,9999,0
1668221903663,ECE 200,058,103643,Zheng; Yang,9999,0,9999,0
1668221904094,ECE 202,A00,103644,Kuzum; Duygu,0,0,0,0
1668221904524,ECE 212BN,A00,103646,Ng; Tse Nga,0,0,0,0
1668221904971,ECE 221,A00,111493,Staff,0,0,0,0
1668221905401,ECE 222B,A00,103647,Lomakin; Vitaliy,0,0,0,0
1668221905825,ECE 230B,A00,103648,Taur; Yuan,0,0,0,0
1668221906251,ECE 238B,A00,103649,Garay; Javier,0,0,0,0
1668221906676,ECE 240B,A00,112900,Fainman; Yeshaiahu,0,0,0,0
1668221907098,ECE 247A,A00,103650,Jokerst; Jesse Vincent,0,0,0,0
1668221907522,ECE 247B,A00,103651,Wang; Joseph,0,0,0,0
1668221907947,ECE 250,A00,103652,Siegel; Paul H.,0,0,0,0
1668221908370,ECE 251A,A00,103654,Rao; Bhaskar D.,0,0,0,0
1668221908793,ECE 257B,A00,103655,Bharadia; Dinesh,0,0,0,0
1668221909218,ECE 258A,A00,103656,Milstein; Laurence B.,0,0,0,0
1668221909642,ECE 260B,A00,103658,Kang; Mingu,0,0,0,0
1668221910069,ECE 264A,A00,103659,Galton; Ian A,0,0,0,0
1668221910496,ECE 265A,A00,103661,Gudem; Prasad S.S.,0,0,0,0
1668221910920,ECE 265D,A00,103662,Gudem; Prasad S.S.,0,0,0,0
1668221911347,ECE 268,A00,103663,Koushanfar; Farinaz,0,0,0,0
1668221911777,ECE 269,A01,103665,Pal; Piya,0,0,0,0
1668221912203,ECE 271B,A00,103666,Vasconcelos; Manuela,0,0,0,0
1668221912628,ECE 276A,A00,103667,Atanasov; Nikolay A.,0,0,0,0
1668221913055,ECE 277,A00,103668,An; Cheolhong,0,0,0,0
1668221913480,ECE 279,A00,117947,Hall; Drew A.,0,0,0,0
1668221914330,ECE 283,A00,103670,Hsueh; Tzu-Chien,0,0,0,0
1668221914752,ECE 284,A00,103671,Turakhia; Yatish Girish,0,0,0,0
1668221915176,ECE 285,A00,103672,Zheng; Yang,0,0,0,0
1668221915176,ECE 285,B00,103673,Sworder; David D.,0,0,0,0
1668221915600,ECE 287,A00,103676,Javidi; Tara,0,0,0,0
1668221916021,MATH 200B,A00,098023,Salehi Golsefidy; Alireza,12,0,15,3
1668221916444,MATH 202B,A00,098024,Rhoades; Brendon Patrick,9,0,15,6
1668221916874,MATH 203B,A00,098025,Oprea; Dragos N.,10,0,15,5
1668221917295,MATH 204B,A00,098026,Sorensen; Claus M,13,0,15,2
1668221917718,MATH 208,A00,098027,Izadi; Elham,7,0,10,3
1668221918145,MATH 209,A00,098028,Pollack; Aaron,10,0,10,0
1668221918566,MATH 211A,A00,112919,Rogalski; Daniel,9,0,10,1
1668221918998,MATH 211B,A00,112920,Seward; Brandon M.,9,0,10,1
1668221919420,MATH 218,A00,098029,Li; Bo,10,0,10,0
1668221919843,MATH 220B,A00,098030,Novak; Jonathan I,11,0,15,4
1668221920273,MATH 221A,A00,098031,Ebenfelt; Peter F,13,0,15,2
1668221920719,MATH 231B,A00,098032,Zlatos; Andrej,12,0,15,3
1668221921145,MATH 240B,A00,098033,Ni; Lei,9,0,15,6
1668221921571,MATH 243,A00,098034,Jekel; David Andrew,10,0,10,0
1668221921995,MATH 245A,A00,098035,Nie; Jiawang,0,0,15,16
1668221922535,MATH 248,A00,098036,Bejenaru; Ioan,10,0,10,0
1668221922962,MATH 250B,A00,098037,Spolaor; Luca,14,0,15,1
1668221923386,MATH 258,A00,098038,Ni; Lei,10,0,10,0
1668221923812,MATH 264B,A00,098041,Rhoades; Brendon Patrick,9,0,15,6
1668221924235,MATH 268,A00,098042,Buss; Samuel R,10,0,10,0
1668221924661,MATH 269,A00,098043,Rhoades; Brendon Patrick,10,0,10,0
1668221925083,MATH 270B,A00,098044,Li; Bo,10,0,15,5
1668221925508,MATH 272B,A00,098045,Holst; Michael J,13,0,15,2
1668221925934,MATH 273A,A00,098046,Tian; Xiaochuan,10,0,15,5
1668221926357,MATH 275,A01,098048,Tian; Xiaochuan,6,0,10,4
1668221926782,MATH 278A,A00,098049,Holst; Michael J,8,0,10,2
1668221927207,MATH 278B,A00,098050,Cloninger; Alexander,10,0,10,0
1668221927630,MATH 278C,A00,098051,Nie; Jiawang,7,0,10,3
1668221928054,MATH 280B,A00,098052,Zheng; Tianyi,10,0,15,5
1668221928478,MATH 281B,A00,098053,Bradic; Jelena,2,0,15,13
1668221928916,MATH 282B,A00,098054,Arias-Castro; Ery,0,0,15,15
1668221929341,MATH 285,A00,098055,Fitzsimmons; Patrick J,0,0,15,17
1668221929795,MATH 287B,A00,098056,Arias-Castro; Ery,2,0,15,13
1668221930236,MATH 288,A00,098057,Agarwal; Pooja,9,0,10,1
1668221930236,MATH 288,B00,098058,Zhang; Danna,8,0,10,2
1668221930236,MATH 288,C00,098059,Williams; Ruth J,10,0,10,0
1668221930661,MATH 290B,A00,098060,Roberts; Justin Deritter,13,0,15,2
1668221931088,MATH 292,A00,098061,Belmont; Eva Kinoshita,10,0,10,0
1668221931518,MATH 295,A00,098062,Suk; Andrew Hoon,48,0,50,2
1668221931940,MATH 296,A00,098063,Novak; Jonathan I,20,0,20,0
1668221932377,MATH 297,001,098064,Gamst; Anthony Collins,9997,0,9999,2
1668222435840,COGS 205,A00,101395,Chiba; Andrea,19,0,20,1
1668222436274,COGS 210B,001,101404,Greene; Deanna Jacquelyn,9998,0,9999,1
1668222436274,COGS 210B,002,101417,Xia; Haijun,9999,0,9999,0
1668222436274,COGS 210B,003,101422,Nitz; Douglas A.,9999,0,9999,0
1668222436274,COGS 210B,004,101423,Hollan; James D.,9998,0,9999,1
1668222436274,COGS 210B,005,101424,Deak; Gedeon O.,9998,0,9999,1
1668222436274,COGS 210B,006,101425,Rossano; Federico,9999,0,9999,0
1668222436699,COGS 211B,A00,101427,Coulson; Seana M,9996,0,9999,3
1668222437122,COGS 220,A00,101428,Hollan; James D.,0,0,25,25
1668222437546,COGS 229,A00,101429,Dow; Steven P,18,0,25,7
1668222437969,COGS 230,A00,101430,Klemmer; Scott R,12,0,17,5
1668222438393,COGS 234,A00,101431,Xia; Haijun,2,0,25,23
1668222438815,COGS 260,A00,101432,Kiyonaga; Anastasia,21,0,25,4
1668222438815,COGS 260,B00,101433,Kirsh; David Joel,15,0,25,10
1668222439239,CSE 202,A00,102371,Impagliazzo; Russell,0,0,0,0
1668222439665,CSE 203B,A01,102373,Cheng; Chung Kuan,0,0,0,0
1668222440097,CSE 208,A00,102374,Micciancio; Daniele,0,0,0,0
1668222440686,CSE 209A,A00,112895,Impagliazzo; Russell,0,0,15,15
1668222441108,CSE 209B,A00,108005,Bellare; Mihir,0,0,0,0
1668222441535,CSE 210,A00,113163,Coblenz; Michael J,0,0,0,0
1668222441958,CSE 219,A00,106111,Dow; Steven P,0,0,20,20
1668222442382,CSE 221,A00,102376,Voelker; Geoffrey M.,0,0,0,0
1668222442805,CSE 224,A01,102378,Porter; George M,0,0,0,0
1668222443238,CSE 229A,A00,102379,Savage; Stefan,0,0,0,0
1668222443661,CSE 229C,A00,102380,Munyaka; Imani N. S.,0,0,0,0
1668222444083,CSE 232B,A00,102382,Deutsch; Alin Bernard,0,0,0,0
1668222444506,CSE 234,A01,112904,Kumar; Arun Kumar,0,0,0,0
1668222444931,CSE 237A,A00,102383,Rosing; Tajana Simunic,0,0,0,0
1668222445354,CSE 239A,A00,102384,Deutsch; Alin Bernard,0,0,0,0
1668222445787,CSE 239B,A00,102385,Polikarpova; Nadezhda,0,0,0,0
1668222446301,CSE 240A,A00,102386,Pannuto; Patrick William,0,0,0,0
1668222446733,CSE 240B,A00,102387,Zhao; Jishen,0,0,0,0
1668222447163,CSE 241A,A00,106406,Kang; Mingu,0,0,0,0
1668222447594,CSE 249B,A00,102388,Kahng; Andrew Byun,0,0,8,8
1668222448021,CSE 251B,A01,102392,Cottrell; Garrison W,0,0,0,0
1668222448021,CSE 251B,A02,102393,Cottrell; Garrison W,0,0,0,0
1668222448449,CSE 252B,A00,102394,Ochoa; Benjamin Lawrence,0,0,0,0
1668222448876,CSE 257,A01,102396,Gao; Sicun,0,0,0,0
1668222449299,CSE 272,A00,102397,Li; Tzumao,0,0,0,0
1668222449722,CSE 274,A00,111323,Chern; Albert Ren-Haur,0,0,0,0
1668222450147,CSE 282,A00,102398,Pevzner; Pavel Arkadjevich,0,0,0,0
1668222450571,CSE 284,A00,114175,Gymrek; Melissa Ann,0,0,0,0
1668222450993,CSE 290,A00,102399,Chandraker; Manmohan Krishna,0,0,0,0
1668222450993,CSE 290,B00,102400,Vaccaro; Kristen Marie,0,0,25,25
1668222450993,CSE 290,C00,102414,Pannuto; Patrick William,0,0,25,25
1668222450993,CSE 290,D00,102427,Pevzner; Pavel Arkadjevich,0,0,0,0
1668222450993,CSE 290,E00,102429,Zhao; Jishen,0,0,0,0
1668222450993,CSE 290,F00,102436,Tullsen; Dean Michael,0,0,0,0
1668222450993,CSE 290,G00,102440,Christensen; Henrik I,0,0,20,20
1668222451422,CSE 291,A00,102443,Su; Hao,0,0,0,0
1668222451422,CSE 291,B00,102448,Polikarpova; Nadezhda,0,0,0,0
1668222451422,CSE 291,C00,102453,Vaccaro; Kristen Marie,0,0,0,0
1668222451422,CSE 291,D00,111343,Savage; Stefan,0,0,0,0
1668222451422,CSE 291,E00,116474,Claffy; Kimberly Claire,0,0,0,0
1668222451422,CSE 291,F00,116479,Pasquale; Joseph,0,0,0,0
1668222451882,CSE 293,001,119111,Bafna; Vineet,9999,0,9999,0
1668222451882,CSE 293,002,119118,Bellare; Mihir,9999,0,9999,0
1668222451882,CSE 293,003,119122,Berg-Kirkpatrick; Taylor D,9999,0,9999,0
1668222451882,CSE 293,004,119135,Christensen; Henrik I,9999,0,9999,0
1668222451882,CSE 293,005,119142,Cottrell; Garrison W,9999,0,9999,0
1668222451882,CSE 293,006,119146,Deutsch; Alin Bernard,9999,0,9999,0
1668222451882,CSE 293,007,119159,Esmaeilzadeh; Hadi,9999,0,9999,0
1668222451882,CSE 293,008,119166,Freund; Yoav,9999,0,9999,0
1668222451882,CSE 293,009,119170,Griswold; William G.,9999,0,9999,0
1668222451882,CSE 293,010,119183,Gymrek; Melissa Ann,9999,0,9999,0
1668222451882,CSE 293,011,119190,Heninger; Nadia A,9999,0,9999,0
1668222451882,CSE 293,012,119230,Impagliazzo; Russell,9999,0,9999,0
1668222451882,CSE 293,013,119232,Jhala; Ranjit,9999,0,9999,0
1668222451882,CSE 293,014,119233,Kahng; Andrew Byun,9999,0,9999,0
1668222451882,CSE 293,015,119298,Kane; Daniel Mertz,9999,0,9999,0
1668222451882,CSE 293,016,119299,Kriegman; David J,9999,0,9999,0
1668222451882,CSE 293,017,119300,Kumar; Arun Kumar,9999,0,9999,0
1668222451882,CSE 293,018,119301,Lerner; Sorin,9999,0,9999,0
1668222451882,CSE 293,019,119302,Lovett; Shachar,9999,0,9999,0
1668222451882,CSE 293,020,119303,McAuley; Julian John,9999,0,9999,0
1668222451882,CSE 293,021,119304,Micciancio; Daniele,9999,0,9999,0
1668222451882,CSE 293,022,119367,Orailoglu; Alex,9999,0,9999,0
1668222451882,CSE 293,023,119382,Paturi; Ramamohan,9999,0,9999,0
1668222451882,CSE 293,024,119404,Polikarpova; Nadezhda,9999,0,9999,0
1668222451882,CSE 293,025,119406,Politz; Joseph Gibbs,9999,0,9999,0
1668222451882,CSE 293,026,119411,Porter; George M,9999,0,9999,0
1668222451882,CSE 293,027,119414,Porter; Leonard Emerson,9999,0,9999,0
1668222451882,CSE 293,028,119416,Ramamoorthi; Ravi,9999,0,9999,0
1668222451882,CSE 293,029,119417,Sahoo; Debashis,9999,0,9999,0
1668222451882,CSE 293,030,119420,Saul; Lawrence,9999,0,9999,0
1668222451882,CSE 293,031,119421,Savage; Stefan,9999,0,9999,0
1668222451882,CSE 293,032,119425,Schulze; Jurgen P.,9999,0,9999,0
1668222451882,CSE 293,033,119426,Snoeren; Alex C.,9999,0,9999,0
1668222451882,CSE 293,034,119428,Shang; Jingbo,9999,0,9999,0
1668222451882,CSE 293,035,119430,Stefan; Deian,9999,0,9999,0
1668222451882,CSE 293,036,119431,Su; Hao,9999,0,9999,0
1668222451882,CSE 293,037,119433,Swanson; Steven James,9999,0,9999,0
1668222451882,CSE 293,038,119435,Tullsen; Dean Michael,9999,0,9999,0
1668222451882,CSE 293,039,119483,Voelker; Geoffrey M.,9999,0,9999,0
1668222451882,CSE 293,040,119537,Zhao; Jishen,9999,0,9999,0
1668222451882,CSE 293,041,119538,Zhou; Yuan-Yuan,9999,0,9999,0
1668222451882,CSE 293,042,119539,Gao; Sicun,9999,0,9999,0
1668222451882,CSE 293,043,119540,Weibel; Nadir,9999,0,9999,0
1668222451882,CSE 293,044,119541,Gupta; Rajesh K.,9999,0,9999,0
1668222451882,CSE 293,045,126410,Vaccaro; Kristen Marie,9999,0,9999,0
1668222451882,CSE 293,046,126411,Klemke; Richard,9999,0,9999,0
1668222452308,CSE 294,A00,102459,Voelker; Geoffrey M.,0,0,0,0
1668222452308,CSE 294,B00,111322,Orailoglu; Alex,0,0,0,0
1668222452730,DSE 201,A00,096914,Deutsch; Alin Bernard,30,0,30,0
1668222453154,DSE 210,A00,096915,Dasgupta; Sanjoy,30,0,30,0
1668222453577,DSE 260A,A00,096916,Altintas De Callaf; Ilkay,30,0,30,0
1668222454036,ECE 200,001,103586,Antipa; Nicholas A,9999,0,9999,0
1668222454036,ECE 200,002,103587,Atanasov; Nikolay A.,9999,0,9999,0
1668222454036,ECE 200,003,103588,Bharadia; Dinesh,9999,0,9999,0
1668222454036,ECE 200,004,103589,Cheng; Chung Kuan,9999,0,9999,0
1668222454036,ECE 200,005,103590,Cosman; Pamela C.,9999,0,9999,0
1668222454036,ECE 200,006,103591,Dayeh; Shadi Ahmad,9999,0,9999,0
1668222454036,ECE 200,007,103592,Fainman; Yeshaiahu,9999,0,9999,0
1668222454036,ECE 200,008,103593,Ford; Joseph Earl,9999,0,9999,0
1668222454036,ECE 200,009,103594,Franceschetti; Massimo,9999,0,9999,0
1668222454036,ECE 200,010,103595,Fullerton; Eric E,9999,0,9999,0
1668222454036,ECE 200,011,103596,Galton; Ian A,9999,0,9999,0
1668222454036,ECE 200,012,103597,Gilja; Vikash,9999,0,9999,0
1668222454036,ECE 200,013,103598,Hall; Drew A.,9999,0,9999,0
1668222454036,ECE 200,014,103599,Hsueh; Tzu-Chien,9999,0,9999,0
1668222454036,ECE 200,015,103600,Javidi; Tara,9999,0,9999,0
1668222454036,ECE 200,016,103601,Kahng; Andrew Byun,9999,0,9999,0
1668222454036,ECE 200,017,103602,Kim; Young-Han,9999,0,9999,0
1668222454036,ECE 200,018,103603,Koushanfar; Farinaz,9999,0,9999,0
1668222454036,ECE 200,019,103604,Kuzum; Duygu,9999,0,9999,0
1668222454036,ECE 200,020,103605,Le; Hanh-Phuc,9999,0,9999,0
1668222454036,ECE 200,021,103606,Lin; Bill,9999,0,9999,0
1668222454036,ECE 200,022,103607,Liu; Zhaowei,9998,0,9999,1
1668222454036,ECE 200,023,103608,Lo; Yu-Hwa,9999,0,9999,0
1668222454036,ECE 200,024,103609,Lomakin; Vitaliy,9999,0,9999,0
1668222454036,ECE 200,025,103610,Mercier; Patrick Philip,9999,0,9999,0
1668222454036,ECE 200,026,103611,Meyer; Florian,9999,0,9999,0
1668222454036,ECE 200,027,103612,Milstein; Laurence B.,9999,0,9999,0
1668222454036,ECE 200,028,103613,Mir Arabbaygi; Siavash,9999,0,9999,0
1668222454036,ECE 200,029,103614,Mookherjea; Shayan,9999,0,9999,0
1668222454036,ECE 200,030,103615,Morris; Karcher William,9999,0,9999,0
1668222454036,ECE 200,031,103616,Ng; Tse Nga,9999,0,9999,0
1668222454036,ECE 200,032,103617,Nguyen; Truong Quang,9999,0,9999,0
1668222454036,ECE 200,033,103618,Nomura; Kenji,9999,0,9999,0
1668222454036,ECE 200,034,103619,Orlitsky; Alon,9999,0,9999,0
1668222454036,ECE 200,035,103620,Pal; Piya,9999,0,9999,0
1668222454036,ECE 200,036,103621,Papen; George C.,9999,0,9999,0
1668222454036,ECE 200,037,103622,Radic; Stojan,9999,0,9999,0
1668222454036,ECE 200,038,103623,Rao; Bhaskar D.,9999,0,9999,0
1668222454036,ECE 200,039,103624,Rao; Ramesh R,9999,0,9999,0
1668222454036,ECE 200,040,103625,Rebeiz; Gabriel,9999,0,9999,0
1668222454036,ECE 200,041,103626,Sanford; John R,9999,0,9999,0
1668222454036,ECE 200,042,103627,Siegel; Paul H.,9999,0,9999,0
1668222454036,ECE 200,043,103628,Sievenpiper; Daniel F.,9999,0,9999,0
1668222454036,ECE 200,044,103629,Sworder; David D.,9999,0,9999,0
1668222454036,ECE 200,045,103630,Taur; Yuan,9999,0,9999,0
1668222454036,ECE 200,046,103631,Touri; Behrouz,9999,0,9999,0
1668222454036,ECE 200,047,103632,Trivedi; Mohan M.,9999,0,9999,0
1668222454036,ECE 200,048,103633,Vasconcelos; Nuno,9999,0,9999,0
1668222454036,ECE 200,049,103634,Wang; Xiaolong,9999,0,9999,0
1668222454036,ECE 200,050,103635,Xie; Pengtao,9999,0,9999,0
1668222454036,ECE 200,051,103636,Yip; Michael,9999,0,9999,0
1668222454036,ECE 200,052,103637,Zeger; Kenneth A.,999,0,999,0
1668222454036,ECE 200,053,103638,Zhang; Xinyu,9999,0,9999,0
1668222454036,ECE 200,054,103639,Turakhia; Yatish Girish,9999,0,9999,0
1668222454036,ECE 200,055,103640,Kang; Mingu,9999,0,9999,0
1668222454036,ECE 200,056,103641,Shi; Yuanyuan,9999,0,9999,0
1668222454036,ECE 200,057,103642,Wang; Edward Jay,9999,0,9999,0
1668222454036,ECE 200,058,103643,Zheng; Yang,9999,0,9999,0
1668222454459,ECE 202,A00,103644,Kuzum; Duygu,0,0,0,0
1668222454885,ECE 212BN,A00,103646,Ng; Tse Nga,0,0,0,0
1668222455308,ECE 221,A00,111493,Staff,0,0,0,0
1668222455736,ECE 222B,A00,103647,Lomakin; Vitaliy,0,0,0,0
1668222456161,ECE 230B,A00,103648,Taur; Yuan,0,0,0,0
1668222456582,ECE 238B,A00,103649,Garay; Javier,0,0,0,0
1668222457009,ECE 240B,A00,112900,Fainman; Yeshaiahu,0,0,0,0
1668222457442,ECE 247A,A00,103650,Jokerst; Jesse Vincent,0,0,0,0
1668222457870,ECE 247B,A00,103651,Wang; Joseph,0,0,0,0
1668222458297,ECE 250,A00,103652,Siegel; Paul H.,0,0,0,0
1668222458736,ECE 251A,A00,103654,Rao; Bhaskar D.,0,0,0,0
1668222459161,ECE 257B,A00,103655,Bharadia; Dinesh,0,0,0,0
1668222459584,ECE 258A,A00,103656,Milstein; Laurence B.,0,0,0,0
1668222460006,ECE 260B,A00,103658,Kang; Mingu,0,0,0,0
1668222460431,ECE 264A,A00,103659,Galton; Ian A,0,0,0,0
1668222460866,ECE 265A,A00,103661,Gudem; Prasad S.S.,0,0,0,0
1668222461297,ECE 265D,A00,103662,Gudem; Prasad S.S.,0,0,0,0
1668222461723,ECE 268,A00,103663,Koushanfar; Farinaz,0,0,0,0
1668222462147,ECE 269,A01,103665,Pal; Piya,0,0,0,0
1668222462577,ECE 271B,A00,103666,Vasconcelos; Manuela,0,0,0,0
1668222462999,ECE 276A,A00,103667,Atanasov; Nikolay A.,0,0,0,0
1668222463423,ECE 277,A00,103668,An; Cheolhong,0,0,0,0
1668222463849,ECE 279,A00,117947,Hall; Drew A.,0,0,0,0
1668222464696,ECE 283,A00,103670,Hsueh; Tzu-Chien,0,0,0,0
1668222465217,ECE 284,A00,103671,Turakhia; Yatish Girish,0,0,0,0
1668222465638,ECE 285,A00,103672,Zheng; Yang,0,0,0,0
1668222465638,ECE 285,B00,103673,Sworder; David D.,0,0,0,0
1668222466062,ECE 287,A00,103676,Javidi; Tara,0,0,0,0
1668222466488,MATH 200B,A00,098023,Salehi Golsefidy; Alireza,12,0,15,3
1668222466915,MATH 202B,A00,098024,Rhoades; Brendon Patrick,9,0,15,6
1668222467341,MATH 203B,A00,098025,Oprea; Dragos N.,10,0,15,5
1668222467772,MATH 204B,A00,098026,Sorensen; Claus M,13,0,15,2
1668222468195,MATH 208,A00,098027,Izadi; Elham,7,0,10,3
1668222468615,MATH 209,A00,098028,Pollack; Aaron,10,0,10,0
1668222469041,MATH 211A,A00,112919,Rogalski; Daniel,9,0,10,1
1668222469463,MATH 211B,A00,112920,Seward; Brandon M.,9,0,10,1
1668222469889,MATH 218,A00,098029,Li; Bo,10,0,10,0
1668222470314,MATH 220B,A00,098030,Novak; Jonathan I,11,0,15,4
1668222470740,MATH 221A,A00,098031,Ebenfelt; Peter F,13,0,15,2
1668222471166,MATH 231B,A00,098032,Zlatos; Andrej,12,0,15,3
1668222471599,MATH 240B,A00,098033,Ni; Lei,9,0,15,6
1668222472032,MATH 243,A00,098034,Jekel; David Andrew,10,0,10,0
1668222472455,MATH 245A,A00,098035,Nie; Jiawang,0,0,15,16
1668222472877,MATH 248,A00,098036,Bejenaru; Ioan,10,0,10,0
1668222473311,MATH 250B,A00,098037,Spolaor; Luca,14,0,15,1
1668222473743,MATH 258,A00,098038,Ni; Lei,10,0,10,0
1668222474172,MATH 264B,A00,098041,Rhoades; Brendon Patrick,9,0,15,6
1668222474604,MATH 268,A00,098042,Buss; Samuel R,10,0,10,0
1668222475029,MATH 269,A00,098043,Rhoades; Brendon Patrick,10,0,10,0
1668222475462,MATH 270B,A00,098044,Li; Bo,10,0,15,5
1668222475894,MATH 272B,A00,098045,Holst; Michael J,13,0,15,2
1668222476323,MATH 273A,A00,098046,Tian; Xiaochuan,10,0,15,5
1668222476744,MATH 275,A01,098048,Tian; Xiaochuan,6,0,10,4
1668222477168,MATH 278A,A00,098049,Holst; Michael J,8,0,10,2
1668222477591,MATH 278B,A00,098050,Cloninger; Alexander,10,0,10,0
1668222478017,MATH 278C,A00,098051,Nie; Jiawang,7,0,10,3
1668222478439,MATH 280B,A00,098052,Zheng; Tianyi,10,0,15,5
1668222478863,MATH 281B,A00,098053,Bradic; Jelena,2,0,15,13
1668222479288,MATH 282B,A00,098054,Arias-Castro; Ery,0,0,15,15
1668222479712,MATH 285,A00,098055,Fitzsimmons; Patrick J,0,0,15,17
1668222480144,MATH 287B,A00,098056,Arias-Castro; Ery,2,0,15,13
1668222480568,MATH 288,A00,098057,Agarwal; Pooja,9,0,10,1
1668222480568,MATH 288,B00,098058,Zhang; Danna,8,0,10,2
1668222480568,MATH 288,C00,098059,Williams; Ruth J,10,0,10,0
1668222480995,MATH 290B,A00,098060,Roberts; Justin Deritter,13,0,15,2
1668222481428,MATH 292,A00,098061,Belmont; Eva Kinoshita,10,0,10,0
1668222481859,MATH 295,A00,098062,Suk; Andrew Hoon,48,0,50,2
1668222482294,MATH 296,A00,098063,Novak; Jonathan I,20,0,20,0
1668222482718,MATH 297,001,098064,Gamst; Anthony Collins,9997,0,9999,2
1668222985836,COGS 205,A00,101395,Chiba; Andrea,19,0,20,1
1668222986260,COGS 210B,001,101404,Greene; Deanna Jacquelyn,9998,0,9999,1
1668222986260,COGS 210B,002,101417,Xia; Haijun,9999,0,9999,0
1668222986260,COGS 210B,003,101422,Nitz; Douglas A.,9999,0,9999,0
1668222986260,COGS 210B,004,101423,Hollan; James D.,9998,0,9999,1
1668222986260,COGS 210B,005,101424,Deak; Gedeon O.,9998,0,9999,1
1668222986260,COGS 210B,006,101425,Rossano; Federico,9999,0,9999,0
1668222986683,COGS 211B,A00,101427,Coulson; Seana M,9996,0,9999,3
1668222987120,COGS 220,A00,101428,Hollan; James D.,0,0,25,25
1668222987546,COGS 229,A00,101429,Dow; Steven P,18,0,25,7
1668222987968,COGS 230,A00,101430,Klemmer; Scott R,12,0,17,5
1668222988398,COGS 234,A00,101431,Xia; Haijun,2,0,25,23
1668222988822,COGS 260,A00,101432,Kiyonaga; Anastasia,21,0,25,4
1668222988822,COGS 260,B00,101433,Kirsh; David Joel,15,0,25,10
1668222989247,CSE 202,A00,102371,Impagliazzo; Russell,0,0,0,0
1668222989678,CSE 203B,A01,102373,Cheng; Chung Kuan,0,0,0,0
1668222990101,CSE 208,A00,102374,Micciancio; Daniele,0,0,0,0
1668222990527,CSE 209A,A00,112895,Impagliazzo; Russell,0,0,15,15
1668222990950,CSE 209B,A00,108005,Bellare; Mihir,0,0,0,0
1668222991374,CSE 210,A00,113163,Coblenz; Michael J,0,0,0,0
1668222991798,CSE 219,A00,106111,Dow; Steven P,0,0,20,20
1668222992225,CSE 221,A00,102376,Voelker; Geoffrey M.,0,0,0,0
1668222992661,CSE 224,A01,102378,Porter; George M,0,0,0,0
1668222993085,CSE 229A,A00,102379,Savage; Stefan,0,0,0,0
1668222993510,CSE 229C,A00,102380,Munyaka; Imani N. S.,0,0,0,0
1668222993936,CSE 232B,A00,102382,Deutsch; Alin Bernard,0,0,0,0
1668222994370,CSE 234,A01,112904,Kumar; Arun Kumar,0,0,0,0
1668222994797,CSE 237A,A00,102383,Rosing; Tajana Simunic,0,0,0,0
1668222995221,CSE 239A,A00,102384,Deutsch; Alin Bernard,0,0,0,0
1668222995647,CSE 239B,A00,102385,Polikarpova; Nadezhda,0,0,0,0
1668222996073,CSE 240A,A00,102386,Pannuto; Patrick William,0,0,0,0
1668222996495,CSE 240B,A00,102387,Zhao; Jishen,0,0,0,0
1668222996920,CSE 241A,A00,106406,Kang; Mingu,0,0,0,0
1668222997345,CSE 249B,A00,102388,Kahng; Andrew Byun,0,0,8,8
1668222997770,CSE 251B,A01,102392,Cottrell; Garrison W,0,0,0,0
1668222997770,CSE 251B,A02,102393,Cottrell; Garrison W,0,0,0,0
1668222998204,CSE 252B,A00,102394,Ochoa; Benjamin Lawrence,0,0,0,0
1668222998641,CSE 257,A01,102396,Gao; Sicun,0,0,0,0
1668222999067,CSE 272,A00,102397,Li; Tzumao,0,0,0,0
1668222999493,CSE 274,A00,111323,Chern; Albert Ren-Haur,0,0,0,0
1668222999917,CSE 282,A00,102398,Pevzner; Pavel Arkadjevich,0,0,0,0
1668223000345,CSE 284,A00,114175,Gymrek; Melissa Ann,0,0,0,0
1668223000769,CSE 290,A00,102399,Chandraker; Manmohan Krishna,0,0,0,0
1668223000769,CSE 290,B00,102400,Vaccaro; Kristen Marie,0,0,25,25
1668223000769,CSE 290,C00,102414,Pannuto; Patrick William,0,0,25,25
1668223000769,CSE 290,D00,102427,Pevzner; Pavel Arkadjevich,0,0,0,0
1668223000769,CSE 290,E00,102429,Zhao; Jishen,0,0,0,0
1668223000769,CSE 290,F00,102436,Tullsen; Dean Michael,0,0,0,0
1668223000769,CSE 290,G00,102440,Christensen; Henrik I,0,0,20,20
1668223001195,CSE 291,A00,102443,Su; Hao,0,0,0,0
1668223001195,CSE 291,B00,102448,Polikarpova; Nadezhda,0,0,0,0
1668223001195,CSE 291,C00,102453,Vaccaro; Kristen Marie,0,0,0,0
1668223001195,CSE 291,D00,111343,Savage; Stefan,0,0,0,0
1668223001195,CSE 291,E00,116474,Claffy; Kimberly Claire,0,0,0,0
1668223001195,CSE 291,F00,116479,Pasquale; Joseph,0,0,0,0
1668223001624,CSE 293,001,119111,Bafna; Vineet,9999,0,9999,0
1668223001624,CSE 293,002,119118,Bellare; Mihir,9999,0,9999,0
1668223001624,CSE 293,003,119122,Berg-Kirkpatrick; Taylor D,9999,0,9999,0
1668223001624,CSE 293,004,119135,Christensen; Henrik I,9999,0,9999,0
1668223001624,CSE 293,005,119142,Cottrell; Garrison W,9999,0,9999,0
1668223001624,CSE 293,006,119146,Deutsch; Alin Bernard,9999,0,9999,0
1668223001624,CSE 293,007,119159,Esmaeilzadeh; Hadi,9999,0,9999,0
1668223001624,CSE 293,008,119166,Freund; Yoav,9999,0,9999,0
1668223001624,CSE 293,009,119170,Griswold; William G.,9999,0,9999,0
1668223001624,CSE 293,010,119183,Gymrek; Melissa Ann,9999,0,9999,0
1668223001624,CSE 293,011,119190,Heninger; Nadia A,9999,0,9999,0
1668223001624,CSE 293,012,119230,Impagliazzo; Russell,9999,0,9999,0
1668223001624,CSE 293,013,119232,Jhala; Ranjit,9999,0,9999,0
1668223001624,CSE 293,014,119233,Kahng; Andrew Byun,9999,0,9999,0
1668223001624,CSE 293,015,119298,Kane; Daniel Mertz,9999,0,9999,0
1668223001624,CSE 293,016,119299,Kriegman; David J,9999,0,9999,0
1668223001624,CSE 293,017,119300,Kumar; Arun Kumar,9999,0,9999,0
1668223001624,CSE 293,018,119301,Lerner; Sorin,9999,0,9999,0
1668223001624,CSE 293,019,119302,Lovett; Shachar,9999,0,9999,0
1668223001624,CSE 293,020,119303,McAuley; Julian John,9999,0,9999,0
1668223001624,CSE 293,021,119304,Micciancio; Daniele,9999,0,9999,0
1668223001624,CSE 293,022,119367,Orailoglu; Alex,9999,0,9999,0
1668223001624,CSE 293,023,119382,Paturi; Ramamohan,9999,0,9999,0
1668223001624,CSE 293,024,119404,Polikarpova; Nadezhda,9999,0,9999,0
1668223001624,CSE 293,025,119406,Politz; Joseph Gibbs,9999,0,9999,0
1668223001624,CSE 293,026,119411,Porter; George M,9999,0,9999,0
1668223001624,CSE 293,027,119414,Porter; Leonard Emerson,9999,0,9999,0
1668223001624,CSE 293,028,119416,Ramamoorthi; Ravi,9999,0,9999,0
1668223001624,CSE 293,029,119417,Sahoo; Debashis,9999,0,9999,0
1668223001624,CSE 293,030,119420,Saul; Lawrence,9999,0,9999,0
1668223001624,CSE 293,031,119421,Savage; Stefan,9999,0,9999,0
1668223001624,CSE 293,032,119425,Schulze; Jurgen P.,9999,0,9999,0
1668223001624,CSE 293,033,119426,Snoeren; Alex C.,9999,0,9999,0
1668223001624,CSE 293,034,119428,Shang; Jingbo,9999,0,9999,0
1668223001624,CSE 293,035,119430,Stefan; Deian,9999,0,9999,0
1668223001624,CSE 293,036,119431,Su; Hao,9999,0,9999,0
1668223001624,CSE 293,037,119433,Swanson; Steven James,9999,0,9999,0
1668223001624,CSE 293,038,119435,Tullsen; Dean Michael,9999,0,9999,0
1668223001624,CSE 293,039,119483,Voelker; Geoffrey M.,9999,0,9999,0
1668223001624,CSE 293,040,119537,Zhao; Jishen,9999,0,9999,0
1668223001624,CSE 293,041,119538,Zhou; Yuan-Yuan,9999,0,9999,0
1668223001624,CSE 293,042,119539,Gao; Sicun,9999,0,9999,0
1668223001624,CSE 293,043,119540,Weibel; Nadir,9999,0,9999,0
1668223001624,CSE 293,044,119541,Gupta; Rajesh K.,9999,0,9999,0
1668223001624,CSE 293,045,126410,Vaccaro; Kristen Marie,9999,0,9999,0
1668223001624,CSE 293,046,126411,Klemke; Richard,9999,0,9999,0
1668223002050,CSE 294,A00,102459,Voelker; Geoffrey M.,0,0,0,0
1668223002050,CSE 294,B00,111322,Orailoglu; Alex,0,0,0,0
1668223002472,DSE 201,A00,096914,Deutsch; Alin Bernard,30,0,30,0
1668223002899,DSE 210,A00,096915,Dasgupta; Sanjoy,30,0,30,0
1668223003338,DSE 260A,A00,096916,Altintas De Callaf; Ilkay,30,0,30,0
1668223003815,ECE 200,001,103586,Antipa; Nicholas A,9999,0,9999,0
1668223003815,ECE 200,002,103587,Atanasov; Nikolay A.,9999,0,9999,0
1668223003815,ECE 200,003,103588,Bharadia; Dinesh,9999,0,9999,0
1668223003815,ECE 200,004,103589,Cheng; Chung Kuan,9999,0,9999,0
1668223003815,ECE 200,005,103590,Cosman; Pamela C.,9999,0,9999,0
1668223003815,ECE 200,006,103591,Dayeh; Shadi Ahmad,9999,0,9999,0
1668223003815,ECE 200,007,103592,Fainman; Yeshaiahu,9999,0,9999,0
1668223003815,ECE 200,008,103593,Ford; Joseph Earl,9999,0,9999,0
1668223003815,ECE 200,009,103594,Franceschetti; Massimo,9999,0,9999,0
1668223003815,ECE 200,010,103595,Fullerton; Eric E,9999,0,9999,0
1668223003815,ECE 200,011,103596,Galton; Ian A,9999,0,9999,0
1668223003815,ECE 200,012,103597,Gilja; Vikash,9999,0,9999,0
1668223003815,ECE 200,013,103598,Hall; Drew A.,9999,0,9999,0
1668223003815,ECE 200,014,103599,Hsueh; Tzu-Chien,9999,0,9999,0
1668223003815,ECE 200,015,103600,Javidi; Tara,9999,0,9999,0
1668223003815,ECE 200,016,103601,Kahng; Andrew Byun,9999,0,9999,0
1668223003815,ECE 200,017,103602,Kim; Young-Han,9999,0,9999,0
1668223003815,ECE 200,018,103603,Koushanfar; Farinaz,9999,0,9999,0
1668223003815,ECE 200,019,103604,Kuzum; Duygu,9999,0,9999,0
1668223003815,ECE 200,020,103605,Le; Hanh-Phuc,9999,0,9999,0
1668223003815,ECE 200,021,103606,Lin; Bill,9999,0,9999,0
1668223003815,ECE 200,022,103607,Liu; Zhaowei,9998,0,9999,1
1668223003815,ECE 200,023,103608,Lo; Yu-Hwa,9999,0,9999,0
1668223003815,ECE 200,024,103609,Lomakin; Vitaliy,9999,0,9999,0
1668223003815,ECE 200,025,103610,Mercier; Patrick Philip,9999,0,9999,0
1668223003815,ECE 200,026,103611,Meyer; Florian,9999,0,9999,0
1668223003815,ECE 200,027,103612,Milstein; Laurence B.,9999,0,9999,0
1668223003815,ECE 200,028,103613,Mir Arabbaygi; Siavash,9999,0,9999,0
1668223003815,ECE 200,029,103614,Mookherjea; Shayan,9999,0,9999,0
1668223003815,ECE 200,030,103615,Morris; Karcher William,9999,0,9999,0
1668223003815,ECE 200,031,103616,Ng; Tse Nga,9999,0,9999,0
1668223003815,ECE 200,032,103617,Nguyen; Truong Quang,9999,0,9999,0
1668223003815,ECE 200,033,103618,Nomura; Kenji,9999,0,9999,0
1668223003815,ECE 200,034,103619,Orlitsky; Alon,9999,0,9999,0
1668223003815,ECE 200,035,103620,Pal; Piya,9999,0,9999,0
1668223003815,ECE 200,036,103621,Papen; George C.,9999,0,9999,0
1668223003815,ECE 200,037,103622,Radic; Stojan,9999,0,9999,0
1668223003815,ECE 200,038,103623,Rao; Bhaskar D.,9999,0,9999,0
1668223003815,ECE 200,039,103624,Rao; Ramesh R,9999,0,9999,0
1668223003815,ECE 200,040,103625,Rebeiz; Gabriel,9999,0,9999,0
1668223003815,ECE 200,041,103626,Sanford; John R,9999,0,9999,0
1668223003815,ECE 200,042,103627,Siegel; Paul H.,9999,0,9999,0
1668223003815,ECE 200,043,103628,Sievenpiper; Daniel F.,9999,0,9999,0
1668223003815,ECE 200,044,103629,Sworder; David D.,9999,0,9999,0
1668223003815,ECE 200,045,103630,Taur; Yuan,9999,0,9999,0
1668223003815,ECE 200,046,103631,Touri; Behrouz,9999,0,9999,0
1668223003815,ECE 200,047,103632,Trivedi; Mohan M.,9999,0,9999,0
1668223003815,ECE 200,048,103633,Vasconcelos; Nuno,9999,0,9999,0
1668223003815,ECE 200,049,103634,Wang; Xiaolong,9999,0,9999,0
1668223003815,ECE 200,050,103635,Xie; Pengtao,9999,0,9999,0
1668223003815,ECE 200,051,103636,Yip; Michael,9999,0,9999,0
1668223003815,ECE 200,052,103637,Zeger; Kenneth A.,999,0,999,0
1668223003815,ECE 200,053,103638,Zhang; Xinyu,9999,0,9999,0
1668223003815,ECE 200,054,103639,Turakhia; Yatish Girish,9999,0,9999,0
1668223003815,ECE 200,055,103640,Kang; Mingu,9999,0,9999,0
1668223003815,ECE 200,056,103641,Shi; Yuanyuan,9999,0,9999,0
1668223003815,ECE 200,057,103642,Wang; Edward Jay,9999,0,9999,0
1668223003815,ECE 200,058,103643,Zheng; Yang,9999,0,9999,0
1668223004252,ECE 202,A00,103644,Kuzum; Duygu,0,0,0,0
1668223004676,ECE 212BN,A00,103646,Ng; Tse Nga,0,0,0,0
1668223005112,ECE 221,A00,111493,Staff,0,0,0,0
1668223005538,ECE 222B,A00,103647,Lomakin; Vitaliy,0,0,0,0
1668223005965,ECE 230B,A00,103648,Taur; Yuan,0,0,0,0
1668223006389,ECE 238B,A00,103649,Garay; Javier,0,0,0,0
1668223006816,ECE 240B,A00,112900,Fainman; Yeshaiahu,0,0,0,0
1668223007242,ECE 247A,A00,103650,Jokerst; Jesse Vincent,0,0,0,0
1668223007668,ECE 247B,A00,103651,Wang; Joseph,0,0,0,0
1668223008096,ECE 250,A00,103652,Siegel; Paul H.,0,0,0,0
1668223008533,ECE 251A,A00,103654,Rao; Bhaskar D.,0,0,0,0
1668223008959,ECE 257B,A00,103655,Bharadia; Dinesh,0,0,0,0
1668223009382,ECE 258A,A00,103656,Milstein; Laurence B.,0,0,0,0
1668223009983,ECE 260B,A00,103658,Kang; Mingu,0,0,0,0
1668223010406,ECE 264A,A00,103659,Galton; Ian A,0,0,0,0
1668223010832,ECE 265A,A00,103661,Gudem; Prasad S.S.,0,0,0,0
1668223011256,ECE 265D,A00,103662,Gudem; Prasad S.S.,0,0,0,0
1668223011680,ECE 268,A00,103663,Koushanfar; Farinaz,0,0,0,0
1668223012106,ECE 269,A01,103665,Pal; Piya,0,0,0,0
1668223012530,ECE 271B,A00,103666,Vasconcelos; Manuela,0,0,0,0
1668223013048,ECE 276A,A00,103667,Atanasov; Nikolay A.,0,0,0,0
1668223013480,ECE 277,A00,103668,An; Cheolhong,0,0,0,0
1668223013904,ECE 279,A00,117947,Hall; Drew A.,0,0,0,0
1668223014780,ECE 283,A00,103670,Hsueh; Tzu-Chien,0,0,0,0
1668223015204,ECE 284,A00,103671,Turakhia; Yatish Girish,0,0,0,0
1668223015628,ECE 285,A00,103672,Zheng; Yang,0,0,0,0
1668223015628,ECE 285,B00,103673,Sworder; David D.,0,0,0,0
1668223016053,ECE 287,A00,103676,Javidi; Tara,0,0,0,0
1668223016481,MATH 200B,A00,098023,Salehi Golsefidy; Alireza,12,0,15,3
1668223016907,MATH 202B,A00,098024,Rhoades; Brendon Patrick,9,0,15,6
1668223017330,MATH 203B,A00,098025,Oprea; Dragos N.,10,0,15,5
1668223017753,MATH 204B,A00,098026,Sorensen; Claus M,13,0,15,2
1668223018179,MATH 208,A00,098027,Izadi; Elham,7,0,10,3
1668223018602,MATH 209,A00,098028,Pollack; Aaron,10,0,10,0
1668223019031,MATH 211A,A00,112919,Rogalski; Daniel,9,0,10,1
1668223019461,MATH 211B,A00,112920,Seward; Brandon M.,9,0,10,1
1668223019882,MATH 218,A00,098029,Li; Bo,10,0,10,0
1668223020316,MATH 220B,A00,098030,Novak; Jonathan I,11,0,15,4
1668223020754,MATH 221A,A00,098031,Ebenfelt; Peter F,13,0,15,2
1668223021180,MATH 231B,A00,098032,Zlatos; Andrej,12,0,15,3
1668223021604,MATH 240B,A00,098033,Ni; Lei,9,0,15,6
1668223022030,MATH 243,A00,098034,Jekel; David Andrew,10,0,10,0
1668223022477,MATH 245A,A00,098035,Nie; Jiawang,0,0,15,16
1668223022902,MATH 248,A00,098036,Bejenaru; Ioan,10,0,10,0
1668223023329,MATH 250B,A00,098037,Spolaor; Luca,14,0,15,1
1668223023767,MATH 258,A00,098038,Ni; Lei,10,0,10,0
1668223024202,MATH 264B,A00,098041,Rhoades; Brendon Patrick,9,0,15,6
1668223024635,MATH 268,A00,098042,Buss; Samuel R,10,0,10,0
1668223025075,MATH 269,A00,098043,Rhoades; Brendon Patrick,10,0,10,0
1668223025500,MATH 270B,A00,098044,Li; Bo,10,0,15,5
1668223025926,MATH 272B,A00,098045,Holst; Michael J,13,0,15,2
1668223026352,MATH 273A,A00,098046,Tian; Xiaochuan,10,0,15,5
1668223026777,MATH 275,A01,098048,Tian; Xiaochuan,6,0,10,4
1668223027201,MATH 278A,A00,098049,Holst; Michael J,8,0,10,2
1668223027624,MATH 278B,A00,098050,Cloninger; Alexander,10,0,10,0
1668223028048,MATH 278C,A00,098051,Nie; Jiawang,7,0,10,3
1668223028482,MATH 280B,A00,098052,Zheng; Tianyi,10,0,15,5
1668223028918,MATH 281B,A00,098053,Bradic; Jelena,2,0,15,13
1668223029355,MATH 282B,A00,098054,Arias-Castro; Ery,0,0,15,15
1668223029783,MATH 285,A00,098055,Fitzsimmons; Patrick J,0,0,15,17
1668223030217,MATH 287B,A00,098056,Arias-Castro; Ery,2,0,15,13
1668223030648,MATH 288,A00,098057,Agarwal; Pooja,9,0,10,1
1668223030648,MATH 288,B00,098058,Zhang; Danna,8,0,10,2
1668223030648,MATH 288,C00,098059,Williams; Ruth J,10,0,10,0
1668223031076,MATH 290B,A00,098060,Roberts; Justin Deritter,13,0,15,2
1668223031500,MATH 292,A00,098061,Belmont; Eva Kinoshita,10,0,10,0
1668223031922,MATH 295,A00,098062,Suk; Andrew Hoon,48,0,50,2
1668223032346,MATH 296,A00,098063,Novak; Jonathan I,20,0,20,0
1668223032771,MATH 297,001,098064,Gamst; Anthony Collins,9997,0,9999,2
1668223535147,COGS 205,A00,101395,Chiba; Andrea,19,0,20,1
1668223535660,COGS 210B,001,101404,Greene; Deanna Jacquelyn,9998,0,9999,1
1668223535660,COGS 210B,002,101417,Xia; Haijun,9999,0,9999,0
1668223535660,COGS 210B,003,101422,Nitz; Douglas A.,9999,0,9999,0
1668223535660,COGS 210B,004,101423,Hollan; James D.,9998,0,9999,1
1668223535660,COGS 210B,005,101424,Deak; Gedeon O.,9998,0,9999,1
1668223535660,COGS 210B,006,101425,Rossano; Federico,9999,0,9999,0
1668223536086,COGS 211B,A00,101427,Coulson; Seana M,9996,0,9999,3
1668223536525,COGS 220,A00,101428,Hollan; James D.,0,0,25,25
1668223536950,COGS 229,A00,101429,Dow; Steven P,18,0,25,7
1668223537374,COGS 230,A00,101430,Klemmer; Scott R,12,0,17,5
1668223537801,COGS 234,A00,101431,Xia; Haijun,2,0,25,23
1668223538233,COGS 260,A00,101432,Kiyonaga; Anastasia,21,0,25,4
1668223538233,COGS 260,B00,101433,Kirsh; David Joel,15,0,25,10
1668223538659,CSE 202,A00,102371,Impagliazzo; Russell,0,0,0,0
1668223539089,CSE 203B,A01,102373,Cheng; Chung Kuan,0,0,0,0
1668223539676,CSE 208,A00,102374,Micciancio; Daniele,0,0,0,0
1668223540105,CSE 209A,A00,112895,Impagliazzo; Russell,0,0,15,15
1668223540533,CSE 209B,A00,108005,Bellare; Mihir,0,0,0,0
1668223540962,CSE 210,A00,113163,Coblenz; Michael J,0,0,0,0
1668223541385,CSE 219,A00,106111,Dow; Steven P,0,0,20,20
1668223541809,CSE 221,A00,102376,Voelker; Geoffrey M.,0,0,0,0
1668223542240,CSE 224,A01,102378,Porter; George M,0,0,0,0
1668223542674,CSE 229A,A00,102379,Savage; Stefan,0,0,0,0
1668223543107,CSE 229C,A00,102380,Munyaka; Imani N. S.,0,0,0,0
1668223543530,CSE 232B,A00,102382,Deutsch; Alin Bernard,0,0,0,0
1668223543967,CSE 234,A01,112904,Kumar; Arun Kumar,0,0,0,0
1668223544391,CSE 237A,A00,102383,Rosing; Tajana Simunic,0,0,0,0
1668223544820,CSE 239A,A00,102384,Deutsch; Alin Bernard,0,0,0,0
1668223545245,CSE 239B,A00,102385,Polikarpova; Nadezhda,0,0,0,0
1668223545668,CSE 240A,A00,102386,Pannuto; Patrick William,0,0,0,0
1668223546093,CSE 240B,A00,102387,Zhao; Jishen,0,0,0,0
1668223546516,CSE 241A,A00,106406,Kang; Mingu,0,0,0,0
1668223546938,CSE 249B,A00,102388,Kahng; Andrew Byun,0,0,8,8
1668223547363,CSE 251B,A01,102392,Cottrell; Garrison W,0,0,0,0
1668223547363,CSE 251B,A02,102393,Cottrell; Garrison W,0,0,0,0
1668223547788,CSE 252B,A00,102394,Ochoa; Benjamin Lawrence,0,0,0,0
1668223548210,CSE 257,A01,102396,Gao; Sicun,0,0,0,0
1668223548636,CSE 272,A00,102397,Li; Tzumao,0,0,0,0
1668223549068,CSE 274,A00,111323,Chern; Albert Ren-Haur,0,0,0,0
1668223549491,CSE 282,A00,102398,Pevzner; Pavel Arkadjevich,0,0,0,0
1668223549914,CSE 284,A00,114175,Gymrek; Melissa Ann,0,0,0,0
1668223550346,CSE 290,A00,102399,Chandraker; Manmohan Krishna,0,0,0,0
1668223550346,CSE 290,B00,102400,Vaccaro; Kristen Marie,0,0,25,25
1668223550346,CSE 290,C00,102414,Pannuto; Patrick William,0,0,25,25
1668223550346,CSE 290,D00,102427,Pevzner; Pavel Arkadjevich,0,0,0,0
1668223550346,CSE 290,E00,102429,Zhao; Jishen,0,0,0,0
1668223550346,CSE 290,F00,102436,Tullsen; Dean Michael,0,0,0,0
1668223550346,CSE 290,G00,102440,Christensen; Henrik I,0,0,20,20
1668223550770,CSE 291,A00,102443,Su; Hao,0,0,0,0
1668223550770,CSE 291,B00,102448,Polikarpova; Nadezhda,0,0,0,0
1668223550770,CSE 291,C00,102453,Vaccaro; Kristen Marie,0,0,0,0
1668223550770,CSE 291,D00,111343,Savage; Stefan,0,0,0,0
1668223550770,CSE 291,E00,116474,Claffy; Kimberly Claire,0,0,0,0
1668223550770,CSE 291,F00,116479,Pasquale; Joseph,0,0,0,0
1668223551226,CSE 293,001,119111,Bafna; Vineet,9999,0,9999,0
1668223551226,CSE 293,002,119118,Bellare; Mihir,9999,0,9999,0
1668223551226,CSE 293,003,119122,Berg-Kirkpatrick; Taylor D,9999,0,9999,0
1668223551226,CSE 293,004,119135,Christensen; Henrik I,9999,0,9999,0
1668223551226,CSE 293,005,119142,Cottrell; Garrison W,9999,0,9999,0
1668223551226,CSE 293,006,119146,Deutsch; Alin Bernard,9999,0,9999,0
1668223551226,CSE 293,007,119159,Esmaeilzadeh; Hadi,9999,0,9999,0
1668223551226,CSE 293,008,119166,Freund; Yoav,9999,0,9999,0
1668223551226,CSE 293,009,119170,Griswold; William G.,9999,0,9999,0
1668223551226,CSE 293,010,119183,Gymrek; Melissa Ann,9999,0,9999,0
1668223551226,CSE 293,011,119190,Heninger; Nadia A,9999,0,9999,0
1668223551226,CSE 293,012,119230,Impagliazzo; Russell,9999,0,9999,0
1668223551226,CSE 293,013,119232,Jhala; Ranjit,9999,0,9999,0
1668223551226,CSE 293,014,119233,Kahng; Andrew Byun,9999,0,9999,0
1668223551226,CSE 293,015,119298,Kane; Daniel Mertz,9999,0,9999,0
1668223551226,CSE 293,016,119299,Kriegman; David J,9999,0,9999,0
1668223551226,CSE 293,017,119300,Kumar; Arun Kumar,9999,0,9999,0
1668223551226,CSE 293,018,119301,Lerner; Sorin,9999,0,9999,0
1668223551226,CSE 293,019,119302,Lovett; Shachar,9999,0,9999,0
1668223551226,CSE 293,020,119303,McAuley; Julian John,9999,0,9999,0
1668223551226,CSE 293,021,119304,Micciancio; Daniele,9999,0,9999,0
1668223551226,CSE 293,022,119367,Orailoglu; Alex,9999,0,9999,0
1668223551226,CSE 293,023,119382,Paturi; Ramamohan,9999,0,9999,0
1668223551226,CSE 293,024,119404,Polikarpova; Nadezhda,9999,0,9999,0
1668223551226,CSE 293,025,119406,Politz; Joseph Gibbs,9999,0,9999,0
1668223551226,CSE 293,026,119411,Porter; George M,9999,0,9999,0
1668223551226,CSE 293,027,119414,Porter; Leonard Emerson,9999,0,9999,0
1668223551226,CSE 293,028,119416,Ramamoorthi; Ravi,9999,0,9999,0
1668223551226,CSE 293,029,119417,Sahoo; Debashis,9999,0,9999,0
1668223551226,CSE 293,030,119420,Saul; Lawrence,9999,0,9999,0
1668223551226,CSE 293,031,119421,Savage; Stefan,9999,0,9999,0
1668223551226,CSE 293,032,119425,Schulze; Jurgen P.,9999,0,9999,0
1668223551226,CSE 293,033,119426,Snoeren; Alex C.,9999,0,9999,0
1668223551226,CSE 293,034,119428,Shang; Jingbo,9999,0,9999,0
1668223551226,CSE 293,035,119430,Stefan; Deian,9999,0,9999,0
1668223551226,CSE 293,036,119431,Su; Hao,9999,0,9999,0
1668223551226,CSE 293,037,119433,Swanson; Steven James,9999,0,9999,0
1668223551226,CSE 293,038,119435,Tullsen; Dean Michael,9999,0,9999,0
1668223551226,CSE 293,039,119483,Voelker; Geoffrey M.,9999,0,9999,0
1668223551226,CSE 293,040,119537,Zhao; Jishen,9999,0,9999,0
1668223551226,CSE 293,041,119538,Zhou; Yuan-Yuan,9999,0,9999,0
1668223551226,CSE 293,042,119539,Gao; Sicun,9999,0,9999,0
1668223551226,CSE 293,043,119540,Weibel; Nadir,9999,0,9999,0
1668223551226,CSE 293,044,119541,Gupta; Rajesh K.,9999,0,9999,0
1668223551226,CSE 293,045,126410,Vaccaro; Kristen Marie,9999,0,9999,0
1668223551226,CSE 293,046,126411,Klemke; Richard,9999,0,9999,0
1668223551651,CSE 294,A00,102459,Voelker; Geoffrey M.,0,0,0,0
1668223551651,CSE 294,B00,111322,Orailoglu; Alex,0,0,0,0
1668223552077,DSE 201,A00,096914,Deutsch; Alin Bernard,30,0,30,0
1668223552501,DSE 210,A00,096915,Dasgupta; Sanjoy,30,0,30,0
1668223552937,DSE 260A,A00,096916,Altintas De Callaf; Ilkay,30,0,30,0
1668223553369,ECE 200,001,103586,Antipa; Nicholas A,9999,0,9999,0
1668223553369,ECE 200,002,103587,Atanasov; Nikolay A.,9999,0,9999,0
1668223553369,ECE 200,003,103588,Bharadia; Dinesh,9999,0,9999,0
1668223553369,ECE 200,004,103589,Cheng; Chung Kuan,9999,0,9999,0
1668223553369,ECE 200,005,103590,Cosman; Pamela C.,9999,0,9999,0
1668223553369,ECE 200,006,103591,Dayeh; Shadi Ahmad,9999,0,9999,0
1668223553369,ECE 200,007,103592,Fainman; Yeshaiahu,9999,0,9999,0
1668223553369,ECE 200,008,103593,Ford; Joseph Earl,9999,0,9999,0
1668223553369,ECE 200,009,103594,Franceschetti; Massimo,9999,0,9999,0
1668223553369,ECE 200,010,103595,Fullerton; Eric E,9999,0,9999,0
1668223553369,ECE 200,011,103596,Galton; Ian A,9999,0,9999,0
1668223553369,ECE 200,012,103597,Gilja; Vikash,9999,0,9999,0
1668223553369,ECE 200,013,103598,Hall; Drew A.,9999,0,9999,0
1668223553369,ECE 200,014,103599,Hsueh; Tzu-Chien,9999,0,9999,0
1668223553369,ECE 200,015,103600,Javidi; Tara,9999,0,9999,0
1668223553369,ECE 200,016,103601,Kahng; Andrew Byun,9999,0,9999,0
1668223553369,ECE 200,017,103602,Kim; Young-Han,9999,0,9999,0
1668223553369,ECE 200,018,103603,Koushanfar; Farinaz,9999,0,9999,0
1668223553369,ECE 200,019,103604,Kuzum; Duygu,9999,0,9999,0
1668223553369,ECE 200,020,103605,Le; Hanh-Phuc,9999,0,9999,0
1668223553369,ECE 200,021,103606,Lin; Bill,9999,0,9999,0
1668223553369,ECE 200,022,103607,Liu; Zhaowei,9998,0,9999,1
1668223553369,ECE 200,023,103608,Lo; Yu-Hwa,9999,0,9999,0
1668223553369,ECE 200,024,103609,Lomakin; Vitaliy,9999,0,9999,0
1668223553369,ECE 200,025,103610,Mercier; Patrick Philip,9999,0,9999,0
1668223553369,ECE 200,026,103611,Meyer; Florian,9999,0,9999,0
1668223553369,ECE 200,027,103612,Milstein; Laurence B.,9999,0,9999,0
1668223553369,ECE 200,028,103613,Mir Arabbaygi; Siavash,9999,0,9999,0
1668223553369,ECE 200,029,103614,Mookherjea; Shayan,9999,0,9999,0
1668223553369,ECE 200,030,103615,Morris; Karcher William,9999,0,9999,0
1668223553369,ECE 200,031,103616,Ng; Tse Nga,9999,0,9999,0
1668223553369,ECE 200,032,103617,Nguyen; Truong Quang,9999,0,9999,0
1668223553369,ECE 200,033,103618,Nomura; Kenji,9999,0,9999,0
1668223553369,ECE 200,034,103619,Orlitsky; Alon,9999,0,9999,0
1668223553369,ECE 200,035,103620,Pal; Piya,9999,0,9999,0
1668223553369,ECE 200,036,103621,Papen; George C.,9999,0,9999,0
1668223553369,ECE 200,037,103622,Radic; Stojan,9999,0,9999,0
1668223553369,ECE 200,038,103623,Rao; Bhaskar D.,9999,0,9999,0
1668223553369,ECE 200,039,103624,Rao; Ramesh R,9999,0,9999,0
1668223553369,ECE 200,040,103625,Rebeiz; Gabriel,9999,0,9999,0
1668223553369,ECE 200,041,103626,Sanford; John R,9999,0,9999,0
1668223553369,ECE 200,042,103627,Siegel; Paul H.,9999,0,9999,0
1668223553369,ECE 200,043,103628,Sievenpiper; Daniel F.,9999,0,9999,0
1668223553369,ECE 200,044,103629,Sworder; David D.,9999,0,9999,0
1668223553369,ECE 200,045,103630,Taur; Yuan,9999,0,9999,0
1668223553369,ECE 200,046,103631,Touri; Behrouz,9999,0,9999,0
1668223553369,ECE 200,047,103632,Trivedi; Mohan M.,9999,0,9999,0
1668223553369,ECE 200,048,103633,Vasconcelos; Nuno,9999,0,9999,0
1668223553369,ECE 200,049,103634,Wang; Xiaolong,9999,0,9999,0
1668223553369,ECE 200,050,103635,Xie; Pengtao,9999,0,9999,0
1668223553369,ECE 200,051,103636,Yip; Michael,9999,0,9999,0
1668223553369,ECE 200,052,103637,Zeger; Kenneth A.,999,0,999,0
1668223553369,ECE 200,053,103638,Zhang; Xinyu,9999,0,9999,0
1668223553369,ECE 200,054,103639,Turakhia; Yatish Girish,9999,0,9999,0
1668223553369,ECE 200,055,103640,Kang; Mingu,9999,0,9999,0
1668223553369,ECE 200,056,103641,Shi; Yuanyuan,9999,0,9999,0
1668223553369,ECE 200,057,103642,Wang; Edward Jay,9999,0,9999,0
1668223553369,ECE 200,058,103643,Zheng; Yang,9999,0,9999,0
1668223553795,ECE 202,A00,103644,Kuzum; Duygu,0,0,0,0
1668223554224,ECE 212BN,A00,103646,Ng; Tse Nga,0,0,0,0
1668223554649,ECE 221,A00,111493,Staff,0,0,0,0
1668223555077,ECE 222B,A00,103647,Lomakin; Vitaliy,0,0,0,0
1668223555502,ECE 230B,A00,103648,Taur; Yuan,0,0,0,0
1668223555926,ECE 238B,A00,103649,Garay; Javier,0,0,0,0
1668223556350,ECE 240B,A00,112900,Fainman; Yeshaiahu,0,0,0,0
1668223556774,ECE 247A,A00,103650,Jokerst; Jesse Vincent,0,0,0,0
1668223557199,ECE 247B,A00,103651,Wang; Joseph,0,0,0,0
1668223557622,ECE 250,A00,103652,Siegel; Paul H.,0,0,0,0
1668223558046,ECE 251A,A00,103654,Rao; Bhaskar D.,0,0,0,0
1668223558480,ECE 257B,A00,103655,Bharadia; Dinesh,0,0,0,0
1668223558905,ECE 258A,A00,103656,Milstein; Laurence B.,0,0,0,0
1668223559329,ECE 260B,A00,103658,Kang; Mingu,0,0,0,0
1668223559753,ECE 264A,A00,103659,Galton; Ian A,0,0,0,0
1668223560178,ECE 265A,A00,103661,Gudem; Prasad S.S.,0,0,0,0
1668223560603,ECE 265D,A00,103662,Gudem; Prasad S.S.,0,0,0,0
1668223561029,ECE 268,A00,103663,Koushanfar; Farinaz,0,0,0,0
1668223561452,ECE 269,A01,103665,Pal; Piya,0,0,0,0
1668223561880,ECE 271B,A00,103666,Vasconcelos; Manuela,0,0,0,0
1668223562303,ECE 276A,A00,103667,Atanasov; Nikolay A.,0,0,0,0
1668223562725,ECE 277,A00,103668,An; Cheolhong,0,0,0,0
1668223563160,ECE 279,A00,117947,Hall; Drew A.,0,0,0,0
1668223564028,ECE 283,A00,103670,Hsueh; Tzu-Chien,0,0,0,0
1668223564451,ECE 284,A00,103671,Turakhia; Yatish Girish,0,0,0,0
1668223564878,ECE 285,A00,103672,Zheng; Yang,0,0,0,0
1668223564878,ECE 285,B00,103673,Sworder; David D.,0,0,0,0
1668223565310,ECE 287,A00,103676,Javidi; Tara,0,0,0,0
1668223565732,MATH 200B,A00,098023,Salehi Golsefidy; Alireza,12,0,15,3
1668223566164,MATH 202B,A00,098024,Rhoades; Brendon Patrick,9,0,15,6
1668223566588,MATH 203B,A00,098025,Oprea; Dragos N.,10,0,15,5
1668223567017,MATH 204B,A00,098026,Sorensen; Claus M,13,0,15,2
1668223567451,MATH 208,A00,098027,Izadi; Elham,7,0,10,3
1668223567876,MATH 209,A00,098028,Pollack; Aaron,10,0,10,0
1668223568302,MATH 211A,A00,112919,Rogalski; Daniel,9,0,10,1
1668223568743,MATH 211B,A00,112920,Seward; Brandon M.,9,0,10,1
1668223569180,MATH 218,A00,098029,Li; Bo,10,0,10,0
1668223569616,MATH 220B,A00,098030,Novak; Jonathan I,11,0,15,4
1668223570039,MATH 221A,A00,098031,Ebenfelt; Peter F,13,0,15,2
1668223570462,MATH 231B,A00,098032,Zlatos; Andrej,12,0,15,3
1668223570887,MATH 240B,A00,098033,Ni; Lei,9,0,15,6
1668223571317,MATH 243,A00,098034,Jekel; David Andrew,10,0,10,0
1668223571741,MATH 245A,A00,098035,Nie; Jiawang,0,0,15,16
1668223572165,MATH 248,A00,098036,Bejenaru; Ioan,10,0,10,0
1668223572601,MATH 250B,A00,098037,Spolaor; Luca,14,0,15,1
1668223573024,MATH 258,A00,098038,Ni; Lei,10,0,10,0
1668223573461,MATH 264B,A00,098041,Rhoades; Brendon Patrick,9,0,15,6
1668223573884,MATH 268,A00,098042,Buss; Samuel R,10,0,10,0
1668223574310,MATH 269,A00,098043,Rhoades; Brendon Patrick,10,0,10,0
1668223574747,MATH 270B,A00,098044,Li; Bo,10,0,15,5
1668223575174,MATH 272B,A00,098045,Holst; Michael J,13,0,15,2
1668223575599,MATH 273A,A00,098046,Tian; Xiaochuan,10,0,15,5
1668223576022,MATH 275,A01,098048,Tian; Xiaochuan,6,0,10,4
1668223576452,MATH 278A,A00,098049,Holst; Michael J,8,0,10,2
1668223576878,MATH 278B,A00,098050,Cloninger; Alexander,10,0,10,0
1668223577302,MATH 278C,A00,098051,Nie; Jiawang,7,0,10,3
1668223577727,MATH 280B,A00,098052,Zheng; Tianyi,10,0,15,5
1668223578157,MATH 281B,A00,098053,Bradic; Jelena,2,0,15,13
1668223578582,MATH 282B,A00,098054,Arias-Castro; Ery,0,0,15,15
1668223579118,MATH 285,A00,098055,Fitzsimmons; Patrick J,0,0,15,17
1668223579542,MATH 287B,A00,098056,Arias-Castro; Ery,2,0,15,13
1668223579968,MATH 288,A00,098057,Agarwal; Pooja,9,0,10,1
1668223579968,MATH 288,B00,098058,Zhang; Danna,8,0,10,2
1668223579968,MATH 288,C00,098059,Williams; Ruth J,10,0,10,0
1668223580400,MATH 290B,A00,098060,Roberts; Justin Deritter,13,0,15,2
1668223580827,MATH 292,A00,098061,Belmont; Eva Kinoshita,10,0,10,0
1668223581250,MATH 295,A00,098062,Suk; Andrew Hoon,48,0,50,2
1668223581674,MATH 296,A00,098063,Novak; Jonathan I,20,0,20,0
1668223582105,MATH 297,001,098064,Gamst; Anthony Collins,9997,0,9999,2
1668224093375,COGS 205,A00,101395,Chiba; Andrea,19,0,20,1
1668224093798,COGS 210B,001,101404,Greene; Deanna Jacquelyn,9998,0,9999,1
1668224093798,COGS 210B,002,101417,Xia; Haijun,9999,0,9999,0
1668224093798,COGS 210B,003,101422,Nitz; Douglas A.,9999,0,9999,0
1668224093798,COGS 210B,004,101423,Hollan; James D.,9998,0,9999,1
1668224093798,COGS 210B,005,101424,Deak; Gedeon O.,9998,0,9999,1
1668224093798,COGS 210B,006,101425,Rossano; Federico,9999,0,9999,0
1668224094221,COGS 211B,A00,101427,Coulson; Seana M,9996,0,9999,3
1668224094646,COGS 220,A00,101428,Hollan; James D.,0,0,25,25
1668224095077,COGS 229,A00,101429,Dow; Steven P,18,0,25,7
1668224095500,COGS 230,A00,101430,Klemmer; Scott R,12,0,17,5
1668224095925,COGS 234,A00,101431,Xia; Haijun,2,0,25,23
1668224096348,COGS 260,A00,101432,Kiyonaga; Anastasia,21,0,25,4
1668224096348,COGS 260,B00,101433,Kirsh; David Joel,15,0,25,10
1668224096773,CSE 202,A00,102371,Impagliazzo; Russell,0,0,0,0
1668224097198,CSE 203B,A01,102373,Cheng; Chung Kuan,0,0,0,0
1668224097622,CSE 208,A00,102374,Micciancio; Daniele,0,0,0,0
1668224098044,CSE 209A,A00,112895,Impagliazzo; Russell,0,0,15,15
1668224098471,CSE 209B,A00,108005,Bellare; Mihir,0,0,0,0
1668224098895,CSE 210,A00,113163,Coblenz; Michael J,0,0,0,0
1668224099318,CSE 219,A00,106111,Dow; Steven P,0,0,20,20
1668224099745,CSE 221,A00,102376,Voelker; Geoffrey M.,0,0,0,0
1668224100169,CSE 224,A01,102378,Porter; George M,0,0,0,0
1668224100591,CSE 229A,A00,102379,Savage; Stefan,0,0,0,0
1668224101015,CSE 229C,A00,102380,Munyaka; Imani N. S.,0,0,0,0
1668224101446,CSE 232B,A00,102382,Deutsch; Alin Bernard,0,0,0,0
1668224101878,CSE 234,A01,112904,Kumar; Arun Kumar,0,0,0,0
1668224102309,CSE 237A,A00,102383,Rosing; Tajana Simunic,0,0,0,0
1668224102737,CSE 239A,A00,102384,Deutsch; Alin Bernard,0,0,0,0
1668224103161,CSE 239B,A00,102385,Polikarpova; Nadezhda,0,0,0,0
1668224103595,CSE 240A,A00,102386,Pannuto; Patrick William,0,0,0,0
1668224104018,CSE 240B,A00,102387,Zhao; Jishen,0,0,0,0
1668224104442,CSE 241A,A00,106406,Kang; Mingu,0,0,0,0
1668224104865,CSE 249B,A00,102388,Kahng; Andrew Byun,0,0,8,8
1668224105288,CSE 251B,A01,102392,Cottrell; Garrison W,0,0,0,0
1668224105288,CSE 251B,A02,102393,Cottrell; Garrison W,0,0,0,0
1668224105715,CSE 252B,A00,102394,Ochoa; Benjamin Lawrence,0,0,0,0
1668224106142,CSE 257,A01,102396,Gao; Sicun,0,0,0,0
1668224106562,CSE 272,A00,102397,Li; Tzumao,0,0,0,0
1668224106986,CSE 274,A00,111323,Chern; Albert Ren-Haur,0,0,0,0
1668224107417,CSE 282,A00,102398,Pevzner; Pavel Arkadjevich,0,0,0,0
1668224107841,CSE 284,A00,114175,Gymrek; Melissa Ann,0,0,0,0
1668224108268,CSE 290,A00,102399,Chandraker; Manmohan Krishna,0,0,0,0
1668224108268,CSE 290,B00,102400,Vaccaro; Kristen Marie,0,0,25,25
1668224108268,CSE 290,C00,102414,Pannuto; Patrick William,0,0,25,25
1668224108268,CSE 290,D00,102427,Pevzner; Pavel Arkadjevich,0,0,0,0
1668224108268,CSE 290,E00,102429,Zhao; Jishen,0,0,0,0
1668224108268,CSE 290,F00,102436,Tullsen; Dean Michael,0,0,0,0
1668224108268,CSE 290,G00,102440,Christensen; Henrik I,0,0,20,20
1668224108697,CSE 291,A00,102443,Su; Hao,0,0,0,0
1668224108697,CSE 291,B00,102448,Polikarpova; Nadezhda,0,0,0,0
1668224108697,CSE 291,C00,102453,Vaccaro; Kristen Marie,0,0,0,0
1668224108697,CSE 291,D00,111343,Savage; Stefan,0,0,0,0
1668224108697,CSE 291,E00,116474,Claffy; Kimberly Claire,0,0,0,0
1668224108697,CSE 291,F00,116479,Pasquale; Joseph,0,0,0,0
1668224109123,CSE 293,001,119111,Bafna; Vineet,9999,0,9999,0
1668224109123,CSE 293,002,119118,Bellare; Mihir,9999,0,9999,0
1668224109123,CSE 293,003,119122,Berg-Kirkpatrick; Taylor D,9999,0,9999,0
1668224109123,CSE 293,004,119135,Christensen; Henrik I,9999,0,9999,0
1668224109123,CSE 293,005,119142,Cottrell; Garrison W,9999,0,9999,0
1668224109123,CSE 293,006,119146,Deutsch; Alin Bernard,9999,0,9999,0
1668224109123,CSE 293,007,119159,Esmaeilzadeh; Hadi,9999,0,9999,0
1668224109123,CSE 293,008,119166,Freund; Yoav,9999,0,9999,0
1668224109123,CSE 293,009,119170,Griswold; William G.,9999,0,9999,0
1668224109123,CSE 293,010,119183,Gymrek; Melissa Ann,9999,0,9999,0
1668224109123,CSE 293,011,119190,Heninger; Nadia A,9999,0,9999,0
1668224109123,CSE 293,012,119230,Impagliazzo; Russell,9999,0,9999,0
1668224109123,CSE 293,013,119232,Jhala; Ranjit,9999,0,9999,0
1668224109123,CSE 293,014,119233,Kahng; Andrew Byun,9999,0,9999,0
1668224109123,CSE 293,015,119298,Kane; Daniel Mertz,9999,0,9999,0
1668224109123,CSE 293,016,119299,Kriegman; David J,9999,0,9999,0
1668224109123,CSE 293,017,119300,Kumar; Arun Kumar,9999,0,9999,0
1668224109123,CSE 293,018,119301,Lerner; Sorin,9999,0,9999,0
1668224109123,CSE 293,019,119302,Lovett; Shachar,9999,0,9999,0
1668224109123,CSE 293,020,119303,McAuley; Julian John,9999,0,9999,0
1668224109123,CSE 293,021,119304,Micciancio; Daniele,9999,0,9999,0
1668224109123,CSE 293,022,119367,Orailoglu; Alex,9999,0,9999,0
1668224109123,CSE 293,023,119382,Paturi; Ramamohan,9999,0,9999,0
1668224109123,CSE 293,024,119404,Polikarpova; Nadezhda,9999,0,9999,0
1668224109123,CSE 293,025,119406,Politz; Joseph Gibbs,9999,0,9999,0
1668224109123,CSE 293,026,119411,Porter; George M,9999,0,9999,0
1668224109123,CSE 293,027,119414,Porter; Leonard Emerson,9999,0,9999,0
1668224109123,CSE 293,028,119416,Ramamoorthi; Ravi,9999,0,9999,0
1668224109123,CSE 293,029,119417,Sahoo; Debashis,9999,0,9999,0
1668224109123,CSE 293,030,119420,Saul; Lawrence,9999,0,9999,0
1668224109123,CSE 293,031,119421,Savage; Stefan,9999,0,9999,0
1668224109123,CSE 293,032,119425,Schulze; Jurgen P.,9999,0,9999,0
1668224109123,CSE 293,033,119426,Snoeren; Alex C.,9999,0,9999,0
1668224109123,CSE 293,034,119428,Shang; Jingbo,9999,0,9999,0
1668224109123,CSE 293,035,119430,Stefan; Deian,9999,0,9999,0
1668224109123,CSE 293,036,119431,Su; Hao,9999,0,9999,0
1668224109123,CSE 293,037,119433,Swanson; Steven James,9999,0,9999,0
1668224109123,CSE 293,038,119435,Tullsen; Dean Michael,9999,0,9999,0
1668224109123,CSE 293,039,119483,Voelker; Geoffrey M.,9999,0,9999,0
1668224109123,CSE 293,040,119537,Zhao; Jishen,9999,0,9999,0
1668224109123,CSE 293,041,119538,Zhou; Yuan-Yuan,9999,0,9999,0
1668224109123,CSE 293,042,119539,Gao; Sicun,9999,0,9999,0
1668224109123,CSE 293,043,119540,Weibel; Nadir,9999,0,9999,0
1668224109123,CSE 293,044,119541,Gupta; Rajesh K.,9999,0,9999,0
1668224109123,CSE 293,045,126410,Vaccaro; Kristen Marie,9999,0,9999,0
1668224109123,CSE 293,046,126411,Klemke; Richard,9999,0,9999,0
1668224109560,CSE 294,A00,102459,Voelker; Geoffrey M.,0,0,0,0
1668224109560,CSE 294,B00,111322,Orailoglu; Alex,0,0,0,0
1668224109994,DSE 201,A00,096914,Deutsch; Alin Bernard,30,0,30,0
1668224110490,DSE 210,A00,096915,Dasgupta; Sanjoy,30,0,30,0
1668224110913,DSE 260A,A00,096916,Altintas De Callaf; Ilkay,30,0,30,0
1668224111372,ECE 200,001,103586,Antipa; Nicholas A,9999,0,9999,0
1668224111372,ECE 200,002,103587,Atanasov; Nikolay A.,9999,0,9999,0
1668224111372,ECE 200,003,103588,Bharadia; Dinesh,9999,0,9999,0
1668224111372,ECE 200,004,103589,Cheng; Chung Kuan,9999,0,9999,0
1668224111372,ECE 200,005,103590,Cosman; Pamela C.,9999,0,9999,0
1668224111372,ECE 200,006,103591,Dayeh; Shadi Ahmad,9999,0,9999,0
1668224111372,ECE 200,007,103592,Fainman; Yeshaiahu,9999,0,9999,0
1668224111372,ECE 200,008,103593,Ford; Joseph Earl,9999,0,9999,0
1668224111372,ECE 200,009,103594,Franceschetti; Massimo,9999,0,9999,0
1668224111372,ECE 200,010,103595,Fullerton; Eric E,9999,0,9999,0
1668224111372,ECE 200,011,103596,Galton; Ian A,9999,0,9999,0
1668224111372,ECE 200,012,103597,Gilja; Vikash,9999,0,9999,0
1668224111372,ECE 200,013,103598,Hall; Drew A.,9999,0,9999,0
1668224111372,ECE 200,014,103599,Hsueh; Tzu-Chien,9999,0,9999,0
1668224111372,ECE 200,015,103600,Javidi; Tara,9999,0,9999,0
1668224111372,ECE 200,016,103601,Kahng; Andrew Byun,9999,0,9999,0
1668224111372,ECE 200,017,103602,Kim; Young-Han,9999,0,9999,0
1668224111372,ECE 200,018,103603,Koushanfar; Farinaz,9999,0,9999,0
1668224111372,ECE 200,019,103604,Kuzum; Duygu,9999,0,9999,0
1668224111372,ECE 200,020,103605,Le; Hanh-Phuc,9999,0,9999,0
1668224111372,ECE 200,021,103606,Lin; Bill,9999,0,9999,0
1668224111372,ECE 200,022,103607,Liu; Zhaowei,9998,0,9999,1
1668224111372,ECE 200,023,103608,Lo; Yu-Hwa,9999,0,9999,0
1668224111372,ECE 200,024,103609,Lomakin; Vitaliy,9999,0,9999,0
1668224111372,ECE 200,025,103610,Mercier; Patrick Philip,9999,0,9999,0
1668224111372,ECE 200,026,103611,Meyer; Florian,9999,0,9999,0
1668224111372,ECE 200,027,103612,Milstein; Laurence B.,9999,0,9999,0
1668224111372,ECE 200,028,103613,Mir Arabbaygi; Siavash,9999,0,9999,0
1668224111372,ECE 200,029,103614,Mookherjea; Shayan,9999,0,9999,0
1668224111372,ECE 200,030,103615,Morris; Karcher William,9999,0,9999,0
1668224111372,ECE 200,031,103616,Ng; Tse Nga,9999,0,9999,0
1668224111372,ECE 200,032,103617,Nguyen; Truong Quang,9999,0,9999,0
1668224111372,ECE 200,033,103618,Nomura; Kenji,9999,0,9999,0
1668224111372,ECE 200,034,103619,Orlitsky; Alon,9999,0,9999,0
1668224111372,ECE 200,035,103620,Pal; Piya,9999,0,9999,0
1668224111372,ECE 200,036,103621,Papen; George C.,9999,0,9999,0
1668224111372,ECE 200,037,103622,Radic; Stojan,9999,0,9999,0
1668224111372,ECE 200,038,103623,Rao; Bhaskar D.,9999,0,9999,0
1668224111372,ECE 200,039,103624,Rao; Ramesh R,9999,0,9999,0
1668224111372,ECE 200,040,103625,Rebeiz; Gabriel,9999,0,9999,0
1668224111372,ECE 200,041,103626,Sanford; John R,9999,0,9999,0
1668224111372,ECE 200,042,103627,Siegel; Paul H.,9999,0,9999,0
1668224111372,ECE 200,043,103628,Sievenpiper; Daniel F.,9999,0,9999,0
1668224111372,ECE 200,044,103629,Sworder; David D.,9999,0,9999,0
1668224111372,ECE 200,045,103630,Taur; Yuan,9999,0,9999,0
1668224111372,ECE 200,046,103631,Touri; Behrouz,9999,0,9999,0
1668224111372,ECE 200,047,103632,Trivedi; Mohan M.,9999,0,9999,0
1668224111372,ECE 200,048,103633,Vasconcelos; Nuno,9999,0,9999,0
1668224111372,ECE 200,049,103634,Wang; Xiaolong,9999,0,9999,0
1668224111372,ECE 200,050,103635,Xie; Pengtao,9999,0,9999,0
1668224111372,ECE 200,051,103636,Yip; Michael,9999,0,9999,0
1668224111372,ECE 200,052,103637,Zeger; Kenneth A.,999,0,999,0
1668224111372,ECE 200,053,103638,Zhang; Xinyu,9999,0,9999,0
1668224111372,ECE 200,054,103639,Turakhia; Yatish Girish,9999,0,9999,0
1668224111372,ECE 200,055,103640,Kang; Mingu,9999,0,9999,0
1668224111372,ECE 200,056,103641,Shi; Yuanyuan,9999,0,9999,0
1668224111372,ECE 200,057,103642,Wang; Edward Jay,9999,0,9999,0
1668224111372,ECE 200,058,103643,Zheng; Yang,9999,0,9999,0
1668224111794,ECE 202,A00,103644,Kuzum; Duygu,0,0,0,0
1668224112223,ECE 212BN,A00,103646,Ng; Tse Nga,0,0,0,0
1668224112645,ECE 221,A00,111493,Staff,0,0,0,0
1668224113231,ECE 222B,A00,103647,Lomakin; Vitaliy,0,0,0,0
1668224113657,ECE 230B,A00,103648,Taur; Yuan,0,0,0,0
1668224114083,ECE 238B,A00,103649,Garay; Javier,0,0,0,0
1668224114512,ECE 240B,A00,112900,Fainman; Yeshaiahu,0,0,0,0
1668224114938,ECE 247A,A00,103650,Jokerst; Jesse Vincent,0,0,0,0
1668224115366,ECE 247B,A00,103651,Wang; Joseph,0,0,0,0
1668224115793,ECE 250,A00,103652,Siegel; Paul H.,0,0,0,0
1668224116217,ECE 251A,A00,103654,Rao; Bhaskar D.,0,0,0,0
1668224116644,ECE 257B,A00,103655,Bharadia; Dinesh,0,0,0,0
1668224117076,ECE 258A,A00,103656,Milstein; Laurence B.,0,0,0,0
1668224117510,ECE 260B,A00,103658,Kang; Mingu,0,0,0,0
1668224117934,ECE 264A,A00,103659,Galton; Ian A,0,0,0,0
1668224118362,ECE 265A,A00,103661,Gudem; Prasad S.S.,0,0,0,0
1668224118793,ECE 265D,A00,103662,Gudem; Prasad S.S.,0,0,0,0
1668224119221,ECE 268,A00,103663,Koushanfar; Farinaz,0,0,0,0
1668224119656,ECE 269,A01,103665,Pal; Piya,0,0,0,0
1668224120080,ECE 271B,A00,103666,Vasconcelos; Manuela,0,0,0,0
1668224120510,ECE 276A,A00,103667,Atanasov; Nikolay A.,0,0,0,0
1668224120941,ECE 277,A00,103668,An; Cheolhong,0,0,0,0
1668224121371,ECE 279,A00,117947,Hall; Drew A.,0,0,0,0
1668224122223,ECE 283,A00,103670,Hsueh; Tzu-Chien,0,0,0,0
1668224122649,ECE 284,A00,103671,Turakhia; Yatish Girish,0,0,0,0
1668224123070,ECE 285,A00,103672,Zheng; Yang,0,0,0,0
1668224123070,ECE 285,B00,103673,Sworder; David D.,0,0,0,0
1668224123525,ECE 287,A00,103676,Javidi; Tara,0,0,0,0
1668224123949,MATH 200B,A00,098023,Salehi Golsefidy; Alireza,12,0,15,3
1668224124372,MATH 202B,A00,098024,Rhoades; Brendon Patrick,9,0,15,6
1668224124804,MATH 203B,A00,098025,Oprea; Dragos N.,10,0,15,5
1668224125239,MATH 204B,A00,098026,Sorensen; Claus M,13,0,15,2
1668224125665,MATH 208,A00,098027,Izadi; Elham,7,0,10,3
1668224126088,MATH 209,A00,098028,Pollack; Aaron,10,0,10,0
1668224126515,MATH 211A,A00,112919,Rogalski; Daniel,9,0,10,1
1668224126940,MATH 211B,A00,112920,Seward; Brandon M.,9,0,10,1
1668224127379,MATH 218,A00,098029,Li; Bo,10,0,10,0
1668224127803,MATH 220B,A00,098030,Novak; Jonathan I,11,0,15,4
1668224128227,MATH 221A,A00,098031,Ebenfelt; Peter F,13,0,15,2
1668224128663,MATH 231B,A00,098032,Zlatos; Andrej,12,0,15,3
1668224129087,MATH 240B,A00,098033,Ni; Lei,9,0,15,6
1668224129510,MATH 243,A00,098034,Jekel; David Andrew,10,0,10,0
1668224129936,MATH 245A,A00,098035,Nie; Jiawang,0,0,15,16
1668224130360,MATH 248,A00,098036,Bejenaru; Ioan,10,0,10,0
1668224130782,MATH 250B,A00,098037,Spolaor; Luca,14,0,15,1
1668224131208,MATH 258,A00,098038,Ni; Lei,10,0,10,0
1668224131643,MATH 264B,A00,098041,Rhoades; Brendon Patrick,9,0,15,6
1668224132079,MATH 268,A00,098042,Buss; Samuel R,10,0,10,0
1668224132502,MATH 269,A00,098043,Rhoades; Brendon Patrick,10,0,10,0
1668224132926,MATH 270B,A00,098044,Li; Bo,10,0,15,5
1668224133349,MATH 272B,A00,098045,Holst; Michael J,13,0,15,2
1668224133774,MATH 273A,A00,098046,Tian; Xiaochuan,10,0,15,5
1668224134197,MATH 275,A01,098048,Tian; Xiaochuan,6,0,10,4
1668224134624,MATH 278A,A00,098049,Holst; Michael J,8,0,10,2
1668224135048,MATH 278B,A00,098050,Cloninger; Alexander,10,0,10,0
1668224135474,MATH 278C,A00,098051,Nie; Jiawang,7,0,10,3
1668224135896,MATH 280B,A00,098052,Zheng; Tianyi,10,0,15,5
1668224136336,MATH 281B,A00,098053,Bradic; Jelena,2,0,15,13
1668224136758,MATH 282B,A00,098054,Arias-Castro; Ery,0,0,15,15
1668224137183,MATH 285,A00,098055,Fitzsimmons; Patrick J,0,0,15,17
1668224137613,MATH 287B,A00,098056,Arias-Castro; Ery,2,0,15,13
1668224138038,MATH 288,A00,098057,Agarwal; Pooja,9,0,10,1
1668224138038,MATH 288,B00,098058,Zhang; Danna,8,0,10,2
1668224138038,MATH 288,C00,098059,Williams; Ruth J,10,0,10,0
1668224138471,MATH 290B,A00,098060,Roberts; Justin Deritter,13,0,15,2
1668224139047,MATH 292,A00,098061,Belmont; Eva Kinoshita,10,0,10,0
1668224139476,MATH 295,A00,098062,Suk; Andrew Hoon,48,0,50,2
1668224139898,MATH 296,A00,098063,Novak; Jonathan I,20,0,20,0
1668224140322,MATH 297,001,098064,Gamst; Anthony Collins,9997,0,9999,2
1668224642189,COGS 205,A00,101395,Chiba; Andrea,19,0,20,1
1668224642617,COGS 210B,001,101404,Greene; Deanna Jacquelyn,9998,0,9999,1
1668224642617,COGS 210B,002,101417,Xia; Haijun,9999,0,9999,0
1668224642617,COGS 210B,003,101422,Nitz; Douglas A.,9999,0,9999,0
1668224642617,COGS 210B,004,101423,Hollan; James D.,9998,0,9999,1
1668224642617,COGS 210B,005,101424,Deak; Gedeon O.,9998,0,9999,1
1668224642617,COGS 210B,006,101425,Rossano; Federico,9999,0,9999,0
1668224643041,COGS 211B,A00,101427,Coulson; Seana M,9996,0,9999,3
1668224643467,COGS 220,A00,101428,Hollan; James D.,0,0,25,25
1668224643901,COGS 229,A00,101429,Dow; Steven P,18,0,25,7
1668224644325,COGS 230,A00,101430,Klemmer; Scott R,12,0,17,5
1668224644752,COGS 234,A00,101431,Xia; Haijun,2,0,25,23
1668224645177,COGS 260,A00,101432,Kiyonaga; Anastasia,21,0,25,4
1668224645177,COGS 260,B00,101433,Kirsh; David Joel,15,0,25,10
1668224645599,CSE 202,A00,102371,Impagliazzo; Russell,0,0,0,0
1668224646029,CSE 203B,A01,102373,Cheng; Chung Kuan,0,0,0,0
1668224646454,CSE 208,A00,102374,Micciancio; Daniele,0,0,0,0
1668224646878,CSE 209A,A00,112895,Impagliazzo; Russell,0,0,15,15
1668224647301,CSE 209B,A00,108005,Bellare; Mihir,0,0,0,0
1668224647727,CSE 210,A00,113163,Coblenz; Michael J,0,0,0,0
1668224648153,CSE 219,A00,106111,Dow; Steven P,0,0,20,20
1668224648576,CSE 221,A00,102376,Voelker; Geoffrey M.,0,0,0,0
1668224648998,CSE 224,A01,102378,Porter; George M,0,0,0,0
1668224649434,CSE 229A,A00,102379,Savage; Stefan,0,0,0,0
1668224649870,CSE 229C,A00,102380,Munyaka; Imani N. S.,0,0,0,0
1668224650293,CSE 232B,A00,102382,Deutsch; Alin Bernard,0,0,0,0
1668224650721,CSE 234,A01,112904,Kumar; Arun Kumar,0,0,0,0
1668224651294,CSE 237A,A00,102383,Rosing; Tajana Simunic,0,0,0,0
1668224651726,CSE 239A,A00,102384,Deutsch; Alin Bernard,0,0,0,0
1668224652153,CSE 239B,A00,102385,Polikarpova; Nadezhda,0,0,0,0
1668224652575,CSE 240A,A00,102386,Pannuto; Patrick William,0,0,0,0
1668224653000,CSE 240B,A00,102387,Zhao; Jishen,0,0,0,0
1668224653426,CSE 241A,A00,106406,Kang; Mingu,0,0,0,0
1668224653850,CSE 249B,A00,102388,Kahng; Andrew Byun,0,0,8,8
1668224654276,CSE 251B,A01,102392,Cottrell; Garrison W,0,0,0,0
1668224654276,CSE 251B,A02,102393,Cottrell; Garrison W,0,0,0,0
1668224654698,CSE 252B,A00,102394,Ochoa; Benjamin Lawrence,0,0,0,0
1668224655123,CSE 257,A01,102396,Gao; Sicun,0,0,0,0
1668224655547,CSE 272,A00,102397,Li; Tzumao,0,0,0,0
1668224655987,CSE 274,A00,111323,Chern; Albert Ren-Haur,0,0,0,0
1668224656411,CSE 282,A00,102398,Pevzner; Pavel Arkadjevich,0,0,0,0
1668224656836,CSE 284,A00,114175,Gymrek; Melissa Ann,0,0,0,0
1668224657274,CSE 290,A00,102399,Chandraker; Manmohan Krishna,0,0,0,0
1668224657274,CSE 290,B00,102400,Vaccaro; Kristen Marie,0,0,25,25
1668224657274,CSE 290,C00,102414,Pannuto; Patrick William,0,0,25,25
1668224657274,CSE 290,D00,102427,Pevzner; Pavel Arkadjevich,0,0,0,0
1668224657274,CSE 290,E00,102429,Zhao; Jishen,0,0,0,0
1668224657274,CSE 290,F00,102436,Tullsen; Dean Michael,0,0,0,0
1668224657274,CSE 290,G00,102440,Christensen; Henrik I,0,0,20,20
1668224657699,CSE 291,A00,102443,Su; Hao,0,0,0,0
1668224657699,CSE 291,B00,102448,Polikarpova; Nadezhda,0,0,0,0
1668224657699,CSE 291,C00,102453,Vaccaro; Kristen Marie,0,0,0,0
1668224657699,CSE 291,D00,111343,Savage; Stefan,0,0,0,0
1668224657699,CSE 291,E00,116474,Claffy; Kimberly Claire,0,0,0,0
1668224657699,CSE 291,F00,116479,Pasquale; Joseph,0,0,0,0
1668224658127,CSE 293,001,119111,Bafna; Vineet,9999,0,9999,0
1668224658127,CSE 293,002,119118,Bellare; Mihir,9999,0,9999,0
1668224658127,CSE 293,003,119122,Berg-Kirkpatrick; Taylor D,9999,0,9999,0
1668224658127,CSE 293,004,119135,Christensen; Henrik I,9999,0,9999,0
1668224658127,CSE 293,005,119142,Cottrell; Garrison W,9999,0,9999,0
1668224658127,CSE 293,006,119146,Deutsch; Alin Bernard,9999,0,9999,0
1668224658127,CSE 293,007,119159,Esmaeilzadeh; Hadi,9999,0,9999,0
1668224658127,CSE 293,008,119166,Freund; Yoav,9999,0,9999,0
1668224658127,CSE 293,009,119170,Griswold; William G.,9999,0,9999,0
1668224658127,CSE 293,010,119183,Gymrek; Melissa Ann,9999,0,9999,0
1668224658127,CSE 293,011,119190,Heninger; Nadia A,9999,0,9999,0
1668224658127,CSE 293,012,119230,Impagliazzo; Russell,9999,0,9999,0
1668224658127,CSE 293,013,119232,Jhala; Ranjit,9999,0,9999,0
1668224658127,CSE 293,014,119233,Kahng; Andrew Byun,9999,0,9999,0
1668224658127,CSE 293,015,119298,Kane; Daniel Mertz,9999,0,9999,0
1668224658127,CSE 293,016,119299,Kriegman; David J,9999,0,9999,0
1668224658127,CSE 293,017,119300,Kumar; Arun Kumar,9999,0,9999,0
1668224658127,CSE 293,018,119301,Lerner; Sorin,9999,0,9999,0
1668224658127,CSE 293,019,119302,Lovett; Shachar,9999,0,9999,0
1668224658127,CSE 293,020,119303,McAuley; Julian John,9999,0,9999,0
1668224658127,CSE 293,021,119304,Micciancio; Daniele,9999,0,9999,0
1668224658127,CSE 293,022,119367,Orailoglu; Alex,9999,0,9999,0
1668224658127,CSE 293,023,119382,Paturi; Ramamohan,9999,0,9999,0
1668224658127,CSE 293,024,119404,Polikarpova; Nadezhda,9999,0,9999,0
1668224658127,CSE 293,025,119406,Politz; Joseph Gibbs,9999,0,9999,0
1668224658127,CSE 293,026,119411,Porter; George M,9999,0,9999,0
1668224658127,CSE 293,027,119414,Porter; Leonard Emerson,9999,0,9999,0
1668224658127,CSE 293,028,119416,Ramamoorthi; Ravi,9999,0,9999,0
1668224658127,CSE 293,029,119417,Sahoo; Debashis,9999,0,9999,0
1668224658127,CSE 293,030,119420,Saul; Lawrence,9999,0,9999,0
1668224658127,CSE 293,031,119421,Savage; Stefan,9999,0,9999,0
1668224658127,CSE 293,032,119425,Schulze; Jurgen P.,9999,0,9999,0
1668224658127,CSE 293,033,119426,Snoeren; Alex C.,9999,0,9999,0
1668224658127,CSE 293,034,119428,Shang; Jingbo,9999,0,9999,0
1668224658127,CSE 293,035,119430,Stefan; Deian,9999,0,9999,0
1668224658127,CSE 293,036,119431,Su; Hao,9999,0,9999,0
1668224658127,CSE 293,037,119433,Swanson; Steven James,9999,0,9999,0
1668224658127,CSE 293,038,119435,Tullsen; Dean Michael,9999,0,9999,0
1668224658127,CSE 293,039,119483,Voelker; Geoffrey M.,9999,0,9999,0
1668224658127,CSE 293,040,119537,Zhao; Jishen,9999,0,9999,0
1668224658127,CSE 293,041,119538,Zhou; Yuan-Yuan,9999,0,9999,0
1668224658127,CSE 293,042,119539,Gao; Sicun,9999,0,9999,0
1668224658127,CSE 293,043,119540,Weibel; Nadir,9999,0,9999,0
1668224658127,CSE 293,044,119541,Gupta; Rajesh K.,9999,0,9999,0
1668224658127,CSE 293,045,126410,Vaccaro; Kristen Marie,9999,0,9999,0
1668224658127,CSE 293,046,126411,Klemke; Richard,9999,0,9999,0
1668224658556,CSE 294,A00,102459,Voelker; Geoffrey M.,0,0,0,0
1668224658556,CSE 294,B00,111322,Orailoglu; Alex,0,0,0,0
1668224658985,DSE 201,A00,096914,Deutsch; Alin Bernard,30,0,30,0
1668224659409,DSE 210,A00,096915,Dasgupta; Sanjoy,30,0,30,0
1668224659836,DSE 260A,A00,096916,Altintas De Callaf; Ilkay,30,0,30,0
1668224660263,ECE 200,001,103586,Antipa; Nicholas A,9999,0,9999,0
1668224660263,ECE 200,002,103587,Atanasov; Nikolay A.,9999,0,9999,0
1668224660263,ECE 200,003,103588,Bharadia; Dinesh,9999,0,9999,0
1668224660263,ECE 200,004,103589,Cheng; Chung Kuan,9999,0,9999,0
1668224660263,ECE 200,005,103590,Cosman; Pamela C.,9999,0,9999,0
1668224660263,ECE 200,006,103591,Dayeh; Shadi Ahmad,9999,0,9999,0
1668224660263,ECE 200,007,103592,Fainman; Yeshaiahu,9999,0,9999,0
1668224660263,ECE 200,008,103593,Ford; Joseph Earl,9999,0,9999,0
1668224660263,ECE 200,009,103594,Franceschetti; Massimo,9999,0,9999,0
1668224660263,ECE 200,010,103595,Fullerton; Eric E,9999,0,9999,0
1668224660263,ECE 200,011,103596,Galton; Ian A,9999,0,9999,0
1668224660263,ECE 200,012,103597,Gilja; Vikash,9999,0,9999,0
1668224660263,ECE 200,013,103598,Hall; Drew A.,9999,0,9999,0
1668224660263,ECE 200,014,103599,Hsueh; Tzu-Chien,9999,0,9999,0
1668224660263,ECE 200,015,103600,Javidi; Tara,9999,0,9999,0
1668224660263,ECE 200,016,103601,Kahng; Andrew Byun,9999,0,9999,0
1668224660263,ECE 200,017,103602,Kim; Young-Han,9999,0,9999,0
1668224660263,ECE 200,018,103603,Koushanfar; Farinaz,9999,0,9999,0
1668224660263,ECE 200,019,103604,Kuzum; Duygu,9999,0,9999,0
1668224660263,ECE 200,020,103605,Le; Hanh-Phuc,9999,0,9999,0
1668224660263,ECE 200,021,103606,Lin; Bill,9999,0,9999,0
1668224660263,ECE 200,022,103607,Liu; Zhaowei,9998,0,9999,1
1668224660263,ECE 200,023,103608,Lo; Yu-Hwa,9999,0,9999,0
1668224660263,ECE 200,024,103609,Lomakin; Vitaliy,9999,0,9999,0
1668224660263,ECE 200,025,103610,Mercier; Patrick Philip,9999,0,9999,0
1668224660263,ECE 200,026,103611,Meyer; Florian,9999,0,9999,0
1668224660263,ECE 200,027,103612,Milstein; Laurence B.,9999,0,9999,0
1668224660263,ECE 200,028,103613,Mir Arabbaygi; Siavash,9999,0,9999,0
1668224660263,ECE 200,029,103614,Mookherjea; Shayan,9999,0,9999,0
1668224660263,ECE 200,030,103615,Morris; Karcher William,9999,0,9999,0
1668224660263,ECE 200,031,103616,Ng; Tse Nga,9999,0,9999,0
1668224660263,ECE 200,032,103617,Nguyen; Truong Quang,9999,0,9999,0
1668224660263,ECE 200,033,103618,Nomura; Kenji,9999,0,9999,0
1668224660263,ECE 200,034,103619,Orlitsky; Alon,9999,0,9999,0
1668224660263,ECE 200,035,103620,Pal; Piya,9999,0,9999,0
1668224660263,ECE 200,036,103621,Papen; George C.,9999,0,9999,0
1668224660263,ECE 200,037,103622,Radic; Stojan,9999,0,9999,0
1668224660263,ECE 200,038,103623,Rao; Bhaskar D.,9999,0,9999,0
1668224660263,ECE 200,039,103624,Rao; Ramesh R,9999,0,9999,0
1668224660263,ECE 200,040,103625,Rebeiz; Gabriel,9999,0,9999,0
1668224660263,ECE 200,041,103626,Sanford; John R,9999,0,9999,0
1668224660263,ECE 200,042,103627,Siegel; Paul H.,9999,0,9999,0
1668224660263,ECE 200,043,103628,Sievenpiper; Daniel F.,9999,0,9999,0
1668224660263,ECE 200,044,103629,Sworder; David D.,9999,0,9999,0
1668224660263,ECE 200,045,103630,Taur; Yuan,9999,0,9999,0
1668224660263,ECE 200,046,103631,Touri; Behrouz,9999,0,9999,0
1668224660263,ECE 200,047,103632,Trivedi; Mohan M.,9999,0,9999,0
1668224660263,ECE 200,048,103633,Vasconcelos; Nuno,9999,0,9999,0
1668224660263,ECE 200,049,103634,Wang; Xiaolong,9999,0,9999,0
1668224660263,ECE 200,050,103635,Xie; Pengtao,9999,0,9999,0
1668224660263,ECE 200,051,103636,Yip; Michael,9999,0,9999,0
1668224660263,ECE 200,052,103637,Zeger; Kenneth A.,999,0,999,0
1668224660263,ECE 200,053,103638,Zhang; Xinyu,9999,0,9999,0
1668224660263,ECE 200,054,103639,Turakhia; Yatish Girish,9999,0,9999,0
1668224660263,ECE 200,055,103640,Kang; Mingu,9999,0,9999,0
1668224660263,ECE 200,056,103641,Shi; Yuanyuan,9999,0,9999,0
1668224660263,ECE 200,057,103642,Wang; Edward Jay,9999,0,9999,0
1668224660263,ECE 200,058,103643,Zheng; Yang,9999,0,9999,0
1668224660686,ECE 202,A00,103644,Kuzum; Duygu,0,0,0,0
1668224661111,ECE 212BN,A00,103646,Ng; Tse Nga,0,0,0,0
1668224661535,ECE 221,A00,111493,Staff,0,0,0,0
1668224661957,ECE 222B,A00,103647,Lomakin; Vitaliy,0,0,0,0
1668224662381,ECE 230B,A00,103648,Taur; Yuan,0,0,0,0
1668224662805,ECE 238B,A00,103649,Garay; Javier,0,0,0,0
1668224663232,ECE 240B,A00,112900,Fainman; Yeshaiahu,0,0,0,0
1668224663656,ECE 247A,A00,103650,Jokerst; Jesse Vincent,0,0,0,0
1668224664082,ECE 247B,A00,103651,Wang; Joseph,0,0,0,0
1668224664509,ECE 250,A00,103652,Siegel; Paul H.,0,0,0,0
1668224664935,ECE 251A,A00,103654,Rao; Bhaskar D.,0,0,0,0
1668224665359,ECE 257B,A00,103655,Bharadia; Dinesh,0,0,0,0
1668224665784,ECE 258A,A00,103656,Milstein; Laurence B.,0,0,0,0
1668224666211,ECE 260B,A00,103658,Kang; Mingu,0,0,0,0
1668224666636,ECE 264A,A00,103659,Galton; Ian A,0,0,0,0
1668224667061,ECE 265A,A00,103661,Gudem; Prasad S.S.,0,0,0,0
1668224667496,ECE 265D,A00,103662,Gudem; Prasad S.S.,0,0,0,0
1668224667933,ECE 268,A00,103663,Koushanfar; Farinaz,0,0,0,0
1668224668363,ECE 269,A01,103665,Pal; Piya,0,0,0,0
1668224668789,ECE 271B,A00,103666,Vasconcelos; Manuela,0,0,0,0
1668224669229,ECE 276A,A00,103667,Atanasov; Nikolay A.,0,0,0,0
1668224669664,ECE 277,A00,103668,An; Cheolhong,0,0,0,0
1668224670086,ECE 279,A00,117947,Hall; Drew A.,0,0,0,0
1668224670935,ECE 283,A00,103670,Hsueh; Tzu-Chien,0,0,0,0
1668224671366,ECE 284,A00,103671,Turakhia; Yatish Girish,0,0,0,0
1668224671791,ECE 285,A00,103672,Zheng; Yang,0,0,0,0
1668224671791,ECE 285,B00,103673,Sworder; David D.,0,0,0,0
1668224672218,ECE 287,A00,103676,Javidi; Tara,0,0,0,0
1668224672640,MATH 200B,A00,098023,Salehi Golsefidy; Alireza,12,0,15,3
1668224673079,MATH 202B,A00,098024,Rhoades; Brendon Patrick,9,0,15,6
1668224673503,MATH 203B,A00,098025,Oprea; Dragos N.,10,0,15,5
1668224673935,MATH 204B,A00,098026,Sorensen; Claus M,13,0,15,2
1668224674359,MATH 208,A00,098027,Izadi; Elham,7,0,10,3
1668224674782,MATH 209,A00,098028,Pollack; Aaron,10,0,10,0
1668224675207,MATH 211A,A00,112919,Rogalski; Daniel,9,0,10,1
1668224675644,MATH 211B,A00,112920,Seward; Brandon M.,9,0,10,1
1668224676149,MATH 218,A00,098029,Li; Bo,10,0,10,0
1668224676578,MATH 220B,A00,098030,Novak; Jonathan I,11,0,15,4
1668224677001,MATH 221A,A00,098031,Ebenfelt; Peter F,13,0,15,2
1668224677424,MATH 231B,A00,098032,Zlatos; Andrej,12,0,15,3
1668224677848,MATH 240B,A00,098033,Ni; Lei,9,0,15,6
1668224678272,MATH 243,A00,098034,Jekel; David Andrew,10,0,10,0
1668224678695,MATH 245A,A00,098035,Nie; Jiawang,0,0,15,16
1668224679127,MATH 248,A00,098036,Bejenaru; Ioan,10,0,10,0
1668224679554,MATH 250B,A00,098037,Spolaor; Luca,14,0,15,1
1668224679977,MATH 258,A00,098038,Ni; Lei,10,0,10,0
1668224680428,MATH 264B,A00,098041,Rhoades; Brendon Patrick,9,0,15,6
1668224680861,MATH 268,A00,098042,Buss; Samuel R,10,0,10,0
1668224681284,MATH 269,A00,098043,Rhoades; Brendon Patrick,10,0,10,0
1668224681708,MATH 270B,A00,098044,Li; Bo,10,0,15,5
1668224682133,MATH 272B,A00,098045,Holst; Michael J,13,0,15,2
1668224682557,MATH 273A,A00,098046,Tian; Xiaochuan,10,0,15,5
1668224682984,MATH 275,A01,098048,Tian; Xiaochuan,6,0,10,4
1668224683408,MATH 278A,A00,098049,Holst; Michael J,8,0,10,2
1668224683834,MATH 278B,A00,098050,Cloninger; Alexander,10,0,10,0
1668224684266,MATH 278C,A00,098051,Nie; Jiawang,7,0,10,3
1668224684692,MATH 280B,A00,098052,Zheng; Tianyi,10,0,15,5
1668224685119,MATH 281B,A00,098053,Bradic; Jelena,2,0,15,13
1668224685550,MATH 282B,A00,098054,Arias-Castro; Ery,0,0,15,15
1668224685974,MATH 285,A00,098055,Fitzsimmons; Patrick J,0,0,15,17
1668224686400,MATH 287B,A00,098056,Arias-Castro; Ery,2,0,15,13
1668224686822,MATH 288,A00,098057,Agarwal; Pooja,9,0,10,1
1668224686822,MATH 288,B00,098058,Zhang; Danna,8,0,10,2
1668224686822,MATH 288,C00,098059,Williams; Ruth J,10,0,10,0
1668224687249,MATH 290B,A00,098060,Roberts; Justin Deritter,13,0,15,2
1668224687675,MATH 292,A00,098061,Belmont; Eva Kinoshita,10,0,10,0
1668224688114,MATH 295,A00,098062,Suk; Andrew Hoon,48,0,50,2
1668224688537,MATH 296,A00,098063,Novak; Jonathan I,20,0,20,0
1668224688962,MATH 297,001,098064,Gamst; Anthony Collins,9997,0,9999,2
1668225190615,COGS 205,A00,101395,Chiba; Andrea,19,0,20,1
1668225191057,COGS 210B,001,101404,Greene; Deanna Jacquelyn,9998,0,9999,1
1668225191057,COGS 210B,002,101417,Xia; Haijun,9999,0,9999,0
1668225191057,COGS 210B,003,101422,Nitz; Douglas A.,9999,0,9999,0
1668225191057,COGS 210B,004,101423,Hollan; James D.,9998,0,9999,1
1668225191057,COGS 210B,005,101424,Deak; Gedeon O.,9998,0,9999,1
1668225191057,COGS 210B,006,101425,Rossano; Federico,9999,0,9999,0
1668225191481,COGS 211B,A00,101427,Coulson; Seana M,9996,0,9999,3
1668225191908,COGS 220,A00,101428,Hollan; James D.,0,0,25,25
1668225192331,COGS 229,A00,101429,Dow; Steven P,18,0,25,7
1668225192754,COGS 230,A00,101430,Klemmer; Scott R,12,0,17,5
1668225193179,COGS 234,A00,101431,Xia; Haijun,2,0,25,23
1668225193609,COGS 260,A00,101432,Kiyonaga; Anastasia,21,0,25,4
1668225193609,COGS 260,B00,101433,Kirsh; David Joel,15,0,25,10
1668225194032,CSE 202,A00,102371,Impagliazzo; Russell,0,0,0,0
1668225194457,CSE 203B,A01,102373,Cheng; Chung Kuan,0,0,0,0
1668225194881,CSE 208,A00,102374,Micciancio; Daniele,0,0,0,0
1668225195304,CSE 209A,A00,112895,Impagliazzo; Russell,0,0,15,15
1668225195727,CSE 209B,A00,108005,Bellare; Mihir,0,0,0,0
1668225196151,CSE 210,A00,113163,Coblenz; Michael J,0,0,0,0
1668225196577,CSE 219,A00,106111,Dow; Steven P,0,0,20,20
1668225196999,CSE 221,A00,102376,Voelker; Geoffrey M.,0,0,0,0
1668225197426,CSE 224,A01,102378,Porter; George M,0,0,0,0
1668225197943,CSE 229A,A00,102379,Savage; Stefan,0,0,0,0
1668225198370,CSE 229C,A00,102380,Munyaka; Imani N. S.,0,0,0,0
1668225198795,CSE 232B,A00,102382,Deutsch; Alin Bernard,0,0,0,0
1668225199219,CSE 234,A01,112904,Kumar; Arun Kumar,0,0,0,0
1668225199642,CSE 237A,A00,102383,Rosing; Tajana Simunic,0,0,0,0
1668225200069,CSE 239A,A00,102384,Deutsch; Alin Bernard,0,0,0,0
1668225200497,CSE 239B,A00,102385,Polikarpova; Nadezhda,0,0,0,0
1668225200923,CSE 240A,A00,102386,Pannuto; Patrick William,0,0,0,0
1668225201356,CSE 240B,A00,102387,Zhao; Jishen,0,0,0,0
1668225201779,CSE 241A,A00,106406,Kang; Mingu,0,0,0,0
1668225202214,CSE 249B,A00,102388,Kahng; Andrew Byun,0,0,8,8
1668225202643,CSE 251B,A01,102392,Cottrell; Garrison W,0,0,0,0
1668225202643,CSE 251B,A02,102393,Cottrell; Garrison W,0,0,0,0
1668225203086,CSE 252B,A00,102394,Ochoa; Benjamin Lawrence,0,0,0,0
1668225203511,CSE 257,A01,102396,Gao; Sicun,0,0,0,0
1668225203942,CSE 272,A00,102397,Li; Tzumao,0,0,0,0
1668225204373,CSE 274,A00,111323,Chern; Albert Ren-Haur,0,0,0,0
1668225204800,CSE 282,A00,102398,Pevzner; Pavel Arkadjevich,0,0,0,0
1668225205224,CSE 284,A00,114175,Gymrek; Melissa Ann,0,0,0,0
1668225205653,CSE 290,A00,102399,Chandraker; Manmohan Krishna,0,0,0,0
1668225205653,CSE 290,B00,102400,Vaccaro; Kristen Marie,0,0,25,25
1668225205653,CSE 290,C00,102414,Pannuto; Patrick William,0,0,25,25
1668225205653,CSE 290,D00,102427,Pevzner; Pavel Arkadjevich,0,0,0,0
1668225205653,CSE 290,E00,102429,Zhao; Jishen,0,0,0,0
1668225205653,CSE 290,F00,102436,Tullsen; Dean Michael,0,0,0,0
1668225205653,CSE 290,G00,102440,Christensen; Henrik I,0,0,20,20
1668225206081,CSE 291,A00,102443,Su; Hao,0,0,0,0
1668225206081,CSE 291,B00,102448,Polikarpova; Nadezhda,0,0,0,0
1668225206081,CSE 291,C00,102453,Vaccaro; Kristen Marie,0,0,0,0
1668225206081,CSE 291,D00,111343,Savage; Stefan,0,0,0,0
1668225206081,CSE 291,E00,116474,Claffy; Kimberly Claire,0,0,0,0
1668225206081,CSE 291,F00,116479,Pasquale; Joseph,0,0,0,0
1668225206511,CSE 293,001,119111,Bafna; Vineet,9999,0,9999,0
1668225206511,CSE 293,002,119118,Bellare; Mihir,9999,0,9999,0
1668225206511,CSE 293,003,119122,Berg-Kirkpatrick; Taylor D,9999,0,9999,0
1668225206511,CSE 293,004,119135,Christensen; Henrik I,9999,0,9999,0
1668225206511,CSE 293,005,119142,Cottrell; Garrison W,9999,0,9999,0
1668225206511,CSE 293,006,119146,Deutsch; Alin Bernard,9999,0,9999,0
1668225206511,CSE 293,007,119159,Esmaeilzadeh; Hadi,9999,0,9999,0
1668225206511,CSE 293,008,119166,Freund; Yoav,9999,0,9999,0
1668225206511,CSE 293,009,119170,Griswold; William G.,9999,0,9999,0
1668225206511,CSE 293,010,119183,Gymrek; Melissa Ann,9999,0,9999,0
1668225206511,CSE 293,011,119190,Heninger; Nadia A,9999,0,9999,0
1668225206511,CSE 293,012,119230,Impagliazzo; Russell,9999,0,9999,0
1668225206511,CSE 293,013,119232,Jhala; Ranjit,9999,0,9999,0
1668225206511,CSE 293,014,119233,Kahng; Andrew Byun,9999,0,9999,0
1668225206511,CSE 293,015,119298,Kane; Daniel Mertz,9999,0,9999,0
1668225206511,CSE 293,016,119299,Kriegman; David J,9999,0,9999,0
1668225206511,CSE 293,017,119300,Kumar; Arun Kumar,9999,0,9999,0
1668225206511,CSE 293,018,119301,Lerner; Sorin,9999,0,9999,0
1668225206511,CSE 293,019,119302,Lovett; Shachar,9999,0,9999,0
1668225206511,CSE 293,020,119303,McAuley; Julian John,9999,0,9999,0
1668225206511,CSE 293,021,119304,Micciancio; Daniele,9999,0,9999,0
1668225206511,CSE 293,022,119367,Orailoglu; Alex,9999,0,9999,0
1668225206511,CSE 293,023,119382,Paturi; Ramamohan,9999,0,9999,0
1668225206511,CSE 293,024,119404,Polikarpova; Nadezhda,9999,0,9999,0
1668225206511,CSE 293,025,119406,Politz; Joseph Gibbs,9999,0,9999,0
1668225206511,CSE 293,026,119411,Porter; George M,9999,0,9999,0
1668225206511,CSE 293,027,119414,Porter; Leonard Emerson,9999,0,9999,0
1668225206511,CSE 293,028,119416,Ramamoorthi; Ravi,9999,0,9999,0
1668225206511,CSE 293,029,119417,Sahoo; Debashis,9999,0,9999,0
1668225206511,CSE 293,030,119420,Saul; Lawrence,9999,0,9999,0
1668225206511,CSE 293,031,119421,Savage; Stefan,9999,0,9999,0
1668225206511,CSE 293,032,119425,Schulze; Jurgen P.,9999,0,9999,0
1668225206511,CSE 293,033,119426,Snoeren; Alex C.,9999,0,9999,0
1668225206511,CSE 293,034,119428,Shang; Jingbo,9999,0,9999,0
1668225206511,CSE 293,035,119430,Stefan; Deian,9999,0,9999,0
1668225206511,CSE 293,036,119431,Su; Hao,9999,0,9999,0
1668225206511,CSE 293,037,119433,Swanson; Steven James,9999,0,9999,0
1668225206511,CSE 293,038,119435,Tullsen; Dean Michael,9999,0,9999,0
1668225206511,CSE 293,039,119483,Voelker; Geoffrey M.,9999,0,9999,0
1668225206511,CSE 293,040,119537,Zhao; Jishen,9999,0,9999,0
1668225206511,CSE 293,041,119538,Zhou; Yuan-Yuan,9999,0,9999,0
1668225206511,CSE 293,042,119539,Gao; Sicun,9999,0,9999,0
1668225206511,CSE 293,043,119540,Weibel; Nadir,9999,0,9999,0
1668225206511,CSE 293,044,119541,Gupta; Rajesh K.,9999,0,9999,0
1668225206511,CSE 293,045,126410,Vaccaro; Kristen Marie,9999,0,9999,0
1668225206511,CSE 293,046,126411,Klemke; Richard,9999,0,9999,0
1668225206941,CSE 294,A00,102459,Voelker; Geoffrey M.,0,0,0,0
1668225206941,CSE 294,B00,111322,Orailoglu; Alex,0,0,0,0
1668225207366,DSE 201,A00,096914,Deutsch; Alin Bernard,30,0,30,0
1668225207788,DSE 210,A00,096915,Dasgupta; Sanjoy,30,0,30,0
1668225208217,DSE 260A,A00,096916,Altintas De Callaf; Ilkay,30,0,30,0
1668225208660,ECE 200,001,103586,Antipa; Nicholas A,9999,0,9999,0
1668225208660,ECE 200,002,103587,Atanasov; Nikolay A.,9999,0,9999,0
1668225208660,ECE 200,003,103588,Bharadia; Dinesh,9999,0,9999,0
1668225208660,ECE 200,004,103589,Cheng; Chung Kuan,9999,0,9999,0
1668225208660,ECE 200,005,103590,Cosman; Pamela C.,9999,0,9999,0
1668225208660,ECE 200,006,103591,Dayeh; Shadi Ahmad,9999,0,9999,0
1668225208660,ECE 200,007,103592,Fainman; Yeshaiahu,9999,0,9999,0
1668225208660,ECE 200,008,103593,Ford; Joseph Earl,9999,0,9999,0
1668225208660,ECE 200,009,103594,Franceschetti; Massimo,9999,0,9999,0
1668225208660,ECE 200,010,103595,Fullerton; Eric E,9999,0,9999,0
1668225208660,ECE 200,011,103596,Galton; Ian A,9999,0,9999,0
1668225208660,ECE 200,012,103597,Gilja; Vikash,9999,0,9999,0
1668225208660,ECE 200,013,103598,Hall; Drew A.,9999,0,9999,0
1668225208660,ECE 200,014,103599,Hsueh; Tzu-Chien,9999,0,9999,0
1668225208660,ECE 200,015,103600,Javidi; Tara,9999,0,9999,0
1668225208660,ECE 200,016,103601,Kahng; Andrew Byun,9999,0,9999,0
1668225208660,ECE 200,017,103602,Kim; Young-Han,9999,0,9999,0
1668225208660,ECE 200,018,103603,Koushanfar; Farinaz,9999,0,9999,0
1668225208660,ECE 200,019,103604,Kuzum; Duygu,9999,0,9999,0
1668225208660,ECE 200,020,103605,Le; Hanh-Phuc,9999,0,9999,0
1668225208660,ECE 200,021,103606,Lin; Bill,9999,0,9999,0
1668225208660,ECE 200,022,103607,Liu; Zhaowei,9998,0,9999,1
1668225208660,ECE 200,023,103608,Lo; Yu-Hwa,9999,0,9999,0
1668225208660,ECE 200,024,103609,Lomakin; Vitaliy,9999,0,9999,0
1668225208660,ECE 200,025,103610,Mercier; Patrick Philip,9999,0,9999,0
1668225208660,ECE 200,026,103611,Meyer; Florian,9999,0,9999,0
1668225208660,ECE 200,027,103612,Milstein; Laurence B.,9999,0,9999,0
1668225208660,ECE 200,028,103613,Mir Arabbaygi; Siavash,9999,0,9999,0
1668225208660,ECE 200,029,103614,Mookherjea; Shayan,9999,0,9999,0
1668225208660,ECE 200,030,103615,Morris; Karcher William,9999,0,9999,0
1668225208660,ECE 200,031,103616,Ng; Tse Nga,9999,0,9999,0
1668225208660,ECE 200,032,103617,Nguyen; Truong Quang,9999,0,9999,0
1668225208660,ECE 200,033,103618,Nomura; Kenji,9999,0,9999,0
1668225208660,ECE 200,034,103619,Orlitsky; Alon,9999,0,9999,0
1668225208660,ECE 200,035,103620,Pal; Piya,9999,0,9999,0
1668225208660,ECE 200,036,103621,Papen; George C.,9999,0,9999,0
1668225208660,ECE 200,037,103622,Radic; Stojan,9999,0,9999,0
1668225208660,ECE 200,038,103623,Rao; Bhaskar D.,9999,0,9999,0
1668225208660,ECE 200,039,103624,Rao; Ramesh R,9999,0,9999,0
1668225208660,ECE 200,040,103625,Rebeiz; Gabriel,9999,0,9999,0
1668225208660,ECE 200,041,103626,Sanford; John R,9999,0,9999,0
1668225208660,ECE 200,042,103627,Siegel; Paul H.,9999,0,9999,0
1668225208660,ECE 200,043,103628,Sievenpiper; Daniel F.,9999,0,9999,0
1668225208660,ECE 200,044,103629,Sworder; David D.,9999,0,9999,0
1668225208660,ECE 200,045,103630,Taur; Yuan,9999,0,9999,0
1668225208660,ECE 200,046,103631,Touri; Behrouz,9999,0,9999,0
1668225208660,ECE 200,047,103632,Trivedi; Mohan M.,9999,0,9999,0
1668225208660,ECE 200,048,103633,Vasconcelos; Nuno,9999,0,9999,0
1668225208660,ECE 200,049,103634,Wang; Xiaolong,9999,0,9999,0
1668225208660,ECE 200,050,103635,Xie; Pengtao,9999,0,9999,0
1668225208660,ECE 200,051,103636,Yip; Michael,9999,0,9999,0
1668225208660,ECE 200,052,103637,Zeger; Kenneth A.,999,0,999,0
1668225208660,ECE 200,053,103638,Zhang; Xinyu,9999,0,9999,0
1668225208660,ECE 200,054,103639,Turakhia; Yatish Girish,9999,0,9999,0
1668225208660,ECE 200,055,103640,Kang; Mingu,9999,0,9999,0
1668225208660,ECE 200,056,103641,Shi; Yuanyuan,9999,0,9999,0
1668225208660,ECE 200,057,103642,Wang; Edward Jay,9999,0,9999,0
1668225208660,ECE 200,058,103643,Zheng; Yang,9999,0,9999,0
1668225209086,ECE 202,A00,103644,Kuzum; Duygu,0,0,0,0
1668225209509,ECE 212BN,A00,103646,Ng; Tse Nga,0,0,0,0
1668225209931,ECE 221,A00,111493,Staff,0,0,0,0
1668225210357,ECE 222B,A00,103647,Lomakin; Vitaliy,0,0,0,0
1668225210779,ECE 230B,A00,103648,Taur; Yuan,0,0,0,0
1668225211208,ECE 238B,A00,103649,Garay; Javier,0,0,0,0
1668225211638,ECE 240B,A00,112900,Fainman; Yeshaiahu,0,0,0,0
1668225212065,ECE 247A,A00,103650,Jokerst; Jesse Vincent,0,0,0,0
1668225212487,ECE 247B,A00,103651,Wang; Joseph,0,0,0,0
1668225212913,ECE 250,A00,103652,Siegel; Paul H.,0,0,0,0
1668225213336,ECE 251A,A00,103654,Rao; Bhaskar D.,0,0,0,0
1668225213758,ECE 257B,A00,103655,Bharadia; Dinesh,0,0,0,0
1668225214186,ECE 258A,A00,103656,Milstein; Laurence B.,0,0,0,0
1668225214613,ECE 260B,A00,103658,Kang; Mingu,0,0,0,0
1668225215038,ECE 264A,A00,103659,Galton; Ian A,0,0,0,0
1668225215465,ECE 265A,A00,103661,Gudem; Prasad S.S.,0,0,0,0
1668225215894,ECE 265D,A00,103662,Gudem; Prasad S.S.,0,0,0,0
1668225216318,ECE 268,A00,103663,Koushanfar; Farinaz,0,0,0,0
1668225216741,ECE 269,A01,103665,Pal; Piya,0,0,0,0
1668225217174,ECE 271B,A00,103666,Vasconcelos; Manuela,0,0,0,0
1668225217609,ECE 276A,A00,103667,Atanasov; Nikolay A.,0,0,0,0
1668225218031,ECE 277,A00,103668,An; Cheolhong,0,0,0,0
1668225218463,ECE 279,A00,117947,Hall; Drew A.,0,0,0,0
1668225219312,ECE 283,A00,103670,Hsueh; Tzu-Chien,0,0,0,0
1668225219735,ECE 284,A00,103671,Turakhia; Yatish Girish,0,0,0,0
1668225220163,ECE 285,A00,103672,Zheng; Yang,0,0,0,0
1668225220163,ECE 285,B00,103673,Sworder; David D.,0,0,0,0
1668225220590,ECE 287,A00,103676,Javidi; Tara,0,0,0,0
1668225221017,MATH 200B,A00,098023,Salehi Golsefidy; Alireza,12,0,15,3
1668225221442,MATH 202B,A00,098024,Rhoades; Brendon Patrick,9,0,15,6
1668225221866,MATH 203B,A00,098025,Oprea; Dragos N.,10,0,15,5
1668225222296,MATH 204B,A00,098026,Sorensen; Claus M,13,0,15,2
1668225222718,MATH 208,A00,098027,Izadi; Elham,7,0,10,3
1668225223142,MATH 209,A00,098028,Pollack; Aaron,10,0,10,0
1668225223571,MATH 211A,A00,112919,Rogalski; Daniel,9,0,10,1
1668225223996,MATH 211B,A00,112920,Seward; Brandon M.,9,0,10,1
1668225224421,MATH 218,A00,098029,Li; Bo,10,0,10,0
1668225224845,MATH 220B,A00,098030,Novak; Jonathan I,11,0,15,4
1668225225268,MATH 221A,A00,098031,Ebenfelt; Peter F,13,0,15,2
1668225225689,MATH 231B,A00,098032,Zlatos; Andrej,12,0,15,3
1668225226112,MATH 240B,A00,098033,Ni; Lei,9,0,15,6
1668225226534,MATH 243,A00,098034,Jekel; David Andrew,10,0,10,0
1668225226960,MATH 245A,A00,098035,Nie; Jiawang,0,0,15,16
1668225227385,MATH 248,A00,098036,Bejenaru; Ioan,10,0,10,0
1668225227809,MATH 250B,A00,098037,Spolaor; Luca,14,0,15,1
1668225228239,MATH 258,A00,098038,Ni; Lei,10,0,10,0
1668225228663,MATH 264B,A00,098041,Rhoades; Brendon Patrick,9,0,15,6
1668225229099,MATH 268,A00,098042,Buss; Samuel R,10,0,10,0
1668225229534,MATH 269,A00,098043,Rhoades; Brendon Patrick,10,0,10,0
1668225229960,MATH 270B,A00,098044,Li; Bo,10,0,15,5
1668225230387,MATH 272B,A00,098045,Holst; Michael J,13,0,15,2
1668225230812,MATH 273A,A00,098046,Tian; Xiaochuan,10,0,15,5
1668225231238,MATH 275,A01,098048,Tian; Xiaochuan,6,0,10,4
1668225231660,MATH 278A,A00,098049,Holst; Michael J,8,0,10,2
1668225232094,MATH 278B,A00,098050,Cloninger; Alexander,10,0,10,0
1668225232520,MATH 278C,A00,098051,Nie; Jiawang,7,0,10,3
1668225232941,MATH 280B,A00,098052,Zheng; Tianyi,10,0,15,5
1668225233369,MATH 281B,A00,098053,Bradic; Jelena,2,0,15,13
1668225233792,MATH 282B,A00,098054,Arias-Castro; Ery,0,0,15,15
1668225234217,MATH 285,A00,098055,Fitzsimmons; Patrick J,0,0,15,17
1668225234648,MATH 287B,A00,098056,Arias-Castro; Ery,2,0,15,13
1668225235070,MATH 288,A00,098057,Agarwal; Pooja,9,0,10,1
1668225235070,MATH 288,B00,098058,Zhang; Danna,8,0,10,2
1668225235070,MATH 288,C00,098059,Williams; Ruth J,10,0,10,0
1668225235494,MATH 290B,A00,098060,Roberts; Justin Deritter,13,0,15,2
1668225235923,MATH 292,A00,098061,Belmont; Eva Kinoshita,10,0,10,0
1668225236349,MATH 295,A00,098062,Suk; Andrew Hoon,48,0,50,2
1668225236770,MATH 296,A00,098063,Novak; Jonathan I,20,0,20,0
1668225237202,MATH 297,001,098064,Gamst; Anthony Collins,9997,0,9999,2
1668225737949,COGS 205,A00,101395,Chiba; Andrea,19,0,20,1
1668225738372,COGS 210B,001,101404,Greene; Deanna Jacquelyn,9998,0,9999,1
1668225738372,COGS 210B,002,101417,Xia; Haijun,9999,0,9999,0
1668225738372,COGS 210B,003,101422,Nitz; Douglas A.,9999,0,9999,0
1668225738372,COGS 210B,004,101423,Hollan; James D.,9998,0,9999,1
1668225738372,COGS 210B,005,101424,Deak; Gedeon O.,9998,0,9999,1
1668225738372,COGS 210B,006,101425,Rossano; Federico,9999,0,9999,0
1668225738804,COGS 211B,A00,101427,Coulson; Seana M,9996,0,9999,3
1668225739228,COGS 220,A00,101428,Hollan; James D.,0,0,25,25
1668225739660,COGS 229,A00,101429,Dow; Steven P,18,0,25,7
1668225740083,COGS 230,A00,101430,Klemmer; Scott R,12,0,17,5
1668225740507,COGS 234,A00,101431,Xia; Haijun,2,0,25,23
1668225740933,COGS 260,A00,101432,Kiyonaga; Anastasia,21,0,25,4
1668225740933,COGS 260,B00,101433,Kirsh; David Joel,15,0,25,10
1668225741356,CSE 202,A00,102371,Impagliazzo; Russell,0,0,0,0
1668225741785,CSE 203B,A01,102373,Cheng; Chung Kuan,0,0,0,0
1668225742208,CSE 208,A00,102374,Micciancio; Daniele,0,0,0,0
1668225742632,CSE 209A,A00,112895,Impagliazzo; Russell,0,0,15,15
1668225743059,CSE 209B,A00,108005,Bellare; Mihir,0,0,0,0
1668225743482,CSE 210,A00,113163,Coblenz; Michael J,0,0,0,0
1668225743905,CSE 219,A00,106111,Dow; Steven P,0,0,20,20
1668225744328,CSE 221,A00,102376,Voelker; Geoffrey M.,0,0,0,0
1668225744755,CSE 224,A01,102378,Porter; George M,0,0,0,0
1668225745180,CSE 229A,A00,102379,Savage; Stefan,0,0,0,0
1668225745602,CSE 229C,A00,102380,Munyaka; Imani N. S.,0,0,0,0
1668225746028,CSE 232B,A00,102382,Deutsch; Alin Bernard,0,0,0,0
1668225746454,CSE 234,A01,112904,Kumar; Arun Kumar,0,0,0,0
1668225746883,CSE 237A,A00,102383,Rosing; Tajana Simunic,0,0,0,0
1668225747306,CSE 239A,A00,102384,Deutsch; Alin Bernard,0,0,0,0
1668225747745,CSE 239B,A00,102385,Polikarpova; Nadezhda,0,0,0,0
1668225748171,CSE 240A,A00,102386,Pannuto; Patrick William,0,0,0,0
1668225748594,CSE 240B,A00,102387,Zhao; Jishen,0,0,0,0
1668225749020,CSE 241A,A00,106406,Kang; Mingu,0,0,0,0
1668225749444,CSE 249B,A00,102388,Kahng; Andrew Byun,0,0,8,8
1668225749871,CSE 251B,A01,102392,Cottrell; Garrison W,0,0,0,0
1668225749871,CSE 251B,A02,102393,Cottrell; Garrison W,0,0,0,0
1668225750295,CSE 252B,A00,102394,Ochoa; Benjamin Lawrence,0,0,0,0
1668225750718,CSE 257,A01,102396,Gao; Sicun,0,0,0,0
1668225751144,CSE 272,A00,102397,Li; Tzumao,0,0,0,0
1668225751571,CSE 274,A00,111323,Chern; Albert Ren-Haur,0,0,0,0
1668225752017,CSE 282,A00,102398,Pevzner; Pavel Arkadjevich,0,0,0,0
1668225752440,CSE 284,A00,114175,Gymrek; Melissa Ann,0,0,0,0
1668225752867,CSE 290,A00,102399,Chandraker; Manmohan Krishna,0,0,0,0
1668225752867,CSE 290,B00,102400,Vaccaro; Kristen Marie,0,0,25,25
1668225752867,CSE 290,C00,102414,Pannuto; Patrick William,0,0,25,25
1668225752867,CSE 290,D00,102427,Pevzner; Pavel Arkadjevich,0,0,0,0
1668225752867,CSE 290,E00,102429,Zhao; Jishen,0,0,0,0
1668225752867,CSE 290,F00,102436,Tullsen; Dean Michael,0,0,0,0
1668225752867,CSE 290,G00,102440,Christensen; Henrik I,0,0,20,20
1668225753296,CSE 291,A00,102443,Su; Hao,0,0,0,0
1668225753296,CSE 291,B00,102448,Polikarpova; Nadezhda,0,0,0,0
1668225753296,CSE 291,C00,102453,Vaccaro; Kristen Marie,0,0,0,0
1668225753296,CSE 291,D00,111343,Savage; Stefan,0,0,0,0
1668225753296,CSE 291,E00,116474,Claffy; Kimberly Claire,0,0,0,0
1668225753296,CSE 291,F00,116479,Pasquale; Joseph,0,0,0,0
1668225753725,CSE 293,001,119111,Bafna; Vineet,9999,0,9999,0
1668225753725,CSE 293,002,119118,Bellare; Mihir,9999,0,9999,0
1668225753725,CSE 293,003,119122,Berg-Kirkpatrick; Taylor D,9999,0,9999,0
1668225753725,CSE 293,004,119135,Christensen; Henrik I,9999,0,9999,0
1668225753725,CSE 293,005,119142,Cottrell; Garrison W,9999,0,9999,0
1668225753725,CSE 293,006,119146,Deutsch; Alin Bernard,9999,0,9999,0
1668225753725,CSE 293,007,119159,Esmaeilzadeh; Hadi,9999,0,9999,0
1668225753725,CSE 293,008,119166,Freund; Yoav,9999,0,9999,0
1668225753725,CSE 293,009,119170,Griswold; William G.,9999,0,9999,0
1668225753725,CSE 293,010,119183,Gymrek; Melissa Ann,9999,0,9999,0
1668225753725,CSE 293,011,119190,Heninger; Nadia A,9999,0,9999,0
1668225753725,CSE 293,012,119230,Impagliazzo; Russell,9999,0,9999,0
1668225753725,CSE 293,013,119232,Jhala; Ranjit,9999,0,9999,0
1668225753725,CSE 293,014,119233,Kahng; Andrew Byun,9999,0,9999,0
1668225753725,CSE 293,015,119298,Kane; Daniel Mertz,9999,0,9999,0
1668225753725,CSE 293,016,119299,Kriegman; David J,9999,0,9999,0
1668225753725,CSE 293,017,119300,Kumar; Arun Kumar,9999,0,9999,0
1668225753725,CSE 293,018,119301,Lerner; Sorin,9999,0,9999,0
1668225753725,CSE 293,019,119302,Lovett; Shachar,9999,0,9999,0
1668225753725,CSE 293,020,119303,McAuley; Julian John,9999,0,9999,0
1668225753725,CSE 293,021,119304,Micciancio; Daniele,9999,0,9999,0
1668225753725,CSE 293,022,119367,Orailoglu; Alex,9999,0,9999,0
1668225753725,CSE 293,023,119382,Paturi; Ramamohan,9999,0,9999,0
1668225753725,CSE 293,024,119404,Polikarpova; Nadezhda,9999,0,9999,0
1668225753725,CSE 293,025,119406,Politz; Joseph Gibbs,9999,0,9999,0
1668225753725,CSE 293,026,119411,Porter; George M,9999,0,9999,0
1668225753725,CSE 293,027,119414,Porter; Leonard Emerson,9999,0,9999,0
1668225753725,CSE 293,028,119416,Ramamoorthi; Ravi,9999,0,9999,0
1668225753725,CSE 293,029,119417,Sahoo; Debashis,9999,0,9999,0
1668225753725,CSE 293,030,119420,Saul; Lawrence,9999,0,9999,0
1668225753725,CSE 293,031,119421,Savage; Stefan,9999,0,9999,0
1668225753725,CSE 293,032,119425,Schulze; Jurgen P.,9999,0,9999,0
1668225753725,CSE 293,033,119426,Snoeren; Alex C.,9999,0,9999,0
1668225753725,CSE 293,034,119428,Shang; Jingbo,9999,0,9999,0
1668225753725,CSE 293,035,119430,Stefan; Deian,9999,0,9999,0
1668225753725,CSE 293,036,119431,Su; Hao,9999,0,9999,0
1668225753725,CSE 293,037,119433,Swanson; Steven James,9999,0,9999,0
1668225753725,CSE 293,038,119435,Tullsen; Dean Michael,9999,0,9999,0
1668225753725,CSE 293,039,119483,Voelker; Geoffrey M.,9999,0,9999,0
1668225753725,CSE 293,040,119537,Zhao; Jishen,9999,0,9999,0
1668225753725,CSE 293,041,119538,Zhou; Yuan-Yuan,9999,0,9999,0
1668225753725,CSE 293,042,119539,Gao; Sicun,9999,0,9999,0
1668225753725,CSE 293,043,119540,Weibel; Nadir,9999,0,9999,0
1668225753725,CSE 293,044,119541,Gupta; Rajesh K.,9999,0,9999,0
1668225753725,CSE 293,045,126410,Vaccaro; Kristen Marie,9999,0,9999,0
1668225753725,CSE 293,046,126411,Klemke; Richard,9999,0,9999,0
1668225754151,CSE 294,A00,102459,Voelker; Geoffrey M.,0,0,0,0
1668225754151,CSE 294,B00,111322,Orailoglu; Alex,0,0,0,0
1668225754578,DSE 201,A00,096914,Deutsch; Alin Bernard,30,0,30,0
1668225755001,DSE 210,A00,096915,Dasgupta; Sanjoy,30,0,30,0
1668225755427,DSE 260A,A00,096916,Altintas De Callaf; Ilkay,30,0,30,0
1668225755857,ECE 200,001,103586,Antipa; Nicholas A,9999,0,9999,0
1668225755857,ECE 200,002,103587,Atanasov; Nikolay A.,9999,0,9999,0
1668225755857,ECE 200,003,103588,Bharadia; Dinesh,9999,0,9999,0
1668225755857,ECE 200,004,103589,Cheng; Chung Kuan,9999,0,9999,0
1668225755857,ECE 200,005,103590,Cosman; Pamela C.,9999,0,9999,0
1668225755857,ECE 200,006,103591,Dayeh; Shadi Ahmad,9999,0,9999,0
1668225755857,ECE 200,007,103592,Fainman; Yeshaiahu,9999,0,9999,0
1668225755857,ECE 200,008,103593,Ford; Joseph Earl,9999,0,9999,0
1668225755857,ECE 200,009,103594,Franceschetti; Massimo,9999,0,9999,0
1668225755857,ECE 200,010,103595,Fullerton; Eric E,9999,0,9999,0
1668225755857,ECE 200,011,103596,Galton; Ian A,9999,0,9999,0
1668225755857,ECE 200,012,103597,Gilja; Vikash,9999,0,9999,0
1668225755857,ECE 200,013,103598,Hall; Drew A.,9999,0,9999,0
1668225755857,ECE 200,014,103599,Hsueh; Tzu-Chien,9999,0,9999,0
1668225755857,ECE 200,015,103600,Javidi; Tara,9999,0,9999,0
1668225755857,ECE 200,016,103601,Kahng; Andrew Byun,9999,0,9999,0
1668225755857,ECE 200,017,103602,Kim; Young-Han,9999,0,9999,0
1668225755857,ECE 200,018,103603,Koushanfar; Farinaz,9999,0,9999,0
1668225755857,ECE 200,019,103604,Kuzum; Duygu,9999,0,9999,0
1668225755857,ECE 200,020,103605,Le; Hanh-Phuc,9999,0,9999,0
1668225755857,ECE 200,021,103606,Lin; Bill,9999,0,9999,0
1668225755857,ECE 200,022,103607,Liu; Zhaowei,9998,0,9999,1
1668225755857,ECE 200,023,103608,Lo; Yu-Hwa,9999,0,9999,0
1668225755857,ECE 200,024,103609,Lomakin; Vitaliy,9999,0,9999,0
1668225755857,ECE 200,025,103610,Mercier; Patrick Philip,9999,0,9999,0
1668225755857,ECE 200,026,103611,Meyer; Florian,9999,0,9999,0
1668225755857,ECE 200,027,103612,Milstein; Laurence B.,9999,0,9999,0
1668225755857,ECE 200,028,103613,Mir Arabbaygi; Siavash,9999,0,9999,0
1668225755857,ECE 200,029,103614,Mookherjea; Shayan,9999,0,9999,0
1668225755857,ECE 200,030,103615,Morris; Karcher William,9999,0,9999,0
1668225755857,ECE 200,031,103616,Ng; Tse Nga,9999,0,9999,0
1668225755857,ECE 200,032,103617,Nguyen; Truong Quang,9999,0,9999,0
1668225755857,ECE 200,033,103618,Nomura; Kenji,9999,0,9999,0
1668225755857,ECE 200,034,103619,Orlitsky; Alon,9999,0,9999,0
1668225755857,ECE 200,035,103620,Pal; Piya,9999,0,9999,0
1668225755857,ECE 200,036,103621,Papen; George C.,9999,0,9999,0
1668225755857,ECE 200,037,103622,Radic; Stojan,9999,0,9999,0
1668225755857,ECE 200,038,103623,Rao; Bhaskar D.,9999,0,9999,0
1668225755857,ECE 200,039,103624,Rao; Ramesh R,9999,0,9999,0
1668225755857,ECE 200,040,103625,Rebeiz; Gabriel,9999,0,9999,0
1668225755857,ECE 200,041,103626,Sanford; John R,9999,0,9999,0
1668225755857,ECE 200,042,103627,Siegel; Paul H.,9999,0,9999,0
1668225755857,ECE 200,043,103628,Sievenpiper; Daniel F.,9999,0,9999,0
1668225755857,ECE 200,044,103629,Sworder; David D.,9999,0,9999,0
1668225755857,ECE 200,045,103630,Taur; Yuan,9999,0,9999,0
1668225755857,ECE 200,046,103631,Touri; Behrouz,9999,0,9999,0
1668225755857,ECE 200,047,103632,Trivedi; Mohan M.,9999,0,9999,0
1668225755857,ECE 200,048,103633,Vasconcelos; Nuno,9999,0,9999,0
1668225755857,ECE 200,049,103634,Wang; Xiaolong,9999,0,9999,0
1668225755857,ECE 200,050,103635,Xie; Pengtao,9999,0,9999,0
1668225755857,ECE 200,051,103636,Yip; Michael,9999,0,9999,0
1668225755857,ECE 200,052,103637,Zeger; Kenneth A.,999,0,999,0
1668225755857,ECE 200,053,103638,Zhang; Xinyu,9999,0,9999,0
1668225755857,ECE 200,054,103639,Turakhia; Yatish Girish,9999,0,9999,0
1668225755857,ECE 200,055,103640,Kang; Mingu,9999,0,9999,0
1668225755857,ECE 200,056,103641,Shi; Yuanyuan,9999,0,9999,0
1668225755857,ECE 200,057,103642,Wang; Edward Jay,9999,0,9999,0
1668225755857,ECE 200,058,103643,Zheng; Yang,9999,0,9999,0
1668225756279,ECE 202,A00,103644,Kuzum; Duygu,0,0,0,0
1668225756703,ECE 212BN,A00,103646,Ng; Tse Nga,0,0,0,0
1668225757128,ECE 221,A00,111493,Staff,0,0,0,0
1668225757551,ECE 222B,A00,103647,Lomakin; Vitaliy,0,0,0,0
1668225757974,ECE 230B,A00,103648,Taur; Yuan,0,0,0,0
1668225758400,ECE 238B,A00,103649,Garay; Javier,0,0,0,0
1668225758825,ECE 240B,A00,112900,Fainman; Yeshaiahu,0,0,0,0
1668225759255,ECE 247A,A00,103650,Jokerst; Jesse Vincent,0,0,0,0
1668225759677,ECE 247B,A00,103651,Wang; Joseph,0,0,0,0
1668225760105,ECE 250,A00,103652,Siegel; Paul H.,0,0,0,0
1668225760529,ECE 251A,A00,103654,Rao; Bhaskar D.,0,0,0,0
1668225760952,ECE 257B,A00,103655,Bharadia; Dinesh,0,0,0,0
1668225761374,ECE 258A,A00,103656,Milstein; Laurence B.,0,0,0,0
1668225761875,ECE 260B,A00,103658,Kang; Mingu,0,0,0,0
1668225762298,ECE 264A,A00,103659,Galton; Ian A,0,0,0,0
1668225762723,ECE 265A,A00,103661,Gudem; Prasad S.S.,0,0,0,0
1668225763151,ECE 265D,A00,103662,Gudem; Prasad S.S.,0,0,0,0
1668225763576,ECE 268,A00,103663,Koushanfar; Farinaz,0,0,0,0
1668225764001,ECE 269,A01,103665,Pal; Piya,0,0,0,0
1668225764426,ECE 271B,A00,103666,Vasconcelos; Manuela,0,0,0,0
1668225764849,ECE 276A,A00,103667,Atanasov; Nikolay A.,0,0,0,0
1668225765283,ECE 277,A00,103668,An; Cheolhong,0,0,0,0
1668225765705,ECE 279,A00,117947,Hall; Drew A.,0,0,0,0
1668225766563,ECE 283,A00,103670,Hsueh; Tzu-Chien,0,0,0,0
1668225766987,ECE 284,A00,103671,Turakhia; Yatish Girish,0,0,0,0
1668225767415,ECE 285,A00,103672,Zheng; Yang,0,0,0,0
1668225767415,ECE 285,B00,103673,Sworder; David D.,0,0,0,0
1668225767843,ECE 287,A00,103676,Javidi; Tara,0,0,0,0
1668225768266,MATH 200B,A00,098023,Salehi Golsefidy; Alireza,12,0,15,3
1668225768691,MATH 202B,A00,098024,Rhoades; Brendon Patrick,9,0,15,6
1668225769114,MATH 203B,A00,098025,Oprea; Dragos N.,10,0,15,5
1668225769538,MATH 204B,A00,098026,Sorensen; Claus M,13,0,15,2
1668225769965,MATH 208,A00,098027,Izadi; Elham,7,0,10,3
1668225770389,MATH 209,A00,098028,Pollack; Aaron,10,0,10,0
1668225770816,MATH 211A,A00,112919,Rogalski; Daniel,9,0,10,1
1668225771243,MATH 211B,A00,112920,Seward; Brandon M.,9,0,10,1
1668225771667,MATH 218,A00,098029,Li; Bo,10,0,10,0
1668225772093,MATH 220B,A00,098030,Novak; Jonathan I,11,0,15,4
1668225772518,MATH 221A,A00,098031,Ebenfelt; Peter F,13,0,15,2
1668225772941,MATH 231B,A00,098032,Zlatos; Andrej,12,0,15,3
1668225773366,MATH 240B,A00,098033,Ni; Lei,9,0,15,6
1668225773797,MATH 243,A00,098034,Jekel; David Andrew,10,0,10,0
1668225774219,MATH 245A,A00,098035,Nie; Jiawang,0,0,15,16
1668225774642,MATH 248,A00,098036,Bejenaru; Ioan,10,0,10,0
1668225775066,MATH 250B,A00,098037,Spolaor; Luca,14,0,15,1
1668225775495,MATH 258,A00,098038,Ni; Lei,10,0,10,0
1668225775917,MATH 264B,A00,098041,Rhoades; Brendon Patrick,9,0,15,6
1668225776343,MATH 268,A00,098042,Buss; Samuel R,10,0,10,0
1668225776774,MATH 269,A00,098043,Rhoades; Brendon Patrick,10,0,10,0
1668225777197,MATH 270B,A00,098044,Li; Bo,10,0,15,5
1668225777619,MATH 272B,A00,098045,Holst; Michael J,13,0,15,2
1668225778044,MATH 273A,A00,098046,Tian; Xiaochuan,10,0,15,5
1668225778468,MATH 275,A01,098048,Tian; Xiaochuan,6,0,10,4
1668225778892,MATH 278A,A00,098049,Holst; Michael J,8,0,10,2
1668225779315,MATH 278B,A00,098050,Cloninger; Alexander,10,0,10,0
1668225779737,MATH 278C,A00,098051,Nie; Jiawang,7,0,10,3
1668225780166,MATH 280B,A00,098052,Zheng; Tianyi,10,0,15,5
1668225780597,MATH 281B,A00,098053,Bradic; Jelena,2,0,15,13
1668225781028,MATH 282B,A00,098054,Arias-Castro; Ery,0,0,15,15
1668225781455,MATH 285,A00,098055,Fitzsimmons; Patrick J,0,0,15,17
1668225781881,MATH 287B,A00,098056,Arias-Castro; Ery,2,0,15,13
1668225782305,MATH 288,A00,098057,Agarwal; Pooja,9,0,10,1
1668225782305,MATH 288,B00,098058,Zhang; Danna,8,0,10,2
1668225782305,MATH 288,C00,098059,Williams; Ruth J,10,0,10,0
1668225782729,MATH 290B,A00,098060,Roberts; Justin Deritter,13,0,15,2
1668225783155,MATH 292,A00,098061,Belmont; Eva Kinoshita,10,0,10,0
1668225783584,MATH 295,A00,098062,Suk; Andrew Hoon,48,0,50,2
1668225784014,MATH 296,A00,098063,Novak; Jonathan I,20,0,20,0
1668225784439,MATH 297,001,098064,Gamst; Anthony Collins,9997,0,9999,2
1668226285776,COGS 205,A00,101395,Chiba; Andrea,19,0,20,1
1668226286202,COGS 210B,001,101404,Greene; Deanna Jacquelyn,9998,0,9999,1
1668226286202,COGS 210B,002,101417,Xia; Haijun,9999,0,9999,0
1668226286202,COGS 210B,003,101422,Nitz; Douglas A.,9999,0,9999,0
1668226286202,COGS 210B,004,101423,Hollan; James D.,9998,0,9999,1
1668226286202,COGS 210B,005,101424,Deak; Gedeon O.,9998,0,9999,1
1668226286202,COGS 210B,006,101425,Rossano; Federico,9999,0,9999,0
1668226286626,COGS 211B,A00,101427,Coulson; Seana M,9996,0,9999,3
1668226287052,COGS 220,A00,101428,Hollan; James D.,0,0,25,25
1668226287480,COGS 229,A00,101429,Dow; Steven P,18,0,25,7
1668226287911,COGS 230,A00,101430,Klemmer; Scott R,12,0,17,5
1668226288334,COGS 234,A00,101431,Xia; Haijun,2,0,25,23
1668226288770,COGS 260,A00,101432,Kiyonaga; Anastasia,21,0,25,4
1668226288770,COGS 260,B00,101433,Kirsh; David Joel,15,0,25,10
1668226289194,CSE 202,A00,102371,Impagliazzo; Russell,0,0,0,0
1668226289626,CSE 203B,A01,102373,Cheng; Chung Kuan,0,0,0,0
1668226290055,CSE 208,A00,102374,Micciancio; Daniele,0,0,0,0
1668226290479,CSE 209A,A00,112895,Impagliazzo; Russell,0,0,15,15
1668226290903,CSE 209B,A00,108005,Bellare; Mihir,0,0,0,0
1668226291325,CSE 210,A00,113163,Coblenz; Michael J,0,0,0,0
1668226291748,CSE 219,A00,106111,Dow; Steven P,0,0,20,20
1668226292169,CSE 221,A00,102376,Voelker; Geoffrey M.,0,0,0,0
1668226292592,CSE 224,A01,102378,Porter; George M,0,0,0,0
1668226293015,CSE 229A,A00,102379,Savage; Stefan,0,0,0,0
1668226293438,CSE 229C,A00,102380,Munyaka; Imani N. S.,0,0,0,0
1668226293861,CSE 232B,A00,102382,Deutsch; Alin Bernard,0,0,0,0
1668226294286,CSE 234,A01,112904,Kumar; Arun Kumar,0,0,0,0
1668226294709,CSE 237A,A00,102383,Rosing; Tajana Simunic,0,0,0,0
1668226295140,CSE 239A,A00,102384,Deutsch; Alin Bernard,0,0,0,0
1668226295567,CSE 239B,A00,102385,Polikarpova; Nadezhda,0,0,0,0
1668226295993,CSE 240A,A00,102386,Pannuto; Patrick William,0,0,0,0
1668226296423,CSE 240B,A00,102387,Zhao; Jishen,0,0,0,0
1668226296847,CSE 241A,A00,106406,Kang; Mingu,0,0,0,0
1668226297274,CSE 249B,A00,102388,Kahng; Andrew Byun,0,0,8,8
1668226297698,CSE 251B,A01,102392,Cottrell; Garrison W,0,0,0,0
1668226297698,CSE 251B,A02,102393,Cottrell; Garrison W,0,0,0,0
1668226298127,CSE 252B,A00,102394,Ochoa; Benjamin Lawrence,0,0,0,0
1668226298553,CSE 257,A01,102396,Gao; Sicun,0,0,0,0
1668226298978,CSE 272,A00,102397,Li; Tzumao,0,0,0,0
1668226299401,CSE 274,A00,111323,Chern; Albert Ren-Haur,0,0,0,0
1668226299823,CSE 282,A00,102398,Pevzner; Pavel Arkadjevich,0,0,0,0
1668226300245,CSE 284,A00,114175,Gymrek; Melissa Ann,0,0,0,0
1668226300680,CSE 290,A00,102399,Chandraker; Manmohan Krishna,0,0,0,0
1668226300680,CSE 290,B00,102400,Vaccaro; Kristen Marie,0,0,25,25
1668226300680,CSE 290,C00,102414,Pannuto; Patrick William,0,0,25,25
1668226300680,CSE 290,D00,102427,Pevzner; Pavel Arkadjevich,0,0,0,0
1668226300680,CSE 290,E00,102429,Zhao; Jishen,0,0,0,0
1668226300680,CSE 290,F00,102436,Tullsen; Dean Michael,0,0,0,0
1668226300680,CSE 290,G00,102440,Christensen; Henrik I,0,0,20,20
1668226301111,CSE 291,A00,102443,Su; Hao,0,0,0,0
1668226301111,CSE 291,B00,102448,Polikarpova; Nadezhda,0,0,0,0
1668226301111,CSE 291,C00,102453,Vaccaro; Kristen Marie,0,0,0,0
1668226301111,CSE 291,D00,111343,Savage; Stefan,0,0,0,0
1668226301111,CSE 291,E00,116474,Claffy; Kimberly Claire,0,0,0,0
1668226301111,CSE 291,F00,116479,Pasquale; Joseph,0,0,0,0
1668226301539,CSE 293,001,119111,Bafna; Vineet,9999,0,9999,0
1668226301539,CSE 293,002,119118,Bellare; Mihir,9999,0,9999,0
1668226301539,CSE 293,003,119122,Berg-Kirkpatrick; Taylor D,9999,0,9999,0
1668226301539,CSE 293,004,119135,Christensen; Henrik I,9999,0,9999,0
1668226301539,CSE 293,005,119142,Cottrell; Garrison W,9999,0,9999,0
1668226301539,CSE 293,006,119146,Deutsch; Alin Bernard,9999,0,9999,0
1668226301539,CSE 293,007,119159,Esmaeilzadeh; Hadi,9999,0,9999,0
1668226301539,CSE 293,008,119166,Freund; Yoav,9999,0,9999,0
1668226301539,CSE 293,009,119170,Griswold; William G.,9999,0,9999,0
1668226301539,CSE 293,010,119183,Gymrek; Melissa Ann,9999,0,9999,0
1668226301539,CSE 293,011,119190,Heninger; Nadia A,9999,0,9999,0
1668226301539,CSE 293,012,119230,Impagliazzo; Russell,9999,0,9999,0
1668226301539,CSE 293,013,119232,Jhala; Ranjit,9999,0,9999,0
1668226301539,CSE 293,014,119233,Kahng; Andrew Byun,9999,0,9999,0
1668226301539,CSE 293,015,119298,Kane; Daniel Mertz,9999,0,9999,0
1668226301539,CSE 293,016,119299,Kriegman; David J,9999,0,9999,0
1668226301539,CSE 293,017,119300,Kumar; Arun Kumar,9999,0,9999,0
1668226301539,CSE 293,018,119301,Lerner; Sorin,9999,0,9999,0
1668226301539,CSE 293,019,119302,Lovett; Shachar,9999,0,9999,0
1668226301539,CSE 293,020,119303,McAuley; Julian John,9999,0,9999,0
1668226301539,CSE 293,021,119304,Micciancio; Daniele,9999,0,9999,0
1668226301539,CSE 293,022,119367,Orailoglu; Alex,9999,0,9999,0
1668226301539,CSE 293,023,119382,Paturi; Ramamohan,9999,0,9999,0
1668226301539,CSE 293,024,119404,Polikarpova; Nadezhda,9999,0,9999,0
1668226301539,CSE 293,025,119406,Politz; Joseph Gibbs,9999,0,9999,0
1668226301539,CSE 293,026,119411,Porter; George M,9999,0,9999,0
1668226301539,CSE 293,027,119414,Porter; Leonard Emerson,9999,0,9999,0
1668226301539,CSE 293,028,119416,Ramamoorthi; Ravi,9999,0,9999,0
1668226301539,CSE 293,029,119417,Sahoo; Debashis,9999,0,9999,0
1668226301539,CSE 293,030,119420,Saul; Lawrence,9999,0,9999,0
1668226301539,CSE 293,031,119421,Savage; Stefan,9999,0,9999,0
1668226301539,CSE 293,032,119425,Schulze; Jurgen P.,9999,0,9999,0
1668226301539,CSE 293,033,119426,Snoeren; Alex C.,9999,0,9999,0
1668226301539,CSE 293,034,119428,Shang; Jingbo,9999,0,9999,0
1668226301539,CSE 293,035,119430,Stefan; Deian,9999,0,9999,0
1668226301539,CSE 293,036,119431,Su; Hao,9999,0,9999,0
1668226301539,CSE 293,037,119433,Swanson; Steven James,9999,0,9999,0
1668226301539,CSE 293,038,119435,Tullsen; Dean Michael,9999,0,9999,0
1668226301539,CSE 293,039,119483,Voelker; Geoffrey M.,9999,0,9999,0
1668226301539,CSE 293,040,119537,Zhao; Jishen,9999,0,9999,0
1668226301539,CSE 293,041,119538,Zhou; Yuan-Yuan,9999,0,9999,0
1668226301539,CSE 293,042,119539,Gao; Sicun,9999,0,9999,0
1668226301539,CSE 293,043,119540,Weibel; Nadir,9999,0,9999,0
1668226301539,CSE 293,044,119541,Gupta; Rajesh K.,9999,0,9999,0
1668226301539,CSE 293,045,126410,Vaccaro; Kristen Marie,9999,0,9999,0
1668226301539,CSE 293,046,126411,Klemke; Richard,9999,0,9999,0
1668226301965,CSE 294,A00,102459,Voelker; Geoffrey M.,0,0,0,0
1668226301965,CSE 294,B00,111322,Orailoglu; Alex,0,0,0,0
1668226302393,DSE 201,A00,096914,Deutsch; Alin Bernard,30,0,30,0
1668226302814,DSE 210,A00,096915,Dasgupta; Sanjoy,30,0,30,0
1668226303237,DSE 260A,A00,096916,Altintas De Callaf; Ilkay,30,0,30,0
1668226303666,ECE 200,001,103586,Antipa; Nicholas A,9999,0,9999,0
1668226303666,ECE 200,002,103587,Atanasov; Nikolay A.,9999,0,9999,0
1668226303666,ECE 200,003,103588,Bharadia; Dinesh,9999,0,9999,0
1668226303666,ECE 200,004,103589,Cheng; Chung Kuan,9999,0,9999,0
1668226303666,ECE 200,005,103590,Cosman; Pamela C.,9999,0,9999,0
1668226303666,ECE 200,006,103591,Dayeh; Shadi Ahmad,9999,0,9999,0
1668226303666,ECE 200,007,103592,Fainman; Yeshaiahu,9999,0,9999,0
1668226303666,ECE 200,008,103593,Ford; Joseph Earl,9999,0,9999,0
1668226303666,ECE 200,009,103594,Franceschetti; Massimo,9999,0,9999,0
1668226303666,ECE 200,010,103595,Fullerton; Eric E,9999,0,9999,0
1668226303666,ECE 200,011,103596,Galton; Ian A,9999,0,9999,0
1668226303666,ECE 200,012,103597,Gilja; Vikash,9999,0,9999,0
1668226303666,ECE 200,013,103598,Hall; Drew A.,9999,0,9999,0
1668226303666,ECE 200,014,103599,Hsueh; Tzu-Chien,9999,0,9999,0
1668226303666,ECE 200,015,103600,Javidi; Tara,9999,0,9999,0
1668226303666,ECE 200,016,103601,Kahng; Andrew Byun,9999,0,9999,0
1668226303666,ECE 200,017,103602,Kim; Young-Han,9999,0,9999,0
1668226303666,ECE 200,018,103603,Koushanfar; Farinaz,9999,0,9999,0
1668226303666,ECE 200,019,103604,Kuzum; Duygu,9999,0,9999,0
1668226303666,ECE 200,020,103605,Le; Hanh-Phuc,9999,0,9999,0
1668226303666,ECE 200,021,103606,Lin; Bill,9999,0,9999,0
1668226303666,ECE 200,022,103607,Liu; Zhaowei,9998,0,9999,1
1668226303666,ECE 200,023,103608,Lo; Yu-Hwa,9999,0,9999,0
1668226303666,ECE 200,024,103609,Lomakin; Vitaliy,9999,0,9999,0
1668226303666,ECE 200,025,103610,Mercier; Patrick Philip,9999,0,9999,0
1668226303666,ECE 200,026,103611,Meyer; Florian,9999,0,9999,0
1668226303666,ECE 200,027,103612,Milstein; Laurence B.,9999,0,9999,0
1668226303666,ECE 200,028,103613,Mir Arabbaygi; Siavash,9999,0,9999,0
1668226303666,ECE 200,029,103614,Mookherjea; Shayan,9999,0,9999,0
1668226303666,ECE 200,030,103615,Morris; Karcher William,9999,0,9999,0
1668226303666,ECE 200,031,103616,Ng; Tse Nga,9999,0,9999,0
1668226303666,ECE 200,032,103617,Nguyen; Truong Quang,9999,0,9999,0
1668226303666,ECE 200,033,103618,Nomura; Kenji,9999,0,9999,0
1668226303666,ECE 200,034,103619,Orlitsky; Alon,9999,0,9999,0
1668226303666,ECE 200,035,103620,Pal; Piya,9999,0,9999,0
1668226303666,ECE 200,036,103621,Papen; George C.,9999,0,9999,0
1668226303666,ECE 200,037,103622,Radic; Stojan,9999,0,9999,0
1668226303666,ECE 200,038,103623,Rao; Bhaskar D.,9999,0,9999,0
1668226303666,ECE 200,039,103624,Rao; Ramesh R,9999,0,9999,0
1668226303666,ECE 200,040,103625,Rebeiz; Gabriel,9999,0,9999,0
1668226303666,ECE 200,041,103626,Sanford; John R,9999,0,9999,0
1668226303666,ECE 200,042,103627,Siegel; Paul H.,9999,0,9999,0
1668226303666,ECE 200,043,103628,Sievenpiper; Daniel F.,9999,0,9999,0
1668226303666,ECE 200,044,103629,Sworder; David D.,9999,0,9999,0
1668226303666,ECE 200,045,103630,Taur; Yuan,9999,0,9999,0
1668226303666,ECE 200,046,103631,Touri; Behrouz,9999,0,9999,0
1668226303666,ECE 200,047,103632,Trivedi; Mohan M.,9999,0,9999,0
1668226303666,ECE 200,048,103633,Vasconcelos; Nuno,9999,0,9999,0
1668226303666,ECE 200,049,103634,Wang; Xiaolong,9999,0,9999,0
1668226303666,ECE 200,050,103635,Xie; Pengtao,9999,0,9999,0
1668226303666,ECE 200,051,103636,Yip; Michael,9999,0,9999,0
1668226303666,ECE 200,052,103637,Zeger; Kenneth A.,999,0,999,0
1668226303666,ECE 200,053,103638,Zhang; Xinyu,9999,0,9999,0
1668226303666,ECE 200,054,103639,Turakhia; Yatish Girish,9999,0,9999,0
1668226303666,ECE 200,055,103640,Kang; Mingu,9999,0,9999,0
1668226303666,ECE 200,056,103641,Shi; Yuanyuan,9999,0,9999,0
1668226303666,ECE 200,057,103642,Wang; Edward Jay,9999,0,9999,0
1668226303666,ECE 200,058,103643,Zheng; Yang,9999,0,9999,0
1668226304090,ECE 202,A00,103644,Kuzum; Duygu,0,0,0,0
1668226304514,ECE 212BN,A00,103646,Ng; Tse Nga,0,0,0,0
1668226304941,ECE 221,A00,111493,Staff,0,0,0,0
1668226305373,ECE 222B,A00,103647,Lomakin; Vitaliy,0,0,0,0
1668226305808,ECE 230B,A00,103648,Taur; Yuan,0,0,0,0
1668226306239,ECE 238B,A00,103649,Garay; Javier,0,0,0,0
1668226306662,ECE 240B,A00,112900,Fainman; Yeshaiahu,0,0,0,0
1668226307090,ECE 247A,A00,103650,Jokerst; Jesse Vincent,0,0,0,0
1668226307513,ECE 247B,A00,103651,Wang; Joseph,0,0,0,0
1668226307937,ECE 250,A00,103652,Siegel; Paul H.,0,0,0,0
1668226308361,ECE 251A,A00,103654,Rao; Bhaskar D.,0,0,0,0
1668226308786,ECE 257B,A00,103655,Bharadia; Dinesh,0,0,0,0
1668226309209,ECE 258A,A00,103656,Milstein; Laurence B.,0,0,0,0
1668226309633,ECE 260B,A00,103658,Kang; Mingu,0,0,0,0
1668226310060,ECE 264A,A00,103659,Galton; Ian A,0,0,0,0
1668226310487,ECE 265A,A00,103661,Gudem; Prasad S.S.,0,0,0,0
1668226310912,ECE 265D,A00,103662,Gudem; Prasad S.S.,0,0,0,0
1668226311336,ECE 268,A00,103663,Koushanfar; Farinaz,0,0,0,0
1668226311768,ECE 269,A01,103665,Pal; Piya,0,0,0,0
1668226312191,ECE 271B,A00,103666,Vasconcelos; Manuela,0,0,0,0
1668226312614,ECE 276A,A00,103667,Atanasov; Nikolay A.,0,0,0,0
1668226313051,ECE 277,A00,103668,An; Cheolhong,0,0,0,0
1668226313479,ECE 279,A00,117947,Hall; Drew A.,0,0,0,0
1668226314326,ECE 283,A00,103670,Hsueh; Tzu-Chien,0,0,0,0
1668226314749,ECE 284,A00,103671,Turakhia; Yatish Girish,0,0,0,0
1668226315175,ECE 285,A00,103672,Zheng; Yang,0,0,0,0
1668226315175,ECE 285,B00,103673,Sworder; David D.,0,0,0,0
1668226315597,ECE 287,A00,103676,Javidi; Tara,0,0,0,0
1668226316031,MATH 200B,A00,098023,Salehi Golsefidy; Alireza,12,0,15,3
1668226316459,MATH 202B,A00,098024,Rhoades; Brendon Patrick,9,0,15,6
1668226316883,MATH 203B,A00,098025,Oprea; Dragos N.,10,0,15,5
1668226317309,MATH 204B,A00,098026,Sorensen; Claus M,13,0,15,2
1668226317744,MATH 208,A00,098027,Izadi; Elham,7,0,10,3
1668226318169,MATH 209,A00,098028,Pollack; Aaron,10,0,10,0
1668226318590,MATH 211A,A00,112919,Rogalski; Daniel,9,0,10,1
1668226319012,MATH 211B,A00,112920,Seward; Brandon M.,9,0,10,1
1668226319435,MATH 218,A00,098029,Li; Bo,10,0,10,0
1668226319857,MATH 220B,A00,098030,Novak; Jonathan I,11,0,15,4
1668226320279,MATH 221A,A00,098031,Ebenfelt; Peter F,13,0,15,2
1668226320711,MATH 231B,A00,098032,Zlatos; Andrej,12,0,15,3
1668226321133,MATH 240B,A00,098033,Ni; Lei,9,0,15,6
1668226321555,MATH 243,A00,098034,Jekel; David Andrew,10,0,10,0
1668226321977,MATH 245A,A00,098035,Nie; Jiawang,0,0,15,16
1668226322400,MATH 248,A00,098036,Bejenaru; Ioan,10,0,10,0
1668226322823,MATH 250B,A00,098037,Spolaor; Luca,14,0,15,1
1668226323244,MATH 258,A00,098038,Ni; Lei,10,0,10,0
1668226323678,MATH 264B,A00,098041,Rhoades; Brendon Patrick,9,0,15,6
1668226324110,MATH 268,A00,098042,Buss; Samuel R,10,0,10,0
1668226324535,MATH 269,A00,098043,Rhoades; Brendon Patrick,10,0,10,0
1668226324961,MATH 270B,A00,098044,Li; Bo,10,0,15,5
1668226325391,MATH 272B,A00,098045,Holst; Michael J,13,0,15,2
1668226325825,MATH 273A,A00,098046,Tian; Xiaochuan,10,0,15,5
1668226326344,MATH 275,A01,098048,Tian; Xiaochuan,6,0,10,4
1668226326771,MATH 278A,A00,098049,Holst; Michael J,8,0,10,2
1668226327200,MATH 278B,A00,098050,Cloninger; Alexander,10,0,10,0
1668226327643,MATH 278C,A00,098051,Nie; Jiawang,7,0,10,3
1668226328066,MATH 280B,A00,098052,Zheng; Tianyi,10,0,15,5
1668226328488,MATH 281B,A00,098053,Bradic; Jelena,2,0,15,13
1668226328922,MATH 282B,A00,098054,Arias-Castro; Ery,0,0,15,15
1668226329346,MATH 285,A00,098055,Fitzsimmons; Patrick J,0,0,15,17
1668226329776,MATH 287B,A00,098056,Arias-Castro; Ery,2,0,15,13
1668226330198,MATH 288,A00,098057,Agarwal; Pooja,9,0,10,1
1668226330198,MATH 288,B00,098058,Zhang; Danna,8,0,10,2
1668226330198,MATH 288,C00,098059,Williams; Ruth J,10,0,10,0
1668226330619,MATH 290B,A00,098060,Roberts; Justin Deritter,13,0,15,2
1668226331043,MATH 292,A00,098061,Belmont; Eva Kinoshita,10,0,10,0
1668226331468,MATH 295,A00,098062,Suk; Andrew Hoon,48,0,50,2
1668226331892,MATH 296,A00,098063,Novak; Jonathan I,20,0,20,0
1668226332318,MATH 297,001,098064,Gamst; Anthony Collins,9997,0,9999,2
1668226834071,COGS 205,A00,101395,Chiba; Andrea,19,0,20,1
1668226834497,COGS 210B,001,101404,Greene; Deanna Jacquelyn,9998,0,9999,1
1668226834497,COGS 210B,002,101417,Xia; Haijun,9999,0,9999,0
1668226834497,COGS 210B,003,101422,Nitz; Douglas A.,9999,0,9999,0
1668226834497,COGS 210B,004,101423,Hollan; James D.,9998,0,9999,1
1668226834497,COGS 210B,005,101424,Deak; Gedeon O.,9998,0,9999,1
1668226834497,COGS 210B,006,101425,Rossano; Federico,9999,0,9999,0
1668226834922,COGS 211B,A00,101427,Coulson; Seana M,9996,0,9999,3
1668226835344,COGS 220,A00,101428,Hollan; James D.,0,0,25,25
1668226835768,COGS 229,A00,101429,Dow; Steven P,18,0,25,7
1668226836198,COGS 230,A00,101430,Klemmer; Scott R,12,0,17,5
1668226836623,COGS 234,A00,101431,Xia; Haijun,2,0,25,23
1668226837053,COGS 260,A00,101432,Kiyonaga; Anastasia,21,0,25,4
1668226837053,COGS 260,B00,101433,Kirsh; David Joel,15,0,25,10
1668226837485,CSE 202,A00,102371,Impagliazzo; Russell,0,0,0,0
1668226837908,CSE 203B,A01,102373,Cheng; Chung Kuan,0,0,0,0
1668226838339,CSE 208,A00,102374,Micciancio; Daniele,0,0,0,0
1668226838762,CSE 209A,A00,112895,Impagliazzo; Russell,0,0,15,15
1668226839207,CSE 209B,A00,108005,Bellare; Mihir,0,0,0,0
1668226839647,CSE 210,A00,113163,Coblenz; Michael J,0,0,0,0
1668226840073,CSE 219,A00,106111,Dow; Steven P,0,0,20,20
1668226840518,CSE 221,A00,102376,Voelker; Geoffrey M.,0,0,0,0
1668226840952,CSE 224,A01,102378,Porter; George M,0,0,0,0
1668226841375,CSE 229A,A00,102379,Savage; Stefan,0,0,0,0
1668226841799,CSE 229C,A00,102380,Munyaka; Imani N. S.,0,0,0,0
1668226842230,CSE 232B,A00,102382,Deutsch; Alin Bernard,0,0,0,0
1668226842661,CSE 234,A01,112904,Kumar; Arun Kumar,0,0,0,0
1668226843093,CSE 237A,A00,102383,Rosing; Tajana Simunic,0,0,0,0
1668226843519,CSE 239A,A00,102384,Deutsch; Alin Bernard,0,0,0,0
1668226843941,CSE 239B,A00,102385,Polikarpova; Nadezhda,0,0,0,0
1668226844365,CSE 240A,A00,102386,Pannuto; Patrick William,0,0,0,0
1668226844799,CSE 240B,A00,102387,Zhao; Jishen,0,0,0,0
1668226845225,CSE 241A,A00,106406,Kang; Mingu,0,0,0,0
1668226845649,CSE 249B,A00,102388,Kahng; Andrew Byun,0,0,8,8
1668226846074,CSE 251B,A01,102392,Cottrell; Garrison W,0,0,0,0
1668226846074,CSE 251B,A02,102393,Cottrell; Garrison W,0,0,0,0
1668226846505,CSE 252B,A00,102394,Ochoa; Benjamin Lawrence,0,0,0,0
1668226846940,CSE 257,A01,102396,Gao; Sicun,0,0,0,0
1668226847365,CSE 272,A00,102397,Li; Tzumao,0,0,0,0
1668226847792,CSE 274,A00,111323,Chern; Albert Ren-Haur,0,0,0,0
1668226848320,CSE 282,A00,102398,Pevzner; Pavel Arkadjevich,0,0,0,0
1668226848746,CSE 284,A00,114175,Gymrek; Melissa Ann,0,0,0,0
1668226849171,CSE 290,A00,102399,Chandraker; Manmohan Krishna,0,0,0,0
1668226849171,CSE 290,B00,102400,Vaccaro; Kristen Marie,0,0,25,25
1668226849171,CSE 290,C00,102414,Pannuto; Patrick William,0,0,25,25
1668226849171,CSE 290,D00,102427,Pevzner; Pavel Arkadjevich,0,0,0,0
1668226849171,CSE 290,E00,102429,Zhao; Jishen,0,0,0,0
1668226849171,CSE 290,F00,102436,Tullsen; Dean Michael,0,0,0,0
1668226849171,CSE 290,G00,102440,Christensen; Henrik I,0,0,20,20
1668226849594,CSE 291,A00,102443,Su; Hao,0,0,0,0
1668226849594,CSE 291,B00,102448,Polikarpova; Nadezhda,0,0,0,0
1668226849594,CSE 291,C00,102453,Vaccaro; Kristen Marie,0,0,0,0
1668226849594,CSE 291,D00,111343,Savage; Stefan,0,0,0,0
1668226849594,CSE 291,E00,116474,Claffy; Kimberly Claire,0,0,0,0
1668226849594,CSE 291,F00,116479,Pasquale; Joseph,0,0,0,0
1668226850030,CSE 293,001,119111,Bafna; Vineet,9999,0,9999,0
1668226850030,CSE 293,002,119118,Bellare; Mihir,9999,0,9999,0
1668226850030,CSE 293,003,119122,Berg-Kirkpatrick; Taylor D,9999,0,9999,0
1668226850030,CSE 293,004,119135,Christensen; Henrik I,9999,0,9999,0
1668226850030,CSE 293,005,119142,Cottrell; Garrison W,9999,0,9999,0
1668226850030,CSE 293,006,119146,Deutsch; Alin Bernard,9999,0,9999,0
1668226850030,CSE 293,007,119159,Esmaeilzadeh; Hadi,9999,0,9999,0
1668226850030,CSE 293,008,119166,Freund; Yoav,9999,0,9999,0
1668226850030,CSE 293,009,119170,Griswold; William G.,9999,0,9999,0
1668226850030,CSE 293,010,119183,Gymrek; Melissa Ann,9999,0,9999,0
1668226850030,CSE 293,011,119190,Heninger; Nadia A,9999,0,9999,0
1668226850030,CSE 293,012,119230,Impagliazzo; Russell,9999,0,9999,0
1668226850030,CSE 293,013,119232,Jhala; Ranjit,9999,0,9999,0
1668226850030,CSE 293,014,119233,Kahng; Andrew Byun,9999,0,9999,0
1668226850030,CSE 293,015,119298,Kane; Daniel Mertz,9999,0,9999,0
1668226850030,CSE 293,016,119299,Kriegman; David J,9999,0,9999,0
1668226850030,CSE 293,017,119300,Kumar; Arun Kumar,9999,0,9999,0
1668226850030,CSE 293,018,119301,Lerner; Sorin,9999,0,9999,0
1668226850030,CSE 293,019,119302,Lovett; Shachar,9999,0,9999,0
1668226850030,CSE 293,020,119303,McAuley; Julian John,9999,0,9999,0
1668226850030,CSE 293,021,119304,Micciancio; Daniele,9999,0,9999,0
1668226850030,CSE 293,022,119367,Orailoglu; Alex,9999,0,9999,0
1668226850030,CSE 293,023,119382,Paturi; Ramamohan,9999,0,9999,0
1668226850030,CSE 293,024,119404,Polikarpova; Nadezhda,9999,0,9999,0
1668226850030,CSE 293,025,119406,Politz; Joseph Gibbs,9999,0,9999,0
1668226850030,CSE 293,026,119411,Porter; George M,9999,0,9999,0
1668226850030,CSE 293,027,119414,Porter; Leonard Emerson,9999,0,9999,0
1668226850030,CSE 293,028,119416,Ramamoorthi; Ravi,9999,0,9999,0
1668226850030,CSE 293,029,119417,Sahoo; Debashis,9999,0,9999,0
1668226850030,CSE 293,030,119420,Saul; Lawrence,9999,0,9999,0
1668226850030,CSE 293,031,119421,Savage; Stefan,9999,0,9999,0
1668226850030,CSE 293,032,119425,Schulze; Jurgen P.,9999,0,9999,0
1668226850030,CSE 293,033,119426,Snoeren; Alex C.,9999,0,9999,0
1668226850030,CSE 293,034,119428,Shang; Jingbo,9999,0,9999,0
1668226850030,CSE 293,035,119430,Stefan; Deian,9999,0,9999,0
1668226850030,CSE 293,036,119431,Su; Hao,9999,0,9999,0
1668226850030,CSE 293,037,119433,Swanson; Steven James,9999,0,9999,0
1668226850030,CSE 293,038,119435,Tullsen; Dean Michael,9999,0,9999,0
1668226850030,CSE 293,039,119483,Voelker; Geoffrey M.,9999,0,9999,0
1668226850030,CSE 293,040,119537,Zhao; Jishen,9999,0,9999,0
1668226850030,CSE 293,041,119538,Zhou; Yuan-Yuan,9999,0,9999,0
1668226850030,CSE 293,042,119539,Gao; Sicun,9999,0,9999,0
1668226850030,CSE 293,043,119540,Weibel; Nadir,9999,0,9999,0
1668226850030,CSE 293,044,119541,Gupta; Rajesh K.,9999,0,9999,0
1668226850030,CSE 293,045,126410,Vaccaro; Kristen Marie,9999,0,9999,0
1668226850030,CSE 293,046,126411,Klemke; Richard,9999,0,9999,0
1668226850461,CSE 294,A00,102459,Voelker; Geoffrey M.,0,0,0,0
1668226850461,CSE 294,B00,111322,Orailoglu; Alex,0,0,0,0
1668226850886,DSE 201,A00,096914,Deutsch; Alin Bernard,30,0,30,0
1668226851310,DSE 210,A00,096915,Dasgupta; Sanjoy,30,0,30,0
1668226851734,DSE 260A,A00,096916,Altintas De Callaf; Ilkay,30,0,30,0
1668226852161,ECE 200,001,103586,Antipa; Nicholas A,9999,0,9999,0
1668226852161,ECE 200,002,103587,Atanasov; Nikolay A.,9999,0,9999,0
1668226852161,ECE 200,003,103588,Bharadia; Dinesh,9999,0,9999,0
1668226852161,ECE 200,004,103589,Cheng; Chung Kuan,9999,0,9999,0
1668226852161,ECE 200,005,103590,Cosman; Pamela C.,9999,0,9999,0
1668226852161,ECE 200,006,103591,Dayeh; Shadi Ahmad,9999,0,9999,0
1668226852161,ECE 200,007,103592,Fainman; Yeshaiahu,9999,0,9999,0
1668226852161,ECE 200,008,103593,Ford; Joseph Earl,9999,0,9999,0
1668226852161,ECE 200,009,103594,Franceschetti; Massimo,9999,0,9999,0
1668226852161,ECE 200,010,103595,Fullerton; Eric E,9999,0,9999,0
1668226852161,ECE 200,011,103596,Galton; Ian A,9999,0,9999,0
1668226852161,ECE 200,012,103597,Gilja; Vikash,9999,0,9999,0
1668226852161,ECE 200,013,103598,Hall; Drew A.,9999,0,9999,0
1668226852161,ECE 200,014,103599,Hsueh; Tzu-Chien,9999,0,9999,0
1668226852161,ECE 200,015,103600,Javidi; Tara,9999,0,9999,0
1668226852161,ECE 200,016,103601,Kahng; Andrew Byun,9999,0,9999,0
1668226852161,ECE 200,017,103602,Kim; Young-Han,9999,0,9999,0
1668226852161,ECE 200,018,103603,Koushanfar; Farinaz,9999,0,9999,0
1668226852161,ECE 200,019,103604,Kuzum; Duygu,9999,0,9999,0
1668226852161,ECE 200,020,103605,Le; Hanh-Phuc,9999,0,9999,0
1668226852161,ECE 200,021,103606,Lin; Bill,9999,0,9999,0
1668226852161,ECE 200,022,103607,Liu; Zhaowei,9998,0,9999,1
1668226852161,ECE 200,023,103608,Lo; Yu-Hwa,9999,0,9999,0
1668226852161,ECE 200,024,103609,Lomakin; Vitaliy,9999,0,9999,0
1668226852161,ECE 200,025,103610,Mercier; Patrick Philip,9999,0,9999,0
1668226852161,ECE 200,026,103611,Meyer; Florian,9999,0,9999,0
1668226852161,ECE 200,027,103612,Milstein; Laurence B.,9999,0,9999,0
1668226852161,ECE 200,028,103613,Mir Arabbaygi; Siavash,9999,0,9999,0
1668226852161,ECE 200,029,103614,Mookherjea; Shayan,9999,0,9999,0
1668226852161,ECE 200,030,103615,Morris; Karcher William,9999,0,9999,0
1668226852161,ECE 200,031,103616,Ng; Tse Nga,9999,0,9999,0
1668226852161,ECE 200,032,103617,Nguyen; Truong Quang,9999,0,9999,0
1668226852161,ECE 200,033,103618,Nomura; Kenji,9999,0,9999,0
1668226852161,ECE 200,034,103619,Orlitsky; Alon,9999,0,9999,0
1668226852161,ECE 200,035,103620,Pal; Piya,9999,0,9999,0
1668226852161,ECE 200,036,103621,Papen; George C.,9999,0,9999,0
1668226852161,ECE 200,037,103622,Radic; Stojan,9999,0,9999,0
1668226852161,ECE 200,038,103623,Rao; Bhaskar D.,9999,0,9999,0
1668226852161,ECE 200,039,103624,Rao; Ramesh R,9999,0,9999,0
1668226852161,ECE 200,040,103625,Rebeiz; Gabriel,9999,0,9999,0
1668226852161,ECE 200,041,103626,Sanford; John R,9999,0,9999,0
1668226852161,ECE 200,042,103627,Siegel; Paul H.,9999,0,9999,0
1668226852161,ECE 200,043,103628,Sievenpiper; Daniel F.,9999,0,9999,0
1668226852161,ECE 200,044,103629,Sworder; David D.,9999,0,9999,0
1668226852161,ECE 200,045,103630,Taur; Yuan,9999,0,9999,0
1668226852161,ECE 200,046,103631,Touri; Behrouz,9999,0,9999,0
1668226852161,ECE 200,047,103632,Trivedi; Mohan M.,9999,0,9999,0
1668226852161,ECE 200,048,103633,Vasconcelos; Nuno,9999,0,9999,0
1668226852161,ECE 200,049,103634,Wang; Xiaolong,9999,0,9999,0
1668226852161,ECE 200,050,103635,Xie; Pengtao,9999,0,9999,0
1668226852161,ECE 200,051,103636,Yip; Michael,9999,0,9999,0
1668226852161,ECE 200,052,103637,Zeger; Kenneth A.,999,0,999,0
1668226852161,ECE 200,053,103638,Zhang; Xinyu,9999,0,9999,0
1668226852161,ECE 200,054,103639,Turakhia; Yatish Girish,9999,0,9999,0
1668226852161,ECE 200,055,103640,Kang; Mingu,9999,0,9999,0
1668226852161,ECE 200,056,103641,Shi; Yuanyuan,9999,0,9999,0
1668226852161,ECE 200,057,103642,Wang; Edward Jay,9999,0,9999,0
1668226852161,ECE 200,058,103643,Zheng; Yang,9999,0,9999,0
1668226852584,ECE 202,A00,103644,Kuzum; Duygu,0,0,0,0
1668226853007,ECE 212BN,A00,103646,Ng; Tse Nga,0,0,0,0
1668226853431,ECE 221,A00,111493,Staff,0,0,0,0
1668226853862,ECE 222B,A00,103647,Lomakin; Vitaliy,0,0,0,0
1668226854286,ECE 230B,A00,103648,Taur; Yuan,0,0,0,0
1668226854718,ECE 238B,A00,103649,Garay; Javier,0,0,0,0
1668226855153,ECE 240B,A00,112900,Fainman; Yeshaiahu,0,0,0,0
1668226855578,ECE 247A,A00,103650,Jokerst; Jesse Vincent,0,0,0,0
1668226856000,ECE 247B,A00,103651,Wang; Joseph,0,0,0,0
1668226856424,ECE 250,A00,103652,Siegel; Paul H.,0,0,0,0
1668226856849,ECE 251A,A00,103654,Rao; Bhaskar D.,0,0,0,0
1668226857273,ECE 257B,A00,103655,Bharadia; Dinesh,0,0,0,0
1668226857696,ECE 258A,A00,103656,Milstein; Laurence B.,0,0,0,0
1668226858121,ECE 260B,A00,103658,Kang; Mingu,0,0,0,0
1668226858545,ECE 264A,A00,103659,Galton; Ian A,0,0,0,0
1668226858969,ECE 265A,A00,103661,Gudem; Prasad S.S.,0,0,0,0
1668226859391,ECE 265D,A00,103662,Gudem; Prasad S.S.,0,0,0,0
1668226859814,ECE 268,A00,103663,Koushanfar; Farinaz,0,0,0,0
1668226860239,ECE 269,A01,103665,Pal; Piya,0,0,0,0
1668226860661,ECE 271B,A00,103666,Vasconcelos; Manuela,0,0,0,0
1668226861084,ECE 276A,A00,103667,Atanasov; Nikolay A.,0,0,0,0
1668226861517,ECE 277,A00,103668,An; Cheolhong,0,0,0,0
1668226861939,ECE 279,A00,117947,Hall; Drew A.,0,0,0,0
1668226862800,ECE 283,A00,103670,Hsueh; Tzu-Chien,0,0,0,0
1668226863223,ECE 284,A00,103671,Turakhia; Yatish Girish,0,0,0,0
1668226863651,ECE 285,A00,103672,Zheng; Yang,0,0,0,0
1668226863651,ECE 285,B00,103673,Sworder; David D.,0,0,0,0
1668226864074,ECE 287,A00,103676,Javidi; Tara,0,0,0,0
1668226864499,MATH 200B,A00,098023,Salehi Golsefidy; Alireza,12,0,15,3
1668226864921,MATH 202B,A00,098024,Rhoades; Brendon Patrick,9,0,15,6
1668226865347,MATH 203B,A00,098025,Oprea; Dragos N.,10,0,15,5
1668226865770,MATH 204B,A00,098026,Sorensen; Claus M,13,0,15,2
1668226866194,MATH 208,A00,098027,Izadi; Elham,7,0,10,3
1668226866618,MATH 209,A00,098028,Pollack; Aaron,10,0,10,0
1668226867043,MATH 211A,A00,112919,Rogalski; Daniel,9,0,10,1
1668226867481,MATH 211B,A00,112920,Seward; Brandon M.,9,0,10,1
1668226867907,MATH 218,A00,098029,Li; Bo,10,0,10,0
1668226868341,MATH 220B,A00,098030,Novak; Jonathan I,11,0,15,4
1668226868768,MATH 221A,A00,098031,Ebenfelt; Peter F,13,0,15,2
1668226869192,MATH 231B,A00,098032,Zlatos; Andrej,12,0,15,3
1668226869617,MATH 240B,A00,098033,Ni; Lei,9,0,15,6
1668226870044,MATH 243,A00,098034,Jekel; David Andrew,10,0,10,0
1668226870471,MATH 245A,A00,098035,Nie; Jiawang,0,0,15,16
1668226870894,MATH 248,A00,098036,Bejenaru; Ioan,10,0,10,0
1668226871318,MATH 250B,A00,098037,Spolaor; Luca,14,0,15,1
1668226871740,MATH 258,A00,098038,Ni; Lei,10,0,10,0
1668226872164,MATH 264B,A00,098041,Rhoades; Brendon Patrick,9,0,15,6
1668226872593,MATH 268,A00,098042,Buss; Samuel R,10,0,10,0
1668226873016,MATH 269,A00,098043,Rhoades; Brendon Patrick,10,0,10,0
1668226873439,MATH 270B,A00,098044,Li; Bo,10,0,15,5
1668226873867,MATH 272B,A00,098045,Holst; Michael J,13,0,15,2
1668226874289,MATH 273A,A00,098046,Tian; Xiaochuan,10,0,15,5
1668226874725,MATH 275,A01,098048,Tian; Xiaochuan,6,0,10,4
1668226875148,MATH 278A,A00,098049,Holst; Michael J,8,0,10,2
1668226875571,MATH 278B,A00,098050,Cloninger; Alexander,10,0,10,0
1668226875996,MATH 278C,A00,098051,Nie; Jiawang,7,0,10,3
1668226876424,MATH 280B,A00,098052,Zheng; Tianyi,10,0,15,5
1668226876853,MATH 281B,A00,098053,Bradic; Jelena,2,0,15,13
1668226877278,MATH 282B,A00,098054,Arias-Castro; Ery,0,0,15,15
1668226877705,MATH 285,A00,098055,Fitzsimmons; Patrick J,0,0,15,17
1668226878127,MATH 287B,A00,098056,Arias-Castro; Ery,2,0,15,13
1668226878552,MATH 288,A00,098057,Agarwal; Pooja,9,0,10,1
1668226878552,MATH 288,B00,098058,Zhang; Danna,8,0,10,2
1668226878552,MATH 288,C00,098059,Williams; Ruth J,10,0,10,0
1668226878979,MATH 290B,A00,098060,Roberts; Justin Deritter,13,0,15,2
1668226879401,MATH 292,A00,098061,Belmont; Eva Kinoshita,10,0,10,0
1668226879827,MATH 295,A00,098062,Suk; Andrew Hoon,48,0,50,2
1668226880258,MATH 296,A00,098063,Novak; Jonathan I,20,0,20,0
1668226880688,MATH 297,001,098064,Gamst; Anthony Collins,9997,0,9999,2
1668227381178,COGS 205,A00,101395,Chiba; Andrea,19,0,20,1
1668227381602,COGS 210B,001,101404,Greene; Deanna Jacquelyn,9998,0,9999,1
1668227381602,COGS 210B,002,101417,Xia; Haijun,9999,0,9999,0
1668227381602,COGS 210B,003,101422,Nitz; Douglas A.,9999,0,9999,0
1668227381602,COGS 210B,004,101423,Hollan; James D.,9998,0,9999,1
1668227381602,COGS 210B,005,101424,Deak; Gedeon O.,9998,0,9999,1
1668227381602,COGS 210B,006,101425,Rossano; Federico,9999,0,9999,0
1668227382027,COGS 211B,A00,101427,Coulson; Seana M,9996,0,9999,3
1668227382450,COGS 220,A00,101428,Hollan; James D.,0,0,25,25
1668227382872,COGS 229,A00,101429,Dow; Steven P,18,0,25,7
1668227383297,COGS 230,A00,101430,Klemmer; Scott R,12,0,17,5
1668227383721,COGS 234,A00,101431,Xia; Haijun,2,0,25,23
1668227384144,COGS 260,A00,101432,Kiyonaga; Anastasia,21,0,25,4
1668227384144,COGS 260,B00,101433,Kirsh; David Joel,15,0,25,10
1668227384569,CSE 202,A00,102371,Impagliazzo; Russell,0,0,0,0
1668227384995,CSE 203B,A01,102373,Cheng; Chung Kuan,0,0,0,0
1668227385423,CSE 208,A00,102374,Micciancio; Daniele,0,0,0,0
1668227385849,CSE 209A,A00,112895,Impagliazzo; Russell,0,0,15,15
1668227386273,CSE 209B,A00,108005,Bellare; Mihir,0,0,0,0
1668227386697,CSE 210,A00,113163,Coblenz; Michael J,0,0,0,0
1668227387122,CSE 219,A00,106111,Dow; Steven P,0,0,20,20
1668227387545,CSE 221,A00,102376,Voelker; Geoffrey M.,0,0,0,0
1668227387968,CSE 224,A01,102378,Porter; George M,0,0,0,0
1668227388393,CSE 229A,A00,102379,Savage; Stefan,0,0,0,0
1668227388814,CSE 229C,A00,102380,Munyaka; Imani N. S.,0,0,0,0
1668227389237,CSE 232B,A00,102382,Deutsch; Alin Bernard,0,0,0,0
1668227389659,CSE 234,A01,112904,Kumar; Arun Kumar,0,0,0,0
1668227390085,CSE 237A,A00,102383,Rosing; Tajana Simunic,0,0,0,0
1668227390507,CSE 239A,A00,102384,Deutsch; Alin Bernard,0,0,0,0
1668227390934,CSE 239B,A00,102385,Polikarpova; Nadezhda,0,0,0,0
1668227391360,CSE 240A,A00,102386,Pannuto; Patrick William,0,0,0,0
1668227391789,CSE 240B,A00,102387,Zhao; Jishen,0,0,0,0
1668227392213,CSE 241A,A00,106406,Kang; Mingu,0,0,0,0
1668227392635,CSE 249B,A00,102388,Kahng; Andrew Byun,0,0,8,8
1668227393061,CSE 251B,A01,102392,Cottrell; Garrison W,0,0,0,0
1668227393061,CSE 251B,A02,102393,Cottrell; Garrison W,0,0,0,0
1668227393484,CSE 252B,A00,102394,Ochoa; Benjamin Lawrence,0,0,0,0
1668227393918,CSE 257,A01,102396,Gao; Sicun,0,0,0,0
1668227394351,CSE 272,A00,102397,Li; Tzumao,0,0,0,0
1668227394786,CSE 274,A00,111323,Chern; Albert Ren-Haur,0,0,0,0
1668227395223,CSE 282,A00,102398,Pevzner; Pavel Arkadjevich,0,0,0,0
1668227395653,CSE 284,A00,114175,Gymrek; Melissa Ann,0,0,0,0
1668227396087,CSE 290,A00,102399,Chandraker; Manmohan Krishna,0,0,0,0
1668227396087,CSE 290,B00,102400,Vaccaro; Kristen Marie,0,0,25,25
1668227396087,CSE 290,C00,102414,Pannuto; Patrick William,0,0,25,25
1668227396087,CSE 290,D00,102427,Pevzner; Pavel Arkadjevich,0,0,0,0
1668227396087,CSE 290,E00,102429,Zhao; Jishen,0,0,0,0
1668227396087,CSE 290,F00,102436,Tullsen; Dean Michael,0,0,0,0
1668227396087,CSE 290,G00,102440,Christensen; Henrik I,0,0,20,20
1668227396513,CSE 291,A00,102443,Su; Hao,0,0,0,0
1668227396513,CSE 291,B00,102448,Polikarpova; Nadezhda,0,0,0,0
1668227396513,CSE 291,C00,102453,Vaccaro; Kristen Marie,0,0,0,0
1668227396513,CSE 291,D00,111343,Savage; Stefan,0,0,0,0
1668227396513,CSE 291,E00,116474,Claffy; Kimberly Claire,0,0,0,0
1668227396513,CSE 291,F00,116479,Pasquale; Joseph,0,0,0,0
1668227396947,CSE 293,001,119111,Bafna; Vineet,9999,0,9999,0
1668227396947,CSE 293,002,119118,Bellare; Mihir,9999,0,9999,0
1668227396947,CSE 293,003,119122,Berg-Kirkpatrick; Taylor D,9999,0,9999,0
1668227396947,CSE 293,004,119135,Christensen; Henrik I,9999,0,9999,0
1668227396947,CSE 293,005,119142,Cottrell; Garrison W,9999,0,9999,0
1668227396947,CSE 293,006,119146,Deutsch; Alin Bernard,9999,0,9999,0
1668227396947,CSE 293,007,119159,Esmaeilzadeh; Hadi,9999,0,9999,0
1668227396947,CSE 293,008,119166,Freund; Yoav,9999,0,9999,0
1668227396947,CSE 293,009,119170,Griswold; William G.,9999,0,9999,0
1668227396947,CSE 293,010,119183,Gymrek; Melissa Ann,9999,0,9999,0
1668227396947,CSE 293,011,119190,Heninger; Nadia A,9999,0,9999,0
1668227396947,CSE 293,012,119230,Impagliazzo; Russell,9999,0,9999,0
1668227396947,CSE 293,013,119232,Jhala; Ranjit,9999,0,9999,0
1668227396947,CSE 293,014,119233,Kahng; Andrew Byun,9999,0,9999,0
1668227396947,CSE 293,015,119298,Kane; Daniel Mertz,9999,0,9999,0
1668227396947,CSE 293,016,119299,Kriegman; David J,9999,0,9999,0
1668227396947,CSE 293,017,119300,Kumar; Arun Kumar,9999,0,9999,0
1668227396947,CSE 293,018,119301,Lerner; Sorin,9999,0,9999,0
1668227396947,CSE 293,019,119302,Lovett; Shachar,9999,0,9999,0
1668227396947,CSE 293,020,119303,McAuley; Julian John,9999,0,9999,0
1668227396947,CSE 293,021,119304,Micciancio; Daniele,9999,0,9999,0
1668227396947,CSE 293,022,119367,Orailoglu; Alex,9999,0,9999,0
1668227396947,CSE 293,023,119382,Paturi; Ramamohan,9999,0,9999,0
1668227396947,CSE 293,024,119404,Polikarpova; Nadezhda,9999,0,9999,0
1668227396947,CSE 293,025,119406,Politz; Joseph Gibbs,9999,0,9999,0
1668227396947,CSE 293,026,119411,Porter; George M,9999,0,9999,0
1668227396947,CSE 293,027,119414,Porter; Leonard Emerson,9999,0,9999,0
1668227396947,CSE 293,028,119416,Ramamoorthi; Ravi,9999,0,9999,0
1668227396947,CSE 293,029,119417,Sahoo; Debashis,9999,0,9999,0
1668227396947,CSE 293,030,119420,Saul; Lawrence,9999,0,9999,0
1668227396947,CSE 293,031,119421,Savage; Stefan,9999,0,9999,0
1668227396947,CSE 293,032,119425,Schulze; Jurgen P.,9999,0,9999,0
1668227396947,CSE 293,033,119426,Snoeren; Alex C.,9999,0,9999,0
1668227396947,CSE 293,034,119428,Shang; Jingbo,9999,0,9999,0
1668227396947,CSE 293,035,119430,Stefan; Deian,9999,0,9999,0
1668227396947,CSE 293,036,119431,Su; Hao,9999,0,9999,0
1668227396947,CSE 293,037,119433,Swanson; Steven James,9999,0,9999,0
1668227396947,CSE 293,038,119435,Tullsen; Dean Michael,9999,0,9999,0
1668227396947,CSE 293,039,119483,Voelker; Geoffrey M.,9999,0,9999,0
1668227396947,CSE 293,040,119537,Zhao; Jishen,9999,0,9999,0
1668227396947,CSE 293,041,119538,Zhou; Yuan-Yuan,9999,0,9999,0
1668227396947,CSE 293,042,119539,Gao; Sicun,9999,0,9999,0
1668227396947,CSE 293,043,119540,Weibel; Nadir,9999,0,9999,0
1668227396947,CSE 293,044,119541,Gupta; Rajesh K.,9999,0,9999,0
1668227396947,CSE 293,045,126410,Vaccaro; Kristen Marie,9999,0,9999,0
1668227396947,CSE 293,046,126411,Klemke; Richard,9999,0,9999,0
1668227397379,CSE 294,A00,102459,Voelker; Geoffrey M.,0,0,0,0
1668227397379,CSE 294,B00,111322,Orailoglu; Alex,0,0,0,0
1668227397805,DSE 201,A00,096914,Deutsch; Alin Bernard,30,0,30,0
1668227398231,DSE 210,A00,096915,Dasgupta; Sanjoy,30,0,30,0
1668227398670,DSE 260A,A00,096916,Altintas De Callaf; Ilkay,30,0,30,0
1668227399125,ECE 200,001,103586,Antipa; Nicholas A,9999,0,9999,0
1668227399125,ECE 200,002,103587,Atanasov; Nikolay A.,9999,0,9999,0
1668227399125,ECE 200,003,103588,Bharadia; Dinesh,9999,0,9999,0
1668227399125,ECE 200,004,103589,Cheng; Chung Kuan,9999,0,9999,0
1668227399125,ECE 200,005,103590,Cosman; Pamela C.,9999,0,9999,0
1668227399125,ECE 200,006,103591,Dayeh; Shadi Ahmad,9999,0,9999,0
1668227399125,ECE 200,007,103592,Fainman; Yeshaiahu,9999,0,9999,0
1668227399125,ECE 200,008,103593,Ford; Joseph Earl,9999,0,9999,0
1668227399125,ECE 200,009,103594,Franceschetti; Massimo,9999,0,9999,0
1668227399125,ECE 200,010,103595,Fullerton; Eric E,9999,0,9999,0
1668227399125,ECE 200,011,103596,Galton; Ian A,9999,0,9999,0
1668227399125,ECE 200,012,103597,Gilja; Vikash,9999,0,9999,0
1668227399125,ECE 200,013,103598,Hall; Drew A.,9999,0,9999,0
1668227399125,ECE 200,014,103599,Hsueh; Tzu-Chien,9999,0,9999,0
1668227399125,ECE 200,015,103600,Javidi; Tara,9999,0,9999,0
1668227399125,ECE 200,016,103601,Kahng; Andrew Byun,9999,0,9999,0
1668227399125,ECE 200,017,103602,Kim; Young-Han,9999,0,9999,0
1668227399125,ECE 200,018,103603,Koushanfar; Farinaz,9999,0,9999,0
1668227399125,ECE 200,019,103604,Kuzum; Duygu,9999,0,9999,0
1668227399125,ECE 200,020,103605,Le; Hanh-Phuc,9999,0,9999,0
1668227399125,ECE 200,021,103606,Lin; Bill,9999,0,9999,0
1668227399125,ECE 200,022,103607,Liu; Zhaowei,9998,0,9999,1
1668227399125,ECE 200,023,103608,Lo; Yu-Hwa,9999,0,9999,0
1668227399125,ECE 200,024,103609,Lomakin; Vitaliy,9999,0,9999,0
1668227399125,ECE 200,025,103610,Mercier; Patrick Philip,9999,0,9999,0
1668227399125,ECE 200,026,103611,Meyer; Florian,9999,0,9999,0
1668227399125,ECE 200,027,103612,Milstein; Laurence B.,9999,0,9999,0
1668227399125,ECE 200,028,103613,Mir Arabbaygi; Siavash,9999,0,9999,0
1668227399125,ECE 200,029,103614,Mookherjea; Shayan,9999,0,9999,0
1668227399125,ECE 200,030,103615,Morris; Karcher William,9999,0,9999,0
1668227399125,ECE 200,031,103616,Ng; Tse Nga,9999,0,9999,0
1668227399125,ECE 200,032,103617,Nguyen; Truong Quang,9999,0,9999,0
1668227399125,ECE 200,033,103618,Nomura; Kenji,9999,0,9999,0
1668227399125,ECE 200,034,103619,Orlitsky; Alon,9999,0,9999,0
1668227399125,ECE 200,035,103620,Pal; Piya,9999,0,9999,0
1668227399125,ECE 200,036,103621,Papen; George C.,9999,0,9999,0
1668227399125,ECE 200,037,103622,Radic; Stojan,9999,0,9999,0
1668227399125,ECE 200,038,103623,Rao; Bhaskar D.,9999,0,9999,0
1668227399125,ECE 200,039,103624,Rao; Ramesh R,9999,0,9999,0
1668227399125,ECE 200,040,103625,Rebeiz; Gabriel,9999,0,9999,0
1668227399125,ECE 200,041,103626,Sanford; John R,9999,0,9999,0
1668227399125,ECE 200,042,103627,Siegel; Paul H.,9999,0,9999,0
1668227399125,ECE 200,043,103628,Sievenpiper; Daniel F.,9999,0,9999,0
1668227399125,ECE 200,044,103629,Sworder; David D.,9999,0,9999,0
1668227399125,ECE 200,045,103630,Taur; Yuan,9999,0,9999,0
1668227399125,ECE 200,046,103631,Touri; Behrouz,9999,0,9999,0
1668227399125,ECE 200,047,103632,Trivedi; Mohan M.,9999,0,9999,0
1668227399125,ECE 200,048,103633,Vasconcelos; Nuno,9999,0,9999,0
1668227399125,ECE 200,049,103634,Wang; Xiaolong,9999,0,9999,0
1668227399125,ECE 200,050,103635,Xie; Pengtao,9999,0,9999,0
1668227399125,ECE 200,051,103636,Yip; Michael,9999,0,9999,0
1668227399125,ECE 200,052,103637,Zeger; Kenneth A.,999,0,999,0
1668227399125,ECE 200,053,103638,Zhang; Xinyu,9999,0,9999,0
1668227399125,ECE 200,054,103639,Turakhia; Yatish Girish,9999,0,9999,0
1668227399125,ECE 200,055,103640,Kang; Mingu,9999,0,9999,0
1668227399125,ECE 200,056,103641,Shi; Yuanyuan,9999,0,9999,0
1668227399125,ECE 200,057,103642,Wang; Edward Jay,9999,0,9999,0
1668227399125,ECE 200,058,103643,Zheng; Yang,9999,0,9999,0
1668227399548,ECE 202,A00,103644,Kuzum; Duygu,0,0,0,0
1668227399985,ECE 212BN,A00,103646,Ng; Tse Nga,0,0,0,0
1668227400441,ECE 221,A00,111493,Staff,0,0,0,0
1668227400865,ECE 222B,A00,103647,Lomakin; Vitaliy,0,0,0,0
1668227401286,ECE 230B,A00,103648,Taur; Yuan,0,0,0,0
1668227401710,ECE 238B,A00,103649,Garay; Javier,0,0,0,0
1668227402137,ECE 240B,A00,112900,Fainman; Yeshaiahu,0,0,0,0
1668227402574,ECE 247A,A00,103650,Jokerst; Jesse Vincent,0,0,0,0
1668227402999,ECE 247B,A00,103651,Wang; Joseph,0,0,0,0
1668227403420,ECE 250,A00,103652,Siegel; Paul H.,0,0,0,0
1668227403847,ECE 251A,A00,103654,Rao; Bhaskar D.,0,0,0,0
1668227404271,ECE 257B,A00,103655,Bharadia; Dinesh,0,0,0,0
1668227404694,ECE 258A,A00,103656,Milstein; Laurence B.,0,0,0,0
1668227405119,ECE 260B,A00,103658,Kang; Mingu,0,0,0,0
1668227405545,ECE 264A,A00,103659,Galton; Ian A,0,0,0,0
1668227405967,ECE 265A,A00,103661,Gudem; Prasad S.S.,0,0,0,0
1668227406391,ECE 265D,A00,103662,Gudem; Prasad S.S.,0,0,0,0
1668227406815,ECE 268,A00,103663,Koushanfar; Farinaz,0,0,0,0
1668227407244,ECE 269,A01,103665,Pal; Piya,0,0,0,0
1668227407679,ECE 271B,A00,103666,Vasconcelos; Manuela,0,0,0,0
1668227408109,ECE 276A,A00,103667,Atanasov; Nikolay A.,0,0,0,0
1668227408534,ECE 277,A00,103668,An; Cheolhong,0,0,0,0
1668227408956,ECE 279,A00,117947,Hall; Drew A.,0,0,0,0
1668227409804,ECE 283,A00,103670,Hsueh; Tzu-Chien,0,0,0,0
1668227410226,ECE 284,A00,103671,Turakhia; Yatish Girish,0,0,0,0
1668227410652,ECE 285,A00,103672,Zheng; Yang,0,0,0,0
1668227410652,ECE 285,B00,103673,Sworder; David D.,0,0,0,0
1668227411086,ECE 287,A00,103676,Javidi; Tara,0,0,0,0
1668227411509,MATH 200B,A00,098023,Salehi Golsefidy; Alireza,12,0,15,3
1668227412042,MATH 202B,A00,098024,Rhoades; Brendon Patrick,9,0,15,6
1668227412483,MATH 203B,A00,098025,Oprea; Dragos N.,10,0,15,5
1668227412907,MATH 204B,A00,098026,Sorensen; Claus M,13,0,15,2
1668227413334,MATH 208,A00,098027,Izadi; Elham,7,0,10,3
1668227413757,MATH 209,A00,098028,Pollack; Aaron,10,0,10,0
1668227414183,MATH 211A,A00,112919,Rogalski; Daniel,9,0,10,1
1668227414607,MATH 211B,A00,112920,Seward; Brandon M.,9,0,10,1
1668227415034,MATH 218,A00,098029,Li; Bo,10,0,10,0
1668227415458,MATH 220B,A00,098030,Novak; Jonathan I,11,0,15,4
1668227415882,MATH 221A,A00,098031,Ebenfelt; Peter F,13,0,15,2
1668227416304,MATH 231B,A00,098032,Zlatos; Andrej,12,0,15,3
1668227416733,MATH 240B,A00,098033,Ni; Lei,9,0,15,6
1668227417164,MATH 243,A00,098034,Jekel; David Andrew,10,0,10,0
1668227417592,MATH 245A,A00,098035,Nie; Jiawang,0,0,15,16
1668227418016,MATH 248,A00,098036,Bejenaru; Ioan,10,0,10,0
1668227418441,MATH 250B,A00,098037,Spolaor; Luca,14,0,15,1
1668227418882,MATH 258,A00,098038,Ni; Lei,10,0,10,0
1668227419306,MATH 264B,A00,098041,Rhoades; Brendon Patrick,9,0,15,6
1668227419730,MATH 268,A00,098042,Buss; Samuel R,10,0,10,0
1668227420152,MATH 269,A00,098043,Rhoades; Brendon Patrick,10,0,10,0
1668227420582,MATH 270B,A00,098044,Li; Bo,10,0,15,5
1668227421010,MATH 272B,A00,098045,Holst; Michael J,13,0,15,2
1668227421435,MATH 273A,A00,098046,Tian; Xiaochuan,10,0,15,5
1668227421858,MATH 275,A01,098048,Tian; Xiaochuan,6,0,10,4
1668227422283,MATH 278A,A00,098049,Holst; Michael J,8,0,10,2
1668227422716,MATH 278B,A00,098050,Cloninger; Alexander,10,0,10,0
1668227423145,MATH 278C,A00,098051,Nie; Jiawang,7,0,10,3
1668227423576,MATH 280B,A00,098052,Zheng; Tianyi,10,0,15,5
1668227424001,MATH 281B,A00,098053,Bradic; Jelena,2,0,15,13
1668227424444,MATH 282B,A00,098054,Arias-Castro; Ery,0,0,15,15
1668227424868,MATH 285,A00,098055,Fitzsimmons; Patrick J,0,0,15,17
1668227425291,MATH 287B,A00,098056,Arias-Castro; Ery,2,0,15,13
1668227425717,MATH 288,A00,098057,Agarwal; Pooja,9,0,10,1
1668227425717,MATH 288,B00,098058,Zhang; Danna,8,0,10,2
1668227425717,MATH 288,C00,098059,Williams; Ruth J,10,0,10,0
1668227426148,MATH 290B,A00,098060,Roberts; Justin Deritter,13,0,15,2
1668227426574,MATH 292,A00,098061,Belmont; Eva Kinoshita,10,0,10,0
1668227427001,MATH 295,A00,098062,Suk; Andrew Hoon,48,0,50,2
1668227427426,MATH 296,A00,098063,Novak; Jonathan I,20,0,20,0
1668227427850,MATH 297,001,098064,Gamst; Anthony Collins,9997,0,9999,2
1668227928574,COGS 205,A00,101395,Chiba; Andrea,19,0,20,1
1668227928997,COGS 210B,001,101404,Greene; Deanna Jacquelyn,9998,0,9999,1
1668227928997,COGS 210B,002,101417,Xia; Haijun,9999,0,9999,0
1668227928997,COGS 210B,003,101422,Nitz; Douglas A.,9999,0,9999,0
1668227928997,COGS 210B,004,101423,Hollan; James D.,9998,0,9999,1
1668227928997,COGS 210B,005,101424,Deak; Gedeon O.,9998,0,9999,1
1668227928997,COGS 210B,006,101425,Rossano; Federico,9999,0,9999,0
1668227929422,COGS 211B,A00,101427,Coulson; Seana M,9996,0,9999,3
1668227929845,COGS 220,A00,101428,Hollan; James D.,0,0,25,25
1668227930268,COGS 229,A00,101429,Dow; Steven P,18,0,25,7
1668227930694,COGS 230,A00,101430,Klemmer; Scott R,12,0,17,5
1668227931117,COGS 234,A00,101431,Xia; Haijun,2,0,25,23
1668227931542,COGS 260,A00,101432,Kiyonaga; Anastasia,21,0,25,4
1668227931542,COGS 260,B00,101433,Kirsh; David Joel,15,0,25,10
1668227931976,CSE 202,A00,102371,Impagliazzo; Russell,0,0,0,0
1668227932404,CSE 203B,A01,102373,Cheng; Chung Kuan,0,0,0,0
1668227932930,CSE 208,A00,102374,Micciancio; Daniele,0,0,0,0
1668227933353,CSE 209A,A00,112895,Impagliazzo; Russell,0,0,15,15
1668227933782,CSE 209B,A00,108005,Bellare; Mihir,0,0,0,0
1668227934205,CSE 210,A00,113163,Coblenz; Michael J,0,0,0,0
1668227934627,CSE 219,A00,106111,Dow; Steven P,0,0,20,20
1668227935049,CSE 221,A00,102376,Voelker; Geoffrey M.,0,0,0,0
1668227935473,CSE 224,A01,102378,Porter; George M,0,0,0,0
1668227935900,CSE 229A,A00,102379,Savage; Stefan,0,0,0,0
1668227936326,CSE 229C,A00,102380,Munyaka; Imani N. S.,0,0,0,0
1668227936749,CSE 232B,A00,102382,Deutsch; Alin Bernard,0,0,0,0
1668227937173,CSE 234,A01,112904,Kumar; Arun Kumar,0,0,0,0
1668227937597,CSE 237A,A00,102383,Rosing; Tajana Simunic,0,0,0,0
1668227938019,CSE 239A,A00,102384,Deutsch; Alin Bernard,0,0,0,0
1668227938442,CSE 239B,A00,102385,Polikarpova; Nadezhda,0,0,0,0
1668227938869,CSE 240A,A00,102386,Pannuto; Patrick William,0,0,0,0
1668227939309,CSE 240B,A00,102387,Zhao; Jishen,0,0,0,0
1668227939738,CSE 241A,A00,106406,Kang; Mingu,0,0,0,0
1668227940161,CSE 249B,A00,102388,Kahng; Andrew Byun,0,0,8,8
1668227940583,CSE 251B,A01,102392,Cottrell; Garrison W,0,0,0,0
1668227940583,CSE 251B,A02,102393,Cottrell; Garrison W,0,0,0,0
1668227941008,CSE 252B,A00,102394,Ochoa; Benjamin Lawrence,0,0,0,0
1668227941435,CSE 257,A01,102396,Gao; Sicun,0,0,0,0
1668227941861,CSE 272,A00,102397,Li; Tzumao,0,0,0,0
1668227942283,CSE 274,A00,111323,Chern; Albert Ren-Haur,0,0,0,0
1668227942709,CSE 282,A00,102398,Pevzner; Pavel Arkadjevich,0,0,0,0
1668227943133,CSE 284,A00,114175,Gymrek; Melissa Ann,0,0,0,0
1668227943559,CSE 290,A00,102399,Chandraker; Manmohan Krishna,0,0,0,0
1668227943559,CSE 290,B00,102400,Vaccaro; Kristen Marie,0,0,25,25
1668227943559,CSE 290,C00,102414,Pannuto; Patrick William,0,0,25,25
1668227943559,CSE 290,D00,102427,Pevzner; Pavel Arkadjevich,0,0,0,0
1668227943559,CSE 290,E00,102429,Zhao; Jishen,0,0,0,0
1668227943559,CSE 290,F00,102436,Tullsen; Dean Michael,0,0,0,0
1668227943559,CSE 290,G00,102440,Christensen; Henrik I,0,0,20,20
1668227943984,CSE 291,A00,102443,Su; Hao,0,0,0,0
1668227943984,CSE 291,B00,102448,Polikarpova; Nadezhda,0,0,0,0
1668227943984,CSE 291,C00,102453,Vaccaro; Kristen Marie,0,0,0,0
1668227943984,CSE 291,D00,111343,Savage; Stefan,0,0,0,0
1668227943984,CSE 291,E00,116474,Claffy; Kimberly Claire,0,0,0,0
1668227943984,CSE 291,F00,116479,Pasquale; Joseph,0,0,0,0
1668227944417,CSE 293,001,119111,Bafna; Vineet,9999,0,9999,0
1668227944417,CSE 293,002,119118,Bellare; Mihir,9999,0,9999,0
1668227944417,CSE 293,003,119122,Berg-Kirkpatrick; Taylor D,9999,0,9999,0
1668227944417,CSE 293,004,119135,Christensen; Henrik I,9999,0,9999,0
1668227944417,CSE 293,005,119142,Cottrell; Garrison W,9999,0,9999,0
1668227944417,CSE 293,006,119146,Deutsch; Alin Bernard,9999,0,9999,0
1668227944417,CSE 293,007,119159,Esmaeilzadeh; Hadi,9999,0,9999,0
1668227944417,CSE 293,008,119166,Freund; Yoav,9999,0,9999,0
1668227944417,CSE 293,009,119170,Griswold; William G.,9999,0,9999,0
1668227944417,CSE 293,010,119183,Gymrek; Melissa Ann,9999,0,9999,0
1668227944417,CSE 293,011,119190,Heninger; Nadia A,9999,0,9999,0
1668227944417,CSE 293,012,119230,Impagliazzo; Russell,9999,0,9999,0
1668227944417,CSE 293,013,119232,Jhala; Ranjit,9999,0,9999,0
1668227944417,CSE 293,014,119233,Kahng; Andrew Byun,9999,0,9999,0
1668227944417,CSE 293,015,119298,Kane; Daniel Mertz,9999,0,9999,0
1668227944417,CSE 293,016,119299,Kriegman; David J,9999,0,9999,0
1668227944417,CSE 293,017,119300,Kumar; Arun Kumar,9999,0,9999,0
1668227944417,CSE 293,018,119301,Lerner; Sorin,9999,0,9999,0
1668227944417,CSE 293,019,119302,Lovett; Shachar,9999,0,9999,0
1668227944417,CSE 293,020,119303,McAuley; Julian John,9999,0,9999,0
1668227944417,CSE 293,021,119304,Micciancio; Daniele,9999,0,9999,0
1668227944417,CSE 293,022,119367,Orailoglu; Alex,9999,0,9999,0
1668227944417,CSE 293,023,119382,Paturi; Ramamohan,9999,0,9999,0
1668227944417,CSE 293,024,119404,Polikarpova; Nadezhda,9999,0,9999,0
1668227944417,CSE 293,025,119406,Politz; Joseph Gibbs,9999,0,9999,0
1668227944417,CSE 293,026,119411,Porter; George M,9999,0,9999,0
1668227944417,CSE 293,027,119414,Porter; Leonard Emerson,9999,0,9999,0
1668227944417,CSE 293,028,119416,Ramamoorthi; Ravi,9999,0,9999,0
1668227944417,CSE 293,029,119417,Sahoo; Debashis,9999,0,9999,0
1668227944417,CSE 293,030,119420,Saul; Lawrence,9999,0,9999,0
1668227944417,CSE 293,031,119421,Savage; Stefan,9999,0,9999,0
1668227944417,CSE 293,032,119425,Schulze; Jurgen P.,9999,0,9999,0
1668227944417,CSE 293,033,119426,Snoeren; Alex C.,9999,0,9999,0
1668227944417,CSE 293,034,119428,Shang; Jingbo,9999,0,9999,0
1668227944417,CSE 293,035,119430,Stefan; Deian,9999,0,9999,0
1668227944417,CSE 293,036,119431,Su; Hao,9999,0,9999,0
1668227944417,CSE 293,037,119433,Swanson; Steven James,9999,0,9999,0
1668227944417,CSE 293,038,119435,Tullsen; Dean Michael,9999,0,9999,0
1668227944417,CSE 293,039,119483,Voelker; Geoffrey M.,9999,0,9999,0
1668227944417,CSE 293,040,119537,Zhao; Jishen,9999,0,9999,0
1668227944417,CSE 293,041,119538,Zhou; Yuan-Yuan,9999,0,9999,0
1668227944417,CSE 293,042,119539,Gao; Sicun,9999,0,9999,0
1668227944417,CSE 293,043,119540,Weibel; Nadir,9999,0,9999,0
1668227944417,CSE 293,044,119541,Gupta; Rajesh K.,9999,0,9999,0
1668227944417,CSE 293,045,126410,Vaccaro; Kristen Marie,9999,0,9999,0
1668227944417,CSE 293,046,126411,Klemke; Richard,9999,0,9999,0
1668227944857,CSE 294,A00,102459,Voelker; Geoffrey M.,0,0,0,0
1668227944857,CSE 294,B00,111322,Orailoglu; Alex,0,0,0,0
1668227945283,DSE 201,A00,096914,Deutsch; Alin Bernard,30,0,30,0
1668227945716,DSE 210,A00,096915,Dasgupta; Sanjoy,30,0,30,0
1668227946151,DSE 260A,A00,096916,Altintas De Callaf; Ilkay,30,0,30,0
1668227946610,ECE 200,001,103586,Antipa; Nicholas A,9999,0,9999,0
1668227946610,ECE 200,002,103587,Atanasov; Nikolay A.,9999,0,9999,0
1668227946610,ECE 200,003,103588,Bharadia; Dinesh,9999,0,9999,0
1668227946610,ECE 200,004,103589,Cheng; Chung Kuan,9999,0,9999,0
1668227946610,ECE 200,005,103590,Cosman; Pamela C.,9999,0,9999,0
1668227946610,ECE 200,006,103591,Dayeh; Shadi Ahmad,9999,0,9999,0
1668227946610,ECE 200,007,103592,Fainman; Yeshaiahu,9999,0,9999,0
1668227946610,ECE 200,008,103593,Ford; Joseph Earl,9999,0,9999,0
1668227946610,ECE 200,009,103594,Franceschetti; Massimo,9999,0,9999,0
1668227946610,ECE 200,010,103595,Fullerton; Eric E,9999,0,9999,0
1668227946610,ECE 200,011,103596,Galton; Ian A,9999,0,9999,0
1668227946610,ECE 200,012,103597,Gilja; Vikash,9999,0,9999,0
1668227946610,ECE 200,013,103598,Hall; Drew A.,9999,0,9999,0
1668227946610,ECE 200,014,103599,Hsueh; Tzu-Chien,9999,0,9999,0
1668227946610,ECE 200,015,103600,Javidi; Tara,9999,0,9999,0
1668227946610,ECE 200,016,103601,Kahng; Andrew Byun,9999,0,9999,0
1668227946610,ECE 200,017,103602,Kim; Young-Han,9999,0,9999,0
1668227946610,ECE 200,018,103603,Koushanfar; Farinaz,9999,0,9999,0
1668227946610,ECE 200,019,103604,Kuzum; Duygu,9999,0,9999,0
1668227946610,ECE 200,020,103605,Le; Hanh-Phuc,9999,0,9999,0
1668227946610,ECE 200,021,103606,Lin; Bill,9999,0,9999,0
1668227946610,ECE 200,022,103607,Liu; Zhaowei,9998,0,9999,1
1668227946610,ECE 200,023,103608,Lo; Yu-Hwa,9999,0,9999,0
1668227946610,ECE 200,024,103609,Lomakin; Vitaliy,9999,0,9999,0
1668227946610,ECE 200,025,103610,Mercier; Patrick Philip,9999,0,9999,0
1668227946610,ECE 200,026,103611,Meyer; Florian,9999,0,9999,0
1668227946610,ECE 200,027,103612,Milstein; Laurence B.,9999,0,9999,0
1668227946610,ECE 200,028,103613,Mir Arabbaygi; Siavash,9999,0,9999,0
1668227946610,ECE 200,029,103614,Mookherjea; Shayan,9999,0,9999,0
1668227946610,ECE 200,030,103615,Morris; Karcher William,9999,0,9999,0
1668227946610,ECE 200,031,103616,Ng; Tse Nga,9999,0,9999,0
1668227946610,ECE 200,032,103617,Nguyen; Truong Quang,9999,0,9999,0
1668227946610,ECE 200,033,103618,Nomura; Kenji,9999,0,9999,0
1668227946610,ECE 200,034,103619,Orlitsky; Alon,9999,0,9999,0
1668227946610,ECE 200,035,103620,Pal; Piya,9999,0,9999,0
1668227946610,ECE 200,036,103621,Papen; George C.,9999,0,9999,0
1668227946610,ECE 200,037,103622,Radic; Stojan,9999,0,9999,0
1668227946610,ECE 200,038,103623,Rao; Bhaskar D.,9999,0,9999,0
1668227946610,ECE 200,039,103624,Rao; Ramesh R,9999,0,9999,0
1668227946610,ECE 200,040,103625,Rebeiz; Gabriel,9999,0,9999,0
1668227946610,ECE 200,041,103626,Sanford; John R,9999,0,9999,0
1668227946610,ECE 200,042,103627,Siegel; Paul H.,9999,0,9999,0
1668227946610,ECE 200,043,103628,Sievenpiper; Daniel F.,9999,0,9999,0
1668227946610,ECE 200,044,103629,Sworder; David D.,9999,0,9999,0
1668227946610,ECE 200,045,103630,Taur; Yuan,9999,0,9999,0
1668227946610,ECE 200,046,103631,Touri; Behrouz,9999,0,9999,0
1668227946610,ECE 200,047,103632,Trivedi; Mohan M.,9999,0,9999,0
1668227946610,ECE 200,048,103633,Vasconcelos; Nuno,9999,0,9999,0
1668227946610,ECE 200,049,103634,Wang; Xiaolong,9999,0,9999,0
1668227946610,ECE 200,050,103635,Xie; Pengtao,9999,0,9999,0
1668227946610,ECE 200,051,103636,Yip; Michael,9999,0,9999,0
1668227946610,ECE 200,052,103637,Zeger; Kenneth A.,999,0,999,0
1668227946610,ECE 200,053,103638,Zhang; Xinyu,9999,0,9999,0
1668227946610,ECE 200,054,103639,Turakhia; Yatish Girish,9999,0,9999,0
1668227946610,ECE 200,055,103640,Kang; Mingu,9999,0,9999,0
1668227946610,ECE 200,056,103641,Shi; Yuanyuan,9999,0,9999,0
1668227946610,ECE 200,057,103642,Wang; Edward Jay,9999,0,9999,0
1668227946610,ECE 200,058,103643,Zheng; Yang,9999,0,9999,0
1668227947042,ECE 202,A00,103644,Kuzum; Duygu,0,0,0,0
1668227947481,ECE 212BN,A00,103646,Ng; Tse Nga,0,0,0,0
1668227947915,ECE 221,A00,111493,Staff,0,0,0,0
1668227948356,ECE 222B,A00,103647,Lomakin; Vitaliy,0,0,0,0
1668227948793,ECE 230B,A00,103648,Taur; Yuan,0,0,0,0
1668227949223,ECE 238B,A00,103649,Garay; Javier,0,0,0,0
1668227949645,ECE 240B,A00,112900,Fainman; Yeshaiahu,0,0,0,0
1668227950072,ECE 247A,A00,103650,Jokerst; Jesse Vincent,0,0,0,0
1668227950495,ECE 247B,A00,103651,Wang; Joseph,0,0,0,0
1668227950918,ECE 250,A00,103652,Siegel; Paul H.,0,0,0,0
1668227951343,ECE 251A,A00,103654,Rao; Bhaskar D.,0,0,0,0
1668227951766,ECE 257B,A00,103655,Bharadia; Dinesh,0,0,0,0
1668227952189,ECE 258A,A00,103656,Milstein; Laurence B.,0,0,0,0
1668227952614,ECE 260B,A00,103658,Kang; Mingu,0,0,0,0
1668227953039,ECE 264A,A00,103659,Galton; Ian A,0,0,0,0
1668227953468,ECE 265A,A00,103661,Gudem; Prasad S.S.,0,0,0,0
1668227953897,ECE 265D,A00,103662,Gudem; Prasad S.S.,0,0,0,0
1668227954324,ECE 268,A00,103663,Koushanfar; Farinaz,0,0,0,0
1668227954749,ECE 269,A01,103665,Pal; Piya,0,0,0,0
1668227955171,ECE 271B,A00,103666,Vasconcelos; Manuela,0,0,0,0
1668227955597,ECE 276A,A00,103667,Atanasov; Nikolay A.,0,0,0,0
1668227956020,ECE 277,A00,103668,An; Cheolhong,0,0,0,0
1668227956446,ECE 279,A00,117947,Hall; Drew A.,0,0,0,0
1668227957306,ECE 283,A00,103670,Hsueh; Tzu-Chien,0,0,0,0
1668227957730,ECE 284,A00,103671,Turakhia; Yatish Girish,0,0,0,0
1668227958158,ECE 285,A00,103672,Zheng; Yang,0,0,0,0
1668227958158,ECE 285,B00,103673,Sworder; David D.,0,0,0,0
1668227958580,ECE 287,A00,103676,Javidi; Tara,0,0,0,0
1668227959005,MATH 200B,A00,098023,Salehi Golsefidy; Alireza,12,0,15,3
1668227959447,MATH 202B,A00,098024,Rhoades; Brendon Patrick,9,0,15,6
1668227959873,MATH 203B,A00,098025,Oprea; Dragos N.,10,0,15,5
1668227960296,MATH 204B,A00,098026,Sorensen; Claus M,13,0,15,2
1668227960721,MATH 208,A00,098027,Izadi; Elham,7,0,10,3
1668227961144,MATH 209,A00,098028,Pollack; Aaron,10,0,10,0
1668227961569,MATH 211A,A00,112919,Rogalski; Daniel,9,0,10,1
1668227961999,MATH 211B,A00,112920,Seward; Brandon M.,9,0,10,1
1668227962425,MATH 218,A00,098029,Li; Bo,10,0,10,0
1668227962848,MATH 220B,A00,098030,Novak; Jonathan I,11,0,15,4
1668227963270,MATH 221A,A00,098031,Ebenfelt; Peter F,13,0,15,2
1668227963692,MATH 231B,A00,098032,Zlatos; Andrej,12,0,15,3
1668227964116,MATH 240B,A00,098033,Ni; Lei,9,0,15,6
1668227964551,MATH 243,A00,098034,Jekel; David Andrew,10,0,10,0
1668227964981,MATH 245A,A00,098035,Nie; Jiawang,0,0,15,16
1668227965406,MATH 248,A00,098036,Bejenaru; Ioan,10,0,10,0
1668227965858,MATH 250B,A00,098037,Spolaor; Luca,14,0,15,1
1668227966282,MATH 258,A00,098038,Ni; Lei,10,0,10,0
1668227966709,MATH 264B,A00,098041,Rhoades; Brendon Patrick,9,0,15,6
1668227967132,MATH 268,A00,098042,Buss; Samuel R,10,0,10,0
1668227967553,MATH 269,A00,098043,Rhoades; Brendon Patrick,10,0,10,0
1668227967985,MATH 270B,A00,098044,Li; Bo,10,0,15,5
1668227968410,MATH 272B,A00,098045,Holst; Michael J,13,0,15,2
1668227968836,MATH 273A,A00,098046,Tian; Xiaochuan,10,0,15,5
1668227969259,MATH 275,A01,098048,Tian; Xiaochuan,6,0,10,4
1668227969683,MATH 278A,A00,098049,Holst; Michael J,8,0,10,2
1668227970109,MATH 278B,A00,098050,Cloninger; Alexander,10,0,10,0
1668227970537,MATH 278C,A00,098051,Nie; Jiawang,7,0,10,3
1668227970973,MATH 280B,A00,098052,Zheng; Tianyi,10,0,15,5
1668227971403,MATH 281B,A00,098053,Bradic; Jelena,2,0,15,13
1668227971828,MATH 282B,A00,098054,Arias-Castro; Ery,0,0,15,15
1668227972253,MATH 285,A00,098055,Fitzsimmons; Patrick J,0,0,15,17
1668227972678,MATH 287B,A00,098056,Arias-Castro; Ery,2,0,15,13
1668227973101,MATH 288,A00,098057,Agarwal; Pooja,9,0,10,1
1668227973101,MATH 288,B00,098058,Zhang; Danna,8,0,10,2
1668227973101,MATH 288,C00,098059,Williams; Ruth J,10,0,10,0
1668227973525,MATH 290B,A00,098060,Roberts; Justin Deritter,13,0,15,2
1668227973949,MATH 292,A00,098061,Belmont; Eva Kinoshita,10,0,10,0
1668227974382,MATH 295,A00,098062,Suk; Andrew Hoon,48,0,50,2
1668227974804,MATH 296,A00,098063,Novak; Jonathan I,20,0,20,0
1668227975228,MATH 297,001,098064,Gamst; Anthony Collins,9997,0,9999,2
1668228498150,COGS 205,A00,101395,Chiba; Andrea,19,0,20,1
1668228498577,COGS 210B,001,101404,Greene; Deanna Jacquelyn,9998,0,9999,1
1668228498577,COGS 210B,002,101417,Xia; Haijun,9999,0,9999,0
1668228498577,COGS 210B,003,101422,Nitz; Douglas A.,9999,0,9999,0
1668228498577,COGS 210B,004,101423,Hollan; James D.,9998,0,9999,1
1668228498577,COGS 210B,005,101424,Deak; Gedeon O.,9998,0,9999,1
1668228498577,COGS 210B,006,101425,Rossano; Federico,9999,0,9999,0
1668228499001,COGS 211B,A00,101427,Coulson; Seana M,9996,0,9999,3
1668228499425,COGS 220,A00,101428,Hollan; James D.,0,0,25,25
1668228499851,COGS 229,A00,101429,Dow; Steven P,18,0,25,7
1668228500277,COGS 230,A00,101430,Klemmer; Scott R,12,0,17,5
1668228500702,COGS 234,A00,101431,Xia; Haijun,2,0,25,23
1668228501127,COGS 260,A00,101432,Kiyonaga; Anastasia,21,0,25,4
1668228501127,COGS 260,B00,101433,Kirsh; David Joel,15,0,25,10
1668228501553,CSE 202,A00,102371,Impagliazzo; Russell,0,0,0,0
1668228501986,CSE 203B,A01,102373,Cheng; Chung Kuan,0,0,0,0
1668228502416,CSE 208,A00,102374,Micciancio; Daniele,0,0,0,0
1668228502840,CSE 209A,A00,112895,Impagliazzo; Russell,0,0,15,15
1668228503269,CSE 209B,A00,108005,Bellare; Mihir,0,0,0,0
1668228503693,CSE 210,A00,113163,Coblenz; Michael J,0,0,0,0
1668228504116,CSE 219,A00,106111,Dow; Steven P,0,0,20,20
1668228504542,CSE 221,A00,102376,Voelker; Geoffrey M.,0,0,0,0
1668228504965,CSE 224,A01,102378,Porter; George M,0,0,0,0
1668228505388,CSE 229A,A00,102379,Savage; Stefan,0,0,0,0
1668228505825,CSE 229C,A00,102380,Munyaka; Imani N. S.,0,0,0,0
1668228506253,CSE 232B,A00,102382,Deutsch; Alin Bernard,0,0,0,0
1668228506688,CSE 234,A01,112904,Kumar; Arun Kumar,0,0,0,0
1668228507111,CSE 237A,A00,102383,Rosing; Tajana Simunic,0,0,0,0
1668228507545,CSE 239A,A00,102384,Deutsch; Alin Bernard,0,0,0,0
1668228507978,CSE 239B,A00,102385,Polikarpova; Nadezhda,0,0,0,0
1668228508403,CSE 240A,A00,102386,Pannuto; Patrick William,0,0,0,0
1668228508836,CSE 240B,A00,102387,Zhao; Jishen,0,0,0,0
1668228509260,CSE 241A,A00,106406,Kang; Mingu,0,0,0,0
1668228509682,CSE 249B,A00,102388,Kahng; Andrew Byun,0,0,8,8
1668228510128,CSE 251B,A01,102392,Cottrell; Garrison W,0,0,0,0
1668228510128,CSE 251B,A02,102393,Cottrell; Garrison W,0,0,0,0
1668228510552,CSE 252B,A00,102394,Ochoa; Benjamin Lawrence,0,0,0,0
1668228510980,CSE 257,A01,102396,Gao; Sicun,0,0,0,0
1668228511411,CSE 272,A00,102397,Li; Tzumao,0,0,0,0
1668228511836,CSE 274,A00,111323,Chern; Albert Ren-Haur,0,0,0,0
1668228512268,CSE 282,A00,102398,Pevzner; Pavel Arkadjevich,0,0,0,0
1668228512694,CSE 284,A00,114175,Gymrek; Melissa Ann,0,0,0,0
1668228513123,CSE 290,A00,102399,Chandraker; Manmohan Krishna,0,0,0,0
1668228513123,CSE 290,B00,102400,Vaccaro; Kristen Marie,0,0,25,25
1668228513123,CSE 290,C00,102414,Pannuto; Patrick William,0,0,25,25
1668228513123,CSE 290,D00,102427,Pevzner; Pavel Arkadjevich,0,0,0,0
1668228513123,CSE 290,E00,102429,Zhao; Jishen,0,0,0,0
1668228513123,CSE 290,F00,102436,Tullsen; Dean Michael,0,0,0,0
1668228513123,CSE 290,G00,102440,Christensen; Henrik I,0,0,20,20
1668228513547,CSE 291,A00,102443,Su; Hao,0,0,0,0
1668228513547,CSE 291,B00,102448,Polikarpova; Nadezhda,0,0,0,0
1668228513547,CSE 291,C00,102453,Vaccaro; Kristen Marie,0,0,0,0
1668228513547,CSE 291,D00,111343,Savage; Stefan,0,0,0,0
1668228513547,CSE 291,E00,116474,Claffy; Kimberly Claire,0,0,0,0
1668228513547,CSE 291,F00,116479,Pasquale; Joseph,0,0,0,0
1668228513983,CSE 293,001,119111,Bafna; Vineet,9999,0,9999,0
1668228513983,CSE 293,002,119118,Bellare; Mihir,9999,0,9999,0
1668228513983,CSE 293,003,119122,Berg-Kirkpatrick; Taylor D,9999,0,9999,0
1668228513983,CSE 293,004,119135,Christensen; Henrik I,9999,0,9999,0
1668228513983,CSE 293,005,119142,Cottrell; Garrison W,9999,0,9999,0
1668228513983,CSE 293,006,119146,Deutsch; Alin Bernard,9999,0,9999,0
1668228513983,CSE 293,007,119159,Esmaeilzadeh; Hadi,9999,0,9999,0
1668228513983,CSE 293,008,119166,Freund; Yoav,9999,0,9999,0
1668228513983,CSE 293,009,119170,Griswold; William G.,9999,0,9999,0
1668228513983,CSE 293,010,119183,Gymrek; Melissa Ann,9999,0,9999,0
1668228513983,CSE 293,011,119190,Heninger; Nadia A,9999,0,9999,0
1668228513983,CSE 293,012,119230,Impagliazzo; Russell,9999,0,9999,0
1668228513983,CSE 293,013,119232,Jhala; Ranjit,9999,0,9999,0
1668228513983,CSE 293,014,119233,Kahng; Andrew Byun,9999,0,9999,0
1668228513983,CSE 293,015,119298,Kane; Daniel Mertz,9999,0,9999,0
1668228513983,CSE 293,016,119299,Kriegman; David J,9999,0,9999,0
1668228513983,CSE 293,017,119300,Kumar; Arun Kumar,9999,0,9999,0
1668228513983,CSE 293,018,119301,Lerner; Sorin,9999,0,9999,0
1668228513983,CSE 293,019,119302,Lovett; Shachar,9999,0,9999,0
1668228513983,CSE 293,020,119303,McAuley; Julian John,9999,0,9999,0
1668228513983,CSE 293,021,119304,Micciancio; Daniele,9999,0,9999,0
1668228513983,CSE 293,022,119367,Orailoglu; Alex,9999,0,9999,0
1668228513983,CSE 293,023,119382,Paturi; Ramamohan,9999,0,9999,0
1668228513983,CSE 293,024,119404,Polikarpova; Nadezhda,9999,0,9999,0
1668228513983,CSE 293,025,119406,Politz; Joseph Gibbs,9999,0,9999,0
1668228513983,CSE 293,026,119411,Porter; George M,9999,0,9999,0
1668228513983,CSE 293,027,119414,Porter; Leonard Emerson,9999,0,9999,0
1668228513983,CSE 293,028,119416,Ramamoorthi; Ravi,9999,0,9999,0
1668228513983,CSE 293,029,119417,Sahoo; Debashis,9999,0,9999,0
1668228513983,CSE 293,030,119420,Saul; Lawrence,9999,0,9999,0
1668228513983,CSE 293,031,119421,Savage; Stefan,9999,0,9999,0
1668228513983,CSE 293,032,119425,Schulze; Jurgen P.,9999,0,9999,0
1668228513983,CSE 293,033,119426,Snoeren; Alex C.,9999,0,9999,0
1668228513983,CSE 293,034,119428,Shang; Jingbo,9999,0,9999,0
1668228513983,CSE 293,035,119430,Stefan; Deian,9999,0,9999,0
1668228513983,CSE 293,036,119431,Su; Hao,9999,0,9999,0
1668228513983,CSE 293,037,119433,Swanson; Steven James,9999,0,9999,0
1668228513983,CSE 293,038,119435,Tullsen; Dean Michael,9999,0,9999,0
1668228513983,CSE 293,039,119483,Voelker; Geoffrey M.,9999,0,9999,0
1668228513983,CSE 293,040,119537,Zhao; Jishen,9999,0,9999,0
1668228513983,CSE 293,041,119538,Zhou; Yuan-Yuan,9999,0,9999,0
1668228513983,CSE 293,042,119539,Gao; Sicun,9999,0,9999,0
1668228513983,CSE 293,043,119540,Weibel; Nadir,9999,0,9999,0
1668228513983,CSE 293,044,119541,Gupta; Rajesh K.,9999,0,9999,0
1668228513983,CSE 293,045,126410,Vaccaro; Kristen Marie,9999,0,9999,0
1668228513983,CSE 293,046,126411,Klemke; Richard,9999,0,9999,0
1668228514405,CSE 294,A00,102459,Voelker; Geoffrey M.,0,0,0,0
1668228514405,CSE 294,B00,111322,Orailoglu; Alex,0,0,0,0
1668228514832,DSE 201,A00,096914,Deutsch; Alin Bernard,30,0,30,0
1668228515267,DSE 210,A00,096915,Dasgupta; Sanjoy,30,0,30,0
1668228515691,DSE 260A,A00,096916,Altintas De Callaf; Ilkay,30,0,30,0
1668228516118,ECE 200,001,103586,Antipa; Nicholas A,9999,0,9999,0
1668228516118,ECE 200,002,103587,Atanasov; Nikolay A.,9999,0,9999,0
1668228516118,ECE 200,003,103588,Bharadia; Dinesh,9999,0,9999,0
1668228516118,ECE 200,004,103589,Cheng; Chung Kuan,9999,0,9999,0
1668228516118,ECE 200,005,103590,Cosman; Pamela C.,9999,0,9999,0
1668228516118,ECE 200,006,103591,Dayeh; Shadi Ahmad,9999,0,9999,0
1668228516118,ECE 200,007,103592,Fainman; Yeshaiahu,9999,0,9999,0
1668228516118,ECE 200,008,103593,Ford; Joseph Earl,9999,0,9999,0
1668228516118,ECE 200,009,103594,Franceschetti; Massimo,9999,0,9999,0
1668228516118,ECE 200,010,103595,Fullerton; Eric E,9999,0,9999,0
1668228516118,ECE 200,011,103596,Galton; Ian A,9999,0,9999,0
1668228516118,ECE 200,012,103597,Gilja; Vikash,9999,0,9999,0
1668228516118,ECE 200,013,103598,Hall; Drew A.,9999,0,9999,0
1668228516118,ECE 200,014,103599,Hsueh; Tzu-Chien,9999,0,9999,0
1668228516118,ECE 200,015,103600,Javidi; Tara,9999,0,9999,0
1668228516118,ECE 200,016,103601,Kahng; Andrew Byun,9999,0,9999,0
1668228516118,ECE 200,017,103602,Kim; Young-Han,9999,0,9999,0
1668228516118,ECE 200,018,103603,Koushanfar; Farinaz,9999,0,9999,0
1668228516118,ECE 200,019,103604,Kuzum; Duygu,9999,0,9999,0
1668228516118,ECE 200,020,103605,Le; Hanh-Phuc,9999,0,9999,0
1668228516118,ECE 200,021,103606,Lin; Bill,9999,0,9999,0
1668228516118,ECE 200,022,103607,Liu; Zhaowei,9998,0,9999,1
1668228516118,ECE 200,023,103608,Lo; Yu-Hwa,9999,0,9999,0
1668228516118,ECE 200,024,103609,Lomakin; Vitaliy,9999,0,9999,0
1668228516118,ECE 200,025,103610,Mercier; Patrick Philip,9999,0,9999,0
1668228516118,ECE 200,026,103611,Meyer; Florian,9999,0,9999,0
1668228516118,ECE 200,027,103612,Milstein; Laurence B.,9999,0,9999,0
1668228516118,ECE 200,028,103613,Mir Arabbaygi; Siavash,9999,0,9999,0
1668228516118,ECE 200,029,103614,Mookherjea; Shayan,9999,0,9999,0
1668228516118,ECE 200,030,103615,Morris; Karcher William,9999,0,9999,0
1668228516118,ECE 200,031,103616,Ng; Tse Nga,9999,0,9999,0
1668228516118,ECE 200,032,103617,Nguyen; Truong Quang,9999,0,9999,0
1668228516118,ECE 200,033,103618,Nomura; Kenji,9999,0,9999,0
1668228516118,ECE 200,034,103619,Orlitsky; Alon,9999,0,9999,0
1668228516118,ECE 200,035,103620,Pal; Piya,9999,0,9999,0
1668228516118,ECE 200,036,103621,Papen; George C.,9999,0,9999,0
1668228516118,ECE 200,037,103622,Radic; Stojan,9999,0,9999,0
1668228516118,ECE 200,038,103623,Rao; Bhaskar D.,9999,0,9999,0
1668228516118,ECE 200,039,103624,Rao; Ramesh R,9999,0,9999,0
1668228516118,ECE 200,040,103625,Rebeiz; Gabriel,9999,0,9999,0
1668228516118,ECE 200,041,103626,Sanford; John R,9999,0,9999,0
1668228516118,ECE 200,042,103627,Siegel; Paul H.,9999,0,9999,0
1668228516118,ECE 200,043,103628,Sievenpiper; Daniel F.,9999,0,9999,0
1668228516118,ECE 200,044,103629,Sworder; David D.,9999,0,9999,0
1668228516118,ECE 200,045,103630,Taur; Yuan,9999,0,9999,0
1668228516118,ECE 200,046,103631,Touri; Behrouz,9999,0,9999,0
1668228516118,ECE 200,047,103632,Trivedi; Mohan M.,9999,0,9999,0
1668228516118,ECE 200,048,103633,Vasconcelos; Nuno,9999,0,9999,0
1668228516118,ECE 200,049,103634,Wang; Xiaolong,9999,0,9999,0
1668228516118,ECE 200,050,103635,Xie; Pengtao,9999,0,9999,0
1668228516118,ECE 200,051,103636,Yip; Michael,9999,0,9999,0
1668228516118,ECE 200,052,103637,Zeger; Kenneth A.,999,0,999,0
1668228516118,ECE 200,053,103638,Zhang; Xinyu,9999,0,9999,0
1668228516118,ECE 200,054,103639,Turakhia; Yatish Girish,9999,0,9999,0
1668228516118,ECE 200,055,103640,Kang; Mingu,9999,0,9999,0
1668228516118,ECE 200,056,103641,Shi; Yuanyuan,9999,0,9999,0
1668228516118,ECE 200,057,103642,Wang; Edward Jay,9999,0,9999,0
1668228516118,ECE 200,058,103643,Zheng; Yang,9999,0,9999,0
1668228516541,ECE 202,A00,103644,Kuzum; Duygu,0,0,0,0
1668228516965,ECE 212BN,A00,103646,Ng; Tse Nga,0,0,0,0
1668228517387,ECE 221,A00,111493,Staff,0,0,0,0
1668228517814,ECE 222B,A00,103647,Lomakin; Vitaliy,0,0,0,0
1668228518245,ECE 230B,A00,103648,Taur; Yuan,0,0,0,0
1668228518670,ECE 238B,A00,103649,Garay; Javier,0,0,0,0
1668228519173,ECE 240B,A00,112900,Fainman; Yeshaiahu,0,0,0,0
1668228519601,ECE 247A,A00,103650,Jokerst; Jesse Vincent,0,0,0,0
1668228520037,ECE 247B,A00,103651,Wang; Joseph,0,0,0,0
1668228520460,ECE 250,A00,103652,Siegel; Paul H.,0,0,0,0
1668228520883,ECE 251A,A00,103654,Rao; Bhaskar D.,0,0,0,0
1668228521307,ECE 257B,A00,103655,Bharadia; Dinesh,0,0,0,0
1668228521735,ECE 258A,A00,103656,Milstein; Laurence B.,0,0,0,0
1668228522160,ECE 260B,A00,103658,Kang; Mingu,0,0,0,0
1668228522582,ECE 264A,A00,103659,Galton; Ian A,0,0,0,0
1668228523006,ECE 265A,A00,103661,Gudem; Prasad S.S.,0,0,0,0
1668228523447,ECE 265D,A00,103662,Gudem; Prasad S.S.,0,0,0,0
1668228523876,ECE 268,A00,103663,Koushanfar; Farinaz,0,0,0,0
1668228524302,ECE 269,A01,103665,Pal; Piya,0,0,0,0
1668228524725,ECE 271B,A00,103666,Vasconcelos; Manuela,0,0,0,0
1668228525148,ECE 276A,A00,103667,Atanasov; Nikolay A.,0,0,0,0
1668228525570,ECE 277,A00,103668,An; Cheolhong,0,0,0,0
1668228525996,ECE 279,A00,117947,Hall; Drew A.,0,0,0,0
1668228526849,ECE 283,A00,103670,Hsueh; Tzu-Chien,0,0,0,0
1668228527274,ECE 284,A00,103671,Turakhia; Yatish Girish,0,0,0,0
1668228527701,ECE 285,A00,103672,Zheng; Yang,0,0,0,0
1668228527701,ECE 285,B00,103673,Sworder; David D.,0,0,0,0
1668228528124,ECE 287,A00,103676,Javidi; Tara,0,0,0,0
1668228528546,MATH 200B,A00,098023,Salehi Golsefidy; Alireza,12,0,15,3
1668228528972,MATH 202B,A00,098024,Rhoades; Brendon Patrick,9,0,15,6
1668228529397,MATH 203B,A00,098025,Oprea; Dragos N.,10,0,15,5
1668228529829,MATH 204B,A00,098026,Sorensen; Claus M,13,0,15,2
1668228530256,MATH 208,A00,098027,Izadi; Elham,7,0,10,3
1668228530683,MATH 209,A00,098028,Pollack; Aaron,10,0,10,0
1668228531109,MATH 211A,A00,112919,Rogalski; Daniel,9,0,10,1
1668228531533,MATH 211B,A00,112920,Seward; Brandon M.,9,0,10,1
1668228531960,MATH 218,A00,098029,Li; Bo,10,0,10,0
1668228532382,MATH 220B,A00,098030,Novak; Jonathan I,11,0,15,4
1668228532810,MATH 221A,A00,098031,Ebenfelt; Peter F,13,0,15,2
1668228533235,MATH 231B,A00,098032,Zlatos; Andrej,12,0,15,3
1668228533656,MATH 240B,A00,098033,Ni; Lei,9,0,15,6
1668228534086,MATH 243,A00,098034,Jekel; David Andrew,10,0,10,0
1668228534510,MATH 245A,A00,098035,Nie; Jiawang,0,0,15,16
1668228534939,MATH 248,A00,098036,Bejenaru; Ioan,10,0,10,0
1668228535363,MATH 250B,A00,098037,Spolaor; Luca,14,0,15,1
1668228535787,MATH 258,A00,098038,Ni; Lei,10,0,10,0
1668228536213,MATH 264B,A00,098041,Rhoades; Brendon Patrick,9,0,15,6
1668228536637,MATH 268,A00,098042,Buss; Samuel R,10,0,10,0
1668228537066,MATH 269,A00,098043,Rhoades; Brendon Patrick,10,0,10,0
1668228537488,MATH 270B,A00,098044,Li; Bo,10,0,15,5
1668228537925,MATH 272B,A00,098045,Holst; Michael J,13,0,15,2
1668228538360,MATH 273A,A00,098046,Tian; Xiaochuan,10,0,15,5
1668228538801,MATH 275,A01,098048,Tian; Xiaochuan,6,0,10,4
1668228539235,MATH 278A,A00,098049,Holst; Michael J,8,0,10,2
1668228539657,MATH 278B,A00,098050,Cloninger; Alexander,10,0,10,0
1668228540081,MATH 278C,A00,098051,Nie; Jiawang,7,0,10,3
1668228540506,MATH 280B,A00,098052,Zheng; Tianyi,10,0,15,5
1668228540929,MATH 281B,A00,098053,Bradic; Jelena,2,0,15,13
1668228541357,MATH 282B,A00,098054,Arias-Castro; Ery,0,0,15,15
1668228541790,MATH 285,A00,098055,Fitzsimmons; Patrick J,0,0,15,17
1668228542212,MATH 287B,A00,098056,Arias-Castro; Ery,2,0,15,13
1668228542639,MATH 288,A00,098057,Agarwal; Pooja,9,0,10,1
1668228542639,MATH 288,B00,098058,Zhang; Danna,8,0,10,2
1668228542639,MATH 288,C00,098059,Williams; Ruth J,10,0,10,0
1668228543062,MATH 290B,A00,098060,Roberts; Justin Deritter,13,0,15,2
1668228543484,MATH 292,A00,098061,Belmont; Eva Kinoshita,10,0,10,0
1668228543913,MATH 295,A00,098062,Suk; Andrew Hoon,48,0,50,2
1668228544338,MATH 296,A00,098063,Novak; Jonathan I,20,0,20,0
1668228544767,MATH 297,001,098064,Gamst; Anthony Collins,9997,0,9999,2
1668229046114,COGS 205,A00,101395,Chiba; Andrea,19,0,20,1
1668229046540,COGS 210B,001,101404,Greene; Deanna Jacquelyn,9998,0,9999,1
1668229046540,COGS 210B,002,101417,Xia; Haijun,9999,0,9999,0
1668229046540,COGS 210B,003,101422,Nitz; Douglas A.,9999,0,9999,0
1668229046540,COGS 210B,004,101423,Hollan; James D.,9998,0,9999,1
1668229046540,COGS 210B,005,101424,Deak; Gedeon O.,9998,0,9999,1
1668229046540,COGS 210B,006,101425,Rossano; Federico,9999,0,9999,0
1668229046966,COGS 211B,A00,101427,Coulson; Seana M,9996,0,9999,3
1668229047392,COGS 220,A00,101428,Hollan; James D.,0,0,25,25
1668229047818,COGS 229,A00,101429,Dow; Steven P,18,0,25,7
1668229048242,COGS 230,A00,101430,Klemmer; Scott R,12,0,17,5
1668229048664,COGS 234,A00,101431,Xia; Haijun,2,0,25,23
1668229049089,COGS 260,A00,101432,Kiyonaga; Anastasia,21,0,25,4
1668229049089,COGS 260,B00,101433,Kirsh; David Joel,15,0,25,10
1668229049518,CSE 202,A00,102371,Impagliazzo; Russell,0,0,0,0
1668229049942,CSE 203B,A01,102373,Cheng; Chung Kuan,0,0,0,0
1668229050366,CSE 208,A00,102374,Micciancio; Daniele,0,0,0,0
1668229050797,CSE 209A,A00,112895,Impagliazzo; Russell,0,0,15,15
1668229051229,CSE 209B,A00,108005,Bellare; Mihir,0,0,0,0
1668229051652,CSE 210,A00,113163,Coblenz; Michael J,0,0,0,0
1668229052085,CSE 219,A00,106111,Dow; Steven P,0,0,20,20
1668229052510,CSE 221,A00,102376,Voelker; Geoffrey M.,0,0,0,0
1668229052945,CSE 224,A01,102378,Porter; George M,0,0,0,0
1668229053369,CSE 229A,A00,102379,Savage; Stefan,0,0,0,0
1668229053793,CSE 229C,A00,102380,Munyaka; Imani N. S.,0,0,0,0
1668229054222,CSE 232B,A00,102382,Deutsch; Alin Bernard,0,0,0,0
1668229054645,CSE 234,A01,112904,Kumar; Arun Kumar,0,0,0,0
1668229055067,CSE 237A,A00,102383,Rosing; Tajana Simunic,0,0,0,0
1668229055493,CSE 239A,A00,102384,Deutsch; Alin Bernard,0,0,0,0
1668229055919,CSE 239B,A00,102385,Polikarpova; Nadezhda,0,0,0,0
1668229056351,CSE 240A,A00,102386,Pannuto; Patrick William,0,0,0,0
1668229056775,CSE 240B,A00,102387,Zhao; Jishen,0,0,0,0
1668229057201,CSE 241A,A00,106406,Kang; Mingu,0,0,0,0
1668229057624,CSE 249B,A00,102388,Kahng; Andrew Byun,0,0,8,8
1668229058049,CSE 251B,A01,102392,Cottrell; Garrison W,0,0,0,0
1668229058049,CSE 251B,A02,102393,Cottrell; Garrison W,0,0,0,0
1668229058473,CSE 252B,A00,102394,Ochoa; Benjamin Lawrence,0,0,0,0
1668229058900,CSE 257,A01,102396,Gao; Sicun,0,0,0,0
1668229059325,CSE 272,A00,102397,Li; Tzumao,0,0,0,0
1668229059751,CSE 274,A00,111323,Chern; Albert Ren-Haur,0,0,0,0
1668229060175,CSE 282,A00,102398,Pevzner; Pavel Arkadjevich,0,0,0,0
1668229060604,CSE 284,A00,114175,Gymrek; Melissa Ann,0,0,0,0
1668229061029,CSE 290,A00,102399,Chandraker; Manmohan Krishna,0,0,0,0
1668229061029,CSE 290,B00,102400,Vaccaro; Kristen Marie,0,0,25,25
1668229061029,CSE 290,C00,102414,Pannuto; Patrick William,0,0,25,25
1668229061029,CSE 290,D00,102427,Pevzner; Pavel Arkadjevich,0,0,0,0
1668229061029,CSE 290,E00,102429,Zhao; Jishen,0,0,0,0
1668229061029,CSE 290,F00,102436,Tullsen; Dean Michael,0,0,0,0
1668229061029,CSE 290,G00,102440,Christensen; Henrik I,0,0,20,20
1668229061454,CSE 291,A00,102443,Su; Hao,0,0,0,0
1668229061454,CSE 291,B00,102448,Polikarpova; Nadezhda,0,0,0,0
1668229061454,CSE 291,C00,102453,Vaccaro; Kristen Marie,0,0,0,0
1668229061454,CSE 291,D00,111343,Savage; Stefan,0,0,0,0
1668229061454,CSE 291,E00,116474,Claffy; Kimberly Claire,0,0,0,0
1668229061454,CSE 291,F00,116479,Pasquale; Joseph,0,0,0,0
1668229061883,CSE 293,001,119111,Bafna; Vineet,9999,0,9999,0
1668229061883,CSE 293,002,119118,Bellare; Mihir,9999,0,9999,0
1668229061883,CSE 293,003,119122,Berg-Kirkpatrick; Taylor D,9999,0,9999,0
1668229061883,CSE 293,004,119135,Christensen; Henrik I,9999,0,9999,0
1668229061883,CSE 293,005,119142,Cottrell; Garrison W,9999,0,9999,0
1668229061883,CSE 293,006,119146,Deutsch; Alin Bernard,9999,0,9999,0
1668229061883,CSE 293,007,119159,Esmaeilzadeh; Hadi,9999,0,9999,0
1668229061883,CSE 293,008,119166,Freund; Yoav,9999,0,9999,0
1668229061883,CSE 293,009,119170,Griswold; William G.,9999,0,9999,0
1668229061883,CSE 293,010,119183,Gymrek; Melissa Ann,9999,0,9999,0
1668229061883,CSE 293,011,119190,Heninger; Nadia A,9999,0,9999,0
1668229061883,CSE 293,012,119230,Impagliazzo; Russell,9999,0,9999,0
1668229061883,CSE 293,013,119232,Jhala; Ranjit,9999,0,9999,0
1668229061883,CSE 293,014,119233,Kahng; Andrew Byun,9999,0,9999,0
1668229061883,CSE 293,015,119298,Kane; Daniel Mertz,9999,0,9999,0
1668229061883,CSE 293,016,119299,Kriegman; David J,9999,0,9999,0
1668229061883,CSE 293,017,119300,Kumar; Arun Kumar,9999,0,9999,0
1668229061883,CSE 293,018,119301,Lerner; Sorin,9999,0,9999,0
1668229061883,CSE 293,019,119302,Lovett; Shachar,9999,0,9999,0
1668229061883,CSE 293,020,119303,McAuley; Julian John,9999,0,9999,0
1668229061883,CSE 293,021,119304,Micciancio; Daniele,9999,0,9999,0
1668229061883,CSE 293,022,119367,Orailoglu; Alex,9999,0,9999,0
1668229061883,CSE 293,023,119382,Paturi; Ramamohan,9999,0,9999,0
1668229061883,CSE 293,024,119404,Polikarpova; Nadezhda,9999,0,9999,0
1668229061883,CSE 293,025,119406,Politz; Joseph Gibbs,9999,0,9999,0
1668229061883,CSE 293,026,119411,Porter; George M,9999,0,9999,0
1668229061883,CSE 293,027,119414,Porter; Leonard Emerson,9999,0,9999,0
1668229061883,CSE 293,028,119416,Ramamoorthi; Ravi,9999,0,9999,0
1668229061883,CSE 293,029,119417,Sahoo; Debashis,9999,0,9999,0
1668229061883,CSE 293,030,119420,Saul; Lawrence,9999,0,9999,0
1668229061883,CSE 293,031,119421,Savage; Stefan,9999,0,9999,0
1668229061883,CSE 293,032,119425,Schulze; Jurgen P.,9999,0,9999,0
1668229061883,CSE 293,033,119426,Snoeren; Alex C.,9999,0,9999,0
1668229061883,CSE 293,034,119428,Shang; Jingbo,9999,0,9999,0
1668229061883,CSE 293,035,119430,Stefan; Deian,9999,0,9999,0
1668229061883,CSE 293,036,119431,Su; Hao,9999,0,9999,0
1668229061883,CSE 293,037,119433,Swanson; Steven James,9999,0,9999,0
1668229061883,CSE 293,038,119435,Tullsen; Dean Michael,9999,0,9999,0
1668229061883,CSE 293,039,119483,Voelker; Geoffrey M.,9999,0,9999,0
1668229061883,CSE 293,040,119537,Zhao; Jishen,9999,0,9999,0
1668229061883,CSE 293,041,119538,Zhou; Yuan-Yuan,9999,0,9999,0
1668229061883,CSE 293,042,119539,Gao; Sicun,9999,0,9999,0
1668229061883,CSE 293,043,119540,Weibel; Nadir,9999,0,9999,0
1668229061883,CSE 293,044,119541,Gupta; Rajesh K.,9999,0,9999,0
1668229061883,CSE 293,045,126410,Vaccaro; Kristen Marie,9999,0,9999,0
1668229061883,CSE 293,046,126411,Klemke; Richard,9999,0,9999,0
1668229062307,CSE 294,A00,102459,Voelker; Geoffrey M.,0,0,0,0
1668229062307,CSE 294,B00,111322,Orailoglu; Alex,0,0,0,0
1668229062743,DSE 201,A00,096914,Deutsch; Alin Bernard,30,0,30,0
1668229063169,DSE 210,A00,096915,Dasgupta; Sanjoy,30,0,30,0
1668229063592,DSE 260A,A00,096916,Altintas De Callaf; Ilkay,30,0,30,0
1668229064021,ECE 200,001,103586,Antipa; Nicholas A,9999,0,9999,0
1668229064021,ECE 200,002,103587,Atanasov; Nikolay A.,9999,0,9999,0
1668229064021,ECE 200,003,103588,Bharadia; Dinesh,9999,0,9999,0
1668229064021,ECE 200,004,103589,Cheng; Chung Kuan,9999,0,9999,0
1668229064021,ECE 200,005,103590,Cosman; Pamela C.,9999,0,9999,0
1668229064021,ECE 200,006,103591,Dayeh; Shadi Ahmad,9999,0,9999,0
1668229064021,ECE 200,007,103592,Fainman; Yeshaiahu,9999,0,9999,0
1668229064021,ECE 200,008,103593,Ford; Joseph Earl,9999,0,9999,0
1668229064021,ECE 200,009,103594,Franceschetti; Massimo,9999,0,9999,0
1668229064021,ECE 200,010,103595,Fullerton; Eric E,9999,0,9999,0
1668229064021,ECE 200,011,103596,Galton; Ian A,9999,0,9999,0
1668229064021,ECE 200,012,103597,Gilja; Vikash,9999,0,9999,0
1668229064021,ECE 200,013,103598,Hall; Drew A.,9999,0,9999,0
1668229064021,ECE 200,014,103599,Hsueh; Tzu-Chien,9999,0,9999,0
1668229064021,ECE 200,015,103600,Javidi; Tara,9999,0,9999,0
1668229064021,ECE 200,016,103601,Kahng; Andrew Byun,9999,0,9999,0
1668229064021,ECE 200,017,103602,Kim; Young-Han,9999,0,9999,0
1668229064021,ECE 200,018,103603,Koushanfar; Farinaz,9999,0,9999,0
1668229064021,ECE 200,019,103604,Kuzum; Duygu,9999,0,9999,0
1668229064021,ECE 200,020,103605,Le; Hanh-Phuc,9999,0,9999,0
1668229064021,ECE 200,021,103606,Lin; Bill,9999,0,9999,0
1668229064021,ECE 200,022,103607,Liu; Zhaowei,9998,0,9999,1
1668229064021,ECE 200,023,103608,Lo; Yu-Hwa,9999,0,9999,0
1668229064021,ECE 200,024,103609,Lomakin; Vitaliy,9999,0,9999,0
1668229064021,ECE 200,025,103610,Mercier; Patrick Philip,9999,0,9999,0
1668229064021,ECE 200,026,103611,Meyer; Florian,9999,0,9999,0
1668229064021,ECE 200,027,103612,Milstein; Laurence B.,9999,0,9999,0
1668229064021,ECE 200,028,103613,Mir Arabbaygi; Siavash,9999,0,9999,0
1668229064021,ECE 200,029,103614,Mookherjea; Shayan,9999,0,9999,0
1668229064021,ECE 200,030,103615,Morris; Karcher William,9999,0,9999,0
1668229064021,ECE 200,031,103616,Ng; Tse Nga,9999,0,9999,0
1668229064021,ECE 200,032,103617,Nguyen; Truong Quang,9999,0,9999,0
1668229064021,ECE 200,033,103618,Nomura; Kenji,9999,0,9999,0
1668229064021,ECE 200,034,103619,Orlitsky; Alon,9999,0,9999,0
1668229064021,ECE 200,035,103620,Pal; Piya,9999,0,9999,0
1668229064021,ECE 200,036,103621,Papen; George C.,9999,0,9999,0
1668229064021,ECE 200,037,103622,Radic; Stojan,9999,0,9999,0
1668229064021,ECE 200,038,103623,Rao; Bhaskar D.,9999,0,9999,0
1668229064021,ECE 200,039,103624,Rao; Ramesh R,9999,0,9999,0
1668229064021,ECE 200,040,103625,Rebeiz; Gabriel,9999,0,9999,0
1668229064021,ECE 200,041,103626,Sanford; John R,9999,0,9999,0
1668229064021,ECE 200,042,103627,Siegel; Paul H.,9999,0,9999,0
1668229064021,ECE 200,043,103628,Sievenpiper; Daniel F.,9999,0,9999,0
1668229064021,ECE 200,044,103629,Sworder; David D.,9999,0,9999,0
1668229064021,ECE 200,045,103630,Taur; Yuan,9999,0,9999,0
1668229064021,ECE 200,046,103631,Touri; Behrouz,9999,0,9999,0
1668229064021,ECE 200,047,103632,Trivedi; Mohan M.,9999,0,9999,0
1668229064021,ECE 200,048,103633,Vasconcelos; Nuno,9999,0,9999,0
1668229064021,ECE 200,049,103634,Wang; Xiaolong,9999,0,9999,0
1668229064021,ECE 200,050,103635,Xie; Pengtao,9999,0,9999,0
1668229064021,ECE 200,051,103636,Yip; Michael,9999,0,9999,0
1668229064021,ECE 200,052,103637,Zeger; Kenneth A.,999,0,999,0
1668229064021,ECE 200,053,103638,Zhang; Xinyu,9999,0,9999,0
1668229064021,ECE 200,054,103639,Turakhia; Yatish Girish,9999,0,9999,0
1668229064021,ECE 200,055,103640,Kang; Mingu,9999,0,9999,0
1668229064021,ECE 200,056,103641,Shi; Yuanyuan,9999,0,9999,0
1668229064021,ECE 200,057,103642,Wang; Edward Jay,9999,0,9999,0
1668229064021,ECE 200,058,103643,Zheng; Yang,9999,0,9999,0
1668229064459,ECE 202,A00,103644,Kuzum; Duygu,0,0,0,0
1668229064884,ECE 212BN,A00,103646,Ng; Tse Nga,0,0,0,0
1668229065308,ECE 221,A00,111493,Staff,0,0,0,0
1668229065729,ECE 222B,A00,103647,Lomakin; Vitaliy,0,0,0,0
1668229066153,ECE 230B,A00,103648,Taur; Yuan,0,0,0,0
1668229066578,ECE 238B,A00,103649,Garay; Javier,0,0,0,0
1668229067006,ECE 240B,A00,112900,Fainman; Yeshaiahu,0,0,0,0
1668229067428,ECE 247A,A00,103650,Jokerst; Jesse Vincent,0,0,0,0
1668229067864,ECE 247B,A00,103651,Wang; Joseph,0,0,0,0
1668229068289,ECE 250,A00,103652,Siegel; Paul H.,0,0,0,0
1668229068715,ECE 251A,A00,103654,Rao; Bhaskar D.,0,0,0,0
1668229069149,ECE 257B,A00,103655,Bharadia; Dinesh,0,0,0,0
1668229069572,ECE 258A,A00,103656,Milstein; Laurence B.,0,0,0,0
1668229069998,ECE 260B,A00,103658,Kang; Mingu,0,0,0,0
1668229070432,ECE 264A,A00,103659,Galton; Ian A,0,0,0,0
1668229070855,ECE 265A,A00,103661,Gudem; Prasad S.S.,0,0,0,0
1668229071287,ECE 265D,A00,103662,Gudem; Prasad S.S.,0,0,0,0
1668229071710,ECE 268,A00,103663,Koushanfar; Farinaz,0,0,0,0
1668229072139,ECE 269,A01,103665,Pal; Piya,0,0,0,0
1668229072577,ECE 271B,A00,103666,Vasconcelos; Manuela,0,0,0,0
1668229072999,ECE 276A,A00,103667,Atanasov; Nikolay A.,0,0,0,0
1668229073422,ECE 277,A00,103668,An; Cheolhong,0,0,0,0
1668229073848,ECE 279,A00,117947,Hall; Drew A.,0,0,0,0
1668229074699,ECE 283,A00,103670,Hsueh; Tzu-Chien,0,0,0,0
1668229075123,ECE 284,A00,103671,Turakhia; Yatish Girish,0,0,0,0
1668229075548,ECE 285,A00,103672,Zheng; Yang,0,0,0,0
1668229075548,ECE 285,B00,103673,Sworder; David D.,0,0,0,0
1668229075981,ECE 287,A00,103676,Javidi; Tara,0,0,0,0
1668229076405,MATH 200B,A00,098023,Salehi Golsefidy; Alireza,12,0,15,3
1668229076831,MATH 202B,A00,098024,Rhoades; Brendon Patrick,9,0,15,6
1668229077254,MATH 203B,A00,098025,Oprea; Dragos N.,10,0,15,5
1668229077678,MATH 204B,A00,098026,Sorensen; Claus M,13,0,15,2
1668229078105,MATH 208,A00,098027,Izadi; Elham,7,0,10,3
1668229078527,MATH 209,A00,098028,Pollack; Aaron,10,0,10,0
1668229078966,MATH 211A,A00,112919,Rogalski; Daniel,9,0,10,1
1668229079396,MATH 211B,A00,112920,Seward; Brandon M.,9,0,10,1
1668229079821,MATH 218,A00,098029,Li; Bo,10,0,10,0
1668229080261,MATH 220B,A00,098030,Novak; Jonathan I,11,0,15,4
1668229080703,MATH 221A,A00,098031,Ebenfelt; Peter F,13,0,15,2
1668229081126,MATH 231B,A00,098032,Zlatos; Andrej,12,0,15,3
1668229081552,MATH 240B,A00,098033,Ni; Lei,9,0,15,6
1668229081978,MATH 243,A00,098034,Jekel; David Andrew,10,0,10,0
1668229082402,MATH 245A,A00,098035,Nie; Jiawang,0,0,15,16
1668229082830,MATH 248,A00,098036,Bejenaru; Ioan,10,0,10,0
1668229083269,MATH 250B,A00,098037,Spolaor; Luca,14,0,15,1
1668229083768,MATH 258,A00,098038,Ni; Lei,10,0,10,0
1668229084199,MATH 264B,A00,098041,Rhoades; Brendon Patrick,9,0,15,6
1668229084622,MATH 268,A00,098042,Buss; Samuel R,10,0,10,0
1668229085057,MATH 269,A00,098043,Rhoades; Brendon Patrick,10,0,10,0
1668229085490,MATH 270B,A00,098044,Li; Bo,10,0,15,5
1668229085926,MATH 272B,A00,098045,Holst; Michael J,13,0,15,2
1668229086354,MATH 273A,A00,098046,Tian; Xiaochuan,10,0,15,5
1668229086789,MATH 275,A01,098048,Tian; Xiaochuan,6,0,10,4
1668229087217,MATH 278A,A00,098049,Holst; Michael J,8,0,10,2
1668229087649,MATH 278B,A00,098050,Cloninger; Alexander,10,0,10,0
1668229088089,MATH 278C,A00,098051,Nie; Jiawang,7,0,10,3
1668229088523,MATH 280B,A00,098052,Zheng; Tianyi,10,0,15,5
1668229088960,MATH 281B,A00,098053,Bradic; Jelena,2,0,15,13
1668229089384,MATH 282B,A00,098054,Arias-Castro; Ery,0,0,15,15
1668229089821,MATH 285,A00,098055,Fitzsimmons; Patrick J,0,0,15,17
1668229090249,MATH 287B,A00,098056,Arias-Castro; Ery,2,0,15,13
1668229090671,MATH 288,A00,098057,Agarwal; Pooja,9,0,10,1
1668229090671,MATH 288,B00,098058,Zhang; Danna,8,0,10,2
1668229090671,MATH 288,C00,098059,Williams; Ruth J,10,0,10,0
1668229091093,MATH 290B,A00,098060,Roberts; Justin Deritter,13,0,15,2
1668229091518,MATH 292,A00,098061,Belmont; Eva Kinoshita,10,0,10,0
1668229091942,MATH 295,A00,098062,Suk; Andrew Hoon,48,0,50,2
1668229092366,MATH 296,A00,098063,Novak; Jonathan I,20,0,20,0
1668229092792,MATH 297,001,098064,Gamst; Anthony Collins,9997,0,9999,2
1668229593725,COGS 205,A00,101395,Chiba; Andrea,19,0,20,1
1668229594154,COGS 210B,001,101404,Greene; Deanna Jacquelyn,9998,0,9999,1
1668229594154,COGS 210B,002,101417,Xia; Haijun,9999,0,9999,0
1668229594154,COGS 210B,003,101422,Nitz; Douglas A.,9999,0,9999,0
1668229594154,COGS 210B,004,101423,Hollan; James D.,9998,0,9999,1
1668229594154,COGS 210B,005,101424,Deak; Gedeon O.,9998,0,9999,1
1668229594154,COGS 210B,006,101425,Rossano; Federico,9999,0,9999,0
1668229594580,COGS 211B,A00,101427,Coulson; Seana M,9996,0,9999,3
1668229595002,COGS 220,A00,101428,Hollan; James D.,0,0,25,25
1668229595445,COGS 229,A00,101429,Dow; Steven P,18,0,25,7
1668229595872,COGS 230,A00,101430,Klemmer; Scott R,12,0,17,5
1668229596313,COGS 234,A00,101431,Xia; Haijun,2,0,25,23
1668229596737,COGS 260,A00,101432,Kiyonaga; Anastasia,21,0,25,4
1668229596737,COGS 260,B00,101433,Kirsh; David Joel,15,0,25,10
1668229597161,CSE 202,A00,102371,Impagliazzo; Russell,0,0,0,0
1668229597586,CSE 203B,A01,102373,Cheng; Chung Kuan,0,0,0,0
1668229598010,CSE 208,A00,102374,Micciancio; Daniele,0,0,0,0
1668229598446,CSE 209A,A00,112895,Impagliazzo; Russell,0,0,15,15
1668229598870,CSE 209B,A00,108005,Bellare; Mihir,0,0,0,0
1668229599294,CSE 210,A00,113163,Coblenz; Michael J,0,0,0,0
1668229599715,CSE 219,A00,106111,Dow; Steven P,0,0,20,20
1668229600136,CSE 221,A00,102376,Voelker; Geoffrey M.,0,0,0,0
1668229600563,CSE 224,A01,102378,Porter; George M,0,0,0,0
1668229600984,CSE 229A,A00,102379,Savage; Stefan,0,0,0,0
1668229601407,CSE 229C,A00,102380,Munyaka; Imani N. S.,0,0,0,0
1668229601831,CSE 232B,A00,102382,Deutsch; Alin Bernard,0,0,0,0
1668229602257,CSE 234,A01,112904,Kumar; Arun Kumar,0,0,0,0
1668229602680,CSE 237A,A00,102383,Rosing; Tajana Simunic,0,0,0,0
1668229603105,CSE 239A,A00,102384,Deutsch; Alin Bernard,0,0,0,0
1668229603528,CSE 239B,A00,102385,Polikarpova; Nadezhda,0,0,0,0
1668229603952,CSE 240A,A00,102386,Pannuto; Patrick William,0,0,0,0
1668229604381,CSE 240B,A00,102387,Zhao; Jishen,0,0,0,0
1668229604900,CSE 241A,A00,106406,Kang; Mingu,0,0,0,0
1668229605329,CSE 249B,A00,102388,Kahng; Andrew Byun,0,0,8,8
1668229605751,CSE 251B,A01,102392,Cottrell; Garrison W,0,0,0,0
1668229605751,CSE 251B,A02,102393,Cottrell; Garrison W,0,0,0,0
1668229606185,CSE 252B,A00,102394,Ochoa; Benjamin Lawrence,0,0,0,0
1668229606619,CSE 257,A01,102396,Gao; Sicun,0,0,0,0
1668229607042,CSE 272,A00,102397,Li; Tzumao,0,0,0,0
1668229607470,CSE 274,A00,111323,Chern; Albert Ren-Haur,0,0,0,0
1668229607908,CSE 282,A00,102398,Pevzner; Pavel Arkadjevich,0,0,0,0
1668229608346,CSE 284,A00,114175,Gymrek; Melissa Ann,0,0,0,0
1668229608774,CSE 290,A00,102399,Chandraker; Manmohan Krishna,0,0,0,0
1668229608774,CSE 290,B00,102400,Vaccaro; Kristen Marie,0,0,25,25
1668229608774,CSE 290,C00,102414,Pannuto; Patrick William,0,0,25,25
1668229608774,CSE 290,D00,102427,Pevzner; Pavel Arkadjevich,0,0,0,0
1668229608774,CSE 290,E00,102429,Zhao; Jishen,0,0,0,0
1668229608774,CSE 290,F00,102436,Tullsen; Dean Michael,0,0,0,0
1668229608774,CSE 290,G00,102440,Christensen; Henrik I,0,0,20,20
1668229609200,CSE 291,A00,102443,Su; Hao,0,0,0,0
1668229609200,CSE 291,B00,102448,Polikarpova; Nadezhda,0,0,0,0
1668229609200,CSE 291,C00,102453,Vaccaro; Kristen Marie,0,0,0,0
1668229609200,CSE 291,D00,111343,Savage; Stefan,0,0,0,0
1668229609200,CSE 291,E00,116474,Claffy; Kimberly Claire,0,0,0,0
1668229609200,CSE 291,F00,116479,Pasquale; Joseph,0,0,0,0
1668229609656,CSE 293,001,119111,Bafna; Vineet,9999,0,9999,0
1668229609656,CSE 293,002,119118,Bellare; Mihir,9999,0,9999,0
1668229609656,CSE 293,003,119122,Berg-Kirkpatrick; Taylor D,9999,0,9999,0
1668229609656,CSE 293,004,119135,Christensen; Henrik I,9999,0,9999,0
1668229609656,CSE 293,005,119142,Cottrell; Garrison W,9999,0,9999,0
1668229609656,CSE 293,006,119146,Deutsch; Alin Bernard,9999,0,9999,0
1668229609656,CSE 293,007,119159,Esmaeilzadeh; Hadi,9999,0,9999,0
1668229609656,CSE 293,008,119166,Freund; Yoav,9999,0,9999,0
1668229609656,CSE 293,009,119170,Griswold; William G.,9999,0,9999,0
1668229609656,CSE 293,010,119183,Gymrek; Melissa Ann,9999,0,9999,0
1668229609656,CSE 293,011,119190,Heninger; Nadia A,9999,0,9999,0
1668229609656,CSE 293,012,119230,Impagliazzo; Russell,9999,0,9999,0
1668229609656,CSE 293,013,119232,Jhala; Ranjit,9999,0,9999,0
1668229609656,CSE 293,014,119233,Kahng; Andrew Byun,9999,0,9999,0
1668229609656,CSE 293,015,119298,Kane; Daniel Mertz,9999,0,9999,0
1668229609656,CSE 293,016,119299,Kriegman; David J,9999,0,9999,0
1668229609656,CSE 293,017,119300,Kumar; Arun Kumar,9999,0,9999,0
1668229609656,CSE 293,018,119301,Lerner; Sorin,9999,0,9999,0
1668229609656,CSE 293,019,119302,Lovett; Shachar,9999,0,9999,0
1668229609656,CSE 293,020,119303,McAuley; Julian John,9999,0,9999,0
1668229609656,CSE 293,021,119304,Micciancio; Daniele,9999,0,9999,0
1668229609656,CSE 293,022,119367,Orailoglu; Alex,9999,0,9999,0
1668229609656,CSE 293,023,119382,Paturi; Ramamohan,9999,0,9999,0
1668229609656,CSE 293,024,119404,Polikarpova; Nadezhda,9999,0,9999,0
1668229609656,CSE 293,025,119406,Politz; Joseph Gibbs,9999,0,9999,0
1668229609656,CSE 293,026,119411,Porter; George M,9999,0,9999,0
1668229609656,CSE 293,027,119414,Porter; Leonard Emerson,9999,0,9999,0
1668229609656,CSE 293,028,119416,Ramamoorthi; Ravi,9999,0,9999,0
1668229609656,CSE 293,029,119417,Sahoo; Debashis,9999,0,9999,0
1668229609656,CSE 293,030,119420,Saul; Lawrence,9999,0,9999,0
1668229609656,CSE 293,031,119421,Savage; Stefan,9999,0,9999,0
1668229609656,CSE 293,032,119425,Schulze; Jurgen P.,9999,0,9999,0
1668229609656,CSE 293,033,119426,Snoeren; Alex C.,9999,0,9999,0
1668229609656,CSE 293,034,119428,Shang; Jingbo,9999,0,9999,0
1668229609656,CSE 293,035,119430,Stefan; Deian,9999,0,9999,0
1668229609656,CSE 293,036,119431,Su; Hao,9999,0,9999,0
1668229609656,CSE 293,037,119433,Swanson; Steven James,9999,0,9999,0
1668229609656,CSE 293,038,119435,Tullsen; Dean Michael,9999,0,9999,0
1668229609656,CSE 293,039,119483,Voelker; Geoffrey M.,9999,0,9999,0
1668229609656,CSE 293,040,119537,Zhao; Jishen,9999,0,9999,0
1668229609656,CSE 293,041,119538,Zhou; Yuan-Yuan,9999,0,9999,0
1668229609656,CSE 293,042,119539,Gao; Sicun,9999,0,9999,0
1668229609656,CSE 293,043,119540,Weibel; Nadir,9999,0,9999,0
1668229609656,CSE 293,044,119541,Gupta; Rajesh K.,9999,0,9999,0
1668229609656,CSE 293,045,126410,Vaccaro; Kristen Marie,9999,0,9999,0
1668229609656,CSE 293,046,126411,Klemke; Richard,9999,0,9999,0
1668229610079,CSE 294,A00,102459,Voelker; Geoffrey M.,0,0,0,0
1668229610079,CSE 294,B00,111322,Orailoglu; Alex,0,0,0,0
1668229610505,DSE 201,A00,096914,Deutsch; Alin Bernard,30,0,30,0
1668229610930,DSE 210,A00,096915,Dasgupta; Sanjoy,30,0,30,0
1668229611360,DSE 260A,A00,096916,Altintas De Callaf; Ilkay,30,0,30,0
1668229611787,ECE 200,001,103586,Antipa; Nicholas A,9999,0,9999,0
1668229611787,ECE 200,002,103587,Atanasov; Nikolay A.,9999,0,9999,0
1668229611787,ECE 200,003,103588,Bharadia; Dinesh,9999,0,9999,0
1668229611787,ECE 200,004,103589,Cheng; Chung Kuan,9999,0,9999,0
1668229611787,ECE 200,005,103590,Cosman; Pamela C.,9999,0,9999,0
1668229611787,ECE 200,006,103591,Dayeh; Shadi Ahmad,9999,0,9999,0
1668229611787,ECE 200,007,103592,Fainman; Yeshaiahu,9999,0,9999,0
1668229611787,ECE 200,008,103593,Ford; Joseph Earl,9999,0,9999,0
1668229611787,ECE 200,009,103594,Franceschetti; Massimo,9999,0,9999,0
1668229611787,ECE 200,010,103595,Fullerton; Eric E,9999,0,9999,0
1668229611787,ECE 200,011,103596,Galton; Ian A,9999,0,9999,0
1668229611787,ECE 200,012,103597,Gilja; Vikash,9999,0,9999,0
1668229611787,ECE 200,013,103598,Hall; Drew A.,9999,0,9999,0
1668229611787,ECE 200,014,103599,Hsueh; Tzu-Chien,9999,0,9999,0
1668229611787,ECE 200,015,103600,Javidi; Tara,9999,0,9999,0
1668229611787,ECE 200,016,103601,Kahng; Andrew Byun,9999,0,9999,0
1668229611787,ECE 200,017,103602,Kim; Young-Han,9999,0,9999,0
1668229611787,ECE 200,018,103603,Koushanfar; Farinaz,9999,0,9999,0
1668229611787,ECE 200,019,103604,Kuzum; Duygu,9999,0,9999,0
1668229611787,ECE 200,020,103605,Le; Hanh-Phuc,9999,0,9999,0
1668229611787,ECE 200,021,103606,Lin; Bill,9999,0,9999,0
1668229611787,ECE 200,022,103607,Liu; Zhaowei,9998,0,9999,1
1668229611787,ECE 200,023,103608,Lo; Yu-Hwa,9999,0,9999,0
1668229611787,ECE 200,024,103609,Lomakin; Vitaliy,9999,0,9999,0
1668229611787,ECE 200,025,103610,Mercier; Patrick Philip,9999,0,9999,0
1668229611787,ECE 200,026,103611,Meyer; Florian,9999,0,9999,0
1668229611787,ECE 200,027,103612,Milstein; Laurence B.,9999,0,9999,0
1668229611787,ECE 200,028,103613,Mir Arabbaygi; Siavash,9999,0,9999,0
1668229611787,ECE 200,029,103614,Mookherjea; Shayan,9999,0,9999,0
1668229611787,ECE 200,030,103615,Morris; Karcher William,9999,0,9999,0
1668229611787,ECE 200,031,103616,Ng; Tse Nga,9999,0,9999,0
1668229611787,ECE 200,032,103617,Nguyen; Truong Quang,9999,0,9999,0
1668229611787,ECE 200,033,103618,Nomura; Kenji,9999,0,9999,0
1668229611787,ECE 200,034,103619,Orlitsky; Alon,9999,0,9999,0
1668229611787,ECE 200,035,103620,Pal; Piya,9999,0,9999,0
1668229611787,ECE 200,036,103621,Papen; George C.,9999,0,9999,0
1668229611787,ECE 200,037,103622,Radic; Stojan,9999,0,9999,0
1668229611787,ECE 200,038,103623,Rao; Bhaskar D.,9999,0,9999,0
1668229611787,ECE 200,039,103624,Rao; Ramesh R,9999,0,9999,0
1668229611787,ECE 200,040,103625,Rebeiz; Gabriel,9999,0,9999,0
1668229611787,ECE 200,041,103626,Sanford; John R,9999,0,9999,0
1668229611787,ECE 200,042,103627,Siegel; Paul H.,9999,0,9999,0
1668229611787,ECE 200,043,103628,Sievenpiper; Daniel F.,9999,0,9999,0
1668229611787,ECE 200,044,103629,Sworder; David D.,9999,0,9999,0
1668229611787,ECE 200,045,103630,Taur; Yuan,9999,0,9999,0
1668229611787,ECE 200,046,103631,Touri; Behrouz,9999,0,9999,0
1668229611787,ECE 200,047,103632,Trivedi; Mohan M.,9999,0,9999,0
1668229611787,ECE 200,048,103633,Vasconcelos; Nuno,9999,0,9999,0
1668229611787,ECE 200,049,103634,Wang; Xiaolong,9999,0,9999,0
1668229611787,ECE 200,050,103635,Xie; Pengtao,9999,0,9999,0
1668229611787,ECE 200,051,103636,Yip; Michael,9999,0,9999,0
1668229611787,ECE 200,052,103637,Zeger; Kenneth A.,999,0,999,0
1668229611787,ECE 200,053,103638,Zhang; Xinyu,9999,0,9999,0
1668229611787,ECE 200,054,103639,Turakhia; Yatish Girish,9999,0,9999,0
1668229611787,ECE 200,055,103640,Kang; Mingu,9999,0,9999,0
1668229611787,ECE 200,056,103641,Shi; Yuanyuan,9999,0,9999,0
1668229611787,ECE 200,057,103642,Wang; Edward Jay,9999,0,9999,0
1668229611787,ECE 200,058,103643,Zheng; Yang,9999,0,9999,0
1668229612225,ECE 202,A00,103644,Kuzum; Duygu,0,0,0,0
1668229612669,ECE 212BN,A00,103646,Ng; Tse Nga,0,0,0,0
1668229613094,ECE 221,A00,111493,Staff,0,0,0,0
1668229613534,ECE 222B,A00,103647,Lomakin; Vitaliy,0,0,0,0
1668229613958,ECE 230B,A00,103648,Taur; Yuan,0,0,0,0
1668229614381,ECE 238B,A00,103649,Garay; Javier,0,0,0,0
1668229614803,ECE 240B,A00,112900,Fainman; Yeshaiahu,0,0,0,0
1668229615226,ECE 247A,A00,103650,Jokerst; Jesse Vincent,0,0,0,0
1668229615656,ECE 247B,A00,103651,Wang; Joseph,0,0,0,0
1668229616082,ECE 250,A00,103652,Siegel; Paul H.,0,0,0,0
1668229616504,ECE 251A,A00,103654,Rao; Bhaskar D.,0,0,0,0
1668229616929,ECE 257B,A00,103655,Bharadia; Dinesh,0,0,0,0
1668229617364,ECE 258A,A00,103656,Milstein; Laurence B.,0,0,0,0
1668229617793,ECE 260B,A00,103658,Kang; Mingu,0,0,0,0
1668229618218,ECE 264A,A00,103659,Galton; Ian A,0,0,0,0
1668229618644,ECE 265A,A00,103661,Gudem; Prasad S.S.,0,0,0,0
1668229619067,ECE 265D,A00,103662,Gudem; Prasad S.S.,0,0,0,0
1668229619490,ECE 268,A00,103663,Koushanfar; Farinaz,0,0,0,0
1668229619915,ECE 269,A01,103665,Pal; Piya,0,0,0,0
1668229620339,ECE 271B,A00,103666,Vasconcelos; Manuela,0,0,0,0
1668229620766,ECE 276A,A00,103667,Atanasov; Nikolay A.,0,0,0,0
1668229621196,ECE 277,A00,103668,An; Cheolhong,0,0,0,0
1668229621623,ECE 279,A00,117947,Hall; Drew A.,0,0,0,0
1668229622469,ECE 283,A00,103670,Hsueh; Tzu-Chien,0,0,0,0
1668229622894,ECE 284,A00,103671,Turakhia; Yatish Girish,0,0,0,0
1668229623328,ECE 285,A00,103672,Zheng; Yang,0,0,0,0
1668229623328,ECE 285,B00,103673,Sworder; David D.,0,0,0,0
1668229623756,ECE 287,A00,103676,Javidi; Tara,0,0,0,0
1668229624184,MATH 200B,A00,098023,Salehi Golsefidy; Alireza,12,0,15,3
1668229624611,MATH 202B,A00,098024,Rhoades; Brendon Patrick,9,0,15,6
1668229625049,MATH 203B,A00,098025,Oprea; Dragos N.,10,0,15,5
1668229625473,MATH 204B,A00,098026,Sorensen; Claus M,13,0,15,2
1668229625898,MATH 208,A00,098027,Izadi; Elham,7,0,10,3
1668229626323,MATH 209,A00,098028,Pollack; Aaron,10,0,10,0
1668229626745,MATH 211A,A00,112919,Rogalski; Daniel,9,0,10,1
1668229627175,MATH 211B,A00,112920,Seward; Brandon M.,9,0,10,1
1668229627610,MATH 218,A00,098029,Li; Bo,10,0,10,0
1668229628041,MATH 220B,A00,098030,Novak; Jonathan I,11,0,15,4
1668229628485,MATH 221A,A00,098031,Ebenfelt; Peter F,13,0,15,2
1668229628909,MATH 231B,A00,098032,Zlatos; Andrej,12,0,15,3
1668229629332,MATH 240B,A00,098033,Ni; Lei,9,0,15,6
1668229629754,MATH 243,A00,098034,Jekel; David Andrew,10,0,10,0
1668229630179,MATH 245A,A00,098035,Nie; Jiawang,0,0,15,16
1668229630604,MATH 248,A00,098036,Bejenaru; Ioan,10,0,10,0
1668229631032,MATH 250B,A00,098037,Spolaor; Luca,14,0,15,1
1668229631453,MATH 258,A00,098038,Ni; Lei,10,0,10,0
1668229631879,MATH 264B,A00,098041,Rhoades; Brendon Patrick,9,0,15,6
1668229632308,MATH 268,A00,098042,Buss; Samuel R,10,0,10,0
1668229632730,MATH 269,A00,098043,Rhoades; Brendon Patrick,10,0,10,0
1668229633162,MATH 270B,A00,098044,Li; Bo,10,0,15,5
1668229633599,MATH 272B,A00,098045,Holst; Michael J,13,0,15,2
1668229634034,MATH 273A,A00,098046,Tian; Xiaochuan,10,0,15,5
1668229634458,MATH 275,A01,098048,Tian; Xiaochuan,6,0,10,4
1668229634880,MATH 278A,A00,098049,Holst; Michael J,8,0,10,2
1668229635308,MATH 278B,A00,098050,Cloninger; Alexander,10,0,10,0
1668229635730,MATH 278C,A00,098051,Nie; Jiawang,7,0,10,3
1668229636162,MATH 280B,A00,098052,Zheng; Tianyi,10,0,15,5
1668229636594,MATH 281B,A00,098053,Bradic; Jelena,2,0,15,13
1668229637021,MATH 282B,A00,098054,Arias-Castro; Ery,0,0,15,15
1668229637446,MATH 285,A00,098055,Fitzsimmons; Patrick J,0,0,15,17
1668229637873,MATH 287B,A00,098056,Arias-Castro; Ery,2,0,15,13
1668229638297,MATH 288,A00,098057,Agarwal; Pooja,9,0,10,1
1668229638297,MATH 288,B00,098058,Zhang; Danna,8,0,10,2
1668229638297,MATH 288,C00,098059,Williams; Ruth J,10,0,10,0
1668229638721,MATH 290B,A00,098060,Roberts; Justin Deritter,13,0,15,2
1668229639144,MATH 292,A00,098061,Belmont; Eva Kinoshita,10,0,10,0
1668229639579,MATH 295,A00,098062,Suk; Andrew Hoon,48,0,50,2
1668229640011,MATH 296,A00,098063,Novak; Jonathan I,20,0,20,0
1668229640434,MATH 297,001,098064,Gamst; Anthony Collins,9997,0,9999,2
1668230142112,COGS 205,A00,101395,Chiba; Andrea,19,0,20,1
1668230142539,COGS 210B,001,101404,Greene; Deanna Jacquelyn,9998,0,9999,1
1668230142539,COGS 210B,002,101417,Xia; Haijun,9999,0,9999,0
1668230142539,COGS 210B,003,101422,Nitz; Douglas A.,9999,0,9999,0
1668230142539,COGS 210B,004,101423,Hollan; James D.,9998,0,9999,1
1668230142539,COGS 210B,005,101424,Deak; Gedeon O.,9998,0,9999,1
1668230142539,COGS 210B,006,101425,Rossano; Federico,9999,0,9999,0
1668230142964,COGS 211B,A00,101427,Coulson; Seana M,9996,0,9999,3
1668230143388,COGS 220,A00,101428,Hollan; James D.,0,0,25,25
1668230143814,COGS 229,A00,101429,Dow; Steven P,18,0,25,7
1668230144240,COGS 230,A00,101430,Klemmer; Scott R,12,0,17,5
1668230144662,COGS 234,A00,101431,Xia; Haijun,2,0,25,23
1668230145083,COGS 260,A00,101432,Kiyonaga; Anastasia,21,0,25,4
1668230145083,COGS 260,B00,101433,Kirsh; David Joel,15,0,25,10
1668230145517,CSE 202,A00,102371,Impagliazzo; Russell,0,0,0,0
1668230145946,CSE 203B,A01,102373,Cheng; Chung Kuan,0,0,0,0
1668230146373,CSE 208,A00,102374,Micciancio; Daniele,0,0,0,0
1668230146796,CSE 209A,A00,112895,Impagliazzo; Russell,0,0,15,15
1668230147222,CSE 209B,A00,108005,Bellare; Mihir,0,0,0,0
1668230147652,CSE 210,A00,113163,Coblenz; Michael J,0,0,0,0
1668230148078,CSE 219,A00,106111,Dow; Steven P,0,0,20,20
1668230148503,CSE 221,A00,102376,Voelker; Geoffrey M.,0,0,0,0
1668230148930,CSE 224,A01,102378,Porter; George M,0,0,0,0
1668230149367,CSE 229A,A00,102379,Savage; Stefan,0,0,0,0
1668230149792,CSE 229C,A00,102380,Munyaka; Imani N. S.,0,0,0,0
1668230150215,CSE 232B,A00,102382,Deutsch; Alin Bernard,0,0,0,0
1668230150641,CSE 234,A01,112904,Kumar; Arun Kumar,0,0,0,0
1668230151075,CSE 237A,A00,102383,Rosing; Tajana Simunic,0,0,0,0
1668230151502,CSE 239A,A00,102384,Deutsch; Alin Bernard,0,0,0,0
1668230151930,CSE 239B,A00,102385,Polikarpova; Nadezhda,0,0,0,0
1668230152354,CSE 240A,A00,102386,Pannuto; Patrick William,0,0,0,0
1668230152780,CSE 240B,A00,102387,Zhao; Jishen,0,0,0,0
1668230153204,CSE 241A,A00,106406,Kang; Mingu,0,0,0,0
1668230153632,CSE 249B,A00,102388,Kahng; Andrew Byun,0,0,8,8
1668230154057,CSE 251B,A01,102392,Cottrell; Garrison W,0,0,0,0
1668230154057,CSE 251B,A02,102393,Cottrell; Garrison W,0,0,0,0
1668230154483,CSE 252B,A00,102394,Ochoa; Benjamin Lawrence,0,0,0,0
1668230154911,CSE 257,A01,102396,Gao; Sicun,0,0,0,0
1668230155334,CSE 272,A00,102397,Li; Tzumao,0,0,0,0
1668230155756,CSE 274,A00,111323,Chern; Albert Ren-Haur,0,0,0,0
1668230156191,CSE 282,A00,102398,Pevzner; Pavel Arkadjevich,0,0,0,0
1668230156615,CSE 284,A00,114175,Gymrek; Melissa Ann,0,0,0,0
1668230157050,CSE 290,A00,102399,Chandraker; Manmohan Krishna,0,0,0,0
1668230157050,CSE 290,B00,102400,Vaccaro; Kristen Marie,0,0,25,25
1668230157050,CSE 290,C00,102414,Pannuto; Patrick William,0,0,25,25
1668230157050,CSE 290,D00,102427,Pevzner; Pavel Arkadjevich,0,0,0,0
1668230157050,CSE 290,E00,102429,Zhao; Jishen,0,0,0,0
1668230157050,CSE 290,F00,102436,Tullsen; Dean Michael,0,0,0,0
1668230157050,CSE 290,G00,102440,Christensen; Henrik I,0,0,20,20
1668230157480,CSE 291,A00,102443,Su; Hao,0,0,0,0
1668230157480,CSE 291,B00,102448,Polikarpova; Nadezhda,0,0,0,0
1668230157480,CSE 291,C00,102453,Vaccaro; Kristen Marie,0,0,0,0
1668230157480,CSE 291,D00,111343,Savage; Stefan,0,0,0,0
1668230157480,CSE 291,E00,116474,Claffy; Kimberly Claire,0,0,0,0
1668230157480,CSE 291,F00,116479,Pasquale; Joseph,0,0,0,0
1668230157914,CSE 293,001,119111,Bafna; Vineet,9999,0,9999,0
1668230157914,CSE 293,002,119118,Bellare; Mihir,9999,0,9999,0
1668230157914,CSE 293,003,119122,Berg-Kirkpatrick; Taylor D,9999,0,9999,0
1668230157914,CSE 293,004,119135,Christensen; Henrik I,9999,0,9999,0
1668230157914,CSE 293,005,119142,Cottrell; Garrison W,9999,0,9999,0
1668230157914,CSE 293,006,119146,Deutsch; Alin Bernard,9999,0,9999,0
1668230157914,CSE 293,007,119159,Esmaeilzadeh; Hadi,9999,0,9999,0
1668230157914,CSE 293,008,119166,Freund; Yoav,9999,0,9999,0
1668230157914,CSE 293,009,119170,Griswold; William G.,9999,0,9999,0
1668230157914,CSE 293,010,119183,Gymrek; Melissa Ann,9999,0,9999,0
1668230157914,CSE 293,011,119190,Heninger; Nadia A,9999,0,9999,0
1668230157914,CSE 293,012,119230,Impagliazzo; Russell,9999,0,9999,0
1668230157914,CSE 293,013,119232,Jhala; Ranjit,9999,0,9999,0
1668230157914,CSE 293,014,119233,Kahng; Andrew Byun,9999,0,9999,0
1668230157914,CSE 293,015,119298,Kane; Daniel Mertz,9999,0,9999,0
1668230157914,CSE 293,016,119299,Kriegman; David J,9999,0,9999,0
1668230157914,CSE 293,017,119300,Kumar; Arun Kumar,9999,0,9999,0
1668230157914,CSE 293,018,119301,Lerner; Sorin,9999,0,9999,0
1668230157914,CSE 293,019,119302,Lovett; Shachar,9999,0,9999,0
1668230157914,CSE 293,020,119303,McAuley; Julian John,9999,0,9999,0
1668230157914,CSE 293,021,119304,Micciancio; Daniele,9999,0,9999,0
1668230157914,CSE 293,022,119367,Orailoglu; Alex,9999,0,9999,0
1668230157914,CSE 293,023,119382,Paturi; Ramamohan,9999,0,9999,0
1668230157914,CSE 293,024,119404,Polikarpova; Nadezhda,9999,0,9999,0
1668230157914,CSE 293,025,119406,Politz; Joseph Gibbs,9999,0,9999,0
1668230157914,CSE 293,026,119411,Porter; George M,9999,0,9999,0
1668230157914,CSE 293,027,119414,Porter; Leonard Emerson,9999,0,9999,0
1668230157914,CSE 293,028,119416,Ramamoorthi; Ravi,9999,0,9999,0
1668230157914,CSE 293,029,119417,Sahoo; Debashis,9999,0,9999,0
1668230157914,CSE 293,030,119420,Saul; Lawrence,9999,0,9999,0
1668230157914,CSE 293,031,119421,Savage; Stefan,9999,0,9999,0
1668230157914,CSE 293,032,119425,Schulze; Jurgen P.,9999,0,9999,0
1668230157914,CSE 293,033,119426,Snoeren; Alex C.,9999,0,9999,0
1668230157914,CSE 293,034,119428,Shang; Jingbo,9999,0,9999,0
1668230157914,CSE 293,035,119430,Stefan; Deian,9999,0,9999,0
1668230157914,CSE 293,036,119431,Su; Hao,9999,0,9999,0
1668230157914,CSE 293,037,119433,Swanson; Steven James,9999,0,9999,0
1668230157914,CSE 293,038,119435,Tullsen; Dean Michael,9999,0,9999,0
1668230157914,CSE 293,039,119483,Voelker; Geoffrey M.,9999,0,9999,0
1668230157914,CSE 293,040,119537,Zhao; Jishen,9999,0,9999,0
1668230157914,CSE 293,041,119538,Zhou; Yuan-Yuan,9999,0,9999,0
1668230157914,CSE 293,042,119539,Gao; Sicun,9999,0,9999,0
1668230157914,CSE 293,043,119540,Weibel; Nadir,9999,0,9999,0
1668230157914,CSE 293,044,119541,Gupta; Rajesh K.,9999,0,9999,0
1668230157914,CSE 293,045,126410,Vaccaro; Kristen Marie,9999,0,9999,0
1668230157914,CSE 293,046,126411,Klemke; Richard,9999,0,9999,0
1668230158340,CSE 294,A00,102459,Voelker; Geoffrey M.,0,0,0,0
1668230158340,CSE 294,B00,111322,Orailoglu; Alex,0,0,0,0
1668230158769,DSE 201,A00,096914,Deutsch; Alin Bernard,30,0,30,0
1668230159192,DSE 210,A00,096915,Dasgupta; Sanjoy,30,0,30,0
1668230159618,DSE 260A,A00,096916,Altintas De Callaf; Ilkay,30,0,30,0
1668230160070,ECE 200,001,103586,Antipa; Nicholas A,9999,0,9999,0
1668230160070,ECE 200,002,103587,Atanasov; Nikolay A.,9999,0,9999,0
1668230160070,ECE 200,003,103588,Bharadia; Dinesh,9999,0,9999,0
1668230160070,ECE 200,004,103589,Cheng; Chung Kuan,9999,0,9999,0
1668230160070,ECE 200,005,103590,Cosman; Pamela C.,9999,0,9999,0
1668230160070,ECE 200,006,103591,Dayeh; Shadi Ahmad,9999,0,9999,0
1668230160070,ECE 200,007,103592,Fainman; Yeshaiahu,9999,0,9999,0
1668230160070,ECE 200,008,103593,Ford; Joseph Earl,9999,0,9999,0
1668230160070,ECE 200,009,103594,Franceschetti; Massimo,9999,0,9999,0
1668230160070,ECE 200,010,103595,Fullerton; Eric E,9999,0,9999,0
1668230160070,ECE 200,011,103596,Galton; Ian A,9999,0,9999,0
1668230160070,ECE 200,012,103597,Gilja; Vikash,9999,0,9999,0
1668230160070,ECE 200,013,103598,Hall; Drew A.,9999,0,9999,0
1668230160070,ECE 200,014,103599,Hsueh; Tzu-Chien,9999,0,9999,0
1668230160070,ECE 200,015,103600,Javidi; Tara,9999,0,9999,0
1668230160070,ECE 200,016,103601,Kahng; Andrew Byun,9999,0,9999,0
1668230160070,ECE 200,017,103602,Kim; Young-Han,9999,0,9999,0
1668230160070,ECE 200,018,103603,Koushanfar; Farinaz,9999,0,9999,0
1668230160070,ECE 200,019,103604,Kuzum; Duygu,9999,0,9999,0
1668230160070,ECE 200,020,103605,Le; Hanh-Phuc,9999,0,9999,0
1668230160070,ECE 200,021,103606,Lin; Bill,9999,0,9999,0
1668230160070,ECE 200,022,103607,Liu; Zhaowei,9998,0,9999,1
1668230160070,ECE 200,023,103608,Lo; Yu-Hwa,9999,0,9999,0
1668230160070,ECE 200,024,103609,Lomakin; Vitaliy,9999,0,9999,0
1668230160070,ECE 200,025,103610,Mercier; Patrick Philip,9999,0,9999,0
1668230160070,ECE 200,026,103611,Meyer; Florian,9999,0,9999,0
1668230160070,ECE 200,027,103612,Milstein; Laurence B.,9999,0,9999,0
1668230160070,ECE 200,028,103613,Mir Arabbaygi; Siavash,9999,0,9999,0
1668230160070,ECE 200,029,103614,Mookherjea; Shayan,9999,0,9999,0
1668230160070,ECE 200,030,103615,Morris; Karcher William,9999,0,9999,0
1668230160070,ECE 200,031,103616,Ng; Tse Nga,9999,0,9999,0
1668230160070,ECE 200,032,103617,Nguyen; Truong Quang,9999,0,9999,0
1668230160070,ECE 200,033,103618,Nomura; Kenji,9999,0,9999,0
1668230160070,ECE 200,034,103619,Orlitsky; Alon,9999,0,9999,0
1668230160070,ECE 200,035,103620,Pal; Piya,9999,0,9999,0
1668230160070,ECE 200,036,103621,Papen; George C.,9999,0,9999,0
1668230160070,ECE 200,037,103622,Radic; Stojan,9999,0,9999,0
1668230160070,ECE 200,038,103623,Rao; Bhaskar D.,9999,0,9999,0
1668230160070,ECE 200,039,103624,Rao; Ramesh R,9999,0,9999,0
1668230160070,ECE 200,040,103625,Rebeiz; Gabriel,9999,0,9999,0
1668230160070,ECE 200,041,103626,Sanford; John R,9999,0,9999,0
1668230160070,ECE 200,042,103627,Siegel; Paul H.,9999,0,9999,0
1668230160070,ECE 200,043,103628,Sievenpiper; Daniel F.,9999,0,9999,0
1668230160070,ECE 200,044,103629,Sworder; David D.,9999,0,9999,0
1668230160070,ECE 200,045,103630,Taur; Yuan,9999,0,9999,0
1668230160070,ECE 200,046,103631,Touri; Behrouz,9999,0,9999,0
1668230160070,ECE 200,047,103632,Trivedi; Mohan M.,9999,0,9999,0
1668230160070,ECE 200,048,103633,Vasconcelos; Nuno,9999,0,9999,0
1668230160070,ECE 200,049,103634,Wang; Xiaolong,9999,0,9999,0
1668230160070,ECE 200,050,103635,Xie; Pengtao,9999,0,9999,0
1668230160070,ECE 200,051,103636,Yip; Michael,9999,0,9999,0
1668230160070,ECE 200,052,103637,Zeger; Kenneth A.,999,0,999,0
1668230160070,ECE 200,053,103638,Zhang; Xinyu,9999,0,9999,0
1668230160070,ECE 200,054,103639,Turakhia; Yatish Girish,9999,0,9999,0
1668230160070,ECE 200,055,103640,Kang; Mingu,9999,0,9999,0
1668230160070,ECE 200,056,103641,Shi; Yuanyuan,9999,0,9999,0
1668230160070,ECE 200,057,103642,Wang; Edward Jay,9999,0,9999,0
1668230160070,ECE 200,058,103643,Zheng; Yang,9999,0,9999,0
1668230160499,ECE 202,A00,103644,Kuzum; Duygu,0,0,0,0
1668230160923,ECE 212BN,A00,103646,Ng; Tse Nga,0,0,0,0
1668230161351,ECE 221,A00,111493,Staff,0,0,0,0
1668230161779,ECE 222B,A00,103647,Lomakin; Vitaliy,0,0,0,0
1668230162214,ECE 230B,A00,103648,Taur; Yuan,0,0,0,0
1668230162646,ECE 238B,A00,103649,Garay; Javier,0,0,0,0
1668230163088,ECE 240B,A00,112900,Fainman; Yeshaiahu,0,0,0,0
1668230163510,ECE 247A,A00,103650,Jokerst; Jesse Vincent,0,0,0,0
1668230163935,ECE 247B,A00,103651,Wang; Joseph,0,0,0,0
1668230164362,ECE 250,A00,103652,Siegel; Paul H.,0,0,0,0
1668230164791,ECE 251A,A00,103654,Rao; Bhaskar D.,0,0,0,0
1668230165214,ECE 257B,A00,103655,Bharadia; Dinesh,0,0,0,0
1668230165643,ECE 258A,A00,103656,Milstein; Laurence B.,0,0,0,0
1668230166080,ECE 260B,A00,103658,Kang; Mingu,0,0,0,0
1668230166509,ECE 264A,A00,103659,Galton; Ian A,0,0,0,0
1668230166939,ECE 265A,A00,103661,Gudem; Prasad S.S.,0,0,0,0
1668230167363,ECE 265D,A00,103662,Gudem; Prasad S.S.,0,0,0,0
1668230167800,ECE 268,A00,103663,Koushanfar; Farinaz,0,0,0,0
1668230168233,ECE 269,A01,103665,Pal; Piya,0,0,0,0
1668230168655,ECE 271B,A00,103666,Vasconcelos; Manuela,0,0,0,0
1668230169079,ECE 276A,A00,103667,Atanasov; Nikolay A.,0,0,0,0
1668230169508,ECE 277,A00,103668,An; Cheolhong,0,0,0,0
1668230170021,ECE 279,A00,117947,Hall; Drew A.,0,0,0,0
1668230170866,ECE 283,A00,103670,Hsueh; Tzu-Chien,0,0,0,0
1668230171293,ECE 284,A00,103671,Turakhia; Yatish Girish,0,0,0,0
1668230171720,ECE 285,A00,103672,Zheng; Yang,0,0,0,0
1668230171720,ECE 285,B00,103673,Sworder; David D.,0,0,0,0
1668230172144,ECE 287,A00,103676,Javidi; Tara,0,0,0,0
1668230172567,MATH 200B,A00,098023,Salehi Golsefidy; Alireza,12,0,15,3
1668230172989,MATH 202B,A00,098024,Rhoades; Brendon Patrick,9,0,15,6
1668230173417,MATH 203B,A00,098025,Oprea; Dragos N.,10,0,15,5
1668230173840,MATH 204B,A00,098026,Sorensen; Claus M,13,0,15,2
1668230174263,MATH 208,A00,098027,Izadi; Elham,7,0,10,3
1668230174687,MATH 209,A00,098028,Pollack; Aaron,10,0,10,0
1668230175113,MATH 211A,A00,112919,Rogalski; Daniel,9,0,10,1
1668230175538,MATH 211B,A00,112920,Seward; Brandon M.,9,0,10,1
1668230175964,MATH 218,A00,098029,Li; Bo,10,0,10,0
1668230176389,MATH 220B,A00,098030,Novak; Jonathan I,11,0,15,4
1668230176811,MATH 221A,A00,098031,Ebenfelt; Peter F,13,0,15,2
1668230177238,MATH 231B,A00,098032,Zlatos; Andrej,12,0,15,3
1668230177662,MATH 240B,A00,098033,Ni; Lei,9,0,15,6
1668230178085,MATH 243,A00,098034,Jekel; David Andrew,10,0,10,0
1668230178516,MATH 245A,A00,098035,Nie; Jiawang,0,0,15,16
1668230178942,MATH 248,A00,098036,Bejenaru; Ioan,10,0,10,0
1668230179366,MATH 250B,A00,098037,Spolaor; Luca,14,0,15,1
1668230179789,MATH 258,A00,098038,Ni; Lei,10,0,10,0
1668230180212,MATH 264B,A00,098041,Rhoades; Brendon Patrick,9,0,15,6
1668230180637,MATH 268,A00,098042,Buss; Samuel R,10,0,10,0
1668230181061,MATH 269,A00,098043,Rhoades; Brendon Patrick,10,0,10,0
1668230181487,MATH 270B,A00,098044,Li; Bo,10,0,15,5
1668230181911,MATH 272B,A00,098045,Holst; Michael J,13,0,15,2
1668230182340,MATH 273A,A00,098046,Tian; Xiaochuan,10,0,15,5
1668230182778,MATH 275,A01,098048,Tian; Xiaochuan,6,0,10,4
1668230183202,MATH 278A,A00,098049,Holst; Michael J,8,0,10,2
1668230183625,MATH 278B,A00,098050,Cloninger; Alexander,10,0,10,0
1668230184047,MATH 278C,A00,098051,Nie; Jiawang,7,0,10,3
1668230184470,MATH 280B,A00,098052,Zheng; Tianyi,10,0,15,5
1668230184895,MATH 281B,A00,098053,Bradic; Jelena,2,0,15,13
1668230185318,MATH 282B,A00,098054,Arias-Castro; Ery,0,0,15,15
1668230185765,MATH 285,A00,098055,Fitzsimmons; Patrick J,0,0,15,17
1668230186189,MATH 287B,A00,098056,Arias-Castro; Ery,2,0,15,13
1668230186615,MATH 288,A00,098057,Agarwal; Pooja,9,0,10,1
1668230186615,MATH 288,B00,098058,Zhang; Danna,8,0,10,2
1668230186615,MATH 288,C00,098059,Williams; Ruth J,10,0,10,0
1668230187041,MATH 290B,A00,098060,Roberts; Justin Deritter,13,0,15,2
1668230187472,MATH 292,A00,098061,Belmont; Eva Kinoshita,10,0,10,0
1668230187899,MATH 295,A00,098062,Suk; Andrew Hoon,48,0,50,2
1668230188334,MATH 296,A00,098063,Novak; Jonathan I,20,0,20,0
1668230188761,MATH 297,001,098064,Gamst; Anthony Collins,9997,0,9999,2
1668230689892,COGS 205,A00,101395,Chiba; Andrea,19,0,20,1
1668230690314,COGS 210B,001,101404,Greene; Deanna Jacquelyn,9998,0,9999,1
1668230690314,COGS 210B,002,101417,Xia; Haijun,9999,0,9999,0
1668230690314,COGS 210B,003,101422,Nitz; Douglas A.,9999,0,9999,0
1668230690314,COGS 210B,004,101423,Hollan; James D.,9998,0,9999,1
1668230690314,COGS 210B,005,101424,Deak; Gedeon O.,9998,0,9999,1
1668230690314,COGS 210B,006,101425,Rossano; Federico,9999,0,9999,0
1668230690738,COGS 211B,A00,101427,Coulson; Seana M,9996,0,9999,3
1668230691268,COGS 220,A00,101428,Hollan; James D.,0,0,25,25
1668230691692,COGS 229,A00,101429,Dow; Steven P,18,0,25,7
1668230692115,COGS 230,A00,101430,Klemmer; Scott R,12,0,17,5
1668230692537,COGS 234,A00,101431,Xia; Haijun,2,0,25,23
1668230692970,COGS 260,A00,101432,Kiyonaga; Anastasia,21,0,25,4
1668230692970,COGS 260,B00,101433,Kirsh; David Joel,15,0,25,10
1668230693395,CSE 202,A00,102371,Impagliazzo; Russell,0,0,0,0
1668230693821,CSE 203B,A01,102373,Cheng; Chung Kuan,0,0,0,0
1668230694246,CSE 208,A00,102374,Micciancio; Daniele,0,0,0,0
1668230694670,CSE 209A,A00,112895,Impagliazzo; Russell,0,0,15,15
1668230695097,CSE 209B,A00,108005,Bellare; Mihir,0,0,0,0
1668230695533,CSE 210,A00,113163,Coblenz; Michael J,0,0,0,0
1668230695960,CSE 219,A00,106111,Dow; Steven P,0,0,20,20
1668230696383,CSE 221,A00,102376,Voelker; Geoffrey M.,0,0,0,0
1668230696808,CSE 224,A01,102378,Porter; George M,0,0,0,0
1668230697235,CSE 229A,A00,102379,Savage; Stefan,0,0,0,0
1668230697665,CSE 229C,A00,102380,Munyaka; Imani N. S.,0,0,0,0
1668230698089,CSE 232B,A00,102382,Deutsch; Alin Bernard,0,0,0,0
1668230698510,CSE 234,A01,112904,Kumar; Arun Kumar,0,0,0,0
1668230698935,CSE 237A,A00,102383,Rosing; Tajana Simunic,0,0,0,0
1668230699358,CSE 239A,A00,102384,Deutsch; Alin Bernard,0,0,0,0
1668230699785,CSE 239B,A00,102385,Polikarpova; Nadezhda,0,0,0,0
1668230700220,CSE 240A,A00,102386,Pannuto; Patrick William,0,0,0,0
1668230700657,CSE 240B,A00,102387,Zhao; Jishen,0,0,0,0
1668230701087,CSE 241A,A00,106406,Kang; Mingu,0,0,0,0
1668230701516,CSE 249B,A00,102388,Kahng; Andrew Byun,0,0,8,8
1668230701939,CSE 251B,A01,102392,Cottrell; Garrison W,0,0,0,0
1668230701939,CSE 251B,A02,102393,Cottrell; Garrison W,0,0,0,0
1668230702365,CSE 252B,A00,102394,Ochoa; Benjamin Lawrence,0,0,0,0
1668230702794,CSE 257,A01,102396,Gao; Sicun,0,0,0,0
1668230703229,CSE 272,A00,102397,Li; Tzumao,0,0,0,0
1668230703681,CSE 274,A00,111323,Chern; Albert Ren-Haur,0,0,0,0
1668230704107,CSE 282,A00,102398,Pevzner; Pavel Arkadjevich,0,0,0,0
1668230704531,CSE 284,A00,114175,Gymrek; Melissa Ann,0,0,0,0
1668230704959,CSE 290,A00,102399,Chandraker; Manmohan Krishna,0,0,0,0
1668230704959,CSE 290,B00,102400,Vaccaro; Kristen Marie,0,0,25,25
1668230704959,CSE 290,C00,102414,Pannuto; Patrick William,0,0,25,25
1668230704959,CSE 290,D00,102427,Pevzner; Pavel Arkadjevich,0,0,0,0
1668230704959,CSE 290,E00,102429,Zhao; Jishen,0,0,0,0
1668230704959,CSE 290,F00,102436,Tullsen; Dean Michael,0,0,0,0
1668230704959,CSE 290,G00,102440,Christensen; Henrik I,0,0,20,20
1668230705391,CSE 291,A00,102443,Su; Hao,0,0,0,0
1668230705391,CSE 291,B00,102448,Polikarpova; Nadezhda,0,0,0,0
1668230705391,CSE 291,C00,102453,Vaccaro; Kristen Marie,0,0,0,0
1668230705391,CSE 291,D00,111343,Savage; Stefan,0,0,0,0
1668230705391,CSE 291,E00,116474,Claffy; Kimberly Claire,0,0,0,0
1668230705391,CSE 291,F00,116479,Pasquale; Joseph,0,0,0,0
1668230705826,CSE 293,001,119111,Bafna; Vineet,9999,0,9999,0
1668230705826,CSE 293,002,119118,Bellare; Mihir,9999,0,9999,0
1668230705826,CSE 293,003,119122,Berg-Kirkpatrick; Taylor D,9999,0,9999,0
1668230705826,CSE 293,004,119135,Christensen; Henrik I,9999,0,9999,0
1668230705826,CSE 293,005,119142,Cottrell; Garrison W,9999,0,9999,0
1668230705826,CSE 293,006,119146,Deutsch; Alin Bernard,9999,0,9999,0
1668230705826,CSE 293,007,119159,Esmaeilzadeh; Hadi,9999,0,9999,0
1668230705826,CSE 293,008,119166,Freund; Yoav,9999,0,9999,0
1668230705826,CSE 293,009,119170,Griswold; William G.,9999,0,9999,0
1668230705826,CSE 293,010,119183,Gymrek; Melissa Ann,9999,0,9999,0
1668230705826,CSE 293,011,119190,Heninger; Nadia A,9999,0,9999,0
1668230705826,CSE 293,012,119230,Impagliazzo; Russell,9999,0,9999,0
1668230705826,CSE 293,013,119232,Jhala; Ranjit,9999,0,9999,0
1668230705826,CSE 293,014,119233,Kahng; Andrew Byun,9999,0,9999,0
1668230705826,CSE 293,015,119298,Kane; Daniel Mertz,9999,0,9999,0
1668230705826,CSE 293,016,119299,Kriegman; David J,9999,0,9999,0
1668230705826,CSE 293,017,119300,Kumar; Arun Kumar,9999,0,9999,0
1668230705826,CSE 293,018,119301,Lerner; Sorin,9999,0,9999,0
1668230705826,CSE 293,019,119302,Lovett; Shachar,9999,0,9999,0
1668230705826,CSE 293,020,119303,McAuley; Julian John,9999,0,9999,0
1668230705826,CSE 293,021,119304,Micciancio; Daniele,9999,0,9999,0
1668230705826,CSE 293,022,119367,Orailoglu; Alex,9999,0,9999,0
1668230705826,CSE 293,023,119382,Paturi; Ramamohan,9999,0,9999,0
1668230705826,CSE 293,024,119404,Polikarpova; Nadezhda,9999,0,9999,0
1668230705826,CSE 293,025,119406,Politz; Joseph Gibbs,9999,0,9999,0
1668230705826,CSE 293,026,119411,Porter; George M,9999,0,9999,0
1668230705826,CSE 293,027,119414,Porter; Leonard Emerson,9999,0,9999,0
1668230705826,CSE 293,028,119416,Ramamoorthi; Ravi,9999,0,9999,0
1668230705826,CSE 293,029,119417,Sahoo; Debashis,9999,0,9999,0
1668230705826,CSE 293,030,119420,Saul; Lawrence,9999,0,9999,0
1668230705826,CSE 293,031,119421,Savage; Stefan,9999,0,9999,0
1668230705826,CSE 293,032,119425,Schulze; Jurgen P.,9999,0,9999,0
1668230705826,CSE 293,033,119426,Snoeren; Alex C.,9999,0,9999,0
1668230705826,CSE 293,034,119428,Shang; Jingbo,9999,0,9999,0
1668230705826,CSE 293,035,119430,Stefan; Deian,9999,0,9999,0
1668230705826,CSE 293,036,119431,Su; Hao,9999,0,9999,0
1668230705826,CSE 293,037,119433,Swanson; Steven James,9999,0,9999,0
1668230705826,CSE 293,038,119435,Tullsen; Dean Michael,9999,0,9999,0
1668230705826,CSE 293,039,119483,Voelker; Geoffrey M.,9999,0,9999,0
1668230705826,CSE 293,040,119537,Zhao; Jishen,9999,0,9999,0
1668230705826,CSE 293,041,119538,Zhou; Yuan-Yuan,9999,0,9999,0
1668230705826,CSE 293,042,119539,Gao; Sicun,9999,0,9999,0
1668230705826,CSE 293,043,119540,Weibel; Nadir,9999,0,9999,0
1668230705826,CSE 293,044,119541,Gupta; Rajesh K.,9999,0,9999,0
1668230705826,CSE 293,045,126410,Vaccaro; Kristen Marie,9999,0,9999,0
1668230705826,CSE 293,046,126411,Klemke; Richard,9999,0,9999,0
1668230706249,CSE 294,A00,102459,Voelker; Geoffrey M.,0,0,0,0
1668230706249,CSE 294,B00,111322,Orailoglu; Alex,0,0,0,0
1668230706673,DSE 201,A00,096914,Deutsch; Alin Bernard,30,0,30,0
1668230707100,DSE 210,A00,096915,Dasgupta; Sanjoy,30,0,30,0
1668230707537,DSE 260A,A00,096916,Altintas De Callaf; Ilkay,30,0,30,0
1668230707967,ECE 200,001,103586,Antipa; Nicholas A,9999,0,9999,0
1668230707967,ECE 200,002,103587,Atanasov; Nikolay A.,9999,0,9999,0
1668230707967,ECE 200,003,103588,Bharadia; Dinesh,9999,0,9999,0
1668230707967,ECE 200,004,103589,Cheng; Chung Kuan,9999,0,9999,0
1668230707967,ECE 200,005,103590,Cosman; Pamela C.,9999,0,9999,0
1668230707967,ECE 200,006,103591,Dayeh; Shadi Ahmad,9999,0,9999,0
1668230707967,ECE 200,007,103592,Fainman; Yeshaiahu,9999,0,9999,0
1668230707967,ECE 200,008,103593,Ford; Joseph Earl,9999,0,9999,0
1668230707967,ECE 200,009,103594,Franceschetti; Massimo,9999,0,9999,0
1668230707967,ECE 200,010,103595,Fullerton; Eric E,9999,0,9999,0
1668230707967,ECE 200,011,103596,Galton; Ian A,9999,0,9999,0
1668230707967,ECE 200,012,103597,Gilja; Vikash,9999,0,9999,0
1668230707967,ECE 200,013,103598,Hall; Drew A.,9999,0,9999,0
1668230707967,ECE 200,014,103599,Hsueh; Tzu-Chien,9999,0,9999,0
1668230707967,ECE 200,015,103600,Javidi; Tara,9999,0,9999,0
1668230707967,ECE 200,016,103601,Kahng; Andrew Byun,9999,0,9999,0
1668230707967,ECE 200,017,103602,Kim; Young-Han,9999,0,9999,0
1668230707967,ECE 200,018,103603,Koushanfar; Farinaz,9999,0,9999,0
1668230707967,ECE 200,019,103604,Kuzum; Duygu,9999,0,9999,0
1668230707967,ECE 200,020,103605,Le; Hanh-Phuc,9999,0,9999,0
1668230707967,ECE 200,021,103606,Lin; Bill,9999,0,9999,0
1668230707967,ECE 200,022,103607,Liu; Zhaowei,9998,0,9999,1
1668230707967,ECE 200,023,103608,Lo; Yu-Hwa,9999,0,9999,0
1668230707967,ECE 200,024,103609,Lomakin; Vitaliy,9999,0,9999,0
1668230707967,ECE 200,025,103610,Mercier; Patrick Philip,9999,0,9999,0
1668230707967,ECE 200,026,103611,Meyer; Florian,9999,0,9999,0
1668230707967,ECE 200,027,103612,Milstein; Laurence B.,9999,0,9999,0
1668230707967,ECE 200,028,103613,Mir Arabbaygi; Siavash,9999,0,9999,0
1668230707967,ECE 200,029,103614,Mookherjea; Shayan,9999,0,9999,0
1668230707967,ECE 200,030,103615,Morris; Karcher William,9999,0,9999,0
1668230707967,ECE 200,031,103616,Ng; Tse Nga,9999,0,9999,0
1668230707967,ECE 200,032,103617,Nguyen; Truong Quang,9999,0,9999,0
1668230707967,ECE 200,033,103618,Nomura; Kenji,9999,0,9999,0
1668230707967,ECE 200,034,103619,Orlitsky; Alon,9999,0,9999,0
1668230707967,ECE 200,035,103620,Pal; Piya,9999,0,9999,0
1668230707967,ECE 200,036,103621,Papen; George C.,9999,0,9999,0
1668230707967,ECE 200,037,103622,Radic; Stojan,9999,0,9999,0
1668230707967,ECE 200,038,103623,Rao; Bhaskar D.,9999,0,9999,0
1668230707967,ECE 200,039,103624,Rao; Ramesh R,9999,0,9999,0
1668230707967,ECE 200,040,103625,Rebeiz; Gabriel,9999,0,9999,0
1668230707967,ECE 200,041,103626,Sanford; John R,9999,0,9999,0
1668230707967,ECE 200,042,103627,Siegel; Paul H.,9999,0,9999,0
1668230707967,ECE 200,043,103628,Sievenpiper; Daniel F.,9999,0,9999,0
1668230707967,ECE 200,044,103629,Sworder; David D.,9999,0,9999,0
1668230707967,ECE 200,045,103630,Taur; Yuan,9999,0,9999,0
1668230707967,ECE 200,046,103631,Touri; Behrouz,9999,0,9999,0
1668230707967,ECE 200,047,103632,Trivedi; Mohan M.,9999,0,9999,0
1668230707967,ECE 200,048,103633,Vasconcelos; Nuno,9999,0,9999,0
1668230707967,ECE 200,049,103634,Wang; Xiaolong,9999,0,9999,0
1668230707967,ECE 200,050,103635,Xie; Pengtao,9999,0,9999,0
1668230707967,ECE 200,051,103636,Yip; Michael,9999,0,9999,0
1668230707967,ECE 200,052,103637,Zeger; Kenneth A.,999,0,999,0
1668230707967,ECE 200,053,103638,Zhang; Xinyu,9999,0,9999,0
1668230707967,ECE 200,054,103639,Turakhia; Yatish Girish,9999,0,9999,0
1668230707967,ECE 200,055,103640,Kang; Mingu,9999,0,9999,0
1668230707967,ECE 200,056,103641,Shi; Yuanyuan,9999,0,9999,0
1668230707967,ECE 200,057,103642,Wang; Edward Jay,9999,0,9999,0
1668230707967,ECE 200,058,103643,Zheng; Yang,9999,0,9999,0
1668230708393,ECE 202,A00,103644,Kuzum; Duygu,0,0,0,0
1668230708820,ECE 212BN,A00,103646,Ng; Tse Nga,0,0,0,0
1668230709242,ECE 221,A00,111493,Staff,0,0,0,0
1668230709665,ECE 222B,A00,103647,Lomakin; Vitaliy,0,0,0,0
1668230710091,ECE 230B,A00,103648,Taur; Yuan,0,0,0,0
1668230710529,ECE 238B,A00,103649,Garay; Javier,0,0,0,0
1668230710954,ECE 240B,A00,112900,Fainman; Yeshaiahu,0,0,0,0
1668230711379,ECE 247A,A00,103650,Jokerst; Jesse Vincent,0,0,0,0
1668230711803,ECE 247B,A00,103651,Wang; Joseph,0,0,0,0
1668230712229,ECE 250,A00,103652,Siegel; Paul H.,0,0,0,0
1668230712654,ECE 251A,A00,103654,Rao; Bhaskar D.,0,0,0,0
1668230713077,ECE 257B,A00,103655,Bharadia; Dinesh,0,0,0,0
1668230713502,ECE 258A,A00,103656,Milstein; Laurence B.,0,0,0,0
1668230713926,ECE 260B,A00,103658,Kang; Mingu,0,0,0,0
1668230714349,ECE 264A,A00,103659,Galton; Ian A,0,0,0,0
1668230714772,ECE 265A,A00,103661,Gudem; Prasad S.S.,0,0,0,0
1668230715193,ECE 265D,A00,103662,Gudem; Prasad S.S.,0,0,0,0
1668230715618,ECE 268,A00,103663,Koushanfar; Farinaz,0,0,0,0
1668230716044,ECE 269,A01,103665,Pal; Piya,0,0,0,0
1668230716471,ECE 271B,A00,103666,Vasconcelos; Manuela,0,0,0,0
1668230716893,ECE 276A,A00,103667,Atanasov; Nikolay A.,0,0,0,0
1668230717315,ECE 277,A00,103668,An; Cheolhong,0,0,0,0
1668230717742,ECE 279,A00,117947,Hall; Drew A.,0,0,0,0
1668230718600,ECE 283,A00,103670,Hsueh; Tzu-Chien,0,0,0,0
1668230719026,ECE 284,A00,103671,Turakhia; Yatish Girish,0,0,0,0
1668230719454,ECE 285,A00,103672,Zheng; Yang,0,0,0,0
1668230719454,ECE 285,B00,103673,Sworder; David D.,0,0,0,0
1668230719885,ECE 287,A00,103676,Javidi; Tara,0,0,0,0
1668230720312,MATH 200B,A00,098023,Salehi Golsefidy; Alireza,12,0,15,3
1668230720739,MATH 202B,A00,098024,Rhoades; Brendon Patrick,9,0,15,6
1668230721164,MATH 203B,A00,098025,Oprea; Dragos N.,10,0,15,5
1668230721607,MATH 204B,A00,098026,Sorensen; Claus M,13,0,15,2
1668230722041,MATH 208,A00,098027,Izadi; Elham,7,0,10,3
1668230722471,MATH 209,A00,098028,Pollack; Aaron,10,0,10,0
1668230722899,MATH 211A,A00,112919,Rogalski; Daniel,9,0,10,1
1668230723326,MATH 211B,A00,112920,Seward; Brandon M.,9,0,10,1
1668230723749,MATH 218,A00,098029,Li; Bo,10,0,10,0
1668230724171,MATH 220B,A00,098030,Novak; Jonathan I,11,0,15,4
1668230724604,MATH 221A,A00,098031,Ebenfelt; Peter F,13,0,15,2
1668230725031,MATH 231B,A00,098032,Zlatos; Andrej,12,0,15,3
1668230725454,MATH 240B,A00,098033,Ni; Lei,9,0,15,6
1668230725885,MATH 243,A00,098034,Jekel; David Andrew,10,0,10,0
1668230726315,MATH 245A,A00,098035,Nie; Jiawang,0,0,15,16
1668230726738,MATH 248,A00,098036,Bejenaru; Ioan,10,0,10,0
1668230727162,MATH 250B,A00,098037,Spolaor; Luca,14,0,15,1
1668230727587,MATH 258,A00,098038,Ni; Lei,10,0,10,0
1668230728012,MATH 264B,A00,098041,Rhoades; Brendon Patrick,9,0,15,6
1668230728435,MATH 268,A00,098042,Buss; Samuel R,10,0,10,0
1668230728862,MATH 269,A00,098043,Rhoades; Brendon Patrick,10,0,10,0
1668230729287,MATH 270B,A00,098044,Li; Bo,10,0,15,5
1668230729712,MATH 272B,A00,098045,Holst; Michael J,13,0,15,2
1668230730134,MATH 273A,A00,098046,Tian; Xiaochuan,10,0,15,5
1668230730559,MATH 275,A01,098048,Tian; Xiaochuan,6,0,10,4
1668230730983,MATH 278A,A00,098049,Holst; Michael J,8,0,10,2
1668230731405,MATH 278B,A00,098050,Cloninger; Alexander,10,0,10,0
1668230731831,MATH 278C,A00,098051,Nie; Jiawang,7,0,10,3
1668230732255,MATH 280B,A00,098052,Zheng; Tianyi,10,0,15,5
1668230732679,MATH 281B,A00,098053,Bradic; Jelena,2,0,15,13
1668230733106,MATH 282B,A00,098054,Arias-Castro; Ery,0,0,15,15
1668230733531,MATH 285,A00,098055,Fitzsimmons; Patrick J,0,0,15,17
1668230733955,MATH 287B,A00,098056,Arias-Castro; Ery,2,0,15,13
1668230734474,MATH 288,A00,098057,Agarwal; Pooja,9,0,10,1
1668230734474,MATH 288,B00,098058,Zhang; Danna,8,0,10,2
1668230734474,MATH 288,C00,098059,Williams; Ruth J,10,0,10,0
1668230734906,MATH 290B,A00,098060,Roberts; Justin Deritter,13,0,15,2
1668230735332,MATH 292,A00,098061,Belmont; Eva Kinoshita,10,0,10,0
1668230735756,MATH 295,A00,098062,Suk; Andrew Hoon,48,0,50,2
1668230736186,MATH 296,A00,098063,Novak; Jonathan I,20,0,20,0
1668230736610,MATH 297,001,098064,Gamst; Anthony Collins,9997,0,9999,2
1668231236345,COGS 205,A00,101395,Chiba; Andrea,19,0,20,1
1668231236768,COGS 210B,001,101404,Greene; Deanna Jacquelyn,9998,0,9999,1
1668231236768,COGS 210B,002,101417,Xia; Haijun,9999,0,9999,0
1668231236768,COGS 210B,003,101422,Nitz; Douglas A.,9999,0,9999,0
1668231236768,COGS 210B,004,101423,Hollan; James D.,9998,0,9999,1
1668231236768,COGS 210B,005,101424,Deak; Gedeon O.,9998,0,9999,1
1668231236768,COGS 210B,006,101425,Rossano; Federico,9999,0,9999,0
1668231237196,COGS 211B,A00,101427,Coulson; Seana M,9996,0,9999,3
1668231237618,COGS 220,A00,101428,Hollan; James D.,0,0,25,25
1668231238057,COGS 229,A00,101429,Dow; Steven P,18,0,25,7
1668231238493,COGS 230,A00,101430,Klemmer; Scott R,12,0,17,5
1668231238916,COGS 234,A00,101431,Xia; Haijun,2,0,25,23
1668231239341,COGS 260,A00,101432,Kiyonaga; Anastasia,21,0,25,4
1668231239341,COGS 260,B00,101433,Kirsh; David Joel,15,0,25,10
1668231239763,CSE 202,A00,102371,Impagliazzo; Russell,0,0,0,0
1668231240199,CSE 203B,A01,102373,Cheng; Chung Kuan,0,0,0,0
1668231240625,CSE 208,A00,102374,Micciancio; Daniele,0,0,0,0
1668231241050,CSE 209A,A00,112895,Impagliazzo; Russell,0,0,15,15
1668231241474,CSE 209B,A00,108005,Bellare; Mihir,0,0,0,0
1668231241899,CSE 210,A00,113163,Coblenz; Michael J,0,0,0,0
1668231242336,CSE 219,A00,106111,Dow; Steven P,0,0,20,20
1668231242759,CSE 221,A00,102376,Voelker; Geoffrey M.,0,0,0,0
1668231243189,CSE 224,A01,102378,Porter; George M,0,0,0,0
1668231243619,CSE 229A,A00,102379,Savage; Stefan,0,0,0,0
1668231244059,CSE 229C,A00,102380,Munyaka; Imani N. S.,0,0,0,0
1668231244483,CSE 232B,A00,102382,Deutsch; Alin Bernard,0,0,0,0
1668231244909,CSE 234,A01,112904,Kumar; Arun Kumar,0,0,0,0
1668231245334,CSE 237A,A00,102383,Rosing; Tajana Simunic,0,0,0,0
1668231245760,CSE 239A,A00,102384,Deutsch; Alin Bernard,0,0,0,0
1668231246184,CSE 239B,A00,102385,Polikarpova; Nadezhda,0,0,0,0
1668231246607,CSE 240A,A00,102386,Pannuto; Patrick William,0,0,0,0
1668231247034,CSE 240B,A00,102387,Zhao; Jishen,0,0,0,0
1668231247457,CSE 241A,A00,106406,Kang; Mingu,0,0,0,0
1668231247881,CSE 249B,A00,102388,Kahng; Andrew Byun,0,0,8,8
1668231248302,CSE 251B,A01,102392,Cottrell; Garrison W,0,0,0,0
1668231248302,CSE 251B,A02,102393,Cottrell; Garrison W,0,0,0,0
1668231248727,CSE 252B,A00,102394,Ochoa; Benjamin Lawrence,0,0,0,0
1668231249151,CSE 257,A01,102396,Gao; Sicun,0,0,0,0
1668231249576,CSE 272,A00,102397,Li; Tzumao,0,0,0,0
1668231250001,CSE 274,A00,111323,Chern; Albert Ren-Haur,0,0,0,0
1668231250432,CSE 282,A00,102398,Pevzner; Pavel Arkadjevich,0,0,0,0
1668231250860,CSE 284,A00,114175,Gymrek; Melissa Ann,0,0,0,0
1668231251290,CSE 290,A00,102399,Chandraker; Manmohan Krishna,0,0,0,0
1668231251290,CSE 290,B00,102400,Vaccaro; Kristen Marie,0,0,25,25
1668231251290,CSE 290,C00,102414,Pannuto; Patrick William,0,0,25,25
1668231251290,CSE 290,D00,102427,Pevzner; Pavel Arkadjevich,0,0,0,0
1668231251290,CSE 290,E00,102429,Zhao; Jishen,0,0,0,0
1668231251290,CSE 290,F00,102436,Tullsen; Dean Michael,0,0,0,0
1668231251290,CSE 290,G00,102440,Christensen; Henrik I,0,0,20,20
1668231251715,CSE 291,A00,102443,Su; Hao,0,0,0,0
1668231251715,CSE 291,B00,102448,Polikarpova; Nadezhda,0,0,0,0
1668231251715,CSE 291,C00,102453,Vaccaro; Kristen Marie,0,0,0,0
1668231251715,CSE 291,D00,111343,Savage; Stefan,0,0,0,0
1668231251715,CSE 291,E00,116474,Claffy; Kimberly Claire,0,0,0,0
1668231251715,CSE 291,F00,116479,Pasquale; Joseph,0,0,0,0
1668231252151,CSE 293,001,119111,Bafna; Vineet,9999,0,9999,0
1668231252151,CSE 293,002,119118,Bellare; Mihir,9999,0,9999,0
1668231252151,CSE 293,003,119122,Berg-Kirkpatrick; Taylor D,9999,0,9999,0
1668231252151,CSE 293,004,119135,Christensen; Henrik I,9999,0,9999,0
1668231252151,CSE 293,005,119142,Cottrell; Garrison W,9999,0,9999,0
1668231252151,CSE 293,006,119146,Deutsch; Alin Bernard,9999,0,9999,0
1668231252151,CSE 293,007,119159,Esmaeilzadeh; Hadi,9999,0,9999,0
1668231252151,CSE 293,008,119166,Freund; Yoav,9999,0,9999,0
1668231252151,CSE 293,009,119170,Griswold; William G.,9999,0,9999,0
1668231252151,CSE 293,010,119183,Gymrek; Melissa Ann,9999,0,9999,0
1668231252151,CSE 293,011,119190,Heninger; Nadia A,9999,0,9999,0
1668231252151,CSE 293,012,119230,Impagliazzo; Russell,9999,0,9999,0
1668231252151,CSE 293,013,119232,Jhala; Ranjit,9999,0,9999,0
1668231252151,CSE 293,014,119233,Kahng; Andrew Byun,9999,0,9999,0
1668231252151,CSE 293,015,119298,Kane; Daniel Mertz,9999,0,9999,0
1668231252151,CSE 293,016,119299,Kriegman; David J,9999,0,9999,0
1668231252151,CSE 293,017,119300,Kumar; Arun Kumar,9999,0,9999,0
1668231252151,CSE 293,018,119301,Lerner; Sorin,9999,0,9999,0
1668231252151,CSE 293,019,119302,Lovett; Shachar,9999,0,9999,0
1668231252151,CSE 293,020,119303,McAuley; Julian John,9999,0,9999,0
1668231252151,CSE 293,021,119304,Micciancio; Daniele,9999,0,9999,0
1668231252151,CSE 293,022,119367,Orailoglu; Alex,9999,0,9999,0
1668231252151,CSE 293,023,119382,Paturi; Ramamohan,9999,0,9999,0
1668231252151,CSE 293,024,119404,Polikarpova; Nadezhda,9999,0,9999,0
1668231252151,CSE 293,025,119406,Politz; Joseph Gibbs,9999,0,9999,0
1668231252151,CSE 293,026,119411,Porter; George M,9999,0,9999,0
1668231252151,CSE 293,027,119414,Porter; Leonard Emerson,9999,0,9999,0
1668231252151,CSE 293,028,119416,Ramamoorthi; Ravi,9999,0,9999,0
1668231252151,CSE 293,029,119417,Sahoo; Debashis,9999,0,9999,0
1668231252151,CSE 293,030,119420,Saul; Lawrence,9999,0,9999,0
1668231252151,CSE 293,031,119421,Savage; Stefan,9999,0,9999,0
1668231252151,CSE 293,032,119425,Schulze; Jurgen P.,9999,0,9999,0
1668231252151,CSE 293,033,119426,Snoeren; Alex C.,9999,0,9999,0
1668231252151,CSE 293,034,119428,Shang; Jingbo,9999,0,9999,0
1668231252151,CSE 293,035,119430,Stefan; Deian,9999,0,9999,0
1668231252151,CSE 293,036,119431,Su; Hao,9999,0,9999,0
1668231252151,CSE 293,037,119433,Swanson; Steven James,9999,0,9999,0
1668231252151,CSE 293,038,119435,Tullsen; Dean Michael,9999,0,9999,0
1668231252151,CSE 293,039,119483,Voelker; Geoffrey M.,9999,0,9999,0
1668231252151,CSE 293,040,119537,Zhao; Jishen,9999,0,9999,0
1668231252151,CSE 293,041,119538,Zhou; Yuan-Yuan,9999,0,9999,0
1668231252151,CSE 293,042,119539,Gao; Sicun,9999,0,9999,0
1668231252151,CSE 293,043,119540,Weibel; Nadir,9999,0,9999,0
1668231252151,CSE 293,044,119541,Gupta; Rajesh K.,9999,0,9999,0
1668231252151,CSE 293,045,126410,Vaccaro; Kristen Marie,9999,0,9999,0
1668231252151,CSE 293,046,126411,Klemke; Richard,9999,0,9999,0
1668231252576,CSE 294,A00,102459,Voelker; Geoffrey M.,0,0,0,0
1668231252576,CSE 294,B00,111322,Orailoglu; Alex,0,0,0,0
1668231253013,DSE 201,A00,096914,Deutsch; Alin Bernard,30,0,30,0
1668231253445,DSE 210,A00,096915,Dasgupta; Sanjoy,30,0,30,0
1668231253869,DSE 260A,A00,096916,Altintas De Callaf; Ilkay,30,0,30,0
1668231254419,ECE 200,001,103586,Antipa; Nicholas A,9999,0,9999,0
1668231254419,ECE 200,002,103587,Atanasov; Nikolay A.,9999,0,9999,0
1668231254419,ECE 200,003,103588,Bharadia; Dinesh,9999,0,9999,0
1668231254419,ECE 200,004,103589,Cheng; Chung Kuan,9999,0,9999,0
1668231254419,ECE 200,005,103590,Cosman; Pamela C.,9999,0,9999,0
1668231254419,ECE 200,006,103591,Dayeh; Shadi Ahmad,9999,0,9999,0
1668231254419,ECE 200,007,103592,Fainman; Yeshaiahu,9999,0,9999,0
1668231254419,ECE 200,008,103593,Ford; Joseph Earl,9999,0,9999,0
1668231254419,ECE 200,009,103594,Franceschetti; Massimo,9999,0,9999,0
1668231254419,ECE 200,010,103595,Fullerton; Eric E,9999,0,9999,0
1668231254419,ECE 200,011,103596,Galton; Ian A,9999,0,9999,0
1668231254419,ECE 200,012,103597,Gilja; Vikash,9999,0,9999,0
1668231254419,ECE 200,013,103598,Hall; Drew A.,9999,0,9999,0
1668231254419,ECE 200,014,103599,Hsueh; Tzu-Chien,9999,0,9999,0
1668231254419,ECE 200,015,103600,Javidi; Tara,9999,0,9999,0
1668231254419,ECE 200,016,103601,Kahng; Andrew Byun,9999,0,9999,0
1668231254419,ECE 200,017,103602,Kim; Young-Han,9999,0,9999,0
1668231254419,ECE 200,018,103603,Koushanfar; Farinaz,9999,0,9999,0
1668231254419,ECE 200,019,103604,Kuzum; Duygu,9999,0,9999,0
1668231254419,ECE 200,020,103605,Le; Hanh-Phuc,9999,0,9999,0
1668231254419,ECE 200,021,103606,Lin; Bill,9999,0,9999,0
1668231254419,ECE 200,022,103607,Liu; Zhaowei,9998,0,9999,1
1668231254419,ECE 200,023,103608,Lo; Yu-Hwa,9999,0,9999,0
1668231254419,ECE 200,024,103609,Lomakin; Vitaliy,9999,0,9999,0
1668231254419,ECE 200,025,103610,Mercier; Patrick Philip,9999,0,9999,0
1668231254419,ECE 200,026,103611,Meyer; Florian,9999,0,9999,0
1668231254419,ECE 200,027,103612,Milstein; Laurence B.,9999,0,9999,0
1668231254419,ECE 200,028,103613,Mir Arabbaygi; Siavash,9999,0,9999,0
1668231254419,ECE 200,029,103614,Mookherjea; Shayan,9999,0,9999,0
1668231254419,ECE 200,030,103615,Morris; Karcher William,9999,0,9999,0
1668231254419,ECE 200,031,103616,Ng; Tse Nga,9999,0,9999,0
1668231254419,ECE 200,032,103617,Nguyen; Truong Quang,9999,0,9999,0
1668231254419,ECE 200,033,103618,Nomura; Kenji,9999,0,9999,0
1668231254419,ECE 200,034,103619,Orlitsky; Alon,9999,0,9999,0
1668231254419,ECE 200,035,103620,Pal; Piya,9999,0,9999,0
1668231254419,ECE 200,036,103621,Papen; George C.,9999,0,9999,0
1668231254419,ECE 200,037,103622,Radic; Stojan,9999,0,9999,0
1668231254419,ECE 200,038,103623,Rao; Bhaskar D.,9999,0,9999,0
1668231254419,ECE 200,039,103624,Rao; Ramesh R,9999,0,9999,0
1668231254419,ECE 200,040,103625,Rebeiz; Gabriel,9999,0,9999,0
1668231254419,ECE 200,041,103626,Sanford; John R,9999,0,9999,0
1668231254419,ECE 200,042,103627,Siegel; Paul H.,9999,0,9999,0
1668231254419,ECE 200,043,103628,Sievenpiper; Daniel F.,9999,0,9999,0
1668231254419,ECE 200,044,103629,Sworder; David D.,9999,0,9999,0
1668231254419,ECE 200,045,103630,Taur; Yuan,9999,0,9999,0
1668231254419,ECE 200,046,103631,Touri; Behrouz,9999,0,9999,0
1668231254419,ECE 200,047,103632,Trivedi; Mohan M.,9999,0,9999,0
1668231254419,ECE 200,048,103633,Vasconcelos; Nuno,9999,0,9999,0
1668231254419,ECE 200,049,103634,Wang; Xiaolong,9999,0,9999,0
1668231254419,ECE 200,050,103635,Xie; Pengtao,9999,0,9999,0
1668231254419,ECE 200,051,103636,Yip; Michael,9999,0,9999,0
1668231254419,ECE 200,052,103637,Zeger; Kenneth A.,999,0,999,0
1668231254419,ECE 200,053,103638,Zhang; Xinyu,9999,0,9999,0
1668231254419,ECE 200,054,103639,Turakhia; Yatish Girish,9999,0,9999,0
1668231254419,ECE 200,055,103640,Kang; Mingu,9999,0,9999,0
1668231254419,ECE 200,056,103641,Shi; Yuanyuan,9999,0,9999,0
1668231254419,ECE 200,057,103642,Wang; Edward Jay,9999,0,9999,0
1668231254419,ECE 200,058,103643,Zheng; Yang,9999,0,9999,0
1668231254857,ECE 202,A00,103644,Kuzum; Duygu,0,0,0,0
1668231255282,ECE 212BN,A00,103646,Ng; Tse Nga,0,0,0,0
1668231255706,ECE 221,A00,111493,Staff,0,0,0,0
1668231256134,ECE 222B,A00,103647,Lomakin; Vitaliy,0,0,0,0
1668231256558,ECE 230B,A00,103648,Taur; Yuan,0,0,0,0
1668231256981,ECE 238B,A00,103649,Garay; Javier,0,0,0,0
1668231257403,ECE 240B,A00,112900,Fainman; Yeshaiahu,0,0,0,0
1668231257828,ECE 247A,A00,103650,Jokerst; Jesse Vincent,0,0,0,0
1668231258267,ECE 247B,A00,103651,Wang; Joseph,0,0,0,0
1668231258699,ECE 250,A00,103652,Siegel; Paul H.,0,0,0,0
1668231259124,ECE 251A,A00,103654,Rao; Bhaskar D.,0,0,0,0
1668231259549,ECE 257B,A00,103655,Bharadia; Dinesh,0,0,0,0
1668231259974,ECE 258A,A00,103656,Milstein; Laurence B.,0,0,0,0
1668231260412,ECE 260B,A00,103658,Kang; Mingu,0,0,0,0
1668231260836,ECE 264A,A00,103659,Galton; Ian A,0,0,0,0
1668231261260,ECE 265A,A00,103661,Gudem; Prasad S.S.,0,0,0,0
1668231261684,ECE 265D,A00,103662,Gudem; Prasad S.S.,0,0,0,0
1668231262114,ECE 268,A00,103663,Koushanfar; Farinaz,0,0,0,0
1668231262538,ECE 269,A01,103665,Pal; Piya,0,0,0,0
1668231262961,ECE 271B,A00,103666,Vasconcelos; Manuela,0,0,0,0
1668231263389,ECE 276A,A00,103667,Atanasov; Nikolay A.,0,0,0,0
1668231263816,ECE 277,A00,103668,An; Cheolhong,0,0,0,0
1668231264240,ECE 279,A00,117947,Hall; Drew A.,0,0,0,0
1668231265090,ECE 283,A00,103670,Hsueh; Tzu-Chien,0,0,0,0
1668231265514,ECE 284,A00,103671,Turakhia; Yatish Girish,0,0,0,0
1668231265941,ECE 285,A00,103672,Zheng; Yang,0,0,0,0
1668231265941,ECE 285,B00,103673,Sworder; David D.,0,0,0,0
1668231266366,ECE 287,A00,103676,Javidi; Tara,0,0,0,0
1668231266797,MATH 200B,A00,098023,Salehi Golsefidy; Alireza,12,0,15,3
1668231267222,MATH 202B,A00,098024,Rhoades; Brendon Patrick,9,0,15,6
1668231267647,MATH 203B,A00,098025,Oprea; Dragos N.,10,0,15,5
1668231268071,MATH 204B,A00,098026,Sorensen; Claus M,13,0,15,2
1668231268496,MATH 208,A00,098027,Izadi; Elham,7,0,10,3
1668231268923,MATH 209,A00,098028,Pollack; Aaron,10,0,10,0
1668231269346,MATH 211A,A00,112919,Rogalski; Daniel,9,0,10,1
1668231269771,MATH 211B,A00,112920,Seward; Brandon M.,9,0,10,1
1668231270194,MATH 218,A00,098029,Li; Bo,10,0,10,0
1668231270618,MATH 220B,A00,098030,Novak; Jonathan I,11,0,15,4
1668231271041,MATH 221A,A00,098031,Ebenfelt; Peter F,13,0,15,2
1668231271465,MATH 231B,A00,098032,Zlatos; Andrej,12,0,15,3
1668231271891,MATH 240B,A00,098033,Ni; Lei,9,0,15,6
1668231272316,MATH 243,A00,098034,Jekel; David Andrew,10,0,10,0
1668231272739,MATH 245A,A00,098035,Nie; Jiawang,0,0,15,16
1668231273169,MATH 248,A00,098036,Bejenaru; Ioan,10,0,10,0
1668231273595,MATH 250B,A00,098037,Spolaor; Luca,14,0,15,1
1668231274020,MATH 258,A00,098038,Ni; Lei,10,0,10,0
1668231274443,MATH 264B,A00,098041,Rhoades; Brendon Patrick,9,0,15,6
1668231274870,MATH 268,A00,098042,Buss; Samuel R,10,0,10,0
1668231275298,MATH 269,A00,098043,Rhoades; Brendon Patrick,10,0,10,0
1668231275724,MATH 270B,A00,098044,Li; Bo,10,0,15,5
1668231276155,MATH 272B,A00,098045,Holst; Michael J,13,0,15,2
1668231276580,MATH 273A,A00,098046,Tian; Xiaochuan,10,0,15,5
1668231277003,MATH 275,A01,098048,Tian; Xiaochuan,6,0,10,4
1668231277426,MATH 278A,A00,098049,Holst; Michael J,8,0,10,2
1668231277852,MATH 278B,A00,098050,Cloninger; Alexander,10,0,10,0
1668231278275,MATH 278C,A00,098051,Nie; Jiawang,7,0,10,3
1668231278700,MATH 280B,A00,098052,Zheng; Tianyi,10,0,15,5
1668231279123,MATH 281B,A00,098053,Bradic; Jelena,2,0,15,13
1668231279552,MATH 282B,A00,098054,Arias-Castro; Ery,0,0,15,15
1668231279976,MATH 285,A00,098055,Fitzsimmons; Patrick J,0,0,15,17
1668231280403,MATH 287B,A00,098056,Arias-Castro; Ery,2,0,15,13
1668231280829,MATH 288,A00,098057,Agarwal; Pooja,9,0,10,1
1668231280829,MATH 288,B00,098058,Zhang; Danna,8,0,10,2
1668231280829,MATH 288,C00,098059,Williams; Ruth J,10,0,10,0
1668231281252,MATH 290B,A00,098060,Roberts; Justin Deritter,13,0,15,2
1668231281684,MATH 292,A00,098061,Belmont; Eva Kinoshita,10,0,10,0
1668231282111,MATH 295,A00,098062,Suk; Andrew Hoon,48,0,50,2
1668231282536,MATH 296,A00,098063,Novak; Jonathan I,20,0,20,0
1668231282960,MATH 297,001,098064,Gamst; Anthony Collins,9997,0,9999,2
1668231782797,COGS 205,A00,101395,Chiba; Andrea,19,0,20,1
1668231783221,COGS 210B,001,101404,Greene; Deanna Jacquelyn,9998,0,9999,1
1668231783221,COGS 210B,002,101417,Xia; Haijun,9999,0,9999,0
1668231783221,COGS 210B,003,101422,Nitz; Douglas A.,9999,0,9999,0
1668231783221,COGS 210B,004,101423,Hollan; James D.,9998,0,9999,1
1668231783221,COGS 210B,005,101424,Deak; Gedeon O.,9998,0,9999,1
1668231783221,COGS 210B,006,101425,Rossano; Federico,9999,0,9999,0
1668231783645,COGS 211B,A00,101427,Coulson; Seana M,9996,0,9999,3
1668231784080,COGS 220,A00,101428,Hollan; James D.,0,0,25,25
1668231784506,COGS 229,A00,101429,Dow; Steven P,18,0,25,7
1668231784933,COGS 230,A00,101430,Klemmer; Scott R,12,0,17,5
1668231785358,COGS 234,A00,101431,Xia; Haijun,2,0,25,23
1668231785786,COGS 260,A00,101432,Kiyonaga; Anastasia,21,0,25,4
1668231785786,COGS 260,B00,101433,Kirsh; David Joel,15,0,25,10
1668231786216,CSE 202,A00,102371,Impagliazzo; Russell,0,0,0,0
1668231786636,CSE 203B,A01,102373,Cheng; Chung Kuan,0,0,0,0
1668231787062,CSE 208,A00,102374,Micciancio; Daniele,0,0,0,0
1668231787483,CSE 209A,A00,112895,Impagliazzo; Russell,0,0,15,15
1668231787906,CSE 209B,A00,108005,Bellare; Mihir,0,0,0,0
1668231788328,CSE 210,A00,113163,Coblenz; Michael J,0,0,0,0
1668231788749,CSE 219,A00,106111,Dow; Steven P,0,0,20,20
1668231789173,CSE 221,A00,102376,Voelker; Geoffrey M.,0,0,0,0
1668231789599,CSE 224,A01,102378,Porter; George M,0,0,0,0
1668231790022,CSE 229A,A00,102379,Savage; Stefan,0,0,0,0
1668231790448,CSE 229C,A00,102380,Munyaka; Imani N. S.,0,0,0,0
1668231790871,CSE 232B,A00,102382,Deutsch; Alin Bernard,0,0,0,0
1668231791297,CSE 234,A01,112904,Kumar; Arun Kumar,0,0,0,0
1668231791721,CSE 237A,A00,102383,Rosing; Tajana Simunic,0,0,0,0
1668231792147,CSE 239A,A00,102384,Deutsch; Alin Bernard,0,0,0,0
1668231792568,CSE 239B,A00,102385,Polikarpova; Nadezhda,0,0,0,0
1668231792997,CSE 240A,A00,102386,Pannuto; Patrick William,0,0,0,0
1668231793431,CSE 240B,A00,102387,Zhao; Jishen,0,0,0,0
1668231793853,CSE 241A,A00,106406,Kang; Mingu,0,0,0,0
1668231794274,CSE 249B,A00,102388,Kahng; Andrew Byun,0,0,8,8
1668231794699,CSE 251B,A01,102392,Cottrell; Garrison W,0,0,0,0
1668231794699,CSE 251B,A02,102393,Cottrell; Garrison W,0,0,0,0
1668231795124,CSE 252B,A00,102394,Ochoa; Benjamin Lawrence,0,0,0,0
1668231795545,CSE 257,A01,102396,Gao; Sicun,0,0,0,0
1668231795976,CSE 272,A00,102397,Li; Tzumao,0,0,0,0
1668231796403,CSE 274,A00,111323,Chern; Albert Ren-Haur,0,0,0,0
1668231796835,CSE 282,A00,102398,Pevzner; Pavel Arkadjevich,0,0,0,0
1668231797258,CSE 284,A00,114175,Gymrek; Melissa Ann,0,0,0,0
1668231797685,CSE 290,A00,102399,Chandraker; Manmohan Krishna,0,0,0,0
1668231797685,CSE 290,B00,102400,Vaccaro; Kristen Marie,0,0,25,25
1668231797685,CSE 290,C00,102414,Pannuto; Patrick William,0,0,25,25
1668231797685,CSE 290,D00,102427,Pevzner; Pavel Arkadjevich,0,0,0,0
1668231797685,CSE 290,E00,102429,Zhao; Jishen,0,0,0,0
1668231797685,CSE 290,F00,102436,Tullsen; Dean Michael,0,0,0,0
1668231797685,CSE 290,G00,102440,Christensen; Henrik I,0,0,20,20
1668231798121,CSE 291,A00,102443,Su; Hao,0,0,0,0
1668231798121,CSE 291,B00,102448,Polikarpova; Nadezhda,0,0,0,0
1668231798121,CSE 291,C00,102453,Vaccaro; Kristen Marie,0,0,0,0
1668231798121,CSE 291,D00,111343,Savage; Stefan,0,0,0,0
1668231798121,CSE 291,E00,116474,Claffy; Kimberly Claire,0,0,0,0
1668231798121,CSE 291,F00,116479,Pasquale; Joseph,0,0,0,0
1668231798550,CSE 293,001,119111,Bafna; Vineet,9999,0,9999,0
1668231798550,CSE 293,002,119118,Bellare; Mihir,9999,0,9999,0
1668231798550,CSE 293,003,119122,Berg-Kirkpatrick; Taylor D,9999,0,9999,0
1668231798550,CSE 293,004,119135,Christensen; Henrik I,9999,0,9999,0
1668231798550,CSE 293,005,119142,Cottrell; Garrison W,9999,0,9999,0
1668231798550,CSE 293,006,119146,Deutsch; Alin Bernard,9999,0,9999,0
1668231798550,CSE 293,007,119159,Esmaeilzadeh; Hadi,9999,0,9999,0
1668231798550,CSE 293,008,119166,Freund; Yoav,9999,0,9999,0
1668231798550,CSE 293,009,119170,Griswold; William G.,9999,0,9999,0
1668231798550,CSE 293,010,119183,Gymrek; Melissa Ann,9999,0,9999,0
1668231798550,CSE 293,011,119190,Heninger; Nadia A,9999,0,9999,0
1668231798550,CSE 293,012,119230,Impagliazzo; Russell,9999,0,9999,0
1668231798550,CSE 293,013,119232,Jhala; Ranjit,9999,0,9999,0
1668231798550,CSE 293,014,119233,Kahng; Andrew Byun,9999,0,9999,0
1668231798550,CSE 293,015,119298,Kane; Daniel Mertz,9999,0,9999,0
1668231798550,CSE 293,016,119299,Kriegman; David J,9999,0,9999,0
1668231798550,CSE 293,017,119300,Kumar; Arun Kumar,9999,0,9999,0
1668231798550,CSE 293,018,119301,Lerner; Sorin,9999,0,9999,0
1668231798550,CSE 293,019,119302,Lovett; Shachar,9999,0,9999,0
1668231798550,CSE 293,020,119303,McAuley; Julian John,9999,0,9999,0
1668231798550,CSE 293,021,119304,Micciancio; Daniele,9999,0,9999,0
1668231798550,CSE 293,022,119367,Orailoglu; Alex,9999,0,9999,0
1668231798550,CSE 293,023,119382,Paturi; Ramamohan,9999,0,9999,0
1668231798550,CSE 293,024,119404,Polikarpova; Nadezhda,9999,0,9999,0
1668231798550,CSE 293,025,119406,Politz; Joseph Gibbs,9999,0,9999,0
1668231798550,CSE 293,026,119411,Porter; George M,9999,0,9999,0
1668231798550,CSE 293,027,119414,Porter; Leonard Emerson,9999,0,9999,0
1668231798550,CSE 293,028,119416,Ramamoorthi; Ravi,9999,0,9999,0
1668231798550,CSE 293,029,119417,Sahoo; Debashis,9999,0,9999,0
1668231798550,CSE 293,030,119420,Saul; Lawrence,9999,0,9999,0
1668231798550,CSE 293,031,119421,Savage; Stefan,9999,0,9999,0
1668231798550,CSE 293,032,119425,Schulze; Jurgen P.,9999,0,9999,0
1668231798550,CSE 293,033,119426,Snoeren; Alex C.,9999,0,9999,0
1668231798550,CSE 293,034,119428,Shang; Jingbo,9999,0,9999,0
1668231798550,CSE 293,035,119430,Stefan; Deian,9999,0,9999,0
1668231798550,CSE 293,036,119431,Su; Hao,9999,0,9999,0
1668231798550,CSE 293,037,119433,Swanson; Steven James,9999,0,9999,0
1668231798550,CSE 293,038,119435,Tullsen; Dean Michael,9999,0,9999,0
1668231798550,CSE 293,039,119483,Voelker; Geoffrey M.,9999,0,9999,0
1668231798550,CSE 293,040,119537,Zhao; Jishen,9999,0,9999,0
1668231798550,CSE 293,041,119538,Zhou; Yuan-Yuan,9999,0,9999,0
1668231798550,CSE 293,042,119539,Gao; Sicun,9999,0,9999,0
1668231798550,CSE 293,043,119540,Weibel; Nadir,9999,0,9999,0
1668231798550,CSE 293,044,119541,Gupta; Rajesh K.,9999,0,9999,0
1668231798550,CSE 293,045,126410,Vaccaro; Kristen Marie,9999,0,9999,0
1668231798550,CSE 293,046,126411,Klemke; Richard,9999,0,9999,0
1668231798975,CSE 294,A00,102459,Voelker; Geoffrey M.,0,0,0,0
1668231798975,CSE 294,B00,111322,Orailoglu; Alex,0,0,0,0
1668231799398,DSE 201,A00,096914,Deutsch; Alin Bernard,30,0,30,0
1668231799822,DSE 210,A00,096915,Dasgupta; Sanjoy,30,0,30,0
1668231800243,DSE 260A,A00,096916,Altintas De Callaf; Ilkay,30,0,30,0
1668231800671,ECE 200,001,103586,Antipa; Nicholas A,9999,0,9999,0
1668231800671,ECE 200,002,103587,Atanasov; Nikolay A.,9999,0,9999,0
1668231800671,ECE 200,003,103588,Bharadia; Dinesh,9999,0,9999,0
1668231800671,ECE 200,004,103589,Cheng; Chung Kuan,9999,0,9999,0
1668231800671,ECE 200,005,103590,Cosman; Pamela C.,9999,0,9999,0
1668231800671,ECE 200,006,103591,Dayeh; Shadi Ahmad,9999,0,9999,0
1668231800671,ECE 200,007,103592,Fainman; Yeshaiahu,9999,0,9999,0
1668231800671,ECE 200,008,103593,Ford; Joseph Earl,9999,0,9999,0
1668231800671,ECE 200,009,103594,Franceschetti; Massimo,9999,0,9999,0
1668231800671,ECE 200,010,103595,Fullerton; Eric E,9999,0,9999,0
1668231800671,ECE 200,011,103596,Galton; Ian A,9999,0,9999,0
1668231800671,ECE 200,012,103597,Gilja; Vikash,9999,0,9999,0
1668231800671,ECE 200,013,103598,Hall; Drew A.,9999,0,9999,0
1668231800671,ECE 200,014,103599,Hsueh; Tzu-Chien,9999,0,9999,0
1668231800671,ECE 200,015,103600,Javidi; Tara,9999,0,9999,0
1668231800671,ECE 200,016,103601,Kahng; Andrew Byun,9999,0,9999,0
1668231800671,ECE 200,017,103602,Kim; Young-Han,9999,0,9999,0
1668231800671,ECE 200,018,103603,Koushanfar; Farinaz,9999,0,9999,0
1668231800671,ECE 200,019,103604,Kuzum; Duygu,9999,0,9999,0
1668231800671,ECE 200,020,103605,Le; Hanh-Phuc,9999,0,9999,0
1668231800671,ECE 200,021,103606,Lin; Bill,9999,0,9999,0
1668231800671,ECE 200,022,103607,Liu; Zhaowei,9998,0,9999,1
1668231800671,ECE 200,023,103608,Lo; Yu-Hwa,9999,0,9999,0
1668231800671,ECE 200,024,103609,Lomakin; Vitaliy,9999,0,9999,0
1668231800671,ECE 200,025,103610,Mercier; Patrick Philip,9999,0,9999,0
1668231800671,ECE 200,026,103611,Meyer; Florian,9999,0,9999,0
1668231800671,ECE 200,027,103612,Milstein; Laurence B.,9999,0,9999,0
1668231800671,ECE 200,028,103613,Mir Arabbaygi; Siavash,9999,0,9999,0
1668231800671,ECE 200,029,103614,Mookherjea; Shayan,9999,0,9999,0
1668231800671,ECE 200,030,103615,Morris; Karcher William,9999,0,9999,0
1668231800671,ECE 200,031,103616,Ng; Tse Nga,9999,0,9999,0
1668231800671,ECE 200,032,103617,Nguyen; Truong Quang,9999,0,9999,0
1668231800671,ECE 200,033,103618,Nomura; Kenji,9999,0,9999,0
1668231800671,ECE 200,034,103619,Orlitsky; Alon,9999,0,9999,0
1668231800671,ECE 200,035,103620,Pal; Piya,9999,0,9999,0
1668231800671,ECE 200,036,103621,Papen; George C.,9999,0,9999,0
1668231800671,ECE 200,037,103622,Radic; Stojan,9999,0,9999,0
1668231800671,ECE 200,038,103623,Rao; Bhaskar D.,9999,0,9999,0
1668231800671,ECE 200,039,103624,Rao; Ramesh R,9999,0,9999,0
1668231800671,ECE 200,040,103625,Rebeiz; Gabriel,9999,0,9999,0
1668231800671,ECE 200,041,103626,Sanford; John R,9999,0,9999,0
1668231800671,ECE 200,042,103627,Siegel; Paul H.,9999,0,9999,0
1668231800671,ECE 200,043,103628,Sievenpiper; Daniel F.,9999,0,9999,0
1668231800671,ECE 200,044,103629,Sworder; David D.,9999,0,9999,0
1668231800671,ECE 200,045,103630,Taur; Yuan,9999,0,9999,0
1668231800671,ECE 200,046,103631,Touri; Behrouz,9999,0,9999,0
1668231800671,ECE 200,047,103632,Trivedi; Mohan M.,9999,0,9999,0
1668231800671,ECE 200,048,103633,Vasconcelos; Nuno,9999,0,9999,0
1668231800671,ECE 200,049,103634,Wang; Xiaolong,9999,0,9999,0
1668231800671,ECE 200,050,103635,Xie; Pengtao,9999,0,9999,0
1668231800671,ECE 200,051,103636,Yip; Michael,9999,0,9999,0
1668231800671,ECE 200,052,103637,Zeger; Kenneth A.,999,0,999,0
1668231800671,ECE 200,053,103638,Zhang; Xinyu,9999,0,9999,0
1668231800671,ECE 200,054,103639,Turakhia; Yatish Girish,9999,0,9999,0
1668231800671,ECE 200,055,103640,Kang; Mingu,9999,0,9999,0
1668231800671,ECE 200,056,103641,Shi; Yuanyuan,9999,0,9999,0
1668231800671,ECE 200,057,103642,Wang; Edward Jay,9999,0,9999,0
1668231800671,ECE 200,058,103643,Zheng; Yang,9999,0,9999,0
1668231801100,ECE 202,A00,103644,Kuzum; Duygu,0,0,0,0
1668231801523,ECE 212BN,A00,103646,Ng; Tse Nga,0,0,0,0
1668231801956,ECE 221,A00,111493,Staff,0,0,0,0
1668231802382,ECE 222B,A00,103647,Lomakin; Vitaliy,0,0,0,0
1668231802806,ECE 230B,A00,103648,Taur; Yuan,0,0,0,0
1668231803229,ECE 238B,A00,103649,Garay; Javier,0,0,0,0
1668231803653,ECE 240B,A00,112900,Fainman; Yeshaiahu,0,0,0,0
1668231804080,ECE 247A,A00,103650,Jokerst; Jesse Vincent,0,0,0,0
1668231804504,ECE 247B,A00,103651,Wang; Joseph,0,0,0,0
1668231804930,ECE 250,A00,103652,Siegel; Paul H.,0,0,0,0
1668231805354,ECE 251A,A00,103654,Rao; Bhaskar D.,0,0,0,0
1668231805778,ECE 257B,A00,103655,Bharadia; Dinesh,0,0,0,0
1668231806201,ECE 258A,A00,103656,Milstein; Laurence B.,0,0,0,0
1668231806623,ECE 260B,A00,103658,Kang; Mingu,0,0,0,0
1668231807055,ECE 264A,A00,103659,Galton; Ian A,0,0,0,0
1668231807481,ECE 265A,A00,103661,Gudem; Prasad S.S.,0,0,0,0
1668231807904,ECE 265D,A00,103662,Gudem; Prasad S.S.,0,0,0,0
1668231808331,ECE 268,A00,103663,Koushanfar; Farinaz,0,0,0,0
1668231808755,ECE 269,A01,103665,Pal; Piya,0,0,0,0
1668231809178,ECE 271B,A00,103666,Vasconcelos; Manuela,0,0,0,0
1668231809600,ECE 276A,A00,103667,Atanasov; Nikolay A.,0,0,0,0
1668231810022,ECE 277,A00,103668,An; Cheolhong,0,0,0,0
1668231810449,ECE 279,A00,117947,Hall; Drew A.,0,0,0,0
1668231811316,ECE 283,A00,103670,Hsueh; Tzu-Chien,0,0,0,0
1668231811741,ECE 284,A00,103671,Turakhia; Yatish Girish,0,0,0,0
1668231812163,ECE 285,A00,103672,Zheng; Yang,0,0,0,0
1668231812163,ECE 285,B00,103673,Sworder; David D.,0,0,0,0
1668231812593,ECE 287,A00,103676,Javidi; Tara,0,0,0,0
1668231813025,MATH 200B,A00,098023,Salehi Golsefidy; Alireza,12,0,15,3
1668231813449,MATH 202B,A00,098024,Rhoades; Brendon Patrick,9,0,15,6
1668231813874,MATH 203B,A00,098025,Oprea; Dragos N.,10,0,15,5
1668231814298,MATH 204B,A00,098026,Sorensen; Claus M,13,0,15,2
1668231814723,MATH 208,A00,098027,Izadi; Elham,7,0,10,3
1668231815146,MATH 209,A00,098028,Pollack; Aaron,10,0,10,0
1668231815583,MATH 211A,A00,112919,Rogalski; Daniel,9,0,10,1
1668231816007,MATH 211B,A00,112920,Seward; Brandon M.,9,0,10,1
1668231816433,MATH 218,A00,098029,Li; Bo,10,0,10,0
1668231816864,MATH 220B,A00,098030,Novak; Jonathan I,11,0,15,4
1668231817366,MATH 221A,A00,098031,Ebenfelt; Peter F,13,0,15,2
1668231817790,MATH 231B,A00,098032,Zlatos; Andrej,12,0,15,3
1668231818213,MATH 240B,A00,098033,Ni; Lei,9,0,15,6
1668231818636,MATH 243,A00,098034,Jekel; David Andrew,10,0,10,0
1668231819059,MATH 245A,A00,098035,Nie; Jiawang,0,0,15,16
1668231819495,MATH 248,A00,098036,Bejenaru; Ioan,10,0,10,0
1668231819920,MATH 250B,A00,098037,Spolaor; Luca,14,0,15,1
1668231820342,MATH 258,A00,098038,Ni; Lei,10,0,10,0
1668231820766,MATH 264B,A00,098041,Rhoades; Brendon Patrick,9,0,15,6
1668231821193,MATH 268,A00,098042,Buss; Samuel R,10,0,10,0
1668231821618,MATH 269,A00,098043,Rhoades; Brendon Patrick,10,0,10,0
1668231822046,MATH 270B,A00,098044,Li; Bo,10,0,15,5
1668231822468,MATH 272B,A00,098045,Holst; Michael J,13,0,15,2
1668231822890,MATH 273A,A00,098046,Tian; Xiaochuan,10,0,15,5
1668231823328,MATH 275,A01,098048,Tian; Xiaochuan,6,0,10,4
1668231823755,MATH 278A,A00,098049,Holst; Michael J,8,0,10,2
1668231824180,MATH 278B,A00,098050,Cloninger; Alexander,10,0,10,0
1668231824602,MATH 278C,A00,098051,Nie; Jiawang,7,0,10,3
1668231825027,MATH 280B,A00,098052,Zheng; Tianyi,10,0,15,5
1668231825450,MATH 281B,A00,098053,Bradic; Jelena,2,0,15,13
1668231825895,MATH 282B,A00,098054,Arias-Castro; Ery,0,0,15,15
1668231826319,MATH 285,A00,098055,Fitzsimmons; Patrick J,0,0,15,17
1668231826742,MATH 287B,A00,098056,Arias-Castro; Ery,2,0,15,13
1668231827197,MATH 288,A00,098057,Agarwal; Pooja,9,0,10,1
1668231827197,MATH 288,B00,098058,Zhang; Danna,8,0,10,2
1668231827197,MATH 288,C00,098059,Williams; Ruth J,10,0,10,0
1668231827630,MATH 290B,A00,098060,Roberts; Justin Deritter,13,0,15,2
1668231828053,MATH 292,A00,098061,Belmont; Eva Kinoshita,10,0,10,0
1668231828489,MATH 295,A00,098062,Suk; Andrew Hoon,48,0,50,2
1668231828915,MATH 296,A00,098063,Novak; Jonathan I,20,0,20,0
1668231829341,MATH 297,001,098064,Gamst; Anthony Collins,9997,0,9999,2
1668232329201,COGS 205,A00,101395,Chiba; Andrea,19,0,20,1
1668232329633,COGS 210B,001,101404,Greene; Deanna Jacquelyn,9998,0,9999,1
1668232329633,COGS 210B,002,101417,Xia; Haijun,9999,0,9999,0
1668232329633,COGS 210B,003,101422,Nitz; Douglas A.,9999,0,9999,0
1668232329633,COGS 210B,004,101423,Hollan; James D.,9998,0,9999,1
1668232329633,COGS 210B,005,101424,Deak; Gedeon O.,9998,0,9999,1
1668232329633,COGS 210B,006,101425,Rossano; Federico,9999,0,9999,0
1668232330060,COGS 211B,A00,101427,Coulson; Seana M,9996,0,9999,3
1668232330485,COGS 220,A00,101428,Hollan; James D.,0,0,25,25
1668232330917,COGS 229,A00,101429,Dow; Steven P,18,0,25,7
1668232331341,COGS 230,A00,101430,Klemmer; Scott R,12,0,17,5
1668232331767,COGS 234,A00,101431,Xia; Haijun,2,0,25,23
1668232332193,COGS 260,A00,101432,Kiyonaga; Anastasia,21,0,25,4
1668232332193,COGS 260,B00,101433,Kirsh; David Joel,15,0,25,10
1668232332620,CSE 202,A00,102371,Impagliazzo; Russell,0,0,0,0
1668232333054,CSE 203B,A01,102373,Cheng; Chung Kuan,0,0,0,0
1668232333476,CSE 208,A00,102374,Micciancio; Daniele,0,0,0,0
1668232333901,CSE 209A,A00,112895,Impagliazzo; Russell,0,0,15,15
1668232334331,CSE 209B,A00,108005,Bellare; Mihir,0,0,0,0
1668232334757,CSE 210,A00,113163,Coblenz; Michael J,0,0,0,0
1668232335180,CSE 219,A00,106111,Dow; Steven P,0,0,20,20
1668232335608,CSE 221,A00,102376,Voelker; Geoffrey M.,0,0,0,0
1668232336033,CSE 224,A01,102378,Porter; George M,0,0,0,0
1668232336459,CSE 229A,A00,102379,Savage; Stefan,0,0,0,0
1668232336884,CSE 229C,A00,102380,Munyaka; Imani N. S.,0,0,0,0
1668232337383,CSE 232B,A00,102382,Deutsch; Alin Bernard,0,0,0,0
1668232337806,CSE 234,A01,112904,Kumar; Arun Kumar,0,0,0,0
1668232338237,CSE 237A,A00,102383,Rosing; Tajana Simunic,0,0,0,0
1668232338660,CSE 239A,A00,102384,Deutsch; Alin Bernard,0,0,0,0
1668232339087,CSE 239B,A00,102385,Polikarpova; Nadezhda,0,0,0,0
1668232339511,CSE 240A,A00,102386,Pannuto; Patrick William,0,0,0,0
1668232339936,CSE 240B,A00,102387,Zhao; Jishen,0,0,0,0
1668232340360,CSE 241A,A00,106406,Kang; Mingu,0,0,0,0
1668232340784,CSE 249B,A00,102388,Kahng; Andrew Byun,0,0,8,8
1668232341212,CSE 251B,A01,102392,Cottrell; Garrison W,0,0,0,0
1668232341212,CSE 251B,A02,102393,Cottrell; Garrison W,0,0,0,0
1668232341634,CSE 252B,A00,102394,Ochoa; Benjamin Lawrence,0,0,0,0
1668232342074,CSE 257,A01,102396,Gao; Sicun,0,0,0,0
1668232342498,CSE 272,A00,102397,Li; Tzumao,0,0,0,0
1668232342921,CSE 274,A00,111323,Chern; Albert Ren-Haur,0,0,0,0
1668232343349,CSE 282,A00,102398,Pevzner; Pavel Arkadjevich,0,0,0,0
1668232343774,CSE 284,A00,114175,Gymrek; Melissa Ann,0,0,0,0
1668232344200,CSE 290,A00,102399,Chandraker; Manmohan Krishna,0,0,0,0
1668232344200,CSE 290,B00,102400,Vaccaro; Kristen Marie,0,0,25,25
1668232344200,CSE 290,C00,102414,Pannuto; Patrick William,0,0,25,25
1668232344200,CSE 290,D00,102427,Pevzner; Pavel Arkadjevich,0,0,0,0
1668232344200,CSE 290,E00,102429,Zhao; Jishen,0,0,0,0
1668232344200,CSE 290,F00,102436,Tullsen; Dean Michael,0,0,0,0
1668232344200,CSE 290,G00,102440,Christensen; Henrik I,0,0,20,20
1668232344621,CSE 291,A00,102443,Su; Hao,0,0,0,0
1668232344621,CSE 291,B00,102448,Polikarpova; Nadezhda,0,0,0,0
1668232344621,CSE 291,C00,102453,Vaccaro; Kristen Marie,0,0,0,0
1668232344621,CSE 291,D00,111343,Savage; Stefan,0,0,0,0
1668232344621,CSE 291,E00,116474,Claffy; Kimberly Claire,0,0,0,0
1668232344621,CSE 291,F00,116479,Pasquale; Joseph,0,0,0,0
1668232345056,CSE 293,001,119111,Bafna; Vineet,9999,0,9999,0
1668232345056,CSE 293,002,119118,Bellare; Mihir,9999,0,9999,0
1668232345056,CSE 293,003,119122,Berg-Kirkpatrick; Taylor D,9999,0,9999,0
1668232345056,CSE 293,004,119135,Christensen; Henrik I,9999,0,9999,0
1668232345056,CSE 293,005,119142,Cottrell; Garrison W,9999,0,9999,0
1668232345056,CSE 293,006,119146,Deutsch; Alin Bernard,9999,0,9999,0
1668232345056,CSE 293,007,119159,Esmaeilzadeh; Hadi,9999,0,9999,0
1668232345056,CSE 293,008,119166,Freund; Yoav,9999,0,9999,0
1668232345056,CSE 293,009,119170,Griswold; William G.,9999,0,9999,0
1668232345056,CSE 293,010,119183,Gymrek; Melissa Ann,9999,0,9999,0
1668232345056,CSE 293,011,119190,Heninger; Nadia A,9999,0,9999,0
1668232345056,CSE 293,012,119230,Impagliazzo; Russell,9999,0,9999,0
1668232345056,CSE 293,013,119232,Jhala; Ranjit,9999,0,9999,0
1668232345056,CSE 293,014,119233,Kahng; Andrew Byun,9999,0,9999,0
1668232345056,CSE 293,015,119298,Kane; Daniel Mertz,9999,0,9999,0
1668232345056,CSE 293,016,119299,Kriegman; David J,9999,0,9999,0
1668232345056,CSE 293,017,119300,Kumar; Arun Kumar,9999,0,9999,0
1668232345056,CSE 293,018,119301,Lerner; Sorin,9999,0,9999,0
1668232345056,CSE 293,019,119302,Lovett; Shachar,9999,0,9999,0
1668232345056,CSE 293,020,119303,McAuley; Julian John,9999,0,9999,0
1668232345056,CSE 293,021,119304,Micciancio; Daniele,9999,0,9999,0
1668232345056,CSE 293,022,119367,Orailoglu; Alex,9999,0,9999,0
1668232345056,CSE 293,023,119382,Paturi; Ramamohan,9999,0,9999,0
1668232345056,CSE 293,024,119404,Polikarpova; Nadezhda,9999,0,9999,0
1668232345056,CSE 293,025,119406,Politz; Joseph Gibbs,9999,0,9999,0
1668232345056,CSE 293,026,119411,Porter; George M,9999,0,9999,0
1668232345056,CSE 293,027,119414,Porter; Leonard Emerson,9999,0,9999,0
1668232345056,CSE 293,028,119416,Ramamoorthi; Ravi,9999,0,9999,0
1668232345056,CSE 293,029,119417,Sahoo; Debashis,9999,0,9999,0
1668232345056,CSE 293,030,119420,Saul; Lawrence,9999,0,9999,0
1668232345056,CSE 293,031,119421,Savage; Stefan,9999,0,9999,0
1668232345056,CSE 293,032,119425,Schulze; Jurgen P.,9999,0,9999,0
1668232345056,CSE 293,033,119426,Snoeren; Alex C.,9999,0,9999,0
1668232345056,CSE 293,034,119428,Shang; Jingbo,9999,0,9999,0
1668232345056,CSE 293,035,119430,Stefan; Deian,9999,0,9999,0
1668232345056,CSE 293,036,119431,Su; Hao,9999,0,9999,0
1668232345056,CSE 293,037,119433,Swanson; Steven James,9999,0,9999,0
1668232345056,CSE 293,038,119435,Tullsen; Dean Michael,9999,0,9999,0
1668232345056,CSE 293,039,119483,Voelker; Geoffrey M.,9999,0,9999,0
1668232345056,CSE 293,040,119537,Zhao; Jishen,9999,0,9999,0
1668232345056,CSE 293,041,119538,Zhou; Yuan-Yuan,9999,0,9999,0
1668232345056,CSE 293,042,119539,Gao; Sicun,9999,0,9999,0
1668232345056,CSE 293,043,119540,Weibel; Nadir,9999,0,9999,0
1668232345056,CSE 293,044,119541,Gupta; Rajesh K.,9999,0,9999,0
1668232345056,CSE 293,045,126410,Vaccaro; Kristen Marie,9999,0,9999,0
1668232345056,CSE 293,046,126411,Klemke; Richard,9999,0,9999,0
1668232345482,CSE 294,A00,102459,Voelker; Geoffrey M.,0,0,0,0
1668232345482,CSE 294,B00,111322,Orailoglu; Alex,0,0,0,0
1668232345909,DSE 201,A00,096914,Deutsch; Alin Bernard,30,0,30,0
1668232346334,DSE 210,A00,096915,Dasgupta; Sanjoy,30,0,30,0
1668232346757,DSE 260A,A00,096916,Altintas De Callaf; Ilkay,30,0,30,0
1668232347218,ECE 200,001,103586,Antipa; Nicholas A,9999,0,9999,0
1668232347218,ECE 200,002,103587,Atanasov; Nikolay A.,9999,0,9999,0
1668232347218,ECE 200,003,103588,Bharadia; Dinesh,9999,0,9999,0
1668232347218,ECE 200,004,103589,Cheng; Chung Kuan,9999,0,9999,0
1668232347218,ECE 200,005,103590,Cosman; Pamela C.,9999,0,9999,0
1668232347218,ECE 200,006,103591,Dayeh; Shadi Ahmad,9999,0,9999,0
1668232347218,ECE 200,007,103592,Fainman; Yeshaiahu,9999,0,9999,0
1668232347218,ECE 200,008,103593,Ford; Joseph Earl,9999,0,9999,0
1668232347218,ECE 200,009,103594,Franceschetti; Massimo,9999,0,9999,0
1668232347218,ECE 200,010,103595,Fullerton; Eric E,9999,0,9999,0
1668232347218,ECE 200,011,103596,Galton; Ian A,9999,0,9999,0
1668232347218,ECE 200,012,103597,Gilja; Vikash,9999,0,9999,0
1668232347218,ECE 200,013,103598,Hall; Drew A.,9999,0,9999,0
1668232347218,ECE 200,014,103599,Hsueh; Tzu-Chien,9999,0,9999,0
1668232347218,ECE 200,015,103600,Javidi; Tara,9999,0,9999,0
1668232347218,ECE 200,016,103601,Kahng; Andrew Byun,9999,0,9999,0
1668232347218,ECE 200,017,103602,Kim; Young-Han,9999,0,9999,0
1668232347218,ECE 200,018,103603,Koushanfar; Farinaz,9999,0,9999,0
1668232347218,ECE 200,019,103604,Kuzum; Duygu,9999,0,9999,0
1668232347218,ECE 200,020,103605,Le; Hanh-Phuc,9999,0,9999,0
1668232347218,ECE 200,021,103606,Lin; Bill,9999,0,9999,0
1668232347218,ECE 200,022,103607,Liu; Zhaowei,9998,0,9999,1
1668232347218,ECE 200,023,103608,Lo; Yu-Hwa,9999,0,9999,0
1668232347218,ECE 200,024,103609,Lomakin; Vitaliy,9999,0,9999,0
1668232347218,ECE 200,025,103610,Mercier; Patrick Philip,9999,0,9999,0
1668232347218,ECE 200,026,103611,Meyer; Florian,9999,0,9999,0
1668232347218,ECE 200,027,103612,Milstein; Laurence B.,9999,0,9999,0
1668232347218,ECE 200,028,103613,Mir Arabbaygi; Siavash,9999,0,9999,0
1668232347218,ECE 200,029,103614,Mookherjea; Shayan,9999,0,9999,0
1668232347218,ECE 200,030,103615,Morris; Karcher William,9999,0,9999,0
1668232347218,ECE 200,031,103616,Ng; Tse Nga,9999,0,9999,0
1668232347218,ECE 200,032,103617,Nguyen; Truong Quang,9999,0,9999,0
1668232347218,ECE 200,033,103618,Nomura; Kenji,9999,0,9999,0
1668232347218,ECE 200,034,103619,Orlitsky; Alon,9999,0,9999,0
1668232347218,ECE 200,035,103620,Pal; Piya,9999,0,9999,0
1668232347218,ECE 200,036,103621,Papen; George C.,9999,0,9999,0
1668232347218,ECE 200,037,103622,Radic; Stojan,9999,0,9999,0
1668232347218,ECE 200,038,103623,Rao; Bhaskar D.,9999,0,9999,0
1668232347218,ECE 200,039,103624,Rao; Ramesh R,9999,0,9999,0
1668232347218,ECE 200,040,103625,Rebeiz; Gabriel,9999,0,9999,0
1668232347218,ECE 200,041,103626,Sanford; John R,9999,0,9999,0
1668232347218,ECE 200,042,103627,Siegel; Paul H.,9999,0,9999,0
1668232347218,ECE 200,043,103628,Sievenpiper; Daniel F.,9999,0,9999,0
1668232347218,ECE 200,044,103629,Sworder; David D.,9999,0,9999,0
1668232347218,ECE 200,045,103630,Taur; Yuan,9999,0,9999,0
1668232347218,ECE 200,046,103631,Touri; Behrouz,9999,0,9999,0
1668232347218,ECE 200,047,103632,Trivedi; Mohan M.,9999,0,9999,0
1668232347218,ECE 200,048,103633,Vasconcelos; Nuno,9999,0,9999,0
1668232347218,ECE 200,049,103634,Wang; Xiaolong,9999,0,9999,0
1668232347218,ECE 200,050,103635,Xie; Pengtao,9999,0,9999,0
1668232347218,ECE 200,051,103636,Yip; Michael,9999,0,9999,0
1668232347218,ECE 200,052,103637,Zeger; Kenneth A.,999,0,999,0
1668232347218,ECE 200,053,103638,Zhang; Xinyu,9999,0,9999,0
1668232347218,ECE 200,054,103639,Turakhia; Yatish Girish,9999,0,9999,0
1668232347218,ECE 200,055,103640,Kang; Mingu,9999,0,9999,0
1668232347218,ECE 200,056,103641,Shi; Yuanyuan,9999,0,9999,0
1668232347218,ECE 200,057,103642,Wang; Edward Jay,9999,0,9999,0
1668232347218,ECE 200,058,103643,Zheng; Yang,9999,0,9999,0
1668232347641,ECE 202,A00,103644,Kuzum; Duygu,0,0,0,0
1668232348065,ECE 212BN,A00,103646,Ng; Tse Nga,0,0,0,0
1668232348488,ECE 221,A00,111493,Staff,0,0,0,0
1668232348912,ECE 222B,A00,103647,Lomakin; Vitaliy,0,0,0,0
1668232349334,ECE 230B,A00,103648,Taur; Yuan,0,0,0,0
1668232349759,ECE 238B,A00,103649,Garay; Javier,0,0,0,0
1668232350183,ECE 240B,A00,112900,Fainman; Yeshaiahu,0,0,0,0
1668232350606,ECE 247A,A00,103650,Jokerst; Jesse Vincent,0,0,0,0
1668232351029,ECE 247B,A00,103651,Wang; Joseph,0,0,0,0
1668232351453,ECE 250,A00,103652,Siegel; Paul H.,0,0,0,0
1668232351885,ECE 251A,A00,103654,Rao; Bhaskar D.,0,0,0,0
1668232352308,ECE 257B,A00,103655,Bharadia; Dinesh,0,0,0,0
1668232352733,ECE 258A,A00,103656,Milstein; Laurence B.,0,0,0,0
1668232353159,ECE 260B,A00,103658,Kang; Mingu,0,0,0,0
1668232353587,ECE 264A,A00,103659,Galton; Ian A,0,0,0,0
1668232354014,ECE 265A,A00,103661,Gudem; Prasad S.S.,0,0,0,0
1668232354436,ECE 265D,A00,103662,Gudem; Prasad S.S.,0,0,0,0
1668232354862,ECE 268,A00,103663,Koushanfar; Farinaz,0,0,0,0
1668232355286,ECE 269,A01,103665,Pal; Piya,0,0,0,0
1668232355713,ECE 271B,A00,103666,Vasconcelos; Manuela,0,0,0,0
1668232356136,ECE 276A,A00,103667,Atanasov; Nikolay A.,0,0,0,0
1668232356561,ECE 277,A00,103668,An; Cheolhong,0,0,0,0
1668232356985,ECE 279,A00,117947,Hall; Drew A.,0,0,0,0
1668232357842,ECE 283,A00,103670,Hsueh; Tzu-Chien,0,0,0,0
1668232358280,ECE 284,A00,103671,Turakhia; Yatish Girish,0,0,0,0
1668232358702,ECE 285,A00,103672,Zheng; Yang,0,0,0,0
1668232358702,ECE 285,B00,103673,Sworder; David D.,0,0,0,0
1668232359132,ECE 287,A00,103676,Javidi; Tara,0,0,0,0
1668232359555,MATH 200B,A00,098023,Salehi Golsefidy; Alireza,12,0,15,3
1668232359980,MATH 202B,A00,098024,Rhoades; Brendon Patrick,9,0,15,6
1668232360409,MATH 203B,A00,098025,Oprea; Dragos N.,10,0,15,5
1668232360831,MATH 204B,A00,098026,Sorensen; Claus M,13,0,15,2
1668232361257,MATH 208,A00,098027,Izadi; Elham,7,0,10,3
1668232361687,MATH 209,A00,098028,Pollack; Aaron,10,0,10,0
1668232362109,MATH 211A,A00,112919,Rogalski; Daniel,9,0,10,1
1668232362530,MATH 211B,A00,112920,Seward; Brandon M.,9,0,10,1
1668232362955,MATH 218,A00,098029,Li; Bo,10,0,10,0
1668232363379,MATH 220B,A00,098030,Novak; Jonathan I,11,0,15,4
1668232363806,MATH 221A,A00,098031,Ebenfelt; Peter F,13,0,15,2
1668232364232,MATH 231B,A00,098032,Zlatos; Andrej,12,0,15,3
1668232364659,MATH 240B,A00,098033,Ni; Lei,9,0,15,6
1668232365082,MATH 243,A00,098034,Jekel; David Andrew,10,0,10,0
1668232365514,MATH 245A,A00,098035,Nie; Jiawang,0,0,15,16
1668232365938,MATH 248,A00,098036,Bejenaru; Ioan,10,0,10,0
1668232366361,MATH 250B,A00,098037,Spolaor; Luca,14,0,15,1
1668232366782,MATH 258,A00,098038,Ni; Lei,10,0,10,0
1668232367207,MATH 264B,A00,098041,Rhoades; Brendon Patrick,9,0,15,6
1668232367647,MATH 268,A00,098042,Buss; Samuel R,10,0,10,0
1668232368071,MATH 269,A00,098043,Rhoades; Brendon Patrick,10,0,10,0
1668232368499,MATH 270B,A00,098044,Li; Bo,10,0,15,5
1668232368928,MATH 272B,A00,098045,Holst; Michael J,13,0,15,2
1668232369356,MATH 273A,A00,098046,Tian; Xiaochuan,10,0,15,5
1668232369793,MATH 275,A01,098048,Tian; Xiaochuan,6,0,10,4
1668232370218,MATH 278A,A00,098049,Holst; Michael J,8,0,10,2
1668232370653,MATH 278B,A00,098050,Cloninger; Alexander,10,0,10,0
1668232371078,MATH 278C,A00,098051,Nie; Jiawang,7,0,10,3
1668232371501,MATH 280B,A00,098052,Zheng; Tianyi,10,0,15,5
1668232371928,MATH 281B,A00,098053,Bradic; Jelena,2,0,15,13
1668232372350,MATH 282B,A00,098054,Arias-Castro; Ery,0,0,15,15
1668232372775,MATH 285,A00,098055,Fitzsimmons; Patrick J,0,0,15,17
1668232373206,MATH 287B,A00,098056,Arias-Castro; Ery,2,0,15,13
1668232373642,MATH 288,A00,098057,Agarwal; Pooja,9,0,10,1
1668232373642,MATH 288,B00,098058,Zhang; Danna,8,0,10,2
1668232373642,MATH 288,C00,098059,Williams; Ruth J,10,0,10,0
1668232374071,MATH 290B,A00,098060,Roberts; Justin Deritter,13,0,15,2
1668232374496,MATH 292,A00,098061,Belmont; Eva Kinoshita,10,0,10,0
1668232374922,MATH 295,A00,098062,Suk; Andrew Hoon,48,0,50,2
1668232375348,MATH 296,A00,098063,Novak; Jonathan I,20,0,20,0
1668232375778,MATH 297,001,098064,Gamst; Anthony Collins,9997,0,9999,2
1668232886568,COGS 205,A00,101395,Chiba; Andrea,19,0,20,1
1668232886993,COGS 210B,001,101404,Greene; Deanna Jacquelyn,9998,0,9999,1
1668232886993,COGS 210B,002,101417,Xia; Haijun,9999,0,9999,0
1668232886993,COGS 210B,003,101422,Nitz; Douglas A.,9999,0,9999,0
1668232886993,COGS 210B,004,101423,Hollan; James D.,9998,0,9999,1
1668232886993,COGS 210B,005,101424,Deak; Gedeon O.,9998,0,9999,1
1668232886993,COGS 210B,006,101425,Rossano; Federico,9999,0,9999,0
1668232887416,COGS 211B,A00,101427,Coulson; Seana M,9996,0,9999,3
1668232887841,COGS 220,A00,101428,Hollan; James D.,0,0,25,25
1668232888268,COGS 229,A00,101429,Dow; Steven P,18,0,25,7
1668232888693,COGS 230,A00,101430,Klemmer; Scott R,12,0,17,5
1668232889117,COGS 234,A00,101431,Xia; Haijun,2,0,25,23
1668232889540,COGS 260,A00,101432,Kiyonaga; Anastasia,21,0,25,4
1668232889540,COGS 260,B00,101433,Kirsh; David Joel,15,0,25,10
1668232889968,CSE 202,A00,102371,Impagliazzo; Russell,0,0,0,0
1668232890408,CSE 203B,A01,102373,Cheng; Chung Kuan,0,0,0,0
1668232890831,CSE 208,A00,102374,Micciancio; Daniele,0,0,0,0
1668232891255,CSE 209A,A00,112895,Impagliazzo; Russell,0,0,15,15
1668232891685,CSE 209B,A00,108005,Bellare; Mihir,0,0,0,0
1668232892108,CSE 210,A00,113163,Coblenz; Michael J,0,0,0,0
1668232892540,CSE 219,A00,106111,Dow; Steven P,0,0,20,20
1668232892976,CSE 221,A00,102376,Voelker; Geoffrey M.,0,0,0,0
1668232893401,CSE 224,A01,102378,Porter; George M,0,0,0,0
1668232893823,CSE 229A,A00,102379,Savage; Stefan,0,0,0,0
1668232894246,CSE 229C,A00,102380,Munyaka; Imani N. S.,0,0,0,0
1668232894686,CSE 232B,A00,102382,Deutsch; Alin Bernard,0,0,0,0
1668232895109,CSE 234,A01,112904,Kumar; Arun Kumar,0,0,0,0
1668232895535,CSE 237A,A00,102383,Rosing; Tajana Simunic,0,0,0,0
1668232895958,CSE 239A,A00,102384,Deutsch; Alin Bernard,0,0,0,0
1668232896385,CSE 239B,A00,102385,Polikarpova; Nadezhda,0,0,0,0
1668232896811,CSE 240A,A00,102386,Pannuto; Patrick William,0,0,0,0
1668232897232,CSE 240B,A00,102387,Zhao; Jishen,0,0,0,0
1668232897661,CSE 241A,A00,106406,Kang; Mingu,0,0,0,0
1668232898085,CSE 249B,A00,102388,Kahng; Andrew Byun,0,0,8,8
1668232898509,CSE 251B,A01,102392,Cottrell; Garrison W,0,0,0,0
1668232898509,CSE 251B,A02,102393,Cottrell; Garrison W,0,0,0,0
1668232898932,CSE 252B,A00,102394,Ochoa; Benjamin Lawrence,0,0,0,0
1668232899359,CSE 257,A01,102396,Gao; Sicun,0,0,0,0
1668232899793,CSE 272,A00,102397,Li; Tzumao,0,0,0,0
1668232900216,CSE 274,A00,111323,Chern; Albert Ren-Haur,0,0,0,0
1668232900643,CSE 282,A00,102398,Pevzner; Pavel Arkadjevich,0,0,0,0
1668232901072,CSE 284,A00,114175,Gymrek; Melissa Ann,0,0,0,0
1668232901495,CSE 290,A00,102399,Chandraker; Manmohan Krishna,0,0,0,0
1668232901495,CSE 290,B00,102400,Vaccaro; Kristen Marie,0,0,25,25
1668232901495,CSE 290,C00,102414,Pannuto; Patrick William,0,0,25,25
1668232901495,CSE 290,D00,102427,Pevzner; Pavel Arkadjevich,0,0,0,0
1668232901495,CSE 290,E00,102429,Zhao; Jishen,0,0,0,0
1668232901495,CSE 290,F00,102436,Tullsen; Dean Michael,0,0,0,0
1668232901495,CSE 290,G00,102440,Christensen; Henrik I,0,0,20,20
1668232901920,CSE 291,A00,102443,Su; Hao,0,0,0,0
1668232901920,CSE 291,B00,102448,Polikarpova; Nadezhda,0,0,0,0
1668232901920,CSE 291,C00,102453,Vaccaro; Kristen Marie,0,0,0,0
1668232901920,CSE 291,D00,111343,Savage; Stefan,0,0,0,0
1668232901920,CSE 291,E00,116474,Claffy; Kimberly Claire,0,0,0,0
1668232901920,CSE 291,F00,116479,Pasquale; Joseph,0,0,0,0
1668232902348,CSE 293,001,119111,Bafna; Vineet,9999,0,9999,0
1668232902348,CSE 293,002,119118,Bellare; Mihir,9999,0,9999,0
1668232902348,CSE 293,003,119122,Berg-Kirkpatrick; Taylor D,9999,0,9999,0
1668232902348,CSE 293,004,119135,Christensen; Henrik I,9999,0,9999,0
1668232902348,CSE 293,005,119142,Cottrell; Garrison W,9999,0,9999,0
1668232902348,CSE 293,006,119146,Deutsch; Alin Bernard,9999,0,9999,0
1668232902348,CSE 293,007,119159,Esmaeilzadeh; Hadi,9999,0,9999,0
1668232902348,CSE 293,008,119166,Freund; Yoav,9999,0,9999,0
1668232902348,CSE 293,009,119170,Griswold; William G.,9999,0,9999,0
1668232902348,CSE 293,010,119183,Gymrek; Melissa Ann,9999,0,9999,0
1668232902348,CSE 293,011,119190,Heninger; Nadia A,9999,0,9999,0
1668232902348,CSE 293,012,119230,Impagliazzo; Russell,9999,0,9999,0
1668232902348,CSE 293,013,119232,Jhala; Ranjit,9999,0,9999,0
1668232902348,CSE 293,014,119233,Kahng; Andrew Byun,9999,0,9999,0
1668232902348,CSE 293,015,119298,Kane; Daniel Mertz,9999,0,9999,0
1668232902348,CSE 293,016,119299,Kriegman; David J,9999,0,9999,0
1668232902348,CSE 293,017,119300,Kumar; Arun Kumar,9999,0,9999,0
1668232902348,CSE 293,018,119301,Lerner; Sorin,9999,0,9999,0
1668232902348,CSE 293,019,119302,Lovett; Shachar,9999,0,9999,0
1668232902348,CSE 293,020,119303,McAuley; Julian John,9999,0,9999,0
1668232902348,CSE 293,021,119304,Micciancio; Daniele,9999,0,9999,0
1668232902348,CSE 293,022,119367,Orailoglu; Alex,9999,0,9999,0
1668232902348,CSE 293,023,119382,Paturi; Ramamohan,9999,0,9999,0
1668232902348,CSE 293,024,119404,Polikarpova; Nadezhda,9999,0,9999,0
1668232902348,CSE 293,025,119406,Politz; Joseph Gibbs,9999,0,9999,0
1668232902348,CSE 293,026,119411,Porter; George M,9999,0,9999,0
1668232902348,CSE 293,027,119414,Porter; Leonard Emerson,9999,0,9999,0
1668232902348,CSE 293,028,119416,Ramamoorthi; Ravi,9999,0,9999,0
1668232902348,CSE 293,029,119417,Sahoo; Debashis,9999,0,9999,0
1668232902348,CSE 293,030,119420,Saul; Lawrence,9999,0,9999,0
1668232902348,CSE 293,031,119421,Savage; Stefan,9999,0,9999,0
1668232902348,CSE 293,032,119425,Schulze; Jurgen P.,9999,0,9999,0
1668232902348,CSE 293,033,119426,Snoeren; Alex C.,9999,0,9999,0
1668232902348,CSE 293,034,119428,Shang; Jingbo,9999,0,9999,0
1668232902348,CSE 293,035,119430,Stefan; Deian,9999,0,9999,0
1668232902348,CSE 293,036,119431,Su; Hao,9999,0,9999,0
1668232902348,CSE 293,037,119433,Swanson; Steven James,9999,0,9999,0
1668232902348,CSE 293,038,119435,Tullsen; Dean Michael,9999,0,9999,0
1668232902348,CSE 293,039,119483,Voelker; Geoffrey M.,9999,0,9999,0
1668232902348,CSE 293,040,119537,Zhao; Jishen,9999,0,9999,0
1668232902348,CSE 293,041,119538,Zhou; Yuan-Yuan,9999,0,9999,0
1668232902348,CSE 293,042,119539,Gao; Sicun,9999,0,9999,0
1668232902348,CSE 293,043,119540,Weibel; Nadir,9999,0,9999,0
1668232902348,CSE 293,044,119541,Gupta; Rajesh K.,9999,0,9999,0
1668232902348,CSE 293,045,126410,Vaccaro; Kristen Marie,9999,0,9999,0
1668232902348,CSE 293,046,126411,Klemke; Richard,9999,0,9999,0
1668232902770,CSE 294,A00,102459,Voelker; Geoffrey M.,0,0,0,0
1668232902770,CSE 294,B00,111322,Orailoglu; Alex,0,0,0,0
1668232903197,DSE 201,A00,096914,Deutsch; Alin Bernard,30,0,30,0
1668232903624,DSE 210,A00,096915,Dasgupta; Sanjoy,30,0,30,0
1668232904047,DSE 260A,A00,096916,Altintas De Callaf; Ilkay,30,0,30,0
1668232904486,ECE 200,001,103586,Antipa; Nicholas A,9999,0,9999,0
1668232904486,ECE 200,002,103587,Atanasov; Nikolay A.,9999,0,9999,0
1668232904486,ECE 200,003,103588,Bharadia; Dinesh,9999,0,9999,0
1668232904486,ECE 200,004,103589,Cheng; Chung Kuan,9999,0,9999,0
1668232904486,ECE 200,005,103590,Cosman; Pamela C.,9999,0,9999,0
1668232904486,ECE 200,006,103591,Dayeh; Shadi Ahmad,9999,0,9999,0
1668232904486,ECE 200,007,103592,Fainman; Yeshaiahu,9999,0,9999,0
1668232904486,ECE 200,008,103593,Ford; Joseph Earl,9999,0,9999,0
1668232904486,ECE 200,009,103594,Franceschetti; Massimo,9999,0,9999,0
1668232904486,ECE 200,010,103595,Fullerton; Eric E,9999,0,9999,0
1668232904486,ECE 200,011,103596,Galton; Ian A,9999,0,9999,0
1668232904486,ECE 200,012,103597,Gilja; Vikash,9999,0,9999,0
1668232904486,ECE 200,013,103598,Hall; Drew A.,9999,0,9999,0
1668232904486,ECE 200,014,103599,Hsueh; Tzu-Chien,9999,0,9999,0
1668232904486,ECE 200,015,103600,Javidi; Tara,9999,0,9999,0
1668232904486,ECE 200,016,103601,Kahng; Andrew Byun,9999,0,9999,0
1668232904486,ECE 200,017,103602,Kim; Young-Han,9999,0,9999,0
1668232904486,ECE 200,018,103603,Koushanfar; Farinaz,9999,0,9999,0
1668232904486,ECE 200,019,103604,Kuzum; Duygu,9999,0,9999,0
1668232904486,ECE 200,020,103605,Le; Hanh-Phuc,9999,0,9999,0
1668232904486,ECE 200,021,103606,Lin; Bill,9999,0,9999,0
1668232904486,ECE 200,022,103607,Liu; Zhaowei,9998,0,9999,1
1668232904486,ECE 200,023,103608,Lo; Yu-Hwa,9999,0,9999,0
1668232904486,ECE 200,024,103609,Lomakin; Vitaliy,9999,0,9999,0
1668232904486,ECE 200,025,103610,Mercier; Patrick Philip,9999,0,9999,0
1668232904486,ECE 200,026,103611,Meyer; Florian,9999,0,9999,0
1668232904486,ECE 200,027,103612,Milstein; Laurence B.,9999,0,9999,0
1668232904486,ECE 200,028,103613,Mir Arabbaygi; Siavash,9999,0,9999,0
1668232904486,ECE 200,029,103614,Mookherjea; Shayan,9999,0,9999,0
1668232904486,ECE 200,030,103615,Morris; Karcher William,9999,0,9999,0
1668232904486,ECE 200,031,103616,Ng; Tse Nga,9999,0,9999,0
1668232904486,ECE 200,032,103617,Nguyen; Truong Quang,9999,0,9999,0
1668232904486,ECE 200,033,103618,Nomura; Kenji,9999,0,9999,0
1668232904486,ECE 200,034,103619,Orlitsky; Alon,9999,0,9999,0
1668232904486,ECE 200,035,103620,Pal; Piya,9999,0,9999,0
1668232904486,ECE 200,036,103621,Papen; George C.,9999,0,9999,0
1668232904486,ECE 200,037,103622,Radic; Stojan,9999,0,9999,0
1668232904486,ECE 200,038,103623,Rao; Bhaskar D.,9999,0,9999,0
1668232904486,ECE 200,039,103624,Rao; Ramesh R,9999,0,9999,0
1668232904486,ECE 200,040,103625,Rebeiz; Gabriel,9999,0,9999,0
1668232904486,ECE 200,041,103626,Sanford; John R,9999,0,9999,0
1668232904486,ECE 200,042,103627,Siegel; Paul H.,9999,0,9999,0
1668232904486,ECE 200,043,103628,Sievenpiper; Daniel F.,9999,0,9999,0
1668232904486,ECE 200,044,103629,Sworder; David D.,9999,0,9999,0
1668232904486,ECE 200,045,103630,Taur; Yuan,9999,0,9999,0
1668232904486,ECE 200,046,103631,Touri; Behrouz,9999,0,9999,0
1668232904486,ECE 200,047,103632,Trivedi; Mohan M.,9999,0,9999,0
1668232904486,ECE 200,048,103633,Vasconcelos; Nuno,9999,0,9999,0
1668232904486,ECE 200,049,103634,Wang; Xiaolong,9999,0,9999,0
1668232904486,ECE 200,050,103635,Xie; Pengtao,9999,0,9999,0
1668232904486,ECE 200,051,103636,Yip; Michael,9999,0,9999,0
1668232904486,ECE 200,052,103637,Zeger; Kenneth A.,999,0,999,0
1668232904486,ECE 200,053,103638,Zhang; Xinyu,9999,0,9999,0
1668232904486,ECE 200,054,103639,Turakhia; Yatish Girish,9999,0,9999,0
1668232904486,ECE 200,055,103640,Kang; Mingu,9999,0,9999,0
1668232904486,ECE 200,056,103641,Shi; Yuanyuan,9999,0,9999,0
1668232904486,ECE 200,057,103642,Wang; Edward Jay,9999,0,9999,0
1668232904486,ECE 200,058,103643,Zheng; Yang,9999,0,9999,0
1668232904910,ECE 202,A00,103644,Kuzum; Duygu,0,0,0,0
1668232905334,ECE 212BN,A00,103646,Ng; Tse Nga,0,0,0,0
1668232905761,ECE 221,A00,111493,Staff,0,0,0,0
1668232906185,ECE 222B,A00,103647,Lomakin; Vitaliy,0,0,0,0
1668232906613,ECE 230B,A00,103648,Taur; Yuan,0,0,0,0
1668232907037,ECE 238B,A00,103649,Garay; Javier,0,0,0,0
1668232907459,ECE 240B,A00,112900,Fainman; Yeshaiahu,0,0,0,0
1668232907887,ECE 247A,A00,103650,Jokerst; Jesse Vincent,0,0,0,0
1668232908313,ECE 247B,A00,103651,Wang; Joseph,0,0,0,0
1668232908739,ECE 250,A00,103652,Siegel; Paul H.,0,0,0,0
1668232909164,ECE 251A,A00,103654,Rao; Bhaskar D.,0,0,0,0
1668232909587,ECE 257B,A00,103655,Bharadia; Dinesh,0,0,0,0
1668232910013,ECE 258A,A00,103656,Milstein; Laurence B.,0,0,0,0
1668232910436,ECE 260B,A00,103658,Kang; Mingu,0,0,0,0
1668232910862,ECE 264A,A00,103659,Galton; Ian A,0,0,0,0
1668232911378,ECE 265A,A00,103661,Gudem; Prasad S.S.,0,0,0,0
1668232911803,ECE 265D,A00,103662,Gudem; Prasad S.S.,0,0,0,0
1668232912228,ECE 268,A00,103663,Koushanfar; Farinaz,0,0,0,0
1668232912655,ECE 269,A01,103665,Pal; Piya,0,0,0,0
1668232913077,ECE 271B,A00,103666,Vasconcelos; Manuela,0,0,0,0
1668232913502,ECE 276A,A00,103667,Atanasov; Nikolay A.,0,0,0,0
1668232913930,ECE 277,A00,103668,An; Cheolhong,0,0,0,0
1668232914353,ECE 279,A00,117947,Hall; Drew A.,0,0,0,0
1668232915225,ECE 283,A00,103670,Hsueh; Tzu-Chien,0,0,0,0
1668232915649,ECE 284,A00,103671,Turakhia; Yatish Girish,0,0,0,0
1668232916092,ECE 285,A00,103672,Zheng; Yang,0,0,0,0
1668232916092,ECE 285,B00,103673,Sworder; David D.,0,0,0,0
1668232916519,ECE 287,A00,103676,Javidi; Tara,0,0,0,0
1668232916943,MATH 200B,A00,098023,Salehi Golsefidy; Alireza,12,0,15,3
1668232917371,MATH 202B,A00,098024,Rhoades; Brendon Patrick,9,0,15,6
1668232917796,MATH 203B,A00,098025,Oprea; Dragos N.,10,0,15,5
1668232918231,MATH 204B,A00,098026,Sorensen; Claus M,13,0,15,2
1668232918668,MATH 208,A00,098027,Izadi; Elham,7,0,10,3
1668232919097,MATH 209,A00,098028,Pollack; Aaron,10,0,10,0
1668232919521,MATH 211A,A00,112919,Rogalski; Daniel,9,0,10,1
1668232919945,MATH 211B,A00,112920,Seward; Brandon M.,9,0,10,1
1668232920368,MATH 218,A00,098029,Li; Bo,10,0,10,0
1668232920790,MATH 220B,A00,098030,Novak; Jonathan I,11,0,15,4
1668232921228,MATH 221A,A00,098031,Ebenfelt; Peter F,13,0,15,2
1668232921649,MATH 231B,A00,098032,Zlatos; Andrej,12,0,15,3
1668232922073,MATH 240B,A00,098033,Ni; Lei,9,0,15,6
1668232922496,MATH 243,A00,098034,Jekel; David Andrew,10,0,10,0
1668232922922,MATH 245A,A00,098035,Nie; Jiawang,0,0,15,16
1668232923344,MATH 248,A00,098036,Bejenaru; Ioan,10,0,10,0
1668232923766,MATH 250B,A00,098037,Spolaor; Luca,14,0,15,1
1668232924189,MATH 258,A00,098038,Ni; Lei,10,0,10,0
1668232924613,MATH 264B,A00,098041,Rhoades; Brendon Patrick,9,0,15,6
1668232925037,MATH 268,A00,098042,Buss; Samuel R,10,0,10,0
1668232925461,MATH 269,A00,098043,Rhoades; Brendon Patrick,10,0,10,0
1668232925882,MATH 270B,A00,098044,Li; Bo,10,0,15,5
1668232926306,MATH 272B,A00,098045,Holst; Michael J,13,0,15,2
1668232926733,MATH 273A,A00,098046,Tian; Xiaochuan,10,0,15,5
1668232927158,MATH 275,A01,098048,Tian; Xiaochuan,6,0,10,4
1668232927598,MATH 278A,A00,098049,Holst; Michael J,8,0,10,2
1668232928045,MATH 278B,A00,098050,Cloninger; Alexander,10,0,10,0
1668232928469,MATH 278C,A00,098051,Nie; Jiawang,7,0,10,3
1668232928893,MATH 280B,A00,098052,Zheng; Tianyi,10,0,15,5
1668232929319,MATH 281B,A00,098053,Bradic; Jelena,2,0,15,13
1668232929745,MATH 282B,A00,098054,Arias-Castro; Ery,0,0,15,15
1668232930169,MATH 285,A00,098055,Fitzsimmons; Patrick J,0,0,15,17
1668232930591,MATH 287B,A00,098056,Arias-Castro; Ery,2,0,15,13
1668232931018,MATH 288,A00,098057,Agarwal; Pooja,9,0,10,1
1668232931018,MATH 288,B00,098058,Zhang; Danna,8,0,10,2
1668232931018,MATH 288,C00,098059,Williams; Ruth J,10,0,10,0
1668232931442,MATH 290B,A00,098060,Roberts; Justin Deritter,13,0,15,2
1668232931866,MATH 292,A00,098061,Belmont; Eva Kinoshita,10,0,10,0
1668232932301,MATH 295,A00,098062,Suk; Andrew Hoon,48,0,50,2
1668232932731,MATH 296,A00,098063,Novak; Jonathan I,20,0,20,0
1668232933157,MATH 297,001,098064,Gamst; Anthony Collins,9997,0,9999,2
1668233433727,COGS 205,A00,101395,Chiba; Andrea,19,0,20,1
1668233434159,COGS 210B,001,101404,Greene; Deanna Jacquelyn,9998,0,9999,1
1668233434159,COGS 210B,002,101417,Xia; Haijun,9999,0,9999,0
1668233434159,COGS 210B,003,101422,Nitz; Douglas A.,9999,0,9999,0
1668233434159,COGS 210B,004,101423,Hollan; James D.,9998,0,9999,1
1668233434159,COGS 210B,005,101424,Deak; Gedeon O.,9998,0,9999,1
1668233434159,COGS 210B,006,101425,Rossano; Federico,9999,0,9999,0
1668233434595,COGS 211B,A00,101427,Coulson; Seana M,9996,0,9999,3
1668233435024,COGS 220,A00,101428,Hollan; James D.,0,0,25,25
1668233435445,COGS 229,A00,101429,Dow; Steven P,18,0,25,7
1668233435883,COGS 230,A00,101430,Klemmer; Scott R,12,0,17,5
1668233436307,COGS 234,A00,101431,Xia; Haijun,2,0,25,23
1668233436734,COGS 260,A00,101432,Kiyonaga; Anastasia,21,0,25,4
1668233436734,COGS 260,B00,101433,Kirsh; David Joel,15,0,25,10
1668233437169,CSE 202,A00,102371,Impagliazzo; Russell,0,0,0,0
1668233437593,CSE 203B,A01,102373,Cheng; Chung Kuan,0,0,0,0
1668233438018,CSE 208,A00,102374,Micciancio; Daniele,0,0,0,0
1668233438442,CSE 209A,A00,112895,Impagliazzo; Russell,0,0,15,15
1668233438872,CSE 209B,A00,108005,Bellare; Mihir,0,0,0,0
1668233439295,CSE 210,A00,113163,Coblenz; Michael J,0,0,0,0
1668233439719,CSE 219,A00,106111,Dow; Steven P,0,0,20,20
1668233440143,CSE 221,A00,102376,Voelker; Geoffrey M.,0,0,0,0
1668233440566,CSE 224,A01,102378,Porter; George M,0,0,0,0
1668233440991,CSE 229A,A00,102379,Savage; Stefan,0,0,0,0
1668233441416,CSE 229C,A00,102380,Munyaka; Imani N. S.,0,0,0,0
1668233441846,CSE 232B,A00,102382,Deutsch; Alin Bernard,0,0,0,0
1668233442272,CSE 234,A01,112904,Kumar; Arun Kumar,0,0,0,0
1668233442698,CSE 237A,A00,102383,Rosing; Tajana Simunic,0,0,0,0
1668233443125,CSE 239A,A00,102384,Deutsch; Alin Bernard,0,0,0,0
1668233443554,CSE 239B,A00,102385,Polikarpova; Nadezhda,0,0,0,0
1668233443981,CSE 240A,A00,102386,Pannuto; Patrick William,0,0,0,0
1668233444408,CSE 240B,A00,102387,Zhao; Jishen,0,0,0,0
1668233444838,CSE 241A,A00,106406,Kang; Mingu,0,0,0,0
1668233445270,CSE 249B,A00,102388,Kahng; Andrew Byun,0,0,8,8
1668233445697,CSE 251B,A01,102392,Cottrell; Garrison W,0,0,0,0
1668233445697,CSE 251B,A02,102393,Cottrell; Garrison W,0,0,0,0
1668233446121,CSE 252B,A00,102394,Ochoa; Benjamin Lawrence,0,0,0,0
1668233446549,CSE 257,A01,102396,Gao; Sicun,0,0,0,0
1668233446982,CSE 272,A00,102397,Li; Tzumao,0,0,0,0
1668233447414,CSE 274,A00,111323,Chern; Albert Ren-Haur,0,0,0,0
1668233447850,CSE 282,A00,102398,Pevzner; Pavel Arkadjevich,0,0,0,0
1668233448292,CSE 284,A00,114175,Gymrek; Melissa Ann,0,0,0,0
1668233448716,CSE 290,A00,102399,Chandraker; Manmohan Krishna,0,0,0,0
1668233448716,CSE 290,B00,102400,Vaccaro; Kristen Marie,0,0,25,25
1668233448716,CSE 290,C00,102414,Pannuto; Patrick William,0,0,25,25
1668233448716,CSE 290,D00,102427,Pevzner; Pavel Arkadjevich,0,0,0,0
1668233448716,CSE 290,E00,102429,Zhao; Jishen,0,0,0,0
1668233448716,CSE 290,F00,102436,Tullsen; Dean Michael,0,0,0,0
1668233448716,CSE 290,G00,102440,Christensen; Henrik I,0,0,20,20
1668233449157,CSE 291,A00,102443,Su; Hao,0,0,0,0
1668233449157,CSE 291,B00,102448,Polikarpova; Nadezhda,0,0,0,0
1668233449157,CSE 291,C00,102453,Vaccaro; Kristen Marie,0,0,0,0
1668233449157,CSE 291,D00,111343,Savage; Stefan,0,0,0,0
1668233449157,CSE 291,E00,116474,Claffy; Kimberly Claire,0,0,0,0
1668233449157,CSE 291,F00,116479,Pasquale; Joseph,0,0,0,0
1668233449623,CSE 293,001,119111,Bafna; Vineet,9999,0,9999,0
1668233449623,CSE 293,002,119118,Bellare; Mihir,9999,0,9999,0
1668233449623,CSE 293,003,119122,Berg-Kirkpatrick; Taylor D,9999,0,9999,0
1668233449623,CSE 293,004,119135,Christensen; Henrik I,9999,0,9999,0
1668233449623,CSE 293,005,119142,Cottrell; Garrison W,9999,0,9999,0
1668233449623,CSE 293,006,119146,Deutsch; Alin Bernard,9999,0,9999,0
1668233449623,CSE 293,007,119159,Esmaeilzadeh; Hadi,9999,0,9999,0
1668233449623,CSE 293,008,119166,Freund; Yoav,9999,0,9999,0
1668233449623,CSE 293,009,119170,Griswold; William G.,9999,0,9999,0
1668233449623,CSE 293,010,119183,Gymrek; Melissa Ann,9999,0,9999,0
1668233449623,CSE 293,011,119190,Heninger; Nadia A,9999,0,9999,0
1668233449623,CSE 293,012,119230,Impagliazzo; Russell,9999,0,9999,0
1668233449623,CSE 293,013,119232,Jhala; Ranjit,9999,0,9999,0
1668233449623,CSE 293,014,119233,Kahng; Andrew Byun,9999,0,9999,0
1668233449623,CSE 293,015,119298,Kane; Daniel Mertz,9999,0,9999,0
1668233449623,CSE 293,016,119299,Kriegman; David J,9999,0,9999,0
1668233449623,CSE 293,017,119300,Kumar; Arun Kumar,9999,0,9999,0
1668233449623,CSE 293,018,119301,Lerner; Sorin,9999,0,9999,0
1668233449623,CSE 293,019,119302,Lovett; Shachar,9999,0,9999,0
1668233449623,CSE 293,020,119303,McAuley; Julian John,9999,0,9999,0
1668233449623,CSE 293,021,119304,Micciancio; Daniele,9999,0,9999,0
1668233449623,CSE 293,022,119367,Orailoglu; Alex,9999,0,9999,0
1668233449623,CSE 293,023,119382,Paturi; Ramamohan,9999,0,9999,0
1668233449623,CSE 293,024,119404,Polikarpova; Nadezhda,9999,0,9999,0
1668233449623,CSE 293,025,119406,Politz; Joseph Gibbs,9999,0,9999,0
1668233449623,CSE 293,026,119411,Porter; George M,9999,0,9999,0
1668233449623,CSE 293,027,119414,Porter; Leonard Emerson,9999,0,9999,0
1668233449623,CSE 293,028,119416,Ramamoorthi; Ravi,9999,0,9999,0
1668233449623,CSE 293,029,119417,Sahoo; Debashis,9999,0,9999,0
1668233449623,CSE 293,030,119420,Saul; Lawrence,9999,0,9999,0
1668233449623,CSE 293,031,119421,Savage; Stefan,9999,0,9999,0
1668233449623,CSE 293,032,119425,Schulze; Jurgen P.,9999,0,9999,0
1668233449623,CSE 293,033,119426,Snoeren; Alex C.,9999,0,9999,0
1668233449623,CSE 293,034,119428,Shang; Jingbo,9999,0,9999,0
1668233449623,CSE 293,035,119430,Stefan; Deian,9999,0,9999,0
1668233449623,CSE 293,036,119431,Su; Hao,9999,0,9999,0
1668233449623,CSE 293,037,119433,Swanson; Steven James,9999,0,9999,0
1668233449623,CSE 293,038,119435,Tullsen; Dean Michael,9999,0,9999,0
1668233449623,CSE 293,039,119483,Voelker; Geoffrey M.,9999,0,9999,0
1668233449623,CSE 293,040,119537,Zhao; Jishen,9999,0,9999,0
1668233449623,CSE 293,041,119538,Zhou; Yuan-Yuan,9999,0,9999,0
1668233449623,CSE 293,042,119539,Gao; Sicun,9999,0,9999,0
1668233449623,CSE 293,043,119540,Weibel; Nadir,9999,0,9999,0
1668233449623,CSE 293,044,119541,Gupta; Rajesh K.,9999,0,9999,0
1668233449623,CSE 293,045,126410,Vaccaro; Kristen Marie,9999,0,9999,0
1668233449623,CSE 293,046,126411,Klemke; Richard,9999,0,9999,0
1668233450047,CSE 294,A00,102459,Voelker; Geoffrey M.,0,0,0,0
1668233450047,CSE 294,B00,111322,Orailoglu; Alex,0,0,0,0
1668233450471,DSE 201,A00,096914,Deutsch; Alin Bernard,30,0,30,0
1668233450897,DSE 210,A00,096915,Dasgupta; Sanjoy,30,0,30,0
1668233451320,DSE 260A,A00,096916,Altintas De Callaf; Ilkay,30,0,30,0
1668233451749,ECE 200,001,103586,Antipa; Nicholas A,9999,0,9999,0
1668233451749,ECE 200,002,103587,Atanasov; Nikolay A.,9999,0,9999,0
1668233451749,ECE 200,003,103588,Bharadia; Dinesh,9999,0,9999,0
1668233451749,ECE 200,004,103589,Cheng; Chung Kuan,9999,0,9999,0
1668233451749,ECE 200,005,103590,Cosman; Pamela C.,9999,0,9999,0
1668233451749,ECE 200,006,103591,Dayeh; Shadi Ahmad,9999,0,9999,0
1668233451749,ECE 200,007,103592,Fainman; Yeshaiahu,9999,0,9999,0
1668233451749,ECE 200,008,103593,Ford; Joseph Earl,9999,0,9999,0
1668233451749,ECE 200,009,103594,Franceschetti; Massimo,9999,0,9999,0
1668233451749,ECE 200,010,103595,Fullerton; Eric E,9999,0,9999,0
1668233451749,ECE 200,011,103596,Galton; Ian A,9999,0,9999,0
1668233451749,ECE 200,012,103597,Gilja; Vikash,9999,0,9999,0
1668233451749,ECE 200,013,103598,Hall; Drew A.,9999,0,9999,0
1668233451749,ECE 200,014,103599,Hsueh; Tzu-Chien,9999,0,9999,0
1668233451749,ECE 200,015,103600,Javidi; Tara,9999,0,9999,0
1668233451749,ECE 200,016,103601,Kahng; Andrew Byun,9999,0,9999,0
1668233451749,ECE 200,017,103602,Kim; Young-Han,9999,0,9999,0
1668233451749,ECE 200,018,103603,Koushanfar; Farinaz,9999,0,9999,0
1668233451749,ECE 200,019,103604,Kuzum; Duygu,9999,0,9999,0
1668233451749,ECE 200,020,103605,Le; Hanh-Phuc,9999,0,9999,0
1668233451749,ECE 200,021,103606,Lin; Bill,9999,0,9999,0
1668233451749,ECE 200,022,103607,Liu; Zhaowei,9998,0,9999,1
1668233451749,ECE 200,023,103608,Lo; Yu-Hwa,9999,0,9999,0
1668233451749,ECE 200,024,103609,Lomakin; Vitaliy,9999,0,9999,0
1668233451749,ECE 200,025,103610,Mercier; Patrick Philip,9999,0,9999,0
1668233451749,ECE 200,026,103611,Meyer; Florian,9999,0,9999,0
1668233451749,ECE 200,027,103612,Milstein; Laurence B.,9999,0,9999,0
1668233451749,ECE 200,028,103613,Mir Arabbaygi; Siavash,9999,0,9999,0
1668233451749,ECE 200,029,103614,Mookherjea; Shayan,9999,0,9999,0
1668233451749,ECE 200,030,103615,Morris; Karcher William,9999,0,9999,0
1668233451749,ECE 200,031,103616,Ng; Tse Nga,9999,0,9999,0
1668233451749,ECE 200,032,103617,Nguyen; Truong Quang,9999,0,9999,0
1668233451749,ECE 200,033,103618,Nomura; Kenji,9999,0,9999,0
1668233451749,ECE 200,034,103619,Orlitsky; Alon,9999,0,9999,0
1668233451749,ECE 200,035,103620,Pal; Piya,9999,0,9999,0
1668233451749,ECE 200,036,103621,Papen; George C.,9999,0,9999,0
1668233451749,ECE 200,037,103622,Radic; Stojan,9999,0,9999,0
1668233451749,ECE 200,038,103623,Rao; Bhaskar D.,9999,0,9999,0
1668233451749,ECE 200,039,103624,Rao; Ramesh R,9999,0,9999,0
1668233451749,ECE 200,040,103625,Rebeiz; Gabriel,9999,0,9999,0
1668233451749,ECE 200,041,103626,Sanford; John R,9999,0,9999,0
1668233451749,ECE 200,042,103627,Siegel; Paul H.,9999,0,9999,0
1668233451749,ECE 200,043,103628,Sievenpiper; Daniel F.,9999,0,9999,0
1668233451749,ECE 200,044,103629,Sworder; David D.,9999,0,9999,0
1668233451749,ECE 200,045,103630,Taur; Yuan,9999,0,9999,0
1668233451749,ECE 200,046,103631,Touri; Behrouz,9999,0,9999,0
1668233451749,ECE 200,047,103632,Trivedi; Mohan M.,9999,0,9999,0
1668233451749,ECE 200,048,103633,Vasconcelos; Nuno,9999,0,9999,0
1668233451749,ECE 200,049,103634,Wang; Xiaolong,9999,0,9999,0
1668233451749,ECE 200,050,103635,Xie; Pengtao,9999,0,9999,0
1668233451749,ECE 200,051,103636,Yip; Michael,9999,0,9999,0
1668233451749,ECE 200,052,103637,Zeger; Kenneth A.,999,0,999,0
1668233451749,ECE 200,053,103638,Zhang; Xinyu,9999,0,9999,0
1668233451749,ECE 200,054,103639,Turakhia; Yatish Girish,9999,0,9999,0
1668233451749,ECE 200,055,103640,Kang; Mingu,9999,0,9999,0
1668233451749,ECE 200,056,103641,Shi; Yuanyuan,9999,0,9999,0
1668233451749,ECE 200,057,103642,Wang; Edward Jay,9999,0,9999,0
1668233451749,ECE 200,058,103643,Zheng; Yang,9999,0,9999,0
1668233452175,ECE 202,A00,103644,Kuzum; Duygu,0,0,0,0
1668233452604,ECE 212BN,A00,103646,Ng; Tse Nga,0,0,0,0
1668233453029,ECE 221,A00,111493,Staff,0,0,0,0
1668233453452,ECE 222B,A00,103647,Lomakin; Vitaliy,0,0,0,0
1668233453876,ECE 230B,A00,103648,Taur; Yuan,0,0,0,0
1668233454303,ECE 238B,A00,103649,Garay; Javier,0,0,0,0
1668233454732,ECE 240B,A00,112900,Fainman; Yeshaiahu,0,0,0,0
1668233455159,ECE 247A,A00,103650,Jokerst; Jesse Vincent,0,0,0,0
1668233455581,ECE 247B,A00,103651,Wang; Joseph,0,0,0,0
1668233456003,ECE 250,A00,103652,Siegel; Paul H.,0,0,0,0
1668233456427,ECE 251A,A00,103654,Rao; Bhaskar D.,0,0,0,0
1668233456849,ECE 257B,A00,103655,Bharadia; Dinesh,0,0,0,0
1668233457275,ECE 258A,A00,103656,Milstein; Laurence B.,0,0,0,0
1668233457696,ECE 260B,A00,103658,Kang; Mingu,0,0,0,0
1668233458122,ECE 264A,A00,103659,Galton; Ian A,0,0,0,0
1668233458568,ECE 265A,A00,103661,Gudem; Prasad S.S.,0,0,0,0
1668233459010,ECE 265D,A00,103662,Gudem; Prasad S.S.,0,0,0,0
1668233459433,ECE 268,A00,103663,Koushanfar; Farinaz,0,0,0,0
1668233459857,ECE 269,A01,103665,Pal; Piya,0,0,0,0
1668233460279,ECE 271B,A00,103666,Vasconcelos; Manuela,0,0,0,0
1668233460703,ECE 276A,A00,103667,Atanasov; Nikolay A.,0,0,0,0
1668233461129,ECE 277,A00,103668,An; Cheolhong,0,0,0,0
1668233461551,ECE 279,A00,117947,Hall; Drew A.,0,0,0,0
1668233462399,ECE 283,A00,103670,Hsueh; Tzu-Chien,0,0,0,0
1668233462834,ECE 284,A00,103671,Turakhia; Yatish Girish,0,0,0,0
1668233463261,ECE 285,A00,103672,Zheng; Yang,0,0,0,0
1668233463261,ECE 285,B00,103673,Sworder; David D.,0,0,0,0
1668233463688,ECE 287,A00,103676,Javidi; Tara,0,0,0,0
1668233464112,MATH 200B,A00,098023,Salehi Golsefidy; Alireza,12,0,15,3
1668233464539,MATH 202B,A00,098024,Rhoades; Brendon Patrick,9,0,15,6
1668233464961,MATH 203B,A00,098025,Oprea; Dragos N.,10,0,15,5
1668233465385,MATH 204B,A00,098026,Sorensen; Claus M,13,0,15,2
1668233465807,MATH 208,A00,098027,Izadi; Elham,7,0,10,3
1668233466233,MATH 209,A00,098028,Pollack; Aaron,10,0,10,0
1668233466673,MATH 211A,A00,112919,Rogalski; Daniel,9,0,10,1
1668233467096,MATH 211B,A00,112920,Seward; Brandon M.,9,0,10,1
1668233467521,MATH 218,A00,098029,Li; Bo,10,0,10,0
1668233467945,MATH 220B,A00,098030,Novak; Jonathan I,11,0,15,4
1668233468368,MATH 221A,A00,098031,Ebenfelt; Peter F,13,0,15,2
1668233468806,MATH 231B,A00,098032,Zlatos; Andrej,12,0,15,3
1668233469234,MATH 240B,A00,098033,Ni; Lei,9,0,15,6
1668233469656,MATH 243,A00,098034,Jekel; David Andrew,10,0,10,0
1668233470080,MATH 245A,A00,098035,Nie; Jiawang,0,0,15,16
1668233470507,MATH 248,A00,098036,Bejenaru; Ioan,10,0,10,0
1668233470941,MATH 250B,A00,098037,Spolaor; Luca,14,0,15,1
1668233471367,MATH 258,A00,098038,Ni; Lei,10,0,10,0
1668233471793,MATH 264B,A00,098041,Rhoades; Brendon Patrick,9,0,15,6
1668233472215,MATH 268,A00,098042,Buss; Samuel R,10,0,10,0
1668233472640,MATH 269,A00,098043,Rhoades; Brendon Patrick,10,0,10,0
1668233473064,MATH 270B,A00,098044,Li; Bo,10,0,15,5
1668233473491,MATH 272B,A00,098045,Holst; Michael J,13,0,15,2
1668233473925,MATH 273A,A00,098046,Tian; Xiaochuan,10,0,15,5
1668233474359,MATH 275,A01,098048,Tian; Xiaochuan,6,0,10,4
1668233474794,MATH 278A,A00,098049,Holst; Michael J,8,0,10,2
1668233475294,MATH 278B,A00,098050,Cloninger; Alexander,10,0,10,0
1668233475725,MATH 278C,A00,098051,Nie; Jiawang,7,0,10,3
1668233476152,MATH 280B,A00,098052,Zheng; Tianyi,10,0,15,5
1668233476583,MATH 281B,A00,098053,Bradic; Jelena,2,0,15,13
1668233477021,MATH 282B,A00,098054,Arias-Castro; Ery,0,0,15,15
1668233477446,MATH 285,A00,098055,Fitzsimmons; Patrick J,0,0,15,17
1668233477869,MATH 287B,A00,098056,Arias-Castro; Ery,2,0,15,13
1668233478293,MATH 288,A00,098057,Agarwal; Pooja,9,0,10,1
1668233478293,MATH 288,B00,098058,Zhang; Danna,8,0,10,2
1668233478293,MATH 288,C00,098059,Williams; Ruth J,10,0,10,0
1668233478715,MATH 290B,A00,098060,Roberts; Justin Deritter,13,0,15,2
1668233479144,MATH 292,A00,098061,Belmont; Eva Kinoshita,10,0,10,0
1668233479574,MATH 295,A00,098062,Suk; Andrew Hoon,48,0,50,2
1668233479998,MATH 296,A00,098063,Novak; Jonathan I,20,0,20,0
1668233480423,MATH 297,001,098064,Gamst; Anthony Collins,9997,0,9999,2
1668233981387,COGS 205,A00,101395,Chiba; Andrea,19,0,20,1
1668233981821,COGS 210B,001,101404,Greene; Deanna Jacquelyn,9998,0,9999,1
1668233981821,COGS 210B,002,101417,Xia; Haijun,9999,0,9999,0
1668233981821,COGS 210B,003,101422,Nitz; Douglas A.,9999,0,9999,0
1668233981821,COGS 210B,004,101423,Hollan; James D.,9998,0,9999,1
1668233981821,COGS 210B,005,101424,Deak; Gedeon O.,9998,0,9999,1
1668233981821,COGS 210B,006,101425,Rossano; Federico,9999,0,9999,0
1668233982253,COGS 211B,A00,101427,Coulson; Seana M,9996,0,9999,3
1668233982679,COGS 220,A00,101428,Hollan; James D.,0,0,25,25
1668233983102,COGS 229,A00,101429,Dow; Steven P,18,0,25,7
1668233983540,COGS 230,A00,101430,Klemmer; Scott R,12,0,17,5
1668233983964,COGS 234,A00,101431,Xia; Haijun,2,0,25,23
1668233984398,COGS 260,A00,101432,Kiyonaga; Anastasia,21,0,25,4
1668233984398,COGS 260,B00,101433,Kirsh; David Joel,15,0,25,10
1668233984822,CSE 202,A00,102371,Impagliazzo; Russell,0,0,0,0
1668233985250,CSE 203B,A01,102373,Cheng; Chung Kuan,0,0,0,0
1668233985675,CSE 208,A00,102374,Micciancio; Daniele,0,0,0,0
1668233986102,CSE 209A,A00,112895,Impagliazzo; Russell,0,0,15,15
1668233986529,CSE 209B,A00,108005,Bellare; Mihir,0,0,0,0
1668233986958,CSE 210,A00,113163,Coblenz; Michael J,0,0,0,0
1668233987382,CSE 219,A00,106111,Dow; Steven P,0,0,20,20
1668233987805,CSE 221,A00,102376,Voelker; Geoffrey M.,0,0,0,0
1668233988229,CSE 224,A01,102378,Porter; George M,0,0,0,0
1668233988656,CSE 229A,A00,102379,Savage; Stefan,0,0,0,0
1668233989087,CSE 229C,A00,102380,Munyaka; Imani N. S.,0,0,0,0
1668233989511,CSE 232B,A00,102382,Deutsch; Alin Bernard,0,0,0,0
1668233989939,CSE 234,A01,112904,Kumar; Arun Kumar,0,0,0,0
1668233990363,CSE 237A,A00,102383,Rosing; Tajana Simunic,0,0,0,0
1668233990789,CSE 239A,A00,102384,Deutsch; Alin Bernard,0,0,0,0
1668233991221,CSE 239B,A00,102385,Polikarpova; Nadezhda,0,0,0,0
1668233991645,CSE 240A,A00,102386,Pannuto; Patrick William,0,0,0,0
1668233992067,CSE 240B,A00,102387,Zhao; Jishen,0,0,0,0
1668233992491,CSE 241A,A00,106406,Kang; Mingu,0,0,0,0
1668233992917,CSE 249B,A00,102388,Kahng; Andrew Byun,0,0,8,8
1668233993342,CSE 251B,A01,102392,Cottrell; Garrison W,0,0,0,0
1668233993342,CSE 251B,A02,102393,Cottrell; Garrison W,0,0,0,0
1668233993770,CSE 252B,A00,102394,Ochoa; Benjamin Lawrence,0,0,0,0
1668233994194,CSE 257,A01,102396,Gao; Sicun,0,0,0,0
1668233994619,CSE 272,A00,102397,Li; Tzumao,0,0,0,0
1668233995043,CSE 274,A00,111323,Chern; Albert Ren-Haur,0,0,0,0
1668233995469,CSE 282,A00,102398,Pevzner; Pavel Arkadjevich,0,0,0,0
1668233995893,CSE 284,A00,114175,Gymrek; Melissa Ann,0,0,0,0
1668233996417,CSE 290,A00,102399,Chandraker; Manmohan Krishna,0,0,0,0
1668233996417,CSE 290,B00,102400,Vaccaro; Kristen Marie,0,0,25,25
1668233996417,CSE 290,C00,102414,Pannuto; Patrick William,0,0,25,25
1668233996417,CSE 290,D00,102427,Pevzner; Pavel Arkadjevich,0,0,0,0
1668233996417,CSE 290,E00,102429,Zhao; Jishen,0,0,0,0
1668233996417,CSE 290,F00,102436,Tullsen; Dean Michael,0,0,0,0
1668233996417,CSE 290,G00,102440,Christensen; Henrik I,0,0,20,20
1668233996852,CSE 291,A00,102443,Su; Hao,0,0,0,0
1668233996852,CSE 291,B00,102448,Polikarpova; Nadezhda,0,0,0,0
1668233996852,CSE 291,C00,102453,Vaccaro; Kristen Marie,0,0,0,0
1668233996852,CSE 291,D00,111343,Savage; Stefan,0,0,0,0
1668233996852,CSE 291,E00,116474,Claffy; Kimberly Claire,0,0,0,0
1668233996852,CSE 291,F00,116479,Pasquale; Joseph,0,0,0,0
1668233997278,CSE 293,001,119111,Bafna; Vineet,9999,0,9999,0
1668233997278,CSE 293,002,119118,Bellare; Mihir,9999,0,9999,0
1668233997278,CSE 293,003,119122,Berg-Kirkpatrick; Taylor D,9999,0,9999,0
1668233997278,CSE 293,004,119135,Christensen; Henrik I,9999,0,9999,0
1668233997278,CSE 293,005,119142,Cottrell; Garrison W,9999,0,9999,0
1668233997278,CSE 293,006,119146,Deutsch; Alin Bernard,9999,0,9999,0
1668233997278,CSE 293,007,119159,Esmaeilzadeh; Hadi,9999,0,9999,0
1668233997278,CSE 293,008,119166,Freund; Yoav,9999,0,9999,0
1668233997278,CSE 293,009,119170,Griswold; William G.,9999,0,9999,0
1668233997278,CSE 293,010,119183,Gymrek; Melissa Ann,9999,0,9999,0
1668233997278,CSE 293,011,119190,Heninger; Nadia A,9999,0,9999,0
1668233997278,CSE 293,012,119230,Impagliazzo; Russell,9999,0,9999,0
1668233997278,CSE 293,013,119232,Jhala; Ranjit,9999,0,9999,0
1668233997278,CSE 293,014,119233,Kahng; Andrew Byun,9999,0,9999,0
1668233997278,CSE 293,015,119298,Kane; Daniel Mertz,9999,0,9999,0
1668233997278,CSE 293,016,119299,Kriegman; David J,9999,0,9999,0
1668233997278,CSE 293,017,119300,Kumar; Arun Kumar,9999,0,9999,0
1668233997278,CSE 293,018,119301,Lerner; Sorin,9999,0,9999,0
1668233997278,CSE 293,019,119302,Lovett; Shachar,9999,0,9999,0
1668233997278,CSE 293,020,119303,McAuley; Julian John,9999,0,9999,0
1668233997278,CSE 293,021,119304,Micciancio; Daniele,9999,0,9999,0
1668233997278,CSE 293,022,119367,Orailoglu; Alex,9999,0,9999,0
1668233997278,CSE 293,023,119382,Paturi; Ramamohan,9999,0,9999,0
1668233997278,CSE 293,024,119404,Polikarpova; Nadezhda,9999,0,9999,0
1668233997278,CSE 293,025,119406,Politz; Joseph Gibbs,9999,0,9999,0
1668233997278,CSE 293,026,119411,Porter; George M,9999,0,9999,0
1668233997278,CSE 293,027,119414,Porter; Leonard Emerson,9999,0,9999,0
1668233997278,CSE 293,028,119416,Ramamoorthi; Ravi,9999,0,9999,0
1668233997278,CSE 293,029,119417,Sahoo; Debashis,9999,0,9999,0
1668233997278,CSE 293,030,119420,Saul; Lawrence,9999,0,9999,0
1668233997278,CSE 293,031,119421,Savage; Stefan,9999,0,9999,0
1668233997278,CSE 293,032,119425,Schulze; Jurgen P.,9999,0,9999,0
1668233997278,CSE 293,033,119426,Snoeren; Alex C.,9999,0,9999,0
1668233997278,CSE 293,034,119428,Shang; Jingbo,9999,0,9999,0
1668233997278,CSE 293,035,119430,Stefan; Deian,9999,0,9999,0
1668233997278,CSE 293,036,119431,Su; Hao,9999,0,9999,0
1668233997278,CSE 293,037,119433,Swanson; Steven James,9999,0,9999,0
1668233997278,CSE 293,038,119435,Tullsen; Dean Michael,9999,0,9999,0
1668233997278,CSE 293,039,119483,Voelker; Geoffrey M.,9999,0,9999,0
1668233997278,CSE 293,040,119537,Zhao; Jishen,9999,0,9999,0
1668233997278,CSE 293,041,119538,Zhou; Yuan-Yuan,9999,0,9999,0
1668233997278,CSE 293,042,119539,Gao; Sicun,9999,0,9999,0
1668233997278,CSE 293,043,119540,Weibel; Nadir,9999,0,9999,0
1668233997278,CSE 293,044,119541,Gupta; Rajesh K.,9999,0,9999,0
1668233997278,CSE 293,045,126410,Vaccaro; Kristen Marie,9999,0,9999,0
1668233997278,CSE 293,046,126411,Klemke; Richard,9999,0,9999,0
1668233997710,CSE 294,A00,102459,Voelker; Geoffrey M.,0,0,0,0
1668233997710,CSE 294,B00,111322,Orailoglu; Alex,0,0,0,0
1668233998142,DSE 201,A00,096914,Deutsch; Alin Bernard,30,0,30,0
1668233998570,DSE 210,A00,096915,Dasgupta; Sanjoy,30,0,30,0
1668233998994,DSE 260A,A00,096916,Altintas De Callaf; Ilkay,30,0,30,0
1668233999426,ECE 200,001,103586,Antipa; Nicholas A,9999,0,9999,0
1668233999426,ECE 200,002,103587,Atanasov; Nikolay A.,9999,0,9999,0
1668233999426,ECE 200,003,103588,Bharadia; Dinesh,9999,0,9999,0
1668233999426,ECE 200,004,103589,Cheng; Chung Kuan,9999,0,9999,0
1668233999426,ECE 200,005,103590,Cosman; Pamela C.,9999,0,9999,0
1668233999426,ECE 200,006,103591,Dayeh; Shadi Ahmad,9999,0,9999,0
1668233999426,ECE 200,007,103592,Fainman; Yeshaiahu,9999,0,9999,0
1668233999426,ECE 200,008,103593,Ford; Joseph Earl,9999,0,9999,0
1668233999426,ECE 200,009,103594,Franceschetti; Massimo,9999,0,9999,0
1668233999426,ECE 200,010,103595,Fullerton; Eric E,9999,0,9999,0
1668233999426,ECE 200,011,103596,Galton; Ian A,9999,0,9999,0
1668233999426,ECE 200,012,103597,Gilja; Vikash,9999,0,9999,0
1668233999426,ECE 200,013,103598,Hall; Drew A.,9999,0,9999,0
1668233999426,ECE 200,014,103599,Hsueh; Tzu-Chien,9999,0,9999,0
1668233999426,ECE 200,015,103600,Javidi; Tara,9999,0,9999,0
1668233999426,ECE 200,016,103601,Kahng; Andrew Byun,9999,0,9999,0
1668233999426,ECE 200,017,103602,Kim; Young-Han,9999,0,9999,0
1668233999426,ECE 200,018,103603,Koushanfar; Farinaz,9999,0,9999,0
1668233999426,ECE 200,019,103604,Kuzum; Duygu,9999,0,9999,0
1668233999426,ECE 200,020,103605,Le; Hanh-Phuc,9999,0,9999,0
1668233999426,ECE 200,021,103606,Lin; Bill,9999,0,9999,0
1668233999426,ECE 200,022,103607,Liu; Zhaowei,9998,0,9999,1
1668233999426,ECE 200,023,103608,Lo; Yu-Hwa,9999,0,9999,0
1668233999426,ECE 200,024,103609,Lomakin; Vitaliy,9999,0,9999,0
1668233999426,ECE 200,025,103610,Mercier; Patrick Philip,9999,0,9999,0
1668233999426,ECE 200,026,103611,Meyer; Florian,9999,0,9999,0
1668233999426,ECE 200,027,103612,Milstein; Laurence B.,9999,0,9999,0
1668233999426,ECE 200,028,103613,Mir Arabbaygi; Siavash,9999,0,9999,0
1668233999426,ECE 200,029,103614,Mookherjea; Shayan,9999,0,9999,0
1668233999426,ECE 200,030,103615,Morris; Karcher William,9999,0,9999,0
1668233999426,ECE 200,031,103616,Ng; Tse Nga,9999,0,9999,0
1668233999426,ECE 200,032,103617,Nguyen; Truong Quang,9999,0,9999,0
1668233999426,ECE 200,033,103618,Nomura; Kenji,9999,0,9999,0
1668233999426,ECE 200,034,103619,Orlitsky; Alon,9999,0,9999,0
1668233999426,ECE 200,035,103620,Pal; Piya,9999,0,9999,0
1668233999426,ECE 200,036,103621,Papen; George C.,9999,0,9999,0
1668233999426,ECE 200,037,103622,Radic; Stojan,9999,0,9999,0
1668233999426,ECE 200,038,103623,Rao; Bhaskar D.,9999,0,9999,0
1668233999426,ECE 200,039,103624,Rao; Ramesh R,9999,0,9999,0
1668233999426,ECE 200,040,103625,Rebeiz; Gabriel,9999,0,9999,0
1668233999426,ECE 200,041,103626,Sanford; John R,9999,0,9999,0
1668233999426,ECE 200,042,103627,Siegel; Paul H.,9999,0,9999,0
1668233999426,ECE 200,043,103628,Sievenpiper; Daniel F.,9999,0,9999,0
1668233999426,ECE 200,044,103629,Sworder; David D.,9999,0,9999,0
1668233999426,ECE 200,045,103630,Taur; Yuan,9999,0,9999,0
1668233999426,ECE 200,046,103631,Touri; Behrouz,9999,0,9999,0
1668233999426,ECE 200,047,103632,Trivedi; Mohan M.,9999,0,9999,0
1668233999426,ECE 200,048,103633,Vasconcelos; Nuno,9999,0,9999,0
1668233999426,ECE 200,049,103634,Wang; Xiaolong,9999,0,9999,0
1668233999426,ECE 200,050,103635,Xie; Pengtao,9999,0,9999,0
1668233999426,ECE 200,051,103636,Yip; Michael,9999,0,9999,0
1668233999426,ECE 200,052,103637,Zeger; Kenneth A.,999,0,999,0
1668233999426,ECE 200,053,103638,Zhang; Xinyu,9999,0,9999,0
1668233999426,ECE 200,054,103639,Turakhia; Yatish Girish,9999,0,9999,0
1668233999426,ECE 200,055,103640,Kang; Mingu,9999,0,9999,0
1668233999426,ECE 200,056,103641,Shi; Yuanyuan,9999,0,9999,0
1668233999426,ECE 200,057,103642,Wang; Edward Jay,9999,0,9999,0
1668233999426,ECE 200,058,103643,Zheng; Yang,9999,0,9999,0
1668233999855,ECE 202,A00,103644,Kuzum; Duygu,0,0,0,0
1668234000282,ECE 212BN,A00,103646,Ng; Tse Nga,0,0,0,0
1668234000722,ECE 221,A00,111493,Staff,0,0,0,0
1668234001155,ECE 222B,A00,103647,Lomakin; Vitaliy,0,0,0,0
1668234001582,ECE 230B,A00,103648,Taur; Yuan,0,0,0,0
1668234002005,ECE 238B,A00,103649,Garay; Javier,0,0,0,0
1668234002432,ECE 240B,A00,112900,Fainman; Yeshaiahu,0,0,0,0
1668234002856,ECE 247A,A00,103650,Jokerst; Jesse Vincent,0,0,0,0
1668234003278,ECE 247B,A00,103651,Wang; Joseph,0,0,0,0
1668234003723,ECE 250,A00,103652,Siegel; Paul H.,0,0,0,0
1668234004149,ECE 251A,A00,103654,Rao; Bhaskar D.,0,0,0,0
1668234004581,ECE 257B,A00,103655,Bharadia; Dinesh,0,0,0,0
1668234005008,ECE 258A,A00,103656,Milstein; Laurence B.,0,0,0,0
1668234005435,ECE 260B,A00,103658,Kang; Mingu,0,0,0,0
1668234005859,ECE 264A,A00,103659,Galton; Ian A,0,0,0,0
1668234006283,ECE 265A,A00,103661,Gudem; Prasad S.S.,0,0,0,0
1668234006718,ECE 265D,A00,103662,Gudem; Prasad S.S.,0,0,0,0
1668234007153,ECE 268,A00,103663,Koushanfar; Farinaz,0,0,0,0
1668234007582,ECE 269,A01,103665,Pal; Piya,0,0,0,0
1668234008006,ECE 271B,A00,103666,Vasconcelos; Manuela,0,0,0,0
1668234008429,ECE 276A,A00,103667,Atanasov; Nikolay A.,0,0,0,0
1668234008855,ECE 277,A00,103668,An; Cheolhong,0,0,0,0
1668234009293,ECE 279,A00,117947,Hall; Drew A.,0,0,0,0
1668234010141,ECE 283,A00,103670,Hsueh; Tzu-Chien,0,0,0,0
1668234010566,ECE 284,A00,103671,Turakhia; Yatish Girish,0,0,0,0
1668234010991,ECE 285,A00,103672,Zheng; Yang,0,0,0,0
1668234010991,ECE 285,B00,103673,Sworder; David D.,0,0,0,0
1668234011419,ECE 287,A00,103676,Javidi; Tara,0,0,0,0
1668234011842,MATH 200B,A00,098023,Salehi Golsefidy; Alireza,12,0,15,3
1668234012266,MATH 202B,A00,098024,Rhoades; Brendon Patrick,9,0,15,6
1668234012690,MATH 203B,A00,098025,Oprea; Dragos N.,10,0,15,5
1668234013117,MATH 204B,A00,098026,Sorensen; Claus M,13,0,15,2
1668234013539,MATH 208,A00,098027,Izadi; Elham,7,0,10,3
1668234013965,MATH 209,A00,098028,Pollack; Aaron,10,0,10,0
1668234014389,MATH 211A,A00,112919,Rogalski; Daniel,9,0,10,1
1668234014813,MATH 211B,A00,112920,Seward; Brandon M.,9,0,10,1
1668234015238,MATH 218,A00,098029,Li; Bo,10,0,10,0
1668234015662,MATH 220B,A00,098030,Novak; Jonathan I,11,0,15,4
1668234016093,MATH 221A,A00,098031,Ebenfelt; Peter F,13,0,15,2
1668234016519,MATH 231B,A00,098032,Zlatos; Andrej,12,0,15,3
1668234016943,MATH 240B,A00,098033,Ni; Lei,9,0,15,6
1668234017369,MATH 243,A00,098034,Jekel; David Andrew,10,0,10,0
1668234017792,MATH 245A,A00,098035,Nie; Jiawang,0,0,15,16
1668234018215,MATH 248,A00,098036,Bejenaru; Ioan,10,0,10,0
1668234018638,MATH 250B,A00,098037,Spolaor; Luca,14,0,15,1
1668234019065,MATH 258,A00,098038,Ni; Lei,10,0,10,0
1668234019489,MATH 264B,A00,098041,Rhoades; Brendon Patrick,9,0,15,6
1668234019915,MATH 268,A00,098042,Buss; Samuel R,10,0,10,0
1668234020337,MATH 269,A00,098043,Rhoades; Brendon Patrick,10,0,10,0
1668234020762,MATH 270B,A00,098044,Li; Bo,10,0,15,5
1668234021197,MATH 272B,A00,098045,Holst; Michael J,13,0,15,2
1668234021623,MATH 273A,A00,098046,Tian; Xiaochuan,10,0,15,5
1668234022054,MATH 275,A01,098048,Tian; Xiaochuan,6,0,10,4
1668234022486,MATH 278A,A00,098049,Holst; Michael J,8,0,10,2
1668234022911,MATH 278B,A00,098050,Cloninger; Alexander,10,0,10,0
1668234023336,MATH 278C,A00,098051,Nie; Jiawang,7,0,10,3
1668234023761,MATH 280B,A00,098052,Zheng; Tianyi,10,0,15,5
1668234024193,MATH 281B,A00,098053,Bradic; Jelena,1,0,15,14
1668234024617,MATH 282B,A00,098054,Arias-Castro; Ery,0,0,15,15
1668234025043,MATH 285,A00,098055,Fitzsimmons; Patrick J,0,0,15,17
1668234025469,MATH 287B,A00,098056,Arias-Castro; Ery,2,0,15,13
1668234025893,MATH 288,A00,098057,Agarwal; Pooja,9,0,10,1
1668234025893,MATH 288,B00,098058,Zhang; Danna,8,0,10,2
1668234025893,MATH 288,C00,098059,Williams; Ruth J,10,0,10,0
1668234026320,MATH 290B,A00,098060,Roberts; Justin Deritter,13,0,15,2
1668234026744,MATH 292,A00,098061,Belmont; Eva Kinoshita,10,0,10,0
1668234027168,MATH 295,A00,098062,Suk; Andrew Hoon,48,0,50,2
1668234027592,MATH 296,A00,098063,Novak; Jonathan I,20,0,20,0
1668234028015,MATH 297,001,098064,Gamst; Anthony Collins,9997,0,9999,2
1668234528323,COGS 205,A00,101395,Chiba; Andrea,19,0,20,1
1668234528757,COGS 210B,001,101404,Greene; Deanna Jacquelyn,9998,0,9999,1
1668234528757,COGS 210B,002,101417,Xia; Haijun,9999,0,9999,0
1668234528757,COGS 210B,003,101422,Nitz; Douglas A.,9999,0,9999,0
1668234528757,COGS 210B,004,101423,Hollan; James D.,9998,0,9999,1
1668234528757,COGS 210B,005,101424,Deak; Gedeon O.,9998,0,9999,1
1668234528757,COGS 210B,006,101425,Rossano; Federico,9999,0,9999,0
1668234529182,COGS 211B,A00,101427,Coulson; Seana M,9996,0,9999,3
1668234529604,COGS 220,A00,101428,Hollan; James D.,0,0,25,25
1668234530033,COGS 229,A00,101429,Dow; Steven P,18,0,25,7
1668234530457,COGS 230,A00,101430,Klemmer; Scott R,12,0,17,5
1668234530883,COGS 234,A00,101431,Xia; Haijun,2,0,25,23
1668234531306,COGS 260,A00,101432,Kiyonaga; Anastasia,21,0,25,4
1668234531306,COGS 260,B00,101433,Kirsh; David Joel,15,0,25,10
1668234531733,CSE 202,A00,102371,Impagliazzo; Russell,0,0,0,0
1668234532158,CSE 203B,A01,102373,Cheng; Chung Kuan,0,0,0,0
1668234532581,CSE 208,A00,102374,Micciancio; Daniele,0,0,0,0
1668234533009,CSE 209A,A00,112895,Impagliazzo; Russell,0,0,15,15
1668234533442,CSE 209B,A00,108005,Bellare; Mihir,0,0,0,0
1668234533877,CSE 210,A00,113163,Coblenz; Michael J,0,0,0,0
1668234534301,CSE 219,A00,106111,Dow; Steven P,0,0,20,20
1668234534723,CSE 221,A00,102376,Voelker; Geoffrey M.,0,0,0,0
1668234535147,CSE 224,A01,102378,Porter; George M,0,0,0,0
1668234535583,CSE 229A,A00,102379,Savage; Stefan,0,0,0,0
1668234536007,CSE 229C,A00,102380,Munyaka; Imani N. S.,0,0,0,0
1668234536430,CSE 232B,A00,102382,Deutsch; Alin Bernard,0,0,0,0
1668234536854,CSE 234,A01,112904,Kumar; Arun Kumar,0,0,0,0
1668234537278,CSE 237A,A00,102383,Rosing; Tajana Simunic,0,0,0,0
1668234537702,CSE 239A,A00,102384,Deutsch; Alin Bernard,0,0,0,0
1668234538135,CSE 239B,A00,102385,Polikarpova; Nadezhda,0,0,0,0
1668234538570,CSE 240A,A00,102386,Pannuto; Patrick William,0,0,0,0
1668234538997,CSE 240B,A00,102387,Zhao; Jishen,0,0,0,0
1668234539423,CSE 241A,A00,106406,Kang; Mingu,0,0,0,0
1668234539856,CSE 249B,A00,102388,Kahng; Andrew Byun,0,0,8,8
1668234540293,CSE 251B,A01,102392,Cottrell; Garrison W,0,0,0,0
1668234540293,CSE 251B,A02,102393,Cottrell; Garrison W,0,0,0,0
1668234540727,CSE 252B,A00,102394,Ochoa; Benjamin Lawrence,0,0,0,0
1668234541158,CSE 257,A01,102396,Gao; Sicun,0,0,0,0
1668234541587,CSE 272,A00,102397,Li; Tzumao,0,0,0,0
1668234542016,CSE 274,A00,111323,Chern; Albert Ren-Haur,0,0,0,0
1668234542440,CSE 282,A00,102398,Pevzner; Pavel Arkadjevich,0,0,0,0
1668234542866,CSE 284,A00,114175,Gymrek; Melissa Ann,0,0,0,0
1668234543290,CSE 290,A00,102399,Chandraker; Manmohan Krishna,0,0,0,0
1668234543290,CSE 290,B00,102400,Vaccaro; Kristen Marie,0,0,25,25
1668234543290,CSE 290,C00,102414,Pannuto; Patrick William,0,0,25,25
1668234543290,CSE 290,D00,102427,Pevzner; Pavel Arkadjevich,0,0,0,0
1668234543290,CSE 290,E00,102429,Zhao; Jishen,0,0,0,0
1668234543290,CSE 290,F00,102436,Tullsen; Dean Michael,0,0,0,0
1668234543290,CSE 290,G00,102440,Christensen; Henrik I,0,0,20,20
1668234543713,CSE 291,A00,102443,Su; Hao,0,0,0,0
1668234543713,CSE 291,B00,102448,Polikarpova; Nadezhda,0,0,0,0
1668234543713,CSE 291,C00,102453,Vaccaro; Kristen Marie,0,0,0,0
1668234543713,CSE 291,D00,111343,Savage; Stefan,0,0,0,0
1668234543713,CSE 291,E00,116474,Claffy; Kimberly Claire,0,0,0,0
1668234543713,CSE 291,F00,116479,Pasquale; Joseph,0,0,0,0
1668234544140,CSE 293,001,119111,Bafna; Vineet,9999,0,9999,0
1668234544140,CSE 293,002,119118,Bellare; Mihir,9999,0,9999,0
1668234544140,CSE 293,003,119122,Berg-Kirkpatrick; Taylor D,9999,0,9999,0
1668234544140,CSE 293,004,119135,Christensen; Henrik I,9999,0,9999,0
1668234544140,CSE 293,005,119142,Cottrell; Garrison W,9999,0,9999,0
1668234544140,CSE 293,006,119146,Deutsch; Alin Bernard,9999,0,9999,0
1668234544140,CSE 293,007,119159,Esmaeilzadeh; Hadi,9999,0,9999,0
1668234544140,CSE 293,008,119166,Freund; Yoav,9999,0,9999,0
1668234544140,CSE 293,009,119170,Griswold; William G.,9999,0,9999,0
1668234544140,CSE 293,010,119183,Gymrek; Melissa Ann,9999,0,9999,0
1668234544140,CSE 293,011,119190,Heninger; Nadia A,9999,0,9999,0
1668234544140,CSE 293,012,119230,Impagliazzo; Russell,9999,0,9999,0
1668234544140,CSE 293,013,119232,Jhala; Ranjit,9999,0,9999,0
1668234544140,CSE 293,014,119233,Kahng; Andrew Byun,9999,0,9999,0
1668234544140,CSE 293,015,119298,Kane; Daniel Mertz,9999,0,9999,0
1668234544140,CSE 293,016,119299,Kriegman; David J,9999,0,9999,0
1668234544140,CSE 293,017,119300,Kumar; Arun Kumar,9999,0,9999,0
1668234544140,CSE 293,018,119301,Lerner; Sorin,9999,0,9999,0
1668234544140,CSE 293,019,119302,Lovett; Shachar,9999,0,9999,0
1668234544140,CSE 293,020,119303,McAuley; Julian John,9999,0,9999,0
1668234544140,CSE 293,021,119304,Micciancio; Daniele,9999,0,9999,0
1668234544140,CSE 293,022,119367,Orailoglu; Alex,9999,0,9999,0
1668234544140,CSE 293,023,119382,Paturi; Ramamohan,9999,0,9999,0
1668234544140,CSE 293,024,119404,Polikarpova; Nadezhda,9999,0,9999,0
1668234544140,CSE 293,025,119406,Politz; Joseph Gibbs,9999,0,9999,0
1668234544140,CSE 293,026,119411,Porter; George M,9999,0,9999,0
1668234544140,CSE 293,027,119414,Porter; Leonard Emerson,9999,0,9999,0
1668234544140,CSE 293,028,119416,Ramamoorthi; Ravi,9999,0,9999,0
1668234544140,CSE 293,029,119417,Sahoo; Debashis,9999,0,9999,0
1668234544140,CSE 293,030,119420,Saul; Lawrence,9999,0,9999,0
1668234544140,CSE 293,031,119421,Savage; Stefan,9999,0,9999,0
1668234544140,CSE 293,032,119425,Schulze; Jurgen P.,9999,0,9999,0
1668234544140,CSE 293,033,119426,Snoeren; Alex C.,9999,0,9999,0
1668234544140,CSE 293,034,119428,Shang; Jingbo,9999,0,9999,0
1668234544140,CSE 293,035,119430,Stefan; Deian,9999,0,9999,0
1668234544140,CSE 293,036,119431,Su; Hao,9999,0,9999,0
1668234544140,CSE 293,037,119433,Swanson; Steven James,9999,0,9999,0
1668234544140,CSE 293,038,119435,Tullsen; Dean Michael,9999,0,9999,0
1668234544140,CSE 293,039,119483,Voelker; Geoffrey M.,9999,0,9999,0
1668234544140,CSE 293,040,119537,Zhao; Jishen,9999,0,9999,0
1668234544140,CSE 293,041,119538,Zhou; Yuan-Yuan,9999,0,9999,0
1668234544140,CSE 293,042,119539,Gao; Sicun,9999,0,9999,0
1668234544140,CSE 293,043,119540,Weibel; Nadir,9999,0,9999,0
1668234544140,CSE 293,044,119541,Gupta; Rajesh K.,9999,0,9999,0
1668234544140,CSE 293,045,126410,Vaccaro; Kristen Marie,9999,0,9999,0
1668234544140,CSE 293,046,126411,Klemke; Richard,9999,0,9999,0
1668234544573,CSE 294,A00,102459,Voelker; Geoffrey M.,0,0,0,0
1668234544573,CSE 294,B00,111322,Orailoglu; Alex,0,0,0,0
1668234544998,DSE 201,A00,096914,Deutsch; Alin Bernard,30,0,30,0
1668234545425,DSE 210,A00,096915,Dasgupta; Sanjoy,30,0,30,0
1668234545847,DSE 260A,A00,096916,Altintas De Callaf; Ilkay,30,0,30,0
1668234546290,ECE 200,001,103586,Antipa; Nicholas A,9999,0,9999,0
1668234546290,ECE 200,002,103587,Atanasov; Nikolay A.,9999,0,9999,0
1668234546290,ECE 200,003,103588,Bharadia; Dinesh,9999,0,9999,0
1668234546290,ECE 200,004,103589,Cheng; Chung Kuan,9999,0,9999,0
1668234546290,ECE 200,005,103590,Cosman; Pamela C.,9999,0,9999,0
1668234546290,ECE 200,006,103591,Dayeh; Shadi Ahmad,9999,0,9999,0
1668234546290,ECE 200,007,103592,Fainman; Yeshaiahu,9999,0,9999,0
1668234546290,ECE 200,008,103593,Ford; Joseph Earl,9999,0,9999,0
1668234546290,ECE 200,009,103594,Franceschetti; Massimo,9999,0,9999,0
1668234546290,ECE 200,010,103595,Fullerton; Eric E,9999,0,9999,0
1668234546290,ECE 200,011,103596,Galton; Ian A,9999,0,9999,0
1668234546290,ECE 200,012,103597,Gilja; Vikash,9999,0,9999,0
1668234546290,ECE 200,013,103598,Hall; Drew A.,9999,0,9999,0
1668234546290,ECE 200,014,103599,Hsueh; Tzu-Chien,9999,0,9999,0
1668234546290,ECE 200,015,103600,Javidi; Tara,9999,0,9999,0
1668234546290,ECE 200,016,103601,Kahng; Andrew Byun,9999,0,9999,0
1668234546290,ECE 200,017,103602,Kim; Young-Han,9999,0,9999,0
1668234546290,ECE 200,018,103603,Koushanfar; Farinaz,9999,0,9999,0
1668234546290,ECE 200,019,103604,Kuzum; Duygu,9999,0,9999,0
1668234546290,ECE 200,020,103605,Le; Hanh-Phuc,9999,0,9999,0
1668234546290,ECE 200,021,103606,Lin; Bill,9999,0,9999,0
1668234546290,ECE 200,022,103607,Liu; Zhaowei,9998,0,9999,1
1668234546290,ECE 200,023,103608,Lo; Yu-Hwa,9999,0,9999,0
1668234546290,ECE 200,024,103609,Lomakin; Vitaliy,9999,0,9999,0
1668234546290,ECE 200,025,103610,Mercier; Patrick Philip,9999,0,9999,0
1668234546290,ECE 200,026,103611,Meyer; Florian,9999,0,9999,0
1668234546290,ECE 200,027,103612,Milstein; Laurence B.,9999,0,9999,0
1668234546290,ECE 200,028,103613,Mir Arabbaygi; Siavash,9999,0,9999,0
1668234546290,ECE 200,029,103614,Mookherjea; Shayan,9999,0,9999,0
1668234546290,ECE 200,030,103615,Morris; Karcher William,9999,0,9999,0
1668234546290,ECE 200,031,103616,Ng; Tse Nga,9999,0,9999,0
1668234546290,ECE 200,032,103617,Nguyen; Truong Quang,9999,0,9999,0
1668234546290,ECE 200,033,103618,Nomura; Kenji,9999,0,9999,0
1668234546290,ECE 200,034,103619,Orlitsky; Alon,9999,0,9999,0
1668234546290,ECE 200,035,103620,Pal; Piya,9999,0,9999,0
1668234546290,ECE 200,036,103621,Papen; George C.,9999,0,9999,0
1668234546290,ECE 200,037,103622,Radic; Stojan,9999,0,9999,0
1668234546290,ECE 200,038,103623,Rao; Bhaskar D.,9999,0,9999,0
1668234546290,ECE 200,039,103624,Rao; Ramesh R,9999,0,9999,0
1668234546290,ECE 200,040,103625,Rebeiz; Gabriel,9999,0,9999,0
1668234546290,ECE 200,041,103626,Sanford; John R,9999,0,9999,0
1668234546290,ECE 200,042,103627,Siegel; Paul H.,9999,0,9999,0
1668234546290,ECE 200,043,103628,Sievenpiper; Daniel F.,9999,0,9999,0
1668234546290,ECE 200,044,103629,Sworder; David D.,9999,0,9999,0
1668234546290,ECE 200,045,103630,Taur; Yuan,9999,0,9999,0
1668234546290,ECE 200,046,103631,Touri; Behrouz,9999,0,9999,0
1668234546290,ECE 200,047,103632,Trivedi; Mohan M.,9999,0,9999,0
1668234546290,ECE 200,048,103633,Vasconcelos; Nuno,9999,0,9999,0
1668234546290,ECE 200,049,103634,Wang; Xiaolong,9999,0,9999,0
1668234546290,ECE 200,050,103635,Xie; Pengtao,9999,0,9999,0
1668234546290,ECE 200,051,103636,Yip; Michael,9999,0,9999,0
1668234546290,ECE 200,052,103637,Zeger; Kenneth A.,999,0,999,0
1668234546290,ECE 200,053,103638,Zhang; Xinyu,9999,0,9999,0
1668234546290,ECE 200,054,103639,Turakhia; Yatish Girish,9999,0,9999,0
1668234546290,ECE 200,055,103640,Kang; Mingu,9999,0,9999,0
1668234546290,ECE 200,056,103641,Shi; Yuanyuan,9999,0,9999,0
1668234546290,ECE 200,057,103642,Wang; Edward Jay,9999,0,9999,0
1668234546290,ECE 200,058,103643,Zheng; Yang,9999,0,9999,0
1668234546712,ECE 202,A00,103644,Kuzum; Duygu,0,0,0,0
1668234547136,ECE 212BN,A00,103646,Ng; Tse Nga,0,0,0,0
1668234547558,ECE 221,A00,111493,Staff,0,0,0,0
1668234547981,ECE 222B,A00,103647,Lomakin; Vitaliy,0,0,0,0
1668234548405,ECE 230B,A00,103648,Taur; Yuan,0,0,0,0
1668234548835,ECE 238B,A00,103649,Garay; Javier,0,0,0,0
1668234549262,ECE 240B,A00,112900,Fainman; Yeshaiahu,0,0,0,0
1668234549692,ECE 247A,A00,103650,Jokerst; Jesse Vincent,0,0,0,0
1668234550129,ECE 247B,A00,103651,Wang; Joseph,0,0,0,0
1668234550566,ECE 250,A00,103652,Siegel; Paul H.,0,0,0,0
1668234550989,ECE 251A,A00,103654,Rao; Bhaskar D.,0,0,0,0
1668234551418,ECE 257B,A00,103655,Bharadia; Dinesh,0,0,0,0
1668234551847,ECE 258A,A00,103656,Milstein; Laurence B.,0,0,0,0
1668234552278,ECE 260B,A00,103658,Kang; Mingu,0,0,0,0
1668234552712,ECE 264A,A00,103659,Galton; Ian A,0,0,0,0
1668234553137,ECE 265A,A00,103661,Gudem; Prasad S.S.,0,0,0,0
1668234553586,ECE 265D,A00,103662,Gudem; Prasad S.S.,0,0,0,0
1668234554020,ECE 268,A00,103663,Koushanfar; Farinaz,0,0,0,0
1668234554455,ECE 269,A01,103665,Pal; Piya,0,0,0,0
1668234554889,ECE 271B,A00,103666,Vasconcelos; Manuela,0,0,0,0
1668234555313,ECE 276A,A00,103667,Atanasov; Nikolay A.,0,0,0,0
1668234555739,ECE 277,A00,103668,An; Cheolhong,0,0,0,0
1668234556163,ECE 279,A00,117947,Hall; Drew A.,0,0,0,0
1668234557013,ECE 283,A00,103670,Hsueh; Tzu-Chien,0,0,0,0
1668234557437,ECE 284,A00,103671,Turakhia; Yatish Girish,0,0,0,0
1668234557867,ECE 285,A00,103672,Zheng; Yang,0,0,0,0
1668234557867,ECE 285,B00,103673,Sworder; David D.,0,0,0,0
1668234558293,ECE 287,A00,103676,Javidi; Tara,0,0,0,0
1668234558716,MATH 200B,A00,098023,Salehi Golsefidy; Alireza,12,0,15,3
1668234559140,MATH 202B,A00,098024,Rhoades; Brendon Patrick,9,0,15,6
1668234559563,MATH 203B,A00,098025,Oprea; Dragos N.,10,0,15,5
1668234560087,MATH 204B,A00,098026,Sorensen; Claus M,13,0,15,2
1668234560509,MATH 208,A00,098027,Izadi; Elham,7,0,10,3
1668234560933,MATH 209,A00,098028,Pollack; Aaron,10,0,10,0
1668234561357,MATH 211A,A00,112919,Rogalski; Daniel,9,0,10,1
1668234561782,MATH 211B,A00,112920,Seward; Brandon M.,9,0,10,1
1668234562206,MATH 218,A00,098029,Li; Bo,10,0,10,0
1668234562629,MATH 220B,A00,098030,Novak; Jonathan I,11,0,15,4
1668234563067,MATH 221A,A00,098031,Ebenfelt; Peter F,13,0,15,2
1668234563490,MATH 231B,A00,098032,Zlatos; Andrej,12,0,15,3
1668234563917,MATH 240B,A00,098033,Ni; Lei,9,0,15,6
1668234564342,MATH 243,A00,098034,Jekel; David Andrew,10,0,10,0
1668234564764,MATH 245A,A00,098035,Nie; Jiawang,0,0,15,16
1668234565201,MATH 248,A00,098036,Bejenaru; Ioan,10,0,10,0
1668234565624,MATH 250B,A00,098037,Spolaor; Luca,14,0,15,1
1668234566049,MATH 258,A00,098038,Ni; Lei,10,0,10,0
1668234566475,MATH 264B,A00,098041,Rhoades; Brendon Patrick,9,0,15,6
1668234566900,MATH 268,A00,098042,Buss; Samuel R,10,0,10,0
1668234567325,MATH 269,A00,098043,Rhoades; Brendon Patrick,10,0,10,0
1668234567752,MATH 270B,A00,098044,Li; Bo,10,0,15,5
1668234568181,MATH 272B,A00,098045,Holst; Michael J,13,0,15,2
1668234568604,MATH 273A,A00,098046,Tian; Xiaochuan,10,0,15,5
1668234569036,MATH 275,A01,098048,Tian; Xiaochuan,6,0,10,4
1668234569474,MATH 278A,A00,098049,Holst; Michael J,8,0,10,2
1668234569901,MATH 278B,A00,098050,Cloninger; Alexander,10,0,10,0
1668234570325,MATH 278C,A00,098051,Nie; Jiawang,7,0,10,3
1668234570751,MATH 280B,A00,098052,Zheng; Tianyi,10,0,15,5
1668234571172,MATH 281B,A00,098053,Bradic; Jelena,1,0,15,14
1668234571597,MATH 282B,A00,098054,Arias-Castro; Ery,0,0,15,15
1668234572026,MATH 285,A00,098055,Fitzsimmons; Patrick J,0,0,15,17
1668234572461,MATH 287B,A00,098056,Arias-Castro; Ery,2,0,15,13
1668234572885,MATH 288,A00,098057,Agarwal; Pooja,9,0,10,1
1668234572885,MATH 288,B00,098058,Zhang; Danna,8,0,10,2
1668234572885,MATH 288,C00,098059,Williams; Ruth J,10,0,10,0
1668234573311,MATH 290B,A00,098060,Roberts; Justin Deritter,13,0,15,2
1668234573742,MATH 292,A00,098061,Belmont; Eva Kinoshita,10,0,10,0
1668234574166,MATH 295,A00,098062,Suk; Andrew Hoon,48,0,50,2
1668234574592,MATH 296,A00,098063,Novak; Jonathan I,20,0,20,0
1668234575021,MATH 297,001,098064,Gamst; Anthony Collins,9997,0,9999,2
1668235075630,COGS 205,A00,101395,Chiba; Andrea,19,0,20,1
1668235076059,COGS 210B,001,101404,Greene; Deanna Jacquelyn,9998,0,9999,1
1668235076059,COGS 210B,002,101417,Xia; Haijun,9999,0,9999,0
1668235076059,COGS 210B,003,101422,Nitz; Douglas A.,9999,0,9999,0
1668235076059,COGS 210B,004,101423,Hollan; James D.,9998,0,9999,1
1668235076059,COGS 210B,005,101424,Deak; Gedeon O.,9998,0,9999,1
1668235076059,COGS 210B,006,101425,Rossano; Federico,9999,0,9999,0
1668235076487,COGS 211B,A00,101427,Coulson; Seana M,9996,0,9999,3
1668235076911,COGS 220,A00,101428,Hollan; James D.,0,0,25,25
1668235077336,COGS 229,A00,101429,Dow; Steven P,18,0,25,7
1668235077759,COGS 230,A00,101430,Klemmer; Scott R,12,0,17,5
1668235078186,COGS 234,A00,101431,Xia; Haijun,2,0,25,23
1668235078611,COGS 260,A00,101432,Kiyonaga; Anastasia,21,0,25,4
1668235078611,COGS 260,B00,101433,Kirsh; David Joel,15,0,25,10
1668235079038,CSE 202,A00,102371,Impagliazzo; Russell,0,0,0,0
1668235079466,CSE 203B,A01,102373,Cheng; Chung Kuan,0,0,0,0
1668235079892,CSE 208,A00,102374,Micciancio; Daniele,0,0,0,0
1668235080314,CSE 209A,A00,112895,Impagliazzo; Russell,0,0,15,15
1668235080819,CSE 209B,A00,108005,Bellare; Mihir,0,0,0,0
1668235081243,CSE 210,A00,113163,Coblenz; Michael J,0,0,0,0
1668235081685,CSE 219,A00,106111,Dow; Steven P,0,0,20,20
1668235082124,CSE 221,A00,102376,Voelker; Geoffrey M.,0,0,0,0
1668235082561,CSE 224,A01,102378,Porter; George M,0,0,0,0
1668235082994,CSE 229A,A00,102379,Savage; Stefan,0,0,0,0
1668235083416,CSE 229C,A00,102380,Munyaka; Imani N. S.,0,0,0,0
1668235083840,CSE 232B,A00,102382,Deutsch; Alin Bernard,0,0,0,0
1668235084262,CSE 234,A01,112904,Kumar; Arun Kumar,0,0,0,0
1668235084688,CSE 237A,A00,102383,Rosing; Tajana Simunic,0,0,0,0
1668235085111,CSE 239A,A00,102384,Deutsch; Alin Bernard,0,0,0,0
1668235085536,CSE 239B,A00,102385,Polikarpova; Nadezhda,0,0,0,0
1668235085962,CSE 240A,A00,102386,Pannuto; Patrick William,0,0,0,0
1668235086387,CSE 240B,A00,102387,Zhao; Jishen,0,0,0,0
1668235086810,CSE 241A,A00,106406,Kang; Mingu,0,0,0,0
1668235087232,CSE 249B,A00,102388,Kahng; Andrew Byun,0,0,8,8
1668235087664,CSE 251B,A01,102392,Cottrell; Garrison W,0,0,0,0
1668235087664,CSE 251B,A02,102393,Cottrell; Garrison W,0,0,0,0
1668235088090,CSE 252B,A00,102394,Ochoa; Benjamin Lawrence,0,0,0,0
1668235088514,CSE 257,A01,102396,Gao; Sicun,0,0,0,0
1668235088939,CSE 272,A00,102397,Li; Tzumao,0,0,0,0
1668235089366,CSE 274,A00,111323,Chern; Albert Ren-Haur,0,0,0,0
1668235089797,CSE 282,A00,102398,Pevzner; Pavel Arkadjevich,0,0,0,0
1668235090234,CSE 284,A00,114175,Gymrek; Melissa Ann,0,0,0,0
1668235090657,CSE 290,A00,102399,Chandraker; Manmohan Krishna,0,0,0,0
1668235090657,CSE 290,B00,102400,Vaccaro; Kristen Marie,0,0,25,25
1668235090657,CSE 290,C00,102414,Pannuto; Patrick William,0,0,25,25
1668235090657,CSE 290,D00,102427,Pevzner; Pavel Arkadjevich,0,0,0,0
1668235090657,CSE 290,E00,102429,Zhao; Jishen,0,0,0,0
1668235090657,CSE 290,F00,102436,Tullsen; Dean Michael,0,0,0,0
1668235090657,CSE 290,G00,102440,Christensen; Henrik I,0,0,20,20
1668235091086,CSE 291,A00,102443,Su; Hao,0,0,0,0
1668235091086,CSE 291,B00,102448,Polikarpova; Nadezhda,0,0,0,0
1668235091086,CSE 291,C00,102453,Vaccaro; Kristen Marie,0,0,0,0
1668235091086,CSE 291,D00,111343,Savage; Stefan,0,0,0,0
1668235091086,CSE 291,E00,116474,Claffy; Kimberly Claire,0,0,0,0
1668235091086,CSE 291,F00,116479,Pasquale; Joseph,0,0,0,0
1668235091559,CSE 293,001,119111,Bafna; Vineet,9999,0,9999,0
1668235091559,CSE 293,002,119118,Bellare; Mihir,9999,0,9999,0
1668235091559,CSE 293,003,119122,Berg-Kirkpatrick; Taylor D,9999,0,9999,0
1668235091559,CSE 293,004,119135,Christensen; Henrik I,9999,0,9999,0
1668235091559,CSE 293,005,119142,Cottrell; Garrison W,9999,0,9999,0
1668235091559,CSE 293,006,119146,Deutsch; Alin Bernard,9999,0,9999,0
1668235091559,CSE 293,007,119159,Esmaeilzadeh; Hadi,9999,0,9999,0
1668235091559,CSE 293,008,119166,Freund; Yoav,9999,0,9999,0
1668235091559,CSE 293,009,119170,Griswold; William G.,9999,0,9999,0
1668235091559,CSE 293,010,119183,Gymrek; Melissa Ann,9999,0,9999,0
1668235091559,CSE 293,011,119190,Heninger; Nadia A,9999,0,9999,0
1668235091559,CSE 293,012,119230,Impagliazzo; Russell,9999,0,9999,0
1668235091559,CSE 293,013,119232,Jhala; Ranjit,9999,0,9999,0
1668235091559,CSE 293,014,119233,Kahng; Andrew Byun,9999,0,9999,0
1668235091559,CSE 293,015,119298,Kane; Daniel Mertz,9999,0,9999,0
1668235091559,CSE 293,016,119299,Kriegman; David J,9999,0,9999,0
1668235091559,CSE 293,017,119300,Kumar; Arun Kumar,9999,0,9999,0
1668235091559,CSE 293,018,119301,Lerner; Sorin,9999,0,9999,0
1668235091559,CSE 293,019,119302,Lovett; Shachar,9999,0,9999,0
1668235091559,CSE 293,020,119303,McAuley; Julian John,9999,0,9999,0
1668235091559,CSE 293,021,119304,Micciancio; Daniele,9999,0,9999,0
1668235091559,CSE 293,022,119367,Orailoglu; Alex,9999,0,9999,0
1668235091559,CSE 293,023,119382,Paturi; Ramamohan,9999,0,9999,0
1668235091559,CSE 293,024,119404,Polikarpova; Nadezhda,9999,0,9999,0
1668235091559,CSE 293,025,119406,Politz; Joseph Gibbs,9999,0,9999,0
1668235091559,CSE 293,026,119411,Porter; George M,9999,0,9999,0
1668235091559,CSE 293,027,119414,Porter; Leonard Emerson,9999,0,9999,0
1668235091559,CSE 293,028,119416,Ramamoorthi; Ravi,9999,0,9999,0
1668235091559,CSE 293,029,119417,Sahoo; Debashis,9999,0,9999,0
1668235091559,CSE 293,030,119420,Saul; Lawrence,9999,0,9999,0
1668235091559,CSE 293,031,119421,Savage; Stefan,9999,0,9999,0
1668235091559,CSE 293,032,119425,Schulze; Jurgen P.,9999,0,9999,0
1668235091559,CSE 293,033,119426,Snoeren; Alex C.,9999,0,9999,0
1668235091559,CSE 293,034,119428,Shang; Jingbo,9999,0,9999,0
1668235091559,CSE 293,035,119430,Stefan; Deian,9999,0,9999,0
1668235091559,CSE 293,036,119431,Su; Hao,9999,0,9999,0
1668235091559,CSE 293,037,119433,Swanson; Steven James,9999,0,9999,0
1668235091559,CSE 293,038,119435,Tullsen; Dean Michael,9999,0,9999,0
1668235091559,CSE 293,039,119483,Voelker; Geoffrey M.,9999,0,9999,0
1668235091559,CSE 293,040,119537,Zhao; Jishen,9999,0,9999,0
1668235091559,CSE 293,041,119538,Zhou; Yuan-Yuan,9999,0,9999,0
1668235091559,CSE 293,042,119539,Gao; Sicun,9999,0,9999,0
1668235091559,CSE 293,043,119540,Weibel; Nadir,9999,0,9999,0
1668235091559,CSE 293,044,119541,Gupta; Rajesh K.,9999,0,9999,0
1668235091559,CSE 293,045,126410,Vaccaro; Kristen Marie,9999,0,9999,0
1668235091559,CSE 293,046,126411,Klemke; Richard,9999,0,9999,0
1668235091998,CSE 294,A00,102459,Voelker; Geoffrey M.,0,0,0,0
1668235091998,CSE 294,B00,111322,Orailoglu; Alex,0,0,0,0
1668235092425,DSE 201,A00,096914,Deutsch; Alin Bernard,30,0,30,0
1668235092851,DSE 210,A00,096915,Dasgupta; Sanjoy,30,0,30,0
1668235093274,DSE 260A,A00,096916,Altintas De Callaf; Ilkay,30,0,30,0
1668235093716,ECE 200,001,103586,Antipa; Nicholas A,9999,0,9999,0
1668235093716,ECE 200,002,103587,Atanasov; Nikolay A.,9999,0,9999,0
1668235093716,ECE 200,003,103588,Bharadia; Dinesh,9999,0,9999,0
1668235093716,ECE 200,004,103589,Cheng; Chung Kuan,9999,0,9999,0
1668235093716,ECE 200,005,103590,Cosman; Pamela C.,9999,0,9999,0
1668235093716,ECE 200,006,103591,Dayeh; Shadi Ahmad,9999,0,9999,0
1668235093716,ECE 200,007,103592,Fainman; Yeshaiahu,9999,0,9999,0
1668235093716,ECE 200,008,103593,Ford; Joseph Earl,9999,0,9999,0
1668235093716,ECE 200,009,103594,Franceschetti; Massimo,9999,0,9999,0
1668235093716,ECE 200,010,103595,Fullerton; Eric E,9999,0,9999,0
1668235093716,ECE 200,011,103596,Galton; Ian A,9999,0,9999,0
1668235093716,ECE 200,012,103597,Gilja; Vikash,9999,0,9999,0
1668235093716,ECE 200,013,103598,Hall; Drew A.,9999,0,9999,0
1668235093716,ECE 200,014,103599,Hsueh; Tzu-Chien,9999,0,9999,0
1668235093716,ECE 200,015,103600,Javidi; Tara,9999,0,9999,0
1668235093716,ECE 200,016,103601,Kahng; Andrew Byun,9999,0,9999,0
1668235093716,ECE 200,017,103602,Kim; Young-Han,9999,0,9999,0
1668235093716,ECE 200,018,103603,Koushanfar; Farinaz,9999,0,9999,0
1668235093716,ECE 200,019,103604,Kuzum; Duygu,9999,0,9999,0
1668235093716,ECE 200,020,103605,Le; Hanh-Phuc,9999,0,9999,0
1668235093716,ECE 200,021,103606,Lin; Bill,9999,0,9999,0
1668235093716,ECE 200,022,103607,Liu; Zhaowei,9998,0,9999,1
1668235093716,ECE 200,023,103608,Lo; Yu-Hwa,9999,0,9999,0
1668235093716,ECE 200,024,103609,Lomakin; Vitaliy,9999,0,9999,0
1668235093716,ECE 200,025,103610,Mercier; Patrick Philip,9999,0,9999,0
1668235093716,ECE 200,026,103611,Meyer; Florian,9999,0,9999,0
1668235093716,ECE 200,027,103612,Milstein; Laurence B.,9999,0,9999,0
1668235093716,ECE 200,028,103613,Mir Arabbaygi; Siavash,9999,0,9999,0
1668235093716,ECE 200,029,103614,Mookherjea; Shayan,9999,0,9999,0
1668235093716,ECE 200,030,103615,Morris; Karcher William,9999,0,9999,0
1668235093716,ECE 200,031,103616,Ng; Tse Nga,9999,0,9999,0
1668235093716,ECE 200,032,103617,Nguyen; Truong Quang,9999,0,9999,0
1668235093716,ECE 200,033,103618,Nomura; Kenji,9999,0,9999,0
1668235093716,ECE 200,034,103619,Orlitsky; Alon,9999,0,9999,0
1668235093716,ECE 200,035,103620,Pal; Piya,9999,0,9999,0
1668235093716,ECE 200,036,103621,Papen; George C.,9999,0,9999,0
1668235093716,ECE 200,037,103622,Radic; Stojan,9999,0,9999,0
1668235093716,ECE 200,038,103623,Rao; Bhaskar D.,9999,0,9999,0
1668235093716,ECE 200,039,103624,Rao; Ramesh R,9999,0,9999,0
1668235093716,ECE 200,040,103625,Rebeiz; Gabriel,9999,0,9999,0
1668235093716,ECE 200,041,103626,Sanford; John R,9999,0,9999,0
1668235093716,ECE 200,042,103627,Siegel; Paul H.,9999,0,9999,0
1668235093716,ECE 200,043,103628,Sievenpiper; Daniel F.,9999,0,9999,0
1668235093716,ECE 200,044,103629,Sworder; David D.,9999,0,9999,0
1668235093716,ECE 200,045,103630,Taur; Yuan,9999,0,9999,0
1668235093716,ECE 200,046,103631,Touri; Behrouz,9999,0,9999,0
1668235093716,ECE 200,047,103632,Trivedi; Mohan M.,9999,0,9999,0
1668235093716,ECE 200,048,103633,Vasconcelos; Nuno,9999,0,9999,0
1668235093716,ECE 200,049,103634,Wang; Xiaolong,9999,0,9999,0
1668235093716,ECE 200,050,103635,Xie; Pengtao,9999,0,9999,0
1668235093716,ECE 200,051,103636,Yip; Michael,9999,0,9999,0
1668235093716,ECE 200,052,103637,Zeger; Kenneth A.,999,0,999,0
1668235093716,ECE 200,053,103638,Zhang; Xinyu,9999,0,9999,0
1668235093716,ECE 200,054,103639,Turakhia; Yatish Girish,9999,0,9999,0
1668235093716,ECE 200,055,103640,Kang; Mingu,9999,0,9999,0
1668235093716,ECE 200,056,103641,Shi; Yuanyuan,9999,0,9999,0
1668235093716,ECE 200,057,103642,Wang; Edward Jay,9999,0,9999,0
1668235093716,ECE 200,058,103643,Zheng; Yang,9999,0,9999,0
1668235094139,ECE 202,A00,103644,Kuzum; Duygu,0,0,0,0
1668235094562,ECE 212BN,A00,103646,Ng; Tse Nga,0,0,0,0
1668235094988,ECE 221,A00,111493,Staff,0,0,0,0
1668235095412,ECE 222B,A00,103647,Lomakin; Vitaliy,0,0,0,0
1668235095836,ECE 230B,A00,103648,Taur; Yuan,0,0,0,0
1668235096257,ECE 238B,A00,103649,Garay; Javier,0,0,0,0
1668235096681,ECE 240B,A00,112900,Fainman; Yeshaiahu,0,0,0,0
1668235097107,ECE 247A,A00,103650,Jokerst; Jesse Vincent,0,0,0,0
1668235097534,ECE 247B,A00,103651,Wang; Joseph,0,0,0,0
1668235097957,ECE 250,A00,103652,Siegel; Paul H.,0,0,0,0
1668235098382,ECE 251A,A00,103654,Rao; Bhaskar D.,0,0,0,0
1668235098811,ECE 257B,A00,103655,Bharadia; Dinesh,0,0,0,0
1668235099236,ECE 258A,A00,103656,Milstein; Laurence B.,0,0,0,0
1668235099659,ECE 260B,A00,103658,Kang; Mingu,0,0,0,0
1668235100083,ECE 264A,A00,103659,Galton; Ian A,0,0,0,0
1668235100518,ECE 265A,A00,103661,Gudem; Prasad S.S.,0,0,0,0
1668235100946,ECE 265D,A00,103662,Gudem; Prasad S.S.,0,0,0,0
1668235101373,ECE 268,A00,103663,Koushanfar; Farinaz,0,0,0,0
1668235101795,ECE 269,A01,103665,Pal; Piya,0,0,0,0
1668235102219,ECE 271B,A00,103666,Vasconcelos; Manuela,0,0,0,0
1668235102642,ECE 276A,A00,103667,Atanasov; Nikolay A.,0,0,0,0
1668235103078,ECE 277,A00,103668,An; Cheolhong,0,0,0,0
1668235103501,ECE 279,A00,117947,Hall; Drew A.,0,0,0,0
1668235104354,ECE 283,A00,103670,Hsueh; Tzu-Chien,0,0,0,0
1668235104776,ECE 284,A00,103671,Turakhia; Yatish Girish,0,0,0,0
1668235105201,ECE 285,A00,103672,Zheng; Yang,0,0,0,0
1668235105201,ECE 285,B00,103673,Sworder; David D.,0,0,0,0
1668235105633,ECE 287,A00,103676,Javidi; Tara,0,0,0,0
1668235106058,MATH 200B,A00,098023,Salehi Golsefidy; Alireza,12,0,15,3
1668235106486,MATH 202B,A00,098024,Rhoades; Brendon Patrick,9,0,15,6
1668235106909,MATH 203B,A00,098025,Oprea; Dragos N.,10,0,15,5
1668235107344,MATH 204B,A00,098026,Sorensen; Claus M,13,0,15,2
1668235107782,MATH 208,A00,098027,Izadi; Elham,7,0,10,3
1668235108206,MATH 209,A00,098028,Pollack; Aaron,10,0,10,0
1668235108630,MATH 211A,A00,112919,Rogalski; Daniel,9,0,10,1
1668235109055,MATH 211B,A00,112920,Seward; Brandon M.,9,0,10,1
1668235109478,MATH 218,A00,098029,Li; Bo,10,0,10,0
1668235109902,MATH 220B,A00,098030,Novak; Jonathan I,11,0,15,4
1668235110335,MATH 221A,A00,098031,Ebenfelt; Peter F,13,0,15,2
1668235110762,MATH 231B,A00,098032,Zlatos; Andrej,12,0,15,3
1668235111186,MATH 240B,A00,098033,Ni; Lei,9,0,15,6
1668235111608,MATH 243,A00,098034,Jekel; David Andrew,10,0,10,0
1668235112035,MATH 245A,A00,098035,Nie; Jiawang,0,0,15,16
1668235112459,MATH 248,A00,098036,Bejenaru; Ioan,10,0,10,0
1668235112891,MATH 250B,A00,098037,Spolaor; Luca,14,0,15,1
1668235113315,MATH 258,A00,098038,Ni; Lei,10,0,10,0
1668235113756,MATH 264B,A00,098041,Rhoades; Brendon Patrick,9,0,15,6
1668235114180,MATH 268,A00,098042,Buss; Samuel R,10,0,10,0
1668235114605,MATH 269,A00,098043,Rhoades; Brendon Patrick,10,0,10,0
1668235115031,MATH 270B,A00,098044,Li; Bo,10,0,15,5
1668235115457,MATH 272B,A00,098045,Holst; Michael J,13,0,15,2
1668235115878,MATH 273A,A00,098046,Tian; Xiaochuan,10,0,15,5
1668235116301,MATH 275,A01,098048,Tian; Xiaochuan,6,0,10,4
1668235116727,MATH 278A,A00,098049,Holst; Michael J,8,0,10,2
1668235117158,MATH 278B,A00,098050,Cloninger; Alexander,10,0,10,0
1668235117583,MATH 278C,A00,098051,Nie; Jiawang,7,0,10,3
1668235118013,MATH 280B,A00,098052,Zheng; Tianyi,10,0,15,5
1668235118454,MATH 281B,A00,098053,Bradic; Jelena,1,0,15,14
1668235118887,MATH 282B,A00,098054,Arias-Castro; Ery,0,0,15,15
1668235119314,MATH 285,A00,098055,Fitzsimmons; Patrick J,0,0,15,17
1668235119738,MATH 287B,A00,098056,Arias-Castro; Ery,2,0,15,13
1668235120181,MATH 288,A00,098057,Agarwal; Pooja,9,0,10,1
1668235120181,MATH 288,B00,098058,Zhang; Danna,8,0,10,2
1668235120181,MATH 288,C00,098059,Williams; Ruth J,10,0,10,0
1668235120626,MATH 290B,A00,098060,Roberts; Justin Deritter,13,0,15,2
1668235121051,MATH 292,A00,098061,Belmont; Eva Kinoshita,10,0,10,0
1668235121477,MATH 295,A00,098062,Suk; Andrew Hoon,48,0,50,2
1668235121902,MATH 296,A00,098063,Novak; Jonathan I,20,0,20,0
1668235122324,MATH 297,001,098064,Gamst; Anthony Collins,9997,0,9999,2
1668235622189,COGS 205,A00,101395,Chiba; Andrea,19,0,20,1
1668235622617,COGS 210B,001,101404,Greene; Deanna Jacquelyn,9998,0,9999,1
1668235622617,COGS 210B,002,101417,Xia; Haijun,9999,0,9999,0
1668235622617,COGS 210B,003,101422,Nitz; Douglas A.,9999,0,9999,0
1668235622617,COGS 210B,004,101423,Hollan; James D.,9998,0,9999,1
1668235622617,COGS 210B,005,101424,Deak; Gedeon O.,9998,0,9999,1
1668235622617,COGS 210B,006,101425,Rossano; Federico,9999,0,9999,0
1668235623045,COGS 211B,A00,101427,Coulson; Seana M,9996,0,9999,3
1668235623479,COGS 220,A00,101428,Hollan; James D.,0,0,25,25
1668235623909,COGS 229,A00,101429,Dow; Steven P,18,0,25,7
1668235624330,COGS 230,A00,101430,Klemmer; Scott R,12,0,17,5
1668235624757,COGS 234,A00,101431,Xia; Haijun,2,0,25,23
1668235625180,COGS 260,A00,101432,Kiyonaga; Anastasia,21,0,25,4
1668235625180,COGS 260,B00,101433,Kirsh; David Joel,15,0,25,10
1668235625603,CSE 202,A00,102371,Impagliazzo; Russell,0,0,0,0
1668235626030,CSE 203B,A01,102373,Cheng; Chung Kuan,0,0,0,0
1668235626458,CSE 208,A00,102374,Micciancio; Daniele,0,0,0,0
1668235626893,CSE 209A,A00,112895,Impagliazzo; Russell,0,0,15,15
1668235627332,CSE 209B,A00,108005,Bellare; Mihir,0,0,0,0
1668235627762,CSE 210,A00,113163,Coblenz; Michael J,0,0,0,0
1668235628188,CSE 219,A00,106111,Dow; Steven P,0,0,20,20
1668235628611,CSE 221,A00,102376,Voelker; Geoffrey M.,0,0,0,0
1668235629033,CSE 224,A01,102378,Porter; George M,0,0,0,0
1668235629455,CSE 229A,A00,102379,Savage; Stefan,0,0,0,0
1668235629882,CSE 229C,A00,102380,Munyaka; Imani N. S.,0,0,0,0
1668235630307,CSE 232B,A00,102382,Deutsch; Alin Bernard,0,0,0,0
1668235630733,CSE 234,A01,112904,Kumar; Arun Kumar,0,0,0,0
1668235631160,CSE 237A,A00,102383,Rosing; Tajana Simunic,0,0,0,0
1668235631585,CSE 239A,A00,102384,Deutsch; Alin Bernard,0,0,0,0
1668235632010,CSE 239B,A00,102385,Polikarpova; Nadezhda,0,0,0,0
1668235632437,CSE 240A,A00,102386,Pannuto; Patrick William,0,0,0,0
1668235632861,CSE 240B,A00,102387,Zhao; Jishen,0,0,0,0
1668235633283,CSE 241A,A00,106406,Kang; Mingu,0,0,0,0
1668235633707,CSE 249B,A00,102388,Kahng; Andrew Byun,0,0,8,8
1668235634135,CSE 251B,A01,102392,Cottrell; Garrison W,0,0,0,0
1668235634135,CSE 251B,A02,102393,Cottrell; Garrison W,0,0,0,0
1668235634557,CSE 252B,A00,102394,Ochoa; Benjamin Lawrence,0,0,0,0
1668235634980,CSE 257,A01,102396,Gao; Sicun,0,0,0,0
1668235635418,CSE 272,A00,102397,Li; Tzumao,0,0,0,0
1668235635842,CSE 274,A00,111323,Chern; Albert Ren-Haur,0,0,0,0
1668235636275,CSE 282,A00,102398,Pevzner; Pavel Arkadjevich,0,0,0,0
1668235636701,CSE 284,A00,114175,Gymrek; Melissa Ann,0,0,0,0
1668235637124,CSE 290,A00,102399,Chandraker; Manmohan Krishna,0,0,0,0
1668235637124,CSE 290,B00,102400,Vaccaro; Kristen Marie,0,0,25,25
1668235637124,CSE 290,C00,102414,Pannuto; Patrick William,0,0,25,25
1668235637124,CSE 290,D00,102427,Pevzner; Pavel Arkadjevich,0,0,0,0
1668235637124,CSE 290,E00,102429,Zhao; Jishen,0,0,0,0
1668235637124,CSE 290,F00,102436,Tullsen; Dean Michael,0,0,0,0
1668235637124,CSE 290,G00,102440,Christensen; Henrik I,0,0,20,20
1668235637552,CSE 291,A00,102443,Su; Hao,0,0,0,0
1668235637552,CSE 291,B00,102448,Polikarpova; Nadezhda,0,0,0,0
1668235637552,CSE 291,C00,102453,Vaccaro; Kristen Marie,0,0,0,0
1668235637552,CSE 291,D00,111343,Savage; Stefan,0,0,0,0
1668235637552,CSE 291,E00,116474,Claffy; Kimberly Claire,0,0,0,0
1668235637552,CSE 291,F00,116479,Pasquale; Joseph,0,0,0,0
1668235637978,CSE 293,001,119111,Bafna; Vineet,9999,0,9999,0
1668235637978,CSE 293,002,119118,Bellare; Mihir,9999,0,9999,0
1668235637978,CSE 293,003,119122,Berg-Kirkpatrick; Taylor D,9999,0,9999,0
1668235637978,CSE 293,004,119135,Christensen; Henrik I,9999,0,9999,0
1668235637978,CSE 293,005,119142,Cottrell; Garrison W,9999,0,9999,0
1668235637978,CSE 293,006,119146,Deutsch; Alin Bernard,9999,0,9999,0
1668235637978,CSE 293,007,119159,Esmaeilzadeh; Hadi,9999,0,9999,0
1668235637978,CSE 293,008,119166,Freund; Yoav,9999,0,9999,0
1668235637978,CSE 293,009,119170,Griswold; William G.,9999,0,9999,0
1668235637978,CSE 293,010,119183,Gymrek; Melissa Ann,9999,0,9999,0
1668235637978,CSE 293,011,119190,Heninger; Nadia A,9999,0,9999,0
1668235637978,CSE 293,012,119230,Impagliazzo; Russell,9999,0,9999,0
1668235637978,CSE 293,013,119232,Jhala; Ranjit,9999,0,9999,0
1668235637978,CSE 293,014,119233,Kahng; Andrew Byun,9999,0,9999,0
1668235637978,CSE 293,015,119298,Kane; Daniel Mertz,9999,0,9999,0
1668235637978,CSE 293,016,119299,Kriegman; David J,9999,0,9999,0
1668235637978,CSE 293,017,119300,Kumar; Arun Kumar,9999,0,9999,0
1668235637978,CSE 293,018,119301,Lerner; Sorin,9999,0,9999,0
1668235637978,CSE 293,019,119302,Lovett; Shachar,9999,0,9999,0
1668235637978,CSE 293,020,119303,McAuley; Julian John,9999,0,9999,0
1668235637978,CSE 293,021,119304,Micciancio; Daniele,9999,0,9999,0
1668235637978,CSE 293,022,119367,Orailoglu; Alex,9999,0,9999,0
1668235637978,CSE 293,023,119382,Paturi; Ramamohan,9999,0,9999,0
1668235637978,CSE 293,024,119404,Polikarpova; Nadezhda,9999,0,9999,0
1668235637978,CSE 293,025,119406,Politz; Joseph Gibbs,9999,0,9999,0
1668235637978,CSE 293,026,119411,Porter; George M,9999,0,9999,0
1668235637978,CSE 293,027,119414,Porter; Leonard Emerson,9999,0,9999,0
1668235637978,CSE 293,028,119416,Ramamoorthi; Ravi,9999,0,9999,0
1668235637978,CSE 293,029,119417,Sahoo; Debashis,9999,0,9999,0
1668235637978,CSE 293,030,119420,Saul; Lawrence,9999,0,9999,0
1668235637978,CSE 293,031,119421,Savage; Stefan,9999,0,9999,0
1668235637978,CSE 293,032,119425,Schulze; Jurgen P.,9999,0,9999,0
1668235637978,CSE 293,033,119426,Snoeren; Alex C.,9999,0,9999,0
1668235637978,CSE 293,034,119428,Shang; Jingbo,9999,0,9999,0
1668235637978,CSE 293,035,119430,Stefan; Deian,9999,0,9999,0
1668235637978,CSE 293,036,119431,Su; Hao,9999,0,9999,0
1668235637978,CSE 293,037,119433,Swanson; Steven James,9999,0,9999,0
1668235637978,CSE 293,038,119435,Tullsen; Dean Michael,9999,0,9999,0
1668235637978,CSE 293,039,119483,Voelker; Geoffrey M.,9999,0,9999,0
1668235637978,CSE 293,040,119537,Zhao; Jishen,9999,0,9999,0
1668235637978,CSE 293,041,119538,Zhou; Yuan-Yuan,9999,0,9999,0
1668235637978,CSE 293,042,119539,Gao; Sicun,9999,0,9999,0
1668235637978,CSE 293,043,119540,Weibel; Nadir,9999,0,9999,0
1668235637978,CSE 293,044,119541,Gupta; Rajesh K.,9999,0,9999,0
1668235637978,CSE 293,045,126410,Vaccaro; Kristen Marie,9999,0,9999,0
1668235637978,CSE 293,046,126411,Klemke; Richard,9999,0,9999,0
1668235638404,CSE 294,A00,102459,Voelker; Geoffrey M.,0,0,0,0
1668235638404,CSE 294,B00,111322,Orailoglu; Alex,0,0,0,0
1668235638830,DSE 201,A00,096914,Deutsch; Alin Bernard,30,0,30,0
1668235639256,DSE 210,A00,096915,Dasgupta; Sanjoy,30,0,30,0
1668235639700,DSE 260A,A00,096916,Altintas De Callaf; Ilkay,30,0,30,0
1668235640146,ECE 200,001,103586,Antipa; Nicholas A,9999,0,9999,0
1668235640146,ECE 200,002,103587,Atanasov; Nikolay A.,9999,0,9999,0
1668235640146,ECE 200,003,103588,Bharadia; Dinesh,9999,0,9999,0
1668235640146,ECE 200,004,103589,Cheng; Chung Kuan,9999,0,9999,0
1668235640146,ECE 200,005,103590,Cosman; Pamela C.,9999,0,9999,0
1668235640146,ECE 200,006,103591,Dayeh; Shadi Ahmad,9999,0,9999,0
1668235640146,ECE 200,007,103592,Fainman; Yeshaiahu,9999,0,9999,0
1668235640146,ECE 200,008,103593,Ford; Joseph Earl,9999,0,9999,0
1668235640146,ECE 200,009,103594,Franceschetti; Massimo,9999,0,9999,0
1668235640146,ECE 200,010,103595,Fullerton; Eric E,9999,0,9999,0
1668235640146,ECE 200,011,103596,Galton; Ian A,9999,0,9999,0
1668235640146,ECE 200,012,103597,Gilja; Vikash,9999,0,9999,0
1668235640146,ECE 200,013,103598,Hall; Drew A.,9999,0,9999,0
1668235640146,ECE 200,014,103599,Hsueh; Tzu-Chien,9999,0,9999,0
1668235640146,ECE 200,015,103600,Javidi; Tara,9999,0,9999,0
1668235640146,ECE 200,016,103601,Kahng; Andrew Byun,9999,0,9999,0
1668235640146,ECE 200,017,103602,Kim; Young-Han,9999,0,9999,0
1668235640146,ECE 200,018,103603,Koushanfar; Farinaz,9999,0,9999,0
1668235640146,ECE 200,019,103604,Kuzum; Duygu,9999,0,9999,0
1668235640146,ECE 200,020,103605,Le; Hanh-Phuc,9999,0,9999,0
1668235640146,ECE 200,021,103606,Lin; Bill,9999,0,9999,0
1668235640146,ECE 200,022,103607,Liu; Zhaowei,9998,0,9999,1
1668235640146,ECE 200,023,103608,Lo; Yu-Hwa,9999,0,9999,0
1668235640146,ECE 200,024,103609,Lomakin; Vitaliy,9999,0,9999,0
1668235640146,ECE 200,025,103610,Mercier; Patrick Philip,9999,0,9999,0
1668235640146,ECE 200,026,103611,Meyer; Florian,9999,0,9999,0
1668235640146,ECE 200,027,103612,Milstein; Laurence B.,9999,0,9999,0
1668235640146,ECE 200,028,103613,Mir Arabbaygi; Siavash,9999,0,9999,0
1668235640146,ECE 200,029,103614,Mookherjea; Shayan,9999,0,9999,0
1668235640146,ECE 200,030,103615,Morris; Karcher William,9999,0,9999,0
1668235640146,ECE 200,031,103616,Ng; Tse Nga,9999,0,9999,0
1668235640146,ECE 200,032,103617,Nguyen; Truong Quang,9999,0,9999,0
1668235640146,ECE 200,033,103618,Nomura; Kenji,9999,0,9999,0
1668235640146,ECE 200,034,103619,Orlitsky; Alon,9999,0,9999,0
1668235640146,ECE 200,035,103620,Pal; Piya,9999,0,9999,0
1668235640146,ECE 200,036,103621,Papen; George C.,9999,0,9999,0
1668235640146,ECE 200,037,103622,Radic; Stojan,9999,0,9999,0
1668235640146,ECE 200,038,103623,Rao; Bhaskar D.,9999,0,9999,0
1668235640146,ECE 200,039,103624,Rao; Ramesh R,9999,0,9999,0
1668235640146,ECE 200,040,103625,Rebeiz; Gabriel,9999,0,9999,0
1668235640146,ECE 200,041,103626,Sanford; John R,9999,0,9999,0
1668235640146,ECE 200,042,103627,Siegel; Paul H.,9999,0,9999,0
1668235640146,ECE 200,043,103628,Sievenpiper; Daniel F.,9999,0,9999,0
1668235640146,ECE 200,044,103629,Sworder; David D.,9999,0,9999,0
1668235640146,ECE 200,045,103630,Taur; Yuan,9999,0,9999,0
1668235640146,ECE 200,046,103631,Touri; Behrouz,9999,0,9999,0
1668235640146,ECE 200,047,103632,Trivedi; Mohan M.,9999,0,9999,0
1668235640146,ECE 200,048,103633,Vasconcelos; Nuno,9999,0,9999,0
1668235640146,ECE 200,049,103634,Wang; Xiaolong,9999,0,9999,0
1668235640146,ECE 200,050,103635,Xie; Pengtao,9999,0,9999,0
1668235640146,ECE 200,051,103636,Yip; Michael,9999,0,9999,0
1668235640146,ECE 200,052,103637,Zeger; Kenneth A.,999,0,999,0
1668235640146,ECE 200,053,103638,Zhang; Xinyu,9999,0,9999,0
1668235640146,ECE 200,054,103639,Turakhia; Yatish Girish,9999,0,9999,0
1668235640146,ECE 200,055,103640,Kang; Mingu,9999,0,9999,0
1668235640146,ECE 200,056,103641,Shi; Yuanyuan,9999,0,9999,0
1668235640146,ECE 200,057,103642,Wang; Edward Jay,9999,0,9999,0
1668235640146,ECE 200,058,103643,Zheng; Yang,9999,0,9999,0
1668235640577,ECE 202,A00,103644,Kuzum; Duygu,0,0,0,0
1668235641018,ECE 212BN,A00,103646,Ng; Tse Nga,0,0,0,0
1668235641454,ECE 221,A00,111493,Staff,0,0,0,0
1668235641885,ECE 222B,A00,103647,Lomakin; Vitaliy,0,0,0,0
1668235642308,ECE 230B,A00,103648,Taur; Yuan,0,0,0,0
1668235642733,ECE 238B,A00,103649,Garay; Javier,0,0,0,0
1668235643159,ECE 240B,A00,112900,Fainman; Yeshaiahu,0,0,0,0
1668235643584,ECE 247A,A00,103650,Jokerst; Jesse Vincent,0,0,0,0
1668235644119,ECE 247B,A00,103651,Wang; Joseph,0,0,0,0
1668235644549,ECE 250,A00,103652,Siegel; Paul H.,0,0,0,0
1668235644980,ECE 251A,A00,103654,Rao; Bhaskar D.,0,0,0,0
1668235645403,ECE 257B,A00,103655,Bharadia; Dinesh,0,0,0,0
1668235645828,ECE 258A,A00,103656,Milstein; Laurence B.,0,0,0,0
1668235646251,ECE 260B,A00,103658,Kang; Mingu,0,0,0,0
1668235646675,ECE 264A,A00,103659,Galton; Ian A,0,0,0,0
1668235647101,ECE 265A,A00,103661,Gudem; Prasad S.S.,0,0,0,0
1668235647525,ECE 265D,A00,103662,Gudem; Prasad S.S.,0,0,0,0
1668235647951,ECE 268,A00,103663,Koushanfar; Farinaz,0,0,0,0
1668235648375,ECE 269,A01,103665,Pal; Piya,0,0,0,0
1668235648802,ECE 271B,A00,103666,Vasconcelos; Manuela,0,0,0,0
1668235649226,ECE 276A,A00,103667,Atanasov; Nikolay A.,0,0,0,0
1668235649653,ECE 277,A00,103668,An; Cheolhong,0,0,0,0
1668235650076,ECE 279,A00,117947,Hall; Drew A.,0,0,0,0
1668235650937,ECE 283,A00,103670,Hsueh; Tzu-Chien,0,0,0,0
1668235651360,ECE 284,A00,103671,Turakhia; Yatish Girish,0,0,0,0
1668235651784,ECE 285,A00,103672,Zheng; Yang,0,0,0,0
1668235651784,ECE 285,B00,103673,Sworder; David D.,0,0,0,0
1668235652207,ECE 287,A00,103676,Javidi; Tara,0,0,0,0
1668235652631,MATH 200B,A00,098023,Salehi Golsefidy; Alireza,12,0,15,3
1668235653054,MATH 202B,A00,098024,Rhoades; Brendon Patrick,9,0,15,6
1668235653478,MATH 203B,A00,098025,Oprea; Dragos N.,10,0,15,5
1668235653901,MATH 204B,A00,098026,Sorensen; Claus M,13,0,15,2
1668235654326,MATH 208,A00,098027,Izadi; Elham,7,0,10,3
1668235654748,MATH 209,A00,098028,Pollack; Aaron,10,0,10,0
1668235655172,MATH 211A,A00,112919,Rogalski; Daniel,9,0,10,1
1668235655597,MATH 211B,A00,112920,Seward; Brandon M.,9,0,10,1
1668235656024,MATH 218,A00,098029,Li; Bo,10,0,10,0
1668235656446,MATH 220B,A00,098030,Novak; Jonathan I,11,0,15,4
1668235656868,MATH 221A,A00,098031,Ebenfelt; Peter F,13,0,15,2
1668235657293,MATH 231B,A00,098032,Zlatos; Andrej,12,0,15,3
1668235657719,MATH 240B,A00,098033,Ni; Lei,9,0,15,6
1668235658145,MATH 243,A00,098034,Jekel; David Andrew,10,0,10,0
1668235658567,MATH 245A,A00,098035,Nie; Jiawang,0,0,15,16
1668235658990,MATH 248,A00,098036,Bejenaru; Ioan,10,0,10,0
1668235659418,MATH 250B,A00,098037,Spolaor; Luca,14,0,15,1
1668235659853,MATH 258,A00,098038,Ni; Lei,10,0,10,0
1668235660277,MATH 264B,A00,098041,Rhoades; Brendon Patrick,9,0,15,6
1668235660720,MATH 268,A00,098042,Buss; Samuel R,10,0,10,0
1668235661142,MATH 269,A00,098043,Rhoades; Brendon Patrick,10,0,10,0
1668235661570,MATH 270B,A00,098044,Li; Bo,10,0,15,5
1668235661993,MATH 272B,A00,098045,Holst; Michael J,13,0,15,2
1668235662420,MATH 273A,A00,098046,Tian; Xiaochuan,10,0,15,5
1668235662843,MATH 275,A01,098048,Tian; Xiaochuan,6,0,10,4
1668235663275,MATH 278A,A00,098049,Holst; Michael J,8,0,10,2
1668235663706,MATH 278B,A00,098050,Cloninger; Alexander,10,0,10,0
1668235664132,MATH 278C,A00,098051,Nie; Jiawang,7,0,10,3
1668235664555,MATH 280B,A00,098052,Zheng; Tianyi,10,0,15,5
1668235664978,MATH 281B,A00,098053,Bradic; Jelena,1,0,15,14
1668235665403,MATH 282B,A00,098054,Arias-Castro; Ery,0,0,15,15
1668235665838,MATH 285,A00,098055,Fitzsimmons; Patrick J,0,0,15,17
1668235666264,MATH 287B,A00,098056,Arias-Castro; Ery,2,0,15,13
1668235666699,MATH 288,A00,098057,Agarwal; Pooja,9,0,10,1
1668235666699,MATH 288,B00,098058,Zhang; Danna,8,0,10,2
1668235666699,MATH 288,C00,098059,Williams; Ruth J,10,0,10,0
1668235667127,MATH 290B,A00,098060,Roberts; Justin Deritter,13,0,15,2
1668235667550,MATH 292,A00,098061,Belmont; Eva Kinoshita,10,0,10,0
1668235667981,MATH 295,A00,098062,Suk; Andrew Hoon,48,0,50,2
1668235668406,MATH 296,A00,098063,Novak; Jonathan I,20,0,20,0
1668235668837,MATH 297,001,098064,Gamst; Anthony Collins,9997,0,9999,2
1668236169718,COGS 205,A00,101395,Chiba; Andrea,19,0,20,1
1668236170144,COGS 210B,001,101404,Greene; Deanna Jacquelyn,9998,0,9999,1
1668236170144,COGS 210B,002,101417,Xia; Haijun,9999,0,9999,0
1668236170144,COGS 210B,003,101422,Nitz; Douglas A.,9999,0,9999,0
1668236170144,COGS 210B,004,101423,Hollan; James D.,9998,0,9999,1
1668236170144,COGS 210B,005,101424,Deak; Gedeon O.,9998,0,9999,1
1668236170144,COGS 210B,006,101425,Rossano; Federico,9999,0,9999,0
1668236170569,COGS 211B,A00,101427,Coulson; Seana M,9996,0,9999,3
1668236170994,COGS 220,A00,101428,Hollan; James D.,0,0,25,25
1668236171418,COGS 229,A00,101429,Dow; Steven P,18,0,25,7
1668236171843,COGS 230,A00,101430,Klemmer; Scott R,12,0,17,5
1668236172271,COGS 234,A00,101431,Xia; Haijun,2,0,25,23
1668236172697,COGS 260,A00,101432,Kiyonaga; Anastasia,21,0,25,4
1668236172697,COGS 260,B00,101433,Kirsh; David Joel,15,0,25,10
1668236173122,CSE 202,A00,102371,Impagliazzo; Russell,0,0,0,0
1668236173551,CSE 203B,A01,102373,Cheng; Chung Kuan,0,0,0,0
1668236173977,CSE 208,A00,102374,Micciancio; Daniele,0,0,0,0
1668236174400,CSE 209A,A00,112895,Impagliazzo; Russell,0,0,15,15
1668236174833,CSE 209B,A00,108005,Bellare; Mihir,0,0,0,0
1668236175258,CSE 210,A00,113163,Coblenz; Michael J,0,0,0,0
1668236175679,CSE 219,A00,106111,Dow; Steven P,0,0,20,20
1668236176105,CSE 221,A00,102376,Voelker; Geoffrey M.,0,0,0,0
1668236176534,CSE 224,A01,102378,Porter; George M,0,0,0,0
1668236176968,CSE 229A,A00,102379,Savage; Stefan,0,0,0,0
1668236177400,CSE 229C,A00,102380,Munyaka; Imani N. S.,0,0,0,0
1668236177823,CSE 232B,A00,102382,Deutsch; Alin Bernard,0,0,0,0
1668236178247,CSE 234,A01,112904,Kumar; Arun Kumar,0,0,0,0
1668236178674,CSE 237A,A00,102383,Rosing; Tajana Simunic,0,0,0,0
1668236179098,CSE 239A,A00,102384,Deutsch; Alin Bernard,0,0,0,0
1668236179523,CSE 239B,A00,102385,Polikarpova; Nadezhda,0,0,0,0
1668236179946,CSE 240A,A00,102386,Pannuto; Patrick William,0,0,0,0
1668236180374,CSE 240B,A00,102387,Zhao; Jishen,0,0,0,0
1668236180801,CSE 241A,A00,106406,Kang; Mingu,0,0,0,0
1668236181226,CSE 249B,A00,102388,Kahng; Andrew Byun,0,0,8,8
1668236181648,CSE 251B,A01,102392,Cottrell; Garrison W,0,0,0,0
1668236181648,CSE 251B,A02,102393,Cottrell; Garrison W,0,0,0,0
1668236182074,CSE 252B,A00,102394,Ochoa; Benjamin Lawrence,0,0,0,0
1668236182500,CSE 257,A01,102396,Gao; Sicun,0,0,0,0
1668236182924,CSE 272,A00,102397,Li; Tzumao,0,0,0,0
1668236183351,CSE 274,A00,111323,Chern; Albert Ren-Haur,0,0,0,0
1668236183777,CSE 282,A00,102398,Pevzner; Pavel Arkadjevich,0,0,0,0
1668236184215,CSE 284,A00,114175,Gymrek; Melissa Ann,0,0,0,0
1668236184637,CSE 290,A00,102399,Chandraker; Manmohan Krishna,0,0,0,0
1668236184637,CSE 290,B00,102400,Vaccaro; Kristen Marie,0,0,25,25
1668236184637,CSE 290,C00,102414,Pannuto; Patrick William,0,0,25,25
1668236184637,CSE 290,D00,102427,Pevzner; Pavel Arkadjevich,0,0,0,0
1668236184637,CSE 290,E00,102429,Zhao; Jishen,0,0,0,0
1668236184637,CSE 290,F00,102436,Tullsen; Dean Michael,0,0,0,0
1668236184637,CSE 290,G00,102440,Christensen; Henrik I,0,0,20,20
1668236185065,CSE 291,A00,102443,Su; Hao,0,0,0,0
1668236185065,CSE 291,B00,102448,Polikarpova; Nadezhda,0,0,0,0
1668236185065,CSE 291,C00,102453,Vaccaro; Kristen Marie,0,0,0,0
1668236185065,CSE 291,D00,111343,Savage; Stefan,0,0,0,0
1668236185065,CSE 291,E00,116474,Claffy; Kimberly Claire,0,0,0,0
1668236185065,CSE 291,F00,116479,Pasquale; Joseph,0,0,0,0
1668236185492,CSE 293,001,119111,Bafna; Vineet,9999,0,9999,0
1668236185492,CSE 293,002,119118,Bellare; Mihir,9999,0,9999,0
1668236185492,CSE 293,003,119122,Berg-Kirkpatrick; Taylor D,9999,0,9999,0
1668236185492,CSE 293,004,119135,Christensen; Henrik I,9999,0,9999,0
1668236185492,CSE 293,005,119142,Cottrell; Garrison W,9999,0,9999,0
1668236185492,CSE 293,006,119146,Deutsch; Alin Bernard,9999,0,9999,0
1668236185492,CSE 293,007,119159,Esmaeilzadeh; Hadi,9999,0,9999,0
1668236185492,CSE 293,008,119166,Freund; Yoav,9999,0,9999,0
1668236185492,CSE 293,009,119170,Griswold; William G.,9999,0,9999,0
1668236185492,CSE 293,010,119183,Gymrek; Melissa Ann,9999,0,9999,0
1668236185492,CSE 293,011,119190,Heninger; Nadia A,9999,0,9999,0
1668236185492,CSE 293,012,119230,Impagliazzo; Russell,9999,0,9999,0
1668236185492,CSE 293,013,119232,Jhala; Ranjit,9999,0,9999,0
1668236185492,CSE 293,014,119233,Kahng; Andrew Byun,9999,0,9999,0
1668236185492,CSE 293,015,119298,Kane; Daniel Mertz,9999,0,9999,0
1668236185492,CSE 293,016,119299,Kriegman; David J,9999,0,9999,0
1668236185492,CSE 293,017,119300,Kumar; Arun Kumar,9999,0,9999,0
1668236185492,CSE 293,018,119301,Lerner; Sorin,9999,0,9999,0
1668236185492,CSE 293,019,119302,Lovett; Shachar,9999,0,9999,0
1668236185492,CSE 293,020,119303,McAuley; Julian John,9999,0,9999,0
1668236185492,CSE 293,021,119304,Micciancio; Daniele,9999,0,9999,0
1668236185492,CSE 293,022,119367,Orailoglu; Alex,9999,0,9999,0
1668236185492,CSE 293,023,119382,Paturi; Ramamohan,9999,0,9999,0
1668236185492,CSE 293,024,119404,Polikarpova; Nadezhda,9999,0,9999,0
1668236185492,CSE 293,025,119406,Politz; Joseph Gibbs,9999,0,9999,0
1668236185492,CSE 293,026,119411,Porter; George M,9999,0,9999,0
1668236185492,CSE 293,027,119414,Porter; Leonard Emerson,9999,0,9999,0
1668236185492,CSE 293,028,119416,Ramamoorthi; Ravi,9999,0,9999,0
1668236185492,CSE 293,029,119417,Sahoo; Debashis,9999,0,9999,0
1668236185492,CSE 293,030,119420,Saul; Lawrence,9999,0,9999,0
1668236185492,CSE 293,031,119421,Savage; Stefan,9999,0,9999,0
1668236185492,CSE 293,032,119425,Schulze; Jurgen P.,9999,0,9999,0
1668236185492,CSE 293,033,119426,Snoeren; Alex C.,9999,0,9999,0
1668236185492,CSE 293,034,119428,Shang; Jingbo,9999,0,9999,0
1668236185492,CSE 293,035,119430,Stefan; Deian,9999,0,9999,0
1668236185492,CSE 293,036,119431,Su; Hao,9999,0,9999,0
1668236185492,CSE 293,037,119433,Swanson; Steven James,9999,0,9999,0
1668236185492,CSE 293,038,119435,Tullsen; Dean Michael,9999,0,9999,0
1668236185492,CSE 293,039,119483,Voelker; Geoffrey M.,9999,0,9999,0
1668236185492,CSE 293,040,119537,Zhao; Jishen,9999,0,9999,0
1668236185492,CSE 293,041,119538,Zhou; Yuan-Yuan,9999,0,9999,0
1668236185492,CSE 293,042,119539,Gao; Sicun,9999,0,9999,0
1668236185492,CSE 293,043,119540,Weibel; Nadir,9999,0,9999,0
1668236185492,CSE 293,044,119541,Gupta; Rajesh K.,9999,0,9999,0
1668236185492,CSE 293,045,126410,Vaccaro; Kristen Marie,9999,0,9999,0
1668236185492,CSE 293,046,126411,Klemke; Richard,9999,0,9999,0
1668236185921,CSE 294,A00,102459,Voelker; Geoffrey M.,0,0,0,0
1668236185921,CSE 294,B00,111322,Orailoglu; Alex,0,0,0,0
1668236186344,DSE 201,A00,096914,Deutsch; Alin Bernard,30,0,30,0
1668236186767,DSE 210,A00,096915,Dasgupta; Sanjoy,30,0,30,0
1668236187209,DSE 260A,A00,096916,Altintas De Callaf; Ilkay,30,0,30,0
1668236187642,ECE 200,001,103586,Antipa; Nicholas A,9999,0,9999,0
1668236187642,ECE 200,002,103587,Atanasov; Nikolay A.,9999,0,9999,0
1668236187642,ECE 200,003,103588,Bharadia; Dinesh,9999,0,9999,0
1668236187642,ECE 200,004,103589,Cheng; Chung Kuan,9999,0,9999,0
1668236187642,ECE 200,005,103590,Cosman; Pamela C.,9999,0,9999,0
1668236187642,ECE 200,006,103591,Dayeh; Shadi Ahmad,9999,0,9999,0
1668236187642,ECE 200,007,103592,Fainman; Yeshaiahu,9999,0,9999,0
1668236187642,ECE 200,008,103593,Ford; Joseph Earl,9999,0,9999,0
1668236187642,ECE 200,009,103594,Franceschetti; Massimo,9999,0,9999,0
1668236187642,ECE 200,010,103595,Fullerton; Eric E,9999,0,9999,0
1668236187642,ECE 200,011,103596,Galton; Ian A,9999,0,9999,0
1668236187642,ECE 200,012,103597,Gilja; Vikash,9999,0,9999,0
1668236187642,ECE 200,013,103598,Hall; Drew A.,9999,0,9999,0
1668236187642,ECE 200,014,103599,Hsueh; Tzu-Chien,9999,0,9999,0
1668236187642,ECE 200,015,103600,Javidi; Tara,9999,0,9999,0
1668236187642,ECE 200,016,103601,Kahng; Andrew Byun,9999,0,9999,0
1668236187642,ECE 200,017,103602,Kim; Young-Han,9999,0,9999,0
1668236187642,ECE 200,018,103603,Koushanfar; Farinaz,9999,0,9999,0
1668236187642,ECE 200,019,103604,Kuzum; Duygu,9999,0,9999,0
1668236187642,ECE 200,020,103605,Le; Hanh-Phuc,9999,0,9999,0
1668236187642,ECE 200,021,103606,Lin; Bill,9999,0,9999,0
1668236187642,ECE 200,022,103607,Liu; Zhaowei,9998,0,9999,1
1668236187642,ECE 200,023,103608,Lo; Yu-Hwa,9999,0,9999,0
1668236187642,ECE 200,024,103609,Lomakin; Vitaliy,9999,0,9999,0
1668236187642,ECE 200,025,103610,Mercier; Patrick Philip,9999,0,9999,0
1668236187642,ECE 200,026,103611,Meyer; Florian,9999,0,9999,0
1668236187642,ECE 200,027,103612,Milstein; Laurence B.,9999,0,9999,0
1668236187642,ECE 200,028,103613,Mir Arabbaygi; Siavash,9999,0,9999,0
1668236187642,ECE 200,029,103614,Mookherjea; Shayan,9999,0,9999,0
1668236187642,ECE 200,030,103615,Morris; Karcher William,9999,0,9999,0
1668236187642,ECE 200,031,103616,Ng; Tse Nga,9999,0,9999,0
1668236187642,ECE 200,032,103617,Nguyen; Truong Quang,9999,0,9999,0
1668236187642,ECE 200,033,103618,Nomura; Kenji,9999,0,9999,0
1668236187642,ECE 200,034,103619,Orlitsky; Alon,9999,0,9999,0
1668236187642,ECE 200,035,103620,Pal; Piya,9999,0,9999,0
1668236187642,ECE 200,036,103621,Papen; George C.,9999,0,9999,0
1668236187642,ECE 200,037,103622,Radic; Stojan,9999,0,9999,0
1668236187642,ECE 200,038,103623,Rao; Bhaskar D.,9999,0,9999,0
1668236187642,ECE 200,039,103624,Rao; Ramesh R,9999,0,9999,0
1668236187642,ECE 200,040,103625,Rebeiz; Gabriel,9999,0,9999,0
1668236187642,ECE 200,041,103626,Sanford; John R,9999,0,9999,0
1668236187642,ECE 200,042,103627,Siegel; Paul H.,9999,0,9999,0
1668236187642,ECE 200,043,103628,Sievenpiper; Daniel F.,9999,0,9999,0
1668236187642,ECE 200,044,103629,Sworder; David D.,9999,0,9999,0
1668236187642,ECE 200,045,103630,Taur; Yuan,9999,0,9999,0
1668236187642,ECE 200,046,103631,Touri; Behrouz,9999,0,9999,0
1668236187642,ECE 200,047,103632,Trivedi; Mohan M.,9999,0,9999,0
1668236187642,ECE 200,048,103633,Vasconcelos; Nuno,9999,0,9999,0
1668236187642,ECE 200,049,103634,Wang; Xiaolong,9999,0,9999,0
1668236187642,ECE 200,050,103635,Xie; Pengtao,9999,0,9999,0
1668236187642,ECE 200,051,103636,Yip; Michael,9999,0,9999,0
1668236187642,ECE 200,052,103637,Zeger; Kenneth A.,999,0,999,0
1668236187642,ECE 200,053,103638,Zhang; Xinyu,9999,0,9999,0
1668236187642,ECE 200,054,103639,Turakhia; Yatish Girish,9999,0,9999,0
1668236187642,ECE 200,055,103640,Kang; Mingu,9999,0,9999,0
1668236187642,ECE 200,056,103641,Shi; Yuanyuan,9999,0,9999,0
1668236187642,ECE 200,057,103642,Wang; Edward Jay,9999,0,9999,0
1668236187642,ECE 200,058,103643,Zheng; Yang,9999,0,9999,0
1668236188070,ECE 202,A00,103644,Kuzum; Duygu,0,0,0,0
1668236188494,ECE 212BN,A00,103646,Ng; Tse Nga,0,0,0,0
1668236188918,ECE 221,A00,111493,Staff,0,0,0,0
1668236189345,ECE 222B,A00,103647,Lomakin; Vitaliy,0,0,0,0
1668236189770,ECE 230B,A00,103648,Taur; Yuan,0,0,0,0
1668236190194,ECE 238B,A00,103649,Garay; Javier,0,0,0,0
1668236190617,ECE 240B,A00,112900,Fainman; Yeshaiahu,0,0,0,0
1668236191040,ECE 247A,A00,103650,Jokerst; Jesse Vincent,0,0,0,0
1668236191464,ECE 247B,A00,103651,Wang; Joseph,0,0,0,0
1668236191891,ECE 250,A00,103652,Siegel; Paul H.,0,0,0,0
1668236192314,ECE 251A,A00,103654,Rao; Bhaskar D.,0,0,0,0
1668236192738,ECE 257B,A00,103655,Bharadia; Dinesh,0,0,0,0
1668236193162,ECE 258A,A00,103656,Milstein; Laurence B.,0,0,0,0
1668236193586,ECE 260B,A00,103658,Kang; Mingu,0,0,0,0
1668236194019,ECE 264A,A00,103659,Galton; Ian A,0,0,0,0
1668236194443,ECE 265A,A00,103661,Gudem; Prasad S.S.,0,0,0,0
1668236194865,ECE 265D,A00,103662,Gudem; Prasad S.S.,0,0,0,0
1668236195293,ECE 268,A00,103663,Koushanfar; Farinaz,0,0,0,0
1668236195715,ECE 269,A01,103665,Pal; Piya,0,0,0,0
1668236196142,ECE 271B,A00,103666,Vasconcelos; Manuela,0,0,0,0
1668236196567,ECE 276A,A00,103667,Atanasov; Nikolay A.,0,0,0,0
1668236196993,ECE 277,A00,103668,An; Cheolhong,0,0,0,0
1668236197419,ECE 279,A00,117947,Hall; Drew A.,0,0,0,0
1668236198266,ECE 283,A00,103670,Hsueh; Tzu-Chien,0,0,0,0
1668236198692,ECE 284,A00,103671,Turakhia; Yatish Girish,0,0,0,0
1668236199114,ECE 285,A00,103672,Zheng; Yang,0,0,0,0
1668236199114,ECE 285,B00,103673,Sworder; David D.,0,0,0,0
1668236199542,ECE 287,A00,103676,Javidi; Tara,0,0,0,0
1668236199975,MATH 200B,A00,098023,Salehi Golsefidy; Alireza,12,0,15,3
1668236200400,MATH 202B,A00,098024,Rhoades; Brendon Patrick,9,0,15,6
1668236200827,MATH 203B,A00,098025,Oprea; Dragos N.,10,0,15,5
1668236201254,MATH 204B,A00,098026,Sorensen; Claus M,13,0,15,2
1668236201680,MATH 208,A00,098027,Izadi; Elham,7,0,10,3
1668236202104,MATH 209,A00,098028,Pollack; Aaron,10,0,10,0
1668236202530,MATH 211A,A00,112919,Rogalski; Daniel,9,0,10,1
1668236202954,MATH 211B,A00,112920,Seward; Brandon M.,9,0,10,1
1668236203380,MATH 218,A00,098029,Li; Bo,10,0,10,0
1668236203803,MATH 220B,A00,098030,Novak; Jonathan I,11,0,15,4
1668236204228,MATH 221A,A00,098031,Ebenfelt; Peter F,13,0,15,2
1668236204652,MATH 231B,A00,098032,Zlatos; Andrej,12,0,15,3
1668236205080,MATH 240B,A00,098033,Ni; Lei,9,0,15,6
1668236205506,MATH 243,A00,098034,Jekel; David Andrew,10,0,10,0
1668236205932,MATH 245A,A00,098035,Nie; Jiawang,0,0,15,16
1668236206353,MATH 248,A00,098036,Bejenaru; Ioan,10,0,10,0
1668236206776,MATH 250B,A00,098037,Spolaor; Luca,14,0,15,1
1668236207200,MATH 258,A00,098038,Ni; Lei,10,0,10,0
1668236207623,MATH 264B,A00,098041,Rhoades; Brendon Patrick,9,0,15,6
1668236208121,MATH 268,A00,098042,Buss; Samuel R,10,0,10,0
1668236208549,MATH 269,A00,098043,Rhoades; Brendon Patrick,10,0,10,0
1668236208987,MATH 270B,A00,098044,Li; Bo,10,0,15,5
1668236209411,MATH 272B,A00,098045,Holst; Michael J,13,0,15,2
1668236209835,MATH 273A,A00,098046,Tian; Xiaochuan,10,0,15,5
1668236210258,MATH 275,A01,098048,Tian; Xiaochuan,6,0,10,4
1668236210681,MATH 278A,A00,098049,Holst; Michael J,8,0,10,2
1668236211108,MATH 278B,A00,098050,Cloninger; Alexander,10,0,10,0
1668236211531,MATH 278C,A00,098051,Nie; Jiawang,7,0,10,3
1668236211958,MATH 280B,A00,098052,Zheng; Tianyi,10,0,15,5
1668236212383,MATH 281B,A00,098053,Bradic; Jelena,1,0,15,14
1668236212807,MATH 282B,A00,098054,Arias-Castro; Ery,0,0,15,15
1668236213233,MATH 285,A00,098055,Fitzsimmons; Patrick J,0,0,15,17
1668236213659,MATH 287B,A00,098056,Arias-Castro; Ery,2,0,15,13
1668236214080,MATH 288,A00,098057,Agarwal; Pooja,9,0,10,1
1668236214080,MATH 288,B00,098058,Zhang; Danna,8,0,10,2
1668236214080,MATH 288,C00,098059,Williams; Ruth J,10,0,10,0
1668236214505,MATH 290B,A00,098060,Roberts; Justin Deritter,13,0,15,2
1668236214929,MATH 292,A00,098061,Belmont; Eva Kinoshita,10,0,10,0
1668236215351,MATH 295,A00,098062,Suk; Andrew Hoon,48,0,50,2
1668236215773,MATH 296,A00,098063,Novak; Jonathan I,20,0,20,0
1668236216196,MATH 297,001,098064,Gamst; Anthony Collins,9997,0,9999,2
1668236717110,COGS 205,A00,101395,Chiba; Andrea,19,0,20,1
1668236717538,COGS 210B,001,101404,Greene; Deanna Jacquelyn,9998,0,9999,1
1668236717538,COGS 210B,002,101417,Xia; Haijun,9999,0,9999,0
1668236717538,COGS 210B,003,101422,Nitz; Douglas A.,9999,0,9999,0
1668236717538,COGS 210B,004,101423,Hollan; James D.,9998,0,9999,1
1668236717538,COGS 210B,005,101424,Deak; Gedeon O.,9998,0,9999,1
1668236717538,COGS 210B,006,101425,Rossano; Federico,9999,0,9999,0
1668236717973,COGS 211B,A00,101427,Coulson; Seana M,9996,0,9999,3
1668236718405,COGS 220,A00,101428,Hollan; James D.,0,0,25,25
1668236718831,COGS 229,A00,101429,Dow; Steven P,18,0,25,7
1668236719258,COGS 230,A00,101430,Klemmer; Scott R,12,0,17,5
1668236719685,COGS 234,A00,101431,Xia; Haijun,2,0,25,23
1668236720113,COGS 260,A00,101432,Kiyonaga; Anastasia,21,0,25,4
1668236720113,COGS 260,B00,101433,Kirsh; David Joel,15,0,25,10
1668236720537,CSE 202,A00,102371,Impagliazzo; Russell,0,0,0,0
1668236720963,CSE 203B,A01,102373,Cheng; Chung Kuan,0,0,0,0
1668236721390,CSE 208,A00,102374,Micciancio; Daniele,0,0,0,0
1668236721816,CSE 209A,A00,112895,Impagliazzo; Russell,0,0,15,15
1668236722252,CSE 209B,A00,108005,Bellare; Mihir,0,0,0,0
1668236722679,CSE 210,A00,113163,Coblenz; Michael J,0,0,0,0
1668236723119,CSE 219,A00,106111,Dow; Steven P,0,0,20,20
1668236723544,CSE 221,A00,102376,Voelker; Geoffrey M.,0,0,0,0
1668236723967,CSE 224,A01,102378,Porter; George M,0,0,0,0
1668236724394,CSE 229A,A00,102379,Savage; Stefan,0,0,0,0
1668236724817,CSE 229C,A00,102380,Munyaka; Imani N. S.,0,0,0,0
1668236725248,CSE 232B,A00,102382,Deutsch; Alin Bernard,0,0,0,0
1668236725679,CSE 234,A01,112904,Kumar; Arun Kumar,0,0,0,0
1668236726102,CSE 237A,A00,102383,Rosing; Tajana Simunic,0,0,0,0
1668236726524,CSE 239A,A00,102384,Deutsch; Alin Bernard,0,0,0,0
1668236726950,CSE 239B,A00,102385,Polikarpova; Nadezhda,0,0,0,0
1668236727374,CSE 240A,A00,102386,Pannuto; Patrick William,0,0,0,0
1668236727798,CSE 240B,A00,102387,Zhao; Jishen,0,0,0,0
1668236728221,CSE 241A,A00,106406,Kang; Mingu,0,0,0,0
1668236728649,CSE 249B,A00,102388,Kahng; Andrew Byun,0,0,8,8
1668236729165,CSE 251B,A01,102392,Cottrell; Garrison W,0,0,0,0
1668236729165,CSE 251B,A02,102393,Cottrell; Garrison W,0,0,0,0
1668236729590,CSE 252B,A00,102394,Ochoa; Benjamin Lawrence,0,0,0,0
1668236730013,CSE 257,A01,102396,Gao; Sicun,0,0,0,0
1668236730454,CSE 272,A00,102397,Li; Tzumao,0,0,0,0
1668236730877,CSE 274,A00,111323,Chern; Albert Ren-Haur,0,0,0,0
1668236731302,CSE 282,A00,102398,Pevzner; Pavel Arkadjevich,0,0,0,0
1668236731725,CSE 284,A00,114175,Gymrek; Melissa Ann,0,0,0,0
1668236732148,CSE 290,A00,102399,Chandraker; Manmohan Krishna,0,0,0,0
1668236732148,CSE 290,B00,102400,Vaccaro; Kristen Marie,0,0,25,25
1668236732148,CSE 290,C00,102414,Pannuto; Patrick William,0,0,25,25
1668236732148,CSE 290,D00,102427,Pevzner; Pavel Arkadjevich,0,0,0,0
1668236732148,CSE 290,E00,102429,Zhao; Jishen,0,0,0,0
1668236732148,CSE 290,F00,102436,Tullsen; Dean Michael,0,0,0,0
1668236732148,CSE 290,G00,102440,Christensen; Henrik I,0,0,20,20
1668236732579,CSE 291,A00,102443,Su; Hao,0,0,0,0
1668236732579,CSE 291,B00,102448,Polikarpova; Nadezhda,0,0,0,0
1668236732579,CSE 291,C00,102453,Vaccaro; Kristen Marie,0,0,0,0
1668236732579,CSE 291,D00,111343,Savage; Stefan,0,0,0,0
1668236732579,CSE 291,E00,116474,Claffy; Kimberly Claire,0,0,0,0
1668236732579,CSE 291,F00,116479,Pasquale; Joseph,0,0,0,0
1668236733009,CSE 293,001,119111,Bafna; Vineet,9999,0,9999,0
1668236733009,CSE 293,002,119118,Bellare; Mihir,9999,0,9999,0
1668236733009,CSE 293,003,119122,Berg-Kirkpatrick; Taylor D,9999,0,9999,0
1668236733009,CSE 293,004,119135,Christensen; Henrik I,9999,0,9999,0
1668236733009,CSE 293,005,119142,Cottrell; Garrison W,9999,0,9999,0
1668236733009,CSE 293,006,119146,Deutsch; Alin Bernard,9999,0,9999,0
1668236733009,CSE 293,007,119159,Esmaeilzadeh; Hadi,9999,0,9999,0
1668236733009,CSE 293,008,119166,Freund; Yoav,9999,0,9999,0
1668236733009,CSE 293,009,119170,Griswold; William G.,9999,0,9999,0
1668236733009,CSE 293,010,119183,Gymrek; Melissa Ann,9999,0,9999,0
1668236733009,CSE 293,011,119190,Heninger; Nadia A,9999,0,9999,0
1668236733009,CSE 293,012,119230,Impagliazzo; Russell,9999,0,9999,0
1668236733009,CSE 293,013,119232,Jhala; Ranjit,9999,0,9999,0
1668236733009,CSE 293,014,119233,Kahng; Andrew Byun,9999,0,9999,0
1668236733009,CSE 293,015,119298,Kane; Daniel Mertz,9999,0,9999,0
1668236733009,CSE 293,016,119299,Kriegman; David J,9999,0,9999,0
1668236733009,CSE 293,017,119300,Kumar; Arun Kumar,9999,0,9999,0
1668236733009,CSE 293,018,119301,Lerner; Sorin,9999,0,9999,0
1668236733009,CSE 293,019,119302,Lovett; Shachar,9999,0,9999,0
1668236733009,CSE 293,020,119303,McAuley; Julian John,9999,0,9999,0
1668236733009,CSE 293,021,119304,Micciancio; Daniele,9999,0,9999,0
1668236733009,CSE 293,022,119367,Orailoglu; Alex,9999,0,9999,0
1668236733009,CSE 293,023,119382,Paturi; Ramamohan,9999,0,9999,0
1668236733009,CSE 293,024,119404,Polikarpova; Nadezhda,9999,0,9999,0
1668236733009,CSE 293,025,119406,Politz; Joseph Gibbs,9999,0,9999,0
1668236733009,CSE 293,026,119411,Porter; George M,9999,0,9999,0
1668236733009,CSE 293,027,119414,Porter; Leonard Emerson,9999,0,9999,0
1668236733009,CSE 293,028,119416,Ramamoorthi; Ravi,9999,0,9999,0
1668236733009,CSE 293,029,119417,Sahoo; Debashis,9999,0,9999,0
1668236733009,CSE 293,030,119420,Saul; Lawrence,9999,0,9999,0
1668236733009,CSE 293,031,119421,Savage; Stefan,9999,0,9999,0
1668236733009,CSE 293,032,119425,Schulze; Jurgen P.,9999,0,9999,0
1668236733009,CSE 293,033,119426,Snoeren; Alex C.,9999,0,9999,0
1668236733009,CSE 293,034,119428,Shang; Jingbo,9999,0,9999,0
1668236733009,CSE 293,035,119430,Stefan; Deian,9999,0,9999,0
1668236733009,CSE 293,036,119431,Su; Hao,9999,0,9999,0
1668236733009,CSE 293,037,119433,Swanson; Steven James,9999,0,9999,0
1668236733009,CSE 293,038,119435,Tullsen; Dean Michael,9999,0,9999,0
1668236733009,CSE 293,039,119483,Voelker; Geoffrey M.,9999,0,9999,0
1668236733009,CSE 293,040,119537,Zhao; Jishen,9999,0,9999,0
1668236733009,CSE 293,041,119538,Zhou; Yuan-Yuan,9999,0,9999,0
1668236733009,CSE 293,042,119539,Gao; Sicun,9999,0,9999,0
1668236733009,CSE 293,043,119540,Weibel; Nadir,9999,0,9999,0
1668236733009,CSE 293,044,119541,Gupta; Rajesh K.,9999,0,9999,0
1668236733009,CSE 293,045,126410,Vaccaro; Kristen Marie,9999,0,9999,0
1668236733009,CSE 293,046,126411,Klemke; Richard,9999,0,9999,0
1668236733434,CSE 294,A00,102459,Voelker; Geoffrey M.,0,0,0,0
1668236733434,CSE 294,B00,111322,Orailoglu; Alex,0,0,0,0
1668236733859,DSE 201,A00,096914,Deutsch; Alin Bernard,30,0,30,0
1668236734287,DSE 210,A00,096915,Dasgupta; Sanjoy,30,0,30,0
1668236734711,DSE 260A,A00,096916,Altintas De Callaf; Ilkay,30,0,30,0
1668236735164,ECE 200,001,103586,Antipa; Nicholas A,9999,0,9999,0
1668236735164,ECE 200,002,103587,Atanasov; Nikolay A.,9999,0,9999,0
1668236735164,ECE 200,003,103588,Bharadia; Dinesh,9999,0,9999,0
1668236735164,ECE 200,004,103589,Cheng; Chung Kuan,9999,0,9999,0
1668236735164,ECE 200,005,103590,Cosman; Pamela C.,9999,0,9999,0
1668236735164,ECE 200,006,103591,Dayeh; Shadi Ahmad,9999,0,9999,0
1668236735164,ECE 200,007,103592,Fainman; Yeshaiahu,9999,0,9999,0
1668236735164,ECE 200,008,103593,Ford; Joseph Earl,9999,0,9999,0
1668236735164,ECE 200,009,103594,Franceschetti; Massimo,9999,0,9999,0
1668236735164,ECE 200,010,103595,Fullerton; Eric E,9999,0,9999,0
1668236735164,ECE 200,011,103596,Galton; Ian A,9999,0,9999,0
1668236735164,ECE 200,012,103597,Gilja; Vikash,9999,0,9999,0
1668236735164,ECE 200,013,103598,Hall; Drew A.,9999,0,9999,0
1668236735164,ECE 200,014,103599,Hsueh; Tzu-Chien,9999,0,9999,0
1668236735164,ECE 200,015,103600,Javidi; Tara,9999,0,9999,0
1668236735164,ECE 200,016,103601,Kahng; Andrew Byun,9999,0,9999,0
1668236735164,ECE 200,017,103602,Kim; Young-Han,9999,0,9999,0
1668236735164,ECE 200,018,103603,Koushanfar; Farinaz,9999,0,9999,0
1668236735164,ECE 200,019,103604,Kuzum; Duygu,9999,0,9999,0
1668236735164,ECE 200,020,103605,Le; Hanh-Phuc,9999,0,9999,0
1668236735164,ECE 200,021,103606,Lin; Bill,9999,0,9999,0
1668236735164,ECE 200,022,103607,Liu; Zhaowei,9998,0,9999,1
1668236735164,ECE 200,023,103608,Lo; Yu-Hwa,9999,0,9999,0
1668236735164,ECE 200,024,103609,Lomakin; Vitaliy,9999,0,9999,0
1668236735164,ECE 200,025,103610,Mercier; Patrick Philip,9999,0,9999,0
1668236735164,ECE 200,026,103611,Meyer; Florian,9999,0,9999,0
1668236735164,ECE 200,027,103612,Milstein; Laurence B.,9999,0,9999,0
1668236735164,ECE 200,028,103613,Mir Arabbaygi; Siavash,9999,0,9999,0
1668236735164,ECE 200,029,103614,Mookherjea; Shayan,9999,0,9999,0
1668236735164,ECE 200,030,103615,Morris; Karcher William,9999,0,9999,0
1668236735164,ECE 200,031,103616,Ng; Tse Nga,9999,0,9999,0
1668236735164,ECE 200,032,103617,Nguyen; Truong Quang,9999,0,9999,0
1668236735164,ECE 200,033,103618,Nomura; Kenji,9999,0,9999,0
1668236735164,ECE 200,034,103619,Orlitsky; Alon,9999,0,9999,0
1668236735164,ECE 200,035,103620,Pal; Piya,9999,0,9999,0
1668236735164,ECE 200,036,103621,Papen; George C.,9999,0,9999,0
1668236735164,ECE 200,037,103622,Radic; Stojan,9999,0,9999,0
1668236735164,ECE 200,038,103623,Rao; Bhaskar D.,9999,0,9999,0
1668236735164,ECE 200,039,103624,Rao; Ramesh R,9999,0,9999,0
1668236735164,ECE 200,040,103625,Rebeiz; Gabriel,9999,0,9999,0
1668236735164,ECE 200,041,103626,Sanford; John R,9999,0,9999,0
1668236735164,ECE 200,042,103627,Siegel; Paul H.,9999,0,9999,0
1668236735164,ECE 200,043,103628,Sievenpiper; Daniel F.,9999,0,9999,0
1668236735164,ECE 200,044,103629,Sworder; David D.,9999,0,9999,0
1668236735164,ECE 200,045,103630,Taur; Yuan,9999,0,9999,0
1668236735164,ECE 200,046,103631,Touri; Behrouz,9999,0,9999,0
1668236735164,ECE 200,047,103632,Trivedi; Mohan M.,9999,0,9999,0
1668236735164,ECE 200,048,103633,Vasconcelos; Nuno,9999,0,9999,0
1668236735164,ECE 200,049,103634,Wang; Xiaolong,9999,0,9999,0
1668236735164,ECE 200,050,103635,Xie; Pengtao,9999,0,9999,0
1668236735164,ECE 200,051,103636,Yip; Michael,9999,0,9999,0
1668236735164,ECE 200,052,103637,Zeger; Kenneth A.,999,0,999,0
1668236735164,ECE 200,053,103638,Zhang; Xinyu,9999,0,9999,0
1668236735164,ECE 200,054,103639,Turakhia; Yatish Girish,9999,0,9999,0
1668236735164,ECE 200,055,103640,Kang; Mingu,9999,0,9999,0
1668236735164,ECE 200,056,103641,Shi; Yuanyuan,9999,0,9999,0
1668236735164,ECE 200,057,103642,Wang; Edward Jay,9999,0,9999,0
1668236735164,ECE 200,058,103643,Zheng; Yang,9999,0,9999,0
1668236735586,ECE 202,A00,103644,Kuzum; Duygu,0,0,0,0
1668236736011,ECE 212BN,A00,103646,Ng; Tse Nga,0,0,0,0
1668236736436,ECE 221,A00,111493,Staff,0,0,0,0
1668236736859,ECE 222B,A00,103647,Lomakin; Vitaliy,0,0,0,0
1668236737282,ECE 230B,A00,103648,Taur; Yuan,0,0,0,0
1668236737707,ECE 238B,A00,103649,Garay; Javier,0,0,0,0
1668236738130,ECE 240B,A00,112900,Fainman; Yeshaiahu,0,0,0,0
1668236738553,ECE 247A,A00,103650,Jokerst; Jesse Vincent,0,0,0,0
1668236738976,ECE 247B,A00,103651,Wang; Joseph,0,0,0,0
1668236739404,ECE 250,A00,103652,Siegel; Paul H.,0,0,0,0
1668236739831,ECE 251A,A00,103654,Rao; Bhaskar D.,0,0,0,0
1668236740262,ECE 257B,A00,103655,Bharadia; Dinesh,0,0,0,0
1668236740686,ECE 258A,A00,103656,Milstein; Laurence B.,0,0,0,0
1668236741117,ECE 260B,A00,103658,Kang; Mingu,0,0,0,0
1668236741542,ECE 264A,A00,103659,Galton; Ian A,0,0,0,0
1668236741981,ECE 265A,A00,103661,Gudem; Prasad S.S.,0,0,0,0
1668236742405,ECE 265D,A00,103662,Gudem; Prasad S.S.,0,0,0,0
1668236742826,ECE 268,A00,103663,Koushanfar; Farinaz,0,0,0,0
1668236743262,ECE 269,A01,103665,Pal; Piya,0,0,0,0
1668236743685,ECE 271B,A00,103666,Vasconcelos; Manuela,0,0,0,0
1668236744107,ECE 276A,A00,103667,Atanasov; Nikolay A.,0,0,0,0
1668236744531,ECE 277,A00,103668,An; Cheolhong,0,0,0,0
1668236744956,ECE 279,A00,117947,Hall; Drew A.,0,0,0,0
1668236745805,ECE 283,A00,103670,Hsueh; Tzu-Chien,0,0,0,0
1668236746229,ECE 284,A00,103671,Turakhia; Yatish Girish,0,0,0,0
1668236746651,ECE 285,A00,103672,Zheng; Yang,0,0,0,0
1668236746651,ECE 285,B00,103673,Sworder; David D.,0,0,0,0
1668236747077,ECE 287,A00,103676,Javidi; Tara,0,0,0,0
1668236747500,MATH 200B,A00,098023,Salehi Golsefidy; Alireza,12,0,15,3
1668236747927,MATH 202B,A00,098024,Rhoades; Brendon Patrick,9,0,15,6
1668236748352,MATH 203B,A00,098025,Oprea; Dragos N.,10,0,15,5
1668236748780,MATH 204B,A00,098026,Sorensen; Claus M,13,0,15,2
1668236749203,MATH 208,A00,098027,Izadi; Elham,7,0,10,3
1668236749625,MATH 209,A00,098028,Pollack; Aaron,10,0,10,0
1668236750048,MATH 211A,A00,112919,Rogalski; Daniel,9,0,10,1
1668236750474,MATH 211B,A00,112920,Seward; Brandon M.,9,0,10,1
1668236750897,MATH 218,A00,098029,Li; Bo,10,0,10,0
1668236751327,MATH 220B,A00,098030,Novak; Jonathan I,11,0,15,4
1668236751753,MATH 221A,A00,098031,Ebenfelt; Peter F,13,0,15,2
1668236752178,MATH 231B,A00,098032,Zlatos; Andrej,12,0,15,3
1668236752605,MATH 240B,A00,098033,Ni; Lei,9,0,15,6
1668236753026,MATH 243,A00,098034,Jekel; David Andrew,10,0,10,0
1668236753451,MATH 245A,A00,098035,Nie; Jiawang,0,0,15,16
1668236753878,MATH 248,A00,098036,Bejenaru; Ioan,10,0,10,0
1668236754301,MATH 250B,A00,098037,Spolaor; Luca,14,0,15,1
1668236754728,MATH 258,A00,098038,Ni; Lei,10,0,10,0
1668236755151,MATH 264B,A00,098041,Rhoades; Brendon Patrick,9,0,15,6
1668236755576,MATH 268,A00,098042,Buss; Samuel R,10,0,10,0
1668236756001,MATH 269,A00,098043,Rhoades; Brendon Patrick,10,0,10,0
1668236756424,MATH 270B,A00,098044,Li; Bo,10,0,15,5
1668236756850,MATH 272B,A00,098045,Holst; Michael J,13,0,15,2
1668236757274,MATH 273A,A00,098046,Tian; Xiaochuan,10,0,15,5
1668236757697,MATH 275,A01,098048,Tian; Xiaochuan,6,0,10,4
1668236758124,MATH 278A,A00,098049,Holst; Michael J,8,0,10,2
1668236758547,MATH 278B,A00,098050,Cloninger; Alexander,10,0,10,0
1668236758972,MATH 278C,A00,098051,Nie; Jiawang,7,0,10,3
1668236759398,MATH 280B,A00,098052,Zheng; Tianyi,10,0,15,5
1668236759822,MATH 281B,A00,098053,Bradic; Jelena,1,0,15,14
1668236760259,MATH 282B,A00,098054,Arias-Castro; Ery,0,0,15,15
1668236760683,MATH 285,A00,098055,Fitzsimmons; Patrick J,0,0,15,17
1668236761105,MATH 287B,A00,098056,Arias-Castro; Ery,2,0,15,13
1668236761527,MATH 288,A00,098057,Agarwal; Pooja,9,0,10,1
1668236761527,MATH 288,B00,098058,Zhang; Danna,8,0,10,2
1668236761527,MATH 288,C00,098059,Williams; Ruth J,10,0,10,0
1668236761953,MATH 290B,A00,098060,Roberts; Justin Deritter,13,0,15,2
1668236762385,MATH 292,A00,098061,Belmont; Eva Kinoshita,10,0,10,0
1668236762807,MATH 295,A00,098062,Suk; Andrew Hoon,48,0,50,2
1668236763236,MATH 296,A00,098063,Novak; Jonathan I,20,0,20,0
1668236763658,MATH 297,001,098064,Gamst; Anthony Collins,9997,0,9999,2
1668237263983,COGS 205,A00,101395,Chiba; Andrea,19,0,20,1
1668237264409,COGS 210B,001,101404,Greene; Deanna Jacquelyn,9998,0,9999,1
1668237264409,COGS 210B,002,101417,Xia; Haijun,9999,0,9999,0
1668237264409,COGS 210B,003,101422,Nitz; Douglas A.,9999,0,9999,0
1668237264409,COGS 210B,004,101423,Hollan; James D.,9998,0,9999,1
1668237264409,COGS 210B,005,101424,Deak; Gedeon O.,9998,0,9999,1
1668237264409,COGS 210B,006,101425,Rossano; Federico,9999,0,9999,0
1668237264832,COGS 211B,A00,101427,Coulson; Seana M,9996,0,9999,3
1668237265264,COGS 220,A00,101428,Hollan; James D.,0,0,25,25
1668237265686,COGS 229,A00,101429,Dow; Steven P,18,0,25,7
1668237266109,COGS 230,A00,101430,Klemmer; Scott R,12,0,17,5
1668237266558,COGS 234,A00,101431,Xia; Haijun,2,0,25,23
1668237266997,COGS 260,A00,101432,Kiyonaga; Anastasia,21,0,25,4
1668237266997,COGS 260,B00,101433,Kirsh; David Joel,15,0,25,10
1668237267426,CSE 202,A00,102371,Impagliazzo; Russell,0,0,0,0
1668237267851,CSE 203B,A01,102373,Cheng; Chung Kuan,0,0,0,0
1668237268275,CSE 208,A00,102374,Micciancio; Daniele,0,0,0,0
1668237268699,CSE 209A,A00,112895,Impagliazzo; Russell,0,0,15,15
1668237269129,CSE 209B,A00,108005,Bellare; Mihir,0,0,0,0
1668237269552,CSE 210,A00,113163,Coblenz; Michael J,0,0,0,0
1668237269977,CSE 219,A00,106111,Dow; Steven P,0,0,20,20
1668237270403,CSE 221,A00,102376,Voelker; Geoffrey M.,0,0,0,0
1668237270830,CSE 224,A01,102378,Porter; George M,0,0,0,0
1668237271254,CSE 229A,A00,102379,Savage; Stefan,0,0,0,0
1668237271680,CSE 229C,A00,102380,Munyaka; Imani N. S.,0,0,0,0
1668237272106,CSE 232B,A00,102382,Deutsch; Alin Bernard,0,0,0,0
1668237272530,CSE 234,A01,112904,Kumar; Arun Kumar,0,0,0,0
1668237272956,CSE 237A,A00,102383,Rosing; Tajana Simunic,0,0,0,0
1668237273380,CSE 239A,A00,102384,Deutsch; Alin Bernard,0,0,0,0
1668237273804,CSE 239B,A00,102385,Polikarpova; Nadezhda,0,0,0,0
1668237274229,CSE 240A,A00,102386,Pannuto; Patrick William,0,0,0,0
1668237274655,CSE 240B,A00,102387,Zhao; Jishen,0,0,0,0
1668237275079,CSE 241A,A00,106406,Kang; Mingu,0,0,0,0
1668237275502,CSE 249B,A00,102388,Kahng; Andrew Byun,0,0,8,8
1668237275925,CSE 251B,A01,102392,Cottrell; Garrison W,0,0,0,0
1668237275925,CSE 251B,A02,102393,Cottrell; Garrison W,0,0,0,0
1668237276352,CSE 252B,A00,102394,Ochoa; Benjamin Lawrence,0,0,0,0
1668237276775,CSE 257,A01,102396,Gao; Sicun,0,0,0,0
1668237277198,CSE 272,A00,102397,Li; Tzumao,0,0,0,0
1668237277632,CSE 274,A00,111323,Chern; Albert Ren-Haur,0,0,0,0
1668237278059,CSE 282,A00,102398,Pevzner; Pavel Arkadjevich,0,0,0,0
1668237278494,CSE 284,A00,114175,Gymrek; Melissa Ann,0,0,0,0
1668237278935,CSE 290,A00,102399,Chandraker; Manmohan Krishna,0,0,0,0
1668237278935,CSE 290,B00,102400,Vaccaro; Kristen Marie,0,0,25,25
1668237278935,CSE 290,C00,102414,Pannuto; Patrick William,0,0,25,25
1668237278935,CSE 290,D00,102427,Pevzner; Pavel Arkadjevich,0,0,0,0
1668237278935,CSE 290,E00,102429,Zhao; Jishen,0,0,0,0
1668237278935,CSE 290,F00,102436,Tullsen; Dean Michael,0,0,0,0
1668237278935,CSE 290,G00,102440,Christensen; Henrik I,0,0,20,20
1668237279362,CSE 291,A00,102443,Su; Hao,0,0,0,0
1668237279362,CSE 291,B00,102448,Polikarpova; Nadezhda,0,0,0,0
1668237279362,CSE 291,C00,102453,Vaccaro; Kristen Marie,0,0,0,0
1668237279362,CSE 291,D00,111343,Savage; Stefan,0,0,0,0
1668237279362,CSE 291,E00,116474,Claffy; Kimberly Claire,0,0,0,0
1668237279362,CSE 291,F00,116479,Pasquale; Joseph,0,0,0,0
1668237279814,CSE 293,001,119111,Bafna; Vineet,9999,0,9999,0
1668237279814,CSE 293,002,119118,Bellare; Mihir,9999,0,9999,0
1668237279814,CSE 293,003,119122,Berg-Kirkpatrick; Taylor D,9999,0,9999,0
1668237279814,CSE 293,004,119135,Christensen; Henrik I,9999,0,9999,0
1668237279814,CSE 293,005,119142,Cottrell; Garrison W,9999,0,9999,0
1668237279814,CSE 293,006,119146,Deutsch; Alin Bernard,9999,0,9999,0
1668237279814,CSE 293,007,119159,Esmaeilzadeh; Hadi,9999,0,9999,0
1668237279814,CSE 293,008,119166,Freund; Yoav,9999,0,9999,0
1668237279814,CSE 293,009,119170,Griswold; William G.,9999,0,9999,0
1668237279814,CSE 293,010,119183,Gymrek; Melissa Ann,9999,0,9999,0
1668237279814,CSE 293,011,119190,Heninger; Nadia A,9999,0,9999,0
1668237279814,CSE 293,012,119230,Impagliazzo; Russell,9999,0,9999,0
1668237279814,CSE 293,013,119232,Jhala; Ranjit,9999,0,9999,0
1668237279814,CSE 293,014,119233,Kahng; Andrew Byun,9999,0,9999,0
1668237279814,CSE 293,015,119298,Kane; Daniel Mertz,9999,0,9999,0
1668237279814,CSE 293,016,119299,Kriegman; David J,9999,0,9999,0
1668237279814,CSE 293,017,119300,Kumar; Arun Kumar,9999,0,9999,0
1668237279814,CSE 293,018,119301,Lerner; Sorin,9999,0,9999,0
1668237279814,CSE 293,019,119302,Lovett; Shachar,9999,0,9999,0
1668237279814,CSE 293,020,119303,McAuley; Julian John,9999,0,9999,0
1668237279814,CSE 293,021,119304,Micciancio; Daniele,9999,0,9999,0
1668237279814,CSE 293,022,119367,Orailoglu; Alex,9999,0,9999,0
1668237279814,CSE 293,023,119382,Paturi; Ramamohan,9999,0,9999,0
1668237279814,CSE 293,024,119404,Polikarpova; Nadezhda,9999,0,9999,0
1668237279814,CSE 293,025,119406,Politz; Joseph Gibbs,9999,0,9999,0
1668237279814,CSE 293,026,119411,Porter; George M,9999,0,9999,0
1668237279814,CSE 293,027,119414,Porter; Leonard Emerson,9999,0,9999,0
1668237279814,CSE 293,028,119416,Ramamoorthi; Ravi,9999,0,9999,0
1668237279814,CSE 293,029,119417,Sahoo; Debashis,9999,0,9999,0
1668237279814,CSE 293,030,119420,Saul; Lawrence,9999,0,9999,0
1668237279814,CSE 293,031,119421,Savage; Stefan,9999,0,9999,0
1668237279814,CSE 293,032,119425,Schulze; Jurgen P.,9999,0,9999,0
1668237279814,CSE 293,033,119426,Snoeren; Alex C.,9999,0,9999,0
1668237279814,CSE 293,034,119428,Shang; Jingbo,9999,0,9999,0
1668237279814,CSE 293,035,119430,Stefan; Deian,9999,0,9999,0
1668237279814,CSE 293,036,119431,Su; Hao,9999,0,9999,0
1668237279814,CSE 293,037,119433,Swanson; Steven James,9999,0,9999,0
1668237279814,CSE 293,038,119435,Tullsen; Dean Michael,9999,0,9999,0
1668237279814,CSE 293,039,119483,Voelker; Geoffrey M.,9999,0,9999,0
1668237279814,CSE 293,040,119537,Zhao; Jishen,9999,0,9999,0
1668237279814,CSE 293,041,119538,Zhou; Yuan-Yuan,9999,0,9999,0
1668237279814,CSE 293,042,119539,Gao; Sicun,9999,0,9999,0
1668237279814,CSE 293,043,119540,Weibel; Nadir,9999,0,9999,0
1668237279814,CSE 293,044,119541,Gupta; Rajesh K.,9999,0,9999,0
1668237279814,CSE 293,045,126410,Vaccaro; Kristen Marie,9999,0,9999,0
1668237279814,CSE 293,046,126411,Klemke; Richard,9999,0,9999,0
1668237280249,CSE 294,A00,102459,Voelker; Geoffrey M.,0,0,0,0
1668237280249,CSE 294,B00,111322,Orailoglu; Alex,0,0,0,0
1668237280671,DSE 201,A00,096914,Deutsch; Alin Bernard,30,0,30,0
1668237281094,DSE 210,A00,096915,Dasgupta; Sanjoy,30,0,30,0
1668237281521,DSE 260A,A00,096916,Altintas De Callaf; Ilkay,30,0,30,0
1668237281963,ECE 200,001,103586,Antipa; Nicholas A,9999,0,9999,0
1668237281963,ECE 200,002,103587,Atanasov; Nikolay A.,9999,0,9999,0
1668237281963,ECE 200,003,103588,Bharadia; Dinesh,9999,0,9999,0
1668237281963,ECE 200,004,103589,Cheng; Chung Kuan,9999,0,9999,0
1668237281963,ECE 200,005,103590,Cosman; Pamela C.,9999,0,9999,0
1668237281963,ECE 200,006,103591,Dayeh; Shadi Ahmad,9999,0,9999,0
1668237281963,ECE 200,007,103592,Fainman; Yeshaiahu,9999,0,9999,0
1668237281963,ECE 200,008,103593,Ford; Joseph Earl,9999,0,9999,0
1668237281963,ECE 200,009,103594,Franceschetti; Massimo,9999,0,9999,0
1668237281963,ECE 200,010,103595,Fullerton; Eric E,9999,0,9999,0
1668237281963,ECE 200,011,103596,Galton; Ian A,9999,0,9999,0
1668237281963,ECE 200,012,103597,Gilja; Vikash,9999,0,9999,0
1668237281963,ECE 200,013,103598,Hall; Drew A.,9999,0,9999,0
1668237281963,ECE 200,014,103599,Hsueh; Tzu-Chien,9999,0,9999,0
1668237281963,ECE 200,015,103600,Javidi; Tara,9999,0,9999,0
1668237281963,ECE 200,016,103601,Kahng; Andrew Byun,9999,0,9999,0
1668237281963,ECE 200,017,103602,Kim; Young-Han,9999,0,9999,0
1668237281963,ECE 200,018,103603,Koushanfar; Farinaz,9999,0,9999,0
1668237281963,ECE 200,019,103604,Kuzum; Duygu,9999,0,9999,0
1668237281963,ECE 200,020,103605,Le; Hanh-Phuc,9999,0,9999,0
1668237281963,ECE 200,021,103606,Lin; Bill,9999,0,9999,0
1668237281963,ECE 200,022,103607,Liu; Zhaowei,9998,0,9999,1
1668237281963,ECE 200,023,103608,Lo; Yu-Hwa,9999,0,9999,0
1668237281963,ECE 200,024,103609,Lomakin; Vitaliy,9999,0,9999,0
1668237281963,ECE 200,025,103610,Mercier; Patrick Philip,9999,0,9999,0
1668237281963,ECE 200,026,103611,Meyer; Florian,9999,0,9999,0
1668237281963,ECE 200,027,103612,Milstein; Laurence B.,9999,0,9999,0
1668237281963,ECE 200,028,103613,Mir Arabbaygi; Siavash,9999,0,9999,0
1668237281963,ECE 200,029,103614,Mookherjea; Shayan,9999,0,9999,0
1668237281963,ECE 200,030,103615,Morris; Karcher William,9999,0,9999,0
1668237281963,ECE 200,031,103616,Ng; Tse Nga,9999,0,9999,0
1668237281963,ECE 200,032,103617,Nguyen; Truong Quang,9999,0,9999,0
1668237281963,ECE 200,033,103618,Nomura; Kenji,9999,0,9999,0
1668237281963,ECE 200,034,103619,Orlitsky; Alon,9999,0,9999,0
1668237281963,ECE 200,035,103620,Pal; Piya,9999,0,9999,0
1668237281963,ECE 200,036,103621,Papen; George C.,9999,0,9999,0
1668237281963,ECE 200,037,103622,Radic; Stojan,9999,0,9999,0
1668237281963,ECE 200,038,103623,Rao; Bhaskar D.,9999,0,9999,0
1668237281963,ECE 200,039,103624,Rao; Ramesh R,9999,0,9999,0
1668237281963,ECE 200,040,103625,Rebeiz; Gabriel,9999,0,9999,0
1668237281963,ECE 200,041,103626,Sanford; John R,9999,0,9999,0
1668237281963,ECE 200,042,103627,Siegel; Paul H.,9999,0,9999,0
1668237281963,ECE 200,043,103628,Sievenpiper; Daniel F.,9999,0,9999,0
1668237281963,ECE 200,044,103629,Sworder; David D.,9999,0,9999,0
1668237281963,ECE 200,045,103630,Taur; Yuan,9999,0,9999,0
1668237281963,ECE 200,046,103631,Touri; Behrouz,9999,0,9999,0
1668237281963,ECE 200,047,103632,Trivedi; Mohan M.,9999,0,9999,0
1668237281963,ECE 200,048,103633,Vasconcelos; Nuno,9999,0,9999,0
1668237281963,ECE 200,049,103634,Wang; Xiaolong,9999,0,9999,0
1668237281963,ECE 200,050,103635,Xie; Pengtao,9999,0,9999,0
1668237281963,ECE 200,051,103636,Yip; Michael,9999,0,9999,0
1668237281963,ECE 200,052,103637,Zeger; Kenneth A.,999,0,999,0
1668237281963,ECE 200,053,103638,Zhang; Xinyu,9999,0,9999,0
1668237281963,ECE 200,054,103639,Turakhia; Yatish Girish,9999,0,9999,0
1668237281963,ECE 200,055,103640,Kang; Mingu,9999,0,9999,0
1668237281963,ECE 200,056,103641,Shi; Yuanyuan,9999,0,9999,0
1668237281963,ECE 200,057,103642,Wang; Edward Jay,9999,0,9999,0
1668237281963,ECE 200,058,103643,Zheng; Yang,9999,0,9999,0
1668237282387,ECE 202,A00,103644,Kuzum; Duygu,0,0,0,0
1668237282811,ECE 212BN,A00,103646,Ng; Tse Nga,0,0,0,0
1668237283235,ECE 221,A00,111493,Staff,0,0,0,0
1668237283659,ECE 222B,A00,103647,Lomakin; Vitaliy,0,0,0,0
1668237284084,ECE 230B,A00,103648,Taur; Yuan,0,0,0,0
1668237284510,ECE 238B,A00,103649,Garay; Javier,0,0,0,0
1668237284935,ECE 240B,A00,112900,Fainman; Yeshaiahu,0,0,0,0
1668237285357,ECE 247A,A00,103650,Jokerst; Jesse Vincent,0,0,0,0
1668237285779,ECE 247B,A00,103651,Wang; Joseph,0,0,0,0
1668237286208,ECE 250,A00,103652,Siegel; Paul H.,0,0,0,0
1668237286636,ECE 251A,A00,103654,Rao; Bhaskar D.,0,0,0,0
1668237287060,ECE 257B,A00,103655,Bharadia; Dinesh,0,0,0,0
1668237287485,ECE 258A,A00,103656,Milstein; Laurence B.,0,0,0,0
1668237287912,ECE 260B,A00,103658,Kang; Mingu,0,0,0,0
1668237288337,ECE 264A,A00,103659,Galton; Ian A,0,0,0,0
1668237288759,ECE 265A,A00,103661,Gudem; Prasad S.S.,0,0,0,0
1668237289182,ECE 265D,A00,103662,Gudem; Prasad S.S.,0,0,0,0
1668237289605,ECE 268,A00,103663,Koushanfar; Farinaz,0,0,0,0
1668237290041,ECE 269,A01,103665,Pal; Piya,0,0,0,0
1668237290467,ECE 271B,A00,103666,Vasconcelos; Manuela,0,0,0,0
1668237290905,ECE 276A,A00,103667,Atanasov; Nikolay A.,0,0,0,0
1668237291330,ECE 277,A00,103668,An; Cheolhong,0,0,0,0
1668237291755,ECE 279,A00,117947,Hall; Drew A.,0,0,0,0
1668237292683,ECE 283,A00,103670,Hsueh; Tzu-Chien,0,0,0,0
1668237293106,ECE 284,A00,103671,Turakhia; Yatish Girish,0,0,0,0
1668237293541,ECE 285,A00,103672,Zheng; Yang,0,0,0,0
1668237293541,ECE 285,B00,103673,Sworder; David D.,0,0,0,0
1668237293975,ECE 287,A00,103676,Javidi; Tara,0,0,0,0
1668237294412,MATH 200B,A00,098023,Salehi Golsefidy; Alireza,12,0,15,3
1668237294834,MATH 202B,A00,098024,Rhoades; Brendon Patrick,9,0,15,6
1668237295264,MATH 203B,A00,098025,Oprea; Dragos N.,10,0,15,5
1668237295699,MATH 204B,A00,098026,Sorensen; Claus M,13,0,15,2
1668237296132,MATH 208,A00,098027,Izadi; Elham,7,0,10,3
1668237296555,MATH 209,A00,098028,Pollack; Aaron,10,0,10,0
1668237296986,MATH 211A,A00,112919,Rogalski; Daniel,9,0,10,1
1668237297409,MATH 211B,A00,112920,Seward; Brandon M.,9,0,10,1
1668237297833,MATH 218,A00,098029,Li; Bo,10,0,10,0
1668237298263,MATH 220B,A00,098030,Novak; Jonathan I,11,0,15,4
1668237298692,MATH 221A,A00,098031,Ebenfelt; Peter F,13,0,15,2
1668237299117,MATH 231B,A00,098032,Zlatos; Andrej,12,0,15,3
1668237299541,MATH 240B,A00,098033,Ni; Lei,9,0,15,6
1668237299967,MATH 243,A00,098034,Jekel; David Andrew,10,0,10,0
1668237300392,MATH 245A,A00,098035,Nie; Jiawang,0,0,15,16
1668237300814,MATH 248,A00,098036,Bejenaru; Ioan,10,0,10,0
1668237301244,MATH 250B,A00,098037,Spolaor; Luca,14,0,15,1
1668237301665,MATH 258,A00,098038,Ni; Lei,10,0,10,0
1668237302092,MATH 264B,A00,098041,Rhoades; Brendon Patrick,9,0,15,6
1668237302515,MATH 268,A00,098042,Buss; Samuel R,10,0,10,0
1668237302939,MATH 269,A00,098043,Rhoades; Brendon Patrick,10,0,10,0
1668237303363,MATH 270B,A00,098044,Li; Bo,10,0,15,5
1668237303791,MATH 272B,A00,098045,Holst; Michael J,13,0,15,2
1668237304214,MATH 273A,A00,098046,Tian; Xiaochuan,10,0,15,5
1668237304640,MATH 275,A01,098048,Tian; Xiaochuan,6,0,10,4
1668237305066,MATH 278A,A00,098049,Holst; Michael J,8,0,10,2
1668237305494,MATH 278B,A00,098050,Cloninger; Alexander,10,0,10,0
1668237305921,MATH 278C,A00,098051,Nie; Jiawang,7,0,10,3
1668237306344,MATH 280B,A00,098052,Zheng; Tianyi,10,0,15,5
1668237306771,MATH 281B,A00,098053,Bradic; Jelena,1,0,15,14
1668237307194,MATH 282B,A00,098054,Arias-Castro; Ery,0,0,15,15
1668237307623,MATH 285,A00,098055,Fitzsimmons; Patrick J,0,0,15,17
1668237308049,MATH 287B,A00,098056,Arias-Castro; Ery,2,0,15,13
1668237308472,MATH 288,A00,098057,Agarwal; Pooja,9,0,10,1
1668237308472,MATH 288,B00,098058,Zhang; Danna,8,0,10,2
1668237308472,MATH 288,C00,098059,Williams; Ruth J,10,0,10,0
1668237308897,MATH 290B,A00,098060,Roberts; Justin Deritter,13,0,15,2
1668237309320,MATH 292,A00,098061,Belmont; Eva Kinoshita,10,0,10,0
1668237309747,MATH 295,A00,098062,Suk; Andrew Hoon,48,0,50,2
1668237310171,MATH 296,A00,098063,Novak; Jonathan I,20,0,20,0
1668237310595,MATH 297,001,098064,Gamst; Anthony Collins,9997,0,9999,2
1668237811055,COGS 205,A00,101395,Chiba; Andrea,19,0,20,1
1668237811478,COGS 210B,001,101404,Greene; Deanna Jacquelyn,9998,0,9999,1
1668237811478,COGS 210B,002,101417,Xia; Haijun,9999,0,9999,0
1668237811478,COGS 210B,003,101422,Nitz; Douglas A.,9999,0,9999,0
1668237811478,COGS 210B,004,101423,Hollan; James D.,9998,0,9999,1
1668237811478,COGS 210B,005,101424,Deak; Gedeon O.,9998,0,9999,1
1668237811478,COGS 210B,006,101425,Rossano; Federico,9999,0,9999,0
1668237811907,COGS 211B,A00,101427,Coulson; Seana M,9996,0,9999,3
1668237812330,COGS 220,A00,101428,Hollan; James D.,0,0,25,25
1668237812756,COGS 229,A00,101429,Dow; Steven P,18,0,25,7
1668237813281,COGS 230,A00,101430,Klemmer; Scott R,12,0,17,5
1668237813709,COGS 234,A00,101431,Xia; Haijun,2,0,25,23
1668237814133,COGS 260,A00,101432,Kiyonaga; Anastasia,21,0,25,4
1668237814133,COGS 260,B00,101433,Kirsh; David Joel,15,0,25,10
1668237814558,CSE 202,A00,102371,Impagliazzo; Russell,0,0,0,0
1668237814982,CSE 203B,A01,102373,Cheng; Chung Kuan,0,0,0,0
1668237815407,CSE 208,A00,102374,Micciancio; Daniele,0,0,0,0
1668237815832,CSE 209A,A00,112895,Impagliazzo; Russell,0,0,15,15
1668237816257,CSE 209B,A00,108005,Bellare; Mihir,0,0,0,0
1668237816684,CSE 210,A00,113163,Coblenz; Michael J,0,0,0,0
1668237817108,CSE 219,A00,106111,Dow; Steven P,0,0,20,20
1668237817535,CSE 221,A00,102376,Voelker; Geoffrey M.,0,0,0,0
1668237817962,CSE 224,A01,102378,Porter; George M,0,0,0,0
1668237818388,CSE 229A,A00,102379,Savage; Stefan,0,0,0,0
1668237818810,CSE 229C,A00,102380,Munyaka; Imani N. S.,0,0,0,0
1668237819235,CSE 232B,A00,102382,Deutsch; Alin Bernard,0,0,0,0
1668237819661,CSE 234,A01,112904,Kumar; Arun Kumar,0,0,0,0
1668237820084,CSE 237A,A00,102383,Rosing; Tajana Simunic,0,0,0,0
1668237820508,CSE 239A,A00,102384,Deutsch; Alin Bernard,0,0,0,0
1668237820933,CSE 239B,A00,102385,Polikarpova; Nadezhda,0,0,0,0
1668237821362,CSE 240A,A00,102386,Pannuto; Patrick William,0,0,0,0
1668237821787,CSE 240B,A00,102387,Zhao; Jishen,0,0,0,0
1668237822212,CSE 241A,A00,106406,Kang; Mingu,0,0,0,0
1668237822635,CSE 249B,A00,102388,Kahng; Andrew Byun,0,0,8,8
1668237823060,CSE 251B,A01,102392,Cottrell; Garrison W,0,0,0,0
1668237823060,CSE 251B,A02,102393,Cottrell; Garrison W,0,0,0,0
1668237823485,CSE 252B,A00,102394,Ochoa; Benjamin Lawrence,0,0,0,0
1668237823911,CSE 257,A01,102396,Gao; Sicun,0,0,0,0
1668237824338,CSE 272,A00,102397,Li; Tzumao,0,0,0,0
1668237824760,CSE 274,A00,111323,Chern; Albert Ren-Haur,0,0,0,0
1668237825184,CSE 282,A00,102398,Pevzner; Pavel Arkadjevich,0,0,0,0
1668237825617,CSE 284,A00,114175,Gymrek; Melissa Ann,0,0,0,0
1668237826042,CSE 290,A00,102399,Chandraker; Manmohan Krishna,0,0,0,0
1668237826042,CSE 290,B00,102400,Vaccaro; Kristen Marie,0,0,25,25
1668237826042,CSE 290,C00,102414,Pannuto; Patrick William,0,0,25,25
1668237826042,CSE 290,D00,102427,Pevzner; Pavel Arkadjevich,0,0,0,0
1668237826042,CSE 290,E00,102429,Zhao; Jishen,0,0,0,0
1668237826042,CSE 290,F00,102436,Tullsen; Dean Michael,0,0,0,0
1668237826042,CSE 290,G00,102440,Christensen; Henrik I,0,0,20,20
1668237826469,CSE 291,A00,102443,Su; Hao,0,0,0,0
1668237826469,CSE 291,B00,102448,Polikarpova; Nadezhda,0,0,0,0
1668237826469,CSE 291,C00,102453,Vaccaro; Kristen Marie,0,0,0,0
1668237826469,CSE 291,D00,111343,Savage; Stefan,0,0,0,0
1668237826469,CSE 291,E00,116474,Claffy; Kimberly Claire,0,0,0,0
1668237826469,CSE 291,F00,116479,Pasquale; Joseph,0,0,0,0
1668237826898,CSE 293,001,119111,Bafna; Vineet,9999,0,9999,0
1668237826898,CSE 293,002,119118,Bellare; Mihir,9999,0,9999,0
1668237826898,CSE 293,003,119122,Berg-Kirkpatrick; Taylor D,9999,0,9999,0
1668237826898,CSE 293,004,119135,Christensen; Henrik I,9999,0,9999,0
1668237826898,CSE 293,005,119142,Cottrell; Garrison W,9999,0,9999,0
1668237826898,CSE 293,006,119146,Deutsch; Alin Bernard,9999,0,9999,0
1668237826898,CSE 293,007,119159,Esmaeilzadeh; Hadi,9999,0,9999,0
1668237826898,CSE 293,008,119166,Freund; Yoav,9999,0,9999,0
1668237826898,CSE 293,009,119170,Griswold; William G.,9999,0,9999,0
1668237826898,CSE 293,010,119183,Gymrek; Melissa Ann,9999,0,9999,0
1668237826898,CSE 293,011,119190,Heninger; Nadia A,9999,0,9999,0
1668237826898,CSE 293,012,119230,Impagliazzo; Russell,9999,0,9999,0
1668237826898,CSE 293,013,119232,Jhala; Ranjit,9999,0,9999,0
1668237826898,CSE 293,014,119233,Kahng; Andrew Byun,9999,0,9999,0
1668237826898,CSE 293,015,119298,Kane; Daniel Mertz,9999,0,9999,0
1668237826898,CSE 293,016,119299,Kriegman; David J,9999,0,9999,0
1668237826898,CSE 293,017,119300,Kumar; Arun Kumar,9999,0,9999,0
1668237826898,CSE 293,018,119301,Lerner; Sorin,9999,0,9999,0
1668237826898,CSE 293,019,119302,Lovett; Shachar,9999,0,9999,0
1668237826898,CSE 293,020,119303,McAuley; Julian John,9999,0,9999,0
1668237826898,CSE 293,021,119304,Micciancio; Daniele,9999,0,9999,0
1668237826898,CSE 293,022,119367,Orailoglu; Alex,9999,0,9999,0
1668237826898,CSE 293,023,119382,Paturi; Ramamohan,9999,0,9999,0
1668237826898,CSE 293,024,119404,Polikarpova; Nadezhda,9999,0,9999,0
1668237826898,CSE 293,025,119406,Politz; Joseph Gibbs,9999,0,9999,0
1668237826898,CSE 293,026,119411,Porter; George M,9999,0,9999,0
1668237826898,CSE 293,027,119414,Porter; Leonard Emerson,9999,0,9999,0
1668237826898,CSE 293,028,119416,Ramamoorthi; Ravi,9999,0,9999,0
1668237826898,CSE 293,029,119417,Sahoo; Debashis,9999,0,9999,0
1668237826898,CSE 293,030,119420,Saul; Lawrence,9999,0,9999,0
1668237826898,CSE 293,031,119421,Savage; Stefan,9999,0,9999,0
1668237826898,CSE 293,032,119425,Schulze; Jurgen P.,9999,0,9999,0
1668237826898,CSE 293,033,119426,Snoeren; Alex C.,9999,0,9999,0
1668237826898,CSE 293,034,119428,Shang; Jingbo,9999,0,9999,0
1668237826898,CSE 293,035,119430,Stefan; Deian,9999,0,9999,0
1668237826898,CSE 293,036,119431,Su; Hao,9999,0,9999,0
1668237826898,CSE 293,037,119433,Swanson; Steven James,9999,0,9999,0
1668237826898,CSE 293,038,119435,Tullsen; Dean Michael,9999,0,9999,0
1668237826898,CSE 293,039,119483,Voelker; Geoffrey M.,9999,0,9999,0
1668237826898,CSE 293,040,119537,Zhao; Jishen,9999,0,9999,0
1668237826898,CSE 293,041,119538,Zhou; Yuan-Yuan,9999,0,9999,0
1668237826898,CSE 293,042,119539,Gao; Sicun,9999,0,9999,0
1668237826898,CSE 293,043,119540,Weibel; Nadir,9999,0,9999,0
1668237826898,CSE 293,044,119541,Gupta; Rajesh K.,9999,0,9999,0
1668237826898,CSE 293,045,126410,Vaccaro; Kristen Marie,9999,0,9999,0
1668237826898,CSE 293,046,126411,Klemke; Richard,9999,0,9999,0
1668237827319,CSE 294,A00,102459,Voelker; Geoffrey M.,0,0,0,0
1668237827319,CSE 294,B00,111322,Orailoglu; Alex,0,0,0,0
1668237827750,DSE 201,A00,096914,Deutsch; Alin Bernard,30,0,30,0
1668237828172,DSE 210,A00,096915,Dasgupta; Sanjoy,30,0,30,0
1668237828595,DSE 260A,A00,096916,Altintas De Callaf; Ilkay,30,0,30,0
1668237829037,ECE 200,001,103586,Antipa; Nicholas A,9999,0,9999,0
1668237829037,ECE 200,002,103587,Atanasov; Nikolay A.,9999,0,9999,0
1668237829037,ECE 200,003,103588,Bharadia; Dinesh,9999,0,9999,0
1668237829037,ECE 200,004,103589,Cheng; Chung Kuan,9999,0,9999,0
1668237829037,ECE 200,005,103590,Cosman; Pamela C.,9999,0,9999,0
1668237829037,ECE 200,006,103591,Dayeh; Shadi Ahmad,9999,0,9999,0
1668237829037,ECE 200,007,103592,Fainman; Yeshaiahu,9999,0,9999,0
1668237829037,ECE 200,008,103593,Ford; Joseph Earl,9999,0,9999,0
1668237829037,ECE 200,009,103594,Franceschetti; Massimo,9999,0,9999,0
1668237829037,ECE 200,010,103595,Fullerton; Eric E,9999,0,9999,0
1668237829037,ECE 200,011,103596,Galton; Ian A,9999,0,9999,0
1668237829037,ECE 200,012,103597,Gilja; Vikash,9999,0,9999,0
1668237829037,ECE 200,013,103598,Hall; Drew A.,9999,0,9999,0
1668237829037,ECE 200,014,103599,Hsueh; Tzu-Chien,9999,0,9999,0
1668237829037,ECE 200,015,103600,Javidi; Tara,9999,0,9999,0
1668237829037,ECE 200,016,103601,Kahng; Andrew Byun,9999,0,9999,0
1668237829037,ECE 200,017,103602,Kim; Young-Han,9999,0,9999,0
1668237829037,ECE 200,018,103603,Koushanfar; Farinaz,9999,0,9999,0
1668237829037,ECE 200,019,103604,Kuzum; Duygu,9999,0,9999,0
1668237829037,ECE 200,020,103605,Le; Hanh-Phuc,9999,0,9999,0
1668237829037,ECE 200,021,103606,Lin; Bill,9999,0,9999,0
1668237829037,ECE 200,022,103607,Liu; Zhaowei,9998,0,9999,1
1668237829037,ECE 200,023,103608,Lo; Yu-Hwa,9999,0,9999,0
1668237829037,ECE 200,024,103609,Lomakin; Vitaliy,9999,0,9999,0
1668237829037,ECE 200,025,103610,Mercier; Patrick Philip,9999,0,9999,0
1668237829037,ECE 200,026,103611,Meyer; Florian,9999,0,9999,0
1668237829037,ECE 200,027,103612,Milstein; Laurence B.,9999,0,9999,0
1668237829037,ECE 200,028,103613,Mir Arabbaygi; Siavash,9999,0,9999,0
1668237829037,ECE 200,029,103614,Mookherjea; Shayan,9999,0,9999,0
1668237829037,ECE 200,030,103615,Morris; Karcher William,9999,0,9999,0
1668237829037,ECE 200,031,103616,Ng; Tse Nga,9999,0,9999,0
1668237829037,ECE 200,032,103617,Nguyen; Truong Quang,9999,0,9999,0
1668237829037,ECE 200,033,103618,Nomura; Kenji,9999,0,9999,0
1668237829037,ECE 200,034,103619,Orlitsky; Alon,9999,0,9999,0
1668237829037,ECE 200,035,103620,Pal; Piya,9999,0,9999,0
1668237829037,ECE 200,036,103621,Papen; George C.,9999,0,9999,0
1668237829037,ECE 200,037,103622,Radic; Stojan,9999,0,9999,0
1668237829037,ECE 200,038,103623,Rao; Bhaskar D.,9999,0,9999,0
1668237829037,ECE 200,039,103624,Rao; Ramesh R,9999,0,9999,0
1668237829037,ECE 200,040,103625,Rebeiz; Gabriel,9999,0,9999,0
1668237829037,ECE 200,041,103626,Sanford; John R,9999,0,9999,0
1668237829037,ECE 200,042,103627,Siegel; Paul H.,9999,0,9999,0
1668237829037,ECE 200,043,103628,Sievenpiper; Daniel F.,9999,0,9999,0
1668237829037,ECE 200,044,103629,Sworder; David D.,9999,0,9999,0
1668237829037,ECE 200,045,103630,Taur; Yuan,9999,0,9999,0
1668237829037,ECE 200,046,103631,Touri; Behrouz,9999,0,9999,0
1668237829037,ECE 200,047,103632,Trivedi; Mohan M.,9999,0,9999,0
1668237829037,ECE 200,048,103633,Vasconcelos; Nuno,9999,0,9999,0
1668237829037,ECE 200,049,103634,Wang; Xiaolong,9999,0,9999,0
1668237829037,ECE 200,050,103635,Xie; Pengtao,9999,0,9999,0
1668237829037,ECE 200,051,103636,Yip; Michael,9999,0,9999,0
1668237829037,ECE 200,052,103637,Zeger; Kenneth A.,999,0,999,0
1668237829037,ECE 200,053,103638,Zhang; Xinyu,9999,0,9999,0
1668237829037,ECE 200,054,103639,Turakhia; Yatish Girish,9999,0,9999,0
1668237829037,ECE 200,055,103640,Kang; Mingu,9999,0,9999,0
1668237829037,ECE 200,056,103641,Shi; Yuanyuan,9999,0,9999,0
1668237829037,ECE 200,057,103642,Wang; Edward Jay,9999,0,9999,0
1668237829037,ECE 200,058,103643,Zheng; Yang,9999,0,9999,0
1668237829461,ECE 202,A00,103644,Kuzum; Duygu,0,0,0,0
1668237829888,ECE 212BN,A00,103646,Ng; Tse Nga,0,0,0,0
1668237830313,ECE 221,A00,111493,Staff,0,0,0,0
1668237830737,ECE 222B,A00,103647,Lomakin; Vitaliy,0,0,0,0
1668237831161,ECE 230B,A00,103648,Taur; Yuan,0,0,0,0
1668237831590,ECE 238B,A00,103649,Garay; Javier,0,0,0,0
1668237832019,ECE 240B,A00,112900,Fainman; Yeshaiahu,0,0,0,0
1668237832446,ECE 247A,A00,103650,Jokerst; Jesse Vincent,0,0,0,0
1668237832871,ECE 247B,A00,103651,Wang; Joseph,0,0,0,0
1668237833305,ECE 250,A00,103652,Siegel; Paul H.,0,0,0,0
1668237833728,ECE 251A,A00,103654,Rao; Bhaskar D.,0,0,0,0
1668237834151,ECE 257B,A00,103655,Bharadia; Dinesh,0,0,0,0
1668237834578,ECE 258A,A00,103656,Milstein; Laurence B.,0,0,0,0
1668237835004,ECE 260B,A00,103658,Kang; Mingu,0,0,0,0
1668237835431,ECE 264A,A00,103659,Galton; Ian A,0,0,0,0
1668237835859,ECE 265A,A00,103661,Gudem; Prasad S.S.,0,0,0,0
1668237836282,ECE 265D,A00,103662,Gudem; Prasad S.S.,0,0,0,0
1668237836708,ECE 268,A00,103663,Koushanfar; Farinaz,0,0,0,0
1668237837133,ECE 269,A01,103665,Pal; Piya,0,0,0,0
1668237837557,ECE 271B,A00,103666,Vasconcelos; Manuela,0,0,0,0
1668237837997,ECE 276A,A00,103667,Atanasov; Nikolay A.,0,0,0,0
1668237838420,ECE 277,A00,103668,An; Cheolhong,0,0,0,0
1668237838850,ECE 279,A00,117947,Hall; Drew A.,0,0,0,0
1668237839701,ECE 283,A00,103670,Hsueh; Tzu-Chien,0,0,0,0
1668237840128,ECE 284,A00,103671,Turakhia; Yatish Girish,0,0,0,0
1668237840556,ECE 285,A00,103672,Zheng; Yang,0,0,0,0
1668237840556,ECE 285,B00,103673,Sworder; David D.,0,0,0,0
1668237840983,ECE 287,A00,103676,Javidi; Tara,0,0,0,0
1668237841417,MATH 200B,A00,098023,Salehi Golsefidy; Alireza,12,0,15,3
1668237841840,MATH 202B,A00,098024,Rhoades; Brendon Patrick,9,0,15,6
1668237842268,MATH 203B,A00,098025,Oprea; Dragos N.,10,0,15,5
1668237842692,MATH 204B,A00,098026,Sorensen; Claus M,13,0,15,2
1668237843118,MATH 208,A00,098027,Izadi; Elham,7,0,10,3
1668237843541,MATH 209,A00,098028,Pollack; Aaron,10,0,10,0
1668237843967,MATH 211A,A00,112919,Rogalski; Daniel,9,0,10,1
1668237844393,MATH 211B,A00,112920,Seward; Brandon M.,9,0,10,1
1668237844846,MATH 218,A00,098029,Li; Bo,10,0,10,0
1668237845271,MATH 220B,A00,098030,Novak; Jonathan I,11,0,15,4
1668237845698,MATH 221A,A00,098031,Ebenfelt; Peter F,13,0,15,2
1668237846121,MATH 231B,A00,098032,Zlatos; Andrej,12,0,15,3
1668237846557,MATH 240B,A00,098033,Ni; Lei,9,0,15,6
1668237846978,MATH 243,A00,098034,Jekel; David Andrew,10,0,10,0
1668237847405,MATH 245A,A00,098035,Nie; Jiawang,0,0,15,16
1668237847837,MATH 248,A00,098036,Bejenaru; Ioan,10,0,10,0
1668237848260,MATH 250B,A00,098037,Spolaor; Luca,14,0,15,1
1668237848690,MATH 258,A00,098038,Ni; Lei,10,0,10,0
1668237849127,MATH 264B,A00,098041,Rhoades; Brendon Patrick,9,0,15,6
1668237849552,MATH 268,A00,098042,Buss; Samuel R,10,0,10,0
1668237849978,MATH 269,A00,098043,Rhoades; Brendon Patrick,10,0,10,0
1668237850401,MATH 270B,A00,098044,Li; Bo,10,0,15,5
1668237850826,MATH 272B,A00,098045,Holst; Michael J,13,0,15,2
1668237851251,MATH 273A,A00,098046,Tian; Xiaochuan,10,0,15,5
1668237851675,MATH 275,A01,098048,Tian; Xiaochuan,6,0,10,4
1668237852108,MATH 278A,A00,098049,Holst; Michael J,8,0,10,2
1668237852536,MATH 278B,A00,098050,Cloninger; Alexander,10,0,10,0
1668237852961,MATH 278C,A00,098051,Nie; Jiawang,7,0,10,3
1668237853386,MATH 280B,A00,098052,Zheng; Tianyi,10,0,15,5
1668237853812,MATH 281B,A00,098053,Bradic; Jelena,1,0,15,14
1668237854236,MATH 282B,A00,098054,Arias-Castro; Ery,0,0,15,15
1668237854660,MATH 285,A00,098055,Fitzsimmons; Patrick J,0,0,15,17
1668237855084,MATH 287B,A00,098056,Arias-Castro; Ery,2,0,15,13
1668237855507,MATH 288,A00,098057,Agarwal; Pooja,9,0,10,1
1668237855507,MATH 288,B00,098058,Zhang; Danna,8,0,10,2
1668237855507,MATH 288,C00,098059,Williams; Ruth J,10,0,10,0
1668237855943,MATH 290B,A00,098060,Roberts; Justin Deritter,13,0,15,2
1668237856460,MATH 292,A00,098061,Belmont; Eva Kinoshita,10,0,10,0
1668237856893,MATH 295,A00,098062,Suk; Andrew Hoon,48,0,50,2
1668237857325,MATH 296,A00,098063,Novak; Jonathan I,20,0,20,0
1668237857760,MATH 297,001,098064,Gamst; Anthony Collins,9997,0,9999,2
1668238358857,COGS 205,A00,101395,Chiba; Andrea,19,0,20,1
1668238359295,COGS 210B,001,101404,Greene; Deanna Jacquelyn,9998,0,9999,1
1668238359295,COGS 210B,002,101417,Xia; Haijun,9999,0,9999,0
1668238359295,COGS 210B,003,101422,Nitz; Douglas A.,9999,0,9999,0
1668238359295,COGS 210B,004,101423,Hollan; James D.,9998,0,9999,1
1668238359295,COGS 210B,005,101424,Deak; Gedeon O.,9998,0,9999,1
1668238359295,COGS 210B,006,101425,Rossano; Federico,9999,0,9999,0
1668238359725,COGS 211B,A00,101427,Coulson; Seana M,9996,0,9999,3
1668238360172,COGS 220,A00,101428,Hollan; James D.,0,0,25,25
1668238360595,COGS 229,A00,101429,Dow; Steven P,18,0,25,7
1668238361022,COGS 230,A00,101430,Klemmer; Scott R,12,0,17,5
1668238361444,COGS 234,A00,101431,Xia; Haijun,2,0,25,23
1668238361871,COGS 260,A00,101432,Kiyonaga; Anastasia,21,0,25,4
1668238361871,COGS 260,B00,101433,Kirsh; David Joel,15,0,25,10
1668238362294,CSE 202,A00,102371,Impagliazzo; Russell,0,0,0,0
1668238362717,CSE 203B,A01,102373,Cheng; Chung Kuan,0,0,0,0
1668238363141,CSE 208,A00,102374,Micciancio; Daniele,0,0,0,0
1668238363568,CSE 209A,A00,112895,Impagliazzo; Russell,0,0,15,15
1668238363994,CSE 209B,A00,108005,Bellare; Mihir,0,0,0,0
1668238364433,CSE 210,A00,113163,Coblenz; Michael J,0,0,0,0
1668238364858,CSE 219,A00,106111,Dow; Steven P,0,0,20,20
1668238365280,CSE 221,A00,102376,Voelker; Geoffrey M.,0,0,0,0
1668238365706,CSE 224,A01,102378,Porter; George M,0,0,0,0
1668238366133,CSE 229A,A00,102379,Savage; Stefan,0,0,0,0
1668238366557,CSE 229C,A00,102380,Munyaka; Imani N. S.,0,0,0,0
1668238366981,CSE 232B,A00,102382,Deutsch; Alin Bernard,0,0,0,0
1668238367407,CSE 234,A01,112904,Kumar; Arun Kumar,0,0,0,0
1668238367831,CSE 237A,A00,102383,Rosing; Tajana Simunic,0,0,0,0
1668238368255,CSE 239A,A00,102384,Deutsch; Alin Bernard,0,0,0,0
1668238368678,CSE 239B,A00,102385,Polikarpova; Nadezhda,0,0,0,0
1668238369116,CSE 240A,A00,102386,Pannuto; Patrick William,0,0,0,0
1668238369544,CSE 240B,A00,102387,Zhao; Jishen,0,0,0,0
1668238369968,CSE 241A,A00,106406,Kang; Mingu,0,0,0,0
1668238370402,CSE 249B,A00,102388,Kahng; Andrew Byun,0,0,8,8
1668238370829,CSE 251B,A01,102392,Cottrell; Garrison W,0,0,0,0
1668238370829,CSE 251B,A02,102393,Cottrell; Garrison W,0,0,0,0
1668238371257,CSE 252B,A00,102394,Ochoa; Benjamin Lawrence,0,0,0,0
1668238371683,CSE 257,A01,102396,Gao; Sicun,0,0,0,0
1668238372105,CSE 272,A00,102397,Li; Tzumao,0,0,0,0
1668238372526,CSE 274,A00,111323,Chern; Albert Ren-Haur,0,0,0,0
1668238372950,CSE 282,A00,102398,Pevzner; Pavel Arkadjevich,0,0,0,0
1668238373374,CSE 284,A00,114175,Gymrek; Melissa Ann,0,0,0,0
1668238373803,CSE 290,A00,102399,Chandraker; Manmohan Krishna,0,0,0,0
1668238373803,CSE 290,B00,102400,Vaccaro; Kristen Marie,0,0,25,25
1668238373803,CSE 290,C00,102414,Pannuto; Patrick William,0,0,25,25
1668238373803,CSE 290,D00,102427,Pevzner; Pavel Arkadjevich,0,0,0,0
1668238373803,CSE 290,E00,102429,Zhao; Jishen,0,0,0,0
1668238373803,CSE 290,F00,102436,Tullsen; Dean Michael,0,0,0,0
1668238373803,CSE 290,G00,102440,Christensen; Henrik I,0,0,20,20
1668238374231,CSE 291,A00,102443,Su; Hao,0,0,0,0
1668238374231,CSE 291,B00,102448,Polikarpova; Nadezhda,0,0,0,0
1668238374231,CSE 291,C00,102453,Vaccaro; Kristen Marie,0,0,0,0
1668238374231,CSE 291,D00,111343,Savage; Stefan,0,0,0,0
1668238374231,CSE 291,E00,116474,Claffy; Kimberly Claire,0,0,0,0
1668238374231,CSE 291,F00,116479,Pasquale; Joseph,0,0,0,0
1668238374656,CSE 293,001,119111,Bafna; Vineet,9999,0,9999,0
1668238374656,CSE 293,002,119118,Bellare; Mihir,9999,0,9999,0
1668238374656,CSE 293,003,119122,Berg-Kirkpatrick; Taylor D,9999,0,9999,0
1668238374656,CSE 293,004,119135,Christensen; Henrik I,9999,0,9999,0
1668238374656,CSE 293,005,119142,Cottrell; Garrison W,9999,0,9999,0
1668238374656,CSE 293,006,119146,Deutsch; Alin Bernard,9999,0,9999,0
1668238374656,CSE 293,007,119159,Esmaeilzadeh; Hadi,9999,0,9999,0
1668238374656,CSE 293,008,119166,Freund; Yoav,9999,0,9999,0
1668238374656,CSE 293,009,119170,Griswold; William G.,9999,0,9999,0
1668238374656,CSE 293,010,119183,Gymrek; Melissa Ann,9999,0,9999,0
1668238374656,CSE 293,011,119190,Heninger; Nadia A,9999,0,9999,0
1668238374656,CSE 293,012,119230,Impagliazzo; Russell,9999,0,9999,0
1668238374656,CSE 293,013,119232,Jhala; Ranjit,9999,0,9999,0
1668238374656,CSE 293,014,119233,Kahng; Andrew Byun,9999,0,9999,0
1668238374656,CSE 293,015,119298,Kane; Daniel Mertz,9999,0,9999,0
1668238374656,CSE 293,016,119299,Kriegman; David J,9999,0,9999,0
1668238374656,CSE 293,017,119300,Kumar; Arun Kumar,9999,0,9999,0
1668238374656,CSE 293,018,119301,Lerner; Sorin,9999,0,9999,0
1668238374656,CSE 293,019,119302,Lovett; Shachar,9999,0,9999,0
1668238374656,CSE 293,020,119303,McAuley; Julian John,9999,0,9999,0
1668238374656,CSE 293,021,119304,Micciancio; Daniele,9999,0,9999,0
1668238374656,CSE 293,022,119367,Orailoglu; Alex,9999,0,9999,0
1668238374656,CSE 293,023,119382,Paturi; Ramamohan,9999,0,9999,0
1668238374656,CSE 293,024,119404,Polikarpova; Nadezhda,9999,0,9999,0
1668238374656,CSE 293,025,119406,Politz; Joseph Gibbs,9999,0,9999,0
1668238374656,CSE 293,026,119411,Porter; George M,9999,0,9999,0
1668238374656,CSE 293,027,119414,Porter; Leonard Emerson,9999,0,9999,0
1668238374656,CSE 293,028,119416,Ramamoorthi; Ravi,9999,0,9999,0
1668238374656,CSE 293,029,119417,Sahoo; Debashis,9999,0,9999,0
1668238374656,CSE 293,030,119420,Saul; Lawrence,9999,0,9999,0
1668238374656,CSE 293,031,119421,Savage; Stefan,9999,0,9999,0
1668238374656,CSE 293,032,119425,Schulze; Jurgen P.,9999,0,9999,0
1668238374656,CSE 293,033,119426,Snoeren; Alex C.,9999,0,9999,0
1668238374656,CSE 293,034,119428,Shang; Jingbo,9999,0,9999,0
1668238374656,CSE 293,035,119430,Stefan; Deian,9999,0,9999,0
1668238374656,CSE 293,036,119431,Su; Hao,9999,0,9999,0
1668238374656,CSE 293,037,119433,Swanson; Steven James,9999,0,9999,0
1668238374656,CSE 293,038,119435,Tullsen; Dean Michael,9999,0,9999,0
1668238374656,CSE 293,039,119483,Voelker; Geoffrey M.,9999,0,9999,0
1668238374656,CSE 293,040,119537,Zhao; Jishen,9999,0,9999,0
1668238374656,CSE 293,041,119538,Zhou; Yuan-Yuan,9999,0,9999,0
1668238374656,CSE 293,042,119539,Gao; Sicun,9999,0,9999,0
1668238374656,CSE 293,043,119540,Weibel; Nadir,9999,0,9999,0
1668238374656,CSE 293,044,119541,Gupta; Rajesh K.,9999,0,9999,0
1668238374656,CSE 293,045,126410,Vaccaro; Kristen Marie,9999,0,9999,0
1668238374656,CSE 293,046,126411,Klemke; Richard,9999,0,9999,0
1668238375082,CSE 294,A00,102459,Voelker; Geoffrey M.,0,0,0,0
1668238375082,CSE 294,B00,111322,Orailoglu; Alex,0,0,0,0
1668238375506,DSE 201,A00,096914,Deutsch; Alin Bernard,30,0,30,0
1668238375931,DSE 210,A00,096915,Dasgupta; Sanjoy,30,0,30,0
1668238376357,DSE 260A,A00,096916,Altintas De Callaf; Ilkay,30,0,30,0
1668238376798,ECE 200,001,103586,Antipa; Nicholas A,9999,0,9999,0
1668238376798,ECE 200,002,103587,Atanasov; Nikolay A.,9999,0,9999,0
1668238376798,ECE 200,003,103588,Bharadia; Dinesh,9999,0,9999,0
1668238376798,ECE 200,004,103589,Cheng; Chung Kuan,9999,0,9999,0
1668238376798,ECE 200,005,103590,Cosman; Pamela C.,9999,0,9999,0
1668238376798,ECE 200,006,103591,Dayeh; Shadi Ahmad,9999,0,9999,0
1668238376798,ECE 200,007,103592,Fainman; Yeshaiahu,9999,0,9999,0
1668238376798,ECE 200,008,103593,Ford; Joseph Earl,9999,0,9999,0
1668238376798,ECE 200,009,103594,Franceschetti; Massimo,9999,0,9999,0
1668238376798,ECE 200,010,103595,Fullerton; Eric E,9999,0,9999,0
1668238376798,ECE 200,011,103596,Galton; Ian A,9999,0,9999,0
1668238376798,ECE 200,012,103597,Gilja; Vikash,9999,0,9999,0
1668238376798,ECE 200,013,103598,Hall; Drew A.,9999,0,9999,0
1668238376798,ECE 200,014,103599,Hsueh; Tzu-Chien,9999,0,9999,0
1668238376798,ECE 200,015,103600,Javidi; Tara,9999,0,9999,0
1668238376798,ECE 200,016,103601,Kahng; Andrew Byun,9999,0,9999,0
1668238376798,ECE 200,017,103602,Kim; Young-Han,9999,0,9999,0
1668238376798,ECE 200,018,103603,Koushanfar; Farinaz,9999,0,9999,0
1668238376798,ECE 200,019,103604,Kuzum; Duygu,9999,0,9999,0
1668238376798,ECE 200,020,103605,Le; Hanh-Phuc,9999,0,9999,0
1668238376798,ECE 200,021,103606,Lin; Bill,9999,0,9999,0
1668238376798,ECE 200,022,103607,Liu; Zhaowei,9998,0,9999,1
1668238376798,ECE 200,023,103608,Lo; Yu-Hwa,9999,0,9999,0
1668238376798,ECE 200,024,103609,Lomakin; Vitaliy,9999,0,9999,0
1668238376798,ECE 200,025,103610,Mercier; Patrick Philip,9999,0,9999,0
1668238376798,ECE 200,026,103611,Meyer; Florian,9999,0,9999,0
1668238376798,ECE 200,027,103612,Milstein; Laurence B.,9999,0,9999,0
1668238376798,ECE 200,028,103613,Mir Arabbaygi; Siavash,9999,0,9999,0
1668238376798,ECE 200,029,103614,Mookherjea; Shayan,9999,0,9999,0
1668238376798,ECE 200,030,103615,Morris; Karcher William,9999,0,9999,0
1668238376798,ECE 200,031,103616,Ng; Tse Nga,9999,0,9999,0
1668238376798,ECE 200,032,103617,Nguyen; Truong Quang,9999,0,9999,0
1668238376798,ECE 200,033,103618,Nomura; Kenji,9999,0,9999,0
1668238376798,ECE 200,034,103619,Orlitsky; Alon,9999,0,9999,0
1668238376798,ECE 200,035,103620,Pal; Piya,9999,0,9999,0
1668238376798,ECE 200,036,103621,Papen; George C.,9999,0,9999,0
1668238376798,ECE 200,037,103622,Radic; Stojan,9999,0,9999,0
1668238376798,ECE 200,038,103623,Rao; Bhaskar D.,9999,0,9999,0
1668238376798,ECE 200,039,103624,Rao; Ramesh R,9999,0,9999,0
1668238376798,ECE 200,040,103625,Rebeiz; Gabriel,9999,0,9999,0
1668238376798,ECE 200,041,103626,Sanford; John R,9999,0,9999,0
1668238376798,ECE 200,042,103627,Siegel; Paul H.,9999,0,9999,0
1668238376798,ECE 200,043,103628,Sievenpiper; Daniel F.,9999,0,9999,0
1668238376798,ECE 200,044,103629,Sworder; David D.,9999,0,9999,0
1668238376798,ECE 200,045,103630,Taur; Yuan,9999,0,9999,0
1668238376798,ECE 200,046,103631,Touri; Behrouz,9999,0,9999,0
1668238376798,ECE 200,047,103632,Trivedi; Mohan M.,9999,0,9999,0
1668238376798,ECE 200,048,103633,Vasconcelos; Nuno,9999,0,9999,0
1668238376798,ECE 200,049,103634,Wang; Xiaolong,9999,0,9999,0
1668238376798,ECE 200,050,103635,Xie; Pengtao,9999,0,9999,0
1668238376798,ECE 200,051,103636,Yip; Michael,9999,0,9999,0
1668238376798,ECE 200,052,103637,Zeger; Kenneth A.,999,0,999,0
1668238376798,ECE 200,053,103638,Zhang; Xinyu,9999,0,9999,0
1668238376798,ECE 200,054,103639,Turakhia; Yatish Girish,9999,0,9999,0
1668238376798,ECE 200,055,103640,Kang; Mingu,9999,0,9999,0
1668238376798,ECE 200,056,103641,Shi; Yuanyuan,9999,0,9999,0
1668238376798,ECE 200,057,103642,Wang; Edward Jay,9999,0,9999,0
1668238376798,ECE 200,058,103643,Zheng; Yang,9999,0,9999,0
1668238377227,ECE 202,A00,103644,Kuzum; Duygu,0,0,0,0
1668238377733,ECE 212BN,A00,103646,Ng; Tse Nga,0,0,0,0
1668238378156,ECE 221,A00,111493,Staff,0,0,0,0
1668238378578,ECE 222B,A00,103647,Lomakin; Vitaliy,0,0,0,0
1668238379006,ECE 230B,A00,103648,Taur; Yuan,0,0,0,0
1668238379435,ECE 238B,A00,103649,Garay; Javier,0,0,0,0
1668238379865,ECE 240B,A00,112900,Fainman; Yeshaiahu,0,0,0,0
1668238380314,ECE 247A,A00,103650,Jokerst; Jesse Vincent,0,0,0,0
1668238380737,ECE 247B,A00,103651,Wang; Joseph,0,0,0,0
1668238381165,ECE 250,A00,103652,Siegel; Paul H.,0,0,0,0
1668238381587,ECE 251A,A00,103654,Rao; Bhaskar D.,0,0,0,0
1668238382021,ECE 257B,A00,103655,Bharadia; Dinesh,0,0,0,0
1668238382445,ECE 258A,A00,103656,Milstein; Laurence B.,0,0,0,0
1668238382876,ECE 260B,A00,103658,Kang; Mingu,0,0,0,0
1668238383299,ECE 264A,A00,103659,Galton; Ian A,0,0,0,0
1668238383723,ECE 265A,A00,103661,Gudem; Prasad S.S.,0,0,0,0
1668238384150,ECE 265D,A00,103662,Gudem; Prasad S.S.,0,0,0,0
1668238384577,ECE 268,A00,103663,Koushanfar; Farinaz,0,0,0,0
1668238385009,ECE 269,A01,103665,Pal; Piya,0,0,0,0
1668238385433,ECE 271B,A00,103666,Vasconcelos; Manuela,0,0,0,0
1668238385881,ECE 276A,A00,103667,Atanasov; Nikolay A.,0,0,0,0
1668238386310,ECE 277,A00,103668,An; Cheolhong,0,0,0,0
1668238386755,ECE 279,A00,117947,Hall; Drew A.,0,0,0,0
1668238387619,ECE 283,A00,103670,Hsueh; Tzu-Chien,0,0,0,0
1668238388057,ECE 284,A00,103671,Turakhia; Yatish Girish,0,0,0,0
1668238388490,ECE 285,A00,103672,Zheng; Yang,0,0,0,0
1668238388490,ECE 285,B00,103673,Sworder; David D.,0,0,0,0
1668238388944,ECE 287,A00,103676,Javidi; Tara,0,0,0,0
1668238389373,MATH 200B,A00,098023,Salehi Golsefidy; Alireza,12,0,15,3
1668238389805,MATH 202B,A00,098024,Rhoades; Brendon Patrick,9,0,15,6
1668238390229,MATH 203B,A00,098025,Oprea; Dragos N.,10,0,15,5
1668238390656,MATH 204B,A00,098026,Sorensen; Claus M,13,0,15,2
1668238391078,MATH 208,A00,098027,Izadi; Elham,7,0,10,3
1668238391501,MATH 209,A00,098028,Pollack; Aaron,10,0,10,0
1668238391924,MATH 211A,A00,112919,Rogalski; Daniel,9,0,10,1
1668238392350,MATH 211B,A00,112920,Seward; Brandon M.,9,0,10,1
1668238392774,MATH 218,A00,098029,Li; Bo,10,0,10,0
1668238393199,MATH 220B,A00,098030,Novak; Jonathan I,11,0,15,4
1668238393622,MATH 221A,A00,098031,Ebenfelt; Peter F,13,0,15,2
1668238394049,MATH 231B,A00,098032,Zlatos; Andrej,12,0,15,3
1668238394475,MATH 240B,A00,098033,Ni; Lei,9,0,15,6
1668238394901,MATH 243,A00,098034,Jekel; David Andrew,10,0,10,0
1668238395326,MATH 245A,A00,098035,Nie; Jiawang,0,0,15,16
1668238395748,MATH 248,A00,098036,Bejenaru; Ioan,10,0,10,0
1668238396174,MATH 250B,A00,098037,Spolaor; Luca,14,0,15,1
1668238396607,MATH 258,A00,098038,Ni; Lei,10,0,10,0
1668238397043,MATH 264B,A00,098041,Rhoades; Brendon Patrick,9,0,15,6
1668238397470,MATH 268,A00,098042,Buss; Samuel R,10,0,10,0
1668238397905,MATH 269,A00,098043,Rhoades; Brendon Patrick,10,0,10,0
1668238398334,MATH 270B,A00,098044,Li; Bo,10,0,15,5
1668238398759,MATH 272B,A00,098045,Holst; Michael J,13,0,15,2
1668238399188,MATH 273A,A00,098046,Tian; Xiaochuan,10,0,15,5
1668238399616,MATH 275,A01,098048,Tian; Xiaochuan,6,0,10,4
1668238400041,MATH 278A,A00,098049,Holst; Michael J,8,0,10,2
1668238400478,MATH 278B,A00,098050,Cloninger; Alexander,10,0,10,0
1668238400908,MATH 278C,A00,098051,Nie; Jiawang,7,0,10,3
1668238401340,MATH 280B,A00,098052,Zheng; Tianyi,10,0,15,5
1668238401768,MATH 281B,A00,098053,Bradic; Jelena,1,0,15,14
1668238402196,MATH 282B,A00,098054,Arias-Castro; Ery,0,0,15,15
1668238402619,MATH 285,A00,098055,Fitzsimmons; Patrick J,0,0,15,17
1668238403044,MATH 287B,A00,098056,Arias-Castro; Ery,2,0,15,13
1668238403469,MATH 288,A00,098057,Agarwal; Pooja,9,0,10,1
1668238403469,MATH 288,B00,098058,Zhang; Danna,8,0,10,2
1668238403469,MATH 288,C00,098059,Williams; Ruth J,10,0,10,0
1668238403904,MATH 290B,A00,098060,Roberts; Justin Deritter,13,0,15,2
1668238404328,MATH 292,A00,098061,Belmont; Eva Kinoshita,10,0,10,0
1668238404754,MATH 295,A00,098062,Suk; Andrew Hoon,48,0,50,2
1668238405180,MATH 296,A00,098063,Novak; Jonathan I,20,0,20,0
1668238405605,MATH 297,001,098064,Gamst; Anthony Collins,9997,0,9999,2
1668238906206,COGS 205,A00,101395,Chiba; Andrea,19,0,20,1
1668238906636,COGS 210B,001,101404,Greene; Deanna Jacquelyn,9998,0,9999,1
1668238906636,COGS 210B,002,101417,Xia; Haijun,9999,0,9999,0
1668238906636,COGS 210B,003,101422,Nitz; Douglas A.,9999,0,9999,0
1668238906636,COGS 210B,004,101423,Hollan; James D.,9998,0,9999,1
1668238906636,COGS 210B,005,101424,Deak; Gedeon O.,9998,0,9999,1
1668238906636,COGS 210B,006,101425,Rossano; Federico,9999,0,9999,0
1668238907063,COGS 211B,A00,101427,Coulson; Seana M,9996,0,9999,3
1668238907493,COGS 220,A00,101428,Hollan; James D.,0,0,25,25
1668238907920,COGS 229,A00,101429,Dow; Steven P,18,0,25,7
1668238908352,COGS 230,A00,101430,Klemmer; Scott R,12,0,17,5
1668238908776,COGS 234,A00,101431,Xia; Haijun,2,0,25,23
1668238909205,COGS 260,A00,101432,Kiyonaga; Anastasia,21,0,25,4
1668238909205,COGS 260,B00,101433,Kirsh; David Joel,15,0,25,10
1668238909646,CSE 202,A00,102371,Impagliazzo; Russell,0,0,0,0
1668238910075,CSE 203B,A01,102373,Cheng; Chung Kuan,0,0,0,0
1668238910503,CSE 208,A00,102374,Micciancio; Daniele,0,0,0,0
1668238910929,CSE 209A,A00,112895,Impagliazzo; Russell,0,0,15,15
1668238911356,CSE 209B,A00,108005,Bellare; Mihir,0,0,0,0
1668238911778,CSE 210,A00,113163,Coblenz; Michael J,0,0,0,0
1668238912203,CSE 219,A00,106111,Dow; Steven P,0,0,20,20
1668238912629,CSE 221,A00,102376,Voelker; Geoffrey M.,0,0,0,0
1668238913055,CSE 224,A01,102378,Porter; George M,0,0,0,0
1668238913481,CSE 229A,A00,102379,Savage; Stefan,0,0,0,0
1668238913905,CSE 229C,A00,102380,Munyaka; Imani N. S.,0,0,0,0
1668238914329,CSE 232B,A00,102382,Deutsch; Alin Bernard,0,0,0,0
1668238914755,CSE 234,A01,112904,Kumar; Arun Kumar,0,0,0,0
1668238933333,CSE 237A,A00,102383,Rosing; Tajana Simunic,0,0,0,0
1668238933758,CSE 239A,A00,102384,Deutsch; Alin Bernard,0,0,0,0
1668238934186,CSE 239B,A00,102385,Polikarpova; Nadezhda,0,0,0,0
1668238934615,CSE 240A,A00,102386,Pannuto; Patrick William,0,0,0,0
1668238935053,CSE 240B,A00,102387,Zhao; Jishen,0,0,0,0
1668238935491,CSE 241A,A00,106406,Kang; Mingu,0,0,0,0
1668238935917,CSE 249B,A00,102388,Kahng; Andrew Byun,0,0,8,8
1668238936355,CSE 251B,A01,102392,Cottrell; Garrison W,0,0,0,0
1668238936355,CSE 251B,A02,102393,Cottrell; Garrison W,0,0,0,0
1668238936785,CSE 252B,A00,102394,Ochoa; Benjamin Lawrence,0,0,0,0
1668238937211,CSE 257,A01,102396,Gao; Sicun,0,0,0,0
1668238937634,CSE 272,A00,102397,Li; Tzumao,0,0,0,0
1668238938061,CSE 274,A00,111323,Chern; Albert Ren-Haur,0,0,0,0
1668238938488,CSE 282,A00,102398,Pevzner; Pavel Arkadjevich,0,0,0,0
1668238938911,CSE 284,A00,114175,Gymrek; Melissa Ann,0,0,0,0
1668238939338,CSE 290,A00,102399,Chandraker; Manmohan Krishna,0,0,0,0
1668238939338,CSE 290,B00,102400,Vaccaro; Kristen Marie,0,0,25,25
1668238939338,CSE 290,C00,102414,Pannuto; Patrick William,0,0,25,25
1668238939338,CSE 290,D00,102427,Pevzner; Pavel Arkadjevich,0,0,0,0
1668238939338,CSE 290,E00,102429,Zhao; Jishen,0,0,0,0
1668238939338,CSE 290,F00,102436,Tullsen; Dean Michael,0,0,0,0
1668238939338,CSE 290,G00,102440,Christensen; Henrik I,0,0,20,20
1668238939767,CSE 291,A00,102443,Su; Hao,0,0,0,0
1668238939767,CSE 291,B00,102448,Polikarpova; Nadezhda,0,0,0,0
1668238939767,CSE 291,C00,102453,Vaccaro; Kristen Marie,0,0,0,0
1668238939767,CSE 291,D00,111343,Savage; Stefan,0,0,0,0
1668238939767,CSE 291,E00,116474,Claffy; Kimberly Claire,0,0,0,0
1668238939767,CSE 291,F00,116479,Pasquale; Joseph,0,0,0,0
1668238940202,CSE 293,001,119111,Bafna; Vineet,9999,0,9999,0
1668238940202,CSE 293,002,119118,Bellare; Mihir,9999,0,9999,0
1668238940202,CSE 293,003,119122,Berg-Kirkpatrick; Taylor D,9999,0,9999,0
1668238940202,CSE 293,004,119135,Christensen; Henrik I,9999,0,9999,0
1668238940202,CSE 293,005,119142,Cottrell; Garrison W,9999,0,9999,0
1668238940202,CSE 293,006,119146,Deutsch; Alin Bernard,9999,0,9999,0
1668238940202,CSE 293,007,119159,Esmaeilzadeh; Hadi,9999,0,9999,0
1668238940202,CSE 293,008,119166,Freund; Yoav,9999,0,9999,0
1668238940202,CSE 293,009,119170,Griswold; William G.,9999,0,9999,0
1668238940202,CSE 293,010,119183,Gymrek; Melissa Ann,9999,0,9999,0
1668238940202,CSE 293,011,119190,Heninger; Nadia A,9999,0,9999,0
1668238940202,CSE 293,012,119230,Impagliazzo; Russell,9999,0,9999,0
1668238940202,CSE 293,013,119232,Jhala; Ranjit,9999,0,9999,0
1668238940202,CSE 293,014,119233,Kahng; Andrew Byun,9999,0,9999,0
1668238940202,CSE 293,015,119298,Kane; Daniel Mertz,9999,0,9999,0
1668238940202,CSE 293,016,119299,Kriegman; David J,9999,0,9999,0
1668238940202,CSE 293,017,119300,Kumar; Arun Kumar,9999,0,9999,0
1668238940202,CSE 293,018,119301,Lerner; Sorin,9999,0,9999,0
1668238940202,CSE 293,019,119302,Lovett; Shachar,9999,0,9999,0
1668238940202,CSE 293,020,119303,McAuley; Julian John,9999,0,9999,0
1668238940202,CSE 293,021,119304,Micciancio; Daniele,9999,0,9999,0
1668238940202,CSE 293,022,119367,Orailoglu; Alex,9999,0,9999,0
1668238940202,CSE 293,023,119382,Paturi; Ramamohan,9999,0,9999,0
1668238940202,CSE 293,024,119404,Polikarpova; Nadezhda,9999,0,9999,0
1668238940202,CSE 293,025,119406,Politz; Joseph Gibbs,9999,0,9999,0
1668238940202,CSE 293,026,119411,Porter; George M,9999,0,9999,0
1668238940202,CSE 293,027,119414,Porter; Leonard Emerson,9999,0,9999,0
1668238940202,CSE 293,028,119416,Ramamoorthi; Ravi,9999,0,9999,0
1668238940202,CSE 293,029,119417,Sahoo; Debashis,9999,0,9999,0
1668238940202,CSE 293,030,119420,Saul; Lawrence,9999,0,9999,0
1668238940202,CSE 293,031,119421,Savage; Stefan,9999,0,9999,0
1668238940202,CSE 293,032,119425,Schulze; Jurgen P.,9999,0,9999,0
1668238940202,CSE 293,033,119426,Snoeren; Alex C.,9999,0,9999,0
1668238940202,CSE 293,034,119428,Shang; Jingbo,9999,0,9999,0
1668238940202,CSE 293,035,119430,Stefan; Deian,9999,0,9999,0
1668238940202,CSE 293,036,119431,Su; Hao,9999,0,9999,0
1668238940202,CSE 293,037,119433,Swanson; Steven James,9999,0,9999,0
1668238940202,CSE 293,038,119435,Tullsen; Dean Michael,9999,0,9999,0
1668238940202,CSE 293,039,119483,Voelker; Geoffrey M.,9999,0,9999,0
1668238940202,CSE 293,040,119537,Zhao; Jishen,9999,0,9999,0
1668238940202,CSE 293,041,119538,Zhou; Yuan-Yuan,9999,0,9999,0
1668238940202,CSE 293,042,119539,Gao; Sicun,9999,0,9999,0
1668238940202,CSE 293,043,119540,Weibel; Nadir,9999,0,9999,0
1668238940202,CSE 293,044,119541,Gupta; Rajesh K.,9999,0,9999,0
1668238940202,CSE 293,045,126410,Vaccaro; Kristen Marie,9999,0,9999,0
1668238940202,CSE 293,046,126411,Klemke; Richard,9999,0,9999,0
1668238940627,CSE 294,A00,102459,Voelker; Geoffrey M.,0,0,0,0
1668238940627,CSE 294,B00,111322,Orailoglu; Alex,0,0,0,0
1668238941052,DSE 201,A00,096914,Deutsch; Alin Bernard,30,0,30,0
1668238941481,DSE 210,A00,096915,Dasgupta; Sanjoy,30,0,30,0
1668238941905,DSE 260A,A00,096916,Altintas De Callaf; Ilkay,30,0,30,0
1668238942345,ECE 200,001,103586,Antipa; Nicholas A,9999,0,9999,0
1668238942345,ECE 200,002,103587,Atanasov; Nikolay A.,9999,0,9999,0
1668238942345,ECE 200,003,103588,Bharadia; Dinesh,9999,0,9999,0
1668238942345,ECE 200,004,103589,Cheng; Chung Kuan,9999,0,9999,0
1668238942345,ECE 200,005,103590,Cosman; Pamela C.,9999,0,9999,0
1668238942345,ECE 200,006,103591,Dayeh; Shadi Ahmad,9999,0,9999,0
1668238942345,ECE 200,007,103592,Fainman; Yeshaiahu,9999,0,9999,0
1668238942345,ECE 200,008,103593,Ford; Joseph Earl,9999,0,9999,0
1668238942345,ECE 200,009,103594,Franceschetti; Massimo,9999,0,9999,0
1668238942345,ECE 200,010,103595,Fullerton; Eric E,9999,0,9999,0
1668238942345,ECE 200,011,103596,Galton; Ian A,9999,0,9999,0
1668238942345,ECE 200,012,103597,Gilja; Vikash,9999,0,9999,0
1668238942345,ECE 200,013,103598,Hall; Drew A.,9999,0,9999,0
1668238942345,ECE 200,014,103599,Hsueh; Tzu-Chien,9999,0,9999,0
1668238942345,ECE 200,015,103600,Javidi; Tara,9999,0,9999,0
1668238942345,ECE 200,016,103601,Kahng; Andrew Byun,9999,0,9999,0
1668238942345,ECE 200,017,103602,Kim; Young-Han,9999,0,9999,0
1668238942345,ECE 200,018,103603,Koushanfar; Farinaz,9999,0,9999,0
1668238942345,ECE 200,019,103604,Kuzum; Duygu,9999,0,9999,0
1668238942345,ECE 200,020,103605,Le; Hanh-Phuc,9999,0,9999,0
1668238942345,ECE 200,021,103606,Lin; Bill,9999,0,9999,0
1668238942345,ECE 200,022,103607,Liu; Zhaowei,9998,0,9999,1
1668238942345,ECE 200,023,103608,Lo; Yu-Hwa,9999,0,9999,0
1668238942345,ECE 200,024,103609,Lomakin; Vitaliy,9999,0,9999,0
1668238942345,ECE 200,025,103610,Mercier; Patrick Philip,9999,0,9999,0
1668238942345,ECE 200,026,103611,Meyer; Florian,9999,0,9999,0
1668238942345,ECE 200,027,103612,Milstein; Laurence B.,9999,0,9999,0
1668238942345,ECE 200,028,103613,Mir Arabbaygi; Siavash,9999,0,9999,0
1668238942345,ECE 200,029,103614,Mookherjea; Shayan,9999,0,9999,0
1668238942345,ECE 200,030,103615,Morris; Karcher William,9999,0,9999,0
1668238942345,ECE 200,031,103616,Ng; Tse Nga,9999,0,9999,0
1668238942345,ECE 200,032,103617,Nguyen; Truong Quang,9999,0,9999,0
1668238942345,ECE 200,033,103618,Nomura; Kenji,9999,0,9999,0
1668238942345,ECE 200,034,103619,Orlitsky; Alon,9999,0,9999,0
1668238942345,ECE 200,035,103620,Pal; Piya,9999,0,9999,0
1668238942345,ECE 200,036,103621,Papen; George C.,9999,0,9999,0
1668238942345,ECE 200,037,103622,Radic; Stojan,9999,0,9999,0
1668238942345,ECE 200,038,103623,Rao; Bhaskar D.,9999,0,9999,0
1668238942345,ECE 200,039,103624,Rao; Ramesh R,9999,0,9999,0
1668238942345,ECE 200,040,103625,Rebeiz; Gabriel,9999,0,9999,0
1668238942345,ECE 200,041,103626,Sanford; John R,9999,0,9999,0
1668238942345,ECE 200,042,103627,Siegel; Paul H.,9999,0,9999,0
1668238942345,ECE 200,043,103628,Sievenpiper; Daniel F.,9999,0,9999,0
1668238942345,ECE 200,044,103629,Sworder; David D.,9999,0,9999,0
1668238942345,ECE 200,045,103630,Taur; Yuan,9999,0,9999,0
1668238942345,ECE 200,046,103631,Touri; Behrouz,9999,0,9999,0
1668238942345,ECE 200,047,103632,Trivedi; Mohan M.,9999,0,9999,0
1668238942345,ECE 200,048,103633,Vasconcelos; Nuno,9999,0,9999,0
1668238942345,ECE 200,049,103634,Wang; Xiaolong,9999,0,9999,0
1668238942345,ECE 200,050,103635,Xie; Pengtao,9999,0,9999,0
1668238942345,ECE 200,051,103636,Yip; Michael,9999,0,9999,0
1668238942345,ECE 200,052,103637,Zeger; Kenneth A.,999,0,999,0
1668238942345,ECE 200,053,103638,Zhang; Xinyu,9999,0,9999,0
1668238942345,ECE 200,054,103639,Turakhia; Yatish Girish,9999,0,9999,0
1668238942345,ECE 200,055,103640,Kang; Mingu,9999,0,9999,0
1668238942345,ECE 200,056,103641,Shi; Yuanyuan,9999,0,9999,0
1668238942345,ECE 200,057,103642,Wang; Edward Jay,9999,0,9999,0
1668238942345,ECE 200,058,103643,Zheng; Yang,9999,0,9999,0
1668238942768,ECE 202,A00,103644,Kuzum; Duygu,0,0,0,0
1668238943194,ECE 212BN,A00,103646,Ng; Tse Nga,0,0,0,0
1668238943618,ECE 221,A00,111493,Staff,0,0,0,0
1668238944046,ECE 222B,A00,103647,Lomakin; Vitaliy,0,0,0,0
1668238944469,ECE 230B,A00,103648,Taur; Yuan,0,0,0,0
1668238944894,ECE 238B,A00,103649,Garay; Javier,0,0,0,0
1668238945318,ECE 240B,A00,112900,Fainman; Yeshaiahu,0,0,0,0
1668238945744,ECE 247A,A00,103650,Jokerst; Jesse Vincent,0,0,0,0
1668238946170,ECE 247B,A00,103651,Wang; Joseph,0,0,0,0
1668238946595,ECE 250,A00,103652,Siegel; Paul H.,0,0,0,0
1668238947018,ECE 251A,A00,103654,Rao; Bhaskar D.,0,0,0,0
1668238947442,ECE 257B,A00,103655,Bharadia; Dinesh,0,0,0,0
1668238947865,ECE 258A,A00,103656,Milstein; Laurence B.,0,0,0,0
1668238948289,ECE 260B,A00,103658,Kang; Mingu,0,0,0,0
1668238948714,ECE 264A,A00,103659,Galton; Ian A,0,0,0,0
1668238949140,ECE 265A,A00,103661,Gudem; Prasad S.S.,0,0,0,0
1668238949565,ECE 265D,A00,103662,Gudem; Prasad S.S.,0,0,0,0
1668238949988,ECE 268,A00,103663,Koushanfar; Farinaz,0,0,0,0
1668238950420,ECE 269,A01,103665,Pal; Piya,0,0,0,0
1668238950848,ECE 271B,A00,103666,Vasconcelos; Manuela,0,0,0,0
1668238951273,ECE 276A,A00,103667,Atanasov; Nikolay A.,0,0,0,0
1668238951708,ECE 277,A00,103668,An; Cheolhong,0,0,0,0
1668238952140,ECE 279,A00,117947,Hall; Drew A.,0,0,0,0
1668238952999,ECE 283,A00,103670,Hsueh; Tzu-Chien,0,0,0,0
1668238953423,ECE 284,A00,103671,Turakhia; Yatish Girish,0,0,0,0
1668238953846,ECE 285,A00,103672,Zheng; Yang,0,0,0,0
1668238953846,ECE 285,B00,103673,Sworder; David D.,0,0,0,0
1668238954278,ECE 287,A00,103676,Javidi; Tara,0,0,0,0
1668238954714,MATH 200B,A00,098023,Salehi Golsefidy; Alireza,12,0,15,3
1668238955163,MATH 202B,A00,098024,Rhoades; Brendon Patrick,9,0,15,6
1668238955601,MATH 203B,A00,098025,Oprea; Dragos N.,10,0,15,5
1668238956026,MATH 204B,A00,098026,Sorensen; Claus M,13,0,15,2
1668238956450,MATH 208,A00,098027,Izadi; Elham,7,0,10,3
1668238956876,MATH 209,A00,098028,Pollack; Aaron,10,0,10,0
1668238957300,MATH 211A,A00,112919,Rogalski; Daniel,9,0,10,1
1668238957735,MATH 211B,A00,112920,Seward; Brandon M.,9,0,10,1
1668238958164,MATH 218,A00,098029,Li; Bo,10,0,10,0
1668238958594,MATH 220B,A00,098030,Novak; Jonathan I,11,0,15,4
1668238959020,MATH 221A,A00,098031,Ebenfelt; Peter F,13,0,15,2
1668238959449,MATH 231B,A00,098032,Zlatos; Andrej,12,0,15,3
1668238959978,MATH 240B,A00,098033,Ni; Lei,9,0,15,6
1668238960406,MATH 243,A00,098034,Jekel; David Andrew,10,0,10,0
1668238960845,MATH 245A,A00,098035,Nie; Jiawang,0,0,15,16
1668238961268,MATH 248,A00,098036,Bejenaru; Ioan,10,0,10,0
1668238961691,MATH 250B,A00,098037,Spolaor; Luca,14,0,15,1
1668238962114,MATH 258,A00,098038,Ni; Lei,10,0,10,0
1668238962548,MATH 264B,A00,098041,Rhoades; Brendon Patrick,9,0,15,6
1668238962976,MATH 268,A00,098042,Buss; Samuel R,10,0,10,0
1668238963411,MATH 269,A00,098043,Rhoades; Brendon Patrick,10,0,10,0
1668238963835,MATH 270B,A00,098044,Li; Bo,10,0,15,5
1668238964269,MATH 272B,A00,098045,Holst; Michael J,13,0,15,2
1668238964693,MATH 273A,A00,098046,Tian; Xiaochuan,10,0,15,5
1668238965117,MATH 275,A01,098048,Tian; Xiaochuan,6,0,10,4
1668238965547,MATH 278A,A00,098049,Holst; Michael J,8,0,10,2
1668238965973,MATH 278B,A00,098050,Cloninger; Alexander,10,0,10,0
1668238966396,MATH 278C,A00,098051,Nie; Jiawang,7,0,10,3
1668238966820,MATH 280B,A00,098052,Zheng; Tianyi,10,0,15,5
1668238967247,MATH 281B,A00,098053,Bradic; Jelena,1,0,15,14
1668238967671,MATH 282B,A00,098054,Arias-Castro; Ery,0,0,15,15
1668238968096,MATH 285,A00,098055,Fitzsimmons; Patrick J,0,0,15,17
1668238968518,MATH 287B,A00,098056,Arias-Castro; Ery,2,0,15,13
1668238968943,MATH 288,A00,098057,Agarwal; Pooja,9,0,10,1
1668238968943,MATH 288,B00,098058,Zhang; Danna,8,0,10,2
1668238968943,MATH 288,C00,098059,Williams; Ruth J,10,0,10,0
1668238969369,MATH 290B,A00,098060,Roberts; Justin Deritter,13,0,15,2
1668238969792,MATH 292,A00,098061,Belmont; Eva Kinoshita,10,0,10,0
1668238970220,MATH 295,A00,098062,Suk; Andrew Hoon,48,0,50,2
1668238970643,MATH 296,A00,098063,Novak; Jonathan I,20,0,20,0
1668238971066,MATH 297,001,098064,Gamst; Anthony Collins,9997,0,9999,2
1668239471359,COGS 205,A00,101395,Chiba; Andrea,19,0,20,1
1668239471782,COGS 210B,001,101404,Greene; Deanna Jacquelyn,9998,0,9999,1
1668239471782,COGS 210B,002,101417,Xia; Haijun,9999,0,9999,0
1668239471782,COGS 210B,003,101422,Nitz; Douglas A.,9999,0,9999,0
1668239471782,COGS 210B,004,101423,Hollan; James D.,9998,0,9999,1
1668239471782,COGS 210B,005,101424,Deak; Gedeon O.,9998,0,9999,1
1668239471782,COGS 210B,006,101425,Rossano; Federico,9999,0,9999,0
1668239472206,COGS 211B,A00,101427,Coulson; Seana M,9996,0,9999,3
1668239472628,COGS 220,A00,101428,Hollan; James D.,0,0,25,25
1668239473053,COGS 229,A00,101429,Dow; Steven P,18,0,25,7
1668239473475,COGS 230,A00,101430,Klemmer; Scott R,12,0,17,5
1668239473901,COGS 234,A00,101431,Xia; Haijun,2,0,25,23
1668239474329,COGS 260,A00,101432,Kiyonaga; Anastasia,21,0,25,4
1668239474329,COGS 260,B00,101433,Kirsh; David Joel,15,0,25,10
1668239474751,CSE 202,A00,102371,Impagliazzo; Russell,0,0,0,0
1668239475178,CSE 203B,A01,102373,Cheng; Chung Kuan,0,0,0,0
1668239475601,CSE 208,A00,102374,Micciancio; Daniele,0,0,0,0
1668239476026,CSE 209A,A00,112895,Impagliazzo; Russell,0,0,15,15
1668239476449,CSE 209B,A00,108005,Bellare; Mihir,0,0,0,0
1668239476872,CSE 210,A00,113163,Coblenz; Michael J,0,0,0,0
1668239477295,CSE 219,A00,106111,Dow; Steven P,0,0,20,20
1668239477719,CSE 221,A00,102376,Voelker; Geoffrey M.,0,0,0,0
1668239478143,CSE 224,A01,102378,Porter; George M,0,0,0,0
1668239478568,CSE 229A,A00,102379,Savage; Stefan,0,0,0,0
1668239478990,CSE 229C,A00,102380,Munyaka; Imani N. S.,0,0,0,0
1668239479414,CSE 232B,A00,102382,Deutsch; Alin Bernard,0,0,0,0
1668239479851,CSE 234,A01,112904,Kumar; Arun Kumar,0,0,0,0
1668239480372,CSE 237A,A00,102383,Rosing; Tajana Simunic,0,0,0,0
1668239480798,CSE 239A,A00,102384,Deutsch; Alin Bernard,0,0,0,0
1668239481226,CSE 239B,A00,102385,Polikarpova; Nadezhda,0,0,0,0
1668239481650,CSE 240A,A00,102386,Pannuto; Patrick William,0,0,0,0
1668239482075,CSE 240B,A00,102387,Zhao; Jishen,0,0,0,0
1668239482500,CSE 241A,A00,106406,Kang; Mingu,0,0,0,0
1668239482925,CSE 249B,A00,102388,Kahng; Andrew Byun,0,0,8,8
1668239483348,CSE 251B,A01,102392,Cottrell; Garrison W,0,0,0,0
1668239483348,CSE 251B,A02,102393,Cottrell; Garrison W,0,0,0,0
1668239483774,CSE 252B,A00,102394,Ochoa; Benjamin Lawrence,0,0,0,0
1668239484201,CSE 257,A01,102396,Gao; Sicun,0,0,0,0
1668239484627,CSE 272,A00,102397,Li; Tzumao,0,0,0,0
1668239485053,CSE 274,A00,111323,Chern; Albert Ren-Haur,0,0,0,0
1668239485477,CSE 282,A00,102398,Pevzner; Pavel Arkadjevich,0,0,0,0
1668239485901,CSE 284,A00,114175,Gymrek; Melissa Ann,0,0,0,0
1668239486327,CSE 290,A00,102399,Chandraker; Manmohan Krishna,0,0,0,0
1668239486327,CSE 290,B00,102400,Vaccaro; Kristen Marie,0,0,25,25
1668239486327,CSE 290,C00,102414,Pannuto; Patrick William,0,0,25,25
1668239486327,CSE 290,D00,102427,Pevzner; Pavel Arkadjevich,0,0,0,0
1668239486327,CSE 290,E00,102429,Zhao; Jishen,0,0,0,0
1668239486327,CSE 290,F00,102436,Tullsen; Dean Michael,0,0,0,0
1668239486327,CSE 290,G00,102440,Christensen; Henrik I,0,0,20,20
1668239486755,CSE 291,A00,102443,Su; Hao,0,0,0,0
1668239486755,CSE 291,B00,102448,Polikarpova; Nadezhda,0,0,0,0
1668239486755,CSE 291,C00,102453,Vaccaro; Kristen Marie,0,0,0,0
1668239486755,CSE 291,D00,111343,Savage; Stefan,0,0,0,0
1668239486755,CSE 291,E00,116474,Claffy; Kimberly Claire,0,0,0,0
1668239486755,CSE 291,F00,116479,Pasquale; Joseph,0,0,0,0
1668239487187,CSE 293,001,119111,Bafna; Vineet,9999,0,9999,0
1668239487187,CSE 293,002,119118,Bellare; Mihir,9999,0,9999,0
1668239487187,CSE 293,003,119122,Berg-Kirkpatrick; Taylor D,9999,0,9999,0
1668239487187,CSE 293,004,119135,Christensen; Henrik I,9999,0,9999,0
1668239487187,CSE 293,005,119142,Cottrell; Garrison W,9999,0,9999,0
1668239487187,CSE 293,006,119146,Deutsch; Alin Bernard,9999,0,9999,0
1668239487187,CSE 293,007,119159,Esmaeilzadeh; Hadi,9999,0,9999,0
1668239487187,CSE 293,008,119166,Freund; Yoav,9999,0,9999,0
1668239487187,CSE 293,009,119170,Griswold; William G.,9999,0,9999,0
1668239487187,CSE 293,010,119183,Gymrek; Melissa Ann,9999,0,9999,0
1668239487187,CSE 293,011,119190,Heninger; Nadia A,9999,0,9999,0
1668239487187,CSE 293,012,119230,Impagliazzo; Russell,9999,0,9999,0
1668239487187,CSE 293,013,119232,Jhala; Ranjit,9999,0,9999,0
1668239487187,CSE 293,014,119233,Kahng; Andrew Byun,9999,0,9999,0
1668239487187,CSE 293,015,119298,Kane; Daniel Mertz,9999,0,9999,0
1668239487187,CSE 293,016,119299,Kriegman; David J,9999,0,9999,0
1668239487187,CSE 293,017,119300,Kumar; Arun Kumar,9999,0,9999,0
1668239487187,CSE 293,018,119301,Lerner; Sorin,9999,0,9999,0
1668239487187,CSE 293,019,119302,Lovett; Shachar,9999,0,9999,0
1668239487187,CSE 293,020,119303,McAuley; Julian John,9999,0,9999,0
1668239487187,CSE 293,021,119304,Micciancio; Daniele,9999,0,9999,0
1668239487187,CSE 293,022,119367,Orailoglu; Alex,9999,0,9999,0
1668239487187,CSE 293,023,119382,Paturi; Ramamohan,9999,0,9999,0
1668239487187,CSE 293,024,119404,Polikarpova; Nadezhda,9999,0,9999,0
1668239487187,CSE 293,025,119406,Politz; Joseph Gibbs,9999,0,9999,0
1668239487187,CSE 293,026,119411,Porter; George M,9999,0,9999,0
1668239487187,CSE 293,027,119414,Porter; Leonard Emerson,9999,0,9999,0
1668239487187,CSE 293,028,119416,Ramamoorthi; Ravi,9999,0,9999,0
1668239487187,CSE 293,029,119417,Sahoo; Debashis,9999,0,9999,0
1668239487187,CSE 293,030,119420,Saul; Lawrence,9999,0,9999,0
1668239487187,CSE 293,031,119421,Savage; Stefan,9999,0,9999,0
1668239487187,CSE 293,032,119425,Schulze; Jurgen P.,9999,0,9999,0
1668239487187,CSE 293,033,119426,Snoeren; Alex C.,9999,0,9999,0
1668239487187,CSE 293,034,119428,Shang; Jingbo,9999,0,9999,0
1668239487187,CSE 293,035,119430,Stefan; Deian,9999,0,9999,0
1668239487187,CSE 293,036,119431,Su; Hao,9999,0,9999,0
1668239487187,CSE 293,037,119433,Swanson; Steven James,9999,0,9999,0
1668239487187,CSE 293,038,119435,Tullsen; Dean Michael,9999,0,9999,0
1668239487187,CSE 293,039,119483,Voelker; Geoffrey M.,9999,0,9999,0
1668239487187,CSE 293,040,119537,Zhao; Jishen,9999,0,9999,0
1668239487187,CSE 293,041,119538,Zhou; Yuan-Yuan,9999,0,9999,0
1668239487187,CSE 293,042,119539,Gao; Sicun,9999,0,9999,0
1668239487187,CSE 293,043,119540,Weibel; Nadir,9999,0,9999,0
1668239487187,CSE 293,044,119541,Gupta; Rajesh K.,9999,0,9999,0
1668239487187,CSE 293,045,126410,Vaccaro; Kristen Marie,9999,0,9999,0
1668239487187,CSE 293,046,126411,Klemke; Richard,9999,0,9999,0
1668239487615,CSE 294,A00,102459,Voelker; Geoffrey M.,0,0,0,0
1668239487615,CSE 294,B00,111322,Orailoglu; Alex,0,0,0,0
1668239488039,DSE 201,A00,096914,Deutsch; Alin Bernard,30,0,30,0
1668239488463,DSE 210,A00,096915,Dasgupta; Sanjoy,30,0,30,0
1668239488887,DSE 260A,A00,096916,Altintas De Callaf; Ilkay,30,0,30,0
1668239489317,ECE 200,001,103586,Antipa; Nicholas A,9999,0,9999,0
1668239489317,ECE 200,002,103587,Atanasov; Nikolay A.,9999,0,9999,0
1668239489317,ECE 200,003,103588,Bharadia; Dinesh,9999,0,9999,0
1668239489317,ECE 200,004,103589,Cheng; Chung Kuan,9999,0,9999,0
1668239489317,ECE 200,005,103590,Cosman; Pamela C.,9999,0,9999,0
1668239489317,ECE 200,006,103591,Dayeh; Shadi Ahmad,9999,0,9999,0
1668239489317,ECE 200,007,103592,Fainman; Yeshaiahu,9999,0,9999,0
1668239489317,ECE 200,008,103593,Ford; Joseph Earl,9999,0,9999,0
1668239489317,ECE 200,009,103594,Franceschetti; Massimo,9999,0,9999,0
1668239489317,ECE 200,010,103595,Fullerton; Eric E,9999,0,9999,0
1668239489317,ECE 200,011,103596,Galton; Ian A,9999,0,9999,0
1668239489317,ECE 200,012,103597,Gilja; Vikash,9999,0,9999,0
1668239489317,ECE 200,013,103598,Hall; Drew A.,9999,0,9999,0
1668239489317,ECE 200,014,103599,Hsueh; Tzu-Chien,9999,0,9999,0
1668239489317,ECE 200,015,103600,Javidi; Tara,9999,0,9999,0
1668239489317,ECE 200,016,103601,Kahng; Andrew Byun,9999,0,9999,0
1668239489317,ECE 200,017,103602,Kim; Young-Han,9999,0,9999,0
1668239489317,ECE 200,018,103603,Koushanfar; Farinaz,9999,0,9999,0
1668239489317,ECE 200,019,103604,Kuzum; Duygu,9999,0,9999,0
1668239489317,ECE 200,020,103605,Le; Hanh-Phuc,9999,0,9999,0
1668239489317,ECE 200,021,103606,Lin; Bill,9999,0,9999,0
1668239489317,ECE 200,022,103607,Liu; Zhaowei,9998,0,9999,1
1668239489317,ECE 200,023,103608,Lo; Yu-Hwa,9999,0,9999,0
1668239489317,ECE 200,024,103609,Lomakin; Vitaliy,9999,0,9999,0
1668239489317,ECE 200,025,103610,Mercier; Patrick Philip,9999,0,9999,0
1668239489317,ECE 200,026,103611,Meyer; Florian,9999,0,9999,0
1668239489317,ECE 200,027,103612,Milstein; Laurence B.,9999,0,9999,0
1668239489317,ECE 200,028,103613,Mir Arabbaygi; Siavash,9999,0,9999,0
1668239489317,ECE 200,029,103614,Mookherjea; Shayan,9999,0,9999,0
1668239489317,ECE 200,030,103615,Morris; Karcher William,9999,0,9999,0
1668239489317,ECE 200,031,103616,Ng; Tse Nga,9999,0,9999,0
1668239489317,ECE 200,032,103617,Nguyen; Truong Quang,9999,0,9999,0
1668239489317,ECE 200,033,103618,Nomura; Kenji,9999,0,9999,0
1668239489317,ECE 200,034,103619,Orlitsky; Alon,9999,0,9999,0
1668239489317,ECE 200,035,103620,Pal; Piya,9999,0,9999,0
1668239489317,ECE 200,036,103621,Papen; George C.,9999,0,9999,0
1668239489317,ECE 200,037,103622,Radic; Stojan,9999,0,9999,0
1668239489317,ECE 200,038,103623,Rao; Bhaskar D.,9999,0,9999,0
1668239489317,ECE 200,039,103624,Rao; Ramesh R,9999,0,9999,0
1668239489317,ECE 200,040,103625,Rebeiz; Gabriel,9999,0,9999,0
1668239489317,ECE 200,041,103626,Sanford; John R,9999,0,9999,0
1668239489317,ECE 200,042,103627,Siegel; Paul H.,9999,0,9999,0
1668239489317,ECE 200,043,103628,Sievenpiper; Daniel F.,9999,0,9999,0
1668239489317,ECE 200,044,103629,Sworder; David D.,9999,0,9999,0
1668239489317,ECE 200,045,103630,Taur; Yuan,9999,0,9999,0
1668239489317,ECE 200,046,103631,Touri; Behrouz,9999,0,9999,0
1668239489317,ECE 200,047,103632,Trivedi; Mohan M.,9999,0,9999,0
1668239489317,ECE 200,048,103633,Vasconcelos; Nuno,9999,0,9999,0
1668239489317,ECE 200,049,103634,Wang; Xiaolong,9999,0,9999,0
1668239489317,ECE 200,050,103635,Xie; Pengtao,9999,0,9999,0
1668239489317,ECE 200,051,103636,Yip; Michael,9999,0,9999,0
1668239489317,ECE 200,052,103637,Zeger; Kenneth A.,999,0,999,0
1668239489317,ECE 200,053,103638,Zhang; Xinyu,9999,0,9999,0
1668239489317,ECE 200,054,103639,Turakhia; Yatish Girish,9999,0,9999,0
1668239489317,ECE 200,055,103640,Kang; Mingu,9999,0,9999,0
1668239489317,ECE 200,056,103641,Shi; Yuanyuan,9999,0,9999,0
1668239489317,ECE 200,057,103642,Wang; Edward Jay,9999,0,9999,0
1668239489317,ECE 200,058,103643,Zheng; Yang,9999,0,9999,0
1668239489743,ECE 202,A00,103644,Kuzum; Duygu,0,0,0,0
1668239490176,ECE 212BN,A00,103646,Ng; Tse Nga,0,0,0,0
1668239490605,ECE 221,A00,111493,Staff,0,0,0,0
1668239491032,ECE 222B,A00,103647,Lomakin; Vitaliy,0,0,0,0
1668239491455,ECE 230B,A00,103648,Taur; Yuan,0,0,0,0
1668239491877,ECE 238B,A00,103649,Garay; Javier,0,0,0,0
1668239492301,ECE 240B,A00,112900,Fainman; Yeshaiahu,0,0,0,0
1668239492725,ECE 247A,A00,103650,Jokerst; Jesse Vincent,0,0,0,0
1668239493156,ECE 247B,A00,103651,Wang; Joseph,0,0,0,0
1668239493585,ECE 250,A00,103652,Siegel; Paul H.,0,0,0,0
1668239494016,ECE 251A,A00,103654,Rao; Bhaskar D.,0,0,0,0
1668239494439,ECE 257B,A00,103655,Bharadia; Dinesh,0,0,0,0
1668239494864,ECE 258A,A00,103656,Milstein; Laurence B.,0,0,0,0
1668239495292,ECE 260B,A00,103658,Kang; Mingu,0,0,0,0
1668239495716,ECE 264A,A00,103659,Galton; Ian A,0,0,0,0
1668239496142,ECE 265A,A00,103661,Gudem; Prasad S.S.,0,0,0,0
1668239496566,ECE 265D,A00,103662,Gudem; Prasad S.S.,0,0,0,0
1668239496993,ECE 268,A00,103663,Koushanfar; Farinaz,0,0,0,0
1668239497419,ECE 269,A01,103665,Pal; Piya,0,0,0,0
1668239497846,ECE 271B,A00,103666,Vasconcelos; Manuela,0,0,0,0
1668239498276,ECE 276A,A00,103667,Atanasov; Nikolay A.,0,0,0,0
1668239498705,ECE 277,A00,103668,An; Cheolhong,0,0,0,0
1668239499129,ECE 279,A00,117947,Hall; Drew A.,0,0,0,0
1668239499977,ECE 283,A00,103670,Hsueh; Tzu-Chien,0,0,0,0
1668239500403,ECE 284,A00,103671,Turakhia; Yatish Girish,0,0,0,0
1668239500830,ECE 285,A00,103672,Zheng; Yang,0,0,0,0
1668239500830,ECE 285,B00,103673,Sworder; David D.,0,0,0,0
1668239501252,ECE 287,A00,103676,Javidi; Tara,0,0,0,0
1668239501677,MATH 200B,A00,098023,Salehi Golsefidy; Alireza,12,0,15,3
1668239502100,MATH 202B,A00,098024,Rhoades; Brendon Patrick,9,0,15,6
1668239502529,MATH 203B,A00,098025,Oprea; Dragos N.,10,0,15,5
1668239502957,MATH 204B,A00,098026,Sorensen; Claus M,13,0,15,2
1668239503381,MATH 208,A00,098027,Izadi; Elham,7,0,10,3
1668239503816,MATH 209,A00,098028,Pollack; Aaron,10,0,10,0
1668239504248,MATH 211A,A00,112919,Rogalski; Daniel,9,0,10,1
1668239504682,MATH 211B,A00,112920,Seward; Brandon M.,9,0,10,1
1668239505117,MATH 218,A00,098029,Li; Bo,10,0,10,0
1668239505550,MATH 220B,A00,098030,Novak; Jonathan I,11,0,15,4
1668239505973,MATH 221A,A00,098031,Ebenfelt; Peter F,13,0,15,2
1668239506396,MATH 231B,A00,098032,Zlatos; Andrej,12,0,15,3
1668239506822,MATH 240B,A00,098033,Ni; Lei,9,0,15,6
1668239507246,MATH 243,A00,098034,Jekel; David Andrew,10,0,10,0
1668239507677,MATH 245A,A00,098035,Nie; Jiawang,0,0,15,16
1668239508103,MATH 248,A00,098036,Bejenaru; Ioan,10,0,10,0
1668239508527,MATH 250B,A00,098037,Spolaor; Luca,14,0,15,1
1668239508951,MATH 258,A00,098038,Ni; Lei,10,0,10,0
1668239509373,MATH 264B,A00,098041,Rhoades; Brendon Patrick,9,0,15,6
1668239509795,MATH 268,A00,098042,Buss; Samuel R,10,0,10,0
1668239510220,MATH 269,A00,098043,Rhoades; Brendon Patrick,10,0,10,0
1668239510646,MATH 270B,A00,098044,Li; Bo,10,0,15,5
1668239511086,MATH 272B,A00,098045,Holst; Michael J,13,0,15,2
1668239511512,MATH 273A,A00,098046,Tian; Xiaochuan,10,0,15,5
1668239511949,MATH 275,A01,098048,Tian; Xiaochuan,6,0,10,4
1668239512384,MATH 278A,A00,098049,Holst; Michael J,8,0,10,2
1668239512814,MATH 278B,A00,098050,Cloninger; Alexander,10,0,10,0
1668239513253,MATH 278C,A00,098051,Nie; Jiawang,7,0,10,3
1668239513676,MATH 280B,A00,098052,Zheng; Tianyi,10,0,15,5
1668239514102,MATH 281B,A00,098053,Bradic; Jelena,1,0,15,14
1668239514526,MATH 282B,A00,098054,Arias-Castro; Ery,0,0,15,15
1668239514950,MATH 285,A00,098055,Fitzsimmons; Patrick J,0,0,15,17
1668239515381,MATH 287B,A00,098056,Arias-Castro; Ery,2,0,15,13
1668239515805,MATH 288,A00,098057,Agarwal; Pooja,9,0,10,1
1668239515805,MATH 288,B00,098058,Zhang; Danna,8,0,10,2
1668239515805,MATH 288,C00,098059,Williams; Ruth J,10,0,10,0
1668239516232,MATH 290B,A00,098060,Roberts; Justin Deritter,13,0,15,2
1668239516658,MATH 292,A00,098061,Belmont; Eva Kinoshita,10,0,10,0
1668239517081,MATH 295,A00,098062,Suk; Andrew Hoon,48,0,50,2
1668239517511,MATH 296,A00,098063,Novak; Jonathan I,20,0,20,0
1668239517936,MATH 297,001,098064,Gamst; Anthony Collins,9997,0,9999,2
1668240018404,COGS 205,A00,101395,Chiba; Andrea,19,0,20,1
1668240018830,COGS 210B,001,101404,Greene; Deanna Jacquelyn,9998,0,9999,1
1668240018830,COGS 210B,002,101417,Xia; Haijun,9999,0,9999,0
1668240018830,COGS 210B,003,101422,Nitz; Douglas A.,9999,0,9999,0
1668240018830,COGS 210B,004,101423,Hollan; James D.,9998,0,9999,1
1668240018830,COGS 210B,005,101424,Deak; Gedeon O.,9998,0,9999,1
1668240018830,COGS 210B,006,101425,Rossano; Federico,9999,0,9999,0
1668240019259,COGS 211B,A00,101427,Coulson; Seana M,9996,0,9999,3
1668240019690,COGS 220,A00,101428,Hollan; James D.,0,0,25,25
1668240020125,COGS 229,A00,101429,Dow; Steven P,18,0,25,7
1668240020551,COGS 230,A00,101430,Klemmer; Scott R,12,0,17,5
1668240020974,COGS 234,A00,101431,Xia; Haijun,2,0,25,23
1668240021409,COGS 260,A00,101432,Kiyonaga; Anastasia,21,0,25,4
1668240021409,COGS 260,B00,101433,Kirsh; David Joel,15,0,25,10
1668240021832,CSE 202,A00,102371,Impagliazzo; Russell,0,0,0,0
1668240022256,CSE 203B,A01,102373,Cheng; Chung Kuan,0,0,0,0
1668240022684,CSE 208,A00,102374,Micciancio; Daniele,0,0,0,0
1668240023110,CSE 209A,A00,112895,Impagliazzo; Russell,0,0,15,15
1668240023536,CSE 209B,A00,108005,Bellare; Mihir,0,0,0,0
1668240023967,CSE 210,A00,113163,Coblenz; Michael J,0,0,0,0
1668240024396,CSE 219,A00,106111,Dow; Steven P,0,0,20,20
1668240024820,CSE 221,A00,102376,Voelker; Geoffrey M.,0,0,0,0
1668240025249,CSE 224,A01,102378,Porter; George M,0,0,0,0
1668240025695,CSE 229A,A00,102379,Savage; Stefan,0,0,0,0
1668240026120,CSE 229C,A00,102380,Munyaka; Imani N. S.,0,0,0,0
1668240026552,CSE 232B,A00,102382,Deutsch; Alin Bernard,0,0,0,0
1668240026976,CSE 234,A01,112904,Kumar; Arun Kumar,0,0,0,0
1668240027409,CSE 237A,A00,102383,Rosing; Tajana Simunic,0,0,0,0
1668240027834,CSE 239A,A00,102384,Deutsch; Alin Bernard,0,0,0,0
1668240028261,CSE 239B,A00,102385,Polikarpova; Nadezhda,0,0,0,0
1668240028689,CSE 240A,A00,102386,Pannuto; Patrick William,0,0,0,0
1668240029114,CSE 240B,A00,102387,Zhao; Jishen,0,0,0,0
1668240029540,CSE 241A,A00,106406,Kang; Mingu,0,0,0,0
1668240029962,CSE 249B,A00,102388,Kahng; Andrew Byun,0,0,8,8
1668240030386,CSE 251B,A01,102392,Cottrell; Garrison W,0,0,0,0
1668240030386,CSE 251B,A02,102393,Cottrell; Garrison W,0,0,0,0
1668240030809,CSE 252B,A00,102394,Ochoa; Benjamin Lawrence,0,0,0,0
1668240031233,CSE 257,A01,102396,Gao; Sicun,0,0,0,0
1668240031666,CSE 272,A00,102397,Li; Tzumao,0,0,0,0
1668240032102,CSE 274,A00,111323,Chern; Albert Ren-Haur,0,0,0,0
1668240032540,CSE 282,A00,102398,Pevzner; Pavel Arkadjevich,0,0,0,0
1668240032968,CSE 284,A00,114175,Gymrek; Melissa Ann,0,0,0,0
1668240033397,CSE 290,A00,102399,Chandraker; Manmohan Krishna,0,0,0,0
1668240033397,CSE 290,B00,102400,Vaccaro; Kristen Marie,0,0,25,25
1668240033397,CSE 290,C00,102414,Pannuto; Patrick William,0,0,25,25
1668240033397,CSE 290,D00,102427,Pevzner; Pavel Arkadjevich,0,0,0,0
1668240033397,CSE 290,E00,102429,Zhao; Jishen,0,0,0,0
1668240033397,CSE 290,F00,102436,Tullsen; Dean Michael,0,0,0,0
1668240033397,CSE 290,G00,102440,Christensen; Henrik I,0,0,20,20
1668240033822,CSE 291,A00,102443,Su; Hao,0,0,0,0
1668240033822,CSE 291,B00,102448,Polikarpova; Nadezhda,0,0,0,0
1668240033822,CSE 291,C00,102453,Vaccaro; Kristen Marie,0,0,0,0
1668240033822,CSE 291,D00,111343,Savage; Stefan,0,0,0,0
1668240033822,CSE 291,E00,116474,Claffy; Kimberly Claire,0,0,0,0
1668240033822,CSE 291,F00,116479,Pasquale; Joseph,0,0,0,0
1668240034248,CSE 293,001,119111,Bafna; Vineet,9999,0,9999,0
1668240034248,CSE 293,002,119118,Bellare; Mihir,9999,0,9999,0
1668240034248,CSE 293,003,119122,Berg-Kirkpatrick; Taylor D,9999,0,9999,0
1668240034248,CSE 293,004,119135,Christensen; Henrik I,9999,0,9999,0
1668240034248,CSE 293,005,119142,Cottrell; Garrison W,9999,0,9999,0
1668240034248,CSE 293,006,119146,Deutsch; Alin Bernard,9999,0,9999,0
1668240034248,CSE 293,007,119159,Esmaeilzadeh; Hadi,9999,0,9999,0
1668240034248,CSE 293,008,119166,Freund; Yoav,9999,0,9999,0
1668240034248,CSE 293,009,119170,Griswold; William G.,9999,0,9999,0
1668240034248,CSE 293,010,119183,Gymrek; Melissa Ann,9999,0,9999,0
1668240034248,CSE 293,011,119190,Heninger; Nadia A,9999,0,9999,0
1668240034248,CSE 293,012,119230,Impagliazzo; Russell,9999,0,9999,0
1668240034248,CSE 293,013,119232,Jhala; Ranjit,9999,0,9999,0
1668240034248,CSE 293,014,119233,Kahng; Andrew Byun,9999,0,9999,0
1668240034248,CSE 293,015,119298,Kane; Daniel Mertz,9999,0,9999,0
1668240034248,CSE 293,016,119299,Kriegman; David J,9999,0,9999,0
1668240034248,CSE 293,017,119300,Kumar; Arun Kumar,9999,0,9999,0
1668240034248,CSE 293,018,119301,Lerner; Sorin,9999,0,9999,0
1668240034248,CSE 293,019,119302,Lovett; Shachar,9999,0,9999,0
1668240034248,CSE 293,020,119303,McAuley; Julian John,9999,0,9999,0
1668240034248,CSE 293,021,119304,Micciancio; Daniele,9999,0,9999,0
1668240034248,CSE 293,022,119367,Orailoglu; Alex,9999,0,9999,0
1668240034248,CSE 293,023,119382,Paturi; Ramamohan,9999,0,9999,0
1668240034248,CSE 293,024,119404,Polikarpova; Nadezhda,9999,0,9999,0
1668240034248,CSE 293,025,119406,Politz; Joseph Gibbs,9999,0,9999,0
1668240034248,CSE 293,026,119411,Porter; George M,9999,0,9999,0
1668240034248,CSE 293,027,119414,Porter; Leonard Emerson,9999,0,9999,0
1668240034248,CSE 293,028,119416,Ramamoorthi; Ravi,9999,0,9999,0
1668240034248,CSE 293,029,119417,Sahoo; Debashis,9999,0,9999,0
1668240034248,CSE 293,030,119420,Saul; Lawrence,9999,0,9999,0
1668240034248,CSE 293,031,119421,Savage; Stefan,9999,0,9999,0
1668240034248,CSE 293,032,119425,Schulze; Jurgen P.,9999,0,9999,0
1668240034248,CSE 293,033,119426,Snoeren; Alex C.,9999,0,9999,0
1668240034248,CSE 293,034,119428,Shang; Jingbo,9999,0,9999,0
1668240034248,CSE 293,035,119430,Stefan; Deian,9999,0,9999,0
1668240034248,CSE 293,036,119431,Su; Hao,9999,0,9999,0
1668240034248,CSE 293,037,119433,Swanson; Steven James,9999,0,9999,0
1668240034248,CSE 293,038,119435,Tullsen; Dean Michael,9999,0,9999,0
1668240034248,CSE 293,039,119483,Voelker; Geoffrey M.,9999,0,9999,0
1668240034248,CSE 293,040,119537,Zhao; Jishen,9999,0,9999,0
1668240034248,CSE 293,041,119538,Zhou; Yuan-Yuan,9999,0,9999,0
1668240034248,CSE 293,042,119539,Gao; Sicun,9999,0,9999,0
1668240034248,CSE 293,043,119540,Weibel; Nadir,9999,0,9999,0
1668240034248,CSE 293,044,119541,Gupta; Rajesh K.,9999,0,9999,0
1668240034248,CSE 293,045,126410,Vaccaro; Kristen Marie,9999,0,9999,0
1668240034248,CSE 293,046,126411,Klemke; Richard,9999,0,9999,0
1668240034678,CSE 294,A00,102459,Voelker; Geoffrey M.,0,0,0,0
1668240034678,CSE 294,B00,111322,Orailoglu; Alex,0,0,0,0
1668240035102,DSE 201,A00,096914,Deutsch; Alin Bernard,30,0,30,0
1668240035527,DSE 210,A00,096915,Dasgupta; Sanjoy,30,0,30,0
1668240035955,DSE 260A,A00,096916,Altintas De Callaf; Ilkay,30,0,30,0
1668240036411,ECE 200,001,103586,Antipa; Nicholas A,9999,0,9999,0
1668240036411,ECE 200,002,103587,Atanasov; Nikolay A.,9999,0,9999,0
1668240036411,ECE 200,003,103588,Bharadia; Dinesh,9999,0,9999,0
1668240036411,ECE 200,004,103589,Cheng; Chung Kuan,9999,0,9999,0
1668240036411,ECE 200,005,103590,Cosman; Pamela C.,9999,0,9999,0
1668240036411,ECE 200,006,103591,Dayeh; Shadi Ahmad,9999,0,9999,0
1668240036411,ECE 200,007,103592,Fainman; Yeshaiahu,9999,0,9999,0
1668240036411,ECE 200,008,103593,Ford; Joseph Earl,9999,0,9999,0
1668240036411,ECE 200,009,103594,Franceschetti; Massimo,9999,0,9999,0
1668240036411,ECE 200,010,103595,Fullerton; Eric E,9999,0,9999,0
1668240036411,ECE 200,011,103596,Galton; Ian A,9999,0,9999,0
1668240036411,ECE 200,012,103597,Gilja; Vikash,9999,0,9999,0
1668240036411,ECE 200,013,103598,Hall; Drew A.,9999,0,9999,0
1668240036411,ECE 200,014,103599,Hsueh; Tzu-Chien,9999,0,9999,0
1668240036411,ECE 200,015,103600,Javidi; Tara,9999,0,9999,0
1668240036411,ECE 200,016,103601,Kahng; Andrew Byun,9999,0,9999,0
1668240036411,ECE 200,017,103602,Kim; Young-Han,9999,0,9999,0
1668240036411,ECE 200,018,103603,Koushanfar; Farinaz,9999,0,9999,0
1668240036411,ECE 200,019,103604,Kuzum; Duygu,9999,0,9999,0
1668240036411,ECE 200,020,103605,Le; Hanh-Phuc,9999,0,9999,0
1668240036411,ECE 200,021,103606,Lin; Bill,9999,0,9999,0
1668240036411,ECE 200,022,103607,Liu; Zhaowei,9998,0,9999,1
1668240036411,ECE 200,023,103608,Lo; Yu-Hwa,9999,0,9999,0
1668240036411,ECE 200,024,103609,Lomakin; Vitaliy,9999,0,9999,0
1668240036411,ECE 200,025,103610,Mercier; Patrick Philip,9999,0,9999,0
1668240036411,ECE 200,026,103611,Meyer; Florian,9999,0,9999,0
1668240036411,ECE 200,027,103612,Milstein; Laurence B.,9999,0,9999,0
1668240036411,ECE 200,028,103613,Mir Arabbaygi; Siavash,9999,0,9999,0
1668240036411,ECE 200,029,103614,Mookherjea; Shayan,9999,0,9999,0
1668240036411,ECE 200,030,103615,Morris; Karcher William,9999,0,9999,0
1668240036411,ECE 200,031,103616,Ng; Tse Nga,9999,0,9999,0
1668240036411,ECE 200,032,103617,Nguyen; Truong Quang,9999,0,9999,0
1668240036411,ECE 200,033,103618,Nomura; Kenji,9999,0,9999,0
1668240036411,ECE 200,034,103619,Orlitsky; Alon,9999,0,9999,0
1668240036411,ECE 200,035,103620,Pal; Piya,9999,0,9999,0
1668240036411,ECE 200,036,103621,Papen; George C.,9999,0,9999,0
1668240036411,ECE 200,037,103622,Radic; Stojan,9999,0,9999,0
1668240036411,ECE 200,038,103623,Rao; Bhaskar D.,9999,0,9999,0
1668240036411,ECE 200,039,103624,Rao; Ramesh R,9999,0,9999,0
1668240036411,ECE 200,040,103625,Rebeiz; Gabriel,9999,0,9999,0
1668240036411,ECE 200,041,103626,Sanford; John R,9999,0,9999,0
1668240036411,ECE 200,042,103627,Siegel; Paul H.,9999,0,9999,0
1668240036411,ECE 200,043,103628,Sievenpiper; Daniel F.,9999,0,9999,0
1668240036411,ECE 200,044,103629,Sworder; David D.,9999,0,9999,0
1668240036411,ECE 200,045,103630,Taur; Yuan,9999,0,9999,0
1668240036411,ECE 200,046,103631,Touri; Behrouz,9999,0,9999,0
1668240036411,ECE 200,047,103632,Trivedi; Mohan M.,9999,0,9999,0
1668240036411,ECE 200,048,103633,Vasconcelos; Nuno,9999,0,9999,0
1668240036411,ECE 200,049,103634,Wang; Xiaolong,9999,0,9999,0
1668240036411,ECE 200,050,103635,Xie; Pengtao,9999,0,9999,0
1668240036411,ECE 200,051,103636,Yip; Michael,9999,0,9999,0
1668240036411,ECE 200,052,103637,Zeger; Kenneth A.,999,0,999,0
1668240036411,ECE 200,053,103638,Zhang; Xinyu,9999,0,9999,0
1668240036411,ECE 200,054,103639,Turakhia; Yatish Girish,9999,0,9999,0
1668240036411,ECE 200,055,103640,Kang; Mingu,9999,0,9999,0
1668240036411,ECE 200,056,103641,Shi; Yuanyuan,9999,0,9999,0
1668240036411,ECE 200,057,103642,Wang; Edward Jay,9999,0,9999,0
1668240036411,ECE 200,058,103643,Zheng; Yang,9999,0,9999,0
1668240036837,ECE 202,A00,103644,Kuzum; Duygu,0,0,0,0
1668240037261,ECE 212BN,A00,103646,Ng; Tse Nga,0,0,0,0
1668240037697,ECE 221,A00,111493,Staff,0,0,0,0
1668240038119,ECE 222B,A00,103647,Lomakin; Vitaliy,0,0,0,0
1668240038563,ECE 230B,A00,103648,Taur; Yuan,0,0,0,0
1668240038992,ECE 238B,A00,103649,Garay; Javier,0,0,0,0
1668240039420,ECE 240B,A00,112900,Fainman; Yeshaiahu,0,0,0,0
1668240039843,ECE 247A,A00,103650,Jokerst; Jesse Vincent,0,0,0,0
1668240040282,ECE 247B,A00,103651,Wang; Joseph,0,0,0,0
1668240040705,ECE 250,A00,103652,Siegel; Paul H.,0,0,0,0
1668240041133,ECE 251A,A00,103654,Rao; Bhaskar D.,0,0,0,0
1668240041558,ECE 257B,A00,103655,Bharadia; Dinesh,0,0,0,0
1668240041989,ECE 258A,A00,103656,Milstein; Laurence B.,0,0,0,0
1668240042424,ECE 260B,A00,103658,Kang; Mingu,0,0,0,0
1668240042848,ECE 264A,A00,103659,Galton; Ian A,0,0,0,0
1668240043273,ECE 265A,A00,103661,Gudem; Prasad S.S.,0,0,0,0
1668240043713,ECE 265D,A00,103662,Gudem; Prasad S.S.,0,0,0,0
1668240044221,ECE 268,A00,103663,Koushanfar; Farinaz,0,0,0,0
1668240044655,ECE 269,A01,103665,Pal; Piya,0,0,0,0
1668240045077,ECE 271B,A00,103666,Vasconcelos; Manuela,0,0,0,0
1668240045503,ECE 276A,A00,103667,Atanasov; Nikolay A.,0,0,0,0
1668240045932,ECE 277,A00,103668,An; Cheolhong,0,0,0,0
1668240046356,ECE 279,A00,117947,Hall; Drew A.,0,0,0,0
1668240047208,ECE 283,A00,103670,Hsueh; Tzu-Chien,0,0,0,0
1668240047637,ECE 284,A00,103671,Turakhia; Yatish Girish,0,0,0,0
1668240048062,ECE 285,A00,103672,Zheng; Yang,0,0,0,0
1668240048062,ECE 285,B00,103673,Sworder; David D.,0,0,0,0
1668240048488,ECE 287,A00,103676,Javidi; Tara,0,0,0,0
1668240048917,MATH 200B,A00,098023,Salehi Golsefidy; Alireza,12,0,15,3
1668240049340,MATH 202B,A00,098024,Rhoades; Brendon Patrick,9,0,15,6
1668240049769,MATH 203B,A00,098025,Oprea; Dragos N.,10,0,15,5
1668240050206,MATH 204B,A00,098026,Sorensen; Claus M,13,0,15,2
1668240050637,MATH 208,A00,098027,Izadi; Elham,7,0,10,3
1668240051062,MATH 209,A00,098028,Pollack; Aaron,10,0,10,0
1668240051489,MATH 211A,A00,112919,Rogalski; Daniel,9,0,10,1
1668240051914,MATH 211B,A00,112920,Seward; Brandon M.,9,0,10,1
1668240052341,MATH 218,A00,098029,Li; Bo,10,0,10,0
1668240052772,MATH 220B,A00,098030,Novak; Jonathan I,11,0,15,4
1668240053199,MATH 221A,A00,098031,Ebenfelt; Peter F,13,0,15,2
1668240053624,MATH 231B,A00,098032,Zlatos; Andrej,12,0,15,3
1668240054053,MATH 240B,A00,098033,Ni; Lei,9,0,15,6
1668240054476,MATH 243,A00,098034,Jekel; David Andrew,10,0,10,0
1668240054903,MATH 245A,A00,098035,Nie; Jiawang,0,0,15,16
1668240055332,MATH 248,A00,098036,Bejenaru; Ioan,10,0,10,0
1668240055755,MATH 250B,A00,098037,Spolaor; Luca,14,0,15,1
1668240056178,MATH 258,A00,098038,Ni; Lei,10,0,10,0
1668240056612,MATH 264B,A00,098041,Rhoades; Brendon Patrick,9,0,15,6
1668240057038,MATH 268,A00,098042,Buss; Samuel R,10,0,10,0
1668240057465,MATH 269,A00,098043,Rhoades; Brendon Patrick,10,0,10,0
1668240057890,MATH 270B,A00,098044,Li; Bo,10,0,15,5
1668240058323,MATH 272B,A00,098045,Holst; Michael J,13,0,15,2
1668240058748,MATH 273A,A00,098046,Tian; Xiaochuan,10,0,15,5
1668240059173,MATH 275,A01,098048,Tian; Xiaochuan,6,0,10,4
1668240059607,MATH 278A,A00,098049,Holst; Michael J,8,0,10,2
1668240060031,MATH 278B,A00,098050,Cloninger; Alexander,10,0,10,0
1668240060457,MATH 278C,A00,098051,Nie; Jiawang,7,0,10,3
1668240060885,MATH 280B,A00,098052,Zheng; Tianyi,10,0,15,5
1668240061309,MATH 281B,A00,098053,Bradic; Jelena,1,0,15,14
1668240061748,MATH 282B,A00,098054,Arias-Castro; Ery,0,0,15,15
1668240062175,MATH 285,A00,098055,Fitzsimmons; Patrick J,0,0,15,17
1668240062602,MATH 287B,A00,098056,Arias-Castro; Ery,2,0,15,13
1668240063031,MATH 288,A00,098057,Agarwal; Pooja,9,0,10,1
1668240063031,MATH 288,B00,098058,Zhang; Danna,8,0,10,2
1668240063031,MATH 288,C00,098059,Williams; Ruth J,10,0,10,0
1668240063461,MATH 290B,A00,098060,Roberts; Justin Deritter,13,0,15,2
1668240063884,MATH 292,A00,098061,Belmont; Eva Kinoshita,10,0,10,0
1668240064306,MATH 295,A00,098062,Suk; Andrew Hoon,48,0,50,2
1668240064728,MATH 296,A00,098063,Novak; Jonathan I,20,0,20,0
1668240065160,MATH 297,001,098064,Gamst; Anthony Collins,9997,0,9999,2
1668240566702,COGS 205,A00,101395,Chiba; Andrea,19,0,20,1
1668240567125,COGS 210B,001,101404,Greene; Deanna Jacquelyn,9998,0,9999,1
1668240567125,COGS 210B,002,101417,Xia; Haijun,9999,0,9999,0
1668240567125,COGS 210B,003,101422,Nitz; Douglas A.,9999,0,9999,0
1668240567125,COGS 210B,004,101423,Hollan; James D.,9998,0,9999,1
1668240567125,COGS 210B,005,101424,Deak; Gedeon O.,9998,0,9999,1
1668240567125,COGS 210B,006,101425,Rossano; Federico,9999,0,9999,0
1668240567548,COGS 211B,A00,101427,Coulson; Seana M,9996,0,9999,3
1668240567973,COGS 220,A00,101428,Hollan; James D.,0,0,25,25
1668240568408,COGS 229,A00,101429,Dow; Steven P,18,0,25,7
1668240568834,COGS 230,A00,101430,Klemmer; Scott R,12,0,17,5
1668240569257,COGS 234,A00,101431,Xia; Haijun,2,0,25,23
1668240569681,COGS 260,A00,101432,Kiyonaga; Anastasia,21,0,25,4
1668240569681,COGS 260,B00,101433,Kirsh; David Joel,15,0,25,10
1668240570102,CSE 202,A00,102371,Impagliazzo; Russell,0,0,0,0
1668240570532,CSE 203B,A01,102373,Cheng; Chung Kuan,0,0,0,0
1668240570958,CSE 208,A00,102374,Micciancio; Daniele,0,0,0,0
1668240571387,CSE 209A,A00,112895,Impagliazzo; Russell,0,0,15,15
1668240571811,CSE 209B,A00,108005,Bellare; Mihir,0,0,0,0
1668240572239,CSE 210,A00,113163,Coblenz; Michael J,0,0,0,0
1668240572664,CSE 219,A00,106111,Dow; Steven P,0,0,20,20
1668240573091,CSE 221,A00,102376,Voelker; Geoffrey M.,0,0,0,0
1668240573513,CSE 224,A01,102378,Porter; George M,0,0,0,0
1668240573940,CSE 229A,A00,102379,Savage; Stefan,0,0,0,0
1668240574363,CSE 229C,A00,102380,Munyaka; Imani N. S.,0,0,0,0
1668240574790,CSE 232B,A00,102382,Deutsch; Alin Bernard,0,0,0,0
1668240575225,CSE 234,A01,112904,Kumar; Arun Kumar,0,0,0,0
1668240575649,CSE 237A,A00,102383,Rosing; Tajana Simunic,0,0,0,0
1668240576074,CSE 239A,A00,102384,Deutsch; Alin Bernard,0,0,0,0
1668240576496,CSE 239B,A00,102385,Polikarpova; Nadezhda,0,0,0,0
1668240576919,CSE 240A,A00,102386,Pannuto; Patrick William,0,0,0,0
1668240577347,CSE 240B,A00,102387,Zhao; Jishen,0,0,0,0
1668240577775,CSE 241A,A00,106406,Kang; Mingu,0,0,0,0
1668240578197,CSE 249B,A00,102388,Kahng; Andrew Byun,0,0,8,8
1668240578623,CSE 251B,A01,102392,Cottrell; Garrison W,0,0,0,0
1668240578623,CSE 251B,A02,102393,Cottrell; Garrison W,0,0,0,0
1668240579046,CSE 252B,A00,102394,Ochoa; Benjamin Lawrence,0,0,0,0
1668240579477,CSE 257,A01,102396,Gao; Sicun,0,0,0,0
1668240579905,CSE 272,A00,102397,Li; Tzumao,0,0,0,0
1668240580334,CSE 274,A00,111323,Chern; Albert Ren-Haur,0,0,0,0
1668240580770,CSE 282,A00,102398,Pevzner; Pavel Arkadjevich,0,0,0,0
1668240581193,CSE 284,A00,114175,Gymrek; Melissa Ann,0,0,0,0
1668240581625,CSE 290,A00,102399,Chandraker; Manmohan Krishna,0,0,0,0
1668240581625,CSE 290,B00,102400,Vaccaro; Kristen Marie,0,0,25,25
1668240581625,CSE 290,C00,102414,Pannuto; Patrick William,0,0,25,25
1668240581625,CSE 290,D00,102427,Pevzner; Pavel Arkadjevich,0,0,0,0
1668240581625,CSE 290,E00,102429,Zhao; Jishen,0,0,0,0
1668240581625,CSE 290,F00,102436,Tullsen; Dean Michael,0,0,0,0
1668240581625,CSE 290,G00,102440,Christensen; Henrik I,0,0,20,20
1668240582053,CSE 291,A00,102443,Su; Hao,0,0,0,0
1668240582053,CSE 291,B00,102448,Polikarpova; Nadezhda,0,0,0,0
1668240582053,CSE 291,C00,102453,Vaccaro; Kristen Marie,0,0,0,0
1668240582053,CSE 291,D00,111343,Savage; Stefan,0,0,0,0
1668240582053,CSE 291,E00,116474,Claffy; Kimberly Claire,0,0,0,0
1668240582053,CSE 291,F00,116479,Pasquale; Joseph,0,0,0,0
1668240582501,CSE 293,001,119111,Bafna; Vineet,9999,0,9999,0
1668240582501,CSE 293,002,119118,Bellare; Mihir,9999,0,9999,0
1668240582501,CSE 293,003,119122,Berg-Kirkpatrick; Taylor D,9999,0,9999,0
1668240582501,CSE 293,004,119135,Christensen; Henrik I,9999,0,9999,0
1668240582501,CSE 293,005,119142,Cottrell; Garrison W,9999,0,9999,0
1668240582501,CSE 293,006,119146,Deutsch; Alin Bernard,9999,0,9999,0
1668240582501,CSE 293,007,119159,Esmaeilzadeh; Hadi,9999,0,9999,0
1668240582501,CSE 293,008,119166,Freund; Yoav,9999,0,9999,0
1668240582501,CSE 293,009,119170,Griswold; William G.,9999,0,9999,0
1668240582501,CSE 293,010,119183,Gymrek; Melissa Ann,9999,0,9999,0
1668240582501,CSE 293,011,119190,Heninger; Nadia A,9999,0,9999,0
1668240582501,CSE 293,012,119230,Impagliazzo; Russell,9999,0,9999,0
1668240582501,CSE 293,013,119232,Jhala; Ranjit,9999,0,9999,0
1668240582501,CSE 293,014,119233,Kahng; Andrew Byun,9999,0,9999,0
1668240582501,CSE 293,015,119298,Kane; Daniel Mertz,9999,0,9999,0
1668240582501,CSE 293,016,119299,Kriegman; David J,9999,0,9999,0
1668240582501,CSE 293,017,119300,Kumar; Arun Kumar,9999,0,9999,0
1668240582501,CSE 293,018,119301,Lerner; Sorin,9999,0,9999,0
1668240582501,CSE 293,019,119302,Lovett; Shachar,9999,0,9999,0
1668240582501,CSE 293,020,119303,McAuley; Julian John,9999,0,9999,0
1668240582501,CSE 293,021,119304,Micciancio; Daniele,9999,0,9999,0
1668240582501,CSE 293,022,119367,Orailoglu; Alex,9999,0,9999,0
1668240582501,CSE 293,023,119382,Paturi; Ramamohan,9999,0,9999,0
1668240582501,CSE 293,024,119404,Polikarpova; Nadezhda,9999,0,9999,0
1668240582501,CSE 293,025,119406,Politz; Joseph Gibbs,9999,0,9999,0
1668240582501,CSE 293,026,119411,Porter; George M,9999,0,9999,0
1668240582501,CSE 293,027,119414,Porter; Leonard Emerson,9999,0,9999,0
1668240582501,CSE 293,028,119416,Ramamoorthi; Ravi,9999,0,9999,0
1668240582501,CSE 293,029,119417,Sahoo; Debashis,9999,0,9999,0
1668240582501,CSE 293,030,119420,Saul; Lawrence,9999,0,9999,0
1668240582501,CSE 293,031,119421,Savage; Stefan,9999,0,9999,0
1668240582501,CSE 293,032,119425,Schulze; Jurgen P.,9999,0,9999,0
1668240582501,CSE 293,033,119426,Snoeren; Alex C.,9999,0,9999,0
1668240582501,CSE 293,034,119428,Shang; Jingbo,9999,0,9999,0
1668240582501,CSE 293,035,119430,Stefan; Deian,9999,0,9999,0
1668240582501,CSE 293,036,119431,Su; Hao,9999,0,9999,0
1668240582501,CSE 293,037,119433,Swanson; Steven James,9999,0,9999,0
1668240582501,CSE 293,038,119435,Tullsen; Dean Michael,9999,0,9999,0
1668240582501,CSE 293,039,119483,Voelker; Geoffrey M.,9999,0,9999,0
1668240582501,CSE 293,040,119537,Zhao; Jishen,9999,0,9999,0
1668240582501,CSE 293,041,119538,Zhou; Yuan-Yuan,9999,0,9999,0
1668240582501,CSE 293,042,119539,Gao; Sicun,9999,0,9999,0
1668240582501,CSE 293,043,119540,Weibel; Nadir,9999,0,9999,0
1668240582501,CSE 293,044,119541,Gupta; Rajesh K.,9999,0,9999,0
1668240582501,CSE 293,045,126410,Vaccaro; Kristen Marie,9999,0,9999,0
1668240582501,CSE 293,046,126411,Klemke; Richard,9999,0,9999,0
1668240582928,CSE 294,A00,102459,Voelker; Geoffrey M.,0,0,0,0
1668240582928,CSE 294,B00,111322,Orailoglu; Alex,0,0,0,0
1668240583352,DSE 201,A00,096914,Deutsch; Alin Bernard,30,0,30,0
1668240583778,DSE 210,A00,096915,Dasgupta; Sanjoy,30,0,30,0
1668240584202,DSE 260A,A00,096916,Altintas De Callaf; Ilkay,30,0,30,0
1668240584628,ECE 200,001,103586,Antipa; Nicholas A,9999,0,9999,0
1668240584628,ECE 200,002,103587,Atanasov; Nikolay A.,9999,0,9999,0
1668240584628,ECE 200,003,103588,Bharadia; Dinesh,9999,0,9999,0
1668240584628,ECE 200,004,103589,Cheng; Chung Kuan,9999,0,9999,0
1668240584628,ECE 200,005,103590,Cosman; Pamela C.,9999,0,9999,0
1668240584628,ECE 200,006,103591,Dayeh; Shadi Ahmad,9999,0,9999,0
1668240584628,ECE 200,007,103592,Fainman; Yeshaiahu,9999,0,9999,0
1668240584628,ECE 200,008,103593,Ford; Joseph Earl,9999,0,9999,0
1668240584628,ECE 200,009,103594,Franceschetti; Massimo,9999,0,9999,0
1668240584628,ECE 200,010,103595,Fullerton; Eric E,9999,0,9999,0
1668240584628,ECE 200,011,103596,Galton; Ian A,9999,0,9999,0
1668240584628,ECE 200,012,103597,Gilja; Vikash,9999,0,9999,0
1668240584628,ECE 200,013,103598,Hall; Drew A.,9999,0,9999,0
1668240584628,ECE 200,014,103599,Hsueh; Tzu-Chien,9999,0,9999,0
1668240584628,ECE 200,015,103600,Javidi; Tara,9999,0,9999,0
1668240584628,ECE 200,016,103601,Kahng; Andrew Byun,9999,0,9999,0
1668240584628,ECE 200,017,103602,Kim; Young-Han,9999,0,9999,0
1668240584628,ECE 200,018,103603,Koushanfar; Farinaz,9999,0,9999,0
1668240584628,ECE 200,019,103604,Kuzum; Duygu,9999,0,9999,0
1668240584628,ECE 200,020,103605,Le; Hanh-Phuc,9999,0,9999,0
1668240584628,ECE 200,021,103606,Lin; Bill,9999,0,9999,0
1668240584628,ECE 200,022,103607,Liu; Zhaowei,9998,0,9999,1
1668240584628,ECE 200,023,103608,Lo; Yu-Hwa,9999,0,9999,0
1668240584628,ECE 200,024,103609,Lomakin; Vitaliy,9999,0,9999,0
1668240584628,ECE 200,025,103610,Mercier; Patrick Philip,9999,0,9999,0
1668240584628,ECE 200,026,103611,Meyer; Florian,9999,0,9999,0
1668240584628,ECE 200,027,103612,Milstein; Laurence B.,9999,0,9999,0
1668240584628,ECE 200,028,103613,Mir Arabbaygi; Siavash,9999,0,9999,0
1668240584628,ECE 200,029,103614,Mookherjea; Shayan,9999,0,9999,0
1668240584628,ECE 200,030,103615,Morris; Karcher William,9999,0,9999,0
1668240584628,ECE 200,031,103616,Ng; Tse Nga,9999,0,9999,0
1668240584628,ECE 200,032,103617,Nguyen; Truong Quang,9999,0,9999,0
1668240584628,ECE 200,033,103618,Nomura; Kenji,9999,0,9999,0
1668240584628,ECE 200,034,103619,Orlitsky; Alon,9999,0,9999,0
1668240584628,ECE 200,035,103620,Pal; Piya,9999,0,9999,0
1668240584628,ECE 200,036,103621,Papen; George C.,9999,0,9999,0
1668240584628,ECE 200,037,103622,Radic; Stojan,9999,0,9999,0
1668240584628,ECE 200,038,103623,Rao; Bhaskar D.,9999,0,9999,0
1668240584628,ECE 200,039,103624,Rao; Ramesh R,9999,0,9999,0
1668240584628,ECE 200,040,103625,Rebeiz; Gabriel,9999,0,9999,0
1668240584628,ECE 200,041,103626,Sanford; John R,9999,0,9999,0
1668240584628,ECE 200,042,103627,Siegel; Paul H.,9999,0,9999,0
1668240584628,ECE 200,043,103628,Sievenpiper; Daniel F.,9999,0,9999,0
1668240584628,ECE 200,044,103629,Sworder; David D.,9999,0,9999,0
1668240584628,ECE 200,045,103630,Taur; Yuan,9999,0,9999,0
1668240584628,ECE 200,046,103631,Touri; Behrouz,9999,0,9999,0
1668240584628,ECE 200,047,103632,Trivedi; Mohan M.,9999,0,9999,0
1668240584628,ECE 200,048,103633,Vasconcelos; Nuno,9999,0,9999,0
1668240584628,ECE 200,049,103634,Wang; Xiaolong,9999,0,9999,0
1668240584628,ECE 200,050,103635,Xie; Pengtao,9999,0,9999,0
1668240584628,ECE 200,051,103636,Yip; Michael,9999,0,9999,0
1668240584628,ECE 200,052,103637,Zeger; Kenneth A.,999,0,999,0
1668240584628,ECE 200,053,103638,Zhang; Xinyu,9999,0,9999,0
1668240584628,ECE 200,054,103639,Turakhia; Yatish Girish,9999,0,9999,0
1668240584628,ECE 200,055,103640,Kang; Mingu,9999,0,9999,0
1668240584628,ECE 200,056,103641,Shi; Yuanyuan,9999,0,9999,0
1668240584628,ECE 200,057,103642,Wang; Edward Jay,9999,0,9999,0
1668240584628,ECE 200,058,103643,Zheng; Yang,9999,0,9999,0
1668240585051,ECE 202,A00,103644,Kuzum; Duygu,0,0,0,0
1668240585473,ECE 212BN,A00,103646,Ng; Tse Nga,0,0,0,0
1668240585897,ECE 221,A00,111493,Staff,0,0,0,0
1668240586322,ECE 222B,A00,103647,Lomakin; Vitaliy,0,0,0,0
1668240586750,ECE 230B,A00,103648,Taur; Yuan,0,0,0,0
1668240587176,ECE 238B,A00,103649,Garay; Javier,0,0,0,0
1668240587601,ECE 240B,A00,112900,Fainman; Yeshaiahu,0,0,0,0
1668240588030,ECE 247A,A00,103650,Jokerst; Jesse Vincent,0,0,0,0
1668240588452,ECE 247B,A00,103651,Wang; Joseph,0,0,0,0
1668240588878,ECE 250,A00,103652,Siegel; Paul H.,0,0,0,0
1668240589306,ECE 251A,A00,103654,Rao; Bhaskar D.,0,0,0,0
1668240589732,ECE 257B,A00,103655,Bharadia; Dinesh,0,0,0,0
1668240590169,ECE 258A,A00,103656,Milstein; Laurence B.,0,0,0,0
1668240590593,ECE 260B,A00,103658,Kang; Mingu,0,0,0,0
1668240591026,ECE 264A,A00,103659,Galton; Ian A,0,0,0,0
1668240591448,ECE 265A,A00,103661,Gudem; Prasad S.S.,0,0,0,0
1668240591873,ECE 265D,A00,103662,Gudem; Prasad S.S.,0,0,0,0
1668240592296,ECE 268,A00,103663,Koushanfar; Farinaz,0,0,0,0
1668240592721,ECE 269,A01,103665,Pal; Piya,0,0,0,0
1668240593145,ECE 271B,A00,103666,Vasconcelos; Manuela,0,0,0,0
1668240593572,ECE 276A,A00,103667,Atanasov; Nikolay A.,0,0,0,0
1668240593997,ECE 277,A00,103668,An; Cheolhong,0,0,0,0
1668240594419,ECE 279,A00,117947,Hall; Drew A.,0,0,0,0
1668240595271,ECE 283,A00,103670,Hsueh; Tzu-Chien,0,0,0,0
1668240595694,ECE 284,A00,103671,Turakhia; Yatish Girish,0,0,0,0
1668240596122,ECE 285,A00,103672,Zheng; Yang,0,0,0,0
1668240596122,ECE 285,B00,103673,Sworder; David D.,0,0,0,0
1668240596560,ECE 287,A00,103676,Javidi; Tara,0,0,0,0
1668240596985,MATH 200B,A00,098023,Salehi Golsefidy; Alireza,12,0,15,3
1668240597409,MATH 202B,A00,098024,Rhoades; Brendon Patrick,9,0,15,6
1668240597854,MATH 203B,A00,098025,Oprea; Dragos N.,10,0,15,5
1668240598288,MATH 204B,A00,098026,Sorensen; Claus M,13,0,15,2
1668240598720,MATH 208,A00,098027,Izadi; Elham,7,0,10,3
1668240599145,MATH 209,A00,098028,Pollack; Aaron,10,0,10,0
1668240599569,MATH 211A,A00,112919,Rogalski; Daniel,9,0,10,1
1668240599998,MATH 211B,A00,112920,Seward; Brandon M.,9,0,10,1
1668240600422,MATH 218,A00,098029,Li; Bo,10,0,10,0
1668240600850,MATH 220B,A00,098030,Novak; Jonathan I,11,0,15,4
1668240601276,MATH 221A,A00,098031,Ebenfelt; Peter F,13,0,15,2
1668240601703,MATH 231B,A00,098032,Zlatos; Andrej,12,0,15,3
1668240602128,MATH 240B,A00,098033,Ni; Lei,9,0,15,6
1668240602559,MATH 243,A00,098034,Jekel; David Andrew,10,0,10,0
1668240602992,MATH 245A,A00,098035,Nie; Jiawang,0,0,15,16
1668240603418,MATH 248,A00,098036,Bejenaru; Ioan,10,0,10,0
1668240603843,MATH 250B,A00,098037,Spolaor; Luca,14,0,15,1
1668240604268,MATH 258,A00,098038,Ni; Lei,10,0,10,0
1668240604692,MATH 264B,A00,098041,Rhoades; Brendon Patrick,9,0,15,6
1668240605122,MATH 268,A00,098042,Buss; Samuel R,10,0,10,0
1668240605550,MATH 269,A00,098043,Rhoades; Brendon Patrick,10,0,10,0
1668240605977,MATH 270B,A00,098044,Li; Bo,10,0,15,5
1668240606406,MATH 272B,A00,098045,Holst; Michael J,13,0,15,2
1668240606838,MATH 273A,A00,098046,Tian; Xiaochuan,10,0,15,5
1668240607263,MATH 275,A01,098048,Tian; Xiaochuan,6,0,10,4
1668240607687,MATH 278A,A00,098049,Holst; Michael J,8,0,10,2
1668240608111,MATH 278B,A00,098050,Cloninger; Alexander,10,0,10,0
1668240608536,MATH 278C,A00,098051,Nie; Jiawang,7,0,10,3
1668240609057,MATH 280B,A00,098052,Zheng; Tianyi,10,0,15,5
1668240609479,MATH 281B,A00,098053,Bradic; Jelena,1,0,15,14
1668240609903,MATH 282B,A00,098054,Arias-Castro; Ery,0,0,15,15
1668240610334,MATH 285,A00,098055,Fitzsimmons; Patrick J,0,0,15,17
1668240610759,MATH 287B,A00,098056,Arias-Castro; Ery,2,0,15,13
1668240611201,MATH 288,A00,098057,Agarwal; Pooja,9,0,10,1
1668240611201,MATH 288,B00,098058,Zhang; Danna,8,0,10,2
1668240611201,MATH 288,C00,098059,Williams; Ruth J,10,0,10,0
1668240611625,MATH 290B,A00,098060,Roberts; Justin Deritter,13,0,15,2
1668240612049,MATH 292,A00,098061,Belmont; Eva Kinoshita,10,0,10,0
1668240612479,MATH 295,A00,098062,Suk; Andrew Hoon,48,0,50,2
1668240612906,MATH 296,A00,098063,Novak; Jonathan I,20,0,20,0
1668240613331,MATH 297,001,098064,Gamst; Anthony Collins,9997,0,9999,2
1668241117805,COGS 205,A00,101395,Chiba; Andrea,19,0,20,1
1668241118232,COGS 210B,001,101404,Greene; Deanna Jacquelyn,9998,0,9999,1
1668241118232,COGS 210B,002,101417,Xia; Haijun,9999,0,9999,0
1668241118232,COGS 210B,003,101422,Nitz; Douglas A.,9999,0,9999,0
1668241118232,COGS 210B,004,101423,Hollan; James D.,9998,0,9999,1
1668241118232,COGS 210B,005,101424,Deak; Gedeon O.,9998,0,9999,1
1668241118232,COGS 210B,006,101425,Rossano; Federico,9999,0,9999,0
1668241118657,COGS 211B,A00,101427,Coulson; Seana M,9996,0,9999,3
1668241119084,COGS 220,A00,101428,Hollan; James D.,0,0,25,25
1668241119517,COGS 229,A00,101429,Dow; Steven P,18,0,25,7
1668241119951,COGS 230,A00,101430,Klemmer; Scott R,12,0,17,5
1668241120379,COGS 234,A00,101431,Xia; Haijun,2,0,25,23
1668241120810,COGS 260,A00,101432,Kiyonaga; Anastasia,21,0,25,4
1668241120810,COGS 260,B00,101433,Kirsh; David Joel,15,0,25,10
1668241121236,CSE 202,A00,102371,Impagliazzo; Russell,0,0,0,0
1668241121662,CSE 203B,A01,102373,Cheng; Chung Kuan,0,0,0,0
1668241122087,CSE 208,A00,102374,Micciancio; Daniele,0,0,0,0
1668241122514,CSE 209A,A00,112895,Impagliazzo; Russell,0,0,15,15
1668241122939,CSE 209B,A00,108005,Bellare; Mihir,0,0,0,0
1668241123363,CSE 210,A00,113163,Coblenz; Michael J,0,0,0,0
1668241123799,CSE 219,A00,106111,Dow; Steven P,0,0,20,20
1668241124239,CSE 221,A00,102376,Voelker; Geoffrey M.,0,0,0,0
1668241124674,CSE 224,A01,102378,Porter; George M,0,0,0,0
1668241125105,CSE 229A,A00,102379,Savage; Stefan,0,0,0,0
1668241125542,CSE 229C,A00,102380,Munyaka; Imani N. S.,0,0,0,0
1668241125972,CSE 232B,A00,102382,Deutsch; Alin Bernard,0,0,0,0
1668241126394,CSE 234,A01,112904,Kumar; Arun Kumar,0,0,0,0
1668241126819,CSE 237A,A00,102383,Rosing; Tajana Simunic,0,0,0,0
1668241127248,CSE 239A,A00,102384,Deutsch; Alin Bernard,0,0,0,0
1668241127670,CSE 239B,A00,102385,Polikarpova; Nadezhda,0,0,0,0
1668241128100,CSE 240A,A00,102386,Pannuto; Patrick William,0,0,0,0
1668241128526,CSE 240B,A00,102387,Zhao; Jishen,0,0,0,0
1668241128950,CSE 241A,A00,106406,Kang; Mingu,0,0,0,0
1668241129374,CSE 249B,A00,102388,Kahng; Andrew Byun,0,0,8,8
1668241129799,CSE 251B,A01,102392,Cottrell; Garrison W,0,0,0,0
1668241129799,CSE 251B,A02,102393,Cottrell; Garrison W,0,0,0,0
1668241130246,CSE 252B,A00,102394,Ochoa; Benjamin Lawrence,0,0,0,0
1668241130670,CSE 257,A01,102396,Gao; Sicun,0,0,0,0
1668241131106,CSE 272,A00,102397,Li; Tzumao,0,0,0,0
1668241131530,CSE 274,A00,111323,Chern; Albert Ren-Haur,0,0,0,0
1668241131958,CSE 282,A00,102398,Pevzner; Pavel Arkadjevich,0,0,0,0
1668241132382,CSE 284,A00,114175,Gymrek; Melissa Ann,0,0,0,0
1668241132811,CSE 290,A00,102399,Chandraker; Manmohan Krishna,0,0,0,0
1668241132811,CSE 290,B00,102400,Vaccaro; Kristen Marie,0,0,25,25
1668241132811,CSE 290,C00,102414,Pannuto; Patrick William,0,0,25,25
1668241132811,CSE 290,D00,102427,Pevzner; Pavel Arkadjevich,0,0,0,0
1668241132811,CSE 290,E00,102429,Zhao; Jishen,0,0,0,0
1668241132811,CSE 290,F00,102436,Tullsen; Dean Michael,0,0,0,0
1668241132811,CSE 290,G00,102440,Christensen; Henrik I,0,0,20,20
1668241133236,CSE 291,A00,102443,Su; Hao,0,0,0,0
1668241133236,CSE 291,B00,102448,Polikarpova; Nadezhda,0,0,0,0
1668241133236,CSE 291,C00,102453,Vaccaro; Kristen Marie,0,0,0,0
1668241133236,CSE 291,D00,111343,Savage; Stefan,0,0,0,0
1668241133236,CSE 291,E00,116474,Claffy; Kimberly Claire,0,0,0,0
1668241133236,CSE 291,F00,116479,Pasquale; Joseph,0,0,0,0
1668241133783,CSE 293,001,119111,Bafna; Vineet,9999,0,9999,0
1668241133783,CSE 293,002,119118,Bellare; Mihir,9999,0,9999,0
1668241133783,CSE 293,003,119122,Berg-Kirkpatrick; Taylor D,9999,0,9999,0
1668241133783,CSE 293,004,119135,Christensen; Henrik I,9999,0,9999,0
1668241133783,CSE 293,005,119142,Cottrell; Garrison W,9999,0,9999,0
1668241133783,CSE 293,006,119146,Deutsch; Alin Bernard,9999,0,9999,0
1668241133783,CSE 293,007,119159,Esmaeilzadeh; Hadi,9999,0,9999,0
1668241133783,CSE 293,008,119166,Freund; Yoav,9999,0,9999,0
1668241133783,CSE 293,009,119170,Griswold; William G.,9999,0,9999,0
1668241133783,CSE 293,010,119183,Gymrek; Melissa Ann,9999,0,9999,0
1668241133783,CSE 293,011,119190,Heninger; Nadia A,9999,0,9999,0
1668241133783,CSE 293,012,119230,Impagliazzo; Russell,9999,0,9999,0
1668241133783,CSE 293,013,119232,Jhala; Ranjit,9999,0,9999,0
1668241133783,CSE 293,014,119233,Kahng; Andrew Byun,9999,0,9999,0
1668241133783,CSE 293,015,119298,Kane; Daniel Mertz,9999,0,9999,0
1668241133783,CSE 293,016,119299,Kriegman; David J,9999,0,9999,0
1668241133783,CSE 293,017,119300,Kumar; Arun Kumar,9999,0,9999,0
1668241133783,CSE 293,018,119301,Lerner; Sorin,9999,0,9999,0
1668241133783,CSE 293,019,119302,Lovett; Shachar,9999,0,9999,0
1668241133783,CSE 293,020,119303,McAuley; Julian John,9999,0,9999,0
1668241133783,CSE 293,021,119304,Micciancio; Daniele,9999,0,9999,0
1668241133783,CSE 293,022,119367,Orailoglu; Alex,9999,0,9999,0
1668241133783,CSE 293,023,119382,Paturi; Ramamohan,9999,0,9999,0
1668241133783,CSE 293,024,119404,Polikarpova; Nadezhda,9999,0,9999,0
1668241133783,CSE 293,025,119406,Politz; Joseph Gibbs,9999,0,9999,0
1668241133783,CSE 293,026,119411,Porter; George M,9999,0,9999,0
1668241133783,CSE 293,027,119414,Porter; Leonard Emerson,9999,0,9999,0
1668241133783,CSE 293,028,119416,Ramamoorthi; Ravi,9999,0,9999,0
1668241133783,CSE 293,029,119417,Sahoo; Debashis,9999,0,9999,0
1668241133783,CSE 293,030,119420,Saul; Lawrence,9999,0,9999,0
1668241133783,CSE 293,031,119421,Savage; Stefan,9999,0,9999,0
1668241133783,CSE 293,032,119425,Schulze; Jurgen P.,9999,0,9999,0
1668241133783,CSE 293,033,119426,Snoeren; Alex C.,9999,0,9999,0
1668241133783,CSE 293,034,119428,Shang; Jingbo,9999,0,9999,0
1668241133783,CSE 293,035,119430,Stefan; Deian,9999,0,9999,0
1668241133783,CSE 293,036,119431,Su; Hao,9999,0,9999,0
1668241133783,CSE 293,037,119433,Swanson; Steven James,9999,0,9999,0
1668241133783,CSE 293,038,119435,Tullsen; Dean Michael,9999,0,9999,0
1668241133783,CSE 293,039,119483,Voelker; Geoffrey M.,9999,0,9999,0
1668241133783,CSE 293,040,119537,Zhao; Jishen,9999,0,9999,0
1668241133783,CSE 293,041,119538,Zhou; Yuan-Yuan,9999,0,9999,0
1668241133783,CSE 293,042,119539,Gao; Sicun,9999,0,9999,0
1668241133783,CSE 293,043,119540,Weibel; Nadir,9999,0,9999,0
1668241133783,CSE 293,044,119541,Gupta; Rajesh K.,9999,0,9999,0
1668241133783,CSE 293,045,126410,Vaccaro; Kristen Marie,9999,0,9999,0
1668241133783,CSE 293,046,126411,Klemke; Richard,9999,0,9999,0
1668241134207,CSE 294,A00,102459,Voelker; Geoffrey M.,0,0,0,0
1668241134207,CSE 294,B00,111322,Orailoglu; Alex,0,0,0,0
1668241134630,DSE 201,A00,096914,Deutsch; Alin Bernard,30,0,30,0
1668241135056,DSE 210,A00,096915,Dasgupta; Sanjoy,30,0,30,0
1668241135485,DSE 260A,A00,096916,Altintas De Callaf; Ilkay,30,0,30,0
1668241135928,ECE 200,001,103586,Antipa; Nicholas A,9999,0,9999,0
1668241135928,ECE 200,002,103587,Atanasov; Nikolay A.,9999,0,9999,0
1668241135928,ECE 200,003,103588,Bharadia; Dinesh,9999,0,9999,0
1668241135928,ECE 200,004,103589,Cheng; Chung Kuan,9999,0,9999,0
1668241135928,ECE 200,005,103590,Cosman; Pamela C.,9999,0,9999,0
1668241135928,ECE 200,006,103591,Dayeh; Shadi Ahmad,9999,0,9999,0
1668241135928,ECE 200,007,103592,Fainman; Yeshaiahu,9999,0,9999,0
1668241135928,ECE 200,008,103593,Ford; Joseph Earl,9999,0,9999,0
1668241135928,ECE 200,009,103594,Franceschetti; Massimo,9999,0,9999,0
1668241135928,ECE 200,010,103595,Fullerton; Eric E,9999,0,9999,0
1668241135928,ECE 200,011,103596,Galton; Ian A,9999,0,9999,0
1668241135928,ECE 200,012,103597,Gilja; Vikash,9999,0,9999,0
1668241135928,ECE 200,013,103598,Hall; Drew A.,9999,0,9999,0
1668241135928,ECE 200,014,103599,Hsueh; Tzu-Chien,9999,0,9999,0
1668241135928,ECE 200,015,103600,Javidi; Tara,9999,0,9999,0
1668241135928,ECE 200,016,103601,Kahng; Andrew Byun,9999,0,9999,0
1668241135928,ECE 200,017,103602,Kim; Young-Han,9999,0,9999,0
1668241135928,ECE 200,018,103603,Koushanfar; Farinaz,9999,0,9999,0
1668241135928,ECE 200,019,103604,Kuzum; Duygu,9999,0,9999,0
1668241135928,ECE 200,020,103605,Le; Hanh-Phuc,9999,0,9999,0
1668241135928,ECE 200,021,103606,Lin; Bill,9999,0,9999,0
1668241135928,ECE 200,022,103607,Liu; Zhaowei,9998,0,9999,1
1668241135928,ECE 200,023,103608,Lo; Yu-Hwa,9999,0,9999,0
1668241135928,ECE 200,024,103609,Lomakin; Vitaliy,9999,0,9999,0
1668241135928,ECE 200,025,103610,Mercier; Patrick Philip,9999,0,9999,0
1668241135928,ECE 200,026,103611,Meyer; Florian,9999,0,9999,0
1668241135928,ECE 200,027,103612,Milstein; Laurence B.,9999,0,9999,0
1668241135928,ECE 200,028,103613,Mir Arabbaygi; Siavash,9999,0,9999,0
1668241135928,ECE 200,029,103614,Mookherjea; Shayan,9999,0,9999,0
1668241135928,ECE 200,030,103615,Morris; Karcher William,9999,0,9999,0
1668241135928,ECE 200,031,103616,Ng; Tse Nga,9999,0,9999,0
1668241135928,ECE 200,032,103617,Nguyen; Truong Quang,9999,0,9999,0
1668241135928,ECE 200,033,103618,Nomura; Kenji,9999,0,9999,0
1668241135928,ECE 200,034,103619,Orlitsky; Alon,9999,0,9999,0
1668241135928,ECE 200,035,103620,Pal; Piya,9999,0,9999,0
1668241135928,ECE 200,036,103621,Papen; George C.,9999,0,9999,0
1668241135928,ECE 200,037,103622,Radic; Stojan,9999,0,9999,0
1668241135928,ECE 200,038,103623,Rao; Bhaskar D.,9999,0,9999,0
1668241135928,ECE 200,039,103624,Rao; Ramesh R,9999,0,9999,0
1668241135928,ECE 200,040,103625,Rebeiz; Gabriel,9999,0,9999,0
1668241135928,ECE 200,041,103626,Sanford; John R,9999,0,9999,0
1668241135928,ECE 200,042,103627,Siegel; Paul H.,9999,0,9999,0
1668241135928,ECE 200,043,103628,Sievenpiper; Daniel F.,9999,0,9999,0
1668241135928,ECE 200,044,103629,Sworder; David D.,9999,0,9999,0
1668241135928,ECE 200,045,103630,Taur; Yuan,9999,0,9999,0
1668241135928,ECE 200,046,103631,Touri; Behrouz,9999,0,9999,0
1668241135928,ECE 200,047,103632,Trivedi; Mohan M.,9999,0,9999,0
1668241135928,ECE 200,048,103633,Vasconcelos; Nuno,9999,0,9999,0
1668241135928,ECE 200,049,103634,Wang; Xiaolong,9999,0,9999,0
1668241135928,ECE 200,050,103635,Xie; Pengtao,9999,0,9999,0
1668241135928,ECE 200,051,103636,Yip; Michael,9999,0,9999,0
1668241135928,ECE 200,052,103637,Zeger; Kenneth A.,999,0,999,0
1668241135928,ECE 200,053,103638,Zhang; Xinyu,9999,0,9999,0
1668241135928,ECE 200,054,103639,Turakhia; Yatish Girish,9999,0,9999,0
1668241135928,ECE 200,055,103640,Kang; Mingu,9999,0,9999,0
1668241135928,ECE 200,056,103641,Shi; Yuanyuan,9999,0,9999,0
1668241135928,ECE 200,057,103642,Wang; Edward Jay,9999,0,9999,0
1668241135928,ECE 200,058,103643,Zheng; Yang,9999,0,9999,0
1668241136353,ECE 202,A00,103644,Kuzum; Duygu,0,0,0,0
1668241136780,ECE 212BN,A00,103646,Ng; Tse Nga,0,0,0,0
1668241137207,ECE 221,A00,111493,Staff,0,0,0,0
1668241137640,ECE 222B,A00,103647,Lomakin; Vitaliy,0,0,0,0
1668241138077,ECE 230B,A00,103648,Taur; Yuan,0,0,0,0
1668241138509,ECE 238B,A00,103649,Garay; Javier,0,0,0,0
1668241138938,ECE 240B,A00,112900,Fainman; Yeshaiahu,0,0,0,0
1668241139375,ECE 247A,A00,103650,Jokerst; Jesse Vincent,0,0,0,0
1668241139801,ECE 247B,A00,103651,Wang; Joseph,0,0,0,0
1668241140229,ECE 250,A00,103652,Siegel; Paul H.,0,0,0,0
1668241140661,ECE 251A,A00,103654,Rao; Bhaskar D.,0,0,0,0
1668241141100,ECE 257B,A00,103655,Bharadia; Dinesh,0,0,0,0
1668241141527,ECE 258A,A00,103656,Milstein; Laurence B.,0,0,0,0
1668241141965,ECE 260B,A00,103658,Kang; Mingu,0,0,0,0
1668241142390,ECE 264A,A00,103659,Galton; Ian A,0,0,0,0
1668241142819,ECE 265A,A00,103661,Gudem; Prasad S.S.,0,0,0,0
1668241143246,ECE 265D,A00,103662,Gudem; Prasad S.S.,0,0,0,0
1668241143671,ECE 268,A00,103663,Koushanfar; Farinaz,0,0,0,0
1668241144097,ECE 269,A01,103665,Pal; Piya,0,0,0,0
1668241144523,ECE 271B,A00,103666,Vasconcelos; Manuela,0,0,0,0
1668241144953,ECE 276A,A00,103667,Atanasov; Nikolay A.,0,0,0,0
1668241145382,ECE 277,A00,103668,An; Cheolhong,0,0,0,0
1668241145807,ECE 279,A00,117947,Hall; Drew A.,0,0,0,0
1668241146663,ECE 283,A00,103670,Hsueh; Tzu-Chien,0,0,0,0
1668241147092,ECE 284,A00,103671,Turakhia; Yatish Girish,0,0,0,0
1668241147520,ECE 285,A00,103672,Zheng; Yang,0,0,0,0
1668241147520,ECE 285,B00,103673,Sworder; David D.,0,0,0,0
1668241147947,ECE 287,A00,103676,Javidi; Tara,0,0,0,0
1668241148377,MATH 200B,A00,098023,Salehi Golsefidy; Alireza,12,0,15,3
1668241148801,MATH 202B,A00,098024,Rhoades; Brendon Patrick,9,0,15,6
1668241149226,MATH 203B,A00,098025,Oprea; Dragos N.,10,0,15,5
1668241149651,MATH 204B,A00,098026,Sorensen; Claus M,13,0,15,2
1668241150078,MATH 208,A00,098027,Izadi; Elham,7,0,10,3
1668241150500,MATH 209,A00,098028,Pollack; Aaron,10,0,10,0
1668241150923,MATH 211A,A00,112919,Rogalski; Daniel,9,0,10,1
1668241151357,MATH 211B,A00,112920,Seward; Brandon M.,9,0,10,1
1668241151783,MATH 218,A00,098029,Li; Bo,10,0,10,0
1668241152208,MATH 220B,A00,098030,Novak; Jonathan I,11,0,15,4
1668241152638,MATH 221A,A00,098031,Ebenfelt; Peter F,13,0,15,2
1668241153066,MATH 231B,A00,098032,Zlatos; Andrej,12,0,15,3
1668241153498,MATH 240B,A00,098033,Ni; Lei,9,0,15,6
1668241153930,MATH 243,A00,098034,Jekel; David Andrew,10,0,10,0
1668241154356,MATH 245A,A00,098035,Nie; Jiawang,0,0,15,16
1668241154779,MATH 248,A00,098036,Bejenaru; Ioan,10,0,10,0
1668241155225,MATH 250B,A00,098037,Spolaor; Luca,14,0,15,1
1668241155648,MATH 258,A00,098038,Ni; Lei,10,0,10,0
1668241156080,MATH 264B,A00,098041,Rhoades; Brendon Patrick,9,0,15,6
1668241156506,MATH 268,A00,098042,Buss; Samuel R,10,0,10,0
1668241156932,MATH 269,A00,098043,Rhoades; Brendon Patrick,10,0,10,0
1668241157367,MATH 270B,A00,098044,Li; Bo,10,0,15,5
1668241157808,MATH 272B,A00,098045,Holst; Michael J,13,0,15,2
1668241158237,MATH 273A,A00,098046,Tian; Xiaochuan,10,0,15,5
1668241158664,MATH 275,A01,098048,Tian; Xiaochuan,6,0,10,4
1668241159093,MATH 278A,A00,098049,Holst; Michael J,8,0,10,2
1668241159517,MATH 278B,A00,098050,Cloninger; Alexander,10,0,10,0
1668241159942,MATH 278C,A00,098051,Nie; Jiawang,7,0,10,3
1668241160371,MATH 280B,A00,098052,Zheng; Tianyi,10,0,15,5
1668241160795,MATH 281B,A00,098053,Bradic; Jelena,1,0,15,14
1668241161219,MATH 282B,A00,098054,Arias-Castro; Ery,0,0,15,15
1668241161642,MATH 285,A00,098055,Fitzsimmons; Patrick J,0,0,15,17
1668241162066,MATH 287B,A00,098056,Arias-Castro; Ery,2,0,15,13
1668241162492,MATH 288,A00,098057,Agarwal; Pooja,9,0,10,1
1668241162492,MATH 288,B00,098058,Zhang; Danna,8,0,10,2
1668241162492,MATH 288,C00,098059,Williams; Ruth J,10,0,10,0
1668241162919,MATH 290B,A00,098060,Roberts; Justin Deritter,13,0,15,2
1668241163344,MATH 292,A00,098061,Belmont; Eva Kinoshita,10,0,10,0
1668241163768,MATH 295,A00,098062,Suk; Andrew Hoon,48,0,50,2
1668241164191,MATH 296,A00,098063,Novak; Jonathan I,20,0,20,0
1668241164619,MATH 297,001,098064,Gamst; Anthony Collins,9997,0,9999,2
1668241665827,COGS 205,A00,101395,Chiba; Andrea,19,0,20,1
1668241666251,COGS 210B,001,101404,Greene; Deanna Jacquelyn,9998,0,9999,1
1668241666251,COGS 210B,002,101417,Xia; Haijun,9999,0,9999,0
1668241666251,COGS 210B,003,101422,Nitz; Douglas A.,9999,0,9999,0
1668241666251,COGS 210B,004,101423,Hollan; James D.,9998,0,9999,1
1668241666251,COGS 210B,005,101424,Deak; Gedeon O.,9998,0,9999,1
1668241666251,COGS 210B,006,101425,Rossano; Federico,9999,0,9999,0
1668241666674,COGS 211B,A00,101427,Coulson; Seana M,9996,0,9999,3
1668241667098,COGS 220,A00,101428,Hollan; James D.,0,0,25,25
1668241667524,COGS 229,A00,101429,Dow; Steven P,18,0,25,7
1668241667946,COGS 230,A00,101430,Klemmer; Scott R,12,0,17,5
1668241668372,COGS 234,A00,101431,Xia; Haijun,2,0,25,23
1668241668797,COGS 260,A00,101432,Kiyonaga; Anastasia,21,0,25,4
1668241668797,COGS 260,B00,101433,Kirsh; David Joel,15,0,25,10
1668241669223,CSE 202,A00,102371,Impagliazzo; Russell,0,0,0,0
1668241669653,CSE 203B,A01,102373,Cheng; Chung Kuan,0,0,0,0
1668241670080,CSE 208,A00,102374,Micciancio; Daniele,0,0,0,0
1668241670510,CSE 209A,A00,112895,Impagliazzo; Russell,0,0,15,15
1668241670939,CSE 209B,A00,108005,Bellare; Mihir,0,0,0,0
1668241671377,CSE 210,A00,113163,Coblenz; Michael J,0,0,0,0
1668241671815,CSE 219,A00,106111,Dow; Steven P,0,0,20,20
1668241672242,CSE 221,A00,102376,Voelker; Geoffrey M.,0,0,0,0
1668241672668,CSE 224,A01,102378,Porter; George M,0,0,0,0
1668241673096,CSE 229A,A00,102379,Savage; Stefan,0,0,0,0
1668241673519,CSE 229C,A00,102380,Munyaka; Imani N. S.,0,0,0,0
1668241673946,CSE 232B,A00,102382,Deutsch; Alin Bernard,0,0,0,0
1668241674371,CSE 234,A01,112904,Kumar; Arun Kumar,0,0,0,0
1668241674803,CSE 237A,A00,102383,Rosing; Tajana Simunic,0,0,0,0
1668241675227,CSE 239A,A00,102384,Deutsch; Alin Bernard,0,0,0,0
1668241675653,CSE 239B,A00,102385,Polikarpova; Nadezhda,0,0,0,0
1668241676077,CSE 240A,A00,102386,Pannuto; Patrick William,0,0,0,0
1668241676505,CSE 240B,A00,102387,Zhao; Jishen,0,0,0,0
1668241676931,CSE 241A,A00,106406,Kang; Mingu,0,0,0,0
1668241677357,CSE 249B,A00,102388,Kahng; Andrew Byun,0,0,8,8
1668241677782,CSE 251B,A01,102392,Cottrell; Garrison W,0,0,0,0
1668241677782,CSE 251B,A02,102393,Cottrell; Garrison W,0,0,0,0
1668241678209,CSE 252B,A00,102394,Ochoa; Benjamin Lawrence,0,0,0,0
1668241678637,CSE 257,A01,102396,Gao; Sicun,0,0,0,0
1668241679063,CSE 272,A00,102397,Li; Tzumao,0,0,0,0
1668241679487,CSE 274,A00,111323,Chern; Albert Ren-Haur,0,0,0,0
1668241679911,CSE 282,A00,102398,Pevzner; Pavel Arkadjevich,0,0,0,0
1668241680344,CSE 284,A00,114175,Gymrek; Melissa Ann,0,0,0,0
1668241680766,CSE 290,A00,102399,Chandraker; Manmohan Krishna,0,0,0,0
1668241680766,CSE 290,B00,102400,Vaccaro; Kristen Marie,0,0,25,25
1668241680766,CSE 290,C00,102414,Pannuto; Patrick William,0,0,25,25
1668241680766,CSE 290,D00,102427,Pevzner; Pavel Arkadjevich,0,0,0,0
1668241680766,CSE 290,E00,102429,Zhao; Jishen,0,0,0,0
1668241680766,CSE 290,F00,102436,Tullsen; Dean Michael,0,0,0,0
1668241680766,CSE 290,G00,102440,Christensen; Henrik I,0,0,20,20
1668241681189,CSE 291,A00,102443,Su; Hao,0,0,0,0
1668241681189,CSE 291,B00,102448,Polikarpova; Nadezhda,0,0,0,0
1668241681189,CSE 291,C00,102453,Vaccaro; Kristen Marie,0,0,0,0
1668241681189,CSE 291,D00,111343,Savage; Stefan,0,0,0,0
1668241681189,CSE 291,E00,116474,Claffy; Kimberly Claire,0,0,0,0
1668241681189,CSE 291,F00,116479,Pasquale; Joseph,0,0,0,0
1668241681641,CSE 293,001,119111,Bafna; Vineet,9999,0,9999,0
1668241681641,CSE 293,002,119118,Bellare; Mihir,9999,0,9999,0
1668241681641,CSE 293,003,119122,Berg-Kirkpatrick; Taylor D,9999,0,9999,0
1668241681641,CSE 293,004,119135,Christensen; Henrik I,9999,0,9999,0
1668241681641,CSE 293,005,119142,Cottrell; Garrison W,9999,0,9999,0
1668241681641,CSE 293,006,119146,Deutsch; Alin Bernard,9999,0,9999,0
1668241681641,CSE 293,007,119159,Esmaeilzadeh; Hadi,9999,0,9999,0
1668241681641,CSE 293,008,119166,Freund; Yoav,9999,0,9999,0
1668241681641,CSE 293,009,119170,Griswold; William G.,9999,0,9999,0
1668241681641,CSE 293,010,119183,Gymrek; Melissa Ann,9999,0,9999,0
1668241681641,CSE 293,011,119190,Heninger; Nadia A,9999,0,9999,0
1668241681641,CSE 293,012,119230,Impagliazzo; Russell,9999,0,9999,0
1668241681641,CSE 293,013,119232,Jhala; Ranjit,9999,0,9999,0
1668241681641,CSE 293,014,119233,Kahng; Andrew Byun,9999,0,9999,0
1668241681641,CSE 293,015,119298,Kane; Daniel Mertz,9999,0,9999,0
1668241681641,CSE 293,016,119299,Kriegman; David J,9999,0,9999,0
1668241681641,CSE 293,017,119300,Kumar; Arun Kumar,9999,0,9999,0
1668241681641,CSE 293,018,119301,Lerner; Sorin,9999,0,9999,0
1668241681641,CSE 293,019,119302,Lovett; Shachar,9999,0,9999,0
1668241681641,CSE 293,020,119303,McAuley; Julian John,9999,0,9999,0
1668241681641,CSE 293,021,119304,Micciancio; Daniele,9999,0,9999,0
1668241681641,CSE 293,022,119367,Orailoglu; Alex,9999,0,9999,0
1668241681641,CSE 293,023,119382,Paturi; Ramamohan,9999,0,9999,0
1668241681641,CSE 293,024,119404,Polikarpova; Nadezhda,9999,0,9999,0
1668241681641,CSE 293,025,119406,Politz; Joseph Gibbs,9999,0,9999,0
1668241681641,CSE 293,026,119411,Porter; George M,9999,0,9999,0
1668241681641,CSE 293,027,119414,Porter; Leonard Emerson,9999,0,9999,0
1668241681641,CSE 293,028,119416,Ramamoorthi; Ravi,9999,0,9999,0
1668241681641,CSE 293,029,119417,Sahoo; Debashis,9999,0,9999,0
1668241681641,CSE 293,030,119420,Saul; Lawrence,9999,0,9999,0
1668241681641,CSE 293,031,119421,Savage; Stefan,9999,0,9999,0
1668241681641,CSE 293,032,119425,Schulze; Jurgen P.,9999,0,9999,0
1668241681641,CSE 293,033,119426,Snoeren; Alex C.,9999,0,9999,0
1668241681641,CSE 293,034,119428,Shang; Jingbo,9999,0,9999,0
1668241681641,CSE 293,035,119430,Stefan; Deian,9999,0,9999,0
1668241681641,CSE 293,036,119431,Su; Hao,9999,0,9999,0
1668241681641,CSE 293,037,119433,Swanson; Steven James,9999,0,9999,0
1668241681641,CSE 293,038,119435,Tullsen; Dean Michael,9999,0,9999,0
1668241681641,CSE 293,039,119483,Voelker; Geoffrey M.,9999,0,9999,0
1668241681641,CSE 293,040,119537,Zhao; Jishen,9999,0,9999,0
1668241681641,CSE 293,041,119538,Zhou; Yuan-Yuan,9999,0,9999,0
1668241681641,CSE 293,042,119539,Gao; Sicun,9999,0,9999,0
1668241681641,CSE 293,043,119540,Weibel; Nadir,9999,0,9999,0
1668241681641,CSE 293,044,119541,Gupta; Rajesh K.,9999,0,9999,0
1668241681641,CSE 293,045,126410,Vaccaro; Kristen Marie,9999,0,9999,0
1668241681641,CSE 293,046,126411,Klemke; Richard,9999,0,9999,0
1668241682065,CSE 294,A00,102459,Voelker; Geoffrey M.,0,0,0,0
1668241682065,CSE 294,B00,111322,Orailoglu; Alex,0,0,0,0
1668241682488,DSE 201,A00,096914,Deutsch; Alin Bernard,30,0,30,0
1668241682916,DSE 210,A00,096915,Dasgupta; Sanjoy,30,0,30,0
1668241683338,DSE 260A,A00,096916,Altintas De Callaf; Ilkay,30,0,30,0
1668241683777,ECE 200,001,103586,Antipa; Nicholas A,9999,0,9999,0
1668241683777,ECE 200,002,103587,Atanasov; Nikolay A.,9999,0,9999,0
1668241683777,ECE 200,003,103588,Bharadia; Dinesh,9999,0,9999,0
1668241683777,ECE 200,004,103589,Cheng; Chung Kuan,9999,0,9999,0
1668241683777,ECE 200,005,103590,Cosman; Pamela C.,9999,0,9999,0
1668241683777,ECE 200,006,103591,Dayeh; Shadi Ahmad,9999,0,9999,0
1668241683777,ECE 200,007,103592,Fainman; Yeshaiahu,9999,0,9999,0
1668241683777,ECE 200,008,103593,Ford; Joseph Earl,9999,0,9999,0
1668241683777,ECE 200,009,103594,Franceschetti; Massimo,9999,0,9999,0
1668241683777,ECE 200,010,103595,Fullerton; Eric E,9999,0,9999,0
1668241683777,ECE 200,011,103596,Galton; Ian A,9999,0,9999,0
1668241683777,ECE 200,012,103597,Gilja; Vikash,9999,0,9999,0
1668241683777,ECE 200,013,103598,Hall; Drew A.,9999,0,9999,0
1668241683777,ECE 200,014,103599,Hsueh; Tzu-Chien,9999,0,9999,0
1668241683777,ECE 200,015,103600,Javidi; Tara,9999,0,9999,0
1668241683777,ECE 200,016,103601,Kahng; Andrew Byun,9999,0,9999,0
1668241683777,ECE 200,017,103602,Kim; Young-Han,9999,0,9999,0
1668241683777,ECE 200,018,103603,Koushanfar; Farinaz,9999,0,9999,0
1668241683777,ECE 200,019,103604,Kuzum; Duygu,9999,0,9999,0
1668241683777,ECE 200,020,103605,Le; Hanh-Phuc,9999,0,9999,0
1668241683777,ECE 200,021,103606,Lin; Bill,9999,0,9999,0
1668241683777,ECE 200,022,103607,Liu; Zhaowei,9998,0,9999,1
1668241683777,ECE 200,023,103608,Lo; Yu-Hwa,9999,0,9999,0
1668241683777,ECE 200,024,103609,Lomakin; Vitaliy,9999,0,9999,0
1668241683777,ECE 200,025,103610,Mercier; Patrick Philip,9999,0,9999,0
1668241683777,ECE 200,026,103611,Meyer; Florian,9999,0,9999,0
1668241683777,ECE 200,027,103612,Milstein; Laurence B.,9999,0,9999,0
1668241683777,ECE 200,028,103613,Mir Arabbaygi; Siavash,9999,0,9999,0
1668241683777,ECE 200,029,103614,Mookherjea; Shayan,9999,0,9999,0
1668241683777,ECE 200,030,103615,Morris; Karcher William,9999,0,9999,0
1668241683777,ECE 200,031,103616,Ng; Tse Nga,9999,0,9999,0
1668241683777,ECE 200,032,103617,Nguyen; Truong Quang,9999,0,9999,0
1668241683777,ECE 200,033,103618,Nomura; Kenji,9999,0,9999,0
1668241683777,ECE 200,034,103619,Orlitsky; Alon,9999,0,9999,0
1668241683777,ECE 200,035,103620,Pal; Piya,9999,0,9999,0
1668241683777,ECE 200,036,103621,Papen; George C.,9999,0,9999,0
1668241683777,ECE 200,037,103622,Radic; Stojan,9999,0,9999,0
1668241683777,ECE 200,038,103623,Rao; Bhaskar D.,9999,0,9999,0
1668241683777,ECE 200,039,103624,Rao; Ramesh R,9999,0,9999,0
1668241683777,ECE 200,040,103625,Rebeiz; Gabriel,9999,0,9999,0
1668241683777,ECE 200,041,103626,Sanford; John R,9999,0,9999,0
1668241683777,ECE 200,042,103627,Siegel; Paul H.,9999,0,9999,0
1668241683777,ECE 200,043,103628,Sievenpiper; Daniel F.,9999,0,9999,0
1668241683777,ECE 200,044,103629,Sworder; David D.,9999,0,9999,0
1668241683777,ECE 200,045,103630,Taur; Yuan,9999,0,9999,0
1668241683777,ECE 200,046,103631,Touri; Behrouz,9999,0,9999,0
1668241683777,ECE 200,047,103632,Trivedi; Mohan M.,9999,0,9999,0
1668241683777,ECE 200,048,103633,Vasconcelos; Nuno,9999,0,9999,0
1668241683777,ECE 200,049,103634,Wang; Xiaolong,9999,0,9999,0
1668241683777,ECE 200,050,103635,Xie; Pengtao,9999,0,9999,0
1668241683777,ECE 200,051,103636,Yip; Michael,9999,0,9999,0
1668241683777,ECE 200,052,103637,Zeger; Kenneth A.,999,0,999,0
1668241683777,ECE 200,053,103638,Zhang; Xinyu,9999,0,9999,0
1668241683777,ECE 200,054,103639,Turakhia; Yatish Girish,9999,0,9999,0
1668241683777,ECE 200,055,103640,Kang; Mingu,9999,0,9999,0
1668241683777,ECE 200,056,103641,Shi; Yuanyuan,9999,0,9999,0
1668241683777,ECE 200,057,103642,Wang; Edward Jay,9999,0,9999,0
1668241683777,ECE 200,058,103643,Zheng; Yang,9999,0,9999,0
1668241684204,ECE 202,A00,103644,Kuzum; Duygu,0,0,0,0
1668241684633,ECE 212BN,A00,103646,Ng; Tse Nga,0,0,0,0
1668241685058,ECE 221,A00,111493,Staff,0,0,0,0
1668241685483,ECE 222B,A00,103647,Lomakin; Vitaliy,0,0,0,0
1668241685907,ECE 230B,A00,103648,Taur; Yuan,0,0,0,0
1668241686331,ECE 238B,A00,103649,Garay; Javier,0,0,0,0
1668241686757,ECE 240B,A00,112900,Fainman; Yeshaiahu,0,0,0,0
1668241687182,ECE 247A,A00,103650,Jokerst; Jesse Vincent,0,0,0,0
1668241687609,ECE 247B,A00,103651,Wang; Joseph,0,0,0,0
1668241688037,ECE 250,A00,103652,Siegel; Paul H.,0,0,0,0
1668241688462,ECE 251A,A00,103654,Rao; Bhaskar D.,0,0,0,0
1668241688886,ECE 257B,A00,103655,Bharadia; Dinesh,0,0,0,0
1668241689312,ECE 258A,A00,103656,Milstein; Laurence B.,0,0,0,0
1668241689736,ECE 260B,A00,103658,Kang; Mingu,0,0,0,0
1668241690161,ECE 264A,A00,103659,Galton; Ian A,0,0,0,0
1668241690584,ECE 265A,A00,103661,Gudem; Prasad S.S.,0,0,0,0
1668241691012,ECE 265D,A00,103662,Gudem; Prasad S.S.,0,0,0,0
1668241691438,ECE 268,A00,103663,Koushanfar; Farinaz,0,0,0,0
1668241691866,ECE 269,A01,103665,Pal; Piya,0,0,0,0
1668241692305,ECE 271B,A00,103666,Vasconcelos; Manuela,0,0,0,0
1668241692730,ECE 276A,A00,103667,Atanasov; Nikolay A.,0,0,0,0
1668241693158,ECE 277,A00,103668,An; Cheolhong,0,0,0,0
1668241693583,ECE 279,A00,117947,Hall; Drew A.,0,0,0,0
1668241694435,ECE 283,A00,103670,Hsueh; Tzu-Chien,0,0,0,0
1668241694869,ECE 284,A00,103671,Turakhia; Yatish Girish,0,0,0,0
1668241695301,ECE 285,A00,103672,Zheng; Yang,0,0,0,0
1668241695301,ECE 285,B00,103673,Sworder; David D.,0,0,0,0
1668241695726,ECE 287,A00,103676,Javidi; Tara,0,0,0,0
1668241696175,MATH 200B,A00,098023,Salehi Golsefidy; Alireza,12,0,15,3
1668241696601,MATH 202B,A00,098024,Rhoades; Brendon Patrick,9,0,15,6
1668241697031,MATH 203B,A00,098025,Oprea; Dragos N.,10,0,15,5
1668241697457,MATH 204B,A00,098026,Sorensen; Claus M,13,0,15,2
1668241697882,MATH 208,A00,098027,Izadi; Elham,7,0,10,3
1668241698379,MATH 209,A00,098028,Pollack; Aaron,10,0,10,0
1668241698814,MATH 211A,A00,112919,Rogalski; Daniel,9,0,10,1
1668241699238,MATH 211B,A00,112920,Seward; Brandon M.,9,0,10,1
1668241699661,MATH 218,A00,098029,Li; Bo,10,0,10,0
1668241700086,MATH 220B,A00,098030,Novak; Jonathan I,11,0,15,4
1668241700512,MATH 221A,A00,098031,Ebenfelt; Peter F,13,0,15,2
1668241700935,MATH 231B,A00,098032,Zlatos; Andrej,12,0,15,3
1668241701363,MATH 240B,A00,098033,Ni; Lei,9,0,15,6
1668241701786,MATH 243,A00,098034,Jekel; David Andrew,10,0,10,0
1668241702209,MATH 245A,A00,098035,Nie; Jiawang,0,0,15,16
1668241702639,MATH 248,A00,098036,Bejenaru; Ioan,10,0,10,0
1668241703066,MATH 250B,A00,098037,Spolaor; Luca,14,0,15,1
1668241703490,MATH 258,A00,098038,Ni; Lei,10,0,10,0
1668241703913,MATH 264B,A00,098041,Rhoades; Brendon Patrick,9,0,15,6
1668241704348,MATH 268,A00,098042,Buss; Samuel R,10,0,10,0
1668241704770,MATH 269,A00,098043,Rhoades; Brendon Patrick,10,0,10,0
1668241705195,MATH 270B,A00,098044,Li; Bo,10,0,15,5
1668241705622,MATH 272B,A00,098045,Holst; Michael J,13,0,15,2
1668241706045,MATH 273A,A00,098046,Tian; Xiaochuan,10,0,15,5
1668241706473,MATH 275,A01,098048,Tian; Xiaochuan,6,0,10,4
1668241706899,MATH 278A,A00,098049,Holst; Michael J,8,0,10,2
1668241707325,MATH 278B,A00,098050,Cloninger; Alexander,10,0,10,0
1668241707747,MATH 278C,A00,098051,Nie; Jiawang,7,0,10,3
1668241708175,MATH 280B,A00,098052,Zheng; Tianyi,10,0,15,5
1668241708597,MATH 281B,A00,098053,Bradic; Jelena,1,0,15,14
1668241709021,MATH 282B,A00,098054,Arias-Castro; Ery,0,0,15,15
1668241709447,MATH 285,A00,098055,Fitzsimmons; Patrick J,0,0,15,17
1668241709870,MATH 287B,A00,098056,Arias-Castro; Ery,2,0,15,13
1668241710306,MATH 288,A00,098057,Agarwal; Pooja,9,0,10,1
1668241710306,MATH 288,B00,098058,Zhang; Danna,8,0,10,2
1668241710306,MATH 288,C00,098059,Williams; Ruth J,10,0,10,0
1668241710732,MATH 290B,A00,098060,Roberts; Justin Deritter,13,0,15,2
1668241711157,MATH 292,A00,098061,Belmont; Eva Kinoshita,10,0,10,0
1668241711582,MATH 295,A00,098062,Suk; Andrew Hoon,48,0,50,2
1668241712009,MATH 296,A00,098063,Novak; Jonathan I,20,0,20,0
1668241712433,MATH 297,001,098064,Gamst; Anthony Collins,9997,0,9999,2
1668242213882,COGS 205,A00,101395,Chiba; Andrea,19,0,20,1
1668242214307,COGS 210B,001,101404,Greene; Deanna Jacquelyn,9998,0,9999,1
1668242214307,COGS 210B,002,101417,Xia; Haijun,9999,0,9999,0
1668242214307,COGS 210B,003,101422,Nitz; Douglas A.,9999,0,9999,0
1668242214307,COGS 210B,004,101423,Hollan; James D.,9998,0,9999,1
1668242214307,COGS 210B,005,101424,Deak; Gedeon O.,9998,0,9999,1
1668242214307,COGS 210B,006,101425,Rossano; Federico,9999,0,9999,0
1668242214731,COGS 211B,A00,101427,Coulson; Seana M,9996,0,9999,3
1668242215155,COGS 220,A00,101428,Hollan; James D.,0,0,25,25
1668242215585,COGS 229,A00,101429,Dow; Steven P,18,0,25,7
1668242216012,COGS 230,A00,101430,Klemmer; Scott R,12,0,17,5
1668242216436,COGS 234,A00,101431,Xia; Haijun,2,0,25,23
1668242216860,COGS 260,A00,101432,Kiyonaga; Anastasia,21,0,25,4
1668242216860,COGS 260,B00,101433,Kirsh; David Joel,15,0,25,10
1668242217287,CSE 202,A00,102371,Impagliazzo; Russell,0,0,0,0
1668242217712,CSE 203B,A01,102373,Cheng; Chung Kuan,0,0,0,0
1668242218139,CSE 208,A00,102374,Micciancio; Daniele,0,0,0,0
1668242218565,CSE 209A,A00,112895,Impagliazzo; Russell,0,0,15,15
1668242218992,CSE 209B,A00,108005,Bellare; Mihir,0,0,0,0
1668242219417,CSE 210,A00,113163,Coblenz; Michael J,0,0,0,0
1668242219919,CSE 219,A00,106111,Dow; Steven P,0,0,20,20
1668242220343,CSE 221,A00,102376,Voelker; Geoffrey M.,0,0,0,0
1668242220766,CSE 224,A01,102378,Porter; George M,0,0,0,0
1668242221193,CSE 229A,A00,102379,Savage; Stefan,0,0,0,0
1668242221615,CSE 229C,A00,102380,Munyaka; Imani N. S.,0,0,0,0
1668242222041,CSE 232B,A00,102382,Deutsch; Alin Bernard,0,0,0,0
1668242222463,CSE 234,A01,112904,Kumar; Arun Kumar,0,0,0,0
1668242222894,CSE 237A,A00,102383,Rosing; Tajana Simunic,0,0,0,0
1668242223329,CSE 239A,A00,102384,Deutsch; Alin Bernard,0,0,0,0
1668242223752,CSE 239B,A00,102385,Polikarpova; Nadezhda,0,0,0,0
1668242224175,CSE 240A,A00,102386,Pannuto; Patrick William,0,0,0,0
1668242224603,CSE 240B,A00,102387,Zhao; Jishen,0,0,0,0
1668242225028,CSE 241A,A00,106406,Kang; Mingu,0,0,0,0
1668242225455,CSE 249B,A00,102388,Kahng; Andrew Byun,0,0,8,8
1668242225880,CSE 251B,A01,102392,Cottrell; Garrison W,0,0,0,0
1668242225880,CSE 251B,A02,102393,Cottrell; Garrison W,0,0,0,0
1668242226307,CSE 252B,A00,102394,Ochoa; Benjamin Lawrence,0,0,0,0
1668242226733,CSE 257,A01,102396,Gao; Sicun,0,0,0,0
1668242227164,CSE 272,A00,102397,Li; Tzumao,0,0,0,0
1668242227589,CSE 274,A00,111323,Chern; Albert Ren-Haur,0,0,0,0
1668242228023,CSE 282,A00,102398,Pevzner; Pavel Arkadjevich,0,0,0,0
1668242228446,CSE 284,A00,114175,Gymrek; Melissa Ann,0,0,0,0
1668242228871,CSE 290,A00,102399,Chandraker; Manmohan Krishna,0,0,0,0
1668242228871,CSE 290,B00,102400,Vaccaro; Kristen Marie,0,0,25,25
1668242228871,CSE 290,C00,102414,Pannuto; Patrick William,0,0,25,25
1668242228871,CSE 290,D00,102427,Pevzner; Pavel Arkadjevich,0,0,0,0
1668242228871,CSE 290,E00,102429,Zhao; Jishen,0,0,0,0
1668242228871,CSE 290,F00,102436,Tullsen; Dean Michael,0,0,0,0
1668242228871,CSE 290,G00,102440,Christensen; Henrik I,0,0,20,20
1668242229303,CSE 291,A00,102443,Su; Hao,0,0,0,0
1668242229303,CSE 291,B00,102448,Polikarpova; Nadezhda,0,0,0,0
1668242229303,CSE 291,C00,102453,Vaccaro; Kristen Marie,0,0,0,0
1668242229303,CSE 291,D00,111343,Savage; Stefan,0,0,0,0
1668242229303,CSE 291,E00,116474,Claffy; Kimberly Claire,0,0,0,0
1668242229303,CSE 291,F00,116479,Pasquale; Joseph,0,0,0,0
1668242229760,CSE 293,001,119111,Bafna; Vineet,9999,0,9999,0
1668242229760,CSE 293,002,119118,Bellare; Mihir,9999,0,9999,0
1668242229760,CSE 293,003,119122,Berg-Kirkpatrick; Taylor D,9999,0,9999,0
1668242229760,CSE 293,004,119135,Christensen; Henrik I,9999,0,9999,0
1668242229760,CSE 293,005,119142,Cottrell; Garrison W,9999,0,9999,0
1668242229760,CSE 293,006,119146,Deutsch; Alin Bernard,9999,0,9999,0
1668242229760,CSE 293,007,119159,Esmaeilzadeh; Hadi,9999,0,9999,0
1668242229760,CSE 293,008,119166,Freund; Yoav,9999,0,9999,0
1668242229760,CSE 293,009,119170,Griswold; William G.,9999,0,9999,0
1668242229760,CSE 293,010,119183,Gymrek; Melissa Ann,9999,0,9999,0
1668242229760,CSE 293,011,119190,Heninger; Nadia A,9999,0,9999,0
1668242229760,CSE 293,012,119230,Impagliazzo; Russell,9999,0,9999,0
1668242229760,CSE 293,013,119232,Jhala; Ranjit,9999,0,9999,0
1668242229760,CSE 293,014,119233,Kahng; Andrew Byun,9999,0,9999,0
1668242229760,CSE 293,015,119298,Kane; Daniel Mertz,9999,0,9999,0
1668242229760,CSE 293,016,119299,Kriegman; David J,9999,0,9999,0
1668242229760,CSE 293,017,119300,Kumar; Arun Kumar,9999,0,9999,0
1668242229760,CSE 293,018,119301,Lerner; Sorin,9999,0,9999,0
1668242229760,CSE 293,019,119302,Lovett; Shachar,9999,0,9999,0
1668242229760,CSE 293,020,119303,McAuley; Julian John,9999,0,9999,0
1668242229760,CSE 293,021,119304,Micciancio; Daniele,9999,0,9999,0
1668242229760,CSE 293,022,119367,Orailoglu; Alex,9999,0,9999,0
1668242229760,CSE 293,023,119382,Paturi; Ramamohan,9999,0,9999,0
1668242229760,CSE 293,024,119404,Polikarpova; Nadezhda,9999,0,9999,0
1668242229760,CSE 293,025,119406,Politz; Joseph Gibbs,9999,0,9999,0
1668242229760,CSE 293,026,119411,Porter; George M,9999,0,9999,0
1668242229760,CSE 293,027,119414,Porter; Leonard Emerson,9999,0,9999,0
1668242229760,CSE 293,028,119416,Ramamoorthi; Ravi,9999,0,9999,0
1668242229760,CSE 293,029,119417,Sahoo; Debashis,9999,0,9999,0
1668242229760,CSE 293,030,119420,Saul; Lawrence,9999,0,9999,0
1668242229760,CSE 293,031,119421,Savage; Stefan,9999,0,9999,0
1668242229760,CSE 293,032,119425,Schulze; Jurgen P.,9999,0,9999,0
1668242229760,CSE 293,033,119426,Snoeren; Alex C.,9999,0,9999,0
1668242229760,CSE 293,034,119428,Shang; Jingbo,9999,0,9999,0
1668242229760,CSE 293,035,119430,Stefan; Deian,9999,0,9999,0
1668242229760,CSE 293,036,119431,Su; Hao,9999,0,9999,0
1668242229760,CSE 293,037,119433,Swanson; Steven James,9999,0,9999,0
1668242229760,CSE 293,038,119435,Tullsen; Dean Michael,9999,0,9999,0
1668242229760,CSE 293,039,119483,Voelker; Geoffrey M.,9999,0,9999,0
1668242229760,CSE 293,040,119537,Zhao; Jishen,9999,0,9999,0
1668242229760,CSE 293,041,119538,Zhou; Yuan-Yuan,9999,0,9999,0
1668242229760,CSE 293,042,119539,Gao; Sicun,9999,0,9999,0
1668242229760,CSE 293,043,119540,Weibel; Nadir,9999,0,9999,0
1668242229760,CSE 293,044,119541,Gupta; Rajesh K.,9999,0,9999,0
1668242229760,CSE 293,045,126410,Vaccaro; Kristen Marie,9999,0,9999,0
1668242229760,CSE 293,046,126411,Klemke; Richard,9999,0,9999,0
1668242230187,CSE 294,A00,102459,Voelker; Geoffrey M.,0,0,0,0
1668242230187,CSE 294,B00,111322,Orailoglu; Alex,0,0,0,0
1668242230614,DSE 201,A00,096914,Deutsch; Alin Bernard,30,0,30,0
1668242231039,DSE 210,A00,096915,Dasgupta; Sanjoy,30,0,30,0
1668242231467,DSE 260A,A00,096916,Altintas De Callaf; Ilkay,30,0,30,0
1668242231914,ECE 200,001,103586,Antipa; Nicholas A,9999,0,9999,0
1668242231914,ECE 200,002,103587,Atanasov; Nikolay A.,9999,0,9999,0
1668242231914,ECE 200,003,103588,Bharadia; Dinesh,9999,0,9999,0
1668242231914,ECE 200,004,103589,Cheng; Chung Kuan,9999,0,9999,0
1668242231914,ECE 200,005,103590,Cosman; Pamela C.,9999,0,9999,0
1668242231914,ECE 200,006,103591,Dayeh; Shadi Ahmad,9999,0,9999,0
1668242231914,ECE 200,007,103592,Fainman; Yeshaiahu,9999,0,9999,0
1668242231914,ECE 200,008,103593,Ford; Joseph Earl,9999,0,9999,0
1668242231914,ECE 200,009,103594,Franceschetti; Massimo,9999,0,9999,0
1668242231914,ECE 200,010,103595,Fullerton; Eric E,9999,0,9999,0
1668242231914,ECE 200,011,103596,Galton; Ian A,9999,0,9999,0
1668242231914,ECE 200,012,103597,Gilja; Vikash,9999,0,9999,0
1668242231914,ECE 200,013,103598,Hall; Drew A.,9999,0,9999,0
1668242231914,ECE 200,014,103599,Hsueh; Tzu-Chien,9999,0,9999,0
1668242231914,ECE 200,015,103600,Javidi; Tara,9999,0,9999,0
1668242231914,ECE 200,016,103601,Kahng; Andrew Byun,9999,0,9999,0
1668242231914,ECE 200,017,103602,Kim; Young-Han,9999,0,9999,0
1668242231914,ECE 200,018,103603,Koushanfar; Farinaz,9999,0,9999,0
1668242231914,ECE 200,019,103604,Kuzum; Duygu,9999,0,9999,0
1668242231914,ECE 200,020,103605,Le; Hanh-Phuc,9999,0,9999,0
1668242231914,ECE 200,021,103606,Lin; Bill,9999,0,9999,0
1668242231914,ECE 200,022,103607,Liu; Zhaowei,9998,0,9999,1
1668242231914,ECE 200,023,103608,Lo; Yu-Hwa,9999,0,9999,0
1668242231914,ECE 200,024,103609,Lomakin; Vitaliy,9999,0,9999,0
1668242231914,ECE 200,025,103610,Mercier; Patrick Philip,9999,0,9999,0
1668242231914,ECE 200,026,103611,Meyer; Florian,9999,0,9999,0
1668242231914,ECE 200,027,103612,Milstein; Laurence B.,9999,0,9999,0
1668242231914,ECE 200,028,103613,Mir Arabbaygi; Siavash,9999,0,9999,0
1668242231914,ECE 200,029,103614,Mookherjea; Shayan,9999,0,9999,0
1668242231914,ECE 200,030,103615,Morris; Karcher William,9999,0,9999,0
1668242231914,ECE 200,031,103616,Ng; Tse Nga,9999,0,9999,0
1668242231914,ECE 200,032,103617,Nguyen; Truong Quang,9999,0,9999,0
1668242231914,ECE 200,033,103618,Nomura; Kenji,9999,0,9999,0
1668242231914,ECE 200,034,103619,Orlitsky; Alon,9999,0,9999,0
1668242231914,ECE 200,035,103620,Pal; Piya,9999,0,9999,0
1668242231914,ECE 200,036,103621,Papen; George C.,9999,0,9999,0
1668242231914,ECE 200,037,103622,Radic; Stojan,9999,0,9999,0
1668242231914,ECE 200,038,103623,Rao; Bhaskar D.,9999,0,9999,0
1668242231914,ECE 200,039,103624,Rao; Ramesh R,9999,0,9999,0
1668242231914,ECE 200,040,103625,Rebeiz; Gabriel,9999,0,9999,0
1668242231914,ECE 200,041,103626,Sanford; John R,9999,0,9999,0
1668242231914,ECE 200,042,103627,Siegel; Paul H.,9999,0,9999,0
1668242231914,ECE 200,043,103628,Sievenpiper; Daniel F.,9999,0,9999,0
1668242231914,ECE 200,044,103629,Sworder; David D.,9999,0,9999,0
1668242231914,ECE 200,045,103630,Taur; Yuan,9999,0,9999,0
1668242231914,ECE 200,046,103631,Touri; Behrouz,9999,0,9999,0
1668242231914,ECE 200,047,103632,Trivedi; Mohan M.,9999,0,9999,0
1668242231914,ECE 200,048,103633,Vasconcelos; Nuno,9999,0,9999,0
1668242231914,ECE 200,049,103634,Wang; Xiaolong,9999,0,9999,0
1668242231914,ECE 200,050,103635,Xie; Pengtao,9999,0,9999,0
1668242231914,ECE 200,051,103636,Yip; Michael,9999,0,9999,0
1668242231914,ECE 200,052,103637,Zeger; Kenneth A.,999,0,999,0
1668242231914,ECE 200,053,103638,Zhang; Xinyu,9999,0,9999,0
1668242231914,ECE 200,054,103639,Turakhia; Yatish Girish,9999,0,9999,0
1668242231914,ECE 200,055,103640,Kang; Mingu,9999,0,9999,0
1668242231914,ECE 200,056,103641,Shi; Yuanyuan,9999,0,9999,0
1668242231914,ECE 200,057,103642,Wang; Edward Jay,9999,0,9999,0
1668242231914,ECE 200,058,103643,Zheng; Yang,9999,0,9999,0
1668242232341,ECE 202,A00,103644,Kuzum; Duygu,0,0,0,0
1668242232767,ECE 212BN,A00,103646,Ng; Tse Nga,0,0,0,0
1668242233191,ECE 221,A00,111493,Staff,0,0,0,0
1668242233618,ECE 222B,A00,103647,Lomakin; Vitaliy,0,0,0,0
1668242234042,ECE 230B,A00,103648,Taur; Yuan,0,0,0,0
1668242234465,ECE 238B,A00,103649,Garay; Javier,0,0,0,0
1668242234891,ECE 240B,A00,112900,Fainman; Yeshaiahu,0,0,0,0
1668242235315,ECE 247A,A00,103650,Jokerst; Jesse Vincent,0,0,0,0
1668242235741,ECE 247B,A00,103651,Wang; Joseph,0,0,0,0
1668242236167,ECE 250,A00,103652,Siegel; Paul H.,0,0,0,0
1668242236601,ECE 251A,A00,103654,Rao; Bhaskar D.,0,0,0,0
1668242237036,ECE 257B,A00,103655,Bharadia; Dinesh,0,0,0,0
1668242237461,ECE 258A,A00,103656,Milstein; Laurence B.,0,0,0,0
1668242237888,ECE 260B,A00,103658,Kang; Mingu,0,0,0,0
1668242238312,ECE 264A,A00,103659,Galton; Ian A,0,0,0,0
1668242238737,ECE 265A,A00,103661,Gudem; Prasad S.S.,0,0,0,0
1668242239172,ECE 265D,A00,103662,Gudem; Prasad S.S.,0,0,0,0
1668242239606,ECE 268,A00,103663,Koushanfar; Farinaz,0,0,0,0
1668242240039,ECE 269,A01,103665,Pal; Piya,0,0,0,0
1668242240470,ECE 271B,A00,103666,Vasconcelos; Manuela,0,0,0,0
1668242240896,ECE 276A,A00,103667,Atanasov; Nikolay A.,0,0,0,0
1668242241321,ECE 277,A00,103668,An; Cheolhong,0,0,0,0
1668242241746,ECE 279,A00,117947,Hall; Drew A.,0,0,0,0
1668242242594,ECE 283,A00,103670,Hsueh; Tzu-Chien,0,0,0,0
1668242243020,ECE 284,A00,103671,Turakhia; Yatish Girish,0,0,0,0
1668242243449,ECE 285,A00,103672,Zheng; Yang,0,0,0,0
1668242243449,ECE 285,B00,103673,Sworder; David D.,0,0,0,0
1668242243873,ECE 287,A00,103676,Javidi; Tara,0,0,0,0
1668242244300,MATH 200B,A00,098023,Salehi Golsefidy; Alireza,12,0,15,3
1668242244733,MATH 202B,A00,098024,Rhoades; Brendon Patrick,9,0,15,6
1668242245157,MATH 203B,A00,098025,Oprea; Dragos N.,10,0,15,5
1668242245592,MATH 204B,A00,098026,Sorensen; Claus M,13,0,15,2
1668242246018,MATH 208,A00,098027,Izadi; Elham,7,0,10,3
1668242246443,MATH 209,A00,098028,Pollack; Aaron,10,0,10,0
1668242246877,MATH 211A,A00,112919,Rogalski; Daniel,9,0,10,1
1668242247301,MATH 211B,A00,112920,Seward; Brandon M.,9,0,10,1
1668242247734,MATH 218,A00,098029,Li; Bo,10,0,10,0
1668242248161,MATH 220B,A00,098030,Novak; Jonathan I,11,0,15,4
1668242248601,MATH 221A,A00,098031,Ebenfelt; Peter F,13,0,15,2
1668242249027,MATH 231B,A00,098032,Zlatos; Andrej,12,0,15,3
1668242249460,MATH 240B,A00,098033,Ni; Lei,9,0,15,6
1668242249897,MATH 243,A00,098034,Jekel; David Andrew,10,0,10,0
1668242250339,MATH 245A,A00,098035,Nie; Jiawang,0,0,15,16
1668242250762,MATH 248,A00,098036,Bejenaru; Ioan,10,0,10,0
1668242251185,MATH 250B,A00,098037,Spolaor; Luca,14,0,15,1
1668242251610,MATH 258,A00,098038,Ni; Lei,10,0,10,0
1668242252035,MATH 264B,A00,098041,Rhoades; Brendon Patrick,9,0,15,6
1668242252457,MATH 268,A00,098042,Buss; Samuel R,10,0,10,0
1668242252885,MATH 269,A00,098043,Rhoades; Brendon Patrick,10,0,10,0
1668242253334,MATH 270B,A00,098044,Li; Bo,10,0,15,5
1668242253760,MATH 272B,A00,098045,Holst; Michael J,13,0,15,2
1668242254186,MATH 273A,A00,098046,Tian; Xiaochuan,10,0,15,5
1668242254611,MATH 275,A01,098048,Tian; Xiaochuan,6,0,10,4
1668242255038,MATH 278A,A00,098049,Holst; Michael J,8,0,10,2
1668242255477,MATH 278B,A00,098050,Cloninger; Alexander,10,0,10,0
1668242255906,MATH 278C,A00,098051,Nie; Jiawang,7,0,10,3
1668242256333,MATH 280B,A00,098052,Zheng; Tianyi,10,0,15,5
1668242256758,MATH 281B,A00,098053,Bradic; Jelena,1,0,15,14
1668242257184,MATH 282B,A00,098054,Arias-Castro; Ery,0,0,15,15
1668242257610,MATH 285,A00,098055,Fitzsimmons; Patrick J,0,0,15,17
1668242258036,MATH 287B,A00,098056,Arias-Castro; Ery,2,0,15,13
1668242258464,MATH 288,A00,098057,Agarwal; Pooja,9,0,10,1
1668242258464,MATH 288,B00,098058,Zhang; Danna,8,0,10,2
1668242258464,MATH 288,C00,098059,Williams; Ruth J,10,0,10,0
1668242258889,MATH 290B,A00,098060,Roberts; Justin Deritter,13,0,15,2
1668242259316,MATH 292,A00,098061,Belmont; Eva Kinoshita,10,0,10,0
1668242259739,MATH 295,A00,098062,Suk; Andrew Hoon,48,0,50,2
1668242260160,MATH 296,A00,098063,Novak; Jonathan I,20,0,20,0
1668242260586,MATH 297,001,098064,Gamst; Anthony Collins,9997,0,9999,2
1668242763492,COGS 205,A00,101395,Chiba; Andrea,19,0,20,1
1668242763918,COGS 210B,001,101404,Greene; Deanna Jacquelyn,9998,0,9999,1
1668242763918,COGS 210B,002,101417,Xia; Haijun,9999,0,9999,0
1668242763918,COGS 210B,003,101422,Nitz; Douglas A.,9999,0,9999,0
1668242763918,COGS 210B,004,101423,Hollan; James D.,9998,0,9999,1
1668242763918,COGS 210B,005,101424,Deak; Gedeon O.,9998,0,9999,1
1668242763918,COGS 210B,006,101425,Rossano; Federico,9999,0,9999,0
1668242764342,COGS 211B,A00,101427,Coulson; Seana M,9996,0,9999,3
1668242764766,COGS 220,A00,101428,Hollan; James D.,0,0,25,25
1668242765192,COGS 229,A00,101429,Dow; Steven P,18,0,25,7
1668242765618,COGS 230,A00,101430,Klemmer; Scott R,12,0,17,5
1668242766041,COGS 234,A00,101431,Xia; Haijun,2,0,25,23
1668242766469,COGS 260,A00,101432,Kiyonaga; Anastasia,21,0,25,4
1668242766469,COGS 260,B00,101433,Kirsh; David Joel,15,0,25,10
1668242766893,CSE 202,A00,102371,Impagliazzo; Russell,0,0,0,0
1668242767323,CSE 203B,A01,102373,Cheng; Chung Kuan,0,0,0,0
1668242767755,CSE 208,A00,102374,Micciancio; Daniele,0,0,0,0
1668242768182,CSE 209A,A00,112895,Impagliazzo; Russell,0,0,15,15
1668242768611,CSE 209B,A00,108005,Bellare; Mihir,0,0,0,0
1668242769037,CSE 210,A00,113163,Coblenz; Michael J,0,0,0,0
1668242769461,CSE 219,A00,106111,Dow; Steven P,0,0,20,20
1668242769886,CSE 221,A00,102376,Voelker; Geoffrey M.,0,0,0,0
1668242770318,CSE 224,A01,102378,Porter; George M,0,0,0,0
1668242770742,CSE 229A,A00,102379,Savage; Stefan,0,0,0,0
1668242771167,CSE 229C,A00,102380,Munyaka; Imani N. S.,0,0,0,0
1668242771605,CSE 232B,A00,102382,Deutsch; Alin Bernard,0,0,0,0
1668242772033,CSE 234,A01,112904,Kumar; Arun Kumar,0,0,0,0
1668242772456,CSE 237A,A00,102383,Rosing; Tajana Simunic,0,0,0,0
1668242772879,CSE 239A,A00,102384,Deutsch; Alin Bernard,0,0,0,0
1668242773302,CSE 239B,A00,102385,Polikarpova; Nadezhda,0,0,0,0
1668242773726,CSE 240A,A00,102386,Pannuto; Patrick William,0,0,0,0
1668242774149,CSE 240B,A00,102387,Zhao; Jishen,0,0,0,0
1668242774574,CSE 241A,A00,106406,Kang; Mingu,0,0,0,0
1668242775004,CSE 249B,A00,102388,Kahng; Andrew Byun,0,0,8,8
1668242775435,CSE 251B,A01,102392,Cottrell; Garrison W,0,0,0,0
1668242775435,CSE 251B,A02,102393,Cottrell; Garrison W,0,0,0,0
1668242775861,CSE 252B,A00,102394,Ochoa; Benjamin Lawrence,0,0,0,0
1668242776304,CSE 257,A01,102396,Gao; Sicun,0,0,0,0
1668242776737,CSE 272,A00,102397,Li; Tzumao,0,0,0,0
1668242777184,CSE 274,A00,111323,Chern; Albert Ren-Haur,0,0,0,0
1668242777633,CSE 282,A00,102398,Pevzner; Pavel Arkadjevich,0,0,0,0
1668242778062,CSE 284,A00,114175,Gymrek; Melissa Ann,0,0,0,0
1668242778491,CSE 290,A00,102399,Chandraker; Manmohan Krishna,0,0,0,0
1668242778491,CSE 290,B00,102400,Vaccaro; Kristen Marie,0,0,25,25
1668242778491,CSE 290,C00,102414,Pannuto; Patrick William,0,0,25,25
1668242778491,CSE 290,D00,102427,Pevzner; Pavel Arkadjevich,0,0,0,0
1668242778491,CSE 290,E00,102429,Zhao; Jishen,0,0,0,0
1668242778491,CSE 290,F00,102436,Tullsen; Dean Michael,0,0,0,0
1668242778491,CSE 290,G00,102440,Christensen; Henrik I,0,0,20,20
1668242778916,CSE 291,A00,102443,Su; Hao,0,0,0,0
1668242778916,CSE 291,B00,102448,Polikarpova; Nadezhda,0,0,0,0
1668242778916,CSE 291,C00,102453,Vaccaro; Kristen Marie,0,0,0,0
1668242778916,CSE 291,D00,111343,Savage; Stefan,0,0,0,0
1668242778916,CSE 291,E00,116474,Claffy; Kimberly Claire,0,0,0,0
1668242778916,CSE 291,F00,116479,Pasquale; Joseph,0,0,0,0
1668242779357,CSE 293,001,119111,Bafna; Vineet,9999,0,9999,0
1668242779357,CSE 293,002,119118,Bellare; Mihir,9999,0,9999,0
1668242779357,CSE 293,003,119122,Berg-Kirkpatrick; Taylor D,9999,0,9999,0
1668242779357,CSE 293,004,119135,Christensen; Henrik I,9999,0,9999,0
1668242779357,CSE 293,005,119142,Cottrell; Garrison W,9999,0,9999,0
1668242779357,CSE 293,006,119146,Deutsch; Alin Bernard,9999,0,9999,0
1668242779357,CSE 293,007,119159,Esmaeilzadeh; Hadi,9999,0,9999,0
1668242779357,CSE 293,008,119166,Freund; Yoav,9999,0,9999,0
1668242779357,CSE 293,009,119170,Griswold; William G.,9999,0,9999,0
1668242779357,CSE 293,010,119183,Gymrek; Melissa Ann,9999,0,9999,0
1668242779357,CSE 293,011,119190,Heninger; Nadia A,9999,0,9999,0
1668242779357,CSE 293,012,119230,Impagliazzo; Russell,9999,0,9999,0
1668242779357,CSE 293,013,119232,Jhala; Ranjit,9999,0,9999,0
1668242779357,CSE 293,014,119233,Kahng; Andrew Byun,9999,0,9999,0
1668242779357,CSE 293,015,119298,Kane; Daniel Mertz,9999,0,9999,0
1668242779357,CSE 293,016,119299,Kriegman; David J,9999,0,9999,0
1668242779357,CSE 293,017,119300,Kumar; Arun Kumar,9999,0,9999,0
1668242779357,CSE 293,018,119301,Lerner; Sorin,9999,0,9999,0
1668242779357,CSE 293,019,119302,Lovett; Shachar,9999,0,9999,0
1668242779357,CSE 293,020,119303,McAuley; Julian John,9999,0,9999,0
1668242779357,CSE 293,021,119304,Micciancio; Daniele,9999,0,9999,0
1668242779357,CSE 293,022,119367,Orailoglu; Alex,9999,0,9999,0
1668242779357,CSE 293,023,119382,Paturi; Ramamohan,9999,0,9999,0
1668242779357,CSE 293,024,119404,Polikarpova; Nadezhda,9999,0,9999,0
1668242779357,CSE 293,025,119406,Politz; Joseph Gibbs,9999,0,9999,0
1668242779357,CSE 293,026,119411,Porter; George M,9999,0,9999,0
1668242779357,CSE 293,027,119414,Porter; Leonard Emerson,9999,0,9999,0
1668242779357,CSE 293,028,119416,Ramamoorthi; Ravi,9999,0,9999,0
1668242779357,CSE 293,029,119417,Sahoo; Debashis,9999,0,9999,0
1668242779357,CSE 293,030,119420,Saul; Lawrence,9999,0,9999,0
1668242779357,CSE 293,031,119421,Savage; Stefan,9999,0,9999,0
1668242779357,CSE 293,032,119425,Schulze; Jurgen P.,9999,0,9999,0
1668242779357,CSE 293,033,119426,Snoeren; Alex C.,9999,0,9999,0
1668242779357,CSE 293,034,119428,Shang; Jingbo,9999,0,9999,0
1668242779357,CSE 293,035,119430,Stefan; Deian,9999,0,9999,0
1668242779357,CSE 293,036,119431,Su; Hao,9999,0,9999,0
1668242779357,CSE 293,037,119433,Swanson; Steven James,9999,0,9999,0
1668242779357,CSE 293,038,119435,Tullsen; Dean Michael,9999,0,9999,0
1668242779357,CSE 293,039,119483,Voelker; Geoffrey M.,9999,0,9999,0
1668242779357,CSE 293,040,119537,Zhao; Jishen,9999,0,9999,0
1668242779357,CSE 293,041,119538,Zhou; Yuan-Yuan,9999,0,9999,0
1668242779357,CSE 293,042,119539,Gao; Sicun,9999,0,9999,0
1668242779357,CSE 293,043,119540,Weibel; Nadir,9999,0,9999,0
1668242779357,CSE 293,044,119541,Gupta; Rajesh K.,9999,0,9999,0
1668242779357,CSE 293,045,126410,Vaccaro; Kristen Marie,9999,0,9999,0
1668242779357,CSE 293,046,126411,Klemke; Richard,9999,0,9999,0
1668242779781,CSE 294,A00,102459,Voelker; Geoffrey M.,0,0,0,0
1668242779781,CSE 294,B00,111322,Orailoglu; Alex,0,0,0,0
1668242780205,DSE 201,A00,096914,Deutsch; Alin Bernard,30,0,30,0
1668242780628,DSE 210,A00,096915,Dasgupta; Sanjoy,30,0,30,0
1668242781055,DSE 260A,A00,096916,Altintas De Callaf; Ilkay,30,0,30,0
1668242781504,ECE 200,001,103586,Antipa; Nicholas A,9999,0,9999,0
1668242781504,ECE 200,002,103587,Atanasov; Nikolay A.,9999,0,9999,0
1668242781504,ECE 200,003,103588,Bharadia; Dinesh,9999,0,9999,0
1668242781504,ECE 200,004,103589,Cheng; Chung Kuan,9999,0,9999,0
1668242781504,ECE 200,005,103590,Cosman; Pamela C.,9999,0,9999,0
1668242781504,ECE 200,006,103591,Dayeh; Shadi Ahmad,9999,0,9999,0
1668242781504,ECE 200,007,103592,Fainman; Yeshaiahu,9999,0,9999,0
1668242781504,ECE 200,008,103593,Ford; Joseph Earl,9999,0,9999,0
1668242781504,ECE 200,009,103594,Franceschetti; Massimo,9999,0,9999,0
1668242781504,ECE 200,010,103595,Fullerton; Eric E,9999,0,9999,0
1668242781504,ECE 200,011,103596,Galton; Ian A,9999,0,9999,0
1668242781504,ECE 200,012,103597,Gilja; Vikash,9999,0,9999,0
1668242781504,ECE 200,013,103598,Hall; Drew A.,9999,0,9999,0
1668242781504,ECE 200,014,103599,Hsueh; Tzu-Chien,9999,0,9999,0
1668242781504,ECE 200,015,103600,Javidi; Tara,9999,0,9999,0
1668242781504,ECE 200,016,103601,Kahng; Andrew Byun,9999,0,9999,0
1668242781504,ECE 200,017,103602,Kim; Young-Han,9999,0,9999,0
1668242781504,ECE 200,018,103603,Koushanfar; Farinaz,9999,0,9999,0
1668242781504,ECE 200,019,103604,Kuzum; Duygu,9999,0,9999,0
1668242781504,ECE 200,020,103605,Le; Hanh-Phuc,9999,0,9999,0
1668242781504,ECE 200,021,103606,Lin; Bill,9999,0,9999,0
1668242781504,ECE 200,022,103607,Liu; Zhaowei,9998,0,9999,1
1668242781504,ECE 200,023,103608,Lo; Yu-Hwa,9999,0,9999,0
1668242781504,ECE 200,024,103609,Lomakin; Vitaliy,9999,0,9999,0
1668242781504,ECE 200,025,103610,Mercier; Patrick Philip,9999,0,9999,0
1668242781504,ECE 200,026,103611,Meyer; Florian,9999,0,9999,0
1668242781504,ECE 200,027,103612,Milstein; Laurence B.,9999,0,9999,0
1668242781504,ECE 200,028,103613,Mir Arabbaygi; Siavash,9999,0,9999,0
1668242781504,ECE 200,029,103614,Mookherjea; Shayan,9999,0,9999,0
1668242781504,ECE 200,030,103615,Morris; Karcher William,9999,0,9999,0
1668242781504,ECE 200,031,103616,Ng; Tse Nga,9999,0,9999,0
1668242781504,ECE 200,032,103617,Nguyen; Truong Quang,9999,0,9999,0
1668242781504,ECE 200,033,103618,Nomura; Kenji,9999,0,9999,0
1668242781504,ECE 200,034,103619,Orlitsky; Alon,9999,0,9999,0
1668242781504,ECE 200,035,103620,Pal; Piya,9999,0,9999,0
1668242781504,ECE 200,036,103621,Papen; George C.,9999,0,9999,0
1668242781504,ECE 200,037,103622,Radic; Stojan,9999,0,9999,0
1668242781504,ECE 200,038,103623,Rao; Bhaskar D.,9999,0,9999,0
1668242781504,ECE 200,039,103624,Rao; Ramesh R,9999,0,9999,0
1668242781504,ECE 200,040,103625,Rebeiz; Gabriel,9999,0,9999,0
1668242781504,ECE 200,041,103626,Sanford; John R,9999,0,9999,0
1668242781504,ECE 200,042,103627,Siegel; Paul H.,9999,0,9999,0
1668242781504,ECE 200,043,103628,Sievenpiper; Daniel F.,9999,0,9999,0
1668242781504,ECE 200,044,103629,Sworder; David D.,9999,0,9999,0
1668242781504,ECE 200,045,103630,Taur; Yuan,9999,0,9999,0
1668242781504,ECE 200,046,103631,Touri; Behrouz,9999,0,9999,0
1668242781504,ECE 200,047,103632,Trivedi; Mohan M.,9999,0,9999,0
1668242781504,ECE 200,048,103633,Vasconcelos; Nuno,9999,0,9999,0
1668242781504,ECE 200,049,103634,Wang; Xiaolong,9999,0,9999,0
1668242781504,ECE 200,050,103635,Xie; Pengtao,9999,0,9999,0
1668242781504,ECE 200,051,103636,Yip; Michael,9999,0,9999,0
1668242781504,ECE 200,052,103637,Zeger; Kenneth A.,999,0,999,0
1668242781504,ECE 200,053,103638,Zhang; Xinyu,9999,0,9999,0
1668242781504,ECE 200,054,103639,Turakhia; Yatish Girish,9999,0,9999,0
1668242781504,ECE 200,055,103640,Kang; Mingu,9999,0,9999,0
1668242781504,ECE 200,056,103641,Shi; Yuanyuan,9999,0,9999,0
1668242781504,ECE 200,057,103642,Wang; Edward Jay,9999,0,9999,0
1668242781504,ECE 200,058,103643,Zheng; Yang,9999,0,9999,0
1668242781928,ECE 202,A00,103644,Kuzum; Duygu,0,0,0,0
1668242782355,ECE 212BN,A00,103646,Ng; Tse Nga,0,0,0,0
1668242782780,ECE 221,A00,111493,Staff,0,0,0,0
1668242783208,ECE 222B,A00,103647,Lomakin; Vitaliy,0,0,0,0
1668242783634,ECE 230B,A00,103648,Taur; Yuan,0,0,0,0
1668242784058,ECE 238B,A00,103649,Garay; Javier,0,0,0,0
1668242784485,ECE 240B,A00,112900,Fainman; Yeshaiahu,0,0,0,0
1668242784925,ECE 247A,A00,103650,Jokerst; Jesse Vincent,0,0,0,0
1668242785351,ECE 247B,A00,103651,Wang; Joseph,0,0,0,0
1668242785774,ECE 250,A00,103652,Siegel; Paul H.,0,0,0,0
1668242786295,ECE 251A,A00,103654,Rao; Bhaskar D.,0,0,0,0
1668242786719,ECE 257B,A00,103655,Bharadia; Dinesh,0,0,0,0
1668242787143,ECE 258A,A00,103656,Milstein; Laurence B.,0,0,0,0
1668242787566,ECE 260B,A00,103658,Kang; Mingu,0,0,0,0
1668242787991,ECE 264A,A00,103659,Galton; Ian A,0,0,0,0
1668242788418,ECE 265A,A00,103661,Gudem; Prasad S.S.,0,0,0,0
1668242788842,ECE 265D,A00,103662,Gudem; Prasad S.S.,0,0,0,0
1668242789267,ECE 268,A00,103663,Koushanfar; Farinaz,0,0,0,0
1668242789690,ECE 269,A01,103665,Pal; Piya,0,0,0,0
1668242790121,ECE 271B,A00,103666,Vasconcelos; Manuela,0,0,0,0
1668242790548,ECE 276A,A00,103667,Atanasov; Nikolay A.,0,0,0,0
1668242790974,ECE 277,A00,103668,An; Cheolhong,0,0,0,0
1668242791402,ECE 279,A00,117947,Hall; Drew A.,0,0,0,0
1668242792250,ECE 283,A00,103670,Hsueh; Tzu-Chien,0,0,0,0
1668242792685,ECE 284,A00,103671,Turakhia; Yatish Girish,0,0,0,0
1668242793123,ECE 285,A00,103672,Zheng; Yang,0,0,0,0
1668242793123,ECE 285,B00,103673,Sworder; David D.,0,0,0,0
1668242793560,ECE 287,A00,103676,Javidi; Tara,0,0,0,0
1668242793984,MATH 200B,A00,098023,Salehi Golsefidy; Alireza,12,0,15,3
1668242794409,MATH 202B,A00,098024,Rhoades; Brendon Patrick,9,0,15,6
1668242794843,MATH 203B,A00,098025,Oprea; Dragos N.,10,0,15,5
1668242795269,MATH 204B,A00,098026,Sorensen; Claus M,13,0,15,2
1668242795704,MATH 208,A00,098027,Izadi; Elham,7,0,10,3
1668242796130,MATH 209,A00,098028,Pollack; Aaron,10,0,10,0
1668242796556,MATH 211A,A00,112919,Rogalski; Daniel,9,0,10,1
1668242796982,MATH 211B,A00,112920,Seward; Brandon M.,9,0,10,1
1668242797408,MATH 218,A00,098029,Li; Bo,10,0,10,0
1668242797835,MATH 220B,A00,098030,Novak; Jonathan I,11,0,15,4
1668242798260,MATH 221A,A00,098031,Ebenfelt; Peter F,13,0,15,2
1668242798684,MATH 231B,A00,098032,Zlatos; Andrej,12,0,15,3
1668242799111,MATH 240B,A00,098033,Ni; Lei,9,0,15,6
1668242799535,MATH 243,A00,098034,Jekel; David Andrew,10,0,10,0
1668242799959,MATH 245A,A00,098035,Nie; Jiawang,0,0,15,16
1668242800399,MATH 248,A00,098036,Bejenaru; Ioan,10,0,10,0
1668242800830,MATH 250B,A00,098037,Spolaor; Luca,14,0,15,1
1668242801257,MATH 258,A00,098038,Ni; Lei,10,0,10,0
1668242801681,MATH 264B,A00,098041,Rhoades; Brendon Patrick,9,0,15,6
1668242802106,MATH 268,A00,098042,Buss; Samuel R,10,0,10,0
1668242802529,MATH 269,A00,098043,Rhoades; Brendon Patrick,10,0,10,0
1668242802958,MATH 270B,A00,098044,Li; Bo,10,0,15,5
1668242803382,MATH 272B,A00,098045,Holst; Michael J,13,0,15,2
1668242803807,MATH 273A,A00,098046,Tian; Xiaochuan,10,0,15,5
1668242804234,MATH 275,A01,098048,Tian; Xiaochuan,6,0,10,4
1668242804657,MATH 278A,A00,098049,Holst; Michael J,8,0,10,2
1668242805087,MATH 278B,A00,098050,Cloninger; Alexander,10,0,10,0
1668242805511,MATH 278C,A00,098051,Nie; Jiawang,7,0,10,3
1668242805934,MATH 280B,A00,098052,Zheng; Tianyi,9,0,15,6
1668242806361,MATH 281B,A00,098053,Bradic; Jelena,1,0,15,14
1668242806789,MATH 282B,A00,098054,Arias-Castro; Ery,0,0,15,15
1668242807218,MATH 285,A00,098055,Fitzsimmons; Patrick J,0,0,15,17
1668242807644,MATH 287B,A00,098056,Arias-Castro; Ery,2,0,15,13
1668242808070,MATH 288,A00,098057,Agarwal; Pooja,9,0,10,1
1668242808070,MATH 288,B00,098058,Zhang; Danna,8,0,10,2
1668242808070,MATH 288,C00,098059,Williams; Ruth J,10,0,10,0
1668242808494,MATH 290B,A00,098060,Roberts; Justin Deritter,13,0,15,2
1668242808919,MATH 292,A00,098061,Belmont; Eva Kinoshita,10,0,10,0
1668242809346,MATH 295,A00,098062,Suk; Andrew Hoon,48,0,50,2
1668242809781,MATH 296,A00,098063,Novak; Jonathan I,20,0,20,0
1668242810205,MATH 297,001,098064,Gamst; Anthony Collins,9997,0,9999,2
1668243311864,COGS 205,A00,101395,Chiba; Andrea,19,0,20,1
1668243312294,COGS 210B,001,101404,Greene; Deanna Jacquelyn,9998,0,9999,1
1668243312294,COGS 210B,002,101417,Xia; Haijun,9999,0,9999,0
1668243312294,COGS 210B,003,101422,Nitz; Douglas A.,9999,0,9999,0
1668243312294,COGS 210B,004,101423,Hollan; James D.,9998,0,9999,1
1668243312294,COGS 210B,005,101424,Deak; Gedeon O.,9998,0,9999,1
1668243312294,COGS 210B,006,101425,Rossano; Federico,9999,0,9999,0
1668243312721,COGS 211B,A00,101427,Coulson; Seana M,9996,0,9999,3
1668243313154,COGS 220,A00,101428,Hollan; James D.,0,0,25,25
1668243313594,COGS 229,A00,101429,Dow; Steven P,18,0,25,7
1668243314024,COGS 230,A00,101430,Klemmer; Scott R,12,0,17,5
1668243314449,COGS 234,A00,101431,Xia; Haijun,2,0,25,23
1668243314876,COGS 260,A00,101432,Kiyonaga; Anastasia,21,0,25,4
1668243314876,COGS 260,B00,101433,Kirsh; David Joel,15,0,25,10
1668243315305,CSE 202,A00,102371,Impagliazzo; Russell,0,0,0,0
1668243315740,CSE 203B,A01,102373,Cheng; Chung Kuan,0,0,0,0
1668243316165,CSE 208,A00,102374,Micciancio; Daniele,0,0,0,0
1668243316590,CSE 209A,A00,112895,Impagliazzo; Russell,0,0,15,15
1668243317019,CSE 209B,A00,108005,Bellare; Mihir,0,0,0,0
1668243317449,CSE 210,A00,113163,Coblenz; Michael J,0,0,0,0
1668243317883,CSE 219,A00,106111,Dow; Steven P,0,0,20,20
1668243318310,CSE 221,A00,102376,Voelker; Geoffrey M.,0,0,0,0
1668243318737,CSE 224,A01,102378,Porter; George M,0,0,0,0
1668243319161,CSE 229A,A00,102379,Savage; Stefan,0,0,0,0
1668243319602,CSE 229C,A00,102380,Munyaka; Imani N. S.,0,0,0,0
1668243320045,CSE 232B,A00,102382,Deutsch; Alin Bernard,0,0,0,0
1668243320485,CSE 234,A01,112904,Kumar; Arun Kumar,0,0,0,0
1668243320909,CSE 237A,A00,102383,Rosing; Tajana Simunic,0,0,0,0
1668243321335,CSE 239A,A00,102384,Deutsch; Alin Bernard,0,0,0,0
1668243321760,CSE 239B,A00,102385,Polikarpova; Nadezhda,0,0,0,0
1668243322190,CSE 240A,A00,102386,Pannuto; Patrick William,0,0,0,0
1668243322616,CSE 240B,A00,102387,Zhao; Jishen,0,0,0,0
1668243323040,CSE 241A,A00,106406,Kang; Mingu,0,0,0,0
1668243323477,CSE 249B,A00,102388,Kahng; Andrew Byun,0,0,8,8
1668243323924,CSE 251B,A01,102392,Cottrell; Garrison W,0,0,0,0
1668243323924,CSE 251B,A02,102393,Cottrell; Garrison W,0,0,0,0
1668243324364,CSE 252B,A00,102394,Ochoa; Benjamin Lawrence,0,0,0,0
1668243324788,CSE 257,A01,102396,Gao; Sicun,0,0,0,0
1668243325212,CSE 272,A00,102397,Li; Tzumao,0,0,0,0
1668243325641,CSE 274,A00,111323,Chern; Albert Ren-Haur,0,0,0,0
1668243326068,CSE 282,A00,102398,Pevzner; Pavel Arkadjevich,0,0,0,0
1668243326494,CSE 284,A00,114175,Gymrek; Melissa Ann,0,0,0,0
1668243326922,CSE 290,A00,102399,Chandraker; Manmohan Krishna,0,0,0,0
1668243326922,CSE 290,B00,102400,Vaccaro; Kristen Marie,0,0,25,25
1668243326922,CSE 290,C00,102414,Pannuto; Patrick William,0,0,25,25
1668243326922,CSE 290,D00,102427,Pevzner; Pavel Arkadjevich,0,0,0,0
1668243326922,CSE 290,E00,102429,Zhao; Jishen,0,0,0,0
1668243326922,CSE 290,F00,102436,Tullsen; Dean Michael,0,0,0,0
1668243326922,CSE 290,G00,102440,Christensen; Henrik I,0,0,20,20
1668243327356,CSE 291,A00,102443,Su; Hao,0,0,0,0
1668243327356,CSE 291,B00,102448,Polikarpova; Nadezhda,0,0,0,0
1668243327356,CSE 291,C00,102453,Vaccaro; Kristen Marie,0,0,0,0
1668243327356,CSE 291,D00,111343,Savage; Stefan,0,0,0,0
1668243327356,CSE 291,E00,116474,Claffy; Kimberly Claire,0,0,0,0
1668243327356,CSE 291,F00,116479,Pasquale; Joseph,0,0,0,0
1668243327822,CSE 293,001,119111,Bafna; Vineet,9999,0,9999,0
1668243327822,CSE 293,002,119118,Bellare; Mihir,9999,0,9999,0
1668243327822,CSE 293,003,119122,Berg-Kirkpatrick; Taylor D,9999,0,9999,0
1668243327822,CSE 293,004,119135,Christensen; Henrik I,9999,0,9999,0
1668243327822,CSE 293,005,119142,Cottrell; Garrison W,9999,0,9999,0
1668243327822,CSE 293,006,119146,Deutsch; Alin Bernard,9999,0,9999,0
1668243327822,CSE 293,007,119159,Esmaeilzadeh; Hadi,9999,0,9999,0
1668243327822,CSE 293,008,119166,Freund; Yoav,9999,0,9999,0
1668243327822,CSE 293,009,119170,Griswold; William G.,9999,0,9999,0
1668243327822,CSE 293,010,119183,Gymrek; Melissa Ann,9999,0,9999,0
1668243327822,CSE 293,011,119190,Heninger; Nadia A,9999,0,9999,0
1668243327822,CSE 293,012,119230,Impagliazzo; Russell,9999,0,9999,0
1668243327822,CSE 293,013,119232,Jhala; Ranjit,9999,0,9999,0
1668243327822,CSE 293,014,119233,Kahng; Andrew Byun,9999,0,9999,0
1668243327822,CSE 293,015,119298,Kane; Daniel Mertz,9999,0,9999,0
1668243327822,CSE 293,016,119299,Kriegman; David J,9999,0,9999,0
1668243327822,CSE 293,017,119300,Kumar; Arun Kumar,9999,0,9999,0
1668243327822,CSE 293,018,119301,Lerner; Sorin,9999,0,9999,0
1668243327822,CSE 293,019,119302,Lovett; Shachar,9999,0,9999,0
1668243327822,CSE 293,020,119303,McAuley; Julian John,9999,0,9999,0
1668243327822,CSE 293,021,119304,Micciancio; Daniele,9999,0,9999,0
1668243327822,CSE 293,022,119367,Orailoglu; Alex,9999,0,9999,0
1668243327822,CSE 293,023,119382,Paturi; Ramamohan,9999,0,9999,0
1668243327822,CSE 293,024,119404,Polikarpova; Nadezhda,9999,0,9999,0
1668243327822,CSE 293,025,119406,Politz; Joseph Gibbs,9999,0,9999,0
1668243327822,CSE 293,026,119411,Porter; George M,9999,0,9999,0
1668243327822,CSE 293,027,119414,Porter; Leonard Emerson,9999,0,9999,0
1668243327822,CSE 293,028,119416,Ramamoorthi; Ravi,9999,0,9999,0
1668243327822,CSE 293,029,119417,Sahoo; Debashis,9999,0,9999,0
1668243327822,CSE 293,030,119420,Saul; Lawrence,9999,0,9999,0
1668243327822,CSE 293,031,119421,Savage; Stefan,9999,0,9999,0
1668243327822,CSE 293,032,119425,Schulze; Jurgen P.,9999,0,9999,0
1668243327822,CSE 293,033,119426,Snoeren; Alex C.,9999,0,9999,0
1668243327822,CSE 293,034,119428,Shang; Jingbo,9999,0,9999,0
1668243327822,CSE 293,035,119430,Stefan; Deian,9999,0,9999,0
1668243327822,CSE 293,036,119431,Su; Hao,9999,0,9999,0
1668243327822,CSE 293,037,119433,Swanson; Steven James,9999,0,9999,0
1668243327822,CSE 293,038,119435,Tullsen; Dean Michael,9999,0,9999,0
1668243327822,CSE 293,039,119483,Voelker; Geoffrey M.,9999,0,9999,0
1668243327822,CSE 293,040,119537,Zhao; Jishen,9999,0,9999,0
1668243327822,CSE 293,041,119538,Zhou; Yuan-Yuan,9999,0,9999,0
1668243327822,CSE 293,042,119539,Gao; Sicun,9999,0,9999,0
1668243327822,CSE 293,043,119540,Weibel; Nadir,9999,0,9999,0
1668243327822,CSE 293,044,119541,Gupta; Rajesh K.,9999,0,9999,0
1668243327822,CSE 293,045,126410,Vaccaro; Kristen Marie,9999,0,9999,0
1668243327822,CSE 293,046,126411,Klemke; Richard,9999,0,9999,0
1668243328246,CSE 294,A00,102459,Voelker; Geoffrey M.,0,0,0,0
1668243328246,CSE 294,B00,111322,Orailoglu; Alex,0,0,0,0
1668243328670,DSE 201,A00,096914,Deutsch; Alin Bernard,30,0,30,0
1668243329093,DSE 210,A00,096915,Dasgupta; Sanjoy,30,0,30,0
1668243329519,DSE 260A,A00,096916,Altintas De Callaf; Ilkay,30,0,30,0
1668243330022,ECE 200,001,103586,Antipa; Nicholas A,9999,0,9999,0
1668243330022,ECE 200,002,103587,Atanasov; Nikolay A.,9999,0,9999,0
1668243330022,ECE 200,003,103588,Bharadia; Dinesh,9999,0,9999,0
1668243330022,ECE 200,004,103589,Cheng; Chung Kuan,9999,0,9999,0
1668243330022,ECE 200,005,103590,Cosman; Pamela C.,9999,0,9999,0
1668243330022,ECE 200,006,103591,Dayeh; Shadi Ahmad,9999,0,9999,0
1668243330022,ECE 200,007,103592,Fainman; Yeshaiahu,9999,0,9999,0
1668243330022,ECE 200,008,103593,Ford; Joseph Earl,9999,0,9999,0
1668243330022,ECE 200,009,103594,Franceschetti; Massimo,9999,0,9999,0
1668243330022,ECE 200,010,103595,Fullerton; Eric E,9999,0,9999,0
1668243330022,ECE 200,011,103596,Galton; Ian A,9999,0,9999,0
1668243330022,ECE 200,012,103597,Gilja; Vikash,9999,0,9999,0
1668243330022,ECE 200,013,103598,Hall; Drew A.,9999,0,9999,0
1668243330022,ECE 200,014,103599,Hsueh; Tzu-Chien,9999,0,9999,0
1668243330022,ECE 200,015,103600,Javidi; Tara,9999,0,9999,0
1668243330022,ECE 200,016,103601,Kahng; Andrew Byun,9999,0,9999,0
1668243330022,ECE 200,017,103602,Kim; Young-Han,9999,0,9999,0
1668243330022,ECE 200,018,103603,Koushanfar; Farinaz,9999,0,9999,0
1668243330022,ECE 200,019,103604,Kuzum; Duygu,9999,0,9999,0
1668243330022,ECE 200,020,103605,Le; Hanh-Phuc,9999,0,9999,0
1668243330022,ECE 200,021,103606,Lin; Bill,9999,0,9999,0
1668243330022,ECE 200,022,103607,Liu; Zhaowei,9998,0,9999,1
1668243330022,ECE 200,023,103608,Lo; Yu-Hwa,9999,0,9999,0
1668243330022,ECE 200,024,103609,Lomakin; Vitaliy,9999,0,9999,0
1668243330022,ECE 200,025,103610,Mercier; Patrick Philip,9999,0,9999,0
1668243330022,ECE 200,026,103611,Meyer; Florian,9999,0,9999,0
1668243330022,ECE 200,027,103612,Milstein; Laurence B.,9999,0,9999,0
1668243330022,ECE 200,028,103613,Mir Arabbaygi; Siavash,9999,0,9999,0
1668243330022,ECE 200,029,103614,Mookherjea; Shayan,9999,0,9999,0
1668243330022,ECE 200,030,103615,Morris; Karcher William,9999,0,9999,0
1668243330022,ECE 200,031,103616,Ng; Tse Nga,9999,0,9999,0
1668243330022,ECE 200,032,103617,Nguyen; Truong Quang,9999,0,9999,0
1668243330022,ECE 200,033,103618,Nomura; Kenji,9999,0,9999,0
1668243330022,ECE 200,034,103619,Orlitsky; Alon,9999,0,9999,0
1668243330022,ECE 200,035,103620,Pal; Piya,9999,0,9999,0
1668243330022,ECE 200,036,103621,Papen; George C.,9999,0,9999,0
1668243330022,ECE 200,037,103622,Radic; Stojan,9999,0,9999,0
1668243330022,ECE 200,038,103623,Rao; Bhaskar D.,9999,0,9999,0
1668243330022,ECE 200,039,103624,Rao; Ramesh R,9999,0,9999,0
1668243330022,ECE 200,040,103625,Rebeiz; Gabriel,9999,0,9999,0
1668243330022,ECE 200,041,103626,Sanford; John R,9999,0,9999,0
1668243330022,ECE 200,042,103627,Siegel; Paul H.,9999,0,9999,0
1668243330022,ECE 200,043,103628,Sievenpiper; Daniel F.,9999,0,9999,0
1668243330022,ECE 200,044,103629,Sworder; David D.,9999,0,9999,0
1668243330022,ECE 200,045,103630,Taur; Yuan,9999,0,9999,0
1668243330022,ECE 200,046,103631,Touri; Behrouz,9999,0,9999,0
1668243330022,ECE 200,047,103632,Trivedi; Mohan M.,9999,0,9999,0
1668243330022,ECE 200,048,103633,Vasconcelos; Nuno,9999,0,9999,0
1668243330022,ECE 200,049,103634,Wang; Xiaolong,9999,0,9999,0
1668243330022,ECE 200,050,103635,Xie; Pengtao,9999,0,9999,0
1668243330022,ECE 200,051,103636,Yip; Michael,9999,0,9999,0
1668243330022,ECE 200,052,103637,Zeger; Kenneth A.,999,0,999,0
1668243330022,ECE 200,053,103638,Zhang; Xinyu,9999,0,9999,0
1668243330022,ECE 200,054,103639,Turakhia; Yatish Girish,9999,0,9999,0
1668243330022,ECE 200,055,103640,Kang; Mingu,9999,0,9999,0
1668243330022,ECE 200,056,103641,Shi; Yuanyuan,9999,0,9999,0
1668243330022,ECE 200,057,103642,Wang; Edward Jay,9999,0,9999,0
1668243330022,ECE 200,058,103643,Zheng; Yang,9999,0,9999,0
1668243330447,ECE 202,A00,103644,Kuzum; Duygu,0,0,0,0
1668243330873,ECE 212BN,A00,103646,Ng; Tse Nga,0,0,0,0
1668243331311,ECE 221,A00,111493,Staff,0,0,0,0
1668243331744,ECE 222B,A00,103647,Lomakin; Vitaliy,0,0,0,0
1668243332171,ECE 230B,A00,103648,Taur; Yuan,0,0,0,0
1668243332597,ECE 238B,A00,103649,Garay; Javier,0,0,0,0
1668243333020,ECE 240B,A00,112900,Fainman; Yeshaiahu,0,0,0,0
1668243333444,ECE 247A,A00,103650,Jokerst; Jesse Vincent,0,0,0,0
1668243333870,ECE 247B,A00,103651,Wang; Joseph,0,0,0,0
1668243334297,ECE 250,A00,103652,Siegel; Paul H.,0,0,0,0
1668243334727,ECE 251A,A00,103654,Rao; Bhaskar D.,0,0,0,0
1668243335152,ECE 257B,A00,103655,Bharadia; Dinesh,0,0,0,0
1668243335580,ECE 258A,A00,103656,Milstein; Laurence B.,0,0,0,0
1668243336008,ECE 260B,A00,103658,Kang; Mingu,0,0,0,0
1668243336434,ECE 264A,A00,103659,Galton; Ian A,0,0,0,0
1668243336861,ECE 265A,A00,103661,Gudem; Prasad S.S.,0,0,0,0
1668243337307,ECE 265D,A00,103662,Gudem; Prasad S.S.,0,0,0,0
1668243337732,ECE 268,A00,103663,Koushanfar; Farinaz,0,0,0,0
1668243338162,ECE 269,A01,103665,Pal; Piya,0,0,0,0
1668243338590,ECE 271B,A00,103666,Vasconcelos; Manuela,0,0,0,0
1668243339013,ECE 276A,A00,103667,Atanasov; Nikolay A.,0,0,0,0
1668243339439,ECE 277,A00,103668,An; Cheolhong,0,0,0,0
1668243339873,ECE 279,A00,117947,Hall; Drew A.,0,0,0,0
1668243340727,ECE 283,A00,103670,Hsueh; Tzu-Chien,0,0,0,0
1668243341156,ECE 284,A00,103671,Turakhia; Yatish Girish,0,0,0,0
1668243341580,ECE 285,A00,103672,Zheng; Yang,0,0,0,0
1668243341580,ECE 285,B00,103673,Sworder; David D.,0,0,0,0
1668243342004,ECE 287,A00,103676,Javidi; Tara,0,0,0,0
1668243342433,MATH 200B,A00,098023,Salehi Golsefidy; Alireza,12,0,15,3
1668243342861,MATH 202B,A00,098024,Rhoades; Brendon Patrick,9,0,15,6
1668243343285,MATH 203B,A00,098025,Oprea; Dragos N.,10,0,15,5
1668243343710,MATH 204B,A00,098026,Sorensen; Claus M,13,0,15,2
1668243344134,MATH 208,A00,098027,Izadi; Elham,7,0,10,3
1668243344558,MATH 209,A00,098028,Pollack; Aaron,10,0,10,0
1668243344982,MATH 211A,A00,112919,Rogalski; Daniel,9,0,10,1
1668243345409,MATH 211B,A00,112920,Seward; Brandon M.,9,0,10,1
1668243345834,MATH 218,A00,098029,Li; Bo,10,0,10,0
1668243346259,MATH 220B,A00,098030,Novak; Jonathan I,11,0,15,4
1668243346683,MATH 221A,A00,098031,Ebenfelt; Peter F,13,0,15,2
1668243347106,MATH 231B,A00,098032,Zlatos; Andrej,12,0,15,3
1668243347534,MATH 240B,A00,098033,Ni; Lei,9,0,15,6
1668243347967,MATH 243,A00,098034,Jekel; David Andrew,10,0,10,0
1668243348393,MATH 245A,A00,098035,Nie; Jiawang,0,0,15,16
1668243348829,MATH 248,A00,098036,Bejenaru; Ioan,10,0,10,0
1668243349262,MATH 250B,A00,098037,Spolaor; Luca,14,0,15,1
1668243349686,MATH 258,A00,098038,Ni; Lei,10,0,10,0
1668243350113,MATH 264B,A00,098041,Rhoades; Brendon Patrick,9,0,15,6
1668243350538,MATH 268,A00,098042,Buss; Samuel R,10,0,10,0
1668243350970,MATH 269,A00,098043,Rhoades; Brendon Patrick,10,0,10,0
1668243351479,MATH 270B,A00,098044,Li; Bo,10,0,15,5
1668243351920,MATH 272B,A00,098045,Holst; Michael J,13,0,15,2
1668243352345,MATH 273A,A00,098046,Tian; Xiaochuan,10,0,15,5
1668243352771,MATH 275,A01,098048,Tian; Xiaochuan,6,0,10,4
1668243353198,MATH 278A,A00,098049,Holst; Michael J,8,0,10,2
1668243353626,MATH 278B,A00,098050,Cloninger; Alexander,10,0,10,0
1668243354048,MATH 278C,A00,098051,Nie; Jiawang,7,0,10,3
1668243354477,MATH 280B,A00,098052,Zheng; Tianyi,9,0,15,6
1668243354902,MATH 281B,A00,098053,Bradic; Jelena,1,0,15,14
1668243355329,MATH 282B,A00,098054,Arias-Castro; Ery,0,0,15,15
1668243355758,MATH 285,A00,098055,Fitzsimmons; Patrick J,0,0,15,17
1668243356180,MATH 287B,A00,098056,Arias-Castro; Ery,2,0,15,13
1668243356605,MATH 288,A00,098057,Agarwal; Pooja,9,0,10,1
1668243356605,MATH 288,B00,098058,Zhang; Danna,8,0,10,2
1668243356605,MATH 288,C00,098059,Williams; Ruth J,10,0,10,0
1668243357038,MATH 290B,A00,098060,Roberts; Justin Deritter,13,0,15,2
1668243357472,MATH 292,A00,098061,Belmont; Eva Kinoshita,10,0,10,0
1668243357897,MATH 295,A00,098062,Suk; Andrew Hoon,48,0,50,2
1668243358323,MATH 296,A00,098063,Novak; Jonathan I,20,0,20,0
1668243358749,MATH 297,001,098064,Gamst; Anthony Collins,9997,0,9999,2
1668243860228,COGS 205,A00,101395,Chiba; Andrea,19,0,20,1
1668243860657,COGS 210B,001,101404,Greene; Deanna Jacquelyn,9998,0,9999,1
1668243860657,COGS 210B,002,101417,Xia; Haijun,9999,0,9999,0
1668243860657,COGS 210B,003,101422,Nitz; Douglas A.,9999,0,9999,0
1668243860657,COGS 210B,004,101423,Hollan; James D.,9998,0,9999,1
1668243860657,COGS 210B,005,101424,Deak; Gedeon O.,9998,0,9999,1
1668243860657,COGS 210B,006,101425,Rossano; Federico,9999,0,9999,0
1668243861082,COGS 211B,A00,101427,Coulson; Seana M,9996,0,9999,3
1668243861507,COGS 220,A00,101428,Hollan; James D.,0,0,25,25
1668243861934,COGS 229,A00,101429,Dow; Steven P,18,0,25,7
1668243862357,COGS 230,A00,101430,Klemmer; Scott R,12,0,17,5
1668243862785,COGS 234,A00,101431,Xia; Haijun,2,0,25,23
1668243863223,COGS 260,A00,101432,Kiyonaga; Anastasia,21,0,25,4
1668243863223,COGS 260,B00,101433,Kirsh; David Joel,15,0,25,10
1668243863646,CSE 202,A00,102371,Impagliazzo; Russell,0,0,0,0
1668243864069,CSE 203B,A01,102373,Cheng; Chung Kuan,0,0,0,0
1668243864501,CSE 208,A00,102374,Micciancio; Daniele,0,0,0,0
1668243864938,CSE 209A,A00,112895,Impagliazzo; Russell,0,0,15,15
1668243865360,CSE 209B,A00,108005,Bellare; Mihir,0,0,0,0
1668243865789,CSE 210,A00,113163,Coblenz; Michael J,0,0,0,0
1668243866220,CSE 219,A00,106111,Dow; Steven P,0,0,20,20
1668243866651,CSE 221,A00,102376,Voelker; Geoffrey M.,0,0,0,0
1668243867075,CSE 224,A01,102378,Porter; George M,0,0,0,0
1668243867503,CSE 229A,A00,102379,Savage; Stefan,0,0,0,0
1668243867929,CSE 229C,A00,102380,Munyaka; Imani N. S.,0,0,0,0
1668243868351,CSE 232B,A00,102382,Deutsch; Alin Bernard,0,0,0,0
1668243868778,CSE 234,A01,112904,Kumar; Arun Kumar,0,0,0,0
1668243869207,CSE 237A,A00,102383,Rosing; Tajana Simunic,0,0,0,0
1668243869630,CSE 239A,A00,102384,Deutsch; Alin Bernard,0,0,0,0
1668243870070,CSE 239B,A00,102385,Polikarpova; Nadezhda,0,0,0,0
1668243870513,CSE 240A,A00,102386,Pannuto; Patrick William,0,0,0,0
1668243870936,CSE 240B,A00,102387,Zhao; Jishen,0,0,0,0
1668243871359,CSE 241A,A00,106406,Kang; Mingu,0,0,0,0
1668243871797,CSE 249B,A00,102388,Kahng; Andrew Byun,0,0,8,8
1668243872228,CSE 251B,A01,102392,Cottrell; Garrison W,0,0,0,0
1668243872228,CSE 251B,A02,102393,Cottrell; Garrison W,0,0,0,0
1668243872654,CSE 252B,A00,102394,Ochoa; Benjamin Lawrence,0,0,0,0
1668243873153,CSE 257,A01,102396,Gao; Sicun,0,0,0,0
1668243873577,CSE 272,A00,102397,Li; Tzumao,0,0,0,0
1668243874004,CSE 274,A00,111323,Chern; Albert Ren-Haur,0,0,0,0
1668243874426,CSE 282,A00,102398,Pevzner; Pavel Arkadjevich,0,0,0,0
1668243874854,CSE 284,A00,114175,Gymrek; Melissa Ann,0,0,0,0
1668243875280,CSE 290,A00,102399,Chandraker; Manmohan Krishna,0,0,0,0
1668243875280,CSE 290,B00,102400,Vaccaro; Kristen Marie,0,0,25,25
1668243875280,CSE 290,C00,102414,Pannuto; Patrick William,0,0,25,25
1668243875280,CSE 290,D00,102427,Pevzner; Pavel Arkadjevich,0,0,0,0
1668243875280,CSE 290,E00,102429,Zhao; Jishen,0,0,0,0
1668243875280,CSE 290,F00,102436,Tullsen; Dean Michael,0,0,0,0
1668243875280,CSE 290,G00,102440,Christensen; Henrik I,0,0,20,20
1668243875710,CSE 291,A00,102443,Su; Hao,0,0,0,0
1668243875710,CSE 291,B00,102448,Polikarpova; Nadezhda,0,0,0,0
1668243875710,CSE 291,C00,102453,Vaccaro; Kristen Marie,0,0,0,0
1668243875710,CSE 291,D00,111343,Savage; Stefan,0,0,0,0
1668243875710,CSE 291,E00,116474,Claffy; Kimberly Claire,0,0,0,0
1668243875710,CSE 291,F00,116479,Pasquale; Joseph,0,0,0,0
1668243876144,CSE 293,001,119111,Bafna; Vineet,9999,0,9999,0
1668243876144,CSE 293,002,119118,Bellare; Mihir,9999,0,9999,0
1668243876144,CSE 293,003,119122,Berg-Kirkpatrick; Taylor D,9999,0,9999,0
1668243876144,CSE 293,004,119135,Christensen; Henrik I,9999,0,9999,0
1668243876144,CSE 293,005,119142,Cottrell; Garrison W,9999,0,9999,0
1668243876144,CSE 293,006,119146,Deutsch; Alin Bernard,9999,0,9999,0
1668243876144,CSE 293,007,119159,Esmaeilzadeh; Hadi,9999,0,9999,0
1668243876144,CSE 293,008,119166,Freund; Yoav,9999,0,9999,0
1668243876144,CSE 293,009,119170,Griswold; William G.,9999,0,9999,0
1668243876144,CSE 293,010,119183,Gymrek; Melissa Ann,9999,0,9999,0
1668243876144,CSE 293,011,119190,Heninger; Nadia A,9999,0,9999,0
1668243876144,CSE 293,012,119230,Impagliazzo; Russell,9999,0,9999,0
1668243876144,CSE 293,013,119232,Jhala; Ranjit,9999,0,9999,0
1668243876144,CSE 293,014,119233,Kahng; Andrew Byun,9999,0,9999,0
1668243876144,CSE 293,015,119298,Kane; Daniel Mertz,9999,0,9999,0
1668243876144,CSE 293,016,119299,Kriegman; David J,9999,0,9999,0
1668243876144,CSE 293,017,119300,Kumar; Arun Kumar,9999,0,9999,0
1668243876144,CSE 293,018,119301,Lerner; Sorin,9999,0,9999,0
1668243876144,CSE 293,019,119302,Lovett; Shachar,9999,0,9999,0
1668243876144,CSE 293,020,119303,McAuley; Julian John,9999,0,9999,0
1668243876144,CSE 293,021,119304,Micciancio; Daniele,9999,0,9999,0
1668243876144,CSE 293,022,119367,Orailoglu; Alex,9999,0,9999,0
1668243876144,CSE 293,023,119382,Paturi; Ramamohan,9999,0,9999,0
1668243876144,CSE 293,024,119404,Polikarpova; Nadezhda,9999,0,9999,0
1668243876144,CSE 293,025,119406,Politz; Joseph Gibbs,9999,0,9999,0
1668243876144,CSE 293,026,119411,Porter; George M,9999,0,9999,0
1668243876144,CSE 293,027,119414,Porter; Leonard Emerson,9999,0,9999,0
1668243876144,CSE 293,028,119416,Ramamoorthi; Ravi,9999,0,9999,0
1668243876144,CSE 293,029,119417,Sahoo; Debashis,9999,0,9999,0
1668243876144,CSE 293,030,119420,Saul; Lawrence,9999,0,9999,0
1668243876144,CSE 293,031,119421,Savage; Stefan,9999,0,9999,0
1668243876144,CSE 293,032,119425,Schulze; Jurgen P.,9999,0,9999,0
1668243876144,CSE 293,033,119426,Snoeren; Alex C.,9999,0,9999,0
1668243876144,CSE 293,034,119428,Shang; Jingbo,9999,0,9999,0
1668243876144,CSE 293,035,119430,Stefan; Deian,9999,0,9999,0
1668243876144,CSE 293,036,119431,Su; Hao,9999,0,9999,0
1668243876144,CSE 293,037,119433,Swanson; Steven James,9999,0,9999,0
1668243876144,CSE 293,038,119435,Tullsen; Dean Michael,9999,0,9999,0
1668243876144,CSE 293,039,119483,Voelker; Geoffrey M.,9999,0,9999,0
1668243876144,CSE 293,040,119537,Zhao; Jishen,9999,0,9999,0
1668243876144,CSE 293,041,119538,Zhou; Yuan-Yuan,9999,0,9999,0
1668243876144,CSE 293,042,119539,Gao; Sicun,9999,0,9999,0
1668243876144,CSE 293,043,119540,Weibel; Nadir,9999,0,9999,0
1668243876144,CSE 293,044,119541,Gupta; Rajesh K.,9999,0,9999,0
1668243876144,CSE 293,045,126410,Vaccaro; Kristen Marie,9999,0,9999,0
1668243876144,CSE 293,046,126411,Klemke; Richard,9999,0,9999,0
1668243876567,CSE 294,A00,102459,Voelker; Geoffrey M.,0,0,0,0
1668243876567,CSE 294,B00,111322,Orailoglu; Alex,0,0,0,0
1668243876992,DSE 201,A00,096914,Deutsch; Alin Bernard,30,0,30,0
1668243877418,DSE 210,A00,096915,Dasgupta; Sanjoy,30,0,30,0
1668243877840,DSE 260A,A00,096916,Altintas De Callaf; Ilkay,30,0,30,0
1668243878310,ECE 200,001,103586,Antipa; Nicholas A,9999,0,9999,0
1668243878310,ECE 200,002,103587,Atanasov; Nikolay A.,9999,0,9999,0
1668243878310,ECE 200,003,103588,Bharadia; Dinesh,9999,0,9999,0
1668243878310,ECE 200,004,103589,Cheng; Chung Kuan,9999,0,9999,0
1668243878310,ECE 200,005,103590,Cosman; Pamela C.,9999,0,9999,0
1668243878310,ECE 200,006,103591,Dayeh; Shadi Ahmad,9999,0,9999,0
1668243878310,ECE 200,007,103592,Fainman; Yeshaiahu,9999,0,9999,0
1668243878310,ECE 200,008,103593,Ford; Joseph Earl,9999,0,9999,0
1668243878310,ECE 200,009,103594,Franceschetti; Massimo,9999,0,9999,0
1668243878310,ECE 200,010,103595,Fullerton; Eric E,9999,0,9999,0
1668243878310,ECE 200,011,103596,Galton; Ian A,9999,0,9999,0
1668243878310,ECE 200,012,103597,Gilja; Vikash,9999,0,9999,0
1668243878310,ECE 200,013,103598,Hall; Drew A.,9999,0,9999,0
1668243878310,ECE 200,014,103599,Hsueh; Tzu-Chien,9999,0,9999,0
1668243878310,ECE 200,015,103600,Javidi; Tara,9999,0,9999,0
1668243878310,ECE 200,016,103601,Kahng; Andrew Byun,9999,0,9999,0
1668243878310,ECE 200,017,103602,Kim; Young-Han,9999,0,9999,0
1668243878310,ECE 200,018,103603,Koushanfar; Farinaz,9999,0,9999,0
1668243878310,ECE 200,019,103604,Kuzum; Duygu,9999,0,9999,0
1668243878310,ECE 200,020,103605,Le; Hanh-Phuc,9999,0,9999,0
1668243878310,ECE 200,021,103606,Lin; Bill,9999,0,9999,0
1668243878310,ECE 200,022,103607,Liu; Zhaowei,9998,0,9999,1
1668243878310,ECE 200,023,103608,Lo; Yu-Hwa,9999,0,9999,0
1668243878310,ECE 200,024,103609,Lomakin; Vitaliy,9999,0,9999,0
1668243878310,ECE 200,025,103610,Mercier; Patrick Philip,9999,0,9999,0
1668243878310,ECE 200,026,103611,Meyer; Florian,9999,0,9999,0
1668243878310,ECE 200,027,103612,Milstein; Laurence B.,9999,0,9999,0
1668243878310,ECE 200,028,103613,Mir Arabbaygi; Siavash,9999,0,9999,0
1668243878310,ECE 200,029,103614,Mookherjea; Shayan,9999,0,9999,0
1668243878310,ECE 200,030,103615,Morris; Karcher William,9999,0,9999,0
1668243878310,ECE 200,031,103616,Ng; Tse Nga,9999,0,9999,0
1668243878310,ECE 200,032,103617,Nguyen; Truong Quang,9999,0,9999,0
1668243878310,ECE 200,033,103618,Nomura; Kenji,9999,0,9999,0
1668243878310,ECE 200,034,103619,Orlitsky; Alon,9999,0,9999,0
1668243878310,ECE 200,035,103620,Pal; Piya,9999,0,9999,0
1668243878310,ECE 200,036,103621,Papen; George C.,9999,0,9999,0
1668243878310,ECE 200,037,103622,Radic; Stojan,9999,0,9999,0
1668243878310,ECE 200,038,103623,Rao; Bhaskar D.,9999,0,9999,0
1668243878310,ECE 200,039,103624,Rao; Ramesh R,9999,0,9999,0
1668243878310,ECE 200,040,103625,Rebeiz; Gabriel,9999,0,9999,0
1668243878310,ECE 200,041,103626,Sanford; John R,9999,0,9999,0
1668243878310,ECE 200,042,103627,Siegel; Paul H.,9999,0,9999,0
1668243878310,ECE 200,043,103628,Sievenpiper; Daniel F.,9999,0,9999,0
1668243878310,ECE 200,044,103629,Sworder; David D.,9999,0,9999,0
1668243878310,ECE 200,045,103630,Taur; Yuan,9999,0,9999,0
1668243878310,ECE 200,046,103631,Touri; Behrouz,9999,0,9999,0
1668243878310,ECE 200,047,103632,Trivedi; Mohan M.,9999,0,9999,0
1668243878310,ECE 200,048,103633,Vasconcelos; Nuno,9999,0,9999,0
1668243878310,ECE 200,049,103634,Wang; Xiaolong,9999,0,9999,0
1668243878310,ECE 200,050,103635,Xie; Pengtao,9999,0,9999,0
1668243878310,ECE 200,051,103636,Yip; Michael,9999,0,9999,0
1668243878310,ECE 200,052,103637,Zeger; Kenneth A.,999,0,999,0
1668243878310,ECE 200,053,103638,Zhang; Xinyu,9999,0,9999,0
1668243878310,ECE 200,054,103639,Turakhia; Yatish Girish,9999,0,9999,0
1668243878310,ECE 200,055,103640,Kang; Mingu,9999,0,9999,0
1668243878310,ECE 200,056,103641,Shi; Yuanyuan,9999,0,9999,0
1668243878310,ECE 200,057,103642,Wang; Edward Jay,9999,0,9999,0
1668243878310,ECE 200,058,103643,Zheng; Yang,9999,0,9999,0
1668243878737,ECE 202,A00,103644,Kuzum; Duygu,0,0,0,0
1668243879160,ECE 212BN,A00,103646,Ng; Tse Nga,0,0,0,0
1668243879585,ECE 221,A00,111493,Staff,0,0,0,0
1668243880011,ECE 222B,A00,103647,Lomakin; Vitaliy,0,0,0,0
1668243880439,ECE 230B,A00,103648,Taur; Yuan,0,0,0,0
1668243880865,ECE 238B,A00,103649,Garay; Javier,0,0,0,0
1668243881288,ECE 240B,A00,112900,Fainman; Yeshaiahu,0,0,0,0
1668243881712,ECE 247A,A00,103650,Jokerst; Jesse Vincent,0,0,0,0
1668243882136,ECE 247B,A00,103651,Wang; Joseph,0,0,0,0
1668243882561,ECE 250,A00,103652,Siegel; Paul H.,0,0,0,0
1668243882985,ECE 251A,A00,103654,Rao; Bhaskar D.,0,0,0,0
1668243883409,ECE 257B,A00,103655,Bharadia; Dinesh,0,0,0,0
1668243883832,ECE 258A,A00,103656,Milstein; Laurence B.,0,0,0,0
1668243884256,ECE 260B,A00,103658,Kang; Mingu,0,0,0,0
1668243884680,ECE 264A,A00,103659,Galton; Ian A,0,0,0,0
1668243885107,ECE 265A,A00,103661,Gudem; Prasad S.S.,0,0,0,0
1668243885530,ECE 265D,A00,103662,Gudem; Prasad S.S.,0,0,0,0
1668243885956,ECE 268,A00,103663,Koushanfar; Farinaz,0,0,0,0
1668243886380,ECE 269,A01,103665,Pal; Piya,0,0,0,0
1668243886807,ECE 271B,A00,103666,Vasconcelos; Manuela,0,0,0,0
1668243887233,ECE 276A,A00,103667,Atanasov; Nikolay A.,0,0,0,0
1668243887669,ECE 277,A00,103668,An; Cheolhong,0,0,0,0
1668243888094,ECE 279,A00,117947,Hall; Drew A.,0,0,0,0
1668243888943,ECE 283,A00,103670,Hsueh; Tzu-Chien,0,0,0,0
1668243889368,ECE 284,A00,103671,Turakhia; Yatish Girish,0,0,0,0
1668243889795,ECE 285,A00,103672,Zheng; Yang,0,0,0,0
1668243889795,ECE 285,B00,103673,Sworder; David D.,0,0,0,0
1668243890222,ECE 287,A00,103676,Javidi; Tara,0,0,0,0
1668243890648,MATH 200B,A00,098023,Salehi Golsefidy; Alireza,12,0,15,3
1668243891087,MATH 202B,A00,098024,Rhoades; Brendon Patrick,9,0,15,6
1668243891514,MATH 203B,A00,098025,Oprea; Dragos N.,10,0,15,5
1668243891940,MATH 204B,A00,098026,Sorensen; Claus M,13,0,15,2
1668243892365,MATH 208,A00,098027,Izadi; Elham,7,0,10,3
1668243892790,MATH 209,A00,098028,Pollack; Aaron,10,0,10,0
1668243893221,MATH 211A,A00,112919,Rogalski; Daniel,9,0,10,1
1668243893648,MATH 211B,A00,112920,Seward; Brandon M.,9,0,10,1
1668243894083,MATH 218,A00,098029,Li; Bo,10,0,10,0
1668243894505,MATH 220B,A00,098030,Novak; Jonathan I,11,0,15,4
1668243894941,MATH 221A,A00,098031,Ebenfelt; Peter F,13,0,15,2
1668243895375,MATH 231B,A00,098032,Zlatos; Andrej,12,0,15,3
1668243895800,MATH 240B,A00,098033,Ni; Lei,9,0,15,6
1668243896224,MATH 243,A00,098034,Jekel; David Andrew,10,0,10,0
1668243896653,MATH 245A,A00,098035,Nie; Jiawang,0,0,15,16
1668243897079,MATH 248,A00,098036,Bejenaru; Ioan,10,0,10,0
1668243897507,MATH 250B,A00,098037,Spolaor; Luca,14,0,15,1
1668243897933,MATH 258,A00,098038,Ni; Lei,10,0,10,0
1668243898356,MATH 264B,A00,098041,Rhoades; Brendon Patrick,9,0,15,6
1668243898778,MATH 268,A00,098042,Buss; Samuel R,10,0,10,0
1668243899201,MATH 269,A00,098043,Rhoades; Brendon Patrick,10,0,10,0
1668243899651,MATH 270B,A00,098044,Li; Bo,10,0,15,5
1668243900086,MATH 272B,A00,098045,Holst; Michael J,13,0,15,2
1668243900521,MATH 273A,A00,098046,Tian; Xiaochuan,10,0,15,5
1668243900945,MATH 275,A01,098048,Tian; Xiaochuan,6,0,10,4
1668243901380,MATH 278A,A00,098049,Holst; Michael J,8,0,10,2
1668243901815,MATH 278B,A00,098050,Cloninger; Alexander,10,0,10,0
1668243902248,MATH 278C,A00,098051,Nie; Jiawang,7,0,10,3
1668243902672,MATH 280B,A00,098052,Zheng; Tianyi,9,0,15,6
1668243903113,MATH 281B,A00,098053,Bradic; Jelena,1,0,15,14
1668243903540,MATH 282B,A00,098054,Arias-Castro; Ery,0,0,15,15
1668243903964,MATH 285,A00,098055,Fitzsimmons; Patrick J,0,0,15,17
1668243904391,MATH 287B,A00,098056,Arias-Castro; Ery,2,0,15,13
1668243904820,MATH 288,A00,098057,Agarwal; Pooja,9,0,10,1
1668243904820,MATH 288,B00,098058,Zhang; Danna,8,0,10,2
1668243904820,MATH 288,C00,098059,Williams; Ruth J,10,0,10,0
1668243905250,MATH 290B,A00,098060,Roberts; Justin Deritter,13,0,15,2
1668243905677,MATH 292,A00,098061,Belmont; Eva Kinoshita,10,0,10,0
1668243906103,MATH 295,A00,098062,Suk; Andrew Hoon,48,0,50,2
1668243906533,MATH 296,A00,098063,Novak; Jonathan I,20,0,20,0
1668243906958,MATH 297,001,098064,Gamst; Anthony Collins,9997,0,9999,2
1668244407398,COGS 205,A00,101395,Chiba; Andrea,19,0,20,1
1668244407825,COGS 210B,001,101404,Greene; Deanna Jacquelyn,9998,0,9999,1
1668244407825,COGS 210B,002,101417,Xia; Haijun,9999,0,9999,0
1668244407825,COGS 210B,003,101422,Nitz; Douglas A.,9999,0,9999,0
1668244407825,COGS 210B,004,101423,Hollan; James D.,9998,0,9999,1
1668244407825,COGS 210B,005,101424,Deak; Gedeon O.,9998,0,9999,1
1668244407825,COGS 210B,006,101425,Rossano; Federico,9999,0,9999,0
1668244408260,COGS 211B,A00,101427,Coulson; Seana M,9996,0,9999,3
1668244408685,COGS 220,A00,101428,Hollan; James D.,0,0,25,25
1668244409110,COGS 229,A00,101429,Dow; Steven P,18,0,25,7
1668244409533,COGS 230,A00,101430,Klemmer; Scott R,12,0,17,5
1668244409957,COGS 234,A00,101431,Xia; Haijun,2,0,25,23
1668244410380,COGS 260,A00,101432,Kiyonaga; Anastasia,21,0,25,4
1668244410380,COGS 260,B00,101433,Kirsh; David Joel,15,0,25,10
1668244410806,CSE 202,A00,102371,Impagliazzo; Russell,0,0,0,0
1668244411230,CSE 203B,A01,102373,Cheng; Chung Kuan,0,0,0,0
1668244411654,CSE 208,A00,102374,Micciancio; Daniele,0,0,0,0
1668244412079,CSE 209A,A00,112895,Impagliazzo; Russell,0,0,15,15
1668244412506,CSE 209B,A00,108005,Bellare; Mihir,0,0,0,0
1668244412942,CSE 210,A00,113163,Coblenz; Michael J,0,0,0,0
1668244413366,CSE 219,A00,106111,Dow; Steven P,0,0,20,20
1668244413799,CSE 221,A00,102376,Voelker; Geoffrey M.,0,0,0,0
1668244414227,CSE 224,A01,102378,Porter; George M,0,0,0,0
1668244414657,CSE 229A,A00,102379,Savage; Stefan,0,0,0,0
1668244415086,CSE 229C,A00,102380,Munyaka; Imani N. S.,0,0,0,0
1668244415522,CSE 232B,A00,102382,Deutsch; Alin Bernard,0,0,0,0
1668244415956,CSE 234,A01,112904,Kumar; Arun Kumar,0,0,0,0
1668244416378,CSE 237A,A00,102383,Rosing; Tajana Simunic,0,0,0,0
1668244416806,CSE 239A,A00,102384,Deutsch; Alin Bernard,0,0,0,0
1668244417229,CSE 239B,A00,102385,Polikarpova; Nadezhda,0,0,0,0
1668244417656,CSE 240A,A00,102386,Pannuto; Patrick William,0,0,0,0
1668244418082,CSE 240B,A00,102387,Zhao; Jishen,0,0,0,0
1668244418505,CSE 241A,A00,106406,Kang; Mingu,0,0,0,0
1668244418931,CSE 249B,A00,102388,Kahng; Andrew Byun,0,0,8,8
1668244419354,CSE 251B,A01,102392,Cottrell; Garrison W,0,0,0,0
1668244419354,CSE 251B,A02,102393,Cottrell; Garrison W,0,0,0,0
1668244419787,CSE 252B,A00,102394,Ochoa; Benjamin Lawrence,0,0,0,0
1668244420219,CSE 257,A01,102396,Gao; Sicun,0,0,0,0
1668244420649,CSE 272,A00,102397,Li; Tzumao,0,0,0,0
1668244421075,CSE 274,A00,111323,Chern; Albert Ren-Haur,0,0,0,0
1668244421501,CSE 282,A00,102398,Pevzner; Pavel Arkadjevich,0,0,0,0
1668244421925,CSE 284,A00,114175,Gymrek; Melissa Ann,0,0,0,0
1668244422351,CSE 290,A00,102399,Chandraker; Manmohan Krishna,0,0,0,0
1668244422351,CSE 290,B00,102400,Vaccaro; Kristen Marie,0,0,25,25
1668244422351,CSE 290,C00,102414,Pannuto; Patrick William,0,0,25,25
1668244422351,CSE 290,D00,102427,Pevzner; Pavel Arkadjevich,0,0,0,0
1668244422351,CSE 290,E00,102429,Zhao; Jishen,0,0,0,0
1668244422351,CSE 290,F00,102436,Tullsen; Dean Michael,0,0,0,0
1668244422351,CSE 290,G00,102440,Christensen; Henrik I,0,0,20,20
1668244422775,CSE 291,A00,102443,Su; Hao,0,0,0,0
1668244422775,CSE 291,B00,102448,Polikarpova; Nadezhda,0,0,0,0
1668244422775,CSE 291,C00,102453,Vaccaro; Kristen Marie,0,0,0,0
1668244422775,CSE 291,D00,111343,Savage; Stefan,0,0,0,0
1668244422775,CSE 291,E00,116474,Claffy; Kimberly Claire,0,0,0,0
1668244422775,CSE 291,F00,116479,Pasquale; Joseph,0,0,0,0
1668244423205,CSE 293,001,119111,Bafna; Vineet,9999,0,9999,0
1668244423205,CSE 293,002,119118,Bellare; Mihir,9999,0,9999,0
1668244423205,CSE 293,003,119122,Berg-Kirkpatrick; Taylor D,9999,0,9999,0
1668244423205,CSE 293,004,119135,Christensen; Henrik I,9999,0,9999,0
1668244423205,CSE 293,005,119142,Cottrell; Garrison W,9999,0,9999,0
1668244423205,CSE 293,006,119146,Deutsch; Alin Bernard,9999,0,9999,0
1668244423205,CSE 293,007,119159,Esmaeilzadeh; Hadi,9999,0,9999,0
1668244423205,CSE 293,008,119166,Freund; Yoav,9999,0,9999,0
1668244423205,CSE 293,009,119170,Griswold; William G.,9999,0,9999,0
1668244423205,CSE 293,010,119183,Gymrek; Melissa Ann,9999,0,9999,0
1668244423205,CSE 293,011,119190,Heninger; Nadia A,9999,0,9999,0
1668244423205,CSE 293,012,119230,Impagliazzo; Russell,9999,0,9999,0
1668244423205,CSE 293,013,119232,Jhala; Ranjit,9999,0,9999,0
1668244423205,CSE 293,014,119233,Kahng; Andrew Byun,9999,0,9999,0
1668244423205,CSE 293,015,119298,Kane; Daniel Mertz,9999,0,9999,0
1668244423205,CSE 293,016,119299,Kriegman; David J,9999,0,9999,0
1668244423205,CSE 293,017,119300,Kumar; Arun Kumar,9999,0,9999,0
1668244423205,CSE 293,018,119301,Lerner; Sorin,9999,0,9999,0
1668244423205,CSE 293,019,119302,Lovett; Shachar,9999,0,9999,0
1668244423205,CSE 293,020,119303,McAuley; Julian John,9999,0,9999,0
1668244423205,CSE 293,021,119304,Micciancio; Daniele,9999,0,9999,0
1668244423205,CSE 293,022,119367,Orailoglu; Alex,9999,0,9999,0
1668244423205,CSE 293,023,119382,Paturi; Ramamohan,9999,0,9999,0
1668244423205,CSE 293,024,119404,Polikarpova; Nadezhda,9999,0,9999,0
1668244423205,CSE 293,025,119406,Politz; Joseph Gibbs,9999,0,9999,0
1668244423205,CSE 293,026,119411,Porter; George M,9999,0,9999,0
1668244423205,CSE 293,027,119414,Porter; Leonard Emerson,9999,0,9999,0
1668244423205,CSE 293,028,119416,Ramamoorthi; Ravi,9999,0,9999,0
1668244423205,CSE 293,029,119417,Sahoo; Debashis,9999,0,9999,0
1668244423205,CSE 293,030,119420,Saul; Lawrence,9999,0,9999,0
1668244423205,CSE 293,031,119421,Savage; Stefan,9999,0,9999,0
1668244423205,CSE 293,032,119425,Schulze; Jurgen P.,9999,0,9999,0
1668244423205,CSE 293,033,119426,Snoeren; Alex C.,9999,0,9999,0
1668244423205,CSE 293,034,119428,Shang; Jingbo,9999,0,9999,0
1668244423205,CSE 293,035,119430,Stefan; Deian,9999,0,9999,0
1668244423205,CSE 293,036,119431,Su; Hao,9999,0,9999,0
1668244423205,CSE 293,037,119433,Swanson; Steven James,9999,0,9999,0
1668244423205,CSE 293,038,119435,Tullsen; Dean Michael,9999,0,9999,0
1668244423205,CSE 293,039,119483,Voelker; Geoffrey M.,9999,0,9999,0
1668244423205,CSE 293,040,119537,Zhao; Jishen,9999,0,9999,0
1668244423205,CSE 293,041,119538,Zhou; Yuan-Yuan,9999,0,9999,0
1668244423205,CSE 293,042,119539,Gao; Sicun,9999,0,9999,0
1668244423205,CSE 293,043,119540,Weibel; Nadir,9999,0,9999,0
1668244423205,CSE 293,044,119541,Gupta; Rajesh K.,9999,0,9999,0
1668244423205,CSE 293,045,126410,Vaccaro; Kristen Marie,9999,0,9999,0
1668244423205,CSE 293,046,126411,Klemke; Richard,9999,0,9999,0
1668244423630,CSE 294,A00,102459,Voelker; Geoffrey M.,0,0,0,0
1668244423630,CSE 294,B00,111322,Orailoglu; Alex,0,0,0,0
1668244424054,DSE 201,A00,096914,Deutsch; Alin Bernard,30,0,30,0
1668244424478,DSE 210,A00,096915,Dasgupta; Sanjoy,30,0,30,0
1668244424904,DSE 260A,A00,096916,Altintas De Callaf; Ilkay,30,0,30,0
1668244425358,ECE 200,001,103586,Antipa; Nicholas A,9999,0,9999,0
1668244425358,ECE 200,002,103587,Atanasov; Nikolay A.,9999,0,9999,0
1668244425358,ECE 200,003,103588,Bharadia; Dinesh,9999,0,9999,0
1668244425358,ECE 200,004,103589,Cheng; Chung Kuan,9999,0,9999,0
1668244425358,ECE 200,005,103590,Cosman; Pamela C.,9999,0,9999,0
1668244425358,ECE 200,006,103591,Dayeh; Shadi Ahmad,9999,0,9999,0
1668244425358,ECE 200,007,103592,Fainman; Yeshaiahu,9999,0,9999,0
1668244425358,ECE 200,008,103593,Ford; Joseph Earl,9999,0,9999,0
1668244425358,ECE 200,009,103594,Franceschetti; Massimo,9999,0,9999,0
1668244425358,ECE 200,010,103595,Fullerton; Eric E,9999,0,9999,0
1668244425358,ECE 200,011,103596,Galton; Ian A,9999,0,9999,0
1668244425358,ECE 200,012,103597,Gilja; Vikash,9999,0,9999,0
1668244425358,ECE 200,013,103598,Hall; Drew A.,9999,0,9999,0
1668244425358,ECE 200,014,103599,Hsueh; Tzu-Chien,9999,0,9999,0
1668244425358,ECE 200,015,103600,Javidi; Tara,9999,0,9999,0
1668244425358,ECE 200,016,103601,Kahng; Andrew Byun,9999,0,9999,0
1668244425358,ECE 200,017,103602,Kim; Young-Han,9999,0,9999,0
1668244425358,ECE 200,018,103603,Koushanfar; Farinaz,9999,0,9999,0
1668244425358,ECE 200,019,103604,Kuzum; Duygu,9999,0,9999,0
1668244425358,ECE 200,020,103605,Le; Hanh-Phuc,9999,0,9999,0
1668244425358,ECE 200,021,103606,Lin; Bill,9999,0,9999,0
1668244425358,ECE 200,022,103607,Liu; Zhaowei,9998,0,9999,1
1668244425358,ECE 200,023,103608,Lo; Yu-Hwa,9999,0,9999,0
1668244425358,ECE 200,024,103609,Lomakin; Vitaliy,9999,0,9999,0
1668244425358,ECE 200,025,103610,Mercier; Patrick Philip,9999,0,9999,0
1668244425358,ECE 200,026,103611,Meyer; Florian,9999,0,9999,0
1668244425358,ECE 200,027,103612,Milstein; Laurence B.,9999,0,9999,0
1668244425358,ECE 200,028,103613,Mir Arabbaygi; Siavash,9999,0,9999,0
1668244425358,ECE 200,029,103614,Mookherjea; Shayan,9999,0,9999,0
1668244425358,ECE 200,030,103615,Morris; Karcher William,9999,0,9999,0
1668244425358,ECE 200,031,103616,Ng; Tse Nga,9999,0,9999,0
1668244425358,ECE 200,032,103617,Nguyen; Truong Quang,9999,0,9999,0
1668244425358,ECE 200,033,103618,Nomura; Kenji,9999,0,9999,0
1668244425358,ECE 200,034,103619,Orlitsky; Alon,9999,0,9999,0
1668244425358,ECE 200,035,103620,Pal; Piya,9999,0,9999,0
1668244425358,ECE 200,036,103621,Papen; George C.,9999,0,9999,0
1668244425358,ECE 200,037,103622,Radic; Stojan,9999,0,9999,0
1668244425358,ECE 200,038,103623,Rao; Bhaskar D.,9999,0,9999,0
1668244425358,ECE 200,039,103624,Rao; Ramesh R,9999,0,9999,0
1668244425358,ECE 200,040,103625,Rebeiz; Gabriel,9999,0,9999,0
1668244425358,ECE 200,041,103626,Sanford; John R,9999,0,9999,0
1668244425358,ECE 200,042,103627,Siegel; Paul H.,9999,0,9999,0
1668244425358,ECE 200,043,103628,Sievenpiper; Daniel F.,9999,0,9999,0
1668244425358,ECE 200,044,103629,Sworder; David D.,9999,0,9999,0
1668244425358,ECE 200,045,103630,Taur; Yuan,9999,0,9999,0
1668244425358,ECE 200,046,103631,Touri; Behrouz,9999,0,9999,0
1668244425358,ECE 200,047,103632,Trivedi; Mohan M.,9999,0,9999,0
1668244425358,ECE 200,048,103633,Vasconcelos; Nuno,9999,0,9999,0
1668244425358,ECE 200,049,103634,Wang; Xiaolong,9999,0,9999,0
1668244425358,ECE 200,050,103635,Xie; Pengtao,9999,0,9999,0
1668244425358,ECE 200,051,103636,Yip; Michael,9999,0,9999,0
1668244425358,ECE 200,052,103637,Zeger; Kenneth A.,999,0,999,0
1668244425358,ECE 200,053,103638,Zhang; Xinyu,9999,0,9999,0
1668244425358,ECE 200,054,103639,Turakhia; Yatish Girish,9999,0,9999,0
1668244425358,ECE 200,055,103640,Kang; Mingu,9999,0,9999,0
1668244425358,ECE 200,056,103641,Shi; Yuanyuan,9999,0,9999,0
1668244425358,ECE 200,057,103642,Wang; Edward Jay,9999,0,9999,0
1668244425358,ECE 200,058,103643,Zheng; Yang,9999,0,9999,0
1668244425782,ECE 202,A00,103644,Kuzum; Duygu,0,0,0,0
1668244426206,ECE 212BN,A00,103646,Ng; Tse Nga,0,0,0,0
1668244426632,ECE 221,A00,111493,Staff,0,0,0,0
1668244427055,ECE 222B,A00,103647,Lomakin; Vitaliy,0,0,0,0
1668244427480,ECE 230B,A00,103648,Taur; Yuan,0,0,0,0
1668244427918,ECE 238B,A00,103649,Garay; Javier,0,0,0,0
1668244428343,ECE 240B,A00,112900,Fainman; Yeshaiahu,0,0,0,0
1668244428768,ECE 247A,A00,103650,Jokerst; Jesse Vincent,0,0,0,0
1668244429199,ECE 247B,A00,103651,Wang; Joseph,0,0,0,0
1668244429627,ECE 250,A00,103652,Siegel; Paul H.,0,0,0,0
1668244430055,ECE 251A,A00,103654,Rao; Bhaskar D.,0,0,0,0
1668244430485,ECE 257B,A00,103655,Bharadia; Dinesh,0,0,0,0
1668244430909,ECE 258A,A00,103656,Milstein; Laurence B.,0,0,0,0
1668244431331,ECE 260B,A00,103658,Kang; Mingu,0,0,0,0
1668244431760,ECE 264A,A00,103659,Galton; Ian A,0,0,0,0
1668244432186,ECE 265A,A00,103661,Gudem; Prasad S.S.,0,0,0,0
1668244432625,ECE 265D,A00,103662,Gudem; Prasad S.S.,0,0,0,0
1668244433052,ECE 268,A00,103663,Koushanfar; Farinaz,0,0,0,0
1668244433478,ECE 269,A01,103665,Pal; Piya,0,0,0,0
1668244433902,ECE 271B,A00,103666,Vasconcelos; Manuela,0,0,0,0
1668244434329,ECE 276A,A00,103667,Atanasov; Nikolay A.,0,0,0,0
1668244434775,ECE 277,A00,103668,An; Cheolhong,0,0,0,0
1668244435200,ECE 279,A00,117947,Hall; Drew A.,0,0,0,0
1668244436055,ECE 283,A00,103670,Hsueh; Tzu-Chien,0,0,0,0
1668244436482,ECE 284,A00,103671,Turakhia; Yatish Girish,0,0,0,0
1668244437000,ECE 285,A00,103672,Zheng; Yang,0,0,0,0
1668244437000,ECE 285,B00,103673,Sworder; David D.,0,0,0,0
1668244437425,ECE 287,A00,103676,Javidi; Tara,0,0,0,0
1668244437853,MATH 200B,A00,098023,Salehi Golsefidy; Alireza,12,0,15,3
1668244438280,MATH 202B,A00,098024,Rhoades; Brendon Patrick,9,0,15,6
1668244438709,MATH 203B,A00,098025,Oprea; Dragos N.,10,0,15,5
1668244439142,MATH 204B,A00,098026,Sorensen; Claus M,13,0,15,2
1668244439574,MATH 208,A00,098027,Izadi; Elham,7,0,10,3
1668244440000,MATH 209,A00,098028,Pollack; Aaron,10,0,10,0
1668244440426,MATH 211A,A00,112919,Rogalski; Daniel,9,0,10,1
1668244440852,MATH 211B,A00,112920,Seward; Brandon M.,9,0,10,1
1668244441278,MATH 218,A00,098029,Li; Bo,10,0,10,0
1668244441702,MATH 220B,A00,098030,Novak; Jonathan I,11,0,15,4
1668244442127,MATH 221A,A00,098031,Ebenfelt; Peter F,13,0,15,2
1668244442550,MATH 231B,A00,098032,Zlatos; Andrej,12,0,15,3
1668244442973,MATH 240B,A00,098033,Ni; Lei,9,0,15,6
1668244443397,MATH 243,A00,098034,Jekel; David Andrew,10,0,10,0
1668244443820,MATH 245A,A00,098035,Nie; Jiawang,0,0,15,16
1668244444248,MATH 248,A00,098036,Bejenaru; Ioan,10,0,10,0
1668244444674,MATH 250B,A00,098037,Spolaor; Luca,14,0,15,1
1668244445101,MATH 258,A00,098038,Ni; Lei,10,0,10,0
1668244445528,MATH 264B,A00,098041,Rhoades; Brendon Patrick,9,0,15,6
1668244445954,MATH 268,A00,098042,Buss; Samuel R,10,0,10,0
1668244446377,MATH 269,A00,098043,Rhoades; Brendon Patrick,10,0,10,0
1668244446800,MATH 270B,A00,098044,Li; Bo,10,0,15,5
1668244447226,MATH 272B,A00,098045,Holst; Michael J,13,0,15,2
1668244447658,MATH 273A,A00,098046,Tian; Xiaochuan,10,0,15,5
1668244448081,MATH 275,A01,098048,Tian; Xiaochuan,6,0,10,4
1668244448504,MATH 278A,A00,098049,Holst; Michael J,8,0,10,2
1668244448928,MATH 278B,A00,098050,Cloninger; Alexander,10,0,10,0
1668244449354,MATH 278C,A00,098051,Nie; Jiawang,7,0,10,3
1668244449778,MATH 280B,A00,098052,Zheng; Tianyi,9,0,15,6
1668244450201,MATH 281B,A00,098053,Bradic; Jelena,1,0,15,14
1668244450625,MATH 282B,A00,098054,Arias-Castro; Ery,0,0,15,15
1668244451049,MATH 285,A00,098055,Fitzsimmons; Patrick J,0,0,15,17
1668244451476,MATH 287B,A00,098056,Arias-Castro; Ery,2,0,15,13
1668244451900,MATH 288,A00,098057,Agarwal; Pooja,9,0,10,1
1668244451900,MATH 288,B00,098058,Zhang; Danna,8,0,10,2
1668244451900,MATH 288,C00,098059,Williams; Ruth J,10,0,10,0
1668244452323,MATH 290B,A00,098060,Roberts; Justin Deritter,13,0,15,2
1668244452746,MATH 292,A00,098061,Belmont; Eva Kinoshita,10,0,10,0
1668244453170,MATH 295,A00,098062,Suk; Andrew Hoon,48,0,50,2
1668244453601,MATH 296,A00,098063,Novak; Jonathan I,20,0,20,0
1668244454030,MATH 297,001,098064,Gamst; Anthony Collins,9997,0,9999,2
1668244955273,COGS 205,A00,101395,Chiba; Andrea,19,0,20,1
1668244955705,COGS 210B,001,101404,Greene; Deanna Jacquelyn,9998,0,9999,1
1668244955705,COGS 210B,002,101417,Xia; Haijun,9999,0,9999,0
1668244955705,COGS 210B,003,101422,Nitz; Douglas A.,9999,0,9999,0
1668244955705,COGS 210B,004,101423,Hollan; James D.,9998,0,9999,1
1668244955705,COGS 210B,005,101424,Deak; Gedeon O.,9998,0,9999,1
1668244955705,COGS 210B,006,101425,Rossano; Federico,9999,0,9999,0
1668244956131,COGS 211B,A00,101427,Coulson; Seana M,9996,0,9999,3
1668244956554,COGS 220,A00,101428,Hollan; James D.,0,0,25,25
1668244956979,COGS 229,A00,101429,Dow; Steven P,18,0,25,7
1668244957406,COGS 230,A00,101430,Klemmer; Scott R,12,0,17,5
1668244957835,COGS 234,A00,101431,Xia; Haijun,2,0,25,23
1668244958355,COGS 260,A00,101432,Kiyonaga; Anastasia,21,0,25,4
1668244958355,COGS 260,B00,101433,Kirsh; David Joel,15,0,25,10
1668244958786,CSE 202,A00,102371,Impagliazzo; Russell,0,0,0,0
1668244959214,CSE 203B,A01,102373,Cheng; Chung Kuan,0,0,0,0
1668244959637,CSE 208,A00,102374,Micciancio; Daniele,0,0,0,0
1668244960067,CSE 209A,A00,112895,Impagliazzo; Russell,0,0,15,15
1668244960491,CSE 209B,A00,108005,Bellare; Mihir,0,0,0,0
1668244960917,CSE 210,A00,113163,Coblenz; Michael J,0,0,0,0
1668244961342,CSE 219,A00,106111,Dow; Steven P,0,0,20,20
1668244961767,CSE 221,A00,102376,Voelker; Geoffrey M.,0,0,0,0
1668244962193,CSE 224,A01,102378,Porter; George M,0,0,0,0
1668244962615,CSE 229A,A00,102379,Savage; Stefan,0,0,0,0
1668244963040,CSE 229C,A00,102380,Munyaka; Imani N. S.,0,0,0,0
1668244963464,CSE 232B,A00,102382,Deutsch; Alin Bernard,0,0,0,0
1668244963893,CSE 234,A01,112904,Kumar; Arun Kumar,0,0,0,0
1668244964325,CSE 237A,A00,102383,Rosing; Tajana Simunic,0,0,0,0
1668244964753,CSE 239A,A00,102384,Deutsch; Alin Bernard,0,0,0,0
1668244965178,CSE 239B,A00,102385,Polikarpova; Nadezhda,0,0,0,0
1668244965600,CSE 240A,A00,102386,Pannuto; Patrick William,0,0,0,0
1668244966026,CSE 240B,A00,102387,Zhao; Jishen,0,0,0,0
1668244966463,CSE 241A,A00,106406,Kang; Mingu,0,0,0,0
1668244966889,CSE 249B,A00,102388,Kahng; Andrew Byun,0,0,8,8
1668244967313,CSE 251B,A01,102392,Cottrell; Garrison W,0,0,0,0
1668244967313,CSE 251B,A02,102393,Cottrell; Garrison W,0,0,0,0
1668244967737,CSE 252B,A00,102394,Ochoa; Benjamin Lawrence,0,0,0,0
1668244968161,CSE 257,A01,102396,Gao; Sicun,0,0,0,0
1668244968591,CSE 272,A00,102397,Li; Tzumao,0,0,0,0
1668244969021,CSE 274,A00,111323,Chern; Albert Ren-Haur,0,0,0,0
1668244969450,CSE 282,A00,102398,Pevzner; Pavel Arkadjevich,0,0,0,0
1668244969882,CSE 284,A00,114175,Gymrek; Melissa Ann,0,0,0,0
1668244970321,CSE 290,A00,102399,Chandraker; Manmohan Krishna,0,0,0,0
1668244970321,CSE 290,B00,102400,Vaccaro; Kristen Marie,0,0,25,25
1668244970321,CSE 290,C00,102414,Pannuto; Patrick William,0,0,25,25
1668244970321,CSE 290,D00,102427,Pevzner; Pavel Arkadjevich,0,0,0,0
1668244970321,CSE 290,E00,102429,Zhao; Jishen,0,0,0,0
1668244970321,CSE 290,F00,102436,Tullsen; Dean Michael,0,0,0,0
1668244970321,CSE 290,G00,102440,Christensen; Henrik I,0,0,20,20
1668244970750,CSE 291,A00,102443,Su; Hao,0,0,0,0
1668244970750,CSE 291,B00,102448,Polikarpova; Nadezhda,0,0,0,0
1668244970750,CSE 291,C00,102453,Vaccaro; Kristen Marie,0,0,0,0
1668244970750,CSE 291,D00,111343,Savage; Stefan,0,0,0,0
1668244970750,CSE 291,E00,116474,Claffy; Kimberly Claire,0,0,0,0
1668244970750,CSE 291,F00,116479,Pasquale; Joseph,0,0,0,0
1668244971200,CSE 293,001,119111,Bafna; Vineet,9999,0,9999,0
1668244971200,CSE 293,002,119118,Bellare; Mihir,9999,0,9999,0
1668244971200,CSE 293,003,119122,Berg-Kirkpatrick; Taylor D,9999,0,9999,0
1668244971200,CSE 293,004,119135,Christensen; Henrik I,9999,0,9999,0
1668244971200,CSE 293,005,119142,Cottrell; Garrison W,9999,0,9999,0
1668244971200,CSE 293,006,119146,Deutsch; Alin Bernard,9999,0,9999,0
1668244971200,CSE 293,007,119159,Esmaeilzadeh; Hadi,9999,0,9999,0
1668244971200,CSE 293,008,119166,Freund; Yoav,9999,0,9999,0
1668244971200,CSE 293,009,119170,Griswold; William G.,9999,0,9999,0
1668244971200,CSE 293,010,119183,Gymrek; Melissa Ann,9999,0,9999,0
1668244971200,CSE 293,011,119190,Heninger; Nadia A,9999,0,9999,0
1668244971200,CSE 293,012,119230,Impagliazzo; Russell,9999,0,9999,0
1668244971200,CSE 293,013,119232,Jhala; Ranjit,9999,0,9999,0
1668244971200,CSE 293,014,119233,Kahng; Andrew Byun,9999,0,9999,0
1668244971200,CSE 293,015,119298,Kane; Daniel Mertz,9999,0,9999,0
1668244971200,CSE 293,016,119299,Kriegman; David J,9999,0,9999,0
1668244971200,CSE 293,017,119300,Kumar; Arun Kumar,9999,0,9999,0
1668244971200,CSE 293,018,119301,Lerner; Sorin,9999,0,9999,0
1668244971200,CSE 293,019,119302,Lovett; Shachar,9999,0,9999,0
1668244971200,CSE 293,020,119303,McAuley; Julian John,9999,0,9999,0
1668244971200,CSE 293,021,119304,Micciancio; Daniele,9999,0,9999,0
1668244971200,CSE 293,022,119367,Orailoglu; Alex,9999,0,9999,0
1668244971200,CSE 293,023,119382,Paturi; Ramamohan,9999,0,9999,0
1668244971200,CSE 293,024,119404,Polikarpova; Nadezhda,9999,0,9999,0
1668244971200,CSE 293,025,119406,Politz; Joseph Gibbs,9999,0,9999,0
1668244971200,CSE 293,026,119411,Porter; George M,9999,0,9999,0
1668244971200,CSE 293,027,119414,Porter; Leonard Emerson,9999,0,9999,0
1668244971200,CSE 293,028,119416,Ramamoorthi; Ravi,9999,0,9999,0
1668244971200,CSE 293,029,119417,Sahoo; Debashis,9999,0,9999,0
1668244971200,CSE 293,030,119420,Saul; Lawrence,9999,0,9999,0
1668244971200,CSE 293,031,119421,Savage; Stefan,9999,0,9999,0
1668244971200,CSE 293,032,119425,Schulze; Jurgen P.,9999,0,9999,0
1668244971200,CSE 293,033,119426,Snoeren; Alex C.,9999,0,9999,0
1668244971200,CSE 293,034,119428,Shang; Jingbo,9999,0,9999,0
1668244971200,CSE 293,035,119430,Stefan; Deian,9999,0,9999,0
1668244971200,CSE 293,036,119431,Su; Hao,9999,0,9999,0
1668244971200,CSE 293,037,119433,Swanson; Steven James,9999,0,9999,0
1668244971200,CSE 293,038,119435,Tullsen; Dean Michael,9999,0,9999,0
1668244971200,CSE 293,039,119483,Voelker; Geoffrey M.,9999,0,9999,0
1668244971200,CSE 293,040,119537,Zhao; Jishen,9999,0,9999,0
1668244971200,CSE 293,041,119538,Zhou; Yuan-Yuan,9999,0,9999,0
1668244971200,CSE 293,042,119539,Gao; Sicun,9999,0,9999,0
1668244971200,CSE 293,043,119540,Weibel; Nadir,9999,0,9999,0
1668244971200,CSE 293,044,119541,Gupta; Rajesh K.,9999,0,9999,0
1668244971200,CSE 293,045,126410,Vaccaro; Kristen Marie,9999,0,9999,0
1668244971200,CSE 293,046,126411,Klemke; Richard,9999,0,9999,0
1668244971623,CSE 294,A00,102459,Voelker; Geoffrey M.,0,0,0,0
1668244971623,CSE 294,B00,111322,Orailoglu; Alex,0,0,0,0
1668244972052,DSE 201,A00,096914,Deutsch; Alin Bernard,30,0,30,0
1668244972477,DSE 210,A00,096915,Dasgupta; Sanjoy,30,0,30,0
1668244972902,DSE 260A,A00,096916,Altintas De Callaf; Ilkay,30,0,30,0
1668244973364,ECE 200,001,103586,Antipa; Nicholas A,9999,0,9999,0
1668244973364,ECE 200,002,103587,Atanasov; Nikolay A.,9999,0,9999,0
1668244973364,ECE 200,003,103588,Bharadia; Dinesh,9999,0,9999,0
1668244973364,ECE 200,004,103589,Cheng; Chung Kuan,9999,0,9999,0
1668244973364,ECE 200,005,103590,Cosman; Pamela C.,9999,0,9999,0
1668244973364,ECE 200,006,103591,Dayeh; Shadi Ahmad,9999,0,9999,0
1668244973364,ECE 200,007,103592,Fainman; Yeshaiahu,9999,0,9999,0
1668244973364,ECE 200,008,103593,Ford; Joseph Earl,9999,0,9999,0
1668244973364,ECE 200,009,103594,Franceschetti; Massimo,9999,0,9999,0
1668244973364,ECE 200,010,103595,Fullerton; Eric E,9999,0,9999,0
1668244973364,ECE 200,011,103596,Galton; Ian A,9999,0,9999,0
1668244973364,ECE 200,012,103597,Gilja; Vikash,9999,0,9999,0
1668244973364,ECE 200,013,103598,Hall; Drew A.,9999,0,9999,0
1668244973364,ECE 200,014,103599,Hsueh; Tzu-Chien,9999,0,9999,0
1668244973364,ECE 200,015,103600,Javidi; Tara,9999,0,9999,0
1668244973364,ECE 200,016,103601,Kahng; Andrew Byun,9999,0,9999,0
1668244973364,ECE 200,017,103602,Kim; Young-Han,9999,0,9999,0
1668244973364,ECE 200,018,103603,Koushanfar; Farinaz,9999,0,9999,0
1668244973364,ECE 200,019,103604,Kuzum; Duygu,9999,0,9999,0
1668244973364,ECE 200,020,103605,Le; Hanh-Phuc,9999,0,9999,0
1668244973364,ECE 200,021,103606,Lin; Bill,9999,0,9999,0
1668244973364,ECE 200,022,103607,Liu; Zhaowei,9998,0,9999,1
1668244973364,ECE 200,023,103608,Lo; Yu-Hwa,9999,0,9999,0
1668244973364,ECE 200,024,103609,Lomakin; Vitaliy,9999,0,9999,0
1668244973364,ECE 200,025,103610,Mercier; Patrick Philip,9999,0,9999,0
1668244973364,ECE 200,026,103611,Meyer; Florian,9999,0,9999,0
1668244973364,ECE 200,027,103612,Milstein; Laurence B.,9999,0,9999,0
1668244973364,ECE 200,028,103613,Mir Arabbaygi; Siavash,9999,0,9999,0
1668244973364,ECE 200,029,103614,Mookherjea; Shayan,9999,0,9999,0
1668244973364,ECE 200,030,103615,Morris; Karcher William,9999,0,9999,0
1668244973364,ECE 200,031,103616,Ng; Tse Nga,9999,0,9999,0
1668244973364,ECE 200,032,103617,Nguyen; Truong Quang,9999,0,9999,0
1668244973364,ECE 200,033,103618,Nomura; Kenji,9999,0,9999,0
1668244973364,ECE 200,034,103619,Orlitsky; Alon,9999,0,9999,0
1668244973364,ECE 200,035,103620,Pal; Piya,9999,0,9999,0
1668244973364,ECE 200,036,103621,Papen; George C.,9999,0,9999,0
1668244973364,ECE 200,037,103622,Radic; Stojan,9999,0,9999,0
1668244973364,ECE 200,038,103623,Rao; Bhaskar D.,9999,0,9999,0
1668244973364,ECE 200,039,103624,Rao; Ramesh R,9999,0,9999,0
1668244973364,ECE 200,040,103625,Rebeiz; Gabriel,9999,0,9999,0
1668244973364,ECE 200,041,103626,Sanford; John R,9999,0,9999,0
1668244973364,ECE 200,042,103627,Siegel; Paul H.,9999,0,9999,0
1668244973364,ECE 200,043,103628,Sievenpiper; Daniel F.,9999,0,9999,0
1668244973364,ECE 200,044,103629,Sworder; David D.,9999,0,9999,0
1668244973364,ECE 200,045,103630,Taur; Yuan,9999,0,9999,0
1668244973364,ECE 200,046,103631,Touri; Behrouz,9999,0,9999,0
1668244973364,ECE 200,047,103632,Trivedi; Mohan M.,9999,0,9999,0
1668244973364,ECE 200,048,103633,Vasconcelos; Nuno,9999,0,9999,0
1668244973364,ECE 200,049,103634,Wang; Xiaolong,9999,0,9999,0
1668244973364,ECE 200,050,103635,Xie; Pengtao,9999,0,9999,0
1668244973364,ECE 200,051,103636,Yip; Michael,9999,0,9999,0
1668244973364,ECE 200,052,103637,Zeger; Kenneth A.,999,0,999,0
1668244973364,ECE 200,053,103638,Zhang; Xinyu,9999,0,9999,0
1668244973364,ECE 200,054,103639,Turakhia; Yatish Girish,9999,0,9999,0
1668244973364,ECE 200,055,103640,Kang; Mingu,9999,0,9999,0
1668244973364,ECE 200,056,103641,Shi; Yuanyuan,9999,0,9999,0
1668244973364,ECE 200,057,103642,Wang; Edward Jay,9999,0,9999,0
1668244973364,ECE 200,058,103643,Zheng; Yang,9999,0,9999,0
1668244973789,ECE 202,A00,103644,Kuzum; Duygu,0,0,0,0
1668244974214,ECE 212BN,A00,103646,Ng; Tse Nga,0,0,0,0
1668244974638,ECE 221,A00,111493,Staff,0,0,0,0
1668244975067,ECE 222B,A00,103647,Lomakin; Vitaliy,0,0,0,0
1668244975492,ECE 230B,A00,103648,Taur; Yuan,0,0,0,0
1668244975917,ECE 238B,A00,103649,Garay; Javier,0,0,0,0
1668244976342,ECE 240B,A00,112900,Fainman; Yeshaiahu,0,0,0,0
1668244976773,ECE 247A,A00,103650,Jokerst; Jesse Vincent,0,0,0,0
1668244977199,ECE 247B,A00,103651,Wang; Joseph,0,0,0,0
1668244977628,ECE 250,A00,103652,Siegel; Paul H.,0,0,0,0
1668244978065,ECE 251A,A00,103654,Rao; Bhaskar D.,0,0,0,0
1668244978494,ECE 257B,A00,103655,Bharadia; Dinesh,0,0,0,0
1668244978921,ECE 258A,A00,103656,Milstein; Laurence B.,0,0,0,0
1668244979344,ECE 260B,A00,103658,Kang; Mingu,0,0,0,0
1668244979774,ECE 264A,A00,103659,Galton; Ian A,0,0,0,0
1668244980208,ECE 265A,A00,103661,Gudem; Prasad S.S.,0,0,0,0
1668244980632,ECE 265D,A00,103662,Gudem; Prasad S.S.,0,0,0,0
1668244981055,ECE 268,A00,103663,Koushanfar; Farinaz,0,0,0,0
1668244981479,ECE 269,A01,103665,Pal; Piya,0,0,0,0
1668244981905,ECE 271B,A00,103666,Vasconcelos; Manuela,0,0,0,0
1668244982330,ECE 276A,A00,103667,Atanasov; Nikolay A.,0,0,0,0
1668244982758,ECE 277,A00,103668,An; Cheolhong,0,0,0,0
1668244983203,ECE 279,A00,117947,Hall; Drew A.,0,0,0,0
1668244984066,ECE 283,A00,103670,Hsueh; Tzu-Chien,0,0,0,0
1668244984498,ECE 284,A00,103671,Turakhia; Yatish Girish,0,0,0,0
1668244984928,ECE 285,A00,103672,Zheng; Yang,0,0,0,0
1668244984928,ECE 285,B00,103673,Sworder; David D.,0,0,0,0
1668244985352,ECE 287,A00,103676,Javidi; Tara,0,0,0,0
1668244985781,MATH 200B,A00,098023,Salehi Golsefidy; Alireza,12,0,15,3
1668244986224,MATH 202B,A00,098024,Rhoades; Brendon Patrick,9,0,15,6
1668244986664,MATH 203B,A00,098025,Oprea; Dragos N.,10,0,15,5
1668244987102,MATH 204B,A00,098026,Sorensen; Claus M,13,0,15,2
1668244987530,MATH 208,A00,098027,Izadi; Elham,7,0,10,3
1668244987957,MATH 209,A00,098028,Pollack; Aaron,10,0,10,0
1668244988394,MATH 211A,A00,112919,Rogalski; Daniel,9,0,10,1
1668244988819,MATH 211B,A00,112920,Seward; Brandon M.,9,0,10,1
1668244989243,MATH 218,A00,098029,Li; Bo,10,0,10,0
1668244989669,MATH 220B,A00,098030,Novak; Jonathan I,11,0,15,4
1668244990098,MATH 221A,A00,098031,Ebenfelt; Peter F,13,0,15,2
1668244990523,MATH 231B,A00,098032,Zlatos; Andrej,12,0,15,3
1668244990949,MATH 240B,A00,098033,Ni; Lei,9,0,15,6
1668244991376,MATH 243,A00,098034,Jekel; David Andrew,10,0,10,0
1668244991801,MATH 245A,A00,098035,Nie; Jiawang,0,0,15,16
1668244992233,MATH 248,A00,098036,Bejenaru; Ioan,10,0,10,0
1668244992657,MATH 250B,A00,098037,Spolaor; Luca,14,0,15,1
1668244993085,MATH 258,A00,098038,Ni; Lei,10,0,10,0
1668244993513,MATH 264B,A00,098041,Rhoades; Brendon Patrick,9,0,15,6
1668244993938,MATH 268,A00,098042,Buss; Samuel R,10,0,10,0
1668244994363,MATH 269,A00,098043,Rhoades; Brendon Patrick,10,0,10,0
1668244994788,MATH 270B,A00,098044,Li; Bo,10,0,15,5
1668244995214,MATH 272B,A00,098045,Holst; Michael J,13,0,15,2
1668244995641,MATH 273A,A00,098046,Tian; Xiaochuan,10,0,15,5
1668244996079,MATH 275,A01,098048,Tian; Xiaochuan,6,0,10,4
1668244996511,MATH 278A,A00,098049,Holst; Michael J,8,0,10,2
1668244996949,MATH 278B,A00,098050,Cloninger; Alexander,10,0,10,0
1668244997380,MATH 278C,A00,098051,Nie; Jiawang,7,0,10,3
1668244997824,MATH 280B,A00,098052,Zheng; Tianyi,9,0,15,6
1668244998253,MATH 281B,A00,098053,Bradic; Jelena,1,0,15,14
1668244998697,MATH 282B,A00,098054,Arias-Castro; Ery,0,0,15,15
1668244999121,MATH 285,A00,098055,Fitzsimmons; Patrick J,0,0,15,17
1668244999546,MATH 287B,A00,098056,Arias-Castro; Ery,2,0,15,13
1668244999977,MATH 288,A00,098057,Agarwal; Pooja,9,0,10,1
1668244999977,MATH 288,B00,098058,Zhang; Danna,8,0,10,2
1668244999977,MATH 288,C00,098059,Williams; Ruth J,10,0,10,0
1668245000406,MATH 290B,A00,098060,Roberts; Justin Deritter,13,0,15,2
1668245000836,MATH 292,A00,098061,Belmont; Eva Kinoshita,10,0,10,0
1668245001264,MATH 295,A00,098062,Suk; Andrew Hoon,48,0,50,2
1668245001763,MATH 296,A00,098063,Novak; Jonathan I,20,0,20,0
1668245002192,MATH 297,001,098064,Gamst; Anthony Collins,9997,0,9999,2
1668245504593,COGS 205,A00,101395,Chiba; Andrea,19,0,20,1
1668245505019,COGS 210B,001,101404,Greene; Deanna Jacquelyn,9998,0,9999,1
1668245505019,COGS 210B,002,101417,Xia; Haijun,9999,0,9999,0
1668245505019,COGS 210B,003,101422,Nitz; Douglas A.,9999,0,9999,0
1668245505019,COGS 210B,004,101423,Hollan; James D.,9998,0,9999,1
1668245505019,COGS 210B,005,101424,Deak; Gedeon O.,9998,0,9999,1
1668245505019,COGS 210B,006,101425,Rossano; Federico,9999,0,9999,0
1668245505459,COGS 211B,A00,101427,Coulson; Seana M,9996,0,9999,3
1668245505887,COGS 220,A00,101428,Hollan; James D.,0,0,25,25
1668245506311,COGS 229,A00,101429,Dow; Steven P,18,0,25,7
1668245506736,COGS 230,A00,101430,Klemmer; Scott R,12,0,17,5
1668245507158,COGS 234,A00,101431,Xia; Haijun,2,0,25,23
1668245507584,COGS 260,A00,101432,Kiyonaga; Anastasia,21,0,25,4
1668245507584,COGS 260,B00,101433,Kirsh; David Joel,15,0,25,10
1668245508008,CSE 202,A00,102371,Impagliazzo; Russell,0,0,0,0
1668245508434,CSE 203B,A01,102373,Cheng; Chung Kuan,0,0,0,0
1668245508860,CSE 208,A00,102374,Micciancio; Daniele,0,0,0,0
1668245509285,CSE 209A,A00,112895,Impagliazzo; Russell,0,0,15,15
1668245509708,CSE 209B,A00,108005,Bellare; Mihir,0,0,0,0
1668245510136,CSE 210,A00,113163,Coblenz; Michael J,0,0,0,0
1668245510563,CSE 219,A00,106111,Dow; Steven P,0,0,20,20
1668245510996,CSE 221,A00,102376,Voelker; Geoffrey M.,0,0,0,0
1668245511421,CSE 224,A01,102378,Porter; George M,0,0,0,0
1668245511845,CSE 229A,A00,102379,Savage; Stefan,0,0,0,0
1668245512278,CSE 229C,A00,102380,Munyaka; Imani N. S.,0,0,0,0
1668245512704,CSE 232B,A00,102382,Deutsch; Alin Bernard,0,0,0,0
1668245513132,CSE 234,A01,112904,Kumar; Arun Kumar,0,0,0,0
1668245513555,CSE 237A,A00,102383,Rosing; Tajana Simunic,0,0,0,0
1668245513979,CSE 239A,A00,102384,Deutsch; Alin Bernard,0,0,0,0
1668245514406,CSE 239B,A00,102385,Polikarpova; Nadezhda,0,0,0,0
1668245514839,CSE 240A,A00,102386,Pannuto; Patrick William,0,0,0,0
1668245515272,CSE 240B,A00,102387,Zhao; Jishen,0,0,0,0
1668245515697,CSE 241A,A00,106406,Kang; Mingu,0,0,0,0
1668245516121,CSE 249B,A00,102388,Kahng; Andrew Byun,0,0,8,8
1668245516548,CSE 251B,A01,102392,Cottrell; Garrison W,0,0,0,0
1668245516548,CSE 251B,A02,102393,Cottrell; Garrison W,0,0,0,0
1668245516988,CSE 252B,A00,102394,Ochoa; Benjamin Lawrence,0,0,0,0
1668245517424,CSE 257,A01,102396,Gao; Sicun,0,0,0,0
1668245517849,CSE 272,A00,102397,Li; Tzumao,0,0,0,0
1668245518283,CSE 274,A00,111323,Chern; Albert Ren-Haur,0,0,0,0
1668245518706,CSE 282,A00,102398,Pevzner; Pavel Arkadjevich,0,0,0,0
1668245519131,CSE 284,A00,114175,Gymrek; Melissa Ann,0,0,0,0
1668245519557,CSE 290,A00,102399,Chandraker; Manmohan Krishna,0,0,0,0
1668245519557,CSE 290,B00,102400,Vaccaro; Kristen Marie,0,0,25,25
1668245519557,CSE 290,C00,102414,Pannuto; Patrick William,0,0,25,25
1668245519557,CSE 290,D00,102427,Pevzner; Pavel Arkadjevich,0,0,0,0
1668245519557,CSE 290,E00,102429,Zhao; Jishen,0,0,0,0
1668245519557,CSE 290,F00,102436,Tullsen; Dean Michael,0,0,0,0
1668245519557,CSE 290,G00,102440,Christensen; Henrik I,0,0,20,20
1668245519988,CSE 291,A00,102443,Su; Hao,0,0,0,0
1668245519988,CSE 291,B00,102448,Polikarpova; Nadezhda,0,0,0,0
1668245519988,CSE 291,C00,102453,Vaccaro; Kristen Marie,0,0,0,0
1668245519988,CSE 291,D00,111343,Savage; Stefan,0,0,0,0
1668245519988,CSE 291,E00,116474,Claffy; Kimberly Claire,0,0,0,0
1668245519988,CSE 291,F00,116479,Pasquale; Joseph,0,0,0,0
1668245520448,CSE 293,001,119111,Bafna; Vineet,9999,0,9999,0
1668245520448,CSE 293,002,119118,Bellare; Mihir,9999,0,9999,0
1668245520448,CSE 293,003,119122,Berg-Kirkpatrick; Taylor D,9999,0,9999,0
1668245520448,CSE 293,004,119135,Christensen; Henrik I,9999,0,9999,0
1668245520448,CSE 293,005,119142,Cottrell; Garrison W,9999,0,9999,0
1668245520448,CSE 293,006,119146,Deutsch; Alin Bernard,9999,0,9999,0
1668245520448,CSE 293,007,119159,Esmaeilzadeh; Hadi,9999,0,9999,0
1668245520448,CSE 293,008,119166,Freund; Yoav,9999,0,9999,0
1668245520448,CSE 293,009,119170,Griswold; William G.,9999,0,9999,0
1668245520448,CSE 293,010,119183,Gymrek; Melissa Ann,9999,0,9999,0
1668245520448,CSE 293,011,119190,Heninger; Nadia A,9999,0,9999,0
1668245520448,CSE 293,012,119230,Impagliazzo; Russell,9999,0,9999,0
1668245520448,CSE 293,013,119232,Jhala; Ranjit,9999,0,9999,0
1668245520448,CSE 293,014,119233,Kahng; Andrew Byun,9999,0,9999,0
1668245520448,CSE 293,015,119298,Kane; Daniel Mertz,9999,0,9999,0
1668245520448,CSE 293,016,119299,Kriegman; David J,9999,0,9999,0
1668245520448,CSE 293,017,119300,Kumar; Arun Kumar,9999,0,9999,0
1668245520448,CSE 293,018,119301,Lerner; Sorin,9999,0,9999,0
1668245520448,CSE 293,019,119302,Lovett; Shachar,9999,0,9999,0
1668245520448,CSE 293,020,119303,McAuley; Julian John,9999,0,9999,0
1668245520448,CSE 293,021,119304,Micciancio; Daniele,9999,0,9999,0
1668245520448,CSE 293,022,119367,Orailoglu; Alex,9999,0,9999,0
1668245520448,CSE 293,023,119382,Paturi; Ramamohan,9999,0,9999,0
1668245520448,CSE 293,024,119404,Polikarpova; Nadezhda,9999,0,9999,0
1668245520448,CSE 293,025,119406,Politz; Joseph Gibbs,9999,0,9999,0
1668245520448,CSE 293,026,119411,Porter; George M,9999,0,9999,0
1668245520448,CSE 293,027,119414,Porter; Leonard Emerson,9999,0,9999,0
1668245520448,CSE 293,028,119416,Ramamoorthi; Ravi,9999,0,9999,0
1668245520448,CSE 293,029,119417,Sahoo; Debashis,9999,0,9999,0
1668245520448,CSE 293,030,119420,Saul; Lawrence,9999,0,9999,0
1668245520448,CSE 293,031,119421,Savage; Stefan,9999,0,9999,0
1668245520448,CSE 293,032,119425,Schulze; Jurgen P.,9999,0,9999,0
1668245520448,CSE 293,033,119426,Snoeren; Alex C.,9999,0,9999,0
1668245520448,CSE 293,034,119428,Shang; Jingbo,9999,0,9999,0
1668245520448,CSE 293,035,119430,Stefan; Deian,9999,0,9999,0
1668245520448,CSE 293,036,119431,Su; Hao,9999,0,9999,0
1668245520448,CSE 293,037,119433,Swanson; Steven James,9999,0,9999,0
1668245520448,CSE 293,038,119435,Tullsen; Dean Michael,9999,0,9999,0
1668245520448,CSE 293,039,119483,Voelker; Geoffrey M.,9999,0,9999,0
1668245520448,CSE 293,040,119537,Zhao; Jishen,9999,0,9999,0
1668245520448,CSE 293,041,119538,Zhou; Yuan-Yuan,9999,0,9999,0
1668245520448,CSE 293,042,119539,Gao; Sicun,9999,0,9999,0
1668245520448,CSE 293,043,119540,Weibel; Nadir,9999,0,9999,0
1668245520448,CSE 293,044,119541,Gupta; Rajesh K.,9999,0,9999,0
1668245520448,CSE 293,045,126410,Vaccaro; Kristen Marie,9999,0,9999,0
1668245520448,CSE 293,046,126411,Klemke; Richard,9999,0,9999,0
1668245520873,CSE 294,A00,102459,Voelker; Geoffrey M.,0,0,0,0
1668245520873,CSE 294,B00,111322,Orailoglu; Alex,0,0,0,0
1668245521302,DSE 201,A00,096914,Deutsch; Alin Bernard,30,0,30,0
1668245521726,DSE 210,A00,096915,Dasgupta; Sanjoy,30,0,30,0
1668245522154,DSE 260A,A00,096916,Altintas De Callaf; Ilkay,30,0,30,0
1668245522592,ECE 200,001,103586,Antipa; Nicholas A,9999,0,9999,0
1668245522592,ECE 200,002,103587,Atanasov; Nikolay A.,9999,0,9999,0
1668245522592,ECE 200,003,103588,Bharadia; Dinesh,9999,0,9999,0
1668245522592,ECE 200,004,103589,Cheng; Chung Kuan,9999,0,9999,0
1668245522592,ECE 200,005,103590,Cosman; Pamela C.,9999,0,9999,0
1668245522592,ECE 200,006,103591,Dayeh; Shadi Ahmad,9999,0,9999,0
1668245522592,ECE 200,007,103592,Fainman; Yeshaiahu,9999,0,9999,0
1668245522592,ECE 200,008,103593,Ford; Joseph Earl,9999,0,9999,0
1668245522592,ECE 200,009,103594,Franceschetti; Massimo,9999,0,9999,0
1668245522592,ECE 200,010,103595,Fullerton; Eric E,9999,0,9999,0
1668245522592,ECE 200,011,103596,Galton; Ian A,9999,0,9999,0
1668245522592,ECE 200,012,103597,Gilja; Vikash,9999,0,9999,0
1668245522592,ECE 200,013,103598,Hall; Drew A.,9999,0,9999,0
1668245522592,ECE 200,014,103599,Hsueh; Tzu-Chien,9999,0,9999,0
1668245522592,ECE 200,015,103600,Javidi; Tara,9999,0,9999,0
1668245522592,ECE 200,016,103601,Kahng; Andrew Byun,9999,0,9999,0
1668245522592,ECE 200,017,103602,Kim; Young-Han,9999,0,9999,0
1668245522592,ECE 200,018,103603,Koushanfar; Farinaz,9999,0,9999,0
1668245522592,ECE 200,019,103604,Kuzum; Duygu,9999,0,9999,0
1668245522592,ECE 200,020,103605,Le; Hanh-Phuc,9999,0,9999,0
1668245522592,ECE 200,021,103606,Lin; Bill,9999,0,9999,0
1668245522592,ECE 200,022,103607,Liu; Zhaowei,9998,0,9999,1
1668245522592,ECE 200,023,103608,Lo; Yu-Hwa,9999,0,9999,0
1668245522592,ECE 200,024,103609,Lomakin; Vitaliy,9999,0,9999,0
1668245522592,ECE 200,025,103610,Mercier; Patrick Philip,9999,0,9999,0
1668245522592,ECE 200,026,103611,Meyer; Florian,9999,0,9999,0
1668245522592,ECE 200,027,103612,Milstein; Laurence B.,9999,0,9999,0
1668245522592,ECE 200,028,103613,Mir Arabbaygi; Siavash,9999,0,9999,0
1668245522592,ECE 200,029,103614,Mookherjea; Shayan,9999,0,9999,0
1668245522592,ECE 200,030,103615,Morris; Karcher William,9999,0,9999,0
1668245522592,ECE 200,031,103616,Ng; Tse Nga,9999,0,9999,0
1668245522592,ECE 200,032,103617,Nguyen; Truong Quang,9999,0,9999,0
1668245522592,ECE 200,033,103618,Nomura; Kenji,9999,0,9999,0
1668245522592,ECE 200,034,103619,Orlitsky; Alon,9999,0,9999,0
1668245522592,ECE 200,035,103620,Pal; Piya,9999,0,9999,0
1668245522592,ECE 200,036,103621,Papen; George C.,9999,0,9999,0
1668245522592,ECE 200,037,103622,Radic; Stojan,9999,0,9999,0
1668245522592,ECE 200,038,103623,Rao; Bhaskar D.,9999,0,9999,0
1668245522592,ECE 200,039,103624,Rao; Ramesh R,9999,0,9999,0
1668245522592,ECE 200,040,103625,Rebeiz; Gabriel,9999,0,9999,0
1668245522592,ECE 200,041,103626,Sanford; John R,9999,0,9999,0
1668245522592,ECE 200,042,103627,Siegel; Paul H.,9999,0,9999,0
1668245522592,ECE 200,043,103628,Sievenpiper; Daniel F.,9999,0,9999,0
1668245522592,ECE 200,044,103629,Sworder; David D.,9999,0,9999,0
1668245522592,ECE 200,045,103630,Taur; Yuan,9999,0,9999,0
1668245522592,ECE 200,046,103631,Touri; Behrouz,9999,0,9999,0
1668245522592,ECE 200,047,103632,Trivedi; Mohan M.,9999,0,9999,0
1668245522592,ECE 200,048,103633,Vasconcelos; Nuno,9999,0,9999,0
1668245522592,ECE 200,049,103634,Wang; Xiaolong,9999,0,9999,0
1668245522592,ECE 200,050,103635,Xie; Pengtao,9999,0,9999,0
1668245522592,ECE 200,051,103636,Yip; Michael,9999,0,9999,0
1668245522592,ECE 200,052,103637,Zeger; Kenneth A.,999,0,999,0
1668245522592,ECE 200,053,103638,Zhang; Xinyu,9999,0,9999,0
1668245522592,ECE 200,054,103639,Turakhia; Yatish Girish,9999,0,9999,0
1668245522592,ECE 200,055,103640,Kang; Mingu,9999,0,9999,0
1668245522592,ECE 200,056,103641,Shi; Yuanyuan,9999,0,9999,0
1668245522592,ECE 200,057,103642,Wang; Edward Jay,9999,0,9999,0
1668245522592,ECE 200,058,103643,Zheng; Yang,9999,0,9999,0
1668245523019,ECE 202,A00,103644,Kuzum; Duygu,0,0,0,0
1668245523443,ECE 212BN,A00,103646,Ng; Tse Nga,0,0,0,0
1668245523867,ECE 221,A00,111493,Staff,0,0,0,0
1668245524392,ECE 222B,A00,103647,Lomakin; Vitaliy,0,0,0,0
1668245524816,ECE 230B,A00,103648,Taur; Yuan,0,0,0,0
1668245525240,ECE 238B,A00,103649,Garay; Javier,0,0,0,0
1668245525664,ECE 240B,A00,112900,Fainman; Yeshaiahu,0,0,0,0
1668245526089,ECE 247A,A00,103650,Jokerst; Jesse Vincent,0,0,0,0
1668245526517,ECE 247B,A00,103651,Wang; Joseph,0,0,0,0
1668245526945,ECE 250,A00,103652,Siegel; Paul H.,0,0,0,0
1668245527375,ECE 251A,A00,103654,Rao; Bhaskar D.,0,0,0,0
1668245527799,ECE 257B,A00,103655,Bharadia; Dinesh,0,0,0,0
1668245528226,ECE 258A,A00,103656,Milstein; Laurence B.,0,0,0,0
1668245528655,ECE 260B,A00,103658,Kang; Mingu,0,0,0,0
1668245529080,ECE 264A,A00,103659,Galton; Ian A,0,0,0,0
1668245529508,ECE 265A,A00,103661,Gudem; Prasad S.S.,0,0,0,0
1668245529938,ECE 265D,A00,103662,Gudem; Prasad S.S.,0,0,0,0
1668245530367,ECE 268,A00,103663,Koushanfar; Farinaz,0,0,0,0
1668245530795,ECE 269,A01,103665,Pal; Piya,0,0,0,0
1668245531227,ECE 271B,A00,103666,Vasconcelos; Manuela,0,0,0,0
1668245531657,ECE 276A,A00,103667,Atanasov; Nikolay A.,0,0,0,0
1668245532086,ECE 277,A00,103668,An; Cheolhong,0,0,0,0
1668245532514,ECE 279,A00,117947,Hall; Drew A.,0,0,0,0
1668245533386,ECE 283,A00,103670,Hsueh; Tzu-Chien,0,0,0,0
1668245533812,ECE 284,A00,103671,Turakhia; Yatish Girish,0,0,0,0
1668245534234,ECE 285,A00,103672,Zheng; Yang,0,0,0,0
1668245534234,ECE 285,B00,103673,Sworder; David D.,0,0,0,0
1668245534664,ECE 287,A00,103676,Javidi; Tara,0,0,0,0
1668245535098,MATH 200B,A00,098023,Salehi Golsefidy; Alireza,12,0,15,3
1668245535524,MATH 202B,A00,098024,Rhoades; Brendon Patrick,9,0,15,6
1668245535960,MATH 203B,A00,098025,Oprea; Dragos N.,10,0,15,5
1668245536389,MATH 204B,A00,098026,Sorensen; Claus M,13,0,15,2
1668245536817,MATH 208,A00,098027,Izadi; Elham,7,0,10,3
1668245537240,MATH 209,A00,098028,Pollack; Aaron,10,0,10,0
1668245537675,MATH 211A,A00,112919,Rogalski; Daniel,9,0,10,1
1668245538103,MATH 211B,A00,112920,Seward; Brandon M.,9,0,10,1
1668245538526,MATH 218,A00,098029,Li; Bo,10,0,10,0
1668245538954,MATH 220B,A00,098030,Novak; Jonathan I,11,0,15,4
1668245539378,MATH 221A,A00,098031,Ebenfelt; Peter F,13,0,15,2
1668245539813,MATH 231B,A00,098032,Zlatos; Andrej,12,0,15,3
1668245540252,MATH 240B,A00,098033,Ni; Lei,9,0,15,6
1668245540693,MATH 243,A00,098034,Jekel; David Andrew,10,0,10,0
1668245541118,MATH 245A,A00,098035,Nie; Jiawang,0,0,15,16
1668245541541,MATH 248,A00,098036,Bejenaru; Ioan,10,0,10,0
1668245541966,MATH 250B,A00,098037,Spolaor; Luca,14,0,15,1
1668245542391,MATH 258,A00,098038,Ni; Lei,10,0,10,0
1668245542817,MATH 264B,A00,098041,Rhoades; Brendon Patrick,9,0,15,6
1668245543242,MATH 268,A00,098042,Buss; Samuel R,10,0,10,0
1668245543665,MATH 269,A00,098043,Rhoades; Brendon Patrick,10,0,10,0
1668245544089,MATH 270B,A00,098044,Li; Bo,10,0,15,5
1668245544518,MATH 272B,A00,098045,Holst; Michael J,13,0,15,2
1668245544945,MATH 273A,A00,098046,Tian; Xiaochuan,10,0,15,5
1668245545368,MATH 275,A01,098048,Tian; Xiaochuan,6,0,10,4
1668245545793,MATH 278A,A00,098049,Holst; Michael J,8,0,10,2
1668245546219,MATH 278B,A00,098050,Cloninger; Alexander,10,0,10,0
1668245546655,MATH 278C,A00,098051,Nie; Jiawang,7,0,10,3
1668245547085,MATH 280B,A00,098052,Zheng; Tianyi,9,0,15,6
1668245547508,MATH 281B,A00,098053,Bradic; Jelena,1,0,15,14
1668245547934,MATH 282B,A00,098054,Arias-Castro; Ery,0,0,15,15
1668245548358,MATH 285,A00,098055,Fitzsimmons; Patrick J,0,0,15,17
1668245548806,MATH 287B,A00,098056,Arias-Castro; Ery,2,0,15,13
1668245549245,MATH 288,A00,098057,Agarwal; Pooja,9,0,10,1
1668245549245,MATH 288,B00,098058,Zhang; Danna,8,0,10,2
1668245549245,MATH 288,C00,098059,Williams; Ruth J,10,0,10,0
1668245549680,MATH 290B,A00,098060,Roberts; Justin Deritter,13,0,15,2
1668245550117,MATH 292,A00,098061,Belmont; Eva Kinoshita,10,0,10,0
1668245550549,MATH 295,A00,098062,Suk; Andrew Hoon,48,0,50,2
1668245550974,MATH 296,A00,098063,Novak; Jonathan I,20,0,20,0
1668245551401,MATH 297,001,098064,Gamst; Anthony Collins,9997,0,9999,2
1668246051898,COGS 205,A00,101395,Chiba; Andrea,19,0,20,1
1668246052320,COGS 210B,001,101404,Greene; Deanna Jacquelyn,9998,0,9999,1
1668246052320,COGS 210B,002,101417,Xia; Haijun,9999,0,9999,0
1668246052320,COGS 210B,003,101422,Nitz; Douglas A.,9999,0,9999,0
1668246052320,COGS 210B,004,101423,Hollan; James D.,9998,0,9999,1
1668246052320,COGS 210B,005,101424,Deak; Gedeon O.,9998,0,9999,1
1668246052320,COGS 210B,006,101425,Rossano; Federico,9999,0,9999,0
1668246052743,COGS 211B,A00,101427,Coulson; Seana M,9996,0,9999,3
1668246053169,COGS 220,A00,101428,Hollan; James D.,0,0,25,25
1668246053592,COGS 229,A00,101429,Dow; Steven P,18,0,25,7
1668246054034,COGS 230,A00,101430,Klemmer; Scott R,12,0,17,5
1668246054456,COGS 234,A00,101431,Xia; Haijun,2,0,25,23
1668246054895,COGS 260,A00,101432,Kiyonaga; Anastasia,21,0,25,4
1668246054895,COGS 260,B00,101433,Kirsh; David Joel,15,0,25,10
1668246055321,CSE 202,A00,102371,Impagliazzo; Russell,0,0,0,0
1668246055746,CSE 203B,A01,102373,Cheng; Chung Kuan,0,0,0,0
1668246056181,CSE 208,A00,102374,Micciancio; Daniele,0,0,0,0
1668246056605,CSE 209A,A00,112895,Impagliazzo; Russell,0,0,15,15
1668246057030,CSE 209B,A00,108005,Bellare; Mihir,0,0,0,0
1668246057461,CSE 210,A00,113163,Coblenz; Michael J,0,0,0,0
1668246057893,CSE 219,A00,106111,Dow; Steven P,0,0,20,20
1668246058319,CSE 221,A00,102376,Voelker; Geoffrey M.,0,0,0,0
1668246058745,CSE 224,A01,102378,Porter; George M,0,0,0,0
1668246059169,CSE 229A,A00,102379,Savage; Stefan,0,0,0,0
1668246059595,CSE 229C,A00,102380,Munyaka; Imani N. S.,0,0,0,0
1668246060023,CSE 232B,A00,102382,Deutsch; Alin Bernard,0,0,0,0
1668246060457,CSE 234,A01,112904,Kumar; Arun Kumar,0,0,0,0
1668246060880,CSE 237A,A00,102383,Rosing; Tajana Simunic,0,0,0,0
1668246061305,CSE 239A,A00,102384,Deutsch; Alin Bernard,0,0,0,0
1668246061730,CSE 239B,A00,102385,Polikarpova; Nadezhda,0,0,0,0
1668246062156,CSE 240A,A00,102386,Pannuto; Patrick William,0,0,0,0
1668246062583,CSE 240B,A00,102387,Zhao; Jishen,0,0,0,0
1668246063009,CSE 241A,A00,106406,Kang; Mingu,0,0,0,0
1668246063435,CSE 249B,A00,102388,Kahng; Andrew Byun,0,0,8,8
1668246063861,CSE 251B,A01,102392,Cottrell; Garrison W,0,0,0,0
1668246063861,CSE 251B,A02,102393,Cottrell; Garrison W,0,0,0,0
1668246064287,CSE 252B,A00,102394,Ochoa; Benjamin Lawrence,0,0,0,0
1668246064717,CSE 257,A01,102396,Gao; Sicun,0,0,0,0
1668246065141,CSE 272,A00,102397,Li; Tzumao,0,0,0,0
1668246065565,CSE 274,A00,111323,Chern; Albert Ren-Haur,0,0,0,0
1668246065994,CSE 282,A00,102398,Pevzner; Pavel Arkadjevich,0,0,0,0
1668246066420,CSE 284,A00,114175,Gymrek; Melissa Ann,0,0,0,0
1668246066845,CSE 290,A00,102399,Chandraker; Manmohan Krishna,0,0,0,0
1668246066845,CSE 290,B00,102400,Vaccaro; Kristen Marie,0,0,25,25
1668246066845,CSE 290,C00,102414,Pannuto; Patrick William,0,0,25,25
1668246066845,CSE 290,D00,102427,Pevzner; Pavel Arkadjevich,0,0,0,0
1668246066845,CSE 290,E00,102429,Zhao; Jishen,0,0,0,0
1668246066845,CSE 290,F00,102436,Tullsen; Dean Michael,0,0,0,0
1668246066845,CSE 290,G00,102440,Christensen; Henrik I,0,0,20,20
1668246067270,CSE 291,A00,102443,Su; Hao,0,0,0,0
1668246067270,CSE 291,B00,102448,Polikarpova; Nadezhda,0,0,0,0
1668246067270,CSE 291,C00,102453,Vaccaro; Kristen Marie,0,0,0,0
1668246067270,CSE 291,D00,111343,Savage; Stefan,0,0,0,0
1668246067270,CSE 291,E00,116474,Claffy; Kimberly Claire,0,0,0,0
1668246067270,CSE 291,F00,116479,Pasquale; Joseph,0,0,0,0
1668246067699,CSE 293,001,119111,Bafna; Vineet,9999,0,9999,0
1668246067699,CSE 293,002,119118,Bellare; Mihir,9999,0,9999,0
1668246067699,CSE 293,003,119122,Berg-Kirkpatrick; Taylor D,9999,0,9999,0
1668246067699,CSE 293,004,119135,Christensen; Henrik I,9999,0,9999,0
1668246067699,CSE 293,005,119142,Cottrell; Garrison W,9999,0,9999,0
1668246067699,CSE 293,006,119146,Deutsch; Alin Bernard,9999,0,9999,0
1668246067699,CSE 293,007,119159,Esmaeilzadeh; Hadi,9999,0,9999,0
1668246067699,CSE 293,008,119166,Freund; Yoav,9999,0,9999,0
1668246067699,CSE 293,009,119170,Griswold; William G.,9999,0,9999,0
1668246067699,CSE 293,010,119183,Gymrek; Melissa Ann,9999,0,9999,0
1668246067699,CSE 293,011,119190,Heninger; Nadia A,9999,0,9999,0
1668246067699,CSE 293,012,119230,Impagliazzo; Russell,9999,0,9999,0
1668246067699,CSE 293,013,119232,Jhala; Ranjit,9999,0,9999,0
1668246067699,CSE 293,014,119233,Kahng; Andrew Byun,9999,0,9999,0
1668246067699,CSE 293,015,119298,Kane; Daniel Mertz,9999,0,9999,0
1668246067699,CSE 293,016,119299,Kriegman; David J,9999,0,9999,0
1668246067699,CSE 293,017,119300,Kumar; Arun Kumar,9999,0,9999,0
1668246067699,CSE 293,018,119301,Lerner; Sorin,9999,0,9999,0
1668246067699,CSE 293,019,119302,Lovett; Shachar,9999,0,9999,0
1668246067699,CSE 293,020,119303,McAuley; Julian John,9999,0,9999,0
1668246067699,CSE 293,021,119304,Micciancio; Daniele,9999,0,9999,0
1668246067699,CSE 293,022,119367,Orailoglu; Alex,9999,0,9999,0
1668246067699,CSE 293,023,119382,Paturi; Ramamohan,9999,0,9999,0
1668246067699,CSE 293,024,119404,Polikarpova; Nadezhda,9999,0,9999,0
1668246067699,CSE 293,025,119406,Politz; Joseph Gibbs,9999,0,9999,0
1668246067699,CSE 293,026,119411,Porter; George M,9999,0,9999,0
1668246067699,CSE 293,027,119414,Porter; Leonard Emerson,9999,0,9999,0
1668246067699,CSE 293,028,119416,Ramamoorthi; Ravi,9999,0,9999,0
1668246067699,CSE 293,029,119417,Sahoo; Debashis,9999,0,9999,0
1668246067699,CSE 293,030,119420,Saul; Lawrence,9999,0,9999,0
1668246067699,CSE 293,031,119421,Savage; Stefan,9999,0,9999,0
1668246067699,CSE 293,032,119425,Schulze; Jurgen P.,9999,0,9999,0
1668246067699,CSE 293,033,119426,Snoeren; Alex C.,9999,0,9999,0
1668246067699,CSE 293,034,119428,Shang; Jingbo,9999,0,9999,0
1668246067699,CSE 293,035,119430,Stefan; Deian,9999,0,9999,0
1668246067699,CSE 293,036,119431,Su; Hao,9999,0,9999,0
1668246067699,CSE 293,037,119433,Swanson; Steven James,9999,0,9999,0
1668246067699,CSE 293,038,119435,Tullsen; Dean Michael,9999,0,9999,0
1668246067699,CSE 293,039,119483,Voelker; Geoffrey M.,9999,0,9999,0
1668246067699,CSE 293,040,119537,Zhao; Jishen,9999,0,9999,0
1668246067699,CSE 293,041,119538,Zhou; Yuan-Yuan,9999,0,9999,0
1668246067699,CSE 293,042,119539,Gao; Sicun,9999,0,9999,0
1668246067699,CSE 293,043,119540,Weibel; Nadir,9999,0,9999,0
1668246067699,CSE 293,044,119541,Gupta; Rajesh K.,9999,0,9999,0
1668246067699,CSE 293,045,126410,Vaccaro; Kristen Marie,9999,0,9999,0
1668246067699,CSE 293,046,126411,Klemke; Richard,9999,0,9999,0
1668246068133,CSE 294,A00,102459,Voelker; Geoffrey M.,0,0,0,0
1668246068133,CSE 294,B00,111322,Orailoglu; Alex,0,0,0,0
1668246068557,DSE 201,A00,096914,Deutsch; Alin Bernard,30,0,30,0
1668246068981,DSE 210,A00,096915,Dasgupta; Sanjoy,30,0,30,0
1668246069412,DSE 260A,A00,096916,Altintas De Callaf; Ilkay,30,0,30,0
1668246069841,ECE 200,001,103586,Antipa; Nicholas A,9999,0,9999,0
1668246069841,ECE 200,002,103587,Atanasov; Nikolay A.,9999,0,9999,0
1668246069841,ECE 200,003,103588,Bharadia; Dinesh,9999,0,9999,0
1668246069841,ECE 200,004,103589,Cheng; Chung Kuan,9999,0,9999,0
1668246069841,ECE 200,005,103590,Cosman; Pamela C.,9999,0,9999,0
1668246069841,ECE 200,006,103591,Dayeh; Shadi Ahmad,9999,0,9999,0
1668246069841,ECE 200,007,103592,Fainman; Yeshaiahu,9999,0,9999,0
1668246069841,ECE 200,008,103593,Ford; Joseph Earl,9999,0,9999,0
1668246069841,ECE 200,009,103594,Franceschetti; Massimo,9999,0,9999,0
1668246069841,ECE 200,010,103595,Fullerton; Eric E,9999,0,9999,0
1668246069841,ECE 200,011,103596,Galton; Ian A,9999,0,9999,0
1668246069841,ECE 200,012,103597,Gilja; Vikash,9999,0,9999,0
1668246069841,ECE 200,013,103598,Hall; Drew A.,9999,0,9999,0
1668246069841,ECE 200,014,103599,Hsueh; Tzu-Chien,9999,0,9999,0
1668246069841,ECE 200,015,103600,Javidi; Tara,9999,0,9999,0
1668246069841,ECE 200,016,103601,Kahng; Andrew Byun,9999,0,9999,0
1668246069841,ECE 200,017,103602,Kim; Young-Han,9999,0,9999,0
1668246069841,ECE 200,018,103603,Koushanfar; Farinaz,9999,0,9999,0
1668246069841,ECE 200,019,103604,Kuzum; Duygu,9999,0,9999,0
1668246069841,ECE 200,020,103605,Le; Hanh-Phuc,9999,0,9999,0
1668246069841,ECE 200,021,103606,Lin; Bill,9999,0,9999,0
1668246069841,ECE 200,022,103607,Liu; Zhaowei,9998,0,9999,1
1668246069841,ECE 200,023,103608,Lo; Yu-Hwa,9999,0,9999,0
1668246069841,ECE 200,024,103609,Lomakin; Vitaliy,9999,0,9999,0
1668246069841,ECE 200,025,103610,Mercier; Patrick Philip,9999,0,9999,0
1668246069841,ECE 200,026,103611,Meyer; Florian,9999,0,9999,0
1668246069841,ECE 200,027,103612,Milstein; Laurence B.,9999,0,9999,0
1668246069841,ECE 200,028,103613,Mir Arabbaygi; Siavash,9999,0,9999,0
1668246069841,ECE 200,029,103614,Mookherjea; Shayan,9999,0,9999,0
1668246069841,ECE 200,030,103615,Morris; Karcher William,9999,0,9999,0
1668246069841,ECE 200,031,103616,Ng; Tse Nga,9999,0,9999,0
1668246069841,ECE 200,032,103617,Nguyen; Truong Quang,9999,0,9999,0
1668246069841,ECE 200,033,103618,Nomura; Kenji,9999,0,9999,0
1668246069841,ECE 200,034,103619,Orlitsky; Alon,9999,0,9999,0
1668246069841,ECE 200,035,103620,Pal; Piya,9999,0,9999,0
1668246069841,ECE 200,036,103621,Papen; George C.,9999,0,9999,0
1668246069841,ECE 200,037,103622,Radic; Stojan,9999,0,9999,0
1668246069841,ECE 200,038,103623,Rao; Bhaskar D.,9999,0,9999,0
1668246069841,ECE 200,039,103624,Rao; Ramesh R,9999,0,9999,0
1668246069841,ECE 200,040,103625,Rebeiz; Gabriel,9999,0,9999,0
1668246069841,ECE 200,041,103626,Sanford; John R,9999,0,9999,0
1668246069841,ECE 200,042,103627,Siegel; Paul H.,9999,0,9999,0
1668246069841,ECE 200,043,103628,Sievenpiper; Daniel F.,9999,0,9999,0
1668246069841,ECE 200,044,103629,Sworder; David D.,9999,0,9999,0
1668246069841,ECE 200,045,103630,Taur; Yuan,9999,0,9999,0
1668246069841,ECE 200,046,103631,Touri; Behrouz,9999,0,9999,0
1668246069841,ECE 200,047,103632,Trivedi; Mohan M.,9999,0,9999,0
1668246069841,ECE 200,048,103633,Vasconcelos; Nuno,9999,0,9999,0
1668246069841,ECE 200,049,103634,Wang; Xiaolong,9999,0,9999,0
1668246069841,ECE 200,050,103635,Xie; Pengtao,9999,0,9999,0
1668246069841,ECE 200,051,103636,Yip; Michael,9999,0,9999,0
1668246069841,ECE 200,052,103637,Zeger; Kenneth A.,999,0,999,0
1668246069841,ECE 200,053,103638,Zhang; Xinyu,9999,0,9999,0
1668246069841,ECE 200,054,103639,Turakhia; Yatish Girish,9999,0,9999,0
1668246069841,ECE 200,055,103640,Kang; Mingu,9999,0,9999,0
1668246069841,ECE 200,056,103641,Shi; Yuanyuan,9999,0,9999,0
1668246069841,ECE 200,057,103642,Wang; Edward Jay,9999,0,9999,0
1668246069841,ECE 200,058,103643,Zheng; Yang,9999,0,9999,0
1668246070264,ECE 202,A00,103644,Kuzum; Duygu,0,0,0,0
1668246070689,ECE 212BN,A00,103646,Ng; Tse Nga,0,0,0,0
1668246071115,ECE 221,A00,111493,Staff,0,0,0,0
1668246071538,ECE 222B,A00,103647,Lomakin; Vitaliy,0,0,0,0
1668246071961,ECE 230B,A00,103648,Taur; Yuan,0,0,0,0
1668246072386,ECE 238B,A00,103649,Garay; Javier,0,0,0,0
1668246072809,ECE 240B,A00,112900,Fainman; Yeshaiahu,0,0,0,0
1668246073240,ECE 247A,A00,103650,Jokerst; Jesse Vincent,0,0,0,0
1668246073676,ECE 247B,A00,103651,Wang; Joseph,0,0,0,0
1668246074103,ECE 250,A00,103652,Siegel; Paul H.,0,0,0,0
1668246074527,ECE 251A,A00,103654,Rao; Bhaskar D.,0,0,0,0
1668246074952,ECE 257B,A00,103655,Bharadia; Dinesh,0,0,0,0
1668246075377,ECE 258A,A00,103656,Milstein; Laurence B.,0,0,0,0
1668246075801,ECE 260B,A00,103658,Kang; Mingu,0,0,0,0
1668246076224,ECE 264A,A00,103659,Galton; Ian A,0,0,0,0
1668246076647,ECE 265A,A00,103661,Gudem; Prasad S.S.,0,0,0,0
1668246077070,ECE 265D,A00,103662,Gudem; Prasad S.S.,0,0,0,0
1668246077495,ECE 268,A00,103663,Koushanfar; Farinaz,0,0,0,0
1668246077917,ECE 269,A01,103665,Pal; Piya,0,0,0,0
1668246078341,ECE 271B,A00,103666,Vasconcelos; Manuela,0,0,0,0
1668246078765,ECE 276A,A00,103667,Atanasov; Nikolay A.,0,0,0,0
1668246079189,ECE 277,A00,103668,An; Cheolhong,0,0,0,0
1668246079613,ECE 279,A00,117947,Hall; Drew A.,0,0,0,0
1668246080463,ECE 283,A00,103670,Hsueh; Tzu-Chien,0,0,0,0
1668246080885,ECE 284,A00,103671,Turakhia; Yatish Girish,0,0,0,0
1668246081311,ECE 285,A00,103672,Zheng; Yang,0,0,0,0
1668246081311,ECE 285,B00,103673,Sworder; David D.,0,0,0,0
1668246081733,ECE 287,A00,103676,Javidi; Tara,0,0,0,0
1668246082158,MATH 200B,A00,098023,Salehi Golsefidy; Alireza,12,0,15,3
1668246082581,MATH 202B,A00,098024,Rhoades; Brendon Patrick,9,0,15,6
1668246083012,MATH 203B,A00,098025,Oprea; Dragos N.,10,0,15,5
1668246083441,MATH 204B,A00,098026,Sorensen; Claus M,13,0,15,2
1668246083867,MATH 208,A00,098027,Izadi; Elham,7,0,10,3
1668246084290,MATH 209,A00,098028,Pollack; Aaron,10,0,10,0
1668246084713,MATH 211A,A00,112919,Rogalski; Daniel,9,0,10,1
1668246085138,MATH 211B,A00,112920,Seward; Brandon M.,9,0,10,1
1668246085562,MATH 218,A00,098029,Li; Bo,10,0,10,0
1668246085986,MATH 220B,A00,098030,Novak; Jonathan I,11,0,15,4
1668246086411,MATH 221A,A00,098031,Ebenfelt; Peter F,13,0,15,2
1668246086834,MATH 231B,A00,098032,Zlatos; Andrej,12,0,15,3
1668246087261,MATH 240B,A00,098033,Ni; Lei,9,0,15,6
1668246087684,MATH 243,A00,098034,Jekel; David Andrew,10,0,10,0
1668246088202,MATH 245A,A00,098035,Nie; Jiawang,0,0,15,16
1668246088635,MATH 248,A00,098036,Bejenaru; Ioan,10,0,10,0
1668246089058,MATH 250B,A00,098037,Spolaor; Luca,14,0,15,1
1668246089484,MATH 258,A00,098038,Ni; Lei,10,0,10,0
1668246089914,MATH 264B,A00,098041,Rhoades; Brendon Patrick,9,0,15,6
1668246090338,MATH 268,A00,098042,Buss; Samuel R,10,0,10,0
1668246090764,MATH 269,A00,098043,Rhoades; Brendon Patrick,10,0,10,0
1668246091188,MATH 270B,A00,098044,Li; Bo,10,0,15,5
1668246091611,MATH 272B,A00,098045,Holst; Michael J,13,0,15,2
1668246092035,MATH 273A,A00,098046,Tian; Xiaochuan,10,0,15,5
1668246092469,MATH 275,A01,098048,Tian; Xiaochuan,6,0,10,4
1668246092900,MATH 278A,A00,098049,Holst; Michael J,8,0,10,2
1668246093334,MATH 278B,A00,098050,Cloninger; Alexander,10,0,10,0
1668246093761,MATH 278C,A00,098051,Nie; Jiawang,7,0,10,3
1668246094184,MATH 280B,A00,098052,Zheng; Tianyi,9,0,15,6
1668246094609,MATH 281B,A00,098053,Bradic; Jelena,1,0,15,14
1668246095033,MATH 282B,A00,098054,Arias-Castro; Ery,0,0,15,15
1668246095461,MATH 285,A00,098055,Fitzsimmons; Patrick J,0,0,15,17
1668246095885,MATH 287B,A00,098056,Arias-Castro; Ery,2,0,15,13
1668246096309,MATH 288,A00,098057,Agarwal; Pooja,9,0,10,1
1668246096309,MATH 288,B00,098058,Zhang; Danna,8,0,10,2
1668246096309,MATH 288,C00,098059,Williams; Ruth J,10,0,10,0
1668246096735,MATH 290B,A00,098060,Roberts; Justin Deritter,13,0,15,2
1668246097158,MATH 292,A00,098061,Belmont; Eva Kinoshita,10,0,10,0
1668246097581,MATH 295,A00,098062,Suk; Andrew Hoon,48,0,50,2
1668246098003,MATH 296,A00,098063,Novak; Jonathan I,20,0,20,0
1668246098427,MATH 297,001,098064,Gamst; Anthony Collins,9997,0,9999,2
1668246598487,COGS 205,A00,101395,Chiba; Andrea,19,0,20,1
1668246598911,COGS 210B,001,101404,Greene; Deanna Jacquelyn,9998,0,9999,1
1668246598911,COGS 210B,002,101417,Xia; Haijun,9999,0,9999,0
1668246598911,COGS 210B,003,101422,Nitz; Douglas A.,9999,0,9999,0
1668246598911,COGS 210B,004,101423,Hollan; James D.,9998,0,9999,1
1668246598911,COGS 210B,005,101424,Deak; Gedeon O.,9998,0,9999,1
1668246598911,COGS 210B,006,101425,Rossano; Federico,9999,0,9999,0
1668246599336,COGS 211B,A00,101427,Coulson; Seana M,9996,0,9999,3
1668246599772,COGS 220,A00,101428,Hollan; James D.,0,0,25,25
1668246600195,COGS 229,A00,101429,Dow; Steven P,18,0,25,7
1668246600617,COGS 230,A00,101430,Klemmer; Scott R,12,0,17,5
1668246601042,COGS 234,A00,101431,Xia; Haijun,2,0,25,23
1668246601466,COGS 260,A00,101432,Kiyonaga; Anastasia,21,0,25,4
1668246601466,COGS 260,B00,101433,Kirsh; David Joel,15,0,25,10
1668246601892,CSE 202,A00,102371,Impagliazzo; Russell,0,0,0,0
1668246602328,CSE 203B,A01,102373,Cheng; Chung Kuan,0,0,0,0
1668246602762,CSE 208,A00,102374,Micciancio; Daniele,0,0,0,0
1668246603196,CSE 209A,A00,112895,Impagliazzo; Russell,0,0,15,15
1668246603618,CSE 209B,A00,108005,Bellare; Mihir,0,0,0,0
1668246604054,CSE 210,A00,113163,Coblenz; Michael J,0,0,0,0
1668246604482,CSE 219,A00,106111,Dow; Steven P,0,0,20,20
1668246604905,CSE 221,A00,102376,Voelker; Geoffrey M.,0,0,0,0
1668246605331,CSE 224,A01,102378,Porter; George M,0,0,0,0
1668246605769,CSE 229A,A00,102379,Savage; Stefan,0,0,0,0
1668246606193,CSE 229C,A00,102380,Munyaka; Imani N. S.,0,0,0,0
1668246606630,CSE 232B,A00,102382,Deutsch; Alin Bernard,0,0,0,0
1668246607065,CSE 234,A01,112904,Kumar; Arun Kumar,0,0,0,0
1668246607494,CSE 237A,A00,102383,Rosing; Tajana Simunic,0,0,0,0
1668246607919,CSE 239A,A00,102384,Deutsch; Alin Bernard,0,0,0,0
1668246608439,CSE 239B,A00,102385,Polikarpova; Nadezhda,0,0,0,0
1668246608869,CSE 240A,A00,102386,Pannuto; Patrick William,0,0,0,0
1668246609304,CSE 240B,A00,102387,Zhao; Jishen,0,0,0,0
1668246609733,CSE 241A,A00,106406,Kang; Mingu,0,0,0,0
1668246610161,CSE 249B,A00,102388,Kahng; Andrew Byun,0,0,8,8
1668246610584,CSE 251B,A01,102392,Cottrell; Garrison W,0,0,0,0
1668246610584,CSE 251B,A02,102393,Cottrell; Garrison W,0,0,0,0
1668246611011,CSE 252B,A00,102394,Ochoa; Benjamin Lawrence,0,0,0,0
1668246611441,CSE 257,A01,102396,Gao; Sicun,0,0,0,0
1668246611876,CSE 272,A00,102397,Li; Tzumao,0,0,0,0
1668246612326,CSE 274,A00,111323,Chern; Albert Ren-Haur,0,0,0,0
1668246612749,CSE 282,A00,102398,Pevzner; Pavel Arkadjevich,0,0,0,0
1668246613176,CSE 284,A00,114175,Gymrek; Melissa Ann,0,0,0,0
1668246613603,CSE 290,A00,102399,Chandraker; Manmohan Krishna,0,0,0,0
1668246613603,CSE 290,B00,102400,Vaccaro; Kristen Marie,0,0,25,25
1668246613603,CSE 290,C00,102414,Pannuto; Patrick William,0,0,25,25
1668246613603,CSE 290,D00,102427,Pevzner; Pavel Arkadjevich,0,0,0,0
1668246613603,CSE 290,E00,102429,Zhao; Jishen,0,0,0,0
1668246613603,CSE 290,F00,102436,Tullsen; Dean Michael,0,0,0,0
1668246613603,CSE 290,G00,102440,Christensen; Henrik I,0,0,20,20
1668246614034,CSE 291,A00,102443,Su; Hao,0,0,0,0
1668246614034,CSE 291,B00,102448,Polikarpova; Nadezhda,0,0,0,0
1668246614034,CSE 291,C00,102453,Vaccaro; Kristen Marie,0,0,0,0
1668246614034,CSE 291,D00,111343,Savage; Stefan,0,0,0,0
1668246614034,CSE 291,E00,116474,Claffy; Kimberly Claire,0,0,0,0
1668246614034,CSE 291,F00,116479,Pasquale; Joseph,0,0,0,0
1668246614494,CSE 293,001,119111,Bafna; Vineet,9999,0,9999,0
1668246614494,CSE 293,002,119118,Bellare; Mihir,9999,0,9999,0
1668246614494,CSE 293,003,119122,Berg-Kirkpatrick; Taylor D,9999,0,9999,0
1668246614494,CSE 293,004,119135,Christensen; Henrik I,9999,0,9999,0
1668246614494,CSE 293,005,119142,Cottrell; Garrison W,9999,0,9999,0
1668246614494,CSE 293,006,119146,Deutsch; Alin Bernard,9999,0,9999,0
1668246614494,CSE 293,007,119159,Esmaeilzadeh; Hadi,9999,0,9999,0
1668246614494,CSE 293,008,119166,Freund; Yoav,9999,0,9999,0
1668246614494,CSE 293,009,119170,Griswold; William G.,9999,0,9999,0
1668246614494,CSE 293,010,119183,Gymrek; Melissa Ann,9999,0,9999,0
1668246614494,CSE 293,011,119190,Heninger; Nadia A,9999,0,9999,0
1668246614494,CSE 293,012,119230,Impagliazzo; Russell,9999,0,9999,0
1668246614494,CSE 293,013,119232,Jhala; Ranjit,9999,0,9999,0
1668246614494,CSE 293,014,119233,Kahng; Andrew Byun,9999,0,9999,0
1668246614494,CSE 293,015,119298,Kane; Daniel Mertz,9999,0,9999,0
1668246614494,CSE 293,016,119299,Kriegman; David J,9999,0,9999,0
1668246614494,CSE 293,017,119300,Kumar; Arun Kumar,9999,0,9999,0
1668246614494,CSE 293,018,119301,Lerner; Sorin,9999,0,9999,0
1668246614494,CSE 293,019,119302,Lovett; Shachar,9999,0,9999,0
1668246614494,CSE 293,020,119303,McAuley; Julian John,9999,0,9999,0
1668246614494,CSE 293,021,119304,Micciancio; Daniele,9999,0,9999,0
1668246614494,CSE 293,022,119367,Orailoglu; Alex,9999,0,9999,0
1668246614494,CSE 293,023,119382,Paturi; Ramamohan,9999,0,9999,0
1668246614494,CSE 293,024,119404,Polikarpova; Nadezhda,9999,0,9999,0
1668246614494,CSE 293,025,119406,Politz; Joseph Gibbs,9999,0,9999,0
1668246614494,CSE 293,026,119411,Porter; George M,9999,0,9999,0
1668246614494,CSE 293,027,119414,Porter; Leonard Emerson,9999,0,9999,0
1668246614494,CSE 293,028,119416,Ramamoorthi; Ravi,9999,0,9999,0
1668246614494,CSE 293,029,119417,Sahoo; Debashis,9999,0,9999,0
1668246614494,CSE 293,030,119420,Saul; Lawrence,9999,0,9999,0
1668246614494,CSE 293,031,119421,Savage; Stefan,9999,0,9999,0
1668246614494,CSE 293,032,119425,Schulze; Jurgen P.,9999,0,9999,0
1668246614494,CSE 293,033,119426,Snoeren; Alex C.,9999,0,9999,0
1668246614494,CSE 293,034,119428,Shang; Jingbo,9999,0,9999,0
1668246614494,CSE 293,035,119430,Stefan; Deian,9999,0,9999,0
1668246614494,CSE 293,036,119431,Su; Hao,9999,0,9999,0
1668246614494,CSE 293,037,119433,Swanson; Steven James,9999,0,9999,0
1668246614494,CSE 293,038,119435,Tullsen; Dean Michael,9999,0,9999,0
1668246614494,CSE 293,039,119483,Voelker; Geoffrey M.,9999,0,9999,0
1668246614494,CSE 293,040,119537,Zhao; Jishen,9999,0,9999,0
1668246614494,CSE 293,041,119538,Zhou; Yuan-Yuan,9999,0,9999,0
1668246614494,CSE 293,042,119539,Gao; Sicun,9999,0,9999,0
1668246614494,CSE 293,043,119540,Weibel; Nadir,9999,0,9999,0
1668246614494,CSE 293,044,119541,Gupta; Rajesh K.,9999,0,9999,0
1668246614494,CSE 293,045,126410,Vaccaro; Kristen Marie,9999,0,9999,0
1668246614494,CSE 293,046,126411,Klemke; Richard,9999,0,9999,0
1668246614918,CSE 294,A00,102459,Voelker; Geoffrey M.,0,0,0,0
1668246614918,CSE 294,B00,111322,Orailoglu; Alex,0,0,0,0
1668246615371,DSE 201,A00,096914,Deutsch; Alin Bernard,30,0,30,0
1668246615807,DSE 210,A00,096915,Dasgupta; Sanjoy,30,0,30,0
1668246616243,DSE 260A,A00,096916,Altintas De Callaf; Ilkay,30,0,30,0
1668246616675,ECE 200,001,103586,Antipa; Nicholas A,9999,0,9999,0
1668246616675,ECE 200,002,103587,Atanasov; Nikolay A.,9999,0,9999,0
1668246616675,ECE 200,003,103588,Bharadia; Dinesh,9999,0,9999,0
1668246616675,ECE 200,004,103589,Cheng; Chung Kuan,9999,0,9999,0
1668246616675,ECE 200,005,103590,Cosman; Pamela C.,9999,0,9999,0
1668246616675,ECE 200,006,103591,Dayeh; Shadi Ahmad,9999,0,9999,0
1668246616675,ECE 200,007,103592,Fainman; Yeshaiahu,9999,0,9999,0
1668246616675,ECE 200,008,103593,Ford; Joseph Earl,9999,0,9999,0
1668246616675,ECE 200,009,103594,Franceschetti; Massimo,9999,0,9999,0
1668246616675,ECE 200,010,103595,Fullerton; Eric E,9999,0,9999,0
1668246616675,ECE 200,011,103596,Galton; Ian A,9999,0,9999,0
1668246616675,ECE 200,012,103597,Gilja; Vikash,9999,0,9999,0
1668246616675,ECE 200,013,103598,Hall; Drew A.,9999,0,9999,0
1668246616675,ECE 200,014,103599,Hsueh; Tzu-Chien,9999,0,9999,0
1668246616675,ECE 200,015,103600,Javidi; Tara,9999,0,9999,0
1668246616675,ECE 200,016,103601,Kahng; Andrew Byun,9999,0,9999,0
1668246616675,ECE 200,017,103602,Kim; Young-Han,9999,0,9999,0
1668246616675,ECE 200,018,103603,Koushanfar; Farinaz,9999,0,9999,0
1668246616675,ECE 200,019,103604,Kuzum; Duygu,9999,0,9999,0
1668246616675,ECE 200,020,103605,Le; Hanh-Phuc,9999,0,9999,0
1668246616675,ECE 200,021,103606,Lin; Bill,9999,0,9999,0
1668246616675,ECE 200,022,103607,Liu; Zhaowei,9998,0,9999,1
1668246616675,ECE 200,023,103608,Lo; Yu-Hwa,9999,0,9999,0
1668246616675,ECE 200,024,103609,Lomakin; Vitaliy,9999,0,9999,0
1668246616675,ECE 200,025,103610,Mercier; Patrick Philip,9999,0,9999,0
1668246616675,ECE 200,026,103611,Meyer; Florian,9999,0,9999,0
1668246616675,ECE 200,027,103612,Milstein; Laurence B.,9999,0,9999,0
1668246616675,ECE 200,028,103613,Mir Arabbaygi; Siavash,9999,0,9999,0
1668246616675,ECE 200,029,103614,Mookherjea; Shayan,9999,0,9999,0
1668246616675,ECE 200,030,103615,Morris; Karcher William,9999,0,9999,0
1668246616675,ECE 200,031,103616,Ng; Tse Nga,9999,0,9999,0
1668246616675,ECE 200,032,103617,Nguyen; Truong Quang,9999,0,9999,0
1668246616675,ECE 200,033,103618,Nomura; Kenji,9999,0,9999,0
1668246616675,ECE 200,034,103619,Orlitsky; Alon,9999,0,9999,0
1668246616675,ECE 200,035,103620,Pal; Piya,9999,0,9999,0
1668246616675,ECE 200,036,103621,Papen; George C.,9999,0,9999,0
1668246616675,ECE 200,037,103622,Radic; Stojan,9999,0,9999,0
1668246616675,ECE 200,038,103623,Rao; Bhaskar D.,9999,0,9999,0
1668246616675,ECE 200,039,103624,Rao; Ramesh R,9999,0,9999,0
1668246616675,ECE 200,040,103625,Rebeiz; Gabriel,9999,0,9999,0
1668246616675,ECE 200,041,103626,Sanford; John R,9999,0,9999,0
1668246616675,ECE 200,042,103627,Siegel; Paul H.,9999,0,9999,0
1668246616675,ECE 200,043,103628,Sievenpiper; Daniel F.,9999,0,9999,0
1668246616675,ECE 200,044,103629,Sworder; David D.,9999,0,9999,0
1668246616675,ECE 200,045,103630,Taur; Yuan,9999,0,9999,0
1668246616675,ECE 200,046,103631,Touri; Behrouz,9999,0,9999,0
1668246616675,ECE 200,047,103632,Trivedi; Mohan M.,9999,0,9999,0
1668246616675,ECE 200,048,103633,Vasconcelos; Nuno,9999,0,9999,0
1668246616675,ECE 200,049,103634,Wang; Xiaolong,9999,0,9999,0
1668246616675,ECE 200,050,103635,Xie; Pengtao,9999,0,9999,0
1668246616675,ECE 200,051,103636,Yip; Michael,9999,0,9999,0
1668246616675,ECE 200,052,103637,Zeger; Kenneth A.,999,0,999,0
1668246616675,ECE 200,053,103638,Zhang; Xinyu,9999,0,9999,0
1668246616675,ECE 200,054,103639,Turakhia; Yatish Girish,9999,0,9999,0
1668246616675,ECE 200,055,103640,Kang; Mingu,9999,0,9999,0
1668246616675,ECE 200,056,103641,Shi; Yuanyuan,9999,0,9999,0
1668246616675,ECE 200,057,103642,Wang; Edward Jay,9999,0,9999,0
1668246616675,ECE 200,058,103643,Zheng; Yang,9999,0,9999,0
1668246617099,ECE 202,A00,103644,Kuzum; Duygu,0,0,0,0
1668246617526,ECE 212BN,A00,103646,Ng; Tse Nga,0,0,0,0
1668246617953,ECE 221,A00,111493,Staff,0,0,0,0
1668246618377,ECE 222B,A00,103647,Lomakin; Vitaliy,0,0,0,0
1668246618807,ECE 230B,A00,103648,Taur; Yuan,0,0,0,0
1668246619237,ECE 238B,A00,103649,Garay; Javier,0,0,0,0
1668246619662,ECE 240B,A00,112900,Fainman; Yeshaiahu,0,0,0,0
1668246620087,ECE 247A,A00,103650,Jokerst; Jesse Vincent,0,0,0,0
1668246620523,ECE 247B,A00,103651,Wang; Joseph,0,0,0,0
1668246620947,ECE 250,A00,103652,Siegel; Paul H.,0,0,0,0
1668246621375,ECE 251A,A00,103654,Rao; Bhaskar D.,0,0,0,0
1668246621804,ECE 257B,A00,103655,Bharadia; Dinesh,0,0,0,0
1668246622227,ECE 258A,A00,103656,Milstein; Laurence B.,0,0,0,0
1668246622659,ECE 260B,A00,103658,Kang; Mingu,0,0,0,0
1668246623082,ECE 264A,A00,103659,Galton; Ian A,0,0,0,0
1668246623519,ECE 265A,A00,103661,Gudem; Prasad S.S.,0,0,0,0
1668246623943,ECE 265D,A00,103662,Gudem; Prasad S.S.,0,0,0,0
1668246624366,ECE 268,A00,103663,Koushanfar; Farinaz,0,0,0,0
1668246624789,ECE 269,A01,103665,Pal; Piya,0,0,0,0
1668246625213,ECE 271B,A00,103666,Vasconcelos; Manuela,0,0,0,0
1668246625637,ECE 276A,A00,103667,Atanasov; Nikolay A.,0,0,0,0
1668246626063,ECE 277,A00,103668,An; Cheolhong,0,0,0,0
1668246626490,ECE 279,A00,117947,Hall; Drew A.,0,0,0,0
1668246627342,ECE 283,A00,103670,Hsueh; Tzu-Chien,0,0,0,0
1668246627764,ECE 284,A00,103671,Turakhia; Yatish Girish,0,0,0,0
1668246628193,ECE 285,A00,103672,Zheng; Yang,0,0,0,0
1668246628193,ECE 285,B00,103673,Sworder; David D.,0,0,0,0
1668246628617,ECE 287,A00,103676,Javidi; Tara,0,0,0,0
1668246629040,MATH 200B,A00,098023,Salehi Golsefidy; Alireza,12,0,15,3
1668246629464,MATH 202B,A00,098024,Rhoades; Brendon Patrick,9,0,15,6
1668246629889,MATH 203B,A00,098025,Oprea; Dragos N.,10,0,15,5
1668246630313,MATH 204B,A00,098026,Sorensen; Claus M,13,0,15,2
1668246630738,MATH 208,A00,098027,Izadi; Elham,7,0,10,3
1668246631163,MATH 209,A00,098028,Pollack; Aaron,10,0,10,0
1668246631586,MATH 211A,A00,112919,Rogalski; Daniel,9,0,10,1
1668246632014,MATH 211B,A00,112920,Seward; Brandon M.,9,0,10,1
1668246632440,MATH 218,A00,098029,Li; Bo,10,0,10,0
1668246632864,MATH 220B,A00,098030,Novak; Jonathan I,11,0,15,4
1668246633291,MATH 221A,A00,098031,Ebenfelt; Peter F,13,0,15,2
1668246633715,MATH 231B,A00,098032,Zlatos; Andrej,12,0,15,3
1668246634148,MATH 240B,A00,098033,Ni; Lei,9,0,15,6
1668246634574,MATH 243,A00,098034,Jekel; David Andrew,10,0,10,0
1668246635004,MATH 245A,A00,098035,Nie; Jiawang,0,0,15,16
1668246635437,MATH 248,A00,098036,Bejenaru; Ioan,10,0,10,0
1668246635870,MATH 250B,A00,098037,Spolaor; Luca,14,0,15,1
1668246636293,MATH 258,A00,098038,Ni; Lei,10,0,10,0
1668246636720,MATH 264B,A00,098041,Rhoades; Brendon Patrick,9,0,15,6
1668246637146,MATH 268,A00,098042,Buss; Samuel R,10,0,10,0
1668246637572,MATH 269,A00,098043,Rhoades; Brendon Patrick,10,0,10,0
1668246637996,MATH 270B,A00,098044,Li; Bo,10,0,15,5
1668246638421,MATH 272B,A00,098045,Holst; Michael J,13,0,15,2
1668246638846,MATH 273A,A00,098046,Tian; Xiaochuan,10,0,15,5
1668246639269,MATH 275,A01,098048,Tian; Xiaochuan,6,0,10,4
1668246639696,MATH 278A,A00,098049,Holst; Michael J,8,0,10,2
1668246640121,MATH 278B,A00,098050,Cloninger; Alexander,10,0,10,0
1668246640547,MATH 278C,A00,098051,Nie; Jiawang,7,0,10,3
1668246640970,MATH 280B,A00,098052,Zheng; Tianyi,9,0,15,6
1668246641398,MATH 281B,A00,098053,Bradic; Jelena,1,0,15,14
1668246641824,MATH 282B,A00,098054,Arias-Castro; Ery,0,0,15,15
1668246642251,MATH 285,A00,098055,Fitzsimmons; Patrick J,0,0,15,17
1668246642675,MATH 287B,A00,098056,Arias-Castro; Ery,2,0,15,13
1668246643097,MATH 288,A00,098057,Agarwal; Pooja,9,0,10,1
1668246643097,MATH 288,B00,098058,Zhang; Danna,8,0,10,2
1668246643097,MATH 288,C00,098059,Williams; Ruth J,10,0,10,0
1668246643524,MATH 290B,A00,098060,Roberts; Justin Deritter,13,0,15,2
1668246643952,MATH 292,A00,098061,Belmont; Eva Kinoshita,10,0,10,0
1668246644403,MATH 295,A00,098062,Suk; Andrew Hoon,48,0,50,2
1668246644841,MATH 296,A00,098063,Novak; Jonathan I,20,0,20,0
1668246645283,MATH 297,001,098064,Gamst; Anthony Collins,9997,0,9999,2
1668247147476,COGS 205,A00,101395,Chiba; Andrea,19,0,20,1
1668247147931,COGS 210B,001,101404,Greene; Deanna Jacquelyn,9998,0,9999,1
1668247147931,COGS 210B,002,101417,Xia; Haijun,9999,0,9999,0
1668247147931,COGS 210B,003,101422,Nitz; Douglas A.,9999,0,9999,0
1668247147931,COGS 210B,004,101423,Hollan; James D.,9998,0,9999,1
1668247147931,COGS 210B,005,101424,Deak; Gedeon O.,9998,0,9999,1
1668247147931,COGS 210B,006,101425,Rossano; Federico,9999,0,9999,0
1668247148356,COGS 211B,A00,101427,Coulson; Seana M,9996,0,9999,3
1668247148803,COGS 220,A00,101428,Hollan; James D.,0,0,25,25
1668247149227,COGS 229,A00,101429,Dow; Steven P,18,0,25,7
1668247149662,COGS 230,A00,101430,Klemmer; Scott R,12,0,17,5
1668247150086,COGS 234,A00,101431,Xia; Haijun,2,0,25,23
1668247150533,COGS 260,A00,101432,Kiyonaga; Anastasia,21,0,25,4
1668247150533,COGS 260,B00,101433,Kirsh; David Joel,15,0,25,10
1668247150960,CSE 202,A00,102371,Impagliazzo; Russell,0,0,0,0
1668247151409,CSE 203B,A01,102373,Cheng; Chung Kuan,0,0,0,0
1668247151847,CSE 208,A00,102374,Micciancio; Daniele,0,0,0,0
1668247152271,CSE 209A,A00,112895,Impagliazzo; Russell,0,0,15,15
1668247152708,CSE 209B,A00,108005,Bellare; Mihir,0,0,0,0
1668247153134,CSE 210,A00,113163,Coblenz; Michael J,0,0,0,0
1668247153558,CSE 219,A00,106111,Dow; Steven P,0,0,20,20
1668247153982,CSE 221,A00,102376,Voelker; Geoffrey M.,0,0,0,0
1668247154406,CSE 224,A01,102378,Porter; George M,0,0,0,0
1668247154839,CSE 229A,A00,102379,Savage; Stefan,0,0,0,0
1668247155262,CSE 229C,A00,102380,Munyaka; Imani N. S.,0,0,0,0
1668247155693,CSE 232B,A00,102382,Deutsch; Alin Bernard,0,0,0,0
1668247156119,CSE 234,A01,112904,Kumar; Arun Kumar,0,0,0,0
1668247156543,CSE 237A,A00,102383,Rosing; Tajana Simunic,0,0,0,0
1668247156967,CSE 239A,A00,102384,Deutsch; Alin Bernard,0,0,0,0
1668247157396,CSE 239B,A00,102385,Polikarpova; Nadezhda,0,0,0,0
1668247157838,CSE 240A,A00,102386,Pannuto; Patrick William,0,0,0,0
1668247158266,CSE 240B,A00,102387,Zhao; Jishen,0,0,0,0
1668247158694,CSE 241A,A00,106406,Kang; Mingu,0,0,0,0
1668247159118,CSE 249B,A00,102388,Kahng; Andrew Byun,0,0,8,8
1668247159544,CSE 251B,A01,102392,Cottrell; Garrison W,0,0,0,0
1668247159544,CSE 251B,A02,102393,Cottrell; Garrison W,0,0,0,0
1668247159970,CSE 252B,A00,102394,Ochoa; Benjamin Lawrence,0,0,0,0
1668247160397,CSE 257,A01,102396,Gao; Sicun,0,0,0,0
1668247160821,CSE 272,A00,102397,Li; Tzumao,0,0,0,0
1668247161250,CSE 274,A00,111323,Chern; Albert Ren-Haur,0,0,0,0
1668247161676,CSE 282,A00,102398,Pevzner; Pavel Arkadjevich,0,0,0,0
1668247162100,CSE 284,A00,114175,Gymrek; Melissa Ann,0,0,0,0
1668247162527,CSE 290,A00,102399,Chandraker; Manmohan Krishna,0,0,0,0
1668247162527,CSE 290,B00,102400,Vaccaro; Kristen Marie,0,0,25,25
1668247162527,CSE 290,C00,102414,Pannuto; Patrick William,0,0,25,25
1668247162527,CSE 290,D00,102427,Pevzner; Pavel Arkadjevich,0,0,0,0
1668247162527,CSE 290,E00,102429,Zhao; Jishen,0,0,0,0
1668247162527,CSE 290,F00,102436,Tullsen; Dean Michael,0,0,0,0
1668247162527,CSE 290,G00,102440,Christensen; Henrik I,0,0,20,20
1668247162952,CSE 291,A00,102443,Su; Hao,0,0,0,0
1668247162952,CSE 291,B00,102448,Polikarpova; Nadezhda,0,0,0,0
1668247162952,CSE 291,C00,102453,Vaccaro; Kristen Marie,0,0,0,0
1668247162952,CSE 291,D00,111343,Savage; Stefan,0,0,0,0
1668247162952,CSE 291,E00,116474,Claffy; Kimberly Claire,0,0,0,0
1668247162952,CSE 291,F00,116479,Pasquale; Joseph,0,0,0,0
1668247163380,CSE 293,001,119111,Bafna; Vineet,9999,0,9999,0
1668247163380,CSE 293,002,119118,Bellare; Mihir,9999,0,9999,0
1668247163380,CSE 293,003,119122,Berg-Kirkpatrick; Taylor D,9999,0,9999,0
1668247163380,CSE 293,004,119135,Christensen; Henrik I,9999,0,9999,0
1668247163380,CSE 293,005,119142,Cottrell; Garrison W,9999,0,9999,0
1668247163380,CSE 293,006,119146,Deutsch; Alin Bernard,9999,0,9999,0
1668247163380,CSE 293,007,119159,Esmaeilzadeh; Hadi,9999,0,9999,0
1668247163380,CSE 293,008,119166,Freund; Yoav,9999,0,9999,0
1668247163380,CSE 293,009,119170,Griswold; William G.,9999,0,9999,0
1668247163380,CSE 293,010,119183,Gymrek; Melissa Ann,9999,0,9999,0
1668247163380,CSE 293,011,119190,Heninger; Nadia A,9999,0,9999,0
1668247163380,CSE 293,012,119230,Impagliazzo; Russell,9999,0,9999,0
1668247163380,CSE 293,013,119232,Jhala; Ranjit,9999,0,9999,0
1668247163380,CSE 293,014,119233,Kahng; Andrew Byun,9999,0,9999,0
1668247163380,CSE 293,015,119298,Kane; Daniel Mertz,9999,0,9999,0
1668247163380,CSE 293,016,119299,Kriegman; David J,9999,0,9999,0
1668247163380,CSE 293,017,119300,Kumar; Arun Kumar,9999,0,9999,0
1668247163380,CSE 293,018,119301,Lerner; Sorin,9999,0,9999,0
1668247163380,CSE 293,019,119302,Lovett; Shachar,9999,0,9999,0
1668247163380,CSE 293,020,119303,McAuley; Julian John,9999,0,9999,0
1668247163380,CSE 293,021,119304,Micciancio; Daniele,9999,0,9999,0
1668247163380,CSE 293,022,119367,Orailoglu; Alex,9999,0,9999,0
1668247163380,CSE 293,023,119382,Paturi; Ramamohan,9999,0,9999,0
1668247163380,CSE 293,024,119404,Polikarpova; Nadezhda,9999,0,9999,0
1668247163380,CSE 293,025,119406,Politz; Joseph Gibbs,9999,0,9999,0
1668247163380,CSE 293,026,119411,Porter; George M,9999,0,9999,0
1668247163380,CSE 293,027,119414,Porter; Leonard Emerson,9999,0,9999,0
1668247163380,CSE 293,028,119416,Ramamoorthi; Ravi,9999,0,9999,0
1668247163380,CSE 293,029,119417,Sahoo; Debashis,9999,0,9999,0
1668247163380,CSE 293,030,119420,Saul; Lawrence,9999,0,9999,0
1668247163380,CSE 293,031,119421,Savage; Stefan,9999,0,9999,0
1668247163380,CSE 293,032,119425,Schulze; Jurgen P.,9999,0,9999,0
1668247163380,CSE 293,033,119426,Snoeren; Alex C.,9999,0,9999,0
1668247163380,CSE 293,034,119428,Shang; Jingbo,9999,0,9999,0
1668247163380,CSE 293,035,119430,Stefan; Deian,9999,0,9999,0
1668247163380,CSE 293,036,119431,Su; Hao,9999,0,9999,0
1668247163380,CSE 293,037,119433,Swanson; Steven James,9999,0,9999,0
1668247163380,CSE 293,038,119435,Tullsen; Dean Michael,9999,0,9999,0
1668247163380,CSE 293,039,119483,Voelker; Geoffrey M.,9999,0,9999,0
1668247163380,CSE 293,040,119537,Zhao; Jishen,9999,0,9999,0
1668247163380,CSE 293,041,119538,Zhou; Yuan-Yuan,9999,0,9999,0
1668247163380,CSE 293,042,119539,Gao; Sicun,9999,0,9999,0
1668247163380,CSE 293,043,119540,Weibel; Nadir,9999,0,9999,0
1668247163380,CSE 293,044,119541,Gupta; Rajesh K.,9999,0,9999,0
1668247163380,CSE 293,045,126410,Vaccaro; Kristen Marie,9999,0,9999,0
1668247163380,CSE 293,046,126411,Klemke; Richard,9999,0,9999,0
1668247163810,CSE 294,A00,102459,Voelker; Geoffrey M.,0,0,0,0
1668247163810,CSE 294,B00,111322,Orailoglu; Alex,0,0,0,0
1668247164237,DSE 201,A00,096914,Deutsch; Alin Bernard,30,0,30,0
1668247164670,DSE 210,A00,096915,Dasgupta; Sanjoy,30,0,30,0
1668247165102,DSE 260A,A00,096916,Altintas De Callaf; Ilkay,30,0,30,0
1668247165550,ECE 200,001,103586,Antipa; Nicholas A,9999,0,9999,0
1668247165550,ECE 200,002,103587,Atanasov; Nikolay A.,9999,0,9999,0
1668247165550,ECE 200,003,103588,Bharadia; Dinesh,9999,0,9999,0
1668247165550,ECE 200,004,103589,Cheng; Chung Kuan,9999,0,9999,0
1668247165550,ECE 200,005,103590,Cosman; Pamela C.,9999,0,9999,0
1668247165550,ECE 200,006,103591,Dayeh; Shadi Ahmad,9999,0,9999,0
1668247165550,ECE 200,007,103592,Fainman; Yeshaiahu,9999,0,9999,0
1668247165550,ECE 200,008,103593,Ford; Joseph Earl,9999,0,9999,0
1668247165550,ECE 200,009,103594,Franceschetti; Massimo,9999,0,9999,0
1668247165550,ECE 200,010,103595,Fullerton; Eric E,9999,0,9999,0
1668247165550,ECE 200,011,103596,Galton; Ian A,9999,0,9999,0
1668247165550,ECE 200,012,103597,Gilja; Vikash,9999,0,9999,0
1668247165550,ECE 200,013,103598,Hall; Drew A.,9999,0,9999,0
1668247165550,ECE 200,014,103599,Hsueh; Tzu-Chien,9999,0,9999,0
1668247165550,ECE 200,015,103600,Javidi; Tara,9999,0,9999,0
1668247165550,ECE 200,016,103601,Kahng; Andrew Byun,9999,0,9999,0
1668247165550,ECE 200,017,103602,Kim; Young-Han,9999,0,9999,0
1668247165550,ECE 200,018,103603,Koushanfar; Farinaz,9999,0,9999,0
1668247165550,ECE 200,019,103604,Kuzum; Duygu,9999,0,9999,0
1668247165550,ECE 200,020,103605,Le; Hanh-Phuc,9999,0,9999,0
1668247165550,ECE 200,021,103606,Lin; Bill,9999,0,9999,0
1668247165550,ECE 200,022,103607,Liu; Zhaowei,9998,0,9999,1
1668247165550,ECE 200,023,103608,Lo; Yu-Hwa,9999,0,9999,0
1668247165550,ECE 200,024,103609,Lomakin; Vitaliy,9999,0,9999,0
1668247165550,ECE 200,025,103610,Mercier; Patrick Philip,9999,0,9999,0
1668247165550,ECE 200,026,103611,Meyer; Florian,9999,0,9999,0
1668247165550,ECE 200,027,103612,Milstein; Laurence B.,9999,0,9999,0
1668247165550,ECE 200,028,103613,Mir Arabbaygi; Siavash,9999,0,9999,0
1668247165550,ECE 200,029,103614,Mookherjea; Shayan,9999,0,9999,0
1668247165550,ECE 200,030,103615,Morris; Karcher William,9999,0,9999,0
1668247165550,ECE 200,031,103616,Ng; Tse Nga,9999,0,9999,0
1668247165550,ECE 200,032,103617,Nguyen; Truong Quang,9999,0,9999,0
1668247165550,ECE 200,033,103618,Nomura; Kenji,9999,0,9999,0
1668247165550,ECE 200,034,103619,Orlitsky; Alon,9999,0,9999,0
1668247165550,ECE 200,035,103620,Pal; Piya,9999,0,9999,0
1668247165550,ECE 200,036,103621,Papen; George C.,9999,0,9999,0
1668247165550,ECE 200,037,103622,Radic; Stojan,9999,0,9999,0
1668247165550,ECE 200,038,103623,Rao; Bhaskar D.,9999,0,9999,0
1668247165550,ECE 200,039,103624,Rao; Ramesh R,9999,0,9999,0
1668247165550,ECE 200,040,103625,Rebeiz; Gabriel,9999,0,9999,0
1668247165550,ECE 200,041,103626,Sanford; John R,9999,0,9999,0
1668247165550,ECE 200,042,103627,Siegel; Paul H.,9999,0,9999,0
1668247165550,ECE 200,043,103628,Sievenpiper; Daniel F.,9999,0,9999,0
1668247165550,ECE 200,044,103629,Sworder; David D.,9999,0,9999,0
1668247165550,ECE 200,045,103630,Taur; Yuan,9999,0,9999,0
1668247165550,ECE 200,046,103631,Touri; Behrouz,9999,0,9999,0
1668247165550,ECE 200,047,103632,Trivedi; Mohan M.,9999,0,9999,0
1668247165550,ECE 200,048,103633,Vasconcelos; Nuno,9999,0,9999,0
1668247165550,ECE 200,049,103634,Wang; Xiaolong,9999,0,9999,0
1668247165550,ECE 200,050,103635,Xie; Pengtao,9999,0,9999,0
1668247165550,ECE 200,051,103636,Yip; Michael,9999,0,9999,0
1668247165550,ECE 200,052,103637,Zeger; Kenneth A.,999,0,999,0
1668247165550,ECE 200,053,103638,Zhang; Xinyu,9999,0,9999,0
1668247165550,ECE 200,054,103639,Turakhia; Yatish Girish,9999,0,9999,0
1668247165550,ECE 200,055,103640,Kang; Mingu,9999,0,9999,0
1668247165550,ECE 200,056,103641,Shi; Yuanyuan,9999,0,9999,0
1668247165550,ECE 200,057,103642,Wang; Edward Jay,9999,0,9999,0
1668247165550,ECE 200,058,103643,Zheng; Yang,9999,0,9999,0
1668247165975,ECE 202,A00,103644,Kuzum; Duygu,0,0,0,0
1668247166403,ECE 212BN,A00,103646,Ng; Tse Nga,0,0,0,0
1668247166827,ECE 221,A00,111493,Staff,0,0,0,0
1668247167255,ECE 222B,A00,103647,Lomakin; Vitaliy,0,0,0,0
1668247167678,ECE 230B,A00,103648,Taur; Yuan,0,0,0,0
1668247168109,ECE 238B,A00,103649,Garay; Javier,0,0,0,0
1668247168534,ECE 240B,A00,112900,Fainman; Yeshaiahu,0,0,0,0
1668247168960,ECE 247A,A00,103650,Jokerst; Jesse Vincent,0,0,0,0
1668247169387,ECE 247B,A00,103651,Wang; Joseph,0,0,0,0
1668247169811,ECE 250,A00,103652,Siegel; Paul H.,0,0,0,0
1668247170241,ECE 251A,A00,103654,Rao; Bhaskar D.,0,0,0,0
1668247170668,ECE 257B,A00,103655,Bharadia; Dinesh,0,0,0,0
1668247171092,ECE 258A,A00,103656,Milstein; Laurence B.,0,0,0,0
1668247171516,ECE 260B,A00,103658,Kang; Mingu,0,0,0,0
1668247171947,ECE 264A,A00,103659,Galton; Ian A,0,0,0,0
1668247172369,ECE 265A,A00,103661,Gudem; Prasad S.S.,0,0,0,0
1668247172794,ECE 265D,A00,103662,Gudem; Prasad S.S.,0,0,0,0
1668247173217,ECE 268,A00,103663,Koushanfar; Farinaz,0,0,0,0
1668247173641,ECE 269,A01,103665,Pal; Piya,0,0,0,0
1668247174181,ECE 271B,A00,103666,Vasconcelos; Manuela,0,0,0,0
1668247174614,ECE 276A,A00,103667,Atanasov; Nikolay A.,0,0,0,0
1668247175039,ECE 277,A00,103668,An; Cheolhong,0,0,0,0
1668247175465,ECE 279,A00,117947,Hall; Drew A.,0,0,0,0
1668247176325,ECE 283,A00,103670,Hsueh; Tzu-Chien,0,0,0,0
1668247176749,ECE 284,A00,103671,Turakhia; Yatish Girish,0,0,0,0
1668247177176,ECE 285,A00,103672,Zheng; Yang,0,0,0,0
1668247177176,ECE 285,B00,103673,Sworder; David D.,0,0,0,0
1668247177603,ECE 287,A00,103676,Javidi; Tara,0,0,0,0
1668247178034,MATH 200B,A00,098023,Salehi Golsefidy; Alireza,12,0,15,3
1668247178461,MATH 202B,A00,098024,Rhoades; Brendon Patrick,9,0,15,6
1668247178883,MATH 203B,A00,098025,Oprea; Dragos N.,10,0,15,5
1668247179318,MATH 204B,A00,098026,Sorensen; Claus M,13,0,15,2
1668247179743,MATH 208,A00,098027,Izadi; Elham,7,0,10,3
1668247180170,MATH 209,A00,098028,Pollack; Aaron,10,0,10,0
1668247180599,MATH 211A,A00,112919,Rogalski; Daniel,9,0,10,1
1668247181025,MATH 211B,A00,112920,Seward; Brandon M.,9,0,10,1
1668247181451,MATH 218,A00,098029,Li; Bo,10,0,10,0
1668247181877,MATH 220B,A00,098030,Novak; Jonathan I,11,0,15,4
1668247182302,MATH 221A,A00,098031,Ebenfelt; Peter F,13,0,15,2
1668247182727,MATH 231B,A00,098032,Zlatos; Andrej,12,0,15,3
1668247183158,MATH 240B,A00,098033,Ni; Lei,9,0,15,6
1668247183593,MATH 243,A00,098034,Jekel; David Andrew,10,0,10,0
1668247184018,MATH 245A,A00,098035,Nie; Jiawang,0,0,15,16
1668247184442,MATH 248,A00,098036,Bejenaru; Ioan,10,0,10,0
1668247184871,MATH 250B,A00,098037,Spolaor; Luca,14,0,15,1
1668247185303,MATH 258,A00,098038,Ni; Lei,10,0,10,0
1668247185734,MATH 264B,A00,098041,Rhoades; Brendon Patrick,9,0,15,6
1668247186160,MATH 268,A00,098042,Buss; Samuel R,10,0,10,0
1668247186587,MATH 269,A00,098043,Rhoades; Brendon Patrick,10,0,10,0
1668247187015,MATH 270B,A00,098044,Li; Bo,10,0,15,5
1668247187441,MATH 272B,A00,098045,Holst; Michael J,13,0,15,2
1668247187869,MATH 273A,A00,098046,Tian; Xiaochuan,10,0,15,5
1668247188295,MATH 275,A01,098048,Tian; Xiaochuan,6,0,10,4
1668247188720,MATH 278A,A00,098049,Holst; Michael J,8,0,10,2
1668247189150,MATH 278B,A00,098050,Cloninger; Alexander,10,0,10,0
1668247189574,MATH 278C,A00,098051,Nie; Jiawang,7,0,10,3
1668247190006,MATH 280B,A00,098052,Zheng; Tianyi,9,0,15,6
1668247190440,MATH 281B,A00,098053,Bradic; Jelena,1,0,15,14
1668247190873,MATH 282B,A00,098054,Arias-Castro; Ery,0,0,15,15
1668247191301,MATH 285,A00,098055,Fitzsimmons; Patrick J,0,0,15,17
1668247191725,MATH 287B,A00,098056,Arias-Castro; Ery,2,0,15,13
1668247192151,MATH 288,A00,098057,Agarwal; Pooja,9,0,10,1
1668247192151,MATH 288,B00,098058,Zhang; Danna,8,0,10,2
1668247192151,MATH 288,C00,098059,Williams; Ruth J,10,0,10,0
1668247192576,MATH 290B,A00,098060,Roberts; Justin Deritter,13,0,15,2
1668247193000,MATH 292,A00,098061,Belmont; Eva Kinoshita,10,0,10,0
1668247193425,MATH 295,A00,098062,Suk; Andrew Hoon,48,0,50,2
1668247193853,MATH 296,A00,098063,Novak; Jonathan I,20,0,20,0
1668247194286,MATH 297,001,098064,Gamst; Anthony Collins,9997,0,9999,2
1668247696784,COGS 205,A00,101395,Chiba; Andrea,19,0,20,1
1668247697220,COGS 210B,001,101404,Greene; Deanna Jacquelyn,9998,0,9999,1
1668247697220,COGS 210B,002,101417,Xia; Haijun,9999,0,9999,0
1668247697220,COGS 210B,003,101422,Nitz; Douglas A.,9999,0,9999,0
1668247697220,COGS 210B,004,101423,Hollan; James D.,9998,0,9999,1
1668247697220,COGS 210B,005,101424,Deak; Gedeon O.,9998,0,9999,1
1668247697220,COGS 210B,006,101425,Rossano; Federico,9999,0,9999,0
1668247697652,COGS 211B,A00,101427,Coulson; Seana M,9996,0,9999,3
1668247698075,COGS 220,A00,101428,Hollan; James D.,0,0,25,25
1668247698502,COGS 229,A00,101429,Dow; Steven P,18,0,25,7
1668247698927,COGS 230,A00,101430,Klemmer; Scott R,12,0,17,5
1668247699361,COGS 234,A00,101431,Xia; Haijun,2,0,25,23
1668247699793,COGS 260,A00,101432,Kiyonaga; Anastasia,21,0,25,4
1668247699793,COGS 260,B00,101433,Kirsh; David Joel,15,0,25,10
1668247700225,CSE 202,A00,102371,Impagliazzo; Russell,0,0,0,0
1668247700666,CSE 203B,A01,102373,Cheng; Chung Kuan,0,0,0,0
1668247701098,CSE 208,A00,102374,Micciancio; Daniele,0,0,0,0
1668247701525,CSE 209A,A00,112895,Impagliazzo; Russell,0,0,15,15
1668247701955,CSE 209B,A00,108005,Bellare; Mihir,0,0,0,0
1668247702387,CSE 210,A00,113163,Coblenz; Michael J,0,0,0,0
1668247702812,CSE 219,A00,106111,Dow; Steven P,0,0,20,20
1668247703238,CSE 221,A00,102376,Voelker; Geoffrey M.,0,0,0,0
1668247703675,CSE 224,A01,102378,Porter; George M,0,0,0,0
1668247704103,CSE 229A,A00,102379,Savage; Stefan,0,0,0,0
1668247704535,CSE 229C,A00,102380,Munyaka; Imani N. S.,0,0,0,0
1668247704960,CSE 232B,A00,102382,Deutsch; Alin Bernard,0,0,0,0
1668247705386,CSE 234,A01,112904,Kumar; Arun Kumar,0,0,0,0
1668247705815,CSE 237A,A00,102383,Rosing; Tajana Simunic,0,0,0,0
1668247706254,CSE 239A,A00,102384,Deutsch; Alin Bernard,0,0,0,0
1668247706680,CSE 239B,A00,102385,Polikarpova; Nadezhda,0,0,0,0
1668247707108,CSE 240A,A00,102386,Pannuto; Patrick William,0,0,0,0
1668247707534,CSE 240B,A00,102387,Zhao; Jishen,0,0,0,0
1668247707983,CSE 241A,A00,106406,Kang; Mingu,0,0,0,0
1668247708406,CSE 249B,A00,102388,Kahng; Andrew Byun,0,0,8,8
1668247708840,CSE 251B,A01,102392,Cottrell; Garrison W,0,0,0,0
1668247708840,CSE 251B,A02,102393,Cottrell; Garrison W,0,0,0,0
1668247709274,CSE 252B,A00,102394,Ochoa; Benjamin Lawrence,0,0,0,0
1668247709697,CSE 257,A01,102396,Gao; Sicun,0,0,0,0
1668247710125,CSE 272,A00,102397,Li; Tzumao,0,0,0,0
1668247710552,CSE 274,A00,111323,Chern; Albert Ren-Haur,0,0,0,0
1668247710983,CSE 282,A00,102398,Pevzner; Pavel Arkadjevich,0,0,0,0
1668247711418,CSE 284,A00,114175,Gymrek; Melissa Ann,0,0,0,0
1668247711879,CSE 290,A00,102399,Chandraker; Manmohan Krishna,0,0,0,0
1668247711879,CSE 290,B00,102400,Vaccaro; Kristen Marie,0,0,25,25
1668247711879,CSE 290,C00,102414,Pannuto; Patrick William,0,0,25,25
1668247711879,CSE 290,D00,102427,Pevzner; Pavel Arkadjevich,0,0,0,0
1668247711879,CSE 290,E00,102429,Zhao; Jishen,0,0,0,0
1668247711879,CSE 290,F00,102436,Tullsen; Dean Michael,0,0,0,0
1668247711879,CSE 290,G00,102440,Christensen; Henrik I,0,0,20,20
1668247712312,CSE 291,A00,102443,Su; Hao,0,0,0,0
1668247712312,CSE 291,B00,102448,Polikarpova; Nadezhda,0,0,0,0
1668247712312,CSE 291,C00,102453,Vaccaro; Kristen Marie,0,0,0,0
1668247712312,CSE 291,D00,111343,Savage; Stefan,0,0,0,0
1668247712312,CSE 291,E00,116474,Claffy; Kimberly Claire,0,0,0,0
1668247712312,CSE 291,F00,116479,Pasquale; Joseph,0,0,0,0
1668247712761,CSE 293,001,119111,Bafna; Vineet,9999,0,9999,0
1668247712761,CSE 293,002,119118,Bellare; Mihir,9999,0,9999,0
1668247712761,CSE 293,003,119122,Berg-Kirkpatrick; Taylor D,9999,0,9999,0
1668247712761,CSE 293,004,119135,Christensen; Henrik I,9999,0,9999,0
1668247712761,CSE 293,005,119142,Cottrell; Garrison W,9999,0,9999,0
1668247712761,CSE 293,006,119146,Deutsch; Alin Bernard,9999,0,9999,0
1668247712761,CSE 293,007,119159,Esmaeilzadeh; Hadi,9999,0,9999,0
1668247712761,CSE 293,008,119166,Freund; Yoav,9999,0,9999,0
1668247712761,CSE 293,009,119170,Griswold; William G.,9999,0,9999,0
1668247712761,CSE 293,010,119183,Gymrek; Melissa Ann,9999,0,9999,0
1668247712761,CSE 293,011,119190,Heninger; Nadia A,9999,0,9999,0
1668247712761,CSE 293,012,119230,Impagliazzo; Russell,9999,0,9999,0
1668247712761,CSE 293,013,119232,Jhala; Ranjit,9999,0,9999,0
1668247712761,CSE 293,014,119233,Kahng; Andrew Byun,9999,0,9999,0
1668247712761,CSE 293,015,119298,Kane; Daniel Mertz,9999,0,9999,0
1668247712761,CSE 293,016,119299,Kriegman; David J,9999,0,9999,0
1668247712761,CSE 293,017,119300,Kumar; Arun Kumar,9999,0,9999,0
1668247712761,CSE 293,018,119301,Lerner; Sorin,9999,0,9999,0
1668247712761,CSE 293,019,119302,Lovett; Shachar,9999,0,9999,0
1668247712761,CSE 293,020,119303,McAuley; Julian John,9999,0,9999,0
1668247712761,CSE 293,021,119304,Micciancio; Daniele,9999,0,9999,0
1668247712761,CSE 293,022,119367,Orailoglu; Alex,9999,0,9999,0
1668247712761,CSE 293,023,119382,Paturi; Ramamohan,9999,0,9999,0
1668247712761,CSE 293,024,119404,Polikarpova; Nadezhda,9999,0,9999,0
1668247712761,CSE 293,025,119406,Politz; Joseph Gibbs,9999,0,9999,0
1668247712761,CSE 293,026,119411,Porter; George M,9999,0,9999,0
1668247712761,CSE 293,027,119414,Porter; Leonard Emerson,9999,0,9999,0
1668247712761,CSE 293,028,119416,Ramamoorthi; Ravi,9999,0,9999,0
1668247712761,CSE 293,029,119417,Sahoo; Debashis,9999,0,9999,0
1668247712761,CSE 293,030,119420,Saul; Lawrence,9999,0,9999,0
1668247712761,CSE 293,031,119421,Savage; Stefan,9999,0,9999,0
1668247712761,CSE 293,032,119425,Schulze; Jurgen P.,9999,0,9999,0
1668247712761,CSE 293,033,119426,Snoeren; Alex C.,9999,0,9999,0
1668247712761,CSE 293,034,119428,Shang; Jingbo,9999,0,9999,0
1668247712761,CSE 293,035,119430,Stefan; Deian,9999,0,9999,0
1668247712761,CSE 293,036,119431,Su; Hao,9999,0,9999,0
1668247712761,CSE 293,037,119433,Swanson; Steven James,9999,0,9999,0
1668247712761,CSE 293,038,119435,Tullsen; Dean Michael,9999,0,9999,0
1668247712761,CSE 293,039,119483,Voelker; Geoffrey M.,9999,0,9999,0
1668247712761,CSE 293,040,119537,Zhao; Jishen,9999,0,9999,0
1668247712761,CSE 293,041,119538,Zhou; Yuan-Yuan,9999,0,9999,0
1668247712761,CSE 293,042,119539,Gao; Sicun,9999,0,9999,0
1668247712761,CSE 293,043,119540,Weibel; Nadir,9999,0,9999,0
1668247712761,CSE 293,044,119541,Gupta; Rajesh K.,9999,0,9999,0
1668247712761,CSE 293,045,126410,Vaccaro; Kristen Marie,9999,0,9999,0
1668247712761,CSE 293,046,126411,Klemke; Richard,9999,0,9999,0
1668247713185,CSE 294,A00,102459,Voelker; Geoffrey M.,0,0,0,0
1668247713185,CSE 294,B00,111322,Orailoglu; Alex,0,0,0,0
1668247713609,DSE 201,A00,096914,Deutsch; Alin Bernard,30,0,30,0
1668247714038,DSE 210,A00,096915,Dasgupta; Sanjoy,30,0,30,0
1668247714469,DSE 260A,A00,096916,Altintas De Callaf; Ilkay,30,0,30,0
1668247714930,ECE 200,001,103586,Antipa; Nicholas A,9999,0,9999,0
1668247714930,ECE 200,002,103587,Atanasov; Nikolay A.,9999,0,9999,0
1668247714930,ECE 200,003,103588,Bharadia; Dinesh,9999,0,9999,0
1668247714930,ECE 200,004,103589,Cheng; Chung Kuan,9999,0,9999,0
1668247714930,ECE 200,005,103590,Cosman; Pamela C.,9999,0,9999,0
1668247714930,ECE 200,006,103591,Dayeh; Shadi Ahmad,9999,0,9999,0
1668247714930,ECE 200,007,103592,Fainman; Yeshaiahu,9999,0,9999,0
1668247714930,ECE 200,008,103593,Ford; Joseph Earl,9999,0,9999,0
1668247714930,ECE 200,009,103594,Franceschetti; Massimo,9999,0,9999,0
1668247714930,ECE 200,010,103595,Fullerton; Eric E,9999,0,9999,0
1668247714930,ECE 200,011,103596,Galton; Ian A,9999,0,9999,0
1668247714930,ECE 200,012,103597,Gilja; Vikash,9999,0,9999,0
1668247714930,ECE 200,013,103598,Hall; Drew A.,9999,0,9999,0
1668247714930,ECE 200,014,103599,Hsueh; Tzu-Chien,9999,0,9999,0
1668247714930,ECE 200,015,103600,Javidi; Tara,9999,0,9999,0
1668247714930,ECE 200,016,103601,Kahng; Andrew Byun,9999,0,9999,0
1668247714930,ECE 200,017,103602,Kim; Young-Han,9999,0,9999,0
1668247714930,ECE 200,018,103603,Koushanfar; Farinaz,9999,0,9999,0
1668247714930,ECE 200,019,103604,Kuzum; Duygu,9999,0,9999,0
1668247714930,ECE 200,020,103605,Le; Hanh-Phuc,9999,0,9999,0
1668247714930,ECE 200,021,103606,Lin; Bill,9999,0,9999,0
1668247714930,ECE 200,022,103607,Liu; Zhaowei,9998,0,9999,1
1668247714930,ECE 200,023,103608,Lo; Yu-Hwa,9999,0,9999,0
1668247714930,ECE 200,024,103609,Lomakin; Vitaliy,9999,0,9999,0
1668247714930,ECE 200,025,103610,Mercier; Patrick Philip,9999,0,9999,0
1668247714930,ECE 200,026,103611,Meyer; Florian,9999,0,9999,0
1668247714930,ECE 200,027,103612,Milstein; Laurence B.,9999,0,9999,0
1668247714930,ECE 200,028,103613,Mir Arabbaygi; Siavash,9999,0,9999,0
1668247714930,ECE 200,029,103614,Mookherjea; Shayan,9999,0,9999,0
1668247714930,ECE 200,030,103615,Morris; Karcher William,9999,0,9999,0
1668247714930,ECE 200,031,103616,Ng; Tse Nga,9999,0,9999,0
1668247714930,ECE 200,032,103617,Nguyen; Truong Quang,9999,0,9999,0
1668247714930,ECE 200,033,103618,Nomura; Kenji,9999,0,9999,0
1668247714930,ECE 200,034,103619,Orlitsky; Alon,9999,0,9999,0
1668247714930,ECE 200,035,103620,Pal; Piya,9999,0,9999,0
1668247714930,ECE 200,036,103621,Papen; George C.,9999,0,9999,0
1668247714930,ECE 200,037,103622,Radic; Stojan,9999,0,9999,0
1668247714930,ECE 200,038,103623,Rao; Bhaskar D.,9999,0,9999,0
1668247714930,ECE 200,039,103624,Rao; Ramesh R,9999,0,9999,0
1668247714930,ECE 200,040,103625,Rebeiz; Gabriel,9999,0,9999,0
1668247714930,ECE 200,041,103626,Sanford; John R,9999,0,9999,0
1668247714930,ECE 200,042,103627,Siegel; Paul H.,9999,0,9999,0
1668247714930,ECE 200,043,103628,Sievenpiper; Daniel F.,9999,0,9999,0
1668247714930,ECE 200,044,103629,Sworder; David D.,9999,0,9999,0
1668247714930,ECE 200,045,103630,Taur; Yuan,9999,0,9999,0
1668247714930,ECE 200,046,103631,Touri; Behrouz,9999,0,9999,0
1668247714930,ECE 200,047,103632,Trivedi; Mohan M.,9999,0,9999,0
1668247714930,ECE 200,048,103633,Vasconcelos; Nuno,9999,0,9999,0
1668247714930,ECE 200,049,103634,Wang; Xiaolong,9999,0,9999,0
1668247714930,ECE 200,050,103635,Xie; Pengtao,9999,0,9999,0
1668247714930,ECE 200,051,103636,Yip; Michael,9999,0,9999,0
1668247714930,ECE 200,052,103637,Zeger; Kenneth A.,999,0,999,0
1668247714930,ECE 200,053,103638,Zhang; Xinyu,9999,0,9999,0
1668247714930,ECE 200,054,103639,Turakhia; Yatish Girish,9999,0,9999,0
1668247714930,ECE 200,055,103640,Kang; Mingu,9999,0,9999,0
1668247714930,ECE 200,056,103641,Shi; Yuanyuan,9999,0,9999,0
1668247714930,ECE 200,057,103642,Wang; Edward Jay,9999,0,9999,0
1668247714930,ECE 200,058,103643,Zheng; Yang,9999,0,9999,0
1668247715356,ECE 202,A00,103644,Kuzum; Duygu,0,0,0,0
1668247715787,ECE 212BN,A00,103646,Ng; Tse Nga,0,0,0,0
1668247716213,ECE 221,A00,111493,Staff,0,0,0,0
1668247716638,ECE 222B,A00,103647,Lomakin; Vitaliy,0,0,0,0
1668247717071,ECE 230B,A00,103648,Taur; Yuan,0,0,0,0
1668247717502,ECE 238B,A00,103649,Garay; Javier,0,0,0,0
1668247717934,ECE 240B,A00,112900,Fainman; Yeshaiahu,0,0,0,0
1668247718358,ECE 247A,A00,103650,Jokerst; Jesse Vincent,0,0,0,0
1668247718784,ECE 247B,A00,103651,Wang; Joseph,0,0,0,0
1668247719218,ECE 250,A00,103652,Siegel; Paul H.,0,0,0,0
1668247719648,ECE 251A,A00,103654,Rao; Bhaskar D.,0,0,0,0
1668247720071,ECE 257B,A00,103655,Bharadia; Dinesh,0,0,0,0
1668247720496,ECE 258A,A00,103656,Milstein; Laurence B.,0,0,0,0
1668247720925,ECE 260B,A00,103658,Kang; Mingu,0,0,0,0
1668247721356,ECE 264A,A00,103659,Galton; Ian A,0,0,0,0
1668247721785,ECE 265A,A00,103661,Gudem; Prasad S.S.,0,0,0,0
1668247722211,ECE 265D,A00,103662,Gudem; Prasad S.S.,0,0,0,0
1668247722647,ECE 268,A00,103663,Koushanfar; Farinaz,0,0,0,0
1668247723085,ECE 269,A01,103665,Pal; Piya,0,0,0,0
1668247723516,ECE 271B,A00,103666,Vasconcelos; Manuela,0,0,0,0
1668247723940,ECE 276A,A00,103667,Atanasov; Nikolay A.,0,0,0,0
1668247724378,ECE 277,A00,103668,An; Cheolhong,0,0,0,0
1668247724809,ECE 279,A00,117947,Hall; Drew A.,0,0,0,0
1668247725683,ECE 283,A00,103670,Hsueh; Tzu-Chien,0,0,0,0
1668247726108,ECE 284,A00,103671,Turakhia; Yatish Girish,0,0,0,0
1668247726535,ECE 285,A00,103672,Zheng; Yang,0,0,0,0
1668247726535,ECE 285,B00,103673,Sworder; David D.,0,0,0,0
1668247726967,ECE 287,A00,103676,Javidi; Tara,0,0,0,0
1668247727400,MATH 200B,A00,098023,Salehi Golsefidy; Alireza,12,0,15,3
1668247727825,MATH 202B,A00,098024,Rhoades; Brendon Patrick,9,0,15,6
1668247728258,MATH 203B,A00,098025,Oprea; Dragos N.,10,0,15,5
1668247728682,MATH 204B,A00,098026,Sorensen; Claus M,13,0,15,2
1668247729105,MATH 208,A00,098027,Izadi; Elham,7,0,10,3
1668247729528,MATH 209,A00,098028,Pollack; Aaron,10,0,10,0
1668247729960,MATH 211A,A00,112919,Rogalski; Daniel,9,0,10,1
1668247730394,MATH 211B,A00,112920,Seward; Brandon M.,9,0,10,1
1668247730822,MATH 218,A00,098029,Li; Bo,10,0,10,0
1668247731249,MATH 220B,A00,098030,Novak; Jonathan I,11,0,15,4
1668247731676,MATH 221A,A00,098031,Ebenfelt; Peter F,13,0,15,2
1668247732099,MATH 231B,A00,098032,Zlatos; Andrej,12,0,15,3
1668247732533,MATH 240B,A00,098033,Ni; Lei,9,0,15,6
1668247732962,MATH 243,A00,098034,Jekel; David Andrew,10,0,10,0
1668247733394,MATH 245A,A00,098035,Nie; Jiawang,0,0,15,16
1668247733820,MATH 248,A00,098036,Bejenaru; Ioan,10,0,10,0
1668247734249,MATH 250B,A00,098037,Spolaor; Luca,14,0,15,1
1668247734675,MATH 258,A00,098038,Ni; Lei,10,0,10,0
1668247735099,MATH 264B,A00,098041,Rhoades; Brendon Patrick,9,0,15,6
1668247735527,MATH 268,A00,098042,Buss; Samuel R,10,0,10,0
1668247735980,MATH 269,A00,098043,Rhoades; Brendon Patrick,10,0,10,0
1668247736419,MATH 270B,A00,098044,Li; Bo,10,0,15,5
1668247736848,MATH 272B,A00,098045,Holst; Michael J,13,0,15,2
1668247737273,MATH 273A,A00,098046,Tian; Xiaochuan,10,0,15,5
1668247737700,MATH 275,A01,098048,Tian; Xiaochuan,6,0,10,4
1668247738127,MATH 278A,A00,098049,Holst; Michael J,8,0,10,2
1668247738550,MATH 278B,A00,098050,Cloninger; Alexander,10,0,10,0
1668247738974,MATH 278C,A00,098051,Nie; Jiawang,7,0,10,3
1668247739398,MATH 280B,A00,098052,Zheng; Tianyi,9,0,15,6
1668247739823,MATH 281B,A00,098053,Bradic; Jelena,1,0,15,14
1668247740338,MATH 282B,A00,098054,Arias-Castro; Ery,0,0,15,15
1668247740766,MATH 285,A00,098055,Fitzsimmons; Patrick J,0,0,15,17
1668247741191,MATH 287B,A00,098056,Arias-Castro; Ery,2,0,15,13
1668247741615,MATH 288,A00,098057,Agarwal; Pooja,9,0,10,1
1668247741615,MATH 288,B00,098058,Zhang; Danna,8,0,10,2
1668247741615,MATH 288,C00,098059,Williams; Ruth J,10,0,10,0
1668247742050,MATH 290B,A00,098060,Roberts; Justin Deritter,13,0,15,2
1668247742479,MATH 292,A00,098061,Belmont; Eva Kinoshita,10,0,10,0
1668247742904,MATH 295,A00,098062,Suk; Andrew Hoon,48,0,50,2
1668247743331,MATH 296,A00,098063,Novak; Jonathan I,20,0,20,0
1668247743755,MATH 297,001,098064,Gamst; Anthony Collins,9997,0,9999,2
1668248246058,COGS 205,A00,101395,Chiba; Andrea,19,0,20,1
1668248246493,COGS 210B,001,101404,Greene; Deanna Jacquelyn,9998,0,9999,1
1668248246493,COGS 210B,002,101417,Xia; Haijun,9999,0,9999,0
1668248246493,COGS 210B,003,101422,Nitz; Douglas A.,9999,0,9999,0
1668248246493,COGS 210B,004,101423,Hollan; James D.,9998,0,9999,1
1668248246493,COGS 210B,005,101424,Deak; Gedeon O.,9998,0,9999,1
1668248246493,COGS 210B,006,101425,Rossano; Federico,9999,0,9999,0
1668248246926,COGS 211B,A00,101427,Coulson; Seana M,9996,0,9999,3
1668248247360,COGS 220,A00,101428,Hollan; James D.,0,0,25,25
1668248247787,COGS 229,A00,101429,Dow; Steven P,18,0,25,7
1668248248211,COGS 230,A00,101430,Klemmer; Scott R,12,0,17,5
1668248248635,COGS 234,A00,101431,Xia; Haijun,2,0,25,23
1668248249058,COGS 260,A00,101432,Kiyonaga; Anastasia,21,0,25,4
1668248249058,COGS 260,B00,101433,Kirsh; David Joel,15,0,25,10
1668248249483,CSE 202,A00,102371,Impagliazzo; Russell,0,0,0,0
1668248249915,CSE 203B,A01,102373,Cheng; Chung Kuan,0,0,0,0
1668248250343,CSE 208,A00,102374,Micciancio; Daniele,0,0,0,0
1668248250774,CSE 209A,A00,112895,Impagliazzo; Russell,0,0,15,15
1668248251203,CSE 209B,A00,108005,Bellare; Mihir,0,0,0,0
1668248251627,CSE 210,A00,113163,Coblenz; Michael J,0,0,0,0
1668248252054,CSE 219,A00,106111,Dow; Steven P,0,0,20,20
1668248252478,CSE 221,A00,102376,Voelker; Geoffrey M.,0,0,0,0
1668248252906,CSE 224,A01,102378,Porter; George M,0,0,0,0
1668248253329,CSE 229A,A00,102379,Savage; Stefan,0,0,0,0
1668248253754,CSE 229C,A00,102380,Munyaka; Imani N. S.,0,0,0,0
1668248254180,CSE 232B,A00,102382,Deutsch; Alin Bernard,0,0,0,0
1668248254607,CSE 234,A01,112904,Kumar; Arun Kumar,0,0,0,0
1668248255035,CSE 237A,A00,102383,Rosing; Tajana Simunic,0,0,0,0
1668248255459,CSE 239A,A00,102384,Deutsch; Alin Bernard,0,0,0,0
1668248255882,CSE 239B,A00,102385,Polikarpova; Nadezhda,0,0,0,0
1668248256308,CSE 240A,A00,102386,Pannuto; Patrick William,0,0,0,0
1668248256737,CSE 240B,A00,102387,Zhao; Jishen,0,0,0,0
1668248257162,CSE 241A,A00,106406,Kang; Mingu,0,0,0,0
1668248257600,CSE 249B,A00,102388,Kahng; Andrew Byun,0,0,8,8
1668248258032,CSE 251B,A01,102392,Cottrell; Garrison W,0,0,0,0
1668248258032,CSE 251B,A02,102393,Cottrell; Garrison W,0,0,0,0
1668248258456,CSE 252B,A00,102394,Ochoa; Benjamin Lawrence,0,0,0,0
1668248258881,CSE 257,A01,102396,Gao; Sicun,0,0,0,0
1668248259305,CSE 272,A00,102397,Li; Tzumao,0,0,0,0
1668248259730,CSE 274,A00,111323,Chern; Albert Ren-Haur,0,0,0,0
1668248260179,CSE 282,A00,102398,Pevzner; Pavel Arkadjevich,0,0,0,0
1668248260611,CSE 284,A00,114175,Gymrek; Melissa Ann,0,0,0,0
1668248261039,CSE 290,A00,102399,Chandraker; Manmohan Krishna,0,0,0,0
1668248261039,CSE 290,B00,102400,Vaccaro; Kristen Marie,0,0,25,25
1668248261039,CSE 290,C00,102414,Pannuto; Patrick William,0,0,25,25
1668248261039,CSE 290,D00,102427,Pevzner; Pavel Arkadjevich,0,0,0,0
1668248261039,CSE 290,E00,102429,Zhao; Jishen,0,0,0,0
1668248261039,CSE 290,F00,102436,Tullsen; Dean Michael,0,0,0,0
1668248261039,CSE 290,G00,102440,Christensen; Henrik I,0,0,20,20
1668248261463,CSE 291,A00,102443,Su; Hao,0,0,0,0
1668248261463,CSE 291,B00,102448,Polikarpova; Nadezhda,0,0,0,0
1668248261463,CSE 291,C00,102453,Vaccaro; Kristen Marie,0,0,0,0
1668248261463,CSE 291,D00,111343,Savage; Stefan,0,0,0,0
1668248261463,CSE 291,E00,116474,Claffy; Kimberly Claire,0,0,0,0
1668248261463,CSE 291,F00,116479,Pasquale; Joseph,0,0,0,0
1668248261893,CSE 293,001,119111,Bafna; Vineet,9999,0,9999,0
1668248261893,CSE 293,002,119118,Bellare; Mihir,9999,0,9999,0
1668248261893,CSE 293,003,119122,Berg-Kirkpatrick; Taylor D,9999,0,9999,0
1668248261893,CSE 293,004,119135,Christensen; Henrik I,9999,0,9999,0
1668248261893,CSE 293,005,119142,Cottrell; Garrison W,9999,0,9999,0
1668248261893,CSE 293,006,119146,Deutsch; Alin Bernard,9999,0,9999,0
1668248261893,CSE 293,007,119159,Esmaeilzadeh; Hadi,9999,0,9999,0
1668248261893,CSE 293,008,119166,Freund; Yoav,9999,0,9999,0
1668248261893,CSE 293,009,119170,Griswold; William G.,9999,0,9999,0
1668248261893,CSE 293,010,119183,Gymrek; Melissa Ann,9999,0,9999,0
1668248261893,CSE 293,011,119190,Heninger; Nadia A,9999,0,9999,0
1668248261893,CSE 293,012,119230,Impagliazzo; Russell,9999,0,9999,0
1668248261893,CSE 293,013,119232,Jhala; Ranjit,9999,0,9999,0
1668248261893,CSE 293,014,119233,Kahng; Andrew Byun,9999,0,9999,0
1668248261893,CSE 293,015,119298,Kane; Daniel Mertz,9999,0,9999,0
1668248261893,CSE 293,016,119299,Kriegman; David J,9999,0,9999,0
1668248261893,CSE 293,017,119300,Kumar; Arun Kumar,9999,0,9999,0
1668248261893,CSE 293,018,119301,Lerner; Sorin,9999,0,9999,0
1668248261893,CSE 293,019,119302,Lovett; Shachar,9999,0,9999,0
1668248261893,CSE 293,020,119303,McAuley; Julian John,9999,0,9999,0
1668248261893,CSE 293,021,119304,Micciancio; Daniele,9999,0,9999,0
1668248261893,CSE 293,022,119367,Orailoglu; Alex,9999,0,9999,0
1668248261893,CSE 293,023,119382,Paturi; Ramamohan,9999,0,9999,0
1668248261893,CSE 293,024,119404,Polikarpova; Nadezhda,9999,0,9999,0
1668248261893,CSE 293,025,119406,Politz; Joseph Gibbs,9999,0,9999,0
1668248261893,CSE 293,026,119411,Porter; George M,9999,0,9999,0
1668248261893,CSE 293,027,119414,Porter; Leonard Emerson,9999,0,9999,0
1668248261893,CSE 293,028,119416,Ramamoorthi; Ravi,9999,0,9999,0
1668248261893,CSE 293,029,119417,Sahoo; Debashis,9999,0,9999,0
1668248261893,CSE 293,030,119420,Saul; Lawrence,9999,0,9999,0
1668248261893,CSE 293,031,119421,Savage; Stefan,9999,0,9999,0
1668248261893,CSE 293,032,119425,Schulze; Jurgen P.,9999,0,9999,0
1668248261893,CSE 293,033,119426,Snoeren; Alex C.,9999,0,9999,0
1668248261893,CSE 293,034,119428,Shang; Jingbo,9999,0,9999,0
1668248261893,CSE 293,035,119430,Stefan; Deian,9999,0,9999,0
1668248261893,CSE 293,036,119431,Su; Hao,9999,0,9999,0
1668248261893,CSE 293,037,119433,Swanson; Steven James,9999,0,9999,0
1668248261893,CSE 293,038,119435,Tullsen; Dean Michael,9999,0,9999,0
1668248261893,CSE 293,039,119483,Voelker; Geoffrey M.,9999,0,9999,0
1668248261893,CSE 293,040,119537,Zhao; Jishen,9999,0,9999,0
1668248261893,CSE 293,041,119538,Zhou; Yuan-Yuan,9999,0,9999,0
1668248261893,CSE 293,042,119539,Gao; Sicun,9999,0,9999,0
1668248261893,CSE 293,043,119540,Weibel; Nadir,9999,0,9999,0
1668248261893,CSE 293,044,119541,Gupta; Rajesh K.,9999,0,9999,0
1668248261893,CSE 293,045,126410,Vaccaro; Kristen Marie,9999,0,9999,0
1668248261893,CSE 293,046,126411,Klemke; Richard,9999,0,9999,0
1668248262317,CSE 294,A00,102459,Voelker; Geoffrey M.,0,0,0,0
1668248262317,CSE 294,B00,111322,Orailoglu; Alex,0,0,0,0
1668248262833,DSE 201,A00,096914,Deutsch; Alin Bernard,30,0,30,0
1668248263262,DSE 210,A00,096915,Dasgupta; Sanjoy,30,0,30,0
1668248263690,DSE 260A,A00,096916,Altintas De Callaf; Ilkay,30,0,30,0
1668248264158,ECE 200,001,103586,Antipa; Nicholas A,9999,0,9999,0
1668248264158,ECE 200,002,103587,Atanasov; Nikolay A.,9999,0,9999,0
1668248264158,ECE 200,003,103588,Bharadia; Dinesh,9999,0,9999,0
1668248264158,ECE 200,004,103589,Cheng; Chung Kuan,9999,0,9999,0
1668248264158,ECE 200,005,103590,Cosman; Pamela C.,9999,0,9999,0
1668248264158,ECE 200,006,103591,Dayeh; Shadi Ahmad,9999,0,9999,0
1668248264158,ECE 200,007,103592,Fainman; Yeshaiahu,9999,0,9999,0
1668248264158,ECE 200,008,103593,Ford; Joseph Earl,9999,0,9999,0
1668248264158,ECE 200,009,103594,Franceschetti; Massimo,9999,0,9999,0
1668248264158,ECE 200,010,103595,Fullerton; Eric E,9999,0,9999,0
1668248264158,ECE 200,011,103596,Galton; Ian A,9999,0,9999,0
1668248264158,ECE 200,012,103597,Gilja; Vikash,9999,0,9999,0
1668248264158,ECE 200,013,103598,Hall; Drew A.,9999,0,9999,0
1668248264158,ECE 200,014,103599,Hsueh; Tzu-Chien,9999,0,9999,0
1668248264158,ECE 200,015,103600,Javidi; Tara,9999,0,9999,0
1668248264158,ECE 200,016,103601,Kahng; Andrew Byun,9999,0,9999,0
1668248264158,ECE 200,017,103602,Kim; Young-Han,9999,0,9999,0
1668248264158,ECE 200,018,103603,Koushanfar; Farinaz,9999,0,9999,0
1668248264158,ECE 200,019,103604,Kuzum; Duygu,9999,0,9999,0
1668248264158,ECE 200,020,103605,Le; Hanh-Phuc,9999,0,9999,0
1668248264158,ECE 200,021,103606,Lin; Bill,9999,0,9999,0
1668248264158,ECE 200,022,103607,Liu; Zhaowei,9998,0,9999,1
1668248264158,ECE 200,023,103608,Lo; Yu-Hwa,9999,0,9999,0
1668248264158,ECE 200,024,103609,Lomakin; Vitaliy,9999,0,9999,0
1668248264158,ECE 200,025,103610,Mercier; Patrick Philip,9999,0,9999,0
1668248264158,ECE 200,026,103611,Meyer; Florian,9999,0,9999,0
1668248264158,ECE 200,027,103612,Milstein; Laurence B.,9999,0,9999,0
1668248264158,ECE 200,028,103613,Mir Arabbaygi; Siavash,9999,0,9999,0
1668248264158,ECE 200,029,103614,Mookherjea; Shayan,9999,0,9999,0
1668248264158,ECE 200,030,103615,Morris; Karcher William,9999,0,9999,0
1668248264158,ECE 200,031,103616,Ng; Tse Nga,9999,0,9999,0
1668248264158,ECE 200,032,103617,Nguyen; Truong Quang,9999,0,9999,0
1668248264158,ECE 200,033,103618,Nomura; Kenji,9999,0,9999,0
1668248264158,ECE 200,034,103619,Orlitsky; Alon,9999,0,9999,0
1668248264158,ECE 200,035,103620,Pal; Piya,9999,0,9999,0
1668248264158,ECE 200,036,103621,Papen; George C.,9999,0,9999,0
1668248264158,ECE 200,037,103622,Radic; Stojan,9999,0,9999,0
1668248264158,ECE 200,038,103623,Rao; Bhaskar D.,9999,0,9999,0
1668248264158,ECE 200,039,103624,Rao; Ramesh R,9999,0,9999,0
1668248264158,ECE 200,040,103625,Rebeiz; Gabriel,9999,0,9999,0
1668248264158,ECE 200,041,103626,Sanford; John R,9999,0,9999,0
1668248264158,ECE 200,042,103627,Siegel; Paul H.,9999,0,9999,0
1668248264158,ECE 200,043,103628,Sievenpiper; Daniel F.,9999,0,9999,0
1668248264158,ECE 200,044,103629,Sworder; David D.,9999,0,9999,0
1668248264158,ECE 200,045,103630,Taur; Yuan,9999,0,9999,0
1668248264158,ECE 200,046,103631,Touri; Behrouz,9999,0,9999,0
1668248264158,ECE 200,047,103632,Trivedi; Mohan M.,9999,0,9999,0
1668248264158,ECE 200,048,103633,Vasconcelos; Nuno,9999,0,9999,0
1668248264158,ECE 200,049,103634,Wang; Xiaolong,9999,0,9999,0
1668248264158,ECE 200,050,103635,Xie; Pengtao,9999,0,9999,0
1668248264158,ECE 200,051,103636,Yip; Michael,9999,0,9999,0
1668248264158,ECE 200,052,103637,Zeger; Kenneth A.,999,0,999,0
1668248264158,ECE 200,053,103638,Zhang; Xinyu,9999,0,9999,0
1668248264158,ECE 200,054,103639,Turakhia; Yatish Girish,9999,0,9999,0
1668248264158,ECE 200,055,103640,Kang; Mingu,9999,0,9999,0
1668248264158,ECE 200,056,103641,Shi; Yuanyuan,9999,0,9999,0
1668248264158,ECE 200,057,103642,Wang; Edward Jay,9999,0,9999,0
1668248264158,ECE 200,058,103643,Zheng; Yang,9999,0,9999,0
1668248264584,ECE 202,A00,103644,Kuzum; Duygu,0,0,0,0
1668248265017,ECE 212BN,A00,103646,Ng; Tse Nga,0,0,0,0
1668248265443,ECE 221,A00,111493,Staff,0,0,0,0
1668248265873,ECE 222B,A00,103647,Lomakin; Vitaliy,0,0,0,0
1668248266298,ECE 230B,A00,103648,Taur; Yuan,0,0,0,0
1668248266722,ECE 238B,A00,103649,Garay; Javier,0,0,0,0
1668248267146,ECE 240B,A00,112900,Fainman; Yeshaiahu,0,0,0,0
1668248267570,ECE 247A,A00,103650,Jokerst; Jesse Vincent,0,0,0,0
1668248267998,ECE 247B,A00,103651,Wang; Joseph,0,0,0,0
1668248268427,ECE 250,A00,103652,Siegel; Paul H.,0,0,0,0
1668248268851,ECE 251A,A00,103654,Rao; Bhaskar D.,0,0,0,0
1668248269279,ECE 257B,A00,103655,Bharadia; Dinesh,0,0,0,0
1668248269703,ECE 258A,A00,103656,Milstein; Laurence B.,0,0,0,0
1668248270139,ECE 260B,A00,103658,Kang; Mingu,0,0,0,0
1668248270564,ECE 264A,A00,103659,Galton; Ian A,0,0,0,0
1668248270988,ECE 265A,A00,103661,Gudem; Prasad S.S.,0,0,0,0
1668248271422,ECE 265D,A00,103662,Gudem; Prasad S.S.,0,0,0,0
1668248271844,ECE 268,A00,103663,Koushanfar; Farinaz,0,0,0,0
1668248272275,ECE 269,A01,103665,Pal; Piya,0,0,0,0
1668248272698,ECE 271B,A00,103666,Vasconcelos; Manuela,0,0,0,0
1668248273121,ECE 276A,A00,103667,Atanasov; Nikolay A.,0,0,0,0
1668248273545,ECE 277,A00,103668,An; Cheolhong,0,0,0,0
1668248273979,ECE 279,A00,117947,Hall; Drew A.,0,0,0,0
1668248274837,ECE 283,A00,103670,Hsueh; Tzu-Chien,0,0,0,0
1668248275266,ECE 284,A00,103671,Turakhia; Yatish Girish,0,0,0,0
1668248275690,ECE 285,A00,103672,Zheng; Yang,0,0,0,0
1668248275690,ECE 285,B00,103673,Sworder; David D.,0,0,0,0
1668248276114,ECE 287,A00,103676,Javidi; Tara,0,0,0,0
1668248276539,MATH 200B,A00,098023,Salehi Golsefidy; Alireza,12,0,15,3
1668248276978,MATH 202B,A00,098024,Rhoades; Brendon Patrick,9,0,15,6
1668248277404,MATH 203B,A00,098025,Oprea; Dragos N.,10,0,15,5
1668248277830,MATH 204B,A00,098026,Sorensen; Claus M,13,0,15,2
1668248278257,MATH 208,A00,098027,Izadi; Elham,7,0,10,3
1668248278683,MATH 209,A00,098028,Pollack; Aaron,10,0,10,0
1668248279107,MATH 211A,A00,112919,Rogalski; Daniel,9,0,10,1
1668248279533,MATH 211B,A00,112920,Seward; Brandon M.,9,0,10,1
1668248279959,MATH 218,A00,098029,Li; Bo,10,0,10,0
1668248280383,MATH 220B,A00,098030,Novak; Jonathan I,11,0,15,4
1668248280815,MATH 221A,A00,098031,Ebenfelt; Peter F,13,0,15,2
1668248281245,MATH 231B,A00,098032,Zlatos; Andrej,12,0,15,3
1668248281682,MATH 240B,A00,098033,Ni; Lei,9,0,15,6
1668248282107,MATH 243,A00,098034,Jekel; David Andrew,10,0,10,0
1668248282533,MATH 245A,A00,098035,Nie; Jiawang,0,0,15,16
1668248282958,MATH 248,A00,098036,Bejenaru; Ioan,10,0,10,0
1668248283389,MATH 250B,A00,098037,Spolaor; Luca,14,0,15,1
1668248283812,MATH 258,A00,098038,Ni; Lei,10,0,10,0
1668248284238,MATH 264B,A00,098041,Rhoades; Brendon Patrick,9,0,15,6
1668248284669,MATH 268,A00,098042,Buss; Samuel R,10,0,10,0
1668248285109,MATH 269,A00,098043,Rhoades; Brendon Patrick,10,0,10,0
1668248285531,MATH 270B,A00,098044,Li; Bo,10,0,15,5
1668248285965,MATH 272B,A00,098045,Holst; Michael J,13,0,15,2
1668248286405,MATH 273A,A00,098046,Tian; Xiaochuan,10,0,15,5
1668248286846,MATH 275,A01,098048,Tian; Xiaochuan,6,0,10,4
1668248287273,MATH 278A,A00,098049,Holst; Michael J,8,0,10,2
1668248287697,MATH 278B,A00,098050,Cloninger; Alexander,10,0,10,0
1668248288124,MATH 278C,A00,098051,Nie; Jiawang,7,0,10,3
1668248288552,MATH 280B,A00,098052,Zheng; Tianyi,9,0,15,6
1668248288975,MATH 281B,A00,098053,Bradic; Jelena,1,0,15,14
1668248289414,MATH 282B,A00,098054,Arias-Castro; Ery,0,0,15,15
1668248289842,MATH 285,A00,098055,Fitzsimmons; Patrick J,0,0,15,17
1668248290271,MATH 287B,A00,098056,Arias-Castro; Ery,2,0,15,13
1668248290694,MATH 288,A00,098057,Agarwal; Pooja,9,0,10,1
1668248290694,MATH 288,B00,098058,Zhang; Danna,8,0,10,2
1668248290694,MATH 288,C00,098059,Williams; Ruth J,10,0,10,0
1668248291118,MATH 290B,A00,098060,Roberts; Justin Deritter,13,0,15,2
1668248291543,MATH 292,A00,098061,Belmont; Eva Kinoshita,10,0,10,0
1668248291969,MATH 295,A00,098062,Suk; Andrew Hoon,48,0,50,2
1668248292400,MATH 296,A00,098063,Novak; Jonathan I,20,0,20,0
1668248292834,MATH 297,001,098064,Gamst; Anthony Collins,9997,0,9999,2
1668248794339,COGS 205,A00,101395,Chiba; Andrea,19,0,20,1
1668248794770,COGS 210B,001,101404,Greene; Deanna Jacquelyn,9998,0,9999,1
1668248794770,COGS 210B,002,101417,Xia; Haijun,9999,0,9999,0
1668248794770,COGS 210B,003,101422,Nitz; Douglas A.,9999,0,9999,0
1668248794770,COGS 210B,004,101423,Hollan; James D.,9998,0,9999,1
1668248794770,COGS 210B,005,101424,Deak; Gedeon O.,9998,0,9999,1
1668248794770,COGS 210B,006,101425,Rossano; Federico,9999,0,9999,0
1668248795196,COGS 211B,A00,101427,Coulson; Seana M,9996,0,9999,3
1668248795622,COGS 220,A00,101428,Hollan; James D.,0,0,25,25
1668248796046,COGS 229,A00,101429,Dow; Steven P,18,0,25,7
1668248796471,COGS 230,A00,101430,Klemmer; Scott R,12,0,17,5
1668248796895,COGS 234,A00,101431,Xia; Haijun,2,0,25,23
1668248797330,COGS 260,A00,101432,Kiyonaga; Anastasia,21,0,25,4
1668248797330,COGS 260,B00,101433,Kirsh; David Joel,15,0,25,10
1668248797754,CSE 202,A00,102371,Impagliazzo; Russell,0,0,0,0
1668248798180,CSE 203B,A01,102373,Cheng; Chung Kuan,0,0,0,0
1668248798609,CSE 208,A00,102374,Micciancio; Daniele,0,0,0,0
1668248799045,CSE 209A,A00,112895,Impagliazzo; Russell,0,0,15,15
1668248799472,CSE 209B,A00,108005,Bellare; Mihir,0,0,0,0
1668248799896,CSE 210,A00,113163,Coblenz; Michael J,0,0,0,0
1668248800324,CSE 219,A00,106111,Dow; Steven P,0,0,20,20
1668248800752,CSE 221,A00,102376,Voelker; Geoffrey M.,0,0,0,0
1668248801181,CSE 224,A01,102378,Porter; George M,0,0,0,0
1668248801604,CSE 229A,A00,102379,Savage; Stefan,0,0,0,0
1668248802030,CSE 229C,A00,102380,Munyaka; Imani N. S.,0,0,0,0
1668248802455,CSE 232B,A00,102382,Deutsch; Alin Bernard,0,0,0,0
1668248802885,CSE 234,A01,112904,Kumar; Arun Kumar,0,0,0,0
1668248803313,CSE 237A,A00,102383,Rosing; Tajana Simunic,0,0,0,0
1668248803740,CSE 239A,A00,102384,Deutsch; Alin Bernard,0,0,0,0
1668248804164,CSE 239B,A00,102385,Polikarpova; Nadezhda,0,0,0,0
1668248804590,CSE 240A,A00,102386,Pannuto; Patrick William,0,0,0,0
1668248805014,CSE 240B,A00,102387,Zhao; Jishen,0,0,0,0
1668248805448,CSE 241A,A00,106406,Kang; Mingu,0,0,0,0
1668248805876,CSE 249B,A00,102388,Kahng; Andrew Byun,0,0,8,8
1668248806302,CSE 251B,A01,102392,Cottrell; Garrison W,0,0,0,0
1668248806302,CSE 251B,A02,102393,Cottrell; Garrison W,0,0,0,0
1668248806727,CSE 252B,A00,102394,Ochoa; Benjamin Lawrence,0,0,0,0
1668248807154,CSE 257,A01,102396,Gao; Sicun,0,0,0,0
1668248807578,CSE 272,A00,102397,Li; Tzumao,0,0,0,0
1668248808003,CSE 274,A00,111323,Chern; Albert Ren-Haur,0,0,0,0
1668248808427,CSE 282,A00,102398,Pevzner; Pavel Arkadjevich,0,0,0,0
1668248808852,CSE 284,A00,114175,Gymrek; Melissa Ann,0,0,0,0
1668248809277,CSE 290,A00,102399,Chandraker; Manmohan Krishna,0,0,0,0
1668248809277,CSE 290,B00,102400,Vaccaro; Kristen Marie,0,0,25,25
1668248809277,CSE 290,C00,102414,Pannuto; Patrick William,0,0,25,25
1668248809277,CSE 290,D00,102427,Pevzner; Pavel Arkadjevich,0,0,0,0
1668248809277,CSE 290,E00,102429,Zhao; Jishen,0,0,0,0
1668248809277,CSE 290,F00,102436,Tullsen; Dean Michael,0,0,0,0
1668248809277,CSE 290,G00,102440,Christensen; Henrik I,0,0,20,20
1668248809706,CSE 291,A00,102443,Su; Hao,0,0,0,0
1668248809706,CSE 291,B00,102448,Polikarpova; Nadezhda,0,0,0,0
1668248809706,CSE 291,C00,102453,Vaccaro; Kristen Marie,0,0,0,0
1668248809706,CSE 291,D00,111343,Savage; Stefan,0,0,0,0
1668248809706,CSE 291,E00,116474,Claffy; Kimberly Claire,0,0,0,0
1668248809706,CSE 291,F00,116479,Pasquale; Joseph,0,0,0,0
1668248810146,CSE 293,001,119111,Bafna; Vineet,9999,0,9999,0
1668248810146,CSE 293,002,119118,Bellare; Mihir,9999,0,9999,0
1668248810146,CSE 293,003,119122,Berg-Kirkpatrick; Taylor D,9999,0,9999,0
1668248810146,CSE 293,004,119135,Christensen; Henrik I,9999,0,9999,0
1668248810146,CSE 293,005,119142,Cottrell; Garrison W,9999,0,9999,0
1668248810146,CSE 293,006,119146,Deutsch; Alin Bernard,9999,0,9999,0
1668248810146,CSE 293,007,119159,Esmaeilzadeh; Hadi,9999,0,9999,0
1668248810146,CSE 293,008,119166,Freund; Yoav,9999,0,9999,0
1668248810146,CSE 293,009,119170,Griswold; William G.,9999,0,9999,0
1668248810146,CSE 293,010,119183,Gymrek; Melissa Ann,9999,0,9999,0
1668248810146,CSE 293,011,119190,Heninger; Nadia A,9999,0,9999,0
1668248810146,CSE 293,012,119230,Impagliazzo; Russell,9999,0,9999,0
1668248810146,CSE 293,013,119232,Jhala; Ranjit,9999,0,9999,0
1668248810146,CSE 293,014,119233,Kahng; Andrew Byun,9999,0,9999,0
1668248810146,CSE 293,015,119298,Kane; Daniel Mertz,9999,0,9999,0
1668248810146,CSE 293,016,119299,Kriegman; David J,9999,0,9999,0
1668248810146,CSE 293,017,119300,Kumar; Arun Kumar,9999,0,9999,0
1668248810146,CSE 293,018,119301,Lerner; Sorin,9999,0,9999,0
1668248810146,CSE 293,019,119302,Lovett; Shachar,9999,0,9999,0
1668248810146,CSE 293,020,119303,McAuley; Julian John,9999,0,9999,0
1668248810146,CSE 293,021,119304,Micciancio; Daniele,9999,0,9999,0
1668248810146,CSE 293,022,119367,Orailoglu; Alex,9999,0,9999,0
1668248810146,CSE 293,023,119382,Paturi; Ramamohan,9999,0,9999,0
1668248810146,CSE 293,024,119404,Polikarpova; Nadezhda,9999,0,9999,0
1668248810146,CSE 293,025,119406,Politz; Joseph Gibbs,9999,0,9999,0
1668248810146,CSE 293,026,119411,Porter; George M,9999,0,9999,0
1668248810146,CSE 293,027,119414,Porter; Leonard Emerson,9999,0,9999,0
1668248810146,CSE 293,028,119416,Ramamoorthi; Ravi,9999,0,9999,0
1668248810146,CSE 293,029,119417,Sahoo; Debashis,9999,0,9999,0
1668248810146,CSE 293,030,119420,Saul; Lawrence,9999,0,9999,0
1668248810146,CSE 293,031,119421,Savage; Stefan,9999,0,9999,0
1668248810146,CSE 293,032,119425,Schulze; Jurgen P.,9999,0,9999,0
1668248810146,CSE 293,033,119426,Snoeren; Alex C.,9999,0,9999,0
1668248810146,CSE 293,034,119428,Shang; Jingbo,9999,0,9999,0
1668248810146,CSE 293,035,119430,Stefan; Deian,9999,0,9999,0
1668248810146,CSE 293,036,119431,Su; Hao,9999,0,9999,0
1668248810146,CSE 293,037,119433,Swanson; Steven James,9999,0,9999,0
1668248810146,CSE 293,038,119435,Tullsen; Dean Michael,9999,0,9999,0
1668248810146,CSE 293,039,119483,Voelker; Geoffrey M.,9999,0,9999,0
1668248810146,CSE 293,040,119537,Zhao; Jishen,9999,0,9999,0
1668248810146,CSE 293,041,119538,Zhou; Yuan-Yuan,9999,0,9999,0
1668248810146,CSE 293,042,119539,Gao; Sicun,9999,0,9999,0
1668248810146,CSE 293,043,119540,Weibel; Nadir,9999,0,9999,0
1668248810146,CSE 293,044,119541,Gupta; Rajesh K.,9999,0,9999,0
1668248810146,CSE 293,045,126410,Vaccaro; Kristen Marie,9999,0,9999,0
1668248810146,CSE 293,046,126411,Klemke; Richard,9999,0,9999,0
1668248810576,CSE 294,A00,102459,Voelker; Geoffrey M.,0,0,0,0
1668248810576,CSE 294,B00,111322,Orailoglu; Alex,0,0,0,0
1668248811006,DSE 201,A00,096914,Deutsch; Alin Bernard,30,0,30,0
1668248811436,DSE 210,A00,096915,Dasgupta; Sanjoy,30,0,30,0
1668248811867,DSE 260A,A00,096916,Altintas De Callaf; Ilkay,30,0,30,0
1668248812309,ECE 200,001,103586,Antipa; Nicholas A,9999,0,9999,0
1668248812309,ECE 200,002,103587,Atanasov; Nikolay A.,9999,0,9999,0
1668248812309,ECE 200,003,103588,Bharadia; Dinesh,9999,0,9999,0
1668248812309,ECE 200,004,103589,Cheng; Chung Kuan,9999,0,9999,0
1668248812309,ECE 200,005,103590,Cosman; Pamela C.,9999,0,9999,0
1668248812309,ECE 200,006,103591,Dayeh; Shadi Ahmad,9999,0,9999,0
1668248812309,ECE 200,007,103592,Fainman; Yeshaiahu,9999,0,9999,0
1668248812309,ECE 200,008,103593,Ford; Joseph Earl,9999,0,9999,0
1668248812309,ECE 200,009,103594,Franceschetti; Massimo,9999,0,9999,0
1668248812309,ECE 200,010,103595,Fullerton; Eric E,9999,0,9999,0
1668248812309,ECE 200,011,103596,Galton; Ian A,9999,0,9999,0
1668248812309,ECE 200,012,103597,Gilja; Vikash,9999,0,9999,0
1668248812309,ECE 200,013,103598,Hall; Drew A.,9999,0,9999,0
1668248812309,ECE 200,014,103599,Hsueh; Tzu-Chien,9999,0,9999,0
1668248812309,ECE 200,015,103600,Javidi; Tara,9999,0,9999,0
1668248812309,ECE 200,016,103601,Kahng; Andrew Byun,9999,0,9999,0
1668248812309,ECE 200,017,103602,Kim; Young-Han,9999,0,9999,0
1668248812309,ECE 200,018,103603,Koushanfar; Farinaz,9999,0,9999,0
1668248812309,ECE 200,019,103604,Kuzum; Duygu,9999,0,9999,0
1668248812309,ECE 200,020,103605,Le; Hanh-Phuc,9999,0,9999,0
1668248812309,ECE 200,021,103606,Lin; Bill,9999,0,9999,0
1668248812309,ECE 200,022,103607,Liu; Zhaowei,9998,0,9999,1
1668248812309,ECE 200,023,103608,Lo; Yu-Hwa,9999,0,9999,0
1668248812309,ECE 200,024,103609,Lomakin; Vitaliy,9999,0,9999,0
1668248812309,ECE 200,025,103610,Mercier; Patrick Philip,9999,0,9999,0
1668248812309,ECE 200,026,103611,Meyer; Florian,9999,0,9999,0
1668248812309,ECE 200,027,103612,Milstein; Laurence B.,9999,0,9999,0
1668248812309,ECE 200,028,103613,Mir Arabbaygi; Siavash,9999,0,9999,0
1668248812309,ECE 200,029,103614,Mookherjea; Shayan,9999,0,9999,0
1668248812309,ECE 200,030,103615,Morris; Karcher William,9999,0,9999,0
1668248812309,ECE 200,031,103616,Ng; Tse Nga,9999,0,9999,0
1668248812309,ECE 200,032,103617,Nguyen; Truong Quang,9999,0,9999,0
1668248812309,ECE 200,033,103618,Nomura; Kenji,9999,0,9999,0
1668248812309,ECE 200,034,103619,Orlitsky; Alon,9999,0,9999,0
1668248812309,ECE 200,035,103620,Pal; Piya,9999,0,9999,0
1668248812309,ECE 200,036,103621,Papen; George C.,9999,0,9999,0
1668248812309,ECE 200,037,103622,Radic; Stojan,9999,0,9999,0
1668248812309,ECE 200,038,103623,Rao; Bhaskar D.,9999,0,9999,0
1668248812309,ECE 200,039,103624,Rao; Ramesh R,9999,0,9999,0
1668248812309,ECE 200,040,103625,Rebeiz; Gabriel,9999,0,9999,0
1668248812309,ECE 200,041,103626,Sanford; John R,9999,0,9999,0
1668248812309,ECE 200,042,103627,Siegel; Paul H.,9999,0,9999,0
1668248812309,ECE 200,043,103628,Sievenpiper; Daniel F.,9999,0,9999,0
1668248812309,ECE 200,044,103629,Sworder; David D.,9999,0,9999,0
1668248812309,ECE 200,045,103630,Taur; Yuan,9999,0,9999,0
1668248812309,ECE 200,046,103631,Touri; Behrouz,9999,0,9999,0
1668248812309,ECE 200,047,103632,Trivedi; Mohan M.,9999,0,9999,0
1668248812309,ECE 200,048,103633,Vasconcelos; Nuno,9999,0,9999,0
1668248812309,ECE 200,049,103634,Wang; Xiaolong,9999,0,9999,0
1668248812309,ECE 200,050,103635,Xie; Pengtao,9999,0,9999,0
1668248812309,ECE 200,051,103636,Yip; Michael,9999,0,9999,0
1668248812309,ECE 200,052,103637,Zeger; Kenneth A.,999,0,999,0
1668248812309,ECE 200,053,103638,Zhang; Xinyu,9999,0,9999,0
1668248812309,ECE 200,054,103639,Turakhia; Yatish Girish,9999,0,9999,0
1668248812309,ECE 200,055,103640,Kang; Mingu,9999,0,9999,0
1668248812309,ECE 200,056,103641,Shi; Yuanyuan,9999,0,9999,0
1668248812309,ECE 200,057,103642,Wang; Edward Jay,9999,0,9999,0
1668248812309,ECE 200,058,103643,Zheng; Yang,9999,0,9999,0
1668248812747,ECE 202,A00,103644,Kuzum; Duygu,0,0,0,0
1668248813170,ECE 212BN,A00,103646,Ng; Tse Nga,0,0,0,0
1668248813603,ECE 221,A00,111493,Staff,0,0,0,0
1668248814040,ECE 222B,A00,103647,Lomakin; Vitaliy,0,0,0,0
1668248814475,ECE 230B,A00,103648,Taur; Yuan,0,0,0,0
1668248814914,ECE 238B,A00,103649,Garay; Javier,0,0,0,0
1668248815343,ECE 240B,A00,112900,Fainman; Yeshaiahu,0,0,0,0
1668248815772,ECE 247A,A00,103650,Jokerst; Jesse Vincent,0,0,0,0
1668248816196,ECE 247B,A00,103651,Wang; Joseph,0,0,0,0
1668248816624,ECE 250,A00,103652,Siegel; Paul H.,0,0,0,0
1668248817050,ECE 251A,A00,103654,Rao; Bhaskar D.,0,0,0,0
1668248817474,ECE 257B,A00,103655,Bharadia; Dinesh,0,0,0,0
1668248817901,ECE 258A,A00,103656,Milstein; Laurence B.,0,0,0,0
1668248818325,ECE 260B,A00,103658,Kang; Mingu,0,0,0,0
1668248818755,ECE 264A,A00,103659,Galton; Ian A,0,0,0,0
1668248819187,ECE 265A,A00,103661,Gudem; Prasad S.S.,0,0,0,0
1668248819613,ECE 265D,A00,103662,Gudem; Prasad S.S.,0,0,0,0
1668248820038,ECE 268,A00,103663,Koushanfar; Farinaz,0,0,0,0
1668248820465,ECE 269,A01,103665,Pal; Piya,0,0,0,0
1668248820893,ECE 271B,A00,103666,Vasconcelos; Manuela,0,0,0,0
1668248821316,ECE 276A,A00,103667,Atanasov; Nikolay A.,0,0,0,0
1668248821747,ECE 277,A00,103668,An; Cheolhong,0,0,0,0
1668248822173,ECE 279,A00,117947,Hall; Drew A.,0,0,0,0
1668248823023,ECE 283,A00,103670,Hsueh; Tzu-Chien,0,0,0,0
1668248823446,ECE 284,A00,103671,Turakhia; Yatish Girish,0,0,0,0
1668248823874,ECE 285,A00,103672,Zheng; Yang,0,0,0,0
1668248823874,ECE 285,B00,103673,Sworder; David D.,0,0,0,0
1668248824299,ECE 287,A00,103676,Javidi; Tara,0,0,0,0
1668248824724,MATH 200B,A00,098023,Salehi Golsefidy; Alireza,12,0,15,3
1668248825147,MATH 202B,A00,098024,Rhoades; Brendon Patrick,9,0,15,6
1668248825570,MATH 203B,A00,098025,Oprea; Dragos N.,10,0,15,5
1668248825999,MATH 204B,A00,098026,Sorensen; Claus M,13,0,15,2
1668248826422,MATH 208,A00,098027,Izadi; Elham,7,0,10,3
1668248826847,MATH 209,A00,098028,Pollack; Aaron,10,0,10,0
1668248827270,MATH 211A,A00,112919,Rogalski; Daniel,9,0,10,1
1668248827784,MATH 211B,A00,112920,Seward; Brandon M.,9,0,10,1
1668248828207,MATH 218,A00,098029,Li; Bo,10,0,10,0
1668248828631,MATH 220B,A00,098030,Novak; Jonathan I,11,0,15,4
1668248829055,MATH 221A,A00,098031,Ebenfelt; Peter F,13,0,15,2
1668248829490,MATH 231B,A00,098032,Zlatos; Andrej,12,0,15,3
1668248829918,MATH 240B,A00,098033,Ni; Lei,9,0,15,6
1668248830342,MATH 243,A00,098034,Jekel; David Andrew,10,0,10,0
1668248830769,MATH 245A,A00,098035,Nie; Jiawang,0,0,15,16
1668248831201,MATH 248,A00,098036,Bejenaru; Ioan,10,0,10,0
1668248831627,MATH 250B,A00,098037,Spolaor; Luca,14,0,15,1
1668248832050,MATH 258,A00,098038,Ni; Lei,10,0,10,0
1668248832475,MATH 264B,A00,098041,Rhoades; Brendon Patrick,9,0,15,6
1668248832897,MATH 268,A00,098042,Buss; Samuel R,10,0,10,0
1668248833332,MATH 269,A00,098043,Rhoades; Brendon Patrick,10,0,10,0
1668248833764,MATH 270B,A00,098044,Li; Bo,10,0,15,5
1668248834200,MATH 272B,A00,098045,Holst; Michael J,13,0,15,2
1668248834625,MATH 273A,A00,098046,Tian; Xiaochuan,10,0,15,5
1668248835054,MATH 275,A01,098048,Tian; Xiaochuan,6,0,10,4
1668248835492,MATH 278A,A00,098049,Holst; Michael J,8,0,10,2
1668248835919,MATH 278B,A00,098050,Cloninger; Alexander,10,0,10,0
1668248836349,MATH 278C,A00,098051,Nie; Jiawang,7,0,10,3
1668248836775,MATH 280B,A00,098052,Zheng; Tianyi,9,0,15,6
1668248837200,MATH 281B,A00,098053,Bradic; Jelena,1,0,15,14
1668248837624,MATH 282B,A00,098054,Arias-Castro; Ery,0,0,15,15
1668248838052,MATH 285,A00,098055,Fitzsimmons; Patrick J,0,0,15,17
1668248838487,MATH 287B,A00,098056,Arias-Castro; Ery,2,0,15,13
1668248838912,MATH 288,A00,098057,Agarwal; Pooja,9,0,10,1
1668248838912,MATH 288,B00,098058,Zhang; Danna,8,0,10,2
1668248838912,MATH 288,C00,098059,Williams; Ruth J,10,0,10,0
1668248839341,MATH 290B,A00,098060,Roberts; Justin Deritter,13,0,15,2
1668248839766,MATH 292,A00,098061,Belmont; Eva Kinoshita,10,0,10,0
1668248840191,MATH 295,A00,098062,Suk; Andrew Hoon,48,0,50,2
1668248840614,MATH 296,A00,098063,Novak; Jonathan I,20,0,20,0
1668248841040,MATH 297,001,098064,Gamst; Anthony Collins,9997,0,9999,2
1668249342193,COGS 205,A00,101395,Chiba; Andrea,19,0,20,1
1668249342619,COGS 210B,001,101404,Greene; Deanna Jacquelyn,9998,0,9999,1
1668249342619,COGS 210B,002,101417,Xia; Haijun,9999,0,9999,0
1668249342619,COGS 210B,003,101422,Nitz; Douglas A.,9999,0,9999,0
1668249342619,COGS 210B,004,101423,Hollan; James D.,9998,0,9999,1
1668249342619,COGS 210B,005,101424,Deak; Gedeon O.,9998,0,9999,1
1668249342619,COGS 210B,006,101425,Rossano; Federico,9999,0,9999,0
1668249343054,COGS 211B,A00,101427,Coulson; Seana M,9996,0,9999,3
1668249343476,COGS 220,A00,101428,Hollan; James D.,0,0,25,25
1668249343899,COGS 229,A00,101429,Dow; Steven P,18,0,25,7
1668249344324,COGS 230,A00,101430,Klemmer; Scott R,12,0,17,5
1668249344748,COGS 234,A00,101431,Xia; Haijun,2,0,25,23
1668249345176,COGS 260,A00,101432,Kiyonaga; Anastasia,21,0,25,4
1668249345176,COGS 260,B00,101433,Kirsh; David Joel,15,0,25,10
1668249345600,CSE 202,A00,102371,Impagliazzo; Russell,0,0,0,0
1668249346023,CSE 203B,A01,102373,Cheng; Chung Kuan,0,0,0,0
1668249346450,CSE 208,A00,102374,Micciancio; Daniele,0,0,0,0
1668249346879,CSE 209A,A00,112895,Impagliazzo; Russell,0,0,15,15
1668249347308,CSE 209B,A00,108005,Bellare; Mihir,0,0,0,0
1668249347734,CSE 210,A00,113163,Coblenz; Michael J,0,0,0,0
1668249348158,CSE 219,A00,106111,Dow; Steven P,0,0,20,20
1668249348585,CSE 221,A00,102376,Voelker; Geoffrey M.,0,0,0,0
1668249349089,CSE 224,A01,102378,Porter; George M,0,0,0,0
1668249349514,CSE 229A,A00,102379,Savage; Stefan,0,0,0,0
1668249349945,CSE 229C,A00,102380,Munyaka; Imani N. S.,0,0,0,0
1668249350375,CSE 232B,A00,102382,Deutsch; Alin Bernard,0,0,0,0
1668249350802,CSE 234,A01,112904,Kumar; Arun Kumar,0,0,0,0
1668249351233,CSE 237A,A00,102383,Rosing; Tajana Simunic,0,0,0,0
1668249351673,CSE 239A,A00,102384,Deutsch; Alin Bernard,0,0,0,0
1668249352102,CSE 239B,A00,102385,Polikarpova; Nadezhda,0,0,0,0
1668249352530,CSE 240A,A00,102386,Pannuto; Patrick William,0,0,0,0
1668249352962,CSE 240B,A00,102387,Zhao; Jishen,0,0,0,0
1668249353398,CSE 241A,A00,106406,Kang; Mingu,0,0,0,0
1668249353834,CSE 249B,A00,102388,Kahng; Andrew Byun,0,0,8,8
1668249354259,CSE 251B,A01,102392,Cottrell; Garrison W,0,0,0,0
1668249354259,CSE 251B,A02,102393,Cottrell; Garrison W,0,0,0,0
1668249354691,CSE 252B,A00,102394,Ochoa; Benjamin Lawrence,0,0,0,0
1668249355121,CSE 257,A01,102396,Gao; Sicun,0,0,0,0
1668249355545,CSE 272,A00,102397,Li; Tzumao,0,0,0,0
1668249355968,CSE 274,A00,111323,Chern; Albert Ren-Haur,0,0,0,0
1668249356396,CSE 282,A00,102398,Pevzner; Pavel Arkadjevich,0,0,0,0
1668249356820,CSE 284,A00,114175,Gymrek; Melissa Ann,0,0,0,0
1668249357245,CSE 290,A00,102399,Chandraker; Manmohan Krishna,0,0,0,0
1668249357245,CSE 290,B00,102400,Vaccaro; Kristen Marie,0,0,25,25
1668249357245,CSE 290,C00,102414,Pannuto; Patrick William,0,0,25,25
1668249357245,CSE 290,D00,102427,Pevzner; Pavel Arkadjevich,0,0,0,0
1668249357245,CSE 290,E00,102429,Zhao; Jishen,0,0,0,0
1668249357245,CSE 290,F00,102436,Tullsen; Dean Michael,0,0,0,0
1668249357245,CSE 290,G00,102440,Christensen; Henrik I,0,0,20,20
1668249357678,CSE 291,A00,102443,Su; Hao,0,0,0,0
1668249357678,CSE 291,B00,102448,Polikarpova; Nadezhda,0,0,0,0
1668249357678,CSE 291,C00,102453,Vaccaro; Kristen Marie,0,0,0,0
1668249357678,CSE 291,D00,111343,Savage; Stefan,0,0,0,0
1668249357678,CSE 291,E00,116474,Claffy; Kimberly Claire,0,0,0,0
1668249357678,CSE 291,F00,116479,Pasquale; Joseph,0,0,0,0
1668249358111,CSE 293,001,119111,Bafna; Vineet,9999,0,9999,0
1668249358111,CSE 293,002,119118,Bellare; Mihir,9999,0,9999,0
1668249358111,CSE 293,003,119122,Berg-Kirkpatrick; Taylor D,9999,0,9999,0
1668249358111,CSE 293,004,119135,Christensen; Henrik I,9999,0,9999,0
1668249358111,CSE 293,005,119142,Cottrell; Garrison W,9999,0,9999,0
1668249358111,CSE 293,006,119146,Deutsch; Alin Bernard,9999,0,9999,0
1668249358111,CSE 293,007,119159,Esmaeilzadeh; Hadi,9999,0,9999,0
1668249358111,CSE 293,008,119166,Freund; Yoav,9999,0,9999,0
1668249358111,CSE 293,009,119170,Griswold; William G.,9999,0,9999,0
1668249358111,CSE 293,010,119183,Gymrek; Melissa Ann,9999,0,9999,0
1668249358111,CSE 293,011,119190,Heninger; Nadia A,9999,0,9999,0
1668249358111,CSE 293,012,119230,Impagliazzo; Russell,9999,0,9999,0
1668249358111,CSE 293,013,119232,Jhala; Ranjit,9999,0,9999,0
1668249358111,CSE 293,014,119233,Kahng; Andrew Byun,9999,0,9999,0
1668249358111,CSE 293,015,119298,Kane; Daniel Mertz,9999,0,9999,0
1668249358111,CSE 293,016,119299,Kriegman; David J,9999,0,9999,0
1668249358111,CSE 293,017,119300,Kumar; Arun Kumar,9999,0,9999,0
1668249358111,CSE 293,018,119301,Lerner; Sorin,9999,0,9999,0
1668249358111,CSE 293,019,119302,Lovett; Shachar,9999,0,9999,0
1668249358111,CSE 293,020,119303,McAuley; Julian John,9999,0,9999,0
1668249358111,CSE 293,021,119304,Micciancio; Daniele,9999,0,9999,0
1668249358111,CSE 293,022,119367,Orailoglu; Alex,9999,0,9999,0
1668249358111,CSE 293,023,119382,Paturi; Ramamohan,9999,0,9999,0
1668249358111,CSE 293,024,119404,Polikarpova; Nadezhda,9999,0,9999,0
1668249358111,CSE 293,025,119406,Politz; Joseph Gibbs,9999,0,9999,0
1668249358111,CSE 293,026,119411,Porter; George M,9999,0,9999,0
1668249358111,CSE 293,027,119414,Porter; Leonard Emerson,9999,0,9999,0
1668249358111,CSE 293,028,119416,Ramamoorthi; Ravi,9999,0,9999,0
1668249358111,CSE 293,029,119417,Sahoo; Debashis,9999,0,9999,0
1668249358111,CSE 293,030,119420,Saul; Lawrence,9999,0,9999,0
1668249358111,CSE 293,031,119421,Savage; Stefan,9999,0,9999,0
1668249358111,CSE 293,032,119425,Schulze; Jurgen P.,9999,0,9999,0
1668249358111,CSE 293,033,119426,Snoeren; Alex C.,9999,0,9999,0
1668249358111,CSE 293,034,119428,Shang; Jingbo,9999,0,9999,0
1668249358111,CSE 293,035,119430,Stefan; Deian,9999,0,9999,0
1668249358111,CSE 293,036,119431,Su; Hao,9999,0,9999,0
1668249358111,CSE 293,037,119433,Swanson; Steven James,9999,0,9999,0
1668249358111,CSE 293,038,119435,Tullsen; Dean Michael,9999,0,9999,0
1668249358111,CSE 293,039,119483,Voelker; Geoffrey M.,9999,0,9999,0
1668249358111,CSE 293,040,119537,Zhao; Jishen,9999,0,9999,0
1668249358111,CSE 293,041,119538,Zhou; Yuan-Yuan,9999,0,9999,0
1668249358111,CSE 293,042,119539,Gao; Sicun,9999,0,9999,0
1668249358111,CSE 293,043,119540,Weibel; Nadir,9999,0,9999,0
1668249358111,CSE 293,044,119541,Gupta; Rajesh K.,9999,0,9999,0
1668249358111,CSE 293,045,126410,Vaccaro; Kristen Marie,9999,0,9999,0
1668249358111,CSE 293,046,126411,Klemke; Richard,9999,0,9999,0
1668249358539,CSE 294,A00,102459,Voelker; Geoffrey M.,0,0,0,0
1668249358539,CSE 294,B00,111322,Orailoglu; Alex,0,0,0,0
1668249358964,DSE 201,A00,096914,Deutsch; Alin Bernard,30,0,30,0
1668249359387,DSE 210,A00,096915,Dasgupta; Sanjoy,30,0,30,0
1668249359820,DSE 260A,A00,096916,Altintas De Callaf; Ilkay,30,0,30,0
1668249360259,ECE 200,001,103586,Antipa; Nicholas A,9999,0,9999,0
1668249360259,ECE 200,002,103587,Atanasov; Nikolay A.,9999,0,9999,0
1668249360259,ECE 200,003,103588,Bharadia; Dinesh,9999,0,9999,0
1668249360259,ECE 200,004,103589,Cheng; Chung Kuan,9999,0,9999,0
1668249360259,ECE 200,005,103590,Cosman; Pamela C.,9999,0,9999,0
1668249360259,ECE 200,006,103591,Dayeh; Shadi Ahmad,9999,0,9999,0
1668249360259,ECE 200,007,103592,Fainman; Yeshaiahu,9999,0,9999,0
1668249360259,ECE 200,008,103593,Ford; Joseph Earl,9999,0,9999,0
1668249360259,ECE 200,009,103594,Franceschetti; Massimo,9999,0,9999,0
1668249360259,ECE 200,010,103595,Fullerton; Eric E,9999,0,9999,0
1668249360259,ECE 200,011,103596,Galton; Ian A,9999,0,9999,0
1668249360259,ECE 200,012,103597,Gilja; Vikash,9999,0,9999,0
1668249360259,ECE 200,013,103598,Hall; Drew A.,9999,0,9999,0
1668249360259,ECE 200,014,103599,Hsueh; Tzu-Chien,9999,0,9999,0
1668249360259,ECE 200,015,103600,Javidi; Tara,9999,0,9999,0
1668249360259,ECE 200,016,103601,Kahng; Andrew Byun,9999,0,9999,0
1668249360259,ECE 200,017,103602,Kim; Young-Han,9999,0,9999,0
1668249360259,ECE 200,018,103603,Koushanfar; Farinaz,9999,0,9999,0
1668249360259,ECE 200,019,103604,Kuzum; Duygu,9999,0,9999,0
1668249360259,ECE 200,020,103605,Le; Hanh-Phuc,9999,0,9999,0
1668249360259,ECE 200,021,103606,Lin; Bill,9999,0,9999,0
1668249360259,ECE 200,022,103607,Liu; Zhaowei,9998,0,9999,1
1668249360259,ECE 200,023,103608,Lo; Yu-Hwa,9999,0,9999,0
1668249360259,ECE 200,024,103609,Lomakin; Vitaliy,9999,0,9999,0
1668249360259,ECE 200,025,103610,Mercier; Patrick Philip,9999,0,9999,0
1668249360259,ECE 200,026,103611,Meyer; Florian,9999,0,9999,0
1668249360259,ECE 200,027,103612,Milstein; Laurence B.,9999,0,9999,0
1668249360259,ECE 200,028,103613,Mir Arabbaygi; Siavash,9999,0,9999,0
1668249360259,ECE 200,029,103614,Mookherjea; Shayan,9999,0,9999,0
1668249360259,ECE 200,030,103615,Morris; Karcher William,9999,0,9999,0
1668249360259,ECE 200,031,103616,Ng; Tse Nga,9999,0,9999,0
1668249360259,ECE 200,032,103617,Nguyen; Truong Quang,9999,0,9999,0
1668249360259,ECE 200,033,103618,Nomura; Kenji,9999,0,9999,0
1668249360259,ECE 200,034,103619,Orlitsky; Alon,9999,0,9999,0
1668249360259,ECE 200,035,103620,Pal; Piya,9999,0,9999,0
1668249360259,ECE 200,036,103621,Papen; George C.,9999,0,9999,0
1668249360259,ECE 200,037,103622,Radic; Stojan,9999,0,9999,0
1668249360259,ECE 200,038,103623,Rao; Bhaskar D.,9999,0,9999,0
1668249360259,ECE 200,039,103624,Rao; Ramesh R,9999,0,9999,0
1668249360259,ECE 200,040,103625,Rebeiz; Gabriel,9999,0,9999,0
1668249360259,ECE 200,041,103626,Sanford; John R,9999,0,9999,0
1668249360259,ECE 200,042,103627,Siegel; Paul H.,9999,0,9999,0
1668249360259,ECE 200,043,103628,Sievenpiper; Daniel F.,9999,0,9999,0
1668249360259,ECE 200,044,103629,Sworder; David D.,9999,0,9999,0
1668249360259,ECE 200,045,103630,Taur; Yuan,9999,0,9999,0
1668249360259,ECE 200,046,103631,Touri; Behrouz,9999,0,9999,0
1668249360259,ECE 200,047,103632,Trivedi; Mohan M.,9999,0,9999,0
1668249360259,ECE 200,048,103633,Vasconcelos; Nuno,9999,0,9999,0
1668249360259,ECE 200,049,103634,Wang; Xiaolong,9999,0,9999,0
1668249360259,ECE 200,050,103635,Xie; Pengtao,9999,0,9999,0
1668249360259,ECE 200,051,103636,Yip; Michael,9999,0,9999,0
1668249360259,ECE 200,052,103637,Zeger; Kenneth A.,999,0,999,0
1668249360259,ECE 200,053,103638,Zhang; Xinyu,9999,0,9999,0
1668249360259,ECE 200,054,103639,Turakhia; Yatish Girish,9999,0,9999,0
1668249360259,ECE 200,055,103640,Kang; Mingu,9999,0,9999,0
1668249360259,ECE 200,056,103641,Shi; Yuanyuan,9999,0,9999,0
1668249360259,ECE 200,057,103642,Wang; Edward Jay,9999,0,9999,0
1668249360259,ECE 200,058,103643,Zheng; Yang,9999,0,9999,0
1668249360686,ECE 202,A00,103644,Kuzum; Duygu,0,0,0,0
1668249361111,ECE 212BN,A00,103646,Ng; Tse Nga,0,0,0,0
1668249361538,ECE 221,A00,111493,Staff,0,0,0,0
1668249361963,ECE 222B,A00,103647,Lomakin; Vitaliy,0,0,0,0
1668249362388,ECE 230B,A00,103648,Taur; Yuan,0,0,0,0
1668249362818,ECE 238B,A00,103649,Garay; Javier,0,0,0,0
1668249363241,ECE 240B,A00,112900,Fainman; Yeshaiahu,0,0,0,0
1668249363666,ECE 247A,A00,103650,Jokerst; Jesse Vincent,0,0,0,0
1668249364092,ECE 247B,A00,103651,Wang; Joseph,0,0,0,0
1668249364515,ECE 250,A00,103652,Siegel; Paul H.,0,0,0,0
1668249364942,ECE 251A,A00,103654,Rao; Bhaskar D.,0,0,0,0
1668249365366,ECE 257B,A00,103655,Bharadia; Dinesh,0,0,0,0
1668249365794,ECE 258A,A00,103656,Milstein; Laurence B.,0,0,0,0
1668249366218,ECE 260B,A00,103658,Kang; Mingu,0,0,0,0
1668249366644,ECE 264A,A00,103659,Galton; Ian A,0,0,0,0
1668249367070,ECE 265A,A00,103661,Gudem; Prasad S.S.,0,0,0,0
1668249367495,ECE 265D,A00,103662,Gudem; Prasad S.S.,0,0,0,0
1668249367918,ECE 268,A00,103663,Koushanfar; Farinaz,0,0,0,0
1668249368345,ECE 269,A01,103665,Pal; Piya,0,0,0,0
1668249368768,ECE 271B,A00,103666,Vasconcelos; Manuela,0,0,0,0
1668249369192,ECE 276A,A00,103667,Atanasov; Nikolay A.,0,0,0,0
1668249369614,ECE 277,A00,103668,An; Cheolhong,0,0,0,0
1668249370038,ECE 279,A00,117947,Hall; Drew A.,0,0,0,0
1668249370891,ECE 283,A00,103670,Hsueh; Tzu-Chien,0,0,0,0
1668249371320,ECE 284,A00,103671,Turakhia; Yatish Girish,0,0,0,0
1668249371747,ECE 285,A00,103672,Zheng; Yang,0,0,0,0
1668249371747,ECE 285,B00,103673,Sworder; David D.,0,0,0,0
1668249372174,ECE 287,A00,103676,Javidi; Tara,0,0,0,0
1668249372599,MATH 200B,A00,098023,Salehi Golsefidy; Alireza,12,0,15,3
1668249373022,MATH 202B,A00,098024,Rhoades; Brendon Patrick,9,0,15,6
1668249373446,MATH 203B,A00,098025,Oprea; Dragos N.,10,0,15,5
1668249373870,MATH 204B,A00,098026,Sorensen; Claus M,13,0,15,2
1668249374299,MATH 208,A00,098027,Izadi; Elham,7,0,10,3
1668249374725,MATH 209,A00,098028,Pollack; Aaron,10,0,10,0
1668249375151,MATH 211A,A00,112919,Rogalski; Daniel,9,0,10,1
1668249375576,MATH 211B,A00,112920,Seward; Brandon M.,9,0,10,1
1668249376008,MATH 218,A00,098029,Li; Bo,10,0,10,0
1668249376436,MATH 220B,A00,098030,Novak; Jonathan I,11,0,15,4
1668249376863,MATH 221A,A00,098031,Ebenfelt; Peter F,13,0,15,2
1668249377287,MATH 231B,A00,098032,Zlatos; Andrej,12,0,15,3
1668249377713,MATH 240B,A00,098033,Ni; Lei,9,0,15,6
1668249378136,MATH 243,A00,098034,Jekel; David Andrew,10,0,10,0
1668249378558,MATH 245A,A00,098035,Nie; Jiawang,0,0,15,16
1668249378980,MATH 248,A00,098036,Bejenaru; Ioan,10,0,10,0
1668249379416,MATH 250B,A00,098037,Spolaor; Luca,14,0,15,1
1668249379847,MATH 258,A00,098038,Ni; Lei,10,0,10,0
1668249380274,MATH 264B,A00,098041,Rhoades; Brendon Patrick,9,0,15,6
1668249380703,MATH 268,A00,098042,Buss; Samuel R,10,0,10,0
1668249381125,MATH 269,A00,098043,Rhoades; Brendon Patrick,10,0,10,0
1668249381547,MATH 270B,A00,098044,Li; Bo,10,0,15,5
1668249381972,MATH 272B,A00,098045,Holst; Michael J,13,0,15,2
1668249382409,MATH 273A,A00,098046,Tian; Xiaochuan,10,0,15,5
1668249382840,MATH 275,A01,098048,Tian; Xiaochuan,6,0,10,4
1668249383266,MATH 278A,A00,098049,Holst; Michael J,8,0,10,2
1668249383691,MATH 278B,A00,098050,Cloninger; Alexander,10,0,10,0
1668249384114,MATH 278C,A00,098051,Nie; Jiawang,7,0,10,3
1668249384537,MATH 280B,A00,098052,Zheng; Tianyi,9,0,15,6
1668249384965,MATH 281B,A00,098053,Bradic; Jelena,1,0,15,14
1668249385388,MATH 282B,A00,098054,Arias-Castro; Ery,0,0,15,15
1668249385817,MATH 285,A00,098055,Fitzsimmons; Patrick J,0,0,15,17
1668249386243,MATH 287B,A00,098056,Arias-Castro; Ery,2,0,15,13
1668249386666,MATH 288,A00,098057,Agarwal; Pooja,9,0,10,1
1668249386666,MATH 288,B00,098058,Zhang; Danna,8,0,10,2
1668249386666,MATH 288,C00,098059,Williams; Ruth J,10,0,10,0
1668249387099,MATH 290B,A00,098060,Roberts; Justin Deritter,13,0,15,2
1668249387527,MATH 292,A00,098061,Belmont; Eva Kinoshita,10,0,10,0
1668249387950,MATH 295,A00,098062,Suk; Andrew Hoon,48,0,50,2
1668249388376,MATH 296,A00,098063,Novak; Jonathan I,20,0,20,0
1668249388800,MATH 297,001,098064,Gamst; Anthony Collins,9997,0,9999,2
1668249889845,COGS 205,A00,101395,Chiba; Andrea,19,0,20,1
1668249890274,COGS 210B,001,101404,Greene; Deanna Jacquelyn,9998,0,9999,1
1668249890274,COGS 210B,002,101417,Xia; Haijun,9999,0,9999,0
1668249890274,COGS 210B,003,101422,Nitz; Douglas A.,9999,0,9999,0
1668249890274,COGS 210B,004,101423,Hollan; James D.,9998,0,9999,1
1668249890274,COGS 210B,005,101424,Deak; Gedeon O.,9998,0,9999,1
1668249890274,COGS 210B,006,101425,Rossano; Federico,9999,0,9999,0
1668249890710,COGS 211B,A00,101427,Coulson; Seana M,9996,0,9999,3
1668249891137,COGS 220,A00,101428,Hollan; James D.,0,0,25,25
1668249891559,COGS 229,A00,101429,Dow; Steven P,18,0,25,7
1668249891984,COGS 230,A00,101430,Klemmer; Scott R,12,0,17,5
1668249892406,COGS 234,A00,101431,Xia; Haijun,2,0,25,23
1668249892832,COGS 260,A00,101432,Kiyonaga; Anastasia,21,0,25,4
1668249892832,COGS 260,B00,101433,Kirsh; David Joel,15,0,25,10
1668249893257,CSE 202,A00,102371,Impagliazzo; Russell,0,0,0,0
1668249893698,CSE 203B,A01,102373,Cheng; Chung Kuan,0,0,0,0
1668249894136,CSE 208,A00,102374,Micciancio; Daniele,0,0,0,0
1668249894561,CSE 209A,A00,112895,Impagliazzo; Russell,0,0,15,15
1668249894984,CSE 209B,A00,108005,Bellare; Mihir,0,0,0,0
1668249895409,CSE 210,A00,113163,Coblenz; Michael J,0,0,0,0
1668249895832,CSE 219,A00,106111,Dow; Steven P,0,0,20,20
1668249896257,CSE 221,A00,102376,Voelker; Geoffrey M.,0,0,0,0
1668249896682,CSE 224,A01,102378,Porter; George M,0,0,0,0
1668249897109,CSE 229A,A00,102379,Savage; Stefan,0,0,0,0
1668249897534,CSE 229C,A00,102380,Munyaka; Imani N. S.,0,0,0,0
1668249897958,CSE 232B,A00,102382,Deutsch; Alin Bernard,0,0,0,0
1668249898381,CSE 234,A01,112904,Kumar; Arun Kumar,0,0,0,0
1668249898804,CSE 237A,A00,102383,Rosing; Tajana Simunic,0,0,0,0
1668249899232,CSE 239A,A00,102384,Deutsch; Alin Bernard,0,0,0,0
1668249899658,CSE 239B,A00,102385,Polikarpova; Nadezhda,0,0,0,0
1668249900082,CSE 240A,A00,102386,Pannuto; Patrick William,0,0,0,0
1668249900505,CSE 240B,A00,102387,Zhao; Jishen,0,0,0,0
1668249900929,CSE 241A,A00,106406,Kang; Mingu,0,0,0,0
1668249901353,CSE 249B,A00,102388,Kahng; Andrew Byun,0,0,8,8
1668249901781,CSE 251B,A01,102392,Cottrell; Garrison W,0,0,0,0
1668249901781,CSE 251B,A02,102393,Cottrell; Garrison W,0,0,0,0
1668249902205,CSE 252B,A00,102394,Ochoa; Benjamin Lawrence,0,0,0,0
1668249902628,CSE 257,A01,102396,Gao; Sicun,0,0,0,0
1668249903051,CSE 272,A00,102397,Li; Tzumao,0,0,0,0
1668249903476,CSE 274,A00,111323,Chern; Albert Ren-Haur,0,0,0,0
1668249903907,CSE 282,A00,102398,Pevzner; Pavel Arkadjevich,0,0,0,0
1668249904330,CSE 284,A00,114175,Gymrek; Melissa Ann,0,0,0,0
1668249904756,CSE 290,A00,102399,Chandraker; Manmohan Krishna,0,0,0,0
1668249904756,CSE 290,B00,102400,Vaccaro; Kristen Marie,0,0,25,25
1668249904756,CSE 290,C00,102414,Pannuto; Patrick William,0,0,25,25
1668249904756,CSE 290,D00,102427,Pevzner; Pavel Arkadjevich,0,0,0,0
1668249904756,CSE 290,E00,102429,Zhao; Jishen,0,0,0,0
1668249904756,CSE 290,F00,102436,Tullsen; Dean Michael,0,0,0,0
1668249904756,CSE 290,G00,102440,Christensen; Henrik I,0,0,20,20
1668249905181,CSE 291,A00,102443,Su; Hao,0,0,0,0
1668249905181,CSE 291,B00,102448,Polikarpova; Nadezhda,0,0,0,0
1668249905181,CSE 291,C00,102453,Vaccaro; Kristen Marie,0,0,0,0
1668249905181,CSE 291,D00,111343,Savage; Stefan,0,0,0,0
1668249905181,CSE 291,E00,116474,Claffy; Kimberly Claire,0,0,0,0
1668249905181,CSE 291,F00,116479,Pasquale; Joseph,0,0,0,0
1668249905624,CSE 293,001,119111,Bafna; Vineet,9999,0,9999,0
1668249905624,CSE 293,002,119118,Bellare; Mihir,9999,0,9999,0
1668249905624,CSE 293,003,119122,Berg-Kirkpatrick; Taylor D,9999,0,9999,0
1668249905624,CSE 293,004,119135,Christensen; Henrik I,9999,0,9999,0
1668249905624,CSE 293,005,119142,Cottrell; Garrison W,9999,0,9999,0
1668249905624,CSE 293,006,119146,Deutsch; Alin Bernard,9999,0,9999,0
1668249905624,CSE 293,007,119159,Esmaeilzadeh; Hadi,9999,0,9999,0
1668249905624,CSE 293,008,119166,Freund; Yoav,9999,0,9999,0
1668249905624,CSE 293,009,119170,Griswold; William G.,9999,0,9999,0
1668249905624,CSE 293,010,119183,Gymrek; Melissa Ann,9999,0,9999,0
1668249905624,CSE 293,011,119190,Heninger; Nadia A,9999,0,9999,0
1668249905624,CSE 293,012,119230,Impagliazzo; Russell,9999,0,9999,0
1668249905624,CSE 293,013,119232,Jhala; Ranjit,9999,0,9999,0
1668249905624,CSE 293,014,119233,Kahng; Andrew Byun,9999,0,9999,0
1668249905624,CSE 293,015,119298,Kane; Daniel Mertz,9999,0,9999,0
1668249905624,CSE 293,016,119299,Kriegman; David J,9999,0,9999,0
1668249905624,CSE 293,017,119300,Kumar; Arun Kumar,9999,0,9999,0
1668249905624,CSE 293,018,119301,Lerner; Sorin,9999,0,9999,0
1668249905624,CSE 293,019,119302,Lovett; Shachar,9999,0,9999,0
1668249905624,CSE 293,020,119303,McAuley; Julian John,9999,0,9999,0
1668249905624,CSE 293,021,119304,Micciancio; Daniele,9999,0,9999,0
1668249905624,CSE 293,022,119367,Orailoglu; Alex,9999,0,9999,0
1668249905624,CSE 293,023,119382,Paturi; Ramamohan,9999,0,9999,0
1668249905624,CSE 293,024,119404,Polikarpova; Nadezhda,9999,0,9999,0
1668249905624,CSE 293,025,119406,Politz; Joseph Gibbs,9999,0,9999,0
1668249905624,CSE 293,026,119411,Porter; George M,9999,0,9999,0
1668249905624,CSE 293,027,119414,Porter; Leonard Emerson,9999,0,9999,0
1668249905624,CSE 293,028,119416,Ramamoorthi; Ravi,9999,0,9999,0
1668249905624,CSE 293,029,119417,Sahoo; Debashis,9999,0,9999,0
1668249905624,CSE 293,030,119420,Saul; Lawrence,9999,0,9999,0
1668249905624,CSE 293,031,119421,Savage; Stefan,9999,0,9999,0
1668249905624,CSE 293,032,119425,Schulze; Jurgen P.,9999,0,9999,0
1668249905624,CSE 293,033,119426,Snoeren; Alex C.,9999,0,9999,0
1668249905624,CSE 293,034,119428,Shang; Jingbo,9999,0,9999,0
1668249905624,CSE 293,035,119430,Stefan; Deian,9999,0,9999,0
1668249905624,CSE 293,036,119431,Su; Hao,9999,0,9999,0
1668249905624,CSE 293,037,119433,Swanson; Steven James,9999,0,9999,0
1668249905624,CSE 293,038,119435,Tullsen; Dean Michael,9999,0,9999,0
1668249905624,CSE 293,039,119483,Voelker; Geoffrey M.,9999,0,9999,0
1668249905624,CSE 293,040,119537,Zhao; Jishen,9999,0,9999,0
1668249905624,CSE 293,041,119538,Zhou; Yuan-Yuan,9999,0,9999,0
1668249905624,CSE 293,042,119539,Gao; Sicun,9999,0,9999,0
1668249905624,CSE 293,043,119540,Weibel; Nadir,9999,0,9999,0
1668249905624,CSE 293,044,119541,Gupta; Rajesh K.,9999,0,9999,0
1668249905624,CSE 293,045,126410,Vaccaro; Kristen Marie,9999,0,9999,0
1668249905624,CSE 293,046,126411,Klemke; Richard,9999,0,9999,0
1668249906050,CSE 294,A00,102459,Voelker; Geoffrey M.,0,0,0,0
1668249906050,CSE 294,B00,111322,Orailoglu; Alex,0,0,0,0
1668249906474,DSE 201,A00,096914,Deutsch; Alin Bernard,30,0,30,0
1668249906901,DSE 210,A00,096915,Dasgupta; Sanjoy,30,0,30,0
1668249907324,DSE 260A,A00,096916,Altintas De Callaf; Ilkay,30,0,30,0
1668249907765,ECE 200,001,103586,Antipa; Nicholas A,9999,0,9999,0
1668249907765,ECE 200,002,103587,Atanasov; Nikolay A.,9999,0,9999,0
1668249907765,ECE 200,003,103588,Bharadia; Dinesh,9999,0,9999,0
1668249907765,ECE 200,004,103589,Cheng; Chung Kuan,9999,0,9999,0
1668249907765,ECE 200,005,103590,Cosman; Pamela C.,9999,0,9999,0
1668249907765,ECE 200,006,103591,Dayeh; Shadi Ahmad,9999,0,9999,0
1668249907765,ECE 200,007,103592,Fainman; Yeshaiahu,9999,0,9999,0
1668249907765,ECE 200,008,103593,Ford; Joseph Earl,9999,0,9999,0
1668249907765,ECE 200,009,103594,Franceschetti; Massimo,9999,0,9999,0
1668249907765,ECE 200,010,103595,Fullerton; Eric E,9999,0,9999,0
1668249907765,ECE 200,011,103596,Galton; Ian A,9999,0,9999,0
1668249907765,ECE 200,012,103597,Gilja; Vikash,9999,0,9999,0
1668249907765,ECE 200,013,103598,Hall; Drew A.,9999,0,9999,0
1668249907765,ECE 200,014,103599,Hsueh; Tzu-Chien,9999,0,9999,0
1668249907765,ECE 200,015,103600,Javidi; Tara,9999,0,9999,0
1668249907765,ECE 200,016,103601,Kahng; Andrew Byun,9999,0,9999,0
1668249907765,ECE 200,017,103602,Kim; Young-Han,9999,0,9999,0
1668249907765,ECE 200,018,103603,Koushanfar; Farinaz,9999,0,9999,0
1668249907765,ECE 200,019,103604,Kuzum; Duygu,9999,0,9999,0
1668249907765,ECE 200,020,103605,Le; Hanh-Phuc,9999,0,9999,0
1668249907765,ECE 200,021,103606,Lin; Bill,9999,0,9999,0
1668249907765,ECE 200,022,103607,Liu; Zhaowei,9998,0,9999,1
1668249907765,ECE 200,023,103608,Lo; Yu-Hwa,9999,0,9999,0
1668249907765,ECE 200,024,103609,Lomakin; Vitaliy,9999,0,9999,0
1668249907765,ECE 200,025,103610,Mercier; Patrick Philip,9999,0,9999,0
1668249907765,ECE 200,026,103611,Meyer; Florian,9999,0,9999,0
1668249907765,ECE 200,027,103612,Milstein; Laurence B.,9999,0,9999,0
1668249907765,ECE 200,028,103613,Mir Arabbaygi; Siavash,9999,0,9999,0
1668249907765,ECE 200,029,103614,Mookherjea; Shayan,9999,0,9999,0
1668249907765,ECE 200,030,103615,Morris; Karcher William,9999,0,9999,0
1668249907765,ECE 200,031,103616,Ng; Tse Nga,9999,0,9999,0
1668249907765,ECE 200,032,103617,Nguyen; Truong Quang,9999,0,9999,0
1668249907765,ECE 200,033,103618,Nomura; Kenji,9999,0,9999,0
1668249907765,ECE 200,034,103619,Orlitsky; Alon,9999,0,9999,0
1668249907765,ECE 200,035,103620,Pal; Piya,9999,0,9999,0
1668249907765,ECE 200,036,103621,Papen; George C.,9999,0,9999,0
1668249907765,ECE 200,037,103622,Radic; Stojan,9999,0,9999,0
1668249907765,ECE 200,038,103623,Rao; Bhaskar D.,9999,0,9999,0
1668249907765,ECE 200,039,103624,Rao; Ramesh R,9999,0,9999,0
1668249907765,ECE 200,040,103625,Rebeiz; Gabriel,9999,0,9999,0
1668249907765,ECE 200,041,103626,Sanford; John R,9999,0,9999,0
1668249907765,ECE 200,042,103627,Siegel; Paul H.,9999,0,9999,0
1668249907765,ECE 200,043,103628,Sievenpiper; Daniel F.,9999,0,9999,0
1668249907765,ECE 200,044,103629,Sworder; David D.,9999,0,9999,0
1668249907765,ECE 200,045,103630,Taur; Yuan,9999,0,9999,0
1668249907765,ECE 200,046,103631,Touri; Behrouz,9999,0,9999,0
1668249907765,ECE 200,047,103632,Trivedi; Mohan M.,9999,0,9999,0
1668249907765,ECE 200,048,103633,Vasconcelos; Nuno,9999,0,9999,0
1668249907765,ECE 200,049,103634,Wang; Xiaolong,9999,0,9999,0
1668249907765,ECE 200,050,103635,Xie; Pengtao,9999,0,9999,0
1668249907765,ECE 200,051,103636,Yip; Michael,9999,0,9999,0
1668249907765,ECE 200,052,103637,Zeger; Kenneth A.,999,0,999,0
1668249907765,ECE 200,053,103638,Zhang; Xinyu,9999,0,9999,0
1668249907765,ECE 200,054,103639,Turakhia; Yatish Girish,9999,0,9999,0
1668249907765,ECE 200,055,103640,Kang; Mingu,9999,0,9999,0
1668249907765,ECE 200,056,103641,Shi; Yuanyuan,9999,0,9999,0
1668249907765,ECE 200,057,103642,Wang; Edward Jay,9999,0,9999,0
1668249907765,ECE 200,058,103643,Zheng; Yang,9999,0,9999,0
1668249908188,ECE 202,A00,103644,Kuzum; Duygu,0,0,0,0
1668249908615,ECE 212BN,A00,103646,Ng; Tse Nga,0,0,0,0
1668249909043,ECE 221,A00,111493,Staff,0,0,0,0
1668249909471,ECE 222B,A00,103647,Lomakin; Vitaliy,0,0,0,0
1668249909898,ECE 230B,A00,103648,Taur; Yuan,0,0,0,0
1668249910322,ECE 238B,A00,103649,Garay; Javier,0,0,0,0
1668249910746,ECE 240B,A00,112900,Fainman; Yeshaiahu,0,0,0,0
1668249911171,ECE 247A,A00,103650,Jokerst; Jesse Vincent,0,0,0,0
1668249911598,ECE 247B,A00,103651,Wang; Joseph,0,0,0,0
1668249912023,ECE 250,A00,103652,Siegel; Paul H.,0,0,0,0
1668249912448,ECE 251A,A00,103654,Rao; Bhaskar D.,0,0,0,0
1668249912875,ECE 257B,A00,103655,Bharadia; Dinesh,0,0,0,0
1668249913402,ECE 258A,A00,103656,Milstein; Laurence B.,0,0,0,0
1668249913824,ECE 260B,A00,103658,Kang; Mingu,0,0,0,0
1668249914247,ECE 264A,A00,103659,Galton; Ian A,0,0,0,0
1668249914681,ECE 265A,A00,103661,Gudem; Prasad S.S.,0,0,0,0
1668249915103,ECE 265D,A00,103662,Gudem; Prasad S.S.,0,0,0,0
1668249915527,ECE 268,A00,103663,Koushanfar; Farinaz,0,0,0,0
1668249915951,ECE 269,A01,103665,Pal; Piya,0,0,0,0
1668249916380,ECE 271B,A00,103666,Vasconcelos; Manuela,0,0,0,0
1668249916806,ECE 276A,A00,103667,Atanasov; Nikolay A.,0,0,0,0
1668249917229,ECE 277,A00,103668,An; Cheolhong,0,0,0,0
1668249917655,ECE 279,A00,117947,Hall; Drew A.,0,0,0,0
1668249918506,ECE 283,A00,103670,Hsueh; Tzu-Chien,0,0,0,0
1668249918930,ECE 284,A00,103671,Turakhia; Yatish Girish,0,0,0,0
1668249919353,ECE 285,A00,103672,Zheng; Yang,0,0,0,0
1668249919353,ECE 285,B00,103673,Sworder; David D.,0,0,0,0
1668249919776,ECE 287,A00,103676,Javidi; Tara,0,0,0,0
1668249920199,MATH 200B,A00,098023,Salehi Golsefidy; Alireza,12,0,15,3
1668249920624,MATH 202B,A00,098024,Rhoades; Brendon Patrick,9,0,15,6
1668249921050,MATH 203B,A00,098025,Oprea; Dragos N.,10,0,15,5
1668249921477,MATH 204B,A00,098026,Sorensen; Claus M,13,0,15,2
1668249921901,MATH 208,A00,098027,Izadi; Elham,7,0,10,3
1668249922326,MATH 209,A00,098028,Pollack; Aaron,10,0,10,0
1668249922750,MATH 211A,A00,112919,Rogalski; Daniel,9,0,10,1
1668249923174,MATH 211B,A00,112920,Seward; Brandon M.,9,0,10,1
1668249923597,MATH 218,A00,098029,Li; Bo,10,0,10,0
1668249924025,MATH 220B,A00,098030,Novak; Jonathan I,11,0,15,4
1668249924453,MATH 221A,A00,098031,Ebenfelt; Peter F,13,0,15,2
1668249924876,MATH 231B,A00,098032,Zlatos; Andrej,12,0,15,3
1668249925299,MATH 240B,A00,098033,Ni; Lei,9,0,15,6
1668249925724,MATH 243,A00,098034,Jekel; David Andrew,10,0,10,0
1668249926153,MATH 245A,A00,098035,Nie; Jiawang,0,0,15,16
1668249926578,MATH 248,A00,098036,Bejenaru; Ioan,10,0,10,0
1668249927013,MATH 250B,A00,098037,Spolaor; Luca,14,0,15,1
1668249927436,MATH 258,A00,098038,Ni; Lei,10,0,10,0
1668249927865,MATH 264B,A00,098041,Rhoades; Brendon Patrick,9,0,15,6
1668249928288,MATH 268,A00,098042,Buss; Samuel R,10,0,10,0
1668249928714,MATH 269,A00,098043,Rhoades; Brendon Patrick,10,0,10,0
1668249929141,MATH 270B,A00,098044,Li; Bo,10,0,15,5
1668249929565,MATH 272B,A00,098045,Holst; Michael J,13,0,15,2
1668249929997,MATH 273A,A00,098046,Tian; Xiaochuan,10,0,15,5
1668249930429,MATH 275,A01,098048,Tian; Xiaochuan,6,0,10,4
1668249930852,MATH 278A,A00,098049,Holst; Michael J,8,0,10,2
1668249931276,MATH 278B,A00,098050,Cloninger; Alexander,10,0,10,0
1668249931701,MATH 278C,A00,098051,Nie; Jiawang,7,0,10,3
1668249932129,MATH 280B,A00,098052,Zheng; Tianyi,9,0,15,6
1668249932554,MATH 281B,A00,098053,Bradic; Jelena,1,0,15,14
1668249932985,MATH 282B,A00,098054,Arias-Castro; Ery,0,0,15,15
1668249933409,MATH 285,A00,098055,Fitzsimmons; Patrick J,0,0,15,17
1668249933834,MATH 287B,A00,098056,Arias-Castro; Ery,2,0,15,13
1668249934258,MATH 288,A00,098057,Agarwal; Pooja,9,0,10,1
1668249934258,MATH 288,B00,098058,Zhang; Danna,8,0,10,2
1668249934258,MATH 288,C00,098059,Williams; Ruth J,10,0,10,0
1668249934681,MATH 290B,A00,098060,Roberts; Justin Deritter,13,0,15,2
1668249935105,MATH 292,A00,098061,Belmont; Eva Kinoshita,10,0,10,0
1668249935530,MATH 295,A00,098062,Suk; Andrew Hoon,48,0,50,2
1668249935958,MATH 296,A00,098063,Novak; Jonathan I,20,0,20,0
1668249936411,MATH 297,001,098064,Gamst; Anthony Collins,9997,0,9999,2
1668250436713,COGS 205,A00,101395,Chiba; Andrea,19,0,20,1
1668250437138,COGS 210B,001,101404,Greene; Deanna Jacquelyn,9998,0,9999,1
1668250437138,COGS 210B,002,101417,Xia; Haijun,9999,0,9999,0
1668250437138,COGS 210B,003,101422,Nitz; Douglas A.,9999,0,9999,0
1668250437138,COGS 210B,004,101423,Hollan; James D.,9998,0,9999,1
1668250437138,COGS 210B,005,101424,Deak; Gedeon O.,9998,0,9999,1
1668250437138,COGS 210B,006,101425,Rossano; Federico,9999,0,9999,0
1668250437562,COGS 211B,A00,101427,Coulson; Seana M,9996,0,9999,3
1668250437985,COGS 220,A00,101428,Hollan; James D.,0,0,25,25
1668250438412,COGS 229,A00,101429,Dow; Steven P,18,0,25,7
1668250438839,COGS 230,A00,101430,Klemmer; Scott R,12,0,17,5
1668250439266,COGS 234,A00,101431,Xia; Haijun,2,0,25,23
1668250439690,COGS 260,A00,101432,Kiyonaga; Anastasia,21,0,25,4
1668250439690,COGS 260,B00,101433,Kirsh; David Joel,15,0,25,10
1668250440113,CSE 202,A00,102371,Impagliazzo; Russell,0,0,0,0
1668250440536,CSE 203B,A01,102373,Cheng; Chung Kuan,0,0,0,0
1668250440964,CSE 208,A00,102374,Micciancio; Daniele,0,0,0,0
1668250441386,CSE 209A,A00,112895,Impagliazzo; Russell,0,0,15,15
1668250441824,CSE 209B,A00,108005,Bellare; Mihir,0,0,0,0
1668250442247,CSE 210,A00,113163,Coblenz; Michael J,0,0,0,0
1668250442672,CSE 219,A00,106111,Dow; Steven P,0,0,20,20
1668250443096,CSE 221,A00,102376,Voelker; Geoffrey M.,0,0,0,0
1668250443525,CSE 224,A01,102378,Porter; George M,0,0,0,0
1668250443947,CSE 229A,A00,102379,Savage; Stefan,0,0,0,0
1668250444370,CSE 229C,A00,102380,Munyaka; Imani N. S.,0,0,0,0
1668250444799,CSE 232B,A00,102382,Deutsch; Alin Bernard,0,0,0,0
1668250445223,CSE 234,A01,112904,Kumar; Arun Kumar,0,0,0,0
1668250445647,CSE 237A,A00,102383,Rosing; Tajana Simunic,0,0,0,0
1668250446073,CSE 239A,A00,102384,Deutsch; Alin Bernard,0,0,0,0
1668250446497,CSE 239B,A00,102385,Polikarpova; Nadezhda,0,0,0,0
1668250446924,CSE 240A,A00,102386,Pannuto; Patrick William,0,0,0,0
1668250447347,CSE 240B,A00,102387,Zhao; Jishen,0,0,0,0
1668250447775,CSE 241A,A00,106406,Kang; Mingu,0,0,0,0
1668250448203,CSE 249B,A00,102388,Kahng; Andrew Byun,0,0,8,8
1668250448627,CSE 251B,A01,102392,Cottrell; Garrison W,0,0,0,0
1668250448627,CSE 251B,A02,102393,Cottrell; Garrison W,0,0,0,0
1668250449062,CSE 252B,A00,102394,Ochoa; Benjamin Lawrence,0,0,0,0
1668250449494,CSE 257,A01,102396,Gao; Sicun,0,0,0,0
1668250449918,CSE 272,A00,102397,Li; Tzumao,0,0,0,0
1668250450354,CSE 274,A00,111323,Chern; Albert Ren-Haur,0,0,0,0
1668250450780,CSE 282,A00,102398,Pevzner; Pavel Arkadjevich,0,0,0,0
1668250451218,CSE 284,A00,114175,Gymrek; Melissa Ann,0,0,0,0
1668250451648,CSE 290,A00,102399,Chandraker; Manmohan Krishna,0,0,0,0
1668250451648,CSE 290,B00,102400,Vaccaro; Kristen Marie,0,0,25,25
1668250451648,CSE 290,C00,102414,Pannuto; Patrick William,0,0,25,25
1668250451648,CSE 290,D00,102427,Pevzner; Pavel Arkadjevich,0,0,0,0
1668250451648,CSE 290,E00,102429,Zhao; Jishen,0,0,0,0
1668250451648,CSE 290,F00,102436,Tullsen; Dean Michael,0,0,0,0
1668250451648,CSE 290,G00,102440,Christensen; Henrik I,0,0,20,20
1668250452100,CSE 291,A00,102443,Su; Hao,0,0,0,0
1668250452100,CSE 291,B00,102448,Polikarpova; Nadezhda,0,0,0,0
1668250452100,CSE 291,C00,102453,Vaccaro; Kristen Marie,0,0,0,0
1668250452100,CSE 291,D00,111343,Savage; Stefan,0,0,0,0
1668250452100,CSE 291,E00,116474,Claffy; Kimberly Claire,0,0,0,0
1668250452100,CSE 291,F00,116479,Pasquale; Joseph,0,0,0,0
1668250452551,CSE 293,001,119111,Bafna; Vineet,9999,0,9999,0
1668250452551,CSE 293,002,119118,Bellare; Mihir,9999,0,9999,0
1668250452551,CSE 293,003,119122,Berg-Kirkpatrick; Taylor D,9999,0,9999,0
1668250452551,CSE 293,004,119135,Christensen; Henrik I,9999,0,9999,0
1668250452551,CSE 293,005,119142,Cottrell; Garrison W,9999,0,9999,0
1668250452551,CSE 293,006,119146,Deutsch; Alin Bernard,9999,0,9999,0
1668250452551,CSE 293,007,119159,Esmaeilzadeh; Hadi,9999,0,9999,0
1668250452551,CSE 293,008,119166,Freund; Yoav,9999,0,9999,0
1668250452551,CSE 293,009,119170,Griswold; William G.,9999,0,9999,0
1668250452551,CSE 293,010,119183,Gymrek; Melissa Ann,9999,0,9999,0
1668250452551,CSE 293,011,119190,Heninger; Nadia A,9999,0,9999,0
1668250452551,CSE 293,012,119230,Impagliazzo; Russell,9999,0,9999,0
1668250452551,CSE 293,013,119232,Jhala; Ranjit,9999,0,9999,0
1668250452551,CSE 293,014,119233,Kahng; Andrew Byun,9999,0,9999,0
1668250452551,CSE 293,015,119298,Kane; Daniel Mertz,9999,0,9999,0
1668250452551,CSE 293,016,119299,Kriegman; David J,9999,0,9999,0
1668250452551,CSE 293,017,119300,Kumar; Arun Kumar,9999,0,9999,0
1668250452551,CSE 293,018,119301,Lerner; Sorin,9999,0,9999,0
1668250452551,CSE 293,019,119302,Lovett; Shachar,9999,0,9999,0
1668250452551,CSE 293,020,119303,McAuley; Julian John,9999,0,9999,0
1668250452551,CSE 293,021,119304,Micciancio; Daniele,9999,0,9999,0
1668250452551,CSE 293,022,119367,Orailoglu; Alex,9999,0,9999,0
1668250452551,CSE 293,023,119382,Paturi; Ramamohan,9999,0,9999,0
1668250452551,CSE 293,024,119404,Polikarpova; Nadezhda,9999,0,9999,0
1668250452551,CSE 293,025,119406,Politz; Joseph Gibbs,9999,0,9999,0
1668250452551,CSE 293,026,119411,Porter; George M,9999,0,9999,0
1668250452551,CSE 293,027,119414,Porter; Leonard Emerson,9999,0,9999,0
1668250452551,CSE 293,028,119416,Ramamoorthi; Ravi,9999,0,9999,0
1668250452551,CSE 293,029,119417,Sahoo; Debashis,9999,0,9999,0
1668250452551,CSE 293,030,119420,Saul; Lawrence,9999,0,9999,0
1668250452551,CSE 293,031,119421,Savage; Stefan,9999,0,9999,0
1668250452551,CSE 293,032,119425,Schulze; Jurgen P.,9999,0,9999,0
1668250452551,CSE 293,033,119426,Snoeren; Alex C.,9999,0,9999,0
1668250452551,CSE 293,034,119428,Shang; Jingbo,9999,0,9999,0
1668250452551,CSE 293,035,119430,Stefan; Deian,9999,0,9999,0
1668250452551,CSE 293,036,119431,Su; Hao,9999,0,9999,0
1668250452551,CSE 293,037,119433,Swanson; Steven James,9999,0,9999,0
1668250452551,CSE 293,038,119435,Tullsen; Dean Michael,9999,0,9999,0
1668250452551,CSE 293,039,119483,Voelker; Geoffrey M.,9999,0,9999,0
1668250452551,CSE 293,040,119537,Zhao; Jishen,9999,0,9999,0
1668250452551,CSE 293,041,119538,Zhou; Yuan-Yuan,9999,0,9999,0
1668250452551,CSE 293,042,119539,Gao; Sicun,9999,0,9999,0
1668250452551,CSE 293,043,119540,Weibel; Nadir,9999,0,9999,0
1668250452551,CSE 293,044,119541,Gupta; Rajesh K.,9999,0,9999,0
1668250452551,CSE 293,045,126410,Vaccaro; Kristen Marie,9999,0,9999,0
1668250452551,CSE 293,046,126411,Klemke; Richard,9999,0,9999,0
1668250452982,CSE 294,A00,102459,Voelker; Geoffrey M.,0,0,0,0
1668250452982,CSE 294,B00,111322,Orailoglu; Alex,0,0,0,0
1668250453432,DSE 201,A00,096914,Deutsch; Alin Bernard,30,0,30,0
1668250453857,DSE 210,A00,096915,Dasgupta; Sanjoy,30,0,30,0
1668250454280,DSE 260A,A00,096916,Altintas De Callaf; Ilkay,30,0,30,0
1668250454721,ECE 200,001,103586,Antipa; Nicholas A,9999,0,9999,0
1668250454721,ECE 200,002,103587,Atanasov; Nikolay A.,9999,0,9999,0
1668250454721,ECE 200,003,103588,Bharadia; Dinesh,9999,0,9999,0
1668250454721,ECE 200,004,103589,Cheng; Chung Kuan,9999,0,9999,0
1668250454721,ECE 200,005,103590,Cosman; Pamela C.,9999,0,9999,0
1668250454721,ECE 200,006,103591,Dayeh; Shadi Ahmad,9999,0,9999,0
1668250454721,ECE 200,007,103592,Fainman; Yeshaiahu,9999,0,9999,0
1668250454721,ECE 200,008,103593,Ford; Joseph Earl,9999,0,9999,0
1668250454721,ECE 200,009,103594,Franceschetti; Massimo,9999,0,9999,0
1668250454721,ECE 200,010,103595,Fullerton; Eric E,9999,0,9999,0
1668250454721,ECE 200,011,103596,Galton; Ian A,9999,0,9999,0
1668250454721,ECE 200,012,103597,Gilja; Vikash,9999,0,9999,0
1668250454721,ECE 200,013,103598,Hall; Drew A.,9999,0,9999,0
1668250454721,ECE 200,014,103599,Hsueh; Tzu-Chien,9999,0,9999,0
1668250454721,ECE 200,015,103600,Javidi; Tara,9999,0,9999,0
1668250454721,ECE 200,016,103601,Kahng; Andrew Byun,9999,0,9999,0
1668250454721,ECE 200,017,103602,Kim; Young-Han,9999,0,9999,0
1668250454721,ECE 200,018,103603,Koushanfar; Farinaz,9999,0,9999,0
1668250454721,ECE 200,019,103604,Kuzum; Duygu,9999,0,9999,0
1668250454721,ECE 200,020,103605,Le; Hanh-Phuc,9999,0,9999,0
1668250454721,ECE 200,021,103606,Lin; Bill,9999,0,9999,0
1668250454721,ECE 200,022,103607,Liu; Zhaowei,9998,0,9999,1
1668250454721,ECE 200,023,103608,Lo; Yu-Hwa,9999,0,9999,0
1668250454721,ECE 200,024,103609,Lomakin; Vitaliy,9999,0,9999,0
1668250454721,ECE 200,025,103610,Mercier; Patrick Philip,9999,0,9999,0
1668250454721,ECE 200,026,103611,Meyer; Florian,9999,0,9999,0
1668250454721,ECE 200,027,103612,Milstein; Laurence B.,9999,0,9999,0
1668250454721,ECE 200,028,103613,Mir Arabbaygi; Siavash,9999,0,9999,0
1668250454721,ECE 200,029,103614,Mookherjea; Shayan,9999,0,9999,0
1668250454721,ECE 200,030,103615,Morris; Karcher William,9999,0,9999,0
1668250454721,ECE 200,031,103616,Ng; Tse Nga,9999,0,9999,0
1668250454721,ECE 200,032,103617,Nguyen; Truong Quang,9999,0,9999,0
1668250454721,ECE 200,033,103618,Nomura; Kenji,9999,0,9999,0
1668250454721,ECE 200,034,103619,Orlitsky; Alon,9999,0,9999,0
1668250454721,ECE 200,035,103620,Pal; Piya,9999,0,9999,0
1668250454721,ECE 200,036,103621,Papen; George C.,9999,0,9999,0
1668250454721,ECE 200,037,103622,Radic; Stojan,9999,0,9999,0
1668250454721,ECE 200,038,103623,Rao; Bhaskar D.,9999,0,9999,0
1668250454721,ECE 200,039,103624,Rao; Ramesh R,9999,0,9999,0
1668250454721,ECE 200,040,103625,Rebeiz; Gabriel,9999,0,9999,0
1668250454721,ECE 200,041,103626,Sanford; John R,9999,0,9999,0
1668250454721,ECE 200,042,103627,Siegel; Paul H.,9999,0,9999,0
1668250454721,ECE 200,043,103628,Sievenpiper; Daniel F.,9999,0,9999,0
1668250454721,ECE 200,044,103629,Sworder; David D.,9999,0,9999,0
1668250454721,ECE 200,045,103630,Taur; Yuan,9999,0,9999,0
1668250454721,ECE 200,046,103631,Touri; Behrouz,9999,0,9999,0
1668250454721,ECE 200,047,103632,Trivedi; Mohan M.,9999,0,9999,0
1668250454721,ECE 200,048,103633,Vasconcelos; Nuno,9999,0,9999,0
1668250454721,ECE 200,049,103634,Wang; Xiaolong,9999,0,9999,0
1668250454721,ECE 200,050,103635,Xie; Pengtao,9999,0,9999,0
1668250454721,ECE 200,051,103636,Yip; Michael,9999,0,9999,0
1668250454721,ECE 200,052,103637,Zeger; Kenneth A.,999,0,999,0
1668250454721,ECE 200,053,103638,Zhang; Xinyu,9999,0,9999,0
1668250454721,ECE 200,054,103639,Turakhia; Yatish Girish,9999,0,9999,0
1668250454721,ECE 200,055,103640,Kang; Mingu,9999,0,9999,0
1668250454721,ECE 200,056,103641,Shi; Yuanyuan,9999,0,9999,0
1668250454721,ECE 200,057,103642,Wang; Edward Jay,9999,0,9999,0
1668250454721,ECE 200,058,103643,Zheng; Yang,9999,0,9999,0
1668250455148,ECE 202,A00,103644,Kuzum; Duygu,0,0,0,0
1668250455573,ECE 212BN,A00,103646,Ng; Tse Nga,0,0,0,0
1668250456003,ECE 221,A00,111493,Staff,0,0,0,0
1668250456430,ECE 222B,A00,103647,Lomakin; Vitaliy,0,0,0,0
1668250456859,ECE 230B,A00,103648,Taur; Yuan,0,0,0,0
1668250457285,ECE 238B,A00,103649,Garay; Javier,0,0,0,0
1668250457717,ECE 240B,A00,112900,Fainman; Yeshaiahu,0,0,0,0
1668250458142,ECE 247A,A00,103650,Jokerst; Jesse Vincent,0,0,0,0
1668250458566,ECE 247B,A00,103651,Wang; Joseph,0,0,0,0
1668250459006,ECE 250,A00,103652,Siegel; Paul H.,0,0,0,0
1668250459441,ECE 251A,A00,103654,Rao; Bhaskar D.,0,0,0,0
1668250459867,ECE 257B,A00,103655,Bharadia; Dinesh,0,0,0,0
1668250460291,ECE 258A,A00,103656,Milstein; Laurence B.,0,0,0,0
1668250460715,ECE 260B,A00,103658,Kang; Mingu,0,0,0,0
1668250461140,ECE 264A,A00,103659,Galton; Ian A,0,0,0,0
1668250461563,ECE 265A,A00,103661,Gudem; Prasad S.S.,0,0,0,0
1668250461988,ECE 265D,A00,103662,Gudem; Prasad S.S.,0,0,0,0
1668250462410,ECE 268,A00,103663,Koushanfar; Farinaz,0,0,0,0
1668250462838,ECE 269,A01,103665,Pal; Piya,0,0,0,0
1668250463276,ECE 271B,A00,103666,Vasconcelos; Manuela,0,0,0,0
1668250463701,ECE 276A,A00,103667,Atanasov; Nikolay A.,0,0,0,0
1668250464128,ECE 277,A00,103668,An; Cheolhong,0,0,0,0
1668250464554,ECE 279,A00,117947,Hall; Drew A.,0,0,0,0
1668250465404,ECE 283,A00,103670,Hsueh; Tzu-Chien,0,0,0,0
1668250465831,ECE 284,A00,103671,Turakhia; Yatish Girish,0,0,0,0
1668250466255,ECE 285,A00,103672,Zheng; Yang,0,0,0,0
1668250466255,ECE 285,B00,103673,Sworder; David D.,0,0,0,0
1668250466678,ECE 287,A00,103676,Javidi; Tara,0,0,0,0
1668250467106,MATH 200B,A00,098023,Salehi Golsefidy; Alireza,12,0,15,3
1668250467535,MATH 202B,A00,098024,Rhoades; Brendon Patrick,9,0,15,6
1668250467958,MATH 203B,A00,098025,Oprea; Dragos N.,10,0,15,5
1668250468383,MATH 204B,A00,098026,Sorensen; Claus M,13,0,15,2
1668250468810,MATH 208,A00,098027,Izadi; Elham,7,0,10,3
1668250469233,MATH 209,A00,098028,Pollack; Aaron,10,0,10,0
1668250469659,MATH 211A,A00,112919,Rogalski; Daniel,9,0,10,1
1668250470087,MATH 211B,A00,112920,Seward; Brandon M.,9,0,10,1
1668250470509,MATH 218,A00,098029,Li; Bo,10,0,10,0
1668250470934,MATH 220B,A00,098030,Novak; Jonathan I,11,0,15,4
1668250471364,MATH 221A,A00,098031,Ebenfelt; Peter F,13,0,15,2
1668250471816,MATH 231B,A00,098032,Zlatos; Andrej,12,0,15,3
1668250472251,MATH 240B,A00,098033,Ni; Lei,9,0,15,6
1668250472678,MATH 243,A00,098034,Jekel; David Andrew,10,0,10,0
1668250473105,MATH 245A,A00,098035,Nie; Jiawang,0,0,15,16
1668250473536,MATH 248,A00,098036,Bejenaru; Ioan,10,0,10,0
1668250473959,MATH 250B,A00,098037,Spolaor; Luca,14,0,15,1
1668250474384,MATH 258,A00,098038,Ni; Lei,10,0,10,0
1668250474811,MATH 264B,A00,098041,Rhoades; Brendon Patrick,9,0,15,6
1668250475244,MATH 268,A00,098042,Buss; Samuel R,10,0,10,0
1668250475668,MATH 269,A00,098043,Rhoades; Brendon Patrick,10,0,10,0
1668250476092,MATH 270B,A00,098044,Li; Bo,10,0,15,5
1668250476517,MATH 272B,A00,098045,Holst; Michael J,13,0,15,2
1668250477018,MATH 273A,A00,098046,Tian; Xiaochuan,10,0,15,5
1668250477442,MATH 275,A01,098048,Tian; Xiaochuan,6,0,10,4
1668250477874,MATH 278A,A00,098049,Holst; Michael J,8,0,10,2
1668250478301,MATH 278B,A00,098050,Cloninger; Alexander,10,0,10,0
1668250478723,MATH 278C,A00,098051,Nie; Jiawang,7,0,10,3
1668250479150,MATH 280B,A00,098052,Zheng; Tianyi,9,0,15,6
1668250479576,MATH 281B,A00,098053,Bradic; Jelena,1,0,15,14
1668250480001,MATH 282B,A00,098054,Arias-Castro; Ery,0,0,15,15
1668250480424,MATH 285,A00,098055,Fitzsimmons; Patrick J,0,0,15,17
1668250480849,MATH 287B,A00,098056,Arias-Castro; Ery,2,0,15,13
1668250481274,MATH 288,A00,098057,Agarwal; Pooja,9,0,10,1
1668250481274,MATH 288,B00,098058,Zhang; Danna,8,0,10,2
1668250481274,MATH 288,C00,098059,Williams; Ruth J,10,0,10,0
1668250481697,MATH 290B,A00,098060,Roberts; Justin Deritter,13,0,15,2
1668250482120,MATH 292,A00,098061,Belmont; Eva Kinoshita,10,0,10,0
1668250482543,MATH 295,A00,098062,Suk; Andrew Hoon,48,0,50,2
1668250482971,MATH 296,A00,098063,Novak; Jonathan I,20,0,20,0
1668250483396,MATH 297,001,098064,Gamst; Anthony Collins,9997,0,9999,2
1668250984116,COGS 205,A00,101395,Chiba; Andrea,19,0,20,1
1668250984542,COGS 210B,001,101404,Greene; Deanna Jacquelyn,9998,0,9999,1
1668250984542,COGS 210B,002,101417,Xia; Haijun,9999,0,9999,0
1668250984542,COGS 210B,003,101422,Nitz; Douglas A.,9999,0,9999,0
1668250984542,COGS 210B,004,101423,Hollan; James D.,9998,0,9999,1
1668250984542,COGS 210B,005,101424,Deak; Gedeon O.,9998,0,9999,1
1668250984542,COGS 210B,006,101425,Rossano; Federico,9999,0,9999,0
1668250984965,COGS 211B,A00,101427,Coulson; Seana M,9996,0,9999,3
1668250985394,COGS 220,A00,101428,Hollan; James D.,0,0,25,25
1668250985821,COGS 229,A00,101429,Dow; Steven P,18,0,25,7
1668250986249,COGS 230,A00,101430,Klemmer; Scott R,12,0,17,5
1668250986675,COGS 234,A00,101431,Xia; Haijun,2,0,25,23
1668250987101,COGS 260,A00,101432,Kiyonaga; Anastasia,21,0,25,4
1668250987101,COGS 260,B00,101433,Kirsh; David Joel,15,0,25,10
1668250987524,CSE 202,A00,102371,Impagliazzo; Russell,0,0,0,0
1668250987949,CSE 203B,A01,102373,Cheng; Chung Kuan,0,0,0,0
1668250988382,CSE 208,A00,102374,Micciancio; Daniele,0,0,0,0
1668250988814,CSE 209A,A00,112895,Impagliazzo; Russell,0,0,15,15
1668250989239,CSE 209B,A00,108005,Bellare; Mihir,0,0,0,0
1668250989667,CSE 210,A00,113163,Coblenz; Michael J,0,0,0,0
1668250990094,CSE 219,A00,106111,Dow; Steven P,0,0,20,20
1668250990519,CSE 221,A00,102376,Voelker; Geoffrey M.,0,0,0,0
1668250990941,CSE 224,A01,102378,Porter; George M,0,0,0,0
1668250991365,CSE 229A,A00,102379,Savage; Stefan,0,0,0,0
1668250991789,CSE 229C,A00,102380,Munyaka; Imani N. S.,0,0,0,0
1668250992228,CSE 232B,A00,102382,Deutsch; Alin Bernard,0,0,0,0
1668250992661,CSE 234,A01,112904,Kumar; Arun Kumar,0,0,0,0
1668250993086,CSE 237A,A00,102383,Rosing; Tajana Simunic,0,0,0,0
1668250993517,CSE 239A,A00,102384,Deutsch; Alin Bernard,0,0,0,0
1668250993942,CSE 239B,A00,102385,Polikarpova; Nadezhda,0,0,0,0
1668250994369,CSE 240A,A00,102386,Pannuto; Patrick William,0,0,0,0
1668250994796,CSE 240B,A00,102387,Zhao; Jishen,0,0,0,0
1668250995219,CSE 241A,A00,106406,Kang; Mingu,0,0,0,0
1668250995644,CSE 249B,A00,102388,Kahng; Andrew Byun,0,0,8,8
1668250996073,CSE 251B,A01,102392,Cottrell; Garrison W,0,0,0,0
1668250996073,CSE 251B,A02,102393,Cottrell; Garrison W,0,0,0,0
1668250996498,CSE 252B,A00,102394,Ochoa; Benjamin Lawrence,0,0,0,0
1668250996925,CSE 257,A01,102396,Gao; Sicun,0,0,0,0
1668250997351,CSE 272,A00,102397,Li; Tzumao,0,0,0,0
1668250997890,CSE 274,A00,111323,Chern; Albert Ren-Haur,0,0,0,0
1668250998317,CSE 282,A00,102398,Pevzner; Pavel Arkadjevich,0,0,0,0
1668250998740,CSE 284,A00,114175,Gymrek; Melissa Ann,0,0,0,0
1668250999164,CSE 290,A00,102399,Chandraker; Manmohan Krishna,0,0,0,0
1668250999164,CSE 290,B00,102400,Vaccaro; Kristen Marie,0,0,25,25
1668250999164,CSE 290,C00,102414,Pannuto; Patrick William,0,0,25,25
1668250999164,CSE 290,D00,102427,Pevzner; Pavel Arkadjevich,0,0,0,0
1668250999164,CSE 290,E00,102429,Zhao; Jishen,0,0,0,0
1668250999164,CSE 290,F00,102436,Tullsen; Dean Michael,0,0,0,0
1668250999164,CSE 290,G00,102440,Christensen; Henrik I,0,0,20,20
1668250999595,CSE 291,A00,102443,Su; Hao,0,0,0,0
1668250999595,CSE 291,B00,102448,Polikarpova; Nadezhda,0,0,0,0
1668250999595,CSE 291,C00,102453,Vaccaro; Kristen Marie,0,0,0,0
1668250999595,CSE 291,D00,111343,Savage; Stefan,0,0,0,0
1668250999595,CSE 291,E00,116474,Claffy; Kimberly Claire,0,0,0,0
1668250999595,CSE 291,F00,116479,Pasquale; Joseph,0,0,0,0
1668251000054,CSE 293,001,119111,Bafna; Vineet,9999,0,9999,0
1668251000054,CSE 293,002,119118,Bellare; Mihir,9999,0,9999,0
1668251000054,CSE 293,003,119122,Berg-Kirkpatrick; Taylor D,9999,0,9999,0
1668251000054,CSE 293,004,119135,Christensen; Henrik I,9999,0,9999,0
1668251000054,CSE 293,005,119142,Cottrell; Garrison W,9999,0,9999,0
1668251000054,CSE 293,006,119146,Deutsch; Alin Bernard,9999,0,9999,0
1668251000054,CSE 293,007,119159,Esmaeilzadeh; Hadi,9999,0,9999,0
1668251000054,CSE 293,008,119166,Freund; Yoav,9999,0,9999,0
1668251000054,CSE 293,009,119170,Griswold; William G.,9999,0,9999,0
1668251000054,CSE 293,010,119183,Gymrek; Melissa Ann,9999,0,9999,0
1668251000054,CSE 293,011,119190,Heninger; Nadia A,9999,0,9999,0
1668251000054,CSE 293,012,119230,Impagliazzo; Russell,9999,0,9999,0
1668251000054,CSE 293,013,119232,Jhala; Ranjit,9999,0,9999,0
1668251000054,CSE 293,014,119233,Kahng; Andrew Byun,9999,0,9999,0
1668251000054,CSE 293,015,119298,Kane; Daniel Mertz,9999,0,9999,0
1668251000054,CSE 293,016,119299,Kriegman; David J,9999,0,9999,0
1668251000054,CSE 293,017,119300,Kumar; Arun Kumar,9999,0,9999,0
1668251000054,CSE 293,018,119301,Lerner; Sorin,9999,0,9999,0
1668251000054,CSE 293,019,119302,Lovett; Shachar,9999,0,9999,0
1668251000054,CSE 293,020,119303,McAuley; Julian John,9999,0,9999,0
1668251000054,CSE 293,021,119304,Micciancio; Daniele,9999,0,9999,0
1668251000054,CSE 293,022,119367,Orailoglu; Alex,9999,0,9999,0
1668251000054,CSE 293,023,119382,Paturi; Ramamohan,9999,0,9999,0
1668251000054,CSE 293,024,119404,Polikarpova; Nadezhda,9999,0,9999,0
1668251000054,CSE 293,025,119406,Politz; Joseph Gibbs,9999,0,9999,0
1668251000054,CSE 293,026,119411,Porter; George M,9999,0,9999,0
1668251000054,CSE 293,027,119414,Porter; Leonard Emerson,9999,0,9999,0
1668251000054,CSE 293,028,119416,Ramamoorthi; Ravi,9999,0,9999,0
1668251000054,CSE 293,029,119417,Sahoo; Debashis,9999,0,9999,0
1668251000054,CSE 293,030,119420,Saul; Lawrence,9999,0,9999,0
1668251000054,CSE 293,031,119421,Savage; Stefan,9999,0,9999,0
1668251000054,CSE 293,032,119425,Schulze; Jurgen P.,9999,0,9999,0
1668251000054,CSE 293,033,119426,Snoeren; Alex C.,9999,0,9999,0
1668251000054,CSE 293,034,119428,Shang; Jingbo,9999,0,9999,0
1668251000054,CSE 293,035,119430,Stefan; Deian,9999,0,9999,0
1668251000054,CSE 293,036,119431,Su; Hao,9999,0,9999,0
1668251000054,CSE 293,037,119433,Swanson; Steven James,9999,0,9999,0
1668251000054,CSE 293,038,119435,Tullsen; Dean Michael,9999,0,9999,0
1668251000054,CSE 293,039,119483,Voelker; Geoffrey M.,9999,0,9999,0
1668251000054,CSE 293,040,119537,Zhao; Jishen,9999,0,9999,0
1668251000054,CSE 293,041,119538,Zhou; Yuan-Yuan,9999,0,9999,0
1668251000054,CSE 293,042,119539,Gao; Sicun,9999,0,9999,0
1668251000054,CSE 293,043,119540,Weibel; Nadir,9999,0,9999,0
1668251000054,CSE 293,044,119541,Gupta; Rajesh K.,9999,0,9999,0
1668251000054,CSE 293,045,126410,Vaccaro; Kristen Marie,9999,0,9999,0
1668251000054,CSE 293,046,126411,Klemke; Richard,9999,0,9999,0
1668251000480,CSE 294,A00,102459,Voelker; Geoffrey M.,0,0,0,0
1668251000480,CSE 294,B00,111322,Orailoglu; Alex,0,0,0,0
1668251000903,DSE 201,A00,096914,Deutsch; Alin Bernard,30,0,30,0
1668251001338,DSE 210,A00,096915,Dasgupta; Sanjoy,30,0,30,0
1668251001765,DSE 260A,A00,096916,Altintas De Callaf; Ilkay,30,0,30,0
1668251002217,ECE 200,001,103586,Antipa; Nicholas A,9999,0,9999,0
1668251002217,ECE 200,002,103587,Atanasov; Nikolay A.,9999,0,9999,0
1668251002217,ECE 200,003,103588,Bharadia; Dinesh,9999,0,9999,0
1668251002217,ECE 200,004,103589,Cheng; Chung Kuan,9999,0,9999,0
1668251002217,ECE 200,005,103590,Cosman; Pamela C.,9999,0,9999,0
1668251002217,ECE 200,006,103591,Dayeh; Shadi Ahmad,9999,0,9999,0
1668251002217,ECE 200,007,103592,Fainman; Yeshaiahu,9999,0,9999,0
1668251002217,ECE 200,008,103593,Ford; Joseph Earl,9999,0,9999,0
1668251002217,ECE 200,009,103594,Franceschetti; Massimo,9999,0,9999,0
1668251002217,ECE 200,010,103595,Fullerton; Eric E,9999,0,9999,0
1668251002217,ECE 200,011,103596,Galton; Ian A,9999,0,9999,0
1668251002217,ECE 200,012,103597,Gilja; Vikash,9999,0,9999,0
1668251002217,ECE 200,013,103598,Hall; Drew A.,9999,0,9999,0
1668251002217,ECE 200,014,103599,Hsueh; Tzu-Chien,9999,0,9999,0
1668251002217,ECE 200,015,103600,Javidi; Tara,9999,0,9999,0
1668251002217,ECE 200,016,103601,Kahng; Andrew Byun,9999,0,9999,0
1668251002217,ECE 200,017,103602,Kim; Young-Han,9999,0,9999,0
1668251002217,ECE 200,018,103603,Koushanfar; Farinaz,9999,0,9999,0
1668251002217,ECE 200,019,103604,Kuzum; Duygu,9999,0,9999,0
1668251002217,ECE 200,020,103605,Le; Hanh-Phuc,9999,0,9999,0
1668251002217,ECE 200,021,103606,Lin; Bill,9999,0,9999,0
1668251002217,ECE 200,022,103607,Liu; Zhaowei,9998,0,9999,1
1668251002217,ECE 200,023,103608,Lo; Yu-Hwa,9999,0,9999,0
1668251002217,ECE 200,024,103609,Lomakin; Vitaliy,9999,0,9999,0
1668251002217,ECE 200,025,103610,Mercier; Patrick Philip,9999,0,9999,0
1668251002217,ECE 200,026,103611,Meyer; Florian,9999,0,9999,0
1668251002217,ECE 200,027,103612,Milstein; Laurence B.,9999,0,9999,0
1668251002217,ECE 200,028,103613,Mir Arabbaygi; Siavash,9999,0,9999,0
1668251002217,ECE 200,029,103614,Mookherjea; Shayan,9999,0,9999,0
1668251002217,ECE 200,030,103615,Morris; Karcher William,9999,0,9999,0
1668251002217,ECE 200,031,103616,Ng; Tse Nga,9999,0,9999,0
1668251002217,ECE 200,032,103617,Nguyen; Truong Quang,9999,0,9999,0
1668251002217,ECE 200,033,103618,Nomura; Kenji,9999,0,9999,0
1668251002217,ECE 200,034,103619,Orlitsky; Alon,9999,0,9999,0
1668251002217,ECE 200,035,103620,Pal; Piya,9999,0,9999,0
1668251002217,ECE 200,036,103621,Papen; George C.,9999,0,9999,0
1668251002217,ECE 200,037,103622,Radic; Stojan,9999,0,9999,0
1668251002217,ECE 200,038,103623,Rao; Bhaskar D.,9999,0,9999,0
1668251002217,ECE 200,039,103624,Rao; Ramesh R,9999,0,9999,0
1668251002217,ECE 200,040,103625,Rebeiz; Gabriel,9999,0,9999,0
1668251002217,ECE 200,041,103626,Sanford; John R,9999,0,9999,0
1668251002217,ECE 200,042,103627,Siegel; Paul H.,9999,0,9999,0
1668251002217,ECE 200,043,103628,Sievenpiper; Daniel F.,9999,0,9999,0
1668251002217,ECE 200,044,103629,Sworder; David D.,9999,0,9999,0
1668251002217,ECE 200,045,103630,Taur; Yuan,9999,0,9999,0
1668251002217,ECE 200,046,103631,Touri; Behrouz,9999,0,9999,0
1668251002217,ECE 200,047,103632,Trivedi; Mohan M.,9999,0,9999,0
1668251002217,ECE 200,048,103633,Vasconcelos; Nuno,9999,0,9999,0
1668251002217,ECE 200,049,103634,Wang; Xiaolong,9999,0,9999,0
1668251002217,ECE 200,050,103635,Xie; Pengtao,9999,0,9999,0
1668251002217,ECE 200,051,103636,Yip; Michael,9999,0,9999,0
1668251002217,ECE 200,052,103637,Zeger; Kenneth A.,999,0,999,0
1668251002217,ECE 200,053,103638,Zhang; Xinyu,9999,0,9999,0
1668251002217,ECE 200,054,103639,Turakhia; Yatish Girish,9999,0,9999,0
1668251002217,ECE 200,055,103640,Kang; Mingu,9999,0,9999,0
1668251002217,ECE 200,056,103641,Shi; Yuanyuan,9999,0,9999,0
1668251002217,ECE 200,057,103642,Wang; Edward Jay,9999,0,9999,0
1668251002217,ECE 200,058,103643,Zheng; Yang,9999,0,9999,0
1668251002640,ECE 202,A00,103644,Kuzum; Duygu,0,0,0,0
1668251003066,ECE 212BN,A00,103646,Ng; Tse Nga,0,0,0,0
1668251003501,ECE 221,A00,111493,Staff,0,0,0,0
1668251003927,ECE 222B,A00,103647,Lomakin; Vitaliy,0,0,0,0
1668251004349,ECE 230B,A00,103648,Taur; Yuan,0,0,0,0
1668251004781,ECE 238B,A00,103649,Garay; Javier,0,0,0,0
1668251005215,ECE 240B,A00,112900,Fainman; Yeshaiahu,0,0,0,0
1668251005641,ECE 247A,A00,103650,Jokerst; Jesse Vincent,0,0,0,0
1668251006065,ECE 247B,A00,103651,Wang; Joseph,0,0,0,0
1668251006492,ECE 250,A00,103652,Siegel; Paul H.,0,0,0,0
1668251006916,ECE 251A,A00,103654,Rao; Bhaskar D.,0,0,0,0
1668251007341,ECE 257B,A00,103655,Bharadia; Dinesh,0,0,0,0
1668251007765,ECE 258A,A00,103656,Milstein; Laurence B.,0,0,0,0
1668251008190,ECE 260B,A00,103658,Kang; Mingu,0,0,0,0
1668251008615,ECE 264A,A00,103659,Galton; Ian A,0,0,0,0
1668251009041,ECE 265A,A00,103661,Gudem; Prasad S.S.,0,0,0,0
1668251009468,ECE 265D,A00,103662,Gudem; Prasad S.S.,0,0,0,0
1668251009892,ECE 268,A00,103663,Koushanfar; Farinaz,0,0,0,0
1668251010316,ECE 269,A01,103665,Pal; Piya,0,0,0,0
1668251010738,ECE 271B,A00,103666,Vasconcelos; Manuela,0,0,0,0
1668251011176,ECE 276A,A00,103667,Atanasov; Nikolay A.,0,0,0,0
1668251011606,ECE 277,A00,103668,An; Cheolhong,0,0,0,0
1668251012029,ECE 279,A00,117947,Hall; Drew A.,0,0,0,0
1668251012881,ECE 283,A00,103670,Hsueh; Tzu-Chien,0,0,0,0
1668251013303,ECE 284,A00,103671,Turakhia; Yatish Girish,0,0,0,0
1668251013730,ECE 285,A00,103672,Zheng; Yang,0,0,0,0
1668251013730,ECE 285,B00,103673,Sworder; David D.,0,0,0,0
1668251014157,ECE 287,A00,103676,Javidi; Tara,0,0,0,0
1668251014585,MATH 200B,A00,098023,Salehi Golsefidy; Alireza,12,0,15,3
1668251015011,MATH 202B,A00,098024,Rhoades; Brendon Patrick,9,0,15,6
1668251015437,MATH 203B,A00,098025,Oprea; Dragos N.,10,0,15,5
1668251015859,MATH 204B,A00,098026,Sorensen; Claus M,13,0,15,2
1668251016285,MATH 208,A00,098027,Izadi; Elham,7,0,10,3
1668251016715,MATH 209,A00,098028,Pollack; Aaron,10,0,10,0
1668251017146,MATH 211A,A00,112919,Rogalski; Daniel,9,0,10,1
1668251017573,MATH 211B,A00,112920,Seward; Brandon M.,9,0,10,1
1668251017999,MATH 218,A00,098029,Li; Bo,10,0,10,0
1668251018422,MATH 220B,A00,098030,Novak; Jonathan I,11,0,15,4
1668251018857,MATH 221A,A00,098031,Ebenfelt; Peter F,13,0,15,2
1668251019283,MATH 231B,A00,098032,Zlatos; Andrej,12,0,15,3
1668251019707,MATH 240B,A00,098033,Ni; Lei,9,0,15,6
1668251020129,MATH 243,A00,098034,Jekel; David Andrew,10,0,10,0
1668251020561,MATH 245A,A00,098035,Nie; Jiawang,0,0,15,16
1668251020986,MATH 248,A00,098036,Bejenaru; Ioan,10,0,10,0
1668251021411,MATH 250B,A00,098037,Spolaor; Luca,14,0,15,1
1668251021836,MATH 258,A00,098038,Ni; Lei,10,0,10,0
1668251022263,MATH 264B,A00,098041,Rhoades; Brendon Patrick,9,0,15,6
1668251022688,MATH 268,A00,098042,Buss; Samuel R,10,0,10,0
1668251023110,MATH 269,A00,098043,Rhoades; Brendon Patrick,10,0,10,0
1668251023536,MATH 270B,A00,098044,Li; Bo,10,0,15,5
1668251023963,MATH 272B,A00,098045,Holst; Michael J,13,0,15,2
1668251024385,MATH 273A,A00,098046,Tian; Xiaochuan,10,0,15,5
1668251024814,MATH 275,A01,098048,Tian; Xiaochuan,6,0,10,4
1668251025241,MATH 278A,A00,098049,Holst; Michael J,8,0,10,2
1668251025662,MATH 278B,A00,098050,Cloninger; Alexander,10,0,10,0
1668251026087,MATH 278C,A00,098051,Nie; Jiawang,7,0,10,3
1668251026512,MATH 280B,A00,098052,Zheng; Tianyi,9,0,15,6
1668251026937,MATH 281B,A00,098053,Bradic; Jelena,1,0,15,14
1668251027362,MATH 282B,A00,098054,Arias-Castro; Ery,0,0,15,15
1668251027787,MATH 285,A00,098055,Fitzsimmons; Patrick J,0,0,15,17
1668251028210,MATH 287B,A00,098056,Arias-Castro; Ery,2,0,15,13
1668251028634,MATH 288,A00,098057,Agarwal; Pooja,9,0,10,1
1668251028634,MATH 288,B00,098058,Zhang; Danna,8,0,10,2
1668251028634,MATH 288,C00,098059,Williams; Ruth J,10,0,10,0
1668251029058,MATH 290B,A00,098060,Roberts; Justin Deritter,13,0,15,2
1668251029484,MATH 292,A00,098061,Belmont; Eva Kinoshita,10,0,10,0
1668251029907,MATH 295,A00,098062,Suk; Andrew Hoon,48,0,50,2
1668251030331,MATH 296,A00,098063,Novak; Jonathan I,20,0,20,0
1668251030759,MATH 297,001,098064,Gamst; Anthony Collins,9997,0,9999,2
1668251532531,COGS 205,A00,101395,Chiba; Andrea,19,0,20,1
1668251532965,COGS 210B,001,101404,Greene; Deanna Jacquelyn,9998,0,9999,1
1668251532965,COGS 210B,002,101417,Xia; Haijun,9999,0,9999,0
1668251532965,COGS 210B,003,101422,Nitz; Douglas A.,9999,0,9999,0
1668251532965,COGS 210B,004,101423,Hollan; James D.,9998,0,9999,1
1668251532965,COGS 210B,005,101424,Deak; Gedeon O.,9998,0,9999,1
1668251532965,COGS 210B,006,101425,Rossano; Federico,9999,0,9999,0
1668251533390,COGS 211B,A00,101427,Coulson; Seana M,9996,0,9999,3
1668251533814,COGS 220,A00,101428,Hollan; James D.,0,0,25,25
1668251534237,COGS 229,A00,101429,Dow; Steven P,18,0,25,7
1668251534661,COGS 230,A00,101430,Klemmer; Scott R,12,0,17,5
1668251535086,COGS 234,A00,101431,Xia; Haijun,2,0,25,23
1668251535514,COGS 260,A00,101432,Kiyonaga; Anastasia,21,0,25,4
1668251535514,COGS 260,B00,101433,Kirsh; David Joel,15,0,25,10
1668251535944,CSE 202,A00,102371,Impagliazzo; Russell,0,0,0,0
1668251536375,CSE 203B,A01,102373,Cheng; Chung Kuan,0,0,0,0
1668251536804,CSE 208,A00,102374,Micciancio; Daniele,0,0,0,0
1668251537232,CSE 209A,A00,112895,Impagliazzo; Russell,0,0,15,15
1668251537659,CSE 209B,A00,108005,Bellare; Mihir,0,0,0,0
1668251538091,CSE 210,A00,113163,Coblenz; Michael J,0,0,0,0
1668251538522,CSE 219,A00,106111,Dow; Steven P,0,0,20,20
1668251538947,CSE 221,A00,102376,Voelker; Geoffrey M.,0,0,0,0
1668251539377,CSE 224,A01,102378,Porter; George M,0,0,0,0
1668251539800,CSE 229A,A00,102379,Savage; Stefan,0,0,0,0
1668251540227,CSE 229C,A00,102380,Munyaka; Imani N. S.,0,0,0,0
1668251540658,CSE 232B,A00,102382,Deutsch; Alin Bernard,0,0,0,0
1668251541080,CSE 234,A01,112904,Kumar; Arun Kumar,0,0,0,0
1668251541504,CSE 237A,A00,102383,Rosing; Tajana Simunic,0,0,0,0
1668251541933,CSE 239A,A00,102384,Deutsch; Alin Bernard,0,0,0,0
1668251542360,CSE 239B,A00,102385,Polikarpova; Nadezhda,0,0,0,0
1668251542783,CSE 240A,A00,102386,Pannuto; Patrick William,0,0,0,0
1668251543211,CSE 240B,A00,102387,Zhao; Jishen,0,0,0,0
1668251543638,CSE 241A,A00,106406,Kang; Mingu,0,0,0,0
1668251544065,CSE 249B,A00,102388,Kahng; Andrew Byun,0,0,8,8
1668251544498,CSE 251B,A01,102392,Cottrell; Garrison W,0,0,0,0
1668251544498,CSE 251B,A02,102393,Cottrell; Garrison W,0,0,0,0
1668251544934,CSE 252B,A00,102394,Ochoa; Benjamin Lawrence,0,0,0,0
1668251545373,CSE 257,A01,102396,Gao; Sicun,0,0,0,0
1668251545797,CSE 272,A00,102397,Li; Tzumao,0,0,0,0
1668251546222,CSE 274,A00,111323,Chern; Albert Ren-Haur,0,0,0,0
1668251546651,CSE 282,A00,102398,Pevzner; Pavel Arkadjevich,0,0,0,0
1668251547089,CSE 284,A00,114175,Gymrek; Melissa Ann,0,0,0,0
1668251547516,CSE 290,A00,102399,Chandraker; Manmohan Krishna,0,0,0,0
1668251547516,CSE 290,B00,102400,Vaccaro; Kristen Marie,0,0,25,25
1668251547516,CSE 290,C00,102414,Pannuto; Patrick William,0,0,25,25
1668251547516,CSE 290,D00,102427,Pevzner; Pavel Arkadjevich,0,0,0,0
1668251547516,CSE 290,E00,102429,Zhao; Jishen,0,0,0,0
1668251547516,CSE 290,F00,102436,Tullsen; Dean Michael,0,0,0,0
1668251547516,CSE 290,G00,102440,Christensen; Henrik I,0,0,20,20
1668251547944,CSE 291,A00,102443,Su; Hao,0,0,0,0
1668251547944,CSE 291,B00,102448,Polikarpova; Nadezhda,0,0,0,0
1668251547944,CSE 291,C00,102453,Vaccaro; Kristen Marie,0,0,0,0
1668251547944,CSE 291,D00,111343,Savage; Stefan,0,0,0,0
1668251547944,CSE 291,E00,116474,Claffy; Kimberly Claire,0,0,0,0
1668251547944,CSE 291,F00,116479,Pasquale; Joseph,0,0,0,0
1668251548410,CSE 293,001,119111,Bafna; Vineet,9999,0,9999,0
1668251548410,CSE 293,002,119118,Bellare; Mihir,9999,0,9999,0
1668251548410,CSE 293,003,119122,Berg-Kirkpatrick; Taylor D,9999,0,9999,0
1668251548410,CSE 293,004,119135,Christensen; Henrik I,9999,0,9999,0
1668251548410,CSE 293,005,119142,Cottrell; Garrison W,9999,0,9999,0
1668251548410,CSE 293,006,119146,Deutsch; Alin Bernard,9999,0,9999,0
1668251548410,CSE 293,007,119159,Esmaeilzadeh; Hadi,9999,0,9999,0
1668251548410,CSE 293,008,119166,Freund; Yoav,9999,0,9999,0
1668251548410,CSE 293,009,119170,Griswold; William G.,9999,0,9999,0
1668251548410,CSE 293,010,119183,Gymrek; Melissa Ann,9999,0,9999,0
1668251548410,CSE 293,011,119190,Heninger; Nadia A,9999,0,9999,0
1668251548410,CSE 293,012,119230,Impagliazzo; Russell,9999,0,9999,0
1668251548410,CSE 293,013,119232,Jhala; Ranjit,9999,0,9999,0
1668251548410,CSE 293,014,119233,Kahng; Andrew Byun,9999,0,9999,0
1668251548410,CSE 293,015,119298,Kane; Daniel Mertz,9999,0,9999,0
1668251548410,CSE 293,016,119299,Kriegman; David J,9999,0,9999,0
1668251548410,CSE 293,017,119300,Kumar; Arun Kumar,9999,0,9999,0
1668251548410,CSE 293,018,119301,Lerner; Sorin,9999,0,9999,0
1668251548410,CSE 293,019,119302,Lovett; Shachar,9999,0,9999,0
1668251548410,CSE 293,020,119303,McAuley; Julian John,9999,0,9999,0
1668251548410,CSE 293,021,119304,Micciancio; Daniele,9999,0,9999,0
1668251548410,CSE 293,022,119367,Orailoglu; Alex,9999,0,9999,0
1668251548410,CSE 293,023,119382,Paturi; Ramamohan,9999,0,9999,0
1668251548410,CSE 293,024,119404,Polikarpova; Nadezhda,9999,0,9999,0
1668251548410,CSE 293,025,119406,Politz; Joseph Gibbs,9999,0,9999,0
1668251548410,CSE 293,026,119411,Porter; George M,9999,0,9999,0
1668251548410,CSE 293,027,119414,Porter; Leonard Emerson,9999,0,9999,0
1668251548410,CSE 293,028,119416,Ramamoorthi; Ravi,9999,0,9999,0
1668251548410,CSE 293,029,119417,Sahoo; Debashis,9999,0,9999,0
1668251548410,CSE 293,030,119420,Saul; Lawrence,9999,0,9999,0
1668251548410,CSE 293,031,119421,Savage; Stefan,9999,0,9999,0
1668251548410,CSE 293,032,119425,Schulze; Jurgen P.,9999,0,9999,0
1668251548410,CSE 293,033,119426,Snoeren; Alex C.,9999,0,9999,0
1668251548410,CSE 293,034,119428,Shang; Jingbo,9999,0,9999,0
1668251548410,CSE 293,035,119430,Stefan; Deian,9999,0,9999,0
1668251548410,CSE 293,036,119431,Su; Hao,9999,0,9999,0
1668251548410,CSE 293,037,119433,Swanson; Steven James,9999,0,9999,0
1668251548410,CSE 293,038,119435,Tullsen; Dean Michael,9999,0,9999,0
1668251548410,CSE 293,039,119483,Voelker; Geoffrey M.,9999,0,9999,0
1668251548410,CSE 293,040,119537,Zhao; Jishen,9999,0,9999,0
1668251548410,CSE 293,041,119538,Zhou; Yuan-Yuan,9999,0,9999,0
1668251548410,CSE 293,042,119539,Gao; Sicun,9999,0,9999,0
1668251548410,CSE 293,043,119540,Weibel; Nadir,9999,0,9999,0
1668251548410,CSE 293,044,119541,Gupta; Rajesh K.,9999,0,9999,0
1668251548410,CSE 293,045,126410,Vaccaro; Kristen Marie,9999,0,9999,0
1668251548410,CSE 293,046,126411,Klemke; Richard,9999,0,9999,0
1668251548834,CSE 294,A00,102459,Voelker; Geoffrey M.,0,0,0,0
1668251548834,CSE 294,B00,111322,Orailoglu; Alex,0,0,0,0
1668251549261,DSE 201,A00,096914,Deutsch; Alin Bernard,30,0,30,0
1668251549685,DSE 210,A00,096915,Dasgupta; Sanjoy,30,0,30,0
1668251550111,DSE 260A,A00,096916,Altintas De Callaf; Ilkay,30,0,30,0
1668251550590,ECE 200,001,103586,Antipa; Nicholas A,9999,0,9999,0
1668251550590,ECE 200,002,103587,Atanasov; Nikolay A.,9999,0,9999,0
1668251550590,ECE 200,003,103588,Bharadia; Dinesh,9999,0,9999,0
1668251550590,ECE 200,004,103589,Cheng; Chung Kuan,9999,0,9999,0
1668251550590,ECE 200,005,103590,Cosman; Pamela C.,9999,0,9999,0
1668251550590,ECE 200,006,103591,Dayeh; Shadi Ahmad,9999,0,9999,0
1668251550590,ECE 200,007,103592,Fainman; Yeshaiahu,9999,0,9999,0
1668251550590,ECE 200,008,103593,Ford; Joseph Earl,9999,0,9999,0
1668251550590,ECE 200,009,103594,Franceschetti; Massimo,9999,0,9999,0
1668251550590,ECE 200,010,103595,Fullerton; Eric E,9999,0,9999,0
1668251550590,ECE 200,011,103596,Galton; Ian A,9999,0,9999,0
1668251550590,ECE 200,012,103597,Gilja; Vikash,9999,0,9999,0
1668251550590,ECE 200,013,103598,Hall; Drew A.,9999,0,9999,0
1668251550590,ECE 200,014,103599,Hsueh; Tzu-Chien,9999,0,9999,0
1668251550590,ECE 200,015,103600,Javidi; Tara,9999,0,9999,0
1668251550590,ECE 200,016,103601,Kahng; Andrew Byun,9999,0,9999,0
1668251550590,ECE 200,017,103602,Kim; Young-Han,9999,0,9999,0
1668251550590,ECE 200,018,103603,Koushanfar; Farinaz,9999,0,9999,0
1668251550590,ECE 200,019,103604,Kuzum; Duygu,9999,0,9999,0
1668251550590,ECE 200,020,103605,Le; Hanh-Phuc,9999,0,9999,0
1668251550590,ECE 200,021,103606,Lin; Bill,9999,0,9999,0
1668251550590,ECE 200,022,103607,Liu; Zhaowei,9998,0,9999,1
1668251550590,ECE 200,023,103608,Lo; Yu-Hwa,9999,0,9999,0
1668251550590,ECE 200,024,103609,Lomakin; Vitaliy,9999,0,9999,0
1668251550590,ECE 200,025,103610,Mercier; Patrick Philip,9999,0,9999,0
1668251550590,ECE 200,026,103611,Meyer; Florian,9999,0,9999,0
1668251550590,ECE 200,027,103612,Milstein; Laurence B.,9999,0,9999,0
1668251550590,ECE 200,028,103613,Mir Arabbaygi; Siavash,9999,0,9999,0
1668251550590,ECE 200,029,103614,Mookherjea; Shayan,9999,0,9999,0
1668251550590,ECE 200,030,103615,Morris; Karcher William,9999,0,9999,0
1668251550590,ECE 200,031,103616,Ng; Tse Nga,9999,0,9999,0
1668251550590,ECE 200,032,103617,Nguyen; Truong Quang,9999,0,9999,0
1668251550590,ECE 200,033,103618,Nomura; Kenji,9999,0,9999,0
1668251550590,ECE 200,034,103619,Orlitsky; Alon,9999,0,9999,0
1668251550590,ECE 200,035,103620,Pal; Piya,9999,0,9999,0
1668251550590,ECE 200,036,103621,Papen; George C.,9999,0,9999,0
1668251550590,ECE 200,037,103622,Radic; Stojan,9999,0,9999,0
1668251550590,ECE 200,038,103623,Rao; Bhaskar D.,9999,0,9999,0
1668251550590,ECE 200,039,103624,Rao; Ramesh R,9999,0,9999,0
1668251550590,ECE 200,040,103625,Rebeiz; Gabriel,9999,0,9999,0
1668251550590,ECE 200,041,103626,Sanford; John R,9999,0,9999,0
1668251550590,ECE 200,042,103627,Siegel; Paul H.,9999,0,9999,0
1668251550590,ECE 200,043,103628,Sievenpiper; Daniel F.,9999,0,9999,0
1668251550590,ECE 200,044,103629,Sworder; David D.,9999,0,9999,0
1668251550590,ECE 200,045,103630,Taur; Yuan,9999,0,9999,0
1668251550590,ECE 200,046,103631,Touri; Behrouz,9999,0,9999,0
1668251550590,ECE 200,047,103632,Trivedi; Mohan M.,9999,0,9999,0
1668251550590,ECE 200,048,103633,Vasconcelos; Nuno,9999,0,9999,0
1668251550590,ECE 200,049,103634,Wang; Xiaolong,9999,0,9999,0
1668251550590,ECE 200,050,103635,Xie; Pengtao,9999,0,9999,0
1668251550590,ECE 200,051,103636,Yip; Michael,9999,0,9999,0
1668251550590,ECE 200,052,103637,Zeger; Kenneth A.,999,0,999,0
1668251550590,ECE 200,053,103638,Zhang; Xinyu,9999,0,9999,0
1668251550590,ECE 200,054,103639,Turakhia; Yatish Girish,9999,0,9999,0
1668251550590,ECE 200,055,103640,Kang; Mingu,9999,0,9999,0
1668251550590,ECE 200,056,103641,Shi; Yuanyuan,9999,0,9999,0
1668251550590,ECE 200,057,103642,Wang; Edward Jay,9999,0,9999,0
1668251550590,ECE 200,058,103643,Zheng; Yang,9999,0,9999,0
1668251551014,ECE 202,A00,103644,Kuzum; Duygu,0,0,0,0
1668251551441,ECE 212BN,A00,103646,Ng; Tse Nga,0,0,0,0
1668251551865,ECE 221,A00,111493,Staff,0,0,0,0
1668251552292,ECE 222B,A00,103647,Lomakin; Vitaliy,0,0,0,0
1668251552727,ECE 230B,A00,103648,Taur; Yuan,0,0,0,0
1668251553151,ECE 238B,A00,103649,Garay; Javier,0,0,0,0
1668251553577,ECE 240B,A00,112900,Fainman; Yeshaiahu,0,0,0,0
1668251554001,ECE 247A,A00,103650,Jokerst; Jesse Vincent,0,0,0,0
1668251554430,ECE 247B,A00,103651,Wang; Joseph,0,0,0,0
1668251554857,ECE 250,A00,103652,Siegel; Paul H.,0,0,0,0
1668251555285,ECE 251A,A00,103654,Rao; Bhaskar D.,0,0,0,0
1668251555707,ECE 257B,A00,103655,Bharadia; Dinesh,0,0,0,0
1668251556136,ECE 258A,A00,103656,Milstein; Laurence B.,0,0,0,0
1668251556563,ECE 260B,A00,103658,Kang; Mingu,0,0,0,0
1668251556998,ECE 264A,A00,103659,Galton; Ian A,0,0,0,0
1668251557423,ECE 265A,A00,103661,Gudem; Prasad S.S.,0,0,0,0
1668251557847,ECE 265D,A00,103662,Gudem; Prasad S.S.,0,0,0,0
1668251558274,ECE 268,A00,103663,Koushanfar; Farinaz,0,0,0,0
1668251558697,ECE 269,A01,103665,Pal; Piya,0,0,0,0
1668251559127,ECE 271B,A00,103666,Vasconcelos; Manuela,0,0,0,0
1668251559550,ECE 276A,A00,103667,Atanasov; Nikolay A.,0,0,0,0
1668251559975,ECE 277,A00,103668,An; Cheolhong,0,0,0,0
1668251560401,ECE 279,A00,117947,Hall; Drew A.,0,0,0,0
1668251561260,ECE 283,A00,103670,Hsueh; Tzu-Chien,0,0,0,0
1668251561706,ECE 284,A00,103671,Turakhia; Yatish Girish,0,0,0,0
1668251562134,ECE 285,A00,103672,Zheng; Yang,0,0,0,0
1668251562134,ECE 285,B00,103673,Sworder; David D.,0,0,0,0
1668251562557,ECE 287,A00,103676,Javidi; Tara,0,0,0,0
1668251563063,MATH 200B,A00,098023,Salehi Golsefidy; Alireza,12,0,15,3
1668251563494,MATH 202B,A00,098024,Rhoades; Brendon Patrick,9,0,15,6
1668251563918,MATH 203B,A00,098025,Oprea; Dragos N.,10,0,15,5
1668251564348,MATH 204B,A00,098026,Sorensen; Claus M,13,0,15,2
1668251564772,MATH 208,A00,098027,Izadi; Elham,7,0,10,3
1668251565203,MATH 209,A00,098028,Pollack; Aaron,10,0,10,0
1668251565629,MATH 211A,A00,112919,Rogalski; Daniel,9,0,10,1
1668251566055,MATH 211B,A00,112920,Seward; Brandon M.,9,0,10,1
1668251566485,MATH 218,A00,098029,Li; Bo,10,0,10,0
1668251566913,MATH 220B,A00,098030,Novak; Jonathan I,11,0,15,4
1668251567340,MATH 221A,A00,098031,Ebenfelt; Peter F,13,0,15,2
1668251567764,MATH 231B,A00,098032,Zlatos; Andrej,12,0,15,3
1668251568191,MATH 240B,A00,098033,Ni; Lei,9,0,15,6
1668251568616,MATH 243,A00,098034,Jekel; David Andrew,10,0,10,0
1668251569045,MATH 245A,A00,098035,Nie; Jiawang,0,0,15,16
1668251569469,MATH 248,A00,098036,Bejenaru; Ioan,10,0,10,0
1668251569896,MATH 250B,A00,098037,Spolaor; Luca,14,0,15,1
1668251570320,MATH 258,A00,098038,Ni; Lei,10,0,10,0
1668251570748,MATH 264B,A00,098041,Rhoades; Brendon Patrick,9,0,15,6
1668251571172,MATH 268,A00,098042,Buss; Samuel R,10,0,10,0
1668251571597,MATH 269,A00,098043,Rhoades; Brendon Patrick,10,0,10,0
1668251572025,MATH 270B,A00,098044,Li; Bo,10,0,15,5
1668251572453,MATH 272B,A00,098045,Holst; Michael J,13,0,15,2
1668251572880,MATH 273A,A00,098046,Tian; Xiaochuan,10,0,15,5
1668251573302,MATH 275,A01,098048,Tian; Xiaochuan,6,0,10,4
1668251573727,MATH 278A,A00,098049,Holst; Michael J,8,0,10,2
1668251574152,MATH 278B,A00,098050,Cloninger; Alexander,10,0,10,0
1668251574577,MATH 278C,A00,098051,Nie; Jiawang,7,0,10,3
1668251574999,MATH 280B,A00,098052,Zheng; Tianyi,9,0,15,6
1668251575431,MATH 281B,A00,098053,Bradic; Jelena,1,0,15,14
1668251575857,MATH 282B,A00,098054,Arias-Castro; Ery,0,0,15,15
1668251576284,MATH 285,A00,098055,Fitzsimmons; Patrick J,0,0,15,17
1668251576710,MATH 287B,A00,098056,Arias-Castro; Ery,2,0,15,13
1668251577140,MATH 288,A00,098057,Agarwal; Pooja,9,0,10,1
1668251577140,MATH 288,B00,098058,Zhang; Danna,8,0,10,2
1668251577140,MATH 288,C00,098059,Williams; Ruth J,10,0,10,0
1668251577564,MATH 290B,A00,098060,Roberts; Justin Deritter,13,0,15,2
1668251577990,MATH 292,A00,098061,Belmont; Eva Kinoshita,10,0,10,0
1668251578414,MATH 295,A00,098062,Suk; Andrew Hoon,48,0,50,2
1668251578837,MATH 296,A00,098063,Novak; Jonathan I,20,0,20,0
1668251579259,MATH 297,001,098064,Gamst; Anthony Collins,9997,0,9999,2
1668252080465,COGS 205,A00,101395,Chiba; Andrea,19,0,20,1
1668252080898,COGS 210B,001,101404,Greene; Deanna Jacquelyn,9998,0,9999,1
1668252080898,COGS 210B,002,101417,Xia; Haijun,9999,0,9999,0
1668252080898,COGS 210B,003,101422,Nitz; Douglas A.,9999,0,9999,0
1668252080898,COGS 210B,004,101423,Hollan; James D.,9998,0,9999,1
1668252080898,COGS 210B,005,101424,Deak; Gedeon O.,9998,0,9999,1
1668252080898,COGS 210B,006,101425,Rossano; Federico,9999,0,9999,0
1668252081324,COGS 211B,A00,101427,Coulson; Seana M,9996,0,9999,3
1668252081749,COGS 220,A00,101428,Hollan; James D.,0,0,25,25
1668252082179,COGS 229,A00,101429,Dow; Steven P,18,0,25,7
1668252082607,COGS 230,A00,101430,Klemmer; Scott R,12,0,17,5
1668252083042,COGS 234,A00,101431,Xia; Haijun,2,0,25,23
1668252083472,COGS 260,A00,101432,Kiyonaga; Anastasia,21,0,25,4
1668252083472,COGS 260,B00,101433,Kirsh; David Joel,15,0,25,10
1668252083897,CSE 202,A00,102371,Impagliazzo; Russell,0,0,0,0
1668252084399,CSE 203B,A01,102373,Cheng; Chung Kuan,0,0,0,0
1668252084821,CSE 208,A00,102374,Micciancio; Daniele,0,0,0,0
1668252085245,CSE 209A,A00,112895,Impagliazzo; Russell,0,0,15,15
1668252085674,CSE 209B,A00,108005,Bellare; Mihir,0,0,0,0
1668252086101,CSE 210,A00,113163,Coblenz; Michael J,0,0,0,0
1668252086528,CSE 219,A00,106111,Dow; Steven P,0,0,20,20
1668252086959,CSE 221,A00,102376,Voelker; Geoffrey M.,0,0,0,0
1668252087385,CSE 224,A01,102378,Porter; George M,0,0,0,0
1668252087809,CSE 229A,A00,102379,Savage; Stefan,0,0,0,0
1668252088233,CSE 229C,A00,102380,Munyaka; Imani N. S.,0,0,0,0
1668252088660,CSE 232B,A00,102382,Deutsch; Alin Bernard,0,0,0,0
1668252089085,CSE 234,A01,112904,Kumar; Arun Kumar,0,0,0,0
1668252089510,CSE 237A,A00,102383,Rosing; Tajana Simunic,0,0,0,0
1668252089934,CSE 239A,A00,102384,Deutsch; Alin Bernard,0,0,0,0
1668252090357,CSE 239B,A00,102385,Polikarpova; Nadezhda,0,0,0,0
1668252090796,CSE 240A,A00,102386,Pannuto; Patrick William,0,0,0,0
1668252091223,CSE 240B,A00,102387,Zhao; Jishen,0,0,0,0
1668252091647,CSE 241A,A00,106406,Kang; Mingu,0,0,0,0
1668252092072,CSE 249B,A00,102388,Kahng; Andrew Byun,0,0,8,8
1668252092497,CSE 251B,A01,102392,Cottrell; Garrison W,0,0,0,0
1668252092497,CSE 251B,A02,102393,Cottrell; Garrison W,0,0,0,0
1668252092925,CSE 252B,A00,102394,Ochoa; Benjamin Lawrence,0,0,0,0
1668252093351,CSE 257,A01,102396,Gao; Sicun,0,0,0,0
1668252093777,CSE 272,A00,102397,Li; Tzumao,0,0,0,0
1668252094200,CSE 274,A00,111323,Chern; Albert Ren-Haur,0,0,0,0
1668252094626,CSE 282,A00,102398,Pevzner; Pavel Arkadjevich,0,0,0,0
1668252095067,CSE 284,A00,114175,Gymrek; Melissa Ann,0,0,0,0
1668252095500,CSE 290,A00,102399,Chandraker; Manmohan Krishna,0,0,0,0
1668252095500,CSE 290,B00,102400,Vaccaro; Kristen Marie,0,0,25,25
1668252095500,CSE 290,C00,102414,Pannuto; Patrick William,0,0,25,25
1668252095500,CSE 290,D00,102427,Pevzner; Pavel Arkadjevich,0,0,0,0
1668252095500,CSE 290,E00,102429,Zhao; Jishen,0,0,0,0
1668252095500,CSE 290,F00,102436,Tullsen; Dean Michael,0,0,0,0
1668252095500,CSE 290,G00,102440,Christensen; Henrik I,0,0,20,20
1668252095934,CSE 291,A00,102443,Su; Hao,0,0,0,0
1668252095934,CSE 291,B00,102448,Polikarpova; Nadezhda,0,0,0,0
1668252095934,CSE 291,C00,102453,Vaccaro; Kristen Marie,0,0,0,0
1668252095934,CSE 291,D00,111343,Savage; Stefan,0,0,0,0
1668252095934,CSE 291,E00,116474,Claffy; Kimberly Claire,0,0,0,0
1668252095934,CSE 291,F00,116479,Pasquale; Joseph,0,0,0,0
1668252096375,CSE 293,001,119111,Bafna; Vineet,9999,0,9999,0
1668252096375,CSE 293,002,119118,Bellare; Mihir,9999,0,9999,0
1668252096375,CSE 293,003,119122,Berg-Kirkpatrick; Taylor D,9999,0,9999,0
1668252096375,CSE 293,004,119135,Christensen; Henrik I,9999,0,9999,0
1668252096375,CSE 293,005,119142,Cottrell; Garrison W,9999,0,9999,0
1668252096375,CSE 293,006,119146,Deutsch; Alin Bernard,9999,0,9999,0
1668252096375,CSE 293,007,119159,Esmaeilzadeh; Hadi,9999,0,9999,0
1668252096375,CSE 293,008,119166,Freund; Yoav,9999,0,9999,0
1668252096375,CSE 293,009,119170,Griswold; William G.,9999,0,9999,0
1668252096375,CSE 293,010,119183,Gymrek; Melissa Ann,9999,0,9999,0
1668252096375,CSE 293,011,119190,Heninger; Nadia A,9999,0,9999,0
1668252096375,CSE 293,012,119230,Impagliazzo; Russell,9999,0,9999,0
1668252096375,CSE 293,013,119232,Jhala; Ranjit,9999,0,9999,0
1668252096375,CSE 293,014,119233,Kahng; Andrew Byun,9999,0,9999,0
1668252096375,CSE 293,015,119298,Kane; Daniel Mertz,9999,0,9999,0
1668252096375,CSE 293,016,119299,Kriegman; David J,9999,0,9999,0
1668252096375,CSE 293,017,119300,Kumar; Arun Kumar,9999,0,9999,0
1668252096375,CSE 293,018,119301,Lerner; Sorin,9999,0,9999,0
1668252096375,CSE 293,019,119302,Lovett; Shachar,9999,0,9999,0
1668252096375,CSE 293,020,119303,McAuley; Julian John,9999,0,9999,0
1668252096375,CSE 293,021,119304,Micciancio; Daniele,9999,0,9999,0
1668252096375,CSE 293,022,119367,Orailoglu; Alex,9999,0,9999,0
1668252096375,CSE 293,023,119382,Paturi; Ramamohan,9999,0,9999,0
1668252096375,CSE 293,024,119404,Polikarpova; Nadezhda,9999,0,9999,0
1668252096375,CSE 293,025,119406,Politz; Joseph Gibbs,9999,0,9999,0
1668252096375,CSE 293,026,119411,Porter; George M,9999,0,9999,0
1668252096375,CSE 293,027,119414,Porter; Leonard Emerson,9999,0,9999,0
1668252096375,CSE 293,028,119416,Ramamoorthi; Ravi,9999,0,9999,0
1668252096375,CSE 293,029,119417,Sahoo; Debashis,9999,0,9999,0
1668252096375,CSE 293,030,119420,Saul; Lawrence,9999,0,9999,0
1668252096375,CSE 293,031,119421,Savage; Stefan,9999,0,9999,0
1668252096375,CSE 293,032,119425,Schulze; Jurgen P.,9999,0,9999,0
1668252096375,CSE 293,033,119426,Snoeren; Alex C.,9999,0,9999,0
1668252096375,CSE 293,034,119428,Shang; Jingbo,9999,0,9999,0
1668252096375,CSE 293,035,119430,Stefan; Deian,9999,0,9999,0
1668252096375,CSE 293,036,119431,Su; Hao,9999,0,9999,0
1668252096375,CSE 293,037,119433,Swanson; Steven James,9999,0,9999,0
1668252096375,CSE 293,038,119435,Tullsen; Dean Michael,9999,0,9999,0
1668252096375,CSE 293,039,119483,Voelker; Geoffrey M.,9999,0,9999,0
1668252096375,CSE 293,040,119537,Zhao; Jishen,9999,0,9999,0
1668252096375,CSE 293,041,119538,Zhou; Yuan-Yuan,9999,0,9999,0
1668252096375,CSE 293,042,119539,Gao; Sicun,9999,0,9999,0
1668252096375,CSE 293,043,119540,Weibel; Nadir,9999,0,9999,0
1668252096375,CSE 293,044,119541,Gupta; Rajesh K.,9999,0,9999,0
1668252096375,CSE 293,045,126410,Vaccaro; Kristen Marie,9999,0,9999,0
1668252096375,CSE 293,046,126411,Klemke; Richard,9999,0,9999,0
1668252096802,CSE 294,A00,102459,Voelker; Geoffrey M.,0,0,0,0
1668252096802,CSE 294,B00,111322,Orailoglu; Alex,0,0,0,0
1668252097231,DSE 201,A00,096914,Deutsch; Alin Bernard,30,0,30,0
1668252097661,DSE 210,A00,096915,Dasgupta; Sanjoy,30,0,30,0
1668252098091,DSE 260A,A00,096916,Altintas De Callaf; Ilkay,30,0,30,0
1668252098544,ECE 200,001,103586,Antipa; Nicholas A,9999,0,9999,0
1668252098544,ECE 200,002,103587,Atanasov; Nikolay A.,9999,0,9999,0
1668252098544,ECE 200,003,103588,Bharadia; Dinesh,9999,0,9999,0
1668252098544,ECE 200,004,103589,Cheng; Chung Kuan,9999,0,9999,0
1668252098544,ECE 200,005,103590,Cosman; Pamela C.,9999,0,9999,0
1668252098544,ECE 200,006,103591,Dayeh; Shadi Ahmad,9999,0,9999,0
1668252098544,ECE 200,007,103592,Fainman; Yeshaiahu,9999,0,9999,0
1668252098544,ECE 200,008,103593,Ford; Joseph Earl,9999,0,9999,0
1668252098544,ECE 200,009,103594,Franceschetti; Massimo,9999,0,9999,0
1668252098544,ECE 200,010,103595,Fullerton; Eric E,9999,0,9999,0
1668252098544,ECE 200,011,103596,Galton; Ian A,9999,0,9999,0
1668252098544,ECE 200,012,103597,Gilja; Vikash,9999,0,9999,0
1668252098544,ECE 200,013,103598,Hall; Drew A.,9999,0,9999,0
1668252098544,ECE 200,014,103599,Hsueh; Tzu-Chien,9999,0,9999,0
1668252098544,ECE 200,015,103600,Javidi; Tara,9999,0,9999,0
1668252098544,ECE 200,016,103601,Kahng; Andrew Byun,9999,0,9999,0
1668252098544,ECE 200,017,103602,Kim; Young-Han,9999,0,9999,0
1668252098544,ECE 200,018,103603,Koushanfar; Farinaz,9999,0,9999,0
1668252098544,ECE 200,019,103604,Kuzum; Duygu,9999,0,9999,0
1668252098544,ECE 200,020,103605,Le; Hanh-Phuc,9999,0,9999,0
1668252098544,ECE 200,021,103606,Lin; Bill,9999,0,9999,0
1668252098544,ECE 200,022,103607,Liu; Zhaowei,9998,0,9999,1
1668252098544,ECE 200,023,103608,Lo; Yu-Hwa,9999,0,9999,0
1668252098544,ECE 200,024,103609,Lomakin; Vitaliy,9999,0,9999,0
1668252098544,ECE 200,025,103610,Mercier; Patrick Philip,9999,0,9999,0
1668252098544,ECE 200,026,103611,Meyer; Florian,9999,0,9999,0
1668252098544,ECE 200,027,103612,Milstein; Laurence B.,9999,0,9999,0
1668252098544,ECE 200,028,103613,Mir Arabbaygi; Siavash,9999,0,9999,0
1668252098544,ECE 200,029,103614,Mookherjea; Shayan,9999,0,9999,0
1668252098544,ECE 200,030,103615,Morris; Karcher William,9999,0,9999,0
1668252098544,ECE 200,031,103616,Ng; Tse Nga,9999,0,9999,0
1668252098544,ECE 200,032,103617,Nguyen; Truong Quang,9999,0,9999,0
1668252098544,ECE 200,033,103618,Nomura; Kenji,9999,0,9999,0
1668252098544,ECE 200,034,103619,Orlitsky; Alon,9999,0,9999,0
1668252098544,ECE 200,035,103620,Pal; Piya,9999,0,9999,0
1668252098544,ECE 200,036,103621,Papen; George C.,9999,0,9999,0
1668252098544,ECE 200,037,103622,Radic; Stojan,9999,0,9999,0
1668252098544,ECE 200,038,103623,Rao; Bhaskar D.,9999,0,9999,0
1668252098544,ECE 200,039,103624,Rao; Ramesh R,9999,0,9999,0
1668252098544,ECE 200,040,103625,Rebeiz; Gabriel,9999,0,9999,0
1668252098544,ECE 200,041,103626,Sanford; John R,9999,0,9999,0
1668252098544,ECE 200,042,103627,Siegel; Paul H.,9999,0,9999,0
1668252098544,ECE 200,043,103628,Sievenpiper; Daniel F.,9999,0,9999,0
1668252098544,ECE 200,044,103629,Sworder; David D.,9999,0,9999,0
1668252098544,ECE 200,045,103630,Taur; Yuan,9999,0,9999,0
1668252098544,ECE 200,046,103631,Touri; Behrouz,9999,0,9999,0
1668252098544,ECE 200,047,103632,Trivedi; Mohan M.,9999,0,9999,0
1668252098544,ECE 200,048,103633,Vasconcelos; Nuno,9999,0,9999,0
1668252098544,ECE 200,049,103634,Wang; Xiaolong,9999,0,9999,0
1668252098544,ECE 200,050,103635,Xie; Pengtao,9999,0,9999,0
1668252098544,ECE 200,051,103636,Yip; Michael,9999,0,9999,0
1668252098544,ECE 200,052,103637,Zeger; Kenneth A.,999,0,999,0
1668252098544,ECE 200,053,103638,Zhang; Xinyu,9999,0,9999,0
1668252098544,ECE 200,054,103639,Turakhia; Yatish Girish,9999,0,9999,0
1668252098544,ECE 200,055,103640,Kang; Mingu,9999,0,9999,0
1668252098544,ECE 200,056,103641,Shi; Yuanyuan,9999,0,9999,0
1668252098544,ECE 200,057,103642,Wang; Edward Jay,9999,0,9999,0
1668252098544,ECE 200,058,103643,Zheng; Yang,9999,0,9999,0
1668252098971,ECE 202,A00,103644,Kuzum; Duygu,0,0,0,0
1668252099394,ECE 212BN,A00,103646,Ng; Tse Nga,0,0,0,0
1668252099817,ECE 221,A00,111493,Staff,0,0,0,0
1668252100245,ECE 222B,A00,103647,Lomakin; Vitaliy,0,0,0,0
1668252100680,ECE 230B,A00,103648,Taur; Yuan,0,0,0,0
1668252101114,ECE 238B,A00,103649,Garay; Javier,0,0,0,0
1668252101536,ECE 240B,A00,112900,Fainman; Yeshaiahu,0,0,0,0
1668252101963,ECE 247A,A00,103650,Jokerst; Jesse Vincent,0,0,0,0
1668252102389,ECE 247B,A00,103651,Wang; Joseph,0,0,0,0
1668252102815,ECE 250,A00,103652,Siegel; Paul H.,0,0,0,0
1668252103239,ECE 251A,A00,103654,Rao; Bhaskar D.,0,0,0,0
1668252103667,ECE 257B,A00,103655,Bharadia; Dinesh,0,0,0,0
1668252104093,ECE 258A,A00,103656,Milstein; Laurence B.,0,0,0,0
1668252104519,ECE 260B,A00,103658,Kang; Mingu,0,0,0,0
1668252104947,ECE 264A,A00,103659,Galton; Ian A,0,0,0,0
1668252105375,ECE 265A,A00,103661,Gudem; Prasad S.S.,0,0,0,0
1668252105798,ECE 265D,A00,103662,Gudem; Prasad S.S.,0,0,0,0
1668252106222,ECE 268,A00,103663,Koushanfar; Farinaz,0,0,0,0
1668252106650,ECE 269,A01,103665,Pal; Piya,0,0,0,0
1668252107082,ECE 271B,A00,103666,Vasconcelos; Manuela,0,0,0,0
1668252107511,ECE 276A,A00,103667,Atanasov; Nikolay A.,0,0,0,0
1668252107936,ECE 277,A00,103668,An; Cheolhong,0,0,0,0
1668252108364,ECE 279,A00,117947,Hall; Drew A.,0,0,0,0
1668252109215,ECE 283,A00,103670,Hsueh; Tzu-Chien,0,0,0,0
1668252109650,ECE 284,A00,103671,Turakhia; Yatish Girish,0,0,0,0
1668252110074,ECE 285,A00,103672,Zheng; Yang,0,0,0,0
1668252110074,ECE 285,B00,103673,Sworder; David D.,0,0,0,0
1668252110504,ECE 287,A00,103676,Javidi; Tara,0,0,0,0
1668252110929,MATH 200B,A00,098023,Salehi Golsefidy; Alireza,12,0,15,3
1668252111355,MATH 202B,A00,098024,Rhoades; Brendon Patrick,9,0,15,6
1668252111783,MATH 203B,A00,098025,Oprea; Dragos N.,10,0,15,5
1668252112207,MATH 204B,A00,098026,Sorensen; Claus M,13,0,15,2
1668252112632,MATH 208,A00,098027,Izadi; Elham,7,0,10,3
1668252113056,MATH 209,A00,098028,Pollack; Aaron,10,0,10,0
1668252113479,MATH 211A,A00,112919,Rogalski; Daniel,9,0,10,1
1668252113903,MATH 211B,A00,112920,Seward; Brandon M.,9,0,10,1
1668252114333,MATH 218,A00,098029,Li; Bo,10,0,10,0
1668252114759,MATH 220B,A00,098030,Novak; Jonathan I,11,0,15,4
1668252115183,MATH 221A,A00,098031,Ebenfelt; Peter F,13,0,15,2
1668252115613,MATH 231B,A00,098032,Zlatos; Andrej,12,0,15,3
1668252116043,MATH 240B,A00,098033,Ni; Lei,9,0,15,6
1668252116465,MATH 243,A00,098034,Jekel; David Andrew,10,0,10,0
1668252116889,MATH 245A,A00,098035,Nie; Jiawang,0,0,15,16
1668252117317,MATH 248,A00,098036,Bejenaru; Ioan,10,0,10,0
1668252117746,MATH 250B,A00,098037,Spolaor; Luca,14,0,15,1
1668252118169,MATH 258,A00,098038,Ni; Lei,10,0,10,0
1668252118592,MATH 264B,A00,098041,Rhoades; Brendon Patrick,9,0,15,6
1668252119018,MATH 268,A00,098042,Buss; Samuel R,10,0,10,0
1668252119442,MATH 269,A00,098043,Rhoades; Brendon Patrick,10,0,10,0
1668252119871,MATH 270B,A00,098044,Li; Bo,10,0,15,5
1668252120303,MATH 272B,A00,098045,Holst; Michael J,13,0,15,2
1668252120733,MATH 273A,A00,098046,Tian; Xiaochuan,10,0,15,5
1668252121161,MATH 275,A01,098048,Tian; Xiaochuan,6,0,10,4
1668252121585,MATH 278A,A00,098049,Holst; Michael J,8,0,10,2
1668252122009,MATH 278B,A00,098050,Cloninger; Alexander,10,0,10,0
1668252122433,MATH 278C,A00,098051,Nie; Jiawang,7,0,10,3
1668252122857,MATH 280B,A00,098052,Zheng; Tianyi,9,0,15,6
1668252123282,MATH 281B,A00,098053,Bradic; Jelena,1,0,15,14
1668252123708,MATH 282B,A00,098054,Arias-Castro; Ery,0,0,15,15
1668252124132,MATH 285,A00,098055,Fitzsimmons; Patrick J,0,0,15,17
1668252124557,MATH 287B,A00,098056,Arias-Castro; Ery,2,0,15,13
1668252124981,MATH 288,A00,098057,Agarwal; Pooja,9,0,10,1
1668252124981,MATH 288,B00,098058,Zhang; Danna,8,0,10,2
1668252124981,MATH 288,C00,098059,Williams; Ruth J,10,0,10,0
1668252125414,MATH 290B,A00,098060,Roberts; Justin Deritter,13,0,15,2
1668252125840,MATH 292,A00,098061,Belmont; Eva Kinoshita,10,0,10,0
1668252126263,MATH 295,A00,098062,Suk; Andrew Hoon,48,0,50,2
1668252126690,MATH 296,A00,098063,Novak; Jonathan I,20,0,20,0
1668252127115,MATH 297,001,098064,Gamst; Anthony Collins,9997,0,9999,2
1668252628456,COGS 205,A00,101395,Chiba; Andrea,19,0,20,1
1668252628883,COGS 210B,001,101404,Greene; Deanna Jacquelyn,9998,0,9999,1
1668252628883,COGS 210B,002,101417,Xia; Haijun,9999,0,9999,0
1668252628883,COGS 210B,003,101422,Nitz; Douglas A.,9999,0,9999,0
1668252628883,COGS 210B,004,101423,Hollan; James D.,9998,0,9999,1
1668252628883,COGS 210B,005,101424,Deak; Gedeon O.,9998,0,9999,1
1668252628883,COGS 210B,006,101425,Rossano; Federico,9999,0,9999,0
1668252629315,COGS 211B,A00,101427,Coulson; Seana M,9996,0,9999,3
1668252629748,COGS 220,A00,101428,Hollan; James D.,0,0,25,25
1668252630176,COGS 229,A00,101429,Dow; Steven P,18,0,25,7
1668252630604,COGS 230,A00,101430,Klemmer; Scott R,12,0,17,5
1668252631031,COGS 234,A00,101431,Xia; Haijun,2,0,25,23
1668252631456,COGS 260,A00,101432,Kiyonaga; Anastasia,21,0,25,4
1668252631456,COGS 260,B00,101433,Kirsh; David Joel,15,0,25,10
1668252631882,CSE 202,A00,102371,Impagliazzo; Russell,0,0,0,0
1668252632306,CSE 203B,A01,102373,Cheng; Chung Kuan,0,0,0,0
1668252632734,CSE 208,A00,102374,Micciancio; Daniele,0,0,0,0
1668252633169,CSE 209A,A00,112895,Impagliazzo; Russell,0,0,15,15
1668252633615,CSE 209B,A00,108005,Bellare; Mihir,0,0,0,0
1668252634068,CSE 210,A00,113163,Coblenz; Michael J,0,0,0,0
1668252634495,CSE 219,A00,106111,Dow; Steven P,0,0,20,20
1668252634930,CSE 221,A00,102376,Voelker; Geoffrey M.,0,0,0,0
1668252635373,CSE 224,A01,102378,Porter; George M,0,0,0,0
1668252635802,CSE 229A,A00,102379,Savage; Stefan,0,0,0,0
1668252636234,CSE 229C,A00,102380,Munyaka; Imani N. S.,0,0,0,0
1668252636659,CSE 232B,A00,102382,Deutsch; Alin Bernard,0,0,0,0
1668252637089,CSE 234,A01,112904,Kumar; Arun Kumar,0,0,0,0
1668252637523,CSE 237A,A00,102383,Rosing; Tajana Simunic,0,0,0,0
1668252637954,CSE 239A,A00,102384,Deutsch; Alin Bernard,0,0,0,0
1668252638380,CSE 239B,A00,102385,Polikarpova; Nadezhda,0,0,0,0
1668252638809,CSE 240A,A00,102386,Pannuto; Patrick William,0,0,0,0
1668252639232,CSE 240B,A00,102387,Zhao; Jishen,0,0,0,0
1668252639657,CSE 241A,A00,106406,Kang; Mingu,0,0,0,0
1668252640086,CSE 249B,A00,102388,Kahng; Andrew Byun,0,0,8,8
1668252640518,CSE 251B,A01,102392,Cottrell; Garrison W,0,0,0,0
1668252640518,CSE 251B,A02,102393,Cottrell; Garrison W,0,0,0,0
1668252640945,CSE 252B,A00,102394,Ochoa; Benjamin Lawrence,0,0,0,0
1668252641371,CSE 257,A01,102396,Gao; Sicun,0,0,0,0
1668252641796,CSE 272,A00,102397,Li; Tzumao,0,0,0,0
1668252642220,CSE 274,A00,111323,Chern; Albert Ren-Haur,0,0,0,0
1668252642643,CSE 282,A00,102398,Pevzner; Pavel Arkadjevich,0,0,0,0
1668252643068,CSE 284,A00,114175,Gymrek; Melissa Ann,0,0,0,0
1668252643495,CSE 290,A00,102399,Chandraker; Manmohan Krishna,0,0,0,0
1668252643495,CSE 290,B00,102400,Vaccaro; Kristen Marie,0,0,25,25
1668252643495,CSE 290,C00,102414,Pannuto; Patrick William,0,0,25,25
1668252643495,CSE 290,D00,102427,Pevzner; Pavel Arkadjevich,0,0,0,0
1668252643495,CSE 290,E00,102429,Zhao; Jishen,0,0,0,0
1668252643495,CSE 290,F00,102436,Tullsen; Dean Michael,0,0,0,0
1668252643495,CSE 290,G00,102440,Christensen; Henrik I,0,0,20,20
1668252643930,CSE 291,A00,102443,Su; Hao,0,0,0,0
1668252643930,CSE 291,B00,102448,Polikarpova; Nadezhda,0,0,0,0
1668252643930,CSE 291,C00,102453,Vaccaro; Kristen Marie,0,0,0,0
1668252643930,CSE 291,D00,111343,Savage; Stefan,0,0,0,0
1668252643930,CSE 291,E00,116474,Claffy; Kimberly Claire,0,0,0,0
1668252643930,CSE 291,F00,116479,Pasquale; Joseph,0,0,0,0
1668252644385,CSE 293,001,119111,Bafna; Vineet,9999,0,9999,0
1668252644385,CSE 293,002,119118,Bellare; Mihir,9999,0,9999,0
1668252644385,CSE 293,003,119122,Berg-Kirkpatrick; Taylor D,9999,0,9999,0
1668252644385,CSE 293,004,119135,Christensen; Henrik I,9999,0,9999,0
1668252644385,CSE 293,005,119142,Cottrell; Garrison W,9999,0,9999,0
1668252644385,CSE 293,006,119146,Deutsch; Alin Bernard,9999,0,9999,0
1668252644385,CSE 293,007,119159,Esmaeilzadeh; Hadi,9999,0,9999,0
1668252644385,CSE 293,008,119166,Freund; Yoav,9999,0,9999,0
1668252644385,CSE 293,009,119170,Griswold; William G.,9999,0,9999,0
1668252644385,CSE 293,010,119183,Gymrek; Melissa Ann,9999,0,9999,0
1668252644385,CSE 293,011,119190,Heninger; Nadia A,9999,0,9999,0
1668252644385,CSE 293,012,119230,Impagliazzo; Russell,9999,0,9999,0
1668252644385,CSE 293,013,119232,Jhala; Ranjit,9999,0,9999,0
1668252644385,CSE 293,014,119233,Kahng; Andrew Byun,9999,0,9999,0
1668252644385,CSE 293,015,119298,Kane; Daniel Mertz,9999,0,9999,0
1668252644385,CSE 293,016,119299,Kriegman; David J,9999,0,9999,0
1668252644385,CSE 293,017,119300,Kumar; Arun Kumar,9999,0,9999,0
1668252644385,CSE 293,018,119301,Lerner; Sorin,9999,0,9999,0
1668252644385,CSE 293,019,119302,Lovett; Shachar,9999,0,9999,0
1668252644385,CSE 293,020,119303,McAuley; Julian John,9999,0,9999,0
1668252644385,CSE 293,021,119304,Micciancio; Daniele,9999,0,9999,0
1668252644385,CSE 293,022,119367,Orailoglu; Alex,9999,0,9999,0
1668252644385,CSE 293,023,119382,Paturi; Ramamohan,9999,0,9999,0
1668252644385,CSE 293,024,119404,Polikarpova; Nadezhda,9999,0,9999,0
1668252644385,CSE 293,025,119406,Politz; Joseph Gibbs,9999,0,9999,0
1668252644385,CSE 293,026,119411,Porter; George M,9999,0,9999,0
1668252644385,CSE 293,027,119414,Porter; Leonard Emerson,9999,0,9999,0
1668252644385,CSE 293,028,119416,Ramamoorthi; Ravi,9999,0,9999,0
1668252644385,CSE 293,029,119417,Sahoo; Debashis,9999,0,9999,0
1668252644385,CSE 293,030,119420,Saul; Lawrence,9999,0,9999,0
1668252644385,CSE 293,031,119421,Savage; Stefan,9999,0,9999,0
1668252644385,CSE 293,032,119425,Schulze; Jurgen P.,9999,0,9999,0
1668252644385,CSE 293,033,119426,Snoeren; Alex C.,9999,0,9999,0
1668252644385,CSE 293,034,119428,Shang; Jingbo,9999,0,9999,0
1668252644385,CSE 293,035,119430,Stefan; Deian,9999,0,9999,0
1668252644385,CSE 293,036,119431,Su; Hao,9999,0,9999,0
1668252644385,CSE 293,037,119433,Swanson; Steven James,9999,0,9999,0
1668252644385,CSE 293,038,119435,Tullsen; Dean Michael,9999,0,9999,0
1668252644385,CSE 293,039,119483,Voelker; Geoffrey M.,9999,0,9999,0
1668252644385,CSE 293,040,119537,Zhao; Jishen,9999,0,9999,0
1668252644385,CSE 293,041,119538,Zhou; Yuan-Yuan,9999,0,9999,0
1668252644385,CSE 293,042,119539,Gao; Sicun,9999,0,9999,0
1668252644385,CSE 293,043,119540,Weibel; Nadir,9999,0,9999,0
1668252644385,CSE 293,044,119541,Gupta; Rajesh K.,9999,0,9999,0
1668252644385,CSE 293,045,126410,Vaccaro; Kristen Marie,9999,0,9999,0
1668252644385,CSE 293,046,126411,Klemke; Richard,9999,0,9999,0
1668252644814,CSE 294,A00,102459,Voelker; Geoffrey M.,0,0,0,0
1668252644814,CSE 294,B00,111322,Orailoglu; Alex,0,0,0,0
1668252645238,DSE 201,A00,096914,Deutsch; Alin Bernard,30,0,30,0
1668252645660,DSE 210,A00,096915,Dasgupta; Sanjoy,30,0,30,0
1668252646086,DSE 260A,A00,096916,Altintas De Callaf; Ilkay,30,0,30,0
1668252646538,ECE 200,001,103586,Antipa; Nicholas A,9999,0,9999,0
1668252646538,ECE 200,002,103587,Atanasov; Nikolay A.,9999,0,9999,0
1668252646538,ECE 200,003,103588,Bharadia; Dinesh,9999,0,9999,0
1668252646538,ECE 200,004,103589,Cheng; Chung Kuan,9999,0,9999,0
1668252646538,ECE 200,005,103590,Cosman; Pamela C.,9999,0,9999,0
1668252646538,ECE 200,006,103591,Dayeh; Shadi Ahmad,9999,0,9999,0
1668252646538,ECE 200,007,103592,Fainman; Yeshaiahu,9999,0,9999,0
1668252646538,ECE 200,008,103593,Ford; Joseph Earl,9999,0,9999,0
1668252646538,ECE 200,009,103594,Franceschetti; Massimo,9999,0,9999,0
1668252646538,ECE 200,010,103595,Fullerton; Eric E,9999,0,9999,0
1668252646538,ECE 200,011,103596,Galton; Ian A,9999,0,9999,0
1668252646538,ECE 200,012,103597,Gilja; Vikash,9999,0,9999,0
1668252646538,ECE 200,013,103598,Hall; Drew A.,9999,0,9999,0
1668252646538,ECE 200,014,103599,Hsueh; Tzu-Chien,9999,0,9999,0
1668252646538,ECE 200,015,103600,Javidi; Tara,9999,0,9999,0
1668252646538,ECE 200,016,103601,Kahng; Andrew Byun,9999,0,9999,0
1668252646538,ECE 200,017,103602,Kim; Young-Han,9999,0,9999,0
1668252646538,ECE 200,018,103603,Koushanfar; Farinaz,9999,0,9999,0
1668252646538,ECE 200,019,103604,Kuzum; Duygu,9999,0,9999,0
1668252646538,ECE 200,020,103605,Le; Hanh-Phuc,9999,0,9999,0
1668252646538,ECE 200,021,103606,Lin; Bill,9999,0,9999,0
1668252646538,ECE 200,022,103607,Liu; Zhaowei,9998,0,9999,1
1668252646538,ECE 200,023,103608,Lo; Yu-Hwa,9999,0,9999,0
1668252646538,ECE 200,024,103609,Lomakin; Vitaliy,9999,0,9999,0
1668252646538,ECE 200,025,103610,Mercier; Patrick Philip,9999,0,9999,0
1668252646538,ECE 200,026,103611,Meyer; Florian,9999,0,9999,0
1668252646538,ECE 200,027,103612,Milstein; Laurence B.,9999,0,9999,0
1668252646538,ECE 200,028,103613,Mir Arabbaygi; Siavash,9999,0,9999,0
1668252646538,ECE 200,029,103614,Mookherjea; Shayan,9999,0,9999,0
1668252646538,ECE 200,030,103615,Morris; Karcher William,9999,0,9999,0
1668252646538,ECE 200,031,103616,Ng; Tse Nga,9999,0,9999,0
1668252646538,ECE 200,032,103617,Nguyen; Truong Quang,9999,0,9999,0
1668252646538,ECE 200,033,103618,Nomura; Kenji,9999,0,9999,0
1668252646538,ECE 200,034,103619,Orlitsky; Alon,9999,0,9999,0
1668252646538,ECE 200,035,103620,Pal; Piya,9999,0,9999,0
1668252646538,ECE 200,036,103621,Papen; George C.,9999,0,9999,0
1668252646538,ECE 200,037,103622,Radic; Stojan,9999,0,9999,0
1668252646538,ECE 200,038,103623,Rao; Bhaskar D.,9999,0,9999,0
1668252646538,ECE 200,039,103624,Rao; Ramesh R,9999,0,9999,0
1668252646538,ECE 200,040,103625,Rebeiz; Gabriel,9999,0,9999,0
1668252646538,ECE 200,041,103626,Sanford; John R,9999,0,9999,0
1668252646538,ECE 200,042,103627,Siegel; Paul H.,9999,0,9999,0
1668252646538,ECE 200,043,103628,Sievenpiper; Daniel F.,9999,0,9999,0
1668252646538,ECE 200,044,103629,Sworder; David D.,9999,0,9999,0
1668252646538,ECE 200,045,103630,Taur; Yuan,9999,0,9999,0
1668252646538,ECE 200,046,103631,Touri; Behrouz,9999,0,9999,0
1668252646538,ECE 200,047,103632,Trivedi; Mohan M.,9999,0,9999,0
1668252646538,ECE 200,048,103633,Vasconcelos; Nuno,9999,0,9999,0
1668252646538,ECE 200,049,103634,Wang; Xiaolong,9999,0,9999,0
1668252646538,ECE 200,050,103635,Xie; Pengtao,9999,0,9999,0
1668252646538,ECE 200,051,103636,Yip; Michael,9999,0,9999,0
1668252646538,ECE 200,052,103637,Zeger; Kenneth A.,999,0,999,0
1668252646538,ECE 200,053,103638,Zhang; Xinyu,9999,0,9999,0
1668252646538,ECE 200,054,103639,Turakhia; Yatish Girish,9999,0,9999,0
1668252646538,ECE 200,055,103640,Kang; Mingu,9999,0,9999,0
1668252646538,ECE 200,056,103641,Shi; Yuanyuan,9999,0,9999,0
1668252646538,ECE 200,057,103642,Wang; Edward Jay,9999,0,9999,0
1668252646538,ECE 200,058,103643,Zheng; Yang,9999,0,9999,0
1668252646965,ECE 202,A00,103644,Kuzum; Duygu,0,0,0,0
1668252647390,ECE 212BN,A00,103646,Ng; Tse Nga,0,0,0,0
1668252647827,ECE 221,A00,111493,Staff,0,0,0,0
1668252648251,ECE 222B,A00,103647,Lomakin; Vitaliy,0,0,0,0
1668252648676,ECE 230B,A00,103648,Taur; Yuan,0,0,0,0
1668252649190,ECE 238B,A00,103649,Garay; Javier,0,0,0,0
1668252649615,ECE 240B,A00,112900,Fainman; Yeshaiahu,0,0,0,0
1668252650046,ECE 247A,A00,103650,Jokerst; Jesse Vincent,0,0,0,0
1668252650474,ECE 247B,A00,103651,Wang; Joseph,0,0,0,0
1668252650901,ECE 250,A00,103652,Siegel; Paul H.,0,0,0,0
1668252651341,ECE 251A,A00,103654,Rao; Bhaskar D.,0,0,0,0
1668252651768,ECE 257B,A00,103655,Bharadia; Dinesh,0,0,0,0
1668252652197,ECE 258A,A00,103656,Milstein; Laurence B.,0,0,0,0
1668252652621,ECE 260B,A00,103658,Kang; Mingu,0,0,0,0
1668252653047,ECE 264A,A00,103659,Galton; Ian A,0,0,0,0
1668252653472,ECE 265A,A00,103661,Gudem; Prasad S.S.,0,0,0,0
1668252653901,ECE 265D,A00,103662,Gudem; Prasad S.S.,0,0,0,0
1668252654325,ECE 268,A00,103663,Koushanfar; Farinaz,0,0,0,0
1668252654751,ECE 269,A01,103665,Pal; Piya,0,0,0,0
1668252655178,ECE 271B,A00,103666,Vasconcelos; Manuela,0,0,0,0
1668252655606,ECE 276A,A00,103667,Atanasov; Nikolay A.,0,0,0,0
1668252656036,ECE 277,A00,103668,An; Cheolhong,0,0,0,0
1668252656473,ECE 279,A00,117947,Hall; Drew A.,0,0,0,0
1668252657322,ECE 283,A00,103670,Hsueh; Tzu-Chien,0,0,0,0
1668252657747,ECE 284,A00,103671,Turakhia; Yatish Girish,0,0,0,0
1668252658172,ECE 285,A00,103672,Zheng; Yang,0,0,0,0
1668252658172,ECE 285,B00,103673,Sworder; David D.,0,0,0,0
1668252658600,ECE 287,A00,103676,Javidi; Tara,0,0,0,0
1668252659032,MATH 200B,A00,098023,Salehi Golsefidy; Alireza,12,0,15,3
1668252659456,MATH 202B,A00,098024,Rhoades; Brendon Patrick,9,0,15,6
1668252659882,MATH 203B,A00,098025,Oprea; Dragos N.,10,0,15,5
1668252660318,MATH 204B,A00,098026,Sorensen; Claus M,13,0,15,2
1668252660745,MATH 208,A00,098027,Izadi; Elham,7,0,10,3
1668252661173,MATH 209,A00,098028,Pollack; Aaron,10,0,10,0
1668252661598,MATH 211A,A00,112919,Rogalski; Daniel,9,0,10,1
1668252662027,MATH 211B,A00,112920,Seward; Brandon M.,9,0,10,1
1668252662455,MATH 218,A00,098029,Li; Bo,10,0,10,0
1668252662887,MATH 220B,A00,098030,Novak; Jonathan I,11,0,15,4
1668252663321,MATH 221A,A00,098031,Ebenfelt; Peter F,13,0,15,2
1668252663757,MATH 231B,A00,098032,Zlatos; Andrej,12,0,15,3
1668252664182,MATH 240B,A00,098033,Ni; Lei,9,0,15,6
1668252664607,MATH 243,A00,098034,Jekel; David Andrew,10,0,10,0
1668252665045,MATH 245A,A00,098035,Nie; Jiawang,0,0,15,16
1668252665472,MATH 248,A00,098036,Bejenaru; Ioan,10,0,10,0
1668252665897,MATH 250B,A00,098037,Spolaor; Luca,14,0,15,1
1668252666326,MATH 258,A00,098038,Ni; Lei,10,0,10,0
1668252666751,MATH 264B,A00,098041,Rhoades; Brendon Patrick,9,0,15,6
1668252667177,MATH 268,A00,098042,Buss; Samuel R,10,0,10,0
1668252667607,MATH 269,A00,098043,Rhoades; Brendon Patrick,10,0,10,0
1668252668041,MATH 270B,A00,098044,Li; Bo,10,0,15,5
1668252668466,MATH 272B,A00,098045,Holst; Michael J,13,0,15,2
1668252668889,MATH 273A,A00,098046,Tian; Xiaochuan,10,0,15,5
1668252669318,MATH 275,A01,098048,Tian; Xiaochuan,6,0,10,4
1668252669759,MATH 278A,A00,098049,Holst; Michael J,8,0,10,2
1668252670197,MATH 278B,A00,098050,Cloninger; Alexander,10,0,10,0
1668252670627,MATH 278C,A00,098051,Nie; Jiawang,7,0,10,3
1668252671053,MATH 280B,A00,098052,Zheng; Tianyi,9,0,15,6
1668252671480,MATH 281B,A00,098053,Bradic; Jelena,1,0,15,14
1668252671904,MATH 282B,A00,098054,Arias-Castro; Ery,0,0,15,15
1668252672328,MATH 285,A00,098055,Fitzsimmons; Patrick J,0,0,15,17
1668252672752,MATH 287B,A00,098056,Arias-Castro; Ery,2,0,15,13
1668252673177,MATH 288,A00,098057,Agarwal; Pooja,9,0,10,1
1668252673177,MATH 288,B00,098058,Zhang; Danna,8,0,10,2
1668252673177,MATH 288,C00,098059,Williams; Ruth J,10,0,10,0
1668252673603,MATH 290B,A00,098060,Roberts; Justin Deritter,13,0,15,2
1668252674030,MATH 292,A00,098061,Belmont; Eva Kinoshita,10,0,10,0
1668252674461,MATH 295,A00,098062,Suk; Andrew Hoon,48,0,50,2
1668252674885,MATH 296,A00,098063,Novak; Jonathan I,20,0,20,0
1668252675311,MATH 297,001,098064,Gamst; Anthony Collins,9997,0,9999,2
1668253177621,COGS 205,A00,101395,Chiba; Andrea,19,0,20,1
1668253178057,COGS 210B,001,101404,Greene; Deanna Jacquelyn,9998,0,9999,1
1668253178057,COGS 210B,002,101417,Xia; Haijun,9999,0,9999,0
1668253178057,COGS 210B,003,101422,Nitz; Douglas A.,9999,0,9999,0
1668253178057,COGS 210B,004,101423,Hollan; James D.,9998,0,9999,1
1668253178057,COGS 210B,005,101424,Deak; Gedeon O.,9998,0,9999,1
1668253178057,COGS 210B,006,101425,Rossano; Federico,9999,0,9999,0
1668253178486,COGS 211B,A00,101427,Coulson; Seana M,9996,0,9999,3
1668253178913,COGS 220,A00,101428,Hollan; James D.,0,0,25,25
1668253179336,COGS 229,A00,101429,Dow; Steven P,18,0,25,7
1668253179762,COGS 230,A00,101430,Klemmer; Scott R,12,0,17,5
1668253180185,COGS 234,A00,101431,Xia; Haijun,2,0,25,23
1668253180612,COGS 260,A00,101432,Kiyonaga; Anastasia,21,0,25,4
1668253180612,COGS 260,B00,101433,Kirsh; David Joel,15,0,25,10
1668253181050,CSE 202,A00,102371,Impagliazzo; Russell,0,0,0,0
1668253181478,CSE 203B,A01,102373,Cheng; Chung Kuan,0,0,0,0
1668253181907,CSE 208,A00,102374,Micciancio; Daniele,0,0,0,0
1668253182336,CSE 209A,A00,112895,Impagliazzo; Russell,0,0,15,15
1668253182762,CSE 209B,A00,108005,Bellare; Mihir,0,0,0,0
1668253183193,CSE 210,A00,113163,Coblenz; Michael J,0,0,0,0
1668253183622,CSE 219,A00,106111,Dow; Steven P,0,0,20,20
1668253184049,CSE 221,A00,102376,Voelker; Geoffrey M.,0,0,0,0
1668253184474,CSE 224,A01,102378,Porter; George M,0,0,0,0
1668253184906,CSE 229A,A00,102379,Savage; Stefan,0,0,0,0
1668253185330,CSE 229C,A00,102380,Munyaka; Imani N. S.,0,0,0,0
1668253185762,CSE 232B,A00,102382,Deutsch; Alin Bernard,0,0,0,0
1668253186193,CSE 234,A01,112904,Kumar; Arun Kumar,0,0,0,0
1668253186624,CSE 237A,A00,102383,Rosing; Tajana Simunic,0,0,0,0
1668253187063,CSE 239A,A00,102384,Deutsch; Alin Bernard,0,0,0,0
1668253187497,CSE 239B,A00,102385,Polikarpova; Nadezhda,0,0,0,0
1668253187923,CSE 240A,A00,102386,Pannuto; Patrick William,0,0,0,0
1668253188349,CSE 240B,A00,102387,Zhao; Jishen,0,0,0,0
1668253188775,CSE 241A,A00,106406,Kang; Mingu,0,0,0,0
1668253189201,CSE 249B,A00,102388,Kahng; Andrew Byun,0,0,8,8
1668253189631,CSE 251B,A01,102392,Cottrell; Garrison W,0,0,0,0
1668253189631,CSE 251B,A02,102393,Cottrell; Garrison W,0,0,0,0
1668253190060,CSE 252B,A00,102394,Ochoa; Benjamin Lawrence,0,0,0,0
1668253190484,CSE 257,A01,102396,Gao; Sicun,0,0,0,0
1668253190911,CSE 272,A00,102397,Li; Tzumao,0,0,0,0
1668253191337,CSE 274,A00,111323,Chern; Albert Ren-Haur,0,0,0,0
1668253191761,CSE 282,A00,102398,Pevzner; Pavel Arkadjevich,0,0,0,0
1668253192200,CSE 284,A00,114175,Gymrek; Melissa Ann,0,0,0,0
1668253192629,CSE 290,A00,102399,Chandraker; Manmohan Krishna,0,0,0,0
1668253192629,CSE 290,B00,102400,Vaccaro; Kristen Marie,0,0,25,25
1668253192629,CSE 290,C00,102414,Pannuto; Patrick William,0,0,25,25
1668253192629,CSE 290,D00,102427,Pevzner; Pavel Arkadjevich,0,0,0,0
1668253192629,CSE 290,E00,102429,Zhao; Jishen,0,0,0,0
1668253192629,CSE 290,F00,102436,Tullsen; Dean Michael,0,0,0,0
1668253192629,CSE 290,G00,102440,Christensen; Henrik I,0,0,20,20
1668253193058,CSE 291,A00,102443,Su; Hao,0,0,0,0
1668253193058,CSE 291,B00,102448,Polikarpova; Nadezhda,0,0,0,0
1668253193058,CSE 291,C00,102453,Vaccaro; Kristen Marie,0,0,0,0
1668253193058,CSE 291,D00,111343,Savage; Stefan,0,0,0,0
1668253193058,CSE 291,E00,116474,Claffy; Kimberly Claire,0,0,0,0
1668253193058,CSE 291,F00,116479,Pasquale; Joseph,0,0,0,0
1668253193581,CSE 293,001,119111,Bafna; Vineet,9999,0,9999,0
1668253193581,CSE 293,002,119118,Bellare; Mihir,9999,0,9999,0
1668253193581,CSE 293,003,119122,Berg-Kirkpatrick; Taylor D,9999,0,9999,0
1668253193581,CSE 293,004,119135,Christensen; Henrik I,9999,0,9999,0
1668253193581,CSE 293,005,119142,Cottrell; Garrison W,9999,0,9999,0
1668253193581,CSE 293,006,119146,Deutsch; Alin Bernard,9999,0,9999,0
1668253193581,CSE 293,007,119159,Esmaeilzadeh; Hadi,9999,0,9999,0
1668253193581,CSE 293,008,119166,Freund; Yoav,9999,0,9999,0
1668253193581,CSE 293,009,119170,Griswold; William G.,9999,0,9999,0
1668253193581,CSE 293,010,119183,Gymrek; Melissa Ann,9999,0,9999,0
1668253193581,CSE 293,011,119190,Heninger; Nadia A,9999,0,9999,0
1668253193581,CSE 293,012,119230,Impagliazzo; Russell,9999,0,9999,0
1668253193581,CSE 293,013,119232,Jhala; Ranjit,9999,0,9999,0
1668253193581,CSE 293,014,119233,Kahng; Andrew Byun,9999,0,9999,0
1668253193581,CSE 293,015,119298,Kane; Daniel Mertz,9999,0,9999,0
1668253193581,CSE 293,016,119299,Kriegman; David J,9999,0,9999,0
1668253193581,CSE 293,017,119300,Kumar; Arun Kumar,9999,0,9999,0
1668253193581,CSE 293,018,119301,Lerner; Sorin,9999,0,9999,0
1668253193581,CSE 293,019,119302,Lovett; Shachar,9999,0,9999,0
1668253193581,CSE 293,020,119303,McAuley; Julian John,9999,0,9999,0
1668253193581,CSE 293,021,119304,Micciancio; Daniele,9999,0,9999,0
1668253193581,CSE 293,022,119367,Orailoglu; Alex,9999,0,9999,0
1668253193581,CSE 293,023,119382,Paturi; Ramamohan,9999,0,9999,0
1668253193581,CSE 293,024,119404,Polikarpova; Nadezhda,9999,0,9999,0
1668253193581,CSE 293,025,119406,Politz; Joseph Gibbs,9999,0,9999,0
1668253193581,CSE 293,026,119411,Porter; George M,9999,0,9999,0
1668253193581,CSE 293,027,119414,Porter; Leonard Emerson,9999,0,9999,0
1668253193581,CSE 293,028,119416,Ramamoorthi; Ravi,9999,0,9999,0
1668253193581,CSE 293,029,119417,Sahoo; Debashis,9999,0,9999,0
1668253193581,CSE 293,030,119420,Saul; Lawrence,9999,0,9999,0
1668253193581,CSE 293,031,119421,Savage; Stefan,9999,0,9999,0
1668253193581,CSE 293,032,119425,Schulze; Jurgen P.,9999,0,9999,0
1668253193581,CSE 293,033,119426,Snoeren; Alex C.,9999,0,9999,0
1668253193581,CSE 293,034,119428,Shang; Jingbo,9999,0,9999,0
1668253193581,CSE 293,035,119430,Stefan; Deian,9999,0,9999,0
1668253193581,CSE 293,036,119431,Su; Hao,9999,0,9999,0
1668253193581,CSE 293,037,119433,Swanson; Steven James,9999,0,9999,0
1668253193581,CSE 293,038,119435,Tullsen; Dean Michael,9999,0,9999,0
1668253193581,CSE 293,039,119483,Voelker; Geoffrey M.,9999,0,9999,0
1668253193581,CSE 293,040,119537,Zhao; Jishen,9999,0,9999,0
1668253193581,CSE 293,041,119538,Zhou; Yuan-Yuan,9999,0,9999,0
1668253193581,CSE 293,042,119539,Gao; Sicun,9999,0,9999,0
1668253193581,CSE 293,043,119540,Weibel; Nadir,9999,0,9999,0
1668253193581,CSE 293,044,119541,Gupta; Rajesh K.,9999,0,9999,0
1668253193581,CSE 293,045,126410,Vaccaro; Kristen Marie,9999,0,9999,0
1668253193581,CSE 293,046,126411,Klemke; Richard,9999,0,9999,0
1668253194017,CSE 294,A00,102459,Voelker; Geoffrey M.,0,0,0,0
1668253194017,CSE 294,B00,111322,Orailoglu; Alex,0,0,0,0
1668253194449,DSE 201,A00,096914,Deutsch; Alin Bernard,30,0,30,0
1668253194891,DSE 210,A00,096915,Dasgupta; Sanjoy,30,0,30,0
1668253195320,DSE 260A,A00,096916,Altintas De Callaf; Ilkay,30,0,30,0
1668253195828,ECE 200,001,103586,Antipa; Nicholas A,9999,0,9999,0
1668253195828,ECE 200,002,103587,Atanasov; Nikolay A.,9999,0,9999,0
1668253195828,ECE 200,003,103588,Bharadia; Dinesh,9999,0,9999,0
1668253195828,ECE 200,004,103589,Cheng; Chung Kuan,9999,0,9999,0
1668253195828,ECE 200,005,103590,Cosman; Pamela C.,9999,0,9999,0
1668253195828,ECE 200,006,103591,Dayeh; Shadi Ahmad,9999,0,9999,0
1668253195828,ECE 200,007,103592,Fainman; Yeshaiahu,9999,0,9999,0
1668253195828,ECE 200,008,103593,Ford; Joseph Earl,9999,0,9999,0
1668253195828,ECE 200,009,103594,Franceschetti; Massimo,9999,0,9999,0
1668253195828,ECE 200,010,103595,Fullerton; Eric E,9999,0,9999,0
1668253195828,ECE 200,011,103596,Galton; Ian A,9999,0,9999,0
1668253195828,ECE 200,012,103597,Gilja; Vikash,9999,0,9999,0
1668253195828,ECE 200,013,103598,Hall; Drew A.,9999,0,9999,0
1668253195828,ECE 200,014,103599,Hsueh; Tzu-Chien,9999,0,9999,0
1668253195828,ECE 200,015,103600,Javidi; Tara,9999,0,9999,0
1668253195828,ECE 200,016,103601,Kahng; Andrew Byun,9999,0,9999,0
1668253195828,ECE 200,017,103602,Kim; Young-Han,9999,0,9999,0
1668253195828,ECE 200,018,103603,Koushanfar; Farinaz,9999,0,9999,0
1668253195828,ECE 200,019,103604,Kuzum; Duygu,9999,0,9999,0
1668253195828,ECE 200,020,103605,Le; Hanh-Phuc,9999,0,9999,0
1668253195828,ECE 200,021,103606,Lin; Bill,9999,0,9999,0
1668253195828,ECE 200,022,103607,Liu; Zhaowei,9998,0,9999,1
1668253195828,ECE 200,023,103608,Lo; Yu-Hwa,9999,0,9999,0
1668253195828,ECE 200,024,103609,Lomakin; Vitaliy,9999,0,9999,0
1668253195828,ECE 200,025,103610,Mercier; Patrick Philip,9999,0,9999,0
1668253195828,ECE 200,026,103611,Meyer; Florian,9999,0,9999,0
1668253195828,ECE 200,027,103612,Milstein; Laurence B.,9999,0,9999,0
1668253195828,ECE 200,028,103613,Mir Arabbaygi; Siavash,9999,0,9999,0
1668253195828,ECE 200,029,103614,Mookherjea; Shayan,9999,0,9999,0
1668253195828,ECE 200,030,103615,Morris; Karcher William,9999,0,9999,0
1668253195828,ECE 200,031,103616,Ng; Tse Nga,9999,0,9999,0
1668253195828,ECE 200,032,103617,Nguyen; Truong Quang,9999,0,9999,0
1668253195828,ECE 200,033,103618,Nomura; Kenji,9999,0,9999,0
1668253195828,ECE 200,034,103619,Orlitsky; Alon,9999,0,9999,0
1668253195828,ECE 200,035,103620,Pal; Piya,9999,0,9999,0
1668253195828,ECE 200,036,103621,Papen; George C.,9999,0,9999,0
1668253195828,ECE 200,037,103622,Radic; Stojan,9999,0,9999,0
1668253195828,ECE 200,038,103623,Rao; Bhaskar D.,9999,0,9999,0
1668253195828,ECE 200,039,103624,Rao; Ramesh R,9999,0,9999,0
1668253195828,ECE 200,040,103625,Rebeiz; Gabriel,9999,0,9999,0
1668253195828,ECE 200,041,103626,Sanford; John R,9999,0,9999,0
1668253195828,ECE 200,042,103627,Siegel; Paul H.,9999,0,9999,0
1668253195828,ECE 200,043,103628,Sievenpiper; Daniel F.,9999,0,9999,0
1668253195828,ECE 200,044,103629,Sworder; David D.,9999,0,9999,0
1668253195828,ECE 200,045,103630,Taur; Yuan,9999,0,9999,0
1668253195828,ECE 200,046,103631,Touri; Behrouz,9999,0,9999,0
1668253195828,ECE 200,047,103632,Trivedi; Mohan M.,9999,0,9999,0
1668253195828,ECE 200,048,103633,Vasconcelos; Nuno,9999,0,9999,0
1668253195828,ECE 200,049,103634,Wang; Xiaolong,9999,0,9999,0
1668253195828,ECE 200,050,103635,Xie; Pengtao,9999,0,9999,0
1668253195828,ECE 200,051,103636,Yip; Michael,9999,0,9999,0
1668253195828,ECE 200,052,103637,Zeger; Kenneth A.,999,0,999,0
1668253195828,ECE 200,053,103638,Zhang; Xinyu,9999,0,9999,0
1668253195828,ECE 200,054,103639,Turakhia; Yatish Girish,9999,0,9999,0
1668253195828,ECE 200,055,103640,Kang; Mingu,9999,0,9999,0
1668253195828,ECE 200,056,103641,Shi; Yuanyuan,9999,0,9999,0
1668253195828,ECE 200,057,103642,Wang; Edward Jay,9999,0,9999,0
1668253195828,ECE 200,058,103643,Zheng; Yang,9999,0,9999,0
1668253196258,ECE 202,A00,103644,Kuzum; Duygu,0,0,0,0
1668253196681,ECE 212BN,A00,103646,Ng; Tse Nga,0,0,0,0
1668253197106,ECE 221,A00,111493,Staff,0,0,0,0
1668253197532,ECE 222B,A00,103647,Lomakin; Vitaliy,0,0,0,0
1668253197958,ECE 230B,A00,103648,Taur; Yuan,0,0,0,0
1668253198391,ECE 238B,A00,103649,Garay; Javier,0,0,0,0
1668253198818,ECE 240B,A00,112900,Fainman; Yeshaiahu,0,0,0,0
1668253199244,ECE 247A,A00,103650,Jokerst; Jesse Vincent,0,0,0,0
1668253199672,ECE 247B,A00,103651,Wang; Joseph,0,0,0,0
1668253200103,ECE 250,A00,103652,Siegel; Paul H.,0,0,0,0
1668253200537,ECE 251A,A00,103654,Rao; Bhaskar D.,0,0,0,0
1668253200972,ECE 257B,A00,103655,Bharadia; Dinesh,0,0,0,0
1668253201404,ECE 258A,A00,103656,Milstein; Laurence B.,0,0,0,0
1668253201832,ECE 260B,A00,103658,Kang; Mingu,0,0,0,0
1668253202270,ECE 264A,A00,103659,Galton; Ian A,0,0,0,0
1668253202697,ECE 265A,A00,103661,Gudem; Prasad S.S.,0,0,0,0
1668253203120,ECE 265D,A00,103662,Gudem; Prasad S.S.,0,0,0,0
1668253203545,ECE 268,A00,103663,Koushanfar; Farinaz,0,0,0,0
1668253203973,ECE 269,A01,103665,Pal; Piya,0,0,0,0
1668253204397,ECE 271B,A00,103666,Vasconcelos; Manuela,0,0,0,0
1668253204822,ECE 276A,A00,103667,Atanasov; Nikolay A.,0,0,0,0
1668253205246,ECE 277,A00,103668,An; Cheolhong,0,0,0,0
1668253205671,ECE 279,A00,117947,Hall; Drew A.,0,0,0,0
1668253206524,ECE 283,A00,103670,Hsueh; Tzu-Chien,0,0,0,0
1668253206949,ECE 284,A00,103671,Turakhia; Yatish Girish,0,0,0,0
1668253207375,ECE 285,A00,103672,Zheng; Yang,0,0,0,0
1668253207375,ECE 285,B00,103673,Sworder; David D.,0,0,0,0
1668253207805,ECE 287,A00,103676,Javidi; Tara,0,0,0,0
1668253208231,MATH 200B,A00,098023,Salehi Golsefidy; Alireza,12,0,15,3
1668253208657,MATH 202B,A00,098024,Rhoades; Brendon Patrick,9,0,15,6
1668253209096,MATH 203B,A00,098025,Oprea; Dragos N.,10,0,15,5
1668253209523,MATH 204B,A00,098026,Sorensen; Claus M,13,0,15,2
1668253209948,MATH 208,A00,098027,Izadi; Elham,7,0,10,3
1668253210372,MATH 209,A00,098028,Pollack; Aaron,10,0,10,0
1668253210801,MATH 211A,A00,112919,Rogalski; Daniel,9,0,10,1
1668253211226,MATH 211B,A00,112920,Seward; Brandon M.,9,0,10,1
1668253211653,MATH 218,A00,098029,Li; Bo,10,0,10,0
1668253212083,MATH 220B,A00,098030,Novak; Jonathan I,11,0,15,4
1668253212508,MATH 221A,A00,098031,Ebenfelt; Peter F,13,0,15,2
1668253212943,MATH 231B,A00,098032,Zlatos; Andrej,12,0,15,3
1668253213368,MATH 240B,A00,098033,Ni; Lei,9,0,15,6
1668253213793,MATH 243,A00,098034,Jekel; David Andrew,10,0,10,0
1668253214217,MATH 245A,A00,098035,Nie; Jiawang,0,0,15,16
1668253214645,MATH 248,A00,098036,Bejenaru; Ioan,10,0,10,0
1668253215149,MATH 250B,A00,098037,Spolaor; Luca,14,0,15,1
1668253215579,MATH 258,A00,098038,Ni; Lei,10,0,10,0
1668253216012,MATH 264B,A00,098041,Rhoades; Brendon Patrick,9,0,15,6
1668253216440,MATH 268,A00,098042,Buss; Samuel R,10,0,10,0
1668253216863,MATH 269,A00,098043,Rhoades; Brendon Patrick,10,0,10,0
1668253217287,MATH 270B,A00,098044,Li; Bo,10,0,15,5
1668253217719,MATH 272B,A00,098045,Holst; Michael J,13,0,15,2
1668253218147,MATH 273A,A00,098046,Tian; Xiaochuan,10,0,15,5
1668253218587,MATH 275,A01,098048,Tian; Xiaochuan,6,0,10,4
1668253219017,MATH 278A,A00,098049,Holst; Michael J,8,0,10,2
1668253219450,MATH 278B,A00,098050,Cloninger; Alexander,10,0,10,0
1668253219875,MATH 278C,A00,098051,Nie; Jiawang,7,0,10,3
1668253220304,MATH 280B,A00,098052,Zheng; Tianyi,9,0,15,6
1668253220736,MATH 281B,A00,098053,Bradic; Jelena,1,0,15,14
1668253221171,MATH 282B,A00,098054,Arias-Castro; Ery,0,0,15,15
1668253221597,MATH 285,A00,098055,Fitzsimmons; Patrick J,0,0,15,17
1668253222022,MATH 287B,A00,098056,Arias-Castro; Ery,2,0,15,13
1668253222446,MATH 288,A00,098057,Agarwal; Pooja,9,0,10,1
1668253222446,MATH 288,B00,098058,Zhang; Danna,8,0,10,2
1668253222446,MATH 288,C00,098059,Williams; Ruth J,10,0,10,0
1668253222877,MATH 290B,A00,098060,Roberts; Justin Deritter,13,0,15,2
1668253223301,MATH 292,A00,098061,Belmont; Eva Kinoshita,10,0,10,0
1668253223725,MATH 295,A00,098062,Suk; Andrew Hoon,48,0,50,2
1668253224150,MATH 296,A00,098063,Novak; Jonathan I,20,0,20,0
1668253224579,MATH 297,001,098064,Gamst; Anthony Collins,9997,0,9999,2
1668253727060,COGS 205,A00,101395,Chiba; Andrea,19,0,20,1
1668253727488,COGS 210B,001,101404,Greene; Deanna Jacquelyn,9998,0,9999,1
1668253727488,COGS 210B,002,101417,Xia; Haijun,9999,0,9999,0
1668253727488,COGS 210B,003,101422,Nitz; Douglas A.,9999,0,9999,0
1668253727488,COGS 210B,004,101423,Hollan; James D.,9998,0,9999,1
1668253727488,COGS 210B,005,101424,Deak; Gedeon O.,9998,0,9999,1
1668253727488,COGS 210B,006,101425,Rossano; Federico,9999,0,9999,0
1668253727916,COGS 211B,A00,101427,Coulson; Seana M,9996,0,9999,3
1668253728339,COGS 220,A00,101428,Hollan; James D.,0,0,25,25
1668253728766,COGS 229,A00,101429,Dow; Steven P,18,0,25,7
1668253729191,COGS 230,A00,101430,Klemmer; Scott R,12,0,17,5
1668253729615,COGS 234,A00,101431,Xia; Haijun,2,0,25,23
1668253730047,COGS 260,A00,101432,Kiyonaga; Anastasia,21,0,25,4
1668253730047,COGS 260,B00,101433,Kirsh; David Joel,15,0,25,10
1668253730487,CSE 202,A00,102371,Impagliazzo; Russell,0,0,0,0
1668253730924,CSE 203B,A01,102373,Cheng; Chung Kuan,0,0,0,0
1668253731354,CSE 208,A00,102374,Micciancio; Daniele,0,0,0,0
1668253731779,CSE 209A,A00,112895,Impagliazzo; Russell,0,0,15,15
1668253732205,CSE 209B,A00,108005,Bellare; Mihir,0,0,0,0
1668253732631,CSE 210,A00,113163,Coblenz; Michael J,0,0,0,0
1668253733060,CSE 219,A00,106111,Dow; Steven P,0,0,20,20
1668253733486,CSE 221,A00,102376,Voelker; Geoffrey M.,0,0,0,0
1668253733915,CSE 224,A01,102378,Porter; George M,0,0,0,0
1668253734343,CSE 229A,A00,102379,Savage; Stefan,0,0,0,0
1668253734767,CSE 229C,A00,102380,Munyaka; Imani N. S.,0,0,0,0
1668253735191,CSE 232B,A00,102382,Deutsch; Alin Bernard,0,0,0,0
1668253735617,CSE 234,A01,112904,Kumar; Arun Kumar,0,0,0,0
1668253736047,CSE 237A,A00,102383,Rosing; Tajana Simunic,0,0,0,0
1668253736470,CSE 239A,A00,102384,Deutsch; Alin Bernard,0,0,0,0
1668253736903,CSE 239B,A00,102385,Polikarpova; Nadezhda,0,0,0,0
1668253737328,CSE 240A,A00,102386,Pannuto; Patrick William,0,0,0,0
1668253737850,CSE 240B,A00,102387,Zhao; Jishen,0,0,0,0
1668253738273,CSE 241A,A00,106406,Kang; Mingu,0,0,0,0
1668253738701,CSE 249B,A00,102388,Kahng; Andrew Byun,0,0,8,8
1668253739162,CSE 251B,A01,102392,Cottrell; Garrison W,0,0,0,0
1668253739162,CSE 251B,A02,102393,Cottrell; Garrison W,0,0,0,0
1668253739592,CSE 252B,A00,102394,Ochoa; Benjamin Lawrence,0,0,0,0
1668253740035,CSE 257,A01,102396,Gao; Sicun,0,0,0,0
1668253740463,CSE 272,A00,102397,Li; Tzumao,0,0,0,0
1668253740892,CSE 274,A00,111323,Chern; Albert Ren-Haur,0,0,0,0
1668253741319,CSE 282,A00,102398,Pevzner; Pavel Arkadjevich,0,0,0,0
1668253741749,CSE 284,A00,114175,Gymrek; Melissa Ann,0,0,0,0
1668253742177,CSE 290,A00,102399,Chandraker; Manmohan Krishna,0,0,0,0
1668253742177,CSE 290,B00,102400,Vaccaro; Kristen Marie,0,0,25,25
1668253742177,CSE 290,C00,102414,Pannuto; Patrick William,0,0,25,25
1668253742177,CSE 290,D00,102427,Pevzner; Pavel Arkadjevich,0,0,0,0
1668253742177,CSE 290,E00,102429,Zhao; Jishen,0,0,0,0
1668253742177,CSE 290,F00,102436,Tullsen; Dean Michael,0,0,0,0
1668253742177,CSE 290,G00,102440,Christensen; Henrik I,0,0,20,20
1668253742613,CSE 291,A00,102443,Su; Hao,0,0,0,0
1668253742613,CSE 291,B00,102448,Polikarpova; Nadezhda,0,0,0,0
1668253742613,CSE 291,C00,102453,Vaccaro; Kristen Marie,0,0,0,0
1668253742613,CSE 291,D00,111343,Savage; Stefan,0,0,0,0
1668253742613,CSE 291,E00,116474,Claffy; Kimberly Claire,0,0,0,0
1668253742613,CSE 291,F00,116479,Pasquale; Joseph,0,0,0,0
1668253743099,CSE 293,001,119111,Bafna; Vineet,9999,0,9999,0
1668253743099,CSE 293,002,119118,Bellare; Mihir,9999,0,9999,0
1668253743099,CSE 293,003,119122,Berg-Kirkpatrick; Taylor D,9999,0,9999,0
1668253743099,CSE 293,004,119135,Christensen; Henrik I,9999,0,9999,0
1668253743099,CSE 293,005,119142,Cottrell; Garrison W,9999,0,9999,0
1668253743099,CSE 293,006,119146,Deutsch; Alin Bernard,9999,0,9999,0
1668253743099,CSE 293,007,119159,Esmaeilzadeh; Hadi,9999,0,9999,0
1668253743099,CSE 293,008,119166,Freund; Yoav,9999,0,9999,0
1668253743099,CSE 293,009,119170,Griswold; William G.,9999,0,9999,0
1668253743099,CSE 293,010,119183,Gymrek; Melissa Ann,9999,0,9999,0
1668253743099,CSE 293,011,119190,Heninger; Nadia A,9999,0,9999,0
1668253743099,CSE 293,012,119230,Impagliazzo; Russell,9999,0,9999,0
1668253743099,CSE 293,013,119232,Jhala; Ranjit,9999,0,9999,0
1668253743099,CSE 293,014,119233,Kahng; Andrew Byun,9999,0,9999,0
1668253743099,CSE 293,015,119298,Kane; Daniel Mertz,9999,0,9999,0
1668253743099,CSE 293,016,119299,Kriegman; David J,9999,0,9999,0
1668253743099,CSE 293,017,119300,Kumar; Arun Kumar,9999,0,9999,0
1668253743099,CSE 293,018,119301,Lerner; Sorin,9999,0,9999,0
1668253743099,CSE 293,019,119302,Lovett; Shachar,9999,0,9999,0
1668253743099,CSE 293,020,119303,McAuley; Julian John,9999,0,9999,0
1668253743099,CSE 293,021,119304,Micciancio; Daniele,9999,0,9999,0
1668253743099,CSE 293,022,119367,Orailoglu; Alex,9999,0,9999,0
1668253743099,CSE 293,023,119382,Paturi; Ramamohan,9999,0,9999,0
1668253743099,CSE 293,024,119404,Polikarpova; Nadezhda,9999,0,9999,0
1668253743099,CSE 293,025,119406,Politz; Joseph Gibbs,9999,0,9999,0
1668253743099,CSE 293,026,119411,Porter; George M,9999,0,9999,0
1668253743099,CSE 293,027,119414,Porter; Leonard Emerson,9999,0,9999,0
1668253743099,CSE 293,028,119416,Ramamoorthi; Ravi,9999,0,9999,0
1668253743099,CSE 293,029,119417,Sahoo; Debashis,9999,0,9999,0
1668253743099,CSE 293,030,119420,Saul; Lawrence,9999,0,9999,0
1668253743099,CSE 293,031,119421,Savage; Stefan,9999,0,9999,0
1668253743099,CSE 293,032,119425,Schulze; Jurgen P.,9999,0,9999,0
1668253743099,CSE 293,033,119426,Snoeren; Alex C.,9999,0,9999,0
1668253743099,CSE 293,034,119428,Shang; Jingbo,9999,0,9999,0
1668253743099,CSE 293,035,119430,Stefan; Deian,9999,0,9999,0
1668253743099,CSE 293,036,119431,Su; Hao,9999,0,9999,0
1668253743099,CSE 293,037,119433,Swanson; Steven James,9999,0,9999,0
1668253743099,CSE 293,038,119435,Tullsen; Dean Michael,9999,0,9999,0
1668253743099,CSE 293,039,119483,Voelker; Geoffrey M.,9999,0,9999,0
1668253743099,CSE 293,040,119537,Zhao; Jishen,9999,0,9999,0
1668253743099,CSE 293,041,119538,Zhou; Yuan-Yuan,9999,0,9999,0
1668253743099,CSE 293,042,119539,Gao; Sicun,9999,0,9999,0
1668253743099,CSE 293,043,119540,Weibel; Nadir,9999,0,9999,0
1668253743099,CSE 293,044,119541,Gupta; Rajesh K.,9999,0,9999,0
1668253743099,CSE 293,045,126410,Vaccaro; Kristen Marie,9999,0,9999,0
1668253743099,CSE 293,046,126411,Klemke; Richard,9999,0,9999,0
1668253743527,CSE 294,A00,102459,Voelker; Geoffrey M.,0,0,0,0
1668253743527,CSE 294,B00,111322,Orailoglu; Alex,0,0,0,0
1668253743953,DSE 201,A00,096914,Deutsch; Alin Bernard,30,0,30,0
1668253744378,DSE 210,A00,096915,Dasgupta; Sanjoy,30,0,30,0
1668253744804,DSE 260A,A00,096916,Altintas De Callaf; Ilkay,30,0,30,0
1668253745339,ECE 200,001,103586,Antipa; Nicholas A,9999,0,9999,0
1668253745339,ECE 200,002,103587,Atanasov; Nikolay A.,9999,0,9999,0
1668253745339,ECE 200,003,103588,Bharadia; Dinesh,9999,0,9999,0
1668253745339,ECE 200,004,103589,Cheng; Chung Kuan,9999,0,9999,0
1668253745339,ECE 200,005,103590,Cosman; Pamela C.,9999,0,9999,0
1668253745339,ECE 200,006,103591,Dayeh; Shadi Ahmad,9999,0,9999,0
1668253745339,ECE 200,007,103592,Fainman; Yeshaiahu,9999,0,9999,0
1668253745339,ECE 200,008,103593,Ford; Joseph Earl,9999,0,9999,0
1668253745339,ECE 200,009,103594,Franceschetti; Massimo,9999,0,9999,0
1668253745339,ECE 200,010,103595,Fullerton; Eric E,9999,0,9999,0
1668253745339,ECE 200,011,103596,Galton; Ian A,9999,0,9999,0
1668253745339,ECE 200,012,103597,Gilja; Vikash,9999,0,9999,0
1668253745339,ECE 200,013,103598,Hall; Drew A.,9999,0,9999,0
1668253745339,ECE 200,014,103599,Hsueh; Tzu-Chien,9999,0,9999,0
1668253745339,ECE 200,015,103600,Javidi; Tara,9999,0,9999,0
1668253745339,ECE 200,016,103601,Kahng; Andrew Byun,9999,0,9999,0
1668253745339,ECE 200,017,103602,Kim; Young-Han,9999,0,9999,0
1668253745339,ECE 200,018,103603,Koushanfar; Farinaz,9999,0,9999,0
1668253745339,ECE 200,019,103604,Kuzum; Duygu,9999,0,9999,0
1668253745339,ECE 200,020,103605,Le; Hanh-Phuc,9999,0,9999,0
1668253745339,ECE 200,021,103606,Lin; Bill,9999,0,9999,0
1668253745339,ECE 200,022,103607,Liu; Zhaowei,9998,0,9999,1
1668253745339,ECE 200,023,103608,Lo; Yu-Hwa,9999,0,9999,0
1668253745339,ECE 200,024,103609,Lomakin; Vitaliy,9999,0,9999,0
1668253745339,ECE 200,025,103610,Mercier; Patrick Philip,9999,0,9999,0
1668253745339,ECE 200,026,103611,Meyer; Florian,9999,0,9999,0
1668253745339,ECE 200,027,103612,Milstein; Laurence B.,9999,0,9999,0
1668253745339,ECE 200,028,103613,Mir Arabbaygi; Siavash,9999,0,9999,0
1668253745339,ECE 200,029,103614,Mookherjea; Shayan,9999,0,9999,0
1668253745339,ECE 200,030,103615,Morris; Karcher William,9999,0,9999,0
1668253745339,ECE 200,031,103616,Ng; Tse Nga,9999,0,9999,0
1668253745339,ECE 200,032,103617,Nguyen; Truong Quang,9999,0,9999,0
1668253745339,ECE 200,033,103618,Nomura; Kenji,9999,0,9999,0
1668253745339,ECE 200,034,103619,Orlitsky; Alon,9999,0,9999,0
1668253745339,ECE 200,035,103620,Pal; Piya,9999,0,9999,0
1668253745339,ECE 200,036,103621,Papen; George C.,9999,0,9999,0
1668253745339,ECE 200,037,103622,Radic; Stojan,9999,0,9999,0
1668253745339,ECE 200,038,103623,Rao; Bhaskar D.,9999,0,9999,0
1668253745339,ECE 200,039,103624,Rao; Ramesh R,9999,0,9999,0
1668253745339,ECE 200,040,103625,Rebeiz; Gabriel,9999,0,9999,0
1668253745339,ECE 200,041,103626,Sanford; John R,9999,0,9999,0
1668253745339,ECE 200,042,103627,Siegel; Paul H.,9999,0,9999,0
1668253745339,ECE 200,043,103628,Sievenpiper; Daniel F.,9999,0,9999,0
1668253745339,ECE 200,044,103629,Sworder; David D.,9999,0,9999,0
1668253745339,ECE 200,045,103630,Taur; Yuan,9999,0,9999,0
1668253745339,ECE 200,046,103631,Touri; Behrouz,9999,0,9999,0
1668253745339,ECE 200,047,103632,Trivedi; Mohan M.,9999,0,9999,0
1668253745339,ECE 200,048,103633,Vasconcelos; Nuno,9999,0,9999,0
1668253745339,ECE 200,049,103634,Wang; Xiaolong,9999,0,9999,0
1668253745339,ECE 200,050,103635,Xie; Pengtao,9999,0,9999,0
1668253745339,ECE 200,051,103636,Yip; Michael,9999,0,9999,0
1668253745339,ECE 200,052,103637,Zeger; Kenneth A.,999,0,999,0
1668253745339,ECE 200,053,103638,Zhang; Xinyu,9999,0,9999,0
1668253745339,ECE 200,054,103639,Turakhia; Yatish Girish,9999,0,9999,0
1668253745339,ECE 200,055,103640,Kang; Mingu,9999,0,9999,0
1668253745339,ECE 200,056,103641,Shi; Yuanyuan,9999,0,9999,0
1668253745339,ECE 200,057,103642,Wang; Edward Jay,9999,0,9999,0
1668253745339,ECE 200,058,103643,Zheng; Yang,9999,0,9999,0
1668253745767,ECE 202,A00,103644,Kuzum; Duygu,0,0,0,0
1668253746199,ECE 212BN,A00,103646,Ng; Tse Nga,0,0,0,0
1668253746625,ECE 221,A00,111493,Staff,0,0,0,0
1668253747048,ECE 222B,A00,103647,Lomakin; Vitaliy,0,0,0,0
1668253747473,ECE 230B,A00,103648,Taur; Yuan,0,0,0,0
1668253747910,ECE 238B,A00,103649,Garay; Javier,0,0,0,0
1668253748339,ECE 240B,A00,112900,Fainman; Yeshaiahu,0,0,0,0
1668253748767,ECE 247A,A00,103650,Jokerst; Jesse Vincent,0,0,0,0
1668253749194,ECE 247B,A00,103651,Wang; Joseph,0,0,0,0
1668253749620,ECE 250,A00,103652,Siegel; Paul H.,0,0,0,0
1668253750044,ECE 251A,A00,103654,Rao; Bhaskar D.,0,0,0,0
1668253750468,ECE 257B,A00,103655,Bharadia; Dinesh,0,0,0,0
1668253750901,ECE 258A,A00,103656,Milstein; Laurence B.,0,0,0,0
1668253751324,ECE 260B,A00,103658,Kang; Mingu,0,0,0,0
1668253751751,ECE 264A,A00,103659,Galton; Ian A,0,0,0,0
1668253752178,ECE 265A,A00,103661,Gudem; Prasad S.S.,0,0,0,0
1668253752601,ECE 265D,A00,103662,Gudem; Prasad S.S.,0,0,0,0
1668253753028,ECE 268,A00,103663,Koushanfar; Farinaz,0,0,0,0
1668253753458,ECE 269,A01,103665,Pal; Piya,0,0,0,0
1668253753882,ECE 271B,A00,103666,Vasconcelos; Manuela,0,0,0,0
1668253754318,ECE 276A,A00,103667,Atanasov; Nikolay A.,0,0,0,0
1668253754757,ECE 277,A00,103668,An; Cheolhong,0,0,0,0
1668253755189,ECE 279,A00,117947,Hall; Drew A.,0,0,0,0
1668253756035,ECE 283,A00,103670,Hsueh; Tzu-Chien,0,0,0,0
1668253756461,ECE 284,A00,103671,Turakhia; Yatish Girish,0,0,0,0
1668253756898,ECE 285,A00,103672,Zheng; Yang,0,0,0,0
1668253756898,ECE 285,B00,103673,Sworder; David D.,0,0,0,0
1668253757330,ECE 287,A00,103676,Javidi; Tara,0,0,0,0
1668253757774,MATH 200B,A00,098023,Salehi Golsefidy; Alireza,12,0,15,3
1668253758223,MATH 202B,A00,098024,Rhoades; Brendon Patrick,9,0,15,6
1668253758658,MATH 203B,A00,098025,Oprea; Dragos N.,10,0,15,5
1668253759098,MATH 204B,A00,098026,Sorensen; Claus M,13,0,15,2
1668253759527,MATH 208,A00,098027,Izadi; Elham,7,0,10,3
1668253759962,MATH 209,A00,098028,Pollack; Aaron,10,0,10,0
1668253760397,MATH 211A,A00,112919,Rogalski; Daniel,9,0,10,1
1668253760828,MATH 211B,A00,112920,Seward; Brandon M.,9,0,10,1
1668253761253,MATH 218,A00,098029,Li; Bo,10,0,10,0
1668253761703,MATH 220B,A00,098030,Novak; Jonathan I,11,0,15,4
1668253762134,MATH 221A,A00,098031,Ebenfelt; Peter F,13,0,15,2
1668253762558,MATH 231B,A00,098032,Zlatos; Andrej,12,0,15,3
1668253762981,MATH 240B,A00,098033,Ni; Lei,9,0,15,6
1668253763405,MATH 243,A00,098034,Jekel; David Andrew,10,0,10,0
1668253763832,MATH 245A,A00,098035,Nie; Jiawang,0,0,15,16
1668253764256,MATH 248,A00,098036,Bejenaru; Ioan,10,0,10,0
1668253764686,MATH 250B,A00,098037,Spolaor; Luca,14,0,15,1
1668253765114,MATH 258,A00,098038,Ni; Lei,10,0,10,0
1668253765537,MATH 264B,A00,098041,Rhoades; Brendon Patrick,9,0,15,6
1668253765962,MATH 268,A00,098042,Buss; Samuel R,10,0,10,0
1668253766395,MATH 269,A00,098043,Rhoades; Brendon Patrick,10,0,10,0
1668253766819,MATH 270B,A00,098044,Li; Bo,10,0,15,5
1668253767243,MATH 272B,A00,098045,Holst; Michael J,13,0,15,2
1668253767670,MATH 273A,A00,098046,Tian; Xiaochuan,10,0,15,5
1668253768100,MATH 275,A01,098048,Tian; Xiaochuan,6,0,10,4
1668253768524,MATH 278A,A00,098049,Holst; Michael J,8,0,10,2
1668253768953,MATH 278B,A00,098050,Cloninger; Alexander,10,0,10,0
1668253769379,MATH 278C,A00,098051,Nie; Jiawang,7,0,10,3
1668253769803,MATH 280B,A00,098052,Zheng; Tianyi,9,0,15,6
1668253770230,MATH 281B,A00,098053,Bradic; Jelena,1,0,15,14
1668253770655,MATH 282B,A00,098054,Arias-Castro; Ery,0,0,15,15
1668253771079,MATH 285,A00,098055,Fitzsimmons; Patrick J,0,0,15,17
1668253771502,MATH 287B,A00,098056,Arias-Castro; Ery,2,0,15,13
1668253771937,MATH 288,A00,098057,Agarwal; Pooja,9,0,10,1
1668253771937,MATH 288,B00,098058,Zhang; Danna,8,0,10,2
1668253771937,MATH 288,C00,098059,Williams; Ruth J,10,0,10,0
1668253772360,MATH 290B,A00,098060,Roberts; Justin Deritter,13,0,15,2
1668253772789,MATH 292,A00,098061,Belmont; Eva Kinoshita,10,0,10,0
1668253773216,MATH 295,A00,098062,Suk; Andrew Hoon,48,0,50,2
1668253773639,MATH 296,A00,098063,Novak; Jonathan I,20,0,20,0
1668253774069,MATH 297,001,098064,Gamst; Anthony Collins,9997,0,9999,2
1668254276432,COGS 205,A00,101395,Chiba; Andrea,19,0,20,1
1668254276858,COGS 210B,001,101404,Greene; Deanna Jacquelyn,9998,0,9999,1
1668254276858,COGS 210B,002,101417,Xia; Haijun,9999,0,9999,0
1668254276858,COGS 210B,003,101422,Nitz; Douglas A.,9999,0,9999,0
1668254276858,COGS 210B,004,101423,Hollan; James D.,9998,0,9999,1
1668254276858,COGS 210B,005,101424,Deak; Gedeon O.,9998,0,9999,1
1668254276858,COGS 210B,006,101425,Rossano; Federico,9999,0,9999,0
1668254277287,COGS 211B,A00,101427,Coulson; Seana M,9996,0,9999,3
1668254277713,COGS 220,A00,101428,Hollan; James D.,0,0,25,25
1668254278137,COGS 229,A00,101429,Dow; Steven P,18,0,25,7
1668254278562,COGS 230,A00,101430,Klemmer; Scott R,12,0,17,5
1668254278996,COGS 234,A00,101431,Xia; Haijun,2,0,25,23
1668254279437,COGS 260,A00,101432,Kiyonaga; Anastasia,21,0,25,4
1668254279437,COGS 260,B00,101433,Kirsh; David Joel,15,0,25,10
1668254279866,CSE 202,A00,102371,Impagliazzo; Russell,0,0,0,0
1668254280293,CSE 203B,A01,102373,Cheng; Chung Kuan,0,0,0,0
1668254280717,CSE 208,A00,102374,Micciancio; Daniele,0,0,0,0
1668254281142,CSE 209A,A00,112895,Impagliazzo; Russell,0,0,15,15
1668254281572,CSE 209B,A00,108005,Bellare; Mihir,0,0,0,0
1668254281997,CSE 210,A00,113163,Coblenz; Michael J,0,0,0,0
1668254282421,CSE 219,A00,106111,Dow; Steven P,0,0,20,20
1668254282851,CSE 221,A00,102376,Voelker; Geoffrey M.,0,0,0,0
1668254283277,CSE 224,A01,102378,Porter; George M,0,0,0,0
1668254283703,CSE 229A,A00,102379,Savage; Stefan,0,0,0,0
1668254284134,CSE 229C,A00,102380,Munyaka; Imani N. S.,0,0,0,0
1668254284565,CSE 232B,A00,102382,Deutsch; Alin Bernard,0,0,0,0
1668254284999,CSE 234,A01,112904,Kumar; Arun Kumar,0,0,0,0
1668254285428,CSE 237A,A00,102383,Rosing; Tajana Simunic,0,0,0,0
1668254285853,CSE 239A,A00,102384,Deutsch; Alin Bernard,0,0,0,0
1668254286277,CSE 239B,A00,102385,Polikarpova; Nadezhda,0,0,0,0
1668254286703,CSE 240A,A00,102386,Pannuto; Patrick William,0,0,0,0
1668254287130,CSE 240B,A00,102387,Zhao; Jishen,0,0,0,0
1668254287558,CSE 241A,A00,106406,Kang; Mingu,0,0,0,0
1668254287988,CSE 249B,A00,102388,Kahng; Andrew Byun,0,0,8,8
1668254288417,CSE 251B,A01,102392,Cottrell; Garrison W,0,0,0,0
1668254288417,CSE 251B,A02,102393,Cottrell; Garrison W,0,0,0,0
1668254288842,CSE 252B,A00,102394,Ochoa; Benjamin Lawrence,0,0,0,0
1668254289266,CSE 257,A01,102396,Gao; Sicun,0,0,0,0
1668254289689,CSE 272,A00,102397,Li; Tzumao,0,0,0,0
1668254290115,CSE 274,A00,111323,Chern; Albert Ren-Haur,0,0,0,0
1668254290541,CSE 282,A00,102398,Pevzner; Pavel Arkadjevich,0,0,0,0
1668254290977,CSE 284,A00,114175,Gymrek; Melissa Ann,0,0,0,0
1668254291410,CSE 290,A00,102399,Chandraker; Manmohan Krishna,0,0,0,0
1668254291410,CSE 290,B00,102400,Vaccaro; Kristen Marie,0,0,25,25
1668254291410,CSE 290,C00,102414,Pannuto; Patrick William,0,0,25,25
1668254291410,CSE 290,D00,102427,Pevzner; Pavel Arkadjevich,0,0,0,0
1668254291410,CSE 290,E00,102429,Zhao; Jishen,0,0,0,0
1668254291410,CSE 290,F00,102436,Tullsen; Dean Michael,0,0,0,0
1668254291410,CSE 290,G00,102440,Christensen; Henrik I,0,0,20,20
1668254291838,CSE 291,A00,102443,Su; Hao,0,0,0,0
1668254291838,CSE 291,B00,102448,Polikarpova; Nadezhda,0,0,0,0
1668254291838,CSE 291,C00,102453,Vaccaro; Kristen Marie,0,0,0,0
1668254291838,CSE 291,D00,111343,Savage; Stefan,0,0,0,0
1668254291838,CSE 291,E00,116474,Claffy; Kimberly Claire,0,0,0,0
1668254291838,CSE 291,F00,116479,Pasquale; Joseph,0,0,0,0
1668254292307,CSE 293,001,119111,Bafna; Vineet,9999,0,9999,0
1668254292307,CSE 293,002,119118,Bellare; Mihir,9999,0,9999,0
1668254292307,CSE 293,003,119122,Berg-Kirkpatrick; Taylor D,9999,0,9999,0
1668254292307,CSE 293,004,119135,Christensen; Henrik I,9999,0,9999,0
1668254292307,CSE 293,005,119142,Cottrell; Garrison W,9999,0,9999,0
1668254292307,CSE 293,006,119146,Deutsch; Alin Bernard,9999,0,9999,0
1668254292307,CSE 293,007,119159,Esmaeilzadeh; Hadi,9999,0,9999,0
1668254292307,CSE 293,008,119166,Freund; Yoav,9999,0,9999,0
1668254292307,CSE 293,009,119170,Griswold; William G.,9999,0,9999,0
1668254292307,CSE 293,010,119183,Gymrek; Melissa Ann,9999,0,9999,0
1668254292307,CSE 293,011,119190,Heninger; Nadia A,9999,0,9999,0
1668254292307,CSE 293,012,119230,Impagliazzo; Russell,9999,0,9999,0
1668254292307,CSE 293,013,119232,Jhala; Ranjit,9999,0,9999,0
1668254292307,CSE 293,014,119233,Kahng; Andrew Byun,9999,0,9999,0
1668254292307,CSE 293,015,119298,Kane; Daniel Mertz,9999,0,9999,0
1668254292307,CSE 293,016,119299,Kriegman; David J,9999,0,9999,0
1668254292307,CSE 293,017,119300,Kumar; Arun Kumar,9999,0,9999,0
1668254292307,CSE 293,018,119301,Lerner; Sorin,9999,0,9999,0
1668254292307,CSE 293,019,119302,Lovett; Shachar,9999,0,9999,0
1668254292307,CSE 293,020,119303,McAuley; Julian John,9999,0,9999,0
1668254292307,CSE 293,021,119304,Micciancio; Daniele,9999,0,9999,0
1668254292307,CSE 293,022,119367,Orailoglu; Alex,9999,0,9999,0
1668254292307,CSE 293,023,119382,Paturi; Ramamohan,9999,0,9999,0
1668254292307,CSE 293,024,119404,Polikarpova; Nadezhda,9999,0,9999,0
1668254292307,CSE 293,025,119406,Politz; Joseph Gibbs,9999,0,9999,0
1668254292307,CSE 293,026,119411,Porter; George M,9999,0,9999,0
1668254292307,CSE 293,027,119414,Porter; Leonard Emerson,9999,0,9999,0
1668254292307,CSE 293,028,119416,Ramamoorthi; Ravi,9999,0,9999,0
1668254292307,CSE 293,029,119417,Sahoo; Debashis,9999,0,9999,0
1668254292307,CSE 293,030,119420,Saul; Lawrence,9999,0,9999,0
1668254292307,CSE 293,031,119421,Savage; Stefan,9999,0,9999,0
1668254292307,CSE 293,032,119425,Schulze; Jurgen P.,9999,0,9999,0
1668254292307,CSE 293,033,119426,Snoeren; Alex C.,9999,0,9999,0
1668254292307,CSE 293,034,119428,Shang; Jingbo,9999,0,9999,0
1668254292307,CSE 293,035,119430,Stefan; Deian,9999,0,9999,0
1668254292307,CSE 293,036,119431,Su; Hao,9999,0,9999,0
1668254292307,CSE 293,037,119433,Swanson; Steven James,9999,0,9999,0
1668254292307,CSE 293,038,119435,Tullsen; Dean Michael,9999,0,9999,0
1668254292307,CSE 293,039,119483,Voelker; Geoffrey M.,9999,0,9999,0
1668254292307,CSE 293,040,119537,Zhao; Jishen,9999,0,9999,0
1668254292307,CSE 293,041,119538,Zhou; Yuan-Yuan,9999,0,9999,0
1668254292307,CSE 293,042,119539,Gao; Sicun,9999,0,9999,0
1668254292307,CSE 293,043,119540,Weibel; Nadir,9999,0,9999,0
1668254292307,CSE 293,044,119541,Gupta; Rajesh K.,9999,0,9999,0
1668254292307,CSE 293,045,126410,Vaccaro; Kristen Marie,9999,0,9999,0
1668254292307,CSE 293,046,126411,Klemke; Richard,9999,0,9999,0
1668254292731,CSE 294,A00,102459,Voelker; Geoffrey M.,0,0,0,0
1668254292731,CSE 294,B00,111322,Orailoglu; Alex,0,0,0,0
1668254293156,DSE 201,A00,096914,Deutsch; Alin Bernard,30,0,30,0
1668254293580,DSE 210,A00,096915,Dasgupta; Sanjoy,30,0,30,0
1668254294010,DSE 260A,A00,096916,Altintas De Callaf; Ilkay,30,0,30,0
1668254294512,ECE 200,001,103586,Antipa; Nicholas A,9999,0,9999,0
1668254294512,ECE 200,002,103587,Atanasov; Nikolay A.,9999,0,9999,0
1668254294512,ECE 200,003,103588,Bharadia; Dinesh,9999,0,9999,0
1668254294512,ECE 200,004,103589,Cheng; Chung Kuan,9999,0,9999,0
1668254294512,ECE 200,005,103590,Cosman; Pamela C.,9999,0,9999,0
1668254294512,ECE 200,006,103591,Dayeh; Shadi Ahmad,9999,0,9999,0
1668254294512,ECE 200,007,103592,Fainman; Yeshaiahu,9999,0,9999,0
1668254294512,ECE 200,008,103593,Ford; Joseph Earl,9999,0,9999,0
1668254294512,ECE 200,009,103594,Franceschetti; Massimo,9999,0,9999,0
1668254294512,ECE 200,010,103595,Fullerton; Eric E,9999,0,9999,0
1668254294512,ECE 200,011,103596,Galton; Ian A,9999,0,9999,0
1668254294512,ECE 200,012,103597,Gilja; Vikash,9999,0,9999,0
1668254294512,ECE 200,013,103598,Hall; Drew A.,9999,0,9999,0
1668254294512,ECE 200,014,103599,Hsueh; Tzu-Chien,9999,0,9999,0
1668254294512,ECE 200,015,103600,Javidi; Tara,9999,0,9999,0
1668254294512,ECE 200,016,103601,Kahng; Andrew Byun,9999,0,9999,0
1668254294512,ECE 200,017,103602,Kim; Young-Han,9999,0,9999,0
1668254294512,ECE 200,018,103603,Koushanfar; Farinaz,9999,0,9999,0
1668254294512,ECE 200,019,103604,Kuzum; Duygu,9999,0,9999,0
1668254294512,ECE 200,020,103605,Le; Hanh-Phuc,9999,0,9999,0
1668254294512,ECE 200,021,103606,Lin; Bill,9999,0,9999,0
1668254294512,ECE 200,022,103607,Liu; Zhaowei,9998,0,9999,1
1668254294512,ECE 200,023,103608,Lo; Yu-Hwa,9999,0,9999,0
1668254294512,ECE 200,024,103609,Lomakin; Vitaliy,9999,0,9999,0
1668254294512,ECE 200,025,103610,Mercier; Patrick Philip,9999,0,9999,0
1668254294512,ECE 200,026,103611,Meyer; Florian,9999,0,9999,0
1668254294512,ECE 200,027,103612,Milstein; Laurence B.,9999,0,9999,0
1668254294512,ECE 200,028,103613,Mir Arabbaygi; Siavash,9999,0,9999,0
1668254294512,ECE 200,029,103614,Mookherjea; Shayan,9999,0,9999,0
1668254294512,ECE 200,030,103615,Morris; Karcher William,9999,0,9999,0
1668254294512,ECE 200,031,103616,Ng; Tse Nga,9999,0,9999,0
1668254294512,ECE 200,032,103617,Nguyen; Truong Quang,9999,0,9999,0
1668254294512,ECE 200,033,103618,Nomura; Kenji,9999,0,9999,0
1668254294512,ECE 200,034,103619,Orlitsky; Alon,9999,0,9999,0
1668254294512,ECE 200,035,103620,Pal; Piya,9999,0,9999,0
1668254294512,ECE 200,036,103621,Papen; George C.,9999,0,9999,0
1668254294512,ECE 200,037,103622,Radic; Stojan,9999,0,9999,0
1668254294512,ECE 200,038,103623,Rao; Bhaskar D.,9999,0,9999,0
1668254294512,ECE 200,039,103624,Rao; Ramesh R,9999,0,9999,0
1668254294512,ECE 200,040,103625,Rebeiz; Gabriel,9999,0,9999,0
1668254294512,ECE 200,041,103626,Sanford; John R,9999,0,9999,0
1668254294512,ECE 200,042,103627,Siegel; Paul H.,9999,0,9999,0
1668254294512,ECE 200,043,103628,Sievenpiper; Daniel F.,9999,0,9999,0
1668254294512,ECE 200,044,103629,Sworder; David D.,9999,0,9999,0
1668254294512,ECE 200,045,103630,Taur; Yuan,9999,0,9999,0
1668254294512,ECE 200,046,103631,Touri; Behrouz,9999,0,9999,0
1668254294512,ECE 200,047,103632,Trivedi; Mohan M.,9999,0,9999,0
1668254294512,ECE 200,048,103633,Vasconcelos; Nuno,9999,0,9999,0
1668254294512,ECE 200,049,103634,Wang; Xiaolong,9999,0,9999,0
1668254294512,ECE 200,050,103635,Xie; Pengtao,9999,0,9999,0
1668254294512,ECE 200,051,103636,Yip; Michael,9999,0,9999,0
1668254294512,ECE 200,052,103637,Zeger; Kenneth A.,999,0,999,0
1668254294512,ECE 200,053,103638,Zhang; Xinyu,9999,0,9999,0
1668254294512,ECE 200,054,103639,Turakhia; Yatish Girish,9999,0,9999,0
1668254294512,ECE 200,055,103640,Kang; Mingu,9999,0,9999,0
1668254294512,ECE 200,056,103641,Shi; Yuanyuan,9999,0,9999,0
1668254294512,ECE 200,057,103642,Wang; Edward Jay,9999,0,9999,0
1668254294512,ECE 200,058,103643,Zheng; Yang,9999,0,9999,0
1668254294937,ECE 202,A00,103644,Kuzum; Duygu,0,0,0,0
1668254295366,ECE 212BN,A00,103646,Ng; Tse Nga,0,0,0,0
1668254295793,ECE 221,A00,111493,Staff,0,0,0,0
1668254296220,ECE 222B,A00,103647,Lomakin; Vitaliy,0,0,0,0
1668254296644,ECE 230B,A00,103648,Taur; Yuan,0,0,0,0
1668254297074,ECE 238B,A00,103649,Garay; Javier,0,0,0,0
1668254297499,ECE 240B,A00,112900,Fainman; Yeshaiahu,0,0,0,0
1668254297923,ECE 247A,A00,103650,Jokerst; Jesse Vincent,0,0,0,0
1668254298348,ECE 247B,A00,103651,Wang; Joseph,0,0,0,0
1668254298777,ECE 250,A00,103652,Siegel; Paul H.,0,0,0,0
1668254299204,ECE 251A,A00,103654,Rao; Bhaskar D.,0,0,0,0
1668254299630,ECE 257B,A00,103655,Bharadia; Dinesh,0,0,0,0
1668254300053,ECE 258A,A00,103656,Milstein; Laurence B.,0,0,0,0
1668254300485,ECE 260B,A00,103658,Kang; Mingu,0,0,0,0
1668254300910,ECE 264A,A00,103659,Galton; Ian A,0,0,0,0
1668254301335,ECE 265A,A00,103661,Gudem; Prasad S.S.,0,0,0,0
1668254301759,ECE 265D,A00,103662,Gudem; Prasad S.S.,0,0,0,0
1668254302184,ECE 268,A00,103663,Koushanfar; Farinaz,0,0,0,0
1668254302612,ECE 269,A01,103665,Pal; Piya,0,0,0,0
1668254303036,ECE 271B,A00,103666,Vasconcelos; Manuela,0,0,0,0
1668254303465,ECE 276A,A00,103667,Atanasov; Nikolay A.,0,0,0,0
1668254303970,ECE 277,A00,103668,An; Cheolhong,0,0,0,0
1668254304395,ECE 279,A00,117947,Hall; Drew A.,0,0,0,0
1668254305245,ECE 283,A00,103670,Hsueh; Tzu-Chien,0,0,0,0
1668254305669,ECE 284,A00,103671,Turakhia; Yatish Girish,0,0,0,0
1668254306094,ECE 285,A00,103672,Zheng; Yang,0,0,0,0
1668254306094,ECE 285,B00,103673,Sworder; David D.,0,0,0,0
1668254306521,ECE 287,A00,103676,Javidi; Tara,0,0,0,0
1668254306953,MATH 200B,A00,098023,Salehi Golsefidy; Alireza,12,0,15,3
1668254307382,MATH 202B,A00,098024,Rhoades; Brendon Patrick,9,0,15,6
1668254307810,MATH 203B,A00,098025,Oprea; Dragos N.,10,0,15,5
1668254308239,MATH 204B,A00,098026,Sorensen; Claus M,13,0,15,2
1668254308668,MATH 208,A00,098027,Izadi; Elham,7,0,10,3
1668254309094,MATH 209,A00,098028,Pollack; Aaron,10,0,10,0
1668254309518,MATH 211A,A00,112919,Rogalski; Daniel,9,0,10,1
1668254309942,MATH 211B,A00,112920,Seward; Brandon M.,9,0,10,1
1668254310370,MATH 218,A00,098029,Li; Bo,10,0,10,0
1668254310797,MATH 220B,A00,098030,Novak; Jonathan I,11,0,15,4
1668254311224,MATH 221A,A00,098031,Ebenfelt; Peter F,13,0,15,2
1668254311648,MATH 231B,A00,098032,Zlatos; Andrej,12,0,15,3
1668254312074,MATH 240B,A00,098033,Ni; Lei,9,0,15,6
1668254312498,MATH 243,A00,098034,Jekel; David Andrew,10,0,10,0
1668254312921,MATH 245A,A00,098035,Nie; Jiawang,0,0,15,16
1668254313348,MATH 248,A00,098036,Bejenaru; Ioan,10,0,10,0
1668254313771,MATH 250B,A00,098037,Spolaor; Luca,14,0,15,1
1668254314193,MATH 258,A00,098038,Ni; Lei,10,0,10,0
1668254314620,MATH 264B,A00,098041,Rhoades; Brendon Patrick,9,0,15,6
1668254315045,MATH 268,A00,098042,Buss; Samuel R,10,0,10,0
1668254315473,MATH 269,A00,098043,Rhoades; Brendon Patrick,10,0,10,0
1668254315901,MATH 270B,A00,098044,Li; Bo,10,0,15,5
1668254316332,MATH 272B,A00,098045,Holst; Michael J,13,0,15,2
1668254316755,MATH 273A,A00,098046,Tian; Xiaochuan,10,0,15,5
1668254317188,MATH 275,A01,098048,Tian; Xiaochuan,6,0,10,4
1668254317613,MATH 278A,A00,098049,Holst; Michael J,8,0,10,2
1668254318043,MATH 278B,A00,098050,Cloninger; Alexander,10,0,10,0
1668254318476,MATH 278C,A00,098051,Nie; Jiawang,7,0,10,3
1668254318903,MATH 280B,A00,098052,Zheng; Tianyi,9,0,15,6
1668254319326,MATH 281B,A00,098053,Bradic; Jelena,1,0,15,14
1668254319755,MATH 282B,A00,098054,Arias-Castro; Ery,0,0,15,15
1668254320183,MATH 285,A00,098055,Fitzsimmons; Patrick J,0,0,15,17
1668254320607,MATH 287B,A00,098056,Arias-Castro; Ery,2,0,15,13
1668254321041,MATH 288,A00,098057,Agarwal; Pooja,9,0,10,1
1668254321041,MATH 288,B00,098058,Zhang; Danna,8,0,10,2
1668254321041,MATH 288,C00,098059,Williams; Ruth J,10,0,10,0
1668254321466,MATH 290B,A00,098060,Roberts; Justin Deritter,13,0,15,2
1668254321899,MATH 292,A00,098061,Belmont; Eva Kinoshita,10,0,10,0
1668254322325,MATH 295,A00,098062,Suk; Andrew Hoon,48,0,50,2
1668254322749,MATH 296,A00,098063,Novak; Jonathan I,20,0,20,0
1668254323174,MATH 297,001,098064,Gamst; Anthony Collins,9997,0,9999,2
1668254826012,COGS 205,A00,101395,Chiba; Andrea,19,0,20,1
1668254826442,COGS 210B,001,101404,Greene; Deanna Jacquelyn,9998,0,9999,1
1668254826442,COGS 210B,002,101417,Xia; Haijun,9999,0,9999,0
1668254826442,COGS 210B,003,101422,Nitz; Douglas A.,9999,0,9999,0
1668254826442,COGS 210B,004,101423,Hollan; James D.,9998,0,9999,1
1668254826442,COGS 210B,005,101424,Deak; Gedeon O.,9998,0,9999,1
1668254826442,COGS 210B,006,101425,Rossano; Federico,9999,0,9999,0
1668254826878,COGS 211B,A00,101427,Coulson; Seana M,9996,0,9999,3
1668254827321,COGS 220,A00,101428,Hollan; James D.,0,0,25,25
1668254827762,COGS 229,A00,101429,Dow; Steven P,18,0,25,7
1668254828197,COGS 230,A00,101430,Klemmer; Scott R,12,0,17,5
1668254828650,COGS 234,A00,101431,Xia; Haijun,2,0,25,23
1668254829099,COGS 260,A00,101432,Kiyonaga; Anastasia,21,0,25,4
1668254829099,COGS 260,B00,101433,Kirsh; David Joel,15,0,25,10
1668254829538,CSE 202,A00,102371,Impagliazzo; Russell,0,0,0,0
1668254829969,CSE 203B,A01,102373,Cheng; Chung Kuan,0,0,0,0
1668254830404,CSE 208,A00,102374,Micciancio; Daniele,0,0,0,0
1668254830848,CSE 209A,A00,112895,Impagliazzo; Russell,0,0,15,15
1668254831278,CSE 209B,A00,108005,Bellare; Mihir,0,0,0,0
1668254831718,CSE 210,A00,113163,Coblenz; Michael J,0,0,0,0
1668254832145,CSE 219,A00,106111,Dow; Steven P,0,0,20,20
1668254832572,CSE 221,A00,102376,Voelker; Geoffrey M.,0,0,0,0
1668254833002,CSE 224,A01,102378,Porter; George M,0,0,0,0
1668254833502,CSE 229A,A00,102379,Savage; Stefan,0,0,0,0
1668254833927,CSE 229C,A00,102380,Munyaka; Imani N. S.,0,0,0,0
1668254834352,CSE 232B,A00,102382,Deutsch; Alin Bernard,0,0,0,0
1668254834791,CSE 234,A01,112904,Kumar; Arun Kumar,0,0,0,0
1668254835221,CSE 237A,A00,102383,Rosing; Tajana Simunic,0,0,0,0
1668254835649,CSE 239A,A00,102384,Deutsch; Alin Bernard,0,0,0,0
1668254836086,CSE 239B,A00,102385,Polikarpova; Nadezhda,0,0,0,0
1668254836517,CSE 240A,A00,102386,Pannuto; Patrick William,0,0,0,0
1668254836947,CSE 240B,A00,102387,Zhao; Jishen,0,0,0,0
1668254837378,CSE 241A,A00,106406,Kang; Mingu,0,0,0,0
1668254837818,CSE 249B,A00,102388,Kahng; Andrew Byun,0,0,8,8
1668254838250,CSE 251B,A01,102392,Cottrell; Garrison W,0,0,0,0
1668254838250,CSE 251B,A02,102393,Cottrell; Garrison W,0,0,0,0
1668254838673,CSE 252B,A00,102394,Ochoa; Benjamin Lawrence,0,0,0,0
1668254839099,CSE 257,A01,102396,Gao; Sicun,0,0,0,0
1668254839523,CSE 272,A00,102397,Li; Tzumao,0,0,0,0
1668254839952,CSE 274,A00,111323,Chern; Albert Ren-Haur,0,0,0,0
1668254840391,CSE 282,A00,102398,Pevzner; Pavel Arkadjevich,0,0,0,0
1668254840823,CSE 284,A00,114175,Gymrek; Melissa Ann,0,0,0,0
1668254841253,CSE 290,A00,102399,Chandraker; Manmohan Krishna,0,0,0,0
1668254841253,CSE 290,B00,102400,Vaccaro; Kristen Marie,0,0,25,25
1668254841253,CSE 290,C00,102414,Pannuto; Patrick William,0,0,25,25
1668254841253,CSE 290,D00,102427,Pevzner; Pavel Arkadjevich,0,0,0,0
1668254841253,CSE 290,E00,102429,Zhao; Jishen,0,0,0,0
1668254841253,CSE 290,F00,102436,Tullsen; Dean Michael,0,0,0,0
1668254841253,CSE 290,G00,102440,Christensen; Henrik I,0,0,20,20
1668254841682,CSE 291,A00,102443,Su; Hao,0,0,0,0
1668254841682,CSE 291,B00,102448,Polikarpova; Nadezhda,0,0,0,0
1668254841682,CSE 291,C00,102453,Vaccaro; Kristen Marie,0,0,0,0
1668254841682,CSE 291,D00,111343,Savage; Stefan,0,0,0,0
1668254841682,CSE 291,E00,116474,Claffy; Kimberly Claire,0,0,0,0
1668254841682,CSE 291,F00,116479,Pasquale; Joseph,0,0,0,0
1668254842179,CSE 293,001,119111,Bafna; Vineet,9999,0,9999,0
1668254842179,CSE 293,002,119118,Bellare; Mihir,9999,0,9999,0
1668254842179,CSE 293,003,119122,Berg-Kirkpatrick; Taylor D,9999,0,9999,0
1668254842179,CSE 293,004,119135,Christensen; Henrik I,9999,0,9999,0
1668254842179,CSE 293,005,119142,Cottrell; Garrison W,9999,0,9999,0
1668254842179,CSE 293,006,119146,Deutsch; Alin Bernard,9999,0,9999,0
1668254842179,CSE 293,007,119159,Esmaeilzadeh; Hadi,9999,0,9999,0
1668254842179,CSE 293,008,119166,Freund; Yoav,9999,0,9999,0
1668254842179,CSE 293,009,119170,Griswold; William G.,9999,0,9999,0
1668254842179,CSE 293,010,119183,Gymrek; Melissa Ann,9999,0,9999,0
1668254842179,CSE 293,011,119190,Heninger; Nadia A,9999,0,9999,0
1668254842179,CSE 293,012,119230,Impagliazzo; Russell,9999,0,9999,0
1668254842179,CSE 293,013,119232,Jhala; Ranjit,9999,0,9999,0
1668254842179,CSE 293,014,119233,Kahng; Andrew Byun,9999,0,9999,0
1668254842179,CSE 293,015,119298,Kane; Daniel Mertz,9999,0,9999,0
1668254842179,CSE 293,016,119299,Kriegman; David J,9999,0,9999,0
1668254842179,CSE 293,017,119300,Kumar; Arun Kumar,9999,0,9999,0
1668254842179,CSE 293,018,119301,Lerner; Sorin,9999,0,9999,0
1668254842179,CSE 293,019,119302,Lovett; Shachar,9999,0,9999,0
1668254842179,CSE 293,020,119303,McAuley; Julian John,9999,0,9999,0
1668254842179,CSE 293,021,119304,Micciancio; Daniele,9999,0,9999,0
1668254842179,CSE 293,022,119367,Orailoglu; Alex,9999,0,9999,0
1668254842179,CSE 293,023,119382,Paturi; Ramamohan,9999,0,9999,0
1668254842179,CSE 293,024,119404,Polikarpova; Nadezhda,9999,0,9999,0
1668254842179,CSE 293,025,119406,Politz; Joseph Gibbs,9999,0,9999,0
1668254842179,CSE 293,026,119411,Porter; George M,9999,0,9999,0
1668254842179,CSE 293,027,119414,Porter; Leonard Emerson,9999,0,9999,0
1668254842179,CSE 293,028,119416,Ramamoorthi; Ravi,9999,0,9999,0
1668254842179,CSE 293,029,119417,Sahoo; Debashis,9999,0,9999,0
1668254842179,CSE 293,030,119420,Saul; Lawrence,9999,0,9999,0
1668254842179,CSE 293,031,119421,Savage; Stefan,9999,0,9999,0
1668254842179,CSE 293,032,119425,Schulze; Jurgen P.,9999,0,9999,0
1668254842179,CSE 293,033,119426,Snoeren; Alex C.,9999,0,9999,0
1668254842179,CSE 293,034,119428,Shang; Jingbo,9999,0,9999,0
1668254842179,CSE 293,035,119430,Stefan; Deian,9999,0,9999,0
1668254842179,CSE 293,036,119431,Su; Hao,9999,0,9999,0
1668254842179,CSE 293,037,119433,Swanson; Steven James,9999,0,9999,0
1668254842179,CSE 293,038,119435,Tullsen; Dean Michael,9999,0,9999,0
1668254842179,CSE 293,039,119483,Voelker; Geoffrey M.,9999,0,9999,0
1668254842179,CSE 293,040,119537,Zhao; Jishen,9999,0,9999,0
1668254842179,CSE 293,041,119538,Zhou; Yuan-Yuan,9999,0,9999,0
1668254842179,CSE 293,042,119539,Gao; Sicun,9999,0,9999,0
1668254842179,CSE 293,043,119540,Weibel; Nadir,9999,0,9999,0
1668254842179,CSE 293,044,119541,Gupta; Rajesh K.,9999,0,9999,0
1668254842179,CSE 293,045,126410,Vaccaro; Kristen Marie,9999,0,9999,0
1668254842179,CSE 293,046,126411,Klemke; Richard,9999,0,9999,0
1668254842608,CSE 294,A00,102459,Voelker; Geoffrey M.,0,0,0,0
1668254842608,CSE 294,B00,111322,Orailoglu; Alex,0,0,0,0
1668254843037,DSE 201,A00,096914,Deutsch; Alin Bernard,30,0,30,0
1668254843471,DSE 210,A00,096915,Dasgupta; Sanjoy,30,0,30,0
1668254843906,DSE 260A,A00,096916,Altintas De Callaf; Ilkay,30,0,30,0
1668254844412,ECE 200,001,103586,Antipa; Nicholas A,9999,0,9999,0
1668254844412,ECE 200,002,103587,Atanasov; Nikolay A.,9999,0,9999,0
1668254844412,ECE 200,003,103588,Bharadia; Dinesh,9999,0,9999,0
1668254844412,ECE 200,004,103589,Cheng; Chung Kuan,9999,0,9999,0
1668254844412,ECE 200,005,103590,Cosman; Pamela C.,9999,0,9999,0
1668254844412,ECE 200,006,103591,Dayeh; Shadi Ahmad,9999,0,9999,0
1668254844412,ECE 200,007,103592,Fainman; Yeshaiahu,9999,0,9999,0
1668254844412,ECE 200,008,103593,Ford; Joseph Earl,9999,0,9999,0
1668254844412,ECE 200,009,103594,Franceschetti; Massimo,9999,0,9999,0
1668254844412,ECE 200,010,103595,Fullerton; Eric E,9999,0,9999,0
1668254844412,ECE 200,011,103596,Galton; Ian A,9999,0,9999,0
1668254844412,ECE 200,012,103597,Gilja; Vikash,9999,0,9999,0
1668254844412,ECE 200,013,103598,Hall; Drew A.,9999,0,9999,0
1668254844412,ECE 200,014,103599,Hsueh; Tzu-Chien,9999,0,9999,0
1668254844412,ECE 200,015,103600,Javidi; Tara,9999,0,9999,0
1668254844412,ECE 200,016,103601,Kahng; Andrew Byun,9999,0,9999,0
1668254844412,ECE 200,017,103602,Kim; Young-Han,9999,0,9999,0
1668254844412,ECE 200,018,103603,Koushanfar; Farinaz,9999,0,9999,0
1668254844412,ECE 200,019,103604,Kuzum; Duygu,9999,0,9999,0
1668254844412,ECE 200,020,103605,Le; Hanh-Phuc,9999,0,9999,0
1668254844412,ECE 200,021,103606,Lin; Bill,9999,0,9999,0
1668254844412,ECE 200,022,103607,Liu; Zhaowei,9998,0,9999,1
1668254844412,ECE 200,023,103608,Lo; Yu-Hwa,9999,0,9999,0
1668254844412,ECE 200,024,103609,Lomakin; Vitaliy,9999,0,9999,0
1668254844412,ECE 200,025,103610,Mercier; Patrick Philip,9999,0,9999,0
1668254844412,ECE 200,026,103611,Meyer; Florian,9999,0,9999,0
1668254844412,ECE 200,027,103612,Milstein; Laurence B.,9999,0,9999,0
1668254844412,ECE 200,028,103613,Mir Arabbaygi; Siavash,9999,0,9999,0
1668254844412,ECE 200,029,103614,Mookherjea; Shayan,9999,0,9999,0
1668254844412,ECE 200,030,103615,Morris; Karcher William,9999,0,9999,0
1668254844412,ECE 200,031,103616,Ng; Tse Nga,9999,0,9999,0
1668254844412,ECE 200,032,103617,Nguyen; Truong Quang,9999,0,9999,0
1668254844412,ECE 200,033,103618,Nomura; Kenji,9999,0,9999,0
1668254844412,ECE 200,034,103619,Orlitsky; Alon,9999,0,9999,0
1668254844412,ECE 200,035,103620,Pal; Piya,9999,0,9999,0
1668254844412,ECE 200,036,103621,Papen; George C.,9999,0,9999,0
1668254844412,ECE 200,037,103622,Radic; Stojan,9999,0,9999,0
1668254844412,ECE 200,038,103623,Rao; Bhaskar D.,9999,0,9999,0
1668254844412,ECE 200,039,103624,Rao; Ramesh R,9999,0,9999,0
1668254844412,ECE 200,040,103625,Rebeiz; Gabriel,9999,0,9999,0
1668254844412,ECE 200,041,103626,Sanford; John R,9999,0,9999,0
1668254844412,ECE 200,042,103627,Siegel; Paul H.,9999,0,9999,0
1668254844412,ECE 200,043,103628,Sievenpiper; Daniel F.,9999,0,9999,0
1668254844412,ECE 200,044,103629,Sworder; David D.,9999,0,9999,0
1668254844412,ECE 200,045,103630,Taur; Yuan,9999,0,9999,0
1668254844412,ECE 200,046,103631,Touri; Behrouz,9999,0,9999,0
1668254844412,ECE 200,047,103632,Trivedi; Mohan M.,9999,0,9999,0
1668254844412,ECE 200,048,103633,Vasconcelos; Nuno,9999,0,9999,0
1668254844412,ECE 200,049,103634,Wang; Xiaolong,9999,0,9999,0
1668254844412,ECE 200,050,103635,Xie; Pengtao,9999,0,9999,0
1668254844412,ECE 200,051,103636,Yip; Michael,9999,0,9999,0
1668254844412,ECE 200,052,103637,Zeger; Kenneth A.,999,0,999,0
1668254844412,ECE 200,053,103638,Zhang; Xinyu,9999,0,9999,0
1668254844412,ECE 200,054,103639,Turakhia; Yatish Girish,9999,0,9999,0
1668254844412,ECE 200,055,103640,Kang; Mingu,9999,0,9999,0
1668254844412,ECE 200,056,103641,Shi; Yuanyuan,9999,0,9999,0
1668254844412,ECE 200,057,103642,Wang; Edward Jay,9999,0,9999,0
1668254844412,ECE 200,058,103643,Zheng; Yang,9999,0,9999,0
1668254844837,ECE 202,A00,103644,Kuzum; Duygu,0,0,0,0
1668254845261,ECE 212BN,A00,103646,Ng; Tse Nga,0,0,0,0
1668254845686,ECE 221,A00,111493,Staff,0,0,0,0
1668254846112,ECE 222B,A00,103647,Lomakin; Vitaliy,0,0,0,0
1668254846535,ECE 230B,A00,103648,Taur; Yuan,0,0,0,0
1668254846967,ECE 238B,A00,103649,Garay; Javier,0,0,0,0
1668254847409,ECE 240B,A00,112900,Fainman; Yeshaiahu,0,0,0,0
1668254847833,ECE 247A,A00,103650,Jokerst; Jesse Vincent,0,0,0,0
1668254848258,ECE 247B,A00,103651,Wang; Joseph,0,0,0,0
1668254848685,ECE 250,A00,103652,Siegel; Paul H.,0,0,0,0
1668254862860,ECE 251A,A00,103654,Rao; Bhaskar D.,0,0,0,0
1668254863291,ECE 257B,A00,103655,Bharadia; Dinesh,0,0,0,0
1668254863716,ECE 258A,A00,103656,Milstein; Laurence B.,0,0,0,0
1668254864146,ECE 260B,A00,103658,Kang; Mingu,0,0,0,0
1668254864570,ECE 264A,A00,103659,Galton; Ian A,0,0,0,0
1668254864997,ECE 265A,A00,103661,Gudem; Prasad S.S.,0,0,0,0
1668254865425,ECE 265D,A00,103662,Gudem; Prasad S.S.,0,0,0,0
1668254865851,ECE 268,A00,103663,Koushanfar; Farinaz,0,0,0,0
1668254866281,ECE 269,A01,103665,Pal; Piya,0,0,0,0
1668254866706,ECE 271B,A00,103666,Vasconcelos; Manuela,0,0,0,0
1668254867137,ECE 276A,A00,103667,Atanasov; Nikolay A.,0,0,0,0
1668254867562,ECE 277,A00,103668,An; Cheolhong,0,0,0,0
1668254868009,ECE 279,A00,117947,Hall; Drew A.,0,0,0,0
1668254868885,ECE 283,A00,103670,Hsueh; Tzu-Chien,0,0,0,0
1668254869313,ECE 284,A00,103671,Turakhia; Yatish Girish,0,0,0,0
1668254869740,ECE 285,A00,103672,Zheng; Yang,0,0,0,0
1668254869740,ECE 285,B00,103673,Sworder; David D.,0,0,0,0
1668254870177,ECE 287,A00,103676,Javidi; Tara,0,0,0,0
1668254870614,MATH 200B,A00,098023,Salehi Golsefidy; Alireza,12,0,15,3
1668254871043,MATH 202B,A00,098024,Rhoades; Brendon Patrick,9,0,15,6
1668254871473,MATH 203B,A00,098025,Oprea; Dragos N.,10,0,15,5
1668254871898,MATH 204B,A00,098026,Sorensen; Claus M,13,0,15,2
1668254872326,MATH 208,A00,098027,Izadi; Elham,7,0,10,3
1668254872751,MATH 209,A00,098028,Pollack; Aaron,10,0,10,0
1668254886678,MATH 211A,A00,112919,Rogalski; Daniel,9,0,10,1
1668254887114,MATH 211B,A00,112920,Seward; Brandon M.,9,0,10,1
1668254887552,MATH 218,A00,098029,Li; Bo,10,0,10,0
1668254887982,MATH 220B,A00,098030,Novak; Jonathan I,11,0,15,4
1668254888410,MATH 221A,A00,098031,Ebenfelt; Peter F,13,0,15,2
1668254888856,MATH 231B,A00,098032,Zlatos; Andrej,12,0,15,3
1668254889288,MATH 240B,A00,098033,Ni; Lei,9,0,15,6
1668254889723,MATH 243,A00,098034,Jekel; David Andrew,10,0,10,0
1668254890149,MATH 245A,A00,098035,Nie; Jiawang,0,0,15,16
1668254890576,MATH 248,A00,098036,Bejenaru; Ioan,10,0,10,0
1668254891005,MATH 250B,A00,098037,Spolaor; Luca,14,0,15,1
1668254891435,MATH 258,A00,098038,Ni; Lei,10,0,10,0
1668254891860,MATH 264B,A00,098041,Rhoades; Brendon Patrick,9,0,15,6
1668254892287,MATH 268,A00,098042,Buss; Samuel R,10,0,10,0
1668254892723,MATH 269,A00,098043,Rhoades; Brendon Patrick,10,0,10,0
1668254893156,MATH 270B,A00,098044,Li; Bo,10,0,15,5
1668254893587,MATH 272B,A00,098045,Holst; Michael J,13,0,15,2
1668254894010,MATH 273A,A00,098046,Tian; Xiaochuan,10,0,15,5
1668254894437,MATH 275,A01,098048,Tian; Xiaochuan,6,0,10,4
1668254894872,MATH 278A,A00,098049,Holst; Michael J,8,0,10,2
1668254895299,MATH 278B,A00,098050,Cloninger; Alexander,10,0,10,0
1668254895721,MATH 278C,A00,098051,Nie; Jiawang,7,0,10,3
1668254896149,MATH 280B,A00,098052,Zheng; Tianyi,9,0,15,6
1668254896578,MATH 281B,A00,098053,Bradic; Jelena,1,0,15,14
1668254897007,MATH 282B,A00,098054,Arias-Castro; Ery,0,0,15,15
1668254910742,MATH 285,A00,098055,Fitzsimmons; Patrick J,0,0,15,17
1668254911164,MATH 287B,A00,098056,Arias-Castro; Ery,2,0,15,13
1668254911596,MATH 288,A00,098057,Agarwal; Pooja,9,0,10,1
1668254911596,MATH 288,B00,098058,Zhang; Danna,8,0,10,2
1668254911596,MATH 288,C00,098059,Williams; Ruth J,10,0,10,0
1668254912022,MATH 290B,A00,098060,Roberts; Justin Deritter,13,0,15,2
1668254912449,MATH 292,A00,098061,Belmont; Eva Kinoshita,10,0,10,0
1668254912886,MATH 295,A00,098062,Suk; Andrew Hoon,48,0,50,2
1668254913313,MATH 296,A00,098063,Novak; Jonathan I,20,0,20,0
1668254913736,MATH 297,001,098064,Gamst; Anthony Collins,9997,0,9999,2
