time,subj_course_id,sec_code,sec_id,prof,available,waitlist,total,enrolled_ct
1668256115384,COGS 205,A00,101395,Chiba; Andrea,19,0,20,1
1668256115811,COGS 210B,001,101404,Greene; Deanna Jacquelyn,9998,0,9999,1
1668256115811,COGS 210B,002,101417,Xia; Haijun,9999,0,9999,0
1668256115811,COGS 210B,003,101422,Nitz; Douglas A.,9999,0,9999,0
1668256115811,COGS 210B,004,101423,Hollan; James D.,9998,0,9999,1
1668256115811,COGS 210B,005,101424,Deak; Gedeon O.,9998,0,9999,1
1668256115811,COGS 210B,006,101425,Rossano; Federico,9999,0,9999,0
1668256116240,COGS 211B,A00,101427,Coulson; Seana M,9996,0,9999,3
1668256116666,COGS 220,A00,101428,Hollan; James D.,0,0,25,25
1668256117094,COGS 229,A00,101429,Dow; Steven P,18,0,25,7
1668256117525,COGS 230,A00,101430,Klemmer; Scott R,12,0,17,5
1668256117954,COGS 234,A00,101431,Xia; Haijun,2,0,25,23
1668256118386,COGS 260,A00,101432,Kiyonaga; Anastasia,21,0,25,4
1668256118386,COGS 260,B00,101433,Kirsh; David Joel,15,0,25,10
1668256118814,CSE 202,A00,102371,Impagliazzo; Russell,0,0,0,0
1668256119242,CSE 203B,A01,102373,Cheng; Chung Kuan,0,0,0,0
1668256119676,CSE 208,A00,102374,Micciancio; Daniele,0,0,0,0
1668256120103,CSE 209A,A00,112895,Impagliazzo; Russell,0,0,15,15
1668256120537,CSE 209B,A00,108005,Bellare; Mihir,0,0,0,0
1668256120972,CSE 210,A00,113163,Coblenz; Michael J,0,0,0,0
1668256121400,CSE 219,A00,106111,Dow; Steven P,0,0,20,20
1668256121830,CSE 221,A00,102376,Voelker; Geoffrey M.,0,0,0,0
1668256122256,CSE 224,A01,102378,Porter; George M,0,0,0,0
1668256122682,CSE 229A,A00,102379,Savage; Stefan,0,0,0,0
1668256123110,CSE 229C,A00,102380,Munyaka; Imani N. S.,0,0,0,0
1668256123535,CSE 232B,A00,102382,Deutsch; Alin Bernard,0,0,0,0
1668256123963,CSE 234,A01,112904,Kumar; Arun Kumar,0,0,0,0
1668256124391,CSE 237A,A00,102383,Rosing; Tajana Simunic,0,0,0,0
1668256124817,CSE 239A,A00,102384,Deutsch; Alin Bernard,0,0,0,0
1668256125244,CSE 239B,A00,102385,Polikarpova; Nadezhda,0,0,0,0
1668256125673,CSE 240A,A00,102386,Pannuto; Patrick William,0,0,0,0
1668256126101,CSE 240B,A00,102387,Zhao; Jishen,0,0,0,0
1668256126528,CSE 241A,A00,106406,Kang; Mingu,0,0,0,0
1668256126952,CSE 249B,A00,102388,Kahng; Andrew Byun,0,0,8,8
1668256127384,CSE 251B,A01,102392,Cottrell; Garrison W,0,0,0,0
1668256127384,CSE 251B,A02,102393,Cottrell; Garrison W,0,0,0,0
1668256127813,CSE 252B,A00,102394,Ochoa; Benjamin Lawrence,0,0,0,0
1668256128241,CSE 257,A01,102396,Gao; Sicun,0,0,0,0
1668256128672,CSE 272,A00,102397,Li; Tzumao,0,0,0,0
1668256129099,CSE 274,A00,111323,Chern; Albert Ren-Haur,0,0,0,0
1668256129528,CSE 282,A00,102398,Pevzner; Pavel Arkadjevich,0,0,0,0
1668256129958,CSE 284,A00,114175,Gymrek; Melissa Ann,0,0,0,0
1668256130403,CSE 290,A00,102399,Chandraker; Manmohan Krishna,0,0,0,0
1668256130403,CSE 290,B00,102400,Vaccaro; Kristen Marie,0,0,25,25
1668256130403,CSE 290,C00,102414,Pannuto; Patrick William,0,0,25,25
1668256130403,CSE 290,D00,102427,Pevzner; Pavel Arkadjevich,0,0,0,0
1668256130403,CSE 290,E00,102429,Zhao; Jishen,0,0,0,0
1668256130403,CSE 290,F00,102436,Tullsen; Dean Michael,0,0,0,0
1668256130403,CSE 290,G00,102440,Christensen; Henrik I,0,0,20,20
1668256130844,CSE 291,A00,102443,Su; Hao,0,0,0,0
1668256130844,CSE 291,B00,102448,Polikarpova; Nadezhda,0,0,0,0
1668256130844,CSE 291,C00,102453,Vaccaro; Kristen Marie,0,0,0,0
1668256130844,CSE 291,D00,111343,Savage; Stefan,0,0,0,0
1668256130844,CSE 291,E00,116474,Claffy; Kimberly Claire,0,0,0,0
1668256130844,CSE 291,F00,116479,Pasquale; Joseph,0,0,0,0
1668256131292,CSE 293,001,119111,Bafna; Vineet,9999,0,9999,0
1668256131292,CSE 293,002,119118,Bellare; Mihir,9999,0,9999,0
1668256131292,CSE 293,003,119122,Berg-Kirkpatrick; Taylor D,9999,0,9999,0
1668256131292,CSE 293,004,119135,Christensen; Henrik I,9999,0,9999,0
1668256131292,CSE 293,005,119142,Cottrell; Garrison W,9999,0,9999,0
1668256131292,CSE 293,006,119146,Deutsch; Alin Bernard,9999,0,9999,0
1668256131292,CSE 293,007,119159,Esmaeilzadeh; Hadi,9999,0,9999,0
1668256131292,CSE 293,008,119166,Freund; Yoav,9999,0,9999,0
1668256131292,CSE 293,009,119170,Griswold; William G.,9999,0,9999,0
1668256131292,CSE 293,010,119183,Gymrek; Melissa Ann,9999,0,9999,0
1668256131292,CSE 293,011,119190,Heninger; Nadia A,9999,0,9999,0
1668256131292,CSE 293,012,119230,Impagliazzo; Russell,9999,0,9999,0
1668256131292,CSE 293,013,119232,Jhala; Ranjit,9999,0,9999,0
1668256131292,CSE 293,014,119233,Kahng; Andrew Byun,9999,0,9999,0
1668256131292,CSE 293,015,119298,Kane; Daniel Mertz,9999,0,9999,0
1668256131292,CSE 293,016,119299,Kriegman; David J,9999,0,9999,0
1668256131292,CSE 293,017,119300,Kumar; Arun Kumar,9999,0,9999,0
1668256131292,CSE 293,018,119301,Lerner; Sorin,9999,0,9999,0
1668256131292,CSE 293,019,119302,Lovett; Shachar,9999,0,9999,0
1668256131292,CSE 293,020,119303,McAuley; Julian John,9999,0,9999,0
1668256131292,CSE 293,021,119304,Micciancio; Daniele,9999,0,9999,0
1668256131292,CSE 293,022,119367,Orailoglu; Alex,9999,0,9999,0
1668256131292,CSE 293,023,119382,Paturi; Ramamohan,9999,0,9999,0
1668256131292,CSE 293,024,119404,Polikarpova; Nadezhda,9999,0,9999,0
1668256131292,CSE 293,025,119406,Politz; Joseph Gibbs,9999,0,9999,0
1668256131292,CSE 293,026,119411,Porter; George M,9999,0,9999,0
1668256131292,CSE 293,027,119414,Porter; Leonard Emerson,9999,0,9999,0
1668256131292,CSE 293,028,119416,Ramamoorthi; Ravi,9999,0,9999,0
1668256131292,CSE 293,029,119417,Sahoo; Debashis,9999,0,9999,0
1668256131292,CSE 293,030,119420,Saul; Lawrence,9999,0,9999,0
1668256131292,CSE 293,031,119421,Savage; Stefan,9999,0,9999,0
1668256131292,CSE 293,032,119425,Schulze; Jurgen P.,9999,0,9999,0
1668256131292,CSE 293,033,119426,Snoeren; Alex C.,9999,0,9999,0
1668256131292,CSE 293,034,119428,Shang; Jingbo,9999,0,9999,0
1668256131292,CSE 293,035,119430,Stefan; Deian,9999,0,9999,0
1668256131292,CSE 293,036,119431,Su; Hao,9999,0,9999,0
1668256131292,CSE 293,037,119433,Swanson; Steven James,9999,0,9999,0
1668256131292,CSE 293,038,119435,Tullsen; Dean Michael,9999,0,9999,0
1668256131292,CSE 293,039,119483,Voelker; Geoffrey M.,9999,0,9999,0
1668256131292,CSE 293,040,119537,Zhao; Jishen,9999,0,9999,0
1668256131292,CSE 293,041,119538,Zhou; Yuan-Yuan,9999,0,9999,0
1668256131292,CSE 293,042,119539,Gao; Sicun,9999,0,9999,0
1668256131292,CSE 293,043,119540,Weibel; Nadir,9999,0,9999,0
1668256131292,CSE 293,044,119541,Gupta; Rajesh K.,9999,0,9999,0
1668256131292,CSE 293,045,126410,Vaccaro; Kristen Marie,9999,0,9999,0
1668256131292,CSE 293,046,126411,Klemke; Richard,9999,0,9999,0
1668256131722,CSE 294,A00,102459,Voelker; Geoffrey M.,0,0,0,0
1668256131722,CSE 294,B00,111322,Orailoglu; Alex,0,0,0,0
1668256132147,DSE 201,A00,096914,Deutsch; Alin Bernard,30,0,30,0
1668256132577,DSE 210,A00,096915,Dasgupta; Sanjoy,30,0,30,0
1668256133010,DSE 260A,A00,096916,Altintas De Callaf; Ilkay,30,0,30,0
1668256133470,ECE 200,001,103586,Antipa; Nicholas A,9999,0,9999,0
1668256133470,ECE 200,002,103587,Atanasov; Nikolay A.,9999,0,9999,0
1668256133470,ECE 200,003,103588,Bharadia; Dinesh,9999,0,9999,0
1668256133470,ECE 200,004,103589,Cheng; Chung Kuan,9999,0,9999,0
1668256133470,ECE 200,005,103590,Cosman; Pamela C.,9999,0,9999,0
1668256133470,ECE 200,006,103591,Dayeh; Shadi Ahmad,9999,0,9999,0
1668256133470,ECE 200,007,103592,Fainman; Yeshaiahu,9999,0,9999,0
1668256133470,ECE 200,008,103593,Ford; Joseph Earl,9999,0,9999,0
1668256133470,ECE 200,009,103594,Franceschetti; Massimo,9999,0,9999,0
1668256133470,ECE 200,010,103595,Fullerton; Eric E,9999,0,9999,0
1668256133470,ECE 200,011,103596,Galton; Ian A,9999,0,9999,0
1668256133470,ECE 200,012,103597,Gilja; Vikash,9999,0,9999,0
1668256133470,ECE 200,013,103598,Hall; Drew A.,9999,0,9999,0
1668256133470,ECE 200,014,103599,Hsueh; Tzu-Chien,9999,0,9999,0
1668256133470,ECE 200,015,103600,Javidi; Tara,9999,0,9999,0
1668256133470,ECE 200,016,103601,Kahng; Andrew Byun,9999,0,9999,0
1668256133470,ECE 200,017,103602,Kim; Young-Han,9999,0,9999,0
1668256133470,ECE 200,018,103603,Koushanfar; Farinaz,9999,0,9999,0
1668256133470,ECE 200,019,103604,Kuzum; Duygu,9999,0,9999,0
1668256133470,ECE 200,020,103605,Le; Hanh-Phuc,9999,0,9999,0
1668256133470,ECE 200,021,103606,Lin; Bill,9999,0,9999,0
1668256133470,ECE 200,022,103607,Liu; Zhaowei,9998,0,9999,1
1668256133470,ECE 200,023,103608,Lo; Yu-Hwa,9999,0,9999,0
1668256133470,ECE 200,024,103609,Lomakin; Vitaliy,9999,0,9999,0
1668256133470,ECE 200,025,103610,Mercier; Patrick Philip,9999,0,9999,0
1668256133470,ECE 200,026,103611,Meyer; Florian,9999,0,9999,0
1668256133470,ECE 200,027,103612,Milstein; Laurence B.,9999,0,9999,0
1668256133470,ECE 200,028,103613,Mir Arabbaygi; Siavash,9999,0,9999,0
1668256133470,ECE 200,029,103614,Mookherjea; Shayan,9999,0,9999,0
1668256133470,ECE 200,030,103615,Morris; Karcher William,9999,0,9999,0
1668256133470,ECE 200,031,103616,Ng; Tse Nga,9999,0,9999,0
1668256133470,ECE 200,032,103617,Nguyen; Truong Quang,9999,0,9999,0
1668256133470,ECE 200,033,103618,Nomura; Kenji,9999,0,9999,0
1668256133470,ECE 200,034,103619,Orlitsky; Alon,9999,0,9999,0
1668256133470,ECE 200,035,103620,Pal; Piya,9999,0,9999,0
1668256133470,ECE 200,036,103621,Papen; George C.,9999,0,9999,0
1668256133470,ECE 200,037,103622,Radic; Stojan,9999,0,9999,0
1668256133470,ECE 200,038,103623,Rao; Bhaskar D.,9999,0,9999,0
1668256133470,ECE 200,039,103624,Rao; Ramesh R,9999,0,9999,0
1668256133470,ECE 200,040,103625,Rebeiz; Gabriel,9999,0,9999,0
1668256133470,ECE 200,041,103626,Sanford; John R,9999,0,9999,0
1668256133470,ECE 200,042,103627,Siegel; Paul H.,9999,0,9999,0
1668256133470,ECE 200,043,103628,Sievenpiper; Daniel F.,9999,0,9999,0
1668256133470,ECE 200,044,103629,Sworder; David D.,9999,0,9999,0
1668256133470,ECE 200,045,103630,Taur; Yuan,9999,0,9999,0
1668256133470,ECE 200,046,103631,Touri; Behrouz,9999,0,9999,0
1668256133470,ECE 200,047,103632,Trivedi; Mohan M.,9999,0,9999,0
1668256133470,ECE 200,048,103633,Vasconcelos; Nuno,9999,0,9999,0
1668256133470,ECE 200,049,103634,Wang; Xiaolong,9999,0,9999,0
1668256133470,ECE 200,050,103635,Xie; Pengtao,9999,0,9999,0
1668256133470,ECE 200,051,103636,Yip; Michael,9999,0,9999,0
1668256133470,ECE 200,052,103637,Zeger; Kenneth A.,999,0,999,0
1668256133470,ECE 200,053,103638,Zhang; Xinyu,9999,0,9999,0
1668256133470,ECE 200,054,103639,Turakhia; Yatish Girish,9999,0,9999,0
1668256133470,ECE 200,055,103640,Kang; Mingu,9999,0,9999,0
1668256133470,ECE 200,056,103641,Shi; Yuanyuan,9999,0,9999,0
1668256133470,ECE 200,057,103642,Wang; Edward Jay,9999,0,9999,0
1668256133470,ECE 200,058,103643,Zheng; Yang,9999,0,9999,0
1668256133911,ECE 202,A00,103644,Kuzum; Duygu,0,0,0,0
1668256134350,ECE 212BN,A00,103646,Ng; Tse Nga,0,0,0,0
1668256134857,ECE 221,A00,111493,Staff,0,0,0,0
1668256135286,ECE 222B,A00,103647,Lomakin; Vitaliy,0,0,0,0
1668256135718,ECE 230B,A00,103648,Taur; Yuan,0,0,0,0
1668256136149,ECE 238B,A00,103649,Garay; Javier,0,0,0,0
1668256136585,ECE 240B,A00,112900,Fainman; Yeshaiahu,0,0,0,0
1668256137014,ECE 247A,A00,103650,Jokerst; Jesse Vincent,0,0,0,0
1668256137451,ECE 247B,A00,103651,Wang; Joseph,0,0,0,0
1668256137883,ECE 250,A00,103652,Siegel; Paul H.,0,0,0,0
1668256138310,ECE 251A,A00,103654,Rao; Bhaskar D.,0,0,0,0
1668256138736,ECE 257B,A00,103655,Bharadia; Dinesh,0,0,0,0
1668256139172,ECE 258A,A00,103656,Milstein; Laurence B.,0,0,0,0
1668256139604,ECE 260B,A00,103658,Kang; Mingu,0,0,0,0
1668256140040,ECE 264A,A00,103659,Galton; Ian A,0,0,0,0
1668256140493,ECE 265A,A00,103661,Gudem; Prasad S.S.,0,0,0,0
1668256140925,ECE 265D,A00,103662,Gudem; Prasad S.S.,0,0,0,0
1668256141367,ECE 268,A00,103663,Koushanfar; Farinaz,0,0,0,0
1668256141801,ECE 269,A01,103665,Pal; Piya,0,0,0,0
1668256142232,ECE 271B,A00,103666,Vasconcelos; Manuela,0,0,0,0
1668256142665,ECE 276A,A00,103667,Atanasov; Nikolay A.,0,0,0,0
1668256143106,ECE 277,A00,103668,An; Cheolhong,0,0,0,0
1668256143532,ECE 279,A00,117947,Hall; Drew A.,0,0,0,0
1668256144406,ECE 283,A00,103670,Hsueh; Tzu-Chien,0,0,0,0
1668256144836,ECE 284,A00,103671,Turakhia; Yatish Girish,0,0,0,0
1668256145259,ECE 285,A00,103672,Zheng; Yang,0,0,0,0
1668256145259,ECE 285,B00,103673,Sworder; David D.,0,0,0,0
1668256145695,ECE 287,A00,103676,Javidi; Tara,0,0,0,0
1668256146122,MATH 200B,A00,098023,Salehi Golsefidy; Alireza,12,0,15,3
1668256146551,MATH 202B,A00,098024,Rhoades; Brendon Patrick,9,0,15,6
1668256146982,MATH 203B,A00,098025,Oprea; Dragos N.,10,0,15,5
1668256147405,MATH 204B,A00,098026,Sorensen; Claus M,13,0,15,2
1668256147831,MATH 208,A00,098027,Izadi; Elham,7,0,10,3
1668256148256,MATH 209,A00,098028,Pollack; Aaron,10,0,10,0
1668256148684,MATH 211A,A00,112919,Rogalski; Daniel,9,0,10,1
1668256149111,MATH 211B,A00,112920,Seward; Brandon M.,9,0,10,1
1668256149549,MATH 218,A00,098029,Li; Bo,10,0,10,0
1668256150007,MATH 220B,A00,098030,Novak; Jonathan I,11,0,15,4
1668256150446,MATH 221A,A00,098031,Ebenfelt; Peter F,13,0,15,2
1668256150885,MATH 231B,A00,098032,Zlatos; Andrej,12,0,15,3
1668256151318,MATH 240B,A00,098033,Ni; Lei,9,0,15,6
1668256151752,MATH 243,A00,098034,Jekel; David Andrew,10,0,10,0
1668256152184,MATH 245A,A00,098035,Nie; Jiawang,0,0,15,16
1668256152620,MATH 248,A00,098036,Bejenaru; Ioan,10,0,10,0
1668256153057,MATH 250B,A00,098037,Spolaor; Luca,14,0,15,1
1668256153495,MATH 258,A00,098038,Ni; Lei,10,0,10,0
1668256153952,MATH 264B,A00,098041,Rhoades; Brendon Patrick,9,0,15,6
1668256154377,MATH 268,A00,098042,Buss; Samuel R,10,0,10,0
1668256154812,MATH 269,A00,098043,Rhoades; Brendon Patrick,10,0,10,0
1668256155255,MATH 270B,A00,098044,Li; Bo,10,0,15,5
1668256155693,MATH 272B,A00,098045,Holst; Michael J,13,0,15,2
1668256156126,MATH 273A,A00,098046,Tian; Xiaochuan,10,0,15,5
1668256156556,MATH 275,A01,098048,Tian; Xiaochuan,6,0,10,4
1668256156992,MATH 278A,A00,098049,Holst; Michael J,8,0,10,2
1668256157429,MATH 278B,A00,098050,Cloninger; Alexander,10,0,10,0
1668256157856,MATH 278C,A00,098051,Nie; Jiawang,7,0,10,3
1668256158283,MATH 280B,A00,098052,Zheng; Tianyi,9,0,15,6
1668256158709,MATH 281B,A00,098053,Bradic; Jelena,1,0,15,14
1668256159139,MATH 282B,A00,098054,Arias-Castro; Ery,0,0,15,15
1668256159566,MATH 285,A00,098055,Fitzsimmons; Patrick J,0,0,15,17
1668256160001,MATH 287B,A00,098056,Arias-Castro; Ery,2,0,15,13
1668256160434,MATH 288,A00,098057,Agarwal; Pooja,9,0,10,1
1668256160434,MATH 288,B00,098058,Zhang; Danna,8,0,10,2
1668256160434,MATH 288,C00,098059,Williams; Ruth J,10,0,10,0
1668256160878,MATH 290B,A00,098060,Roberts; Justin Deritter,13,0,15,2
1668256161308,MATH 292,A00,098061,Belmont; Eva Kinoshita,10,0,10,0
1668256161742,MATH 295,A00,098062,Suk; Andrew Hoon,48,0,50,2
1668256162167,MATH 296,A00,098063,Novak; Jonathan I,20,0,20,0
1668256162594,MATH 297,001,098064,Gamst; Anthony Collins,9997,0,9999,2
1668256666333,COGS 205,A00,101395,Chiba; Andrea,19,0,20,1
1668256666770,COGS 210B,001,101404,Greene; Deanna Jacquelyn,9998,0,9999,1
1668256666770,COGS 210B,002,101417,Xia; Haijun,9999,0,9999,0
1668256666770,COGS 210B,003,101422,Nitz; Douglas A.,9999,0,9999,0
1668256666770,COGS 210B,004,101423,Hollan; James D.,9998,0,9999,1
1668256666770,COGS 210B,005,101424,Deak; Gedeon O.,9998,0,9999,1
1668256666770,COGS 210B,006,101425,Rossano; Federico,9999,0,9999,0
1668256667198,COGS 211B,A00,101427,Coulson; Seana M,9996,0,9999,3
1668256667626,COGS 220,A00,101428,Hollan; James D.,0,0,25,25
1668256668061,COGS 229,A00,101429,Dow; Steven P,18,0,25,7
1668256668492,COGS 230,A00,101430,Klemmer; Scott R,12,0,17,5
1668256668923,COGS 234,A00,101431,Xia; Haijun,2,0,25,23
1668256669349,COGS 260,A00,101432,Kiyonaga; Anastasia,21,0,25,4
1668256669349,COGS 260,B00,101433,Kirsh; David Joel,15,0,25,10
1668256669778,CSE 202,A00,102371,Impagliazzo; Russell,0,0,0,0
1668256670205,CSE 203B,A01,102373,Cheng; Chung Kuan,0,0,0,0
1668256670629,CSE 208,A00,102374,Micciancio; Daniele,0,0,0,0
1668256671073,CSE 209A,A00,112895,Impagliazzo; Russell,0,0,15,15
1668256671516,CSE 209B,A00,108005,Bellare; Mihir,0,0,0,0
1668256671948,CSE 210,A00,113163,Coblenz; Michael J,0,0,0,0
1668256672389,CSE 219,A00,106111,Dow; Steven P,0,0,20,20
1668256672820,CSE 221,A00,102376,Voelker; Geoffrey M.,0,0,0,0
1668256673246,CSE 224,A01,102378,Porter; George M,0,0,0,0
1668256673671,CSE 229A,A00,102379,Savage; Stefan,0,0,0,0
1668256674097,CSE 229C,A00,102380,Munyaka; Imani N. S.,0,0,0,0
1668256674532,CSE 232B,A00,102382,Deutsch; Alin Bernard,0,0,0,0
1668256674961,CSE 234,A01,112904,Kumar; Arun Kumar,0,0,0,0
1668256675397,CSE 237A,A00,102383,Rosing; Tajana Simunic,0,0,0,0
1668256675820,CSE 239A,A00,102384,Deutsch; Alin Bernard,0,0,0,0
1668256676250,CSE 239B,A00,102385,Polikarpova; Nadezhda,0,0,0,0
1668256676678,CSE 240A,A00,102386,Pannuto; Patrick William,0,0,0,0
1668256677104,CSE 240B,A00,102387,Zhao; Jishen,0,0,0,0
1668256677532,CSE 241A,A00,106406,Kang; Mingu,0,0,0,0
1668256677956,CSE 249B,A00,102388,Kahng; Andrew Byun,0,0,8,8
1668256678389,CSE 251B,A01,102392,Cottrell; Garrison W,0,0,0,0
1668256678389,CSE 251B,A02,102393,Cottrell; Garrison W,0,0,0,0
1668256678814,CSE 252B,A00,102394,Ochoa; Benjamin Lawrence,0,0,0,0
1668256679243,CSE 257,A01,102396,Gao; Sicun,0,0,0,0
1668256679671,CSE 272,A00,102397,Li; Tzumao,0,0,0,0
1668256680098,CSE 274,A00,111323,Chern; Albert Ren-Haur,0,0,0,0
1668256680527,CSE 282,A00,102398,Pevzner; Pavel Arkadjevich,0,0,0,0
1668256680953,CSE 284,A00,114175,Gymrek; Melissa Ann,0,0,0,0
1668256681386,CSE 290,A00,102399,Chandraker; Manmohan Krishna,0,0,0,0
1668256681386,CSE 290,B00,102400,Vaccaro; Kristen Marie,0,0,25,25
1668256681386,CSE 290,C00,102414,Pannuto; Patrick William,0,0,25,25
1668256681386,CSE 290,D00,102427,Pevzner; Pavel Arkadjevich,0,0,0,0
1668256681386,CSE 290,E00,102429,Zhao; Jishen,0,0,0,0
1668256681386,CSE 290,F00,102436,Tullsen; Dean Michael,0,0,0,0
1668256681386,CSE 290,G00,102440,Christensen; Henrik I,0,0,20,20
1668256681824,CSE 291,A00,102443,Su; Hao,0,0,0,0
1668256681824,CSE 291,B00,102448,Polikarpova; Nadezhda,0,0,0,0
1668256681824,CSE 291,C00,102453,Vaccaro; Kristen Marie,0,0,0,0
1668256681824,CSE 291,D00,111343,Savage; Stefan,0,0,0,0
1668256681824,CSE 291,E00,116474,Claffy; Kimberly Claire,0,0,0,0
1668256681824,CSE 291,F00,116479,Pasquale; Joseph,0,0,0,0
1668256682286,CSE 293,001,119111,Bafna; Vineet,9999,0,9999,0
1668256682286,CSE 293,002,119118,Bellare; Mihir,9999,0,9999,0
1668256682286,CSE 293,003,119122,Berg-Kirkpatrick; Taylor D,9999,0,9999,0
1668256682286,CSE 293,004,119135,Christensen; Henrik I,9999,0,9999,0
1668256682286,CSE 293,005,119142,Cottrell; Garrison W,9999,0,9999,0
1668256682286,CSE 293,006,119146,Deutsch; Alin Bernard,9999,0,9999,0
1668256682286,CSE 293,007,119159,Esmaeilzadeh; Hadi,9999,0,9999,0
1668256682286,CSE 293,008,119166,Freund; Yoav,9999,0,9999,0
1668256682286,CSE 293,009,119170,Griswold; William G.,9999,0,9999,0
1668256682286,CSE 293,010,119183,Gymrek; Melissa Ann,9999,0,9999,0
1668256682286,CSE 293,011,119190,Heninger; Nadia A,9999,0,9999,0
1668256682286,CSE 293,012,119230,Impagliazzo; Russell,9999,0,9999,0
1668256682286,CSE 293,013,119232,Jhala; Ranjit,9999,0,9999,0
1668256682286,CSE 293,014,119233,Kahng; Andrew Byun,9999,0,9999,0
1668256682286,CSE 293,015,119298,Kane; Daniel Mertz,9999,0,9999,0
1668256682286,CSE 293,016,119299,Kriegman; David J,9999,0,9999,0
1668256682286,CSE 293,017,119300,Kumar; Arun Kumar,9999,0,9999,0
1668256682286,CSE 293,018,119301,Lerner; Sorin,9999,0,9999,0
1668256682286,CSE 293,019,119302,Lovett; Shachar,9999,0,9999,0
1668256682286,CSE 293,020,119303,McAuley; Julian John,9999,0,9999,0
1668256682286,CSE 293,021,119304,Micciancio; Daniele,9999,0,9999,0
1668256682286,CSE 293,022,119367,Orailoglu; Alex,9999,0,9999,0
1668256682286,CSE 293,023,119382,Paturi; Ramamohan,9999,0,9999,0
1668256682286,CSE 293,024,119404,Polikarpova; Nadezhda,9999,0,9999,0
1668256682286,CSE 293,025,119406,Politz; Joseph Gibbs,9999,0,9999,0
1668256682286,CSE 293,026,119411,Porter; George M,9999,0,9999,0
1668256682286,CSE 293,027,119414,Porter; Leonard Emerson,9999,0,9999,0
1668256682286,CSE 293,028,119416,Ramamoorthi; Ravi,9999,0,9999,0
1668256682286,CSE 293,029,119417,Sahoo; Debashis,9999,0,9999,0
1668256682286,CSE 293,030,119420,Saul; Lawrence,9999,0,9999,0
1668256682286,CSE 293,031,119421,Savage; Stefan,9999,0,9999,0
1668256682286,CSE 293,032,119425,Schulze; Jurgen P.,9999,0,9999,0
1668256682286,CSE 293,033,119426,Snoeren; Alex C.,9999,0,9999,0
1668256682286,CSE 293,034,119428,Shang; Jingbo,9999,0,9999,0
1668256682286,CSE 293,035,119430,Stefan; Deian,9999,0,9999,0
1668256682286,CSE 293,036,119431,Su; Hao,9999,0,9999,0
1668256682286,CSE 293,037,119433,Swanson; Steven James,9999,0,9999,0
1668256682286,CSE 293,038,119435,Tullsen; Dean Michael,9999,0,9999,0
1668256682286,CSE 293,039,119483,Voelker; Geoffrey M.,9999,0,9999,0
1668256682286,CSE 293,040,119537,Zhao; Jishen,9999,0,9999,0
1668256682286,CSE 293,041,119538,Zhou; Yuan-Yuan,9999,0,9999,0
1668256682286,CSE 293,042,119539,Gao; Sicun,9999,0,9999,0
1668256682286,CSE 293,043,119540,Weibel; Nadir,9999,0,9999,0
1668256682286,CSE 293,044,119541,Gupta; Rajesh K.,9999,0,9999,0
1668256682286,CSE 293,045,126410,Vaccaro; Kristen Marie,9999,0,9999,0
1668256682286,CSE 293,046,126411,Klemke; Richard,9999,0,9999,0
1668256682715,CSE 294,A00,102459,Voelker; Geoffrey M.,0,0,0,0
1668256682715,CSE 294,B00,111322,Orailoglu; Alex,0,0,0,0
1668256683141,DSE 201,A00,096914,Deutsch; Alin Bernard,30,0,30,0
1668256683571,DSE 210,A00,096915,Dasgupta; Sanjoy,30,0,30,0
1668256683998,DSE 260A,A00,096916,Altintas De Callaf; Ilkay,30,0,30,0
1668256684452,ECE 200,001,103586,Antipa; Nicholas A,9999,0,9999,0
1668256684452,ECE 200,002,103587,Atanasov; Nikolay A.,9999,0,9999,0
1668256684452,ECE 200,003,103588,Bharadia; Dinesh,9999,0,9999,0
1668256684452,ECE 200,004,103589,Cheng; Chung Kuan,9999,0,9999,0
1668256684452,ECE 200,005,103590,Cosman; Pamela C.,9999,0,9999,0
1668256684452,ECE 200,006,103591,Dayeh; Shadi Ahmad,9999,0,9999,0
1668256684452,ECE 200,007,103592,Fainman; Yeshaiahu,9999,0,9999,0
1668256684452,ECE 200,008,103593,Ford; Joseph Earl,9999,0,9999,0
1668256684452,ECE 200,009,103594,Franceschetti; Massimo,9999,0,9999,0
1668256684452,ECE 200,010,103595,Fullerton; Eric E,9999,0,9999,0
1668256684452,ECE 200,011,103596,Galton; Ian A,9999,0,9999,0
1668256684452,ECE 200,012,103597,Gilja; Vikash,9999,0,9999,0
1668256684452,ECE 200,013,103598,Hall; Drew A.,9999,0,9999,0
1668256684452,ECE 200,014,103599,Hsueh; Tzu-Chien,9999,0,9999,0
1668256684452,ECE 200,015,103600,Javidi; Tara,9999,0,9999,0
1668256684452,ECE 200,016,103601,Kahng; Andrew Byun,9999,0,9999,0
1668256684452,ECE 200,017,103602,Kim; Young-Han,9999,0,9999,0
1668256684452,ECE 200,018,103603,Koushanfar; Farinaz,9999,0,9999,0
1668256684452,ECE 200,019,103604,Kuzum; Duygu,9999,0,9999,0
1668256684452,ECE 200,020,103605,Le; Hanh-Phuc,9999,0,9999,0
1668256684452,ECE 200,021,103606,Lin; Bill,9999,0,9999,0
1668256684452,ECE 200,022,103607,Liu; Zhaowei,9998,0,9999,1
1668256684452,ECE 200,023,103608,Lo; Yu-Hwa,9999,0,9999,0
1668256684452,ECE 200,024,103609,Lomakin; Vitaliy,9999,0,9999,0
1668256684452,ECE 200,025,103610,Mercier; Patrick Philip,9999,0,9999,0
1668256684452,ECE 200,026,103611,Meyer; Florian,9999,0,9999,0
1668256684452,ECE 200,027,103612,Milstein; Laurence B.,9999,0,9999,0
1668256684452,ECE 200,028,103613,Mir Arabbaygi; Siavash,9999,0,9999,0
1668256684452,ECE 200,029,103614,Mookherjea; Shayan,9999,0,9999,0
1668256684452,ECE 200,030,103615,Morris; Karcher William,9999,0,9999,0
1668256684452,ECE 200,031,103616,Ng; Tse Nga,9999,0,9999,0
1668256684452,ECE 200,032,103617,Nguyen; Truong Quang,9999,0,9999,0
1668256684452,ECE 200,033,103618,Nomura; Kenji,9999,0,9999,0
1668256684452,ECE 200,034,103619,Orlitsky; Alon,9999,0,9999,0
1668256684452,ECE 200,035,103620,Pal; Piya,9999,0,9999,0
1668256684452,ECE 200,036,103621,Papen; George C.,9999,0,9999,0
1668256684452,ECE 200,037,103622,Radic; Stojan,9999,0,9999,0
1668256684452,ECE 200,038,103623,Rao; Bhaskar D.,9999,0,9999,0
1668256684452,ECE 200,039,103624,Rao; Ramesh R,9999,0,9999,0
1668256684452,ECE 200,040,103625,Rebeiz; Gabriel,9999,0,9999,0
1668256684452,ECE 200,041,103626,Sanford; John R,9999,0,9999,0
1668256684452,ECE 200,042,103627,Siegel; Paul H.,9999,0,9999,0
1668256684452,ECE 200,043,103628,Sievenpiper; Daniel F.,9999,0,9999,0
1668256684452,ECE 200,044,103629,Sworder; David D.,9999,0,9999,0
1668256684452,ECE 200,045,103630,Taur; Yuan,9999,0,9999,0
1668256684452,ECE 200,046,103631,Touri; Behrouz,9999,0,9999,0
1668256684452,ECE 200,047,103632,Trivedi; Mohan M.,9999,0,9999,0
1668256684452,ECE 200,048,103633,Vasconcelos; Nuno,9999,0,9999,0
1668256684452,ECE 200,049,103634,Wang; Xiaolong,9999,0,9999,0
1668256684452,ECE 200,050,103635,Xie; Pengtao,9999,0,9999,0
1668256684452,ECE 200,051,103636,Yip; Michael,9999,0,9999,0
1668256684452,ECE 200,052,103637,Zeger; Kenneth A.,999,0,999,0
1668256684452,ECE 200,053,103638,Zhang; Xinyu,9999,0,9999,0
1668256684452,ECE 200,054,103639,Turakhia; Yatish Girish,9999,0,9999,0
1668256684452,ECE 200,055,103640,Kang; Mingu,9999,0,9999,0
1668256684452,ECE 200,056,103641,Shi; Yuanyuan,9999,0,9999,0
1668256684452,ECE 200,057,103642,Wang; Edward Jay,9999,0,9999,0
1668256684452,ECE 200,058,103643,Zheng; Yang,9999,0,9999,0
1668256684881,ECE 202,A00,103644,Kuzum; Duygu,0,0,0,0
1668256685308,ECE 212BN,A00,103646,Ng; Tse Nga,0,0,0,0
1668256685735,ECE 221,A00,111493,Staff,0,0,0,0
1668256686163,ECE 222B,A00,103647,Lomakin; Vitaliy,0,0,0,0
1668256686587,ECE 230B,A00,103648,Taur; Yuan,0,0,0,0
1668256687017,ECE 238B,A00,103649,Garay; Javier,0,0,0,0
1668256687447,ECE 240B,A00,112900,Fainman; Yeshaiahu,0,0,0,0
1668256687877,ECE 247A,A00,103650,Jokerst; Jesse Vincent,0,0,0,0
1668256688303,ECE 247B,A00,103651,Wang; Joseph,0,0,0,0
1668256688736,ECE 250,A00,103652,Siegel; Paul H.,0,0,0,0
1668256689167,ECE 251A,A00,103654,Rao; Bhaskar D.,0,0,0,0
1668256689597,ECE 257B,A00,103655,Bharadia; Dinesh,0,0,0,0
1668256690028,ECE 258A,A00,103656,Milstein; Laurence B.,0,0,0,0
1668256690454,ECE 260B,A00,103658,Kang; Mingu,0,0,0,0
1668256690887,ECE 264A,A00,103659,Galton; Ian A,0,0,0,0
1668256691314,ECE 265A,A00,103661,Gudem; Prasad S.S.,0,0,0,0
1668256691742,ECE 265D,A00,103662,Gudem; Prasad S.S.,0,0,0,0
1668256692167,ECE 268,A00,103663,Koushanfar; Farinaz,0,0,0,0
1668256692592,ECE 269,A01,103665,Pal; Piya,0,0,0,0
1668256693020,ECE 271B,A00,103666,Vasconcelos; Manuela,0,0,0,0
1668256693446,ECE 276A,A00,103667,Atanasov; Nikolay A.,0,0,0,0
1668256693871,ECE 277,A00,103668,An; Cheolhong,0,0,0,0
1668256694297,ECE 279,A00,117947,Hall; Drew A.,0,0,0,0
1668256695159,ECE 283,A00,103670,Hsueh; Tzu-Chien,0,0,0,0
1668256695586,ECE 284,A00,103671,Turakhia; Yatish Girish,0,0,0,0
1668256696010,ECE 285,A00,103672,Zheng; Yang,0,0,0,0
1668256696010,ECE 285,B00,103673,Sworder; David D.,0,0,0,0
1668256696435,ECE 287,A00,103676,Javidi; Tara,0,0,0,0
1668256696862,MATH 200B,A00,098023,Salehi Golsefidy; Alireza,12,0,15,3
1668256697288,MATH 202B,A00,098024,Rhoades; Brendon Patrick,9,0,15,6
1668256697717,MATH 203B,A00,098025,Oprea; Dragos N.,10,0,15,5
1668256698147,MATH 204B,A00,098026,Sorensen; Claus M,13,0,15,2
1668256698570,MATH 208,A00,098027,Izadi; Elham,7,0,10,3
1668256698998,MATH 209,A00,098028,Pollack; Aaron,10,0,10,0
1668256699422,MATH 211A,A00,112919,Rogalski; Daniel,9,0,10,1
1668256699848,MATH 211B,A00,112920,Seward; Brandon M.,9,0,10,1
1668256700274,MATH 218,A00,098029,Li; Bo,10,0,10,0
1668256700725,MATH 220B,A00,098030,Novak; Jonathan I,11,0,15,4
1668256701156,MATH 221A,A00,098031,Ebenfelt; Peter F,13,0,15,2
1668256701586,MATH 231B,A00,098032,Zlatos; Andrej,12,0,15,3
1668256702037,MATH 240B,A00,098033,Ni; Lei,9,0,15,6
1668256702558,MATH 243,A00,098034,Jekel; David Andrew,10,0,10,0
1668256702985,MATH 245A,A00,098035,Nie; Jiawang,0,0,15,16
1668256703416,MATH 248,A00,098036,Bejenaru; Ioan,10,0,10,0
1668256703842,MATH 250B,A00,098037,Spolaor; Luca,14,0,15,1
1668256704269,MATH 258,A00,098038,Ni; Lei,10,0,10,0
1668256704694,MATH 264B,A00,098041,Rhoades; Brendon Patrick,9,0,15,6
1668256705119,MATH 268,A00,098042,Buss; Samuel R,10,0,10,0
1668256705549,MATH 269,A00,098043,Rhoades; Brendon Patrick,10,0,10,0
1668256705980,MATH 270B,A00,098044,Li; Bo,10,0,15,5
1668256706406,MATH 272B,A00,098045,Holst; Michael J,13,0,15,2
1668256706842,MATH 273A,A00,098046,Tian; Xiaochuan,10,0,15,5
1668256707281,MATH 275,A01,098048,Tian; Xiaochuan,6,0,10,4
1668256707704,MATH 278A,A00,098049,Holst; Michael J,8,0,10,2
1668256708136,MATH 278B,A00,098050,Cloninger; Alexander,10,0,10,0
1668256708576,MATH 278C,A00,098051,Nie; Jiawang,7,0,10,3
1668256709010,MATH 280B,A00,098052,Zheng; Tianyi,9,0,15,6
1668256709447,MATH 281B,A00,098053,Bradic; Jelena,1,0,15,14
1668256709892,MATH 282B,A00,098054,Arias-Castro; Ery,0,0,15,15
1668256710321,MATH 285,A00,098055,Fitzsimmons; Patrick J,0,0,15,17
1668256710752,MATH 287B,A00,098056,Arias-Castro; Ery,2,0,15,13
1668256711187,MATH 288,A00,098057,Agarwal; Pooja,9,0,10,1
1668256711187,MATH 288,B00,098058,Zhang; Danna,8,0,10,2
1668256711187,MATH 288,C00,098059,Williams; Ruth J,10,0,10,0
1668256711624,MATH 290B,A00,098060,Roberts; Justin Deritter,13,0,15,2
1668256712052,MATH 292,A00,098061,Belmont; Eva Kinoshita,10,0,10,0
1668256712479,MATH 295,A00,098062,Suk; Andrew Hoon,48,0,50,2
1668256712905,MATH 296,A00,098063,Novak; Jonathan I,20,0,20,0
1668256713332,MATH 297,001,098064,Gamst; Anthony Collins,9997,0,9999,2
1668257216515,COGS 205,A00,101395,Chiba; Andrea,19,0,20,1
1668257216943,COGS 210B,001,101404,Greene; Deanna Jacquelyn,9998,0,9999,1
1668257216943,COGS 210B,002,101417,Xia; Haijun,9999,0,9999,0
1668257216943,COGS 210B,003,101422,Nitz; Douglas A.,9999,0,9999,0
1668257216943,COGS 210B,004,101423,Hollan; James D.,9998,0,9999,1
1668257216943,COGS 210B,005,101424,Deak; Gedeon O.,9998,0,9999,1
1668257216943,COGS 210B,006,101425,Rossano; Federico,9999,0,9999,0
1668257217367,COGS 211B,A00,101427,Coulson; Seana M,9996,0,9999,3
1668257217791,COGS 220,A00,101428,Hollan; James D.,0,0,25,25
1668257218215,COGS 229,A00,101429,Dow; Steven P,18,0,25,7
1668257218643,COGS 230,A00,101430,Klemmer; Scott R,12,0,17,5
1668257219070,COGS 234,A00,101431,Xia; Haijun,2,0,25,23
1668257219496,COGS 260,A00,101432,Kiyonaga; Anastasia,21,0,25,4
1668257219496,COGS 260,B00,101433,Kirsh; David Joel,15,0,25,10
1668257219926,CSE 202,A00,102371,Impagliazzo; Russell,0,0,0,0
1668257220351,CSE 203B,A01,102373,Cheng; Chung Kuan,0,0,0,0
1668257220781,CSE 208,A00,102374,Micciancio; Daniele,0,0,0,0
1668257221209,CSE 209A,A00,112895,Impagliazzo; Russell,0,0,15,15
1668257221634,CSE 209B,A00,108005,Bellare; Mihir,0,0,0,0
1668257222059,CSE 210,A00,113163,Coblenz; Michael J,0,0,0,0
1668257222486,CSE 219,A00,106111,Dow; Steven P,0,0,20,20
1668257222911,CSE 221,A00,102376,Voelker; Geoffrey M.,0,0,0,0
1668257223339,CSE 224,A01,102378,Porter; George M,0,0,0,0
1668257223766,CSE 229A,A00,102379,Savage; Stefan,0,0,0,0
1668257224191,CSE 229C,A00,102380,Munyaka; Imani N. S.,0,0,0,0
1668257224616,CSE 232B,A00,102382,Deutsch; Alin Bernard,0,0,0,0
1668257225042,CSE 234,A01,112904,Kumar; Arun Kumar,0,0,0,0
1668257225467,CSE 237A,A00,102383,Rosing; Tajana Simunic,0,0,0,0
1668257225987,CSE 239A,A00,102384,Deutsch; Alin Bernard,0,0,0,0
1668257226415,CSE 239B,A00,102385,Polikarpova; Nadezhda,0,0,0,0
1668257226843,CSE 240A,A00,102386,Pannuto; Patrick William,0,0,0,0
1668257227270,CSE 240B,A00,102387,Zhao; Jishen,0,0,0,0
1668257227703,CSE 241A,A00,106406,Kang; Mingu,0,0,0,0
1668257228131,CSE 249B,A00,102388,Kahng; Andrew Byun,0,0,8,8
1668257228562,CSE 251B,A01,102392,Cottrell; Garrison W,0,0,0,0
1668257228562,CSE 251B,A02,102393,Cottrell; Garrison W,0,0,0,0
1668257228995,CSE 252B,A00,102394,Ochoa; Benjamin Lawrence,0,0,0,0
1668257229433,CSE 257,A01,102396,Gao; Sicun,0,0,0,0
1668257229869,CSE 272,A00,102397,Li; Tzumao,0,0,0,0
1668257230297,CSE 274,A00,111323,Chern; Albert Ren-Haur,0,0,0,0
1668257230721,CSE 282,A00,102398,Pevzner; Pavel Arkadjevich,0,0,0,0
1668257231148,CSE 284,A00,114175,Gymrek; Melissa Ann,0,0,0,0
1668257231576,CSE 290,A00,102399,Chandraker; Manmohan Krishna,0,0,0,0
1668257231576,CSE 290,B00,102400,Vaccaro; Kristen Marie,0,0,25,25
1668257231576,CSE 290,C00,102414,Pannuto; Patrick William,0,0,25,25
1668257231576,CSE 290,D00,102427,Pevzner; Pavel Arkadjevich,0,0,0,0
1668257231576,CSE 290,E00,102429,Zhao; Jishen,0,0,0,0
1668257231576,CSE 290,F00,102436,Tullsen; Dean Michael,0,0,0,0
1668257231576,CSE 290,G00,102440,Christensen; Henrik I,0,0,20,20
1668257232010,CSE 291,A00,102443,Su; Hao,0,0,0,0
1668257232010,CSE 291,B00,102448,Polikarpova; Nadezhda,0,0,0,0
1668257232010,CSE 291,C00,102453,Vaccaro; Kristen Marie,0,0,0,0
1668257232010,CSE 291,D00,111343,Savage; Stefan,0,0,0,0
1668257232010,CSE 291,E00,116474,Claffy; Kimberly Claire,0,0,0,0
1668257232010,CSE 291,F00,116479,Pasquale; Joseph,0,0,0,0
1668257232468,CSE 293,001,119111,Bafna; Vineet,9999,0,9999,0
1668257232468,CSE 293,002,119118,Bellare; Mihir,9999,0,9999,0
1668257232468,CSE 293,003,119122,Berg-Kirkpatrick; Taylor D,9999,0,9999,0
1668257232468,CSE 293,004,119135,Christensen; Henrik I,9999,0,9999,0
1668257232468,CSE 293,005,119142,Cottrell; Garrison W,9999,0,9999,0
1668257232468,CSE 293,006,119146,Deutsch; Alin Bernard,9999,0,9999,0
1668257232468,CSE 293,007,119159,Esmaeilzadeh; Hadi,9999,0,9999,0
1668257232468,CSE 293,008,119166,Freund; Yoav,9999,0,9999,0
1668257232468,CSE 293,009,119170,Griswold; William G.,9999,0,9999,0
1668257232468,CSE 293,010,119183,Gymrek; Melissa Ann,9999,0,9999,0
1668257232468,CSE 293,011,119190,Heninger; Nadia A,9999,0,9999,0
1668257232468,CSE 293,012,119230,Impagliazzo; Russell,9999,0,9999,0
1668257232468,CSE 293,013,119232,Jhala; Ranjit,9999,0,9999,0
1668257232468,CSE 293,014,119233,Kahng; Andrew Byun,9999,0,9999,0
1668257232468,CSE 293,015,119298,Kane; Daniel Mertz,9999,0,9999,0
1668257232468,CSE 293,016,119299,Kriegman; David J,9999,0,9999,0
1668257232468,CSE 293,017,119300,Kumar; Arun Kumar,9999,0,9999,0
1668257232468,CSE 293,018,119301,Lerner; Sorin,9999,0,9999,0
1668257232468,CSE 293,019,119302,Lovett; Shachar,9999,0,9999,0
1668257232468,CSE 293,020,119303,McAuley; Julian John,9999,0,9999,0
1668257232468,CSE 293,021,119304,Micciancio; Daniele,9999,0,9999,0
1668257232468,CSE 293,022,119367,Orailoglu; Alex,9999,0,9999,0
1668257232468,CSE 293,023,119382,Paturi; Ramamohan,9999,0,9999,0
1668257232468,CSE 293,024,119404,Polikarpova; Nadezhda,9999,0,9999,0
1668257232468,CSE 293,025,119406,Politz; Joseph Gibbs,9999,0,9999,0
1668257232468,CSE 293,026,119411,Porter; George M,9999,0,9999,0
1668257232468,CSE 293,027,119414,Porter; Leonard Emerson,9999,0,9999,0
1668257232468,CSE 293,028,119416,Ramamoorthi; Ravi,9999,0,9999,0
1668257232468,CSE 293,029,119417,Sahoo; Debashis,9999,0,9999,0
1668257232468,CSE 293,030,119420,Saul; Lawrence,9999,0,9999,0
1668257232468,CSE 293,031,119421,Savage; Stefan,9999,0,9999,0
1668257232468,CSE 293,032,119425,Schulze; Jurgen P.,9999,0,9999,0
1668257232468,CSE 293,033,119426,Snoeren; Alex C.,9999,0,9999,0
1668257232468,CSE 293,034,119428,Shang; Jingbo,9999,0,9999,0
1668257232468,CSE 293,035,119430,Stefan; Deian,9999,0,9999,0
1668257232468,CSE 293,036,119431,Su; Hao,9999,0,9999,0
1668257232468,CSE 293,037,119433,Swanson; Steven James,9999,0,9999,0
1668257232468,CSE 293,038,119435,Tullsen; Dean Michael,9999,0,9999,0
1668257232468,CSE 293,039,119483,Voelker; Geoffrey M.,9999,0,9999,0
1668257232468,CSE 293,040,119537,Zhao; Jishen,9999,0,9999,0
1668257232468,CSE 293,041,119538,Zhou; Yuan-Yuan,9999,0,9999,0
1668257232468,CSE 293,042,119539,Gao; Sicun,9999,0,9999,0
1668257232468,CSE 293,043,119540,Weibel; Nadir,9999,0,9999,0
1668257232468,CSE 293,044,119541,Gupta; Rajesh K.,9999,0,9999,0
1668257232468,CSE 293,045,126410,Vaccaro; Kristen Marie,9999,0,9999,0
1668257232468,CSE 293,046,126411,Klemke; Richard,9999,0,9999,0
1668257232895,CSE 294,A00,102459,Voelker; Geoffrey M.,0,0,0,0
1668257232895,CSE 294,B00,111322,Orailoglu; Alex,0,0,0,0
1668257233325,DSE 201,A00,096914,Deutsch; Alin Bernard,30,0,30,0
1668257233751,DSE 210,A00,096915,Dasgupta; Sanjoy,30,0,30,0
1668257234176,DSE 260A,A00,096916,Altintas De Callaf; Ilkay,30,0,30,0
1668257234629,ECE 200,001,103586,Antipa; Nicholas A,9999,0,9999,0
1668257234629,ECE 200,002,103587,Atanasov; Nikolay A.,9999,0,9999,0
1668257234629,ECE 200,003,103588,Bharadia; Dinesh,9999,0,9999,0
1668257234629,ECE 200,004,103589,Cheng; Chung Kuan,9999,0,9999,0
1668257234629,ECE 200,005,103590,Cosman; Pamela C.,9999,0,9999,0
1668257234629,ECE 200,006,103591,Dayeh; Shadi Ahmad,9999,0,9999,0
1668257234629,ECE 200,007,103592,Fainman; Yeshaiahu,9999,0,9999,0
1668257234629,ECE 200,008,103593,Ford; Joseph Earl,9999,0,9999,0
1668257234629,ECE 200,009,103594,Franceschetti; Massimo,9999,0,9999,0
1668257234629,ECE 200,010,103595,Fullerton; Eric E,9999,0,9999,0
1668257234629,ECE 200,011,103596,Galton; Ian A,9999,0,9999,0
1668257234629,ECE 200,012,103597,Gilja; Vikash,9999,0,9999,0
1668257234629,ECE 200,013,103598,Hall; Drew A.,9999,0,9999,0
1668257234629,ECE 200,014,103599,Hsueh; Tzu-Chien,9999,0,9999,0
1668257234629,ECE 200,015,103600,Javidi; Tara,9999,0,9999,0
1668257234629,ECE 200,016,103601,Kahng; Andrew Byun,9999,0,9999,0
1668257234629,ECE 200,017,103602,Kim; Young-Han,9999,0,9999,0
1668257234629,ECE 200,018,103603,Koushanfar; Farinaz,9999,0,9999,0
1668257234629,ECE 200,019,103604,Kuzum; Duygu,9999,0,9999,0
1668257234629,ECE 200,020,103605,Le; Hanh-Phuc,9999,0,9999,0
1668257234629,ECE 200,021,103606,Lin; Bill,9999,0,9999,0
1668257234629,ECE 200,022,103607,Liu; Zhaowei,9998,0,9999,1
1668257234629,ECE 200,023,103608,Lo; Yu-Hwa,9999,0,9999,0
1668257234629,ECE 200,024,103609,Lomakin; Vitaliy,9999,0,9999,0
1668257234629,ECE 200,025,103610,Mercier; Patrick Philip,9999,0,9999,0
1668257234629,ECE 200,026,103611,Meyer; Florian,9999,0,9999,0
1668257234629,ECE 200,027,103612,Milstein; Laurence B.,9999,0,9999,0
1668257234629,ECE 200,028,103613,Mir Arabbaygi; Siavash,9999,0,9999,0
1668257234629,ECE 200,029,103614,Mookherjea; Shayan,9999,0,9999,0
1668257234629,ECE 200,030,103615,Morris; Karcher William,9999,0,9999,0
1668257234629,ECE 200,031,103616,Ng; Tse Nga,9999,0,9999,0
1668257234629,ECE 200,032,103617,Nguyen; Truong Quang,9999,0,9999,0
1668257234629,ECE 200,033,103618,Nomura; Kenji,9999,0,9999,0
1668257234629,ECE 200,034,103619,Orlitsky; Alon,9999,0,9999,0
1668257234629,ECE 200,035,103620,Pal; Piya,9999,0,9999,0
1668257234629,ECE 200,036,103621,Papen; George C.,9999,0,9999,0
1668257234629,ECE 200,037,103622,Radic; Stojan,9999,0,9999,0
1668257234629,ECE 200,038,103623,Rao; Bhaskar D.,9999,0,9999,0
1668257234629,ECE 200,039,103624,Rao; Ramesh R,9999,0,9999,0
1668257234629,ECE 200,040,103625,Rebeiz; Gabriel,9999,0,9999,0
1668257234629,ECE 200,041,103626,Sanford; John R,9999,0,9999,0
1668257234629,ECE 200,042,103627,Siegel; Paul H.,9999,0,9999,0
1668257234629,ECE 200,043,103628,Sievenpiper; Daniel F.,9999,0,9999,0
1668257234629,ECE 200,044,103629,Sworder; David D.,9999,0,9999,0
1668257234629,ECE 200,045,103630,Taur; Yuan,9999,0,9999,0
1668257234629,ECE 200,046,103631,Touri; Behrouz,9999,0,9999,0
1668257234629,ECE 200,047,103632,Trivedi; Mohan M.,9999,0,9999,0
1668257234629,ECE 200,048,103633,Vasconcelos; Nuno,9999,0,9999,0
1668257234629,ECE 200,049,103634,Wang; Xiaolong,9999,0,9999,0
1668257234629,ECE 200,050,103635,Xie; Pengtao,9999,0,9999,0
1668257234629,ECE 200,051,103636,Yip; Michael,9999,0,9999,0
1668257234629,ECE 200,052,103637,Zeger; Kenneth A.,999,0,999,0
1668257234629,ECE 200,053,103638,Zhang; Xinyu,9999,0,9999,0
1668257234629,ECE 200,054,103639,Turakhia; Yatish Girish,9999,0,9999,0
1668257234629,ECE 200,055,103640,Kang; Mingu,9999,0,9999,0
1668257234629,ECE 200,056,103641,Shi; Yuanyuan,9999,0,9999,0
1668257234629,ECE 200,057,103642,Wang; Edward Jay,9999,0,9999,0
1668257234629,ECE 200,058,103643,Zheng; Yang,9999,0,9999,0
1668257235055,ECE 202,A00,103644,Kuzum; Duygu,0,0,0,0
1668257235482,ECE 212BN,A00,103646,Ng; Tse Nga,0,0,0,0
1668257235907,ECE 221,A00,111493,Staff,0,0,0,0
1668257236333,ECE 222B,A00,103647,Lomakin; Vitaliy,0,0,0,0
1668257236758,ECE 230B,A00,103648,Taur; Yuan,0,0,0,0
1668257237191,ECE 238B,A00,103649,Garay; Javier,0,0,0,0
1668257237618,ECE 240B,A00,112900,Fainman; Yeshaiahu,0,0,0,0
1668257238047,ECE 247A,A00,103650,Jokerst; Jesse Vincent,0,0,0,0
1668257238480,ECE 247B,A00,103651,Wang; Joseph,0,0,0,0
1668257238912,ECE 250,A00,103652,Siegel; Paul H.,0,0,0,0
1668257239341,ECE 251A,A00,103654,Rao; Bhaskar D.,0,0,0,0
1668257239778,ECE 257B,A00,103655,Bharadia; Dinesh,0,0,0,0
1668257240201,ECE 258A,A00,103656,Milstein; Laurence B.,0,0,0,0
1668257240629,ECE 260B,A00,103658,Kang; Mingu,0,0,0,0
1668257241054,ECE 264A,A00,103659,Galton; Ian A,0,0,0,0
1668257241481,ECE 265A,A00,103661,Gudem; Prasad S.S.,0,0,0,0
1668257241905,ECE 265D,A00,103662,Gudem; Prasad S.S.,0,0,0,0
1668257242330,ECE 268,A00,103663,Koushanfar; Farinaz,0,0,0,0
1668257242755,ECE 269,A01,103665,Pal; Piya,0,0,0,0
1668257243182,ECE 271B,A00,103666,Vasconcelos; Manuela,0,0,0,0
1668257243606,ECE 276A,A00,103667,Atanasov; Nikolay A.,0,0,0,0
1668257244036,ECE 277,A00,103668,An; Cheolhong,0,0,0,0
1668257244461,ECE 279,A00,117947,Hall; Drew A.,0,0,0,0
1668257245312,ECE 283,A00,103670,Hsueh; Tzu-Chien,0,0,0,0
1668257245736,ECE 284,A00,103671,Turakhia; Yatish Girish,0,0,0,0
1668257246161,ECE 285,A00,103672,Zheng; Yang,0,0,0,0
1668257246161,ECE 285,B00,103673,Sworder; David D.,0,0,0,0
1668257246587,ECE 287,A00,103676,Javidi; Tara,0,0,0,0
1668257247025,MATH 200B,A00,098023,Salehi Golsefidy; Alireza,12,0,15,3
1668257247457,MATH 202B,A00,098024,Rhoades; Brendon Patrick,9,0,15,6
1668257247882,MATH 203B,A00,098025,Oprea; Dragos N.,10,0,15,5
1668257248305,MATH 204B,A00,098026,Sorensen; Claus M,13,0,15,2
1668257248734,MATH 208,A00,098027,Izadi; Elham,7,0,10,3
1668257249161,MATH 209,A00,098028,Pollack; Aaron,10,0,10,0
1668257249586,MATH 211A,A00,112919,Rogalski; Daniel,9,0,10,1
1668257250011,MATH 211B,A00,112920,Seward; Brandon M.,9,0,10,1
1668257250440,MATH 218,A00,098029,Li; Bo,10,0,10,0
1668257250866,MATH 220B,A00,098030,Novak; Jonathan I,11,0,15,4
1668257251293,MATH 221A,A00,098031,Ebenfelt; Peter F,13,0,15,2
1668257251726,MATH 231B,A00,098032,Zlatos; Andrej,12,0,15,3
1668257252154,MATH 240B,A00,098033,Ni; Lei,9,0,15,6
1668257252578,MATH 243,A00,098034,Jekel; David Andrew,10,0,10,0
1668257253004,MATH 245A,A00,098035,Nie; Jiawang,0,0,15,16
1668257253429,MATH 248,A00,098036,Bejenaru; Ioan,10,0,10,0
1668257253853,MATH 250B,A00,098037,Spolaor; Luca,14,0,15,1
1668257254279,MATH 258,A00,098038,Ni; Lei,10,0,10,0
1668257254714,MATH 264B,A00,098041,Rhoades; Brendon Patrick,9,0,15,6
1668257255139,MATH 268,A00,098042,Buss; Samuel R,10,0,10,0
1668257255586,MATH 269,A00,098043,Rhoades; Brendon Patrick,10,0,10,0
1668257256012,MATH 270B,A00,098044,Li; Bo,10,0,15,5
1668257256438,MATH 272B,A00,098045,Holst; Michael J,13,0,15,2
1668257256864,MATH 273A,A00,098046,Tian; Xiaochuan,10,0,15,5
1668257257292,MATH 275,A01,098048,Tian; Xiaochuan,6,0,10,4
1668257257719,MATH 278A,A00,098049,Holst; Michael J,8,0,10,2
1668257258145,MATH 278B,A00,098050,Cloninger; Alexander,10,0,10,0
1668257258573,MATH 278C,A00,098051,Nie; Jiawang,7,0,10,3
1668257258997,MATH 280B,A00,098052,Zheng; Tianyi,9,0,15,6
1668257259421,MATH 281B,A00,098053,Bradic; Jelena,1,0,15,14
1668257259847,MATH 282B,A00,098054,Arias-Castro; Ery,0,0,15,15
1668257260277,MATH 285,A00,098055,Fitzsimmons; Patrick J,0,0,15,17
1668257260704,MATH 287B,A00,098056,Arias-Castro; Ery,2,0,15,13
1668257261131,MATH 288,A00,098057,Agarwal; Pooja,9,0,10,1
1668257261131,MATH 288,B00,098058,Zhang; Danna,8,0,10,2
1668257261131,MATH 288,C00,098059,Williams; Ruth J,10,0,10,0
1668257261569,MATH 290B,A00,098060,Roberts; Justin Deritter,13,0,15,2
1668257261993,MATH 292,A00,098061,Belmont; Eva Kinoshita,10,0,10,0
1668257262417,MATH 295,A00,098062,Suk; Andrew Hoon,48,0,50,2
1668257262841,MATH 296,A00,098063,Novak; Jonathan I,20,0,20,0
1668257263269,MATH 297,001,098064,Gamst; Anthony Collins,9997,0,9999,2
1668257765619,COGS 205,A00,101395,Chiba; Andrea,19,0,20,1
1668257766047,COGS 210B,001,101404,Greene; Deanna Jacquelyn,9998,0,9999,1
1668257766047,COGS 210B,002,101417,Xia; Haijun,9999,0,9999,0
1668257766047,COGS 210B,003,101422,Nitz; Douglas A.,9999,0,9999,0
1668257766047,COGS 210B,004,101423,Hollan; James D.,9998,0,9999,1
1668257766047,COGS 210B,005,101424,Deak; Gedeon O.,9998,0,9999,1
1668257766047,COGS 210B,006,101425,Rossano; Federico,9999,0,9999,0
1668257766478,COGS 211B,A00,101427,Coulson; Seana M,9996,0,9999,3
1668257766906,COGS 220,A00,101428,Hollan; James D.,0,0,25,25
1668257767331,COGS 229,A00,101429,Dow; Steven P,18,0,25,7
1668257767761,COGS 230,A00,101430,Klemmer; Scott R,12,0,17,5
1668257768186,COGS 234,A00,101431,Xia; Haijun,2,0,25,23
1668257768612,COGS 260,A00,101432,Kiyonaga; Anastasia,21,0,25,4
1668257768612,COGS 260,B00,101433,Kirsh; David Joel,15,0,25,10
1668257769043,CSE 202,A00,102371,Impagliazzo; Russell,0,0,0,0
1668257769467,CSE 203B,A01,102373,Cheng; Chung Kuan,0,0,0,0
1668257769894,CSE 208,A00,102374,Micciancio; Daniele,0,0,0,0
1668257770322,CSE 209A,A00,112895,Impagliazzo; Russell,0,0,15,15
1668257770761,CSE 209B,A00,108005,Bellare; Mihir,0,0,0,0
1668257771189,CSE 210,A00,113163,Coblenz; Michael J,0,0,0,0
1668257771615,CSE 219,A00,106111,Dow; Steven P,0,0,20,20
1668257772044,CSE 221,A00,102376,Voelker; Geoffrey M.,0,0,0,0
1668257772468,CSE 224,A01,102378,Porter; George M,0,0,0,0
1668257772893,CSE 229A,A00,102379,Savage; Stefan,0,0,0,0
1668257773322,CSE 229C,A00,102380,Munyaka; Imani N. S.,0,0,0,0
1668257773746,CSE 232B,A00,102382,Deutsch; Alin Bernard,0,0,0,0
1668257774181,CSE 234,A01,112904,Kumar; Arun Kumar,0,0,0,0
1668257774617,CSE 237A,A00,102383,Rosing; Tajana Simunic,0,0,0,0
1668257775056,CSE 239A,A00,102384,Deutsch; Alin Bernard,0,0,0,0
1668257775493,CSE 239B,A00,102385,Polikarpova; Nadezhda,0,0,0,0
1668257775919,CSE 240A,A00,102386,Pannuto; Patrick William,0,0,0,0
1668257776348,CSE 240B,A00,102387,Zhao; Jishen,0,0,0,0
1668257776773,CSE 241A,A00,106406,Kang; Mingu,0,0,0,0
1668257777198,CSE 249B,A00,102388,Kahng; Andrew Byun,0,0,8,8
1668257777624,CSE 251B,A01,102392,Cottrell; Garrison W,0,0,0,0
1668257777624,CSE 251B,A02,102393,Cottrell; Garrison W,0,0,0,0
1668257778049,CSE 252B,A00,102394,Ochoa; Benjamin Lawrence,0,0,0,0
1668257778477,CSE 257,A01,102396,Gao; Sicun,0,0,0,0
1668257778907,CSE 272,A00,102397,Li; Tzumao,0,0,0,0
1668257779331,CSE 274,A00,111323,Chern; Albert Ren-Haur,0,0,0,0
1668257779757,CSE 282,A00,102398,Pevzner; Pavel Arkadjevich,0,0,0,0
1668257780188,CSE 284,A00,114175,Gymrek; Melissa Ann,0,0,0,0
1668257780626,CSE 290,A00,102399,Chandraker; Manmohan Krishna,0,0,0,0
1668257780626,CSE 290,B00,102400,Vaccaro; Kristen Marie,0,0,25,25
1668257780626,CSE 290,C00,102414,Pannuto; Patrick William,0,0,25,25
1668257780626,CSE 290,D00,102427,Pevzner; Pavel Arkadjevich,0,0,0,0
1668257780626,CSE 290,E00,102429,Zhao; Jishen,0,0,0,0
1668257780626,CSE 290,F00,102436,Tullsen; Dean Michael,0,0,0,0
1668257780626,CSE 290,G00,102440,Christensen; Henrik I,0,0,20,20
1668257781061,CSE 291,A00,102443,Su; Hao,0,0,0,0
1668257781061,CSE 291,B00,102448,Polikarpova; Nadezhda,0,0,0,0
1668257781061,CSE 291,C00,102453,Vaccaro; Kristen Marie,0,0,0,0
1668257781061,CSE 291,D00,111343,Savage; Stefan,0,0,0,0
1668257781061,CSE 291,E00,116474,Claffy; Kimberly Claire,0,0,0,0
1668257781061,CSE 291,F00,116479,Pasquale; Joseph,0,0,0,0
1668257781502,CSE 293,001,119111,Bafna; Vineet,9999,0,9999,0
1668257781502,CSE 293,002,119118,Bellare; Mihir,9999,0,9999,0
1668257781502,CSE 293,003,119122,Berg-Kirkpatrick; Taylor D,9999,0,9999,0
1668257781502,CSE 293,004,119135,Christensen; Henrik I,9999,0,9999,0
1668257781502,CSE 293,005,119142,Cottrell; Garrison W,9999,0,9999,0
1668257781502,CSE 293,006,119146,Deutsch; Alin Bernard,9999,0,9999,0
1668257781502,CSE 293,007,119159,Esmaeilzadeh; Hadi,9999,0,9999,0
1668257781502,CSE 293,008,119166,Freund; Yoav,9999,0,9999,0
1668257781502,CSE 293,009,119170,Griswold; William G.,9999,0,9999,0
1668257781502,CSE 293,010,119183,Gymrek; Melissa Ann,9999,0,9999,0
1668257781502,CSE 293,011,119190,Heninger; Nadia A,9999,0,9999,0
1668257781502,CSE 293,012,119230,Impagliazzo; Russell,9999,0,9999,0
1668257781502,CSE 293,013,119232,Jhala; Ranjit,9999,0,9999,0
1668257781502,CSE 293,014,119233,Kahng; Andrew Byun,9999,0,9999,0
1668257781502,CSE 293,015,119298,Kane; Daniel Mertz,9999,0,9999,0
1668257781502,CSE 293,016,119299,Kriegman; David J,9999,0,9999,0
1668257781502,CSE 293,017,119300,Kumar; Arun Kumar,9999,0,9999,0
1668257781502,CSE 293,018,119301,Lerner; Sorin,9999,0,9999,0
1668257781502,CSE 293,019,119302,Lovett; Shachar,9999,0,9999,0
1668257781502,CSE 293,020,119303,McAuley; Julian John,9999,0,9999,0
1668257781502,CSE 293,021,119304,Micciancio; Daniele,9999,0,9999,0
1668257781502,CSE 293,022,119367,Orailoglu; Alex,9999,0,9999,0
1668257781502,CSE 293,023,119382,Paturi; Ramamohan,9999,0,9999,0
1668257781502,CSE 293,024,119404,Polikarpova; Nadezhda,9999,0,9999,0
1668257781502,CSE 293,025,119406,Politz; Joseph Gibbs,9999,0,9999,0
1668257781502,CSE 293,026,119411,Porter; George M,9999,0,9999,0
1668257781502,CSE 293,027,119414,Porter; Leonard Emerson,9999,0,9999,0
1668257781502,CSE 293,028,119416,Ramamoorthi; Ravi,9999,0,9999,0
1668257781502,CSE 293,029,119417,Sahoo; Debashis,9999,0,9999,0
1668257781502,CSE 293,030,119420,Saul; Lawrence,9999,0,9999,0
1668257781502,CSE 293,031,119421,Savage; Stefan,9999,0,9999,0
1668257781502,CSE 293,032,119425,Schulze; Jurgen P.,9999,0,9999,0
1668257781502,CSE 293,033,119426,Snoeren; Alex C.,9999,0,9999,0
1668257781502,CSE 293,034,119428,Shang; Jingbo,9999,0,9999,0
1668257781502,CSE 293,035,119430,Stefan; Deian,9999,0,9999,0
1668257781502,CSE 293,036,119431,Su; Hao,9999,0,9999,0
1668257781502,CSE 293,037,119433,Swanson; Steven James,9999,0,9999,0
1668257781502,CSE 293,038,119435,Tullsen; Dean Michael,9999,0,9999,0
1668257781502,CSE 293,039,119483,Voelker; Geoffrey M.,9999,0,9999,0
1668257781502,CSE 293,040,119537,Zhao; Jishen,9999,0,9999,0
1668257781502,CSE 293,041,119538,Zhou; Yuan-Yuan,9999,0,9999,0
1668257781502,CSE 293,042,119539,Gao; Sicun,9999,0,9999,0
1668257781502,CSE 293,043,119540,Weibel; Nadir,9999,0,9999,0
1668257781502,CSE 293,044,119541,Gupta; Rajesh K.,9999,0,9999,0
1668257781502,CSE 293,045,126410,Vaccaro; Kristen Marie,9999,0,9999,0
1668257781502,CSE 293,046,126411,Klemke; Richard,9999,0,9999,0
1668257781927,CSE 294,A00,102459,Voelker; Geoffrey M.,0,0,0,0
1668257781927,CSE 294,B00,111322,Orailoglu; Alex,0,0,0,0
1668257782356,DSE 201,A00,096914,Deutsch; Alin Bernard,30,0,30,0
1668257782781,DSE 210,A00,096915,Dasgupta; Sanjoy,30,0,30,0
1668257783213,DSE 260A,A00,096916,Altintas De Callaf; Ilkay,30,0,30,0
1668257783667,ECE 200,001,103586,Antipa; Nicholas A,9999,0,9999,0
1668257783667,ECE 200,002,103587,Atanasov; Nikolay A.,9999,0,9999,0
1668257783667,ECE 200,003,103588,Bharadia; Dinesh,9999,0,9999,0
1668257783667,ECE 200,004,103589,Cheng; Chung Kuan,9999,0,9999,0
1668257783667,ECE 200,005,103590,Cosman; Pamela C.,9999,0,9999,0
1668257783667,ECE 200,006,103591,Dayeh; Shadi Ahmad,9999,0,9999,0
1668257783667,ECE 200,007,103592,Fainman; Yeshaiahu,9999,0,9999,0
1668257783667,ECE 200,008,103593,Ford; Joseph Earl,9999,0,9999,0
1668257783667,ECE 200,009,103594,Franceschetti; Massimo,9999,0,9999,0
1668257783667,ECE 200,010,103595,Fullerton; Eric E,9999,0,9999,0
1668257783667,ECE 200,011,103596,Galton; Ian A,9999,0,9999,0
1668257783667,ECE 200,012,103597,Gilja; Vikash,9999,0,9999,0
1668257783667,ECE 200,013,103598,Hall; Drew A.,9999,0,9999,0
1668257783667,ECE 200,014,103599,Hsueh; Tzu-Chien,9999,0,9999,0
1668257783667,ECE 200,015,103600,Javidi; Tara,9999,0,9999,0
1668257783667,ECE 200,016,103601,Kahng; Andrew Byun,9999,0,9999,0
1668257783667,ECE 200,017,103602,Kim; Young-Han,9999,0,9999,0
1668257783667,ECE 200,018,103603,Koushanfar; Farinaz,9999,0,9999,0
1668257783667,ECE 200,019,103604,Kuzum; Duygu,9999,0,9999,0
1668257783667,ECE 200,020,103605,Le; Hanh-Phuc,9999,0,9999,0
1668257783667,ECE 200,021,103606,Lin; Bill,9999,0,9999,0
1668257783667,ECE 200,022,103607,Liu; Zhaowei,9998,0,9999,1
1668257783667,ECE 200,023,103608,Lo; Yu-Hwa,9999,0,9999,0
1668257783667,ECE 200,024,103609,Lomakin; Vitaliy,9999,0,9999,0
1668257783667,ECE 200,025,103610,Mercier; Patrick Philip,9999,0,9999,0
1668257783667,ECE 200,026,103611,Meyer; Florian,9999,0,9999,0
1668257783667,ECE 200,027,103612,Milstein; Laurence B.,9999,0,9999,0
1668257783667,ECE 200,028,103613,Mir Arabbaygi; Siavash,9999,0,9999,0
1668257783667,ECE 200,029,103614,Mookherjea; Shayan,9999,0,9999,0
1668257783667,ECE 200,030,103615,Morris; Karcher William,9999,0,9999,0
1668257783667,ECE 200,031,103616,Ng; Tse Nga,9999,0,9999,0
1668257783667,ECE 200,032,103617,Nguyen; Truong Quang,9999,0,9999,0
1668257783667,ECE 200,033,103618,Nomura; Kenji,9999,0,9999,0
1668257783667,ECE 200,034,103619,Orlitsky; Alon,9999,0,9999,0
1668257783667,ECE 200,035,103620,Pal; Piya,9999,0,9999,0
1668257783667,ECE 200,036,103621,Papen; George C.,9999,0,9999,0
1668257783667,ECE 200,037,103622,Radic; Stojan,9999,0,9999,0
1668257783667,ECE 200,038,103623,Rao; Bhaskar D.,9999,0,9999,0
1668257783667,ECE 200,039,103624,Rao; Ramesh R,9999,0,9999,0
1668257783667,ECE 200,040,103625,Rebeiz; Gabriel,9999,0,9999,0
1668257783667,ECE 200,041,103626,Sanford; John R,9999,0,9999,0
1668257783667,ECE 200,042,103627,Siegel; Paul H.,9999,0,9999,0
1668257783667,ECE 200,043,103628,Sievenpiper; Daniel F.,9999,0,9999,0
1668257783667,ECE 200,044,103629,Sworder; David D.,9999,0,9999,0
1668257783667,ECE 200,045,103630,Taur; Yuan,9999,0,9999,0
1668257783667,ECE 200,046,103631,Touri; Behrouz,9999,0,9999,0
1668257783667,ECE 200,047,103632,Trivedi; Mohan M.,9999,0,9999,0
1668257783667,ECE 200,048,103633,Vasconcelos; Nuno,9999,0,9999,0
1668257783667,ECE 200,049,103634,Wang; Xiaolong,9999,0,9999,0
1668257783667,ECE 200,050,103635,Xie; Pengtao,9999,0,9999,0
1668257783667,ECE 200,051,103636,Yip; Michael,9999,0,9999,0
1668257783667,ECE 200,052,103637,Zeger; Kenneth A.,999,0,999,0
1668257783667,ECE 200,053,103638,Zhang; Xinyu,9999,0,9999,0
1668257783667,ECE 200,054,103639,Turakhia; Yatish Girish,9999,0,9999,0
1668257783667,ECE 200,055,103640,Kang; Mingu,9999,0,9999,0
1668257783667,ECE 200,056,103641,Shi; Yuanyuan,9999,0,9999,0
1668257783667,ECE 200,057,103642,Wang; Edward Jay,9999,0,9999,0
1668257783667,ECE 200,058,103643,Zheng; Yang,9999,0,9999,0
1668257784094,ECE 202,A00,103644,Kuzum; Duygu,0,0,0,0
1668257784520,ECE 212BN,A00,103646,Ng; Tse Nga,0,0,0,0
1668257784946,ECE 221,A00,111493,Staff,0,0,0,0
1668257785370,ECE 222B,A00,103647,Lomakin; Vitaliy,0,0,0,0
1668257785795,ECE 230B,A00,103648,Taur; Yuan,0,0,0,0
1668257786221,ECE 238B,A00,103649,Garay; Javier,0,0,0,0
1668257786648,ECE 240B,A00,112900,Fainman; Yeshaiahu,0,0,0,0
1668257787074,ECE 247A,A00,103650,Jokerst; Jesse Vincent,0,0,0,0
1668257787500,ECE 247B,A00,103651,Wang; Joseph,0,0,0,0
1668257787935,ECE 250,A00,103652,Siegel; Paul H.,0,0,0,0
1668257788361,ECE 251A,A00,103654,Rao; Bhaskar D.,0,0,0,0
1668257788800,ECE 257B,A00,103655,Bharadia; Dinesh,0,0,0,0
1668257789227,ECE 258A,A00,103656,Milstein; Laurence B.,0,0,0,0
1668257789653,ECE 260B,A00,103658,Kang; Mingu,0,0,0,0
1668257790078,ECE 264A,A00,103659,Galton; Ian A,0,0,0,0
1668257790502,ECE 265A,A00,103661,Gudem; Prasad S.S.,0,0,0,0
1668257790936,ECE 265D,A00,103662,Gudem; Prasad S.S.,0,0,0,0
1668257791362,ECE 268,A00,103663,Koushanfar; Farinaz,0,0,0,0
1668257791874,ECE 269,A01,103665,Pal; Piya,0,0,0,0
1668257792299,ECE 271B,A00,103666,Vasconcelos; Manuela,0,0,0,0
1668257792724,ECE 276A,A00,103667,Atanasov; Nikolay A.,0,0,0,0
1668257793154,ECE 277,A00,103668,An; Cheolhong,0,0,0,0
1668257793584,ECE 279,A00,117947,Hall; Drew A.,0,0,0,0
1668257794437,ECE 283,A00,103670,Hsueh; Tzu-Chien,0,0,0,0
1668257794865,ECE 284,A00,103671,Turakhia; Yatish Girish,0,0,0,0
1668257795301,ECE 285,A00,103672,Zheng; Yang,0,0,0,0
1668257795301,ECE 285,B00,103673,Sworder; David D.,0,0,0,0
1668257795736,ECE 287,A00,103676,Javidi; Tara,0,0,0,0
1668257796160,MATH 200B,A00,098023,Salehi Golsefidy; Alireza,12,0,15,3
1668257796586,MATH 202B,A00,098024,Rhoades; Brendon Patrick,9,0,15,6
1668257797014,MATH 203B,A00,098025,Oprea; Dragos N.,10,0,15,5
1668257797442,MATH 204B,A00,098026,Sorensen; Claus M,13,0,15,2
1668257797873,MATH 208,A00,098027,Izadi; Elham,7,0,10,3
1668257798298,MATH 209,A00,098028,Pollack; Aaron,10,0,10,0
1668257798725,MATH 211A,A00,112919,Rogalski; Daniel,9,0,10,1
1668257799155,MATH 211B,A00,112920,Seward; Brandon M.,9,0,10,1
1668257799580,MATH 218,A00,098029,Li; Bo,10,0,10,0
1668257800014,MATH 220B,A00,098030,Novak; Jonathan I,11,0,15,4
1668257800438,MATH 221A,A00,098031,Ebenfelt; Peter F,13,0,15,2
1668257800866,MATH 231B,A00,098032,Zlatos; Andrej,12,0,15,3
1668257801336,MATH 240B,A00,098033,Ni; Lei,9,0,15,6
1668257801763,MATH 243,A00,098034,Jekel; David Andrew,10,0,10,0
1668257802193,MATH 245A,A00,098035,Nie; Jiawang,0,0,15,16
1668257802617,MATH 248,A00,098036,Bejenaru; Ioan,10,0,10,0
1668257803042,MATH 250B,A00,098037,Spolaor; Luca,14,0,15,1
1668257803472,MATH 258,A00,098038,Ni; Lei,10,0,10,0
1668257803897,MATH 264B,A00,098041,Rhoades; Brendon Patrick,9,0,15,6
1668257804321,MATH 268,A00,098042,Buss; Samuel R,10,0,10,0
1668257804746,MATH 269,A00,098043,Rhoades; Brendon Patrick,10,0,10,0
1668257805172,MATH 270B,A00,098044,Li; Bo,10,0,15,5
1668257805603,MATH 272B,A00,098045,Holst; Michael J,13,0,15,2
1668257806030,MATH 273A,A00,098046,Tian; Xiaochuan,10,0,15,5
1668257806463,MATH 275,A01,098048,Tian; Xiaochuan,6,0,10,4
1668257806891,MATH 278A,A00,098049,Holst; Michael J,8,0,10,2
1668257807320,MATH 278B,A00,098050,Cloninger; Alexander,10,0,10,0
1668257807747,MATH 278C,A00,098051,Nie; Jiawang,7,0,10,3
1668257808171,MATH 280B,A00,098052,Zheng; Tianyi,9,0,15,6
1668257808595,MATH 281B,A00,098053,Bradic; Jelena,1,0,15,14
1668257809018,MATH 282B,A00,098054,Arias-Castro; Ery,0,0,15,15
1668257809460,MATH 285,A00,098055,Fitzsimmons; Patrick J,0,0,15,17
1668257809885,MATH 287B,A00,098056,Arias-Castro; Ery,2,0,15,13
1668257810312,MATH 288,A00,098057,Agarwal; Pooja,9,0,10,1
1668257810312,MATH 288,B00,098058,Zhang; Danna,8,0,10,2
1668257810312,MATH 288,C00,098059,Williams; Ruth J,10,0,10,0
1668257810741,MATH 290B,A00,098060,Roberts; Justin Deritter,13,0,15,2
1668257811168,MATH 292,A00,098061,Belmont; Eva Kinoshita,10,0,10,0
1668257811608,MATH 295,A00,098062,Suk; Andrew Hoon,48,0,50,2
1668257812033,MATH 296,A00,098063,Novak; Jonathan I,20,0,20,0
1668257812459,MATH 297,001,098064,Gamst; Anthony Collins,9997,0,9999,2
1668258314013,COGS 205,A00,101395,Chiba; Andrea,19,0,20,1
1668258314437,COGS 210B,001,101404,Greene; Deanna Jacquelyn,9998,0,9999,1
1668258314437,COGS 210B,002,101417,Xia; Haijun,9999,0,9999,0
1668258314437,COGS 210B,003,101422,Nitz; Douglas A.,9999,0,9999,0
1668258314437,COGS 210B,004,101423,Hollan; James D.,9998,0,9999,1
1668258314437,COGS 210B,005,101424,Deak; Gedeon O.,9998,0,9999,1
1668258314437,COGS 210B,006,101425,Rossano; Federico,9999,0,9999,0
1668258314861,COGS 211B,A00,101427,Coulson; Seana M,9996,0,9999,3
1668258315285,COGS 220,A00,101428,Hollan; James D.,0,0,25,25
1668258315706,COGS 229,A00,101429,Dow; Steven P,18,0,25,7
1668258316133,COGS 230,A00,101430,Klemmer; Scott R,12,0,17,5
1668258316557,COGS 234,A00,101431,Xia; Haijun,2,0,25,23
1668258316983,COGS 260,A00,101432,Kiyonaga; Anastasia,21,0,25,4
1668258316983,COGS 260,B00,101433,Kirsh; David Joel,15,0,25,10
1668258317410,CSE 202,A00,102371,Impagliazzo; Russell,0,0,0,0
1668258317835,CSE 203B,A01,102373,Cheng; Chung Kuan,0,0,0,0
1668258318262,CSE 208,A00,102374,Micciancio; Daniele,0,0,0,0
1668258318687,CSE 209A,A00,112895,Impagliazzo; Russell,0,0,15,15
1668258319112,CSE 209B,A00,108005,Bellare; Mihir,0,0,0,0
1668258319539,CSE 210,A00,113163,Coblenz; Michael J,0,0,0,0
1668258319962,CSE 219,A00,106111,Dow; Steven P,0,0,20,20
1668258320387,CSE 221,A00,102376,Voelker; Geoffrey M.,0,0,0,0
1668258320810,CSE 224,A01,102378,Porter; George M,0,0,0,0
1668258321235,CSE 229A,A00,102379,Savage; Stefan,0,0,0,0
1668258321669,CSE 229C,A00,102380,Munyaka; Imani N. S.,0,0,0,0
1668258322096,CSE 232B,A00,102382,Deutsch; Alin Bernard,0,0,0,0
1668258322522,CSE 234,A01,112904,Kumar; Arun Kumar,0,0,0,0
1668258322947,CSE 237A,A00,102383,Rosing; Tajana Simunic,0,0,0,0
1668258323371,CSE 239A,A00,102384,Deutsch; Alin Bernard,0,0,0,0
1668258323795,CSE 239B,A00,102385,Polikarpova; Nadezhda,0,0,0,0
1668258324219,CSE 240A,A00,102386,Pannuto; Patrick William,0,0,0,0
1668258324654,CSE 240B,A00,102387,Zhao; Jishen,0,0,0,0
1668258325085,CSE 241A,A00,106406,Kang; Mingu,0,0,0,0
1668258325509,CSE 249B,A00,102388,Kahng; Andrew Byun,0,0,8,8
1668258325932,CSE 251B,A01,102392,Cottrell; Garrison W,0,0,0,0
1668258325932,CSE 251B,A02,102393,Cottrell; Garrison W,0,0,0,0
1668258326357,CSE 252B,A00,102394,Ochoa; Benjamin Lawrence,0,0,0,0
1668258326783,CSE 257,A01,102396,Gao; Sicun,0,0,0,0
1668258327208,CSE 272,A00,102397,Li; Tzumao,0,0,0,0
1668258327635,CSE 274,A00,111323,Chern; Albert Ren-Haur,0,0,0,0
1668258328059,CSE 282,A00,102398,Pevzner; Pavel Arkadjevich,0,0,0,0
1668258328484,CSE 284,A00,114175,Gymrek; Melissa Ann,0,0,0,0
1668258328909,CSE 290,A00,102399,Chandraker; Manmohan Krishna,0,0,0,0
1668258328909,CSE 290,B00,102400,Vaccaro; Kristen Marie,0,0,25,25
1668258328909,CSE 290,C00,102414,Pannuto; Patrick William,0,0,25,25
1668258328909,CSE 290,D00,102427,Pevzner; Pavel Arkadjevich,0,0,0,0
1668258328909,CSE 290,E00,102429,Zhao; Jishen,0,0,0,0
1668258328909,CSE 290,F00,102436,Tullsen; Dean Michael,0,0,0,0
1668258328909,CSE 290,G00,102440,Christensen; Henrik I,0,0,20,20
1668258329333,CSE 291,A00,102443,Su; Hao,0,0,0,0
1668258329333,CSE 291,B00,102448,Polikarpova; Nadezhda,0,0,0,0
1668258329333,CSE 291,C00,102453,Vaccaro; Kristen Marie,0,0,0,0
1668258329333,CSE 291,D00,111343,Savage; Stefan,0,0,0,0
1668258329333,CSE 291,E00,116474,Claffy; Kimberly Claire,0,0,0,0
1668258329333,CSE 291,F00,116479,Pasquale; Joseph,0,0,0,0
1668258329772,CSE 293,001,119111,Bafna; Vineet,9999,0,9999,0
1668258329772,CSE 293,002,119118,Bellare; Mihir,9999,0,9999,0
1668258329772,CSE 293,003,119122,Berg-Kirkpatrick; Taylor D,9999,0,9999,0
1668258329772,CSE 293,004,119135,Christensen; Henrik I,9999,0,9999,0
1668258329772,CSE 293,005,119142,Cottrell; Garrison W,9999,0,9999,0
1668258329772,CSE 293,006,119146,Deutsch; Alin Bernard,9999,0,9999,0
1668258329772,CSE 293,007,119159,Esmaeilzadeh; Hadi,9999,0,9999,0
1668258329772,CSE 293,008,119166,Freund; Yoav,9999,0,9999,0
1668258329772,CSE 293,009,119170,Griswold; William G.,9999,0,9999,0
1668258329772,CSE 293,010,119183,Gymrek; Melissa Ann,9999,0,9999,0
1668258329772,CSE 293,011,119190,Heninger; Nadia A,9999,0,9999,0
1668258329772,CSE 293,012,119230,Impagliazzo; Russell,9999,0,9999,0
1668258329772,CSE 293,013,119232,Jhala; Ranjit,9999,0,9999,0
1668258329772,CSE 293,014,119233,Kahng; Andrew Byun,9999,0,9999,0
1668258329772,CSE 293,015,119298,Kane; Daniel Mertz,9999,0,9999,0
1668258329772,CSE 293,016,119299,Kriegman; David J,9999,0,9999,0
1668258329772,CSE 293,017,119300,Kumar; Arun Kumar,9999,0,9999,0
1668258329772,CSE 293,018,119301,Lerner; Sorin,9999,0,9999,0
1668258329772,CSE 293,019,119302,Lovett; Shachar,9999,0,9999,0
1668258329772,CSE 293,020,119303,McAuley; Julian John,9999,0,9999,0
1668258329772,CSE 293,021,119304,Micciancio; Daniele,9999,0,9999,0
1668258329772,CSE 293,022,119367,Orailoglu; Alex,9999,0,9999,0
1668258329772,CSE 293,023,119382,Paturi; Ramamohan,9999,0,9999,0
1668258329772,CSE 293,024,119404,Polikarpova; Nadezhda,9999,0,9999,0
1668258329772,CSE 293,025,119406,Politz; Joseph Gibbs,9999,0,9999,0
1668258329772,CSE 293,026,119411,Porter; George M,9999,0,9999,0
1668258329772,CSE 293,027,119414,Porter; Leonard Emerson,9999,0,9999,0
1668258329772,CSE 293,028,119416,Ramamoorthi; Ravi,9999,0,9999,0
1668258329772,CSE 293,029,119417,Sahoo; Debashis,9999,0,9999,0
1668258329772,CSE 293,030,119420,Saul; Lawrence,9999,0,9999,0
1668258329772,CSE 293,031,119421,Savage; Stefan,9999,0,9999,0
1668258329772,CSE 293,032,119425,Schulze; Jurgen P.,9999,0,9999,0
1668258329772,CSE 293,033,119426,Snoeren; Alex C.,9999,0,9999,0
1668258329772,CSE 293,034,119428,Shang; Jingbo,9999,0,9999,0
1668258329772,CSE 293,035,119430,Stefan; Deian,9999,0,9999,0
1668258329772,CSE 293,036,119431,Su; Hao,9999,0,9999,0
1668258329772,CSE 293,037,119433,Swanson; Steven James,9999,0,9999,0
1668258329772,CSE 293,038,119435,Tullsen; Dean Michael,9999,0,9999,0
1668258329772,CSE 293,039,119483,Voelker; Geoffrey M.,9999,0,9999,0
1668258329772,CSE 293,040,119537,Zhao; Jishen,9999,0,9999,0
1668258329772,CSE 293,041,119538,Zhou; Yuan-Yuan,9999,0,9999,0
1668258329772,CSE 293,042,119539,Gao; Sicun,9999,0,9999,0
1668258329772,CSE 293,043,119540,Weibel; Nadir,9999,0,9999,0
1668258329772,CSE 293,044,119541,Gupta; Rajesh K.,9999,0,9999,0
1668258329772,CSE 293,045,126410,Vaccaro; Kristen Marie,9999,0,9999,0
1668258329772,CSE 293,046,126411,Klemke; Richard,9999,0,9999,0
1668258330198,CSE 294,A00,102459,Voelker; Geoffrey M.,0,0,0,0
1668258330198,CSE 294,B00,111322,Orailoglu; Alex,0,0,0,0
1668258330621,DSE 201,A00,096914,Deutsch; Alin Bernard,30,0,30,0
1668258331043,DSE 210,A00,096915,Dasgupta; Sanjoy,30,0,30,0
1668258331468,DSE 260A,A00,096916,Altintas De Callaf; Ilkay,30,0,30,0
1668258331909,ECE 200,001,103586,Antipa; Nicholas A,9999,0,9999,0
1668258331909,ECE 200,002,103587,Atanasov; Nikolay A.,9999,0,9999,0
1668258331909,ECE 200,003,103588,Bharadia; Dinesh,9999,0,9999,0
1668258331909,ECE 200,004,103589,Cheng; Chung Kuan,9999,0,9999,0
1668258331909,ECE 200,005,103590,Cosman; Pamela C.,9999,0,9999,0
1668258331909,ECE 200,006,103591,Dayeh; Shadi Ahmad,9999,0,9999,0
1668258331909,ECE 200,007,103592,Fainman; Yeshaiahu,9999,0,9999,0
1668258331909,ECE 200,008,103593,Ford; Joseph Earl,9999,0,9999,0
1668258331909,ECE 200,009,103594,Franceschetti; Massimo,9999,0,9999,0
1668258331909,ECE 200,010,103595,Fullerton; Eric E,9999,0,9999,0
1668258331909,ECE 200,011,103596,Galton; Ian A,9999,0,9999,0
1668258331909,ECE 200,012,103597,Gilja; Vikash,9999,0,9999,0
1668258331909,ECE 200,013,103598,Hall; Drew A.,9999,0,9999,0
1668258331909,ECE 200,014,103599,Hsueh; Tzu-Chien,9999,0,9999,0
1668258331909,ECE 200,015,103600,Javidi; Tara,9999,0,9999,0
1668258331909,ECE 200,016,103601,Kahng; Andrew Byun,9999,0,9999,0
1668258331909,ECE 200,017,103602,Kim; Young-Han,9999,0,9999,0
1668258331909,ECE 200,018,103603,Koushanfar; Farinaz,9999,0,9999,0
1668258331909,ECE 200,019,103604,Kuzum; Duygu,9999,0,9999,0
1668258331909,ECE 200,020,103605,Le; Hanh-Phuc,9999,0,9999,0
1668258331909,ECE 200,021,103606,Lin; Bill,9999,0,9999,0
1668258331909,ECE 200,022,103607,Liu; Zhaowei,9998,0,9999,1
1668258331909,ECE 200,023,103608,Lo; Yu-Hwa,9999,0,9999,0
1668258331909,ECE 200,024,103609,Lomakin; Vitaliy,9999,0,9999,0
1668258331909,ECE 200,025,103610,Mercier; Patrick Philip,9999,0,9999,0
1668258331909,ECE 200,026,103611,Meyer; Florian,9999,0,9999,0
1668258331909,ECE 200,027,103612,Milstein; Laurence B.,9999,0,9999,0
1668258331909,ECE 200,028,103613,Mir Arabbaygi; Siavash,9999,0,9999,0
1668258331909,ECE 200,029,103614,Mookherjea; Shayan,9999,0,9999,0
1668258331909,ECE 200,030,103615,Morris; Karcher William,9999,0,9999,0
1668258331909,ECE 200,031,103616,Ng; Tse Nga,9999,0,9999,0
1668258331909,ECE 200,032,103617,Nguyen; Truong Quang,9999,0,9999,0
1668258331909,ECE 200,033,103618,Nomura; Kenji,9999,0,9999,0
1668258331909,ECE 200,034,103619,Orlitsky; Alon,9999,0,9999,0
1668258331909,ECE 200,035,103620,Pal; Piya,9999,0,9999,0
1668258331909,ECE 200,036,103621,Papen; George C.,9999,0,9999,0
1668258331909,ECE 200,037,103622,Radic; Stojan,9999,0,9999,0
1668258331909,ECE 200,038,103623,Rao; Bhaskar D.,9999,0,9999,0
1668258331909,ECE 200,039,103624,Rao; Ramesh R,9999,0,9999,0
1668258331909,ECE 200,040,103625,Rebeiz; Gabriel,9999,0,9999,0
1668258331909,ECE 200,041,103626,Sanford; John R,9999,0,9999,0
1668258331909,ECE 200,042,103627,Siegel; Paul H.,9999,0,9999,0
1668258331909,ECE 200,043,103628,Sievenpiper; Daniel F.,9999,0,9999,0
1668258331909,ECE 200,044,103629,Sworder; David D.,9999,0,9999,0
1668258331909,ECE 200,045,103630,Taur; Yuan,9999,0,9999,0
1668258331909,ECE 200,046,103631,Touri; Behrouz,9999,0,9999,0
1668258331909,ECE 200,047,103632,Trivedi; Mohan M.,9999,0,9999,0
1668258331909,ECE 200,048,103633,Vasconcelos; Nuno,9999,0,9999,0
1668258331909,ECE 200,049,103634,Wang; Xiaolong,9999,0,9999,0
1668258331909,ECE 200,050,103635,Xie; Pengtao,9999,0,9999,0
1668258331909,ECE 200,051,103636,Yip; Michael,9999,0,9999,0
1668258331909,ECE 200,052,103637,Zeger; Kenneth A.,999,0,999,0
1668258331909,ECE 200,053,103638,Zhang; Xinyu,9999,0,9999,0
1668258331909,ECE 200,054,103639,Turakhia; Yatish Girish,9999,0,9999,0
1668258331909,ECE 200,055,103640,Kang; Mingu,9999,0,9999,0
1668258331909,ECE 200,056,103641,Shi; Yuanyuan,9999,0,9999,0
1668258331909,ECE 200,057,103642,Wang; Edward Jay,9999,0,9999,0
1668258331909,ECE 200,058,103643,Zheng; Yang,9999,0,9999,0
1668258332333,ECE 202,A00,103644,Kuzum; Duygu,0,0,0,0
1668258332761,ECE 212BN,A00,103646,Ng; Tse Nga,0,0,0,0
1668258333193,ECE 221,A00,111493,Staff,0,0,0,0
1668258333618,ECE 222B,A00,103647,Lomakin; Vitaliy,0,0,0,0
1668258334046,ECE 230B,A00,103648,Taur; Yuan,0,0,0,0
1668258334471,ECE 238B,A00,103649,Garay; Javier,0,0,0,0
1668258334894,ECE 240B,A00,112900,Fainman; Yeshaiahu,0,0,0,0
1668258335317,ECE 247A,A00,103650,Jokerst; Jesse Vincent,0,0,0,0
1668258335742,ECE 247B,A00,103651,Wang; Joseph,0,0,0,0
1668258336170,ECE 250,A00,103652,Siegel; Paul H.,0,0,0,0
1668258336603,ECE 251A,A00,103654,Rao; Bhaskar D.,0,0,0,0
1668258337027,ECE 257B,A00,103655,Bharadia; Dinesh,0,0,0,0
1668258337450,ECE 258A,A00,103656,Milstein; Laurence B.,0,0,0,0
1668258337877,ECE 260B,A00,103658,Kang; Mingu,0,0,0,0
1668258338303,ECE 264A,A00,103659,Galton; Ian A,0,0,0,0
1668258338727,ECE 265A,A00,103661,Gudem; Prasad S.S.,0,0,0,0
1668258339153,ECE 265D,A00,103662,Gudem; Prasad S.S.,0,0,0,0
1668258339574,ECE 268,A00,103663,Koushanfar; Farinaz,0,0,0,0
1668258339999,ECE 269,A01,103665,Pal; Piya,0,0,0,0
1668258340426,ECE 271B,A00,103666,Vasconcelos; Manuela,0,0,0,0
1668258340865,ECE 276A,A00,103667,Atanasov; Nikolay A.,0,0,0,0
1668258341290,ECE 277,A00,103668,An; Cheolhong,0,0,0,0
1668258341713,ECE 279,A00,117947,Hall; Drew A.,0,0,0,0
1668258342568,ECE 283,A00,103670,Hsueh; Tzu-Chien,0,0,0,0
1668258342999,ECE 284,A00,103671,Turakhia; Yatish Girish,0,0,0,0
1668258343432,ECE 285,A00,103672,Zheng; Yang,0,0,0,0
1668258343432,ECE 285,B00,103673,Sworder; David D.,0,0,0,0
1668258343860,ECE 287,A00,103676,Javidi; Tara,0,0,0,0
1668258344288,MATH 200B,A00,098023,Salehi Golsefidy; Alireza,12,0,15,3
1668258344714,MATH 202B,A00,098024,Rhoades; Brendon Patrick,9,0,15,6
1668258345137,MATH 203B,A00,098025,Oprea; Dragos N.,10,0,15,5
1668258345559,MATH 204B,A00,098026,Sorensen; Claus M,13,0,15,2
1668258345980,MATH 208,A00,098027,Izadi; Elham,7,0,10,3
1668258346408,MATH 209,A00,098028,Pollack; Aaron,10,0,10,0
1668258346835,MATH 211A,A00,112919,Rogalski; Daniel,9,0,10,1
1668258347261,MATH 211B,A00,112920,Seward; Brandon M.,9,0,10,1
1668258347686,MATH 218,A00,098029,Li; Bo,10,0,10,0
1668258348112,MATH 220B,A00,098030,Novak; Jonathan I,11,0,15,4
1668258348535,MATH 221A,A00,098031,Ebenfelt; Peter F,13,0,15,2
1668258348974,MATH 231B,A00,098032,Zlatos; Andrej,12,0,15,3
1668258349404,MATH 240B,A00,098033,Ni; Lei,9,0,15,6
1668258349831,MATH 243,A00,098034,Jekel; David Andrew,10,0,10,0
1668258350257,MATH 245A,A00,098035,Nie; Jiawang,0,0,15,16
1668258350680,MATH 248,A00,098036,Bejenaru; Ioan,10,0,10,0
1668258351105,MATH 250B,A00,098037,Spolaor; Luca,14,0,15,1
1668258351531,MATH 258,A00,098038,Ni; Lei,10,0,10,0
1668258351959,MATH 264B,A00,098041,Rhoades; Brendon Patrick,9,0,15,6
1668258352384,MATH 268,A00,098042,Buss; Samuel R,10,0,10,0
1668258352810,MATH 269,A00,098043,Rhoades; Brendon Patrick,10,0,10,0
1668258353234,MATH 270B,A00,098044,Li; Bo,10,0,15,5
1668258353658,MATH 272B,A00,098045,Holst; Michael J,13,0,15,2
1668258354082,MATH 273A,A00,098046,Tian; Xiaochuan,10,0,15,5
1668258354519,MATH 275,A01,098048,Tian; Xiaochuan,6,0,10,4
1668258354957,MATH 278A,A00,098049,Holst; Michael J,8,0,10,2
1668258355400,MATH 278B,A00,098050,Cloninger; Alexander,10,0,10,0
1668258355825,MATH 278C,A00,098051,Nie; Jiawang,7,0,10,3
1668258356250,MATH 280B,A00,098052,Zheng; Tianyi,9,0,15,6
1668258356749,MATH 281B,A00,098053,Bradic; Jelena,1,0,15,14
1668258357177,MATH 282B,A00,098054,Arias-Castro; Ery,0,0,15,15
1668258357602,MATH 285,A00,098055,Fitzsimmons; Patrick J,0,0,15,17
1668258358025,MATH 287B,A00,098056,Arias-Castro; Ery,2,0,15,13
1668258358455,MATH 288,A00,098057,Agarwal; Pooja,9,0,10,1
1668258358455,MATH 288,B00,098058,Zhang; Danna,8,0,10,2
1668258358455,MATH 288,C00,098059,Williams; Ruth J,10,0,10,0
1668258358883,MATH 290B,A00,098060,Roberts; Justin Deritter,13,0,15,2
1668258359306,MATH 292,A00,098061,Belmont; Eva Kinoshita,10,0,10,0
1668258359734,MATH 295,A00,098062,Suk; Andrew Hoon,48,0,50,2
1668258360176,MATH 296,A00,098063,Novak; Jonathan I,20,0,20,0
1668258360608,MATH 297,001,098064,Gamst; Anthony Collins,9997,0,9999,2
1668258861141,COGS 205,A00,101395,Chiba; Andrea,19,0,20,1
1668258861569,COGS 210B,001,101404,Greene; Deanna Jacquelyn,9998,0,9999,1
1668258861569,COGS 210B,002,101417,Xia; Haijun,9999,0,9999,0
1668258861569,COGS 210B,003,101422,Nitz; Douglas A.,9999,0,9999,0
1668258861569,COGS 210B,004,101423,Hollan; James D.,9998,0,9999,1
1668258861569,COGS 210B,005,101424,Deak; Gedeon O.,9998,0,9999,1
1668258861569,COGS 210B,006,101425,Rossano; Federico,9999,0,9999,0
1668258862000,COGS 211B,A00,101427,Coulson; Seana M,9996,0,9999,3
1668258862425,COGS 220,A00,101428,Hollan; James D.,0,0,25,25
1668258862853,COGS 229,A00,101429,Dow; Steven P,18,0,25,7
1668258863280,COGS 230,A00,101430,Klemmer; Scott R,12,0,17,5
1668258863707,COGS 234,A00,101431,Xia; Haijun,2,0,25,23
1668258864146,COGS 260,A00,101432,Kiyonaga; Anastasia,21,0,25,4
1668258864146,COGS 260,B00,101433,Kirsh; David Joel,15,0,25,10
1668258864572,CSE 202,A00,102371,Impagliazzo; Russell,0,0,0,0
1668258865023,CSE 203B,A01,102373,Cheng; Chung Kuan,0,0,0,0
1668258865454,CSE 208,A00,102374,Micciancio; Daniele,0,0,0,0
1668258865879,CSE 209A,A00,112895,Impagliazzo; Russell,0,0,15,15
1668258866302,CSE 209B,A00,108005,Bellare; Mihir,0,0,0,0
1668258866728,CSE 210,A00,113163,Coblenz; Michael J,0,0,0,0
1668258867159,CSE 219,A00,106111,Dow; Steven P,0,0,20,20
1668258867581,CSE 221,A00,102376,Voelker; Geoffrey M.,0,0,0,0
1668258868017,CSE 224,A01,102378,Porter; George M,0,0,0,0
1668258868441,CSE 229A,A00,102379,Savage; Stefan,0,0,0,0
1668258868866,CSE 229C,A00,102380,Munyaka; Imani N. S.,0,0,0,0
1668258869302,CSE 232B,A00,102382,Deutsch; Alin Bernard,0,0,0,0
1668258869728,CSE 234,A01,112904,Kumar; Arun Kumar,0,0,0,0
1668258870151,CSE 237A,A00,102383,Rosing; Tajana Simunic,0,0,0,0
1668258870581,CSE 239A,A00,102384,Deutsch; Alin Bernard,0,0,0,0
1668258871012,CSE 239B,A00,102385,Polikarpova; Nadezhda,0,0,0,0
1668258871439,CSE 240A,A00,102386,Pannuto; Patrick William,0,0,0,0
1668258871864,CSE 240B,A00,102387,Zhao; Jishen,0,0,0,0
1668258872289,CSE 241A,A00,106406,Kang; Mingu,0,0,0,0
1668258872714,CSE 249B,A00,102388,Kahng; Andrew Byun,0,0,8,8
1668258873140,CSE 251B,A01,102392,Cottrell; Garrison W,0,0,0,0
1668258873140,CSE 251B,A02,102393,Cottrell; Garrison W,0,0,0,0
1668258873563,CSE 252B,A00,102394,Ochoa; Benjamin Lawrence,0,0,0,0
1668258873994,CSE 257,A01,102396,Gao; Sicun,0,0,0,0
1668258874419,CSE 272,A00,102397,Li; Tzumao,0,0,0,0
1668258874842,CSE 274,A00,111323,Chern; Albert Ren-Haur,0,0,0,0
1668258875271,CSE 282,A00,102398,Pevzner; Pavel Arkadjevich,0,0,0,0
1668258875694,CSE 284,A00,114175,Gymrek; Melissa Ann,0,0,0,0
1668258876119,CSE 290,A00,102399,Chandraker; Manmohan Krishna,0,0,0,0
1668258876119,CSE 290,B00,102400,Vaccaro; Kristen Marie,0,0,25,25
1668258876119,CSE 290,C00,102414,Pannuto; Patrick William,0,0,25,25
1668258876119,CSE 290,D00,102427,Pevzner; Pavel Arkadjevich,0,0,0,0
1668258876119,CSE 290,E00,102429,Zhao; Jishen,0,0,0,0
1668258876119,CSE 290,F00,102436,Tullsen; Dean Michael,0,0,0,0
1668258876119,CSE 290,G00,102440,Christensen; Henrik I,0,0,20,20
1668258876547,CSE 291,A00,102443,Su; Hao,0,0,0,0
1668258876547,CSE 291,B00,102448,Polikarpova; Nadezhda,0,0,0,0
1668258876547,CSE 291,C00,102453,Vaccaro; Kristen Marie,0,0,0,0
1668258876547,CSE 291,D00,111343,Savage; Stefan,0,0,0,0
1668258876547,CSE 291,E00,116474,Claffy; Kimberly Claire,0,0,0,0
1668258876547,CSE 291,F00,116479,Pasquale; Joseph,0,0,0,0
1668258877008,CSE 293,001,119111,Bafna; Vineet,9999,0,9999,0
1668258877008,CSE 293,002,119118,Bellare; Mihir,9999,0,9999,0
1668258877008,CSE 293,003,119122,Berg-Kirkpatrick; Taylor D,9999,0,9999,0
1668258877008,CSE 293,004,119135,Christensen; Henrik I,9999,0,9999,0
1668258877008,CSE 293,005,119142,Cottrell; Garrison W,9999,0,9999,0
1668258877008,CSE 293,006,119146,Deutsch; Alin Bernard,9999,0,9999,0
1668258877008,CSE 293,007,119159,Esmaeilzadeh; Hadi,9999,0,9999,0
1668258877008,CSE 293,008,119166,Freund; Yoav,9999,0,9999,0
1668258877008,CSE 293,009,119170,Griswold; William G.,9999,0,9999,0
1668258877008,CSE 293,010,119183,Gymrek; Melissa Ann,9999,0,9999,0
1668258877008,CSE 293,011,119190,Heninger; Nadia A,9999,0,9999,0
1668258877008,CSE 293,012,119230,Impagliazzo; Russell,9999,0,9999,0
1668258877008,CSE 293,013,119232,Jhala; Ranjit,9999,0,9999,0
1668258877008,CSE 293,014,119233,Kahng; Andrew Byun,9999,0,9999,0
1668258877008,CSE 293,015,119298,Kane; Daniel Mertz,9999,0,9999,0
1668258877008,CSE 293,016,119299,Kriegman; David J,9999,0,9999,0
1668258877008,CSE 293,017,119300,Kumar; Arun Kumar,9999,0,9999,0
1668258877008,CSE 293,018,119301,Lerner; Sorin,9999,0,9999,0
1668258877008,CSE 293,019,119302,Lovett; Shachar,9999,0,9999,0
1668258877008,CSE 293,020,119303,McAuley; Julian John,9999,0,9999,0
1668258877008,CSE 293,021,119304,Micciancio; Daniele,9999,0,9999,0
1668258877008,CSE 293,022,119367,Orailoglu; Alex,9999,0,9999,0
1668258877008,CSE 293,023,119382,Paturi; Ramamohan,9999,0,9999,0
1668258877008,CSE 293,024,119404,Polikarpova; Nadezhda,9999,0,9999,0
1668258877008,CSE 293,025,119406,Politz; Joseph Gibbs,9999,0,9999,0
1668258877008,CSE 293,026,119411,Porter; George M,9999,0,9999,0
1668258877008,CSE 293,027,119414,Porter; Leonard Emerson,9999,0,9999,0
1668258877008,CSE 293,028,119416,Ramamoorthi; Ravi,9999,0,9999,0
1668258877008,CSE 293,029,119417,Sahoo; Debashis,9999,0,9999,0
1668258877008,CSE 293,030,119420,Saul; Lawrence,9999,0,9999,0
1668258877008,CSE 293,031,119421,Savage; Stefan,9999,0,9999,0
1668258877008,CSE 293,032,119425,Schulze; Jurgen P.,9999,0,9999,0
1668258877008,CSE 293,033,119426,Snoeren; Alex C.,9999,0,9999,0
1668258877008,CSE 293,034,119428,Shang; Jingbo,9999,0,9999,0
1668258877008,CSE 293,035,119430,Stefan; Deian,9999,0,9999,0
1668258877008,CSE 293,036,119431,Su; Hao,9999,0,9999,0
1668258877008,CSE 293,037,119433,Swanson; Steven James,9999,0,9999,0
1668258877008,CSE 293,038,119435,Tullsen; Dean Michael,9999,0,9999,0
1668258877008,CSE 293,039,119483,Voelker; Geoffrey M.,9999,0,9999,0
1668258877008,CSE 293,040,119537,Zhao; Jishen,9999,0,9999,0
1668258877008,CSE 293,041,119538,Zhou; Yuan-Yuan,9999,0,9999,0
1668258877008,CSE 293,042,119539,Gao; Sicun,9999,0,9999,0
1668258877008,CSE 293,043,119540,Weibel; Nadir,9999,0,9999,0
1668258877008,CSE 293,044,119541,Gupta; Rajesh K.,9999,0,9999,0
1668258877008,CSE 293,045,126410,Vaccaro; Kristen Marie,9999,0,9999,0
1668258877008,CSE 293,046,126411,Klemke; Richard,9999,0,9999,0
1668258877526,CSE 294,A00,102459,Voelker; Geoffrey M.,0,0,0,0
1668258877526,CSE 294,B00,111322,Orailoglu; Alex,0,0,0,0
1668258877948,DSE 201,A00,096914,Deutsch; Alin Bernard,30,0,30,0
1668258878373,DSE 210,A00,096915,Dasgupta; Sanjoy,30,0,30,0
1668258878795,DSE 260A,A00,096916,Altintas De Callaf; Ilkay,30,0,30,0
1668258879244,ECE 200,001,103586,Antipa; Nicholas A,9999,0,9999,0
1668258879244,ECE 200,002,103587,Atanasov; Nikolay A.,9999,0,9999,0
1668258879244,ECE 200,003,103588,Bharadia; Dinesh,9999,0,9999,0
1668258879244,ECE 200,004,103589,Cheng; Chung Kuan,9999,0,9999,0
1668258879244,ECE 200,005,103590,Cosman; Pamela C.,9999,0,9999,0
1668258879244,ECE 200,006,103591,Dayeh; Shadi Ahmad,9999,0,9999,0
1668258879244,ECE 200,007,103592,Fainman; Yeshaiahu,9999,0,9999,0
1668258879244,ECE 200,008,103593,Ford; Joseph Earl,9999,0,9999,0
1668258879244,ECE 200,009,103594,Franceschetti; Massimo,9999,0,9999,0
1668258879244,ECE 200,010,103595,Fullerton; Eric E,9999,0,9999,0
1668258879244,ECE 200,011,103596,Galton; Ian A,9999,0,9999,0
1668258879244,ECE 200,012,103597,Gilja; Vikash,9999,0,9999,0
1668258879244,ECE 200,013,103598,Hall; Drew A.,9999,0,9999,0
1668258879244,ECE 200,014,103599,Hsueh; Tzu-Chien,9999,0,9999,0
1668258879244,ECE 200,015,103600,Javidi; Tara,9999,0,9999,0
1668258879244,ECE 200,016,103601,Kahng; Andrew Byun,9999,0,9999,0
1668258879244,ECE 200,017,103602,Kim; Young-Han,9999,0,9999,0
1668258879244,ECE 200,018,103603,Koushanfar; Farinaz,9999,0,9999,0
1668258879244,ECE 200,019,103604,Kuzum; Duygu,9999,0,9999,0
1668258879244,ECE 200,020,103605,Le; Hanh-Phuc,9999,0,9999,0
1668258879244,ECE 200,021,103606,Lin; Bill,9999,0,9999,0
1668258879244,ECE 200,022,103607,Liu; Zhaowei,9998,0,9999,1
1668258879244,ECE 200,023,103608,Lo; Yu-Hwa,9999,0,9999,0
1668258879244,ECE 200,024,103609,Lomakin; Vitaliy,9999,0,9999,0
1668258879244,ECE 200,025,103610,Mercier; Patrick Philip,9999,0,9999,0
1668258879244,ECE 200,026,103611,Meyer; Florian,9999,0,9999,0
1668258879244,ECE 200,027,103612,Milstein; Laurence B.,9999,0,9999,0
1668258879244,ECE 200,028,103613,Mir Arabbaygi; Siavash,9999,0,9999,0
1668258879244,ECE 200,029,103614,Mookherjea; Shayan,9999,0,9999,0
1668258879244,ECE 200,030,103615,Morris; Karcher William,9999,0,9999,0
1668258879244,ECE 200,031,103616,Ng; Tse Nga,9999,0,9999,0
1668258879244,ECE 200,032,103617,Nguyen; Truong Quang,9999,0,9999,0
1668258879244,ECE 200,033,103618,Nomura; Kenji,9999,0,9999,0
1668258879244,ECE 200,034,103619,Orlitsky; Alon,9999,0,9999,0
1668258879244,ECE 200,035,103620,Pal; Piya,9999,0,9999,0
1668258879244,ECE 200,036,103621,Papen; George C.,9999,0,9999,0
1668258879244,ECE 200,037,103622,Radic; Stojan,9999,0,9999,0
1668258879244,ECE 200,038,103623,Rao; Bhaskar D.,9999,0,9999,0
1668258879244,ECE 200,039,103624,Rao; Ramesh R,9999,0,9999,0
1668258879244,ECE 200,040,103625,Rebeiz; Gabriel,9999,0,9999,0
1668258879244,ECE 200,041,103626,Sanford; John R,9999,0,9999,0
1668258879244,ECE 200,042,103627,Siegel; Paul H.,9999,0,9999,0
1668258879244,ECE 200,043,103628,Sievenpiper; Daniel F.,9999,0,9999,0
1668258879244,ECE 200,044,103629,Sworder; David D.,9999,0,9999,0
1668258879244,ECE 200,045,103630,Taur; Yuan,9999,0,9999,0
1668258879244,ECE 200,046,103631,Touri; Behrouz,9999,0,9999,0
1668258879244,ECE 200,047,103632,Trivedi; Mohan M.,9999,0,9999,0
1668258879244,ECE 200,048,103633,Vasconcelos; Nuno,9999,0,9999,0
1668258879244,ECE 200,049,103634,Wang; Xiaolong,9999,0,9999,0
1668258879244,ECE 200,050,103635,Xie; Pengtao,9999,0,9999,0
1668258879244,ECE 200,051,103636,Yip; Michael,9999,0,9999,0
1668258879244,ECE 200,052,103637,Zeger; Kenneth A.,999,0,999,0
1668258879244,ECE 200,053,103638,Zhang; Xinyu,9999,0,9999,0
1668258879244,ECE 200,054,103639,Turakhia; Yatish Girish,9999,0,9999,0
1668258879244,ECE 200,055,103640,Kang; Mingu,9999,0,9999,0
1668258879244,ECE 200,056,103641,Shi; Yuanyuan,9999,0,9999,0
1668258879244,ECE 200,057,103642,Wang; Edward Jay,9999,0,9999,0
1668258879244,ECE 200,058,103643,Zheng; Yang,9999,0,9999,0
1668258879667,ECE 202,A00,103644,Kuzum; Duygu,0,0,0,0
1668258880092,ECE 212BN,A00,103646,Ng; Tse Nga,0,0,0,0
1668258880519,ECE 221,A00,111493,Staff,0,0,0,0
1668258880944,ECE 222B,A00,103647,Lomakin; Vitaliy,0,0,0,0
1668258881369,ECE 230B,A00,103648,Taur; Yuan,0,0,0,0
1668258881794,ECE 238B,A00,103649,Garay; Javier,0,0,0,0
1668258882221,ECE 240B,A00,112900,Fainman; Yeshaiahu,0,0,0,0
1668258882647,ECE 247A,A00,103650,Jokerst; Jesse Vincent,0,0,0,0
1668258883073,ECE 247B,A00,103651,Wang; Joseph,0,0,0,0
1668258883499,ECE 250,A00,103652,Siegel; Paul H.,0,0,0,0
1668258883934,ECE 251A,A00,103654,Rao; Bhaskar D.,0,0,0,0
1668258884357,ECE 257B,A00,103655,Bharadia; Dinesh,0,0,0,0
1668258884782,ECE 258A,A00,103656,Milstein; Laurence B.,0,0,0,0
1668258885205,ECE 260B,A00,103658,Kang; Mingu,0,0,0,0
1668258885628,ECE 264A,A00,103659,Galton; Ian A,0,0,0,0
1668258886066,ECE 265A,A00,103661,Gudem; Prasad S.S.,0,0,0,0
1668258886492,ECE 265D,A00,103662,Gudem; Prasad S.S.,0,0,0,0
1668258886919,ECE 268,A00,103663,Koushanfar; Farinaz,0,0,0,0
1668258887354,ECE 269,A01,103665,Pal; Piya,0,0,0,0
1668258887777,ECE 271B,A00,103666,Vasconcelos; Manuela,0,0,0,0
1668258888200,ECE 276A,A00,103667,Atanasov; Nikolay A.,0,0,0,0
1668258888629,ECE 277,A00,103668,An; Cheolhong,0,0,0,0
1668258889058,ECE 279,A00,117947,Hall; Drew A.,0,0,0,0
1668258889906,ECE 283,A00,103670,Hsueh; Tzu-Chien,0,0,0,0
1668258890333,ECE 284,A00,103671,Turakhia; Yatish Girish,0,0,0,0
1668258890763,ECE 285,A00,103672,Zheng; Yang,0,0,0,0
1668258890763,ECE 285,B00,103673,Sworder; David D.,0,0,0,0
1668258891189,ECE 287,A00,103676,Javidi; Tara,0,0,0,0
1668258891619,MATH 200B,A00,098023,Salehi Golsefidy; Alireza,12,0,15,3
1668258892053,MATH 202B,A00,098024,Rhoades; Brendon Patrick,9,0,15,6
1668258892481,MATH 203B,A00,098025,Oprea; Dragos N.,10,0,15,5
1668258892905,MATH 204B,A00,098026,Sorensen; Claus M,13,0,15,2
1668258893329,MATH 208,A00,098027,Izadi; Elham,7,0,10,3
1668258893754,MATH 209,A00,098028,Pollack; Aaron,10,0,10,0
1668258894181,MATH 211A,A00,112919,Rogalski; Daniel,9,0,10,1
1668258894603,MATH 211B,A00,112920,Seward; Brandon M.,9,0,10,1
1668258895026,MATH 218,A00,098029,Li; Bo,10,0,10,0
1668258895453,MATH 220B,A00,098030,Novak; Jonathan I,11,0,15,4
1668258895876,MATH 221A,A00,098031,Ebenfelt; Peter F,13,0,15,2
1668258896299,MATH 231B,A00,098032,Zlatos; Andrej,12,0,15,3
1668258896726,MATH 240B,A00,098033,Ni; Lei,9,0,15,6
1668258897152,MATH 243,A00,098034,Jekel; David Andrew,10,0,10,0
1668258897576,MATH 245A,A00,098035,Nie; Jiawang,0,0,15,16
1668258898002,MATH 248,A00,098036,Bejenaru; Ioan,10,0,10,0
1668258898434,MATH 250B,A00,098037,Spolaor; Luca,14,0,15,1
1668258898865,MATH 258,A00,098038,Ni; Lei,10,0,10,0
1668258899289,MATH 264B,A00,098041,Rhoades; Brendon Patrick,9,0,15,6
1668258899714,MATH 268,A00,098042,Buss; Samuel R,10,0,10,0
1668258900153,MATH 269,A00,098043,Rhoades; Brendon Patrick,10,0,10,0
1668258900579,MATH 270B,A00,098044,Li; Bo,10,0,15,5
1668258901004,MATH 272B,A00,098045,Holst; Michael J,13,0,15,2
1668258901429,MATH 273A,A00,098046,Tian; Xiaochuan,10,0,15,5
1668258901856,MATH 275,A01,098048,Tian; Xiaochuan,6,0,10,4
1668258902278,MATH 278A,A00,098049,Holst; Michael J,8,0,10,2
1668258902720,MATH 278B,A00,098050,Cloninger; Alexander,10,0,10,0
1668258903144,MATH 278C,A00,098051,Nie; Jiawang,7,0,10,3
1668258903571,MATH 280B,A00,098052,Zheng; Tianyi,9,0,15,6
1668258903995,MATH 281B,A00,098053,Bradic; Jelena,1,0,15,14
1668258904421,MATH 282B,A00,098054,Arias-Castro; Ery,0,0,15,15
1668258904851,MATH 285,A00,098055,Fitzsimmons; Patrick J,0,0,15,17
1668258905277,MATH 287B,A00,098056,Arias-Castro; Ery,2,0,15,13
1668258905702,MATH 288,A00,098057,Agarwal; Pooja,9,0,10,1
1668258905702,MATH 288,B00,098058,Zhang; Danna,8,0,10,2
1668258905702,MATH 288,C00,098059,Williams; Ruth J,10,0,10,0
1668258906125,MATH 290B,A00,098060,Roberts; Justin Deritter,13,0,15,2
1668258906550,MATH 292,A00,098061,Belmont; Eva Kinoshita,10,0,10,0
1668258906973,MATH 295,A00,098062,Suk; Andrew Hoon,48,0,50,2
1668258907397,MATH 296,A00,098063,Novak; Jonathan I,20,0,20,0
1668258907821,MATH 297,001,098064,Gamst; Anthony Collins,9997,0,9999,2
1668259407945,COGS 205,A00,101395,Chiba; Andrea,19,0,20,1
1668259408372,COGS 210B,001,101404,Greene; Deanna Jacquelyn,9998,0,9999,1
1668259408372,COGS 210B,002,101417,Xia; Haijun,9999,0,9999,0
1668259408372,COGS 210B,003,101422,Nitz; Douglas A.,9999,0,9999,0
1668259408372,COGS 210B,004,101423,Hollan; James D.,9998,0,9999,1
1668259408372,COGS 210B,005,101424,Deak; Gedeon O.,9998,0,9999,1
1668259408372,COGS 210B,006,101425,Rossano; Federico,9999,0,9999,0
1668259408798,COGS 211B,A00,101427,Coulson; Seana M,9996,0,9999,3
1668259409221,COGS 220,A00,101428,Hollan; James D.,0,0,25,25
1668259409648,COGS 229,A00,101429,Dow; Steven P,18,0,25,7
1668259410072,COGS 230,A00,101430,Klemmer; Scott R,12,0,17,5
1668259410494,COGS 234,A00,101431,Xia; Haijun,2,0,25,23
1668259410917,COGS 260,A00,101432,Kiyonaga; Anastasia,21,0,25,4
1668259410917,COGS 260,B00,101433,Kirsh; David Joel,15,0,25,10
1668259411344,CSE 202,A00,102371,Impagliazzo; Russell,0,0,0,0
1668259411770,CSE 203B,A01,102373,Cheng; Chung Kuan,0,0,0,0
1668259412196,CSE 208,A00,102374,Micciancio; Daniele,0,0,0,0
1668259412619,CSE 209A,A00,112895,Impagliazzo; Russell,0,0,15,15
1668259413051,CSE 209B,A00,108005,Bellare; Mihir,0,0,0,0
1668259413480,CSE 210,A00,113163,Coblenz; Michael J,0,0,0,0
1668259413915,CSE 219,A00,106111,Dow; Steven P,0,0,20,20
1668259414341,CSE 221,A00,102376,Voelker; Geoffrey M.,0,0,0,0
1668259414765,CSE 224,A01,102378,Porter; George M,0,0,0,0
1668259415192,CSE 229A,A00,102379,Savage; Stefan,0,0,0,0
1668259415618,CSE 229C,A00,102380,Munyaka; Imani N. S.,0,0,0,0
1668259416044,CSE 232B,A00,102382,Deutsch; Alin Bernard,0,0,0,0
1668259416471,CSE 234,A01,112904,Kumar; Arun Kumar,0,0,0,0
1668259416898,CSE 237A,A00,102383,Rosing; Tajana Simunic,0,0,0,0
1668259417329,CSE 239A,A00,102384,Deutsch; Alin Bernard,0,0,0,0
1668259417751,CSE 239B,A00,102385,Polikarpova; Nadezhda,0,0,0,0
1668259418174,CSE 240A,A00,102386,Pannuto; Patrick William,0,0,0,0
1668259418603,CSE 240B,A00,102387,Zhao; Jishen,0,0,0,0
1668259419030,CSE 241A,A00,106406,Kang; Mingu,0,0,0,0
1668259419456,CSE 249B,A00,102388,Kahng; Andrew Byun,0,0,8,8
1668259419884,CSE 251B,A01,102392,Cottrell; Garrison W,0,0,0,0
1668259419884,CSE 251B,A02,102393,Cottrell; Garrison W,0,0,0,0
1668259420310,CSE 252B,A00,102394,Ochoa; Benjamin Lawrence,0,0,0,0
1668259420733,CSE 257,A01,102396,Gao; Sicun,0,0,0,0
1668259421157,CSE 272,A00,102397,Li; Tzumao,0,0,0,0
1668259421581,CSE 274,A00,111323,Chern; Albert Ren-Haur,0,0,0,0
1668259422008,CSE 282,A00,102398,Pevzner; Pavel Arkadjevich,0,0,0,0
1668259422434,CSE 284,A00,114175,Gymrek; Melissa Ann,0,0,0,0
1668259422861,CSE 290,A00,102399,Chandraker; Manmohan Krishna,0,0,0,0
1668259422861,CSE 290,B00,102400,Vaccaro; Kristen Marie,0,0,25,25
1668259422861,CSE 290,C00,102414,Pannuto; Patrick William,0,0,25,25
1668259422861,CSE 290,D00,102427,Pevzner; Pavel Arkadjevich,0,0,0,0
1668259422861,CSE 290,E00,102429,Zhao; Jishen,0,0,0,0
1668259422861,CSE 290,F00,102436,Tullsen; Dean Michael,0,0,0,0
1668259422861,CSE 290,G00,102440,Christensen; Henrik I,0,0,20,20
1668259423286,CSE 291,A00,102443,Su; Hao,0,0,0,0
1668259423286,CSE 291,B00,102448,Polikarpova; Nadezhda,0,0,0,0
1668259423286,CSE 291,C00,102453,Vaccaro; Kristen Marie,0,0,0,0
1668259423286,CSE 291,D00,111343,Savage; Stefan,0,0,0,0
1668259423286,CSE 291,E00,116474,Claffy; Kimberly Claire,0,0,0,0
1668259423286,CSE 291,F00,116479,Pasquale; Joseph,0,0,0,0
1668259423721,CSE 293,001,119111,Bafna; Vineet,9999,0,9999,0
1668259423721,CSE 293,002,119118,Bellare; Mihir,9999,0,9999,0
1668259423721,CSE 293,003,119122,Berg-Kirkpatrick; Taylor D,9999,0,9999,0
1668259423721,CSE 293,004,119135,Christensen; Henrik I,9999,0,9999,0
1668259423721,CSE 293,005,119142,Cottrell; Garrison W,9999,0,9999,0
1668259423721,CSE 293,006,119146,Deutsch; Alin Bernard,9999,0,9999,0
1668259423721,CSE 293,007,119159,Esmaeilzadeh; Hadi,9999,0,9999,0
1668259423721,CSE 293,008,119166,Freund; Yoav,9999,0,9999,0
1668259423721,CSE 293,009,119170,Griswold; William G.,9999,0,9999,0
1668259423721,CSE 293,010,119183,Gymrek; Melissa Ann,9999,0,9999,0
1668259423721,CSE 293,011,119190,Heninger; Nadia A,9999,0,9999,0
1668259423721,CSE 293,012,119230,Impagliazzo; Russell,9999,0,9999,0
1668259423721,CSE 293,013,119232,Jhala; Ranjit,9999,0,9999,0
1668259423721,CSE 293,014,119233,Kahng; Andrew Byun,9999,0,9999,0
1668259423721,CSE 293,015,119298,Kane; Daniel Mertz,9999,0,9999,0
1668259423721,CSE 293,016,119299,Kriegman; David J,9999,0,9999,0
1668259423721,CSE 293,017,119300,Kumar; Arun Kumar,9999,0,9999,0
1668259423721,CSE 293,018,119301,Lerner; Sorin,9999,0,9999,0
1668259423721,CSE 293,019,119302,Lovett; Shachar,9999,0,9999,0
1668259423721,CSE 293,020,119303,McAuley; Julian John,9999,0,9999,0
1668259423721,CSE 293,021,119304,Micciancio; Daniele,9999,0,9999,0
1668259423721,CSE 293,022,119367,Orailoglu; Alex,9999,0,9999,0
1668259423721,CSE 293,023,119382,Paturi; Ramamohan,9999,0,9999,0
1668259423721,CSE 293,024,119404,Polikarpova; Nadezhda,9999,0,9999,0
1668259423721,CSE 293,025,119406,Politz; Joseph Gibbs,9999,0,9999,0
1668259423721,CSE 293,026,119411,Porter; George M,9999,0,9999,0
1668259423721,CSE 293,027,119414,Porter; Leonard Emerson,9999,0,9999,0
1668259423721,CSE 293,028,119416,Ramamoorthi; Ravi,9999,0,9999,0
1668259423721,CSE 293,029,119417,Sahoo; Debashis,9999,0,9999,0
1668259423721,CSE 293,030,119420,Saul; Lawrence,9999,0,9999,0
1668259423721,CSE 293,031,119421,Savage; Stefan,9999,0,9999,0
1668259423721,CSE 293,032,119425,Schulze; Jurgen P.,9999,0,9999,0
1668259423721,CSE 293,033,119426,Snoeren; Alex C.,9999,0,9999,0
1668259423721,CSE 293,034,119428,Shang; Jingbo,9999,0,9999,0
1668259423721,CSE 293,035,119430,Stefan; Deian,9999,0,9999,0
1668259423721,CSE 293,036,119431,Su; Hao,9999,0,9999,0
1668259423721,CSE 293,037,119433,Swanson; Steven James,9999,0,9999,0
1668259423721,CSE 293,038,119435,Tullsen; Dean Michael,9999,0,9999,0
1668259423721,CSE 293,039,119483,Voelker; Geoffrey M.,9999,0,9999,0
1668259423721,CSE 293,040,119537,Zhao; Jishen,9999,0,9999,0
1668259423721,CSE 293,041,119538,Zhou; Yuan-Yuan,9999,0,9999,0
1668259423721,CSE 293,042,119539,Gao; Sicun,9999,0,9999,0
1668259423721,CSE 293,043,119540,Weibel; Nadir,9999,0,9999,0
1668259423721,CSE 293,044,119541,Gupta; Rajesh K.,9999,0,9999,0
1668259423721,CSE 293,045,126410,Vaccaro; Kristen Marie,9999,0,9999,0
1668259423721,CSE 293,046,126411,Klemke; Richard,9999,0,9999,0
1668259424146,CSE 294,A00,102459,Voelker; Geoffrey M.,0,0,0,0
1668259424146,CSE 294,B00,111322,Orailoglu; Alex,0,0,0,0
1668259424569,DSE 201,A00,096914,Deutsch; Alin Bernard,30,0,30,0
1668259424995,DSE 210,A00,096915,Dasgupta; Sanjoy,30,0,30,0
1668259425420,DSE 260A,A00,096916,Altintas De Callaf; Ilkay,30,0,30,0
1668259425846,ECE 200,001,103586,Antipa; Nicholas A,9999,0,9999,0
1668259425846,ECE 200,002,103587,Atanasov; Nikolay A.,9999,0,9999,0
1668259425846,ECE 200,003,103588,Bharadia; Dinesh,9999,0,9999,0
1668259425846,ECE 200,004,103589,Cheng; Chung Kuan,9999,0,9999,0
1668259425846,ECE 200,005,103590,Cosman; Pamela C.,9999,0,9999,0
1668259425846,ECE 200,006,103591,Dayeh; Shadi Ahmad,9999,0,9999,0
1668259425846,ECE 200,007,103592,Fainman; Yeshaiahu,9999,0,9999,0
1668259425846,ECE 200,008,103593,Ford; Joseph Earl,9999,0,9999,0
1668259425846,ECE 200,009,103594,Franceschetti; Massimo,9999,0,9999,0
1668259425846,ECE 200,010,103595,Fullerton; Eric E,9999,0,9999,0
1668259425846,ECE 200,011,103596,Galton; Ian A,9999,0,9999,0
1668259425846,ECE 200,012,103597,Gilja; Vikash,9999,0,9999,0
1668259425846,ECE 200,013,103598,Hall; Drew A.,9999,0,9999,0
1668259425846,ECE 200,014,103599,Hsueh; Tzu-Chien,9999,0,9999,0
1668259425846,ECE 200,015,103600,Javidi; Tara,9999,0,9999,0
1668259425846,ECE 200,016,103601,Kahng; Andrew Byun,9999,0,9999,0
1668259425846,ECE 200,017,103602,Kim; Young-Han,9999,0,9999,0
1668259425846,ECE 200,018,103603,Koushanfar; Farinaz,9999,0,9999,0
1668259425846,ECE 200,019,103604,Kuzum; Duygu,9999,0,9999,0
1668259425846,ECE 200,020,103605,Le; Hanh-Phuc,9999,0,9999,0
1668259425846,ECE 200,021,103606,Lin; Bill,9999,0,9999,0
1668259425846,ECE 200,022,103607,Liu; Zhaowei,9998,0,9999,1
1668259425846,ECE 200,023,103608,Lo; Yu-Hwa,9999,0,9999,0
1668259425846,ECE 200,024,103609,Lomakin; Vitaliy,9999,0,9999,0
1668259425846,ECE 200,025,103610,Mercier; Patrick Philip,9999,0,9999,0
1668259425846,ECE 200,026,103611,Meyer; Florian,9999,0,9999,0
1668259425846,ECE 200,027,103612,Milstein; Laurence B.,9999,0,9999,0
1668259425846,ECE 200,028,103613,Mir Arabbaygi; Siavash,9999,0,9999,0
1668259425846,ECE 200,029,103614,Mookherjea; Shayan,9999,0,9999,0
1668259425846,ECE 200,030,103615,Morris; Karcher William,9999,0,9999,0
1668259425846,ECE 200,031,103616,Ng; Tse Nga,9999,0,9999,0
1668259425846,ECE 200,032,103617,Nguyen; Truong Quang,9999,0,9999,0
1668259425846,ECE 200,033,103618,Nomura; Kenji,9999,0,9999,0
1668259425846,ECE 200,034,103619,Orlitsky; Alon,9999,0,9999,0
1668259425846,ECE 200,035,103620,Pal; Piya,9999,0,9999,0
1668259425846,ECE 200,036,103621,Papen; George C.,9999,0,9999,0
1668259425846,ECE 200,037,103622,Radic; Stojan,9999,0,9999,0
1668259425846,ECE 200,038,103623,Rao; Bhaskar D.,9999,0,9999,0
1668259425846,ECE 200,039,103624,Rao; Ramesh R,9999,0,9999,0
1668259425846,ECE 200,040,103625,Rebeiz; Gabriel,9999,0,9999,0
1668259425846,ECE 200,041,103626,Sanford; John R,9999,0,9999,0
1668259425846,ECE 200,042,103627,Siegel; Paul H.,9999,0,9999,0
1668259425846,ECE 200,043,103628,Sievenpiper; Daniel F.,9999,0,9999,0
1668259425846,ECE 200,044,103629,Sworder; David D.,9999,0,9999,0
1668259425846,ECE 200,045,103630,Taur; Yuan,9999,0,9999,0
1668259425846,ECE 200,046,103631,Touri; Behrouz,9999,0,9999,0
1668259425846,ECE 200,047,103632,Trivedi; Mohan M.,9999,0,9999,0
1668259425846,ECE 200,048,103633,Vasconcelos; Nuno,9999,0,9999,0
1668259425846,ECE 200,049,103634,Wang; Xiaolong,9999,0,9999,0
1668259425846,ECE 200,050,103635,Xie; Pengtao,9999,0,9999,0
1668259425846,ECE 200,051,103636,Yip; Michael,9999,0,9999,0
1668259425846,ECE 200,052,103637,Zeger; Kenneth A.,999,0,999,0
1668259425846,ECE 200,053,103638,Zhang; Xinyu,9999,0,9999,0
1668259425846,ECE 200,054,103639,Turakhia; Yatish Girish,9999,0,9999,0
1668259425846,ECE 200,055,103640,Kang; Mingu,9999,0,9999,0
1668259425846,ECE 200,056,103641,Shi; Yuanyuan,9999,0,9999,0
1668259425846,ECE 200,057,103642,Wang; Edward Jay,9999,0,9999,0
1668259425846,ECE 200,058,103643,Zheng; Yang,9999,0,9999,0
1668259426271,ECE 202,A00,103644,Kuzum; Duygu,0,0,0,0
1668259426699,ECE 212BN,A00,103646,Ng; Tse Nga,0,0,0,0
1668259427122,ECE 221,A00,111493,Staff,0,0,0,0
1668259427546,ECE 222B,A00,103647,Lomakin; Vitaliy,0,0,0,0
1668259427975,ECE 230B,A00,103648,Taur; Yuan,0,0,0,0
1668259428405,ECE 238B,A00,103649,Garay; Javier,0,0,0,0
1668259428843,ECE 240B,A00,112900,Fainman; Yeshaiahu,0,0,0,0
1668259429269,ECE 247A,A00,103650,Jokerst; Jesse Vincent,0,0,0,0
1668259429706,ECE 247B,A00,103651,Wang; Joseph,0,0,0,0
1668259430129,ECE 250,A00,103652,Siegel; Paul H.,0,0,0,0
1668259430552,ECE 251A,A00,103654,Rao; Bhaskar D.,0,0,0,0
1668259430978,ECE 257B,A00,103655,Bharadia; Dinesh,0,0,0,0
1668259431406,ECE 258A,A00,103656,Milstein; Laurence B.,0,0,0,0
1668259431829,ECE 260B,A00,103658,Kang; Mingu,0,0,0,0
1668259432252,ECE 264A,A00,103659,Galton; Ian A,0,0,0,0
1668259432675,ECE 265A,A00,103661,Gudem; Prasad S.S.,0,0,0,0
1668259433099,ECE 265D,A00,103662,Gudem; Prasad S.S.,0,0,0,0
1668259433522,ECE 268,A00,103663,Koushanfar; Farinaz,0,0,0,0
1668259433948,ECE 269,A01,103665,Pal; Piya,0,0,0,0
1668259434372,ECE 271B,A00,103666,Vasconcelos; Manuela,0,0,0,0
1668259434795,ECE 276A,A00,103667,Atanasov; Nikolay A.,0,0,0,0
1668259435225,ECE 277,A00,103668,An; Cheolhong,0,0,0,0
1668259435663,ECE 279,A00,117947,Hall; Drew A.,0,0,0,0
1668259436511,ECE 283,A00,103670,Hsueh; Tzu-Chien,0,0,0,0
1668259436937,ECE 284,A00,103671,Turakhia; Yatish Girish,0,0,0,0
1668259437367,ECE 285,A00,103672,Zheng; Yang,0,0,0,0
1668259437367,ECE 285,B00,103673,Sworder; David D.,0,0,0,0
1668259437790,ECE 287,A00,103676,Javidi; Tara,0,0,0,0
1668259438220,MATH 200B,A00,098023,Salehi Golsefidy; Alireza,12,0,15,3
1668259438643,MATH 202B,A00,098024,Rhoades; Brendon Patrick,9,0,15,6
1668259439068,MATH 203B,A00,098025,Oprea; Dragos N.,10,0,15,5
1668259439502,MATH 204B,A00,098026,Sorensen; Claus M,13,0,15,2
1668259439940,MATH 208,A00,098027,Izadi; Elham,7,0,10,3
1668259440364,MATH 209,A00,098028,Pollack; Aaron,10,0,10,0
1668259440878,MATH 211A,A00,112919,Rogalski; Daniel,9,0,10,1
1668259441305,MATH 211B,A00,112920,Seward; Brandon M.,9,0,10,1
1668259441736,MATH 218,A00,098029,Li; Bo,10,0,10,0
1668259442161,MATH 220B,A00,098030,Novak; Jonathan I,11,0,15,4
1668259442587,MATH 221A,A00,098031,Ebenfelt; Peter F,13,0,15,2
1668259443012,MATH 231B,A00,098032,Zlatos; Andrej,12,0,15,3
1668259443445,MATH 240B,A00,098033,Ni; Lei,9,0,15,6
1668259443873,MATH 243,A00,098034,Jekel; David Andrew,10,0,10,0
1668259444298,MATH 245A,A00,098035,Nie; Jiawang,0,0,15,16
1668259444723,MATH 248,A00,098036,Bejenaru; Ioan,10,0,10,0
1668259445151,MATH 250B,A00,098037,Spolaor; Luca,14,0,15,1
1668259445575,MATH 258,A00,098038,Ni; Lei,10,0,10,0
1668259445999,MATH 264B,A00,098041,Rhoades; Brendon Patrick,9,0,15,6
1668259446430,MATH 268,A00,098042,Buss; Samuel R,10,0,10,0
1668259446870,MATH 269,A00,098043,Rhoades; Brendon Patrick,10,0,10,0
1668259447295,MATH 270B,A00,098044,Li; Bo,10,0,15,5
1668259447725,MATH 272B,A00,098045,Holst; Michael J,13,0,15,2
1668259448161,MATH 273A,A00,098046,Tian; Xiaochuan,10,0,15,5
1668259448589,MATH 275,A01,098048,Tian; Xiaochuan,6,0,10,4
1668259449022,MATH 278A,A00,098049,Holst; Michael J,8,0,10,2
1668259449451,MATH 278B,A00,098050,Cloninger; Alexander,10,0,10,0
1668259449878,MATH 278C,A00,098051,Nie; Jiawang,7,0,10,3
1668259450314,MATH 280B,A00,098052,Zheng; Tianyi,9,0,15,6
1668259450738,MATH 281B,A00,098053,Bradic; Jelena,1,0,15,14
1668259451166,MATH 282B,A00,098054,Arias-Castro; Ery,0,0,15,15
1668259451589,MATH 285,A00,098055,Fitzsimmons; Patrick J,0,0,15,17
1668259452016,MATH 287B,A00,098056,Arias-Castro; Ery,2,0,15,13
1668259452442,MATH 288,A00,098057,Agarwal; Pooja,9,0,10,1
1668259452442,MATH 288,B00,098058,Zhang; Danna,8,0,10,2
1668259452442,MATH 288,C00,098059,Williams; Ruth J,10,0,10,0
1668259452864,MATH 290B,A00,098060,Roberts; Justin Deritter,13,0,15,2
1668259453289,MATH 292,A00,098061,Belmont; Eva Kinoshita,10,0,10,0
1668259453726,MATH 295,A00,098062,Suk; Andrew Hoon,48,0,50,2
1668259454155,MATH 296,A00,098063,Novak; Jonathan I,20,0,20,0
1668259454579,MATH 297,001,098064,Gamst; Anthony Collins,9997,0,9999,2
1668259954751,COGS 205,A00,101395,Chiba; Andrea,19,0,20,1
1668259955178,COGS 210B,001,101404,Greene; Deanna Jacquelyn,9998,0,9999,1
1668259955178,COGS 210B,002,101417,Xia; Haijun,9999,0,9999,0
1668259955178,COGS 210B,003,101422,Nitz; Douglas A.,9999,0,9999,0
1668259955178,COGS 210B,004,101423,Hollan; James D.,9998,0,9999,1
1668259955178,COGS 210B,005,101424,Deak; Gedeon O.,9998,0,9999,1
1668259955178,COGS 210B,006,101425,Rossano; Federico,9999,0,9999,0
1668259955601,COGS 211B,A00,101427,Coulson; Seana M,9996,0,9999,3
1668259956028,COGS 220,A00,101428,Hollan; James D.,0,0,25,25
1668259956449,COGS 229,A00,101429,Dow; Steven P,18,0,25,7
1668259956877,COGS 230,A00,101430,Klemmer; Scott R,12,0,17,5
1668259957305,COGS 234,A00,101431,Xia; Haijun,2,0,25,23
1668259957733,COGS 260,A00,101432,Kiyonaga; Anastasia,21,0,25,4
1668259957733,COGS 260,B00,101433,Kirsh; David Joel,15,0,25,10
1668259958158,CSE 202,A00,102371,Impagliazzo; Russell,0,0,0,0
1668259958581,CSE 203B,A01,102373,Cheng; Chung Kuan,0,0,0,0
1668259959005,CSE 208,A00,102374,Micciancio; Daniele,0,0,0,0
1668259959432,CSE 209A,A00,112895,Impagliazzo; Russell,0,0,15,15
1668259959856,CSE 209B,A00,108005,Bellare; Mihir,0,0,0,0
1668259960288,CSE 210,A00,113163,Coblenz; Michael J,0,0,0,0
1668259960727,CSE 219,A00,106111,Dow; Steven P,0,0,20,20
1668259961244,CSE 221,A00,102376,Voelker; Geoffrey M.,0,0,0,0
1668259961675,CSE 224,A01,102378,Porter; George M,0,0,0,0
1668259962100,CSE 229A,A00,102379,Savage; Stefan,0,0,0,0
1668259962523,CSE 229C,A00,102380,Munyaka; Imani N. S.,0,0,0,0
1668259962947,CSE 232B,A00,102382,Deutsch; Alin Bernard,0,0,0,0
1668259963378,CSE 234,A01,112904,Kumar; Arun Kumar,0,0,0,0
1668259963804,CSE 237A,A00,102383,Rosing; Tajana Simunic,0,0,0,0
1668259964230,CSE 239A,A00,102384,Deutsch; Alin Bernard,0,0,0,0
1668259964654,CSE 239B,A00,102385,Polikarpova; Nadezhda,0,0,0,0
1668259965085,CSE 240A,A00,102386,Pannuto; Patrick William,0,0,0,0
1668259965513,CSE 240B,A00,102387,Zhao; Jishen,0,0,0,0
1668259965936,CSE 241A,A00,106406,Kang; Mingu,0,0,0,0
1668259966359,CSE 249B,A00,102388,Kahng; Andrew Byun,0,0,8,8
1668259966787,CSE 251B,A01,102392,Cottrell; Garrison W,0,0,0,0
1668259966787,CSE 251B,A02,102393,Cottrell; Garrison W,0,0,0,0
1668259967208,CSE 252B,A00,102394,Ochoa; Benjamin Lawrence,0,0,0,0
1668259967641,CSE 257,A01,102396,Gao; Sicun,0,0,0,0
1668259968065,CSE 272,A00,102397,Li; Tzumao,0,0,0,0
1668259968502,CSE 274,A00,111323,Chern; Albert Ren-Haur,0,0,0,0
1668259968939,CSE 282,A00,102398,Pevzner; Pavel Arkadjevich,0,0,0,0
1668259969367,CSE 284,A00,114175,Gymrek; Melissa Ann,0,0,0,0
1668259969791,CSE 290,A00,102399,Chandraker; Manmohan Krishna,0,0,0,0
1668259969791,CSE 290,B00,102400,Vaccaro; Kristen Marie,0,0,25,25
1668259969791,CSE 290,C00,102414,Pannuto; Patrick William,0,0,25,25
1668259969791,CSE 290,D00,102427,Pevzner; Pavel Arkadjevich,0,0,0,0
1668259969791,CSE 290,E00,102429,Zhao; Jishen,0,0,0,0
1668259969791,CSE 290,F00,102436,Tullsen; Dean Michael,0,0,0,0
1668259969791,CSE 290,G00,102440,Christensen; Henrik I,0,0,20,20
1668259970220,CSE 291,A00,102443,Su; Hao,0,0,0,0
1668259970220,CSE 291,B00,102448,Polikarpova; Nadezhda,0,0,0,0
1668259970220,CSE 291,C00,102453,Vaccaro; Kristen Marie,0,0,0,0
1668259970220,CSE 291,D00,111343,Savage; Stefan,0,0,0,0
1668259970220,CSE 291,E00,116474,Claffy; Kimberly Claire,0,0,0,0
1668259970220,CSE 291,F00,116479,Pasquale; Joseph,0,0,0,0
1668259970654,CSE 293,001,119111,Bafna; Vineet,9999,0,9999,0
1668259970654,CSE 293,002,119118,Bellare; Mihir,9999,0,9999,0
1668259970654,CSE 293,003,119122,Berg-Kirkpatrick; Taylor D,9999,0,9999,0
1668259970654,CSE 293,004,119135,Christensen; Henrik I,9999,0,9999,0
1668259970654,CSE 293,005,119142,Cottrell; Garrison W,9999,0,9999,0
1668259970654,CSE 293,006,119146,Deutsch; Alin Bernard,9999,0,9999,0
1668259970654,CSE 293,007,119159,Esmaeilzadeh; Hadi,9999,0,9999,0
1668259970654,CSE 293,008,119166,Freund; Yoav,9999,0,9999,0
1668259970654,CSE 293,009,119170,Griswold; William G.,9999,0,9999,0
1668259970654,CSE 293,010,119183,Gymrek; Melissa Ann,9999,0,9999,0
1668259970654,CSE 293,011,119190,Heninger; Nadia A,9999,0,9999,0
1668259970654,CSE 293,012,119230,Impagliazzo; Russell,9999,0,9999,0
1668259970654,CSE 293,013,119232,Jhala; Ranjit,9999,0,9999,0
1668259970654,CSE 293,014,119233,Kahng; Andrew Byun,9999,0,9999,0
1668259970654,CSE 293,015,119298,Kane; Daniel Mertz,9999,0,9999,0
1668259970654,CSE 293,016,119299,Kriegman; David J,9999,0,9999,0
1668259970654,CSE 293,017,119300,Kumar; Arun Kumar,9999,0,9999,0
1668259970654,CSE 293,018,119301,Lerner; Sorin,9999,0,9999,0
1668259970654,CSE 293,019,119302,Lovett; Shachar,9999,0,9999,0
1668259970654,CSE 293,020,119303,McAuley; Julian John,9999,0,9999,0
1668259970654,CSE 293,021,119304,Micciancio; Daniele,9999,0,9999,0
1668259970654,CSE 293,022,119367,Orailoglu; Alex,9999,0,9999,0
1668259970654,CSE 293,023,119382,Paturi; Ramamohan,9999,0,9999,0
1668259970654,CSE 293,024,119404,Polikarpova; Nadezhda,9999,0,9999,0
1668259970654,CSE 293,025,119406,Politz; Joseph Gibbs,9999,0,9999,0
1668259970654,CSE 293,026,119411,Porter; George M,9999,0,9999,0
1668259970654,CSE 293,027,119414,Porter; Leonard Emerson,9999,0,9999,0
1668259970654,CSE 293,028,119416,Ramamoorthi; Ravi,9999,0,9999,0
1668259970654,CSE 293,029,119417,Sahoo; Debashis,9999,0,9999,0
1668259970654,CSE 293,030,119420,Saul; Lawrence,9999,0,9999,0
1668259970654,CSE 293,031,119421,Savage; Stefan,9999,0,9999,0
1668259970654,CSE 293,032,119425,Schulze; Jurgen P.,9999,0,9999,0
1668259970654,CSE 293,033,119426,Snoeren; Alex C.,9999,0,9999,0
1668259970654,CSE 293,034,119428,Shang; Jingbo,9999,0,9999,0
1668259970654,CSE 293,035,119430,Stefan; Deian,9999,0,9999,0
1668259970654,CSE 293,036,119431,Su; Hao,9999,0,9999,0
1668259970654,CSE 293,037,119433,Swanson; Steven James,9999,0,9999,0
1668259970654,CSE 293,038,119435,Tullsen; Dean Michael,9999,0,9999,0
1668259970654,CSE 293,039,119483,Voelker; Geoffrey M.,9999,0,9999,0
1668259970654,CSE 293,040,119537,Zhao; Jishen,9999,0,9999,0
1668259970654,CSE 293,041,119538,Zhou; Yuan-Yuan,9999,0,9999,0
1668259970654,CSE 293,042,119539,Gao; Sicun,9999,0,9999,0
1668259970654,CSE 293,043,119540,Weibel; Nadir,9999,0,9999,0
1668259970654,CSE 293,044,119541,Gupta; Rajesh K.,9999,0,9999,0
1668259970654,CSE 293,045,126410,Vaccaro; Kristen Marie,9999,0,9999,0
1668259970654,CSE 293,046,126411,Klemke; Richard,9999,0,9999,0
1668259971078,CSE 294,A00,102459,Voelker; Geoffrey M.,0,0,0,0
1668259971078,CSE 294,B00,111322,Orailoglu; Alex,0,0,0,0
1668259971516,DSE 201,A00,096914,Deutsch; Alin Bernard,30,0,30,0
1668259971948,DSE 210,A00,096915,Dasgupta; Sanjoy,30,0,30,0
1668259972382,DSE 260A,A00,096916,Altintas De Callaf; Ilkay,30,0,30,0
1668259972827,ECE 200,001,103586,Antipa; Nicholas A,9999,0,9999,0
1668259972827,ECE 200,002,103587,Atanasov; Nikolay A.,9999,0,9999,0
1668259972827,ECE 200,003,103588,Bharadia; Dinesh,9999,0,9999,0
1668259972827,ECE 200,004,103589,Cheng; Chung Kuan,9999,0,9999,0
1668259972827,ECE 200,005,103590,Cosman; Pamela C.,9999,0,9999,0
1668259972827,ECE 200,006,103591,Dayeh; Shadi Ahmad,9999,0,9999,0
1668259972827,ECE 200,007,103592,Fainman; Yeshaiahu,9999,0,9999,0
1668259972827,ECE 200,008,103593,Ford; Joseph Earl,9999,0,9999,0
1668259972827,ECE 200,009,103594,Franceschetti; Massimo,9999,0,9999,0
1668259972827,ECE 200,010,103595,Fullerton; Eric E,9999,0,9999,0
1668259972827,ECE 200,011,103596,Galton; Ian A,9999,0,9999,0
1668259972827,ECE 200,012,103597,Gilja; Vikash,9999,0,9999,0
1668259972827,ECE 200,013,103598,Hall; Drew A.,9999,0,9999,0
1668259972827,ECE 200,014,103599,Hsueh; Tzu-Chien,9999,0,9999,0
1668259972827,ECE 200,015,103600,Javidi; Tara,9999,0,9999,0
1668259972827,ECE 200,016,103601,Kahng; Andrew Byun,9999,0,9999,0
1668259972827,ECE 200,017,103602,Kim; Young-Han,9999,0,9999,0
1668259972827,ECE 200,018,103603,Koushanfar; Farinaz,9999,0,9999,0
1668259972827,ECE 200,019,103604,Kuzum; Duygu,9999,0,9999,0
1668259972827,ECE 200,020,103605,Le; Hanh-Phuc,9999,0,9999,0
1668259972827,ECE 200,021,103606,Lin; Bill,9999,0,9999,0
1668259972827,ECE 200,022,103607,Liu; Zhaowei,9998,0,9999,1
1668259972827,ECE 200,023,103608,Lo; Yu-Hwa,9999,0,9999,0
1668259972827,ECE 200,024,103609,Lomakin; Vitaliy,9999,0,9999,0
1668259972827,ECE 200,025,103610,Mercier; Patrick Philip,9999,0,9999,0
1668259972827,ECE 200,026,103611,Meyer; Florian,9999,0,9999,0
1668259972827,ECE 200,027,103612,Milstein; Laurence B.,9999,0,9999,0
1668259972827,ECE 200,028,103613,Mir Arabbaygi; Siavash,9999,0,9999,0
1668259972827,ECE 200,029,103614,Mookherjea; Shayan,9999,0,9999,0
1668259972827,ECE 200,030,103615,Morris; Karcher William,9999,0,9999,0
1668259972827,ECE 200,031,103616,Ng; Tse Nga,9999,0,9999,0
1668259972827,ECE 200,032,103617,Nguyen; Truong Quang,9999,0,9999,0
1668259972827,ECE 200,033,103618,Nomura; Kenji,9999,0,9999,0
1668259972827,ECE 200,034,103619,Orlitsky; Alon,9999,0,9999,0
1668259972827,ECE 200,035,103620,Pal; Piya,9999,0,9999,0
1668259972827,ECE 200,036,103621,Papen; George C.,9999,0,9999,0
1668259972827,ECE 200,037,103622,Radic; Stojan,9999,0,9999,0
1668259972827,ECE 200,038,103623,Rao; Bhaskar D.,9999,0,9999,0
1668259972827,ECE 200,039,103624,Rao; Ramesh R,9999,0,9999,0
1668259972827,ECE 200,040,103625,Rebeiz; Gabriel,9999,0,9999,0
1668259972827,ECE 200,041,103626,Sanford; John R,9999,0,9999,0
1668259972827,ECE 200,042,103627,Siegel; Paul H.,9999,0,9999,0
1668259972827,ECE 200,043,103628,Sievenpiper; Daniel F.,9999,0,9999,0
1668259972827,ECE 200,044,103629,Sworder; David D.,9999,0,9999,0
1668259972827,ECE 200,045,103630,Taur; Yuan,9999,0,9999,0
1668259972827,ECE 200,046,103631,Touri; Behrouz,9999,0,9999,0
1668259972827,ECE 200,047,103632,Trivedi; Mohan M.,9999,0,9999,0
1668259972827,ECE 200,048,103633,Vasconcelos; Nuno,9999,0,9999,0
1668259972827,ECE 200,049,103634,Wang; Xiaolong,9999,0,9999,0
1668259972827,ECE 200,050,103635,Xie; Pengtao,9999,0,9999,0
1668259972827,ECE 200,051,103636,Yip; Michael,9999,0,9999,0
1668259972827,ECE 200,052,103637,Zeger; Kenneth A.,999,0,999,0
1668259972827,ECE 200,053,103638,Zhang; Xinyu,9999,0,9999,0
1668259972827,ECE 200,054,103639,Turakhia; Yatish Girish,9999,0,9999,0
1668259972827,ECE 200,055,103640,Kang; Mingu,9999,0,9999,0
1668259972827,ECE 200,056,103641,Shi; Yuanyuan,9999,0,9999,0
1668259972827,ECE 200,057,103642,Wang; Edward Jay,9999,0,9999,0
1668259972827,ECE 200,058,103643,Zheng; Yang,9999,0,9999,0
1668259973251,ECE 202,A00,103644,Kuzum; Duygu,0,0,0,0
1668259973681,ECE 212BN,A00,103646,Ng; Tse Nga,0,0,0,0
1668259974109,ECE 221,A00,111493,Staff,0,0,0,0
1668259974534,ECE 222B,A00,103647,Lomakin; Vitaliy,0,0,0,0
1668259974966,ECE 230B,A00,103648,Taur; Yuan,0,0,0,0
1668259975391,ECE 238B,A00,103649,Garay; Javier,0,0,0,0
1668259975814,ECE 240B,A00,112900,Fainman; Yeshaiahu,0,0,0,0
1668259976239,ECE 247A,A00,103650,Jokerst; Jesse Vincent,0,0,0,0
1668259976666,ECE 247B,A00,103651,Wang; Joseph,0,0,0,0
1668259977089,ECE 250,A00,103652,Siegel; Paul H.,0,0,0,0
1668259977514,ECE 251A,A00,103654,Rao; Bhaskar D.,0,0,0,0
1668259977937,ECE 257B,A00,103655,Bharadia; Dinesh,0,0,0,0
1668259978359,ECE 258A,A00,103656,Milstein; Laurence B.,0,0,0,0
1668259978785,ECE 260B,A00,103658,Kang; Mingu,0,0,0,0
1668259979207,ECE 264A,A00,103659,Galton; Ian A,0,0,0,0
1668259979635,ECE 265A,A00,103661,Gudem; Prasad S.S.,0,0,0,0
1668259980057,ECE 265D,A00,103662,Gudem; Prasad S.S.,0,0,0,0
1668259980481,ECE 268,A00,103663,Koushanfar; Farinaz,0,0,0,0
1668259980902,ECE 269,A01,103665,Pal; Piya,0,0,0,0
1668259981343,ECE 271B,A00,103666,Vasconcelos; Manuela,0,0,0,0
1668259981766,ECE 276A,A00,103667,Atanasov; Nikolay A.,0,0,0,0
1668259982189,ECE 277,A00,103668,An; Cheolhong,0,0,0,0
1668259982623,ECE 279,A00,117947,Hall; Drew A.,0,0,0,0
1668259983494,ECE 283,A00,103670,Hsueh; Tzu-Chien,0,0,0,0
1668259983931,ECE 284,A00,103671,Turakhia; Yatish Girish,0,0,0,0
1668259984374,ECE 285,A00,103672,Zheng; Yang,0,0,0,0
1668259984374,ECE 285,B00,103673,Sworder; David D.,0,0,0,0
1668259984806,ECE 287,A00,103676,Javidi; Tara,0,0,0,0
1668259985231,MATH 200B,A00,098023,Salehi Golsefidy; Alireza,12,0,15,3
1668259985655,MATH 202B,A00,098024,Rhoades; Brendon Patrick,9,0,15,6
1668259986082,MATH 203B,A00,098025,Oprea; Dragos N.,10,0,15,5
1668259986504,MATH 204B,A00,098026,Sorensen; Claus M,13,0,15,2
1668259986933,MATH 208,A00,098027,Izadi; Elham,7,0,10,3
1668259987357,MATH 209,A00,098028,Pollack; Aaron,10,0,10,0
1668259987785,MATH 211A,A00,112919,Rogalski; Daniel,9,0,10,1
1668259988209,MATH 211B,A00,112920,Seward; Brandon M.,9,0,10,1
1668259988633,MATH 218,A00,098029,Li; Bo,10,0,10,0
1668259989057,MATH 220B,A00,098030,Novak; Jonathan I,11,0,15,4
1668259989480,MATH 221A,A00,098031,Ebenfelt; Peter F,13,0,15,2
1668259989903,MATH 231B,A00,098032,Zlatos; Andrej,12,0,15,3
1668259990330,MATH 240B,A00,098033,Ni; Lei,9,0,15,6
1668259990752,MATH 243,A00,098034,Jekel; David Andrew,10,0,10,0
1668259991178,MATH 245A,A00,098035,Nie; Jiawang,0,0,15,16
1668259991602,MATH 248,A00,098036,Bejenaru; Ioan,10,0,10,0
1668259992027,MATH 250B,A00,098037,Spolaor; Luca,14,0,15,1
1668259992462,MATH 258,A00,098038,Ni; Lei,10,0,10,0
1668259992893,MATH 264B,A00,098041,Rhoades; Brendon Patrick,9,0,15,6
1668259993317,MATH 268,A00,098042,Buss; Samuel R,10,0,10,0
1668259993740,MATH 269,A00,098043,Rhoades; Brendon Patrick,10,0,10,0
1668259994163,MATH 270B,A00,098044,Li; Bo,10,0,15,5
1668259994586,MATH 272B,A00,098045,Holst; Michael J,13,0,15,2
1668259995009,MATH 273A,A00,098046,Tian; Xiaochuan,10,0,15,5
1668259995432,MATH 275,A01,098048,Tian; Xiaochuan,6,0,10,4
1668259995859,MATH 278A,A00,098049,Holst; Michael J,8,0,10,2
1668259996281,MATH 278B,A00,098050,Cloninger; Alexander,10,0,10,0
1668259996707,MATH 278C,A00,098051,Nie; Jiawang,7,0,10,3
1668259997130,MATH 280B,A00,098052,Zheng; Tianyi,9,0,15,6
1668259997553,MATH 281B,A00,098053,Bradic; Jelena,1,0,15,14
1668259997977,MATH 282B,A00,098054,Arias-Castro; Ery,0,0,15,15
1668259998408,MATH 285,A00,098055,Fitzsimmons; Patrick J,0,0,15,17
1668259998832,MATH 287B,A00,098056,Arias-Castro; Ery,2,0,15,13
1668259999255,MATH 288,A00,098057,Agarwal; Pooja,9,0,10,1
1668259999255,MATH 288,B00,098058,Zhang; Danna,8,0,10,2
1668259999255,MATH 288,C00,098059,Williams; Ruth J,10,0,10,0
1668259999678,MATH 290B,A00,098060,Roberts; Justin Deritter,13,0,15,2
1668260000102,MATH 292,A00,098061,Belmont; Eva Kinoshita,10,0,10,0
1668260000525,MATH 295,A00,098062,Suk; Andrew Hoon,48,0,50,2
1668260000947,MATH 296,A00,098063,Novak; Jonathan I,20,0,20,0
1668260001375,MATH 297,001,098064,Gamst; Anthony Collins,9997,0,9999,2
1668260501422,COGS 205,A00,101395,Chiba; Andrea,19,0,20,1
1668260501844,COGS 210B,001,101404,Greene; Deanna Jacquelyn,9998,0,9999,1
1668260501844,COGS 210B,002,101417,Xia; Haijun,9999,0,9999,0
1668260501844,COGS 210B,003,101422,Nitz; Douglas A.,9999,0,9999,0
1668260501844,COGS 210B,004,101423,Hollan; James D.,9998,0,9999,1
1668260501844,COGS 210B,005,101424,Deak; Gedeon O.,9998,0,9999,1
1668260501844,COGS 210B,006,101425,Rossano; Federico,9999,0,9999,0
1668260502271,COGS 211B,A00,101427,Coulson; Seana M,9996,0,9999,3
1668260502694,COGS 220,A00,101428,Hollan; James D.,0,0,25,25
1668260503117,COGS 229,A00,101429,Dow; Steven P,18,0,25,7
1668260503543,COGS 230,A00,101430,Klemmer; Scott R,12,0,17,5
1668260503967,COGS 234,A00,101431,Xia; Haijun,2,0,25,23
1668260504391,COGS 260,A00,101432,Kiyonaga; Anastasia,21,0,25,4
1668260504391,COGS 260,B00,101433,Kirsh; David Joel,15,0,25,10
1668260504817,CSE 202,A00,102371,Impagliazzo; Russell,0,0,0,0
1668260505252,CSE 203B,A01,102373,Cheng; Chung Kuan,0,0,0,0
1668260505673,CSE 208,A00,102374,Micciancio; Daniele,0,0,0,0
1668260506110,CSE 209A,A00,112895,Impagliazzo; Russell,0,0,15,15
1668260506543,CSE 209B,A00,108005,Bellare; Mihir,0,0,0,0
1668260506969,CSE 210,A00,113163,Coblenz; Michael J,0,0,0,0
1668260507395,CSE 219,A00,106111,Dow; Steven P,0,0,20,20
1668260507858,CSE 221,A00,102376,Voelker; Geoffrey M.,0,0,0,0
1668260508294,CSE 224,A01,102378,Porter; George M,0,0,0,0
1668260508725,CSE 229A,A00,102379,Savage; Stefan,0,0,0,0
1668260509150,CSE 229C,A00,102380,Munyaka; Imani N. S.,0,0,0,0
1668260509574,CSE 232B,A00,102382,Deutsch; Alin Bernard,0,0,0,0
1668260509999,CSE 234,A01,112904,Kumar; Arun Kumar,0,0,0,0
1668260510421,CSE 237A,A00,102383,Rosing; Tajana Simunic,0,0,0,0
1668260510847,CSE 239A,A00,102384,Deutsch; Alin Bernard,0,0,0,0
1668260511273,CSE 239B,A00,102385,Polikarpova; Nadezhda,0,0,0,0
1668260511701,CSE 240A,A00,102386,Pannuto; Patrick William,0,0,0,0
1668260512126,CSE 240B,A00,102387,Zhao; Jishen,0,0,0,0
1668260512548,CSE 241A,A00,106406,Kang; Mingu,0,0,0,0
1668260512975,CSE 249B,A00,102388,Kahng; Andrew Byun,0,0,8,8
1668260513403,CSE 251B,A01,102392,Cottrell; Garrison W,0,0,0,0
1668260513403,CSE 251B,A02,102393,Cottrell; Garrison W,0,0,0,0
1668260513834,CSE 252B,A00,102394,Ochoa; Benjamin Lawrence,0,0,0,0
1668260514265,CSE 257,A01,102396,Gao; Sicun,0,0,0,0
1668260514690,CSE 272,A00,102397,Li; Tzumao,0,0,0,0
1668260515113,CSE 274,A00,111323,Chern; Albert Ren-Haur,0,0,0,0
1668260515545,CSE 282,A00,102398,Pevzner; Pavel Arkadjevich,0,0,0,0
1668260515968,CSE 284,A00,114175,Gymrek; Melissa Ann,0,0,0,0
1668260516391,CSE 290,A00,102399,Chandraker; Manmohan Krishna,0,0,0,0
1668260516391,CSE 290,B00,102400,Vaccaro; Kristen Marie,0,0,25,25
1668260516391,CSE 290,C00,102414,Pannuto; Patrick William,0,0,25,25
1668260516391,CSE 290,D00,102427,Pevzner; Pavel Arkadjevich,0,0,0,0
1668260516391,CSE 290,E00,102429,Zhao; Jishen,0,0,0,0
1668260516391,CSE 290,F00,102436,Tullsen; Dean Michael,0,0,0,0
1668260516391,CSE 290,G00,102440,Christensen; Henrik I,0,0,20,20
1668260516819,CSE 291,A00,102443,Su; Hao,0,0,0,0
1668260516819,CSE 291,B00,102448,Polikarpova; Nadezhda,0,0,0,0
1668260516819,CSE 291,C00,102453,Vaccaro; Kristen Marie,0,0,0,0
1668260516819,CSE 291,D00,111343,Savage; Stefan,0,0,0,0
1668260516819,CSE 291,E00,116474,Claffy; Kimberly Claire,0,0,0,0
1668260516819,CSE 291,F00,116479,Pasquale; Joseph,0,0,0,0
1668260517246,CSE 293,001,119111,Bafna; Vineet,9999,0,9999,0
1668260517246,CSE 293,002,119118,Bellare; Mihir,9999,0,9999,0
1668260517246,CSE 293,003,119122,Berg-Kirkpatrick; Taylor D,9999,0,9999,0
1668260517246,CSE 293,004,119135,Christensen; Henrik I,9999,0,9999,0
1668260517246,CSE 293,005,119142,Cottrell; Garrison W,9999,0,9999,0
1668260517246,CSE 293,006,119146,Deutsch; Alin Bernard,9999,0,9999,0
1668260517246,CSE 293,007,119159,Esmaeilzadeh; Hadi,9999,0,9999,0
1668260517246,CSE 293,008,119166,Freund; Yoav,9999,0,9999,0
1668260517246,CSE 293,009,119170,Griswold; William G.,9999,0,9999,0
1668260517246,CSE 293,010,119183,Gymrek; Melissa Ann,9999,0,9999,0
1668260517246,CSE 293,011,119190,Heninger; Nadia A,9999,0,9999,0
1668260517246,CSE 293,012,119230,Impagliazzo; Russell,9999,0,9999,0
1668260517246,CSE 293,013,119232,Jhala; Ranjit,9999,0,9999,0
1668260517246,CSE 293,014,119233,Kahng; Andrew Byun,9999,0,9999,0
1668260517246,CSE 293,015,119298,Kane; Daniel Mertz,9999,0,9999,0
1668260517246,CSE 293,016,119299,Kriegman; David J,9999,0,9999,0
1668260517246,CSE 293,017,119300,Kumar; Arun Kumar,9999,0,9999,0
1668260517246,CSE 293,018,119301,Lerner; Sorin,9999,0,9999,0
1668260517246,CSE 293,019,119302,Lovett; Shachar,9999,0,9999,0
1668260517246,CSE 293,020,119303,McAuley; Julian John,9999,0,9999,0
1668260517246,CSE 293,021,119304,Micciancio; Daniele,9999,0,9999,0
1668260517246,CSE 293,022,119367,Orailoglu; Alex,9999,0,9999,0
1668260517246,CSE 293,023,119382,Paturi; Ramamohan,9999,0,9999,0
1668260517246,CSE 293,024,119404,Polikarpova; Nadezhda,9999,0,9999,0
1668260517246,CSE 293,025,119406,Politz; Joseph Gibbs,9999,0,9999,0
1668260517246,CSE 293,026,119411,Porter; George M,9999,0,9999,0
1668260517246,CSE 293,027,119414,Porter; Leonard Emerson,9999,0,9999,0
1668260517246,CSE 293,028,119416,Ramamoorthi; Ravi,9999,0,9999,0
1668260517246,CSE 293,029,119417,Sahoo; Debashis,9999,0,9999,0
1668260517246,CSE 293,030,119420,Saul; Lawrence,9999,0,9999,0
1668260517246,CSE 293,031,119421,Savage; Stefan,9999,0,9999,0
1668260517246,CSE 293,032,119425,Schulze; Jurgen P.,9999,0,9999,0
1668260517246,CSE 293,033,119426,Snoeren; Alex C.,9999,0,9999,0
1668260517246,CSE 293,034,119428,Shang; Jingbo,9999,0,9999,0
1668260517246,CSE 293,035,119430,Stefan; Deian,9999,0,9999,0
1668260517246,CSE 293,036,119431,Su; Hao,9999,0,9999,0
1668260517246,CSE 293,037,119433,Swanson; Steven James,9999,0,9999,0
1668260517246,CSE 293,038,119435,Tullsen; Dean Michael,9999,0,9999,0
1668260517246,CSE 293,039,119483,Voelker; Geoffrey M.,9999,0,9999,0
1668260517246,CSE 293,040,119537,Zhao; Jishen,9999,0,9999,0
1668260517246,CSE 293,041,119538,Zhou; Yuan-Yuan,9999,0,9999,0
1668260517246,CSE 293,042,119539,Gao; Sicun,9999,0,9999,0
1668260517246,CSE 293,043,119540,Weibel; Nadir,9999,0,9999,0
1668260517246,CSE 293,044,119541,Gupta; Rajesh K.,9999,0,9999,0
1668260517246,CSE 293,045,126410,Vaccaro; Kristen Marie,9999,0,9999,0
1668260517246,CSE 293,046,126411,Klemke; Richard,9999,0,9999,0
1668260517668,CSE 294,A00,102459,Voelker; Geoffrey M.,0,0,0,0
1668260517668,CSE 294,B00,111322,Orailoglu; Alex,0,0,0,0
1668260518095,DSE 201,A00,096914,Deutsch; Alin Bernard,30,0,30,0
1668260518518,DSE 210,A00,096915,Dasgupta; Sanjoy,30,0,30,0
1668260518945,DSE 260A,A00,096916,Altintas De Callaf; Ilkay,30,0,30,0
1668260519373,ECE 200,001,103586,Antipa; Nicholas A,9999,0,9999,0
1668260519373,ECE 200,002,103587,Atanasov; Nikolay A.,9999,0,9999,0
1668260519373,ECE 200,003,103588,Bharadia; Dinesh,9999,0,9999,0
1668260519373,ECE 200,004,103589,Cheng; Chung Kuan,9999,0,9999,0
1668260519373,ECE 200,005,103590,Cosman; Pamela C.,9999,0,9999,0
1668260519373,ECE 200,006,103591,Dayeh; Shadi Ahmad,9999,0,9999,0
1668260519373,ECE 200,007,103592,Fainman; Yeshaiahu,9999,0,9999,0
1668260519373,ECE 200,008,103593,Ford; Joseph Earl,9999,0,9999,0
1668260519373,ECE 200,009,103594,Franceschetti; Massimo,9999,0,9999,0
1668260519373,ECE 200,010,103595,Fullerton; Eric E,9999,0,9999,0
1668260519373,ECE 200,011,103596,Galton; Ian A,9999,0,9999,0
1668260519373,ECE 200,012,103597,Gilja; Vikash,9999,0,9999,0
1668260519373,ECE 200,013,103598,Hall; Drew A.,9999,0,9999,0
1668260519373,ECE 200,014,103599,Hsueh; Tzu-Chien,9999,0,9999,0
1668260519373,ECE 200,015,103600,Javidi; Tara,9999,0,9999,0
1668260519373,ECE 200,016,103601,Kahng; Andrew Byun,9999,0,9999,0
1668260519373,ECE 200,017,103602,Kim; Young-Han,9999,0,9999,0
1668260519373,ECE 200,018,103603,Koushanfar; Farinaz,9999,0,9999,0
1668260519373,ECE 200,019,103604,Kuzum; Duygu,9999,0,9999,0
1668260519373,ECE 200,020,103605,Le; Hanh-Phuc,9999,0,9999,0
1668260519373,ECE 200,021,103606,Lin; Bill,9999,0,9999,0
1668260519373,ECE 200,022,103607,Liu; Zhaowei,9998,0,9999,1
1668260519373,ECE 200,023,103608,Lo; Yu-Hwa,9999,0,9999,0
1668260519373,ECE 200,024,103609,Lomakin; Vitaliy,9999,0,9999,0
1668260519373,ECE 200,025,103610,Mercier; Patrick Philip,9999,0,9999,0
1668260519373,ECE 200,026,103611,Meyer; Florian,9999,0,9999,0
1668260519373,ECE 200,027,103612,Milstein; Laurence B.,9999,0,9999,0
1668260519373,ECE 200,028,103613,Mir Arabbaygi; Siavash,9999,0,9999,0
1668260519373,ECE 200,029,103614,Mookherjea; Shayan,9999,0,9999,0
1668260519373,ECE 200,030,103615,Morris; Karcher William,9999,0,9999,0
1668260519373,ECE 200,031,103616,Ng; Tse Nga,9999,0,9999,0
1668260519373,ECE 200,032,103617,Nguyen; Truong Quang,9999,0,9999,0
1668260519373,ECE 200,033,103618,Nomura; Kenji,9999,0,9999,0
1668260519373,ECE 200,034,103619,Orlitsky; Alon,9999,0,9999,0
1668260519373,ECE 200,035,103620,Pal; Piya,9999,0,9999,0
1668260519373,ECE 200,036,103621,Papen; George C.,9999,0,9999,0
1668260519373,ECE 200,037,103622,Radic; Stojan,9999,0,9999,0
1668260519373,ECE 200,038,103623,Rao; Bhaskar D.,9999,0,9999,0
1668260519373,ECE 200,039,103624,Rao; Ramesh R,9999,0,9999,0
1668260519373,ECE 200,040,103625,Rebeiz; Gabriel,9999,0,9999,0
1668260519373,ECE 200,041,103626,Sanford; John R,9999,0,9999,0
1668260519373,ECE 200,042,103627,Siegel; Paul H.,9999,0,9999,0
1668260519373,ECE 200,043,103628,Sievenpiper; Daniel F.,9999,0,9999,0
1668260519373,ECE 200,044,103629,Sworder; David D.,9999,0,9999,0
1668260519373,ECE 200,045,103630,Taur; Yuan,9999,0,9999,0
1668260519373,ECE 200,046,103631,Touri; Behrouz,9999,0,9999,0
1668260519373,ECE 200,047,103632,Trivedi; Mohan M.,9999,0,9999,0
1668260519373,ECE 200,048,103633,Vasconcelos; Nuno,9999,0,9999,0
1668260519373,ECE 200,049,103634,Wang; Xiaolong,9999,0,9999,0
1668260519373,ECE 200,050,103635,Xie; Pengtao,9999,0,9999,0
1668260519373,ECE 200,051,103636,Yip; Michael,9999,0,9999,0
1668260519373,ECE 200,052,103637,Zeger; Kenneth A.,999,0,999,0
1668260519373,ECE 200,053,103638,Zhang; Xinyu,9999,0,9999,0
1668260519373,ECE 200,054,103639,Turakhia; Yatish Girish,9999,0,9999,0
1668260519373,ECE 200,055,103640,Kang; Mingu,9999,0,9999,0
1668260519373,ECE 200,056,103641,Shi; Yuanyuan,9999,0,9999,0
1668260519373,ECE 200,057,103642,Wang; Edward Jay,9999,0,9999,0
1668260519373,ECE 200,058,103643,Zheng; Yang,9999,0,9999,0
1668260519796,ECE 202,A00,103644,Kuzum; Duygu,0,0,0,0
1668260520234,ECE 212BN,A00,103646,Ng; Tse Nga,0,0,0,0
1668260520658,ECE 221,A00,111493,Staff,0,0,0,0
1668260521086,ECE 222B,A00,103647,Lomakin; Vitaliy,0,0,0,0
1668260521510,ECE 230B,A00,103648,Taur; Yuan,0,0,0,0
1668260521937,ECE 238B,A00,103649,Garay; Javier,0,0,0,0
1668260522362,ECE 240B,A00,112900,Fainman; Yeshaiahu,0,0,0,0
1668260522799,ECE 247A,A00,103650,Jokerst; Jesse Vincent,0,0,0,0
1668260523222,ECE 247B,A00,103651,Wang; Joseph,0,0,0,0
1668260523648,ECE 250,A00,103652,Siegel; Paul H.,0,0,0,0
1668260524078,ECE 251A,A00,103654,Rao; Bhaskar D.,0,0,0,0
1668260524584,ECE 257B,A00,103655,Bharadia; Dinesh,0,0,0,0
1668260525008,ECE 258A,A00,103656,Milstein; Laurence B.,0,0,0,0
1668260525431,ECE 260B,A00,103658,Kang; Mingu,0,0,0,0
1668260525861,ECE 264A,A00,103659,Galton; Ian A,0,0,0,0
1668260526296,ECE 265A,A00,103661,Gudem; Prasad S.S.,0,0,0,0
1668260526721,ECE 265D,A00,103662,Gudem; Prasad S.S.,0,0,0,0
1668260527144,ECE 268,A00,103663,Koushanfar; Farinaz,0,0,0,0
1668260527572,ECE 269,A01,103665,Pal; Piya,0,0,0,0
1668260527998,ECE 271B,A00,103666,Vasconcelos; Manuela,0,0,0,0
1668260528421,ECE 276A,A00,103667,Atanasov; Nikolay A.,0,0,0,0
1668260528853,ECE 277,A00,103668,An; Cheolhong,0,0,0,0
1668260529284,ECE 279,A00,117947,Hall; Drew A.,0,0,0,0
1668260530137,ECE 283,A00,103670,Hsueh; Tzu-Chien,0,0,0,0
1668260530561,ECE 284,A00,103671,Turakhia; Yatish Girish,0,0,0,0
1668260530986,ECE 285,A00,103672,Zheng; Yang,0,0,0,0
1668260530986,ECE 285,B00,103673,Sworder; David D.,0,0,0,0
1668260531421,ECE 287,A00,103676,Javidi; Tara,0,0,0,0
1668260531845,MATH 200B,A00,098023,Salehi Golsefidy; Alireza,12,0,15,3
1668260532287,MATH 202B,A00,098024,Rhoades; Brendon Patrick,9,0,15,6
1668260532715,MATH 203B,A00,098025,Oprea; Dragos N.,10,0,15,5
1668260533143,MATH 204B,A00,098026,Sorensen; Claus M,13,0,15,2
1668260533567,MATH 208,A00,098027,Izadi; Elham,7,0,10,3
1668260533998,MATH 209,A00,098028,Pollack; Aaron,10,0,10,0
1668260534428,MATH 211A,A00,112919,Rogalski; Daniel,9,0,10,1
1668260534854,MATH 211B,A00,112920,Seward; Brandon M.,9,0,10,1
1668260535281,MATH 218,A00,098029,Li; Bo,10,0,10,0
1668260535704,MATH 220B,A00,098030,Novak; Jonathan I,11,0,15,4
1668260536131,MATH 221A,A00,098031,Ebenfelt; Peter F,13,0,15,2
1668260536558,MATH 231B,A00,098032,Zlatos; Andrej,12,0,15,3
1668260536999,MATH 240B,A00,098033,Ni; Lei,9,0,15,6
1668260537423,MATH 243,A00,098034,Jekel; David Andrew,10,0,10,0
1668260537847,MATH 245A,A00,098035,Nie; Jiawang,0,0,15,16
1668260538273,MATH 248,A00,098036,Bejenaru; Ioan,10,0,10,0
1668260538703,MATH 250B,A00,098037,Spolaor; Luca,14,0,15,1
1668260539126,MATH 258,A00,098038,Ni; Lei,10,0,10,0
1668260539549,MATH 264B,A00,098041,Rhoades; Brendon Patrick,9,0,15,6
1668260539979,MATH 268,A00,098042,Buss; Samuel R,10,0,10,0
1668260540402,MATH 269,A00,098043,Rhoades; Brendon Patrick,10,0,10,0
1668260540830,MATH 270B,A00,098044,Li; Bo,10,0,15,5
1668260541270,MATH 272B,A00,098045,Holst; Michael J,13,0,15,2
1668260541695,MATH 273A,A00,098046,Tian; Xiaochuan,10,0,15,5
1668260542119,MATH 275,A01,098048,Tian; Xiaochuan,6,0,10,4
1668260542544,MATH 278A,A00,098049,Holst; Michael J,8,0,10,2
1668260542969,MATH 278B,A00,098050,Cloninger; Alexander,10,0,10,0
1668260543399,MATH 278C,A00,098051,Nie; Jiawang,7,0,10,3
1668260543823,MATH 280B,A00,098052,Zheng; Tianyi,9,0,15,6
1668260544249,MATH 281B,A00,098053,Bradic; Jelena,1,0,15,14
1668260544682,MATH 282B,A00,098054,Arias-Castro; Ery,0,0,15,15
1668260545105,MATH 285,A00,098055,Fitzsimmons; Patrick J,0,0,15,17
1668260545537,MATH 287B,A00,098056,Arias-Castro; Ery,2,0,15,13
1668260545974,MATH 288,A00,098057,Agarwal; Pooja,9,0,10,1
1668260545974,MATH 288,B00,098058,Zhang; Danna,8,0,10,2
1668260545974,MATH 288,C00,098059,Williams; Ruth J,10,0,10,0
1668260546411,MATH 290B,A00,098060,Roberts; Justin Deritter,13,0,15,2
1668260546835,MATH 292,A00,098061,Belmont; Eva Kinoshita,10,0,10,0
1668260547257,MATH 295,A00,098062,Suk; Andrew Hoon,48,0,50,2
1668260547681,MATH 296,A00,098063,Novak; Jonathan I,20,0,20,0
1668260548107,MATH 297,001,098064,Gamst; Anthony Collins,9997,0,9999,2
1668261049205,COGS 205,A00,101395,Chiba; Andrea,19,0,20,1
1668261049632,COGS 210B,001,101404,Greene; Deanna Jacquelyn,9998,0,9999,1
1668261049632,COGS 210B,002,101417,Xia; Haijun,9999,0,9999,0
1668261049632,COGS 210B,003,101422,Nitz; Douglas A.,9999,0,9999,0
1668261049632,COGS 210B,004,101423,Hollan; James D.,9998,0,9999,1
1668261049632,COGS 210B,005,101424,Deak; Gedeon O.,9998,0,9999,1
1668261049632,COGS 210B,006,101425,Rossano; Federico,9999,0,9999,0
1668261050058,COGS 211B,A00,101427,Coulson; Seana M,9996,0,9999,3
1668261050483,COGS 220,A00,101428,Hollan; James D.,0,0,25,25
1668261050906,COGS 229,A00,101429,Dow; Steven P,18,0,25,7
1668261051334,COGS 230,A00,101430,Klemmer; Scott R,12,0,17,5
1668261051755,COGS 234,A00,101431,Xia; Haijun,2,0,25,23
1668261052187,COGS 260,A00,101432,Kiyonaga; Anastasia,21,0,25,4
1668261052187,COGS 260,B00,101433,Kirsh; David Joel,15,0,25,10
1668261052616,CSE 202,A00,102371,Impagliazzo; Russell,0,0,0,0
1668261053043,CSE 203B,A01,102373,Cheng; Chung Kuan,0,0,0,0
1668261053487,CSE 208,A00,102374,Micciancio; Daniele,0,0,0,0
1668261053921,CSE 209A,A00,112895,Impagliazzo; Russell,0,0,15,15
1668261054349,CSE 209B,A00,108005,Bellare; Mihir,0,0,0,0
1668261054775,CSE 210,A00,113163,Coblenz; Michael J,0,0,0,0
1668261055203,CSE 219,A00,106111,Dow; Steven P,0,0,20,20
1668261055630,CSE 221,A00,102376,Voelker; Geoffrey M.,0,0,0,0
1668261056053,CSE 224,A01,102378,Porter; George M,0,0,0,0
1668261056478,CSE 229A,A00,102379,Savage; Stefan,0,0,0,0
1668261056901,CSE 229C,A00,102380,Munyaka; Imani N. S.,0,0,0,0
1668261057334,CSE 232B,A00,102382,Deutsch; Alin Bernard,0,0,0,0
1668261057760,CSE 234,A01,112904,Kumar; Arun Kumar,0,0,0,0
1668261058191,CSE 237A,A00,102383,Rosing; Tajana Simunic,0,0,0,0
1668261058622,CSE 239A,A00,102384,Deutsch; Alin Bernard,0,0,0,0
1668261059054,CSE 239B,A00,102385,Polikarpova; Nadezhda,0,0,0,0
1668261059482,CSE 240A,A00,102386,Pannuto; Patrick William,0,0,0,0
1668261059922,CSE 240B,A00,102387,Zhao; Jishen,0,0,0,0
1668261060356,CSE 241A,A00,106406,Kang; Mingu,0,0,0,0
1668261060781,CSE 249B,A00,102388,Kahng; Andrew Byun,0,0,8,8
1668261061208,CSE 251B,A01,102392,Cottrell; Garrison W,0,0,0,0
1668261061208,CSE 251B,A02,102393,Cottrell; Garrison W,0,0,0,0
1668261061636,CSE 252B,A00,102394,Ochoa; Benjamin Lawrence,0,0,0,0
1668261062061,CSE 257,A01,102396,Gao; Sicun,0,0,0,0
1668261062485,CSE 272,A00,102397,Li; Tzumao,0,0,0,0
1668261062914,CSE 274,A00,111323,Chern; Albert Ren-Haur,0,0,0,0
1668261063337,CSE 282,A00,102398,Pevzner; Pavel Arkadjevich,0,0,0,0
1668261063762,CSE 284,A00,114175,Gymrek; Melissa Ann,0,0,0,0
1668261064197,CSE 290,A00,102399,Chandraker; Manmohan Krishna,0,0,0,0
1668261064197,CSE 290,B00,102400,Vaccaro; Kristen Marie,0,0,25,25
1668261064197,CSE 290,C00,102414,Pannuto; Patrick William,0,0,25,25
1668261064197,CSE 290,D00,102427,Pevzner; Pavel Arkadjevich,0,0,0,0
1668261064197,CSE 290,E00,102429,Zhao; Jishen,0,0,0,0
1668261064197,CSE 290,F00,102436,Tullsen; Dean Michael,0,0,0,0
1668261064197,CSE 290,G00,102440,Christensen; Henrik I,0,0,20,20
1668261064630,CSE 291,A00,102443,Su; Hao,0,0,0,0
1668261064630,CSE 291,B00,102448,Polikarpova; Nadezhda,0,0,0,0
1668261064630,CSE 291,C00,102453,Vaccaro; Kristen Marie,0,0,0,0
1668261064630,CSE 291,D00,111343,Savage; Stefan,0,0,0,0
1668261064630,CSE 291,E00,116474,Claffy; Kimberly Claire,0,0,0,0
1668261064630,CSE 291,F00,116479,Pasquale; Joseph,0,0,0,0
1668261065069,CSE 293,001,119111,Bafna; Vineet,9999,0,9999,0
1668261065069,CSE 293,002,119118,Bellare; Mihir,9999,0,9999,0
1668261065069,CSE 293,003,119122,Berg-Kirkpatrick; Taylor D,9999,0,9999,0
1668261065069,CSE 293,004,119135,Christensen; Henrik I,9999,0,9999,0
1668261065069,CSE 293,005,119142,Cottrell; Garrison W,9999,0,9999,0
1668261065069,CSE 293,006,119146,Deutsch; Alin Bernard,9999,0,9999,0
1668261065069,CSE 293,007,119159,Esmaeilzadeh; Hadi,9999,0,9999,0
1668261065069,CSE 293,008,119166,Freund; Yoav,9999,0,9999,0
1668261065069,CSE 293,009,119170,Griswold; William G.,9999,0,9999,0
1668261065069,CSE 293,010,119183,Gymrek; Melissa Ann,9999,0,9999,0
1668261065069,CSE 293,011,119190,Heninger; Nadia A,9999,0,9999,0
1668261065069,CSE 293,012,119230,Impagliazzo; Russell,9999,0,9999,0
1668261065069,CSE 293,013,119232,Jhala; Ranjit,9999,0,9999,0
1668261065069,CSE 293,014,119233,Kahng; Andrew Byun,9999,0,9999,0
1668261065069,CSE 293,015,119298,Kane; Daniel Mertz,9999,0,9999,0
1668261065069,CSE 293,016,119299,Kriegman; David J,9999,0,9999,0
1668261065069,CSE 293,017,119300,Kumar; Arun Kumar,9999,0,9999,0
1668261065069,CSE 293,018,119301,Lerner; Sorin,9999,0,9999,0
1668261065069,CSE 293,019,119302,Lovett; Shachar,9999,0,9999,0
1668261065069,CSE 293,020,119303,McAuley; Julian John,9999,0,9999,0
1668261065069,CSE 293,021,119304,Micciancio; Daniele,9999,0,9999,0
1668261065069,CSE 293,022,119367,Orailoglu; Alex,9999,0,9999,0
1668261065069,CSE 293,023,119382,Paturi; Ramamohan,9999,0,9999,0
1668261065069,CSE 293,024,119404,Polikarpova; Nadezhda,9999,0,9999,0
1668261065069,CSE 293,025,119406,Politz; Joseph Gibbs,9999,0,9999,0
1668261065069,CSE 293,026,119411,Porter; George M,9999,0,9999,0
1668261065069,CSE 293,027,119414,Porter; Leonard Emerson,9999,0,9999,0
1668261065069,CSE 293,028,119416,Ramamoorthi; Ravi,9999,0,9999,0
1668261065069,CSE 293,029,119417,Sahoo; Debashis,9999,0,9999,0
1668261065069,CSE 293,030,119420,Saul; Lawrence,9999,0,9999,0
1668261065069,CSE 293,031,119421,Savage; Stefan,9999,0,9999,0
1668261065069,CSE 293,032,119425,Schulze; Jurgen P.,9999,0,9999,0
1668261065069,CSE 293,033,119426,Snoeren; Alex C.,9999,0,9999,0
1668261065069,CSE 293,034,119428,Shang; Jingbo,9999,0,9999,0
1668261065069,CSE 293,035,119430,Stefan; Deian,9999,0,9999,0
1668261065069,CSE 293,036,119431,Su; Hao,9999,0,9999,0
1668261065069,CSE 293,037,119433,Swanson; Steven James,9999,0,9999,0
1668261065069,CSE 293,038,119435,Tullsen; Dean Michael,9999,0,9999,0
1668261065069,CSE 293,039,119483,Voelker; Geoffrey M.,9999,0,9999,0
1668261065069,CSE 293,040,119537,Zhao; Jishen,9999,0,9999,0
1668261065069,CSE 293,041,119538,Zhou; Yuan-Yuan,9999,0,9999,0
1668261065069,CSE 293,042,119539,Gao; Sicun,9999,0,9999,0
1668261065069,CSE 293,043,119540,Weibel; Nadir,9999,0,9999,0
1668261065069,CSE 293,044,119541,Gupta; Rajesh K.,9999,0,9999,0
1668261065069,CSE 293,045,126410,Vaccaro; Kristen Marie,9999,0,9999,0
1668261065069,CSE 293,046,126411,Klemke; Richard,9999,0,9999,0
1668261065500,CSE 294,A00,102459,Voelker; Geoffrey M.,0,0,0,0
1668261065500,CSE 294,B00,111322,Orailoglu; Alex,0,0,0,0
1668261065924,DSE 201,A00,096914,Deutsch; Alin Bernard,30,0,30,0
1668261066349,DSE 210,A00,096915,Dasgupta; Sanjoy,30,0,30,0
1668261066784,DSE 260A,A00,096916,Altintas De Callaf; Ilkay,30,0,30,0
1668261067256,ECE 200,001,103586,Antipa; Nicholas A,9999,0,9999,0
1668261067256,ECE 200,002,103587,Atanasov; Nikolay A.,9999,0,9999,0
1668261067256,ECE 200,003,103588,Bharadia; Dinesh,9999,0,9999,0
1668261067256,ECE 200,004,103589,Cheng; Chung Kuan,9999,0,9999,0
1668261067256,ECE 200,005,103590,Cosman; Pamela C.,9999,0,9999,0
1668261067256,ECE 200,006,103591,Dayeh; Shadi Ahmad,9999,0,9999,0
1668261067256,ECE 200,007,103592,Fainman; Yeshaiahu,9999,0,9999,0
1668261067256,ECE 200,008,103593,Ford; Joseph Earl,9999,0,9999,0
1668261067256,ECE 200,009,103594,Franceschetti; Massimo,9999,0,9999,0
1668261067256,ECE 200,010,103595,Fullerton; Eric E,9999,0,9999,0
1668261067256,ECE 200,011,103596,Galton; Ian A,9999,0,9999,0
1668261067256,ECE 200,012,103597,Gilja; Vikash,9999,0,9999,0
1668261067256,ECE 200,013,103598,Hall; Drew A.,9999,0,9999,0
1668261067256,ECE 200,014,103599,Hsueh; Tzu-Chien,9999,0,9999,0
1668261067256,ECE 200,015,103600,Javidi; Tara,9999,0,9999,0
1668261067256,ECE 200,016,103601,Kahng; Andrew Byun,9999,0,9999,0
1668261067256,ECE 200,017,103602,Kim; Young-Han,9999,0,9999,0
1668261067256,ECE 200,018,103603,Koushanfar; Farinaz,9999,0,9999,0
1668261067256,ECE 200,019,103604,Kuzum; Duygu,9999,0,9999,0
1668261067256,ECE 200,020,103605,Le; Hanh-Phuc,9999,0,9999,0
1668261067256,ECE 200,021,103606,Lin; Bill,9999,0,9999,0
1668261067256,ECE 200,022,103607,Liu; Zhaowei,9998,0,9999,1
1668261067256,ECE 200,023,103608,Lo; Yu-Hwa,9999,0,9999,0
1668261067256,ECE 200,024,103609,Lomakin; Vitaliy,9999,0,9999,0
1668261067256,ECE 200,025,103610,Mercier; Patrick Philip,9999,0,9999,0
1668261067256,ECE 200,026,103611,Meyer; Florian,9999,0,9999,0
1668261067256,ECE 200,027,103612,Milstein; Laurence B.,9999,0,9999,0
1668261067256,ECE 200,028,103613,Mir Arabbaygi; Siavash,9999,0,9999,0
1668261067256,ECE 200,029,103614,Mookherjea; Shayan,9999,0,9999,0
1668261067256,ECE 200,030,103615,Morris; Karcher William,9999,0,9999,0
1668261067256,ECE 200,031,103616,Ng; Tse Nga,9999,0,9999,0
1668261067256,ECE 200,032,103617,Nguyen; Truong Quang,9999,0,9999,0
1668261067256,ECE 200,033,103618,Nomura; Kenji,9999,0,9999,0
1668261067256,ECE 200,034,103619,Orlitsky; Alon,9999,0,9999,0
1668261067256,ECE 200,035,103620,Pal; Piya,9999,0,9999,0
1668261067256,ECE 200,036,103621,Papen; George C.,9999,0,9999,0
1668261067256,ECE 200,037,103622,Radic; Stojan,9999,0,9999,0
1668261067256,ECE 200,038,103623,Rao; Bhaskar D.,9999,0,9999,0
1668261067256,ECE 200,039,103624,Rao; Ramesh R,9999,0,9999,0
1668261067256,ECE 200,040,103625,Rebeiz; Gabriel,9999,0,9999,0
1668261067256,ECE 200,041,103626,Sanford; John R,9999,0,9999,0
1668261067256,ECE 200,042,103627,Siegel; Paul H.,9999,0,9999,0
1668261067256,ECE 200,043,103628,Sievenpiper; Daniel F.,9999,0,9999,0
1668261067256,ECE 200,044,103629,Sworder; David D.,9999,0,9999,0
1668261067256,ECE 200,045,103630,Taur; Yuan,9999,0,9999,0
1668261067256,ECE 200,046,103631,Touri; Behrouz,9999,0,9999,0
1668261067256,ECE 200,047,103632,Trivedi; Mohan M.,9999,0,9999,0
1668261067256,ECE 200,048,103633,Vasconcelos; Nuno,9999,0,9999,0
1668261067256,ECE 200,049,103634,Wang; Xiaolong,9999,0,9999,0
1668261067256,ECE 200,050,103635,Xie; Pengtao,9999,0,9999,0
1668261067256,ECE 200,051,103636,Yip; Michael,9999,0,9999,0
1668261067256,ECE 200,052,103637,Zeger; Kenneth A.,999,0,999,0
1668261067256,ECE 200,053,103638,Zhang; Xinyu,9999,0,9999,0
1668261067256,ECE 200,054,103639,Turakhia; Yatish Girish,9999,0,9999,0
1668261067256,ECE 200,055,103640,Kang; Mingu,9999,0,9999,0
1668261067256,ECE 200,056,103641,Shi; Yuanyuan,9999,0,9999,0
1668261067256,ECE 200,057,103642,Wang; Edward Jay,9999,0,9999,0
1668261067256,ECE 200,058,103643,Zheng; Yang,9999,0,9999,0
1668261067681,ECE 202,A00,103644,Kuzum; Duygu,0,0,0,0
1668261068108,ECE 212BN,A00,103646,Ng; Tse Nga,0,0,0,0
1668261068534,ECE 221,A00,111493,Staff,0,0,0,0
1668261068959,ECE 222B,A00,103647,Lomakin; Vitaliy,0,0,0,0
1668261069391,ECE 230B,A00,103648,Taur; Yuan,0,0,0,0
1668261069825,ECE 238B,A00,103649,Garay; Javier,0,0,0,0
1668261070262,ECE 240B,A00,112900,Fainman; Yeshaiahu,0,0,0,0
1668261070690,ECE 247A,A00,103650,Jokerst; Jesse Vincent,0,0,0,0
1668261071117,ECE 247B,A00,103651,Wang; Joseph,0,0,0,0
1668261071543,ECE 250,A00,103652,Siegel; Paul H.,0,0,0,0
1668261071971,ECE 251A,A00,103654,Rao; Bhaskar D.,0,0,0,0
1668261072395,ECE 257B,A00,103655,Bharadia; Dinesh,0,0,0,0
1668261072821,ECE 258A,A00,103656,Milstein; Laurence B.,0,0,0,0
1668261073245,ECE 260B,A00,103658,Kang; Mingu,0,0,0,0
1668261073668,ECE 264A,A00,103659,Galton; Ian A,0,0,0,0
1668261074102,ECE 265A,A00,103661,Gudem; Prasad S.S.,0,0,0,0
1668261074541,ECE 265D,A00,103662,Gudem; Prasad S.S.,0,0,0,0
1668261074969,ECE 268,A00,103663,Koushanfar; Farinaz,0,0,0,0
1668261075393,ECE 269,A01,103665,Pal; Piya,0,0,0,0
1668261075816,ECE 271B,A00,103666,Vasconcelos; Manuela,0,0,0,0
1668261076239,ECE 276A,A00,103667,Atanasov; Nikolay A.,0,0,0,0
1668261076662,ECE 277,A00,103668,An; Cheolhong,0,0,0,0
1668261077087,ECE 279,A00,117947,Hall; Drew A.,0,0,0,0
1668261077949,ECE 283,A00,103670,Hsueh; Tzu-Chien,0,0,0,0
1668261078374,ECE 284,A00,103671,Turakhia; Yatish Girish,0,0,0,0
1668261078813,ECE 285,A00,103672,Zheng; Yang,0,0,0,0
1668261078813,ECE 285,B00,103673,Sworder; David D.,0,0,0,0
1668261079238,ECE 287,A00,103676,Javidi; Tara,0,0,0,0
1668261079667,MATH 200B,A00,098023,Salehi Golsefidy; Alireza,12,0,15,3
1668261080101,MATH 202B,A00,098024,Rhoades; Brendon Patrick,9,0,15,6
1668261080526,MATH 203B,A00,098025,Oprea; Dragos N.,10,0,15,5
1668261080959,MATH 204B,A00,098026,Sorensen; Claus M,13,0,15,2
1668261081390,MATH 208,A00,098027,Izadi; Elham,7,0,10,3
1668261081824,MATH 209,A00,098028,Pollack; Aaron,10,0,10,0
1668261082253,MATH 211A,A00,112919,Rogalski; Daniel,9,0,10,1
1668261082692,MATH 211B,A00,112920,Seward; Brandon M.,9,0,10,1
1668261083132,MATH 218,A00,098029,Li; Bo,10,0,10,0
1668261083569,MATH 220B,A00,098030,Novak; Jonathan I,11,0,15,4
1668261083994,MATH 221A,A00,098031,Ebenfelt; Peter F,13,0,15,2
1668261084420,MATH 231B,A00,098032,Zlatos; Andrej,12,0,15,3
1668261084844,MATH 240B,A00,098033,Ni; Lei,9,0,15,6
1668261085271,MATH 243,A00,098034,Jekel; David Andrew,10,0,10,0
1668261085700,MATH 245A,A00,098035,Nie; Jiawang,0,0,15,16
1668261086124,MATH 248,A00,098036,Bejenaru; Ioan,10,0,10,0
1668261086553,MATH 250B,A00,098037,Spolaor; Luca,14,0,15,1
1668261086977,MATH 258,A00,098038,Ni; Lei,10,0,10,0
1668261087400,MATH 264B,A00,098041,Rhoades; Brendon Patrick,9,0,15,6
1668261087821,MATH 268,A00,098042,Buss; Samuel R,10,0,10,0
1668261088249,MATH 269,A00,098043,Rhoades; Brendon Patrick,10,0,10,0
1668261088678,MATH 270B,A00,098044,Li; Bo,10,0,15,5
1668261089196,MATH 272B,A00,098045,Holst; Michael J,13,0,15,2
1668261089627,MATH 273A,A00,098046,Tian; Xiaochuan,10,0,15,5
1668261090051,MATH 275,A01,098048,Tian; Xiaochuan,6,0,10,4
1668261090491,MATH 278A,A00,098049,Holst; Michael J,8,0,10,2
1668261090915,MATH 278B,A00,098050,Cloninger; Alexander,10,0,10,0
1668261091340,MATH 278C,A00,098051,Nie; Jiawang,7,0,10,3
1668261091762,MATH 280B,A00,098052,Zheng; Tianyi,9,0,15,6
1668261092186,MATH 281B,A00,098053,Bradic; Jelena,1,0,15,14
1668261092611,MATH 282B,A00,098054,Arias-Castro; Ery,0,0,15,15
1668261093048,MATH 285,A00,098055,Fitzsimmons; Patrick J,0,0,15,17
1668261093480,MATH 287B,A00,098056,Arias-Castro; Ery,2,0,15,13
1668261093906,MATH 288,A00,098057,Agarwal; Pooja,9,0,10,1
1668261093906,MATH 288,B00,098058,Zhang; Danna,8,0,10,2
1668261093906,MATH 288,C00,098059,Williams; Ruth J,10,0,10,0
1668261094331,MATH 290B,A00,098060,Roberts; Justin Deritter,13,0,15,2
1668261094760,MATH 292,A00,098061,Belmont; Eva Kinoshita,10,0,10,0
1668261095185,MATH 295,A00,098062,Suk; Andrew Hoon,48,0,50,2
1668261095626,MATH 296,A00,098063,Novak; Jonathan I,20,0,20,0
1668261096053,MATH 297,001,098064,Gamst; Anthony Collins,9997,0,9999,2
1668261599680,COGS 205,A00,101395,Chiba; Andrea,19,0,20,1
1668261600114,COGS 210B,001,101404,Greene; Deanna Jacquelyn,9998,0,9999,1
1668261600114,COGS 210B,002,101417,Xia; Haijun,9999,0,9999,0
1668261600114,COGS 210B,003,101422,Nitz; Douglas A.,9999,0,9999,0
1668261600114,COGS 210B,004,101423,Hollan; James D.,9998,0,9999,1
1668261600114,COGS 210B,005,101424,Deak; Gedeon O.,9998,0,9999,1
1668261600114,COGS 210B,006,101425,Rossano; Federico,9999,0,9999,0
1668261600545,COGS 211B,A00,101427,Coulson; Seana M,9996,0,9999,3
1668261600969,COGS 220,A00,101428,Hollan; James D.,0,0,25,25
1668261601396,COGS 229,A00,101429,Dow; Steven P,18,0,25,7
1668261601821,COGS 230,A00,101430,Klemmer; Scott R,12,0,17,5
1668261602252,COGS 234,A00,101431,Xia; Haijun,2,0,25,23
1668261602680,COGS 260,A00,101432,Kiyonaga; Anastasia,21,0,25,4
1668261602680,COGS 260,B00,101433,Kirsh; David Joel,15,0,25,10
1668261603114,CSE 202,A00,102371,Impagliazzo; Russell,0,0,0,0
1668261603548,CSE 203B,A01,102373,Cheng; Chung Kuan,0,0,0,0
1668261603978,CSE 208,A00,102374,Micciancio; Daniele,0,0,0,0
1668261604416,CSE 209A,A00,112895,Impagliazzo; Russell,0,0,15,15
1668261604852,CSE 209B,A00,108005,Bellare; Mihir,0,0,0,0
1668261605280,CSE 210,A00,113163,Coblenz; Michael J,0,0,0,0
1668261605708,CSE 219,A00,106111,Dow; Steven P,0,0,20,20
1668261606231,CSE 221,A00,102376,Voelker; Geoffrey M.,0,0,0,0
1668261606675,CSE 224,A01,102378,Porter; George M,0,0,0,0
1668261607099,CSE 229A,A00,102379,Savage; Stefan,0,0,0,0
1668261607547,CSE 229C,A00,102380,Munyaka; Imani N. S.,0,0,0,0
1668261607970,CSE 232B,A00,102382,Deutsch; Alin Bernard,0,0,0,0
1668261608398,CSE 234,A01,112904,Kumar; Arun Kumar,0,0,0,0
1668261608835,CSE 237A,A00,102383,Rosing; Tajana Simunic,0,0,0,0
1668261609275,CSE 239A,A00,102384,Deutsch; Alin Bernard,0,0,0,0
1668261609701,CSE 239B,A00,102385,Polikarpova; Nadezhda,0,0,0,0
1668261610129,CSE 240A,A00,102386,Pannuto; Patrick William,0,0,0,0
1668261610559,CSE 240B,A00,102387,Zhao; Jishen,0,0,0,0
1668261610987,CSE 241A,A00,106406,Kang; Mingu,0,0,0,0
1668261611418,CSE 249B,A00,102388,Kahng; Andrew Byun,0,0,8,8
1668261611861,CSE 251B,A01,102392,Cottrell; Garrison W,0,0,0,0
1668261611861,CSE 251B,A02,102393,Cottrell; Garrison W,0,0,0,0
1668261612290,CSE 252B,A00,102394,Ochoa; Benjamin Lawrence,0,0,0,0
1668261612721,CSE 257,A01,102396,Gao; Sicun,0,0,0,0
1668261613228,CSE 272,A00,102397,Li; Tzumao,0,0,0,0
1668261613656,CSE 274,A00,111323,Chern; Albert Ren-Haur,0,0,0,0
1668261614087,CSE 282,A00,102398,Pevzner; Pavel Arkadjevich,0,0,0,0
1668261614522,CSE 284,A00,114175,Gymrek; Melissa Ann,0,0,0,0
1668261614954,CSE 290,A00,102399,Chandraker; Manmohan Krishna,0,0,0,0
1668261614954,CSE 290,B00,102400,Vaccaro; Kristen Marie,0,0,25,25
1668261614954,CSE 290,C00,102414,Pannuto; Patrick William,0,0,25,25
1668261614954,CSE 290,D00,102427,Pevzner; Pavel Arkadjevich,0,0,0,0
1668261614954,CSE 290,E00,102429,Zhao; Jishen,0,0,0,0
1668261614954,CSE 290,F00,102436,Tullsen; Dean Michael,0,0,0,0
1668261614954,CSE 290,G00,102440,Christensen; Henrik I,0,0,20,20
1668261615405,CSE 291,A00,102443,Su; Hao,0,0,0,0
1668261615405,CSE 291,B00,102448,Polikarpova; Nadezhda,0,0,0,0
1668261615405,CSE 291,C00,102453,Vaccaro; Kristen Marie,0,0,0,0
1668261615405,CSE 291,D00,111343,Savage; Stefan,0,0,0,0
1668261615405,CSE 291,E00,116474,Claffy; Kimberly Claire,0,0,0,0
1668261615405,CSE 291,F00,116479,Pasquale; Joseph,0,0,0,0
1668261615848,CSE 293,001,119111,Bafna; Vineet,9999,0,9999,0
1668261615848,CSE 293,002,119118,Bellare; Mihir,9999,0,9999,0
1668261615848,CSE 293,003,119122,Berg-Kirkpatrick; Taylor D,9999,0,9999,0
1668261615848,CSE 293,004,119135,Christensen; Henrik I,9999,0,9999,0
1668261615848,CSE 293,005,119142,Cottrell; Garrison W,9999,0,9999,0
1668261615848,CSE 293,006,119146,Deutsch; Alin Bernard,9999,0,9999,0
1668261615848,CSE 293,007,119159,Esmaeilzadeh; Hadi,9999,0,9999,0
1668261615848,CSE 293,008,119166,Freund; Yoav,9999,0,9999,0
1668261615848,CSE 293,009,119170,Griswold; William G.,9999,0,9999,0
1668261615848,CSE 293,010,119183,Gymrek; Melissa Ann,9999,0,9999,0
1668261615848,CSE 293,011,119190,Heninger; Nadia A,9999,0,9999,0
1668261615848,CSE 293,012,119230,Impagliazzo; Russell,9999,0,9999,0
1668261615848,CSE 293,013,119232,Jhala; Ranjit,9999,0,9999,0
1668261615848,CSE 293,014,119233,Kahng; Andrew Byun,9999,0,9999,0
1668261615848,CSE 293,015,119298,Kane; Daniel Mertz,9999,0,9999,0
1668261615848,CSE 293,016,119299,Kriegman; David J,9999,0,9999,0
1668261615848,CSE 293,017,119300,Kumar; Arun Kumar,9999,0,9999,0
1668261615848,CSE 293,018,119301,Lerner; Sorin,9999,0,9999,0
1668261615848,CSE 293,019,119302,Lovett; Shachar,9999,0,9999,0
1668261615848,CSE 293,020,119303,McAuley; Julian John,9999,0,9999,0
1668261615848,CSE 293,021,119304,Micciancio; Daniele,9999,0,9999,0
1668261615848,CSE 293,022,119367,Orailoglu; Alex,9999,0,9999,0
1668261615848,CSE 293,023,119382,Paturi; Ramamohan,9999,0,9999,0
1668261615848,CSE 293,024,119404,Polikarpova; Nadezhda,9999,0,9999,0
1668261615848,CSE 293,025,119406,Politz; Joseph Gibbs,9999,0,9999,0
1668261615848,CSE 293,026,119411,Porter; George M,9999,0,9999,0
1668261615848,CSE 293,027,119414,Porter; Leonard Emerson,9999,0,9999,0
1668261615848,CSE 293,028,119416,Ramamoorthi; Ravi,9999,0,9999,0
1668261615848,CSE 293,029,119417,Sahoo; Debashis,9999,0,9999,0
1668261615848,CSE 293,030,119420,Saul; Lawrence,9999,0,9999,0
1668261615848,CSE 293,031,119421,Savage; Stefan,9999,0,9999,0
1668261615848,CSE 293,032,119425,Schulze; Jurgen P.,9999,0,9999,0
1668261615848,CSE 293,033,119426,Snoeren; Alex C.,9999,0,9999,0
1668261615848,CSE 293,034,119428,Shang; Jingbo,9999,0,9999,0
1668261615848,CSE 293,035,119430,Stefan; Deian,9999,0,9999,0
1668261615848,CSE 293,036,119431,Su; Hao,9999,0,9999,0
1668261615848,CSE 293,037,119433,Swanson; Steven James,9999,0,9999,0
1668261615848,CSE 293,038,119435,Tullsen; Dean Michael,9999,0,9999,0
1668261615848,CSE 293,039,119483,Voelker; Geoffrey M.,9999,0,9999,0
1668261615848,CSE 293,040,119537,Zhao; Jishen,9999,0,9999,0
1668261615848,CSE 293,041,119538,Zhou; Yuan-Yuan,9999,0,9999,0
1668261615848,CSE 293,042,119539,Gao; Sicun,9999,0,9999,0
1668261615848,CSE 293,043,119540,Weibel; Nadir,9999,0,9999,0
1668261615848,CSE 293,044,119541,Gupta; Rajesh K.,9999,0,9999,0
1668261615848,CSE 293,045,126410,Vaccaro; Kristen Marie,9999,0,9999,0
1668261615848,CSE 293,046,126411,Klemke; Richard,9999,0,9999,0
1668261616277,CSE 294,A00,102459,Voelker; Geoffrey M.,0,0,0,0
1668261616277,CSE 294,B00,111322,Orailoglu; Alex,0,0,0,0
1668261616704,DSE 201,A00,096914,Deutsch; Alin Bernard,30,0,30,0
1668261617142,DSE 210,A00,096915,Dasgupta; Sanjoy,30,0,30,0
1668261617583,DSE 260A,A00,096916,Altintas De Callaf; Ilkay,30,0,30,0
1668261618044,ECE 200,001,103586,Antipa; Nicholas A,9999,0,9999,0
1668261618044,ECE 200,002,103587,Atanasov; Nikolay A.,9999,0,9999,0
1668261618044,ECE 200,003,103588,Bharadia; Dinesh,9999,0,9999,0
1668261618044,ECE 200,004,103589,Cheng; Chung Kuan,9999,0,9999,0
1668261618044,ECE 200,005,103590,Cosman; Pamela C.,9999,0,9999,0
1668261618044,ECE 200,006,103591,Dayeh; Shadi Ahmad,9999,0,9999,0
1668261618044,ECE 200,007,103592,Fainman; Yeshaiahu,9999,0,9999,0
1668261618044,ECE 200,008,103593,Ford; Joseph Earl,9999,0,9999,0
1668261618044,ECE 200,009,103594,Franceschetti; Massimo,9999,0,9999,0
1668261618044,ECE 200,010,103595,Fullerton; Eric E,9999,0,9999,0
1668261618044,ECE 200,011,103596,Galton; Ian A,9999,0,9999,0
1668261618044,ECE 200,012,103597,Gilja; Vikash,9999,0,9999,0
1668261618044,ECE 200,013,103598,Hall; Drew A.,9999,0,9999,0
1668261618044,ECE 200,014,103599,Hsueh; Tzu-Chien,9999,0,9999,0
1668261618044,ECE 200,015,103600,Javidi; Tara,9999,0,9999,0
1668261618044,ECE 200,016,103601,Kahng; Andrew Byun,9999,0,9999,0
1668261618044,ECE 200,017,103602,Kim; Young-Han,9999,0,9999,0
1668261618044,ECE 200,018,103603,Koushanfar; Farinaz,9999,0,9999,0
1668261618044,ECE 200,019,103604,Kuzum; Duygu,9999,0,9999,0
1668261618044,ECE 200,020,103605,Le; Hanh-Phuc,9999,0,9999,0
1668261618044,ECE 200,021,103606,Lin; Bill,9999,0,9999,0
1668261618044,ECE 200,022,103607,Liu; Zhaowei,9998,0,9999,1
1668261618044,ECE 200,023,103608,Lo; Yu-Hwa,9999,0,9999,0
1668261618044,ECE 200,024,103609,Lomakin; Vitaliy,9999,0,9999,0
1668261618044,ECE 200,025,103610,Mercier; Patrick Philip,9999,0,9999,0
1668261618044,ECE 200,026,103611,Meyer; Florian,9999,0,9999,0
1668261618044,ECE 200,027,103612,Milstein; Laurence B.,9999,0,9999,0
1668261618044,ECE 200,028,103613,Mir Arabbaygi; Siavash,9999,0,9999,0
1668261618044,ECE 200,029,103614,Mookherjea; Shayan,9999,0,9999,0
1668261618044,ECE 200,030,103615,Morris; Karcher William,9999,0,9999,0
1668261618044,ECE 200,031,103616,Ng; Tse Nga,9999,0,9999,0
1668261618044,ECE 200,032,103617,Nguyen; Truong Quang,9999,0,9999,0
1668261618044,ECE 200,033,103618,Nomura; Kenji,9999,0,9999,0
1668261618044,ECE 200,034,103619,Orlitsky; Alon,9999,0,9999,0
1668261618044,ECE 200,035,103620,Pal; Piya,9999,0,9999,0
1668261618044,ECE 200,036,103621,Papen; George C.,9999,0,9999,0
1668261618044,ECE 200,037,103622,Radic; Stojan,9999,0,9999,0
1668261618044,ECE 200,038,103623,Rao; Bhaskar D.,9999,0,9999,0
1668261618044,ECE 200,039,103624,Rao; Ramesh R,9999,0,9999,0
1668261618044,ECE 200,040,103625,Rebeiz; Gabriel,9999,0,9999,0
1668261618044,ECE 200,041,103626,Sanford; John R,9999,0,9999,0
1668261618044,ECE 200,042,103627,Siegel; Paul H.,9999,0,9999,0
1668261618044,ECE 200,043,103628,Sievenpiper; Daniel F.,9999,0,9999,0
1668261618044,ECE 200,044,103629,Sworder; David D.,9999,0,9999,0
1668261618044,ECE 200,045,103630,Taur; Yuan,9999,0,9999,0
1668261618044,ECE 200,046,103631,Touri; Behrouz,9999,0,9999,0
1668261618044,ECE 200,047,103632,Trivedi; Mohan M.,9999,0,9999,0
1668261618044,ECE 200,048,103633,Vasconcelos; Nuno,9999,0,9999,0
1668261618044,ECE 200,049,103634,Wang; Xiaolong,9999,0,9999,0
1668261618044,ECE 200,050,103635,Xie; Pengtao,9999,0,9999,0
1668261618044,ECE 200,051,103636,Yip; Michael,9999,0,9999,0
1668261618044,ECE 200,052,103637,Zeger; Kenneth A.,999,0,999,0
1668261618044,ECE 200,053,103638,Zhang; Xinyu,9999,0,9999,0
1668261618044,ECE 200,054,103639,Turakhia; Yatish Girish,9999,0,9999,0
1668261618044,ECE 200,055,103640,Kang; Mingu,9999,0,9999,0
1668261618044,ECE 200,056,103641,Shi; Yuanyuan,9999,0,9999,0
1668261618044,ECE 200,057,103642,Wang; Edward Jay,9999,0,9999,0
1668261618044,ECE 200,058,103643,Zheng; Yang,9999,0,9999,0
1668261618471,ECE 202,A00,103644,Kuzum; Duygu,0,0,0,0
1668261618896,ECE 212BN,A00,103646,Ng; Tse Nga,0,0,0,0
1668261619321,ECE 221,A00,111493,Staff,0,0,0,0
1668261619745,ECE 222B,A00,103647,Lomakin; Vitaliy,0,0,0,0
1668261620170,ECE 230B,A00,103648,Taur; Yuan,0,0,0,0
1668261620596,ECE 238B,A00,103649,Garay; Javier,0,0,0,0
1668261621021,ECE 240B,A00,112900,Fainman; Yeshaiahu,0,0,0,0
1668261621450,ECE 247A,A00,103650,Jokerst; Jesse Vincent,0,0,0,0
1668261621877,ECE 247B,A00,103651,Wang; Joseph,0,0,0,0
1668261622310,ECE 250,A00,103652,Siegel; Paul H.,0,0,0,0
1668261622734,ECE 251A,A00,103654,Rao; Bhaskar D.,0,0,0,0
1668261623164,ECE 257B,A00,103655,Bharadia; Dinesh,0,0,0,0
1668261623594,ECE 258A,A00,103656,Milstein; Laurence B.,0,0,0,0
1668261624029,ECE 260B,A00,103658,Kang; Mingu,0,0,0,0
1668261624468,ECE 264A,A00,103659,Galton; Ian A,0,0,0,0
1668261624898,ECE 265A,A00,103661,Gudem; Prasad S.S.,0,0,0,0
1668261625335,ECE 265D,A00,103662,Gudem; Prasad S.S.,0,0,0,0
1668261625773,ECE 268,A00,103663,Koushanfar; Farinaz,0,0,0,0
1668261626209,ECE 269,A01,103665,Pal; Piya,0,0,0,0
1668261626634,ECE 271B,A00,103666,Vasconcelos; Manuela,0,0,0,0
1668261627059,ECE 276A,A00,103667,Atanasov; Nikolay A.,0,0,0,0
1668261627493,ECE 277,A00,103668,An; Cheolhong,0,0,0,0
1668261627919,ECE 279,A00,117947,Hall; Drew A.,0,0,0,0
1668261628772,ECE 283,A00,103670,Hsueh; Tzu-Chien,0,0,0,0
1668261629198,ECE 284,A00,103671,Turakhia; Yatish Girish,0,0,0,0
1668261629629,ECE 285,A00,103672,Zheng; Yang,0,0,0,0
1668261629629,ECE 285,B00,103673,Sworder; David D.,0,0,0,0
1668261630054,ECE 287,A00,103676,Javidi; Tara,0,0,0,0
1668261630479,MATH 200B,A00,098023,Salehi Golsefidy; Alireza,12,0,15,3
1668261630903,MATH 202B,A00,098024,Rhoades; Brendon Patrick,9,0,15,6
1668261631342,MATH 203B,A00,098025,Oprea; Dragos N.,10,0,15,5
1668261631770,MATH 204B,A00,098026,Sorensen; Claus M,13,0,15,2
1668261632198,MATH 208,A00,098027,Izadi; Elham,7,0,10,3
1668261632625,MATH 209,A00,098028,Pollack; Aaron,10,0,10,0
1668261633051,MATH 211A,A00,112919,Rogalski; Daniel,9,0,10,1
1668261633478,MATH 211B,A00,112920,Seward; Brandon M.,9,0,10,1
1668261633905,MATH 218,A00,098029,Li; Bo,10,0,10,0
1668261634336,MATH 220B,A00,098030,Novak; Jonathan I,11,0,15,4
1668261634765,MATH 221A,A00,098031,Ebenfelt; Peter F,13,0,15,2
1668261635197,MATH 231B,A00,098032,Zlatos; Andrej,12,0,15,3
1668261635622,MATH 240B,A00,098033,Ni; Lei,9,0,15,6
1668261636049,MATH 243,A00,098034,Jekel; David Andrew,10,0,10,0
1668261636488,MATH 245A,A00,098035,Nie; Jiawang,0,0,15,16
1668261636929,MATH 248,A00,098036,Bejenaru; Ioan,10,0,10,0
1668261637354,MATH 250B,A00,098037,Spolaor; Luca,14,0,15,1
1668261637780,MATH 258,A00,098038,Ni; Lei,10,0,10,0
1668261638205,MATH 264B,A00,098041,Rhoades; Brendon Patrick,9,0,15,6
1668261638634,MATH 268,A00,098042,Buss; Samuel R,10,0,10,0
1668261639058,MATH 269,A00,098043,Rhoades; Brendon Patrick,10,0,10,0
1668261639483,MATH 270B,A00,098044,Li; Bo,10,0,15,5
1668261639907,MATH 272B,A00,098045,Holst; Michael J,13,0,15,2
1668261640335,MATH 273A,A00,098046,Tian; Xiaochuan,10,0,15,5
1668261640762,MATH 275,A01,098048,Tian; Xiaochuan,6,0,10,4
1668261641185,MATH 278A,A00,098049,Holst; Michael J,8,0,10,2
1668261641616,MATH 278B,A00,098050,Cloninger; Alexander,10,0,10,0
1668261642041,MATH 278C,A00,098051,Nie; Jiawang,7,0,10,3
1668261642465,MATH 280B,A00,098052,Zheng; Tianyi,9,0,15,6
1668261642891,MATH 281B,A00,098053,Bradic; Jelena,1,0,15,14
1668261643316,MATH 282B,A00,098054,Arias-Castro; Ery,0,0,15,15
1668261643748,MATH 285,A00,098055,Fitzsimmons; Patrick J,0,0,15,17
1668261644175,MATH 287B,A00,098056,Arias-Castro; Ery,2,0,15,13
1668261644602,MATH 288,A00,098057,Agarwal; Pooja,9,0,10,1
1668261644602,MATH 288,B00,098058,Zhang; Danna,8,0,10,2
1668261644602,MATH 288,C00,098059,Williams; Ruth J,10,0,10,0
1668261645029,MATH 290B,A00,098060,Roberts; Justin Deritter,13,0,15,2
1668261645455,MATH 292,A00,098061,Belmont; Eva Kinoshita,10,0,10,0
1668261645881,MATH 295,A00,098062,Suk; Andrew Hoon,48,0,50,2
1668261646304,MATH 296,A00,098063,Novak; Jonathan I,20,0,20,0
1668261646729,MATH 297,001,098064,Gamst; Anthony Collins,9997,0,9999,2
1668262150577,COGS 205,A00,101395,Chiba; Andrea,19,0,20,1
1668262151008,COGS 210B,001,101404,Greene; Deanna Jacquelyn,9998,0,9999,1
1668262151008,COGS 210B,002,101417,Xia; Haijun,9999,0,9999,0
1668262151008,COGS 210B,003,101422,Nitz; Douglas A.,9999,0,9999,0
1668262151008,COGS 210B,004,101423,Hollan; James D.,9998,0,9999,1
1668262151008,COGS 210B,005,101424,Deak; Gedeon O.,9998,0,9999,1
1668262151008,COGS 210B,006,101425,Rossano; Federico,9999,0,9999,0
1668262151432,COGS 211B,A00,101427,Coulson; Seana M,9996,0,9999,3
1668262151857,COGS 220,A00,101428,Hollan; James D.,0,0,25,25
1668262152280,COGS 229,A00,101429,Dow; Steven P,18,0,25,7
1668262152719,COGS 230,A00,101430,Klemmer; Scott R,12,0,17,5
1668262153148,COGS 234,A00,101431,Xia; Haijun,2,0,25,23
1668262153587,COGS 260,A00,101432,Kiyonaga; Anastasia,21,0,25,4
1668262153587,COGS 260,B00,101433,Kirsh; David Joel,15,0,25,10
1668262154035,CSE 202,A00,102371,Impagliazzo; Russell,0,0,0,0
1668262154466,CSE 203B,A01,102373,Cheng; Chung Kuan,0,0,0,0
1668262154899,CSE 208,A00,102374,Micciancio; Daniele,0,0,0,0
1668262155323,CSE 209A,A00,112895,Impagliazzo; Russell,0,0,15,15
1668262155746,CSE 209B,A00,108005,Bellare; Mihir,0,0,0,0
1668262156171,CSE 210,A00,113163,Coblenz; Michael J,0,0,0,0
1668262156599,CSE 219,A00,106111,Dow; Steven P,0,0,20,20
1668262157027,CSE 221,A00,102376,Voelker; Geoffrey M.,0,0,0,0
1668262157451,CSE 224,A01,102378,Porter; George M,0,0,0,0
1668262157874,CSE 229A,A00,102379,Savage; Stefan,0,0,0,0
1668262158300,CSE 229C,A00,102380,Munyaka; Imani N. S.,0,0,0,0
1668262158726,CSE 232B,A00,102382,Deutsch; Alin Bernard,0,0,0,0
1668262159149,CSE 234,A01,112904,Kumar; Arun Kumar,0,0,0,0
1668262159592,CSE 237A,A00,102383,Rosing; Tajana Simunic,0,0,0,0
1668262160028,CSE 239A,A00,102384,Deutsch; Alin Bernard,0,0,0,0
1668262160461,CSE 239B,A00,102385,Polikarpova; Nadezhda,0,0,0,0
1668262160915,CSE 240A,A00,102386,Pannuto; Patrick William,0,0,0,0
1668262161339,CSE 240B,A00,102387,Zhao; Jishen,0,0,0,0
1668262161776,CSE 241A,A00,106406,Kang; Mingu,0,0,0,0
1668262162215,CSE 249B,A00,102388,Kahng; Andrew Byun,0,0,8,8
1668262162643,CSE 251B,A01,102392,Cottrell; Garrison W,0,0,0,0
1668262162643,CSE 251B,A02,102393,Cottrell; Garrison W,0,0,0,0
1668262163076,CSE 252B,A00,102394,Ochoa; Benjamin Lawrence,0,0,0,0
1668262163505,CSE 257,A01,102396,Gao; Sicun,0,0,0,0
1668262163939,CSE 272,A00,102397,Li; Tzumao,0,0,0,0
1668262164364,CSE 274,A00,111323,Chern; Albert Ren-Haur,0,0,0,0
1668262164793,CSE 282,A00,102398,Pevzner; Pavel Arkadjevich,0,0,0,0
1668262165229,CSE 284,A00,114175,Gymrek; Melissa Ann,0,0,0,0
1668262165656,CSE 290,A00,102399,Chandraker; Manmohan Krishna,0,0,0,0
1668262165656,CSE 290,B00,102400,Vaccaro; Kristen Marie,0,0,25,25
1668262165656,CSE 290,C00,102414,Pannuto; Patrick William,0,0,25,25
1668262165656,CSE 290,D00,102427,Pevzner; Pavel Arkadjevich,0,0,0,0
1668262165656,CSE 290,E00,102429,Zhao; Jishen,0,0,0,0
1668262165656,CSE 290,F00,102436,Tullsen; Dean Michael,0,0,0,0
1668262165656,CSE 290,G00,102440,Christensen; Henrik I,0,0,20,20
1668262166092,CSE 291,A00,102443,Su; Hao,0,0,0,0
1668262166092,CSE 291,B00,102448,Polikarpova; Nadezhda,0,0,0,0
1668262166092,CSE 291,C00,102453,Vaccaro; Kristen Marie,0,0,0,0
1668262166092,CSE 291,D00,111343,Savage; Stefan,0,0,0,0
1668262166092,CSE 291,E00,116474,Claffy; Kimberly Claire,0,0,0,0
1668262166092,CSE 291,F00,116479,Pasquale; Joseph,0,0,0,0
1668262166553,CSE 293,001,119111,Bafna; Vineet,9999,0,9999,0
1668262166553,CSE 293,002,119118,Bellare; Mihir,9999,0,9999,0
1668262166553,CSE 293,003,119122,Berg-Kirkpatrick; Taylor D,9999,0,9999,0
1668262166553,CSE 293,004,119135,Christensen; Henrik I,9999,0,9999,0
1668262166553,CSE 293,005,119142,Cottrell; Garrison W,9999,0,9999,0
1668262166553,CSE 293,006,119146,Deutsch; Alin Bernard,9999,0,9999,0
1668262166553,CSE 293,007,119159,Esmaeilzadeh; Hadi,9999,0,9999,0
1668262166553,CSE 293,008,119166,Freund; Yoav,9999,0,9999,0
1668262166553,CSE 293,009,119170,Griswold; William G.,9999,0,9999,0
1668262166553,CSE 293,010,119183,Gymrek; Melissa Ann,9999,0,9999,0
1668262166553,CSE 293,011,119190,Heninger; Nadia A,9999,0,9999,0
1668262166553,CSE 293,012,119230,Impagliazzo; Russell,9999,0,9999,0
1668262166553,CSE 293,013,119232,Jhala; Ranjit,9999,0,9999,0
1668262166553,CSE 293,014,119233,Kahng; Andrew Byun,9999,0,9999,0
1668262166553,CSE 293,015,119298,Kane; Daniel Mertz,9999,0,9999,0
1668262166553,CSE 293,016,119299,Kriegman; David J,9999,0,9999,0
1668262166553,CSE 293,017,119300,Kumar; Arun Kumar,9999,0,9999,0
1668262166553,CSE 293,018,119301,Lerner; Sorin,9999,0,9999,0
1668262166553,CSE 293,019,119302,Lovett; Shachar,9999,0,9999,0
1668262166553,CSE 293,020,119303,McAuley; Julian John,9999,0,9999,0
1668262166553,CSE 293,021,119304,Micciancio; Daniele,9999,0,9999,0
1668262166553,CSE 293,022,119367,Orailoglu; Alex,9999,0,9999,0
1668262166553,CSE 293,023,119382,Paturi; Ramamohan,9999,0,9999,0
1668262166553,CSE 293,024,119404,Polikarpova; Nadezhda,9999,0,9999,0
1668262166553,CSE 293,025,119406,Politz; Joseph Gibbs,9999,0,9999,0
1668262166553,CSE 293,026,119411,Porter; George M,9999,0,9999,0
1668262166553,CSE 293,027,119414,Porter; Leonard Emerson,9999,0,9999,0
1668262166553,CSE 293,028,119416,Ramamoorthi; Ravi,9999,0,9999,0
1668262166553,CSE 293,029,119417,Sahoo; Debashis,9999,0,9999,0
1668262166553,CSE 293,030,119420,Saul; Lawrence,9999,0,9999,0
1668262166553,CSE 293,031,119421,Savage; Stefan,9999,0,9999,0
1668262166553,CSE 293,032,119425,Schulze; Jurgen P.,9999,0,9999,0
1668262166553,CSE 293,033,119426,Snoeren; Alex C.,9999,0,9999,0
1668262166553,CSE 293,034,119428,Shang; Jingbo,9999,0,9999,0
1668262166553,CSE 293,035,119430,Stefan; Deian,9999,0,9999,0
1668262166553,CSE 293,036,119431,Su; Hao,9999,0,9999,0
1668262166553,CSE 293,037,119433,Swanson; Steven James,9999,0,9999,0
1668262166553,CSE 293,038,119435,Tullsen; Dean Michael,9999,0,9999,0
1668262166553,CSE 293,039,119483,Voelker; Geoffrey M.,9999,0,9999,0
1668262166553,CSE 293,040,119537,Zhao; Jishen,9999,0,9999,0
1668262166553,CSE 293,041,119538,Zhou; Yuan-Yuan,9999,0,9999,0
1668262166553,CSE 293,042,119539,Gao; Sicun,9999,0,9999,0
1668262166553,CSE 293,043,119540,Weibel; Nadir,9999,0,9999,0
1668262166553,CSE 293,044,119541,Gupta; Rajesh K.,9999,0,9999,0
1668262166553,CSE 293,045,126410,Vaccaro; Kristen Marie,9999,0,9999,0
1668262166553,CSE 293,046,126411,Klemke; Richard,9999,0,9999,0
1668262166981,CSE 294,A00,102459,Voelker; Geoffrey M.,0,0,0,0
1668262166981,CSE 294,B00,111322,Orailoglu; Alex,0,0,0,0
1668262167407,DSE 201,A00,096914,Deutsch; Alin Bernard,30,0,30,0
1668262167830,DSE 210,A00,096915,Dasgupta; Sanjoy,30,0,30,0
1668262168261,DSE 260A,A00,096916,Altintas De Callaf; Ilkay,30,0,30,0
1668262168719,ECE 200,001,103586,Antipa; Nicholas A,9999,0,9999,0
1668262168719,ECE 200,002,103587,Atanasov; Nikolay A.,9999,0,9999,0
1668262168719,ECE 200,003,103588,Bharadia; Dinesh,9999,0,9999,0
1668262168719,ECE 200,004,103589,Cheng; Chung Kuan,9999,0,9999,0
1668262168719,ECE 200,005,103590,Cosman; Pamela C.,9999,0,9999,0
1668262168719,ECE 200,006,103591,Dayeh; Shadi Ahmad,9999,0,9999,0
1668262168719,ECE 200,007,103592,Fainman; Yeshaiahu,9999,0,9999,0
1668262168719,ECE 200,008,103593,Ford; Joseph Earl,9999,0,9999,0
1668262168719,ECE 200,009,103594,Franceschetti; Massimo,9999,0,9999,0
1668262168719,ECE 200,010,103595,Fullerton; Eric E,9999,0,9999,0
1668262168719,ECE 200,011,103596,Galton; Ian A,9999,0,9999,0
1668262168719,ECE 200,012,103597,Gilja; Vikash,9999,0,9999,0
1668262168719,ECE 200,013,103598,Hall; Drew A.,9999,0,9999,0
1668262168719,ECE 200,014,103599,Hsueh; Tzu-Chien,9999,0,9999,0
1668262168719,ECE 200,015,103600,Javidi; Tara,9999,0,9999,0
1668262168719,ECE 200,016,103601,Kahng; Andrew Byun,9999,0,9999,0
1668262168719,ECE 200,017,103602,Kim; Young-Han,9999,0,9999,0
1668262168719,ECE 200,018,103603,Koushanfar; Farinaz,9999,0,9999,0
1668262168719,ECE 200,019,103604,Kuzum; Duygu,9999,0,9999,0
1668262168719,ECE 200,020,103605,Le; Hanh-Phuc,9999,0,9999,0
1668262168719,ECE 200,021,103606,Lin; Bill,9999,0,9999,0
1668262168719,ECE 200,022,103607,Liu; Zhaowei,9998,0,9999,1
1668262168719,ECE 200,023,103608,Lo; Yu-Hwa,9999,0,9999,0
1668262168719,ECE 200,024,103609,Lomakin; Vitaliy,9999,0,9999,0
1668262168719,ECE 200,025,103610,Mercier; Patrick Philip,9999,0,9999,0
1668262168719,ECE 200,026,103611,Meyer; Florian,9999,0,9999,0
1668262168719,ECE 200,027,103612,Milstein; Laurence B.,9999,0,9999,0
1668262168719,ECE 200,028,103613,Mir Arabbaygi; Siavash,9999,0,9999,0
1668262168719,ECE 200,029,103614,Mookherjea; Shayan,9999,0,9999,0
1668262168719,ECE 200,030,103615,Morris; Karcher William,9999,0,9999,0
1668262168719,ECE 200,031,103616,Ng; Tse Nga,9999,0,9999,0
1668262168719,ECE 200,032,103617,Nguyen; Truong Quang,9999,0,9999,0
1668262168719,ECE 200,033,103618,Nomura; Kenji,9999,0,9999,0
1668262168719,ECE 200,034,103619,Orlitsky; Alon,9999,0,9999,0
1668262168719,ECE 200,035,103620,Pal; Piya,9999,0,9999,0
1668262168719,ECE 200,036,103621,Papen; George C.,9999,0,9999,0
1668262168719,ECE 200,037,103622,Radic; Stojan,9999,0,9999,0
1668262168719,ECE 200,038,103623,Rao; Bhaskar D.,9999,0,9999,0
1668262168719,ECE 200,039,103624,Rao; Ramesh R,9999,0,9999,0
1668262168719,ECE 200,040,103625,Rebeiz; Gabriel,9999,0,9999,0
1668262168719,ECE 200,041,103626,Sanford; John R,9999,0,9999,0
1668262168719,ECE 200,042,103627,Siegel; Paul H.,9999,0,9999,0
1668262168719,ECE 200,043,103628,Sievenpiper; Daniel F.,9999,0,9999,0
1668262168719,ECE 200,044,103629,Sworder; David D.,9999,0,9999,0
1668262168719,ECE 200,045,103630,Taur; Yuan,9999,0,9999,0
1668262168719,ECE 200,046,103631,Touri; Behrouz,9999,0,9999,0
1668262168719,ECE 200,047,103632,Trivedi; Mohan M.,9999,0,9999,0
1668262168719,ECE 200,048,103633,Vasconcelos; Nuno,9999,0,9999,0
1668262168719,ECE 200,049,103634,Wang; Xiaolong,9999,0,9999,0
1668262168719,ECE 200,050,103635,Xie; Pengtao,9999,0,9999,0
1668262168719,ECE 200,051,103636,Yip; Michael,9999,0,9999,0
1668262168719,ECE 200,052,103637,Zeger; Kenneth A.,999,0,999,0
1668262168719,ECE 200,053,103638,Zhang; Xinyu,9999,0,9999,0
1668262168719,ECE 200,054,103639,Turakhia; Yatish Girish,9999,0,9999,0
1668262168719,ECE 200,055,103640,Kang; Mingu,9999,0,9999,0
1668262168719,ECE 200,056,103641,Shi; Yuanyuan,9999,0,9999,0
1668262168719,ECE 200,057,103642,Wang; Edward Jay,9999,0,9999,0
1668262168719,ECE 200,058,103643,Zheng; Yang,9999,0,9999,0
1668262169154,ECE 202,A00,103644,Kuzum; Duygu,0,0,0,0
1668262169587,ECE 212BN,A00,103646,Ng; Tse Nga,0,0,0,0
1668262170014,ECE 221,A00,111493,Staff,0,0,0,0
1668262170449,ECE 222B,A00,103647,Lomakin; Vitaliy,0,0,0,0
1668262170875,ECE 230B,A00,103648,Taur; Yuan,0,0,0,0
1668262171302,ECE 238B,A00,103649,Garay; Javier,0,0,0,0
1668262171729,ECE 240B,A00,112900,Fainman; Yeshaiahu,0,0,0,0
1668262172156,ECE 247A,A00,103650,Jokerst; Jesse Vincent,0,0,0,0
1668262172586,ECE 247B,A00,103651,Wang; Joseph,0,0,0,0
1668262173016,ECE 250,A00,103652,Siegel; Paul H.,0,0,0,0
1668262173441,ECE 251A,A00,103654,Rao; Bhaskar D.,0,0,0,0
1668262173868,ECE 257B,A00,103655,Bharadia; Dinesh,0,0,0,0
1668262174295,ECE 258A,A00,103656,Milstein; Laurence B.,0,0,0,0
1668262174720,ECE 260B,A00,103658,Kang; Mingu,0,0,0,0
1668262175152,ECE 264A,A00,103659,Galton; Ian A,0,0,0,0
1668262175580,ECE 265A,A00,103661,Gudem; Prasad S.S.,0,0,0,0
1668262176007,ECE 265D,A00,103662,Gudem; Prasad S.S.,0,0,0,0
1668262176431,ECE 268,A00,103663,Koushanfar; Farinaz,0,0,0,0
1668262176869,ECE 269,A01,103665,Pal; Piya,0,0,0,0
1668262177294,ECE 271B,A00,103666,Vasconcelos; Manuela,0,0,0,0
1668262177720,ECE 276A,A00,103667,Atanasov; Nikolay A.,0,0,0,0
1668262178148,ECE 277,A00,103668,An; Cheolhong,0,0,0,0
1668262178575,ECE 279,A00,117947,Hall; Drew A.,0,0,0,0
1668262179427,ECE 283,A00,103670,Hsueh; Tzu-Chien,0,0,0,0
1668262179879,ECE 284,A00,103671,Turakhia; Yatish Girish,0,0,0,0
1668262180303,ECE 285,A00,103672,Zheng; Yang,0,0,0,0
1668262180303,ECE 285,B00,103673,Sworder; David D.,0,0,0,0
1668262180815,ECE 287,A00,103676,Javidi; Tara,0,0,0,0
1668262181245,MATH 200B,A00,098023,Salehi Golsefidy; Alireza,12,0,15,3
1668262181681,MATH 202B,A00,098024,Rhoades; Brendon Patrick,9,0,15,6
1668262182105,MATH 203B,A00,098025,Oprea; Dragos N.,10,0,15,5
1668262182535,MATH 204B,A00,098026,Sorensen; Claus M,13,0,15,2
1668262182962,MATH 208,A00,098027,Izadi; Elham,7,0,10,3
1668262183385,MATH 209,A00,098028,Pollack; Aaron,10,0,10,0
1668262183819,MATH 211A,A00,112919,Rogalski; Daniel,9,0,10,1
1668262184251,MATH 211B,A00,112920,Seward; Brandon M.,9,0,10,1
1668262184680,MATH 218,A00,098029,Li; Bo,10,0,10,0
1668262185115,MATH 220B,A00,098030,Novak; Jonathan I,11,0,15,4
1668262185549,MATH 221A,A00,098031,Ebenfelt; Peter F,13,0,15,2
1668262185986,MATH 231B,A00,098032,Zlatos; Andrej,12,0,15,3
1668262186430,MATH 240B,A00,098033,Ni; Lei,9,0,15,6
1668262186863,MATH 243,A00,098034,Jekel; David Andrew,10,0,10,0
1668262187288,MATH 245A,A00,098035,Nie; Jiawang,0,0,15,16
1668262187716,MATH 248,A00,098036,Bejenaru; Ioan,10,0,10,0
1668262188141,MATH 250B,A00,098037,Spolaor; Luca,14,0,15,1
1668262188565,MATH 258,A00,098038,Ni; Lei,10,0,10,0
1668262189001,MATH 264B,A00,098041,Rhoades; Brendon Patrick,9,0,15,6
1668262189425,MATH 268,A00,098042,Buss; Samuel R,10,0,10,0
1668262189851,MATH 269,A00,098043,Rhoades; Brendon Patrick,10,0,10,0
1668262190279,MATH 270B,A00,098044,Li; Bo,10,0,15,5
1668262190704,MATH 272B,A00,098045,Holst; Michael J,13,0,15,2
1668262191128,MATH 273A,A00,098046,Tian; Xiaochuan,10,0,15,5
1668262191561,MATH 275,A01,098048,Tian; Xiaochuan,6,0,10,4
1668262191986,MATH 278A,A00,098049,Holst; Michael J,8,0,10,2
1668262192410,MATH 278B,A00,098050,Cloninger; Alexander,10,0,10,0
1668262192847,MATH 278C,A00,098051,Nie; Jiawang,7,0,10,3
1668262193280,MATH 280B,A00,098052,Zheng; Tianyi,9,0,15,6
1668262193707,MATH 281B,A00,098053,Bradic; Jelena,1,0,15,14
1668262194141,MATH 282B,A00,098054,Arias-Castro; Ery,0,0,15,15
1668262194576,MATH 285,A00,098055,Fitzsimmons; Patrick J,0,0,15,17
1668262195012,MATH 287B,A00,098056,Arias-Castro; Ery,2,0,15,13
1668262195451,MATH 288,A00,098057,Agarwal; Pooja,9,0,10,1
1668262195451,MATH 288,B00,098058,Zhang; Danna,8,0,10,2
1668262195451,MATH 288,C00,098059,Williams; Ruth J,10,0,10,0
1668262195886,MATH 290B,A00,098060,Roberts; Justin Deritter,13,0,15,2
1668262196322,MATH 292,A00,098061,Belmont; Eva Kinoshita,10,0,10,0
1668262196749,MATH 295,A00,098062,Suk; Andrew Hoon,48,0,50,2
1668262197172,MATH 296,A00,098063,Novak; Jonathan I,20,0,20,0
1668262197609,MATH 297,001,098064,Gamst; Anthony Collins,9997,0,9999,2
1668262700752,COGS 205,A00,101395,Chiba; Andrea,19,0,20,1
1668262701190,COGS 210B,001,101404,Greene; Deanna Jacquelyn,9998,0,9999,1
1668262701190,COGS 210B,002,101417,Xia; Haijun,9999,0,9999,0
1668262701190,COGS 210B,003,101422,Nitz; Douglas A.,9999,0,9999,0
1668262701190,COGS 210B,004,101423,Hollan; James D.,9998,0,9999,1
1668262701190,COGS 210B,005,101424,Deak; Gedeon O.,9998,0,9999,1
1668262701190,COGS 210B,006,101425,Rossano; Federico,9999,0,9999,0
1668262701626,COGS 211B,A00,101427,Coulson; Seana M,9996,0,9999,3
1668262702050,COGS 220,A00,101428,Hollan; James D.,0,0,25,25
1668262702477,COGS 229,A00,101429,Dow; Steven P,18,0,25,7
1668262702912,COGS 230,A00,101430,Klemmer; Scott R,12,0,17,5
1668262703339,COGS 234,A00,101431,Xia; Haijun,2,0,25,23
1668262703764,COGS 260,A00,101432,Kiyonaga; Anastasia,21,0,25,4
1668262703764,COGS 260,B00,101433,Kirsh; David Joel,15,0,25,10
1668262704281,CSE 202,A00,102371,Impagliazzo; Russell,0,0,0,0
1668262704713,CSE 203B,A01,102373,Cheng; Chung Kuan,0,0,0,0
1668262705140,CSE 208,A00,102374,Micciancio; Daniele,0,0,0,0
1668262705574,CSE 209A,A00,112895,Impagliazzo; Russell,0,0,15,15
1668262706004,CSE 209B,A00,108005,Bellare; Mihir,0,0,0,0
1668262706431,CSE 210,A00,113163,Coblenz; Michael J,0,0,0,0
1668262706871,CSE 219,A00,106111,Dow; Steven P,0,0,20,20
1668262707303,CSE 221,A00,102376,Voelker; Geoffrey M.,0,0,0,0
1668262707727,CSE 224,A01,102378,Porter; George M,0,0,0,0
1668262708154,CSE 229A,A00,102379,Savage; Stefan,0,0,0,0
1668262708584,CSE 229C,A00,102380,Munyaka; Imani N. S.,0,0,0,0
1668262709013,CSE 232B,A00,102382,Deutsch; Alin Bernard,0,0,0,0
1668262709441,CSE 234,A01,112904,Kumar; Arun Kumar,0,0,0,0
1668262709866,CSE 237A,A00,102383,Rosing; Tajana Simunic,0,0,0,0
1668262710299,CSE 239A,A00,102384,Deutsch; Alin Bernard,0,0,0,0
1668262710723,CSE 239B,A00,102385,Polikarpova; Nadezhda,0,0,0,0
1668262711149,CSE 240A,A00,102386,Pannuto; Patrick William,0,0,0,0
1668262711583,CSE 240B,A00,102387,Zhao; Jishen,0,0,0,0
1668262712013,CSE 241A,A00,106406,Kang; Mingu,0,0,0,0
1668262712437,CSE 249B,A00,102388,Kahng; Andrew Byun,0,0,8,8
1668262712872,CSE 251B,A01,102392,Cottrell; Garrison W,0,0,0,0
1668262712872,CSE 251B,A02,102393,Cottrell; Garrison W,0,0,0,0
1668262713301,CSE 252B,A00,102394,Ochoa; Benjamin Lawrence,0,0,0,0
1668262713724,CSE 257,A01,102396,Gao; Sicun,0,0,0,0
1668262714159,CSE 272,A00,102397,Li; Tzumao,0,0,0,0
1668262714590,CSE 274,A00,111323,Chern; Albert Ren-Haur,0,0,0,0
1668262715035,CSE 282,A00,102398,Pevzner; Pavel Arkadjevich,0,0,0,0
1668262715463,CSE 284,A00,114175,Gymrek; Melissa Ann,0,0,0,0
1668262715901,CSE 290,A00,102399,Chandraker; Manmohan Krishna,0,0,0,0
1668262715901,CSE 290,B00,102400,Vaccaro; Kristen Marie,0,0,25,25
1668262715901,CSE 290,C00,102414,Pannuto; Patrick William,0,0,25,25
1668262715901,CSE 290,D00,102427,Pevzner; Pavel Arkadjevich,0,0,0,0
1668262715901,CSE 290,E00,102429,Zhao; Jishen,0,0,0,0
1668262715901,CSE 290,F00,102436,Tullsen; Dean Michael,0,0,0,0
1668262715901,CSE 290,G00,102440,Christensen; Henrik I,0,0,20,20
1668262716328,CSE 291,A00,102443,Su; Hao,0,0,0,0
1668262716328,CSE 291,B00,102448,Polikarpova; Nadezhda,0,0,0,0
1668262716328,CSE 291,C00,102453,Vaccaro; Kristen Marie,0,0,0,0
1668262716328,CSE 291,D00,111343,Savage; Stefan,0,0,0,0
1668262716328,CSE 291,E00,116474,Claffy; Kimberly Claire,0,0,0,0
1668262716328,CSE 291,F00,116479,Pasquale; Joseph,0,0,0,0
1668262716768,CSE 293,001,119111,Bafna; Vineet,9999,0,9999,0
1668262716768,CSE 293,002,119118,Bellare; Mihir,9999,0,9999,0
1668262716768,CSE 293,003,119122,Berg-Kirkpatrick; Taylor D,9999,0,9999,0
1668262716768,CSE 293,004,119135,Christensen; Henrik I,9999,0,9999,0
1668262716768,CSE 293,005,119142,Cottrell; Garrison W,9999,0,9999,0
1668262716768,CSE 293,006,119146,Deutsch; Alin Bernard,9999,0,9999,0
1668262716768,CSE 293,007,119159,Esmaeilzadeh; Hadi,9999,0,9999,0
1668262716768,CSE 293,008,119166,Freund; Yoav,9999,0,9999,0
1668262716768,CSE 293,009,119170,Griswold; William G.,9999,0,9999,0
1668262716768,CSE 293,010,119183,Gymrek; Melissa Ann,9999,0,9999,0
1668262716768,CSE 293,011,119190,Heninger; Nadia A,9999,0,9999,0
1668262716768,CSE 293,012,119230,Impagliazzo; Russell,9999,0,9999,0
1668262716768,CSE 293,013,119232,Jhala; Ranjit,9999,0,9999,0
1668262716768,CSE 293,014,119233,Kahng; Andrew Byun,9999,0,9999,0
1668262716768,CSE 293,015,119298,Kane; Daniel Mertz,9999,0,9999,0
1668262716768,CSE 293,016,119299,Kriegman; David J,9999,0,9999,0
1668262716768,CSE 293,017,119300,Kumar; Arun Kumar,9999,0,9999,0
1668262716768,CSE 293,018,119301,Lerner; Sorin,9999,0,9999,0
1668262716768,CSE 293,019,119302,Lovett; Shachar,9999,0,9999,0
1668262716768,CSE 293,020,119303,McAuley; Julian John,9999,0,9999,0
1668262716768,CSE 293,021,119304,Micciancio; Daniele,9999,0,9999,0
1668262716768,CSE 293,022,119367,Orailoglu; Alex,9999,0,9999,0
1668262716768,CSE 293,023,119382,Paturi; Ramamohan,9999,0,9999,0
1668262716768,CSE 293,024,119404,Polikarpova; Nadezhda,9999,0,9999,0
1668262716768,CSE 293,025,119406,Politz; Joseph Gibbs,9999,0,9999,0
1668262716768,CSE 293,026,119411,Porter; George M,9999,0,9999,0
1668262716768,CSE 293,027,119414,Porter; Leonard Emerson,9999,0,9999,0
1668262716768,CSE 293,028,119416,Ramamoorthi; Ravi,9999,0,9999,0
1668262716768,CSE 293,029,119417,Sahoo; Debashis,9999,0,9999,0
1668262716768,CSE 293,030,119420,Saul; Lawrence,9999,0,9999,0
1668262716768,CSE 293,031,119421,Savage; Stefan,9999,0,9999,0
1668262716768,CSE 293,032,119425,Schulze; Jurgen P.,9999,0,9999,0
1668262716768,CSE 293,033,119426,Snoeren; Alex C.,9999,0,9999,0
1668262716768,CSE 293,034,119428,Shang; Jingbo,9999,0,9999,0
1668262716768,CSE 293,035,119430,Stefan; Deian,9999,0,9999,0
1668262716768,CSE 293,036,119431,Su; Hao,9999,0,9999,0
1668262716768,CSE 293,037,119433,Swanson; Steven James,9999,0,9999,0
1668262716768,CSE 293,038,119435,Tullsen; Dean Michael,9999,0,9999,0
1668262716768,CSE 293,039,119483,Voelker; Geoffrey M.,9999,0,9999,0
1668262716768,CSE 293,040,119537,Zhao; Jishen,9999,0,9999,0
1668262716768,CSE 293,041,119538,Zhou; Yuan-Yuan,9999,0,9999,0
1668262716768,CSE 293,042,119539,Gao; Sicun,9999,0,9999,0
1668262716768,CSE 293,043,119540,Weibel; Nadir,9999,0,9999,0
1668262716768,CSE 293,044,119541,Gupta; Rajesh K.,9999,0,9999,0
1668262716768,CSE 293,045,126410,Vaccaro; Kristen Marie,9999,0,9999,0
1668262716768,CSE 293,046,126411,Klemke; Richard,9999,0,9999,0
1668262717190,CSE 294,A00,102459,Voelker; Geoffrey M.,0,0,0,0
1668262717190,CSE 294,B00,111322,Orailoglu; Alex,0,0,0,0
1668262717620,DSE 201,A00,096914,Deutsch; Alin Bernard,30,0,30,0
1668262718044,DSE 210,A00,096915,Dasgupta; Sanjoy,30,0,30,0
1668262718467,DSE 260A,A00,096916,Altintas De Callaf; Ilkay,30,0,30,0
1668262718936,ECE 200,001,103586,Antipa; Nicholas A,9999,0,9999,0
1668262718936,ECE 200,002,103587,Atanasov; Nikolay A.,9999,0,9999,0
1668262718936,ECE 200,003,103588,Bharadia; Dinesh,9999,0,9999,0
1668262718936,ECE 200,004,103589,Cheng; Chung Kuan,9999,0,9999,0
1668262718936,ECE 200,005,103590,Cosman; Pamela C.,9999,0,9999,0
1668262718936,ECE 200,006,103591,Dayeh; Shadi Ahmad,9999,0,9999,0
1668262718936,ECE 200,007,103592,Fainman; Yeshaiahu,9999,0,9999,0
1668262718936,ECE 200,008,103593,Ford; Joseph Earl,9999,0,9999,0
1668262718936,ECE 200,009,103594,Franceschetti; Massimo,9999,0,9999,0
1668262718936,ECE 200,010,103595,Fullerton; Eric E,9999,0,9999,0
1668262718936,ECE 200,011,103596,Galton; Ian A,9999,0,9999,0
1668262718936,ECE 200,012,103597,Gilja; Vikash,9999,0,9999,0
1668262718936,ECE 200,013,103598,Hall; Drew A.,9999,0,9999,0
1668262718936,ECE 200,014,103599,Hsueh; Tzu-Chien,9999,0,9999,0
1668262718936,ECE 200,015,103600,Javidi; Tara,9999,0,9999,0
1668262718936,ECE 200,016,103601,Kahng; Andrew Byun,9999,0,9999,0
1668262718936,ECE 200,017,103602,Kim; Young-Han,9999,0,9999,0
1668262718936,ECE 200,018,103603,Koushanfar; Farinaz,9999,0,9999,0
1668262718936,ECE 200,019,103604,Kuzum; Duygu,9999,0,9999,0
1668262718936,ECE 200,020,103605,Le; Hanh-Phuc,9999,0,9999,0
1668262718936,ECE 200,021,103606,Lin; Bill,9999,0,9999,0
1668262718936,ECE 200,022,103607,Liu; Zhaowei,9998,0,9999,1
1668262718936,ECE 200,023,103608,Lo; Yu-Hwa,9999,0,9999,0
1668262718936,ECE 200,024,103609,Lomakin; Vitaliy,9999,0,9999,0
1668262718936,ECE 200,025,103610,Mercier; Patrick Philip,9999,0,9999,0
1668262718936,ECE 200,026,103611,Meyer; Florian,9999,0,9999,0
1668262718936,ECE 200,027,103612,Milstein; Laurence B.,9999,0,9999,0
1668262718936,ECE 200,028,103613,Mir Arabbaygi; Siavash,9999,0,9999,0
1668262718936,ECE 200,029,103614,Mookherjea; Shayan,9999,0,9999,0
1668262718936,ECE 200,030,103615,Morris; Karcher William,9999,0,9999,0
1668262718936,ECE 200,031,103616,Ng; Tse Nga,9999,0,9999,0
1668262718936,ECE 200,032,103617,Nguyen; Truong Quang,9999,0,9999,0
1668262718936,ECE 200,033,103618,Nomura; Kenji,9999,0,9999,0
1668262718936,ECE 200,034,103619,Orlitsky; Alon,9999,0,9999,0
1668262718936,ECE 200,035,103620,Pal; Piya,9999,0,9999,0
1668262718936,ECE 200,036,103621,Papen; George C.,9999,0,9999,0
1668262718936,ECE 200,037,103622,Radic; Stojan,9999,0,9999,0
1668262718936,ECE 200,038,103623,Rao; Bhaskar D.,9999,0,9999,0
1668262718936,ECE 200,039,103624,Rao; Ramesh R,9999,0,9999,0
1668262718936,ECE 200,040,103625,Rebeiz; Gabriel,9999,0,9999,0
1668262718936,ECE 200,041,103626,Sanford; John R,9999,0,9999,0
1668262718936,ECE 200,042,103627,Siegel; Paul H.,9999,0,9999,0
1668262718936,ECE 200,043,103628,Sievenpiper; Daniel F.,9999,0,9999,0
1668262718936,ECE 200,044,103629,Sworder; David D.,9999,0,9999,0
1668262718936,ECE 200,045,103630,Taur; Yuan,9999,0,9999,0
1668262718936,ECE 200,046,103631,Touri; Behrouz,9999,0,9999,0
1668262718936,ECE 200,047,103632,Trivedi; Mohan M.,9999,0,9999,0
1668262718936,ECE 200,048,103633,Vasconcelos; Nuno,9999,0,9999,0
1668262718936,ECE 200,049,103634,Wang; Xiaolong,9999,0,9999,0
1668262718936,ECE 200,050,103635,Xie; Pengtao,9999,0,9999,0
1668262718936,ECE 200,051,103636,Yip; Michael,9999,0,9999,0
1668262718936,ECE 200,052,103637,Zeger; Kenneth A.,999,0,999,0
1668262718936,ECE 200,053,103638,Zhang; Xinyu,9999,0,9999,0
1668262718936,ECE 200,054,103639,Turakhia; Yatish Girish,9999,0,9999,0
1668262718936,ECE 200,055,103640,Kang; Mingu,9999,0,9999,0
1668262718936,ECE 200,056,103641,Shi; Yuanyuan,9999,0,9999,0
1668262718936,ECE 200,057,103642,Wang; Edward Jay,9999,0,9999,0
1668262718936,ECE 200,058,103643,Zheng; Yang,9999,0,9999,0
1668262719366,ECE 202,A00,103644,Kuzum; Duygu,0,0,0,0
1668262719802,ECE 212BN,A00,103646,Ng; Tse Nga,0,0,0,0
1668262720229,ECE 221,A00,111493,Staff,0,0,0,0
1668262720659,ECE 222B,A00,103647,Lomakin; Vitaliy,0,0,0,0
1668262721106,ECE 230B,A00,103648,Taur; Yuan,0,0,0,0
1668262721538,ECE 238B,A00,103649,Garay; Javier,0,0,0,0
1668262721962,ECE 240B,A00,112900,Fainman; Yeshaiahu,0,0,0,0
1668262722399,ECE 247A,A00,103650,Jokerst; Jesse Vincent,0,0,0,0
1668262722833,ECE 247B,A00,103651,Wang; Joseph,0,0,0,0
1668262723262,ECE 250,A00,103652,Siegel; Paul H.,0,0,0,0
1668262723698,ECE 251A,A00,103654,Rao; Bhaskar D.,0,0,0,0
1668262724132,ECE 257B,A00,103655,Bharadia; Dinesh,0,0,0,0
1668262724555,ECE 258A,A00,103656,Milstein; Laurence B.,0,0,0,0
1668262724983,ECE 260B,A00,103658,Kang; Mingu,0,0,0,0
1668262725407,ECE 264A,A00,103659,Galton; Ian A,0,0,0,0
1668262725832,ECE 265A,A00,103661,Gudem; Prasad S.S.,0,0,0,0
1668262726259,ECE 265D,A00,103662,Gudem; Prasad S.S.,0,0,0,0
1668262726694,ECE 268,A00,103663,Koushanfar; Farinaz,0,0,0,0
1668262727119,ECE 269,A01,103665,Pal; Piya,0,0,0,0
1668262727547,ECE 271B,A00,103666,Vasconcelos; Manuela,0,0,0,0
1668262727970,ECE 276A,A00,103667,Atanasov; Nikolay A.,0,0,0,0
1668262728396,ECE 277,A00,103668,An; Cheolhong,0,0,0,0
1668262728828,ECE 279,A00,117947,Hall; Drew A.,0,0,0,0
1668262729679,ECE 283,A00,103670,Hsueh; Tzu-Chien,0,0,0,0
1668262730102,ECE 284,A00,103671,Turakhia; Yatish Girish,0,0,0,0
1668262730528,ECE 285,A00,103672,Zheng; Yang,0,0,0,0
1668262730528,ECE 285,B00,103673,Sworder; David D.,0,0,0,0
1668262730964,ECE 287,A00,103676,Javidi; Tara,0,0,0,0
1668262731401,MATH 200B,A00,098023,Salehi Golsefidy; Alireza,12,0,15,3
1668262731828,MATH 202B,A00,098024,Rhoades; Brendon Patrick,9,0,15,6
1668262732251,MATH 203B,A00,098025,Oprea; Dragos N.,10,0,15,5
1668262732679,MATH 204B,A00,098026,Sorensen; Claus M,13,0,15,2
1668262733101,MATH 208,A00,098027,Izadi; Elham,7,0,10,3
1668262733525,MATH 209,A00,098028,Pollack; Aaron,10,0,10,0
1668262733954,MATH 211A,A00,112919,Rogalski; Daniel,9,0,10,1
1668262734386,MATH 211B,A00,112920,Seward; Brandon M.,9,0,10,1
1668262734821,MATH 218,A00,098029,Li; Bo,10,0,10,0
1668262735246,MATH 220B,A00,098030,Novak; Jonathan I,11,0,15,4
1668262735675,MATH 221A,A00,098031,Ebenfelt; Peter F,13,0,15,2
1668262736102,MATH 231B,A00,098032,Zlatos; Andrej,12,0,15,3
1668262736534,MATH 240B,A00,098033,Ni; Lei,9,0,15,6
1668262736956,MATH 243,A00,098034,Jekel; David Andrew,10,0,10,0
1668262737390,MATH 245A,A00,098035,Nie; Jiawang,0,0,15,16
1668262737814,MATH 248,A00,098036,Bejenaru; Ioan,10,0,10,0
1668262738238,MATH 250B,A00,098037,Spolaor; Luca,14,0,15,1
1668262738666,MATH 258,A00,098038,Ni; Lei,10,0,10,0
1668262739093,MATH 264B,A00,098041,Rhoades; Brendon Patrick,9,0,15,6
1668262739521,MATH 268,A00,098042,Buss; Samuel R,10,0,10,0
1668262739949,MATH 269,A00,098043,Rhoades; Brendon Patrick,10,0,10,0
1668262740383,MATH 270B,A00,098044,Li; Bo,10,0,15,5
1668262740810,MATH 272B,A00,098045,Holst; Michael J,13,0,15,2
1668262741244,MATH 273A,A00,098046,Tian; Xiaochuan,10,0,15,5
1668262741672,MATH 275,A01,098048,Tian; Xiaochuan,6,0,10,4
1668262742103,MATH 278A,A00,098049,Holst; Michael J,8,0,10,2
1668262742530,MATH 278B,A00,098050,Cloninger; Alexander,10,0,10,0
1668262742958,MATH 278C,A00,098051,Nie; Jiawang,7,0,10,3
1668262743382,MATH 280B,A00,098052,Zheng; Tianyi,9,0,15,6
1668262743822,MATH 281B,A00,098053,Bradic; Jelena,1,0,15,14
1668262744274,MATH 282B,A00,098054,Arias-Castro; Ery,0,0,15,15
1668262744703,MATH 285,A00,098055,Fitzsimmons; Patrick J,0,0,15,17
1668262745131,MATH 287B,A00,098056,Arias-Castro; Ery,2,0,15,13
1668262745555,MATH 288,A00,098057,Agarwal; Pooja,9,0,10,1
1668262745555,MATH 288,B00,098058,Zhang; Danna,8,0,10,2
1668262745555,MATH 288,C00,098059,Williams; Ruth J,10,0,10,0
1668262745983,MATH 290B,A00,098060,Roberts; Justin Deritter,13,0,15,2
1668262746413,MATH 292,A00,098061,Belmont; Eva Kinoshita,10,0,10,0
1668262746837,MATH 295,A00,098062,Suk; Andrew Hoon,48,0,50,2
1668262747261,MATH 296,A00,098063,Novak; Jonathan I,20,0,20,0
1668262747786,MATH 297,001,098064,Gamst; Anthony Collins,9997,0,9999,2
1668263249557,COGS 205,A00,101395,Chiba; Andrea,19,0,20,1
1668263249987,COGS 210B,001,101404,Greene; Deanna Jacquelyn,9998,0,9999,1
1668263249987,COGS 210B,002,101417,Xia; Haijun,9999,0,9999,0
1668263249987,COGS 210B,003,101422,Nitz; Douglas A.,9999,0,9999,0
1668263249987,COGS 210B,004,101423,Hollan; James D.,9998,0,9999,1
1668263249987,COGS 210B,005,101424,Deak; Gedeon O.,9998,0,9999,1
1668263249987,COGS 210B,006,101425,Rossano; Federico,9999,0,9999,0
1668263250413,COGS 211B,A00,101427,Coulson; Seana M,9996,0,9999,3
1668263250835,COGS 220,A00,101428,Hollan; James D.,0,0,25,25
1668263251262,COGS 229,A00,101429,Dow; Steven P,18,0,25,7
1668263251691,COGS 230,A00,101430,Klemmer; Scott R,12,0,17,5
1668263252114,COGS 234,A00,101431,Xia; Haijun,2,0,25,23
1668263252540,COGS 260,A00,101432,Kiyonaga; Anastasia,21,0,25,4
1668263252540,COGS 260,B00,101433,Kirsh; David Joel,15,0,25,10
1668263252964,CSE 202,A00,102371,Impagliazzo; Russell,0,0,0,0
1668263253388,CSE 203B,A01,102373,Cheng; Chung Kuan,0,0,0,0
1668263253810,CSE 208,A00,102374,Micciancio; Daniele,0,0,0,0
1668263254238,CSE 209A,A00,112895,Impagliazzo; Russell,0,0,15,15
1668263254674,CSE 209B,A00,108005,Bellare; Mihir,0,0,0,0
1668263255099,CSE 210,A00,113163,Coblenz; Michael J,0,0,0,0
1668263255526,CSE 219,A00,106111,Dow; Steven P,0,0,20,20
1668263255948,CSE 221,A00,102376,Voelker; Geoffrey M.,0,0,0,0
1668263256372,CSE 224,A01,102378,Porter; George M,0,0,0,0
1668263256797,CSE 229A,A00,102379,Savage; Stefan,0,0,0,0
1668263257233,CSE 229C,A00,102380,Munyaka; Imani N. S.,0,0,0,0
1668263257660,CSE 232B,A00,102382,Deutsch; Alin Bernard,0,0,0,0
1668263258086,CSE 234,A01,112904,Kumar; Arun Kumar,0,0,0,0
1668263258513,CSE 237A,A00,102383,Rosing; Tajana Simunic,0,0,0,0
1668263258940,CSE 239A,A00,102384,Deutsch; Alin Bernard,0,0,0,0
1668263259363,CSE 239B,A00,102385,Polikarpova; Nadezhda,0,0,0,0
1668263259787,CSE 240A,A00,102386,Pannuto; Patrick William,0,0,0,0
1668263260214,CSE 240B,A00,102387,Zhao; Jishen,0,0,0,0
1668263260637,CSE 241A,A00,106406,Kang; Mingu,0,0,0,0
1668263261064,CSE 249B,A00,102388,Kahng; Andrew Byun,0,0,8,8
1668263261501,CSE 251B,A01,102392,Cottrell; Garrison W,0,0,0,0
1668263261501,CSE 251B,A02,102393,Cottrell; Garrison W,0,0,0,0
1668263261932,CSE 252B,A00,102394,Ochoa; Benjamin Lawrence,0,0,0,0
1668263262363,CSE 257,A01,102396,Gao; Sicun,0,0,0,0
1668263262789,CSE 272,A00,102397,Li; Tzumao,0,0,0,0
1668263263211,CSE 274,A00,111323,Chern; Albert Ren-Haur,0,0,0,0
1668263263647,CSE 282,A00,102398,Pevzner; Pavel Arkadjevich,0,0,0,0
1668263264073,CSE 284,A00,114175,Gymrek; Melissa Ann,0,0,0,0
1668263264506,CSE 290,A00,102399,Chandraker; Manmohan Krishna,0,0,0,0
1668263264506,CSE 290,B00,102400,Vaccaro; Kristen Marie,0,0,25,25
1668263264506,CSE 290,C00,102414,Pannuto; Patrick William,0,0,25,25
1668263264506,CSE 290,D00,102427,Pevzner; Pavel Arkadjevich,0,0,0,0
1668263264506,CSE 290,E00,102429,Zhao; Jishen,0,0,0,0
1668263264506,CSE 290,F00,102436,Tullsen; Dean Michael,0,0,0,0
1668263264506,CSE 290,G00,102440,Christensen; Henrik I,0,0,20,20
1668263264930,CSE 291,A00,102443,Su; Hao,0,0,0,0
1668263264930,CSE 291,B00,102448,Polikarpova; Nadezhda,0,0,0,0
1668263264930,CSE 291,C00,102453,Vaccaro; Kristen Marie,0,0,0,0
1668263264930,CSE 291,D00,111343,Savage; Stefan,0,0,0,0
1668263264930,CSE 291,E00,116474,Claffy; Kimberly Claire,0,0,0,0
1668263264930,CSE 291,F00,116479,Pasquale; Joseph,0,0,0,0
1668263265379,CSE 293,001,119111,Bafna; Vineet,9999,0,9999,0
1668263265379,CSE 293,002,119118,Bellare; Mihir,9999,0,9999,0
1668263265379,CSE 293,003,119122,Berg-Kirkpatrick; Taylor D,9999,0,9999,0
1668263265379,CSE 293,004,119135,Christensen; Henrik I,9999,0,9999,0
1668263265379,CSE 293,005,119142,Cottrell; Garrison W,9999,0,9999,0
1668263265379,CSE 293,006,119146,Deutsch; Alin Bernard,9999,0,9999,0
1668263265379,CSE 293,007,119159,Esmaeilzadeh; Hadi,9999,0,9999,0
1668263265379,CSE 293,008,119166,Freund; Yoav,9999,0,9999,0
1668263265379,CSE 293,009,119170,Griswold; William G.,9999,0,9999,0
1668263265379,CSE 293,010,119183,Gymrek; Melissa Ann,9999,0,9999,0
1668263265379,CSE 293,011,119190,Heninger; Nadia A,9999,0,9999,0
1668263265379,CSE 293,012,119230,Impagliazzo; Russell,9999,0,9999,0
1668263265379,CSE 293,013,119232,Jhala; Ranjit,9999,0,9999,0
1668263265379,CSE 293,014,119233,Kahng; Andrew Byun,9999,0,9999,0
1668263265379,CSE 293,015,119298,Kane; Daniel Mertz,9999,0,9999,0
1668263265379,CSE 293,016,119299,Kriegman; David J,9999,0,9999,0
1668263265379,CSE 293,017,119300,Kumar; Arun Kumar,9999,0,9999,0
1668263265379,CSE 293,018,119301,Lerner; Sorin,9999,0,9999,0
1668263265379,CSE 293,019,119302,Lovett; Shachar,9999,0,9999,0
1668263265379,CSE 293,020,119303,McAuley; Julian John,9999,0,9999,0
1668263265379,CSE 293,021,119304,Micciancio; Daniele,9999,0,9999,0
1668263265379,CSE 293,022,119367,Orailoglu; Alex,9999,0,9999,0
1668263265379,CSE 293,023,119382,Paturi; Ramamohan,9999,0,9999,0
1668263265379,CSE 293,024,119404,Polikarpova; Nadezhda,9999,0,9999,0
1668263265379,CSE 293,025,119406,Politz; Joseph Gibbs,9999,0,9999,0
1668263265379,CSE 293,026,119411,Porter; George M,9999,0,9999,0
1668263265379,CSE 293,027,119414,Porter; Leonard Emerson,9999,0,9999,0
1668263265379,CSE 293,028,119416,Ramamoorthi; Ravi,9999,0,9999,0
1668263265379,CSE 293,029,119417,Sahoo; Debashis,9999,0,9999,0
1668263265379,CSE 293,030,119420,Saul; Lawrence,9999,0,9999,0
1668263265379,CSE 293,031,119421,Savage; Stefan,9999,0,9999,0
1668263265379,CSE 293,032,119425,Schulze; Jurgen P.,9999,0,9999,0
1668263265379,CSE 293,033,119426,Snoeren; Alex C.,9999,0,9999,0
1668263265379,CSE 293,034,119428,Shang; Jingbo,9999,0,9999,0
1668263265379,CSE 293,035,119430,Stefan; Deian,9999,0,9999,0
1668263265379,CSE 293,036,119431,Su; Hao,9999,0,9999,0
1668263265379,CSE 293,037,119433,Swanson; Steven James,9999,0,9999,0
1668263265379,CSE 293,038,119435,Tullsen; Dean Michael,9999,0,9999,0
1668263265379,CSE 293,039,119483,Voelker; Geoffrey M.,9999,0,9999,0
1668263265379,CSE 293,040,119537,Zhao; Jishen,9999,0,9999,0
1668263265379,CSE 293,041,119538,Zhou; Yuan-Yuan,9999,0,9999,0
1668263265379,CSE 293,042,119539,Gao; Sicun,9999,0,9999,0
1668263265379,CSE 293,043,119540,Weibel; Nadir,9999,0,9999,0
1668263265379,CSE 293,044,119541,Gupta; Rajesh K.,9999,0,9999,0
1668263265379,CSE 293,045,126410,Vaccaro; Kristen Marie,9999,0,9999,0
1668263265379,CSE 293,046,126411,Klemke; Richard,9999,0,9999,0
1668263265806,CSE 294,A00,102459,Voelker; Geoffrey M.,0,0,0,0
1668263265806,CSE 294,B00,111322,Orailoglu; Alex,0,0,0,0
1668263266241,DSE 201,A00,096914,Deutsch; Alin Bernard,30,0,30,0
1668263266666,DSE 210,A00,096915,Dasgupta; Sanjoy,30,0,30,0
1668263267090,DSE 260A,A00,096916,Altintas De Callaf; Ilkay,30,0,30,0
1668263267532,ECE 200,001,103586,Antipa; Nicholas A,9999,0,9999,0
1668263267532,ECE 200,002,103587,Atanasov; Nikolay A.,9999,0,9999,0
1668263267532,ECE 200,003,103588,Bharadia; Dinesh,9999,0,9999,0
1668263267532,ECE 200,004,103589,Cheng; Chung Kuan,9999,0,9999,0
1668263267532,ECE 200,005,103590,Cosman; Pamela C.,9999,0,9999,0
1668263267532,ECE 200,006,103591,Dayeh; Shadi Ahmad,9999,0,9999,0
1668263267532,ECE 200,007,103592,Fainman; Yeshaiahu,9999,0,9999,0
1668263267532,ECE 200,008,103593,Ford; Joseph Earl,9999,0,9999,0
1668263267532,ECE 200,009,103594,Franceschetti; Massimo,9999,0,9999,0
1668263267532,ECE 200,010,103595,Fullerton; Eric E,9999,0,9999,0
1668263267532,ECE 200,011,103596,Galton; Ian A,9999,0,9999,0
1668263267532,ECE 200,012,103597,Gilja; Vikash,9999,0,9999,0
1668263267532,ECE 200,013,103598,Hall; Drew A.,9999,0,9999,0
1668263267532,ECE 200,014,103599,Hsueh; Tzu-Chien,9999,0,9999,0
1668263267532,ECE 200,015,103600,Javidi; Tara,9999,0,9999,0
1668263267532,ECE 200,016,103601,Kahng; Andrew Byun,9999,0,9999,0
1668263267532,ECE 200,017,103602,Kim; Young-Han,9999,0,9999,0
1668263267532,ECE 200,018,103603,Koushanfar; Farinaz,9999,0,9999,0
1668263267532,ECE 200,019,103604,Kuzum; Duygu,9999,0,9999,0
1668263267532,ECE 200,020,103605,Le; Hanh-Phuc,9999,0,9999,0
1668263267532,ECE 200,021,103606,Lin; Bill,9999,0,9999,0
1668263267532,ECE 200,022,103607,Liu; Zhaowei,9998,0,9999,1
1668263267532,ECE 200,023,103608,Lo; Yu-Hwa,9999,0,9999,0
1668263267532,ECE 200,024,103609,Lomakin; Vitaliy,9999,0,9999,0
1668263267532,ECE 200,025,103610,Mercier; Patrick Philip,9999,0,9999,0
1668263267532,ECE 200,026,103611,Meyer; Florian,9999,0,9999,0
1668263267532,ECE 200,027,103612,Milstein; Laurence B.,9999,0,9999,0
1668263267532,ECE 200,028,103613,Mir Arabbaygi; Siavash,9999,0,9999,0
1668263267532,ECE 200,029,103614,Mookherjea; Shayan,9999,0,9999,0
1668263267532,ECE 200,030,103615,Morris; Karcher William,9999,0,9999,0
1668263267532,ECE 200,031,103616,Ng; Tse Nga,9999,0,9999,0
1668263267532,ECE 200,032,103617,Nguyen; Truong Quang,9999,0,9999,0
1668263267532,ECE 200,033,103618,Nomura; Kenji,9999,0,9999,0
1668263267532,ECE 200,034,103619,Orlitsky; Alon,9999,0,9999,0
1668263267532,ECE 200,035,103620,Pal; Piya,9999,0,9999,0
1668263267532,ECE 200,036,103621,Papen; George C.,9999,0,9999,0
1668263267532,ECE 200,037,103622,Radic; Stojan,9999,0,9999,0
1668263267532,ECE 200,038,103623,Rao; Bhaskar D.,9999,0,9999,0
1668263267532,ECE 200,039,103624,Rao; Ramesh R,9999,0,9999,0
1668263267532,ECE 200,040,103625,Rebeiz; Gabriel,9999,0,9999,0
1668263267532,ECE 200,041,103626,Sanford; John R,9999,0,9999,0
1668263267532,ECE 200,042,103627,Siegel; Paul H.,9999,0,9999,0
1668263267532,ECE 200,043,103628,Sievenpiper; Daniel F.,9999,0,9999,0
1668263267532,ECE 200,044,103629,Sworder; David D.,9999,0,9999,0
1668263267532,ECE 200,045,103630,Taur; Yuan,9999,0,9999,0
1668263267532,ECE 200,046,103631,Touri; Behrouz,9999,0,9999,0
1668263267532,ECE 200,047,103632,Trivedi; Mohan M.,9999,0,9999,0
1668263267532,ECE 200,048,103633,Vasconcelos; Nuno,9999,0,9999,0
1668263267532,ECE 200,049,103634,Wang; Xiaolong,9999,0,9999,0
1668263267532,ECE 200,050,103635,Xie; Pengtao,9999,0,9999,0
1668263267532,ECE 200,051,103636,Yip; Michael,9999,0,9999,0
1668263267532,ECE 200,052,103637,Zeger; Kenneth A.,999,0,999,0
1668263267532,ECE 200,053,103638,Zhang; Xinyu,9999,0,9999,0
1668263267532,ECE 200,054,103639,Turakhia; Yatish Girish,9999,0,9999,0
1668263267532,ECE 200,055,103640,Kang; Mingu,9999,0,9999,0
1668263267532,ECE 200,056,103641,Shi; Yuanyuan,9999,0,9999,0
1668263267532,ECE 200,057,103642,Wang; Edward Jay,9999,0,9999,0
1668263267532,ECE 200,058,103643,Zheng; Yang,9999,0,9999,0
1668263267959,ECE 202,A00,103644,Kuzum; Duygu,0,0,0,0
1668263268383,ECE 212BN,A00,103646,Ng; Tse Nga,0,0,0,0
1668263268825,ECE 221,A00,111493,Staff,0,0,0,0
1668263269249,ECE 222B,A00,103647,Lomakin; Vitaliy,0,0,0,0
1668263269786,ECE 230B,A00,103648,Taur; Yuan,0,0,0,0
1668263270213,ECE 238B,A00,103649,Garay; Javier,0,0,0,0
1668263270635,ECE 240B,A00,112900,Fainman; Yeshaiahu,0,0,0,0
1668263271059,ECE 247A,A00,103650,Jokerst; Jesse Vincent,0,0,0,0
1668263271482,ECE 247B,A00,103651,Wang; Joseph,0,0,0,0
1668263271916,ECE 250,A00,103652,Siegel; Paul H.,0,0,0,0
1668263272358,ECE 251A,A00,103654,Rao; Bhaskar D.,0,0,0,0
1668263272790,ECE 257B,A00,103655,Bharadia; Dinesh,0,0,0,0
1668263273223,ECE 258A,A00,103656,Milstein; Laurence B.,0,0,0,0
1668263273648,ECE 260B,A00,103658,Kang; Mingu,0,0,0,0
1668263274073,ECE 264A,A00,103659,Galton; Ian A,0,0,0,0
1668263274500,ECE 265A,A00,103661,Gudem; Prasad S.S.,0,0,0,0
1668263274932,ECE 265D,A00,103662,Gudem; Prasad S.S.,0,0,0,0
1668263275356,ECE 268,A00,103663,Koushanfar; Farinaz,0,0,0,0
1668263275782,ECE 269,A01,103665,Pal; Piya,0,0,0,0
1668263276206,ECE 271B,A00,103666,Vasconcelos; Manuela,0,0,0,0
1668263276639,ECE 276A,A00,103667,Atanasov; Nikolay A.,0,0,0,0
1668263277069,ECE 277,A00,103668,An; Cheolhong,0,0,0,0
1668263277491,ECE 279,A00,117947,Hall; Drew A.,0,0,0,0
1668263278352,ECE 283,A00,103670,Hsueh; Tzu-Chien,0,0,0,0
1668263278777,ECE 284,A00,103671,Turakhia; Yatish Girish,0,0,0,0
1668263279203,ECE 285,A00,103672,Zheng; Yang,0,0,0,0
1668263279203,ECE 285,B00,103673,Sworder; David D.,0,0,0,0
1668263279627,ECE 287,A00,103676,Javidi; Tara,0,0,0,0
1668263280050,MATH 200B,A00,098023,Salehi Golsefidy; Alireza,12,0,15,3
1668263280475,MATH 202B,A00,098024,Rhoades; Brendon Patrick,9,0,15,6
1668263280897,MATH 203B,A00,098025,Oprea; Dragos N.,10,0,15,5
1668263281321,MATH 204B,A00,098026,Sorensen; Claus M,13,0,15,2
1668263281746,MATH 208,A00,098027,Izadi; Elham,7,0,10,3
1668263282173,MATH 209,A00,098028,Pollack; Aaron,10,0,10,0
1668263282610,MATH 211A,A00,112919,Rogalski; Daniel,9,0,10,1
1668263283046,MATH 211B,A00,112920,Seward; Brandon M.,9,0,10,1
1668263283477,MATH 218,A00,098029,Li; Bo,10,0,10,0
1668263283902,MATH 220B,A00,098030,Novak; Jonathan I,11,0,15,4
1668263284325,MATH 221A,A00,098031,Ebenfelt; Peter F,13,0,15,2
1668263284748,MATH 231B,A00,098032,Zlatos; Andrej,12,0,15,3
1668263285175,MATH 240B,A00,098033,Ni; Lei,9,0,15,6
1668263285601,MATH 243,A00,098034,Jekel; David Andrew,10,0,10,0
1668263286038,MATH 245A,A00,098035,Nie; Jiawang,0,0,15,16
1668263286459,MATH 248,A00,098036,Bejenaru; Ioan,10,0,10,0
1668263286886,MATH 250B,A00,098037,Spolaor; Luca,14,0,15,1
1668263287309,MATH 258,A00,098038,Ni; Lei,10,0,10,0
1668263287742,MATH 264B,A00,098041,Rhoades; Brendon Patrick,9,0,15,6
1668263288174,MATH 268,A00,098042,Buss; Samuel R,10,0,10,0
1668263288598,MATH 269,A00,098043,Rhoades; Brendon Patrick,10,0,10,0
1668263289022,MATH 270B,A00,098044,Li; Bo,10,0,15,5
1668263289449,MATH 272B,A00,098045,Holst; Michael J,13,0,15,2
1668263289871,MATH 273A,A00,098046,Tian; Xiaochuan,10,0,15,5
1668263290300,MATH 275,A01,098048,Tian; Xiaochuan,6,0,10,4
1668263290726,MATH 278A,A00,098049,Holst; Michael J,8,0,10,2
1668263291158,MATH 278B,A00,098050,Cloninger; Alexander,10,0,10,0
1668263291583,MATH 278C,A00,098051,Nie; Jiawang,7,0,10,3
1668263292014,MATH 280B,A00,098052,Zheng; Tianyi,9,0,15,6
1668263292439,MATH 281B,A00,098053,Bradic; Jelena,1,0,15,14
1668263292864,MATH 282B,A00,098054,Arias-Castro; Ery,0,0,15,15
1668263293291,MATH 285,A00,098055,Fitzsimmons; Patrick J,0,0,15,17
1668263293718,MATH 287B,A00,098056,Arias-Castro; Ery,2,0,15,13
1668263294142,MATH 288,A00,098057,Agarwal; Pooja,9,0,10,1
1668263294142,MATH 288,B00,098058,Zhang; Danna,8,0,10,2
1668263294142,MATH 288,C00,098059,Williams; Ruth J,10,0,10,0
1668263294566,MATH 290B,A00,098060,Roberts; Justin Deritter,13,0,15,2
1668263294990,MATH 292,A00,098061,Belmont; Eva Kinoshita,10,0,10,0
1668263295427,MATH 295,A00,098062,Suk; Andrew Hoon,48,0,50,2
1668263295860,MATH 296,A00,098063,Novak; Jonathan I,20,0,20,0
1668263296299,MATH 297,001,098064,Gamst; Anthony Collins,9997,0,9999,2
1668263797710,COGS 205,A00,101395,Chiba; Andrea,19,0,20,1
1668263798147,COGS 210B,001,101404,Greene; Deanna Jacquelyn,9998,0,9999,1
1668263798147,COGS 210B,002,101417,Xia; Haijun,9999,0,9999,0
1668263798147,COGS 210B,003,101422,Nitz; Douglas A.,9999,0,9999,0
1668263798147,COGS 210B,004,101423,Hollan; James D.,9998,0,9999,1
1668263798147,COGS 210B,005,101424,Deak; Gedeon O.,9998,0,9999,1
1668263798147,COGS 210B,006,101425,Rossano; Federico,9999,0,9999,0
1668263798577,COGS 211B,A00,101427,Coulson; Seana M,9996,0,9999,3
1668263799001,COGS 220,A00,101428,Hollan; James D.,0,0,25,25
1668263799426,COGS 229,A00,101429,Dow; Steven P,18,0,25,7
1668263799855,COGS 230,A00,101430,Klemmer; Scott R,12,0,17,5
1668263800298,COGS 234,A00,101431,Xia; Haijun,2,0,25,23
1668263800731,COGS 260,A00,101432,Kiyonaga; Anastasia,21,0,25,4
1668263800731,COGS 260,B00,101433,Kirsh; David Joel,15,0,25,10
1668263801162,CSE 202,A00,102371,Impagliazzo; Russell,0,0,0,0
1668263801589,CSE 203B,A01,102373,Cheng; Chung Kuan,0,0,0,0
1668263802025,CSE 208,A00,102374,Micciancio; Daniele,0,0,0,0
1668263802448,CSE 209A,A00,112895,Impagliazzo; Russell,0,0,15,15
1668263802882,CSE 209B,A00,108005,Bellare; Mihir,0,0,0,0
1668263803316,CSE 210,A00,113163,Coblenz; Michael J,0,0,0,0
1668263803743,CSE 219,A00,106111,Dow; Steven P,0,0,20,20
1668263804167,CSE 221,A00,102376,Voelker; Geoffrey M.,0,0,0,0
1668263804591,CSE 224,A01,102378,Porter; George M,0,0,0,0
1668263805019,CSE 229A,A00,102379,Savage; Stefan,0,0,0,0
1668263805444,CSE 229C,A00,102380,Munyaka; Imani N. S.,0,0,0,0
1668263805882,CSE 232B,A00,102382,Deutsch; Alin Bernard,0,0,0,0
1668263806310,CSE 234,A01,112904,Kumar; Arun Kumar,0,0,0,0
1668263806733,CSE 237A,A00,102383,Rosing; Tajana Simunic,0,0,0,0
1668263807174,CSE 239A,A00,102384,Deutsch; Alin Bernard,0,0,0,0
1668263807602,CSE 239B,A00,102385,Polikarpova; Nadezhda,0,0,0,0
1668263808025,CSE 240A,A00,102386,Pannuto; Patrick William,0,0,0,0
1668263808447,CSE 240B,A00,102387,Zhao; Jishen,0,0,0,0
1668263808883,CSE 241A,A00,106406,Kang; Mingu,0,0,0,0
1668263809311,CSE 249B,A00,102388,Kahng; Andrew Byun,0,0,8,8
1668263809742,CSE 251B,A01,102392,Cottrell; Garrison W,0,0,0,0
1668263809742,CSE 251B,A02,102393,Cottrell; Garrison W,0,0,0,0
1668263810166,CSE 252B,A00,102394,Ochoa; Benjamin Lawrence,0,0,0,0
1668263810590,CSE 257,A01,102396,Gao; Sicun,0,0,0,0
1668263811017,CSE 272,A00,102397,Li; Tzumao,0,0,0,0
1668263811443,CSE 274,A00,111323,Chern; Albert Ren-Haur,0,0,0,0
1668263811868,CSE 282,A00,102398,Pevzner; Pavel Arkadjevich,0,0,0,0
1668263812291,CSE 284,A00,114175,Gymrek; Melissa Ann,0,0,0,0
1668263812716,CSE 290,A00,102399,Chandraker; Manmohan Krishna,0,0,0,0
1668263812716,CSE 290,B00,102400,Vaccaro; Kristen Marie,0,0,25,25
1668263812716,CSE 290,C00,102414,Pannuto; Patrick William,0,0,25,25
1668263812716,CSE 290,D00,102427,Pevzner; Pavel Arkadjevich,0,0,0,0
1668263812716,CSE 290,E00,102429,Zhao; Jishen,0,0,0,0
1668263812716,CSE 290,F00,102436,Tullsen; Dean Michael,0,0,0,0
1668263812716,CSE 290,G00,102440,Christensen; Henrik I,0,0,20,20
1668263813142,CSE 291,A00,102443,Su; Hao,0,0,0,0
1668263813142,CSE 291,B00,102448,Polikarpova; Nadezhda,0,0,0,0
1668263813142,CSE 291,C00,102453,Vaccaro; Kristen Marie,0,0,0,0
1668263813142,CSE 291,D00,111343,Savage; Stefan,0,0,0,0
1668263813142,CSE 291,E00,116474,Claffy; Kimberly Claire,0,0,0,0
1668263813142,CSE 291,F00,116479,Pasquale; Joseph,0,0,0,0
1668263813574,CSE 293,001,119111,Bafna; Vineet,9999,0,9999,0
1668263813574,CSE 293,002,119118,Bellare; Mihir,9999,0,9999,0
1668263813574,CSE 293,003,119122,Berg-Kirkpatrick; Taylor D,9999,0,9999,0
1668263813574,CSE 293,004,119135,Christensen; Henrik I,9999,0,9999,0
1668263813574,CSE 293,005,119142,Cottrell; Garrison W,9999,0,9999,0
1668263813574,CSE 293,006,119146,Deutsch; Alin Bernard,9999,0,9999,0
1668263813574,CSE 293,007,119159,Esmaeilzadeh; Hadi,9999,0,9999,0
1668263813574,CSE 293,008,119166,Freund; Yoav,9999,0,9999,0
1668263813574,CSE 293,009,119170,Griswold; William G.,9999,0,9999,0
1668263813574,CSE 293,010,119183,Gymrek; Melissa Ann,9999,0,9999,0
1668263813574,CSE 293,011,119190,Heninger; Nadia A,9999,0,9999,0
1668263813574,CSE 293,012,119230,Impagliazzo; Russell,9999,0,9999,0
1668263813574,CSE 293,013,119232,Jhala; Ranjit,9999,0,9999,0
1668263813574,CSE 293,014,119233,Kahng; Andrew Byun,9999,0,9999,0
1668263813574,CSE 293,015,119298,Kane; Daniel Mertz,9999,0,9999,0
1668263813574,CSE 293,016,119299,Kriegman; David J,9999,0,9999,0
1668263813574,CSE 293,017,119300,Kumar; Arun Kumar,9999,0,9999,0
1668263813574,CSE 293,018,119301,Lerner; Sorin,9999,0,9999,0
1668263813574,CSE 293,019,119302,Lovett; Shachar,9999,0,9999,0
1668263813574,CSE 293,020,119303,McAuley; Julian John,9999,0,9999,0
1668263813574,CSE 293,021,119304,Micciancio; Daniele,9999,0,9999,0
1668263813574,CSE 293,022,119367,Orailoglu; Alex,9999,0,9999,0
1668263813574,CSE 293,023,119382,Paturi; Ramamohan,9999,0,9999,0
1668263813574,CSE 293,024,119404,Polikarpova; Nadezhda,9999,0,9999,0
1668263813574,CSE 293,025,119406,Politz; Joseph Gibbs,9999,0,9999,0
1668263813574,CSE 293,026,119411,Porter; George M,9999,0,9999,0
1668263813574,CSE 293,027,119414,Porter; Leonard Emerson,9999,0,9999,0
1668263813574,CSE 293,028,119416,Ramamoorthi; Ravi,9999,0,9999,0
1668263813574,CSE 293,029,119417,Sahoo; Debashis,9999,0,9999,0
1668263813574,CSE 293,030,119420,Saul; Lawrence,9999,0,9999,0
1668263813574,CSE 293,031,119421,Savage; Stefan,9999,0,9999,0
1668263813574,CSE 293,032,119425,Schulze; Jurgen P.,9999,0,9999,0
1668263813574,CSE 293,033,119426,Snoeren; Alex C.,9999,0,9999,0
1668263813574,CSE 293,034,119428,Shang; Jingbo,9999,0,9999,0
1668263813574,CSE 293,035,119430,Stefan; Deian,9999,0,9999,0
1668263813574,CSE 293,036,119431,Su; Hao,9999,0,9999,0
1668263813574,CSE 293,037,119433,Swanson; Steven James,9999,0,9999,0
1668263813574,CSE 293,038,119435,Tullsen; Dean Michael,9999,0,9999,0
1668263813574,CSE 293,039,119483,Voelker; Geoffrey M.,9999,0,9999,0
1668263813574,CSE 293,040,119537,Zhao; Jishen,9999,0,9999,0
1668263813574,CSE 293,041,119538,Zhou; Yuan-Yuan,9999,0,9999,0
1668263813574,CSE 293,042,119539,Gao; Sicun,9999,0,9999,0
1668263813574,CSE 293,043,119540,Weibel; Nadir,9999,0,9999,0
1668263813574,CSE 293,044,119541,Gupta; Rajesh K.,9999,0,9999,0
1668263813574,CSE 293,045,126410,Vaccaro; Kristen Marie,9999,0,9999,0
1668263813574,CSE 293,046,126411,Klemke; Richard,9999,0,9999,0
1668263814000,CSE 294,A00,102459,Voelker; Geoffrey M.,0,0,0,0
1668263814000,CSE 294,B00,111322,Orailoglu; Alex,0,0,0,0
1668263814432,DSE 201,A00,096914,Deutsch; Alin Bernard,30,0,30,0
1668263814856,DSE 210,A00,096915,Dasgupta; Sanjoy,30,0,30,0
1668263815282,DSE 260A,A00,096916,Altintas De Callaf; Ilkay,30,0,30,0
1668263815724,ECE 200,001,103586,Antipa; Nicholas A,9999,0,9999,0
1668263815724,ECE 200,002,103587,Atanasov; Nikolay A.,9999,0,9999,0
1668263815724,ECE 200,003,103588,Bharadia; Dinesh,9999,0,9999,0
1668263815724,ECE 200,004,103589,Cheng; Chung Kuan,9999,0,9999,0
1668263815724,ECE 200,005,103590,Cosman; Pamela C.,9999,0,9999,0
1668263815724,ECE 200,006,103591,Dayeh; Shadi Ahmad,9999,0,9999,0
1668263815724,ECE 200,007,103592,Fainman; Yeshaiahu,9999,0,9999,0
1668263815724,ECE 200,008,103593,Ford; Joseph Earl,9999,0,9999,0
1668263815724,ECE 200,009,103594,Franceschetti; Massimo,9999,0,9999,0
1668263815724,ECE 200,010,103595,Fullerton; Eric E,9999,0,9999,0
1668263815724,ECE 200,011,103596,Galton; Ian A,9999,0,9999,0
1668263815724,ECE 200,012,103597,Gilja; Vikash,9999,0,9999,0
1668263815724,ECE 200,013,103598,Hall; Drew A.,9999,0,9999,0
1668263815724,ECE 200,014,103599,Hsueh; Tzu-Chien,9999,0,9999,0
1668263815724,ECE 200,015,103600,Javidi; Tara,9999,0,9999,0
1668263815724,ECE 200,016,103601,Kahng; Andrew Byun,9999,0,9999,0
1668263815724,ECE 200,017,103602,Kim; Young-Han,9999,0,9999,0
1668263815724,ECE 200,018,103603,Koushanfar; Farinaz,9999,0,9999,0
1668263815724,ECE 200,019,103604,Kuzum; Duygu,9999,0,9999,0
1668263815724,ECE 200,020,103605,Le; Hanh-Phuc,9999,0,9999,0
1668263815724,ECE 200,021,103606,Lin; Bill,9999,0,9999,0
1668263815724,ECE 200,022,103607,Liu; Zhaowei,9998,0,9999,1
1668263815724,ECE 200,023,103608,Lo; Yu-Hwa,9999,0,9999,0
1668263815724,ECE 200,024,103609,Lomakin; Vitaliy,9999,0,9999,0
1668263815724,ECE 200,025,103610,Mercier; Patrick Philip,9999,0,9999,0
1668263815724,ECE 200,026,103611,Meyer; Florian,9999,0,9999,0
1668263815724,ECE 200,027,103612,Milstein; Laurence B.,9999,0,9999,0
1668263815724,ECE 200,028,103613,Mir Arabbaygi; Siavash,9999,0,9999,0
1668263815724,ECE 200,029,103614,Mookherjea; Shayan,9999,0,9999,0
1668263815724,ECE 200,030,103615,Morris; Karcher William,9999,0,9999,0
1668263815724,ECE 200,031,103616,Ng; Tse Nga,9999,0,9999,0
1668263815724,ECE 200,032,103617,Nguyen; Truong Quang,9999,0,9999,0
1668263815724,ECE 200,033,103618,Nomura; Kenji,9999,0,9999,0
1668263815724,ECE 200,034,103619,Orlitsky; Alon,9999,0,9999,0
1668263815724,ECE 200,035,103620,Pal; Piya,9999,0,9999,0
1668263815724,ECE 200,036,103621,Papen; George C.,9999,0,9999,0
1668263815724,ECE 200,037,103622,Radic; Stojan,9999,0,9999,0
1668263815724,ECE 200,038,103623,Rao; Bhaskar D.,9999,0,9999,0
1668263815724,ECE 200,039,103624,Rao; Ramesh R,9999,0,9999,0
1668263815724,ECE 200,040,103625,Rebeiz; Gabriel,9999,0,9999,0
1668263815724,ECE 200,041,103626,Sanford; John R,9999,0,9999,0
1668263815724,ECE 200,042,103627,Siegel; Paul H.,9999,0,9999,0
1668263815724,ECE 200,043,103628,Sievenpiper; Daniel F.,9999,0,9999,0
1668263815724,ECE 200,044,103629,Sworder; David D.,9999,0,9999,0
1668263815724,ECE 200,045,103630,Taur; Yuan,9999,0,9999,0
1668263815724,ECE 200,046,103631,Touri; Behrouz,9999,0,9999,0
1668263815724,ECE 200,047,103632,Trivedi; Mohan M.,9999,0,9999,0
1668263815724,ECE 200,048,103633,Vasconcelos; Nuno,9999,0,9999,0
1668263815724,ECE 200,049,103634,Wang; Xiaolong,9999,0,9999,0
1668263815724,ECE 200,050,103635,Xie; Pengtao,9999,0,9999,0
1668263815724,ECE 200,051,103636,Yip; Michael,9999,0,9999,0
1668263815724,ECE 200,052,103637,Zeger; Kenneth A.,999,0,999,0
1668263815724,ECE 200,053,103638,Zhang; Xinyu,9999,0,9999,0
1668263815724,ECE 200,054,103639,Turakhia; Yatish Girish,9999,0,9999,0
1668263815724,ECE 200,055,103640,Kang; Mingu,9999,0,9999,0
1668263815724,ECE 200,056,103641,Shi; Yuanyuan,9999,0,9999,0
1668263815724,ECE 200,057,103642,Wang; Edward Jay,9999,0,9999,0
1668263815724,ECE 200,058,103643,Zheng; Yang,9999,0,9999,0
1668263816151,ECE 202,A00,103644,Kuzum; Duygu,0,0,0,0
1668263816573,ECE 212BN,A00,103646,Ng; Tse Nga,0,0,0,0
1668263817004,ECE 221,A00,111493,Staff,0,0,0,0
1668263817432,ECE 222B,A00,103647,Lomakin; Vitaliy,0,0,0,0
1668263817860,ECE 230B,A00,103648,Taur; Yuan,0,0,0,0
1668263818283,ECE 238B,A00,103649,Garay; Javier,0,0,0,0
1668263818713,ECE 240B,A00,112900,Fainman; Yeshaiahu,0,0,0,0
1668263819139,ECE 247A,A00,103650,Jokerst; Jesse Vincent,0,0,0,0
1668263819564,ECE 247B,A00,103651,Wang; Joseph,0,0,0,0
1668263819994,ECE 250,A00,103652,Siegel; Paul H.,0,0,0,0
1668263820421,ECE 251A,A00,103654,Rao; Bhaskar D.,0,0,0,0
1668263820854,ECE 257B,A00,103655,Bharadia; Dinesh,0,0,0,0
1668263821286,ECE 258A,A00,103656,Milstein; Laurence B.,0,0,0,0
1668263821725,ECE 260B,A00,103658,Kang; Mingu,0,0,0,0
1668263822161,ECE 264A,A00,103659,Galton; Ian A,0,0,0,0
1668263822588,ECE 265A,A00,103661,Gudem; Prasad S.S.,0,0,0,0
1668263823023,ECE 265D,A00,103662,Gudem; Prasad S.S.,0,0,0,0
1668263823458,ECE 268,A00,103663,Koushanfar; Farinaz,0,0,0,0
1668263823884,ECE 269,A01,103665,Pal; Piya,0,0,0,0
1668263824307,ECE 271B,A00,103666,Vasconcelos; Manuela,0,0,0,0
1668263824743,ECE 276A,A00,103667,Atanasov; Nikolay A.,0,0,0,0
1668263825170,ECE 277,A00,103668,An; Cheolhong,0,0,0,0
1668263825596,ECE 279,A00,117947,Hall; Drew A.,0,0,0,0
1668263826456,ECE 283,A00,103670,Hsueh; Tzu-Chien,0,0,0,0
1668263826881,ECE 284,A00,103671,Turakhia; Yatish Girish,0,0,0,0
1668263827309,ECE 285,A00,103672,Zheng; Yang,0,0,0,0
1668263827309,ECE 285,B00,103673,Sworder; David D.,0,0,0,0
1668263827736,ECE 287,A00,103676,Javidi; Tara,0,0,0,0
1668263828171,MATH 200B,A00,098023,Salehi Golsefidy; Alireza,12,0,15,3
1668263828594,MATH 202B,A00,098024,Rhoades; Brendon Patrick,9,0,15,6
1668263829029,MATH 203B,A00,098025,Oprea; Dragos N.,10,0,15,5
1668263829463,MATH 204B,A00,098026,Sorensen; Claus M,13,0,15,2
1668263829898,MATH 208,A00,098027,Izadi; Elham,7,0,10,3
1668263830322,MATH 209,A00,098028,Pollack; Aaron,10,0,10,0
1668263830745,MATH 211A,A00,112919,Rogalski; Daniel,9,0,10,1
1668263831168,MATH 211B,A00,112920,Seward; Brandon M.,9,0,10,1
1668263831591,MATH 218,A00,098029,Li; Bo,10,0,10,0
1668263832017,MATH 220B,A00,098030,Novak; Jonathan I,11,0,15,4
1668263832444,MATH 221A,A00,098031,Ebenfelt; Peter F,13,0,15,2
1668263832882,MATH 231B,A00,098032,Zlatos; Andrej,12,0,15,3
1668263833322,MATH 240B,A00,098033,Ni; Lei,9,0,15,6
1668263833744,MATH 243,A00,098034,Jekel; David Andrew,10,0,10,0
1668263834172,MATH 245A,A00,098035,Nie; Jiawang,0,0,15,16
1668263834691,MATH 248,A00,098036,Bejenaru; Ioan,10,0,10,0
1668263835115,MATH 250B,A00,098037,Spolaor; Luca,14,0,15,1
1668263835536,MATH 258,A00,098038,Ni; Lei,10,0,10,0
1668263835962,MATH 264B,A00,098041,Rhoades; Brendon Patrick,9,0,15,6
1668263836385,MATH 268,A00,098042,Buss; Samuel R,10,0,10,0
1668263836809,MATH 269,A00,098043,Rhoades; Brendon Patrick,10,0,10,0
1668263837238,MATH 270B,A00,098044,Li; Bo,10,0,15,5
1668263837686,MATH 272B,A00,098045,Holst; Michael J,13,0,15,2
1668263838119,MATH 273A,A00,098046,Tian; Xiaochuan,10,0,15,5
1668263838554,MATH 275,A01,098048,Tian; Xiaochuan,6,0,10,4
1668263838984,MATH 278A,A00,098049,Holst; Michael J,8,0,10,2
1668263839425,MATH 278B,A00,098050,Cloninger; Alexander,10,0,10,0
1668263839851,MATH 278C,A00,098051,Nie; Jiawang,7,0,10,3
1668263840277,MATH 280B,A00,098052,Zheng; Tianyi,9,0,15,6
1668263840700,MATH 281B,A00,098053,Bradic; Jelena,1,0,15,14
1668263841131,MATH 282B,A00,098054,Arias-Castro; Ery,0,0,15,15
1668263841558,MATH 285,A00,098055,Fitzsimmons; Patrick J,0,0,15,17
1668263841982,MATH 287B,A00,098056,Arias-Castro; Ery,2,0,15,13
1668263842410,MATH 288,A00,098057,Agarwal; Pooja,9,0,10,1
1668263842410,MATH 288,B00,098058,Zhang; Danna,8,0,10,2
1668263842410,MATH 288,C00,098059,Williams; Ruth J,10,0,10,0
1668263842834,MATH 290B,A00,098060,Roberts; Justin Deritter,13,0,15,2
1668263843262,MATH 292,A00,098061,Belmont; Eva Kinoshita,10,0,10,0
1668263843686,MATH 295,A00,098062,Suk; Andrew Hoon,48,0,50,2
1668263844113,MATH 296,A00,098063,Novak; Jonathan I,20,0,20,0
1668263844541,MATH 297,001,098064,Gamst; Anthony Collins,9997,0,9999,2
1668264345815,COGS 205,A00,101395,Chiba; Andrea,19,0,20,1
1668264346249,COGS 210B,001,101404,Greene; Deanna Jacquelyn,9998,0,9999,1
1668264346249,COGS 210B,002,101417,Xia; Haijun,9999,0,9999,0
1668264346249,COGS 210B,003,101422,Nitz; Douglas A.,9999,0,9999,0
1668264346249,COGS 210B,004,101423,Hollan; James D.,9998,0,9999,1
1668264346249,COGS 210B,005,101424,Deak; Gedeon O.,9998,0,9999,1
1668264346249,COGS 210B,006,101425,Rossano; Federico,9999,0,9999,0
1668264346672,COGS 211B,A00,101427,Coulson; Seana M,9996,0,9999,3
1668264347109,COGS 220,A00,101428,Hollan; James D.,0,0,25,25
1668264347533,COGS 229,A00,101429,Dow; Steven P,18,0,25,7
1668264347958,COGS 230,A00,101430,Klemmer; Scott R,12,0,17,5
1668264348392,COGS 234,A00,101431,Xia; Haijun,2,0,25,23
1668264348815,COGS 260,A00,101432,Kiyonaga; Anastasia,21,0,25,4
1668264348815,COGS 260,B00,101433,Kirsh; David Joel,15,0,25,10
1668264349255,CSE 202,A00,102371,Impagliazzo; Russell,0,0,0,0
1668264349681,CSE 203B,A01,102373,Cheng; Chung Kuan,0,0,0,0
1668264350106,CSE 208,A00,102374,Micciancio; Daniele,0,0,0,0
1668264350533,CSE 209A,A00,112895,Impagliazzo; Russell,0,0,15,15
1668264350961,CSE 209B,A00,108005,Bellare; Mihir,0,0,0,0
1668264351386,CSE 210,A00,113163,Coblenz; Michael J,0,0,0,0
1668264351816,CSE 219,A00,106111,Dow; Steven P,0,0,20,20
1668264352249,CSE 221,A00,102376,Voelker; Geoffrey M.,0,0,0,0
1668264352677,CSE 224,A01,102378,Porter; George M,0,0,0,0
1668264353102,CSE 229A,A00,102379,Savage; Stefan,0,0,0,0
1668264353525,CSE 229C,A00,102380,Munyaka; Imani N. S.,0,0,0,0
1668264353949,CSE 232B,A00,102382,Deutsch; Alin Bernard,0,0,0,0
1668264354375,CSE 234,A01,112904,Kumar; Arun Kumar,0,0,0,0
1668264354800,CSE 237A,A00,102383,Rosing; Tajana Simunic,0,0,0,0
1668264355228,CSE 239A,A00,102384,Deutsch; Alin Bernard,0,0,0,0
1668264355651,CSE 239B,A00,102385,Polikarpova; Nadezhda,0,0,0,0
1668264356154,CSE 240A,A00,102386,Pannuto; Patrick William,0,0,0,0
1668264356598,CSE 240B,A00,102387,Zhao; Jishen,0,0,0,0
1668264357030,CSE 241A,A00,106406,Kang; Mingu,0,0,0,0
1668264357453,CSE 249B,A00,102388,Kahng; Andrew Byun,0,0,8,8
1668264357876,CSE 251B,A01,102392,Cottrell; Garrison W,0,0,0,0
1668264357876,CSE 251B,A02,102393,Cottrell; Garrison W,0,0,0,0
1668264358311,CSE 252B,A00,102394,Ochoa; Benjamin Lawrence,0,0,0,0
1668264358766,CSE 257,A01,102396,Gao; Sicun,0,0,0,0
1668264359197,CSE 272,A00,102397,Li; Tzumao,0,0,0,0
1668264359619,CSE 274,A00,111323,Chern; Albert Ren-Haur,0,0,0,0
1668264360042,CSE 282,A00,102398,Pevzner; Pavel Arkadjevich,0,0,0,0
1668264360465,CSE 284,A00,114175,Gymrek; Melissa Ann,0,0,0,0
1668264360891,CSE 290,A00,102399,Chandraker; Manmohan Krishna,0,0,0,0
1668264360891,CSE 290,B00,102400,Vaccaro; Kristen Marie,0,0,25,25
1668264360891,CSE 290,C00,102414,Pannuto; Patrick William,0,0,25,25
1668264360891,CSE 290,D00,102427,Pevzner; Pavel Arkadjevich,0,0,0,0
1668264360891,CSE 290,E00,102429,Zhao; Jishen,0,0,0,0
1668264360891,CSE 290,F00,102436,Tullsen; Dean Michael,0,0,0,0
1668264360891,CSE 290,G00,102440,Christensen; Henrik I,0,0,20,20
1668264361314,CSE 291,A00,102443,Su; Hao,0,0,0,0
1668264361314,CSE 291,B00,102448,Polikarpova; Nadezhda,0,0,0,0
1668264361314,CSE 291,C00,102453,Vaccaro; Kristen Marie,0,0,0,0
1668264361314,CSE 291,D00,111343,Savage; Stefan,0,0,0,0
1668264361314,CSE 291,E00,116474,Claffy; Kimberly Claire,0,0,0,0
1668264361314,CSE 291,F00,116479,Pasquale; Joseph,0,0,0,0
1668264361740,CSE 293,001,119111,Bafna; Vineet,9999,0,9999,0
1668264361740,CSE 293,002,119118,Bellare; Mihir,9999,0,9999,0
1668264361740,CSE 293,003,119122,Berg-Kirkpatrick; Taylor D,9999,0,9999,0
1668264361740,CSE 293,004,119135,Christensen; Henrik I,9999,0,9999,0
1668264361740,CSE 293,005,119142,Cottrell; Garrison W,9999,0,9999,0
1668264361740,CSE 293,006,119146,Deutsch; Alin Bernard,9999,0,9999,0
1668264361740,CSE 293,007,119159,Esmaeilzadeh; Hadi,9999,0,9999,0
1668264361740,CSE 293,008,119166,Freund; Yoav,9999,0,9999,0
1668264361740,CSE 293,009,119170,Griswold; William G.,9999,0,9999,0
1668264361740,CSE 293,010,119183,Gymrek; Melissa Ann,9999,0,9999,0
1668264361740,CSE 293,011,119190,Heninger; Nadia A,9999,0,9999,0
1668264361740,CSE 293,012,119230,Impagliazzo; Russell,9999,0,9999,0
1668264361740,CSE 293,013,119232,Jhala; Ranjit,9999,0,9999,0
1668264361740,CSE 293,014,119233,Kahng; Andrew Byun,9999,0,9999,0
1668264361740,CSE 293,015,119298,Kane; Daniel Mertz,9999,0,9999,0
1668264361740,CSE 293,016,119299,Kriegman; David J,9999,0,9999,0
1668264361740,CSE 293,017,119300,Kumar; Arun Kumar,9999,0,9999,0
1668264361740,CSE 293,018,119301,Lerner; Sorin,9999,0,9999,0
1668264361740,CSE 293,019,119302,Lovett; Shachar,9999,0,9999,0
1668264361740,CSE 293,020,119303,McAuley; Julian John,9999,0,9999,0
1668264361740,CSE 293,021,119304,Micciancio; Daniele,9999,0,9999,0
1668264361740,CSE 293,022,119367,Orailoglu; Alex,9999,0,9999,0
1668264361740,CSE 293,023,119382,Paturi; Ramamohan,9999,0,9999,0
1668264361740,CSE 293,024,119404,Polikarpova; Nadezhda,9999,0,9999,0
1668264361740,CSE 293,025,119406,Politz; Joseph Gibbs,9999,0,9999,0
1668264361740,CSE 293,026,119411,Porter; George M,9999,0,9999,0
1668264361740,CSE 293,027,119414,Porter; Leonard Emerson,9999,0,9999,0
1668264361740,CSE 293,028,119416,Ramamoorthi; Ravi,9999,0,9999,0
1668264361740,CSE 293,029,119417,Sahoo; Debashis,9999,0,9999,0
1668264361740,CSE 293,030,119420,Saul; Lawrence,9999,0,9999,0
1668264361740,CSE 293,031,119421,Savage; Stefan,9999,0,9999,0
1668264361740,CSE 293,032,119425,Schulze; Jurgen P.,9999,0,9999,0
1668264361740,CSE 293,033,119426,Snoeren; Alex C.,9999,0,9999,0
1668264361740,CSE 293,034,119428,Shang; Jingbo,9999,0,9999,0
1668264361740,CSE 293,035,119430,Stefan; Deian,9999,0,9999,0
1668264361740,CSE 293,036,119431,Su; Hao,9999,0,9999,0
1668264361740,CSE 293,037,119433,Swanson; Steven James,9999,0,9999,0
1668264361740,CSE 293,038,119435,Tullsen; Dean Michael,9999,0,9999,0
1668264361740,CSE 293,039,119483,Voelker; Geoffrey M.,9999,0,9999,0
1668264361740,CSE 293,040,119537,Zhao; Jishen,9999,0,9999,0
1668264361740,CSE 293,041,119538,Zhou; Yuan-Yuan,9999,0,9999,0
1668264361740,CSE 293,042,119539,Gao; Sicun,9999,0,9999,0
1668264361740,CSE 293,043,119540,Weibel; Nadir,9999,0,9999,0
1668264361740,CSE 293,044,119541,Gupta; Rajesh K.,9999,0,9999,0
1668264361740,CSE 293,045,126410,Vaccaro; Kristen Marie,9999,0,9999,0
1668264361740,CSE 293,046,126411,Klemke; Richard,9999,0,9999,0
1668264362162,CSE 294,A00,102459,Voelker; Geoffrey M.,0,0,0,0
1668264362162,CSE 294,B00,111322,Orailoglu; Alex,0,0,0,0
1668264362587,DSE 201,A00,096914,Deutsch; Alin Bernard,30,0,30,0
1668264363010,DSE 210,A00,096915,Dasgupta; Sanjoy,30,0,30,0
1668264363447,DSE 260A,A00,096916,Altintas De Callaf; Ilkay,30,0,30,0
1668264363883,ECE 200,001,103586,Antipa; Nicholas A,9999,0,9999,0
1668264363883,ECE 200,002,103587,Atanasov; Nikolay A.,9999,0,9999,0
1668264363883,ECE 200,003,103588,Bharadia; Dinesh,9999,0,9999,0
1668264363883,ECE 200,004,103589,Cheng; Chung Kuan,9999,0,9999,0
1668264363883,ECE 200,005,103590,Cosman; Pamela C.,9999,0,9999,0
1668264363883,ECE 200,006,103591,Dayeh; Shadi Ahmad,9999,0,9999,0
1668264363883,ECE 200,007,103592,Fainman; Yeshaiahu,9999,0,9999,0
1668264363883,ECE 200,008,103593,Ford; Joseph Earl,9999,0,9999,0
1668264363883,ECE 200,009,103594,Franceschetti; Massimo,9999,0,9999,0
1668264363883,ECE 200,010,103595,Fullerton; Eric E,9999,0,9999,0
1668264363883,ECE 200,011,103596,Galton; Ian A,9999,0,9999,0
1668264363883,ECE 200,012,103597,Gilja; Vikash,9999,0,9999,0
1668264363883,ECE 200,013,103598,Hall; Drew A.,9999,0,9999,0
1668264363883,ECE 200,014,103599,Hsueh; Tzu-Chien,9999,0,9999,0
1668264363883,ECE 200,015,103600,Javidi; Tara,9999,0,9999,0
1668264363883,ECE 200,016,103601,Kahng; Andrew Byun,9999,0,9999,0
1668264363883,ECE 200,017,103602,Kim; Young-Han,9999,0,9999,0
1668264363883,ECE 200,018,103603,Koushanfar; Farinaz,9999,0,9999,0
1668264363883,ECE 200,019,103604,Kuzum; Duygu,9999,0,9999,0
1668264363883,ECE 200,020,103605,Le; Hanh-Phuc,9999,0,9999,0
1668264363883,ECE 200,021,103606,Lin; Bill,9999,0,9999,0
1668264363883,ECE 200,022,103607,Liu; Zhaowei,9998,0,9999,1
1668264363883,ECE 200,023,103608,Lo; Yu-Hwa,9999,0,9999,0
1668264363883,ECE 200,024,103609,Lomakin; Vitaliy,9999,0,9999,0
1668264363883,ECE 200,025,103610,Mercier; Patrick Philip,9999,0,9999,0
1668264363883,ECE 200,026,103611,Meyer; Florian,9999,0,9999,0
1668264363883,ECE 200,027,103612,Milstein; Laurence B.,9999,0,9999,0
1668264363883,ECE 200,028,103613,Mir Arabbaygi; Siavash,9999,0,9999,0
1668264363883,ECE 200,029,103614,Mookherjea; Shayan,9999,0,9999,0
1668264363883,ECE 200,030,103615,Morris; Karcher William,9999,0,9999,0
1668264363883,ECE 200,031,103616,Ng; Tse Nga,9999,0,9999,0
1668264363883,ECE 200,032,103617,Nguyen; Truong Quang,9999,0,9999,0
1668264363883,ECE 200,033,103618,Nomura; Kenji,9999,0,9999,0
1668264363883,ECE 200,034,103619,Orlitsky; Alon,9999,0,9999,0
1668264363883,ECE 200,035,103620,Pal; Piya,9999,0,9999,0
1668264363883,ECE 200,036,103621,Papen; George C.,9999,0,9999,0
1668264363883,ECE 200,037,103622,Radic; Stojan,9999,0,9999,0
1668264363883,ECE 200,038,103623,Rao; Bhaskar D.,9999,0,9999,0
1668264363883,ECE 200,039,103624,Rao; Ramesh R,9999,0,9999,0
1668264363883,ECE 200,040,103625,Rebeiz; Gabriel,9999,0,9999,0
1668264363883,ECE 200,041,103626,Sanford; John R,9999,0,9999,0
1668264363883,ECE 200,042,103627,Siegel; Paul H.,9999,0,9999,0
1668264363883,ECE 200,043,103628,Sievenpiper; Daniel F.,9999,0,9999,0
1668264363883,ECE 200,044,103629,Sworder; David D.,9999,0,9999,0
1668264363883,ECE 200,045,103630,Taur; Yuan,9999,0,9999,0
1668264363883,ECE 200,046,103631,Touri; Behrouz,9999,0,9999,0
1668264363883,ECE 200,047,103632,Trivedi; Mohan M.,9999,0,9999,0
1668264363883,ECE 200,048,103633,Vasconcelos; Nuno,9999,0,9999,0
1668264363883,ECE 200,049,103634,Wang; Xiaolong,9999,0,9999,0
1668264363883,ECE 200,050,103635,Xie; Pengtao,9999,0,9999,0
1668264363883,ECE 200,051,103636,Yip; Michael,9999,0,9999,0
1668264363883,ECE 200,052,103637,Zeger; Kenneth A.,999,0,999,0
1668264363883,ECE 200,053,103638,Zhang; Xinyu,9999,0,9999,0
1668264363883,ECE 200,054,103639,Turakhia; Yatish Girish,9999,0,9999,0
1668264363883,ECE 200,055,103640,Kang; Mingu,9999,0,9999,0
1668264363883,ECE 200,056,103641,Shi; Yuanyuan,9999,0,9999,0
1668264363883,ECE 200,057,103642,Wang; Edward Jay,9999,0,9999,0
1668264363883,ECE 200,058,103643,Zheng; Yang,9999,0,9999,0
1668264364308,ECE 202,A00,103644,Kuzum; Duygu,0,0,0,0
1668264364732,ECE 212BN,A00,103646,Ng; Tse Nga,0,0,0,0
1668264365157,ECE 221,A00,111493,Staff,0,0,0,0
1668264365579,ECE 222B,A00,103647,Lomakin; Vitaliy,0,0,0,0
1668264366004,ECE 230B,A00,103648,Taur; Yuan,0,0,0,0
1668264366430,ECE 238B,A00,103649,Garay; Javier,0,0,0,0
1668264366852,ECE 240B,A00,112900,Fainman; Yeshaiahu,0,0,0,0
1668264367276,ECE 247A,A00,103650,Jokerst; Jesse Vincent,0,0,0,0
1668264367698,ECE 247B,A00,103651,Wang; Joseph,0,0,0,0
1668264368121,ECE 250,A00,103652,Siegel; Paul H.,0,0,0,0
1668264368544,ECE 251A,A00,103654,Rao; Bhaskar D.,0,0,0,0
1668264368970,ECE 257B,A00,103655,Bharadia; Dinesh,0,0,0,0
1668264369395,ECE 258A,A00,103656,Milstein; Laurence B.,0,0,0,0
1668264369817,ECE 260B,A00,103658,Kang; Mingu,0,0,0,0
1668264370254,ECE 264A,A00,103659,Galton; Ian A,0,0,0,0
1668264370685,ECE 265A,A00,103661,Gudem; Prasad S.S.,0,0,0,0
1668264371113,ECE 265D,A00,103662,Gudem; Prasad S.S.,0,0,0,0
1668264371546,ECE 268,A00,103663,Koushanfar; Farinaz,0,0,0,0
1668264371988,ECE 269,A01,103665,Pal; Piya,0,0,0,0
1668264372422,ECE 271B,A00,103666,Vasconcelos; Manuela,0,0,0,0
1668264372846,ECE 276A,A00,103667,Atanasov; Nikolay A.,0,0,0,0
1668264373284,ECE 277,A00,103668,An; Cheolhong,0,0,0,0
1668264373712,ECE 279,A00,117947,Hall; Drew A.,0,0,0,0
1668264374561,ECE 283,A00,103670,Hsueh; Tzu-Chien,0,0,0,0
1668264374990,ECE 284,A00,103671,Turakhia; Yatish Girish,0,0,0,0
1668264375423,ECE 285,A00,103672,Zheng; Yang,0,0,0,0
1668264375423,ECE 285,B00,103673,Sworder; David D.,0,0,0,0
1668264375862,ECE 287,A00,103676,Javidi; Tara,0,0,0,0
1668264376295,MATH 200B,A00,098023,Salehi Golsefidy; Alireza,12,0,15,3
1668264376720,MATH 202B,A00,098024,Rhoades; Brendon Patrick,9,0,15,6
1668264377143,MATH 203B,A00,098025,Oprea; Dragos N.,10,0,15,5
1668264377584,MATH 204B,A00,098026,Sorensen; Claus M,13,0,15,2
1668264378008,MATH 208,A00,098027,Izadi; Elham,7,0,10,3
1668264378442,MATH 209,A00,098028,Pollack; Aaron,10,0,10,0
1668264378864,MATH 211A,A00,112919,Rogalski; Daniel,9,0,10,1
1668264379299,MATH 211B,A00,112920,Seward; Brandon M.,9,0,10,1
1668264379736,MATH 218,A00,098029,Li; Bo,10,0,10,0
1668264380166,MATH 220B,A00,098030,Novak; Jonathan I,11,0,15,4
1668264380589,MATH 221A,A00,098031,Ebenfelt; Peter F,13,0,15,2
1668264381023,MATH 231B,A00,098032,Zlatos; Andrej,12,0,15,3
1668264381446,MATH 240B,A00,098033,Ni; Lei,9,0,15,6
1668264381879,MATH 243,A00,098034,Jekel; David Andrew,10,0,10,0
1668264382304,MATH 245A,A00,098035,Nie; Jiawang,0,0,15,16
1668264382735,MATH 248,A00,098036,Bejenaru; Ioan,10,0,10,0
1668264383171,MATH 250B,A00,098037,Spolaor; Luca,14,0,15,1
1668264383595,MATH 258,A00,098038,Ni; Lei,10,0,10,0
1668264384020,MATH 264B,A00,098041,Rhoades; Brendon Patrick,9,0,15,6
1668264384447,MATH 268,A00,098042,Buss; Samuel R,10,0,10,0
1668264384870,MATH 269,A00,098043,Rhoades; Brendon Patrick,10,0,10,0
1668264385293,MATH 270B,A00,098044,Li; Bo,10,0,15,5
1668264385716,MATH 272B,A00,098045,Holst; Michael J,13,0,15,2
1668264386150,MATH 273A,A00,098046,Tian; Xiaochuan,10,0,15,5
1668264386575,MATH 275,A01,098048,Tian; Xiaochuan,6,0,10,4
1668264387009,MATH 278A,A00,098049,Holst; Michael J,8,0,10,2
1668264387435,MATH 278B,A00,098050,Cloninger; Alexander,10,0,10,0
1668264387866,MATH 278C,A00,098051,Nie; Jiawang,7,0,10,3
1668264388291,MATH 280B,A00,098052,Zheng; Tianyi,9,0,15,6
1668264388720,MATH 281B,A00,098053,Bradic; Jelena,1,0,15,14
1668264389162,MATH 282B,A00,098054,Arias-Castro; Ery,0,0,15,15
1668264389584,MATH 285,A00,098055,Fitzsimmons; Patrick J,0,0,15,17
1668264390009,MATH 287B,A00,098056,Arias-Castro; Ery,2,0,15,13
1668264390434,MATH 288,A00,098057,Agarwal; Pooja,9,0,10,1
1668264390434,MATH 288,B00,098058,Zhang; Danna,8,0,10,2
1668264390434,MATH 288,C00,098059,Williams; Ruth J,10,0,10,0
1668264390864,MATH 290B,A00,098060,Roberts; Justin Deritter,13,0,15,2
1668264391288,MATH 292,A00,098061,Belmont; Eva Kinoshita,10,0,10,0
1668264391711,MATH 295,A00,098062,Suk; Andrew Hoon,48,0,50,2
1668264392138,MATH 296,A00,098063,Novak; Jonathan I,20,0,20,0
1668264392563,MATH 297,001,098064,Gamst; Anthony Collins,9997,0,9999,2
1668264893614,COGS 205,A00,101395,Chiba; Andrea,19,0,20,1
1668264894040,COGS 210B,001,101404,Greene; Deanna Jacquelyn,9998,0,9999,1
1668264894040,COGS 210B,002,101417,Xia; Haijun,9999,0,9999,0
1668264894040,COGS 210B,003,101422,Nitz; Douglas A.,9999,0,9999,0
1668264894040,COGS 210B,004,101423,Hollan; James D.,9998,0,9999,1
1668264894040,COGS 210B,005,101424,Deak; Gedeon O.,9998,0,9999,1
1668264894040,COGS 210B,006,101425,Rossano; Federico,9999,0,9999,0
1668264894467,COGS 211B,A00,101427,Coulson; Seana M,9996,0,9999,3
1668264894896,COGS 220,A00,101428,Hollan; James D.,0,0,25,25
1668264895323,COGS 229,A00,101429,Dow; Steven P,18,0,25,7
1668264895757,COGS 230,A00,101430,Klemmer; Scott R,12,0,17,5
1668264896195,COGS 234,A00,101431,Xia; Haijun,2,0,25,23
1668264896620,COGS 260,A00,101432,Kiyonaga; Anastasia,21,0,25,4
1668264896620,COGS 260,B00,101433,Kirsh; David Joel,15,0,25,10
1668264897044,CSE 202,A00,102371,Impagliazzo; Russell,0,0,0,0
1668264897467,CSE 203B,A01,102373,Cheng; Chung Kuan,0,0,0,0
1668264897890,CSE 208,A00,102374,Micciancio; Daniele,0,0,0,0
1668264898326,CSE 209A,A00,112895,Impagliazzo; Russell,0,0,15,15
1668264898752,CSE 209B,A00,108005,Bellare; Mihir,0,0,0,0
1668264899179,CSE 210,A00,113163,Coblenz; Michael J,0,0,0,0
1668264899613,CSE 219,A00,106111,Dow; Steven P,0,0,20,20
1668264900038,CSE 221,A00,102376,Voelker; Geoffrey M.,0,0,0,0
1668264900490,CSE 224,A01,102378,Porter; George M,0,0,0,0
1668264900920,CSE 229A,A00,102379,Savage; Stefan,0,0,0,0
1668264901350,CSE 229C,A00,102380,Munyaka; Imani N. S.,0,0,0,0
1668264901791,CSE 232B,A00,102382,Deutsch; Alin Bernard,0,0,0,0
1668264902213,CSE 234,A01,112904,Kumar; Arun Kumar,0,0,0,0
1668264902649,CSE 237A,A00,102383,Rosing; Tajana Simunic,0,0,0,0
1668264903079,CSE 239A,A00,102384,Deutsch; Alin Bernard,0,0,0,0
1668264903503,CSE 239B,A00,102385,Polikarpova; Nadezhda,0,0,0,0
1668264903934,CSE 240A,A00,102386,Pannuto; Patrick William,0,0,0,0
1668264904361,CSE 240B,A00,102387,Zhao; Jishen,0,0,0,0
1668264904785,CSE 241A,A00,106406,Kang; Mingu,0,0,0,0
1668264905208,CSE 249B,A00,102388,Kahng; Andrew Byun,0,0,8,8
1668264905635,CSE 251B,A01,102392,Cottrell; Garrison W,0,0,0,0
1668264905635,CSE 251B,A02,102393,Cottrell; Garrison W,0,0,0,0
1668264906066,CSE 252B,A00,102394,Ochoa; Benjamin Lawrence,0,0,0,0
1668264906501,CSE 257,A01,102396,Gao; Sicun,0,0,0,0
1668264906940,CSE 272,A00,102397,Li; Tzumao,0,0,0,0
1668264907366,CSE 274,A00,111323,Chern; Albert Ren-Haur,0,0,0,0
1668264907788,CSE 282,A00,102398,Pevzner; Pavel Arkadjevich,0,0,0,0
1668264908212,CSE 284,A00,114175,Gymrek; Melissa Ann,0,0,0,0
1668264908636,CSE 290,A00,102399,Chandraker; Manmohan Krishna,0,0,0,0
1668264908636,CSE 290,B00,102400,Vaccaro; Kristen Marie,0,0,25,25
1668264908636,CSE 290,C00,102414,Pannuto; Patrick William,0,0,25,25
1668264908636,CSE 290,D00,102427,Pevzner; Pavel Arkadjevich,0,0,0,0
1668264908636,CSE 290,E00,102429,Zhao; Jishen,0,0,0,0
1668264908636,CSE 290,F00,102436,Tullsen; Dean Michael,0,0,0,0
1668264908636,CSE 290,G00,102440,Christensen; Henrik I,0,0,20,20
1668264909061,CSE 291,A00,102443,Su; Hao,0,0,0,0
1668264909061,CSE 291,B00,102448,Polikarpova; Nadezhda,0,0,0,0
1668264909061,CSE 291,C00,102453,Vaccaro; Kristen Marie,0,0,0,0
1668264909061,CSE 291,D00,111343,Savage; Stefan,0,0,0,0
1668264909061,CSE 291,E00,116474,Claffy; Kimberly Claire,0,0,0,0
1668264909061,CSE 291,F00,116479,Pasquale; Joseph,0,0,0,0
1668264909497,CSE 293,001,119111,Bafna; Vineet,9999,0,9999,0
1668264909497,CSE 293,002,119118,Bellare; Mihir,9999,0,9999,0
1668264909497,CSE 293,003,119122,Berg-Kirkpatrick; Taylor D,9999,0,9999,0
1668264909497,CSE 293,004,119135,Christensen; Henrik I,9999,0,9999,0
1668264909497,CSE 293,005,119142,Cottrell; Garrison W,9999,0,9999,0
1668264909497,CSE 293,006,119146,Deutsch; Alin Bernard,9999,0,9999,0
1668264909497,CSE 293,007,119159,Esmaeilzadeh; Hadi,9999,0,9999,0
1668264909497,CSE 293,008,119166,Freund; Yoav,9999,0,9999,0
1668264909497,CSE 293,009,119170,Griswold; William G.,9999,0,9999,0
1668264909497,CSE 293,010,119183,Gymrek; Melissa Ann,9999,0,9999,0
1668264909497,CSE 293,011,119190,Heninger; Nadia A,9999,0,9999,0
1668264909497,CSE 293,012,119230,Impagliazzo; Russell,9999,0,9999,0
1668264909497,CSE 293,013,119232,Jhala; Ranjit,9999,0,9999,0
1668264909497,CSE 293,014,119233,Kahng; Andrew Byun,9999,0,9999,0
1668264909497,CSE 293,015,119298,Kane; Daniel Mertz,9999,0,9999,0
1668264909497,CSE 293,016,119299,Kriegman; David J,9999,0,9999,0
1668264909497,CSE 293,017,119300,Kumar; Arun Kumar,9999,0,9999,0
1668264909497,CSE 293,018,119301,Lerner; Sorin,9999,0,9999,0
1668264909497,CSE 293,019,119302,Lovett; Shachar,9999,0,9999,0
1668264909497,CSE 293,020,119303,McAuley; Julian John,9999,0,9999,0
1668264909497,CSE 293,021,119304,Micciancio; Daniele,9999,0,9999,0
1668264909497,CSE 293,022,119367,Orailoglu; Alex,9999,0,9999,0
1668264909497,CSE 293,023,119382,Paturi; Ramamohan,9999,0,9999,0
1668264909497,CSE 293,024,119404,Polikarpova; Nadezhda,9999,0,9999,0
1668264909497,CSE 293,025,119406,Politz; Joseph Gibbs,9999,0,9999,0
1668264909497,CSE 293,026,119411,Porter; George M,9999,0,9999,0
1668264909497,CSE 293,027,119414,Porter; Leonard Emerson,9999,0,9999,0
1668264909497,CSE 293,028,119416,Ramamoorthi; Ravi,9999,0,9999,0
1668264909497,CSE 293,029,119417,Sahoo; Debashis,9999,0,9999,0
1668264909497,CSE 293,030,119420,Saul; Lawrence,9999,0,9999,0
1668264909497,CSE 293,031,119421,Savage; Stefan,9999,0,9999,0
1668264909497,CSE 293,032,119425,Schulze; Jurgen P.,9999,0,9999,0
1668264909497,CSE 293,033,119426,Snoeren; Alex C.,9999,0,9999,0
1668264909497,CSE 293,034,119428,Shang; Jingbo,9999,0,9999,0
1668264909497,CSE 293,035,119430,Stefan; Deian,9999,0,9999,0
1668264909497,CSE 293,036,119431,Su; Hao,9999,0,9999,0
1668264909497,CSE 293,037,119433,Swanson; Steven James,9999,0,9999,0
1668264909497,CSE 293,038,119435,Tullsen; Dean Michael,9999,0,9999,0
1668264909497,CSE 293,039,119483,Voelker; Geoffrey M.,9999,0,9999,0
1668264909497,CSE 293,040,119537,Zhao; Jishen,9999,0,9999,0
1668264909497,CSE 293,041,119538,Zhou; Yuan-Yuan,9999,0,9999,0
1668264909497,CSE 293,042,119539,Gao; Sicun,9999,0,9999,0
1668264909497,CSE 293,043,119540,Weibel; Nadir,9999,0,9999,0
1668264909497,CSE 293,044,119541,Gupta; Rajesh K.,9999,0,9999,0
1668264909497,CSE 293,045,126410,Vaccaro; Kristen Marie,9999,0,9999,0
1668264909497,CSE 293,046,126411,Klemke; Richard,9999,0,9999,0
1668264909924,CSE 294,A00,102459,Voelker; Geoffrey M.,0,0,0,0
1668264909924,CSE 294,B00,111322,Orailoglu; Alex,0,0,0,0
1668264910349,DSE 201,A00,096914,Deutsch; Alin Bernard,30,0,30,0
1668264910776,DSE 210,A00,096915,Dasgupta; Sanjoy,30,0,30,0
1668264911198,DSE 260A,A00,096916,Altintas De Callaf; Ilkay,30,0,30,0
1668264911625,ECE 200,001,103586,Antipa; Nicholas A,9999,0,9999,0
1668264911625,ECE 200,002,103587,Atanasov; Nikolay A.,9999,0,9999,0
1668264911625,ECE 200,003,103588,Bharadia; Dinesh,9999,0,9999,0
1668264911625,ECE 200,004,103589,Cheng; Chung Kuan,9999,0,9999,0
1668264911625,ECE 200,005,103590,Cosman; Pamela C.,9999,0,9999,0
1668264911625,ECE 200,006,103591,Dayeh; Shadi Ahmad,9999,0,9999,0
1668264911625,ECE 200,007,103592,Fainman; Yeshaiahu,9999,0,9999,0
1668264911625,ECE 200,008,103593,Ford; Joseph Earl,9999,0,9999,0
1668264911625,ECE 200,009,103594,Franceschetti; Massimo,9999,0,9999,0
1668264911625,ECE 200,010,103595,Fullerton; Eric E,9999,0,9999,0
1668264911625,ECE 200,011,103596,Galton; Ian A,9999,0,9999,0
1668264911625,ECE 200,012,103597,Gilja; Vikash,9999,0,9999,0
1668264911625,ECE 200,013,103598,Hall; Drew A.,9999,0,9999,0
1668264911625,ECE 200,014,103599,Hsueh; Tzu-Chien,9999,0,9999,0
1668264911625,ECE 200,015,103600,Javidi; Tara,9999,0,9999,0
1668264911625,ECE 200,016,103601,Kahng; Andrew Byun,9999,0,9999,0
1668264911625,ECE 200,017,103602,Kim; Young-Han,9999,0,9999,0
1668264911625,ECE 200,018,103603,Koushanfar; Farinaz,9999,0,9999,0
1668264911625,ECE 200,019,103604,Kuzum; Duygu,9999,0,9999,0
1668264911625,ECE 200,020,103605,Le; Hanh-Phuc,9999,0,9999,0
1668264911625,ECE 200,021,103606,Lin; Bill,9999,0,9999,0
1668264911625,ECE 200,022,103607,Liu; Zhaowei,9998,0,9999,1
1668264911625,ECE 200,023,103608,Lo; Yu-Hwa,9999,0,9999,0
1668264911625,ECE 200,024,103609,Lomakin; Vitaliy,9999,0,9999,0
1668264911625,ECE 200,025,103610,Mercier; Patrick Philip,9999,0,9999,0
1668264911625,ECE 200,026,103611,Meyer; Florian,9999,0,9999,0
1668264911625,ECE 200,027,103612,Milstein; Laurence B.,9999,0,9999,0
1668264911625,ECE 200,028,103613,Mir Arabbaygi; Siavash,9999,0,9999,0
1668264911625,ECE 200,029,103614,Mookherjea; Shayan,9999,0,9999,0
1668264911625,ECE 200,030,103615,Morris; Karcher William,9999,0,9999,0
1668264911625,ECE 200,031,103616,Ng; Tse Nga,9999,0,9999,0
1668264911625,ECE 200,032,103617,Nguyen; Truong Quang,9999,0,9999,0
1668264911625,ECE 200,033,103618,Nomura; Kenji,9999,0,9999,0
1668264911625,ECE 200,034,103619,Orlitsky; Alon,9999,0,9999,0
1668264911625,ECE 200,035,103620,Pal; Piya,9999,0,9999,0
1668264911625,ECE 200,036,103621,Papen; George C.,9999,0,9999,0
1668264911625,ECE 200,037,103622,Radic; Stojan,9999,0,9999,0
1668264911625,ECE 200,038,103623,Rao; Bhaskar D.,9999,0,9999,0
1668264911625,ECE 200,039,103624,Rao; Ramesh R,9999,0,9999,0
1668264911625,ECE 200,040,103625,Rebeiz; Gabriel,9999,0,9999,0
1668264911625,ECE 200,041,103626,Sanford; John R,9999,0,9999,0
1668264911625,ECE 200,042,103627,Siegel; Paul H.,9999,0,9999,0
1668264911625,ECE 200,043,103628,Sievenpiper; Daniel F.,9999,0,9999,0
1668264911625,ECE 200,044,103629,Sworder; David D.,9999,0,9999,0
1668264911625,ECE 200,045,103630,Taur; Yuan,9999,0,9999,0
1668264911625,ECE 200,046,103631,Touri; Behrouz,9999,0,9999,0
1668264911625,ECE 200,047,103632,Trivedi; Mohan M.,9999,0,9999,0
1668264911625,ECE 200,048,103633,Vasconcelos; Nuno,9999,0,9999,0
1668264911625,ECE 200,049,103634,Wang; Xiaolong,9999,0,9999,0
1668264911625,ECE 200,050,103635,Xie; Pengtao,9999,0,9999,0
1668264911625,ECE 200,051,103636,Yip; Michael,9999,0,9999,0
1668264911625,ECE 200,052,103637,Zeger; Kenneth A.,999,0,999,0
1668264911625,ECE 200,053,103638,Zhang; Xinyu,9999,0,9999,0
1668264911625,ECE 200,054,103639,Turakhia; Yatish Girish,9999,0,9999,0
1668264911625,ECE 200,055,103640,Kang; Mingu,9999,0,9999,0
1668264911625,ECE 200,056,103641,Shi; Yuanyuan,9999,0,9999,0
1668264911625,ECE 200,057,103642,Wang; Edward Jay,9999,0,9999,0
1668264911625,ECE 200,058,103643,Zheng; Yang,9999,0,9999,0
1668264912048,ECE 202,A00,103644,Kuzum; Duygu,0,0,0,0
1668264912472,ECE 212BN,A00,103646,Ng; Tse Nga,0,0,0,0
1668264912908,ECE 221,A00,111493,Staff,0,0,0,0
1668264913349,ECE 222B,A00,103647,Lomakin; Vitaliy,0,0,0,0
1668264913775,ECE 230B,A00,103648,Taur; Yuan,0,0,0,0
1668264914201,ECE 238B,A00,103649,Garay; Javier,0,0,0,0
1668264914625,ECE 240B,A00,112900,Fainman; Yeshaiahu,0,0,0,0
1668264915048,ECE 247A,A00,103650,Jokerst; Jesse Vincent,0,0,0,0
1668264915472,ECE 247B,A00,103651,Wang; Joseph,0,0,0,0
1668264915910,ECE 250,A00,103652,Siegel; Paul H.,0,0,0,0
1668264916338,ECE 251A,A00,103654,Rao; Bhaskar D.,0,0,0,0
1668264916762,ECE 257B,A00,103655,Bharadia; Dinesh,0,0,0,0
1668264917189,ECE 258A,A00,103656,Milstein; Laurence B.,0,0,0,0
1668264917615,ECE 260B,A00,103658,Kang; Mingu,0,0,0,0
1668264918041,ECE 264A,A00,103659,Galton; Ian A,0,0,0,0
1668264918463,ECE 265A,A00,103661,Gudem; Prasad S.S.,0,0,0,0
1668264918887,ECE 265D,A00,103662,Gudem; Prasad S.S.,0,0,0,0
1668264919319,ECE 268,A00,103663,Koushanfar; Farinaz,0,0,0,0
1668264919744,ECE 269,A01,103665,Pal; Piya,0,0,0,0
1668264920166,ECE 271B,A00,103666,Vasconcelos; Manuela,0,0,0,0
1668264920670,ECE 276A,A00,103667,Atanasov; Nikolay A.,0,0,0,0
1668264921092,ECE 277,A00,103668,An; Cheolhong,0,0,0,0
1668264921521,ECE 279,A00,117947,Hall; Drew A.,0,0,0,0
1668264922374,ECE 283,A00,103670,Hsueh; Tzu-Chien,0,0,0,0
1668264922808,ECE 284,A00,103671,Turakhia; Yatish Girish,0,0,0,0
1668264923232,ECE 285,A00,103672,Zheng; Yang,0,0,0,0
1668264923232,ECE 285,B00,103673,Sworder; David D.,0,0,0,0
1668264923656,ECE 287,A00,103676,Javidi; Tara,0,0,0,0
1668264924084,MATH 200B,A00,098023,Salehi Golsefidy; Alireza,12,0,15,3
1668264924519,MATH 202B,A00,098024,Rhoades; Brendon Patrick,9,0,15,6
1668264924943,MATH 203B,A00,098025,Oprea; Dragos N.,10,0,15,5
1668264925367,MATH 204B,A00,098026,Sorensen; Claus M,13,0,15,2
1668264925794,MATH 208,A00,098027,Izadi; Elham,7,0,10,3
1668264926218,MATH 209,A00,098028,Pollack; Aaron,10,0,10,0
1668264926644,MATH 211A,A00,112919,Rogalski; Daniel,9,0,10,1
1668264927078,MATH 211B,A00,112920,Seward; Brandon M.,9,0,10,1
1668264927502,MATH 218,A00,098029,Li; Bo,10,0,10,0
1668264927927,MATH 220B,A00,098030,Novak; Jonathan I,11,0,15,4
1668264928350,MATH 221A,A00,098031,Ebenfelt; Peter F,13,0,15,2
1668264928775,MATH 231B,A00,098032,Zlatos; Andrej,12,0,15,3
1668264929213,MATH 240B,A00,098033,Ni; Lei,9,0,15,6
1668264929639,MATH 243,A00,098034,Jekel; David Andrew,10,0,10,0
1668264930062,MATH 245A,A00,098035,Nie; Jiawang,0,0,15,16
1668264930487,MATH 248,A00,098036,Bejenaru; Ioan,10,0,10,0
1668264930914,MATH 250B,A00,098037,Spolaor; Luca,14,0,15,1
1668264931337,MATH 258,A00,098038,Ni; Lei,10,0,10,0
1668264931760,MATH 264B,A00,098041,Rhoades; Brendon Patrick,9,0,15,6
1668264932184,MATH 268,A00,098042,Buss; Samuel R,10,0,10,0
1668264932608,MATH 269,A00,098043,Rhoades; Brendon Patrick,10,0,10,0
1668264933033,MATH 270B,A00,098044,Li; Bo,10,0,15,5
1668264933458,MATH 272B,A00,098045,Holst; Michael J,13,0,15,2
1668264933882,MATH 273A,A00,098046,Tian; Xiaochuan,10,0,15,5
1668264934333,MATH 275,A01,098048,Tian; Xiaochuan,6,0,10,4
1668264934755,MATH 278A,A00,098049,Holst; Michael J,8,0,10,2
1668264935179,MATH 278B,A00,098050,Cloninger; Alexander,10,0,10,0
1668264935602,MATH 278C,A00,098051,Nie; Jiawang,7,0,10,3
1668264936029,MATH 280B,A00,098052,Zheng; Tianyi,9,0,15,6
1668264936455,MATH 281B,A00,098053,Bradic; Jelena,1,0,15,14
1668264936878,MATH 282B,A00,098054,Arias-Castro; Ery,0,0,15,15
1668264937314,MATH 285,A00,098055,Fitzsimmons; Patrick J,0,0,15,17
1668264937735,MATH 287B,A00,098056,Arias-Castro; Ery,2,0,15,13
1668264938169,MATH 288,A00,098057,Agarwal; Pooja,9,0,10,1
1668264938169,MATH 288,B00,098058,Zhang; Danna,8,0,10,2
1668264938169,MATH 288,C00,098059,Williams; Ruth J,10,0,10,0
1668264938594,MATH 290B,A00,098060,Roberts; Justin Deritter,13,0,15,2
1668264939019,MATH 292,A00,098061,Belmont; Eva Kinoshita,10,0,10,0
1668264939444,MATH 295,A00,098062,Suk; Andrew Hoon,48,0,50,2
1668264939878,MATH 296,A00,098063,Novak; Jonathan I,20,0,20,0
1668264940308,MATH 297,001,098064,Gamst; Anthony Collins,9997,0,9999,2
1668265444659,COGS 205,A00,101395,Chiba; Andrea,19,0,20,1
1668265445171,COGS 210B,001,101404,Greene; Deanna Jacquelyn,9998,0,9999,1
1668265445171,COGS 210B,002,101417,Xia; Haijun,9999,0,9999,0
1668265445171,COGS 210B,003,101422,Nitz; Douglas A.,9999,0,9999,0
1668265445171,COGS 210B,004,101423,Hollan; James D.,9998,0,9999,1
1668265445171,COGS 210B,005,101424,Deak; Gedeon O.,9998,0,9999,1
1668265445171,COGS 210B,006,101425,Rossano; Federico,9999,0,9999,0
1668265445607,COGS 211B,A00,101427,Coulson; Seana M,9996,0,9999,3
1668265446033,COGS 220,A00,101428,Hollan; James D.,0,0,25,25
1668265446457,COGS 229,A00,101429,Dow; Steven P,18,0,25,7
1668265446880,COGS 230,A00,101430,Klemmer; Scott R,12,0,17,5
1668265447313,COGS 234,A00,101431,Xia; Haijun,2,0,25,23
1668265447737,COGS 260,A00,101432,Kiyonaga; Anastasia,21,0,25,4
1668265447737,COGS 260,B00,101433,Kirsh; David Joel,15,0,25,10
1668265448163,CSE 202,A00,102371,Impagliazzo; Russell,0,0,0,0
1668265448587,CSE 203B,A01,102373,Cheng; Chung Kuan,0,0,0,0
1668265449014,CSE 208,A00,102374,Micciancio; Daniele,0,0,0,0
1668265449439,CSE 209A,A00,112895,Impagliazzo; Russell,0,0,15,15
1668265449864,CSE 209B,A00,108005,Bellare; Mihir,0,0,0,0
1668265450290,CSE 210,A00,113163,Coblenz; Michael J,0,0,0,0
1668265450718,CSE 219,A00,106111,Dow; Steven P,0,0,20,20
1668265451141,CSE 221,A00,102376,Voelker; Geoffrey M.,0,0,0,0
1668265451580,CSE 224,A01,102378,Porter; George M,0,0,0,0
1668265452007,CSE 229A,A00,102379,Savage; Stefan,0,0,0,0
1668265452434,CSE 229C,A00,102380,Munyaka; Imani N. S.,0,0,0,0
1668265452860,CSE 232B,A00,102382,Deutsch; Alin Bernard,0,0,0,0
1668265453286,CSE 234,A01,112904,Kumar; Arun Kumar,0,0,0,0
1668265453709,CSE 237A,A00,102383,Rosing; Tajana Simunic,0,0,0,0
1668265454133,CSE 239A,A00,102384,Deutsch; Alin Bernard,0,0,0,0
1668265454558,CSE 239B,A00,102385,Polikarpova; Nadezhda,0,0,0,0
1668265454981,CSE 240A,A00,102386,Pannuto; Patrick William,0,0,0,0
1668265455410,CSE 240B,A00,102387,Zhao; Jishen,0,0,0,0
1668265455849,CSE 241A,A00,106406,Kang; Mingu,0,0,0,0
1668265456272,CSE 249B,A00,102388,Kahng; Andrew Byun,0,0,8,8
1668265456706,CSE 251B,A01,102392,Cottrell; Garrison W,0,0,0,0
1668265456706,CSE 251B,A02,102393,Cottrell; Garrison W,0,0,0,0
1668265457130,CSE 252B,A00,102394,Ochoa; Benjamin Lawrence,0,0,0,0
1668265457553,CSE 257,A01,102396,Gao; Sicun,0,0,0,0
1668265457979,CSE 272,A00,102397,Li; Tzumao,0,0,0,0
1668265458415,CSE 274,A00,111323,Chern; Albert Ren-Haur,0,0,0,0
1668265458839,CSE 282,A00,102398,Pevzner; Pavel Arkadjevich,0,0,0,0
1668265459263,CSE 284,A00,114175,Gymrek; Melissa Ann,0,0,0,0
1668265459692,CSE 290,A00,102399,Chandraker; Manmohan Krishna,0,0,0,0
1668265459692,CSE 290,B00,102400,Vaccaro; Kristen Marie,0,0,25,25
1668265459692,CSE 290,C00,102414,Pannuto; Patrick William,0,0,25,25
1668265459692,CSE 290,D00,102427,Pevzner; Pavel Arkadjevich,0,0,0,0
1668265459692,CSE 290,E00,102429,Zhao; Jishen,0,0,0,0
1668265459692,CSE 290,F00,102436,Tullsen; Dean Michael,0,0,0,0
1668265459692,CSE 290,G00,102440,Christensen; Henrik I,0,0,20,20
1668265460129,CSE 291,A00,102443,Su; Hao,0,0,0,0
1668265460129,CSE 291,B00,102448,Polikarpova; Nadezhda,0,0,0,0
1668265460129,CSE 291,C00,102453,Vaccaro; Kristen Marie,0,0,0,0
1668265460129,CSE 291,D00,111343,Savage; Stefan,0,0,0,0
1668265460129,CSE 291,E00,116474,Claffy; Kimberly Claire,0,0,0,0
1668265460129,CSE 291,F00,116479,Pasquale; Joseph,0,0,0,0
1668265460563,CSE 293,001,119111,Bafna; Vineet,9999,0,9999,0
1668265460563,CSE 293,002,119118,Bellare; Mihir,9999,0,9999,0
1668265460563,CSE 293,003,119122,Berg-Kirkpatrick; Taylor D,9999,0,9999,0
1668265460563,CSE 293,004,119135,Christensen; Henrik I,9999,0,9999,0
1668265460563,CSE 293,005,119142,Cottrell; Garrison W,9999,0,9999,0
1668265460563,CSE 293,006,119146,Deutsch; Alin Bernard,9999,0,9999,0
1668265460563,CSE 293,007,119159,Esmaeilzadeh; Hadi,9999,0,9999,0
1668265460563,CSE 293,008,119166,Freund; Yoav,9999,0,9999,0
1668265460563,CSE 293,009,119170,Griswold; William G.,9999,0,9999,0
1668265460563,CSE 293,010,119183,Gymrek; Melissa Ann,9999,0,9999,0
1668265460563,CSE 293,011,119190,Heninger; Nadia A,9999,0,9999,0
1668265460563,CSE 293,012,119230,Impagliazzo; Russell,9999,0,9999,0
1668265460563,CSE 293,013,119232,Jhala; Ranjit,9999,0,9999,0
1668265460563,CSE 293,014,119233,Kahng; Andrew Byun,9999,0,9999,0
1668265460563,CSE 293,015,119298,Kane; Daniel Mertz,9999,0,9999,0
1668265460563,CSE 293,016,119299,Kriegman; David J,9999,0,9999,0
1668265460563,CSE 293,017,119300,Kumar; Arun Kumar,9999,0,9999,0
1668265460563,CSE 293,018,119301,Lerner; Sorin,9999,0,9999,0
1668265460563,CSE 293,019,119302,Lovett; Shachar,9999,0,9999,0
1668265460563,CSE 293,020,119303,McAuley; Julian John,9999,0,9999,0
1668265460563,CSE 293,021,119304,Micciancio; Daniele,9999,0,9999,0
1668265460563,CSE 293,022,119367,Orailoglu; Alex,9999,0,9999,0
1668265460563,CSE 293,023,119382,Paturi; Ramamohan,9999,0,9999,0
1668265460563,CSE 293,024,119404,Polikarpova; Nadezhda,9999,0,9999,0
1668265460563,CSE 293,025,119406,Politz; Joseph Gibbs,9999,0,9999,0
1668265460563,CSE 293,026,119411,Porter; George M,9999,0,9999,0
1668265460563,CSE 293,027,119414,Porter; Leonard Emerson,9999,0,9999,0
1668265460563,CSE 293,028,119416,Ramamoorthi; Ravi,9999,0,9999,0
1668265460563,CSE 293,029,119417,Sahoo; Debashis,9999,0,9999,0
1668265460563,CSE 293,030,119420,Saul; Lawrence,9999,0,9999,0
1668265460563,CSE 293,031,119421,Savage; Stefan,9999,0,9999,0
1668265460563,CSE 293,032,119425,Schulze; Jurgen P.,9999,0,9999,0
1668265460563,CSE 293,033,119426,Snoeren; Alex C.,9999,0,9999,0
1668265460563,CSE 293,034,119428,Shang; Jingbo,9999,0,9999,0
1668265460563,CSE 293,035,119430,Stefan; Deian,9999,0,9999,0
1668265460563,CSE 293,036,119431,Su; Hao,9999,0,9999,0
1668265460563,CSE 293,037,119433,Swanson; Steven James,9999,0,9999,0
1668265460563,CSE 293,038,119435,Tullsen; Dean Michael,9999,0,9999,0
1668265460563,CSE 293,039,119483,Voelker; Geoffrey M.,9999,0,9999,0
1668265460563,CSE 293,040,119537,Zhao; Jishen,9999,0,9999,0
1668265460563,CSE 293,041,119538,Zhou; Yuan-Yuan,9999,0,9999,0
1668265460563,CSE 293,042,119539,Gao; Sicun,9999,0,9999,0
1668265460563,CSE 293,043,119540,Weibel; Nadir,9999,0,9999,0
1668265460563,CSE 293,044,119541,Gupta; Rajesh K.,9999,0,9999,0
1668265460563,CSE 293,045,126410,Vaccaro; Kristen Marie,9999,0,9999,0
1668265460563,CSE 293,046,126411,Klemke; Richard,9999,0,9999,0
1668265460998,CSE 294,A00,102459,Voelker; Geoffrey M.,0,0,0,0
1668265460998,CSE 294,B00,111322,Orailoglu; Alex,0,0,0,0
1668265461421,DSE 201,A00,096914,Deutsch; Alin Bernard,30,0,30,0
1668265461845,DSE 210,A00,096915,Dasgupta; Sanjoy,30,0,30,0
1668265462279,DSE 260A,A00,096916,Altintas De Callaf; Ilkay,30,0,30,0
1668265462712,ECE 200,001,103586,Antipa; Nicholas A,9999,0,9999,0
1668265462712,ECE 200,002,103587,Atanasov; Nikolay A.,9999,0,9999,0
1668265462712,ECE 200,003,103588,Bharadia; Dinesh,9999,0,9999,0
1668265462712,ECE 200,004,103589,Cheng; Chung Kuan,9999,0,9999,0
1668265462712,ECE 200,005,103590,Cosman; Pamela C.,9999,0,9999,0
1668265462712,ECE 200,006,103591,Dayeh; Shadi Ahmad,9999,0,9999,0
1668265462712,ECE 200,007,103592,Fainman; Yeshaiahu,9999,0,9999,0
1668265462712,ECE 200,008,103593,Ford; Joseph Earl,9999,0,9999,0
1668265462712,ECE 200,009,103594,Franceschetti; Massimo,9999,0,9999,0
1668265462712,ECE 200,010,103595,Fullerton; Eric E,9999,0,9999,0
1668265462712,ECE 200,011,103596,Galton; Ian A,9999,0,9999,0
1668265462712,ECE 200,012,103597,Gilja; Vikash,9999,0,9999,0
1668265462712,ECE 200,013,103598,Hall; Drew A.,9999,0,9999,0
1668265462712,ECE 200,014,103599,Hsueh; Tzu-Chien,9999,0,9999,0
1668265462712,ECE 200,015,103600,Javidi; Tara,9999,0,9999,0
1668265462712,ECE 200,016,103601,Kahng; Andrew Byun,9999,0,9999,0
1668265462712,ECE 200,017,103602,Kim; Young-Han,9999,0,9999,0
1668265462712,ECE 200,018,103603,Koushanfar; Farinaz,9999,0,9999,0
1668265462712,ECE 200,019,103604,Kuzum; Duygu,9999,0,9999,0
1668265462712,ECE 200,020,103605,Le; Hanh-Phuc,9999,0,9999,0
1668265462712,ECE 200,021,103606,Lin; Bill,9999,0,9999,0
1668265462712,ECE 200,022,103607,Liu; Zhaowei,9998,0,9999,1
1668265462712,ECE 200,023,103608,Lo; Yu-Hwa,9999,0,9999,0
1668265462712,ECE 200,024,103609,Lomakin; Vitaliy,9999,0,9999,0
1668265462712,ECE 200,025,103610,Mercier; Patrick Philip,9999,0,9999,0
1668265462712,ECE 200,026,103611,Meyer; Florian,9999,0,9999,0
1668265462712,ECE 200,027,103612,Milstein; Laurence B.,9999,0,9999,0
1668265462712,ECE 200,028,103613,Mir Arabbaygi; Siavash,9999,0,9999,0
1668265462712,ECE 200,029,103614,Mookherjea; Shayan,9999,0,9999,0
1668265462712,ECE 200,030,103615,Morris; Karcher William,9999,0,9999,0
1668265462712,ECE 200,031,103616,Ng; Tse Nga,9999,0,9999,0
1668265462712,ECE 200,032,103617,Nguyen; Truong Quang,9999,0,9999,0
1668265462712,ECE 200,033,103618,Nomura; Kenji,9999,0,9999,0
1668265462712,ECE 200,034,103619,Orlitsky; Alon,9999,0,9999,0
1668265462712,ECE 200,035,103620,Pal; Piya,9999,0,9999,0
1668265462712,ECE 200,036,103621,Papen; George C.,9999,0,9999,0
1668265462712,ECE 200,037,103622,Radic; Stojan,9999,0,9999,0
1668265462712,ECE 200,038,103623,Rao; Bhaskar D.,9999,0,9999,0
1668265462712,ECE 200,039,103624,Rao; Ramesh R,9999,0,9999,0
1668265462712,ECE 200,040,103625,Rebeiz; Gabriel,9999,0,9999,0
1668265462712,ECE 200,041,103626,Sanford; John R,9999,0,9999,0
1668265462712,ECE 200,042,103627,Siegel; Paul H.,9999,0,9999,0
1668265462712,ECE 200,043,103628,Sievenpiper; Daniel F.,9999,0,9999,0
1668265462712,ECE 200,044,103629,Sworder; David D.,9999,0,9999,0
1668265462712,ECE 200,045,103630,Taur; Yuan,9999,0,9999,0
1668265462712,ECE 200,046,103631,Touri; Behrouz,9999,0,9999,0
1668265462712,ECE 200,047,103632,Trivedi; Mohan M.,9999,0,9999,0
1668265462712,ECE 200,048,103633,Vasconcelos; Nuno,9999,0,9999,0
1668265462712,ECE 200,049,103634,Wang; Xiaolong,9999,0,9999,0
1668265462712,ECE 200,050,103635,Xie; Pengtao,9999,0,9999,0
1668265462712,ECE 200,051,103636,Yip; Michael,9999,0,9999,0
1668265462712,ECE 200,052,103637,Zeger; Kenneth A.,999,0,999,0
1668265462712,ECE 200,053,103638,Zhang; Xinyu,9999,0,9999,0
1668265462712,ECE 200,054,103639,Turakhia; Yatish Girish,9999,0,9999,0
1668265462712,ECE 200,055,103640,Kang; Mingu,9999,0,9999,0
1668265462712,ECE 200,056,103641,Shi; Yuanyuan,9999,0,9999,0
1668265462712,ECE 200,057,103642,Wang; Edward Jay,9999,0,9999,0
1668265462712,ECE 200,058,103643,Zheng; Yang,9999,0,9999,0
1668265463136,ECE 202,A00,103644,Kuzum; Duygu,0,0,0,0
1668265463558,ECE 212BN,A00,103646,Ng; Tse Nga,0,0,0,0
1668265463981,ECE 221,A00,111493,Staff,0,0,0,0
1668265464416,ECE 222B,A00,103647,Lomakin; Vitaliy,0,0,0,0
1668265464841,ECE 230B,A00,103648,Taur; Yuan,0,0,0,0
1668265465264,ECE 238B,A00,103649,Garay; Javier,0,0,0,0
1668265465697,ECE 240B,A00,112900,Fainman; Yeshaiahu,0,0,0,0
1668265466125,ECE 247A,A00,103650,Jokerst; Jesse Vincent,0,0,0,0
1668265466557,ECE 247B,A00,103651,Wang; Joseph,0,0,0,0
1668265466983,ECE 250,A00,103652,Siegel; Paul H.,0,0,0,0
1668265467423,ECE 251A,A00,103654,Rao; Bhaskar D.,0,0,0,0
1668265467846,ECE 257B,A00,103655,Bharadia; Dinesh,0,0,0,0
1668265468283,ECE 258A,A00,103656,Milstein; Laurence B.,0,0,0,0
1668265468706,ECE 260B,A00,103658,Kang; Mingu,0,0,0,0
1668265469135,ECE 264A,A00,103659,Galton; Ian A,0,0,0,0
1668265469560,ECE 265A,A00,103661,Gudem; Prasad S.S.,0,0,0,0
1668265469982,ECE 265D,A00,103662,Gudem; Prasad S.S.,0,0,0,0
1668265470412,ECE 268,A00,103663,Koushanfar; Farinaz,0,0,0,0
1668265470835,ECE 269,A01,103665,Pal; Piya,0,0,0,0
1668265471262,ECE 271B,A00,103666,Vasconcelos; Manuela,0,0,0,0
1668265471687,ECE 276A,A00,103667,Atanasov; Nikolay A.,0,0,0,0
1668265472109,ECE 277,A00,103668,An; Cheolhong,0,0,0,0
1668265472542,ECE 279,A00,117947,Hall; Drew A.,0,0,0,0
1668265473391,ECE 283,A00,103670,Hsueh; Tzu-Chien,0,0,0,0
1668265473813,ECE 284,A00,103671,Turakhia; Yatish Girish,0,0,0,0
1668265474245,ECE 285,A00,103672,Zheng; Yang,0,0,0,0
1668265474245,ECE 285,B00,103673,Sworder; David D.,0,0,0,0
1668265474684,ECE 287,A00,103676,Javidi; Tara,0,0,0,0
1668265475117,MATH 200B,A00,098023,Salehi Golsefidy; Alireza,12,0,15,3
1668265475540,MATH 202B,A00,098024,Rhoades; Brendon Patrick,9,0,15,6
1668265475994,MATH 203B,A00,098025,Oprea; Dragos N.,10,0,15,5
1668265476420,MATH 204B,A00,098026,Sorensen; Claus M,13,0,15,2
1668265476843,MATH 208,A00,098027,Izadi; Elham,7,0,10,3
1668265477267,MATH 209,A00,098028,Pollack; Aaron,10,0,10,0
1668265477697,MATH 211A,A00,112919,Rogalski; Daniel,9,0,10,1
1668265478120,MATH 211B,A00,112920,Seward; Brandon M.,9,0,10,1
1668265478556,MATH 218,A00,098029,Li; Bo,10,0,10,0
1668265478992,MATH 220B,A00,098030,Novak; Jonathan I,11,0,15,4
1668265479416,MATH 221A,A00,098031,Ebenfelt; Peter F,13,0,15,2
1668265479845,MATH 231B,A00,098032,Zlatos; Andrej,12,0,15,3
1668265480279,MATH 240B,A00,098033,Ni; Lei,9,0,15,6
1668265480702,MATH 243,A00,098034,Jekel; David Andrew,10,0,10,0
1668265481128,MATH 245A,A00,098035,Nie; Jiawang,0,0,15,16
1668265481554,MATH 248,A00,098036,Bejenaru; Ioan,10,0,10,0
1668265481984,MATH 250B,A00,098037,Spolaor; Luca,14,0,15,1
1668265482407,MATH 258,A00,098038,Ni; Lei,10,0,10,0
1668265482836,MATH 264B,A00,098041,Rhoades; Brendon Patrick,9,0,15,6
1668265483261,MATH 268,A00,098042,Buss; Samuel R,10,0,10,0
1668265483687,MATH 269,A00,098043,Rhoades; Brendon Patrick,10,0,10,0
1668265484114,MATH 270B,A00,098044,Li; Bo,10,0,15,5
1668265484544,MATH 272B,A00,098045,Holst; Michael J,13,0,15,2
1668265484967,MATH 273A,A00,098046,Tian; Xiaochuan,10,0,15,5
1668265485395,MATH 275,A01,098048,Tian; Xiaochuan,6,0,10,4
1668265485828,MATH 278A,A00,098049,Holst; Michael J,8,0,10,2
1668265486259,MATH 278B,A00,098050,Cloninger; Alexander,10,0,10,0
1668265486681,MATH 278C,A00,098051,Nie; Jiawang,7,0,10,3
1668265487113,MATH 280B,A00,098052,Zheng; Tianyi,9,0,15,6
1668265487544,MATH 281B,A00,098053,Bradic; Jelena,1,0,15,14
1668265487972,MATH 282B,A00,098054,Arias-Castro; Ery,0,0,15,15
1668265488511,MATH 285,A00,098055,Fitzsimmons; Patrick J,0,0,15,17
1668265488936,MATH 287B,A00,098056,Arias-Castro; Ery,2,0,15,13
1668265489359,MATH 288,A00,098057,Agarwal; Pooja,9,0,10,1
1668265489359,MATH 288,B00,098058,Zhang; Danna,8,0,10,2
1668265489359,MATH 288,C00,098059,Williams; Ruth J,10,0,10,0
1668265489795,MATH 290B,A00,098060,Roberts; Justin Deritter,13,0,15,2
1668265490231,MATH 292,A00,098061,Belmont; Eva Kinoshita,10,0,10,0
1668265490657,MATH 295,A00,098062,Suk; Andrew Hoon,48,0,50,2
1668265491081,MATH 296,A00,098063,Novak; Jonathan I,20,0,20,0
1668265491509,MATH 297,001,098064,Gamst; Anthony Collins,9997,0,9999,2
1668265994113,COGS 205,A00,101395,Chiba; Andrea,19,0,20,1
1668265994538,COGS 210B,001,101404,Greene; Deanna Jacquelyn,9998,0,9999,1
1668265994538,COGS 210B,002,101417,Xia; Haijun,9999,0,9999,0
1668265994538,COGS 210B,003,101422,Nitz; Douglas A.,9999,0,9999,0
1668265994538,COGS 210B,004,101423,Hollan; James D.,9998,0,9999,1
1668265994538,COGS 210B,005,101424,Deak; Gedeon O.,9998,0,9999,1
1668265994538,COGS 210B,006,101425,Rossano; Federico,9999,0,9999,0
1668265994962,COGS 211B,A00,101427,Coulson; Seana M,9996,0,9999,3
1668265995383,COGS 220,A00,101428,Hollan; James D.,0,0,25,25
1668265995817,COGS 229,A00,101429,Dow; Steven P,18,0,25,7
1668265996258,COGS 230,A00,101430,Klemmer; Scott R,12,0,17,5
1668265996688,COGS 234,A00,101431,Xia; Haijun,2,0,25,23
1668265997115,COGS 260,A00,101432,Kiyonaga; Anastasia,21,0,25,4
1668265997115,COGS 260,B00,101433,Kirsh; David Joel,15,0,25,10
1668265997541,CSE 202,A00,102371,Impagliazzo; Russell,0,0,0,0
1668265997969,CSE 203B,A01,102373,Cheng; Chung Kuan,0,0,0,0
1668265998396,CSE 208,A00,102374,Micciancio; Daniele,0,0,0,0
1668265998831,CSE 209A,A00,112895,Impagliazzo; Russell,0,0,15,15
1668265999256,CSE 209B,A00,108005,Bellare; Mihir,0,0,0,0
1668265999678,CSE 210,A00,113163,Coblenz; Michael J,0,0,0,0
1668266000105,CSE 219,A00,106111,Dow; Steven P,0,0,20,20
1668266000534,CSE 221,A00,102376,Voelker; Geoffrey M.,0,0,0,0
1668266000957,CSE 224,A01,102378,Porter; George M,0,0,0,0
1668266001382,CSE 229A,A00,102379,Savage; Stefan,0,0,0,0
1668266001804,CSE 229C,A00,102380,Munyaka; Imani N. S.,0,0,0,0
1668266002229,CSE 232B,A00,102382,Deutsch; Alin Bernard,0,0,0,0
1668266002667,CSE 234,A01,112904,Kumar; Arun Kumar,0,0,0,0
1668266003089,CSE 237A,A00,102383,Rosing; Tajana Simunic,0,0,0,0
1668266003511,CSE 239A,A00,102384,Deutsch; Alin Bernard,0,0,0,0
1668266003943,CSE 239B,A00,102385,Polikarpova; Nadezhda,0,0,0,0
1668266004367,CSE 240A,A00,102386,Pannuto; Patrick William,0,0,0,0
1668266004792,CSE 240B,A00,102387,Zhao; Jishen,0,0,0,0
1668266005218,CSE 241A,A00,106406,Kang; Mingu,0,0,0,0
1668266005644,CSE 249B,A00,102388,Kahng; Andrew Byun,0,0,8,8
1668266006067,CSE 251B,A01,102392,Cottrell; Garrison W,0,0,0,0
1668266006067,CSE 251B,A02,102393,Cottrell; Garrison W,0,0,0,0
1668266006493,CSE 252B,A00,102394,Ochoa; Benjamin Lawrence,0,0,0,0
1668266006929,CSE 257,A01,102396,Gao; Sicun,0,0,0,0
1668266007362,CSE 272,A00,102397,Li; Tzumao,0,0,0,0
1668266007789,CSE 274,A00,111323,Chern; Albert Ren-Haur,0,0,0,0
1668266008218,CSE 282,A00,102398,Pevzner; Pavel Arkadjevich,0,0,0,0
1668266008648,CSE 284,A00,114175,Gymrek; Melissa Ann,0,0,0,0
1668266009076,CSE 290,A00,102399,Chandraker; Manmohan Krishna,0,0,0,0
1668266009076,CSE 290,B00,102400,Vaccaro; Kristen Marie,0,0,25,25
1668266009076,CSE 290,C00,102414,Pannuto; Patrick William,0,0,25,25
1668266009076,CSE 290,D00,102427,Pevzner; Pavel Arkadjevich,0,0,0,0
1668266009076,CSE 290,E00,102429,Zhao; Jishen,0,0,0,0
1668266009076,CSE 290,F00,102436,Tullsen; Dean Michael,0,0,0,0
1668266009076,CSE 290,G00,102440,Christensen; Henrik I,0,0,20,20
1668266009509,CSE 291,A00,102443,Su; Hao,0,0,0,0
1668266009509,CSE 291,B00,102448,Polikarpova; Nadezhda,0,0,0,0
1668266009509,CSE 291,C00,102453,Vaccaro; Kristen Marie,0,0,0,0
1668266009509,CSE 291,D00,111343,Savage; Stefan,0,0,0,0
1668266009509,CSE 291,E00,116474,Claffy; Kimberly Claire,0,0,0,0
1668266009509,CSE 291,F00,116479,Pasquale; Joseph,0,0,0,0
1668266009936,CSE 293,001,119111,Bafna; Vineet,9999,0,9999,0
1668266009936,CSE 293,002,119118,Bellare; Mihir,9999,0,9999,0
1668266009936,CSE 293,003,119122,Berg-Kirkpatrick; Taylor D,9999,0,9999,0
1668266009936,CSE 293,004,119135,Christensen; Henrik I,9999,0,9999,0
1668266009936,CSE 293,005,119142,Cottrell; Garrison W,9999,0,9999,0
1668266009936,CSE 293,006,119146,Deutsch; Alin Bernard,9999,0,9999,0
1668266009936,CSE 293,007,119159,Esmaeilzadeh; Hadi,9999,0,9999,0
1668266009936,CSE 293,008,119166,Freund; Yoav,9999,0,9999,0
1668266009936,CSE 293,009,119170,Griswold; William G.,9999,0,9999,0
1668266009936,CSE 293,010,119183,Gymrek; Melissa Ann,9999,0,9999,0
1668266009936,CSE 293,011,119190,Heninger; Nadia A,9999,0,9999,0
1668266009936,CSE 293,012,119230,Impagliazzo; Russell,9999,0,9999,0
1668266009936,CSE 293,013,119232,Jhala; Ranjit,9999,0,9999,0
1668266009936,CSE 293,014,119233,Kahng; Andrew Byun,9999,0,9999,0
1668266009936,CSE 293,015,119298,Kane; Daniel Mertz,9999,0,9999,0
1668266009936,CSE 293,016,119299,Kriegman; David J,9999,0,9999,0
1668266009936,CSE 293,017,119300,Kumar; Arun Kumar,9999,0,9999,0
1668266009936,CSE 293,018,119301,Lerner; Sorin,9999,0,9999,0
1668266009936,CSE 293,019,119302,Lovett; Shachar,9999,0,9999,0
1668266009936,CSE 293,020,119303,McAuley; Julian John,9999,0,9999,0
1668266009936,CSE 293,021,119304,Micciancio; Daniele,9999,0,9999,0
1668266009936,CSE 293,022,119367,Orailoglu; Alex,9999,0,9999,0
1668266009936,CSE 293,023,119382,Paturi; Ramamohan,9999,0,9999,0
1668266009936,CSE 293,024,119404,Polikarpova; Nadezhda,9999,0,9999,0
1668266009936,CSE 293,025,119406,Politz; Joseph Gibbs,9999,0,9999,0
1668266009936,CSE 293,026,119411,Porter; George M,9999,0,9999,0
1668266009936,CSE 293,027,119414,Porter; Leonard Emerson,9999,0,9999,0
1668266009936,CSE 293,028,119416,Ramamoorthi; Ravi,9999,0,9999,0
1668266009936,CSE 293,029,119417,Sahoo; Debashis,9999,0,9999,0
1668266009936,CSE 293,030,119420,Saul; Lawrence,9999,0,9999,0
1668266009936,CSE 293,031,119421,Savage; Stefan,9999,0,9999,0
1668266009936,CSE 293,032,119425,Schulze; Jurgen P.,9999,0,9999,0
1668266009936,CSE 293,033,119426,Snoeren; Alex C.,9999,0,9999,0
1668266009936,CSE 293,034,119428,Shang; Jingbo,9999,0,9999,0
1668266009936,CSE 293,035,119430,Stefan; Deian,9999,0,9999,0
1668266009936,CSE 293,036,119431,Su; Hao,9999,0,9999,0
1668266009936,CSE 293,037,119433,Swanson; Steven James,9999,0,9999,0
1668266009936,CSE 293,038,119435,Tullsen; Dean Michael,9999,0,9999,0
1668266009936,CSE 293,039,119483,Voelker; Geoffrey M.,9999,0,9999,0
1668266009936,CSE 293,040,119537,Zhao; Jishen,9999,0,9999,0
1668266009936,CSE 293,041,119538,Zhou; Yuan-Yuan,9999,0,9999,0
1668266009936,CSE 293,042,119539,Gao; Sicun,9999,0,9999,0
1668266009936,CSE 293,043,119540,Weibel; Nadir,9999,0,9999,0
1668266009936,CSE 293,044,119541,Gupta; Rajesh K.,9999,0,9999,0
1668266009936,CSE 293,045,126410,Vaccaro; Kristen Marie,9999,0,9999,0
1668266009936,CSE 293,046,126411,Klemke; Richard,9999,0,9999,0
1668266010363,CSE 294,A00,102459,Voelker; Geoffrey M.,0,0,0,0
1668266010363,CSE 294,B00,111322,Orailoglu; Alex,0,0,0,0
1668266010786,DSE 201,A00,096914,Deutsch; Alin Bernard,30,0,30,0
1668266011305,DSE 210,A00,096915,Dasgupta; Sanjoy,30,0,30,0
1668266011728,DSE 260A,A00,096916,Altintas De Callaf; Ilkay,30,0,30,0
1668266012190,ECE 200,001,103586,Antipa; Nicholas A,9999,0,9999,0
1668266012190,ECE 200,002,103587,Atanasov; Nikolay A.,9999,0,9999,0
1668266012190,ECE 200,003,103588,Bharadia; Dinesh,9999,0,9999,0
1668266012190,ECE 200,004,103589,Cheng; Chung Kuan,9999,0,9999,0
1668266012190,ECE 200,005,103590,Cosman; Pamela C.,9999,0,9999,0
1668266012190,ECE 200,006,103591,Dayeh; Shadi Ahmad,9999,0,9999,0
1668266012190,ECE 200,007,103592,Fainman; Yeshaiahu,9999,0,9999,0
1668266012190,ECE 200,008,103593,Ford; Joseph Earl,9999,0,9999,0
1668266012190,ECE 200,009,103594,Franceschetti; Massimo,9999,0,9999,0
1668266012190,ECE 200,010,103595,Fullerton; Eric E,9999,0,9999,0
1668266012190,ECE 200,011,103596,Galton; Ian A,9999,0,9999,0
1668266012190,ECE 200,012,103597,Gilja; Vikash,9999,0,9999,0
1668266012190,ECE 200,013,103598,Hall; Drew A.,9999,0,9999,0
1668266012190,ECE 200,014,103599,Hsueh; Tzu-Chien,9999,0,9999,0
1668266012190,ECE 200,015,103600,Javidi; Tara,9999,0,9999,0
1668266012190,ECE 200,016,103601,Kahng; Andrew Byun,9999,0,9999,0
1668266012190,ECE 200,017,103602,Kim; Young-Han,9999,0,9999,0
1668266012190,ECE 200,018,103603,Koushanfar; Farinaz,9999,0,9999,0
1668266012190,ECE 200,019,103604,Kuzum; Duygu,9999,0,9999,0
1668266012190,ECE 200,020,103605,Le; Hanh-Phuc,9999,0,9999,0
1668266012190,ECE 200,021,103606,Lin; Bill,9999,0,9999,0
1668266012190,ECE 200,022,103607,Liu; Zhaowei,9998,0,9999,1
1668266012190,ECE 200,023,103608,Lo; Yu-Hwa,9999,0,9999,0
1668266012190,ECE 200,024,103609,Lomakin; Vitaliy,9999,0,9999,0
1668266012190,ECE 200,025,103610,Mercier; Patrick Philip,9999,0,9999,0
1668266012190,ECE 200,026,103611,Meyer; Florian,9999,0,9999,0
1668266012190,ECE 200,027,103612,Milstein; Laurence B.,9999,0,9999,0
1668266012190,ECE 200,028,103613,Mir Arabbaygi; Siavash,9999,0,9999,0
1668266012190,ECE 200,029,103614,Mookherjea; Shayan,9999,0,9999,0
1668266012190,ECE 200,030,103615,Morris; Karcher William,9999,0,9999,0
1668266012190,ECE 200,031,103616,Ng; Tse Nga,9999,0,9999,0
1668266012190,ECE 200,032,103617,Nguyen; Truong Quang,9999,0,9999,0
1668266012190,ECE 200,033,103618,Nomura; Kenji,9999,0,9999,0
1668266012190,ECE 200,034,103619,Orlitsky; Alon,9999,0,9999,0
1668266012190,ECE 200,035,103620,Pal; Piya,9999,0,9999,0
1668266012190,ECE 200,036,103621,Papen; George C.,9999,0,9999,0
1668266012190,ECE 200,037,103622,Radic; Stojan,9999,0,9999,0
1668266012190,ECE 200,038,103623,Rao; Bhaskar D.,9999,0,9999,0
1668266012190,ECE 200,039,103624,Rao; Ramesh R,9999,0,9999,0
1668266012190,ECE 200,040,103625,Rebeiz; Gabriel,9999,0,9999,0
1668266012190,ECE 200,041,103626,Sanford; John R,9999,0,9999,0
1668266012190,ECE 200,042,103627,Siegel; Paul H.,9999,0,9999,0
1668266012190,ECE 200,043,103628,Sievenpiper; Daniel F.,9999,0,9999,0
1668266012190,ECE 200,044,103629,Sworder; David D.,9999,0,9999,0
1668266012190,ECE 200,045,103630,Taur; Yuan,9999,0,9999,0
1668266012190,ECE 200,046,103631,Touri; Behrouz,9999,0,9999,0
1668266012190,ECE 200,047,103632,Trivedi; Mohan M.,9999,0,9999,0
1668266012190,ECE 200,048,103633,Vasconcelos; Nuno,9999,0,9999,0
1668266012190,ECE 200,049,103634,Wang; Xiaolong,9999,0,9999,0
1668266012190,ECE 200,050,103635,Xie; Pengtao,9999,0,9999,0
1668266012190,ECE 200,051,103636,Yip; Michael,9999,0,9999,0
1668266012190,ECE 200,052,103637,Zeger; Kenneth A.,999,0,999,0
1668266012190,ECE 200,053,103638,Zhang; Xinyu,9999,0,9999,0
1668266012190,ECE 200,054,103639,Turakhia; Yatish Girish,9999,0,9999,0
1668266012190,ECE 200,055,103640,Kang; Mingu,9999,0,9999,0
1668266012190,ECE 200,056,103641,Shi; Yuanyuan,9999,0,9999,0
1668266012190,ECE 200,057,103642,Wang; Edward Jay,9999,0,9999,0
1668266012190,ECE 200,058,103643,Zheng; Yang,9999,0,9999,0
1668266012617,ECE 202,A00,103644,Kuzum; Duygu,0,0,0,0
1668266013046,ECE 212BN,A00,103646,Ng; Tse Nga,0,0,0,0
1668266013471,ECE 221,A00,111493,Staff,0,0,0,0
1668266013895,ECE 222B,A00,103647,Lomakin; Vitaliy,0,0,0,0
1668266014319,ECE 230B,A00,103648,Taur; Yuan,0,0,0,0
1668266014754,ECE 238B,A00,103649,Garay; Javier,0,0,0,0
1668266015179,ECE 240B,A00,112900,Fainman; Yeshaiahu,0,0,0,0
1668266015609,ECE 247A,A00,103650,Jokerst; Jesse Vincent,0,0,0,0
1668266016031,ECE 247B,A00,103651,Wang; Joseph,0,0,0,0
1668266016459,ECE 250,A00,103652,Siegel; Paul H.,0,0,0,0
1668266016897,ECE 251A,A00,103654,Rao; Bhaskar D.,0,0,0,0
1668266017322,ECE 257B,A00,103655,Bharadia; Dinesh,0,0,0,0
1668266017746,ECE 258A,A00,103656,Milstein; Laurence B.,0,0,0,0
1668266018171,ECE 260B,A00,103658,Kang; Mingu,0,0,0,0
1668266018599,ECE 264A,A00,103659,Galton; Ian A,0,0,0,0
1668266019032,ECE 265A,A00,103661,Gudem; Prasad S.S.,0,0,0,0
1668266019459,ECE 265D,A00,103662,Gudem; Prasad S.S.,0,0,0,0
1668266019886,ECE 268,A00,103663,Koushanfar; Farinaz,0,0,0,0
1668266020315,ECE 269,A01,103665,Pal; Piya,0,0,0,0
1668266020739,ECE 271B,A00,103666,Vasconcelos; Manuela,0,0,0,0
1668266021162,ECE 276A,A00,103667,Atanasov; Nikolay A.,0,0,0,0
1668266021595,ECE 277,A00,103668,An; Cheolhong,0,0,0,0
1668266022024,ECE 279,A00,117947,Hall; Drew A.,0,0,0,0
1668266022877,ECE 283,A00,103670,Hsueh; Tzu-Chien,0,0,0,0
1668266023302,ECE 284,A00,103671,Turakhia; Yatish Girish,0,0,0,0
1668266023726,ECE 285,A00,103672,Zheng; Yang,0,0,0,0
1668266023726,ECE 285,B00,103673,Sworder; David D.,0,0,0,0
1668266024150,ECE 287,A00,103676,Javidi; Tara,0,0,0,0
1668266024573,MATH 200B,A00,098023,Salehi Golsefidy; Alireza,12,0,15,3
1668266024996,MATH 202B,A00,098024,Rhoades; Brendon Patrick,9,0,15,6
1668266025439,MATH 203B,A00,098025,Oprea; Dragos N.,10,0,15,5
1668266025875,MATH 204B,A00,098026,Sorensen; Claus M,13,0,15,2
1668266026301,MATH 208,A00,098027,Izadi; Elham,7,0,10,3
1668266026726,MATH 209,A00,098028,Pollack; Aaron,10,0,10,0
1668266027149,MATH 211A,A00,112919,Rogalski; Daniel,9,0,10,1
1668266027585,MATH 211B,A00,112920,Seward; Brandon M.,9,0,10,1
1668266028027,MATH 218,A00,098029,Li; Bo,10,0,10,0
1668266028450,MATH 220B,A00,098030,Novak; Jonathan I,11,0,15,4
1668266028881,MATH 221A,A00,098031,Ebenfelt; Peter F,13,0,15,2
1668266029305,MATH 231B,A00,098032,Zlatos; Andrej,12,0,15,3
1668266029743,MATH 240B,A00,098033,Ni; Lei,9,0,15,6
1668266030169,MATH 243,A00,098034,Jekel; David Andrew,10,0,10,0
1668266030597,MATH 245A,A00,098035,Nie; Jiawang,0,0,15,16
1668266031018,MATH 248,A00,098036,Bejenaru; Ioan,10,0,10,0
1668266031445,MATH 250B,A00,098037,Spolaor; Luca,14,0,15,1
1668266031870,MATH 258,A00,098038,Ni; Lei,10,0,10,0
1668266032297,MATH 264B,A00,098041,Rhoades; Brendon Patrick,9,0,15,6
1668266032722,MATH 268,A00,098042,Buss; Samuel R,10,0,10,0
1668266033146,MATH 269,A00,098043,Rhoades; Brendon Patrick,10,0,10,0
1668266033580,MATH 270B,A00,098044,Li; Bo,10,0,15,5
1668266034006,MATH 272B,A00,098045,Holst; Michael J,13,0,15,2
1668266034446,MATH 273A,A00,098046,Tian; Xiaochuan,10,0,15,5
1668266034875,MATH 275,A01,098048,Tian; Xiaochuan,6,0,10,4
1668266035300,MATH 278A,A00,098049,Holst; Michael J,8,0,10,2
1668266035733,MATH 278B,A00,098050,Cloninger; Alexander,10,0,10,0
1668266036167,MATH 278C,A00,098051,Nie; Jiawang,7,0,10,3
1668266036592,MATH 280B,A00,098052,Zheng; Tianyi,9,0,15,6
1668266037020,MATH 281B,A00,098053,Bradic; Jelena,1,0,15,14
1668266037446,MATH 282B,A00,098054,Arias-Castro; Ery,0,0,15,15
1668266037878,MATH 285,A00,098055,Fitzsimmons; Patrick J,0,0,15,17
1668266038304,MATH 287B,A00,098056,Arias-Castro; Ery,2,0,15,13
1668266038726,MATH 288,A00,098057,Agarwal; Pooja,9,0,10,1
1668266038726,MATH 288,B00,098058,Zhang; Danna,8,0,10,2
1668266038726,MATH 288,C00,098059,Williams; Ruth J,10,0,10,0
1668266039164,MATH 290B,A00,098060,Roberts; Justin Deritter,13,0,15,2
1668266039588,MATH 292,A00,098061,Belmont; Eva Kinoshita,10,0,10,0
1668266040025,MATH 295,A00,098062,Suk; Andrew Hoon,48,0,50,2
1668266040450,MATH 296,A00,098063,Novak; Jonathan I,20,0,20,0
1668266040876,MATH 297,001,098064,Gamst; Anthony Collins,9997,0,9999,2
1668266542631,COGS 205,A00,101395,Chiba; Andrea,19,0,20,1
1668266543066,COGS 210B,001,101404,Greene; Deanna Jacquelyn,9998,0,9999,1
1668266543066,COGS 210B,002,101417,Xia; Haijun,9999,0,9999,0
1668266543066,COGS 210B,003,101422,Nitz; Douglas A.,9999,0,9999,0
1668266543066,COGS 210B,004,101423,Hollan; James D.,9998,0,9999,1
1668266543066,COGS 210B,005,101424,Deak; Gedeon O.,9998,0,9999,1
1668266543066,COGS 210B,006,101425,Rossano; Federico,9999,0,9999,0
1668266543491,COGS 211B,A00,101427,Coulson; Seana M,9996,0,9999,3
1668266543923,COGS 220,A00,101428,Hollan; James D.,0,0,25,25
1668266544353,COGS 229,A00,101429,Dow; Steven P,18,0,25,7
1668266544777,COGS 230,A00,101430,Klemmer; Scott R,12,0,17,5
1668266545204,COGS 234,A00,101431,Xia; Haijun,2,0,25,23
1668266545628,COGS 260,A00,101432,Kiyonaga; Anastasia,21,0,25,4
1668266545628,COGS 260,B00,101433,Kirsh; David Joel,15,0,25,10
1668266546057,CSE 202,A00,102371,Impagliazzo; Russell,0,0,0,0
1668266546483,CSE 203B,A01,102373,Cheng; Chung Kuan,0,0,0,0
1668266546914,CSE 208,A00,102374,Micciancio; Daniele,0,0,0,0
1668266547338,CSE 209A,A00,112895,Impagliazzo; Russell,0,0,15,15
1668266547765,CSE 209B,A00,108005,Bellare; Mihir,0,0,0,0
1668266548191,CSE 210,A00,113163,Coblenz; Michael J,0,0,0,0
1668266548616,CSE 219,A00,106111,Dow; Steven P,0,0,20,20
1668266549048,CSE 221,A00,102376,Voelker; Geoffrey M.,0,0,0,0
1668266549488,CSE 224,A01,102378,Porter; George M,0,0,0,0
1668266549913,CSE 229A,A00,102379,Savage; Stefan,0,0,0,0
1668266550352,CSE 229C,A00,102380,Munyaka; Imani N. S.,0,0,0,0
1668266550776,CSE 232B,A00,102382,Deutsch; Alin Bernard,0,0,0,0
1668266551207,CSE 234,A01,112904,Kumar; Arun Kumar,0,0,0,0
1668266551632,CSE 237A,A00,102383,Rosing; Tajana Simunic,0,0,0,0
1668266552060,CSE 239A,A00,102384,Deutsch; Alin Bernard,0,0,0,0
1668266552484,CSE 239B,A00,102385,Polikarpova; Nadezhda,0,0,0,0
1668266552911,CSE 240A,A00,102386,Pannuto; Patrick William,0,0,0,0
1668266553334,CSE 240B,A00,102387,Zhao; Jishen,0,0,0,0
1668266553764,CSE 241A,A00,106406,Kang; Mingu,0,0,0,0
1668266554188,CSE 249B,A00,102388,Kahng; Andrew Byun,0,0,8,8
1668266554613,CSE 251B,A01,102392,Cottrell; Garrison W,0,0,0,0
1668266554613,CSE 251B,A02,102393,Cottrell; Garrison W,0,0,0,0
1668266555036,CSE 252B,A00,102394,Ochoa; Benjamin Lawrence,0,0,0,0
1668266555470,CSE 257,A01,102396,Gao; Sicun,0,0,0,0
1668266555896,CSE 272,A00,102397,Li; Tzumao,0,0,0,0
1668266556335,CSE 274,A00,111323,Chern; Albert Ren-Haur,0,0,0,0
1668266556766,CSE 282,A00,102398,Pevzner; Pavel Arkadjevich,0,0,0,0
1668266557188,CSE 284,A00,114175,Gymrek; Melissa Ann,0,0,0,0
1668266557614,CSE 290,A00,102399,Chandraker; Manmohan Krishna,0,0,0,0
1668266557614,CSE 290,B00,102400,Vaccaro; Kristen Marie,0,0,25,25
1668266557614,CSE 290,C00,102414,Pannuto; Patrick William,0,0,25,25
1668266557614,CSE 290,D00,102427,Pevzner; Pavel Arkadjevich,0,0,0,0
1668266557614,CSE 290,E00,102429,Zhao; Jishen,0,0,0,0
1668266557614,CSE 290,F00,102436,Tullsen; Dean Michael,0,0,0,0
1668266557614,CSE 290,G00,102440,Christensen; Henrik I,0,0,20,20
1668266558039,CSE 291,A00,102443,Su; Hao,0,0,0,0
1668266558039,CSE 291,B00,102448,Polikarpova; Nadezhda,0,0,0,0
1668266558039,CSE 291,C00,102453,Vaccaro; Kristen Marie,0,0,0,0
1668266558039,CSE 291,D00,111343,Savage; Stefan,0,0,0,0
1668266558039,CSE 291,E00,116474,Claffy; Kimberly Claire,0,0,0,0
1668266558039,CSE 291,F00,116479,Pasquale; Joseph,0,0,0,0
1668266558465,CSE 293,001,119111,Bafna; Vineet,9999,0,9999,0
1668266558465,CSE 293,002,119118,Bellare; Mihir,9999,0,9999,0
1668266558465,CSE 293,003,119122,Berg-Kirkpatrick; Taylor D,9999,0,9999,0
1668266558465,CSE 293,004,119135,Christensen; Henrik I,9999,0,9999,0
1668266558465,CSE 293,005,119142,Cottrell; Garrison W,9999,0,9999,0
1668266558465,CSE 293,006,119146,Deutsch; Alin Bernard,9999,0,9999,0
1668266558465,CSE 293,007,119159,Esmaeilzadeh; Hadi,9999,0,9999,0
1668266558465,CSE 293,008,119166,Freund; Yoav,9999,0,9999,0
1668266558465,CSE 293,009,119170,Griswold; William G.,9999,0,9999,0
1668266558465,CSE 293,010,119183,Gymrek; Melissa Ann,9999,0,9999,0
1668266558465,CSE 293,011,119190,Heninger; Nadia A,9999,0,9999,0
1668266558465,CSE 293,012,119230,Impagliazzo; Russell,9999,0,9999,0
1668266558465,CSE 293,013,119232,Jhala; Ranjit,9999,0,9999,0
1668266558465,CSE 293,014,119233,Kahng; Andrew Byun,9999,0,9999,0
1668266558465,CSE 293,015,119298,Kane; Daniel Mertz,9999,0,9999,0
1668266558465,CSE 293,016,119299,Kriegman; David J,9999,0,9999,0
1668266558465,CSE 293,017,119300,Kumar; Arun Kumar,9999,0,9999,0
1668266558465,CSE 293,018,119301,Lerner; Sorin,9999,0,9999,0
1668266558465,CSE 293,019,119302,Lovett; Shachar,9999,0,9999,0
1668266558465,CSE 293,020,119303,McAuley; Julian John,9999,0,9999,0
1668266558465,CSE 293,021,119304,Micciancio; Daniele,9999,0,9999,0
1668266558465,CSE 293,022,119367,Orailoglu; Alex,9999,0,9999,0
1668266558465,CSE 293,023,119382,Paturi; Ramamohan,9999,0,9999,0
1668266558465,CSE 293,024,119404,Polikarpova; Nadezhda,9999,0,9999,0
1668266558465,CSE 293,025,119406,Politz; Joseph Gibbs,9999,0,9999,0
1668266558465,CSE 293,026,119411,Porter; George M,9999,0,9999,0
1668266558465,CSE 293,027,119414,Porter; Leonard Emerson,9999,0,9999,0
1668266558465,CSE 293,028,119416,Ramamoorthi; Ravi,9999,0,9999,0
1668266558465,CSE 293,029,119417,Sahoo; Debashis,9999,0,9999,0
1668266558465,CSE 293,030,119420,Saul; Lawrence,9999,0,9999,0
1668266558465,CSE 293,031,119421,Savage; Stefan,9999,0,9999,0
1668266558465,CSE 293,032,119425,Schulze; Jurgen P.,9999,0,9999,0
1668266558465,CSE 293,033,119426,Snoeren; Alex C.,9999,0,9999,0
1668266558465,CSE 293,034,119428,Shang; Jingbo,9999,0,9999,0
1668266558465,CSE 293,035,119430,Stefan; Deian,9999,0,9999,0
1668266558465,CSE 293,036,119431,Su; Hao,9999,0,9999,0
1668266558465,CSE 293,037,119433,Swanson; Steven James,9999,0,9999,0
1668266558465,CSE 293,038,119435,Tullsen; Dean Michael,9999,0,9999,0
1668266558465,CSE 293,039,119483,Voelker; Geoffrey M.,9999,0,9999,0
1668266558465,CSE 293,040,119537,Zhao; Jishen,9999,0,9999,0
1668266558465,CSE 293,041,119538,Zhou; Yuan-Yuan,9999,0,9999,0
1668266558465,CSE 293,042,119539,Gao; Sicun,9999,0,9999,0
1668266558465,CSE 293,043,119540,Weibel; Nadir,9999,0,9999,0
1668266558465,CSE 293,044,119541,Gupta; Rajesh K.,9999,0,9999,0
1668266558465,CSE 293,045,126410,Vaccaro; Kristen Marie,9999,0,9999,0
1668266558465,CSE 293,046,126411,Klemke; Richard,9999,0,9999,0
1668266558897,CSE 294,A00,102459,Voelker; Geoffrey M.,0,0,0,0
1668266558897,CSE 294,B00,111322,Orailoglu; Alex,0,0,0,0
1668266559319,DSE 201,A00,096914,Deutsch; Alin Bernard,30,0,30,0
1668266559746,DSE 210,A00,096915,Dasgupta; Sanjoy,30,0,30,0
1668266560170,DSE 260A,A00,096916,Altintas De Callaf; Ilkay,30,0,30,0
1668266560598,ECE 200,001,103586,Antipa; Nicholas A,9999,0,9999,0
1668266560598,ECE 200,002,103587,Atanasov; Nikolay A.,9999,0,9999,0
1668266560598,ECE 200,003,103588,Bharadia; Dinesh,9999,0,9999,0
1668266560598,ECE 200,004,103589,Cheng; Chung Kuan,9999,0,9999,0
1668266560598,ECE 200,005,103590,Cosman; Pamela C.,9999,0,9999,0
1668266560598,ECE 200,006,103591,Dayeh; Shadi Ahmad,9999,0,9999,0
1668266560598,ECE 200,007,103592,Fainman; Yeshaiahu,9999,0,9999,0
1668266560598,ECE 200,008,103593,Ford; Joseph Earl,9999,0,9999,0
1668266560598,ECE 200,009,103594,Franceschetti; Massimo,9999,0,9999,0
1668266560598,ECE 200,010,103595,Fullerton; Eric E,9999,0,9999,0
1668266560598,ECE 200,011,103596,Galton; Ian A,9999,0,9999,0
1668266560598,ECE 200,012,103597,Gilja; Vikash,9999,0,9999,0
1668266560598,ECE 200,013,103598,Hall; Drew A.,9999,0,9999,0
1668266560598,ECE 200,014,103599,Hsueh; Tzu-Chien,9999,0,9999,0
1668266560598,ECE 200,015,103600,Javidi; Tara,9999,0,9999,0
1668266560598,ECE 200,016,103601,Kahng; Andrew Byun,9999,0,9999,0
1668266560598,ECE 200,017,103602,Kim; Young-Han,9999,0,9999,0
1668266560598,ECE 200,018,103603,Koushanfar; Farinaz,9999,0,9999,0
1668266560598,ECE 200,019,103604,Kuzum; Duygu,9999,0,9999,0
1668266560598,ECE 200,020,103605,Le; Hanh-Phuc,9999,0,9999,0
1668266560598,ECE 200,021,103606,Lin; Bill,9999,0,9999,0
1668266560598,ECE 200,022,103607,Liu; Zhaowei,9998,0,9999,1
1668266560598,ECE 200,023,103608,Lo; Yu-Hwa,9999,0,9999,0
1668266560598,ECE 200,024,103609,Lomakin; Vitaliy,9999,0,9999,0
1668266560598,ECE 200,025,103610,Mercier; Patrick Philip,9999,0,9999,0
1668266560598,ECE 200,026,103611,Meyer; Florian,9999,0,9999,0
1668266560598,ECE 200,027,103612,Milstein; Laurence B.,9999,0,9999,0
1668266560598,ECE 200,028,103613,Mir Arabbaygi; Siavash,9999,0,9999,0
1668266560598,ECE 200,029,103614,Mookherjea; Shayan,9999,0,9999,0
1668266560598,ECE 200,030,103615,Morris; Karcher William,9999,0,9999,0
1668266560598,ECE 200,031,103616,Ng; Tse Nga,9999,0,9999,0
1668266560598,ECE 200,032,103617,Nguyen; Truong Quang,9999,0,9999,0
1668266560598,ECE 200,033,103618,Nomura; Kenji,9999,0,9999,0
1668266560598,ECE 200,034,103619,Orlitsky; Alon,9999,0,9999,0
1668266560598,ECE 200,035,103620,Pal; Piya,9999,0,9999,0
1668266560598,ECE 200,036,103621,Papen; George C.,9999,0,9999,0
1668266560598,ECE 200,037,103622,Radic; Stojan,9999,0,9999,0
1668266560598,ECE 200,038,103623,Rao; Bhaskar D.,9999,0,9999,0
1668266560598,ECE 200,039,103624,Rao; Ramesh R,9999,0,9999,0
1668266560598,ECE 200,040,103625,Rebeiz; Gabriel,9999,0,9999,0
1668266560598,ECE 200,041,103626,Sanford; John R,9999,0,9999,0
1668266560598,ECE 200,042,103627,Siegel; Paul H.,9999,0,9999,0
1668266560598,ECE 200,043,103628,Sievenpiper; Daniel F.,9999,0,9999,0
1668266560598,ECE 200,044,103629,Sworder; David D.,9999,0,9999,0
1668266560598,ECE 200,045,103630,Taur; Yuan,9999,0,9999,0
1668266560598,ECE 200,046,103631,Touri; Behrouz,9999,0,9999,0
1668266560598,ECE 200,047,103632,Trivedi; Mohan M.,9999,0,9999,0
1668266560598,ECE 200,048,103633,Vasconcelos; Nuno,9999,0,9999,0
1668266560598,ECE 200,049,103634,Wang; Xiaolong,9999,0,9999,0
1668266560598,ECE 200,050,103635,Xie; Pengtao,9999,0,9999,0
1668266560598,ECE 200,051,103636,Yip; Michael,9999,0,9999,0
1668266560598,ECE 200,052,103637,Zeger; Kenneth A.,999,0,999,0
1668266560598,ECE 200,053,103638,Zhang; Xinyu,9999,0,9999,0
1668266560598,ECE 200,054,103639,Turakhia; Yatish Girish,9999,0,9999,0
1668266560598,ECE 200,055,103640,Kang; Mingu,9999,0,9999,0
1668266560598,ECE 200,056,103641,Shi; Yuanyuan,9999,0,9999,0
1668266560598,ECE 200,057,103642,Wang; Edward Jay,9999,0,9999,0
1668266560598,ECE 200,058,103643,Zheng; Yang,9999,0,9999,0
1668266561022,ECE 202,A00,103644,Kuzum; Duygu,0,0,0,0
1668266561448,ECE 212BN,A00,103646,Ng; Tse Nga,0,0,0,0
1668266561876,ECE 221,A00,111493,Staff,0,0,0,0
1668266562302,ECE 222B,A00,103647,Lomakin; Vitaliy,0,0,0,0
1668266562725,ECE 230B,A00,103648,Taur; Yuan,0,0,0,0
1668266563151,ECE 238B,A00,103649,Garay; Javier,0,0,0,0
1668266563586,ECE 240B,A00,112900,Fainman; Yeshaiahu,0,0,0,0
1668266564014,ECE 247A,A00,103650,Jokerst; Jesse Vincent,0,0,0,0
1668266564451,ECE 247B,A00,103651,Wang; Joseph,0,0,0,0
1668266564875,ECE 250,A00,103652,Siegel; Paul H.,0,0,0,0
1668266565313,ECE 251A,A00,103654,Rao; Bhaskar D.,0,0,0,0
1668266565748,ECE 257B,A00,103655,Bharadia; Dinesh,0,0,0,0
1668266566175,ECE 258A,A00,103656,Milstein; Laurence B.,0,0,0,0
1668266566601,ECE 260B,A00,103658,Kang; Mingu,0,0,0,0
1668266567025,ECE 264A,A00,103659,Galton; Ian A,0,0,0,0
1668266567452,ECE 265A,A00,103661,Gudem; Prasad S.S.,0,0,0,0
1668266567881,ECE 265D,A00,103662,Gudem; Prasad S.S.,0,0,0,0
1668266568309,ECE 268,A00,103663,Koushanfar; Farinaz,0,0,0,0
1668266568732,ECE 269,A01,103665,Pal; Piya,0,0,0,0
1668266569159,ECE 271B,A00,103666,Vasconcelos; Manuela,0,0,0,0
1668266569583,ECE 276A,A00,103667,Atanasov; Nikolay A.,0,0,0,0
1668266570020,ECE 277,A00,103668,An; Cheolhong,0,0,0,0
1668266570447,ECE 279,A00,117947,Hall; Drew A.,0,0,0,0
1668266571299,ECE 283,A00,103670,Hsueh; Tzu-Chien,0,0,0,0
1668266571735,ECE 284,A00,103671,Turakhia; Yatish Girish,0,0,0,0
1668266572163,ECE 285,A00,103672,Zheng; Yang,0,0,0,0
1668266572163,ECE 285,B00,103673,Sworder; David D.,0,0,0,0
1668266572584,ECE 287,A00,103676,Javidi; Tara,0,0,0,0
1668266573023,MATH 200B,A00,098023,Salehi Golsefidy; Alireza,12,0,15,3
1668266573447,MATH 202B,A00,098024,Rhoades; Brendon Patrick,9,0,15,6
1668266573873,MATH 203B,A00,098025,Oprea; Dragos N.,10,0,15,5
1668266574294,MATH 204B,A00,098026,Sorensen; Claus M,13,0,15,2
1668266574733,MATH 208,A00,098027,Izadi; Elham,7,0,10,3
1668266575165,MATH 209,A00,098028,Pollack; Aaron,10,0,10,0
1668266575591,MATH 211A,A00,112919,Rogalski; Daniel,9,0,10,1
1668266576017,MATH 211B,A00,112920,Seward; Brandon M.,9,0,10,1
1668266576566,MATH 218,A00,098029,Li; Bo,10,0,10,0
1668266577003,MATH 220B,A00,098030,Novak; Jonathan I,11,0,15,4
1668266577433,MATH 221A,A00,098031,Ebenfelt; Peter F,13,0,15,2
1668266577858,MATH 231B,A00,098032,Zlatos; Andrej,12,0,15,3
1668266578285,MATH 240B,A00,098033,Ni; Lei,9,0,15,6
1668266578714,MATH 243,A00,098034,Jekel; David Andrew,10,0,10,0
1668266579141,MATH 245A,A00,098035,Nie; Jiawang,0,0,15,16
1668266579564,MATH 248,A00,098036,Bejenaru; Ioan,10,0,10,0
1668266579989,MATH 250B,A00,098037,Spolaor; Luca,14,0,15,1
1668266580425,MATH 258,A00,098038,Ni; Lei,10,0,10,0
1668266580851,MATH 264B,A00,098041,Rhoades; Brendon Patrick,9,0,15,6
1668266581286,MATH 268,A00,098042,Buss; Samuel R,10,0,10,0
1668266581711,MATH 269,A00,098043,Rhoades; Brendon Patrick,10,0,10,0
1668266582139,MATH 270B,A00,098044,Li; Bo,10,0,15,5
1668266582564,MATH 272B,A00,098045,Holst; Michael J,13,0,15,2
1668266582990,MATH 273A,A00,098046,Tian; Xiaochuan,10,0,15,5
1668266583413,MATH 275,A01,098048,Tian; Xiaochuan,6,0,10,4
1668266583837,MATH 278A,A00,098049,Holst; Michael J,8,0,10,2
1668266584260,MATH 278B,A00,098050,Cloninger; Alexander,10,0,10,0
1668266584698,MATH 278C,A00,098051,Nie; Jiawang,7,0,10,3
1668266585121,MATH 280B,A00,098052,Zheng; Tianyi,9,0,15,6
1668266585561,MATH 281B,A00,098053,Bradic; Jelena,1,0,15,14
1668266585983,MATH 282B,A00,098054,Arias-Castro; Ery,0,0,15,15
1668266586410,MATH 285,A00,098055,Fitzsimmons; Patrick J,0,0,15,17
1668266586833,MATH 287B,A00,098056,Arias-Castro; Ery,2,0,15,13
1668266587259,MATH 288,A00,098057,Agarwal; Pooja,9,0,10,1
1668266587259,MATH 288,B00,098058,Zhang; Danna,8,0,10,2
1668266587259,MATH 288,C00,098059,Williams; Ruth J,10,0,10,0
1668266587682,MATH 290B,A00,098060,Roberts; Justin Deritter,13,0,15,2
1668266588121,MATH 292,A00,098061,Belmont; Eva Kinoshita,10,0,10,0
1668266588545,MATH 295,A00,098062,Suk; Andrew Hoon,48,0,50,2
1668266588971,MATH 296,A00,098063,Novak; Jonathan I,20,0,20,0
1668266589406,MATH 297,001,098064,Gamst; Anthony Collins,9997,0,9999,2
1668267091364,COGS 205,A00,101395,Chiba; Andrea,19,0,20,1
1668267091787,COGS 210B,001,101404,Greene; Deanna Jacquelyn,9998,0,9999,1
1668267091787,COGS 210B,002,101417,Xia; Haijun,9999,0,9999,0
1668267091787,COGS 210B,003,101422,Nitz; Douglas A.,9999,0,9999,0
1668267091787,COGS 210B,004,101423,Hollan; James D.,9998,0,9999,1
1668267091787,COGS 210B,005,101424,Deak; Gedeon O.,9998,0,9999,1
1668267091787,COGS 210B,006,101425,Rossano; Federico,9999,0,9999,0
1668267092212,COGS 211B,A00,101427,Coulson; Seana M,9996,0,9999,3
1668267092639,COGS 220,A00,101428,Hollan; James D.,0,0,25,25
1668267093075,COGS 229,A00,101429,Dow; Steven P,18,0,25,7
1668267093503,COGS 230,A00,101430,Klemmer; Scott R,12,0,17,5
1668267093932,COGS 234,A00,101431,Xia; Haijun,2,0,25,23
1668267094359,COGS 260,A00,101432,Kiyonaga; Anastasia,21,0,25,4
1668267094359,COGS 260,B00,101433,Kirsh; David Joel,15,0,25,10
1668267094795,CSE 202,A00,102371,Impagliazzo; Russell,0,0,0,0
1668267095219,CSE 203B,A01,102373,Cheng; Chung Kuan,0,0,0,0
1668267095651,CSE 208,A00,102374,Micciancio; Daniele,0,0,0,0
1668267096075,CSE 209A,A00,112895,Impagliazzo; Russell,0,0,15,15
1668267096498,CSE 209B,A00,108005,Bellare; Mihir,0,0,0,0
1668267096937,CSE 210,A00,113163,Coblenz; Michael J,0,0,0,0
1668267097370,CSE 219,A00,106111,Dow; Steven P,0,0,20,20
1668267097793,CSE 221,A00,102376,Voelker; Geoffrey M.,0,0,0,0
1668267098227,CSE 224,A01,102378,Porter; George M,0,0,0,0
1668267098745,CSE 229A,A00,102379,Savage; Stefan,0,0,0,0
1668267099183,CSE 229C,A00,102380,Munyaka; Imani N. S.,0,0,0,0
1668267099605,CSE 232B,A00,102382,Deutsch; Alin Bernard,0,0,0,0
1668267100041,CSE 234,A01,112904,Kumar; Arun Kumar,0,0,0,0
1668267100463,CSE 237A,A00,102383,Rosing; Tajana Simunic,0,0,0,0
1668267100889,CSE 239A,A00,102384,Deutsch; Alin Bernard,0,0,0,0
1668267101315,CSE 239B,A00,102385,Polikarpova; Nadezhda,0,0,0,0
1668267101758,CSE 240A,A00,102386,Pannuto; Patrick William,0,0,0,0
1668267102193,CSE 240B,A00,102387,Zhao; Jishen,0,0,0,0
1668267102617,CSE 241A,A00,106406,Kang; Mingu,0,0,0,0
1668267103042,CSE 249B,A00,102388,Kahng; Andrew Byun,0,0,8,8
1668267103473,CSE 251B,A01,102392,Cottrell; Garrison W,0,0,0,0
1668267103473,CSE 251B,A02,102393,Cottrell; Garrison W,0,0,0,0
1668267103900,CSE 252B,A00,102394,Ochoa; Benjamin Lawrence,0,0,0,0
1668267104337,CSE 257,A01,102396,Gao; Sicun,0,0,0,0
1668267104761,CSE 272,A00,102397,Li; Tzumao,0,0,0,0
1668267105191,CSE 274,A00,111323,Chern; Albert Ren-Haur,0,0,0,0
1668267105617,CSE 282,A00,102398,Pevzner; Pavel Arkadjevich,0,0,0,0
1668267106059,CSE 284,A00,114175,Gymrek; Melissa Ann,0,0,0,0
1668267106495,CSE 290,A00,102399,Chandraker; Manmohan Krishna,0,0,0,0
1668267106495,CSE 290,B00,102400,Vaccaro; Kristen Marie,0,0,25,25
1668267106495,CSE 290,C00,102414,Pannuto; Patrick William,0,0,25,25
1668267106495,CSE 290,D00,102427,Pevzner; Pavel Arkadjevich,0,0,0,0
1668267106495,CSE 290,E00,102429,Zhao; Jishen,0,0,0,0
1668267106495,CSE 290,F00,102436,Tullsen; Dean Michael,0,0,0,0
1668267106495,CSE 290,G00,102440,Christensen; Henrik I,0,0,20,20
1668267106935,CSE 291,A00,102443,Su; Hao,0,0,0,0
1668267106935,CSE 291,B00,102448,Polikarpova; Nadezhda,0,0,0,0
1668267106935,CSE 291,C00,102453,Vaccaro; Kristen Marie,0,0,0,0
1668267106935,CSE 291,D00,111343,Savage; Stefan,0,0,0,0
1668267106935,CSE 291,E00,116474,Claffy; Kimberly Claire,0,0,0,0
1668267106935,CSE 291,F00,116479,Pasquale; Joseph,0,0,0,0
1668267107359,CSE 293,001,119111,Bafna; Vineet,9999,0,9999,0
1668267107359,CSE 293,002,119118,Bellare; Mihir,9999,0,9999,0
1668267107359,CSE 293,003,119122,Berg-Kirkpatrick; Taylor D,9999,0,9999,0
1668267107359,CSE 293,004,119135,Christensen; Henrik I,9999,0,9999,0
1668267107359,CSE 293,005,119142,Cottrell; Garrison W,9999,0,9999,0
1668267107359,CSE 293,006,119146,Deutsch; Alin Bernard,9999,0,9999,0
1668267107359,CSE 293,007,119159,Esmaeilzadeh; Hadi,9999,0,9999,0
1668267107359,CSE 293,008,119166,Freund; Yoav,9999,0,9999,0
1668267107359,CSE 293,009,119170,Griswold; William G.,9999,0,9999,0
1668267107359,CSE 293,010,119183,Gymrek; Melissa Ann,9999,0,9999,0
1668267107359,CSE 293,011,119190,Heninger; Nadia A,9999,0,9999,0
1668267107359,CSE 293,012,119230,Impagliazzo; Russell,9999,0,9999,0
1668267107359,CSE 293,013,119232,Jhala; Ranjit,9999,0,9999,0
1668267107359,CSE 293,014,119233,Kahng; Andrew Byun,9999,0,9999,0
1668267107359,CSE 293,015,119298,Kane; Daniel Mertz,9999,0,9999,0
1668267107359,CSE 293,016,119299,Kriegman; David J,9999,0,9999,0
1668267107359,CSE 293,017,119300,Kumar; Arun Kumar,9999,0,9999,0
1668267107359,CSE 293,018,119301,Lerner; Sorin,9999,0,9999,0
1668267107359,CSE 293,019,119302,Lovett; Shachar,9999,0,9999,0
1668267107359,CSE 293,020,119303,McAuley; Julian John,9999,0,9999,0
1668267107359,CSE 293,021,119304,Micciancio; Daniele,9999,0,9999,0
1668267107359,CSE 293,022,119367,Orailoglu; Alex,9999,0,9999,0
1668267107359,CSE 293,023,119382,Paturi; Ramamohan,9999,0,9999,0
1668267107359,CSE 293,024,119404,Polikarpova; Nadezhda,9999,0,9999,0
1668267107359,CSE 293,025,119406,Politz; Joseph Gibbs,9999,0,9999,0
1668267107359,CSE 293,026,119411,Porter; George M,9999,0,9999,0
1668267107359,CSE 293,027,119414,Porter; Leonard Emerson,9999,0,9999,0
1668267107359,CSE 293,028,119416,Ramamoorthi; Ravi,9999,0,9999,0
1668267107359,CSE 293,029,119417,Sahoo; Debashis,9999,0,9999,0
1668267107359,CSE 293,030,119420,Saul; Lawrence,9999,0,9999,0
1668267107359,CSE 293,031,119421,Savage; Stefan,9999,0,9999,0
1668267107359,CSE 293,032,119425,Schulze; Jurgen P.,9999,0,9999,0
1668267107359,CSE 293,033,119426,Snoeren; Alex C.,9999,0,9999,0
1668267107359,CSE 293,034,119428,Shang; Jingbo,9999,0,9999,0
1668267107359,CSE 293,035,119430,Stefan; Deian,9999,0,9999,0
1668267107359,CSE 293,036,119431,Su; Hao,9999,0,9999,0
1668267107359,CSE 293,037,119433,Swanson; Steven James,9999,0,9999,0
1668267107359,CSE 293,038,119435,Tullsen; Dean Michael,9999,0,9999,0
1668267107359,CSE 293,039,119483,Voelker; Geoffrey M.,9999,0,9999,0
1668267107359,CSE 293,040,119537,Zhao; Jishen,9999,0,9999,0
1668267107359,CSE 293,041,119538,Zhou; Yuan-Yuan,9999,0,9999,0
1668267107359,CSE 293,042,119539,Gao; Sicun,9999,0,9999,0
1668267107359,CSE 293,043,119540,Weibel; Nadir,9999,0,9999,0
1668267107359,CSE 293,044,119541,Gupta; Rajesh K.,9999,0,9999,0
1668267107359,CSE 293,045,126410,Vaccaro; Kristen Marie,9999,0,9999,0
1668267107359,CSE 293,046,126411,Klemke; Richard,9999,0,9999,0
1668267107784,CSE 294,A00,102459,Voelker; Geoffrey M.,0,0,0,0
1668267107784,CSE 294,B00,111322,Orailoglu; Alex,0,0,0,0
1668267108216,DSE 201,A00,096914,Deutsch; Alin Bernard,30,0,30,0
1668267108638,DSE 210,A00,096915,Dasgupta; Sanjoy,30,0,30,0
1668267109063,DSE 260A,A00,096916,Altintas De Callaf; Ilkay,30,0,30,0
1668267109514,ECE 200,001,103586,Antipa; Nicholas A,9999,0,9999,0
1668267109514,ECE 200,002,103587,Atanasov; Nikolay A.,9999,0,9999,0
1668267109514,ECE 200,003,103588,Bharadia; Dinesh,9999,0,9999,0
1668267109514,ECE 200,004,103589,Cheng; Chung Kuan,9999,0,9999,0
1668267109514,ECE 200,005,103590,Cosman; Pamela C.,9999,0,9999,0
1668267109514,ECE 200,006,103591,Dayeh; Shadi Ahmad,9999,0,9999,0
1668267109514,ECE 200,007,103592,Fainman; Yeshaiahu,9999,0,9999,0
1668267109514,ECE 200,008,103593,Ford; Joseph Earl,9999,0,9999,0
1668267109514,ECE 200,009,103594,Franceschetti; Massimo,9999,0,9999,0
1668267109514,ECE 200,010,103595,Fullerton; Eric E,9999,0,9999,0
1668267109514,ECE 200,011,103596,Galton; Ian A,9999,0,9999,0
1668267109514,ECE 200,012,103597,Gilja; Vikash,9999,0,9999,0
1668267109514,ECE 200,013,103598,Hall; Drew A.,9999,0,9999,0
1668267109514,ECE 200,014,103599,Hsueh; Tzu-Chien,9999,0,9999,0
1668267109514,ECE 200,015,103600,Javidi; Tara,9999,0,9999,0
1668267109514,ECE 200,016,103601,Kahng; Andrew Byun,9999,0,9999,0
1668267109514,ECE 200,017,103602,Kim; Young-Han,9999,0,9999,0
1668267109514,ECE 200,018,103603,Koushanfar; Farinaz,9999,0,9999,0
1668267109514,ECE 200,019,103604,Kuzum; Duygu,9999,0,9999,0
1668267109514,ECE 200,020,103605,Le; Hanh-Phuc,9999,0,9999,0
1668267109514,ECE 200,021,103606,Lin; Bill,9999,0,9999,0
1668267109514,ECE 200,022,103607,Liu; Zhaowei,9998,0,9999,1
1668267109514,ECE 200,023,103608,Lo; Yu-Hwa,9999,0,9999,0
1668267109514,ECE 200,024,103609,Lomakin; Vitaliy,9999,0,9999,0
1668267109514,ECE 200,025,103610,Mercier; Patrick Philip,9999,0,9999,0
1668267109514,ECE 200,026,103611,Meyer; Florian,9999,0,9999,0
1668267109514,ECE 200,027,103612,Milstein; Laurence B.,9999,0,9999,0
1668267109514,ECE 200,028,103613,Mir Arabbaygi; Siavash,9999,0,9999,0
1668267109514,ECE 200,029,103614,Mookherjea; Shayan,9999,0,9999,0
1668267109514,ECE 200,030,103615,Morris; Karcher William,9999,0,9999,0
1668267109514,ECE 200,031,103616,Ng; Tse Nga,9999,0,9999,0
1668267109514,ECE 200,032,103617,Nguyen; Truong Quang,9999,0,9999,0
1668267109514,ECE 200,033,103618,Nomura; Kenji,9999,0,9999,0
1668267109514,ECE 200,034,103619,Orlitsky; Alon,9999,0,9999,0
1668267109514,ECE 200,035,103620,Pal; Piya,9999,0,9999,0
1668267109514,ECE 200,036,103621,Papen; George C.,9999,0,9999,0
1668267109514,ECE 200,037,103622,Radic; Stojan,9999,0,9999,0
1668267109514,ECE 200,038,103623,Rao; Bhaskar D.,9999,0,9999,0
1668267109514,ECE 200,039,103624,Rao; Ramesh R,9999,0,9999,0
1668267109514,ECE 200,040,103625,Rebeiz; Gabriel,9999,0,9999,0
1668267109514,ECE 200,041,103626,Sanford; John R,9999,0,9999,0
1668267109514,ECE 200,042,103627,Siegel; Paul H.,9999,0,9999,0
1668267109514,ECE 200,043,103628,Sievenpiper; Daniel F.,9999,0,9999,0
1668267109514,ECE 200,044,103629,Sworder; David D.,9999,0,9999,0
1668267109514,ECE 200,045,103630,Taur; Yuan,9999,0,9999,0
1668267109514,ECE 200,046,103631,Touri; Behrouz,9999,0,9999,0
1668267109514,ECE 200,047,103632,Trivedi; Mohan M.,9999,0,9999,0
1668267109514,ECE 200,048,103633,Vasconcelos; Nuno,9999,0,9999,0
1668267109514,ECE 200,049,103634,Wang; Xiaolong,9999,0,9999,0
1668267109514,ECE 200,050,103635,Xie; Pengtao,9999,0,9999,0
1668267109514,ECE 200,051,103636,Yip; Michael,9999,0,9999,0
1668267109514,ECE 200,052,103637,Zeger; Kenneth A.,999,0,999,0
1668267109514,ECE 200,053,103638,Zhang; Xinyu,9999,0,9999,0
1668267109514,ECE 200,054,103639,Turakhia; Yatish Girish,9999,0,9999,0
1668267109514,ECE 200,055,103640,Kang; Mingu,9999,0,9999,0
1668267109514,ECE 200,056,103641,Shi; Yuanyuan,9999,0,9999,0
1668267109514,ECE 200,057,103642,Wang; Edward Jay,9999,0,9999,0
1668267109514,ECE 200,058,103643,Zheng; Yang,9999,0,9999,0
1668267109938,ECE 202,A00,103644,Kuzum; Duygu,0,0,0,0
1668267110370,ECE 212BN,A00,103646,Ng; Tse Nga,0,0,0,0
1668267110796,ECE 221,A00,111493,Staff,0,0,0,0
1668267111226,ECE 222B,A00,103647,Lomakin; Vitaliy,0,0,0,0
1668267111661,ECE 230B,A00,103648,Taur; Yuan,0,0,0,0
1668267112089,ECE 238B,A00,103649,Garay; Javier,0,0,0,0
1668267112514,ECE 240B,A00,112900,Fainman; Yeshaiahu,0,0,0,0
1668267112938,ECE 247A,A00,103650,Jokerst; Jesse Vincent,0,0,0,0
1668267113365,ECE 247B,A00,103651,Wang; Joseph,0,0,0,0
1668267113798,ECE 250,A00,103652,Siegel; Paul H.,0,0,0,0
1668267114226,ECE 251A,A00,103654,Rao; Bhaskar D.,0,0,0,0
1668267114656,ECE 257B,A00,103655,Bharadia; Dinesh,0,0,0,0
1668267115081,ECE 258A,A00,103656,Milstein; Laurence B.,0,0,0,0
1668267115504,ECE 260B,A00,103658,Kang; Mingu,0,0,0,0
1668267115934,ECE 264A,A00,103659,Galton; Ian A,0,0,0,0
1668267116374,ECE 265A,A00,103661,Gudem; Prasad S.S.,0,0,0,0
1668267116798,ECE 265D,A00,103662,Gudem; Prasad S.S.,0,0,0,0
1668267117223,ECE 268,A00,103663,Koushanfar; Farinaz,0,0,0,0
1668267117645,ECE 269,A01,103665,Pal; Piya,0,0,0,0
1668267118086,ECE 271B,A00,103666,Vasconcelos; Manuela,0,0,0,0
1668267118513,ECE 276A,A00,103667,Atanasov; Nikolay A.,0,0,0,0
1668267118947,ECE 277,A00,103668,An; Cheolhong,0,0,0,0
1668267119388,ECE 279,A00,117947,Hall; Drew A.,0,0,0,0
1668267120244,ECE 283,A00,103670,Hsueh; Tzu-Chien,0,0,0,0
1668267120671,ECE 284,A00,103671,Turakhia; Yatish Girish,0,0,0,0
1668267121097,ECE 285,A00,103672,Zheng; Yang,0,0,0,0
1668267121097,ECE 285,B00,103673,Sworder; David D.,0,0,0,0
1668267121523,ECE 287,A00,103676,Javidi; Tara,0,0,0,0
1668267121958,MATH 200B,A00,098023,Salehi Golsefidy; Alireza,12,0,15,3
1668267122382,MATH 202B,A00,098024,Rhoades; Brendon Patrick,9,0,15,6
1668267122810,MATH 203B,A00,098025,Oprea; Dragos N.,10,0,15,5
1668267123234,MATH 204B,A00,098026,Sorensen; Claus M,13,0,15,2
1668267123659,MATH 208,A00,098027,Izadi; Elham,7,0,10,3
1668267124098,MATH 209,A00,098028,Pollack; Aaron,10,0,10,0
1668267124523,MATH 211A,A00,112919,Rogalski; Daniel,9,0,10,1
1668267124950,MATH 211B,A00,112920,Seward; Brandon M.,9,0,10,1
1668267125377,MATH 218,A00,098029,Li; Bo,10,0,10,0
1668267125802,MATH 220B,A00,098030,Novak; Jonathan I,11,0,15,4
1668267126229,MATH 221A,A00,098031,Ebenfelt; Peter F,13,0,15,2
1668267126655,MATH 231B,A00,098032,Zlatos; Andrej,12,0,15,3
1668267127079,MATH 240B,A00,098033,Ni; Lei,9,0,15,6
1668267127511,MATH 243,A00,098034,Jekel; David Andrew,10,0,10,0
1668267127949,MATH 245A,A00,098035,Nie; Jiawang,0,0,15,16
1668267128375,MATH 248,A00,098036,Bejenaru; Ioan,10,0,10,0
1668267128799,MATH 250B,A00,098037,Spolaor; Luca,14,0,15,1
1668267129230,MATH 258,A00,098038,Ni; Lei,10,0,10,0
1668267129656,MATH 264B,A00,098041,Rhoades; Brendon Patrick,9,0,15,6
1668267130079,MATH 268,A00,098042,Buss; Samuel R,10,0,10,0
1668267130501,MATH 269,A00,098043,Rhoades; Brendon Patrick,10,0,10,0
1668267130926,MATH 270B,A00,098044,Li; Bo,10,0,15,5
1668267131354,MATH 272B,A00,098045,Holst; Michael J,13,0,15,2
1668267131791,MATH 273A,A00,098046,Tian; Xiaochuan,10,0,15,5
1668267132221,MATH 275,A01,098048,Tian; Xiaochuan,6,0,10,4
1668267132647,MATH 278A,A00,098049,Holst; Michael J,8,0,10,2
1668267133070,MATH 278B,A00,098050,Cloninger; Alexander,10,0,10,0
1668267133495,MATH 278C,A00,098051,Nie; Jiawang,7,0,10,3
1668267133927,MATH 280B,A00,098052,Zheng; Tianyi,9,0,15,6
1668267134352,MATH 281B,A00,098053,Bradic; Jelena,1,0,15,14
1668267134781,MATH 282B,A00,098054,Arias-Castro; Ery,0,0,15,15
1668267135204,MATH 285,A00,098055,Fitzsimmons; Patrick J,0,0,15,17
1668267135626,MATH 287B,A00,098056,Arias-Castro; Ery,2,0,15,13
1668267136060,MATH 288,A00,098057,Agarwal; Pooja,9,0,10,1
1668267136060,MATH 288,B00,098058,Zhang; Danna,8,0,10,2
1668267136060,MATH 288,C00,098059,Williams; Ruth J,10,0,10,0
1668267136486,MATH 290B,A00,098060,Roberts; Justin Deritter,13,0,15,2
1668267136911,MATH 292,A00,098061,Belmont; Eva Kinoshita,10,0,10,0
1668267137336,MATH 295,A00,098062,Suk; Andrew Hoon,48,0,50,2
1668267137771,MATH 296,A00,098063,Novak; Jonathan I,20,0,20,0
1668267138195,MATH 297,001,098064,Gamst; Anthony Collins,9997,0,9999,2
1668267640606,COGS 205,A00,101395,Chiba; Andrea,19,0,20,1
1668267641030,COGS 210B,001,101404,Greene; Deanna Jacquelyn,9998,0,9999,1
1668267641030,COGS 210B,002,101417,Xia; Haijun,9999,0,9999,0
1668267641030,COGS 210B,003,101422,Nitz; Douglas A.,9999,0,9999,0
1668267641030,COGS 210B,004,101423,Hollan; James D.,9998,0,9999,1
1668267641030,COGS 210B,005,101424,Deak; Gedeon O.,9998,0,9999,1
1668267641030,COGS 210B,006,101425,Rossano; Federico,9999,0,9999,0
1668267641452,COGS 211B,A00,101427,Coulson; Seana M,9996,0,9999,3
1668267641874,COGS 220,A00,101428,Hollan; James D.,0,0,25,25
1668267642302,COGS 229,A00,101429,Dow; Steven P,18,0,25,7
1668267642738,COGS 230,A00,101430,Klemmer; Scott R,12,0,17,5
1668267643169,COGS 234,A00,101431,Xia; Haijun,2,0,25,23
1668267643595,COGS 260,A00,101432,Kiyonaga; Anastasia,21,0,25,4
1668267643595,COGS 260,B00,101433,Kirsh; David Joel,15,0,25,10
1668267644031,CSE 202,A00,102371,Impagliazzo; Russell,0,0,0,0
1668267644486,CSE 203B,A01,102373,Cheng; Chung Kuan,0,0,0,0
1668267644911,CSE 208,A00,102374,Micciancio; Daniele,0,0,0,0
1668267645337,CSE 209A,A00,112895,Impagliazzo; Russell,0,0,15,15
1668267645767,CSE 209B,A00,108005,Bellare; Mihir,0,0,0,0
1668267646202,CSE 210,A00,113163,Coblenz; Michael J,0,0,0,0
1668267646635,CSE 219,A00,106111,Dow; Steven P,0,0,20,20
1668267647062,CSE 221,A00,102376,Voelker; Geoffrey M.,0,0,0,0
1668267647488,CSE 224,A01,102378,Porter; George M,0,0,0,0
1668267647913,CSE 229A,A00,102379,Savage; Stefan,0,0,0,0
1668267648341,CSE 229C,A00,102380,Munyaka; Imani N. S.,0,0,0,0
1668267648765,CSE 232B,A00,102382,Deutsch; Alin Bernard,0,0,0,0
1668267649199,CSE 234,A01,112904,Kumar; Arun Kumar,0,0,0,0
1668267649648,CSE 237A,A00,102383,Rosing; Tajana Simunic,0,0,0,0
1668267650074,CSE 239A,A00,102384,Deutsch; Alin Bernard,0,0,0,0
1668267650499,CSE 239B,A00,102385,Polikarpova; Nadezhda,0,0,0,0
1668267650925,CSE 240A,A00,102386,Pannuto; Patrick William,0,0,0,0
1668267651352,CSE 240B,A00,102387,Zhao; Jishen,0,0,0,0
1668267651776,CSE 241A,A00,106406,Kang; Mingu,0,0,0,0
1668267652200,CSE 249B,A00,102388,Kahng; Andrew Byun,0,0,8,8
1668267652627,CSE 251B,A01,102392,Cottrell; Garrison W,0,0,0,0
1668267652627,CSE 251B,A02,102393,Cottrell; Garrison W,0,0,0,0
1668267653049,CSE 252B,A00,102394,Ochoa; Benjamin Lawrence,0,0,0,0
1668267653483,CSE 257,A01,102396,Gao; Sicun,0,0,0,0
1668267653906,CSE 272,A00,102397,Li; Tzumao,0,0,0,0
1668267654329,CSE 274,A00,111323,Chern; Albert Ren-Haur,0,0,0,0
1668267654764,CSE 282,A00,102398,Pevzner; Pavel Arkadjevich,0,0,0,0
1668267655199,CSE 284,A00,114175,Gymrek; Melissa Ann,0,0,0,0
1668267655626,CSE 290,A00,102399,Chandraker; Manmohan Krishna,0,0,0,0
1668267655626,CSE 290,B00,102400,Vaccaro; Kristen Marie,0,0,25,25
1668267655626,CSE 290,C00,102414,Pannuto; Patrick William,0,0,25,25
1668267655626,CSE 290,D00,102427,Pevzner; Pavel Arkadjevich,0,0,0,0
1668267655626,CSE 290,E00,102429,Zhao; Jishen,0,0,0,0
1668267655626,CSE 290,F00,102436,Tullsen; Dean Michael,0,0,0,0
1668267655626,CSE 290,G00,102440,Christensen; Henrik I,0,0,20,20
1668267656063,CSE 291,A00,102443,Su; Hao,0,0,0,0
1668267656063,CSE 291,B00,102448,Polikarpova; Nadezhda,0,0,0,0
1668267656063,CSE 291,C00,102453,Vaccaro; Kristen Marie,0,0,0,0
1668267656063,CSE 291,D00,111343,Savage; Stefan,0,0,0,0
1668267656063,CSE 291,E00,116474,Claffy; Kimberly Claire,0,0,0,0
1668267656063,CSE 291,F00,116479,Pasquale; Joseph,0,0,0,0
1668267656498,CSE 293,001,119111,Bafna; Vineet,9999,0,9999,0
1668267656498,CSE 293,002,119118,Bellare; Mihir,9999,0,9999,0
1668267656498,CSE 293,003,119122,Berg-Kirkpatrick; Taylor D,9999,0,9999,0
1668267656498,CSE 293,004,119135,Christensen; Henrik I,9999,0,9999,0
1668267656498,CSE 293,005,119142,Cottrell; Garrison W,9999,0,9999,0
1668267656498,CSE 293,006,119146,Deutsch; Alin Bernard,9999,0,9999,0
1668267656498,CSE 293,007,119159,Esmaeilzadeh; Hadi,9999,0,9999,0
1668267656498,CSE 293,008,119166,Freund; Yoav,9999,0,9999,0
1668267656498,CSE 293,009,119170,Griswold; William G.,9999,0,9999,0
1668267656498,CSE 293,010,119183,Gymrek; Melissa Ann,9999,0,9999,0
1668267656498,CSE 293,011,119190,Heninger; Nadia A,9999,0,9999,0
1668267656498,CSE 293,012,119230,Impagliazzo; Russell,9999,0,9999,0
1668267656498,CSE 293,013,119232,Jhala; Ranjit,9999,0,9999,0
1668267656498,CSE 293,014,119233,Kahng; Andrew Byun,9999,0,9999,0
1668267656498,CSE 293,015,119298,Kane; Daniel Mertz,9999,0,9999,0
1668267656498,CSE 293,016,119299,Kriegman; David J,9999,0,9999,0
1668267656498,CSE 293,017,119300,Kumar; Arun Kumar,9999,0,9999,0
1668267656498,CSE 293,018,119301,Lerner; Sorin,9999,0,9999,0
1668267656498,CSE 293,019,119302,Lovett; Shachar,9999,0,9999,0
1668267656498,CSE 293,020,119303,McAuley; Julian John,9999,0,9999,0
1668267656498,CSE 293,021,119304,Micciancio; Daniele,9999,0,9999,0
1668267656498,CSE 293,022,119367,Orailoglu; Alex,9999,0,9999,0
1668267656498,CSE 293,023,119382,Paturi; Ramamohan,9999,0,9999,0
1668267656498,CSE 293,024,119404,Polikarpova; Nadezhda,9999,0,9999,0
1668267656498,CSE 293,025,119406,Politz; Joseph Gibbs,9999,0,9999,0
1668267656498,CSE 293,026,119411,Porter; George M,9999,0,9999,0
1668267656498,CSE 293,027,119414,Porter; Leonard Emerson,9999,0,9999,0
1668267656498,CSE 293,028,119416,Ramamoorthi; Ravi,9999,0,9999,0
1668267656498,CSE 293,029,119417,Sahoo; Debashis,9999,0,9999,0
1668267656498,CSE 293,030,119420,Saul; Lawrence,9999,0,9999,0
1668267656498,CSE 293,031,119421,Savage; Stefan,9999,0,9999,0
1668267656498,CSE 293,032,119425,Schulze; Jurgen P.,9999,0,9999,0
1668267656498,CSE 293,033,119426,Snoeren; Alex C.,9999,0,9999,0
1668267656498,CSE 293,034,119428,Shang; Jingbo,9999,0,9999,0
1668267656498,CSE 293,035,119430,Stefan; Deian,9999,0,9999,0
1668267656498,CSE 293,036,119431,Su; Hao,9999,0,9999,0
1668267656498,CSE 293,037,119433,Swanson; Steven James,9999,0,9999,0
1668267656498,CSE 293,038,119435,Tullsen; Dean Michael,9999,0,9999,0
1668267656498,CSE 293,039,119483,Voelker; Geoffrey M.,9999,0,9999,0
1668267656498,CSE 293,040,119537,Zhao; Jishen,9999,0,9999,0
1668267656498,CSE 293,041,119538,Zhou; Yuan-Yuan,9999,0,9999,0
1668267656498,CSE 293,042,119539,Gao; Sicun,9999,0,9999,0
1668267656498,CSE 293,043,119540,Weibel; Nadir,9999,0,9999,0
1668267656498,CSE 293,044,119541,Gupta; Rajesh K.,9999,0,9999,0
1668267656498,CSE 293,045,126410,Vaccaro; Kristen Marie,9999,0,9999,0
1668267656498,CSE 293,046,126411,Klemke; Richard,9999,0,9999,0
1668267656919,CSE 294,A00,102459,Voelker; Geoffrey M.,0,0,0,0
1668267656919,CSE 294,B00,111322,Orailoglu; Alex,0,0,0,0
1668267657345,DSE 201,A00,096914,Deutsch; Alin Bernard,30,0,30,0
1668267657768,DSE 210,A00,096915,Dasgupta; Sanjoy,30,0,30,0
1668267658201,DSE 260A,A00,096916,Altintas De Callaf; Ilkay,30,0,30,0
1668267658638,ECE 200,001,103586,Antipa; Nicholas A,9999,0,9999,0
1668267658638,ECE 200,002,103587,Atanasov; Nikolay A.,9999,0,9999,0
1668267658638,ECE 200,003,103588,Bharadia; Dinesh,9999,0,9999,0
1668267658638,ECE 200,004,103589,Cheng; Chung Kuan,9999,0,9999,0
1668267658638,ECE 200,005,103590,Cosman; Pamela C.,9999,0,9999,0
1668267658638,ECE 200,006,103591,Dayeh; Shadi Ahmad,9999,0,9999,0
1668267658638,ECE 200,007,103592,Fainman; Yeshaiahu,9999,0,9999,0
1668267658638,ECE 200,008,103593,Ford; Joseph Earl,9999,0,9999,0
1668267658638,ECE 200,009,103594,Franceschetti; Massimo,9999,0,9999,0
1668267658638,ECE 200,010,103595,Fullerton; Eric E,9999,0,9999,0
1668267658638,ECE 200,011,103596,Galton; Ian A,9999,0,9999,0
1668267658638,ECE 200,012,103597,Gilja; Vikash,9999,0,9999,0
1668267658638,ECE 200,013,103598,Hall; Drew A.,9999,0,9999,0
1668267658638,ECE 200,014,103599,Hsueh; Tzu-Chien,9999,0,9999,0
1668267658638,ECE 200,015,103600,Javidi; Tara,9999,0,9999,0
1668267658638,ECE 200,016,103601,Kahng; Andrew Byun,9999,0,9999,0
1668267658638,ECE 200,017,103602,Kim; Young-Han,9999,0,9999,0
1668267658638,ECE 200,018,103603,Koushanfar; Farinaz,9999,0,9999,0
1668267658638,ECE 200,019,103604,Kuzum; Duygu,9999,0,9999,0
1668267658638,ECE 200,020,103605,Le; Hanh-Phuc,9999,0,9999,0
1668267658638,ECE 200,021,103606,Lin; Bill,9999,0,9999,0
1668267658638,ECE 200,022,103607,Liu; Zhaowei,9998,0,9999,1
1668267658638,ECE 200,023,103608,Lo; Yu-Hwa,9999,0,9999,0
1668267658638,ECE 200,024,103609,Lomakin; Vitaliy,9999,0,9999,0
1668267658638,ECE 200,025,103610,Mercier; Patrick Philip,9999,0,9999,0
1668267658638,ECE 200,026,103611,Meyer; Florian,9999,0,9999,0
1668267658638,ECE 200,027,103612,Milstein; Laurence B.,9999,0,9999,0
1668267658638,ECE 200,028,103613,Mir Arabbaygi; Siavash,9999,0,9999,0
1668267658638,ECE 200,029,103614,Mookherjea; Shayan,9999,0,9999,0
1668267658638,ECE 200,030,103615,Morris; Karcher William,9999,0,9999,0
1668267658638,ECE 200,031,103616,Ng; Tse Nga,9999,0,9999,0
1668267658638,ECE 200,032,103617,Nguyen; Truong Quang,9999,0,9999,0
1668267658638,ECE 200,033,103618,Nomura; Kenji,9999,0,9999,0
1668267658638,ECE 200,034,103619,Orlitsky; Alon,9999,0,9999,0
1668267658638,ECE 200,035,103620,Pal; Piya,9999,0,9999,0
1668267658638,ECE 200,036,103621,Papen; George C.,9999,0,9999,0
1668267658638,ECE 200,037,103622,Radic; Stojan,9999,0,9999,0
1668267658638,ECE 200,038,103623,Rao; Bhaskar D.,9999,0,9999,0
1668267658638,ECE 200,039,103624,Rao; Ramesh R,9999,0,9999,0
1668267658638,ECE 200,040,103625,Rebeiz; Gabriel,9999,0,9999,0
1668267658638,ECE 200,041,103626,Sanford; John R,9999,0,9999,0
1668267658638,ECE 200,042,103627,Siegel; Paul H.,9999,0,9999,0
1668267658638,ECE 200,043,103628,Sievenpiper; Daniel F.,9999,0,9999,0
1668267658638,ECE 200,044,103629,Sworder; David D.,9999,0,9999,0
1668267658638,ECE 200,045,103630,Taur; Yuan,9999,0,9999,0
1668267658638,ECE 200,046,103631,Touri; Behrouz,9999,0,9999,0
1668267658638,ECE 200,047,103632,Trivedi; Mohan M.,9999,0,9999,0
1668267658638,ECE 200,048,103633,Vasconcelos; Nuno,9999,0,9999,0
1668267658638,ECE 200,049,103634,Wang; Xiaolong,9999,0,9999,0
1668267658638,ECE 200,050,103635,Xie; Pengtao,9999,0,9999,0
1668267658638,ECE 200,051,103636,Yip; Michael,9999,0,9999,0
1668267658638,ECE 200,052,103637,Zeger; Kenneth A.,999,0,999,0
1668267658638,ECE 200,053,103638,Zhang; Xinyu,9999,0,9999,0
1668267658638,ECE 200,054,103639,Turakhia; Yatish Girish,9999,0,9999,0
1668267658638,ECE 200,055,103640,Kang; Mingu,9999,0,9999,0
1668267658638,ECE 200,056,103641,Shi; Yuanyuan,9999,0,9999,0
1668267658638,ECE 200,057,103642,Wang; Edward Jay,9999,0,9999,0
1668267658638,ECE 200,058,103643,Zheng; Yang,9999,0,9999,0
1668267659065,ECE 202,A00,103644,Kuzum; Duygu,0,0,0,0
1668267659488,ECE 212BN,A00,103646,Ng; Tse Nga,0,0,0,0
1668267659919,ECE 221,A00,111493,Staff,0,0,0,0
1668267660354,ECE 222B,A00,103647,Lomakin; Vitaliy,0,0,0,0
1668267660786,ECE 230B,A00,103648,Taur; Yuan,0,0,0,0
1668267661214,ECE 238B,A00,103649,Garay; Javier,0,0,0,0
1668267661637,ECE 240B,A00,112900,Fainman; Yeshaiahu,0,0,0,0
1668267662063,ECE 247A,A00,103650,Jokerst; Jesse Vincent,0,0,0,0
1668267662495,ECE 247B,A00,103651,Wang; Joseph,0,0,0,0
1668267662933,ECE 250,A00,103652,Siegel; Paul H.,0,0,0,0
1668267663360,ECE 251A,A00,103654,Rao; Bhaskar D.,0,0,0,0
1668267663782,ECE 257B,A00,103655,Bharadia; Dinesh,0,0,0,0
1668267664205,ECE 258A,A00,103656,Milstein; Laurence B.,0,0,0,0
1668267664718,ECE 260B,A00,103658,Kang; Mingu,0,0,0,0
1668267665157,ECE 264A,A00,103659,Galton; Ian A,0,0,0,0
1668267665581,ECE 265A,A00,103661,Gudem; Prasad S.S.,0,0,0,0
1668267666006,ECE 265D,A00,103662,Gudem; Prasad S.S.,0,0,0,0
1668267666429,ECE 268,A00,103663,Koushanfar; Farinaz,0,0,0,0
1668267666862,ECE 269,A01,103665,Pal; Piya,0,0,0,0
1668267667291,ECE 271B,A00,103666,Vasconcelos; Manuela,0,0,0,0
1668267667720,ECE 276A,A00,103667,Atanasov; Nikolay A.,0,0,0,0
1668267668143,ECE 277,A00,103668,An; Cheolhong,0,0,0,0
1668267668566,ECE 279,A00,117947,Hall; Drew A.,0,0,0,0
1668267669419,ECE 283,A00,103670,Hsueh; Tzu-Chien,0,0,0,0
1668267669842,ECE 284,A00,103671,Turakhia; Yatish Girish,0,0,0,0
1668267670264,ECE 285,A00,103672,Zheng; Yang,0,0,0,0
1668267670264,ECE 285,B00,103673,Sworder; David D.,0,0,0,0
1668267670687,ECE 287,A00,103676,Javidi; Tara,0,0,0,0
1668267671111,MATH 200B,A00,098023,Salehi Golsefidy; Alireza,12,0,15,3
1668267671538,MATH 202B,A00,098024,Rhoades; Brendon Patrick,9,0,15,6
1668267671962,MATH 203B,A00,098025,Oprea; Dragos N.,10,0,15,5
1668267672387,MATH 204B,A00,098026,Sorensen; Claus M,13,0,15,2
1668267672812,MATH 208,A00,098027,Izadi; Elham,7,0,10,3
1668267673239,MATH 209,A00,098028,Pollack; Aaron,10,0,10,0
1668267673664,MATH 211A,A00,112919,Rogalski; Daniel,9,0,10,1
1668267674095,MATH 211B,A00,112920,Seward; Brandon M.,9,0,10,1
1668267674518,MATH 218,A00,098029,Li; Bo,10,0,10,0
1668267674943,MATH 220B,A00,098030,Novak; Jonathan I,11,0,15,4
1668267675370,MATH 221A,A00,098031,Ebenfelt; Peter F,13,0,15,2
1668267675798,MATH 231B,A00,098032,Zlatos; Andrej,12,0,15,3
1668267676222,MATH 240B,A00,098033,Ni; Lei,9,0,15,6
1668267676647,MATH 243,A00,098034,Jekel; David Andrew,10,0,10,0
1668267677084,MATH 245A,A00,098035,Nie; Jiawang,0,0,15,16
1668267677508,MATH 248,A00,098036,Bejenaru; Ioan,10,0,10,0
1668267677933,MATH 250B,A00,098037,Spolaor; Luca,14,0,15,1
1668267678362,MATH 258,A00,098038,Ni; Lei,10,0,10,0
1668267678788,MATH 264B,A00,098041,Rhoades; Brendon Patrick,9,0,15,6
1668267679216,MATH 268,A00,098042,Buss; Samuel R,10,0,10,0
1668267679640,MATH 269,A00,098043,Rhoades; Brendon Patrick,10,0,10,0
1668267680074,MATH 270B,A00,098044,Li; Bo,10,0,15,5
1668267680506,MATH 272B,A00,098045,Holst; Michael J,13,0,15,2
1668267680939,MATH 273A,A00,098046,Tian; Xiaochuan,10,0,15,5
1668267681364,MATH 275,A01,098048,Tian; Xiaochuan,6,0,10,4
1668267681786,MATH 278A,A00,098049,Holst; Michael J,8,0,10,2
1668267682210,MATH 278B,A00,098050,Cloninger; Alexander,10,0,10,0
1668267682642,MATH 278C,A00,098051,Nie; Jiawang,7,0,10,3
1668267683077,MATH 280B,A00,098052,Zheng; Tianyi,9,0,15,6
1668267683502,MATH 281B,A00,098053,Bradic; Jelena,1,0,15,14
1668267683929,MATH 282B,A00,098054,Arias-Castro; Ery,0,0,15,15
1668267684352,MATH 285,A00,098055,Fitzsimmons; Patrick J,0,0,15,17
1668267684790,MATH 287B,A00,098056,Arias-Castro; Ery,2,0,15,13
1668267685222,MATH 288,A00,098057,Agarwal; Pooja,9,0,10,1
1668267685222,MATH 288,B00,098058,Zhang; Danna,8,0,10,2
1668267685222,MATH 288,C00,098059,Williams; Ruth J,10,0,10,0
1668267685649,MATH 290B,A00,098060,Roberts; Justin Deritter,13,0,15,2
1668267686071,MATH 292,A00,098061,Belmont; Eva Kinoshita,10,0,10,0
1668267686498,MATH 295,A00,098062,Suk; Andrew Hoon,48,0,50,2
1668267686925,MATH 296,A00,098063,Novak; Jonathan I,20,0,20,0
1668267687349,MATH 297,001,098064,Gamst; Anthony Collins,9997,0,9999,2
1668268189830,COGS 205,A00,101395,Chiba; Andrea,19,0,20,1
1668268190257,COGS 210B,001,101404,Greene; Deanna Jacquelyn,9998,0,9999,1
1668268190257,COGS 210B,002,101417,Xia; Haijun,9999,0,9999,0
1668268190257,COGS 210B,003,101422,Nitz; Douglas A.,9999,0,9999,0
1668268190257,COGS 210B,004,101423,Hollan; James D.,9998,0,9999,1
1668268190257,COGS 210B,005,101424,Deak; Gedeon O.,9998,0,9999,1
1668268190257,COGS 210B,006,101425,Rossano; Federico,9999,0,9999,0
1668268190690,COGS 211B,A00,101427,Coulson; Seana M,9996,0,9999,3
1668268191128,COGS 220,A00,101428,Hollan; James D.,0,0,25,25
1668268191552,COGS 229,A00,101429,Dow; Steven P,18,0,25,7
1668268191978,COGS 230,A00,101430,Klemmer; Scott R,12,0,17,5
1668268192407,COGS 234,A00,101431,Xia; Haijun,2,0,25,23
1668268192830,COGS 260,A00,101432,Kiyonaga; Anastasia,21,0,25,4
1668268192830,COGS 260,B00,101433,Kirsh; David Joel,15,0,25,10
1668268193258,CSE 202,A00,102371,Impagliazzo; Russell,0,0,0,0
1668268193688,CSE 203B,A01,102373,Cheng; Chung Kuan,0,0,0,0
1668268194112,CSE 208,A00,102374,Micciancio; Daniele,0,0,0,0
1668268194540,CSE 209A,A00,112895,Impagliazzo; Russell,0,0,15,15
1668268194976,CSE 209B,A00,108005,Bellare; Mihir,0,0,0,0
1668268195419,CSE 210,A00,113163,Coblenz; Michael J,0,0,0,0
1668268195857,CSE 219,A00,106111,Dow; Steven P,0,0,20,20
1668268196279,CSE 221,A00,102376,Voelker; Geoffrey M.,0,0,0,0
1668268196722,CSE 224,A01,102378,Porter; George M,0,0,0,0
1668268197161,CSE 229A,A00,102379,Savage; Stefan,0,0,0,0
1668268197586,CSE 229C,A00,102380,Munyaka; Imani N. S.,0,0,0,0
1668268198009,CSE 232B,A00,102382,Deutsch; Alin Bernard,0,0,0,0
1668268198434,CSE 234,A01,112904,Kumar; Arun Kumar,0,0,0,0
1668268198867,CSE 237A,A00,102383,Rosing; Tajana Simunic,0,0,0,0
1668268199300,CSE 239A,A00,102384,Deutsch; Alin Bernard,0,0,0,0
1668268199723,CSE 239B,A00,102385,Polikarpova; Nadezhda,0,0,0,0
1668268200145,CSE 240A,A00,102386,Pannuto; Patrick William,0,0,0,0
1668268200568,CSE 240B,A00,102387,Zhao; Jishen,0,0,0,0
1668268200993,CSE 241A,A00,106406,Kang; Mingu,0,0,0,0
1668268201423,CSE 249B,A00,102388,Kahng; Andrew Byun,0,0,8,8
1668268201848,CSE 251B,A01,102392,Cottrell; Garrison W,0,0,0,0
1668268201848,CSE 251B,A02,102393,Cottrell; Garrison W,0,0,0,0
1668268202285,CSE 252B,A00,102394,Ochoa; Benjamin Lawrence,0,0,0,0
1668268202712,CSE 257,A01,102396,Gao; Sicun,0,0,0,0
1668268203140,CSE 272,A00,102397,Li; Tzumao,0,0,0,0
1668268203567,CSE 274,A00,111323,Chern; Albert Ren-Haur,0,0,0,0
1668268203999,CSE 282,A00,102398,Pevzner; Pavel Arkadjevich,0,0,0,0
1668268204429,CSE 284,A00,114175,Gymrek; Melissa Ann,0,0,0,0
1668268204857,CSE 290,A00,102399,Chandraker; Manmohan Krishna,0,0,0,0
1668268204857,CSE 290,B00,102400,Vaccaro; Kristen Marie,0,0,25,25
1668268204857,CSE 290,C00,102414,Pannuto; Patrick William,0,0,25,25
1668268204857,CSE 290,D00,102427,Pevzner; Pavel Arkadjevich,0,0,0,0
1668268204857,CSE 290,E00,102429,Zhao; Jishen,0,0,0,0
1668268204857,CSE 290,F00,102436,Tullsen; Dean Michael,0,0,0,0
1668268204857,CSE 290,G00,102440,Christensen; Henrik I,0,0,20,20
1668268205285,CSE 291,A00,102443,Su; Hao,0,0,0,0
1668268205285,CSE 291,B00,102448,Polikarpova; Nadezhda,0,0,0,0
1668268205285,CSE 291,C00,102453,Vaccaro; Kristen Marie,0,0,0,0
1668268205285,CSE 291,D00,111343,Savage; Stefan,0,0,0,0
1668268205285,CSE 291,E00,116474,Claffy; Kimberly Claire,0,0,0,0
1668268205285,CSE 291,F00,116479,Pasquale; Joseph,0,0,0,0
1668268205768,CSE 293,001,119111,Bafna; Vineet,9999,0,9999,0
1668268205768,CSE 293,002,119118,Bellare; Mihir,9999,0,9999,0
1668268205768,CSE 293,003,119122,Berg-Kirkpatrick; Taylor D,9999,0,9999,0
1668268205768,CSE 293,004,119135,Christensen; Henrik I,9999,0,9999,0
1668268205768,CSE 293,005,119142,Cottrell; Garrison W,9999,0,9999,0
1668268205768,CSE 293,006,119146,Deutsch; Alin Bernard,9999,0,9999,0
1668268205768,CSE 293,007,119159,Esmaeilzadeh; Hadi,9999,0,9999,0
1668268205768,CSE 293,008,119166,Freund; Yoav,9999,0,9999,0
1668268205768,CSE 293,009,119170,Griswold; William G.,9999,0,9999,0
1668268205768,CSE 293,010,119183,Gymrek; Melissa Ann,9999,0,9999,0
1668268205768,CSE 293,011,119190,Heninger; Nadia A,9999,0,9999,0
1668268205768,CSE 293,012,119230,Impagliazzo; Russell,9999,0,9999,0
1668268205768,CSE 293,013,119232,Jhala; Ranjit,9999,0,9999,0
1668268205768,CSE 293,014,119233,Kahng; Andrew Byun,9999,0,9999,0
1668268205768,CSE 293,015,119298,Kane; Daniel Mertz,9999,0,9999,0
1668268205768,CSE 293,016,119299,Kriegman; David J,9999,0,9999,0
1668268205768,CSE 293,017,119300,Kumar; Arun Kumar,9999,0,9999,0
1668268205768,CSE 293,018,119301,Lerner; Sorin,9999,0,9999,0
1668268205768,CSE 293,019,119302,Lovett; Shachar,9999,0,9999,0
1668268205768,CSE 293,020,119303,McAuley; Julian John,9999,0,9999,0
1668268205768,CSE 293,021,119304,Micciancio; Daniele,9999,0,9999,0
1668268205768,CSE 293,022,119367,Orailoglu; Alex,9999,0,9999,0
1668268205768,CSE 293,023,119382,Paturi; Ramamohan,9999,0,9999,0
1668268205768,CSE 293,024,119404,Polikarpova; Nadezhda,9999,0,9999,0
1668268205768,CSE 293,025,119406,Politz; Joseph Gibbs,9999,0,9999,0
1668268205768,CSE 293,026,119411,Porter; George M,9999,0,9999,0
1668268205768,CSE 293,027,119414,Porter; Leonard Emerson,9999,0,9999,0
1668268205768,CSE 293,028,119416,Ramamoorthi; Ravi,9999,0,9999,0
1668268205768,CSE 293,029,119417,Sahoo; Debashis,9999,0,9999,0
1668268205768,CSE 293,030,119420,Saul; Lawrence,9999,0,9999,0
1668268205768,CSE 293,031,119421,Savage; Stefan,9999,0,9999,0
1668268205768,CSE 293,032,119425,Schulze; Jurgen P.,9999,0,9999,0
1668268205768,CSE 293,033,119426,Snoeren; Alex C.,9999,0,9999,0
1668268205768,CSE 293,034,119428,Shang; Jingbo,9999,0,9999,0
1668268205768,CSE 293,035,119430,Stefan; Deian,9999,0,9999,0
1668268205768,CSE 293,036,119431,Su; Hao,9999,0,9999,0
1668268205768,CSE 293,037,119433,Swanson; Steven James,9999,0,9999,0
1668268205768,CSE 293,038,119435,Tullsen; Dean Michael,9999,0,9999,0
1668268205768,CSE 293,039,119483,Voelker; Geoffrey M.,9999,0,9999,0
1668268205768,CSE 293,040,119537,Zhao; Jishen,9999,0,9999,0
1668268205768,CSE 293,041,119538,Zhou; Yuan-Yuan,9999,0,9999,0
1668268205768,CSE 293,042,119539,Gao; Sicun,9999,0,9999,0
1668268205768,CSE 293,043,119540,Weibel; Nadir,9999,0,9999,0
1668268205768,CSE 293,044,119541,Gupta; Rajesh K.,9999,0,9999,0
1668268205768,CSE 293,045,126410,Vaccaro; Kristen Marie,9999,0,9999,0
1668268205768,CSE 293,046,126411,Klemke; Richard,9999,0,9999,0
1668268206194,CSE 294,A00,102459,Voelker; Geoffrey M.,0,0,0,0
1668268206194,CSE 294,B00,111322,Orailoglu; Alex,0,0,0,0
1668268206626,DSE 201,A00,096914,Deutsch; Alin Bernard,30,0,30,0
1668268207050,DSE 210,A00,096915,Dasgupta; Sanjoy,30,0,30,0
1668268207476,DSE 260A,A00,096916,Altintas De Callaf; Ilkay,30,0,30,0
1668268207922,ECE 200,001,103586,Antipa; Nicholas A,9999,0,9999,0
1668268207922,ECE 200,002,103587,Atanasov; Nikolay A.,9999,0,9999,0
1668268207922,ECE 200,003,103588,Bharadia; Dinesh,9999,0,9999,0
1668268207922,ECE 200,004,103589,Cheng; Chung Kuan,9999,0,9999,0
1668268207922,ECE 200,005,103590,Cosman; Pamela C.,9999,0,9999,0
1668268207922,ECE 200,006,103591,Dayeh; Shadi Ahmad,9999,0,9999,0
1668268207922,ECE 200,007,103592,Fainman; Yeshaiahu,9999,0,9999,0
1668268207922,ECE 200,008,103593,Ford; Joseph Earl,9999,0,9999,0
1668268207922,ECE 200,009,103594,Franceschetti; Massimo,9999,0,9999,0
1668268207922,ECE 200,010,103595,Fullerton; Eric E,9999,0,9999,0
1668268207922,ECE 200,011,103596,Galton; Ian A,9999,0,9999,0
1668268207922,ECE 200,012,103597,Gilja; Vikash,9999,0,9999,0
1668268207922,ECE 200,013,103598,Hall; Drew A.,9999,0,9999,0
1668268207922,ECE 200,014,103599,Hsueh; Tzu-Chien,9999,0,9999,0
1668268207922,ECE 200,015,103600,Javidi; Tara,9999,0,9999,0
1668268207922,ECE 200,016,103601,Kahng; Andrew Byun,9999,0,9999,0
1668268207922,ECE 200,017,103602,Kim; Young-Han,9999,0,9999,0
1668268207922,ECE 200,018,103603,Koushanfar; Farinaz,9999,0,9999,0
1668268207922,ECE 200,019,103604,Kuzum; Duygu,9999,0,9999,0
1668268207922,ECE 200,020,103605,Le; Hanh-Phuc,9999,0,9999,0
1668268207922,ECE 200,021,103606,Lin; Bill,9999,0,9999,0
1668268207922,ECE 200,022,103607,Liu; Zhaowei,9998,0,9999,1
1668268207922,ECE 200,023,103608,Lo; Yu-Hwa,9999,0,9999,0
1668268207922,ECE 200,024,103609,Lomakin; Vitaliy,9999,0,9999,0
1668268207922,ECE 200,025,103610,Mercier; Patrick Philip,9999,0,9999,0
1668268207922,ECE 200,026,103611,Meyer; Florian,9999,0,9999,0
1668268207922,ECE 200,027,103612,Milstein; Laurence B.,9999,0,9999,0
1668268207922,ECE 200,028,103613,Mir Arabbaygi; Siavash,9999,0,9999,0
1668268207922,ECE 200,029,103614,Mookherjea; Shayan,9999,0,9999,0
1668268207922,ECE 200,030,103615,Morris; Karcher William,9999,0,9999,0
1668268207922,ECE 200,031,103616,Ng; Tse Nga,9999,0,9999,0
1668268207922,ECE 200,032,103617,Nguyen; Truong Quang,9999,0,9999,0
1668268207922,ECE 200,033,103618,Nomura; Kenji,9999,0,9999,0
1668268207922,ECE 200,034,103619,Orlitsky; Alon,9999,0,9999,0
1668268207922,ECE 200,035,103620,Pal; Piya,9999,0,9999,0
1668268207922,ECE 200,036,103621,Papen; George C.,9999,0,9999,0
1668268207922,ECE 200,037,103622,Radic; Stojan,9999,0,9999,0
1668268207922,ECE 200,038,103623,Rao; Bhaskar D.,9999,0,9999,0
1668268207922,ECE 200,039,103624,Rao; Ramesh R,9999,0,9999,0
1668268207922,ECE 200,040,103625,Rebeiz; Gabriel,9999,0,9999,0
1668268207922,ECE 200,041,103626,Sanford; John R,9999,0,9999,0
1668268207922,ECE 200,042,103627,Siegel; Paul H.,9999,0,9999,0
1668268207922,ECE 200,043,103628,Sievenpiper; Daniel F.,9999,0,9999,0
1668268207922,ECE 200,044,103629,Sworder; David D.,9999,0,9999,0
1668268207922,ECE 200,045,103630,Taur; Yuan,9999,0,9999,0
1668268207922,ECE 200,046,103631,Touri; Behrouz,9999,0,9999,0
1668268207922,ECE 200,047,103632,Trivedi; Mohan M.,9999,0,9999,0
1668268207922,ECE 200,048,103633,Vasconcelos; Nuno,9999,0,9999,0
1668268207922,ECE 200,049,103634,Wang; Xiaolong,9999,0,9999,0
1668268207922,ECE 200,050,103635,Xie; Pengtao,9999,0,9999,0
1668268207922,ECE 200,051,103636,Yip; Michael,9999,0,9999,0
1668268207922,ECE 200,052,103637,Zeger; Kenneth A.,999,0,999,0
1668268207922,ECE 200,053,103638,Zhang; Xinyu,9999,0,9999,0
1668268207922,ECE 200,054,103639,Turakhia; Yatish Girish,9999,0,9999,0
1668268207922,ECE 200,055,103640,Kang; Mingu,9999,0,9999,0
1668268207922,ECE 200,056,103641,Shi; Yuanyuan,9999,0,9999,0
1668268207922,ECE 200,057,103642,Wang; Edward Jay,9999,0,9999,0
1668268207922,ECE 200,058,103643,Zheng; Yang,9999,0,9999,0
1668268208363,ECE 202,A00,103644,Kuzum; Duygu,0,0,0,0
1668268208795,ECE 212BN,A00,103646,Ng; Tse Nga,0,0,0,0
1668268209219,ECE 221,A00,111493,Staff,0,0,0,0
1668268209641,ECE 222B,A00,103647,Lomakin; Vitaliy,0,0,0,0
1668268210067,ECE 230B,A00,103648,Taur; Yuan,0,0,0,0
1668268210494,ECE 238B,A00,103649,Garay; Javier,0,0,0,0
1668268210919,ECE 240B,A00,112900,Fainman; Yeshaiahu,0,0,0,0
1668268211342,ECE 247A,A00,103650,Jokerst; Jesse Vincent,0,0,0,0
1668268211765,ECE 247B,A00,103651,Wang; Joseph,0,0,0,0
1668268212194,ECE 250,A00,103652,Siegel; Paul H.,0,0,0,0
1668268212622,ECE 251A,A00,103654,Rao; Bhaskar D.,0,0,0,0
1668268213045,ECE 257B,A00,103655,Bharadia; Dinesh,0,0,0,0
1668268213472,ECE 258A,A00,103656,Milstein; Laurence B.,0,0,0,0
1668268213904,ECE 260B,A00,103658,Kang; Mingu,0,0,0,0
1668268214328,ECE 264A,A00,103659,Galton; Ian A,0,0,0,0
1668268214758,ECE 265A,A00,103661,Gudem; Prasad S.S.,0,0,0,0
1668268215181,ECE 265D,A00,103662,Gudem; Prasad S.S.,0,0,0,0
1668268215606,ECE 268,A00,103663,Koushanfar; Farinaz,0,0,0,0
1668268216032,ECE 269,A01,103665,Pal; Piya,0,0,0,0
1668268216470,ECE 271B,A00,103666,Vasconcelos; Manuela,0,0,0,0
1668268216902,ECE 276A,A00,103667,Atanasov; Nikolay A.,0,0,0,0
1668268217328,ECE 277,A00,103668,An; Cheolhong,0,0,0,0
1668268217757,ECE 279,A00,117947,Hall; Drew A.,0,0,0,0
1668268218621,ECE 283,A00,103670,Hsueh; Tzu-Chien,0,0,0,0
1668268219045,ECE 284,A00,103671,Turakhia; Yatish Girish,0,0,0,0
1668268219469,ECE 285,A00,103672,Zheng; Yang,0,0,0,0
1668268219469,ECE 285,B00,103673,Sworder; David D.,0,0,0,0
1668268219891,ECE 287,A00,103676,Javidi; Tara,0,0,0,0
1668268220318,MATH 200B,A00,098023,Salehi Golsefidy; Alireza,12,0,15,3
1668268220758,MATH 202B,A00,098024,Rhoades; Brendon Patrick,9,0,15,6
1668268221180,MATH 203B,A00,098025,Oprea; Dragos N.,10,0,15,5
1668268221603,MATH 204B,A00,098026,Sorensen; Claus M,13,0,15,2
1668268222032,MATH 208,A00,098027,Izadi; Elham,7,0,10,3
1668268222459,MATH 209,A00,098028,Pollack; Aaron,10,0,10,0
1668268222885,MATH 211A,A00,112919,Rogalski; Daniel,9,0,10,1
1668268223309,MATH 211B,A00,112920,Seward; Brandon M.,9,0,10,1
1668268223736,MATH 218,A00,098029,Li; Bo,10,0,10,0
1668268224169,MATH 220B,A00,098030,Novak; Jonathan I,11,0,15,4
1668268224597,MATH 221A,A00,098031,Ebenfelt; Peter F,13,0,15,2
1668268225019,MATH 231B,A00,098032,Zlatos; Andrej,12,0,15,3
1668268225441,MATH 240B,A00,098033,Ni; Lei,9,0,15,6
1668268225878,MATH 243,A00,098034,Jekel; David Andrew,10,0,10,0
1668268226308,MATH 245A,A00,098035,Nie; Jiawang,0,0,15,16
1668268226732,MATH 248,A00,098036,Bejenaru; Ioan,10,0,10,0
1668268227156,MATH 250B,A00,098037,Spolaor; Luca,14,0,15,1
1668268227586,MATH 258,A00,098038,Ni; Lei,10,0,10,0
1668268228008,MATH 264B,A00,098041,Rhoades; Brendon Patrick,9,0,15,6
1668268228432,MATH 268,A00,098042,Buss; Samuel R,10,0,10,0
1668268228856,MATH 269,A00,098043,Rhoades; Brendon Patrick,10,0,10,0
1668268229282,MATH 270B,A00,098044,Li; Bo,10,0,15,5
1668268229717,MATH 272B,A00,098045,Holst; Michael J,13,0,15,2
1668268230153,MATH 273A,A00,098046,Tian; Xiaochuan,10,0,15,5
1668268230693,MATH 275,A01,098048,Tian; Xiaochuan,6,0,10,4
1668268231121,MATH 278A,A00,098049,Holst; Michael J,8,0,10,2
1668268231547,MATH 278B,A00,098050,Cloninger; Alexander,10,0,10,0
1668268231970,MATH 278C,A00,098051,Nie; Jiawang,7,0,10,3
1668268232397,MATH 280B,A00,098052,Zheng; Tianyi,9,0,15,6
1668268232828,MATH 281B,A00,098053,Bradic; Jelena,1,0,15,14
1668268233266,MATH 282B,A00,098054,Arias-Castro; Ery,0,0,15,15
1668268233692,MATH 285,A00,098055,Fitzsimmons; Patrick J,0,0,15,17
1668268234114,MATH 287B,A00,098056,Arias-Castro; Ery,2,0,15,13
1668268234548,MATH 288,A00,098057,Agarwal; Pooja,9,0,10,1
1668268234548,MATH 288,B00,098058,Zhang; Danna,8,0,10,2
1668268234548,MATH 288,C00,098059,Williams; Ruth J,10,0,10,0
1668268234975,MATH 290B,A00,098060,Roberts; Justin Deritter,13,0,15,2
1668268235401,MATH 292,A00,098061,Belmont; Eva Kinoshita,10,0,10,0
1668268235828,MATH 295,A00,098062,Suk; Andrew Hoon,48,0,50,2
1668268236252,MATH 296,A00,098063,Novak; Jonathan I,20,0,20,0
1668268236684,MATH 297,001,098064,Gamst; Anthony Collins,9997,0,9999,2
1668268739306,COGS 205,A00,101395,Chiba; Andrea,19,0,20,1
1668268739734,COGS 210B,001,101404,Greene; Deanna Jacquelyn,9998,0,9999,1
1668268739734,COGS 210B,002,101417,Xia; Haijun,9999,0,9999,0
1668268739734,COGS 210B,003,101422,Nitz; Douglas A.,9999,0,9999,0
1668268739734,COGS 210B,004,101423,Hollan; James D.,9998,0,9999,1
1668268739734,COGS 210B,005,101424,Deak; Gedeon O.,9998,0,9999,1
1668268739734,COGS 210B,006,101425,Rossano; Federico,9999,0,9999,0
1668268740166,COGS 211B,A00,101427,Coulson; Seana M,9996,0,9999,3
1668268740598,COGS 220,A00,101428,Hollan; James D.,0,0,25,25
1668268741036,COGS 229,A00,101429,Dow; Steven P,18,0,25,7
1668268741467,COGS 230,A00,101430,Klemmer; Scott R,12,0,17,5
1668268741894,COGS 234,A00,101431,Xia; Haijun,2,0,25,23
1668268742323,COGS 260,A00,101432,Kiyonaga; Anastasia,21,0,25,4
1668268742323,COGS 260,B00,101433,Kirsh; David Joel,15,0,25,10
1668268742746,CSE 202,A00,102371,Impagliazzo; Russell,0,0,0,0
1668268743170,CSE 203B,A01,102373,Cheng; Chung Kuan,0,0,0,0
1668268743598,CSE 208,A00,102374,Micciancio; Daniele,0,0,0,0
1668268744031,CSE 209A,A00,112895,Impagliazzo; Russell,0,0,15,15
1668268744458,CSE 209B,A00,108005,Bellare; Mihir,0,0,0,0
1668268744881,CSE 210,A00,113163,Coblenz; Michael J,0,0,0,0
1668268745303,CSE 219,A00,106111,Dow; Steven P,0,0,20,20
1668268745726,CSE 221,A00,102376,Voelker; Geoffrey M.,0,0,0,0
1668268746168,CSE 224,A01,102378,Porter; George M,0,0,0,0
1668268746601,CSE 229A,A00,102379,Savage; Stefan,0,0,0,0
1668268747042,CSE 229C,A00,102380,Munyaka; Imani N. S.,0,0,0,0
1668268747474,CSE 232B,A00,102382,Deutsch; Alin Bernard,0,0,0,0
1668268747904,CSE 234,A01,112904,Kumar; Arun Kumar,0,0,0,0
1668268748351,CSE 237A,A00,102383,Rosing; Tajana Simunic,0,0,0,0
1668268748791,CSE 239A,A00,102384,Deutsch; Alin Bernard,0,0,0,0
1668268749214,CSE 239B,A00,102385,Polikarpova; Nadezhda,0,0,0,0
1668268749640,CSE 240A,A00,102386,Pannuto; Patrick William,0,0,0,0
1668268750066,CSE 240B,A00,102387,Zhao; Jishen,0,0,0,0
1668268750489,CSE 241A,A00,106406,Kang; Mingu,0,0,0,0
1668268750914,CSE 249B,A00,102388,Kahng; Andrew Byun,0,0,8,8
1668268751349,CSE 251B,A01,102392,Cottrell; Garrison W,0,0,0,0
1668268751349,CSE 251B,A02,102393,Cottrell; Garrison W,0,0,0,0
1668268751770,CSE 252B,A00,102394,Ochoa; Benjamin Lawrence,0,0,0,0
1668268752194,CSE 257,A01,102396,Gao; Sicun,0,0,0,0
1668268752622,CSE 272,A00,102397,Li; Tzumao,0,0,0,0
1668268753051,CSE 274,A00,111323,Chern; Albert Ren-Haur,0,0,0,0
1668268753595,CSE 282,A00,102398,Pevzner; Pavel Arkadjevich,0,0,0,0
1668268754029,CSE 284,A00,114175,Gymrek; Melissa Ann,0,0,0,0
1668268754457,CSE 290,A00,102399,Chandraker; Manmohan Krishna,0,0,0,0
1668268754457,CSE 290,B00,102400,Vaccaro; Kristen Marie,0,0,25,25
1668268754457,CSE 290,C00,102414,Pannuto; Patrick William,0,0,25,25
1668268754457,CSE 290,D00,102427,Pevzner; Pavel Arkadjevich,0,0,0,0
1668268754457,CSE 290,E00,102429,Zhao; Jishen,0,0,0,0
1668268754457,CSE 290,F00,102436,Tullsen; Dean Michael,0,0,0,0
1668268754457,CSE 290,G00,102440,Christensen; Henrik I,0,0,20,20
1668268754879,CSE 291,A00,102443,Su; Hao,0,0,0,0
1668268754879,CSE 291,B00,102448,Polikarpova; Nadezhda,0,0,0,0
1668268754879,CSE 291,C00,102453,Vaccaro; Kristen Marie,0,0,0,0
1668268754879,CSE 291,D00,111343,Savage; Stefan,0,0,0,0
1668268754879,CSE 291,E00,116474,Claffy; Kimberly Claire,0,0,0,0
1668268754879,CSE 291,F00,116479,Pasquale; Joseph,0,0,0,0
1668268755312,CSE 293,001,119111,Bafna; Vineet,9999,0,9999,0
1668268755312,CSE 293,002,119118,Bellare; Mihir,9999,0,9999,0
1668268755312,CSE 293,003,119122,Berg-Kirkpatrick; Taylor D,9999,0,9999,0
1668268755312,CSE 293,004,119135,Christensen; Henrik I,9999,0,9999,0
1668268755312,CSE 293,005,119142,Cottrell; Garrison W,9999,0,9999,0
1668268755312,CSE 293,006,119146,Deutsch; Alin Bernard,9999,0,9999,0
1668268755312,CSE 293,007,119159,Esmaeilzadeh; Hadi,9999,0,9999,0
1668268755312,CSE 293,008,119166,Freund; Yoav,9999,0,9999,0
1668268755312,CSE 293,009,119170,Griswold; William G.,9999,0,9999,0
1668268755312,CSE 293,010,119183,Gymrek; Melissa Ann,9999,0,9999,0
1668268755312,CSE 293,011,119190,Heninger; Nadia A,9999,0,9999,0
1668268755312,CSE 293,012,119230,Impagliazzo; Russell,9999,0,9999,0
1668268755312,CSE 293,013,119232,Jhala; Ranjit,9999,0,9999,0
1668268755312,CSE 293,014,119233,Kahng; Andrew Byun,9999,0,9999,0
1668268755312,CSE 293,015,119298,Kane; Daniel Mertz,9999,0,9999,0
1668268755312,CSE 293,016,119299,Kriegman; David J,9999,0,9999,0
1668268755312,CSE 293,017,119300,Kumar; Arun Kumar,9999,0,9999,0
1668268755312,CSE 293,018,119301,Lerner; Sorin,9999,0,9999,0
1668268755312,CSE 293,019,119302,Lovett; Shachar,9999,0,9999,0
1668268755312,CSE 293,020,119303,McAuley; Julian John,9999,0,9999,0
1668268755312,CSE 293,021,119304,Micciancio; Daniele,9999,0,9999,0
1668268755312,CSE 293,022,119367,Orailoglu; Alex,9999,0,9999,0
1668268755312,CSE 293,023,119382,Paturi; Ramamohan,9999,0,9999,0
1668268755312,CSE 293,024,119404,Polikarpova; Nadezhda,9999,0,9999,0
1668268755312,CSE 293,025,119406,Politz; Joseph Gibbs,9999,0,9999,0
1668268755312,CSE 293,026,119411,Porter; George M,9999,0,9999,0
1668268755312,CSE 293,027,119414,Porter; Leonard Emerson,9999,0,9999,0
1668268755312,CSE 293,028,119416,Ramamoorthi; Ravi,9999,0,9999,0
1668268755312,CSE 293,029,119417,Sahoo; Debashis,9999,0,9999,0
1668268755312,CSE 293,030,119420,Saul; Lawrence,9999,0,9999,0
1668268755312,CSE 293,031,119421,Savage; Stefan,9999,0,9999,0
1668268755312,CSE 293,032,119425,Schulze; Jurgen P.,9999,0,9999,0
1668268755312,CSE 293,033,119426,Snoeren; Alex C.,9999,0,9999,0
1668268755312,CSE 293,034,119428,Shang; Jingbo,9999,0,9999,0
1668268755312,CSE 293,035,119430,Stefan; Deian,9999,0,9999,0
1668268755312,CSE 293,036,119431,Su; Hao,9999,0,9999,0
1668268755312,CSE 293,037,119433,Swanson; Steven James,9999,0,9999,0
1668268755312,CSE 293,038,119435,Tullsen; Dean Michael,9999,0,9999,0
1668268755312,CSE 293,039,119483,Voelker; Geoffrey M.,9999,0,9999,0
1668268755312,CSE 293,040,119537,Zhao; Jishen,9999,0,9999,0
1668268755312,CSE 293,041,119538,Zhou; Yuan-Yuan,9999,0,9999,0
1668268755312,CSE 293,042,119539,Gao; Sicun,9999,0,9999,0
1668268755312,CSE 293,043,119540,Weibel; Nadir,9999,0,9999,0
1668268755312,CSE 293,044,119541,Gupta; Rajesh K.,9999,0,9999,0
1668268755312,CSE 293,045,126410,Vaccaro; Kristen Marie,9999,0,9999,0
1668268755312,CSE 293,046,126411,Klemke; Richard,9999,0,9999,0
1668268755736,CSE 294,A00,102459,Voelker; Geoffrey M.,0,0,0,0
1668268755736,CSE 294,B00,111322,Orailoglu; Alex,0,0,0,0
1668268756167,DSE 201,A00,096914,Deutsch; Alin Bernard,30,0,30,0
1668268756604,DSE 210,A00,096915,Dasgupta; Sanjoy,30,0,30,0
1668268757027,DSE 260A,A00,096916,Altintas De Callaf; Ilkay,30,0,30,0
1668268757463,ECE 200,001,103586,Antipa; Nicholas A,9999,0,9999,0
1668268757463,ECE 200,002,103587,Atanasov; Nikolay A.,9999,0,9999,0
1668268757463,ECE 200,003,103588,Bharadia; Dinesh,9999,0,9999,0
1668268757463,ECE 200,004,103589,Cheng; Chung Kuan,9999,0,9999,0
1668268757463,ECE 200,005,103590,Cosman; Pamela C.,9999,0,9999,0
1668268757463,ECE 200,006,103591,Dayeh; Shadi Ahmad,9999,0,9999,0
1668268757463,ECE 200,007,103592,Fainman; Yeshaiahu,9999,0,9999,0
1668268757463,ECE 200,008,103593,Ford; Joseph Earl,9999,0,9999,0
1668268757463,ECE 200,009,103594,Franceschetti; Massimo,9999,0,9999,0
1668268757463,ECE 200,010,103595,Fullerton; Eric E,9999,0,9999,0
1668268757463,ECE 200,011,103596,Galton; Ian A,9999,0,9999,0
1668268757463,ECE 200,012,103597,Gilja; Vikash,9999,0,9999,0
1668268757463,ECE 200,013,103598,Hall; Drew A.,9999,0,9999,0
1668268757463,ECE 200,014,103599,Hsueh; Tzu-Chien,9999,0,9999,0
1668268757463,ECE 200,015,103600,Javidi; Tara,9999,0,9999,0
1668268757463,ECE 200,016,103601,Kahng; Andrew Byun,9999,0,9999,0
1668268757463,ECE 200,017,103602,Kim; Young-Han,9999,0,9999,0
1668268757463,ECE 200,018,103603,Koushanfar; Farinaz,9999,0,9999,0
1668268757463,ECE 200,019,103604,Kuzum; Duygu,9999,0,9999,0
1668268757463,ECE 200,020,103605,Le; Hanh-Phuc,9999,0,9999,0
1668268757463,ECE 200,021,103606,Lin; Bill,9999,0,9999,0
1668268757463,ECE 200,022,103607,Liu; Zhaowei,9998,0,9999,1
1668268757463,ECE 200,023,103608,Lo; Yu-Hwa,9999,0,9999,0
1668268757463,ECE 200,024,103609,Lomakin; Vitaliy,9999,0,9999,0
1668268757463,ECE 200,025,103610,Mercier; Patrick Philip,9999,0,9999,0
1668268757463,ECE 200,026,103611,Meyer; Florian,9999,0,9999,0
1668268757463,ECE 200,027,103612,Milstein; Laurence B.,9999,0,9999,0
1668268757463,ECE 200,028,103613,Mir Arabbaygi; Siavash,9999,0,9999,0
1668268757463,ECE 200,029,103614,Mookherjea; Shayan,9999,0,9999,0
1668268757463,ECE 200,030,103615,Morris; Karcher William,9999,0,9999,0
1668268757463,ECE 200,031,103616,Ng; Tse Nga,9999,0,9999,0
1668268757463,ECE 200,032,103617,Nguyen; Truong Quang,9999,0,9999,0
1668268757463,ECE 200,033,103618,Nomura; Kenji,9999,0,9999,0
1668268757463,ECE 200,034,103619,Orlitsky; Alon,9999,0,9999,0
1668268757463,ECE 200,035,103620,Pal; Piya,9999,0,9999,0
1668268757463,ECE 200,036,103621,Papen; George C.,9999,0,9999,0
1668268757463,ECE 200,037,103622,Radic; Stojan,9999,0,9999,0
1668268757463,ECE 200,038,103623,Rao; Bhaskar D.,9999,0,9999,0
1668268757463,ECE 200,039,103624,Rao; Ramesh R,9999,0,9999,0
1668268757463,ECE 200,040,103625,Rebeiz; Gabriel,9999,0,9999,0
1668268757463,ECE 200,041,103626,Sanford; John R,9999,0,9999,0
1668268757463,ECE 200,042,103627,Siegel; Paul H.,9999,0,9999,0
1668268757463,ECE 200,043,103628,Sievenpiper; Daniel F.,9999,0,9999,0
1668268757463,ECE 200,044,103629,Sworder; David D.,9999,0,9999,0
1668268757463,ECE 200,045,103630,Taur; Yuan,9999,0,9999,0
1668268757463,ECE 200,046,103631,Touri; Behrouz,9999,0,9999,0
1668268757463,ECE 200,047,103632,Trivedi; Mohan M.,9999,0,9999,0
1668268757463,ECE 200,048,103633,Vasconcelos; Nuno,9999,0,9999,0
1668268757463,ECE 200,049,103634,Wang; Xiaolong,9999,0,9999,0
1668268757463,ECE 200,050,103635,Xie; Pengtao,9999,0,9999,0
1668268757463,ECE 200,051,103636,Yip; Michael,9999,0,9999,0
1668268757463,ECE 200,052,103637,Zeger; Kenneth A.,999,0,999,0
1668268757463,ECE 200,053,103638,Zhang; Xinyu,9999,0,9999,0
1668268757463,ECE 200,054,103639,Turakhia; Yatish Girish,9999,0,9999,0
1668268757463,ECE 200,055,103640,Kang; Mingu,9999,0,9999,0
1668268757463,ECE 200,056,103641,Shi; Yuanyuan,9999,0,9999,0
1668268757463,ECE 200,057,103642,Wang; Edward Jay,9999,0,9999,0
1668268757463,ECE 200,058,103643,Zheng; Yang,9999,0,9999,0
1668268757889,ECE 202,A00,103644,Kuzum; Duygu,0,0,0,0
1668268758324,ECE 212BN,A00,103646,Ng; Tse Nga,0,0,0,0
1668268758750,ECE 221,A00,111493,Staff,0,0,0,0
1668268759174,ECE 222B,A00,103647,Lomakin; Vitaliy,0,0,0,0
1668268759607,ECE 230B,A00,103648,Taur; Yuan,0,0,0,0
1668268760044,ECE 238B,A00,103649,Garay; Javier,0,0,0,0
1668268760469,ECE 240B,A00,112900,Fainman; Yeshaiahu,0,0,0,0
1668268760893,ECE 247A,A00,103650,Jokerst; Jesse Vincent,0,0,0,0
1668268761331,ECE 247B,A00,103651,Wang; Joseph,0,0,0,0
1668268761759,ECE 250,A00,103652,Siegel; Paul H.,0,0,0,0
1668268762183,ECE 251A,A00,103654,Rao; Bhaskar D.,0,0,0,0
1668268762607,ECE 257B,A00,103655,Bharadia; Dinesh,0,0,0,0
1668268763043,ECE 258A,A00,103656,Milstein; Laurence B.,0,0,0,0
1668268763469,ECE 260B,A00,103658,Kang; Mingu,0,0,0,0
1668268763892,ECE 264A,A00,103659,Galton; Ian A,0,0,0,0
1668268764320,ECE 265A,A00,103661,Gudem; Prasad S.S.,0,0,0,0
1668268764744,ECE 265D,A00,103662,Gudem; Prasad S.S.,0,0,0,0
1668268765176,ECE 268,A00,103663,Koushanfar; Farinaz,0,0,0,0
1668268765603,ECE 269,A01,103665,Pal; Piya,0,0,0,0
1668268766027,ECE 271B,A00,103666,Vasconcelos; Manuela,0,0,0,0
1668268766453,ECE 276A,A00,103667,Atanasov; Nikolay A.,0,0,0,0
1668268766877,ECE 277,A00,103668,An; Cheolhong,0,0,0,0
1668268767300,ECE 279,A00,117947,Hall; Drew A.,0,0,0,0
1668268768160,ECE 283,A00,103670,Hsueh; Tzu-Chien,0,0,0,0
1668268768590,ECE 284,A00,103671,Turakhia; Yatish Girish,0,0,0,0
1668268769026,ECE 285,A00,103672,Zheng; Yang,0,0,0,0
1668268769026,ECE 285,B00,103673,Sworder; David D.,0,0,0,0
1668268769454,ECE 287,A00,103676,Javidi; Tara,0,0,0,0
1668268769885,MATH 200B,A00,098023,Salehi Golsefidy; Alireza,12,0,15,3
1668268770309,MATH 202B,A00,098024,Rhoades; Brendon Patrick,9,0,15,6
1668268770748,MATH 203B,A00,098025,Oprea; Dragos N.,10,0,15,5
1668268771171,MATH 204B,A00,098026,Sorensen; Claus M,13,0,15,2
1668268771596,MATH 208,A00,098027,Izadi; Elham,7,0,10,3
1668268772027,MATH 209,A00,098028,Pollack; Aaron,10,0,10,0
1668268772453,MATH 211A,A00,112919,Rogalski; Daniel,9,0,10,1
1668268772888,MATH 211B,A00,112920,Seward; Brandon M.,9,0,10,1
1668268773315,MATH 218,A00,098029,Li; Bo,10,0,10,0
1668268773740,MATH 220B,A00,098030,Novak; Jonathan I,11,0,15,4
1668268774169,MATH 221A,A00,098031,Ebenfelt; Peter F,13,0,15,2
1668268774599,MATH 231B,A00,098032,Zlatos; Andrej,12,0,15,3
1668268775022,MATH 240B,A00,098033,Ni; Lei,9,0,15,6
1668268775448,MATH 243,A00,098034,Jekel; David Andrew,10,0,10,0
1668268775874,MATH 245A,A00,098035,Nie; Jiawang,0,0,15,16
1668268776296,MATH 248,A00,098036,Bejenaru; Ioan,10,0,10,0
1668268776733,MATH 250B,A00,098037,Spolaor; Luca,14,0,15,1
1668268777170,MATH 258,A00,098038,Ni; Lei,10,0,10,0
1668268777603,MATH 264B,A00,098041,Rhoades; Brendon Patrick,9,0,15,6
1668268778031,MATH 268,A00,098042,Buss; Samuel R,10,0,10,0
1668268778457,MATH 269,A00,098043,Rhoades; Brendon Patrick,10,0,10,0
1668268778880,MATH 270B,A00,098044,Li; Bo,10,0,15,5
1668268779306,MATH 272B,A00,098045,Holst; Michael J,13,0,15,2
1668268779728,MATH 273A,A00,098046,Tian; Xiaochuan,10,0,15,5
1668268780155,MATH 275,A01,098048,Tian; Xiaochuan,6,0,10,4
1668268780582,MATH 278A,A00,098049,Holst; Michael J,8,0,10,2
1668268781005,MATH 278B,A00,098050,Cloninger; Alexander,10,0,10,0
1668268781427,MATH 278C,A00,098051,Nie; Jiawang,7,0,10,3
1668268781853,MATH 280B,A00,098052,Zheng; Tianyi,9,0,15,6
1668268782281,MATH 281B,A00,098053,Bradic; Jelena,1,0,15,14
1668268782707,MATH 282B,A00,098054,Arias-Castro; Ery,0,0,15,15
1668268783142,MATH 285,A00,098055,Fitzsimmons; Patrick J,0,0,15,17
1668268783564,MATH 287B,A00,098056,Arias-Castro; Ery,2,0,15,13
1668268783990,MATH 288,A00,098057,Agarwal; Pooja,9,0,10,1
1668268783990,MATH 288,B00,098058,Zhang; Danna,8,0,10,2
1668268783990,MATH 288,C00,098059,Williams; Ruth J,10,0,10,0
1668268784414,MATH 290B,A00,098060,Roberts; Justin Deritter,13,0,15,2
1668268784837,MATH 292,A00,098061,Belmont; Eva Kinoshita,10,0,10,0
1668268785263,MATH 295,A00,098062,Suk; Andrew Hoon,48,0,50,2
1668268785684,MATH 296,A00,098063,Novak; Jonathan I,20,0,20,0
1668268786117,MATH 297,001,098064,Gamst; Anthony Collins,9997,0,9999,2
1668269288437,COGS 205,A00,101395,Chiba; Andrea,19,0,20,1
1668269288860,COGS 210B,001,101404,Greene; Deanna Jacquelyn,9998,0,9999,1
1668269288860,COGS 210B,002,101417,Xia; Haijun,9999,0,9999,0
1668269288860,COGS 210B,003,101422,Nitz; Douglas A.,9999,0,9999,0
1668269288860,COGS 210B,004,101423,Hollan; James D.,9998,0,9999,1
1668269288860,COGS 210B,005,101424,Deak; Gedeon O.,9998,0,9999,1
1668269288860,COGS 210B,006,101425,Rossano; Federico,9999,0,9999,0
1668269289290,COGS 211B,A00,101427,Coulson; Seana M,9996,0,9999,3
1668269289714,COGS 220,A00,101428,Hollan; James D.,0,0,25,25
1668269290150,COGS 229,A00,101429,Dow; Steven P,18,0,25,7
1668269290577,COGS 230,A00,101430,Klemmer; Scott R,12,0,17,5
1668269291001,COGS 234,A00,101431,Xia; Haijun,2,0,25,23
1668269291425,COGS 260,A00,101432,Kiyonaga; Anastasia,21,0,25,4
1668269291425,COGS 260,B00,101433,Kirsh; David Joel,15,0,25,10
1668269291851,CSE 202,A00,102371,Impagliazzo; Russell,0,0,0,0
1668269292276,CSE 203B,A01,102373,Cheng; Chung Kuan,0,0,0,0
1668269292711,CSE 208,A00,102374,Micciancio; Daniele,0,0,0,0
1668269293144,CSE 209A,A00,112895,Impagliazzo; Russell,0,0,15,15
1668269293579,CSE 209B,A00,108005,Bellare; Mihir,0,0,0,0
1668269294004,CSE 210,A00,113163,Coblenz; Michael J,0,0,0,0
1668269294432,CSE 219,A00,106111,Dow; Steven P,0,0,20,20
1668269294854,CSE 221,A00,102376,Voelker; Geoffrey M.,0,0,0,0
1668269295286,CSE 224,A01,102378,Porter; George M,0,0,0,0
1668269295725,CSE 229A,A00,102379,Savage; Stefan,0,0,0,0
1668269296148,CSE 229C,A00,102380,Munyaka; Imani N. S.,0,0,0,0
1668269296586,CSE 232B,A00,102382,Deutsch; Alin Bernard,0,0,0,0
1668269297009,CSE 234,A01,112904,Kumar; Arun Kumar,0,0,0,0
1668269297434,CSE 237A,A00,102383,Rosing; Tajana Simunic,0,0,0,0
1668269297866,CSE 239A,A00,102384,Deutsch; Alin Bernard,0,0,0,0
1668269298290,CSE 239B,A00,102385,Polikarpova; Nadezhda,0,0,0,0
1668269298715,CSE 240A,A00,102386,Pannuto; Patrick William,0,0,0,0
1668269299138,CSE 240B,A00,102387,Zhao; Jishen,0,0,0,0
1668269299572,CSE 241A,A00,106406,Kang; Mingu,0,0,0,0
1668269300031,CSE 249B,A00,102388,Kahng; Andrew Byun,0,0,8,8
1668269300459,CSE 251B,A01,102392,Cottrell; Garrison W,0,0,0,0
1668269300459,CSE 251B,A02,102393,Cottrell; Garrison W,0,0,0,0
1668269300891,CSE 252B,A00,102394,Ochoa; Benjamin Lawrence,0,0,0,0
1668269301321,CSE 257,A01,102396,Gao; Sicun,0,0,0,0
1668269301743,CSE 272,A00,102397,Li; Tzumao,0,0,0,0
1668269302170,CSE 274,A00,111323,Chern; Albert Ren-Haur,0,0,0,0
1668269302592,CSE 282,A00,102398,Pevzner; Pavel Arkadjevich,0,0,0,0
1668269303017,CSE 284,A00,114175,Gymrek; Melissa Ann,0,0,0,0
1668269303446,CSE 290,A00,102399,Chandraker; Manmohan Krishna,0,0,0,0
1668269303446,CSE 290,B00,102400,Vaccaro; Kristen Marie,0,0,25,25
1668269303446,CSE 290,C00,102414,Pannuto; Patrick William,0,0,25,25
1668269303446,CSE 290,D00,102427,Pevzner; Pavel Arkadjevich,0,0,0,0
1668269303446,CSE 290,E00,102429,Zhao; Jishen,0,0,0,0
1668269303446,CSE 290,F00,102436,Tullsen; Dean Michael,0,0,0,0
1668269303446,CSE 290,G00,102440,Christensen; Henrik I,0,0,20,20
1668269303879,CSE 291,A00,102443,Su; Hao,0,0,0,0
1668269303879,CSE 291,B00,102448,Polikarpova; Nadezhda,0,0,0,0
1668269303879,CSE 291,C00,102453,Vaccaro; Kristen Marie,0,0,0,0
1668269303879,CSE 291,D00,111343,Savage; Stefan,0,0,0,0
1668269303879,CSE 291,E00,116474,Claffy; Kimberly Claire,0,0,0,0
1668269303879,CSE 291,F00,116479,Pasquale; Joseph,0,0,0,0
1668269304307,CSE 293,001,119111,Bafna; Vineet,9999,0,9999,0
1668269304307,CSE 293,002,119118,Bellare; Mihir,9999,0,9999,0
1668269304307,CSE 293,003,119122,Berg-Kirkpatrick; Taylor D,9999,0,9999,0
1668269304307,CSE 293,004,119135,Christensen; Henrik I,9999,0,9999,0
1668269304307,CSE 293,005,119142,Cottrell; Garrison W,9999,0,9999,0
1668269304307,CSE 293,006,119146,Deutsch; Alin Bernard,9999,0,9999,0
1668269304307,CSE 293,007,119159,Esmaeilzadeh; Hadi,9999,0,9999,0
1668269304307,CSE 293,008,119166,Freund; Yoav,9999,0,9999,0
1668269304307,CSE 293,009,119170,Griswold; William G.,9999,0,9999,0
1668269304307,CSE 293,010,119183,Gymrek; Melissa Ann,9999,0,9999,0
1668269304307,CSE 293,011,119190,Heninger; Nadia A,9999,0,9999,0
1668269304307,CSE 293,012,119230,Impagliazzo; Russell,9999,0,9999,0
1668269304307,CSE 293,013,119232,Jhala; Ranjit,9999,0,9999,0
1668269304307,CSE 293,014,119233,Kahng; Andrew Byun,9999,0,9999,0
1668269304307,CSE 293,015,119298,Kane; Daniel Mertz,9999,0,9999,0
1668269304307,CSE 293,016,119299,Kriegman; David J,9999,0,9999,0
1668269304307,CSE 293,017,119300,Kumar; Arun Kumar,9999,0,9999,0
1668269304307,CSE 293,018,119301,Lerner; Sorin,9999,0,9999,0
1668269304307,CSE 293,019,119302,Lovett; Shachar,9999,0,9999,0
1668269304307,CSE 293,020,119303,McAuley; Julian John,9999,0,9999,0
1668269304307,CSE 293,021,119304,Micciancio; Daniele,9999,0,9999,0
1668269304307,CSE 293,022,119367,Orailoglu; Alex,9999,0,9999,0
1668269304307,CSE 293,023,119382,Paturi; Ramamohan,9999,0,9999,0
1668269304307,CSE 293,024,119404,Polikarpova; Nadezhda,9999,0,9999,0
1668269304307,CSE 293,025,119406,Politz; Joseph Gibbs,9999,0,9999,0
1668269304307,CSE 293,026,119411,Porter; George M,9999,0,9999,0
1668269304307,CSE 293,027,119414,Porter; Leonard Emerson,9999,0,9999,0
1668269304307,CSE 293,028,119416,Ramamoorthi; Ravi,9999,0,9999,0
1668269304307,CSE 293,029,119417,Sahoo; Debashis,9999,0,9999,0
1668269304307,CSE 293,030,119420,Saul; Lawrence,9999,0,9999,0
1668269304307,CSE 293,031,119421,Savage; Stefan,9999,0,9999,0
1668269304307,CSE 293,032,119425,Schulze; Jurgen P.,9999,0,9999,0
1668269304307,CSE 293,033,119426,Snoeren; Alex C.,9999,0,9999,0
1668269304307,CSE 293,034,119428,Shang; Jingbo,9999,0,9999,0
1668269304307,CSE 293,035,119430,Stefan; Deian,9999,0,9999,0
1668269304307,CSE 293,036,119431,Su; Hao,9999,0,9999,0
1668269304307,CSE 293,037,119433,Swanson; Steven James,9999,0,9999,0
1668269304307,CSE 293,038,119435,Tullsen; Dean Michael,9999,0,9999,0
1668269304307,CSE 293,039,119483,Voelker; Geoffrey M.,9999,0,9999,0
1668269304307,CSE 293,040,119537,Zhao; Jishen,9999,0,9999,0
1668269304307,CSE 293,041,119538,Zhou; Yuan-Yuan,9999,0,9999,0
1668269304307,CSE 293,042,119539,Gao; Sicun,9999,0,9999,0
1668269304307,CSE 293,043,119540,Weibel; Nadir,9999,0,9999,0
1668269304307,CSE 293,044,119541,Gupta; Rajesh K.,9999,0,9999,0
1668269304307,CSE 293,045,126410,Vaccaro; Kristen Marie,9999,0,9999,0
1668269304307,CSE 293,046,126411,Klemke; Richard,9999,0,9999,0
1668269304736,CSE 294,A00,102459,Voelker; Geoffrey M.,0,0,0,0
1668269304736,CSE 294,B00,111322,Orailoglu; Alex,0,0,0,0
1668269305158,DSE 201,A00,096914,Deutsch; Alin Bernard,30,0,30,0
1668269305585,DSE 210,A00,096915,Dasgupta; Sanjoy,30,0,30,0
1668269306020,DSE 260A,A00,096916,Altintas De Callaf; Ilkay,30,0,30,0
1668269306455,ECE 200,001,103586,Antipa; Nicholas A,9999,0,9999,0
1668269306455,ECE 200,002,103587,Atanasov; Nikolay A.,9999,0,9999,0
1668269306455,ECE 200,003,103588,Bharadia; Dinesh,9999,0,9999,0
1668269306455,ECE 200,004,103589,Cheng; Chung Kuan,9999,0,9999,0
1668269306455,ECE 200,005,103590,Cosman; Pamela C.,9999,0,9999,0
1668269306455,ECE 200,006,103591,Dayeh; Shadi Ahmad,9999,0,9999,0
1668269306455,ECE 200,007,103592,Fainman; Yeshaiahu,9999,0,9999,0
1668269306455,ECE 200,008,103593,Ford; Joseph Earl,9999,0,9999,0
1668269306455,ECE 200,009,103594,Franceschetti; Massimo,9999,0,9999,0
1668269306455,ECE 200,010,103595,Fullerton; Eric E,9999,0,9999,0
1668269306455,ECE 200,011,103596,Galton; Ian A,9999,0,9999,0
1668269306455,ECE 200,012,103597,Gilja; Vikash,9999,0,9999,0
1668269306455,ECE 200,013,103598,Hall; Drew A.,9999,0,9999,0
1668269306455,ECE 200,014,103599,Hsueh; Tzu-Chien,9999,0,9999,0
1668269306455,ECE 200,015,103600,Javidi; Tara,9999,0,9999,0
1668269306455,ECE 200,016,103601,Kahng; Andrew Byun,9999,0,9999,0
1668269306455,ECE 200,017,103602,Kim; Young-Han,9999,0,9999,0
1668269306455,ECE 200,018,103603,Koushanfar; Farinaz,9999,0,9999,0
1668269306455,ECE 200,019,103604,Kuzum; Duygu,9999,0,9999,0
1668269306455,ECE 200,020,103605,Le; Hanh-Phuc,9999,0,9999,0
1668269306455,ECE 200,021,103606,Lin; Bill,9999,0,9999,0
1668269306455,ECE 200,022,103607,Liu; Zhaowei,9998,0,9999,1
1668269306455,ECE 200,023,103608,Lo; Yu-Hwa,9999,0,9999,0
1668269306455,ECE 200,024,103609,Lomakin; Vitaliy,9999,0,9999,0
1668269306455,ECE 200,025,103610,Mercier; Patrick Philip,9999,0,9999,0
1668269306455,ECE 200,026,103611,Meyer; Florian,9999,0,9999,0
1668269306455,ECE 200,027,103612,Milstein; Laurence B.,9999,0,9999,0
1668269306455,ECE 200,028,103613,Mir Arabbaygi; Siavash,9999,0,9999,0
1668269306455,ECE 200,029,103614,Mookherjea; Shayan,9999,0,9999,0
1668269306455,ECE 200,030,103615,Morris; Karcher William,9999,0,9999,0
1668269306455,ECE 200,031,103616,Ng; Tse Nga,9999,0,9999,0
1668269306455,ECE 200,032,103617,Nguyen; Truong Quang,9999,0,9999,0
1668269306455,ECE 200,033,103618,Nomura; Kenji,9999,0,9999,0
1668269306455,ECE 200,034,103619,Orlitsky; Alon,9999,0,9999,0
1668269306455,ECE 200,035,103620,Pal; Piya,9999,0,9999,0
1668269306455,ECE 200,036,103621,Papen; George C.,9999,0,9999,0
1668269306455,ECE 200,037,103622,Radic; Stojan,9999,0,9999,0
1668269306455,ECE 200,038,103623,Rao; Bhaskar D.,9999,0,9999,0
1668269306455,ECE 200,039,103624,Rao; Ramesh R,9999,0,9999,0
1668269306455,ECE 200,040,103625,Rebeiz; Gabriel,9999,0,9999,0
1668269306455,ECE 200,041,103626,Sanford; John R,9999,0,9999,0
1668269306455,ECE 200,042,103627,Siegel; Paul H.,9999,0,9999,0
1668269306455,ECE 200,043,103628,Sievenpiper; Daniel F.,9999,0,9999,0
1668269306455,ECE 200,044,103629,Sworder; David D.,9999,0,9999,0
1668269306455,ECE 200,045,103630,Taur; Yuan,9999,0,9999,0
1668269306455,ECE 200,046,103631,Touri; Behrouz,9999,0,9999,0
1668269306455,ECE 200,047,103632,Trivedi; Mohan M.,9999,0,9999,0
1668269306455,ECE 200,048,103633,Vasconcelos; Nuno,9999,0,9999,0
1668269306455,ECE 200,049,103634,Wang; Xiaolong,9999,0,9999,0
1668269306455,ECE 200,050,103635,Xie; Pengtao,9999,0,9999,0
1668269306455,ECE 200,051,103636,Yip; Michael,9999,0,9999,0
1668269306455,ECE 200,052,103637,Zeger; Kenneth A.,999,0,999,0
1668269306455,ECE 200,053,103638,Zhang; Xinyu,9999,0,9999,0
1668269306455,ECE 200,054,103639,Turakhia; Yatish Girish,9999,0,9999,0
1668269306455,ECE 200,055,103640,Kang; Mingu,9999,0,9999,0
1668269306455,ECE 200,056,103641,Shi; Yuanyuan,9999,0,9999,0
1668269306455,ECE 200,057,103642,Wang; Edward Jay,9999,0,9999,0
1668269306455,ECE 200,058,103643,Zheng; Yang,9999,0,9999,0
1668269306878,ECE 202,A00,103644,Kuzum; Duygu,0,0,0,0
1668269307302,ECE 212BN,A00,103646,Ng; Tse Nga,0,0,0,0
1668269307726,ECE 221,A00,111493,Staff,0,0,0,0
1668269308155,ECE 222B,A00,103647,Lomakin; Vitaliy,0,0,0,0
1668269308589,ECE 230B,A00,103648,Taur; Yuan,0,0,0,0
1668269309024,ECE 238B,A00,103649,Garay; Javier,0,0,0,0
1668269309450,ECE 240B,A00,112900,Fainman; Yeshaiahu,0,0,0,0
1668269309878,ECE 247A,A00,103650,Jokerst; Jesse Vincent,0,0,0,0
1668269310304,ECE 247B,A00,103651,Wang; Joseph,0,0,0,0
1668269310737,ECE 250,A00,103652,Siegel; Paul H.,0,0,0,0
1668269311166,ECE 251A,A00,103654,Rao; Bhaskar D.,0,0,0,0
1668269311593,ECE 257B,A00,103655,Bharadia; Dinesh,0,0,0,0
1668269312020,ECE 258A,A00,103656,Milstein; Laurence B.,0,0,0,0
1668269312446,ECE 260B,A00,103658,Kang; Mingu,0,0,0,0
1668269312872,ECE 264A,A00,103659,Galton; Ian A,0,0,0,0
1668269313296,ECE 265A,A00,103661,Gudem; Prasad S.S.,0,0,0,0
1668269313724,ECE 265D,A00,103662,Gudem; Prasad S.S.,0,0,0,0
1668269314157,ECE 268,A00,103663,Koushanfar; Farinaz,0,0,0,0
1668269314585,ECE 269,A01,103665,Pal; Piya,0,0,0,0
1668269315011,ECE 271B,A00,103666,Vasconcelos; Manuela,0,0,0,0
1668269315437,ECE 276A,A00,103667,Atanasov; Nikolay A.,0,0,0,0
1668269315862,ECE 277,A00,103668,An; Cheolhong,0,0,0,0
1668269316287,ECE 279,A00,117947,Hall; Drew A.,0,0,0,0
1668269317142,ECE 283,A00,103670,Hsueh; Tzu-Chien,0,0,0,0
1668269317579,ECE 284,A00,103671,Turakhia; Yatish Girish,0,0,0,0
1668269318003,ECE 285,A00,103672,Zheng; Yang,0,0,0,0
1668269318003,ECE 285,B00,103673,Sworder; David D.,0,0,0,0
1668269318430,ECE 287,A00,103676,Javidi; Tara,0,0,0,0
1668269318863,MATH 200B,A00,098023,Salehi Golsefidy; Alireza,12,0,15,3
1668269319386,MATH 202B,A00,098024,Rhoades; Brendon Patrick,9,0,15,6
1668269319809,MATH 203B,A00,098025,Oprea; Dragos N.,10,0,15,5
1668269320235,MATH 204B,A00,098026,Sorensen; Claus M,13,0,15,2
1668269320660,MATH 208,A00,098027,Izadi; Elham,7,0,10,3
1668269321087,MATH 209,A00,098028,Pollack; Aaron,10,0,10,0
1668269321515,MATH 211A,A00,112919,Rogalski; Daniel,9,0,10,1
1668269321944,MATH 211B,A00,112920,Seward; Brandon M.,9,0,10,1
1668269322370,MATH 218,A00,098029,Li; Bo,10,0,10,0
1668269322794,MATH 220B,A00,098030,Novak; Jonathan I,11,0,15,4
1668269323219,MATH 221A,A00,098031,Ebenfelt; Peter F,13,0,15,2
1668269323647,MATH 231B,A00,098032,Zlatos; Andrej,12,0,15,3
1668269324069,MATH 240B,A00,098033,Ni; Lei,9,0,15,6
1668269324494,MATH 243,A00,098034,Jekel; David Andrew,10,0,10,0
1668269324920,MATH 245A,A00,098035,Nie; Jiawang,0,0,15,16
1668269325343,MATH 248,A00,098036,Bejenaru; Ioan,10,0,10,0
1668269325781,MATH 250B,A00,098037,Spolaor; Luca,14,0,15,1
1668269326206,MATH 258,A00,098038,Ni; Lei,10,0,10,0
1668269326645,MATH 264B,A00,098041,Rhoades; Brendon Patrick,9,0,15,6
1668269327070,MATH 268,A00,098042,Buss; Samuel R,10,0,10,0
1668269327492,MATH 269,A00,098043,Rhoades; Brendon Patrick,10,0,10,0
1668269327916,MATH 270B,A00,098044,Li; Bo,10,0,15,5
1668269328347,MATH 272B,A00,098045,Holst; Michael J,13,0,15,2
1668269328772,MATH 273A,A00,098046,Tian; Xiaochuan,10,0,15,5
1668269329205,MATH 275,A01,098048,Tian; Xiaochuan,6,0,10,4
1668269329628,MATH 278A,A00,098049,Holst; Michael J,8,0,10,2
1668269330050,MATH 278B,A00,098050,Cloninger; Alexander,10,0,10,0
1668269330477,MATH 278C,A00,098051,Nie; Jiawang,7,0,10,3
1668269330910,MATH 280B,A00,098052,Zheng; Tianyi,9,0,15,6
1668269331343,MATH 281B,A00,098053,Bradic; Jelena,1,0,15,14
1668269331786,MATH 282B,A00,098054,Arias-Castro; Ery,0,0,15,15
1668269332222,MATH 285,A00,098055,Fitzsimmons; Patrick J,0,0,15,17
1668269332646,MATH 287B,A00,098056,Arias-Castro; Ery,2,0,15,13
1668269333077,MATH 288,A00,098057,Agarwal; Pooja,9,0,10,1
1668269333077,MATH 288,B00,098058,Zhang; Danna,8,0,10,2
1668269333077,MATH 288,C00,098059,Williams; Ruth J,10,0,10,0
1668269333499,MATH 290B,A00,098060,Roberts; Justin Deritter,13,0,15,2
1668269333932,MATH 292,A00,098061,Belmont; Eva Kinoshita,10,0,10,0
1668269334365,MATH 295,A00,098062,Suk; Andrew Hoon,48,0,50,2
1668269334788,MATH 296,A00,098063,Novak; Jonathan I,20,0,20,0
1668269335227,MATH 297,001,098064,Gamst; Anthony Collins,9997,0,9999,2
1668269837074,COGS 205,A00,101395,Chiba; Andrea,19,0,20,1
1668269837498,COGS 210B,001,101404,Greene; Deanna Jacquelyn,9998,0,9999,1
1668269837498,COGS 210B,002,101417,Xia; Haijun,9999,0,9999,0
1668269837498,COGS 210B,003,101422,Nitz; Douglas A.,9999,0,9999,0
1668269837498,COGS 210B,004,101423,Hollan; James D.,9998,0,9999,1
1668269837498,COGS 210B,005,101424,Deak; Gedeon O.,9998,0,9999,1
1668269837498,COGS 210B,006,101425,Rossano; Federico,9999,0,9999,0
1668269837933,COGS 211B,A00,101427,Coulson; Seana M,9996,0,9999,3
1668269838357,COGS 220,A00,101428,Hollan; James D.,0,0,25,25
1668269838782,COGS 229,A00,101429,Dow; Steven P,18,0,25,7
1668269839210,COGS 230,A00,101430,Klemmer; Scott R,12,0,17,5
1668269839631,COGS 234,A00,101431,Xia; Haijun,2,0,25,23
1668269840054,COGS 260,A00,101432,Kiyonaga; Anastasia,21,0,25,4
1668269840054,COGS 260,B00,101433,Kirsh; David Joel,15,0,25,10
1668269840481,CSE 202,A00,102371,Impagliazzo; Russell,0,0,0,0
1668269840913,CSE 203B,A01,102373,Cheng; Chung Kuan,0,0,0,0
1668269841437,CSE 208,A00,102374,Micciancio; Daniele,0,0,0,0
1668269841863,CSE 209A,A00,112895,Impagliazzo; Russell,0,0,15,15
1668269842296,CSE 209B,A00,108005,Bellare; Mihir,0,0,0,0
1668269842720,CSE 210,A00,113163,Coblenz; Michael J,0,0,0,0
1668269843155,CSE 219,A00,106111,Dow; Steven P,0,0,20,20
1668269843583,CSE 221,A00,102376,Voelker; Geoffrey M.,0,0,0,0
1668269844006,CSE 224,A01,102378,Porter; George M,0,0,0,0
1668269844431,CSE 229A,A00,102379,Savage; Stefan,0,0,0,0
1668269844874,CSE 229C,A00,102380,Munyaka; Imani N. S.,0,0,0,0
1668269845298,CSE 232B,A00,102382,Deutsch; Alin Bernard,0,0,0,0
1668269845724,CSE 234,A01,112904,Kumar; Arun Kumar,0,0,0,0
1668269846147,CSE 237A,A00,102383,Rosing; Tajana Simunic,0,0,0,0
1668269846573,CSE 239A,A00,102384,Deutsch; Alin Bernard,0,0,0,0
1668269846998,CSE 239B,A00,102385,Polikarpova; Nadezhda,0,0,0,0
1668269847423,CSE 240A,A00,102386,Pannuto; Patrick William,0,0,0,0
1668269847848,CSE 240B,A00,102387,Zhao; Jishen,0,0,0,0
1668269848270,CSE 241A,A00,106406,Kang; Mingu,0,0,0,0
1668269848693,CSE 249B,A00,102388,Kahng; Andrew Byun,0,0,8,8
1668269849117,CSE 251B,A01,102392,Cottrell; Garrison W,0,0,0,0
1668269849117,CSE 251B,A02,102393,Cottrell; Garrison W,0,0,0,0
1668269849539,CSE 252B,A00,102394,Ochoa; Benjamin Lawrence,0,0,0,0
1668269849978,CSE 257,A01,102396,Gao; Sicun,0,0,0,0
1668269850406,CSE 272,A00,102397,Li; Tzumao,0,0,0,0
1668269850832,CSE 274,A00,111323,Chern; Albert Ren-Haur,0,0,0,0
1668269851255,CSE 282,A00,102398,Pevzner; Pavel Arkadjevich,0,0,0,0
1668269851685,CSE 284,A00,114175,Gymrek; Melissa Ann,0,0,0,0
1668269852110,CSE 290,A00,102399,Chandraker; Manmohan Krishna,0,0,0,0
1668269852110,CSE 290,B00,102400,Vaccaro; Kristen Marie,0,0,25,25
1668269852110,CSE 290,C00,102414,Pannuto; Patrick William,0,0,25,25
1668269852110,CSE 290,D00,102427,Pevzner; Pavel Arkadjevich,0,0,0,0
1668269852110,CSE 290,E00,102429,Zhao; Jishen,0,0,0,0
1668269852110,CSE 290,F00,102436,Tullsen; Dean Michael,0,0,0,0
1668269852110,CSE 290,G00,102440,Christensen; Henrik I,0,0,20,20
1668269852538,CSE 291,A00,102443,Su; Hao,0,0,0,0
1668269852538,CSE 291,B00,102448,Polikarpova; Nadezhda,0,0,0,0
1668269852538,CSE 291,C00,102453,Vaccaro; Kristen Marie,0,0,0,0
1668269852538,CSE 291,D00,111343,Savage; Stefan,0,0,0,0
1668269852538,CSE 291,E00,116474,Claffy; Kimberly Claire,0,0,0,0
1668269852538,CSE 291,F00,116479,Pasquale; Joseph,0,0,0,0
1668269852965,CSE 293,001,119111,Bafna; Vineet,9999,0,9999,0
1668269852965,CSE 293,002,119118,Bellare; Mihir,9999,0,9999,0
1668269852965,CSE 293,003,119122,Berg-Kirkpatrick; Taylor D,9999,0,9999,0
1668269852965,CSE 293,004,119135,Christensen; Henrik I,9999,0,9999,0
1668269852965,CSE 293,005,119142,Cottrell; Garrison W,9999,0,9999,0
1668269852965,CSE 293,006,119146,Deutsch; Alin Bernard,9999,0,9999,0
1668269852965,CSE 293,007,119159,Esmaeilzadeh; Hadi,9999,0,9999,0
1668269852965,CSE 293,008,119166,Freund; Yoav,9999,0,9999,0
1668269852965,CSE 293,009,119170,Griswold; William G.,9999,0,9999,0
1668269852965,CSE 293,010,119183,Gymrek; Melissa Ann,9999,0,9999,0
1668269852965,CSE 293,011,119190,Heninger; Nadia A,9999,0,9999,0
1668269852965,CSE 293,012,119230,Impagliazzo; Russell,9999,0,9999,0
1668269852965,CSE 293,013,119232,Jhala; Ranjit,9999,0,9999,0
1668269852965,CSE 293,014,119233,Kahng; Andrew Byun,9999,0,9999,0
1668269852965,CSE 293,015,119298,Kane; Daniel Mertz,9999,0,9999,0
1668269852965,CSE 293,016,119299,Kriegman; David J,9999,0,9999,0
1668269852965,CSE 293,017,119300,Kumar; Arun Kumar,9999,0,9999,0
1668269852965,CSE 293,018,119301,Lerner; Sorin,9999,0,9999,0
1668269852965,CSE 293,019,119302,Lovett; Shachar,9999,0,9999,0
1668269852965,CSE 293,020,119303,McAuley; Julian John,9999,0,9999,0
1668269852965,CSE 293,021,119304,Micciancio; Daniele,9999,0,9999,0
1668269852965,CSE 293,022,119367,Orailoglu; Alex,9999,0,9999,0
1668269852965,CSE 293,023,119382,Paturi; Ramamohan,9999,0,9999,0
1668269852965,CSE 293,024,119404,Polikarpova; Nadezhda,9999,0,9999,0
1668269852965,CSE 293,025,119406,Politz; Joseph Gibbs,9999,0,9999,0
1668269852965,CSE 293,026,119411,Porter; George M,9999,0,9999,0
1668269852965,CSE 293,027,119414,Porter; Leonard Emerson,9999,0,9999,0
1668269852965,CSE 293,028,119416,Ramamoorthi; Ravi,9999,0,9999,0
1668269852965,CSE 293,029,119417,Sahoo; Debashis,9999,0,9999,0
1668269852965,CSE 293,030,119420,Saul; Lawrence,9999,0,9999,0
1668269852965,CSE 293,031,119421,Savage; Stefan,9999,0,9999,0
1668269852965,CSE 293,032,119425,Schulze; Jurgen P.,9999,0,9999,0
1668269852965,CSE 293,033,119426,Snoeren; Alex C.,9999,0,9999,0
1668269852965,CSE 293,034,119428,Shang; Jingbo,9999,0,9999,0
1668269852965,CSE 293,035,119430,Stefan; Deian,9999,0,9999,0
1668269852965,CSE 293,036,119431,Su; Hao,9999,0,9999,0
1668269852965,CSE 293,037,119433,Swanson; Steven James,9999,0,9999,0
1668269852965,CSE 293,038,119435,Tullsen; Dean Michael,9999,0,9999,0
1668269852965,CSE 293,039,119483,Voelker; Geoffrey M.,9999,0,9999,0
1668269852965,CSE 293,040,119537,Zhao; Jishen,9999,0,9999,0
1668269852965,CSE 293,041,119538,Zhou; Yuan-Yuan,9999,0,9999,0
1668269852965,CSE 293,042,119539,Gao; Sicun,9999,0,9999,0
1668269852965,CSE 293,043,119540,Weibel; Nadir,9999,0,9999,0
1668269852965,CSE 293,044,119541,Gupta; Rajesh K.,9999,0,9999,0
1668269852965,CSE 293,045,126410,Vaccaro; Kristen Marie,9999,0,9999,0
1668269852965,CSE 293,046,126411,Klemke; Richard,9999,0,9999,0
1668269853400,CSE 294,A00,102459,Voelker; Geoffrey M.,0,0,0,0
1668269853400,CSE 294,B00,111322,Orailoglu; Alex,0,0,0,0
1668269853827,DSE 201,A00,096914,Deutsch; Alin Bernard,30,0,30,0
1668269854251,DSE 210,A00,096915,Dasgupta; Sanjoy,30,0,30,0
1668269854677,DSE 260A,A00,096916,Altintas De Callaf; Ilkay,30,0,30,0
1668269855105,ECE 200,001,103586,Antipa; Nicholas A,9999,0,9999,0
1668269855105,ECE 200,002,103587,Atanasov; Nikolay A.,9999,0,9999,0
1668269855105,ECE 200,003,103588,Bharadia; Dinesh,9999,0,9999,0
1668269855105,ECE 200,004,103589,Cheng; Chung Kuan,9999,0,9999,0
1668269855105,ECE 200,005,103590,Cosman; Pamela C.,9999,0,9999,0
1668269855105,ECE 200,006,103591,Dayeh; Shadi Ahmad,9999,0,9999,0
1668269855105,ECE 200,007,103592,Fainman; Yeshaiahu,9999,0,9999,0
1668269855105,ECE 200,008,103593,Ford; Joseph Earl,9999,0,9999,0
1668269855105,ECE 200,009,103594,Franceschetti; Massimo,9999,0,9999,0
1668269855105,ECE 200,010,103595,Fullerton; Eric E,9999,0,9999,0
1668269855105,ECE 200,011,103596,Galton; Ian A,9999,0,9999,0
1668269855105,ECE 200,012,103597,Gilja; Vikash,9999,0,9999,0
1668269855105,ECE 200,013,103598,Hall; Drew A.,9999,0,9999,0
1668269855105,ECE 200,014,103599,Hsueh; Tzu-Chien,9999,0,9999,0
1668269855105,ECE 200,015,103600,Javidi; Tara,9999,0,9999,0
1668269855105,ECE 200,016,103601,Kahng; Andrew Byun,9999,0,9999,0
1668269855105,ECE 200,017,103602,Kim; Young-Han,9999,0,9999,0
1668269855105,ECE 200,018,103603,Koushanfar; Farinaz,9999,0,9999,0
1668269855105,ECE 200,019,103604,Kuzum; Duygu,9999,0,9999,0
1668269855105,ECE 200,020,103605,Le; Hanh-Phuc,9999,0,9999,0
1668269855105,ECE 200,021,103606,Lin; Bill,9999,0,9999,0
1668269855105,ECE 200,022,103607,Liu; Zhaowei,9998,0,9999,1
1668269855105,ECE 200,023,103608,Lo; Yu-Hwa,9999,0,9999,0
1668269855105,ECE 200,024,103609,Lomakin; Vitaliy,9999,0,9999,0
1668269855105,ECE 200,025,103610,Mercier; Patrick Philip,9999,0,9999,0
1668269855105,ECE 200,026,103611,Meyer; Florian,9999,0,9999,0
1668269855105,ECE 200,027,103612,Milstein; Laurence B.,9999,0,9999,0
1668269855105,ECE 200,028,103613,Mir Arabbaygi; Siavash,9999,0,9999,0
1668269855105,ECE 200,029,103614,Mookherjea; Shayan,9999,0,9999,0
1668269855105,ECE 200,030,103615,Morris; Karcher William,9999,0,9999,0
1668269855105,ECE 200,031,103616,Ng; Tse Nga,9999,0,9999,0
1668269855105,ECE 200,032,103617,Nguyen; Truong Quang,9999,0,9999,0
1668269855105,ECE 200,033,103618,Nomura; Kenji,9999,0,9999,0
1668269855105,ECE 200,034,103619,Orlitsky; Alon,9999,0,9999,0
1668269855105,ECE 200,035,103620,Pal; Piya,9999,0,9999,0
1668269855105,ECE 200,036,103621,Papen; George C.,9999,0,9999,0
1668269855105,ECE 200,037,103622,Radic; Stojan,9999,0,9999,0
1668269855105,ECE 200,038,103623,Rao; Bhaskar D.,9999,0,9999,0
1668269855105,ECE 200,039,103624,Rao; Ramesh R,9999,0,9999,0
1668269855105,ECE 200,040,103625,Rebeiz; Gabriel,9999,0,9999,0
1668269855105,ECE 200,041,103626,Sanford; John R,9999,0,9999,0
1668269855105,ECE 200,042,103627,Siegel; Paul H.,9999,0,9999,0
1668269855105,ECE 200,043,103628,Sievenpiper; Daniel F.,9999,0,9999,0
1668269855105,ECE 200,044,103629,Sworder; David D.,9999,0,9999,0
1668269855105,ECE 200,045,103630,Taur; Yuan,9999,0,9999,0
1668269855105,ECE 200,046,103631,Touri; Behrouz,9999,0,9999,0
1668269855105,ECE 200,047,103632,Trivedi; Mohan M.,9999,0,9999,0
1668269855105,ECE 200,048,103633,Vasconcelos; Nuno,9999,0,9999,0
1668269855105,ECE 200,049,103634,Wang; Xiaolong,9999,0,9999,0
1668269855105,ECE 200,050,103635,Xie; Pengtao,9999,0,9999,0
1668269855105,ECE 200,051,103636,Yip; Michael,9999,0,9999,0
1668269855105,ECE 200,052,103637,Zeger; Kenneth A.,999,0,999,0
1668269855105,ECE 200,053,103638,Zhang; Xinyu,9999,0,9999,0
1668269855105,ECE 200,054,103639,Turakhia; Yatish Girish,9999,0,9999,0
1668269855105,ECE 200,055,103640,Kang; Mingu,9999,0,9999,0
1668269855105,ECE 200,056,103641,Shi; Yuanyuan,9999,0,9999,0
1668269855105,ECE 200,057,103642,Wang; Edward Jay,9999,0,9999,0
1668269855105,ECE 200,058,103643,Zheng; Yang,9999,0,9999,0
1668269855533,ECE 202,A00,103644,Kuzum; Duygu,0,0,0,0
1668269855958,ECE 212BN,A00,103646,Ng; Tse Nga,0,0,0,0
1668269856386,ECE 221,A00,111493,Staff,0,0,0,0
1668269856818,ECE 222B,A00,103647,Lomakin; Vitaliy,0,0,0,0
1668269857241,ECE 230B,A00,103648,Taur; Yuan,0,0,0,0
1668269857665,ECE 238B,A00,103649,Garay; Javier,0,0,0,0
1668269858090,ECE 240B,A00,112900,Fainman; Yeshaiahu,0,0,0,0
1668269858511,ECE 247A,A00,103650,Jokerst; Jesse Vincent,0,0,0,0
1668269858936,ECE 247B,A00,103651,Wang; Joseph,0,0,0,0
1668269859364,ECE 250,A00,103652,Siegel; Paul H.,0,0,0,0
1668269859787,ECE 251A,A00,103654,Rao; Bhaskar D.,0,0,0,0
1668269860210,ECE 257B,A00,103655,Bharadia; Dinesh,0,0,0,0
1668269860633,ECE 258A,A00,103656,Milstein; Laurence B.,0,0,0,0
1668269861057,ECE 260B,A00,103658,Kang; Mingu,0,0,0,0
1668269861482,ECE 264A,A00,103659,Galton; Ian A,0,0,0,0
1668269861907,ECE 265A,A00,103661,Gudem; Prasad S.S.,0,0,0,0
1668269862338,ECE 265D,A00,103662,Gudem; Prasad S.S.,0,0,0,0
1668269862762,ECE 268,A00,103663,Koushanfar; Farinaz,0,0,0,0
1668269863201,ECE 269,A01,103665,Pal; Piya,0,0,0,0
1668269863623,ECE 271B,A00,103666,Vasconcelos; Manuela,0,0,0,0
1668269864059,ECE 276A,A00,103667,Atanasov; Nikolay A.,0,0,0,0
1668269864484,ECE 277,A00,103668,An; Cheolhong,0,0,0,0
1668269864913,ECE 279,A00,117947,Hall; Drew A.,0,0,0,0
1668269865760,ECE 283,A00,103670,Hsueh; Tzu-Chien,0,0,0,0
1668269866183,ECE 284,A00,103671,Turakhia; Yatish Girish,0,0,0,0
1668269866611,ECE 285,A00,103672,Zheng; Yang,0,0,0,0
1668269866611,ECE 285,B00,103673,Sworder; David D.,0,0,0,0
1668269867045,ECE 287,A00,103676,Javidi; Tara,0,0,0,0
1668269867475,MATH 200B,A00,098023,Salehi Golsefidy; Alireza,12,0,15,3
1668269867906,MATH 202B,A00,098024,Rhoades; Brendon Patrick,9,0,15,6
1668269868342,MATH 203B,A00,098025,Oprea; Dragos N.,10,0,15,5
1668269868775,MATH 204B,A00,098026,Sorensen; Claus M,13,0,15,2
1668269869199,MATH 208,A00,098027,Izadi; Elham,7,0,10,3
1668269869624,MATH 209,A00,098028,Pollack; Aaron,10,0,10,0
1668269870050,MATH 211A,A00,112919,Rogalski; Daniel,9,0,10,1
1668269870486,MATH 211B,A00,112920,Seward; Brandon M.,9,0,10,1
1668269870908,MATH 218,A00,098029,Li; Bo,10,0,10,0
1668269871337,MATH 220B,A00,098030,Novak; Jonathan I,11,0,15,4
1668269871770,MATH 221A,A00,098031,Ebenfelt; Peter F,13,0,15,2
1668269872205,MATH 231B,A00,098032,Zlatos; Andrej,12,0,15,3
1668269872643,MATH 240B,A00,098033,Ni; Lei,9,0,15,6
1668269873068,MATH 243,A00,098034,Jekel; David Andrew,10,0,10,0
1668269873500,MATH 245A,A00,098035,Nie; Jiawang,0,0,15,16
1668269873925,MATH 248,A00,098036,Bejenaru; Ioan,10,0,10,0
1668269874350,MATH 250B,A00,098037,Spolaor; Luca,14,0,15,1
1668269874773,MATH 258,A00,098038,Ni; Lei,10,0,10,0
1668269875206,MATH 264B,A00,098041,Rhoades; Brendon Patrick,9,0,15,6
1668269875628,MATH 268,A00,098042,Buss; Samuel R,10,0,10,0
1668269876053,MATH 269,A00,098043,Rhoades; Brendon Patrick,10,0,10,0
1668269876477,MATH 270B,A00,098044,Li; Bo,10,0,15,5
1668269876902,MATH 272B,A00,098045,Holst; Michael J,13,0,15,2
1668269877337,MATH 273A,A00,098046,Tian; Xiaochuan,10,0,15,5
1668269877775,MATH 275,A01,098048,Tian; Xiaochuan,6,0,10,4
1668269878212,MATH 278A,A00,098049,Holst; Michael J,8,0,10,2
1668269878639,MATH 278B,A00,098050,Cloninger; Alexander,10,0,10,0
1668269879075,MATH 278C,A00,098051,Nie; Jiawang,7,0,10,3
1668269879503,MATH 280B,A00,098052,Zheng; Tianyi,9,0,15,6
1668269879927,MATH 281B,A00,098053,Bradic; Jelena,1,0,15,14
1668269880352,MATH 282B,A00,098054,Arias-Castro; Ery,0,0,15,15
1668269880775,MATH 285,A00,098055,Fitzsimmons; Patrick J,0,0,15,17
1668269881213,MATH 287B,A00,098056,Arias-Castro; Ery,2,0,15,13
1668269881635,MATH 288,A00,098057,Agarwal; Pooja,9,0,10,1
1668269881635,MATH 288,B00,098058,Zhang; Danna,8,0,10,2
1668269881635,MATH 288,C00,098059,Williams; Ruth J,10,0,10,0
1668269882061,MATH 290B,A00,098060,Roberts; Justin Deritter,13,0,15,2
1668269882488,MATH 292,A00,098061,Belmont; Eva Kinoshita,10,0,10,0
1668269882916,MATH 295,A00,098062,Suk; Andrew Hoon,48,0,50,2
1668269883340,MATH 296,A00,098063,Novak; Jonathan I,20,0,20,0
1668269883768,MATH 297,001,098064,Gamst; Anthony Collins,9997,0,9999,2
1668270385830,COGS 205,A00,101395,Chiba; Andrea,19,0,20,1
1668270386256,COGS 210B,001,101404,Greene; Deanna Jacquelyn,9998,0,9999,1
1668270386256,COGS 210B,002,101417,Xia; Haijun,9999,0,9999,0
1668270386256,COGS 210B,003,101422,Nitz; Douglas A.,9999,0,9999,0
1668270386256,COGS 210B,004,101423,Hollan; James D.,9998,0,9999,1
1668270386256,COGS 210B,005,101424,Deak; Gedeon O.,9998,0,9999,1
1668270386256,COGS 210B,006,101425,Rossano; Federico,9999,0,9999,0
1668270386680,COGS 211B,A00,101427,Coulson; Seana M,9996,0,9999,3
1668270387118,COGS 220,A00,101428,Hollan; James D.,0,0,25,25
1668270387553,COGS 229,A00,101429,Dow; Steven P,18,0,25,7
1668270387978,COGS 230,A00,101430,Klemmer; Scott R,12,0,17,5
1668270388407,COGS 234,A00,101431,Xia; Haijun,2,0,25,23
1668270388832,COGS 260,A00,101432,Kiyonaga; Anastasia,21,0,25,4
1668270388832,COGS 260,B00,101433,Kirsh; David Joel,15,0,25,10
1668270389267,CSE 202,A00,102371,Impagliazzo; Russell,0,0,0,0
1668270389693,CSE 203B,A01,102373,Cheng; Chung Kuan,0,0,0,0
1668270390119,CSE 208,A00,102374,Micciancio; Daniele,0,0,0,0
1668270390552,CSE 209A,A00,112895,Impagliazzo; Russell,0,0,15,15
1668270390985,CSE 209B,A00,108005,Bellare; Mihir,0,0,0,0
1668270391422,CSE 210,A00,113163,Coblenz; Michael J,0,0,0,0
1668270391853,CSE 219,A00,106111,Dow; Steven P,0,0,20,20
1668270392280,CSE 221,A00,102376,Voelker; Geoffrey M.,0,0,0,0
1668270392702,CSE 224,A01,102378,Porter; George M,0,0,0,0
1668270393124,CSE 229A,A00,102379,Savage; Stefan,0,0,0,0
1668270393546,CSE 229C,A00,102380,Munyaka; Imani N. S.,0,0,0,0
1668270393971,CSE 232B,A00,102382,Deutsch; Alin Bernard,0,0,0,0
1668270394400,CSE 234,A01,112904,Kumar; Arun Kumar,0,0,0,0
1668270394829,CSE 237A,A00,102383,Rosing; Tajana Simunic,0,0,0,0
1668270395256,CSE 239A,A00,102384,Deutsch; Alin Bernard,0,0,0,0
1668270395681,CSE 239B,A00,102385,Polikarpova; Nadezhda,0,0,0,0
1668270396107,CSE 240A,A00,102386,Pannuto; Patrick William,0,0,0,0
1668270396532,CSE 240B,A00,102387,Zhao; Jishen,0,0,0,0
1668270396956,CSE 241A,A00,106406,Kang; Mingu,0,0,0,0
1668270397390,CSE 249B,A00,102388,Kahng; Andrew Byun,0,0,8,8
1668270397814,CSE 251B,A01,102392,Cottrell; Garrison W,0,0,0,0
1668270397814,CSE 251B,A02,102393,Cottrell; Garrison W,0,0,0,0
1668270398256,CSE 252B,A00,102394,Ochoa; Benjamin Lawrence,0,0,0,0
1668270398678,CSE 257,A01,102396,Gao; Sicun,0,0,0,0
1668270399105,CSE 272,A00,102397,Li; Tzumao,0,0,0,0
1668270399528,CSE 274,A00,111323,Chern; Albert Ren-Haur,0,0,0,0
1668270399956,CSE 282,A00,102398,Pevzner; Pavel Arkadjevich,0,0,0,0
1668270400379,CSE 284,A00,114175,Gymrek; Melissa Ann,0,0,0,0
1668270400807,CSE 290,A00,102399,Chandraker; Manmohan Krishna,0,0,0,0
1668270400807,CSE 290,B00,102400,Vaccaro; Kristen Marie,0,0,25,25
1668270400807,CSE 290,C00,102414,Pannuto; Patrick William,0,0,25,25
1668270400807,CSE 290,D00,102427,Pevzner; Pavel Arkadjevich,0,0,0,0
1668270400807,CSE 290,E00,102429,Zhao; Jishen,0,0,0,0
1668270400807,CSE 290,F00,102436,Tullsen; Dean Michael,0,0,0,0
1668270400807,CSE 290,G00,102440,Christensen; Henrik I,0,0,20,20
1668270401233,CSE 291,A00,102443,Su; Hao,0,0,0,0
1668270401233,CSE 291,B00,102448,Polikarpova; Nadezhda,0,0,0,0
1668270401233,CSE 291,C00,102453,Vaccaro; Kristen Marie,0,0,0,0
1668270401233,CSE 291,D00,111343,Savage; Stefan,0,0,0,0
1668270401233,CSE 291,E00,116474,Claffy; Kimberly Claire,0,0,0,0
1668270401233,CSE 291,F00,116479,Pasquale; Joseph,0,0,0,0
1668270401670,CSE 293,001,119111,Bafna; Vineet,9999,0,9999,0
1668270401670,CSE 293,002,119118,Bellare; Mihir,9999,0,9999,0
1668270401670,CSE 293,003,119122,Berg-Kirkpatrick; Taylor D,9999,0,9999,0
1668270401670,CSE 293,004,119135,Christensen; Henrik I,9999,0,9999,0
1668270401670,CSE 293,005,119142,Cottrell; Garrison W,9999,0,9999,0
1668270401670,CSE 293,006,119146,Deutsch; Alin Bernard,9999,0,9999,0
1668270401670,CSE 293,007,119159,Esmaeilzadeh; Hadi,9999,0,9999,0
1668270401670,CSE 293,008,119166,Freund; Yoav,9999,0,9999,0
1668270401670,CSE 293,009,119170,Griswold; William G.,9999,0,9999,0
1668270401670,CSE 293,010,119183,Gymrek; Melissa Ann,9999,0,9999,0
1668270401670,CSE 293,011,119190,Heninger; Nadia A,9999,0,9999,0
1668270401670,CSE 293,012,119230,Impagliazzo; Russell,9999,0,9999,0
1668270401670,CSE 293,013,119232,Jhala; Ranjit,9999,0,9999,0
1668270401670,CSE 293,014,119233,Kahng; Andrew Byun,9999,0,9999,0
1668270401670,CSE 293,015,119298,Kane; Daniel Mertz,9999,0,9999,0
1668270401670,CSE 293,016,119299,Kriegman; David J,9999,0,9999,0
1668270401670,CSE 293,017,119300,Kumar; Arun Kumar,9999,0,9999,0
1668270401670,CSE 293,018,119301,Lerner; Sorin,9999,0,9999,0
1668270401670,CSE 293,019,119302,Lovett; Shachar,9999,0,9999,0
1668270401670,CSE 293,020,119303,McAuley; Julian John,9999,0,9999,0
1668270401670,CSE 293,021,119304,Micciancio; Daniele,9999,0,9999,0
1668270401670,CSE 293,022,119367,Orailoglu; Alex,9999,0,9999,0
1668270401670,CSE 293,023,119382,Paturi; Ramamohan,9999,0,9999,0
1668270401670,CSE 293,024,119404,Polikarpova; Nadezhda,9999,0,9999,0
1668270401670,CSE 293,025,119406,Politz; Joseph Gibbs,9999,0,9999,0
1668270401670,CSE 293,026,119411,Porter; George M,9999,0,9999,0
1668270401670,CSE 293,027,119414,Porter; Leonard Emerson,9999,0,9999,0
1668270401670,CSE 293,028,119416,Ramamoorthi; Ravi,9999,0,9999,0
1668270401670,CSE 293,029,119417,Sahoo; Debashis,9999,0,9999,0
1668270401670,CSE 293,030,119420,Saul; Lawrence,9999,0,9999,0
1668270401670,CSE 293,031,119421,Savage; Stefan,9999,0,9999,0
1668270401670,CSE 293,032,119425,Schulze; Jurgen P.,9999,0,9999,0
1668270401670,CSE 293,033,119426,Snoeren; Alex C.,9999,0,9999,0
1668270401670,CSE 293,034,119428,Shang; Jingbo,9999,0,9999,0
1668270401670,CSE 293,035,119430,Stefan; Deian,9999,0,9999,0
1668270401670,CSE 293,036,119431,Su; Hao,9999,0,9999,0
1668270401670,CSE 293,037,119433,Swanson; Steven James,9999,0,9999,0
1668270401670,CSE 293,038,119435,Tullsen; Dean Michael,9999,0,9999,0
1668270401670,CSE 293,039,119483,Voelker; Geoffrey M.,9999,0,9999,0
1668270401670,CSE 293,040,119537,Zhao; Jishen,9999,0,9999,0
1668270401670,CSE 293,041,119538,Zhou; Yuan-Yuan,9999,0,9999,0
1668270401670,CSE 293,042,119539,Gao; Sicun,9999,0,9999,0
1668270401670,CSE 293,043,119540,Weibel; Nadir,9999,0,9999,0
1668270401670,CSE 293,044,119541,Gupta; Rajesh K.,9999,0,9999,0
1668270401670,CSE 293,045,126410,Vaccaro; Kristen Marie,9999,0,9999,0
1668270401670,CSE 293,046,126411,Klemke; Richard,9999,0,9999,0
1668270402104,CSE 294,A00,102459,Voelker; Geoffrey M.,0,0,0,0
1668270402104,CSE 294,B00,111322,Orailoglu; Alex,0,0,0,0
1668270402527,DSE 201,A00,096914,Deutsch; Alin Bernard,30,0,30,0
1668270402950,DSE 210,A00,096915,Dasgupta; Sanjoy,30,0,30,0
1668270403376,DSE 260A,A00,096916,Altintas De Callaf; Ilkay,30,0,30,0
1668270403818,ECE 200,001,103586,Antipa; Nicholas A,9999,0,9999,0
1668270403818,ECE 200,002,103587,Atanasov; Nikolay A.,9999,0,9999,0
1668270403818,ECE 200,003,103588,Bharadia; Dinesh,9999,0,9999,0
1668270403818,ECE 200,004,103589,Cheng; Chung Kuan,9999,0,9999,0
1668270403818,ECE 200,005,103590,Cosman; Pamela C.,9999,0,9999,0
1668270403818,ECE 200,006,103591,Dayeh; Shadi Ahmad,9999,0,9999,0
1668270403818,ECE 200,007,103592,Fainman; Yeshaiahu,9999,0,9999,0
1668270403818,ECE 200,008,103593,Ford; Joseph Earl,9999,0,9999,0
1668270403818,ECE 200,009,103594,Franceschetti; Massimo,9999,0,9999,0
1668270403818,ECE 200,010,103595,Fullerton; Eric E,9999,0,9999,0
1668270403818,ECE 200,011,103596,Galton; Ian A,9999,0,9999,0
1668270403818,ECE 200,012,103597,Gilja; Vikash,9999,0,9999,0
1668270403818,ECE 200,013,103598,Hall; Drew A.,9999,0,9999,0
1668270403818,ECE 200,014,103599,Hsueh; Tzu-Chien,9999,0,9999,0
1668270403818,ECE 200,015,103600,Javidi; Tara,9999,0,9999,0
1668270403818,ECE 200,016,103601,Kahng; Andrew Byun,9999,0,9999,0
1668270403818,ECE 200,017,103602,Kim; Young-Han,9999,0,9999,0
1668270403818,ECE 200,018,103603,Koushanfar; Farinaz,9999,0,9999,0
1668270403818,ECE 200,019,103604,Kuzum; Duygu,9999,0,9999,0
1668270403818,ECE 200,020,103605,Le; Hanh-Phuc,9999,0,9999,0
1668270403818,ECE 200,021,103606,Lin; Bill,9999,0,9999,0
1668270403818,ECE 200,022,103607,Liu; Zhaowei,9998,0,9999,1
1668270403818,ECE 200,023,103608,Lo; Yu-Hwa,9999,0,9999,0
1668270403818,ECE 200,024,103609,Lomakin; Vitaliy,9999,0,9999,0
1668270403818,ECE 200,025,103610,Mercier; Patrick Philip,9999,0,9999,0
1668270403818,ECE 200,026,103611,Meyer; Florian,9999,0,9999,0
1668270403818,ECE 200,027,103612,Milstein; Laurence B.,9999,0,9999,0
1668270403818,ECE 200,028,103613,Mir Arabbaygi; Siavash,9999,0,9999,0
1668270403818,ECE 200,029,103614,Mookherjea; Shayan,9999,0,9999,0
1668270403818,ECE 200,030,103615,Morris; Karcher William,9999,0,9999,0
1668270403818,ECE 200,031,103616,Ng; Tse Nga,9999,0,9999,0
1668270403818,ECE 200,032,103617,Nguyen; Truong Quang,9999,0,9999,0
1668270403818,ECE 200,033,103618,Nomura; Kenji,9999,0,9999,0
1668270403818,ECE 200,034,103619,Orlitsky; Alon,9999,0,9999,0
1668270403818,ECE 200,035,103620,Pal; Piya,9999,0,9999,0
1668270403818,ECE 200,036,103621,Papen; George C.,9999,0,9999,0
1668270403818,ECE 200,037,103622,Radic; Stojan,9999,0,9999,0
1668270403818,ECE 200,038,103623,Rao; Bhaskar D.,9999,0,9999,0
1668270403818,ECE 200,039,103624,Rao; Ramesh R,9999,0,9999,0
1668270403818,ECE 200,040,103625,Rebeiz; Gabriel,9999,0,9999,0
1668270403818,ECE 200,041,103626,Sanford; John R,9999,0,9999,0
1668270403818,ECE 200,042,103627,Siegel; Paul H.,9999,0,9999,0
1668270403818,ECE 200,043,103628,Sievenpiper; Daniel F.,9999,0,9999,0
1668270403818,ECE 200,044,103629,Sworder; David D.,9999,0,9999,0
1668270403818,ECE 200,045,103630,Taur; Yuan,9999,0,9999,0
1668270403818,ECE 200,046,103631,Touri; Behrouz,9999,0,9999,0
1668270403818,ECE 200,047,103632,Trivedi; Mohan M.,9999,0,9999,0
1668270403818,ECE 200,048,103633,Vasconcelos; Nuno,9999,0,9999,0
1668270403818,ECE 200,049,103634,Wang; Xiaolong,9999,0,9999,0
1668270403818,ECE 200,050,103635,Xie; Pengtao,9999,0,9999,0
1668270403818,ECE 200,051,103636,Yip; Michael,9999,0,9999,0
1668270403818,ECE 200,052,103637,Zeger; Kenneth A.,999,0,999,0
1668270403818,ECE 200,053,103638,Zhang; Xinyu,9999,0,9999,0
1668270403818,ECE 200,054,103639,Turakhia; Yatish Girish,9999,0,9999,0
1668270403818,ECE 200,055,103640,Kang; Mingu,9999,0,9999,0
1668270403818,ECE 200,056,103641,Shi; Yuanyuan,9999,0,9999,0
1668270403818,ECE 200,057,103642,Wang; Edward Jay,9999,0,9999,0
1668270403818,ECE 200,058,103643,Zheng; Yang,9999,0,9999,0
1668270404242,ECE 202,A00,103644,Kuzum; Duygu,0,0,0,0
1668270404681,ECE 212BN,A00,103646,Ng; Tse Nga,0,0,0,0
1668270405103,ECE 221,A00,111493,Staff,0,0,0,0
1668270405545,ECE 222B,A00,103647,Lomakin; Vitaliy,0,0,0,0
1668270405968,ECE 230B,A00,103648,Taur; Yuan,0,0,0,0
1668270406404,ECE 238B,A00,103649,Garay; Javier,0,0,0,0
1668270406916,ECE 240B,A00,112900,Fainman; Yeshaiahu,0,0,0,0
1668270407340,ECE 247A,A00,103650,Jokerst; Jesse Vincent,0,0,0,0
1668270407763,ECE 247B,A00,103651,Wang; Joseph,0,0,0,0
1668270408191,ECE 250,A00,103652,Siegel; Paul H.,0,0,0,0
1668270408613,ECE 251A,A00,103654,Rao; Bhaskar D.,0,0,0,0
1668270409052,ECE 257B,A00,103655,Bharadia; Dinesh,0,0,0,0
1668270409477,ECE 258A,A00,103656,Milstein; Laurence B.,0,0,0,0
1668270409902,ECE 260B,A00,103658,Kang; Mingu,0,0,0,0
1668270410328,ECE 264A,A00,103659,Galton; Ian A,0,0,0,0
1668270410754,ECE 265A,A00,103661,Gudem; Prasad S.S.,0,0,0,0
1668270411178,ECE 265D,A00,103662,Gudem; Prasad S.S.,0,0,0,0
1668270411610,ECE 268,A00,103663,Koushanfar; Farinaz,0,0,0,0
1668270412038,ECE 269,A01,103665,Pal; Piya,0,0,0,0
1668270412462,ECE 271B,A00,103666,Vasconcelos; Manuela,0,0,0,0
1668270412901,ECE 276A,A00,103667,Atanasov; Nikolay A.,0,0,0,0
1668270413328,ECE 277,A00,103668,An; Cheolhong,0,0,0,0
1668270414060,ECE 279,A00,117947,Hall; Drew A.,0,0,0,0
1668270414922,ECE 283,A00,103670,Hsueh; Tzu-Chien,0,0,0,0
1668270415347,ECE 284,A00,103671,Turakhia; Yatish Girish,0,0,0,0
1668270415774,ECE 285,A00,103672,Zheng; Yang,0,0,0,0
1668270415774,ECE 285,B00,103673,Sworder; David D.,0,0,0,0
1668270416210,ECE 287,A00,103676,Javidi; Tara,0,0,0,0
1668270416642,MATH 200B,A00,098023,Salehi Golsefidy; Alireza,12,0,15,3
1668270417077,MATH 202B,A00,098024,Rhoades; Brendon Patrick,9,0,15,6
1668270417505,MATH 203B,A00,098025,Oprea; Dragos N.,10,0,15,5
1668270417934,MATH 204B,A00,098026,Sorensen; Claus M,13,0,15,2
1668270418358,MATH 208,A00,098027,Izadi; Elham,7,0,10,3
1668270418796,MATH 209,A00,098028,Pollack; Aaron,10,0,10,0
1668270419220,MATH 211A,A00,112919,Rogalski; Daniel,9,0,10,1
1668270419654,MATH 211B,A00,112920,Seward; Brandon M.,9,0,10,1
1668270420091,MATH 218,A00,098029,Li; Bo,10,0,10,0
1668270420514,MATH 220B,A00,098030,Novak; Jonathan I,11,0,15,4
1668270420946,MATH 221A,A00,098031,Ebenfelt; Peter F,13,0,15,2
1668270421370,MATH 231B,A00,098032,Zlatos; Andrej,12,0,15,3
1668270421807,MATH 240B,A00,098033,Ni; Lei,9,0,15,6
1668270422232,MATH 243,A00,098034,Jekel; David Andrew,10,0,10,0
1668270422667,MATH 245A,A00,098035,Nie; Jiawang,0,0,15,16
1668270423096,MATH 248,A00,098036,Bejenaru; Ioan,10,0,10,0
1668270423521,MATH 250B,A00,098037,Spolaor; Luca,14,0,15,1
1668270423954,MATH 258,A00,098038,Ni; Lei,10,0,10,0
1668270424377,MATH 264B,A00,098041,Rhoades; Brendon Patrick,9,0,15,6
1668270424804,MATH 268,A00,098042,Buss; Samuel R,10,0,10,0
1668270425229,MATH 269,A00,098043,Rhoades; Brendon Patrick,10,0,10,0
1668270425657,MATH 270B,A00,098044,Li; Bo,10,0,15,5
1668270426088,MATH 272B,A00,098045,Holst; Michael J,13,0,15,2
1668270426513,MATH 273A,A00,098046,Tian; Xiaochuan,10,0,15,5
1668270426937,MATH 275,A01,098048,Tian; Xiaochuan,6,0,10,4
1668270427364,MATH 278A,A00,098049,Holst; Michael J,8,0,10,2
1668270427791,MATH 278B,A00,098050,Cloninger; Alexander,10,0,10,0
1668270428225,MATH 278C,A00,098051,Nie; Jiawang,7,0,10,3
1668270428653,MATH 280B,A00,098052,Zheng; Tianyi,9,0,15,6
1668270429089,MATH 281B,A00,098053,Bradic; Jelena,1,0,15,14
1668270429513,MATH 282B,A00,098054,Arias-Castro; Ery,0,0,15,15
1668270429942,MATH 285,A00,098055,Fitzsimmons; Patrick J,0,0,15,17
1668270430368,MATH 287B,A00,098056,Arias-Castro; Ery,2,0,15,13
1668270430802,MATH 288,A00,098057,Agarwal; Pooja,9,0,10,1
1668270430802,MATH 288,B00,098058,Zhang; Danna,8,0,10,2
1668270430802,MATH 288,C00,098059,Williams; Ruth J,10,0,10,0
1668270431235,MATH 290B,A00,098060,Roberts; Justin Deritter,13,0,15,2
1668270431670,MATH 292,A00,098061,Belmont; Eva Kinoshita,10,0,10,0
1668270432093,MATH 295,A00,098062,Suk; Andrew Hoon,48,0,50,2
1668270432518,MATH 296,A00,098063,Novak; Jonathan I,20,0,20,0
1668270432957,MATH 297,001,098064,Gamst; Anthony Collins,9997,0,9999,2
1668270934528,COGS 205,A00,101395,Chiba; Andrea,19,0,20,1
1668270934954,COGS 210B,001,101404,Greene; Deanna Jacquelyn,9998,0,9999,1
1668270934954,COGS 210B,002,101417,Xia; Haijun,9999,0,9999,0
1668270934954,COGS 210B,003,101422,Nitz; Douglas A.,9999,0,9999,0
1668270934954,COGS 210B,004,101423,Hollan; James D.,9998,0,9999,1
1668270934954,COGS 210B,005,101424,Deak; Gedeon O.,9998,0,9999,1
1668270934954,COGS 210B,006,101425,Rossano; Federico,9999,0,9999,0
1668270935380,COGS 211B,A00,101427,Coulson; Seana M,9996,0,9999,3
1668270935809,COGS 220,A00,101428,Hollan; James D.,0,0,25,25
1668270936234,COGS 229,A00,101429,Dow; Steven P,18,0,25,7
1668270936662,COGS 230,A00,101430,Klemmer; Scott R,12,0,17,5
1668270937083,COGS 234,A00,101431,Xia; Haijun,2,0,25,23
1668270937509,COGS 260,A00,101432,Kiyonaga; Anastasia,21,0,25,4
1668270937509,COGS 260,B00,101433,Kirsh; David Joel,15,0,25,10
1668270937933,CSE 202,A00,102371,Impagliazzo; Russell,0,0,0,0
1668270938369,CSE 203B,A01,102373,Cheng; Chung Kuan,0,0,0,0
1668270938792,CSE 208,A00,102374,Micciancio; Daniele,0,0,0,0
1668270939231,CSE 209A,A00,112895,Impagliazzo; Russell,0,0,15,15
1668270939655,CSE 209B,A00,108005,Bellare; Mihir,0,0,0,0
1668270940081,CSE 210,A00,113163,Coblenz; Michael J,0,0,0,0
1668270940504,CSE 219,A00,106111,Dow; Steven P,0,0,20,20
1668270940932,CSE 221,A00,102376,Voelker; Geoffrey M.,0,0,0,0
1668270941355,CSE 224,A01,102378,Porter; George M,0,0,0,0
1668270941779,CSE 229A,A00,102379,Savage; Stefan,0,0,0,0
1668270942201,CSE 229C,A00,102380,Munyaka; Imani N. S.,0,0,0,0
1668270942631,CSE 232B,A00,102382,Deutsch; Alin Bernard,0,0,0,0
1668270943055,CSE 234,A01,112904,Kumar; Arun Kumar,0,0,0,0
1668270943478,CSE 237A,A00,102383,Rosing; Tajana Simunic,0,0,0,0
1668270943906,CSE 239A,A00,102384,Deutsch; Alin Bernard,0,0,0,0
1668270944339,CSE 239B,A00,102385,Polikarpova; Nadezhda,0,0,0,0
1668270944764,CSE 240A,A00,102386,Pannuto; Patrick William,0,0,0,0
1668270945188,CSE 240B,A00,102387,Zhao; Jishen,0,0,0,0
1668270945613,CSE 241A,A00,106406,Kang; Mingu,0,0,0,0
1668270946038,CSE 249B,A00,102388,Kahng; Andrew Byun,0,0,8,8
1668270946467,CSE 251B,A01,102392,Cottrell; Garrison W,0,0,0,0
1668270946467,CSE 251B,A02,102393,Cottrell; Garrison W,0,0,0,0
1668270946892,CSE 252B,A00,102394,Ochoa; Benjamin Lawrence,0,0,0,0
1668270947319,CSE 257,A01,102396,Gao; Sicun,0,0,0,0
1668270947755,CSE 272,A00,102397,Li; Tzumao,0,0,0,0
1668270948178,CSE 274,A00,111323,Chern; Albert Ren-Haur,0,0,0,0
1668270948613,CSE 282,A00,102398,Pevzner; Pavel Arkadjevich,0,0,0,0
1668270949036,CSE 284,A00,114175,Gymrek; Melissa Ann,0,0,0,0
1668270949463,CSE 290,A00,102399,Chandraker; Manmohan Krishna,0,0,0,0
1668270949463,CSE 290,B00,102400,Vaccaro; Kristen Marie,0,0,25,25
1668270949463,CSE 290,C00,102414,Pannuto; Patrick William,0,0,25,25
1668270949463,CSE 290,D00,102427,Pevzner; Pavel Arkadjevich,0,0,0,0
1668270949463,CSE 290,E00,102429,Zhao; Jishen,0,0,0,0
1668270949463,CSE 290,F00,102436,Tullsen; Dean Michael,0,0,0,0
1668270949463,CSE 290,G00,102440,Christensen; Henrik I,0,0,20,20
1668270949898,CSE 291,A00,102443,Su; Hao,0,0,0,0
1668270949898,CSE 291,B00,102448,Polikarpova; Nadezhda,0,0,0,0
1668270949898,CSE 291,C00,102453,Vaccaro; Kristen Marie,0,0,0,0
1668270949898,CSE 291,D00,111343,Savage; Stefan,0,0,0,0
1668270949898,CSE 291,E00,116474,Claffy; Kimberly Claire,0,0,0,0
1668270949898,CSE 291,F00,116479,Pasquale; Joseph,0,0,0,0
1668270950328,CSE 293,001,119111,Bafna; Vineet,9999,0,9999,0
1668270950328,CSE 293,002,119118,Bellare; Mihir,9999,0,9999,0
1668270950328,CSE 293,003,119122,Berg-Kirkpatrick; Taylor D,9999,0,9999,0
1668270950328,CSE 293,004,119135,Christensen; Henrik I,9999,0,9999,0
1668270950328,CSE 293,005,119142,Cottrell; Garrison W,9999,0,9999,0
1668270950328,CSE 293,006,119146,Deutsch; Alin Bernard,9999,0,9999,0
1668270950328,CSE 293,007,119159,Esmaeilzadeh; Hadi,9999,0,9999,0
1668270950328,CSE 293,008,119166,Freund; Yoav,9999,0,9999,0
1668270950328,CSE 293,009,119170,Griswold; William G.,9999,0,9999,0
1668270950328,CSE 293,010,119183,Gymrek; Melissa Ann,9999,0,9999,0
1668270950328,CSE 293,011,119190,Heninger; Nadia A,9999,0,9999,0
1668270950328,CSE 293,012,119230,Impagliazzo; Russell,9999,0,9999,0
1668270950328,CSE 293,013,119232,Jhala; Ranjit,9999,0,9999,0
1668270950328,CSE 293,014,119233,Kahng; Andrew Byun,9999,0,9999,0
1668270950328,CSE 293,015,119298,Kane; Daniel Mertz,9999,0,9999,0
1668270950328,CSE 293,016,119299,Kriegman; David J,9999,0,9999,0
1668270950328,CSE 293,017,119300,Kumar; Arun Kumar,9999,0,9999,0
1668270950328,CSE 293,018,119301,Lerner; Sorin,9999,0,9999,0
1668270950328,CSE 293,019,119302,Lovett; Shachar,9999,0,9999,0
1668270950328,CSE 293,020,119303,McAuley; Julian John,9999,0,9999,0
1668270950328,CSE 293,021,119304,Micciancio; Daniele,9999,0,9999,0
1668270950328,CSE 293,022,119367,Orailoglu; Alex,9999,0,9999,0
1668270950328,CSE 293,023,119382,Paturi; Ramamohan,9999,0,9999,0
1668270950328,CSE 293,024,119404,Polikarpova; Nadezhda,9999,0,9999,0
1668270950328,CSE 293,025,119406,Politz; Joseph Gibbs,9999,0,9999,0
1668270950328,CSE 293,026,119411,Porter; George M,9999,0,9999,0
1668270950328,CSE 293,027,119414,Porter; Leonard Emerson,9999,0,9999,0
1668270950328,CSE 293,028,119416,Ramamoorthi; Ravi,9999,0,9999,0
1668270950328,CSE 293,029,119417,Sahoo; Debashis,9999,0,9999,0
1668270950328,CSE 293,030,119420,Saul; Lawrence,9999,0,9999,0
1668270950328,CSE 293,031,119421,Savage; Stefan,9999,0,9999,0
1668270950328,CSE 293,032,119425,Schulze; Jurgen P.,9999,0,9999,0
1668270950328,CSE 293,033,119426,Snoeren; Alex C.,9999,0,9999,0
1668270950328,CSE 293,034,119428,Shang; Jingbo,9999,0,9999,0
1668270950328,CSE 293,035,119430,Stefan; Deian,9999,0,9999,0
1668270950328,CSE 293,036,119431,Su; Hao,9999,0,9999,0
1668270950328,CSE 293,037,119433,Swanson; Steven James,9999,0,9999,0
1668270950328,CSE 293,038,119435,Tullsen; Dean Michael,9999,0,9999,0
1668270950328,CSE 293,039,119483,Voelker; Geoffrey M.,9999,0,9999,0
1668270950328,CSE 293,040,119537,Zhao; Jishen,9999,0,9999,0
1668270950328,CSE 293,041,119538,Zhou; Yuan-Yuan,9999,0,9999,0
1668270950328,CSE 293,042,119539,Gao; Sicun,9999,0,9999,0
1668270950328,CSE 293,043,119540,Weibel; Nadir,9999,0,9999,0
1668270950328,CSE 293,044,119541,Gupta; Rajesh K.,9999,0,9999,0
1668270950328,CSE 293,045,126410,Vaccaro; Kristen Marie,9999,0,9999,0
1668270950328,CSE 293,046,126411,Klemke; Richard,9999,0,9999,0
1668270950763,CSE 294,A00,102459,Voelker; Geoffrey M.,0,0,0,0
1668270950763,CSE 294,B00,111322,Orailoglu; Alex,0,0,0,0
1668270951187,DSE 201,A00,096914,Deutsch; Alin Bernard,30,0,30,0
1668270951616,DSE 210,A00,096915,Dasgupta; Sanjoy,30,0,30,0
1668270952049,DSE 260A,A00,096916,Altintas De Callaf; Ilkay,30,0,30,0
1668270952493,ECE 200,001,103586,Antipa; Nicholas A,9999,0,9999,0
1668270952493,ECE 200,002,103587,Atanasov; Nikolay A.,9999,0,9999,0
1668270952493,ECE 200,003,103588,Bharadia; Dinesh,9999,0,9999,0
1668270952493,ECE 200,004,103589,Cheng; Chung Kuan,9999,0,9999,0
1668270952493,ECE 200,005,103590,Cosman; Pamela C.,9999,0,9999,0
1668270952493,ECE 200,006,103591,Dayeh; Shadi Ahmad,9999,0,9999,0
1668270952493,ECE 200,007,103592,Fainman; Yeshaiahu,9999,0,9999,0
1668270952493,ECE 200,008,103593,Ford; Joseph Earl,9999,0,9999,0
1668270952493,ECE 200,009,103594,Franceschetti; Massimo,9999,0,9999,0
1668270952493,ECE 200,010,103595,Fullerton; Eric E,9999,0,9999,0
1668270952493,ECE 200,011,103596,Galton; Ian A,9999,0,9999,0
1668270952493,ECE 200,012,103597,Gilja; Vikash,9999,0,9999,0
1668270952493,ECE 200,013,103598,Hall; Drew A.,9999,0,9999,0
1668270952493,ECE 200,014,103599,Hsueh; Tzu-Chien,9999,0,9999,0
1668270952493,ECE 200,015,103600,Javidi; Tara,9999,0,9999,0
1668270952493,ECE 200,016,103601,Kahng; Andrew Byun,9999,0,9999,0
1668270952493,ECE 200,017,103602,Kim; Young-Han,9999,0,9999,0
1668270952493,ECE 200,018,103603,Koushanfar; Farinaz,9999,0,9999,0
1668270952493,ECE 200,019,103604,Kuzum; Duygu,9999,0,9999,0
1668270952493,ECE 200,020,103605,Le; Hanh-Phuc,9999,0,9999,0
1668270952493,ECE 200,021,103606,Lin; Bill,9999,0,9999,0
1668270952493,ECE 200,022,103607,Liu; Zhaowei,9998,0,9999,1
1668270952493,ECE 200,023,103608,Lo; Yu-Hwa,9999,0,9999,0
1668270952493,ECE 200,024,103609,Lomakin; Vitaliy,9999,0,9999,0
1668270952493,ECE 200,025,103610,Mercier; Patrick Philip,9999,0,9999,0
1668270952493,ECE 200,026,103611,Meyer; Florian,9999,0,9999,0
1668270952493,ECE 200,027,103612,Milstein; Laurence B.,9999,0,9999,0
1668270952493,ECE 200,028,103613,Mir Arabbaygi; Siavash,9999,0,9999,0
1668270952493,ECE 200,029,103614,Mookherjea; Shayan,9999,0,9999,0
1668270952493,ECE 200,030,103615,Morris; Karcher William,9999,0,9999,0
1668270952493,ECE 200,031,103616,Ng; Tse Nga,9999,0,9999,0
1668270952493,ECE 200,032,103617,Nguyen; Truong Quang,9999,0,9999,0
1668270952493,ECE 200,033,103618,Nomura; Kenji,9999,0,9999,0
1668270952493,ECE 200,034,103619,Orlitsky; Alon,9999,0,9999,0
1668270952493,ECE 200,035,103620,Pal; Piya,9999,0,9999,0
1668270952493,ECE 200,036,103621,Papen; George C.,9999,0,9999,0
1668270952493,ECE 200,037,103622,Radic; Stojan,9999,0,9999,0
1668270952493,ECE 200,038,103623,Rao; Bhaskar D.,9999,0,9999,0
1668270952493,ECE 200,039,103624,Rao; Ramesh R,9999,0,9999,0
1668270952493,ECE 200,040,103625,Rebeiz; Gabriel,9999,0,9999,0
1668270952493,ECE 200,041,103626,Sanford; John R,9999,0,9999,0
1668270952493,ECE 200,042,103627,Siegel; Paul H.,9999,0,9999,0
1668270952493,ECE 200,043,103628,Sievenpiper; Daniel F.,9999,0,9999,0
1668270952493,ECE 200,044,103629,Sworder; David D.,9999,0,9999,0
1668270952493,ECE 200,045,103630,Taur; Yuan,9999,0,9999,0
1668270952493,ECE 200,046,103631,Touri; Behrouz,9999,0,9999,0
1668270952493,ECE 200,047,103632,Trivedi; Mohan M.,9999,0,9999,0
1668270952493,ECE 200,048,103633,Vasconcelos; Nuno,9999,0,9999,0
1668270952493,ECE 200,049,103634,Wang; Xiaolong,9999,0,9999,0
1668270952493,ECE 200,050,103635,Xie; Pengtao,9999,0,9999,0
1668270952493,ECE 200,051,103636,Yip; Michael,9999,0,9999,0
1668270952493,ECE 200,052,103637,Zeger; Kenneth A.,999,0,999,0
1668270952493,ECE 200,053,103638,Zhang; Xinyu,9999,0,9999,0
1668270952493,ECE 200,054,103639,Turakhia; Yatish Girish,9999,0,9999,0
1668270952493,ECE 200,055,103640,Kang; Mingu,9999,0,9999,0
1668270952493,ECE 200,056,103641,Shi; Yuanyuan,9999,0,9999,0
1668270952493,ECE 200,057,103642,Wang; Edward Jay,9999,0,9999,0
1668270952493,ECE 200,058,103643,Zheng; Yang,9999,0,9999,0
1668270952924,ECE 202,A00,103644,Kuzum; Duygu,0,0,0,0
1668270953347,ECE 212BN,A00,103646,Ng; Tse Nga,0,0,0,0
1668270953771,ECE 221,A00,111493,Staff,0,0,0,0
1668270954195,ECE 222B,A00,103647,Lomakin; Vitaliy,0,0,0,0
1668270954626,ECE 230B,A00,103648,Taur; Yuan,0,0,0,0
1668270955049,ECE 238B,A00,103649,Garay; Javier,0,0,0,0
1668270955476,ECE 240B,A00,112900,Fainman; Yeshaiahu,0,0,0,0
1668270955903,ECE 247A,A00,103650,Jokerst; Jesse Vincent,0,0,0,0
1668270956327,ECE 247B,A00,103651,Wang; Joseph,0,0,0,0
1668270956752,ECE 250,A00,103652,Siegel; Paul H.,0,0,0,0
1668270957176,ECE 251A,A00,103654,Rao; Bhaskar D.,0,0,0,0
1668270957597,ECE 257B,A00,103655,Bharadia; Dinesh,0,0,0,0
1668270958021,ECE 258A,A00,103656,Milstein; Laurence B.,0,0,0,0
1668270958449,ECE 260B,A00,103658,Kang; Mingu,0,0,0,0
1668270958877,ECE 264A,A00,103659,Galton; Ian A,0,0,0,0
1668270959313,ECE 265A,A00,103661,Gudem; Prasad S.S.,0,0,0,0
1668270959736,ECE 265D,A00,103662,Gudem; Prasad S.S.,0,0,0,0
1668270960163,ECE 268,A00,103663,Koushanfar; Farinaz,0,0,0,0
1668270960595,ECE 269,A01,103665,Pal; Piya,0,0,0,0
1668270961021,ECE 271B,A00,103666,Vasconcelos; Manuela,0,0,0,0
1668270961449,ECE 276A,A00,103667,Atanasov; Nikolay A.,0,0,0,0
1668270961872,ECE 277,A00,103668,An; Cheolhong,0,0,0,0
1668270962298,ECE 279,A00,117947,Hall; Drew A.,0,0,0,0
1668270963148,ECE 283,A00,103670,Hsueh; Tzu-Chien,0,0,0,0
1668270963581,ECE 284,A00,103671,Turakhia; Yatish Girish,0,0,0,0
1668270964007,ECE 285,A00,103672,Zheng; Yang,0,0,0,0
1668270964007,ECE 285,B00,103673,Sworder; David D.,0,0,0,0
1668270964432,ECE 287,A00,103676,Javidi; Tara,0,0,0,0
1668270964870,MATH 200B,A00,098023,Salehi Golsefidy; Alireza,12,0,15,3
1668270965293,MATH 202B,A00,098024,Rhoades; Brendon Patrick,9,0,15,6
1668270965728,MATH 203B,A00,098025,Oprea; Dragos N.,10,0,15,5
1668270966166,MATH 204B,A00,098026,Sorensen; Claus M,13,0,15,2
1668270966587,MATH 208,A00,098027,Izadi; Elham,7,0,10,3
1668270967011,MATH 209,A00,098028,Pollack; Aaron,10,0,10,0
1668270967435,MATH 211A,A00,112919,Rogalski; Daniel,9,0,10,1
1668270967856,MATH 211B,A00,112920,Seward; Brandon M.,9,0,10,1
1668270968288,MATH 218,A00,098029,Li; Bo,10,0,10,0
1668270968717,MATH 220B,A00,098030,Novak; Jonathan I,11,0,15,4
1668270969153,MATH 221A,A00,098031,Ebenfelt; Peter F,13,0,15,2
1668270969576,MATH 231B,A00,098032,Zlatos; Andrej,12,0,15,3
1668270970000,MATH 240B,A00,098033,Ni; Lei,9,0,15,6
1668270970426,MATH 243,A00,098034,Jekel; David Andrew,10,0,10,0
1668270970850,MATH 245A,A00,098035,Nie; Jiawang,0,0,15,16
1668270971273,MATH 248,A00,098036,Bejenaru; Ioan,10,0,10,0
1668270971711,MATH 250B,A00,098037,Spolaor; Luca,14,0,15,1
1668270972226,MATH 258,A00,098038,Ni; Lei,10,0,10,0
1668270972648,MATH 264B,A00,098041,Rhoades; Brendon Patrick,9,0,15,6
1668270973074,MATH 268,A00,098042,Buss; Samuel R,10,0,10,0
1668270973500,MATH 269,A00,098043,Rhoades; Brendon Patrick,10,0,10,0
1668270973927,MATH 270B,A00,098044,Li; Bo,10,0,15,5
1668270974354,MATH 272B,A00,098045,Holst; Michael J,13,0,15,2
1668270974778,MATH 273A,A00,098046,Tian; Xiaochuan,10,0,15,5
1668270975210,MATH 275,A01,098048,Tian; Xiaochuan,6,0,10,4
1668270975633,MATH 278A,A00,098049,Holst; Michael J,8,0,10,2
1668270976057,MATH 278B,A00,098050,Cloninger; Alexander,10,0,10,0
1668270976482,MATH 278C,A00,098051,Nie; Jiawang,7,0,10,3
1668270976906,MATH 280B,A00,098052,Zheng; Tianyi,9,0,15,6
1668270977333,MATH 281B,A00,098053,Bradic; Jelena,1,0,15,14
1668270977758,MATH 282B,A00,098054,Arias-Castro; Ery,0,0,15,15
1668270978187,MATH 285,A00,098055,Fitzsimmons; Patrick J,0,0,15,17
1668270978620,MATH 287B,A00,098056,Arias-Castro; Ery,2,0,15,13
1668270979047,MATH 288,A00,098057,Agarwal; Pooja,9,0,10,1
1668270979047,MATH 288,B00,098058,Zhang; Danna,8,0,10,2
1668270979047,MATH 288,C00,098059,Williams; Ruth J,10,0,10,0
1668270979483,MATH 290B,A00,098060,Roberts; Justin Deritter,13,0,15,2
1668270979912,MATH 292,A00,098061,Belmont; Eva Kinoshita,10,0,10,0
1668270980346,MATH 295,A00,098062,Suk; Andrew Hoon,48,0,50,2
1668270980769,MATH 296,A00,098063,Novak; Jonathan I,20,0,20,0
1668270981191,MATH 297,001,098064,Gamst; Anthony Collins,9997,0,9999,2
1668271483086,COGS 205,A00,101395,Chiba; Andrea,19,0,20,1
1668271483510,COGS 210B,001,101404,Greene; Deanna Jacquelyn,9998,0,9999,1
1668271483510,COGS 210B,002,101417,Xia; Haijun,9999,0,9999,0
1668271483510,COGS 210B,003,101422,Nitz; Douglas A.,9999,0,9999,0
1668271483510,COGS 210B,004,101423,Hollan; James D.,9998,0,9999,1
1668271483510,COGS 210B,005,101424,Deak; Gedeon O.,9998,0,9999,1
1668271483510,COGS 210B,006,101425,Rossano; Federico,9999,0,9999,0
1668271483941,COGS 211B,A00,101427,Coulson; Seana M,9996,0,9999,3
1668271484376,COGS 220,A00,101428,Hollan; James D.,0,0,25,25
1668271484799,COGS 229,A00,101429,Dow; Steven P,18,0,25,7
1668271485232,COGS 230,A00,101430,Klemmer; Scott R,12,0,17,5
1668271485670,COGS 234,A00,101431,Xia; Haijun,2,0,25,23
1668271486094,COGS 260,A00,101432,Kiyonaga; Anastasia,21,0,25,4
1668271486094,COGS 260,B00,101433,Kirsh; David Joel,15,0,25,10
1668271486522,CSE 202,A00,102371,Impagliazzo; Russell,0,0,0,0
1668271486948,CSE 203B,A01,102373,Cheng; Chung Kuan,0,0,0,0
1668271487377,CSE 208,A00,102374,Micciancio; Daniele,0,0,0,0
1668271487803,CSE 209A,A00,112895,Impagliazzo; Russell,0,0,15,15
1668271488228,CSE 209B,A00,108005,Bellare; Mihir,0,0,0,0
1668271488657,CSE 210,A00,113163,Coblenz; Michael J,0,0,0,0
1668271489085,CSE 219,A00,106111,Dow; Steven P,0,0,20,20
1668271489509,CSE 221,A00,102376,Voelker; Geoffrey M.,0,0,0,0
1668271489934,CSE 224,A01,102378,Porter; George M,0,0,0,0
1668271490357,CSE 229A,A00,102379,Savage; Stefan,0,0,0,0
1668271490780,CSE 229C,A00,102380,Munyaka; Imani N. S.,0,0,0,0
1668271491216,CSE 232B,A00,102382,Deutsch; Alin Bernard,0,0,0,0
1668271491642,CSE 234,A01,112904,Kumar; Arun Kumar,0,0,0,0
1668271492077,CSE 237A,A00,102383,Rosing; Tajana Simunic,0,0,0,0
1668271492506,CSE 239A,A00,102384,Deutsch; Alin Bernard,0,0,0,0
1668271492932,CSE 239B,A00,102385,Polikarpova; Nadezhda,0,0,0,0
1668271493359,CSE 240A,A00,102386,Pannuto; Patrick William,0,0,0,0
1668271493797,CSE 240B,A00,102387,Zhao; Jishen,0,0,0,0
1668271494330,CSE 241A,A00,106406,Kang; Mingu,0,0,0,0
1668271494752,CSE 249B,A00,102388,Kahng; Andrew Byun,0,0,8,8
1668271495176,CSE 251B,A01,102392,Cottrell; Garrison W,0,0,0,0
1668271495176,CSE 251B,A02,102393,Cottrell; Garrison W,0,0,0,0
1668271495598,CSE 252B,A00,102394,Ochoa; Benjamin Lawrence,0,0,0,0
1668271496024,CSE 257,A01,102396,Gao; Sicun,0,0,0,0
1668271496448,CSE 272,A00,102397,Li; Tzumao,0,0,0,0
1668271496872,CSE 274,A00,111323,Chern; Albert Ren-Haur,0,0,0,0
1668271497296,CSE 282,A00,102398,Pevzner; Pavel Arkadjevich,0,0,0,0
1668271497726,CSE 284,A00,114175,Gymrek; Melissa Ann,0,0,0,0
1668271498160,CSE 290,A00,102399,Chandraker; Manmohan Krishna,0,0,0,0
1668271498160,CSE 290,B00,102400,Vaccaro; Kristen Marie,0,0,25,25
1668271498160,CSE 290,C00,102414,Pannuto; Patrick William,0,0,25,25
1668271498160,CSE 290,D00,102427,Pevzner; Pavel Arkadjevich,0,0,0,0
1668271498160,CSE 290,E00,102429,Zhao; Jishen,0,0,0,0
1668271498160,CSE 290,F00,102436,Tullsen; Dean Michael,0,0,0,0
1668271498160,CSE 290,G00,102440,Christensen; Henrik I,0,0,20,20
1668271498590,CSE 291,A00,102443,Su; Hao,0,0,0,0
1668271498590,CSE 291,B00,102448,Polikarpova; Nadezhda,0,0,0,0
1668271498590,CSE 291,C00,102453,Vaccaro; Kristen Marie,0,0,0,0
1668271498590,CSE 291,D00,111343,Savage; Stefan,0,0,0,0
1668271498590,CSE 291,E00,116474,Claffy; Kimberly Claire,0,0,0,0
1668271498590,CSE 291,F00,116479,Pasquale; Joseph,0,0,0,0
1668271499016,CSE 293,001,119111,Bafna; Vineet,9999,0,9999,0
1668271499016,CSE 293,002,119118,Bellare; Mihir,9999,0,9999,0
1668271499016,CSE 293,003,119122,Berg-Kirkpatrick; Taylor D,9999,0,9999,0
1668271499016,CSE 293,004,119135,Christensen; Henrik I,9999,0,9999,0
1668271499016,CSE 293,005,119142,Cottrell; Garrison W,9999,0,9999,0
1668271499016,CSE 293,006,119146,Deutsch; Alin Bernard,9999,0,9999,0
1668271499016,CSE 293,007,119159,Esmaeilzadeh; Hadi,9999,0,9999,0
1668271499016,CSE 293,008,119166,Freund; Yoav,9999,0,9999,0
1668271499016,CSE 293,009,119170,Griswold; William G.,9999,0,9999,0
1668271499016,CSE 293,010,119183,Gymrek; Melissa Ann,9999,0,9999,0
1668271499016,CSE 293,011,119190,Heninger; Nadia A,9999,0,9999,0
1668271499016,CSE 293,012,119230,Impagliazzo; Russell,9999,0,9999,0
1668271499016,CSE 293,013,119232,Jhala; Ranjit,9999,0,9999,0
1668271499016,CSE 293,014,119233,Kahng; Andrew Byun,9999,0,9999,0
1668271499016,CSE 293,015,119298,Kane; Daniel Mertz,9999,0,9999,0
1668271499016,CSE 293,016,119299,Kriegman; David J,9999,0,9999,0
1668271499016,CSE 293,017,119300,Kumar; Arun Kumar,9999,0,9999,0
1668271499016,CSE 293,018,119301,Lerner; Sorin,9999,0,9999,0
1668271499016,CSE 293,019,119302,Lovett; Shachar,9999,0,9999,0
1668271499016,CSE 293,020,119303,McAuley; Julian John,9999,0,9999,0
1668271499016,CSE 293,021,119304,Micciancio; Daniele,9999,0,9999,0
1668271499016,CSE 293,022,119367,Orailoglu; Alex,9999,0,9999,0
1668271499016,CSE 293,023,119382,Paturi; Ramamohan,9999,0,9999,0
1668271499016,CSE 293,024,119404,Polikarpova; Nadezhda,9999,0,9999,0
1668271499016,CSE 293,025,119406,Politz; Joseph Gibbs,9999,0,9999,0
1668271499016,CSE 293,026,119411,Porter; George M,9999,0,9999,0
1668271499016,CSE 293,027,119414,Porter; Leonard Emerson,9999,0,9999,0
1668271499016,CSE 293,028,119416,Ramamoorthi; Ravi,9999,0,9999,0
1668271499016,CSE 293,029,119417,Sahoo; Debashis,9999,0,9999,0
1668271499016,CSE 293,030,119420,Saul; Lawrence,9999,0,9999,0
1668271499016,CSE 293,031,119421,Savage; Stefan,9999,0,9999,0
1668271499016,CSE 293,032,119425,Schulze; Jurgen P.,9999,0,9999,0
1668271499016,CSE 293,033,119426,Snoeren; Alex C.,9999,0,9999,0
1668271499016,CSE 293,034,119428,Shang; Jingbo,9999,0,9999,0
1668271499016,CSE 293,035,119430,Stefan; Deian,9999,0,9999,0
1668271499016,CSE 293,036,119431,Su; Hao,9999,0,9999,0
1668271499016,CSE 293,037,119433,Swanson; Steven James,9999,0,9999,0
1668271499016,CSE 293,038,119435,Tullsen; Dean Michael,9999,0,9999,0
1668271499016,CSE 293,039,119483,Voelker; Geoffrey M.,9999,0,9999,0
1668271499016,CSE 293,040,119537,Zhao; Jishen,9999,0,9999,0
1668271499016,CSE 293,041,119538,Zhou; Yuan-Yuan,9999,0,9999,0
1668271499016,CSE 293,042,119539,Gao; Sicun,9999,0,9999,0
1668271499016,CSE 293,043,119540,Weibel; Nadir,9999,0,9999,0
1668271499016,CSE 293,044,119541,Gupta; Rajesh K.,9999,0,9999,0
1668271499016,CSE 293,045,126410,Vaccaro; Kristen Marie,9999,0,9999,0
1668271499016,CSE 293,046,126411,Klemke; Richard,9999,0,9999,0
1668271499447,CSE 294,A00,102459,Voelker; Geoffrey M.,0,0,0,0
1668271499447,CSE 294,B00,111322,Orailoglu; Alex,0,0,0,0
1668271499885,DSE 201,A00,096914,Deutsch; Alin Bernard,30,0,30,0
1668271500310,DSE 210,A00,096915,Dasgupta; Sanjoy,30,0,30,0
1668271500734,DSE 260A,A00,096916,Altintas De Callaf; Ilkay,30,0,30,0
1668271501169,ECE 200,001,103586,Antipa; Nicholas A,9999,0,9999,0
1668271501169,ECE 200,002,103587,Atanasov; Nikolay A.,9999,0,9999,0
1668271501169,ECE 200,003,103588,Bharadia; Dinesh,9999,0,9999,0
1668271501169,ECE 200,004,103589,Cheng; Chung Kuan,9999,0,9999,0
1668271501169,ECE 200,005,103590,Cosman; Pamela C.,9999,0,9999,0
1668271501169,ECE 200,006,103591,Dayeh; Shadi Ahmad,9999,0,9999,0
1668271501169,ECE 200,007,103592,Fainman; Yeshaiahu,9999,0,9999,0
1668271501169,ECE 200,008,103593,Ford; Joseph Earl,9999,0,9999,0
1668271501169,ECE 200,009,103594,Franceschetti; Massimo,9999,0,9999,0
1668271501169,ECE 200,010,103595,Fullerton; Eric E,9999,0,9999,0
1668271501169,ECE 200,011,103596,Galton; Ian A,9999,0,9999,0
1668271501169,ECE 200,012,103597,Gilja; Vikash,9999,0,9999,0
1668271501169,ECE 200,013,103598,Hall; Drew A.,9999,0,9999,0
1668271501169,ECE 200,014,103599,Hsueh; Tzu-Chien,9999,0,9999,0
1668271501169,ECE 200,015,103600,Javidi; Tara,9999,0,9999,0
1668271501169,ECE 200,016,103601,Kahng; Andrew Byun,9999,0,9999,0
1668271501169,ECE 200,017,103602,Kim; Young-Han,9999,0,9999,0
1668271501169,ECE 200,018,103603,Koushanfar; Farinaz,9999,0,9999,0
1668271501169,ECE 200,019,103604,Kuzum; Duygu,9999,0,9999,0
1668271501169,ECE 200,020,103605,Le; Hanh-Phuc,9999,0,9999,0
1668271501169,ECE 200,021,103606,Lin; Bill,9999,0,9999,0
1668271501169,ECE 200,022,103607,Liu; Zhaowei,9998,0,9999,1
1668271501169,ECE 200,023,103608,Lo; Yu-Hwa,9999,0,9999,0
1668271501169,ECE 200,024,103609,Lomakin; Vitaliy,9999,0,9999,0
1668271501169,ECE 200,025,103610,Mercier; Patrick Philip,9999,0,9999,0
1668271501169,ECE 200,026,103611,Meyer; Florian,9999,0,9999,0
1668271501169,ECE 200,027,103612,Milstein; Laurence B.,9999,0,9999,0
1668271501169,ECE 200,028,103613,Mir Arabbaygi; Siavash,9999,0,9999,0
1668271501169,ECE 200,029,103614,Mookherjea; Shayan,9999,0,9999,0
1668271501169,ECE 200,030,103615,Morris; Karcher William,9999,0,9999,0
1668271501169,ECE 200,031,103616,Ng; Tse Nga,9999,0,9999,0
1668271501169,ECE 200,032,103617,Nguyen; Truong Quang,9999,0,9999,0
1668271501169,ECE 200,033,103618,Nomura; Kenji,9999,0,9999,0
1668271501169,ECE 200,034,103619,Orlitsky; Alon,9999,0,9999,0
1668271501169,ECE 200,035,103620,Pal; Piya,9999,0,9999,0
1668271501169,ECE 200,036,103621,Papen; George C.,9999,0,9999,0
1668271501169,ECE 200,037,103622,Radic; Stojan,9999,0,9999,0
1668271501169,ECE 200,038,103623,Rao; Bhaskar D.,9999,0,9999,0
1668271501169,ECE 200,039,103624,Rao; Ramesh R,9999,0,9999,0
1668271501169,ECE 200,040,103625,Rebeiz; Gabriel,9999,0,9999,0
1668271501169,ECE 200,041,103626,Sanford; John R,9999,0,9999,0
1668271501169,ECE 200,042,103627,Siegel; Paul H.,9999,0,9999,0
1668271501169,ECE 200,043,103628,Sievenpiper; Daniel F.,9999,0,9999,0
1668271501169,ECE 200,044,103629,Sworder; David D.,9999,0,9999,0
1668271501169,ECE 200,045,103630,Taur; Yuan,9999,0,9999,0
1668271501169,ECE 200,046,103631,Touri; Behrouz,9999,0,9999,0
1668271501169,ECE 200,047,103632,Trivedi; Mohan M.,9999,0,9999,0
1668271501169,ECE 200,048,103633,Vasconcelos; Nuno,9999,0,9999,0
1668271501169,ECE 200,049,103634,Wang; Xiaolong,9999,0,9999,0
1668271501169,ECE 200,050,103635,Xie; Pengtao,9999,0,9999,0
1668271501169,ECE 200,051,103636,Yip; Michael,9999,0,9999,0
1668271501169,ECE 200,052,103637,Zeger; Kenneth A.,999,0,999,0
1668271501169,ECE 200,053,103638,Zhang; Xinyu,9999,0,9999,0
1668271501169,ECE 200,054,103639,Turakhia; Yatish Girish,9999,0,9999,0
1668271501169,ECE 200,055,103640,Kang; Mingu,9999,0,9999,0
1668271501169,ECE 200,056,103641,Shi; Yuanyuan,9999,0,9999,0
1668271501169,ECE 200,057,103642,Wang; Edward Jay,9999,0,9999,0
1668271501169,ECE 200,058,103643,Zheng; Yang,9999,0,9999,0
1668271501604,ECE 202,A00,103644,Kuzum; Duygu,0,0,0,0
1668271502031,ECE 212BN,A00,103646,Ng; Tse Nga,0,0,0,0
1668271502454,ECE 221,A00,111493,Staff,0,0,0,0
1668271502884,ECE 222B,A00,103647,Lomakin; Vitaliy,0,0,0,0
1668271503314,ECE 230B,A00,103648,Taur; Yuan,0,0,0,0
1668271503741,ECE 238B,A00,103649,Garay; Javier,0,0,0,0
1668271504167,ECE 240B,A00,112900,Fainman; Yeshaiahu,0,0,0,0
1668271504592,ECE 247A,A00,103650,Jokerst; Jesse Vincent,0,0,0,0
1668271505018,ECE 247B,A00,103651,Wang; Joseph,0,0,0,0
1668271505440,ECE 250,A00,103652,Siegel; Paul H.,0,0,0,0
1668271505867,ECE 251A,A00,103654,Rao; Bhaskar D.,0,0,0,0
1668271506290,ECE 257B,A00,103655,Bharadia; Dinesh,0,0,0,0
1668271506711,ECE 258A,A00,103656,Milstein; Laurence B.,0,0,0,0
1668271507135,ECE 260B,A00,103658,Kang; Mingu,0,0,0,0
1668271507562,ECE 264A,A00,103659,Galton; Ian A,0,0,0,0
1668271507986,ECE 265A,A00,103661,Gudem; Prasad S.S.,0,0,0,0
1668271508408,ECE 265D,A00,103662,Gudem; Prasad S.S.,0,0,0,0
1668271508842,ECE 268,A00,103663,Koushanfar; Farinaz,0,0,0,0
1668271509269,ECE 269,A01,103665,Pal; Piya,0,0,0,0
1668271509707,ECE 271B,A00,103666,Vasconcelos; Manuela,0,0,0,0
1668271510135,ECE 276A,A00,103667,Atanasov; Nikolay A.,0,0,0,0
1668271510558,ECE 277,A00,103668,An; Cheolhong,0,0,0,0
1668271510983,ECE 279,A00,117947,Hall; Drew A.,0,0,0,0
1668271511831,ECE 283,A00,103670,Hsueh; Tzu-Chien,0,0,0,0
1668271512256,ECE 284,A00,103671,Turakhia; Yatish Girish,0,0,0,0
1668271512679,ECE 285,A00,103672,Zheng; Yang,0,0,0,0
1668271512679,ECE 285,B00,103673,Sworder; David D.,0,0,0,0
1668271513106,ECE 287,A00,103676,Javidi; Tara,0,0,0,0
1668271513529,MATH 200B,A00,098023,Salehi Golsefidy; Alireza,12,0,15,3
1668271513958,MATH 202B,A00,098024,Rhoades; Brendon Patrick,9,0,15,6
1668271514385,MATH 203B,A00,098025,Oprea; Dragos N.,10,0,15,5
1668271514817,MATH 204B,A00,098026,Sorensen; Claus M,13,0,15,2
1668271515245,MATH 208,A00,098027,Izadi; Elham,7,0,10,3
1668271515668,MATH 209,A00,098028,Pollack; Aaron,10,0,10,0
1668271516091,MATH 211A,A00,112919,Rogalski; Daniel,9,0,10,1
1668271516514,MATH 211B,A00,112920,Seward; Brandon M.,9,0,10,1
1668271516940,MATH 218,A00,098029,Li; Bo,10,0,10,0
1668271517365,MATH 220B,A00,098030,Novak; Jonathan I,11,0,15,4
1668271517788,MATH 221A,A00,098031,Ebenfelt; Peter F,13,0,15,2
1668271518212,MATH 231B,A00,098032,Zlatos; Andrej,12,0,15,3
1668271518634,MATH 240B,A00,098033,Ni; Lei,9,0,15,6
1668271519060,MATH 243,A00,098034,Jekel; David Andrew,10,0,10,0
1668271519486,MATH 245A,A00,098035,Nie; Jiawang,0,0,15,16
1668271519913,MATH 248,A00,098036,Bejenaru; Ioan,10,0,10,0
1668271520338,MATH 250B,A00,098037,Spolaor; Luca,14,0,15,1
1668271520764,MATH 258,A00,098038,Ni; Lei,10,0,10,0
1668271521187,MATH 264B,A00,098041,Rhoades; Brendon Patrick,9,0,15,6
1668271521612,MATH 268,A00,098042,Buss; Samuel R,10,0,10,0
1668271522037,MATH 269,A00,098043,Rhoades; Brendon Patrick,10,0,10,0
1668271522462,MATH 270B,A00,098044,Li; Bo,10,0,15,5
1668271522886,MATH 272B,A00,098045,Holst; Michael J,13,0,15,2
1668271523313,MATH 273A,A00,098046,Tian; Xiaochuan,10,0,15,5
1668271523736,MATH 275,A01,098048,Tian; Xiaochuan,6,0,10,4
1668271524159,MATH 278A,A00,098049,Holst; Michael J,8,0,10,2
1668271524590,MATH 278B,A00,098050,Cloninger; Alexander,10,0,10,0
1668271525019,MATH 278C,A00,098051,Nie; Jiawang,7,0,10,3
1668271525448,MATH 280B,A00,098052,Zheng; Tianyi,9,0,15,6
1668271525877,MATH 281B,A00,098053,Bradic; Jelena,1,0,15,14
1668271526303,MATH 282B,A00,098054,Arias-Castro; Ery,0,0,15,15
1668271526727,MATH 285,A00,098055,Fitzsimmons; Patrick J,0,0,15,17
1668271527150,MATH 287B,A00,098056,Arias-Castro; Ery,2,0,15,13
1668271527577,MATH 288,A00,098057,Agarwal; Pooja,9,0,10,1
1668271527577,MATH 288,B00,098058,Zhang; Danna,8,0,10,2
1668271527577,MATH 288,C00,098059,Williams; Ruth J,10,0,10,0
1668271528001,MATH 290B,A00,098060,Roberts; Justin Deritter,13,0,15,2
1668271528428,MATH 292,A00,098061,Belmont; Eva Kinoshita,10,0,10,0
1668271528857,MATH 295,A00,098062,Suk; Andrew Hoon,48,0,50,2
1668271529281,MATH 296,A00,098063,Novak; Jonathan I,20,0,20,0
1668271529718,MATH 297,001,098064,Gamst; Anthony Collins,9997,0,9999,2
1668272035566,COGS 205,A00,101395,Chiba; Andrea,19,0,20,1
1668272035992,COGS 210B,001,101404,Greene; Deanna Jacquelyn,9998,0,9999,1
1668272035992,COGS 210B,002,101417,Xia; Haijun,9999,0,9999,0
1668272035992,COGS 210B,003,101422,Nitz; Douglas A.,9999,0,9999,0
1668272035992,COGS 210B,004,101423,Hollan; James D.,9998,0,9999,1
1668272035992,COGS 210B,005,101424,Deak; Gedeon O.,9998,0,9999,1
1668272035992,COGS 210B,006,101425,Rossano; Federico,9999,0,9999,0
1668272036415,COGS 211B,A00,101427,Coulson; Seana M,9996,0,9999,3
1668272036840,COGS 220,A00,101428,Hollan; James D.,0,0,25,25
1668272037265,COGS 229,A00,101429,Dow; Steven P,18,0,25,7
1668272037695,COGS 230,A00,101430,Klemmer; Scott R,12,0,17,5
1668272038120,COGS 234,A00,101431,Xia; Haijun,2,0,25,23
1668272038543,COGS 260,A00,101432,Kiyonaga; Anastasia,21,0,25,4
1668272038543,COGS 260,B00,101433,Kirsh; David Joel,15,0,25,10
1668272038971,CSE 202,A00,102371,Impagliazzo; Russell,0,0,0,0
1668272039395,CSE 203B,A01,102373,Cheng; Chung Kuan,0,0,0,0
1668272039819,CSE 208,A00,102374,Micciancio; Daniele,0,0,0,0
1668272040247,CSE 209A,A00,112895,Impagliazzo; Russell,0,0,15,15
1668272040673,CSE 209B,A00,108005,Bellare; Mihir,0,0,0,0
1668272041097,CSE 210,A00,113163,Coblenz; Michael J,0,0,0,0
1668272041521,CSE 219,A00,106111,Dow; Steven P,0,0,20,20
1668272041944,CSE 221,A00,102376,Voelker; Geoffrey M.,0,0,0,0
1668272042379,CSE 224,A01,102378,Porter; George M,0,0,0,0
1668272042808,CSE 229A,A00,102379,Savage; Stefan,0,0,0,0
1668272043238,CSE 229C,A00,102380,Munyaka; Imani N. S.,0,0,0,0
1668272043665,CSE 232B,A00,102382,Deutsch; Alin Bernard,0,0,0,0
1668272044096,CSE 234,A01,112904,Kumar; Arun Kumar,0,0,0,0
1668272044523,CSE 237A,A00,102383,Rosing; Tajana Simunic,0,0,0,0
1668272044950,CSE 239A,A00,102384,Deutsch; Alin Bernard,0,0,0,0
1668272045374,CSE 239B,A00,102385,Polikarpova; Nadezhda,0,0,0,0
1668272045797,CSE 240A,A00,102386,Pannuto; Patrick William,0,0,0,0
1668272046223,CSE 240B,A00,102387,Zhao; Jishen,0,0,0,0
1668272046650,CSE 241A,A00,106406,Kang; Mingu,0,0,0,0
1668272047078,CSE 249B,A00,102388,Kahng; Andrew Byun,0,0,8,8
1668272047516,CSE 251B,A01,102392,Cottrell; Garrison W,0,0,0,0
1668272047516,CSE 251B,A02,102393,Cottrell; Garrison W,0,0,0,0
1668272047945,CSE 252B,A00,102394,Ochoa; Benjamin Lawrence,0,0,0,0
1668272048384,CSE 257,A01,102396,Gao; Sicun,0,0,0,0
1668272048827,CSE 272,A00,102397,Li; Tzumao,0,0,0,0
1668272049251,CSE 274,A00,111323,Chern; Albert Ren-Haur,0,0,0,0
1668272049677,CSE 282,A00,102398,Pevzner; Pavel Arkadjevich,0,0,0,0
1668272050105,CSE 284,A00,114175,Gymrek; Melissa Ann,0,0,0,0
1668272050530,CSE 290,A00,102399,Chandraker; Manmohan Krishna,0,0,0,0
1668272050530,CSE 290,B00,102400,Vaccaro; Kristen Marie,0,0,25,25
1668272050530,CSE 290,C00,102414,Pannuto; Patrick William,0,0,25,25
1668272050530,CSE 290,D00,102427,Pevzner; Pavel Arkadjevich,0,0,0,0
1668272050530,CSE 290,E00,102429,Zhao; Jishen,0,0,0,0
1668272050530,CSE 290,F00,102436,Tullsen; Dean Michael,0,0,0,0
1668272050530,CSE 290,G00,102440,Christensen; Henrik I,0,0,20,20
1668272050954,CSE 291,A00,102443,Su; Hao,0,0,0,0
1668272050954,CSE 291,B00,102448,Polikarpova; Nadezhda,0,0,0,0
1668272050954,CSE 291,C00,102453,Vaccaro; Kristen Marie,0,0,0,0
1668272050954,CSE 291,D00,111343,Savage; Stefan,0,0,0,0
1668272050954,CSE 291,E00,116474,Claffy; Kimberly Claire,0,0,0,0
1668272050954,CSE 291,F00,116479,Pasquale; Joseph,0,0,0,0
1668272051386,CSE 293,001,119111,Bafna; Vineet,9999,0,9999,0
1668272051386,CSE 293,002,119118,Bellare; Mihir,9999,0,9999,0
1668272051386,CSE 293,003,119122,Berg-Kirkpatrick; Taylor D,9999,0,9999,0
1668272051386,CSE 293,004,119135,Christensen; Henrik I,9999,0,9999,0
1668272051386,CSE 293,005,119142,Cottrell; Garrison W,9999,0,9999,0
1668272051386,CSE 293,006,119146,Deutsch; Alin Bernard,9999,0,9999,0
1668272051386,CSE 293,007,119159,Esmaeilzadeh; Hadi,9999,0,9999,0
1668272051386,CSE 293,008,119166,Freund; Yoav,9999,0,9999,0
1668272051386,CSE 293,009,119170,Griswold; William G.,9999,0,9999,0
1668272051386,CSE 293,010,119183,Gymrek; Melissa Ann,9999,0,9999,0
1668272051386,CSE 293,011,119190,Heninger; Nadia A,9999,0,9999,0
1668272051386,CSE 293,012,119230,Impagliazzo; Russell,9999,0,9999,0
1668272051386,CSE 293,013,119232,Jhala; Ranjit,9999,0,9999,0
1668272051386,CSE 293,014,119233,Kahng; Andrew Byun,9999,0,9999,0
1668272051386,CSE 293,015,119298,Kane; Daniel Mertz,9999,0,9999,0
1668272051386,CSE 293,016,119299,Kriegman; David J,9999,0,9999,0
1668272051386,CSE 293,017,119300,Kumar; Arun Kumar,9999,0,9999,0
1668272051386,CSE 293,018,119301,Lerner; Sorin,9999,0,9999,0
1668272051386,CSE 293,019,119302,Lovett; Shachar,9999,0,9999,0
1668272051386,CSE 293,020,119303,McAuley; Julian John,9999,0,9999,0
1668272051386,CSE 293,021,119304,Micciancio; Daniele,9999,0,9999,0
1668272051386,CSE 293,022,119367,Orailoglu; Alex,9999,0,9999,0
1668272051386,CSE 293,023,119382,Paturi; Ramamohan,9999,0,9999,0
1668272051386,CSE 293,024,119404,Polikarpova; Nadezhda,9999,0,9999,0
1668272051386,CSE 293,025,119406,Politz; Joseph Gibbs,9999,0,9999,0
1668272051386,CSE 293,026,119411,Porter; George M,9999,0,9999,0
1668272051386,CSE 293,027,119414,Porter; Leonard Emerson,9999,0,9999,0
1668272051386,CSE 293,028,119416,Ramamoorthi; Ravi,9999,0,9999,0
1668272051386,CSE 293,029,119417,Sahoo; Debashis,9999,0,9999,0
1668272051386,CSE 293,030,119420,Saul; Lawrence,9999,0,9999,0
1668272051386,CSE 293,031,119421,Savage; Stefan,9999,0,9999,0
1668272051386,CSE 293,032,119425,Schulze; Jurgen P.,9999,0,9999,0
1668272051386,CSE 293,033,119426,Snoeren; Alex C.,9999,0,9999,0
1668272051386,CSE 293,034,119428,Shang; Jingbo,9999,0,9999,0
1668272051386,CSE 293,035,119430,Stefan; Deian,9999,0,9999,0
1668272051386,CSE 293,036,119431,Su; Hao,9999,0,9999,0
1668272051386,CSE 293,037,119433,Swanson; Steven James,9999,0,9999,0
1668272051386,CSE 293,038,119435,Tullsen; Dean Michael,9999,0,9999,0
1668272051386,CSE 293,039,119483,Voelker; Geoffrey M.,9999,0,9999,0
1668272051386,CSE 293,040,119537,Zhao; Jishen,9999,0,9999,0
1668272051386,CSE 293,041,119538,Zhou; Yuan-Yuan,9999,0,9999,0
1668272051386,CSE 293,042,119539,Gao; Sicun,9999,0,9999,0
1668272051386,CSE 293,043,119540,Weibel; Nadir,9999,0,9999,0
1668272051386,CSE 293,044,119541,Gupta; Rajesh K.,9999,0,9999,0
1668272051386,CSE 293,045,126410,Vaccaro; Kristen Marie,9999,0,9999,0
1668272051386,CSE 293,046,126411,Klemke; Richard,9999,0,9999,0
1668272051810,CSE 294,A00,102459,Voelker; Geoffrey M.,0,0,0,0
1668272051810,CSE 294,B00,111322,Orailoglu; Alex,0,0,0,0
1668272052233,DSE 201,A00,096914,Deutsch; Alin Bernard,30,0,30,0
1668272052661,DSE 210,A00,096915,Dasgupta; Sanjoy,30,0,30,0
1668272053084,DSE 260A,A00,096916,Altintas De Callaf; Ilkay,30,0,30,0
1668272053527,ECE 200,001,103586,Antipa; Nicholas A,9999,0,9999,0
1668272053527,ECE 200,002,103587,Atanasov; Nikolay A.,9999,0,9999,0
1668272053527,ECE 200,003,103588,Bharadia; Dinesh,9999,0,9999,0
1668272053527,ECE 200,004,103589,Cheng; Chung Kuan,9999,0,9999,0
1668272053527,ECE 200,005,103590,Cosman; Pamela C.,9999,0,9999,0
1668272053527,ECE 200,006,103591,Dayeh; Shadi Ahmad,9999,0,9999,0
1668272053527,ECE 200,007,103592,Fainman; Yeshaiahu,9999,0,9999,0
1668272053527,ECE 200,008,103593,Ford; Joseph Earl,9999,0,9999,0
1668272053527,ECE 200,009,103594,Franceschetti; Massimo,9999,0,9999,0
1668272053527,ECE 200,010,103595,Fullerton; Eric E,9999,0,9999,0
1668272053527,ECE 200,011,103596,Galton; Ian A,9999,0,9999,0
1668272053527,ECE 200,012,103597,Gilja; Vikash,9999,0,9999,0
1668272053527,ECE 200,013,103598,Hall; Drew A.,9999,0,9999,0
1668272053527,ECE 200,014,103599,Hsueh; Tzu-Chien,9999,0,9999,0
1668272053527,ECE 200,015,103600,Javidi; Tara,9999,0,9999,0
1668272053527,ECE 200,016,103601,Kahng; Andrew Byun,9999,0,9999,0
1668272053527,ECE 200,017,103602,Kim; Young-Han,9999,0,9999,0
1668272053527,ECE 200,018,103603,Koushanfar; Farinaz,9999,0,9999,0
1668272053527,ECE 200,019,103604,Kuzum; Duygu,9999,0,9999,0
1668272053527,ECE 200,020,103605,Le; Hanh-Phuc,9999,0,9999,0
1668272053527,ECE 200,021,103606,Lin; Bill,9999,0,9999,0
1668272053527,ECE 200,022,103607,Liu; Zhaowei,9998,0,9999,1
1668272053527,ECE 200,023,103608,Lo; Yu-Hwa,9999,0,9999,0
1668272053527,ECE 200,024,103609,Lomakin; Vitaliy,9999,0,9999,0
1668272053527,ECE 200,025,103610,Mercier; Patrick Philip,9999,0,9999,0
1668272053527,ECE 200,026,103611,Meyer; Florian,9999,0,9999,0
1668272053527,ECE 200,027,103612,Milstein; Laurence B.,9999,0,9999,0
1668272053527,ECE 200,028,103613,Mir Arabbaygi; Siavash,9999,0,9999,0
1668272053527,ECE 200,029,103614,Mookherjea; Shayan,9999,0,9999,0
1668272053527,ECE 200,030,103615,Morris; Karcher William,9999,0,9999,0
1668272053527,ECE 200,031,103616,Ng; Tse Nga,9999,0,9999,0
1668272053527,ECE 200,032,103617,Nguyen; Truong Quang,9999,0,9999,0
1668272053527,ECE 200,033,103618,Nomura; Kenji,9999,0,9999,0
1668272053527,ECE 200,034,103619,Orlitsky; Alon,9999,0,9999,0
1668272053527,ECE 200,035,103620,Pal; Piya,9999,0,9999,0
1668272053527,ECE 200,036,103621,Papen; George C.,9999,0,9999,0
1668272053527,ECE 200,037,103622,Radic; Stojan,9999,0,9999,0
1668272053527,ECE 200,038,103623,Rao; Bhaskar D.,9999,0,9999,0
1668272053527,ECE 200,039,103624,Rao; Ramesh R,9999,0,9999,0
1668272053527,ECE 200,040,103625,Rebeiz; Gabriel,9999,0,9999,0
1668272053527,ECE 200,041,103626,Sanford; John R,9999,0,9999,0
1668272053527,ECE 200,042,103627,Siegel; Paul H.,9999,0,9999,0
1668272053527,ECE 200,043,103628,Sievenpiper; Daniel F.,9999,0,9999,0
1668272053527,ECE 200,044,103629,Sworder; David D.,9999,0,9999,0
1668272053527,ECE 200,045,103630,Taur; Yuan,9999,0,9999,0
1668272053527,ECE 200,046,103631,Touri; Behrouz,9999,0,9999,0
1668272053527,ECE 200,047,103632,Trivedi; Mohan M.,9999,0,9999,0
1668272053527,ECE 200,048,103633,Vasconcelos; Nuno,9999,0,9999,0
1668272053527,ECE 200,049,103634,Wang; Xiaolong,9999,0,9999,0
1668272053527,ECE 200,050,103635,Xie; Pengtao,9999,0,9999,0
1668272053527,ECE 200,051,103636,Yip; Michael,9999,0,9999,0
1668272053527,ECE 200,052,103637,Zeger; Kenneth A.,999,0,999,0
1668272053527,ECE 200,053,103638,Zhang; Xinyu,9999,0,9999,0
1668272053527,ECE 200,054,103639,Turakhia; Yatish Girish,9999,0,9999,0
1668272053527,ECE 200,055,103640,Kang; Mingu,9999,0,9999,0
1668272053527,ECE 200,056,103641,Shi; Yuanyuan,9999,0,9999,0
1668272053527,ECE 200,057,103642,Wang; Edward Jay,9999,0,9999,0
1668272053527,ECE 200,058,103643,Zheng; Yang,9999,0,9999,0
1668272053952,ECE 202,A00,103644,Kuzum; Duygu,0,0,0,0
1668272054392,ECE 212BN,A00,103646,Ng; Tse Nga,0,0,0,0
1668272054821,ECE 221,A00,111493,Staff,0,0,0,0
1668272055255,ECE 222B,A00,103647,Lomakin; Vitaliy,0,0,0,0
1668272055696,ECE 230B,A00,103648,Taur; Yuan,0,0,0,0
1668272056131,ECE 238B,A00,103649,Garay; Javier,0,0,0,0
1668272056559,ECE 240B,A00,112900,Fainman; Yeshaiahu,0,0,0,0
1668272056992,ECE 247A,A00,103650,Jokerst; Jesse Vincent,0,0,0,0
1668272057419,ECE 247B,A00,103651,Wang; Joseph,0,0,0,0
1668272057842,ECE 250,A00,103652,Siegel; Paul H.,0,0,0,0
1668272058277,ECE 251A,A00,103654,Rao; Bhaskar D.,0,0,0,0
1668272058714,ECE 257B,A00,103655,Bharadia; Dinesh,0,0,0,0
1668272059137,ECE 258A,A00,103656,Milstein; Laurence B.,0,0,0,0
1668272059563,ECE 260B,A00,103658,Kang; Mingu,0,0,0,0
1668272059993,ECE 264A,A00,103659,Galton; Ian A,0,0,0,0
1668272060419,ECE 265A,A00,103661,Gudem; Prasad S.S.,0,0,0,0
1668272060846,ECE 265D,A00,103662,Gudem; Prasad S.S.,0,0,0,0
1668272061268,ECE 268,A00,103663,Koushanfar; Farinaz,0,0,0,0
1668272061691,ECE 269,A01,103665,Pal; Piya,0,0,0,0
1668272062114,ECE 271B,A00,103666,Vasconcelos; Manuela,0,0,0,0
1668272062539,ECE 276A,A00,103667,Atanasov; Nikolay A.,0,0,0,0
1668272062964,ECE 277,A00,103668,An; Cheolhong,0,0,0,0
1668272063478,ECE 279,A00,117947,Hall; Drew A.,0,0,0,0
1668272064329,ECE 283,A00,103670,Hsueh; Tzu-Chien,0,0,0,0
1668272064768,ECE 284,A00,103671,Turakhia; Yatish Girish,0,0,0,0
1668272065192,ECE 285,A00,103672,Zheng; Yang,0,0,0,0
1668272065192,ECE 285,B00,103673,Sworder; David D.,0,0,0,0
1668272065617,ECE 287,A00,103676,Javidi; Tara,0,0,0,0
1668272066050,MATH 200B,A00,098023,Salehi Golsefidy; Alireza,12,0,15,3
1668272066474,MATH 202B,A00,098024,Rhoades; Brendon Patrick,9,0,15,6
1668272066903,MATH 203B,A00,098025,Oprea; Dragos N.,10,0,15,5
1668272067336,MATH 204B,A00,098026,Sorensen; Claus M,13,0,15,2
1668272067770,MATH 208,A00,098027,Izadi; Elham,7,0,10,3
1668272068195,MATH 209,A00,098028,Pollack; Aaron,10,0,10,0
1668272068630,MATH 211A,A00,112919,Rogalski; Daniel,9,0,10,1
1668272069078,MATH 211B,A00,112920,Seward; Brandon M.,9,0,10,1
1668272069500,MATH 218,A00,098029,Li; Bo,10,0,10,0
1668272069926,MATH 220B,A00,098030,Novak; Jonathan I,11,0,15,4
1668272070357,MATH 221A,A00,098031,Ebenfelt; Peter F,13,0,15,2
1668272070782,MATH 231B,A00,098032,Zlatos; Andrej,12,0,15,3
1668272071205,MATH 240B,A00,098033,Ni; Lei,9,0,15,6
1668272071648,MATH 243,A00,098034,Jekel; David Andrew,10,0,10,0
1668272072072,MATH 245A,A00,098035,Nie; Jiawang,0,0,15,16
1668272072495,MATH 248,A00,098036,Bejenaru; Ioan,10,0,10,0
1668272072918,MATH 250B,A00,098037,Spolaor; Luca,14,0,15,1
1668272073344,MATH 258,A00,098038,Ni; Lei,10,0,10,0
1668272073779,MATH 264B,A00,098041,Rhoades; Brendon Patrick,9,0,15,6
1668272074204,MATH 268,A00,098042,Buss; Samuel R,10,0,10,0
1668272074629,MATH 269,A00,098043,Rhoades; Brendon Patrick,10,0,10,0
1668272075053,MATH 270B,A00,098044,Li; Bo,10,0,15,5
1668272075479,MATH 272B,A00,098045,Holst; Michael J,13,0,15,2
1668272075905,MATH 273A,A00,098046,Tian; Xiaochuan,10,0,15,5
1668272076330,MATH 275,A01,098048,Tian; Xiaochuan,6,0,10,4
1668272076754,MATH 278A,A00,098049,Holst; Michael J,8,0,10,2
1668272077181,MATH 278B,A00,098050,Cloninger; Alexander,10,0,10,0
1668272077620,MATH 278C,A00,098051,Nie; Jiawang,7,0,10,3
1668272078047,MATH 280B,A00,098052,Zheng; Tianyi,9,0,15,6
1668272078472,MATH 281B,A00,098053,Bradic; Jelena,1,0,15,14
1668272078913,MATH 282B,A00,098054,Arias-Castro; Ery,0,0,15,15
1668272079340,MATH 285,A00,098055,Fitzsimmons; Patrick J,0,0,15,17
1668272079771,MATH 287B,A00,098056,Arias-Castro; Ery,2,0,15,13
1668272080194,MATH 288,A00,098057,Agarwal; Pooja,9,0,10,1
1668272080194,MATH 288,B00,098058,Zhang; Danna,8,0,10,2
1668272080194,MATH 288,C00,098059,Williams; Ruth J,10,0,10,0
1668272080621,MATH 290B,A00,098060,Roberts; Justin Deritter,13,0,15,2
1668272081051,MATH 292,A00,098061,Belmont; Eva Kinoshita,10,0,10,0
1668272081484,MATH 295,A00,098062,Suk; Andrew Hoon,48,0,50,2
1668272081913,MATH 296,A00,098063,Novak; Jonathan I,20,0,20,0
1668272082355,MATH 297,001,098064,Gamst; Anthony Collins,9997,0,9999,2
1668272584056,COGS 205,A00,101395,Chiba; Andrea,19,0,20,1
1668272584482,COGS 210B,001,101404,Greene; Deanna Jacquelyn,9998,0,9999,1
1668272584482,COGS 210B,002,101417,Xia; Haijun,9999,0,9999,0
1668272584482,COGS 210B,003,101422,Nitz; Douglas A.,9999,0,9999,0
1668272584482,COGS 210B,004,101423,Hollan; James D.,9998,0,9999,1
1668272584482,COGS 210B,005,101424,Deak; Gedeon O.,9998,0,9999,1
1668272584482,COGS 210B,006,101425,Rossano; Federico,9999,0,9999,0
1668272584908,COGS 211B,A00,101427,Coulson; Seana M,9996,0,9999,3
1668272585445,COGS 220,A00,101428,Hollan; James D.,0,0,25,25
1668272585876,COGS 229,A00,101429,Dow; Steven P,18,0,25,7
1668272586301,COGS 230,A00,101430,Klemmer; Scott R,12,0,17,5
1668272586724,COGS 234,A00,101431,Xia; Haijun,2,0,25,23
1668272587148,COGS 260,A00,101432,Kiyonaga; Anastasia,21,0,25,4
1668272587148,COGS 260,B00,101433,Kirsh; David Joel,15,0,25,10
1668272587575,CSE 202,A00,102371,Impagliazzo; Russell,0,0,0,0
1668272587998,CSE 203B,A01,102373,Cheng; Chung Kuan,0,0,0,0
1668272588438,CSE 208,A00,102374,Micciancio; Daniele,0,0,0,0
1668272588863,CSE 209A,A00,112895,Impagliazzo; Russell,0,0,15,15
1668272589286,CSE 209B,A00,108005,Bellare; Mihir,0,0,0,0
1668272589719,CSE 210,A00,113163,Coblenz; Michael J,0,0,0,0
1668272590155,CSE 219,A00,106111,Dow; Steven P,0,0,20,20
1668272590586,CSE 221,A00,102376,Voelker; Geoffrey M.,0,0,0,0
1668272591017,CSE 224,A01,102378,Porter; George M,0,0,0,0
1668272591441,CSE 229A,A00,102379,Savage; Stefan,0,0,0,0
1668272591868,CSE 229C,A00,102380,Munyaka; Imani N. S.,0,0,0,0
1668272592291,CSE 232B,A00,102382,Deutsch; Alin Bernard,0,0,0,0
1668272592719,CSE 234,A01,112904,Kumar; Arun Kumar,0,0,0,0
1668272593145,CSE 237A,A00,102383,Rosing; Tajana Simunic,0,0,0,0
1668272593567,CSE 239A,A00,102384,Deutsch; Alin Bernard,0,0,0,0
1668272594003,CSE 239B,A00,102385,Polikarpova; Nadezhda,0,0,0,0
1668272594429,CSE 240A,A00,102386,Pannuto; Patrick William,0,0,0,0
1668272594858,CSE 240B,A00,102387,Zhao; Jishen,0,0,0,0
1668272595287,CSE 241A,A00,106406,Kang; Mingu,0,0,0,0
1668272595714,CSE 249B,A00,102388,Kahng; Andrew Byun,0,0,8,8
1668272596140,CSE 251B,A01,102392,Cottrell; Garrison W,0,0,0,0
1668272596140,CSE 251B,A02,102393,Cottrell; Garrison W,0,0,0,0
1668272596564,CSE 252B,A00,102394,Ochoa; Benjamin Lawrence,0,0,0,0
1668272596989,CSE 257,A01,102396,Gao; Sicun,0,0,0,0
1668272597413,CSE 272,A00,102397,Li; Tzumao,0,0,0,0
1668272597843,CSE 274,A00,111323,Chern; Albert Ren-Haur,0,0,0,0
1668272598270,CSE 282,A00,102398,Pevzner; Pavel Arkadjevich,0,0,0,0
1668272598697,CSE 284,A00,114175,Gymrek; Melissa Ann,0,0,0,0
1668272599136,CSE 290,A00,102399,Chandraker; Manmohan Krishna,0,0,0,0
1668272599136,CSE 290,B00,102400,Vaccaro; Kristen Marie,0,0,25,25
1668272599136,CSE 290,C00,102414,Pannuto; Patrick William,0,0,25,25
1668272599136,CSE 290,D00,102427,Pevzner; Pavel Arkadjevich,0,0,0,0
1668272599136,CSE 290,E00,102429,Zhao; Jishen,0,0,0,0
1668272599136,CSE 290,F00,102436,Tullsen; Dean Michael,0,0,0,0
1668272599136,CSE 290,G00,102440,Christensen; Henrik I,0,0,20,20
1668272599574,CSE 291,A00,102443,Su; Hao,0,0,0,0
1668272599574,CSE 291,B00,102448,Polikarpova; Nadezhda,0,0,0,0
1668272599574,CSE 291,C00,102453,Vaccaro; Kristen Marie,0,0,0,0
1668272599574,CSE 291,D00,111343,Savage; Stefan,0,0,0,0
1668272599574,CSE 291,E00,116474,Claffy; Kimberly Claire,0,0,0,0
1668272599574,CSE 291,F00,116479,Pasquale; Joseph,0,0,0,0
1668272600012,CSE 293,001,119111,Bafna; Vineet,9999,0,9999,0
1668272600012,CSE 293,002,119118,Bellare; Mihir,9999,0,9999,0
1668272600012,CSE 293,003,119122,Berg-Kirkpatrick; Taylor D,9999,0,9999,0
1668272600012,CSE 293,004,119135,Christensen; Henrik I,9999,0,9999,0
1668272600012,CSE 293,005,119142,Cottrell; Garrison W,9999,0,9999,0
1668272600012,CSE 293,006,119146,Deutsch; Alin Bernard,9999,0,9999,0
1668272600012,CSE 293,007,119159,Esmaeilzadeh; Hadi,9999,0,9999,0
1668272600012,CSE 293,008,119166,Freund; Yoav,9999,0,9999,0
1668272600012,CSE 293,009,119170,Griswold; William G.,9999,0,9999,0
1668272600012,CSE 293,010,119183,Gymrek; Melissa Ann,9999,0,9999,0
1668272600012,CSE 293,011,119190,Heninger; Nadia A,9999,0,9999,0
1668272600012,CSE 293,012,119230,Impagliazzo; Russell,9999,0,9999,0
1668272600012,CSE 293,013,119232,Jhala; Ranjit,9999,0,9999,0
1668272600012,CSE 293,014,119233,Kahng; Andrew Byun,9999,0,9999,0
1668272600012,CSE 293,015,119298,Kane; Daniel Mertz,9999,0,9999,0
1668272600012,CSE 293,016,119299,Kriegman; David J,9999,0,9999,0
1668272600012,CSE 293,017,119300,Kumar; Arun Kumar,9999,0,9999,0
1668272600012,CSE 293,018,119301,Lerner; Sorin,9999,0,9999,0
1668272600012,CSE 293,019,119302,Lovett; Shachar,9999,0,9999,0
1668272600012,CSE 293,020,119303,McAuley; Julian John,9999,0,9999,0
1668272600012,CSE 293,021,119304,Micciancio; Daniele,9999,0,9999,0
1668272600012,CSE 293,022,119367,Orailoglu; Alex,9999,0,9999,0
1668272600012,CSE 293,023,119382,Paturi; Ramamohan,9999,0,9999,0
1668272600012,CSE 293,024,119404,Polikarpova; Nadezhda,9999,0,9999,0
1668272600012,CSE 293,025,119406,Politz; Joseph Gibbs,9999,0,9999,0
1668272600012,CSE 293,026,119411,Porter; George M,9999,0,9999,0
1668272600012,CSE 293,027,119414,Porter; Leonard Emerson,9999,0,9999,0
1668272600012,CSE 293,028,119416,Ramamoorthi; Ravi,9999,0,9999,0
1668272600012,CSE 293,029,119417,Sahoo; Debashis,9999,0,9999,0
1668272600012,CSE 293,030,119420,Saul; Lawrence,9999,0,9999,0
1668272600012,CSE 293,031,119421,Savage; Stefan,9999,0,9999,0
1668272600012,CSE 293,032,119425,Schulze; Jurgen P.,9999,0,9999,0
1668272600012,CSE 293,033,119426,Snoeren; Alex C.,9999,0,9999,0
1668272600012,CSE 293,034,119428,Shang; Jingbo,9999,0,9999,0
1668272600012,CSE 293,035,119430,Stefan; Deian,9999,0,9999,0
1668272600012,CSE 293,036,119431,Su; Hao,9999,0,9999,0
1668272600012,CSE 293,037,119433,Swanson; Steven James,9999,0,9999,0
1668272600012,CSE 293,038,119435,Tullsen; Dean Michael,9999,0,9999,0
1668272600012,CSE 293,039,119483,Voelker; Geoffrey M.,9999,0,9999,0
1668272600012,CSE 293,040,119537,Zhao; Jishen,9999,0,9999,0
1668272600012,CSE 293,041,119538,Zhou; Yuan-Yuan,9999,0,9999,0
1668272600012,CSE 293,042,119539,Gao; Sicun,9999,0,9999,0
1668272600012,CSE 293,043,119540,Weibel; Nadir,9999,0,9999,0
1668272600012,CSE 293,044,119541,Gupta; Rajesh K.,9999,0,9999,0
1668272600012,CSE 293,045,126410,Vaccaro; Kristen Marie,9999,0,9999,0
1668272600012,CSE 293,046,126411,Klemke; Richard,9999,0,9999,0
1668272600447,CSE 294,A00,102459,Voelker; Geoffrey M.,0,0,0,0
1668272600447,CSE 294,B00,111322,Orailoglu; Alex,0,0,0,0
1668272600885,DSE 201,A00,096914,Deutsch; Alin Bernard,30,0,30,0
1668272601313,DSE 210,A00,096915,Dasgupta; Sanjoy,30,0,30,0
1668272601753,DSE 260A,A00,096916,Altintas De Callaf; Ilkay,30,0,30,0
1668272602226,ECE 200,001,103586,Antipa; Nicholas A,9999,0,9999,0
1668272602226,ECE 200,002,103587,Atanasov; Nikolay A.,9999,0,9999,0
1668272602226,ECE 200,003,103588,Bharadia; Dinesh,9999,0,9999,0
1668272602226,ECE 200,004,103589,Cheng; Chung Kuan,9999,0,9999,0
1668272602226,ECE 200,005,103590,Cosman; Pamela C.,9999,0,9999,0
1668272602226,ECE 200,006,103591,Dayeh; Shadi Ahmad,9999,0,9999,0
1668272602226,ECE 200,007,103592,Fainman; Yeshaiahu,9999,0,9999,0
1668272602226,ECE 200,008,103593,Ford; Joseph Earl,9999,0,9999,0
1668272602226,ECE 200,009,103594,Franceschetti; Massimo,9999,0,9999,0
1668272602226,ECE 200,010,103595,Fullerton; Eric E,9999,0,9999,0
1668272602226,ECE 200,011,103596,Galton; Ian A,9999,0,9999,0
1668272602226,ECE 200,012,103597,Gilja; Vikash,9999,0,9999,0
1668272602226,ECE 200,013,103598,Hall; Drew A.,9999,0,9999,0
1668272602226,ECE 200,014,103599,Hsueh; Tzu-Chien,9999,0,9999,0
1668272602226,ECE 200,015,103600,Javidi; Tara,9999,0,9999,0
1668272602226,ECE 200,016,103601,Kahng; Andrew Byun,9999,0,9999,0
1668272602226,ECE 200,017,103602,Kim; Young-Han,9999,0,9999,0
1668272602226,ECE 200,018,103603,Koushanfar; Farinaz,9999,0,9999,0
1668272602226,ECE 200,019,103604,Kuzum; Duygu,9999,0,9999,0
1668272602226,ECE 200,020,103605,Le; Hanh-Phuc,9999,0,9999,0
1668272602226,ECE 200,021,103606,Lin; Bill,9999,0,9999,0
1668272602226,ECE 200,022,103607,Liu; Zhaowei,9998,0,9999,1
1668272602226,ECE 200,023,103608,Lo; Yu-Hwa,9999,0,9999,0
1668272602226,ECE 200,024,103609,Lomakin; Vitaliy,9999,0,9999,0
1668272602226,ECE 200,025,103610,Mercier; Patrick Philip,9999,0,9999,0
1668272602226,ECE 200,026,103611,Meyer; Florian,9999,0,9999,0
1668272602226,ECE 200,027,103612,Milstein; Laurence B.,9999,0,9999,0
1668272602226,ECE 200,028,103613,Mir Arabbaygi; Siavash,9999,0,9999,0
1668272602226,ECE 200,029,103614,Mookherjea; Shayan,9999,0,9999,0
1668272602226,ECE 200,030,103615,Morris; Karcher William,9999,0,9999,0
1668272602226,ECE 200,031,103616,Ng; Tse Nga,9999,0,9999,0
1668272602226,ECE 200,032,103617,Nguyen; Truong Quang,9999,0,9999,0
1668272602226,ECE 200,033,103618,Nomura; Kenji,9999,0,9999,0
1668272602226,ECE 200,034,103619,Orlitsky; Alon,9999,0,9999,0
1668272602226,ECE 200,035,103620,Pal; Piya,9999,0,9999,0
1668272602226,ECE 200,036,103621,Papen; George C.,9999,0,9999,0
1668272602226,ECE 200,037,103622,Radic; Stojan,9999,0,9999,0
1668272602226,ECE 200,038,103623,Rao; Bhaskar D.,9999,0,9999,0
1668272602226,ECE 200,039,103624,Rao; Ramesh R,9999,0,9999,0
1668272602226,ECE 200,040,103625,Rebeiz; Gabriel,9999,0,9999,0
1668272602226,ECE 200,041,103626,Sanford; John R,9999,0,9999,0
1668272602226,ECE 200,042,103627,Siegel; Paul H.,9999,0,9999,0
1668272602226,ECE 200,043,103628,Sievenpiper; Daniel F.,9999,0,9999,0
1668272602226,ECE 200,044,103629,Sworder; David D.,9999,0,9999,0
1668272602226,ECE 200,045,103630,Taur; Yuan,9999,0,9999,0
1668272602226,ECE 200,046,103631,Touri; Behrouz,9999,0,9999,0
1668272602226,ECE 200,047,103632,Trivedi; Mohan M.,9999,0,9999,0
1668272602226,ECE 200,048,103633,Vasconcelos; Nuno,9999,0,9999,0
1668272602226,ECE 200,049,103634,Wang; Xiaolong,9999,0,9999,0
1668272602226,ECE 200,050,103635,Xie; Pengtao,9999,0,9999,0
1668272602226,ECE 200,051,103636,Yip; Michael,9999,0,9999,0
1668272602226,ECE 200,052,103637,Zeger; Kenneth A.,999,0,999,0
1668272602226,ECE 200,053,103638,Zhang; Xinyu,9999,0,9999,0
1668272602226,ECE 200,054,103639,Turakhia; Yatish Girish,9999,0,9999,0
1668272602226,ECE 200,055,103640,Kang; Mingu,9999,0,9999,0
1668272602226,ECE 200,056,103641,Shi; Yuanyuan,9999,0,9999,0
1668272602226,ECE 200,057,103642,Wang; Edward Jay,9999,0,9999,0
1668272602226,ECE 200,058,103643,Zheng; Yang,9999,0,9999,0
1668272602663,ECE 202,A00,103644,Kuzum; Duygu,0,0,0,0
1668272603099,ECE 212BN,A00,103646,Ng; Tse Nga,0,0,0,0
1668272603525,ECE 221,A00,111493,Staff,0,0,0,0
1668272603948,ECE 222B,A00,103647,Lomakin; Vitaliy,0,0,0,0
1668272604373,ECE 230B,A00,103648,Taur; Yuan,0,0,0,0
1668272604806,ECE 238B,A00,103649,Garay; Javier,0,0,0,0
1668272605240,ECE 240B,A00,112900,Fainman; Yeshaiahu,0,0,0,0
1668272605665,ECE 247A,A00,103650,Jokerst; Jesse Vincent,0,0,0,0
1668272606093,ECE 247B,A00,103651,Wang; Joseph,0,0,0,0
1668272606535,ECE 250,A00,103652,Siegel; Paul H.,0,0,0,0
1668272606960,ECE 251A,A00,103654,Rao; Bhaskar D.,0,0,0,0
1668272607383,ECE 257B,A00,103655,Bharadia; Dinesh,0,0,0,0
1668272607812,ECE 258A,A00,103656,Milstein; Laurence B.,0,0,0,0
1668272608248,ECE 260B,A00,103658,Kang; Mingu,0,0,0,0
1668272608680,ECE 264A,A00,103659,Galton; Ian A,0,0,0,0
1668272609120,ECE 265A,A00,103661,Gudem; Prasad S.S.,0,0,0,0
1668272609542,ECE 265D,A00,103662,Gudem; Prasad S.S.,0,0,0,0
1668272609967,ECE 268,A00,103663,Koushanfar; Farinaz,0,0,0,0
1668272610391,ECE 269,A01,103665,Pal; Piya,0,0,0,0
1668272610817,ECE 271B,A00,103666,Vasconcelos; Manuela,0,0,0,0
1668272611240,ECE 276A,A00,103667,Atanasov; Nikolay A.,0,0,0,0
1668272611681,ECE 277,A00,103668,An; Cheolhong,0,0,0,0
1668272612111,ECE 279,A00,117947,Hall; Drew A.,0,0,0,0
1668272612967,ECE 283,A00,103670,Hsueh; Tzu-Chien,0,0,0,0
1668272613394,ECE 284,A00,103671,Turakhia; Yatish Girish,0,0,0,0
1668272613819,ECE 285,A00,103672,Zheng; Yang,0,0,0,0
1668272613819,ECE 285,B00,103673,Sworder; David D.,0,0,0,0
1668272614250,ECE 287,A00,103676,Javidi; Tara,0,0,0,0
1668272614671,MATH 200B,A00,098023,Salehi Golsefidy; Alireza,12,0,15,3
1668272615109,MATH 202B,A00,098024,Rhoades; Brendon Patrick,9,0,15,6
1668272615533,MATH 203B,A00,098025,Oprea; Dragos N.,10,0,15,5
1668272615959,MATH 204B,A00,098026,Sorensen; Claus M,13,0,15,2
1668272616382,MATH 208,A00,098027,Izadi; Elham,7,0,10,3
1668272616803,MATH 209,A00,098028,Pollack; Aaron,10,0,10,0
1668272617228,MATH 211A,A00,112919,Rogalski; Daniel,9,0,10,1
1668272617659,MATH 211B,A00,112920,Seward; Brandon M.,9,0,10,1
1668272618089,MATH 218,A00,098029,Li; Bo,10,0,10,0
1668272618513,MATH 220B,A00,098030,Novak; Jonathan I,11,0,15,4
1668272618950,MATH 221A,A00,098031,Ebenfelt; Peter F,13,0,15,2
1668272619374,MATH 231B,A00,098032,Zlatos; Andrej,12,0,15,3
1668272619798,MATH 240B,A00,098033,Ni; Lei,9,0,15,6
1668272620222,MATH 243,A00,098034,Jekel; David Andrew,10,0,10,0
1668272620647,MATH 245A,A00,098035,Nie; Jiawang,0,0,15,16
1668272621071,MATH 248,A00,098036,Bejenaru; Ioan,10,0,10,0
1668272621497,MATH 250B,A00,098037,Spolaor; Luca,14,0,15,1
1668272621922,MATH 258,A00,098038,Ni; Lei,10,0,10,0
1668272622348,MATH 264B,A00,098041,Rhoades; Brendon Patrick,9,0,15,6
1668272622772,MATH 268,A00,098042,Buss; Samuel R,10,0,10,0
1668272623196,MATH 269,A00,098043,Rhoades; Brendon Patrick,10,0,10,0
1668272623631,MATH 270B,A00,098044,Li; Bo,10,0,15,5
1668272624056,MATH 272B,A00,098045,Holst; Michael J,13,0,15,2
1668272624483,MATH 273A,A00,098046,Tian; Xiaochuan,10,0,15,5
1668272624910,MATH 275,A01,098048,Tian; Xiaochuan,6,0,10,4
1668272625333,MATH 278A,A00,098049,Holst; Michael J,8,0,10,2
1668272625755,MATH 278B,A00,098050,Cloninger; Alexander,10,0,10,0
1668272626179,MATH 278C,A00,098051,Nie; Jiawang,7,0,10,3
1668272626603,MATH 280B,A00,098052,Zheng; Tianyi,9,0,15,6
1668272627025,MATH 281B,A00,098053,Bradic; Jelena,1,0,15,14
1668272627449,MATH 282B,A00,098054,Arias-Castro; Ery,0,0,15,15
1668272627877,MATH 285,A00,098055,Fitzsimmons; Patrick J,0,0,15,17
1668272628303,MATH 287B,A00,098056,Arias-Castro; Ery,2,0,15,13
1668272628853,MATH 288,A00,098057,Agarwal; Pooja,9,0,10,1
1668272628853,MATH 288,B00,098058,Zhang; Danna,8,0,10,2
1668272628853,MATH 288,C00,098059,Williams; Ruth J,10,0,10,0
1668272629276,MATH 290B,A00,098060,Roberts; Justin Deritter,13,0,15,2
1668272629702,MATH 292,A00,098061,Belmont; Eva Kinoshita,10,0,10,0
1668272630132,MATH 295,A00,098062,Suk; Andrew Hoon,48,0,50,2
1668272630556,MATH 296,A00,098063,Novak; Jonathan I,20,0,20,0
1668272630982,MATH 297,001,098064,Gamst; Anthony Collins,9997,0,9999,2
1668273132720,COGS 205,A00,101395,Chiba; Andrea,19,0,20,1
1668273133143,COGS 210B,001,101404,Greene; Deanna Jacquelyn,9998,0,9999,1
1668273133143,COGS 210B,002,101417,Xia; Haijun,9999,0,9999,0
1668273133143,COGS 210B,003,101422,Nitz; Douglas A.,9999,0,9999,0
1668273133143,COGS 210B,004,101423,Hollan; James D.,9998,0,9999,1
1668273133143,COGS 210B,005,101424,Deak; Gedeon O.,9998,0,9999,1
1668273133143,COGS 210B,006,101425,Rossano; Federico,9999,0,9999,0
1668273133575,COGS 211B,A00,101427,Coulson; Seana M,9996,0,9999,3
1668273134001,COGS 220,A00,101428,Hollan; James D.,0,0,25,25
1668273134434,COGS 229,A00,101429,Dow; Steven P,18,0,25,7
1668273134861,COGS 230,A00,101430,Klemmer; Scott R,12,0,17,5
1668273135296,COGS 234,A00,101431,Xia; Haijun,2,0,25,23
1668273135771,COGS 260,A00,101432,Kiyonaga; Anastasia,21,0,25,4
1668273135771,COGS 260,B00,101433,Kirsh; David Joel,15,0,25,10
1668273136199,CSE 202,A00,102371,Impagliazzo; Russell,0,0,0,0
1668273136621,CSE 203B,A01,102373,Cheng; Chung Kuan,0,0,0,0
1668273137044,CSE 208,A00,102374,Micciancio; Daniele,0,0,0,0
1668273137469,CSE 209A,A00,112895,Impagliazzo; Russell,0,0,15,15
1668273137893,CSE 209B,A00,108005,Bellare; Mihir,0,0,0,0
1668273138326,CSE 210,A00,113163,Coblenz; Michael J,0,0,0,0
1668273138750,CSE 219,A00,106111,Dow; Steven P,0,0,20,20
1668273139183,CSE 221,A00,102376,Voelker; Geoffrey M.,0,0,0,0
1668273139612,CSE 224,A01,102378,Porter; George M,0,0,0,0
1668273140038,CSE 229A,A00,102379,Savage; Stefan,0,0,0,0
1668273140477,CSE 229C,A00,102380,Munyaka; Imani N. S.,0,0,0,0
1668273140915,CSE 232B,A00,102382,Deutsch; Alin Bernard,0,0,0,0
1668273141342,CSE 234,A01,112904,Kumar; Arun Kumar,0,0,0,0
1668273141764,CSE 237A,A00,102383,Rosing; Tajana Simunic,0,0,0,0
1668273142196,CSE 239A,A00,102384,Deutsch; Alin Bernard,0,0,0,0
1668273142631,CSE 239B,A00,102385,Polikarpova; Nadezhda,0,0,0,0
1668273143062,CSE 240A,A00,102386,Pannuto; Patrick William,0,0,0,0
1668273143489,CSE 240B,A00,102387,Zhao; Jishen,0,0,0,0
1668273143924,CSE 241A,A00,106406,Kang; Mingu,0,0,0,0
1668273144352,CSE 249B,A00,102388,Kahng; Andrew Byun,0,0,8,8
1668273144776,CSE 251B,A01,102392,Cottrell; Garrison W,0,0,0,0
1668273144776,CSE 251B,A02,102393,Cottrell; Garrison W,0,0,0,0
1668273145204,CSE 252B,A00,102394,Ochoa; Benjamin Lawrence,0,0,0,0
1668273145629,CSE 257,A01,102396,Gao; Sicun,0,0,0,0
1668273146055,CSE 272,A00,102397,Li; Tzumao,0,0,0,0
1668273146478,CSE 274,A00,111323,Chern; Albert Ren-Haur,0,0,0,0
1668273146917,CSE 282,A00,102398,Pevzner; Pavel Arkadjevich,0,0,0,0
1668273147343,CSE 284,A00,114175,Gymrek; Melissa Ann,0,0,0,0
1668273147771,CSE 290,A00,102399,Chandraker; Manmohan Krishna,0,0,0,0
1668273147771,CSE 290,B00,102400,Vaccaro; Kristen Marie,0,0,25,25
1668273147771,CSE 290,C00,102414,Pannuto; Patrick William,0,0,25,25
1668273147771,CSE 290,D00,102427,Pevzner; Pavel Arkadjevich,0,0,0,0
1668273147771,CSE 290,E00,102429,Zhao; Jishen,0,0,0,0
1668273147771,CSE 290,F00,102436,Tullsen; Dean Michael,0,0,0,0
1668273147771,CSE 290,G00,102440,Christensen; Henrik I,0,0,20,20
1668273148197,CSE 291,A00,102443,Su; Hao,0,0,0,0
1668273148197,CSE 291,B00,102448,Polikarpova; Nadezhda,0,0,0,0
1668273148197,CSE 291,C00,102453,Vaccaro; Kristen Marie,0,0,0,0
1668273148197,CSE 291,D00,111343,Savage; Stefan,0,0,0,0
1668273148197,CSE 291,E00,116474,Claffy; Kimberly Claire,0,0,0,0
1668273148197,CSE 291,F00,116479,Pasquale; Joseph,0,0,0,0
1668273148632,CSE 293,001,119111,Bafna; Vineet,9999,0,9999,0
1668273148632,CSE 293,002,119118,Bellare; Mihir,9999,0,9999,0
1668273148632,CSE 293,003,119122,Berg-Kirkpatrick; Taylor D,9999,0,9999,0
1668273148632,CSE 293,004,119135,Christensen; Henrik I,9999,0,9999,0
1668273148632,CSE 293,005,119142,Cottrell; Garrison W,9999,0,9999,0
1668273148632,CSE 293,006,119146,Deutsch; Alin Bernard,9999,0,9999,0
1668273148632,CSE 293,007,119159,Esmaeilzadeh; Hadi,9999,0,9999,0
1668273148632,CSE 293,008,119166,Freund; Yoav,9999,0,9999,0
1668273148632,CSE 293,009,119170,Griswold; William G.,9999,0,9999,0
1668273148632,CSE 293,010,119183,Gymrek; Melissa Ann,9999,0,9999,0
1668273148632,CSE 293,011,119190,Heninger; Nadia A,9999,0,9999,0
1668273148632,CSE 293,012,119230,Impagliazzo; Russell,9999,0,9999,0
1668273148632,CSE 293,013,119232,Jhala; Ranjit,9999,0,9999,0
1668273148632,CSE 293,014,119233,Kahng; Andrew Byun,9999,0,9999,0
1668273148632,CSE 293,015,119298,Kane; Daniel Mertz,9999,0,9999,0
1668273148632,CSE 293,016,119299,Kriegman; David J,9999,0,9999,0
1668273148632,CSE 293,017,119300,Kumar; Arun Kumar,9999,0,9999,0
1668273148632,CSE 293,018,119301,Lerner; Sorin,9999,0,9999,0
1668273148632,CSE 293,019,119302,Lovett; Shachar,9999,0,9999,0
1668273148632,CSE 293,020,119303,McAuley; Julian John,9999,0,9999,0
1668273148632,CSE 293,021,119304,Micciancio; Daniele,9999,0,9999,0
1668273148632,CSE 293,022,119367,Orailoglu; Alex,9999,0,9999,0
1668273148632,CSE 293,023,119382,Paturi; Ramamohan,9999,0,9999,0
1668273148632,CSE 293,024,119404,Polikarpova; Nadezhda,9999,0,9999,0
1668273148632,CSE 293,025,119406,Politz; Joseph Gibbs,9999,0,9999,0
1668273148632,CSE 293,026,119411,Porter; George M,9999,0,9999,0
1668273148632,CSE 293,027,119414,Porter; Leonard Emerson,9999,0,9999,0
1668273148632,CSE 293,028,119416,Ramamoorthi; Ravi,9999,0,9999,0
1668273148632,CSE 293,029,119417,Sahoo; Debashis,9999,0,9999,0
1668273148632,CSE 293,030,119420,Saul; Lawrence,9999,0,9999,0
1668273148632,CSE 293,031,119421,Savage; Stefan,9999,0,9999,0
1668273148632,CSE 293,032,119425,Schulze; Jurgen P.,9999,0,9999,0
1668273148632,CSE 293,033,119426,Snoeren; Alex C.,9999,0,9999,0
1668273148632,CSE 293,034,119428,Shang; Jingbo,9999,0,9999,0
1668273148632,CSE 293,035,119430,Stefan; Deian,9999,0,9999,0
1668273148632,CSE 293,036,119431,Su; Hao,9999,0,9999,0
1668273148632,CSE 293,037,119433,Swanson; Steven James,9999,0,9999,0
1668273148632,CSE 293,038,119435,Tullsen; Dean Michael,9999,0,9999,0
1668273148632,CSE 293,039,119483,Voelker; Geoffrey M.,9999,0,9999,0
1668273148632,CSE 293,040,119537,Zhao; Jishen,9999,0,9999,0
1668273148632,CSE 293,041,119538,Zhou; Yuan-Yuan,9999,0,9999,0
1668273148632,CSE 293,042,119539,Gao; Sicun,9999,0,9999,0
1668273148632,CSE 293,043,119540,Weibel; Nadir,9999,0,9999,0
1668273148632,CSE 293,044,119541,Gupta; Rajesh K.,9999,0,9999,0
1668273148632,CSE 293,045,126410,Vaccaro; Kristen Marie,9999,0,9999,0
1668273148632,CSE 293,046,126411,Klemke; Richard,9999,0,9999,0
1668273149065,CSE 294,A00,102459,Voelker; Geoffrey M.,0,0,0,0
1668273149065,CSE 294,B00,111322,Orailoglu; Alex,0,0,0,0
1668273149496,DSE 201,A00,096914,Deutsch; Alin Bernard,30,0,30,0
1668273149927,DSE 210,A00,096915,Dasgupta; Sanjoy,30,0,30,0
1668273150354,DSE 260A,A00,096916,Altintas De Callaf; Ilkay,30,0,30,0
1668273150887,ECE 200,001,103586,Antipa; Nicholas A,9999,0,9999,0
1668273150887,ECE 200,002,103587,Atanasov; Nikolay A.,9999,0,9999,0
1668273150887,ECE 200,003,103588,Bharadia; Dinesh,9999,0,9999,0
1668273150887,ECE 200,004,103589,Cheng; Chung Kuan,9999,0,9999,0
1668273150887,ECE 200,005,103590,Cosman; Pamela C.,9999,0,9999,0
1668273150887,ECE 200,006,103591,Dayeh; Shadi Ahmad,9999,0,9999,0
1668273150887,ECE 200,007,103592,Fainman; Yeshaiahu,9999,0,9999,0
1668273150887,ECE 200,008,103593,Ford; Joseph Earl,9999,0,9999,0
1668273150887,ECE 200,009,103594,Franceschetti; Massimo,9999,0,9999,0
1668273150887,ECE 200,010,103595,Fullerton; Eric E,9999,0,9999,0
1668273150887,ECE 200,011,103596,Galton; Ian A,9999,0,9999,0
1668273150887,ECE 200,012,103597,Gilja; Vikash,9999,0,9999,0
1668273150887,ECE 200,013,103598,Hall; Drew A.,9999,0,9999,0
1668273150887,ECE 200,014,103599,Hsueh; Tzu-Chien,9999,0,9999,0
1668273150887,ECE 200,015,103600,Javidi; Tara,9999,0,9999,0
1668273150887,ECE 200,016,103601,Kahng; Andrew Byun,9999,0,9999,0
1668273150887,ECE 200,017,103602,Kim; Young-Han,9999,0,9999,0
1668273150887,ECE 200,018,103603,Koushanfar; Farinaz,9999,0,9999,0
1668273150887,ECE 200,019,103604,Kuzum; Duygu,9999,0,9999,0
1668273150887,ECE 200,020,103605,Le; Hanh-Phuc,9999,0,9999,0
1668273150887,ECE 200,021,103606,Lin; Bill,9999,0,9999,0
1668273150887,ECE 200,022,103607,Liu; Zhaowei,9998,0,9999,1
1668273150887,ECE 200,023,103608,Lo; Yu-Hwa,9999,0,9999,0
1668273150887,ECE 200,024,103609,Lomakin; Vitaliy,9999,0,9999,0
1668273150887,ECE 200,025,103610,Mercier; Patrick Philip,9999,0,9999,0
1668273150887,ECE 200,026,103611,Meyer; Florian,9999,0,9999,0
1668273150887,ECE 200,027,103612,Milstein; Laurence B.,9999,0,9999,0
1668273150887,ECE 200,028,103613,Mir Arabbaygi; Siavash,9999,0,9999,0
1668273150887,ECE 200,029,103614,Mookherjea; Shayan,9999,0,9999,0
1668273150887,ECE 200,030,103615,Morris; Karcher William,9999,0,9999,0
1668273150887,ECE 200,031,103616,Ng; Tse Nga,9999,0,9999,0
1668273150887,ECE 200,032,103617,Nguyen; Truong Quang,9999,0,9999,0
1668273150887,ECE 200,033,103618,Nomura; Kenji,9999,0,9999,0
1668273150887,ECE 200,034,103619,Orlitsky; Alon,9999,0,9999,0
1668273150887,ECE 200,035,103620,Pal; Piya,9999,0,9999,0
1668273150887,ECE 200,036,103621,Papen; George C.,9999,0,9999,0
1668273150887,ECE 200,037,103622,Radic; Stojan,9999,0,9999,0
1668273150887,ECE 200,038,103623,Rao; Bhaskar D.,9999,0,9999,0
1668273150887,ECE 200,039,103624,Rao; Ramesh R,9999,0,9999,0
1668273150887,ECE 200,040,103625,Rebeiz; Gabriel,9999,0,9999,0
1668273150887,ECE 200,041,103626,Sanford; John R,9999,0,9999,0
1668273150887,ECE 200,042,103627,Siegel; Paul H.,9999,0,9999,0
1668273150887,ECE 200,043,103628,Sievenpiper; Daniel F.,9999,0,9999,0
1668273150887,ECE 200,044,103629,Sworder; David D.,9999,0,9999,0
1668273150887,ECE 200,045,103630,Taur; Yuan,9999,0,9999,0
1668273150887,ECE 200,046,103631,Touri; Behrouz,9999,0,9999,0
1668273150887,ECE 200,047,103632,Trivedi; Mohan M.,9999,0,9999,0
1668273150887,ECE 200,048,103633,Vasconcelos; Nuno,9999,0,9999,0
1668273150887,ECE 200,049,103634,Wang; Xiaolong,9999,0,9999,0
1668273150887,ECE 200,050,103635,Xie; Pengtao,9999,0,9999,0
1668273150887,ECE 200,051,103636,Yip; Michael,9999,0,9999,0
1668273150887,ECE 200,052,103637,Zeger; Kenneth A.,999,0,999,0
1668273150887,ECE 200,053,103638,Zhang; Xinyu,9999,0,9999,0
1668273150887,ECE 200,054,103639,Turakhia; Yatish Girish,9999,0,9999,0
1668273150887,ECE 200,055,103640,Kang; Mingu,9999,0,9999,0
1668273150887,ECE 200,056,103641,Shi; Yuanyuan,9999,0,9999,0
1668273150887,ECE 200,057,103642,Wang; Edward Jay,9999,0,9999,0
1668273150887,ECE 200,058,103643,Zheng; Yang,9999,0,9999,0
1668273151313,ECE 202,A00,103644,Kuzum; Duygu,0,0,0,0
1668273151741,ECE 212BN,A00,103646,Ng; Tse Nga,0,0,0,0
1668273152169,ECE 221,A00,111493,Staff,0,0,0,0
1668273152595,ECE 222B,A00,103647,Lomakin; Vitaliy,0,0,0,0
1668273153031,ECE 230B,A00,103648,Taur; Yuan,0,0,0,0
1668273153466,ECE 238B,A00,103649,Garay; Javier,0,0,0,0
1668273153903,ECE 240B,A00,112900,Fainman; Yeshaiahu,0,0,0,0
1668273154327,ECE 247A,A00,103650,Jokerst; Jesse Vincent,0,0,0,0
1668273154751,ECE 247B,A00,103651,Wang; Joseph,0,0,0,0
1668273155177,ECE 250,A00,103652,Siegel; Paul H.,0,0,0,0
1668273155601,ECE 251A,A00,103654,Rao; Bhaskar D.,0,0,0,0
1668273156028,ECE 257B,A00,103655,Bharadia; Dinesh,0,0,0,0
1668273156451,ECE 258A,A00,103656,Milstein; Laurence B.,0,0,0,0
1668273156874,ECE 260B,A00,103658,Kang; Mingu,0,0,0,0
1668273157299,ECE 264A,A00,103659,Galton; Ian A,0,0,0,0
1668273157733,ECE 265A,A00,103661,Gudem; Prasad S.S.,0,0,0,0
1668273158158,ECE 265D,A00,103662,Gudem; Prasad S.S.,0,0,0,0
1668273158580,ECE 268,A00,103663,Koushanfar; Farinaz,0,0,0,0
1668273159013,ECE 269,A01,103665,Pal; Piya,0,0,0,0
1668273159438,ECE 271B,A00,103666,Vasconcelos; Manuela,0,0,0,0
1668273159868,ECE 276A,A00,103667,Atanasov; Nikolay A.,0,0,0,0
1668273160307,ECE 277,A00,103668,An; Cheolhong,0,0,0,0
1668273160751,ECE 279,A00,117947,Hall; Drew A.,0,0,0,0
1668273161615,ECE 283,A00,103670,Hsueh; Tzu-Chien,0,0,0,0
1668273162038,ECE 284,A00,103671,Turakhia; Yatish Girish,0,0,0,0
1668273162472,ECE 285,A00,103672,Zheng; Yang,0,0,0,0
1668273162472,ECE 285,B00,103673,Sworder; David D.,0,0,0,0
1668273162896,ECE 287,A00,103676,Javidi; Tara,0,0,0,0
1668273163350,MATH 200B,A00,098023,Salehi Golsefidy; Alireza,12,0,15,3
1668273163774,MATH 202B,A00,098024,Rhoades; Brendon Patrick,9,0,15,6
1668273164197,MATH 203B,A00,098025,Oprea; Dragos N.,10,0,15,5
1668273164635,MATH 204B,A00,098026,Sorensen; Claus M,13,0,15,2
1668273165078,MATH 208,A00,098027,Izadi; Elham,7,0,10,3
1668273165503,MATH 209,A00,098028,Pollack; Aaron,10,0,10,0
1668273165940,MATH 211A,A00,112919,Rogalski; Daniel,9,0,10,1
1668273166379,MATH 211B,A00,112920,Seward; Brandon M.,9,0,10,1
1668273166810,MATH 218,A00,098029,Li; Bo,10,0,10,0
1668273167234,MATH 220B,A00,098030,Novak; Jonathan I,11,0,15,4
1668273167667,MATH 221A,A00,098031,Ebenfelt; Peter F,13,0,15,2
1668273168106,MATH 231B,A00,098032,Zlatos; Andrej,12,0,15,3
1668273168528,MATH 240B,A00,098033,Ni; Lei,9,0,15,6
1668273168953,MATH 243,A00,098034,Jekel; David Andrew,10,0,10,0
1668273169376,MATH 245A,A00,098035,Nie; Jiawang,0,0,15,16
1668273169799,MATH 248,A00,098036,Bejenaru; Ioan,10,0,10,0
1668273170225,MATH 250B,A00,098037,Spolaor; Luca,14,0,15,1
1668273170648,MATH 258,A00,098038,Ni; Lei,10,0,10,0
1668273171083,MATH 264B,A00,098041,Rhoades; Brendon Patrick,9,0,15,6
1668273171512,MATH 268,A00,098042,Buss; Samuel R,10,0,10,0
1668273171941,MATH 269,A00,098043,Rhoades; Brendon Patrick,10,0,10,0
1668273172369,MATH 270B,A00,098044,Li; Bo,10,0,15,5
1668273172799,MATH 272B,A00,098045,Holst; Michael J,13,0,15,2
1668273173234,MATH 273A,A00,098046,Tian; Xiaochuan,10,0,15,5
1668273173657,MATH 275,A01,098048,Tian; Xiaochuan,6,0,10,4
1668273174081,MATH 278A,A00,098049,Holst; Michael J,8,0,10,2
1668273174503,MATH 278B,A00,098050,Cloninger; Alexander,10,0,10,0
1668273174927,MATH 278C,A00,098051,Nie; Jiawang,7,0,10,3
1668273175354,MATH 280B,A00,098052,Zheng; Tianyi,9,0,15,6
1668273175779,MATH 281B,A00,098053,Bradic; Jelena,1,0,15,14
1668273176206,MATH 282B,A00,098054,Arias-Castro; Ery,0,0,15,15
1668273176633,MATH 285,A00,098055,Fitzsimmons; Patrick J,0,0,15,17
1668273177056,MATH 287B,A00,098056,Arias-Castro; Ery,2,0,15,13
1668273177479,MATH 288,A00,098057,Agarwal; Pooja,9,0,10,1
1668273177479,MATH 288,B00,098058,Zhang; Danna,8,0,10,2
1668273177479,MATH 288,C00,098059,Williams; Ruth J,10,0,10,0
1668273177903,MATH 290B,A00,098060,Roberts; Justin Deritter,13,0,15,2
1668273178341,MATH 292,A00,098061,Belmont; Eva Kinoshita,10,0,10,0
1668273178776,MATH 295,A00,098062,Suk; Andrew Hoon,48,0,50,2
1668273179218,MATH 296,A00,098063,Novak; Jonathan I,20,0,20,0
1668273179651,MATH 297,001,098064,Gamst; Anthony Collins,9997,0,9999,2
1668273680880,COGS 205,A00,101395,Chiba; Andrea,19,0,20,1
1668273681309,COGS 210B,001,101404,Greene; Deanna Jacquelyn,9998,0,9999,1
1668273681309,COGS 210B,002,101417,Xia; Haijun,9999,0,9999,0
1668273681309,COGS 210B,003,101422,Nitz; Douglas A.,9999,0,9999,0
1668273681309,COGS 210B,004,101423,Hollan; James D.,9998,0,9999,1
1668273681309,COGS 210B,005,101424,Deak; Gedeon O.,9998,0,9999,1
1668273681309,COGS 210B,006,101425,Rossano; Federico,9999,0,9999,0
1668273681733,COGS 211B,A00,101427,Coulson; Seana M,9996,0,9999,3
1668273682156,COGS 220,A00,101428,Hollan; James D.,0,0,25,25
1668273682580,COGS 229,A00,101429,Dow; Steven P,18,0,25,7
1668273683003,COGS 230,A00,101430,Klemmer; Scott R,12,0,17,5
1668273683429,COGS 234,A00,101431,Xia; Haijun,2,0,25,23
1668273683852,COGS 260,A00,101432,Kiyonaga; Anastasia,21,0,25,4
1668273683852,COGS 260,B00,101433,Kirsh; David Joel,15,0,25,10
1668273684276,CSE 202,A00,102371,Impagliazzo; Russell,0,0,0,0
1668273684700,CSE 203B,A01,102373,Cheng; Chung Kuan,0,0,0,0
1668273685126,CSE 208,A00,102374,Micciancio; Daniele,0,0,0,0
1668273685548,CSE 209A,A00,112895,Impagliazzo; Russell,0,0,15,15
1668273685974,CSE 209B,A00,108005,Bellare; Mihir,0,0,0,0
1668273686407,CSE 210,A00,113163,Coblenz; Michael J,0,0,0,0
1668273686832,CSE 219,A00,106111,Dow; Steven P,0,0,20,20
1668273687255,CSE 221,A00,102376,Voelker; Geoffrey M.,0,0,0,0
1668273687680,CSE 224,A01,102378,Porter; George M,0,0,0,0
1668273688104,CSE 229A,A00,102379,Savage; Stefan,0,0,0,0
1668273688531,CSE 229C,A00,102380,Munyaka; Imani N. S.,0,0,0,0
1668273688957,CSE 232B,A00,102382,Deutsch; Alin Bernard,0,0,0,0
1668273689382,CSE 234,A01,112904,Kumar; Arun Kumar,0,0,0,0
1668273689807,CSE 237A,A00,102383,Rosing; Tajana Simunic,0,0,0,0
1668273690231,CSE 239A,A00,102384,Deutsch; Alin Bernard,0,0,0,0
1668273690655,CSE 239B,A00,102385,Polikarpova; Nadezhda,0,0,0,0
1668273691079,CSE 240A,A00,102386,Pannuto; Patrick William,0,0,0,0
1668273691505,CSE 240B,A00,102387,Zhao; Jishen,0,0,0,0
1668273691928,CSE 241A,A00,106406,Kang; Mingu,0,0,0,0
1668273692351,CSE 249B,A00,102388,Kahng; Andrew Byun,0,0,8,8
1668273692775,CSE 251B,A01,102392,Cottrell; Garrison W,0,0,0,0
1668273692775,CSE 251B,A02,102393,Cottrell; Garrison W,0,0,0,0
1668273693199,CSE 252B,A00,102394,Ochoa; Benjamin Lawrence,0,0,0,0
1668273693625,CSE 257,A01,102396,Gao; Sicun,0,0,0,0
1668273694054,CSE 272,A00,102397,Li; Tzumao,0,0,0,0
1668273694479,CSE 274,A00,111323,Chern; Albert Ren-Haur,0,0,0,0
1668273694903,CSE 282,A00,102398,Pevzner; Pavel Arkadjevich,0,0,0,0
1668273695325,CSE 284,A00,114175,Gymrek; Melissa Ann,0,0,0,0
1668273695750,CSE 290,A00,102399,Chandraker; Manmohan Krishna,0,0,0,0
1668273695750,CSE 290,B00,102400,Vaccaro; Kristen Marie,0,0,25,25
1668273695750,CSE 290,C00,102414,Pannuto; Patrick William,0,0,25,25
1668273695750,CSE 290,D00,102427,Pevzner; Pavel Arkadjevich,0,0,0,0
1668273695750,CSE 290,E00,102429,Zhao; Jishen,0,0,0,0
1668273695750,CSE 290,F00,102436,Tullsen; Dean Michael,0,0,0,0
1668273695750,CSE 290,G00,102440,Christensen; Henrik I,0,0,20,20
1668273696174,CSE 291,A00,102443,Su; Hao,0,0,0,0
1668273696174,CSE 291,B00,102448,Polikarpova; Nadezhda,0,0,0,0
1668273696174,CSE 291,C00,102453,Vaccaro; Kristen Marie,0,0,0,0
1668273696174,CSE 291,D00,111343,Savage; Stefan,0,0,0,0
1668273696174,CSE 291,E00,116474,Claffy; Kimberly Claire,0,0,0,0
1668273696174,CSE 291,F00,116479,Pasquale; Joseph,0,0,0,0
1668273696628,CSE 293,001,119111,Bafna; Vineet,9999,0,9999,0
1668273696628,CSE 293,002,119118,Bellare; Mihir,9999,0,9999,0
1668273696628,CSE 293,003,119122,Berg-Kirkpatrick; Taylor D,9999,0,9999,0
1668273696628,CSE 293,004,119135,Christensen; Henrik I,9999,0,9999,0
1668273696628,CSE 293,005,119142,Cottrell; Garrison W,9999,0,9999,0
1668273696628,CSE 293,006,119146,Deutsch; Alin Bernard,9999,0,9999,0
1668273696628,CSE 293,007,119159,Esmaeilzadeh; Hadi,9999,0,9999,0
1668273696628,CSE 293,008,119166,Freund; Yoav,9999,0,9999,0
1668273696628,CSE 293,009,119170,Griswold; William G.,9999,0,9999,0
1668273696628,CSE 293,010,119183,Gymrek; Melissa Ann,9999,0,9999,0
1668273696628,CSE 293,011,119190,Heninger; Nadia A,9999,0,9999,0
1668273696628,CSE 293,012,119230,Impagliazzo; Russell,9999,0,9999,0
1668273696628,CSE 293,013,119232,Jhala; Ranjit,9999,0,9999,0
1668273696628,CSE 293,014,119233,Kahng; Andrew Byun,9999,0,9999,0
1668273696628,CSE 293,015,119298,Kane; Daniel Mertz,9999,0,9999,0
1668273696628,CSE 293,016,119299,Kriegman; David J,9999,0,9999,0
1668273696628,CSE 293,017,119300,Kumar; Arun Kumar,9999,0,9999,0
1668273696628,CSE 293,018,119301,Lerner; Sorin,9999,0,9999,0
1668273696628,CSE 293,019,119302,Lovett; Shachar,9999,0,9999,0
1668273696628,CSE 293,020,119303,McAuley; Julian John,9999,0,9999,0
1668273696628,CSE 293,021,119304,Micciancio; Daniele,9999,0,9999,0
1668273696628,CSE 293,022,119367,Orailoglu; Alex,9999,0,9999,0
1668273696628,CSE 293,023,119382,Paturi; Ramamohan,9999,0,9999,0
1668273696628,CSE 293,024,119404,Polikarpova; Nadezhda,9999,0,9999,0
1668273696628,CSE 293,025,119406,Politz; Joseph Gibbs,9999,0,9999,0
1668273696628,CSE 293,026,119411,Porter; George M,9999,0,9999,0
1668273696628,CSE 293,027,119414,Porter; Leonard Emerson,9999,0,9999,0
1668273696628,CSE 293,028,119416,Ramamoorthi; Ravi,9999,0,9999,0
1668273696628,CSE 293,029,119417,Sahoo; Debashis,9999,0,9999,0
1668273696628,CSE 293,030,119420,Saul; Lawrence,9999,0,9999,0
1668273696628,CSE 293,031,119421,Savage; Stefan,9999,0,9999,0
1668273696628,CSE 293,032,119425,Schulze; Jurgen P.,9999,0,9999,0
1668273696628,CSE 293,033,119426,Snoeren; Alex C.,9999,0,9999,0
1668273696628,CSE 293,034,119428,Shang; Jingbo,9999,0,9999,0
1668273696628,CSE 293,035,119430,Stefan; Deian,9999,0,9999,0
1668273696628,CSE 293,036,119431,Su; Hao,9999,0,9999,0
1668273696628,CSE 293,037,119433,Swanson; Steven James,9999,0,9999,0
1668273696628,CSE 293,038,119435,Tullsen; Dean Michael,9999,0,9999,0
1668273696628,CSE 293,039,119483,Voelker; Geoffrey M.,9999,0,9999,0
1668273696628,CSE 293,040,119537,Zhao; Jishen,9999,0,9999,0
1668273696628,CSE 293,041,119538,Zhou; Yuan-Yuan,9999,0,9999,0
1668273696628,CSE 293,042,119539,Gao; Sicun,9999,0,9999,0
1668273696628,CSE 293,043,119540,Weibel; Nadir,9999,0,9999,0
1668273696628,CSE 293,044,119541,Gupta; Rajesh K.,9999,0,9999,0
1668273696628,CSE 293,045,126410,Vaccaro; Kristen Marie,9999,0,9999,0
1668273696628,CSE 293,046,126411,Klemke; Richard,9999,0,9999,0
1668273697054,CSE 294,A00,102459,Voelker; Geoffrey M.,0,0,0,0
1668273697054,CSE 294,B00,111322,Orailoglu; Alex,0,0,0,0
1668273697479,DSE 201,A00,096914,Deutsch; Alin Bernard,30,0,30,0
1668273697920,DSE 210,A00,096915,Dasgupta; Sanjoy,30,0,30,0
1668273698343,DSE 260A,A00,096916,Altintas De Callaf; Ilkay,30,0,30,0
1668273698770,ECE 200,001,103586,Antipa; Nicholas A,9999,0,9999,0
1668273698770,ECE 200,002,103587,Atanasov; Nikolay A.,9999,0,9999,0
1668273698770,ECE 200,003,103588,Bharadia; Dinesh,9999,0,9999,0
1668273698770,ECE 200,004,103589,Cheng; Chung Kuan,9999,0,9999,0
1668273698770,ECE 200,005,103590,Cosman; Pamela C.,9999,0,9999,0
1668273698770,ECE 200,006,103591,Dayeh; Shadi Ahmad,9999,0,9999,0
1668273698770,ECE 200,007,103592,Fainman; Yeshaiahu,9999,0,9999,0
1668273698770,ECE 200,008,103593,Ford; Joseph Earl,9999,0,9999,0
1668273698770,ECE 200,009,103594,Franceschetti; Massimo,9999,0,9999,0
1668273698770,ECE 200,010,103595,Fullerton; Eric E,9999,0,9999,0
1668273698770,ECE 200,011,103596,Galton; Ian A,9999,0,9999,0
1668273698770,ECE 200,012,103597,Gilja; Vikash,9999,0,9999,0
1668273698770,ECE 200,013,103598,Hall; Drew A.,9999,0,9999,0
1668273698770,ECE 200,014,103599,Hsueh; Tzu-Chien,9999,0,9999,0
1668273698770,ECE 200,015,103600,Javidi; Tara,9999,0,9999,0
1668273698770,ECE 200,016,103601,Kahng; Andrew Byun,9999,0,9999,0
1668273698770,ECE 200,017,103602,Kim; Young-Han,9999,0,9999,0
1668273698770,ECE 200,018,103603,Koushanfar; Farinaz,9999,0,9999,0
1668273698770,ECE 200,019,103604,Kuzum; Duygu,9999,0,9999,0
1668273698770,ECE 200,020,103605,Le; Hanh-Phuc,9999,0,9999,0
1668273698770,ECE 200,021,103606,Lin; Bill,9999,0,9999,0
1668273698770,ECE 200,022,103607,Liu; Zhaowei,9998,0,9999,1
1668273698770,ECE 200,023,103608,Lo; Yu-Hwa,9999,0,9999,0
1668273698770,ECE 200,024,103609,Lomakin; Vitaliy,9999,0,9999,0
1668273698770,ECE 200,025,103610,Mercier; Patrick Philip,9999,0,9999,0
1668273698770,ECE 200,026,103611,Meyer; Florian,9999,0,9999,0
1668273698770,ECE 200,027,103612,Milstein; Laurence B.,9999,0,9999,0
1668273698770,ECE 200,028,103613,Mir Arabbaygi; Siavash,9999,0,9999,0
1668273698770,ECE 200,029,103614,Mookherjea; Shayan,9999,0,9999,0
1668273698770,ECE 200,030,103615,Morris; Karcher William,9999,0,9999,0
1668273698770,ECE 200,031,103616,Ng; Tse Nga,9999,0,9999,0
1668273698770,ECE 200,032,103617,Nguyen; Truong Quang,9999,0,9999,0
1668273698770,ECE 200,033,103618,Nomura; Kenji,9999,0,9999,0
1668273698770,ECE 200,034,103619,Orlitsky; Alon,9999,0,9999,0
1668273698770,ECE 200,035,103620,Pal; Piya,9999,0,9999,0
1668273698770,ECE 200,036,103621,Papen; George C.,9999,0,9999,0
1668273698770,ECE 200,037,103622,Radic; Stojan,9999,0,9999,0
1668273698770,ECE 200,038,103623,Rao; Bhaskar D.,9999,0,9999,0
1668273698770,ECE 200,039,103624,Rao; Ramesh R,9999,0,9999,0
1668273698770,ECE 200,040,103625,Rebeiz; Gabriel,9999,0,9999,0
1668273698770,ECE 200,041,103626,Sanford; John R,9999,0,9999,0
1668273698770,ECE 200,042,103627,Siegel; Paul H.,9999,0,9999,0
1668273698770,ECE 200,043,103628,Sievenpiper; Daniel F.,9999,0,9999,0
1668273698770,ECE 200,044,103629,Sworder; David D.,9999,0,9999,0
1668273698770,ECE 200,045,103630,Taur; Yuan,9999,0,9999,0
1668273698770,ECE 200,046,103631,Touri; Behrouz,9999,0,9999,0
1668273698770,ECE 200,047,103632,Trivedi; Mohan M.,9999,0,9999,0
1668273698770,ECE 200,048,103633,Vasconcelos; Nuno,9999,0,9999,0
1668273698770,ECE 200,049,103634,Wang; Xiaolong,9999,0,9999,0
1668273698770,ECE 200,050,103635,Xie; Pengtao,9999,0,9999,0
1668273698770,ECE 200,051,103636,Yip; Michael,9999,0,9999,0
1668273698770,ECE 200,052,103637,Zeger; Kenneth A.,999,0,999,0
1668273698770,ECE 200,053,103638,Zhang; Xinyu,9999,0,9999,0
1668273698770,ECE 200,054,103639,Turakhia; Yatish Girish,9999,0,9999,0
1668273698770,ECE 200,055,103640,Kang; Mingu,9999,0,9999,0
1668273698770,ECE 200,056,103641,Shi; Yuanyuan,9999,0,9999,0
1668273698770,ECE 200,057,103642,Wang; Edward Jay,9999,0,9999,0
1668273698770,ECE 200,058,103643,Zheng; Yang,9999,0,9999,0
1668273699195,ECE 202,A00,103644,Kuzum; Duygu,0,0,0,0
1668273699622,ECE 212BN,A00,103646,Ng; Tse Nga,0,0,0,0
1668273700060,ECE 221,A00,111493,Staff,0,0,0,0
1668273700487,ECE 222B,A00,103647,Lomakin; Vitaliy,0,0,0,0
1668273700913,ECE 230B,A00,103648,Taur; Yuan,0,0,0,0
1668273701340,ECE 238B,A00,103649,Garay; Javier,0,0,0,0
1668273701770,ECE 240B,A00,112900,Fainman; Yeshaiahu,0,0,0,0
1668273702197,ECE 247A,A00,103650,Jokerst; Jesse Vincent,0,0,0,0
1668273702636,ECE 247B,A00,103651,Wang; Joseph,0,0,0,0
1668273703067,ECE 250,A00,103652,Siegel; Paul H.,0,0,0,0
1668273703492,ECE 251A,A00,103654,Rao; Bhaskar D.,0,0,0,0
1668273703918,ECE 257B,A00,103655,Bharadia; Dinesh,0,0,0,0
1668273704352,ECE 258A,A00,103656,Milstein; Laurence B.,0,0,0,0
1668273704776,ECE 260B,A00,103658,Kang; Mingu,0,0,0,0
1668273705202,ECE 264A,A00,103659,Galton; Ian A,0,0,0,0
1668273705627,ECE 265A,A00,103661,Gudem; Prasad S.S.,0,0,0,0
1668273706054,ECE 265D,A00,103662,Gudem; Prasad S.S.,0,0,0,0
1668273706479,ECE 268,A00,103663,Koushanfar; Farinaz,0,0,0,0
1668273706905,ECE 269,A01,103665,Pal; Piya,0,0,0,0
1668273707334,ECE 271B,A00,103666,Vasconcelos; Manuela,0,0,0,0
1668273707759,ECE 276A,A00,103667,Atanasov; Nikolay A.,0,0,0,0
1668273708182,ECE 277,A00,103668,An; Cheolhong,0,0,0,0
1668273708604,ECE 279,A00,117947,Hall; Drew A.,0,0,0,0
1668273709458,ECE 283,A00,103670,Hsueh; Tzu-Chien,0,0,0,0
1668273709888,ECE 284,A00,103671,Turakhia; Yatish Girish,0,0,0,0
1668273710315,ECE 285,A00,103672,Zheng; Yang,0,0,0,0
1668273710315,ECE 285,B00,103673,Sworder; David D.,0,0,0,0
1668273710752,ECE 287,A00,103676,Javidi; Tara,0,0,0,0
1668273711176,MATH 200B,A00,098023,Salehi Golsefidy; Alireza,12,0,15,3
1668273711599,MATH 202B,A00,098024,Rhoades; Brendon Patrick,9,0,15,6
1668273712023,MATH 203B,A00,098025,Oprea; Dragos N.,10,0,15,5
1668273712458,MATH 204B,A00,098026,Sorensen; Claus M,13,0,15,2
1668273712884,MATH 208,A00,098027,Izadi; Elham,7,0,10,3
1668273713310,MATH 209,A00,098028,Pollack; Aaron,10,0,10,0
1668273713733,MATH 211A,A00,112919,Rogalski; Daniel,9,0,10,1
1668273714166,MATH 211B,A00,112920,Seward; Brandon M.,9,0,10,1
1668273714597,MATH 218,A00,098029,Li; Bo,10,0,10,0
1668273715024,MATH 220B,A00,098030,Novak; Jonathan I,11,0,15,4
1668273715541,MATH 221A,A00,098031,Ebenfelt; Peter F,13,0,15,2
1668273715968,MATH 231B,A00,098032,Zlatos; Andrej,12,0,15,3
1668273716390,MATH 240B,A00,098033,Ni; Lei,9,0,15,6
1668273716812,MATH 243,A00,098034,Jekel; David Andrew,10,0,10,0
1668273717236,MATH 245A,A00,098035,Nie; Jiawang,0,0,15,16
1668273717659,MATH 248,A00,098036,Bejenaru; Ioan,10,0,10,0
1668273718081,MATH 250B,A00,098037,Spolaor; Luca,14,0,15,1
1668273718505,MATH 258,A00,098038,Ni; Lei,10,0,10,0
1668273718929,MATH 264B,A00,098041,Rhoades; Brendon Patrick,9,0,15,6
1668273719351,MATH 268,A00,098042,Buss; Samuel R,10,0,10,0
1668273719776,MATH 269,A00,098043,Rhoades; Brendon Patrick,10,0,10,0
1668273720199,MATH 270B,A00,098044,Li; Bo,10,0,15,5
1668273720634,MATH 272B,A00,098045,Holst; Michael J,13,0,15,2
1668273721060,MATH 273A,A00,098046,Tian; Xiaochuan,10,0,15,5
1668273721484,MATH 275,A01,098048,Tian; Xiaochuan,6,0,10,4
1668273721907,MATH 278A,A00,098049,Holst; Michael J,8,0,10,2
1668273722334,MATH 278B,A00,098050,Cloninger; Alexander,10,0,10,0
1668273722758,MATH 278C,A00,098051,Nie; Jiawang,7,0,10,3
1668273723183,MATH 280B,A00,098052,Zheng; Tianyi,9,0,15,6
1668273723607,MATH 281B,A00,098053,Bradic; Jelena,1,0,15,14
1668273724030,MATH 282B,A00,098054,Arias-Castro; Ery,0,0,15,15
1668273724456,MATH 285,A00,098055,Fitzsimmons; Patrick J,0,0,15,17
1668273724887,MATH 287B,A00,098056,Arias-Castro; Ery,2,0,15,13
1668273725313,MATH 288,A00,098057,Agarwal; Pooja,9,0,10,1
1668273725313,MATH 288,B00,098058,Zhang; Danna,8,0,10,2
1668273725313,MATH 288,C00,098059,Williams; Ruth J,10,0,10,0
1668273725741,MATH 290B,A00,098060,Roberts; Justin Deritter,13,0,15,2
1668273726164,MATH 292,A00,098061,Belmont; Eva Kinoshita,10,0,10,0
1668273726589,MATH 295,A00,098062,Suk; Andrew Hoon,48,0,50,2
1668273727016,MATH 296,A00,098063,Novak; Jonathan I,20,0,20,0
1668273727439,MATH 297,001,098064,Gamst; Anthony Collins,9997,0,9999,2
1668274227362,COGS 205,A00,101395,Chiba; Andrea,19,0,20,1
1668274227790,COGS 210B,001,101404,Greene; Deanna Jacquelyn,9998,0,9999,1
1668274227790,COGS 210B,002,101417,Xia; Haijun,9999,0,9999,0
1668274227790,COGS 210B,003,101422,Nitz; Douglas A.,9999,0,9999,0
1668274227790,COGS 210B,004,101423,Hollan; James D.,9998,0,9999,1
1668274227790,COGS 210B,005,101424,Deak; Gedeon O.,9998,0,9999,1
1668274227790,COGS 210B,006,101425,Rossano; Federico,9999,0,9999,0
1668274228218,COGS 211B,A00,101427,Coulson; Seana M,9996,0,9999,3
1668274228642,COGS 220,A00,101428,Hollan; James D.,0,0,25,25
1668274229067,COGS 229,A00,101429,Dow; Steven P,18,0,25,7
1668274229493,COGS 230,A00,101430,Klemmer; Scott R,12,0,17,5
1668274229920,COGS 234,A00,101431,Xia; Haijun,2,0,25,23
1668274230346,COGS 260,A00,101432,Kiyonaga; Anastasia,21,0,25,4
1668274230346,COGS 260,B00,101433,Kirsh; David Joel,15,0,25,10
1668274230768,CSE 202,A00,102371,Impagliazzo; Russell,0,0,0,0
1668274231191,CSE 203B,A01,102373,Cheng; Chung Kuan,0,0,0,0
1668274231616,CSE 208,A00,102374,Micciancio; Daniele,0,0,0,0
1668274232038,CSE 209A,A00,112895,Impagliazzo; Russell,0,0,15,15
1668274232463,CSE 209B,A00,108005,Bellare; Mihir,0,0,0,0
1668274232887,CSE 210,A00,113163,Coblenz; Michael J,0,0,0,0
1668274233325,CSE 219,A00,106111,Dow; Steven P,0,0,20,20
1668274233749,CSE 221,A00,102376,Voelker; Geoffrey M.,0,0,0,0
1668274234175,CSE 224,A01,102378,Porter; George M,0,0,0,0
1668274234603,CSE 229A,A00,102379,Savage; Stefan,0,0,0,0
1668274235030,CSE 229C,A00,102380,Munyaka; Imani N. S.,0,0,0,0
1668274235525,CSE 232B,A00,102382,Deutsch; Alin Bernard,0,0,0,0
1668274235950,CSE 234,A01,112904,Kumar; Arun Kumar,0,0,0,0
1668274236373,CSE 237A,A00,102383,Rosing; Tajana Simunic,0,0,0,0
1668274236799,CSE 239A,A00,102384,Deutsch; Alin Bernard,0,0,0,0
1668274237226,CSE 239B,A00,102385,Polikarpova; Nadezhda,0,0,0,0
1668274237650,CSE 240A,A00,102386,Pannuto; Patrick William,0,0,0,0
1668274238075,CSE 240B,A00,102387,Zhao; Jishen,0,0,0,0
1668274238501,CSE 241A,A00,106406,Kang; Mingu,0,0,0,0
1668274238925,CSE 249B,A00,102388,Kahng; Andrew Byun,0,0,8,8
1668274239348,CSE 251B,A01,102392,Cottrell; Garrison W,0,0,0,0
1668274239348,CSE 251B,A02,102393,Cottrell; Garrison W,0,0,0,0
1668274239774,CSE 252B,A00,102394,Ochoa; Benjamin Lawrence,0,0,0,0
1668274240196,CSE 257,A01,102396,Gao; Sicun,0,0,0,0
1668274240621,CSE 272,A00,102397,Li; Tzumao,0,0,0,0
1668274241043,CSE 274,A00,111323,Chern; Albert Ren-Haur,0,0,0,0
1668274241468,CSE 282,A00,102398,Pevzner; Pavel Arkadjevich,0,0,0,0
1668274241893,CSE 284,A00,114175,Gymrek; Melissa Ann,0,0,0,0
1668274242322,CSE 290,A00,102399,Chandraker; Manmohan Krishna,0,0,0,0
1668274242322,CSE 290,B00,102400,Vaccaro; Kristen Marie,0,0,25,25
1668274242322,CSE 290,C00,102414,Pannuto; Patrick William,0,0,25,25
1668274242322,CSE 290,D00,102427,Pevzner; Pavel Arkadjevich,0,0,0,0
1668274242322,CSE 290,E00,102429,Zhao; Jishen,0,0,0,0
1668274242322,CSE 290,F00,102436,Tullsen; Dean Michael,0,0,0,0
1668274242322,CSE 290,G00,102440,Christensen; Henrik I,0,0,20,20
1668274242749,CSE 291,A00,102443,Su; Hao,0,0,0,0
1668274242749,CSE 291,B00,102448,Polikarpova; Nadezhda,0,0,0,0
1668274242749,CSE 291,C00,102453,Vaccaro; Kristen Marie,0,0,0,0
1668274242749,CSE 291,D00,111343,Savage; Stefan,0,0,0,0
1668274242749,CSE 291,E00,116474,Claffy; Kimberly Claire,0,0,0,0
1668274242749,CSE 291,F00,116479,Pasquale; Joseph,0,0,0,0
1668274243175,CSE 293,001,119111,Bafna; Vineet,9999,0,9999,0
1668274243175,CSE 293,002,119118,Bellare; Mihir,9999,0,9999,0
1668274243175,CSE 293,003,119122,Berg-Kirkpatrick; Taylor D,9999,0,9999,0
1668274243175,CSE 293,004,119135,Christensen; Henrik I,9999,0,9999,0
1668274243175,CSE 293,005,119142,Cottrell; Garrison W,9999,0,9999,0
1668274243175,CSE 293,006,119146,Deutsch; Alin Bernard,9999,0,9999,0
1668274243175,CSE 293,007,119159,Esmaeilzadeh; Hadi,9999,0,9999,0
1668274243175,CSE 293,008,119166,Freund; Yoav,9999,0,9999,0
1668274243175,CSE 293,009,119170,Griswold; William G.,9999,0,9999,0
1668274243175,CSE 293,010,119183,Gymrek; Melissa Ann,9999,0,9999,0
1668274243175,CSE 293,011,119190,Heninger; Nadia A,9999,0,9999,0
1668274243175,CSE 293,012,119230,Impagliazzo; Russell,9999,0,9999,0
1668274243175,CSE 293,013,119232,Jhala; Ranjit,9999,0,9999,0
1668274243175,CSE 293,014,119233,Kahng; Andrew Byun,9999,0,9999,0
1668274243175,CSE 293,015,119298,Kane; Daniel Mertz,9999,0,9999,0
1668274243175,CSE 293,016,119299,Kriegman; David J,9999,0,9999,0
1668274243175,CSE 293,017,119300,Kumar; Arun Kumar,9999,0,9999,0
1668274243175,CSE 293,018,119301,Lerner; Sorin,9999,0,9999,0
1668274243175,CSE 293,019,119302,Lovett; Shachar,9999,0,9999,0
1668274243175,CSE 293,020,119303,McAuley; Julian John,9999,0,9999,0
1668274243175,CSE 293,021,119304,Micciancio; Daniele,9999,0,9999,0
1668274243175,CSE 293,022,119367,Orailoglu; Alex,9999,0,9999,0
1668274243175,CSE 293,023,119382,Paturi; Ramamohan,9999,0,9999,0
1668274243175,CSE 293,024,119404,Polikarpova; Nadezhda,9999,0,9999,0
1668274243175,CSE 293,025,119406,Politz; Joseph Gibbs,9999,0,9999,0
1668274243175,CSE 293,026,119411,Porter; George M,9999,0,9999,0
1668274243175,CSE 293,027,119414,Porter; Leonard Emerson,9999,0,9999,0
1668274243175,CSE 293,028,119416,Ramamoorthi; Ravi,9999,0,9999,0
1668274243175,CSE 293,029,119417,Sahoo; Debashis,9999,0,9999,0
1668274243175,CSE 293,030,119420,Saul; Lawrence,9999,0,9999,0
1668274243175,CSE 293,031,119421,Savage; Stefan,9999,0,9999,0
1668274243175,CSE 293,032,119425,Schulze; Jurgen P.,9999,0,9999,0
1668274243175,CSE 293,033,119426,Snoeren; Alex C.,9999,0,9999,0
1668274243175,CSE 293,034,119428,Shang; Jingbo,9999,0,9999,0
1668274243175,CSE 293,035,119430,Stefan; Deian,9999,0,9999,0
1668274243175,CSE 293,036,119431,Su; Hao,9999,0,9999,0
1668274243175,CSE 293,037,119433,Swanson; Steven James,9999,0,9999,0
1668274243175,CSE 293,038,119435,Tullsen; Dean Michael,9999,0,9999,0
1668274243175,CSE 293,039,119483,Voelker; Geoffrey M.,9999,0,9999,0
1668274243175,CSE 293,040,119537,Zhao; Jishen,9999,0,9999,0
1668274243175,CSE 293,041,119538,Zhou; Yuan-Yuan,9999,0,9999,0
1668274243175,CSE 293,042,119539,Gao; Sicun,9999,0,9999,0
1668274243175,CSE 293,043,119540,Weibel; Nadir,9999,0,9999,0
1668274243175,CSE 293,044,119541,Gupta; Rajesh K.,9999,0,9999,0
1668274243175,CSE 293,045,126410,Vaccaro; Kristen Marie,9999,0,9999,0
1668274243175,CSE 293,046,126411,Klemke; Richard,9999,0,9999,0
1668274243601,CSE 294,A00,102459,Voelker; Geoffrey M.,0,0,0,0
1668274243601,CSE 294,B00,111322,Orailoglu; Alex,0,0,0,0
1668274244026,DSE 201,A00,096914,Deutsch; Alin Bernard,30,0,30,0
1668274244453,DSE 210,A00,096915,Dasgupta; Sanjoy,30,0,30,0
1668274244880,DSE 260A,A00,096916,Altintas De Callaf; Ilkay,30,0,30,0
1668274245304,ECE 200,001,103586,Antipa; Nicholas A,9999,0,9999,0
1668274245304,ECE 200,002,103587,Atanasov; Nikolay A.,9999,0,9999,0
1668274245304,ECE 200,003,103588,Bharadia; Dinesh,9999,0,9999,0
1668274245304,ECE 200,004,103589,Cheng; Chung Kuan,9999,0,9999,0
1668274245304,ECE 200,005,103590,Cosman; Pamela C.,9999,0,9999,0
1668274245304,ECE 200,006,103591,Dayeh; Shadi Ahmad,9999,0,9999,0
1668274245304,ECE 200,007,103592,Fainman; Yeshaiahu,9999,0,9999,0
1668274245304,ECE 200,008,103593,Ford; Joseph Earl,9999,0,9999,0
1668274245304,ECE 200,009,103594,Franceschetti; Massimo,9999,0,9999,0
1668274245304,ECE 200,010,103595,Fullerton; Eric E,9999,0,9999,0
1668274245304,ECE 200,011,103596,Galton; Ian A,9999,0,9999,0
1668274245304,ECE 200,012,103597,Gilja; Vikash,9999,0,9999,0
1668274245304,ECE 200,013,103598,Hall; Drew A.,9999,0,9999,0
1668274245304,ECE 200,014,103599,Hsueh; Tzu-Chien,9999,0,9999,0
1668274245304,ECE 200,015,103600,Javidi; Tara,9999,0,9999,0
1668274245304,ECE 200,016,103601,Kahng; Andrew Byun,9999,0,9999,0
1668274245304,ECE 200,017,103602,Kim; Young-Han,9999,0,9999,0
1668274245304,ECE 200,018,103603,Koushanfar; Farinaz,9999,0,9999,0
1668274245304,ECE 200,019,103604,Kuzum; Duygu,9999,0,9999,0
1668274245304,ECE 200,020,103605,Le; Hanh-Phuc,9999,0,9999,0
1668274245304,ECE 200,021,103606,Lin; Bill,9999,0,9999,0
1668274245304,ECE 200,022,103607,Liu; Zhaowei,9998,0,9999,1
1668274245304,ECE 200,023,103608,Lo; Yu-Hwa,9999,0,9999,0
1668274245304,ECE 200,024,103609,Lomakin; Vitaliy,9999,0,9999,0
1668274245304,ECE 200,025,103610,Mercier; Patrick Philip,9999,0,9999,0
1668274245304,ECE 200,026,103611,Meyer; Florian,9999,0,9999,0
1668274245304,ECE 200,027,103612,Milstein; Laurence B.,9999,0,9999,0
1668274245304,ECE 200,028,103613,Mir Arabbaygi; Siavash,9999,0,9999,0
1668274245304,ECE 200,029,103614,Mookherjea; Shayan,9999,0,9999,0
1668274245304,ECE 200,030,103615,Morris; Karcher William,9999,0,9999,0
1668274245304,ECE 200,031,103616,Ng; Tse Nga,9999,0,9999,0
1668274245304,ECE 200,032,103617,Nguyen; Truong Quang,9999,0,9999,0
1668274245304,ECE 200,033,103618,Nomura; Kenji,9999,0,9999,0
1668274245304,ECE 200,034,103619,Orlitsky; Alon,9999,0,9999,0
1668274245304,ECE 200,035,103620,Pal; Piya,9999,0,9999,0
1668274245304,ECE 200,036,103621,Papen; George C.,9999,0,9999,0
1668274245304,ECE 200,037,103622,Radic; Stojan,9999,0,9999,0
1668274245304,ECE 200,038,103623,Rao; Bhaskar D.,9999,0,9999,0
1668274245304,ECE 200,039,103624,Rao; Ramesh R,9999,0,9999,0
1668274245304,ECE 200,040,103625,Rebeiz; Gabriel,9999,0,9999,0
1668274245304,ECE 200,041,103626,Sanford; John R,9999,0,9999,0
1668274245304,ECE 200,042,103627,Siegel; Paul H.,9999,0,9999,0
1668274245304,ECE 200,043,103628,Sievenpiper; Daniel F.,9999,0,9999,0
1668274245304,ECE 200,044,103629,Sworder; David D.,9999,0,9999,0
1668274245304,ECE 200,045,103630,Taur; Yuan,9999,0,9999,0
1668274245304,ECE 200,046,103631,Touri; Behrouz,9999,0,9999,0
1668274245304,ECE 200,047,103632,Trivedi; Mohan M.,9999,0,9999,0
1668274245304,ECE 200,048,103633,Vasconcelos; Nuno,9999,0,9999,0
1668274245304,ECE 200,049,103634,Wang; Xiaolong,9999,0,9999,0
1668274245304,ECE 200,050,103635,Xie; Pengtao,9999,0,9999,0
1668274245304,ECE 200,051,103636,Yip; Michael,9999,0,9999,0
1668274245304,ECE 200,052,103637,Zeger; Kenneth A.,999,0,999,0
1668274245304,ECE 200,053,103638,Zhang; Xinyu,9999,0,9999,0
1668274245304,ECE 200,054,103639,Turakhia; Yatish Girish,9999,0,9999,0
1668274245304,ECE 200,055,103640,Kang; Mingu,9999,0,9999,0
1668274245304,ECE 200,056,103641,Shi; Yuanyuan,9999,0,9999,0
1668274245304,ECE 200,057,103642,Wang; Edward Jay,9999,0,9999,0
1668274245304,ECE 200,058,103643,Zheng; Yang,9999,0,9999,0
1668274245727,ECE 202,A00,103644,Kuzum; Duygu,0,0,0,0
1668274246154,ECE 212BN,A00,103646,Ng; Tse Nga,0,0,0,0
1668274246579,ECE 221,A00,111493,Staff,0,0,0,0
1668274247005,ECE 222B,A00,103647,Lomakin; Vitaliy,0,0,0,0
1668274247438,ECE 230B,A00,103648,Taur; Yuan,0,0,0,0
1668274247862,ECE 238B,A00,103649,Garay; Javier,0,0,0,0
1668274248285,ECE 240B,A00,112900,Fainman; Yeshaiahu,0,0,0,0
1668274248710,ECE 247A,A00,103650,Jokerst; Jesse Vincent,0,0,0,0
1668274249135,ECE 247B,A00,103651,Wang; Joseph,0,0,0,0
1668274249563,ECE 250,A00,103652,Siegel; Paul H.,0,0,0,0
1668274249988,ECE 251A,A00,103654,Rao; Bhaskar D.,0,0,0,0
1668274250415,ECE 257B,A00,103655,Bharadia; Dinesh,0,0,0,0
1668274250838,ECE 258A,A00,103656,Milstein; Laurence B.,0,0,0,0
1668274251265,ECE 260B,A00,103658,Kang; Mingu,0,0,0,0
1668274251697,ECE 264A,A00,103659,Galton; Ian A,0,0,0,0
1668274252120,ECE 265A,A00,103661,Gudem; Prasad S.S.,0,0,0,0
1668274252556,ECE 265D,A00,103662,Gudem; Prasad S.S.,0,0,0,0
1668274252983,ECE 268,A00,103663,Koushanfar; Farinaz,0,0,0,0
1668274253410,ECE 269,A01,103665,Pal; Piya,0,0,0,0
1668274253844,ECE 271B,A00,103666,Vasconcelos; Manuela,0,0,0,0
1668274254268,ECE 276A,A00,103667,Atanasov; Nikolay A.,0,0,0,0
1668274254690,ECE 277,A00,103668,An; Cheolhong,0,0,0,0
1668274255126,ECE 279,A00,117947,Hall; Drew A.,0,0,0,0
1668274255979,ECE 283,A00,103670,Hsueh; Tzu-Chien,0,0,0,0
1668274256406,ECE 284,A00,103671,Turakhia; Yatish Girish,0,0,0,0
1668274256837,ECE 285,A00,103672,Zheng; Yang,0,0,0,0
1668274256837,ECE 285,B00,103673,Sworder; David D.,0,0,0,0
1668274257260,ECE 287,A00,103676,Javidi; Tara,0,0,0,0
1668274257683,MATH 200B,A00,098023,Salehi Golsefidy; Alireza,12,0,15,3
1668274258114,MATH 202B,A00,098024,Rhoades; Brendon Patrick,9,0,15,6
1668274258541,MATH 203B,A00,098025,Oprea; Dragos N.,10,0,15,5
1668274258964,MATH 204B,A00,098026,Sorensen; Claus M,13,0,15,2
1668274259389,MATH 208,A00,098027,Izadi; Elham,7,0,10,3
1668274259812,MATH 209,A00,098028,Pollack; Aaron,10,0,10,0
1668274260238,MATH 211A,A00,112919,Rogalski; Daniel,9,0,10,1
1668274260662,MATH 211B,A00,112920,Seward; Brandon M.,9,0,10,1
1668274261084,MATH 218,A00,098029,Li; Bo,10,0,10,0
1668274261508,MATH 220B,A00,098030,Novak; Jonathan I,11,0,15,4
1668274261936,MATH 221A,A00,098031,Ebenfelt; Peter F,13,0,15,2
1668274262359,MATH 231B,A00,098032,Zlatos; Andrej,12,0,15,3
1668274262800,MATH 240B,A00,098033,Ni; Lei,9,0,15,6
1668274263239,MATH 243,A00,098034,Jekel; David Andrew,10,0,10,0
1668274263663,MATH 245A,A00,098035,Nie; Jiawang,0,0,15,16
1668274264085,MATH 248,A00,098036,Bejenaru; Ioan,10,0,10,0
1668274264509,MATH 250B,A00,098037,Spolaor; Luca,14,0,15,1
1668274264933,MATH 258,A00,098038,Ni; Lei,10,0,10,0
1668274265365,MATH 264B,A00,098041,Rhoades; Brendon Patrick,9,0,15,6
1668274265794,MATH 268,A00,098042,Buss; Samuel R,10,0,10,0
1668274266230,MATH 269,A00,098043,Rhoades; Brendon Patrick,10,0,10,0
1668274266657,MATH 270B,A00,098044,Li; Bo,10,0,15,5
1668274267097,MATH 272B,A00,098045,Holst; Michael J,13,0,15,2
1668274267529,MATH 273A,A00,098046,Tian; Xiaochuan,10,0,15,5
1668274267959,MATH 275,A01,098048,Tian; Xiaochuan,6,0,10,4
1668274268385,MATH 278A,A00,098049,Holst; Michael J,8,0,10,2
1668274268807,MATH 278B,A00,098050,Cloninger; Alexander,10,0,10,0
1668274269233,MATH 278C,A00,098051,Nie; Jiawang,7,0,10,3
1668274269659,MATH 280B,A00,098052,Zheng; Tianyi,9,0,15,6
1668274270084,MATH 281B,A00,098053,Bradic; Jelena,1,0,15,14
1668274270507,MATH 282B,A00,098054,Arias-Castro; Ery,0,0,15,15
1668274270932,MATH 285,A00,098055,Fitzsimmons; Patrick J,0,0,15,17
1668274271359,MATH 287B,A00,098056,Arias-Castro; Ery,2,0,15,13
1668274271782,MATH 288,A00,098057,Agarwal; Pooja,9,0,10,1
1668274271782,MATH 288,B00,098058,Zhang; Danna,8,0,10,2
1668274271782,MATH 288,C00,098059,Williams; Ruth J,10,0,10,0
1668274272204,MATH 290B,A00,098060,Roberts; Justin Deritter,13,0,15,2
1668274272631,MATH 292,A00,098061,Belmont; Eva Kinoshita,10,0,10,0
1668274273055,MATH 295,A00,098062,Suk; Andrew Hoon,48,0,50,2
1668274273482,MATH 296,A00,098063,Novak; Jonathan I,20,0,20,0
1668274273907,MATH 297,001,098064,Gamst; Anthony Collins,9997,0,9999,2
1668274773596,COGS 205,A00,101395,Chiba; Andrea,19,0,20,1
1668274774020,COGS 210B,001,101404,Greene; Deanna Jacquelyn,9998,0,9999,1
1668274774020,COGS 210B,002,101417,Xia; Haijun,9999,0,9999,0
1668274774020,COGS 210B,003,101422,Nitz; Douglas A.,9999,0,9999,0
1668274774020,COGS 210B,004,101423,Hollan; James D.,9998,0,9999,1
1668274774020,COGS 210B,005,101424,Deak; Gedeon O.,9998,0,9999,1
1668274774020,COGS 210B,006,101425,Rossano; Federico,9999,0,9999,0
1668274774444,COGS 211B,A00,101427,Coulson; Seana M,9996,0,9999,3
1668274774869,COGS 220,A00,101428,Hollan; James D.,0,0,25,25
1668274775294,COGS 229,A00,101429,Dow; Steven P,18,0,25,7
1668274775718,COGS 230,A00,101430,Klemmer; Scott R,12,0,17,5
1668274776144,COGS 234,A00,101431,Xia; Haijun,2,0,25,23
1668274776566,COGS 260,A00,101432,Kiyonaga; Anastasia,21,0,25,4
1668274776566,COGS 260,B00,101433,Kirsh; David Joel,15,0,25,10
1668274776999,CSE 202,A00,102371,Impagliazzo; Russell,0,0,0,0
1668274777444,CSE 203B,A01,102373,Cheng; Chung Kuan,0,0,0,0
1668274777868,CSE 208,A00,102374,Micciancio; Daniele,0,0,0,0
1668274778292,CSE 209A,A00,112895,Impagliazzo; Russell,0,0,15,15
1668274778717,CSE 209B,A00,108005,Bellare; Mihir,0,0,0,0
1668274779140,CSE 210,A00,113163,Coblenz; Michael J,0,0,0,0
1668274779565,CSE 219,A00,106111,Dow; Steven P,0,0,20,20
1668274779989,CSE 221,A00,102376,Voelker; Geoffrey M.,0,0,0,0
1668274780416,CSE 224,A01,102378,Porter; George M,0,0,0,0
1668274780842,CSE 229A,A00,102379,Savage; Stefan,0,0,0,0
1668274781274,CSE 229C,A00,102380,Munyaka; Imani N. S.,0,0,0,0
1668274781701,CSE 232B,A00,102382,Deutsch; Alin Bernard,0,0,0,0
1668274782124,CSE 234,A01,112904,Kumar; Arun Kumar,0,0,0,0
1668274782551,CSE 237A,A00,102383,Rosing; Tajana Simunic,0,0,0,0
1668274782974,CSE 239A,A00,102384,Deutsch; Alin Bernard,0,0,0,0
1668274783414,CSE 239B,A00,102385,Polikarpova; Nadezhda,0,0,0,0
1668274783843,CSE 240A,A00,102386,Pannuto; Patrick William,0,0,0,0
1668274784265,CSE 240B,A00,102387,Zhao; Jishen,0,0,0,0
1668274784688,CSE 241A,A00,106406,Kang; Mingu,0,0,0,0
1668274785113,CSE 249B,A00,102388,Kahng; Andrew Byun,0,0,8,8
1668274785537,CSE 251B,A01,102392,Cottrell; Garrison W,0,0,0,0
1668274785537,CSE 251B,A02,102393,Cottrell; Garrison W,0,0,0,0
1668274785970,CSE 252B,A00,102394,Ochoa; Benjamin Lawrence,0,0,0,0
1668274786393,CSE 257,A01,102396,Gao; Sicun,0,0,0,0
1668274786818,CSE 272,A00,102397,Li; Tzumao,0,0,0,0
1668274787246,CSE 274,A00,111323,Chern; Albert Ren-Haur,0,0,0,0
1668274787678,CSE 282,A00,102398,Pevzner; Pavel Arkadjevich,0,0,0,0
1668274788101,CSE 284,A00,114175,Gymrek; Melissa Ann,0,0,0,0
1668274788527,CSE 290,A00,102399,Chandraker; Manmohan Krishna,0,0,0,0
1668274788527,CSE 290,B00,102400,Vaccaro; Kristen Marie,0,0,25,25
1668274788527,CSE 290,C00,102414,Pannuto; Patrick William,0,0,25,25
1668274788527,CSE 290,D00,102427,Pevzner; Pavel Arkadjevich,0,0,0,0
1668274788527,CSE 290,E00,102429,Zhao; Jishen,0,0,0,0
1668274788527,CSE 290,F00,102436,Tullsen; Dean Michael,0,0,0,0
1668274788527,CSE 290,G00,102440,Christensen; Henrik I,0,0,20,20
1668274788957,CSE 291,A00,102443,Su; Hao,0,0,0,0
1668274788957,CSE 291,B00,102448,Polikarpova; Nadezhda,0,0,0,0
1668274788957,CSE 291,C00,102453,Vaccaro; Kristen Marie,0,0,0,0
1668274788957,CSE 291,D00,111343,Savage; Stefan,0,0,0,0
1668274788957,CSE 291,E00,116474,Claffy; Kimberly Claire,0,0,0,0
1668274788957,CSE 291,F00,116479,Pasquale; Joseph,0,0,0,0
1668274789425,CSE 293,001,119111,Bafna; Vineet,9999,0,9999,0
1668274789425,CSE 293,002,119118,Bellare; Mihir,9999,0,9999,0
1668274789425,CSE 293,003,119122,Berg-Kirkpatrick; Taylor D,9999,0,9999,0
1668274789425,CSE 293,004,119135,Christensen; Henrik I,9999,0,9999,0
1668274789425,CSE 293,005,119142,Cottrell; Garrison W,9999,0,9999,0
1668274789425,CSE 293,006,119146,Deutsch; Alin Bernard,9999,0,9999,0
1668274789425,CSE 293,007,119159,Esmaeilzadeh; Hadi,9999,0,9999,0
1668274789425,CSE 293,008,119166,Freund; Yoav,9999,0,9999,0
1668274789425,CSE 293,009,119170,Griswold; William G.,9999,0,9999,0
1668274789425,CSE 293,010,119183,Gymrek; Melissa Ann,9999,0,9999,0
1668274789425,CSE 293,011,119190,Heninger; Nadia A,9999,0,9999,0
1668274789425,CSE 293,012,119230,Impagliazzo; Russell,9999,0,9999,0
1668274789425,CSE 293,013,119232,Jhala; Ranjit,9999,0,9999,0
1668274789425,CSE 293,014,119233,Kahng; Andrew Byun,9999,0,9999,0
1668274789425,CSE 293,015,119298,Kane; Daniel Mertz,9999,0,9999,0
1668274789425,CSE 293,016,119299,Kriegman; David J,9999,0,9999,0
1668274789425,CSE 293,017,119300,Kumar; Arun Kumar,9999,0,9999,0
1668274789425,CSE 293,018,119301,Lerner; Sorin,9999,0,9999,0
1668274789425,CSE 293,019,119302,Lovett; Shachar,9999,0,9999,0
1668274789425,CSE 293,020,119303,McAuley; Julian John,9999,0,9999,0
1668274789425,CSE 293,021,119304,Micciancio; Daniele,9999,0,9999,0
1668274789425,CSE 293,022,119367,Orailoglu; Alex,9999,0,9999,0
1668274789425,CSE 293,023,119382,Paturi; Ramamohan,9999,0,9999,0
1668274789425,CSE 293,024,119404,Polikarpova; Nadezhda,9999,0,9999,0
1668274789425,CSE 293,025,119406,Politz; Joseph Gibbs,9999,0,9999,0
1668274789425,CSE 293,026,119411,Porter; George M,9999,0,9999,0
1668274789425,CSE 293,027,119414,Porter; Leonard Emerson,9999,0,9999,0
1668274789425,CSE 293,028,119416,Ramamoorthi; Ravi,9999,0,9999,0
1668274789425,CSE 293,029,119417,Sahoo; Debashis,9999,0,9999,0
1668274789425,CSE 293,030,119420,Saul; Lawrence,9999,0,9999,0
1668274789425,CSE 293,031,119421,Savage; Stefan,9999,0,9999,0
1668274789425,CSE 293,032,119425,Schulze; Jurgen P.,9999,0,9999,0
1668274789425,CSE 293,033,119426,Snoeren; Alex C.,9999,0,9999,0
1668274789425,CSE 293,034,119428,Shang; Jingbo,9999,0,9999,0
1668274789425,CSE 293,035,119430,Stefan; Deian,9999,0,9999,0
1668274789425,CSE 293,036,119431,Su; Hao,9999,0,9999,0
1668274789425,CSE 293,037,119433,Swanson; Steven James,9999,0,9999,0
1668274789425,CSE 293,038,119435,Tullsen; Dean Michael,9999,0,9999,0
1668274789425,CSE 293,039,119483,Voelker; Geoffrey M.,9999,0,9999,0
1668274789425,CSE 293,040,119537,Zhao; Jishen,9999,0,9999,0
1668274789425,CSE 293,041,119538,Zhou; Yuan-Yuan,9999,0,9999,0
1668274789425,CSE 293,042,119539,Gao; Sicun,9999,0,9999,0
1668274789425,CSE 293,043,119540,Weibel; Nadir,9999,0,9999,0
1668274789425,CSE 293,044,119541,Gupta; Rajesh K.,9999,0,9999,0
1668274789425,CSE 293,045,126410,Vaccaro; Kristen Marie,9999,0,9999,0
1668274789425,CSE 293,046,126411,Klemke; Richard,9999,0,9999,0
1668274789849,CSE 294,A00,102459,Voelker; Geoffrey M.,0,0,0,0
1668274789849,CSE 294,B00,111322,Orailoglu; Alex,0,0,0,0
1668274790273,DSE 201,A00,096914,Deutsch; Alin Bernard,30,0,30,0
1668274790704,DSE 210,A00,096915,Dasgupta; Sanjoy,30,0,30,0
1668274791130,DSE 260A,A00,096916,Altintas De Callaf; Ilkay,30,0,30,0
1668274791559,ECE 200,001,103586,Antipa; Nicholas A,9999,0,9999,0
1668274791559,ECE 200,002,103587,Atanasov; Nikolay A.,9999,0,9999,0
1668274791559,ECE 200,003,103588,Bharadia; Dinesh,9999,0,9999,0
1668274791559,ECE 200,004,103589,Cheng; Chung Kuan,9999,0,9999,0
1668274791559,ECE 200,005,103590,Cosman; Pamela C.,9999,0,9999,0
1668274791559,ECE 200,006,103591,Dayeh; Shadi Ahmad,9999,0,9999,0
1668274791559,ECE 200,007,103592,Fainman; Yeshaiahu,9999,0,9999,0
1668274791559,ECE 200,008,103593,Ford; Joseph Earl,9999,0,9999,0
1668274791559,ECE 200,009,103594,Franceschetti; Massimo,9999,0,9999,0
1668274791559,ECE 200,010,103595,Fullerton; Eric E,9999,0,9999,0
1668274791559,ECE 200,011,103596,Galton; Ian A,9999,0,9999,0
1668274791559,ECE 200,012,103597,Gilja; Vikash,9999,0,9999,0
1668274791559,ECE 200,013,103598,Hall; Drew A.,9999,0,9999,0
1668274791559,ECE 200,014,103599,Hsueh; Tzu-Chien,9999,0,9999,0
1668274791559,ECE 200,015,103600,Javidi; Tara,9999,0,9999,0
1668274791559,ECE 200,016,103601,Kahng; Andrew Byun,9999,0,9999,0
1668274791559,ECE 200,017,103602,Kim; Young-Han,9999,0,9999,0
1668274791559,ECE 200,018,103603,Koushanfar; Farinaz,9999,0,9999,0
1668274791559,ECE 200,019,103604,Kuzum; Duygu,9999,0,9999,0
1668274791559,ECE 200,020,103605,Le; Hanh-Phuc,9999,0,9999,0
1668274791559,ECE 200,021,103606,Lin; Bill,9999,0,9999,0
1668274791559,ECE 200,022,103607,Liu; Zhaowei,9998,0,9999,1
1668274791559,ECE 200,023,103608,Lo; Yu-Hwa,9999,0,9999,0
1668274791559,ECE 200,024,103609,Lomakin; Vitaliy,9999,0,9999,0
1668274791559,ECE 200,025,103610,Mercier; Patrick Philip,9999,0,9999,0
1668274791559,ECE 200,026,103611,Meyer; Florian,9999,0,9999,0
1668274791559,ECE 200,027,103612,Milstein; Laurence B.,9999,0,9999,0
1668274791559,ECE 200,028,103613,Mir Arabbaygi; Siavash,9999,0,9999,0
1668274791559,ECE 200,029,103614,Mookherjea; Shayan,9999,0,9999,0
1668274791559,ECE 200,030,103615,Morris; Karcher William,9999,0,9999,0
1668274791559,ECE 200,031,103616,Ng; Tse Nga,9999,0,9999,0
1668274791559,ECE 200,032,103617,Nguyen; Truong Quang,9999,0,9999,0
1668274791559,ECE 200,033,103618,Nomura; Kenji,9999,0,9999,0
1668274791559,ECE 200,034,103619,Orlitsky; Alon,9999,0,9999,0
1668274791559,ECE 200,035,103620,Pal; Piya,9999,0,9999,0
1668274791559,ECE 200,036,103621,Papen; George C.,9999,0,9999,0
1668274791559,ECE 200,037,103622,Radic; Stojan,9999,0,9999,0
1668274791559,ECE 200,038,103623,Rao; Bhaskar D.,9999,0,9999,0
1668274791559,ECE 200,039,103624,Rao; Ramesh R,9999,0,9999,0
1668274791559,ECE 200,040,103625,Rebeiz; Gabriel,9999,0,9999,0
1668274791559,ECE 200,041,103626,Sanford; John R,9999,0,9999,0
1668274791559,ECE 200,042,103627,Siegel; Paul H.,9999,0,9999,0
1668274791559,ECE 200,043,103628,Sievenpiper; Daniel F.,9999,0,9999,0
1668274791559,ECE 200,044,103629,Sworder; David D.,9999,0,9999,0
1668274791559,ECE 200,045,103630,Taur; Yuan,9999,0,9999,0
1668274791559,ECE 200,046,103631,Touri; Behrouz,9999,0,9999,0
1668274791559,ECE 200,047,103632,Trivedi; Mohan M.,9999,0,9999,0
1668274791559,ECE 200,048,103633,Vasconcelos; Nuno,9999,0,9999,0
1668274791559,ECE 200,049,103634,Wang; Xiaolong,9999,0,9999,0
1668274791559,ECE 200,050,103635,Xie; Pengtao,9999,0,9999,0
1668274791559,ECE 200,051,103636,Yip; Michael,9999,0,9999,0
1668274791559,ECE 200,052,103637,Zeger; Kenneth A.,999,0,999,0
1668274791559,ECE 200,053,103638,Zhang; Xinyu,9999,0,9999,0
1668274791559,ECE 200,054,103639,Turakhia; Yatish Girish,9999,0,9999,0
1668274791559,ECE 200,055,103640,Kang; Mingu,9999,0,9999,0
1668274791559,ECE 200,056,103641,Shi; Yuanyuan,9999,0,9999,0
1668274791559,ECE 200,057,103642,Wang; Edward Jay,9999,0,9999,0
1668274791559,ECE 200,058,103643,Zheng; Yang,9999,0,9999,0
1668274791982,ECE 202,A00,103644,Kuzum; Duygu,0,0,0,0
1668274792405,ECE 212BN,A00,103646,Ng; Tse Nga,0,0,0,0
1668274792831,ECE 221,A00,111493,Staff,0,0,0,0
1668274793255,ECE 222B,A00,103647,Lomakin; Vitaliy,0,0,0,0
1668274793682,ECE 230B,A00,103648,Taur; Yuan,0,0,0,0
1668274794107,ECE 238B,A00,103649,Garay; Javier,0,0,0,0
1668274794532,ECE 240B,A00,112900,Fainman; Yeshaiahu,0,0,0,0
1668274794958,ECE 247A,A00,103650,Jokerst; Jesse Vincent,0,0,0,0
1668274795382,ECE 247B,A00,103651,Wang; Joseph,0,0,0,0
1668274795806,ECE 250,A00,103652,Siegel; Paul H.,0,0,0,0
1668274796238,ECE 251A,A00,103654,Rao; Bhaskar D.,0,0,0,0
1668274796661,ECE 257B,A00,103655,Bharadia; Dinesh,0,0,0,0
1668274797087,ECE 258A,A00,103656,Milstein; Laurence B.,0,0,0,0
1668274797519,ECE 260B,A00,103658,Kang; Mingu,0,0,0,0
1668274797942,ECE 264A,A00,103659,Galton; Ian A,0,0,0,0
1668274798480,ECE 265A,A00,103661,Gudem; Prasad S.S.,0,0,0,0
1668274798904,ECE 265D,A00,103662,Gudem; Prasad S.S.,0,0,0,0
1668274799326,ECE 268,A00,103663,Koushanfar; Farinaz,0,0,0,0
1668274799749,ECE 269,A01,103665,Pal; Piya,0,0,0,0
1668274800173,ECE 271B,A00,103666,Vasconcelos; Manuela,0,0,0,0
1668274800606,ECE 276A,A00,103667,Atanasov; Nikolay A.,0,0,0,0
1668274801032,ECE 277,A00,103668,An; Cheolhong,0,0,0,0
1668274801455,ECE 279,A00,117947,Hall; Drew A.,0,0,0,0
1668274802316,ECE 283,A00,103670,Hsueh; Tzu-Chien,0,0,0,0
1668274802746,ECE 284,A00,103671,Turakhia; Yatish Girish,0,0,0,0
1668274803181,ECE 285,A00,103672,Zheng; Yang,0,0,0,0
1668274803181,ECE 285,B00,103673,Sworder; David D.,0,0,0,0
1668274803613,ECE 287,A00,103676,Javidi; Tara,0,0,0,0
1668274804039,MATH 200B,A00,098023,Salehi Golsefidy; Alireza,12,0,15,3
1668274804474,MATH 202B,A00,098024,Rhoades; Brendon Patrick,9,0,15,6
1668274804901,MATH 203B,A00,098025,Oprea; Dragos N.,10,0,15,5
1668274805328,MATH 204B,A00,098026,Sorensen; Claus M,13,0,15,2
1668274805754,MATH 208,A00,098027,Izadi; Elham,7,0,10,3
1668274806179,MATH 209,A00,098028,Pollack; Aaron,10,0,10,0
1668274806604,MATH 211A,A00,112919,Rogalski; Daniel,9,0,10,1
1668274807027,MATH 211B,A00,112920,Seward; Brandon M.,9,0,10,1
1668274807465,MATH 218,A00,098029,Li; Bo,10,0,10,0
1668274807902,MATH 220B,A00,098030,Novak; Jonathan I,11,0,15,4
1668274808326,MATH 221A,A00,098031,Ebenfelt; Peter F,13,0,15,2
1668274808749,MATH 231B,A00,098032,Zlatos; Andrej,12,0,15,3
1668274809176,MATH 240B,A00,098033,Ni; Lei,9,0,15,6
1668274809600,MATH 243,A00,098034,Jekel; David Andrew,10,0,10,0
1668274810023,MATH 245A,A00,098035,Nie; Jiawang,0,0,15,16
1668274810446,MATH 248,A00,098036,Bejenaru; Ioan,10,0,10,0
1668274810870,MATH 250B,A00,098037,Spolaor; Luca,14,0,15,1
1668274811296,MATH 258,A00,098038,Ni; Lei,10,0,10,0
1668274811723,MATH 264B,A00,098041,Rhoades; Brendon Patrick,9,0,15,6
1668274812152,MATH 268,A00,098042,Buss; Samuel R,10,0,10,0
1668274812580,MATH 269,A00,098043,Rhoades; Brendon Patrick,10,0,10,0
1668274813004,MATH 270B,A00,098044,Li; Bo,10,0,15,5
1668274813447,MATH 272B,A00,098045,Holst; Michael J,13,0,15,2
1668274813879,MATH 273A,A00,098046,Tian; Xiaochuan,10,0,15,5
1668274814312,MATH 275,A01,098048,Tian; Xiaochuan,6,0,10,4
1668274814742,MATH 278A,A00,098049,Holst; Michael J,8,0,10,2
1668274815164,MATH 278B,A00,098050,Cloninger; Alexander,10,0,10,0
1668274815587,MATH 278C,A00,098051,Nie; Jiawang,7,0,10,3
1668274816014,MATH 280B,A00,098052,Zheng; Tianyi,9,0,15,6
1668274816441,MATH 281B,A00,098053,Bradic; Jelena,1,0,15,14
1668274816863,MATH 282B,A00,098054,Arias-Castro; Ery,0,0,15,15
1668274817288,MATH 285,A00,098055,Fitzsimmons; Patrick J,0,0,15,17
1668274817713,MATH 287B,A00,098056,Arias-Castro; Ery,2,0,15,13
1668274818136,MATH 288,A00,098057,Agarwal; Pooja,9,0,10,1
1668274818136,MATH 288,B00,098058,Zhang; Danna,8,0,10,2
1668274818136,MATH 288,C00,098059,Williams; Ruth J,10,0,10,0
1668274818559,MATH 290B,A00,098060,Roberts; Justin Deritter,13,0,15,2
1668274818993,MATH 292,A00,098061,Belmont; Eva Kinoshita,10,0,10,0
1668274819418,MATH 295,A00,098062,Suk; Andrew Hoon,48,0,50,2
1668274819851,MATH 296,A00,098063,Novak; Jonathan I,20,0,20,0
1668274820287,MATH 297,001,098064,Gamst; Anthony Collins,9997,0,9999,2
1668275320610,COGS 205,A00,101395,Chiba; Andrea,19,0,20,1
1668275321034,COGS 210B,001,101404,Greene; Deanna Jacquelyn,9998,0,9999,1
1668275321034,COGS 210B,002,101417,Xia; Haijun,9999,0,9999,0
1668275321034,COGS 210B,003,101422,Nitz; Douglas A.,9999,0,9999,0
1668275321034,COGS 210B,004,101423,Hollan; James D.,9998,0,9999,1
1668275321034,COGS 210B,005,101424,Deak; Gedeon O.,9998,0,9999,1
1668275321034,COGS 210B,006,101425,Rossano; Federico,9999,0,9999,0
1668275321457,COGS 211B,A00,101427,Coulson; Seana M,9996,0,9999,3
1668275321882,COGS 220,A00,101428,Hollan; James D.,0,0,25,25
1668275322305,COGS 229,A00,101429,Dow; Steven P,18,0,25,7
1668275322727,COGS 230,A00,101430,Klemmer; Scott R,12,0,17,5
1668275323152,COGS 234,A00,101431,Xia; Haijun,2,0,25,23
1668275323573,COGS 260,A00,101432,Kiyonaga; Anastasia,21,0,25,4
1668275323573,COGS 260,B00,101433,Kirsh; David Joel,15,0,25,10
1668275323999,CSE 202,A00,102371,Impagliazzo; Russell,0,0,0,0
1668275324423,CSE 203B,A01,102373,Cheng; Chung Kuan,0,0,0,0
1668275324853,CSE 208,A00,102374,Micciancio; Daniele,0,0,0,0
1668275325278,CSE 209A,A00,112895,Impagliazzo; Russell,0,0,15,15
1668275325702,CSE 209B,A00,108005,Bellare; Mihir,0,0,0,0
1668275326125,CSE 210,A00,113163,Coblenz; Michael J,0,0,0,0
1668275326551,CSE 219,A00,106111,Dow; Steven P,0,0,20,20
1668275326978,CSE 221,A00,102376,Voelker; Geoffrey M.,0,0,0,0
1668275327402,CSE 224,A01,102378,Porter; George M,0,0,0,0
1668275327825,CSE 229A,A00,102379,Savage; Stefan,0,0,0,0
1668275328251,CSE 229C,A00,102380,Munyaka; Imani N. S.,0,0,0,0
1668275328674,CSE 232B,A00,102382,Deutsch; Alin Bernard,0,0,0,0
1668275329103,CSE 234,A01,112904,Kumar; Arun Kumar,0,0,0,0
1668275329531,CSE 237A,A00,102383,Rosing; Tajana Simunic,0,0,0,0
1668275329954,CSE 239A,A00,102384,Deutsch; Alin Bernard,0,0,0,0
1668275330386,CSE 239B,A00,102385,Polikarpova; Nadezhda,0,0,0,0
1668275330807,CSE 240A,A00,102386,Pannuto; Patrick William,0,0,0,0
1668275331240,CSE 240B,A00,102387,Zhao; Jishen,0,0,0,0
1668275331667,CSE 241A,A00,106406,Kang; Mingu,0,0,0,0
1668275332097,CSE 249B,A00,102388,Kahng; Andrew Byun,0,0,8,8
1668275332522,CSE 251B,A01,102392,Cottrell; Garrison W,0,0,0,0
1668275332522,CSE 251B,A02,102393,Cottrell; Garrison W,0,0,0,0
1668275332960,CSE 252B,A00,102394,Ochoa; Benjamin Lawrence,0,0,0,0
1668275333384,CSE 257,A01,102396,Gao; Sicun,0,0,0,0
1668275333810,CSE 272,A00,102397,Li; Tzumao,0,0,0,0
1668275334232,CSE 274,A00,111323,Chern; Albert Ren-Haur,0,0,0,0
1668275334656,CSE 282,A00,102398,Pevzner; Pavel Arkadjevich,0,0,0,0
1668275335078,CSE 284,A00,114175,Gymrek; Melissa Ann,0,0,0,0
1668275335505,CSE 290,A00,102399,Chandraker; Manmohan Krishna,0,0,0,0
1668275335505,CSE 290,B00,102400,Vaccaro; Kristen Marie,0,0,25,25
1668275335505,CSE 290,C00,102414,Pannuto; Patrick William,0,0,25,25
1668275335505,CSE 290,D00,102427,Pevzner; Pavel Arkadjevich,0,0,0,0
1668275335505,CSE 290,E00,102429,Zhao; Jishen,0,0,0,0
1668275335505,CSE 290,F00,102436,Tullsen; Dean Michael,0,0,0,0
1668275335505,CSE 290,G00,102440,Christensen; Henrik I,0,0,20,20
1668275335928,CSE 291,A00,102443,Su; Hao,0,0,0,0
1668275335928,CSE 291,B00,102448,Polikarpova; Nadezhda,0,0,0,0
1668275335928,CSE 291,C00,102453,Vaccaro; Kristen Marie,0,0,0,0
1668275335928,CSE 291,D00,111343,Savage; Stefan,0,0,0,0
1668275335928,CSE 291,E00,116474,Claffy; Kimberly Claire,0,0,0,0
1668275335928,CSE 291,F00,116479,Pasquale; Joseph,0,0,0,0
1668275336354,CSE 293,001,119111,Bafna; Vineet,9999,0,9999,0
1668275336354,CSE 293,002,119118,Bellare; Mihir,9999,0,9999,0
1668275336354,CSE 293,003,119122,Berg-Kirkpatrick; Taylor D,9999,0,9999,0
1668275336354,CSE 293,004,119135,Christensen; Henrik I,9999,0,9999,0
1668275336354,CSE 293,005,119142,Cottrell; Garrison W,9999,0,9999,0
1668275336354,CSE 293,006,119146,Deutsch; Alin Bernard,9999,0,9999,0
1668275336354,CSE 293,007,119159,Esmaeilzadeh; Hadi,9999,0,9999,0
1668275336354,CSE 293,008,119166,Freund; Yoav,9999,0,9999,0
1668275336354,CSE 293,009,119170,Griswold; William G.,9999,0,9999,0
1668275336354,CSE 293,010,119183,Gymrek; Melissa Ann,9999,0,9999,0
1668275336354,CSE 293,011,119190,Heninger; Nadia A,9999,0,9999,0
1668275336354,CSE 293,012,119230,Impagliazzo; Russell,9999,0,9999,0
1668275336354,CSE 293,013,119232,Jhala; Ranjit,9999,0,9999,0
1668275336354,CSE 293,014,119233,Kahng; Andrew Byun,9999,0,9999,0
1668275336354,CSE 293,015,119298,Kane; Daniel Mertz,9999,0,9999,0
1668275336354,CSE 293,016,119299,Kriegman; David J,9999,0,9999,0
1668275336354,CSE 293,017,119300,Kumar; Arun Kumar,9999,0,9999,0
1668275336354,CSE 293,018,119301,Lerner; Sorin,9999,0,9999,0
1668275336354,CSE 293,019,119302,Lovett; Shachar,9999,0,9999,0
1668275336354,CSE 293,020,119303,McAuley; Julian John,9999,0,9999,0
1668275336354,CSE 293,021,119304,Micciancio; Daniele,9999,0,9999,0
1668275336354,CSE 293,022,119367,Orailoglu; Alex,9999,0,9999,0
1668275336354,CSE 293,023,119382,Paturi; Ramamohan,9999,0,9999,0
1668275336354,CSE 293,024,119404,Polikarpova; Nadezhda,9999,0,9999,0
1668275336354,CSE 293,025,119406,Politz; Joseph Gibbs,9999,0,9999,0
1668275336354,CSE 293,026,119411,Porter; George M,9999,0,9999,0
1668275336354,CSE 293,027,119414,Porter; Leonard Emerson,9999,0,9999,0
1668275336354,CSE 293,028,119416,Ramamoorthi; Ravi,9999,0,9999,0
1668275336354,CSE 293,029,119417,Sahoo; Debashis,9999,0,9999,0
1668275336354,CSE 293,030,119420,Saul; Lawrence,9999,0,9999,0
1668275336354,CSE 293,031,119421,Savage; Stefan,9999,0,9999,0
1668275336354,CSE 293,032,119425,Schulze; Jurgen P.,9999,0,9999,0
1668275336354,CSE 293,033,119426,Snoeren; Alex C.,9999,0,9999,0
1668275336354,CSE 293,034,119428,Shang; Jingbo,9999,0,9999,0
1668275336354,CSE 293,035,119430,Stefan; Deian,9999,0,9999,0
1668275336354,CSE 293,036,119431,Su; Hao,9999,0,9999,0
1668275336354,CSE 293,037,119433,Swanson; Steven James,9999,0,9999,0
1668275336354,CSE 293,038,119435,Tullsen; Dean Michael,9999,0,9999,0
1668275336354,CSE 293,039,119483,Voelker; Geoffrey M.,9999,0,9999,0
1668275336354,CSE 293,040,119537,Zhao; Jishen,9999,0,9999,0
1668275336354,CSE 293,041,119538,Zhou; Yuan-Yuan,9999,0,9999,0
1668275336354,CSE 293,042,119539,Gao; Sicun,9999,0,9999,0
1668275336354,CSE 293,043,119540,Weibel; Nadir,9999,0,9999,0
1668275336354,CSE 293,044,119541,Gupta; Rajesh K.,9999,0,9999,0
1668275336354,CSE 293,045,126410,Vaccaro; Kristen Marie,9999,0,9999,0
1668275336354,CSE 293,046,126411,Klemke; Richard,9999,0,9999,0
1668275336778,CSE 294,A00,102459,Voelker; Geoffrey M.,0,0,0,0
1668275336778,CSE 294,B00,111322,Orailoglu; Alex,0,0,0,0
1668275337213,DSE 201,A00,096914,Deutsch; Alin Bernard,30,0,30,0
1668275337635,DSE 210,A00,096915,Dasgupta; Sanjoy,30,0,30,0
1668275338057,DSE 260A,A00,096916,Altintas De Callaf; Ilkay,30,0,30,0
1668275338519,ECE 200,001,103586,Antipa; Nicholas A,9999,0,9999,0
1668275338519,ECE 200,002,103587,Atanasov; Nikolay A.,9999,0,9999,0
1668275338519,ECE 200,003,103588,Bharadia; Dinesh,9999,0,9999,0
1668275338519,ECE 200,004,103589,Cheng; Chung Kuan,9999,0,9999,0
1668275338519,ECE 200,005,103590,Cosman; Pamela C.,9999,0,9999,0
1668275338519,ECE 200,006,103591,Dayeh; Shadi Ahmad,9999,0,9999,0
1668275338519,ECE 200,007,103592,Fainman; Yeshaiahu,9999,0,9999,0
1668275338519,ECE 200,008,103593,Ford; Joseph Earl,9999,0,9999,0
1668275338519,ECE 200,009,103594,Franceschetti; Massimo,9999,0,9999,0
1668275338519,ECE 200,010,103595,Fullerton; Eric E,9999,0,9999,0
1668275338519,ECE 200,011,103596,Galton; Ian A,9999,0,9999,0
1668275338519,ECE 200,012,103597,Gilja; Vikash,9999,0,9999,0
1668275338519,ECE 200,013,103598,Hall; Drew A.,9999,0,9999,0
1668275338519,ECE 200,014,103599,Hsueh; Tzu-Chien,9999,0,9999,0
1668275338519,ECE 200,015,103600,Javidi; Tara,9999,0,9999,0
1668275338519,ECE 200,016,103601,Kahng; Andrew Byun,9999,0,9999,0
1668275338519,ECE 200,017,103602,Kim; Young-Han,9999,0,9999,0
1668275338519,ECE 200,018,103603,Koushanfar; Farinaz,9999,0,9999,0
1668275338519,ECE 200,019,103604,Kuzum; Duygu,9999,0,9999,0
1668275338519,ECE 200,020,103605,Le; Hanh-Phuc,9999,0,9999,0
1668275338519,ECE 200,021,103606,Lin; Bill,9999,0,9999,0
1668275338519,ECE 200,022,103607,Liu; Zhaowei,9998,0,9999,1
1668275338519,ECE 200,023,103608,Lo; Yu-Hwa,9999,0,9999,0
1668275338519,ECE 200,024,103609,Lomakin; Vitaliy,9999,0,9999,0
1668275338519,ECE 200,025,103610,Mercier; Patrick Philip,9999,0,9999,0
1668275338519,ECE 200,026,103611,Meyer; Florian,9999,0,9999,0
1668275338519,ECE 200,027,103612,Milstein; Laurence B.,9999,0,9999,0
1668275338519,ECE 200,028,103613,Mir Arabbaygi; Siavash,9999,0,9999,0
1668275338519,ECE 200,029,103614,Mookherjea; Shayan,9999,0,9999,0
1668275338519,ECE 200,030,103615,Morris; Karcher William,9999,0,9999,0
1668275338519,ECE 200,031,103616,Ng; Tse Nga,9999,0,9999,0
1668275338519,ECE 200,032,103617,Nguyen; Truong Quang,9999,0,9999,0
1668275338519,ECE 200,033,103618,Nomura; Kenji,9999,0,9999,0
1668275338519,ECE 200,034,103619,Orlitsky; Alon,9999,0,9999,0
1668275338519,ECE 200,035,103620,Pal; Piya,9999,0,9999,0
1668275338519,ECE 200,036,103621,Papen; George C.,9999,0,9999,0
1668275338519,ECE 200,037,103622,Radic; Stojan,9999,0,9999,0
1668275338519,ECE 200,038,103623,Rao; Bhaskar D.,9999,0,9999,0
1668275338519,ECE 200,039,103624,Rao; Ramesh R,9999,0,9999,0
1668275338519,ECE 200,040,103625,Rebeiz; Gabriel,9999,0,9999,0
1668275338519,ECE 200,041,103626,Sanford; John R,9999,0,9999,0
1668275338519,ECE 200,042,103627,Siegel; Paul H.,9999,0,9999,0
1668275338519,ECE 200,043,103628,Sievenpiper; Daniel F.,9999,0,9999,0
1668275338519,ECE 200,044,103629,Sworder; David D.,9999,0,9999,0
1668275338519,ECE 200,045,103630,Taur; Yuan,9999,0,9999,0
1668275338519,ECE 200,046,103631,Touri; Behrouz,9999,0,9999,0
1668275338519,ECE 200,047,103632,Trivedi; Mohan M.,9999,0,9999,0
1668275338519,ECE 200,048,103633,Vasconcelos; Nuno,9999,0,9999,0
1668275338519,ECE 200,049,103634,Wang; Xiaolong,9999,0,9999,0
1668275338519,ECE 200,050,103635,Xie; Pengtao,9999,0,9999,0
1668275338519,ECE 200,051,103636,Yip; Michael,9999,0,9999,0
1668275338519,ECE 200,052,103637,Zeger; Kenneth A.,999,0,999,0
1668275338519,ECE 200,053,103638,Zhang; Xinyu,9999,0,9999,0
1668275338519,ECE 200,054,103639,Turakhia; Yatish Girish,9999,0,9999,0
1668275338519,ECE 200,055,103640,Kang; Mingu,9999,0,9999,0
1668275338519,ECE 200,056,103641,Shi; Yuanyuan,9999,0,9999,0
1668275338519,ECE 200,057,103642,Wang; Edward Jay,9999,0,9999,0
1668275338519,ECE 200,058,103643,Zheng; Yang,9999,0,9999,0
1668275338954,ECE 202,A00,103644,Kuzum; Duygu,0,0,0,0
1668275339393,ECE 212BN,A00,103646,Ng; Tse Nga,0,0,0,0
1668275339821,ECE 221,A00,111493,Staff,0,0,0,0
1668275340251,ECE 222B,A00,103647,Lomakin; Vitaliy,0,0,0,0
1668275340682,ECE 230B,A00,103648,Taur; Yuan,0,0,0,0
1668275341107,ECE 238B,A00,103649,Garay; Javier,0,0,0,0
1668275341530,ECE 240B,A00,112900,Fainman; Yeshaiahu,0,0,0,0
1668275341958,ECE 247A,A00,103650,Jokerst; Jesse Vincent,0,0,0,0
1668275342381,ECE 247B,A00,103651,Wang; Joseph,0,0,0,0
1668275342805,ECE 250,A00,103652,Siegel; Paul H.,0,0,0,0
1668275343229,ECE 251A,A00,103654,Rao; Bhaskar D.,0,0,0,0
1668275343654,ECE 257B,A00,103655,Bharadia; Dinesh,0,0,0,0
1668275344077,ECE 258A,A00,103656,Milstein; Laurence B.,0,0,0,0
1668275344502,ECE 260B,A00,103658,Kang; Mingu,0,0,0,0
1668275344925,ECE 264A,A00,103659,Galton; Ian A,0,0,0,0
1668275345350,ECE 265A,A00,103661,Gudem; Prasad S.S.,0,0,0,0
1668275345783,ECE 265D,A00,103662,Gudem; Prasad S.S.,0,0,0,0
1668275346238,ECE 268,A00,103663,Koushanfar; Farinaz,0,0,0,0
1668275346665,ECE 269,A01,103665,Pal; Piya,0,0,0,0
1668275347101,ECE 271B,A00,103666,Vasconcelos; Manuela,0,0,0,0
1668275347535,ECE 276A,A00,103667,Atanasov; Nikolay A.,0,0,0,0
1668275347968,ECE 277,A00,103668,An; Cheolhong,0,0,0,0
1668275348403,ECE 279,A00,117947,Hall; Drew A.,0,0,0,0
1668275349277,ECE 283,A00,103670,Hsueh; Tzu-Chien,0,0,0,0
1668275349707,ECE 284,A00,103671,Turakhia; Yatish Girish,0,0,0,0
1668275350138,ECE 285,A00,103672,Zheng; Yang,0,0,0,0
1668275350138,ECE 285,B00,103673,Sworder; David D.,0,0,0,0
1668275350580,ECE 287,A00,103676,Javidi; Tara,0,0,0,0
1668275351009,MATH 200B,A00,098023,Salehi Golsefidy; Alireza,12,0,15,3
1668275351432,MATH 202B,A00,098024,Rhoades; Brendon Patrick,9,0,15,6
1668275351854,MATH 203B,A00,098025,Oprea; Dragos N.,10,0,15,5
1668275352277,MATH 204B,A00,098026,Sorensen; Claus M,13,0,15,2
1668275352704,MATH 208,A00,098027,Izadi; Elham,7,0,10,3
1668275353130,MATH 209,A00,098028,Pollack; Aaron,10,0,10,0
1668275353554,MATH 211A,A00,112919,Rogalski; Daniel,9,0,10,1
1668275353980,MATH 211B,A00,112920,Seward; Brandon M.,9,0,10,1
1668275354405,MATH 218,A00,098029,Li; Bo,10,0,10,0
1668275354826,MATH 220B,A00,098030,Novak; Jonathan I,11,0,15,4
1668275355251,MATH 221A,A00,098031,Ebenfelt; Peter F,13,0,15,2
1668275355672,MATH 231B,A00,098032,Zlatos; Andrej,12,0,15,3
1668275356106,MATH 240B,A00,098033,Ni; Lei,9,0,15,6
1668275356531,MATH 243,A00,098034,Jekel; David Andrew,10,0,10,0
1668275356959,MATH 245A,A00,098035,Nie; Jiawang,0,0,15,16
1668275357391,MATH 248,A00,098036,Bejenaru; Ioan,10,0,10,0
1668275357815,MATH 250B,A00,098037,Spolaor; Luca,14,0,15,1
1668275358239,MATH 258,A00,098038,Ni; Lei,10,0,10,0
1668275358663,MATH 264B,A00,098041,Rhoades; Brendon Patrick,9,0,15,6
1668275359089,MATH 268,A00,098042,Buss; Samuel R,10,0,10,0
1668275359519,MATH 269,A00,098043,Rhoades; Brendon Patrick,10,0,10,0
1668275359945,MATH 270B,A00,098044,Li; Bo,10,0,15,5
1668275360368,MATH 272B,A00,098045,Holst; Michael J,13,0,15,2
1668275360791,MATH 273A,A00,098046,Tian; Xiaochuan,10,0,15,5
1668275361220,MATH 275,A01,098048,Tian; Xiaochuan,6,0,10,4
1668275361644,MATH 278A,A00,098049,Holst; Michael J,8,0,10,2
1668275362166,MATH 278B,A00,098050,Cloninger; Alexander,10,0,10,0
1668275362600,MATH 278C,A00,098051,Nie; Jiawang,7,0,10,3
1668275363026,MATH 280B,A00,098052,Zheng; Tianyi,9,0,15,6
1668275363450,MATH 281B,A00,098053,Bradic; Jelena,1,0,15,14
1668275363874,MATH 282B,A00,098054,Arias-Castro; Ery,0,0,15,15
1668275364310,MATH 285,A00,098055,Fitzsimmons; Patrick J,0,0,15,17
1668275364735,MATH 287B,A00,098056,Arias-Castro; Ery,2,0,15,13
1668275365160,MATH 288,A00,098057,Agarwal; Pooja,9,0,10,1
1668275365160,MATH 288,B00,098058,Zhang; Danna,8,0,10,2
1668275365160,MATH 288,C00,098059,Williams; Ruth J,10,0,10,0
1668275365583,MATH 290B,A00,098060,Roberts; Justin Deritter,13,0,15,2
1668275366015,MATH 292,A00,098061,Belmont; Eva Kinoshita,10,0,10,0
1668275366438,MATH 295,A00,098062,Suk; Andrew Hoon,48,0,50,2
1668275366863,MATH 296,A00,098063,Novak; Jonathan I,20,0,20,0
1668275367286,MATH 297,001,098064,Gamst; Anthony Collins,9997,0,9999,2
1668275866352,COGS 205,A00,101395,Chiba; Andrea,19,0,20,1
1668275866774,COGS 210B,001,101404,Greene; Deanna Jacquelyn,9998,0,9999,1
1668275866774,COGS 210B,002,101417,Xia; Haijun,9999,0,9999,0
1668275866774,COGS 210B,003,101422,Nitz; Douglas A.,9999,0,9999,0
1668275866774,COGS 210B,004,101423,Hollan; James D.,9998,0,9999,1
1668275866774,COGS 210B,005,101424,Deak; Gedeon O.,9998,0,9999,1
1668275866774,COGS 210B,006,101425,Rossano; Federico,9999,0,9999,0
1668275867198,COGS 211B,A00,101427,Coulson; Seana M,9996,0,9999,3
1668275867624,COGS 220,A00,101428,Hollan; James D.,0,0,25,25
1668275868051,COGS 229,A00,101429,Dow; Steven P,18,0,25,7
1668275868475,COGS 230,A00,101430,Klemmer; Scott R,12,0,17,5
1668275868898,COGS 234,A00,101431,Xia; Haijun,2,0,25,23
1668275869324,COGS 260,A00,101432,Kiyonaga; Anastasia,21,0,25,4
1668275869324,COGS 260,B00,101433,Kirsh; David Joel,15,0,25,10
1668275869750,CSE 202,A00,102371,Impagliazzo; Russell,0,0,0,0
1668275870174,CSE 203B,A01,102373,Cheng; Chung Kuan,0,0,0,0
1668275870605,CSE 208,A00,102374,Micciancio; Daniele,0,0,0,0
1668275871030,CSE 209A,A00,112895,Impagliazzo; Russell,0,0,15,15
1668275871457,CSE 209B,A00,108005,Bellare; Mihir,0,0,0,0
1668275871882,CSE 210,A00,113163,Coblenz; Michael J,0,0,0,0
1668275872309,CSE 219,A00,106111,Dow; Steven P,0,0,20,20
1668275872735,CSE 221,A00,102376,Voelker; Geoffrey M.,0,0,0,0
1668275873163,CSE 224,A01,102378,Porter; George M,0,0,0,0
1668275873586,CSE 229A,A00,102379,Savage; Stefan,0,0,0,0
1668275874013,CSE 229C,A00,102380,Munyaka; Imani N. S.,0,0,0,0
1668275874437,CSE 232B,A00,102382,Deutsch; Alin Bernard,0,0,0,0
1668275874861,CSE 234,A01,112904,Kumar; Arun Kumar,0,0,0,0
1668275875286,CSE 237A,A00,102383,Rosing; Tajana Simunic,0,0,0,0
1668275875712,CSE 239A,A00,102384,Deutsch; Alin Bernard,0,0,0,0
1668275876137,CSE 239B,A00,102385,Polikarpova; Nadezhda,0,0,0,0
1668275876564,CSE 240A,A00,102386,Pannuto; Patrick William,0,0,0,0
1668275876991,CSE 240B,A00,102387,Zhao; Jishen,0,0,0,0
1668275877415,CSE 241A,A00,106406,Kang; Mingu,0,0,0,0
1668275877838,CSE 249B,A00,102388,Kahng; Andrew Byun,0,0,8,8
1668275878262,CSE 251B,A01,102392,Cottrell; Garrison W,0,0,0,0
1668275878262,CSE 251B,A02,102393,Cottrell; Garrison W,0,0,0,0
1668275878686,CSE 252B,A00,102394,Ochoa; Benjamin Lawrence,0,0,0,0
1668275879115,CSE 257,A01,102396,Gao; Sicun,0,0,0,0
1668275879541,CSE 272,A00,102397,Li; Tzumao,0,0,0,0
1668275879968,CSE 274,A00,111323,Chern; Albert Ren-Haur,0,0,0,0
1668275880392,CSE 282,A00,102398,Pevzner; Pavel Arkadjevich,0,0,0,0
1668275880815,CSE 284,A00,114175,Gymrek; Melissa Ann,0,0,0,0
1668275881327,CSE 290,A00,102399,Chandraker; Manmohan Krishna,0,0,0,0
1668275881327,CSE 290,B00,102400,Vaccaro; Kristen Marie,0,0,25,25
1668275881327,CSE 290,C00,102414,Pannuto; Patrick William,0,0,25,25
1668275881327,CSE 290,D00,102427,Pevzner; Pavel Arkadjevich,0,0,0,0
1668275881327,CSE 290,E00,102429,Zhao; Jishen,0,0,0,0
1668275881327,CSE 290,F00,102436,Tullsen; Dean Michael,0,0,0,0
1668275881327,CSE 290,G00,102440,Christensen; Henrik I,0,0,20,20
1668275881753,CSE 291,A00,102443,Su; Hao,0,0,0,0
1668275881753,CSE 291,B00,102448,Polikarpova; Nadezhda,0,0,0,0
1668275881753,CSE 291,C00,102453,Vaccaro; Kristen Marie,0,0,0,0
1668275881753,CSE 291,D00,111343,Savage; Stefan,0,0,0,0
1668275881753,CSE 291,E00,116474,Claffy; Kimberly Claire,0,0,0,0
1668275881753,CSE 291,F00,116479,Pasquale; Joseph,0,0,0,0
1668275882187,CSE 293,001,119111,Bafna; Vineet,9999,0,9999,0
1668275882187,CSE 293,002,119118,Bellare; Mihir,9999,0,9999,0
1668275882187,CSE 293,003,119122,Berg-Kirkpatrick; Taylor D,9999,0,9999,0
1668275882187,CSE 293,004,119135,Christensen; Henrik I,9999,0,9999,0
1668275882187,CSE 293,005,119142,Cottrell; Garrison W,9999,0,9999,0
1668275882187,CSE 293,006,119146,Deutsch; Alin Bernard,9999,0,9999,0
1668275882187,CSE 293,007,119159,Esmaeilzadeh; Hadi,9999,0,9999,0
1668275882187,CSE 293,008,119166,Freund; Yoav,9999,0,9999,0
1668275882187,CSE 293,009,119170,Griswold; William G.,9999,0,9999,0
1668275882187,CSE 293,010,119183,Gymrek; Melissa Ann,9999,0,9999,0
1668275882187,CSE 293,011,119190,Heninger; Nadia A,9999,0,9999,0
1668275882187,CSE 293,012,119230,Impagliazzo; Russell,9999,0,9999,0
1668275882187,CSE 293,013,119232,Jhala; Ranjit,9999,0,9999,0
1668275882187,CSE 293,014,119233,Kahng; Andrew Byun,9999,0,9999,0
1668275882187,CSE 293,015,119298,Kane; Daniel Mertz,9999,0,9999,0
1668275882187,CSE 293,016,119299,Kriegman; David J,9999,0,9999,0
1668275882187,CSE 293,017,119300,Kumar; Arun Kumar,9999,0,9999,0
1668275882187,CSE 293,018,119301,Lerner; Sorin,9999,0,9999,0
1668275882187,CSE 293,019,119302,Lovett; Shachar,9999,0,9999,0
1668275882187,CSE 293,020,119303,McAuley; Julian John,9999,0,9999,0
1668275882187,CSE 293,021,119304,Micciancio; Daniele,9999,0,9999,0
1668275882187,CSE 293,022,119367,Orailoglu; Alex,9999,0,9999,0
1668275882187,CSE 293,023,119382,Paturi; Ramamohan,9999,0,9999,0
1668275882187,CSE 293,024,119404,Polikarpova; Nadezhda,9999,0,9999,0
1668275882187,CSE 293,025,119406,Politz; Joseph Gibbs,9999,0,9999,0
1668275882187,CSE 293,026,119411,Porter; George M,9999,0,9999,0
1668275882187,CSE 293,027,119414,Porter; Leonard Emerson,9999,0,9999,0
1668275882187,CSE 293,028,119416,Ramamoorthi; Ravi,9999,0,9999,0
1668275882187,CSE 293,029,119417,Sahoo; Debashis,9999,0,9999,0
1668275882187,CSE 293,030,119420,Saul; Lawrence,9999,0,9999,0
1668275882187,CSE 293,031,119421,Savage; Stefan,9999,0,9999,0
1668275882187,CSE 293,032,119425,Schulze; Jurgen P.,9999,0,9999,0
1668275882187,CSE 293,033,119426,Snoeren; Alex C.,9999,0,9999,0
1668275882187,CSE 293,034,119428,Shang; Jingbo,9999,0,9999,0
1668275882187,CSE 293,035,119430,Stefan; Deian,9999,0,9999,0
1668275882187,CSE 293,036,119431,Su; Hao,9999,0,9999,0
1668275882187,CSE 293,037,119433,Swanson; Steven James,9999,0,9999,0
1668275882187,CSE 293,038,119435,Tullsen; Dean Michael,9999,0,9999,0
1668275882187,CSE 293,039,119483,Voelker; Geoffrey M.,9999,0,9999,0
1668275882187,CSE 293,040,119537,Zhao; Jishen,9999,0,9999,0
1668275882187,CSE 293,041,119538,Zhou; Yuan-Yuan,9999,0,9999,0
1668275882187,CSE 293,042,119539,Gao; Sicun,9999,0,9999,0
1668275882187,CSE 293,043,119540,Weibel; Nadir,9999,0,9999,0
1668275882187,CSE 293,044,119541,Gupta; Rajesh K.,9999,0,9999,0
1668275882187,CSE 293,045,126410,Vaccaro; Kristen Marie,9999,0,9999,0
1668275882187,CSE 293,046,126411,Klemke; Richard,9999,0,9999,0
1668275882610,CSE 294,A00,102459,Voelker; Geoffrey M.,0,0,0,0
1668275882610,CSE 294,B00,111322,Orailoglu; Alex,0,0,0,0
1668275883034,DSE 201,A00,096914,Deutsch; Alin Bernard,30,0,30,0
1668275883456,DSE 210,A00,096915,Dasgupta; Sanjoy,30,0,30,0
1668275883883,DSE 260A,A00,096916,Altintas De Callaf; Ilkay,30,0,30,0
1668275884312,ECE 200,001,103586,Antipa; Nicholas A,9999,0,9999,0
1668275884312,ECE 200,002,103587,Atanasov; Nikolay A.,9999,0,9999,0
1668275884312,ECE 200,003,103588,Bharadia; Dinesh,9999,0,9999,0
1668275884312,ECE 200,004,103589,Cheng; Chung Kuan,9999,0,9999,0
1668275884312,ECE 200,005,103590,Cosman; Pamela C.,9999,0,9999,0
1668275884312,ECE 200,006,103591,Dayeh; Shadi Ahmad,9999,0,9999,0
1668275884312,ECE 200,007,103592,Fainman; Yeshaiahu,9999,0,9999,0
1668275884312,ECE 200,008,103593,Ford; Joseph Earl,9999,0,9999,0
1668275884312,ECE 200,009,103594,Franceschetti; Massimo,9999,0,9999,0
1668275884312,ECE 200,010,103595,Fullerton; Eric E,9999,0,9999,0
1668275884312,ECE 200,011,103596,Galton; Ian A,9999,0,9999,0
1668275884312,ECE 200,012,103597,Gilja; Vikash,9999,0,9999,0
1668275884312,ECE 200,013,103598,Hall; Drew A.,9999,0,9999,0
1668275884312,ECE 200,014,103599,Hsueh; Tzu-Chien,9999,0,9999,0
1668275884312,ECE 200,015,103600,Javidi; Tara,9999,0,9999,0
1668275884312,ECE 200,016,103601,Kahng; Andrew Byun,9999,0,9999,0
1668275884312,ECE 200,017,103602,Kim; Young-Han,9999,0,9999,0
1668275884312,ECE 200,018,103603,Koushanfar; Farinaz,9999,0,9999,0
1668275884312,ECE 200,019,103604,Kuzum; Duygu,9999,0,9999,0
1668275884312,ECE 200,020,103605,Le; Hanh-Phuc,9999,0,9999,0
1668275884312,ECE 200,021,103606,Lin; Bill,9999,0,9999,0
1668275884312,ECE 200,022,103607,Liu; Zhaowei,9998,0,9999,1
1668275884312,ECE 200,023,103608,Lo; Yu-Hwa,9999,0,9999,0
1668275884312,ECE 200,024,103609,Lomakin; Vitaliy,9999,0,9999,0
1668275884312,ECE 200,025,103610,Mercier; Patrick Philip,9999,0,9999,0
1668275884312,ECE 200,026,103611,Meyer; Florian,9999,0,9999,0
1668275884312,ECE 200,027,103612,Milstein; Laurence B.,9999,0,9999,0
1668275884312,ECE 200,028,103613,Mir Arabbaygi; Siavash,9999,0,9999,0
1668275884312,ECE 200,029,103614,Mookherjea; Shayan,9999,0,9999,0
1668275884312,ECE 200,030,103615,Morris; Karcher William,9999,0,9999,0
1668275884312,ECE 200,031,103616,Ng; Tse Nga,9999,0,9999,0
1668275884312,ECE 200,032,103617,Nguyen; Truong Quang,9999,0,9999,0
1668275884312,ECE 200,033,103618,Nomura; Kenji,9999,0,9999,0
1668275884312,ECE 200,034,103619,Orlitsky; Alon,9999,0,9999,0
1668275884312,ECE 200,035,103620,Pal; Piya,9999,0,9999,0
1668275884312,ECE 200,036,103621,Papen; George C.,9999,0,9999,0
1668275884312,ECE 200,037,103622,Radic; Stojan,9999,0,9999,0
1668275884312,ECE 200,038,103623,Rao; Bhaskar D.,9999,0,9999,0
1668275884312,ECE 200,039,103624,Rao; Ramesh R,9999,0,9999,0
1668275884312,ECE 200,040,103625,Rebeiz; Gabriel,9999,0,9999,0
1668275884312,ECE 200,041,103626,Sanford; John R,9999,0,9999,0
1668275884312,ECE 200,042,103627,Siegel; Paul H.,9999,0,9999,0
1668275884312,ECE 200,043,103628,Sievenpiper; Daniel F.,9999,0,9999,0
1668275884312,ECE 200,044,103629,Sworder; David D.,9999,0,9999,0
1668275884312,ECE 200,045,103630,Taur; Yuan,9999,0,9999,0
1668275884312,ECE 200,046,103631,Touri; Behrouz,9999,0,9999,0
1668275884312,ECE 200,047,103632,Trivedi; Mohan M.,9999,0,9999,0
1668275884312,ECE 200,048,103633,Vasconcelos; Nuno,9999,0,9999,0
1668275884312,ECE 200,049,103634,Wang; Xiaolong,9999,0,9999,0
1668275884312,ECE 200,050,103635,Xie; Pengtao,9999,0,9999,0
1668275884312,ECE 200,051,103636,Yip; Michael,9999,0,9999,0
1668275884312,ECE 200,052,103637,Zeger; Kenneth A.,999,0,999,0
1668275884312,ECE 200,053,103638,Zhang; Xinyu,9999,0,9999,0
1668275884312,ECE 200,054,103639,Turakhia; Yatish Girish,9999,0,9999,0
1668275884312,ECE 200,055,103640,Kang; Mingu,9999,0,9999,0
1668275884312,ECE 200,056,103641,Shi; Yuanyuan,9999,0,9999,0
1668275884312,ECE 200,057,103642,Wang; Edward Jay,9999,0,9999,0
1668275884312,ECE 200,058,103643,Zheng; Yang,9999,0,9999,0
1668275884736,ECE 202,A00,103644,Kuzum; Duygu,0,0,0,0
1668275885160,ECE 212BN,A00,103646,Ng; Tse Nga,0,0,0,0
1668275885585,ECE 221,A00,111493,Staff,0,0,0,0
1668275886008,ECE 222B,A00,103647,Lomakin; Vitaliy,0,0,0,0
1668275886429,ECE 230B,A00,103648,Taur; Yuan,0,0,0,0
1668275886852,ECE 238B,A00,103649,Garay; Javier,0,0,0,0
1668275887278,ECE 240B,A00,112900,Fainman; Yeshaiahu,0,0,0,0
1668275887705,ECE 247A,A00,103650,Jokerst; Jesse Vincent,0,0,0,0
1668275888128,ECE 247B,A00,103651,Wang; Joseph,0,0,0,0
1668275888556,ECE 250,A00,103652,Siegel; Paul H.,0,0,0,0
1668275888982,ECE 251A,A00,103654,Rao; Bhaskar D.,0,0,0,0
1668275889406,ECE 257B,A00,103655,Bharadia; Dinesh,0,0,0,0
1668275889830,ECE 258A,A00,103656,Milstein; Laurence B.,0,0,0,0
1668275890255,ECE 260B,A00,103658,Kang; Mingu,0,0,0,0
1668275890684,ECE 264A,A00,103659,Galton; Ian A,0,0,0,0
1668275891108,ECE 265A,A00,103661,Gudem; Prasad S.S.,0,0,0,0
1668275891530,ECE 265D,A00,103662,Gudem; Prasad S.S.,0,0,0,0
1668275891953,ECE 268,A00,103663,Koushanfar; Farinaz,0,0,0,0
1668275892380,ECE 269,A01,103665,Pal; Piya,0,0,0,0
1668275892803,ECE 271B,A00,103666,Vasconcelos; Manuela,0,0,0,0
1668275893227,ECE 276A,A00,103667,Atanasov; Nikolay A.,0,0,0,0
1668275893652,ECE 277,A00,103668,An; Cheolhong,0,0,0,0
1668275894074,ECE 279,A00,117947,Hall; Drew A.,0,0,0,0
1668275894927,ECE 283,A00,103670,Hsueh; Tzu-Chien,0,0,0,0
1668275895355,ECE 284,A00,103671,Turakhia; Yatish Girish,0,0,0,0
1668275895777,ECE 285,A00,103672,Zheng; Yang,0,0,0,0
1668275895777,ECE 285,B00,103673,Sworder; David D.,0,0,0,0
1668275896201,ECE 287,A00,103676,Javidi; Tara,0,0,0,0
1668275896629,MATH 200B,A00,098023,Salehi Golsefidy; Alireza,12,0,15,3
1668275897052,MATH 202B,A00,098024,Rhoades; Brendon Patrick,9,0,15,6
1668275897475,MATH 203B,A00,098025,Oprea; Dragos N.,10,0,15,5
1668275897900,MATH 204B,A00,098026,Sorensen; Claus M,13,0,15,2
1668275898326,MATH 208,A00,098027,Izadi; Elham,7,0,10,3
1668275898750,MATH 209,A00,098028,Pollack; Aaron,10,0,10,0
1668275899177,MATH 211A,A00,112919,Rogalski; Daniel,9,0,10,1
1668275899602,MATH 211B,A00,112920,Seward; Brandon M.,9,0,10,1
1668275900025,MATH 218,A00,098029,Li; Bo,10,0,10,0
1668275900449,MATH 220B,A00,098030,Novak; Jonathan I,11,0,15,4
1668275900873,MATH 221A,A00,098031,Ebenfelt; Peter F,13,0,15,2
1668275901299,MATH 231B,A00,098032,Zlatos; Andrej,12,0,15,3
1668275901723,MATH 240B,A00,098033,Ni; Lei,9,0,15,6
1668275902149,MATH 243,A00,098034,Jekel; David Andrew,10,0,10,0
1668275902576,MATH 245A,A00,098035,Nie; Jiawang,0,0,15,16
1668275902999,MATH 248,A00,098036,Bejenaru; Ioan,10,0,10,0
1668275903435,MATH 250B,A00,098037,Spolaor; Luca,14,0,15,1
1668275903861,MATH 258,A00,098038,Ni; Lei,10,0,10,0
1668275904285,MATH 264B,A00,098041,Rhoades; Brendon Patrick,9,0,15,6
1668275904711,MATH 268,A00,098042,Buss; Samuel R,10,0,10,0
1668275905134,MATH 269,A00,098043,Rhoades; Brendon Patrick,10,0,10,0
1668275905560,MATH 270B,A00,098044,Li; Bo,10,0,15,5
1668275905987,MATH 272B,A00,098045,Holst; Michael J,13,0,15,2
1668275906415,MATH 273A,A00,098046,Tian; Xiaochuan,10,0,15,5
1668275906839,MATH 275,A01,098048,Tian; Xiaochuan,6,0,10,4
1668275907261,MATH 278A,A00,098049,Holst; Michael J,8,0,10,2
1668275907682,MATH 278B,A00,098050,Cloninger; Alexander,10,0,10,0
1668275908108,MATH 278C,A00,098051,Nie; Jiawang,7,0,10,3
1668275908535,MATH 280B,A00,098052,Zheng; Tianyi,9,0,15,6
1668275908958,MATH 281B,A00,098053,Bradic; Jelena,1,0,15,14
1668275909381,MATH 282B,A00,098054,Arias-Castro; Ery,0,0,15,15
1668275909818,MATH 285,A00,098055,Fitzsimmons; Patrick J,0,0,15,17
1668275910242,MATH 287B,A00,098056,Arias-Castro; Ery,2,0,15,13
1668275910667,MATH 288,A00,098057,Agarwal; Pooja,9,0,10,1
1668275910667,MATH 288,B00,098058,Zhang; Danna,8,0,10,2
1668275910667,MATH 288,C00,098059,Williams; Ruth J,10,0,10,0
1668275911094,MATH 290B,A00,098060,Roberts; Justin Deritter,13,0,15,2
1668275911518,MATH 292,A00,098061,Belmont; Eva Kinoshita,10,0,10,0
1668275911943,MATH 295,A00,098062,Suk; Andrew Hoon,48,0,50,2
1668275912370,MATH 296,A00,098063,Novak; Jonathan I,20,0,20,0
1668275912796,MATH 297,001,098064,Gamst; Anthony Collins,9997,0,9999,2
1668276411453,COGS 205,A00,101395,Chiba; Andrea,19,0,20,1
1668276411878,COGS 210B,001,101404,Greene; Deanna Jacquelyn,9998,0,9999,1
1668276411878,COGS 210B,002,101417,Xia; Haijun,9999,0,9999,0
1668276411878,COGS 210B,003,101422,Nitz; Douglas A.,9999,0,9999,0
1668276411878,COGS 210B,004,101423,Hollan; James D.,9998,0,9999,1
1668276411878,COGS 210B,005,101424,Deak; Gedeon O.,9998,0,9999,1
1668276411878,COGS 210B,006,101425,Rossano; Federico,9999,0,9999,0
1668276412304,COGS 211B,A00,101427,Coulson; Seana M,9996,0,9999,3
1668276412728,COGS 220,A00,101428,Hollan; James D.,0,0,25,25
1668276413160,COGS 229,A00,101429,Dow; Steven P,18,0,25,7
1668276413583,COGS 230,A00,101430,Klemmer; Scott R,12,0,17,5
1668276414008,COGS 234,A00,101431,Xia; Haijun,2,0,25,23
1668276414432,COGS 260,A00,101432,Kiyonaga; Anastasia,21,0,25,4
1668276414432,COGS 260,B00,101433,Kirsh; David Joel,15,0,25,10
1668276414857,CSE 202,A00,102371,Impagliazzo; Russell,0,0,0,0
1668276415283,CSE 203B,A01,102373,Cheng; Chung Kuan,0,0,0,0
1668276415706,CSE 208,A00,102374,Micciancio; Daniele,0,0,0,0
1668276416128,CSE 209A,A00,112895,Impagliazzo; Russell,0,0,15,15
1668276416557,CSE 209B,A00,108005,Bellare; Mihir,0,0,0,0
1668276416983,CSE 210,A00,113163,Coblenz; Michael J,0,0,0,0
1668276417413,CSE 219,A00,106111,Dow; Steven P,0,0,20,20
1668276417840,CSE 221,A00,102376,Voelker; Geoffrey M.,0,0,0,0
1668276418266,CSE 224,A01,102378,Porter; George M,0,0,0,0
1668276418689,CSE 229A,A00,102379,Savage; Stefan,0,0,0,0
1668276419113,CSE 229C,A00,102380,Munyaka; Imani N. S.,0,0,0,0
1668276419536,CSE 232B,A00,102382,Deutsch; Alin Bernard,0,0,0,0
1668276419959,CSE 234,A01,112904,Kumar; Arun Kumar,0,0,0,0
1668276420382,CSE 237A,A00,102383,Rosing; Tajana Simunic,0,0,0,0
1668276420807,CSE 239A,A00,102384,Deutsch; Alin Bernard,0,0,0,0
1668276421230,CSE 239B,A00,102385,Polikarpova; Nadezhda,0,0,0,0
1668276421652,CSE 240A,A00,102386,Pannuto; Patrick William,0,0,0,0
1668276422078,CSE 240B,A00,102387,Zhao; Jishen,0,0,0,0
1668276422504,CSE 241A,A00,106406,Kang; Mingu,0,0,0,0
1668276422935,CSE 249B,A00,102388,Kahng; Andrew Byun,0,0,8,8
1668276423358,CSE 251B,A01,102392,Cottrell; Garrison W,0,0,0,0
1668276423358,CSE 251B,A02,102393,Cottrell; Garrison W,0,0,0,0
1668276423782,CSE 252B,A00,102394,Ochoa; Benjamin Lawrence,0,0,0,0
1668276424207,CSE 257,A01,102396,Gao; Sicun,0,0,0,0
1668276424630,CSE 272,A00,102397,Li; Tzumao,0,0,0,0
1668276425057,CSE 274,A00,111323,Chern; Albert Ren-Haur,0,0,0,0
1668276425481,CSE 282,A00,102398,Pevzner; Pavel Arkadjevich,0,0,0,0
1668276425913,CSE 284,A00,114175,Gymrek; Melissa Ann,0,0,0,0
1668276426336,CSE 290,A00,102399,Chandraker; Manmohan Krishna,0,0,0,0
1668276426336,CSE 290,B00,102400,Vaccaro; Kristen Marie,0,0,25,25
1668276426336,CSE 290,C00,102414,Pannuto; Patrick William,0,0,25,25
1668276426336,CSE 290,D00,102427,Pevzner; Pavel Arkadjevich,0,0,0,0
1668276426336,CSE 290,E00,102429,Zhao; Jishen,0,0,0,0
1668276426336,CSE 290,F00,102436,Tullsen; Dean Michael,0,0,0,0
1668276426336,CSE 290,G00,102440,Christensen; Henrik I,0,0,20,20
1668276426759,CSE 291,A00,102443,Su; Hao,0,0,0,0
1668276426759,CSE 291,B00,102448,Polikarpova; Nadezhda,0,0,0,0
1668276426759,CSE 291,C00,102453,Vaccaro; Kristen Marie,0,0,0,0
1668276426759,CSE 291,D00,111343,Savage; Stefan,0,0,0,0
1668276426759,CSE 291,E00,116474,Claffy; Kimberly Claire,0,0,0,0
1668276426759,CSE 291,F00,116479,Pasquale; Joseph,0,0,0,0
1668276427203,CSE 293,001,119111,Bafna; Vineet,9999,0,9999,0
1668276427203,CSE 293,002,119118,Bellare; Mihir,9999,0,9999,0
1668276427203,CSE 293,003,119122,Berg-Kirkpatrick; Taylor D,9999,0,9999,0
1668276427203,CSE 293,004,119135,Christensen; Henrik I,9999,0,9999,0
1668276427203,CSE 293,005,119142,Cottrell; Garrison W,9999,0,9999,0
1668276427203,CSE 293,006,119146,Deutsch; Alin Bernard,9999,0,9999,0
1668276427203,CSE 293,007,119159,Esmaeilzadeh; Hadi,9999,0,9999,0
1668276427203,CSE 293,008,119166,Freund; Yoav,9999,0,9999,0
1668276427203,CSE 293,009,119170,Griswold; William G.,9999,0,9999,0
1668276427203,CSE 293,010,119183,Gymrek; Melissa Ann,9999,0,9999,0
1668276427203,CSE 293,011,119190,Heninger; Nadia A,9999,0,9999,0
1668276427203,CSE 293,012,119230,Impagliazzo; Russell,9999,0,9999,0
1668276427203,CSE 293,013,119232,Jhala; Ranjit,9999,0,9999,0
1668276427203,CSE 293,014,119233,Kahng; Andrew Byun,9999,0,9999,0
1668276427203,CSE 293,015,119298,Kane; Daniel Mertz,9999,0,9999,0
1668276427203,CSE 293,016,119299,Kriegman; David J,9999,0,9999,0
1668276427203,CSE 293,017,119300,Kumar; Arun Kumar,9999,0,9999,0
1668276427203,CSE 293,018,119301,Lerner; Sorin,9999,0,9999,0
1668276427203,CSE 293,019,119302,Lovett; Shachar,9999,0,9999,0
1668276427203,CSE 293,020,119303,McAuley; Julian John,9999,0,9999,0
1668276427203,CSE 293,021,119304,Micciancio; Daniele,9999,0,9999,0
1668276427203,CSE 293,022,119367,Orailoglu; Alex,9999,0,9999,0
1668276427203,CSE 293,023,119382,Paturi; Ramamohan,9999,0,9999,0
1668276427203,CSE 293,024,119404,Polikarpova; Nadezhda,9999,0,9999,0
1668276427203,CSE 293,025,119406,Politz; Joseph Gibbs,9999,0,9999,0
1668276427203,CSE 293,026,119411,Porter; George M,9999,0,9999,0
1668276427203,CSE 293,027,119414,Porter; Leonard Emerson,9999,0,9999,0
1668276427203,CSE 293,028,119416,Ramamoorthi; Ravi,9999,0,9999,0
1668276427203,CSE 293,029,119417,Sahoo; Debashis,9999,0,9999,0
1668276427203,CSE 293,030,119420,Saul; Lawrence,9999,0,9999,0
1668276427203,CSE 293,031,119421,Savage; Stefan,9999,0,9999,0
1668276427203,CSE 293,032,119425,Schulze; Jurgen P.,9999,0,9999,0
1668276427203,CSE 293,033,119426,Snoeren; Alex C.,9999,0,9999,0
1668276427203,CSE 293,034,119428,Shang; Jingbo,9999,0,9999,0
1668276427203,CSE 293,035,119430,Stefan; Deian,9999,0,9999,0
1668276427203,CSE 293,036,119431,Su; Hao,9999,0,9999,0
1668276427203,CSE 293,037,119433,Swanson; Steven James,9999,0,9999,0
1668276427203,CSE 293,038,119435,Tullsen; Dean Michael,9999,0,9999,0
1668276427203,CSE 293,039,119483,Voelker; Geoffrey M.,9999,0,9999,0
1668276427203,CSE 293,040,119537,Zhao; Jishen,9999,0,9999,0
1668276427203,CSE 293,041,119538,Zhou; Yuan-Yuan,9999,0,9999,0
1668276427203,CSE 293,042,119539,Gao; Sicun,9999,0,9999,0
1668276427203,CSE 293,043,119540,Weibel; Nadir,9999,0,9999,0
1668276427203,CSE 293,044,119541,Gupta; Rajesh K.,9999,0,9999,0
1668276427203,CSE 293,045,126410,Vaccaro; Kristen Marie,9999,0,9999,0
1668276427203,CSE 293,046,126411,Klemke; Richard,9999,0,9999,0
1668276427626,CSE 294,A00,102459,Voelker; Geoffrey M.,0,0,0,0
1668276427626,CSE 294,B00,111322,Orailoglu; Alex,0,0,0,0
1668276428049,DSE 201,A00,096914,Deutsch; Alin Bernard,30,0,30,0
1668276428474,DSE 210,A00,096915,Dasgupta; Sanjoy,30,0,30,0
1668276428901,DSE 260A,A00,096916,Altintas De Callaf; Ilkay,30,0,30,0
1668276429335,ECE 200,001,103586,Antipa; Nicholas A,9999,0,9999,0
1668276429335,ECE 200,002,103587,Atanasov; Nikolay A.,9999,0,9999,0
1668276429335,ECE 200,003,103588,Bharadia; Dinesh,9999,0,9999,0
1668276429335,ECE 200,004,103589,Cheng; Chung Kuan,9999,0,9999,0
1668276429335,ECE 200,005,103590,Cosman; Pamela C.,9999,0,9999,0
1668276429335,ECE 200,006,103591,Dayeh; Shadi Ahmad,9999,0,9999,0
1668276429335,ECE 200,007,103592,Fainman; Yeshaiahu,9999,0,9999,0
1668276429335,ECE 200,008,103593,Ford; Joseph Earl,9999,0,9999,0
1668276429335,ECE 200,009,103594,Franceschetti; Massimo,9999,0,9999,0
1668276429335,ECE 200,010,103595,Fullerton; Eric E,9999,0,9999,0
1668276429335,ECE 200,011,103596,Galton; Ian A,9999,0,9999,0
1668276429335,ECE 200,012,103597,Gilja; Vikash,9999,0,9999,0
1668276429335,ECE 200,013,103598,Hall; Drew A.,9999,0,9999,0
1668276429335,ECE 200,014,103599,Hsueh; Tzu-Chien,9999,0,9999,0
1668276429335,ECE 200,015,103600,Javidi; Tara,9999,0,9999,0
1668276429335,ECE 200,016,103601,Kahng; Andrew Byun,9999,0,9999,0
1668276429335,ECE 200,017,103602,Kim; Young-Han,9999,0,9999,0
1668276429335,ECE 200,018,103603,Koushanfar; Farinaz,9999,0,9999,0
1668276429335,ECE 200,019,103604,Kuzum; Duygu,9999,0,9999,0
1668276429335,ECE 200,020,103605,Le; Hanh-Phuc,9999,0,9999,0
1668276429335,ECE 200,021,103606,Lin; Bill,9999,0,9999,0
1668276429335,ECE 200,022,103607,Liu; Zhaowei,9998,0,9999,1
1668276429335,ECE 200,023,103608,Lo; Yu-Hwa,9999,0,9999,0
1668276429335,ECE 200,024,103609,Lomakin; Vitaliy,9999,0,9999,0
1668276429335,ECE 200,025,103610,Mercier; Patrick Philip,9999,0,9999,0
1668276429335,ECE 200,026,103611,Meyer; Florian,9999,0,9999,0
1668276429335,ECE 200,027,103612,Milstein; Laurence B.,9999,0,9999,0
1668276429335,ECE 200,028,103613,Mir Arabbaygi; Siavash,9999,0,9999,0
1668276429335,ECE 200,029,103614,Mookherjea; Shayan,9999,0,9999,0
1668276429335,ECE 200,030,103615,Morris; Karcher William,9999,0,9999,0
1668276429335,ECE 200,031,103616,Ng; Tse Nga,9999,0,9999,0
1668276429335,ECE 200,032,103617,Nguyen; Truong Quang,9999,0,9999,0
1668276429335,ECE 200,033,103618,Nomura; Kenji,9999,0,9999,0
1668276429335,ECE 200,034,103619,Orlitsky; Alon,9999,0,9999,0
1668276429335,ECE 200,035,103620,Pal; Piya,9999,0,9999,0
1668276429335,ECE 200,036,103621,Papen; George C.,9999,0,9999,0
1668276429335,ECE 200,037,103622,Radic; Stojan,9999,0,9999,0
1668276429335,ECE 200,038,103623,Rao; Bhaskar D.,9999,0,9999,0
1668276429335,ECE 200,039,103624,Rao; Ramesh R,9999,0,9999,0
1668276429335,ECE 200,040,103625,Rebeiz; Gabriel,9999,0,9999,0
1668276429335,ECE 200,041,103626,Sanford; John R,9999,0,9999,0
1668276429335,ECE 200,042,103627,Siegel; Paul H.,9999,0,9999,0
1668276429335,ECE 200,043,103628,Sievenpiper; Daniel F.,9999,0,9999,0
1668276429335,ECE 200,044,103629,Sworder; David D.,9999,0,9999,0
1668276429335,ECE 200,045,103630,Taur; Yuan,9999,0,9999,0
1668276429335,ECE 200,046,103631,Touri; Behrouz,9999,0,9999,0
1668276429335,ECE 200,047,103632,Trivedi; Mohan M.,9999,0,9999,0
1668276429335,ECE 200,048,103633,Vasconcelos; Nuno,9999,0,9999,0
1668276429335,ECE 200,049,103634,Wang; Xiaolong,9999,0,9999,0
1668276429335,ECE 200,050,103635,Xie; Pengtao,9999,0,9999,0
1668276429335,ECE 200,051,103636,Yip; Michael,9999,0,9999,0
1668276429335,ECE 200,052,103637,Zeger; Kenneth A.,999,0,999,0
1668276429335,ECE 200,053,103638,Zhang; Xinyu,9999,0,9999,0
1668276429335,ECE 200,054,103639,Turakhia; Yatish Girish,9999,0,9999,0
1668276429335,ECE 200,055,103640,Kang; Mingu,9999,0,9999,0
1668276429335,ECE 200,056,103641,Shi; Yuanyuan,9999,0,9999,0
1668276429335,ECE 200,057,103642,Wang; Edward Jay,9999,0,9999,0
1668276429335,ECE 200,058,103643,Zheng; Yang,9999,0,9999,0
1668276429761,ECE 202,A00,103644,Kuzum; Duygu,0,0,0,0
1668276430186,ECE 212BN,A00,103646,Ng; Tse Nga,0,0,0,0
1668276430610,ECE 221,A00,111493,Staff,0,0,0,0
1668276431035,ECE 222B,A00,103647,Lomakin; Vitaliy,0,0,0,0
1668276431461,ECE 230B,A00,103648,Taur; Yuan,0,0,0,0
1668276431885,ECE 238B,A00,103649,Garay; Javier,0,0,0,0
1668276432346,ECE 240B,A00,112900,Fainman; Yeshaiahu,0,0,0,0
1668276432771,ECE 247A,A00,103650,Jokerst; Jesse Vincent,0,0,0,0
1668276433196,ECE 247B,A00,103651,Wang; Joseph,0,0,0,0
1668276433622,ECE 250,A00,103652,Siegel; Paul H.,0,0,0,0
1668276434046,ECE 251A,A00,103654,Rao; Bhaskar D.,0,0,0,0
1668276434467,ECE 257B,A00,103655,Bharadia; Dinesh,0,0,0,0
1668276434891,ECE 258A,A00,103656,Milstein; Laurence B.,0,0,0,0
1668276435317,ECE 260B,A00,103658,Kang; Mingu,0,0,0,0
1668276435740,ECE 264A,A00,103659,Galton; Ian A,0,0,0,0
1668276436164,ECE 265A,A00,103661,Gudem; Prasad S.S.,0,0,0,0
1668276436586,ECE 265D,A00,103662,Gudem; Prasad S.S.,0,0,0,0
1668276437010,ECE 268,A00,103663,Koushanfar; Farinaz,0,0,0,0
1668276437438,ECE 269,A01,103665,Pal; Piya,0,0,0,0
1668276437861,ECE 271B,A00,103666,Vasconcelos; Manuela,0,0,0,0
1668276438283,ECE 276A,A00,103667,Atanasov; Nikolay A.,0,0,0,0
1668276438707,ECE 277,A00,103668,An; Cheolhong,0,0,0,0
1668276439131,ECE 279,A00,117947,Hall; Drew A.,0,0,0,0
1668276439979,ECE 283,A00,103670,Hsueh; Tzu-Chien,0,0,0,0
1668276440413,ECE 284,A00,103671,Turakhia; Yatish Girish,0,0,0,0
1668276440836,ECE 285,A00,103672,Zheng; Yang,0,0,0,0
1668276440836,ECE 285,B00,103673,Sworder; David D.,0,0,0,0
1668276441260,ECE 287,A00,103676,Javidi; Tara,0,0,0,0
1668276441686,MATH 200B,A00,098023,Salehi Golsefidy; Alireza,12,0,15,3
1668276442110,MATH 202B,A00,098024,Rhoades; Brendon Patrick,9,0,15,6
1668276442537,MATH 203B,A00,098025,Oprea; Dragos N.,10,0,15,5
1668276443051,MATH 204B,A00,098026,Sorensen; Claus M,13,0,15,2
1668276443476,MATH 208,A00,098027,Izadi; Elham,7,0,10,3
1668276443899,MATH 209,A00,098028,Pollack; Aaron,10,0,10,0
1668276444333,MATH 211A,A00,112919,Rogalski; Daniel,9,0,10,1
1668276444755,MATH 211B,A00,112920,Seward; Brandon M.,9,0,10,1
1668276445179,MATH 218,A00,098029,Li; Bo,10,0,10,0
1668276445603,MATH 220B,A00,098030,Novak; Jonathan I,11,0,15,4
1668276446027,MATH 221A,A00,098031,Ebenfelt; Peter F,13,0,15,2
1668276446452,MATH 231B,A00,098032,Zlatos; Andrej,12,0,15,3
1668276446876,MATH 240B,A00,098033,Ni; Lei,9,0,15,6
1668276447301,MATH 243,A00,098034,Jekel; David Andrew,10,0,10,0
1668276447724,MATH 245A,A00,098035,Nie; Jiawang,0,0,15,16
1668276448157,MATH 248,A00,098036,Bejenaru; Ioan,10,0,10,0
1668276448580,MATH 250B,A00,098037,Spolaor; Luca,14,0,15,1
1668276449005,MATH 258,A00,098038,Ni; Lei,10,0,10,0
1668276449436,MATH 264B,A00,098041,Rhoades; Brendon Patrick,9,0,15,6
1668276449860,MATH 268,A00,098042,Buss; Samuel R,10,0,10,0
1668276450286,MATH 269,A00,098043,Rhoades; Brendon Patrick,10,0,10,0
1668276450710,MATH 270B,A00,098044,Li; Bo,10,0,15,5
1668276451134,MATH 272B,A00,098045,Holst; Michael J,13,0,15,2
1668276451564,MATH 273A,A00,098046,Tian; Xiaochuan,10,0,15,5
1668276451991,MATH 275,A01,098048,Tian; Xiaochuan,6,0,10,4
1668276452413,MATH 278A,A00,098049,Holst; Michael J,8,0,10,2
1668276452837,MATH 278B,A00,098050,Cloninger; Alexander,10,0,10,0
1668276453261,MATH 278C,A00,098051,Nie; Jiawang,7,0,10,3
1668276453684,MATH 280B,A00,098052,Zheng; Tianyi,9,0,15,6
1668276454108,MATH 281B,A00,098053,Bradic; Jelena,1,0,15,14
1668276454530,MATH 282B,A00,098054,Arias-Castro; Ery,0,0,15,15
1668276454961,MATH 285,A00,098055,Fitzsimmons; Patrick J,0,0,15,17
1668276455385,MATH 287B,A00,098056,Arias-Castro; Ery,2,0,15,13
1668276455811,MATH 288,A00,098057,Agarwal; Pooja,9,0,10,1
1668276455811,MATH 288,B00,098058,Zhang; Danna,8,0,10,2
1668276455811,MATH 288,C00,098059,Williams; Ruth J,10,0,10,0
1668276456234,MATH 290B,A00,098060,Roberts; Justin Deritter,13,0,15,2
1668276456660,MATH 292,A00,098061,Belmont; Eva Kinoshita,10,0,10,0
1668276457084,MATH 295,A00,098062,Suk; Andrew Hoon,48,0,50,2
1668276457510,MATH 296,A00,098063,Novak; Jonathan I,20,0,20,0
1668276457934,MATH 297,001,098064,Gamst; Anthony Collins,9997,0,9999,2
1668276956505,COGS 205,A00,101395,Chiba; Andrea,19,0,20,1
1668276956928,COGS 210B,001,101404,Greene; Deanna Jacquelyn,9998,0,9999,1
1668276956928,COGS 210B,002,101417,Xia; Haijun,9999,0,9999,0
1668276956928,COGS 210B,003,101422,Nitz; Douglas A.,9999,0,9999,0
1668276956928,COGS 210B,004,101423,Hollan; James D.,9998,0,9999,1
1668276956928,COGS 210B,005,101424,Deak; Gedeon O.,9998,0,9999,1
1668276956928,COGS 210B,006,101425,Rossano; Federico,9999,0,9999,0
1668276957360,COGS 211B,A00,101427,Coulson; Seana M,9996,0,9999,3
1668276957783,COGS 220,A00,101428,Hollan; James D.,0,0,25,25
1668276958210,COGS 229,A00,101429,Dow; Steven P,18,0,25,7
1668276958636,COGS 230,A00,101430,Klemmer; Scott R,12,0,17,5
1668276959061,COGS 234,A00,101431,Xia; Haijun,2,0,25,23
1668276959485,COGS 260,A00,101432,Kiyonaga; Anastasia,21,0,25,4
1668276959485,COGS 260,B00,101433,Kirsh; David Joel,15,0,25,10
1668276959908,CSE 202,A00,102371,Impagliazzo; Russell,0,0,0,0
1668276960338,CSE 203B,A01,102373,Cheng; Chung Kuan,0,0,0,0
1668276960765,CSE 208,A00,102374,Micciancio; Daniele,0,0,0,0
1668276961188,CSE 209A,A00,112895,Impagliazzo; Russell,0,0,15,15
1668276961689,CSE 209B,A00,108005,Bellare; Mihir,0,0,0,0
1668276962113,CSE 210,A00,113163,Coblenz; Michael J,0,0,0,0
1668276962539,CSE 219,A00,106111,Dow; Steven P,0,0,20,20
1668276962961,CSE 221,A00,102376,Voelker; Geoffrey M.,0,0,0,0
1668276963386,CSE 224,A01,102378,Porter; George M,0,0,0,0
1668276963811,CSE 229A,A00,102379,Savage; Stefan,0,0,0,0
1668276964238,CSE 229C,A00,102380,Munyaka; Imani N. S.,0,0,0,0
1668276964663,CSE 232B,A00,102382,Deutsch; Alin Bernard,0,0,0,0
1668276965091,CSE 234,A01,112904,Kumar; Arun Kumar,0,0,0,0
1668276965514,CSE 237A,A00,102383,Rosing; Tajana Simunic,0,0,0,0
1668276965939,CSE 239A,A00,102384,Deutsch; Alin Bernard,0,0,0,0
1668276966360,CSE 239B,A00,102385,Polikarpova; Nadezhda,0,0,0,0
1668276966791,CSE 240A,A00,102386,Pannuto; Patrick William,0,0,0,0
1668276967218,CSE 240B,A00,102387,Zhao; Jishen,0,0,0,0
1668276967642,CSE 241A,A00,106406,Kang; Mingu,0,0,0,0
1668276968076,CSE 249B,A00,102388,Kahng; Andrew Byun,0,0,8,8
1668276968500,CSE 251B,A01,102392,Cottrell; Garrison W,0,0,0,0
1668276968500,CSE 251B,A02,102393,Cottrell; Garrison W,0,0,0,0
1668276968925,CSE 252B,A00,102394,Ochoa; Benjamin Lawrence,0,0,0,0
1668276969351,CSE 257,A01,102396,Gao; Sicun,0,0,0,0
1668276969773,CSE 272,A00,102397,Li; Tzumao,0,0,0,0
1668276970196,CSE 274,A00,111323,Chern; Albert Ren-Haur,0,0,0,0
1668276970619,CSE 282,A00,102398,Pevzner; Pavel Arkadjevich,0,0,0,0
1668276971042,CSE 284,A00,114175,Gymrek; Melissa Ann,0,0,0,0
1668276971468,CSE 290,A00,102399,Chandraker; Manmohan Krishna,0,0,0,0
1668276971468,CSE 290,B00,102400,Vaccaro; Kristen Marie,0,0,25,25
1668276971468,CSE 290,C00,102414,Pannuto; Patrick William,0,0,25,25
1668276971468,CSE 290,D00,102427,Pevzner; Pavel Arkadjevich,0,0,0,0
1668276971468,CSE 290,E00,102429,Zhao; Jishen,0,0,0,0
1668276971468,CSE 290,F00,102436,Tullsen; Dean Michael,0,0,0,0
1668276971468,CSE 290,G00,102440,Christensen; Henrik I,0,0,20,20
1668276971906,CSE 291,A00,102443,Su; Hao,0,0,0,0
1668276971906,CSE 291,B00,102448,Polikarpova; Nadezhda,0,0,0,0
1668276971906,CSE 291,C00,102453,Vaccaro; Kristen Marie,0,0,0,0
1668276971906,CSE 291,D00,111343,Savage; Stefan,0,0,0,0
1668276971906,CSE 291,E00,116474,Claffy; Kimberly Claire,0,0,0,0
1668276971906,CSE 291,F00,116479,Pasquale; Joseph,0,0,0,0
1668276972335,CSE 293,001,119111,Bafna; Vineet,9999,0,9999,0
1668276972335,CSE 293,002,119118,Bellare; Mihir,9999,0,9999,0
1668276972335,CSE 293,003,119122,Berg-Kirkpatrick; Taylor D,9999,0,9999,0
1668276972335,CSE 293,004,119135,Christensen; Henrik I,9999,0,9999,0
1668276972335,CSE 293,005,119142,Cottrell; Garrison W,9999,0,9999,0
1668276972335,CSE 293,006,119146,Deutsch; Alin Bernard,9999,0,9999,0
1668276972335,CSE 293,007,119159,Esmaeilzadeh; Hadi,9999,0,9999,0
1668276972335,CSE 293,008,119166,Freund; Yoav,9999,0,9999,0
1668276972335,CSE 293,009,119170,Griswold; William G.,9999,0,9999,0
1668276972335,CSE 293,010,119183,Gymrek; Melissa Ann,9999,0,9999,0
1668276972335,CSE 293,011,119190,Heninger; Nadia A,9999,0,9999,0
1668276972335,CSE 293,012,119230,Impagliazzo; Russell,9999,0,9999,0
1668276972335,CSE 293,013,119232,Jhala; Ranjit,9999,0,9999,0
1668276972335,CSE 293,014,119233,Kahng; Andrew Byun,9999,0,9999,0
1668276972335,CSE 293,015,119298,Kane; Daniel Mertz,9999,0,9999,0
1668276972335,CSE 293,016,119299,Kriegman; David J,9999,0,9999,0
1668276972335,CSE 293,017,119300,Kumar; Arun Kumar,9999,0,9999,0
1668276972335,CSE 293,018,119301,Lerner; Sorin,9999,0,9999,0
1668276972335,CSE 293,019,119302,Lovett; Shachar,9999,0,9999,0
1668276972335,CSE 293,020,119303,McAuley; Julian John,9999,0,9999,0
1668276972335,CSE 293,021,119304,Micciancio; Daniele,9999,0,9999,0
1668276972335,CSE 293,022,119367,Orailoglu; Alex,9999,0,9999,0
1668276972335,CSE 293,023,119382,Paturi; Ramamohan,9999,0,9999,0
1668276972335,CSE 293,024,119404,Polikarpova; Nadezhda,9999,0,9999,0
1668276972335,CSE 293,025,119406,Politz; Joseph Gibbs,9999,0,9999,0
1668276972335,CSE 293,026,119411,Porter; George M,9999,0,9999,0
1668276972335,CSE 293,027,119414,Porter; Leonard Emerson,9999,0,9999,0
1668276972335,CSE 293,028,119416,Ramamoorthi; Ravi,9999,0,9999,0
1668276972335,CSE 293,029,119417,Sahoo; Debashis,9999,0,9999,0
1668276972335,CSE 293,030,119420,Saul; Lawrence,9999,0,9999,0
1668276972335,CSE 293,031,119421,Savage; Stefan,9999,0,9999,0
1668276972335,CSE 293,032,119425,Schulze; Jurgen P.,9999,0,9999,0
1668276972335,CSE 293,033,119426,Snoeren; Alex C.,9999,0,9999,0
1668276972335,CSE 293,034,119428,Shang; Jingbo,9999,0,9999,0
1668276972335,CSE 293,035,119430,Stefan; Deian,9999,0,9999,0
1668276972335,CSE 293,036,119431,Su; Hao,9999,0,9999,0
1668276972335,CSE 293,037,119433,Swanson; Steven James,9999,0,9999,0
1668276972335,CSE 293,038,119435,Tullsen; Dean Michael,9999,0,9999,0
1668276972335,CSE 293,039,119483,Voelker; Geoffrey M.,9999,0,9999,0
1668276972335,CSE 293,040,119537,Zhao; Jishen,9999,0,9999,0
1668276972335,CSE 293,041,119538,Zhou; Yuan-Yuan,9999,0,9999,0
1668276972335,CSE 293,042,119539,Gao; Sicun,9999,0,9999,0
1668276972335,CSE 293,043,119540,Weibel; Nadir,9999,0,9999,0
1668276972335,CSE 293,044,119541,Gupta; Rajesh K.,9999,0,9999,0
1668276972335,CSE 293,045,126410,Vaccaro; Kristen Marie,9999,0,9999,0
1668276972335,CSE 293,046,126411,Klemke; Richard,9999,0,9999,0
1668276972758,CSE 294,A00,102459,Voelker; Geoffrey M.,0,0,0,0
1668276972758,CSE 294,B00,111322,Orailoglu; Alex,0,0,0,0
1668276973180,DSE 201,A00,096914,Deutsch; Alin Bernard,30,0,30,0
1668276973606,DSE 210,A00,096915,Dasgupta; Sanjoy,30,0,30,0
1668276974030,DSE 260A,A00,096916,Altintas De Callaf; Ilkay,30,0,30,0
1668276974456,ECE 200,001,103586,Antipa; Nicholas A,9999,0,9999,0
1668276974456,ECE 200,002,103587,Atanasov; Nikolay A.,9999,0,9999,0
1668276974456,ECE 200,003,103588,Bharadia; Dinesh,9999,0,9999,0
1668276974456,ECE 200,004,103589,Cheng; Chung Kuan,9999,0,9999,0
1668276974456,ECE 200,005,103590,Cosman; Pamela C.,9999,0,9999,0
1668276974456,ECE 200,006,103591,Dayeh; Shadi Ahmad,9999,0,9999,0
1668276974456,ECE 200,007,103592,Fainman; Yeshaiahu,9999,0,9999,0
1668276974456,ECE 200,008,103593,Ford; Joseph Earl,9999,0,9999,0
1668276974456,ECE 200,009,103594,Franceschetti; Massimo,9999,0,9999,0
1668276974456,ECE 200,010,103595,Fullerton; Eric E,9999,0,9999,0
1668276974456,ECE 200,011,103596,Galton; Ian A,9999,0,9999,0
1668276974456,ECE 200,012,103597,Gilja; Vikash,9999,0,9999,0
1668276974456,ECE 200,013,103598,Hall; Drew A.,9999,0,9999,0
1668276974456,ECE 200,014,103599,Hsueh; Tzu-Chien,9999,0,9999,0
1668276974456,ECE 200,015,103600,Javidi; Tara,9999,0,9999,0
1668276974456,ECE 200,016,103601,Kahng; Andrew Byun,9999,0,9999,0
1668276974456,ECE 200,017,103602,Kim; Young-Han,9999,0,9999,0
1668276974456,ECE 200,018,103603,Koushanfar; Farinaz,9999,0,9999,0
1668276974456,ECE 200,019,103604,Kuzum; Duygu,9999,0,9999,0
1668276974456,ECE 200,020,103605,Le; Hanh-Phuc,9999,0,9999,0
1668276974456,ECE 200,021,103606,Lin; Bill,9999,0,9999,0
1668276974456,ECE 200,022,103607,Liu; Zhaowei,9998,0,9999,1
1668276974456,ECE 200,023,103608,Lo; Yu-Hwa,9999,0,9999,0
1668276974456,ECE 200,024,103609,Lomakin; Vitaliy,9999,0,9999,0
1668276974456,ECE 200,025,103610,Mercier; Patrick Philip,9999,0,9999,0
1668276974456,ECE 200,026,103611,Meyer; Florian,9999,0,9999,0
1668276974456,ECE 200,027,103612,Milstein; Laurence B.,9999,0,9999,0
1668276974456,ECE 200,028,103613,Mir Arabbaygi; Siavash,9999,0,9999,0
1668276974456,ECE 200,029,103614,Mookherjea; Shayan,9999,0,9999,0
1668276974456,ECE 200,030,103615,Morris; Karcher William,9999,0,9999,0
1668276974456,ECE 200,031,103616,Ng; Tse Nga,9999,0,9999,0
1668276974456,ECE 200,032,103617,Nguyen; Truong Quang,9999,0,9999,0
1668276974456,ECE 200,033,103618,Nomura; Kenji,9999,0,9999,0
1668276974456,ECE 200,034,103619,Orlitsky; Alon,9999,0,9999,0
1668276974456,ECE 200,035,103620,Pal; Piya,9999,0,9999,0
1668276974456,ECE 200,036,103621,Papen; George C.,9999,0,9999,0
1668276974456,ECE 200,037,103622,Radic; Stojan,9999,0,9999,0
1668276974456,ECE 200,038,103623,Rao; Bhaskar D.,9999,0,9999,0
1668276974456,ECE 200,039,103624,Rao; Ramesh R,9999,0,9999,0
1668276974456,ECE 200,040,103625,Rebeiz; Gabriel,9999,0,9999,0
1668276974456,ECE 200,041,103626,Sanford; John R,9999,0,9999,0
1668276974456,ECE 200,042,103627,Siegel; Paul H.,9999,0,9999,0
1668276974456,ECE 200,043,103628,Sievenpiper; Daniel F.,9999,0,9999,0
1668276974456,ECE 200,044,103629,Sworder; David D.,9999,0,9999,0
1668276974456,ECE 200,045,103630,Taur; Yuan,9999,0,9999,0
1668276974456,ECE 200,046,103631,Touri; Behrouz,9999,0,9999,0
1668276974456,ECE 200,047,103632,Trivedi; Mohan M.,9999,0,9999,0
1668276974456,ECE 200,048,103633,Vasconcelos; Nuno,9999,0,9999,0
1668276974456,ECE 200,049,103634,Wang; Xiaolong,9999,0,9999,0
1668276974456,ECE 200,050,103635,Xie; Pengtao,9999,0,9999,0
1668276974456,ECE 200,051,103636,Yip; Michael,9999,0,9999,0
1668276974456,ECE 200,052,103637,Zeger; Kenneth A.,999,0,999,0
1668276974456,ECE 200,053,103638,Zhang; Xinyu,9999,0,9999,0
1668276974456,ECE 200,054,103639,Turakhia; Yatish Girish,9999,0,9999,0
1668276974456,ECE 200,055,103640,Kang; Mingu,9999,0,9999,0
1668276974456,ECE 200,056,103641,Shi; Yuanyuan,9999,0,9999,0
1668276974456,ECE 200,057,103642,Wang; Edward Jay,9999,0,9999,0
1668276974456,ECE 200,058,103643,Zheng; Yang,9999,0,9999,0
1668276974883,ECE 202,A00,103644,Kuzum; Duygu,0,0,0,0
1668276975309,ECE 212BN,A00,103646,Ng; Tse Nga,0,0,0,0
1668276975737,ECE 221,A00,111493,Staff,0,0,0,0
1668276976160,ECE 222B,A00,103647,Lomakin; Vitaliy,0,0,0,0
1668276976582,ECE 230B,A00,103648,Taur; Yuan,0,0,0,0
1668276977010,ECE 238B,A00,103649,Garay; Javier,0,0,0,0
1668276977435,ECE 240B,A00,112900,Fainman; Yeshaiahu,0,0,0,0
1668276977860,ECE 247A,A00,103650,Jokerst; Jesse Vincent,0,0,0,0
1668276978287,ECE 247B,A00,103651,Wang; Joseph,0,0,0,0
1668276978711,ECE 250,A00,103652,Siegel; Paul H.,0,0,0,0
1668276979138,ECE 251A,A00,103654,Rao; Bhaskar D.,0,0,0,0
1668276979565,ECE 257B,A00,103655,Bharadia; Dinesh,0,0,0,0
1668276979989,ECE 258A,A00,103656,Milstein; Laurence B.,0,0,0,0
1668276980412,ECE 260B,A00,103658,Kang; Mingu,0,0,0,0
1668276980841,ECE 264A,A00,103659,Galton; Ian A,0,0,0,0
1668276981265,ECE 265A,A00,103661,Gudem; Prasad S.S.,0,0,0,0
1668276981688,ECE 265D,A00,103662,Gudem; Prasad S.S.,0,0,0,0
1668276982114,ECE 268,A00,103663,Koushanfar; Farinaz,0,0,0,0
1668276982537,ECE 269,A01,103665,Pal; Piya,0,0,0,0
1668276982959,ECE 271B,A00,103666,Vasconcelos; Manuela,0,0,0,0
1668276983383,ECE 276A,A00,103667,Atanasov; Nikolay A.,0,0,0,0
1668276983806,ECE 277,A00,103668,An; Cheolhong,0,0,0,0
1668276984229,ECE 279,A00,117947,Hall; Drew A.,0,0,0,0
1668276985076,ECE 283,A00,103670,Hsueh; Tzu-Chien,0,0,0,0
1668276985502,ECE 284,A00,103671,Turakhia; Yatish Girish,0,0,0,0
1668276985928,ECE 285,A00,103672,Zheng; Yang,0,0,0,0
1668276985928,ECE 285,B00,103673,Sworder; David D.,0,0,0,0
1668276986352,ECE 287,A00,103676,Javidi; Tara,0,0,0,0
1668276986775,MATH 200B,A00,098023,Salehi Golsefidy; Alireza,12,0,15,3
1668276987198,MATH 202B,A00,098024,Rhoades; Brendon Patrick,9,0,15,6
1668276987619,MATH 203B,A00,098025,Oprea; Dragos N.,10,0,15,5
1668276988043,MATH 204B,A00,098026,Sorensen; Claus M,13,0,15,2
1668276988470,MATH 208,A00,098027,Izadi; Elham,7,0,10,3
1668276988893,MATH 209,A00,098028,Pollack; Aaron,10,0,10,0
1668276989319,MATH 211A,A00,112919,Rogalski; Daniel,9,0,10,1
1668276989744,MATH 211B,A00,112920,Seward; Brandon M.,9,0,10,1
1668276990171,MATH 218,A00,098029,Li; Bo,10,0,10,0
1668276990595,MATH 220B,A00,098030,Novak; Jonathan I,11,0,15,4
1668276991018,MATH 221A,A00,098031,Ebenfelt; Peter F,13,0,15,2
1668276991443,MATH 231B,A00,098032,Zlatos; Andrej,12,0,15,3
1668276991872,MATH 240B,A00,098033,Ni; Lei,9,0,15,6
1668276992296,MATH 243,A00,098034,Jekel; David Andrew,10,0,10,0
1668276992719,MATH 245A,A00,098035,Nie; Jiawang,0,0,15,16
1668276993143,MATH 248,A00,098036,Bejenaru; Ioan,10,0,10,0
1668276993565,MATH 250B,A00,098037,Spolaor; Luca,14,0,15,1
1668276993990,MATH 258,A00,098038,Ni; Lei,10,0,10,0
1668276994414,MATH 264B,A00,098041,Rhoades; Brendon Patrick,9,0,15,6
1668276994835,MATH 268,A00,098042,Buss; Samuel R,10,0,10,0
1668276995258,MATH 269,A00,098043,Rhoades; Brendon Patrick,10,0,10,0
1668276995683,MATH 270B,A00,098044,Li; Bo,10,0,15,5
1668276996110,MATH 272B,A00,098045,Holst; Michael J,13,0,15,2
1668276996532,MATH 273A,A00,098046,Tian; Xiaochuan,10,0,15,5
1668276996956,MATH 275,A01,098048,Tian; Xiaochuan,6,0,10,4
1668276997380,MATH 278A,A00,098049,Holst; Michael J,8,0,10,2
1668276997801,MATH 278B,A00,098050,Cloninger; Alexander,10,0,10,0
1668276998224,MATH 278C,A00,098051,Nie; Jiawang,7,0,10,3
1668276998648,MATH 280B,A00,098052,Zheng; Tianyi,9,0,15,6
1668276999072,MATH 281B,A00,098053,Bradic; Jelena,1,0,15,14
1668276999495,MATH 282B,A00,098054,Arias-Castro; Ery,0,0,15,15
1668276999923,MATH 285,A00,098055,Fitzsimmons; Patrick J,0,0,15,17
1668277000348,MATH 287B,A00,098056,Arias-Castro; Ery,2,0,15,13
1668277000778,MATH 288,A00,098057,Agarwal; Pooja,9,0,10,1
1668277000778,MATH 288,B00,098058,Zhang; Danna,8,0,10,2
1668277000778,MATH 288,C00,098059,Williams; Ruth J,10,0,10,0
1668277001203,MATH 290B,A00,098060,Roberts; Justin Deritter,13,0,15,2
1668277001628,MATH 292,A00,098061,Belmont; Eva Kinoshita,10,0,10,0
1668277002058,MATH 295,A00,098062,Suk; Andrew Hoon,48,0,50,2
1668277002499,MATH 296,A00,098063,Novak; Jonathan I,20,0,20,0
1668277002922,MATH 297,001,098064,Gamst; Anthony Collins,9997,0,9999,2
1668277501694,COGS 205,A00,101395,Chiba; Andrea,19,0,20,1
1668277502119,COGS 210B,001,101404,Greene; Deanna Jacquelyn,9998,0,9999,1
1668277502119,COGS 210B,002,101417,Xia; Haijun,9999,0,9999,0
1668277502119,COGS 210B,003,101422,Nitz; Douglas A.,9999,0,9999,0
1668277502119,COGS 210B,004,101423,Hollan; James D.,9998,0,9999,1
1668277502119,COGS 210B,005,101424,Deak; Gedeon O.,9998,0,9999,1
1668277502119,COGS 210B,006,101425,Rossano; Federico,9999,0,9999,0
1668277502544,COGS 211B,A00,101427,Coulson; Seana M,9996,0,9999,3
1668277502976,COGS 220,A00,101428,Hollan; James D.,0,0,25,25
1668277503408,COGS 229,A00,101429,Dow; Steven P,18,0,25,7
1668277503833,COGS 230,A00,101430,Klemmer; Scott R,12,0,17,5
1668277504256,COGS 234,A00,101431,Xia; Haijun,1,0,25,24
1668277504683,COGS 260,A00,101432,Kiyonaga; Anastasia,21,0,25,4
1668277504683,COGS 260,B00,101433,Kirsh; David Joel,15,0,25,10
1668277505108,CSE 202,A00,102371,Impagliazzo; Russell,0,0,0,0
1668277505534,CSE 203B,A01,102373,Cheng; Chung Kuan,0,0,0,0
1668277505962,CSE 208,A00,102374,Micciancio; Daniele,0,0,0,0
1668277506385,CSE 209A,A00,112895,Impagliazzo; Russell,0,0,15,15
1668277506810,CSE 209B,A00,108005,Bellare; Mihir,0,0,0,0
1668277507236,CSE 210,A00,113163,Coblenz; Michael J,0,0,0,0
1668277507662,CSE 219,A00,106111,Dow; Steven P,0,0,20,20
1668277508090,CSE 221,A00,102376,Voelker; Geoffrey M.,0,0,0,0
1668277508518,CSE 224,A01,102378,Porter; George M,0,0,0,0
1668277508943,CSE 229A,A00,102379,Savage; Stefan,0,0,0,0
1668277509371,CSE 229C,A00,102380,Munyaka; Imani N. S.,0,0,0,0
1668277509794,CSE 232B,A00,102382,Deutsch; Alin Bernard,0,0,0,0
1668277510217,CSE 234,A01,112904,Kumar; Arun Kumar,0,0,0,0
1668277510640,CSE 237A,A00,102383,Rosing; Tajana Simunic,0,0,0,0
1668277511072,CSE 239A,A00,102384,Deutsch; Alin Bernard,0,0,0,0
1668277511497,CSE 239B,A00,102385,Polikarpova; Nadezhda,0,0,0,0
1668277511924,CSE 240A,A00,102386,Pannuto; Patrick William,0,0,0,0
1668277512348,CSE 240B,A00,102387,Zhao; Jishen,0,0,0,0
1668277512774,CSE 241A,A00,106406,Kang; Mingu,0,0,0,0
1668277513198,CSE 249B,A00,102388,Kahng; Andrew Byun,0,0,8,8
1668277513622,CSE 251B,A01,102392,Cottrell; Garrison W,0,0,0,0
1668277513622,CSE 251B,A02,102393,Cottrell; Garrison W,0,0,0,0
1668277514047,CSE 252B,A00,102394,Ochoa; Benjamin Lawrence,0,0,0,0
1668277514472,CSE 257,A01,102396,Gao; Sicun,0,0,0,0
1668277514895,CSE 272,A00,102397,Li; Tzumao,0,0,0,0
1668277515320,CSE 274,A00,111323,Chern; Albert Ren-Haur,0,0,0,0
1668277515745,CSE 282,A00,102398,Pevzner; Pavel Arkadjevich,0,0,0,0
1668277516174,CSE 284,A00,114175,Gymrek; Melissa Ann,0,0,0,0
1668277516599,CSE 290,A00,102399,Chandraker; Manmohan Krishna,0,0,0,0
1668277516599,CSE 290,B00,102400,Vaccaro; Kristen Marie,0,0,25,25
1668277516599,CSE 290,C00,102414,Pannuto; Patrick William,0,0,25,25
1668277516599,CSE 290,D00,102427,Pevzner; Pavel Arkadjevich,0,0,0,0
1668277516599,CSE 290,E00,102429,Zhao; Jishen,0,0,0,0
1668277516599,CSE 290,F00,102436,Tullsen; Dean Michael,0,0,0,0
1668277516599,CSE 290,G00,102440,Christensen; Henrik I,0,0,20,20
1668277517024,CSE 291,A00,102443,Su; Hao,0,0,0,0
1668277517024,CSE 291,B00,102448,Polikarpova; Nadezhda,0,0,0,0
1668277517024,CSE 291,C00,102453,Vaccaro; Kristen Marie,0,0,0,0
1668277517024,CSE 291,D00,111343,Savage; Stefan,0,0,0,0
1668277517024,CSE 291,E00,116474,Claffy; Kimberly Claire,0,0,0,0
1668277517024,CSE 291,F00,116479,Pasquale; Joseph,0,0,0,0
1668277517450,CSE 293,001,119111,Bafna; Vineet,9999,0,9999,0
1668277517450,CSE 293,002,119118,Bellare; Mihir,9999,0,9999,0
1668277517450,CSE 293,003,119122,Berg-Kirkpatrick; Taylor D,9999,0,9999,0
1668277517450,CSE 293,004,119135,Christensen; Henrik I,9999,0,9999,0
1668277517450,CSE 293,005,119142,Cottrell; Garrison W,9999,0,9999,0
1668277517450,CSE 293,006,119146,Deutsch; Alin Bernard,9999,0,9999,0
1668277517450,CSE 293,007,119159,Esmaeilzadeh; Hadi,9999,0,9999,0
1668277517450,CSE 293,008,119166,Freund; Yoav,9999,0,9999,0
1668277517450,CSE 293,009,119170,Griswold; William G.,9999,0,9999,0
1668277517450,CSE 293,010,119183,Gymrek; Melissa Ann,9999,0,9999,0
1668277517450,CSE 293,011,119190,Heninger; Nadia A,9999,0,9999,0
1668277517450,CSE 293,012,119230,Impagliazzo; Russell,9999,0,9999,0
1668277517450,CSE 293,013,119232,Jhala; Ranjit,9999,0,9999,0
1668277517450,CSE 293,014,119233,Kahng; Andrew Byun,9999,0,9999,0
1668277517450,CSE 293,015,119298,Kane; Daniel Mertz,9999,0,9999,0
1668277517450,CSE 293,016,119299,Kriegman; David J,9999,0,9999,0
1668277517450,CSE 293,017,119300,Kumar; Arun Kumar,9999,0,9999,0
1668277517450,CSE 293,018,119301,Lerner; Sorin,9999,0,9999,0
1668277517450,CSE 293,019,119302,Lovett; Shachar,9999,0,9999,0
1668277517450,CSE 293,020,119303,McAuley; Julian John,9999,0,9999,0
1668277517450,CSE 293,021,119304,Micciancio; Daniele,9999,0,9999,0
1668277517450,CSE 293,022,119367,Orailoglu; Alex,9999,0,9999,0
1668277517450,CSE 293,023,119382,Paturi; Ramamohan,9999,0,9999,0
1668277517450,CSE 293,024,119404,Polikarpova; Nadezhda,9999,0,9999,0
1668277517450,CSE 293,025,119406,Politz; Joseph Gibbs,9999,0,9999,0
1668277517450,CSE 293,026,119411,Porter; George M,9999,0,9999,0
1668277517450,CSE 293,027,119414,Porter; Leonard Emerson,9999,0,9999,0
1668277517450,CSE 293,028,119416,Ramamoorthi; Ravi,9999,0,9999,0
1668277517450,CSE 293,029,119417,Sahoo; Debashis,9999,0,9999,0
1668277517450,CSE 293,030,119420,Saul; Lawrence,9999,0,9999,0
1668277517450,CSE 293,031,119421,Savage; Stefan,9999,0,9999,0
1668277517450,CSE 293,032,119425,Schulze; Jurgen P.,9999,0,9999,0
1668277517450,CSE 293,033,119426,Snoeren; Alex C.,9999,0,9999,0
1668277517450,CSE 293,034,119428,Shang; Jingbo,9999,0,9999,0
1668277517450,CSE 293,035,119430,Stefan; Deian,9999,0,9999,0
1668277517450,CSE 293,036,119431,Su; Hao,9999,0,9999,0
1668277517450,CSE 293,037,119433,Swanson; Steven James,9999,0,9999,0
1668277517450,CSE 293,038,119435,Tullsen; Dean Michael,9999,0,9999,0
1668277517450,CSE 293,039,119483,Voelker; Geoffrey M.,9999,0,9999,0
1668277517450,CSE 293,040,119537,Zhao; Jishen,9999,0,9999,0
1668277517450,CSE 293,041,119538,Zhou; Yuan-Yuan,9999,0,9999,0
1668277517450,CSE 293,042,119539,Gao; Sicun,9999,0,9999,0
1668277517450,CSE 293,043,119540,Weibel; Nadir,9999,0,9999,0
1668277517450,CSE 293,044,119541,Gupta; Rajesh K.,9999,0,9999,0
1668277517450,CSE 293,045,126410,Vaccaro; Kristen Marie,9999,0,9999,0
1668277517450,CSE 293,046,126411,Klemke; Richard,9999,0,9999,0
1668277517874,CSE 294,A00,102459,Voelker; Geoffrey M.,0,0,0,0
1668277517874,CSE 294,B00,111322,Orailoglu; Alex,0,0,0,0
1668277518302,DSE 201,A00,096914,Deutsch; Alin Bernard,30,0,30,0
1668277518725,DSE 210,A00,096915,Dasgupta; Sanjoy,30,0,30,0
1668277519146,DSE 260A,A00,096916,Altintas De Callaf; Ilkay,30,0,30,0
1668277519582,ECE 200,001,103586,Antipa; Nicholas A,9999,0,9999,0
1668277519582,ECE 200,002,103587,Atanasov; Nikolay A.,9999,0,9999,0
1668277519582,ECE 200,003,103588,Bharadia; Dinesh,9999,0,9999,0
1668277519582,ECE 200,004,103589,Cheng; Chung Kuan,9999,0,9999,0
1668277519582,ECE 200,005,103590,Cosman; Pamela C.,9999,0,9999,0
1668277519582,ECE 200,006,103591,Dayeh; Shadi Ahmad,9999,0,9999,0
1668277519582,ECE 200,007,103592,Fainman; Yeshaiahu,9999,0,9999,0
1668277519582,ECE 200,008,103593,Ford; Joseph Earl,9999,0,9999,0
1668277519582,ECE 200,009,103594,Franceschetti; Massimo,9999,0,9999,0
1668277519582,ECE 200,010,103595,Fullerton; Eric E,9999,0,9999,0
1668277519582,ECE 200,011,103596,Galton; Ian A,9999,0,9999,0
1668277519582,ECE 200,012,103597,Gilja; Vikash,9999,0,9999,0
1668277519582,ECE 200,013,103598,Hall; Drew A.,9999,0,9999,0
1668277519582,ECE 200,014,103599,Hsueh; Tzu-Chien,9999,0,9999,0
1668277519582,ECE 200,015,103600,Javidi; Tara,9999,0,9999,0
1668277519582,ECE 200,016,103601,Kahng; Andrew Byun,9999,0,9999,0
1668277519582,ECE 200,017,103602,Kim; Young-Han,9999,0,9999,0
1668277519582,ECE 200,018,103603,Koushanfar; Farinaz,9999,0,9999,0
1668277519582,ECE 200,019,103604,Kuzum; Duygu,9999,0,9999,0
1668277519582,ECE 200,020,103605,Le; Hanh-Phuc,9999,0,9999,0
1668277519582,ECE 200,021,103606,Lin; Bill,9999,0,9999,0
1668277519582,ECE 200,022,103607,Liu; Zhaowei,9998,0,9999,1
1668277519582,ECE 200,023,103608,Lo; Yu-Hwa,9999,0,9999,0
1668277519582,ECE 200,024,103609,Lomakin; Vitaliy,9999,0,9999,0
1668277519582,ECE 200,025,103610,Mercier; Patrick Philip,9999,0,9999,0
1668277519582,ECE 200,026,103611,Meyer; Florian,9999,0,9999,0
1668277519582,ECE 200,027,103612,Milstein; Laurence B.,9999,0,9999,0
1668277519582,ECE 200,028,103613,Mir Arabbaygi; Siavash,9999,0,9999,0
1668277519582,ECE 200,029,103614,Mookherjea; Shayan,9999,0,9999,0
1668277519582,ECE 200,030,103615,Morris; Karcher William,9999,0,9999,0
1668277519582,ECE 200,031,103616,Ng; Tse Nga,9999,0,9999,0
1668277519582,ECE 200,032,103617,Nguyen; Truong Quang,9999,0,9999,0
1668277519582,ECE 200,033,103618,Nomura; Kenji,9999,0,9999,0
1668277519582,ECE 200,034,103619,Orlitsky; Alon,9999,0,9999,0
1668277519582,ECE 200,035,103620,Pal; Piya,9999,0,9999,0
1668277519582,ECE 200,036,103621,Papen; George C.,9999,0,9999,0
1668277519582,ECE 200,037,103622,Radic; Stojan,9999,0,9999,0
1668277519582,ECE 200,038,103623,Rao; Bhaskar D.,9999,0,9999,0
1668277519582,ECE 200,039,103624,Rao; Ramesh R,9999,0,9999,0
1668277519582,ECE 200,040,103625,Rebeiz; Gabriel,9999,0,9999,0
1668277519582,ECE 200,041,103626,Sanford; John R,9999,0,9999,0
1668277519582,ECE 200,042,103627,Siegel; Paul H.,9999,0,9999,0
1668277519582,ECE 200,043,103628,Sievenpiper; Daniel F.,9999,0,9999,0
1668277519582,ECE 200,044,103629,Sworder; David D.,9999,0,9999,0
1668277519582,ECE 200,045,103630,Taur; Yuan,9999,0,9999,0
1668277519582,ECE 200,046,103631,Touri; Behrouz,9999,0,9999,0
1668277519582,ECE 200,047,103632,Trivedi; Mohan M.,9999,0,9999,0
1668277519582,ECE 200,048,103633,Vasconcelos; Nuno,9999,0,9999,0
1668277519582,ECE 200,049,103634,Wang; Xiaolong,9999,0,9999,0
1668277519582,ECE 200,050,103635,Xie; Pengtao,9999,0,9999,0
1668277519582,ECE 200,051,103636,Yip; Michael,9999,0,9999,0
1668277519582,ECE 200,052,103637,Zeger; Kenneth A.,999,0,999,0
1668277519582,ECE 200,053,103638,Zhang; Xinyu,9999,0,9999,0
1668277519582,ECE 200,054,103639,Turakhia; Yatish Girish,9999,0,9999,0
1668277519582,ECE 200,055,103640,Kang; Mingu,9999,0,9999,0
1668277519582,ECE 200,056,103641,Shi; Yuanyuan,9999,0,9999,0
1668277519582,ECE 200,057,103642,Wang; Edward Jay,9999,0,9999,0
1668277519582,ECE 200,058,103643,Zheng; Yang,9999,0,9999,0
1668277520004,ECE 202,A00,103644,Kuzum; Duygu,0,0,0,0
1668277520431,ECE 212BN,A00,103646,Ng; Tse Nga,0,0,0,0
1668277520856,ECE 221,A00,111493,Staff,0,0,0,0
1668277521280,ECE 222B,A00,103647,Lomakin; Vitaliy,0,0,0,0
1668277521703,ECE 230B,A00,103648,Taur; Yuan,0,0,0,0
1668277522126,ECE 238B,A00,103649,Garay; Javier,0,0,0,0
1668277522552,ECE 240B,A00,112900,Fainman; Yeshaiahu,0,0,0,0
1668277522975,ECE 247A,A00,103650,Jokerst; Jesse Vincent,0,0,0,0
1668277523491,ECE 247B,A00,103651,Wang; Joseph,0,0,0,0
1668277523915,ECE 250,A00,103652,Siegel; Paul H.,0,0,0,0
1668277524340,ECE 251A,A00,103654,Rao; Bhaskar D.,0,0,0,0
1668277524763,ECE 257B,A00,103655,Bharadia; Dinesh,0,0,0,0
1668277525191,ECE 258A,A00,103656,Milstein; Laurence B.,0,0,0,0
1668277525615,ECE 260B,A00,103658,Kang; Mingu,0,0,0,0
1668277526042,ECE 264A,A00,103659,Galton; Ian A,0,0,0,0
1668277526469,ECE 265A,A00,103661,Gudem; Prasad S.S.,0,0,0,0
1668277526894,ECE 265D,A00,103662,Gudem; Prasad S.S.,0,0,0,0
1668277527320,ECE 268,A00,103663,Koushanfar; Farinaz,0,0,0,0
1668277527743,ECE 269,A01,103665,Pal; Piya,0,0,0,0
1668277528168,ECE 271B,A00,103666,Vasconcelos; Manuela,0,0,0,0
1668277528594,ECE 276A,A00,103667,Atanasov; Nikolay A.,0,0,0,0
1668277529023,ECE 277,A00,103668,An; Cheolhong,0,0,0,0
1668277529444,ECE 279,A00,117947,Hall; Drew A.,0,0,0,0
1668277530295,ECE 283,A00,103670,Hsueh; Tzu-Chien,0,0,0,0
1668277530719,ECE 284,A00,103671,Turakhia; Yatish Girish,0,0,0,0
1668277531144,ECE 285,A00,103672,Zheng; Yang,0,0,0,0
1668277531144,ECE 285,B00,103673,Sworder; David D.,0,0,0,0
1668277531570,ECE 287,A00,103676,Javidi; Tara,0,0,0,0
1668277532002,MATH 200B,A00,098023,Salehi Golsefidy; Alireza,12,0,15,3
1668277532423,MATH 202B,A00,098024,Rhoades; Brendon Patrick,9,0,15,6
1668277532850,MATH 203B,A00,098025,Oprea; Dragos N.,10,0,15,5
1668277533272,MATH 204B,A00,098026,Sorensen; Claus M,13,0,15,2
1668277533696,MATH 208,A00,098027,Izadi; Elham,7,0,10,3
1668277534125,MATH 209,A00,098028,Pollack; Aaron,10,0,10,0
1668277534550,MATH 211A,A00,112919,Rogalski; Daniel,9,0,10,1
1668277534973,MATH 211B,A00,112920,Seward; Brandon M.,9,0,10,1
1668277535400,MATH 218,A00,098029,Li; Bo,10,0,10,0
1668277535823,MATH 220B,A00,098030,Novak; Jonathan I,11,0,15,4
1668277536249,MATH 221A,A00,098031,Ebenfelt; Peter F,13,0,15,2
1668277536671,MATH 231B,A00,098032,Zlatos; Andrej,12,0,15,3
1668277537094,MATH 240B,A00,098033,Ni; Lei,9,0,15,6
1668277537529,MATH 243,A00,098034,Jekel; David Andrew,10,0,10,0
1668277537952,MATH 245A,A00,098035,Nie; Jiawang,0,0,15,16
1668277538375,MATH 248,A00,098036,Bejenaru; Ioan,10,0,10,0
1668277538799,MATH 250B,A00,098037,Spolaor; Luca,14,0,15,1
1668277539221,MATH 258,A00,098038,Ni; Lei,10,0,10,0
1668277539651,MATH 264B,A00,098041,Rhoades; Brendon Patrick,9,0,15,6
1668277540074,MATH 268,A00,098042,Buss; Samuel R,10,0,10,0
1668277540496,MATH 269,A00,098043,Rhoades; Brendon Patrick,10,0,10,0
1668277540923,MATH 270B,A00,098044,Li; Bo,10,0,15,5
1668277541347,MATH 272B,A00,098045,Holst; Michael J,13,0,15,2
1668277541769,MATH 273A,A00,098046,Tian; Xiaochuan,10,0,15,5
1668277542196,MATH 275,A01,098048,Tian; Xiaochuan,6,0,10,4
1668277542619,MATH 278A,A00,098049,Holst; Michael J,8,0,10,2
1668277543042,MATH 278B,A00,098050,Cloninger; Alexander,10,0,10,0
1668277543467,MATH 278C,A00,098051,Nie; Jiawang,7,0,10,3
1668277543894,MATH 280B,A00,098052,Zheng; Tianyi,9,0,15,6
1668277544317,MATH 281B,A00,098053,Bradic; Jelena,1,0,15,14
1668277544739,MATH 282B,A00,098054,Arias-Castro; Ery,0,0,15,15
1668277545164,MATH 285,A00,098055,Fitzsimmons; Patrick J,0,0,15,17
1668277545586,MATH 287B,A00,098056,Arias-Castro; Ery,2,0,15,13
1668277546011,MATH 288,A00,098057,Agarwal; Pooja,9,0,10,1
1668277546011,MATH 288,B00,098058,Zhang; Danna,8,0,10,2
1668277546011,MATH 288,C00,098059,Williams; Ruth J,10,0,10,0
1668277546434,MATH 290B,A00,098060,Roberts; Justin Deritter,13,0,15,2
1668277546859,MATH 292,A00,098061,Belmont; Eva Kinoshita,10,0,10,0
1668277547283,MATH 295,A00,098062,Suk; Andrew Hoon,48,0,50,2
1668277547707,MATH 296,A00,098063,Novak; Jonathan I,20,0,20,0
1668277548131,MATH 297,001,098064,Gamst; Anthony Collins,9997,0,9999,2
1668278047013,COGS 205,A00,101395,Chiba; Andrea,19,0,20,1
1668278047438,COGS 210B,001,101404,Greene; Deanna Jacquelyn,9998,0,9999,1
1668278047438,COGS 210B,002,101417,Xia; Haijun,9999,0,9999,0
1668278047438,COGS 210B,003,101422,Nitz; Douglas A.,9999,0,9999,0
1668278047438,COGS 210B,004,101423,Hollan; James D.,9998,0,9999,1
1668278047438,COGS 210B,005,101424,Deak; Gedeon O.,9998,0,9999,1
1668278047438,COGS 210B,006,101425,Rossano; Federico,9999,0,9999,0
1668278047862,COGS 211B,A00,101427,Coulson; Seana M,9996,0,9999,3
1668278048286,COGS 220,A00,101428,Hollan; James D.,0,0,25,25
1668278048712,COGS 229,A00,101429,Dow; Steven P,18,0,25,7
1668278049138,COGS 230,A00,101430,Klemmer; Scott R,12,0,17,5
1668278049567,COGS 234,A00,101431,Xia; Haijun,1,0,25,24
1668278049988,COGS 260,A00,101432,Kiyonaga; Anastasia,21,0,25,4
1668278049988,COGS 260,B00,101433,Kirsh; David Joel,15,0,25,10
1668278050412,CSE 202,A00,102371,Impagliazzo; Russell,0,0,0,0
1668278050840,CSE 203B,A01,102373,Cheng; Chung Kuan,0,0,0,0
1668278051264,CSE 208,A00,102374,Micciancio; Daniele,0,0,0,0
1668278051689,CSE 209A,A00,112895,Impagliazzo; Russell,0,0,15,15
1668278052112,CSE 209B,A00,108005,Bellare; Mihir,0,0,0,0
1668278052536,CSE 210,A00,113163,Coblenz; Michael J,0,0,0,0
1668278052962,CSE 219,A00,106111,Dow; Steven P,0,0,20,20
1668278053386,CSE 221,A00,102376,Voelker; Geoffrey M.,0,0,0,0
1668278053814,CSE 224,A01,102378,Porter; George M,0,0,0,0
1668278054241,CSE 229A,A00,102379,Savage; Stefan,0,0,0,0
1668278054668,CSE 229C,A00,102380,Munyaka; Imani N. S.,0,0,0,0
1668278055098,CSE 232B,A00,102382,Deutsch; Alin Bernard,0,0,0,0
1668278055520,CSE 234,A01,112904,Kumar; Arun Kumar,0,0,0,0
1668278055945,CSE 237A,A00,102383,Rosing; Tajana Simunic,0,0,0,0
1668278056367,CSE 239A,A00,102384,Deutsch; Alin Bernard,0,0,0,0
1668278056797,CSE 239B,A00,102385,Polikarpova; Nadezhda,0,0,0,0
1668278057219,CSE 240A,A00,102386,Pannuto; Patrick William,0,0,0,0
1668278057646,CSE 240B,A00,102387,Zhao; Jishen,0,0,0,0
1668278058070,CSE 241A,A00,106406,Kang; Mingu,0,0,0,0
1668278058493,CSE 249B,A00,102388,Kahng; Andrew Byun,0,0,8,8
1668278058924,CSE 251B,A01,102392,Cottrell; Garrison W,0,0,0,0
1668278058924,CSE 251B,A02,102393,Cottrell; Garrison W,0,0,0,0
1668278059354,CSE 252B,A00,102394,Ochoa; Benjamin Lawrence,0,0,0,0
1668278059779,CSE 257,A01,102396,Gao; Sicun,0,0,0,0
1668278060202,CSE 272,A00,102397,Li; Tzumao,0,0,0,0
1668278060625,CSE 274,A00,111323,Chern; Albert Ren-Haur,0,0,0,0
1668278061054,CSE 282,A00,102398,Pevzner; Pavel Arkadjevich,0,0,0,0
1668278061479,CSE 284,A00,114175,Gymrek; Melissa Ann,0,0,0,0
1668278061907,CSE 290,A00,102399,Chandraker; Manmohan Krishna,0,0,0,0
1668278061907,CSE 290,B00,102400,Vaccaro; Kristen Marie,0,0,25,25
1668278061907,CSE 290,C00,102414,Pannuto; Patrick William,0,0,25,25
1668278061907,CSE 290,D00,102427,Pevzner; Pavel Arkadjevich,0,0,0,0
1668278061907,CSE 290,E00,102429,Zhao; Jishen,0,0,0,0
1668278061907,CSE 290,F00,102436,Tullsen; Dean Michael,0,0,0,0
1668278061907,CSE 290,G00,102440,Christensen; Henrik I,0,0,20,20
1668278062336,CSE 291,A00,102443,Su; Hao,0,0,0,0
1668278062336,CSE 291,B00,102448,Polikarpova; Nadezhda,0,0,0,0
1668278062336,CSE 291,C00,102453,Vaccaro; Kristen Marie,0,0,0,0
1668278062336,CSE 291,D00,111343,Savage; Stefan,0,0,0,0
1668278062336,CSE 291,E00,116474,Claffy; Kimberly Claire,0,0,0,0
1668278062336,CSE 291,F00,116479,Pasquale; Joseph,0,0,0,0
1668278062763,CSE 293,001,119111,Bafna; Vineet,9999,0,9999,0
1668278062763,CSE 293,002,119118,Bellare; Mihir,9999,0,9999,0
1668278062763,CSE 293,003,119122,Berg-Kirkpatrick; Taylor D,9999,0,9999,0
1668278062763,CSE 293,004,119135,Christensen; Henrik I,9999,0,9999,0
1668278062763,CSE 293,005,119142,Cottrell; Garrison W,9999,0,9999,0
1668278062763,CSE 293,006,119146,Deutsch; Alin Bernard,9999,0,9999,0
1668278062763,CSE 293,007,119159,Esmaeilzadeh; Hadi,9999,0,9999,0
1668278062763,CSE 293,008,119166,Freund; Yoav,9999,0,9999,0
1668278062763,CSE 293,009,119170,Griswold; William G.,9999,0,9999,0
1668278062763,CSE 293,010,119183,Gymrek; Melissa Ann,9999,0,9999,0
1668278062763,CSE 293,011,119190,Heninger; Nadia A,9999,0,9999,0
1668278062763,CSE 293,012,119230,Impagliazzo; Russell,9999,0,9999,0
1668278062763,CSE 293,013,119232,Jhala; Ranjit,9999,0,9999,0
1668278062763,CSE 293,014,119233,Kahng; Andrew Byun,9999,0,9999,0
1668278062763,CSE 293,015,119298,Kane; Daniel Mertz,9999,0,9999,0
1668278062763,CSE 293,016,119299,Kriegman; David J,9999,0,9999,0
1668278062763,CSE 293,017,119300,Kumar; Arun Kumar,9999,0,9999,0
1668278062763,CSE 293,018,119301,Lerner; Sorin,9999,0,9999,0
1668278062763,CSE 293,019,119302,Lovett; Shachar,9999,0,9999,0
1668278062763,CSE 293,020,119303,McAuley; Julian John,9999,0,9999,0
1668278062763,CSE 293,021,119304,Micciancio; Daniele,9999,0,9999,0
1668278062763,CSE 293,022,119367,Orailoglu; Alex,9999,0,9999,0
1668278062763,CSE 293,023,119382,Paturi; Ramamohan,9999,0,9999,0
1668278062763,CSE 293,024,119404,Polikarpova; Nadezhda,9999,0,9999,0
1668278062763,CSE 293,025,119406,Politz; Joseph Gibbs,9999,0,9999,0
1668278062763,CSE 293,026,119411,Porter; George M,9999,0,9999,0
1668278062763,CSE 293,027,119414,Porter; Leonard Emerson,9999,0,9999,0
1668278062763,CSE 293,028,119416,Ramamoorthi; Ravi,9999,0,9999,0
1668278062763,CSE 293,029,119417,Sahoo; Debashis,9999,0,9999,0
1668278062763,CSE 293,030,119420,Saul; Lawrence,9999,0,9999,0
1668278062763,CSE 293,031,119421,Savage; Stefan,9999,0,9999,0
1668278062763,CSE 293,032,119425,Schulze; Jurgen P.,9999,0,9999,0
1668278062763,CSE 293,033,119426,Snoeren; Alex C.,9999,0,9999,0
1668278062763,CSE 293,034,119428,Shang; Jingbo,9999,0,9999,0
1668278062763,CSE 293,035,119430,Stefan; Deian,9999,0,9999,0
1668278062763,CSE 293,036,119431,Su; Hao,9999,0,9999,0
1668278062763,CSE 293,037,119433,Swanson; Steven James,9999,0,9999,0
1668278062763,CSE 293,038,119435,Tullsen; Dean Michael,9999,0,9999,0
1668278062763,CSE 293,039,119483,Voelker; Geoffrey M.,9999,0,9999,0
1668278062763,CSE 293,040,119537,Zhao; Jishen,9999,0,9999,0
1668278062763,CSE 293,041,119538,Zhou; Yuan-Yuan,9999,0,9999,0
1668278062763,CSE 293,042,119539,Gao; Sicun,9999,0,9999,0
1668278062763,CSE 293,043,119540,Weibel; Nadir,9999,0,9999,0
1668278062763,CSE 293,044,119541,Gupta; Rajesh K.,9999,0,9999,0
1668278062763,CSE 293,045,126410,Vaccaro; Kristen Marie,9999,0,9999,0
1668278062763,CSE 293,046,126411,Klemke; Richard,9999,0,9999,0
1668278063190,CSE 294,A00,102459,Voelker; Geoffrey M.,0,0,0,0
1668278063190,CSE 294,B00,111322,Orailoglu; Alex,0,0,0,0
1668278063615,DSE 201,A00,096914,Deutsch; Alin Bernard,30,0,30,0
1668278064040,DSE 210,A00,096915,Dasgupta; Sanjoy,30,0,30,0
1668278064462,DSE 260A,A00,096916,Altintas De Callaf; Ilkay,30,0,30,0
1668278064889,ECE 200,001,103586,Antipa; Nicholas A,9999,0,9999,0
1668278064889,ECE 200,002,103587,Atanasov; Nikolay A.,9999,0,9999,0
1668278064889,ECE 200,003,103588,Bharadia; Dinesh,9999,0,9999,0
1668278064889,ECE 200,004,103589,Cheng; Chung Kuan,9999,0,9999,0
1668278064889,ECE 200,005,103590,Cosman; Pamela C.,9999,0,9999,0
1668278064889,ECE 200,006,103591,Dayeh; Shadi Ahmad,9999,0,9999,0
1668278064889,ECE 200,007,103592,Fainman; Yeshaiahu,9999,0,9999,0
1668278064889,ECE 200,008,103593,Ford; Joseph Earl,9999,0,9999,0
1668278064889,ECE 200,009,103594,Franceschetti; Massimo,9999,0,9999,0
1668278064889,ECE 200,010,103595,Fullerton; Eric E,9999,0,9999,0
1668278064889,ECE 200,011,103596,Galton; Ian A,9999,0,9999,0
1668278064889,ECE 200,012,103597,Gilja; Vikash,9999,0,9999,0
1668278064889,ECE 200,013,103598,Hall; Drew A.,9999,0,9999,0
1668278064889,ECE 200,014,103599,Hsueh; Tzu-Chien,9999,0,9999,0
1668278064889,ECE 200,015,103600,Javidi; Tara,9999,0,9999,0
1668278064889,ECE 200,016,103601,Kahng; Andrew Byun,9999,0,9999,0
1668278064889,ECE 200,017,103602,Kim; Young-Han,9999,0,9999,0
1668278064889,ECE 200,018,103603,Koushanfar; Farinaz,9999,0,9999,0
1668278064889,ECE 200,019,103604,Kuzum; Duygu,9999,0,9999,0
1668278064889,ECE 200,020,103605,Le; Hanh-Phuc,9999,0,9999,0
1668278064889,ECE 200,021,103606,Lin; Bill,9999,0,9999,0
1668278064889,ECE 200,022,103607,Liu; Zhaowei,9998,0,9999,1
1668278064889,ECE 200,023,103608,Lo; Yu-Hwa,9999,0,9999,0
1668278064889,ECE 200,024,103609,Lomakin; Vitaliy,9999,0,9999,0
1668278064889,ECE 200,025,103610,Mercier; Patrick Philip,9999,0,9999,0
1668278064889,ECE 200,026,103611,Meyer; Florian,9999,0,9999,0
1668278064889,ECE 200,027,103612,Milstein; Laurence B.,9999,0,9999,0
1668278064889,ECE 200,028,103613,Mir Arabbaygi; Siavash,9999,0,9999,0
1668278064889,ECE 200,029,103614,Mookherjea; Shayan,9999,0,9999,0
1668278064889,ECE 200,030,103615,Morris; Karcher William,9999,0,9999,0
1668278064889,ECE 200,031,103616,Ng; Tse Nga,9999,0,9999,0
1668278064889,ECE 200,032,103617,Nguyen; Truong Quang,9999,0,9999,0
1668278064889,ECE 200,033,103618,Nomura; Kenji,9999,0,9999,0
1668278064889,ECE 200,034,103619,Orlitsky; Alon,9999,0,9999,0
1668278064889,ECE 200,035,103620,Pal; Piya,9999,0,9999,0
1668278064889,ECE 200,036,103621,Papen; George C.,9999,0,9999,0
1668278064889,ECE 200,037,103622,Radic; Stojan,9999,0,9999,0
1668278064889,ECE 200,038,103623,Rao; Bhaskar D.,9999,0,9999,0
1668278064889,ECE 200,039,103624,Rao; Ramesh R,9999,0,9999,0
1668278064889,ECE 200,040,103625,Rebeiz; Gabriel,9999,0,9999,0
1668278064889,ECE 200,041,103626,Sanford; John R,9999,0,9999,0
1668278064889,ECE 200,042,103627,Siegel; Paul H.,9999,0,9999,0
1668278064889,ECE 200,043,103628,Sievenpiper; Daniel F.,9999,0,9999,0
1668278064889,ECE 200,044,103629,Sworder; David D.,9999,0,9999,0
1668278064889,ECE 200,045,103630,Taur; Yuan,9999,0,9999,0
1668278064889,ECE 200,046,103631,Touri; Behrouz,9999,0,9999,0
1668278064889,ECE 200,047,103632,Trivedi; Mohan M.,9999,0,9999,0
1668278064889,ECE 200,048,103633,Vasconcelos; Nuno,9999,0,9999,0
1668278064889,ECE 200,049,103634,Wang; Xiaolong,9999,0,9999,0
1668278064889,ECE 200,050,103635,Xie; Pengtao,9999,0,9999,0
1668278064889,ECE 200,051,103636,Yip; Michael,9999,0,9999,0
1668278064889,ECE 200,052,103637,Zeger; Kenneth A.,999,0,999,0
1668278064889,ECE 200,053,103638,Zhang; Xinyu,9999,0,9999,0
1668278064889,ECE 200,054,103639,Turakhia; Yatish Girish,9999,0,9999,0
1668278064889,ECE 200,055,103640,Kang; Mingu,9999,0,9999,0
1668278064889,ECE 200,056,103641,Shi; Yuanyuan,9999,0,9999,0
1668278064889,ECE 200,057,103642,Wang; Edward Jay,9999,0,9999,0
1668278064889,ECE 200,058,103643,Zheng; Yang,9999,0,9999,0
1668278065315,ECE 202,A00,103644,Kuzum; Duygu,0,0,0,0
1668278065739,ECE 212BN,A00,103646,Ng; Tse Nga,0,0,0,0
1668278066162,ECE 221,A00,111493,Staff,0,0,0,0
1668278066585,ECE 222B,A00,103647,Lomakin; Vitaliy,0,0,0,0
1668278067012,ECE 230B,A00,103648,Taur; Yuan,0,0,0,0
1668278067435,ECE 238B,A00,103649,Garay; Javier,0,0,0,0
1668278067880,ECE 240B,A00,112900,Fainman; Yeshaiahu,0,0,0,0
1668278068306,ECE 247A,A00,103650,Jokerst; Jesse Vincent,0,0,0,0
1668278068733,ECE 247B,A00,103651,Wang; Joseph,0,0,0,0
1668278069156,ECE 250,A00,103652,Siegel; Paul H.,0,0,0,0
1668278069579,ECE 251A,A00,103654,Rao; Bhaskar D.,0,0,0,0
1668278070002,ECE 257B,A00,103655,Bharadia; Dinesh,0,0,0,0
1668278070429,ECE 258A,A00,103656,Milstein; Laurence B.,0,0,0,0
1668278070852,ECE 260B,A00,103658,Kang; Mingu,0,0,0,0
1668278071280,ECE 264A,A00,103659,Galton; Ian A,0,0,0,0
1668278071712,ECE 265A,A00,103661,Gudem; Prasad S.S.,0,0,0,0
1668278072135,ECE 265D,A00,103662,Gudem; Prasad S.S.,0,0,0,0
1668278072558,ECE 268,A00,103663,Koushanfar; Farinaz,0,0,0,0
1668278072981,ECE 269,A01,103665,Pal; Piya,0,0,0,0
1668278073403,ECE 271B,A00,103666,Vasconcelos; Manuela,0,0,0,0
1668278073833,ECE 276A,A00,103667,Atanasov; Nikolay A.,0,0,0,0
1668278074266,ECE 277,A00,103668,An; Cheolhong,0,0,0,0
1668278074690,ECE 279,A00,117947,Hall; Drew A.,0,0,0,0
1668278075539,ECE 283,A00,103670,Hsueh; Tzu-Chien,0,0,0,0
1668278075962,ECE 284,A00,103671,Turakhia; Yatish Girish,0,0,0,0
1668278076384,ECE 285,A00,103672,Zheng; Yang,0,0,0,0
1668278076384,ECE 285,B00,103673,Sworder; David D.,0,0,0,0
1668278076808,ECE 287,A00,103676,Javidi; Tara,0,0,0,0
1668278077231,MATH 200B,A00,098023,Salehi Golsefidy; Alireza,12,0,15,3
1668278077654,MATH 202B,A00,098024,Rhoades; Brendon Patrick,9,0,15,6
1668278078080,MATH 203B,A00,098025,Oprea; Dragos N.,10,0,15,5
1668278078509,MATH 204B,A00,098026,Sorensen; Claus M,13,0,15,2
1668278078933,MATH 208,A00,098027,Izadi; Elham,7,0,10,3
1668278079358,MATH 209,A00,098028,Pollack; Aaron,10,0,10,0
1668278079788,MATH 211A,A00,112919,Rogalski; Daniel,9,0,10,1
1668278080215,MATH 211B,A00,112920,Seward; Brandon M.,9,0,10,1
1668278080638,MATH 218,A00,098029,Li; Bo,10,0,10,0
1668278081065,MATH 220B,A00,098030,Novak; Jonathan I,11,0,15,4
1668278081491,MATH 221A,A00,098031,Ebenfelt; Peter F,13,0,15,2
1668278081915,MATH 231B,A00,098032,Zlatos; Andrej,12,0,15,3
1668278082341,MATH 240B,A00,098033,Ni; Lei,9,0,15,6
1668278082763,MATH 243,A00,098034,Jekel; David Andrew,10,0,10,0
1668278083189,MATH 245A,A00,098035,Nie; Jiawang,0,0,15,16
1668278083612,MATH 248,A00,098036,Bejenaru; Ioan,10,0,10,0
1668278084035,MATH 250B,A00,098037,Spolaor; Luca,14,0,15,1
1668278084457,MATH 258,A00,098038,Ni; Lei,10,0,10,0
1668278084883,MATH 264B,A00,098041,Rhoades; Brendon Patrick,9,0,15,6
1668278085403,MATH 268,A00,098042,Buss; Samuel R,10,0,10,0
1668278085824,MATH 269,A00,098043,Rhoades; Brendon Patrick,10,0,10,0
1668278086251,MATH 270B,A00,098044,Li; Bo,10,0,15,5
1668278086675,MATH 272B,A00,098045,Holst; Michael J,13,0,15,2
1668278087101,MATH 273A,A00,098046,Tian; Xiaochuan,10,0,15,5
1668278087524,MATH 275,A01,098048,Tian; Xiaochuan,6,0,10,4
1668278087947,MATH 278A,A00,098049,Holst; Michael J,8,0,10,2
1668278088374,MATH 278B,A00,098050,Cloninger; Alexander,10,0,10,0
1668278088797,MATH 278C,A00,098051,Nie; Jiawang,7,0,10,3
1668278089220,MATH 280B,A00,098052,Zheng; Tianyi,9,0,15,6
1668278089648,MATH 281B,A00,098053,Bradic; Jelena,1,0,15,14
1668278090081,MATH 282B,A00,098054,Arias-Castro; Ery,0,0,15,15
1668278090505,MATH 285,A00,098055,Fitzsimmons; Patrick J,0,0,15,17
1668278090931,MATH 287B,A00,098056,Arias-Castro; Ery,2,0,15,13
1668278091355,MATH 288,A00,098057,Agarwal; Pooja,9,0,10,1
1668278091355,MATH 288,B00,098058,Zhang; Danna,8,0,10,2
1668278091355,MATH 288,C00,098059,Williams; Ruth J,10,0,10,0
1668278091779,MATH 290B,A00,098060,Roberts; Justin Deritter,13,0,15,2
1668278092205,MATH 292,A00,098061,Belmont; Eva Kinoshita,10,0,10,0
1668278092629,MATH 295,A00,098062,Suk; Andrew Hoon,48,0,50,2
1668278093056,MATH 296,A00,098063,Novak; Jonathan I,20,0,20,0
1668278093479,MATH 297,001,098064,Gamst; Anthony Collins,9997,0,9999,2
1668278591674,COGS 205,A00,101395,Chiba; Andrea,19,0,20,1
1668278592099,COGS 210B,001,101404,Greene; Deanna Jacquelyn,9998,0,9999,1
1668278592099,COGS 210B,002,101417,Xia; Haijun,9999,0,9999,0
1668278592099,COGS 210B,003,101422,Nitz; Douglas A.,9999,0,9999,0
1668278592099,COGS 210B,004,101423,Hollan; James D.,9998,0,9999,1
1668278592099,COGS 210B,005,101424,Deak; Gedeon O.,9998,0,9999,1
1668278592099,COGS 210B,006,101425,Rossano; Federico,9999,0,9999,0
1668278592525,COGS 211B,A00,101427,Coulson; Seana M,9996,0,9999,3
1668278592949,COGS 220,A00,101428,Hollan; James D.,0,0,25,25
1668278593375,COGS 229,A00,101429,Dow; Steven P,18,0,25,7
1668278593801,COGS 230,A00,101430,Klemmer; Scott R,12,0,17,5
1668278594237,COGS 234,A00,101431,Xia; Haijun,1,0,25,24
1668278594663,COGS 260,A00,101432,Kiyonaga; Anastasia,21,0,25,4
1668278594663,COGS 260,B00,101433,Kirsh; David Joel,15,0,25,10
1668278595090,CSE 202,A00,102371,Impagliazzo; Russell,0,0,0,0
1668278595512,CSE 203B,A01,102373,Cheng; Chung Kuan,0,0,0,0
1668278595935,CSE 208,A00,102374,Micciancio; Daniele,0,0,0,0
1668278596361,CSE 209A,A00,112895,Impagliazzo; Russell,0,0,15,15
1668278596784,CSE 209B,A00,108005,Bellare; Mihir,0,0,0,0
1668278597207,CSE 210,A00,113163,Coblenz; Michael J,0,0,0,0
1668278597634,CSE 219,A00,106111,Dow; Steven P,0,0,20,20
1668278598058,CSE 221,A00,102376,Voelker; Geoffrey M.,0,0,0,0
1668278598484,CSE 224,A01,102378,Porter; George M,0,0,0,0
1668278598911,CSE 229A,A00,102379,Savage; Stefan,0,0,0,0
1668278599337,CSE 229C,A00,102380,Munyaka; Imani N. S.,0,0,0,0
1668278599762,CSE 232B,A00,102382,Deutsch; Alin Bernard,0,0,0,0
1668278600185,CSE 234,A01,112904,Kumar; Arun Kumar,0,0,0,0
1668278600612,CSE 237A,A00,102383,Rosing; Tajana Simunic,0,0,0,0
1668278601039,CSE 239A,A00,102384,Deutsch; Alin Bernard,0,0,0,0
1668278601463,CSE 239B,A00,102385,Polikarpova; Nadezhda,0,0,0,0
1668278601887,CSE 240A,A00,102386,Pannuto; Patrick William,0,0,0,0
1668278602311,CSE 240B,A00,102387,Zhao; Jishen,0,0,0,0
1668278602734,CSE 241A,A00,106406,Kang; Mingu,0,0,0,0
1668278603160,CSE 249B,A00,102388,Kahng; Andrew Byun,0,0,8,8
1668278603662,CSE 251B,A01,102392,Cottrell; Garrison W,0,0,0,0
1668278603662,CSE 251B,A02,102393,Cottrell; Garrison W,0,0,0,0
1668278604085,CSE 252B,A00,102394,Ochoa; Benjamin Lawrence,0,0,0,0
1668278604509,CSE 257,A01,102396,Gao; Sicun,0,0,0,0
1668278604935,CSE 272,A00,102397,Li; Tzumao,0,0,0,0
1668278605360,CSE 274,A00,111323,Chern; Albert Ren-Haur,0,0,0,0
1668278605783,CSE 282,A00,102398,Pevzner; Pavel Arkadjevich,0,0,0,0
1668278606206,CSE 284,A00,114175,Gymrek; Melissa Ann,0,0,0,0
1668278606631,CSE 290,A00,102399,Chandraker; Manmohan Krishna,0,0,0,0
1668278606631,CSE 290,B00,102400,Vaccaro; Kristen Marie,0,0,25,25
1668278606631,CSE 290,C00,102414,Pannuto; Patrick William,0,0,25,25
1668278606631,CSE 290,D00,102427,Pevzner; Pavel Arkadjevich,0,0,0,0
1668278606631,CSE 290,E00,102429,Zhao; Jishen,0,0,0,0
1668278606631,CSE 290,F00,102436,Tullsen; Dean Michael,0,0,0,0
1668278606631,CSE 290,G00,102440,Christensen; Henrik I,0,0,20,20
1668278607056,CSE 291,A00,102443,Su; Hao,0,0,0,0
1668278607056,CSE 291,B00,102448,Polikarpova; Nadezhda,0,0,0,0
1668278607056,CSE 291,C00,102453,Vaccaro; Kristen Marie,0,0,0,0
1668278607056,CSE 291,D00,111343,Savage; Stefan,0,0,0,0
1668278607056,CSE 291,E00,116474,Claffy; Kimberly Claire,0,0,0,0
1668278607056,CSE 291,F00,116479,Pasquale; Joseph,0,0,0,0
1668278607492,CSE 293,001,119111,Bafna; Vineet,9999,0,9999,0
1668278607492,CSE 293,002,119118,Bellare; Mihir,9999,0,9999,0
1668278607492,CSE 293,003,119122,Berg-Kirkpatrick; Taylor D,9999,0,9999,0
1668278607492,CSE 293,004,119135,Christensen; Henrik I,9999,0,9999,0
1668278607492,CSE 293,005,119142,Cottrell; Garrison W,9999,0,9999,0
1668278607492,CSE 293,006,119146,Deutsch; Alin Bernard,9999,0,9999,0
1668278607492,CSE 293,007,119159,Esmaeilzadeh; Hadi,9999,0,9999,0
1668278607492,CSE 293,008,119166,Freund; Yoav,9999,0,9999,0
1668278607492,CSE 293,009,119170,Griswold; William G.,9999,0,9999,0
1668278607492,CSE 293,010,119183,Gymrek; Melissa Ann,9999,0,9999,0
1668278607492,CSE 293,011,119190,Heninger; Nadia A,9999,0,9999,0
1668278607492,CSE 293,012,119230,Impagliazzo; Russell,9999,0,9999,0
1668278607492,CSE 293,013,119232,Jhala; Ranjit,9999,0,9999,0
1668278607492,CSE 293,014,119233,Kahng; Andrew Byun,9999,0,9999,0
1668278607492,CSE 293,015,119298,Kane; Daniel Mertz,9999,0,9999,0
1668278607492,CSE 293,016,119299,Kriegman; David J,9999,0,9999,0
1668278607492,CSE 293,017,119300,Kumar; Arun Kumar,9999,0,9999,0
1668278607492,CSE 293,018,119301,Lerner; Sorin,9999,0,9999,0
1668278607492,CSE 293,019,119302,Lovett; Shachar,9999,0,9999,0
1668278607492,CSE 293,020,119303,McAuley; Julian John,9999,0,9999,0
1668278607492,CSE 293,021,119304,Micciancio; Daniele,9999,0,9999,0
1668278607492,CSE 293,022,119367,Orailoglu; Alex,9999,0,9999,0
1668278607492,CSE 293,023,119382,Paturi; Ramamohan,9999,0,9999,0
1668278607492,CSE 293,024,119404,Polikarpova; Nadezhda,9999,0,9999,0
1668278607492,CSE 293,025,119406,Politz; Joseph Gibbs,9999,0,9999,0
1668278607492,CSE 293,026,119411,Porter; George M,9999,0,9999,0
1668278607492,CSE 293,027,119414,Porter; Leonard Emerson,9999,0,9999,0
1668278607492,CSE 293,028,119416,Ramamoorthi; Ravi,9999,0,9999,0
1668278607492,CSE 293,029,119417,Sahoo; Debashis,9999,0,9999,0
1668278607492,CSE 293,030,119420,Saul; Lawrence,9999,0,9999,0
1668278607492,CSE 293,031,119421,Savage; Stefan,9999,0,9999,0
1668278607492,CSE 293,032,119425,Schulze; Jurgen P.,9999,0,9999,0
1668278607492,CSE 293,033,119426,Snoeren; Alex C.,9999,0,9999,0
1668278607492,CSE 293,034,119428,Shang; Jingbo,9999,0,9999,0
1668278607492,CSE 293,035,119430,Stefan; Deian,9999,0,9999,0
1668278607492,CSE 293,036,119431,Su; Hao,9999,0,9999,0
1668278607492,CSE 293,037,119433,Swanson; Steven James,9999,0,9999,0
1668278607492,CSE 293,038,119435,Tullsen; Dean Michael,9999,0,9999,0
1668278607492,CSE 293,039,119483,Voelker; Geoffrey M.,9999,0,9999,0
1668278607492,CSE 293,040,119537,Zhao; Jishen,9999,0,9999,0
1668278607492,CSE 293,041,119538,Zhou; Yuan-Yuan,9999,0,9999,0
1668278607492,CSE 293,042,119539,Gao; Sicun,9999,0,9999,0
1668278607492,CSE 293,043,119540,Weibel; Nadir,9999,0,9999,0
1668278607492,CSE 293,044,119541,Gupta; Rajesh K.,9999,0,9999,0
1668278607492,CSE 293,045,126410,Vaccaro; Kristen Marie,9999,0,9999,0
1668278607492,CSE 293,046,126411,Klemke; Richard,9999,0,9999,0
1668278607917,CSE 294,A00,102459,Voelker; Geoffrey M.,0,0,0,0
1668278607917,CSE 294,B00,111322,Orailoglu; Alex,0,0,0,0
1668278608342,DSE 201,A00,096914,Deutsch; Alin Bernard,30,0,30,0
1668278608767,DSE 210,A00,096915,Dasgupta; Sanjoy,30,0,30,0
1668278609194,DSE 260A,A00,096916,Altintas De Callaf; Ilkay,30,0,30,0
1668278609630,ECE 200,001,103586,Antipa; Nicholas A,9999,0,9999,0
1668278609630,ECE 200,002,103587,Atanasov; Nikolay A.,9999,0,9999,0
1668278609630,ECE 200,003,103588,Bharadia; Dinesh,9999,0,9999,0
1668278609630,ECE 200,004,103589,Cheng; Chung Kuan,9999,0,9999,0
1668278609630,ECE 200,005,103590,Cosman; Pamela C.,9999,0,9999,0
1668278609630,ECE 200,006,103591,Dayeh; Shadi Ahmad,9999,0,9999,0
1668278609630,ECE 200,007,103592,Fainman; Yeshaiahu,9999,0,9999,0
1668278609630,ECE 200,008,103593,Ford; Joseph Earl,9999,0,9999,0
1668278609630,ECE 200,009,103594,Franceschetti; Massimo,9999,0,9999,0
1668278609630,ECE 200,010,103595,Fullerton; Eric E,9999,0,9999,0
1668278609630,ECE 200,011,103596,Galton; Ian A,9999,0,9999,0
1668278609630,ECE 200,012,103597,Gilja; Vikash,9999,0,9999,0
1668278609630,ECE 200,013,103598,Hall; Drew A.,9999,0,9999,0
1668278609630,ECE 200,014,103599,Hsueh; Tzu-Chien,9999,0,9999,0
1668278609630,ECE 200,015,103600,Javidi; Tara,9999,0,9999,0
1668278609630,ECE 200,016,103601,Kahng; Andrew Byun,9999,0,9999,0
1668278609630,ECE 200,017,103602,Kim; Young-Han,9999,0,9999,0
1668278609630,ECE 200,018,103603,Koushanfar; Farinaz,9999,0,9999,0
1668278609630,ECE 200,019,103604,Kuzum; Duygu,9999,0,9999,0
1668278609630,ECE 200,020,103605,Le; Hanh-Phuc,9999,0,9999,0
1668278609630,ECE 200,021,103606,Lin; Bill,9999,0,9999,0
1668278609630,ECE 200,022,103607,Liu; Zhaowei,9998,0,9999,1
1668278609630,ECE 200,023,103608,Lo; Yu-Hwa,9999,0,9999,0
1668278609630,ECE 200,024,103609,Lomakin; Vitaliy,9999,0,9999,0
1668278609630,ECE 200,025,103610,Mercier; Patrick Philip,9999,0,9999,0
1668278609630,ECE 200,026,103611,Meyer; Florian,9999,0,9999,0
1668278609630,ECE 200,027,103612,Milstein; Laurence B.,9999,0,9999,0
1668278609630,ECE 200,028,103613,Mir Arabbaygi; Siavash,9999,0,9999,0
1668278609630,ECE 200,029,103614,Mookherjea; Shayan,9999,0,9999,0
1668278609630,ECE 200,030,103615,Morris; Karcher William,9999,0,9999,0
1668278609630,ECE 200,031,103616,Ng; Tse Nga,9999,0,9999,0
1668278609630,ECE 200,032,103617,Nguyen; Truong Quang,9999,0,9999,0
1668278609630,ECE 200,033,103618,Nomura; Kenji,9999,0,9999,0
1668278609630,ECE 200,034,103619,Orlitsky; Alon,9999,0,9999,0
1668278609630,ECE 200,035,103620,Pal; Piya,9999,0,9999,0
1668278609630,ECE 200,036,103621,Papen; George C.,9999,0,9999,0
1668278609630,ECE 200,037,103622,Radic; Stojan,9999,0,9999,0
1668278609630,ECE 200,038,103623,Rao; Bhaskar D.,9999,0,9999,0
1668278609630,ECE 200,039,103624,Rao; Ramesh R,9999,0,9999,0
1668278609630,ECE 200,040,103625,Rebeiz; Gabriel,9999,0,9999,0
1668278609630,ECE 200,041,103626,Sanford; John R,9999,0,9999,0
1668278609630,ECE 200,042,103627,Siegel; Paul H.,9999,0,9999,0
1668278609630,ECE 200,043,103628,Sievenpiper; Daniel F.,9999,0,9999,0
1668278609630,ECE 200,044,103629,Sworder; David D.,9999,0,9999,0
1668278609630,ECE 200,045,103630,Taur; Yuan,9999,0,9999,0
1668278609630,ECE 200,046,103631,Touri; Behrouz,9999,0,9999,0
1668278609630,ECE 200,047,103632,Trivedi; Mohan M.,9999,0,9999,0
1668278609630,ECE 200,048,103633,Vasconcelos; Nuno,9999,0,9999,0
1668278609630,ECE 200,049,103634,Wang; Xiaolong,9999,0,9999,0
1668278609630,ECE 200,050,103635,Xie; Pengtao,9999,0,9999,0
1668278609630,ECE 200,051,103636,Yip; Michael,9999,0,9999,0
1668278609630,ECE 200,052,103637,Zeger; Kenneth A.,999,0,999,0
1668278609630,ECE 200,053,103638,Zhang; Xinyu,9999,0,9999,0
1668278609630,ECE 200,054,103639,Turakhia; Yatish Girish,9999,0,9999,0
1668278609630,ECE 200,055,103640,Kang; Mingu,9999,0,9999,0
1668278609630,ECE 200,056,103641,Shi; Yuanyuan,9999,0,9999,0
1668278609630,ECE 200,057,103642,Wang; Edward Jay,9999,0,9999,0
1668278609630,ECE 200,058,103643,Zheng; Yang,9999,0,9999,0
1668278610053,ECE 202,A00,103644,Kuzum; Duygu,0,0,0,0
1668278610476,ECE 212BN,A00,103646,Ng; Tse Nga,0,0,0,0
1668278610902,ECE 221,A00,111493,Staff,0,0,0,0
1668278611329,ECE 222B,A00,103647,Lomakin; Vitaliy,0,0,0,0
1668278611752,ECE 230B,A00,103648,Taur; Yuan,0,0,0,0
1668278612175,ECE 238B,A00,103649,Garay; Javier,0,0,0,0
1668278612597,ECE 240B,A00,112900,Fainman; Yeshaiahu,0,0,0,0
1668278613021,ECE 247A,A00,103650,Jokerst; Jesse Vincent,0,0,0,0
1668278613450,ECE 247B,A00,103651,Wang; Joseph,0,0,0,0
1668278613875,ECE 250,A00,103652,Siegel; Paul H.,0,0,0,0
1668278614299,ECE 251A,A00,103654,Rao; Bhaskar D.,0,0,0,0
1668278614724,ECE 257B,A00,103655,Bharadia; Dinesh,0,0,0,0
1668278615157,ECE 258A,A00,103656,Milstein; Laurence B.,0,0,0,0
1668278615581,ECE 260B,A00,103658,Kang; Mingu,0,0,0,0
1668278616004,ECE 264A,A00,103659,Galton; Ian A,0,0,0,0
1668278616442,ECE 265A,A00,103661,Gudem; Prasad S.S.,0,0,0,0
1668278616866,ECE 265D,A00,103662,Gudem; Prasad S.S.,0,0,0,0
1668278617290,ECE 268,A00,103663,Koushanfar; Farinaz,0,0,0,0
1668278617713,ECE 269,A01,103665,Pal; Piya,0,0,0,0
1668278618137,ECE 271B,A00,103666,Vasconcelos; Manuela,0,0,0,0
1668278618564,ECE 276A,A00,103667,Atanasov; Nikolay A.,0,0,0,0
1668278618988,ECE 277,A00,103668,An; Cheolhong,0,0,0,0
1668278619411,ECE 279,A00,117947,Hall; Drew A.,0,0,0,0
1668278620259,ECE 283,A00,103670,Hsueh; Tzu-Chien,0,0,0,0
1668278620682,ECE 284,A00,103671,Turakhia; Yatish Girish,0,0,0,0
1668278621115,ECE 285,A00,103672,Zheng; Yang,0,0,0,0
1668278621115,ECE 285,B00,103673,Sworder; David D.,0,0,0,0
1668278621539,ECE 287,A00,103676,Javidi; Tara,0,0,0,0
1668278621967,MATH 200B,A00,098023,Salehi Golsefidy; Alireza,12,0,15,3
1668278622388,MATH 202B,A00,098024,Rhoades; Brendon Patrick,9,0,15,6
1668278622814,MATH 203B,A00,098025,Oprea; Dragos N.,10,0,15,5
1668278623241,MATH 204B,A00,098026,Sorensen; Claus M,13,0,15,2
1668278623664,MATH 208,A00,098027,Izadi; Elham,7,0,10,3
1668278624095,MATH 209,A00,098028,Pollack; Aaron,10,0,10,0
1668278624518,MATH 211A,A00,112919,Rogalski; Daniel,9,0,10,1
1668278624939,MATH 211B,A00,112920,Seward; Brandon M.,9,0,10,1
1668278625364,MATH 218,A00,098029,Li; Bo,10,0,10,0
1668278625788,MATH 220B,A00,098030,Novak; Jonathan I,11,0,15,4
1668278626213,MATH 221A,A00,098031,Ebenfelt; Peter F,13,0,15,2
1668278626635,MATH 231B,A00,098032,Zlatos; Andrej,12,0,15,3
1668278627063,MATH 240B,A00,098033,Ni; Lei,9,0,15,6
1668278627487,MATH 243,A00,098034,Jekel; David Andrew,10,0,10,0
1668278627912,MATH 245A,A00,098035,Nie; Jiawang,0,0,15,16
1668278628341,MATH 248,A00,098036,Bejenaru; Ioan,10,0,10,0
1668278628768,MATH 250B,A00,098037,Spolaor; Luca,14,0,15,1
1668278629191,MATH 258,A00,098038,Ni; Lei,10,0,10,0
1668278629615,MATH 264B,A00,098041,Rhoades; Brendon Patrick,9,0,15,6
1668278630038,MATH 268,A00,098042,Buss; Samuel R,10,0,10,0
1668278630463,MATH 269,A00,098043,Rhoades; Brendon Patrick,10,0,10,0
1668278630889,MATH 270B,A00,098044,Li; Bo,10,0,15,5
1668278631317,MATH 272B,A00,098045,Holst; Michael J,13,0,15,2
1668278631739,MATH 273A,A00,098046,Tian; Xiaochuan,10,0,15,5
1668278632165,MATH 275,A01,098048,Tian; Xiaochuan,6,0,10,4
1668278632590,MATH 278A,A00,098049,Holst; Michael J,8,0,10,2
1668278633011,MATH 278B,A00,098050,Cloninger; Alexander,10,0,10,0
1668278633435,MATH 278C,A00,098051,Nie; Jiawang,7,0,10,3
1668278633861,MATH 280B,A00,098052,Zheng; Tianyi,9,0,15,6
1668278634283,MATH 281B,A00,098053,Bradic; Jelena,1,0,15,14
1668278634707,MATH 282B,A00,098054,Arias-Castro; Ery,0,0,15,15
1668278635133,MATH 285,A00,098055,Fitzsimmons; Patrick J,0,0,15,17
1668278635558,MATH 287B,A00,098056,Arias-Castro; Ery,2,0,15,13
1668278635983,MATH 288,A00,098057,Agarwal; Pooja,9,0,10,1
1668278635983,MATH 288,B00,098058,Zhang; Danna,8,0,10,2
1668278635983,MATH 288,C00,098059,Williams; Ruth J,10,0,10,0
1668278636418,MATH 290B,A00,098060,Roberts; Justin Deritter,13,0,15,2
1668278636840,MATH 292,A00,098061,Belmont; Eva Kinoshita,10,0,10,0
1668278637263,MATH 295,A00,098062,Suk; Andrew Hoon,48,0,50,2
1668278637685,MATH 296,A00,098063,Novak; Jonathan I,20,0,20,0
1668278638114,MATH 297,001,098064,Gamst; Anthony Collins,9997,0,9999,2
1668279137065,COGS 205,A00,101395,Chiba; Andrea,19,0,20,1
1668279137490,COGS 210B,001,101404,Greene; Deanna Jacquelyn,9998,0,9999,1
1668279137490,COGS 210B,002,101417,Xia; Haijun,9999,0,9999,0
1668279137490,COGS 210B,003,101422,Nitz; Douglas A.,9999,0,9999,0
1668279137490,COGS 210B,004,101423,Hollan; James D.,9998,0,9999,1
1668279137490,COGS 210B,005,101424,Deak; Gedeon O.,9998,0,9999,1
1668279137490,COGS 210B,006,101425,Rossano; Federico,9999,0,9999,0
1668279137913,COGS 211B,A00,101427,Coulson; Seana M,9996,0,9999,3
1668279138336,COGS 220,A00,101428,Hollan; James D.,0,0,25,25
1668279138758,COGS 229,A00,101429,Dow; Steven P,18,0,25,7
1668279139181,COGS 230,A00,101430,Klemmer; Scott R,12,0,17,5
1668279139605,COGS 234,A00,101431,Xia; Haijun,1,0,25,24
1668279140028,COGS 260,A00,101432,Kiyonaga; Anastasia,21,0,25,4
1668279140028,COGS 260,B00,101433,Kirsh; David Joel,15,0,25,10
1668279140454,CSE 202,A00,102371,Impagliazzo; Russell,0,0,0,0
1668279140876,CSE 203B,A01,102373,Cheng; Chung Kuan,0,0,0,0
1668279141301,CSE 208,A00,102374,Micciancio; Daniele,0,0,0,0
1668279141724,CSE 209A,A00,112895,Impagliazzo; Russell,0,0,15,15
1668279142148,CSE 209B,A00,108005,Bellare; Mihir,0,0,0,0
1668279142583,CSE 210,A00,113163,Coblenz; Michael J,0,0,0,0
1668279143005,CSE 219,A00,106111,Dow; Steven P,0,0,20,20
1668279143429,CSE 221,A00,102376,Voelker; Geoffrey M.,0,0,0,0
1668279143852,CSE 224,A01,102378,Porter; George M,0,0,0,0
1668279144278,CSE 229A,A00,102379,Savage; Stefan,0,0,0,0
1668279144713,CSE 229C,A00,102380,Munyaka; Imani N. S.,0,0,0,0
1668279145136,CSE 232B,A00,102382,Deutsch; Alin Bernard,0,0,0,0
1668279145561,CSE 234,A01,112904,Kumar; Arun Kumar,0,0,0,0
1668279146000,CSE 237A,A00,102383,Rosing; Tajana Simunic,0,0,0,0
1668279146424,CSE 239A,A00,102384,Deutsch; Alin Bernard,0,0,0,0
1668279146851,CSE 239B,A00,102385,Polikarpova; Nadezhda,0,0,0,0
1668279147284,CSE 240A,A00,102386,Pannuto; Patrick William,0,0,0,0
1668279147707,CSE 240B,A00,102387,Zhao; Jishen,0,0,0,0
1668279148130,CSE 241A,A00,106406,Kang; Mingu,0,0,0,0
1668279148556,CSE 249B,A00,102388,Kahng; Andrew Byun,0,0,8,8
1668279148979,CSE 251B,A01,102392,Cottrell; Garrison W,0,0,0,0
1668279148979,CSE 251B,A02,102393,Cottrell; Garrison W,0,0,0,0
1668279149404,CSE 252B,A00,102394,Ochoa; Benjamin Lawrence,0,0,0,0
1668279149828,CSE 257,A01,102396,Gao; Sicun,0,0,0,0
1668279150255,CSE 272,A00,102397,Li; Tzumao,0,0,0,0
1668279150679,CSE 274,A00,111323,Chern; Albert Ren-Haur,0,0,0,0
1668279151104,CSE 282,A00,102398,Pevzner; Pavel Arkadjevich,0,0,0,0
1668279151527,CSE 284,A00,114175,Gymrek; Melissa Ann,0,0,0,0
1668279151955,CSE 290,A00,102399,Chandraker; Manmohan Krishna,0,0,0,0
1668279151955,CSE 290,B00,102400,Vaccaro; Kristen Marie,0,0,25,25
1668279151955,CSE 290,C00,102414,Pannuto; Patrick William,0,0,25,25
1668279151955,CSE 290,D00,102427,Pevzner; Pavel Arkadjevich,0,0,0,0
1668279151955,CSE 290,E00,102429,Zhao; Jishen,0,0,0,0
1668279151955,CSE 290,F00,102436,Tullsen; Dean Michael,0,0,0,0
1668279151955,CSE 290,G00,102440,Christensen; Henrik I,0,0,20,20
1668279152383,CSE 291,A00,102443,Su; Hao,0,0,0,0
1668279152383,CSE 291,B00,102448,Polikarpova; Nadezhda,0,0,0,0
1668279152383,CSE 291,C00,102453,Vaccaro; Kristen Marie,0,0,0,0
1668279152383,CSE 291,D00,111343,Savage; Stefan,0,0,0,0
1668279152383,CSE 291,E00,116474,Claffy; Kimberly Claire,0,0,0,0
1668279152383,CSE 291,F00,116479,Pasquale; Joseph,0,0,0,0
1668279152809,CSE 293,001,119111,Bafna; Vineet,9999,0,9999,0
1668279152809,CSE 293,002,119118,Bellare; Mihir,9999,0,9999,0
1668279152809,CSE 293,003,119122,Berg-Kirkpatrick; Taylor D,9999,0,9999,0
1668279152809,CSE 293,004,119135,Christensen; Henrik I,9999,0,9999,0
1668279152809,CSE 293,005,119142,Cottrell; Garrison W,9999,0,9999,0
1668279152809,CSE 293,006,119146,Deutsch; Alin Bernard,9999,0,9999,0
1668279152809,CSE 293,007,119159,Esmaeilzadeh; Hadi,9999,0,9999,0
1668279152809,CSE 293,008,119166,Freund; Yoav,9999,0,9999,0
1668279152809,CSE 293,009,119170,Griswold; William G.,9999,0,9999,0
1668279152809,CSE 293,010,119183,Gymrek; Melissa Ann,9999,0,9999,0
1668279152809,CSE 293,011,119190,Heninger; Nadia A,9999,0,9999,0
1668279152809,CSE 293,012,119230,Impagliazzo; Russell,9999,0,9999,0
1668279152809,CSE 293,013,119232,Jhala; Ranjit,9999,0,9999,0
1668279152809,CSE 293,014,119233,Kahng; Andrew Byun,9999,0,9999,0
1668279152809,CSE 293,015,119298,Kane; Daniel Mertz,9999,0,9999,0
1668279152809,CSE 293,016,119299,Kriegman; David J,9999,0,9999,0
1668279152809,CSE 293,017,119300,Kumar; Arun Kumar,9999,0,9999,0
1668279152809,CSE 293,018,119301,Lerner; Sorin,9999,0,9999,0
1668279152809,CSE 293,019,119302,Lovett; Shachar,9999,0,9999,0
1668279152809,CSE 293,020,119303,McAuley; Julian John,9999,0,9999,0
1668279152809,CSE 293,021,119304,Micciancio; Daniele,9999,0,9999,0
1668279152809,CSE 293,022,119367,Orailoglu; Alex,9999,0,9999,0
1668279152809,CSE 293,023,119382,Paturi; Ramamohan,9999,0,9999,0
1668279152809,CSE 293,024,119404,Polikarpova; Nadezhda,9999,0,9999,0
1668279152809,CSE 293,025,119406,Politz; Joseph Gibbs,9999,0,9999,0
1668279152809,CSE 293,026,119411,Porter; George M,9999,0,9999,0
1668279152809,CSE 293,027,119414,Porter; Leonard Emerson,9999,0,9999,0
1668279152809,CSE 293,028,119416,Ramamoorthi; Ravi,9999,0,9999,0
1668279152809,CSE 293,029,119417,Sahoo; Debashis,9999,0,9999,0
1668279152809,CSE 293,030,119420,Saul; Lawrence,9999,0,9999,0
1668279152809,CSE 293,031,119421,Savage; Stefan,9999,0,9999,0
1668279152809,CSE 293,032,119425,Schulze; Jurgen P.,9999,0,9999,0
1668279152809,CSE 293,033,119426,Snoeren; Alex C.,9999,0,9999,0
1668279152809,CSE 293,034,119428,Shang; Jingbo,9999,0,9999,0
1668279152809,CSE 293,035,119430,Stefan; Deian,9999,0,9999,0
1668279152809,CSE 293,036,119431,Su; Hao,9999,0,9999,0
1668279152809,CSE 293,037,119433,Swanson; Steven James,9999,0,9999,0
1668279152809,CSE 293,038,119435,Tullsen; Dean Michael,9999,0,9999,0
1668279152809,CSE 293,039,119483,Voelker; Geoffrey M.,9999,0,9999,0
1668279152809,CSE 293,040,119537,Zhao; Jishen,9999,0,9999,0
1668279152809,CSE 293,041,119538,Zhou; Yuan-Yuan,9999,0,9999,0
1668279152809,CSE 293,042,119539,Gao; Sicun,9999,0,9999,0
1668279152809,CSE 293,043,119540,Weibel; Nadir,9999,0,9999,0
1668279152809,CSE 293,044,119541,Gupta; Rajesh K.,9999,0,9999,0
1668279152809,CSE 293,045,126410,Vaccaro; Kristen Marie,9999,0,9999,0
1668279152809,CSE 293,046,126411,Klemke; Richard,9999,0,9999,0
1668279153232,CSE 294,A00,102459,Voelker; Geoffrey M.,0,0,0,0
1668279153232,CSE 294,B00,111322,Orailoglu; Alex,0,0,0,0
1668279153655,DSE 201,A00,096914,Deutsch; Alin Bernard,30,0,30,0
1668279154079,DSE 210,A00,096915,Dasgupta; Sanjoy,30,0,30,0
1668279154505,DSE 260A,A00,096916,Altintas De Callaf; Ilkay,30,0,30,0
1668279154933,ECE 200,001,103586,Antipa; Nicholas A,9999,0,9999,0
1668279154933,ECE 200,002,103587,Atanasov; Nikolay A.,9999,0,9999,0
1668279154933,ECE 200,003,103588,Bharadia; Dinesh,9999,0,9999,0
1668279154933,ECE 200,004,103589,Cheng; Chung Kuan,9999,0,9999,0
1668279154933,ECE 200,005,103590,Cosman; Pamela C.,9999,0,9999,0
1668279154933,ECE 200,006,103591,Dayeh; Shadi Ahmad,9999,0,9999,0
1668279154933,ECE 200,007,103592,Fainman; Yeshaiahu,9999,0,9999,0
1668279154933,ECE 200,008,103593,Ford; Joseph Earl,9999,0,9999,0
1668279154933,ECE 200,009,103594,Franceschetti; Massimo,9999,0,9999,0
1668279154933,ECE 200,010,103595,Fullerton; Eric E,9999,0,9999,0
1668279154933,ECE 200,011,103596,Galton; Ian A,9999,0,9999,0
1668279154933,ECE 200,012,103597,Gilja; Vikash,9999,0,9999,0
1668279154933,ECE 200,013,103598,Hall; Drew A.,9999,0,9999,0
1668279154933,ECE 200,014,103599,Hsueh; Tzu-Chien,9999,0,9999,0
1668279154933,ECE 200,015,103600,Javidi; Tara,9999,0,9999,0
1668279154933,ECE 200,016,103601,Kahng; Andrew Byun,9999,0,9999,0
1668279154933,ECE 200,017,103602,Kim; Young-Han,9999,0,9999,0
1668279154933,ECE 200,018,103603,Koushanfar; Farinaz,9999,0,9999,0
1668279154933,ECE 200,019,103604,Kuzum; Duygu,9999,0,9999,0
1668279154933,ECE 200,020,103605,Le; Hanh-Phuc,9999,0,9999,0
1668279154933,ECE 200,021,103606,Lin; Bill,9999,0,9999,0
1668279154933,ECE 200,022,103607,Liu; Zhaowei,9998,0,9999,1
1668279154933,ECE 200,023,103608,Lo; Yu-Hwa,9999,0,9999,0
1668279154933,ECE 200,024,103609,Lomakin; Vitaliy,9999,0,9999,0
1668279154933,ECE 200,025,103610,Mercier; Patrick Philip,9999,0,9999,0
1668279154933,ECE 200,026,103611,Meyer; Florian,9999,0,9999,0
1668279154933,ECE 200,027,103612,Milstein; Laurence B.,9999,0,9999,0
1668279154933,ECE 200,028,103613,Mir Arabbaygi; Siavash,9999,0,9999,0
1668279154933,ECE 200,029,103614,Mookherjea; Shayan,9999,0,9999,0
1668279154933,ECE 200,030,103615,Morris; Karcher William,9999,0,9999,0
1668279154933,ECE 200,031,103616,Ng; Tse Nga,9999,0,9999,0
1668279154933,ECE 200,032,103617,Nguyen; Truong Quang,9999,0,9999,0
1668279154933,ECE 200,033,103618,Nomura; Kenji,9999,0,9999,0
1668279154933,ECE 200,034,103619,Orlitsky; Alon,9999,0,9999,0
1668279154933,ECE 200,035,103620,Pal; Piya,9999,0,9999,0
1668279154933,ECE 200,036,103621,Papen; George C.,9999,0,9999,0
1668279154933,ECE 200,037,103622,Radic; Stojan,9999,0,9999,0
1668279154933,ECE 200,038,103623,Rao; Bhaskar D.,9999,0,9999,0
1668279154933,ECE 200,039,103624,Rao; Ramesh R,9999,0,9999,0
1668279154933,ECE 200,040,103625,Rebeiz; Gabriel,9999,0,9999,0
1668279154933,ECE 200,041,103626,Sanford; John R,9999,0,9999,0
1668279154933,ECE 200,042,103627,Siegel; Paul H.,9999,0,9999,0
1668279154933,ECE 200,043,103628,Sievenpiper; Daniel F.,9999,0,9999,0
1668279154933,ECE 200,044,103629,Sworder; David D.,9999,0,9999,0
1668279154933,ECE 200,045,103630,Taur; Yuan,9999,0,9999,0
1668279154933,ECE 200,046,103631,Touri; Behrouz,9999,0,9999,0
1668279154933,ECE 200,047,103632,Trivedi; Mohan M.,9999,0,9999,0
1668279154933,ECE 200,048,103633,Vasconcelos; Nuno,9999,0,9999,0
1668279154933,ECE 200,049,103634,Wang; Xiaolong,9999,0,9999,0
1668279154933,ECE 200,050,103635,Xie; Pengtao,9999,0,9999,0
1668279154933,ECE 200,051,103636,Yip; Michael,9999,0,9999,0
1668279154933,ECE 200,052,103637,Zeger; Kenneth A.,999,0,999,0
1668279154933,ECE 200,053,103638,Zhang; Xinyu,9999,0,9999,0
1668279154933,ECE 200,054,103639,Turakhia; Yatish Girish,9999,0,9999,0
1668279154933,ECE 200,055,103640,Kang; Mingu,9999,0,9999,0
1668279154933,ECE 200,056,103641,Shi; Yuanyuan,9999,0,9999,0
1668279154933,ECE 200,057,103642,Wang; Edward Jay,9999,0,9999,0
1668279154933,ECE 200,058,103643,Zheng; Yang,9999,0,9999,0
1668279155361,ECE 202,A00,103644,Kuzum; Duygu,0,0,0,0
1668279155784,ECE 212BN,A00,103646,Ng; Tse Nga,0,0,0,0
1668279156209,ECE 221,A00,111493,Staff,0,0,0,0
1668279156634,ECE 222B,A00,103647,Lomakin; Vitaliy,0,0,0,0
1668279157061,ECE 230B,A00,103648,Taur; Yuan,0,0,0,0
1668279157484,ECE 238B,A00,103649,Garay; Javier,0,0,0,0
1668279157919,ECE 240B,A00,112900,Fainman; Yeshaiahu,0,0,0,0
1668279158340,ECE 247A,A00,103650,Jokerst; Jesse Vincent,0,0,0,0
1668279158765,ECE 247B,A00,103651,Wang; Joseph,0,0,0,0
1668279159191,ECE 250,A00,103652,Siegel; Paul H.,0,0,0,0
1668279159615,ECE 251A,A00,103654,Rao; Bhaskar D.,0,0,0,0
1668279160039,ECE 257B,A00,103655,Bharadia; Dinesh,0,0,0,0
1668279160466,ECE 258A,A00,103656,Milstein; Laurence B.,0,0,0,0
1668279160890,ECE 260B,A00,103658,Kang; Mingu,0,0,0,0
1668279161314,ECE 264A,A00,103659,Galton; Ian A,0,0,0,0
1668279161737,ECE 265A,A00,103661,Gudem; Prasad S.S.,0,0,0,0
1668279162162,ECE 265D,A00,103662,Gudem; Prasad S.S.,0,0,0,0
1668279162589,ECE 268,A00,103663,Koushanfar; Farinaz,0,0,0,0
1668279163015,ECE 269,A01,103665,Pal; Piya,0,0,0,0
1668279163438,ECE 271B,A00,103666,Vasconcelos; Manuela,0,0,0,0
1668279163862,ECE 276A,A00,103667,Atanasov; Nikolay A.,0,0,0,0
1668279164285,ECE 277,A00,103668,An; Cheolhong,0,0,0,0
1668279164709,ECE 279,A00,117947,Hall; Drew A.,0,0,0,0
1668279165656,ECE 283,A00,103670,Hsueh; Tzu-Chien,0,0,0,0
1668279166078,ECE 284,A00,103671,Turakhia; Yatish Girish,0,0,0,0
1668279166503,ECE 285,A00,103672,Zheng; Yang,0,0,0,0
1668279166503,ECE 285,B00,103673,Sworder; David D.,0,0,0,0
1668279166928,ECE 287,A00,103676,Javidi; Tara,0,0,0,0
1668279167362,MATH 200B,A00,098023,Salehi Golsefidy; Alireza,12,0,15,3
1668279167785,MATH 202B,A00,098024,Rhoades; Brendon Patrick,9,0,15,6
1668279168208,MATH 203B,A00,098025,Oprea; Dragos N.,10,0,15,5
1668279168631,MATH 204B,A00,098026,Sorensen; Claus M,13,0,15,2
1668279169062,MATH 208,A00,098027,Izadi; Elham,7,0,10,3
1668279169488,MATH 209,A00,098028,Pollack; Aaron,10,0,10,0
1668279169912,MATH 211A,A00,112919,Rogalski; Daniel,9,0,10,1
1668279170343,MATH 211B,A00,112920,Seward; Brandon M.,9,0,10,1
1668279170767,MATH 218,A00,098029,Li; Bo,10,0,10,0
1668279171194,MATH 220B,A00,098030,Novak; Jonathan I,11,0,15,4
1668279171617,MATH 221A,A00,098031,Ebenfelt; Peter F,13,0,15,2
1668279172040,MATH 231B,A00,098032,Zlatos; Andrej,12,0,15,3
1668279172467,MATH 240B,A00,098033,Ni; Lei,9,0,15,6
1668279172890,MATH 243,A00,098034,Jekel; David Andrew,10,0,10,0
1668279173318,MATH 245A,A00,098035,Nie; Jiawang,0,0,15,16
1668279173743,MATH 248,A00,098036,Bejenaru; Ioan,10,0,10,0
1668279174168,MATH 250B,A00,098037,Spolaor; Luca,14,0,15,1
1668279174591,MATH 258,A00,098038,Ni; Lei,10,0,10,0
1668279175014,MATH 264B,A00,098041,Rhoades; Brendon Patrick,9,0,15,6
1668279175439,MATH 268,A00,098042,Buss; Samuel R,10,0,10,0
1668279175862,MATH 269,A00,098043,Rhoades; Brendon Patrick,10,0,10,0
1668279176286,MATH 270B,A00,098044,Li; Bo,10,0,15,5
1668279176709,MATH 272B,A00,098045,Holst; Michael J,13,0,15,2
1668279177133,MATH 273A,A00,098046,Tian; Xiaochuan,10,0,15,5
1668279177558,MATH 275,A01,098048,Tian; Xiaochuan,6,0,10,4
1668279177982,MATH 278A,A00,098049,Holst; Michael J,8,0,10,2
1668279178404,MATH 278B,A00,098050,Cloninger; Alexander,10,0,10,0
1668279178830,MATH 278C,A00,098051,Nie; Jiawang,7,0,10,3
1668279179258,MATH 280B,A00,098052,Zheng; Tianyi,8,0,15,7
1668279179682,MATH 281B,A00,098053,Bradic; Jelena,1,0,15,14
1668279180109,MATH 282B,A00,098054,Arias-Castro; Ery,0,0,15,15
1668279180543,MATH 285,A00,098055,Fitzsimmons; Patrick J,0,0,15,17
1668279180966,MATH 287B,A00,098056,Arias-Castro; Ery,2,0,15,13
1668279181388,MATH 288,A00,098057,Agarwal; Pooja,9,0,10,1
1668279181388,MATH 288,B00,098058,Zhang; Danna,8,0,10,2
1668279181388,MATH 288,C00,098059,Williams; Ruth J,9,0,10,1
1668279181814,MATH 290B,A00,098060,Roberts; Justin Deritter,13,0,15,2
1668279182240,MATH 292,A00,098061,Belmont; Eva Kinoshita,10,0,10,0
1668279182670,MATH 295,A00,098062,Suk; Andrew Hoon,48,0,50,2
1668279183094,MATH 296,A00,098063,Novak; Jonathan I,20,0,20,0
1668279183523,MATH 297,001,098064,Gamst; Anthony Collins,9997,0,9999,2
1668279682087,COGS 205,A00,101395,Chiba; Andrea,19,0,20,1
1668279682522,COGS 210B,001,101404,Greene; Deanna Jacquelyn,9998,0,9999,1
1668279682522,COGS 210B,002,101417,Xia; Haijun,9999,0,9999,0
1668279682522,COGS 210B,003,101422,Nitz; Douglas A.,9999,0,9999,0
1668279682522,COGS 210B,004,101423,Hollan; James D.,9998,0,9999,1
1668279682522,COGS 210B,005,101424,Deak; Gedeon O.,9998,0,9999,1
1668279682522,COGS 210B,006,101425,Rossano; Federico,9999,0,9999,0
1668279682946,COGS 211B,A00,101427,Coulson; Seana M,9996,0,9999,3
1668279683367,COGS 220,A00,101428,Hollan; James D.,0,0,25,25
1668279683793,COGS 229,A00,101429,Dow; Steven P,18,0,25,7
1668279684288,COGS 230,A00,101430,Klemmer; Scott R,12,0,17,5
1668279684717,COGS 234,A00,101431,Xia; Haijun,1,0,25,24
1668279685139,COGS 260,A00,101432,Kiyonaga; Anastasia,21,0,25,4
1668279685139,COGS 260,B00,101433,Kirsh; David Joel,15,0,25,10
1668279685568,CSE 202,A00,102371,Impagliazzo; Russell,0,0,0,0
1668279685996,CSE 203B,A01,102373,Cheng; Chung Kuan,0,0,0,0
1668279686418,CSE 208,A00,102374,Micciancio; Daniele,0,0,0,0
1668279686840,CSE 209A,A00,112895,Impagliazzo; Russell,0,0,15,15
1668279687261,CSE 209B,A00,108005,Bellare; Mihir,0,0,0,0
1668279687685,CSE 210,A00,113163,Coblenz; Michael J,0,0,0,0
1668279688109,CSE 219,A00,106111,Dow; Steven P,0,0,20,20
1668279688534,CSE 221,A00,102376,Voelker; Geoffrey M.,0,0,0,0
1668279688956,CSE 224,A01,102378,Porter; George M,0,0,0,0
1668279689382,CSE 229A,A00,102379,Savage; Stefan,0,0,0,0
1668279689805,CSE 229C,A00,102380,Munyaka; Imani N. S.,0,0,0,0
1668279690228,CSE 232B,A00,102382,Deutsch; Alin Bernard,0,0,0,0
1668279690650,CSE 234,A01,112904,Kumar; Arun Kumar,0,0,0,0
1668279691073,CSE 237A,A00,102383,Rosing; Tajana Simunic,0,0,0,0
1668279691503,CSE 239A,A00,102384,Deutsch; Alin Bernard,0,0,0,0
1668279691928,CSE 239B,A00,102385,Polikarpova; Nadezhda,0,0,0,0
1668279692351,CSE 240A,A00,102386,Pannuto; Patrick William,0,0,0,0
1668279692772,CSE 240B,A00,102387,Zhao; Jishen,0,0,0,0
1668279693207,CSE 241A,A00,106406,Kang; Mingu,0,0,0,0
1668279693630,CSE 249B,A00,102388,Kahng; Andrew Byun,0,0,8,8
1668279694055,CSE 251B,A01,102392,Cottrell; Garrison W,0,0,0,0
1668279694055,CSE 251B,A02,102393,Cottrell; Garrison W,0,0,0,0
1668279694479,CSE 252B,A00,102394,Ochoa; Benjamin Lawrence,0,0,0,0
1668279694903,CSE 257,A01,102396,Gao; Sicun,0,0,0,0
1668279695328,CSE 272,A00,102397,Li; Tzumao,0,0,0,0
1668279695751,CSE 274,A00,111323,Chern; Albert Ren-Haur,0,0,0,0
1668279696180,CSE 282,A00,102398,Pevzner; Pavel Arkadjevich,0,0,0,0
1668279696603,CSE 284,A00,114175,Gymrek; Melissa Ann,0,0,0,0
1668279697031,CSE 290,A00,102399,Chandraker; Manmohan Krishna,0,0,0,0
1668279697031,CSE 290,B00,102400,Vaccaro; Kristen Marie,0,0,25,25
1668279697031,CSE 290,C00,102414,Pannuto; Patrick William,0,0,25,25
1668279697031,CSE 290,D00,102427,Pevzner; Pavel Arkadjevich,0,0,0,0
1668279697031,CSE 290,E00,102429,Zhao; Jishen,0,0,0,0
1668279697031,CSE 290,F00,102436,Tullsen; Dean Michael,0,0,0,0
1668279697031,CSE 290,G00,102440,Christensen; Henrik I,0,0,20,20
1668279697453,CSE 291,A00,102443,Su; Hao,0,0,0,0
1668279697453,CSE 291,B00,102448,Polikarpova; Nadezhda,0,0,0,0
1668279697453,CSE 291,C00,102453,Vaccaro; Kristen Marie,0,0,0,0
1668279697453,CSE 291,D00,111343,Savage; Stefan,0,0,0,0
1668279697453,CSE 291,E00,116474,Claffy; Kimberly Claire,0,0,0,0
1668279697453,CSE 291,F00,116479,Pasquale; Joseph,0,0,0,0
1668279697881,CSE 293,001,119111,Bafna; Vineet,9999,0,9999,0
1668279697881,CSE 293,002,119118,Bellare; Mihir,9999,0,9999,0
1668279697881,CSE 293,003,119122,Berg-Kirkpatrick; Taylor D,9999,0,9999,0
1668279697881,CSE 293,004,119135,Christensen; Henrik I,9999,0,9999,0
1668279697881,CSE 293,005,119142,Cottrell; Garrison W,9999,0,9999,0
1668279697881,CSE 293,006,119146,Deutsch; Alin Bernard,9999,0,9999,0
1668279697881,CSE 293,007,119159,Esmaeilzadeh; Hadi,9999,0,9999,0
1668279697881,CSE 293,008,119166,Freund; Yoav,9999,0,9999,0
1668279697881,CSE 293,009,119170,Griswold; William G.,9999,0,9999,0
1668279697881,CSE 293,010,119183,Gymrek; Melissa Ann,9999,0,9999,0
1668279697881,CSE 293,011,119190,Heninger; Nadia A,9999,0,9999,0
1668279697881,CSE 293,012,119230,Impagliazzo; Russell,9999,0,9999,0
1668279697881,CSE 293,013,119232,Jhala; Ranjit,9999,0,9999,0
1668279697881,CSE 293,014,119233,Kahng; Andrew Byun,9999,0,9999,0
1668279697881,CSE 293,015,119298,Kane; Daniel Mertz,9999,0,9999,0
1668279697881,CSE 293,016,119299,Kriegman; David J,9999,0,9999,0
1668279697881,CSE 293,017,119300,Kumar; Arun Kumar,9999,0,9999,0
1668279697881,CSE 293,018,119301,Lerner; Sorin,9999,0,9999,0
1668279697881,CSE 293,019,119302,Lovett; Shachar,9999,0,9999,0
1668279697881,CSE 293,020,119303,McAuley; Julian John,9999,0,9999,0
1668279697881,CSE 293,021,119304,Micciancio; Daniele,9999,0,9999,0
1668279697881,CSE 293,022,119367,Orailoglu; Alex,9999,0,9999,0
1668279697881,CSE 293,023,119382,Paturi; Ramamohan,9999,0,9999,0
1668279697881,CSE 293,024,119404,Polikarpova; Nadezhda,9999,0,9999,0
1668279697881,CSE 293,025,119406,Politz; Joseph Gibbs,9999,0,9999,0
1668279697881,CSE 293,026,119411,Porter; George M,9999,0,9999,0
1668279697881,CSE 293,027,119414,Porter; Leonard Emerson,9999,0,9999,0
1668279697881,CSE 293,028,119416,Ramamoorthi; Ravi,9999,0,9999,0
1668279697881,CSE 293,029,119417,Sahoo; Debashis,9999,0,9999,0
1668279697881,CSE 293,030,119420,Saul; Lawrence,9999,0,9999,0
1668279697881,CSE 293,031,119421,Savage; Stefan,9999,0,9999,0
1668279697881,CSE 293,032,119425,Schulze; Jurgen P.,9999,0,9999,0
1668279697881,CSE 293,033,119426,Snoeren; Alex C.,9999,0,9999,0
1668279697881,CSE 293,034,119428,Shang; Jingbo,9999,0,9999,0
1668279697881,CSE 293,035,119430,Stefan; Deian,9999,0,9999,0
1668279697881,CSE 293,036,119431,Su; Hao,9999,0,9999,0
1668279697881,CSE 293,037,119433,Swanson; Steven James,9999,0,9999,0
1668279697881,CSE 293,038,119435,Tullsen; Dean Michael,9999,0,9999,0
1668279697881,CSE 293,039,119483,Voelker; Geoffrey M.,9999,0,9999,0
1668279697881,CSE 293,040,119537,Zhao; Jishen,9999,0,9999,0
1668279697881,CSE 293,041,119538,Zhou; Yuan-Yuan,9999,0,9999,0
1668279697881,CSE 293,042,119539,Gao; Sicun,9999,0,9999,0
1668279697881,CSE 293,043,119540,Weibel; Nadir,9999,0,9999,0
1668279697881,CSE 293,044,119541,Gupta; Rajesh K.,9999,0,9999,0
1668279697881,CSE 293,045,126410,Vaccaro; Kristen Marie,9999,0,9999,0
1668279697881,CSE 293,046,126411,Klemke; Richard,9999,0,9999,0
1668279698309,CSE 294,A00,102459,Voelker; Geoffrey M.,0,0,0,0
1668279698309,CSE 294,B00,111322,Orailoglu; Alex,0,0,0,0
1668279698735,DSE 201,A00,096914,Deutsch; Alin Bernard,30,0,30,0
1668279699160,DSE 210,A00,096915,Dasgupta; Sanjoy,30,0,30,0
1668279699583,DSE 260A,A00,096916,Altintas De Callaf; Ilkay,30,0,30,0
1668279700017,ECE 200,001,103586,Antipa; Nicholas A,9999,0,9999,0
1668279700017,ECE 200,002,103587,Atanasov; Nikolay A.,9999,0,9999,0
1668279700017,ECE 200,003,103588,Bharadia; Dinesh,9999,0,9999,0
1668279700017,ECE 200,004,103589,Cheng; Chung Kuan,9999,0,9999,0
1668279700017,ECE 200,005,103590,Cosman; Pamela C.,9999,0,9999,0
1668279700017,ECE 200,006,103591,Dayeh; Shadi Ahmad,9999,0,9999,0
1668279700017,ECE 200,007,103592,Fainman; Yeshaiahu,9999,0,9999,0
1668279700017,ECE 200,008,103593,Ford; Joseph Earl,9999,0,9999,0
1668279700017,ECE 200,009,103594,Franceschetti; Massimo,9999,0,9999,0
1668279700017,ECE 200,010,103595,Fullerton; Eric E,9999,0,9999,0
1668279700017,ECE 200,011,103596,Galton; Ian A,9999,0,9999,0
1668279700017,ECE 200,012,103597,Gilja; Vikash,9999,0,9999,0
1668279700017,ECE 200,013,103598,Hall; Drew A.,9999,0,9999,0
1668279700017,ECE 200,014,103599,Hsueh; Tzu-Chien,9999,0,9999,0
1668279700017,ECE 200,015,103600,Javidi; Tara,9999,0,9999,0
1668279700017,ECE 200,016,103601,Kahng; Andrew Byun,9999,0,9999,0
1668279700017,ECE 200,017,103602,Kim; Young-Han,9999,0,9999,0
1668279700017,ECE 200,018,103603,Koushanfar; Farinaz,9999,0,9999,0
1668279700017,ECE 200,019,103604,Kuzum; Duygu,9999,0,9999,0
1668279700017,ECE 200,020,103605,Le; Hanh-Phuc,9999,0,9999,0
1668279700017,ECE 200,021,103606,Lin; Bill,9999,0,9999,0
1668279700017,ECE 200,022,103607,Liu; Zhaowei,9998,0,9999,1
1668279700017,ECE 200,023,103608,Lo; Yu-Hwa,9999,0,9999,0
1668279700017,ECE 200,024,103609,Lomakin; Vitaliy,9999,0,9999,0
1668279700017,ECE 200,025,103610,Mercier; Patrick Philip,9999,0,9999,0
1668279700017,ECE 200,026,103611,Meyer; Florian,9999,0,9999,0
1668279700017,ECE 200,027,103612,Milstein; Laurence B.,9999,0,9999,0
1668279700017,ECE 200,028,103613,Mir Arabbaygi; Siavash,9999,0,9999,0
1668279700017,ECE 200,029,103614,Mookherjea; Shayan,9999,0,9999,0
1668279700017,ECE 200,030,103615,Morris; Karcher William,9999,0,9999,0
1668279700017,ECE 200,031,103616,Ng; Tse Nga,9999,0,9999,0
1668279700017,ECE 200,032,103617,Nguyen; Truong Quang,9999,0,9999,0
1668279700017,ECE 200,033,103618,Nomura; Kenji,9999,0,9999,0
1668279700017,ECE 200,034,103619,Orlitsky; Alon,9999,0,9999,0
1668279700017,ECE 200,035,103620,Pal; Piya,9999,0,9999,0
1668279700017,ECE 200,036,103621,Papen; George C.,9999,0,9999,0
1668279700017,ECE 200,037,103622,Radic; Stojan,9999,0,9999,0
1668279700017,ECE 200,038,103623,Rao; Bhaskar D.,9999,0,9999,0
1668279700017,ECE 200,039,103624,Rao; Ramesh R,9999,0,9999,0
1668279700017,ECE 200,040,103625,Rebeiz; Gabriel,9999,0,9999,0
1668279700017,ECE 200,041,103626,Sanford; John R,9999,0,9999,0
1668279700017,ECE 200,042,103627,Siegel; Paul H.,9999,0,9999,0
1668279700017,ECE 200,043,103628,Sievenpiper; Daniel F.,9999,0,9999,0
1668279700017,ECE 200,044,103629,Sworder; David D.,9999,0,9999,0
1668279700017,ECE 200,045,103630,Taur; Yuan,9999,0,9999,0
1668279700017,ECE 200,046,103631,Touri; Behrouz,9999,0,9999,0
1668279700017,ECE 200,047,103632,Trivedi; Mohan M.,9999,0,9999,0
1668279700017,ECE 200,048,103633,Vasconcelos; Nuno,9999,0,9999,0
1668279700017,ECE 200,049,103634,Wang; Xiaolong,9999,0,9999,0
1668279700017,ECE 200,050,103635,Xie; Pengtao,9999,0,9999,0
1668279700017,ECE 200,051,103636,Yip; Michael,9999,0,9999,0
1668279700017,ECE 200,052,103637,Zeger; Kenneth A.,999,0,999,0
1668279700017,ECE 200,053,103638,Zhang; Xinyu,9999,0,9999,0
1668279700017,ECE 200,054,103639,Turakhia; Yatish Girish,9999,0,9999,0
1668279700017,ECE 200,055,103640,Kang; Mingu,9999,0,9999,0
1668279700017,ECE 200,056,103641,Shi; Yuanyuan,9999,0,9999,0
1668279700017,ECE 200,057,103642,Wang; Edward Jay,9999,0,9999,0
1668279700017,ECE 200,058,103643,Zheng; Yang,9999,0,9999,0
1668279700440,ECE 202,A00,103644,Kuzum; Duygu,0,0,0,0
1668279700861,ECE 212BN,A00,103646,Ng; Tse Nga,0,0,0,0
1668279701287,ECE 221,A00,111493,Staff,0,0,0,0
1668279701717,ECE 222B,A00,103647,Lomakin; Vitaliy,0,0,0,0
1668279702140,ECE 230B,A00,103648,Taur; Yuan,0,0,0,0
1668279702566,ECE 238B,A00,103649,Garay; Javier,0,0,0,0
1668279702999,ECE 240B,A00,112900,Fainman; Yeshaiahu,0,0,0,0
1668279703421,ECE 247A,A00,103650,Jokerst; Jesse Vincent,0,0,0,0
1668279703850,ECE 247B,A00,103651,Wang; Joseph,0,0,0,0
1668279704276,ECE 250,A00,103652,Siegel; Paul H.,0,0,0,0
1668279704710,ECE 251A,A00,103654,Rao; Bhaskar D.,0,0,0,0
1668279705154,ECE 257B,A00,103655,Bharadia; Dinesh,0,0,0,0
1668279705581,ECE 258A,A00,103656,Milstein; Laurence B.,0,0,0,0
1668279706003,ECE 260B,A00,103658,Kang; Mingu,0,0,0,0
1668279706437,ECE 264A,A00,103659,Galton; Ian A,0,0,0,0
1668279706863,ECE 265A,A00,103661,Gudem; Prasad S.S.,0,0,0,0
1668279707291,ECE 265D,A00,103662,Gudem; Prasad S.S.,0,0,0,0
1668279707715,ECE 268,A00,103663,Koushanfar; Farinaz,0,0,0,0
1668279708146,ECE 269,A01,103665,Pal; Piya,0,0,0,0
1668279708570,ECE 271B,A00,103666,Vasconcelos; Manuela,0,0,0,0
1668279708991,ECE 276A,A00,103667,Atanasov; Nikolay A.,0,0,0,0
1668279709414,ECE 277,A00,103668,An; Cheolhong,0,0,0,0
1668279709836,ECE 279,A00,117947,Hall; Drew A.,0,0,0,0
1668279710680,ECE 283,A00,103670,Hsueh; Tzu-Chien,0,0,0,0
1668279711103,ECE 284,A00,103671,Turakhia; Yatish Girish,0,0,0,0
1668279711527,ECE 285,A00,103672,Zheng; Yang,0,0,0,0
1668279711527,ECE 285,B00,103673,Sworder; David D.,0,0,0,0
1668279711953,ECE 287,A00,103676,Javidi; Tara,0,0,0,0
1668279712378,MATH 200B,A00,098023,Salehi Golsefidy; Alireza,12,0,15,3
1668279712812,MATH 202B,A00,098024,Rhoades; Brendon Patrick,9,0,15,6
1668279713242,MATH 203B,A00,098025,Oprea; Dragos N.,10,0,15,5
1668279713663,MATH 204B,A00,098026,Sorensen; Claus M,13,0,15,2
1668279714089,MATH 208,A00,098027,Izadi; Elham,7,0,10,3
1668279714521,MATH 209,A00,098028,Pollack; Aaron,10,0,10,0
1668279714954,MATH 211A,A00,112919,Rogalski; Daniel,9,0,10,1
1668279715381,MATH 211B,A00,112920,Seward; Brandon M.,9,0,10,1
1668279715818,MATH 218,A00,098029,Li; Bo,10,0,10,0
1668279716243,MATH 220B,A00,098030,Novak; Jonathan I,11,0,15,4
1668279716666,MATH 221A,A00,098031,Ebenfelt; Peter F,13,0,15,2
1668279717093,MATH 231B,A00,098032,Zlatos; Andrej,12,0,15,3
1668279717518,MATH 240B,A00,098033,Ni; Lei,9,0,15,6
1668279717945,MATH 243,A00,098034,Jekel; David Andrew,10,0,10,0
1668279718368,MATH 245A,A00,098035,Nie; Jiawang,0,0,15,16
1668279718793,MATH 248,A00,098036,Bejenaru; Ioan,10,0,10,0
1668279719216,MATH 250B,A00,098037,Spolaor; Luca,14,0,15,1
1668279719640,MATH 258,A00,098038,Ni; Lei,10,0,10,0
1668279720063,MATH 264B,A00,098041,Rhoades; Brendon Patrick,9,0,15,6
1668279720496,MATH 268,A00,098042,Buss; Samuel R,10,0,10,0
1668279720921,MATH 269,A00,098043,Rhoades; Brendon Patrick,10,0,10,0
1668279721345,MATH 270B,A00,098044,Li; Bo,10,0,15,5
1668279721784,MATH 272B,A00,098045,Holst; Michael J,13,0,15,2
1668279722210,MATH 273A,A00,098046,Tian; Xiaochuan,10,0,15,5
1668279722634,MATH 275,A01,098048,Tian; Xiaochuan,6,0,10,4
1668279723066,MATH 278A,A00,098049,Holst; Michael J,8,0,10,2
1668279723491,MATH 278B,A00,098050,Cloninger; Alexander,10,0,10,0
1668279723915,MATH 278C,A00,098051,Nie; Jiawang,7,0,10,3
1668279724338,MATH 280B,A00,098052,Zheng; Tianyi,8,0,15,7
1668279724765,MATH 281B,A00,098053,Bradic; Jelena,1,0,15,14
1668279725190,MATH 282B,A00,098054,Arias-Castro; Ery,0,0,15,15
1668279725615,MATH 285,A00,098055,Fitzsimmons; Patrick J,0,0,15,17
1668279726036,MATH 287B,A00,098056,Arias-Castro; Ery,2,0,15,13
1668279726459,MATH 288,A00,098057,Agarwal; Pooja,9,0,10,1
1668279726459,MATH 288,B00,098058,Zhang; Danna,8,0,10,2
1668279726459,MATH 288,C00,098059,Williams; Ruth J,9,0,10,1
1668279726883,MATH 290B,A00,098060,Roberts; Justin Deritter,13,0,15,2
1668279727381,MATH 292,A00,098061,Belmont; Eva Kinoshita,10,0,10,0
1668279727804,MATH 295,A00,098062,Suk; Andrew Hoon,48,0,50,2
1668279728228,MATH 296,A00,098063,Novak; Jonathan I,20,0,20,0
1668279728651,MATH 297,001,098064,Gamst; Anthony Collins,9997,0,9999,2
1668280227586,COGS 205,A00,101395,Chiba; Andrea,19,0,20,1
1668280228010,COGS 210B,001,101404,Greene; Deanna Jacquelyn,9998,0,9999,1
1668280228010,COGS 210B,002,101417,Xia; Haijun,9999,0,9999,0
1668280228010,COGS 210B,003,101422,Nitz; Douglas A.,9999,0,9999,0
1668280228010,COGS 210B,004,101423,Hollan; James D.,9998,0,9999,1
1668280228010,COGS 210B,005,101424,Deak; Gedeon O.,9998,0,9999,1
1668280228010,COGS 210B,006,101425,Rossano; Federico,9999,0,9999,0
1668280228442,COGS 211B,A00,101427,Coulson; Seana M,9996,0,9999,3
1668280228867,COGS 220,A00,101428,Hollan; James D.,0,0,25,25
1668280229290,COGS 229,A00,101429,Dow; Steven P,18,0,25,7
1668280229717,COGS 230,A00,101430,Klemmer; Scott R,12,0,17,5
1668280230142,COGS 234,A00,101431,Xia; Haijun,1,0,25,24
1668280230567,COGS 260,A00,101432,Kiyonaga; Anastasia,21,0,25,4
1668280230567,COGS 260,B00,101433,Kirsh; David Joel,15,0,25,10
1668280230991,CSE 202,A00,102371,Impagliazzo; Russell,0,0,0,0
1668280231414,CSE 203B,A01,102373,Cheng; Chung Kuan,0,0,0,0
1668280231841,CSE 208,A00,102374,Micciancio; Daniele,0,0,0,0
1668280232276,CSE 209A,A00,112895,Impagliazzo; Russell,0,0,15,15
1668280232700,CSE 209B,A00,108005,Bellare; Mihir,0,0,0,0
1668280233123,CSE 210,A00,113163,Coblenz; Michael J,0,0,0,0
1668280233548,CSE 219,A00,106111,Dow; Steven P,0,0,20,20
1668280233975,CSE 221,A00,102376,Voelker; Geoffrey M.,0,0,0,0
1668280234400,CSE 224,A01,102378,Porter; George M,0,0,0,0
1668280234826,CSE 229A,A00,102379,Savage; Stefan,0,0,0,0
1668280235250,CSE 229C,A00,102380,Munyaka; Imani N. S.,0,0,0,0
1668280235676,CSE 232B,A00,102382,Deutsch; Alin Bernard,0,0,0,0
1668280236099,CSE 234,A01,112904,Kumar; Arun Kumar,0,0,0,0
1668280236526,CSE 237A,A00,102383,Rosing; Tajana Simunic,0,0,0,0
1668280236952,CSE 239A,A00,102384,Deutsch; Alin Bernard,0,0,0,0
1668280237375,CSE 239B,A00,102385,Polikarpova; Nadezhda,0,0,0,0
1668280237805,CSE 240A,A00,102386,Pannuto; Patrick William,0,0,0,0
1668280238230,CSE 240B,A00,102387,Zhao; Jishen,0,0,0,0
1668280238655,CSE 241A,A00,106406,Kang; Mingu,0,0,0,0
1668280239079,CSE 249B,A00,102388,Kahng; Andrew Byun,0,0,8,8
1668280239515,CSE 251B,A01,102392,Cottrell; Garrison W,0,0,0,0
1668280239515,CSE 251B,A02,102393,Cottrell; Garrison W,0,0,0,0
1668280239938,CSE 252B,A00,102394,Ochoa; Benjamin Lawrence,0,0,0,0
1668280240364,CSE 257,A01,102396,Gao; Sicun,0,0,0,0
1668280240787,CSE 272,A00,102397,Li; Tzumao,0,0,0,0
1668280241210,CSE 274,A00,111323,Chern; Albert Ren-Haur,0,0,0,0
1668280241633,CSE 282,A00,102398,Pevzner; Pavel Arkadjevich,0,0,0,0
1668280242056,CSE 284,A00,114175,Gymrek; Melissa Ann,0,0,0,0
1668280242482,CSE 290,A00,102399,Chandraker; Manmohan Krishna,0,0,0,0
1668280242482,CSE 290,B00,102400,Vaccaro; Kristen Marie,0,0,25,25
1668280242482,CSE 290,C00,102414,Pannuto; Patrick William,0,0,25,25
1668280242482,CSE 290,D00,102427,Pevzner; Pavel Arkadjevich,0,0,0,0
1668280242482,CSE 290,E00,102429,Zhao; Jishen,0,0,0,0
1668280242482,CSE 290,F00,102436,Tullsen; Dean Michael,0,0,0,0
1668280242482,CSE 290,G00,102440,Christensen; Henrik I,0,0,20,20
1668280242910,CSE 291,A00,102443,Su; Hao,0,0,0,0
1668280242910,CSE 291,B00,102448,Polikarpova; Nadezhda,0,0,0,0
1668280242910,CSE 291,C00,102453,Vaccaro; Kristen Marie,0,0,0,0
1668280242910,CSE 291,D00,111343,Savage; Stefan,0,0,0,0
1668280242910,CSE 291,E00,116474,Claffy; Kimberly Claire,0,0,0,0
1668280242910,CSE 291,F00,116479,Pasquale; Joseph,0,0,0,0
1668280243346,CSE 293,001,119111,Bafna; Vineet,9999,0,9999,0
1668280243346,CSE 293,002,119118,Bellare; Mihir,9999,0,9999,0
1668280243346,CSE 293,003,119122,Berg-Kirkpatrick; Taylor D,9999,0,9999,0
1668280243346,CSE 293,004,119135,Christensen; Henrik I,9999,0,9999,0
1668280243346,CSE 293,005,119142,Cottrell; Garrison W,9999,0,9999,0
1668280243346,CSE 293,006,119146,Deutsch; Alin Bernard,9999,0,9999,0
1668280243346,CSE 293,007,119159,Esmaeilzadeh; Hadi,9999,0,9999,0
1668280243346,CSE 293,008,119166,Freund; Yoav,9999,0,9999,0
1668280243346,CSE 293,009,119170,Griswold; William G.,9999,0,9999,0
1668280243346,CSE 293,010,119183,Gymrek; Melissa Ann,9999,0,9999,0
1668280243346,CSE 293,011,119190,Heninger; Nadia A,9999,0,9999,0
1668280243346,CSE 293,012,119230,Impagliazzo; Russell,9999,0,9999,0
1668280243346,CSE 293,013,119232,Jhala; Ranjit,9999,0,9999,0
1668280243346,CSE 293,014,119233,Kahng; Andrew Byun,9999,0,9999,0
1668280243346,CSE 293,015,119298,Kane; Daniel Mertz,9999,0,9999,0
1668280243346,CSE 293,016,119299,Kriegman; David J,9999,0,9999,0
1668280243346,CSE 293,017,119300,Kumar; Arun Kumar,9999,0,9999,0
1668280243346,CSE 293,018,119301,Lerner; Sorin,9999,0,9999,0
1668280243346,CSE 293,019,119302,Lovett; Shachar,9999,0,9999,0
1668280243346,CSE 293,020,119303,McAuley; Julian John,9999,0,9999,0
1668280243346,CSE 293,021,119304,Micciancio; Daniele,9999,0,9999,0
1668280243346,CSE 293,022,119367,Orailoglu; Alex,9999,0,9999,0
1668280243346,CSE 293,023,119382,Paturi; Ramamohan,9999,0,9999,0
1668280243346,CSE 293,024,119404,Polikarpova; Nadezhda,9999,0,9999,0
1668280243346,CSE 293,025,119406,Politz; Joseph Gibbs,9999,0,9999,0
1668280243346,CSE 293,026,119411,Porter; George M,9999,0,9999,0
1668280243346,CSE 293,027,119414,Porter; Leonard Emerson,9999,0,9999,0
1668280243346,CSE 293,028,119416,Ramamoorthi; Ravi,9999,0,9999,0
1668280243346,CSE 293,029,119417,Sahoo; Debashis,9999,0,9999,0
1668280243346,CSE 293,030,119420,Saul; Lawrence,9999,0,9999,0
1668280243346,CSE 293,031,119421,Savage; Stefan,9999,0,9999,0
1668280243346,CSE 293,032,119425,Schulze; Jurgen P.,9999,0,9999,0
1668280243346,CSE 293,033,119426,Snoeren; Alex C.,9999,0,9999,0
1668280243346,CSE 293,034,119428,Shang; Jingbo,9999,0,9999,0
1668280243346,CSE 293,035,119430,Stefan; Deian,9999,0,9999,0
1668280243346,CSE 293,036,119431,Su; Hao,9999,0,9999,0
1668280243346,CSE 293,037,119433,Swanson; Steven James,9999,0,9999,0
1668280243346,CSE 293,038,119435,Tullsen; Dean Michael,9999,0,9999,0
1668280243346,CSE 293,039,119483,Voelker; Geoffrey M.,9999,0,9999,0
1668280243346,CSE 293,040,119537,Zhao; Jishen,9999,0,9999,0
1668280243346,CSE 293,041,119538,Zhou; Yuan-Yuan,9999,0,9999,0
1668280243346,CSE 293,042,119539,Gao; Sicun,9999,0,9999,0
1668280243346,CSE 293,043,119540,Weibel; Nadir,9999,0,9999,0
1668280243346,CSE 293,044,119541,Gupta; Rajesh K.,9999,0,9999,0
1668280243346,CSE 293,045,126410,Vaccaro; Kristen Marie,9999,0,9999,0
1668280243346,CSE 293,046,126411,Klemke; Richard,9999,0,9999,0
1668280243773,CSE 294,A00,102459,Voelker; Geoffrey M.,0,0,0,0
1668280243773,CSE 294,B00,111322,Orailoglu; Alex,0,0,0,0
1668280244196,DSE 201,A00,096914,Deutsch; Alin Bernard,30,0,30,0
1668280244625,DSE 210,A00,096915,Dasgupta; Sanjoy,30,0,30,0
1668280245050,DSE 260A,A00,096916,Altintas De Callaf; Ilkay,30,0,30,0
1668280245486,ECE 200,001,103586,Antipa; Nicholas A,9999,0,9999,0
1668280245486,ECE 200,002,103587,Atanasov; Nikolay A.,9999,0,9999,0
1668280245486,ECE 200,003,103588,Bharadia; Dinesh,9999,0,9999,0
1668280245486,ECE 200,004,103589,Cheng; Chung Kuan,9999,0,9999,0
1668280245486,ECE 200,005,103590,Cosman; Pamela C.,9999,0,9999,0
1668280245486,ECE 200,006,103591,Dayeh; Shadi Ahmad,9999,0,9999,0
1668280245486,ECE 200,007,103592,Fainman; Yeshaiahu,9999,0,9999,0
1668280245486,ECE 200,008,103593,Ford; Joseph Earl,9999,0,9999,0
1668280245486,ECE 200,009,103594,Franceschetti; Massimo,9999,0,9999,0
1668280245486,ECE 200,010,103595,Fullerton; Eric E,9999,0,9999,0
1668280245486,ECE 200,011,103596,Galton; Ian A,9999,0,9999,0
1668280245486,ECE 200,012,103597,Gilja; Vikash,9999,0,9999,0
1668280245486,ECE 200,013,103598,Hall; Drew A.,9999,0,9999,0
1668280245486,ECE 200,014,103599,Hsueh; Tzu-Chien,9999,0,9999,0
1668280245486,ECE 200,015,103600,Javidi; Tara,9999,0,9999,0
1668280245486,ECE 200,016,103601,Kahng; Andrew Byun,9999,0,9999,0
1668280245486,ECE 200,017,103602,Kim; Young-Han,9999,0,9999,0
1668280245486,ECE 200,018,103603,Koushanfar; Farinaz,9999,0,9999,0
1668280245486,ECE 200,019,103604,Kuzum; Duygu,9999,0,9999,0
1668280245486,ECE 200,020,103605,Le; Hanh-Phuc,9999,0,9999,0
1668280245486,ECE 200,021,103606,Lin; Bill,9999,0,9999,0
1668280245486,ECE 200,022,103607,Liu; Zhaowei,9998,0,9999,1
1668280245486,ECE 200,023,103608,Lo; Yu-Hwa,9999,0,9999,0
1668280245486,ECE 200,024,103609,Lomakin; Vitaliy,9999,0,9999,0
1668280245486,ECE 200,025,103610,Mercier; Patrick Philip,9999,0,9999,0
1668280245486,ECE 200,026,103611,Meyer; Florian,9999,0,9999,0
1668280245486,ECE 200,027,103612,Milstein; Laurence B.,9999,0,9999,0
1668280245486,ECE 200,028,103613,Mir Arabbaygi; Siavash,9999,0,9999,0
1668280245486,ECE 200,029,103614,Mookherjea; Shayan,9999,0,9999,0
1668280245486,ECE 200,030,103615,Morris; Karcher William,9999,0,9999,0
1668280245486,ECE 200,031,103616,Ng; Tse Nga,9999,0,9999,0
1668280245486,ECE 200,032,103617,Nguyen; Truong Quang,9999,0,9999,0
1668280245486,ECE 200,033,103618,Nomura; Kenji,9999,0,9999,0
1668280245486,ECE 200,034,103619,Orlitsky; Alon,9999,0,9999,0
1668280245486,ECE 200,035,103620,Pal; Piya,9999,0,9999,0
1668280245486,ECE 200,036,103621,Papen; George C.,9999,0,9999,0
1668280245486,ECE 200,037,103622,Radic; Stojan,9999,0,9999,0
1668280245486,ECE 200,038,103623,Rao; Bhaskar D.,9999,0,9999,0
1668280245486,ECE 200,039,103624,Rao; Ramesh R,9999,0,9999,0
1668280245486,ECE 200,040,103625,Rebeiz; Gabriel,9999,0,9999,0
1668280245486,ECE 200,041,103626,Sanford; John R,9999,0,9999,0
1668280245486,ECE 200,042,103627,Siegel; Paul H.,9999,0,9999,0
1668280245486,ECE 200,043,103628,Sievenpiper; Daniel F.,9999,0,9999,0
1668280245486,ECE 200,044,103629,Sworder; David D.,9999,0,9999,0
1668280245486,ECE 200,045,103630,Taur; Yuan,9999,0,9999,0
1668280245486,ECE 200,046,103631,Touri; Behrouz,9999,0,9999,0
1668280245486,ECE 200,047,103632,Trivedi; Mohan M.,9999,0,9999,0
1668280245486,ECE 200,048,103633,Vasconcelos; Nuno,9999,0,9999,0
1668280245486,ECE 200,049,103634,Wang; Xiaolong,9999,0,9999,0
1668280245486,ECE 200,050,103635,Xie; Pengtao,9999,0,9999,0
1668280245486,ECE 200,051,103636,Yip; Michael,9999,0,9999,0
1668280245486,ECE 200,052,103637,Zeger; Kenneth A.,999,0,999,0
1668280245486,ECE 200,053,103638,Zhang; Xinyu,9999,0,9999,0
1668280245486,ECE 200,054,103639,Turakhia; Yatish Girish,9999,0,9999,0
1668280245486,ECE 200,055,103640,Kang; Mingu,9999,0,9999,0
1668280245486,ECE 200,056,103641,Shi; Yuanyuan,9999,0,9999,0
1668280245486,ECE 200,057,103642,Wang; Edward Jay,9999,0,9999,0
1668280245486,ECE 200,058,103643,Zheng; Yang,9999,0,9999,0
1668280245910,ECE 202,A00,103644,Kuzum; Duygu,0,0,0,0
1668280246426,ECE 212BN,A00,103646,Ng; Tse Nga,0,0,0,0
1668280246850,ECE 221,A00,111493,Staff,0,0,0,0
1668280247278,ECE 222B,A00,103647,Lomakin; Vitaliy,0,0,0,0
1668280247702,ECE 230B,A00,103648,Taur; Yuan,0,0,0,0
1668280248128,ECE 238B,A00,103649,Garay; Javier,0,0,0,0
1668280248553,ECE 240B,A00,112900,Fainman; Yeshaiahu,0,0,0,0
1668280248977,ECE 247A,A00,103650,Jokerst; Jesse Vincent,0,0,0,0
1668280249401,ECE 247B,A00,103651,Wang; Joseph,0,0,0,0
1668280249824,ECE 250,A00,103652,Siegel; Paul H.,0,0,0,0
1668280250250,ECE 251A,A00,103654,Rao; Bhaskar D.,0,0,0,0
1668280250678,ECE 257B,A00,103655,Bharadia; Dinesh,0,0,0,0
1668280251101,ECE 258A,A00,103656,Milstein; Laurence B.,0,0,0,0
1668280251542,ECE 260B,A00,103658,Kang; Mingu,0,0,0,0
1668280251968,ECE 264A,A00,103659,Galton; Ian A,0,0,0,0
1668280252392,ECE 265A,A00,103661,Gudem; Prasad S.S.,0,0,0,0
1668280252815,ECE 265D,A00,103662,Gudem; Prasad S.S.,0,0,0,0
1668280253241,ECE 268,A00,103663,Koushanfar; Farinaz,0,0,0,0
1668280253662,ECE 269,A01,103665,Pal; Piya,0,0,0,0
1668280254086,ECE 271B,A00,103666,Vasconcelos; Manuela,0,0,0,0
1668280254518,ECE 276A,A00,103667,Atanasov; Nikolay A.,0,0,0,0
1668280254943,ECE 277,A00,103668,An; Cheolhong,0,0,0,0
1668280255368,ECE 279,A00,117947,Hall; Drew A.,0,0,0,0
1668280256218,ECE 283,A00,103670,Hsueh; Tzu-Chien,0,0,0,0
1668280256641,ECE 284,A00,103671,Turakhia; Yatish Girish,0,0,0,0
1668280257067,ECE 285,A00,103672,Zheng; Yang,0,0,0,0
1668280257067,ECE 285,B00,103673,Sworder; David D.,0,0,0,0
1668280257491,ECE 287,A00,103676,Javidi; Tara,0,0,0,0
1668280257914,MATH 200B,A00,098023,Salehi Golsefidy; Alireza,12,0,15,3
1668280258337,MATH 202B,A00,098024,Rhoades; Brendon Patrick,9,0,15,6
1668280258763,MATH 203B,A00,098025,Oprea; Dragos N.,10,0,15,5
1668280259192,MATH 204B,A00,098026,Sorensen; Claus M,13,0,15,2
1668280259616,MATH 208,A00,098027,Izadi; Elham,7,0,10,3
1668280260054,MATH 209,A00,098028,Pollack; Aaron,10,0,10,0
1668280260476,MATH 211A,A00,112919,Rogalski; Daniel,9,0,10,1
1668280260902,MATH 211B,A00,112920,Seward; Brandon M.,9,0,10,1
1668280261326,MATH 218,A00,098029,Li; Bo,10,0,10,0
1668280261757,MATH 220B,A00,098030,Novak; Jonathan I,11,0,15,4
1668280262189,MATH 221A,A00,098031,Ebenfelt; Peter F,13,0,15,2
1668280262613,MATH 231B,A00,098032,Zlatos; Andrej,12,0,15,3
1668280263036,MATH 240B,A00,098033,Ni; Lei,9,0,15,6
1668280263463,MATH 243,A00,098034,Jekel; David Andrew,10,0,10,0
1668280263891,MATH 245A,A00,098035,Nie; Jiawang,0,0,15,16
1668280264315,MATH 248,A00,098036,Bejenaru; Ioan,10,0,10,0
1668280264743,MATH 250B,A00,098037,Spolaor; Luca,14,0,15,1
1668280265166,MATH 258,A00,098038,Ni; Lei,10,0,10,0
1668280265594,MATH 264B,A00,098041,Rhoades; Brendon Patrick,9,0,15,6
1668280266017,MATH 268,A00,098042,Buss; Samuel R,10,0,10,0
1668280266439,MATH 269,A00,098043,Rhoades; Brendon Patrick,10,0,10,0
1668280266865,MATH 270B,A00,098044,Li; Bo,10,0,15,5
1668280267291,MATH 272B,A00,098045,Holst; Michael J,13,0,15,2
1668280267715,MATH 273A,A00,098046,Tian; Xiaochuan,10,0,15,5
1668280268138,MATH 275,A01,098048,Tian; Xiaochuan,6,0,10,4
1668280268567,MATH 278A,A00,098049,Holst; Michael J,8,0,10,2
1668280268991,MATH 278B,A00,098050,Cloninger; Alexander,10,0,10,0
1668280269417,MATH 278C,A00,098051,Nie; Jiawang,7,0,10,3
1668280269851,MATH 280B,A00,098052,Zheng; Tianyi,8,0,15,7
1668280270285,MATH 281B,A00,098053,Bradic; Jelena,1,0,15,14
1668280270707,MATH 282B,A00,098054,Arias-Castro; Ery,0,0,15,15
1668280271133,MATH 285,A00,098055,Fitzsimmons; Patrick J,0,0,15,17
1668280271556,MATH 287B,A00,098056,Arias-Castro; Ery,2,0,15,13
1668280271982,MATH 288,A00,098057,Agarwal; Pooja,9,0,10,1
1668280271982,MATH 288,B00,098058,Zhang; Danna,8,0,10,2
1668280271982,MATH 288,C00,098059,Williams; Ruth J,9,0,10,1
1668280272407,MATH 290B,A00,098060,Roberts; Justin Deritter,13,0,15,2
1668280272830,MATH 292,A00,098061,Belmont; Eva Kinoshita,10,0,10,0
1668280273254,MATH 295,A00,098062,Suk; Andrew Hoon,48,0,50,2
1668280273677,MATH 296,A00,098063,Novak; Jonathan I,20,0,20,0
1668280274100,MATH 297,001,098064,Gamst; Anthony Collins,9997,0,9999,2
1668280772897,COGS 205,A00,101395,Chiba; Andrea,19,0,20,1
1668280773321,COGS 210B,001,101404,Greene; Deanna Jacquelyn,9998,0,9999,1
1668280773321,COGS 210B,002,101417,Xia; Haijun,9999,0,9999,0
1668280773321,COGS 210B,003,101422,Nitz; Douglas A.,9999,0,9999,0
1668280773321,COGS 210B,004,101423,Hollan; James D.,9998,0,9999,1
1668280773321,COGS 210B,005,101424,Deak; Gedeon O.,9998,0,9999,1
1668280773321,COGS 210B,006,101425,Rossano; Federico,9999,0,9999,0
1668280773747,COGS 211B,A00,101427,Coulson; Seana M,9996,0,9999,3
1668280774170,COGS 220,A00,101428,Hollan; James D.,0,0,25,25
1668280774596,COGS 229,A00,101429,Dow; Steven P,18,0,25,7
1668280775018,COGS 230,A00,101430,Klemmer; Scott R,12,0,17,5
1668280775441,COGS 234,A00,101431,Xia; Haijun,1,0,25,24
1668280775866,COGS 260,A00,101432,Kiyonaga; Anastasia,21,0,25,4
1668280775866,COGS 260,B00,101433,Kirsh; David Joel,15,0,25,10
1668280776290,CSE 202,A00,102371,Impagliazzo; Russell,0,0,0,0
1668280776716,CSE 203B,A01,102373,Cheng; Chung Kuan,0,0,0,0
1668280777141,CSE 208,A00,102374,Micciancio; Daniele,0,0,0,0
1668280777565,CSE 209A,A00,112895,Impagliazzo; Russell,0,0,15,15
1668280777991,CSE 209B,A00,108005,Bellare; Mihir,0,0,0,0
1668280778416,CSE 210,A00,113163,Coblenz; Michael J,0,0,0,0
1668280778838,CSE 219,A00,106111,Dow; Steven P,0,0,20,20
1668280779264,CSE 221,A00,102376,Voelker; Geoffrey M.,0,0,0,0
1668280779687,CSE 224,A01,102378,Porter; George M,0,0,0,0
1668280780114,CSE 229A,A00,102379,Savage; Stefan,0,0,0,0
1668280780542,CSE 229C,A00,102380,Munyaka; Imani N. S.,0,0,0,0
1668280780965,CSE 232B,A00,102382,Deutsch; Alin Bernard,0,0,0,0
1668280781388,CSE 234,A01,112904,Kumar; Arun Kumar,0,0,0,0
1668280781820,CSE 237A,A00,102383,Rosing; Tajana Simunic,0,0,0,0
1668280782245,CSE 239A,A00,102384,Deutsch; Alin Bernard,0,0,0,0
1668280782670,CSE 239B,A00,102385,Polikarpova; Nadezhda,0,0,0,0
1668280783099,CSE 240A,A00,102386,Pannuto; Patrick William,0,0,0,0
1668280783523,CSE 240B,A00,102387,Zhao; Jishen,0,0,0,0
1668280783948,CSE 241A,A00,106406,Kang; Mingu,0,0,0,0
1668280784380,CSE 249B,A00,102388,Kahng; Andrew Byun,0,0,8,8
1668280784817,CSE 251B,A01,102392,Cottrell; Garrison W,0,0,0,0
1668280784817,CSE 251B,A02,102393,Cottrell; Garrison W,0,0,0,0
1668280785250,CSE 252B,A00,102394,Ochoa; Benjamin Lawrence,0,0,0,0
1668280785676,CSE 257,A01,102396,Gao; Sicun,0,0,0,0
1668280786103,CSE 272,A00,102397,Li; Tzumao,0,0,0,0
1668280786526,CSE 274,A00,111323,Chern; Albert Ren-Haur,0,0,0,0
1668280786949,CSE 282,A00,102398,Pevzner; Pavel Arkadjevich,0,0,0,0
1668280787379,CSE 284,A00,114175,Gymrek; Melissa Ann,0,0,0,0
1668280787805,CSE 290,A00,102399,Chandraker; Manmohan Krishna,0,0,0,0
1668280787805,CSE 290,B00,102400,Vaccaro; Kristen Marie,0,0,25,25
1668280787805,CSE 290,C00,102414,Pannuto; Patrick William,0,0,25,25
1668280787805,CSE 290,D00,102427,Pevzner; Pavel Arkadjevich,0,0,0,0
1668280787805,CSE 290,E00,102429,Zhao; Jishen,0,0,0,0
1668280787805,CSE 290,F00,102436,Tullsen; Dean Michael,0,0,0,0
1668280787805,CSE 290,G00,102440,Christensen; Henrik I,0,0,20,20
1668280788235,CSE 291,A00,102443,Su; Hao,0,0,0,0
1668280788235,CSE 291,B00,102448,Polikarpova; Nadezhda,0,0,0,0
1668280788235,CSE 291,C00,102453,Vaccaro; Kristen Marie,0,0,0,0
1668280788235,CSE 291,D00,111343,Savage; Stefan,0,0,0,0
1668280788235,CSE 291,E00,116474,Claffy; Kimberly Claire,0,0,0,0
1668280788235,CSE 291,F00,116479,Pasquale; Joseph,0,0,0,0
1668280788670,CSE 293,001,119111,Bafna; Vineet,9999,0,9999,0
1668280788670,CSE 293,002,119118,Bellare; Mihir,9999,0,9999,0
1668280788670,CSE 293,003,119122,Berg-Kirkpatrick; Taylor D,9999,0,9999,0
1668280788670,CSE 293,004,119135,Christensen; Henrik I,9999,0,9999,0
1668280788670,CSE 293,005,119142,Cottrell; Garrison W,9999,0,9999,0
1668280788670,CSE 293,006,119146,Deutsch; Alin Bernard,9999,0,9999,0
1668280788670,CSE 293,007,119159,Esmaeilzadeh; Hadi,9999,0,9999,0
1668280788670,CSE 293,008,119166,Freund; Yoav,9999,0,9999,0
1668280788670,CSE 293,009,119170,Griswold; William G.,9999,0,9999,0
1668280788670,CSE 293,010,119183,Gymrek; Melissa Ann,9999,0,9999,0
1668280788670,CSE 293,011,119190,Heninger; Nadia A,9999,0,9999,0
1668280788670,CSE 293,012,119230,Impagliazzo; Russell,9999,0,9999,0
1668280788670,CSE 293,013,119232,Jhala; Ranjit,9999,0,9999,0
1668280788670,CSE 293,014,119233,Kahng; Andrew Byun,9999,0,9999,0
1668280788670,CSE 293,015,119298,Kane; Daniel Mertz,9999,0,9999,0
1668280788670,CSE 293,016,119299,Kriegman; David J,9999,0,9999,0
1668280788670,CSE 293,017,119300,Kumar; Arun Kumar,9999,0,9999,0
1668280788670,CSE 293,018,119301,Lerner; Sorin,9999,0,9999,0
1668280788670,CSE 293,019,119302,Lovett; Shachar,9999,0,9999,0
1668280788670,CSE 293,020,119303,McAuley; Julian John,9999,0,9999,0
1668280788670,CSE 293,021,119304,Micciancio; Daniele,9999,0,9999,0
1668280788670,CSE 293,022,119367,Orailoglu; Alex,9999,0,9999,0
1668280788670,CSE 293,023,119382,Paturi; Ramamohan,9999,0,9999,0
1668280788670,CSE 293,024,119404,Polikarpova; Nadezhda,9999,0,9999,0
1668280788670,CSE 293,025,119406,Politz; Joseph Gibbs,9999,0,9999,0
1668280788670,CSE 293,026,119411,Porter; George M,9999,0,9999,0
1668280788670,CSE 293,027,119414,Porter; Leonard Emerson,9999,0,9999,0
1668280788670,CSE 293,028,119416,Ramamoorthi; Ravi,9999,0,9999,0
1668280788670,CSE 293,029,119417,Sahoo; Debashis,9999,0,9999,0
1668280788670,CSE 293,030,119420,Saul; Lawrence,9999,0,9999,0
1668280788670,CSE 293,031,119421,Savage; Stefan,9999,0,9999,0
1668280788670,CSE 293,032,119425,Schulze; Jurgen P.,9999,0,9999,0
1668280788670,CSE 293,033,119426,Snoeren; Alex C.,9999,0,9999,0
1668280788670,CSE 293,034,119428,Shang; Jingbo,9999,0,9999,0
1668280788670,CSE 293,035,119430,Stefan; Deian,9999,0,9999,0
1668280788670,CSE 293,036,119431,Su; Hao,9999,0,9999,0
1668280788670,CSE 293,037,119433,Swanson; Steven James,9999,0,9999,0
1668280788670,CSE 293,038,119435,Tullsen; Dean Michael,9999,0,9999,0
1668280788670,CSE 293,039,119483,Voelker; Geoffrey M.,9999,0,9999,0
1668280788670,CSE 293,040,119537,Zhao; Jishen,9999,0,9999,0
1668280788670,CSE 293,041,119538,Zhou; Yuan-Yuan,9999,0,9999,0
1668280788670,CSE 293,042,119539,Gao; Sicun,9999,0,9999,0
1668280788670,CSE 293,043,119540,Weibel; Nadir,9999,0,9999,0
1668280788670,CSE 293,044,119541,Gupta; Rajesh K.,9999,0,9999,0
1668280788670,CSE 293,045,126410,Vaccaro; Kristen Marie,9999,0,9999,0
1668280788670,CSE 293,046,126411,Klemke; Richard,9999,0,9999,0
1668280789100,CSE 294,A00,102459,Voelker; Geoffrey M.,0,0,0,0
1668280789100,CSE 294,B00,111322,Orailoglu; Alex,0,0,0,0
1668280789525,DSE 201,A00,096914,Deutsch; Alin Bernard,30,0,30,0
1668280789952,DSE 210,A00,096915,Dasgupta; Sanjoy,30,0,30,0
1668280790381,DSE 260A,A00,096916,Altintas De Callaf; Ilkay,30,0,30,0
1668280790808,ECE 200,001,103586,Antipa; Nicholas A,9999,0,9999,0
1668280790808,ECE 200,002,103587,Atanasov; Nikolay A.,9999,0,9999,0
1668280790808,ECE 200,003,103588,Bharadia; Dinesh,9999,0,9999,0
1668280790808,ECE 200,004,103589,Cheng; Chung Kuan,9999,0,9999,0
1668280790808,ECE 200,005,103590,Cosman; Pamela C.,9999,0,9999,0
1668280790808,ECE 200,006,103591,Dayeh; Shadi Ahmad,9999,0,9999,0
1668280790808,ECE 200,007,103592,Fainman; Yeshaiahu,9999,0,9999,0
1668280790808,ECE 200,008,103593,Ford; Joseph Earl,9999,0,9999,0
1668280790808,ECE 200,009,103594,Franceschetti; Massimo,9999,0,9999,0
1668280790808,ECE 200,010,103595,Fullerton; Eric E,9999,0,9999,0
1668280790808,ECE 200,011,103596,Galton; Ian A,9999,0,9999,0
1668280790808,ECE 200,012,103597,Gilja; Vikash,9999,0,9999,0
1668280790808,ECE 200,013,103598,Hall; Drew A.,9999,0,9999,0
1668280790808,ECE 200,014,103599,Hsueh; Tzu-Chien,9999,0,9999,0
1668280790808,ECE 200,015,103600,Javidi; Tara,9999,0,9999,0
1668280790808,ECE 200,016,103601,Kahng; Andrew Byun,9999,0,9999,0
1668280790808,ECE 200,017,103602,Kim; Young-Han,9999,0,9999,0
1668280790808,ECE 200,018,103603,Koushanfar; Farinaz,9999,0,9999,0
1668280790808,ECE 200,019,103604,Kuzum; Duygu,9999,0,9999,0
1668280790808,ECE 200,020,103605,Le; Hanh-Phuc,9999,0,9999,0
1668280790808,ECE 200,021,103606,Lin; Bill,9999,0,9999,0
1668280790808,ECE 200,022,103607,Liu; Zhaowei,9998,0,9999,1
1668280790808,ECE 200,023,103608,Lo; Yu-Hwa,9999,0,9999,0
1668280790808,ECE 200,024,103609,Lomakin; Vitaliy,9999,0,9999,0
1668280790808,ECE 200,025,103610,Mercier; Patrick Philip,9999,0,9999,0
1668280790808,ECE 200,026,103611,Meyer; Florian,9999,0,9999,0
1668280790808,ECE 200,027,103612,Milstein; Laurence B.,9999,0,9999,0
1668280790808,ECE 200,028,103613,Mir Arabbaygi; Siavash,9999,0,9999,0
1668280790808,ECE 200,029,103614,Mookherjea; Shayan,9999,0,9999,0
1668280790808,ECE 200,030,103615,Morris; Karcher William,9999,0,9999,0
1668280790808,ECE 200,031,103616,Ng; Tse Nga,9999,0,9999,0
1668280790808,ECE 200,032,103617,Nguyen; Truong Quang,9999,0,9999,0
1668280790808,ECE 200,033,103618,Nomura; Kenji,9999,0,9999,0
1668280790808,ECE 200,034,103619,Orlitsky; Alon,9999,0,9999,0
1668280790808,ECE 200,035,103620,Pal; Piya,9999,0,9999,0
1668280790808,ECE 200,036,103621,Papen; George C.,9999,0,9999,0
1668280790808,ECE 200,037,103622,Radic; Stojan,9999,0,9999,0
1668280790808,ECE 200,038,103623,Rao; Bhaskar D.,9999,0,9999,0
1668280790808,ECE 200,039,103624,Rao; Ramesh R,9999,0,9999,0
1668280790808,ECE 200,040,103625,Rebeiz; Gabriel,9999,0,9999,0
1668280790808,ECE 200,041,103626,Sanford; John R,9999,0,9999,0
1668280790808,ECE 200,042,103627,Siegel; Paul H.,9999,0,9999,0
1668280790808,ECE 200,043,103628,Sievenpiper; Daniel F.,9999,0,9999,0
1668280790808,ECE 200,044,103629,Sworder; David D.,9999,0,9999,0
1668280790808,ECE 200,045,103630,Taur; Yuan,9999,0,9999,0
1668280790808,ECE 200,046,103631,Touri; Behrouz,9999,0,9999,0
1668280790808,ECE 200,047,103632,Trivedi; Mohan M.,9999,0,9999,0
1668280790808,ECE 200,048,103633,Vasconcelos; Nuno,9999,0,9999,0
1668280790808,ECE 200,049,103634,Wang; Xiaolong,9999,0,9999,0
1668280790808,ECE 200,050,103635,Xie; Pengtao,9999,0,9999,0
1668280790808,ECE 200,051,103636,Yip; Michael,9999,0,9999,0
1668280790808,ECE 200,052,103637,Zeger; Kenneth A.,999,0,999,0
1668280790808,ECE 200,053,103638,Zhang; Xinyu,9999,0,9999,0
1668280790808,ECE 200,054,103639,Turakhia; Yatish Girish,9999,0,9999,0
1668280790808,ECE 200,055,103640,Kang; Mingu,9999,0,9999,0
1668280790808,ECE 200,056,103641,Shi; Yuanyuan,9999,0,9999,0
1668280790808,ECE 200,057,103642,Wang; Edward Jay,9999,0,9999,0
1668280790808,ECE 200,058,103643,Zheng; Yang,9999,0,9999,0
1668280791232,ECE 202,A00,103644,Kuzum; Duygu,0,0,0,0
1668280791656,ECE 212BN,A00,103646,Ng; Tse Nga,0,0,0,0
1668280792081,ECE 221,A00,111493,Staff,0,0,0,0
1668280792503,ECE 222B,A00,103647,Lomakin; Vitaliy,0,0,0,0
1668280792927,ECE 230B,A00,103648,Taur; Yuan,0,0,0,0
1668280793359,ECE 238B,A00,103649,Garay; Javier,0,0,0,0
1668280793784,ECE 240B,A00,112900,Fainman; Yeshaiahu,0,0,0,0
1668280794210,ECE 247A,A00,103650,Jokerst; Jesse Vincent,0,0,0,0
1668280794638,ECE 247B,A00,103651,Wang; Joseph,0,0,0,0
1668280795063,ECE 250,A00,103652,Siegel; Paul H.,0,0,0,0
1668280795487,ECE 251A,A00,103654,Rao; Bhaskar D.,0,0,0,0
1668280795911,ECE 257B,A00,103655,Bharadia; Dinesh,0,0,0,0
1668280796336,ECE 258A,A00,103656,Milstein; Laurence B.,0,0,0,0
1668280796762,ECE 260B,A00,103658,Kang; Mingu,0,0,0,0
1668280797188,ECE 264A,A00,103659,Galton; Ian A,0,0,0,0
1668280797611,ECE 265A,A00,103661,Gudem; Prasad S.S.,0,0,0,0
1668280798040,ECE 265D,A00,103662,Gudem; Prasad S.S.,0,0,0,0
1668280798464,ECE 268,A00,103663,Koushanfar; Farinaz,0,0,0,0
1668280798887,ECE 269,A01,103665,Pal; Piya,0,0,0,0
1668280799310,ECE 271B,A00,103666,Vasconcelos; Manuela,0,0,0,0
1668280799735,ECE 276A,A00,103667,Atanasov; Nikolay A.,0,0,0,0
1668280800162,ECE 277,A00,103668,An; Cheolhong,0,0,0,0
1668280800587,ECE 279,A00,117947,Hall; Drew A.,0,0,0,0
1668280801441,ECE 283,A00,103670,Hsueh; Tzu-Chien,0,0,0,0
1668280801868,ECE 284,A00,103671,Turakhia; Yatish Girish,0,0,0,0
1668280802293,ECE 285,A00,103672,Zheng; Yang,0,0,0,0
1668280802293,ECE 285,B00,103673,Sworder; David D.,0,0,0,0
1668280802717,ECE 287,A00,103676,Javidi; Tara,0,0,0,0
1668280803142,MATH 200B,A00,098023,Salehi Golsefidy; Alireza,12,0,15,3
1668280803566,MATH 202B,A00,098024,Rhoades; Brendon Patrick,9,0,15,6
1668280803994,MATH 203B,A00,098025,Oprea; Dragos N.,10,0,15,5
1668280804418,MATH 204B,A00,098026,Sorensen; Claus M,13,0,15,2
1668280804844,MATH 208,A00,098027,Izadi; Elham,7,0,10,3
1668280805270,MATH 209,A00,098028,Pollack; Aaron,10,0,10,0
1668280805692,MATH 211A,A00,112919,Rogalski; Daniel,9,0,10,1
1668280806126,MATH 211B,A00,112920,Seward; Brandon M.,9,0,10,1
1668280806551,MATH 218,A00,098029,Li; Bo,10,0,10,0
1668280806975,MATH 220B,A00,098030,Novak; Jonathan I,11,0,15,4
1668280807400,MATH 221A,A00,098031,Ebenfelt; Peter F,13,0,15,2
1668280807832,MATH 231B,A00,098032,Zlatos; Andrej,12,0,15,3
1668280808332,MATH 240B,A00,098033,Ni; Lei,9,0,15,6
1668280808756,MATH 243,A00,098034,Jekel; David Andrew,10,0,10,0
1668280809185,MATH 245A,A00,098035,Nie; Jiawang,0,0,15,16
1668280809612,MATH 248,A00,098036,Bejenaru; Ioan,10,0,10,0
1668280810038,MATH 250B,A00,098037,Spolaor; Luca,14,0,15,1
1668280810465,MATH 258,A00,098038,Ni; Lei,10,0,10,0
1668280810892,MATH 264B,A00,098041,Rhoades; Brendon Patrick,9,0,15,6
1668280811316,MATH 268,A00,098042,Buss; Samuel R,10,0,10,0
1668280811739,MATH 269,A00,098043,Rhoades; Brendon Patrick,10,0,10,0
1668280812163,MATH 270B,A00,098044,Li; Bo,10,0,15,5
1668280812586,MATH 272B,A00,098045,Holst; Michael J,13,0,15,2
1668280813010,MATH 273A,A00,098046,Tian; Xiaochuan,10,0,15,5
1668280813434,MATH 275,A01,098048,Tian; Xiaochuan,6,0,10,4
1668280813860,MATH 278A,A00,098049,Holst; Michael J,8,0,10,2
1668280814284,MATH 278B,A00,098050,Cloninger; Alexander,10,0,10,0
1668280814709,MATH 278C,A00,098051,Nie; Jiawang,7,0,10,3
1668280815132,MATH 280B,A00,098052,Zheng; Tianyi,8,0,15,7
1668280815555,MATH 281B,A00,098053,Bradic; Jelena,1,0,15,14
1668280815983,MATH 282B,A00,098054,Arias-Castro; Ery,0,0,15,15
1668280816406,MATH 285,A00,098055,Fitzsimmons; Patrick J,0,0,15,17
1668280816831,MATH 287B,A00,098056,Arias-Castro; Ery,2,0,15,13
1668280817256,MATH 288,A00,098057,Agarwal; Pooja,9,0,10,1
1668280817256,MATH 288,B00,098058,Zhang; Danna,8,0,10,2
1668280817256,MATH 288,C00,098059,Williams; Ruth J,9,0,10,1
1668280817679,MATH 290B,A00,098060,Roberts; Justin Deritter,13,0,15,2
1668280818105,MATH 292,A00,098061,Belmont; Eva Kinoshita,10,0,10,0
1668280818528,MATH 295,A00,098062,Suk; Andrew Hoon,48,0,50,2
1668280818958,MATH 296,A00,098063,Novak; Jonathan I,20,0,20,0
1668280819385,MATH 297,001,098064,Gamst; Anthony Collins,9997,0,9999,2
1668281317761,COGS 205,A00,101395,Chiba; Andrea,19,0,20,1
1668281318186,COGS 210B,001,101404,Greene; Deanna Jacquelyn,9998,0,9999,1
1668281318186,COGS 210B,002,101417,Xia; Haijun,9999,0,9999,0
1668281318186,COGS 210B,003,101422,Nitz; Douglas A.,9999,0,9999,0
1668281318186,COGS 210B,004,101423,Hollan; James D.,9998,0,9999,1
1668281318186,COGS 210B,005,101424,Deak; Gedeon O.,9998,0,9999,1
1668281318186,COGS 210B,006,101425,Rossano; Federico,9999,0,9999,0
1668281318612,COGS 211B,A00,101427,Coulson; Seana M,9996,0,9999,3
1668281319038,COGS 220,A00,101428,Hollan; James D.,0,0,25,25
1668281319460,COGS 229,A00,101429,Dow; Steven P,18,0,25,7
1668281319885,COGS 230,A00,101430,Klemmer; Scott R,12,0,17,5
1668281320311,COGS 234,A00,101431,Xia; Haijun,1,0,25,24
1668281320735,COGS 260,A00,101432,Kiyonaga; Anastasia,21,0,25,4
1668281320735,COGS 260,B00,101433,Kirsh; David Joel,15,0,25,10
1668281321159,CSE 202,A00,102371,Impagliazzo; Russell,0,0,0,0
1668281321583,CSE 203B,A01,102373,Cheng; Chung Kuan,0,0,0,0
1668281322007,CSE 208,A00,102374,Micciancio; Daniele,0,0,0,0
1668281322432,CSE 209A,A00,112895,Impagliazzo; Russell,0,0,15,15
1668281322855,CSE 209B,A00,108005,Bellare; Mihir,0,0,0,0
1668281323281,CSE 210,A00,113163,Coblenz; Michael J,0,0,0,0
1668281323705,CSE 219,A00,106111,Dow; Steven P,0,0,20,20
1668281324132,CSE 221,A00,102376,Voelker; Geoffrey M.,0,0,0,0
1668281324555,CSE 224,A01,102378,Porter; George M,0,0,0,0
1668281324979,CSE 229A,A00,102379,Savage; Stefan,0,0,0,0
1668281325409,CSE 229C,A00,102380,Munyaka; Imani N. S.,0,0,0,0
1668281325840,CSE 232B,A00,102382,Deutsch; Alin Bernard,0,0,0,0
1668281326265,CSE 234,A01,112904,Kumar; Arun Kumar,0,0,0,0
1668281326761,CSE 237A,A00,102383,Rosing; Tajana Simunic,0,0,0,0
1668281327191,CSE 239A,A00,102384,Deutsch; Alin Bernard,0,0,0,0
1668281327614,CSE 239B,A00,102385,Polikarpova; Nadezhda,0,0,0,0
1668281328037,CSE 240A,A00,102386,Pannuto; Patrick William,0,0,0,0
1668281328463,CSE 240B,A00,102387,Zhao; Jishen,0,0,0,0
1668281328888,CSE 241A,A00,106406,Kang; Mingu,0,0,0,0
1668281329310,CSE 249B,A00,102388,Kahng; Andrew Byun,0,0,8,8
1668281329738,CSE 251B,A01,102392,Cottrell; Garrison W,0,0,0,0
1668281329738,CSE 251B,A02,102393,Cottrell; Garrison W,0,0,0,0
1668281330163,CSE 252B,A00,102394,Ochoa; Benjamin Lawrence,0,0,0,0
1668281330604,CSE 257,A01,102396,Gao; Sicun,0,0,0,0
1668281331032,CSE 272,A00,102397,Li; Tzumao,0,0,0,0
1668281331454,CSE 274,A00,111323,Chern; Albert Ren-Haur,0,0,0,0
1668281331881,CSE 282,A00,102398,Pevzner; Pavel Arkadjevich,0,0,0,0
1668281332306,CSE 284,A00,114175,Gymrek; Melissa Ann,0,0,0,0
1668281332735,CSE 290,A00,102399,Chandraker; Manmohan Krishna,0,0,0,0
1668281332735,CSE 290,B00,102400,Vaccaro; Kristen Marie,0,0,25,25
1668281332735,CSE 290,C00,102414,Pannuto; Patrick William,0,0,25,25
1668281332735,CSE 290,D00,102427,Pevzner; Pavel Arkadjevich,0,0,0,0
1668281332735,CSE 290,E00,102429,Zhao; Jishen,0,0,0,0
1668281332735,CSE 290,F00,102436,Tullsen; Dean Michael,0,0,0,0
1668281332735,CSE 290,G00,102440,Christensen; Henrik I,0,0,20,20
1668281333164,CSE 291,A00,102443,Su; Hao,0,0,0,0
1668281333164,CSE 291,B00,102448,Polikarpova; Nadezhda,0,0,0,0
1668281333164,CSE 291,C00,102453,Vaccaro; Kristen Marie,0,0,0,0
1668281333164,CSE 291,D00,111343,Savage; Stefan,0,0,0,0
1668281333164,CSE 291,E00,116474,Claffy; Kimberly Claire,0,0,0,0
1668281333164,CSE 291,F00,116479,Pasquale; Joseph,0,0,0,0
1668281333618,CSE 293,001,119111,Bafna; Vineet,9999,0,9999,0
1668281333618,CSE 293,002,119118,Bellare; Mihir,9999,0,9999,0
1668281333618,CSE 293,003,119122,Berg-Kirkpatrick; Taylor D,9999,0,9999,0
1668281333618,CSE 293,004,119135,Christensen; Henrik I,9999,0,9999,0
1668281333618,CSE 293,005,119142,Cottrell; Garrison W,9999,0,9999,0
1668281333618,CSE 293,006,119146,Deutsch; Alin Bernard,9999,0,9999,0
1668281333618,CSE 293,007,119159,Esmaeilzadeh; Hadi,9999,0,9999,0
1668281333618,CSE 293,008,119166,Freund; Yoav,9999,0,9999,0
1668281333618,CSE 293,009,119170,Griswold; William G.,9999,0,9999,0
1668281333618,CSE 293,010,119183,Gymrek; Melissa Ann,9999,0,9999,0
1668281333618,CSE 293,011,119190,Heninger; Nadia A,9999,0,9999,0
1668281333618,CSE 293,012,119230,Impagliazzo; Russell,9999,0,9999,0
1668281333618,CSE 293,013,119232,Jhala; Ranjit,9999,0,9999,0
1668281333618,CSE 293,014,119233,Kahng; Andrew Byun,9999,0,9999,0
1668281333618,CSE 293,015,119298,Kane; Daniel Mertz,9999,0,9999,0
1668281333618,CSE 293,016,119299,Kriegman; David J,9999,0,9999,0
1668281333618,CSE 293,017,119300,Kumar; Arun Kumar,9999,0,9999,0
1668281333618,CSE 293,018,119301,Lerner; Sorin,9999,0,9999,0
1668281333618,CSE 293,019,119302,Lovett; Shachar,9999,0,9999,0
1668281333618,CSE 293,020,119303,McAuley; Julian John,9999,0,9999,0
1668281333618,CSE 293,021,119304,Micciancio; Daniele,9999,0,9999,0
1668281333618,CSE 293,022,119367,Orailoglu; Alex,9999,0,9999,0
1668281333618,CSE 293,023,119382,Paturi; Ramamohan,9999,0,9999,0
1668281333618,CSE 293,024,119404,Polikarpova; Nadezhda,9999,0,9999,0
1668281333618,CSE 293,025,119406,Politz; Joseph Gibbs,9999,0,9999,0
1668281333618,CSE 293,026,119411,Porter; George M,9999,0,9999,0
1668281333618,CSE 293,027,119414,Porter; Leonard Emerson,9999,0,9999,0
1668281333618,CSE 293,028,119416,Ramamoorthi; Ravi,9999,0,9999,0
1668281333618,CSE 293,029,119417,Sahoo; Debashis,9999,0,9999,0
1668281333618,CSE 293,030,119420,Saul; Lawrence,9999,0,9999,0
1668281333618,CSE 293,031,119421,Savage; Stefan,9999,0,9999,0
1668281333618,CSE 293,032,119425,Schulze; Jurgen P.,9999,0,9999,0
1668281333618,CSE 293,033,119426,Snoeren; Alex C.,9999,0,9999,0
1668281333618,CSE 293,034,119428,Shang; Jingbo,9999,0,9999,0
1668281333618,CSE 293,035,119430,Stefan; Deian,9999,0,9999,0
1668281333618,CSE 293,036,119431,Su; Hao,9999,0,9999,0
1668281333618,CSE 293,037,119433,Swanson; Steven James,9999,0,9999,0
1668281333618,CSE 293,038,119435,Tullsen; Dean Michael,9999,0,9999,0
1668281333618,CSE 293,039,119483,Voelker; Geoffrey M.,9999,0,9999,0
1668281333618,CSE 293,040,119537,Zhao; Jishen,9999,0,9999,0
1668281333618,CSE 293,041,119538,Zhou; Yuan-Yuan,9999,0,9999,0
1668281333618,CSE 293,042,119539,Gao; Sicun,9999,0,9999,0
1668281333618,CSE 293,043,119540,Weibel; Nadir,9999,0,9999,0
1668281333618,CSE 293,044,119541,Gupta; Rajesh K.,9999,0,9999,0
1668281333618,CSE 293,045,126410,Vaccaro; Kristen Marie,9999,0,9999,0
1668281333618,CSE 293,046,126411,Klemke; Richard,9999,0,9999,0
1668281334042,CSE 294,A00,102459,Voelker; Geoffrey M.,0,0,0,0
1668281334042,CSE 294,B00,111322,Orailoglu; Alex,0,0,0,0
1668281334467,DSE 201,A00,096914,Deutsch; Alin Bernard,30,0,30,0
1668281334894,DSE 210,A00,096915,Dasgupta; Sanjoy,30,0,30,0
1668281335316,DSE 260A,A00,096916,Altintas De Callaf; Ilkay,30,0,30,0
1668281335744,ECE 200,001,103586,Antipa; Nicholas A,9999,0,9999,0
1668281335744,ECE 200,002,103587,Atanasov; Nikolay A.,9999,0,9999,0
1668281335744,ECE 200,003,103588,Bharadia; Dinesh,9999,0,9999,0
1668281335744,ECE 200,004,103589,Cheng; Chung Kuan,9999,0,9999,0
1668281335744,ECE 200,005,103590,Cosman; Pamela C.,9999,0,9999,0
1668281335744,ECE 200,006,103591,Dayeh; Shadi Ahmad,9999,0,9999,0
1668281335744,ECE 200,007,103592,Fainman; Yeshaiahu,9999,0,9999,0
1668281335744,ECE 200,008,103593,Ford; Joseph Earl,9999,0,9999,0
1668281335744,ECE 200,009,103594,Franceschetti; Massimo,9999,0,9999,0
1668281335744,ECE 200,010,103595,Fullerton; Eric E,9999,0,9999,0
1668281335744,ECE 200,011,103596,Galton; Ian A,9999,0,9999,0
1668281335744,ECE 200,012,103597,Gilja; Vikash,9999,0,9999,0
1668281335744,ECE 200,013,103598,Hall; Drew A.,9999,0,9999,0
1668281335744,ECE 200,014,103599,Hsueh; Tzu-Chien,9999,0,9999,0
1668281335744,ECE 200,015,103600,Javidi; Tara,9999,0,9999,0
1668281335744,ECE 200,016,103601,Kahng; Andrew Byun,9999,0,9999,0
1668281335744,ECE 200,017,103602,Kim; Young-Han,9999,0,9999,0
1668281335744,ECE 200,018,103603,Koushanfar; Farinaz,9999,0,9999,0
1668281335744,ECE 200,019,103604,Kuzum; Duygu,9999,0,9999,0
1668281335744,ECE 200,020,103605,Le; Hanh-Phuc,9999,0,9999,0
1668281335744,ECE 200,021,103606,Lin; Bill,9999,0,9999,0
1668281335744,ECE 200,022,103607,Liu; Zhaowei,9998,0,9999,1
1668281335744,ECE 200,023,103608,Lo; Yu-Hwa,9999,0,9999,0
1668281335744,ECE 200,024,103609,Lomakin; Vitaliy,9999,0,9999,0
1668281335744,ECE 200,025,103610,Mercier; Patrick Philip,9999,0,9999,0
1668281335744,ECE 200,026,103611,Meyer; Florian,9999,0,9999,0
1668281335744,ECE 200,027,103612,Milstein; Laurence B.,9999,0,9999,0
1668281335744,ECE 200,028,103613,Mir Arabbaygi; Siavash,9999,0,9999,0
1668281335744,ECE 200,029,103614,Mookherjea; Shayan,9999,0,9999,0
1668281335744,ECE 200,030,103615,Morris; Karcher William,9999,0,9999,0
1668281335744,ECE 200,031,103616,Ng; Tse Nga,9999,0,9999,0
1668281335744,ECE 200,032,103617,Nguyen; Truong Quang,9999,0,9999,0
1668281335744,ECE 200,033,103618,Nomura; Kenji,9999,0,9999,0
1668281335744,ECE 200,034,103619,Orlitsky; Alon,9999,0,9999,0
1668281335744,ECE 200,035,103620,Pal; Piya,9999,0,9999,0
1668281335744,ECE 200,036,103621,Papen; George C.,9999,0,9999,0
1668281335744,ECE 200,037,103622,Radic; Stojan,9999,0,9999,0
1668281335744,ECE 200,038,103623,Rao; Bhaskar D.,9999,0,9999,0
1668281335744,ECE 200,039,103624,Rao; Ramesh R,9999,0,9999,0
1668281335744,ECE 200,040,103625,Rebeiz; Gabriel,9999,0,9999,0
1668281335744,ECE 200,041,103626,Sanford; John R,9999,0,9999,0
1668281335744,ECE 200,042,103627,Siegel; Paul H.,9999,0,9999,0
1668281335744,ECE 200,043,103628,Sievenpiper; Daniel F.,9999,0,9999,0
1668281335744,ECE 200,044,103629,Sworder; David D.,9999,0,9999,0
1668281335744,ECE 200,045,103630,Taur; Yuan,9999,0,9999,0
1668281335744,ECE 200,046,103631,Touri; Behrouz,9999,0,9999,0
1668281335744,ECE 200,047,103632,Trivedi; Mohan M.,9999,0,9999,0
1668281335744,ECE 200,048,103633,Vasconcelos; Nuno,9999,0,9999,0
1668281335744,ECE 200,049,103634,Wang; Xiaolong,9999,0,9999,0
1668281335744,ECE 200,050,103635,Xie; Pengtao,9999,0,9999,0
1668281335744,ECE 200,051,103636,Yip; Michael,9999,0,9999,0
1668281335744,ECE 200,052,103637,Zeger; Kenneth A.,999,0,999,0
1668281335744,ECE 200,053,103638,Zhang; Xinyu,9999,0,9999,0
1668281335744,ECE 200,054,103639,Turakhia; Yatish Girish,9999,0,9999,0
1668281335744,ECE 200,055,103640,Kang; Mingu,9999,0,9999,0
1668281335744,ECE 200,056,103641,Shi; Yuanyuan,9999,0,9999,0
1668281335744,ECE 200,057,103642,Wang; Edward Jay,9999,0,9999,0
1668281335744,ECE 200,058,103643,Zheng; Yang,9999,0,9999,0
1668281336168,ECE 202,A00,103644,Kuzum; Duygu,0,0,0,0
1668281336592,ECE 212BN,A00,103646,Ng; Tse Nga,0,0,0,0
1668281337017,ECE 221,A00,111493,Staff,0,0,0,0
1668281337440,ECE 222B,A00,103647,Lomakin; Vitaliy,0,0,0,0
1668281337866,ECE 230B,A00,103648,Taur; Yuan,0,0,0,0
1668281338296,ECE 238B,A00,103649,Garay; Javier,0,0,0,0
1668281338721,ECE 240B,A00,112900,Fainman; Yeshaiahu,0,0,0,0
1668281339144,ECE 247A,A00,103650,Jokerst; Jesse Vincent,0,0,0,0
1668281339569,ECE 247B,A00,103651,Wang; Joseph,0,0,0,0
1668281339994,ECE 250,A00,103652,Siegel; Paul H.,0,0,0,0
1668281340417,ECE 251A,A00,103654,Rao; Bhaskar D.,0,0,0,0
1668281340841,ECE 257B,A00,103655,Bharadia; Dinesh,0,0,0,0
1668281341272,ECE 258A,A00,103656,Milstein; Laurence B.,0,0,0,0
1668281341708,ECE 260B,A00,103658,Kang; Mingu,0,0,0,0
1668281342135,ECE 264A,A00,103659,Galton; Ian A,0,0,0,0
1668281342558,ECE 265A,A00,103661,Gudem; Prasad S.S.,0,0,0,0
1668281342984,ECE 265D,A00,103662,Gudem; Prasad S.S.,0,0,0,0
1668281343407,ECE 268,A00,103663,Koushanfar; Farinaz,0,0,0,0
1668281343840,ECE 269,A01,103665,Pal; Piya,0,0,0,0
1668281344268,ECE 271B,A00,103666,Vasconcelos; Manuela,0,0,0,0
1668281344691,ECE 276A,A00,103667,Atanasov; Nikolay A.,0,0,0,0
1668281345114,ECE 277,A00,103668,An; Cheolhong,0,0,0,0
1668281345536,ECE 279,A00,117947,Hall; Drew A.,0,0,0,0
1668281346383,ECE 283,A00,103670,Hsueh; Tzu-Chien,0,0,0,0
1668281346809,ECE 284,A00,103671,Turakhia; Yatish Girish,0,0,0,0
1668281347233,ECE 285,A00,103672,Zheng; Yang,0,0,0,0
1668281347233,ECE 285,B00,103673,Sworder; David D.,0,0,0,0
1668281347657,ECE 287,A00,103676,Javidi; Tara,0,0,0,0
1668281348081,MATH 200B,A00,098023,Salehi Golsefidy; Alireza,12,0,15,3
1668281348507,MATH 202B,A00,098024,Rhoades; Brendon Patrick,9,0,15,6
1668281348934,MATH 203B,A00,098025,Oprea; Dragos N.,10,0,15,5
1668281349361,MATH 204B,A00,098026,Sorensen; Claus M,13,0,15,2
1668281349785,MATH 208,A00,098027,Izadi; Elham,7,0,10,3
1668281350208,MATH 209,A00,098028,Pollack; Aaron,10,0,10,0
1668281350634,MATH 211A,A00,112919,Rogalski; Daniel,9,0,10,1
1668281351059,MATH 211B,A00,112920,Seward; Brandon M.,9,0,10,1
1668281351480,MATH 218,A00,098029,Li; Bo,10,0,10,0
1668281351908,MATH 220B,A00,098030,Novak; Jonathan I,11,0,15,4
1668281352340,MATH 221A,A00,098031,Ebenfelt; Peter F,13,0,15,2
1668281352778,MATH 231B,A00,098032,Zlatos; Andrej,12,0,15,3
1668281353203,MATH 240B,A00,098033,Ni; Lei,9,0,15,6
1668281353625,MATH 243,A00,098034,Jekel; David Andrew,10,0,10,0
1668281354050,MATH 245A,A00,098035,Nie; Jiawang,0,0,15,16
1668281354475,MATH 248,A00,098036,Bejenaru; Ioan,10,0,10,0
1668281354905,MATH 250B,A00,098037,Spolaor; Luca,14,0,15,1
1668281355329,MATH 258,A00,098038,Ni; Lei,10,0,10,0
1668281355754,MATH 264B,A00,098041,Rhoades; Brendon Patrick,9,0,15,6
1668281356179,MATH 268,A00,098042,Buss; Samuel R,10,0,10,0
1668281356603,MATH 269,A00,098043,Rhoades; Brendon Patrick,10,0,10,0
1668281357030,MATH 270B,A00,098044,Li; Bo,10,0,15,5
1668281357456,MATH 272B,A00,098045,Holst; Michael J,13,0,15,2
1668281357883,MATH 273A,A00,098046,Tian; Xiaochuan,10,0,15,5
1668281358309,MATH 275,A01,098048,Tian; Xiaochuan,6,0,10,4
1668281358733,MATH 278A,A00,098049,Holst; Michael J,8,0,10,2
1668281359156,MATH 278B,A00,098050,Cloninger; Alexander,10,0,10,0
1668281359581,MATH 278C,A00,098051,Nie; Jiawang,7,0,10,3
1668281360004,MATH 280B,A00,098052,Zheng; Tianyi,8,0,15,7
1668281360437,MATH 281B,A00,098053,Bradic; Jelena,1,0,15,14
1668281360860,MATH 282B,A00,098054,Arias-Castro; Ery,0,0,15,15
1668281361286,MATH 285,A00,098055,Fitzsimmons; Patrick J,0,0,15,17
1668281361710,MATH 287B,A00,098056,Arias-Castro; Ery,2,0,15,13
1668281362135,MATH 288,A00,098057,Agarwal; Pooja,9,0,10,1
1668281362135,MATH 288,B00,098058,Zhang; Danna,8,0,10,2
1668281362135,MATH 288,C00,098059,Williams; Ruth J,9,0,10,1
1668281362563,MATH 290B,A00,098060,Roberts; Justin Deritter,13,0,15,2
1668281362985,MATH 292,A00,098061,Belmont; Eva Kinoshita,10,0,10,0
1668281363411,MATH 295,A00,098062,Suk; Andrew Hoon,48,0,50,2
1668281363834,MATH 296,A00,098063,Novak; Jonathan I,20,0,20,0
1668281364258,MATH 297,001,098064,Gamst; Anthony Collins,9997,0,9999,2
1668281863322,COGS 205,A00,101395,Chiba; Andrea,19,0,20,1
1668281863746,COGS 210B,001,101404,Greene; Deanna Jacquelyn,9998,0,9999,1
1668281863746,COGS 210B,002,101417,Xia; Haijun,9999,0,9999,0
1668281863746,COGS 210B,003,101422,Nitz; Douglas A.,9999,0,9999,0
1668281863746,COGS 210B,004,101423,Hollan; James D.,9998,0,9999,1
1668281863746,COGS 210B,005,101424,Deak; Gedeon O.,9998,0,9999,1
1668281863746,COGS 210B,006,101425,Rossano; Federico,9999,0,9999,0
1668281864173,COGS 211B,A00,101427,Coulson; Seana M,9996,0,9999,3
1668281864597,COGS 220,A00,101428,Hollan; James D.,0,0,25,25
1668281865023,COGS 229,A00,101429,Dow; Steven P,18,0,25,7
1668281865450,COGS 230,A00,101430,Klemmer; Scott R,12,0,17,5
1668281865875,COGS 234,A00,101431,Xia; Haijun,1,0,25,24
1668281866300,COGS 260,A00,101432,Kiyonaga; Anastasia,21,0,25,4
1668281866300,COGS 260,B00,101433,Kirsh; David Joel,15,0,25,10
1668281866723,CSE 202,A00,102371,Impagliazzo; Russell,0,0,0,0
1668281867146,CSE 203B,A01,102373,Cheng; Chung Kuan,0,0,0,0
1668281867578,CSE 208,A00,102374,Micciancio; Daniele,0,0,0,0
1668281868002,CSE 209A,A00,112895,Impagliazzo; Russell,0,0,15,15
1668281868425,CSE 209B,A00,108005,Bellare; Mihir,0,0,0,0
1668281868853,CSE 210,A00,113163,Coblenz; Michael J,0,0,0,0
1668281869277,CSE 219,A00,106111,Dow; Steven P,0,0,20,20
1668281869702,CSE 221,A00,102376,Voelker; Geoffrey M.,0,0,0,0
1668281870124,CSE 224,A01,102378,Porter; George M,0,0,0,0
1668281870547,CSE 229A,A00,102379,Savage; Stefan,0,0,0,0
1668281870971,CSE 229C,A00,102380,Munyaka; Imani N. S.,0,0,0,0
1668281871405,CSE 232B,A00,102382,Deutsch; Alin Bernard,0,0,0,0
1668281871830,CSE 234,A01,112904,Kumar; Arun Kumar,0,0,0,0
1668281872254,CSE 237A,A00,102383,Rosing; Tajana Simunic,0,0,0,0
1668281872677,CSE 239A,A00,102384,Deutsch; Alin Bernard,0,0,0,0
1668281873101,CSE 239B,A00,102385,Polikarpova; Nadezhda,0,0,0,0
1668281873526,CSE 240A,A00,102386,Pannuto; Patrick William,0,0,0,0
1668281873959,CSE 240B,A00,102387,Zhao; Jishen,0,0,0,0
1668281874386,CSE 241A,A00,106406,Kang; Mingu,0,0,0,0
1668281874810,CSE 249B,A00,102388,Kahng; Andrew Byun,0,0,8,8
1668281875235,CSE 251B,A01,102392,Cottrell; Garrison W,0,0,0,0
1668281875235,CSE 251B,A02,102393,Cottrell; Garrison W,0,0,0,0
1668281875659,CSE 252B,A00,102394,Ochoa; Benjamin Lawrence,0,0,0,0
1668281876082,CSE 257,A01,102396,Gao; Sicun,0,0,0,0
1668281876506,CSE 272,A00,102397,Li; Tzumao,0,0,0,0
1668281876935,CSE 274,A00,111323,Chern; Albert Ren-Haur,0,0,0,0
1668281877361,CSE 282,A00,102398,Pevzner; Pavel Arkadjevich,0,0,0,0
1668281877788,CSE 284,A00,114175,Gymrek; Melissa Ann,0,0,0,0
1668281878211,CSE 290,A00,102399,Chandraker; Manmohan Krishna,0,0,0,0
1668281878211,CSE 290,B00,102400,Vaccaro; Kristen Marie,0,0,25,25
1668281878211,CSE 290,C00,102414,Pannuto; Patrick William,0,0,25,25
1668281878211,CSE 290,D00,102427,Pevzner; Pavel Arkadjevich,0,0,0,0
1668281878211,CSE 290,E00,102429,Zhao; Jishen,0,0,0,0
1668281878211,CSE 290,F00,102436,Tullsen; Dean Michael,0,0,0,0
1668281878211,CSE 290,G00,102440,Christensen; Henrik I,0,0,20,20
1668281878640,CSE 291,A00,102443,Su; Hao,0,0,0,0
1668281878640,CSE 291,B00,102448,Polikarpova; Nadezhda,0,0,0,0
1668281878640,CSE 291,C00,102453,Vaccaro; Kristen Marie,0,0,0,0
1668281878640,CSE 291,D00,111343,Savage; Stefan,0,0,0,0
1668281878640,CSE 291,E00,116474,Claffy; Kimberly Claire,0,0,0,0
1668281878640,CSE 291,F00,116479,Pasquale; Joseph,0,0,0,0
1668281879064,CSE 293,001,119111,Bafna; Vineet,9999,0,9999,0
1668281879064,CSE 293,002,119118,Bellare; Mihir,9999,0,9999,0
1668281879064,CSE 293,003,119122,Berg-Kirkpatrick; Taylor D,9999,0,9999,0
1668281879064,CSE 293,004,119135,Christensen; Henrik I,9999,0,9999,0
1668281879064,CSE 293,005,119142,Cottrell; Garrison W,9999,0,9999,0
1668281879064,CSE 293,006,119146,Deutsch; Alin Bernard,9999,0,9999,0
1668281879064,CSE 293,007,119159,Esmaeilzadeh; Hadi,9999,0,9999,0
1668281879064,CSE 293,008,119166,Freund; Yoav,9999,0,9999,0
1668281879064,CSE 293,009,119170,Griswold; William G.,9999,0,9999,0
1668281879064,CSE 293,010,119183,Gymrek; Melissa Ann,9999,0,9999,0
1668281879064,CSE 293,011,119190,Heninger; Nadia A,9999,0,9999,0
1668281879064,CSE 293,012,119230,Impagliazzo; Russell,9999,0,9999,0
1668281879064,CSE 293,013,119232,Jhala; Ranjit,9999,0,9999,0
1668281879064,CSE 293,014,119233,Kahng; Andrew Byun,9999,0,9999,0
1668281879064,CSE 293,015,119298,Kane; Daniel Mertz,9999,0,9999,0
1668281879064,CSE 293,016,119299,Kriegman; David J,9999,0,9999,0
1668281879064,CSE 293,017,119300,Kumar; Arun Kumar,9999,0,9999,0
1668281879064,CSE 293,018,119301,Lerner; Sorin,9999,0,9999,0
1668281879064,CSE 293,019,119302,Lovett; Shachar,9999,0,9999,0
1668281879064,CSE 293,020,119303,McAuley; Julian John,9999,0,9999,0
1668281879064,CSE 293,021,119304,Micciancio; Daniele,9999,0,9999,0
1668281879064,CSE 293,022,119367,Orailoglu; Alex,9999,0,9999,0
1668281879064,CSE 293,023,119382,Paturi; Ramamohan,9999,0,9999,0
1668281879064,CSE 293,024,119404,Polikarpova; Nadezhda,9999,0,9999,0
1668281879064,CSE 293,025,119406,Politz; Joseph Gibbs,9999,0,9999,0
1668281879064,CSE 293,026,119411,Porter; George M,9999,0,9999,0
1668281879064,CSE 293,027,119414,Porter; Leonard Emerson,9999,0,9999,0
1668281879064,CSE 293,028,119416,Ramamoorthi; Ravi,9999,0,9999,0
1668281879064,CSE 293,029,119417,Sahoo; Debashis,9999,0,9999,0
1668281879064,CSE 293,030,119420,Saul; Lawrence,9999,0,9999,0
1668281879064,CSE 293,031,119421,Savage; Stefan,9999,0,9999,0
1668281879064,CSE 293,032,119425,Schulze; Jurgen P.,9999,0,9999,0
1668281879064,CSE 293,033,119426,Snoeren; Alex C.,9999,0,9999,0
1668281879064,CSE 293,034,119428,Shang; Jingbo,9999,0,9999,0
1668281879064,CSE 293,035,119430,Stefan; Deian,9999,0,9999,0
1668281879064,CSE 293,036,119431,Su; Hao,9999,0,9999,0
1668281879064,CSE 293,037,119433,Swanson; Steven James,9999,0,9999,0
1668281879064,CSE 293,038,119435,Tullsen; Dean Michael,9999,0,9999,0
1668281879064,CSE 293,039,119483,Voelker; Geoffrey M.,9999,0,9999,0
1668281879064,CSE 293,040,119537,Zhao; Jishen,9999,0,9999,0
1668281879064,CSE 293,041,119538,Zhou; Yuan-Yuan,9999,0,9999,0
1668281879064,CSE 293,042,119539,Gao; Sicun,9999,0,9999,0
1668281879064,CSE 293,043,119540,Weibel; Nadir,9999,0,9999,0
1668281879064,CSE 293,044,119541,Gupta; Rajesh K.,9999,0,9999,0
1668281879064,CSE 293,045,126410,Vaccaro; Kristen Marie,9999,0,9999,0
1668281879064,CSE 293,046,126411,Klemke; Richard,9999,0,9999,0
1668281879487,CSE 294,A00,102459,Voelker; Geoffrey M.,0,0,0,0
1668281879487,CSE 294,B00,111322,Orailoglu; Alex,0,0,0,0
1668281879911,DSE 201,A00,096914,Deutsch; Alin Bernard,30,0,30,0
1668281880333,DSE 210,A00,096915,Dasgupta; Sanjoy,30,0,30,0
1668281880756,DSE 260A,A00,096916,Altintas De Callaf; Ilkay,30,0,30,0
1668281881183,ECE 200,001,103586,Antipa; Nicholas A,9999,0,9999,0
1668281881183,ECE 200,002,103587,Atanasov; Nikolay A.,9999,0,9999,0
1668281881183,ECE 200,003,103588,Bharadia; Dinesh,9999,0,9999,0
1668281881183,ECE 200,004,103589,Cheng; Chung Kuan,9999,0,9999,0
1668281881183,ECE 200,005,103590,Cosman; Pamela C.,9999,0,9999,0
1668281881183,ECE 200,006,103591,Dayeh; Shadi Ahmad,9999,0,9999,0
1668281881183,ECE 200,007,103592,Fainman; Yeshaiahu,9999,0,9999,0
1668281881183,ECE 200,008,103593,Ford; Joseph Earl,9999,0,9999,0
1668281881183,ECE 200,009,103594,Franceschetti; Massimo,9999,0,9999,0
1668281881183,ECE 200,010,103595,Fullerton; Eric E,9999,0,9999,0
1668281881183,ECE 200,011,103596,Galton; Ian A,9999,0,9999,0
1668281881183,ECE 200,012,103597,Gilja; Vikash,9999,0,9999,0
1668281881183,ECE 200,013,103598,Hall; Drew A.,9999,0,9999,0
1668281881183,ECE 200,014,103599,Hsueh; Tzu-Chien,9999,0,9999,0
1668281881183,ECE 200,015,103600,Javidi; Tara,9999,0,9999,0
1668281881183,ECE 200,016,103601,Kahng; Andrew Byun,9999,0,9999,0
1668281881183,ECE 200,017,103602,Kim; Young-Han,9999,0,9999,0
1668281881183,ECE 200,018,103603,Koushanfar; Farinaz,9999,0,9999,0
1668281881183,ECE 200,019,103604,Kuzum; Duygu,9999,0,9999,0
1668281881183,ECE 200,020,103605,Le; Hanh-Phuc,9999,0,9999,0
1668281881183,ECE 200,021,103606,Lin; Bill,9999,0,9999,0
1668281881183,ECE 200,022,103607,Liu; Zhaowei,9998,0,9999,1
1668281881183,ECE 200,023,103608,Lo; Yu-Hwa,9999,0,9999,0
1668281881183,ECE 200,024,103609,Lomakin; Vitaliy,9999,0,9999,0
1668281881183,ECE 200,025,103610,Mercier; Patrick Philip,9999,0,9999,0
1668281881183,ECE 200,026,103611,Meyer; Florian,9999,0,9999,0
1668281881183,ECE 200,027,103612,Milstein; Laurence B.,9999,0,9999,0
1668281881183,ECE 200,028,103613,Mir Arabbaygi; Siavash,9999,0,9999,0
1668281881183,ECE 200,029,103614,Mookherjea; Shayan,9999,0,9999,0
1668281881183,ECE 200,030,103615,Morris; Karcher William,9999,0,9999,0
1668281881183,ECE 200,031,103616,Ng; Tse Nga,9999,0,9999,0
1668281881183,ECE 200,032,103617,Nguyen; Truong Quang,9999,0,9999,0
1668281881183,ECE 200,033,103618,Nomura; Kenji,9999,0,9999,0
1668281881183,ECE 200,034,103619,Orlitsky; Alon,9999,0,9999,0
1668281881183,ECE 200,035,103620,Pal; Piya,9999,0,9999,0
1668281881183,ECE 200,036,103621,Papen; George C.,9999,0,9999,0
1668281881183,ECE 200,037,103622,Radic; Stojan,9999,0,9999,0
1668281881183,ECE 200,038,103623,Rao; Bhaskar D.,9999,0,9999,0
1668281881183,ECE 200,039,103624,Rao; Ramesh R,9999,0,9999,0
1668281881183,ECE 200,040,103625,Rebeiz; Gabriel,9999,0,9999,0
1668281881183,ECE 200,041,103626,Sanford; John R,9999,0,9999,0
1668281881183,ECE 200,042,103627,Siegel; Paul H.,9999,0,9999,0
1668281881183,ECE 200,043,103628,Sievenpiper; Daniel F.,9999,0,9999,0
1668281881183,ECE 200,044,103629,Sworder; David D.,9999,0,9999,0
1668281881183,ECE 200,045,103630,Taur; Yuan,9999,0,9999,0
1668281881183,ECE 200,046,103631,Touri; Behrouz,9999,0,9999,0
1668281881183,ECE 200,047,103632,Trivedi; Mohan M.,9999,0,9999,0
1668281881183,ECE 200,048,103633,Vasconcelos; Nuno,9999,0,9999,0
1668281881183,ECE 200,049,103634,Wang; Xiaolong,9999,0,9999,0
1668281881183,ECE 200,050,103635,Xie; Pengtao,9999,0,9999,0
1668281881183,ECE 200,051,103636,Yip; Michael,9999,0,9999,0
1668281881183,ECE 200,052,103637,Zeger; Kenneth A.,999,0,999,0
1668281881183,ECE 200,053,103638,Zhang; Xinyu,9999,0,9999,0
1668281881183,ECE 200,054,103639,Turakhia; Yatish Girish,9999,0,9999,0
1668281881183,ECE 200,055,103640,Kang; Mingu,9999,0,9999,0
1668281881183,ECE 200,056,103641,Shi; Yuanyuan,9999,0,9999,0
1668281881183,ECE 200,057,103642,Wang; Edward Jay,9999,0,9999,0
1668281881183,ECE 200,058,103643,Zheng; Yang,9999,0,9999,0
1668281881611,ECE 202,A00,103644,Kuzum; Duygu,0,0,0,0
1668281882037,ECE 212BN,A00,103646,Ng; Tse Nga,0,0,0,0
1668281882460,ECE 221,A00,111493,Staff,0,0,0,0
1668281882886,ECE 222B,A00,103647,Lomakin; Vitaliy,0,0,0,0
1668281883313,ECE 230B,A00,103648,Taur; Yuan,0,0,0,0
1668281883736,ECE 238B,A00,103649,Garay; Javier,0,0,0,0
1668281884159,ECE 240B,A00,112900,Fainman; Yeshaiahu,0,0,0,0
1668281884591,ECE 247A,A00,103650,Jokerst; Jesse Vincent,0,0,0,0
1668281885022,ECE 247B,A00,103651,Wang; Joseph,0,0,0,0
1668281885445,ECE 250,A00,103652,Siegel; Paul H.,0,0,0,0
1668281885871,ECE 251A,A00,103654,Rao; Bhaskar D.,0,0,0,0
1668281886294,ECE 257B,A00,103655,Bharadia; Dinesh,0,0,0,0
1668281886722,ECE 258A,A00,103656,Milstein; Laurence B.,0,0,0,0
1668281887145,ECE 260B,A00,103658,Kang; Mingu,0,0,0,0
1668281887571,ECE 264A,A00,103659,Galton; Ian A,0,0,0,0
1668281887994,ECE 265A,A00,103661,Gudem; Prasad S.S.,0,0,0,0
1668281888421,ECE 265D,A00,103662,Gudem; Prasad S.S.,0,0,0,0
1668281888948,ECE 268,A00,103663,Koushanfar; Farinaz,0,0,0,0
1668281889374,ECE 269,A01,103665,Pal; Piya,0,0,0,0
1668281889802,ECE 271B,A00,103666,Vasconcelos; Manuela,0,0,0,0
1668281890226,ECE 276A,A00,103667,Atanasov; Nikolay A.,0,0,0,0
1668281890652,ECE 277,A00,103668,An; Cheolhong,0,0,0,0
1668281891075,ECE 279,A00,117947,Hall; Drew A.,0,0,0,0
1668281891927,ECE 283,A00,103670,Hsueh; Tzu-Chien,0,0,0,0
1668281892353,ECE 284,A00,103671,Turakhia; Yatish Girish,0,0,0,0
1668281892776,ECE 285,A00,103672,Zheng; Yang,0,0,0,0
1668281892776,ECE 285,B00,103673,Sworder; David D.,0,0,0,0
1668281893203,ECE 287,A00,103676,Javidi; Tara,0,0,0,0
1668281893628,MATH 200B,A00,098023,Salehi Golsefidy; Alireza,12,0,15,3
1668281894054,MATH 202B,A00,098024,Rhoades; Brendon Patrick,9,0,15,6
1668281894484,MATH 203B,A00,098025,Oprea; Dragos N.,10,0,15,5
1668281894907,MATH 204B,A00,098026,Sorensen; Claus M,13,0,15,2
1668281895330,MATH 208,A00,098027,Izadi; Elham,7,0,10,3
1668281895754,MATH 209,A00,098028,Pollack; Aaron,10,0,10,0
1668281896179,MATH 211A,A00,112919,Rogalski; Daniel,9,0,10,1
1668281896603,MATH 211B,A00,112920,Seward; Brandon M.,9,0,10,1
1668281897025,MATH 218,A00,098029,Li; Bo,10,0,10,0
1668281897454,MATH 220B,A00,098030,Novak; Jonathan I,11,0,15,4
1668281897882,MATH 221A,A00,098031,Ebenfelt; Peter F,13,0,15,2
1668281898307,MATH 231B,A00,098032,Zlatos; Andrej,12,0,15,3
1668281898730,MATH 240B,A00,098033,Ni; Lei,9,0,15,6
1668281899154,MATH 243,A00,098034,Jekel; David Andrew,10,0,10,0
1668281899581,MATH 245A,A00,098035,Nie; Jiawang,0,0,15,16
1668281900012,MATH 248,A00,098036,Bejenaru; Ioan,10,0,10,0
1668281900436,MATH 250B,A00,098037,Spolaor; Luca,14,0,15,1
1668281900860,MATH 258,A00,098038,Ni; Lei,10,0,10,0
1668281901285,MATH 264B,A00,098041,Rhoades; Brendon Patrick,9,0,15,6
1668281901709,MATH 268,A00,098042,Buss; Samuel R,10,0,10,0
1668281902136,MATH 269,A00,098043,Rhoades; Brendon Patrick,10,0,10,0
1668281902562,MATH 270B,A00,098044,Li; Bo,10,0,15,5
1668281902989,MATH 272B,A00,098045,Holst; Michael J,13,0,15,2
1668281903413,MATH 273A,A00,098046,Tian; Xiaochuan,10,0,15,5
1668281903838,MATH 275,A01,098048,Tian; Xiaochuan,6,0,10,4
1668281904262,MATH 278A,A00,098049,Holst; Michael J,8,0,10,2
1668281904687,MATH 278B,A00,098050,Cloninger; Alexander,10,0,10,0
1668281905113,MATH 278C,A00,098051,Nie; Jiawang,7,0,10,3
1668281905540,MATH 280B,A00,098052,Zheng; Tianyi,8,0,15,7
1668281905964,MATH 281B,A00,098053,Bradic; Jelena,1,0,15,14
1668281906387,MATH 282B,A00,098054,Arias-Castro; Ery,0,0,15,15
1668281906812,MATH 285,A00,098055,Fitzsimmons; Patrick J,0,0,15,17
1668281907235,MATH 287B,A00,098056,Arias-Castro; Ery,2,0,15,13
1668281907660,MATH 288,A00,098057,Agarwal; Pooja,9,0,10,1
1668281907660,MATH 288,B00,098058,Zhang; Danna,8,0,10,2
1668281907660,MATH 288,C00,098059,Williams; Ruth J,9,0,10,1
1668281908083,MATH 290B,A00,098060,Roberts; Justin Deritter,13,0,15,2
1668281908506,MATH 292,A00,098061,Belmont; Eva Kinoshita,10,0,10,0
1668281908932,MATH 295,A00,098062,Suk; Andrew Hoon,48,0,50,2
1668281909358,MATH 296,A00,098063,Novak; Jonathan I,20,0,20,0
1668281909782,MATH 297,001,098064,Gamst; Anthony Collins,9997,0,9999,2
1668282408809,COGS 205,A00,101395,Chiba; Andrea,19,0,20,1
1668282409232,COGS 210B,001,101404,Greene; Deanna Jacquelyn,9998,0,9999,1
1668282409232,COGS 210B,002,101417,Xia; Haijun,9999,0,9999,0
1668282409232,COGS 210B,003,101422,Nitz; Douglas A.,9999,0,9999,0
1668282409232,COGS 210B,004,101423,Hollan; James D.,9998,0,9999,1
1668282409232,COGS 210B,005,101424,Deak; Gedeon O.,9998,0,9999,1
1668282409232,COGS 210B,006,101425,Rossano; Federico,9999,0,9999,0
1668282409657,COGS 211B,A00,101427,Coulson; Seana M,9996,0,9999,3
1668282410081,COGS 220,A00,101428,Hollan; James D.,0,0,25,25
1668282410508,COGS 229,A00,101429,Dow; Steven P,18,0,25,7
1668282410937,COGS 230,A00,101430,Klemmer; Scott R,12,0,17,5
1668282411361,COGS 234,A00,101431,Xia; Haijun,1,0,25,24
1668282411788,COGS 260,A00,101432,Kiyonaga; Anastasia,21,0,25,4
1668282411788,COGS 260,B00,101433,Kirsh; David Joel,15,0,25,10
1668282412226,CSE 202,A00,102371,Impagliazzo; Russell,0,0,0,0
1668282412651,CSE 203B,A01,102373,Cheng; Chung Kuan,0,0,0,0
1668282413076,CSE 208,A00,102374,Micciancio; Daniele,0,0,0,0
1668282413514,CSE 209A,A00,112895,Impagliazzo; Russell,0,0,15,15
1668282413938,CSE 209B,A00,108005,Bellare; Mihir,0,0,0,0
1668282414366,CSE 210,A00,113163,Coblenz; Michael J,0,0,0,0
1668282414792,CSE 219,A00,106111,Dow; Steven P,0,0,20,20
1668282415216,CSE 221,A00,102376,Voelker; Geoffrey M.,0,0,0,0
1668282415640,CSE 224,A01,102378,Porter; George M,0,0,0,0
1668282416062,CSE 229A,A00,102379,Savage; Stefan,0,0,0,0
1668282416492,CSE 229C,A00,102380,Munyaka; Imani N. S.,0,0,0,0
1668282416915,CSE 232B,A00,102382,Deutsch; Alin Bernard,0,0,0,0
1668282417339,CSE 234,A01,112904,Kumar; Arun Kumar,0,0,0,0
1668282417766,CSE 237A,A00,102383,Rosing; Tajana Simunic,0,0,0,0
1668282418193,CSE 239A,A00,102384,Deutsch; Alin Bernard,0,0,0,0
1668282418616,CSE 239B,A00,102385,Polikarpova; Nadezhda,0,0,0,0
1668282419044,CSE 240A,A00,102386,Pannuto; Patrick William,0,0,0,0
1668282419467,CSE 240B,A00,102387,Zhao; Jishen,0,0,0,0
1668282419892,CSE 241A,A00,106406,Kang; Mingu,0,0,0,0
1668282420329,CSE 249B,A00,102388,Kahng; Andrew Byun,0,0,8,8
1668282420753,CSE 251B,A01,102392,Cottrell; Garrison W,0,0,0,0
1668282420753,CSE 251B,A02,102393,Cottrell; Garrison W,0,0,0,0
1668282421179,CSE 252B,A00,102394,Ochoa; Benjamin Lawrence,0,0,0,0
1668282421603,CSE 257,A01,102396,Gao; Sicun,0,0,0,0
1668282422034,CSE 272,A00,102397,Li; Tzumao,0,0,0,0
1668282422461,CSE 274,A00,111323,Chern; Albert Ren-Haur,0,0,0,0
1668282422887,CSE 282,A00,102398,Pevzner; Pavel Arkadjevich,0,0,0,0
1668282423313,CSE 284,A00,114175,Gymrek; Melissa Ann,0,0,0,0
1668282423738,CSE 290,A00,102399,Chandraker; Manmohan Krishna,0,0,0,0
1668282423738,CSE 290,B00,102400,Vaccaro; Kristen Marie,0,0,25,25
1668282423738,CSE 290,C00,102414,Pannuto; Patrick William,0,0,25,25
1668282423738,CSE 290,D00,102427,Pevzner; Pavel Arkadjevich,0,0,0,0
1668282423738,CSE 290,E00,102429,Zhao; Jishen,0,0,0,0
1668282423738,CSE 290,F00,102436,Tullsen; Dean Michael,0,0,0,0
1668282423738,CSE 290,G00,102440,Christensen; Henrik I,0,0,20,20
1668282424163,CSE 291,A00,102443,Su; Hao,0,0,0,0
1668282424163,CSE 291,B00,102448,Polikarpova; Nadezhda,0,0,0,0
1668282424163,CSE 291,C00,102453,Vaccaro; Kristen Marie,0,0,0,0
1668282424163,CSE 291,D00,111343,Savage; Stefan,0,0,0,0
1668282424163,CSE 291,E00,116474,Claffy; Kimberly Claire,0,0,0,0
1668282424163,CSE 291,F00,116479,Pasquale; Joseph,0,0,0,0
1668282424591,CSE 293,001,119111,Bafna; Vineet,9999,0,9999,0
1668282424591,CSE 293,002,119118,Bellare; Mihir,9999,0,9999,0
1668282424591,CSE 293,003,119122,Berg-Kirkpatrick; Taylor D,9999,0,9999,0
1668282424591,CSE 293,004,119135,Christensen; Henrik I,9999,0,9999,0
1668282424591,CSE 293,005,119142,Cottrell; Garrison W,9999,0,9999,0
1668282424591,CSE 293,006,119146,Deutsch; Alin Bernard,9999,0,9999,0
1668282424591,CSE 293,007,119159,Esmaeilzadeh; Hadi,9999,0,9999,0
1668282424591,CSE 293,008,119166,Freund; Yoav,9999,0,9999,0
1668282424591,CSE 293,009,119170,Griswold; William G.,9999,0,9999,0
1668282424591,CSE 293,010,119183,Gymrek; Melissa Ann,9999,0,9999,0
1668282424591,CSE 293,011,119190,Heninger; Nadia A,9999,0,9999,0
1668282424591,CSE 293,012,119230,Impagliazzo; Russell,9999,0,9999,0
1668282424591,CSE 293,013,119232,Jhala; Ranjit,9999,0,9999,0
1668282424591,CSE 293,014,119233,Kahng; Andrew Byun,9999,0,9999,0
1668282424591,CSE 293,015,119298,Kane; Daniel Mertz,9999,0,9999,0
1668282424591,CSE 293,016,119299,Kriegman; David J,9999,0,9999,0
1668282424591,CSE 293,017,119300,Kumar; Arun Kumar,9999,0,9999,0
1668282424591,CSE 293,018,119301,Lerner; Sorin,9999,0,9999,0
1668282424591,CSE 293,019,119302,Lovett; Shachar,9999,0,9999,0
1668282424591,CSE 293,020,119303,McAuley; Julian John,9999,0,9999,0
1668282424591,CSE 293,021,119304,Micciancio; Daniele,9999,0,9999,0
1668282424591,CSE 293,022,119367,Orailoglu; Alex,9999,0,9999,0
1668282424591,CSE 293,023,119382,Paturi; Ramamohan,9999,0,9999,0
1668282424591,CSE 293,024,119404,Polikarpova; Nadezhda,9999,0,9999,0
1668282424591,CSE 293,025,119406,Politz; Joseph Gibbs,9999,0,9999,0
1668282424591,CSE 293,026,119411,Porter; George M,9999,0,9999,0
1668282424591,CSE 293,027,119414,Porter; Leonard Emerson,9999,0,9999,0
1668282424591,CSE 293,028,119416,Ramamoorthi; Ravi,9999,0,9999,0
1668282424591,CSE 293,029,119417,Sahoo; Debashis,9999,0,9999,0
1668282424591,CSE 293,030,119420,Saul; Lawrence,9999,0,9999,0
1668282424591,CSE 293,031,119421,Savage; Stefan,9999,0,9999,0
1668282424591,CSE 293,032,119425,Schulze; Jurgen P.,9999,0,9999,0
1668282424591,CSE 293,033,119426,Snoeren; Alex C.,9999,0,9999,0
1668282424591,CSE 293,034,119428,Shang; Jingbo,9999,0,9999,0
1668282424591,CSE 293,035,119430,Stefan; Deian,9999,0,9999,0
1668282424591,CSE 293,036,119431,Su; Hao,9999,0,9999,0
1668282424591,CSE 293,037,119433,Swanson; Steven James,9999,0,9999,0
1668282424591,CSE 293,038,119435,Tullsen; Dean Michael,9999,0,9999,0
1668282424591,CSE 293,039,119483,Voelker; Geoffrey M.,9999,0,9999,0
1668282424591,CSE 293,040,119537,Zhao; Jishen,9999,0,9999,0
1668282424591,CSE 293,041,119538,Zhou; Yuan-Yuan,9999,0,9999,0
1668282424591,CSE 293,042,119539,Gao; Sicun,9999,0,9999,0
1668282424591,CSE 293,043,119540,Weibel; Nadir,9999,0,9999,0
1668282424591,CSE 293,044,119541,Gupta; Rajesh K.,9999,0,9999,0
1668282424591,CSE 293,045,126410,Vaccaro; Kristen Marie,9999,0,9999,0
1668282424591,CSE 293,046,126411,Klemke; Richard,9999,0,9999,0
1668282425022,CSE 294,A00,102459,Voelker; Geoffrey M.,0,0,0,0
1668282425022,CSE 294,B00,111322,Orailoglu; Alex,0,0,0,0
1668282425445,DSE 201,A00,096914,Deutsch; Alin Bernard,30,0,30,0
1668282425869,DSE 210,A00,096915,Dasgupta; Sanjoy,30,0,30,0
1668282426295,DSE 260A,A00,096916,Altintas De Callaf; Ilkay,30,0,30,0
1668282426725,ECE 200,001,103586,Antipa; Nicholas A,9999,0,9999,0
1668282426725,ECE 200,002,103587,Atanasov; Nikolay A.,9999,0,9999,0
1668282426725,ECE 200,003,103588,Bharadia; Dinesh,9999,0,9999,0
1668282426725,ECE 200,004,103589,Cheng; Chung Kuan,9999,0,9999,0
1668282426725,ECE 200,005,103590,Cosman; Pamela C.,9999,0,9999,0
1668282426725,ECE 200,006,103591,Dayeh; Shadi Ahmad,9999,0,9999,0
1668282426725,ECE 200,007,103592,Fainman; Yeshaiahu,9999,0,9999,0
1668282426725,ECE 200,008,103593,Ford; Joseph Earl,9999,0,9999,0
1668282426725,ECE 200,009,103594,Franceschetti; Massimo,9999,0,9999,0
1668282426725,ECE 200,010,103595,Fullerton; Eric E,9999,0,9999,0
1668282426725,ECE 200,011,103596,Galton; Ian A,9999,0,9999,0
1668282426725,ECE 200,012,103597,Gilja; Vikash,9999,0,9999,0
1668282426725,ECE 200,013,103598,Hall; Drew A.,9999,0,9999,0
1668282426725,ECE 200,014,103599,Hsueh; Tzu-Chien,9999,0,9999,0
1668282426725,ECE 200,015,103600,Javidi; Tara,9999,0,9999,0
1668282426725,ECE 200,016,103601,Kahng; Andrew Byun,9999,0,9999,0
1668282426725,ECE 200,017,103602,Kim; Young-Han,9999,0,9999,0
1668282426725,ECE 200,018,103603,Koushanfar; Farinaz,9999,0,9999,0
1668282426725,ECE 200,019,103604,Kuzum; Duygu,9999,0,9999,0
1668282426725,ECE 200,020,103605,Le; Hanh-Phuc,9999,0,9999,0
1668282426725,ECE 200,021,103606,Lin; Bill,9999,0,9999,0
1668282426725,ECE 200,022,103607,Liu; Zhaowei,9998,0,9999,1
1668282426725,ECE 200,023,103608,Lo; Yu-Hwa,9999,0,9999,0
1668282426725,ECE 200,024,103609,Lomakin; Vitaliy,9999,0,9999,0
1668282426725,ECE 200,025,103610,Mercier; Patrick Philip,9999,0,9999,0
1668282426725,ECE 200,026,103611,Meyer; Florian,9999,0,9999,0
1668282426725,ECE 200,027,103612,Milstein; Laurence B.,9999,0,9999,0
1668282426725,ECE 200,028,103613,Mir Arabbaygi; Siavash,9999,0,9999,0
1668282426725,ECE 200,029,103614,Mookherjea; Shayan,9999,0,9999,0
1668282426725,ECE 200,030,103615,Morris; Karcher William,9999,0,9999,0
1668282426725,ECE 200,031,103616,Ng; Tse Nga,9999,0,9999,0
1668282426725,ECE 200,032,103617,Nguyen; Truong Quang,9999,0,9999,0
1668282426725,ECE 200,033,103618,Nomura; Kenji,9999,0,9999,0
1668282426725,ECE 200,034,103619,Orlitsky; Alon,9999,0,9999,0
1668282426725,ECE 200,035,103620,Pal; Piya,9999,0,9999,0
1668282426725,ECE 200,036,103621,Papen; George C.,9999,0,9999,0
1668282426725,ECE 200,037,103622,Radic; Stojan,9999,0,9999,0
1668282426725,ECE 200,038,103623,Rao; Bhaskar D.,9999,0,9999,0
1668282426725,ECE 200,039,103624,Rao; Ramesh R,9999,0,9999,0
1668282426725,ECE 200,040,103625,Rebeiz; Gabriel,9999,0,9999,0
1668282426725,ECE 200,041,103626,Sanford; John R,9999,0,9999,0
1668282426725,ECE 200,042,103627,Siegel; Paul H.,9999,0,9999,0
1668282426725,ECE 200,043,103628,Sievenpiper; Daniel F.,9999,0,9999,0
1668282426725,ECE 200,044,103629,Sworder; David D.,9999,0,9999,0
1668282426725,ECE 200,045,103630,Taur; Yuan,9999,0,9999,0
1668282426725,ECE 200,046,103631,Touri; Behrouz,9999,0,9999,0
1668282426725,ECE 200,047,103632,Trivedi; Mohan M.,9999,0,9999,0
1668282426725,ECE 200,048,103633,Vasconcelos; Nuno,9999,0,9999,0
1668282426725,ECE 200,049,103634,Wang; Xiaolong,9999,0,9999,0
1668282426725,ECE 200,050,103635,Xie; Pengtao,9999,0,9999,0
1668282426725,ECE 200,051,103636,Yip; Michael,9999,0,9999,0
1668282426725,ECE 200,052,103637,Zeger; Kenneth A.,999,0,999,0
1668282426725,ECE 200,053,103638,Zhang; Xinyu,9999,0,9999,0
1668282426725,ECE 200,054,103639,Turakhia; Yatish Girish,9999,0,9999,0
1668282426725,ECE 200,055,103640,Kang; Mingu,9999,0,9999,0
1668282426725,ECE 200,056,103641,Shi; Yuanyuan,9999,0,9999,0
1668282426725,ECE 200,057,103642,Wang; Edward Jay,9999,0,9999,0
1668282426725,ECE 200,058,103643,Zheng; Yang,9999,0,9999,0
1668282427149,ECE 202,A00,103644,Kuzum; Duygu,0,0,0,0
1668282427576,ECE 212BN,A00,103646,Ng; Tse Nga,0,0,0,0
1668282428002,ECE 221,A00,111493,Staff,0,0,0,0
1668282428425,ECE 222B,A00,103647,Lomakin; Vitaliy,0,0,0,0
1668282428852,ECE 230B,A00,103648,Taur; Yuan,0,0,0,0
1668282429275,ECE 238B,A00,103649,Garay; Javier,0,0,0,0
1668282429703,ECE 240B,A00,112900,Fainman; Yeshaiahu,0,0,0,0
1668282430127,ECE 247A,A00,103650,Jokerst; Jesse Vincent,0,0,0,0
1668282430550,ECE 247B,A00,103651,Wang; Joseph,0,0,0,0
1668282430974,ECE 250,A00,103652,Siegel; Paul H.,0,0,0,0
1668282431400,ECE 251A,A00,103654,Rao; Bhaskar D.,0,0,0,0
1668282431823,ECE 257B,A00,103655,Bharadia; Dinesh,0,0,0,0
1668282432247,ECE 258A,A00,103656,Milstein; Laurence B.,0,0,0,0
1668282432677,ECE 260B,A00,103658,Kang; Mingu,0,0,0,0
1668282433111,ECE 264A,A00,103659,Galton; Ian A,0,0,0,0
1668282433534,ECE 265A,A00,103661,Gudem; Prasad S.S.,0,0,0,0
1668282433963,ECE 265D,A00,103662,Gudem; Prasad S.S.,0,0,0,0
1668282434388,ECE 268,A00,103663,Koushanfar; Farinaz,0,0,0,0
1668282434813,ECE 269,A01,103665,Pal; Piya,0,0,0,0
1668282435237,ECE 271B,A00,103666,Vasconcelos; Manuela,0,0,0,0
1668282435662,ECE 276A,A00,103667,Atanasov; Nikolay A.,0,0,0,0
1668282436085,ECE 277,A00,103668,An; Cheolhong,0,0,0,0
1668282436513,ECE 279,A00,117947,Hall; Drew A.,0,0,0,0
1668282437361,ECE 283,A00,103670,Hsueh; Tzu-Chien,0,0,0,0
1668282437786,ECE 284,A00,103671,Turakhia; Yatish Girish,0,0,0,0
1668282438213,ECE 285,A00,103672,Zheng; Yang,0,0,0,0
1668282438213,ECE 285,B00,103673,Sworder; David D.,0,0,0,0
1668282438641,ECE 287,A00,103676,Javidi; Tara,0,0,0,0
1668282439068,MATH 200B,A00,098023,Salehi Golsefidy; Alireza,12,0,15,3
1668282439491,MATH 202B,A00,098024,Rhoades; Brendon Patrick,9,0,15,6
1668282439923,MATH 203B,A00,098025,Oprea; Dragos N.,10,0,15,5
1668282440345,MATH 204B,A00,098026,Sorensen; Claus M,13,0,15,2
1668282440773,MATH 208,A00,098027,Izadi; Elham,7,0,10,3
1668282441195,MATH 209,A00,098028,Pollack; Aaron,10,0,10,0
1668282441621,MATH 211A,A00,112919,Rogalski; Daniel,9,0,10,1
1668282442042,MATH 211B,A00,112920,Seward; Brandon M.,9,0,10,1
1668282442469,MATH 218,A00,098029,Li; Bo,10,0,10,0
1668282442892,MATH 220B,A00,098030,Novak; Jonathan I,11,0,15,4
1668282443315,MATH 221A,A00,098031,Ebenfelt; Peter F,13,0,15,2
1668282443738,MATH 231B,A00,098032,Zlatos; Andrej,12,0,15,3
1668282444166,MATH 240B,A00,098033,Ni; Lei,9,0,15,6
1668282444589,MATH 243,A00,098034,Jekel; David Andrew,10,0,10,0
1668282445013,MATH 245A,A00,098035,Nie; Jiawang,0,0,15,16
1668282445442,MATH 248,A00,098036,Bejenaru; Ioan,10,0,10,0
1668282445866,MATH 250B,A00,098037,Spolaor; Luca,14,0,15,1
1668282446298,MATH 258,A00,098038,Ni; Lei,10,0,10,0
1668282446723,MATH 264B,A00,098041,Rhoades; Brendon Patrick,9,0,15,6
1668282447148,MATH 268,A00,098042,Buss; Samuel R,10,0,10,0
1668282447571,MATH 269,A00,098043,Rhoades; Brendon Patrick,10,0,10,0
1668282447994,MATH 270B,A00,098044,Li; Bo,10,0,15,5
1668282448422,MATH 272B,A00,098045,Holst; Michael J,13,0,15,2
1668282448852,MATH 273A,A00,098046,Tian; Xiaochuan,10,0,15,5
1668282449274,MATH 275,A01,098048,Tian; Xiaochuan,6,0,10,4
1668282449699,MATH 278A,A00,098049,Holst; Michael J,8,0,10,2
1668282450124,MATH 278B,A00,098050,Cloninger; Alexander,10,0,10,0
1668282450548,MATH 278C,A00,098051,Nie; Jiawang,7,0,10,3
1668282451045,MATH 280B,A00,098052,Zheng; Tianyi,8,0,15,7
1668282451471,MATH 281B,A00,098053,Bradic; Jelena,1,0,15,14
1668282451900,MATH 282B,A00,098054,Arias-Castro; Ery,0,0,15,15
1668282452323,MATH 285,A00,098055,Fitzsimmons; Patrick J,0,0,15,17
1668282452748,MATH 287B,A00,098056,Arias-Castro; Ery,2,0,15,13
1668282453172,MATH 288,A00,098057,Agarwal; Pooja,9,0,10,1
1668282453172,MATH 288,B00,098058,Zhang; Danna,8,0,10,2
1668282453172,MATH 288,C00,098059,Williams; Ruth J,9,0,10,1
1668282453595,MATH 290B,A00,098060,Roberts; Justin Deritter,13,0,15,2
1668282454018,MATH 292,A00,098061,Belmont; Eva Kinoshita,10,0,10,0
1668282454443,MATH 295,A00,098062,Suk; Andrew Hoon,48,0,50,2
1668282454869,MATH 296,A00,098063,Novak; Jonathan I,20,0,20,0
1668282455294,MATH 297,001,098064,Gamst; Anthony Collins,9997,0,9999,2
1668282964256,COGS 205,A00,101395,Chiba; Andrea,19,0,20,1
1668282964683,COGS 210B,001,101404,Greene; Deanna Jacquelyn,9998,0,9999,1
1668282964683,COGS 210B,002,101417,Xia; Haijun,9999,0,9999,0
1668282964683,COGS 210B,003,101422,Nitz; Douglas A.,9999,0,9999,0
1668282964683,COGS 210B,004,101423,Hollan; James D.,9998,0,9999,1
1668282964683,COGS 210B,005,101424,Deak; Gedeon O.,9998,0,9999,1
1668282964683,COGS 210B,006,101425,Rossano; Federico,9999,0,9999,0
1668282965107,COGS 211B,A00,101427,Coulson; Seana M,9996,0,9999,3
1668282965547,COGS 220,A00,101428,Hollan; James D.,0,0,25,25
1668282965973,COGS 229,A00,101429,Dow; Steven P,18,0,25,7
1668282966403,COGS 230,A00,101430,Klemmer; Scott R,12,0,17,5
1668282966828,COGS 234,A00,101431,Xia; Haijun,1,0,25,24
1668282967252,COGS 260,A00,101432,Kiyonaga; Anastasia,21,0,25,4
1668282967252,COGS 260,B00,101433,Kirsh; David Joel,15,0,25,10
1668282967675,CSE 202,A00,102371,Impagliazzo; Russell,0,0,0,0
1668282968097,CSE 203B,A01,102373,Cheng; Chung Kuan,0,0,0,0
1668282968521,CSE 208,A00,102374,Micciancio; Daniele,0,0,0,0
1668282968944,CSE 209A,A00,112895,Impagliazzo; Russell,0,0,15,15
1668282969366,CSE 209B,A00,108005,Bellare; Mihir,0,0,0,0
1668282969793,CSE 210,A00,113163,Coblenz; Michael J,0,0,0,0
1668282970218,CSE 219,A00,106111,Dow; Steven P,0,0,20,20
1668282970642,CSE 221,A00,102376,Voelker; Geoffrey M.,0,0,0,0
1668282971067,CSE 224,A01,102378,Porter; George M,0,0,0,0
1668282971490,CSE 229A,A00,102379,Savage; Stefan,0,0,0,0
1668282971915,CSE 229C,A00,102380,Munyaka; Imani N. S.,0,0,0,0
1668282972338,CSE 232B,A00,102382,Deutsch; Alin Bernard,0,0,0,0
1668282972765,CSE 234,A01,112904,Kumar; Arun Kumar,0,0,0,0
1668282973188,CSE 237A,A00,102383,Rosing; Tajana Simunic,0,0,0,0
1668282973610,CSE 239A,A00,102384,Deutsch; Alin Bernard,0,0,0,0
1668282974036,CSE 239B,A00,102385,Polikarpova; Nadezhda,0,0,0,0
1668282974461,CSE 240A,A00,102386,Pannuto; Patrick William,0,0,0,0
1668282974885,CSE 240B,A00,102387,Zhao; Jishen,0,0,0,0
1668282975307,CSE 241A,A00,106406,Kang; Mingu,0,0,0,0
1668282975730,CSE 249B,A00,102388,Kahng; Andrew Byun,0,0,8,8
1668282976158,CSE 251B,A01,102392,Cottrell; Garrison W,0,0,0,0
1668282976158,CSE 251B,A02,102393,Cottrell; Garrison W,0,0,0,0
1668282976583,CSE 252B,A00,102394,Ochoa; Benjamin Lawrence,0,0,0,0
1668282977010,CSE 257,A01,102396,Gao; Sicun,0,0,0,0
1668282977435,CSE 272,A00,102397,Li; Tzumao,0,0,0,0
1668282977857,CSE 274,A00,111323,Chern; Albert Ren-Haur,0,0,0,0
1668282978280,CSE 282,A00,102398,Pevzner; Pavel Arkadjevich,0,0,0,0
1668282978702,CSE 284,A00,114175,Gymrek; Melissa Ann,0,0,0,0
1668282979125,CSE 290,A00,102399,Chandraker; Manmohan Krishna,0,0,0,0
1668282979125,CSE 290,B00,102400,Vaccaro; Kristen Marie,0,0,25,25
1668282979125,CSE 290,C00,102414,Pannuto; Patrick William,0,0,25,25
1668282979125,CSE 290,D00,102427,Pevzner; Pavel Arkadjevich,0,0,0,0
1668282979125,CSE 290,E00,102429,Zhao; Jishen,0,0,0,0
1668282979125,CSE 290,F00,102436,Tullsen; Dean Michael,0,0,0,0
1668282979125,CSE 290,G00,102440,Christensen; Henrik I,0,0,20,20
1668282979549,CSE 291,A00,102443,Su; Hao,0,0,0,0
1668282979549,CSE 291,B00,102448,Polikarpova; Nadezhda,0,0,0,0
1668282979549,CSE 291,C00,102453,Vaccaro; Kristen Marie,0,0,0,0
1668282979549,CSE 291,D00,111343,Savage; Stefan,0,0,0,0
1668282979549,CSE 291,E00,116474,Claffy; Kimberly Claire,0,0,0,0
1668282979549,CSE 291,F00,116479,Pasquale; Joseph,0,0,0,0
1668282980074,CSE 293,001,119111,Bafna; Vineet,9999,0,9999,0
1668282980074,CSE 293,002,119118,Bellare; Mihir,9999,0,9999,0
1668282980074,CSE 293,003,119122,Berg-Kirkpatrick; Taylor D,9999,0,9999,0
1668282980074,CSE 293,004,119135,Christensen; Henrik I,9999,0,9999,0
1668282980074,CSE 293,005,119142,Cottrell; Garrison W,9999,0,9999,0
1668282980074,CSE 293,006,119146,Deutsch; Alin Bernard,9999,0,9999,0
1668282980074,CSE 293,007,119159,Esmaeilzadeh; Hadi,9999,0,9999,0
1668282980074,CSE 293,008,119166,Freund; Yoav,9999,0,9999,0
1668282980074,CSE 293,009,119170,Griswold; William G.,9999,0,9999,0
1668282980074,CSE 293,010,119183,Gymrek; Melissa Ann,9999,0,9999,0
1668282980074,CSE 293,011,119190,Heninger; Nadia A,9999,0,9999,0
1668282980074,CSE 293,012,119230,Impagliazzo; Russell,9999,0,9999,0
1668282980074,CSE 293,013,119232,Jhala; Ranjit,9999,0,9999,0
1668282980074,CSE 293,014,119233,Kahng; Andrew Byun,9999,0,9999,0
1668282980074,CSE 293,015,119298,Kane; Daniel Mertz,9999,0,9999,0
1668282980074,CSE 293,016,119299,Kriegman; David J,9999,0,9999,0
1668282980074,CSE 293,017,119300,Kumar; Arun Kumar,9999,0,9999,0
1668282980074,CSE 293,018,119301,Lerner; Sorin,9999,0,9999,0
1668282980074,CSE 293,019,119302,Lovett; Shachar,9999,0,9999,0
1668282980074,CSE 293,020,119303,McAuley; Julian John,9999,0,9999,0
1668282980074,CSE 293,021,119304,Micciancio; Daniele,9999,0,9999,0
1668282980074,CSE 293,022,119367,Orailoglu; Alex,9999,0,9999,0
1668282980074,CSE 293,023,119382,Paturi; Ramamohan,9999,0,9999,0
1668282980074,CSE 293,024,119404,Polikarpova; Nadezhda,9999,0,9999,0
1668282980074,CSE 293,025,119406,Politz; Joseph Gibbs,9999,0,9999,0
1668282980074,CSE 293,026,119411,Porter; George M,9999,0,9999,0
1668282980074,CSE 293,027,119414,Porter; Leonard Emerson,9999,0,9999,0
1668282980074,CSE 293,028,119416,Ramamoorthi; Ravi,9999,0,9999,0
1668282980074,CSE 293,029,119417,Sahoo; Debashis,9999,0,9999,0
1668282980074,CSE 293,030,119420,Saul; Lawrence,9999,0,9999,0
1668282980074,CSE 293,031,119421,Savage; Stefan,9999,0,9999,0
1668282980074,CSE 293,032,119425,Schulze; Jurgen P.,9999,0,9999,0
1668282980074,CSE 293,033,119426,Snoeren; Alex C.,9999,0,9999,0
1668282980074,CSE 293,034,119428,Shang; Jingbo,9999,0,9999,0
1668282980074,CSE 293,035,119430,Stefan; Deian,9999,0,9999,0
1668282980074,CSE 293,036,119431,Su; Hao,9999,0,9999,0
1668282980074,CSE 293,037,119433,Swanson; Steven James,9999,0,9999,0
1668282980074,CSE 293,038,119435,Tullsen; Dean Michael,9999,0,9999,0
1668282980074,CSE 293,039,119483,Voelker; Geoffrey M.,9999,0,9999,0
1668282980074,CSE 293,040,119537,Zhao; Jishen,9999,0,9999,0
1668282980074,CSE 293,041,119538,Zhou; Yuan-Yuan,9999,0,9999,0
1668282980074,CSE 293,042,119539,Gao; Sicun,9999,0,9999,0
1668282980074,CSE 293,043,119540,Weibel; Nadir,9999,0,9999,0
1668282980074,CSE 293,044,119541,Gupta; Rajesh K.,9999,0,9999,0
1668282980074,CSE 293,045,126410,Vaccaro; Kristen Marie,9999,0,9999,0
1668282980074,CSE 293,046,126411,Klemke; Richard,9999,0,9999,0
1668282980497,CSE 294,A00,102459,Voelker; Geoffrey M.,0,0,0,0
1668282980497,CSE 294,B00,111322,Orailoglu; Alex,0,0,0,0
1668282980920,DSE 201,A00,096914,Deutsch; Alin Bernard,30,0,30,0
1668282981346,DSE 210,A00,096915,Dasgupta; Sanjoy,30,0,30,0
1668282981772,DSE 260A,A00,096916,Altintas De Callaf; Ilkay,30,0,30,0
1668282982197,ECE 200,001,103586,Antipa; Nicholas A,9999,0,9999,0
1668282982197,ECE 200,002,103587,Atanasov; Nikolay A.,9999,0,9999,0
1668282982197,ECE 200,003,103588,Bharadia; Dinesh,9999,0,9999,0
1668282982197,ECE 200,004,103589,Cheng; Chung Kuan,9999,0,9999,0
1668282982197,ECE 200,005,103590,Cosman; Pamela C.,9999,0,9999,0
1668282982197,ECE 200,006,103591,Dayeh; Shadi Ahmad,9999,0,9999,0
1668282982197,ECE 200,007,103592,Fainman; Yeshaiahu,9999,0,9999,0
1668282982197,ECE 200,008,103593,Ford; Joseph Earl,9999,0,9999,0
1668282982197,ECE 200,009,103594,Franceschetti; Massimo,9999,0,9999,0
1668282982197,ECE 200,010,103595,Fullerton; Eric E,9999,0,9999,0
1668282982197,ECE 200,011,103596,Galton; Ian A,9999,0,9999,0
1668282982197,ECE 200,012,103597,Gilja; Vikash,9999,0,9999,0
1668282982197,ECE 200,013,103598,Hall; Drew A.,9999,0,9999,0
1668282982197,ECE 200,014,103599,Hsueh; Tzu-Chien,9999,0,9999,0
1668282982197,ECE 200,015,103600,Javidi; Tara,9999,0,9999,0
1668282982197,ECE 200,016,103601,Kahng; Andrew Byun,9999,0,9999,0
1668282982197,ECE 200,017,103602,Kim; Young-Han,9999,0,9999,0
1668282982197,ECE 200,018,103603,Koushanfar; Farinaz,9999,0,9999,0
1668282982197,ECE 200,019,103604,Kuzum; Duygu,9999,0,9999,0
1668282982197,ECE 200,020,103605,Le; Hanh-Phuc,9999,0,9999,0
1668282982197,ECE 200,021,103606,Lin; Bill,9999,0,9999,0
1668282982197,ECE 200,022,103607,Liu; Zhaowei,9998,0,9999,1
1668282982197,ECE 200,023,103608,Lo; Yu-Hwa,9999,0,9999,0
1668282982197,ECE 200,024,103609,Lomakin; Vitaliy,9999,0,9999,0
1668282982197,ECE 200,025,103610,Mercier; Patrick Philip,9999,0,9999,0
1668282982197,ECE 200,026,103611,Meyer; Florian,9999,0,9999,0
1668282982197,ECE 200,027,103612,Milstein; Laurence B.,9999,0,9999,0
1668282982197,ECE 200,028,103613,Mir Arabbaygi; Siavash,9999,0,9999,0
1668282982197,ECE 200,029,103614,Mookherjea; Shayan,9999,0,9999,0
1668282982197,ECE 200,030,103615,Morris; Karcher William,9999,0,9999,0
1668282982197,ECE 200,031,103616,Ng; Tse Nga,9999,0,9999,0
1668282982197,ECE 200,032,103617,Nguyen; Truong Quang,9999,0,9999,0
1668282982197,ECE 200,033,103618,Nomura; Kenji,9999,0,9999,0
1668282982197,ECE 200,034,103619,Orlitsky; Alon,9999,0,9999,0
1668282982197,ECE 200,035,103620,Pal; Piya,9999,0,9999,0
1668282982197,ECE 200,036,103621,Papen; George C.,9999,0,9999,0
1668282982197,ECE 200,037,103622,Radic; Stojan,9999,0,9999,0
1668282982197,ECE 200,038,103623,Rao; Bhaskar D.,9999,0,9999,0
1668282982197,ECE 200,039,103624,Rao; Ramesh R,9999,0,9999,0
1668282982197,ECE 200,040,103625,Rebeiz; Gabriel,9999,0,9999,0
1668282982197,ECE 200,041,103626,Sanford; John R,9999,0,9999,0
1668282982197,ECE 200,042,103627,Siegel; Paul H.,9999,0,9999,0
1668282982197,ECE 200,043,103628,Sievenpiper; Daniel F.,9999,0,9999,0
1668282982197,ECE 200,044,103629,Sworder; David D.,9999,0,9999,0
1668282982197,ECE 200,045,103630,Taur; Yuan,9999,0,9999,0
1668282982197,ECE 200,046,103631,Touri; Behrouz,9999,0,9999,0
1668282982197,ECE 200,047,103632,Trivedi; Mohan M.,9999,0,9999,0
1668282982197,ECE 200,048,103633,Vasconcelos; Nuno,9999,0,9999,0
1668282982197,ECE 200,049,103634,Wang; Xiaolong,9999,0,9999,0
1668282982197,ECE 200,050,103635,Xie; Pengtao,9999,0,9999,0
1668282982197,ECE 200,051,103636,Yip; Michael,9999,0,9999,0
1668282982197,ECE 200,052,103637,Zeger; Kenneth A.,999,0,999,0
1668282982197,ECE 200,053,103638,Zhang; Xinyu,9999,0,9999,0
1668282982197,ECE 200,054,103639,Turakhia; Yatish Girish,9999,0,9999,0
1668282982197,ECE 200,055,103640,Kang; Mingu,9999,0,9999,0
1668282982197,ECE 200,056,103641,Shi; Yuanyuan,9999,0,9999,0
1668282982197,ECE 200,057,103642,Wang; Edward Jay,9999,0,9999,0
1668282982197,ECE 200,058,103643,Zheng; Yang,9999,0,9999,0
1668282982626,ECE 202,A00,103644,Kuzum; Duygu,0,0,0,0
1668282983050,ECE 212BN,A00,103646,Ng; Tse Nga,0,0,0,0
1668282983476,ECE 221,A00,111493,Staff,0,0,0,0
1668282983902,ECE 222B,A00,103647,Lomakin; Vitaliy,0,0,0,0
1668282984324,ECE 230B,A00,103648,Taur; Yuan,0,0,0,0
1668282984749,ECE 238B,A00,103649,Garay; Javier,0,0,0,0
1668282985173,ECE 240B,A00,112900,Fainman; Yeshaiahu,0,0,0,0
1668282985599,ECE 247A,A00,103650,Jokerst; Jesse Vincent,0,0,0,0
1668282986025,ECE 247B,A00,103651,Wang; Joseph,0,0,0,0
1668282986449,ECE 250,A00,103652,Siegel; Paul H.,0,0,0,0
1668282986877,ECE 251A,A00,103654,Rao; Bhaskar D.,0,0,0,0
1668282987300,ECE 257B,A00,103655,Bharadia; Dinesh,0,0,0,0
1668282987722,ECE 258A,A00,103656,Milstein; Laurence B.,0,0,0,0
1668282988147,ECE 260B,A00,103658,Kang; Mingu,0,0,0,0
1668282988572,ECE 264A,A00,103659,Galton; Ian A,0,0,0,0
1668282988998,ECE 265A,A00,103661,Gudem; Prasad S.S.,0,0,0,0
1668282989425,ECE 265D,A00,103662,Gudem; Prasad S.S.,0,0,0,0
1668282989851,ECE 268,A00,103663,Koushanfar; Farinaz,0,0,0,0
1668282990277,ECE 269,A01,103665,Pal; Piya,0,0,0,0
1668282990701,ECE 271B,A00,103666,Vasconcelos; Manuela,0,0,0,0
1668282991126,ECE 276A,A00,103667,Atanasov; Nikolay A.,0,0,0,0
1668282991552,ECE 277,A00,103668,An; Cheolhong,0,0,0,0
1668282991975,ECE 279,A00,117947,Hall; Drew A.,0,0,0,0
1668282992822,ECE 283,A00,103670,Hsueh; Tzu-Chien,0,0,0,0
1668282993245,ECE 284,A00,103671,Turakhia; Yatish Girish,0,0,0,0
1668282993668,ECE 285,A00,103672,Zheng; Yang,0,0,0,0
1668282993668,ECE 285,B00,103673,Sworder; David D.,0,0,0,0
1668282994094,ECE 287,A00,103676,Javidi; Tara,0,0,0,0
1668282994517,MATH 200B,A00,098023,Salehi Golsefidy; Alireza,12,0,15,3
1668282994940,MATH 202B,A00,098024,Rhoades; Brendon Patrick,9,0,15,6
1668282995362,MATH 203B,A00,098025,Oprea; Dragos N.,10,0,15,5
1668282995785,MATH 204B,A00,098026,Sorensen; Claus M,13,0,15,2
1668282996209,MATH 208,A00,098027,Izadi; Elham,7,0,10,3
1668282996633,MATH 209,A00,098028,Pollack; Aaron,10,0,10,0
1668282997056,MATH 211A,A00,112919,Rogalski; Daniel,9,0,10,1
1668282997479,MATH 211B,A00,112920,Seward; Brandon M.,9,0,10,1
1668282997901,MATH 218,A00,098029,Li; Bo,10,0,10,0
1668282998325,MATH 220B,A00,098030,Novak; Jonathan I,11,0,15,4
1668282998753,MATH 221A,A00,098031,Ebenfelt; Peter F,13,0,15,2
1668282999175,MATH 231B,A00,098032,Zlatos; Andrej,12,0,15,3
1668282999598,MATH 240B,A00,098033,Ni; Lei,9,0,15,6
1668283000022,MATH 243,A00,098034,Jekel; David Andrew,10,0,10,0
1668283000449,MATH 245A,A00,098035,Nie; Jiawang,0,0,15,16
1668283000873,MATH 248,A00,098036,Bejenaru; Ioan,10,0,10,0
1668283001295,MATH 250B,A00,098037,Spolaor; Luca,14,0,15,1
1668283001721,MATH 258,A00,098038,Ni; Lei,10,0,10,0
1668283002145,MATH 264B,A00,098041,Rhoades; Brendon Patrick,9,0,15,6
1668283002566,MATH 268,A00,098042,Buss; Samuel R,10,0,10,0
1668283002993,MATH 269,A00,098043,Rhoades; Brendon Patrick,10,0,10,0
1668283003415,MATH 270B,A00,098044,Li; Bo,10,0,15,5
1668283003837,MATH 272B,A00,098045,Holst; Michael J,13,0,15,2
1668283004261,MATH 273A,A00,098046,Tian; Xiaochuan,10,0,15,5
1668283004685,MATH 275,A01,098048,Tian; Xiaochuan,6,0,10,4
1668283005109,MATH 278A,A00,098049,Holst; Michael J,8,0,10,2
1668283005534,MATH 278B,A00,098050,Cloninger; Alexander,10,0,10,0
1668283005958,MATH 278C,A00,098051,Nie; Jiawang,7,0,10,3
1668283006383,MATH 280B,A00,098052,Zheng; Tianyi,8,0,15,7
1668283006807,MATH 281B,A00,098053,Bradic; Jelena,1,0,15,14
1668283007231,MATH 282B,A00,098054,Arias-Castro; Ery,0,0,15,15
1668283007658,MATH 285,A00,098055,Fitzsimmons; Patrick J,0,0,15,17
1668283008084,MATH 287B,A00,098056,Arias-Castro; Ery,2,0,15,13
1668283008505,MATH 288,A00,098057,Agarwal; Pooja,9,0,10,1
1668283008505,MATH 288,B00,098058,Zhang; Danna,8,0,10,2
1668283008505,MATH 288,C00,098059,Williams; Ruth J,9,0,10,1
1668283008929,MATH 290B,A00,098060,Roberts; Justin Deritter,13,0,15,2
1668283009352,MATH 292,A00,098061,Belmont; Eva Kinoshita,10,0,10,0
1668283009783,MATH 295,A00,098062,Suk; Andrew Hoon,48,0,50,2
1668283010207,MATH 296,A00,098063,Novak; Jonathan I,20,0,20,0
1668283010630,MATH 297,001,098064,Gamst; Anthony Collins,9997,0,9999,2
1668283509337,COGS 205,A00,101395,Chiba; Andrea,19,0,20,1
1668283509761,COGS 210B,001,101404,Greene; Deanna Jacquelyn,9998,0,9999,1
1668283509761,COGS 210B,002,101417,Xia; Haijun,9999,0,9999,0
1668283509761,COGS 210B,003,101422,Nitz; Douglas A.,9999,0,9999,0
1668283509761,COGS 210B,004,101423,Hollan; James D.,9998,0,9999,1
1668283509761,COGS 210B,005,101424,Deak; Gedeon O.,9998,0,9999,1
1668283509761,COGS 210B,006,101425,Rossano; Federico,9999,0,9999,0
1668283510278,COGS 211B,A00,101427,Coulson; Seana M,9996,0,9999,3
1668283510703,COGS 220,A00,101428,Hollan; James D.,0,0,25,25
1668283511126,COGS 229,A00,101429,Dow; Steven P,18,0,25,7
1668283511557,COGS 230,A00,101430,Klemmer; Scott R,12,0,17,5
1668283511978,COGS 234,A00,101431,Xia; Haijun,1,0,25,24
1668283512406,COGS 260,A00,101432,Kiyonaga; Anastasia,21,0,25,4
1668283512406,COGS 260,B00,101433,Kirsh; David Joel,15,0,25,10
1668283512828,CSE 202,A00,102371,Impagliazzo; Russell,0,0,0,0
1668283513256,CSE 203B,A01,102373,Cheng; Chung Kuan,0,0,0,0
1668283513685,CSE 208,A00,102374,Micciancio; Daniele,0,0,0,0
1668283514111,CSE 209A,A00,112895,Impagliazzo; Russell,0,0,15,15
1668283514536,CSE 209B,A00,108005,Bellare; Mihir,0,0,0,0
1668283514959,CSE 210,A00,113163,Coblenz; Michael J,0,0,0,0
1668283515390,CSE 219,A00,106111,Dow; Steven P,0,0,20,20
1668283515816,CSE 221,A00,102376,Voelker; Geoffrey M.,0,0,0,0
1668283516244,CSE 224,A01,102378,Porter; George M,0,0,0,0
1668283516670,CSE 229A,A00,102379,Savage; Stefan,0,0,0,0
1668283517093,CSE 229C,A00,102380,Munyaka; Imani N. S.,0,0,0,0
1668283517517,CSE 232B,A00,102382,Deutsch; Alin Bernard,0,0,0,0
1668283517943,CSE 234,A01,112904,Kumar; Arun Kumar,0,0,0,0
1668283518370,CSE 237A,A00,102383,Rosing; Tajana Simunic,0,0,0,0
1668283518793,CSE 239A,A00,102384,Deutsch; Alin Bernard,0,0,0,0
1668283519220,CSE 239B,A00,102385,Polikarpova; Nadezhda,0,0,0,0
1668283519646,CSE 240A,A00,102386,Pannuto; Patrick William,0,0,0,0
1668283520071,CSE 240B,A00,102387,Zhao; Jishen,0,0,0,0
1668283520494,CSE 241A,A00,106406,Kang; Mingu,0,0,0,0
1668283520918,CSE 249B,A00,102388,Kahng; Andrew Byun,0,0,8,8
1668283521342,CSE 251B,A01,102392,Cottrell; Garrison W,0,0,0,0
1668283521342,CSE 251B,A02,102393,Cottrell; Garrison W,0,0,0,0
1668283521767,CSE 252B,A00,102394,Ochoa; Benjamin Lawrence,0,0,0,0
1668283522191,CSE 257,A01,102396,Gao; Sicun,0,0,0,0
1668283522615,CSE 272,A00,102397,Li; Tzumao,0,0,0,0
1668283523038,CSE 274,A00,111323,Chern; Albert Ren-Haur,0,0,0,0
1668283523466,CSE 282,A00,102398,Pevzner; Pavel Arkadjevich,0,0,0,0
1668283523899,CSE 284,A00,114175,Gymrek; Melissa Ann,0,0,0,0
1668283524322,CSE 290,A00,102399,Chandraker; Manmohan Krishna,0,0,0,0
1668283524322,CSE 290,B00,102400,Vaccaro; Kristen Marie,0,0,25,25
1668283524322,CSE 290,C00,102414,Pannuto; Patrick William,0,0,25,25
1668283524322,CSE 290,D00,102427,Pevzner; Pavel Arkadjevich,0,0,0,0
1668283524322,CSE 290,E00,102429,Zhao; Jishen,0,0,0,0
1668283524322,CSE 290,F00,102436,Tullsen; Dean Michael,0,0,0,0
1668283524322,CSE 290,G00,102440,Christensen; Henrik I,0,0,20,20
1668283524750,CSE 291,A00,102443,Su; Hao,0,0,0,0
1668283524750,CSE 291,B00,102448,Polikarpova; Nadezhda,0,0,0,0
1668283524750,CSE 291,C00,102453,Vaccaro; Kristen Marie,0,0,0,0
1668283524750,CSE 291,D00,111343,Savage; Stefan,0,0,0,0
1668283524750,CSE 291,E00,116474,Claffy; Kimberly Claire,0,0,0,0
1668283524750,CSE 291,F00,116479,Pasquale; Joseph,0,0,0,0
1668283525185,CSE 293,001,119111,Bafna; Vineet,9999,0,9999,0
1668283525185,CSE 293,002,119118,Bellare; Mihir,9999,0,9999,0
1668283525185,CSE 293,003,119122,Berg-Kirkpatrick; Taylor D,9999,0,9999,0
1668283525185,CSE 293,004,119135,Christensen; Henrik I,9999,0,9999,0
1668283525185,CSE 293,005,119142,Cottrell; Garrison W,9999,0,9999,0
1668283525185,CSE 293,006,119146,Deutsch; Alin Bernard,9999,0,9999,0
1668283525185,CSE 293,007,119159,Esmaeilzadeh; Hadi,9999,0,9999,0
1668283525185,CSE 293,008,119166,Freund; Yoav,9999,0,9999,0
1668283525185,CSE 293,009,119170,Griswold; William G.,9999,0,9999,0
1668283525185,CSE 293,010,119183,Gymrek; Melissa Ann,9999,0,9999,0
1668283525185,CSE 293,011,119190,Heninger; Nadia A,9999,0,9999,0
1668283525185,CSE 293,012,119230,Impagliazzo; Russell,9999,0,9999,0
1668283525185,CSE 293,013,119232,Jhala; Ranjit,9999,0,9999,0
1668283525185,CSE 293,014,119233,Kahng; Andrew Byun,9999,0,9999,0
1668283525185,CSE 293,015,119298,Kane; Daniel Mertz,9999,0,9999,0
1668283525185,CSE 293,016,119299,Kriegman; David J,9999,0,9999,0
1668283525185,CSE 293,017,119300,Kumar; Arun Kumar,9999,0,9999,0
1668283525185,CSE 293,018,119301,Lerner; Sorin,9999,0,9999,0
1668283525185,CSE 293,019,119302,Lovett; Shachar,9999,0,9999,0
1668283525185,CSE 293,020,119303,McAuley; Julian John,9999,0,9999,0
1668283525185,CSE 293,021,119304,Micciancio; Daniele,9999,0,9999,0
1668283525185,CSE 293,022,119367,Orailoglu; Alex,9999,0,9999,0
1668283525185,CSE 293,023,119382,Paturi; Ramamohan,9999,0,9999,0
1668283525185,CSE 293,024,119404,Polikarpova; Nadezhda,9999,0,9999,0
1668283525185,CSE 293,025,119406,Politz; Joseph Gibbs,9999,0,9999,0
1668283525185,CSE 293,026,119411,Porter; George M,9999,0,9999,0
1668283525185,CSE 293,027,119414,Porter; Leonard Emerson,9999,0,9999,0
1668283525185,CSE 293,028,119416,Ramamoorthi; Ravi,9999,0,9999,0
1668283525185,CSE 293,029,119417,Sahoo; Debashis,9999,0,9999,0
1668283525185,CSE 293,030,119420,Saul; Lawrence,9999,0,9999,0
1668283525185,CSE 293,031,119421,Savage; Stefan,9999,0,9999,0
1668283525185,CSE 293,032,119425,Schulze; Jurgen P.,9999,0,9999,0
1668283525185,CSE 293,033,119426,Snoeren; Alex C.,9999,0,9999,0
1668283525185,CSE 293,034,119428,Shang; Jingbo,9999,0,9999,0
1668283525185,CSE 293,035,119430,Stefan; Deian,9999,0,9999,0
1668283525185,CSE 293,036,119431,Su; Hao,9999,0,9999,0
1668283525185,CSE 293,037,119433,Swanson; Steven James,9999,0,9999,0
1668283525185,CSE 293,038,119435,Tullsen; Dean Michael,9999,0,9999,0
1668283525185,CSE 293,039,119483,Voelker; Geoffrey M.,9999,0,9999,0
1668283525185,CSE 293,040,119537,Zhao; Jishen,9999,0,9999,0
1668283525185,CSE 293,041,119538,Zhou; Yuan-Yuan,9999,0,9999,0
1668283525185,CSE 293,042,119539,Gao; Sicun,9999,0,9999,0
1668283525185,CSE 293,043,119540,Weibel; Nadir,9999,0,9999,0
1668283525185,CSE 293,044,119541,Gupta; Rajesh K.,9999,0,9999,0
1668283525185,CSE 293,045,126410,Vaccaro; Kristen Marie,9999,0,9999,0
1668283525185,CSE 293,046,126411,Klemke; Richard,9999,0,9999,0
1668283525612,CSE 294,A00,102459,Voelker; Geoffrey M.,0,0,0,0
1668283525612,CSE 294,B00,111322,Orailoglu; Alex,0,0,0,0
1668283526038,DSE 201,A00,096914,Deutsch; Alin Bernard,30,0,30,0
1668283526462,DSE 210,A00,096915,Dasgupta; Sanjoy,30,0,30,0
1668283526888,DSE 260A,A00,096916,Altintas De Callaf; Ilkay,30,0,30,0
1668283527326,ECE 200,001,103586,Antipa; Nicholas A,9999,0,9999,0
1668283527326,ECE 200,002,103587,Atanasov; Nikolay A.,9999,0,9999,0
1668283527326,ECE 200,003,103588,Bharadia; Dinesh,9999,0,9999,0
1668283527326,ECE 200,004,103589,Cheng; Chung Kuan,9999,0,9999,0
1668283527326,ECE 200,005,103590,Cosman; Pamela C.,9999,0,9999,0
1668283527326,ECE 200,006,103591,Dayeh; Shadi Ahmad,9999,0,9999,0
1668283527326,ECE 200,007,103592,Fainman; Yeshaiahu,9999,0,9999,0
1668283527326,ECE 200,008,103593,Ford; Joseph Earl,9999,0,9999,0
1668283527326,ECE 200,009,103594,Franceschetti; Massimo,9999,0,9999,0
1668283527326,ECE 200,010,103595,Fullerton; Eric E,9999,0,9999,0
1668283527326,ECE 200,011,103596,Galton; Ian A,9999,0,9999,0
1668283527326,ECE 200,012,103597,Gilja; Vikash,9999,0,9999,0
1668283527326,ECE 200,013,103598,Hall; Drew A.,9999,0,9999,0
1668283527326,ECE 200,014,103599,Hsueh; Tzu-Chien,9999,0,9999,0
1668283527326,ECE 200,015,103600,Javidi; Tara,9999,0,9999,0
1668283527326,ECE 200,016,103601,Kahng; Andrew Byun,9999,0,9999,0
1668283527326,ECE 200,017,103602,Kim; Young-Han,9999,0,9999,0
1668283527326,ECE 200,018,103603,Koushanfar; Farinaz,9999,0,9999,0
1668283527326,ECE 200,019,103604,Kuzum; Duygu,9999,0,9999,0
1668283527326,ECE 200,020,103605,Le; Hanh-Phuc,9999,0,9999,0
1668283527326,ECE 200,021,103606,Lin; Bill,9999,0,9999,0
1668283527326,ECE 200,022,103607,Liu; Zhaowei,9998,0,9999,1
1668283527326,ECE 200,023,103608,Lo; Yu-Hwa,9999,0,9999,0
1668283527326,ECE 200,024,103609,Lomakin; Vitaliy,9999,0,9999,0
1668283527326,ECE 200,025,103610,Mercier; Patrick Philip,9999,0,9999,0
1668283527326,ECE 200,026,103611,Meyer; Florian,9999,0,9999,0
1668283527326,ECE 200,027,103612,Milstein; Laurence B.,9999,0,9999,0
1668283527326,ECE 200,028,103613,Mir Arabbaygi; Siavash,9999,0,9999,0
1668283527326,ECE 200,029,103614,Mookherjea; Shayan,9999,0,9999,0
1668283527326,ECE 200,030,103615,Morris; Karcher William,9999,0,9999,0
1668283527326,ECE 200,031,103616,Ng; Tse Nga,9999,0,9999,0
1668283527326,ECE 200,032,103617,Nguyen; Truong Quang,9999,0,9999,0
1668283527326,ECE 200,033,103618,Nomura; Kenji,9999,0,9999,0
1668283527326,ECE 200,034,103619,Orlitsky; Alon,9999,0,9999,0
1668283527326,ECE 200,035,103620,Pal; Piya,9999,0,9999,0
1668283527326,ECE 200,036,103621,Papen; George C.,9999,0,9999,0
1668283527326,ECE 200,037,103622,Radic; Stojan,9999,0,9999,0
1668283527326,ECE 200,038,103623,Rao; Bhaskar D.,9999,0,9999,0
1668283527326,ECE 200,039,103624,Rao; Ramesh R,9999,0,9999,0
1668283527326,ECE 200,040,103625,Rebeiz; Gabriel,9999,0,9999,0
1668283527326,ECE 200,041,103626,Sanford; John R,9999,0,9999,0
1668283527326,ECE 200,042,103627,Siegel; Paul H.,9999,0,9999,0
1668283527326,ECE 200,043,103628,Sievenpiper; Daniel F.,9999,0,9999,0
1668283527326,ECE 200,044,103629,Sworder; David D.,9999,0,9999,0
1668283527326,ECE 200,045,103630,Taur; Yuan,9999,0,9999,0
1668283527326,ECE 200,046,103631,Touri; Behrouz,9999,0,9999,0
1668283527326,ECE 200,047,103632,Trivedi; Mohan M.,9999,0,9999,0
1668283527326,ECE 200,048,103633,Vasconcelos; Nuno,9999,0,9999,0
1668283527326,ECE 200,049,103634,Wang; Xiaolong,9999,0,9999,0
1668283527326,ECE 200,050,103635,Xie; Pengtao,9999,0,9999,0
1668283527326,ECE 200,051,103636,Yip; Michael,9999,0,9999,0
1668283527326,ECE 200,052,103637,Zeger; Kenneth A.,999,0,999,0
1668283527326,ECE 200,053,103638,Zhang; Xinyu,9999,0,9999,0
1668283527326,ECE 200,054,103639,Turakhia; Yatish Girish,9999,0,9999,0
1668283527326,ECE 200,055,103640,Kang; Mingu,9999,0,9999,0
1668283527326,ECE 200,056,103641,Shi; Yuanyuan,9999,0,9999,0
1668283527326,ECE 200,057,103642,Wang; Edward Jay,9999,0,9999,0
1668283527326,ECE 200,058,103643,Zheng; Yang,9999,0,9999,0
1668283527752,ECE 202,A00,103644,Kuzum; Duygu,0,0,0,0
1668283528177,ECE 212BN,A00,103646,Ng; Tse Nga,0,0,0,0
1668283528601,ECE 221,A00,111493,Staff,0,0,0,0
1668283529025,ECE 222B,A00,103647,Lomakin; Vitaliy,0,0,0,0
1668283529450,ECE 230B,A00,103648,Taur; Yuan,0,0,0,0
1668283529875,ECE 238B,A00,103649,Garay; Javier,0,0,0,0
1668283530305,ECE 240B,A00,112900,Fainman; Yeshaiahu,0,0,0,0
1668283530740,ECE 247A,A00,103650,Jokerst; Jesse Vincent,0,0,0,0
1668283531162,ECE 247B,A00,103651,Wang; Joseph,0,0,0,0
1668283531593,ECE 250,A00,103652,Siegel; Paul H.,0,0,0,0
1668283532028,ECE 251A,A00,103654,Rao; Bhaskar D.,0,0,0,0
1668283532450,ECE 257B,A00,103655,Bharadia; Dinesh,0,0,0,0
1668283532880,ECE 258A,A00,103656,Milstein; Laurence B.,0,0,0,0
1668283533304,ECE 260B,A00,103658,Kang; Mingu,0,0,0,0
1668283533733,ECE 264A,A00,103659,Galton; Ian A,0,0,0,0
1668283534157,ECE 265A,A00,103661,Gudem; Prasad S.S.,0,0,0,0
1668283534592,ECE 265D,A00,103662,Gudem; Prasad S.S.,0,0,0,0
1668283535017,ECE 268,A00,103663,Koushanfar; Farinaz,0,0,0,0
1668283535441,ECE 269,A01,103665,Pal; Piya,0,0,0,0
1668283535864,ECE 271B,A00,103666,Vasconcelos; Manuela,0,0,0,0
1668283536290,ECE 276A,A00,103667,Atanasov; Nikolay A.,0,0,0,0
1668283536717,ECE 277,A00,103668,An; Cheolhong,0,0,0,0
1668283537142,ECE 279,A00,117947,Hall; Drew A.,0,0,0,0
1668283537995,ECE 283,A00,103670,Hsueh; Tzu-Chien,0,0,0,0
1668283538425,ECE 284,A00,103671,Turakhia; Yatish Girish,0,0,0,0
1668283538850,ECE 285,A00,103672,Zheng; Yang,0,0,0,0
1668283538850,ECE 285,B00,103673,Sworder; David D.,0,0,0,0
1668283539277,ECE 287,A00,103676,Javidi; Tara,0,0,0,0
1668283539701,MATH 200B,A00,098023,Salehi Golsefidy; Alireza,12,0,15,3
1668283540130,MATH 202B,A00,098024,Rhoades; Brendon Patrick,9,0,15,6
1668283540552,MATH 203B,A00,098025,Oprea; Dragos N.,10,0,15,5
1668283540982,MATH 204B,A00,098026,Sorensen; Claus M,13,0,15,2
1668283541410,MATH 208,A00,098027,Izadi; Elham,7,0,10,3
1668283541951,MATH 209,A00,098028,Pollack; Aaron,10,0,10,0
1668283542374,MATH 211A,A00,112919,Rogalski; Daniel,9,0,10,1
1668283542798,MATH 211B,A00,112920,Seward; Brandon M.,9,0,10,1
1668283543225,MATH 218,A00,098029,Li; Bo,10,0,10,0
1668283543652,MATH 220B,A00,098030,Novak; Jonathan I,11,0,15,4
1668283544076,MATH 221A,A00,098031,Ebenfelt; Peter F,13,0,15,2
1668283544506,MATH 231B,A00,098032,Zlatos; Andrej,12,0,15,3
1668283544929,MATH 240B,A00,098033,Ni; Lei,9,0,15,6
1668283545355,MATH 243,A00,098034,Jekel; David Andrew,10,0,10,0
1668283545784,MATH 245A,A00,098035,Nie; Jiawang,0,0,15,16
1668283546207,MATH 248,A00,098036,Bejenaru; Ioan,10,0,10,0
1668283546629,MATH 250B,A00,098037,Spolaor; Luca,14,0,15,1
1668283547053,MATH 258,A00,098038,Ni; Lei,10,0,10,0
1668283547474,MATH 264B,A00,098041,Rhoades; Brendon Patrick,9,0,15,6
1668283547900,MATH 268,A00,098042,Buss; Samuel R,10,0,10,0
1668283548333,MATH 269,A00,098043,Rhoades; Brendon Patrick,10,0,10,0
1668283548756,MATH 270B,A00,098044,Li; Bo,10,0,15,5
1668283549179,MATH 272B,A00,098045,Holst; Michael J,13,0,15,2
1668283549604,MATH 273A,A00,098046,Tian; Xiaochuan,10,0,15,5
1668283550036,MATH 275,A01,098048,Tian; Xiaochuan,6,0,10,4
1668283550462,MATH 278A,A00,098049,Holst; Michael J,8,0,10,2
1668283550885,MATH 278B,A00,098050,Cloninger; Alexander,10,0,10,0
1668283551309,MATH 278C,A00,098051,Nie; Jiawang,7,0,10,3
1668283551743,MATH 280B,A00,098052,Zheng; Tianyi,8,0,15,7
1668283552166,MATH 281B,A00,098053,Bradic; Jelena,1,0,15,14
1668283552593,MATH 282B,A00,098054,Arias-Castro; Ery,0,0,15,15
1668283553021,MATH 285,A00,098055,Fitzsimmons; Patrick J,0,0,15,17
1668283553445,MATH 287B,A00,098056,Arias-Castro; Ery,2,0,15,13
1668283553875,MATH 288,A00,098057,Agarwal; Pooja,9,0,10,1
1668283553875,MATH 288,B00,098058,Zhang; Danna,8,0,10,2
1668283553875,MATH 288,C00,098059,Williams; Ruth J,9,0,10,1
1668283554298,MATH 290B,A00,098060,Roberts; Justin Deritter,13,0,15,2
1668283554722,MATH 292,A00,098061,Belmont; Eva Kinoshita,10,0,10,0
1668283555148,MATH 295,A00,098062,Suk; Andrew Hoon,48,0,50,2
1668283555572,MATH 296,A00,098063,Novak; Jonathan I,20,0,20,0
1668283555999,MATH 297,001,098064,Gamst; Anthony Collins,9997,0,9999,2
1668284055040,COGS 205,A00,101395,Chiba; Andrea,19,0,20,1
1668284055461,COGS 210B,001,101404,Greene; Deanna Jacquelyn,9998,0,9999,1
1668284055461,COGS 210B,002,101417,Xia; Haijun,9999,0,9999,0
1668284055461,COGS 210B,003,101422,Nitz; Douglas A.,9999,0,9999,0
1668284055461,COGS 210B,004,101423,Hollan; James D.,9998,0,9999,1
1668284055461,COGS 210B,005,101424,Deak; Gedeon O.,9998,0,9999,1
1668284055461,COGS 210B,006,101425,Rossano; Federico,9999,0,9999,0
1668284055884,COGS 211B,A00,101427,Coulson; Seana M,9996,0,9999,3
1668284056308,COGS 220,A00,101428,Hollan; James D.,0,0,25,25
1668284056748,COGS 229,A00,101429,Dow; Steven P,18,0,25,7
1668284057170,COGS 230,A00,101430,Klemmer; Scott R,12,0,17,5
1668284057595,COGS 234,A00,101431,Xia; Haijun,1,0,25,24
1668284058020,COGS 260,A00,101432,Kiyonaga; Anastasia,21,0,25,4
1668284058020,COGS 260,B00,101433,Kirsh; David Joel,15,0,25,10
1668284058444,CSE 202,A00,102371,Impagliazzo; Russell,0,0,0,0
1668284058867,CSE 203B,A01,102373,Cheng; Chung Kuan,0,0,0,0
1668284059291,CSE 208,A00,102374,Micciancio; Daniele,0,0,0,0
1668284059715,CSE 209A,A00,112895,Impagliazzo; Russell,0,0,15,15
1668284060139,CSE 209B,A00,108005,Bellare; Mihir,0,0,0,0
1668284060562,CSE 210,A00,113163,Coblenz; Michael J,0,0,0,0
1668284061080,CSE 219,A00,106111,Dow; Steven P,0,0,20,20
1668284061505,CSE 221,A00,102376,Voelker; Geoffrey M.,0,0,0,0
1668284061928,CSE 224,A01,102378,Porter; George M,0,0,0,0
1668284062357,CSE 229A,A00,102379,Savage; Stefan,0,0,0,0
1668284062783,CSE 229C,A00,102380,Munyaka; Imani N. S.,0,0,0,0
1668284063207,CSE 232B,A00,102382,Deutsch; Alin Bernard,0,0,0,0
1668284063631,CSE 234,A01,112904,Kumar; Arun Kumar,0,0,0,0
1668284064058,CSE 237A,A00,102383,Rosing; Tajana Simunic,0,0,0,0
1668284064483,CSE 239A,A00,102384,Deutsch; Alin Bernard,0,0,0,0
1668284064905,CSE 239B,A00,102385,Polikarpova; Nadezhda,0,0,0,0
1668284065331,CSE 240A,A00,102386,Pannuto; Patrick William,0,0,0,0
1668284065756,CSE 240B,A00,102387,Zhao; Jishen,0,0,0,0
1668284066181,CSE 241A,A00,106406,Kang; Mingu,0,0,0,0
1668284066602,CSE 249B,A00,102388,Kahng; Andrew Byun,0,0,8,8
1668284067025,CSE 251B,A01,102392,Cottrell; Garrison W,0,0,0,0
1668284067025,CSE 251B,A02,102393,Cottrell; Garrison W,0,0,0,0
1668284067453,CSE 252B,A00,102394,Ochoa; Benjamin Lawrence,0,0,0,0
1668284067877,CSE 257,A01,102396,Gao; Sicun,0,0,0,0
1668284068302,CSE 272,A00,102397,Li; Tzumao,0,0,0,0
1668284068727,CSE 274,A00,111323,Chern; Albert Ren-Haur,0,0,0,0
1668284069150,CSE 282,A00,102398,Pevzner; Pavel Arkadjevich,0,0,0,0
1668284069577,CSE 284,A00,114175,Gymrek; Melissa Ann,0,0,0,0
1668284070000,CSE 290,A00,102399,Chandraker; Manmohan Krishna,0,0,0,0
1668284070000,CSE 290,B00,102400,Vaccaro; Kristen Marie,0,0,25,25
1668284070000,CSE 290,C00,102414,Pannuto; Patrick William,0,0,25,25
1668284070000,CSE 290,D00,102427,Pevzner; Pavel Arkadjevich,0,0,0,0
1668284070000,CSE 290,E00,102429,Zhao; Jishen,0,0,0,0
1668284070000,CSE 290,F00,102436,Tullsen; Dean Michael,0,0,0,0
1668284070000,CSE 290,G00,102440,Christensen; Henrik I,0,0,20,20
1668284070428,CSE 291,A00,102443,Su; Hao,0,0,0,0
1668284070428,CSE 291,B00,102448,Polikarpova; Nadezhda,0,0,0,0
1668284070428,CSE 291,C00,102453,Vaccaro; Kristen Marie,0,0,0,0
1668284070428,CSE 291,D00,111343,Savage; Stefan,0,0,0,0
1668284070428,CSE 291,E00,116474,Claffy; Kimberly Claire,0,0,0,0
1668284070428,CSE 291,F00,116479,Pasquale; Joseph,0,0,0,0
1668284070859,CSE 293,001,119111,Bafna; Vineet,9999,0,9999,0
1668284070859,CSE 293,002,119118,Bellare; Mihir,9999,0,9999,0
1668284070859,CSE 293,003,119122,Berg-Kirkpatrick; Taylor D,9999,0,9999,0
1668284070859,CSE 293,004,119135,Christensen; Henrik I,9999,0,9999,0
1668284070859,CSE 293,005,119142,Cottrell; Garrison W,9999,0,9999,0
1668284070859,CSE 293,006,119146,Deutsch; Alin Bernard,9999,0,9999,0
1668284070859,CSE 293,007,119159,Esmaeilzadeh; Hadi,9999,0,9999,0
1668284070859,CSE 293,008,119166,Freund; Yoav,9999,0,9999,0
1668284070859,CSE 293,009,119170,Griswold; William G.,9999,0,9999,0
1668284070859,CSE 293,010,119183,Gymrek; Melissa Ann,9999,0,9999,0
1668284070859,CSE 293,011,119190,Heninger; Nadia A,9999,0,9999,0
1668284070859,CSE 293,012,119230,Impagliazzo; Russell,9999,0,9999,0
1668284070859,CSE 293,013,119232,Jhala; Ranjit,9999,0,9999,0
1668284070859,CSE 293,014,119233,Kahng; Andrew Byun,9999,0,9999,0
1668284070859,CSE 293,015,119298,Kane; Daniel Mertz,9999,0,9999,0
1668284070859,CSE 293,016,119299,Kriegman; David J,9999,0,9999,0
1668284070859,CSE 293,017,119300,Kumar; Arun Kumar,9999,0,9999,0
1668284070859,CSE 293,018,119301,Lerner; Sorin,9999,0,9999,0
1668284070859,CSE 293,019,119302,Lovett; Shachar,9999,0,9999,0
1668284070859,CSE 293,020,119303,McAuley; Julian John,9999,0,9999,0
1668284070859,CSE 293,021,119304,Micciancio; Daniele,9999,0,9999,0
1668284070859,CSE 293,022,119367,Orailoglu; Alex,9999,0,9999,0
1668284070859,CSE 293,023,119382,Paturi; Ramamohan,9999,0,9999,0
1668284070859,CSE 293,024,119404,Polikarpova; Nadezhda,9999,0,9999,0
1668284070859,CSE 293,025,119406,Politz; Joseph Gibbs,9999,0,9999,0
1668284070859,CSE 293,026,119411,Porter; George M,9999,0,9999,0
1668284070859,CSE 293,027,119414,Porter; Leonard Emerson,9999,0,9999,0
1668284070859,CSE 293,028,119416,Ramamoorthi; Ravi,9999,0,9999,0
1668284070859,CSE 293,029,119417,Sahoo; Debashis,9999,0,9999,0
1668284070859,CSE 293,030,119420,Saul; Lawrence,9999,0,9999,0
1668284070859,CSE 293,031,119421,Savage; Stefan,9999,0,9999,0
1668284070859,CSE 293,032,119425,Schulze; Jurgen P.,9999,0,9999,0
1668284070859,CSE 293,033,119426,Snoeren; Alex C.,9999,0,9999,0
1668284070859,CSE 293,034,119428,Shang; Jingbo,9999,0,9999,0
1668284070859,CSE 293,035,119430,Stefan; Deian,9999,0,9999,0
1668284070859,CSE 293,036,119431,Su; Hao,9999,0,9999,0
1668284070859,CSE 293,037,119433,Swanson; Steven James,9999,0,9999,0
1668284070859,CSE 293,038,119435,Tullsen; Dean Michael,9999,0,9999,0
1668284070859,CSE 293,039,119483,Voelker; Geoffrey M.,9999,0,9999,0
1668284070859,CSE 293,040,119537,Zhao; Jishen,9999,0,9999,0
1668284070859,CSE 293,041,119538,Zhou; Yuan-Yuan,9999,0,9999,0
1668284070859,CSE 293,042,119539,Gao; Sicun,9999,0,9999,0
1668284070859,CSE 293,043,119540,Weibel; Nadir,9999,0,9999,0
1668284070859,CSE 293,044,119541,Gupta; Rajesh K.,9999,0,9999,0
1668284070859,CSE 293,045,126410,Vaccaro; Kristen Marie,9999,0,9999,0
1668284070859,CSE 293,046,126411,Klemke; Richard,9999,0,9999,0
1668284071289,CSE 294,A00,102459,Voelker; Geoffrey M.,0,0,0,0
1668284071289,CSE 294,B00,111322,Orailoglu; Alex,0,0,0,0
1668284071715,DSE 201,A00,096914,Deutsch; Alin Bernard,30,0,30,0
1668284072150,DSE 210,A00,096915,Dasgupta; Sanjoy,30,0,30,0
1668284072573,DSE 260A,A00,096916,Altintas De Callaf; Ilkay,30,0,30,0
1668284073001,ECE 200,001,103586,Antipa; Nicholas A,9999,0,9999,0
1668284073001,ECE 200,002,103587,Atanasov; Nikolay A.,9999,0,9999,0
1668284073001,ECE 200,003,103588,Bharadia; Dinesh,9999,0,9999,0
1668284073001,ECE 200,004,103589,Cheng; Chung Kuan,9999,0,9999,0
1668284073001,ECE 200,005,103590,Cosman; Pamela C.,9999,0,9999,0
1668284073001,ECE 200,006,103591,Dayeh; Shadi Ahmad,9999,0,9999,0
1668284073001,ECE 200,007,103592,Fainman; Yeshaiahu,9999,0,9999,0
1668284073001,ECE 200,008,103593,Ford; Joseph Earl,9999,0,9999,0
1668284073001,ECE 200,009,103594,Franceschetti; Massimo,9999,0,9999,0
1668284073001,ECE 200,010,103595,Fullerton; Eric E,9999,0,9999,0
1668284073001,ECE 200,011,103596,Galton; Ian A,9999,0,9999,0
1668284073001,ECE 200,012,103597,Gilja; Vikash,9999,0,9999,0
1668284073001,ECE 200,013,103598,Hall; Drew A.,9999,0,9999,0
1668284073001,ECE 200,014,103599,Hsueh; Tzu-Chien,9999,0,9999,0
1668284073001,ECE 200,015,103600,Javidi; Tara,9999,0,9999,0
1668284073001,ECE 200,016,103601,Kahng; Andrew Byun,9999,0,9999,0
1668284073001,ECE 200,017,103602,Kim; Young-Han,9999,0,9999,0
1668284073001,ECE 200,018,103603,Koushanfar; Farinaz,9999,0,9999,0
1668284073001,ECE 200,019,103604,Kuzum; Duygu,9999,0,9999,0
1668284073001,ECE 200,020,103605,Le; Hanh-Phuc,9999,0,9999,0
1668284073001,ECE 200,021,103606,Lin; Bill,9999,0,9999,0
1668284073001,ECE 200,022,103607,Liu; Zhaowei,9998,0,9999,1
1668284073001,ECE 200,023,103608,Lo; Yu-Hwa,9999,0,9999,0
1668284073001,ECE 200,024,103609,Lomakin; Vitaliy,9999,0,9999,0
1668284073001,ECE 200,025,103610,Mercier; Patrick Philip,9999,0,9999,0
1668284073001,ECE 200,026,103611,Meyer; Florian,9999,0,9999,0
1668284073001,ECE 200,027,103612,Milstein; Laurence B.,9999,0,9999,0
1668284073001,ECE 200,028,103613,Mir Arabbaygi; Siavash,9999,0,9999,0
1668284073001,ECE 200,029,103614,Mookherjea; Shayan,9999,0,9999,0
1668284073001,ECE 200,030,103615,Morris; Karcher William,9999,0,9999,0
1668284073001,ECE 200,031,103616,Ng; Tse Nga,9999,0,9999,0
1668284073001,ECE 200,032,103617,Nguyen; Truong Quang,9999,0,9999,0
1668284073001,ECE 200,033,103618,Nomura; Kenji,9999,0,9999,0
1668284073001,ECE 200,034,103619,Orlitsky; Alon,9999,0,9999,0
1668284073001,ECE 200,035,103620,Pal; Piya,9999,0,9999,0
1668284073001,ECE 200,036,103621,Papen; George C.,9999,0,9999,0
1668284073001,ECE 200,037,103622,Radic; Stojan,9999,0,9999,0
1668284073001,ECE 200,038,103623,Rao; Bhaskar D.,9999,0,9999,0
1668284073001,ECE 200,039,103624,Rao; Ramesh R,9999,0,9999,0
1668284073001,ECE 200,040,103625,Rebeiz; Gabriel,9999,0,9999,0
1668284073001,ECE 200,041,103626,Sanford; John R,9999,0,9999,0
1668284073001,ECE 200,042,103627,Siegel; Paul H.,9999,0,9999,0
1668284073001,ECE 200,043,103628,Sievenpiper; Daniel F.,9999,0,9999,0
1668284073001,ECE 200,044,103629,Sworder; David D.,9999,0,9999,0
1668284073001,ECE 200,045,103630,Taur; Yuan,9999,0,9999,0
1668284073001,ECE 200,046,103631,Touri; Behrouz,9999,0,9999,0
1668284073001,ECE 200,047,103632,Trivedi; Mohan M.,9999,0,9999,0
1668284073001,ECE 200,048,103633,Vasconcelos; Nuno,9999,0,9999,0
1668284073001,ECE 200,049,103634,Wang; Xiaolong,9999,0,9999,0
1668284073001,ECE 200,050,103635,Xie; Pengtao,9999,0,9999,0
1668284073001,ECE 200,051,103636,Yip; Michael,9999,0,9999,0
1668284073001,ECE 200,052,103637,Zeger; Kenneth A.,999,0,999,0
1668284073001,ECE 200,053,103638,Zhang; Xinyu,9999,0,9999,0
1668284073001,ECE 200,054,103639,Turakhia; Yatish Girish,9999,0,9999,0
1668284073001,ECE 200,055,103640,Kang; Mingu,9999,0,9999,0
1668284073001,ECE 200,056,103641,Shi; Yuanyuan,9999,0,9999,0
1668284073001,ECE 200,057,103642,Wang; Edward Jay,9999,0,9999,0
1668284073001,ECE 200,058,103643,Zheng; Yang,9999,0,9999,0
1668284073428,ECE 202,A00,103644,Kuzum; Duygu,0,0,0,0
1668284073853,ECE 212BN,A00,103646,Ng; Tse Nga,0,0,0,0
1668284074277,ECE 221,A00,111493,Staff,0,0,0,0
1668284074702,ECE 222B,A00,103647,Lomakin; Vitaliy,0,0,0,0
1668284075126,ECE 230B,A00,103648,Taur; Yuan,0,0,0,0
1668284075550,ECE 238B,A00,103649,Garay; Javier,0,0,0,0
1668284075973,ECE 240B,A00,112900,Fainman; Yeshaiahu,0,0,0,0
1668284076399,ECE 247A,A00,103650,Jokerst; Jesse Vincent,0,0,0,0
1668284076831,ECE 247B,A00,103651,Wang; Joseph,0,0,0,0
1668284077255,ECE 250,A00,103652,Siegel; Paul H.,0,0,0,0
1668284077678,ECE 251A,A00,103654,Rao; Bhaskar D.,0,0,0,0
1668284078101,ECE 257B,A00,103655,Bharadia; Dinesh,0,0,0,0
1668284078528,ECE 258A,A00,103656,Milstein; Laurence B.,0,0,0,0
1668284078952,ECE 260B,A00,103658,Kang; Mingu,0,0,0,0
1668284079379,ECE 264A,A00,103659,Galton; Ian A,0,0,0,0
1668284079805,ECE 265A,A00,103661,Gudem; Prasad S.S.,0,0,0,0
1668284080227,ECE 265D,A00,103662,Gudem; Prasad S.S.,0,0,0,0
1668284080651,ECE 268,A00,103663,Koushanfar; Farinaz,0,0,0,0
1668284081074,ECE 269,A01,103665,Pal; Piya,0,0,0,0
1668284081496,ECE 271B,A00,103666,Vasconcelos; Manuela,0,0,0,0
1668284081918,ECE 276A,A00,103667,Atanasov; Nikolay A.,0,0,0,0
1668284082344,ECE 277,A00,103668,An; Cheolhong,0,0,0,0
1668284082766,ECE 279,A00,117947,Hall; Drew A.,0,0,0,0
1668284083620,ECE 283,A00,103670,Hsueh; Tzu-Chien,0,0,0,0
1668284084043,ECE 284,A00,103671,Turakhia; Yatish Girish,0,0,0,0
1668284084471,ECE 285,A00,103672,Zheng; Yang,0,0,0,0
1668284084471,ECE 285,B00,103673,Sworder; David D.,0,0,0,0
1668284084894,ECE 287,A00,103676,Javidi; Tara,0,0,0,0
1668284085321,MATH 200B,A00,098023,Salehi Golsefidy; Alireza,12,0,15,3
1668284085745,MATH 202B,A00,098024,Rhoades; Brendon Patrick,9,0,15,6
1668284086167,MATH 203B,A00,098025,Oprea; Dragos N.,10,0,15,5
1668284086591,MATH 204B,A00,098026,Sorensen; Claus M,13,0,15,2
1668284087016,MATH 208,A00,098027,Izadi; Elham,7,0,10,3
1668284087447,MATH 209,A00,098028,Pollack; Aaron,10,0,10,0
1668284087872,MATH 211A,A00,112919,Rogalski; Daniel,9,0,10,1
1668284088298,MATH 211B,A00,112920,Seward; Brandon M.,9,0,10,1
1668284088723,MATH 218,A00,098029,Li; Bo,10,0,10,0
1668284089148,MATH 220B,A00,098030,Novak; Jonathan I,11,0,15,4
1668284089573,MATH 221A,A00,098031,Ebenfelt; Peter F,13,0,15,2
1668284089997,MATH 231B,A00,098032,Zlatos; Andrej,12,0,15,3
1668284090427,MATH 240B,A00,098033,Ni; Lei,9,0,15,6
1668284090852,MATH 243,A00,098034,Jekel; David Andrew,10,0,10,0
1668284091277,MATH 245A,A00,098035,Nie; Jiawang,0,0,15,16
1668284091717,MATH 248,A00,098036,Bejenaru; Ioan,10,0,10,0
1668284092144,MATH 250B,A00,098037,Spolaor; Luca,14,0,15,1
1668284092567,MATH 258,A00,098038,Ni; Lei,10,0,10,0
1668284092993,MATH 264B,A00,098041,Rhoades; Brendon Patrick,9,0,15,6
1668284093415,MATH 268,A00,098042,Buss; Samuel R,10,0,10,0
1668284093839,MATH 269,A00,098043,Rhoades; Brendon Patrick,10,0,10,0
1668284094263,MATH 270B,A00,098044,Li; Bo,10,0,15,5
1668284094688,MATH 272B,A00,098045,Holst; Michael J,13,0,15,2
1668284095114,MATH 273A,A00,098046,Tian; Xiaochuan,10,0,15,5
1668284095539,MATH 275,A01,098048,Tian; Xiaochuan,6,0,10,4
1668284095963,MATH 278A,A00,098049,Holst; Michael J,8,0,10,2
1668284096386,MATH 278B,A00,098050,Cloninger; Alexander,10,0,10,0
1668284096810,MATH 278C,A00,098051,Nie; Jiawang,7,0,10,3
1668284097235,MATH 280B,A00,098052,Zheng; Tianyi,8,0,15,7
1668284097674,MATH 281B,A00,098053,Bradic; Jelena,1,0,15,14
1668284098097,MATH 282B,A00,098054,Arias-Castro; Ery,0,0,15,15
1668284098532,MATH 285,A00,098055,Fitzsimmons; Patrick J,0,0,15,17
1668284098958,MATH 287B,A00,098056,Arias-Castro; Ery,2,0,15,13
1668284099381,MATH 288,A00,098057,Agarwal; Pooja,9,0,10,1
1668284099381,MATH 288,B00,098058,Zhang; Danna,8,0,10,2
1668284099381,MATH 288,C00,098059,Williams; Ruth J,9,0,10,1
1668284099808,MATH 290B,A00,098060,Roberts; Justin Deritter,13,0,15,2
1668284100232,MATH 292,A00,098061,Belmont; Eva Kinoshita,10,0,10,0
1668284100658,MATH 295,A00,098062,Suk; Andrew Hoon,48,0,50,2
1668284101087,MATH 296,A00,098063,Novak; Jonathan I,20,0,20,0
1668284101510,MATH 297,001,098064,Gamst; Anthony Collins,9997,0,9999,2
1668284600104,COGS 205,A00,101395,Chiba; Andrea,19,0,20,1
1668284600529,COGS 210B,001,101404,Greene; Deanna Jacquelyn,9998,0,9999,1
1668284600529,COGS 210B,002,101417,Xia; Haijun,9999,0,9999,0
1668284600529,COGS 210B,003,101422,Nitz; Douglas A.,9999,0,9999,0
1668284600529,COGS 210B,004,101423,Hollan; James D.,9998,0,9999,1
1668284600529,COGS 210B,005,101424,Deak; Gedeon O.,9998,0,9999,1
1668284600529,COGS 210B,006,101425,Rossano; Federico,9999,0,9999,0
1668284600952,COGS 211B,A00,101427,Coulson; Seana M,9996,0,9999,3
1668284601381,COGS 220,A00,101428,Hollan; James D.,0,0,25,25
1668284601811,COGS 229,A00,101429,Dow; Steven P,18,0,25,7
1668284602235,COGS 230,A00,101430,Klemmer; Scott R,12,0,17,5
1668284602660,COGS 234,A00,101431,Xia; Haijun,1,0,25,24
1668284603083,COGS 260,A00,101432,Kiyonaga; Anastasia,21,0,25,4
1668284603083,COGS 260,B00,101433,Kirsh; David Joel,15,0,25,10
1668284603509,CSE 202,A00,102371,Impagliazzo; Russell,0,0,0,0
1668284603934,CSE 203B,A01,102373,Cheng; Chung Kuan,0,0,0,0
1668284604361,CSE 208,A00,102374,Micciancio; Daniele,0,0,0,0
1668284604786,CSE 209A,A00,112895,Impagliazzo; Russell,0,0,15,15
1668284605211,CSE 209B,A00,108005,Bellare; Mihir,0,0,0,0
1668284605635,CSE 210,A00,113163,Coblenz; Michael J,0,0,0,0
1668284606059,CSE 219,A00,106111,Dow; Steven P,0,0,20,20
1668284606484,CSE 221,A00,102376,Voelker; Geoffrey M.,0,0,0,0
1668284606908,CSE 224,A01,102378,Porter; George M,0,0,0,0
1668284607332,CSE 229A,A00,102379,Savage; Stefan,0,0,0,0
1668284607754,CSE 229C,A00,102380,Munyaka; Imani N. S.,0,0,0,0
1668284608181,CSE 232B,A00,102382,Deutsch; Alin Bernard,0,0,0,0
1668284608608,CSE 234,A01,112904,Kumar; Arun Kumar,0,0,0,0
1668284609033,CSE 237A,A00,102383,Rosing; Tajana Simunic,0,0,0,0
1668284609455,CSE 239A,A00,102384,Deutsch; Alin Bernard,0,0,0,0
1668284609889,CSE 239B,A00,102385,Polikarpova; Nadezhda,0,0,0,0
1668284610313,CSE 240A,A00,102386,Pannuto; Patrick William,0,0,0,0
1668284610735,CSE 240B,A00,102387,Zhao; Jishen,0,0,0,0
1668284611158,CSE 241A,A00,106406,Kang; Mingu,0,0,0,0
1668284611581,CSE 249B,A00,102388,Kahng; Andrew Byun,0,0,8,8
1668284612009,CSE 251B,A01,102392,Cottrell; Garrison W,0,0,0,0
1668284612009,CSE 251B,A02,102393,Cottrell; Garrison W,0,0,0,0
1668284612436,CSE 252B,A00,102394,Ochoa; Benjamin Lawrence,0,0,0,0
1668284612862,CSE 257,A01,102396,Gao; Sicun,0,0,0,0
1668284613285,CSE 272,A00,102397,Li; Tzumao,0,0,0,0
1668284613712,CSE 274,A00,111323,Chern; Albert Ren-Haur,0,0,0,0
1668284614135,CSE 282,A00,102398,Pevzner; Pavel Arkadjevich,0,0,0,0
1668284614562,CSE 284,A00,114175,Gymrek; Melissa Ann,0,0,0,0
1668284614989,CSE 290,A00,102399,Chandraker; Manmohan Krishna,0,0,0,0
1668284614989,CSE 290,B00,102400,Vaccaro; Kristen Marie,0,0,25,25
1668284614989,CSE 290,C00,102414,Pannuto; Patrick William,0,0,25,25
1668284614989,CSE 290,D00,102427,Pevzner; Pavel Arkadjevich,0,0,0,0
1668284614989,CSE 290,E00,102429,Zhao; Jishen,0,0,0,0
1668284614989,CSE 290,F00,102436,Tullsen; Dean Michael,0,0,0,0
1668284614989,CSE 290,G00,102440,Christensen; Henrik I,0,0,20,20
1668284615418,CSE 291,A00,102443,Su; Hao,0,0,0,0
1668284615418,CSE 291,B00,102448,Polikarpova; Nadezhda,0,0,0,0
1668284615418,CSE 291,C00,102453,Vaccaro; Kristen Marie,0,0,0,0
1668284615418,CSE 291,D00,111343,Savage; Stefan,0,0,0,0
1668284615418,CSE 291,E00,116474,Claffy; Kimberly Claire,0,0,0,0
1668284615418,CSE 291,F00,116479,Pasquale; Joseph,0,0,0,0
1668284615846,CSE 293,001,119111,Bafna; Vineet,9999,0,9999,0
1668284615846,CSE 293,002,119118,Bellare; Mihir,9999,0,9999,0
1668284615846,CSE 293,003,119122,Berg-Kirkpatrick; Taylor D,9999,0,9999,0
1668284615846,CSE 293,004,119135,Christensen; Henrik I,9999,0,9999,0
1668284615846,CSE 293,005,119142,Cottrell; Garrison W,9999,0,9999,0
1668284615846,CSE 293,006,119146,Deutsch; Alin Bernard,9999,0,9999,0
1668284615846,CSE 293,007,119159,Esmaeilzadeh; Hadi,9999,0,9999,0
1668284615846,CSE 293,008,119166,Freund; Yoav,9999,0,9999,0
1668284615846,CSE 293,009,119170,Griswold; William G.,9999,0,9999,0
1668284615846,CSE 293,010,119183,Gymrek; Melissa Ann,9999,0,9999,0
1668284615846,CSE 293,011,119190,Heninger; Nadia A,9999,0,9999,0
1668284615846,CSE 293,012,119230,Impagliazzo; Russell,9999,0,9999,0
1668284615846,CSE 293,013,119232,Jhala; Ranjit,9999,0,9999,0
1668284615846,CSE 293,014,119233,Kahng; Andrew Byun,9999,0,9999,0
1668284615846,CSE 293,015,119298,Kane; Daniel Mertz,9999,0,9999,0
1668284615846,CSE 293,016,119299,Kriegman; David J,9999,0,9999,0
1668284615846,CSE 293,017,119300,Kumar; Arun Kumar,9999,0,9999,0
1668284615846,CSE 293,018,119301,Lerner; Sorin,9999,0,9999,0
1668284615846,CSE 293,019,119302,Lovett; Shachar,9999,0,9999,0
1668284615846,CSE 293,020,119303,McAuley; Julian John,9999,0,9999,0
1668284615846,CSE 293,021,119304,Micciancio; Daniele,9999,0,9999,0
1668284615846,CSE 293,022,119367,Orailoglu; Alex,9999,0,9999,0
1668284615846,CSE 293,023,119382,Paturi; Ramamohan,9999,0,9999,0
1668284615846,CSE 293,024,119404,Polikarpova; Nadezhda,9999,0,9999,0
1668284615846,CSE 293,025,119406,Politz; Joseph Gibbs,9999,0,9999,0
1668284615846,CSE 293,026,119411,Porter; George M,9999,0,9999,0
1668284615846,CSE 293,027,119414,Porter; Leonard Emerson,9999,0,9999,0
1668284615846,CSE 293,028,119416,Ramamoorthi; Ravi,9999,0,9999,0
1668284615846,CSE 293,029,119417,Sahoo; Debashis,9999,0,9999,0
1668284615846,CSE 293,030,119420,Saul; Lawrence,9999,0,9999,0
1668284615846,CSE 293,031,119421,Savage; Stefan,9999,0,9999,0
1668284615846,CSE 293,032,119425,Schulze; Jurgen P.,9999,0,9999,0
1668284615846,CSE 293,033,119426,Snoeren; Alex C.,9999,0,9999,0
1668284615846,CSE 293,034,119428,Shang; Jingbo,9999,0,9999,0
1668284615846,CSE 293,035,119430,Stefan; Deian,9999,0,9999,0
1668284615846,CSE 293,036,119431,Su; Hao,9999,0,9999,0
1668284615846,CSE 293,037,119433,Swanson; Steven James,9999,0,9999,0
1668284615846,CSE 293,038,119435,Tullsen; Dean Michael,9999,0,9999,0
1668284615846,CSE 293,039,119483,Voelker; Geoffrey M.,9999,0,9999,0
1668284615846,CSE 293,040,119537,Zhao; Jishen,9999,0,9999,0
1668284615846,CSE 293,041,119538,Zhou; Yuan-Yuan,9999,0,9999,0
1668284615846,CSE 293,042,119539,Gao; Sicun,9999,0,9999,0
1668284615846,CSE 293,043,119540,Weibel; Nadir,9999,0,9999,0
1668284615846,CSE 293,044,119541,Gupta; Rajesh K.,9999,0,9999,0
1668284615846,CSE 293,045,126410,Vaccaro; Kristen Marie,9999,0,9999,0
1668284615846,CSE 293,046,126411,Klemke; Richard,9999,0,9999,0
1668284616273,CSE 294,A00,102459,Voelker; Geoffrey M.,0,0,0,0
1668284616273,CSE 294,B00,111322,Orailoglu; Alex,0,0,0,0
1668284616697,DSE 201,A00,096914,Deutsch; Alin Bernard,30,0,30,0
1668284617124,DSE 210,A00,096915,Dasgupta; Sanjoy,30,0,30,0
1668284617552,DSE 260A,A00,096916,Altintas De Callaf; Ilkay,30,0,30,0
1668284617979,ECE 200,001,103586,Antipa; Nicholas A,9999,0,9999,0
1668284617979,ECE 200,002,103587,Atanasov; Nikolay A.,9999,0,9999,0
1668284617979,ECE 200,003,103588,Bharadia; Dinesh,9999,0,9999,0
1668284617979,ECE 200,004,103589,Cheng; Chung Kuan,9999,0,9999,0
1668284617979,ECE 200,005,103590,Cosman; Pamela C.,9999,0,9999,0
1668284617979,ECE 200,006,103591,Dayeh; Shadi Ahmad,9999,0,9999,0
1668284617979,ECE 200,007,103592,Fainman; Yeshaiahu,9999,0,9999,0
1668284617979,ECE 200,008,103593,Ford; Joseph Earl,9999,0,9999,0
1668284617979,ECE 200,009,103594,Franceschetti; Massimo,9999,0,9999,0
1668284617979,ECE 200,010,103595,Fullerton; Eric E,9999,0,9999,0
1668284617979,ECE 200,011,103596,Galton; Ian A,9999,0,9999,0
1668284617979,ECE 200,012,103597,Gilja; Vikash,9999,0,9999,0
1668284617979,ECE 200,013,103598,Hall; Drew A.,9999,0,9999,0
1668284617979,ECE 200,014,103599,Hsueh; Tzu-Chien,9999,0,9999,0
1668284617979,ECE 200,015,103600,Javidi; Tara,9999,0,9999,0
1668284617979,ECE 200,016,103601,Kahng; Andrew Byun,9999,0,9999,0
1668284617979,ECE 200,017,103602,Kim; Young-Han,9999,0,9999,0
1668284617979,ECE 200,018,103603,Koushanfar; Farinaz,9999,0,9999,0
1668284617979,ECE 200,019,103604,Kuzum; Duygu,9999,0,9999,0
1668284617979,ECE 200,020,103605,Le; Hanh-Phuc,9999,0,9999,0
1668284617979,ECE 200,021,103606,Lin; Bill,9999,0,9999,0
1668284617979,ECE 200,022,103607,Liu; Zhaowei,9998,0,9999,1
1668284617979,ECE 200,023,103608,Lo; Yu-Hwa,9999,0,9999,0
1668284617979,ECE 200,024,103609,Lomakin; Vitaliy,9999,0,9999,0
1668284617979,ECE 200,025,103610,Mercier; Patrick Philip,9999,0,9999,0
1668284617979,ECE 200,026,103611,Meyer; Florian,9999,0,9999,0
1668284617979,ECE 200,027,103612,Milstein; Laurence B.,9999,0,9999,0
1668284617979,ECE 200,028,103613,Mir Arabbaygi; Siavash,9999,0,9999,0
1668284617979,ECE 200,029,103614,Mookherjea; Shayan,9999,0,9999,0
1668284617979,ECE 200,030,103615,Morris; Karcher William,9999,0,9999,0
1668284617979,ECE 200,031,103616,Ng; Tse Nga,9999,0,9999,0
1668284617979,ECE 200,032,103617,Nguyen; Truong Quang,9999,0,9999,0
1668284617979,ECE 200,033,103618,Nomura; Kenji,9999,0,9999,0
1668284617979,ECE 200,034,103619,Orlitsky; Alon,9999,0,9999,0
1668284617979,ECE 200,035,103620,Pal; Piya,9999,0,9999,0
1668284617979,ECE 200,036,103621,Papen; George C.,9999,0,9999,0
1668284617979,ECE 200,037,103622,Radic; Stojan,9999,0,9999,0
1668284617979,ECE 200,038,103623,Rao; Bhaskar D.,9999,0,9999,0
1668284617979,ECE 200,039,103624,Rao; Ramesh R,9999,0,9999,0
1668284617979,ECE 200,040,103625,Rebeiz; Gabriel,9999,0,9999,0
1668284617979,ECE 200,041,103626,Sanford; John R,9999,0,9999,0
1668284617979,ECE 200,042,103627,Siegel; Paul H.,9999,0,9999,0
1668284617979,ECE 200,043,103628,Sievenpiper; Daniel F.,9999,0,9999,0
1668284617979,ECE 200,044,103629,Sworder; David D.,9999,0,9999,0
1668284617979,ECE 200,045,103630,Taur; Yuan,9999,0,9999,0
1668284617979,ECE 200,046,103631,Touri; Behrouz,9999,0,9999,0
1668284617979,ECE 200,047,103632,Trivedi; Mohan M.,9999,0,9999,0
1668284617979,ECE 200,048,103633,Vasconcelos; Nuno,9999,0,9999,0
1668284617979,ECE 200,049,103634,Wang; Xiaolong,9999,0,9999,0
1668284617979,ECE 200,050,103635,Xie; Pengtao,9999,0,9999,0
1668284617979,ECE 200,051,103636,Yip; Michael,9999,0,9999,0
1668284617979,ECE 200,052,103637,Zeger; Kenneth A.,999,0,999,0
1668284617979,ECE 200,053,103638,Zhang; Xinyu,9999,0,9999,0
1668284617979,ECE 200,054,103639,Turakhia; Yatish Girish,9999,0,9999,0
1668284617979,ECE 200,055,103640,Kang; Mingu,9999,0,9999,0
1668284617979,ECE 200,056,103641,Shi; Yuanyuan,9999,0,9999,0
1668284617979,ECE 200,057,103642,Wang; Edward Jay,9999,0,9999,0
1668284617979,ECE 200,058,103643,Zheng; Yang,9999,0,9999,0
1668284618407,ECE 202,A00,103644,Kuzum; Duygu,0,0,0,0
1668284618833,ECE 212BN,A00,103646,Ng; Tse Nga,0,0,0,0
1668284619260,ECE 221,A00,111493,Staff,0,0,0,0
1668284619685,ECE 222B,A00,103647,Lomakin; Vitaliy,0,0,0,0
1668284620111,ECE 230B,A00,103648,Taur; Yuan,0,0,0,0
1668284620538,ECE 238B,A00,103649,Garay; Javier,0,0,0,0
1668284620971,ECE 240B,A00,112900,Fainman; Yeshaiahu,0,0,0,0
1668284621400,ECE 247A,A00,103650,Jokerst; Jesse Vincent,0,0,0,0
1668284621824,ECE 247B,A00,103651,Wang; Joseph,0,0,0,0
1668284622247,ECE 250,A00,103652,Siegel; Paul H.,0,0,0,0
1668284622763,ECE 251A,A00,103654,Rao; Bhaskar D.,0,0,0,0
1668284623192,ECE 257B,A00,103655,Bharadia; Dinesh,0,0,0,0
1668284623614,ECE 258A,A00,103656,Milstein; Laurence B.,0,0,0,0
1668284624039,ECE 260B,A00,103658,Kang; Mingu,0,0,0,0
1668284624462,ECE 264A,A00,103659,Galton; Ian A,0,0,0,0
1668284624891,ECE 265A,A00,103661,Gudem; Prasad S.S.,0,0,0,0
1668284625314,ECE 265D,A00,103662,Gudem; Prasad S.S.,0,0,0,0
1668284625739,ECE 268,A00,103663,Koushanfar; Farinaz,0,0,0,0
1668284626167,ECE 269,A01,103665,Pal; Piya,0,0,0,0
1668284626595,ECE 271B,A00,103666,Vasconcelos; Manuela,0,0,0,0
1668284627018,ECE 276A,A00,103667,Atanasov; Nikolay A.,0,0,0,0
1668284627441,ECE 277,A00,103668,An; Cheolhong,0,0,0,0
1668284627862,ECE 279,A00,117947,Hall; Drew A.,0,0,0,0
1668284628711,ECE 283,A00,103670,Hsueh; Tzu-Chien,0,0,0,0
1668284629139,ECE 284,A00,103671,Turakhia; Yatish Girish,0,0,0,0
1668284629564,ECE 285,A00,103672,Zheng; Yang,0,0,0,0
1668284629564,ECE 285,B00,103673,Sworder; David D.,0,0,0,0
1668284629986,ECE 287,A00,103676,Javidi; Tara,0,0,0,0
1668284630413,MATH 200B,A00,098023,Salehi Golsefidy; Alireza,12,0,15,3
1668284630848,MATH 202B,A00,098024,Rhoades; Brendon Patrick,9,0,15,6
1668284631277,MATH 203B,A00,098025,Oprea; Dragos N.,10,0,15,5
1668284631702,MATH 204B,A00,098026,Sorensen; Claus M,13,0,15,2
1668284632135,MATH 208,A00,098027,Izadi; Elham,7,0,10,3
1668284632557,MATH 209,A00,098028,Pollack; Aaron,10,0,10,0
1668284632981,MATH 211A,A00,112919,Rogalski; Daniel,9,0,10,1
1668284633403,MATH 211B,A00,112920,Seward; Brandon M.,9,0,10,1
1668284633835,MATH 218,A00,098029,Li; Bo,10,0,10,0
1668284634261,MATH 220B,A00,098030,Novak; Jonathan I,11,0,15,4
1668284634684,MATH 221A,A00,098031,Ebenfelt; Peter F,13,0,15,2
1668284635106,MATH 231B,A00,098032,Zlatos; Andrej,12,0,15,3
1668284635532,MATH 240B,A00,098033,Ni; Lei,9,0,15,6
1668284635954,MATH 243,A00,098034,Jekel; David Andrew,10,0,10,0
1668284636378,MATH 245A,A00,098035,Nie; Jiawang,0,0,15,16
1668284636801,MATH 248,A00,098036,Bejenaru; Ioan,10,0,10,0
1668284637224,MATH 250B,A00,098037,Spolaor; Luca,14,0,15,1
1668284637649,MATH 258,A00,098038,Ni; Lei,10,0,10,0
1668284638083,MATH 264B,A00,098041,Rhoades; Brendon Patrick,9,0,15,6
1668284638507,MATH 268,A00,098042,Buss; Samuel R,10,0,10,0
1668284638945,MATH 269,A00,098043,Rhoades; Brendon Patrick,10,0,10,0
1668284639375,MATH 270B,A00,098044,Li; Bo,10,0,15,5
1668284639799,MATH 272B,A00,098045,Holst; Michael J,13,0,15,2
1668284640231,MATH 273A,A00,098046,Tian; Xiaochuan,10,0,15,5
1668284640658,MATH 275,A01,098048,Tian; Xiaochuan,6,0,10,4
1668284641082,MATH 278A,A00,098049,Holst; Michael J,8,0,10,2
1668284641514,MATH 278B,A00,098050,Cloninger; Alexander,10,0,10,0
1668284641941,MATH 278C,A00,098051,Nie; Jiawang,7,0,10,3
1668284642366,MATH 280B,A00,098052,Zheng; Tianyi,8,0,15,7
1668284642793,MATH 281B,A00,098053,Bradic; Jelena,1,0,15,14
1668284643219,MATH 282B,A00,098054,Arias-Castro; Ery,0,0,15,15
1668284643642,MATH 285,A00,098055,Fitzsimmons; Patrick J,0,0,15,17
1668284644064,MATH 287B,A00,098056,Arias-Castro; Ery,2,0,15,13
1668284644487,MATH 288,A00,098057,Agarwal; Pooja,9,0,10,1
1668284644487,MATH 288,B00,098058,Zhang; Danna,8,0,10,2
1668284644487,MATH 288,C00,098059,Williams; Ruth J,9,0,10,1
1668284644913,MATH 290B,A00,098060,Roberts; Justin Deritter,13,0,15,2
1668284645337,MATH 292,A00,098061,Belmont; Eva Kinoshita,10,0,10,0
1668284645761,MATH 295,A00,098062,Suk; Andrew Hoon,48,0,50,2
1668284646189,MATH 296,A00,098063,Novak; Jonathan I,20,0,20,0
1668284646616,MATH 297,001,098064,Gamst; Anthony Collins,9997,0,9999,2
1668285146609,COGS 205,A00,101395,Chiba; Andrea,19,0,20,1
1668285147032,COGS 210B,001,101404,Greene; Deanna Jacquelyn,9998,0,9999,1
1668285147032,COGS 210B,002,101417,Xia; Haijun,9999,0,9999,0
1668285147032,COGS 210B,003,101422,Nitz; Douglas A.,9999,0,9999,0
1668285147032,COGS 210B,004,101423,Hollan; James D.,9998,0,9999,1
1668285147032,COGS 210B,005,101424,Deak; Gedeon O.,9998,0,9999,1
1668285147032,COGS 210B,006,101425,Rossano; Federico,9999,0,9999,0
1668285147464,COGS 211B,A00,101427,Coulson; Seana M,9996,0,9999,3
1668285147889,COGS 220,A00,101428,Hollan; James D.,0,0,25,25
1668285148314,COGS 229,A00,101429,Dow; Steven P,18,0,25,7
1668285148738,COGS 230,A00,101430,Klemmer; Scott R,12,0,17,5
1668285149160,COGS 234,A00,101431,Xia; Haijun,1,0,25,24
1668285149585,COGS 260,A00,101432,Kiyonaga; Anastasia,21,0,25,4
1668285149585,COGS 260,B00,101433,Kirsh; David Joel,15,0,25,10
1668285150012,CSE 202,A00,102371,Impagliazzo; Russell,0,0,0,0
1668285150434,CSE 203B,A01,102373,Cheng; Chung Kuan,0,0,0,0
1668285150857,CSE 208,A00,102374,Micciancio; Daniele,0,0,0,0
1668285151280,CSE 209A,A00,112895,Impagliazzo; Russell,0,0,15,15
1668285151731,CSE 209B,A00,108005,Bellare; Mihir,0,0,0,0
1668285152158,CSE 210,A00,113163,Coblenz; Michael J,0,0,0,0
1668285152583,CSE 219,A00,106111,Dow; Steven P,0,0,20,20
1668285153008,CSE 221,A00,102376,Voelker; Geoffrey M.,0,0,0,0
1668285153431,CSE 224,A01,102378,Porter; George M,0,0,0,0
1668285153856,CSE 229A,A00,102379,Savage; Stefan,0,0,0,0
1668285154279,CSE 229C,A00,102380,Munyaka; Imani N. S.,0,0,0,0
1668285154702,CSE 232B,A00,102382,Deutsch; Alin Bernard,0,0,0,0
1668285155136,CSE 234,A01,112904,Kumar; Arun Kumar,0,0,0,0
1668285155560,CSE 237A,A00,102383,Rosing; Tajana Simunic,0,0,0,0
1668285155986,CSE 239A,A00,102384,Deutsch; Alin Bernard,0,0,0,0
1668285156416,CSE 239B,A00,102385,Polikarpova; Nadezhda,0,0,0,0
1668285156838,CSE 240A,A00,102386,Pannuto; Patrick William,0,0,0,0
1668285157262,CSE 240B,A00,102387,Zhao; Jishen,0,0,0,0
1668285157699,CSE 241A,A00,106406,Kang; Mingu,0,0,0,0
1668285158126,CSE 249B,A00,102388,Kahng; Andrew Byun,0,0,8,8
1668285158561,CSE 251B,A01,102392,Cottrell; Garrison W,0,0,0,0
1668285158561,CSE 251B,A02,102393,Cottrell; Garrison W,0,0,0,0
1668285158985,CSE 252B,A00,102394,Ochoa; Benjamin Lawrence,0,0,0,0
1668285159409,CSE 257,A01,102396,Gao; Sicun,0,0,0,0
1668285159839,CSE 272,A00,102397,Li; Tzumao,0,0,0,0
1668285160263,CSE 274,A00,111323,Chern; Albert Ren-Haur,0,0,0,0
1668285160693,CSE 282,A00,102398,Pevzner; Pavel Arkadjevich,0,0,0,0
1668285161117,CSE 284,A00,114175,Gymrek; Melissa Ann,0,0,0,0
1668285161542,CSE 290,A00,102399,Chandraker; Manmohan Krishna,0,0,0,0
1668285161542,CSE 290,B00,102400,Vaccaro; Kristen Marie,0,0,25,25
1668285161542,CSE 290,C00,102414,Pannuto; Patrick William,0,0,25,25
1668285161542,CSE 290,D00,102427,Pevzner; Pavel Arkadjevich,0,0,0,0
1668285161542,CSE 290,E00,102429,Zhao; Jishen,0,0,0,0
1668285161542,CSE 290,F00,102436,Tullsen; Dean Michael,0,0,0,0
1668285161542,CSE 290,G00,102440,Christensen; Henrik I,0,0,20,20
1668285161980,CSE 291,A00,102443,Su; Hao,0,0,0,0
1668285161980,CSE 291,B00,102448,Polikarpova; Nadezhda,0,0,0,0
1668285161980,CSE 291,C00,102453,Vaccaro; Kristen Marie,0,0,0,0
1668285161980,CSE 291,D00,111343,Savage; Stefan,0,0,0,0
1668285161980,CSE 291,E00,116474,Claffy; Kimberly Claire,0,0,0,0
1668285161980,CSE 291,F00,116479,Pasquale; Joseph,0,0,0,0
1668285162414,CSE 293,001,119111,Bafna; Vineet,9999,0,9999,0
1668285162414,CSE 293,002,119118,Bellare; Mihir,9999,0,9999,0
1668285162414,CSE 293,003,119122,Berg-Kirkpatrick; Taylor D,9999,0,9999,0
1668285162414,CSE 293,004,119135,Christensen; Henrik I,9999,0,9999,0
1668285162414,CSE 293,005,119142,Cottrell; Garrison W,9999,0,9999,0
1668285162414,CSE 293,006,119146,Deutsch; Alin Bernard,9999,0,9999,0
1668285162414,CSE 293,007,119159,Esmaeilzadeh; Hadi,9999,0,9999,0
1668285162414,CSE 293,008,119166,Freund; Yoav,9999,0,9999,0
1668285162414,CSE 293,009,119170,Griswold; William G.,9999,0,9999,0
1668285162414,CSE 293,010,119183,Gymrek; Melissa Ann,9999,0,9999,0
1668285162414,CSE 293,011,119190,Heninger; Nadia A,9999,0,9999,0
1668285162414,CSE 293,012,119230,Impagliazzo; Russell,9999,0,9999,0
1668285162414,CSE 293,013,119232,Jhala; Ranjit,9999,0,9999,0
1668285162414,CSE 293,014,119233,Kahng; Andrew Byun,9999,0,9999,0
1668285162414,CSE 293,015,119298,Kane; Daniel Mertz,9999,0,9999,0
1668285162414,CSE 293,016,119299,Kriegman; David J,9999,0,9999,0
1668285162414,CSE 293,017,119300,Kumar; Arun Kumar,9999,0,9999,0
1668285162414,CSE 293,018,119301,Lerner; Sorin,9999,0,9999,0
1668285162414,CSE 293,019,119302,Lovett; Shachar,9999,0,9999,0
1668285162414,CSE 293,020,119303,McAuley; Julian John,9999,0,9999,0
1668285162414,CSE 293,021,119304,Micciancio; Daniele,9999,0,9999,0
1668285162414,CSE 293,022,119367,Orailoglu; Alex,9999,0,9999,0
1668285162414,CSE 293,023,119382,Paturi; Ramamohan,9999,0,9999,0
1668285162414,CSE 293,024,119404,Polikarpova; Nadezhda,9999,0,9999,0
1668285162414,CSE 293,025,119406,Politz; Joseph Gibbs,9999,0,9999,0
1668285162414,CSE 293,026,119411,Porter; George M,9999,0,9999,0
1668285162414,CSE 293,027,119414,Porter; Leonard Emerson,9999,0,9999,0
1668285162414,CSE 293,028,119416,Ramamoorthi; Ravi,9999,0,9999,0
1668285162414,CSE 293,029,119417,Sahoo; Debashis,9999,0,9999,0
1668285162414,CSE 293,030,119420,Saul; Lawrence,9999,0,9999,0
1668285162414,CSE 293,031,119421,Savage; Stefan,9999,0,9999,0
1668285162414,CSE 293,032,119425,Schulze; Jurgen P.,9999,0,9999,0
1668285162414,CSE 293,033,119426,Snoeren; Alex C.,9999,0,9999,0
1668285162414,CSE 293,034,119428,Shang; Jingbo,9999,0,9999,0
1668285162414,CSE 293,035,119430,Stefan; Deian,9999,0,9999,0
1668285162414,CSE 293,036,119431,Su; Hao,9999,0,9999,0
1668285162414,CSE 293,037,119433,Swanson; Steven James,9999,0,9999,0
1668285162414,CSE 293,038,119435,Tullsen; Dean Michael,9999,0,9999,0
1668285162414,CSE 293,039,119483,Voelker; Geoffrey M.,9999,0,9999,0
1668285162414,CSE 293,040,119537,Zhao; Jishen,9999,0,9999,0
1668285162414,CSE 293,041,119538,Zhou; Yuan-Yuan,9999,0,9999,0
1668285162414,CSE 293,042,119539,Gao; Sicun,9999,0,9999,0
1668285162414,CSE 293,043,119540,Weibel; Nadir,9999,0,9999,0
1668285162414,CSE 293,044,119541,Gupta; Rajesh K.,9999,0,9999,0
1668285162414,CSE 293,045,126410,Vaccaro; Kristen Marie,9999,0,9999,0
1668285162414,CSE 293,046,126411,Klemke; Richard,9999,0,9999,0
1668285162838,CSE 294,A00,102459,Voelker; Geoffrey M.,0,0,0,0
1668285162838,CSE 294,B00,111322,Orailoglu; Alex,0,0,0,0
1668285163262,DSE 201,A00,096914,Deutsch; Alin Bernard,30,0,30,0
1668285163685,DSE 210,A00,096915,Dasgupta; Sanjoy,30,0,30,0
1668285164108,DSE 260A,A00,096916,Altintas De Callaf; Ilkay,30,0,30,0
1668285164532,ECE 200,001,103586,Antipa; Nicholas A,9999,0,9999,0
1668285164532,ECE 200,002,103587,Atanasov; Nikolay A.,9999,0,9999,0
1668285164532,ECE 200,003,103588,Bharadia; Dinesh,9999,0,9999,0
1668285164532,ECE 200,004,103589,Cheng; Chung Kuan,9999,0,9999,0
1668285164532,ECE 200,005,103590,Cosman; Pamela C.,9999,0,9999,0
1668285164532,ECE 200,006,103591,Dayeh; Shadi Ahmad,9999,0,9999,0
1668285164532,ECE 200,007,103592,Fainman; Yeshaiahu,9999,0,9999,0
1668285164532,ECE 200,008,103593,Ford; Joseph Earl,9999,0,9999,0
1668285164532,ECE 200,009,103594,Franceschetti; Massimo,9999,0,9999,0
1668285164532,ECE 200,010,103595,Fullerton; Eric E,9999,0,9999,0
1668285164532,ECE 200,011,103596,Galton; Ian A,9999,0,9999,0
1668285164532,ECE 200,012,103597,Gilja; Vikash,9999,0,9999,0
1668285164532,ECE 200,013,103598,Hall; Drew A.,9999,0,9999,0
1668285164532,ECE 200,014,103599,Hsueh; Tzu-Chien,9999,0,9999,0
1668285164532,ECE 200,015,103600,Javidi; Tara,9999,0,9999,0
1668285164532,ECE 200,016,103601,Kahng; Andrew Byun,9999,0,9999,0
1668285164532,ECE 200,017,103602,Kim; Young-Han,9999,0,9999,0
1668285164532,ECE 200,018,103603,Koushanfar; Farinaz,9999,0,9999,0
1668285164532,ECE 200,019,103604,Kuzum; Duygu,9999,0,9999,0
1668285164532,ECE 200,020,103605,Le; Hanh-Phuc,9999,0,9999,0
1668285164532,ECE 200,021,103606,Lin; Bill,9999,0,9999,0
1668285164532,ECE 200,022,103607,Liu; Zhaowei,9998,0,9999,1
1668285164532,ECE 200,023,103608,Lo; Yu-Hwa,9999,0,9999,0
1668285164532,ECE 200,024,103609,Lomakin; Vitaliy,9999,0,9999,0
1668285164532,ECE 200,025,103610,Mercier; Patrick Philip,9999,0,9999,0
1668285164532,ECE 200,026,103611,Meyer; Florian,9999,0,9999,0
1668285164532,ECE 200,027,103612,Milstein; Laurence B.,9999,0,9999,0
1668285164532,ECE 200,028,103613,Mir Arabbaygi; Siavash,9999,0,9999,0
1668285164532,ECE 200,029,103614,Mookherjea; Shayan,9999,0,9999,0
1668285164532,ECE 200,030,103615,Morris; Karcher William,9999,0,9999,0
1668285164532,ECE 200,031,103616,Ng; Tse Nga,9999,0,9999,0
1668285164532,ECE 200,032,103617,Nguyen; Truong Quang,9999,0,9999,0
1668285164532,ECE 200,033,103618,Nomura; Kenji,9999,0,9999,0
1668285164532,ECE 200,034,103619,Orlitsky; Alon,9999,0,9999,0
1668285164532,ECE 200,035,103620,Pal; Piya,9999,0,9999,0
1668285164532,ECE 200,036,103621,Papen; George C.,9999,0,9999,0
1668285164532,ECE 200,037,103622,Radic; Stojan,9999,0,9999,0
1668285164532,ECE 200,038,103623,Rao; Bhaskar D.,9999,0,9999,0
1668285164532,ECE 200,039,103624,Rao; Ramesh R,9999,0,9999,0
1668285164532,ECE 200,040,103625,Rebeiz; Gabriel,9999,0,9999,0
1668285164532,ECE 200,041,103626,Sanford; John R,9999,0,9999,0
1668285164532,ECE 200,042,103627,Siegel; Paul H.,9999,0,9999,0
1668285164532,ECE 200,043,103628,Sievenpiper; Daniel F.,9999,0,9999,0
1668285164532,ECE 200,044,103629,Sworder; David D.,9999,0,9999,0
1668285164532,ECE 200,045,103630,Taur; Yuan,9999,0,9999,0
1668285164532,ECE 200,046,103631,Touri; Behrouz,9999,0,9999,0
1668285164532,ECE 200,047,103632,Trivedi; Mohan M.,9999,0,9999,0
1668285164532,ECE 200,048,103633,Vasconcelos; Nuno,9999,0,9999,0
1668285164532,ECE 200,049,103634,Wang; Xiaolong,9999,0,9999,0
1668285164532,ECE 200,050,103635,Xie; Pengtao,9999,0,9999,0
1668285164532,ECE 200,051,103636,Yip; Michael,9999,0,9999,0
1668285164532,ECE 200,052,103637,Zeger; Kenneth A.,999,0,999,0
1668285164532,ECE 200,053,103638,Zhang; Xinyu,9999,0,9999,0
1668285164532,ECE 200,054,103639,Turakhia; Yatish Girish,9999,0,9999,0
1668285164532,ECE 200,055,103640,Kang; Mingu,9999,0,9999,0
1668285164532,ECE 200,056,103641,Shi; Yuanyuan,9999,0,9999,0
1668285164532,ECE 200,057,103642,Wang; Edward Jay,9999,0,9999,0
1668285164532,ECE 200,058,103643,Zheng; Yang,9999,0,9999,0
1668285164957,ECE 202,A00,103644,Kuzum; Duygu,0,0,0,0
1668285165380,ECE 212BN,A00,103646,Ng; Tse Nga,0,0,0,0
1668285165802,ECE 221,A00,111493,Staff,0,0,0,0
1668285166229,ECE 222B,A00,103647,Lomakin; Vitaliy,0,0,0,0
1668285166653,ECE 230B,A00,103648,Taur; Yuan,0,0,0,0
1668285167078,ECE 238B,A00,103649,Garay; Javier,0,0,0,0
1668285167503,ECE 240B,A00,112900,Fainman; Yeshaiahu,0,0,0,0
1668285167929,ECE 247A,A00,103650,Jokerst; Jesse Vincent,0,0,0,0
1668285168352,ECE 247B,A00,103651,Wang; Joseph,0,0,0,0
1668285168778,ECE 250,A00,103652,Siegel; Paul H.,0,0,0,0
1668285169202,ECE 251A,A00,103654,Rao; Bhaskar D.,0,0,0,0
1668285169627,ECE 257B,A00,103655,Bharadia; Dinesh,0,0,0,0
1668285170054,ECE 258A,A00,103656,Milstein; Laurence B.,0,0,0,0
1668285170478,ECE 260B,A00,103658,Kang; Mingu,0,0,0,0
1668285170902,ECE 264A,A00,103659,Galton; Ian A,0,0,0,0
1668285171326,ECE 265A,A00,103661,Gudem; Prasad S.S.,0,0,0,0
1668285171753,ECE 265D,A00,103662,Gudem; Prasad S.S.,0,0,0,0
1668285172175,ECE 268,A00,103663,Koushanfar; Farinaz,0,0,0,0
1668285172598,ECE 269,A01,103665,Pal; Piya,0,0,0,0
1668285173021,ECE 271B,A00,103666,Vasconcelos; Manuela,0,0,0,0
1668285173448,ECE 276A,A00,103667,Atanasov; Nikolay A.,0,0,0,0
1668285173880,ECE 277,A00,103668,An; Cheolhong,0,0,0,0
1668285174304,ECE 279,A00,117947,Hall; Drew A.,0,0,0,0
1668285175157,ECE 283,A00,103670,Hsueh; Tzu-Chien,0,0,0,0
1668285175582,ECE 284,A00,103671,Turakhia; Yatish Girish,0,0,0,0
1668285176008,ECE 285,A00,103672,Zheng; Yang,0,0,0,0
1668285176008,ECE 285,B00,103673,Sworder; David D.,0,0,0,0
1668285176432,ECE 287,A00,103676,Javidi; Tara,0,0,0,0
1668285176858,MATH 200B,A00,098023,Salehi Golsefidy; Alireza,12,0,15,3
1668285177282,MATH 202B,A00,098024,Rhoades; Brendon Patrick,9,0,15,6
1668285177709,MATH 203B,A00,098025,Oprea; Dragos N.,10,0,15,5
1668285178132,MATH 204B,A00,098026,Sorensen; Claus M,13,0,15,2
1668285178554,MATH 208,A00,098027,Izadi; Elham,7,0,10,3
1668285178980,MATH 209,A00,098028,Pollack; Aaron,10,0,10,0
1668285179405,MATH 211A,A00,112919,Rogalski; Daniel,9,0,10,1
1668285179829,MATH 211B,A00,112920,Seward; Brandon M.,9,0,10,1
1668285180251,MATH 218,A00,098029,Li; Bo,10,0,10,0
1668285180677,MATH 220B,A00,098030,Novak; Jonathan I,11,0,15,4
1668285181110,MATH 221A,A00,098031,Ebenfelt; Peter F,13,0,15,2
1668285181536,MATH 231B,A00,098032,Zlatos; Andrej,12,0,15,3
1668285181967,MATH 240B,A00,098033,Ni; Lei,9,0,15,6
1668285182409,MATH 243,A00,098034,Jekel; David Andrew,10,0,10,0
1668285182833,MATH 245A,A00,098035,Nie; Jiawang,0,0,15,16
1668285183258,MATH 248,A00,098036,Bejenaru; Ioan,10,0,10,0
1668285183681,MATH 250B,A00,098037,Spolaor; Luca,14,0,15,1
1668285184110,MATH 258,A00,098038,Ni; Lei,10,0,10,0
1668285184537,MATH 264B,A00,098041,Rhoades; Brendon Patrick,9,0,15,6
1668285184960,MATH 268,A00,098042,Buss; Samuel R,10,0,10,0
1668285185386,MATH 269,A00,098043,Rhoades; Brendon Patrick,10,0,10,0
1668285185884,MATH 270B,A00,098044,Li; Bo,10,0,15,5
1668285186306,MATH 272B,A00,098045,Holst; Michael J,13,0,15,2
1668285186730,MATH 273A,A00,098046,Tian; Xiaochuan,10,0,15,5
1668285187158,MATH 275,A01,098048,Tian; Xiaochuan,6,0,10,4
1668285187583,MATH 278A,A00,098049,Holst; Michael J,8,0,10,2
1668285188010,MATH 278B,A00,098050,Cloninger; Alexander,10,0,10,0
1668285188435,MATH 278C,A00,098051,Nie; Jiawang,7,0,10,3
1668285188859,MATH 280B,A00,098052,Zheng; Tianyi,8,0,15,7
1668285189286,MATH 281B,A00,098053,Bradic; Jelena,1,0,15,14
1668285189708,MATH 282B,A00,098054,Arias-Castro; Ery,0,0,15,15
1668285190133,MATH 285,A00,098055,Fitzsimmons; Patrick J,0,0,15,17
1668285190557,MATH 287B,A00,098056,Arias-Castro; Ery,2,0,15,13
1668285190985,MATH 288,A00,098057,Agarwal; Pooja,9,0,10,1
1668285190985,MATH 288,B00,098058,Zhang; Danna,8,0,10,2
1668285190985,MATH 288,C00,098059,Williams; Ruth J,9,0,10,1
1668285191409,MATH 290B,A00,098060,Roberts; Justin Deritter,13,0,15,2
1668285191833,MATH 292,A00,098061,Belmont; Eva Kinoshita,10,0,10,0
1668285192259,MATH 295,A00,098062,Suk; Andrew Hoon,48,0,50,2
1668285192684,MATH 296,A00,098063,Novak; Jonathan I,20,0,20,0
1668285193110,MATH 297,001,098064,Gamst; Anthony Collins,9997,0,9999,2
1668285691874,COGS 205,A00,101395,Chiba; Andrea,19,0,20,1
1668285692299,COGS 210B,001,101404,Greene; Deanna Jacquelyn,9998,0,9999,1
1668285692299,COGS 210B,002,101417,Xia; Haijun,9999,0,9999,0
1668285692299,COGS 210B,003,101422,Nitz; Douglas A.,9999,0,9999,0
1668285692299,COGS 210B,004,101423,Hollan; James D.,9998,0,9999,1
1668285692299,COGS 210B,005,101424,Deak; Gedeon O.,9998,0,9999,1
1668285692299,COGS 210B,006,101425,Rossano; Federico,9999,0,9999,0
1668285692723,COGS 211B,A00,101427,Coulson; Seana M,9996,0,9999,3
1668285693148,COGS 220,A00,101428,Hollan; James D.,0,0,25,25
1668285693570,COGS 229,A00,101429,Dow; Steven P,18,0,25,7
1668285693994,COGS 230,A00,101430,Klemmer; Scott R,12,0,17,5
1668285694417,COGS 234,A00,101431,Xia; Haijun,1,0,25,24
1668285694841,COGS 260,A00,101432,Kiyonaga; Anastasia,21,0,25,4
1668285694841,COGS 260,B00,101433,Kirsh; David Joel,15,0,25,10
1668285695266,CSE 202,A00,102371,Impagliazzo; Russell,0,0,0,0
1668285695689,CSE 203B,A01,102373,Cheng; Chung Kuan,0,0,0,0
1668285696115,CSE 208,A00,102374,Micciancio; Daniele,0,0,0,0
1668285696537,CSE 209A,A00,112895,Impagliazzo; Russell,0,0,15,15
1668285696964,CSE 209B,A00,108005,Bellare; Mihir,0,0,0,0
1668285697390,CSE 210,A00,113163,Coblenz; Michael J,0,0,0,0
1668285697813,CSE 219,A00,106111,Dow; Steven P,0,0,20,20
1668285698239,CSE 221,A00,102376,Voelker; Geoffrey M.,0,0,0,0
1668285698662,CSE 224,A01,102378,Porter; George M,0,0,0,0
1668285699091,CSE 229A,A00,102379,Savage; Stefan,0,0,0,0
1668285699517,CSE 229C,A00,102380,Munyaka; Imani N. S.,0,0,0,0
1668285699940,CSE 232B,A00,102382,Deutsch; Alin Bernard,0,0,0,0
1668285700367,CSE 234,A01,112904,Kumar; Arun Kumar,0,0,0,0
1668285700794,CSE 237A,A00,102383,Rosing; Tajana Simunic,0,0,0,0
1668285701217,CSE 239A,A00,102384,Deutsch; Alin Bernard,0,0,0,0
1668285701644,CSE 239B,A00,102385,Polikarpova; Nadezhda,0,0,0,0
1668285702077,CSE 240A,A00,102386,Pannuto; Patrick William,0,0,0,0
1668285702501,CSE 240B,A00,102387,Zhao; Jishen,0,0,0,0
1668285702928,CSE 241A,A00,106406,Kang; Mingu,0,0,0,0
1668285703351,CSE 249B,A00,102388,Kahng; Andrew Byun,0,0,8,8
1668285703776,CSE 251B,A01,102392,Cottrell; Garrison W,0,0,0,0
1668285703776,CSE 251B,A02,102393,Cottrell; Garrison W,0,0,0,0
1668285704202,CSE 252B,A00,102394,Ochoa; Benjamin Lawrence,0,0,0,0
1668285704743,CSE 257,A01,102396,Gao; Sicun,0,0,0,0
1668285705170,CSE 272,A00,102397,Li; Tzumao,0,0,0,0
1668285705600,CSE 274,A00,111323,Chern; Albert Ren-Haur,0,0,0,0
1668285706029,CSE 282,A00,102398,Pevzner; Pavel Arkadjevich,0,0,0,0
1668285706455,CSE 284,A00,114175,Gymrek; Melissa Ann,0,0,0,0
1668285706882,CSE 290,A00,102399,Chandraker; Manmohan Krishna,0,0,0,0
1668285706882,CSE 290,B00,102400,Vaccaro; Kristen Marie,0,0,25,25
1668285706882,CSE 290,C00,102414,Pannuto; Patrick William,0,0,25,25
1668285706882,CSE 290,D00,102427,Pevzner; Pavel Arkadjevich,0,0,0,0
1668285706882,CSE 290,E00,102429,Zhao; Jishen,0,0,0,0
1668285706882,CSE 290,F00,102436,Tullsen; Dean Michael,0,0,0,0
1668285706882,CSE 290,G00,102440,Christensen; Henrik I,0,0,20,20
1668285707313,CSE 291,A00,102443,Su; Hao,0,0,0,0
1668285707313,CSE 291,B00,102448,Polikarpova; Nadezhda,0,0,0,0
1668285707313,CSE 291,C00,102453,Vaccaro; Kristen Marie,0,0,0,0
1668285707313,CSE 291,D00,111343,Savage; Stefan,0,0,0,0
1668285707313,CSE 291,E00,116474,Claffy; Kimberly Claire,0,0,0,0
1668285707313,CSE 291,F00,116479,Pasquale; Joseph,0,0,0,0
1668285707739,CSE 293,001,119111,Bafna; Vineet,9999,0,9999,0
1668285707739,CSE 293,002,119118,Bellare; Mihir,9999,0,9999,0
1668285707739,CSE 293,003,119122,Berg-Kirkpatrick; Taylor D,9999,0,9999,0
1668285707739,CSE 293,004,119135,Christensen; Henrik I,9999,0,9999,0
1668285707739,CSE 293,005,119142,Cottrell; Garrison W,9999,0,9999,0
1668285707739,CSE 293,006,119146,Deutsch; Alin Bernard,9999,0,9999,0
1668285707739,CSE 293,007,119159,Esmaeilzadeh; Hadi,9999,0,9999,0
1668285707739,CSE 293,008,119166,Freund; Yoav,9999,0,9999,0
1668285707739,CSE 293,009,119170,Griswold; William G.,9999,0,9999,0
1668285707739,CSE 293,010,119183,Gymrek; Melissa Ann,9999,0,9999,0
1668285707739,CSE 293,011,119190,Heninger; Nadia A,9999,0,9999,0
1668285707739,CSE 293,012,119230,Impagliazzo; Russell,9999,0,9999,0
1668285707739,CSE 293,013,119232,Jhala; Ranjit,9999,0,9999,0
1668285707739,CSE 293,014,119233,Kahng; Andrew Byun,9999,0,9999,0
1668285707739,CSE 293,015,119298,Kane; Daniel Mertz,9999,0,9999,0
1668285707739,CSE 293,016,119299,Kriegman; David J,9999,0,9999,0
1668285707739,CSE 293,017,119300,Kumar; Arun Kumar,9999,0,9999,0
1668285707739,CSE 293,018,119301,Lerner; Sorin,9999,0,9999,0
1668285707739,CSE 293,019,119302,Lovett; Shachar,9999,0,9999,0
1668285707739,CSE 293,020,119303,McAuley; Julian John,9999,0,9999,0
1668285707739,CSE 293,021,119304,Micciancio; Daniele,9999,0,9999,0
1668285707739,CSE 293,022,119367,Orailoglu; Alex,9999,0,9999,0
1668285707739,CSE 293,023,119382,Paturi; Ramamohan,9999,0,9999,0
1668285707739,CSE 293,024,119404,Polikarpova; Nadezhda,9999,0,9999,0
1668285707739,CSE 293,025,119406,Politz; Joseph Gibbs,9999,0,9999,0
1668285707739,CSE 293,026,119411,Porter; George M,9999,0,9999,0
1668285707739,CSE 293,027,119414,Porter; Leonard Emerson,9999,0,9999,0
1668285707739,CSE 293,028,119416,Ramamoorthi; Ravi,9999,0,9999,0
1668285707739,CSE 293,029,119417,Sahoo; Debashis,9999,0,9999,0
1668285707739,CSE 293,030,119420,Saul; Lawrence,9999,0,9999,0
1668285707739,CSE 293,031,119421,Savage; Stefan,9999,0,9999,0
1668285707739,CSE 293,032,119425,Schulze; Jurgen P.,9999,0,9999,0
1668285707739,CSE 293,033,119426,Snoeren; Alex C.,9999,0,9999,0
1668285707739,CSE 293,034,119428,Shang; Jingbo,9999,0,9999,0
1668285707739,CSE 293,035,119430,Stefan; Deian,9999,0,9999,0
1668285707739,CSE 293,036,119431,Su; Hao,9999,0,9999,0
1668285707739,CSE 293,037,119433,Swanson; Steven James,9999,0,9999,0
1668285707739,CSE 293,038,119435,Tullsen; Dean Michael,9999,0,9999,0
1668285707739,CSE 293,039,119483,Voelker; Geoffrey M.,9999,0,9999,0
1668285707739,CSE 293,040,119537,Zhao; Jishen,9999,0,9999,0
1668285707739,CSE 293,041,119538,Zhou; Yuan-Yuan,9999,0,9999,0
1668285707739,CSE 293,042,119539,Gao; Sicun,9999,0,9999,0
1668285707739,CSE 293,043,119540,Weibel; Nadir,9999,0,9999,0
1668285707739,CSE 293,044,119541,Gupta; Rajesh K.,9999,0,9999,0
1668285707739,CSE 293,045,126410,Vaccaro; Kristen Marie,9999,0,9999,0
1668285707739,CSE 293,046,126411,Klemke; Richard,9999,0,9999,0
1668285708163,CSE 294,A00,102459,Voelker; Geoffrey M.,0,0,0,0
1668285708163,CSE 294,B00,111322,Orailoglu; Alex,0,0,0,0
1668285708589,DSE 201,A00,096914,Deutsch; Alin Bernard,30,0,30,0
1668285709015,DSE 210,A00,096915,Dasgupta; Sanjoy,30,0,30,0
1668285709439,DSE 260A,A00,096916,Altintas De Callaf; Ilkay,30,0,30,0
1668285709876,ECE 200,001,103586,Antipa; Nicholas A,9999,0,9999,0
1668285709876,ECE 200,002,103587,Atanasov; Nikolay A.,9999,0,9999,0
1668285709876,ECE 200,003,103588,Bharadia; Dinesh,9999,0,9999,0
1668285709876,ECE 200,004,103589,Cheng; Chung Kuan,9999,0,9999,0
1668285709876,ECE 200,005,103590,Cosman; Pamela C.,9999,0,9999,0
1668285709876,ECE 200,006,103591,Dayeh; Shadi Ahmad,9999,0,9999,0
1668285709876,ECE 200,007,103592,Fainman; Yeshaiahu,9999,0,9999,0
1668285709876,ECE 200,008,103593,Ford; Joseph Earl,9999,0,9999,0
1668285709876,ECE 200,009,103594,Franceschetti; Massimo,9999,0,9999,0
1668285709876,ECE 200,010,103595,Fullerton; Eric E,9999,0,9999,0
1668285709876,ECE 200,011,103596,Galton; Ian A,9999,0,9999,0
1668285709876,ECE 200,012,103597,Gilja; Vikash,9999,0,9999,0
1668285709876,ECE 200,013,103598,Hall; Drew A.,9999,0,9999,0
1668285709876,ECE 200,014,103599,Hsueh; Tzu-Chien,9999,0,9999,0
1668285709876,ECE 200,015,103600,Javidi; Tara,9999,0,9999,0
1668285709876,ECE 200,016,103601,Kahng; Andrew Byun,9999,0,9999,0
1668285709876,ECE 200,017,103602,Kim; Young-Han,9999,0,9999,0
1668285709876,ECE 200,018,103603,Koushanfar; Farinaz,9999,0,9999,0
1668285709876,ECE 200,019,103604,Kuzum; Duygu,9999,0,9999,0
1668285709876,ECE 200,020,103605,Le; Hanh-Phuc,9999,0,9999,0
1668285709876,ECE 200,021,103606,Lin; Bill,9999,0,9999,0
1668285709876,ECE 200,022,103607,Liu; Zhaowei,9998,0,9999,1
1668285709876,ECE 200,023,103608,Lo; Yu-Hwa,9999,0,9999,0
1668285709876,ECE 200,024,103609,Lomakin; Vitaliy,9999,0,9999,0
1668285709876,ECE 200,025,103610,Mercier; Patrick Philip,9999,0,9999,0
1668285709876,ECE 200,026,103611,Meyer; Florian,9999,0,9999,0
1668285709876,ECE 200,027,103612,Milstein; Laurence B.,9999,0,9999,0
1668285709876,ECE 200,028,103613,Mir Arabbaygi; Siavash,9999,0,9999,0
1668285709876,ECE 200,029,103614,Mookherjea; Shayan,9999,0,9999,0
1668285709876,ECE 200,030,103615,Morris; Karcher William,9999,0,9999,0
1668285709876,ECE 200,031,103616,Ng; Tse Nga,9999,0,9999,0
1668285709876,ECE 200,032,103617,Nguyen; Truong Quang,9999,0,9999,0
1668285709876,ECE 200,033,103618,Nomura; Kenji,9999,0,9999,0
1668285709876,ECE 200,034,103619,Orlitsky; Alon,9999,0,9999,0
1668285709876,ECE 200,035,103620,Pal; Piya,9999,0,9999,0
1668285709876,ECE 200,036,103621,Papen; George C.,9999,0,9999,0
1668285709876,ECE 200,037,103622,Radic; Stojan,9999,0,9999,0
1668285709876,ECE 200,038,103623,Rao; Bhaskar D.,9999,0,9999,0
1668285709876,ECE 200,039,103624,Rao; Ramesh R,9999,0,9999,0
1668285709876,ECE 200,040,103625,Rebeiz; Gabriel,9999,0,9999,0
1668285709876,ECE 200,041,103626,Sanford; John R,9999,0,9999,0
1668285709876,ECE 200,042,103627,Siegel; Paul H.,9999,0,9999,0
1668285709876,ECE 200,043,103628,Sievenpiper; Daniel F.,9999,0,9999,0
1668285709876,ECE 200,044,103629,Sworder; David D.,9999,0,9999,0
1668285709876,ECE 200,045,103630,Taur; Yuan,9999,0,9999,0
1668285709876,ECE 200,046,103631,Touri; Behrouz,9999,0,9999,0
1668285709876,ECE 200,047,103632,Trivedi; Mohan M.,9999,0,9999,0
1668285709876,ECE 200,048,103633,Vasconcelos; Nuno,9999,0,9999,0
1668285709876,ECE 200,049,103634,Wang; Xiaolong,9999,0,9999,0
1668285709876,ECE 200,050,103635,Xie; Pengtao,9999,0,9999,0
1668285709876,ECE 200,051,103636,Yip; Michael,9999,0,9999,0
1668285709876,ECE 200,052,103637,Zeger; Kenneth A.,999,0,999,0
1668285709876,ECE 200,053,103638,Zhang; Xinyu,9999,0,9999,0
1668285709876,ECE 200,054,103639,Turakhia; Yatish Girish,9999,0,9999,0
1668285709876,ECE 200,055,103640,Kang; Mingu,9999,0,9999,0
1668285709876,ECE 200,056,103641,Shi; Yuanyuan,9999,0,9999,0
1668285709876,ECE 200,057,103642,Wang; Edward Jay,9999,0,9999,0
1668285709876,ECE 200,058,103643,Zheng; Yang,9999,0,9999,0
1668285710302,ECE 202,A00,103644,Kuzum; Duygu,0,0,0,0
1668285710743,ECE 212BN,A00,103646,Ng; Tse Nga,0,0,0,0
1668285711169,ECE 221,A00,111493,Staff,0,0,0,0
1668285711598,ECE 222B,A00,103647,Lomakin; Vitaliy,0,0,0,0
1668285712022,ECE 230B,A00,103648,Taur; Yuan,0,0,0,0
1668285712449,ECE 238B,A00,103649,Garay; Javier,0,0,0,0
1668285712877,ECE 240B,A00,112900,Fainman; Yeshaiahu,0,0,0,0
1668285713303,ECE 247A,A00,103650,Jokerst; Jesse Vincent,0,0,0,0
1668285713726,ECE 247B,A00,103651,Wang; Joseph,0,0,0,0
1668285714151,ECE 250,A00,103652,Siegel; Paul H.,0,0,0,0
1668285714574,ECE 251A,A00,103654,Rao; Bhaskar D.,0,0,0,0
1668285714999,ECE 257B,A00,103655,Bharadia; Dinesh,0,0,0,0
1668285715427,ECE 258A,A00,103656,Milstein; Laurence B.,0,0,0,0
1668285715850,ECE 260B,A00,103658,Kang; Mingu,0,0,0,0
1668285716273,ECE 264A,A00,103659,Galton; Ian A,0,0,0,0
1668285716706,ECE 265A,A00,103661,Gudem; Prasad S.S.,0,0,0,0
1668285717130,ECE 265D,A00,103662,Gudem; Prasad S.S.,0,0,0,0
1668285717557,ECE 268,A00,103663,Koushanfar; Farinaz,0,0,0,0
1668285717980,ECE 269,A01,103665,Pal; Piya,0,0,0,0
1668285718403,ECE 271B,A00,103666,Vasconcelos; Manuela,0,0,0,0
1668285718828,ECE 276A,A00,103667,Atanasov; Nikolay A.,0,0,0,0
1668285719254,ECE 277,A00,103668,An; Cheolhong,0,0,0,0
1668285719679,ECE 279,A00,117947,Hall; Drew A.,0,0,0,0
1668285720539,ECE 283,A00,103670,Hsueh; Tzu-Chien,0,0,0,0
1668285720965,ECE 284,A00,103671,Turakhia; Yatish Girish,0,0,0,0
1668285721389,ECE 285,A00,103672,Zheng; Yang,0,0,0,0
1668285721389,ECE 285,B00,103673,Sworder; David D.,0,0,0,0
1668285721813,ECE 287,A00,103676,Javidi; Tara,0,0,0,0
1668285722239,MATH 200B,A00,098023,Salehi Golsefidy; Alireza,12,0,15,3
1668285722665,MATH 202B,A00,098024,Rhoades; Brendon Patrick,9,0,15,6
1668285723089,MATH 203B,A00,098025,Oprea; Dragos N.,10,0,15,5
1668285723511,MATH 204B,A00,098026,Sorensen; Claus M,13,0,15,2
1668285723935,MATH 208,A00,098027,Izadi; Elham,7,0,10,3
1668285724359,MATH 209,A00,098028,Pollack; Aaron,10,0,10,0
1668285724792,MATH 211A,A00,112919,Rogalski; Daniel,9,0,10,1
1668285725216,MATH 211B,A00,112920,Seward; Brandon M.,9,0,10,1
1668285725647,MATH 218,A00,098029,Li; Bo,10,0,10,0
1668285726069,MATH 220B,A00,098030,Novak; Jonathan I,11,0,15,4
1668285726496,MATH 221A,A00,098031,Ebenfelt; Peter F,13,0,15,2
1668285726923,MATH 231B,A00,098032,Zlatos; Andrej,12,0,15,3
1668285727351,MATH 240B,A00,098033,Ni; Lei,9,0,15,6
1668285727786,MATH 243,A00,098034,Jekel; David Andrew,10,0,10,0
1668285728209,MATH 245A,A00,098035,Nie; Jiawang,0,0,15,16
1668285728634,MATH 248,A00,098036,Bejenaru; Ioan,10,0,10,0
1668285729060,MATH 250B,A00,098037,Spolaor; Luca,14,0,15,1
1668285729484,MATH 258,A00,098038,Ni; Lei,10,0,10,0
1668285729911,MATH 264B,A00,098041,Rhoades; Brendon Patrick,9,0,15,6
1668285730335,MATH 268,A00,098042,Buss; Samuel R,10,0,10,0
1668285730761,MATH 269,A00,098043,Rhoades; Brendon Patrick,10,0,10,0
1668285731189,MATH 270B,A00,098044,Li; Bo,10,0,15,5
1668285731615,MATH 272B,A00,098045,Holst; Michael J,13,0,15,2
1668285732041,MATH 273A,A00,098046,Tian; Xiaochuan,10,0,15,5
1668285732464,MATH 275,A01,098048,Tian; Xiaochuan,6,0,10,4
1668285732887,MATH 278A,A00,098049,Holst; Michael J,8,0,10,2
1668285733310,MATH 278B,A00,098050,Cloninger; Alexander,10,0,10,0
1668285733740,MATH 278C,A00,098051,Nie; Jiawang,7,0,10,3
1668285734163,MATH 280B,A00,098052,Zheng; Tianyi,8,0,15,7
1668285734593,MATH 281B,A00,098053,Bradic; Jelena,1,0,15,14
1668285735017,MATH 282B,A00,098054,Arias-Castro; Ery,0,0,15,15
1668285735441,MATH 285,A00,098055,Fitzsimmons; Patrick J,0,0,15,17
1668285735863,MATH 287B,A00,098056,Arias-Castro; Ery,2,0,15,13
1668285736287,MATH 288,A00,098057,Agarwal; Pooja,9,0,10,1
1668285736287,MATH 288,B00,098058,Zhang; Danna,8,0,10,2
1668285736287,MATH 288,C00,098059,Williams; Ruth J,9,0,10,1
1668285736711,MATH 290B,A00,098060,Roberts; Justin Deritter,13,0,15,2
1668285737138,MATH 292,A00,098061,Belmont; Eva Kinoshita,10,0,10,0
1668285737564,MATH 295,A00,098062,Suk; Andrew Hoon,48,0,50,2
1668285737990,MATH 296,A00,098063,Novak; Jonathan I,20,0,20,0
1668285738417,MATH 297,001,098064,Gamst; Anthony Collins,9997,0,9999,2
1668286237282,COGS 205,A00,101395,Chiba; Andrea,19,0,20,1
1668286237705,COGS 210B,001,101404,Greene; Deanna Jacquelyn,9998,0,9999,1
1668286237705,COGS 210B,002,101417,Xia; Haijun,9999,0,9999,0
1668286237705,COGS 210B,003,101422,Nitz; Douglas A.,9999,0,9999,0
1668286237705,COGS 210B,004,101423,Hollan; James D.,9998,0,9999,1
1668286237705,COGS 210B,005,101424,Deak; Gedeon O.,9998,0,9999,1
1668286237705,COGS 210B,006,101425,Rossano; Federico,9999,0,9999,0
1668286238129,COGS 211B,A00,101427,Coulson; Seana M,9996,0,9999,3
1668286238552,COGS 220,A00,101428,Hollan; James D.,0,0,25,25
1668286238976,COGS 229,A00,101429,Dow; Steven P,18,0,25,7
1668286239399,COGS 230,A00,101430,Klemmer; Scott R,12,0,17,5
1668286239821,COGS 234,A00,101431,Xia; Haijun,1,0,25,24
1668286240248,COGS 260,A00,101432,Kiyonaga; Anastasia,21,0,25,4
1668286240248,COGS 260,B00,101433,Kirsh; David Joel,15,0,25,10
1668286240671,CSE 202,A00,102371,Impagliazzo; Russell,0,0,0,0
1668286241094,CSE 203B,A01,102373,Cheng; Chung Kuan,0,0,0,0
1668286241519,CSE 208,A00,102374,Micciancio; Daniele,0,0,0,0
1668286241941,CSE 209A,A00,112895,Impagliazzo; Russell,0,0,15,15
1668286242365,CSE 209B,A00,108005,Bellare; Mihir,0,0,0,0
1668286242787,CSE 210,A00,113163,Coblenz; Michael J,0,0,0,0
1668286243214,CSE 219,A00,106111,Dow; Steven P,0,0,20,20
1668286243639,CSE 221,A00,102376,Voelker; Geoffrey M.,0,0,0,0
1668286244062,CSE 224,A01,102378,Porter; George M,0,0,0,0
1668286244490,CSE 229A,A00,102379,Savage; Stefan,0,0,0,0
1668286244915,CSE 229C,A00,102380,Munyaka; Imani N. S.,0,0,0,0
1668286245399,CSE 232B,A00,102382,Deutsch; Alin Bernard,0,0,0,0
1668286245822,CSE 234,A01,112904,Kumar; Arun Kumar,0,0,0,0
1668286246251,CSE 237A,A00,102383,Rosing; Tajana Simunic,0,0,0,0
1668286246675,CSE 239A,A00,102384,Deutsch; Alin Bernard,0,0,0,0
1668286247098,CSE 239B,A00,102385,Polikarpova; Nadezhda,0,0,0,0
1668286247534,CSE 240A,A00,102386,Pannuto; Patrick William,0,0,0,0
1668286247962,CSE 240B,A00,102387,Zhao; Jishen,0,0,0,0
1668286248389,CSE 241A,A00,106406,Kang; Mingu,0,0,0,0
1668286248810,CSE 249B,A00,102388,Kahng; Andrew Byun,0,0,8,8
1668286249246,CSE 251B,A01,102392,Cottrell; Garrison W,0,0,0,0
1668286249246,CSE 251B,A02,102393,Cottrell; Garrison W,0,0,0,0
1668286249668,CSE 252B,A00,102394,Ochoa; Benjamin Lawrence,0,0,0,0
1668286250103,CSE 257,A01,102396,Gao; Sicun,0,0,0,0
1668286250526,CSE 272,A00,102397,Li; Tzumao,0,0,0,0
1668286250951,CSE 274,A00,111323,Chern; Albert Ren-Haur,0,0,0,0
1668286251373,CSE 282,A00,102398,Pevzner; Pavel Arkadjevich,0,0,0,0
1668286251800,CSE 284,A00,114175,Gymrek; Melissa Ann,0,0,0,0
1668286252224,CSE 290,A00,102399,Chandraker; Manmohan Krishna,0,0,0,0
1668286252224,CSE 290,B00,102400,Vaccaro; Kristen Marie,0,0,25,25
1668286252224,CSE 290,C00,102414,Pannuto; Patrick William,0,0,25,25
1668286252224,CSE 290,D00,102427,Pevzner; Pavel Arkadjevich,0,0,0,0
1668286252224,CSE 290,E00,102429,Zhao; Jishen,0,0,0,0
1668286252224,CSE 290,F00,102436,Tullsen; Dean Michael,0,0,0,0
1668286252224,CSE 290,G00,102440,Christensen; Henrik I,0,0,20,20
1668286252653,CSE 291,A00,102443,Su; Hao,0,0,0,0
1668286252653,CSE 291,B00,102448,Polikarpova; Nadezhda,0,0,0,0
1668286252653,CSE 291,C00,102453,Vaccaro; Kristen Marie,0,0,0,0
1668286252653,CSE 291,D00,111343,Savage; Stefan,0,0,0,0
1668286252653,CSE 291,E00,116474,Claffy; Kimberly Claire,0,0,0,0
1668286252653,CSE 291,F00,116479,Pasquale; Joseph,0,0,0,0
1668286253080,CSE 293,001,119111,Bafna; Vineet,9999,0,9999,0
1668286253080,CSE 293,002,119118,Bellare; Mihir,9999,0,9999,0
1668286253080,CSE 293,003,119122,Berg-Kirkpatrick; Taylor D,9999,0,9999,0
1668286253080,CSE 293,004,119135,Christensen; Henrik I,9999,0,9999,0
1668286253080,CSE 293,005,119142,Cottrell; Garrison W,9999,0,9999,0
1668286253080,CSE 293,006,119146,Deutsch; Alin Bernard,9999,0,9999,0
1668286253080,CSE 293,007,119159,Esmaeilzadeh; Hadi,9999,0,9999,0
1668286253080,CSE 293,008,119166,Freund; Yoav,9999,0,9999,0
1668286253080,CSE 293,009,119170,Griswold; William G.,9999,0,9999,0
1668286253080,CSE 293,010,119183,Gymrek; Melissa Ann,9999,0,9999,0
1668286253080,CSE 293,011,119190,Heninger; Nadia A,9999,0,9999,0
1668286253080,CSE 293,012,119230,Impagliazzo; Russell,9999,0,9999,0
1668286253080,CSE 293,013,119232,Jhala; Ranjit,9999,0,9999,0
1668286253080,CSE 293,014,119233,Kahng; Andrew Byun,9999,0,9999,0
1668286253080,CSE 293,015,119298,Kane; Daniel Mertz,9999,0,9999,0
1668286253080,CSE 293,016,119299,Kriegman; David J,9999,0,9999,0
1668286253080,CSE 293,017,119300,Kumar; Arun Kumar,9999,0,9999,0
1668286253080,CSE 293,018,119301,Lerner; Sorin,9999,0,9999,0
1668286253080,CSE 293,019,119302,Lovett; Shachar,9999,0,9999,0
1668286253080,CSE 293,020,119303,McAuley; Julian John,9999,0,9999,0
1668286253080,CSE 293,021,119304,Micciancio; Daniele,9999,0,9999,0
1668286253080,CSE 293,022,119367,Orailoglu; Alex,9999,0,9999,0
1668286253080,CSE 293,023,119382,Paturi; Ramamohan,9999,0,9999,0
1668286253080,CSE 293,024,119404,Polikarpova; Nadezhda,9999,0,9999,0
1668286253080,CSE 293,025,119406,Politz; Joseph Gibbs,9999,0,9999,0
1668286253080,CSE 293,026,119411,Porter; George M,9999,0,9999,0
1668286253080,CSE 293,027,119414,Porter; Leonard Emerson,9999,0,9999,0
1668286253080,CSE 293,028,119416,Ramamoorthi; Ravi,9999,0,9999,0
1668286253080,CSE 293,029,119417,Sahoo; Debashis,9999,0,9999,0
1668286253080,CSE 293,030,119420,Saul; Lawrence,9999,0,9999,0
1668286253080,CSE 293,031,119421,Savage; Stefan,9999,0,9999,0
1668286253080,CSE 293,032,119425,Schulze; Jurgen P.,9999,0,9999,0
1668286253080,CSE 293,033,119426,Snoeren; Alex C.,9999,0,9999,0
1668286253080,CSE 293,034,119428,Shang; Jingbo,9999,0,9999,0
1668286253080,CSE 293,035,119430,Stefan; Deian,9999,0,9999,0
1668286253080,CSE 293,036,119431,Su; Hao,9999,0,9999,0
1668286253080,CSE 293,037,119433,Swanson; Steven James,9999,0,9999,0
1668286253080,CSE 293,038,119435,Tullsen; Dean Michael,9999,0,9999,0
1668286253080,CSE 293,039,119483,Voelker; Geoffrey M.,9999,0,9999,0
1668286253080,CSE 293,040,119537,Zhao; Jishen,9999,0,9999,0
1668286253080,CSE 293,041,119538,Zhou; Yuan-Yuan,9999,0,9999,0
1668286253080,CSE 293,042,119539,Gao; Sicun,9999,0,9999,0
1668286253080,CSE 293,043,119540,Weibel; Nadir,9999,0,9999,0
1668286253080,CSE 293,044,119541,Gupta; Rajesh K.,9999,0,9999,0
1668286253080,CSE 293,045,126410,Vaccaro; Kristen Marie,9999,0,9999,0
1668286253080,CSE 293,046,126411,Klemke; Richard,9999,0,9999,0
1668286253505,CSE 294,A00,102459,Voelker; Geoffrey M.,0,0,0,0
1668286253505,CSE 294,B00,111322,Orailoglu; Alex,0,0,0,0
1668286253930,DSE 201,A00,096914,Deutsch; Alin Bernard,30,0,30,0
1668286254356,DSE 210,A00,096915,Dasgupta; Sanjoy,30,0,30,0
1668286254784,DSE 260A,A00,096916,Altintas De Callaf; Ilkay,30,0,30,0
1668286255213,ECE 200,001,103586,Antipa; Nicholas A,9999,0,9999,0
1668286255213,ECE 200,002,103587,Atanasov; Nikolay A.,9999,0,9999,0
1668286255213,ECE 200,003,103588,Bharadia; Dinesh,9999,0,9999,0
1668286255213,ECE 200,004,103589,Cheng; Chung Kuan,9999,0,9999,0
1668286255213,ECE 200,005,103590,Cosman; Pamela C.,9999,0,9999,0
1668286255213,ECE 200,006,103591,Dayeh; Shadi Ahmad,9999,0,9999,0
1668286255213,ECE 200,007,103592,Fainman; Yeshaiahu,9999,0,9999,0
1668286255213,ECE 200,008,103593,Ford; Joseph Earl,9999,0,9999,0
1668286255213,ECE 200,009,103594,Franceschetti; Massimo,9999,0,9999,0
1668286255213,ECE 200,010,103595,Fullerton; Eric E,9999,0,9999,0
1668286255213,ECE 200,011,103596,Galton; Ian A,9999,0,9999,0
1668286255213,ECE 200,012,103597,Gilja; Vikash,9999,0,9999,0
1668286255213,ECE 200,013,103598,Hall; Drew A.,9999,0,9999,0
1668286255213,ECE 200,014,103599,Hsueh; Tzu-Chien,9999,0,9999,0
1668286255213,ECE 200,015,103600,Javidi; Tara,9999,0,9999,0
1668286255213,ECE 200,016,103601,Kahng; Andrew Byun,9999,0,9999,0
1668286255213,ECE 200,017,103602,Kim; Young-Han,9999,0,9999,0
1668286255213,ECE 200,018,103603,Koushanfar; Farinaz,9999,0,9999,0
1668286255213,ECE 200,019,103604,Kuzum; Duygu,9999,0,9999,0
1668286255213,ECE 200,020,103605,Le; Hanh-Phuc,9999,0,9999,0
1668286255213,ECE 200,021,103606,Lin; Bill,9999,0,9999,0
1668286255213,ECE 200,022,103607,Liu; Zhaowei,9998,0,9999,1
1668286255213,ECE 200,023,103608,Lo; Yu-Hwa,9999,0,9999,0
1668286255213,ECE 200,024,103609,Lomakin; Vitaliy,9999,0,9999,0
1668286255213,ECE 200,025,103610,Mercier; Patrick Philip,9999,0,9999,0
1668286255213,ECE 200,026,103611,Meyer; Florian,9999,0,9999,0
1668286255213,ECE 200,027,103612,Milstein; Laurence B.,9999,0,9999,0
1668286255213,ECE 200,028,103613,Mir Arabbaygi; Siavash,9999,0,9999,0
1668286255213,ECE 200,029,103614,Mookherjea; Shayan,9999,0,9999,0
1668286255213,ECE 200,030,103615,Morris; Karcher William,9999,0,9999,0
1668286255213,ECE 200,031,103616,Ng; Tse Nga,9999,0,9999,0
1668286255213,ECE 200,032,103617,Nguyen; Truong Quang,9999,0,9999,0
1668286255213,ECE 200,033,103618,Nomura; Kenji,9999,0,9999,0
1668286255213,ECE 200,034,103619,Orlitsky; Alon,9999,0,9999,0
1668286255213,ECE 200,035,103620,Pal; Piya,9999,0,9999,0
1668286255213,ECE 200,036,103621,Papen; George C.,9999,0,9999,0
1668286255213,ECE 200,037,103622,Radic; Stojan,9999,0,9999,0
1668286255213,ECE 200,038,103623,Rao; Bhaskar D.,9999,0,9999,0
1668286255213,ECE 200,039,103624,Rao; Ramesh R,9999,0,9999,0
1668286255213,ECE 200,040,103625,Rebeiz; Gabriel,9999,0,9999,0
1668286255213,ECE 200,041,103626,Sanford; John R,9999,0,9999,0
1668286255213,ECE 200,042,103627,Siegel; Paul H.,9999,0,9999,0
1668286255213,ECE 200,043,103628,Sievenpiper; Daniel F.,9999,0,9999,0
1668286255213,ECE 200,044,103629,Sworder; David D.,9999,0,9999,0
1668286255213,ECE 200,045,103630,Taur; Yuan,9999,0,9999,0
1668286255213,ECE 200,046,103631,Touri; Behrouz,9999,0,9999,0
1668286255213,ECE 200,047,103632,Trivedi; Mohan M.,9999,0,9999,0
1668286255213,ECE 200,048,103633,Vasconcelos; Nuno,9999,0,9999,0
1668286255213,ECE 200,049,103634,Wang; Xiaolong,9999,0,9999,0
1668286255213,ECE 200,050,103635,Xie; Pengtao,9999,0,9999,0
1668286255213,ECE 200,051,103636,Yip; Michael,9999,0,9999,0
1668286255213,ECE 200,052,103637,Zeger; Kenneth A.,999,0,999,0
1668286255213,ECE 200,053,103638,Zhang; Xinyu,9999,0,9999,0
1668286255213,ECE 200,054,103639,Turakhia; Yatish Girish,9999,0,9999,0
1668286255213,ECE 200,055,103640,Kang; Mingu,9999,0,9999,0
1668286255213,ECE 200,056,103641,Shi; Yuanyuan,9999,0,9999,0
1668286255213,ECE 200,057,103642,Wang; Edward Jay,9999,0,9999,0
1668286255213,ECE 200,058,103643,Zheng; Yang,9999,0,9999,0
1668286255636,ECE 202,A00,103644,Kuzum; Duygu,0,0,0,0
1668286256061,ECE 212BN,A00,103646,Ng; Tse Nga,0,0,0,0
1668286256484,ECE 221,A00,111493,Staff,0,0,0,0
1668286256910,ECE 222B,A00,103647,Lomakin; Vitaliy,0,0,0,0
1668286257337,ECE 230B,A00,103648,Taur; Yuan,0,0,0,0
1668286257765,ECE 238B,A00,103649,Garay; Javier,0,0,0,0
1668286258191,ECE 240B,A00,112900,Fainman; Yeshaiahu,0,0,0,0
1668286258618,ECE 247A,A00,103650,Jokerst; Jesse Vincent,0,0,0,0
1668286259040,ECE 247B,A00,103651,Wang; Joseph,0,0,0,0
1668286259469,ECE 250,A00,103652,Siegel; Paul H.,0,0,0,0
1668286259896,ECE 251A,A00,103654,Rao; Bhaskar D.,0,0,0,0
1668286260330,ECE 257B,A00,103655,Bharadia; Dinesh,0,0,0,0
1668286260752,ECE 258A,A00,103656,Milstein; Laurence B.,0,0,0,0
1668286261176,ECE 260B,A00,103658,Kang; Mingu,0,0,0,0
1668286261612,ECE 264A,A00,103659,Galton; Ian A,0,0,0,0
1668286262037,ECE 265A,A00,103661,Gudem; Prasad S.S.,0,0,0,0
1668286262461,ECE 265D,A00,103662,Gudem; Prasad S.S.,0,0,0,0
1668286262884,ECE 268,A00,103663,Koushanfar; Farinaz,0,0,0,0
1668286263307,ECE 269,A01,103665,Pal; Piya,0,0,0,0
1668286263731,ECE 271B,A00,103666,Vasconcelos; Manuela,0,0,0,0
1668286264164,ECE 276A,A00,103667,Atanasov; Nikolay A.,0,0,0,0
1668286264587,ECE 277,A00,103668,An; Cheolhong,0,0,0,0
1668286265013,ECE 279,A00,117947,Hall; Drew A.,0,0,0,0
1668286265861,ECE 283,A00,103670,Hsueh; Tzu-Chien,0,0,0,0
1668286266286,ECE 284,A00,103671,Turakhia; Yatish Girish,0,0,0,0
1668286266784,ECE 285,A00,103672,Zheng; Yang,0,0,0,0
1668286266784,ECE 285,B00,103673,Sworder; David D.,0,0,0,0
1668286267210,ECE 287,A00,103676,Javidi; Tara,0,0,0,0
1668286267632,MATH 200B,A00,098023,Salehi Golsefidy; Alireza,12,0,15,3
1668286268064,MATH 202B,A00,098024,Rhoades; Brendon Patrick,9,0,15,6
1668286268493,MATH 203B,A00,098025,Oprea; Dragos N.,10,0,15,5
1668286268917,MATH 204B,A00,098026,Sorensen; Claus M,13,0,15,2
1668286269342,MATH 208,A00,098027,Izadi; Elham,7,0,10,3
1668286269773,MATH 209,A00,098028,Pollack; Aaron,10,0,10,0
1668286270200,MATH 211A,A00,112919,Rogalski; Daniel,9,0,10,1
1668286270623,MATH 211B,A00,112920,Seward; Brandon M.,9,0,10,1
1668286271049,MATH 218,A00,098029,Li; Bo,10,0,10,0
1668286271476,MATH 220B,A00,098030,Novak; Jonathan I,11,0,15,4
1668286271907,MATH 221A,A00,098031,Ebenfelt; Peter F,13,0,15,2
1668286272333,MATH 231B,A00,098032,Zlatos; Andrej,12,0,15,3
1668286272759,MATH 240B,A00,098033,Ni; Lei,9,0,15,6
1668286273183,MATH 243,A00,098034,Jekel; David Andrew,10,0,10,0
1668286273606,MATH 245A,A00,098035,Nie; Jiawang,0,0,15,16
1668286274032,MATH 248,A00,098036,Bejenaru; Ioan,10,0,10,0
1668286274454,MATH 250B,A00,098037,Spolaor; Luca,14,0,15,1
1668286274880,MATH 258,A00,098038,Ni; Lei,10,0,10,0
1668286275304,MATH 264B,A00,098041,Rhoades; Brendon Patrick,9,0,15,6
1668286275727,MATH 268,A00,098042,Buss; Samuel R,10,0,10,0
1668286276150,MATH 269,A00,098043,Rhoades; Brendon Patrick,10,0,10,0
1668286276578,MATH 270B,A00,098044,Li; Bo,10,0,15,5
1668286277003,MATH 272B,A00,098045,Holst; Michael J,13,0,15,2
1668286277431,MATH 273A,A00,098046,Tian; Xiaochuan,10,0,15,5
1668286277856,MATH 275,A01,098048,Tian; Xiaochuan,6,0,10,4
1668286278280,MATH 278A,A00,098049,Holst; Michael J,8,0,10,2
1668286278702,MATH 278B,A00,098050,Cloninger; Alexander,10,0,10,0
1668286279125,MATH 278C,A00,098051,Nie; Jiawang,7,0,10,3
1668286279548,MATH 280B,A00,098052,Zheng; Tianyi,8,0,15,7
1668286279974,MATH 281B,A00,098053,Bradic; Jelena,1,0,15,14
1668286280398,MATH 282B,A00,098054,Arias-Castro; Ery,0,0,15,15
1668286280822,MATH 285,A00,098055,Fitzsimmons; Patrick J,0,0,15,17
1668286281248,MATH 287B,A00,098056,Arias-Castro; Ery,2,0,15,13
1668286281672,MATH 288,A00,098057,Agarwal; Pooja,9,0,10,1
1668286281672,MATH 288,B00,098058,Zhang; Danna,8,0,10,2
1668286281672,MATH 288,C00,098059,Williams; Ruth J,9,0,10,1
1668286282096,MATH 290B,A00,098060,Roberts; Justin Deritter,13,0,15,2
1668286282520,MATH 292,A00,098061,Belmont; Eva Kinoshita,10,0,10,0
1668286282944,MATH 295,A00,098062,Suk; Andrew Hoon,48,0,50,2
1668286283366,MATH 296,A00,098063,Novak; Jonathan I,20,0,20,0
1668286283790,MATH 297,001,098064,Gamst; Anthony Collins,9997,0,9999,2
1668286782012,COGS 205,A00,101395,Chiba; Andrea,19,0,20,1
1668286782441,COGS 210B,001,101404,Greene; Deanna Jacquelyn,9998,0,9999,1
1668286782441,COGS 210B,002,101417,Xia; Haijun,9999,0,9999,0
1668286782441,COGS 210B,003,101422,Nitz; Douglas A.,9999,0,9999,0
1668286782441,COGS 210B,004,101423,Hollan; James D.,9998,0,9999,1
1668286782441,COGS 210B,005,101424,Deak; Gedeon O.,9998,0,9999,1
1668286782441,COGS 210B,006,101425,Rossano; Federico,9999,0,9999,0
1668286782865,COGS 211B,A00,101427,Coulson; Seana M,9996,0,9999,3
1668286783290,COGS 220,A00,101428,Hollan; James D.,0,0,25,25
1668286783716,COGS 229,A00,101429,Dow; Steven P,18,0,25,7
1668286784140,COGS 230,A00,101430,Klemmer; Scott R,12,0,17,5
1668286784566,COGS 234,A00,101431,Xia; Haijun,1,0,25,24
1668286785063,COGS 260,A00,101432,Kiyonaga; Anastasia,21,0,25,4
1668286785063,COGS 260,B00,101433,Kirsh; David Joel,15,0,25,10
1668286785484,CSE 202,A00,102371,Impagliazzo; Russell,0,0,0,0
1668286785908,CSE 203B,A01,102373,Cheng; Chung Kuan,0,0,0,0
1668286786332,CSE 208,A00,102374,Micciancio; Daniele,0,0,0,0
1668286786755,CSE 209A,A00,112895,Impagliazzo; Russell,0,0,15,15
1668286787179,CSE 209B,A00,108005,Bellare; Mihir,0,0,0,0
1668286787606,CSE 210,A00,113163,Coblenz; Michael J,0,0,0,0
1668286788031,CSE 219,A00,106111,Dow; Steven P,0,0,20,20
1668286788452,CSE 221,A00,102376,Voelker; Geoffrey M.,0,0,0,0
1668286788874,CSE 224,A01,102378,Porter; George M,0,0,0,0
1668286789296,CSE 229A,A00,102379,Savage; Stefan,0,0,0,0
1668286789727,CSE 229C,A00,102380,Munyaka; Imani N. S.,0,0,0,0
1668286790149,CSE 232B,A00,102382,Deutsch; Alin Bernard,0,0,0,0
1668286790578,CSE 234,A01,112904,Kumar; Arun Kumar,0,0,0,0
1668286791014,CSE 237A,A00,102383,Rosing; Tajana Simunic,0,0,0,0
1668286791437,CSE 239A,A00,102384,Deutsch; Alin Bernard,0,0,0,0
1668286791871,CSE 239B,A00,102385,Polikarpova; Nadezhda,0,0,0,0
1668286792294,CSE 240A,A00,102386,Pannuto; Patrick William,0,0,0,0
1668286792718,CSE 240B,A00,102387,Zhao; Jishen,0,0,0,0
1668286793141,CSE 241A,A00,106406,Kang; Mingu,0,0,0,0
1668286793563,CSE 249B,A00,102388,Kahng; Andrew Byun,0,0,8,8
1668286793986,CSE 251B,A01,102392,Cottrell; Garrison W,0,0,0,0
1668286793986,CSE 251B,A02,102393,Cottrell; Garrison W,0,0,0,0
1668286794411,CSE 252B,A00,102394,Ochoa; Benjamin Lawrence,0,0,0,0
1668286794834,CSE 257,A01,102396,Gao; Sicun,0,0,0,0
1668286795261,CSE 272,A00,102397,Li; Tzumao,0,0,0,0
1668286795685,CSE 274,A00,111323,Chern; Albert Ren-Haur,0,0,0,0
1668286796109,CSE 282,A00,102398,Pevzner; Pavel Arkadjevich,0,0,0,0
1668286796533,CSE 284,A00,114175,Gymrek; Melissa Ann,0,0,0,0
1668286796960,CSE 290,A00,102399,Chandraker; Manmohan Krishna,0,0,0,0
1668286796960,CSE 290,B00,102400,Vaccaro; Kristen Marie,0,0,25,25
1668286796960,CSE 290,C00,102414,Pannuto; Patrick William,0,0,25,25
1668286796960,CSE 290,D00,102427,Pevzner; Pavel Arkadjevich,0,0,0,0
1668286796960,CSE 290,E00,102429,Zhao; Jishen,0,0,0,0
1668286796960,CSE 290,F00,102436,Tullsen; Dean Michael,0,0,0,0
1668286796960,CSE 290,G00,102440,Christensen; Henrik I,0,0,20,20
1668286797394,CSE 291,A00,102443,Su; Hao,0,0,0,0
1668286797394,CSE 291,B00,102448,Polikarpova; Nadezhda,0,0,0,0
1668286797394,CSE 291,C00,102453,Vaccaro; Kristen Marie,0,0,0,0
1668286797394,CSE 291,D00,111343,Savage; Stefan,0,0,0,0
1668286797394,CSE 291,E00,116474,Claffy; Kimberly Claire,0,0,0,0
1668286797394,CSE 291,F00,116479,Pasquale; Joseph,0,0,0,0
1668286797827,CSE 293,001,119111,Bafna; Vineet,9999,0,9999,0
1668286797827,CSE 293,002,119118,Bellare; Mihir,9999,0,9999,0
1668286797827,CSE 293,003,119122,Berg-Kirkpatrick; Taylor D,9999,0,9999,0
1668286797827,CSE 293,004,119135,Christensen; Henrik I,9999,0,9999,0
1668286797827,CSE 293,005,119142,Cottrell; Garrison W,9999,0,9999,0
1668286797827,CSE 293,006,119146,Deutsch; Alin Bernard,9999,0,9999,0
1668286797827,CSE 293,007,119159,Esmaeilzadeh; Hadi,9999,0,9999,0
1668286797827,CSE 293,008,119166,Freund; Yoav,9999,0,9999,0
1668286797827,CSE 293,009,119170,Griswold; William G.,9999,0,9999,0
1668286797827,CSE 293,010,119183,Gymrek; Melissa Ann,9999,0,9999,0
1668286797827,CSE 293,011,119190,Heninger; Nadia A,9999,0,9999,0
1668286797827,CSE 293,012,119230,Impagliazzo; Russell,9999,0,9999,0
1668286797827,CSE 293,013,119232,Jhala; Ranjit,9999,0,9999,0
1668286797827,CSE 293,014,119233,Kahng; Andrew Byun,9999,0,9999,0
1668286797827,CSE 293,015,119298,Kane; Daniel Mertz,9999,0,9999,0
1668286797827,CSE 293,016,119299,Kriegman; David J,9999,0,9999,0
1668286797827,CSE 293,017,119300,Kumar; Arun Kumar,9999,0,9999,0
1668286797827,CSE 293,018,119301,Lerner; Sorin,9999,0,9999,0
1668286797827,CSE 293,019,119302,Lovett; Shachar,9999,0,9999,0
1668286797827,CSE 293,020,119303,McAuley; Julian John,9999,0,9999,0
1668286797827,CSE 293,021,119304,Micciancio; Daniele,9999,0,9999,0
1668286797827,CSE 293,022,119367,Orailoglu; Alex,9999,0,9999,0
1668286797827,CSE 293,023,119382,Paturi; Ramamohan,9999,0,9999,0
1668286797827,CSE 293,024,119404,Polikarpova; Nadezhda,9999,0,9999,0
1668286797827,CSE 293,025,119406,Politz; Joseph Gibbs,9999,0,9999,0
1668286797827,CSE 293,026,119411,Porter; George M,9999,0,9999,0
1668286797827,CSE 293,027,119414,Porter; Leonard Emerson,9999,0,9999,0
1668286797827,CSE 293,028,119416,Ramamoorthi; Ravi,9999,0,9999,0
1668286797827,CSE 293,029,119417,Sahoo; Debashis,9999,0,9999,0
1668286797827,CSE 293,030,119420,Saul; Lawrence,9999,0,9999,0
1668286797827,CSE 293,031,119421,Savage; Stefan,9999,0,9999,0
1668286797827,CSE 293,032,119425,Schulze; Jurgen P.,9999,0,9999,0
1668286797827,CSE 293,033,119426,Snoeren; Alex C.,9999,0,9999,0
1668286797827,CSE 293,034,119428,Shang; Jingbo,9999,0,9999,0
1668286797827,CSE 293,035,119430,Stefan; Deian,9999,0,9999,0
1668286797827,CSE 293,036,119431,Su; Hao,9999,0,9999,0
1668286797827,CSE 293,037,119433,Swanson; Steven James,9999,0,9999,0
1668286797827,CSE 293,038,119435,Tullsen; Dean Michael,9999,0,9999,0
1668286797827,CSE 293,039,119483,Voelker; Geoffrey M.,9999,0,9999,0
1668286797827,CSE 293,040,119537,Zhao; Jishen,9999,0,9999,0
1668286797827,CSE 293,041,119538,Zhou; Yuan-Yuan,9999,0,9999,0
1668286797827,CSE 293,042,119539,Gao; Sicun,9999,0,9999,0
1668286797827,CSE 293,043,119540,Weibel; Nadir,9999,0,9999,0
1668286797827,CSE 293,044,119541,Gupta; Rajesh K.,9999,0,9999,0
1668286797827,CSE 293,045,126410,Vaccaro; Kristen Marie,9999,0,9999,0
1668286797827,CSE 293,046,126411,Klemke; Richard,9999,0,9999,0
1668286798254,CSE 294,A00,102459,Voelker; Geoffrey M.,0,0,0,0
1668286798254,CSE 294,B00,111322,Orailoglu; Alex,0,0,0,0
1668286798688,DSE 201,A00,096914,Deutsch; Alin Bernard,30,0,30,0
1668286799114,DSE 210,A00,096915,Dasgupta; Sanjoy,30,0,30,0
1668286799542,DSE 260A,A00,096916,Altintas De Callaf; Ilkay,30,0,30,0
1668286799980,ECE 200,001,103586,Antipa; Nicholas A,9999,0,9999,0
1668286799980,ECE 200,002,103587,Atanasov; Nikolay A.,9999,0,9999,0
1668286799980,ECE 200,003,103588,Bharadia; Dinesh,9999,0,9999,0
1668286799980,ECE 200,004,103589,Cheng; Chung Kuan,9999,0,9999,0
1668286799980,ECE 200,005,103590,Cosman; Pamela C.,9999,0,9999,0
1668286799980,ECE 200,006,103591,Dayeh; Shadi Ahmad,9999,0,9999,0
1668286799980,ECE 200,007,103592,Fainman; Yeshaiahu,9999,0,9999,0
1668286799980,ECE 200,008,103593,Ford; Joseph Earl,9999,0,9999,0
1668286799980,ECE 200,009,103594,Franceschetti; Massimo,9999,0,9999,0
1668286799980,ECE 200,010,103595,Fullerton; Eric E,9999,0,9999,0
1668286799980,ECE 200,011,103596,Galton; Ian A,9999,0,9999,0
1668286799980,ECE 200,012,103597,Gilja; Vikash,9999,0,9999,0
1668286799980,ECE 200,013,103598,Hall; Drew A.,9999,0,9999,0
1668286799980,ECE 200,014,103599,Hsueh; Tzu-Chien,9999,0,9999,0
1668286799980,ECE 200,015,103600,Javidi; Tara,9999,0,9999,0
1668286799980,ECE 200,016,103601,Kahng; Andrew Byun,9999,0,9999,0
1668286799980,ECE 200,017,103602,Kim; Young-Han,9999,0,9999,0
1668286799980,ECE 200,018,103603,Koushanfar; Farinaz,9999,0,9999,0
1668286799980,ECE 200,019,103604,Kuzum; Duygu,9999,0,9999,0
1668286799980,ECE 200,020,103605,Le; Hanh-Phuc,9999,0,9999,0
1668286799980,ECE 200,021,103606,Lin; Bill,9999,0,9999,0
1668286799980,ECE 200,022,103607,Liu; Zhaowei,9998,0,9999,1
1668286799980,ECE 200,023,103608,Lo; Yu-Hwa,9999,0,9999,0
1668286799980,ECE 200,024,103609,Lomakin; Vitaliy,9999,0,9999,0
1668286799980,ECE 200,025,103610,Mercier; Patrick Philip,9999,0,9999,0
1668286799980,ECE 200,026,103611,Meyer; Florian,9999,0,9999,0
1668286799980,ECE 200,027,103612,Milstein; Laurence B.,9999,0,9999,0
1668286799980,ECE 200,028,103613,Mir Arabbaygi; Siavash,9999,0,9999,0
1668286799980,ECE 200,029,103614,Mookherjea; Shayan,9999,0,9999,0
1668286799980,ECE 200,030,103615,Morris; Karcher William,9999,0,9999,0
1668286799980,ECE 200,031,103616,Ng; Tse Nga,9999,0,9999,0
1668286799980,ECE 200,032,103617,Nguyen; Truong Quang,9999,0,9999,0
1668286799980,ECE 200,033,103618,Nomura; Kenji,9999,0,9999,0
1668286799980,ECE 200,034,103619,Orlitsky; Alon,9999,0,9999,0
1668286799980,ECE 200,035,103620,Pal; Piya,9999,0,9999,0
1668286799980,ECE 200,036,103621,Papen; George C.,9999,0,9999,0
1668286799980,ECE 200,037,103622,Radic; Stojan,9999,0,9999,0
1668286799980,ECE 200,038,103623,Rao; Bhaskar D.,9999,0,9999,0
1668286799980,ECE 200,039,103624,Rao; Ramesh R,9999,0,9999,0
1668286799980,ECE 200,040,103625,Rebeiz; Gabriel,9999,0,9999,0
1668286799980,ECE 200,041,103626,Sanford; John R,9999,0,9999,0
1668286799980,ECE 200,042,103627,Siegel; Paul H.,9999,0,9999,0
1668286799980,ECE 200,043,103628,Sievenpiper; Daniel F.,9999,0,9999,0
1668286799980,ECE 200,044,103629,Sworder; David D.,9999,0,9999,0
1668286799980,ECE 200,045,103630,Taur; Yuan,9999,0,9999,0
1668286799980,ECE 200,046,103631,Touri; Behrouz,9999,0,9999,0
1668286799980,ECE 200,047,103632,Trivedi; Mohan M.,9999,0,9999,0
1668286799980,ECE 200,048,103633,Vasconcelos; Nuno,9999,0,9999,0
1668286799980,ECE 200,049,103634,Wang; Xiaolong,9999,0,9999,0
1668286799980,ECE 200,050,103635,Xie; Pengtao,9999,0,9999,0
1668286799980,ECE 200,051,103636,Yip; Michael,9999,0,9999,0
1668286799980,ECE 200,052,103637,Zeger; Kenneth A.,999,0,999,0
1668286799980,ECE 200,053,103638,Zhang; Xinyu,9999,0,9999,0
1668286799980,ECE 200,054,103639,Turakhia; Yatish Girish,9999,0,9999,0
1668286799980,ECE 200,055,103640,Kang; Mingu,9999,0,9999,0
1668286799980,ECE 200,056,103641,Shi; Yuanyuan,9999,0,9999,0
1668286799980,ECE 200,057,103642,Wang; Edward Jay,9999,0,9999,0
1668286799980,ECE 200,058,103643,Zheng; Yang,9999,0,9999,0
1668286800407,ECE 202,A00,103644,Kuzum; Duygu,0,0,0,0
1668286800835,ECE 212BN,A00,103646,Ng; Tse Nga,0,0,0,0
1668286801260,ECE 221,A00,111493,Staff,0,0,0,0
1668286801685,ECE 222B,A00,103647,Lomakin; Vitaliy,0,0,0,0
1668286802121,ECE 230B,A00,103648,Taur; Yuan,0,0,0,0
1668286802543,ECE 238B,A00,103649,Garay; Javier,0,0,0,0
1668286802969,ECE 240B,A00,112900,Fainman; Yeshaiahu,0,0,0,0
1668286803400,ECE 247A,A00,103650,Jokerst; Jesse Vincent,0,0,0,0
1668286803826,ECE 247B,A00,103651,Wang; Joseph,0,0,0,0
1668286804249,ECE 250,A00,103652,Siegel; Paul H.,0,0,0,0
1668286804672,ECE 251A,A00,103654,Rao; Bhaskar D.,0,0,0,0
1668286805093,ECE 257B,A00,103655,Bharadia; Dinesh,0,0,0,0
1668286805516,ECE 258A,A00,103656,Milstein; Laurence B.,0,0,0,0
1668286805940,ECE 260B,A00,103658,Kang; Mingu,0,0,0,0
1668286806382,ECE 264A,A00,103659,Galton; Ian A,0,0,0,0
1668286806807,ECE 265A,A00,103661,Gudem; Prasad S.S.,0,0,0,0
1668286807229,ECE 265D,A00,103662,Gudem; Prasad S.S.,0,0,0,0
1668286807656,ECE 268,A00,103663,Koushanfar; Farinaz,0,0,0,0
1668286808077,ECE 269,A01,103665,Pal; Piya,0,0,0,0
1668286808513,ECE 271B,A00,103666,Vasconcelos; Manuela,0,0,0,0
1668286808938,ECE 276A,A00,103667,Atanasov; Nikolay A.,0,0,0,0
1668286809362,ECE 277,A00,103668,An; Cheolhong,0,0,0,0
1668286809783,ECE 279,A00,117947,Hall; Drew A.,0,0,0,0
1668286810634,ECE 283,A00,103670,Hsueh; Tzu-Chien,0,0,0,0
1668286811058,ECE 284,A00,103671,Turakhia; Yatish Girish,0,0,0,0
1668286811484,ECE 285,A00,103672,Zheng; Yang,0,0,0,0
1668286811484,ECE 285,B00,103673,Sworder; David D.,0,0,0,0
1668286811911,ECE 287,A00,103676,Javidi; Tara,0,0,0,0
1668286812334,MATH 200B,A00,098023,Salehi Golsefidy; Alireza,12,0,15,3
1668286812756,MATH 202B,A00,098024,Rhoades; Brendon Patrick,9,0,15,6
1668286813178,MATH 203B,A00,098025,Oprea; Dragos N.,10,0,15,5
1668286813602,MATH 204B,A00,098026,Sorensen; Claus M,13,0,15,2
1668286814027,MATH 208,A00,098027,Izadi; Elham,7,0,10,3
1668286814449,MATH 209,A00,098028,Pollack; Aaron,10,0,10,0
1668286814877,MATH 211A,A00,112919,Rogalski; Daniel,9,0,10,1
1668286815300,MATH 211B,A00,112920,Seward; Brandon M.,9,0,10,1
1668286815722,MATH 218,A00,098029,Li; Bo,10,0,10,0
1668286816148,MATH 220B,A00,098030,Novak; Jonathan I,11,0,15,4
1668286816572,MATH 221A,A00,098031,Ebenfelt; Peter F,13,0,15,2
1668286817007,MATH 231B,A00,098032,Zlatos; Andrej,12,0,15,3
1668286817430,MATH 240B,A00,098033,Ni; Lei,9,0,15,6
1668286817853,MATH 243,A00,098034,Jekel; David Andrew,10,0,10,0
1668286818276,MATH 245A,A00,098035,Nie; Jiawang,0,0,15,16
1668286818700,MATH 248,A00,098036,Bejenaru; Ioan,10,0,10,0
1668286819126,MATH 250B,A00,098037,Spolaor; Luca,14,0,15,1
1668286819548,MATH 258,A00,098038,Ni; Lei,10,0,10,0
1668286819974,MATH 264B,A00,098041,Rhoades; Brendon Patrick,9,0,15,6
1668286820400,MATH 268,A00,098042,Buss; Samuel R,10,0,10,0
1668286820826,MATH 269,A00,098043,Rhoades; Brendon Patrick,10,0,10,0
1668286821252,MATH 270B,A00,098044,Li; Bo,10,0,15,5
1668286821676,MATH 272B,A00,098045,Holst; Michael J,13,0,15,2
1668286822100,MATH 273A,A00,098046,Tian; Xiaochuan,10,0,15,5
1668286822525,MATH 275,A01,098048,Tian; Xiaochuan,6,0,10,4
1668286822948,MATH 278A,A00,098049,Holst; Michael J,8,0,10,2
1668286823374,MATH 278B,A00,098050,Cloninger; Alexander,10,0,10,0
1668286823799,MATH 278C,A00,098051,Nie; Jiawang,7,0,10,3
1668286824222,MATH 280B,A00,098052,Zheng; Tianyi,8,0,15,7
1668286824645,MATH 281B,A00,098053,Bradic; Jelena,1,0,15,14
1668286825071,MATH 282B,A00,098054,Arias-Castro; Ery,0,0,15,15
1668286825495,MATH 285,A00,098055,Fitzsimmons; Patrick J,0,0,15,17
1668286825919,MATH 287B,A00,098056,Arias-Castro; Ery,2,0,15,13
1668286826341,MATH 288,A00,098057,Agarwal; Pooja,9,0,10,1
1668286826341,MATH 288,B00,098058,Zhang; Danna,8,0,10,2
1668286826341,MATH 288,C00,098059,Williams; Ruth J,9,0,10,1
1668286826765,MATH 290B,A00,098060,Roberts; Justin Deritter,13,0,15,2
1668286827189,MATH 292,A00,098061,Belmont; Eva Kinoshita,10,0,10,0
1668286827611,MATH 295,A00,098062,Suk; Andrew Hoon,48,0,50,2
1668286828108,MATH 296,A00,098063,Novak; Jonathan I,20,0,20,0
1668286828566,MATH 297,001,098064,Gamst; Anthony Collins,9997,0,9999,2
1668287327291,COGS 205,A00,101395,Chiba; Andrea,19,0,20,1
1668287327716,COGS 210B,001,101404,Greene; Deanna Jacquelyn,9998,0,9999,1
1668287327716,COGS 210B,002,101417,Xia; Haijun,9999,0,9999,0
1668287327716,COGS 210B,003,101422,Nitz; Douglas A.,9999,0,9999,0
1668287327716,COGS 210B,004,101423,Hollan; James D.,9998,0,9999,1
1668287327716,COGS 210B,005,101424,Deak; Gedeon O.,9998,0,9999,1
1668287327716,COGS 210B,006,101425,Rossano; Federico,9999,0,9999,0
1668287328145,COGS 211B,A00,101427,Coulson; Seana M,9996,0,9999,3
1668287328568,COGS 220,A00,101428,Hollan; James D.,0,0,25,25
1668287328996,COGS 229,A00,101429,Dow; Steven P,18,0,25,7
1668287329418,COGS 230,A00,101430,Klemmer; Scott R,12,0,17,5
1668287329845,COGS 234,A00,101431,Xia; Haijun,1,0,25,24
1668287330271,COGS 260,A00,101432,Kiyonaga; Anastasia,21,0,25,4
1668287330271,COGS 260,B00,101433,Kirsh; David Joel,15,0,25,10
1668287330694,CSE 202,A00,102371,Impagliazzo; Russell,0,0,0,0
1668287331117,CSE 203B,A01,102373,Cheng; Chung Kuan,0,0,0,0
1668287331544,CSE 208,A00,102374,Micciancio; Daniele,0,0,0,0
1668287331965,CSE 209A,A00,112895,Impagliazzo; Russell,0,0,15,15
1668287332390,CSE 209B,A00,108005,Bellare; Mihir,0,0,0,0
1668287332817,CSE 210,A00,113163,Coblenz; Michael J,0,0,0,0
1668287333241,CSE 219,A00,106111,Dow; Steven P,0,0,20,20
1668287333668,CSE 221,A00,102376,Voelker; Geoffrey M.,0,0,0,0
1668287334093,CSE 224,A01,102378,Porter; George M,0,0,0,0
1668287334519,CSE 229A,A00,102379,Savage; Stefan,0,0,0,0
1668287334942,CSE 229C,A00,102380,Munyaka; Imani N. S.,0,0,0,0
1668287335364,CSE 232B,A00,102382,Deutsch; Alin Bernard,0,0,0,0
1668287335792,CSE 234,A01,112904,Kumar; Arun Kumar,0,0,0,0
1668287336216,CSE 237A,A00,102383,Rosing; Tajana Simunic,0,0,0,0
1668287336640,CSE 239A,A00,102384,Deutsch; Alin Bernard,0,0,0,0
1668287337072,CSE 239B,A00,102385,Polikarpova; Nadezhda,0,0,0,0
1668287337495,CSE 240A,A00,102386,Pannuto; Patrick William,0,0,0,0
1668287337917,CSE 240B,A00,102387,Zhao; Jishen,0,0,0,0
1668287338344,CSE 241A,A00,106406,Kang; Mingu,0,0,0,0
1668287338768,CSE 249B,A00,102388,Kahng; Andrew Byun,0,0,8,8
1668287339194,CSE 251B,A01,102392,Cottrell; Garrison W,0,0,0,0
1668287339194,CSE 251B,A02,102393,Cottrell; Garrison W,0,0,0,0
1668287339619,CSE 252B,A00,102394,Ochoa; Benjamin Lawrence,0,0,0,0
1668287340042,CSE 257,A01,102396,Gao; Sicun,0,0,0,0
1668287340467,CSE 272,A00,102397,Li; Tzumao,0,0,0,0
1668287340892,CSE 274,A00,111323,Chern; Albert Ren-Haur,0,0,0,0
1668287341316,CSE 282,A00,102398,Pevzner; Pavel Arkadjevich,0,0,0,0
1668287341743,CSE 284,A00,114175,Gymrek; Melissa Ann,0,0,0,0
1668287342168,CSE 290,A00,102399,Chandraker; Manmohan Krishna,0,0,0,0
1668287342168,CSE 290,B00,102400,Vaccaro; Kristen Marie,0,0,25,25
1668287342168,CSE 290,C00,102414,Pannuto; Patrick William,0,0,25,25
1668287342168,CSE 290,D00,102427,Pevzner; Pavel Arkadjevich,0,0,0,0
1668287342168,CSE 290,E00,102429,Zhao; Jishen,0,0,0,0
1668287342168,CSE 290,F00,102436,Tullsen; Dean Michael,0,0,0,0
1668287342168,CSE 290,G00,102440,Christensen; Henrik I,0,0,20,20
1668287342597,CSE 291,A00,102443,Su; Hao,0,0,0,0
1668287342597,CSE 291,B00,102448,Polikarpova; Nadezhda,0,0,0,0
1668287342597,CSE 291,C00,102453,Vaccaro; Kristen Marie,0,0,0,0
1668287342597,CSE 291,D00,111343,Savage; Stefan,0,0,0,0
1668287342597,CSE 291,E00,116474,Claffy; Kimberly Claire,0,0,0,0
1668287342597,CSE 291,F00,116479,Pasquale; Joseph,0,0,0,0
1668287343026,CSE 293,001,119111,Bafna; Vineet,9999,0,9999,0
1668287343026,CSE 293,002,119118,Bellare; Mihir,9999,0,9999,0
1668287343026,CSE 293,003,119122,Berg-Kirkpatrick; Taylor D,9999,0,9999,0
1668287343026,CSE 293,004,119135,Christensen; Henrik I,9999,0,9999,0
1668287343026,CSE 293,005,119142,Cottrell; Garrison W,9999,0,9999,0
1668287343026,CSE 293,006,119146,Deutsch; Alin Bernard,9999,0,9999,0
1668287343026,CSE 293,007,119159,Esmaeilzadeh; Hadi,9999,0,9999,0
1668287343026,CSE 293,008,119166,Freund; Yoav,9999,0,9999,0
1668287343026,CSE 293,009,119170,Griswold; William G.,9999,0,9999,0
1668287343026,CSE 293,010,119183,Gymrek; Melissa Ann,9999,0,9999,0
1668287343026,CSE 293,011,119190,Heninger; Nadia A,9999,0,9999,0
1668287343026,CSE 293,012,119230,Impagliazzo; Russell,9999,0,9999,0
1668287343026,CSE 293,013,119232,Jhala; Ranjit,9999,0,9999,0
1668287343026,CSE 293,014,119233,Kahng; Andrew Byun,9999,0,9999,0
1668287343026,CSE 293,015,119298,Kane; Daniel Mertz,9999,0,9999,0
1668287343026,CSE 293,016,119299,Kriegman; David J,9999,0,9999,0
1668287343026,CSE 293,017,119300,Kumar; Arun Kumar,9999,0,9999,0
1668287343026,CSE 293,018,119301,Lerner; Sorin,9999,0,9999,0
1668287343026,CSE 293,019,119302,Lovett; Shachar,9999,0,9999,0
1668287343026,CSE 293,020,119303,McAuley; Julian John,9999,0,9999,0
1668287343026,CSE 293,021,119304,Micciancio; Daniele,9999,0,9999,0
1668287343026,CSE 293,022,119367,Orailoglu; Alex,9999,0,9999,0
1668287343026,CSE 293,023,119382,Paturi; Ramamohan,9999,0,9999,0
1668287343026,CSE 293,024,119404,Polikarpova; Nadezhda,9999,0,9999,0
1668287343026,CSE 293,025,119406,Politz; Joseph Gibbs,9999,0,9999,0
1668287343026,CSE 293,026,119411,Porter; George M,9999,0,9999,0
1668287343026,CSE 293,027,119414,Porter; Leonard Emerson,9999,0,9999,0
1668287343026,CSE 293,028,119416,Ramamoorthi; Ravi,9999,0,9999,0
1668287343026,CSE 293,029,119417,Sahoo; Debashis,9999,0,9999,0
1668287343026,CSE 293,030,119420,Saul; Lawrence,9999,0,9999,0
1668287343026,CSE 293,031,119421,Savage; Stefan,9999,0,9999,0
1668287343026,CSE 293,032,119425,Schulze; Jurgen P.,9999,0,9999,0
1668287343026,CSE 293,033,119426,Snoeren; Alex C.,9999,0,9999,0
1668287343026,CSE 293,034,119428,Shang; Jingbo,9999,0,9999,0
1668287343026,CSE 293,035,119430,Stefan; Deian,9999,0,9999,0
1668287343026,CSE 293,036,119431,Su; Hao,9999,0,9999,0
1668287343026,CSE 293,037,119433,Swanson; Steven James,9999,0,9999,0
1668287343026,CSE 293,038,119435,Tullsen; Dean Michael,9999,0,9999,0
1668287343026,CSE 293,039,119483,Voelker; Geoffrey M.,9999,0,9999,0
1668287343026,CSE 293,040,119537,Zhao; Jishen,9999,0,9999,0
1668287343026,CSE 293,041,119538,Zhou; Yuan-Yuan,9999,0,9999,0
1668287343026,CSE 293,042,119539,Gao; Sicun,9999,0,9999,0
1668287343026,CSE 293,043,119540,Weibel; Nadir,9999,0,9999,0
1668287343026,CSE 293,044,119541,Gupta; Rajesh K.,9999,0,9999,0
1668287343026,CSE 293,045,126410,Vaccaro; Kristen Marie,9999,0,9999,0
1668287343026,CSE 293,046,126411,Klemke; Richard,9999,0,9999,0
1668287343452,CSE 294,A00,102459,Voelker; Geoffrey M.,0,0,0,0
1668287343452,CSE 294,B00,111322,Orailoglu; Alex,0,0,0,0
1668287343875,DSE 201,A00,096914,Deutsch; Alin Bernard,30,0,30,0
1668287344302,DSE 210,A00,096915,Dasgupta; Sanjoy,30,0,30,0
1668287344730,DSE 260A,A00,096916,Altintas De Callaf; Ilkay,30,0,30,0
1668287345159,ECE 200,001,103586,Antipa; Nicholas A,9999,0,9999,0
1668287345159,ECE 200,002,103587,Atanasov; Nikolay A.,9999,0,9999,0
1668287345159,ECE 200,003,103588,Bharadia; Dinesh,9999,0,9999,0
1668287345159,ECE 200,004,103589,Cheng; Chung Kuan,9999,0,9999,0
1668287345159,ECE 200,005,103590,Cosman; Pamela C.,9999,0,9999,0
1668287345159,ECE 200,006,103591,Dayeh; Shadi Ahmad,9999,0,9999,0
1668287345159,ECE 200,007,103592,Fainman; Yeshaiahu,9999,0,9999,0
1668287345159,ECE 200,008,103593,Ford; Joseph Earl,9999,0,9999,0
1668287345159,ECE 200,009,103594,Franceschetti; Massimo,9999,0,9999,0
1668287345159,ECE 200,010,103595,Fullerton; Eric E,9999,0,9999,0
1668287345159,ECE 200,011,103596,Galton; Ian A,9999,0,9999,0
1668287345159,ECE 200,012,103597,Gilja; Vikash,9999,0,9999,0
1668287345159,ECE 200,013,103598,Hall; Drew A.,9999,0,9999,0
1668287345159,ECE 200,014,103599,Hsueh; Tzu-Chien,9999,0,9999,0
1668287345159,ECE 200,015,103600,Javidi; Tara,9999,0,9999,0
1668287345159,ECE 200,016,103601,Kahng; Andrew Byun,9999,0,9999,0
1668287345159,ECE 200,017,103602,Kim; Young-Han,9999,0,9999,0
1668287345159,ECE 200,018,103603,Koushanfar; Farinaz,9999,0,9999,0
1668287345159,ECE 200,019,103604,Kuzum; Duygu,9999,0,9999,0
1668287345159,ECE 200,020,103605,Le; Hanh-Phuc,9999,0,9999,0
1668287345159,ECE 200,021,103606,Lin; Bill,9999,0,9999,0
1668287345159,ECE 200,022,103607,Liu; Zhaowei,9998,0,9999,1
1668287345159,ECE 200,023,103608,Lo; Yu-Hwa,9999,0,9999,0
1668287345159,ECE 200,024,103609,Lomakin; Vitaliy,9999,0,9999,0
1668287345159,ECE 200,025,103610,Mercier; Patrick Philip,9999,0,9999,0
1668287345159,ECE 200,026,103611,Meyer; Florian,9999,0,9999,0
1668287345159,ECE 200,027,103612,Milstein; Laurence B.,9999,0,9999,0
1668287345159,ECE 200,028,103613,Mir Arabbaygi; Siavash,9999,0,9999,0
1668287345159,ECE 200,029,103614,Mookherjea; Shayan,9999,0,9999,0
1668287345159,ECE 200,030,103615,Morris; Karcher William,9999,0,9999,0
1668287345159,ECE 200,031,103616,Ng; Tse Nga,9999,0,9999,0
1668287345159,ECE 200,032,103617,Nguyen; Truong Quang,9999,0,9999,0
1668287345159,ECE 200,033,103618,Nomura; Kenji,9999,0,9999,0
1668287345159,ECE 200,034,103619,Orlitsky; Alon,9999,0,9999,0
1668287345159,ECE 200,035,103620,Pal; Piya,9999,0,9999,0
1668287345159,ECE 200,036,103621,Papen; George C.,9999,0,9999,0
1668287345159,ECE 200,037,103622,Radic; Stojan,9999,0,9999,0
1668287345159,ECE 200,038,103623,Rao; Bhaskar D.,9999,0,9999,0
1668287345159,ECE 200,039,103624,Rao; Ramesh R,9999,0,9999,0
1668287345159,ECE 200,040,103625,Rebeiz; Gabriel,9999,0,9999,0
1668287345159,ECE 200,041,103626,Sanford; John R,9999,0,9999,0
1668287345159,ECE 200,042,103627,Siegel; Paul H.,9999,0,9999,0
1668287345159,ECE 200,043,103628,Sievenpiper; Daniel F.,9999,0,9999,0
1668287345159,ECE 200,044,103629,Sworder; David D.,9999,0,9999,0
1668287345159,ECE 200,045,103630,Taur; Yuan,9999,0,9999,0
1668287345159,ECE 200,046,103631,Touri; Behrouz,9999,0,9999,0
1668287345159,ECE 200,047,103632,Trivedi; Mohan M.,9999,0,9999,0
1668287345159,ECE 200,048,103633,Vasconcelos; Nuno,9999,0,9999,0
1668287345159,ECE 200,049,103634,Wang; Xiaolong,9999,0,9999,0
1668287345159,ECE 200,050,103635,Xie; Pengtao,9999,0,9999,0
1668287345159,ECE 200,051,103636,Yip; Michael,9999,0,9999,0
1668287345159,ECE 200,052,103637,Zeger; Kenneth A.,999,0,999,0
1668287345159,ECE 200,053,103638,Zhang; Xinyu,9999,0,9999,0
1668287345159,ECE 200,054,103639,Turakhia; Yatish Girish,9999,0,9999,0
1668287345159,ECE 200,055,103640,Kang; Mingu,9999,0,9999,0
1668287345159,ECE 200,056,103641,Shi; Yuanyuan,9999,0,9999,0
1668287345159,ECE 200,057,103642,Wang; Edward Jay,9999,0,9999,0
1668287345159,ECE 200,058,103643,Zheng; Yang,9999,0,9999,0
1668287345591,ECE 202,A00,103644,Kuzum; Duygu,0,0,0,0
1668287346015,ECE 212BN,A00,103646,Ng; Tse Nga,0,0,0,0
1668287346442,ECE 221,A00,111493,Staff,0,0,0,0
1668287346943,ECE 222B,A00,103647,Lomakin; Vitaliy,0,0,0,0
1668287347369,ECE 230B,A00,103648,Taur; Yuan,0,0,0,0
1668287347792,ECE 238B,A00,103649,Garay; Javier,0,0,0,0
1668287348218,ECE 240B,A00,112900,Fainman; Yeshaiahu,0,0,0,0
1668287348644,ECE 247A,A00,103650,Jokerst; Jesse Vincent,0,0,0,0
1668287349069,ECE 247B,A00,103651,Wang; Joseph,0,0,0,0
1668287349493,ECE 250,A00,103652,Siegel; Paul H.,0,0,0,0
1668287349919,ECE 251A,A00,103654,Rao; Bhaskar D.,0,0,0,0
1668287350343,ECE 257B,A00,103655,Bharadia; Dinesh,0,0,0,0
1668287350766,ECE 258A,A00,103656,Milstein; Laurence B.,0,0,0,0
1668287351190,ECE 260B,A00,103658,Kang; Mingu,0,0,0,0
1668287351616,ECE 264A,A00,103659,Galton; Ian A,0,0,0,0
1668287352041,ECE 265A,A00,103661,Gudem; Prasad S.S.,0,0,0,0
1668287352466,ECE 265D,A00,103662,Gudem; Prasad S.S.,0,0,0,0
1668287352889,ECE 268,A00,103663,Koushanfar; Farinaz,0,0,0,0
1668287353312,ECE 269,A01,103665,Pal; Piya,0,0,0,0
1668287353738,ECE 271B,A00,103666,Vasconcelos; Manuela,0,0,0,0
1668287354162,ECE 276A,A00,103667,Atanasov; Nikolay A.,0,0,0,0
1668287354594,ECE 277,A00,103668,An; Cheolhong,0,0,0,0
1668287355017,ECE 279,A00,117947,Hall; Drew A.,0,0,0,0
1668287355868,ECE 283,A00,103670,Hsueh; Tzu-Chien,0,0,0,0
1668287356296,ECE 284,A00,103671,Turakhia; Yatish Girish,0,0,0,0
1668287356719,ECE 285,A00,103672,Zheng; Yang,0,0,0,0
1668287356719,ECE 285,B00,103673,Sworder; David D.,0,0,0,0
1668287357144,ECE 287,A00,103676,Javidi; Tara,0,0,0,0
1668287357570,MATH 200B,A00,098023,Salehi Golsefidy; Alireza,12,0,15,3
1668287358000,MATH 202B,A00,098024,Rhoades; Brendon Patrick,9,0,15,6
1668287358422,MATH 203B,A00,098025,Oprea; Dragos N.,10,0,15,5
1668287358848,MATH 204B,A00,098026,Sorensen; Claus M,13,0,15,2
1668287359270,MATH 208,A00,098027,Izadi; Elham,7,0,10,3
1668287359696,MATH 209,A00,098028,Pollack; Aaron,10,0,10,0
1668287360121,MATH 211A,A00,112919,Rogalski; Daniel,9,0,10,1
1668287360543,MATH 211B,A00,112920,Seward; Brandon M.,9,0,10,1
1668287360969,MATH 218,A00,098029,Li; Bo,10,0,10,0
1668287361393,MATH 220B,A00,098030,Novak; Jonathan I,11,0,15,4
1668287361819,MATH 221A,A00,098031,Ebenfelt; Peter F,13,0,15,2
1668287362242,MATH 231B,A00,098032,Zlatos; Andrej,12,0,15,3
1668287362672,MATH 240B,A00,098033,Ni; Lei,9,0,15,6
1668287363096,MATH 243,A00,098034,Jekel; David Andrew,10,0,10,0
1668287363521,MATH 245A,A00,098035,Nie; Jiawang,0,0,15,16
1668287363948,MATH 248,A00,098036,Bejenaru; Ioan,10,0,10,0
1668287364372,MATH 250B,A00,098037,Spolaor; Luca,14,0,15,1
1668287364798,MATH 258,A00,098038,Ni; Lei,10,0,10,0
1668287365223,MATH 264B,A00,098041,Rhoades; Brendon Patrick,9,0,15,6
1668287365648,MATH 268,A00,098042,Buss; Samuel R,10,0,10,0
1668287366078,MATH 269,A00,098043,Rhoades; Brendon Patrick,10,0,10,0
1668287366501,MATH 270B,A00,098044,Li; Bo,10,0,15,5
1668287366924,MATH 272B,A00,098045,Holst; Michael J,13,0,15,2
1668287367347,MATH 273A,A00,098046,Tian; Xiaochuan,10,0,15,5
1668287367770,MATH 275,A01,098048,Tian; Xiaochuan,6,0,10,4
1668287368193,MATH 278A,A00,098049,Holst; Michael J,8,0,10,2
1668287368619,MATH 278B,A00,098050,Cloninger; Alexander,10,0,10,0
1668287369044,MATH 278C,A00,098051,Nie; Jiawang,7,0,10,3
1668287369467,MATH 280B,A00,098052,Zheng; Tianyi,8,0,15,7
1668287369892,MATH 281B,A00,098053,Bradic; Jelena,1,0,15,14
1668287370319,MATH 282B,A00,098054,Arias-Castro; Ery,0,0,15,15
1668287370745,MATH 285,A00,098055,Fitzsimmons; Patrick J,0,0,15,17
1668287371171,MATH 287B,A00,098056,Arias-Castro; Ery,2,0,15,13
1668287371593,MATH 288,A00,098057,Agarwal; Pooja,9,0,10,1
1668287371593,MATH 288,B00,098058,Zhang; Danna,8,0,10,2
1668287371593,MATH 288,C00,098059,Williams; Ruth J,9,0,10,1
1668287372020,MATH 290B,A00,098060,Roberts; Justin Deritter,13,0,15,2
1668287372444,MATH 292,A00,098061,Belmont; Eva Kinoshita,10,0,10,0
1668287372866,MATH 295,A00,098062,Suk; Andrew Hoon,48,0,50,2
1668287373297,MATH 296,A00,098063,Novak; Jonathan I,20,0,20,0
1668287373721,MATH 297,001,098064,Gamst; Anthony Collins,9997,0,9999,2
1668287872462,COGS 205,A00,101395,Chiba; Andrea,19,0,20,1
1668287872884,COGS 210B,001,101404,Greene; Deanna Jacquelyn,9998,0,9999,1
1668287872884,COGS 210B,002,101417,Xia; Haijun,9999,0,9999,0
1668287872884,COGS 210B,003,101422,Nitz; Douglas A.,9999,0,9999,0
1668287872884,COGS 210B,004,101423,Hollan; James D.,9998,0,9999,1
1668287872884,COGS 210B,005,101424,Deak; Gedeon O.,9998,0,9999,1
1668287872884,COGS 210B,006,101425,Rossano; Federico,9999,0,9999,0
1668287873313,COGS 211B,A00,101427,Coulson; Seana M,9996,0,9999,3
1668287873736,COGS 220,A00,101428,Hollan; James D.,0,0,25,25
1668287874161,COGS 229,A00,101429,Dow; Steven P,18,0,25,7
1668287874584,COGS 230,A00,101430,Klemmer; Scott R,12,0,17,5
1668287875012,COGS 234,A00,101431,Xia; Haijun,1,0,25,24
1668287875434,COGS 260,A00,101432,Kiyonaga; Anastasia,21,0,25,4
1668287875434,COGS 260,B00,101433,Kirsh; David Joel,15,0,25,10
1668287875859,CSE 202,A00,102371,Impagliazzo; Russell,0,0,0,0
1668287876284,CSE 203B,A01,102373,Cheng; Chung Kuan,0,0,0,0
1668287876708,CSE 208,A00,102374,Micciancio; Daniele,0,0,0,0
1668287877134,CSE 209A,A00,112895,Impagliazzo; Russell,0,0,15,15
1668287877569,CSE 209B,A00,108005,Bellare; Mihir,0,0,0,0
1668287877995,CSE 210,A00,113163,Coblenz; Michael J,0,0,0,0
1668287878417,CSE 219,A00,106111,Dow; Steven P,0,0,20,20
1668287878842,CSE 221,A00,102376,Voelker; Geoffrey M.,0,0,0,0
1668287879268,CSE 224,A01,102378,Porter; George M,0,0,0,0
1668287879696,CSE 229A,A00,102379,Savage; Stefan,0,0,0,0
1668287880125,CSE 229C,A00,102380,Munyaka; Imani N. S.,0,0,0,0
1668287880549,CSE 232B,A00,102382,Deutsch; Alin Bernard,0,0,0,0
1668287880975,CSE 234,A01,112904,Kumar; Arun Kumar,0,0,0,0
1668287881401,CSE 237A,A00,102383,Rosing; Tajana Simunic,0,0,0,0
1668287881825,CSE 239A,A00,102384,Deutsch; Alin Bernard,0,0,0,0
1668287882248,CSE 239B,A00,102385,Polikarpova; Nadezhda,0,0,0,0
1668287882679,CSE 240A,A00,102386,Pannuto; Patrick William,0,0,0,0
1668287883103,CSE 240B,A00,102387,Zhao; Jishen,0,0,0,0
1668287883529,CSE 241A,A00,106406,Kang; Mingu,0,0,0,0
1668287883953,CSE 249B,A00,102388,Kahng; Andrew Byun,0,0,8,8
1668287884379,CSE 251B,A01,102392,Cottrell; Garrison W,0,0,0,0
1668287884379,CSE 251B,A02,102393,Cottrell; Garrison W,0,0,0,0
1668287884806,CSE 252B,A00,102394,Ochoa; Benjamin Lawrence,0,0,0,0
1668287885229,CSE 257,A01,102396,Gao; Sicun,0,0,0,0
1668287885656,CSE 272,A00,102397,Li; Tzumao,0,0,0,0
1668287886081,CSE 274,A00,111323,Chern; Albert Ren-Haur,0,0,0,0
1668287886502,CSE 282,A00,102398,Pevzner; Pavel Arkadjevich,0,0,0,0
1668287886929,CSE 284,A00,114175,Gymrek; Melissa Ann,0,0,0,0
1668287887354,CSE 290,A00,102399,Chandraker; Manmohan Krishna,0,0,0,0
1668287887354,CSE 290,B00,102400,Vaccaro; Kristen Marie,0,0,25,25
1668287887354,CSE 290,C00,102414,Pannuto; Patrick William,0,0,25,25
1668287887354,CSE 290,D00,102427,Pevzner; Pavel Arkadjevich,0,0,0,0
1668287887354,CSE 290,E00,102429,Zhao; Jishen,0,0,0,0
1668287887354,CSE 290,F00,102436,Tullsen; Dean Michael,0,0,0,0
1668287887354,CSE 290,G00,102440,Christensen; Henrik I,0,0,20,20
1668287887783,CSE 291,A00,102443,Su; Hao,0,0,0,0
1668287887783,CSE 291,B00,102448,Polikarpova; Nadezhda,0,0,0,0
1668287887783,CSE 291,C00,102453,Vaccaro; Kristen Marie,0,0,0,0
1668287887783,CSE 291,D00,111343,Savage; Stefan,0,0,0,0
1668287887783,CSE 291,E00,116474,Claffy; Kimberly Claire,0,0,0,0
1668287887783,CSE 291,F00,116479,Pasquale; Joseph,0,0,0,0
1668287888217,CSE 293,001,119111,Bafna; Vineet,9999,0,9999,0
1668287888217,CSE 293,002,119118,Bellare; Mihir,9999,0,9999,0
1668287888217,CSE 293,003,119122,Berg-Kirkpatrick; Taylor D,9999,0,9999,0
1668287888217,CSE 293,004,119135,Christensen; Henrik I,9999,0,9999,0
1668287888217,CSE 293,005,119142,Cottrell; Garrison W,9999,0,9999,0
1668287888217,CSE 293,006,119146,Deutsch; Alin Bernard,9999,0,9999,0
1668287888217,CSE 293,007,119159,Esmaeilzadeh; Hadi,9999,0,9999,0
1668287888217,CSE 293,008,119166,Freund; Yoav,9999,0,9999,0
1668287888217,CSE 293,009,119170,Griswold; William G.,9999,0,9999,0
1668287888217,CSE 293,010,119183,Gymrek; Melissa Ann,9999,0,9999,0
1668287888217,CSE 293,011,119190,Heninger; Nadia A,9999,0,9999,0
1668287888217,CSE 293,012,119230,Impagliazzo; Russell,9999,0,9999,0
1668287888217,CSE 293,013,119232,Jhala; Ranjit,9999,0,9999,0
1668287888217,CSE 293,014,119233,Kahng; Andrew Byun,9999,0,9999,0
1668287888217,CSE 293,015,119298,Kane; Daniel Mertz,9999,0,9999,0
1668287888217,CSE 293,016,119299,Kriegman; David J,9999,0,9999,0
1668287888217,CSE 293,017,119300,Kumar; Arun Kumar,9999,0,9999,0
1668287888217,CSE 293,018,119301,Lerner; Sorin,9999,0,9999,0
1668287888217,CSE 293,019,119302,Lovett; Shachar,9999,0,9999,0
1668287888217,CSE 293,020,119303,McAuley; Julian John,9999,0,9999,0
1668287888217,CSE 293,021,119304,Micciancio; Daniele,9999,0,9999,0
1668287888217,CSE 293,022,119367,Orailoglu; Alex,9999,0,9999,0
1668287888217,CSE 293,023,119382,Paturi; Ramamohan,9999,0,9999,0
1668287888217,CSE 293,024,119404,Polikarpova; Nadezhda,9999,0,9999,0
1668287888217,CSE 293,025,119406,Politz; Joseph Gibbs,9999,0,9999,0
1668287888217,CSE 293,026,119411,Porter; George M,9999,0,9999,0
1668287888217,CSE 293,027,119414,Porter; Leonard Emerson,9999,0,9999,0
1668287888217,CSE 293,028,119416,Ramamoorthi; Ravi,9999,0,9999,0
1668287888217,CSE 293,029,119417,Sahoo; Debashis,9999,0,9999,0
1668287888217,CSE 293,030,119420,Saul; Lawrence,9999,0,9999,0
1668287888217,CSE 293,031,119421,Savage; Stefan,9999,0,9999,0
1668287888217,CSE 293,032,119425,Schulze; Jurgen P.,9999,0,9999,0
1668287888217,CSE 293,033,119426,Snoeren; Alex C.,9999,0,9999,0
1668287888217,CSE 293,034,119428,Shang; Jingbo,9999,0,9999,0
1668287888217,CSE 293,035,119430,Stefan; Deian,9999,0,9999,0
1668287888217,CSE 293,036,119431,Su; Hao,9999,0,9999,0
1668287888217,CSE 293,037,119433,Swanson; Steven James,9999,0,9999,0
1668287888217,CSE 293,038,119435,Tullsen; Dean Michael,9999,0,9999,0
1668287888217,CSE 293,039,119483,Voelker; Geoffrey M.,9999,0,9999,0
1668287888217,CSE 293,040,119537,Zhao; Jishen,9999,0,9999,0
1668287888217,CSE 293,041,119538,Zhou; Yuan-Yuan,9999,0,9999,0
1668287888217,CSE 293,042,119539,Gao; Sicun,9999,0,9999,0
1668287888217,CSE 293,043,119540,Weibel; Nadir,9999,0,9999,0
1668287888217,CSE 293,044,119541,Gupta; Rajesh K.,9999,0,9999,0
1668287888217,CSE 293,045,126410,Vaccaro; Kristen Marie,9999,0,9999,0
1668287888217,CSE 293,046,126411,Klemke; Richard,9999,0,9999,0
1668287888639,CSE 294,A00,102459,Voelker; Geoffrey M.,0,0,0,0
1668287888639,CSE 294,B00,111322,Orailoglu; Alex,0,0,0,0
1668287889063,DSE 201,A00,096914,Deutsch; Alin Bernard,30,0,30,0
1668287889485,DSE 210,A00,096915,Dasgupta; Sanjoy,30,0,30,0
1668287889912,DSE 260A,A00,096916,Altintas De Callaf; Ilkay,30,0,30,0
1668287890347,ECE 200,001,103586,Antipa; Nicholas A,9999,0,9999,0
1668287890347,ECE 200,002,103587,Atanasov; Nikolay A.,9999,0,9999,0
1668287890347,ECE 200,003,103588,Bharadia; Dinesh,9999,0,9999,0
1668287890347,ECE 200,004,103589,Cheng; Chung Kuan,9999,0,9999,0
1668287890347,ECE 200,005,103590,Cosman; Pamela C.,9999,0,9999,0
1668287890347,ECE 200,006,103591,Dayeh; Shadi Ahmad,9999,0,9999,0
1668287890347,ECE 200,007,103592,Fainman; Yeshaiahu,9999,0,9999,0
1668287890347,ECE 200,008,103593,Ford; Joseph Earl,9999,0,9999,0
1668287890347,ECE 200,009,103594,Franceschetti; Massimo,9999,0,9999,0
1668287890347,ECE 200,010,103595,Fullerton; Eric E,9999,0,9999,0
1668287890347,ECE 200,011,103596,Galton; Ian A,9999,0,9999,0
1668287890347,ECE 200,012,103597,Gilja; Vikash,9999,0,9999,0
1668287890347,ECE 200,013,103598,Hall; Drew A.,9999,0,9999,0
1668287890347,ECE 200,014,103599,Hsueh; Tzu-Chien,9999,0,9999,0
1668287890347,ECE 200,015,103600,Javidi; Tara,9999,0,9999,0
1668287890347,ECE 200,016,103601,Kahng; Andrew Byun,9999,0,9999,0
1668287890347,ECE 200,017,103602,Kim; Young-Han,9999,0,9999,0
1668287890347,ECE 200,018,103603,Koushanfar; Farinaz,9999,0,9999,0
1668287890347,ECE 200,019,103604,Kuzum; Duygu,9999,0,9999,0
1668287890347,ECE 200,020,103605,Le; Hanh-Phuc,9999,0,9999,0
1668287890347,ECE 200,021,103606,Lin; Bill,9999,0,9999,0
1668287890347,ECE 200,022,103607,Liu; Zhaowei,9998,0,9999,1
1668287890347,ECE 200,023,103608,Lo; Yu-Hwa,9999,0,9999,0
1668287890347,ECE 200,024,103609,Lomakin; Vitaliy,9999,0,9999,0
1668287890347,ECE 200,025,103610,Mercier; Patrick Philip,9999,0,9999,0
1668287890347,ECE 200,026,103611,Meyer; Florian,9999,0,9999,0
1668287890347,ECE 200,027,103612,Milstein; Laurence B.,9999,0,9999,0
1668287890347,ECE 200,028,103613,Mir Arabbaygi; Siavash,9999,0,9999,0
1668287890347,ECE 200,029,103614,Mookherjea; Shayan,9999,0,9999,0
1668287890347,ECE 200,030,103615,Morris; Karcher William,9999,0,9999,0
1668287890347,ECE 200,031,103616,Ng; Tse Nga,9999,0,9999,0
1668287890347,ECE 200,032,103617,Nguyen; Truong Quang,9999,0,9999,0
1668287890347,ECE 200,033,103618,Nomura; Kenji,9999,0,9999,0
1668287890347,ECE 200,034,103619,Orlitsky; Alon,9999,0,9999,0
1668287890347,ECE 200,035,103620,Pal; Piya,9999,0,9999,0
1668287890347,ECE 200,036,103621,Papen; George C.,9999,0,9999,0
1668287890347,ECE 200,037,103622,Radic; Stojan,9999,0,9999,0
1668287890347,ECE 200,038,103623,Rao; Bhaskar D.,9999,0,9999,0
1668287890347,ECE 200,039,103624,Rao; Ramesh R,9999,0,9999,0
1668287890347,ECE 200,040,103625,Rebeiz; Gabriel,9999,0,9999,0
1668287890347,ECE 200,041,103626,Sanford; John R,9999,0,9999,0
1668287890347,ECE 200,042,103627,Siegel; Paul H.,9999,0,9999,0
1668287890347,ECE 200,043,103628,Sievenpiper; Daniel F.,9999,0,9999,0
1668287890347,ECE 200,044,103629,Sworder; David D.,9999,0,9999,0
1668287890347,ECE 200,045,103630,Taur; Yuan,9999,0,9999,0
1668287890347,ECE 200,046,103631,Touri; Behrouz,9999,0,9999,0
1668287890347,ECE 200,047,103632,Trivedi; Mohan M.,9999,0,9999,0
1668287890347,ECE 200,048,103633,Vasconcelos; Nuno,9999,0,9999,0
1668287890347,ECE 200,049,103634,Wang; Xiaolong,9999,0,9999,0
1668287890347,ECE 200,050,103635,Xie; Pengtao,9999,0,9999,0
1668287890347,ECE 200,051,103636,Yip; Michael,9999,0,9999,0
1668287890347,ECE 200,052,103637,Zeger; Kenneth A.,999,0,999,0
1668287890347,ECE 200,053,103638,Zhang; Xinyu,9999,0,9999,0
1668287890347,ECE 200,054,103639,Turakhia; Yatish Girish,9999,0,9999,0
1668287890347,ECE 200,055,103640,Kang; Mingu,9999,0,9999,0
1668287890347,ECE 200,056,103641,Shi; Yuanyuan,9999,0,9999,0
1668287890347,ECE 200,057,103642,Wang; Edward Jay,9999,0,9999,0
1668287890347,ECE 200,058,103643,Zheng; Yang,9999,0,9999,0
1668287890772,ECE 202,A00,103644,Kuzum; Duygu,0,0,0,0
1668287891195,ECE 212BN,A00,103646,Ng; Tse Nga,0,0,0,0
1668287891620,ECE 221,A00,111493,Staff,0,0,0,0
1668287892043,ECE 222B,A00,103647,Lomakin; Vitaliy,0,0,0,0
1668287892467,ECE 230B,A00,103648,Taur; Yuan,0,0,0,0
1668287892891,ECE 238B,A00,103649,Garay; Javier,0,0,0,0
1668287893313,ECE 240B,A00,112900,Fainman; Yeshaiahu,0,0,0,0
1668287893735,ECE 247A,A00,103650,Jokerst; Jesse Vincent,0,0,0,0
1668287894166,ECE 247B,A00,103651,Wang; Joseph,0,0,0,0
1668287894590,ECE 250,A00,103652,Siegel; Paul H.,0,0,0,0
1668287895012,ECE 251A,A00,103654,Rao; Bhaskar D.,0,0,0,0
1668287895436,ECE 257B,A00,103655,Bharadia; Dinesh,0,0,0,0
1668287895863,ECE 258A,A00,103656,Milstein; Laurence B.,0,0,0,0
1668287896288,ECE 260B,A00,103658,Kang; Mingu,0,0,0,0
1668287896714,ECE 264A,A00,103659,Galton; Ian A,0,0,0,0
1668287897141,ECE 265A,A00,103661,Gudem; Prasad S.S.,0,0,0,0
1668287897567,ECE 265D,A00,103662,Gudem; Prasad S.S.,0,0,0,0
1668287897989,ECE 268,A00,103663,Koushanfar; Farinaz,0,0,0,0
1668287898413,ECE 269,A01,103665,Pal; Piya,0,0,0,0
1668287898837,ECE 271B,A00,103666,Vasconcelos; Manuela,0,0,0,0
1668287899262,ECE 276A,A00,103667,Atanasov; Nikolay A.,0,0,0,0
1668287899687,ECE 277,A00,103668,An; Cheolhong,0,0,0,0
1668287900110,ECE 279,A00,117947,Hall; Drew A.,0,0,0,0
1668287900958,ECE 283,A00,103670,Hsueh; Tzu-Chien,0,0,0,0
1668287901383,ECE 284,A00,103671,Turakhia; Yatish Girish,0,0,0,0
1668287901809,ECE 285,A00,103672,Zheng; Yang,0,0,0,0
1668287901809,ECE 285,B00,103673,Sworder; David D.,0,0,0,0
1668287902230,ECE 287,A00,103676,Javidi; Tara,0,0,0,0
1668287902657,MATH 200B,A00,098023,Salehi Golsefidy; Alireza,12,0,15,3
1668287903081,MATH 202B,A00,098024,Rhoades; Brendon Patrick,9,0,15,6
1668287903504,MATH 203B,A00,098025,Oprea; Dragos N.,10,0,15,5
1668287903931,MATH 204B,A00,098026,Sorensen; Claus M,13,0,15,2
1668287904357,MATH 208,A00,098027,Izadi; Elham,7,0,10,3
1668287904783,MATH 209,A00,098028,Pollack; Aaron,10,0,10,0
1668287905206,MATH 211A,A00,112919,Rogalski; Daniel,9,0,10,1
1668287905629,MATH 211B,A00,112920,Seward; Brandon M.,9,0,10,1
1668287906051,MATH 218,A00,098029,Li; Bo,10,0,10,0
1668287906477,MATH 220B,A00,098030,Novak; Jonathan I,11,0,15,4
1668287906906,MATH 221A,A00,098031,Ebenfelt; Peter F,13,0,15,2
1668287907328,MATH 231B,A00,098032,Zlatos; Andrej,12,0,15,3
1668287907751,MATH 240B,A00,098033,Ni; Lei,9,0,15,6
1668287908178,MATH 243,A00,098034,Jekel; David Andrew,10,0,10,0
1668287908691,MATH 245A,A00,098035,Nie; Jiawang,0,0,15,16
1668287909116,MATH 248,A00,098036,Bejenaru; Ioan,10,0,10,0
1668287909541,MATH 250B,A00,098037,Spolaor; Luca,14,0,15,1
1668287909965,MATH 258,A00,098038,Ni; Lei,10,0,10,0
1668287910387,MATH 264B,A00,098041,Rhoades; Brendon Patrick,9,0,15,6
1668287910808,MATH 268,A00,098042,Buss; Samuel R,10,0,10,0
1668287911234,MATH 269,A00,098043,Rhoades; Brendon Patrick,10,0,10,0
1668287911658,MATH 270B,A00,098044,Li; Bo,10,0,15,5
1668287912082,MATH 272B,A00,098045,Holst; Michael J,13,0,15,2
1668287912504,MATH 273A,A00,098046,Tian; Xiaochuan,10,0,15,5
1668287912929,MATH 275,A01,098048,Tian; Xiaochuan,6,0,10,4
1668287913352,MATH 278A,A00,098049,Holst; Michael J,8,0,10,2
1668287913786,MATH 278B,A00,098050,Cloninger; Alexander,10,0,10,0
1668287914210,MATH 278C,A00,098051,Nie; Jiawang,7,0,10,3
1668287914636,MATH 280B,A00,098052,Zheng; Tianyi,8,0,15,7
1668287915065,MATH 281B,A00,098053,Bradic; Jelena,1,0,15,14
1668287915488,MATH 282B,A00,098054,Arias-Castro; Ery,0,0,15,15
1668287915919,MATH 285,A00,098055,Fitzsimmons; Patrick J,0,0,15,17
1668287916343,MATH 287B,A00,098056,Arias-Castro; Ery,2,0,15,13
1668287916768,MATH 288,A00,098057,Agarwal; Pooja,9,0,10,1
1668287916768,MATH 288,B00,098058,Zhang; Danna,8,0,10,2
1668287916768,MATH 288,C00,098059,Williams; Ruth J,9,0,10,1
1668287917195,MATH 290B,A00,098060,Roberts; Justin Deritter,13,0,15,2
1668287917621,MATH 292,A00,098061,Belmont; Eva Kinoshita,10,0,10,0
1668287918046,MATH 295,A00,098062,Suk; Andrew Hoon,48,0,50,2
1668287918472,MATH 296,A00,098063,Novak; Jonathan I,20,0,20,0
1668287918896,MATH 297,001,098064,Gamst; Anthony Collins,9997,0,9999,2
1668288417422,COGS 205,A00,101395,Chiba; Andrea,19,0,20,1
1668288417848,COGS 210B,001,101404,Greene; Deanna Jacquelyn,9998,0,9999,1
1668288417848,COGS 210B,002,101417,Xia; Haijun,9999,0,9999,0
1668288417848,COGS 210B,003,101422,Nitz; Douglas A.,9999,0,9999,0
1668288417848,COGS 210B,004,101423,Hollan; James D.,9998,0,9999,1
1668288417848,COGS 210B,005,101424,Deak; Gedeon O.,9998,0,9999,1
1668288417848,COGS 210B,006,101425,Rossano; Federico,9999,0,9999,0
1668288418272,COGS 211B,A00,101427,Coulson; Seana M,9996,0,9999,3
1668288418696,COGS 220,A00,101428,Hollan; James D.,0,0,25,25
1668288419119,COGS 229,A00,101429,Dow; Steven P,18,0,25,7
1668288419545,COGS 230,A00,101430,Klemmer; Scott R,12,0,17,5
1668288419969,COGS 234,A00,101431,Xia; Haijun,1,0,25,24
1668288420395,COGS 260,A00,101432,Kiyonaga; Anastasia,21,0,25,4
1668288420395,COGS 260,B00,101433,Kirsh; David Joel,15,0,25,10
1668288420823,CSE 202,A00,102371,Impagliazzo; Russell,0,0,0,0
1668288421250,CSE 203B,A01,102373,Cheng; Chung Kuan,0,0,0,0
1668288421676,CSE 208,A00,102374,Micciancio; Daniele,0,0,0,0
1668288422102,CSE 209A,A00,112895,Impagliazzo; Russell,0,0,15,15
1668288422529,CSE 209B,A00,108005,Bellare; Mihir,0,0,0,0
1668288422954,CSE 210,A00,113163,Coblenz; Michael J,0,0,0,0
1668288423377,CSE 219,A00,106111,Dow; Steven P,0,0,20,20
1668288423800,CSE 221,A00,102376,Voelker; Geoffrey M.,0,0,0,0
1668288424224,CSE 224,A01,102378,Porter; George M,0,0,0,0
1668288424648,CSE 229A,A00,102379,Savage; Stefan,0,0,0,0
1668288425071,CSE 229C,A00,102380,Munyaka; Imani N. S.,0,0,0,0
1668288425497,CSE 232B,A00,102382,Deutsch; Alin Bernard,0,0,0,0
1668288425927,CSE 234,A01,112904,Kumar; Arun Kumar,0,0,0,0
1668288426352,CSE 237A,A00,102383,Rosing; Tajana Simunic,0,0,0,0
1668288426789,CSE 239A,A00,102384,Deutsch; Alin Bernard,0,0,0,0
1668288427311,CSE 239B,A00,102385,Polikarpova; Nadezhda,0,0,0,0
1668288427734,CSE 240A,A00,102386,Pannuto; Patrick William,0,0,0,0
1668288428156,CSE 240B,A00,102387,Zhao; Jishen,0,0,0,0
1668288428584,CSE 241A,A00,106406,Kang; Mingu,0,0,0,0
1668288429009,CSE 249B,A00,102388,Kahng; Andrew Byun,0,0,8,8
1668288429440,CSE 251B,A01,102392,Cottrell; Garrison W,0,0,0,0
1668288429440,CSE 251B,A02,102393,Cottrell; Garrison W,0,0,0,0
1668288429865,CSE 252B,A00,102394,Ochoa; Benjamin Lawrence,0,0,0,0
1668288430293,CSE 257,A01,102396,Gao; Sicun,0,0,0,0
1668288430716,CSE 272,A00,102397,Li; Tzumao,0,0,0,0
1668288431147,CSE 274,A00,111323,Chern; Albert Ren-Haur,0,0,0,0
1668288431578,CSE 282,A00,102398,Pevzner; Pavel Arkadjevich,0,0,0,0
1668288432003,CSE 284,A00,114175,Gymrek; Melissa Ann,0,0,0,0
1668288432430,CSE 290,A00,102399,Chandraker; Manmohan Krishna,0,0,0,0
1668288432430,CSE 290,B00,102400,Vaccaro; Kristen Marie,0,0,25,25
1668288432430,CSE 290,C00,102414,Pannuto; Patrick William,0,0,25,25
1668288432430,CSE 290,D00,102427,Pevzner; Pavel Arkadjevich,0,0,0,0
1668288432430,CSE 290,E00,102429,Zhao; Jishen,0,0,0,0
1668288432430,CSE 290,F00,102436,Tullsen; Dean Michael,0,0,0,0
1668288432430,CSE 290,G00,102440,Christensen; Henrik I,0,0,20,20
1668288432858,CSE 291,A00,102443,Su; Hao,0,0,0,0
1668288432858,CSE 291,B00,102448,Polikarpova; Nadezhda,0,0,0,0
1668288432858,CSE 291,C00,102453,Vaccaro; Kristen Marie,0,0,0,0
1668288432858,CSE 291,D00,111343,Savage; Stefan,0,0,0,0
1668288432858,CSE 291,E00,116474,Claffy; Kimberly Claire,0,0,0,0
1668288432858,CSE 291,F00,116479,Pasquale; Joseph,0,0,0,0
1668288433292,CSE 293,001,119111,Bafna; Vineet,9999,0,9999,0
1668288433292,CSE 293,002,119118,Bellare; Mihir,9999,0,9999,0
1668288433292,CSE 293,003,119122,Berg-Kirkpatrick; Taylor D,9999,0,9999,0
1668288433292,CSE 293,004,119135,Christensen; Henrik I,9999,0,9999,0
1668288433292,CSE 293,005,119142,Cottrell; Garrison W,9999,0,9999,0
1668288433292,CSE 293,006,119146,Deutsch; Alin Bernard,9999,0,9999,0
1668288433292,CSE 293,007,119159,Esmaeilzadeh; Hadi,9999,0,9999,0
1668288433292,CSE 293,008,119166,Freund; Yoav,9999,0,9999,0
1668288433292,CSE 293,009,119170,Griswold; William G.,9999,0,9999,0
1668288433292,CSE 293,010,119183,Gymrek; Melissa Ann,9999,0,9999,0
1668288433292,CSE 293,011,119190,Heninger; Nadia A,9999,0,9999,0
1668288433292,CSE 293,012,119230,Impagliazzo; Russell,9999,0,9999,0
1668288433292,CSE 293,013,119232,Jhala; Ranjit,9999,0,9999,0
1668288433292,CSE 293,014,119233,Kahng; Andrew Byun,9999,0,9999,0
1668288433292,CSE 293,015,119298,Kane; Daniel Mertz,9999,0,9999,0
1668288433292,CSE 293,016,119299,Kriegman; David J,9999,0,9999,0
1668288433292,CSE 293,017,119300,Kumar; Arun Kumar,9999,0,9999,0
1668288433292,CSE 293,018,119301,Lerner; Sorin,9999,0,9999,0
1668288433292,CSE 293,019,119302,Lovett; Shachar,9999,0,9999,0
1668288433292,CSE 293,020,119303,McAuley; Julian John,9999,0,9999,0
1668288433292,CSE 293,021,119304,Micciancio; Daniele,9999,0,9999,0
1668288433292,CSE 293,022,119367,Orailoglu; Alex,9999,0,9999,0
1668288433292,CSE 293,023,119382,Paturi; Ramamohan,9999,0,9999,0
1668288433292,CSE 293,024,119404,Polikarpova; Nadezhda,9999,0,9999,0
1668288433292,CSE 293,025,119406,Politz; Joseph Gibbs,9999,0,9999,0
1668288433292,CSE 293,026,119411,Porter; George M,9999,0,9999,0
1668288433292,CSE 293,027,119414,Porter; Leonard Emerson,9999,0,9999,0
1668288433292,CSE 293,028,119416,Ramamoorthi; Ravi,9999,0,9999,0
1668288433292,CSE 293,029,119417,Sahoo; Debashis,9999,0,9999,0
1668288433292,CSE 293,030,119420,Saul; Lawrence,9999,0,9999,0
1668288433292,CSE 293,031,119421,Savage; Stefan,9999,0,9999,0
1668288433292,CSE 293,032,119425,Schulze; Jurgen P.,9999,0,9999,0
1668288433292,CSE 293,033,119426,Snoeren; Alex C.,9999,0,9999,0
1668288433292,CSE 293,034,119428,Shang; Jingbo,9999,0,9999,0
1668288433292,CSE 293,035,119430,Stefan; Deian,9999,0,9999,0
1668288433292,CSE 293,036,119431,Su; Hao,9999,0,9999,0
1668288433292,CSE 293,037,119433,Swanson; Steven James,9999,0,9999,0
1668288433292,CSE 293,038,119435,Tullsen; Dean Michael,9999,0,9999,0
1668288433292,CSE 293,039,119483,Voelker; Geoffrey M.,9999,0,9999,0
1668288433292,CSE 293,040,119537,Zhao; Jishen,9999,0,9999,0
1668288433292,CSE 293,041,119538,Zhou; Yuan-Yuan,9999,0,9999,0
1668288433292,CSE 293,042,119539,Gao; Sicun,9999,0,9999,0
1668288433292,CSE 293,043,119540,Weibel; Nadir,9999,0,9999,0
1668288433292,CSE 293,044,119541,Gupta; Rajesh K.,9999,0,9999,0
1668288433292,CSE 293,045,126410,Vaccaro; Kristen Marie,9999,0,9999,0
1668288433292,CSE 293,046,126411,Klemke; Richard,9999,0,9999,0
1668288433715,CSE 294,A00,102459,Voelker; Geoffrey M.,0,0,0,0
1668288433715,CSE 294,B00,111322,Orailoglu; Alex,0,0,0,0
1668288434140,DSE 201,A00,096914,Deutsch; Alin Bernard,30,0,30,0
1668288434566,DSE 210,A00,096915,Dasgupta; Sanjoy,30,0,30,0
1668288434992,DSE 260A,A00,096916,Altintas De Callaf; Ilkay,30,0,30,0
1668288435426,ECE 200,001,103586,Antipa; Nicholas A,9999,0,9999,0
1668288435426,ECE 200,002,103587,Atanasov; Nikolay A.,9999,0,9999,0
1668288435426,ECE 200,003,103588,Bharadia; Dinesh,9999,0,9999,0
1668288435426,ECE 200,004,103589,Cheng; Chung Kuan,9999,0,9999,0
1668288435426,ECE 200,005,103590,Cosman; Pamela C.,9999,0,9999,0
1668288435426,ECE 200,006,103591,Dayeh; Shadi Ahmad,9999,0,9999,0
1668288435426,ECE 200,007,103592,Fainman; Yeshaiahu,9999,0,9999,0
1668288435426,ECE 200,008,103593,Ford; Joseph Earl,9999,0,9999,0
1668288435426,ECE 200,009,103594,Franceschetti; Massimo,9999,0,9999,0
1668288435426,ECE 200,010,103595,Fullerton; Eric E,9999,0,9999,0
1668288435426,ECE 200,011,103596,Galton; Ian A,9999,0,9999,0
1668288435426,ECE 200,012,103597,Gilja; Vikash,9999,0,9999,0
1668288435426,ECE 200,013,103598,Hall; Drew A.,9999,0,9999,0
1668288435426,ECE 200,014,103599,Hsueh; Tzu-Chien,9999,0,9999,0
1668288435426,ECE 200,015,103600,Javidi; Tara,9999,0,9999,0
1668288435426,ECE 200,016,103601,Kahng; Andrew Byun,9999,0,9999,0
1668288435426,ECE 200,017,103602,Kim; Young-Han,9999,0,9999,0
1668288435426,ECE 200,018,103603,Koushanfar; Farinaz,9999,0,9999,0
1668288435426,ECE 200,019,103604,Kuzum; Duygu,9999,0,9999,0
1668288435426,ECE 200,020,103605,Le; Hanh-Phuc,9999,0,9999,0
1668288435426,ECE 200,021,103606,Lin; Bill,9999,0,9999,0
1668288435426,ECE 200,022,103607,Liu; Zhaowei,9998,0,9999,1
1668288435426,ECE 200,023,103608,Lo; Yu-Hwa,9999,0,9999,0
1668288435426,ECE 200,024,103609,Lomakin; Vitaliy,9999,0,9999,0
1668288435426,ECE 200,025,103610,Mercier; Patrick Philip,9999,0,9999,0
1668288435426,ECE 200,026,103611,Meyer; Florian,9999,0,9999,0
1668288435426,ECE 200,027,103612,Milstein; Laurence B.,9999,0,9999,0
1668288435426,ECE 200,028,103613,Mir Arabbaygi; Siavash,9999,0,9999,0
1668288435426,ECE 200,029,103614,Mookherjea; Shayan,9999,0,9999,0
1668288435426,ECE 200,030,103615,Morris; Karcher William,9999,0,9999,0
1668288435426,ECE 200,031,103616,Ng; Tse Nga,9999,0,9999,0
1668288435426,ECE 200,032,103617,Nguyen; Truong Quang,9999,0,9999,0
1668288435426,ECE 200,033,103618,Nomura; Kenji,9999,0,9999,0
1668288435426,ECE 200,034,103619,Orlitsky; Alon,9999,0,9999,0
1668288435426,ECE 200,035,103620,Pal; Piya,9999,0,9999,0
1668288435426,ECE 200,036,103621,Papen; George C.,9999,0,9999,0
1668288435426,ECE 200,037,103622,Radic; Stojan,9999,0,9999,0
1668288435426,ECE 200,038,103623,Rao; Bhaskar D.,9999,0,9999,0
1668288435426,ECE 200,039,103624,Rao; Ramesh R,9999,0,9999,0
1668288435426,ECE 200,040,103625,Rebeiz; Gabriel,9999,0,9999,0
1668288435426,ECE 200,041,103626,Sanford; John R,9999,0,9999,0
1668288435426,ECE 200,042,103627,Siegel; Paul H.,9999,0,9999,0
1668288435426,ECE 200,043,103628,Sievenpiper; Daniel F.,9999,0,9999,0
1668288435426,ECE 200,044,103629,Sworder; David D.,9999,0,9999,0
1668288435426,ECE 200,045,103630,Taur; Yuan,9999,0,9999,0
1668288435426,ECE 200,046,103631,Touri; Behrouz,9999,0,9999,0
1668288435426,ECE 200,047,103632,Trivedi; Mohan M.,9999,0,9999,0
1668288435426,ECE 200,048,103633,Vasconcelos; Nuno,9999,0,9999,0
1668288435426,ECE 200,049,103634,Wang; Xiaolong,9999,0,9999,0
1668288435426,ECE 200,050,103635,Xie; Pengtao,9999,0,9999,0
1668288435426,ECE 200,051,103636,Yip; Michael,9999,0,9999,0
1668288435426,ECE 200,052,103637,Zeger; Kenneth A.,999,0,999,0
1668288435426,ECE 200,053,103638,Zhang; Xinyu,9999,0,9999,0
1668288435426,ECE 200,054,103639,Turakhia; Yatish Girish,9999,0,9999,0
1668288435426,ECE 200,055,103640,Kang; Mingu,9999,0,9999,0
1668288435426,ECE 200,056,103641,Shi; Yuanyuan,9999,0,9999,0
1668288435426,ECE 200,057,103642,Wang; Edward Jay,9999,0,9999,0
1668288435426,ECE 200,058,103643,Zheng; Yang,9999,0,9999,0
1668288435858,ECE 202,A00,103644,Kuzum; Duygu,0,0,0,0
1668288436283,ECE 212BN,A00,103646,Ng; Tse Nga,0,0,0,0
1668288436708,ECE 221,A00,111493,Staff,0,0,0,0
1668288437131,ECE 222B,A00,103647,Lomakin; Vitaliy,0,0,0,0
1668288437558,ECE 230B,A00,103648,Taur; Yuan,0,0,0,0
1668288437983,ECE 238B,A00,103649,Garay; Javier,0,0,0,0
1668288438406,ECE 240B,A00,112900,Fainman; Yeshaiahu,0,0,0,0
1668288438829,ECE 247A,A00,103650,Jokerst; Jesse Vincent,0,0,0,0
1668288439256,ECE 247B,A00,103651,Wang; Joseph,0,0,0,0
1668288439684,ECE 250,A00,103652,Siegel; Paul H.,0,0,0,0
1668288440107,ECE 251A,A00,103654,Rao; Bhaskar D.,0,0,0,0
1668288440539,ECE 257B,A00,103655,Bharadia; Dinesh,0,0,0,0
1668288440967,ECE 258A,A00,103656,Milstein; Laurence B.,0,0,0,0
1668288441389,ECE 260B,A00,103658,Kang; Mingu,0,0,0,0
1668288441812,ECE 264A,A00,103659,Galton; Ian A,0,0,0,0
1668288442238,ECE 265A,A00,103661,Gudem; Prasad S.S.,0,0,0,0
1668288442664,ECE 265D,A00,103662,Gudem; Prasad S.S.,0,0,0,0
1668288443091,ECE 268,A00,103663,Koushanfar; Farinaz,0,0,0,0
1668288443519,ECE 269,A01,103665,Pal; Piya,0,0,0,0
1668288443945,ECE 271B,A00,103666,Vasconcelos; Manuela,0,0,0,0
1668288444368,ECE 276A,A00,103667,Atanasov; Nikolay A.,0,0,0,0
1668288444794,ECE 277,A00,103668,An; Cheolhong,0,0,0,0
1668288445216,ECE 279,A00,117947,Hall; Drew A.,0,0,0,0
1668288446062,ECE 283,A00,103670,Hsueh; Tzu-Chien,0,0,0,0
1668288446496,ECE 284,A00,103671,Turakhia; Yatish Girish,0,0,0,0
1668288446921,ECE 285,A00,103672,Zheng; Yang,0,0,0,0
1668288446921,ECE 285,B00,103673,Sworder; David D.,0,0,0,0
1668288447345,ECE 287,A00,103676,Javidi; Tara,0,0,0,0
1668288447766,MATH 200B,A00,098023,Salehi Golsefidy; Alireza,12,0,15,3
1668288448189,MATH 202B,A00,098024,Rhoades; Brendon Patrick,9,0,15,6
1668288448612,MATH 203B,A00,098025,Oprea; Dragos N.,10,0,15,5
1668288449056,MATH 204B,A00,098026,Sorensen; Claus M,13,0,15,2
1668288449480,MATH 208,A00,098027,Izadi; Elham,7,0,10,3
1668288449903,MATH 209,A00,098028,Pollack; Aaron,10,0,10,0
1668288450329,MATH 211A,A00,112919,Rogalski; Daniel,9,0,10,1
1668288450751,MATH 211B,A00,112920,Seward; Brandon M.,9,0,10,1
1668288451177,MATH 218,A00,098029,Li; Bo,10,0,10,0
1668288451601,MATH 220B,A00,098030,Novak; Jonathan I,11,0,15,4
1668288452024,MATH 221A,A00,098031,Ebenfelt; Peter F,13,0,15,2
1668288452451,MATH 231B,A00,098032,Zlatos; Andrej,12,0,15,3
1668288452874,MATH 240B,A00,098033,Ni; Lei,9,0,15,6
1668288453302,MATH 243,A00,098034,Jekel; David Andrew,10,0,10,0
1668288453727,MATH 245A,A00,098035,Nie; Jiawang,0,0,15,16
1668288454156,MATH 248,A00,098036,Bejenaru; Ioan,10,0,10,0
1668288454581,MATH 250B,A00,098037,Spolaor; Luca,14,0,15,1
1668288455007,MATH 258,A00,098038,Ni; Lei,10,0,10,0
1668288455431,MATH 264B,A00,098041,Rhoades; Brendon Patrick,9,0,15,6
1668288455855,MATH 268,A00,098042,Buss; Samuel R,10,0,10,0
1668288456280,MATH 269,A00,098043,Rhoades; Brendon Patrick,10,0,10,0
1668288456706,MATH 270B,A00,098044,Li; Bo,10,0,15,5
1668288457130,MATH 272B,A00,098045,Holst; Michael J,13,0,15,2
1668288457555,MATH 273A,A00,098046,Tian; Xiaochuan,10,0,15,5
1668288457983,MATH 275,A01,098048,Tian; Xiaochuan,6,0,10,4
1668288458406,MATH 278A,A00,098049,Holst; Michael J,8,0,10,2
1668288458828,MATH 278B,A00,098050,Cloninger; Alexander,10,0,10,0
1668288459252,MATH 278C,A00,098051,Nie; Jiawang,7,0,10,3
1668288459675,MATH 280B,A00,098052,Zheng; Tianyi,8,0,15,7
1668288460120,MATH 281B,A00,098053,Bradic; Jelena,1,0,15,14
1668288460545,MATH 282B,A00,098054,Arias-Castro; Ery,0,0,15,15
1668288460968,MATH 285,A00,098055,Fitzsimmons; Patrick J,0,0,15,17
1668288461391,MATH 287B,A00,098056,Arias-Castro; Ery,2,0,15,13
1668288461814,MATH 288,A00,098057,Agarwal; Pooja,9,0,10,1
1668288461814,MATH 288,B00,098058,Zhang; Danna,8,0,10,2
1668288461814,MATH 288,C00,098059,Williams; Ruth J,9,0,10,1
1668288462239,MATH 290B,A00,098060,Roberts; Justin Deritter,13,0,15,2
1668288462665,MATH 292,A00,098061,Belmont; Eva Kinoshita,10,0,10,0
1668288463088,MATH 295,A00,098062,Suk; Andrew Hoon,48,0,50,2
1668288463512,MATH 296,A00,098063,Novak; Jonathan I,20,0,20,0
1668288463937,MATH 297,001,098064,Gamst; Anthony Collins,9997,0,9999,2
1668288962765,COGS 205,A00,101395,Chiba; Andrea,19,0,20,1
1668288963192,COGS 210B,001,101404,Greene; Deanna Jacquelyn,9998,0,9999,1
1668288963192,COGS 210B,002,101417,Xia; Haijun,9999,0,9999,0
1668288963192,COGS 210B,003,101422,Nitz; Douglas A.,9999,0,9999,0
1668288963192,COGS 210B,004,101423,Hollan; James D.,9998,0,9999,1
1668288963192,COGS 210B,005,101424,Deak; Gedeon O.,9998,0,9999,1
1668288963192,COGS 210B,006,101425,Rossano; Federico,9999,0,9999,0
1668288963614,COGS 211B,A00,101427,Coulson; Seana M,9996,0,9999,3
1668288964040,COGS 220,A00,101428,Hollan; James D.,0,0,25,25
1668288964466,COGS 229,A00,101429,Dow; Steven P,18,0,25,7
1668288964891,COGS 230,A00,101430,Klemmer; Scott R,12,0,17,5
1668288965314,COGS 234,A00,101431,Xia; Haijun,1,0,25,24
1668288965741,COGS 260,A00,101432,Kiyonaga; Anastasia,21,0,25,4
1668288965741,COGS 260,B00,101433,Kirsh; David Joel,15,0,25,10
1668288966164,CSE 202,A00,102371,Impagliazzo; Russell,0,0,0,0
1668288966588,CSE 203B,A01,102373,Cheng; Chung Kuan,0,0,0,0
1668288967013,CSE 208,A00,102374,Micciancio; Daniele,0,0,0,0
1668288967439,CSE 209A,A00,112895,Impagliazzo; Russell,0,0,15,15
1668288967862,CSE 209B,A00,108005,Bellare; Mihir,0,0,0,0
1668288968284,CSE 210,A00,113163,Coblenz; Michael J,0,0,0,0
1668288968709,CSE 219,A00,106111,Dow; Steven P,0,0,20,20
1668288969132,CSE 221,A00,102376,Voelker; Geoffrey M.,0,0,0,0
1668288969557,CSE 224,A01,102378,Porter; George M,0,0,0,0
1668288969981,CSE 229A,A00,102379,Savage; Stefan,0,0,0,0
1668288970410,CSE 229C,A00,102380,Munyaka; Imani N. S.,0,0,0,0
1668288970835,CSE 232B,A00,102382,Deutsch; Alin Bernard,0,0,0,0
1668288971257,CSE 234,A01,112904,Kumar; Arun Kumar,0,0,0,0
1668288971681,CSE 237A,A00,102383,Rosing; Tajana Simunic,0,0,0,0
1668288972104,CSE 239A,A00,102384,Deutsch; Alin Bernard,0,0,0,0
1668288972529,CSE 239B,A00,102385,Polikarpova; Nadezhda,0,0,0,0
1668288972952,CSE 240A,A00,102386,Pannuto; Patrick William,0,0,0,0
1668288973377,CSE 240B,A00,102387,Zhao; Jishen,0,0,0,0
1668288973798,CSE 241A,A00,106406,Kang; Mingu,0,0,0,0
1668288974229,CSE 249B,A00,102388,Kahng; Andrew Byun,0,0,8,8
1668288974652,CSE 251B,A01,102392,Cottrell; Garrison W,0,0,0,0
1668288974652,CSE 251B,A02,102393,Cottrell; Garrison W,0,0,0,0
1668288975079,CSE 252B,A00,102394,Ochoa; Benjamin Lawrence,0,0,0,0
1668288975509,CSE 257,A01,102396,Gao; Sicun,0,0,0,0
1668288975933,CSE 272,A00,102397,Li; Tzumao,0,0,0,0
1668288976358,CSE 274,A00,111323,Chern; Albert Ren-Haur,0,0,0,0
1668288976783,CSE 282,A00,102398,Pevzner; Pavel Arkadjevich,0,0,0,0
1668288977205,CSE 284,A00,114175,Gymrek; Melissa Ann,0,0,0,0
1668288977628,CSE 290,A00,102399,Chandraker; Manmohan Krishna,0,0,0,0
1668288977628,CSE 290,B00,102400,Vaccaro; Kristen Marie,0,0,25,25
1668288977628,CSE 290,C00,102414,Pannuto; Patrick William,0,0,25,25
1668288977628,CSE 290,D00,102427,Pevzner; Pavel Arkadjevich,0,0,0,0
1668288977628,CSE 290,E00,102429,Zhao; Jishen,0,0,0,0
1668288977628,CSE 290,F00,102436,Tullsen; Dean Michael,0,0,0,0
1668288977628,CSE 290,G00,102440,Christensen; Henrik I,0,0,20,20
1668288978050,CSE 291,A00,102443,Su; Hao,0,0,0,0
1668288978050,CSE 291,B00,102448,Polikarpova; Nadezhda,0,0,0,0
1668288978050,CSE 291,C00,102453,Vaccaro; Kristen Marie,0,0,0,0
1668288978050,CSE 291,D00,111343,Savage; Stefan,0,0,0,0
1668288978050,CSE 291,E00,116474,Claffy; Kimberly Claire,0,0,0,0
1668288978050,CSE 291,F00,116479,Pasquale; Joseph,0,0,0,0
1668288978475,CSE 293,001,119111,Bafna; Vineet,9999,0,9999,0
1668288978475,CSE 293,002,119118,Bellare; Mihir,9999,0,9999,0
1668288978475,CSE 293,003,119122,Berg-Kirkpatrick; Taylor D,9999,0,9999,0
1668288978475,CSE 293,004,119135,Christensen; Henrik I,9999,0,9999,0
1668288978475,CSE 293,005,119142,Cottrell; Garrison W,9999,0,9999,0
1668288978475,CSE 293,006,119146,Deutsch; Alin Bernard,9999,0,9999,0
1668288978475,CSE 293,007,119159,Esmaeilzadeh; Hadi,9999,0,9999,0
1668288978475,CSE 293,008,119166,Freund; Yoav,9999,0,9999,0
1668288978475,CSE 293,009,119170,Griswold; William G.,9999,0,9999,0
1668288978475,CSE 293,010,119183,Gymrek; Melissa Ann,9999,0,9999,0
1668288978475,CSE 293,011,119190,Heninger; Nadia A,9999,0,9999,0
1668288978475,CSE 293,012,119230,Impagliazzo; Russell,9999,0,9999,0
1668288978475,CSE 293,013,119232,Jhala; Ranjit,9999,0,9999,0
1668288978475,CSE 293,014,119233,Kahng; Andrew Byun,9999,0,9999,0
1668288978475,CSE 293,015,119298,Kane; Daniel Mertz,9999,0,9999,0
1668288978475,CSE 293,016,119299,Kriegman; David J,9999,0,9999,0
1668288978475,CSE 293,017,119300,Kumar; Arun Kumar,9999,0,9999,0
1668288978475,CSE 293,018,119301,Lerner; Sorin,9999,0,9999,0
1668288978475,CSE 293,019,119302,Lovett; Shachar,9999,0,9999,0
1668288978475,CSE 293,020,119303,McAuley; Julian John,9999,0,9999,0
1668288978475,CSE 293,021,119304,Micciancio; Daniele,9999,0,9999,0
1668288978475,CSE 293,022,119367,Orailoglu; Alex,9999,0,9999,0
1668288978475,CSE 293,023,119382,Paturi; Ramamohan,9999,0,9999,0
1668288978475,CSE 293,024,119404,Polikarpova; Nadezhda,9999,0,9999,0
1668288978475,CSE 293,025,119406,Politz; Joseph Gibbs,9999,0,9999,0
1668288978475,CSE 293,026,119411,Porter; George M,9999,0,9999,0
1668288978475,CSE 293,027,119414,Porter; Leonard Emerson,9999,0,9999,0
1668288978475,CSE 293,028,119416,Ramamoorthi; Ravi,9999,0,9999,0
1668288978475,CSE 293,029,119417,Sahoo; Debashis,9999,0,9999,0
1668288978475,CSE 293,030,119420,Saul; Lawrence,9999,0,9999,0
1668288978475,CSE 293,031,119421,Savage; Stefan,9999,0,9999,0
1668288978475,CSE 293,032,119425,Schulze; Jurgen P.,9999,0,9999,0
1668288978475,CSE 293,033,119426,Snoeren; Alex C.,9999,0,9999,0
1668288978475,CSE 293,034,119428,Shang; Jingbo,9999,0,9999,0
1668288978475,CSE 293,035,119430,Stefan; Deian,9999,0,9999,0
1668288978475,CSE 293,036,119431,Su; Hao,9999,0,9999,0
1668288978475,CSE 293,037,119433,Swanson; Steven James,9999,0,9999,0
1668288978475,CSE 293,038,119435,Tullsen; Dean Michael,9999,0,9999,0
1668288978475,CSE 293,039,119483,Voelker; Geoffrey M.,9999,0,9999,0
1668288978475,CSE 293,040,119537,Zhao; Jishen,9999,0,9999,0
1668288978475,CSE 293,041,119538,Zhou; Yuan-Yuan,9999,0,9999,0
1668288978475,CSE 293,042,119539,Gao; Sicun,9999,0,9999,0
1668288978475,CSE 293,043,119540,Weibel; Nadir,9999,0,9999,0
1668288978475,CSE 293,044,119541,Gupta; Rajesh K.,9999,0,9999,0
1668288978475,CSE 293,045,126410,Vaccaro; Kristen Marie,9999,0,9999,0
1668288978475,CSE 293,046,126411,Klemke; Richard,9999,0,9999,0
1668288978898,CSE 294,A00,102459,Voelker; Geoffrey M.,0,0,0,0
1668288978898,CSE 294,B00,111322,Orailoglu; Alex,0,0,0,0
1668288979326,DSE 201,A00,096914,Deutsch; Alin Bernard,30,0,30,0
1668288979752,DSE 210,A00,096915,Dasgupta; Sanjoy,30,0,30,0
1668288980176,DSE 260A,A00,096916,Altintas De Callaf; Ilkay,30,0,30,0
1668288980603,ECE 200,001,103586,Antipa; Nicholas A,9999,0,9999,0
1668288980603,ECE 200,002,103587,Atanasov; Nikolay A.,9999,0,9999,0
1668288980603,ECE 200,003,103588,Bharadia; Dinesh,9999,0,9999,0
1668288980603,ECE 200,004,103589,Cheng; Chung Kuan,9999,0,9999,0
1668288980603,ECE 200,005,103590,Cosman; Pamela C.,9999,0,9999,0
1668288980603,ECE 200,006,103591,Dayeh; Shadi Ahmad,9999,0,9999,0
1668288980603,ECE 200,007,103592,Fainman; Yeshaiahu,9999,0,9999,0
1668288980603,ECE 200,008,103593,Ford; Joseph Earl,9999,0,9999,0
1668288980603,ECE 200,009,103594,Franceschetti; Massimo,9999,0,9999,0
1668288980603,ECE 200,010,103595,Fullerton; Eric E,9999,0,9999,0
1668288980603,ECE 200,011,103596,Galton; Ian A,9999,0,9999,0
1668288980603,ECE 200,012,103597,Gilja; Vikash,9999,0,9999,0
1668288980603,ECE 200,013,103598,Hall; Drew A.,9999,0,9999,0
1668288980603,ECE 200,014,103599,Hsueh; Tzu-Chien,9999,0,9999,0
1668288980603,ECE 200,015,103600,Javidi; Tara,9999,0,9999,0
1668288980603,ECE 200,016,103601,Kahng; Andrew Byun,9999,0,9999,0
1668288980603,ECE 200,017,103602,Kim; Young-Han,9999,0,9999,0
1668288980603,ECE 200,018,103603,Koushanfar; Farinaz,9999,0,9999,0
1668288980603,ECE 200,019,103604,Kuzum; Duygu,9999,0,9999,0
1668288980603,ECE 200,020,103605,Le; Hanh-Phuc,9999,0,9999,0
1668288980603,ECE 200,021,103606,Lin; Bill,9999,0,9999,0
1668288980603,ECE 200,022,103607,Liu; Zhaowei,9998,0,9999,1
1668288980603,ECE 200,023,103608,Lo; Yu-Hwa,9999,0,9999,0
1668288980603,ECE 200,024,103609,Lomakin; Vitaliy,9999,0,9999,0
1668288980603,ECE 200,025,103610,Mercier; Patrick Philip,9999,0,9999,0
1668288980603,ECE 200,026,103611,Meyer; Florian,9999,0,9999,0
1668288980603,ECE 200,027,103612,Milstein; Laurence B.,9999,0,9999,0
1668288980603,ECE 200,028,103613,Mir Arabbaygi; Siavash,9999,0,9999,0
1668288980603,ECE 200,029,103614,Mookherjea; Shayan,9999,0,9999,0
1668288980603,ECE 200,030,103615,Morris; Karcher William,9999,0,9999,0
1668288980603,ECE 200,031,103616,Ng; Tse Nga,9999,0,9999,0
1668288980603,ECE 200,032,103617,Nguyen; Truong Quang,9999,0,9999,0
1668288980603,ECE 200,033,103618,Nomura; Kenji,9999,0,9999,0
1668288980603,ECE 200,034,103619,Orlitsky; Alon,9999,0,9999,0
1668288980603,ECE 200,035,103620,Pal; Piya,9999,0,9999,0
1668288980603,ECE 200,036,103621,Papen; George C.,9999,0,9999,0
1668288980603,ECE 200,037,103622,Radic; Stojan,9999,0,9999,0
1668288980603,ECE 200,038,103623,Rao; Bhaskar D.,9999,0,9999,0
1668288980603,ECE 200,039,103624,Rao; Ramesh R,9999,0,9999,0
1668288980603,ECE 200,040,103625,Rebeiz; Gabriel,9999,0,9999,0
1668288980603,ECE 200,041,103626,Sanford; John R,9999,0,9999,0
1668288980603,ECE 200,042,103627,Siegel; Paul H.,9999,0,9999,0
1668288980603,ECE 200,043,103628,Sievenpiper; Daniel F.,9999,0,9999,0
1668288980603,ECE 200,044,103629,Sworder; David D.,9999,0,9999,0
1668288980603,ECE 200,045,103630,Taur; Yuan,9999,0,9999,0
1668288980603,ECE 200,046,103631,Touri; Behrouz,9999,0,9999,0
1668288980603,ECE 200,047,103632,Trivedi; Mohan M.,9999,0,9999,0
1668288980603,ECE 200,048,103633,Vasconcelos; Nuno,9999,0,9999,0
1668288980603,ECE 200,049,103634,Wang; Xiaolong,9999,0,9999,0
1668288980603,ECE 200,050,103635,Xie; Pengtao,9999,0,9999,0
1668288980603,ECE 200,051,103636,Yip; Michael,9999,0,9999,0
1668288980603,ECE 200,052,103637,Zeger; Kenneth A.,999,0,999,0
1668288980603,ECE 200,053,103638,Zhang; Xinyu,9999,0,9999,0
1668288980603,ECE 200,054,103639,Turakhia; Yatish Girish,9999,0,9999,0
1668288980603,ECE 200,055,103640,Kang; Mingu,9999,0,9999,0
1668288980603,ECE 200,056,103641,Shi; Yuanyuan,9999,0,9999,0
1668288980603,ECE 200,057,103642,Wang; Edward Jay,9999,0,9999,0
1668288980603,ECE 200,058,103643,Zheng; Yang,9999,0,9999,0
1668288981026,ECE 202,A00,103644,Kuzum; Duygu,0,0,0,0
1668288981449,ECE 212BN,A00,103646,Ng; Tse Nga,0,0,0,0
1668288981873,ECE 221,A00,111493,Staff,0,0,0,0
1668288982298,ECE 222B,A00,103647,Lomakin; Vitaliy,0,0,0,0
1668288982723,ECE 230B,A00,103648,Taur; Yuan,0,0,0,0
1668288983146,ECE 238B,A00,103649,Garay; Javier,0,0,0,0
1668288983571,ECE 240B,A00,112900,Fainman; Yeshaiahu,0,0,0,0
1668288983995,ECE 247A,A00,103650,Jokerst; Jesse Vincent,0,0,0,0
1668288984422,ECE 247B,A00,103651,Wang; Joseph,0,0,0,0
1668288984849,ECE 250,A00,103652,Siegel; Paul H.,0,0,0,0
1668288985281,ECE 251A,A00,103654,Rao; Bhaskar D.,0,0,0,0
1668288985703,ECE 257B,A00,103655,Bharadia; Dinesh,0,0,0,0
1668288986129,ECE 258A,A00,103656,Milstein; Laurence B.,0,0,0,0
1668288986551,ECE 260B,A00,103658,Kang; Mingu,0,0,0,0
1668288986977,ECE 264A,A00,103659,Galton; Ian A,0,0,0,0
1668288987404,ECE 265A,A00,103661,Gudem; Prasad S.S.,0,0,0,0
1668288987825,ECE 265D,A00,103662,Gudem; Prasad S.S.,0,0,0,0
1668288988250,ECE 268,A00,103663,Koushanfar; Farinaz,0,0,0,0
1668288988676,ECE 269,A01,103665,Pal; Piya,0,0,0,0
1668288989178,ECE 271B,A00,103666,Vasconcelos; Manuela,0,0,0,0
1668288989601,ECE 276A,A00,103667,Atanasov; Nikolay A.,0,0,0,0
1668288990023,ECE 277,A00,103668,An; Cheolhong,0,0,0,0
1668288990446,ECE 279,A00,117947,Hall; Drew A.,0,0,0,0
1668288991298,ECE 283,A00,103670,Hsueh; Tzu-Chien,0,0,0,0
1668288991728,ECE 284,A00,103671,Turakhia; Yatish Girish,0,0,0,0
1668288992156,ECE 285,A00,103672,Zheng; Yang,0,0,0,0
1668288992156,ECE 285,B00,103673,Sworder; David D.,0,0,0,0
1668288992578,ECE 287,A00,103676,Javidi; Tara,0,0,0,0
1668288993002,MATH 200B,A00,098023,Salehi Golsefidy; Alireza,12,0,15,3
1668288993425,MATH 202B,A00,098024,Rhoades; Brendon Patrick,9,0,15,6
1668288993847,MATH 203B,A00,098025,Oprea; Dragos N.,10,0,15,5
1668288994271,MATH 204B,A00,098026,Sorensen; Claus M,13,0,15,2
1668288994693,MATH 208,A00,098027,Izadi; Elham,7,0,10,3
1668288995119,MATH 209,A00,098028,Pollack; Aaron,10,0,10,0
1668288995542,MATH 211A,A00,112919,Rogalski; Daniel,9,0,10,1
1668288995964,MATH 211B,A00,112920,Seward; Brandon M.,9,0,10,1
1668288996396,MATH 218,A00,098029,Li; Bo,10,0,10,0
1668288996823,MATH 220B,A00,098030,Novak; Jonathan I,11,0,15,4
1668288997249,MATH 221A,A00,098031,Ebenfelt; Peter F,13,0,15,2
1668288997672,MATH 231B,A00,098032,Zlatos; Andrej,12,0,15,3
1668288998099,MATH 240B,A00,098033,Ni; Lei,9,0,15,6
1668288998521,MATH 243,A00,098034,Jekel; David Andrew,10,0,10,0
1668288998948,MATH 245A,A00,098035,Nie; Jiawang,0,0,15,16
1668288999370,MATH 248,A00,098036,Bejenaru; Ioan,10,0,10,0
1668288999793,MATH 250B,A00,098037,Spolaor; Luca,14,0,15,1
1668289000218,MATH 258,A00,098038,Ni; Lei,10,0,10,0
1668289000645,MATH 264B,A00,098041,Rhoades; Brendon Patrick,9,0,15,6
1668289001070,MATH 268,A00,098042,Buss; Samuel R,10,0,10,0
1668289001496,MATH 269,A00,098043,Rhoades; Brendon Patrick,10,0,10,0
1668289001920,MATH 270B,A00,098044,Li; Bo,10,0,15,5
1668289002346,MATH 272B,A00,098045,Holst; Michael J,13,0,15,2
1668289002768,MATH 273A,A00,098046,Tian; Xiaochuan,10,0,15,5
1668289003195,MATH 275,A01,098048,Tian; Xiaochuan,6,0,10,4
1668289003625,MATH 278A,A00,098049,Holst; Michael J,8,0,10,2
1668289004050,MATH 278B,A00,098050,Cloninger; Alexander,10,0,10,0
1668289004472,MATH 278C,A00,098051,Nie; Jiawang,7,0,10,3
1668289004900,MATH 280B,A00,098052,Zheng; Tianyi,8,0,15,7
1668289005325,MATH 281B,A00,098053,Bradic; Jelena,1,0,15,14
1668289005748,MATH 282B,A00,098054,Arias-Castro; Ery,0,0,15,15
1668289006171,MATH 285,A00,098055,Fitzsimmons; Patrick J,0,0,15,17
1668289006593,MATH 287B,A00,098056,Arias-Castro; Ery,2,0,15,13
1668289007016,MATH 288,A00,098057,Agarwal; Pooja,9,0,10,1
1668289007016,MATH 288,B00,098058,Zhang; Danna,8,0,10,2
1668289007016,MATH 288,C00,098059,Williams; Ruth J,9,0,10,1
1668289007442,MATH 290B,A00,098060,Roberts; Justin Deritter,13,0,15,2
1668289007865,MATH 292,A00,098061,Belmont; Eva Kinoshita,10,0,10,0
1668289008296,MATH 295,A00,098062,Suk; Andrew Hoon,48,0,50,2
1668289008726,MATH 296,A00,098063,Novak; Jonathan I,20,0,20,0
1668289009151,MATH 297,001,098064,Gamst; Anthony Collins,9997,0,9999,2
1668289507629,COGS 205,A00,101395,Chiba; Andrea,19,0,20,1
1668289508053,COGS 210B,001,101404,Greene; Deanna Jacquelyn,9998,0,9999,1
1668289508053,COGS 210B,002,101417,Xia; Haijun,9999,0,9999,0
1668289508053,COGS 210B,003,101422,Nitz; Douglas A.,9999,0,9999,0
1668289508053,COGS 210B,004,101423,Hollan; James D.,9998,0,9999,1
1668289508053,COGS 210B,005,101424,Deak; Gedeon O.,9998,0,9999,1
1668289508053,COGS 210B,006,101425,Rossano; Federico,9999,0,9999,0
1668289508477,COGS 211B,A00,101427,Coulson; Seana M,9996,0,9999,3
1668289508903,COGS 220,A00,101428,Hollan; James D.,0,0,25,25
1668289509329,COGS 229,A00,101429,Dow; Steven P,18,0,25,7
1668289509751,COGS 230,A00,101430,Klemmer; Scott R,12,0,17,5
1668289510174,COGS 234,A00,101431,Xia; Haijun,1,0,25,24
1668289510603,COGS 260,A00,101432,Kiyonaga; Anastasia,21,0,25,4
1668289510603,COGS 260,B00,101433,Kirsh; David Joel,15,0,25,10
1668289511030,CSE 202,A00,102371,Impagliazzo; Russell,0,0,0,0
1668289511456,CSE 203B,A01,102373,Cheng; Chung Kuan,0,0,0,0
1668289511881,CSE 208,A00,102374,Micciancio; Daniele,0,0,0,0
1668289512304,CSE 209A,A00,112895,Impagliazzo; Russell,0,0,15,15
1668289512729,CSE 209B,A00,108005,Bellare; Mihir,0,0,0,0
1668289513158,CSE 210,A00,113163,Coblenz; Michael J,0,0,0,0
1668289513581,CSE 219,A00,106111,Dow; Steven P,0,0,20,20
1668289514007,CSE 221,A00,102376,Voelker; Geoffrey M.,0,0,0,0
1668289514433,CSE 224,A01,102378,Porter; George M,0,0,0,0
1668289514866,CSE 229A,A00,102379,Savage; Stefan,0,0,0,0
1668289515291,CSE 229C,A00,102380,Munyaka; Imani N. S.,0,0,0,0
1668289515715,CSE 232B,A00,102382,Deutsch; Alin Bernard,0,0,0,0
1668289516144,CSE 234,A01,112904,Kumar; Arun Kumar,0,0,0,0
1668289516569,CSE 237A,A00,102383,Rosing; Tajana Simunic,0,0,0,0
1668289516993,CSE 239A,A00,102384,Deutsch; Alin Bernard,0,0,0,0
1668289517417,CSE 239B,A00,102385,Polikarpova; Nadezhda,0,0,0,0
1668289517841,CSE 240A,A00,102386,Pannuto; Patrick William,0,0,0,0
1668289518264,CSE 240B,A00,102387,Zhao; Jishen,0,0,0,0
1668289518687,CSE 241A,A00,106406,Kang; Mingu,0,0,0,0
1668289519111,CSE 249B,A00,102388,Kahng; Andrew Byun,0,0,8,8
1668289519535,CSE 251B,A01,102392,Cottrell; Garrison W,0,0,0,0
1668289519535,CSE 251B,A02,102393,Cottrell; Garrison W,0,0,0,0
1668289519959,CSE 252B,A00,102394,Ochoa; Benjamin Lawrence,0,0,0,0
1668289520382,CSE 257,A01,102396,Gao; Sicun,0,0,0,0
1668289520805,CSE 272,A00,102397,Li; Tzumao,0,0,0,0
1668289521236,CSE 274,A00,111323,Chern; Albert Ren-Haur,0,0,0,0
1668289521664,CSE 282,A00,102398,Pevzner; Pavel Arkadjevich,0,0,0,0
1668289522093,CSE 284,A00,114175,Gymrek; Melissa Ann,0,0,0,0
1668289522519,CSE 290,A00,102399,Chandraker; Manmohan Krishna,0,0,0,0
1668289522519,CSE 290,B00,102400,Vaccaro; Kristen Marie,0,0,25,25
1668289522519,CSE 290,C00,102414,Pannuto; Patrick William,0,0,25,25
1668289522519,CSE 290,D00,102427,Pevzner; Pavel Arkadjevich,0,0,0,0
1668289522519,CSE 290,E00,102429,Zhao; Jishen,0,0,0,0
1668289522519,CSE 290,F00,102436,Tullsen; Dean Michael,0,0,0,0
1668289522519,CSE 290,G00,102440,Christensen; Henrik I,0,0,20,20
1668289522945,CSE 291,A00,102443,Su; Hao,0,0,0,0
1668289522945,CSE 291,B00,102448,Polikarpova; Nadezhda,0,0,0,0
1668289522945,CSE 291,C00,102453,Vaccaro; Kristen Marie,0,0,0,0
1668289522945,CSE 291,D00,111343,Savage; Stefan,0,0,0,0
1668289522945,CSE 291,E00,116474,Claffy; Kimberly Claire,0,0,0,0
1668289522945,CSE 291,F00,116479,Pasquale; Joseph,0,0,0,0
1668289523379,CSE 293,001,119111,Bafna; Vineet,9999,0,9999,0
1668289523379,CSE 293,002,119118,Bellare; Mihir,9999,0,9999,0
1668289523379,CSE 293,003,119122,Berg-Kirkpatrick; Taylor D,9999,0,9999,0
1668289523379,CSE 293,004,119135,Christensen; Henrik I,9999,0,9999,0
1668289523379,CSE 293,005,119142,Cottrell; Garrison W,9999,0,9999,0
1668289523379,CSE 293,006,119146,Deutsch; Alin Bernard,9999,0,9999,0
1668289523379,CSE 293,007,119159,Esmaeilzadeh; Hadi,9999,0,9999,0
1668289523379,CSE 293,008,119166,Freund; Yoav,9999,0,9999,0
1668289523379,CSE 293,009,119170,Griswold; William G.,9999,0,9999,0
1668289523379,CSE 293,010,119183,Gymrek; Melissa Ann,9999,0,9999,0
1668289523379,CSE 293,011,119190,Heninger; Nadia A,9999,0,9999,0
1668289523379,CSE 293,012,119230,Impagliazzo; Russell,9999,0,9999,0
1668289523379,CSE 293,013,119232,Jhala; Ranjit,9999,0,9999,0
1668289523379,CSE 293,014,119233,Kahng; Andrew Byun,9999,0,9999,0
1668289523379,CSE 293,015,119298,Kane; Daniel Mertz,9999,0,9999,0
1668289523379,CSE 293,016,119299,Kriegman; David J,9999,0,9999,0
1668289523379,CSE 293,017,119300,Kumar; Arun Kumar,9999,0,9999,0
1668289523379,CSE 293,018,119301,Lerner; Sorin,9999,0,9999,0
1668289523379,CSE 293,019,119302,Lovett; Shachar,9999,0,9999,0
1668289523379,CSE 293,020,119303,McAuley; Julian John,9999,0,9999,0
1668289523379,CSE 293,021,119304,Micciancio; Daniele,9999,0,9999,0
1668289523379,CSE 293,022,119367,Orailoglu; Alex,9999,0,9999,0
1668289523379,CSE 293,023,119382,Paturi; Ramamohan,9999,0,9999,0
1668289523379,CSE 293,024,119404,Polikarpova; Nadezhda,9999,0,9999,0
1668289523379,CSE 293,025,119406,Politz; Joseph Gibbs,9999,0,9999,0
1668289523379,CSE 293,026,119411,Porter; George M,9999,0,9999,0
1668289523379,CSE 293,027,119414,Porter; Leonard Emerson,9999,0,9999,0
1668289523379,CSE 293,028,119416,Ramamoorthi; Ravi,9999,0,9999,0
1668289523379,CSE 293,029,119417,Sahoo; Debashis,9999,0,9999,0
1668289523379,CSE 293,030,119420,Saul; Lawrence,9999,0,9999,0
1668289523379,CSE 293,031,119421,Savage; Stefan,9999,0,9999,0
1668289523379,CSE 293,032,119425,Schulze; Jurgen P.,9999,0,9999,0
1668289523379,CSE 293,033,119426,Snoeren; Alex C.,9999,0,9999,0
1668289523379,CSE 293,034,119428,Shang; Jingbo,9999,0,9999,0
1668289523379,CSE 293,035,119430,Stefan; Deian,9999,0,9999,0
1668289523379,CSE 293,036,119431,Su; Hao,9999,0,9999,0
1668289523379,CSE 293,037,119433,Swanson; Steven James,9999,0,9999,0
1668289523379,CSE 293,038,119435,Tullsen; Dean Michael,9999,0,9999,0
1668289523379,CSE 293,039,119483,Voelker; Geoffrey M.,9999,0,9999,0
1668289523379,CSE 293,040,119537,Zhao; Jishen,9999,0,9999,0
1668289523379,CSE 293,041,119538,Zhou; Yuan-Yuan,9999,0,9999,0
1668289523379,CSE 293,042,119539,Gao; Sicun,9999,0,9999,0
1668289523379,CSE 293,043,119540,Weibel; Nadir,9999,0,9999,0
1668289523379,CSE 293,044,119541,Gupta; Rajesh K.,9999,0,9999,0
1668289523379,CSE 293,045,126410,Vaccaro; Kristen Marie,9999,0,9999,0
1668289523379,CSE 293,046,126411,Klemke; Richard,9999,0,9999,0
1668289523802,CSE 294,A00,102459,Voelker; Geoffrey M.,0,0,0,0
1668289523802,CSE 294,B00,111322,Orailoglu; Alex,0,0,0,0
1668289524226,DSE 201,A00,096914,Deutsch; Alin Bernard,30,0,30,0
1668289524648,DSE 210,A00,096915,Dasgupta; Sanjoy,30,0,30,0
1668289525083,DSE 260A,A00,096916,Altintas De Callaf; Ilkay,30,0,30,0
1668289525513,ECE 200,001,103586,Antipa; Nicholas A,9999,0,9999,0
1668289525513,ECE 200,002,103587,Atanasov; Nikolay A.,9999,0,9999,0
1668289525513,ECE 200,003,103588,Bharadia; Dinesh,9999,0,9999,0
1668289525513,ECE 200,004,103589,Cheng; Chung Kuan,9999,0,9999,0
1668289525513,ECE 200,005,103590,Cosman; Pamela C.,9999,0,9999,0
1668289525513,ECE 200,006,103591,Dayeh; Shadi Ahmad,9999,0,9999,0
1668289525513,ECE 200,007,103592,Fainman; Yeshaiahu,9999,0,9999,0
1668289525513,ECE 200,008,103593,Ford; Joseph Earl,9999,0,9999,0
1668289525513,ECE 200,009,103594,Franceschetti; Massimo,9999,0,9999,0
1668289525513,ECE 200,010,103595,Fullerton; Eric E,9999,0,9999,0
1668289525513,ECE 200,011,103596,Galton; Ian A,9999,0,9999,0
1668289525513,ECE 200,012,103597,Gilja; Vikash,9999,0,9999,0
1668289525513,ECE 200,013,103598,Hall; Drew A.,9999,0,9999,0
1668289525513,ECE 200,014,103599,Hsueh; Tzu-Chien,9999,0,9999,0
1668289525513,ECE 200,015,103600,Javidi; Tara,9999,0,9999,0
1668289525513,ECE 200,016,103601,Kahng; Andrew Byun,9999,0,9999,0
1668289525513,ECE 200,017,103602,Kim; Young-Han,9999,0,9999,0
1668289525513,ECE 200,018,103603,Koushanfar; Farinaz,9999,0,9999,0
1668289525513,ECE 200,019,103604,Kuzum; Duygu,9999,0,9999,0
1668289525513,ECE 200,020,103605,Le; Hanh-Phuc,9999,0,9999,0
1668289525513,ECE 200,021,103606,Lin; Bill,9999,0,9999,0
1668289525513,ECE 200,022,103607,Liu; Zhaowei,9998,0,9999,1
1668289525513,ECE 200,023,103608,Lo; Yu-Hwa,9999,0,9999,0
1668289525513,ECE 200,024,103609,Lomakin; Vitaliy,9999,0,9999,0
1668289525513,ECE 200,025,103610,Mercier; Patrick Philip,9999,0,9999,0
1668289525513,ECE 200,026,103611,Meyer; Florian,9999,0,9999,0
1668289525513,ECE 200,027,103612,Milstein; Laurence B.,9999,0,9999,0
1668289525513,ECE 200,028,103613,Mir Arabbaygi; Siavash,9999,0,9999,0
1668289525513,ECE 200,029,103614,Mookherjea; Shayan,9999,0,9999,0
1668289525513,ECE 200,030,103615,Morris; Karcher William,9999,0,9999,0
1668289525513,ECE 200,031,103616,Ng; Tse Nga,9999,0,9999,0
1668289525513,ECE 200,032,103617,Nguyen; Truong Quang,9999,0,9999,0
1668289525513,ECE 200,033,103618,Nomura; Kenji,9999,0,9999,0
1668289525513,ECE 200,034,103619,Orlitsky; Alon,9999,0,9999,0
1668289525513,ECE 200,035,103620,Pal; Piya,9999,0,9999,0
1668289525513,ECE 200,036,103621,Papen; George C.,9999,0,9999,0
1668289525513,ECE 200,037,103622,Radic; Stojan,9999,0,9999,0
1668289525513,ECE 200,038,103623,Rao; Bhaskar D.,9999,0,9999,0
1668289525513,ECE 200,039,103624,Rao; Ramesh R,9999,0,9999,0
1668289525513,ECE 200,040,103625,Rebeiz; Gabriel,9999,0,9999,0
1668289525513,ECE 200,041,103626,Sanford; John R,9999,0,9999,0
1668289525513,ECE 200,042,103627,Siegel; Paul H.,9999,0,9999,0
1668289525513,ECE 200,043,103628,Sievenpiper; Daniel F.,9999,0,9999,0
1668289525513,ECE 200,044,103629,Sworder; David D.,9999,0,9999,0
1668289525513,ECE 200,045,103630,Taur; Yuan,9999,0,9999,0
1668289525513,ECE 200,046,103631,Touri; Behrouz,9999,0,9999,0
1668289525513,ECE 200,047,103632,Trivedi; Mohan M.,9999,0,9999,0
1668289525513,ECE 200,048,103633,Vasconcelos; Nuno,9999,0,9999,0
1668289525513,ECE 200,049,103634,Wang; Xiaolong,9999,0,9999,0
1668289525513,ECE 200,050,103635,Xie; Pengtao,9999,0,9999,0
1668289525513,ECE 200,051,103636,Yip; Michael,9999,0,9999,0
1668289525513,ECE 200,052,103637,Zeger; Kenneth A.,999,0,999,0
1668289525513,ECE 200,053,103638,Zhang; Xinyu,9999,0,9999,0
1668289525513,ECE 200,054,103639,Turakhia; Yatish Girish,9999,0,9999,0
1668289525513,ECE 200,055,103640,Kang; Mingu,9999,0,9999,0
1668289525513,ECE 200,056,103641,Shi; Yuanyuan,9999,0,9999,0
1668289525513,ECE 200,057,103642,Wang; Edward Jay,9999,0,9999,0
1668289525513,ECE 200,058,103643,Zheng; Yang,9999,0,9999,0
1668289525936,ECE 202,A00,103644,Kuzum; Duygu,0,0,0,0
1668289526360,ECE 212BN,A00,103646,Ng; Tse Nga,0,0,0,0
1668289526783,ECE 221,A00,111493,Staff,0,0,0,0
1668289527207,ECE 222B,A00,103647,Lomakin; Vitaliy,0,0,0,0
1668289527631,ECE 230B,A00,103648,Taur; Yuan,0,0,0,0
1668289528058,ECE 238B,A00,103649,Garay; Javier,0,0,0,0
1668289528492,ECE 240B,A00,112900,Fainman; Yeshaiahu,0,0,0,0
1668289528916,ECE 247A,A00,103650,Jokerst; Jesse Vincent,0,0,0,0
1668289529342,ECE 247B,A00,103651,Wang; Joseph,0,0,0,0
1668289529766,ECE 250,A00,103652,Siegel; Paul H.,0,0,0,0
1668289530189,ECE 251A,A00,103654,Rao; Bhaskar D.,0,0,0,0
1668289530613,ECE 257B,A00,103655,Bharadia; Dinesh,0,0,0,0
1668289531038,ECE 258A,A00,103656,Milstein; Laurence B.,0,0,0,0
1668289531463,ECE 260B,A00,103658,Kang; Mingu,0,0,0,0
1668289531891,ECE 264A,A00,103659,Galton; Ian A,0,0,0,0
1668289532314,ECE 265A,A00,103661,Gudem; Prasad S.S.,0,0,0,0
1668289532739,ECE 265D,A00,103662,Gudem; Prasad S.S.,0,0,0,0
1668289533161,ECE 268,A00,103663,Koushanfar; Farinaz,0,0,0,0
1668289533584,ECE 269,A01,103665,Pal; Piya,0,0,0,0
1668289534007,ECE 271B,A00,103666,Vasconcelos; Manuela,0,0,0,0
1668289534429,ECE 276A,A00,103667,Atanasov; Nikolay A.,0,0,0,0
1668289534852,ECE 277,A00,103668,An; Cheolhong,0,0,0,0
1668289535278,ECE 279,A00,117947,Hall; Drew A.,0,0,0,0
1668289536125,ECE 283,A00,103670,Hsueh; Tzu-Chien,0,0,0,0
1668289536550,ECE 284,A00,103671,Turakhia; Yatish Girish,0,0,0,0
1668289536974,ECE 285,A00,103672,Zheng; Yang,0,0,0,0
1668289536974,ECE 285,B00,103673,Sworder; David D.,0,0,0,0
1668289537399,ECE 287,A00,103676,Javidi; Tara,0,0,0,0
1668289537827,MATH 200B,A00,098023,Salehi Golsefidy; Alireza,12,0,15,3
1668289538249,MATH 202B,A00,098024,Rhoades; Brendon Patrick,9,0,15,6
1668289538677,MATH 203B,A00,098025,Oprea; Dragos N.,10,0,15,5
1668289539100,MATH 204B,A00,098026,Sorensen; Claus M,13,0,15,2
1668289539537,MATH 208,A00,098027,Izadi; Elham,7,0,10,3
1668289539961,MATH 209,A00,098028,Pollack; Aaron,10,0,10,0
1668289540384,MATH 211A,A00,112919,Rogalski; Daniel,9,0,10,1
1668289540808,MATH 211B,A00,112920,Seward; Brandon M.,9,0,10,1
1668289541234,MATH 218,A00,098029,Li; Bo,10,0,10,0
1668289541661,MATH 220B,A00,098030,Novak; Jonathan I,11,0,15,4
1668289542084,MATH 221A,A00,098031,Ebenfelt; Peter F,13,0,15,2
1668289542510,MATH 231B,A00,098032,Zlatos; Andrej,12,0,15,3
1668289542933,MATH 240B,A00,098033,Ni; Lei,9,0,15,6
1668289543360,MATH 243,A00,098034,Jekel; David Andrew,10,0,10,0
1668289543783,MATH 245A,A00,098035,Nie; Jiawang,0,0,15,16
1668289544216,MATH 248,A00,098036,Bejenaru; Ioan,10,0,10,0
1668289544644,MATH 250B,A00,098037,Spolaor; Luca,14,0,15,1
1668289545068,MATH 258,A00,098038,Ni; Lei,10,0,10,0
1668289545495,MATH 264B,A00,098041,Rhoades; Brendon Patrick,9,0,15,6
1668289545918,MATH 268,A00,098042,Buss; Samuel R,10,0,10,0
1668289546341,MATH 269,A00,098043,Rhoades; Brendon Patrick,10,0,10,0
1668289546764,MATH 270B,A00,098044,Li; Bo,10,0,15,5
1668289547189,MATH 272B,A00,098045,Holst; Michael J,13,0,15,2
1668289547613,MATH 273A,A00,098046,Tian; Xiaochuan,10,0,15,5
1668289548041,MATH 275,A01,098048,Tian; Xiaochuan,6,0,10,4
1668289548475,MATH 278A,A00,098049,Holst; Michael J,8,0,10,2
1668289548898,MATH 278B,A00,098050,Cloninger; Alexander,10,0,10,0
1668289549328,MATH 278C,A00,098051,Nie; Jiawang,7,0,10,3
1668289549751,MATH 280B,A00,098052,Zheng; Tianyi,8,0,15,7
1668289550178,MATH 281B,A00,098053,Bradic; Jelena,1,0,15,14
1668289550706,MATH 282B,A00,098054,Arias-Castro; Ery,0,0,15,15
1668289551130,MATH 285,A00,098055,Fitzsimmons; Patrick J,0,0,15,17
1668289551556,MATH 287B,A00,098056,Arias-Castro; Ery,2,0,15,13
1668289551980,MATH 288,A00,098057,Agarwal; Pooja,9,0,10,1
1668289551980,MATH 288,B00,098058,Zhang; Danna,8,0,10,2
1668289551980,MATH 288,C00,098059,Williams; Ruth J,9,0,10,1
1668289552404,MATH 290B,A00,098060,Roberts; Justin Deritter,13,0,15,2
1668289552837,MATH 292,A00,098061,Belmont; Eva Kinoshita,10,0,10,0
1668289553261,MATH 295,A00,098062,Suk; Andrew Hoon,48,0,50,2
1668289553686,MATH 296,A00,098063,Novak; Jonathan I,20,0,20,0
1668289554111,MATH 297,001,098064,Gamst; Anthony Collins,9997,0,9999,2
1668290052998,COGS 205,A00,101395,Chiba; Andrea,19,0,20,1
1668290053423,COGS 210B,001,101404,Greene; Deanna Jacquelyn,9998,0,9999,1
1668290053423,COGS 210B,002,101417,Xia; Haijun,9999,0,9999,0
1668290053423,COGS 210B,003,101422,Nitz; Douglas A.,9999,0,9999,0
1668290053423,COGS 210B,004,101423,Hollan; James D.,9998,0,9999,1
1668290053423,COGS 210B,005,101424,Deak; Gedeon O.,9998,0,9999,1
1668290053423,COGS 210B,006,101425,Rossano; Federico,9999,0,9999,0
1668290053846,COGS 211B,A00,101427,Coulson; Seana M,9996,0,9999,3
1668290054284,COGS 220,A00,101428,Hollan; James D.,0,0,25,25
1668290054707,COGS 229,A00,101429,Dow; Steven P,18,0,25,7
1668290055130,COGS 230,A00,101430,Klemmer; Scott R,12,0,17,5
1668290055555,COGS 234,A00,101431,Xia; Haijun,1,0,25,24
1668290055980,COGS 260,A00,101432,Kiyonaga; Anastasia,21,0,25,4
1668290055980,COGS 260,B00,101433,Kirsh; David Joel,15,0,25,10
1668290056410,CSE 202,A00,102371,Impagliazzo; Russell,0,0,0,0
1668290056837,CSE 203B,A01,102373,Cheng; Chung Kuan,0,0,0,0
1668290057262,CSE 208,A00,102374,Micciancio; Daniele,0,0,0,0
1668290057686,CSE 209A,A00,112895,Impagliazzo; Russell,0,0,15,15
1668290058116,CSE 209B,A00,108005,Bellare; Mihir,0,0,0,0
1668290058541,CSE 210,A00,113163,Coblenz; Michael J,0,0,0,0
1668290058965,CSE 219,A00,106111,Dow; Steven P,0,0,20,20
1668290059390,CSE 221,A00,102376,Voelker; Geoffrey M.,0,0,0,0
1668290059817,CSE 224,A01,102378,Porter; George M,0,0,0,0
1668290060251,CSE 229A,A00,102379,Savage; Stefan,0,0,0,0
1668290060675,CSE 229C,A00,102380,Munyaka; Imani N. S.,0,0,0,0
1668290061105,CSE 232B,A00,102382,Deutsch; Alin Bernard,0,0,0,0
1668290061528,CSE 234,A01,112904,Kumar; Arun Kumar,0,0,0,0
1668290061953,CSE 237A,A00,102383,Rosing; Tajana Simunic,0,0,0,0
1668290062376,CSE 239A,A00,102384,Deutsch; Alin Bernard,0,0,0,0
1668290062799,CSE 239B,A00,102385,Polikarpova; Nadezhda,0,0,0,0
1668290063224,CSE 240A,A00,102386,Pannuto; Patrick William,0,0,0,0
1668290063649,CSE 240B,A00,102387,Zhao; Jishen,0,0,0,0
1668290064082,CSE 241A,A00,106406,Kang; Mingu,0,0,0,0
1668290064507,CSE 249B,A00,102388,Kahng; Andrew Byun,0,0,8,8
1668290064928,CSE 251B,A01,102392,Cottrell; Garrison W,0,0,0,0
1668290064928,CSE 251B,A02,102393,Cottrell; Garrison W,0,0,0,0
1668290065354,CSE 252B,A00,102394,Ochoa; Benjamin Lawrence,0,0,0,0
1668290065777,CSE 257,A01,102396,Gao; Sicun,0,0,0,0
1668290066202,CSE 272,A00,102397,Li; Tzumao,0,0,0,0
1668290066630,CSE 274,A00,111323,Chern; Albert Ren-Haur,0,0,0,0
1668290067057,CSE 282,A00,102398,Pevzner; Pavel Arkadjevich,0,0,0,0
1668290067478,CSE 284,A00,114175,Gymrek; Melissa Ann,0,0,0,0
1668290067905,CSE 290,A00,102399,Chandraker; Manmohan Krishna,0,0,0,0
1668290067905,CSE 290,B00,102400,Vaccaro; Kristen Marie,0,0,25,25
1668290067905,CSE 290,C00,102414,Pannuto; Patrick William,0,0,25,25
1668290067905,CSE 290,D00,102427,Pevzner; Pavel Arkadjevich,0,0,0,0
1668290067905,CSE 290,E00,102429,Zhao; Jishen,0,0,0,0
1668290067905,CSE 290,F00,102436,Tullsen; Dean Michael,0,0,0,0
1668290067905,CSE 290,G00,102440,Christensen; Henrik I,0,0,20,20
1668290068335,CSE 291,A00,102443,Su; Hao,0,0,0,0
1668290068335,CSE 291,B00,102448,Polikarpova; Nadezhda,0,0,0,0
1668290068335,CSE 291,C00,102453,Vaccaro; Kristen Marie,0,0,0,0
1668290068335,CSE 291,D00,111343,Savage; Stefan,0,0,0,0
1668290068335,CSE 291,E00,116474,Claffy; Kimberly Claire,0,0,0,0
1668290068335,CSE 291,F00,116479,Pasquale; Joseph,0,0,0,0
1668290068762,CSE 293,001,119111,Bafna; Vineet,9999,0,9999,0
1668290068762,CSE 293,002,119118,Bellare; Mihir,9999,0,9999,0
1668290068762,CSE 293,003,119122,Berg-Kirkpatrick; Taylor D,9999,0,9999,0
1668290068762,CSE 293,004,119135,Christensen; Henrik I,9999,0,9999,0
1668290068762,CSE 293,005,119142,Cottrell; Garrison W,9999,0,9999,0
1668290068762,CSE 293,006,119146,Deutsch; Alin Bernard,9999,0,9999,0
1668290068762,CSE 293,007,119159,Esmaeilzadeh; Hadi,9999,0,9999,0
1668290068762,CSE 293,008,119166,Freund; Yoav,9999,0,9999,0
1668290068762,CSE 293,009,119170,Griswold; William G.,9999,0,9999,0
1668290068762,CSE 293,010,119183,Gymrek; Melissa Ann,9999,0,9999,0
1668290068762,CSE 293,011,119190,Heninger; Nadia A,9999,0,9999,0
1668290068762,CSE 293,012,119230,Impagliazzo; Russell,9999,0,9999,0
1668290068762,CSE 293,013,119232,Jhala; Ranjit,9999,0,9999,0
1668290068762,CSE 293,014,119233,Kahng; Andrew Byun,9999,0,9999,0
1668290068762,CSE 293,015,119298,Kane; Daniel Mertz,9999,0,9999,0
1668290068762,CSE 293,016,119299,Kriegman; David J,9999,0,9999,0
1668290068762,CSE 293,017,119300,Kumar; Arun Kumar,9999,0,9999,0
1668290068762,CSE 293,018,119301,Lerner; Sorin,9999,0,9999,0
1668290068762,CSE 293,019,119302,Lovett; Shachar,9999,0,9999,0
1668290068762,CSE 293,020,119303,McAuley; Julian John,9999,0,9999,0
1668290068762,CSE 293,021,119304,Micciancio; Daniele,9999,0,9999,0
1668290068762,CSE 293,022,119367,Orailoglu; Alex,9999,0,9999,0
1668290068762,CSE 293,023,119382,Paturi; Ramamohan,9999,0,9999,0
1668290068762,CSE 293,024,119404,Polikarpova; Nadezhda,9999,0,9999,0
1668290068762,CSE 293,025,119406,Politz; Joseph Gibbs,9999,0,9999,0
1668290068762,CSE 293,026,119411,Porter; George M,9999,0,9999,0
1668290068762,CSE 293,027,119414,Porter; Leonard Emerson,9999,0,9999,0
1668290068762,CSE 293,028,119416,Ramamoorthi; Ravi,9999,0,9999,0
1668290068762,CSE 293,029,119417,Sahoo; Debashis,9999,0,9999,0
1668290068762,CSE 293,030,119420,Saul; Lawrence,9999,0,9999,0
1668290068762,CSE 293,031,119421,Savage; Stefan,9999,0,9999,0
1668290068762,CSE 293,032,119425,Schulze; Jurgen P.,9999,0,9999,0
1668290068762,CSE 293,033,119426,Snoeren; Alex C.,9999,0,9999,0
1668290068762,CSE 293,034,119428,Shang; Jingbo,9999,0,9999,0
1668290068762,CSE 293,035,119430,Stefan; Deian,9999,0,9999,0
1668290068762,CSE 293,036,119431,Su; Hao,9999,0,9999,0
1668290068762,CSE 293,037,119433,Swanson; Steven James,9999,0,9999,0
1668290068762,CSE 293,038,119435,Tullsen; Dean Michael,9999,0,9999,0
1668290068762,CSE 293,039,119483,Voelker; Geoffrey M.,9999,0,9999,0
1668290068762,CSE 293,040,119537,Zhao; Jishen,9999,0,9999,0
1668290068762,CSE 293,041,119538,Zhou; Yuan-Yuan,9999,0,9999,0
1668290068762,CSE 293,042,119539,Gao; Sicun,9999,0,9999,0
1668290068762,CSE 293,043,119540,Weibel; Nadir,9999,0,9999,0
1668290068762,CSE 293,044,119541,Gupta; Rajesh K.,9999,0,9999,0
1668290068762,CSE 293,045,126410,Vaccaro; Kristen Marie,9999,0,9999,0
1668290068762,CSE 293,046,126411,Klemke; Richard,9999,0,9999,0
1668290069185,CSE 294,A00,102459,Voelker; Geoffrey M.,0,0,0,0
1668290069185,CSE 294,B00,111322,Orailoglu; Alex,0,0,0,0
1668290069706,DSE 201,A00,096914,Deutsch; Alin Bernard,30,0,30,0
1668290070131,DSE 210,A00,096915,Dasgupta; Sanjoy,30,0,30,0
1668290070557,DSE 260A,A00,096916,Altintas De Callaf; Ilkay,30,0,30,0
1668290071000,ECE 200,001,103586,Antipa; Nicholas A,9999,0,9999,0
1668290071000,ECE 200,002,103587,Atanasov; Nikolay A.,9999,0,9999,0
1668290071000,ECE 200,003,103588,Bharadia; Dinesh,9999,0,9999,0
1668290071000,ECE 200,004,103589,Cheng; Chung Kuan,9999,0,9999,0
1668290071000,ECE 200,005,103590,Cosman; Pamela C.,9999,0,9999,0
1668290071000,ECE 200,006,103591,Dayeh; Shadi Ahmad,9999,0,9999,0
1668290071000,ECE 200,007,103592,Fainman; Yeshaiahu,9999,0,9999,0
1668290071000,ECE 200,008,103593,Ford; Joseph Earl,9999,0,9999,0
1668290071000,ECE 200,009,103594,Franceschetti; Massimo,9999,0,9999,0
1668290071000,ECE 200,010,103595,Fullerton; Eric E,9999,0,9999,0
1668290071000,ECE 200,011,103596,Galton; Ian A,9999,0,9999,0
1668290071000,ECE 200,012,103597,Gilja; Vikash,9999,0,9999,0
1668290071000,ECE 200,013,103598,Hall; Drew A.,9999,0,9999,0
1668290071000,ECE 200,014,103599,Hsueh; Tzu-Chien,9999,0,9999,0
1668290071000,ECE 200,015,103600,Javidi; Tara,9999,0,9999,0
1668290071000,ECE 200,016,103601,Kahng; Andrew Byun,9999,0,9999,0
1668290071000,ECE 200,017,103602,Kim; Young-Han,9999,0,9999,0
1668290071000,ECE 200,018,103603,Koushanfar; Farinaz,9999,0,9999,0
1668290071000,ECE 200,019,103604,Kuzum; Duygu,9999,0,9999,0
1668290071000,ECE 200,020,103605,Le; Hanh-Phuc,9999,0,9999,0
1668290071000,ECE 200,021,103606,Lin; Bill,9999,0,9999,0
1668290071000,ECE 200,022,103607,Liu; Zhaowei,9998,0,9999,1
1668290071000,ECE 200,023,103608,Lo; Yu-Hwa,9999,0,9999,0
1668290071000,ECE 200,024,103609,Lomakin; Vitaliy,9999,0,9999,0
1668290071000,ECE 200,025,103610,Mercier; Patrick Philip,9999,0,9999,0
1668290071000,ECE 200,026,103611,Meyer; Florian,9999,0,9999,0
1668290071000,ECE 200,027,103612,Milstein; Laurence B.,9999,0,9999,0
1668290071000,ECE 200,028,103613,Mir Arabbaygi; Siavash,9999,0,9999,0
1668290071000,ECE 200,029,103614,Mookherjea; Shayan,9999,0,9999,0
1668290071000,ECE 200,030,103615,Morris; Karcher William,9999,0,9999,0
1668290071000,ECE 200,031,103616,Ng; Tse Nga,9999,0,9999,0
1668290071000,ECE 200,032,103617,Nguyen; Truong Quang,9999,0,9999,0
1668290071000,ECE 200,033,103618,Nomura; Kenji,9999,0,9999,0
1668290071000,ECE 200,034,103619,Orlitsky; Alon,9999,0,9999,0
1668290071000,ECE 200,035,103620,Pal; Piya,9999,0,9999,0
1668290071000,ECE 200,036,103621,Papen; George C.,9999,0,9999,0
1668290071000,ECE 200,037,103622,Radic; Stojan,9999,0,9999,0
1668290071000,ECE 200,038,103623,Rao; Bhaskar D.,9999,0,9999,0
1668290071000,ECE 200,039,103624,Rao; Ramesh R,9999,0,9999,0
1668290071000,ECE 200,040,103625,Rebeiz; Gabriel,9999,0,9999,0
1668290071000,ECE 200,041,103626,Sanford; John R,9999,0,9999,0
1668290071000,ECE 200,042,103627,Siegel; Paul H.,9999,0,9999,0
1668290071000,ECE 200,043,103628,Sievenpiper; Daniel F.,9999,0,9999,0
1668290071000,ECE 200,044,103629,Sworder; David D.,9999,0,9999,0
1668290071000,ECE 200,045,103630,Taur; Yuan,9999,0,9999,0
1668290071000,ECE 200,046,103631,Touri; Behrouz,9999,0,9999,0
1668290071000,ECE 200,047,103632,Trivedi; Mohan M.,9999,0,9999,0
1668290071000,ECE 200,048,103633,Vasconcelos; Nuno,9999,0,9999,0
1668290071000,ECE 200,049,103634,Wang; Xiaolong,9999,0,9999,0
1668290071000,ECE 200,050,103635,Xie; Pengtao,9999,0,9999,0
1668290071000,ECE 200,051,103636,Yip; Michael,9999,0,9999,0
1668290071000,ECE 200,052,103637,Zeger; Kenneth A.,999,0,999,0
1668290071000,ECE 200,053,103638,Zhang; Xinyu,9999,0,9999,0
1668290071000,ECE 200,054,103639,Turakhia; Yatish Girish,9999,0,9999,0
1668290071000,ECE 200,055,103640,Kang; Mingu,9999,0,9999,0
1668290071000,ECE 200,056,103641,Shi; Yuanyuan,9999,0,9999,0
1668290071000,ECE 200,057,103642,Wang; Edward Jay,9999,0,9999,0
1668290071000,ECE 200,058,103643,Zheng; Yang,9999,0,9999,0
1668290071424,ECE 202,A00,103644,Kuzum; Duygu,0,0,0,0
1668290071846,ECE 212BN,A00,103646,Ng; Tse Nga,0,0,0,0
1668290072275,ECE 221,A00,111493,Staff,0,0,0,0
1668290072698,ECE 222B,A00,103647,Lomakin; Vitaliy,0,0,0,0
1668290073121,ECE 230B,A00,103648,Taur; Yuan,0,0,0,0
1668290073545,ECE 238B,A00,103649,Garay; Javier,0,0,0,0
1668290073970,ECE 240B,A00,112900,Fainman; Yeshaiahu,0,0,0,0
1668290074398,ECE 247A,A00,103650,Jokerst; Jesse Vincent,0,0,0,0
1668290074825,ECE 247B,A00,103651,Wang; Joseph,0,0,0,0
1668290075250,ECE 250,A00,103652,Siegel; Paul H.,0,0,0,0
1668290075675,ECE 251A,A00,103654,Rao; Bhaskar D.,0,0,0,0
1668290076098,ECE 257B,A00,103655,Bharadia; Dinesh,0,0,0,0
1668290076520,ECE 258A,A00,103656,Milstein; Laurence B.,0,0,0,0
1668290076944,ECE 260B,A00,103658,Kang; Mingu,0,0,0,0
1668290077370,ECE 264A,A00,103659,Galton; Ian A,0,0,0,0
1668290077799,ECE 265A,A00,103661,Gudem; Prasad S.S.,0,0,0,0
1668290078223,ECE 265D,A00,103662,Gudem; Prasad S.S.,0,0,0,0
1668290078646,ECE 268,A00,103663,Koushanfar; Farinaz,0,0,0,0
1668290079079,ECE 269,A01,103665,Pal; Piya,0,0,0,0
1668290079506,ECE 271B,A00,103666,Vasconcelos; Manuela,0,0,0,0
1668290079931,ECE 276A,A00,103667,Atanasov; Nikolay A.,0,0,0,0
1668290080355,ECE 277,A00,103668,An; Cheolhong,0,0,0,0
1668290080781,ECE 279,A00,117947,Hall; Drew A.,0,0,0,0
1668290081628,ECE 283,A00,103670,Hsueh; Tzu-Chien,0,0,0,0
1668290082054,ECE 284,A00,103671,Turakhia; Yatish Girish,0,0,0,0
1668290082482,ECE 285,A00,103672,Zheng; Yang,0,0,0,0
1668290082482,ECE 285,B00,103673,Sworder; David D.,0,0,0,0
1668290082907,ECE 287,A00,103676,Javidi; Tara,0,0,0,0
1668290083334,MATH 200B,A00,098023,Salehi Golsefidy; Alireza,12,0,15,3
1668290083761,MATH 202B,A00,098024,Rhoades; Brendon Patrick,9,0,15,6
1668290084185,MATH 203B,A00,098025,Oprea; Dragos N.,10,0,15,5
1668290084615,MATH 204B,A00,098026,Sorensen; Claus M,13,0,15,2
1668290085040,MATH 208,A00,098027,Izadi; Elham,7,0,10,3
1668290085476,MATH 209,A00,098028,Pollack; Aaron,10,0,10,0
1668290085902,MATH 211A,A00,112919,Rogalski; Daniel,9,0,10,1
1668290086325,MATH 211B,A00,112920,Seward; Brandon M.,9,0,10,1
1668290086751,MATH 218,A00,098029,Li; Bo,10,0,10,0
1668290087176,MATH 220B,A00,098030,Novak; Jonathan I,11,0,15,4
1668290087602,MATH 221A,A00,098031,Ebenfelt; Peter F,13,0,15,2
1668290088026,MATH 231B,A00,098032,Zlatos; Andrej,12,0,15,3
1668290088452,MATH 240B,A00,098033,Ni; Lei,9,0,15,6
1668290088874,MATH 243,A00,098034,Jekel; David Andrew,10,0,10,0
1668290089298,MATH 245A,A00,098035,Nie; Jiawang,0,0,15,16
1668290089723,MATH 248,A00,098036,Bejenaru; Ioan,10,0,10,0
1668290090152,MATH 250B,A00,098037,Spolaor; Luca,14,0,15,1
1668290090574,MATH 258,A00,098038,Ni; Lei,10,0,10,0
1668290090998,MATH 264B,A00,098041,Rhoades; Brendon Patrick,9,0,15,6
1668290091421,MATH 268,A00,098042,Buss; Samuel R,10,0,10,0
1668290091847,MATH 269,A00,098043,Rhoades; Brendon Patrick,10,0,10,0
1668290092270,MATH 270B,A00,098044,Li; Bo,10,0,15,5
1668290092695,MATH 272B,A00,098045,Holst; Michael J,13,0,15,2
1668290093122,MATH 273A,A00,098046,Tian; Xiaochuan,10,0,15,5
1668290093546,MATH 275,A01,098048,Tian; Xiaochuan,6,0,10,4
1668290093972,MATH 278A,A00,098049,Holst; Michael J,8,0,10,2
1668290094528,MATH 278B,A00,098050,Cloninger; Alexander,10,0,10,0
1668290094955,MATH 278C,A00,098051,Nie; Jiawang,7,0,10,3
1668290095379,MATH 280B,A00,098052,Zheng; Tianyi,8,0,15,7
1668290095810,MATH 281B,A00,098053,Bradic; Jelena,1,0,15,14
1668290096233,MATH 282B,A00,098054,Arias-Castro; Ery,0,0,15,15
1668290096657,MATH 285,A00,098055,Fitzsimmons; Patrick J,0,0,15,17
1668290097081,MATH 287B,A00,098056,Arias-Castro; Ery,2,0,15,13
1668290097507,MATH 288,A00,098057,Agarwal; Pooja,9,0,10,1
1668290097507,MATH 288,B00,098058,Zhang; Danna,8,0,10,2
1668290097507,MATH 288,C00,098059,Williams; Ruth J,9,0,10,1
1668290097930,MATH 290B,A00,098060,Roberts; Justin Deritter,13,0,15,2
1668290098353,MATH 292,A00,098061,Belmont; Eva Kinoshita,10,0,10,0
1668290098779,MATH 295,A00,098062,Suk; Andrew Hoon,48,0,50,2
1668290099204,MATH 296,A00,098063,Novak; Jonathan I,20,0,20,0
1668290099627,MATH 297,001,098064,Gamst; Anthony Collins,9997,0,9999,2
1668290598139,COGS 205,A00,101395,Chiba; Andrea,19,0,20,1
1668290598565,COGS 210B,001,101404,Greene; Deanna Jacquelyn,9998,0,9999,1
1668290598565,COGS 210B,002,101417,Xia; Haijun,9999,0,9999,0
1668290598565,COGS 210B,003,101422,Nitz; Douglas A.,9999,0,9999,0
1668290598565,COGS 210B,004,101423,Hollan; James D.,9998,0,9999,1
1668290598565,COGS 210B,005,101424,Deak; Gedeon O.,9998,0,9999,1
1668290598565,COGS 210B,006,101425,Rossano; Federico,9999,0,9999,0
1668290598987,COGS 211B,A00,101427,Coulson; Seana M,9996,0,9999,3
1668290599413,COGS 220,A00,101428,Hollan; James D.,0,0,25,25
1668290599838,COGS 229,A00,101429,Dow; Steven P,18,0,25,7
1668290600263,COGS 230,A00,101430,Klemmer; Scott R,12,0,17,5
1668290600686,COGS 234,A00,101431,Xia; Haijun,1,0,25,24
1668290601108,COGS 260,A00,101432,Kiyonaga; Anastasia,21,0,25,4
1668290601108,COGS 260,B00,101433,Kirsh; David Joel,15,0,25,10
1668290601531,CSE 202,A00,102371,Impagliazzo; Russell,0,0,0,0
1668290601955,CSE 203B,A01,102373,Cheng; Chung Kuan,0,0,0,0
1668290602382,CSE 208,A00,102374,Micciancio; Daniele,0,0,0,0
1668290602805,CSE 209A,A00,112895,Impagliazzo; Russell,0,0,15,15
1668290603235,CSE 209B,A00,108005,Bellare; Mihir,0,0,0,0
1668290603661,CSE 210,A00,113163,Coblenz; Michael J,0,0,0,0
1668290604089,CSE 219,A00,106111,Dow; Steven P,0,0,20,20
1668290604510,CSE 221,A00,102376,Voelker; Geoffrey M.,0,0,0,0
1668290604937,CSE 224,A01,102378,Porter; George M,0,0,0,0
1668290605360,CSE 229A,A00,102379,Savage; Stefan,0,0,0,0
1668290605785,CSE 229C,A00,102380,Munyaka; Imani N. S.,0,0,0,0
1668290606210,CSE 232B,A00,102382,Deutsch; Alin Bernard,0,0,0,0
1668290606633,CSE 234,A01,112904,Kumar; Arun Kumar,0,0,0,0
1668290607059,CSE 237A,A00,102383,Rosing; Tajana Simunic,0,0,0,0
1668290607480,CSE 239A,A00,102384,Deutsch; Alin Bernard,0,0,0,0
1668290607903,CSE 239B,A00,102385,Polikarpova; Nadezhda,0,0,0,0
1668290608325,CSE 240A,A00,102386,Pannuto; Patrick William,0,0,0,0
1668290608750,CSE 240B,A00,102387,Zhao; Jishen,0,0,0,0
1668290609182,CSE 241A,A00,106406,Kang; Mingu,0,0,0,0
1668290609608,CSE 249B,A00,102388,Kahng; Andrew Byun,0,0,8,8
1668290610031,CSE 251B,A01,102392,Cottrell; Garrison W,0,0,0,0
1668290610031,CSE 251B,A02,102393,Cottrell; Garrison W,0,0,0,0
1668290610456,CSE 252B,A00,102394,Ochoa; Benjamin Lawrence,0,0,0,0
1668290610878,CSE 257,A01,102396,Gao; Sicun,0,0,0,0
1668290611305,CSE 272,A00,102397,Li; Tzumao,0,0,0,0
1668290611728,CSE 274,A00,111323,Chern; Albert Ren-Haur,0,0,0,0
1668290612166,CSE 282,A00,102398,Pevzner; Pavel Arkadjevich,0,0,0,0
1668290612590,CSE 284,A00,114175,Gymrek; Melissa Ann,0,0,0,0
1668290613013,CSE 290,A00,102399,Chandraker; Manmohan Krishna,0,0,0,0
1668290613013,CSE 290,B00,102400,Vaccaro; Kristen Marie,0,0,25,25
1668290613013,CSE 290,C00,102414,Pannuto; Patrick William,0,0,25,25
1668290613013,CSE 290,D00,102427,Pevzner; Pavel Arkadjevich,0,0,0,0
1668290613013,CSE 290,E00,102429,Zhao; Jishen,0,0,0,0
1668290613013,CSE 290,F00,102436,Tullsen; Dean Michael,0,0,0,0
1668290613013,CSE 290,G00,102440,Christensen; Henrik I,0,0,20,20
1668290613439,CSE 291,A00,102443,Su; Hao,0,0,0,0
1668290613439,CSE 291,B00,102448,Polikarpova; Nadezhda,0,0,0,0
1668290613439,CSE 291,C00,102453,Vaccaro; Kristen Marie,0,0,0,0
1668290613439,CSE 291,D00,111343,Savage; Stefan,0,0,0,0
1668290613439,CSE 291,E00,116474,Claffy; Kimberly Claire,0,0,0,0
1668290613439,CSE 291,F00,116479,Pasquale; Joseph,0,0,0,0
1668290613865,CSE 293,001,119111,Bafna; Vineet,9999,0,9999,0
1668290613865,CSE 293,002,119118,Bellare; Mihir,9999,0,9999,0
1668290613865,CSE 293,003,119122,Berg-Kirkpatrick; Taylor D,9999,0,9999,0
1668290613865,CSE 293,004,119135,Christensen; Henrik I,9999,0,9999,0
1668290613865,CSE 293,005,119142,Cottrell; Garrison W,9999,0,9999,0
1668290613865,CSE 293,006,119146,Deutsch; Alin Bernard,9999,0,9999,0
1668290613865,CSE 293,007,119159,Esmaeilzadeh; Hadi,9999,0,9999,0
1668290613865,CSE 293,008,119166,Freund; Yoav,9999,0,9999,0
1668290613865,CSE 293,009,119170,Griswold; William G.,9999,0,9999,0
1668290613865,CSE 293,010,119183,Gymrek; Melissa Ann,9999,0,9999,0
1668290613865,CSE 293,011,119190,Heninger; Nadia A,9999,0,9999,0
1668290613865,CSE 293,012,119230,Impagliazzo; Russell,9999,0,9999,0
1668290613865,CSE 293,013,119232,Jhala; Ranjit,9999,0,9999,0
1668290613865,CSE 293,014,119233,Kahng; Andrew Byun,9999,0,9999,0
1668290613865,CSE 293,015,119298,Kane; Daniel Mertz,9999,0,9999,0
1668290613865,CSE 293,016,119299,Kriegman; David J,9999,0,9999,0
1668290613865,CSE 293,017,119300,Kumar; Arun Kumar,9999,0,9999,0
1668290613865,CSE 293,018,119301,Lerner; Sorin,9999,0,9999,0
1668290613865,CSE 293,019,119302,Lovett; Shachar,9999,0,9999,0
1668290613865,CSE 293,020,119303,McAuley; Julian John,9999,0,9999,0
1668290613865,CSE 293,021,119304,Micciancio; Daniele,9999,0,9999,0
1668290613865,CSE 293,022,119367,Orailoglu; Alex,9999,0,9999,0
1668290613865,CSE 293,023,119382,Paturi; Ramamohan,9999,0,9999,0
1668290613865,CSE 293,024,119404,Polikarpova; Nadezhda,9999,0,9999,0
1668290613865,CSE 293,025,119406,Politz; Joseph Gibbs,9999,0,9999,0
1668290613865,CSE 293,026,119411,Porter; George M,9999,0,9999,0
1668290613865,CSE 293,027,119414,Porter; Leonard Emerson,9999,0,9999,0
1668290613865,CSE 293,028,119416,Ramamoorthi; Ravi,9999,0,9999,0
1668290613865,CSE 293,029,119417,Sahoo; Debashis,9999,0,9999,0
1668290613865,CSE 293,030,119420,Saul; Lawrence,9999,0,9999,0
1668290613865,CSE 293,031,119421,Savage; Stefan,9999,0,9999,0
1668290613865,CSE 293,032,119425,Schulze; Jurgen P.,9999,0,9999,0
1668290613865,CSE 293,033,119426,Snoeren; Alex C.,9999,0,9999,0
1668290613865,CSE 293,034,119428,Shang; Jingbo,9999,0,9999,0
1668290613865,CSE 293,035,119430,Stefan; Deian,9999,0,9999,0
1668290613865,CSE 293,036,119431,Su; Hao,9999,0,9999,0
1668290613865,CSE 293,037,119433,Swanson; Steven James,9999,0,9999,0
1668290613865,CSE 293,038,119435,Tullsen; Dean Michael,9999,0,9999,0
1668290613865,CSE 293,039,119483,Voelker; Geoffrey M.,9999,0,9999,0
1668290613865,CSE 293,040,119537,Zhao; Jishen,9999,0,9999,0
1668290613865,CSE 293,041,119538,Zhou; Yuan-Yuan,9999,0,9999,0
1668290613865,CSE 293,042,119539,Gao; Sicun,9999,0,9999,0
1668290613865,CSE 293,043,119540,Weibel; Nadir,9999,0,9999,0
1668290613865,CSE 293,044,119541,Gupta; Rajesh K.,9999,0,9999,0
1668290613865,CSE 293,045,126410,Vaccaro; Kristen Marie,9999,0,9999,0
1668290613865,CSE 293,046,126411,Klemke; Richard,9999,0,9999,0
1668290614292,CSE 294,A00,102459,Voelker; Geoffrey M.,0,0,0,0
1668290614292,CSE 294,B00,111322,Orailoglu; Alex,0,0,0,0
1668290614727,DSE 201,A00,096914,Deutsch; Alin Bernard,30,0,30,0
1668290615156,DSE 210,A00,096915,Dasgupta; Sanjoy,30,0,30,0
1668290615582,DSE 260A,A00,096916,Altintas De Callaf; Ilkay,30,0,30,0
1668290616019,ECE 200,001,103586,Antipa; Nicholas A,9999,0,9999,0
1668290616019,ECE 200,002,103587,Atanasov; Nikolay A.,9999,0,9999,0
1668290616019,ECE 200,003,103588,Bharadia; Dinesh,9999,0,9999,0
1668290616019,ECE 200,004,103589,Cheng; Chung Kuan,9999,0,9999,0
1668290616019,ECE 200,005,103590,Cosman; Pamela C.,9999,0,9999,0
1668290616019,ECE 200,006,103591,Dayeh; Shadi Ahmad,9999,0,9999,0
1668290616019,ECE 200,007,103592,Fainman; Yeshaiahu,9999,0,9999,0
1668290616019,ECE 200,008,103593,Ford; Joseph Earl,9999,0,9999,0
1668290616019,ECE 200,009,103594,Franceschetti; Massimo,9999,0,9999,0
1668290616019,ECE 200,010,103595,Fullerton; Eric E,9999,0,9999,0
1668290616019,ECE 200,011,103596,Galton; Ian A,9999,0,9999,0
1668290616019,ECE 200,012,103597,Gilja; Vikash,9999,0,9999,0
1668290616019,ECE 200,013,103598,Hall; Drew A.,9999,0,9999,0
1668290616019,ECE 200,014,103599,Hsueh; Tzu-Chien,9999,0,9999,0
1668290616019,ECE 200,015,103600,Javidi; Tara,9999,0,9999,0
1668290616019,ECE 200,016,103601,Kahng; Andrew Byun,9999,0,9999,0
1668290616019,ECE 200,017,103602,Kim; Young-Han,9999,0,9999,0
1668290616019,ECE 200,018,103603,Koushanfar; Farinaz,9999,0,9999,0
1668290616019,ECE 200,019,103604,Kuzum; Duygu,9999,0,9999,0
1668290616019,ECE 200,020,103605,Le; Hanh-Phuc,9999,0,9999,0
1668290616019,ECE 200,021,103606,Lin; Bill,9999,0,9999,0
1668290616019,ECE 200,022,103607,Liu; Zhaowei,9998,0,9999,1
1668290616019,ECE 200,023,103608,Lo; Yu-Hwa,9999,0,9999,0
1668290616019,ECE 200,024,103609,Lomakin; Vitaliy,9999,0,9999,0
1668290616019,ECE 200,025,103610,Mercier; Patrick Philip,9999,0,9999,0
1668290616019,ECE 200,026,103611,Meyer; Florian,9999,0,9999,0
1668290616019,ECE 200,027,103612,Milstein; Laurence B.,9999,0,9999,0
1668290616019,ECE 200,028,103613,Mir Arabbaygi; Siavash,9999,0,9999,0
1668290616019,ECE 200,029,103614,Mookherjea; Shayan,9999,0,9999,0
1668290616019,ECE 200,030,103615,Morris; Karcher William,9999,0,9999,0
1668290616019,ECE 200,031,103616,Ng; Tse Nga,9999,0,9999,0
1668290616019,ECE 200,032,103617,Nguyen; Truong Quang,9999,0,9999,0
1668290616019,ECE 200,033,103618,Nomura; Kenji,9999,0,9999,0
1668290616019,ECE 200,034,103619,Orlitsky; Alon,9999,0,9999,0
1668290616019,ECE 200,035,103620,Pal; Piya,9999,0,9999,0
1668290616019,ECE 200,036,103621,Papen; George C.,9999,0,9999,0
1668290616019,ECE 200,037,103622,Radic; Stojan,9999,0,9999,0
1668290616019,ECE 200,038,103623,Rao; Bhaskar D.,9999,0,9999,0
1668290616019,ECE 200,039,103624,Rao; Ramesh R,9999,0,9999,0
1668290616019,ECE 200,040,103625,Rebeiz; Gabriel,9999,0,9999,0
1668290616019,ECE 200,041,103626,Sanford; John R,9999,0,9999,0
1668290616019,ECE 200,042,103627,Siegel; Paul H.,9999,0,9999,0
1668290616019,ECE 200,043,103628,Sievenpiper; Daniel F.,9999,0,9999,0
1668290616019,ECE 200,044,103629,Sworder; David D.,9999,0,9999,0
1668290616019,ECE 200,045,103630,Taur; Yuan,9999,0,9999,0
1668290616019,ECE 200,046,103631,Touri; Behrouz,9999,0,9999,0
1668290616019,ECE 200,047,103632,Trivedi; Mohan M.,9999,0,9999,0
1668290616019,ECE 200,048,103633,Vasconcelos; Nuno,9999,0,9999,0
1668290616019,ECE 200,049,103634,Wang; Xiaolong,9999,0,9999,0
1668290616019,ECE 200,050,103635,Xie; Pengtao,9999,0,9999,0
1668290616019,ECE 200,051,103636,Yip; Michael,9999,0,9999,0
1668290616019,ECE 200,052,103637,Zeger; Kenneth A.,999,0,999,0
1668290616019,ECE 200,053,103638,Zhang; Xinyu,9999,0,9999,0
1668290616019,ECE 200,054,103639,Turakhia; Yatish Girish,9999,0,9999,0
1668290616019,ECE 200,055,103640,Kang; Mingu,9999,0,9999,0
1668290616019,ECE 200,056,103641,Shi; Yuanyuan,9999,0,9999,0
1668290616019,ECE 200,057,103642,Wang; Edward Jay,9999,0,9999,0
1668290616019,ECE 200,058,103643,Zheng; Yang,9999,0,9999,0
1668290616442,ECE 202,A00,103644,Kuzum; Duygu,0,0,0,0
1668290616867,ECE 212BN,A00,103646,Ng; Tse Nga,0,0,0,0
1668290617291,ECE 221,A00,111493,Staff,0,0,0,0
1668290617716,ECE 222B,A00,103647,Lomakin; Vitaliy,0,0,0,0
1668290618140,ECE 230B,A00,103648,Taur; Yuan,0,0,0,0
1668290618571,ECE 238B,A00,103649,Garay; Javier,0,0,0,0
1668290618994,ECE 240B,A00,112900,Fainman; Yeshaiahu,0,0,0,0
1668290619422,ECE 247A,A00,103650,Jokerst; Jesse Vincent,0,0,0,0
1668290619848,ECE 247B,A00,103651,Wang; Joseph,0,0,0,0
1668290620273,ECE 250,A00,103652,Siegel; Paul H.,0,0,0,0
1668290620702,ECE 251A,A00,103654,Rao; Bhaskar D.,0,0,0,0
1668290621129,ECE 257B,A00,103655,Bharadia; Dinesh,0,0,0,0
1668290621554,ECE 258A,A00,103656,Milstein; Laurence B.,0,0,0,0
1668290621980,ECE 260B,A00,103658,Kang; Mingu,0,0,0,0
1668290622411,ECE 264A,A00,103659,Galton; Ian A,0,0,0,0
1668290622836,ECE 265A,A00,103661,Gudem; Prasad S.S.,0,0,0,0
1668290623262,ECE 265D,A00,103662,Gudem; Prasad S.S.,0,0,0,0
1668290623685,ECE 268,A00,103663,Koushanfar; Farinaz,0,0,0,0
1668290624109,ECE 269,A01,103665,Pal; Piya,0,0,0,0
1668290624533,ECE 271B,A00,103666,Vasconcelos; Manuela,0,0,0,0
1668290624959,ECE 276A,A00,103667,Atanasov; Nikolay A.,0,0,0,0
1668290625386,ECE 277,A00,103668,An; Cheolhong,0,0,0,0
1668290625815,ECE 279,A00,117947,Hall; Drew A.,0,0,0,0
1668290626662,ECE 283,A00,103670,Hsueh; Tzu-Chien,0,0,0,0
1668290627087,ECE 284,A00,103671,Turakhia; Yatish Girish,0,0,0,0
1668290627510,ECE 285,A00,103672,Zheng; Yang,0,0,0,0
1668290627510,ECE 285,B00,103673,Sworder; David D.,0,0,0,0
1668290627934,ECE 287,A00,103676,Javidi; Tara,0,0,0,0
1668290628360,MATH 200B,A00,098023,Salehi Golsefidy; Alireza,12,0,15,3
1668290628782,MATH 202B,A00,098024,Rhoades; Brendon Patrick,9,0,15,6
1668290629206,MATH 203B,A00,098025,Oprea; Dragos N.,10,0,15,5
1668290629630,MATH 204B,A00,098026,Sorensen; Claus M,13,0,15,2
1668290630056,MATH 208,A00,098027,Izadi; Elham,7,0,10,3
1668290630487,MATH 209,A00,098028,Pollack; Aaron,10,0,10,0
1668290630910,MATH 211A,A00,112919,Rogalski; Daniel,9,0,10,1
1668290631427,MATH 211B,A00,112920,Seward; Brandon M.,9,0,10,1
1668290631856,MATH 218,A00,098029,Li; Bo,10,0,10,0
1668290632286,MATH 220B,A00,098030,Novak; Jonathan I,11,0,15,4
1668290632712,MATH 221A,A00,098031,Ebenfelt; Peter F,13,0,15,2
1668290633134,MATH 231B,A00,098032,Zlatos; Andrej,12,0,15,3
1668290633562,MATH 240B,A00,098033,Ni; Lei,9,0,15,6
1668290633992,MATH 243,A00,098034,Jekel; David Andrew,10,0,10,0
1668290634420,MATH 245A,A00,098035,Nie; Jiawang,0,0,15,16
1668290634847,MATH 248,A00,098036,Bejenaru; Ioan,10,0,10,0
1668290635270,MATH 250B,A00,098037,Spolaor; Luca,14,0,15,1
1668290635696,MATH 258,A00,098038,Ni; Lei,10,0,10,0
1668290636120,MATH 264B,A00,098041,Rhoades; Brendon Patrick,9,0,15,6
1668290636543,MATH 268,A00,098042,Buss; Samuel R,10,0,10,0
1668290636969,MATH 269,A00,098043,Rhoades; Brendon Patrick,10,0,10,0
1668290637392,MATH 270B,A00,098044,Li; Bo,10,0,15,5
1668290637814,MATH 272B,A00,098045,Holst; Michael J,13,0,15,2
1668290638238,MATH 273A,A00,098046,Tian; Xiaochuan,10,0,15,5
1668290638662,MATH 275,A01,098048,Tian; Xiaochuan,6,0,10,4
1668290639086,MATH 278A,A00,098049,Holst; Michael J,8,0,10,2
1668290639511,MATH 278B,A00,098050,Cloninger; Alexander,10,0,10,0
1668290639936,MATH 278C,A00,098051,Nie; Jiawang,7,0,10,3
1668290640364,MATH 280B,A00,098052,Zheng; Tianyi,8,0,15,7
1668290640791,MATH 281B,A00,098053,Bradic; Jelena,1,0,15,14
1668290641217,MATH 282B,A00,098054,Arias-Castro; Ery,0,0,15,15
1668290641650,MATH 285,A00,098055,Fitzsimmons; Patrick J,0,0,15,17
1668290642073,MATH 287B,A00,098056,Arias-Castro; Ery,2,0,15,13
1668290642497,MATH 288,A00,098057,Agarwal; Pooja,9,0,10,1
1668290642497,MATH 288,B00,098058,Zhang; Danna,8,0,10,2
1668290642497,MATH 288,C00,098059,Williams; Ruth J,9,0,10,1
1668290642920,MATH 290B,A00,098060,Roberts; Justin Deritter,13,0,15,2
1668290643345,MATH 292,A00,098061,Belmont; Eva Kinoshita,10,0,10,0
1668290643767,MATH 295,A00,098062,Suk; Andrew Hoon,48,0,50,2
1668290644189,MATH 296,A00,098063,Novak; Jonathan I,20,0,20,0
1668290644613,MATH 297,001,098064,Gamst; Anthony Collins,9997,0,9999,2
1668291142910,COGS 205,A00,101395,Chiba; Andrea,19,0,20,1
1668291143337,COGS 210B,001,101404,Greene; Deanna Jacquelyn,9998,0,9999,1
1668291143337,COGS 210B,002,101417,Xia; Haijun,9999,0,9999,0
1668291143337,COGS 210B,003,101422,Nitz; Douglas A.,9999,0,9999,0
1668291143337,COGS 210B,004,101423,Hollan; James D.,9998,0,9999,1
1668291143337,COGS 210B,005,101424,Deak; Gedeon O.,9998,0,9999,1
1668291143337,COGS 210B,006,101425,Rossano; Federico,9999,0,9999,0
1668291143763,COGS 211B,A00,101427,Coulson; Seana M,9996,0,9999,3
1668291144185,COGS 220,A00,101428,Hollan; James D.,0,0,25,25
1668291144608,COGS 229,A00,101429,Dow; Steven P,18,0,25,7
1668291145036,COGS 230,A00,101430,Klemmer; Scott R,12,0,17,5
1668291145459,COGS 234,A00,101431,Xia; Haijun,1,0,25,24
1668291145884,COGS 260,A00,101432,Kiyonaga; Anastasia,21,0,25,4
1668291145884,COGS 260,B00,101433,Kirsh; David Joel,15,0,25,10
1668291146306,CSE 202,A00,102371,Impagliazzo; Russell,0,0,0,0
1668291146731,CSE 203B,A01,102373,Cheng; Chung Kuan,0,0,0,0
1668291147156,CSE 208,A00,102374,Micciancio; Daniele,0,0,0,0
1668291147582,CSE 209A,A00,112895,Impagliazzo; Russell,0,0,15,15
1668291148005,CSE 209B,A00,108005,Bellare; Mihir,0,0,0,0
1668291148432,CSE 210,A00,113163,Coblenz; Michael J,0,0,0,0
1668291148857,CSE 219,A00,106111,Dow; Steven P,0,0,20,20
1668291149281,CSE 221,A00,102376,Voelker; Geoffrey M.,0,0,0,0
1668291149801,CSE 224,A01,102378,Porter; George M,0,0,0,0
1668291150227,CSE 229A,A00,102379,Savage; Stefan,0,0,0,0
1668291150649,CSE 229C,A00,102380,Munyaka; Imani N. S.,0,0,0,0
1668291151074,CSE 232B,A00,102382,Deutsch; Alin Bernard,0,0,0,0
1668291151496,CSE 234,A01,112904,Kumar; Arun Kumar,0,0,0,0
1668291151922,CSE 237A,A00,102383,Rosing; Tajana Simunic,0,0,0,0
1668291152346,CSE 239A,A00,102384,Deutsch; Alin Bernard,0,0,0,0
1668291152770,CSE 239B,A00,102385,Polikarpova; Nadezhda,0,0,0,0
1668291153193,CSE 240A,A00,102386,Pannuto; Patrick William,0,0,0,0
1668291153627,CSE 240B,A00,102387,Zhao; Jishen,0,0,0,0
1668291154053,CSE 241A,A00,106406,Kang; Mingu,0,0,0,0
1668291154475,CSE 249B,A00,102388,Kahng; Andrew Byun,0,0,8,8
1668291154902,CSE 251B,A01,102392,Cottrell; Garrison W,0,0,0,0
1668291154902,CSE 251B,A02,102393,Cottrell; Garrison W,0,0,0,0
1668291155325,CSE 252B,A00,102394,Ochoa; Benjamin Lawrence,0,0,0,0
1668291155748,CSE 257,A01,102396,Gao; Sicun,0,0,0,0
1668291156175,CSE 272,A00,102397,Li; Tzumao,0,0,0,0
1668291156602,CSE 274,A00,111323,Chern; Albert Ren-Haur,0,0,0,0
1668291157026,CSE 282,A00,102398,Pevzner; Pavel Arkadjevich,0,0,0,0
1668291157452,CSE 284,A00,114175,Gymrek; Melissa Ann,0,0,0,0
1668291157875,CSE 290,A00,102399,Chandraker; Manmohan Krishna,0,0,0,0
1668291157875,CSE 290,B00,102400,Vaccaro; Kristen Marie,0,0,25,25
1668291157875,CSE 290,C00,102414,Pannuto; Patrick William,0,0,25,25
1668291157875,CSE 290,D00,102427,Pevzner; Pavel Arkadjevich,0,0,0,0
1668291157875,CSE 290,E00,102429,Zhao; Jishen,0,0,0,0
1668291157875,CSE 290,F00,102436,Tullsen; Dean Michael,0,0,0,0
1668291157875,CSE 290,G00,102440,Christensen; Henrik I,0,0,20,20
1668291158302,CSE 291,A00,102443,Su; Hao,0,0,0,0
1668291158302,CSE 291,B00,102448,Polikarpova; Nadezhda,0,0,0,0
1668291158302,CSE 291,C00,102453,Vaccaro; Kristen Marie,0,0,0,0
1668291158302,CSE 291,D00,111343,Savage; Stefan,0,0,0,0
1668291158302,CSE 291,E00,116474,Claffy; Kimberly Claire,0,0,0,0
1668291158302,CSE 291,F00,116479,Pasquale; Joseph,0,0,0,0
1668291158759,CSE 293,001,119111,Bafna; Vineet,9999,0,9999,0
1668291158759,CSE 293,002,119118,Bellare; Mihir,9999,0,9999,0
1668291158759,CSE 293,003,119122,Berg-Kirkpatrick; Taylor D,9999,0,9999,0
1668291158759,CSE 293,004,119135,Christensen; Henrik I,9999,0,9999,0
1668291158759,CSE 293,005,119142,Cottrell; Garrison W,9999,0,9999,0
1668291158759,CSE 293,006,119146,Deutsch; Alin Bernard,9999,0,9999,0
1668291158759,CSE 293,007,119159,Esmaeilzadeh; Hadi,9999,0,9999,0
1668291158759,CSE 293,008,119166,Freund; Yoav,9999,0,9999,0
1668291158759,CSE 293,009,119170,Griswold; William G.,9999,0,9999,0
1668291158759,CSE 293,010,119183,Gymrek; Melissa Ann,9999,0,9999,0
1668291158759,CSE 293,011,119190,Heninger; Nadia A,9999,0,9999,0
1668291158759,CSE 293,012,119230,Impagliazzo; Russell,9999,0,9999,0
1668291158759,CSE 293,013,119232,Jhala; Ranjit,9999,0,9999,0
1668291158759,CSE 293,014,119233,Kahng; Andrew Byun,9999,0,9999,0
1668291158759,CSE 293,015,119298,Kane; Daniel Mertz,9999,0,9999,0
1668291158759,CSE 293,016,119299,Kriegman; David J,9999,0,9999,0
1668291158759,CSE 293,017,119300,Kumar; Arun Kumar,9999,0,9999,0
1668291158759,CSE 293,018,119301,Lerner; Sorin,9999,0,9999,0
1668291158759,CSE 293,019,119302,Lovett; Shachar,9999,0,9999,0
1668291158759,CSE 293,020,119303,McAuley; Julian John,9999,0,9999,0
1668291158759,CSE 293,021,119304,Micciancio; Daniele,9999,0,9999,0
1668291158759,CSE 293,022,119367,Orailoglu; Alex,9999,0,9999,0
1668291158759,CSE 293,023,119382,Paturi; Ramamohan,9999,0,9999,0
1668291158759,CSE 293,024,119404,Polikarpova; Nadezhda,9999,0,9999,0
1668291158759,CSE 293,025,119406,Politz; Joseph Gibbs,9999,0,9999,0
1668291158759,CSE 293,026,119411,Porter; George M,9999,0,9999,0
1668291158759,CSE 293,027,119414,Porter; Leonard Emerson,9999,0,9999,0
1668291158759,CSE 293,028,119416,Ramamoorthi; Ravi,9999,0,9999,0
1668291158759,CSE 293,029,119417,Sahoo; Debashis,9999,0,9999,0
1668291158759,CSE 293,030,119420,Saul; Lawrence,9999,0,9999,0
1668291158759,CSE 293,031,119421,Savage; Stefan,9999,0,9999,0
1668291158759,CSE 293,032,119425,Schulze; Jurgen P.,9999,0,9999,0
1668291158759,CSE 293,033,119426,Snoeren; Alex C.,9999,0,9999,0
1668291158759,CSE 293,034,119428,Shang; Jingbo,9999,0,9999,0
1668291158759,CSE 293,035,119430,Stefan; Deian,9999,0,9999,0
1668291158759,CSE 293,036,119431,Su; Hao,9999,0,9999,0
1668291158759,CSE 293,037,119433,Swanson; Steven James,9999,0,9999,0
1668291158759,CSE 293,038,119435,Tullsen; Dean Michael,9999,0,9999,0
1668291158759,CSE 293,039,119483,Voelker; Geoffrey M.,9999,0,9999,0
1668291158759,CSE 293,040,119537,Zhao; Jishen,9999,0,9999,0
1668291158759,CSE 293,041,119538,Zhou; Yuan-Yuan,9999,0,9999,0
1668291158759,CSE 293,042,119539,Gao; Sicun,9999,0,9999,0
1668291158759,CSE 293,043,119540,Weibel; Nadir,9999,0,9999,0
1668291158759,CSE 293,044,119541,Gupta; Rajesh K.,9999,0,9999,0
1668291158759,CSE 293,045,126410,Vaccaro; Kristen Marie,9999,0,9999,0
1668291158759,CSE 293,046,126411,Klemke; Richard,9999,0,9999,0
1668291159183,CSE 294,A00,102459,Voelker; Geoffrey M.,0,0,0,0
1668291159183,CSE 294,B00,111322,Orailoglu; Alex,0,0,0,0
1668291159607,DSE 201,A00,096914,Deutsch; Alin Bernard,30,0,30,0
1668291160033,DSE 210,A00,096915,Dasgupta; Sanjoy,30,0,30,0
1668291160454,DSE 260A,A00,096916,Altintas De Callaf; Ilkay,30,0,30,0
1668291160887,ECE 200,001,103586,Antipa; Nicholas A,9999,0,9999,0
1668291160887,ECE 200,002,103587,Atanasov; Nikolay A.,9999,0,9999,0
1668291160887,ECE 200,003,103588,Bharadia; Dinesh,9999,0,9999,0
1668291160887,ECE 200,004,103589,Cheng; Chung Kuan,9999,0,9999,0
1668291160887,ECE 200,005,103590,Cosman; Pamela C.,9999,0,9999,0
1668291160887,ECE 200,006,103591,Dayeh; Shadi Ahmad,9999,0,9999,0
1668291160887,ECE 200,007,103592,Fainman; Yeshaiahu,9999,0,9999,0
1668291160887,ECE 200,008,103593,Ford; Joseph Earl,9999,0,9999,0
1668291160887,ECE 200,009,103594,Franceschetti; Massimo,9999,0,9999,0
1668291160887,ECE 200,010,103595,Fullerton; Eric E,9999,0,9999,0
1668291160887,ECE 200,011,103596,Galton; Ian A,9999,0,9999,0
1668291160887,ECE 200,012,103597,Gilja; Vikash,9999,0,9999,0
1668291160887,ECE 200,013,103598,Hall; Drew A.,9999,0,9999,0
1668291160887,ECE 200,014,103599,Hsueh; Tzu-Chien,9999,0,9999,0
1668291160887,ECE 200,015,103600,Javidi; Tara,9999,0,9999,0
1668291160887,ECE 200,016,103601,Kahng; Andrew Byun,9999,0,9999,0
1668291160887,ECE 200,017,103602,Kim; Young-Han,9999,0,9999,0
1668291160887,ECE 200,018,103603,Koushanfar; Farinaz,9999,0,9999,0
1668291160887,ECE 200,019,103604,Kuzum; Duygu,9999,0,9999,0
1668291160887,ECE 200,020,103605,Le; Hanh-Phuc,9999,0,9999,0
1668291160887,ECE 200,021,103606,Lin; Bill,9999,0,9999,0
1668291160887,ECE 200,022,103607,Liu; Zhaowei,9998,0,9999,1
1668291160887,ECE 200,023,103608,Lo; Yu-Hwa,9999,0,9999,0
1668291160887,ECE 200,024,103609,Lomakin; Vitaliy,9999,0,9999,0
1668291160887,ECE 200,025,103610,Mercier; Patrick Philip,9999,0,9999,0
1668291160887,ECE 200,026,103611,Meyer; Florian,9999,0,9999,0
1668291160887,ECE 200,027,103612,Milstein; Laurence B.,9999,0,9999,0
1668291160887,ECE 200,028,103613,Mir Arabbaygi; Siavash,9999,0,9999,0
1668291160887,ECE 200,029,103614,Mookherjea; Shayan,9999,0,9999,0
1668291160887,ECE 200,030,103615,Morris; Karcher William,9999,0,9999,0
1668291160887,ECE 200,031,103616,Ng; Tse Nga,9999,0,9999,0
1668291160887,ECE 200,032,103617,Nguyen; Truong Quang,9999,0,9999,0
1668291160887,ECE 200,033,103618,Nomura; Kenji,9999,0,9999,0
1668291160887,ECE 200,034,103619,Orlitsky; Alon,9999,0,9999,0
1668291160887,ECE 200,035,103620,Pal; Piya,9999,0,9999,0
1668291160887,ECE 200,036,103621,Papen; George C.,9999,0,9999,0
1668291160887,ECE 200,037,103622,Radic; Stojan,9999,0,9999,0
1668291160887,ECE 200,038,103623,Rao; Bhaskar D.,9999,0,9999,0
1668291160887,ECE 200,039,103624,Rao; Ramesh R,9999,0,9999,0
1668291160887,ECE 200,040,103625,Rebeiz; Gabriel,9999,0,9999,0
1668291160887,ECE 200,041,103626,Sanford; John R,9999,0,9999,0
1668291160887,ECE 200,042,103627,Siegel; Paul H.,9999,0,9999,0
1668291160887,ECE 200,043,103628,Sievenpiper; Daniel F.,9999,0,9999,0
1668291160887,ECE 200,044,103629,Sworder; David D.,9999,0,9999,0
1668291160887,ECE 200,045,103630,Taur; Yuan,9999,0,9999,0
1668291160887,ECE 200,046,103631,Touri; Behrouz,9999,0,9999,0
1668291160887,ECE 200,047,103632,Trivedi; Mohan M.,9999,0,9999,0
1668291160887,ECE 200,048,103633,Vasconcelos; Nuno,9999,0,9999,0
1668291160887,ECE 200,049,103634,Wang; Xiaolong,9999,0,9999,0
1668291160887,ECE 200,050,103635,Xie; Pengtao,9999,0,9999,0
1668291160887,ECE 200,051,103636,Yip; Michael,9999,0,9999,0
1668291160887,ECE 200,052,103637,Zeger; Kenneth A.,999,0,999,0
1668291160887,ECE 200,053,103638,Zhang; Xinyu,9999,0,9999,0
1668291160887,ECE 200,054,103639,Turakhia; Yatish Girish,9999,0,9999,0
1668291160887,ECE 200,055,103640,Kang; Mingu,9999,0,9999,0
1668291160887,ECE 200,056,103641,Shi; Yuanyuan,9999,0,9999,0
1668291160887,ECE 200,057,103642,Wang; Edward Jay,9999,0,9999,0
1668291160887,ECE 200,058,103643,Zheng; Yang,9999,0,9999,0
1668291161313,ECE 202,A00,103644,Kuzum; Duygu,0,0,0,0
1668291161739,ECE 212BN,A00,103646,Ng; Tse Nga,0,0,0,0
1668291162169,ECE 221,A00,111493,Staff,0,0,0,0
1668291162591,ECE 222B,A00,103647,Lomakin; Vitaliy,0,0,0,0
1668291163016,ECE 230B,A00,103648,Taur; Yuan,0,0,0,0
1668291163442,ECE 238B,A00,103649,Garay; Javier,0,0,0,0
1668291163882,ECE 240B,A00,112900,Fainman; Yeshaiahu,0,0,0,0
1668291164307,ECE 247A,A00,103650,Jokerst; Jesse Vincent,0,0,0,0
1668291164730,ECE 247B,A00,103651,Wang; Joseph,0,0,0,0
1668291165156,ECE 250,A00,103652,Siegel; Paul H.,0,0,0,0
1668291165582,ECE 251A,A00,103654,Rao; Bhaskar D.,0,0,0,0
1668291166006,ECE 257B,A00,103655,Bharadia; Dinesh,0,0,0,0
1668291166429,ECE 258A,A00,103656,Milstein; Laurence B.,0,0,0,0
1668291166853,ECE 260B,A00,103658,Kang; Mingu,0,0,0,0
1668291167280,ECE 264A,A00,103659,Galton; Ian A,0,0,0,0
1668291167703,ECE 265A,A00,103661,Gudem; Prasad S.S.,0,0,0,0
1668291168129,ECE 265D,A00,103662,Gudem; Prasad S.S.,0,0,0,0
1668291168550,ECE 268,A00,103663,Koushanfar; Farinaz,0,0,0,0
1668291168975,ECE 269,A01,103665,Pal; Piya,0,0,0,0
1668291169402,ECE 271B,A00,103666,Vasconcelos; Manuela,0,0,0,0
1668291169826,ECE 276A,A00,103667,Atanasov; Nikolay A.,0,0,0,0
1668291170248,ECE 277,A00,103668,An; Cheolhong,0,0,0,0
1668291170674,ECE 279,A00,117947,Hall; Drew A.,0,0,0,0
1668291171524,ECE 283,A00,103670,Hsueh; Tzu-Chien,0,0,0,0
1668291171949,ECE 284,A00,103671,Turakhia; Yatish Girish,0,0,0,0
1668291172373,ECE 285,A00,103672,Zheng; Yang,0,0,0,0
1668291172373,ECE 285,B00,103673,Sworder; David D.,0,0,0,0
1668291172796,ECE 287,A00,103676,Javidi; Tara,0,0,0,0
1668291173226,MATH 200B,A00,098023,Salehi Golsefidy; Alireza,12,0,15,3
1668291173650,MATH 202B,A00,098024,Rhoades; Brendon Patrick,9,0,15,6
1668291174075,MATH 203B,A00,098025,Oprea; Dragos N.,10,0,15,5
1668291174497,MATH 204B,A00,098026,Sorensen; Claus M,13,0,15,2
1668291174921,MATH 208,A00,098027,Izadi; Elham,7,0,10,3
1668291175347,MATH 209,A00,098028,Pollack; Aaron,10,0,10,0
1668291175778,MATH 211A,A00,112919,Rogalski; Daniel,9,0,10,1
1668291176201,MATH 211B,A00,112920,Seward; Brandon M.,9,0,10,1
1668291176625,MATH 218,A00,098029,Li; Bo,10,0,10,0
1668291177047,MATH 220B,A00,098030,Novak; Jonathan I,11,0,15,4
1668291177471,MATH 221A,A00,098031,Ebenfelt; Peter F,13,0,15,2
1668291177896,MATH 231B,A00,098032,Zlatos; Andrej,12,0,15,3
1668291178320,MATH 240B,A00,098033,Ni; Lei,9,0,15,6
1668291178745,MATH 243,A00,098034,Jekel; David Andrew,10,0,10,0
1668291179169,MATH 245A,A00,098035,Nie; Jiawang,0,0,15,16
1668291179591,MATH 248,A00,098036,Bejenaru; Ioan,10,0,10,0
1668291180016,MATH 250B,A00,098037,Spolaor; Luca,14,0,15,1
1668291180442,MATH 258,A00,098038,Ni; Lei,10,0,10,0
1668291180867,MATH 264B,A00,098041,Rhoades; Brendon Patrick,9,0,15,6
1668291181293,MATH 268,A00,098042,Buss; Samuel R,10,0,10,0
1668291181716,MATH 269,A00,098043,Rhoades; Brendon Patrick,10,0,10,0
1668291182141,MATH 270B,A00,098044,Li; Bo,10,0,15,5
1668291182566,MATH 272B,A00,098045,Holst; Michael J,13,0,15,2
1668291182993,MATH 273A,A00,098046,Tian; Xiaochuan,10,0,15,5
1668291183419,MATH 275,A01,098048,Tian; Xiaochuan,6,0,10,4
1668291183842,MATH 278A,A00,098049,Holst; Michael J,8,0,10,2
1668291184266,MATH 278B,A00,098050,Cloninger; Alexander,10,0,10,0
1668291184690,MATH 278C,A00,098051,Nie; Jiawang,7,0,10,3
1668291185116,MATH 280B,A00,098052,Zheng; Tianyi,8,0,15,7
1668291185542,MATH 281B,A00,098053,Bradic; Jelena,1,0,15,14
1668291185967,MATH 282B,A00,098054,Arias-Castro; Ery,0,0,15,15
1668291186390,MATH 285,A00,098055,Fitzsimmons; Patrick J,0,0,15,17
1668291186815,MATH 287B,A00,098056,Arias-Castro; Ery,2,0,15,13
1668291187240,MATH 288,A00,098057,Agarwal; Pooja,9,0,10,1
1668291187240,MATH 288,B00,098058,Zhang; Danna,8,0,10,2
1668291187240,MATH 288,C00,098059,Williams; Ruth J,9,0,10,1
1668291187670,MATH 290B,A00,098060,Roberts; Justin Deritter,13,0,15,2
1668291188095,MATH 292,A00,098061,Belmont; Eva Kinoshita,10,0,10,0
1668291188518,MATH 295,A00,098062,Suk; Andrew Hoon,48,0,50,2
1668291188944,MATH 296,A00,098063,Novak; Jonathan I,20,0,20,0
1668291189367,MATH 297,001,098064,Gamst; Anthony Collins,9997,0,9999,2
1668291688104,COGS 205,A00,101395,Chiba; Andrea,19,0,20,1
1668291688533,COGS 210B,001,101404,Greene; Deanna Jacquelyn,9998,0,9999,1
1668291688533,COGS 210B,002,101417,Xia; Haijun,9999,0,9999,0
1668291688533,COGS 210B,003,101422,Nitz; Douglas A.,9999,0,9999,0
1668291688533,COGS 210B,004,101423,Hollan; James D.,9998,0,9999,1
1668291688533,COGS 210B,005,101424,Deak; Gedeon O.,9998,0,9999,1
1668291688533,COGS 210B,006,101425,Rossano; Federico,9999,0,9999,0
1668291688957,COGS 211B,A00,101427,Coulson; Seana M,9996,0,9999,3
1668291689384,COGS 220,A00,101428,Hollan; James D.,0,0,25,25
1668291689809,COGS 229,A00,101429,Dow; Steven P,18,0,25,7
1668291690231,COGS 230,A00,101430,Klemmer; Scott R,12,0,17,5
1668291690655,COGS 234,A00,101431,Xia; Haijun,1,0,25,24
1668291691081,COGS 260,A00,101432,Kiyonaga; Anastasia,21,0,25,4
1668291691081,COGS 260,B00,101433,Kirsh; David Joel,15,0,25,10
1668291691508,CSE 202,A00,102371,Impagliazzo; Russell,0,0,0,0
1668291691938,CSE 203B,A01,102373,Cheng; Chung Kuan,0,0,0,0
1668291692359,CSE 208,A00,102374,Micciancio; Daniele,0,0,0,0
1668291692783,CSE 209A,A00,112895,Impagliazzo; Russell,0,0,15,15
1668291693209,CSE 209B,A00,108005,Bellare; Mihir,0,0,0,0
1668291693633,CSE 210,A00,113163,Coblenz; Michael J,0,0,0,0
1668291694057,CSE 219,A00,106111,Dow; Steven P,0,0,20,20
1668291694479,CSE 221,A00,102376,Voelker; Geoffrey M.,0,0,0,0
1668291694905,CSE 224,A01,102378,Porter; George M,0,0,0,0
1668291695330,CSE 229A,A00,102379,Savage; Stefan,0,0,0,0
1668291695753,CSE 229C,A00,102380,Munyaka; Imani N. S.,0,0,0,0
1668291696176,CSE 232B,A00,102382,Deutsch; Alin Bernard,0,0,0,0
1668291696608,CSE 234,A01,112904,Kumar; Arun Kumar,0,0,0,0
1668291697033,CSE 237A,A00,102383,Rosing; Tajana Simunic,0,0,0,0
1668291697457,CSE 239A,A00,102384,Deutsch; Alin Bernard,0,0,0,0
1668291697881,CSE 239B,A00,102385,Polikarpova; Nadezhda,0,0,0,0
1668291698305,CSE 240A,A00,102386,Pannuto; Patrick William,0,0,0,0
1668291698729,CSE 240B,A00,102387,Zhao; Jishen,0,0,0,0
1668291699154,CSE 241A,A00,106406,Kang; Mingu,0,0,0,0
1668291699582,CSE 249B,A00,102388,Kahng; Andrew Byun,0,0,8,8
1668291700009,CSE 251B,A01,102392,Cottrell; Garrison W,0,0,0,0
1668291700009,CSE 251B,A02,102393,Cottrell; Garrison W,0,0,0,0
1668291700433,CSE 252B,A00,102394,Ochoa; Benjamin Lawrence,0,0,0,0
1668291700859,CSE 257,A01,102396,Gao; Sicun,0,0,0,0
1668291701289,CSE 272,A00,102397,Li; Tzumao,0,0,0,0
1668291701715,CSE 274,A00,111323,Chern; Albert Ren-Haur,0,0,0,0
1668291702139,CSE 282,A00,102398,Pevzner; Pavel Arkadjevich,0,0,0,0
1668291702565,CSE 284,A00,114175,Gymrek; Melissa Ann,0,0,0,0
1668291702993,CSE 290,A00,102399,Chandraker; Manmohan Krishna,0,0,0,0
1668291702993,CSE 290,B00,102400,Vaccaro; Kristen Marie,0,0,25,25
1668291702993,CSE 290,C00,102414,Pannuto; Patrick William,0,0,25,25
1668291702993,CSE 290,D00,102427,Pevzner; Pavel Arkadjevich,0,0,0,0
1668291702993,CSE 290,E00,102429,Zhao; Jishen,0,0,0,0
1668291702993,CSE 290,F00,102436,Tullsen; Dean Michael,0,0,0,0
1668291702993,CSE 290,G00,102440,Christensen; Henrik I,0,0,20,20
1668291703421,CSE 291,A00,102443,Su; Hao,0,0,0,0
1668291703421,CSE 291,B00,102448,Polikarpova; Nadezhda,0,0,0,0
1668291703421,CSE 291,C00,102453,Vaccaro; Kristen Marie,0,0,0,0
1668291703421,CSE 291,D00,111343,Savage; Stefan,0,0,0,0
1668291703421,CSE 291,E00,116474,Claffy; Kimberly Claire,0,0,0,0
1668291703421,CSE 291,F00,116479,Pasquale; Joseph,0,0,0,0
1668291703853,CSE 293,001,119111,Bafna; Vineet,9999,0,9999,0
1668291703853,CSE 293,002,119118,Bellare; Mihir,9999,0,9999,0
1668291703853,CSE 293,003,119122,Berg-Kirkpatrick; Taylor D,9999,0,9999,0
1668291703853,CSE 293,004,119135,Christensen; Henrik I,9999,0,9999,0
1668291703853,CSE 293,005,119142,Cottrell; Garrison W,9999,0,9999,0
1668291703853,CSE 293,006,119146,Deutsch; Alin Bernard,9999,0,9999,0
1668291703853,CSE 293,007,119159,Esmaeilzadeh; Hadi,9999,0,9999,0
1668291703853,CSE 293,008,119166,Freund; Yoav,9999,0,9999,0
1668291703853,CSE 293,009,119170,Griswold; William G.,9999,0,9999,0
1668291703853,CSE 293,010,119183,Gymrek; Melissa Ann,9999,0,9999,0
1668291703853,CSE 293,011,119190,Heninger; Nadia A,9999,0,9999,0
1668291703853,CSE 293,012,119230,Impagliazzo; Russell,9999,0,9999,0
1668291703853,CSE 293,013,119232,Jhala; Ranjit,9999,0,9999,0
1668291703853,CSE 293,014,119233,Kahng; Andrew Byun,9999,0,9999,0
1668291703853,CSE 293,015,119298,Kane; Daniel Mertz,9999,0,9999,0
1668291703853,CSE 293,016,119299,Kriegman; David J,9999,0,9999,0
1668291703853,CSE 293,017,119300,Kumar; Arun Kumar,9999,0,9999,0
1668291703853,CSE 293,018,119301,Lerner; Sorin,9999,0,9999,0
1668291703853,CSE 293,019,119302,Lovett; Shachar,9999,0,9999,0
1668291703853,CSE 293,020,119303,McAuley; Julian John,9999,0,9999,0
1668291703853,CSE 293,021,119304,Micciancio; Daniele,9999,0,9999,0
1668291703853,CSE 293,022,119367,Orailoglu; Alex,9999,0,9999,0
1668291703853,CSE 293,023,119382,Paturi; Ramamohan,9999,0,9999,0
1668291703853,CSE 293,024,119404,Polikarpova; Nadezhda,9999,0,9999,0
1668291703853,CSE 293,025,119406,Politz; Joseph Gibbs,9999,0,9999,0
1668291703853,CSE 293,026,119411,Porter; George M,9999,0,9999,0
1668291703853,CSE 293,027,119414,Porter; Leonard Emerson,9999,0,9999,0
1668291703853,CSE 293,028,119416,Ramamoorthi; Ravi,9999,0,9999,0
1668291703853,CSE 293,029,119417,Sahoo; Debashis,9999,0,9999,0
1668291703853,CSE 293,030,119420,Saul; Lawrence,9999,0,9999,0
1668291703853,CSE 293,031,119421,Savage; Stefan,9999,0,9999,0
1668291703853,CSE 293,032,119425,Schulze; Jurgen P.,9999,0,9999,0
1668291703853,CSE 293,033,119426,Snoeren; Alex C.,9999,0,9999,0
1668291703853,CSE 293,034,119428,Shang; Jingbo,9999,0,9999,0
1668291703853,CSE 293,035,119430,Stefan; Deian,9999,0,9999,0
1668291703853,CSE 293,036,119431,Su; Hao,9999,0,9999,0
1668291703853,CSE 293,037,119433,Swanson; Steven James,9999,0,9999,0
1668291703853,CSE 293,038,119435,Tullsen; Dean Michael,9999,0,9999,0
1668291703853,CSE 293,039,119483,Voelker; Geoffrey M.,9999,0,9999,0
1668291703853,CSE 293,040,119537,Zhao; Jishen,9999,0,9999,0
1668291703853,CSE 293,041,119538,Zhou; Yuan-Yuan,9999,0,9999,0
1668291703853,CSE 293,042,119539,Gao; Sicun,9999,0,9999,0
1668291703853,CSE 293,043,119540,Weibel; Nadir,9999,0,9999,0
1668291703853,CSE 293,044,119541,Gupta; Rajesh K.,9999,0,9999,0
1668291703853,CSE 293,045,126410,Vaccaro; Kristen Marie,9999,0,9999,0
1668291703853,CSE 293,046,126411,Klemke; Richard,9999,0,9999,0
1668291704275,CSE 294,A00,102459,Voelker; Geoffrey M.,0,0,0,0
1668291704275,CSE 294,B00,111322,Orailoglu; Alex,0,0,0,0
1668291704702,DSE 201,A00,096914,Deutsch; Alin Bernard,30,0,30,0
1668291705127,DSE 210,A00,096915,Dasgupta; Sanjoy,30,0,30,0
1668291705549,DSE 260A,A00,096916,Altintas De Callaf; Ilkay,30,0,30,0
1668291705993,ECE 200,001,103586,Antipa; Nicholas A,9999,0,9999,0
1668291705993,ECE 200,002,103587,Atanasov; Nikolay A.,9999,0,9999,0
1668291705993,ECE 200,003,103588,Bharadia; Dinesh,9999,0,9999,0
1668291705993,ECE 200,004,103589,Cheng; Chung Kuan,9999,0,9999,0
1668291705993,ECE 200,005,103590,Cosman; Pamela C.,9999,0,9999,0
1668291705993,ECE 200,006,103591,Dayeh; Shadi Ahmad,9999,0,9999,0
1668291705993,ECE 200,007,103592,Fainman; Yeshaiahu,9999,0,9999,0
1668291705993,ECE 200,008,103593,Ford; Joseph Earl,9999,0,9999,0
1668291705993,ECE 200,009,103594,Franceschetti; Massimo,9999,0,9999,0
1668291705993,ECE 200,010,103595,Fullerton; Eric E,9999,0,9999,0
1668291705993,ECE 200,011,103596,Galton; Ian A,9999,0,9999,0
1668291705993,ECE 200,012,103597,Gilja; Vikash,9999,0,9999,0
1668291705993,ECE 200,013,103598,Hall; Drew A.,9999,0,9999,0
1668291705993,ECE 200,014,103599,Hsueh; Tzu-Chien,9999,0,9999,0
1668291705993,ECE 200,015,103600,Javidi; Tara,9999,0,9999,0
1668291705993,ECE 200,016,103601,Kahng; Andrew Byun,9999,0,9999,0
1668291705993,ECE 200,017,103602,Kim; Young-Han,9999,0,9999,0
1668291705993,ECE 200,018,103603,Koushanfar; Farinaz,9999,0,9999,0
1668291705993,ECE 200,019,103604,Kuzum; Duygu,9999,0,9999,0
1668291705993,ECE 200,020,103605,Le; Hanh-Phuc,9999,0,9999,0
1668291705993,ECE 200,021,103606,Lin; Bill,9999,0,9999,0
1668291705993,ECE 200,022,103607,Liu; Zhaowei,9998,0,9999,1
1668291705993,ECE 200,023,103608,Lo; Yu-Hwa,9999,0,9999,0
1668291705993,ECE 200,024,103609,Lomakin; Vitaliy,9999,0,9999,0
1668291705993,ECE 200,025,103610,Mercier; Patrick Philip,9999,0,9999,0
1668291705993,ECE 200,026,103611,Meyer; Florian,9999,0,9999,0
1668291705993,ECE 200,027,103612,Milstein; Laurence B.,9999,0,9999,0
1668291705993,ECE 200,028,103613,Mir Arabbaygi; Siavash,9999,0,9999,0
1668291705993,ECE 200,029,103614,Mookherjea; Shayan,9999,0,9999,0
1668291705993,ECE 200,030,103615,Morris; Karcher William,9999,0,9999,0
1668291705993,ECE 200,031,103616,Ng; Tse Nga,9999,0,9999,0
1668291705993,ECE 200,032,103617,Nguyen; Truong Quang,9999,0,9999,0
1668291705993,ECE 200,033,103618,Nomura; Kenji,9999,0,9999,0
1668291705993,ECE 200,034,103619,Orlitsky; Alon,9999,0,9999,0
1668291705993,ECE 200,035,103620,Pal; Piya,9999,0,9999,0
1668291705993,ECE 200,036,103621,Papen; George C.,9999,0,9999,0
1668291705993,ECE 200,037,103622,Radic; Stojan,9999,0,9999,0
1668291705993,ECE 200,038,103623,Rao; Bhaskar D.,9999,0,9999,0
1668291705993,ECE 200,039,103624,Rao; Ramesh R,9999,0,9999,0
1668291705993,ECE 200,040,103625,Rebeiz; Gabriel,9999,0,9999,0
1668291705993,ECE 200,041,103626,Sanford; John R,9999,0,9999,0
1668291705993,ECE 200,042,103627,Siegel; Paul H.,9999,0,9999,0
1668291705993,ECE 200,043,103628,Sievenpiper; Daniel F.,9999,0,9999,0
1668291705993,ECE 200,044,103629,Sworder; David D.,9999,0,9999,0
1668291705993,ECE 200,045,103630,Taur; Yuan,9999,0,9999,0
1668291705993,ECE 200,046,103631,Touri; Behrouz,9999,0,9999,0
1668291705993,ECE 200,047,103632,Trivedi; Mohan M.,9999,0,9999,0
1668291705993,ECE 200,048,103633,Vasconcelos; Nuno,9999,0,9999,0
1668291705993,ECE 200,049,103634,Wang; Xiaolong,9999,0,9999,0
1668291705993,ECE 200,050,103635,Xie; Pengtao,9999,0,9999,0
1668291705993,ECE 200,051,103636,Yip; Michael,9999,0,9999,0
1668291705993,ECE 200,052,103637,Zeger; Kenneth A.,999,0,999,0
1668291705993,ECE 200,053,103638,Zhang; Xinyu,9999,0,9999,0
1668291705993,ECE 200,054,103639,Turakhia; Yatish Girish,9999,0,9999,0
1668291705993,ECE 200,055,103640,Kang; Mingu,9999,0,9999,0
1668291705993,ECE 200,056,103641,Shi; Yuanyuan,9999,0,9999,0
1668291705993,ECE 200,057,103642,Wang; Edward Jay,9999,0,9999,0
1668291705993,ECE 200,058,103643,Zheng; Yang,9999,0,9999,0
1668291706420,ECE 202,A00,103644,Kuzum; Duygu,0,0,0,0
1668291706848,ECE 212BN,A00,103646,Ng; Tse Nga,0,0,0,0
1668291707273,ECE 221,A00,111493,Staff,0,0,0,0
1668291707699,ECE 222B,A00,103647,Lomakin; Vitaliy,0,0,0,0
1668291708122,ECE 230B,A00,103648,Taur; Yuan,0,0,0,0
1668291708550,ECE 238B,A00,103649,Garay; Javier,0,0,0,0
1668291708975,ECE 240B,A00,112900,Fainman; Yeshaiahu,0,0,0,0
1668291709399,ECE 247A,A00,103650,Jokerst; Jesse Vincent,0,0,0,0
1668291709827,ECE 247B,A00,103651,Wang; Joseph,0,0,0,0
1668291710249,ECE 250,A00,103652,Siegel; Paul H.,0,0,0,0
1668291710676,ECE 251A,A00,103654,Rao; Bhaskar D.,0,0,0,0
1668291711098,ECE 257B,A00,103655,Bharadia; Dinesh,0,0,0,0
1668291711599,ECE 258A,A00,103656,Milstein; Laurence B.,0,0,0,0
1668291712026,ECE 260B,A00,103658,Kang; Mingu,0,0,0,0
1668291712454,ECE 264A,A00,103659,Galton; Ian A,0,0,0,0
1668291712886,ECE 265A,A00,103661,Gudem; Prasad S.S.,0,0,0,0
1668291713309,ECE 265D,A00,103662,Gudem; Prasad S.S.,0,0,0,0
1668291713740,ECE 268,A00,103663,Koushanfar; Farinaz,0,0,0,0
1668291714162,ECE 269,A01,103665,Pal; Piya,0,0,0,0
1668291714593,ECE 271B,A00,103666,Vasconcelos; Manuela,0,0,0,0
1668291715015,ECE 276A,A00,103667,Atanasov; Nikolay A.,0,0,0,0
1668291715437,ECE 277,A00,103668,An; Cheolhong,0,0,0,0
1668291715863,ECE 279,A00,117947,Hall; Drew A.,0,0,0,0
1668291716720,ECE 283,A00,103670,Hsueh; Tzu-Chien,0,0,0,0
1668291717144,ECE 284,A00,103671,Turakhia; Yatish Girish,0,0,0,0
1668291717568,ECE 285,A00,103672,Zheng; Yang,0,0,0,0
1668291717568,ECE 285,B00,103673,Sworder; David D.,0,0,0,0
1668291717991,ECE 287,A00,103676,Javidi; Tara,0,0,0,0
1668291718419,MATH 200B,A00,098023,Salehi Golsefidy; Alireza,12,0,15,3
1668291718845,MATH 202B,A00,098024,Rhoades; Brendon Patrick,9,0,15,6
1668291719273,MATH 203B,A00,098025,Oprea; Dragos N.,10,0,15,5
1668291719699,MATH 204B,A00,098026,Sorensen; Claus M,13,0,15,2
1668291720124,MATH 208,A00,098027,Izadi; Elham,7,0,10,3
1668291720551,MATH 209,A00,098028,Pollack; Aaron,10,0,10,0
1668291720973,MATH 211A,A00,112919,Rogalski; Daniel,9,0,10,1
1668291721399,MATH 211B,A00,112920,Seward; Brandon M.,9,0,10,1
1668291721823,MATH 218,A00,098029,Li; Bo,10,0,10,0
1668291722245,MATH 220B,A00,098030,Novak; Jonathan I,11,0,15,4
1668291722669,MATH 221A,A00,098031,Ebenfelt; Peter F,13,0,15,2
1668291723097,MATH 231B,A00,098032,Zlatos; Andrej,12,0,15,3
1668291723535,MATH 240B,A00,098033,Ni; Lei,9,0,15,6
1668291723959,MATH 243,A00,098034,Jekel; David Andrew,10,0,10,0
1668291724389,MATH 245A,A00,098035,Nie; Jiawang,0,0,15,16
1668291724824,MATH 248,A00,098036,Bejenaru; Ioan,10,0,10,0
1668291725249,MATH 250B,A00,098037,Spolaor; Luca,14,0,15,1
1668291725677,MATH 258,A00,098038,Ni; Lei,10,0,10,0
1668291726101,MATH 264B,A00,098041,Rhoades; Brendon Patrick,9,0,15,6
1668291726531,MATH 268,A00,098042,Buss; Samuel R,10,0,10,0
1668291726955,MATH 269,A00,098043,Rhoades; Brendon Patrick,10,0,10,0
1668291727379,MATH 270B,A00,098044,Li; Bo,10,0,15,5
1668291727802,MATH 272B,A00,098045,Holst; Michael J,13,0,15,2
1668291728227,MATH 273A,A00,098046,Tian; Xiaochuan,10,0,15,5
1668291728651,MATH 275,A01,098048,Tian; Xiaochuan,6,0,10,4
1668291729074,MATH 278A,A00,098049,Holst; Michael J,8,0,10,2
1668291729496,MATH 278B,A00,098050,Cloninger; Alexander,10,0,10,0
1668291729918,MATH 278C,A00,098051,Nie; Jiawang,7,0,10,3
1668291730345,MATH 280B,A00,098052,Zheng; Tianyi,8,0,15,7
1668291730777,MATH 281B,A00,098053,Bradic; Jelena,1,0,15,14
1668291731205,MATH 282B,A00,098054,Arias-Castro; Ery,0,0,15,15
1668291731627,MATH 285,A00,098055,Fitzsimmons; Patrick J,0,0,15,17
1668291732051,MATH 287B,A00,098056,Arias-Castro; Ery,2,0,15,13
1668291732482,MATH 288,A00,098057,Agarwal; Pooja,9,0,10,1
1668291732482,MATH 288,B00,098058,Zhang; Danna,8,0,10,2
1668291732482,MATH 288,C00,098059,Williams; Ruth J,9,0,10,1
1668291732917,MATH 290B,A00,098060,Roberts; Justin Deritter,13,0,15,2
1668291733351,MATH 292,A00,098061,Belmont; Eva Kinoshita,10,0,10,0
1668291733776,MATH 295,A00,098062,Suk; Andrew Hoon,48,0,50,2
1668291734212,MATH 296,A00,098063,Novak; Jonathan I,20,0,20,0
1668291734635,MATH 297,001,098064,Gamst; Anthony Collins,9997,0,9999,2
1668292233464,COGS 205,A00,101395,Chiba; Andrea,19,0,20,1
1668292233887,COGS 210B,001,101404,Greene; Deanna Jacquelyn,9998,0,9999,1
1668292233887,COGS 210B,002,101417,Xia; Haijun,9999,0,9999,0
1668292233887,COGS 210B,003,101422,Nitz; Douglas A.,9999,0,9999,0
1668292233887,COGS 210B,004,101423,Hollan; James D.,9998,0,9999,1
1668292233887,COGS 210B,005,101424,Deak; Gedeon O.,9998,0,9999,1
1668292233887,COGS 210B,006,101425,Rossano; Federico,9999,0,9999,0
1668292234312,COGS 211B,A00,101427,Coulson; Seana M,9996,0,9999,3
1668292234736,COGS 220,A00,101428,Hollan; James D.,0,0,25,25
1668292235167,COGS 229,A00,101429,Dow; Steven P,18,0,25,7
1668292235592,COGS 230,A00,101430,Klemmer; Scott R,12,0,17,5
1668292236015,COGS 234,A00,101431,Xia; Haijun,1,0,25,24
1668292236441,COGS 260,A00,101432,Kiyonaga; Anastasia,21,0,25,4
1668292236441,COGS 260,B00,101433,Kirsh; David Joel,15,0,25,10
1668292236868,CSE 202,A00,102371,Impagliazzo; Russell,0,0,0,0
1668292237289,CSE 203B,A01,102373,Cheng; Chung Kuan,0,0,0,0
1668292237715,CSE 208,A00,102374,Micciancio; Daniele,0,0,0,0
1668292238140,CSE 209A,A00,112895,Impagliazzo; Russell,0,0,15,15
1668292238563,CSE 209B,A00,108005,Bellare; Mihir,0,0,0,0
1668292238986,CSE 210,A00,113163,Coblenz; Michael J,0,0,0,0
1668292239411,CSE 219,A00,106111,Dow; Steven P,0,0,20,20
1668292239836,CSE 221,A00,102376,Voelker; Geoffrey M.,0,0,0,0
1668292240259,CSE 224,A01,102378,Porter; George M,0,0,0,0
1668292240684,CSE 229A,A00,102379,Savage; Stefan,0,0,0,0
1668292241111,CSE 229C,A00,102380,Munyaka; Imani N. S.,0,0,0,0
1668292241540,CSE 232B,A00,102382,Deutsch; Alin Bernard,0,0,0,0
1668292241963,CSE 234,A01,112904,Kumar; Arun Kumar,0,0,0,0
1668292242388,CSE 237A,A00,102383,Rosing; Tajana Simunic,0,0,0,0
1668292242815,CSE 239A,A00,102384,Deutsch; Alin Bernard,0,0,0,0
1668292243238,CSE 239B,A00,102385,Polikarpova; Nadezhda,0,0,0,0
1668292243665,CSE 240A,A00,102386,Pannuto; Patrick William,0,0,0,0
1668292244089,CSE 240B,A00,102387,Zhao; Jishen,0,0,0,0
1668292244516,CSE 241A,A00,106406,Kang; Mingu,0,0,0,0
1668292244939,CSE 249B,A00,102388,Kahng; Andrew Byun,0,0,8,8
1668292245362,CSE 251B,A01,102392,Cottrell; Garrison W,0,0,0,0
1668292245362,CSE 251B,A02,102393,Cottrell; Garrison W,0,0,0,0
1668292245786,CSE 252B,A00,102394,Ochoa; Benjamin Lawrence,0,0,0,0
1668292246213,CSE 257,A01,102396,Gao; Sicun,0,0,0,0
1668292246638,CSE 272,A00,102397,Li; Tzumao,0,0,0,0
1668292247063,CSE 274,A00,111323,Chern; Albert Ren-Haur,0,0,0,0
1668292247488,CSE 282,A00,102398,Pevzner; Pavel Arkadjevich,0,0,0,0
1668292247910,CSE 284,A00,114175,Gymrek; Melissa Ann,0,0,0,0
1668292248334,CSE 290,A00,102399,Chandraker; Manmohan Krishna,0,0,0,0
1668292248334,CSE 290,B00,102400,Vaccaro; Kristen Marie,0,0,25,25
1668292248334,CSE 290,C00,102414,Pannuto; Patrick William,0,0,25,25
1668292248334,CSE 290,D00,102427,Pevzner; Pavel Arkadjevich,0,0,0,0
1668292248334,CSE 290,E00,102429,Zhao; Jishen,0,0,0,0
1668292248334,CSE 290,F00,102436,Tullsen; Dean Michael,0,0,0,0
1668292248334,CSE 290,G00,102440,Christensen; Henrik I,0,0,20,20
1668292248758,CSE 291,A00,102443,Su; Hao,0,0,0,0
1668292248758,CSE 291,B00,102448,Polikarpova; Nadezhda,0,0,0,0
1668292248758,CSE 291,C00,102453,Vaccaro; Kristen Marie,0,0,0,0
1668292248758,CSE 291,D00,111343,Savage; Stefan,0,0,0,0
1668292248758,CSE 291,E00,116474,Claffy; Kimberly Claire,0,0,0,0
1668292248758,CSE 291,F00,116479,Pasquale; Joseph,0,0,0,0
1668292249192,CSE 293,001,119111,Bafna; Vineet,9999,0,9999,0
1668292249192,CSE 293,002,119118,Bellare; Mihir,9999,0,9999,0
1668292249192,CSE 293,003,119122,Berg-Kirkpatrick; Taylor D,9999,0,9999,0
1668292249192,CSE 293,004,119135,Christensen; Henrik I,9999,0,9999,0
1668292249192,CSE 293,005,119142,Cottrell; Garrison W,9999,0,9999,0
1668292249192,CSE 293,006,119146,Deutsch; Alin Bernard,9999,0,9999,0
1668292249192,CSE 293,007,119159,Esmaeilzadeh; Hadi,9999,0,9999,0
1668292249192,CSE 293,008,119166,Freund; Yoav,9999,0,9999,0
1668292249192,CSE 293,009,119170,Griswold; William G.,9999,0,9999,0
1668292249192,CSE 293,010,119183,Gymrek; Melissa Ann,9999,0,9999,0
1668292249192,CSE 293,011,119190,Heninger; Nadia A,9999,0,9999,0
1668292249192,CSE 293,012,119230,Impagliazzo; Russell,9999,0,9999,0
1668292249192,CSE 293,013,119232,Jhala; Ranjit,9999,0,9999,0
1668292249192,CSE 293,014,119233,Kahng; Andrew Byun,9999,0,9999,0
1668292249192,CSE 293,015,119298,Kane; Daniel Mertz,9999,0,9999,0
1668292249192,CSE 293,016,119299,Kriegman; David J,9999,0,9999,0
1668292249192,CSE 293,017,119300,Kumar; Arun Kumar,9999,0,9999,0
1668292249192,CSE 293,018,119301,Lerner; Sorin,9999,0,9999,0
1668292249192,CSE 293,019,119302,Lovett; Shachar,9999,0,9999,0
1668292249192,CSE 293,020,119303,McAuley; Julian John,9999,0,9999,0
1668292249192,CSE 293,021,119304,Micciancio; Daniele,9999,0,9999,0
1668292249192,CSE 293,022,119367,Orailoglu; Alex,9999,0,9999,0
1668292249192,CSE 293,023,119382,Paturi; Ramamohan,9999,0,9999,0
1668292249192,CSE 293,024,119404,Polikarpova; Nadezhda,9999,0,9999,0
1668292249192,CSE 293,025,119406,Politz; Joseph Gibbs,9999,0,9999,0
1668292249192,CSE 293,026,119411,Porter; George M,9999,0,9999,0
1668292249192,CSE 293,027,119414,Porter; Leonard Emerson,9999,0,9999,0
1668292249192,CSE 293,028,119416,Ramamoorthi; Ravi,9999,0,9999,0
1668292249192,CSE 293,029,119417,Sahoo; Debashis,9999,0,9999,0
1668292249192,CSE 293,030,119420,Saul; Lawrence,9999,0,9999,0
1668292249192,CSE 293,031,119421,Savage; Stefan,9999,0,9999,0
1668292249192,CSE 293,032,119425,Schulze; Jurgen P.,9999,0,9999,0
1668292249192,CSE 293,033,119426,Snoeren; Alex C.,9999,0,9999,0
1668292249192,CSE 293,034,119428,Shang; Jingbo,9999,0,9999,0
1668292249192,CSE 293,035,119430,Stefan; Deian,9999,0,9999,0
1668292249192,CSE 293,036,119431,Su; Hao,9999,0,9999,0
1668292249192,CSE 293,037,119433,Swanson; Steven James,9999,0,9999,0
1668292249192,CSE 293,038,119435,Tullsen; Dean Michael,9999,0,9999,0
1668292249192,CSE 293,039,119483,Voelker; Geoffrey M.,9999,0,9999,0
1668292249192,CSE 293,040,119537,Zhao; Jishen,9999,0,9999,0
1668292249192,CSE 293,041,119538,Zhou; Yuan-Yuan,9999,0,9999,0
1668292249192,CSE 293,042,119539,Gao; Sicun,9999,0,9999,0
1668292249192,CSE 293,043,119540,Weibel; Nadir,9999,0,9999,0
1668292249192,CSE 293,044,119541,Gupta; Rajesh K.,9999,0,9999,0
1668292249192,CSE 293,045,126410,Vaccaro; Kristen Marie,9999,0,9999,0
1668292249192,CSE 293,046,126411,Klemke; Richard,9999,0,9999,0
1668292249624,CSE 294,A00,102459,Voelker; Geoffrey M.,0,0,0,0
1668292249624,CSE 294,B00,111322,Orailoglu; Alex,0,0,0,0
1668292250047,DSE 201,A00,096914,Deutsch; Alin Bernard,30,0,30,0
1668292250473,DSE 210,A00,096915,Dasgupta; Sanjoy,30,0,30,0
1668292250907,DSE 260A,A00,096916,Altintas De Callaf; Ilkay,30,0,30,0
1668292251366,ECE 200,001,103586,Antipa; Nicholas A,9999,0,9999,0
1668292251366,ECE 200,002,103587,Atanasov; Nikolay A.,9999,0,9999,0
1668292251366,ECE 200,003,103588,Bharadia; Dinesh,9999,0,9999,0
1668292251366,ECE 200,004,103589,Cheng; Chung Kuan,9999,0,9999,0
1668292251366,ECE 200,005,103590,Cosman; Pamela C.,9999,0,9999,0
1668292251366,ECE 200,006,103591,Dayeh; Shadi Ahmad,9999,0,9999,0
1668292251366,ECE 200,007,103592,Fainman; Yeshaiahu,9999,0,9999,0
1668292251366,ECE 200,008,103593,Ford; Joseph Earl,9999,0,9999,0
1668292251366,ECE 200,009,103594,Franceschetti; Massimo,9999,0,9999,0
1668292251366,ECE 200,010,103595,Fullerton; Eric E,9999,0,9999,0
1668292251366,ECE 200,011,103596,Galton; Ian A,9999,0,9999,0
1668292251366,ECE 200,012,103597,Gilja; Vikash,9999,0,9999,0
1668292251366,ECE 200,013,103598,Hall; Drew A.,9999,0,9999,0
1668292251366,ECE 200,014,103599,Hsueh; Tzu-Chien,9999,0,9999,0
1668292251366,ECE 200,015,103600,Javidi; Tara,9999,0,9999,0
1668292251366,ECE 200,016,103601,Kahng; Andrew Byun,9999,0,9999,0
1668292251366,ECE 200,017,103602,Kim; Young-Han,9999,0,9999,0
1668292251366,ECE 200,018,103603,Koushanfar; Farinaz,9999,0,9999,0
1668292251366,ECE 200,019,103604,Kuzum; Duygu,9999,0,9999,0
1668292251366,ECE 200,020,103605,Le; Hanh-Phuc,9999,0,9999,0
1668292251366,ECE 200,021,103606,Lin; Bill,9999,0,9999,0
1668292251366,ECE 200,022,103607,Liu; Zhaowei,9998,0,9999,1
1668292251366,ECE 200,023,103608,Lo; Yu-Hwa,9999,0,9999,0
1668292251366,ECE 200,024,103609,Lomakin; Vitaliy,9999,0,9999,0
1668292251366,ECE 200,025,103610,Mercier; Patrick Philip,9999,0,9999,0
1668292251366,ECE 200,026,103611,Meyer; Florian,9999,0,9999,0
1668292251366,ECE 200,027,103612,Milstein; Laurence B.,9999,0,9999,0
1668292251366,ECE 200,028,103613,Mir Arabbaygi; Siavash,9999,0,9999,0
1668292251366,ECE 200,029,103614,Mookherjea; Shayan,9999,0,9999,0
1668292251366,ECE 200,030,103615,Morris; Karcher William,9999,0,9999,0
1668292251366,ECE 200,031,103616,Ng; Tse Nga,9999,0,9999,0
1668292251366,ECE 200,032,103617,Nguyen; Truong Quang,9999,0,9999,0
1668292251366,ECE 200,033,103618,Nomura; Kenji,9999,0,9999,0
1668292251366,ECE 200,034,103619,Orlitsky; Alon,9999,0,9999,0
1668292251366,ECE 200,035,103620,Pal; Piya,9999,0,9999,0
1668292251366,ECE 200,036,103621,Papen; George C.,9999,0,9999,0
1668292251366,ECE 200,037,103622,Radic; Stojan,9999,0,9999,0
1668292251366,ECE 200,038,103623,Rao; Bhaskar D.,9999,0,9999,0
1668292251366,ECE 200,039,103624,Rao; Ramesh R,9999,0,9999,0
1668292251366,ECE 200,040,103625,Rebeiz; Gabriel,9999,0,9999,0
1668292251366,ECE 200,041,103626,Sanford; John R,9999,0,9999,0
1668292251366,ECE 200,042,103627,Siegel; Paul H.,9999,0,9999,0
1668292251366,ECE 200,043,103628,Sievenpiper; Daniel F.,9999,0,9999,0
1668292251366,ECE 200,044,103629,Sworder; David D.,9999,0,9999,0
1668292251366,ECE 200,045,103630,Taur; Yuan,9999,0,9999,0
1668292251366,ECE 200,046,103631,Touri; Behrouz,9999,0,9999,0
1668292251366,ECE 200,047,103632,Trivedi; Mohan M.,9999,0,9999,0
1668292251366,ECE 200,048,103633,Vasconcelos; Nuno,9999,0,9999,0
1668292251366,ECE 200,049,103634,Wang; Xiaolong,9999,0,9999,0
1668292251366,ECE 200,050,103635,Xie; Pengtao,9999,0,9999,0
1668292251366,ECE 200,051,103636,Yip; Michael,9999,0,9999,0
1668292251366,ECE 200,052,103637,Zeger; Kenneth A.,999,0,999,0
1668292251366,ECE 200,053,103638,Zhang; Xinyu,9999,0,9999,0
1668292251366,ECE 200,054,103639,Turakhia; Yatish Girish,9999,0,9999,0
1668292251366,ECE 200,055,103640,Kang; Mingu,9999,0,9999,0
1668292251366,ECE 200,056,103641,Shi; Yuanyuan,9999,0,9999,0
1668292251366,ECE 200,057,103642,Wang; Edward Jay,9999,0,9999,0
1668292251366,ECE 200,058,103643,Zheng; Yang,9999,0,9999,0
1668292251791,ECE 202,A00,103644,Kuzum; Duygu,0,0,0,0
1668292252213,ECE 212BN,A00,103646,Ng; Tse Nga,0,0,0,0
1668292252635,ECE 221,A00,111493,Staff,0,0,0,0
1668292253057,ECE 222B,A00,103647,Lomakin; Vitaliy,0,0,0,0
1668292253481,ECE 230B,A00,103648,Taur; Yuan,0,0,0,0
1668292253907,ECE 238B,A00,103649,Garay; Javier,0,0,0,0
1668292254329,ECE 240B,A00,112900,Fainman; Yeshaiahu,0,0,0,0
1668292254751,ECE 247A,A00,103650,Jokerst; Jesse Vincent,0,0,0,0
1668292255174,ECE 247B,A00,103651,Wang; Joseph,0,0,0,0
1668292255597,ECE 250,A00,103652,Siegel; Paul H.,0,0,0,0
1668292256022,ECE 251A,A00,103654,Rao; Bhaskar D.,0,0,0,0
1668292256449,ECE 257B,A00,103655,Bharadia; Dinesh,0,0,0,0
1668292256871,ECE 258A,A00,103656,Milstein; Laurence B.,0,0,0,0
1668292257296,ECE 260B,A00,103658,Kang; Mingu,0,0,0,0
1668292257717,ECE 264A,A00,103659,Galton; Ian A,0,0,0,0
1668292258144,ECE 265A,A00,103661,Gudem; Prasad S.S.,0,0,0,0
1668292258571,ECE 265D,A00,103662,Gudem; Prasad S.S.,0,0,0,0
1668292258997,ECE 268,A00,103663,Koushanfar; Farinaz,0,0,0,0
1668292259419,ECE 269,A01,103665,Pal; Piya,0,0,0,0
1668292259843,ECE 271B,A00,103666,Vasconcelos; Manuela,0,0,0,0
1668292260278,ECE 276A,A00,103667,Atanasov; Nikolay A.,0,0,0,0
1668292260708,ECE 277,A00,103668,An; Cheolhong,0,0,0,0
1668292261132,ECE 279,A00,117947,Hall; Drew A.,0,0,0,0
1668292261983,ECE 283,A00,103670,Hsueh; Tzu-Chien,0,0,0,0
1668292262407,ECE 284,A00,103671,Turakhia; Yatish Girish,0,0,0,0
1668292262830,ECE 285,A00,103672,Zheng; Yang,0,0,0,0
1668292262830,ECE 285,B00,103673,Sworder; David D.,0,0,0,0
1668292263253,ECE 287,A00,103676,Javidi; Tara,0,0,0,0
1668292263676,MATH 200B,A00,098023,Salehi Golsefidy; Alireza,12,0,15,3
1668292264102,MATH 202B,A00,098024,Rhoades; Brendon Patrick,9,0,15,6
1668292264528,MATH 203B,A00,098025,Oprea; Dragos N.,10,0,15,5
1668292264953,MATH 204B,A00,098026,Sorensen; Claus M,13,0,15,2
1668292265375,MATH 208,A00,098027,Izadi; Elham,7,0,10,3
1668292265802,MATH 209,A00,098028,Pollack; Aaron,10,0,10,0
1668292266226,MATH 211A,A00,112919,Rogalski; Daniel,9,0,10,1
1668292266647,MATH 211B,A00,112920,Seward; Brandon M.,9,0,10,1
1668292267072,MATH 218,A00,098029,Li; Bo,10,0,10,0
1668292267496,MATH 220B,A00,098030,Novak; Jonathan I,11,0,15,4
1668292267918,MATH 221A,A00,098031,Ebenfelt; Peter F,13,0,15,2
1668292268345,MATH 231B,A00,098032,Zlatos; Andrej,12,0,15,3
1668292268767,MATH 240B,A00,098033,Ni; Lei,9,0,15,6
1668292269194,MATH 243,A00,098034,Jekel; David Andrew,10,0,10,0
1668292269617,MATH 245A,A00,098035,Nie; Jiawang,0,0,15,16
1668292270044,MATH 248,A00,098036,Bejenaru; Ioan,10,0,10,0
1668292270468,MATH 250B,A00,098037,Spolaor; Luca,14,0,15,1
1668292270892,MATH 258,A00,098038,Ni; Lei,10,0,10,0
1668292271315,MATH 264B,A00,098041,Rhoades; Brendon Patrick,9,0,15,6
1668292271737,MATH 268,A00,098042,Buss; Samuel R,10,0,10,0
1668292272161,MATH 269,A00,098043,Rhoades; Brendon Patrick,10,0,10,0
1668292272584,MATH 270B,A00,098044,Li; Bo,10,0,15,5
1668292273008,MATH 272B,A00,098045,Holst; Michael J,13,0,15,2
1668292273528,MATH 273A,A00,098046,Tian; Xiaochuan,10,0,15,5
1668292273951,MATH 275,A01,098048,Tian; Xiaochuan,6,0,10,4
1668292274373,MATH 278A,A00,098049,Holst; Michael J,8,0,10,2
1668292274798,MATH 278B,A00,098050,Cloninger; Alexander,10,0,10,0
1668292275222,MATH 278C,A00,098051,Nie; Jiawang,7,0,10,3
1668292275653,MATH 280B,A00,098052,Zheng; Tianyi,8,0,15,7
1668292276079,MATH 281B,A00,098053,Bradic; Jelena,1,0,15,14
1668292276503,MATH 282B,A00,098054,Arias-Castro; Ery,0,0,15,15
1668292276927,MATH 285,A00,098055,Fitzsimmons; Patrick J,0,0,15,17
1668292277353,MATH 287B,A00,098056,Arias-Castro; Ery,2,0,15,13
1668292277778,MATH 288,A00,098057,Agarwal; Pooja,9,0,10,1
1668292277778,MATH 288,B00,098058,Zhang; Danna,8,0,10,2
1668292277778,MATH 288,C00,098059,Williams; Ruth J,9,0,10,1
1668292278209,MATH 290B,A00,098060,Roberts; Justin Deritter,13,0,15,2
1668292278634,MATH 292,A00,098061,Belmont; Eva Kinoshita,10,0,10,0
1668292279062,MATH 295,A00,098062,Suk; Andrew Hoon,48,0,50,2
1668292279485,MATH 296,A00,098063,Novak; Jonathan I,20,0,20,0
1668292279911,MATH 297,001,098064,Gamst; Anthony Collins,9997,0,9999,2
1668292790014,COGS 205,A00,101395,Chiba; Andrea,19,0,20,1
1668292790440,COGS 210B,001,101404,Greene; Deanna Jacquelyn,9998,0,9999,1
1668292790440,COGS 210B,002,101417,Xia; Haijun,9999,0,9999,0
1668292790440,COGS 210B,003,101422,Nitz; Douglas A.,9999,0,9999,0
1668292790440,COGS 210B,004,101423,Hollan; James D.,9998,0,9999,1
1668292790440,COGS 210B,005,101424,Deak; Gedeon O.,9998,0,9999,1
1668292790440,COGS 210B,006,101425,Rossano; Federico,9999,0,9999,0
1668292790875,COGS 211B,A00,101427,Coulson; Seana M,9996,0,9999,3
1668292791300,COGS 220,A00,101428,Hollan; James D.,0,0,25,25
1668292791726,COGS 229,A00,101429,Dow; Steven P,18,0,25,7
1668292792149,COGS 230,A00,101430,Klemmer; Scott R,12,0,17,5
1668292792573,COGS 234,A00,101431,Xia; Haijun,1,0,25,24
1668292793013,COGS 260,A00,101432,Kiyonaga; Anastasia,21,0,25,4
1668292793013,COGS 260,B00,101433,Kirsh; David Joel,15,0,25,10
1668292793437,CSE 202,A00,102371,Impagliazzo; Russell,0,0,0,0
1668292793863,CSE 203B,A01,102373,Cheng; Chung Kuan,0,0,0,0
1668292794288,CSE 208,A00,102374,Micciancio; Daniele,0,0,0,0
1668292794712,CSE 209A,A00,112895,Impagliazzo; Russell,0,0,15,15
1668292795135,CSE 209B,A00,108005,Bellare; Mihir,0,0,0,0
1668292795557,CSE 210,A00,113163,Coblenz; Michael J,0,0,0,0
1668292795999,CSE 219,A00,106111,Dow; Steven P,0,0,20,20
1668292796426,CSE 221,A00,102376,Voelker; Geoffrey M.,0,0,0,0
1668292796851,CSE 224,A01,102378,Porter; George M,0,0,0,0
1668292797274,CSE 229A,A00,102379,Savage; Stefan,0,0,0,0
1668292797699,CSE 229C,A00,102380,Munyaka; Imani N. S.,0,0,0,0
1668292798122,CSE 232B,A00,102382,Deutsch; Alin Bernard,0,0,0,0
1668292798548,CSE 234,A01,112904,Kumar; Arun Kumar,0,0,0,0
1668292798973,CSE 237A,A00,102383,Rosing; Tajana Simunic,0,0,0,0
1668292799395,CSE 239A,A00,102384,Deutsch; Alin Bernard,0,0,0,0
1668292799820,CSE 239B,A00,102385,Polikarpova; Nadezhda,0,0,0,0
1668292800242,CSE 240A,A00,102386,Pannuto; Patrick William,0,0,0,0
1668292800680,CSE 240B,A00,102387,Zhao; Jishen,0,0,0,0
1668292801105,CSE 241A,A00,106406,Kang; Mingu,0,0,0,0
1668292801535,CSE 249B,A00,102388,Kahng; Andrew Byun,0,0,8,8
1668292801963,CSE 251B,A01,102392,Cottrell; Garrison W,0,0,0,0
1668292801963,CSE 251B,A02,102393,Cottrell; Garrison W,0,0,0,0
1668292802392,CSE 252B,A00,102394,Ochoa; Benjamin Lawrence,0,0,0,0
1668292802827,CSE 257,A01,102396,Gao; Sicun,0,0,0,0
1668292803252,CSE 272,A00,102397,Li; Tzumao,0,0,0,0
1668292803767,CSE 274,A00,111323,Chern; Albert Ren-Haur,0,0,0,0
1668292804189,CSE 282,A00,102398,Pevzner; Pavel Arkadjevich,0,0,0,0
1668292804612,CSE 284,A00,114175,Gymrek; Melissa Ann,0,0,0,0
1668292805038,CSE 290,A00,102399,Chandraker; Manmohan Krishna,0,0,0,0
1668292805038,CSE 290,B00,102400,Vaccaro; Kristen Marie,0,0,25,25
1668292805038,CSE 290,C00,102414,Pannuto; Patrick William,0,0,25,25
1668292805038,CSE 290,D00,102427,Pevzner; Pavel Arkadjevich,0,0,0,0
1668292805038,CSE 290,E00,102429,Zhao; Jishen,0,0,0,0
1668292805038,CSE 290,F00,102436,Tullsen; Dean Michael,0,0,0,0
1668292805038,CSE 290,G00,102440,Christensen; Henrik I,0,0,20,20
1668292805466,CSE 291,A00,102443,Su; Hao,0,0,0,0
1668292805466,CSE 291,B00,102448,Polikarpova; Nadezhda,0,0,0,0
1668292805466,CSE 291,C00,102453,Vaccaro; Kristen Marie,0,0,0,0
1668292805466,CSE 291,D00,111343,Savage; Stefan,0,0,0,0
1668292805466,CSE 291,E00,116474,Claffy; Kimberly Claire,0,0,0,0
1668292805466,CSE 291,F00,116479,Pasquale; Joseph,0,0,0,0
1668292805893,CSE 293,001,119111,Bafna; Vineet,9999,0,9999,0
1668292805893,CSE 293,002,119118,Bellare; Mihir,9999,0,9999,0
1668292805893,CSE 293,003,119122,Berg-Kirkpatrick; Taylor D,9999,0,9999,0
1668292805893,CSE 293,004,119135,Christensen; Henrik I,9999,0,9999,0
1668292805893,CSE 293,005,119142,Cottrell; Garrison W,9999,0,9999,0
1668292805893,CSE 293,006,119146,Deutsch; Alin Bernard,9999,0,9999,0
1668292805893,CSE 293,007,119159,Esmaeilzadeh; Hadi,9999,0,9999,0
1668292805893,CSE 293,008,119166,Freund; Yoav,9999,0,9999,0
1668292805893,CSE 293,009,119170,Griswold; William G.,9999,0,9999,0
1668292805893,CSE 293,010,119183,Gymrek; Melissa Ann,9999,0,9999,0
1668292805893,CSE 293,011,119190,Heninger; Nadia A,9999,0,9999,0
1668292805893,CSE 293,012,119230,Impagliazzo; Russell,9999,0,9999,0
1668292805893,CSE 293,013,119232,Jhala; Ranjit,9999,0,9999,0
1668292805893,CSE 293,014,119233,Kahng; Andrew Byun,9999,0,9999,0
1668292805893,CSE 293,015,119298,Kane; Daniel Mertz,9999,0,9999,0
1668292805893,CSE 293,016,119299,Kriegman; David J,9999,0,9999,0
1668292805893,CSE 293,017,119300,Kumar; Arun Kumar,9999,0,9999,0
1668292805893,CSE 293,018,119301,Lerner; Sorin,9999,0,9999,0
1668292805893,CSE 293,019,119302,Lovett; Shachar,9999,0,9999,0
1668292805893,CSE 293,020,119303,McAuley; Julian John,9999,0,9999,0
1668292805893,CSE 293,021,119304,Micciancio; Daniele,9999,0,9999,0
1668292805893,CSE 293,022,119367,Orailoglu; Alex,9999,0,9999,0
1668292805893,CSE 293,023,119382,Paturi; Ramamohan,9999,0,9999,0
1668292805893,CSE 293,024,119404,Polikarpova; Nadezhda,9999,0,9999,0
1668292805893,CSE 293,025,119406,Politz; Joseph Gibbs,9999,0,9999,0
1668292805893,CSE 293,026,119411,Porter; George M,9999,0,9999,0
1668292805893,CSE 293,027,119414,Porter; Leonard Emerson,9999,0,9999,0
1668292805893,CSE 293,028,119416,Ramamoorthi; Ravi,9999,0,9999,0
1668292805893,CSE 293,029,119417,Sahoo; Debashis,9999,0,9999,0
1668292805893,CSE 293,030,119420,Saul; Lawrence,9999,0,9999,0
1668292805893,CSE 293,031,119421,Savage; Stefan,9999,0,9999,0
1668292805893,CSE 293,032,119425,Schulze; Jurgen P.,9999,0,9999,0
1668292805893,CSE 293,033,119426,Snoeren; Alex C.,9999,0,9999,0
1668292805893,CSE 293,034,119428,Shang; Jingbo,9999,0,9999,0
1668292805893,CSE 293,035,119430,Stefan; Deian,9999,0,9999,0
1668292805893,CSE 293,036,119431,Su; Hao,9999,0,9999,0
1668292805893,CSE 293,037,119433,Swanson; Steven James,9999,0,9999,0
1668292805893,CSE 293,038,119435,Tullsen; Dean Michael,9999,0,9999,0
1668292805893,CSE 293,039,119483,Voelker; Geoffrey M.,9999,0,9999,0
1668292805893,CSE 293,040,119537,Zhao; Jishen,9999,0,9999,0
1668292805893,CSE 293,041,119538,Zhou; Yuan-Yuan,9999,0,9999,0
1668292805893,CSE 293,042,119539,Gao; Sicun,9999,0,9999,0
1668292805893,CSE 293,043,119540,Weibel; Nadir,9999,0,9999,0
1668292805893,CSE 293,044,119541,Gupta; Rajesh K.,9999,0,9999,0
1668292805893,CSE 293,045,126410,Vaccaro; Kristen Marie,9999,0,9999,0
1668292805893,CSE 293,046,126411,Klemke; Richard,9999,0,9999,0
1668292806316,CSE 294,A00,102459,Voelker; Geoffrey M.,0,0,0,0
1668292806316,CSE 294,B00,111322,Orailoglu; Alex,0,0,0,0
1668292806742,DSE 201,A00,096914,Deutsch; Alin Bernard,30,0,30,0
1668292807166,DSE 210,A00,096915,Dasgupta; Sanjoy,30,0,30,0
1668292807599,DSE 260A,A00,096916,Altintas De Callaf; Ilkay,30,0,30,0
1668292808025,ECE 200,001,103586,Antipa; Nicholas A,9999,0,9999,0
1668292808025,ECE 200,002,103587,Atanasov; Nikolay A.,9999,0,9999,0
1668292808025,ECE 200,003,103588,Bharadia; Dinesh,9999,0,9999,0
1668292808025,ECE 200,004,103589,Cheng; Chung Kuan,9999,0,9999,0
1668292808025,ECE 200,005,103590,Cosman; Pamela C.,9999,0,9999,0
1668292808025,ECE 200,006,103591,Dayeh; Shadi Ahmad,9999,0,9999,0
1668292808025,ECE 200,007,103592,Fainman; Yeshaiahu,9999,0,9999,0
1668292808025,ECE 200,008,103593,Ford; Joseph Earl,9999,0,9999,0
1668292808025,ECE 200,009,103594,Franceschetti; Massimo,9999,0,9999,0
1668292808025,ECE 200,010,103595,Fullerton; Eric E,9999,0,9999,0
1668292808025,ECE 200,011,103596,Galton; Ian A,9999,0,9999,0
1668292808025,ECE 200,012,103597,Gilja; Vikash,9999,0,9999,0
1668292808025,ECE 200,013,103598,Hall; Drew A.,9999,0,9999,0
1668292808025,ECE 200,014,103599,Hsueh; Tzu-Chien,9999,0,9999,0
1668292808025,ECE 200,015,103600,Javidi; Tara,9999,0,9999,0
1668292808025,ECE 200,016,103601,Kahng; Andrew Byun,9999,0,9999,0
1668292808025,ECE 200,017,103602,Kim; Young-Han,9999,0,9999,0
1668292808025,ECE 200,018,103603,Koushanfar; Farinaz,9999,0,9999,0
1668292808025,ECE 200,019,103604,Kuzum; Duygu,9999,0,9999,0
1668292808025,ECE 200,020,103605,Le; Hanh-Phuc,9999,0,9999,0
1668292808025,ECE 200,021,103606,Lin; Bill,9999,0,9999,0
1668292808025,ECE 200,022,103607,Liu; Zhaowei,9998,0,9999,1
1668292808025,ECE 200,023,103608,Lo; Yu-Hwa,9999,0,9999,0
1668292808025,ECE 200,024,103609,Lomakin; Vitaliy,9999,0,9999,0
1668292808025,ECE 200,025,103610,Mercier; Patrick Philip,9999,0,9999,0
1668292808025,ECE 200,026,103611,Meyer; Florian,9999,0,9999,0
1668292808025,ECE 200,027,103612,Milstein; Laurence B.,9999,0,9999,0
1668292808025,ECE 200,028,103613,Mir Arabbaygi; Siavash,9999,0,9999,0
1668292808025,ECE 200,029,103614,Mookherjea; Shayan,9999,0,9999,0
1668292808025,ECE 200,030,103615,Morris; Karcher William,9999,0,9999,0
1668292808025,ECE 200,031,103616,Ng; Tse Nga,9999,0,9999,0
1668292808025,ECE 200,032,103617,Nguyen; Truong Quang,9999,0,9999,0
1668292808025,ECE 200,033,103618,Nomura; Kenji,9999,0,9999,0
1668292808025,ECE 200,034,103619,Orlitsky; Alon,9999,0,9999,0
1668292808025,ECE 200,035,103620,Pal; Piya,9999,0,9999,0
1668292808025,ECE 200,036,103621,Papen; George C.,9999,0,9999,0
1668292808025,ECE 200,037,103622,Radic; Stojan,9999,0,9999,0
1668292808025,ECE 200,038,103623,Rao; Bhaskar D.,9999,0,9999,0
1668292808025,ECE 200,039,103624,Rao; Ramesh R,9999,0,9999,0
1668292808025,ECE 200,040,103625,Rebeiz; Gabriel,9999,0,9999,0
1668292808025,ECE 200,041,103626,Sanford; John R,9999,0,9999,0
1668292808025,ECE 200,042,103627,Siegel; Paul H.,9999,0,9999,0
1668292808025,ECE 200,043,103628,Sievenpiper; Daniel F.,9999,0,9999,0
1668292808025,ECE 200,044,103629,Sworder; David D.,9999,0,9999,0
1668292808025,ECE 200,045,103630,Taur; Yuan,9999,0,9999,0
1668292808025,ECE 200,046,103631,Touri; Behrouz,9999,0,9999,0
1668292808025,ECE 200,047,103632,Trivedi; Mohan M.,9999,0,9999,0
1668292808025,ECE 200,048,103633,Vasconcelos; Nuno,9999,0,9999,0
1668292808025,ECE 200,049,103634,Wang; Xiaolong,9999,0,9999,0
1668292808025,ECE 200,050,103635,Xie; Pengtao,9999,0,9999,0
1668292808025,ECE 200,051,103636,Yip; Michael,9999,0,9999,0
1668292808025,ECE 200,052,103637,Zeger; Kenneth A.,999,0,999,0
1668292808025,ECE 200,053,103638,Zhang; Xinyu,9999,0,9999,0
1668292808025,ECE 200,054,103639,Turakhia; Yatish Girish,9999,0,9999,0
1668292808025,ECE 200,055,103640,Kang; Mingu,9999,0,9999,0
1668292808025,ECE 200,056,103641,Shi; Yuanyuan,9999,0,9999,0
1668292808025,ECE 200,057,103642,Wang; Edward Jay,9999,0,9999,0
1668292808025,ECE 200,058,103643,Zheng; Yang,9999,0,9999,0
1668292808449,ECE 202,A00,103644,Kuzum; Duygu,0,0,0,0
1668292808874,ECE 212BN,A00,103646,Ng; Tse Nga,0,0,0,0
1668292809298,ECE 221,A00,111493,Staff,0,0,0,0
1668292809721,ECE 222B,A00,103647,Lomakin; Vitaliy,0,0,0,0
1668292810145,ECE 230B,A00,103648,Taur; Yuan,0,0,0,0
1668292810569,ECE 238B,A00,103649,Garay; Javier,0,0,0,0
1668292810993,ECE 240B,A00,112900,Fainman; Yeshaiahu,0,0,0,0
1668292811425,ECE 247A,A00,103650,Jokerst; Jesse Vincent,0,0,0,0
1668292811851,ECE 247B,A00,103651,Wang; Joseph,0,0,0,0
1668292812274,ECE 250,A00,103652,Siegel; Paul H.,0,0,0,0
1668292812701,ECE 251A,A00,103654,Rao; Bhaskar D.,0,0,0,0
1668292813127,ECE 257B,A00,103655,Bharadia; Dinesh,0,0,0,0
1668292813551,ECE 258A,A00,103656,Milstein; Laurence B.,0,0,0,0
1668292813973,ECE 260B,A00,103658,Kang; Mingu,0,0,0,0
1668292814400,ECE 264A,A00,103659,Galton; Ian A,0,0,0,0
1668292814823,ECE 265A,A00,103661,Gudem; Prasad S.S.,0,0,0,0
1668292815250,ECE 265D,A00,103662,Gudem; Prasad S.S.,0,0,0,0
1668292815679,ECE 268,A00,103663,Koushanfar; Farinaz,0,0,0,0
1668292816103,ECE 269,A01,103665,Pal; Piya,0,0,0,0
1668292816526,ECE 271B,A00,103666,Vasconcelos; Manuela,0,0,0,0
1668292816953,ECE 276A,A00,103667,Atanasov; Nikolay A.,0,0,0,0
1668292817376,ECE 277,A00,103668,An; Cheolhong,0,0,0,0
1668292817809,ECE 279,A00,117947,Hall; Drew A.,0,0,0,0
1668292818670,ECE 283,A00,103670,Hsueh; Tzu-Chien,0,0,0,0
1668292819098,ECE 284,A00,103671,Turakhia; Yatish Girish,0,0,0,0
1668292819521,ECE 285,A00,103672,Zheng; Yang,0,0,0,0
1668292819521,ECE 285,B00,103673,Sworder; David D.,0,0,0,0
1668292819948,ECE 287,A00,103676,Javidi; Tara,0,0,0,0
1668292820374,MATH 200B,A00,098023,Salehi Golsefidy; Alireza,12,0,15,3
1668292820798,MATH 202B,A00,098024,Rhoades; Brendon Patrick,9,0,15,6
1668292821224,MATH 203B,A00,098025,Oprea; Dragos N.,10,0,15,5
1668292821653,MATH 204B,A00,098026,Sorensen; Claus M,13,0,15,2
1668292822079,MATH 208,A00,098027,Izadi; Elham,7,0,10,3
1668292822508,MATH 209,A00,098028,Pollack; Aaron,10,0,10,0
1668292822932,MATH 211A,A00,112919,Rogalski; Daniel,9,0,10,1
1668292823357,MATH 211B,A00,112920,Seward; Brandon M.,9,0,10,1
1668292823791,MATH 218,A00,098029,Li; Bo,10,0,10,0
1668292824217,MATH 220B,A00,098030,Novak; Jonathan I,11,0,15,4
1668292824640,MATH 221A,A00,098031,Ebenfelt; Peter F,13,0,15,2
1668292825063,MATH 231B,A00,098032,Zlatos; Andrej,12,0,15,3
1668292825491,MATH 240B,A00,098033,Ni; Lei,9,0,15,6
1668292825916,MATH 243,A00,098034,Jekel; David Andrew,10,0,10,0
1668292826338,MATH 245A,A00,098035,Nie; Jiawang,0,0,15,16
1668292826765,MATH 248,A00,098036,Bejenaru; Ioan,10,0,10,0
1668292827188,MATH 250B,A00,098037,Spolaor; Luca,14,0,15,1
1668292827611,MATH 258,A00,098038,Ni; Lei,10,0,10,0
1668292828035,MATH 264B,A00,098041,Rhoades; Brendon Patrick,9,0,15,6
1668292828466,MATH 268,A00,098042,Buss; Samuel R,10,0,10,0
1668292828891,MATH 269,A00,098043,Rhoades; Brendon Patrick,10,0,10,0
1668292829316,MATH 270B,A00,098044,Li; Bo,10,0,15,5
1668292829739,MATH 272B,A00,098045,Holst; Michael J,13,0,15,2
1668292830163,MATH 273A,A00,098046,Tian; Xiaochuan,10,0,15,5
1668292830588,MATH 275,A01,098048,Tian; Xiaochuan,6,0,10,4
1668292831013,MATH 278A,A00,098049,Holst; Michael J,8,0,10,2
1668292831438,MATH 278B,A00,098050,Cloninger; Alexander,10,0,10,0
1668292831865,MATH 278C,A00,098051,Nie; Jiawang,7,0,10,3
1668292832287,MATH 280B,A00,098052,Zheng; Tianyi,8,0,15,7
1668292832711,MATH 281B,A00,098053,Bradic; Jelena,1,0,15,14
1668292833137,MATH 282B,A00,098054,Arias-Castro; Ery,0,0,15,15
1668292833568,MATH 285,A00,098055,Fitzsimmons; Patrick J,0,0,15,17
1668292833994,MATH 287B,A00,098056,Arias-Castro; Ery,2,0,15,13
1668292834417,MATH 288,A00,098057,Agarwal; Pooja,9,0,10,1
1668292834417,MATH 288,B00,098058,Zhang; Danna,8,0,10,2
1668292834417,MATH 288,C00,098059,Williams; Ruth J,9,0,10,1
1668292834845,MATH 290B,A00,098060,Roberts; Justin Deritter,13,0,15,2
1668292835269,MATH 292,A00,098061,Belmont; Eva Kinoshita,10,0,10,0
1668292835696,MATH 295,A00,098062,Suk; Andrew Hoon,48,0,50,2
1668292836119,MATH 296,A00,098063,Novak; Jonathan I,20,0,20,0
1668292836546,MATH 297,001,098064,Gamst; Anthony Collins,9997,0,9999,2
1668293335453,COGS 205,A00,101395,Chiba; Andrea,19,0,20,1
1668293335876,COGS 210B,001,101404,Greene; Deanna Jacquelyn,9998,0,9999,1
1668293335876,COGS 210B,002,101417,Xia; Haijun,9999,0,9999,0
1668293335876,COGS 210B,003,101422,Nitz; Douglas A.,9999,0,9999,0
1668293335876,COGS 210B,004,101423,Hollan; James D.,9998,0,9999,1
1668293335876,COGS 210B,005,101424,Deak; Gedeon O.,9998,0,9999,1
1668293335876,COGS 210B,006,101425,Rossano; Federico,9999,0,9999,0
1668293336300,COGS 211B,A00,101427,Coulson; Seana M,9996,0,9999,3
1668293336725,COGS 220,A00,101428,Hollan; James D.,0,0,25,25
1668293337150,COGS 229,A00,101429,Dow; Steven P,18,0,25,7
1668293337572,COGS 230,A00,101430,Klemmer; Scott R,12,0,17,5
1668293337998,COGS 234,A00,101431,Xia; Haijun,1,0,25,24
1668293338423,COGS 260,A00,101432,Kiyonaga; Anastasia,21,0,25,4
1668293338423,COGS 260,B00,101433,Kirsh; David Joel,15,0,25,10
1668293338848,CSE 202,A00,102371,Impagliazzo; Russell,0,0,0,0
1668293339273,CSE 203B,A01,102373,Cheng; Chung Kuan,0,0,0,0
1668293339696,CSE 208,A00,102374,Micciancio; Daniele,0,0,0,0
1668293340119,CSE 209A,A00,112895,Impagliazzo; Russell,0,0,15,15
1668293340540,CSE 209B,A00,108005,Bellare; Mihir,0,0,0,0
1668293340965,CSE 210,A00,113163,Coblenz; Michael J,0,0,0,0
1668293341390,CSE 219,A00,106111,Dow; Steven P,0,0,20,20
1668293341814,CSE 221,A00,102376,Voelker; Geoffrey M.,0,0,0,0
1668293342241,CSE 224,A01,102378,Porter; George M,0,0,0,0
1668293342664,CSE 229A,A00,102379,Savage; Stefan,0,0,0,0
1668293343088,CSE 229C,A00,102380,Munyaka; Imani N. S.,0,0,0,0
1668293343509,CSE 232B,A00,102382,Deutsch; Alin Bernard,0,0,0,0
1668293343937,CSE 234,A01,112904,Kumar; Arun Kumar,0,0,0,0
1668293344364,CSE 237A,A00,102383,Rosing; Tajana Simunic,0,0,0,0
1668293344788,CSE 239A,A00,102384,Deutsch; Alin Bernard,0,0,0,0
1668293345214,CSE 239B,A00,102385,Polikarpova; Nadezhda,0,0,0,0
1668293345641,CSE 240A,A00,102386,Pannuto; Patrick William,0,0,0,0
1668293346066,CSE 240B,A00,102387,Zhao; Jishen,0,0,0,0
1668293346490,CSE 241A,A00,106406,Kang; Mingu,0,0,0,0
1668293346918,CSE 249B,A00,102388,Kahng; Andrew Byun,0,0,8,8
1668293347342,CSE 251B,A01,102392,Cottrell; Garrison W,0,0,0,0
1668293347342,CSE 251B,A02,102393,Cottrell; Garrison W,0,0,0,0
1668293347768,CSE 252B,A00,102394,Ochoa; Benjamin Lawrence,0,0,0,0
1668293348195,CSE 257,A01,102396,Gao; Sicun,0,0,0,0
1668293348620,CSE 272,A00,102397,Li; Tzumao,0,0,0,0
1668293349044,CSE 274,A00,111323,Chern; Albert Ren-Haur,0,0,0,0
1668293349470,CSE 282,A00,102398,Pevzner; Pavel Arkadjevich,0,0,0,0
1668293349896,CSE 284,A00,114175,Gymrek; Melissa Ann,0,0,0,0
1668293350320,CSE 290,A00,102399,Chandraker; Manmohan Krishna,0,0,0,0
1668293350320,CSE 290,B00,102400,Vaccaro; Kristen Marie,0,0,25,25
1668293350320,CSE 290,C00,102414,Pannuto; Patrick William,0,0,25,25
1668293350320,CSE 290,D00,102427,Pevzner; Pavel Arkadjevich,0,0,0,0
1668293350320,CSE 290,E00,102429,Zhao; Jishen,0,0,0,0
1668293350320,CSE 290,F00,102436,Tullsen; Dean Michael,0,0,0,0
1668293350320,CSE 290,G00,102440,Christensen; Henrik I,0,0,20,20
1668293350744,CSE 291,A00,102443,Su; Hao,0,0,0,0
1668293350744,CSE 291,B00,102448,Polikarpova; Nadezhda,0,0,0,0
1668293350744,CSE 291,C00,102453,Vaccaro; Kristen Marie,0,0,0,0
1668293350744,CSE 291,D00,111343,Savage; Stefan,0,0,0,0
1668293350744,CSE 291,E00,116474,Claffy; Kimberly Claire,0,0,0,0
1668293350744,CSE 291,F00,116479,Pasquale; Joseph,0,0,0,0
1668293351176,CSE 293,001,119111,Bafna; Vineet,9999,0,9999,0
1668293351176,CSE 293,002,119118,Bellare; Mihir,9999,0,9999,0
1668293351176,CSE 293,003,119122,Berg-Kirkpatrick; Taylor D,9999,0,9999,0
1668293351176,CSE 293,004,119135,Christensen; Henrik I,9999,0,9999,0
1668293351176,CSE 293,005,119142,Cottrell; Garrison W,9999,0,9999,0
1668293351176,CSE 293,006,119146,Deutsch; Alin Bernard,9999,0,9999,0
1668293351176,CSE 293,007,119159,Esmaeilzadeh; Hadi,9999,0,9999,0
1668293351176,CSE 293,008,119166,Freund; Yoav,9999,0,9999,0
1668293351176,CSE 293,009,119170,Griswold; William G.,9999,0,9999,0
1668293351176,CSE 293,010,119183,Gymrek; Melissa Ann,9999,0,9999,0
1668293351176,CSE 293,011,119190,Heninger; Nadia A,9999,0,9999,0
1668293351176,CSE 293,012,119230,Impagliazzo; Russell,9999,0,9999,0
1668293351176,CSE 293,013,119232,Jhala; Ranjit,9999,0,9999,0
1668293351176,CSE 293,014,119233,Kahng; Andrew Byun,9999,0,9999,0
1668293351176,CSE 293,015,119298,Kane; Daniel Mertz,9999,0,9999,0
1668293351176,CSE 293,016,119299,Kriegman; David J,9999,0,9999,0
1668293351176,CSE 293,017,119300,Kumar; Arun Kumar,9999,0,9999,0
1668293351176,CSE 293,018,119301,Lerner; Sorin,9999,0,9999,0
1668293351176,CSE 293,019,119302,Lovett; Shachar,9999,0,9999,0
1668293351176,CSE 293,020,119303,McAuley; Julian John,9999,0,9999,0
1668293351176,CSE 293,021,119304,Micciancio; Daniele,9999,0,9999,0
1668293351176,CSE 293,022,119367,Orailoglu; Alex,9999,0,9999,0
1668293351176,CSE 293,023,119382,Paturi; Ramamohan,9999,0,9999,0
1668293351176,CSE 293,024,119404,Polikarpova; Nadezhda,9999,0,9999,0
1668293351176,CSE 293,025,119406,Politz; Joseph Gibbs,9999,0,9999,0
1668293351176,CSE 293,026,119411,Porter; George M,9999,0,9999,0
1668293351176,CSE 293,027,119414,Porter; Leonard Emerson,9999,0,9999,0
1668293351176,CSE 293,028,119416,Ramamoorthi; Ravi,9999,0,9999,0
1668293351176,CSE 293,029,119417,Sahoo; Debashis,9999,0,9999,0
1668293351176,CSE 293,030,119420,Saul; Lawrence,9999,0,9999,0
1668293351176,CSE 293,031,119421,Savage; Stefan,9999,0,9999,0
1668293351176,CSE 293,032,119425,Schulze; Jurgen P.,9999,0,9999,0
1668293351176,CSE 293,033,119426,Snoeren; Alex C.,9999,0,9999,0
1668293351176,CSE 293,034,119428,Shang; Jingbo,9999,0,9999,0
1668293351176,CSE 293,035,119430,Stefan; Deian,9999,0,9999,0
1668293351176,CSE 293,036,119431,Su; Hao,9999,0,9999,0
1668293351176,CSE 293,037,119433,Swanson; Steven James,9999,0,9999,0
1668293351176,CSE 293,038,119435,Tullsen; Dean Michael,9999,0,9999,0
1668293351176,CSE 293,039,119483,Voelker; Geoffrey M.,9999,0,9999,0
1668293351176,CSE 293,040,119537,Zhao; Jishen,9999,0,9999,0
1668293351176,CSE 293,041,119538,Zhou; Yuan-Yuan,9999,0,9999,0
1668293351176,CSE 293,042,119539,Gao; Sicun,9999,0,9999,0
1668293351176,CSE 293,043,119540,Weibel; Nadir,9999,0,9999,0
1668293351176,CSE 293,044,119541,Gupta; Rajesh K.,9999,0,9999,0
1668293351176,CSE 293,045,126410,Vaccaro; Kristen Marie,9999,0,9999,0
1668293351176,CSE 293,046,126411,Klemke; Richard,9999,0,9999,0
1668293351601,CSE 294,A00,102459,Voelker; Geoffrey M.,0,0,0,0
1668293351601,CSE 294,B00,111322,Orailoglu; Alex,0,0,0,0
1668293352026,DSE 201,A00,096914,Deutsch; Alin Bernard,30,0,30,0
1668293352454,DSE 210,A00,096915,Dasgupta; Sanjoy,30,0,30,0
1668293352878,DSE 260A,A00,096916,Altintas De Callaf; Ilkay,30,0,30,0
1668293353315,ECE 200,001,103586,Antipa; Nicholas A,9999,0,9999,0
1668293353315,ECE 200,002,103587,Atanasov; Nikolay A.,9999,0,9999,0
1668293353315,ECE 200,003,103588,Bharadia; Dinesh,9999,0,9999,0
1668293353315,ECE 200,004,103589,Cheng; Chung Kuan,9999,0,9999,0
1668293353315,ECE 200,005,103590,Cosman; Pamela C.,9999,0,9999,0
1668293353315,ECE 200,006,103591,Dayeh; Shadi Ahmad,9999,0,9999,0
1668293353315,ECE 200,007,103592,Fainman; Yeshaiahu,9999,0,9999,0
1668293353315,ECE 200,008,103593,Ford; Joseph Earl,9999,0,9999,0
1668293353315,ECE 200,009,103594,Franceschetti; Massimo,9999,0,9999,0
1668293353315,ECE 200,010,103595,Fullerton; Eric E,9999,0,9999,0
1668293353315,ECE 200,011,103596,Galton; Ian A,9999,0,9999,0
1668293353315,ECE 200,012,103597,Gilja; Vikash,9999,0,9999,0
1668293353315,ECE 200,013,103598,Hall; Drew A.,9999,0,9999,0
1668293353315,ECE 200,014,103599,Hsueh; Tzu-Chien,9999,0,9999,0
1668293353315,ECE 200,015,103600,Javidi; Tara,9999,0,9999,0
1668293353315,ECE 200,016,103601,Kahng; Andrew Byun,9999,0,9999,0
1668293353315,ECE 200,017,103602,Kim; Young-Han,9999,0,9999,0
1668293353315,ECE 200,018,103603,Koushanfar; Farinaz,9999,0,9999,0
1668293353315,ECE 200,019,103604,Kuzum; Duygu,9999,0,9999,0
1668293353315,ECE 200,020,103605,Le; Hanh-Phuc,9999,0,9999,0
1668293353315,ECE 200,021,103606,Lin; Bill,9999,0,9999,0
1668293353315,ECE 200,022,103607,Liu; Zhaowei,9998,0,9999,1
1668293353315,ECE 200,023,103608,Lo; Yu-Hwa,9999,0,9999,0
1668293353315,ECE 200,024,103609,Lomakin; Vitaliy,9999,0,9999,0
1668293353315,ECE 200,025,103610,Mercier; Patrick Philip,9999,0,9999,0
1668293353315,ECE 200,026,103611,Meyer; Florian,9999,0,9999,0
1668293353315,ECE 200,027,103612,Milstein; Laurence B.,9999,0,9999,0
1668293353315,ECE 200,028,103613,Mir Arabbaygi; Siavash,9999,0,9999,0
1668293353315,ECE 200,029,103614,Mookherjea; Shayan,9999,0,9999,0
1668293353315,ECE 200,030,103615,Morris; Karcher William,9999,0,9999,0
1668293353315,ECE 200,031,103616,Ng; Tse Nga,9999,0,9999,0
1668293353315,ECE 200,032,103617,Nguyen; Truong Quang,9999,0,9999,0
1668293353315,ECE 200,033,103618,Nomura; Kenji,9999,0,9999,0
1668293353315,ECE 200,034,103619,Orlitsky; Alon,9999,0,9999,0
1668293353315,ECE 200,035,103620,Pal; Piya,9999,0,9999,0
1668293353315,ECE 200,036,103621,Papen; George C.,9999,0,9999,0
1668293353315,ECE 200,037,103622,Radic; Stojan,9999,0,9999,0
1668293353315,ECE 200,038,103623,Rao; Bhaskar D.,9999,0,9999,0
1668293353315,ECE 200,039,103624,Rao; Ramesh R,9999,0,9999,0
1668293353315,ECE 200,040,103625,Rebeiz; Gabriel,9999,0,9999,0
1668293353315,ECE 200,041,103626,Sanford; John R,9999,0,9999,0
1668293353315,ECE 200,042,103627,Siegel; Paul H.,9999,0,9999,0
1668293353315,ECE 200,043,103628,Sievenpiper; Daniel F.,9999,0,9999,0
1668293353315,ECE 200,044,103629,Sworder; David D.,9999,0,9999,0
1668293353315,ECE 200,045,103630,Taur; Yuan,9999,0,9999,0
1668293353315,ECE 200,046,103631,Touri; Behrouz,9999,0,9999,0
1668293353315,ECE 200,047,103632,Trivedi; Mohan M.,9999,0,9999,0
1668293353315,ECE 200,048,103633,Vasconcelos; Nuno,9999,0,9999,0
1668293353315,ECE 200,049,103634,Wang; Xiaolong,9999,0,9999,0
1668293353315,ECE 200,050,103635,Xie; Pengtao,9999,0,9999,0
1668293353315,ECE 200,051,103636,Yip; Michael,9999,0,9999,0
1668293353315,ECE 200,052,103637,Zeger; Kenneth A.,999,0,999,0
1668293353315,ECE 200,053,103638,Zhang; Xinyu,9999,0,9999,0
1668293353315,ECE 200,054,103639,Turakhia; Yatish Girish,9999,0,9999,0
1668293353315,ECE 200,055,103640,Kang; Mingu,9999,0,9999,0
1668293353315,ECE 200,056,103641,Shi; Yuanyuan,9999,0,9999,0
1668293353315,ECE 200,057,103642,Wang; Edward Jay,9999,0,9999,0
1668293353315,ECE 200,058,103643,Zheng; Yang,9999,0,9999,0
1668293353741,ECE 202,A00,103644,Kuzum; Duygu,0,0,0,0
1668293354164,ECE 212BN,A00,103646,Ng; Tse Nga,0,0,0,0
1668293354588,ECE 221,A00,111493,Staff,0,0,0,0
1668293355011,ECE 222B,A00,103647,Lomakin; Vitaliy,0,0,0,0
1668293355436,ECE 230B,A00,103648,Taur; Yuan,0,0,0,0
1668293355858,ECE 238B,A00,103649,Garay; Javier,0,0,0,0
1668293356284,ECE 240B,A00,112900,Fainman; Yeshaiahu,0,0,0,0
1668293356707,ECE 247A,A00,103650,Jokerst; Jesse Vincent,0,0,0,0
1668293357130,ECE 247B,A00,103651,Wang; Joseph,0,0,0,0
1668293357553,ECE 250,A00,103652,Siegel; Paul H.,0,0,0,0
1668293357979,ECE 251A,A00,103654,Rao; Bhaskar D.,0,0,0,0
1668293358402,ECE 257B,A00,103655,Bharadia; Dinesh,0,0,0,0
1668293358828,ECE 258A,A00,103656,Milstein; Laurence B.,0,0,0,0
1668293359252,ECE 260B,A00,103658,Kang; Mingu,0,0,0,0
1668293359678,ECE 264A,A00,103659,Galton; Ian A,0,0,0,0
1668293360101,ECE 265A,A00,103661,Gudem; Prasad S.S.,0,0,0,0
1668293360537,ECE 265D,A00,103662,Gudem; Prasad S.S.,0,0,0,0
1668293360965,ECE 268,A00,103663,Koushanfar; Farinaz,0,0,0,0
1668293361388,ECE 269,A01,103665,Pal; Piya,0,0,0,0
1668293361815,ECE 271B,A00,103666,Vasconcelos; Manuela,0,0,0,0
1668293362238,ECE 276A,A00,103667,Atanasov; Nikolay A.,0,0,0,0
1668293362665,ECE 277,A00,103668,An; Cheolhong,0,0,0,0
1668293363088,ECE 279,A00,117947,Hall; Drew A.,0,0,0,0
1668293363938,ECE 283,A00,103670,Hsueh; Tzu-Chien,0,0,0,0
1668293364361,ECE 284,A00,103671,Turakhia; Yatish Girish,0,0,0,0
1668293364787,ECE 285,A00,103672,Zheng; Yang,0,0,0,0
1668293364787,ECE 285,B00,103673,Sworder; David D.,0,0,0,0
1668293365212,ECE 287,A00,103676,Javidi; Tara,0,0,0,0
1668293365713,MATH 200B,A00,098023,Salehi Golsefidy; Alireza,12,0,15,3
1668293366139,MATH 202B,A00,098024,Rhoades; Brendon Patrick,9,0,15,6
1668293366565,MATH 203B,A00,098025,Oprea; Dragos N.,10,0,15,5
1668293366991,MATH 204B,A00,098026,Sorensen; Claus M,13,0,15,2
1668293367414,MATH 208,A00,098027,Izadi; Elham,7,0,10,3
1668293367839,MATH 209,A00,098028,Pollack; Aaron,10,0,10,0
1668293368265,MATH 211A,A00,112919,Rogalski; Daniel,9,0,10,1
1668293368692,MATH 211B,A00,112920,Seward; Brandon M.,9,0,10,1
1668293369116,MATH 218,A00,098029,Li; Bo,10,0,10,0
1668293369541,MATH 220B,A00,098030,Novak; Jonathan I,11,0,15,4
1668293369965,MATH 221A,A00,098031,Ebenfelt; Peter F,13,0,15,2
1668293370393,MATH 231B,A00,098032,Zlatos; Andrej,12,0,15,3
1668293370815,MATH 240B,A00,098033,Ni; Lei,9,0,15,6
1668293371246,MATH 243,A00,098034,Jekel; David Andrew,10,0,10,0
1668293371669,MATH 245A,A00,098035,Nie; Jiawang,0,0,15,16
1668293372093,MATH 248,A00,098036,Bejenaru; Ioan,10,0,10,0
1668293372520,MATH 250B,A00,098037,Spolaor; Luca,14,0,15,1
1668293372942,MATH 258,A00,098038,Ni; Lei,10,0,10,0
1668293373367,MATH 264B,A00,098041,Rhoades; Brendon Patrick,9,0,15,6
1668293373795,MATH 268,A00,098042,Buss; Samuel R,10,0,10,0
1668293374218,MATH 269,A00,098043,Rhoades; Brendon Patrick,10,0,10,0
1668293374640,MATH 270B,A00,098044,Li; Bo,10,0,15,5
1668293375064,MATH 272B,A00,098045,Holst; Michael J,13,0,15,2
1668293375489,MATH 273A,A00,098046,Tian; Xiaochuan,10,0,15,5
1668293375913,MATH 275,A01,098048,Tian; Xiaochuan,6,0,10,4
1668293376342,MATH 278A,A00,098049,Holst; Michael J,8,0,10,2
1668293376770,MATH 278B,A00,098050,Cloninger; Alexander,10,0,10,0
1668293377193,MATH 278C,A00,098051,Nie; Jiawang,7,0,10,3
1668293377622,MATH 280B,A00,098052,Zheng; Tianyi,8,0,15,7
1668293378047,MATH 281B,A00,098053,Bradic; Jelena,1,0,15,14
1668293378475,MATH 282B,A00,098054,Arias-Castro; Ery,0,0,15,15
1668293378904,MATH 285,A00,098055,Fitzsimmons; Patrick J,0,0,15,17
1668293379327,MATH 287B,A00,098056,Arias-Castro; Ery,2,0,15,13
1668293379751,MATH 288,A00,098057,Agarwal; Pooja,9,0,10,1
1668293379751,MATH 288,B00,098058,Zhang; Danna,8,0,10,2
1668293379751,MATH 288,C00,098059,Williams; Ruth J,9,0,10,1
1668293380174,MATH 290B,A00,098060,Roberts; Justin Deritter,13,0,15,2
1668293380609,MATH 292,A00,098061,Belmont; Eva Kinoshita,10,0,10,0
1668293381034,MATH 295,A00,098062,Suk; Andrew Hoon,48,0,50,2
1668293381466,MATH 296,A00,098063,Novak; Jonathan I,20,0,20,0
1668293381891,MATH 297,001,098064,Gamst; Anthony Collins,9997,0,9999,2
1668293880650,COGS 205,A00,101395,Chiba; Andrea,19,0,20,1
1668293881078,COGS 210B,001,101404,Greene; Deanna Jacquelyn,9998,0,9999,1
1668293881078,COGS 210B,002,101417,Xia; Haijun,9999,0,9999,0
1668293881078,COGS 210B,003,101422,Nitz; Douglas A.,9999,0,9999,0
1668293881078,COGS 210B,004,101423,Hollan; James D.,9998,0,9999,1
1668293881078,COGS 210B,005,101424,Deak; Gedeon O.,9998,0,9999,1
1668293881078,COGS 210B,006,101425,Rossano; Federico,9999,0,9999,0
1668293881503,COGS 211B,A00,101427,Coulson; Seana M,9996,0,9999,3
1668293881927,COGS 220,A00,101428,Hollan; James D.,0,0,25,25
1668293882350,COGS 229,A00,101429,Dow; Steven P,18,0,25,7
1668293882774,COGS 230,A00,101430,Klemmer; Scott R,12,0,17,5
1668293883197,COGS 234,A00,101431,Xia; Haijun,1,0,25,24
1668293883622,COGS 260,A00,101432,Kiyonaga; Anastasia,21,0,25,4
1668293883622,COGS 260,B00,101433,Kirsh; David Joel,15,0,25,10
1668293884056,CSE 202,A00,102371,Impagliazzo; Russell,0,0,0,0
1668293884573,CSE 203B,A01,102373,Cheng; Chung Kuan,0,0,0,0
1668293884996,CSE 208,A00,102374,Micciancio; Daniele,0,0,0,0
1668293885422,CSE 209A,A00,112895,Impagliazzo; Russell,0,0,15,15
1668293885852,CSE 209B,A00,108005,Bellare; Mihir,0,0,0,0
1668293886281,CSE 210,A00,113163,Coblenz; Michael J,0,0,0,0
1668293886706,CSE 219,A00,106111,Dow; Steven P,0,0,20,20
1668293887129,CSE 221,A00,102376,Voelker; Geoffrey M.,0,0,0,0
1668293887557,CSE 224,A01,102378,Porter; George M,0,0,0,0
1668293887984,CSE 229A,A00,102379,Savage; Stefan,0,0,0,0
1668293888407,CSE 229C,A00,102380,Munyaka; Imani N. S.,0,0,0,0
1668293888831,CSE 232B,A00,102382,Deutsch; Alin Bernard,0,0,0,0
1668293889258,CSE 234,A01,112904,Kumar; Arun Kumar,0,0,0,0
1668293889687,CSE 237A,A00,102383,Rosing; Tajana Simunic,0,0,0,0
1668293890112,CSE 239A,A00,102384,Deutsch; Alin Bernard,0,0,0,0
1668293890534,CSE 239B,A00,102385,Polikarpova; Nadezhda,0,0,0,0
1668293890966,CSE 240A,A00,102386,Pannuto; Patrick William,0,0,0,0
1668293891391,CSE 240B,A00,102387,Zhao; Jishen,0,0,0,0
1668293891813,CSE 241A,A00,106406,Kang; Mingu,0,0,0,0
1668293892237,CSE 249B,A00,102388,Kahng; Andrew Byun,0,0,8,8
1668293892660,CSE 251B,A01,102392,Cottrell; Garrison W,0,0,0,0
1668293892660,CSE 251B,A02,102393,Cottrell; Garrison W,0,0,0,0
1668293893085,CSE 252B,A00,102394,Ochoa; Benjamin Lawrence,0,0,0,0
1668293893510,CSE 257,A01,102396,Gao; Sicun,0,0,0,0
1668293893934,CSE 272,A00,102397,Li; Tzumao,0,0,0,0
1668293894360,CSE 274,A00,111323,Chern; Albert Ren-Haur,0,0,0,0
1668293894784,CSE 282,A00,102398,Pevzner; Pavel Arkadjevich,0,0,0,0
1668293895206,CSE 284,A00,114175,Gymrek; Melissa Ann,0,0,0,0
1668293895634,CSE 290,A00,102399,Chandraker; Manmohan Krishna,0,0,0,0
1668293895634,CSE 290,B00,102400,Vaccaro; Kristen Marie,0,0,25,25
1668293895634,CSE 290,C00,102414,Pannuto; Patrick William,0,0,25,25
1668293895634,CSE 290,D00,102427,Pevzner; Pavel Arkadjevich,0,0,0,0
1668293895634,CSE 290,E00,102429,Zhao; Jishen,0,0,0,0
1668293895634,CSE 290,F00,102436,Tullsen; Dean Michael,0,0,0,0
1668293895634,CSE 290,G00,102440,Christensen; Henrik I,0,0,20,20
1668293896066,CSE 291,A00,102443,Su; Hao,0,0,0,0
1668293896066,CSE 291,B00,102448,Polikarpova; Nadezhda,0,0,0,0
1668293896066,CSE 291,C00,102453,Vaccaro; Kristen Marie,0,0,0,0
1668293896066,CSE 291,D00,111343,Savage; Stefan,0,0,0,0
1668293896066,CSE 291,E00,116474,Claffy; Kimberly Claire,0,0,0,0
1668293896066,CSE 291,F00,116479,Pasquale; Joseph,0,0,0,0
1668293896493,CSE 293,001,119111,Bafna; Vineet,9999,0,9999,0
1668293896493,CSE 293,002,119118,Bellare; Mihir,9999,0,9999,0
1668293896493,CSE 293,003,119122,Berg-Kirkpatrick; Taylor D,9999,0,9999,0
1668293896493,CSE 293,004,119135,Christensen; Henrik I,9999,0,9999,0
1668293896493,CSE 293,005,119142,Cottrell; Garrison W,9999,0,9999,0
1668293896493,CSE 293,006,119146,Deutsch; Alin Bernard,9999,0,9999,0
1668293896493,CSE 293,007,119159,Esmaeilzadeh; Hadi,9999,0,9999,0
1668293896493,CSE 293,008,119166,Freund; Yoav,9999,0,9999,0
1668293896493,CSE 293,009,119170,Griswold; William G.,9999,0,9999,0
1668293896493,CSE 293,010,119183,Gymrek; Melissa Ann,9999,0,9999,0
1668293896493,CSE 293,011,119190,Heninger; Nadia A,9999,0,9999,0
1668293896493,CSE 293,012,119230,Impagliazzo; Russell,9999,0,9999,0
1668293896493,CSE 293,013,119232,Jhala; Ranjit,9999,0,9999,0
1668293896493,CSE 293,014,119233,Kahng; Andrew Byun,9999,0,9999,0
1668293896493,CSE 293,015,119298,Kane; Daniel Mertz,9999,0,9999,0
1668293896493,CSE 293,016,119299,Kriegman; David J,9999,0,9999,0
1668293896493,CSE 293,017,119300,Kumar; Arun Kumar,9999,0,9999,0
1668293896493,CSE 293,018,119301,Lerner; Sorin,9999,0,9999,0
1668293896493,CSE 293,019,119302,Lovett; Shachar,9999,0,9999,0
1668293896493,CSE 293,020,119303,McAuley; Julian John,9999,0,9999,0
1668293896493,CSE 293,021,119304,Micciancio; Daniele,9999,0,9999,0
1668293896493,CSE 293,022,119367,Orailoglu; Alex,9999,0,9999,0
1668293896493,CSE 293,023,119382,Paturi; Ramamohan,9999,0,9999,0
1668293896493,CSE 293,024,119404,Polikarpova; Nadezhda,9999,0,9999,0
1668293896493,CSE 293,025,119406,Politz; Joseph Gibbs,9999,0,9999,0
1668293896493,CSE 293,026,119411,Porter; George M,9999,0,9999,0
1668293896493,CSE 293,027,119414,Porter; Leonard Emerson,9999,0,9999,0
1668293896493,CSE 293,028,119416,Ramamoorthi; Ravi,9999,0,9999,0
1668293896493,CSE 293,029,119417,Sahoo; Debashis,9999,0,9999,0
1668293896493,CSE 293,030,119420,Saul; Lawrence,9999,0,9999,0
1668293896493,CSE 293,031,119421,Savage; Stefan,9999,0,9999,0
1668293896493,CSE 293,032,119425,Schulze; Jurgen P.,9999,0,9999,0
1668293896493,CSE 293,033,119426,Snoeren; Alex C.,9999,0,9999,0
1668293896493,CSE 293,034,119428,Shang; Jingbo,9999,0,9999,0
1668293896493,CSE 293,035,119430,Stefan; Deian,9999,0,9999,0
1668293896493,CSE 293,036,119431,Su; Hao,9999,0,9999,0
1668293896493,CSE 293,037,119433,Swanson; Steven James,9999,0,9999,0
1668293896493,CSE 293,038,119435,Tullsen; Dean Michael,9999,0,9999,0
1668293896493,CSE 293,039,119483,Voelker; Geoffrey M.,9999,0,9999,0
1668293896493,CSE 293,040,119537,Zhao; Jishen,9999,0,9999,0
1668293896493,CSE 293,041,119538,Zhou; Yuan-Yuan,9999,0,9999,0
1668293896493,CSE 293,042,119539,Gao; Sicun,9999,0,9999,0
1668293896493,CSE 293,043,119540,Weibel; Nadir,9999,0,9999,0
1668293896493,CSE 293,044,119541,Gupta; Rajesh K.,9999,0,9999,0
1668293896493,CSE 293,045,126410,Vaccaro; Kristen Marie,9999,0,9999,0
1668293896493,CSE 293,046,126411,Klemke; Richard,9999,0,9999,0
1668293896916,CSE 294,A00,102459,Voelker; Geoffrey M.,0,0,0,0
1668293896916,CSE 294,B00,111322,Orailoglu; Alex,0,0,0,0
1668293897341,DSE 201,A00,096914,Deutsch; Alin Bernard,30,0,30,0
1668293897763,DSE 210,A00,096915,Dasgupta; Sanjoy,30,0,30,0
1668293898189,DSE 260A,A00,096916,Altintas De Callaf; Ilkay,30,0,30,0
1668293898617,ECE 200,001,103586,Antipa; Nicholas A,9999,0,9999,0
1668293898617,ECE 200,002,103587,Atanasov; Nikolay A.,9999,0,9999,0
1668293898617,ECE 200,003,103588,Bharadia; Dinesh,9999,0,9999,0
1668293898617,ECE 200,004,103589,Cheng; Chung Kuan,9999,0,9999,0
1668293898617,ECE 200,005,103590,Cosman; Pamela C.,9999,0,9999,0
1668293898617,ECE 200,006,103591,Dayeh; Shadi Ahmad,9999,0,9999,0
1668293898617,ECE 200,007,103592,Fainman; Yeshaiahu,9999,0,9999,0
1668293898617,ECE 200,008,103593,Ford; Joseph Earl,9999,0,9999,0
1668293898617,ECE 200,009,103594,Franceschetti; Massimo,9999,0,9999,0
1668293898617,ECE 200,010,103595,Fullerton; Eric E,9999,0,9999,0
1668293898617,ECE 200,011,103596,Galton; Ian A,9999,0,9999,0
1668293898617,ECE 200,012,103597,Gilja; Vikash,9999,0,9999,0
1668293898617,ECE 200,013,103598,Hall; Drew A.,9999,0,9999,0
1668293898617,ECE 200,014,103599,Hsueh; Tzu-Chien,9999,0,9999,0
1668293898617,ECE 200,015,103600,Javidi; Tara,9999,0,9999,0
1668293898617,ECE 200,016,103601,Kahng; Andrew Byun,9999,0,9999,0
1668293898617,ECE 200,017,103602,Kim; Young-Han,9999,0,9999,0
1668293898617,ECE 200,018,103603,Koushanfar; Farinaz,9999,0,9999,0
1668293898617,ECE 200,019,103604,Kuzum; Duygu,9999,0,9999,0
1668293898617,ECE 200,020,103605,Le; Hanh-Phuc,9999,0,9999,0
1668293898617,ECE 200,021,103606,Lin; Bill,9999,0,9999,0
1668293898617,ECE 200,022,103607,Liu; Zhaowei,9998,0,9999,1
1668293898617,ECE 200,023,103608,Lo; Yu-Hwa,9999,0,9999,0
1668293898617,ECE 200,024,103609,Lomakin; Vitaliy,9999,0,9999,0
1668293898617,ECE 200,025,103610,Mercier; Patrick Philip,9999,0,9999,0
1668293898617,ECE 200,026,103611,Meyer; Florian,9999,0,9999,0
1668293898617,ECE 200,027,103612,Milstein; Laurence B.,9999,0,9999,0
1668293898617,ECE 200,028,103613,Mir Arabbaygi; Siavash,9999,0,9999,0
1668293898617,ECE 200,029,103614,Mookherjea; Shayan,9999,0,9999,0
1668293898617,ECE 200,030,103615,Morris; Karcher William,9999,0,9999,0
1668293898617,ECE 200,031,103616,Ng; Tse Nga,9999,0,9999,0
1668293898617,ECE 200,032,103617,Nguyen; Truong Quang,9999,0,9999,0
1668293898617,ECE 200,033,103618,Nomura; Kenji,9999,0,9999,0
1668293898617,ECE 200,034,103619,Orlitsky; Alon,9999,0,9999,0
1668293898617,ECE 200,035,103620,Pal; Piya,9999,0,9999,0
1668293898617,ECE 200,036,103621,Papen; George C.,9999,0,9999,0
1668293898617,ECE 200,037,103622,Radic; Stojan,9999,0,9999,0
1668293898617,ECE 200,038,103623,Rao; Bhaskar D.,9999,0,9999,0
1668293898617,ECE 200,039,103624,Rao; Ramesh R,9999,0,9999,0
1668293898617,ECE 200,040,103625,Rebeiz; Gabriel,9999,0,9999,0
1668293898617,ECE 200,041,103626,Sanford; John R,9999,0,9999,0
1668293898617,ECE 200,042,103627,Siegel; Paul H.,9999,0,9999,0
1668293898617,ECE 200,043,103628,Sievenpiper; Daniel F.,9999,0,9999,0
1668293898617,ECE 200,044,103629,Sworder; David D.,9999,0,9999,0
1668293898617,ECE 200,045,103630,Taur; Yuan,9999,0,9999,0
1668293898617,ECE 200,046,103631,Touri; Behrouz,9999,0,9999,0
1668293898617,ECE 200,047,103632,Trivedi; Mohan M.,9999,0,9999,0
1668293898617,ECE 200,048,103633,Vasconcelos; Nuno,9999,0,9999,0
1668293898617,ECE 200,049,103634,Wang; Xiaolong,9999,0,9999,0
1668293898617,ECE 200,050,103635,Xie; Pengtao,9999,0,9999,0
1668293898617,ECE 200,051,103636,Yip; Michael,9999,0,9999,0
1668293898617,ECE 200,052,103637,Zeger; Kenneth A.,999,0,999,0
1668293898617,ECE 200,053,103638,Zhang; Xinyu,9999,0,9999,0
1668293898617,ECE 200,054,103639,Turakhia; Yatish Girish,9999,0,9999,0
1668293898617,ECE 200,055,103640,Kang; Mingu,9999,0,9999,0
1668293898617,ECE 200,056,103641,Shi; Yuanyuan,9999,0,9999,0
1668293898617,ECE 200,057,103642,Wang; Edward Jay,9999,0,9999,0
1668293898617,ECE 200,058,103643,Zheng; Yang,9999,0,9999,0
1668293899040,ECE 202,A00,103644,Kuzum; Duygu,0,0,0,0
1668293899478,ECE 212BN,A00,103646,Ng; Tse Nga,0,0,0,0
1668293899902,ECE 221,A00,111493,Staff,0,0,0,0
1668293900336,ECE 222B,A00,103647,Lomakin; Vitaliy,0,0,0,0
1668293900766,ECE 230B,A00,103648,Taur; Yuan,0,0,0,0
1668293901189,ECE 238B,A00,103649,Garay; Javier,0,0,0,0
1668293901612,ECE 240B,A00,112900,Fainman; Yeshaiahu,0,0,0,0
1668293902038,ECE 247A,A00,103650,Jokerst; Jesse Vincent,0,0,0,0
1668293902463,ECE 247B,A00,103651,Wang; Joseph,0,0,0,0
1668293902886,ECE 250,A00,103652,Siegel; Paul H.,0,0,0,0
1668293903319,ECE 251A,A00,103654,Rao; Bhaskar D.,0,0,0,0
1668293903741,ECE 257B,A00,103655,Bharadia; Dinesh,0,0,0,0
1668293904169,ECE 258A,A00,103656,Milstein; Laurence B.,0,0,0,0
1668293904591,ECE 260B,A00,103658,Kang; Mingu,0,0,0,0
1668293905021,ECE 264A,A00,103659,Galton; Ian A,0,0,0,0
1668293905445,ECE 265A,A00,103661,Gudem; Prasad S.S.,0,0,0,0
1668293905871,ECE 265D,A00,103662,Gudem; Prasad S.S.,0,0,0,0
1668293906293,ECE 268,A00,103663,Koushanfar; Farinaz,0,0,0,0
1668293906717,ECE 269,A01,103665,Pal; Piya,0,0,0,0
1668293907148,ECE 271B,A00,103666,Vasconcelos; Manuela,0,0,0,0
1668293907570,ECE 276A,A00,103667,Atanasov; Nikolay A.,0,0,0,0
1668293908001,ECE 277,A00,103668,An; Cheolhong,0,0,0,0
1668293908424,ECE 279,A00,117947,Hall; Drew A.,0,0,0,0
1668293909269,ECE 283,A00,103670,Hsueh; Tzu-Chien,0,0,0,0
1668293909693,ECE 284,A00,103671,Turakhia; Yatish Girish,0,0,0,0
1668293910116,ECE 285,A00,103672,Zheng; Yang,0,0,0,0
1668293910116,ECE 285,B00,103673,Sworder; David D.,0,0,0,0
1668293910549,ECE 287,A00,103676,Javidi; Tara,0,0,0,0
1668293910972,MATH 200B,A00,098023,Salehi Golsefidy; Alireza,12,0,15,3
1668293911397,MATH 202B,A00,098024,Rhoades; Brendon Patrick,9,0,15,6
1668293911822,MATH 203B,A00,098025,Oprea; Dragos N.,10,0,15,5
1668293912252,MATH 204B,A00,098026,Sorensen; Claus M,13,0,15,2
1668293912680,MATH 208,A00,098027,Izadi; Elham,7,0,10,3
1668293913104,MATH 209,A00,098028,Pollack; Aaron,10,0,10,0
1668293913528,MATH 211A,A00,112919,Rogalski; Daniel,9,0,10,1
1668293913956,MATH 211B,A00,112920,Seward; Brandon M.,9,0,10,1
1668293914391,MATH 218,A00,098029,Li; Bo,10,0,10,0
1668293914815,MATH 220B,A00,098030,Novak; Jonathan I,11,0,15,4
1668293915242,MATH 221A,A00,098031,Ebenfelt; Peter F,13,0,15,2
1668293915668,MATH 231B,A00,098032,Zlatos; Andrej,12,0,15,3
1668293916091,MATH 240B,A00,098033,Ni; Lei,9,0,15,6
1668293916517,MATH 243,A00,098034,Jekel; David Andrew,10,0,10,0
1668293916940,MATH 245A,A00,098035,Nie; Jiawang,0,0,15,16
1668293917367,MATH 248,A00,098036,Bejenaru; Ioan,10,0,10,0
1668293917789,MATH 250B,A00,098037,Spolaor; Luca,14,0,15,1
1668293918214,MATH 258,A00,098038,Ni; Lei,10,0,10,0
1668293918640,MATH 264B,A00,098041,Rhoades; Brendon Patrick,9,0,15,6
1668293919064,MATH 268,A00,098042,Buss; Samuel R,10,0,10,0
1668293919488,MATH 269,A00,098043,Rhoades; Brendon Patrick,10,0,10,0
1668293919916,MATH 270B,A00,098044,Li; Bo,10,0,15,5
1668293920339,MATH 272B,A00,098045,Holst; Michael J,13,0,15,2
1668293920765,MATH 273A,A00,098046,Tian; Xiaochuan,10,0,15,5
1668293921192,MATH 275,A01,098048,Tian; Xiaochuan,6,0,10,4
1668293921616,MATH 278A,A00,098049,Holst; Michael J,8,0,10,2
1668293922047,MATH 278B,A00,098050,Cloninger; Alexander,10,0,10,0
1668293922471,MATH 278C,A00,098051,Nie; Jiawang,7,0,10,3
1668293922894,MATH 280B,A00,098052,Zheng; Tianyi,8,0,15,7
1668293923329,MATH 281B,A00,098053,Bradic; Jelena,1,0,15,14
1668293923751,MATH 282B,A00,098054,Arias-Castro; Ery,0,0,15,15
1668293924174,MATH 285,A00,098055,Fitzsimmons; Patrick J,0,0,15,17
1668293924598,MATH 287B,A00,098056,Arias-Castro; Ery,2,0,15,13
1668293925021,MATH 288,A00,098057,Agarwal; Pooja,9,0,10,1
1668293925021,MATH 288,B00,098058,Zhang; Danna,8,0,10,2
1668293925021,MATH 288,C00,098059,Williams; Ruth J,9,0,10,1
1668293925448,MATH 290B,A00,098060,Roberts; Justin Deritter,13,0,15,2
1668293925871,MATH 292,A00,098061,Belmont; Eva Kinoshita,10,0,10,0
1668293926294,MATH 295,A00,098062,Suk; Andrew Hoon,48,0,50,2
1668293926720,MATH 296,A00,098063,Novak; Jonathan I,20,0,20,0
1668293927142,MATH 297,001,098064,Gamst; Anthony Collins,9997,0,9999,2
1668294425853,COGS 205,A00,101395,Chiba; Andrea,19,0,20,1
1668294426289,COGS 210B,001,101404,Greene; Deanna Jacquelyn,9998,0,9999,1
1668294426289,COGS 210B,002,101417,Xia; Haijun,9999,0,9999,0
1668294426289,COGS 210B,003,101422,Nitz; Douglas A.,9999,0,9999,0
1668294426289,COGS 210B,004,101423,Hollan; James D.,9998,0,9999,1
1668294426289,COGS 210B,005,101424,Deak; Gedeon O.,9998,0,9999,1
1668294426289,COGS 210B,006,101425,Rossano; Federico,9999,0,9999,0
1668294426711,COGS 211B,A00,101427,Coulson; Seana M,9996,0,9999,3
1668294427134,COGS 220,A00,101428,Hollan; James D.,0,0,25,25
1668294427559,COGS 229,A00,101429,Dow; Steven P,18,0,25,7
1668294427983,COGS 230,A00,101430,Klemmer; Scott R,12,0,17,5
1668294428410,COGS 234,A00,101431,Xia; Haijun,1,0,25,24
1668294428833,COGS 260,A00,101432,Kiyonaga; Anastasia,21,0,25,4
1668294428833,COGS 260,B00,101433,Kirsh; David Joel,15,0,25,10
1668294429259,CSE 202,A00,102371,Impagliazzo; Russell,0,0,0,0
1668294429688,CSE 203B,A01,102373,Cheng; Chung Kuan,0,0,0,0
1668294430115,CSE 208,A00,102374,Micciancio; Daniele,0,0,0,0
1668294430541,CSE 209A,A00,112895,Impagliazzo; Russell,0,0,15,15
1668294430965,CSE 209B,A00,108005,Bellare; Mihir,0,0,0,0
1668294431390,CSE 210,A00,113163,Coblenz; Michael J,0,0,0,0
1668294431814,CSE 219,A00,106111,Dow; Steven P,0,0,20,20
1668294432237,CSE 221,A00,102376,Voelker; Geoffrey M.,0,0,0,0
1668294432660,CSE 224,A01,102378,Porter; George M,0,0,0,0
1668294433090,CSE 229A,A00,102379,Savage; Stefan,0,0,0,0
1668294433516,CSE 229C,A00,102380,Munyaka; Imani N. S.,0,0,0,0
1668294433942,CSE 232B,A00,102382,Deutsch; Alin Bernard,0,0,0,0
1668294434375,CSE 234,A01,112904,Kumar; Arun Kumar,0,0,0,0
1668294434798,CSE 237A,A00,102383,Rosing; Tajana Simunic,0,0,0,0
1668294435222,CSE 239A,A00,102384,Deutsch; Alin Bernard,0,0,0,0
1668294435644,CSE 239B,A00,102385,Polikarpova; Nadezhda,0,0,0,0
1668294436069,CSE 240A,A00,102386,Pannuto; Patrick William,0,0,0,0
1668294436495,CSE 240B,A00,102387,Zhao; Jishen,0,0,0,0
1668294436921,CSE 241A,A00,106406,Kang; Mingu,0,0,0,0
1668294437348,CSE 249B,A00,102388,Kahng; Andrew Byun,0,0,8,8
1668294437782,CSE 251B,A01,102392,Cottrell; Garrison W,0,0,0,0
1668294437782,CSE 251B,A02,102393,Cottrell; Garrison W,0,0,0,0
1668294438206,CSE 252B,A00,102394,Ochoa; Benjamin Lawrence,0,0,0,0
1668294438630,CSE 257,A01,102396,Gao; Sicun,0,0,0,0
1668294439061,CSE 272,A00,102397,Li; Tzumao,0,0,0,0
1668294439488,CSE 274,A00,111323,Chern; Albert Ren-Haur,0,0,0,0
1668294439916,CSE 282,A00,102398,Pevzner; Pavel Arkadjevich,0,0,0,0
1668294440345,CSE 284,A00,114175,Gymrek; Melissa Ann,0,0,0,0
1668294440770,CSE 290,A00,102399,Chandraker; Manmohan Krishna,0,0,0,0
1668294440770,CSE 290,B00,102400,Vaccaro; Kristen Marie,0,0,25,25
1668294440770,CSE 290,C00,102414,Pannuto; Patrick William,0,0,25,25
1668294440770,CSE 290,D00,102427,Pevzner; Pavel Arkadjevich,0,0,0,0
1668294440770,CSE 290,E00,102429,Zhao; Jishen,0,0,0,0
1668294440770,CSE 290,F00,102436,Tullsen; Dean Michael,0,0,0,0
1668294440770,CSE 290,G00,102440,Christensen; Henrik I,0,0,20,20
1668294441200,CSE 291,A00,102443,Su; Hao,0,0,0,0
1668294441200,CSE 291,B00,102448,Polikarpova; Nadezhda,0,0,0,0
1668294441200,CSE 291,C00,102453,Vaccaro; Kristen Marie,0,0,0,0
1668294441200,CSE 291,D00,111343,Savage; Stefan,0,0,0,0
1668294441200,CSE 291,E00,116474,Claffy; Kimberly Claire,0,0,0,0
1668294441200,CSE 291,F00,116479,Pasquale; Joseph,0,0,0,0
1668294441630,CSE 293,001,119111,Bafna; Vineet,9999,0,9999,0
1668294441630,CSE 293,002,119118,Bellare; Mihir,9999,0,9999,0
1668294441630,CSE 293,003,119122,Berg-Kirkpatrick; Taylor D,9999,0,9999,0
1668294441630,CSE 293,004,119135,Christensen; Henrik I,9999,0,9999,0
1668294441630,CSE 293,005,119142,Cottrell; Garrison W,9999,0,9999,0
1668294441630,CSE 293,006,119146,Deutsch; Alin Bernard,9999,0,9999,0
1668294441630,CSE 293,007,119159,Esmaeilzadeh; Hadi,9999,0,9999,0
1668294441630,CSE 293,008,119166,Freund; Yoav,9999,0,9999,0
1668294441630,CSE 293,009,119170,Griswold; William G.,9999,0,9999,0
1668294441630,CSE 293,010,119183,Gymrek; Melissa Ann,9999,0,9999,0
1668294441630,CSE 293,011,119190,Heninger; Nadia A,9999,0,9999,0
1668294441630,CSE 293,012,119230,Impagliazzo; Russell,9999,0,9999,0
1668294441630,CSE 293,013,119232,Jhala; Ranjit,9999,0,9999,0
1668294441630,CSE 293,014,119233,Kahng; Andrew Byun,9999,0,9999,0
1668294441630,CSE 293,015,119298,Kane; Daniel Mertz,9999,0,9999,0
1668294441630,CSE 293,016,119299,Kriegman; David J,9999,0,9999,0
1668294441630,CSE 293,017,119300,Kumar; Arun Kumar,9999,0,9999,0
1668294441630,CSE 293,018,119301,Lerner; Sorin,9999,0,9999,0
1668294441630,CSE 293,019,119302,Lovett; Shachar,9999,0,9999,0
1668294441630,CSE 293,020,119303,McAuley; Julian John,9999,0,9999,0
1668294441630,CSE 293,021,119304,Micciancio; Daniele,9999,0,9999,0
1668294441630,CSE 293,022,119367,Orailoglu; Alex,9999,0,9999,0
1668294441630,CSE 293,023,119382,Paturi; Ramamohan,9999,0,9999,0
1668294441630,CSE 293,024,119404,Polikarpova; Nadezhda,9999,0,9999,0
1668294441630,CSE 293,025,119406,Politz; Joseph Gibbs,9999,0,9999,0
1668294441630,CSE 293,026,119411,Porter; George M,9999,0,9999,0
1668294441630,CSE 293,027,119414,Porter; Leonard Emerson,9999,0,9999,0
1668294441630,CSE 293,028,119416,Ramamoorthi; Ravi,9999,0,9999,0
1668294441630,CSE 293,029,119417,Sahoo; Debashis,9999,0,9999,0
1668294441630,CSE 293,030,119420,Saul; Lawrence,9999,0,9999,0
1668294441630,CSE 293,031,119421,Savage; Stefan,9999,0,9999,0
1668294441630,CSE 293,032,119425,Schulze; Jurgen P.,9999,0,9999,0
1668294441630,CSE 293,033,119426,Snoeren; Alex C.,9999,0,9999,0
1668294441630,CSE 293,034,119428,Shang; Jingbo,9999,0,9999,0
1668294441630,CSE 293,035,119430,Stefan; Deian,9999,0,9999,0
1668294441630,CSE 293,036,119431,Su; Hao,9999,0,9999,0
1668294441630,CSE 293,037,119433,Swanson; Steven James,9999,0,9999,0
1668294441630,CSE 293,038,119435,Tullsen; Dean Michael,9999,0,9999,0
1668294441630,CSE 293,039,119483,Voelker; Geoffrey M.,9999,0,9999,0
1668294441630,CSE 293,040,119537,Zhao; Jishen,9999,0,9999,0
1668294441630,CSE 293,041,119538,Zhou; Yuan-Yuan,9999,0,9999,0
1668294441630,CSE 293,042,119539,Gao; Sicun,9999,0,9999,0
1668294441630,CSE 293,043,119540,Weibel; Nadir,9999,0,9999,0
1668294441630,CSE 293,044,119541,Gupta; Rajesh K.,9999,0,9999,0
1668294441630,CSE 293,045,126410,Vaccaro; Kristen Marie,9999,0,9999,0
1668294441630,CSE 293,046,126411,Klemke; Richard,9999,0,9999,0
1668294442055,CSE 294,A00,102459,Voelker; Geoffrey M.,0,0,0,0
1668294442055,CSE 294,B00,111322,Orailoglu; Alex,0,0,0,0
1668294442479,DSE 201,A00,096914,Deutsch; Alin Bernard,30,0,30,0
1668294442902,DSE 210,A00,096915,Dasgupta; Sanjoy,30,0,30,0
1668294443328,DSE 260A,A00,096916,Altintas De Callaf; Ilkay,30,0,30,0
1668294443765,ECE 200,001,103586,Antipa; Nicholas A,9999,0,9999,0
1668294443765,ECE 200,002,103587,Atanasov; Nikolay A.,9999,0,9999,0
1668294443765,ECE 200,003,103588,Bharadia; Dinesh,9999,0,9999,0
1668294443765,ECE 200,004,103589,Cheng; Chung Kuan,9999,0,9999,0
1668294443765,ECE 200,005,103590,Cosman; Pamela C.,9999,0,9999,0
1668294443765,ECE 200,006,103591,Dayeh; Shadi Ahmad,9999,0,9999,0
1668294443765,ECE 200,007,103592,Fainman; Yeshaiahu,9999,0,9999,0
1668294443765,ECE 200,008,103593,Ford; Joseph Earl,9999,0,9999,0
1668294443765,ECE 200,009,103594,Franceschetti; Massimo,9999,0,9999,0
1668294443765,ECE 200,010,103595,Fullerton; Eric E,9999,0,9999,0
1668294443765,ECE 200,011,103596,Galton; Ian A,9999,0,9999,0
1668294443765,ECE 200,012,103597,Gilja; Vikash,9999,0,9999,0
1668294443765,ECE 200,013,103598,Hall; Drew A.,9999,0,9999,0
1668294443765,ECE 200,014,103599,Hsueh; Tzu-Chien,9999,0,9999,0
1668294443765,ECE 200,015,103600,Javidi; Tara,9999,0,9999,0
1668294443765,ECE 200,016,103601,Kahng; Andrew Byun,9999,0,9999,0
1668294443765,ECE 200,017,103602,Kim; Young-Han,9999,0,9999,0
1668294443765,ECE 200,018,103603,Koushanfar; Farinaz,9999,0,9999,0
1668294443765,ECE 200,019,103604,Kuzum; Duygu,9999,0,9999,0
1668294443765,ECE 200,020,103605,Le; Hanh-Phuc,9999,0,9999,0
1668294443765,ECE 200,021,103606,Lin; Bill,9999,0,9999,0
1668294443765,ECE 200,022,103607,Liu; Zhaowei,9998,0,9999,1
1668294443765,ECE 200,023,103608,Lo; Yu-Hwa,9999,0,9999,0
1668294443765,ECE 200,024,103609,Lomakin; Vitaliy,9999,0,9999,0
1668294443765,ECE 200,025,103610,Mercier; Patrick Philip,9999,0,9999,0
1668294443765,ECE 200,026,103611,Meyer; Florian,9999,0,9999,0
1668294443765,ECE 200,027,103612,Milstein; Laurence B.,9999,0,9999,0
1668294443765,ECE 200,028,103613,Mir Arabbaygi; Siavash,9999,0,9999,0
1668294443765,ECE 200,029,103614,Mookherjea; Shayan,9999,0,9999,0
1668294443765,ECE 200,030,103615,Morris; Karcher William,9999,0,9999,0
1668294443765,ECE 200,031,103616,Ng; Tse Nga,9999,0,9999,0
1668294443765,ECE 200,032,103617,Nguyen; Truong Quang,9999,0,9999,0
1668294443765,ECE 200,033,103618,Nomura; Kenji,9999,0,9999,0
1668294443765,ECE 200,034,103619,Orlitsky; Alon,9999,0,9999,0
1668294443765,ECE 200,035,103620,Pal; Piya,9999,0,9999,0
1668294443765,ECE 200,036,103621,Papen; George C.,9999,0,9999,0
1668294443765,ECE 200,037,103622,Radic; Stojan,9999,0,9999,0
1668294443765,ECE 200,038,103623,Rao; Bhaskar D.,9999,0,9999,0
1668294443765,ECE 200,039,103624,Rao; Ramesh R,9999,0,9999,0
1668294443765,ECE 200,040,103625,Rebeiz; Gabriel,9999,0,9999,0
1668294443765,ECE 200,041,103626,Sanford; John R,9999,0,9999,0
1668294443765,ECE 200,042,103627,Siegel; Paul H.,9999,0,9999,0
1668294443765,ECE 200,043,103628,Sievenpiper; Daniel F.,9999,0,9999,0
1668294443765,ECE 200,044,103629,Sworder; David D.,9999,0,9999,0
1668294443765,ECE 200,045,103630,Taur; Yuan,9999,0,9999,0
1668294443765,ECE 200,046,103631,Touri; Behrouz,9999,0,9999,0
1668294443765,ECE 200,047,103632,Trivedi; Mohan M.,9999,0,9999,0
1668294443765,ECE 200,048,103633,Vasconcelos; Nuno,9999,0,9999,0
1668294443765,ECE 200,049,103634,Wang; Xiaolong,9999,0,9999,0
1668294443765,ECE 200,050,103635,Xie; Pengtao,9999,0,9999,0
1668294443765,ECE 200,051,103636,Yip; Michael,9999,0,9999,0
1668294443765,ECE 200,052,103637,Zeger; Kenneth A.,999,0,999,0
1668294443765,ECE 200,053,103638,Zhang; Xinyu,9999,0,9999,0
1668294443765,ECE 200,054,103639,Turakhia; Yatish Girish,9999,0,9999,0
1668294443765,ECE 200,055,103640,Kang; Mingu,9999,0,9999,0
1668294443765,ECE 200,056,103641,Shi; Yuanyuan,9999,0,9999,0
1668294443765,ECE 200,057,103642,Wang; Edward Jay,9999,0,9999,0
1668294443765,ECE 200,058,103643,Zheng; Yang,9999,0,9999,0
1668294444194,ECE 202,A00,103644,Kuzum; Duygu,0,0,0,0
1668294444618,ECE 212BN,A00,103646,Ng; Tse Nga,0,0,0,0
1668294445042,ECE 221,A00,111493,Staff,0,0,0,0
1668294445467,ECE 222B,A00,103647,Lomakin; Vitaliy,0,0,0,0
1668294445890,ECE 230B,A00,103648,Taur; Yuan,0,0,0,0
1668294446389,ECE 238B,A00,103649,Garay; Javier,0,0,0,0
1668294446823,ECE 240B,A00,112900,Fainman; Yeshaiahu,0,0,0,0
1668294447250,ECE 247A,A00,103650,Jokerst; Jesse Vincent,0,0,0,0
1668294447675,ECE 247B,A00,103651,Wang; Joseph,0,0,0,0
1668294448110,ECE 250,A00,103652,Siegel; Paul H.,0,0,0,0
1668294448534,ECE 251A,A00,103654,Rao; Bhaskar D.,0,0,0,0
1668294448959,ECE 257B,A00,103655,Bharadia; Dinesh,0,0,0,0
1668294449382,ECE 258A,A00,103656,Milstein; Laurence B.,0,0,0,0
1668294449812,ECE 260B,A00,103658,Kang; Mingu,0,0,0,0
1668294450240,ECE 264A,A00,103659,Galton; Ian A,0,0,0,0
1668294450666,ECE 265A,A00,103661,Gudem; Prasad S.S.,0,0,0,0
1668294451091,ECE 265D,A00,103662,Gudem; Prasad S.S.,0,0,0,0
1668294451519,ECE 268,A00,103663,Koushanfar; Farinaz,0,0,0,0
1668294451943,ECE 269,A01,103665,Pal; Piya,0,0,0,0
1668294452367,ECE 271B,A00,103666,Vasconcelos; Manuela,0,0,0,0
1668294452791,ECE 276A,A00,103667,Atanasov; Nikolay A.,0,0,0,0
1668294453215,ECE 277,A00,103668,An; Cheolhong,0,0,0,0
1668294453636,ECE 279,A00,117947,Hall; Drew A.,0,0,0,0
1668294454486,ECE 283,A00,103670,Hsueh; Tzu-Chien,0,0,0,0
1668294454911,ECE 284,A00,103671,Turakhia; Yatish Girish,0,0,0,0
1668294455334,ECE 285,A00,103672,Zheng; Yang,0,0,0,0
1668294455334,ECE 285,B00,103673,Sworder; David D.,0,0,0,0
1668294455758,ECE 287,A00,103676,Javidi; Tara,0,0,0,0
1668294456182,MATH 200B,A00,098023,Salehi Golsefidy; Alireza,12,0,15,3
1668294456613,MATH 202B,A00,098024,Rhoades; Brendon Patrick,9,0,15,6
1668294457038,MATH 203B,A00,098025,Oprea; Dragos N.,10,0,15,5
1668294457462,MATH 204B,A00,098026,Sorensen; Claus M,13,0,15,2
1668294457901,MATH 208,A00,098027,Izadi; Elham,7,0,10,3
1668294458327,MATH 209,A00,098028,Pollack; Aaron,10,0,10,0
1668294458752,MATH 211A,A00,112919,Rogalski; Daniel,9,0,10,1
1668294459176,MATH 211B,A00,112920,Seward; Brandon M.,9,0,10,1
1668294459601,MATH 218,A00,098029,Li; Bo,10,0,10,0
1668294460024,MATH 220B,A00,098030,Novak; Jonathan I,11,0,15,4
1668294460447,MATH 221A,A00,098031,Ebenfelt; Peter F,13,0,15,2
1668294460873,MATH 231B,A00,098032,Zlatos; Andrej,12,0,15,3
1668294461311,MATH 240B,A00,098033,Ni; Lei,9,0,15,6
1668294461737,MATH 243,A00,098034,Jekel; David Andrew,10,0,10,0
1668294462166,MATH 245A,A00,098035,Nie; Jiawang,0,0,15,16
1668294462591,MATH 248,A00,098036,Bejenaru; Ioan,10,0,10,0
1668294463017,MATH 250B,A00,098037,Spolaor; Luca,14,0,15,1
1668294463443,MATH 258,A00,098038,Ni; Lei,10,0,10,0
1668294463866,MATH 264B,A00,098041,Rhoades; Brendon Patrick,9,0,15,6
1668294464291,MATH 268,A00,098042,Buss; Samuel R,10,0,10,0
1668294464714,MATH 269,A00,098043,Rhoades; Brendon Patrick,10,0,10,0
1668294465143,MATH 270B,A00,098044,Li; Bo,10,0,15,5
1668294465566,MATH 272B,A00,098045,Holst; Michael J,13,0,15,2
1668294465998,MATH 273A,A00,098046,Tian; Xiaochuan,10,0,15,5
1668294466424,MATH 275,A01,098048,Tian; Xiaochuan,6,0,10,4
1668294466849,MATH 278A,A00,098049,Holst; Michael J,8,0,10,2
1668294467274,MATH 278B,A00,098050,Cloninger; Alexander,10,0,10,0
1668294467695,MATH 278C,A00,098051,Nie; Jiawang,7,0,10,3
1668294468118,MATH 280B,A00,098052,Zheng; Tianyi,8,0,15,7
1668294468540,MATH 281B,A00,098053,Bradic; Jelena,1,0,15,14
1668294468962,MATH 282B,A00,098054,Arias-Castro; Ery,0,0,15,15
1668294469384,MATH 285,A00,098055,Fitzsimmons; Patrick J,0,0,15,17
1668294469810,MATH 287B,A00,098056,Arias-Castro; Ery,2,0,15,13
1668294470233,MATH 288,A00,098057,Agarwal; Pooja,9,0,10,1
1668294470233,MATH 288,B00,098058,Zhang; Danna,8,0,10,2
1668294470233,MATH 288,C00,098059,Williams; Ruth J,9,0,10,1
1668294470658,MATH 290B,A00,098060,Roberts; Justin Deritter,13,0,15,2
1668294471084,MATH 292,A00,098061,Belmont; Eva Kinoshita,10,0,10,0
1668294471506,MATH 295,A00,098062,Suk; Andrew Hoon,48,0,50,2
1668294471930,MATH 296,A00,098063,Novak; Jonathan I,20,0,20,0
1668294472352,MATH 297,001,098064,Gamst; Anthony Collins,9997,0,9999,2
1668294970837,COGS 205,A00,101395,Chiba; Andrea,19,0,20,1
1668294971266,COGS 210B,001,101404,Greene; Deanna Jacquelyn,9998,0,9999,1
1668294971266,COGS 210B,002,101417,Xia; Haijun,9999,0,9999,0
1668294971266,COGS 210B,003,101422,Nitz; Douglas A.,9999,0,9999,0
1668294971266,COGS 210B,004,101423,Hollan; James D.,9998,0,9999,1
1668294971266,COGS 210B,005,101424,Deak; Gedeon O.,9998,0,9999,1
1668294971266,COGS 210B,006,101425,Rossano; Federico,9999,0,9999,0
1668294971691,COGS 211B,A00,101427,Coulson; Seana M,9996,0,9999,3
1668294972113,COGS 220,A00,101428,Hollan; James D.,0,0,25,25
1668294972539,COGS 229,A00,101429,Dow; Steven P,18,0,25,7
1668294972962,COGS 230,A00,101430,Klemmer; Scott R,12,0,17,5
1668294973387,COGS 234,A00,101431,Xia; Haijun,1,0,25,24
1668294973812,COGS 260,A00,101432,Kiyonaga; Anastasia,21,0,25,4
1668294973812,COGS 260,B00,101433,Kirsh; David Joel,15,0,25,10
1668294974245,CSE 202,A00,102371,Impagliazzo; Russell,0,0,0,0
1668294974672,CSE 203B,A01,102373,Cheng; Chung Kuan,0,0,0,0
1668294975115,CSE 208,A00,102374,Micciancio; Daniele,0,0,0,0
1668294975538,CSE 209A,A00,112895,Impagliazzo; Russell,0,0,15,15
1668294975962,CSE 209B,A00,108005,Bellare; Mihir,0,0,0,0
1668294976384,CSE 210,A00,113163,Coblenz; Michael J,0,0,0,0
1668294976808,CSE 219,A00,106111,Dow; Steven P,0,0,20,20
1668294977234,CSE 221,A00,102376,Voelker; Geoffrey M.,0,0,0,0
1668294977656,CSE 224,A01,102378,Porter; George M,0,0,0,0
1668294978081,CSE 229A,A00,102379,Savage; Stefan,0,0,0,0
1668294978508,CSE 229C,A00,102380,Munyaka; Imani N. S.,0,0,0,0
1668294978931,CSE 232B,A00,102382,Deutsch; Alin Bernard,0,0,0,0
1668294979358,CSE 234,A01,112904,Kumar; Arun Kumar,0,0,0,0
1668294979786,CSE 237A,A00,102383,Rosing; Tajana Simunic,0,0,0,0
1668294980210,CSE 239A,A00,102384,Deutsch; Alin Bernard,0,0,0,0
1668294980634,CSE 239B,A00,102385,Polikarpova; Nadezhda,0,0,0,0
1668294981056,CSE 240A,A00,102386,Pannuto; Patrick William,0,0,0,0
1668294981479,CSE 240B,A00,102387,Zhao; Jishen,0,0,0,0
1668294981905,CSE 241A,A00,106406,Kang; Mingu,0,0,0,0
1668294982329,CSE 249B,A00,102388,Kahng; Andrew Byun,0,0,8,8
1668294982751,CSE 251B,A01,102392,Cottrell; Garrison W,0,0,0,0
1668294982751,CSE 251B,A02,102393,Cottrell; Garrison W,0,0,0,0
1668294983178,CSE 252B,A00,102394,Ochoa; Benjamin Lawrence,0,0,0,0
1668294983609,CSE 257,A01,102396,Gao; Sicun,0,0,0,0
1668294984033,CSE 272,A00,102397,Li; Tzumao,0,0,0,0
1668294984461,CSE 274,A00,111323,Chern; Albert Ren-Haur,0,0,0,0
1668294984885,CSE 282,A00,102398,Pevzner; Pavel Arkadjevich,0,0,0,0
1668294985311,CSE 284,A00,114175,Gymrek; Melissa Ann,0,0,0,0
1668294985738,CSE 290,A00,102399,Chandraker; Manmohan Krishna,0,0,0,0
1668294985738,CSE 290,B00,102400,Vaccaro; Kristen Marie,0,0,25,25
1668294985738,CSE 290,C00,102414,Pannuto; Patrick William,0,0,25,25
1668294985738,CSE 290,D00,102427,Pevzner; Pavel Arkadjevich,0,0,0,0
1668294985738,CSE 290,E00,102429,Zhao; Jishen,0,0,0,0
1668294985738,CSE 290,F00,102436,Tullsen; Dean Michael,0,0,0,0
1668294985738,CSE 290,G00,102440,Christensen; Henrik I,0,0,20,20
1668294986162,CSE 291,A00,102443,Su; Hao,0,0,0,0
1668294986162,CSE 291,B00,102448,Polikarpova; Nadezhda,0,0,0,0
1668294986162,CSE 291,C00,102453,Vaccaro; Kristen Marie,0,0,0,0
1668294986162,CSE 291,D00,111343,Savage; Stefan,0,0,0,0
1668294986162,CSE 291,E00,116474,Claffy; Kimberly Claire,0,0,0,0
1668294986162,CSE 291,F00,116479,Pasquale; Joseph,0,0,0,0
1668294986598,CSE 293,001,119111,Bafna; Vineet,9999,0,9999,0
1668294986598,CSE 293,002,119118,Bellare; Mihir,9999,0,9999,0
1668294986598,CSE 293,003,119122,Berg-Kirkpatrick; Taylor D,9999,0,9999,0
1668294986598,CSE 293,004,119135,Christensen; Henrik I,9999,0,9999,0
1668294986598,CSE 293,005,119142,Cottrell; Garrison W,9999,0,9999,0
1668294986598,CSE 293,006,119146,Deutsch; Alin Bernard,9999,0,9999,0
1668294986598,CSE 293,007,119159,Esmaeilzadeh; Hadi,9999,0,9999,0
1668294986598,CSE 293,008,119166,Freund; Yoav,9999,0,9999,0
1668294986598,CSE 293,009,119170,Griswold; William G.,9999,0,9999,0
1668294986598,CSE 293,010,119183,Gymrek; Melissa Ann,9999,0,9999,0
1668294986598,CSE 293,011,119190,Heninger; Nadia A,9999,0,9999,0
1668294986598,CSE 293,012,119230,Impagliazzo; Russell,9999,0,9999,0
1668294986598,CSE 293,013,119232,Jhala; Ranjit,9999,0,9999,0
1668294986598,CSE 293,014,119233,Kahng; Andrew Byun,9999,0,9999,0
1668294986598,CSE 293,015,119298,Kane; Daniel Mertz,9999,0,9999,0
1668294986598,CSE 293,016,119299,Kriegman; David J,9999,0,9999,0
1668294986598,CSE 293,017,119300,Kumar; Arun Kumar,9999,0,9999,0
1668294986598,CSE 293,018,119301,Lerner; Sorin,9999,0,9999,0
1668294986598,CSE 293,019,119302,Lovett; Shachar,9999,0,9999,0
1668294986598,CSE 293,020,119303,McAuley; Julian John,9999,0,9999,0
1668294986598,CSE 293,021,119304,Micciancio; Daniele,9999,0,9999,0
1668294986598,CSE 293,022,119367,Orailoglu; Alex,9999,0,9999,0
1668294986598,CSE 293,023,119382,Paturi; Ramamohan,9999,0,9999,0
1668294986598,CSE 293,024,119404,Polikarpova; Nadezhda,9999,0,9999,0
1668294986598,CSE 293,025,119406,Politz; Joseph Gibbs,9999,0,9999,0
1668294986598,CSE 293,026,119411,Porter; George M,9999,0,9999,0
1668294986598,CSE 293,027,119414,Porter; Leonard Emerson,9999,0,9999,0
1668294986598,CSE 293,028,119416,Ramamoorthi; Ravi,9999,0,9999,0
1668294986598,CSE 293,029,119417,Sahoo; Debashis,9999,0,9999,0
1668294986598,CSE 293,030,119420,Saul; Lawrence,9999,0,9999,0
1668294986598,CSE 293,031,119421,Savage; Stefan,9999,0,9999,0
1668294986598,CSE 293,032,119425,Schulze; Jurgen P.,9999,0,9999,0
1668294986598,CSE 293,033,119426,Snoeren; Alex C.,9999,0,9999,0
1668294986598,CSE 293,034,119428,Shang; Jingbo,9999,0,9999,0
1668294986598,CSE 293,035,119430,Stefan; Deian,9999,0,9999,0
1668294986598,CSE 293,036,119431,Su; Hao,9999,0,9999,0
1668294986598,CSE 293,037,119433,Swanson; Steven James,9999,0,9999,0
1668294986598,CSE 293,038,119435,Tullsen; Dean Michael,9999,0,9999,0
1668294986598,CSE 293,039,119483,Voelker; Geoffrey M.,9999,0,9999,0
1668294986598,CSE 293,040,119537,Zhao; Jishen,9999,0,9999,0
1668294986598,CSE 293,041,119538,Zhou; Yuan-Yuan,9999,0,9999,0
1668294986598,CSE 293,042,119539,Gao; Sicun,9999,0,9999,0
1668294986598,CSE 293,043,119540,Weibel; Nadir,9999,0,9999,0
1668294986598,CSE 293,044,119541,Gupta; Rajesh K.,9999,0,9999,0
1668294986598,CSE 293,045,126410,Vaccaro; Kristen Marie,9999,0,9999,0
1668294986598,CSE 293,046,126411,Klemke; Richard,9999,0,9999,0
1668294987022,CSE 294,A00,102459,Voelker; Geoffrey M.,0,0,0,0
1668294987022,CSE 294,B00,111322,Orailoglu; Alex,0,0,0,0
1668294987450,DSE 201,A00,096914,Deutsch; Alin Bernard,30,0,30,0
1668294987875,DSE 210,A00,096915,Dasgupta; Sanjoy,30,0,30,0
1668294988299,DSE 260A,A00,096916,Altintas De Callaf; Ilkay,30,0,30,0
1668294988738,ECE 200,001,103586,Antipa; Nicholas A,9999,0,9999,0
1668294988738,ECE 200,002,103587,Atanasov; Nikolay A.,9999,0,9999,0
1668294988738,ECE 200,003,103588,Bharadia; Dinesh,9999,0,9999,0
1668294988738,ECE 200,004,103589,Cheng; Chung Kuan,9999,0,9999,0
1668294988738,ECE 200,005,103590,Cosman; Pamela C.,9999,0,9999,0
1668294988738,ECE 200,006,103591,Dayeh; Shadi Ahmad,9999,0,9999,0
1668294988738,ECE 200,007,103592,Fainman; Yeshaiahu,9999,0,9999,0
1668294988738,ECE 200,008,103593,Ford; Joseph Earl,9999,0,9999,0
1668294988738,ECE 200,009,103594,Franceschetti; Massimo,9999,0,9999,0
1668294988738,ECE 200,010,103595,Fullerton; Eric E,9999,0,9999,0
1668294988738,ECE 200,011,103596,Galton; Ian A,9999,0,9999,0
1668294988738,ECE 200,012,103597,Gilja; Vikash,9999,0,9999,0
1668294988738,ECE 200,013,103598,Hall; Drew A.,9999,0,9999,0
1668294988738,ECE 200,014,103599,Hsueh; Tzu-Chien,9999,0,9999,0
1668294988738,ECE 200,015,103600,Javidi; Tara,9999,0,9999,0
1668294988738,ECE 200,016,103601,Kahng; Andrew Byun,9999,0,9999,0
1668294988738,ECE 200,017,103602,Kim; Young-Han,9999,0,9999,0
1668294988738,ECE 200,018,103603,Koushanfar; Farinaz,9999,0,9999,0
1668294988738,ECE 200,019,103604,Kuzum; Duygu,9999,0,9999,0
1668294988738,ECE 200,020,103605,Le; Hanh-Phuc,9999,0,9999,0
1668294988738,ECE 200,021,103606,Lin; Bill,9999,0,9999,0
1668294988738,ECE 200,022,103607,Liu; Zhaowei,9998,0,9999,1
1668294988738,ECE 200,023,103608,Lo; Yu-Hwa,9999,0,9999,0
1668294988738,ECE 200,024,103609,Lomakin; Vitaliy,9999,0,9999,0
1668294988738,ECE 200,025,103610,Mercier; Patrick Philip,9999,0,9999,0
1668294988738,ECE 200,026,103611,Meyer; Florian,9999,0,9999,0
1668294988738,ECE 200,027,103612,Milstein; Laurence B.,9999,0,9999,0
1668294988738,ECE 200,028,103613,Mir Arabbaygi; Siavash,9999,0,9999,0
1668294988738,ECE 200,029,103614,Mookherjea; Shayan,9999,0,9999,0
1668294988738,ECE 200,030,103615,Morris; Karcher William,9999,0,9999,0
1668294988738,ECE 200,031,103616,Ng; Tse Nga,9999,0,9999,0
1668294988738,ECE 200,032,103617,Nguyen; Truong Quang,9999,0,9999,0
1668294988738,ECE 200,033,103618,Nomura; Kenji,9999,0,9999,0
1668294988738,ECE 200,034,103619,Orlitsky; Alon,9999,0,9999,0
1668294988738,ECE 200,035,103620,Pal; Piya,9999,0,9999,0
1668294988738,ECE 200,036,103621,Papen; George C.,9999,0,9999,0
1668294988738,ECE 200,037,103622,Radic; Stojan,9999,0,9999,0
1668294988738,ECE 200,038,103623,Rao; Bhaskar D.,9999,0,9999,0
1668294988738,ECE 200,039,103624,Rao; Ramesh R,9999,0,9999,0
1668294988738,ECE 200,040,103625,Rebeiz; Gabriel,9999,0,9999,0
1668294988738,ECE 200,041,103626,Sanford; John R,9999,0,9999,0
1668294988738,ECE 200,042,103627,Siegel; Paul H.,9999,0,9999,0
1668294988738,ECE 200,043,103628,Sievenpiper; Daniel F.,9999,0,9999,0
1668294988738,ECE 200,044,103629,Sworder; David D.,9999,0,9999,0
1668294988738,ECE 200,045,103630,Taur; Yuan,9999,0,9999,0
1668294988738,ECE 200,046,103631,Touri; Behrouz,9999,0,9999,0
1668294988738,ECE 200,047,103632,Trivedi; Mohan M.,9999,0,9999,0
1668294988738,ECE 200,048,103633,Vasconcelos; Nuno,9999,0,9999,0
1668294988738,ECE 200,049,103634,Wang; Xiaolong,9999,0,9999,0
1668294988738,ECE 200,050,103635,Xie; Pengtao,9999,0,9999,0
1668294988738,ECE 200,051,103636,Yip; Michael,9999,0,9999,0
1668294988738,ECE 200,052,103637,Zeger; Kenneth A.,999,0,999,0
1668294988738,ECE 200,053,103638,Zhang; Xinyu,9999,0,9999,0
1668294988738,ECE 200,054,103639,Turakhia; Yatish Girish,9999,0,9999,0
1668294988738,ECE 200,055,103640,Kang; Mingu,9999,0,9999,0
1668294988738,ECE 200,056,103641,Shi; Yuanyuan,9999,0,9999,0
1668294988738,ECE 200,057,103642,Wang; Edward Jay,9999,0,9999,0
1668294988738,ECE 200,058,103643,Zheng; Yang,9999,0,9999,0
1668294989161,ECE 202,A00,103644,Kuzum; Duygu,0,0,0,0
1668294989587,ECE 212BN,A00,103646,Ng; Tse Nga,0,0,0,0
1668294990016,ECE 221,A00,111493,Staff,0,0,0,0
1668294990445,ECE 222B,A00,103647,Lomakin; Vitaliy,0,0,0,0
1668294990868,ECE 230B,A00,103648,Taur; Yuan,0,0,0,0
1668294991292,ECE 238B,A00,103649,Garay; Javier,0,0,0,0
1668294991725,ECE 240B,A00,112900,Fainman; Yeshaiahu,0,0,0,0
1668294992154,ECE 247A,A00,103650,Jokerst; Jesse Vincent,0,0,0,0
1668294992577,ECE 247B,A00,103651,Wang; Joseph,0,0,0,0
1668294993002,ECE 250,A00,103652,Siegel; Paul H.,0,0,0,0
1668294993425,ECE 251A,A00,103654,Rao; Bhaskar D.,0,0,0,0
1668294993847,ECE 257B,A00,103655,Bharadia; Dinesh,0,0,0,0
1668294994271,ECE 258A,A00,103656,Milstein; Laurence B.,0,0,0,0
1668294994693,ECE 260B,A00,103658,Kang; Mingu,0,0,0,0
1668294995120,ECE 264A,A00,103659,Galton; Ian A,0,0,0,0
1668294995543,ECE 265A,A00,103661,Gudem; Prasad S.S.,0,0,0,0
1668294995966,ECE 265D,A00,103662,Gudem; Prasad S.S.,0,0,0,0
1668294996390,ECE 268,A00,103663,Koushanfar; Farinaz,0,0,0,0
1668294996813,ECE 269,A01,103665,Pal; Piya,0,0,0,0
1668294997235,ECE 271B,A00,103666,Vasconcelos; Manuela,0,0,0,0
1668294997660,ECE 276A,A00,103667,Atanasov; Nikolay A.,0,0,0,0
1668294998086,ECE 277,A00,103668,An; Cheolhong,0,0,0,0
1668294998512,ECE 279,A00,117947,Hall; Drew A.,0,0,0,0
1668294999358,ECE 283,A00,103670,Hsueh; Tzu-Chien,0,0,0,0
1668294999794,ECE 284,A00,103671,Turakhia; Yatish Girish,0,0,0,0
1668295000228,ECE 285,A00,103672,Zheng; Yang,0,0,0,0
1668295000228,ECE 285,B00,103673,Sworder; David D.,0,0,0,0
1668295000665,ECE 287,A00,103676,Javidi; Tara,0,0,0,0
1668295001092,MATH 200B,A00,098023,Salehi Golsefidy; Alireza,12,0,15,3
1668295001516,MATH 202B,A00,098024,Rhoades; Brendon Patrick,9,0,15,6
1668295001939,MATH 203B,A00,098025,Oprea; Dragos N.,10,0,15,5
1668295002366,MATH 204B,A00,098026,Sorensen; Claus M,13,0,15,2
1668295002787,MATH 208,A00,098027,Izadi; Elham,7,0,10,3
1668295003211,MATH 209,A00,098028,Pollack; Aaron,10,0,10,0
1668295003633,MATH 211A,A00,112919,Rogalski; Daniel,9,0,10,1
1668295004057,MATH 211B,A00,112920,Seward; Brandon M.,9,0,10,1
1668295004481,MATH 218,A00,098029,Li; Bo,10,0,10,0
1668295004905,MATH 220B,A00,098030,Novak; Jonathan I,11,0,15,4
1668295005333,MATH 221A,A00,098031,Ebenfelt; Peter F,13,0,15,2
1668295005755,MATH 231B,A00,098032,Zlatos; Andrej,12,0,15,3
1668295006186,MATH 240B,A00,098033,Ni; Lei,9,0,15,6
1668295006611,MATH 243,A00,098034,Jekel; David Andrew,10,0,10,0
1668295007033,MATH 245A,A00,098035,Nie; Jiawang,0,0,15,16
1668295007458,MATH 248,A00,098036,Bejenaru; Ioan,10,0,10,0
1668295007970,MATH 250B,A00,098037,Spolaor; Luca,14,0,15,1
1668295008408,MATH 258,A00,098038,Ni; Lei,10,0,10,0
1668295008831,MATH 264B,A00,098041,Rhoades; Brendon Patrick,9,0,15,6
1668295009254,MATH 268,A00,098042,Buss; Samuel R,10,0,10,0
1668295009683,MATH 269,A00,098043,Rhoades; Brendon Patrick,10,0,10,0
1668295010108,MATH 270B,A00,098044,Li; Bo,10,0,15,5
1668295010532,MATH 272B,A00,098045,Holst; Michael J,13,0,15,2
1668295010965,MATH 273A,A00,098046,Tian; Xiaochuan,10,0,15,5
1668295011392,MATH 275,A01,098048,Tian; Xiaochuan,6,0,10,4
1668295011814,MATH 278A,A00,098049,Holst; Michael J,8,0,10,2
1668295012241,MATH 278B,A00,098050,Cloninger; Alexander,10,0,10,0
1668295012666,MATH 278C,A00,098051,Nie; Jiawang,7,0,10,3
1668295013092,MATH 280B,A00,098052,Zheng; Tianyi,8,0,15,7
1668295013522,MATH 281B,A00,098053,Bradic; Jelena,1,0,15,14
1668295013946,MATH 282B,A00,098054,Arias-Castro; Ery,0,0,15,15
1668295014370,MATH 285,A00,098055,Fitzsimmons; Patrick J,0,0,15,17
1668295014796,MATH 287B,A00,098056,Arias-Castro; Ery,2,0,15,13
1668295015230,MATH 288,A00,098057,Agarwal; Pooja,9,0,10,1
1668295015230,MATH 288,B00,098058,Zhang; Danna,8,0,10,2
1668295015230,MATH 288,C00,098059,Williams; Ruth J,9,0,10,1
1668295015653,MATH 290B,A00,098060,Roberts; Justin Deritter,13,0,15,2
1668295016078,MATH 292,A00,098061,Belmont; Eva Kinoshita,10,0,10,0
1668295016500,MATH 295,A00,098062,Suk; Andrew Hoon,48,0,50,2
1668295016923,MATH 296,A00,098063,Novak; Jonathan I,20,0,20,0
1668295017347,MATH 297,001,098064,Gamst; Anthony Collins,9997,0,9999,2
1668295516055,COGS 205,A00,101395,Chiba; Andrea,19,0,20,1
1668295516483,COGS 210B,001,101404,Greene; Deanna Jacquelyn,9998,0,9999,1
1668295516483,COGS 210B,002,101417,Xia; Haijun,9999,0,9999,0
1668295516483,COGS 210B,003,101422,Nitz; Douglas A.,9999,0,9999,0
1668295516483,COGS 210B,004,101423,Hollan; James D.,9998,0,9999,1
1668295516483,COGS 210B,005,101424,Deak; Gedeon O.,9998,0,9999,1
1668295516483,COGS 210B,006,101425,Rossano; Federico,9999,0,9999,0
1668295516907,COGS 211B,A00,101427,Coulson; Seana M,9996,0,9999,3
1668295517334,COGS 220,A00,101428,Hollan; James D.,0,0,25,25
1668295517757,COGS 229,A00,101429,Dow; Steven P,18,0,25,7
1668295518182,COGS 230,A00,101430,Klemmer; Scott R,12,0,17,5
1668295518607,COGS 234,A00,101431,Xia; Haijun,1,0,25,24
1668295519040,COGS 260,A00,101432,Kiyonaga; Anastasia,21,0,25,4
1668295519040,COGS 260,B00,101433,Kirsh; David Joel,15,0,25,10
1668295519469,CSE 202,A00,102371,Impagliazzo; Russell,0,0,0,0
1668295519896,CSE 203B,A01,102373,Cheng; Chung Kuan,0,0,0,0
1668295520322,CSE 208,A00,102374,Micciancio; Daniele,0,0,0,0
1668295520744,CSE 209A,A00,112895,Impagliazzo; Russell,0,0,15,15
1668295521174,CSE 209B,A00,108005,Bellare; Mihir,0,0,0,0
1668295521597,CSE 210,A00,113163,Coblenz; Michael J,0,0,0,0
1668295522022,CSE 219,A00,106111,Dow; Steven P,0,0,20,20
1668295522459,CSE 221,A00,102376,Voelker; Geoffrey M.,0,0,0,0
1668295522883,CSE 224,A01,102378,Porter; George M,0,0,0,0
1668295523308,CSE 229A,A00,102379,Savage; Stefan,0,0,0,0
1668295523731,CSE 229C,A00,102380,Munyaka; Imani N. S.,0,0,0,0
1668295524155,CSE 232B,A00,102382,Deutsch; Alin Bernard,0,0,0,0
1668295524578,CSE 234,A01,112904,Kumar; Arun Kumar,0,0,0,0
1668295525003,CSE 237A,A00,102383,Rosing; Tajana Simunic,0,0,0,0
1668295525434,CSE 239A,A00,102384,Deutsch; Alin Bernard,0,0,0,0
1668295525856,CSE 239B,A00,102385,Polikarpova; Nadezhda,0,0,0,0
1668295526282,CSE 240A,A00,102386,Pannuto; Patrick William,0,0,0,0
1668295526781,CSE 240B,A00,102387,Zhao; Jishen,0,0,0,0
1668295527205,CSE 241A,A00,106406,Kang; Mingu,0,0,0,0
1668295527628,CSE 249B,A00,102388,Kahng; Andrew Byun,0,0,8,8
1668295528060,CSE 251B,A01,102392,Cottrell; Garrison W,0,0,0,0
1668295528060,CSE 251B,A02,102393,Cottrell; Garrison W,0,0,0,0
1668295528482,CSE 252B,A00,102394,Ochoa; Benjamin Lawrence,0,0,0,0
1668295528905,CSE 257,A01,102396,Gao; Sicun,0,0,0,0
1668295529328,CSE 272,A00,102397,Li; Tzumao,0,0,0,0
1668295529749,CSE 274,A00,111323,Chern; Albert Ren-Haur,0,0,0,0
1668295530173,CSE 282,A00,102398,Pevzner; Pavel Arkadjevich,0,0,0,0
1668295530599,CSE 284,A00,114175,Gymrek; Melissa Ann,0,0,0,0
1668295531021,CSE 290,A00,102399,Chandraker; Manmohan Krishna,0,0,0,0
1668295531021,CSE 290,B00,102400,Vaccaro; Kristen Marie,0,0,25,25
1668295531021,CSE 290,C00,102414,Pannuto; Patrick William,0,0,25,25
1668295531021,CSE 290,D00,102427,Pevzner; Pavel Arkadjevich,0,0,0,0
1668295531021,CSE 290,E00,102429,Zhao; Jishen,0,0,0,0
1668295531021,CSE 290,F00,102436,Tullsen; Dean Michael,0,0,0,0
1668295531021,CSE 290,G00,102440,Christensen; Henrik I,0,0,20,20
1668295531444,CSE 291,A00,102443,Su; Hao,0,0,0,0
1668295531444,CSE 291,B00,102448,Polikarpova; Nadezhda,0,0,0,0
1668295531444,CSE 291,C00,102453,Vaccaro; Kristen Marie,0,0,0,0
1668295531444,CSE 291,D00,111343,Savage; Stefan,0,0,0,0
1668295531444,CSE 291,E00,116474,Claffy; Kimberly Claire,0,0,0,0
1668295531444,CSE 291,F00,116479,Pasquale; Joseph,0,0,0,0
1668295531870,CSE 293,001,119111,Bafna; Vineet,9999,0,9999,0
1668295531870,CSE 293,002,119118,Bellare; Mihir,9999,0,9999,0
1668295531870,CSE 293,003,119122,Berg-Kirkpatrick; Taylor D,9999,0,9999,0
1668295531870,CSE 293,004,119135,Christensen; Henrik I,9999,0,9999,0
1668295531870,CSE 293,005,119142,Cottrell; Garrison W,9999,0,9999,0
1668295531870,CSE 293,006,119146,Deutsch; Alin Bernard,9999,0,9999,0
1668295531870,CSE 293,007,119159,Esmaeilzadeh; Hadi,9999,0,9999,0
1668295531870,CSE 293,008,119166,Freund; Yoav,9999,0,9999,0
1668295531870,CSE 293,009,119170,Griswold; William G.,9999,0,9999,0
1668295531870,CSE 293,010,119183,Gymrek; Melissa Ann,9999,0,9999,0
1668295531870,CSE 293,011,119190,Heninger; Nadia A,9999,0,9999,0
1668295531870,CSE 293,012,119230,Impagliazzo; Russell,9999,0,9999,0
1668295531870,CSE 293,013,119232,Jhala; Ranjit,9999,0,9999,0
1668295531870,CSE 293,014,119233,Kahng; Andrew Byun,9999,0,9999,0
1668295531870,CSE 293,015,119298,Kane; Daniel Mertz,9999,0,9999,0
1668295531870,CSE 293,016,119299,Kriegman; David J,9999,0,9999,0
1668295531870,CSE 293,017,119300,Kumar; Arun Kumar,9999,0,9999,0
1668295531870,CSE 293,018,119301,Lerner; Sorin,9999,0,9999,0
1668295531870,CSE 293,019,119302,Lovett; Shachar,9999,0,9999,0
1668295531870,CSE 293,020,119303,McAuley; Julian John,9999,0,9999,0
1668295531870,CSE 293,021,119304,Micciancio; Daniele,9999,0,9999,0
1668295531870,CSE 293,022,119367,Orailoglu; Alex,9999,0,9999,0
1668295531870,CSE 293,023,119382,Paturi; Ramamohan,9999,0,9999,0
1668295531870,CSE 293,024,119404,Polikarpova; Nadezhda,9999,0,9999,0
1668295531870,CSE 293,025,119406,Politz; Joseph Gibbs,9999,0,9999,0
1668295531870,CSE 293,026,119411,Porter; George M,9999,0,9999,0
1668295531870,CSE 293,027,119414,Porter; Leonard Emerson,9999,0,9999,0
1668295531870,CSE 293,028,119416,Ramamoorthi; Ravi,9999,0,9999,0
1668295531870,CSE 293,029,119417,Sahoo; Debashis,9999,0,9999,0
1668295531870,CSE 293,030,119420,Saul; Lawrence,9999,0,9999,0
1668295531870,CSE 293,031,119421,Savage; Stefan,9999,0,9999,0
1668295531870,CSE 293,032,119425,Schulze; Jurgen P.,9999,0,9999,0
1668295531870,CSE 293,033,119426,Snoeren; Alex C.,9999,0,9999,0
1668295531870,CSE 293,034,119428,Shang; Jingbo,9999,0,9999,0
1668295531870,CSE 293,035,119430,Stefan; Deian,9999,0,9999,0
1668295531870,CSE 293,036,119431,Su; Hao,9999,0,9999,0
1668295531870,CSE 293,037,119433,Swanson; Steven James,9999,0,9999,0
1668295531870,CSE 293,038,119435,Tullsen; Dean Michael,9999,0,9999,0
1668295531870,CSE 293,039,119483,Voelker; Geoffrey M.,9999,0,9999,0
1668295531870,CSE 293,040,119537,Zhao; Jishen,9999,0,9999,0
1668295531870,CSE 293,041,119538,Zhou; Yuan-Yuan,9999,0,9999,0
1668295531870,CSE 293,042,119539,Gao; Sicun,9999,0,9999,0
1668295531870,CSE 293,043,119540,Weibel; Nadir,9999,0,9999,0
1668295531870,CSE 293,044,119541,Gupta; Rajesh K.,9999,0,9999,0
1668295531870,CSE 293,045,126410,Vaccaro; Kristen Marie,9999,0,9999,0
1668295531870,CSE 293,046,126411,Klemke; Richard,9999,0,9999,0
1668295532295,CSE 294,A00,102459,Voelker; Geoffrey M.,0,0,0,0
1668295532295,CSE 294,B00,111322,Orailoglu; Alex,0,0,0,0
1668295532718,DSE 201,A00,096914,Deutsch; Alin Bernard,30,0,30,0
1668295533143,DSE 210,A00,096915,Dasgupta; Sanjoy,30,0,30,0
1668295533568,DSE 260A,A00,096916,Altintas De Callaf; Ilkay,30,0,30,0
1668295533997,ECE 200,001,103586,Antipa; Nicholas A,9999,0,9999,0
1668295533997,ECE 200,002,103587,Atanasov; Nikolay A.,9999,0,9999,0
1668295533997,ECE 200,003,103588,Bharadia; Dinesh,9999,0,9999,0
1668295533997,ECE 200,004,103589,Cheng; Chung Kuan,9999,0,9999,0
1668295533997,ECE 200,005,103590,Cosman; Pamela C.,9999,0,9999,0
1668295533997,ECE 200,006,103591,Dayeh; Shadi Ahmad,9999,0,9999,0
1668295533997,ECE 200,007,103592,Fainman; Yeshaiahu,9999,0,9999,0
1668295533997,ECE 200,008,103593,Ford; Joseph Earl,9999,0,9999,0
1668295533997,ECE 200,009,103594,Franceschetti; Massimo,9999,0,9999,0
1668295533997,ECE 200,010,103595,Fullerton; Eric E,9999,0,9999,0
1668295533997,ECE 200,011,103596,Galton; Ian A,9999,0,9999,0
1668295533997,ECE 200,012,103597,Gilja; Vikash,9999,0,9999,0
1668295533997,ECE 200,013,103598,Hall; Drew A.,9999,0,9999,0
1668295533997,ECE 200,014,103599,Hsueh; Tzu-Chien,9999,0,9999,0
1668295533997,ECE 200,015,103600,Javidi; Tara,9999,0,9999,0
1668295533997,ECE 200,016,103601,Kahng; Andrew Byun,9999,0,9999,0
1668295533997,ECE 200,017,103602,Kim; Young-Han,9999,0,9999,0
1668295533997,ECE 200,018,103603,Koushanfar; Farinaz,9999,0,9999,0
1668295533997,ECE 200,019,103604,Kuzum; Duygu,9999,0,9999,0
1668295533997,ECE 200,020,103605,Le; Hanh-Phuc,9999,0,9999,0
1668295533997,ECE 200,021,103606,Lin; Bill,9999,0,9999,0
1668295533997,ECE 200,022,103607,Liu; Zhaowei,9998,0,9999,1
1668295533997,ECE 200,023,103608,Lo; Yu-Hwa,9999,0,9999,0
1668295533997,ECE 200,024,103609,Lomakin; Vitaliy,9999,0,9999,0
1668295533997,ECE 200,025,103610,Mercier; Patrick Philip,9999,0,9999,0
1668295533997,ECE 200,026,103611,Meyer; Florian,9999,0,9999,0
1668295533997,ECE 200,027,103612,Milstein; Laurence B.,9999,0,9999,0
1668295533997,ECE 200,028,103613,Mir Arabbaygi; Siavash,9999,0,9999,0
1668295533997,ECE 200,029,103614,Mookherjea; Shayan,9999,0,9999,0
1668295533997,ECE 200,030,103615,Morris; Karcher William,9999,0,9999,0
1668295533997,ECE 200,031,103616,Ng; Tse Nga,9999,0,9999,0
1668295533997,ECE 200,032,103617,Nguyen; Truong Quang,9999,0,9999,0
1668295533997,ECE 200,033,103618,Nomura; Kenji,9999,0,9999,0
1668295533997,ECE 200,034,103619,Orlitsky; Alon,9999,0,9999,0
1668295533997,ECE 200,035,103620,Pal; Piya,9999,0,9999,0
1668295533997,ECE 200,036,103621,Papen; George C.,9999,0,9999,0
1668295533997,ECE 200,037,103622,Radic; Stojan,9999,0,9999,0
1668295533997,ECE 200,038,103623,Rao; Bhaskar D.,9999,0,9999,0
1668295533997,ECE 200,039,103624,Rao; Ramesh R,9999,0,9999,0
1668295533997,ECE 200,040,103625,Rebeiz; Gabriel,9999,0,9999,0
1668295533997,ECE 200,041,103626,Sanford; John R,9999,0,9999,0
1668295533997,ECE 200,042,103627,Siegel; Paul H.,9999,0,9999,0
1668295533997,ECE 200,043,103628,Sievenpiper; Daniel F.,9999,0,9999,0
1668295533997,ECE 200,044,103629,Sworder; David D.,9999,0,9999,0
1668295533997,ECE 200,045,103630,Taur; Yuan,9999,0,9999,0
1668295533997,ECE 200,046,103631,Touri; Behrouz,9999,0,9999,0
1668295533997,ECE 200,047,103632,Trivedi; Mohan M.,9999,0,9999,0
1668295533997,ECE 200,048,103633,Vasconcelos; Nuno,9999,0,9999,0
1668295533997,ECE 200,049,103634,Wang; Xiaolong,9999,0,9999,0
1668295533997,ECE 200,050,103635,Xie; Pengtao,9999,0,9999,0
1668295533997,ECE 200,051,103636,Yip; Michael,9999,0,9999,0
1668295533997,ECE 200,052,103637,Zeger; Kenneth A.,999,0,999,0
1668295533997,ECE 200,053,103638,Zhang; Xinyu,9999,0,9999,0
1668295533997,ECE 200,054,103639,Turakhia; Yatish Girish,9999,0,9999,0
1668295533997,ECE 200,055,103640,Kang; Mingu,9999,0,9999,0
1668295533997,ECE 200,056,103641,Shi; Yuanyuan,9999,0,9999,0
1668295533997,ECE 200,057,103642,Wang; Edward Jay,9999,0,9999,0
1668295533997,ECE 200,058,103643,Zheng; Yang,9999,0,9999,0
1668295534420,ECE 202,A00,103644,Kuzum; Duygu,0,0,0,0
1668295534845,ECE 212BN,A00,103646,Ng; Tse Nga,0,0,0,0
1668295535268,ECE 221,A00,111493,Staff,0,0,0,0
1668295535690,ECE 222B,A00,103647,Lomakin; Vitaliy,0,0,0,0
1668295536122,ECE 230B,A00,103648,Taur; Yuan,0,0,0,0
1668295536556,ECE 238B,A00,103649,Garay; Javier,0,0,0,0
1668295536979,ECE 240B,A00,112900,Fainman; Yeshaiahu,0,0,0,0
1668295537402,ECE 247A,A00,103650,Jokerst; Jesse Vincent,0,0,0,0
1668295537829,ECE 247B,A00,103651,Wang; Joseph,0,0,0,0
1668295538255,ECE 250,A00,103652,Siegel; Paul H.,0,0,0,0
1668295538680,ECE 251A,A00,103654,Rao; Bhaskar D.,0,0,0,0
1668295539107,ECE 257B,A00,103655,Bharadia; Dinesh,0,0,0,0
1668295539530,ECE 258A,A00,103656,Milstein; Laurence B.,0,0,0,0
1668295539956,ECE 260B,A00,103658,Kang; Mingu,0,0,0,0
1668295540378,ECE 264A,A00,103659,Galton; Ian A,0,0,0,0
1668295540814,ECE 265A,A00,103661,Gudem; Prasad S.S.,0,0,0,0
1668295541239,ECE 265D,A00,103662,Gudem; Prasad S.S.,0,0,0,0
1668295541663,ECE 268,A00,103663,Koushanfar; Farinaz,0,0,0,0
1668295542087,ECE 269,A01,103665,Pal; Piya,0,0,0,0
1668295542510,ECE 271B,A00,103666,Vasconcelos; Manuela,0,0,0,0
1668295542946,ECE 276A,A00,103667,Atanasov; Nikolay A.,0,0,0,0
1668295543372,ECE 277,A00,103668,An; Cheolhong,0,0,0,0
1668295543796,ECE 279,A00,117947,Hall; Drew A.,0,0,0,0
1668295544646,ECE 283,A00,103670,Hsueh; Tzu-Chien,0,0,0,0
1668295545071,ECE 284,A00,103671,Turakhia; Yatish Girish,0,0,0,0
1668295545496,ECE 285,A00,103672,Zheng; Yang,0,0,0,0
1668295545496,ECE 285,B00,103673,Sworder; David D.,0,0,0,0
1668295545925,ECE 287,A00,103676,Javidi; Tara,0,0,0,0
1668295546349,MATH 200B,A00,098023,Salehi Golsefidy; Alireza,12,0,15,3
1668295546772,MATH 202B,A00,098024,Rhoades; Brendon Patrick,9,0,15,6
1668295547199,MATH 203B,A00,098025,Oprea; Dragos N.,10,0,15,5
1668295547624,MATH 204B,A00,098026,Sorensen; Claus M,13,0,15,2
1668295548047,MATH 208,A00,098027,Izadi; Elham,7,0,10,3
1668295548469,MATH 209,A00,098028,Pollack; Aaron,10,0,10,0
1668295548892,MATH 211A,A00,112919,Rogalski; Daniel,9,0,10,1
1668295549315,MATH 211B,A00,112920,Seward; Brandon M.,9,0,10,1
1668295549737,MATH 218,A00,098029,Li; Bo,10,0,10,0
1668295550162,MATH 220B,A00,098030,Novak; Jonathan I,11,0,15,4
1668295550589,MATH 221A,A00,098031,Ebenfelt; Peter F,13,0,15,2
1668295551019,MATH 231B,A00,098032,Zlatos; Andrej,12,0,15,3
1668295551445,MATH 240B,A00,098033,Ni; Lei,9,0,15,6
1668295551868,MATH 243,A00,098034,Jekel; David Andrew,10,0,10,0
1668295552294,MATH 245A,A00,098035,Nie; Jiawang,0,0,15,16
1668295552720,MATH 248,A00,098036,Bejenaru; Ioan,10,0,10,0
1668295553143,MATH 250B,A00,098037,Spolaor; Luca,14,0,15,1
1668295553565,MATH 258,A00,098038,Ni; Lei,10,0,10,0
1668295553989,MATH 264B,A00,098041,Rhoades; Brendon Patrick,9,0,15,6
1668295554413,MATH 268,A00,098042,Buss; Samuel R,10,0,10,0
1668295554836,MATH 269,A00,098043,Rhoades; Brendon Patrick,10,0,10,0
1668295555258,MATH 270B,A00,098044,Li; Bo,10,0,15,5
1668295555686,MATH 272B,A00,098045,Holst; Michael J,13,0,15,2
1668295556111,MATH 273A,A00,098046,Tian; Xiaochuan,10,0,15,5
1668295556549,MATH 275,A01,098048,Tian; Xiaochuan,6,0,10,4
1668295556974,MATH 278A,A00,098049,Holst; Michael J,8,0,10,2
1668295557402,MATH 278B,A00,098050,Cloninger; Alexander,10,0,10,0
1668295557824,MATH 278C,A00,098051,Nie; Jiawang,7,0,10,3
1668295558248,MATH 280B,A00,098052,Zheng; Tianyi,8,0,15,7
1668295558676,MATH 281B,A00,098053,Bradic; Jelena,1,0,15,14
1668295559103,MATH 282B,A00,098054,Arias-Castro; Ery,0,0,15,15
1668295559534,MATH 285,A00,098055,Fitzsimmons; Patrick J,0,0,15,17
1668295559959,MATH 287B,A00,098056,Arias-Castro; Ery,2,0,15,13
1668295560398,MATH 288,A00,098057,Agarwal; Pooja,9,0,10,1
1668295560398,MATH 288,B00,098058,Zhang; Danna,8,0,10,2
1668295560398,MATH 288,C00,098059,Williams; Ruth J,9,0,10,1
1668295560820,MATH 290B,A00,098060,Roberts; Justin Deritter,13,0,15,2
1668295561244,MATH 292,A00,098061,Belmont; Eva Kinoshita,10,0,10,0
1668295561668,MATH 295,A00,098062,Suk; Andrew Hoon,48,0,50,2
1668295562092,MATH 296,A00,098063,Novak; Jonathan I,20,0,20,0
1668295562528,MATH 297,001,098064,Gamst; Anthony Collins,9997,0,9999,2
1668296061170,COGS 205,A00,101395,Chiba; Andrea,19,0,20,1
1668296061594,COGS 210B,001,101404,Greene; Deanna Jacquelyn,9998,0,9999,1
1668296061594,COGS 210B,002,101417,Xia; Haijun,9999,0,9999,0
1668296061594,COGS 210B,003,101422,Nitz; Douglas A.,9999,0,9999,0
1668296061594,COGS 210B,004,101423,Hollan; James D.,9998,0,9999,1
1668296061594,COGS 210B,005,101424,Deak; Gedeon O.,9998,0,9999,1
1668296061594,COGS 210B,006,101425,Rossano; Federico,9999,0,9999,0
1668296062022,COGS 211B,A00,101427,Coulson; Seana M,9996,0,9999,3
1668296062448,COGS 220,A00,101428,Hollan; James D.,0,0,25,25
1668296062872,COGS 229,A00,101429,Dow; Steven P,18,0,25,7
1668296063304,COGS 230,A00,101430,Klemmer; Scott R,12,0,17,5
1668296063752,COGS 234,A00,101431,Xia; Haijun,1,0,25,24
1668296064178,COGS 260,A00,101432,Kiyonaga; Anastasia,21,0,25,4
1668296064178,COGS 260,B00,101433,Kirsh; David Joel,15,0,25,10
1668296064609,CSE 202,A00,102371,Impagliazzo; Russell,0,0,0,0
1668296065032,CSE 203B,A01,102373,Cheng; Chung Kuan,0,0,0,0
1668296065460,CSE 208,A00,102374,Micciancio; Daniele,0,0,0,0
1668296065882,CSE 209A,A00,112895,Impagliazzo; Russell,0,0,15,15
1668296066307,CSE 209B,A00,108005,Bellare; Mihir,0,0,0,0
1668296066731,CSE 210,A00,113163,Coblenz; Michael J,0,0,0,0
1668296067154,CSE 219,A00,106111,Dow; Steven P,0,0,20,20
1668296067600,CSE 221,A00,102376,Voelker; Geoffrey M.,0,0,0,0
1668296068027,CSE 224,A01,102378,Porter; George M,0,0,0,0
1668296068451,CSE 229A,A00,102379,Savage; Stefan,0,0,0,0
1668296068873,CSE 229C,A00,102380,Munyaka; Imani N. S.,0,0,0,0
1668296069301,CSE 232B,A00,102382,Deutsch; Alin Bernard,0,0,0,0
1668296069725,CSE 234,A01,112904,Kumar; Arun Kumar,0,0,0,0
1668296070151,CSE 237A,A00,102383,Rosing; Tajana Simunic,0,0,0,0
1668296070577,CSE 239A,A00,102384,Deutsch; Alin Bernard,0,0,0,0
1668296071003,CSE 239B,A00,102385,Polikarpova; Nadezhda,0,0,0,0
1668296071434,CSE 240A,A00,102386,Pannuto; Patrick William,0,0,0,0
1668296071859,CSE 240B,A00,102387,Zhao; Jishen,0,0,0,0
1668296072284,CSE 241A,A00,106406,Kang; Mingu,0,0,0,0
1668296072708,CSE 249B,A00,102388,Kahng; Andrew Byun,0,0,8,8
1668296073139,CSE 251B,A01,102392,Cottrell; Garrison W,0,0,0,0
1668296073139,CSE 251B,A02,102393,Cottrell; Garrison W,0,0,0,0
1668296073563,CSE 252B,A00,102394,Ochoa; Benjamin Lawrence,0,0,0,0
1668296073988,CSE 257,A01,102396,Gao; Sicun,0,0,0,0
1668296074428,CSE 272,A00,102397,Li; Tzumao,0,0,0,0
1668296074850,CSE 274,A00,111323,Chern; Albert Ren-Haur,0,0,0,0
1668296075274,CSE 282,A00,102398,Pevzner; Pavel Arkadjevich,0,0,0,0
1668296075706,CSE 284,A00,114175,Gymrek; Melissa Ann,0,0,0,0
1668296076134,CSE 290,A00,102399,Chandraker; Manmohan Krishna,0,0,0,0
1668296076134,CSE 290,B00,102400,Vaccaro; Kristen Marie,0,0,25,25
1668296076134,CSE 290,C00,102414,Pannuto; Patrick William,0,0,25,25
1668296076134,CSE 290,D00,102427,Pevzner; Pavel Arkadjevich,0,0,0,0
1668296076134,CSE 290,E00,102429,Zhao; Jishen,0,0,0,0
1668296076134,CSE 290,F00,102436,Tullsen; Dean Michael,0,0,0,0
1668296076134,CSE 290,G00,102440,Christensen; Henrik I,0,0,20,20
1668296076559,CSE 291,A00,102443,Su; Hao,0,0,0,0
1668296076559,CSE 291,B00,102448,Polikarpova; Nadezhda,0,0,0,0
1668296076559,CSE 291,C00,102453,Vaccaro; Kristen Marie,0,0,0,0
1668296076559,CSE 291,D00,111343,Savage; Stefan,0,0,0,0
1668296076559,CSE 291,E00,116474,Claffy; Kimberly Claire,0,0,0,0
1668296076559,CSE 291,F00,116479,Pasquale; Joseph,0,0,0,0
1668296076994,CSE 293,001,119111,Bafna; Vineet,9999,0,9999,0
1668296076994,CSE 293,002,119118,Bellare; Mihir,9999,0,9999,0
1668296076994,CSE 293,003,119122,Berg-Kirkpatrick; Taylor D,9999,0,9999,0
1668296076994,CSE 293,004,119135,Christensen; Henrik I,9999,0,9999,0
1668296076994,CSE 293,005,119142,Cottrell; Garrison W,9999,0,9999,0
1668296076994,CSE 293,006,119146,Deutsch; Alin Bernard,9999,0,9999,0
1668296076994,CSE 293,007,119159,Esmaeilzadeh; Hadi,9999,0,9999,0
1668296076994,CSE 293,008,119166,Freund; Yoav,9999,0,9999,0
1668296076994,CSE 293,009,119170,Griswold; William G.,9999,0,9999,0
1668296076994,CSE 293,010,119183,Gymrek; Melissa Ann,9999,0,9999,0
1668296076994,CSE 293,011,119190,Heninger; Nadia A,9999,0,9999,0
1668296076994,CSE 293,012,119230,Impagliazzo; Russell,9999,0,9999,0
1668296076994,CSE 293,013,119232,Jhala; Ranjit,9999,0,9999,0
1668296076994,CSE 293,014,119233,Kahng; Andrew Byun,9999,0,9999,0
1668296076994,CSE 293,015,119298,Kane; Daniel Mertz,9999,0,9999,0
1668296076994,CSE 293,016,119299,Kriegman; David J,9999,0,9999,0
1668296076994,CSE 293,017,119300,Kumar; Arun Kumar,9999,0,9999,0
1668296076994,CSE 293,018,119301,Lerner; Sorin,9999,0,9999,0
1668296076994,CSE 293,019,119302,Lovett; Shachar,9999,0,9999,0
1668296076994,CSE 293,020,119303,McAuley; Julian John,9999,0,9999,0
1668296076994,CSE 293,021,119304,Micciancio; Daniele,9999,0,9999,0
1668296076994,CSE 293,022,119367,Orailoglu; Alex,9999,0,9999,0
1668296076994,CSE 293,023,119382,Paturi; Ramamohan,9999,0,9999,0
1668296076994,CSE 293,024,119404,Polikarpova; Nadezhda,9999,0,9999,0
1668296076994,CSE 293,025,119406,Politz; Joseph Gibbs,9999,0,9999,0
1668296076994,CSE 293,026,119411,Porter; George M,9999,0,9999,0
1668296076994,CSE 293,027,119414,Porter; Leonard Emerson,9999,0,9999,0
1668296076994,CSE 293,028,119416,Ramamoorthi; Ravi,9999,0,9999,0
1668296076994,CSE 293,029,119417,Sahoo; Debashis,9999,0,9999,0
1668296076994,CSE 293,030,119420,Saul; Lawrence,9999,0,9999,0
1668296076994,CSE 293,031,119421,Savage; Stefan,9999,0,9999,0
1668296076994,CSE 293,032,119425,Schulze; Jurgen P.,9999,0,9999,0
1668296076994,CSE 293,033,119426,Snoeren; Alex C.,9999,0,9999,0
1668296076994,CSE 293,034,119428,Shang; Jingbo,9999,0,9999,0
1668296076994,CSE 293,035,119430,Stefan; Deian,9999,0,9999,0
1668296076994,CSE 293,036,119431,Su; Hao,9999,0,9999,0
1668296076994,CSE 293,037,119433,Swanson; Steven James,9999,0,9999,0
1668296076994,CSE 293,038,119435,Tullsen; Dean Michael,9999,0,9999,0
1668296076994,CSE 293,039,119483,Voelker; Geoffrey M.,9999,0,9999,0
1668296076994,CSE 293,040,119537,Zhao; Jishen,9999,0,9999,0
1668296076994,CSE 293,041,119538,Zhou; Yuan-Yuan,9999,0,9999,0
1668296076994,CSE 293,042,119539,Gao; Sicun,9999,0,9999,0
1668296076994,CSE 293,043,119540,Weibel; Nadir,9999,0,9999,0
1668296076994,CSE 293,044,119541,Gupta; Rajesh K.,9999,0,9999,0
1668296076994,CSE 293,045,126410,Vaccaro; Kristen Marie,9999,0,9999,0
1668296076994,CSE 293,046,126411,Klemke; Richard,9999,0,9999,0
1668296077417,CSE 294,A00,102459,Voelker; Geoffrey M.,0,0,0,0
1668296077417,CSE 294,B00,111322,Orailoglu; Alex,0,0,0,0
1668296077841,DSE 201,A00,096914,Deutsch; Alin Bernard,30,0,30,0
1668296078267,DSE 210,A00,096915,Dasgupta; Sanjoy,30,0,30,0
1668296078698,DSE 260A,A00,096916,Altintas De Callaf; Ilkay,30,0,30,0
1668296079157,ECE 200,001,103586,Antipa; Nicholas A,9999,0,9999,0
1668296079157,ECE 200,002,103587,Atanasov; Nikolay A.,9999,0,9999,0
1668296079157,ECE 200,003,103588,Bharadia; Dinesh,9999,0,9999,0
1668296079157,ECE 200,004,103589,Cheng; Chung Kuan,9999,0,9999,0
1668296079157,ECE 200,005,103590,Cosman; Pamela C.,9999,0,9999,0
1668296079157,ECE 200,006,103591,Dayeh; Shadi Ahmad,9999,0,9999,0
1668296079157,ECE 200,007,103592,Fainman; Yeshaiahu,9999,0,9999,0
1668296079157,ECE 200,008,103593,Ford; Joseph Earl,9999,0,9999,0
1668296079157,ECE 200,009,103594,Franceschetti; Massimo,9999,0,9999,0
1668296079157,ECE 200,010,103595,Fullerton; Eric E,9999,0,9999,0
1668296079157,ECE 200,011,103596,Galton; Ian A,9999,0,9999,0
1668296079157,ECE 200,012,103597,Gilja; Vikash,9999,0,9999,0
1668296079157,ECE 200,013,103598,Hall; Drew A.,9999,0,9999,0
1668296079157,ECE 200,014,103599,Hsueh; Tzu-Chien,9999,0,9999,0
1668296079157,ECE 200,015,103600,Javidi; Tara,9999,0,9999,0
1668296079157,ECE 200,016,103601,Kahng; Andrew Byun,9999,0,9999,0
1668296079157,ECE 200,017,103602,Kim; Young-Han,9999,0,9999,0
1668296079157,ECE 200,018,103603,Koushanfar; Farinaz,9999,0,9999,0
1668296079157,ECE 200,019,103604,Kuzum; Duygu,9999,0,9999,0
1668296079157,ECE 200,020,103605,Le; Hanh-Phuc,9999,0,9999,0
1668296079157,ECE 200,021,103606,Lin; Bill,9999,0,9999,0
1668296079157,ECE 200,022,103607,Liu; Zhaowei,9998,0,9999,1
1668296079157,ECE 200,023,103608,Lo; Yu-Hwa,9999,0,9999,0
1668296079157,ECE 200,024,103609,Lomakin; Vitaliy,9999,0,9999,0
1668296079157,ECE 200,025,103610,Mercier; Patrick Philip,9999,0,9999,0
1668296079157,ECE 200,026,103611,Meyer; Florian,9999,0,9999,0
1668296079157,ECE 200,027,103612,Milstein; Laurence B.,9999,0,9999,0
1668296079157,ECE 200,028,103613,Mir Arabbaygi; Siavash,9999,0,9999,0
1668296079157,ECE 200,029,103614,Mookherjea; Shayan,9999,0,9999,0
1668296079157,ECE 200,030,103615,Morris; Karcher William,9999,0,9999,0
1668296079157,ECE 200,031,103616,Ng; Tse Nga,9999,0,9999,0
1668296079157,ECE 200,032,103617,Nguyen; Truong Quang,9999,0,9999,0
1668296079157,ECE 200,033,103618,Nomura; Kenji,9999,0,9999,0
1668296079157,ECE 200,034,103619,Orlitsky; Alon,9999,0,9999,0
1668296079157,ECE 200,035,103620,Pal; Piya,9999,0,9999,0
1668296079157,ECE 200,036,103621,Papen; George C.,9999,0,9999,0
1668296079157,ECE 200,037,103622,Radic; Stojan,9999,0,9999,0
1668296079157,ECE 200,038,103623,Rao; Bhaskar D.,9999,0,9999,0
1668296079157,ECE 200,039,103624,Rao; Ramesh R,9999,0,9999,0
1668296079157,ECE 200,040,103625,Rebeiz; Gabriel,9999,0,9999,0
1668296079157,ECE 200,041,103626,Sanford; John R,9999,0,9999,0
1668296079157,ECE 200,042,103627,Siegel; Paul H.,9999,0,9999,0
1668296079157,ECE 200,043,103628,Sievenpiper; Daniel F.,9999,0,9999,0
1668296079157,ECE 200,044,103629,Sworder; David D.,9999,0,9999,0
1668296079157,ECE 200,045,103630,Taur; Yuan,9999,0,9999,0
1668296079157,ECE 200,046,103631,Touri; Behrouz,9999,0,9999,0
1668296079157,ECE 200,047,103632,Trivedi; Mohan M.,9999,0,9999,0
1668296079157,ECE 200,048,103633,Vasconcelos; Nuno,9999,0,9999,0
1668296079157,ECE 200,049,103634,Wang; Xiaolong,9999,0,9999,0
1668296079157,ECE 200,050,103635,Xie; Pengtao,9999,0,9999,0
1668296079157,ECE 200,051,103636,Yip; Michael,9999,0,9999,0
1668296079157,ECE 200,052,103637,Zeger; Kenneth A.,999,0,999,0
1668296079157,ECE 200,053,103638,Zhang; Xinyu,9999,0,9999,0
1668296079157,ECE 200,054,103639,Turakhia; Yatish Girish,9999,0,9999,0
1668296079157,ECE 200,055,103640,Kang; Mingu,9999,0,9999,0
1668296079157,ECE 200,056,103641,Shi; Yuanyuan,9999,0,9999,0
1668296079157,ECE 200,057,103642,Wang; Edward Jay,9999,0,9999,0
1668296079157,ECE 200,058,103643,Zheng; Yang,9999,0,9999,0
1668296079604,ECE 202,A00,103644,Kuzum; Duygu,0,0,0,0
1668296080033,ECE 212BN,A00,103646,Ng; Tse Nga,0,0,0,0
1668296080457,ECE 221,A00,111493,Staff,0,0,0,0
1668296080881,ECE 222B,A00,103647,Lomakin; Vitaliy,0,0,0,0
1668296081309,ECE 230B,A00,103648,Taur; Yuan,0,0,0,0
1668296081732,ECE 238B,A00,103649,Garay; Javier,0,0,0,0
1668296082156,ECE 240B,A00,112900,Fainman; Yeshaiahu,0,0,0,0
1668296082580,ECE 247A,A00,103650,Jokerst; Jesse Vincent,0,0,0,0
1668296083003,ECE 247B,A00,103651,Wang; Joseph,0,0,0,0
1668296083426,ECE 250,A00,103652,Siegel; Paul H.,0,0,0,0
1668296083851,ECE 251A,A00,103654,Rao; Bhaskar D.,0,0,0,0
1668296084275,ECE 257B,A00,103655,Bharadia; Dinesh,0,0,0,0
1668296084700,ECE 258A,A00,103656,Milstein; Laurence B.,0,0,0,0
1668296085123,ECE 260B,A00,103658,Kang; Mingu,0,0,0,0
1668296085546,ECE 264A,A00,103659,Galton; Ian A,0,0,0,0
1668296085971,ECE 265A,A00,103661,Gudem; Prasad S.S.,0,0,0,0
1668296086395,ECE 265D,A00,103662,Gudem; Prasad S.S.,0,0,0,0
1668296086827,ECE 268,A00,103663,Koushanfar; Farinaz,0,0,0,0
1668296087253,ECE 269,A01,103665,Pal; Piya,0,0,0,0
1668296087683,ECE 271B,A00,103666,Vasconcelos; Manuela,0,0,0,0
1668296088107,ECE 276A,A00,103667,Atanasov; Nikolay A.,0,0,0,0
1668296088640,ECE 277,A00,103668,An; Cheolhong,0,0,0,0
1668296089063,ECE 279,A00,117947,Hall; Drew A.,0,0,0,0
1668296089915,ECE 283,A00,103670,Hsueh; Tzu-Chien,0,0,0,0
1668296090338,ECE 284,A00,103671,Turakhia; Yatish Girish,0,0,0,0
1668296090762,ECE 285,A00,103672,Zheng; Yang,0,0,0,0
1668296090762,ECE 285,B00,103673,Sworder; David D.,0,0,0,0
1668296091185,ECE 287,A00,103676,Javidi; Tara,0,0,0,0
1668296091618,MATH 200B,A00,098023,Salehi Golsefidy; Alireza,12,0,15,3
1668296092044,MATH 202B,A00,098024,Rhoades; Brendon Patrick,9,0,15,6
1668296092471,MATH 203B,A00,098025,Oprea; Dragos N.,10,0,15,5
1668296092900,MATH 204B,A00,098026,Sorensen; Claus M,13,0,15,2
1668296093324,MATH 208,A00,098027,Izadi; Elham,7,0,10,3
1668296093751,MATH 209,A00,098028,Pollack; Aaron,10,0,10,0
1668296094177,MATH 211A,A00,112919,Rogalski; Daniel,9,0,10,1
1668296094603,MATH 211B,A00,112920,Seward; Brandon M.,9,0,10,1
1668296095025,MATH 218,A00,098029,Li; Bo,10,0,10,0
1668296095458,MATH 220B,A00,098030,Novak; Jonathan I,11,0,15,4
1668296095884,MATH 221A,A00,098031,Ebenfelt; Peter F,13,0,15,2
1668296096318,MATH 231B,A00,098032,Zlatos; Andrej,12,0,15,3
1668296096744,MATH 240B,A00,098033,Ni; Lei,9,0,15,6
1668296097167,MATH 243,A00,098034,Jekel; David Andrew,10,0,10,0
1668296097605,MATH 245A,A00,098035,Nie; Jiawang,0,0,15,16
1668296098029,MATH 248,A00,098036,Bejenaru; Ioan,10,0,10,0
1668296098458,MATH 250B,A00,098037,Spolaor; Luca,14,0,15,1
1668296098883,MATH 258,A00,098038,Ni; Lei,10,0,10,0
1668296099310,MATH 264B,A00,098041,Rhoades; Brendon Patrick,9,0,15,6
1668296099736,MATH 268,A00,098042,Buss; Samuel R,10,0,10,0
1668296100160,MATH 269,A00,098043,Rhoades; Brendon Patrick,10,0,10,0
1668296100605,MATH 270B,A00,098044,Li; Bo,10,0,15,5
1668296101031,MATH 272B,A00,098045,Holst; Michael J,13,0,15,2
1668296101463,MATH 273A,A00,098046,Tian; Xiaochuan,10,0,15,5
1668296101889,MATH 275,A01,098048,Tian; Xiaochuan,6,0,10,4
1668296102321,MATH 278A,A00,098049,Holst; Michael J,8,0,10,2
1668296102746,MATH 278B,A00,098050,Cloninger; Alexander,10,0,10,0
1668296103172,MATH 278C,A00,098051,Nie; Jiawang,7,0,10,3
1668296103595,MATH 280B,A00,098052,Zheng; Tianyi,8,0,15,7
1668296104018,MATH 281B,A00,098053,Bradic; Jelena,1,0,15,14
1668296104442,MATH 282B,A00,098054,Arias-Castro; Ery,0,0,15,15
1668296104869,MATH 285,A00,098055,Fitzsimmons; Patrick J,0,0,15,17
1668296105297,MATH 287B,A00,098056,Arias-Castro; Ery,2,0,15,13
1668296105720,MATH 288,A00,098057,Agarwal; Pooja,9,0,10,1
1668296105720,MATH 288,B00,098058,Zhang; Danna,8,0,10,2
1668296105720,MATH 288,C00,098059,Williams; Ruth J,9,0,10,1
1668296106143,MATH 290B,A00,098060,Roberts; Justin Deritter,13,0,15,2
1668296106568,MATH 292,A00,098061,Belmont; Eva Kinoshita,10,0,10,0
1668296106995,MATH 295,A00,098062,Suk; Andrew Hoon,48,0,50,2
1668296107421,MATH 296,A00,098063,Novak; Jonathan I,20,0,20,0
1668296107844,MATH 297,001,098064,Gamst; Anthony Collins,9997,0,9999,2
1668296606568,COGS 205,A00,101395,Chiba; Andrea,19,0,20,1
1668296607006,COGS 210B,001,101404,Greene; Deanna Jacquelyn,9998,0,9999,1
1668296607006,COGS 210B,002,101417,Xia; Haijun,9999,0,9999,0
1668296607006,COGS 210B,003,101422,Nitz; Douglas A.,9999,0,9999,0
1668296607006,COGS 210B,004,101423,Hollan; James D.,9998,0,9999,1
1668296607006,COGS 210B,005,101424,Deak; Gedeon O.,9998,0,9999,1
1668296607006,COGS 210B,006,101425,Rossano; Federico,9999,0,9999,0
1668296607603,COGS 211B,A00,101427,Coulson; Seana M,9996,0,9999,3
1668296608025,COGS 220,A00,101428,Hollan; James D.,0,0,25,25
1668296608450,COGS 229,A00,101429,Dow; Steven P,18,0,25,7
1668296608880,COGS 230,A00,101430,Klemmer; Scott R,12,0,17,5
1668296609301,COGS 234,A00,101431,Xia; Haijun,1,0,25,24
1668296609724,COGS 260,A00,101432,Kiyonaga; Anastasia,21,0,25,4
1668296609724,COGS 260,B00,101433,Kirsh; David Joel,15,0,25,10
1668296610156,CSE 202,A00,102371,Impagliazzo; Russell,0,0,0,0
1668296610579,CSE 203B,A01,102373,Cheng; Chung Kuan,0,0,0,0
1668296611007,CSE 208,A00,102374,Micciancio; Daniele,0,0,0,0
1668296611433,CSE 209A,A00,112895,Impagliazzo; Russell,0,0,15,15
1668296611857,CSE 209B,A00,108005,Bellare; Mihir,0,0,0,0
1668296612283,CSE 210,A00,113163,Coblenz; Michael J,0,0,0,0
1668296612706,CSE 219,A00,106111,Dow; Steven P,0,0,20,20
1668296613130,CSE 221,A00,102376,Voelker; Geoffrey M.,0,0,0,0
1668296613556,CSE 224,A01,102378,Porter; George M,0,0,0,0
1668296613979,CSE 229A,A00,102379,Savage; Stefan,0,0,0,0
1668296614404,CSE 229C,A00,102380,Munyaka; Imani N. S.,0,0,0,0
1668296614832,CSE 232B,A00,102382,Deutsch; Alin Bernard,0,0,0,0
1668296615258,CSE 234,A01,112904,Kumar; Arun Kumar,0,0,0,0
1668296615690,CSE 237A,A00,102383,Rosing; Tajana Simunic,0,0,0,0
1668296616113,CSE 239A,A00,102384,Deutsch; Alin Bernard,0,0,0,0
1668296616538,CSE 239B,A00,102385,Polikarpova; Nadezhda,0,0,0,0
1668296616961,CSE 240A,A00,102386,Pannuto; Patrick William,0,0,0,0
1668296617395,CSE 240B,A00,102387,Zhao; Jishen,0,0,0,0
1668296617820,CSE 241A,A00,106406,Kang; Mingu,0,0,0,0
1668296618242,CSE 249B,A00,102388,Kahng; Andrew Byun,0,0,8,8
1668296618668,CSE 251B,A01,102392,Cottrell; Garrison W,0,0,0,0
1668296618668,CSE 251B,A02,102393,Cottrell; Garrison W,0,0,0,0
1668296619094,CSE 252B,A00,102394,Ochoa; Benjamin Lawrence,0,0,0,0
1668296619523,CSE 257,A01,102396,Gao; Sicun,0,0,0,0
1668296619946,CSE 272,A00,102397,Li; Tzumao,0,0,0,0
1668296620370,CSE 274,A00,111323,Chern; Albert Ren-Haur,0,0,0,0
1668296620793,CSE 282,A00,102398,Pevzner; Pavel Arkadjevich,0,0,0,0
1668296621217,CSE 284,A00,114175,Gymrek; Melissa Ann,0,0,0,0
1668296621643,CSE 290,A00,102399,Chandraker; Manmohan Krishna,0,0,0,0
1668296621643,CSE 290,B00,102400,Vaccaro; Kristen Marie,0,0,25,25
1668296621643,CSE 290,C00,102414,Pannuto; Patrick William,0,0,25,25
1668296621643,CSE 290,D00,102427,Pevzner; Pavel Arkadjevich,0,0,0,0
1668296621643,CSE 290,E00,102429,Zhao; Jishen,0,0,0,0
1668296621643,CSE 290,F00,102436,Tullsen; Dean Michael,0,0,0,0
1668296621643,CSE 290,G00,102440,Christensen; Henrik I,0,0,20,20
1668296622067,CSE 291,A00,102443,Su; Hao,0,0,0,0
1668296622067,CSE 291,B00,102448,Polikarpova; Nadezhda,0,0,0,0
1668296622067,CSE 291,C00,102453,Vaccaro; Kristen Marie,0,0,0,0
1668296622067,CSE 291,D00,111343,Savage; Stefan,0,0,0,0
1668296622067,CSE 291,E00,116474,Claffy; Kimberly Claire,0,0,0,0
1668296622067,CSE 291,F00,116479,Pasquale; Joseph,0,0,0,0
1668296622493,CSE 293,001,119111,Bafna; Vineet,9999,0,9999,0
1668296622493,CSE 293,002,119118,Bellare; Mihir,9999,0,9999,0
1668296622493,CSE 293,003,119122,Berg-Kirkpatrick; Taylor D,9999,0,9999,0
1668296622493,CSE 293,004,119135,Christensen; Henrik I,9999,0,9999,0
1668296622493,CSE 293,005,119142,Cottrell; Garrison W,9999,0,9999,0
1668296622493,CSE 293,006,119146,Deutsch; Alin Bernard,9999,0,9999,0
1668296622493,CSE 293,007,119159,Esmaeilzadeh; Hadi,9999,0,9999,0
1668296622493,CSE 293,008,119166,Freund; Yoav,9999,0,9999,0
1668296622493,CSE 293,009,119170,Griswold; William G.,9999,0,9999,0
1668296622493,CSE 293,010,119183,Gymrek; Melissa Ann,9999,0,9999,0
1668296622493,CSE 293,011,119190,Heninger; Nadia A,9999,0,9999,0
1668296622493,CSE 293,012,119230,Impagliazzo; Russell,9999,0,9999,0
1668296622493,CSE 293,013,119232,Jhala; Ranjit,9999,0,9999,0
1668296622493,CSE 293,014,119233,Kahng; Andrew Byun,9999,0,9999,0
1668296622493,CSE 293,015,119298,Kane; Daniel Mertz,9999,0,9999,0
1668296622493,CSE 293,016,119299,Kriegman; David J,9999,0,9999,0
1668296622493,CSE 293,017,119300,Kumar; Arun Kumar,9999,0,9999,0
1668296622493,CSE 293,018,119301,Lerner; Sorin,9999,0,9999,0
1668296622493,CSE 293,019,119302,Lovett; Shachar,9999,0,9999,0
1668296622493,CSE 293,020,119303,McAuley; Julian John,9999,0,9999,0
1668296622493,CSE 293,021,119304,Micciancio; Daniele,9999,0,9999,0
1668296622493,CSE 293,022,119367,Orailoglu; Alex,9999,0,9999,0
1668296622493,CSE 293,023,119382,Paturi; Ramamohan,9999,0,9999,0
1668296622493,CSE 293,024,119404,Polikarpova; Nadezhda,9999,0,9999,0
1668296622493,CSE 293,025,119406,Politz; Joseph Gibbs,9999,0,9999,0
1668296622493,CSE 293,026,119411,Porter; George M,9999,0,9999,0
1668296622493,CSE 293,027,119414,Porter; Leonard Emerson,9999,0,9999,0
1668296622493,CSE 293,028,119416,Ramamoorthi; Ravi,9999,0,9999,0
1668296622493,CSE 293,029,119417,Sahoo; Debashis,9999,0,9999,0
1668296622493,CSE 293,030,119420,Saul; Lawrence,9999,0,9999,0
1668296622493,CSE 293,031,119421,Savage; Stefan,9999,0,9999,0
1668296622493,CSE 293,032,119425,Schulze; Jurgen P.,9999,0,9999,0
1668296622493,CSE 293,033,119426,Snoeren; Alex C.,9999,0,9999,0
1668296622493,CSE 293,034,119428,Shang; Jingbo,9999,0,9999,0
1668296622493,CSE 293,035,119430,Stefan; Deian,9999,0,9999,0
1668296622493,CSE 293,036,119431,Su; Hao,9999,0,9999,0
1668296622493,CSE 293,037,119433,Swanson; Steven James,9999,0,9999,0
1668296622493,CSE 293,038,119435,Tullsen; Dean Michael,9999,0,9999,0
1668296622493,CSE 293,039,119483,Voelker; Geoffrey M.,9999,0,9999,0
1668296622493,CSE 293,040,119537,Zhao; Jishen,9999,0,9999,0
1668296622493,CSE 293,041,119538,Zhou; Yuan-Yuan,9999,0,9999,0
1668296622493,CSE 293,042,119539,Gao; Sicun,9999,0,9999,0
1668296622493,CSE 293,043,119540,Weibel; Nadir,9999,0,9999,0
1668296622493,CSE 293,044,119541,Gupta; Rajesh K.,9999,0,9999,0
1668296622493,CSE 293,045,126410,Vaccaro; Kristen Marie,9999,0,9999,0
1668296622493,CSE 293,046,126411,Klemke; Richard,9999,0,9999,0
1668296622917,CSE 294,A00,102459,Voelker; Geoffrey M.,0,0,0,0
1668296622917,CSE 294,B00,111322,Orailoglu; Alex,0,0,0,0
1668296623341,DSE 201,A00,096914,Deutsch; Alin Bernard,30,0,30,0
1668296623766,DSE 210,A00,096915,Dasgupta; Sanjoy,30,0,30,0
1668296624194,DSE 260A,A00,096916,Altintas De Callaf; Ilkay,30,0,30,0
1668296624629,ECE 200,001,103586,Antipa; Nicholas A,9999,0,9999,0
1668296624629,ECE 200,002,103587,Atanasov; Nikolay A.,9999,0,9999,0
1668296624629,ECE 200,003,103588,Bharadia; Dinesh,9999,0,9999,0
1668296624629,ECE 200,004,103589,Cheng; Chung Kuan,9999,0,9999,0
1668296624629,ECE 200,005,103590,Cosman; Pamela C.,9999,0,9999,0
1668296624629,ECE 200,006,103591,Dayeh; Shadi Ahmad,9999,0,9999,0
1668296624629,ECE 200,007,103592,Fainman; Yeshaiahu,9999,0,9999,0
1668296624629,ECE 200,008,103593,Ford; Joseph Earl,9999,0,9999,0
1668296624629,ECE 200,009,103594,Franceschetti; Massimo,9999,0,9999,0
1668296624629,ECE 200,010,103595,Fullerton; Eric E,9999,0,9999,0
1668296624629,ECE 200,011,103596,Galton; Ian A,9999,0,9999,0
1668296624629,ECE 200,012,103597,Gilja; Vikash,9999,0,9999,0
1668296624629,ECE 200,013,103598,Hall; Drew A.,9999,0,9999,0
1668296624629,ECE 200,014,103599,Hsueh; Tzu-Chien,9999,0,9999,0
1668296624629,ECE 200,015,103600,Javidi; Tara,9999,0,9999,0
1668296624629,ECE 200,016,103601,Kahng; Andrew Byun,9999,0,9999,0
1668296624629,ECE 200,017,103602,Kim; Young-Han,9999,0,9999,0
1668296624629,ECE 200,018,103603,Koushanfar; Farinaz,9999,0,9999,0
1668296624629,ECE 200,019,103604,Kuzum; Duygu,9999,0,9999,0
1668296624629,ECE 200,020,103605,Le; Hanh-Phuc,9999,0,9999,0
1668296624629,ECE 200,021,103606,Lin; Bill,9999,0,9999,0
1668296624629,ECE 200,022,103607,Liu; Zhaowei,9998,0,9999,1
1668296624629,ECE 200,023,103608,Lo; Yu-Hwa,9999,0,9999,0
1668296624629,ECE 200,024,103609,Lomakin; Vitaliy,9999,0,9999,0
1668296624629,ECE 200,025,103610,Mercier; Patrick Philip,9999,0,9999,0
1668296624629,ECE 200,026,103611,Meyer; Florian,9999,0,9999,0
1668296624629,ECE 200,027,103612,Milstein; Laurence B.,9999,0,9999,0
1668296624629,ECE 200,028,103613,Mir Arabbaygi; Siavash,9999,0,9999,0
1668296624629,ECE 200,029,103614,Mookherjea; Shayan,9999,0,9999,0
1668296624629,ECE 200,030,103615,Morris; Karcher William,9999,0,9999,0
1668296624629,ECE 200,031,103616,Ng; Tse Nga,9999,0,9999,0
1668296624629,ECE 200,032,103617,Nguyen; Truong Quang,9999,0,9999,0
1668296624629,ECE 200,033,103618,Nomura; Kenji,9999,0,9999,0
1668296624629,ECE 200,034,103619,Orlitsky; Alon,9999,0,9999,0
1668296624629,ECE 200,035,103620,Pal; Piya,9999,0,9999,0
1668296624629,ECE 200,036,103621,Papen; George C.,9999,0,9999,0
1668296624629,ECE 200,037,103622,Radic; Stojan,9999,0,9999,0
1668296624629,ECE 200,038,103623,Rao; Bhaskar D.,9999,0,9999,0
1668296624629,ECE 200,039,103624,Rao; Ramesh R,9999,0,9999,0
1668296624629,ECE 200,040,103625,Rebeiz; Gabriel,9999,0,9999,0
1668296624629,ECE 200,041,103626,Sanford; John R,9999,0,9999,0
1668296624629,ECE 200,042,103627,Siegel; Paul H.,9999,0,9999,0
1668296624629,ECE 200,043,103628,Sievenpiper; Daniel F.,9999,0,9999,0
1668296624629,ECE 200,044,103629,Sworder; David D.,9999,0,9999,0
1668296624629,ECE 200,045,103630,Taur; Yuan,9999,0,9999,0
1668296624629,ECE 200,046,103631,Touri; Behrouz,9999,0,9999,0
1668296624629,ECE 200,047,103632,Trivedi; Mohan M.,9999,0,9999,0
1668296624629,ECE 200,048,103633,Vasconcelos; Nuno,9999,0,9999,0
1668296624629,ECE 200,049,103634,Wang; Xiaolong,9999,0,9999,0
1668296624629,ECE 200,050,103635,Xie; Pengtao,9999,0,9999,0
1668296624629,ECE 200,051,103636,Yip; Michael,9999,0,9999,0
1668296624629,ECE 200,052,103637,Zeger; Kenneth A.,999,0,999,0
1668296624629,ECE 200,053,103638,Zhang; Xinyu,9999,0,9999,0
1668296624629,ECE 200,054,103639,Turakhia; Yatish Girish,9999,0,9999,0
1668296624629,ECE 200,055,103640,Kang; Mingu,9999,0,9999,0
1668296624629,ECE 200,056,103641,Shi; Yuanyuan,9999,0,9999,0
1668296624629,ECE 200,057,103642,Wang; Edward Jay,9999,0,9999,0
1668296624629,ECE 200,058,103643,Zheng; Yang,9999,0,9999,0
1668296625062,ECE 202,A00,103644,Kuzum; Duygu,0,0,0,0
1668296625485,ECE 212BN,A00,103646,Ng; Tse Nga,0,0,0,0
1668296625912,ECE 221,A00,111493,Staff,0,0,0,0
1668296626336,ECE 222B,A00,103647,Lomakin; Vitaliy,0,0,0,0
1668296626761,ECE 230B,A00,103648,Taur; Yuan,0,0,0,0
1668296627189,ECE 238B,A00,103649,Garay; Javier,0,0,0,0
1668296627612,ECE 240B,A00,112900,Fainman; Yeshaiahu,0,0,0,0
1668296628051,ECE 247A,A00,103650,Jokerst; Jesse Vincent,0,0,0,0
1668296628472,ECE 247B,A00,103651,Wang; Joseph,0,0,0,0
1668296628908,ECE 250,A00,103652,Siegel; Paul H.,0,0,0,0
1668296629332,ECE 251A,A00,103654,Rao; Bhaskar D.,0,0,0,0
1668296629756,ECE 257B,A00,103655,Bharadia; Dinesh,0,0,0,0
1668296630179,ECE 258A,A00,103656,Milstein; Laurence B.,0,0,0,0
1668296630607,ECE 260B,A00,103658,Kang; Mingu,0,0,0,0
1668296631031,ECE 264A,A00,103659,Galton; Ian A,0,0,0,0
1668296631454,ECE 265A,A00,103661,Gudem; Prasad S.S.,0,0,0,0
1668296631880,ECE 265D,A00,103662,Gudem; Prasad S.S.,0,0,0,0
1668296632302,ECE 268,A00,103663,Koushanfar; Farinaz,0,0,0,0
1668296632728,ECE 269,A01,103665,Pal; Piya,0,0,0,0
1668296633160,ECE 271B,A00,103666,Vasconcelos; Manuela,0,0,0,0
1668296633588,ECE 276A,A00,103667,Atanasov; Nikolay A.,0,0,0,0
1668296634015,ECE 277,A00,103668,An; Cheolhong,0,0,0,0
1668296634438,ECE 279,A00,117947,Hall; Drew A.,0,0,0,0
1668296635299,ECE 283,A00,103670,Hsueh; Tzu-Chien,0,0,0,0
1668296635725,ECE 284,A00,103671,Turakhia; Yatish Girish,0,0,0,0
1668296636150,ECE 285,A00,103672,Zheng; Yang,0,0,0,0
1668296636150,ECE 285,B00,103673,Sworder; David D.,0,0,0,0
1668296636575,ECE 287,A00,103676,Javidi; Tara,0,0,0,0
1668296636999,MATH 200B,A00,098023,Salehi Golsefidy; Alireza,12,0,15,3
1668296637423,MATH 202B,A00,098024,Rhoades; Brendon Patrick,9,0,15,6
1668296637847,MATH 203B,A00,098025,Oprea; Dragos N.,10,0,15,5
1668296638271,MATH 204B,A00,098026,Sorensen; Claus M,13,0,15,2
1668296638696,MATH 208,A00,098027,Izadi; Elham,7,0,10,3
1668296639123,MATH 209,A00,098028,Pollack; Aaron,10,0,10,0
1668296639548,MATH 211A,A00,112919,Rogalski; Daniel,9,0,10,1
1668296639977,MATH 211B,A00,112920,Seward; Brandon M.,9,0,10,1
1668296640404,MATH 218,A00,098029,Li; Bo,10,0,10,0
1668296640827,MATH 220B,A00,098030,Novak; Jonathan I,11,0,15,4
1668296641255,MATH 221A,A00,098031,Ebenfelt; Peter F,13,0,15,2
1668296641679,MATH 231B,A00,098032,Zlatos; Andrej,12,0,15,3
1668296642103,MATH 240B,A00,098033,Ni; Lei,9,0,15,6
1668296642528,MATH 243,A00,098034,Jekel; David Andrew,10,0,10,0
1668296642951,MATH 245A,A00,098035,Nie; Jiawang,0,0,15,16
1668296643376,MATH 248,A00,098036,Bejenaru; Ioan,10,0,10,0
1668296643801,MATH 250B,A00,098037,Spolaor; Luca,14,0,15,1
1668296644228,MATH 258,A00,098038,Ni; Lei,10,0,10,0
1668296644655,MATH 264B,A00,098041,Rhoades; Brendon Patrick,9,0,15,6
1668296645079,MATH 268,A00,098042,Buss; Samuel R,10,0,10,0
1668296645506,MATH 269,A00,098043,Rhoades; Brendon Patrick,10,0,10,0
1668296645932,MATH 270B,A00,098044,Li; Bo,10,0,15,5
1668296646358,MATH 272B,A00,098045,Holst; Michael J,13,0,15,2
1668296646783,MATH 273A,A00,098046,Tian; Xiaochuan,10,0,15,5
1668296647211,MATH 275,A01,098048,Tian; Xiaochuan,6,0,10,4
1668296647634,MATH 278A,A00,098049,Holst; Michael J,8,0,10,2
1668296648058,MATH 278B,A00,098050,Cloninger; Alexander,10,0,10,0
1668296648482,MATH 278C,A00,098051,Nie; Jiawang,7,0,10,3
1668296648905,MATH 280B,A00,098052,Zheng; Tianyi,8,0,15,7
1668296649327,MATH 281B,A00,098053,Bradic; Jelena,1,0,15,14
1668296649754,MATH 282B,A00,098054,Arias-Castro; Ery,0,0,15,15
1668296650179,MATH 285,A00,098055,Fitzsimmons; Patrick J,0,0,15,17
1668296650678,MATH 287B,A00,098056,Arias-Castro; Ery,2,0,15,13
1668296651104,MATH 288,A00,098057,Agarwal; Pooja,9,0,10,1
1668296651104,MATH 288,B00,098058,Zhang; Danna,8,0,10,2
1668296651104,MATH 288,C00,098059,Williams; Ruth J,9,0,10,1
1668296651529,MATH 290B,A00,098060,Roberts; Justin Deritter,13,0,15,2
1668296651954,MATH 292,A00,098061,Belmont; Eva Kinoshita,10,0,10,0
1668296652380,MATH 295,A00,098062,Suk; Andrew Hoon,48,0,50,2
1668296652803,MATH 296,A00,098063,Novak; Jonathan I,20,0,20,0
1668296653227,MATH 297,001,098064,Gamst; Anthony Collins,9997,0,9999,2
1668297151653,COGS 205,A00,101395,Chiba; Andrea,19,0,20,1
1668297152081,COGS 210B,001,101404,Greene; Deanna Jacquelyn,9998,0,9999,1
1668297152081,COGS 210B,002,101417,Xia; Haijun,9999,0,9999,0
1668297152081,COGS 210B,003,101422,Nitz; Douglas A.,9999,0,9999,0
1668297152081,COGS 210B,004,101423,Hollan; James D.,9998,0,9999,1
1668297152081,COGS 210B,005,101424,Deak; Gedeon O.,9998,0,9999,1
1668297152081,COGS 210B,006,101425,Rossano; Federico,9999,0,9999,0
1668297152504,COGS 211B,A00,101427,Coulson; Seana M,9996,0,9999,3
1668297152934,COGS 220,A00,101428,Hollan; James D.,0,0,25,25
1668297153360,COGS 229,A00,101429,Dow; Steven P,18,0,25,7
1668297153782,COGS 230,A00,101430,Klemmer; Scott R,12,0,17,5
1668297154206,COGS 234,A00,101431,Xia; Haijun,1,0,25,24
1668297154630,COGS 260,A00,101432,Kiyonaga; Anastasia,21,0,25,4
1668297154630,COGS 260,B00,101433,Kirsh; David Joel,15,0,25,10
1668297155055,CSE 202,A00,102371,Impagliazzo; Russell,0,0,0,0
1668297155480,CSE 203B,A01,102373,Cheng; Chung Kuan,0,0,0,0
1668297155906,CSE 208,A00,102374,Micciancio; Daniele,0,0,0,0
1668297156329,CSE 209A,A00,112895,Impagliazzo; Russell,0,0,15,15
1668297156752,CSE 209B,A00,108005,Bellare; Mihir,0,0,0,0
1668297157175,CSE 210,A00,113163,Coblenz; Michael J,0,0,0,0
1668297157602,CSE 219,A00,106111,Dow; Steven P,0,0,20,20
1668297158025,CSE 221,A00,102376,Voelker; Geoffrey M.,0,0,0,0
1668297158459,CSE 224,A01,102378,Porter; George M,0,0,0,0
1668297158882,CSE 229A,A00,102379,Savage; Stefan,0,0,0,0
1668297159305,CSE 229C,A00,102380,Munyaka; Imani N. S.,0,0,0,0
1668297159728,CSE 232B,A00,102382,Deutsch; Alin Bernard,0,0,0,0
1668297160153,CSE 234,A01,112904,Kumar; Arun Kumar,0,0,0,0
1668297160577,CSE 237A,A00,102383,Rosing; Tajana Simunic,0,0,0,0
1668297161006,CSE 239A,A00,102384,Deutsch; Alin Bernard,0,0,0,0
1668297161429,CSE 239B,A00,102385,Polikarpova; Nadezhda,0,0,0,0
1668297161853,CSE 240A,A00,102386,Pannuto; Patrick William,0,0,0,0
1668297162276,CSE 240B,A00,102387,Zhao; Jishen,0,0,0,0
1668297162706,CSE 241A,A00,106406,Kang; Mingu,0,0,0,0
1668297163129,CSE 249B,A00,102388,Kahng; Andrew Byun,0,0,8,8
1668297163552,CSE 251B,A01,102392,Cottrell; Garrison W,0,0,0,0
1668297163552,CSE 251B,A02,102393,Cottrell; Garrison W,0,0,0,0
1668297163974,CSE 252B,A00,102394,Ochoa; Benjamin Lawrence,0,0,0,0
1668297164405,CSE 257,A01,102396,Gao; Sicun,0,0,0,0
1668297164830,CSE 272,A00,102397,Li; Tzumao,0,0,0,0
1668297165254,CSE 274,A00,111323,Chern; Albert Ren-Haur,0,0,0,0
1668297165677,CSE 282,A00,102398,Pevzner; Pavel Arkadjevich,0,0,0,0
1668297166103,CSE 284,A00,114175,Gymrek; Melissa Ann,0,0,0,0
1668297166527,CSE 290,A00,102399,Chandraker; Manmohan Krishna,0,0,0,0
1668297166527,CSE 290,B00,102400,Vaccaro; Kristen Marie,0,0,25,25
1668297166527,CSE 290,C00,102414,Pannuto; Patrick William,0,0,25,25
1668297166527,CSE 290,D00,102427,Pevzner; Pavel Arkadjevich,0,0,0,0
1668297166527,CSE 290,E00,102429,Zhao; Jishen,0,0,0,0
1668297166527,CSE 290,F00,102436,Tullsen; Dean Michael,0,0,0,0
1668297166527,CSE 290,G00,102440,Christensen; Henrik I,0,0,20,20
1668297166952,CSE 291,A00,102443,Su; Hao,0,0,0,0
1668297166952,CSE 291,B00,102448,Polikarpova; Nadezhda,0,0,0,0
1668297166952,CSE 291,C00,102453,Vaccaro; Kristen Marie,0,0,0,0
1668297166952,CSE 291,D00,111343,Savage; Stefan,0,0,0,0
1668297166952,CSE 291,E00,116474,Claffy; Kimberly Claire,0,0,0,0
1668297166952,CSE 291,F00,116479,Pasquale; Joseph,0,0,0,0
1668297167385,CSE 293,001,119111,Bafna; Vineet,9999,0,9999,0
1668297167385,CSE 293,002,119118,Bellare; Mihir,9999,0,9999,0
1668297167385,CSE 293,003,119122,Berg-Kirkpatrick; Taylor D,9999,0,9999,0
1668297167385,CSE 293,004,119135,Christensen; Henrik I,9999,0,9999,0
1668297167385,CSE 293,005,119142,Cottrell; Garrison W,9999,0,9999,0
1668297167385,CSE 293,006,119146,Deutsch; Alin Bernard,9999,0,9999,0
1668297167385,CSE 293,007,119159,Esmaeilzadeh; Hadi,9999,0,9999,0
1668297167385,CSE 293,008,119166,Freund; Yoav,9999,0,9999,0
1668297167385,CSE 293,009,119170,Griswold; William G.,9999,0,9999,0
1668297167385,CSE 293,010,119183,Gymrek; Melissa Ann,9999,0,9999,0
1668297167385,CSE 293,011,119190,Heninger; Nadia A,9999,0,9999,0
1668297167385,CSE 293,012,119230,Impagliazzo; Russell,9999,0,9999,0
1668297167385,CSE 293,013,119232,Jhala; Ranjit,9999,0,9999,0
1668297167385,CSE 293,014,119233,Kahng; Andrew Byun,9999,0,9999,0
1668297167385,CSE 293,015,119298,Kane; Daniel Mertz,9999,0,9999,0
1668297167385,CSE 293,016,119299,Kriegman; David J,9999,0,9999,0
1668297167385,CSE 293,017,119300,Kumar; Arun Kumar,9999,0,9999,0
1668297167385,CSE 293,018,119301,Lerner; Sorin,9999,0,9999,0
1668297167385,CSE 293,019,119302,Lovett; Shachar,9999,0,9999,0
1668297167385,CSE 293,020,119303,McAuley; Julian John,9999,0,9999,0
1668297167385,CSE 293,021,119304,Micciancio; Daniele,9999,0,9999,0
1668297167385,CSE 293,022,119367,Orailoglu; Alex,9999,0,9999,0
1668297167385,CSE 293,023,119382,Paturi; Ramamohan,9999,0,9999,0
1668297167385,CSE 293,024,119404,Polikarpova; Nadezhda,9999,0,9999,0
1668297167385,CSE 293,025,119406,Politz; Joseph Gibbs,9999,0,9999,0
1668297167385,CSE 293,026,119411,Porter; George M,9999,0,9999,0
1668297167385,CSE 293,027,119414,Porter; Leonard Emerson,9999,0,9999,0
1668297167385,CSE 293,028,119416,Ramamoorthi; Ravi,9999,0,9999,0
1668297167385,CSE 293,029,119417,Sahoo; Debashis,9999,0,9999,0
1668297167385,CSE 293,030,119420,Saul; Lawrence,9999,0,9999,0
1668297167385,CSE 293,031,119421,Savage; Stefan,9999,0,9999,0
1668297167385,CSE 293,032,119425,Schulze; Jurgen P.,9999,0,9999,0
1668297167385,CSE 293,033,119426,Snoeren; Alex C.,9999,0,9999,0
1668297167385,CSE 293,034,119428,Shang; Jingbo,9999,0,9999,0
1668297167385,CSE 293,035,119430,Stefan; Deian,9999,0,9999,0
1668297167385,CSE 293,036,119431,Su; Hao,9999,0,9999,0
1668297167385,CSE 293,037,119433,Swanson; Steven James,9999,0,9999,0
1668297167385,CSE 293,038,119435,Tullsen; Dean Michael,9999,0,9999,0
1668297167385,CSE 293,039,119483,Voelker; Geoffrey M.,9999,0,9999,0
1668297167385,CSE 293,040,119537,Zhao; Jishen,9999,0,9999,0
1668297167385,CSE 293,041,119538,Zhou; Yuan-Yuan,9999,0,9999,0
1668297167385,CSE 293,042,119539,Gao; Sicun,9999,0,9999,0
1668297167385,CSE 293,043,119540,Weibel; Nadir,9999,0,9999,0
1668297167385,CSE 293,044,119541,Gupta; Rajesh K.,9999,0,9999,0
1668297167385,CSE 293,045,126410,Vaccaro; Kristen Marie,9999,0,9999,0
1668297167385,CSE 293,046,126411,Klemke; Richard,9999,0,9999,0
1668297167812,CSE 294,A00,102459,Voelker; Geoffrey M.,0,0,0,0
1668297167812,CSE 294,B00,111322,Orailoglu; Alex,0,0,0,0
1668297168236,DSE 201,A00,096914,Deutsch; Alin Bernard,30,0,30,0
1668297168661,DSE 210,A00,096915,Dasgupta; Sanjoy,30,0,30,0
1668297169165,DSE 260A,A00,096916,Altintas De Callaf; Ilkay,30,0,30,0
1668297169609,ECE 200,001,103586,Antipa; Nicholas A,9999,0,9999,0
1668297169609,ECE 200,002,103587,Atanasov; Nikolay A.,9999,0,9999,0
1668297169609,ECE 200,003,103588,Bharadia; Dinesh,9999,0,9999,0
1668297169609,ECE 200,004,103589,Cheng; Chung Kuan,9999,0,9999,0
1668297169609,ECE 200,005,103590,Cosman; Pamela C.,9999,0,9999,0
1668297169609,ECE 200,006,103591,Dayeh; Shadi Ahmad,9999,0,9999,0
1668297169609,ECE 200,007,103592,Fainman; Yeshaiahu,9999,0,9999,0
1668297169609,ECE 200,008,103593,Ford; Joseph Earl,9999,0,9999,0
1668297169609,ECE 200,009,103594,Franceschetti; Massimo,9999,0,9999,0
1668297169609,ECE 200,010,103595,Fullerton; Eric E,9999,0,9999,0
1668297169609,ECE 200,011,103596,Galton; Ian A,9999,0,9999,0
1668297169609,ECE 200,012,103597,Gilja; Vikash,9999,0,9999,0
1668297169609,ECE 200,013,103598,Hall; Drew A.,9999,0,9999,0
1668297169609,ECE 200,014,103599,Hsueh; Tzu-Chien,9999,0,9999,0
1668297169609,ECE 200,015,103600,Javidi; Tara,9999,0,9999,0
1668297169609,ECE 200,016,103601,Kahng; Andrew Byun,9999,0,9999,0
1668297169609,ECE 200,017,103602,Kim; Young-Han,9999,0,9999,0
1668297169609,ECE 200,018,103603,Koushanfar; Farinaz,9999,0,9999,0
1668297169609,ECE 200,019,103604,Kuzum; Duygu,9999,0,9999,0
1668297169609,ECE 200,020,103605,Le; Hanh-Phuc,9999,0,9999,0
1668297169609,ECE 200,021,103606,Lin; Bill,9999,0,9999,0
1668297169609,ECE 200,022,103607,Liu; Zhaowei,9998,0,9999,1
1668297169609,ECE 200,023,103608,Lo; Yu-Hwa,9999,0,9999,0
1668297169609,ECE 200,024,103609,Lomakin; Vitaliy,9999,0,9999,0
1668297169609,ECE 200,025,103610,Mercier; Patrick Philip,9999,0,9999,0
1668297169609,ECE 200,026,103611,Meyer; Florian,9999,0,9999,0
1668297169609,ECE 200,027,103612,Milstein; Laurence B.,9999,0,9999,0
1668297169609,ECE 200,028,103613,Mir Arabbaygi; Siavash,9999,0,9999,0
1668297169609,ECE 200,029,103614,Mookherjea; Shayan,9999,0,9999,0
1668297169609,ECE 200,030,103615,Morris; Karcher William,9999,0,9999,0
1668297169609,ECE 200,031,103616,Ng; Tse Nga,9999,0,9999,0
1668297169609,ECE 200,032,103617,Nguyen; Truong Quang,9999,0,9999,0
1668297169609,ECE 200,033,103618,Nomura; Kenji,9999,0,9999,0
1668297169609,ECE 200,034,103619,Orlitsky; Alon,9999,0,9999,0
1668297169609,ECE 200,035,103620,Pal; Piya,9999,0,9999,0
1668297169609,ECE 200,036,103621,Papen; George C.,9999,0,9999,0
1668297169609,ECE 200,037,103622,Radic; Stojan,9999,0,9999,0
1668297169609,ECE 200,038,103623,Rao; Bhaskar D.,9999,0,9999,0
1668297169609,ECE 200,039,103624,Rao; Ramesh R,9999,0,9999,0
1668297169609,ECE 200,040,103625,Rebeiz; Gabriel,9999,0,9999,0
1668297169609,ECE 200,041,103626,Sanford; John R,9999,0,9999,0
1668297169609,ECE 200,042,103627,Siegel; Paul H.,9999,0,9999,0
1668297169609,ECE 200,043,103628,Sievenpiper; Daniel F.,9999,0,9999,0
1668297169609,ECE 200,044,103629,Sworder; David D.,9999,0,9999,0
1668297169609,ECE 200,045,103630,Taur; Yuan,9999,0,9999,0
1668297169609,ECE 200,046,103631,Touri; Behrouz,9999,0,9999,0
1668297169609,ECE 200,047,103632,Trivedi; Mohan M.,9999,0,9999,0
1668297169609,ECE 200,048,103633,Vasconcelos; Nuno,9999,0,9999,0
1668297169609,ECE 200,049,103634,Wang; Xiaolong,9999,0,9999,0
1668297169609,ECE 200,050,103635,Xie; Pengtao,9999,0,9999,0
1668297169609,ECE 200,051,103636,Yip; Michael,9999,0,9999,0
1668297169609,ECE 200,052,103637,Zeger; Kenneth A.,999,0,999,0
1668297169609,ECE 200,053,103638,Zhang; Xinyu,9999,0,9999,0
1668297169609,ECE 200,054,103639,Turakhia; Yatish Girish,9999,0,9999,0
1668297169609,ECE 200,055,103640,Kang; Mingu,9999,0,9999,0
1668297169609,ECE 200,056,103641,Shi; Yuanyuan,9999,0,9999,0
1668297169609,ECE 200,057,103642,Wang; Edward Jay,9999,0,9999,0
1668297169609,ECE 200,058,103643,Zheng; Yang,9999,0,9999,0
1668297170039,ECE 202,A00,103644,Kuzum; Duygu,0,0,0,0
1668297170467,ECE 212BN,A00,103646,Ng; Tse Nga,0,0,0,0
1668297170889,ECE 221,A00,111493,Staff,0,0,0,0
1668297171317,ECE 222B,A00,103647,Lomakin; Vitaliy,0,0,0,0
1668297171740,ECE 230B,A00,103648,Taur; Yuan,0,0,0,0
1668297172165,ECE 238B,A00,103649,Garay; Javier,0,0,0,0
1668297172590,ECE 240B,A00,112900,Fainman; Yeshaiahu,0,0,0,0
1668297173015,ECE 247A,A00,103650,Jokerst; Jesse Vincent,0,0,0,0
1668297173438,ECE 247B,A00,103651,Wang; Joseph,0,0,0,0
1668297173865,ECE 250,A00,103652,Siegel; Paul H.,0,0,0,0
1668297174290,ECE 251A,A00,103654,Rao; Bhaskar D.,0,0,0,0
1668297174712,ECE 257B,A00,103655,Bharadia; Dinesh,0,0,0,0
1668297175136,ECE 258A,A00,103656,Milstein; Laurence B.,0,0,0,0
1668297175558,ECE 260B,A00,103658,Kang; Mingu,0,0,0,0
1668297175982,ECE 264A,A00,103659,Galton; Ian A,0,0,0,0
1668297176405,ECE 265A,A00,103661,Gudem; Prasad S.S.,0,0,0,0
1668297176828,ECE 265D,A00,103662,Gudem; Prasad S.S.,0,0,0,0
1668297177251,ECE 268,A00,103663,Koushanfar; Farinaz,0,0,0,0
1668297177674,ECE 269,A01,103665,Pal; Piya,0,0,0,0
1668297178096,ECE 271B,A00,103666,Vasconcelos; Manuela,0,0,0,0
1668297178520,ECE 276A,A00,103667,Atanasov; Nikolay A.,0,0,0,0
1668297178946,ECE 277,A00,103668,An; Cheolhong,0,0,0,0
1668297179369,ECE 279,A00,117947,Hall; Drew A.,0,0,0,0
1668297180216,ECE 283,A00,103670,Hsueh; Tzu-Chien,0,0,0,0
1668297180640,ECE 284,A00,103671,Turakhia; Yatish Girish,0,0,0,0
1668297181064,ECE 285,A00,103672,Zheng; Yang,0,0,0,0
1668297181064,ECE 285,B00,103673,Sworder; David D.,0,0,0,0
1668297181490,ECE 287,A00,103676,Javidi; Tara,0,0,0,0
1668297181916,MATH 200B,A00,098023,Salehi Golsefidy; Alireza,12,0,15,3
1668297182348,MATH 202B,A00,098024,Rhoades; Brendon Patrick,9,0,15,6
1668297182770,MATH 203B,A00,098025,Oprea; Dragos N.,10,0,15,5
1668297183195,MATH 204B,A00,098026,Sorensen; Claus M,13,0,15,2
1668297183619,MATH 208,A00,098027,Izadi; Elham,7,0,10,3
1668297184043,MATH 209,A00,098028,Pollack; Aaron,10,0,10,0
1668297184467,MATH 211A,A00,112919,Rogalski; Daniel,9,0,10,1
1668297184893,MATH 211B,A00,112920,Seward; Brandon M.,9,0,10,1
1668297185319,MATH 218,A00,098029,Li; Bo,10,0,10,0
1668297185745,MATH 220B,A00,098030,Novak; Jonathan I,11,0,15,4
1668297186172,MATH 221A,A00,098031,Ebenfelt; Peter F,13,0,15,2
1668297186601,MATH 231B,A00,098032,Zlatos; Andrej,12,0,15,3
1668297187023,MATH 240B,A00,098033,Ni; Lei,9,0,15,6
1668297187447,MATH 243,A00,098034,Jekel; David Andrew,10,0,10,0
1668297187872,MATH 245A,A00,098035,Nie; Jiawang,0,0,15,16
1668297188293,MATH 248,A00,098036,Bejenaru; Ioan,10,0,10,0
1668297188718,MATH 250B,A00,098037,Spolaor; Luca,14,0,15,1
1668297189141,MATH 258,A00,098038,Ni; Lei,10,0,10,0
1668297189562,MATH 264B,A00,098041,Rhoades; Brendon Patrick,9,0,15,6
1668297189989,MATH 268,A00,098042,Buss; Samuel R,10,0,10,0
1668297190414,MATH 269,A00,098043,Rhoades; Brendon Patrick,10,0,10,0
1668297190838,MATH 270B,A00,098044,Li; Bo,10,0,15,5
1668297191262,MATH 272B,A00,098045,Holst; Michael J,13,0,15,2
1668297191694,MATH 273A,A00,098046,Tian; Xiaochuan,10,0,15,5
1668297192119,MATH 275,A01,098048,Tian; Xiaochuan,6,0,10,4
1668297192544,MATH 278A,A00,098049,Holst; Michael J,8,0,10,2
1668297192968,MATH 278B,A00,098050,Cloninger; Alexander,10,0,10,0
1668297193391,MATH 278C,A00,098051,Nie; Jiawang,7,0,10,3
1668297193816,MATH 280B,A00,098052,Zheng; Tianyi,8,0,15,7
1668297194241,MATH 281B,A00,098053,Bradic; Jelena,1,0,15,14
1668297194666,MATH 282B,A00,098054,Arias-Castro; Ery,0,0,15,15
1668297195093,MATH 285,A00,098055,Fitzsimmons; Patrick J,0,0,15,17
1668297195516,MATH 287B,A00,098056,Arias-Castro; Ery,2,0,15,13
1668297195940,MATH 288,A00,098057,Agarwal; Pooja,9,0,10,1
1668297195940,MATH 288,B00,098058,Zhang; Danna,8,0,10,2
1668297195940,MATH 288,C00,098059,Williams; Ruth J,9,0,10,1
1668297196363,MATH 290B,A00,098060,Roberts; Justin Deritter,13,0,15,2
1668297196786,MATH 292,A00,098061,Belmont; Eva Kinoshita,10,0,10,0
1668297197210,MATH 295,A00,098062,Suk; Andrew Hoon,48,0,50,2
1668297197632,MATH 296,A00,098063,Novak; Jonathan I,20,0,20,0
1668297198059,MATH 297,001,098064,Gamst; Anthony Collins,9997,0,9999,2
1668297696803,COGS 205,A00,101395,Chiba; Andrea,19,0,20,1
1668297697225,COGS 210B,001,101404,Greene; Deanna Jacquelyn,9998,0,9999,1
1668297697225,COGS 210B,002,101417,Xia; Haijun,9999,0,9999,0
1668297697225,COGS 210B,003,101422,Nitz; Douglas A.,9999,0,9999,0
1668297697225,COGS 210B,004,101423,Hollan; James D.,9998,0,9999,1
1668297697225,COGS 210B,005,101424,Deak; Gedeon O.,9998,0,9999,1
1668297697225,COGS 210B,006,101425,Rossano; Federico,9999,0,9999,0
1668297697651,COGS 211B,A00,101427,Coulson; Seana M,9996,0,9999,3
1668297698075,COGS 220,A00,101428,Hollan; James D.,0,0,25,25
1668297698503,COGS 229,A00,101429,Dow; Steven P,18,0,25,7
1668297698930,COGS 230,A00,101430,Klemmer; Scott R,12,0,17,5
1668297699355,COGS 234,A00,101431,Xia; Haijun,1,0,25,24
1668297699782,COGS 260,A00,101432,Kiyonaga; Anastasia,21,0,25,4
1668297699782,COGS 260,B00,101433,Kirsh; David Joel,15,0,25,10
1668297700207,CSE 202,A00,102371,Impagliazzo; Russell,0,0,0,0
1668297700634,CSE 203B,A01,102373,Cheng; Chung Kuan,0,0,0,0
1668297701057,CSE 208,A00,102374,Micciancio; Daniele,0,0,0,0
1668297701483,CSE 209A,A00,112895,Impagliazzo; Russell,0,0,15,15
1668297701908,CSE 209B,A00,108005,Bellare; Mihir,0,0,0,0
1668297702331,CSE 210,A00,113163,Coblenz; Michael J,0,0,0,0
1668297702755,CSE 219,A00,106111,Dow; Steven P,0,0,20,20
1668297703182,CSE 221,A00,102376,Voelker; Geoffrey M.,0,0,0,0
1668297703604,CSE 224,A01,102378,Porter; George M,0,0,0,0
1668297704033,CSE 229A,A00,102379,Savage; Stefan,0,0,0,0
1668297704456,CSE 229C,A00,102380,Munyaka; Imani N. S.,0,0,0,0
1668297704888,CSE 232B,A00,102382,Deutsch; Alin Bernard,0,0,0,0
1668297705311,CSE 234,A01,112904,Kumar; Arun Kumar,0,0,0,0
1668297705734,CSE 237A,A00,102383,Rosing; Tajana Simunic,0,0,0,0
1668297706158,CSE 239A,A00,102384,Deutsch; Alin Bernard,0,0,0,0
1668297706609,CSE 239B,A00,102385,Polikarpova; Nadezhda,0,0,0,0
1668297707033,CSE 240A,A00,102386,Pannuto; Patrick William,0,0,0,0
1668297707458,CSE 240B,A00,102387,Zhao; Jishen,0,0,0,0
1668297707886,CSE 241A,A00,106406,Kang; Mingu,0,0,0,0
1668297708319,CSE 249B,A00,102388,Kahng; Andrew Byun,0,0,8,8
1668297708741,CSE 251B,A01,102392,Cottrell; Garrison W,0,0,0,0
1668297708741,CSE 251B,A02,102393,Cottrell; Garrison W,0,0,0,0
1668297709168,CSE 252B,A00,102394,Ochoa; Benjamin Lawrence,0,0,0,0
1668297709590,CSE 257,A01,102396,Gao; Sicun,0,0,0,0
1668297710018,CSE 272,A00,102397,Li; Tzumao,0,0,0,0
1668297710443,CSE 274,A00,111323,Chern; Albert Ren-Haur,0,0,0,0
1668297710874,CSE 282,A00,102398,Pevzner; Pavel Arkadjevich,0,0,0,0
1668297711297,CSE 284,A00,114175,Gymrek; Melissa Ann,0,0,0,0
1668297711723,CSE 290,A00,102399,Chandraker; Manmohan Krishna,0,0,0,0
1668297711723,CSE 290,B00,102400,Vaccaro; Kristen Marie,0,0,25,25
1668297711723,CSE 290,C00,102414,Pannuto; Patrick William,0,0,25,25
1668297711723,CSE 290,D00,102427,Pevzner; Pavel Arkadjevich,0,0,0,0
1668297711723,CSE 290,E00,102429,Zhao; Jishen,0,0,0,0
1668297711723,CSE 290,F00,102436,Tullsen; Dean Michael,0,0,0,0
1668297711723,CSE 290,G00,102440,Christensen; Henrik I,0,0,20,20
1668297712150,CSE 291,A00,102443,Su; Hao,0,0,0,0
1668297712150,CSE 291,B00,102448,Polikarpova; Nadezhda,0,0,0,0
1668297712150,CSE 291,C00,102453,Vaccaro; Kristen Marie,0,0,0,0
1668297712150,CSE 291,D00,111343,Savage; Stefan,0,0,0,0
1668297712150,CSE 291,E00,116474,Claffy; Kimberly Claire,0,0,0,0
1668297712150,CSE 291,F00,116479,Pasquale; Joseph,0,0,0,0
1668297712578,CSE 293,001,119111,Bafna; Vineet,9999,0,9999,0
1668297712578,CSE 293,002,119118,Bellare; Mihir,9999,0,9999,0
1668297712578,CSE 293,003,119122,Berg-Kirkpatrick; Taylor D,9999,0,9999,0
1668297712578,CSE 293,004,119135,Christensen; Henrik I,9999,0,9999,0
1668297712578,CSE 293,005,119142,Cottrell; Garrison W,9999,0,9999,0
1668297712578,CSE 293,006,119146,Deutsch; Alin Bernard,9999,0,9999,0
1668297712578,CSE 293,007,119159,Esmaeilzadeh; Hadi,9999,0,9999,0
1668297712578,CSE 293,008,119166,Freund; Yoav,9999,0,9999,0
1668297712578,CSE 293,009,119170,Griswold; William G.,9999,0,9999,0
1668297712578,CSE 293,010,119183,Gymrek; Melissa Ann,9999,0,9999,0
1668297712578,CSE 293,011,119190,Heninger; Nadia A,9999,0,9999,0
1668297712578,CSE 293,012,119230,Impagliazzo; Russell,9999,0,9999,0
1668297712578,CSE 293,013,119232,Jhala; Ranjit,9999,0,9999,0
1668297712578,CSE 293,014,119233,Kahng; Andrew Byun,9999,0,9999,0
1668297712578,CSE 293,015,119298,Kane; Daniel Mertz,9999,0,9999,0
1668297712578,CSE 293,016,119299,Kriegman; David J,9999,0,9999,0
1668297712578,CSE 293,017,119300,Kumar; Arun Kumar,9999,0,9999,0
1668297712578,CSE 293,018,119301,Lerner; Sorin,9999,0,9999,0
1668297712578,CSE 293,019,119302,Lovett; Shachar,9999,0,9999,0
1668297712578,CSE 293,020,119303,McAuley; Julian John,9999,0,9999,0
1668297712578,CSE 293,021,119304,Micciancio; Daniele,9999,0,9999,0
1668297712578,CSE 293,022,119367,Orailoglu; Alex,9999,0,9999,0
1668297712578,CSE 293,023,119382,Paturi; Ramamohan,9999,0,9999,0
1668297712578,CSE 293,024,119404,Polikarpova; Nadezhda,9999,0,9999,0
1668297712578,CSE 293,025,119406,Politz; Joseph Gibbs,9999,0,9999,0
1668297712578,CSE 293,026,119411,Porter; George M,9999,0,9999,0
1668297712578,CSE 293,027,119414,Porter; Leonard Emerson,9999,0,9999,0
1668297712578,CSE 293,028,119416,Ramamoorthi; Ravi,9999,0,9999,0
1668297712578,CSE 293,029,119417,Sahoo; Debashis,9999,0,9999,0
1668297712578,CSE 293,030,119420,Saul; Lawrence,9999,0,9999,0
1668297712578,CSE 293,031,119421,Savage; Stefan,9999,0,9999,0
1668297712578,CSE 293,032,119425,Schulze; Jurgen P.,9999,0,9999,0
1668297712578,CSE 293,033,119426,Snoeren; Alex C.,9999,0,9999,0
1668297712578,CSE 293,034,119428,Shang; Jingbo,9999,0,9999,0
1668297712578,CSE 293,035,119430,Stefan; Deian,9999,0,9999,0
1668297712578,CSE 293,036,119431,Su; Hao,9999,0,9999,0
1668297712578,CSE 293,037,119433,Swanson; Steven James,9999,0,9999,0
1668297712578,CSE 293,038,119435,Tullsen; Dean Michael,9999,0,9999,0
1668297712578,CSE 293,039,119483,Voelker; Geoffrey M.,9999,0,9999,0
1668297712578,CSE 293,040,119537,Zhao; Jishen,9999,0,9999,0
1668297712578,CSE 293,041,119538,Zhou; Yuan-Yuan,9999,0,9999,0
1668297712578,CSE 293,042,119539,Gao; Sicun,9999,0,9999,0
1668297712578,CSE 293,043,119540,Weibel; Nadir,9999,0,9999,0
1668297712578,CSE 293,044,119541,Gupta; Rajesh K.,9999,0,9999,0
1668297712578,CSE 293,045,126410,Vaccaro; Kristen Marie,9999,0,9999,0
1668297712578,CSE 293,046,126411,Klemke; Richard,9999,0,9999,0
1668297713002,CSE 294,A00,102459,Voelker; Geoffrey M.,0,0,0,0
1668297713002,CSE 294,B00,111322,Orailoglu; Alex,0,0,0,0
1668297713427,DSE 201,A00,096914,Deutsch; Alin Bernard,30,0,30,0
1668297713851,DSE 210,A00,096915,Dasgupta; Sanjoy,30,0,30,0
1668297714278,DSE 260A,A00,096916,Altintas De Callaf; Ilkay,30,0,30,0
1668297714712,ECE 200,001,103586,Antipa; Nicholas A,9999,0,9999,0
1668297714712,ECE 200,002,103587,Atanasov; Nikolay A.,9999,0,9999,0
1668297714712,ECE 200,003,103588,Bharadia; Dinesh,9999,0,9999,0
1668297714712,ECE 200,004,103589,Cheng; Chung Kuan,9999,0,9999,0
1668297714712,ECE 200,005,103590,Cosman; Pamela C.,9999,0,9999,0
1668297714712,ECE 200,006,103591,Dayeh; Shadi Ahmad,9999,0,9999,0
1668297714712,ECE 200,007,103592,Fainman; Yeshaiahu,9999,0,9999,0
1668297714712,ECE 200,008,103593,Ford; Joseph Earl,9999,0,9999,0
1668297714712,ECE 200,009,103594,Franceschetti; Massimo,9999,0,9999,0
1668297714712,ECE 200,010,103595,Fullerton; Eric E,9999,0,9999,0
1668297714712,ECE 200,011,103596,Galton; Ian A,9999,0,9999,0
1668297714712,ECE 200,012,103597,Gilja; Vikash,9999,0,9999,0
1668297714712,ECE 200,013,103598,Hall; Drew A.,9999,0,9999,0
1668297714712,ECE 200,014,103599,Hsueh; Tzu-Chien,9999,0,9999,0
1668297714712,ECE 200,015,103600,Javidi; Tara,9999,0,9999,0
1668297714712,ECE 200,016,103601,Kahng; Andrew Byun,9999,0,9999,0
1668297714712,ECE 200,017,103602,Kim; Young-Han,9999,0,9999,0
1668297714712,ECE 200,018,103603,Koushanfar; Farinaz,9999,0,9999,0
1668297714712,ECE 200,019,103604,Kuzum; Duygu,9999,0,9999,0
1668297714712,ECE 200,020,103605,Le; Hanh-Phuc,9999,0,9999,0
1668297714712,ECE 200,021,103606,Lin; Bill,9999,0,9999,0
1668297714712,ECE 200,022,103607,Liu; Zhaowei,9998,0,9999,1
1668297714712,ECE 200,023,103608,Lo; Yu-Hwa,9999,0,9999,0
1668297714712,ECE 200,024,103609,Lomakin; Vitaliy,9999,0,9999,0
1668297714712,ECE 200,025,103610,Mercier; Patrick Philip,9999,0,9999,0
1668297714712,ECE 200,026,103611,Meyer; Florian,9999,0,9999,0
1668297714712,ECE 200,027,103612,Milstein; Laurence B.,9999,0,9999,0
1668297714712,ECE 200,028,103613,Mir Arabbaygi; Siavash,9999,0,9999,0
1668297714712,ECE 200,029,103614,Mookherjea; Shayan,9999,0,9999,0
1668297714712,ECE 200,030,103615,Morris; Karcher William,9999,0,9999,0
1668297714712,ECE 200,031,103616,Ng; Tse Nga,9999,0,9999,0
1668297714712,ECE 200,032,103617,Nguyen; Truong Quang,9999,0,9999,0
1668297714712,ECE 200,033,103618,Nomura; Kenji,9999,0,9999,0
1668297714712,ECE 200,034,103619,Orlitsky; Alon,9999,0,9999,0
1668297714712,ECE 200,035,103620,Pal; Piya,9999,0,9999,0
1668297714712,ECE 200,036,103621,Papen; George C.,9999,0,9999,0
1668297714712,ECE 200,037,103622,Radic; Stojan,9999,0,9999,0
1668297714712,ECE 200,038,103623,Rao; Bhaskar D.,9999,0,9999,0
1668297714712,ECE 200,039,103624,Rao; Ramesh R,9999,0,9999,0
1668297714712,ECE 200,040,103625,Rebeiz; Gabriel,9999,0,9999,0
1668297714712,ECE 200,041,103626,Sanford; John R,9999,0,9999,0
1668297714712,ECE 200,042,103627,Siegel; Paul H.,9999,0,9999,0
1668297714712,ECE 200,043,103628,Sievenpiper; Daniel F.,9999,0,9999,0
1668297714712,ECE 200,044,103629,Sworder; David D.,9999,0,9999,0
1668297714712,ECE 200,045,103630,Taur; Yuan,9999,0,9999,0
1668297714712,ECE 200,046,103631,Touri; Behrouz,9999,0,9999,0
1668297714712,ECE 200,047,103632,Trivedi; Mohan M.,9999,0,9999,0
1668297714712,ECE 200,048,103633,Vasconcelos; Nuno,9999,0,9999,0
1668297714712,ECE 200,049,103634,Wang; Xiaolong,9999,0,9999,0
1668297714712,ECE 200,050,103635,Xie; Pengtao,9999,0,9999,0
1668297714712,ECE 200,051,103636,Yip; Michael,9999,0,9999,0
1668297714712,ECE 200,052,103637,Zeger; Kenneth A.,999,0,999,0
1668297714712,ECE 200,053,103638,Zhang; Xinyu,9999,0,9999,0
1668297714712,ECE 200,054,103639,Turakhia; Yatish Girish,9999,0,9999,0
1668297714712,ECE 200,055,103640,Kang; Mingu,9999,0,9999,0
1668297714712,ECE 200,056,103641,Shi; Yuanyuan,9999,0,9999,0
1668297714712,ECE 200,057,103642,Wang; Edward Jay,9999,0,9999,0
1668297714712,ECE 200,058,103643,Zheng; Yang,9999,0,9999,0
1668297715135,ECE 202,A00,103644,Kuzum; Duygu,0,0,0,0
1668297715561,ECE 212BN,A00,103646,Ng; Tse Nga,0,0,0,0
1668297715994,ECE 221,A00,111493,Staff,0,0,0,0
1668297716424,ECE 222B,A00,103647,Lomakin; Vitaliy,0,0,0,0
1668297716848,ECE 230B,A00,103648,Taur; Yuan,0,0,0,0
1668297717272,ECE 238B,A00,103649,Garay; Javier,0,0,0,0
1668297717697,ECE 240B,A00,112900,Fainman; Yeshaiahu,0,0,0,0
1668297718124,ECE 247A,A00,103650,Jokerst; Jesse Vincent,0,0,0,0
1668297718554,ECE 247B,A00,103651,Wang; Joseph,0,0,0,0
1668297718981,ECE 250,A00,103652,Siegel; Paul H.,0,0,0,0
1668297719406,ECE 251A,A00,103654,Rao; Bhaskar D.,0,0,0,0
1668297719831,ECE 257B,A00,103655,Bharadia; Dinesh,0,0,0,0
1668297720267,ECE 258A,A00,103656,Milstein; Laurence B.,0,0,0,0
1668297720689,ECE 260B,A00,103658,Kang; Mingu,0,0,0,0
1668297721127,ECE 264A,A00,103659,Galton; Ian A,0,0,0,0
1668297721551,ECE 265A,A00,103661,Gudem; Prasad S.S.,0,0,0,0
1668297721975,ECE 265D,A00,103662,Gudem; Prasad S.S.,0,0,0,0
1668297722402,ECE 268,A00,103663,Koushanfar; Farinaz,0,0,0,0
1668297722824,ECE 269,A01,103665,Pal; Piya,0,0,0,0
1668297723266,ECE 271B,A00,103666,Vasconcelos; Manuela,0,0,0,0
1668297723698,ECE 276A,A00,103667,Atanasov; Nikolay A.,0,0,0,0
1668297724133,ECE 277,A00,103668,An; Cheolhong,0,0,0,0
1668297724561,ECE 279,A00,117947,Hall; Drew A.,0,0,0,0
1668297725411,ECE 283,A00,103670,Hsueh; Tzu-Chien,0,0,0,0
1668297725838,ECE 284,A00,103671,Turakhia; Yatish Girish,0,0,0,0
1668297726270,ECE 285,A00,103672,Zheng; Yang,0,0,0,0
1668297726270,ECE 285,B00,103673,Sworder; David D.,0,0,0,0
1668297726694,ECE 287,A00,103676,Javidi; Tara,0,0,0,0
1668297727118,MATH 200B,A00,098023,Salehi Golsefidy; Alireza,12,0,15,3
1668297727543,MATH 202B,A00,098024,Rhoades; Brendon Patrick,9,0,15,6
1668297727967,MATH 203B,A00,098025,Oprea; Dragos N.,10,0,15,5
1668297728392,MATH 204B,A00,098026,Sorensen; Claus M,13,0,15,2
1668297728818,MATH 208,A00,098027,Izadi; Elham,7,0,10,3
1668297729240,MATH 209,A00,098028,Pollack; Aaron,10,0,10,0
1668297729663,MATH 211A,A00,112919,Rogalski; Daniel,9,0,10,1
1668297730086,MATH 211B,A00,112920,Seward; Brandon M.,9,0,10,1
1668297730510,MATH 218,A00,098029,Li; Bo,10,0,10,0
1668297731016,MATH 220B,A00,098030,Novak; Jonathan I,11,0,15,4
1668297731441,MATH 221A,A00,098031,Ebenfelt; Peter F,13,0,15,2
1668297731865,MATH 231B,A00,098032,Zlatos; Andrej,12,0,15,3
1668297732288,MATH 240B,A00,098033,Ni; Lei,9,0,15,6
1668297732712,MATH 243,A00,098034,Jekel; David Andrew,10,0,10,0
1668297733138,MATH 245A,A00,098035,Nie; Jiawang,0,0,15,16
1668297733563,MATH 248,A00,098036,Bejenaru; Ioan,10,0,10,0
1668297733987,MATH 250B,A00,098037,Spolaor; Luca,14,0,15,1
1668297734412,MATH 258,A00,098038,Ni; Lei,10,0,10,0
1668297734835,MATH 264B,A00,098041,Rhoades; Brendon Patrick,9,0,15,6
1668297735267,MATH 268,A00,098042,Buss; Samuel R,10,0,10,0
1668297735695,MATH 269,A00,098043,Rhoades; Brendon Patrick,10,0,10,0
1668297736122,MATH 270B,A00,098044,Li; Bo,10,0,15,5
1668297736547,MATH 272B,A00,098045,Holst; Michael J,13,0,15,2
1668297736978,MATH 273A,A00,098046,Tian; Xiaochuan,10,0,15,5
1668297737401,MATH 275,A01,098048,Tian; Xiaochuan,6,0,10,4
1668297737824,MATH 278A,A00,098049,Holst; Michael J,8,0,10,2
1668297738250,MATH 278B,A00,098050,Cloninger; Alexander,10,0,10,0
1668297738675,MATH 278C,A00,098051,Nie; Jiawang,7,0,10,3
1668297739100,MATH 280B,A00,098052,Zheng; Tianyi,8,0,15,7
1668297739522,MATH 281B,A00,098053,Bradic; Jelena,1,0,15,14
1668297739947,MATH 282B,A00,098054,Arias-Castro; Ery,0,0,15,15
1668297740375,MATH 285,A00,098055,Fitzsimmons; Patrick J,0,0,15,17
1668297740803,MATH 287B,A00,098056,Arias-Castro; Ery,2,0,15,13
1668297741226,MATH 288,A00,098057,Agarwal; Pooja,9,0,10,1
1668297741226,MATH 288,B00,098058,Zhang; Danna,8,0,10,2
1668297741226,MATH 288,C00,098059,Williams; Ruth J,9,0,10,1
1668297741649,MATH 290B,A00,098060,Roberts; Justin Deritter,13,0,15,2
1668297742075,MATH 292,A00,098061,Belmont; Eva Kinoshita,10,0,10,0
1668297742508,MATH 295,A00,098062,Suk; Andrew Hoon,48,0,50,2
1668297742932,MATH 296,A00,098063,Novak; Jonathan I,20,0,20,0
1668297743358,MATH 297,001,098064,Gamst; Anthony Collins,9997,0,9999,2
1668298242268,COGS 205,A00,101395,Chiba; Andrea,19,0,20,1
1668298242696,COGS 210B,001,101404,Greene; Deanna Jacquelyn,9998,0,9999,1
1668298242696,COGS 210B,002,101417,Xia; Haijun,9999,0,9999,0
1668298242696,COGS 210B,003,101422,Nitz; Douglas A.,9999,0,9999,0
1668298242696,COGS 210B,004,101423,Hollan; James D.,9998,0,9999,1
1668298242696,COGS 210B,005,101424,Deak; Gedeon O.,9998,0,9999,1
1668298242696,COGS 210B,006,101425,Rossano; Federico,9999,0,9999,0
1668298243139,COGS 211B,A00,101427,Coulson; Seana M,9996,0,9999,3
1668298243562,COGS 220,A00,101428,Hollan; James D.,0,0,25,25
1668298243985,COGS 229,A00,101429,Dow; Steven P,18,0,25,7
1668298244411,COGS 230,A00,101430,Klemmer; Scott R,12,0,17,5
1668298244838,COGS 234,A00,101431,Xia; Haijun,1,0,25,24
1668298245265,COGS 260,A00,101432,Kiyonaga; Anastasia,21,0,25,4
1668298245265,COGS 260,B00,101433,Kirsh; David Joel,15,0,25,10
1668298245686,CSE 202,A00,102371,Impagliazzo; Russell,0,0,0,0
1668298246114,CSE 203B,A01,102373,Cheng; Chung Kuan,0,0,0,0
1668298246540,CSE 208,A00,102374,Micciancio; Daniele,0,0,0,0
1668298246965,CSE 209A,A00,112895,Impagliazzo; Russell,0,0,15,15
1668298247387,CSE 209B,A00,108005,Bellare; Mihir,0,0,0,0
1668298247810,CSE 210,A00,113163,Coblenz; Michael J,0,0,0,0
1668298248234,CSE 219,A00,106111,Dow; Steven P,0,0,20,20
1668298248661,CSE 221,A00,102376,Voelker; Geoffrey M.,0,0,0,0
1668298249087,CSE 224,A01,102378,Porter; George M,0,0,0,0
1668298249516,CSE 229A,A00,102379,Savage; Stefan,0,0,0,0
1668298250019,CSE 229C,A00,102380,Munyaka; Imani N. S.,0,0,0,0
1668298250446,CSE 232B,A00,102382,Deutsch; Alin Bernard,0,0,0,0
1668298250869,CSE 234,A01,112904,Kumar; Arun Kumar,0,0,0,0
1668298251298,CSE 237A,A00,102383,Rosing; Tajana Simunic,0,0,0,0
1668298251723,CSE 239A,A00,102384,Deutsch; Alin Bernard,0,0,0,0
1668298252148,CSE 239B,A00,102385,Polikarpova; Nadezhda,0,0,0,0
1668298252576,CSE 240A,A00,102386,Pannuto; Patrick William,0,0,0,0
1668298252999,CSE 240B,A00,102387,Zhao; Jishen,0,0,0,0
1668298253421,CSE 241A,A00,106406,Kang; Mingu,0,0,0,0
1668298253847,CSE 249B,A00,102388,Kahng; Andrew Byun,0,0,8,8
1668298254270,CSE 251B,A01,102392,Cottrell; Garrison W,0,0,0,0
1668298254270,CSE 251B,A02,102393,Cottrell; Garrison W,0,0,0,0
1668298254695,CSE 252B,A00,102394,Ochoa; Benjamin Lawrence,0,0,0,0
1668298255123,CSE 257,A01,102396,Gao; Sicun,0,0,0,0
1668298255549,CSE 272,A00,102397,Li; Tzumao,0,0,0,0
1668298255975,CSE 274,A00,111323,Chern; Albert Ren-Haur,0,0,0,0
1668298256410,CSE 282,A00,102398,Pevzner; Pavel Arkadjevich,0,0,0,0
1668298256838,CSE 284,A00,114175,Gymrek; Melissa Ann,0,0,0,0
1668298257266,CSE 290,A00,102399,Chandraker; Manmohan Krishna,0,0,0,0
1668298257266,CSE 290,B00,102400,Vaccaro; Kristen Marie,0,0,25,25
1668298257266,CSE 290,C00,102414,Pannuto; Patrick William,0,0,25,25
1668298257266,CSE 290,D00,102427,Pevzner; Pavel Arkadjevich,0,0,0,0
1668298257266,CSE 290,E00,102429,Zhao; Jishen,0,0,0,0
1668298257266,CSE 290,F00,102436,Tullsen; Dean Michael,0,0,0,0
1668298257266,CSE 290,G00,102440,Christensen; Henrik I,0,0,20,20
1668298257690,CSE 291,A00,102443,Su; Hao,0,0,0,0
1668298257690,CSE 291,B00,102448,Polikarpova; Nadezhda,0,0,0,0
1668298257690,CSE 291,C00,102453,Vaccaro; Kristen Marie,0,0,0,0
1668298257690,CSE 291,D00,111343,Savage; Stefan,0,0,0,0
1668298257690,CSE 291,E00,116474,Claffy; Kimberly Claire,0,0,0,0
1668298257690,CSE 291,F00,116479,Pasquale; Joseph,0,0,0,0
1668298258124,CSE 293,001,119111,Bafna; Vineet,9999,0,9999,0
1668298258124,CSE 293,002,119118,Bellare; Mihir,9999,0,9999,0
1668298258124,CSE 293,003,119122,Berg-Kirkpatrick; Taylor D,9999,0,9999,0
1668298258124,CSE 293,004,119135,Christensen; Henrik I,9999,0,9999,0
1668298258124,CSE 293,005,119142,Cottrell; Garrison W,9999,0,9999,0
1668298258124,CSE 293,006,119146,Deutsch; Alin Bernard,9999,0,9999,0
1668298258124,CSE 293,007,119159,Esmaeilzadeh; Hadi,9999,0,9999,0
1668298258124,CSE 293,008,119166,Freund; Yoav,9999,0,9999,0
1668298258124,CSE 293,009,119170,Griswold; William G.,9999,0,9999,0
1668298258124,CSE 293,010,119183,Gymrek; Melissa Ann,9999,0,9999,0
1668298258124,CSE 293,011,119190,Heninger; Nadia A,9999,0,9999,0
1668298258124,CSE 293,012,119230,Impagliazzo; Russell,9999,0,9999,0
1668298258124,CSE 293,013,119232,Jhala; Ranjit,9999,0,9999,0
1668298258124,CSE 293,014,119233,Kahng; Andrew Byun,9999,0,9999,0
1668298258124,CSE 293,015,119298,Kane; Daniel Mertz,9999,0,9999,0
1668298258124,CSE 293,016,119299,Kriegman; David J,9999,0,9999,0
1668298258124,CSE 293,017,119300,Kumar; Arun Kumar,9999,0,9999,0
1668298258124,CSE 293,018,119301,Lerner; Sorin,9999,0,9999,0
1668298258124,CSE 293,019,119302,Lovett; Shachar,9999,0,9999,0
1668298258124,CSE 293,020,119303,McAuley; Julian John,9999,0,9999,0
1668298258124,CSE 293,021,119304,Micciancio; Daniele,9999,0,9999,0
1668298258124,CSE 293,022,119367,Orailoglu; Alex,9999,0,9999,0
1668298258124,CSE 293,023,119382,Paturi; Ramamohan,9999,0,9999,0
1668298258124,CSE 293,024,119404,Polikarpova; Nadezhda,9999,0,9999,0
1668298258124,CSE 293,025,119406,Politz; Joseph Gibbs,9999,0,9999,0
1668298258124,CSE 293,026,119411,Porter; George M,9999,0,9999,0
1668298258124,CSE 293,027,119414,Porter; Leonard Emerson,9999,0,9999,0
1668298258124,CSE 293,028,119416,Ramamoorthi; Ravi,9999,0,9999,0
1668298258124,CSE 293,029,119417,Sahoo; Debashis,9999,0,9999,0
1668298258124,CSE 293,030,119420,Saul; Lawrence,9999,0,9999,0
1668298258124,CSE 293,031,119421,Savage; Stefan,9999,0,9999,0
1668298258124,CSE 293,032,119425,Schulze; Jurgen P.,9999,0,9999,0
1668298258124,CSE 293,033,119426,Snoeren; Alex C.,9999,0,9999,0
1668298258124,CSE 293,034,119428,Shang; Jingbo,9999,0,9999,0
1668298258124,CSE 293,035,119430,Stefan; Deian,9999,0,9999,0
1668298258124,CSE 293,036,119431,Su; Hao,9999,0,9999,0
1668298258124,CSE 293,037,119433,Swanson; Steven James,9999,0,9999,0
1668298258124,CSE 293,038,119435,Tullsen; Dean Michael,9999,0,9999,0
1668298258124,CSE 293,039,119483,Voelker; Geoffrey M.,9999,0,9999,0
1668298258124,CSE 293,040,119537,Zhao; Jishen,9999,0,9999,0
1668298258124,CSE 293,041,119538,Zhou; Yuan-Yuan,9999,0,9999,0
1668298258124,CSE 293,042,119539,Gao; Sicun,9999,0,9999,0
1668298258124,CSE 293,043,119540,Weibel; Nadir,9999,0,9999,0
1668298258124,CSE 293,044,119541,Gupta; Rajesh K.,9999,0,9999,0
1668298258124,CSE 293,045,126410,Vaccaro; Kristen Marie,9999,0,9999,0
1668298258124,CSE 293,046,126411,Klemke; Richard,9999,0,9999,0
1668298258550,CSE 294,A00,102459,Voelker; Geoffrey M.,0,0,0,0
1668298258550,CSE 294,B00,111322,Orailoglu; Alex,0,0,0,0
1668298258975,DSE 201,A00,096914,Deutsch; Alin Bernard,30,0,30,0
1668298259399,DSE 210,A00,096915,Dasgupta; Sanjoy,30,0,30,0
1668298259824,DSE 260A,A00,096916,Altintas De Callaf; Ilkay,30,0,30,0
1668298260263,ECE 200,001,103586,Antipa; Nicholas A,9999,0,9999,0
1668298260263,ECE 200,002,103587,Atanasov; Nikolay A.,9999,0,9999,0
1668298260263,ECE 200,003,103588,Bharadia; Dinesh,9999,0,9999,0
1668298260263,ECE 200,004,103589,Cheng; Chung Kuan,9999,0,9999,0
1668298260263,ECE 200,005,103590,Cosman; Pamela C.,9999,0,9999,0
1668298260263,ECE 200,006,103591,Dayeh; Shadi Ahmad,9999,0,9999,0
1668298260263,ECE 200,007,103592,Fainman; Yeshaiahu,9999,0,9999,0
1668298260263,ECE 200,008,103593,Ford; Joseph Earl,9999,0,9999,0
1668298260263,ECE 200,009,103594,Franceschetti; Massimo,9999,0,9999,0
1668298260263,ECE 200,010,103595,Fullerton; Eric E,9999,0,9999,0
1668298260263,ECE 200,011,103596,Galton; Ian A,9999,0,9999,0
1668298260263,ECE 200,012,103597,Gilja; Vikash,9999,0,9999,0
1668298260263,ECE 200,013,103598,Hall; Drew A.,9999,0,9999,0
1668298260263,ECE 200,014,103599,Hsueh; Tzu-Chien,9999,0,9999,0
1668298260263,ECE 200,015,103600,Javidi; Tara,9999,0,9999,0
1668298260263,ECE 200,016,103601,Kahng; Andrew Byun,9999,0,9999,0
1668298260263,ECE 200,017,103602,Kim; Young-Han,9999,0,9999,0
1668298260263,ECE 200,018,103603,Koushanfar; Farinaz,9999,0,9999,0
1668298260263,ECE 200,019,103604,Kuzum; Duygu,9999,0,9999,0
1668298260263,ECE 200,020,103605,Le; Hanh-Phuc,9999,0,9999,0
1668298260263,ECE 200,021,103606,Lin; Bill,9999,0,9999,0
1668298260263,ECE 200,022,103607,Liu; Zhaowei,9998,0,9999,1
1668298260263,ECE 200,023,103608,Lo; Yu-Hwa,9999,0,9999,0
1668298260263,ECE 200,024,103609,Lomakin; Vitaliy,9999,0,9999,0
1668298260263,ECE 200,025,103610,Mercier; Patrick Philip,9999,0,9999,0
1668298260263,ECE 200,026,103611,Meyer; Florian,9999,0,9999,0
1668298260263,ECE 200,027,103612,Milstein; Laurence B.,9999,0,9999,0
1668298260263,ECE 200,028,103613,Mir Arabbaygi; Siavash,9999,0,9999,0
1668298260263,ECE 200,029,103614,Mookherjea; Shayan,9999,0,9999,0
1668298260263,ECE 200,030,103615,Morris; Karcher William,9999,0,9999,0
1668298260263,ECE 200,031,103616,Ng; Tse Nga,9999,0,9999,0
1668298260263,ECE 200,032,103617,Nguyen; Truong Quang,9999,0,9999,0
1668298260263,ECE 200,033,103618,Nomura; Kenji,9999,0,9999,0
1668298260263,ECE 200,034,103619,Orlitsky; Alon,9999,0,9999,0
1668298260263,ECE 200,035,103620,Pal; Piya,9999,0,9999,0
1668298260263,ECE 200,036,103621,Papen; George C.,9999,0,9999,0
1668298260263,ECE 200,037,103622,Radic; Stojan,9999,0,9999,0
1668298260263,ECE 200,038,103623,Rao; Bhaskar D.,9999,0,9999,0
1668298260263,ECE 200,039,103624,Rao; Ramesh R,9999,0,9999,0
1668298260263,ECE 200,040,103625,Rebeiz; Gabriel,9999,0,9999,0
1668298260263,ECE 200,041,103626,Sanford; John R,9999,0,9999,0
1668298260263,ECE 200,042,103627,Siegel; Paul H.,9999,0,9999,0
1668298260263,ECE 200,043,103628,Sievenpiper; Daniel F.,9999,0,9999,0
1668298260263,ECE 200,044,103629,Sworder; David D.,9999,0,9999,0
1668298260263,ECE 200,045,103630,Taur; Yuan,9999,0,9999,0
1668298260263,ECE 200,046,103631,Touri; Behrouz,9999,0,9999,0
1668298260263,ECE 200,047,103632,Trivedi; Mohan M.,9999,0,9999,0
1668298260263,ECE 200,048,103633,Vasconcelos; Nuno,9999,0,9999,0
1668298260263,ECE 200,049,103634,Wang; Xiaolong,9999,0,9999,0
1668298260263,ECE 200,050,103635,Xie; Pengtao,9999,0,9999,0
1668298260263,ECE 200,051,103636,Yip; Michael,9999,0,9999,0
1668298260263,ECE 200,052,103637,Zeger; Kenneth A.,999,0,999,0
1668298260263,ECE 200,053,103638,Zhang; Xinyu,9999,0,9999,0
1668298260263,ECE 200,054,103639,Turakhia; Yatish Girish,9999,0,9999,0
1668298260263,ECE 200,055,103640,Kang; Mingu,9999,0,9999,0
1668298260263,ECE 200,056,103641,Shi; Yuanyuan,9999,0,9999,0
1668298260263,ECE 200,057,103642,Wang; Edward Jay,9999,0,9999,0
1668298260263,ECE 200,058,103643,Zheng; Yang,9999,0,9999,0
1668298260688,ECE 202,A00,103644,Kuzum; Duygu,0,0,0,0
1668298261111,ECE 212BN,A00,103646,Ng; Tse Nga,0,0,0,0
1668298261543,ECE 221,A00,111493,Staff,0,0,0,0
1668298261970,ECE 222B,A00,103647,Lomakin; Vitaliy,0,0,0,0
1668298262394,ECE 230B,A00,103648,Taur; Yuan,0,0,0,0
1668298262818,ECE 238B,A00,103649,Garay; Javier,0,0,0,0
1668298263246,ECE 240B,A00,112900,Fainman; Yeshaiahu,0,0,0,0
1668298263668,ECE 247A,A00,103650,Jokerst; Jesse Vincent,0,0,0,0
1668298264104,ECE 247B,A00,103651,Wang; Joseph,0,0,0,0
1668298264531,ECE 250,A00,103652,Siegel; Paul H.,0,0,0,0
1668298264957,ECE 251A,A00,103654,Rao; Bhaskar D.,0,0,0,0
1668298265383,ECE 257B,A00,103655,Bharadia; Dinesh,0,0,0,0
1668298265808,ECE 258A,A00,103656,Milstein; Laurence B.,0,0,0,0
1668298266241,ECE 260B,A00,103658,Kang; Mingu,0,0,0,0
1668298266662,ECE 264A,A00,103659,Galton; Ian A,0,0,0,0
1668298267089,ECE 265A,A00,103661,Gudem; Prasad S.S.,0,0,0,0
1668298267511,ECE 265D,A00,103662,Gudem; Prasad S.S.,0,0,0,0
1668298267935,ECE 268,A00,103663,Koushanfar; Farinaz,0,0,0,0
1668298268377,ECE 269,A01,103665,Pal; Piya,0,0,0,0
1668298268827,ECE 271B,A00,103666,Vasconcelos; Manuela,0,0,0,0
1668298269250,ECE 276A,A00,103667,Atanasov; Nikolay A.,0,0,0,0
1668298269676,ECE 277,A00,103668,An; Cheolhong,0,0,0,0
1668298270103,ECE 279,A00,117947,Hall; Drew A.,0,0,0,0
1668298270959,ECE 283,A00,103670,Hsueh; Tzu-Chien,0,0,0,0
1668298271385,ECE 284,A00,103671,Turakhia; Yatish Girish,0,0,0,0
1668298271812,ECE 285,A00,103672,Zheng; Yang,0,0,0,0
1668298271812,ECE 285,B00,103673,Sworder; David D.,0,0,0,0
1668298272240,ECE 287,A00,103676,Javidi; Tara,0,0,0,0
1668298272664,MATH 200B,A00,098023,Salehi Golsefidy; Alireza,12,0,15,3
1668298273087,MATH 202B,A00,098024,Rhoades; Brendon Patrick,9,0,15,6
1668298273510,MATH 203B,A00,098025,Oprea; Dragos N.,10,0,15,5
1668298273934,MATH 204B,A00,098026,Sorensen; Claus M,13,0,15,2
1668298274356,MATH 208,A00,098027,Izadi; Elham,7,0,10,3
1668298274779,MATH 209,A00,098028,Pollack; Aaron,10,0,10,0
1668298275202,MATH 211A,A00,112919,Rogalski; Daniel,9,0,10,1
1668298275624,MATH 211B,A00,112920,Seward; Brandon M.,9,0,10,1
1668298276049,MATH 218,A00,098029,Li; Bo,10,0,10,0
1668298276471,MATH 220B,A00,098030,Novak; Jonathan I,11,0,15,4
1668298276897,MATH 221A,A00,098031,Ebenfelt; Peter F,13,0,15,2
1668298277323,MATH 231B,A00,098032,Zlatos; Andrej,12,0,15,3
1668298277756,MATH 240B,A00,098033,Ni; Lei,9,0,15,6
1668298278181,MATH 243,A00,098034,Jekel; David Andrew,10,0,10,0
1668298278603,MATH 245A,A00,098035,Nie; Jiawang,0,0,15,16
1668298279027,MATH 248,A00,098036,Bejenaru; Ioan,10,0,10,0
1668298279450,MATH 250B,A00,098037,Spolaor; Luca,14,0,15,1
1668298279873,MATH 258,A00,098038,Ni; Lei,10,0,10,0
1668298280298,MATH 264B,A00,098041,Rhoades; Brendon Patrick,9,0,15,6
1668298280722,MATH 268,A00,098042,Buss; Samuel R,10,0,10,0
1668298281147,MATH 269,A00,098043,Rhoades; Brendon Patrick,10,0,10,0
1668298281574,MATH 270B,A00,098044,Li; Bo,10,0,15,5
1668298281998,MATH 272B,A00,098045,Holst; Michael J,13,0,15,2
1668298282422,MATH 273A,A00,098046,Tian; Xiaochuan,10,0,15,5
1668298282847,MATH 275,A01,098048,Tian; Xiaochuan,6,0,10,4
1668298283272,MATH 278A,A00,098049,Holst; Michael J,8,0,10,2
1668298283694,MATH 278B,A00,098050,Cloninger; Alexander,10,0,10,0
1668298284116,MATH 278C,A00,098051,Nie; Jiawang,7,0,10,3
1668298284539,MATH 280B,A00,098052,Zheng; Tianyi,8,0,15,7
1668298284964,MATH 281B,A00,098053,Bradic; Jelena,1,0,15,14
1668298285387,MATH 282B,A00,098054,Arias-Castro; Ery,0,0,15,15
1668298285811,MATH 285,A00,098055,Fitzsimmons; Patrick J,0,0,15,17
1668298286238,MATH 287B,A00,098056,Arias-Castro; Ery,2,0,15,13
1668298286662,MATH 288,A00,098057,Agarwal; Pooja,9,0,10,1
1668298286662,MATH 288,B00,098058,Zhang; Danna,8,0,10,2
1668298286662,MATH 288,C00,098059,Williams; Ruth J,9,0,10,1
1668298287087,MATH 290B,A00,098060,Roberts; Justin Deritter,13,0,15,2
1668298287521,MATH 292,A00,098061,Belmont; Eva Kinoshita,10,0,10,0
1668298287946,MATH 295,A00,098062,Suk; Andrew Hoon,48,0,50,2
1668298288369,MATH 296,A00,098063,Novak; Jonathan I,20,0,20,0
1668298288792,MATH 297,001,098064,Gamst; Anthony Collins,9997,0,9999,2
1668298787599,COGS 205,A00,101395,Chiba; Andrea,19,0,20,1
1668298788024,COGS 210B,001,101404,Greene; Deanna Jacquelyn,9998,0,9999,1
1668298788024,COGS 210B,002,101417,Xia; Haijun,9999,0,9999,0
1668298788024,COGS 210B,003,101422,Nitz; Douglas A.,9999,0,9999,0
1668298788024,COGS 210B,004,101423,Hollan; James D.,9998,0,9999,1
1668298788024,COGS 210B,005,101424,Deak; Gedeon O.,9998,0,9999,1
1668298788024,COGS 210B,006,101425,Rossano; Federico,9999,0,9999,0
1668298788461,COGS 211B,A00,101427,Coulson; Seana M,9996,0,9999,3
1668298788883,COGS 220,A00,101428,Hollan; James D.,0,0,25,25
1668298789309,COGS 229,A00,101429,Dow; Steven P,18,0,25,7
1668298789732,COGS 230,A00,101430,Klemmer; Scott R,12,0,17,5
1668298790155,COGS 234,A00,101431,Xia; Haijun,1,0,25,24
1668298790582,COGS 260,A00,101432,Kiyonaga; Anastasia,21,0,25,4
1668298790582,COGS 260,B00,101433,Kirsh; David Joel,15,0,25,10
1668298791018,CSE 202,A00,102371,Impagliazzo; Russell,0,0,0,0
1668298791441,CSE 203B,A01,102373,Cheng; Chung Kuan,0,0,0,0
1668298791869,CSE 208,A00,102374,Micciancio; Daniele,0,0,0,0
1668298792292,CSE 209A,A00,112895,Impagliazzo; Russell,0,0,15,15
1668298792715,CSE 209B,A00,108005,Bellare; Mihir,0,0,0,0
1668298793140,CSE 210,A00,113163,Coblenz; Michael J,0,0,0,0
1668298793564,CSE 219,A00,106111,Dow; Steven P,0,0,20,20
1668298793987,CSE 221,A00,102376,Voelker; Geoffrey M.,0,0,0,0
1668298794410,CSE 224,A01,102378,Porter; George M,0,0,0,0
1668298794837,CSE 229A,A00,102379,Savage; Stefan,0,0,0,0
1668298795263,CSE 229C,A00,102380,Munyaka; Imani N. S.,0,0,0,0
1668298795687,CSE 232B,A00,102382,Deutsch; Alin Bernard,0,0,0,0
1668298796111,CSE 234,A01,112904,Kumar; Arun Kumar,0,0,0,0
1668298796538,CSE 237A,A00,102383,Rosing; Tajana Simunic,0,0,0,0
1668298796962,CSE 239A,A00,102384,Deutsch; Alin Bernard,0,0,0,0
1668298797387,CSE 239B,A00,102385,Polikarpova; Nadezhda,0,0,0,0
1668298797808,CSE 240A,A00,102386,Pannuto; Patrick William,0,0,0,0
1668298798232,CSE 240B,A00,102387,Zhao; Jishen,0,0,0,0
1668298798655,CSE 241A,A00,106406,Kang; Mingu,0,0,0,0
1668298799078,CSE 249B,A00,102388,Kahng; Andrew Byun,0,0,8,8
1668298799506,CSE 251B,A01,102392,Cottrell; Garrison W,0,0,0,0
1668298799506,CSE 251B,A02,102393,Cottrell; Garrison W,0,0,0,0
1668298799930,CSE 252B,A00,102394,Ochoa; Benjamin Lawrence,0,0,0,0
1668298800358,CSE 257,A01,102396,Gao; Sicun,0,0,0,0
1668298800784,CSE 272,A00,102397,Li; Tzumao,0,0,0,0
1668298801207,CSE 274,A00,111323,Chern; Albert Ren-Haur,0,0,0,0
1668298801637,CSE 282,A00,102398,Pevzner; Pavel Arkadjevich,0,0,0,0
1668298802061,CSE 284,A00,114175,Gymrek; Melissa Ann,0,0,0,0
1668298802489,CSE 290,A00,102399,Chandraker; Manmohan Krishna,0,0,0,0
1668298802489,CSE 290,B00,102400,Vaccaro; Kristen Marie,0,0,25,25
1668298802489,CSE 290,C00,102414,Pannuto; Patrick William,0,0,25,25
1668298802489,CSE 290,D00,102427,Pevzner; Pavel Arkadjevich,0,0,0,0
1668298802489,CSE 290,E00,102429,Zhao; Jishen,0,0,0,0
1668298802489,CSE 290,F00,102436,Tullsen; Dean Michael,0,0,0,0
1668298802489,CSE 290,G00,102440,Christensen; Henrik I,0,0,20,20
1668298802913,CSE 291,A00,102443,Su; Hao,0,0,0,0
1668298802913,CSE 291,B00,102448,Polikarpova; Nadezhda,0,0,0,0
1668298802913,CSE 291,C00,102453,Vaccaro; Kristen Marie,0,0,0,0
1668298802913,CSE 291,D00,111343,Savage; Stefan,0,0,0,0
1668298802913,CSE 291,E00,116474,Claffy; Kimberly Claire,0,0,0,0
1668298802913,CSE 291,F00,116479,Pasquale; Joseph,0,0,0,0
1668298803343,CSE 293,001,119111,Bafna; Vineet,9999,0,9999,0
1668298803343,CSE 293,002,119118,Bellare; Mihir,9999,0,9999,0
1668298803343,CSE 293,003,119122,Berg-Kirkpatrick; Taylor D,9999,0,9999,0
1668298803343,CSE 293,004,119135,Christensen; Henrik I,9999,0,9999,0
1668298803343,CSE 293,005,119142,Cottrell; Garrison W,9999,0,9999,0
1668298803343,CSE 293,006,119146,Deutsch; Alin Bernard,9999,0,9999,0
1668298803343,CSE 293,007,119159,Esmaeilzadeh; Hadi,9999,0,9999,0
1668298803343,CSE 293,008,119166,Freund; Yoav,9999,0,9999,0
1668298803343,CSE 293,009,119170,Griswold; William G.,9999,0,9999,0
1668298803343,CSE 293,010,119183,Gymrek; Melissa Ann,9999,0,9999,0
1668298803343,CSE 293,011,119190,Heninger; Nadia A,9999,0,9999,0
1668298803343,CSE 293,012,119230,Impagliazzo; Russell,9999,0,9999,0
1668298803343,CSE 293,013,119232,Jhala; Ranjit,9999,0,9999,0
1668298803343,CSE 293,014,119233,Kahng; Andrew Byun,9999,0,9999,0
1668298803343,CSE 293,015,119298,Kane; Daniel Mertz,9999,0,9999,0
1668298803343,CSE 293,016,119299,Kriegman; David J,9999,0,9999,0
1668298803343,CSE 293,017,119300,Kumar; Arun Kumar,9999,0,9999,0
1668298803343,CSE 293,018,119301,Lerner; Sorin,9999,0,9999,0
1668298803343,CSE 293,019,119302,Lovett; Shachar,9999,0,9999,0
1668298803343,CSE 293,020,119303,McAuley; Julian John,9999,0,9999,0
1668298803343,CSE 293,021,119304,Micciancio; Daniele,9999,0,9999,0
1668298803343,CSE 293,022,119367,Orailoglu; Alex,9999,0,9999,0
1668298803343,CSE 293,023,119382,Paturi; Ramamohan,9999,0,9999,0
1668298803343,CSE 293,024,119404,Polikarpova; Nadezhda,9999,0,9999,0
1668298803343,CSE 293,025,119406,Politz; Joseph Gibbs,9999,0,9999,0
1668298803343,CSE 293,026,119411,Porter; George M,9999,0,9999,0
1668298803343,CSE 293,027,119414,Porter; Leonard Emerson,9999,0,9999,0
1668298803343,CSE 293,028,119416,Ramamoorthi; Ravi,9999,0,9999,0
1668298803343,CSE 293,029,119417,Sahoo; Debashis,9999,0,9999,0
1668298803343,CSE 293,030,119420,Saul; Lawrence,9999,0,9999,0
1668298803343,CSE 293,031,119421,Savage; Stefan,9999,0,9999,0
1668298803343,CSE 293,032,119425,Schulze; Jurgen P.,9999,0,9999,0
1668298803343,CSE 293,033,119426,Snoeren; Alex C.,9999,0,9999,0
1668298803343,CSE 293,034,119428,Shang; Jingbo,9999,0,9999,0
1668298803343,CSE 293,035,119430,Stefan; Deian,9999,0,9999,0
1668298803343,CSE 293,036,119431,Su; Hao,9999,0,9999,0
1668298803343,CSE 293,037,119433,Swanson; Steven James,9999,0,9999,0
1668298803343,CSE 293,038,119435,Tullsen; Dean Michael,9999,0,9999,0
1668298803343,CSE 293,039,119483,Voelker; Geoffrey M.,9999,0,9999,0
1668298803343,CSE 293,040,119537,Zhao; Jishen,9999,0,9999,0
1668298803343,CSE 293,041,119538,Zhou; Yuan-Yuan,9999,0,9999,0
1668298803343,CSE 293,042,119539,Gao; Sicun,9999,0,9999,0
1668298803343,CSE 293,043,119540,Weibel; Nadir,9999,0,9999,0
1668298803343,CSE 293,044,119541,Gupta; Rajesh K.,9999,0,9999,0
1668298803343,CSE 293,045,126410,Vaccaro; Kristen Marie,9999,0,9999,0
1668298803343,CSE 293,046,126411,Klemke; Richard,9999,0,9999,0
1668298803768,CSE 294,A00,102459,Voelker; Geoffrey M.,0,0,0,0
1668298803768,CSE 294,B00,111322,Orailoglu; Alex,0,0,0,0
1668298804191,DSE 201,A00,096914,Deutsch; Alin Bernard,30,0,30,0
1668298804615,DSE 210,A00,096915,Dasgupta; Sanjoy,30,0,30,0
1668298805042,DSE 260A,A00,096916,Altintas De Callaf; Ilkay,30,0,30,0
1668298805479,ECE 200,001,103586,Antipa; Nicholas A,9999,0,9999,0
1668298805479,ECE 200,002,103587,Atanasov; Nikolay A.,9999,0,9999,0
1668298805479,ECE 200,003,103588,Bharadia; Dinesh,9999,0,9999,0
1668298805479,ECE 200,004,103589,Cheng; Chung Kuan,9999,0,9999,0
1668298805479,ECE 200,005,103590,Cosman; Pamela C.,9999,0,9999,0
1668298805479,ECE 200,006,103591,Dayeh; Shadi Ahmad,9999,0,9999,0
1668298805479,ECE 200,007,103592,Fainman; Yeshaiahu,9999,0,9999,0
1668298805479,ECE 200,008,103593,Ford; Joseph Earl,9999,0,9999,0
1668298805479,ECE 200,009,103594,Franceschetti; Massimo,9999,0,9999,0
1668298805479,ECE 200,010,103595,Fullerton; Eric E,9999,0,9999,0
1668298805479,ECE 200,011,103596,Galton; Ian A,9999,0,9999,0
1668298805479,ECE 200,012,103597,Gilja; Vikash,9999,0,9999,0
1668298805479,ECE 200,013,103598,Hall; Drew A.,9999,0,9999,0
1668298805479,ECE 200,014,103599,Hsueh; Tzu-Chien,9999,0,9999,0
1668298805479,ECE 200,015,103600,Javidi; Tara,9999,0,9999,0
1668298805479,ECE 200,016,103601,Kahng; Andrew Byun,9999,0,9999,0
1668298805479,ECE 200,017,103602,Kim; Young-Han,9999,0,9999,0
1668298805479,ECE 200,018,103603,Koushanfar; Farinaz,9999,0,9999,0
1668298805479,ECE 200,019,103604,Kuzum; Duygu,9999,0,9999,0
1668298805479,ECE 200,020,103605,Le; Hanh-Phuc,9999,0,9999,0
1668298805479,ECE 200,021,103606,Lin; Bill,9999,0,9999,0
1668298805479,ECE 200,022,103607,Liu; Zhaowei,9998,0,9999,1
1668298805479,ECE 200,023,103608,Lo; Yu-Hwa,9999,0,9999,0
1668298805479,ECE 200,024,103609,Lomakin; Vitaliy,9999,0,9999,0
1668298805479,ECE 200,025,103610,Mercier; Patrick Philip,9999,0,9999,0
1668298805479,ECE 200,026,103611,Meyer; Florian,9999,0,9999,0
1668298805479,ECE 200,027,103612,Milstein; Laurence B.,9999,0,9999,0
1668298805479,ECE 200,028,103613,Mir Arabbaygi; Siavash,9999,0,9999,0
1668298805479,ECE 200,029,103614,Mookherjea; Shayan,9999,0,9999,0
1668298805479,ECE 200,030,103615,Morris; Karcher William,9999,0,9999,0
1668298805479,ECE 200,031,103616,Ng; Tse Nga,9999,0,9999,0
1668298805479,ECE 200,032,103617,Nguyen; Truong Quang,9999,0,9999,0
1668298805479,ECE 200,033,103618,Nomura; Kenji,9999,0,9999,0
1668298805479,ECE 200,034,103619,Orlitsky; Alon,9999,0,9999,0
1668298805479,ECE 200,035,103620,Pal; Piya,9999,0,9999,0
1668298805479,ECE 200,036,103621,Papen; George C.,9999,0,9999,0
1668298805479,ECE 200,037,103622,Radic; Stojan,9999,0,9999,0
1668298805479,ECE 200,038,103623,Rao; Bhaskar D.,9999,0,9999,0
1668298805479,ECE 200,039,103624,Rao; Ramesh R,9999,0,9999,0
1668298805479,ECE 200,040,103625,Rebeiz; Gabriel,9999,0,9999,0
1668298805479,ECE 200,041,103626,Sanford; John R,9999,0,9999,0
1668298805479,ECE 200,042,103627,Siegel; Paul H.,9999,0,9999,0
1668298805479,ECE 200,043,103628,Sievenpiper; Daniel F.,9999,0,9999,0
1668298805479,ECE 200,044,103629,Sworder; David D.,9999,0,9999,0
1668298805479,ECE 200,045,103630,Taur; Yuan,9999,0,9999,0
1668298805479,ECE 200,046,103631,Touri; Behrouz,9999,0,9999,0
1668298805479,ECE 200,047,103632,Trivedi; Mohan M.,9999,0,9999,0
1668298805479,ECE 200,048,103633,Vasconcelos; Nuno,9999,0,9999,0
1668298805479,ECE 200,049,103634,Wang; Xiaolong,9999,0,9999,0
1668298805479,ECE 200,050,103635,Xie; Pengtao,9999,0,9999,0
1668298805479,ECE 200,051,103636,Yip; Michael,9999,0,9999,0
1668298805479,ECE 200,052,103637,Zeger; Kenneth A.,999,0,999,0
1668298805479,ECE 200,053,103638,Zhang; Xinyu,9999,0,9999,0
1668298805479,ECE 200,054,103639,Turakhia; Yatish Girish,9999,0,9999,0
1668298805479,ECE 200,055,103640,Kang; Mingu,9999,0,9999,0
1668298805479,ECE 200,056,103641,Shi; Yuanyuan,9999,0,9999,0
1668298805479,ECE 200,057,103642,Wang; Edward Jay,9999,0,9999,0
1668298805479,ECE 200,058,103643,Zheng; Yang,9999,0,9999,0
1668298805904,ECE 202,A00,103644,Kuzum; Duygu,0,0,0,0
1668298806330,ECE 212BN,A00,103646,Ng; Tse Nga,0,0,0,0
1668298806753,ECE 221,A00,111493,Staff,0,0,0,0
1668298807177,ECE 222B,A00,103647,Lomakin; Vitaliy,0,0,0,0
1668298807602,ECE 230B,A00,103648,Taur; Yuan,0,0,0,0
1668298808031,ECE 238B,A00,103649,Garay; Javier,0,0,0,0
1668298808456,ECE 240B,A00,112900,Fainman; Yeshaiahu,0,0,0,0
1668298808878,ECE 247A,A00,103650,Jokerst; Jesse Vincent,0,0,0,0
1668298809303,ECE 247B,A00,103651,Wang; Joseph,0,0,0,0
1668298809731,ECE 250,A00,103652,Siegel; Paul H.,0,0,0,0
1668298810158,ECE 251A,A00,103654,Rao; Bhaskar D.,0,0,0,0
1668298810582,ECE 257B,A00,103655,Bharadia; Dinesh,0,0,0,0
1668298811008,ECE 258A,A00,103656,Milstein; Laurence B.,0,0,0,0
1668298811431,ECE 260B,A00,103658,Kang; Mingu,0,0,0,0
1668298811947,ECE 264A,A00,103659,Galton; Ian A,0,0,0,0
1668298812369,ECE 265A,A00,103661,Gudem; Prasad S.S.,0,0,0,0
1668298812793,ECE 265D,A00,103662,Gudem; Prasad S.S.,0,0,0,0
1668298813217,ECE 268,A00,103663,Koushanfar; Farinaz,0,0,0,0
1668298813640,ECE 269,A01,103665,Pal; Piya,0,0,0,0
1668298814068,ECE 271B,A00,103666,Vasconcelos; Manuela,0,0,0,0
1668298814496,ECE 276A,A00,103667,Atanasov; Nikolay A.,0,0,0,0
1668298814923,ECE 277,A00,103668,An; Cheolhong,0,0,0,0
1668298815354,ECE 279,A00,117947,Hall; Drew A.,0,0,0,0
1668298816204,ECE 283,A00,103670,Hsueh; Tzu-Chien,0,0,0,0
1668298816635,ECE 284,A00,103671,Turakhia; Yatish Girish,0,0,0,0
1668298817063,ECE 285,A00,103672,Zheng; Yang,0,0,0,0
1668298817063,ECE 285,B00,103673,Sworder; David D.,0,0,0,0
1668298817487,ECE 287,A00,103676,Javidi; Tara,0,0,0,0
1668298817911,MATH 200B,A00,098023,Salehi Golsefidy; Alireza,12,0,15,3
1668298818335,MATH 202B,A00,098024,Rhoades; Brendon Patrick,9,0,15,6
1668298818759,MATH 203B,A00,098025,Oprea; Dragos N.,10,0,15,5
1668298819186,MATH 204B,A00,098026,Sorensen; Claus M,13,0,15,2
1668298819611,MATH 208,A00,098027,Izadi; Elham,7,0,10,3
1668298820038,MATH 209,A00,098028,Pollack; Aaron,10,0,10,0
1668298820461,MATH 211A,A00,112919,Rogalski; Daniel,9,0,10,1
1668298820884,MATH 211B,A00,112920,Seward; Brandon M.,9,0,10,1
1668298821310,MATH 218,A00,098029,Li; Bo,10,0,10,0
1668298821738,MATH 220B,A00,098030,Novak; Jonathan I,11,0,15,4
1668298822161,MATH 221A,A00,098031,Ebenfelt; Peter F,13,0,15,2
1668298822587,MATH 231B,A00,098032,Zlatos; Andrej,12,0,15,3
1668298823012,MATH 240B,A00,098033,Ni; Lei,9,0,15,6
1668298823438,MATH 243,A00,098034,Jekel; David Andrew,10,0,10,0
1668298823861,MATH 245A,A00,098035,Nie; Jiawang,0,0,15,16
1668298824284,MATH 248,A00,098036,Bejenaru; Ioan,10,0,10,0
1668298824711,MATH 250B,A00,098037,Spolaor; Luca,14,0,15,1
1668298825138,MATH 258,A00,098038,Ni; Lei,10,0,10,0
1668298825563,MATH 264B,A00,098041,Rhoades; Brendon Patrick,9,0,15,6
1668298825993,MATH 268,A00,098042,Buss; Samuel R,10,0,10,0
1668298826419,MATH 269,A00,098043,Rhoades; Brendon Patrick,10,0,10,0
1668298826842,MATH 270B,A00,098044,Li; Bo,10,0,15,5
1668298827266,MATH 272B,A00,098045,Holst; Michael J,13,0,15,2
1668298827692,MATH 273A,A00,098046,Tian; Xiaochuan,10,0,15,5
1668298828130,MATH 275,A01,098048,Tian; Xiaochuan,6,0,10,4
1668298828554,MATH 278A,A00,098049,Holst; Michael J,8,0,10,2
1668298828985,MATH 278B,A00,098050,Cloninger; Alexander,10,0,10,0
1668298829410,MATH 278C,A00,098051,Nie; Jiawang,7,0,10,3
1668298829837,MATH 280B,A00,098052,Zheng; Tianyi,8,0,15,7
1668298830268,MATH 281B,A00,098053,Bradic; Jelena,1,0,15,14
1668298830691,MATH 282B,A00,098054,Arias-Castro; Ery,0,0,15,15
1668298831122,MATH 285,A00,098055,Fitzsimmons; Patrick J,0,0,15,17
1668298831547,MATH 287B,A00,098056,Arias-Castro; Ery,2,0,15,13
1668298831972,MATH 288,A00,098057,Agarwal; Pooja,9,0,10,1
1668298831972,MATH 288,B00,098058,Zhang; Danna,8,0,10,2
1668298831972,MATH 288,C00,098059,Williams; Ruth J,9,0,10,1
1668298832398,MATH 290B,A00,098060,Roberts; Justin Deritter,13,0,15,2
1668298832821,MATH 292,A00,098061,Belmont; Eva Kinoshita,10,0,10,0
1668298833247,MATH 295,A00,098062,Suk; Andrew Hoon,48,0,50,2
1668298833671,MATH 296,A00,098063,Novak; Jonathan I,20,0,20,0
1668298834095,MATH 297,001,098064,Gamst; Anthony Collins,9997,0,9999,2
1668299333062,COGS 205,A00,101395,Chiba; Andrea,19,0,20,1
1668299333489,COGS 210B,001,101404,Greene; Deanna Jacquelyn,9998,0,9999,1
1668299333489,COGS 210B,002,101417,Xia; Haijun,9999,0,9999,0
1668299333489,COGS 210B,003,101422,Nitz; Douglas A.,9999,0,9999,0
1668299333489,COGS 210B,004,101423,Hollan; James D.,9998,0,9999,1
1668299333489,COGS 210B,005,101424,Deak; Gedeon O.,9998,0,9999,1
1668299333489,COGS 210B,006,101425,Rossano; Federico,9999,0,9999,0
1668299333912,COGS 211B,A00,101427,Coulson; Seana M,9996,0,9999,3
1668299334339,COGS 220,A00,101428,Hollan; James D.,0,0,25,25
1668299334766,COGS 229,A00,101429,Dow; Steven P,18,0,25,7
1668299335195,COGS 230,A00,101430,Klemmer; Scott R,12,0,17,5
1668299335618,COGS 234,A00,101431,Xia; Haijun,1,0,25,24
1668299336044,COGS 260,A00,101432,Kiyonaga; Anastasia,21,0,25,4
1668299336044,COGS 260,B00,101433,Kirsh; David Joel,15,0,25,10
1668299336470,CSE 202,A00,102371,Impagliazzo; Russell,0,0,0,0
1668299336905,CSE 203B,A01,102373,Cheng; Chung Kuan,0,0,0,0
1668299337336,CSE 208,A00,102374,Micciancio; Daniele,0,0,0,0
1668299337761,CSE 209A,A00,112895,Impagliazzo; Russell,0,0,15,15
1668299338184,CSE 209B,A00,108005,Bellare; Mihir,0,0,0,0
1668299338607,CSE 210,A00,113163,Coblenz; Michael J,0,0,0,0
1668299339029,CSE 219,A00,106111,Dow; Steven P,0,0,20,20
1668299339457,CSE 221,A00,102376,Voelker; Geoffrey M.,0,0,0,0
1668299339882,CSE 224,A01,102378,Porter; George M,0,0,0,0
1668299340309,CSE 229A,A00,102379,Savage; Stefan,0,0,0,0
1668299340737,CSE 229C,A00,102380,Munyaka; Imani N. S.,0,0,0,0
1668299341164,CSE 232B,A00,102382,Deutsch; Alin Bernard,0,0,0,0
1668299341590,CSE 234,A01,112904,Kumar; Arun Kumar,0,0,0,0
1668299342014,CSE 237A,A00,102383,Rosing; Tajana Simunic,0,0,0,0
1668299342452,CSE 239A,A00,102384,Deutsch; Alin Bernard,0,0,0,0
1668299342877,CSE 239B,A00,102385,Polikarpova; Nadezhda,0,0,0,0
1668299343300,CSE 240A,A00,102386,Pannuto; Patrick William,0,0,0,0
1668299343724,CSE 240B,A00,102387,Zhao; Jishen,0,0,0,0
1668299344158,CSE 241A,A00,106406,Kang; Mingu,0,0,0,0
1668299344581,CSE 249B,A00,102388,Kahng; Andrew Byun,0,0,8,8
1668299345005,CSE 251B,A01,102392,Cottrell; Garrison W,0,0,0,0
1668299345005,CSE 251B,A02,102393,Cottrell; Garrison W,0,0,0,0
1668299345428,CSE 252B,A00,102394,Ochoa; Benjamin Lawrence,0,0,0,0
1668299345855,CSE 257,A01,102396,Gao; Sicun,0,0,0,0
1668299346278,CSE 272,A00,102397,Li; Tzumao,0,0,0,0
1668299346702,CSE 274,A00,111323,Chern; Albert Ren-Haur,0,0,0,0
1668299347126,CSE 282,A00,102398,Pevzner; Pavel Arkadjevich,0,0,0,0
1668299347553,CSE 284,A00,114175,Gymrek; Melissa Ann,0,0,0,0
1668299347976,CSE 290,A00,102399,Chandraker; Manmohan Krishna,0,0,0,0
1668299347976,CSE 290,B00,102400,Vaccaro; Kristen Marie,0,0,25,25
1668299347976,CSE 290,C00,102414,Pannuto; Patrick William,0,0,25,25
1668299347976,CSE 290,D00,102427,Pevzner; Pavel Arkadjevich,0,0,0,0
1668299347976,CSE 290,E00,102429,Zhao; Jishen,0,0,0,0
1668299347976,CSE 290,F00,102436,Tullsen; Dean Michael,0,0,0,0
1668299347976,CSE 290,G00,102440,Christensen; Henrik I,0,0,20,20
1668299348406,CSE 291,A00,102443,Su; Hao,0,0,0,0
1668299348406,CSE 291,B00,102448,Polikarpova; Nadezhda,0,0,0,0
1668299348406,CSE 291,C00,102453,Vaccaro; Kristen Marie,0,0,0,0
1668299348406,CSE 291,D00,111343,Savage; Stefan,0,0,0,0
1668299348406,CSE 291,E00,116474,Claffy; Kimberly Claire,0,0,0,0
1668299348406,CSE 291,F00,116479,Pasquale; Joseph,0,0,0,0
1668299348839,CSE 293,001,119111,Bafna; Vineet,9999,0,9999,0
1668299348839,CSE 293,002,119118,Bellare; Mihir,9999,0,9999,0
1668299348839,CSE 293,003,119122,Berg-Kirkpatrick; Taylor D,9999,0,9999,0
1668299348839,CSE 293,004,119135,Christensen; Henrik I,9999,0,9999,0
1668299348839,CSE 293,005,119142,Cottrell; Garrison W,9999,0,9999,0
1668299348839,CSE 293,006,119146,Deutsch; Alin Bernard,9999,0,9999,0
1668299348839,CSE 293,007,119159,Esmaeilzadeh; Hadi,9999,0,9999,0
1668299348839,CSE 293,008,119166,Freund; Yoav,9999,0,9999,0
1668299348839,CSE 293,009,119170,Griswold; William G.,9999,0,9999,0
1668299348839,CSE 293,010,119183,Gymrek; Melissa Ann,9999,0,9999,0
1668299348839,CSE 293,011,119190,Heninger; Nadia A,9999,0,9999,0
1668299348839,CSE 293,012,119230,Impagliazzo; Russell,9999,0,9999,0
1668299348839,CSE 293,013,119232,Jhala; Ranjit,9999,0,9999,0
1668299348839,CSE 293,014,119233,Kahng; Andrew Byun,9999,0,9999,0
1668299348839,CSE 293,015,119298,Kane; Daniel Mertz,9999,0,9999,0
1668299348839,CSE 293,016,119299,Kriegman; David J,9999,0,9999,0
1668299348839,CSE 293,017,119300,Kumar; Arun Kumar,9999,0,9999,0
1668299348839,CSE 293,018,119301,Lerner; Sorin,9999,0,9999,0
1668299348839,CSE 293,019,119302,Lovett; Shachar,9999,0,9999,0
1668299348839,CSE 293,020,119303,McAuley; Julian John,9999,0,9999,0
1668299348839,CSE 293,021,119304,Micciancio; Daniele,9999,0,9999,0
1668299348839,CSE 293,022,119367,Orailoglu; Alex,9999,0,9999,0
1668299348839,CSE 293,023,119382,Paturi; Ramamohan,9999,0,9999,0
1668299348839,CSE 293,024,119404,Polikarpova; Nadezhda,9999,0,9999,0
1668299348839,CSE 293,025,119406,Politz; Joseph Gibbs,9999,0,9999,0
1668299348839,CSE 293,026,119411,Porter; George M,9999,0,9999,0
1668299348839,CSE 293,027,119414,Porter; Leonard Emerson,9999,0,9999,0
1668299348839,CSE 293,028,119416,Ramamoorthi; Ravi,9999,0,9999,0
1668299348839,CSE 293,029,119417,Sahoo; Debashis,9999,0,9999,0
1668299348839,CSE 293,030,119420,Saul; Lawrence,9999,0,9999,0
1668299348839,CSE 293,031,119421,Savage; Stefan,9999,0,9999,0
1668299348839,CSE 293,032,119425,Schulze; Jurgen P.,9999,0,9999,0
1668299348839,CSE 293,033,119426,Snoeren; Alex C.,9999,0,9999,0
1668299348839,CSE 293,034,119428,Shang; Jingbo,9999,0,9999,0
1668299348839,CSE 293,035,119430,Stefan; Deian,9999,0,9999,0
1668299348839,CSE 293,036,119431,Su; Hao,9999,0,9999,0
1668299348839,CSE 293,037,119433,Swanson; Steven James,9999,0,9999,0
1668299348839,CSE 293,038,119435,Tullsen; Dean Michael,9999,0,9999,0
1668299348839,CSE 293,039,119483,Voelker; Geoffrey M.,9999,0,9999,0
1668299348839,CSE 293,040,119537,Zhao; Jishen,9999,0,9999,0
1668299348839,CSE 293,041,119538,Zhou; Yuan-Yuan,9999,0,9999,0
1668299348839,CSE 293,042,119539,Gao; Sicun,9999,0,9999,0
1668299348839,CSE 293,043,119540,Weibel; Nadir,9999,0,9999,0
1668299348839,CSE 293,044,119541,Gupta; Rajesh K.,9999,0,9999,0
1668299348839,CSE 293,045,126410,Vaccaro; Kristen Marie,9999,0,9999,0
1668299348839,CSE 293,046,126411,Klemke; Richard,9999,0,9999,0
1668299349263,CSE 294,A00,102459,Voelker; Geoffrey M.,0,0,0,0
1668299349263,CSE 294,B00,111322,Orailoglu; Alex,0,0,0,0
1668299349688,DSE 201,A00,096914,Deutsch; Alin Bernard,30,0,30,0
1668299350112,DSE 210,A00,096915,Dasgupta; Sanjoy,30,0,30,0
1668299350537,DSE 260A,A00,096916,Altintas De Callaf; Ilkay,30,0,30,0
1668299350967,ECE 200,001,103586,Antipa; Nicholas A,9999,0,9999,0
1668299350967,ECE 200,002,103587,Atanasov; Nikolay A.,9999,0,9999,0
1668299350967,ECE 200,003,103588,Bharadia; Dinesh,9999,0,9999,0
1668299350967,ECE 200,004,103589,Cheng; Chung Kuan,9999,0,9999,0
1668299350967,ECE 200,005,103590,Cosman; Pamela C.,9999,0,9999,0
1668299350967,ECE 200,006,103591,Dayeh; Shadi Ahmad,9999,0,9999,0
1668299350967,ECE 200,007,103592,Fainman; Yeshaiahu,9999,0,9999,0
1668299350967,ECE 200,008,103593,Ford; Joseph Earl,9999,0,9999,0
1668299350967,ECE 200,009,103594,Franceschetti; Massimo,9999,0,9999,0
1668299350967,ECE 200,010,103595,Fullerton; Eric E,9999,0,9999,0
1668299350967,ECE 200,011,103596,Galton; Ian A,9999,0,9999,0
1668299350967,ECE 200,012,103597,Gilja; Vikash,9999,0,9999,0
1668299350967,ECE 200,013,103598,Hall; Drew A.,9999,0,9999,0
1668299350967,ECE 200,014,103599,Hsueh; Tzu-Chien,9999,0,9999,0
1668299350967,ECE 200,015,103600,Javidi; Tara,9999,0,9999,0
1668299350967,ECE 200,016,103601,Kahng; Andrew Byun,9999,0,9999,0
1668299350967,ECE 200,017,103602,Kim; Young-Han,9999,0,9999,0
1668299350967,ECE 200,018,103603,Koushanfar; Farinaz,9999,0,9999,0
1668299350967,ECE 200,019,103604,Kuzum; Duygu,9999,0,9999,0
1668299350967,ECE 200,020,103605,Le; Hanh-Phuc,9999,0,9999,0
1668299350967,ECE 200,021,103606,Lin; Bill,9999,0,9999,0
1668299350967,ECE 200,022,103607,Liu; Zhaowei,9998,0,9999,1
1668299350967,ECE 200,023,103608,Lo; Yu-Hwa,9999,0,9999,0
1668299350967,ECE 200,024,103609,Lomakin; Vitaliy,9999,0,9999,0
1668299350967,ECE 200,025,103610,Mercier; Patrick Philip,9999,0,9999,0
1668299350967,ECE 200,026,103611,Meyer; Florian,9999,0,9999,0
1668299350967,ECE 200,027,103612,Milstein; Laurence B.,9999,0,9999,0
1668299350967,ECE 200,028,103613,Mir Arabbaygi; Siavash,9999,0,9999,0
1668299350967,ECE 200,029,103614,Mookherjea; Shayan,9999,0,9999,0
1668299350967,ECE 200,030,103615,Morris; Karcher William,9999,0,9999,0
1668299350967,ECE 200,031,103616,Ng; Tse Nga,9999,0,9999,0
1668299350967,ECE 200,032,103617,Nguyen; Truong Quang,9999,0,9999,0
1668299350967,ECE 200,033,103618,Nomura; Kenji,9999,0,9999,0
1668299350967,ECE 200,034,103619,Orlitsky; Alon,9999,0,9999,0
1668299350967,ECE 200,035,103620,Pal; Piya,9999,0,9999,0
1668299350967,ECE 200,036,103621,Papen; George C.,9999,0,9999,0
1668299350967,ECE 200,037,103622,Radic; Stojan,9999,0,9999,0
1668299350967,ECE 200,038,103623,Rao; Bhaskar D.,9999,0,9999,0
1668299350967,ECE 200,039,103624,Rao; Ramesh R,9999,0,9999,0
1668299350967,ECE 200,040,103625,Rebeiz; Gabriel,9999,0,9999,0
1668299350967,ECE 200,041,103626,Sanford; John R,9999,0,9999,0
1668299350967,ECE 200,042,103627,Siegel; Paul H.,9999,0,9999,0
1668299350967,ECE 200,043,103628,Sievenpiper; Daniel F.,9999,0,9999,0
1668299350967,ECE 200,044,103629,Sworder; David D.,9999,0,9999,0
1668299350967,ECE 200,045,103630,Taur; Yuan,9999,0,9999,0
1668299350967,ECE 200,046,103631,Touri; Behrouz,9999,0,9999,0
1668299350967,ECE 200,047,103632,Trivedi; Mohan M.,9999,0,9999,0
1668299350967,ECE 200,048,103633,Vasconcelos; Nuno,9999,0,9999,0
1668299350967,ECE 200,049,103634,Wang; Xiaolong,9999,0,9999,0
1668299350967,ECE 200,050,103635,Xie; Pengtao,9999,0,9999,0
1668299350967,ECE 200,051,103636,Yip; Michael,9999,0,9999,0
1668299350967,ECE 200,052,103637,Zeger; Kenneth A.,999,0,999,0
1668299350967,ECE 200,053,103638,Zhang; Xinyu,9999,0,9999,0
1668299350967,ECE 200,054,103639,Turakhia; Yatish Girish,9999,0,9999,0
1668299350967,ECE 200,055,103640,Kang; Mingu,9999,0,9999,0
1668299350967,ECE 200,056,103641,Shi; Yuanyuan,9999,0,9999,0
1668299350967,ECE 200,057,103642,Wang; Edward Jay,9999,0,9999,0
1668299350967,ECE 200,058,103643,Zheng; Yang,9999,0,9999,0
1668299351400,ECE 202,A00,103644,Kuzum; Duygu,0,0,0,0
1668299351822,ECE 212BN,A00,103646,Ng; Tse Nga,0,0,0,0
1668299352247,ECE 221,A00,111493,Staff,0,0,0,0
1668299352684,ECE 222B,A00,103647,Lomakin; Vitaliy,0,0,0,0
1668299353108,ECE 230B,A00,103648,Taur; Yuan,0,0,0,0
1668299353530,ECE 238B,A00,103649,Garay; Javier,0,0,0,0
1668299353954,ECE 240B,A00,112900,Fainman; Yeshaiahu,0,0,0,0
1668299354378,ECE 247A,A00,103650,Jokerst; Jesse Vincent,0,0,0,0
1668299354805,ECE 247B,A00,103651,Wang; Joseph,0,0,0,0
1668299355234,ECE 250,A00,103652,Siegel; Paul H.,0,0,0,0
1668299355656,ECE 251A,A00,103654,Rao; Bhaskar D.,0,0,0,0
1668299356090,ECE 257B,A00,103655,Bharadia; Dinesh,0,0,0,0
1668299356513,ECE 258A,A00,103656,Milstein; Laurence B.,0,0,0,0
1668299356938,ECE 260B,A00,103658,Kang; Mingu,0,0,0,0
1668299357363,ECE 264A,A00,103659,Galton; Ian A,0,0,0,0
1668299357788,ECE 265A,A00,103661,Gudem; Prasad S.S.,0,0,0,0
1668299358210,ECE 265D,A00,103662,Gudem; Prasad S.S.,0,0,0,0
1668299358635,ECE 268,A00,103663,Koushanfar; Farinaz,0,0,0,0
1668299359061,ECE 269,A01,103665,Pal; Piya,0,0,0,0
1668299359484,ECE 271B,A00,103666,Vasconcelos; Manuela,0,0,0,0
1668299359910,ECE 276A,A00,103667,Atanasov; Nikolay A.,0,0,0,0
1668299360334,ECE 277,A00,103668,An; Cheolhong,0,0,0,0
1668299360758,ECE 279,A00,117947,Hall; Drew A.,0,0,0,0
1668299361604,ECE 283,A00,103670,Hsueh; Tzu-Chien,0,0,0,0
1668299362036,ECE 284,A00,103671,Turakhia; Yatish Girish,0,0,0,0
1668299362458,ECE 285,A00,103672,Zheng; Yang,0,0,0,0
1668299362458,ECE 285,B00,103673,Sworder; David D.,0,0,0,0
1668299362881,ECE 287,A00,103676,Javidi; Tara,0,0,0,0
1668299363303,MATH 200B,A00,098023,Salehi Golsefidy; Alireza,12,0,15,3
1668299363729,MATH 202B,A00,098024,Rhoades; Brendon Patrick,9,0,15,6
1668299364153,MATH 203B,A00,098025,Oprea; Dragos N.,10,0,15,5
1668299364580,MATH 204B,A00,098026,Sorensen; Claus M,13,0,15,2
1668299365007,MATH 208,A00,098027,Izadi; Elham,7,0,10,3
1668299365430,MATH 209,A00,098028,Pollack; Aaron,10,0,10,0
1668299365853,MATH 211A,A00,112919,Rogalski; Daniel,9,0,10,1
1668299366279,MATH 211B,A00,112920,Seward; Brandon M.,9,0,10,1
1668299366704,MATH 218,A00,098029,Li; Bo,10,0,10,0
1668299367128,MATH 220B,A00,098030,Novak; Jonathan I,11,0,15,4
1668299367554,MATH 221A,A00,098031,Ebenfelt; Peter F,13,0,15,2
1668299367977,MATH 231B,A00,098032,Zlatos; Andrej,12,0,15,3
1668299368402,MATH 240B,A00,098033,Ni; Lei,9,0,15,6
1668299368829,MATH 243,A00,098034,Jekel; David Andrew,10,0,10,0
1668299369254,MATH 245A,A00,098035,Nie; Jiawang,0,0,15,16
1668299369678,MATH 248,A00,098036,Bejenaru; Ioan,10,0,10,0
1668299370106,MATH 250B,A00,098037,Spolaor; Luca,14,0,15,1
1668299370529,MATH 258,A00,098038,Ni; Lei,10,0,10,0
1668299370956,MATH 264B,A00,098041,Rhoades; Brendon Patrick,9,0,15,6
1668299371381,MATH 268,A00,098042,Buss; Samuel R,10,0,10,0
1668299371807,MATH 269,A00,098043,Rhoades; Brendon Patrick,10,0,10,0
1668299372231,MATH 270B,A00,098044,Li; Bo,10,0,15,5
1668299372654,MATH 272B,A00,098045,Holst; Michael J,13,0,15,2
1668299373081,MATH 273A,A00,098046,Tian; Xiaochuan,10,0,15,5
1668299373512,MATH 275,A01,098048,Tian; Xiaochuan,6,0,10,4
1668299374014,MATH 278A,A00,098049,Holst; Michael J,8,0,10,2
1668299374440,MATH 278B,A00,098050,Cloninger; Alexander,10,0,10,0
1668299374866,MATH 278C,A00,098051,Nie; Jiawang,7,0,10,3
1668299375291,MATH 280B,A00,098052,Zheng; Tianyi,8,0,15,7
1668299375726,MATH 281B,A00,098053,Bradic; Jelena,1,0,15,14
1668299376151,MATH 282B,A00,098054,Arias-Castro; Ery,0,0,15,15
1668299376575,MATH 285,A00,098055,Fitzsimmons; Patrick J,0,0,15,17
1668299377002,MATH 287B,A00,098056,Arias-Castro; Ery,2,0,15,13
1668299377428,MATH 288,A00,098057,Agarwal; Pooja,9,0,10,1
1668299377428,MATH 288,B00,098058,Zhang; Danna,8,0,10,2
1668299377428,MATH 288,C00,098059,Williams; Ruth J,9,0,10,1
1668299377854,MATH 290B,A00,098060,Roberts; Justin Deritter,13,0,15,2
1668299378280,MATH 292,A00,098061,Belmont; Eva Kinoshita,10,0,10,0
1668299378709,MATH 295,A00,098062,Suk; Andrew Hoon,48,0,50,2
1668299379144,MATH 296,A00,098063,Novak; Jonathan I,20,0,20,0
1668299379566,MATH 297,001,098064,Gamst; Anthony Collins,9997,0,9999,2
1668299878538,COGS 205,A00,101395,Chiba; Andrea,19,0,20,1
1668299878962,COGS 210B,001,101404,Greene; Deanna Jacquelyn,9998,0,9999,1
1668299878962,COGS 210B,002,101417,Xia; Haijun,9999,0,9999,0
1668299878962,COGS 210B,003,101422,Nitz; Douglas A.,9999,0,9999,0
1668299878962,COGS 210B,004,101423,Hollan; James D.,9998,0,9999,1
1668299878962,COGS 210B,005,101424,Deak; Gedeon O.,9998,0,9999,1
1668299878962,COGS 210B,006,101425,Rossano; Federico,9999,0,9999,0
1668299879384,COGS 211B,A00,101427,Coulson; Seana M,9996,0,9999,3
1668299879808,COGS 220,A00,101428,Hollan; James D.,0,0,25,25
1668299880234,COGS 229,A00,101429,Dow; Steven P,18,0,25,7
1668299880659,COGS 230,A00,101430,Klemmer; Scott R,12,0,17,5
1668299881083,COGS 234,A00,101431,Xia; Haijun,1,0,25,24
1668299881505,COGS 260,A00,101432,Kiyonaga; Anastasia,21,0,25,4
1668299881505,COGS 260,B00,101433,Kirsh; David Joel,15,0,25,10
1668299881928,CSE 202,A00,102371,Impagliazzo; Russell,0,0,0,0
1668299882351,CSE 203B,A01,102373,Cheng; Chung Kuan,0,0,0,0
1668299882774,CSE 208,A00,102374,Micciancio; Daniele,0,0,0,0
1668299883208,CSE 209A,A00,112895,Impagliazzo; Russell,0,0,15,15
1668299883630,CSE 209B,A00,108005,Bellare; Mihir,0,0,0,0
1668299884057,CSE 210,A00,113163,Coblenz; Michael J,0,0,0,0
1668299884480,CSE 219,A00,106111,Dow; Steven P,0,0,20,20
1668299884903,CSE 221,A00,102376,Voelker; Geoffrey M.,0,0,0,0
1668299885326,CSE 224,A01,102378,Porter; George M,0,0,0,0
1668299885750,CSE 229A,A00,102379,Savage; Stefan,0,0,0,0
1668299886172,CSE 229C,A00,102380,Munyaka; Imani N. S.,0,0,0,0
1668299886593,CSE 232B,A00,102382,Deutsch; Alin Bernard,0,0,0,0
1668299887018,CSE 234,A01,112904,Kumar; Arun Kumar,0,0,0,0
1668299887443,CSE 237A,A00,102383,Rosing; Tajana Simunic,0,0,0,0
1668299887867,CSE 239A,A00,102384,Deutsch; Alin Bernard,0,0,0,0
1668299888289,CSE 239B,A00,102385,Polikarpova; Nadezhda,0,0,0,0
1668299888713,CSE 240A,A00,102386,Pannuto; Patrick William,0,0,0,0
1668299889140,CSE 240B,A00,102387,Zhao; Jishen,0,0,0,0
1668299889562,CSE 241A,A00,106406,Kang; Mingu,0,0,0,0
1668299889985,CSE 249B,A00,102388,Kahng; Andrew Byun,0,0,8,8
1668299890408,CSE 251B,A01,102392,Cottrell; Garrison W,0,0,0,0
1668299890408,CSE 251B,A02,102393,Cottrell; Garrison W,0,0,0,0
1668299890832,CSE 252B,A00,102394,Ochoa; Benjamin Lawrence,0,0,0,0
1668299891255,CSE 257,A01,102396,Gao; Sicun,0,0,0,0
1668299891679,CSE 272,A00,102397,Li; Tzumao,0,0,0,0
1668299892104,CSE 274,A00,111323,Chern; Albert Ren-Haur,0,0,0,0
1668299892527,CSE 282,A00,102398,Pevzner; Pavel Arkadjevich,0,0,0,0
1668299893028,CSE 284,A00,114175,Gymrek; Melissa Ann,0,0,0,0
1668299893457,CSE 290,A00,102399,Chandraker; Manmohan Krishna,0,0,0,0
1668299893457,CSE 290,B00,102400,Vaccaro; Kristen Marie,0,0,25,25
1668299893457,CSE 290,C00,102414,Pannuto; Patrick William,0,0,25,25
1668299893457,CSE 290,D00,102427,Pevzner; Pavel Arkadjevich,0,0,0,0
1668299893457,CSE 290,E00,102429,Zhao; Jishen,0,0,0,0
1668299893457,CSE 290,F00,102436,Tullsen; Dean Michael,0,0,0,0
1668299893457,CSE 290,G00,102440,Christensen; Henrik I,0,0,20,20
1668299893886,CSE 291,A00,102443,Su; Hao,0,0,0,0
1668299893886,CSE 291,B00,102448,Polikarpova; Nadezhda,0,0,0,0
1668299893886,CSE 291,C00,102453,Vaccaro; Kristen Marie,0,0,0,0
1668299893886,CSE 291,D00,111343,Savage; Stefan,0,0,0,0
1668299893886,CSE 291,E00,116474,Claffy; Kimberly Claire,0,0,0,0
1668299893886,CSE 291,F00,116479,Pasquale; Joseph,0,0,0,0
1668299894311,CSE 293,001,119111,Bafna; Vineet,9999,0,9999,0
1668299894311,CSE 293,002,119118,Bellare; Mihir,9999,0,9999,0
1668299894311,CSE 293,003,119122,Berg-Kirkpatrick; Taylor D,9999,0,9999,0
1668299894311,CSE 293,004,119135,Christensen; Henrik I,9999,0,9999,0
1668299894311,CSE 293,005,119142,Cottrell; Garrison W,9999,0,9999,0
1668299894311,CSE 293,006,119146,Deutsch; Alin Bernard,9999,0,9999,0
1668299894311,CSE 293,007,119159,Esmaeilzadeh; Hadi,9999,0,9999,0
1668299894311,CSE 293,008,119166,Freund; Yoav,9999,0,9999,0
1668299894311,CSE 293,009,119170,Griswold; William G.,9999,0,9999,0
1668299894311,CSE 293,010,119183,Gymrek; Melissa Ann,9999,0,9999,0
1668299894311,CSE 293,011,119190,Heninger; Nadia A,9999,0,9999,0
1668299894311,CSE 293,012,119230,Impagliazzo; Russell,9999,0,9999,0
1668299894311,CSE 293,013,119232,Jhala; Ranjit,9999,0,9999,0
1668299894311,CSE 293,014,119233,Kahng; Andrew Byun,9999,0,9999,0
1668299894311,CSE 293,015,119298,Kane; Daniel Mertz,9999,0,9999,0
1668299894311,CSE 293,016,119299,Kriegman; David J,9999,0,9999,0
1668299894311,CSE 293,017,119300,Kumar; Arun Kumar,9999,0,9999,0
1668299894311,CSE 293,018,119301,Lerner; Sorin,9999,0,9999,0
1668299894311,CSE 293,019,119302,Lovett; Shachar,9999,0,9999,0
1668299894311,CSE 293,020,119303,McAuley; Julian John,9999,0,9999,0
1668299894311,CSE 293,021,119304,Micciancio; Daniele,9999,0,9999,0
1668299894311,CSE 293,022,119367,Orailoglu; Alex,9999,0,9999,0
1668299894311,CSE 293,023,119382,Paturi; Ramamohan,9999,0,9999,0
1668299894311,CSE 293,024,119404,Polikarpova; Nadezhda,9999,0,9999,0
1668299894311,CSE 293,025,119406,Politz; Joseph Gibbs,9999,0,9999,0
1668299894311,CSE 293,026,119411,Porter; George M,9999,0,9999,0
1668299894311,CSE 293,027,119414,Porter; Leonard Emerson,9999,0,9999,0
1668299894311,CSE 293,028,119416,Ramamoorthi; Ravi,9999,0,9999,0
1668299894311,CSE 293,029,119417,Sahoo; Debashis,9999,0,9999,0
1668299894311,CSE 293,030,119420,Saul; Lawrence,9999,0,9999,0
1668299894311,CSE 293,031,119421,Savage; Stefan,9999,0,9999,0
1668299894311,CSE 293,032,119425,Schulze; Jurgen P.,9999,0,9999,0
1668299894311,CSE 293,033,119426,Snoeren; Alex C.,9999,0,9999,0
1668299894311,CSE 293,034,119428,Shang; Jingbo,9999,0,9999,0
1668299894311,CSE 293,035,119430,Stefan; Deian,9999,0,9999,0
1668299894311,CSE 293,036,119431,Su; Hao,9999,0,9999,0
1668299894311,CSE 293,037,119433,Swanson; Steven James,9999,0,9999,0
1668299894311,CSE 293,038,119435,Tullsen; Dean Michael,9999,0,9999,0
1668299894311,CSE 293,039,119483,Voelker; Geoffrey M.,9999,0,9999,0
1668299894311,CSE 293,040,119537,Zhao; Jishen,9999,0,9999,0
1668299894311,CSE 293,041,119538,Zhou; Yuan-Yuan,9999,0,9999,0
1668299894311,CSE 293,042,119539,Gao; Sicun,9999,0,9999,0
1668299894311,CSE 293,043,119540,Weibel; Nadir,9999,0,9999,0
1668299894311,CSE 293,044,119541,Gupta; Rajesh K.,9999,0,9999,0
1668299894311,CSE 293,045,126410,Vaccaro; Kristen Marie,9999,0,9999,0
1668299894311,CSE 293,046,126411,Klemke; Richard,9999,0,9999,0
1668299894738,CSE 294,A00,102459,Voelker; Geoffrey M.,0,0,0,0
1668299894738,CSE 294,B00,111322,Orailoglu; Alex,0,0,0,0
1668299895161,DSE 201,A00,096914,Deutsch; Alin Bernard,30,0,30,0
1668299895582,DSE 210,A00,096915,Dasgupta; Sanjoy,30,0,30,0
1668299896004,DSE 260A,A00,096916,Altintas De Callaf; Ilkay,30,0,30,0
1668299896432,ECE 200,001,103586,Antipa; Nicholas A,9999,0,9999,0
1668299896432,ECE 200,002,103587,Atanasov; Nikolay A.,9999,0,9999,0
1668299896432,ECE 200,003,103588,Bharadia; Dinesh,9999,0,9999,0
1668299896432,ECE 200,004,103589,Cheng; Chung Kuan,9999,0,9999,0
1668299896432,ECE 200,005,103590,Cosman; Pamela C.,9999,0,9999,0
1668299896432,ECE 200,006,103591,Dayeh; Shadi Ahmad,9999,0,9999,0
1668299896432,ECE 200,007,103592,Fainman; Yeshaiahu,9999,0,9999,0
1668299896432,ECE 200,008,103593,Ford; Joseph Earl,9999,0,9999,0
1668299896432,ECE 200,009,103594,Franceschetti; Massimo,9999,0,9999,0
1668299896432,ECE 200,010,103595,Fullerton; Eric E,9999,0,9999,0
1668299896432,ECE 200,011,103596,Galton; Ian A,9999,0,9999,0
1668299896432,ECE 200,012,103597,Gilja; Vikash,9999,0,9999,0
1668299896432,ECE 200,013,103598,Hall; Drew A.,9999,0,9999,0
1668299896432,ECE 200,014,103599,Hsueh; Tzu-Chien,9999,0,9999,0
1668299896432,ECE 200,015,103600,Javidi; Tara,9999,0,9999,0
1668299896432,ECE 200,016,103601,Kahng; Andrew Byun,9999,0,9999,0
1668299896432,ECE 200,017,103602,Kim; Young-Han,9999,0,9999,0
1668299896432,ECE 200,018,103603,Koushanfar; Farinaz,9999,0,9999,0
1668299896432,ECE 200,019,103604,Kuzum; Duygu,9999,0,9999,0
1668299896432,ECE 200,020,103605,Le; Hanh-Phuc,9999,0,9999,0
1668299896432,ECE 200,021,103606,Lin; Bill,9999,0,9999,0
1668299896432,ECE 200,022,103607,Liu; Zhaowei,9998,0,9999,1
1668299896432,ECE 200,023,103608,Lo; Yu-Hwa,9999,0,9999,0
1668299896432,ECE 200,024,103609,Lomakin; Vitaliy,9999,0,9999,0
1668299896432,ECE 200,025,103610,Mercier; Patrick Philip,9999,0,9999,0
1668299896432,ECE 200,026,103611,Meyer; Florian,9999,0,9999,0
1668299896432,ECE 200,027,103612,Milstein; Laurence B.,9999,0,9999,0
1668299896432,ECE 200,028,103613,Mir Arabbaygi; Siavash,9999,0,9999,0
1668299896432,ECE 200,029,103614,Mookherjea; Shayan,9999,0,9999,0
1668299896432,ECE 200,030,103615,Morris; Karcher William,9999,0,9999,0
1668299896432,ECE 200,031,103616,Ng; Tse Nga,9999,0,9999,0
1668299896432,ECE 200,032,103617,Nguyen; Truong Quang,9999,0,9999,0
1668299896432,ECE 200,033,103618,Nomura; Kenji,9999,0,9999,0
1668299896432,ECE 200,034,103619,Orlitsky; Alon,9999,0,9999,0
1668299896432,ECE 200,035,103620,Pal; Piya,9999,0,9999,0
1668299896432,ECE 200,036,103621,Papen; George C.,9999,0,9999,0
1668299896432,ECE 200,037,103622,Radic; Stojan,9999,0,9999,0
1668299896432,ECE 200,038,103623,Rao; Bhaskar D.,9999,0,9999,0
1668299896432,ECE 200,039,103624,Rao; Ramesh R,9999,0,9999,0
1668299896432,ECE 200,040,103625,Rebeiz; Gabriel,9999,0,9999,0
1668299896432,ECE 200,041,103626,Sanford; John R,9999,0,9999,0
1668299896432,ECE 200,042,103627,Siegel; Paul H.,9999,0,9999,0
1668299896432,ECE 200,043,103628,Sievenpiper; Daniel F.,9999,0,9999,0
1668299896432,ECE 200,044,103629,Sworder; David D.,9999,0,9999,0
1668299896432,ECE 200,045,103630,Taur; Yuan,9999,0,9999,0
1668299896432,ECE 200,046,103631,Touri; Behrouz,9999,0,9999,0
1668299896432,ECE 200,047,103632,Trivedi; Mohan M.,9999,0,9999,0
1668299896432,ECE 200,048,103633,Vasconcelos; Nuno,9999,0,9999,0
1668299896432,ECE 200,049,103634,Wang; Xiaolong,9999,0,9999,0
1668299896432,ECE 200,050,103635,Xie; Pengtao,9999,0,9999,0
1668299896432,ECE 200,051,103636,Yip; Michael,9999,0,9999,0
1668299896432,ECE 200,052,103637,Zeger; Kenneth A.,999,0,999,0
1668299896432,ECE 200,053,103638,Zhang; Xinyu,9999,0,9999,0
1668299896432,ECE 200,054,103639,Turakhia; Yatish Girish,9999,0,9999,0
1668299896432,ECE 200,055,103640,Kang; Mingu,9999,0,9999,0
1668299896432,ECE 200,056,103641,Shi; Yuanyuan,9999,0,9999,0
1668299896432,ECE 200,057,103642,Wang; Edward Jay,9999,0,9999,0
1668299896432,ECE 200,058,103643,Zheng; Yang,9999,0,9999,0
1668299896857,ECE 202,A00,103644,Kuzum; Duygu,0,0,0,0
1668299897284,ECE 212BN,A00,103646,Ng; Tse Nga,0,0,0,0
1668299897712,ECE 221,A00,111493,Staff,0,0,0,0
1668299898137,ECE 222B,A00,103647,Lomakin; Vitaliy,0,0,0,0
1668299898563,ECE 230B,A00,103648,Taur; Yuan,0,0,0,0
1668299898993,ECE 238B,A00,103649,Garay; Javier,0,0,0,0
1668299899418,ECE 240B,A00,112900,Fainman; Yeshaiahu,0,0,0,0
1668299899842,ECE 247A,A00,103650,Jokerst; Jesse Vincent,0,0,0,0
1668299900263,ECE 247B,A00,103651,Wang; Joseph,0,0,0,0
1668299900688,ECE 250,A00,103652,Siegel; Paul H.,0,0,0,0
1668299901112,ECE 251A,A00,103654,Rao; Bhaskar D.,0,0,0,0
1668299901533,ECE 257B,A00,103655,Bharadia; Dinesh,0,0,0,0
1668299901956,ECE 258A,A00,103656,Milstein; Laurence B.,0,0,0,0
1668299902395,ECE 260B,A00,103658,Kang; Mingu,0,0,0,0
1668299902827,ECE 264A,A00,103659,Galton; Ian A,0,0,0,0
1668299903255,ECE 265A,A00,103661,Gudem; Prasad S.S.,0,0,0,0
1668299903680,ECE 265D,A00,103662,Gudem; Prasad S.S.,0,0,0,0
1668299904103,ECE 268,A00,103663,Koushanfar; Farinaz,0,0,0,0
1668299904528,ECE 269,A01,103665,Pal; Piya,0,0,0,0
1668299904954,ECE 271B,A00,103666,Vasconcelos; Manuela,0,0,0,0
1668299905379,ECE 276A,A00,103667,Atanasov; Nikolay A.,0,0,0,0
1668299905807,ECE 277,A00,103668,An; Cheolhong,0,0,0,0
1668299906232,ECE 279,A00,117947,Hall; Drew A.,0,0,0,0
1668299907081,ECE 283,A00,103670,Hsueh; Tzu-Chien,0,0,0,0
1668299907506,ECE 284,A00,103671,Turakhia; Yatish Girish,0,0,0,0
1668299907933,ECE 285,A00,103672,Zheng; Yang,0,0,0,0
1668299907933,ECE 285,B00,103673,Sworder; David D.,0,0,0,0
1668299908361,ECE 287,A00,103676,Javidi; Tara,0,0,0,0
1668299908787,MATH 200B,A00,098023,Salehi Golsefidy; Alireza,12,0,15,3
1668299909211,MATH 202B,A00,098024,Rhoades; Brendon Patrick,9,0,15,6
1668299909636,MATH 203B,A00,098025,Oprea; Dragos N.,10,0,15,5
1668299910059,MATH 204B,A00,098026,Sorensen; Claus M,13,0,15,2
1668299910488,MATH 208,A00,098027,Izadi; Elham,7,0,10,3
1668299910911,MATH 209,A00,098028,Pollack; Aaron,10,0,10,0
1668299911343,MATH 211A,A00,112919,Rogalski; Daniel,9,0,10,1
1668299911771,MATH 211B,A00,112920,Seward; Brandon M.,9,0,10,1
1668299912196,MATH 218,A00,098029,Li; Bo,10,0,10,0
1668299912642,MATH 220B,A00,098030,Novak; Jonathan I,11,0,15,4
1668299913067,MATH 221A,A00,098031,Ebenfelt; Peter F,13,0,15,2
1668299913494,MATH 231B,A00,098032,Zlatos; Andrej,12,0,15,3
1668299913916,MATH 240B,A00,098033,Ni; Lei,9,0,15,6
1668299914341,MATH 243,A00,098034,Jekel; David Andrew,10,0,10,0
1668299914765,MATH 245A,A00,098035,Nie; Jiawang,0,0,15,16
1668299915188,MATH 248,A00,098036,Bejenaru; Ioan,10,0,10,0
1668299915619,MATH 250B,A00,098037,Spolaor; Luca,14,0,15,1
1668299916042,MATH 258,A00,098038,Ni; Lei,10,0,10,0
1668299916466,MATH 264B,A00,098041,Rhoades; Brendon Patrick,9,0,15,6
1668299916888,MATH 268,A00,098042,Buss; Samuel R,10,0,10,0
1668299917317,MATH 269,A00,098043,Rhoades; Brendon Patrick,10,0,10,0
1668299917742,MATH 270B,A00,098044,Li; Bo,10,0,15,5
1668299918165,MATH 272B,A00,098045,Holst; Michael J,13,0,15,2
1668299918598,MATH 273A,A00,098046,Tian; Xiaochuan,10,0,15,5
1668299919041,MATH 275,A01,098048,Tian; Xiaochuan,6,0,10,4
1668299919464,MATH 278A,A00,098049,Holst; Michael J,8,0,10,2
1668299919887,MATH 278B,A00,098050,Cloninger; Alexander,10,0,10,0
1668299920311,MATH 278C,A00,098051,Nie; Jiawang,7,0,10,3
1668299920736,MATH 280B,A00,098052,Zheng; Tianyi,8,0,15,7
1668299921160,MATH 281B,A00,098053,Bradic; Jelena,1,0,15,14
1668299921587,MATH 282B,A00,098054,Arias-Castro; Ery,0,0,15,15
1668299922013,MATH 285,A00,098055,Fitzsimmons; Patrick J,0,0,15,17
1668299922436,MATH 287B,A00,098056,Arias-Castro; Ery,2,0,15,13
1668299922860,MATH 288,A00,098057,Agarwal; Pooja,9,0,10,1
1668299922860,MATH 288,B00,098058,Zhang; Danna,8,0,10,2
1668299922860,MATH 288,C00,098059,Williams; Ruth J,9,0,10,1
1668299923289,MATH 290B,A00,098060,Roberts; Justin Deritter,13,0,15,2
1668299923713,MATH 292,A00,098061,Belmont; Eva Kinoshita,10,0,10,0
1668299924136,MATH 295,A00,098062,Suk; Andrew Hoon,48,0,50,2
1668299924564,MATH 296,A00,098063,Novak; Jonathan I,20,0,20,0
1668299924988,MATH 297,001,098064,Gamst; Anthony Collins,9997,0,9999,2
1668300423942,COGS 205,A00,101395,Chiba; Andrea,19,0,20,1
1668300424370,COGS 210B,001,101404,Greene; Deanna Jacquelyn,9998,0,9999,1
1668300424370,COGS 210B,002,101417,Xia; Haijun,9999,0,9999,0
1668300424370,COGS 210B,003,101422,Nitz; Douglas A.,9999,0,9999,0
1668300424370,COGS 210B,004,101423,Hollan; James D.,9998,0,9999,1
1668300424370,COGS 210B,005,101424,Deak; Gedeon O.,9998,0,9999,1
1668300424370,COGS 210B,006,101425,Rossano; Federico,9999,0,9999,0
1668300424791,COGS 211B,A00,101427,Coulson; Seana M,9996,0,9999,3
1668300425218,COGS 220,A00,101428,Hollan; James D.,0,0,25,25
1668300425639,COGS 229,A00,101429,Dow; Steven P,18,0,25,7
1668300426064,COGS 230,A00,101430,Klemmer; Scott R,12,0,17,5
1668300426488,COGS 234,A00,101431,Xia; Haijun,1,0,25,24
1668300426912,COGS 260,A00,101432,Kiyonaga; Anastasia,21,0,25,4
1668300426912,COGS 260,B00,101433,Kirsh; David Joel,15,0,25,10
1668300427336,CSE 202,A00,102371,Impagliazzo; Russell,0,0,0,0
1668300427760,CSE 203B,A01,102373,Cheng; Chung Kuan,0,0,0,0
1668300428183,CSE 208,A00,102374,Micciancio; Daniele,0,0,0,0
1668300428609,CSE 209A,A00,112895,Impagliazzo; Russell,0,0,15,15
1668300429033,CSE 209B,A00,108005,Bellare; Mihir,0,0,0,0
1668300429455,CSE 210,A00,113163,Coblenz; Michael J,0,0,0,0
1668300429879,CSE 219,A00,106111,Dow; Steven P,0,0,20,20
1668300430308,CSE 221,A00,102376,Voelker; Geoffrey M.,0,0,0,0
1668300430736,CSE 224,A01,102378,Porter; George M,0,0,0,0
1668300431158,CSE 229A,A00,102379,Savage; Stefan,0,0,0,0
1668300431582,CSE 229C,A00,102380,Munyaka; Imani N. S.,0,0,0,0
1668300432005,CSE 232B,A00,102382,Deutsch; Alin Bernard,0,0,0,0
1668300432431,CSE 234,A01,112904,Kumar; Arun Kumar,0,0,0,0
1668300432856,CSE 237A,A00,102383,Rosing; Tajana Simunic,0,0,0,0
1668300433278,CSE 239A,A00,102384,Deutsch; Alin Bernard,0,0,0,0
1668300433704,CSE 239B,A00,102385,Polikarpova; Nadezhda,0,0,0,0
1668300434130,CSE 240A,A00,102386,Pannuto; Patrick William,0,0,0,0
1668300434553,CSE 240B,A00,102387,Zhao; Jishen,0,0,0,0
1668300434986,CSE 241A,A00,106406,Kang; Mingu,0,0,0,0
1668300435408,CSE 249B,A00,102388,Kahng; Andrew Byun,0,0,8,8
1668300435836,CSE 251B,A01,102392,Cottrell; Garrison W,0,0,0,0
1668300435836,CSE 251B,A02,102393,Cottrell; Garrison W,0,0,0,0
1668300436261,CSE 252B,A00,102394,Ochoa; Benjamin Lawrence,0,0,0,0
1668300436687,CSE 257,A01,102396,Gao; Sicun,0,0,0,0
1668300437118,CSE 272,A00,102397,Li; Tzumao,0,0,0,0
1668300437540,CSE 274,A00,111323,Chern; Albert Ren-Haur,0,0,0,0
1668300437968,CSE 282,A00,102398,Pevzner; Pavel Arkadjevich,0,0,0,0
1668300438395,CSE 284,A00,114175,Gymrek; Melissa Ann,0,0,0,0
1668300438821,CSE 290,A00,102399,Chandraker; Manmohan Krishna,0,0,0,0
1668300438821,CSE 290,B00,102400,Vaccaro; Kristen Marie,0,0,25,25
1668300438821,CSE 290,C00,102414,Pannuto; Patrick William,0,0,25,25
1668300438821,CSE 290,D00,102427,Pevzner; Pavel Arkadjevich,0,0,0,0
1668300438821,CSE 290,E00,102429,Zhao; Jishen,0,0,0,0
1668300438821,CSE 290,F00,102436,Tullsen; Dean Michael,0,0,0,0
1668300438821,CSE 290,G00,102440,Christensen; Henrik I,0,0,20,20
1668300439252,CSE 291,A00,102443,Su; Hao,0,0,0,0
1668300439252,CSE 291,B00,102448,Polikarpova; Nadezhda,0,0,0,0
1668300439252,CSE 291,C00,102453,Vaccaro; Kristen Marie,0,0,0,0
1668300439252,CSE 291,D00,111343,Savage; Stefan,0,0,0,0
1668300439252,CSE 291,E00,116474,Claffy; Kimberly Claire,0,0,0,0
1668300439252,CSE 291,F00,116479,Pasquale; Joseph,0,0,0,0
1668300439678,CSE 293,001,119111,Bafna; Vineet,9999,0,9999,0
1668300439678,CSE 293,002,119118,Bellare; Mihir,9999,0,9999,0
1668300439678,CSE 293,003,119122,Berg-Kirkpatrick; Taylor D,9999,0,9999,0
1668300439678,CSE 293,004,119135,Christensen; Henrik I,9999,0,9999,0
1668300439678,CSE 293,005,119142,Cottrell; Garrison W,9999,0,9999,0
1668300439678,CSE 293,006,119146,Deutsch; Alin Bernard,9999,0,9999,0
1668300439678,CSE 293,007,119159,Esmaeilzadeh; Hadi,9999,0,9999,0
1668300439678,CSE 293,008,119166,Freund; Yoav,9999,0,9999,0
1668300439678,CSE 293,009,119170,Griswold; William G.,9999,0,9999,0
1668300439678,CSE 293,010,119183,Gymrek; Melissa Ann,9999,0,9999,0
1668300439678,CSE 293,011,119190,Heninger; Nadia A,9999,0,9999,0
1668300439678,CSE 293,012,119230,Impagliazzo; Russell,9999,0,9999,0
1668300439678,CSE 293,013,119232,Jhala; Ranjit,9999,0,9999,0
1668300439678,CSE 293,014,119233,Kahng; Andrew Byun,9999,0,9999,0
1668300439678,CSE 293,015,119298,Kane; Daniel Mertz,9999,0,9999,0
1668300439678,CSE 293,016,119299,Kriegman; David J,9999,0,9999,0
1668300439678,CSE 293,017,119300,Kumar; Arun Kumar,9999,0,9999,0
1668300439678,CSE 293,018,119301,Lerner; Sorin,9999,0,9999,0
1668300439678,CSE 293,019,119302,Lovett; Shachar,9999,0,9999,0
1668300439678,CSE 293,020,119303,McAuley; Julian John,9999,0,9999,0
1668300439678,CSE 293,021,119304,Micciancio; Daniele,9999,0,9999,0
1668300439678,CSE 293,022,119367,Orailoglu; Alex,9999,0,9999,0
1668300439678,CSE 293,023,119382,Paturi; Ramamohan,9999,0,9999,0
1668300439678,CSE 293,024,119404,Polikarpova; Nadezhda,9999,0,9999,0
1668300439678,CSE 293,025,119406,Politz; Joseph Gibbs,9999,0,9999,0
1668300439678,CSE 293,026,119411,Porter; George M,9999,0,9999,0
1668300439678,CSE 293,027,119414,Porter; Leonard Emerson,9999,0,9999,0
1668300439678,CSE 293,028,119416,Ramamoorthi; Ravi,9999,0,9999,0
1668300439678,CSE 293,029,119417,Sahoo; Debashis,9999,0,9999,0
1668300439678,CSE 293,030,119420,Saul; Lawrence,9999,0,9999,0
1668300439678,CSE 293,031,119421,Savage; Stefan,9999,0,9999,0
1668300439678,CSE 293,032,119425,Schulze; Jurgen P.,9999,0,9999,0
1668300439678,CSE 293,033,119426,Snoeren; Alex C.,9999,0,9999,0
1668300439678,CSE 293,034,119428,Shang; Jingbo,9999,0,9999,0
1668300439678,CSE 293,035,119430,Stefan; Deian,9999,0,9999,0
1668300439678,CSE 293,036,119431,Su; Hao,9999,0,9999,0
1668300439678,CSE 293,037,119433,Swanson; Steven James,9999,0,9999,0
1668300439678,CSE 293,038,119435,Tullsen; Dean Michael,9999,0,9999,0
1668300439678,CSE 293,039,119483,Voelker; Geoffrey M.,9999,0,9999,0
1668300439678,CSE 293,040,119537,Zhao; Jishen,9999,0,9999,0
1668300439678,CSE 293,041,119538,Zhou; Yuan-Yuan,9999,0,9999,0
1668300439678,CSE 293,042,119539,Gao; Sicun,9999,0,9999,0
1668300439678,CSE 293,043,119540,Weibel; Nadir,9999,0,9999,0
1668300439678,CSE 293,044,119541,Gupta; Rajesh K.,9999,0,9999,0
1668300439678,CSE 293,045,126410,Vaccaro; Kristen Marie,9999,0,9999,0
1668300439678,CSE 293,046,126411,Klemke; Richard,9999,0,9999,0
1668300440102,CSE 294,A00,102459,Voelker; Geoffrey M.,0,0,0,0
1668300440102,CSE 294,B00,111322,Orailoglu; Alex,0,0,0,0
1668300440539,DSE 201,A00,096914,Deutsch; Alin Bernard,30,0,30,0
1668300440965,DSE 210,A00,096915,Dasgupta; Sanjoy,30,0,30,0
1668300441388,DSE 260A,A00,096916,Altintas De Callaf; Ilkay,30,0,30,0
1668300441828,ECE 200,001,103586,Antipa; Nicholas A,9999,0,9999,0
1668300441828,ECE 200,002,103587,Atanasov; Nikolay A.,9999,0,9999,0
1668300441828,ECE 200,003,103588,Bharadia; Dinesh,9999,0,9999,0
1668300441828,ECE 200,004,103589,Cheng; Chung Kuan,9999,0,9999,0
1668300441828,ECE 200,005,103590,Cosman; Pamela C.,9999,0,9999,0
1668300441828,ECE 200,006,103591,Dayeh; Shadi Ahmad,9999,0,9999,0
1668300441828,ECE 200,007,103592,Fainman; Yeshaiahu,9999,0,9999,0
1668300441828,ECE 200,008,103593,Ford; Joseph Earl,9999,0,9999,0
1668300441828,ECE 200,009,103594,Franceschetti; Massimo,9999,0,9999,0
1668300441828,ECE 200,010,103595,Fullerton; Eric E,9999,0,9999,0
1668300441828,ECE 200,011,103596,Galton; Ian A,9999,0,9999,0
1668300441828,ECE 200,012,103597,Gilja; Vikash,9999,0,9999,0
1668300441828,ECE 200,013,103598,Hall; Drew A.,9999,0,9999,0
1668300441828,ECE 200,014,103599,Hsueh; Tzu-Chien,9999,0,9999,0
1668300441828,ECE 200,015,103600,Javidi; Tara,9999,0,9999,0
1668300441828,ECE 200,016,103601,Kahng; Andrew Byun,9999,0,9999,0
1668300441828,ECE 200,017,103602,Kim; Young-Han,9999,0,9999,0
1668300441828,ECE 200,018,103603,Koushanfar; Farinaz,9999,0,9999,0
1668300441828,ECE 200,019,103604,Kuzum; Duygu,9999,0,9999,0
1668300441828,ECE 200,020,103605,Le; Hanh-Phuc,9999,0,9999,0
1668300441828,ECE 200,021,103606,Lin; Bill,9999,0,9999,0
1668300441828,ECE 200,022,103607,Liu; Zhaowei,9998,0,9999,1
1668300441828,ECE 200,023,103608,Lo; Yu-Hwa,9999,0,9999,0
1668300441828,ECE 200,024,103609,Lomakin; Vitaliy,9999,0,9999,0
1668300441828,ECE 200,025,103610,Mercier; Patrick Philip,9999,0,9999,0
1668300441828,ECE 200,026,103611,Meyer; Florian,9999,0,9999,0
1668300441828,ECE 200,027,103612,Milstein; Laurence B.,9999,0,9999,0
1668300441828,ECE 200,028,103613,Mir Arabbaygi; Siavash,9999,0,9999,0
1668300441828,ECE 200,029,103614,Mookherjea; Shayan,9999,0,9999,0
1668300441828,ECE 200,030,103615,Morris; Karcher William,9999,0,9999,0
1668300441828,ECE 200,031,103616,Ng; Tse Nga,9999,0,9999,0
1668300441828,ECE 200,032,103617,Nguyen; Truong Quang,9999,0,9999,0
1668300441828,ECE 200,033,103618,Nomura; Kenji,9999,0,9999,0
1668300441828,ECE 200,034,103619,Orlitsky; Alon,9999,0,9999,0
1668300441828,ECE 200,035,103620,Pal; Piya,9999,0,9999,0
1668300441828,ECE 200,036,103621,Papen; George C.,9999,0,9999,0
1668300441828,ECE 200,037,103622,Radic; Stojan,9999,0,9999,0
1668300441828,ECE 200,038,103623,Rao; Bhaskar D.,9999,0,9999,0
1668300441828,ECE 200,039,103624,Rao; Ramesh R,9999,0,9999,0
1668300441828,ECE 200,040,103625,Rebeiz; Gabriel,9999,0,9999,0
1668300441828,ECE 200,041,103626,Sanford; John R,9999,0,9999,0
1668300441828,ECE 200,042,103627,Siegel; Paul H.,9999,0,9999,0
1668300441828,ECE 200,043,103628,Sievenpiper; Daniel F.,9999,0,9999,0
1668300441828,ECE 200,044,103629,Sworder; David D.,9999,0,9999,0
1668300441828,ECE 200,045,103630,Taur; Yuan,9999,0,9999,0
1668300441828,ECE 200,046,103631,Touri; Behrouz,9999,0,9999,0
1668300441828,ECE 200,047,103632,Trivedi; Mohan M.,9999,0,9999,0
1668300441828,ECE 200,048,103633,Vasconcelos; Nuno,9999,0,9999,0
1668300441828,ECE 200,049,103634,Wang; Xiaolong,9999,0,9999,0
1668300441828,ECE 200,050,103635,Xie; Pengtao,9999,0,9999,0
1668300441828,ECE 200,051,103636,Yip; Michael,9999,0,9999,0
1668300441828,ECE 200,052,103637,Zeger; Kenneth A.,999,0,999,0
1668300441828,ECE 200,053,103638,Zhang; Xinyu,9999,0,9999,0
1668300441828,ECE 200,054,103639,Turakhia; Yatish Girish,9999,0,9999,0
1668300441828,ECE 200,055,103640,Kang; Mingu,9999,0,9999,0
1668300441828,ECE 200,056,103641,Shi; Yuanyuan,9999,0,9999,0
1668300441828,ECE 200,057,103642,Wang; Edward Jay,9999,0,9999,0
1668300441828,ECE 200,058,103643,Zheng; Yang,9999,0,9999,0
1668300442256,ECE 202,A00,103644,Kuzum; Duygu,0,0,0,0
1668300442679,ECE 212BN,A00,103646,Ng; Tse Nga,0,0,0,0
1668300443103,ECE 221,A00,111493,Staff,0,0,0,0
1668300443528,ECE 222B,A00,103647,Lomakin; Vitaliy,0,0,0,0
1668300443951,ECE 230B,A00,103648,Taur; Yuan,0,0,0,0
1668300444374,ECE 238B,A00,103649,Garay; Javier,0,0,0,0
1668300444798,ECE 240B,A00,112900,Fainman; Yeshaiahu,0,0,0,0
1668300445221,ECE 247A,A00,103650,Jokerst; Jesse Vincent,0,0,0,0
1668300445651,ECE 247B,A00,103651,Wang; Joseph,0,0,0,0
1668300446075,ECE 250,A00,103652,Siegel; Paul H.,0,0,0,0
1668300446506,ECE 251A,A00,103654,Rao; Bhaskar D.,0,0,0,0
1668300446931,ECE 257B,A00,103655,Bharadia; Dinesh,0,0,0,0
1668300447364,ECE 258A,A00,103656,Milstein; Laurence B.,0,0,0,0
1668300447787,ECE 260B,A00,103658,Kang; Mingu,0,0,0,0
1668300448211,ECE 264A,A00,103659,Galton; Ian A,0,0,0,0
1668300448637,ECE 265A,A00,103661,Gudem; Prasad S.S.,0,0,0,0
1668300449064,ECE 265D,A00,103662,Gudem; Prasad S.S.,0,0,0,0
1668300449489,ECE 268,A00,103663,Koushanfar; Farinaz,0,0,0,0
1668300449913,ECE 269,A01,103665,Pal; Piya,0,0,0,0
1668300450338,ECE 271B,A00,103666,Vasconcelos; Manuela,0,0,0,0
1668300450760,ECE 276A,A00,103667,Atanasov; Nikolay A.,0,0,0,0
1668300451185,ECE 277,A00,103668,An; Cheolhong,0,0,0,0
1668300451617,ECE 279,A00,117947,Hall; Drew A.,0,0,0,0
1668300452473,ECE 283,A00,103670,Hsueh; Tzu-Chien,0,0,0,0
1668300452900,ECE 284,A00,103671,Turakhia; Yatish Girish,0,0,0,0
1668300453327,ECE 285,A00,103672,Zheng; Yang,0,0,0,0
1668300453327,ECE 285,B00,103673,Sworder; David D.,0,0,0,0
1668300453751,ECE 287,A00,103676,Javidi; Tara,0,0,0,0
1668300454179,MATH 200B,A00,098023,Salehi Golsefidy; Alireza,12,0,15,3
1668300454602,MATH 202B,A00,098024,Rhoades; Brendon Patrick,9,0,15,6
1668300455119,MATH 203B,A00,098025,Oprea; Dragos N.,10,0,15,5
1668300455541,MATH 204B,A00,098026,Sorensen; Claus M,13,0,15,2
1668300455968,MATH 208,A00,098027,Izadi; Elham,7,0,10,3
1668300456391,MATH 209,A00,098028,Pollack; Aaron,10,0,10,0
1668300456814,MATH 211A,A00,112919,Rogalski; Daniel,9,0,10,1
1668300457236,MATH 211B,A00,112920,Seward; Brandon M.,9,0,10,1
1668300457659,MATH 218,A00,098029,Li; Bo,10,0,10,0
1668300458084,MATH 220B,A00,098030,Novak; Jonathan I,11,0,15,4
1668300458506,MATH 221A,A00,098031,Ebenfelt; Peter F,13,0,15,2
1668300458931,MATH 231B,A00,098032,Zlatos; Andrej,12,0,15,3
1668300459353,MATH 240B,A00,098033,Ni; Lei,9,0,15,6
1668300459778,MATH 243,A00,098034,Jekel; David Andrew,10,0,10,0
1668300460204,MATH 245A,A00,098035,Nie; Jiawang,0,0,15,16
1668300460627,MATH 248,A00,098036,Bejenaru; Ioan,10,0,10,0
1668300461054,MATH 250B,A00,098037,Spolaor; Luca,14,0,15,1
1668300461477,MATH 258,A00,098038,Ni; Lei,10,0,10,0
1668300461904,MATH 264B,A00,098041,Rhoades; Brendon Patrick,9,0,15,6
1668300462326,MATH 268,A00,098042,Buss; Samuel R,10,0,10,0
1668300462753,MATH 269,A00,098043,Rhoades; Brendon Patrick,10,0,10,0
1668300463180,MATH 270B,A00,098044,Li; Bo,10,0,15,5
1668300463603,MATH 272B,A00,098045,Holst; Michael J,13,0,15,2
1668300464029,MATH 273A,A00,098046,Tian; Xiaochuan,10,0,15,5
1668300464452,MATH 275,A01,098048,Tian; Xiaochuan,6,0,10,4
1668300464875,MATH 278A,A00,098049,Holst; Michael J,8,0,10,2
1668300465304,MATH 278B,A00,098050,Cloninger; Alexander,10,0,10,0
1668300465728,MATH 278C,A00,098051,Nie; Jiawang,7,0,10,3
1668300466155,MATH 280B,A00,098052,Zheng; Tianyi,8,0,15,7
1668300466579,MATH 281B,A00,098053,Bradic; Jelena,1,0,15,14
1668300467002,MATH 282B,A00,098054,Arias-Castro; Ery,0,0,15,15
1668300467427,MATH 285,A00,098055,Fitzsimmons; Patrick J,0,0,15,17
1668300467854,MATH 287B,A00,098056,Arias-Castro; Ery,2,0,15,13
1668300468280,MATH 288,A00,098057,Agarwal; Pooja,9,0,10,1
1668300468280,MATH 288,B00,098058,Zhang; Danna,8,0,10,2
1668300468280,MATH 288,C00,098059,Williams; Ruth J,9,0,10,1
1668300468704,MATH 290B,A00,098060,Roberts; Justin Deritter,13,0,15,2
1668300469130,MATH 292,A00,098061,Belmont; Eva Kinoshita,10,0,10,0
1668300469554,MATH 295,A00,098062,Suk; Andrew Hoon,48,0,50,2
1668300469978,MATH 296,A00,098063,Novak; Jonathan I,20,0,20,0
1668300470402,MATH 297,001,098064,Gamst; Anthony Collins,9997,0,9999,2
1668300969284,COGS 205,A00,101395,Chiba; Andrea,19,0,20,1
1668300969710,COGS 210B,001,101404,Greene; Deanna Jacquelyn,9998,0,9999,1
1668300969710,COGS 210B,002,101417,Xia; Haijun,9999,0,9999,0
1668300969710,COGS 210B,003,101422,Nitz; Douglas A.,9999,0,9999,0
1668300969710,COGS 210B,004,101423,Hollan; James D.,9998,0,9999,1
1668300969710,COGS 210B,005,101424,Deak; Gedeon O.,9998,0,9999,1
1668300969710,COGS 210B,006,101425,Rossano; Federico,9999,0,9999,0
1668300970135,COGS 211B,A00,101427,Coulson; Seana M,9996,0,9999,3
1668300970560,COGS 220,A00,101428,Hollan; James D.,0,0,25,25
1668300970984,COGS 229,A00,101429,Dow; Steven P,18,0,25,7
1668300971407,COGS 230,A00,101430,Klemmer; Scott R,12,0,17,5
1668300971830,COGS 234,A00,101431,Xia; Haijun,1,0,25,24
1668300972254,COGS 260,A00,101432,Kiyonaga; Anastasia,21,0,25,4
1668300972254,COGS 260,B00,101433,Kirsh; David Joel,15,0,25,10
1668300972677,CSE 202,A00,102371,Impagliazzo; Russell,0,0,0,0
1668300973101,CSE 203B,A01,102373,Cheng; Chung Kuan,0,0,0,0
1668300973533,CSE 208,A00,102374,Micciancio; Daniele,0,0,0,0
1668300974045,CSE 209A,A00,112895,Impagliazzo; Russell,0,0,15,15
1668300974479,CSE 209B,A00,108005,Bellare; Mihir,0,0,0,0
1668300974909,CSE 210,A00,113163,Coblenz; Michael J,0,0,0,0
1668300975333,CSE 219,A00,106111,Dow; Steven P,0,0,20,20
1668300975757,CSE 221,A00,102376,Voelker; Geoffrey M.,0,0,0,0
1668300976180,CSE 224,A01,102378,Porter; George M,0,0,0,0
1668300976605,CSE 229A,A00,102379,Savage; Stefan,0,0,0,0
1668300977028,CSE 229C,A00,102380,Munyaka; Imani N. S.,0,0,0,0
1668300977452,CSE 232B,A00,102382,Deutsch; Alin Bernard,0,0,0,0
1668300977883,CSE 234,A01,112904,Kumar; Arun Kumar,0,0,0,0
1668300978308,CSE 237A,A00,102383,Rosing; Tajana Simunic,0,0,0,0
1668300978734,CSE 239A,A00,102384,Deutsch; Alin Bernard,0,0,0,0
1668300979159,CSE 239B,A00,102385,Polikarpova; Nadezhda,0,0,0,0
1668300979585,CSE 240A,A00,102386,Pannuto; Patrick William,0,0,0,0
1668300980010,CSE 240B,A00,102387,Zhao; Jishen,0,0,0,0
1668300980439,CSE 241A,A00,106406,Kang; Mingu,0,0,0,0
1668300980862,CSE 249B,A00,102388,Kahng; Andrew Byun,0,0,8,8
1668300981287,CSE 251B,A01,102392,Cottrell; Garrison W,0,0,0,0
1668300981287,CSE 251B,A02,102393,Cottrell; Garrison W,0,0,0,0
1668300981710,CSE 252B,A00,102394,Ochoa; Benjamin Lawrence,0,0,0,0
1668300982135,CSE 257,A01,102396,Gao; Sicun,0,0,0,0
1668300982561,CSE 272,A00,102397,Li; Tzumao,0,0,0,0
1668300982986,CSE 274,A00,111323,Chern; Albert Ren-Haur,0,0,0,0
1668300983409,CSE 282,A00,102398,Pevzner; Pavel Arkadjevich,0,0,0,0
1668300983832,CSE 284,A00,114175,Gymrek; Melissa Ann,0,0,0,0
1668300984260,CSE 290,A00,102399,Chandraker; Manmohan Krishna,0,0,0,0
1668300984260,CSE 290,B00,102400,Vaccaro; Kristen Marie,0,0,25,25
1668300984260,CSE 290,C00,102414,Pannuto; Patrick William,0,0,25,25
1668300984260,CSE 290,D00,102427,Pevzner; Pavel Arkadjevich,0,0,0,0
1668300984260,CSE 290,E00,102429,Zhao; Jishen,0,0,0,0
1668300984260,CSE 290,F00,102436,Tullsen; Dean Michael,0,0,0,0
1668300984260,CSE 290,G00,102440,Christensen; Henrik I,0,0,20,20
1668300984691,CSE 291,A00,102443,Su; Hao,0,0,0,0
1668300984691,CSE 291,B00,102448,Polikarpova; Nadezhda,0,0,0,0
1668300984691,CSE 291,C00,102453,Vaccaro; Kristen Marie,0,0,0,0
1668300984691,CSE 291,D00,111343,Savage; Stefan,0,0,0,0
1668300984691,CSE 291,E00,116474,Claffy; Kimberly Claire,0,0,0,0
1668300984691,CSE 291,F00,116479,Pasquale; Joseph,0,0,0,0
1668300985117,CSE 293,001,119111,Bafna; Vineet,9999,0,9999,0
1668300985117,CSE 293,002,119118,Bellare; Mihir,9999,0,9999,0
1668300985117,CSE 293,003,119122,Berg-Kirkpatrick; Taylor D,9999,0,9999,0
1668300985117,CSE 293,004,119135,Christensen; Henrik I,9999,0,9999,0
1668300985117,CSE 293,005,119142,Cottrell; Garrison W,9999,0,9999,0
1668300985117,CSE 293,006,119146,Deutsch; Alin Bernard,9999,0,9999,0
1668300985117,CSE 293,007,119159,Esmaeilzadeh; Hadi,9999,0,9999,0
1668300985117,CSE 293,008,119166,Freund; Yoav,9999,0,9999,0
1668300985117,CSE 293,009,119170,Griswold; William G.,9999,0,9999,0
1668300985117,CSE 293,010,119183,Gymrek; Melissa Ann,9999,0,9999,0
1668300985117,CSE 293,011,119190,Heninger; Nadia A,9999,0,9999,0
1668300985117,CSE 293,012,119230,Impagliazzo; Russell,9999,0,9999,0
1668300985117,CSE 293,013,119232,Jhala; Ranjit,9999,0,9999,0
1668300985117,CSE 293,014,119233,Kahng; Andrew Byun,9999,0,9999,0
1668300985117,CSE 293,015,119298,Kane; Daniel Mertz,9999,0,9999,0
1668300985117,CSE 293,016,119299,Kriegman; David J,9999,0,9999,0
1668300985117,CSE 293,017,119300,Kumar; Arun Kumar,9999,0,9999,0
1668300985117,CSE 293,018,119301,Lerner; Sorin,9999,0,9999,0
1668300985117,CSE 293,019,119302,Lovett; Shachar,9999,0,9999,0
1668300985117,CSE 293,020,119303,McAuley; Julian John,9999,0,9999,0
1668300985117,CSE 293,021,119304,Micciancio; Daniele,9999,0,9999,0
1668300985117,CSE 293,022,119367,Orailoglu; Alex,9999,0,9999,0
1668300985117,CSE 293,023,119382,Paturi; Ramamohan,9999,0,9999,0
1668300985117,CSE 293,024,119404,Polikarpova; Nadezhda,9999,0,9999,0
1668300985117,CSE 293,025,119406,Politz; Joseph Gibbs,9999,0,9999,0
1668300985117,CSE 293,026,119411,Porter; George M,9999,0,9999,0
1668300985117,CSE 293,027,119414,Porter; Leonard Emerson,9999,0,9999,0
1668300985117,CSE 293,028,119416,Ramamoorthi; Ravi,9999,0,9999,0
1668300985117,CSE 293,029,119417,Sahoo; Debashis,9999,0,9999,0
1668300985117,CSE 293,030,119420,Saul; Lawrence,9999,0,9999,0
1668300985117,CSE 293,031,119421,Savage; Stefan,9999,0,9999,0
1668300985117,CSE 293,032,119425,Schulze; Jurgen P.,9999,0,9999,0
1668300985117,CSE 293,033,119426,Snoeren; Alex C.,9999,0,9999,0
1668300985117,CSE 293,034,119428,Shang; Jingbo,9999,0,9999,0
1668300985117,CSE 293,035,119430,Stefan; Deian,9999,0,9999,0
1668300985117,CSE 293,036,119431,Su; Hao,9999,0,9999,0
1668300985117,CSE 293,037,119433,Swanson; Steven James,9999,0,9999,0
1668300985117,CSE 293,038,119435,Tullsen; Dean Michael,9999,0,9999,0
1668300985117,CSE 293,039,119483,Voelker; Geoffrey M.,9999,0,9999,0
1668300985117,CSE 293,040,119537,Zhao; Jishen,9999,0,9999,0
1668300985117,CSE 293,041,119538,Zhou; Yuan-Yuan,9999,0,9999,0
1668300985117,CSE 293,042,119539,Gao; Sicun,9999,0,9999,0
1668300985117,CSE 293,043,119540,Weibel; Nadir,9999,0,9999,0
1668300985117,CSE 293,044,119541,Gupta; Rajesh K.,9999,0,9999,0
1668300985117,CSE 293,045,126410,Vaccaro; Kristen Marie,9999,0,9999,0
1668300985117,CSE 293,046,126411,Klemke; Richard,9999,0,9999,0
1668300985542,CSE 294,A00,102459,Voelker; Geoffrey M.,0,0,0,0
1668300985542,CSE 294,B00,111322,Orailoglu; Alex,0,0,0,0
1668300985969,DSE 201,A00,096914,Deutsch; Alin Bernard,30,0,30,0
1668300986392,DSE 210,A00,096915,Dasgupta; Sanjoy,30,0,30,0
1668300986814,DSE 260A,A00,096916,Altintas De Callaf; Ilkay,30,0,30,0
1668300987243,ECE 200,001,103586,Antipa; Nicholas A,9999,0,9999,0
1668300987243,ECE 200,002,103587,Atanasov; Nikolay A.,9999,0,9999,0
1668300987243,ECE 200,003,103588,Bharadia; Dinesh,9999,0,9999,0
1668300987243,ECE 200,004,103589,Cheng; Chung Kuan,9999,0,9999,0
1668300987243,ECE 200,005,103590,Cosman; Pamela C.,9999,0,9999,0
1668300987243,ECE 200,006,103591,Dayeh; Shadi Ahmad,9999,0,9999,0
1668300987243,ECE 200,007,103592,Fainman; Yeshaiahu,9999,0,9999,0
1668300987243,ECE 200,008,103593,Ford; Joseph Earl,9999,0,9999,0
1668300987243,ECE 200,009,103594,Franceschetti; Massimo,9999,0,9999,0
1668300987243,ECE 200,010,103595,Fullerton; Eric E,9999,0,9999,0
1668300987243,ECE 200,011,103596,Galton; Ian A,9999,0,9999,0
1668300987243,ECE 200,012,103597,Gilja; Vikash,9999,0,9999,0
1668300987243,ECE 200,013,103598,Hall; Drew A.,9999,0,9999,0
1668300987243,ECE 200,014,103599,Hsueh; Tzu-Chien,9999,0,9999,0
1668300987243,ECE 200,015,103600,Javidi; Tara,9999,0,9999,0
1668300987243,ECE 200,016,103601,Kahng; Andrew Byun,9999,0,9999,0
1668300987243,ECE 200,017,103602,Kim; Young-Han,9999,0,9999,0
1668300987243,ECE 200,018,103603,Koushanfar; Farinaz,9999,0,9999,0
1668300987243,ECE 200,019,103604,Kuzum; Duygu,9999,0,9999,0
1668300987243,ECE 200,020,103605,Le; Hanh-Phuc,9999,0,9999,0
1668300987243,ECE 200,021,103606,Lin; Bill,9999,0,9999,0
1668300987243,ECE 200,022,103607,Liu; Zhaowei,9998,0,9999,1
1668300987243,ECE 200,023,103608,Lo; Yu-Hwa,9999,0,9999,0
1668300987243,ECE 200,024,103609,Lomakin; Vitaliy,9999,0,9999,0
1668300987243,ECE 200,025,103610,Mercier; Patrick Philip,9999,0,9999,0
1668300987243,ECE 200,026,103611,Meyer; Florian,9999,0,9999,0
1668300987243,ECE 200,027,103612,Milstein; Laurence B.,9999,0,9999,0
1668300987243,ECE 200,028,103613,Mir Arabbaygi; Siavash,9999,0,9999,0
1668300987243,ECE 200,029,103614,Mookherjea; Shayan,9999,0,9999,0
1668300987243,ECE 200,030,103615,Morris; Karcher William,9999,0,9999,0
1668300987243,ECE 200,031,103616,Ng; Tse Nga,9999,0,9999,0
1668300987243,ECE 200,032,103617,Nguyen; Truong Quang,9999,0,9999,0
1668300987243,ECE 200,033,103618,Nomura; Kenji,9999,0,9999,0
1668300987243,ECE 200,034,103619,Orlitsky; Alon,9999,0,9999,0
1668300987243,ECE 200,035,103620,Pal; Piya,9999,0,9999,0
1668300987243,ECE 200,036,103621,Papen; George C.,9999,0,9999,0
1668300987243,ECE 200,037,103622,Radic; Stojan,9999,0,9999,0
1668300987243,ECE 200,038,103623,Rao; Bhaskar D.,9999,0,9999,0
1668300987243,ECE 200,039,103624,Rao; Ramesh R,9999,0,9999,0
1668300987243,ECE 200,040,103625,Rebeiz; Gabriel,9999,0,9999,0
1668300987243,ECE 200,041,103626,Sanford; John R,9999,0,9999,0
1668300987243,ECE 200,042,103627,Siegel; Paul H.,9999,0,9999,0
1668300987243,ECE 200,043,103628,Sievenpiper; Daniel F.,9999,0,9999,0
1668300987243,ECE 200,044,103629,Sworder; David D.,9999,0,9999,0
1668300987243,ECE 200,045,103630,Taur; Yuan,9999,0,9999,0
1668300987243,ECE 200,046,103631,Touri; Behrouz,9999,0,9999,0
1668300987243,ECE 200,047,103632,Trivedi; Mohan M.,9999,0,9999,0
1668300987243,ECE 200,048,103633,Vasconcelos; Nuno,9999,0,9999,0
1668300987243,ECE 200,049,103634,Wang; Xiaolong,9999,0,9999,0
1668300987243,ECE 200,050,103635,Xie; Pengtao,9999,0,9999,0
1668300987243,ECE 200,051,103636,Yip; Michael,9999,0,9999,0
1668300987243,ECE 200,052,103637,Zeger; Kenneth A.,999,0,999,0
1668300987243,ECE 200,053,103638,Zhang; Xinyu,9999,0,9999,0
1668300987243,ECE 200,054,103639,Turakhia; Yatish Girish,9999,0,9999,0
1668300987243,ECE 200,055,103640,Kang; Mingu,9999,0,9999,0
1668300987243,ECE 200,056,103641,Shi; Yuanyuan,9999,0,9999,0
1668300987243,ECE 200,057,103642,Wang; Edward Jay,9999,0,9999,0
1668300987243,ECE 200,058,103643,Zheng; Yang,9999,0,9999,0
1668300987667,ECE 202,A00,103644,Kuzum; Duygu,0,0,0,0
1668300988088,ECE 212BN,A00,103646,Ng; Tse Nga,0,0,0,0
1668300988512,ECE 221,A00,111493,Staff,0,0,0,0
1668300988938,ECE 222B,A00,103647,Lomakin; Vitaliy,0,0,0,0
1668300989363,ECE 230B,A00,103648,Taur; Yuan,0,0,0,0
1668300989786,ECE 238B,A00,103649,Garay; Javier,0,0,0,0
1668300990211,ECE 240B,A00,112900,Fainman; Yeshaiahu,0,0,0,0
1668300990634,ECE 247A,A00,103650,Jokerst; Jesse Vincent,0,0,0,0
1668300991061,ECE 247B,A00,103651,Wang; Joseph,0,0,0,0
1668300991487,ECE 250,A00,103652,Siegel; Paul H.,0,0,0,0
1668300991910,ECE 251A,A00,103654,Rao; Bhaskar D.,0,0,0,0
1668300992335,ECE 257B,A00,103655,Bharadia; Dinesh,0,0,0,0
1668300992764,ECE 258A,A00,103656,Milstein; Laurence B.,0,0,0,0
1668300993187,ECE 260B,A00,103658,Kang; Mingu,0,0,0,0
1668300993609,ECE 264A,A00,103659,Galton; Ian A,0,0,0,0
1668300994036,ECE 265A,A00,103661,Gudem; Prasad S.S.,0,0,0,0
1668300994459,ECE 265D,A00,103662,Gudem; Prasad S.S.,0,0,0,0
1668300994886,ECE 268,A00,103663,Koushanfar; Farinaz,0,0,0,0
1668300995312,ECE 269,A01,103665,Pal; Piya,0,0,0,0
1668300995735,ECE 271B,A00,103666,Vasconcelos; Manuela,0,0,0,0
1668300996159,ECE 276A,A00,103667,Atanasov; Nikolay A.,0,0,0,0
1668300996581,ECE 277,A00,103668,An; Cheolhong,0,0,0,0
1668300997016,ECE 279,A00,117947,Hall; Drew A.,0,0,0,0
1668300997864,ECE 283,A00,103670,Hsueh; Tzu-Chien,0,0,0,0
1668300998290,ECE 284,A00,103671,Turakhia; Yatish Girish,0,0,0,0
1668300998715,ECE 285,A00,103672,Zheng; Yang,0,0,0,0
1668300998715,ECE 285,B00,103673,Sworder; David D.,0,0,0,0
1668300999140,ECE 287,A00,103676,Javidi; Tara,0,0,0,0
1668300999567,MATH 200B,A00,098023,Salehi Golsefidy; Alireza,12,0,15,3
1668301000000,MATH 202B,A00,098024,Rhoades; Brendon Patrick,9,0,15,6
1668301000426,MATH 203B,A00,098025,Oprea; Dragos N.,10,0,15,5
1668301000850,MATH 204B,A00,098026,Sorensen; Claus M,13,0,15,2
1668301001275,MATH 208,A00,098027,Izadi; Elham,7,0,10,3
1668301001716,MATH 209,A00,098028,Pollack; Aaron,10,0,10,0
1668301002149,MATH 211A,A00,112919,Rogalski; Daniel,9,0,10,1
1668301002574,MATH 211B,A00,112920,Seward; Brandon M.,9,0,10,1
1668301002999,MATH 218,A00,098029,Li; Bo,10,0,10,0
1668301003424,MATH 220B,A00,098030,Novak; Jonathan I,11,0,15,4
1668301003847,MATH 221A,A00,098031,Ebenfelt; Peter F,13,0,15,2
1668301004275,MATH 231B,A00,098032,Zlatos; Andrej,12,0,15,3
1668301004701,MATH 240B,A00,098033,Ni; Lei,9,0,15,6
1668301005124,MATH 243,A00,098034,Jekel; David Andrew,10,0,10,0
1668301005549,MATH 245A,A00,098035,Nie; Jiawang,0,0,15,16
1668301005971,MATH 248,A00,098036,Bejenaru; Ioan,10,0,10,0
1668301006409,MATH 250B,A00,098037,Spolaor; Luca,14,0,15,1
1668301006834,MATH 258,A00,098038,Ni; Lei,10,0,10,0
1668301007260,MATH 264B,A00,098041,Rhoades; Brendon Patrick,9,0,15,6
1668301007686,MATH 268,A00,098042,Buss; Samuel R,10,0,10,0
1668301008111,MATH 269,A00,098043,Rhoades; Brendon Patrick,10,0,10,0
1668301008540,MATH 270B,A00,098044,Li; Bo,10,0,15,5
1668301008970,MATH 272B,A00,098045,Holst; Michael J,13,0,15,2
1668301009393,MATH 273A,A00,098046,Tian; Xiaochuan,10,0,15,5
1668301009826,MATH 275,A01,098048,Tian; Xiaochuan,6,0,10,4
1668301010252,MATH 278A,A00,098049,Holst; Michael J,8,0,10,2
1668301010677,MATH 278B,A00,098050,Cloninger; Alexander,10,0,10,0
1668301011101,MATH 278C,A00,098051,Nie; Jiawang,7,0,10,3
1668301011528,MATH 280B,A00,098052,Zheng; Tianyi,8,0,15,7
1668301011955,MATH 281B,A00,098053,Bradic; Jelena,1,0,15,14
1668301012377,MATH 282B,A00,098054,Arias-Castro; Ery,0,0,15,15
1668301012805,MATH 285,A00,098055,Fitzsimmons; Patrick J,0,0,15,17
1668301013228,MATH 287B,A00,098056,Arias-Castro; Ery,2,0,15,13
1668301013653,MATH 288,A00,098057,Agarwal; Pooja,9,0,10,1
1668301013653,MATH 288,B00,098058,Zhang; Danna,8,0,10,2
1668301013653,MATH 288,C00,098059,Williams; Ruth J,9,0,10,1
1668301014078,MATH 290B,A00,098060,Roberts; Justin Deritter,13,0,15,2
1668301014501,MATH 292,A00,098061,Belmont; Eva Kinoshita,10,0,10,0
1668301014925,MATH 295,A00,098062,Suk; Andrew Hoon,48,0,50,2
1668301015349,MATH 296,A00,098063,Novak; Jonathan I,20,0,20,0
1668301015776,MATH 297,001,098064,Gamst; Anthony Collins,9997,0,9999,2
1668301525098,COGS 205,A00,101395,Chiba; Andrea,19,0,20,1
1668301525525,COGS 210B,001,101404,Greene; Deanna Jacquelyn,9998,0,9999,1
1668301525525,COGS 210B,002,101417,Xia; Haijun,9999,0,9999,0
1668301525525,COGS 210B,003,101422,Nitz; Douglas A.,9999,0,9999,0
1668301525525,COGS 210B,004,101423,Hollan; James D.,9998,0,9999,1
1668301525525,COGS 210B,005,101424,Deak; Gedeon O.,9998,0,9999,1
1668301525525,COGS 210B,006,101425,Rossano; Federico,9999,0,9999,0
1668301525950,COGS 211B,A00,101427,Coulson; Seana M,9996,0,9999,3
1668301526377,COGS 220,A00,101428,Hollan; James D.,0,0,25,25
1668301526802,COGS 229,A00,101429,Dow; Steven P,18,0,25,7
1668301527225,COGS 230,A00,101430,Klemmer; Scott R,12,0,17,5
1668301527648,COGS 234,A00,101431,Xia; Haijun,1,0,25,24
1668301528083,COGS 260,A00,101432,Kiyonaga; Anastasia,21,0,25,4
1668301528083,COGS 260,B00,101433,Kirsh; David Joel,15,0,25,10
1668301528511,CSE 202,A00,102371,Impagliazzo; Russell,0,0,0,0
1668301528938,CSE 203B,A01,102373,Cheng; Chung Kuan,0,0,0,0
1668301529372,CSE 208,A00,102374,Micciancio; Daniele,0,0,0,0
1668301529797,CSE 209A,A00,112895,Impagliazzo; Russell,0,0,15,15
1668301530221,CSE 209B,A00,108005,Bellare; Mihir,0,0,0,0
1668301530648,CSE 210,A00,113163,Coblenz; Michael J,0,0,0,0
1668301531072,CSE 219,A00,106111,Dow; Steven P,0,0,20,20
1668301531495,CSE 221,A00,102376,Voelker; Geoffrey M.,0,0,0,0
1668301531919,CSE 224,A01,102378,Porter; George M,0,0,0,0
1668301532345,CSE 229A,A00,102379,Savage; Stefan,0,0,0,0
1668301532785,CSE 229C,A00,102380,Munyaka; Imani N. S.,0,0,0,0
1668301533209,CSE 232B,A00,102382,Deutsch; Alin Bernard,0,0,0,0
1668301533634,CSE 234,A01,112904,Kumar; Arun Kumar,0,0,0,0
1668301534057,CSE 237A,A00,102383,Rosing; Tajana Simunic,0,0,0,0
1668301534481,CSE 239A,A00,102384,Deutsch; Alin Bernard,0,0,0,0
1668301534904,CSE 239B,A00,102385,Polikarpova; Nadezhda,0,0,0,0
1668301536526,CSE 240A,A00,102386,Pannuto; Patrick William,0,0,0,0
1668301536954,CSE 240B,A00,102387,Zhao; Jishen,0,0,0,0
1668301537377,CSE 241A,A00,106406,Kang; Mingu,0,0,0,0
1668301537799,CSE 249B,A00,102388,Kahng; Andrew Byun,0,0,8,8
1668301538224,CSE 251B,A01,102392,Cottrell; Garrison W,0,0,0,0
1668301538224,CSE 251B,A02,102393,Cottrell; Garrison W,0,0,0,0
1668301538652,CSE 252B,A00,102394,Ochoa; Benjamin Lawrence,0,0,0,0
1668301539075,CSE 257,A01,102396,Gao; Sicun,0,0,0,0
1668301539504,CSE 272,A00,102397,Li; Tzumao,0,0,0,0
1668301539929,CSE 274,A00,111323,Chern; Albert Ren-Haur,0,0,0,0
1668301540354,CSE 282,A00,102398,Pevzner; Pavel Arkadjevich,0,0,0,0
1668301540780,CSE 284,A00,114175,Gymrek; Melissa Ann,0,0,0,0
1668301541206,CSE 290,A00,102399,Chandraker; Manmohan Krishna,0,0,0,0
1668301541206,CSE 290,B00,102400,Vaccaro; Kristen Marie,0,0,25,25
1668301541206,CSE 290,C00,102414,Pannuto; Patrick William,0,0,25,25
1668301541206,CSE 290,D00,102427,Pevzner; Pavel Arkadjevich,0,0,0,0
1668301541206,CSE 290,E00,102429,Zhao; Jishen,0,0,0,0
1668301541206,CSE 290,F00,102436,Tullsen; Dean Michael,0,0,0,0
1668301541206,CSE 290,G00,102440,Christensen; Henrik I,0,0,20,20
1668301541631,CSE 291,A00,102443,Su; Hao,0,0,0,0
1668301541631,CSE 291,B00,102448,Polikarpova; Nadezhda,0,0,0,0
1668301541631,CSE 291,C00,102453,Vaccaro; Kristen Marie,0,0,0,0
1668301541631,CSE 291,D00,111343,Savage; Stefan,0,0,0,0
1668301541631,CSE 291,E00,116474,Claffy; Kimberly Claire,0,0,0,0
1668301541631,CSE 291,F00,116479,Pasquale; Joseph,0,0,0,0
1668301542075,CSE 293,001,119111,Bafna; Vineet,9999,0,9999,0
1668301542075,CSE 293,002,119118,Bellare; Mihir,9999,0,9999,0
1668301542075,CSE 293,003,119122,Berg-Kirkpatrick; Taylor D,9999,0,9999,0
1668301542075,CSE 293,004,119135,Christensen; Henrik I,9999,0,9999,0
1668301542075,CSE 293,005,119142,Cottrell; Garrison W,9999,0,9999,0
1668301542075,CSE 293,006,119146,Deutsch; Alin Bernard,9999,0,9999,0
1668301542075,CSE 293,007,119159,Esmaeilzadeh; Hadi,9999,0,9999,0
1668301542075,CSE 293,008,119166,Freund; Yoav,9999,0,9999,0
1668301542075,CSE 293,009,119170,Griswold; William G.,9999,0,9999,0
1668301542075,CSE 293,010,119183,Gymrek; Melissa Ann,9999,0,9999,0
1668301542075,CSE 293,011,119190,Heninger; Nadia A,9999,0,9999,0
1668301542075,CSE 293,012,119230,Impagliazzo; Russell,9999,0,9999,0
1668301542075,CSE 293,013,119232,Jhala; Ranjit,9999,0,9999,0
1668301542075,CSE 293,014,119233,Kahng; Andrew Byun,9999,0,9999,0
1668301542075,CSE 293,015,119298,Kane; Daniel Mertz,9999,0,9999,0
1668301542075,CSE 293,016,119299,Kriegman; David J,9999,0,9999,0
1668301542075,CSE 293,017,119300,Kumar; Arun Kumar,9999,0,9999,0
1668301542075,CSE 293,018,119301,Lerner; Sorin,9999,0,9999,0
1668301542075,CSE 293,019,119302,Lovett; Shachar,9999,0,9999,0
1668301542075,CSE 293,020,119303,McAuley; Julian John,9999,0,9999,0
1668301542075,CSE 293,021,119304,Micciancio; Daniele,9999,0,9999,0
1668301542075,CSE 293,022,119367,Orailoglu; Alex,9999,0,9999,0
1668301542075,CSE 293,023,119382,Paturi; Ramamohan,9999,0,9999,0
1668301542075,CSE 293,024,119404,Polikarpova; Nadezhda,9999,0,9999,0
1668301542075,CSE 293,025,119406,Politz; Joseph Gibbs,9999,0,9999,0
1668301542075,CSE 293,026,119411,Porter; George M,9999,0,9999,0
1668301542075,CSE 293,027,119414,Porter; Leonard Emerson,9999,0,9999,0
1668301542075,CSE 293,028,119416,Ramamoorthi; Ravi,9999,0,9999,0
1668301542075,CSE 293,029,119417,Sahoo; Debashis,9999,0,9999,0
1668301542075,CSE 293,030,119420,Saul; Lawrence,9999,0,9999,0
1668301542075,CSE 293,031,119421,Savage; Stefan,9999,0,9999,0
1668301542075,CSE 293,032,119425,Schulze; Jurgen P.,9999,0,9999,0
1668301542075,CSE 293,033,119426,Snoeren; Alex C.,9999,0,9999,0
1668301542075,CSE 293,034,119428,Shang; Jingbo,9999,0,9999,0
1668301542075,CSE 293,035,119430,Stefan; Deian,9999,0,9999,0
1668301542075,CSE 293,036,119431,Su; Hao,9999,0,9999,0
1668301542075,CSE 293,037,119433,Swanson; Steven James,9999,0,9999,0
1668301542075,CSE 293,038,119435,Tullsen; Dean Michael,9999,0,9999,0
1668301542075,CSE 293,039,119483,Voelker; Geoffrey M.,9999,0,9999,0
1668301542075,CSE 293,040,119537,Zhao; Jishen,9999,0,9999,0
1668301542075,CSE 293,041,119538,Zhou; Yuan-Yuan,9999,0,9999,0
1668301542075,CSE 293,042,119539,Gao; Sicun,9999,0,9999,0
1668301542075,CSE 293,043,119540,Weibel; Nadir,9999,0,9999,0
1668301542075,CSE 293,044,119541,Gupta; Rajesh K.,9999,0,9999,0
1668301542075,CSE 293,045,126410,Vaccaro; Kristen Marie,9999,0,9999,0
1668301542075,CSE 293,046,126411,Klemke; Richard,9999,0,9999,0
1668301542500,CSE 294,A00,102459,Voelker; Geoffrey M.,0,0,0,0
1668301542500,CSE 294,B00,111322,Orailoglu; Alex,0,0,0,0
1668301542924,DSE 201,A00,096914,Deutsch; Alin Bernard,30,0,30,0
1668301543349,DSE 210,A00,096915,Dasgupta; Sanjoy,30,0,30,0
1668301543772,DSE 260A,A00,096916,Altintas De Callaf; Ilkay,30,0,30,0
1668301544224,ECE 200,001,103586,Antipa; Nicholas A,9999,0,9999,0
1668301544224,ECE 200,002,103587,Atanasov; Nikolay A.,9999,0,9999,0
1668301544224,ECE 200,003,103588,Bharadia; Dinesh,9999,0,9999,0
1668301544224,ECE 200,004,103589,Cheng; Chung Kuan,9999,0,9999,0
1668301544224,ECE 200,005,103590,Cosman; Pamela C.,9999,0,9999,0
1668301544224,ECE 200,006,103591,Dayeh; Shadi Ahmad,9999,0,9999,0
1668301544224,ECE 200,007,103592,Fainman; Yeshaiahu,9999,0,9999,0
1668301544224,ECE 200,008,103593,Ford; Joseph Earl,9999,0,9999,0
1668301544224,ECE 200,009,103594,Franceschetti; Massimo,9999,0,9999,0
1668301544224,ECE 200,010,103595,Fullerton; Eric E,9999,0,9999,0
1668301544224,ECE 200,011,103596,Galton; Ian A,9999,0,9999,0
1668301544224,ECE 200,012,103597,Gilja; Vikash,9999,0,9999,0
1668301544224,ECE 200,013,103598,Hall; Drew A.,9999,0,9999,0
1668301544224,ECE 200,014,103599,Hsueh; Tzu-Chien,9999,0,9999,0
1668301544224,ECE 200,015,103600,Javidi; Tara,9999,0,9999,0
1668301544224,ECE 200,016,103601,Kahng; Andrew Byun,9999,0,9999,0
1668301544224,ECE 200,017,103602,Kim; Young-Han,9999,0,9999,0
1668301544224,ECE 200,018,103603,Koushanfar; Farinaz,9999,0,9999,0
1668301544224,ECE 200,019,103604,Kuzum; Duygu,9999,0,9999,0
1668301544224,ECE 200,020,103605,Le; Hanh-Phuc,9999,0,9999,0
1668301544224,ECE 200,021,103606,Lin; Bill,9999,0,9999,0
1668301544224,ECE 200,022,103607,Liu; Zhaowei,9998,0,9999,1
1668301544224,ECE 200,023,103608,Lo; Yu-Hwa,9999,0,9999,0
1668301544224,ECE 200,024,103609,Lomakin; Vitaliy,9999,0,9999,0
1668301544224,ECE 200,025,103610,Mercier; Patrick Philip,9999,0,9999,0
1668301544224,ECE 200,026,103611,Meyer; Florian,9999,0,9999,0
1668301544224,ECE 200,027,103612,Milstein; Laurence B.,9999,0,9999,0
1668301544224,ECE 200,028,103613,Mir Arabbaygi; Siavash,9999,0,9999,0
1668301544224,ECE 200,029,103614,Mookherjea; Shayan,9999,0,9999,0
1668301544224,ECE 200,030,103615,Morris; Karcher William,9999,0,9999,0
1668301544224,ECE 200,031,103616,Ng; Tse Nga,9999,0,9999,0
1668301544224,ECE 200,032,103617,Nguyen; Truong Quang,9999,0,9999,0
1668301544224,ECE 200,033,103618,Nomura; Kenji,9999,0,9999,0
1668301544224,ECE 200,034,103619,Orlitsky; Alon,9999,0,9999,0
1668301544224,ECE 200,035,103620,Pal; Piya,9999,0,9999,0
1668301544224,ECE 200,036,103621,Papen; George C.,9999,0,9999,0
1668301544224,ECE 200,037,103622,Radic; Stojan,9999,0,9999,0
1668301544224,ECE 200,038,103623,Rao; Bhaskar D.,9999,0,9999,0
1668301544224,ECE 200,039,103624,Rao; Ramesh R,9999,0,9999,0
1668301544224,ECE 200,040,103625,Rebeiz; Gabriel,9999,0,9999,0
1668301544224,ECE 200,041,103626,Sanford; John R,9999,0,9999,0
1668301544224,ECE 200,042,103627,Siegel; Paul H.,9999,0,9999,0
1668301544224,ECE 200,043,103628,Sievenpiper; Daniel F.,9999,0,9999,0
1668301544224,ECE 200,044,103629,Sworder; David D.,9999,0,9999,0
1668301544224,ECE 200,045,103630,Taur; Yuan,9999,0,9999,0
1668301544224,ECE 200,046,103631,Touri; Behrouz,9999,0,9999,0
1668301544224,ECE 200,047,103632,Trivedi; Mohan M.,9999,0,9999,0
1668301544224,ECE 200,048,103633,Vasconcelos; Nuno,9999,0,9999,0
1668301544224,ECE 200,049,103634,Wang; Xiaolong,9999,0,9999,0
1668301544224,ECE 200,050,103635,Xie; Pengtao,9999,0,9999,0
1668301544224,ECE 200,051,103636,Yip; Michael,9999,0,9999,0
1668301544224,ECE 200,052,103637,Zeger; Kenneth A.,999,0,999,0
1668301544224,ECE 200,053,103638,Zhang; Xinyu,9999,0,9999,0
1668301544224,ECE 200,054,103639,Turakhia; Yatish Girish,9999,0,9999,0
1668301544224,ECE 200,055,103640,Kang; Mingu,9999,0,9999,0
1668301544224,ECE 200,056,103641,Shi; Yuanyuan,9999,0,9999,0
1668301544224,ECE 200,057,103642,Wang; Edward Jay,9999,0,9999,0
1668301544224,ECE 200,058,103643,Zheng; Yang,9999,0,9999,0
1668301544649,ECE 202,A00,103644,Kuzum; Duygu,0,0,0,0
1668301545072,ECE 212BN,A00,103646,Ng; Tse Nga,0,0,0,0
1668301545497,ECE 221,A00,111493,Staff,0,0,0,0
1668301545923,ECE 222B,A00,103647,Lomakin; Vitaliy,0,0,0,0
1668301546358,ECE 230B,A00,103648,Taur; Yuan,0,0,0,0
1668301546782,ECE 238B,A00,103649,Garay; Javier,0,0,0,0
1668301547208,ECE 240B,A00,112900,Fainman; Yeshaiahu,0,0,0,0
1668301547709,ECE 247A,A00,103650,Jokerst; Jesse Vincent,0,0,0,0
1668301548133,ECE 247B,A00,103651,Wang; Joseph,0,0,0,0
1668301548557,ECE 250,A00,103652,Siegel; Paul H.,0,0,0,0
1668301548989,ECE 251A,A00,103654,Rao; Bhaskar D.,0,0,0,0
1668301549418,ECE 257B,A00,103655,Bharadia; Dinesh,0,0,0,0
1668301549845,ECE 258A,A00,103656,Milstein; Laurence B.,0,0,0,0
1668301550270,ECE 260B,A00,103658,Kang; Mingu,0,0,0,0
1668301550694,ECE 264A,A00,103659,Galton; Ian A,0,0,0,0
1668301551122,ECE 265A,A00,103661,Gudem; Prasad S.S.,0,0,0,0
1668301551546,ECE 265D,A00,103662,Gudem; Prasad S.S.,0,0,0,0
1668301551968,ECE 268,A00,103663,Koushanfar; Farinaz,0,0,0,0
1668301552390,ECE 269,A01,103665,Pal; Piya,0,0,0,0
1668301552824,ECE 271B,A00,103666,Vasconcelos; Manuela,0,0,0,0
1668301553250,ECE 276A,A00,103667,Atanasov; Nikolay A.,0,0,0,0
1668301553675,ECE 277,A00,103668,An; Cheolhong,0,0,0,0
1668301554101,ECE 279,A00,117947,Hall; Drew A.,0,0,0,0
1668301554949,ECE 283,A00,103670,Hsueh; Tzu-Chien,0,0,0,0
1668301555375,ECE 284,A00,103671,Turakhia; Yatish Girish,0,0,0,0
1668301555801,ECE 285,A00,103672,Zheng; Yang,0,0,0,0
1668301555801,ECE 285,B00,103673,Sworder; David D.,0,0,0,0
1668301556227,ECE 287,A00,103676,Javidi; Tara,0,0,0,0
1668301556652,MATH 200B,A00,098023,Salehi Golsefidy; Alireza,12,0,15,3
1668301557075,MATH 202B,A00,098024,Rhoades; Brendon Patrick,9,0,15,6
1668301557506,MATH 203B,A00,098025,Oprea; Dragos N.,10,0,15,5
1668301557931,MATH 204B,A00,098026,Sorensen; Claus M,13,0,15,2
1668301558356,MATH 208,A00,098027,Izadi; Elham,7,0,10,3
1668301558788,MATH 209,A00,098028,Pollack; Aaron,10,0,10,0
1668301559213,MATH 211A,A00,112919,Rogalski; Daniel,9,0,10,1
1668301559643,MATH 211B,A00,112920,Seward; Brandon M.,9,0,10,1
1668301560123,MATH 218,A00,098029,Li; Bo,10,0,10,0
1668301560551,MATH 220B,A00,098030,Novak; Jonathan I,11,0,15,4
1668301560977,MATH 221A,A00,098031,Ebenfelt; Peter F,13,0,15,2
1668301561400,MATH 231B,A00,098032,Zlatos; Andrej,12,0,15,3
1668301561831,MATH 240B,A00,098033,Ni; Lei,9,0,15,6
1668301562255,MATH 243,A00,098034,Jekel; David Andrew,10,0,10,0
1668301562701,MATH 245A,A00,098035,Nie; Jiawang,0,0,15,16
1668301563136,MATH 248,A00,098036,Bejenaru; Ioan,10,0,10,0
1668301563563,MATH 250B,A00,098037,Spolaor; Luca,14,0,15,1
1668301564002,MATH 258,A00,098038,Ni; Lei,10,0,10,0
1668301564427,MATH 264B,A00,098041,Rhoades; Brendon Patrick,9,0,15,6
1668301564852,MATH 268,A00,098042,Buss; Samuel R,10,0,10,0
1668301565278,MATH 269,A00,098043,Rhoades; Brendon Patrick,10,0,10,0
1668301565703,MATH 270B,A00,098044,Li; Bo,10,0,15,5
1668301566126,MATH 272B,A00,098045,Holst; Michael J,13,0,15,2
1668301566560,MATH 273A,A00,098046,Tian; Xiaochuan,10,0,15,5
1668301566991,MATH 275,A01,098048,Tian; Xiaochuan,6,0,10,4
1668301567418,MATH 278A,A00,098049,Holst; Michael J,8,0,10,2
1668301567840,MATH 278B,A00,098050,Cloninger; Alexander,10,0,10,0
1668301568263,MATH 278C,A00,098051,Nie; Jiawang,7,0,10,3
1668301568686,MATH 280B,A00,098052,Zheng; Tianyi,8,0,15,7
1668301569110,MATH 281B,A00,098053,Bradic; Jelena,1,0,15,14
1668301569532,MATH 282B,A00,098054,Arias-Castro; Ery,0,0,15,15
1668301569955,MATH 285,A00,098055,Fitzsimmons; Patrick J,0,0,15,17
1668301570378,MATH 287B,A00,098056,Arias-Castro; Ery,2,0,15,13
1668301570801,MATH 288,A00,098057,Agarwal; Pooja,9,0,10,1
1668301570801,MATH 288,B00,098058,Zhang; Danna,8,0,10,2
1668301570801,MATH 288,C00,098059,Williams; Ruth J,9,0,10,1
1668301571226,MATH 290B,A00,098060,Roberts; Justin Deritter,13,0,15,2
1668301571649,MATH 292,A00,098061,Belmont; Eva Kinoshita,10,0,10,0
1668301572076,MATH 295,A00,098062,Suk; Andrew Hoon,48,0,50,2
1668301572499,MATH 296,A00,098063,Novak; Jonathan I,20,0,20,0
1668301572924,MATH 297,001,098064,Gamst; Anthony Collins,9997,0,9999,2
1668302072145,COGS 205,A00,101395,Chiba; Andrea,19,0,20,1
1668302072568,COGS 210B,001,101404,Greene; Deanna Jacquelyn,9998,0,9999,1
1668302072568,COGS 210B,002,101417,Xia; Haijun,9999,0,9999,0
1668302072568,COGS 210B,003,101422,Nitz; Douglas A.,9999,0,9999,0
1668302072568,COGS 210B,004,101423,Hollan; James D.,9998,0,9999,1
1668302072568,COGS 210B,005,101424,Deak; Gedeon O.,9998,0,9999,1
1668302072568,COGS 210B,006,101425,Rossano; Federico,9999,0,9999,0
1668302072995,COGS 211B,A00,101427,Coulson; Seana M,9996,0,9999,3
1668302073418,COGS 220,A00,101428,Hollan; James D.,0,0,25,25
1668302073842,COGS 229,A00,101429,Dow; Steven P,18,0,25,7
1668302074266,COGS 230,A00,101430,Klemmer; Scott R,12,0,17,5
1668302074693,COGS 234,A00,101431,Xia; Haijun,1,0,25,24
1668302075119,COGS 260,A00,101432,Kiyonaga; Anastasia,21,0,25,4
1668302075119,COGS 260,B00,101433,Kirsh; David Joel,15,0,25,10
1668302075546,CSE 202,A00,102371,Impagliazzo; Russell,0,0,0,0
1668302075970,CSE 203B,A01,102373,Cheng; Chung Kuan,0,0,0,0
1668302076396,CSE 208,A00,102374,Micciancio; Daniele,0,0,0,0
1668302076819,CSE 209A,A00,112895,Impagliazzo; Russell,0,0,15,15
1668302077245,CSE 209B,A00,108005,Bellare; Mihir,0,0,0,0
1668302077672,CSE 210,A00,113163,Coblenz; Michael J,0,0,0,0
1668302078093,CSE 219,A00,106111,Dow; Steven P,0,0,20,20
1668302078517,CSE 221,A00,102376,Voelker; Geoffrey M.,0,0,0,0
1668302078945,CSE 224,A01,102378,Porter; George M,0,0,0,0
1668302079369,CSE 229A,A00,102379,Savage; Stefan,0,0,0,0
1668302079793,CSE 229C,A00,102380,Munyaka; Imani N. S.,0,0,0,0
1668302080219,CSE 232B,A00,102382,Deutsch; Alin Bernard,0,0,0,0
1668302080644,CSE 234,A01,112904,Kumar; Arun Kumar,0,0,0,0
1668302081071,CSE 237A,A00,102383,Rosing; Tajana Simunic,0,0,0,0
1668302081495,CSE 239A,A00,102384,Deutsch; Alin Bernard,0,0,0,0
1668302081920,CSE 239B,A00,102385,Polikarpova; Nadezhda,0,0,0,0
1668302082346,CSE 240A,A00,102386,Pannuto; Patrick William,0,0,0,0
1668302082771,CSE 240B,A00,102387,Zhao; Jishen,0,0,0,0
1668302083197,CSE 241A,A00,106406,Kang; Mingu,0,0,0,0
1668302083621,CSE 249B,A00,102388,Kahng; Andrew Byun,0,0,8,8
1668302084047,CSE 251B,A01,102392,Cottrell; Garrison W,0,0,0,0
1668302084047,CSE 251B,A02,102393,Cottrell; Garrison W,0,0,0,0
1668302084472,CSE 252B,A00,102394,Ochoa; Benjamin Lawrence,0,0,0,0
1668302084897,CSE 257,A01,102396,Gao; Sicun,0,0,0,0
1668302085320,CSE 272,A00,102397,Li; Tzumao,0,0,0,0
1668302085744,CSE 274,A00,111323,Chern; Albert Ren-Haur,0,0,0,0
1668302086174,CSE 282,A00,102398,Pevzner; Pavel Arkadjevich,0,0,0,0
1668302086601,CSE 284,A00,114175,Gymrek; Melissa Ann,0,0,0,0
1668302087029,CSE 290,A00,102399,Chandraker; Manmohan Krishna,0,0,0,0
1668302087029,CSE 290,B00,102400,Vaccaro; Kristen Marie,0,0,25,25
1668302087029,CSE 290,C00,102414,Pannuto; Patrick William,0,0,25,25
1668302087029,CSE 290,D00,102427,Pevzner; Pavel Arkadjevich,0,0,0,0
1668302087029,CSE 290,E00,102429,Zhao; Jishen,0,0,0,0
1668302087029,CSE 290,F00,102436,Tullsen; Dean Michael,0,0,0,0
1668302087029,CSE 290,G00,102440,Christensen; Henrik I,0,0,20,20
1668302087452,CSE 291,A00,102443,Su; Hao,0,0,0,0
1668302087452,CSE 291,B00,102448,Polikarpova; Nadezhda,0,0,0,0
1668302087452,CSE 291,C00,102453,Vaccaro; Kristen Marie,0,0,0,0
1668302087452,CSE 291,D00,111343,Savage; Stefan,0,0,0,0
1668302087452,CSE 291,E00,116474,Claffy; Kimberly Claire,0,0,0,0
1668302087452,CSE 291,F00,116479,Pasquale; Joseph,0,0,0,0
1668302087886,CSE 293,001,119111,Bafna; Vineet,9999,0,9999,0
1668302087886,CSE 293,002,119118,Bellare; Mihir,9999,0,9999,0
1668302087886,CSE 293,003,119122,Berg-Kirkpatrick; Taylor D,9999,0,9999,0
1668302087886,CSE 293,004,119135,Christensen; Henrik I,9999,0,9999,0
1668302087886,CSE 293,005,119142,Cottrell; Garrison W,9999,0,9999,0
1668302087886,CSE 293,006,119146,Deutsch; Alin Bernard,9999,0,9999,0
1668302087886,CSE 293,007,119159,Esmaeilzadeh; Hadi,9999,0,9999,0
1668302087886,CSE 293,008,119166,Freund; Yoav,9999,0,9999,0
1668302087886,CSE 293,009,119170,Griswold; William G.,9999,0,9999,0
1668302087886,CSE 293,010,119183,Gymrek; Melissa Ann,9999,0,9999,0
1668302087886,CSE 293,011,119190,Heninger; Nadia A,9999,0,9999,0
1668302087886,CSE 293,012,119230,Impagliazzo; Russell,9999,0,9999,0
1668302087886,CSE 293,013,119232,Jhala; Ranjit,9999,0,9999,0
1668302087886,CSE 293,014,119233,Kahng; Andrew Byun,9999,0,9999,0
1668302087886,CSE 293,015,119298,Kane; Daniel Mertz,9999,0,9999,0
1668302087886,CSE 293,016,119299,Kriegman; David J,9999,0,9999,0
1668302087886,CSE 293,017,119300,Kumar; Arun Kumar,9999,0,9999,0
1668302087886,CSE 293,018,119301,Lerner; Sorin,9999,0,9999,0
1668302087886,CSE 293,019,119302,Lovett; Shachar,9999,0,9999,0
1668302087886,CSE 293,020,119303,McAuley; Julian John,9999,0,9999,0
1668302087886,CSE 293,021,119304,Micciancio; Daniele,9999,0,9999,0
1668302087886,CSE 293,022,119367,Orailoglu; Alex,9999,0,9999,0
1668302087886,CSE 293,023,119382,Paturi; Ramamohan,9999,0,9999,0
1668302087886,CSE 293,024,119404,Polikarpova; Nadezhda,9999,0,9999,0
1668302087886,CSE 293,025,119406,Politz; Joseph Gibbs,9999,0,9999,0
1668302087886,CSE 293,026,119411,Porter; George M,9999,0,9999,0
1668302087886,CSE 293,027,119414,Porter; Leonard Emerson,9999,0,9999,0
1668302087886,CSE 293,028,119416,Ramamoorthi; Ravi,9999,0,9999,0
1668302087886,CSE 293,029,119417,Sahoo; Debashis,9999,0,9999,0
1668302087886,CSE 293,030,119420,Saul; Lawrence,9999,0,9999,0
1668302087886,CSE 293,031,119421,Savage; Stefan,9999,0,9999,0
1668302087886,CSE 293,032,119425,Schulze; Jurgen P.,9999,0,9999,0
1668302087886,CSE 293,033,119426,Snoeren; Alex C.,9999,0,9999,0
1668302087886,CSE 293,034,119428,Shang; Jingbo,9999,0,9999,0
1668302087886,CSE 293,035,119430,Stefan; Deian,9999,0,9999,0
1668302087886,CSE 293,036,119431,Su; Hao,9999,0,9999,0
1668302087886,CSE 293,037,119433,Swanson; Steven James,9999,0,9999,0
1668302087886,CSE 293,038,119435,Tullsen; Dean Michael,9999,0,9999,0
1668302087886,CSE 293,039,119483,Voelker; Geoffrey M.,9999,0,9999,0
1668302087886,CSE 293,040,119537,Zhao; Jishen,9999,0,9999,0
1668302087886,CSE 293,041,119538,Zhou; Yuan-Yuan,9999,0,9999,0
1668302087886,CSE 293,042,119539,Gao; Sicun,9999,0,9999,0
1668302087886,CSE 293,043,119540,Weibel; Nadir,9999,0,9999,0
1668302087886,CSE 293,044,119541,Gupta; Rajesh K.,9999,0,9999,0
1668302087886,CSE 293,045,126410,Vaccaro; Kristen Marie,9999,0,9999,0
1668302087886,CSE 293,046,126411,Klemke; Richard,9999,0,9999,0
1668302088319,CSE 294,A00,102459,Voelker; Geoffrey M.,0,0,0,0
1668302088319,CSE 294,B00,111322,Orailoglu; Alex,0,0,0,0
1668302088742,DSE 201,A00,096914,Deutsch; Alin Bernard,30,0,30,0
1668302089165,DSE 210,A00,096915,Dasgupta; Sanjoy,30,0,30,0
1668302089590,DSE 260A,A00,096916,Altintas De Callaf; Ilkay,30,0,30,0
1668302090029,ECE 200,001,103586,Antipa; Nicholas A,9999,0,9999,0
1668302090029,ECE 200,002,103587,Atanasov; Nikolay A.,9999,0,9999,0
1668302090029,ECE 200,003,103588,Bharadia; Dinesh,9999,0,9999,0
1668302090029,ECE 200,004,103589,Cheng; Chung Kuan,9999,0,9999,0
1668302090029,ECE 200,005,103590,Cosman; Pamela C.,9999,0,9999,0
1668302090029,ECE 200,006,103591,Dayeh; Shadi Ahmad,9999,0,9999,0
1668302090029,ECE 200,007,103592,Fainman; Yeshaiahu,9999,0,9999,0
1668302090029,ECE 200,008,103593,Ford; Joseph Earl,9999,0,9999,0
1668302090029,ECE 200,009,103594,Franceschetti; Massimo,9999,0,9999,0
1668302090029,ECE 200,010,103595,Fullerton; Eric E,9999,0,9999,0
1668302090029,ECE 200,011,103596,Galton; Ian A,9999,0,9999,0
1668302090029,ECE 200,012,103597,Gilja; Vikash,9999,0,9999,0
1668302090029,ECE 200,013,103598,Hall; Drew A.,9999,0,9999,0
1668302090029,ECE 200,014,103599,Hsueh; Tzu-Chien,9999,0,9999,0
1668302090029,ECE 200,015,103600,Javidi; Tara,9999,0,9999,0
1668302090029,ECE 200,016,103601,Kahng; Andrew Byun,9999,0,9999,0
1668302090029,ECE 200,017,103602,Kim; Young-Han,9999,0,9999,0
1668302090029,ECE 200,018,103603,Koushanfar; Farinaz,9999,0,9999,0
1668302090029,ECE 200,019,103604,Kuzum; Duygu,9999,0,9999,0
1668302090029,ECE 200,020,103605,Le; Hanh-Phuc,9999,0,9999,0
1668302090029,ECE 200,021,103606,Lin; Bill,9999,0,9999,0
1668302090029,ECE 200,022,103607,Liu; Zhaowei,9998,0,9999,1
1668302090029,ECE 200,023,103608,Lo; Yu-Hwa,9999,0,9999,0
1668302090029,ECE 200,024,103609,Lomakin; Vitaliy,9999,0,9999,0
1668302090029,ECE 200,025,103610,Mercier; Patrick Philip,9999,0,9999,0
1668302090029,ECE 200,026,103611,Meyer; Florian,9999,0,9999,0
1668302090029,ECE 200,027,103612,Milstein; Laurence B.,9999,0,9999,0
1668302090029,ECE 200,028,103613,Mir Arabbaygi; Siavash,9999,0,9999,0
1668302090029,ECE 200,029,103614,Mookherjea; Shayan,9999,0,9999,0
1668302090029,ECE 200,030,103615,Morris; Karcher William,9999,0,9999,0
1668302090029,ECE 200,031,103616,Ng; Tse Nga,9999,0,9999,0
1668302090029,ECE 200,032,103617,Nguyen; Truong Quang,9999,0,9999,0
1668302090029,ECE 200,033,103618,Nomura; Kenji,9999,0,9999,0
1668302090029,ECE 200,034,103619,Orlitsky; Alon,9999,0,9999,0
1668302090029,ECE 200,035,103620,Pal; Piya,9999,0,9999,0
1668302090029,ECE 200,036,103621,Papen; George C.,9999,0,9999,0
1668302090029,ECE 200,037,103622,Radic; Stojan,9999,0,9999,0
1668302090029,ECE 200,038,103623,Rao; Bhaskar D.,9999,0,9999,0
1668302090029,ECE 200,039,103624,Rao; Ramesh R,9999,0,9999,0
1668302090029,ECE 200,040,103625,Rebeiz; Gabriel,9999,0,9999,0
1668302090029,ECE 200,041,103626,Sanford; John R,9999,0,9999,0
1668302090029,ECE 200,042,103627,Siegel; Paul H.,9999,0,9999,0
1668302090029,ECE 200,043,103628,Sievenpiper; Daniel F.,9999,0,9999,0
1668302090029,ECE 200,044,103629,Sworder; David D.,9999,0,9999,0
1668302090029,ECE 200,045,103630,Taur; Yuan,9999,0,9999,0
1668302090029,ECE 200,046,103631,Touri; Behrouz,9999,0,9999,0
1668302090029,ECE 200,047,103632,Trivedi; Mohan M.,9999,0,9999,0
1668302090029,ECE 200,048,103633,Vasconcelos; Nuno,9999,0,9999,0
1668302090029,ECE 200,049,103634,Wang; Xiaolong,9999,0,9999,0
1668302090029,ECE 200,050,103635,Xie; Pengtao,9999,0,9999,0
1668302090029,ECE 200,051,103636,Yip; Michael,9999,0,9999,0
1668302090029,ECE 200,052,103637,Zeger; Kenneth A.,999,0,999,0
1668302090029,ECE 200,053,103638,Zhang; Xinyu,9999,0,9999,0
1668302090029,ECE 200,054,103639,Turakhia; Yatish Girish,9999,0,9999,0
1668302090029,ECE 200,055,103640,Kang; Mingu,9999,0,9999,0
1668302090029,ECE 200,056,103641,Shi; Yuanyuan,9999,0,9999,0
1668302090029,ECE 200,057,103642,Wang; Edward Jay,9999,0,9999,0
1668302090029,ECE 200,058,103643,Zheng; Yang,9999,0,9999,0
1668302090454,ECE 202,A00,103644,Kuzum; Duygu,0,0,0,0
1668302090880,ECE 212BN,A00,103646,Ng; Tse Nga,0,0,0,0
1668302091305,ECE 221,A00,111493,Staff,0,0,0,0
1668302091727,ECE 222B,A00,103647,Lomakin; Vitaliy,0,0,0,0
1668302092150,ECE 230B,A00,103648,Taur; Yuan,0,0,0,0
1668302092577,ECE 238B,A00,103649,Garay; Javier,0,0,0,0
1668302093003,ECE 240B,A00,112900,Fainman; Yeshaiahu,0,0,0,0
1668302093427,ECE 247A,A00,103650,Jokerst; Jesse Vincent,0,0,0,0
1668302093854,ECE 247B,A00,103651,Wang; Joseph,0,0,0,0
1668302094277,ECE 250,A00,103652,Siegel; Paul H.,0,0,0,0
1668302094709,ECE 251A,A00,103654,Rao; Bhaskar D.,0,0,0,0
1668302095131,ECE 257B,A00,103655,Bharadia; Dinesh,0,0,0,0
1668302095555,ECE 258A,A00,103656,Milstein; Laurence B.,0,0,0,0
1668302095979,ECE 260B,A00,103658,Kang; Mingu,0,0,0,0
1668302096404,ECE 264A,A00,103659,Galton; Ian A,0,0,0,0
1668302096827,ECE 265A,A00,103661,Gudem; Prasad S.S.,0,0,0,0
1668302097253,ECE 265D,A00,103662,Gudem; Prasad S.S.,0,0,0,0
1668302097692,ECE 268,A00,103663,Koushanfar; Farinaz,0,0,0,0
1668302098129,ECE 269,A01,103665,Pal; Piya,0,0,0,0
1668302098555,ECE 271B,A00,103666,Vasconcelos; Manuela,0,0,0,0
1668302098978,ECE 276A,A00,103667,Atanasov; Nikolay A.,0,0,0,0
1668302099406,ECE 277,A00,103668,An; Cheolhong,0,0,0,0
1668302099837,ECE 279,A00,117947,Hall; Drew A.,0,0,0,0
1668302100700,ECE 283,A00,103670,Hsueh; Tzu-Chien,0,0,0,0
1668302101125,ECE 284,A00,103671,Turakhia; Yatish Girish,0,0,0,0
1668302101547,ECE 285,A00,103672,Zheng; Yang,0,0,0,0
1668302101547,ECE 285,B00,103673,Sworder; David D.,0,0,0,0
1668302101971,ECE 287,A00,103676,Javidi; Tara,0,0,0,0
1668302102392,MATH 200B,A00,098023,Salehi Golsefidy; Alireza,12,0,15,3
1668302102817,MATH 202B,A00,098024,Rhoades; Brendon Patrick,9,0,15,6
1668302103252,MATH 203B,A00,098025,Oprea; Dragos N.,10,0,15,5
1668302103674,MATH 204B,A00,098026,Sorensen; Claus M,13,0,15,2
1668302104096,MATH 208,A00,098027,Izadi; Elham,7,0,10,3
1668302104521,MATH 209,A00,098028,Pollack; Aaron,10,0,10,0
1668302104946,MATH 211A,A00,112919,Rogalski; Daniel,9,0,10,1
1668302105370,MATH 211B,A00,112920,Seward; Brandon M.,9,0,10,1
1668302105791,MATH 218,A00,098029,Li; Bo,10,0,10,0
1668302106213,MATH 220B,A00,098030,Novak; Jonathan I,11,0,15,4
1668302106633,MATH 221A,A00,098031,Ebenfelt; Peter F,13,0,15,2
1668302107059,MATH 231B,A00,098032,Zlatos; Andrej,12,0,15,3
1668302107484,MATH 240B,A00,098033,Ni; Lei,9,0,15,6
1668302107906,MATH 243,A00,098034,Jekel; David Andrew,10,0,10,0
1668302108331,MATH 245A,A00,098035,Nie; Jiawang,0,0,15,16
1668302108753,MATH 248,A00,098036,Bejenaru; Ioan,10,0,10,0
1668302109176,MATH 250B,A00,098037,Spolaor; Luca,14,0,15,1
1668302109599,MATH 258,A00,098038,Ni; Lei,10,0,10,0
1668302110116,MATH 264B,A00,098041,Rhoades; Brendon Patrick,9,0,15,6
1668302110538,MATH 268,A00,098042,Buss; Samuel R,10,0,10,0
1668302110961,MATH 269,A00,098043,Rhoades; Brendon Patrick,10,0,10,0
1668302111392,MATH 270B,A00,098044,Li; Bo,10,0,15,5
1668302111819,MATH 272B,A00,098045,Holst; Michael J,13,0,15,2
1668302112240,MATH 273A,A00,098046,Tian; Xiaochuan,10,0,15,5
1668302112661,MATH 275,A01,098048,Tian; Xiaochuan,6,0,10,4
1668302113086,MATH 278A,A00,098049,Holst; Michael J,8,0,10,2
1668302113509,MATH 278B,A00,098050,Cloninger; Alexander,10,0,10,0
1668302113935,MATH 278C,A00,098051,Nie; Jiawang,7,0,10,3
1668302114360,MATH 280B,A00,098052,Zheng; Tianyi,8,0,15,7
1668302114785,MATH 281B,A00,098053,Bradic; Jelena,1,0,15,14
1668302115209,MATH 282B,A00,098054,Arias-Castro; Ery,0,0,15,15
1668302115633,MATH 285,A00,098055,Fitzsimmons; Patrick J,0,0,15,17
1668302116060,MATH 287B,A00,098056,Arias-Castro; Ery,2,0,15,13
1668302116483,MATH 288,A00,098057,Agarwal; Pooja,9,0,10,1
1668302116483,MATH 288,B00,098058,Zhang; Danna,8,0,10,2
1668302116483,MATH 288,C00,098059,Williams; Ruth J,9,0,10,1
1668302116910,MATH 290B,A00,098060,Roberts; Justin Deritter,13,0,15,2
1668302117334,MATH 292,A00,098061,Belmont; Eva Kinoshita,10,0,10,0
1668302117757,MATH 295,A00,098062,Suk; Andrew Hoon,48,0,50,2
1668302118179,MATH 296,A00,098063,Novak; Jonathan I,20,0,20,0
1668302118602,MATH 297,001,098064,Gamst; Anthony Collins,9997,0,9999,2
1668302617149,COGS 205,A00,101395,Chiba; Andrea,19,0,20,1
1668302617577,COGS 210B,001,101404,Greene; Deanna Jacquelyn,9998,0,9999,1
1668302617577,COGS 210B,002,101417,Xia; Haijun,9999,0,9999,0
1668302617577,COGS 210B,003,101422,Nitz; Douglas A.,9999,0,9999,0
1668302617577,COGS 210B,004,101423,Hollan; James D.,9998,0,9999,1
1668302617577,COGS 210B,005,101424,Deak; Gedeon O.,9998,0,9999,1
1668302617577,COGS 210B,006,101425,Rossano; Federico,9999,0,9999,0
1668302618000,COGS 211B,A00,101427,Coulson; Seana M,9996,0,9999,3
1668302618421,COGS 220,A00,101428,Hollan; James D.,0,0,25,25
1668302618848,COGS 229,A00,101429,Dow; Steven P,18,0,25,7
1668302619276,COGS 230,A00,101430,Klemmer; Scott R,12,0,17,5
1668302619718,COGS 234,A00,101431,Xia; Haijun,1,0,25,24
1668302620144,COGS 260,A00,101432,Kiyonaga; Anastasia,21,0,25,4
1668302620144,COGS 260,B00,101433,Kirsh; David Joel,15,0,25,10
1668302620569,CSE 202,A00,102371,Impagliazzo; Russell,0,0,0,0
1668302620994,CSE 203B,A01,102373,Cheng; Chung Kuan,0,0,0,0
1668302621419,CSE 208,A00,102374,Micciancio; Daniele,0,0,0,0
1668302621845,CSE 209A,A00,112895,Impagliazzo; Russell,0,0,15,15
1668302622276,CSE 209B,A00,108005,Bellare; Mihir,0,0,0,0
1668302622701,CSE 210,A00,113163,Coblenz; Michael J,0,0,0,0
1668302623123,CSE 219,A00,106111,Dow; Steven P,0,0,20,20
1668302623550,CSE 221,A00,102376,Voelker; Geoffrey M.,0,0,0,0
1668302623973,CSE 224,A01,102378,Porter; George M,0,0,0,0
1668302624405,CSE 229A,A00,102379,Savage; Stefan,0,0,0,0
1668302624830,CSE 229C,A00,102380,Munyaka; Imani N. S.,0,0,0,0
1668302625256,CSE 232B,A00,102382,Deutsch; Alin Bernard,0,0,0,0
1668302625677,CSE 234,A01,112904,Kumar; Arun Kumar,0,0,0,0
1668302626103,CSE 237A,A00,102383,Rosing; Tajana Simunic,0,0,0,0
1668302626525,CSE 239A,A00,102384,Deutsch; Alin Bernard,0,0,0,0
1668302626946,CSE 239B,A00,102385,Polikarpova; Nadezhda,0,0,0,0
1668302627373,CSE 240A,A00,102386,Pannuto; Patrick William,0,0,0,0
1668302627798,CSE 240B,A00,102387,Zhao; Jishen,0,0,0,0
1668302628220,CSE 241A,A00,106406,Kang; Mingu,0,0,0,0
1668302628728,CSE 249B,A00,102388,Kahng; Andrew Byun,0,0,8,8
1668302629153,CSE 251B,A01,102392,Cottrell; Garrison W,0,0,0,0
1668302629153,CSE 251B,A02,102393,Cottrell; Garrison W,0,0,0,0
1668302629577,CSE 252B,A00,102394,Ochoa; Benjamin Lawrence,0,0,0,0
1668302630002,CSE 257,A01,102396,Gao; Sicun,0,0,0,0
1668302630428,CSE 272,A00,102397,Li; Tzumao,0,0,0,0
1668302630851,CSE 274,A00,111323,Chern; Albert Ren-Haur,0,0,0,0
1668302631275,CSE 282,A00,102398,Pevzner; Pavel Arkadjevich,0,0,0,0
1668302631699,CSE 284,A00,114175,Gymrek; Melissa Ann,0,0,0,0
1668302632123,CSE 290,A00,102399,Chandraker; Manmohan Krishna,0,0,0,0
1668302632123,CSE 290,B00,102400,Vaccaro; Kristen Marie,0,0,25,25
1668302632123,CSE 290,C00,102414,Pannuto; Patrick William,0,0,25,25
1668302632123,CSE 290,D00,102427,Pevzner; Pavel Arkadjevich,0,0,0,0
1668302632123,CSE 290,E00,102429,Zhao; Jishen,0,0,0,0
1668302632123,CSE 290,F00,102436,Tullsen; Dean Michael,0,0,0,0
1668302632123,CSE 290,G00,102440,Christensen; Henrik I,0,0,20,20
1668302632558,CSE 291,A00,102443,Su; Hao,0,0,0,0
1668302632558,CSE 291,B00,102448,Polikarpova; Nadezhda,0,0,0,0
1668302632558,CSE 291,C00,102453,Vaccaro; Kristen Marie,0,0,0,0
1668302632558,CSE 291,D00,111343,Savage; Stefan,0,0,0,0
1668302632558,CSE 291,E00,116474,Claffy; Kimberly Claire,0,0,0,0
1668302632558,CSE 291,F00,116479,Pasquale; Joseph,0,0,0,0
1668302632992,CSE 293,001,119111,Bafna; Vineet,9999,0,9999,0
1668302632992,CSE 293,002,119118,Bellare; Mihir,9999,0,9999,0
1668302632992,CSE 293,003,119122,Berg-Kirkpatrick; Taylor D,9999,0,9999,0
1668302632992,CSE 293,004,119135,Christensen; Henrik I,9999,0,9999,0
1668302632992,CSE 293,005,119142,Cottrell; Garrison W,9999,0,9999,0
1668302632992,CSE 293,006,119146,Deutsch; Alin Bernard,9999,0,9999,0
1668302632992,CSE 293,007,119159,Esmaeilzadeh; Hadi,9999,0,9999,0
1668302632992,CSE 293,008,119166,Freund; Yoav,9999,0,9999,0
1668302632992,CSE 293,009,119170,Griswold; William G.,9999,0,9999,0
1668302632992,CSE 293,010,119183,Gymrek; Melissa Ann,9999,0,9999,0
1668302632992,CSE 293,011,119190,Heninger; Nadia A,9999,0,9999,0
1668302632992,CSE 293,012,119230,Impagliazzo; Russell,9999,0,9999,0
1668302632992,CSE 293,013,119232,Jhala; Ranjit,9999,0,9999,0
1668302632992,CSE 293,014,119233,Kahng; Andrew Byun,9999,0,9999,0
1668302632992,CSE 293,015,119298,Kane; Daniel Mertz,9999,0,9999,0
1668302632992,CSE 293,016,119299,Kriegman; David J,9999,0,9999,0
1668302632992,CSE 293,017,119300,Kumar; Arun Kumar,9999,0,9999,0
1668302632992,CSE 293,018,119301,Lerner; Sorin,9999,0,9999,0
1668302632992,CSE 293,019,119302,Lovett; Shachar,9999,0,9999,0
1668302632992,CSE 293,020,119303,McAuley; Julian John,9999,0,9999,0
1668302632992,CSE 293,021,119304,Micciancio; Daniele,9999,0,9999,0
1668302632992,CSE 293,022,119367,Orailoglu; Alex,9999,0,9999,0
1668302632992,CSE 293,023,119382,Paturi; Ramamohan,9999,0,9999,0
1668302632992,CSE 293,024,119404,Polikarpova; Nadezhda,9999,0,9999,0
1668302632992,CSE 293,025,119406,Politz; Joseph Gibbs,9999,0,9999,0
1668302632992,CSE 293,026,119411,Porter; George M,9999,0,9999,0
1668302632992,CSE 293,027,119414,Porter; Leonard Emerson,9999,0,9999,0
1668302632992,CSE 293,028,119416,Ramamoorthi; Ravi,9999,0,9999,0
1668302632992,CSE 293,029,119417,Sahoo; Debashis,9999,0,9999,0
1668302632992,CSE 293,030,119420,Saul; Lawrence,9999,0,9999,0
1668302632992,CSE 293,031,119421,Savage; Stefan,9999,0,9999,0
1668302632992,CSE 293,032,119425,Schulze; Jurgen P.,9999,0,9999,0
1668302632992,CSE 293,033,119426,Snoeren; Alex C.,9999,0,9999,0
1668302632992,CSE 293,034,119428,Shang; Jingbo,9999,0,9999,0
1668302632992,CSE 293,035,119430,Stefan; Deian,9999,0,9999,0
1668302632992,CSE 293,036,119431,Su; Hao,9999,0,9999,0
1668302632992,CSE 293,037,119433,Swanson; Steven James,9999,0,9999,0
1668302632992,CSE 293,038,119435,Tullsen; Dean Michael,9999,0,9999,0
1668302632992,CSE 293,039,119483,Voelker; Geoffrey M.,9999,0,9999,0
1668302632992,CSE 293,040,119537,Zhao; Jishen,9999,0,9999,0
1668302632992,CSE 293,041,119538,Zhou; Yuan-Yuan,9999,0,9999,0
1668302632992,CSE 293,042,119539,Gao; Sicun,9999,0,9999,0
1668302632992,CSE 293,043,119540,Weibel; Nadir,9999,0,9999,0
1668302632992,CSE 293,044,119541,Gupta; Rajesh K.,9999,0,9999,0
1668302632992,CSE 293,045,126410,Vaccaro; Kristen Marie,9999,0,9999,0
1668302632992,CSE 293,046,126411,Klemke; Richard,9999,0,9999,0
1668302633419,CSE 294,A00,102459,Voelker; Geoffrey M.,0,0,0,0
1668302633419,CSE 294,B00,111322,Orailoglu; Alex,0,0,0,0
1668302633846,DSE 201,A00,096914,Deutsch; Alin Bernard,30,0,30,0
1668302634272,DSE 210,A00,096915,Dasgupta; Sanjoy,30,0,30,0
1668302634697,DSE 260A,A00,096916,Altintas De Callaf; Ilkay,30,0,30,0
1668302635131,ECE 200,001,103586,Antipa; Nicholas A,9999,0,9999,0
1668302635131,ECE 200,002,103587,Atanasov; Nikolay A.,9999,0,9999,0
1668302635131,ECE 200,003,103588,Bharadia; Dinesh,9999,0,9999,0
1668302635131,ECE 200,004,103589,Cheng; Chung Kuan,9999,0,9999,0
1668302635131,ECE 200,005,103590,Cosman; Pamela C.,9999,0,9999,0
1668302635131,ECE 200,006,103591,Dayeh; Shadi Ahmad,9999,0,9999,0
1668302635131,ECE 200,007,103592,Fainman; Yeshaiahu,9999,0,9999,0
1668302635131,ECE 200,008,103593,Ford; Joseph Earl,9999,0,9999,0
1668302635131,ECE 200,009,103594,Franceschetti; Massimo,9999,0,9999,0
1668302635131,ECE 200,010,103595,Fullerton; Eric E,9999,0,9999,0
1668302635131,ECE 200,011,103596,Galton; Ian A,9999,0,9999,0
1668302635131,ECE 200,012,103597,Gilja; Vikash,9999,0,9999,0
1668302635131,ECE 200,013,103598,Hall; Drew A.,9999,0,9999,0
1668302635131,ECE 200,014,103599,Hsueh; Tzu-Chien,9999,0,9999,0
1668302635131,ECE 200,015,103600,Javidi; Tara,9999,0,9999,0
1668302635131,ECE 200,016,103601,Kahng; Andrew Byun,9999,0,9999,0
1668302635131,ECE 200,017,103602,Kim; Young-Han,9999,0,9999,0
1668302635131,ECE 200,018,103603,Koushanfar; Farinaz,9999,0,9999,0
1668302635131,ECE 200,019,103604,Kuzum; Duygu,9999,0,9999,0
1668302635131,ECE 200,020,103605,Le; Hanh-Phuc,9999,0,9999,0
1668302635131,ECE 200,021,103606,Lin; Bill,9999,0,9999,0
1668302635131,ECE 200,022,103607,Liu; Zhaowei,9998,0,9999,1
1668302635131,ECE 200,023,103608,Lo; Yu-Hwa,9999,0,9999,0
1668302635131,ECE 200,024,103609,Lomakin; Vitaliy,9999,0,9999,0
1668302635131,ECE 200,025,103610,Mercier; Patrick Philip,9999,0,9999,0
1668302635131,ECE 200,026,103611,Meyer; Florian,9999,0,9999,0
1668302635131,ECE 200,027,103612,Milstein; Laurence B.,9999,0,9999,0
1668302635131,ECE 200,028,103613,Mir Arabbaygi; Siavash,9999,0,9999,0
1668302635131,ECE 200,029,103614,Mookherjea; Shayan,9999,0,9999,0
1668302635131,ECE 200,030,103615,Morris; Karcher William,9999,0,9999,0
1668302635131,ECE 200,031,103616,Ng; Tse Nga,9999,0,9999,0
1668302635131,ECE 200,032,103617,Nguyen; Truong Quang,9999,0,9999,0
1668302635131,ECE 200,033,103618,Nomura; Kenji,9999,0,9999,0
1668302635131,ECE 200,034,103619,Orlitsky; Alon,9999,0,9999,0
1668302635131,ECE 200,035,103620,Pal; Piya,9999,0,9999,0
1668302635131,ECE 200,036,103621,Papen; George C.,9999,0,9999,0
1668302635131,ECE 200,037,103622,Radic; Stojan,9999,0,9999,0
1668302635131,ECE 200,038,103623,Rao; Bhaskar D.,9999,0,9999,0
1668302635131,ECE 200,039,103624,Rao; Ramesh R,9999,0,9999,0
1668302635131,ECE 200,040,103625,Rebeiz; Gabriel,9999,0,9999,0
1668302635131,ECE 200,041,103626,Sanford; John R,9999,0,9999,0
1668302635131,ECE 200,042,103627,Siegel; Paul H.,9999,0,9999,0
1668302635131,ECE 200,043,103628,Sievenpiper; Daniel F.,9999,0,9999,0
1668302635131,ECE 200,044,103629,Sworder; David D.,9999,0,9999,0
1668302635131,ECE 200,045,103630,Taur; Yuan,9999,0,9999,0
1668302635131,ECE 200,046,103631,Touri; Behrouz,9999,0,9999,0
1668302635131,ECE 200,047,103632,Trivedi; Mohan M.,9999,0,9999,0
1668302635131,ECE 200,048,103633,Vasconcelos; Nuno,9999,0,9999,0
1668302635131,ECE 200,049,103634,Wang; Xiaolong,9999,0,9999,0
1668302635131,ECE 200,050,103635,Xie; Pengtao,9999,0,9999,0
1668302635131,ECE 200,051,103636,Yip; Michael,9999,0,9999,0
1668302635131,ECE 200,052,103637,Zeger; Kenneth A.,999,0,999,0
1668302635131,ECE 200,053,103638,Zhang; Xinyu,9999,0,9999,0
1668302635131,ECE 200,054,103639,Turakhia; Yatish Girish,9999,0,9999,0
1668302635131,ECE 200,055,103640,Kang; Mingu,9999,0,9999,0
1668302635131,ECE 200,056,103641,Shi; Yuanyuan,9999,0,9999,0
1668302635131,ECE 200,057,103642,Wang; Edward Jay,9999,0,9999,0
1668302635131,ECE 200,058,103643,Zheng; Yang,9999,0,9999,0
1668302635556,ECE 202,A00,103644,Kuzum; Duygu,0,0,0,0
1668302635982,ECE 212BN,A00,103646,Ng; Tse Nga,0,0,0,0
1668302636412,ECE 221,A00,111493,Staff,0,0,0,0
1668302636837,ECE 222B,A00,103647,Lomakin; Vitaliy,0,0,0,0
1668302637261,ECE 230B,A00,103648,Taur; Yuan,0,0,0,0
1668302637689,ECE 238B,A00,103649,Garay; Javier,0,0,0,0
1668302638112,ECE 240B,A00,112900,Fainman; Yeshaiahu,0,0,0,0
1668302638534,ECE 247A,A00,103650,Jokerst; Jesse Vincent,0,0,0,0
1668302638960,ECE 247B,A00,103651,Wang; Joseph,0,0,0,0
1668302639383,ECE 250,A00,103652,Siegel; Paul H.,0,0,0,0
1668302639807,ECE 251A,A00,103654,Rao; Bhaskar D.,0,0,0,0
1668302640235,ECE 257B,A00,103655,Bharadia; Dinesh,0,0,0,0
1668302640674,ECE 258A,A00,103656,Milstein; Laurence B.,0,0,0,0
1668302641095,ECE 260B,A00,103658,Kang; Mingu,0,0,0,0
1668302641520,ECE 264A,A00,103659,Galton; Ian A,0,0,0,0
1668302641949,ECE 265A,A00,103661,Gudem; Prasad S.S.,0,0,0,0
1668302642374,ECE 265D,A00,103662,Gudem; Prasad S.S.,0,0,0,0
1668302642804,ECE 268,A00,103663,Koushanfar; Farinaz,0,0,0,0
1668302643226,ECE 269,A01,103665,Pal; Piya,0,0,0,0
1668302643650,ECE 271B,A00,103666,Vasconcelos; Manuela,0,0,0,0
1668302644078,ECE 276A,A00,103667,Atanasov; Nikolay A.,0,0,0,0
1668302644505,ECE 277,A00,103668,An; Cheolhong,0,0,0,0
1668302644926,ECE 279,A00,117947,Hall; Drew A.,0,0,0,0
1668302645777,ECE 283,A00,103670,Hsueh; Tzu-Chien,0,0,0,0
1668302646205,ECE 284,A00,103671,Turakhia; Yatish Girish,0,0,0,0
1668302646627,ECE 285,A00,103672,Zheng; Yang,0,0,0,0
1668302646627,ECE 285,B00,103673,Sworder; David D.,0,0,0,0
1668302647052,ECE 287,A00,103676,Javidi; Tara,0,0,0,0
1668302647475,MATH 200B,A00,098023,Salehi Golsefidy; Alireza,12,0,15,3
1668302647897,MATH 202B,A00,098024,Rhoades; Brendon Patrick,9,0,15,6
1668302648324,MATH 203B,A00,098025,Oprea; Dragos N.,10,0,15,5
1668302648750,MATH 204B,A00,098026,Sorensen; Claus M,13,0,15,2
1668302649174,MATH 208,A00,098027,Izadi; Elham,7,0,10,3
1668302649609,MATH 209,A00,098028,Pollack; Aaron,10,0,10,0
1668302650036,MATH 211A,A00,112919,Rogalski; Daniel,9,0,10,1
1668302650459,MATH 211B,A00,112920,Seward; Brandon M.,9,0,10,1
1668302650883,MATH 218,A00,098029,Li; Bo,10,0,10,0
1668302651306,MATH 220B,A00,098030,Novak; Jonathan I,11,0,15,4
1668302651733,MATH 221A,A00,098031,Ebenfelt; Peter F,13,0,15,2
1668302652159,MATH 231B,A00,098032,Zlatos; Andrej,12,0,15,3
1668302652582,MATH 240B,A00,098033,Ni; Lei,9,0,15,6
1668302653007,MATH 243,A00,098034,Jekel; David Andrew,10,0,10,0
1668302653432,MATH 245A,A00,098035,Nie; Jiawang,0,0,15,16
1668302653857,MATH 248,A00,098036,Bejenaru; Ioan,10,0,10,0
1668302654282,MATH 250B,A00,098037,Spolaor; Luca,14,0,15,1
1668302654705,MATH 258,A00,098038,Ni; Lei,10,0,10,0
1668302655132,MATH 264B,A00,098041,Rhoades; Brendon Patrick,9,0,15,6
1668302655553,MATH 268,A00,098042,Buss; Samuel R,10,0,10,0
1668302655977,MATH 269,A00,098043,Rhoades; Brendon Patrick,10,0,10,0
1668302656400,MATH 270B,A00,098044,Li; Bo,10,0,15,5
1668302656827,MATH 272B,A00,098045,Holst; Michael J,13,0,15,2
1668302657249,MATH 273A,A00,098046,Tian; Xiaochuan,10,0,15,5
1668302657673,MATH 275,A01,098048,Tian; Xiaochuan,6,0,10,4
1668302658100,MATH 278A,A00,098049,Holst; Michael J,8,0,10,2
1668302658525,MATH 278B,A00,098050,Cloninger; Alexander,10,0,10,0
1668302658949,MATH 278C,A00,098051,Nie; Jiawang,7,0,10,3
1668302659374,MATH 280B,A00,098052,Zheng; Tianyi,8,0,15,7
1668302659800,MATH 281B,A00,098053,Bradic; Jelena,1,0,15,14
1668302660223,MATH 282B,A00,098054,Arias-Castro; Ery,0,0,15,15
1668302660647,MATH 285,A00,098055,Fitzsimmons; Patrick J,0,0,15,17
1668302661071,MATH 287B,A00,098056,Arias-Castro; Ery,2,0,15,13
1668302661493,MATH 288,A00,098057,Agarwal; Pooja,9,0,10,1
1668302661493,MATH 288,B00,098058,Zhang; Danna,8,0,10,2
1668302661493,MATH 288,C00,098059,Williams; Ruth J,9,0,10,1
1668302661918,MATH 290B,A00,098060,Roberts; Justin Deritter,13,0,15,2
1668302662346,MATH 292,A00,098061,Belmont; Eva Kinoshita,10,0,10,0
1668302662771,MATH 295,A00,098062,Suk; Andrew Hoon,48,0,50,2
1668302663194,MATH 296,A00,098063,Novak; Jonathan I,20,0,20,0
1668302663617,MATH 297,001,098064,Gamst; Anthony Collins,9997,0,9999,2
1668303162865,COGS 205,A00,101395,Chiba; Andrea,19,0,20,1
1668303163289,COGS 210B,001,101404,Greene; Deanna Jacquelyn,9998,0,9999,1
1668303163289,COGS 210B,002,101417,Xia; Haijun,9999,0,9999,0
1668303163289,COGS 210B,003,101422,Nitz; Douglas A.,9999,0,9999,0
1668303163289,COGS 210B,004,101423,Hollan; James D.,9998,0,9999,1
1668303163289,COGS 210B,005,101424,Deak; Gedeon O.,9998,0,9999,1
1668303163289,COGS 210B,006,101425,Rossano; Federico,9999,0,9999,0
1668303163721,COGS 211B,A00,101427,Coulson; Seana M,9996,0,9999,3
1668303164144,COGS 220,A00,101428,Hollan; James D.,0,0,25,25
1668303164568,COGS 229,A00,101429,Dow; Steven P,18,0,25,7
1668303164993,COGS 230,A00,101430,Klemmer; Scott R,12,0,17,5
1668303165414,COGS 234,A00,101431,Xia; Haijun,1,0,25,24
1668303165851,COGS 260,A00,101432,Kiyonaga; Anastasia,21,0,25,4
1668303165851,COGS 260,B00,101433,Kirsh; David Joel,15,0,25,10
1668303166273,CSE 202,A00,102371,Impagliazzo; Russell,0,0,0,0
1668303166696,CSE 203B,A01,102373,Cheng; Chung Kuan,0,0,0,0
1668303167121,CSE 208,A00,102374,Micciancio; Daniele,0,0,0,0
1668303167558,CSE 209A,A00,112895,Impagliazzo; Russell,0,0,15,15
1668303167981,CSE 209B,A00,108005,Bellare; Mihir,0,0,0,0
1668303168404,CSE 210,A00,113163,Coblenz; Michael J,0,0,0,0
1668303168827,CSE 219,A00,106111,Dow; Steven P,0,0,20,20
1668303169251,CSE 221,A00,102376,Voelker; Geoffrey M.,0,0,0,0
1668303169675,CSE 224,A01,102378,Porter; George M,0,0,0,0
1668303170099,CSE 229A,A00,102379,Savage; Stefan,0,0,0,0
1668303170525,CSE 229C,A00,102380,Munyaka; Imani N. S.,0,0,0,0
1668303170949,CSE 232B,A00,102382,Deutsch; Alin Bernard,0,0,0,0
1668303171371,CSE 234,A01,112904,Kumar; Arun Kumar,0,0,0,0
1668303171795,CSE 237A,A00,102383,Rosing; Tajana Simunic,0,0,0,0
1668303172217,CSE 239A,A00,102384,Deutsch; Alin Bernard,0,0,0,0
1668303172641,CSE 239B,A00,102385,Polikarpova; Nadezhda,0,0,0,0
1668303173064,CSE 240A,A00,102386,Pannuto; Patrick William,0,0,0,0
1668303173487,CSE 240B,A00,102387,Zhao; Jishen,0,0,0,0
1668303173909,CSE 241A,A00,106406,Kang; Mingu,0,0,0,0
1668303174334,CSE 249B,A00,102388,Kahng; Andrew Byun,0,0,8,8
1668303174756,CSE 251B,A01,102392,Cottrell; Garrison W,0,0,0,0
1668303174756,CSE 251B,A02,102393,Cottrell; Garrison W,0,0,0,0
1668303175181,CSE 252B,A00,102394,Ochoa; Benjamin Lawrence,0,0,0,0
1668303175606,CSE 257,A01,102396,Gao; Sicun,0,0,0,0
1668303176029,CSE 272,A00,102397,Li; Tzumao,0,0,0,0
1668303176454,CSE 274,A00,111323,Chern; Albert Ren-Haur,0,0,0,0
1668303176881,CSE 282,A00,102398,Pevzner; Pavel Arkadjevich,0,0,0,0
1668303177304,CSE 284,A00,114175,Gymrek; Melissa Ann,0,0,0,0
1668303177727,CSE 290,A00,102399,Chandraker; Manmohan Krishna,0,0,0,0
1668303177727,CSE 290,B00,102400,Vaccaro; Kristen Marie,0,0,25,25
1668303177727,CSE 290,C00,102414,Pannuto; Patrick William,0,0,25,25
1668303177727,CSE 290,D00,102427,Pevzner; Pavel Arkadjevich,0,0,0,0
1668303177727,CSE 290,E00,102429,Zhao; Jishen,0,0,0,0
1668303177727,CSE 290,F00,102436,Tullsen; Dean Michael,0,0,0,0
1668303177727,CSE 290,G00,102440,Christensen; Henrik I,0,0,20,20
1668303178153,CSE 291,A00,102443,Su; Hao,0,0,0,0
1668303178153,CSE 291,B00,102448,Polikarpova; Nadezhda,0,0,0,0
1668303178153,CSE 291,C00,102453,Vaccaro; Kristen Marie,0,0,0,0
1668303178153,CSE 291,D00,111343,Savage; Stefan,0,0,0,0
1668303178153,CSE 291,E00,116474,Claffy; Kimberly Claire,0,0,0,0
1668303178153,CSE 291,F00,116479,Pasquale; Joseph,0,0,0,0
1668303178598,CSE 293,001,119111,Bafna; Vineet,9999,0,9999,0
1668303178598,CSE 293,002,119118,Bellare; Mihir,9999,0,9999,0
1668303178598,CSE 293,003,119122,Berg-Kirkpatrick; Taylor D,9999,0,9999,0
1668303178598,CSE 293,004,119135,Christensen; Henrik I,9999,0,9999,0
1668303178598,CSE 293,005,119142,Cottrell; Garrison W,9999,0,9999,0
1668303178598,CSE 293,006,119146,Deutsch; Alin Bernard,9999,0,9999,0
1668303178598,CSE 293,007,119159,Esmaeilzadeh; Hadi,9999,0,9999,0
1668303178598,CSE 293,008,119166,Freund; Yoav,9999,0,9999,0
1668303178598,CSE 293,009,119170,Griswold; William G.,9999,0,9999,0
1668303178598,CSE 293,010,119183,Gymrek; Melissa Ann,9999,0,9999,0
1668303178598,CSE 293,011,119190,Heninger; Nadia A,9999,0,9999,0
1668303178598,CSE 293,012,119230,Impagliazzo; Russell,9999,0,9999,0
1668303178598,CSE 293,013,119232,Jhala; Ranjit,9999,0,9999,0
1668303178598,CSE 293,014,119233,Kahng; Andrew Byun,9999,0,9999,0
1668303178598,CSE 293,015,119298,Kane; Daniel Mertz,9999,0,9999,0
1668303178598,CSE 293,016,119299,Kriegman; David J,9999,0,9999,0
1668303178598,CSE 293,017,119300,Kumar; Arun Kumar,9999,0,9999,0
1668303178598,CSE 293,018,119301,Lerner; Sorin,9999,0,9999,0
1668303178598,CSE 293,019,119302,Lovett; Shachar,9999,0,9999,0
1668303178598,CSE 293,020,119303,McAuley; Julian John,9999,0,9999,0
1668303178598,CSE 293,021,119304,Micciancio; Daniele,9999,0,9999,0
1668303178598,CSE 293,022,119367,Orailoglu; Alex,9999,0,9999,0
1668303178598,CSE 293,023,119382,Paturi; Ramamohan,9999,0,9999,0
1668303178598,CSE 293,024,119404,Polikarpova; Nadezhda,9999,0,9999,0
1668303178598,CSE 293,025,119406,Politz; Joseph Gibbs,9999,0,9999,0
1668303178598,CSE 293,026,119411,Porter; George M,9999,0,9999,0
1668303178598,CSE 293,027,119414,Porter; Leonard Emerson,9999,0,9999,0
1668303178598,CSE 293,028,119416,Ramamoorthi; Ravi,9999,0,9999,0
1668303178598,CSE 293,029,119417,Sahoo; Debashis,9999,0,9999,0
1668303178598,CSE 293,030,119420,Saul; Lawrence,9999,0,9999,0
1668303178598,CSE 293,031,119421,Savage; Stefan,9999,0,9999,0
1668303178598,CSE 293,032,119425,Schulze; Jurgen P.,9999,0,9999,0
1668303178598,CSE 293,033,119426,Snoeren; Alex C.,9999,0,9999,0
1668303178598,CSE 293,034,119428,Shang; Jingbo,9999,0,9999,0
1668303178598,CSE 293,035,119430,Stefan; Deian,9999,0,9999,0
1668303178598,CSE 293,036,119431,Su; Hao,9999,0,9999,0
1668303178598,CSE 293,037,119433,Swanson; Steven James,9999,0,9999,0
1668303178598,CSE 293,038,119435,Tullsen; Dean Michael,9999,0,9999,0
1668303178598,CSE 293,039,119483,Voelker; Geoffrey M.,9999,0,9999,0
1668303178598,CSE 293,040,119537,Zhao; Jishen,9999,0,9999,0
1668303178598,CSE 293,041,119538,Zhou; Yuan-Yuan,9999,0,9999,0
1668303178598,CSE 293,042,119539,Gao; Sicun,9999,0,9999,0
1668303178598,CSE 293,043,119540,Weibel; Nadir,9999,0,9999,0
1668303178598,CSE 293,044,119541,Gupta; Rajesh K.,9999,0,9999,0
1668303178598,CSE 293,045,126410,Vaccaro; Kristen Marie,9999,0,9999,0
1668303178598,CSE 293,046,126411,Klemke; Richard,9999,0,9999,0
1668303179024,CSE 294,A00,102459,Voelker; Geoffrey M.,0,0,0,0
1668303179024,CSE 294,B00,111322,Orailoglu; Alex,0,0,0,0
1668303179449,DSE 201,A00,096914,Deutsch; Alin Bernard,30,0,30,0
1668303179870,DSE 210,A00,096915,Dasgupta; Sanjoy,30,0,30,0
1668303180291,DSE 260A,A00,096916,Altintas De Callaf; Ilkay,30,0,30,0
1668303180727,ECE 200,001,103586,Antipa; Nicholas A,9999,0,9999,0
1668303180727,ECE 200,002,103587,Atanasov; Nikolay A.,9999,0,9999,0
1668303180727,ECE 200,003,103588,Bharadia; Dinesh,9999,0,9999,0
1668303180727,ECE 200,004,103589,Cheng; Chung Kuan,9999,0,9999,0
1668303180727,ECE 200,005,103590,Cosman; Pamela C.,9999,0,9999,0
1668303180727,ECE 200,006,103591,Dayeh; Shadi Ahmad,9999,0,9999,0
1668303180727,ECE 200,007,103592,Fainman; Yeshaiahu,9999,0,9999,0
1668303180727,ECE 200,008,103593,Ford; Joseph Earl,9999,0,9999,0
1668303180727,ECE 200,009,103594,Franceschetti; Massimo,9999,0,9999,0
1668303180727,ECE 200,010,103595,Fullerton; Eric E,9999,0,9999,0
1668303180727,ECE 200,011,103596,Galton; Ian A,9999,0,9999,0
1668303180727,ECE 200,012,103597,Gilja; Vikash,9999,0,9999,0
1668303180727,ECE 200,013,103598,Hall; Drew A.,9999,0,9999,0
1668303180727,ECE 200,014,103599,Hsueh; Tzu-Chien,9999,0,9999,0
1668303180727,ECE 200,015,103600,Javidi; Tara,9999,0,9999,0
1668303180727,ECE 200,016,103601,Kahng; Andrew Byun,9999,0,9999,0
1668303180727,ECE 200,017,103602,Kim; Young-Han,9999,0,9999,0
1668303180727,ECE 200,018,103603,Koushanfar; Farinaz,9999,0,9999,0
1668303180727,ECE 200,019,103604,Kuzum; Duygu,9999,0,9999,0
1668303180727,ECE 200,020,103605,Le; Hanh-Phuc,9999,0,9999,0
1668303180727,ECE 200,021,103606,Lin; Bill,9999,0,9999,0
1668303180727,ECE 200,022,103607,Liu; Zhaowei,9998,0,9999,1
1668303180727,ECE 200,023,103608,Lo; Yu-Hwa,9999,0,9999,0
1668303180727,ECE 200,024,103609,Lomakin; Vitaliy,9999,0,9999,0
1668303180727,ECE 200,025,103610,Mercier; Patrick Philip,9999,0,9999,0
1668303180727,ECE 200,026,103611,Meyer; Florian,9999,0,9999,0
1668303180727,ECE 200,027,103612,Milstein; Laurence B.,9999,0,9999,0
1668303180727,ECE 200,028,103613,Mir Arabbaygi; Siavash,9999,0,9999,0
1668303180727,ECE 200,029,103614,Mookherjea; Shayan,9999,0,9999,0
1668303180727,ECE 200,030,103615,Morris; Karcher William,9999,0,9999,0
1668303180727,ECE 200,031,103616,Ng; Tse Nga,9999,0,9999,0
1668303180727,ECE 200,032,103617,Nguyen; Truong Quang,9999,0,9999,0
1668303180727,ECE 200,033,103618,Nomura; Kenji,9999,0,9999,0
1668303180727,ECE 200,034,103619,Orlitsky; Alon,9999,0,9999,0
1668303180727,ECE 200,035,103620,Pal; Piya,9999,0,9999,0
1668303180727,ECE 200,036,103621,Papen; George C.,9999,0,9999,0
1668303180727,ECE 200,037,103622,Radic; Stojan,9999,0,9999,0
1668303180727,ECE 200,038,103623,Rao; Bhaskar D.,9999,0,9999,0
1668303180727,ECE 200,039,103624,Rao; Ramesh R,9999,0,9999,0
1668303180727,ECE 200,040,103625,Rebeiz; Gabriel,9999,0,9999,0
1668303180727,ECE 200,041,103626,Sanford; John R,9999,0,9999,0
1668303180727,ECE 200,042,103627,Siegel; Paul H.,9999,0,9999,0
1668303180727,ECE 200,043,103628,Sievenpiper; Daniel F.,9999,0,9999,0
1668303180727,ECE 200,044,103629,Sworder; David D.,9999,0,9999,0
1668303180727,ECE 200,045,103630,Taur; Yuan,9999,0,9999,0
1668303180727,ECE 200,046,103631,Touri; Behrouz,9999,0,9999,0
1668303180727,ECE 200,047,103632,Trivedi; Mohan M.,9999,0,9999,0
1668303180727,ECE 200,048,103633,Vasconcelos; Nuno,9999,0,9999,0
1668303180727,ECE 200,049,103634,Wang; Xiaolong,9999,0,9999,0
1668303180727,ECE 200,050,103635,Xie; Pengtao,9999,0,9999,0
1668303180727,ECE 200,051,103636,Yip; Michael,9999,0,9999,0
1668303180727,ECE 200,052,103637,Zeger; Kenneth A.,999,0,999,0
1668303180727,ECE 200,053,103638,Zhang; Xinyu,9999,0,9999,0
1668303180727,ECE 200,054,103639,Turakhia; Yatish Girish,9999,0,9999,0
1668303180727,ECE 200,055,103640,Kang; Mingu,9999,0,9999,0
1668303180727,ECE 200,056,103641,Shi; Yuanyuan,9999,0,9999,0
1668303180727,ECE 200,057,103642,Wang; Edward Jay,9999,0,9999,0
1668303180727,ECE 200,058,103643,Zheng; Yang,9999,0,9999,0
1668303181150,ECE 202,A00,103644,Kuzum; Duygu,0,0,0,0
1668303181573,ECE 212BN,A00,103646,Ng; Tse Nga,0,0,0,0
1668303181997,ECE 221,A00,111493,Staff,0,0,0,0
1668303182426,ECE 222B,A00,103647,Lomakin; Vitaliy,0,0,0,0
1668303182850,ECE 230B,A00,103648,Taur; Yuan,0,0,0,0
1668303183275,ECE 238B,A00,103649,Garay; Javier,0,0,0,0
1668303183699,ECE 240B,A00,112900,Fainman; Yeshaiahu,0,0,0,0
1668303184123,ECE 247A,A00,103650,Jokerst; Jesse Vincent,0,0,0,0
1668303184545,ECE 247B,A00,103651,Wang; Joseph,0,0,0,0
1668303184973,ECE 250,A00,103652,Siegel; Paul H.,0,0,0,0
1668303185397,ECE 251A,A00,103654,Rao; Bhaskar D.,0,0,0,0
1668303185821,ECE 257B,A00,103655,Bharadia; Dinesh,0,0,0,0
1668303186245,ECE 258A,A00,103656,Milstein; Laurence B.,0,0,0,0
1668303186673,ECE 260B,A00,103658,Kang; Mingu,0,0,0,0
1668303187099,ECE 264A,A00,103659,Galton; Ian A,0,0,0,0
1668303187525,ECE 265A,A00,103661,Gudem; Prasad S.S.,0,0,0,0
1668303187949,ECE 265D,A00,103662,Gudem; Prasad S.S.,0,0,0,0
1668303188373,ECE 268,A00,103663,Koushanfar; Farinaz,0,0,0,0
1668303188795,ECE 269,A01,103665,Pal; Piya,0,0,0,0
1668303189220,ECE 271B,A00,103666,Vasconcelos; Manuela,0,0,0,0
1668303189643,ECE 276A,A00,103667,Atanasov; Nikolay A.,0,0,0,0
1668303190070,ECE 277,A00,103668,An; Cheolhong,0,0,0,0
1668303190492,ECE 279,A00,117947,Hall; Drew A.,0,0,0,0
1668303191431,ECE 283,A00,103670,Hsueh; Tzu-Chien,0,0,0,0
1668303191854,ECE 284,A00,103671,Turakhia; Yatish Girish,0,0,0,0
1668303192281,ECE 285,A00,103672,Zheng; Yang,0,0,0,0
1668303192281,ECE 285,B00,103673,Sworder; David D.,0,0,0,0
1668303192706,ECE 287,A00,103676,Javidi; Tara,0,0,0,0
1668303193133,MATH 200B,A00,098023,Salehi Golsefidy; Alireza,12,0,15,3
1668303193557,MATH 202B,A00,098024,Rhoades; Brendon Patrick,9,0,15,6
1668303193981,MATH 203B,A00,098025,Oprea; Dragos N.,10,0,15,5
1668303194403,MATH 204B,A00,098026,Sorensen; Claus M,13,0,15,2
1668303194827,MATH 208,A00,098027,Izadi; Elham,7,0,10,3
1668303195252,MATH 209,A00,098028,Pollack; Aaron,10,0,10,0
1668303195677,MATH 211A,A00,112919,Rogalski; Daniel,9,0,10,1
1668303196099,MATH 211B,A00,112920,Seward; Brandon M.,9,0,10,1
1668303196522,MATH 218,A00,098029,Li; Bo,10,0,10,0
1668303196949,MATH 220B,A00,098030,Novak; Jonathan I,11,0,15,4
1668303197373,MATH 221A,A00,098031,Ebenfelt; Peter F,13,0,15,2
1668303197799,MATH 231B,A00,098032,Zlatos; Andrej,12,0,15,3
1668303198225,MATH 240B,A00,098033,Ni; Lei,9,0,15,6
1668303198649,MATH 243,A00,098034,Jekel; David Andrew,10,0,10,0
1668303199077,MATH 245A,A00,098035,Nie; Jiawang,0,0,15,16
1668303199501,MATH 248,A00,098036,Bejenaru; Ioan,10,0,10,0
1668303199925,MATH 250B,A00,098037,Spolaor; Luca,14,0,15,1
1668303200349,MATH 258,A00,098038,Ni; Lei,10,0,10,0
1668303200772,MATH 264B,A00,098041,Rhoades; Brendon Patrick,9,0,15,6
1668303201194,MATH 268,A00,098042,Buss; Samuel R,10,0,10,0
1668303201621,MATH 269,A00,098043,Rhoades; Brendon Patrick,10,0,10,0
1668303202043,MATH 270B,A00,098044,Li; Bo,10,0,15,5
1668303202469,MATH 272B,A00,098045,Holst; Michael J,13,0,15,2
1668303202900,MATH 273A,A00,098046,Tian; Xiaochuan,10,0,15,5
1668303203328,MATH 275,A01,098048,Tian; Xiaochuan,6,0,10,4
1668303203752,MATH 278A,A00,098049,Holst; Michael J,8,0,10,2
1668303204175,MATH 278B,A00,098050,Cloninger; Alexander,10,0,10,0
1668303204598,MATH 278C,A00,098051,Nie; Jiawang,7,0,10,3
1668303205024,MATH 280B,A00,098052,Zheng; Tianyi,8,0,15,7
1668303205449,MATH 281B,A00,098053,Bradic; Jelena,1,0,15,14
1668303205878,MATH 282B,A00,098054,Arias-Castro; Ery,0,0,15,15
1668303206302,MATH 285,A00,098055,Fitzsimmons; Patrick J,0,0,15,17
1668303206726,MATH 287B,A00,098056,Arias-Castro; Ery,2,0,15,13
1668303207152,MATH 288,A00,098057,Agarwal; Pooja,9,0,10,1
1668303207152,MATH 288,B00,098058,Zhang; Danna,8,0,10,2
1668303207152,MATH 288,C00,098059,Williams; Ruth J,9,0,10,1
1668303207574,MATH 290B,A00,098060,Roberts; Justin Deritter,13,0,15,2
1668303207999,MATH 292,A00,098061,Belmont; Eva Kinoshita,10,0,10,0
1668303208422,MATH 295,A00,098062,Suk; Andrew Hoon,48,0,50,2
1668303208847,MATH 296,A00,098063,Novak; Jonathan I,20,0,20,0
1668303209269,MATH 297,001,098064,Gamst; Anthony Collins,9997,0,9999,2
1668303707909,COGS 205,A00,101395,Chiba; Andrea,19,0,20,1
1668303708333,COGS 210B,001,101404,Greene; Deanna Jacquelyn,9998,0,9999,1
1668303708333,COGS 210B,002,101417,Xia; Haijun,9999,0,9999,0
1668303708333,COGS 210B,003,101422,Nitz; Douglas A.,9999,0,9999,0
1668303708333,COGS 210B,004,101423,Hollan; James D.,9998,0,9999,1
1668303708333,COGS 210B,005,101424,Deak; Gedeon O.,9998,0,9999,1
1668303708333,COGS 210B,006,101425,Rossano; Federico,9999,0,9999,0
1668303708769,COGS 211B,A00,101427,Coulson; Seana M,9996,0,9999,3
1668303709195,COGS 220,A00,101428,Hollan; James D.,0,0,25,25
1668303709711,COGS 229,A00,101429,Dow; Steven P,18,0,25,7
1668303710136,COGS 230,A00,101430,Klemmer; Scott R,12,0,17,5
1668303710559,COGS 234,A00,101431,Xia; Haijun,1,0,25,24
1668303710986,COGS 260,A00,101432,Kiyonaga; Anastasia,21,0,25,4
1668303710986,COGS 260,B00,101433,Kirsh; David Joel,15,0,25,10
1668303711411,CSE 202,A00,102371,Impagliazzo; Russell,0,0,0,0
1668303711838,CSE 203B,A01,102373,Cheng; Chung Kuan,0,0,0,0
1668303712263,CSE 208,A00,102374,Micciancio; Daniele,0,0,0,0
1668303712691,CSE 209A,A00,112895,Impagliazzo; Russell,0,0,15,15
1668303713119,CSE 209B,A00,108005,Bellare; Mihir,0,0,0,0
1668303713558,CSE 210,A00,113163,Coblenz; Michael J,0,0,0,0
1668303713982,CSE 219,A00,106111,Dow; Steven P,0,0,20,20
1668303714405,CSE 221,A00,102376,Voelker; Geoffrey M.,0,0,0,0
1668303714830,CSE 224,A01,102378,Porter; George M,0,0,0,0
1668303715254,CSE 229A,A00,102379,Savage; Stefan,0,0,0,0
1668303715678,CSE 229C,A00,102380,Munyaka; Imani N. S.,0,0,0,0
1668303716101,CSE 232B,A00,102382,Deutsch; Alin Bernard,0,0,0,0
1668303716523,CSE 234,A01,112904,Kumar; Arun Kumar,0,0,0,0
1668303716947,CSE 237A,A00,102383,Rosing; Tajana Simunic,0,0,0,0
1668303717371,CSE 239A,A00,102384,Deutsch; Alin Bernard,0,0,0,0
1668303717795,CSE 239B,A00,102385,Polikarpova; Nadezhda,0,0,0,0
1668303718221,CSE 240A,A00,102386,Pannuto; Patrick William,0,0,0,0
1668303718646,CSE 240B,A00,102387,Zhao; Jishen,0,0,0,0
1668303719071,CSE 241A,A00,106406,Kang; Mingu,0,0,0,0
1668303719496,CSE 249B,A00,102388,Kahng; Andrew Byun,0,0,8,8
1668303719925,CSE 251B,A01,102392,Cottrell; Garrison W,0,0,0,0
1668303719925,CSE 251B,A02,102393,Cottrell; Garrison W,0,0,0,0
1668303720349,CSE 252B,A00,102394,Ochoa; Benjamin Lawrence,0,0,0,0
1668303720776,CSE 257,A01,102396,Gao; Sicun,0,0,0,0
1668303721205,CSE 272,A00,102397,Li; Tzumao,0,0,0,0
1668303721629,CSE 274,A00,111323,Chern; Albert Ren-Haur,0,0,0,0
1668303722055,CSE 282,A00,102398,Pevzner; Pavel Arkadjevich,0,0,0,0
1668303722478,CSE 284,A00,114175,Gymrek; Melissa Ann,0,0,0,0
1668303722907,CSE 290,A00,102399,Chandraker; Manmohan Krishna,0,0,0,0
1668303722907,CSE 290,B00,102400,Vaccaro; Kristen Marie,0,0,25,25
1668303722907,CSE 290,C00,102414,Pannuto; Patrick William,0,0,25,25
1668303722907,CSE 290,D00,102427,Pevzner; Pavel Arkadjevich,0,0,0,0
1668303722907,CSE 290,E00,102429,Zhao; Jishen,0,0,0,0
1668303722907,CSE 290,F00,102436,Tullsen; Dean Michael,0,0,0,0
1668303722907,CSE 290,G00,102440,Christensen; Henrik I,0,0,20,20
1668303723331,CSE 291,A00,102443,Su; Hao,0,0,0,0
1668303723331,CSE 291,B00,102448,Polikarpova; Nadezhda,0,0,0,0
1668303723331,CSE 291,C00,102453,Vaccaro; Kristen Marie,0,0,0,0
1668303723331,CSE 291,D00,111343,Savage; Stefan,0,0,0,0
1668303723331,CSE 291,E00,116474,Claffy; Kimberly Claire,0,0,0,0
1668303723331,CSE 291,F00,116479,Pasquale; Joseph,0,0,0,0
1668303723767,CSE 293,001,119111,Bafna; Vineet,9999,0,9999,0
1668303723767,CSE 293,002,119118,Bellare; Mihir,9999,0,9999,0
1668303723767,CSE 293,003,119122,Berg-Kirkpatrick; Taylor D,9999,0,9999,0
1668303723767,CSE 293,004,119135,Christensen; Henrik I,9999,0,9999,0
1668303723767,CSE 293,005,119142,Cottrell; Garrison W,9999,0,9999,0
1668303723767,CSE 293,006,119146,Deutsch; Alin Bernard,9999,0,9999,0
1668303723767,CSE 293,007,119159,Esmaeilzadeh; Hadi,9999,0,9999,0
1668303723767,CSE 293,008,119166,Freund; Yoav,9999,0,9999,0
1668303723767,CSE 293,009,119170,Griswold; William G.,9999,0,9999,0
1668303723767,CSE 293,010,119183,Gymrek; Melissa Ann,9999,0,9999,0
1668303723767,CSE 293,011,119190,Heninger; Nadia A,9999,0,9999,0
1668303723767,CSE 293,012,119230,Impagliazzo; Russell,9999,0,9999,0
1668303723767,CSE 293,013,119232,Jhala; Ranjit,9999,0,9999,0
1668303723767,CSE 293,014,119233,Kahng; Andrew Byun,9999,0,9999,0
1668303723767,CSE 293,015,119298,Kane; Daniel Mertz,9999,0,9999,0
1668303723767,CSE 293,016,119299,Kriegman; David J,9999,0,9999,0
1668303723767,CSE 293,017,119300,Kumar; Arun Kumar,9999,0,9999,0
1668303723767,CSE 293,018,119301,Lerner; Sorin,9999,0,9999,0
1668303723767,CSE 293,019,119302,Lovett; Shachar,9999,0,9999,0
1668303723767,CSE 293,020,119303,McAuley; Julian John,9999,0,9999,0
1668303723767,CSE 293,021,119304,Micciancio; Daniele,9999,0,9999,0
1668303723767,CSE 293,022,119367,Orailoglu; Alex,9999,0,9999,0
1668303723767,CSE 293,023,119382,Paturi; Ramamohan,9999,0,9999,0
1668303723767,CSE 293,024,119404,Polikarpova; Nadezhda,9999,0,9999,0
1668303723767,CSE 293,025,119406,Politz; Joseph Gibbs,9999,0,9999,0
1668303723767,CSE 293,026,119411,Porter; George M,9999,0,9999,0
1668303723767,CSE 293,027,119414,Porter; Leonard Emerson,9999,0,9999,0
1668303723767,CSE 293,028,119416,Ramamoorthi; Ravi,9999,0,9999,0
1668303723767,CSE 293,029,119417,Sahoo; Debashis,9999,0,9999,0
1668303723767,CSE 293,030,119420,Saul; Lawrence,9999,0,9999,0
1668303723767,CSE 293,031,119421,Savage; Stefan,9999,0,9999,0
1668303723767,CSE 293,032,119425,Schulze; Jurgen P.,9999,0,9999,0
1668303723767,CSE 293,033,119426,Snoeren; Alex C.,9999,0,9999,0
1668303723767,CSE 293,034,119428,Shang; Jingbo,9999,0,9999,0
1668303723767,CSE 293,035,119430,Stefan; Deian,9999,0,9999,0
1668303723767,CSE 293,036,119431,Su; Hao,9999,0,9999,0
1668303723767,CSE 293,037,119433,Swanson; Steven James,9999,0,9999,0
1668303723767,CSE 293,038,119435,Tullsen; Dean Michael,9999,0,9999,0
1668303723767,CSE 293,039,119483,Voelker; Geoffrey M.,9999,0,9999,0
1668303723767,CSE 293,040,119537,Zhao; Jishen,9999,0,9999,0
1668303723767,CSE 293,041,119538,Zhou; Yuan-Yuan,9999,0,9999,0
1668303723767,CSE 293,042,119539,Gao; Sicun,9999,0,9999,0
1668303723767,CSE 293,043,119540,Weibel; Nadir,9999,0,9999,0
1668303723767,CSE 293,044,119541,Gupta; Rajesh K.,9999,0,9999,0
1668303723767,CSE 293,045,126410,Vaccaro; Kristen Marie,9999,0,9999,0
1668303723767,CSE 293,046,126411,Klemke; Richard,9999,0,9999,0
1668303724190,CSE 294,A00,102459,Voelker; Geoffrey M.,0,0,0,0
1668303724190,CSE 294,B00,111322,Orailoglu; Alex,0,0,0,0
1668303724619,DSE 201,A00,096914,Deutsch; Alin Bernard,30,0,30,0
1668303725051,DSE 210,A00,096915,Dasgupta; Sanjoy,30,0,30,0
1668303725479,DSE 260A,A00,096916,Altintas De Callaf; Ilkay,30,0,30,0
1668303725906,ECE 200,001,103586,Antipa; Nicholas A,9999,0,9999,0
1668303725906,ECE 200,002,103587,Atanasov; Nikolay A.,9999,0,9999,0
1668303725906,ECE 200,003,103588,Bharadia; Dinesh,9999,0,9999,0
1668303725906,ECE 200,004,103589,Cheng; Chung Kuan,9999,0,9999,0
1668303725906,ECE 200,005,103590,Cosman; Pamela C.,9999,0,9999,0
1668303725906,ECE 200,006,103591,Dayeh; Shadi Ahmad,9999,0,9999,0
1668303725906,ECE 200,007,103592,Fainman; Yeshaiahu,9999,0,9999,0
1668303725906,ECE 200,008,103593,Ford; Joseph Earl,9999,0,9999,0
1668303725906,ECE 200,009,103594,Franceschetti; Massimo,9999,0,9999,0
1668303725906,ECE 200,010,103595,Fullerton; Eric E,9999,0,9999,0
1668303725906,ECE 200,011,103596,Galton; Ian A,9999,0,9999,0
1668303725906,ECE 200,012,103597,Gilja; Vikash,9999,0,9999,0
1668303725906,ECE 200,013,103598,Hall; Drew A.,9999,0,9999,0
1668303725906,ECE 200,014,103599,Hsueh; Tzu-Chien,9999,0,9999,0
1668303725906,ECE 200,015,103600,Javidi; Tara,9999,0,9999,0
1668303725906,ECE 200,016,103601,Kahng; Andrew Byun,9999,0,9999,0
1668303725906,ECE 200,017,103602,Kim; Young-Han,9999,0,9999,0
1668303725906,ECE 200,018,103603,Koushanfar; Farinaz,9999,0,9999,0
1668303725906,ECE 200,019,103604,Kuzum; Duygu,9999,0,9999,0
1668303725906,ECE 200,020,103605,Le; Hanh-Phuc,9999,0,9999,0
1668303725906,ECE 200,021,103606,Lin; Bill,9999,0,9999,0
1668303725906,ECE 200,022,103607,Liu; Zhaowei,9998,0,9999,1
1668303725906,ECE 200,023,103608,Lo; Yu-Hwa,9999,0,9999,0
1668303725906,ECE 200,024,103609,Lomakin; Vitaliy,9999,0,9999,0
1668303725906,ECE 200,025,103610,Mercier; Patrick Philip,9999,0,9999,0
1668303725906,ECE 200,026,103611,Meyer; Florian,9999,0,9999,0
1668303725906,ECE 200,027,103612,Milstein; Laurence B.,9999,0,9999,0
1668303725906,ECE 200,028,103613,Mir Arabbaygi; Siavash,9999,0,9999,0
1668303725906,ECE 200,029,103614,Mookherjea; Shayan,9999,0,9999,0
1668303725906,ECE 200,030,103615,Morris; Karcher William,9999,0,9999,0
1668303725906,ECE 200,031,103616,Ng; Tse Nga,9999,0,9999,0
1668303725906,ECE 200,032,103617,Nguyen; Truong Quang,9999,0,9999,0
1668303725906,ECE 200,033,103618,Nomura; Kenji,9999,0,9999,0
1668303725906,ECE 200,034,103619,Orlitsky; Alon,9999,0,9999,0
1668303725906,ECE 200,035,103620,Pal; Piya,9999,0,9999,0
1668303725906,ECE 200,036,103621,Papen; George C.,9999,0,9999,0
1668303725906,ECE 200,037,103622,Radic; Stojan,9999,0,9999,0
1668303725906,ECE 200,038,103623,Rao; Bhaskar D.,9999,0,9999,0
1668303725906,ECE 200,039,103624,Rao; Ramesh R,9999,0,9999,0
1668303725906,ECE 200,040,103625,Rebeiz; Gabriel,9999,0,9999,0
1668303725906,ECE 200,041,103626,Sanford; John R,9999,0,9999,0
1668303725906,ECE 200,042,103627,Siegel; Paul H.,9999,0,9999,0
1668303725906,ECE 200,043,103628,Sievenpiper; Daniel F.,9999,0,9999,0
1668303725906,ECE 200,044,103629,Sworder; David D.,9999,0,9999,0
1668303725906,ECE 200,045,103630,Taur; Yuan,9999,0,9999,0
1668303725906,ECE 200,046,103631,Touri; Behrouz,9999,0,9999,0
1668303725906,ECE 200,047,103632,Trivedi; Mohan M.,9999,0,9999,0
1668303725906,ECE 200,048,103633,Vasconcelos; Nuno,9999,0,9999,0
1668303725906,ECE 200,049,103634,Wang; Xiaolong,9999,0,9999,0
1668303725906,ECE 200,050,103635,Xie; Pengtao,9999,0,9999,0
1668303725906,ECE 200,051,103636,Yip; Michael,9999,0,9999,0
1668303725906,ECE 200,052,103637,Zeger; Kenneth A.,999,0,999,0
1668303725906,ECE 200,053,103638,Zhang; Xinyu,9999,0,9999,0
1668303725906,ECE 200,054,103639,Turakhia; Yatish Girish,9999,0,9999,0
1668303725906,ECE 200,055,103640,Kang; Mingu,9999,0,9999,0
1668303725906,ECE 200,056,103641,Shi; Yuanyuan,9999,0,9999,0
1668303725906,ECE 200,057,103642,Wang; Edward Jay,9999,0,9999,0
1668303725906,ECE 200,058,103643,Zheng; Yang,9999,0,9999,0
1668303726331,ECE 202,A00,103644,Kuzum; Duygu,0,0,0,0
1668303726754,ECE 212BN,A00,103646,Ng; Tse Nga,0,0,0,0
1668303727179,ECE 221,A00,111493,Staff,0,0,0,0
1668303727605,ECE 222B,A00,103647,Lomakin; Vitaliy,0,0,0,0
1668303728036,ECE 230B,A00,103648,Taur; Yuan,0,0,0,0
1668303728463,ECE 238B,A00,103649,Garay; Javier,0,0,0,0
1668303728896,ECE 240B,A00,112900,Fainman; Yeshaiahu,0,0,0,0
1668303729325,ECE 247A,A00,103650,Jokerst; Jesse Vincent,0,0,0,0
1668303729751,ECE 247B,A00,103651,Wang; Joseph,0,0,0,0
1668303730175,ECE 250,A00,103652,Siegel; Paul H.,0,0,0,0
1668303730601,ECE 251A,A00,103654,Rao; Bhaskar D.,0,0,0,0
1668303731024,ECE 257B,A00,103655,Bharadia; Dinesh,0,0,0,0
1668303731449,ECE 258A,A00,103656,Milstein; Laurence B.,0,0,0,0
1668303731876,ECE 260B,A00,103658,Kang; Mingu,0,0,0,0
1668303732300,ECE 264A,A00,103659,Galton; Ian A,0,0,0,0
1668303732725,ECE 265A,A00,103661,Gudem; Prasad S.S.,0,0,0,0
1668303733152,ECE 265D,A00,103662,Gudem; Prasad S.S.,0,0,0,0
1668303733581,ECE 268,A00,103663,Koushanfar; Farinaz,0,0,0,0
1668303734009,ECE 269,A01,103665,Pal; Piya,0,0,0,0
1668303734432,ECE 271B,A00,103666,Vasconcelos; Manuela,0,0,0,0
1668303734857,ECE 276A,A00,103667,Atanasov; Nikolay A.,0,0,0,0
1668303735283,ECE 277,A00,103668,An; Cheolhong,0,0,0,0
1668303735705,ECE 279,A00,117947,Hall; Drew A.,0,0,0,0
1668303736554,ECE 283,A00,103670,Hsueh; Tzu-Chien,0,0,0,0
1668303736979,ECE 284,A00,103671,Turakhia; Yatish Girish,0,0,0,0
1668303737405,ECE 285,A00,103672,Zheng; Yang,0,0,0,0
1668303737405,ECE 285,B00,103673,Sworder; David D.,0,0,0,0
1668303737832,ECE 287,A00,103676,Javidi; Tara,0,0,0,0
1668303738256,MATH 200B,A00,098023,Salehi Golsefidy; Alireza,12,0,15,3
1668303738678,MATH 202B,A00,098024,Rhoades; Brendon Patrick,9,0,15,6
1668303739100,MATH 203B,A00,098025,Oprea; Dragos N.,10,0,15,5
1668303739526,MATH 204B,A00,098026,Sorensen; Claus M,13,0,15,2
1668303739949,MATH 208,A00,098027,Izadi; Elham,7,0,10,3
1668303740375,MATH 209,A00,098028,Pollack; Aaron,10,0,10,0
1668303740799,MATH 211A,A00,112919,Rogalski; Daniel,9,0,10,1
1668303741228,MATH 211B,A00,112920,Seward; Brandon M.,9,0,10,1
1668303741653,MATH 218,A00,098029,Li; Bo,10,0,10,0
1668303742077,MATH 220B,A00,098030,Novak; Jonathan I,11,0,15,4
1668303742501,MATH 221A,A00,098031,Ebenfelt; Peter F,13,0,15,2
1668303742924,MATH 231B,A00,098032,Zlatos; Andrej,12,0,15,3
1668303743347,MATH 240B,A00,098033,Ni; Lei,9,0,15,6
1668303743772,MATH 243,A00,098034,Jekel; David Andrew,10,0,10,0
1668303744196,MATH 245A,A00,098035,Nie; Jiawang,0,0,15,16
1668303744619,MATH 248,A00,098036,Bejenaru; Ioan,10,0,10,0
1668303745045,MATH 250B,A00,098037,Spolaor; Luca,14,0,15,1
1668303745471,MATH 258,A00,098038,Ni; Lei,10,0,10,0
1668303745893,MATH 264B,A00,098041,Rhoades; Brendon Patrick,9,0,15,6
1668303746318,MATH 268,A00,098042,Buss; Samuel R,10,0,10,0
1668303746741,MATH 269,A00,098043,Rhoades; Brendon Patrick,10,0,10,0
1668303747175,MATH 270B,A00,098044,Li; Bo,10,0,15,5
1668303747597,MATH 272B,A00,098045,Holst; Michael J,13,0,15,2
1668303748022,MATH 273A,A00,098046,Tian; Xiaochuan,10,0,15,5
1668303748447,MATH 275,A01,098048,Tian; Xiaochuan,6,0,10,4
1668303748872,MATH 278A,A00,098049,Holst; Michael J,8,0,10,2
1668303749295,MATH 278B,A00,098050,Cloninger; Alexander,10,0,10,0
1668303749718,MATH 278C,A00,098051,Nie; Jiawang,7,0,10,3
1668303750146,MATH 280B,A00,098052,Zheng; Tianyi,8,0,15,7
1668303750568,MATH 281B,A00,098053,Bradic; Jelena,1,0,15,14
1668303750992,MATH 282B,A00,098054,Arias-Castro; Ery,0,0,15,15
1668303751415,MATH 285,A00,098055,Fitzsimmons; Patrick J,0,0,15,17
1668303751839,MATH 287B,A00,098056,Arias-Castro; Ery,2,0,15,13
1668303752273,MATH 288,A00,098057,Agarwal; Pooja,9,0,10,1
1668303752273,MATH 288,B00,098058,Zhang; Danna,8,0,10,2
1668303752273,MATH 288,C00,098059,Williams; Ruth J,9,0,10,1
1668303752775,MATH 290B,A00,098060,Roberts; Justin Deritter,13,0,15,2
1668303753200,MATH 292,A00,098061,Belmont; Eva Kinoshita,10,0,10,0
1668303753622,MATH 295,A00,098062,Suk; Andrew Hoon,48,0,50,2
1668303754049,MATH 296,A00,098063,Novak; Jonathan I,20,0,20,0
1668303754476,MATH 297,001,098064,Gamst; Anthony Collins,9997,0,9999,2
1668304253655,COGS 205,A00,101395,Chiba; Andrea,19,0,20,1
1668304254080,COGS 210B,001,101404,Greene; Deanna Jacquelyn,9998,0,9999,1
1668304254080,COGS 210B,002,101417,Xia; Haijun,9999,0,9999,0
1668304254080,COGS 210B,003,101422,Nitz; Douglas A.,9999,0,9999,0
1668304254080,COGS 210B,004,101423,Hollan; James D.,9998,0,9999,1
1668304254080,COGS 210B,005,101424,Deak; Gedeon O.,9998,0,9999,1
1668304254080,COGS 210B,006,101425,Rossano; Federico,9999,0,9999,0
1668304254506,COGS 211B,A00,101427,Coulson; Seana M,9996,0,9999,3
1668304254931,COGS 220,A00,101428,Hollan; James D.,0,0,25,25
1668304255354,COGS 229,A00,101429,Dow; Steven P,18,0,25,7
1668304255778,COGS 230,A00,101430,Klemmer; Scott R,12,0,17,5
1668304256202,COGS 234,A00,101431,Xia; Haijun,1,0,25,24
1668304256627,COGS 260,A00,101432,Kiyonaga; Anastasia,21,0,25,4
1668304256627,COGS 260,B00,101433,Kirsh; David Joel,15,0,25,10
1668304257059,CSE 202,A00,102371,Impagliazzo; Russell,0,0,0,0
1668304257482,CSE 203B,A01,102373,Cheng; Chung Kuan,0,0,0,0
1668304257909,CSE 208,A00,102374,Micciancio; Daniele,0,0,0,0
1668304258331,CSE 209A,A00,112895,Impagliazzo; Russell,0,0,15,15
1668304258754,CSE 209B,A00,108005,Bellare; Mihir,0,0,0,0
1668304259179,CSE 210,A00,113163,Coblenz; Michael J,0,0,0,0
1668304259602,CSE 219,A00,106111,Dow; Steven P,0,0,20,20
1668304260030,CSE 221,A00,102376,Voelker; Geoffrey M.,0,0,0,0
1668304260453,CSE 224,A01,102378,Porter; George M,0,0,0,0
1668304260879,CSE 229A,A00,102379,Savage; Stefan,0,0,0,0
1668304261303,CSE 229C,A00,102380,Munyaka; Imani N. S.,0,0,0,0
1668304261740,CSE 232B,A00,102382,Deutsch; Alin Bernard,0,0,0,0
1668304262170,CSE 234,A01,112904,Kumar; Arun Kumar,0,0,0,0
1668304262594,CSE 237A,A00,102383,Rosing; Tajana Simunic,0,0,0,0
1668304263019,CSE 239A,A00,102384,Deutsch; Alin Bernard,0,0,0,0
1668304263444,CSE 239B,A00,102385,Polikarpova; Nadezhda,0,0,0,0
1668304263869,CSE 240A,A00,102386,Pannuto; Patrick William,0,0,0,0
1668304264294,CSE 240B,A00,102387,Zhao; Jishen,0,0,0,0
1668304264717,CSE 241A,A00,106406,Kang; Mingu,0,0,0,0
1668304265143,CSE 249B,A00,102388,Kahng; Andrew Byun,0,0,8,8
1668304265568,CSE 251B,A01,102392,Cottrell; Garrison W,0,0,0,0
1668304265568,CSE 251B,A02,102393,Cottrell; Garrison W,0,0,0,0
1668304265989,CSE 252B,A00,102394,Ochoa; Benjamin Lawrence,0,0,0,0
1668304266418,CSE 257,A01,102396,Gao; Sicun,0,0,0,0
1668304266854,CSE 272,A00,102397,Li; Tzumao,0,0,0,0
1668304267283,CSE 274,A00,111323,Chern; Albert Ren-Haur,0,0,0,0
1668304267707,CSE 282,A00,102398,Pevzner; Pavel Arkadjevich,0,0,0,0
1668304268132,CSE 284,A00,114175,Gymrek; Melissa Ann,0,0,0,0
1668304268559,CSE 290,A00,102399,Chandraker; Manmohan Krishna,0,0,0,0
1668304268559,CSE 290,B00,102400,Vaccaro; Kristen Marie,0,0,25,25
1668304268559,CSE 290,C00,102414,Pannuto; Patrick William,0,0,25,25
1668304268559,CSE 290,D00,102427,Pevzner; Pavel Arkadjevich,0,0,0,0
1668304268559,CSE 290,E00,102429,Zhao; Jishen,0,0,0,0
1668304268559,CSE 290,F00,102436,Tullsen; Dean Michael,0,0,0,0
1668304268559,CSE 290,G00,102440,Christensen; Henrik I,0,0,20,20
1668304268984,CSE 291,A00,102443,Su; Hao,0,0,0,0
1668304268984,CSE 291,B00,102448,Polikarpova; Nadezhda,0,0,0,0
1668304268984,CSE 291,C00,102453,Vaccaro; Kristen Marie,0,0,0,0
1668304268984,CSE 291,D00,111343,Savage; Stefan,0,0,0,0
1668304268984,CSE 291,E00,116474,Claffy; Kimberly Claire,0,0,0,0
1668304268984,CSE 291,F00,116479,Pasquale; Joseph,0,0,0,0
1668304269417,CSE 293,001,119111,Bafna; Vineet,9999,0,9999,0
1668304269417,CSE 293,002,119118,Bellare; Mihir,9999,0,9999,0
1668304269417,CSE 293,003,119122,Berg-Kirkpatrick; Taylor D,9999,0,9999,0
1668304269417,CSE 293,004,119135,Christensen; Henrik I,9999,0,9999,0
1668304269417,CSE 293,005,119142,Cottrell; Garrison W,9999,0,9999,0
1668304269417,CSE 293,006,119146,Deutsch; Alin Bernard,9999,0,9999,0
1668304269417,CSE 293,007,119159,Esmaeilzadeh; Hadi,9999,0,9999,0
1668304269417,CSE 293,008,119166,Freund; Yoav,9999,0,9999,0
1668304269417,CSE 293,009,119170,Griswold; William G.,9999,0,9999,0
1668304269417,CSE 293,010,119183,Gymrek; Melissa Ann,9999,0,9999,0
1668304269417,CSE 293,011,119190,Heninger; Nadia A,9999,0,9999,0
1668304269417,CSE 293,012,119230,Impagliazzo; Russell,9999,0,9999,0
1668304269417,CSE 293,013,119232,Jhala; Ranjit,9999,0,9999,0
1668304269417,CSE 293,014,119233,Kahng; Andrew Byun,9999,0,9999,0
1668304269417,CSE 293,015,119298,Kane; Daniel Mertz,9999,0,9999,0
1668304269417,CSE 293,016,119299,Kriegman; David J,9999,0,9999,0
1668304269417,CSE 293,017,119300,Kumar; Arun Kumar,9999,0,9999,0
1668304269417,CSE 293,018,119301,Lerner; Sorin,9999,0,9999,0
1668304269417,CSE 293,019,119302,Lovett; Shachar,9999,0,9999,0
1668304269417,CSE 293,020,119303,McAuley; Julian John,9999,0,9999,0
1668304269417,CSE 293,021,119304,Micciancio; Daniele,9999,0,9999,0
1668304269417,CSE 293,022,119367,Orailoglu; Alex,9999,0,9999,0
1668304269417,CSE 293,023,119382,Paturi; Ramamohan,9999,0,9999,0
1668304269417,CSE 293,024,119404,Polikarpova; Nadezhda,9999,0,9999,0
1668304269417,CSE 293,025,119406,Politz; Joseph Gibbs,9999,0,9999,0
1668304269417,CSE 293,026,119411,Porter; George M,9999,0,9999,0
1668304269417,CSE 293,027,119414,Porter; Leonard Emerson,9999,0,9999,0
1668304269417,CSE 293,028,119416,Ramamoorthi; Ravi,9999,0,9999,0
1668304269417,CSE 293,029,119417,Sahoo; Debashis,9999,0,9999,0
1668304269417,CSE 293,030,119420,Saul; Lawrence,9999,0,9999,0
1668304269417,CSE 293,031,119421,Savage; Stefan,9999,0,9999,0
1668304269417,CSE 293,032,119425,Schulze; Jurgen P.,9999,0,9999,0
1668304269417,CSE 293,033,119426,Snoeren; Alex C.,9999,0,9999,0
1668304269417,CSE 293,034,119428,Shang; Jingbo,9999,0,9999,0
1668304269417,CSE 293,035,119430,Stefan; Deian,9999,0,9999,0
1668304269417,CSE 293,036,119431,Su; Hao,9999,0,9999,0
1668304269417,CSE 293,037,119433,Swanson; Steven James,9999,0,9999,0
1668304269417,CSE 293,038,119435,Tullsen; Dean Michael,9999,0,9999,0
1668304269417,CSE 293,039,119483,Voelker; Geoffrey M.,9999,0,9999,0
1668304269417,CSE 293,040,119537,Zhao; Jishen,9999,0,9999,0
1668304269417,CSE 293,041,119538,Zhou; Yuan-Yuan,9999,0,9999,0
1668304269417,CSE 293,042,119539,Gao; Sicun,9999,0,9999,0
1668304269417,CSE 293,043,119540,Weibel; Nadir,9999,0,9999,0
1668304269417,CSE 293,044,119541,Gupta; Rajesh K.,9999,0,9999,0
1668304269417,CSE 293,045,126410,Vaccaro; Kristen Marie,9999,0,9999,0
1668304269417,CSE 293,046,126411,Klemke; Richard,9999,0,9999,0
1668304269847,CSE 294,A00,102459,Voelker; Geoffrey M.,0,0,0,0
1668304269847,CSE 294,B00,111322,Orailoglu; Alex,0,0,0,0
1668304270271,DSE 201,A00,096914,Deutsch; Alin Bernard,30,0,30,0
1668304270705,DSE 210,A00,096915,Dasgupta; Sanjoy,30,0,30,0
1668304271133,DSE 260A,A00,096916,Altintas De Callaf; Ilkay,30,0,30,0
1668304271577,ECE 200,001,103586,Antipa; Nicholas A,9999,0,9999,0
1668304271577,ECE 200,002,103587,Atanasov; Nikolay A.,9999,0,9999,0
1668304271577,ECE 200,003,103588,Bharadia; Dinesh,9999,0,9999,0
1668304271577,ECE 200,004,103589,Cheng; Chung Kuan,9999,0,9999,0
1668304271577,ECE 200,005,103590,Cosman; Pamela C.,9999,0,9999,0
1668304271577,ECE 200,006,103591,Dayeh; Shadi Ahmad,9999,0,9999,0
1668304271577,ECE 200,007,103592,Fainman; Yeshaiahu,9999,0,9999,0
1668304271577,ECE 200,008,103593,Ford; Joseph Earl,9999,0,9999,0
1668304271577,ECE 200,009,103594,Franceschetti; Massimo,9999,0,9999,0
1668304271577,ECE 200,010,103595,Fullerton; Eric E,9999,0,9999,0
1668304271577,ECE 200,011,103596,Galton; Ian A,9999,0,9999,0
1668304271577,ECE 200,012,103597,Gilja; Vikash,9999,0,9999,0
1668304271577,ECE 200,013,103598,Hall; Drew A.,9999,0,9999,0
1668304271577,ECE 200,014,103599,Hsueh; Tzu-Chien,9999,0,9999,0
1668304271577,ECE 200,015,103600,Javidi; Tara,9999,0,9999,0
1668304271577,ECE 200,016,103601,Kahng; Andrew Byun,9999,0,9999,0
1668304271577,ECE 200,017,103602,Kim; Young-Han,9999,0,9999,0
1668304271577,ECE 200,018,103603,Koushanfar; Farinaz,9999,0,9999,0
1668304271577,ECE 200,019,103604,Kuzum; Duygu,9999,0,9999,0
1668304271577,ECE 200,020,103605,Le; Hanh-Phuc,9999,0,9999,0
1668304271577,ECE 200,021,103606,Lin; Bill,9999,0,9999,0
1668304271577,ECE 200,022,103607,Liu; Zhaowei,9998,0,9999,1
1668304271577,ECE 200,023,103608,Lo; Yu-Hwa,9999,0,9999,0
1668304271577,ECE 200,024,103609,Lomakin; Vitaliy,9999,0,9999,0
1668304271577,ECE 200,025,103610,Mercier; Patrick Philip,9999,0,9999,0
1668304271577,ECE 200,026,103611,Meyer; Florian,9999,0,9999,0
1668304271577,ECE 200,027,103612,Milstein; Laurence B.,9999,0,9999,0
1668304271577,ECE 200,028,103613,Mir Arabbaygi; Siavash,9999,0,9999,0
1668304271577,ECE 200,029,103614,Mookherjea; Shayan,9999,0,9999,0
1668304271577,ECE 200,030,103615,Morris; Karcher William,9999,0,9999,0
1668304271577,ECE 200,031,103616,Ng; Tse Nga,9999,0,9999,0
1668304271577,ECE 200,032,103617,Nguyen; Truong Quang,9999,0,9999,0
1668304271577,ECE 200,033,103618,Nomura; Kenji,9999,0,9999,0
1668304271577,ECE 200,034,103619,Orlitsky; Alon,9999,0,9999,0
1668304271577,ECE 200,035,103620,Pal; Piya,9999,0,9999,0
1668304271577,ECE 200,036,103621,Papen; George C.,9999,0,9999,0
1668304271577,ECE 200,037,103622,Radic; Stojan,9999,0,9999,0
1668304271577,ECE 200,038,103623,Rao; Bhaskar D.,9999,0,9999,0
1668304271577,ECE 200,039,103624,Rao; Ramesh R,9999,0,9999,0
1668304271577,ECE 200,040,103625,Rebeiz; Gabriel,9999,0,9999,0
1668304271577,ECE 200,041,103626,Sanford; John R,9999,0,9999,0
1668304271577,ECE 200,042,103627,Siegel; Paul H.,9999,0,9999,0
1668304271577,ECE 200,043,103628,Sievenpiper; Daniel F.,9999,0,9999,0
1668304271577,ECE 200,044,103629,Sworder; David D.,9999,0,9999,0
1668304271577,ECE 200,045,103630,Taur; Yuan,9999,0,9999,0
1668304271577,ECE 200,046,103631,Touri; Behrouz,9999,0,9999,0
1668304271577,ECE 200,047,103632,Trivedi; Mohan M.,9999,0,9999,0
1668304271577,ECE 200,048,103633,Vasconcelos; Nuno,9999,0,9999,0
1668304271577,ECE 200,049,103634,Wang; Xiaolong,9999,0,9999,0
1668304271577,ECE 200,050,103635,Xie; Pengtao,9999,0,9999,0
1668304271577,ECE 200,051,103636,Yip; Michael,9999,0,9999,0
1668304271577,ECE 200,052,103637,Zeger; Kenneth A.,999,0,999,0
1668304271577,ECE 200,053,103638,Zhang; Xinyu,9999,0,9999,0
1668304271577,ECE 200,054,103639,Turakhia; Yatish Girish,9999,0,9999,0
1668304271577,ECE 200,055,103640,Kang; Mingu,9999,0,9999,0
1668304271577,ECE 200,056,103641,Shi; Yuanyuan,9999,0,9999,0
1668304271577,ECE 200,057,103642,Wang; Edward Jay,9999,0,9999,0
1668304271577,ECE 200,058,103643,Zheng; Yang,9999,0,9999,0
1668304272085,ECE 202,A00,103644,Kuzum; Duygu,0,0,0,0
1668304272509,ECE 212BN,A00,103646,Ng; Tse Nga,0,0,0,0
1668304272933,ECE 221,A00,111493,Staff,0,0,0,0
1668304273356,ECE 222B,A00,103647,Lomakin; Vitaliy,0,0,0,0
1668304273780,ECE 230B,A00,103648,Taur; Yuan,0,0,0,0
1668304274205,ECE 238B,A00,103649,Garay; Javier,0,0,0,0
1668304274630,ECE 240B,A00,112900,Fainman; Yeshaiahu,0,0,0,0
1668304275056,ECE 247A,A00,103650,Jokerst; Jesse Vincent,0,0,0,0
1668304275479,ECE 247B,A00,103651,Wang; Joseph,0,0,0,0
1668304275904,ECE 250,A00,103652,Siegel; Paul H.,0,0,0,0
1668304276329,ECE 251A,A00,103654,Rao; Bhaskar D.,0,0,0,0
1668304276757,ECE 257B,A00,103655,Bharadia; Dinesh,0,0,0,0
1668304277185,ECE 258A,A00,103656,Milstein; Laurence B.,0,0,0,0
1668304277610,ECE 260B,A00,103658,Kang; Mingu,0,0,0,0
1668304278035,ECE 264A,A00,103659,Galton; Ian A,0,0,0,0
1668304278460,ECE 265A,A00,103661,Gudem; Prasad S.S.,0,0,0,0
1668304278885,ECE 265D,A00,103662,Gudem; Prasad S.S.,0,0,0,0
1668304279308,ECE 268,A00,103663,Koushanfar; Farinaz,0,0,0,0
1668304279732,ECE 269,A01,103665,Pal; Piya,0,0,0,0
1668304280168,ECE 271B,A00,103666,Vasconcelos; Manuela,0,0,0,0
1668304280594,ECE 276A,A00,103667,Atanasov; Nikolay A.,0,0,0,0
1668304281018,ECE 277,A00,103668,An; Cheolhong,0,0,0,0
1668304281453,ECE 279,A00,117947,Hall; Drew A.,0,0,0,0
1668304282302,ECE 283,A00,103670,Hsueh; Tzu-Chien,0,0,0,0
1668304282725,ECE 284,A00,103671,Turakhia; Yatish Girish,0,0,0,0
1668304283149,ECE 285,A00,103672,Zheng; Yang,0,0,0,0
1668304283149,ECE 285,B00,103673,Sworder; David D.,0,0,0,0
1668304283573,ECE 287,A00,103676,Javidi; Tara,0,0,0,0
1668304283997,MATH 200B,A00,098023,Salehi Golsefidy; Alireza,12,0,15,3
1668304284429,MATH 202B,A00,098024,Rhoades; Brendon Patrick,9,0,15,6
1668304284855,MATH 203B,A00,098025,Oprea; Dragos N.,10,0,15,5
1668304285280,MATH 204B,A00,098026,Sorensen; Claus M,13,0,15,2
1668304285707,MATH 208,A00,098027,Izadi; Elham,7,0,10,3
1668304286135,MATH 209,A00,098028,Pollack; Aaron,10,0,10,0
1668304286563,MATH 211A,A00,112919,Rogalski; Daniel,9,0,10,1
1668304286986,MATH 211B,A00,112920,Seward; Brandon M.,9,0,10,1
1668304287413,MATH 218,A00,098029,Li; Bo,10,0,10,0
1668304287837,MATH 220B,A00,098030,Novak; Jonathan I,11,0,15,4
1668304288259,MATH 221A,A00,098031,Ebenfelt; Peter F,13,0,15,2
1668304288686,MATH 231B,A00,098032,Zlatos; Andrej,12,0,15,3
1668304289110,MATH 240B,A00,098033,Ni; Lei,9,0,15,6
1668304289535,MATH 243,A00,098034,Jekel; David Andrew,10,0,10,0
1668304289967,MATH 245A,A00,098035,Nie; Jiawang,0,0,15,16
1668304290396,MATH 248,A00,098036,Bejenaru; Ioan,10,0,10,0
1668304290822,MATH 250B,A00,098037,Spolaor; Luca,14,0,15,1
1668304291250,MATH 258,A00,098038,Ni; Lei,10,0,10,0
1668304291673,MATH 264B,A00,098041,Rhoades; Brendon Patrick,9,0,15,6
1668304292103,MATH 268,A00,098042,Buss; Samuel R,10,0,10,0
1668304292527,MATH 269,A00,098043,Rhoades; Brendon Patrick,10,0,10,0
1668304292950,MATH 270B,A00,098044,Li; Bo,10,0,15,5
1668304293373,MATH 272B,A00,098045,Holst; Michael J,13,0,15,2
1668304293797,MATH 273A,A00,098046,Tian; Xiaochuan,10,0,15,5
1668304294225,MATH 275,A01,098048,Tian; Xiaochuan,6,0,10,4
1668304294656,MATH 278A,A00,098049,Holst; Michael J,8,0,10,2
1668304295078,MATH 278B,A00,098050,Cloninger; Alexander,10,0,10,0
1668304295504,MATH 278C,A00,098051,Nie; Jiawang,7,0,10,3
1668304295926,MATH 280B,A00,098052,Zheng; Tianyi,8,0,15,7
1668304296353,MATH 281B,A00,098053,Bradic; Jelena,1,0,15,14
1668304296779,MATH 282B,A00,098054,Arias-Castro; Ery,0,0,15,15
1668304297205,MATH 285,A00,098055,Fitzsimmons; Patrick J,0,0,15,17
1668304297631,MATH 287B,A00,098056,Arias-Castro; Ery,2,0,15,13
1668304298057,MATH 288,A00,098057,Agarwal; Pooja,9,0,10,1
1668304298057,MATH 288,B00,098058,Zhang; Danna,8,0,10,2
1668304298057,MATH 288,C00,098059,Williams; Ruth J,9,0,10,1
1668304298480,MATH 290B,A00,098060,Roberts; Justin Deritter,13,0,15,2
1668304298909,MATH 292,A00,098061,Belmont; Eva Kinoshita,10,0,10,0
1668304299332,MATH 295,A00,098062,Suk; Andrew Hoon,48,0,50,2
1668304299763,MATH 296,A00,098063,Novak; Jonathan I,20,0,20,0
1668304300186,MATH 297,001,098064,Gamst; Anthony Collins,9997,0,9999,2
1668304799053,COGS 205,A00,101395,Chiba; Andrea,19,0,20,1
1668304799478,COGS 210B,001,101404,Greene; Deanna Jacquelyn,9998,0,9999,1
1668304799478,COGS 210B,002,101417,Xia; Haijun,9999,0,9999,0
1668304799478,COGS 210B,003,101422,Nitz; Douglas A.,9999,0,9999,0
1668304799478,COGS 210B,004,101423,Hollan; James D.,9998,0,9999,1
1668304799478,COGS 210B,005,101424,Deak; Gedeon O.,9998,0,9999,1
1668304799478,COGS 210B,006,101425,Rossano; Federico,9999,0,9999,0
1668304799901,COGS 211B,A00,101427,Coulson; Seana M,9996,0,9999,3
1668304800327,COGS 220,A00,101428,Hollan; James D.,0,0,25,25
1668304800750,COGS 229,A00,101429,Dow; Steven P,18,0,25,7
1668304801175,COGS 230,A00,101430,Klemmer; Scott R,12,0,17,5
1668304801607,COGS 234,A00,101431,Xia; Haijun,1,0,25,24
1668304802029,COGS 260,A00,101432,Kiyonaga; Anastasia,21,0,25,4
1668304802029,COGS 260,B00,101433,Kirsh; David Joel,15,0,25,10
1668304802458,CSE 202,A00,102371,Impagliazzo; Russell,0,0,0,0
1668304802886,CSE 203B,A01,102373,Cheng; Chung Kuan,0,0,0,0
1668304803313,CSE 208,A00,102374,Micciancio; Daniele,0,0,0,0
1668304803737,CSE 209A,A00,112895,Impagliazzo; Russell,0,0,15,15
1668304804162,CSE 209B,A00,108005,Bellare; Mihir,0,0,0,0
1668304804585,CSE 210,A00,113163,Coblenz; Michael J,0,0,0,0
1668304805012,CSE 219,A00,106111,Dow; Steven P,0,0,20,20
1668304805434,CSE 221,A00,102376,Voelker; Geoffrey M.,0,0,0,0
1668304805857,CSE 224,A01,102378,Porter; George M,0,0,0,0
1668304806278,CSE 229A,A00,102379,Savage; Stefan,0,0,0,0
1668304806700,CSE 229C,A00,102380,Munyaka; Imani N. S.,0,0,0,0
1668304807122,CSE 232B,A00,102382,Deutsch; Alin Bernard,0,0,0,0
1668304807552,CSE 234,A01,112904,Kumar; Arun Kumar,0,0,0,0
1668304807977,CSE 237A,A00,102383,Rosing; Tajana Simunic,0,0,0,0
1668304808398,CSE 239A,A00,102384,Deutsch; Alin Bernard,0,0,0,0
1668304808834,CSE 239B,A00,102385,Polikarpova; Nadezhda,0,0,0,0
1668304809257,CSE 240A,A00,102386,Pannuto; Patrick William,0,0,0,0
1668304809679,CSE 240B,A00,102387,Zhao; Jishen,0,0,0,0
1668304810103,CSE 241A,A00,106406,Kang; Mingu,0,0,0,0
1668304810534,CSE 249B,A00,102388,Kahng; Andrew Byun,0,0,8,8
1668304810958,CSE 251B,A01,102392,Cottrell; Garrison W,0,0,0,0
1668304810958,CSE 251B,A02,102393,Cottrell; Garrison W,0,0,0,0
1668304811382,CSE 252B,A00,102394,Ochoa; Benjamin Lawrence,0,0,0,0
1668304811808,CSE 257,A01,102396,Gao; Sicun,0,0,0,0
1668304812232,CSE 272,A00,102397,Li; Tzumao,0,0,0,0
1668304812658,CSE 274,A00,111323,Chern; Albert Ren-Haur,0,0,0,0
1668304813083,CSE 282,A00,102398,Pevzner; Pavel Arkadjevich,0,0,0,0
1668304813510,CSE 284,A00,114175,Gymrek; Melissa Ann,0,0,0,0
1668304813938,CSE 290,A00,102399,Chandraker; Manmohan Krishna,0,0,0,0
1668304813938,CSE 290,B00,102400,Vaccaro; Kristen Marie,0,0,25,25
1668304813938,CSE 290,C00,102414,Pannuto; Patrick William,0,0,25,25
1668304813938,CSE 290,D00,102427,Pevzner; Pavel Arkadjevich,0,0,0,0
1668304813938,CSE 290,E00,102429,Zhao; Jishen,0,0,0,0
1668304813938,CSE 290,F00,102436,Tullsen; Dean Michael,0,0,0,0
1668304813938,CSE 290,G00,102440,Christensen; Henrik I,0,0,20,20
1668304814367,CSE 291,A00,102443,Su; Hao,0,0,0,0
1668304814367,CSE 291,B00,102448,Polikarpova; Nadezhda,0,0,0,0
1668304814367,CSE 291,C00,102453,Vaccaro; Kristen Marie,0,0,0,0
1668304814367,CSE 291,D00,111343,Savage; Stefan,0,0,0,0
1668304814367,CSE 291,E00,116474,Claffy; Kimberly Claire,0,0,0,0
1668304814367,CSE 291,F00,116479,Pasquale; Joseph,0,0,0,0
1668304814794,CSE 293,001,119111,Bafna; Vineet,9999,0,9999,0
1668304814794,CSE 293,002,119118,Bellare; Mihir,9999,0,9999,0
1668304814794,CSE 293,003,119122,Berg-Kirkpatrick; Taylor D,9999,0,9999,0
1668304814794,CSE 293,004,119135,Christensen; Henrik I,9999,0,9999,0
1668304814794,CSE 293,005,119142,Cottrell; Garrison W,9999,0,9999,0
1668304814794,CSE 293,006,119146,Deutsch; Alin Bernard,9999,0,9999,0
1668304814794,CSE 293,007,119159,Esmaeilzadeh; Hadi,9999,0,9999,0
1668304814794,CSE 293,008,119166,Freund; Yoav,9999,0,9999,0
1668304814794,CSE 293,009,119170,Griswold; William G.,9999,0,9999,0
1668304814794,CSE 293,010,119183,Gymrek; Melissa Ann,9999,0,9999,0
1668304814794,CSE 293,011,119190,Heninger; Nadia A,9999,0,9999,0
1668304814794,CSE 293,012,119230,Impagliazzo; Russell,9999,0,9999,0
1668304814794,CSE 293,013,119232,Jhala; Ranjit,9999,0,9999,0
1668304814794,CSE 293,014,119233,Kahng; Andrew Byun,9999,0,9999,0
1668304814794,CSE 293,015,119298,Kane; Daniel Mertz,9999,0,9999,0
1668304814794,CSE 293,016,119299,Kriegman; David J,9999,0,9999,0
1668304814794,CSE 293,017,119300,Kumar; Arun Kumar,9999,0,9999,0
1668304814794,CSE 293,018,119301,Lerner; Sorin,9999,0,9999,0
1668304814794,CSE 293,019,119302,Lovett; Shachar,9999,0,9999,0
1668304814794,CSE 293,020,119303,McAuley; Julian John,9999,0,9999,0
1668304814794,CSE 293,021,119304,Micciancio; Daniele,9999,0,9999,0
1668304814794,CSE 293,022,119367,Orailoglu; Alex,9999,0,9999,0
1668304814794,CSE 293,023,119382,Paturi; Ramamohan,9999,0,9999,0
1668304814794,CSE 293,024,119404,Polikarpova; Nadezhda,9999,0,9999,0
1668304814794,CSE 293,025,119406,Politz; Joseph Gibbs,9999,0,9999,0
1668304814794,CSE 293,026,119411,Porter; George M,9999,0,9999,0
1668304814794,CSE 293,027,119414,Porter; Leonard Emerson,9999,0,9999,0
1668304814794,CSE 293,028,119416,Ramamoorthi; Ravi,9999,0,9999,0
1668304814794,CSE 293,029,119417,Sahoo; Debashis,9999,0,9999,0
1668304814794,CSE 293,030,119420,Saul; Lawrence,9999,0,9999,0
1668304814794,CSE 293,031,119421,Savage; Stefan,9999,0,9999,0
1668304814794,CSE 293,032,119425,Schulze; Jurgen P.,9999,0,9999,0
1668304814794,CSE 293,033,119426,Snoeren; Alex C.,9999,0,9999,0
1668304814794,CSE 293,034,119428,Shang; Jingbo,9999,0,9999,0
1668304814794,CSE 293,035,119430,Stefan; Deian,9999,0,9999,0
1668304814794,CSE 293,036,119431,Su; Hao,9999,0,9999,0
1668304814794,CSE 293,037,119433,Swanson; Steven James,9999,0,9999,0
1668304814794,CSE 293,038,119435,Tullsen; Dean Michael,9999,0,9999,0
1668304814794,CSE 293,039,119483,Voelker; Geoffrey M.,9999,0,9999,0
1668304814794,CSE 293,040,119537,Zhao; Jishen,9999,0,9999,0
1668304814794,CSE 293,041,119538,Zhou; Yuan-Yuan,9999,0,9999,0
1668304814794,CSE 293,042,119539,Gao; Sicun,9999,0,9999,0
1668304814794,CSE 293,043,119540,Weibel; Nadir,9999,0,9999,0
1668304814794,CSE 293,044,119541,Gupta; Rajesh K.,9999,0,9999,0
1668304814794,CSE 293,045,126410,Vaccaro; Kristen Marie,9999,0,9999,0
1668304814794,CSE 293,046,126411,Klemke; Richard,9999,0,9999,0
1668304815221,CSE 294,A00,102459,Voelker; Geoffrey M.,0,0,0,0
1668304815221,CSE 294,B00,111322,Orailoglu; Alex,0,0,0,0
1668304815643,DSE 201,A00,096914,Deutsch; Alin Bernard,30,0,30,0
1668304816069,DSE 210,A00,096915,Dasgupta; Sanjoy,30,0,30,0
1668304816494,DSE 260A,A00,096916,Altintas De Callaf; Ilkay,30,0,30,0
1668304816922,ECE 200,001,103586,Antipa; Nicholas A,9999,0,9999,0
1668304816922,ECE 200,002,103587,Atanasov; Nikolay A.,9999,0,9999,0
1668304816922,ECE 200,003,103588,Bharadia; Dinesh,9999,0,9999,0
1668304816922,ECE 200,004,103589,Cheng; Chung Kuan,9999,0,9999,0
1668304816922,ECE 200,005,103590,Cosman; Pamela C.,9999,0,9999,0
1668304816922,ECE 200,006,103591,Dayeh; Shadi Ahmad,9999,0,9999,0
1668304816922,ECE 200,007,103592,Fainman; Yeshaiahu,9999,0,9999,0
1668304816922,ECE 200,008,103593,Ford; Joseph Earl,9999,0,9999,0
1668304816922,ECE 200,009,103594,Franceschetti; Massimo,9999,0,9999,0
1668304816922,ECE 200,010,103595,Fullerton; Eric E,9999,0,9999,0
1668304816922,ECE 200,011,103596,Galton; Ian A,9999,0,9999,0
1668304816922,ECE 200,012,103597,Gilja; Vikash,9999,0,9999,0
1668304816922,ECE 200,013,103598,Hall; Drew A.,9999,0,9999,0
1668304816922,ECE 200,014,103599,Hsueh; Tzu-Chien,9999,0,9999,0
1668304816922,ECE 200,015,103600,Javidi; Tara,9999,0,9999,0
1668304816922,ECE 200,016,103601,Kahng; Andrew Byun,9999,0,9999,0
1668304816922,ECE 200,017,103602,Kim; Young-Han,9999,0,9999,0
1668304816922,ECE 200,018,103603,Koushanfar; Farinaz,9999,0,9999,0
1668304816922,ECE 200,019,103604,Kuzum; Duygu,9999,0,9999,0
1668304816922,ECE 200,020,103605,Le; Hanh-Phuc,9999,0,9999,0
1668304816922,ECE 200,021,103606,Lin; Bill,9999,0,9999,0
1668304816922,ECE 200,022,103607,Liu; Zhaowei,9998,0,9999,1
1668304816922,ECE 200,023,103608,Lo; Yu-Hwa,9999,0,9999,0
1668304816922,ECE 200,024,103609,Lomakin; Vitaliy,9999,0,9999,0
1668304816922,ECE 200,025,103610,Mercier; Patrick Philip,9999,0,9999,0
1668304816922,ECE 200,026,103611,Meyer; Florian,9999,0,9999,0
1668304816922,ECE 200,027,103612,Milstein; Laurence B.,9999,0,9999,0
1668304816922,ECE 200,028,103613,Mir Arabbaygi; Siavash,9999,0,9999,0
1668304816922,ECE 200,029,103614,Mookherjea; Shayan,9999,0,9999,0
1668304816922,ECE 200,030,103615,Morris; Karcher William,9999,0,9999,0
1668304816922,ECE 200,031,103616,Ng; Tse Nga,9999,0,9999,0
1668304816922,ECE 200,032,103617,Nguyen; Truong Quang,9999,0,9999,0
1668304816922,ECE 200,033,103618,Nomura; Kenji,9999,0,9999,0
1668304816922,ECE 200,034,103619,Orlitsky; Alon,9999,0,9999,0
1668304816922,ECE 200,035,103620,Pal; Piya,9999,0,9999,0
1668304816922,ECE 200,036,103621,Papen; George C.,9999,0,9999,0
1668304816922,ECE 200,037,103622,Radic; Stojan,9999,0,9999,0
1668304816922,ECE 200,038,103623,Rao; Bhaskar D.,9999,0,9999,0
1668304816922,ECE 200,039,103624,Rao; Ramesh R,9999,0,9999,0
1668304816922,ECE 200,040,103625,Rebeiz; Gabriel,9999,0,9999,0
1668304816922,ECE 200,041,103626,Sanford; John R,9999,0,9999,0
1668304816922,ECE 200,042,103627,Siegel; Paul H.,9999,0,9999,0
1668304816922,ECE 200,043,103628,Sievenpiper; Daniel F.,9999,0,9999,0
1668304816922,ECE 200,044,103629,Sworder; David D.,9999,0,9999,0
1668304816922,ECE 200,045,103630,Taur; Yuan,9999,0,9999,0
1668304816922,ECE 200,046,103631,Touri; Behrouz,9999,0,9999,0
1668304816922,ECE 200,047,103632,Trivedi; Mohan M.,9999,0,9999,0
1668304816922,ECE 200,048,103633,Vasconcelos; Nuno,9999,0,9999,0
1668304816922,ECE 200,049,103634,Wang; Xiaolong,9999,0,9999,0
1668304816922,ECE 200,050,103635,Xie; Pengtao,9999,0,9999,0
1668304816922,ECE 200,051,103636,Yip; Michael,9999,0,9999,0
1668304816922,ECE 200,052,103637,Zeger; Kenneth A.,999,0,999,0
1668304816922,ECE 200,053,103638,Zhang; Xinyu,9999,0,9999,0
1668304816922,ECE 200,054,103639,Turakhia; Yatish Girish,9999,0,9999,0
1668304816922,ECE 200,055,103640,Kang; Mingu,9999,0,9999,0
1668304816922,ECE 200,056,103641,Shi; Yuanyuan,9999,0,9999,0
1668304816922,ECE 200,057,103642,Wang; Edward Jay,9999,0,9999,0
1668304816922,ECE 200,058,103643,Zheng; Yang,9999,0,9999,0
1668304817347,ECE 202,A00,103644,Kuzum; Duygu,0,0,0,0
1668304817773,ECE 212BN,A00,103646,Ng; Tse Nga,0,0,0,0
1668304818217,ECE 221,A00,111493,Staff,0,0,0,0
1668304818642,ECE 222B,A00,103647,Lomakin; Vitaliy,0,0,0,0
1668304819069,ECE 230B,A00,103648,Taur; Yuan,0,0,0,0
1668304819493,ECE 238B,A00,103649,Garay; Javier,0,0,0,0
1668304819921,ECE 240B,A00,112900,Fainman; Yeshaiahu,0,0,0,0
1668304820349,ECE 247A,A00,103650,Jokerst; Jesse Vincent,0,0,0,0
1668304820774,ECE 247B,A00,103651,Wang; Joseph,0,0,0,0
1668304821201,ECE 250,A00,103652,Siegel; Paul H.,0,0,0,0
1668304821627,ECE 251A,A00,103654,Rao; Bhaskar D.,0,0,0,0
1668304822050,ECE 257B,A00,103655,Bharadia; Dinesh,0,0,0,0
1668304822475,ECE 258A,A00,103656,Milstein; Laurence B.,0,0,0,0
1668304822901,ECE 260B,A00,103658,Kang; Mingu,0,0,0,0
1668304823328,ECE 264A,A00,103659,Galton; Ian A,0,0,0,0
1668304823752,ECE 265A,A00,103661,Gudem; Prasad S.S.,0,0,0,0
1668304824179,ECE 265D,A00,103662,Gudem; Prasad S.S.,0,0,0,0
1668304824606,ECE 268,A00,103663,Koushanfar; Farinaz,0,0,0,0
1668304825029,ECE 269,A01,103665,Pal; Piya,0,0,0,0
1668304825455,ECE 271B,A00,103666,Vasconcelos; Manuela,0,0,0,0
1668304825881,ECE 276A,A00,103667,Atanasov; Nikolay A.,0,0,0,0
1668304826307,ECE 277,A00,103668,An; Cheolhong,0,0,0,0
1668304826733,ECE 279,A00,117947,Hall; Drew A.,0,0,0,0
1668304827589,ECE 283,A00,103670,Hsueh; Tzu-Chien,0,0,0,0
1668304828012,ECE 284,A00,103671,Turakhia; Yatish Girish,0,0,0,0
1668304828441,ECE 285,A00,103672,Zheng; Yang,0,0,0,0
1668304828441,ECE 285,B00,103673,Sworder; David D.,0,0,0,0
1668304828868,ECE 287,A00,103676,Javidi; Tara,0,0,0,0
1668304829292,MATH 200B,A00,098023,Salehi Golsefidy; Alireza,12,0,15,3
1668304829721,MATH 202B,A00,098024,Rhoades; Brendon Patrick,9,0,15,6
1668304830157,MATH 203B,A00,098025,Oprea; Dragos N.,10,0,15,5
1668304830578,MATH 204B,A00,098026,Sorensen; Claus M,13,0,15,2
1668304831001,MATH 208,A00,098027,Izadi; Elham,7,0,10,3
1668304831428,MATH 209,A00,098028,Pollack; Aaron,10,0,10,0
1668304831851,MATH 211A,A00,112919,Rogalski; Daniel,9,0,10,1
1668304832278,MATH 211B,A00,112920,Seward; Brandon M.,9,0,10,1
1668304832701,MATH 218,A00,098029,Li; Bo,10,0,10,0
1668304833125,MATH 220B,A00,098030,Novak; Jonathan I,11,0,15,4
1668304833554,MATH 221A,A00,098031,Ebenfelt; Peter F,13,0,15,2
1668304834071,MATH 231B,A00,098032,Zlatos; Andrej,12,0,15,3
1668304834497,MATH 240B,A00,098033,Ni; Lei,9,0,15,6
1668304834931,MATH 243,A00,098034,Jekel; David Andrew,10,0,10,0
1668304835357,MATH 245A,A00,098035,Nie; Jiawang,0,0,15,16
1668304835785,MATH 248,A00,098036,Bejenaru; Ioan,10,0,10,0
1668304836213,MATH 250B,A00,098037,Spolaor; Luca,14,0,15,1
1668304836657,MATH 258,A00,098038,Ni; Lei,10,0,10,0
1668304837086,MATH 264B,A00,098041,Rhoades; Brendon Patrick,9,0,15,6
1668304837509,MATH 268,A00,098042,Buss; Samuel R,10,0,10,0
1668304837932,MATH 269,A00,098043,Rhoades; Brendon Patrick,10,0,10,0
1668304838357,MATH 270B,A00,098044,Li; Bo,10,0,15,5
1668304838785,MATH 272B,A00,098045,Holst; Michael J,13,0,15,2
1668304839209,MATH 273A,A00,098046,Tian; Xiaochuan,10,0,15,5
1668304839632,MATH 275,A01,098048,Tian; Xiaochuan,6,0,10,4
1668304840054,MATH 278A,A00,098049,Holst; Michael J,8,0,10,2
1668304840478,MATH 278B,A00,098050,Cloninger; Alexander,10,0,10,0
1668304840903,MATH 278C,A00,098051,Nie; Jiawang,7,0,10,3
1668304841329,MATH 280B,A00,098052,Zheng; Tianyi,8,0,15,7
1668304841754,MATH 281B,A00,098053,Bradic; Jelena,1,0,15,14
1668304842181,MATH 282B,A00,098054,Arias-Castro; Ery,0,0,15,15
1668304842603,MATH 285,A00,098055,Fitzsimmons; Patrick J,0,0,15,17
1668304843030,MATH 287B,A00,098056,Arias-Castro; Ery,2,0,15,13
1668304843456,MATH 288,A00,098057,Agarwal; Pooja,9,0,10,1
1668304843456,MATH 288,B00,098058,Zhang; Danna,8,0,10,2
1668304843456,MATH 288,C00,098059,Williams; Ruth J,9,0,10,1
1668304843886,MATH 290B,A00,098060,Roberts; Justin Deritter,13,0,15,2
1668304844308,MATH 292,A00,098061,Belmont; Eva Kinoshita,10,0,10,0
1668304844740,MATH 295,A00,098062,Suk; Andrew Hoon,48,0,50,2
1668304845163,MATH 296,A00,098063,Novak; Jonathan I,20,0,20,0
1668304845585,MATH 297,001,098064,Gamst; Anthony Collins,9997,0,9999,2
1668305344615,COGS 205,A00,101395,Chiba; Andrea,19,0,20,1
1668305345039,COGS 210B,001,101404,Greene; Deanna Jacquelyn,9998,0,9999,1
1668305345039,COGS 210B,002,101417,Xia; Haijun,9999,0,9999,0
1668305345039,COGS 210B,003,101422,Nitz; Douglas A.,9999,0,9999,0
1668305345039,COGS 210B,004,101423,Hollan; James D.,9998,0,9999,1
1668305345039,COGS 210B,005,101424,Deak; Gedeon O.,9998,0,9999,1
1668305345039,COGS 210B,006,101425,Rossano; Federico,9999,0,9999,0
1668305345466,COGS 211B,A00,101427,Coulson; Seana M,9996,0,9999,3
1668305345887,COGS 220,A00,101428,Hollan; James D.,0,0,25,25
1668305346310,COGS 229,A00,101429,Dow; Steven P,18,0,25,7
1668305346733,COGS 230,A00,101430,Klemmer; Scott R,12,0,17,5
1668305347157,COGS 234,A00,101431,Xia; Haijun,1,0,25,24
1668305347596,COGS 260,A00,101432,Kiyonaga; Anastasia,21,0,25,4
1668305347596,COGS 260,B00,101433,Kirsh; David Joel,15,0,25,10
1668305348022,CSE 202,A00,102371,Impagliazzo; Russell,0,0,0,0
1668305348449,CSE 203B,A01,102373,Cheng; Chung Kuan,0,0,0,0
1668305348872,CSE 208,A00,102374,Micciancio; Daniele,0,0,0,0
1668305349302,CSE 209A,A00,112895,Impagliazzo; Russell,0,0,15,15
1668305349727,CSE 209B,A00,108005,Bellare; Mihir,0,0,0,0
1668305350155,CSE 210,A00,113163,Coblenz; Michael J,0,0,0,0
1668305350581,CSE 219,A00,106111,Dow; Steven P,0,0,20,20
1668305351006,CSE 221,A00,102376,Voelker; Geoffrey M.,0,0,0,0
1668305351433,CSE 224,A01,102378,Porter; George M,0,0,0,0
1668305351857,CSE 229A,A00,102379,Savage; Stefan,0,0,0,0
1668305352280,CSE 229C,A00,102380,Munyaka; Imani N. S.,0,0,0,0
1668305352705,CSE 232B,A00,102382,Deutsch; Alin Bernard,0,0,0,0
1668305353225,CSE 234,A01,112904,Kumar; Arun Kumar,0,0,0,0
1668305353648,CSE 237A,A00,102383,Rosing; Tajana Simunic,0,0,0,0
1668305354070,CSE 239A,A00,102384,Deutsch; Alin Bernard,0,0,0,0
1668305354494,CSE 239B,A00,102385,Polikarpova; Nadezhda,0,0,0,0
1668305354930,CSE 240A,A00,102386,Pannuto; Patrick William,0,0,0,0
1668305355356,CSE 240B,A00,102387,Zhao; Jishen,0,0,0,0
1668305355779,CSE 241A,A00,106406,Kang; Mingu,0,0,0,0
1668305356203,CSE 249B,A00,102388,Kahng; Andrew Byun,0,0,8,8
1668305356629,CSE 251B,A01,102392,Cottrell; Garrison W,0,0,0,0
1668305356629,CSE 251B,A02,102393,Cottrell; Garrison W,0,0,0,0
1668305357051,CSE 252B,A00,102394,Ochoa; Benjamin Lawrence,0,0,0,0
1668305357478,CSE 257,A01,102396,Gao; Sicun,0,0,0,0
1668305357901,CSE 272,A00,102397,Li; Tzumao,0,0,0,0
1668305358328,CSE 274,A00,111323,Chern; Albert Ren-Haur,0,0,0,0
1668305358750,CSE 282,A00,102398,Pevzner; Pavel Arkadjevich,0,0,0,0
1668305359174,CSE 284,A00,114175,Gymrek; Melissa Ann,0,0,0,0
1668305359597,CSE 290,A00,102399,Chandraker; Manmohan Krishna,0,0,0,0
1668305359597,CSE 290,B00,102400,Vaccaro; Kristen Marie,0,0,25,25
1668305359597,CSE 290,C00,102414,Pannuto; Patrick William,0,0,25,25
1668305359597,CSE 290,D00,102427,Pevzner; Pavel Arkadjevich,0,0,0,0
1668305359597,CSE 290,E00,102429,Zhao; Jishen,0,0,0,0
1668305359597,CSE 290,F00,102436,Tullsen; Dean Michael,0,0,0,0
1668305359597,CSE 290,G00,102440,Christensen; Henrik I,0,0,20,20
1668305360021,CSE 291,A00,102443,Su; Hao,0,0,0,0
1668305360021,CSE 291,B00,102448,Polikarpova; Nadezhda,0,0,0,0
1668305360021,CSE 291,C00,102453,Vaccaro; Kristen Marie,0,0,0,0
1668305360021,CSE 291,D00,111343,Savage; Stefan,0,0,0,0
1668305360021,CSE 291,E00,116474,Claffy; Kimberly Claire,0,0,0,0
1668305360021,CSE 291,F00,116479,Pasquale; Joseph,0,0,0,0
1668305360455,CSE 293,001,119111,Bafna; Vineet,9999,0,9999,0
1668305360455,CSE 293,002,119118,Bellare; Mihir,9999,0,9999,0
1668305360455,CSE 293,003,119122,Berg-Kirkpatrick; Taylor D,9999,0,9999,0
1668305360455,CSE 293,004,119135,Christensen; Henrik I,9999,0,9999,0
1668305360455,CSE 293,005,119142,Cottrell; Garrison W,9999,0,9999,0
1668305360455,CSE 293,006,119146,Deutsch; Alin Bernard,9999,0,9999,0
1668305360455,CSE 293,007,119159,Esmaeilzadeh; Hadi,9999,0,9999,0
1668305360455,CSE 293,008,119166,Freund; Yoav,9999,0,9999,0
1668305360455,CSE 293,009,119170,Griswold; William G.,9999,0,9999,0
1668305360455,CSE 293,010,119183,Gymrek; Melissa Ann,9999,0,9999,0
1668305360455,CSE 293,011,119190,Heninger; Nadia A,9999,0,9999,0
1668305360455,CSE 293,012,119230,Impagliazzo; Russell,9999,0,9999,0
1668305360455,CSE 293,013,119232,Jhala; Ranjit,9999,0,9999,0
1668305360455,CSE 293,014,119233,Kahng; Andrew Byun,9999,0,9999,0
1668305360455,CSE 293,015,119298,Kane; Daniel Mertz,9999,0,9999,0
1668305360455,CSE 293,016,119299,Kriegman; David J,9999,0,9999,0
1668305360455,CSE 293,017,119300,Kumar; Arun Kumar,9999,0,9999,0
1668305360455,CSE 293,018,119301,Lerner; Sorin,9999,0,9999,0
1668305360455,CSE 293,019,119302,Lovett; Shachar,9999,0,9999,0
1668305360455,CSE 293,020,119303,McAuley; Julian John,9999,0,9999,0
1668305360455,CSE 293,021,119304,Micciancio; Daniele,9999,0,9999,0
1668305360455,CSE 293,022,119367,Orailoglu; Alex,9999,0,9999,0
1668305360455,CSE 293,023,119382,Paturi; Ramamohan,9999,0,9999,0
1668305360455,CSE 293,024,119404,Polikarpova; Nadezhda,9999,0,9999,0
1668305360455,CSE 293,025,119406,Politz; Joseph Gibbs,9999,0,9999,0
1668305360455,CSE 293,026,119411,Porter; George M,9999,0,9999,0
1668305360455,CSE 293,027,119414,Porter; Leonard Emerson,9999,0,9999,0
1668305360455,CSE 293,028,119416,Ramamoorthi; Ravi,9999,0,9999,0
1668305360455,CSE 293,029,119417,Sahoo; Debashis,9999,0,9999,0
1668305360455,CSE 293,030,119420,Saul; Lawrence,9999,0,9999,0
1668305360455,CSE 293,031,119421,Savage; Stefan,9999,0,9999,0
1668305360455,CSE 293,032,119425,Schulze; Jurgen P.,9999,0,9999,0
1668305360455,CSE 293,033,119426,Snoeren; Alex C.,9999,0,9999,0
1668305360455,CSE 293,034,119428,Shang; Jingbo,9999,0,9999,0
1668305360455,CSE 293,035,119430,Stefan; Deian,9999,0,9999,0
1668305360455,CSE 293,036,119431,Su; Hao,9999,0,9999,0
1668305360455,CSE 293,037,119433,Swanson; Steven James,9999,0,9999,0
1668305360455,CSE 293,038,119435,Tullsen; Dean Michael,9999,0,9999,0
1668305360455,CSE 293,039,119483,Voelker; Geoffrey M.,9999,0,9999,0
1668305360455,CSE 293,040,119537,Zhao; Jishen,9999,0,9999,0
1668305360455,CSE 293,041,119538,Zhou; Yuan-Yuan,9999,0,9999,0
1668305360455,CSE 293,042,119539,Gao; Sicun,9999,0,9999,0
1668305360455,CSE 293,043,119540,Weibel; Nadir,9999,0,9999,0
1668305360455,CSE 293,044,119541,Gupta; Rajesh K.,9999,0,9999,0
1668305360455,CSE 293,045,126410,Vaccaro; Kristen Marie,9999,0,9999,0
1668305360455,CSE 293,046,126411,Klemke; Richard,9999,0,9999,0
1668305360881,CSE 294,A00,102459,Voelker; Geoffrey M.,0,0,0,0
1668305360881,CSE 294,B00,111322,Orailoglu; Alex,0,0,0,0
1668305361303,DSE 201,A00,096914,Deutsch; Alin Bernard,30,0,30,0
1668305361725,DSE 210,A00,096915,Dasgupta; Sanjoy,30,0,30,0
1668305362147,DSE 260A,A00,096916,Altintas De Callaf; Ilkay,30,0,30,0
1668305362586,ECE 200,001,103586,Antipa; Nicholas A,9999,0,9999,0
1668305362586,ECE 200,002,103587,Atanasov; Nikolay A.,9999,0,9999,0
1668305362586,ECE 200,003,103588,Bharadia; Dinesh,9999,0,9999,0
1668305362586,ECE 200,004,103589,Cheng; Chung Kuan,9999,0,9999,0
1668305362586,ECE 200,005,103590,Cosman; Pamela C.,9999,0,9999,0
1668305362586,ECE 200,006,103591,Dayeh; Shadi Ahmad,9999,0,9999,0
1668305362586,ECE 200,007,103592,Fainman; Yeshaiahu,9999,0,9999,0
1668305362586,ECE 200,008,103593,Ford; Joseph Earl,9999,0,9999,0
1668305362586,ECE 200,009,103594,Franceschetti; Massimo,9999,0,9999,0
1668305362586,ECE 200,010,103595,Fullerton; Eric E,9999,0,9999,0
1668305362586,ECE 200,011,103596,Galton; Ian A,9999,0,9999,0
1668305362586,ECE 200,012,103597,Gilja; Vikash,9999,0,9999,0
1668305362586,ECE 200,013,103598,Hall; Drew A.,9999,0,9999,0
1668305362586,ECE 200,014,103599,Hsueh; Tzu-Chien,9999,0,9999,0
1668305362586,ECE 200,015,103600,Javidi; Tara,9999,0,9999,0
1668305362586,ECE 200,016,103601,Kahng; Andrew Byun,9999,0,9999,0
1668305362586,ECE 200,017,103602,Kim; Young-Han,9999,0,9999,0
1668305362586,ECE 200,018,103603,Koushanfar; Farinaz,9999,0,9999,0
1668305362586,ECE 200,019,103604,Kuzum; Duygu,9999,0,9999,0
1668305362586,ECE 200,020,103605,Le; Hanh-Phuc,9999,0,9999,0
1668305362586,ECE 200,021,103606,Lin; Bill,9999,0,9999,0
1668305362586,ECE 200,022,103607,Liu; Zhaowei,9998,0,9999,1
1668305362586,ECE 200,023,103608,Lo; Yu-Hwa,9999,0,9999,0
1668305362586,ECE 200,024,103609,Lomakin; Vitaliy,9999,0,9999,0
1668305362586,ECE 200,025,103610,Mercier; Patrick Philip,9999,0,9999,0
1668305362586,ECE 200,026,103611,Meyer; Florian,9999,0,9999,0
1668305362586,ECE 200,027,103612,Milstein; Laurence B.,9999,0,9999,0
1668305362586,ECE 200,028,103613,Mir Arabbaygi; Siavash,9999,0,9999,0
1668305362586,ECE 200,029,103614,Mookherjea; Shayan,9999,0,9999,0
1668305362586,ECE 200,030,103615,Morris; Karcher William,9999,0,9999,0
1668305362586,ECE 200,031,103616,Ng; Tse Nga,9999,0,9999,0
1668305362586,ECE 200,032,103617,Nguyen; Truong Quang,9999,0,9999,0
1668305362586,ECE 200,033,103618,Nomura; Kenji,9999,0,9999,0
1668305362586,ECE 200,034,103619,Orlitsky; Alon,9999,0,9999,0
1668305362586,ECE 200,035,103620,Pal; Piya,9999,0,9999,0
1668305362586,ECE 200,036,103621,Papen; George C.,9999,0,9999,0
1668305362586,ECE 200,037,103622,Radic; Stojan,9999,0,9999,0
1668305362586,ECE 200,038,103623,Rao; Bhaskar D.,9999,0,9999,0
1668305362586,ECE 200,039,103624,Rao; Ramesh R,9999,0,9999,0
1668305362586,ECE 200,040,103625,Rebeiz; Gabriel,9999,0,9999,0
1668305362586,ECE 200,041,103626,Sanford; John R,9999,0,9999,0
1668305362586,ECE 200,042,103627,Siegel; Paul H.,9999,0,9999,0
1668305362586,ECE 200,043,103628,Sievenpiper; Daniel F.,9999,0,9999,0
1668305362586,ECE 200,044,103629,Sworder; David D.,9999,0,9999,0
1668305362586,ECE 200,045,103630,Taur; Yuan,9999,0,9999,0
1668305362586,ECE 200,046,103631,Touri; Behrouz,9999,0,9999,0
1668305362586,ECE 200,047,103632,Trivedi; Mohan M.,9999,0,9999,0
1668305362586,ECE 200,048,103633,Vasconcelos; Nuno,9999,0,9999,0
1668305362586,ECE 200,049,103634,Wang; Xiaolong,9999,0,9999,0
1668305362586,ECE 200,050,103635,Xie; Pengtao,9999,0,9999,0
1668305362586,ECE 200,051,103636,Yip; Michael,9999,0,9999,0
1668305362586,ECE 200,052,103637,Zeger; Kenneth A.,999,0,999,0
1668305362586,ECE 200,053,103638,Zhang; Xinyu,9999,0,9999,0
1668305362586,ECE 200,054,103639,Turakhia; Yatish Girish,9999,0,9999,0
1668305362586,ECE 200,055,103640,Kang; Mingu,9999,0,9999,0
1668305362586,ECE 200,056,103641,Shi; Yuanyuan,9999,0,9999,0
1668305362586,ECE 200,057,103642,Wang; Edward Jay,9999,0,9999,0
1668305362586,ECE 200,058,103643,Zheng; Yang,9999,0,9999,0
1668305363011,ECE 202,A00,103644,Kuzum; Duygu,0,0,0,0
1668305363434,ECE 212BN,A00,103646,Ng; Tse Nga,0,0,0,0
1668305363858,ECE 221,A00,111493,Staff,0,0,0,0
1668305364285,ECE 222B,A00,103647,Lomakin; Vitaliy,0,0,0,0
1668305364709,ECE 230B,A00,103648,Taur; Yuan,0,0,0,0
1668305365136,ECE 238B,A00,103649,Garay; Javier,0,0,0,0
1668305365567,ECE 240B,A00,112900,Fainman; Yeshaiahu,0,0,0,0
1668305365993,ECE 247A,A00,103650,Jokerst; Jesse Vincent,0,0,0,0
1668305366415,ECE 247B,A00,103651,Wang; Joseph,0,0,0,0
1668305366837,ECE 250,A00,103652,Siegel; Paul H.,0,0,0,0
1668305367259,ECE 251A,A00,103654,Rao; Bhaskar D.,0,0,0,0
1668305367682,ECE 257B,A00,103655,Bharadia; Dinesh,0,0,0,0
1668305368105,ECE 258A,A00,103656,Milstein; Laurence B.,0,0,0,0
1668305368529,ECE 260B,A00,103658,Kang; Mingu,0,0,0,0
1668305368961,ECE 264A,A00,103659,Galton; Ian A,0,0,0,0
1668305369387,ECE 265A,A00,103661,Gudem; Prasad S.S.,0,0,0,0
1668305369819,ECE 265D,A00,103662,Gudem; Prasad S.S.,0,0,0,0
1668305370244,ECE 268,A00,103663,Koushanfar; Farinaz,0,0,0,0
1668305370671,ECE 269,A01,103665,Pal; Piya,0,0,0,0
1668305371093,ECE 271B,A00,103666,Vasconcelos; Manuela,0,0,0,0
1668305371519,ECE 276A,A00,103667,Atanasov; Nikolay A.,0,0,0,0
1668305371941,ECE 277,A00,103668,An; Cheolhong,0,0,0,0
1668305372363,ECE 279,A00,117947,Hall; Drew A.,0,0,0,0
1668305373223,ECE 283,A00,103670,Hsueh; Tzu-Chien,0,0,0,0
1668305373649,ECE 284,A00,103671,Turakhia; Yatish Girish,0,0,0,0
1668305374072,ECE 285,A00,103672,Zheng; Yang,0,0,0,0
1668305374072,ECE 285,B00,103673,Sworder; David D.,0,0,0,0
1668305374495,ECE 287,A00,103676,Javidi; Tara,0,0,0,0
1668305374922,MATH 200B,A00,098023,Salehi Golsefidy; Alireza,12,0,15,3
1668305375346,MATH 202B,A00,098024,Rhoades; Brendon Patrick,9,0,15,6
1668305375776,MATH 203B,A00,098025,Oprea; Dragos N.,10,0,15,5
1668305376199,MATH 204B,A00,098026,Sorensen; Claus M,13,0,15,2
1668305376621,MATH 208,A00,098027,Izadi; Elham,7,0,10,3
1668305377046,MATH 209,A00,098028,Pollack; Aaron,10,0,10,0
1668305377469,MATH 211A,A00,112919,Rogalski; Daniel,9,0,10,1
1668305377894,MATH 211B,A00,112920,Seward; Brandon M.,9,0,10,1
1668305378319,MATH 218,A00,098029,Li; Bo,10,0,10,0
1668305378743,MATH 220B,A00,098030,Novak; Jonathan I,11,0,15,4
1668305379190,MATH 221A,A00,098031,Ebenfelt; Peter F,13,0,15,2
1668305379614,MATH 231B,A00,098032,Zlatos; Andrej,12,0,15,3
1668305380040,MATH 240B,A00,098033,Ni; Lei,9,0,15,6
1668305380463,MATH 243,A00,098034,Jekel; David Andrew,10,0,10,0
1668305380888,MATH 245A,A00,098035,Nie; Jiawang,0,0,15,16
1668305381311,MATH 248,A00,098036,Bejenaru; Ioan,10,0,10,0
1668305381736,MATH 250B,A00,098037,Spolaor; Luca,14,0,15,1
1668305382160,MATH 258,A00,098038,Ni; Lei,10,0,10,0
1668305382588,MATH 264B,A00,098041,Rhoades; Brendon Patrick,9,0,15,6
1668305383014,MATH 268,A00,098042,Buss; Samuel R,10,0,10,0
1668305383438,MATH 269,A00,098043,Rhoades; Brendon Patrick,10,0,10,0
1668305383861,MATH 270B,A00,098044,Li; Bo,10,0,15,5
1668305384285,MATH 272B,A00,098045,Holst; Michael J,13,0,15,2
1668305384709,MATH 273A,A00,098046,Tian; Xiaochuan,10,0,15,5
1668305385138,MATH 275,A01,098048,Tian; Xiaochuan,6,0,10,4
1668305385562,MATH 278A,A00,098049,Holst; Michael J,8,0,10,2
1668305385985,MATH 278B,A00,098050,Cloninger; Alexander,10,0,10,0
1668305386407,MATH 278C,A00,098051,Nie; Jiawang,7,0,10,3
1668305386834,MATH 280B,A00,098052,Zheng; Tianyi,8,0,15,7
1668305387260,MATH 281B,A00,098053,Bradic; Jelena,1,0,15,14
1668305387690,MATH 282B,A00,098054,Arias-Castro; Ery,0,0,15,15
1668305388114,MATH 285,A00,098055,Fitzsimmons; Patrick J,0,0,15,17
1668305388551,MATH 287B,A00,098056,Arias-Castro; Ery,2,0,15,13
1668305388986,MATH 288,A00,098057,Agarwal; Pooja,9,0,10,1
1668305388986,MATH 288,B00,098058,Zhang; Danna,8,0,10,2
1668305388986,MATH 288,C00,098059,Williams; Ruth J,9,0,10,1
1668305389408,MATH 290B,A00,098060,Roberts; Justin Deritter,13,0,15,2
1668305389843,MATH 292,A00,098061,Belmont; Eva Kinoshita,10,0,10,0
1668305390270,MATH 295,A00,098062,Suk; Andrew Hoon,48,0,50,2
1668305390695,MATH 296,A00,098063,Novak; Jonathan I,20,0,20,0
1668305391119,MATH 297,001,098064,Gamst; Anthony Collins,9997,0,9999,2
1668305889908,COGS 205,A00,101395,Chiba; Andrea,19,0,20,1
1668305890333,COGS 210B,001,101404,Greene; Deanna Jacquelyn,9998,0,9999,1
1668305890333,COGS 210B,002,101417,Xia; Haijun,9999,0,9999,0
1668305890333,COGS 210B,003,101422,Nitz; Douglas A.,9999,0,9999,0
1668305890333,COGS 210B,004,101423,Hollan; James D.,9998,0,9999,1
1668305890333,COGS 210B,005,101424,Deak; Gedeon O.,9998,0,9999,1
1668305890333,COGS 210B,006,101425,Rossano; Federico,9999,0,9999,0
1668305890757,COGS 211B,A00,101427,Coulson; Seana M,9996,0,9999,3
1668305891184,COGS 220,A00,101428,Hollan; James D.,0,0,25,25
1668305891609,COGS 229,A00,101429,Dow; Steven P,18,0,25,7
1668305892033,COGS 230,A00,101430,Klemmer; Scott R,12,0,17,5
1668305892455,COGS 234,A00,101431,Xia; Haijun,1,0,25,24
1668305892879,COGS 260,A00,101432,Kiyonaga; Anastasia,21,0,25,4
1668305892879,COGS 260,B00,101433,Kirsh; David Joel,15,0,25,10
1668305893309,CSE 202,A00,102371,Impagliazzo; Russell,0,0,0,0
1668305893734,CSE 203B,A01,102373,Cheng; Chung Kuan,0,0,0,0
1668305894158,CSE 208,A00,102374,Micciancio; Daniele,0,0,0,0
1668305894582,CSE 209A,A00,112895,Impagliazzo; Russell,0,0,15,15
1668305895005,CSE 209B,A00,108005,Bellare; Mihir,0,0,0,0
1668305895432,CSE 210,A00,113163,Coblenz; Michael J,0,0,0,0
1668305895855,CSE 219,A00,106111,Dow; Steven P,0,0,20,20
1668305896282,CSE 221,A00,102376,Voelker; Geoffrey M.,0,0,0,0
1668305896705,CSE 224,A01,102378,Porter; George M,0,0,0,0
1668305897130,CSE 229A,A00,102379,Savage; Stefan,0,0,0,0
1668305897555,CSE 229C,A00,102380,Munyaka; Imani N. S.,0,0,0,0
1668305897981,CSE 232B,A00,102382,Deutsch; Alin Bernard,0,0,0,0
1668305898410,CSE 234,A01,112904,Kumar; Arun Kumar,0,0,0,0
1668305898835,CSE 237A,A00,102383,Rosing; Tajana Simunic,0,0,0,0
1668305899263,CSE 239A,A00,102384,Deutsch; Alin Bernard,0,0,0,0
1668305899687,CSE 239B,A00,102385,Polikarpova; Nadezhda,0,0,0,0
1668305900123,CSE 240A,A00,102386,Pannuto; Patrick William,0,0,0,0
1668305900547,CSE 240B,A00,102387,Zhao; Jishen,0,0,0,0
1668305900972,CSE 241A,A00,106406,Kang; Mingu,0,0,0,0
1668305901402,CSE 249B,A00,102388,Kahng; Andrew Byun,0,0,8,8
1668305901838,CSE 251B,A01,102392,Cottrell; Garrison W,0,0,0,0
1668305901838,CSE 251B,A02,102393,Cottrell; Garrison W,0,0,0,0
1668305902269,CSE 252B,A00,102394,Ochoa; Benjamin Lawrence,0,0,0,0
1668305902694,CSE 257,A01,102396,Gao; Sicun,0,0,0,0
1668305903132,CSE 272,A00,102397,Li; Tzumao,0,0,0,0
1668305903556,CSE 274,A00,111323,Chern; Albert Ren-Haur,0,0,0,0
1668305903979,CSE 282,A00,102398,Pevzner; Pavel Arkadjevich,0,0,0,0
1668305904402,CSE 284,A00,114175,Gymrek; Melissa Ann,0,0,0,0
1668305904827,CSE 290,A00,102399,Chandraker; Manmohan Krishna,0,0,0,0
1668305904827,CSE 290,B00,102400,Vaccaro; Kristen Marie,0,0,25,25
1668305904827,CSE 290,C00,102414,Pannuto; Patrick William,0,0,25,25
1668305904827,CSE 290,D00,102427,Pevzner; Pavel Arkadjevich,0,0,0,0
1668305904827,CSE 290,E00,102429,Zhao; Jishen,0,0,0,0
1668305904827,CSE 290,F00,102436,Tullsen; Dean Michael,0,0,0,0
1668305904827,CSE 290,G00,102440,Christensen; Henrik I,0,0,20,20
1668305905252,CSE 291,A00,102443,Su; Hao,0,0,0,0
1668305905252,CSE 291,B00,102448,Polikarpova; Nadezhda,0,0,0,0
1668305905252,CSE 291,C00,102453,Vaccaro; Kristen Marie,0,0,0,0
1668305905252,CSE 291,D00,111343,Savage; Stefan,0,0,0,0
1668305905252,CSE 291,E00,116474,Claffy; Kimberly Claire,0,0,0,0
1668305905252,CSE 291,F00,116479,Pasquale; Joseph,0,0,0,0
1668305905689,CSE 293,001,119111,Bafna; Vineet,9999,0,9999,0
1668305905689,CSE 293,002,119118,Bellare; Mihir,9999,0,9999,0
1668305905689,CSE 293,003,119122,Berg-Kirkpatrick; Taylor D,9999,0,9999,0
1668305905689,CSE 293,004,119135,Christensen; Henrik I,9999,0,9999,0
1668305905689,CSE 293,005,119142,Cottrell; Garrison W,9999,0,9999,0
1668305905689,CSE 293,006,119146,Deutsch; Alin Bernard,9999,0,9999,0
1668305905689,CSE 293,007,119159,Esmaeilzadeh; Hadi,9999,0,9999,0
1668305905689,CSE 293,008,119166,Freund; Yoav,9999,0,9999,0
1668305905689,CSE 293,009,119170,Griswold; William G.,9999,0,9999,0
1668305905689,CSE 293,010,119183,Gymrek; Melissa Ann,9999,0,9999,0
1668305905689,CSE 293,011,119190,Heninger; Nadia A,9999,0,9999,0
1668305905689,CSE 293,012,119230,Impagliazzo; Russell,9999,0,9999,0
1668305905689,CSE 293,013,119232,Jhala; Ranjit,9999,0,9999,0
1668305905689,CSE 293,014,119233,Kahng; Andrew Byun,9999,0,9999,0
1668305905689,CSE 293,015,119298,Kane; Daniel Mertz,9999,0,9999,0
1668305905689,CSE 293,016,119299,Kriegman; David J,9999,0,9999,0
1668305905689,CSE 293,017,119300,Kumar; Arun Kumar,9999,0,9999,0
1668305905689,CSE 293,018,119301,Lerner; Sorin,9999,0,9999,0
1668305905689,CSE 293,019,119302,Lovett; Shachar,9999,0,9999,0
1668305905689,CSE 293,020,119303,McAuley; Julian John,9999,0,9999,0
1668305905689,CSE 293,021,119304,Micciancio; Daniele,9999,0,9999,0
1668305905689,CSE 293,022,119367,Orailoglu; Alex,9999,0,9999,0
1668305905689,CSE 293,023,119382,Paturi; Ramamohan,9999,0,9999,0
1668305905689,CSE 293,024,119404,Polikarpova; Nadezhda,9999,0,9999,0
1668305905689,CSE 293,025,119406,Politz; Joseph Gibbs,9999,0,9999,0
1668305905689,CSE 293,026,119411,Porter; George M,9999,0,9999,0
1668305905689,CSE 293,027,119414,Porter; Leonard Emerson,9999,0,9999,0
1668305905689,CSE 293,028,119416,Ramamoorthi; Ravi,9999,0,9999,0
1668305905689,CSE 293,029,119417,Sahoo; Debashis,9999,0,9999,0
1668305905689,CSE 293,030,119420,Saul; Lawrence,9999,0,9999,0
1668305905689,CSE 293,031,119421,Savage; Stefan,9999,0,9999,0
1668305905689,CSE 293,032,119425,Schulze; Jurgen P.,9999,0,9999,0
1668305905689,CSE 293,033,119426,Snoeren; Alex C.,9999,0,9999,0
1668305905689,CSE 293,034,119428,Shang; Jingbo,9999,0,9999,0
1668305905689,CSE 293,035,119430,Stefan; Deian,9999,0,9999,0
1668305905689,CSE 293,036,119431,Su; Hao,9999,0,9999,0
1668305905689,CSE 293,037,119433,Swanson; Steven James,9999,0,9999,0
1668305905689,CSE 293,038,119435,Tullsen; Dean Michael,9999,0,9999,0
1668305905689,CSE 293,039,119483,Voelker; Geoffrey M.,9999,0,9999,0
1668305905689,CSE 293,040,119537,Zhao; Jishen,9999,0,9999,0
1668305905689,CSE 293,041,119538,Zhou; Yuan-Yuan,9999,0,9999,0
1668305905689,CSE 293,042,119539,Gao; Sicun,9999,0,9999,0
1668305905689,CSE 293,043,119540,Weibel; Nadir,9999,0,9999,0
1668305905689,CSE 293,044,119541,Gupta; Rajesh K.,9999,0,9999,0
1668305905689,CSE 293,045,126410,Vaccaro; Kristen Marie,9999,0,9999,0
1668305905689,CSE 293,046,126411,Klemke; Richard,9999,0,9999,0
1668305906115,CSE 294,A00,102459,Voelker; Geoffrey M.,0,0,0,0
1668305906115,CSE 294,B00,111322,Orailoglu; Alex,0,0,0,0
1668305906547,DSE 201,A00,096914,Deutsch; Alin Bernard,30,0,30,0
1668305906974,DSE 210,A00,096915,Dasgupta; Sanjoy,30,0,30,0
1668305907401,DSE 260A,A00,096916,Altintas De Callaf; Ilkay,30,0,30,0
1668305907838,ECE 200,001,103586,Antipa; Nicholas A,9999,0,9999,0
1668305907838,ECE 200,002,103587,Atanasov; Nikolay A.,9999,0,9999,0
1668305907838,ECE 200,003,103588,Bharadia; Dinesh,9999,0,9999,0
1668305907838,ECE 200,004,103589,Cheng; Chung Kuan,9999,0,9999,0
1668305907838,ECE 200,005,103590,Cosman; Pamela C.,9999,0,9999,0
1668305907838,ECE 200,006,103591,Dayeh; Shadi Ahmad,9999,0,9999,0
1668305907838,ECE 200,007,103592,Fainman; Yeshaiahu,9999,0,9999,0
1668305907838,ECE 200,008,103593,Ford; Joseph Earl,9999,0,9999,0
1668305907838,ECE 200,009,103594,Franceschetti; Massimo,9999,0,9999,0
1668305907838,ECE 200,010,103595,Fullerton; Eric E,9999,0,9999,0
1668305907838,ECE 200,011,103596,Galton; Ian A,9999,0,9999,0
1668305907838,ECE 200,012,103597,Gilja; Vikash,9999,0,9999,0
1668305907838,ECE 200,013,103598,Hall; Drew A.,9999,0,9999,0
1668305907838,ECE 200,014,103599,Hsueh; Tzu-Chien,9999,0,9999,0
1668305907838,ECE 200,015,103600,Javidi; Tara,9999,0,9999,0
1668305907838,ECE 200,016,103601,Kahng; Andrew Byun,9999,0,9999,0
1668305907838,ECE 200,017,103602,Kim; Young-Han,9999,0,9999,0
1668305907838,ECE 200,018,103603,Koushanfar; Farinaz,9999,0,9999,0
1668305907838,ECE 200,019,103604,Kuzum; Duygu,9999,0,9999,0
1668305907838,ECE 200,020,103605,Le; Hanh-Phuc,9999,0,9999,0
1668305907838,ECE 200,021,103606,Lin; Bill,9999,0,9999,0
1668305907838,ECE 200,022,103607,Liu; Zhaowei,9998,0,9999,1
1668305907838,ECE 200,023,103608,Lo; Yu-Hwa,9999,0,9999,0
1668305907838,ECE 200,024,103609,Lomakin; Vitaliy,9999,0,9999,0
1668305907838,ECE 200,025,103610,Mercier; Patrick Philip,9999,0,9999,0
1668305907838,ECE 200,026,103611,Meyer; Florian,9999,0,9999,0
1668305907838,ECE 200,027,103612,Milstein; Laurence B.,9999,0,9999,0
1668305907838,ECE 200,028,103613,Mir Arabbaygi; Siavash,9999,0,9999,0
1668305907838,ECE 200,029,103614,Mookherjea; Shayan,9999,0,9999,0
1668305907838,ECE 200,030,103615,Morris; Karcher William,9999,0,9999,0
1668305907838,ECE 200,031,103616,Ng; Tse Nga,9999,0,9999,0
1668305907838,ECE 200,032,103617,Nguyen; Truong Quang,9999,0,9999,0
1668305907838,ECE 200,033,103618,Nomura; Kenji,9999,0,9999,0
1668305907838,ECE 200,034,103619,Orlitsky; Alon,9999,0,9999,0
1668305907838,ECE 200,035,103620,Pal; Piya,9999,0,9999,0
1668305907838,ECE 200,036,103621,Papen; George C.,9999,0,9999,0
1668305907838,ECE 200,037,103622,Radic; Stojan,9999,0,9999,0
1668305907838,ECE 200,038,103623,Rao; Bhaskar D.,9999,0,9999,0
1668305907838,ECE 200,039,103624,Rao; Ramesh R,9999,0,9999,0
1668305907838,ECE 200,040,103625,Rebeiz; Gabriel,9999,0,9999,0
1668305907838,ECE 200,041,103626,Sanford; John R,9999,0,9999,0
1668305907838,ECE 200,042,103627,Siegel; Paul H.,9999,0,9999,0
1668305907838,ECE 200,043,103628,Sievenpiper; Daniel F.,9999,0,9999,0
1668305907838,ECE 200,044,103629,Sworder; David D.,9999,0,9999,0
1668305907838,ECE 200,045,103630,Taur; Yuan,9999,0,9999,0
1668305907838,ECE 200,046,103631,Touri; Behrouz,9999,0,9999,0
1668305907838,ECE 200,047,103632,Trivedi; Mohan M.,9999,0,9999,0
1668305907838,ECE 200,048,103633,Vasconcelos; Nuno,9999,0,9999,0
1668305907838,ECE 200,049,103634,Wang; Xiaolong,9999,0,9999,0
1668305907838,ECE 200,050,103635,Xie; Pengtao,9999,0,9999,0
1668305907838,ECE 200,051,103636,Yip; Michael,9999,0,9999,0
1668305907838,ECE 200,052,103637,Zeger; Kenneth A.,999,0,999,0
1668305907838,ECE 200,053,103638,Zhang; Xinyu,9999,0,9999,0
1668305907838,ECE 200,054,103639,Turakhia; Yatish Girish,9999,0,9999,0
1668305907838,ECE 200,055,103640,Kang; Mingu,9999,0,9999,0
1668305907838,ECE 200,056,103641,Shi; Yuanyuan,9999,0,9999,0
1668305907838,ECE 200,057,103642,Wang; Edward Jay,9999,0,9999,0
1668305907838,ECE 200,058,103643,Zheng; Yang,9999,0,9999,0
1668305908263,ECE 202,A00,103644,Kuzum; Duygu,0,0,0,0
1668305908689,ECE 212BN,A00,103646,Ng; Tse Nga,0,0,0,0
1668305909113,ECE 221,A00,111493,Staff,0,0,0,0
1668305909536,ECE 222B,A00,103647,Lomakin; Vitaliy,0,0,0,0
1668305909958,ECE 230B,A00,103648,Taur; Yuan,0,0,0,0
1668305910389,ECE 238B,A00,103649,Garay; Javier,0,0,0,0
1668305910820,ECE 240B,A00,112900,Fainman; Yeshaiahu,0,0,0,0
1668305911246,ECE 247A,A00,103650,Jokerst; Jesse Vincent,0,0,0,0
1668305911672,ECE 247B,A00,103651,Wang; Joseph,0,0,0,0
1668305912096,ECE 250,A00,103652,Siegel; Paul H.,0,0,0,0
1668305912525,ECE 251A,A00,103654,Rao; Bhaskar D.,0,0,0,0
1668305912950,ECE 257B,A00,103655,Bharadia; Dinesh,0,0,0,0
1668305913375,ECE 258A,A00,103656,Milstein; Laurence B.,0,0,0,0
1668305913808,ECE 260B,A00,103658,Kang; Mingu,0,0,0,0
1668305914234,ECE 264A,A00,103659,Galton; Ian A,0,0,0,0
1668305914661,ECE 265A,A00,103661,Gudem; Prasad S.S.,0,0,0,0
1668305915164,ECE 265D,A00,103662,Gudem; Prasad S.S.,0,0,0,0
1668305915595,ECE 268,A00,103663,Koushanfar; Farinaz,0,0,0,0
1668305916022,ECE 269,A01,103665,Pal; Piya,0,0,0,0
1668305916447,ECE 271B,A00,103666,Vasconcelos; Manuela,0,0,0,0
1668305916872,ECE 276A,A00,103667,Atanasov; Nikolay A.,0,0,0,0
1668305917299,ECE 277,A00,103668,An; Cheolhong,0,0,0,0
1668305917722,ECE 279,A00,117947,Hall; Drew A.,0,0,0,0
1668305918570,ECE 283,A00,103670,Hsueh; Tzu-Chien,0,0,0,0
1668305918996,ECE 284,A00,103671,Turakhia; Yatish Girish,0,0,0,0
1668305919421,ECE 285,A00,103672,Zheng; Yang,0,0,0,0
1668305919421,ECE 285,B00,103673,Sworder; David D.,0,0,0,0
1668305919846,ECE 287,A00,103676,Javidi; Tara,0,0,0,0
1668305920275,MATH 200B,A00,098023,Salehi Golsefidy; Alireza,12,0,15,3
1668305920699,MATH 202B,A00,098024,Rhoades; Brendon Patrick,9,0,15,6
1668305921128,MATH 203B,A00,098025,Oprea; Dragos N.,10,0,15,5
1668305921557,MATH 204B,A00,098026,Sorensen; Claus M,13,0,15,2
1668305921979,MATH 208,A00,098027,Izadi; Elham,7,0,10,3
1668305922403,MATH 209,A00,098028,Pollack; Aaron,10,0,10,0
1668305922834,MATH 211A,A00,112919,Rogalski; Daniel,9,0,10,1
1668305923257,MATH 211B,A00,112920,Seward; Brandon M.,9,0,10,1
1668305923679,MATH 218,A00,098029,Li; Bo,10,0,10,0
1668305924103,MATH 220B,A00,098030,Novak; Jonathan I,11,0,15,4
1668305924527,MATH 221A,A00,098031,Ebenfelt; Peter F,13,0,15,2
1668305924950,MATH 231B,A00,098032,Zlatos; Andrej,12,0,15,3
1668305925373,MATH 240B,A00,098033,Ni; Lei,9,0,15,6
1668305925796,MATH 243,A00,098034,Jekel; David Andrew,10,0,10,0
1668305926222,MATH 245A,A00,098035,Nie; Jiawang,0,0,15,16
1668305926651,MATH 248,A00,098036,Bejenaru; Ioan,10,0,10,0
1668305927075,MATH 250B,A00,098037,Spolaor; Luca,14,0,15,1
1668305927499,MATH 258,A00,098038,Ni; Lei,10,0,10,0
1668305927922,MATH 264B,A00,098041,Rhoades; Brendon Patrick,9,0,15,6
1668305928345,MATH 268,A00,098042,Buss; Samuel R,10,0,10,0
1668305928768,MATH 269,A00,098043,Rhoades; Brendon Patrick,10,0,10,0
1668305929194,MATH 270B,A00,098044,Li; Bo,10,0,15,5
1668305929619,MATH 272B,A00,098045,Holst; Michael J,13,0,15,2
1668305930045,MATH 273A,A00,098046,Tian; Xiaochuan,10,0,15,5
1668305930476,MATH 275,A01,098048,Tian; Xiaochuan,6,0,10,4
1668305930903,MATH 278A,A00,098049,Holst; Michael J,8,0,10,2
1668305931329,MATH 278B,A00,098050,Cloninger; Alexander,10,0,10,0
1668305931752,MATH 278C,A00,098051,Nie; Jiawang,7,0,10,3
1668305932177,MATH 280B,A00,098052,Zheng; Tianyi,8,0,15,7
1668305932605,MATH 281B,A00,098053,Bradic; Jelena,1,0,15,14
1668305933032,MATH 282B,A00,098054,Arias-Castro; Ery,0,0,15,15
1668305933460,MATH 285,A00,098055,Fitzsimmons; Patrick J,0,0,15,17
1668305933897,MATH 287B,A00,098056,Arias-Castro; Ery,2,0,15,13
1668305934321,MATH 288,A00,098057,Agarwal; Pooja,9,0,10,1
1668305934321,MATH 288,B00,098058,Zhang; Danna,8,0,10,2
1668305934321,MATH 288,C00,098059,Williams; Ruth J,9,0,10,1
1668305934744,MATH 290B,A00,098060,Roberts; Justin Deritter,13,0,15,2
1668305935169,MATH 292,A00,098061,Belmont; Eva Kinoshita,10,0,10,0
1668305935594,MATH 295,A00,098062,Suk; Andrew Hoon,48,0,50,2
1668305936017,MATH 296,A00,098063,Novak; Jonathan I,20,0,20,0
1668305936443,MATH 297,001,098064,Gamst; Anthony Collins,9997,0,9999,2
1668306436019,COGS 205,A00,101395,Chiba; Andrea,19,0,20,1
1668306436446,COGS 210B,001,101404,Greene; Deanna Jacquelyn,9998,0,9999,1
1668306436446,COGS 210B,002,101417,Xia; Haijun,9999,0,9999,0
1668306436446,COGS 210B,003,101422,Nitz; Douglas A.,9999,0,9999,0
1668306436446,COGS 210B,004,101423,Hollan; James D.,9998,0,9999,1
1668306436446,COGS 210B,005,101424,Deak; Gedeon O.,9998,0,9999,1
1668306436446,COGS 210B,006,101425,Rossano; Federico,9999,0,9999,0
1668306436872,COGS 211B,A00,101427,Coulson; Seana M,9996,0,9999,3
1668306437298,COGS 220,A00,101428,Hollan; James D.,0,0,25,25
1668306437727,COGS 229,A00,101429,Dow; Steven P,18,0,25,7
1668306438156,COGS 230,A00,101430,Klemmer; Scott R,12,0,17,5
1668306438581,COGS 234,A00,101431,Xia; Haijun,1,0,25,24
1668306439005,COGS 260,A00,101432,Kiyonaga; Anastasia,21,0,25,4
1668306439005,COGS 260,B00,101433,Kirsh; David Joel,15,0,25,10
1668306439430,CSE 202,A00,102371,Impagliazzo; Russell,0,0,0,0
1668306439857,CSE 203B,A01,102373,Cheng; Chung Kuan,0,0,0,0
1668306440283,CSE 208,A00,102374,Micciancio; Daniele,0,0,0,0
1668306440706,CSE 209A,A00,112895,Impagliazzo; Russell,0,0,15,15
1668306441131,CSE 209B,A00,108005,Bellare; Mihir,0,0,0,0
1668306441555,CSE 210,A00,113163,Coblenz; Michael J,0,0,0,0
1668306441979,CSE 219,A00,106111,Dow; Steven P,0,0,20,20
1668306442404,CSE 221,A00,102376,Voelker; Geoffrey M.,0,0,0,0
1668306442832,CSE 224,A01,102378,Porter; George M,0,0,0,0
1668306443256,CSE 229A,A00,102379,Savage; Stefan,0,0,0,0
1668306443681,CSE 229C,A00,102380,Munyaka; Imani N. S.,0,0,0,0
1668306444114,CSE 232B,A00,102382,Deutsch; Alin Bernard,0,0,0,0
1668306444545,CSE 234,A01,112904,Kumar; Arun Kumar,0,0,0,0
1668306444969,CSE 237A,A00,102383,Rosing; Tajana Simunic,0,0,0,0
1668306445397,CSE 239A,A00,102384,Deutsch; Alin Bernard,0,0,0,0
1668306445825,CSE 239B,A00,102385,Polikarpova; Nadezhda,0,0,0,0
1668306446248,CSE 240A,A00,102386,Pannuto; Patrick William,0,0,0,0
1668306446675,CSE 240B,A00,102387,Zhao; Jishen,0,0,0,0
1668306447099,CSE 241A,A00,106406,Kang; Mingu,0,0,0,0
1668306447535,CSE 249B,A00,102388,Kahng; Andrew Byun,0,0,8,8
1668306447957,CSE 251B,A01,102392,Cottrell; Garrison W,0,0,0,0
1668306447957,CSE 251B,A02,102393,Cottrell; Garrison W,0,0,0,0
1668306448380,CSE 252B,A00,102394,Ochoa; Benjamin Lawrence,0,0,0,0
1668306448816,CSE 257,A01,102396,Gao; Sicun,0,0,0,0
1668306449241,CSE 272,A00,102397,Li; Tzumao,0,0,0,0
1668306449669,CSE 274,A00,111323,Chern; Albert Ren-Haur,0,0,0,0
1668306450093,CSE 282,A00,102398,Pevzner; Pavel Arkadjevich,0,0,0,0
1668306450521,CSE 284,A00,114175,Gymrek; Melissa Ann,0,0,0,0
1668306450948,CSE 290,A00,102399,Chandraker; Manmohan Krishna,0,0,0,0
1668306450948,CSE 290,B00,102400,Vaccaro; Kristen Marie,0,0,25,25
1668306450948,CSE 290,C00,102414,Pannuto; Patrick William,0,0,25,25
1668306450948,CSE 290,D00,102427,Pevzner; Pavel Arkadjevich,0,0,0,0
1668306450948,CSE 290,E00,102429,Zhao; Jishen,0,0,0,0
1668306450948,CSE 290,F00,102436,Tullsen; Dean Michael,0,0,0,0
1668306450948,CSE 290,G00,102440,Christensen; Henrik I,0,0,20,20
1668306451378,CSE 291,A00,102443,Su; Hao,0,0,0,0
1668306451378,CSE 291,B00,102448,Polikarpova; Nadezhda,0,0,0,0
1668306451378,CSE 291,C00,102453,Vaccaro; Kristen Marie,0,0,0,0
1668306451378,CSE 291,D00,111343,Savage; Stefan,0,0,0,0
1668306451378,CSE 291,E00,116474,Claffy; Kimberly Claire,0,0,0,0
1668306451378,CSE 291,F00,116479,Pasquale; Joseph,0,0,0,0
1668306451817,CSE 293,001,119111,Bafna; Vineet,9999,0,9999,0
1668306451817,CSE 293,002,119118,Bellare; Mihir,9999,0,9999,0
1668306451817,CSE 293,003,119122,Berg-Kirkpatrick; Taylor D,9999,0,9999,0
1668306451817,CSE 293,004,119135,Christensen; Henrik I,9999,0,9999,0
1668306451817,CSE 293,005,119142,Cottrell; Garrison W,9999,0,9999,0
1668306451817,CSE 293,006,119146,Deutsch; Alin Bernard,9999,0,9999,0
1668306451817,CSE 293,007,119159,Esmaeilzadeh; Hadi,9999,0,9999,0
1668306451817,CSE 293,008,119166,Freund; Yoav,9999,0,9999,0
1668306451817,CSE 293,009,119170,Griswold; William G.,9999,0,9999,0
1668306451817,CSE 293,010,119183,Gymrek; Melissa Ann,9999,0,9999,0
1668306451817,CSE 293,011,119190,Heninger; Nadia A,9999,0,9999,0
1668306451817,CSE 293,012,119230,Impagliazzo; Russell,9999,0,9999,0
1668306451817,CSE 293,013,119232,Jhala; Ranjit,9999,0,9999,0
1668306451817,CSE 293,014,119233,Kahng; Andrew Byun,9999,0,9999,0
1668306451817,CSE 293,015,119298,Kane; Daniel Mertz,9999,0,9999,0
1668306451817,CSE 293,016,119299,Kriegman; David J,9999,0,9999,0
1668306451817,CSE 293,017,119300,Kumar; Arun Kumar,9999,0,9999,0
1668306451817,CSE 293,018,119301,Lerner; Sorin,9999,0,9999,0
1668306451817,CSE 293,019,119302,Lovett; Shachar,9999,0,9999,0
1668306451817,CSE 293,020,119303,McAuley; Julian John,9999,0,9999,0
1668306451817,CSE 293,021,119304,Micciancio; Daniele,9999,0,9999,0
1668306451817,CSE 293,022,119367,Orailoglu; Alex,9999,0,9999,0
1668306451817,CSE 293,023,119382,Paturi; Ramamohan,9999,0,9999,0
1668306451817,CSE 293,024,119404,Polikarpova; Nadezhda,9999,0,9999,0
1668306451817,CSE 293,025,119406,Politz; Joseph Gibbs,9999,0,9999,0
1668306451817,CSE 293,026,119411,Porter; George M,9999,0,9999,0
1668306451817,CSE 293,027,119414,Porter; Leonard Emerson,9999,0,9999,0
1668306451817,CSE 293,028,119416,Ramamoorthi; Ravi,9999,0,9999,0
1668306451817,CSE 293,029,119417,Sahoo; Debashis,9999,0,9999,0
1668306451817,CSE 293,030,119420,Saul; Lawrence,9999,0,9999,0
1668306451817,CSE 293,031,119421,Savage; Stefan,9999,0,9999,0
1668306451817,CSE 293,032,119425,Schulze; Jurgen P.,9999,0,9999,0
1668306451817,CSE 293,033,119426,Snoeren; Alex C.,9999,0,9999,0
1668306451817,CSE 293,034,119428,Shang; Jingbo,9999,0,9999,0
1668306451817,CSE 293,035,119430,Stefan; Deian,9999,0,9999,0
1668306451817,CSE 293,036,119431,Su; Hao,9999,0,9999,0
1668306451817,CSE 293,037,119433,Swanson; Steven James,9999,0,9999,0
1668306451817,CSE 293,038,119435,Tullsen; Dean Michael,9999,0,9999,0
1668306451817,CSE 293,039,119483,Voelker; Geoffrey M.,9999,0,9999,0
1668306451817,CSE 293,040,119537,Zhao; Jishen,9999,0,9999,0
1668306451817,CSE 293,041,119538,Zhou; Yuan-Yuan,9999,0,9999,0
1668306451817,CSE 293,042,119539,Gao; Sicun,9999,0,9999,0
1668306451817,CSE 293,043,119540,Weibel; Nadir,9999,0,9999,0
1668306451817,CSE 293,044,119541,Gupta; Rajesh K.,9999,0,9999,0
1668306451817,CSE 293,045,126410,Vaccaro; Kristen Marie,9999,0,9999,0
1668306451817,CSE 293,046,126411,Klemke; Richard,9999,0,9999,0
1668306452240,CSE 294,A00,102459,Voelker; Geoffrey M.,0,0,0,0
1668306452240,CSE 294,B00,111322,Orailoglu; Alex,0,0,0,0
1668306452665,DSE 201,A00,096914,Deutsch; Alin Bernard,30,0,30,0
1668306453087,DSE 210,A00,096915,Dasgupta; Sanjoy,30,0,30,0
1668306453512,DSE 260A,A00,096916,Altintas De Callaf; Ilkay,30,0,30,0
1668306453945,ECE 200,001,103586,Antipa; Nicholas A,9999,0,9999,0
1668306453945,ECE 200,002,103587,Atanasov; Nikolay A.,9999,0,9999,0
1668306453945,ECE 200,003,103588,Bharadia; Dinesh,9999,0,9999,0
1668306453945,ECE 200,004,103589,Cheng; Chung Kuan,9999,0,9999,0
1668306453945,ECE 200,005,103590,Cosman; Pamela C.,9999,0,9999,0
1668306453945,ECE 200,006,103591,Dayeh; Shadi Ahmad,9999,0,9999,0
1668306453945,ECE 200,007,103592,Fainman; Yeshaiahu,9999,0,9999,0
1668306453945,ECE 200,008,103593,Ford; Joseph Earl,9999,0,9999,0
1668306453945,ECE 200,009,103594,Franceschetti; Massimo,9999,0,9999,0
1668306453945,ECE 200,010,103595,Fullerton; Eric E,9999,0,9999,0
1668306453945,ECE 200,011,103596,Galton; Ian A,9999,0,9999,0
1668306453945,ECE 200,012,103597,Gilja; Vikash,9999,0,9999,0
1668306453945,ECE 200,013,103598,Hall; Drew A.,9999,0,9999,0
1668306453945,ECE 200,014,103599,Hsueh; Tzu-Chien,9999,0,9999,0
1668306453945,ECE 200,015,103600,Javidi; Tara,9999,0,9999,0
1668306453945,ECE 200,016,103601,Kahng; Andrew Byun,9999,0,9999,0
1668306453945,ECE 200,017,103602,Kim; Young-Han,9999,0,9999,0
1668306453945,ECE 200,018,103603,Koushanfar; Farinaz,9999,0,9999,0
1668306453945,ECE 200,019,103604,Kuzum; Duygu,9999,0,9999,0
1668306453945,ECE 200,020,103605,Le; Hanh-Phuc,9999,0,9999,0
1668306453945,ECE 200,021,103606,Lin; Bill,9999,0,9999,0
1668306453945,ECE 200,022,103607,Liu; Zhaowei,9998,0,9999,1
1668306453945,ECE 200,023,103608,Lo; Yu-Hwa,9999,0,9999,0
1668306453945,ECE 200,024,103609,Lomakin; Vitaliy,9999,0,9999,0
1668306453945,ECE 200,025,103610,Mercier; Patrick Philip,9999,0,9999,0
1668306453945,ECE 200,026,103611,Meyer; Florian,9999,0,9999,0
1668306453945,ECE 200,027,103612,Milstein; Laurence B.,9999,0,9999,0
1668306453945,ECE 200,028,103613,Mir Arabbaygi; Siavash,9999,0,9999,0
1668306453945,ECE 200,029,103614,Mookherjea; Shayan,9999,0,9999,0
1668306453945,ECE 200,030,103615,Morris; Karcher William,9999,0,9999,0
1668306453945,ECE 200,031,103616,Ng; Tse Nga,9999,0,9999,0
1668306453945,ECE 200,032,103617,Nguyen; Truong Quang,9999,0,9999,0
1668306453945,ECE 200,033,103618,Nomura; Kenji,9999,0,9999,0
1668306453945,ECE 200,034,103619,Orlitsky; Alon,9999,0,9999,0
1668306453945,ECE 200,035,103620,Pal; Piya,9999,0,9999,0
1668306453945,ECE 200,036,103621,Papen; George C.,9999,0,9999,0
1668306453945,ECE 200,037,103622,Radic; Stojan,9999,0,9999,0
1668306453945,ECE 200,038,103623,Rao; Bhaskar D.,9999,0,9999,0
1668306453945,ECE 200,039,103624,Rao; Ramesh R,9999,0,9999,0
1668306453945,ECE 200,040,103625,Rebeiz; Gabriel,9999,0,9999,0
1668306453945,ECE 200,041,103626,Sanford; John R,9999,0,9999,0
1668306453945,ECE 200,042,103627,Siegel; Paul H.,9999,0,9999,0
1668306453945,ECE 200,043,103628,Sievenpiper; Daniel F.,9999,0,9999,0
1668306453945,ECE 200,044,103629,Sworder; David D.,9999,0,9999,0
1668306453945,ECE 200,045,103630,Taur; Yuan,9999,0,9999,0
1668306453945,ECE 200,046,103631,Touri; Behrouz,9999,0,9999,0
1668306453945,ECE 200,047,103632,Trivedi; Mohan M.,9999,0,9999,0
1668306453945,ECE 200,048,103633,Vasconcelos; Nuno,9999,0,9999,0
1668306453945,ECE 200,049,103634,Wang; Xiaolong,9999,0,9999,0
1668306453945,ECE 200,050,103635,Xie; Pengtao,9999,0,9999,0
1668306453945,ECE 200,051,103636,Yip; Michael,9999,0,9999,0
1668306453945,ECE 200,052,103637,Zeger; Kenneth A.,999,0,999,0
1668306453945,ECE 200,053,103638,Zhang; Xinyu,9999,0,9999,0
1668306453945,ECE 200,054,103639,Turakhia; Yatish Girish,9999,0,9999,0
1668306453945,ECE 200,055,103640,Kang; Mingu,9999,0,9999,0
1668306453945,ECE 200,056,103641,Shi; Yuanyuan,9999,0,9999,0
1668306453945,ECE 200,057,103642,Wang; Edward Jay,9999,0,9999,0
1668306453945,ECE 200,058,103643,Zheng; Yang,9999,0,9999,0
1668306454368,ECE 202,A00,103644,Kuzum; Duygu,0,0,0,0
1668306454793,ECE 212BN,A00,103646,Ng; Tse Nga,0,0,0,0
1668306455222,ECE 221,A00,111493,Staff,0,0,0,0
1668306455651,ECE 222B,A00,103647,Lomakin; Vitaliy,0,0,0,0
1668306456077,ECE 230B,A00,103648,Taur; Yuan,0,0,0,0
1668306456501,ECE 238B,A00,103649,Garay; Javier,0,0,0,0
1668306456925,ECE 240B,A00,112900,Fainman; Yeshaiahu,0,0,0,0
1668306457349,ECE 247A,A00,103650,Jokerst; Jesse Vincent,0,0,0,0
1668306457777,ECE 247B,A00,103651,Wang; Joseph,0,0,0,0
1668306458200,ECE 250,A00,103652,Siegel; Paul H.,0,0,0,0
1668306458624,ECE 251A,A00,103654,Rao; Bhaskar D.,0,0,0,0
1668306459050,ECE 257B,A00,103655,Bharadia; Dinesh,0,0,0,0
1668306459479,ECE 258A,A00,103656,Milstein; Laurence B.,0,0,0,0
1668306459912,ECE 260B,A00,103658,Kang; Mingu,0,0,0,0
1668306460335,ECE 264A,A00,103659,Galton; Ian A,0,0,0,0
1668306460762,ECE 265A,A00,103661,Gudem; Prasad S.S.,0,0,0,0
1668306461187,ECE 265D,A00,103662,Gudem; Prasad S.S.,0,0,0,0
1668306461612,ECE 268,A00,103663,Koushanfar; Farinaz,0,0,0,0
1668306462036,ECE 269,A01,103665,Pal; Piya,0,0,0,0
1668306462461,ECE 271B,A00,103666,Vasconcelos; Manuela,0,0,0,0
1668306462888,ECE 276A,A00,103667,Atanasov; Nikolay A.,0,0,0,0
1668306463310,ECE 277,A00,103668,An; Cheolhong,0,0,0,0
1668306463738,ECE 279,A00,117947,Hall; Drew A.,0,0,0,0
1668306464585,ECE 283,A00,103670,Hsueh; Tzu-Chien,0,0,0,0
1668306465013,ECE 284,A00,103671,Turakhia; Yatish Girish,0,0,0,0
1668306465442,ECE 285,A00,103672,Zheng; Yang,0,0,0,0
1668306465442,ECE 285,B00,103673,Sworder; David D.,0,0,0,0
1668306465864,ECE 287,A00,103676,Javidi; Tara,0,0,0,0
1668306466292,MATH 200B,A00,098023,Salehi Golsefidy; Alireza,12,0,15,3
1668306466720,MATH 202B,A00,098024,Rhoades; Brendon Patrick,9,0,15,6
1668306467143,MATH 203B,A00,098025,Oprea; Dragos N.,10,0,15,5
1668306467578,MATH 204B,A00,098026,Sorensen; Claus M,13,0,15,2
1668306468004,MATH 208,A00,098027,Izadi; Elham,7,0,10,3
1668306468429,MATH 209,A00,098028,Pollack; Aaron,10,0,10,0
1668306468864,MATH 211A,A00,112919,Rogalski; Daniel,9,0,10,1
1668306469295,MATH 211B,A00,112920,Seward; Brandon M.,9,0,10,1
1668306469721,MATH 218,A00,098029,Li; Bo,10,0,10,0
1668306470144,MATH 220B,A00,098030,Novak; Jonathan I,11,0,15,4
1668306470571,MATH 221A,A00,098031,Ebenfelt; Peter F,13,0,15,2
1668306470997,MATH 231B,A00,098032,Zlatos; Andrej,12,0,15,3
1668306471422,MATH 240B,A00,098033,Ni; Lei,9,0,15,6
1668306471853,MATH 243,A00,098034,Jekel; David Andrew,10,0,10,0
1668306472278,MATH 245A,A00,098035,Nie; Jiawang,0,0,15,16
1668306472702,MATH 248,A00,098036,Bejenaru; Ioan,10,0,10,0
1668306473127,MATH 250B,A00,098037,Spolaor; Luca,14,0,15,1
1668306473578,MATH 258,A00,098038,Ni; Lei,10,0,10,0
1668306474005,MATH 264B,A00,098041,Rhoades; Brendon Patrick,9,0,15,6
1668306474430,MATH 268,A00,098042,Buss; Samuel R,10,0,10,0
1668306474855,MATH 269,A00,098043,Rhoades; Brendon Patrick,10,0,10,0
1668306475279,MATH 270B,A00,098044,Li; Bo,10,0,15,5
1668306475702,MATH 272B,A00,098045,Holst; Michael J,13,0,15,2
1668306476128,MATH 273A,A00,098046,Tian; Xiaochuan,10,0,15,5
1668306476552,MATH 275,A01,098048,Tian; Xiaochuan,6,0,10,4
1668306476978,MATH 278A,A00,098049,Holst; Michael J,8,0,10,2
1668306477404,MATH 278B,A00,098050,Cloninger; Alexander,10,0,10,0
1668306477906,MATH 278C,A00,098051,Nie; Jiawang,7,0,10,3
1668306478330,MATH 280B,A00,098052,Zheng; Tianyi,8,0,15,7
1668306478758,MATH 281B,A00,098053,Bradic; Jelena,1,0,15,14
1668306479183,MATH 282B,A00,098054,Arias-Castro; Ery,0,0,15,15
1668306479607,MATH 285,A00,098055,Fitzsimmons; Patrick J,0,0,15,17
1668306480036,MATH 287B,A00,098056,Arias-Castro; Ery,2,0,15,13
1668306480462,MATH 288,A00,098057,Agarwal; Pooja,9,0,10,1
1668306480462,MATH 288,B00,098058,Zhang; Danna,8,0,10,2
1668306480462,MATH 288,C00,098059,Williams; Ruth J,9,0,10,1
1668306480888,MATH 290B,A00,098060,Roberts; Justin Deritter,13,0,15,2
1668306481311,MATH 292,A00,098061,Belmont; Eva Kinoshita,10,0,10,0
1668306481736,MATH 295,A00,098062,Suk; Andrew Hoon,48,0,50,2
1668306482161,MATH 296,A00,098063,Novak; Jonathan I,20,0,20,0
1668306482584,MATH 297,001,098064,Gamst; Anthony Collins,9997,0,9999,2
1668307046432,COGS 205,A00,101395,Chiba; Andrea,19,0,20,1
1668307046878,COGS 210B,001,101404,Greene; Deanna Jacquelyn,9998,0,9999,1
1668307046878,COGS 210B,002,101417,Xia; Haijun,9999,0,9999,0
1668307046878,COGS 210B,003,101422,Nitz; Douglas A.,9999,0,9999,0
1668307046878,COGS 210B,004,101423,Hollan; James D.,9998,0,9999,1
1668307046878,COGS 210B,005,101424,Deak; Gedeon O.,9998,0,9999,1
1668307046878,COGS 210B,006,101425,Rossano; Federico,9999,0,9999,0
1668307047308,COGS 211B,A00,101427,Coulson; Seana M,9996,0,9999,3
1668307047742,COGS 220,A00,101428,Hollan; James D.,0,0,25,25
1668307048180,COGS 229,A00,101429,Dow; Steven P,18,0,25,7
1668307048618,COGS 230,A00,101430,Klemmer; Scott R,12,0,17,5
1668307049061,COGS 234,A00,101431,Xia; Haijun,1,0,25,24
1668307049491,COGS 260,A00,101432,Kiyonaga; Anastasia,21,0,25,4
1668307049491,COGS 260,B00,101433,Kirsh; David Joel,15,0,25,10
1668307049915,CSE 202,A00,102371,Impagliazzo; Russell,0,0,0,0
1668307050347,CSE 203B,A01,102373,Cheng; Chung Kuan,0,0,0,0
1668307050788,CSE 208,A00,102374,Micciancio; Daniele,0,0,0,0
1668307051210,CSE 209A,A00,112895,Impagliazzo; Russell,0,0,15,15
1668307051633,CSE 209B,A00,108005,Bellare; Mihir,0,0,0,0
1668307052074,CSE 210,A00,113163,Coblenz; Michael J,0,0,0,0
1668307052511,CSE 219,A00,106111,Dow; Steven P,0,0,20,20
1668307052939,CSE 221,A00,102376,Voelker; Geoffrey M.,0,0,0,0
1668307053372,CSE 224,A01,102378,Porter; George M,0,0,0,0
1668307053802,CSE 229A,A00,102379,Savage; Stefan,0,0,0,0
1668307054225,CSE 229C,A00,102380,Munyaka; Imani N. S.,0,0,0,0
1668307054674,CSE 232B,A00,102382,Deutsch; Alin Bernard,0,0,0,0
1668307055099,CSE 234,A01,112904,Kumar; Arun Kumar,0,0,0,0
1668307055527,CSE 237A,A00,102383,Rosing; Tajana Simunic,0,0,0,0
1668307055959,CSE 239A,A00,102384,Deutsch; Alin Bernard,0,0,0,0
1668307056389,CSE 239B,A00,102385,Polikarpova; Nadezhda,0,0,0,0
1668307056815,CSE 240A,A00,102386,Pannuto; Patrick William,0,0,0,0
1668307057239,CSE 240B,A00,102387,Zhao; Jishen,0,0,0,0
1668307057671,CSE 241A,A00,106406,Kang; Mingu,0,0,0,0
1668307058107,CSE 249B,A00,102388,Kahng; Andrew Byun,0,0,8,8
1668307058535,CSE 251B,A01,102392,Cottrell; Garrison W,0,0,0,0
1668307058535,CSE 251B,A02,102393,Cottrell; Garrison W,0,0,0,0
1668307058959,CSE 252B,A00,102394,Ochoa; Benjamin Lawrence,0,0,0,0
1668307059397,CSE 257,A01,102396,Gao; Sicun,0,0,0,0
1668307059822,CSE 272,A00,102397,Li; Tzumao,0,0,0,0
1668307060247,CSE 274,A00,111323,Chern; Albert Ren-Haur,0,0,0,0
1668307060677,CSE 282,A00,102398,Pevzner; Pavel Arkadjevich,0,0,0,0
1668307061099,CSE 284,A00,114175,Gymrek; Melissa Ann,0,0,0,0
1668307061524,CSE 290,A00,102399,Chandraker; Manmohan Krishna,0,0,0,0
1668307061524,CSE 290,B00,102400,Vaccaro; Kristen Marie,0,0,25,25
1668307061524,CSE 290,C00,102414,Pannuto; Patrick William,0,0,25,25
1668307061524,CSE 290,D00,102427,Pevzner; Pavel Arkadjevich,0,0,0,0
1668307061524,CSE 290,E00,102429,Zhao; Jishen,0,0,0,0
1668307061524,CSE 290,F00,102436,Tullsen; Dean Michael,0,0,0,0
1668307061524,CSE 290,G00,102440,Christensen; Henrik I,0,0,20,20
1668307061964,CSE 291,A00,102443,Su; Hao,0,0,0,0
1668307061964,CSE 291,B00,102448,Polikarpova; Nadezhda,0,0,0,0
1668307061964,CSE 291,C00,102453,Vaccaro; Kristen Marie,0,0,0,0
1668307061964,CSE 291,D00,111343,Savage; Stefan,0,0,0,0
1668307061964,CSE 291,E00,116474,Claffy; Kimberly Claire,0,0,0,0
1668307061964,CSE 291,F00,116479,Pasquale; Joseph,0,0,0,0
1668307062393,CSE 293,001,119111,Bafna; Vineet,9999,0,9999,0
1668307062393,CSE 293,002,119118,Bellare; Mihir,9999,0,9999,0
1668307062393,CSE 293,003,119122,Berg-Kirkpatrick; Taylor D,9999,0,9999,0
1668307062393,CSE 293,004,119135,Christensen; Henrik I,9999,0,9999,0
1668307062393,CSE 293,005,119142,Cottrell; Garrison W,9999,0,9999,0
1668307062393,CSE 293,006,119146,Deutsch; Alin Bernard,9999,0,9999,0
1668307062393,CSE 293,007,119159,Esmaeilzadeh; Hadi,9999,0,9999,0
1668307062393,CSE 293,008,119166,Freund; Yoav,9999,0,9999,0
1668307062393,CSE 293,009,119170,Griswold; William G.,9999,0,9999,0
1668307062393,CSE 293,010,119183,Gymrek; Melissa Ann,9999,0,9999,0
1668307062393,CSE 293,011,119190,Heninger; Nadia A,9999,0,9999,0
1668307062393,CSE 293,012,119230,Impagliazzo; Russell,9999,0,9999,0
1668307062393,CSE 293,013,119232,Jhala; Ranjit,9999,0,9999,0
1668307062393,CSE 293,014,119233,Kahng; Andrew Byun,9999,0,9999,0
1668307062393,CSE 293,015,119298,Kane; Daniel Mertz,9999,0,9999,0
1668307062393,CSE 293,016,119299,Kriegman; David J,9999,0,9999,0
1668307062393,CSE 293,017,119300,Kumar; Arun Kumar,9999,0,9999,0
1668307062393,CSE 293,018,119301,Lerner; Sorin,9999,0,9999,0
1668307062393,CSE 293,019,119302,Lovett; Shachar,9999,0,9999,0
1668307062393,CSE 293,020,119303,McAuley; Julian John,9999,0,9999,0
1668307062393,CSE 293,021,119304,Micciancio; Daniele,9999,0,9999,0
1668307062393,CSE 293,022,119367,Orailoglu; Alex,9999,0,9999,0
1668307062393,CSE 293,023,119382,Paturi; Ramamohan,9999,0,9999,0
1668307062393,CSE 293,024,119404,Polikarpova; Nadezhda,9999,0,9999,0
1668307062393,CSE 293,025,119406,Politz; Joseph Gibbs,9999,0,9999,0
1668307062393,CSE 293,026,119411,Porter; George M,9999,0,9999,0
1668307062393,CSE 293,027,119414,Porter; Leonard Emerson,9999,0,9999,0
1668307062393,CSE 293,028,119416,Ramamoorthi; Ravi,9999,0,9999,0
1668307062393,CSE 293,029,119417,Sahoo; Debashis,9999,0,9999,0
1668307062393,CSE 293,030,119420,Saul; Lawrence,9999,0,9999,0
1668307062393,CSE 293,031,119421,Savage; Stefan,9999,0,9999,0
1668307062393,CSE 293,032,119425,Schulze; Jurgen P.,9999,0,9999,0
1668307062393,CSE 293,033,119426,Snoeren; Alex C.,9999,0,9999,0
1668307062393,CSE 293,034,119428,Shang; Jingbo,9999,0,9999,0
1668307062393,CSE 293,035,119430,Stefan; Deian,9999,0,9999,0
1668307062393,CSE 293,036,119431,Su; Hao,9999,0,9999,0
1668307062393,CSE 293,037,119433,Swanson; Steven James,9999,0,9999,0
1668307062393,CSE 293,038,119435,Tullsen; Dean Michael,9999,0,9999,0
1668307062393,CSE 293,039,119483,Voelker; Geoffrey M.,9999,0,9999,0
1668307062393,CSE 293,040,119537,Zhao; Jishen,9999,0,9999,0
1668307062393,CSE 293,041,119538,Zhou; Yuan-Yuan,9999,0,9999,0
1668307062393,CSE 293,042,119539,Gao; Sicun,9999,0,9999,0
1668307062393,CSE 293,043,119540,Weibel; Nadir,9999,0,9999,0
1668307062393,CSE 293,044,119541,Gupta; Rajesh K.,9999,0,9999,0
1668307062393,CSE 293,045,126410,Vaccaro; Kristen Marie,9999,0,9999,0
1668307062393,CSE 293,046,126411,Klemke; Richard,9999,0,9999,0
1668307062815,CSE 294,A00,102459,Voelker; Geoffrey M.,0,0,0,0
1668307062815,CSE 294,B00,111322,Orailoglu; Alex,0,0,0,0
1668307063241,DSE 201,A00,096914,Deutsch; Alin Bernard,30,0,30,0
1668307063665,DSE 210,A00,096915,Dasgupta; Sanjoy,30,0,30,0
1668307064094,DSE 260A,A00,096916,Altintas De Callaf; Ilkay,30,0,30,0
1668307064545,ECE 200,001,103586,Antipa; Nicholas A,9999,0,9999,0
1668307064545,ECE 200,002,103587,Atanasov; Nikolay A.,9999,0,9999,0
1668307064545,ECE 200,003,103588,Bharadia; Dinesh,9999,0,9999,0
1668307064545,ECE 200,004,103589,Cheng; Chung Kuan,9999,0,9999,0
1668307064545,ECE 200,005,103590,Cosman; Pamela C.,9999,0,9999,0
1668307064545,ECE 200,006,103591,Dayeh; Shadi Ahmad,9999,0,9999,0
1668307064545,ECE 200,007,103592,Fainman; Yeshaiahu,9999,0,9999,0
1668307064545,ECE 200,008,103593,Ford; Joseph Earl,9999,0,9999,0
1668307064545,ECE 200,009,103594,Franceschetti; Massimo,9999,0,9999,0
1668307064545,ECE 200,010,103595,Fullerton; Eric E,9999,0,9999,0
1668307064545,ECE 200,011,103596,Galton; Ian A,9999,0,9999,0
1668307064545,ECE 200,012,103597,Gilja; Vikash,9999,0,9999,0
1668307064545,ECE 200,013,103598,Hall; Drew A.,9999,0,9999,0
1668307064545,ECE 200,014,103599,Hsueh; Tzu-Chien,9999,0,9999,0
1668307064545,ECE 200,015,103600,Javidi; Tara,9999,0,9999,0
1668307064545,ECE 200,016,103601,Kahng; Andrew Byun,9999,0,9999,0
1668307064545,ECE 200,017,103602,Kim; Young-Han,9999,0,9999,0
1668307064545,ECE 200,018,103603,Koushanfar; Farinaz,9999,0,9999,0
1668307064545,ECE 200,019,103604,Kuzum; Duygu,9999,0,9999,0
1668307064545,ECE 200,020,103605,Le; Hanh-Phuc,9999,0,9999,0
1668307064545,ECE 200,021,103606,Lin; Bill,9999,0,9999,0
1668307064545,ECE 200,022,103607,Liu; Zhaowei,9998,0,9999,1
1668307064545,ECE 200,023,103608,Lo; Yu-Hwa,9999,0,9999,0
1668307064545,ECE 200,024,103609,Lomakin; Vitaliy,9999,0,9999,0
1668307064545,ECE 200,025,103610,Mercier; Patrick Philip,9999,0,9999,0
1668307064545,ECE 200,026,103611,Meyer; Florian,9999,0,9999,0
1668307064545,ECE 200,027,103612,Milstein; Laurence B.,9999,0,9999,0
1668307064545,ECE 200,028,103613,Mir Arabbaygi; Siavash,9999,0,9999,0
1668307064545,ECE 200,029,103614,Mookherjea; Shayan,9999,0,9999,0
1668307064545,ECE 200,030,103615,Morris; Karcher William,9999,0,9999,0
1668307064545,ECE 200,031,103616,Ng; Tse Nga,9999,0,9999,0
1668307064545,ECE 200,032,103617,Nguyen; Truong Quang,9999,0,9999,0
1668307064545,ECE 200,033,103618,Nomura; Kenji,9999,0,9999,0
1668307064545,ECE 200,034,103619,Orlitsky; Alon,9999,0,9999,0
1668307064545,ECE 200,035,103620,Pal; Piya,9999,0,9999,0
1668307064545,ECE 200,036,103621,Papen; George C.,9999,0,9999,0
1668307064545,ECE 200,037,103622,Radic; Stojan,9999,0,9999,0
1668307064545,ECE 200,038,103623,Rao; Bhaskar D.,9999,0,9999,0
1668307064545,ECE 200,039,103624,Rao; Ramesh R,9999,0,9999,0
1668307064545,ECE 200,040,103625,Rebeiz; Gabriel,9999,0,9999,0
1668307064545,ECE 200,041,103626,Sanford; John R,9999,0,9999,0
1668307064545,ECE 200,042,103627,Siegel; Paul H.,9999,0,9999,0
1668307064545,ECE 200,043,103628,Sievenpiper; Daniel F.,9999,0,9999,0
1668307064545,ECE 200,044,103629,Sworder; David D.,9999,0,9999,0
1668307064545,ECE 200,045,103630,Taur; Yuan,9999,0,9999,0
1668307064545,ECE 200,046,103631,Touri; Behrouz,9999,0,9999,0
1668307064545,ECE 200,047,103632,Trivedi; Mohan M.,9999,0,9999,0
1668307064545,ECE 200,048,103633,Vasconcelos; Nuno,9999,0,9999,0
1668307064545,ECE 200,049,103634,Wang; Xiaolong,9999,0,9999,0
1668307064545,ECE 200,050,103635,Xie; Pengtao,9999,0,9999,0
1668307064545,ECE 200,051,103636,Yip; Michael,9999,0,9999,0
1668307064545,ECE 200,052,103637,Zeger; Kenneth A.,999,0,999,0
1668307064545,ECE 200,053,103638,Zhang; Xinyu,9999,0,9999,0
1668307064545,ECE 200,054,103639,Turakhia; Yatish Girish,9999,0,9999,0
1668307064545,ECE 200,055,103640,Kang; Mingu,9999,0,9999,0
1668307064545,ECE 200,056,103641,Shi; Yuanyuan,9999,0,9999,0
1668307064545,ECE 200,057,103642,Wang; Edward Jay,9999,0,9999,0
1668307064545,ECE 200,058,103643,Zheng; Yang,9999,0,9999,0
1668307064971,ECE 202,A00,103644,Kuzum; Duygu,0,0,0,0
1668307065397,ECE 212BN,A00,103646,Ng; Tse Nga,0,0,0,0
1668307065821,ECE 221,A00,111493,Staff,0,0,0,0
1668307066358,ECE 222B,A00,103647,Lomakin; Vitaliy,0,0,0,0
1668307066786,ECE 230B,A00,103648,Taur; Yuan,0,0,0,0
1668307067208,ECE 238B,A00,103649,Garay; Javier,0,0,0,0
1668307067630,ECE 240B,A00,112900,Fainman; Yeshaiahu,0,0,0,0
1668307068057,ECE 247A,A00,103650,Jokerst; Jesse Vincent,0,0,0,0
1668307068482,ECE 247B,A00,103651,Wang; Joseph,0,0,0,0
1668307068906,ECE 250,A00,103652,Siegel; Paul H.,0,0,0,0
1668307069332,ECE 251A,A00,103654,Rao; Bhaskar D.,0,0,0,0
1668307069760,ECE 257B,A00,103655,Bharadia; Dinesh,0,0,0,0
1668307070198,ECE 258A,A00,103656,Milstein; Laurence B.,0,0,0,0
1668307070623,ECE 260B,A00,103658,Kang; Mingu,0,0,0,0
1668307071047,ECE 264A,A00,103659,Galton; Ian A,0,0,0,0
1668307071490,ECE 265A,A00,103661,Gudem; Prasad S.S.,0,0,0,0
1668307071928,ECE 265D,A00,103662,Gudem; Prasad S.S.,0,0,0,0
1668307072368,ECE 268,A00,103663,Koushanfar; Farinaz,0,0,0,0
1668307072801,ECE 269,A01,103665,Pal; Piya,0,0,0,0
1668307073227,ECE 271B,A00,103666,Vasconcelos; Manuela,0,0,0,0
1668307073672,ECE 276A,A00,103667,Atanasov; Nikolay A.,0,0,0,0
1668307074109,ECE 277,A00,103668,An; Cheolhong,0,0,0,0
1668307074531,ECE 279,A00,117947,Hall; Drew A.,0,0,0,0
1668307075394,ECE 283,A00,103670,Hsueh; Tzu-Chien,0,0,0,0
1668307075826,ECE 284,A00,103671,Turakhia; Yatish Girish,0,0,0,0
1668307076249,ECE 285,A00,103672,Zheng; Yang,0,0,0,0
1668307076249,ECE 285,B00,103673,Sworder; David D.,0,0,0,0
1668307076673,ECE 287,A00,103676,Javidi; Tara,0,0,0,0
1668307077100,MATH 200B,A00,098023,Salehi Golsefidy; Alireza,12,0,15,3
1668307077534,MATH 202B,A00,098024,Rhoades; Brendon Patrick,9,0,15,6
1668307077958,MATH 203B,A00,098025,Oprea; Dragos N.,10,0,15,5
1668307078387,MATH 204B,A00,098026,Sorensen; Claus M,13,0,15,2
1668307078811,MATH 208,A00,098027,Izadi; Elham,7,0,10,3
1668307079242,MATH 209,A00,098028,Pollack; Aaron,10,0,10,0
1668307079670,MATH 211A,A00,112919,Rogalski; Daniel,9,0,10,1
1668307080098,MATH 211B,A00,112920,Seward; Brandon M.,9,0,10,1
1668307080535,MATH 218,A00,098029,Li; Bo,10,0,10,0
1668307080963,MATH 220B,A00,098030,Novak; Jonathan I,11,0,15,4
1668307081388,MATH 221A,A00,098031,Ebenfelt; Peter F,13,0,15,2
1668307081815,MATH 231B,A00,098032,Zlatos; Andrej,12,0,15,3
1668307082253,MATH 240B,A00,098033,Ni; Lei,9,0,15,6
1668307082681,MATH 243,A00,098034,Jekel; David Andrew,10,0,10,0
1668307083129,MATH 245A,A00,098035,Nie; Jiawang,0,0,15,16
1668307083562,MATH 248,A00,098036,Bejenaru; Ioan,10,0,10,0
1668307083987,MATH 250B,A00,098037,Spolaor; Luca,14,0,15,1
1668307084415,MATH 258,A00,098038,Ni; Lei,10,0,10,0
1668307084839,MATH 264B,A00,098041,Rhoades; Brendon Patrick,9,0,15,6
1668307085275,MATH 268,A00,098042,Buss; Samuel R,10,0,10,0
1668307085704,MATH 269,A00,098043,Rhoades; Brendon Patrick,10,0,10,0
1668307086128,MATH 270B,A00,098044,Li; Bo,10,0,15,5
1668307086555,MATH 272B,A00,098045,Holst; Michael J,13,0,15,2
1668307086990,MATH 273A,A00,098046,Tian; Xiaochuan,10,0,15,5
1668307087415,MATH 275,A01,098048,Tian; Xiaochuan,6,0,10,4
1668307087839,MATH 278A,A00,098049,Holst; Michael J,8,0,10,2
1668307088272,MATH 278B,A00,098050,Cloninger; Alexander,10,0,10,0
1668307088697,MATH 278C,A00,098051,Nie; Jiawang,7,0,10,3
1668307089124,MATH 280B,A00,098052,Zheng; Tianyi,8,0,15,7
1668307089562,MATH 281B,A00,098053,Bradic; Jelena,1,0,15,14
1668307089986,MATH 282B,A00,098054,Arias-Castro; Ery,0,0,15,15
1668307090410,MATH 285,A00,098055,Fitzsimmons; Patrick J,0,0,15,17
1668307090841,MATH 287B,A00,098056,Arias-Castro; Ery,2,0,15,13
1668307091264,MATH 288,A00,098057,Agarwal; Pooja,9,0,10,1
1668307091264,MATH 288,B00,098058,Zhang; Danna,8,0,10,2
1668307091264,MATH 288,C00,098059,Williams; Ruth J,9,0,10,1
1668307091692,MATH 290B,A00,098060,Roberts; Justin Deritter,13,0,15,2
1668307092132,MATH 292,A00,098061,Belmont; Eva Kinoshita,10,0,10,0
1668307092555,MATH 295,A00,098062,Suk; Andrew Hoon,48,0,50,2
1668307092990,MATH 296,A00,098063,Novak; Jonathan I,20,0,20,0
1668307093418,MATH 297,001,098064,Gamst; Anthony Collins,9997,0,9999,2
1668307595304,COGS 205,A00,101395,Chiba; Andrea,19,0,20,1
1668307595728,COGS 210B,001,101404,Greene; Deanna Jacquelyn,9998,0,9999,1
1668307595728,COGS 210B,002,101417,Xia; Haijun,9999,0,9999,0
1668307595728,COGS 210B,003,101422,Nitz; Douglas A.,9999,0,9999,0
1668307595728,COGS 210B,004,101423,Hollan; James D.,9998,0,9999,1
1668307595728,COGS 210B,005,101424,Deak; Gedeon O.,9998,0,9999,1
1668307595728,COGS 210B,006,101425,Rossano; Federico,9999,0,9999,0
1668307596153,COGS 211B,A00,101427,Coulson; Seana M,9996,0,9999,3
1668307596577,COGS 220,A00,101428,Hollan; James D.,0,0,25,25
1668307597002,COGS 229,A00,101429,Dow; Steven P,18,0,25,7
1668307597437,COGS 230,A00,101430,Klemmer; Scott R,12,0,17,5
1668307597862,COGS 234,A00,101431,Xia; Haijun,1,0,25,24
1668307598287,COGS 260,A00,101432,Kiyonaga; Anastasia,21,0,25,4
1668307598287,COGS 260,B00,101433,Kirsh; David Joel,15,0,25,10
1668307598711,CSE 202,A00,102371,Impagliazzo; Russell,0,0,0,0
1668307599150,CSE 203B,A01,102373,Cheng; Chung Kuan,0,0,0,0
1668307599587,CSE 208,A00,102374,Micciancio; Daniele,0,0,0,0
1668307600021,CSE 209A,A00,112895,Impagliazzo; Russell,0,0,15,15
1668307600444,CSE 209B,A00,108005,Bellare; Mihir,0,0,0,0
1668307600869,CSE 210,A00,113163,Coblenz; Michael J,0,0,0,0
1668307601294,CSE 219,A00,106111,Dow; Steven P,0,0,20,20
1668307601718,CSE 221,A00,102376,Voelker; Geoffrey M.,0,0,0,0
1668307602151,CSE 224,A01,102378,Porter; George M,0,0,0,0
1668307602577,CSE 229A,A00,102379,Savage; Stefan,0,0,0,0
1668307603018,CSE 229C,A00,102380,Munyaka; Imani N. S.,0,0,0,0
1668307603455,CSE 232B,A00,102382,Deutsch; Alin Bernard,0,0,0,0
1668307603882,CSE 234,A01,112904,Kumar; Arun Kumar,0,0,0,0
1668307604307,CSE 237A,A00,102383,Rosing; Tajana Simunic,0,0,0,0
1668307604737,CSE 239A,A00,102384,Deutsch; Alin Bernard,0,0,0,0
1668307605160,CSE 239B,A00,102385,Polikarpova; Nadezhda,0,0,0,0
1668307605588,CSE 240A,A00,102386,Pannuto; Patrick William,0,0,0,0
1668307606013,CSE 240B,A00,102387,Zhao; Jishen,0,0,0,0
1668307606435,CSE 241A,A00,106406,Kang; Mingu,0,0,0,0
1668307606859,CSE 249B,A00,102388,Kahng; Andrew Byun,0,0,8,8
1668307607285,CSE 251B,A01,102392,Cottrell; Garrison W,0,0,0,0
1668307607285,CSE 251B,A02,102393,Cottrell; Garrison W,0,0,0,0
1668307607722,CSE 252B,A00,102394,Ochoa; Benjamin Lawrence,0,0,0,0
1668307608149,CSE 257,A01,102396,Gao; Sicun,0,0,0,0
1668307608575,CSE 272,A00,102397,Li; Tzumao,0,0,0,0
1668307609013,CSE 274,A00,111323,Chern; Albert Ren-Haur,0,0,0,0
1668307609442,CSE 282,A00,102398,Pevzner; Pavel Arkadjevich,0,0,0,0
1668307609865,CSE 284,A00,114175,Gymrek; Melissa Ann,0,0,0,0
1668307610292,CSE 290,A00,102399,Chandraker; Manmohan Krishna,0,0,0,0
1668307610292,CSE 290,B00,102400,Vaccaro; Kristen Marie,0,0,25,25
1668307610292,CSE 290,C00,102414,Pannuto; Patrick William,0,0,25,25
1668307610292,CSE 290,D00,102427,Pevzner; Pavel Arkadjevich,0,0,0,0
1668307610292,CSE 290,E00,102429,Zhao; Jishen,0,0,0,0
1668307610292,CSE 290,F00,102436,Tullsen; Dean Michael,0,0,0,0
1668307610292,CSE 290,G00,102440,Christensen; Henrik I,0,0,20,20
1668307610717,CSE 291,A00,102443,Su; Hao,0,0,0,0
1668307610717,CSE 291,B00,102448,Polikarpova; Nadezhda,0,0,0,0
1668307610717,CSE 291,C00,102453,Vaccaro; Kristen Marie,0,0,0,0
1668307610717,CSE 291,D00,111343,Savage; Stefan,0,0,0,0
1668307610717,CSE 291,E00,116474,Claffy; Kimberly Claire,0,0,0,0
1668307610717,CSE 291,F00,116479,Pasquale; Joseph,0,0,0,0
1668307611145,CSE 293,001,119111,Bafna; Vineet,9999,0,9999,0
1668307611145,CSE 293,002,119118,Bellare; Mihir,9999,0,9999,0
1668307611145,CSE 293,003,119122,Berg-Kirkpatrick; Taylor D,9999,0,9999,0
1668307611145,CSE 293,004,119135,Christensen; Henrik I,9999,0,9999,0
1668307611145,CSE 293,005,119142,Cottrell; Garrison W,9999,0,9999,0
1668307611145,CSE 293,006,119146,Deutsch; Alin Bernard,9999,0,9999,0
1668307611145,CSE 293,007,119159,Esmaeilzadeh; Hadi,9999,0,9999,0
1668307611145,CSE 293,008,119166,Freund; Yoav,9999,0,9999,0
1668307611145,CSE 293,009,119170,Griswold; William G.,9999,0,9999,0
1668307611145,CSE 293,010,119183,Gymrek; Melissa Ann,9999,0,9999,0
1668307611145,CSE 293,011,119190,Heninger; Nadia A,9999,0,9999,0
1668307611145,CSE 293,012,119230,Impagliazzo; Russell,9999,0,9999,0
1668307611145,CSE 293,013,119232,Jhala; Ranjit,9999,0,9999,0
1668307611145,CSE 293,014,119233,Kahng; Andrew Byun,9999,0,9999,0
1668307611145,CSE 293,015,119298,Kane; Daniel Mertz,9999,0,9999,0
1668307611145,CSE 293,016,119299,Kriegman; David J,9999,0,9999,0
1668307611145,CSE 293,017,119300,Kumar; Arun Kumar,9999,0,9999,0
1668307611145,CSE 293,018,119301,Lerner; Sorin,9999,0,9999,0
1668307611145,CSE 293,019,119302,Lovett; Shachar,9999,0,9999,0
1668307611145,CSE 293,020,119303,McAuley; Julian John,9999,0,9999,0
1668307611145,CSE 293,021,119304,Micciancio; Daniele,9999,0,9999,0
1668307611145,CSE 293,022,119367,Orailoglu; Alex,9999,0,9999,0
1668307611145,CSE 293,023,119382,Paturi; Ramamohan,9999,0,9999,0
1668307611145,CSE 293,024,119404,Polikarpova; Nadezhda,9999,0,9999,0
1668307611145,CSE 293,025,119406,Politz; Joseph Gibbs,9999,0,9999,0
1668307611145,CSE 293,026,119411,Porter; George M,9999,0,9999,0
1668307611145,CSE 293,027,119414,Porter; Leonard Emerson,9999,0,9999,0
1668307611145,CSE 293,028,119416,Ramamoorthi; Ravi,9999,0,9999,0
1668307611145,CSE 293,029,119417,Sahoo; Debashis,9999,0,9999,0
1668307611145,CSE 293,030,119420,Saul; Lawrence,9999,0,9999,0
1668307611145,CSE 293,031,119421,Savage; Stefan,9999,0,9999,0
1668307611145,CSE 293,032,119425,Schulze; Jurgen P.,9999,0,9999,0
1668307611145,CSE 293,033,119426,Snoeren; Alex C.,9999,0,9999,0
1668307611145,CSE 293,034,119428,Shang; Jingbo,9999,0,9999,0
1668307611145,CSE 293,035,119430,Stefan; Deian,9999,0,9999,0
1668307611145,CSE 293,036,119431,Su; Hao,9999,0,9999,0
1668307611145,CSE 293,037,119433,Swanson; Steven James,9999,0,9999,0
1668307611145,CSE 293,038,119435,Tullsen; Dean Michael,9999,0,9999,0
1668307611145,CSE 293,039,119483,Voelker; Geoffrey M.,9999,0,9999,0
1668307611145,CSE 293,040,119537,Zhao; Jishen,9999,0,9999,0
1668307611145,CSE 293,041,119538,Zhou; Yuan-Yuan,9999,0,9999,0
1668307611145,CSE 293,042,119539,Gao; Sicun,9999,0,9999,0
1668307611145,CSE 293,043,119540,Weibel; Nadir,9999,0,9999,0
1668307611145,CSE 293,044,119541,Gupta; Rajesh K.,9999,0,9999,0
1668307611145,CSE 293,045,126410,Vaccaro; Kristen Marie,9999,0,9999,0
1668307611145,CSE 293,046,126411,Klemke; Richard,9999,0,9999,0
1668307611571,CSE 294,A00,102459,Voelker; Geoffrey M.,0,0,0,0
1668307611571,CSE 294,B00,111322,Orailoglu; Alex,0,0,0,0
1668307612002,DSE 201,A00,096914,Deutsch; Alin Bernard,30,0,30,0
1668307612424,DSE 210,A00,096915,Dasgupta; Sanjoy,30,0,30,0
1668307612847,DSE 260A,A00,096916,Altintas De Callaf; Ilkay,30,0,30,0
1668307613283,ECE 200,001,103586,Antipa; Nicholas A,9999,0,9999,0
1668307613283,ECE 200,002,103587,Atanasov; Nikolay A.,9999,0,9999,0
1668307613283,ECE 200,003,103588,Bharadia; Dinesh,9999,0,9999,0
1668307613283,ECE 200,004,103589,Cheng; Chung Kuan,9999,0,9999,0
1668307613283,ECE 200,005,103590,Cosman; Pamela C.,9999,0,9999,0
1668307613283,ECE 200,006,103591,Dayeh; Shadi Ahmad,9999,0,9999,0
1668307613283,ECE 200,007,103592,Fainman; Yeshaiahu,9999,0,9999,0
1668307613283,ECE 200,008,103593,Ford; Joseph Earl,9999,0,9999,0
1668307613283,ECE 200,009,103594,Franceschetti; Massimo,9999,0,9999,0
1668307613283,ECE 200,010,103595,Fullerton; Eric E,9999,0,9999,0
1668307613283,ECE 200,011,103596,Galton; Ian A,9999,0,9999,0
1668307613283,ECE 200,012,103597,Gilja; Vikash,9999,0,9999,0
1668307613283,ECE 200,013,103598,Hall; Drew A.,9999,0,9999,0
1668307613283,ECE 200,014,103599,Hsueh; Tzu-Chien,9999,0,9999,0
1668307613283,ECE 200,015,103600,Javidi; Tara,9999,0,9999,0
1668307613283,ECE 200,016,103601,Kahng; Andrew Byun,9999,0,9999,0
1668307613283,ECE 200,017,103602,Kim; Young-Han,9999,0,9999,0
1668307613283,ECE 200,018,103603,Koushanfar; Farinaz,9999,0,9999,0
1668307613283,ECE 200,019,103604,Kuzum; Duygu,9999,0,9999,0
1668307613283,ECE 200,020,103605,Le; Hanh-Phuc,9999,0,9999,0
1668307613283,ECE 200,021,103606,Lin; Bill,9999,0,9999,0
1668307613283,ECE 200,022,103607,Liu; Zhaowei,9998,0,9999,1
1668307613283,ECE 200,023,103608,Lo; Yu-Hwa,9999,0,9999,0
1668307613283,ECE 200,024,103609,Lomakin; Vitaliy,9999,0,9999,0
1668307613283,ECE 200,025,103610,Mercier; Patrick Philip,9999,0,9999,0
1668307613283,ECE 200,026,103611,Meyer; Florian,9999,0,9999,0
1668307613283,ECE 200,027,103612,Milstein; Laurence B.,9999,0,9999,0
1668307613283,ECE 200,028,103613,Mir Arabbaygi; Siavash,9999,0,9999,0
1668307613283,ECE 200,029,103614,Mookherjea; Shayan,9999,0,9999,0
1668307613283,ECE 200,030,103615,Morris; Karcher William,9999,0,9999,0
1668307613283,ECE 200,031,103616,Ng; Tse Nga,9999,0,9999,0
1668307613283,ECE 200,032,103617,Nguyen; Truong Quang,9999,0,9999,0
1668307613283,ECE 200,033,103618,Nomura; Kenji,9999,0,9999,0
1668307613283,ECE 200,034,103619,Orlitsky; Alon,9999,0,9999,0
1668307613283,ECE 200,035,103620,Pal; Piya,9999,0,9999,0
1668307613283,ECE 200,036,103621,Papen; George C.,9999,0,9999,0
1668307613283,ECE 200,037,103622,Radic; Stojan,9999,0,9999,0
1668307613283,ECE 200,038,103623,Rao; Bhaskar D.,9999,0,9999,0
1668307613283,ECE 200,039,103624,Rao; Ramesh R,9999,0,9999,0
1668307613283,ECE 200,040,103625,Rebeiz; Gabriel,9999,0,9999,0
1668307613283,ECE 200,041,103626,Sanford; John R,9999,0,9999,0
1668307613283,ECE 200,042,103627,Siegel; Paul H.,9999,0,9999,0
1668307613283,ECE 200,043,103628,Sievenpiper; Daniel F.,9999,0,9999,0
1668307613283,ECE 200,044,103629,Sworder; David D.,9999,0,9999,0
1668307613283,ECE 200,045,103630,Taur; Yuan,9999,0,9999,0
1668307613283,ECE 200,046,103631,Touri; Behrouz,9999,0,9999,0
1668307613283,ECE 200,047,103632,Trivedi; Mohan M.,9999,0,9999,0
1668307613283,ECE 200,048,103633,Vasconcelos; Nuno,9999,0,9999,0
1668307613283,ECE 200,049,103634,Wang; Xiaolong,9999,0,9999,0
1668307613283,ECE 200,050,103635,Xie; Pengtao,9999,0,9999,0
1668307613283,ECE 200,051,103636,Yip; Michael,9999,0,9999,0
1668307613283,ECE 200,052,103637,Zeger; Kenneth A.,999,0,999,0
1668307613283,ECE 200,053,103638,Zhang; Xinyu,9999,0,9999,0
1668307613283,ECE 200,054,103639,Turakhia; Yatish Girish,9999,0,9999,0
1668307613283,ECE 200,055,103640,Kang; Mingu,9999,0,9999,0
1668307613283,ECE 200,056,103641,Shi; Yuanyuan,9999,0,9999,0
1668307613283,ECE 200,057,103642,Wang; Edward Jay,9999,0,9999,0
1668307613283,ECE 200,058,103643,Zheng; Yang,9999,0,9999,0
1668307613707,ECE 202,A00,103644,Kuzum; Duygu,0,0,0,0
1668307614131,ECE 212BN,A00,103646,Ng; Tse Nga,0,0,0,0
1668307614556,ECE 221,A00,111493,Staff,0,0,0,0
1668307614979,ECE 222B,A00,103647,Lomakin; Vitaliy,0,0,0,0
1668307615413,ECE 230B,A00,103648,Taur; Yuan,0,0,0,0
1668307615836,ECE 238B,A00,103649,Garay; Javier,0,0,0,0
1668307616260,ECE 240B,A00,112900,Fainman; Yeshaiahu,0,0,0,0
1668307616687,ECE 247A,A00,103650,Jokerst; Jesse Vincent,0,0,0,0
1668307617120,ECE 247B,A00,103651,Wang; Joseph,0,0,0,0
1668307617544,ECE 250,A00,103652,Siegel; Paul H.,0,0,0,0
1668307617968,ECE 251A,A00,103654,Rao; Bhaskar D.,0,0,0,0
1668307618390,ECE 257B,A00,103655,Bharadia; Dinesh,0,0,0,0
1668307618818,ECE 258A,A00,103656,Milstein; Laurence B.,0,0,0,0
1668307619246,ECE 260B,A00,103658,Kang; Mingu,0,0,0,0
1668307619676,ECE 264A,A00,103659,Galton; Ian A,0,0,0,0
1668307620103,ECE 265A,A00,103661,Gudem; Prasad S.S.,0,0,0,0
1668307620533,ECE 265D,A00,103662,Gudem; Prasad S.S.,0,0,0,0
1668307620959,ECE 268,A00,103663,Koushanfar; Farinaz,0,0,0,0
1668307621381,ECE 269,A01,103665,Pal; Piya,0,0,0,0
1668307621804,ECE 271B,A00,103666,Vasconcelos; Manuela,0,0,0,0
1668307622230,ECE 276A,A00,103667,Atanasov; Nikolay A.,0,0,0,0
1668307622654,ECE 277,A00,103668,An; Cheolhong,0,0,0,0
1668307623077,ECE 279,A00,117947,Hall; Drew A.,0,0,0,0
1668307623924,ECE 283,A00,103670,Hsueh; Tzu-Chien,0,0,0,0
1668307624352,ECE 284,A00,103671,Turakhia; Yatish Girish,0,0,0,0
1668307624778,ECE 285,A00,103672,Zheng; Yang,0,0,0,0
1668307624778,ECE 285,B00,103673,Sworder; David D.,0,0,0,0
1668307625202,ECE 287,A00,103676,Javidi; Tara,0,0,0,0
1668307625636,MATH 200B,A00,098023,Salehi Golsefidy; Alireza,12,0,15,3
1668307626062,MATH 202B,A00,098024,Rhoades; Brendon Patrick,9,0,15,6
1668307626486,MATH 203B,A00,098025,Oprea; Dragos N.,10,0,15,5
1668307626915,MATH 204B,A00,098026,Sorensen; Claus M,13,0,15,2
1668307627339,MATH 208,A00,098027,Izadi; Elham,7,0,10,3
1668307627761,MATH 209,A00,098028,Pollack; Aaron,10,0,10,0
1668307628184,MATH 211A,A00,112919,Rogalski; Daniel,9,0,10,1
1668307628610,MATH 211B,A00,112920,Seward; Brandon M.,9,0,10,1
1668307629036,MATH 218,A00,098029,Li; Bo,10,0,10,0
1668307629457,MATH 220B,A00,098030,Novak; Jonathan I,11,0,15,4
1668307629883,MATH 221A,A00,098031,Ebenfelt; Peter F,13,0,15,2
1668307630307,MATH 231B,A00,098032,Zlatos; Andrej,12,0,15,3
1668307630734,MATH 240B,A00,098033,Ni; Lei,9,0,15,6
1668307631160,MATH 243,A00,098034,Jekel; David Andrew,10,0,10,0
1668307631704,MATH 245A,A00,098035,Nie; Jiawang,0,0,15,16
1668307632130,MATH 248,A00,098036,Bejenaru; Ioan,10,0,10,0
1668307632552,MATH 250B,A00,098037,Spolaor; Luca,14,0,15,1
1668307632976,MATH 258,A00,098038,Ni; Lei,10,0,10,0
1668307633409,MATH 264B,A00,098041,Rhoades; Brendon Patrick,9,0,15,6
1668307633833,MATH 268,A00,098042,Buss; Samuel R,10,0,10,0
1668307634256,MATH 269,A00,098043,Rhoades; Brendon Patrick,10,0,10,0
1668307634683,MATH 270B,A00,098044,Li; Bo,10,0,15,5
1668307635106,MATH 272B,A00,098045,Holst; Michael J,13,0,15,2
1668307635533,MATH 273A,A00,098046,Tian; Xiaochuan,10,0,15,5
1668307635962,MATH 275,A01,098048,Tian; Xiaochuan,6,0,10,4
1668307636385,MATH 278A,A00,098049,Holst; Michael J,8,0,10,2
1668307636819,MATH 278B,A00,098050,Cloninger; Alexander,10,0,10,0
1668307637263,MATH 278C,A00,098051,Nie; Jiawang,7,0,10,3
1668307637690,MATH 280B,A00,098052,Zheng; Tianyi,8,0,15,7
1668307638125,MATH 281B,A00,098053,Bradic; Jelena,1,0,15,14
1668307638553,MATH 282B,A00,098054,Arias-Castro; Ery,0,0,15,15
1668307638979,MATH 285,A00,098055,Fitzsimmons; Patrick J,0,0,15,17
1668307639403,MATH 287B,A00,098056,Arias-Castro; Ery,2,0,15,13
1668307639826,MATH 288,A00,098057,Agarwal; Pooja,9,0,10,1
1668307639826,MATH 288,B00,098058,Zhang; Danna,8,0,10,2
1668307639826,MATH 288,C00,098059,Williams; Ruth J,9,0,10,1
1668307640253,MATH 290B,A00,098060,Roberts; Justin Deritter,13,0,15,2
1668307640677,MATH 292,A00,098061,Belmont; Eva Kinoshita,10,0,10,0
1668307641102,MATH 295,A00,098062,Suk; Andrew Hoon,48,0,50,2
1668307641527,MATH 296,A00,098063,Novak; Jonathan I,20,0,20,0
1668307641953,MATH 297,001,098064,Gamst; Anthony Collins,9997,0,9999,2
1668308142547,COGS 205,A00,101395,Chiba; Andrea,19,0,20,1
1668308142970,COGS 210B,001,101404,Greene; Deanna Jacquelyn,9998,0,9999,1
1668308142970,COGS 210B,002,101417,Xia; Haijun,9999,0,9999,0
1668308142970,COGS 210B,003,101422,Nitz; Douglas A.,9999,0,9999,0
1668308142970,COGS 210B,004,101423,Hollan; James D.,9998,0,9999,1
1668308142970,COGS 210B,005,101424,Deak; Gedeon O.,9998,0,9999,1
1668308142970,COGS 210B,006,101425,Rossano; Federico,9999,0,9999,0
1668308143393,COGS 211B,A00,101427,Coulson; Seana M,9996,0,9999,3
1668308143816,COGS 220,A00,101428,Hollan; James D.,0,0,25,25
1668308144250,COGS 229,A00,101429,Dow; Steven P,18,0,25,7
1668308144676,COGS 230,A00,101430,Klemmer; Scott R,12,0,17,5
1668308145121,COGS 234,A00,101431,Xia; Haijun,1,0,25,24
1668308145548,COGS 260,A00,101432,Kiyonaga; Anastasia,21,0,25,4
1668308145548,COGS 260,B00,101433,Kirsh; David Joel,15,0,25,10
1668308145974,CSE 202,A00,102371,Impagliazzo; Russell,0,0,0,0
1668308146401,CSE 203B,A01,102373,Cheng; Chung Kuan,0,0,0,0
1668308146828,CSE 208,A00,102374,Micciancio; Daniele,0,0,0,0
1668308147253,CSE 209A,A00,112895,Impagliazzo; Russell,0,0,15,15
1668308147681,CSE 209B,A00,108005,Bellare; Mihir,0,0,0,0
1668308148106,CSE 210,A00,113163,Coblenz; Michael J,0,0,0,0
1668308148531,CSE 219,A00,106111,Dow; Steven P,0,0,20,20
1668308148961,CSE 221,A00,102376,Voelker; Geoffrey M.,0,0,0,0
1668308149387,CSE 224,A01,102378,Porter; George M,0,0,0,0
1668308149813,CSE 229A,A00,102379,Savage; Stefan,0,0,0,0
1668308150236,CSE 229C,A00,102380,Munyaka; Imani N. S.,0,0,0,0
1668308150666,CSE 232B,A00,102382,Deutsch; Alin Bernard,0,0,0,0
1668308151094,CSE 234,A01,112904,Kumar; Arun Kumar,0,0,0,0
1668308151524,CSE 237A,A00,102383,Rosing; Tajana Simunic,0,0,0,0
1668308151950,CSE 239A,A00,102384,Deutsch; Alin Bernard,0,0,0,0
1668308152459,CSE 239B,A00,102385,Polikarpova; Nadezhda,0,0,0,0
1668308152886,CSE 240A,A00,102386,Pannuto; Patrick William,0,0,0,0
1668308153318,CSE 240B,A00,102387,Zhao; Jishen,0,0,0,0
1668308153762,CSE 241A,A00,106406,Kang; Mingu,0,0,0,0
1668308154196,CSE 249B,A00,102388,Kahng; Andrew Byun,0,0,8,8
1668308154622,CSE 251B,A01,102392,Cottrell; Garrison W,0,0,0,0
1668308154622,CSE 251B,A02,102393,Cottrell; Garrison W,0,0,0,0
1668308155048,CSE 252B,A00,102394,Ochoa; Benjamin Lawrence,0,0,0,0
1668308155483,CSE 257,A01,102396,Gao; Sicun,0,0,0,0
1668308155905,CSE 272,A00,102397,Li; Tzumao,0,0,0,0
1668308156330,CSE 274,A00,111323,Chern; Albert Ren-Haur,0,0,0,0
1668308156753,CSE 282,A00,102398,Pevzner; Pavel Arkadjevich,0,0,0,0
1668308157175,CSE 284,A00,114175,Gymrek; Melissa Ann,0,0,0,0
1668308157596,CSE 290,A00,102399,Chandraker; Manmohan Krishna,0,0,0,0
1668308157596,CSE 290,B00,102400,Vaccaro; Kristen Marie,0,0,25,25
1668308157596,CSE 290,C00,102414,Pannuto; Patrick William,0,0,25,25
1668308157596,CSE 290,D00,102427,Pevzner; Pavel Arkadjevich,0,0,0,0
1668308157596,CSE 290,E00,102429,Zhao; Jishen,0,0,0,0
1668308157596,CSE 290,F00,102436,Tullsen; Dean Michael,0,0,0,0
1668308157596,CSE 290,G00,102440,Christensen; Henrik I,0,0,20,20
1668308158021,CSE 291,A00,102443,Su; Hao,0,0,0,0
1668308158021,CSE 291,B00,102448,Polikarpova; Nadezhda,0,0,0,0
1668308158021,CSE 291,C00,102453,Vaccaro; Kristen Marie,0,0,0,0
1668308158021,CSE 291,D00,111343,Savage; Stefan,0,0,0,0
1668308158021,CSE 291,E00,116474,Claffy; Kimberly Claire,0,0,0,0
1668308158021,CSE 291,F00,116479,Pasquale; Joseph,0,0,0,0
1668308158454,CSE 293,001,119111,Bafna; Vineet,9999,0,9999,0
1668308158454,CSE 293,002,119118,Bellare; Mihir,9999,0,9999,0
1668308158454,CSE 293,003,119122,Berg-Kirkpatrick; Taylor D,9999,0,9999,0
1668308158454,CSE 293,004,119135,Christensen; Henrik I,9999,0,9999,0
1668308158454,CSE 293,005,119142,Cottrell; Garrison W,9999,0,9999,0
1668308158454,CSE 293,006,119146,Deutsch; Alin Bernard,9999,0,9999,0
1668308158454,CSE 293,007,119159,Esmaeilzadeh; Hadi,9999,0,9999,0
1668308158454,CSE 293,008,119166,Freund; Yoav,9999,0,9999,0
1668308158454,CSE 293,009,119170,Griswold; William G.,9999,0,9999,0
1668308158454,CSE 293,010,119183,Gymrek; Melissa Ann,9999,0,9999,0
1668308158454,CSE 293,011,119190,Heninger; Nadia A,9999,0,9999,0
1668308158454,CSE 293,012,119230,Impagliazzo; Russell,9999,0,9999,0
1668308158454,CSE 293,013,119232,Jhala; Ranjit,9999,0,9999,0
1668308158454,CSE 293,014,119233,Kahng; Andrew Byun,9999,0,9999,0
1668308158454,CSE 293,015,119298,Kane; Daniel Mertz,9999,0,9999,0
1668308158454,CSE 293,016,119299,Kriegman; David J,9999,0,9999,0
1668308158454,CSE 293,017,119300,Kumar; Arun Kumar,9999,0,9999,0
1668308158454,CSE 293,018,119301,Lerner; Sorin,9999,0,9999,0
1668308158454,CSE 293,019,119302,Lovett; Shachar,9999,0,9999,0
1668308158454,CSE 293,020,119303,McAuley; Julian John,9999,0,9999,0
1668308158454,CSE 293,021,119304,Micciancio; Daniele,9999,0,9999,0
1668308158454,CSE 293,022,119367,Orailoglu; Alex,9999,0,9999,0
1668308158454,CSE 293,023,119382,Paturi; Ramamohan,9999,0,9999,0
1668308158454,CSE 293,024,119404,Polikarpova; Nadezhda,9999,0,9999,0
1668308158454,CSE 293,025,119406,Politz; Joseph Gibbs,9999,0,9999,0
1668308158454,CSE 293,026,119411,Porter; George M,9999,0,9999,0
1668308158454,CSE 293,027,119414,Porter; Leonard Emerson,9999,0,9999,0
1668308158454,CSE 293,028,119416,Ramamoorthi; Ravi,9999,0,9999,0
1668308158454,CSE 293,029,119417,Sahoo; Debashis,9999,0,9999,0
1668308158454,CSE 293,030,119420,Saul; Lawrence,9999,0,9999,0
1668308158454,CSE 293,031,119421,Savage; Stefan,9999,0,9999,0
1668308158454,CSE 293,032,119425,Schulze; Jurgen P.,9999,0,9999,0
1668308158454,CSE 293,033,119426,Snoeren; Alex C.,9999,0,9999,0
1668308158454,CSE 293,034,119428,Shang; Jingbo,9999,0,9999,0
1668308158454,CSE 293,035,119430,Stefan; Deian,9999,0,9999,0
1668308158454,CSE 293,036,119431,Su; Hao,9999,0,9999,0
1668308158454,CSE 293,037,119433,Swanson; Steven James,9999,0,9999,0
1668308158454,CSE 293,038,119435,Tullsen; Dean Michael,9999,0,9999,0
1668308158454,CSE 293,039,119483,Voelker; Geoffrey M.,9999,0,9999,0
1668308158454,CSE 293,040,119537,Zhao; Jishen,9999,0,9999,0
1668308158454,CSE 293,041,119538,Zhou; Yuan-Yuan,9999,0,9999,0
1668308158454,CSE 293,042,119539,Gao; Sicun,9999,0,9999,0
1668308158454,CSE 293,043,119540,Weibel; Nadir,9999,0,9999,0
1668308158454,CSE 293,044,119541,Gupta; Rajesh K.,9999,0,9999,0
1668308158454,CSE 293,045,126410,Vaccaro; Kristen Marie,9999,0,9999,0
1668308158454,CSE 293,046,126411,Klemke; Richard,9999,0,9999,0
1668308158885,CSE 294,A00,102459,Voelker; Geoffrey M.,0,0,0,0
1668308158885,CSE 294,B00,111322,Orailoglu; Alex,0,0,0,0
1668308159318,DSE 201,A00,096914,Deutsch; Alin Bernard,30,0,30,0
1668308159742,DSE 210,A00,096915,Dasgupta; Sanjoy,30,0,30,0
1668308160175,DSE 260A,A00,096916,Altintas De Callaf; Ilkay,30,0,30,0
1668308160604,ECE 200,001,103586,Antipa; Nicholas A,9999,0,9999,0
1668308160604,ECE 200,002,103587,Atanasov; Nikolay A.,9999,0,9999,0
1668308160604,ECE 200,003,103588,Bharadia; Dinesh,9999,0,9999,0
1668308160604,ECE 200,004,103589,Cheng; Chung Kuan,9999,0,9999,0
1668308160604,ECE 200,005,103590,Cosman; Pamela C.,9999,0,9999,0
1668308160604,ECE 200,006,103591,Dayeh; Shadi Ahmad,9999,0,9999,0
1668308160604,ECE 200,007,103592,Fainman; Yeshaiahu,9999,0,9999,0
1668308160604,ECE 200,008,103593,Ford; Joseph Earl,9999,0,9999,0
1668308160604,ECE 200,009,103594,Franceschetti; Massimo,9999,0,9999,0
1668308160604,ECE 200,010,103595,Fullerton; Eric E,9999,0,9999,0
1668308160604,ECE 200,011,103596,Galton; Ian A,9999,0,9999,0
1668308160604,ECE 200,012,103597,Gilja; Vikash,9999,0,9999,0
1668308160604,ECE 200,013,103598,Hall; Drew A.,9999,0,9999,0
1668308160604,ECE 200,014,103599,Hsueh; Tzu-Chien,9999,0,9999,0
1668308160604,ECE 200,015,103600,Javidi; Tara,9999,0,9999,0
1668308160604,ECE 200,016,103601,Kahng; Andrew Byun,9999,0,9999,0
1668308160604,ECE 200,017,103602,Kim; Young-Han,9999,0,9999,0
1668308160604,ECE 200,018,103603,Koushanfar; Farinaz,9999,0,9999,0
1668308160604,ECE 200,019,103604,Kuzum; Duygu,9999,0,9999,0
1668308160604,ECE 200,020,103605,Le; Hanh-Phuc,9999,0,9999,0
1668308160604,ECE 200,021,103606,Lin; Bill,9999,0,9999,0
1668308160604,ECE 200,022,103607,Liu; Zhaowei,9998,0,9999,1
1668308160604,ECE 200,023,103608,Lo; Yu-Hwa,9999,0,9999,0
1668308160604,ECE 200,024,103609,Lomakin; Vitaliy,9999,0,9999,0
1668308160604,ECE 200,025,103610,Mercier; Patrick Philip,9999,0,9999,0
1668308160604,ECE 200,026,103611,Meyer; Florian,9999,0,9999,0
1668308160604,ECE 200,027,103612,Milstein; Laurence B.,9999,0,9999,0
1668308160604,ECE 200,028,103613,Mir Arabbaygi; Siavash,9999,0,9999,0
1668308160604,ECE 200,029,103614,Mookherjea; Shayan,9999,0,9999,0
1668308160604,ECE 200,030,103615,Morris; Karcher William,9999,0,9999,0
1668308160604,ECE 200,031,103616,Ng; Tse Nga,9999,0,9999,0
1668308160604,ECE 200,032,103617,Nguyen; Truong Quang,9999,0,9999,0
1668308160604,ECE 200,033,103618,Nomura; Kenji,9999,0,9999,0
1668308160604,ECE 200,034,103619,Orlitsky; Alon,9999,0,9999,0
1668308160604,ECE 200,035,103620,Pal; Piya,9999,0,9999,0
1668308160604,ECE 200,036,103621,Papen; George C.,9999,0,9999,0
1668308160604,ECE 200,037,103622,Radic; Stojan,9999,0,9999,0
1668308160604,ECE 200,038,103623,Rao; Bhaskar D.,9999,0,9999,0
1668308160604,ECE 200,039,103624,Rao; Ramesh R,9999,0,9999,0
1668308160604,ECE 200,040,103625,Rebeiz; Gabriel,9999,0,9999,0
1668308160604,ECE 200,041,103626,Sanford; John R,9999,0,9999,0
1668308160604,ECE 200,042,103627,Siegel; Paul H.,9999,0,9999,0
1668308160604,ECE 200,043,103628,Sievenpiper; Daniel F.,9999,0,9999,0
1668308160604,ECE 200,044,103629,Sworder; David D.,9999,0,9999,0
1668308160604,ECE 200,045,103630,Taur; Yuan,9999,0,9999,0
1668308160604,ECE 200,046,103631,Touri; Behrouz,9999,0,9999,0
1668308160604,ECE 200,047,103632,Trivedi; Mohan M.,9999,0,9999,0
1668308160604,ECE 200,048,103633,Vasconcelos; Nuno,9999,0,9999,0
1668308160604,ECE 200,049,103634,Wang; Xiaolong,9999,0,9999,0
1668308160604,ECE 200,050,103635,Xie; Pengtao,9999,0,9999,0
1668308160604,ECE 200,051,103636,Yip; Michael,9999,0,9999,0
1668308160604,ECE 200,052,103637,Zeger; Kenneth A.,999,0,999,0
1668308160604,ECE 200,053,103638,Zhang; Xinyu,9999,0,9999,0
1668308160604,ECE 200,054,103639,Turakhia; Yatish Girish,9999,0,9999,0
1668308160604,ECE 200,055,103640,Kang; Mingu,9999,0,9999,0
1668308160604,ECE 200,056,103641,Shi; Yuanyuan,9999,0,9999,0
1668308160604,ECE 200,057,103642,Wang; Edward Jay,9999,0,9999,0
1668308160604,ECE 200,058,103643,Zheng; Yang,9999,0,9999,0
1668308161027,ECE 202,A00,103644,Kuzum; Duygu,0,0,0,0
1668308161450,ECE 212BN,A00,103646,Ng; Tse Nga,0,0,0,0
1668308161874,ECE 221,A00,111493,Staff,0,0,0,0
1668308162300,ECE 222B,A00,103647,Lomakin; Vitaliy,0,0,0,0
1668308162726,ECE 230B,A00,103648,Taur; Yuan,0,0,0,0
1668308163150,ECE 238B,A00,103649,Garay; Javier,0,0,0,0
1668308163572,ECE 240B,A00,112900,Fainman; Yeshaiahu,0,0,0,0
1668308163998,ECE 247A,A00,103650,Jokerst; Jesse Vincent,0,0,0,0
1668308164434,ECE 247B,A00,103651,Wang; Joseph,0,0,0,0
1668308164863,ECE 250,A00,103652,Siegel; Paul H.,0,0,0,0
1668308165294,ECE 251A,A00,103654,Rao; Bhaskar D.,0,0,0,0
1668308165718,ECE 257B,A00,103655,Bharadia; Dinesh,0,0,0,0
1668308166146,ECE 258A,A00,103656,Milstein; Laurence B.,0,0,0,0
1668308166570,ECE 260B,A00,103658,Kang; Mingu,0,0,0,0
1668308166998,ECE 264A,A00,103659,Galton; Ian A,0,0,0,0
1668308167424,ECE 265A,A00,103661,Gudem; Prasad S.S.,0,0,0,0
1668308167847,ECE 265D,A00,103662,Gudem; Prasad S.S.,0,0,0,0
1668308168278,ECE 268,A00,103663,Koushanfar; Farinaz,0,0,0,0
1668308168702,ECE 269,A01,103665,Pal; Piya,0,0,0,0
1668308169126,ECE 271B,A00,103666,Vasconcelos; Manuela,0,0,0,0
1668308169552,ECE 276A,A00,103667,Atanasov; Nikolay A.,0,0,0,0
1668308169992,ECE 277,A00,103668,An; Cheolhong,0,0,0,0
1668308170422,ECE 279,A00,117947,Hall; Drew A.,0,0,0,0
1668308171278,ECE 283,A00,103670,Hsueh; Tzu-Chien,0,0,0,0
1668308171701,ECE 284,A00,103671,Turakhia; Yatish Girish,0,0,0,0
1668308172126,ECE 285,A00,103672,Zheng; Yang,0,0,0,0
1668308172126,ECE 285,B00,103673,Sworder; David D.,0,0,0,0
1668308172552,ECE 287,A00,103676,Javidi; Tara,0,0,0,0
1668308172974,MATH 200B,A00,098023,Salehi Golsefidy; Alireza,12,0,15,3
1668308173399,MATH 202B,A00,098024,Rhoades; Brendon Patrick,9,0,15,6
1668308173824,MATH 203B,A00,098025,Oprea; Dragos N.,10,0,15,5
1668308174248,MATH 204B,A00,098026,Sorensen; Claus M,13,0,15,2
1668308174674,MATH 208,A00,098027,Izadi; Elham,7,0,10,3
1668308175108,MATH 209,A00,098028,Pollack; Aaron,10,0,10,0
1668308175531,MATH 211A,A00,112919,Rogalski; Daniel,9,0,10,1
1668308175959,MATH 211B,A00,112920,Seward; Brandon M.,9,0,10,1
1668308176386,MATH 218,A00,098029,Li; Bo,10,0,10,0
1668308176812,MATH 220B,A00,098030,Novak; Jonathan I,11,0,15,4
1668308177239,MATH 221A,A00,098031,Ebenfelt; Peter F,13,0,15,2
1668308177663,MATH 231B,A00,098032,Zlatos; Andrej,12,0,15,3
1668308178089,MATH 240B,A00,098033,Ni; Lei,9,0,15,6
1668308178515,MATH 243,A00,098034,Jekel; David Andrew,10,0,10,0
1668308178939,MATH 245A,A00,098035,Nie; Jiawang,0,0,15,16
1668308179365,MATH 248,A00,098036,Bejenaru; Ioan,10,0,10,0
1668308179798,MATH 250B,A00,098037,Spolaor; Luca,14,0,15,1
1668308180232,MATH 258,A00,098038,Ni; Lei,10,0,10,0
1668308180657,MATH 264B,A00,098041,Rhoades; Brendon Patrick,9,0,15,6
1668308181093,MATH 268,A00,098042,Buss; Samuel R,10,0,10,0
1668308181528,MATH 269,A00,098043,Rhoades; Brendon Patrick,10,0,10,0
1668308181951,MATH 270B,A00,098044,Li; Bo,10,0,15,5
1668308182388,MATH 272B,A00,098045,Holst; Michael J,13,0,15,2
1668308182813,MATH 273A,A00,098046,Tian; Xiaochuan,10,0,15,5
1668308183238,MATH 275,A01,098048,Tian; Xiaochuan,6,0,10,4
1668308183660,MATH 278A,A00,098049,Holst; Michael J,8,0,10,2
1668308184092,MATH 278B,A00,098050,Cloninger; Alexander,10,0,10,0
1668308184518,MATH 278C,A00,098051,Nie; Jiawang,7,0,10,3
1668308184941,MATH 280B,A00,098052,Zheng; Tianyi,8,0,15,7
1668308185370,MATH 281B,A00,098053,Bradic; Jelena,1,0,15,14
1668308185805,MATH 282B,A00,098054,Arias-Castro; Ery,0,0,15,15
1668308186230,MATH 285,A00,098055,Fitzsimmons; Patrick J,0,0,15,17
1668308186657,MATH 287B,A00,098056,Arias-Castro; Ery,2,0,15,13
1668308187084,MATH 288,A00,098057,Agarwal; Pooja,9,0,10,1
1668308187084,MATH 288,B00,098058,Zhang; Danna,8,0,10,2
1668308187084,MATH 288,C00,098059,Williams; Ruth J,9,0,10,1
1668308187516,MATH 290B,A00,098060,Roberts; Justin Deritter,13,0,15,2
1668308187946,MATH 292,A00,098061,Belmont; Eva Kinoshita,10,0,10,0
1668308188372,MATH 295,A00,098062,Suk; Andrew Hoon,48,0,50,2
1668308188795,MATH 296,A00,098063,Novak; Jonathan I,20,0,20,0
1668308189219,MATH 297,001,098064,Gamst; Anthony Collins,9997,0,9999,2
1668308689673,COGS 205,A00,101395,Chiba; Andrea,19,0,20,1
1668308690099,COGS 210B,001,101404,Greene; Deanna Jacquelyn,9998,0,9999,1
1668308690099,COGS 210B,002,101417,Xia; Haijun,9999,0,9999,0
1668308690099,COGS 210B,003,101422,Nitz; Douglas A.,9999,0,9999,0
1668308690099,COGS 210B,004,101423,Hollan; James D.,9998,0,9999,1
1668308690099,COGS 210B,005,101424,Deak; Gedeon O.,9998,0,9999,1
1668308690099,COGS 210B,006,101425,Rossano; Federico,9999,0,9999,0
1668308690523,COGS 211B,A00,101427,Coulson; Seana M,9996,0,9999,3
1668308690949,COGS 220,A00,101428,Hollan; James D.,0,0,25,25
1668308691375,COGS 229,A00,101429,Dow; Steven P,18,0,25,7
1668308691805,COGS 230,A00,101430,Klemmer; Scott R,12,0,17,5
1668308692229,COGS 234,A00,101431,Xia; Haijun,1,0,25,24
1668308692654,COGS 260,A00,101432,Kiyonaga; Anastasia,21,0,25,4
1668308692654,COGS 260,B00,101433,Kirsh; David Joel,15,0,25,10
1668308693077,CSE 202,A00,102371,Impagliazzo; Russell,0,0,0,0
1668308693503,CSE 203B,A01,102373,Cheng; Chung Kuan,0,0,0,0
1668308693927,CSE 208,A00,102374,Micciancio; Daniele,0,0,0,0
1668308694353,CSE 209A,A00,112895,Impagliazzo; Russell,0,0,15,15
1668308694774,CSE 209B,A00,108005,Bellare; Mihir,0,0,0,0
1668308695199,CSE 210,A00,113163,Coblenz; Michael J,0,0,0,0
1668308695627,CSE 219,A00,106111,Dow; Steven P,0,0,20,20
1668308696054,CSE 221,A00,102376,Voelker; Geoffrey M.,0,0,0,0
1668308696481,CSE 224,A01,102378,Porter; George M,0,0,0,0
1668308696914,CSE 229A,A00,102379,Savage; Stefan,0,0,0,0
1668308697339,CSE 229C,A00,102380,Munyaka; Imani N. S.,0,0,0,0
1668308697764,CSE 232B,A00,102382,Deutsch; Alin Bernard,0,0,0,0
1668308698186,CSE 234,A01,112904,Kumar; Arun Kumar,0,0,0,0
1668308698610,CSE 237A,A00,102383,Rosing; Tajana Simunic,0,0,0,0
1668308699034,CSE 239A,A00,102384,Deutsch; Alin Bernard,0,0,0,0
1668308699463,CSE 239B,A00,102385,Polikarpova; Nadezhda,0,0,0,0
1668308699886,CSE 240A,A00,102386,Pannuto; Patrick William,0,0,0,0
1668308700309,CSE 240B,A00,102387,Zhao; Jishen,0,0,0,0
1668308700735,CSE 241A,A00,106406,Kang; Mingu,0,0,0,0
1668308701171,CSE 249B,A00,102388,Kahng; Andrew Byun,0,0,8,8
1668308701597,CSE 251B,A01,102392,Cottrell; Garrison W,0,0,0,0
1668308701597,CSE 251B,A02,102393,Cottrell; Garrison W,0,0,0,0
1668308702023,CSE 252B,A00,102394,Ochoa; Benjamin Lawrence,0,0,0,0
1668308702449,CSE 257,A01,102396,Gao; Sicun,0,0,0,0
1668308702873,CSE 272,A00,102397,Li; Tzumao,0,0,0,0
1668308703299,CSE 274,A00,111323,Chern; Albert Ren-Haur,0,0,0,0
1668308703730,CSE 282,A00,102398,Pevzner; Pavel Arkadjevich,0,0,0,0
1668308704155,CSE 284,A00,114175,Gymrek; Melissa Ann,0,0,0,0
1668308704589,CSE 290,A00,102399,Chandraker; Manmohan Krishna,0,0,0,0
1668308704589,CSE 290,B00,102400,Vaccaro; Kristen Marie,0,0,25,25
1668308704589,CSE 290,C00,102414,Pannuto; Patrick William,0,0,25,25
1668308704589,CSE 290,D00,102427,Pevzner; Pavel Arkadjevich,0,0,0,0
1668308704589,CSE 290,E00,102429,Zhao; Jishen,0,0,0,0
1668308704589,CSE 290,F00,102436,Tullsen; Dean Michael,0,0,0,0
1668308704589,CSE 290,G00,102440,Christensen; Henrik I,0,0,20,20
1668308705013,CSE 291,A00,102443,Su; Hao,0,0,0,0
1668308705013,CSE 291,B00,102448,Polikarpova; Nadezhda,0,0,0,0
1668308705013,CSE 291,C00,102453,Vaccaro; Kristen Marie,0,0,0,0
1668308705013,CSE 291,D00,111343,Savage; Stefan,0,0,0,0
1668308705013,CSE 291,E00,116474,Claffy; Kimberly Claire,0,0,0,0
1668308705013,CSE 291,F00,116479,Pasquale; Joseph,0,0,0,0
1668308705457,CSE 293,001,119111,Bafna; Vineet,9999,0,9999,0
1668308705457,CSE 293,002,119118,Bellare; Mihir,9999,0,9999,0
1668308705457,CSE 293,003,119122,Berg-Kirkpatrick; Taylor D,9999,0,9999,0
1668308705457,CSE 293,004,119135,Christensen; Henrik I,9999,0,9999,0
1668308705457,CSE 293,005,119142,Cottrell; Garrison W,9999,0,9999,0
1668308705457,CSE 293,006,119146,Deutsch; Alin Bernard,9999,0,9999,0
1668308705457,CSE 293,007,119159,Esmaeilzadeh; Hadi,9999,0,9999,0
1668308705457,CSE 293,008,119166,Freund; Yoav,9999,0,9999,0
1668308705457,CSE 293,009,119170,Griswold; William G.,9999,0,9999,0
1668308705457,CSE 293,010,119183,Gymrek; Melissa Ann,9999,0,9999,0
1668308705457,CSE 293,011,119190,Heninger; Nadia A,9999,0,9999,0
1668308705457,CSE 293,012,119230,Impagliazzo; Russell,9999,0,9999,0
1668308705457,CSE 293,013,119232,Jhala; Ranjit,9999,0,9999,0
1668308705457,CSE 293,014,119233,Kahng; Andrew Byun,9999,0,9999,0
1668308705457,CSE 293,015,119298,Kane; Daniel Mertz,9999,0,9999,0
1668308705457,CSE 293,016,119299,Kriegman; David J,9999,0,9999,0
1668308705457,CSE 293,017,119300,Kumar; Arun Kumar,9999,0,9999,0
1668308705457,CSE 293,018,119301,Lerner; Sorin,9999,0,9999,0
1668308705457,CSE 293,019,119302,Lovett; Shachar,9999,0,9999,0
1668308705457,CSE 293,020,119303,McAuley; Julian John,9999,0,9999,0
1668308705457,CSE 293,021,119304,Micciancio; Daniele,9999,0,9999,0
1668308705457,CSE 293,022,119367,Orailoglu; Alex,9999,0,9999,0
1668308705457,CSE 293,023,119382,Paturi; Ramamohan,9999,0,9999,0
1668308705457,CSE 293,024,119404,Polikarpova; Nadezhda,9999,0,9999,0
1668308705457,CSE 293,025,119406,Politz; Joseph Gibbs,9999,0,9999,0
1668308705457,CSE 293,026,119411,Porter; George M,9999,0,9999,0
1668308705457,CSE 293,027,119414,Porter; Leonard Emerson,9999,0,9999,0
1668308705457,CSE 293,028,119416,Ramamoorthi; Ravi,9999,0,9999,0
1668308705457,CSE 293,029,119417,Sahoo; Debashis,9999,0,9999,0
1668308705457,CSE 293,030,119420,Saul; Lawrence,9999,0,9999,0
1668308705457,CSE 293,031,119421,Savage; Stefan,9999,0,9999,0
1668308705457,CSE 293,032,119425,Schulze; Jurgen P.,9999,0,9999,0
1668308705457,CSE 293,033,119426,Snoeren; Alex C.,9999,0,9999,0
1668308705457,CSE 293,034,119428,Shang; Jingbo,9999,0,9999,0
1668308705457,CSE 293,035,119430,Stefan; Deian,9999,0,9999,0
1668308705457,CSE 293,036,119431,Su; Hao,9999,0,9999,0
1668308705457,CSE 293,037,119433,Swanson; Steven James,9999,0,9999,0
1668308705457,CSE 293,038,119435,Tullsen; Dean Michael,9999,0,9999,0
1668308705457,CSE 293,039,119483,Voelker; Geoffrey M.,9999,0,9999,0
1668308705457,CSE 293,040,119537,Zhao; Jishen,9999,0,9999,0
1668308705457,CSE 293,041,119538,Zhou; Yuan-Yuan,9999,0,9999,0
1668308705457,CSE 293,042,119539,Gao; Sicun,9999,0,9999,0
1668308705457,CSE 293,043,119540,Weibel; Nadir,9999,0,9999,0
1668308705457,CSE 293,044,119541,Gupta; Rajesh K.,9999,0,9999,0
1668308705457,CSE 293,045,126410,Vaccaro; Kristen Marie,9999,0,9999,0
1668308705457,CSE 293,046,126411,Klemke; Richard,9999,0,9999,0
1668308705881,CSE 294,A00,102459,Voelker; Geoffrey M.,0,0,0,0
1668308705881,CSE 294,B00,111322,Orailoglu; Alex,0,0,0,0
1668308706307,DSE 201,A00,096914,Deutsch; Alin Bernard,30,0,30,0
1668308706733,DSE 210,A00,096915,Dasgupta; Sanjoy,30,0,30,0
1668308707157,DSE 260A,A00,096916,Altintas De Callaf; Ilkay,30,0,30,0
1668308707588,ECE 200,001,103586,Antipa; Nicholas A,9999,0,9999,0
1668308707588,ECE 200,002,103587,Atanasov; Nikolay A.,9999,0,9999,0
1668308707588,ECE 200,003,103588,Bharadia; Dinesh,9999,0,9999,0
1668308707588,ECE 200,004,103589,Cheng; Chung Kuan,9999,0,9999,0
1668308707588,ECE 200,005,103590,Cosman; Pamela C.,9999,0,9999,0
1668308707588,ECE 200,006,103591,Dayeh; Shadi Ahmad,9999,0,9999,0
1668308707588,ECE 200,007,103592,Fainman; Yeshaiahu,9999,0,9999,0
1668308707588,ECE 200,008,103593,Ford; Joseph Earl,9999,0,9999,0
1668308707588,ECE 200,009,103594,Franceschetti; Massimo,9999,0,9999,0
1668308707588,ECE 200,010,103595,Fullerton; Eric E,9999,0,9999,0
1668308707588,ECE 200,011,103596,Galton; Ian A,9999,0,9999,0
1668308707588,ECE 200,012,103597,Gilja; Vikash,9999,0,9999,0
1668308707588,ECE 200,013,103598,Hall; Drew A.,9999,0,9999,0
1668308707588,ECE 200,014,103599,Hsueh; Tzu-Chien,9999,0,9999,0
1668308707588,ECE 200,015,103600,Javidi; Tara,9999,0,9999,0
1668308707588,ECE 200,016,103601,Kahng; Andrew Byun,9999,0,9999,0
1668308707588,ECE 200,017,103602,Kim; Young-Han,9999,0,9999,0
1668308707588,ECE 200,018,103603,Koushanfar; Farinaz,9999,0,9999,0
1668308707588,ECE 200,019,103604,Kuzum; Duygu,9999,0,9999,0
1668308707588,ECE 200,020,103605,Le; Hanh-Phuc,9999,0,9999,0
1668308707588,ECE 200,021,103606,Lin; Bill,9999,0,9999,0
1668308707588,ECE 200,022,103607,Liu; Zhaowei,9998,0,9999,1
1668308707588,ECE 200,023,103608,Lo; Yu-Hwa,9999,0,9999,0
1668308707588,ECE 200,024,103609,Lomakin; Vitaliy,9999,0,9999,0
1668308707588,ECE 200,025,103610,Mercier; Patrick Philip,9999,0,9999,0
1668308707588,ECE 200,026,103611,Meyer; Florian,9999,0,9999,0
1668308707588,ECE 200,027,103612,Milstein; Laurence B.,9999,0,9999,0
1668308707588,ECE 200,028,103613,Mir Arabbaygi; Siavash,9999,0,9999,0
1668308707588,ECE 200,029,103614,Mookherjea; Shayan,9999,0,9999,0
1668308707588,ECE 200,030,103615,Morris; Karcher William,9999,0,9999,0
1668308707588,ECE 200,031,103616,Ng; Tse Nga,9999,0,9999,0
1668308707588,ECE 200,032,103617,Nguyen; Truong Quang,9999,0,9999,0
1668308707588,ECE 200,033,103618,Nomura; Kenji,9999,0,9999,0
1668308707588,ECE 200,034,103619,Orlitsky; Alon,9999,0,9999,0
1668308707588,ECE 200,035,103620,Pal; Piya,9999,0,9999,0
1668308707588,ECE 200,036,103621,Papen; George C.,9999,0,9999,0
1668308707588,ECE 200,037,103622,Radic; Stojan,9999,0,9999,0
1668308707588,ECE 200,038,103623,Rao; Bhaskar D.,9999,0,9999,0
1668308707588,ECE 200,039,103624,Rao; Ramesh R,9999,0,9999,0
1668308707588,ECE 200,040,103625,Rebeiz; Gabriel,9999,0,9999,0
1668308707588,ECE 200,041,103626,Sanford; John R,9999,0,9999,0
1668308707588,ECE 200,042,103627,Siegel; Paul H.,9999,0,9999,0
1668308707588,ECE 200,043,103628,Sievenpiper; Daniel F.,9999,0,9999,0
1668308707588,ECE 200,044,103629,Sworder; David D.,9999,0,9999,0
1668308707588,ECE 200,045,103630,Taur; Yuan,9999,0,9999,0
1668308707588,ECE 200,046,103631,Touri; Behrouz,9999,0,9999,0
1668308707588,ECE 200,047,103632,Trivedi; Mohan M.,9999,0,9999,0
1668308707588,ECE 200,048,103633,Vasconcelos; Nuno,9999,0,9999,0
1668308707588,ECE 200,049,103634,Wang; Xiaolong,9999,0,9999,0
1668308707588,ECE 200,050,103635,Xie; Pengtao,9999,0,9999,0
1668308707588,ECE 200,051,103636,Yip; Michael,9999,0,9999,0
1668308707588,ECE 200,052,103637,Zeger; Kenneth A.,999,0,999,0
1668308707588,ECE 200,053,103638,Zhang; Xinyu,9999,0,9999,0
1668308707588,ECE 200,054,103639,Turakhia; Yatish Girish,9999,0,9999,0
1668308707588,ECE 200,055,103640,Kang; Mingu,9999,0,9999,0
1668308707588,ECE 200,056,103641,Shi; Yuanyuan,9999,0,9999,0
1668308707588,ECE 200,057,103642,Wang; Edward Jay,9999,0,9999,0
1668308707588,ECE 200,058,103643,Zheng; Yang,9999,0,9999,0
1668308708010,ECE 202,A00,103644,Kuzum; Duygu,0,0,0,0
1668308708434,ECE 212BN,A00,103646,Ng; Tse Nga,0,0,0,0
1668308708861,ECE 221,A00,111493,Staff,0,0,0,0
1668308709283,ECE 222B,A00,103647,Lomakin; Vitaliy,0,0,0,0
1668308709707,ECE 230B,A00,103648,Taur; Yuan,0,0,0,0
1668308710133,ECE 238B,A00,103649,Garay; Javier,0,0,0,0
1668308710557,ECE 240B,A00,112900,Fainman; Yeshaiahu,0,0,0,0
1668308710980,ECE 247A,A00,103650,Jokerst; Jesse Vincent,0,0,0,0
1668308711428,ECE 247B,A00,103651,Wang; Joseph,0,0,0,0
1668308711855,ECE 250,A00,103652,Siegel; Paul H.,0,0,0,0
1668308712279,ECE 251A,A00,103654,Rao; Bhaskar D.,0,0,0,0
1668308712703,ECE 257B,A00,103655,Bharadia; Dinesh,0,0,0,0
1668308713133,ECE 258A,A00,103656,Milstein; Laurence B.,0,0,0,0
1668308713559,ECE 260B,A00,103658,Kang; Mingu,0,0,0,0
1668308713988,ECE 264A,A00,103659,Galton; Ian A,0,0,0,0
1668308714415,ECE 265A,A00,103661,Gudem; Prasad S.S.,0,0,0,0
1668308714840,ECE 265D,A00,103662,Gudem; Prasad S.S.,0,0,0,0
1668308715263,ECE 268,A00,103663,Koushanfar; Farinaz,0,0,0,0
1668308715687,ECE 269,A01,103665,Pal; Piya,0,0,0,0
1668308716203,ECE 271B,A00,103666,Vasconcelos; Manuela,0,0,0,0
1668308716631,ECE 276A,A00,103667,Atanasov; Nikolay A.,0,0,0,0
1668308717054,ECE 277,A00,103668,An; Cheolhong,0,0,0,0
1668308717497,ECE 279,A00,117947,Hall; Drew A.,0,0,0,0
1668308718348,ECE 283,A00,103670,Hsueh; Tzu-Chien,0,0,0,0
1668308718791,ECE 284,A00,103671,Turakhia; Yatish Girish,0,0,0,0
1668308719229,ECE 285,A00,103672,Zheng; Yang,0,0,0,0
1668308719229,ECE 285,B00,103673,Sworder; David D.,0,0,0,0
1668308719652,ECE 287,A00,103676,Javidi; Tara,0,0,0,0
1668308720076,MATH 200B,A00,098023,Salehi Golsefidy; Alireza,12,0,15,3
1668308720500,MATH 202B,A00,098024,Rhoades; Brendon Patrick,9,0,15,6
1668308720922,MATH 203B,A00,098025,Oprea; Dragos N.,10,0,15,5
1668308721360,MATH 204B,A00,098026,Sorensen; Claus M,13,0,15,2
1668308721786,MATH 208,A00,098027,Izadi; Elham,7,0,10,3
1668308722208,MATH 209,A00,098028,Pollack; Aaron,10,0,10,0
1668308722631,MATH 211A,A00,112919,Rogalski; Daniel,9,0,10,1
1668308723064,MATH 211B,A00,112920,Seward; Brandon M.,9,0,10,1
1668308723493,MATH 218,A00,098029,Li; Bo,10,0,10,0
1668308723916,MATH 220B,A00,098030,Novak; Jonathan I,11,0,15,4
1668308724345,MATH 221A,A00,098031,Ebenfelt; Peter F,13,0,15,2
1668308724784,MATH 231B,A00,098032,Zlatos; Andrej,12,0,15,3
1668308725212,MATH 240B,A00,098033,Ni; Lei,9,0,15,6
1668308725647,MATH 243,A00,098034,Jekel; David Andrew,10,0,10,0
1668308726075,MATH 245A,A00,098035,Nie; Jiawang,0,0,15,16
1668308726499,MATH 248,A00,098036,Bejenaru; Ioan,10,0,10,0
1668308726930,MATH 250B,A00,098037,Spolaor; Luca,14,0,15,1
1668308727369,MATH 258,A00,098038,Ni; Lei,10,0,10,0
1668308727795,MATH 264B,A00,098041,Rhoades; Brendon Patrick,9,0,15,6
1668308728217,MATH 268,A00,098042,Buss; Samuel R,10,0,10,0
1668308728643,MATH 269,A00,098043,Rhoades; Brendon Patrick,10,0,10,0
1668308729073,MATH 270B,A00,098044,Li; Bo,10,0,15,5
1668308729504,MATH 272B,A00,098045,Holst; Michael J,13,0,15,2
1668308729927,MATH 273A,A00,098046,Tian; Xiaochuan,10,0,15,5
1668308730351,MATH 275,A01,098048,Tian; Xiaochuan,6,0,10,4
1668308730776,MATH 278A,A00,098049,Holst; Michael J,8,0,10,2
1668308731198,MATH 278B,A00,098050,Cloninger; Alexander,10,0,10,0
1668308731629,MATH 278C,A00,098051,Nie; Jiawang,7,0,10,3
1668308732055,MATH 280B,A00,098052,Zheng; Tianyi,8,0,15,7
1668308732486,MATH 281B,A00,098053,Bradic; Jelena,1,0,15,14
1668308732910,MATH 282B,A00,098054,Arias-Castro; Ery,0,0,15,15
1668308733337,MATH 285,A00,098055,Fitzsimmons; Patrick J,0,0,15,17
1668308733760,MATH 287B,A00,098056,Arias-Castro; Ery,2,0,15,13
1668308734187,MATH 288,A00,098057,Agarwal; Pooja,9,0,10,1
1668308734187,MATH 288,B00,098058,Zhang; Danna,8,0,10,2
1668308734187,MATH 288,C00,098059,Williams; Ruth J,9,0,10,1
1668308734625,MATH 290B,A00,098060,Roberts; Justin Deritter,13,0,15,2
1668308735052,MATH 292,A00,098061,Belmont; Eva Kinoshita,10,0,10,0
1668308735478,MATH 295,A00,098062,Suk; Andrew Hoon,48,0,50,2
1668308735901,MATH 296,A00,098063,Novak; Jonathan I,20,0,20,0
1668308736342,MATH 297,001,098064,Gamst; Anthony Collins,9997,0,9999,2
1668309236161,COGS 205,A00,101395,Chiba; Andrea,19,0,20,1
1668309236585,COGS 210B,001,101404,Greene; Deanna Jacquelyn,9998,0,9999,1
1668309236585,COGS 210B,002,101417,Xia; Haijun,9999,0,9999,0
1668309236585,COGS 210B,003,101422,Nitz; Douglas A.,9999,0,9999,0
1668309236585,COGS 210B,004,101423,Hollan; James D.,9998,0,9999,1
1668309236585,COGS 210B,005,101424,Deak; Gedeon O.,9998,0,9999,1
1668309236585,COGS 210B,006,101425,Rossano; Federico,9999,0,9999,0
1668309237009,COGS 211B,A00,101427,Coulson; Seana M,9996,0,9999,3
1668309237435,COGS 220,A00,101428,Hollan; James D.,0,0,25,25
1668309237861,COGS 229,A00,101429,Dow; Steven P,18,0,25,7
1668309238287,COGS 230,A00,101430,Klemmer; Scott R,12,0,17,5
1668309238712,COGS 234,A00,101431,Xia; Haijun,1,0,25,24
1668309239136,COGS 260,A00,101432,Kiyonaga; Anastasia,21,0,25,4
1668309239136,COGS 260,B00,101433,Kirsh; David Joel,15,0,25,10
1668309239558,CSE 202,A00,102371,Impagliazzo; Russell,0,0,0,0
1668309239985,CSE 203B,A01,102373,Cheng; Chung Kuan,0,0,0,0
1668309240411,CSE 208,A00,102374,Micciancio; Daniele,0,0,0,0
1668309240839,CSE 209A,A00,112895,Impagliazzo; Russell,0,0,15,15
1668309241263,CSE 209B,A00,108005,Bellare; Mihir,0,0,0,0
1668309241689,CSE 210,A00,113163,Coblenz; Michael J,0,0,0,0
1668309242116,CSE 219,A00,106111,Dow; Steven P,0,0,20,20
1668309242541,CSE 221,A00,102376,Voelker; Geoffrey M.,0,0,0,0
1668309242969,CSE 224,A01,102378,Porter; George M,0,0,0,0
1668309243398,CSE 229A,A00,102379,Savage; Stefan,0,0,0,0
1668309243821,CSE 229C,A00,102380,Munyaka; Imani N. S.,0,0,0,0
1668309244254,CSE 232B,A00,102382,Deutsch; Alin Bernard,0,0,0,0
1668309244682,CSE 234,A01,112904,Kumar; Arun Kumar,0,0,0,0
1668309245106,CSE 237A,A00,102383,Rosing; Tajana Simunic,0,0,0,0
1668309245532,CSE 239A,A00,102384,Deutsch; Alin Bernard,0,0,0,0
1668309245956,CSE 239B,A00,102385,Polikarpova; Nadezhda,0,0,0,0
1668309246380,CSE 240A,A00,102386,Pannuto; Patrick William,0,0,0,0
1668309246807,CSE 240B,A00,102387,Zhao; Jishen,0,0,0,0
1668309247233,CSE 241A,A00,106406,Kang; Mingu,0,0,0,0
1668309247656,CSE 249B,A00,102388,Kahng; Andrew Byun,0,0,8,8
1668309248083,CSE 251B,A01,102392,Cottrell; Garrison W,0,0,0,0
1668309248083,CSE 251B,A02,102393,Cottrell; Garrison W,0,0,0,0
1668309248508,CSE 252B,A00,102394,Ochoa; Benjamin Lawrence,0,0,0,0
1668309248934,CSE 257,A01,102396,Gao; Sicun,0,0,0,0
1668309249357,CSE 272,A00,102397,Li; Tzumao,0,0,0,0
1668309249783,CSE 274,A00,111323,Chern; Albert Ren-Haur,0,0,0,0
1668309250217,CSE 282,A00,102398,Pevzner; Pavel Arkadjevich,0,0,0,0
1668309250639,CSE 284,A00,114175,Gymrek; Melissa Ann,0,0,0,0
1668309251064,CSE 290,A00,102399,Chandraker; Manmohan Krishna,0,0,0,0
1668309251064,CSE 290,B00,102400,Vaccaro; Kristen Marie,0,0,25,25
1668309251064,CSE 290,C00,102414,Pannuto; Patrick William,0,0,25,25
1668309251064,CSE 290,D00,102427,Pevzner; Pavel Arkadjevich,0,0,0,0
1668309251064,CSE 290,E00,102429,Zhao; Jishen,0,0,0,0
1668309251064,CSE 290,F00,102436,Tullsen; Dean Michael,0,0,0,0
1668309251064,CSE 290,G00,102440,Christensen; Henrik I,0,0,20,20
1668309251494,CSE 291,A00,102443,Su; Hao,0,0,0,0
1668309251494,CSE 291,B00,102448,Polikarpova; Nadezhda,0,0,0,0
1668309251494,CSE 291,C00,102453,Vaccaro; Kristen Marie,0,0,0,0
1668309251494,CSE 291,D00,111343,Savage; Stefan,0,0,0,0
1668309251494,CSE 291,E00,116474,Claffy; Kimberly Claire,0,0,0,0
1668309251494,CSE 291,F00,116479,Pasquale; Joseph,0,0,0,0
1668309251923,CSE 293,001,119111,Bafna; Vineet,9999,0,9999,0
1668309251923,CSE 293,002,119118,Bellare; Mihir,9999,0,9999,0
1668309251923,CSE 293,003,119122,Berg-Kirkpatrick; Taylor D,9999,0,9999,0
1668309251923,CSE 293,004,119135,Christensen; Henrik I,9999,0,9999,0
1668309251923,CSE 293,005,119142,Cottrell; Garrison W,9999,0,9999,0
1668309251923,CSE 293,006,119146,Deutsch; Alin Bernard,9999,0,9999,0
1668309251923,CSE 293,007,119159,Esmaeilzadeh; Hadi,9999,0,9999,0
1668309251923,CSE 293,008,119166,Freund; Yoav,9999,0,9999,0
1668309251923,CSE 293,009,119170,Griswold; William G.,9999,0,9999,0
1668309251923,CSE 293,010,119183,Gymrek; Melissa Ann,9999,0,9999,0
1668309251923,CSE 293,011,119190,Heninger; Nadia A,9999,0,9999,0
1668309251923,CSE 293,012,119230,Impagliazzo; Russell,9999,0,9999,0
1668309251923,CSE 293,013,119232,Jhala; Ranjit,9999,0,9999,0
1668309251923,CSE 293,014,119233,Kahng; Andrew Byun,9999,0,9999,0
1668309251923,CSE 293,015,119298,Kane; Daniel Mertz,9999,0,9999,0
1668309251923,CSE 293,016,119299,Kriegman; David J,9999,0,9999,0
1668309251923,CSE 293,017,119300,Kumar; Arun Kumar,9999,0,9999,0
1668309251923,CSE 293,018,119301,Lerner; Sorin,9999,0,9999,0
1668309251923,CSE 293,019,119302,Lovett; Shachar,9999,0,9999,0
1668309251923,CSE 293,020,119303,McAuley; Julian John,9999,0,9999,0
1668309251923,CSE 293,021,119304,Micciancio; Daniele,9999,0,9999,0
1668309251923,CSE 293,022,119367,Orailoglu; Alex,9999,0,9999,0
1668309251923,CSE 293,023,119382,Paturi; Ramamohan,9999,0,9999,0
1668309251923,CSE 293,024,119404,Polikarpova; Nadezhda,9999,0,9999,0
1668309251923,CSE 293,025,119406,Politz; Joseph Gibbs,9999,0,9999,0
1668309251923,CSE 293,026,119411,Porter; George M,9999,0,9999,0
1668309251923,CSE 293,027,119414,Porter; Leonard Emerson,9999,0,9999,0
1668309251923,CSE 293,028,119416,Ramamoorthi; Ravi,9999,0,9999,0
1668309251923,CSE 293,029,119417,Sahoo; Debashis,9999,0,9999,0
1668309251923,CSE 293,030,119420,Saul; Lawrence,9999,0,9999,0
1668309251923,CSE 293,031,119421,Savage; Stefan,9999,0,9999,0
1668309251923,CSE 293,032,119425,Schulze; Jurgen P.,9999,0,9999,0
1668309251923,CSE 293,033,119426,Snoeren; Alex C.,9999,0,9999,0
1668309251923,CSE 293,034,119428,Shang; Jingbo,9999,0,9999,0
1668309251923,CSE 293,035,119430,Stefan; Deian,9999,0,9999,0
1668309251923,CSE 293,036,119431,Su; Hao,9999,0,9999,0
1668309251923,CSE 293,037,119433,Swanson; Steven James,9999,0,9999,0
1668309251923,CSE 293,038,119435,Tullsen; Dean Michael,9999,0,9999,0
1668309251923,CSE 293,039,119483,Voelker; Geoffrey M.,9999,0,9999,0
1668309251923,CSE 293,040,119537,Zhao; Jishen,9999,0,9999,0
1668309251923,CSE 293,041,119538,Zhou; Yuan-Yuan,9999,0,9999,0
1668309251923,CSE 293,042,119539,Gao; Sicun,9999,0,9999,0
1668309251923,CSE 293,043,119540,Weibel; Nadir,9999,0,9999,0
1668309251923,CSE 293,044,119541,Gupta; Rajesh K.,9999,0,9999,0
1668309251923,CSE 293,045,126410,Vaccaro; Kristen Marie,9999,0,9999,0
1668309251923,CSE 293,046,126411,Klemke; Richard,9999,0,9999,0
1668309252348,CSE 294,A00,102459,Voelker; Geoffrey M.,0,0,0,0
1668309252348,CSE 294,B00,111322,Orailoglu; Alex,0,0,0,0
1668309252777,DSE 201,A00,096914,Deutsch; Alin Bernard,30,0,30,0
1668309253200,DSE 210,A00,096915,Dasgupta; Sanjoy,30,0,30,0
1668309253623,DSE 260A,A00,096916,Altintas De Callaf; Ilkay,30,0,30,0
1668309254052,ECE 200,001,103586,Antipa; Nicholas A,9999,0,9999,0
1668309254052,ECE 200,002,103587,Atanasov; Nikolay A.,9999,0,9999,0
1668309254052,ECE 200,003,103588,Bharadia; Dinesh,9999,0,9999,0
1668309254052,ECE 200,004,103589,Cheng; Chung Kuan,9999,0,9999,0
1668309254052,ECE 200,005,103590,Cosman; Pamela C.,9999,0,9999,0
1668309254052,ECE 200,006,103591,Dayeh; Shadi Ahmad,9999,0,9999,0
1668309254052,ECE 200,007,103592,Fainman; Yeshaiahu,9999,0,9999,0
1668309254052,ECE 200,008,103593,Ford; Joseph Earl,9999,0,9999,0
1668309254052,ECE 200,009,103594,Franceschetti; Massimo,9999,0,9999,0
1668309254052,ECE 200,010,103595,Fullerton; Eric E,9999,0,9999,0
1668309254052,ECE 200,011,103596,Galton; Ian A,9999,0,9999,0
1668309254052,ECE 200,012,103597,Gilja; Vikash,9999,0,9999,0
1668309254052,ECE 200,013,103598,Hall; Drew A.,9999,0,9999,0
1668309254052,ECE 200,014,103599,Hsueh; Tzu-Chien,9999,0,9999,0
1668309254052,ECE 200,015,103600,Javidi; Tara,9999,0,9999,0
1668309254052,ECE 200,016,103601,Kahng; Andrew Byun,9999,0,9999,0
1668309254052,ECE 200,017,103602,Kim; Young-Han,9999,0,9999,0
1668309254052,ECE 200,018,103603,Koushanfar; Farinaz,9999,0,9999,0
1668309254052,ECE 200,019,103604,Kuzum; Duygu,9999,0,9999,0
1668309254052,ECE 200,020,103605,Le; Hanh-Phuc,9999,0,9999,0
1668309254052,ECE 200,021,103606,Lin; Bill,9999,0,9999,0
1668309254052,ECE 200,022,103607,Liu; Zhaowei,9998,0,9999,1
1668309254052,ECE 200,023,103608,Lo; Yu-Hwa,9999,0,9999,0
1668309254052,ECE 200,024,103609,Lomakin; Vitaliy,9999,0,9999,0
1668309254052,ECE 200,025,103610,Mercier; Patrick Philip,9999,0,9999,0
1668309254052,ECE 200,026,103611,Meyer; Florian,9999,0,9999,0
1668309254052,ECE 200,027,103612,Milstein; Laurence B.,9999,0,9999,0
1668309254052,ECE 200,028,103613,Mir Arabbaygi; Siavash,9999,0,9999,0
1668309254052,ECE 200,029,103614,Mookherjea; Shayan,9999,0,9999,0
1668309254052,ECE 200,030,103615,Morris; Karcher William,9999,0,9999,0
1668309254052,ECE 200,031,103616,Ng; Tse Nga,9999,0,9999,0
1668309254052,ECE 200,032,103617,Nguyen; Truong Quang,9999,0,9999,0
1668309254052,ECE 200,033,103618,Nomura; Kenji,9999,0,9999,0
1668309254052,ECE 200,034,103619,Orlitsky; Alon,9999,0,9999,0
1668309254052,ECE 200,035,103620,Pal; Piya,9999,0,9999,0
1668309254052,ECE 200,036,103621,Papen; George C.,9999,0,9999,0
1668309254052,ECE 200,037,103622,Radic; Stojan,9999,0,9999,0
1668309254052,ECE 200,038,103623,Rao; Bhaskar D.,9999,0,9999,0
1668309254052,ECE 200,039,103624,Rao; Ramesh R,9999,0,9999,0
1668309254052,ECE 200,040,103625,Rebeiz; Gabriel,9999,0,9999,0
1668309254052,ECE 200,041,103626,Sanford; John R,9999,0,9999,0
1668309254052,ECE 200,042,103627,Siegel; Paul H.,9999,0,9999,0
1668309254052,ECE 200,043,103628,Sievenpiper; Daniel F.,9999,0,9999,0
1668309254052,ECE 200,044,103629,Sworder; David D.,9999,0,9999,0
1668309254052,ECE 200,045,103630,Taur; Yuan,9999,0,9999,0
1668309254052,ECE 200,046,103631,Touri; Behrouz,9999,0,9999,0
1668309254052,ECE 200,047,103632,Trivedi; Mohan M.,9999,0,9999,0
1668309254052,ECE 200,048,103633,Vasconcelos; Nuno,9999,0,9999,0
1668309254052,ECE 200,049,103634,Wang; Xiaolong,9999,0,9999,0
1668309254052,ECE 200,050,103635,Xie; Pengtao,9999,0,9999,0
1668309254052,ECE 200,051,103636,Yip; Michael,9999,0,9999,0
1668309254052,ECE 200,052,103637,Zeger; Kenneth A.,999,0,999,0
1668309254052,ECE 200,053,103638,Zhang; Xinyu,9999,0,9999,0
1668309254052,ECE 200,054,103639,Turakhia; Yatish Girish,9999,0,9999,0
1668309254052,ECE 200,055,103640,Kang; Mingu,9999,0,9999,0
1668309254052,ECE 200,056,103641,Shi; Yuanyuan,9999,0,9999,0
1668309254052,ECE 200,057,103642,Wang; Edward Jay,9999,0,9999,0
1668309254052,ECE 200,058,103643,Zheng; Yang,9999,0,9999,0
1668309254478,ECE 202,A00,103644,Kuzum; Duygu,0,0,0,0
1668309254905,ECE 212BN,A00,103646,Ng; Tse Nga,0,0,0,0
1668309255341,ECE 221,A00,111493,Staff,0,0,0,0
1668309255767,ECE 222B,A00,103647,Lomakin; Vitaliy,0,0,0,0
1668309256192,ECE 230B,A00,103648,Taur; Yuan,0,0,0,0
1668309256614,ECE 238B,A00,103649,Garay; Javier,0,0,0,0
1668309257037,ECE 240B,A00,112900,Fainman; Yeshaiahu,0,0,0,0
1668309257468,ECE 247A,A00,103650,Jokerst; Jesse Vincent,0,0,0,0
1668309257896,ECE 247B,A00,103651,Wang; Joseph,0,0,0,0
1668309258324,ECE 250,A00,103652,Siegel; Paul H.,0,0,0,0
1668309258747,ECE 251A,A00,103654,Rao; Bhaskar D.,0,0,0,0
1668309259181,ECE 257B,A00,103655,Bharadia; Dinesh,0,0,0,0
1668309259603,ECE 258A,A00,103656,Milstein; Laurence B.,0,0,0,0
1668309260026,ECE 260B,A00,103658,Kang; Mingu,0,0,0,0
1668309260453,ECE 264A,A00,103659,Galton; Ian A,0,0,0,0
1668309260879,ECE 265A,A00,103661,Gudem; Prasad S.S.,0,0,0,0
1668309261306,ECE 265D,A00,103662,Gudem; Prasad S.S.,0,0,0,0
1668309261734,ECE 268,A00,103663,Koushanfar; Farinaz,0,0,0,0
1668309262165,ECE 269,A01,103665,Pal; Piya,0,0,0,0
1668309262593,ECE 271B,A00,103666,Vasconcelos; Manuela,0,0,0,0
1668309263020,ECE 276A,A00,103667,Atanasov; Nikolay A.,0,0,0,0
1668309263445,ECE 277,A00,103668,An; Cheolhong,0,0,0,0
1668309263870,ECE 279,A00,117947,Hall; Drew A.,0,0,0,0
1668309264721,ECE 283,A00,103670,Hsueh; Tzu-Chien,0,0,0,0
1668309265153,ECE 284,A00,103671,Turakhia; Yatish Girish,0,0,0,0
1668309265580,ECE 285,A00,103672,Zheng; Yang,0,0,0,0
1668309265580,ECE 285,B00,103673,Sworder; David D.,0,0,0,0
1668309266011,ECE 287,A00,103676,Javidi; Tara,0,0,0,0
1668309266436,MATH 200B,A00,098023,Salehi Golsefidy; Alireza,12,0,15,3
1668309266858,MATH 202B,A00,098024,Rhoades; Brendon Patrick,9,0,15,6
1668309267282,MATH 203B,A00,098025,Oprea; Dragos N.,10,0,15,5
1668309267705,MATH 204B,A00,098026,Sorensen; Claus M,13,0,15,2
1668309268129,MATH 208,A00,098027,Izadi; Elham,7,0,10,3
1668309268552,MATH 209,A00,098028,Pollack; Aaron,10,0,10,0
1668309268977,MATH 211A,A00,112919,Rogalski; Daniel,9,0,10,1
1668309269400,MATH 211B,A00,112920,Seward; Brandon M.,9,0,10,1
1668309269826,MATH 218,A00,098029,Li; Bo,10,0,10,0
1668309270249,MATH 220B,A00,098030,Novak; Jonathan I,11,0,15,4
1668309270675,MATH 221A,A00,098031,Ebenfelt; Peter F,13,0,15,2
1668309271097,MATH 231B,A00,098032,Zlatos; Andrej,12,0,15,3
1668309271537,MATH 240B,A00,098033,Ni; Lei,9,0,15,6
1668309271963,MATH 243,A00,098034,Jekel; David Andrew,10,0,10,0
1668309272389,MATH 245A,A00,098035,Nie; Jiawang,0,0,15,16
1668309272822,MATH 248,A00,098036,Bejenaru; Ioan,10,0,10,0
1668309273244,MATH 250B,A00,098037,Spolaor; Luca,14,0,15,1
1668309273666,MATH 258,A00,098038,Ni; Lei,10,0,10,0
1668309274094,MATH 264B,A00,098041,Rhoades; Brendon Patrick,9,0,15,6
1668309274517,MATH 268,A00,098042,Buss; Samuel R,10,0,10,0
1668309274947,MATH 269,A00,098043,Rhoades; Brendon Patrick,10,0,10,0
1668309275373,MATH 270B,A00,098044,Li; Bo,10,0,15,5
1668309275801,MATH 272B,A00,098045,Holst; Michael J,13,0,15,2
1668309276227,MATH 273A,A00,098046,Tian; Xiaochuan,10,0,15,5
1668309276654,MATH 275,A01,098048,Tian; Xiaochuan,6,0,10,4
1668309277078,MATH 278A,A00,098049,Holst; Michael J,8,0,10,2
1668309277500,MATH 278B,A00,098050,Cloninger; Alexander,10,0,10,0
1668309277924,MATH 278C,A00,098051,Nie; Jiawang,7,0,10,3
1668309278354,MATH 280B,A00,098052,Zheng; Tianyi,8,0,15,7
1668309278778,MATH 281B,A00,098053,Bradic; Jelena,1,0,15,14
1668309279323,MATH 282B,A00,098054,Arias-Castro; Ery,0,0,15,15
1668309279751,MATH 285,A00,098055,Fitzsimmons; Patrick J,0,0,15,17
1668309280177,MATH 287B,A00,098056,Arias-Castro; Ery,2,0,15,13
1668309280600,MATH 288,A00,098057,Agarwal; Pooja,9,0,10,1
1668309280600,MATH 288,B00,098058,Zhang; Danna,8,0,10,2
1668309280600,MATH 288,C00,098059,Williams; Ruth J,9,0,10,1
1668309281032,MATH 290B,A00,098060,Roberts; Justin Deritter,13,0,15,2
1668309281464,MATH 292,A00,098061,Belmont; Eva Kinoshita,10,0,10,0
1668309281889,MATH 295,A00,098062,Suk; Andrew Hoon,48,0,50,2
1668309282312,MATH 296,A00,098063,Novak; Jonathan I,20,0,20,0
1668309282735,MATH 297,001,098064,Gamst; Anthony Collins,9997,0,9999,2
1668309782775,COGS 205,A00,101395,Chiba; Andrea,19,0,20,1
1668309783197,COGS 210B,001,101404,Greene; Deanna Jacquelyn,9998,0,9999,1
1668309783197,COGS 210B,002,101417,Xia; Haijun,9999,0,9999,0
1668309783197,COGS 210B,003,101422,Nitz; Douglas A.,9999,0,9999,0
1668309783197,COGS 210B,004,101423,Hollan; James D.,9998,0,9999,1
1668309783197,COGS 210B,005,101424,Deak; Gedeon O.,9998,0,9999,1
1668309783197,COGS 210B,006,101425,Rossano; Federico,9999,0,9999,0
1668309783622,COGS 211B,A00,101427,Coulson; Seana M,9996,0,9999,3
1668309784045,COGS 220,A00,101428,Hollan; James D.,0,0,25,25
1668309784473,COGS 229,A00,101429,Dow; Steven P,18,0,25,7
1668309784914,COGS 230,A00,101430,Klemmer; Scott R,12,0,17,5
1668309785337,COGS 234,A00,101431,Xia; Haijun,1,0,25,24
1668309785761,COGS 260,A00,101432,Kiyonaga; Anastasia,21,0,25,4
1668309785761,COGS 260,B00,101433,Kirsh; David Joel,15,0,25,10
1668309786211,CSE 202,A00,102371,Impagliazzo; Russell,0,0,0,0
1668309786649,CSE 203B,A01,102373,Cheng; Chung Kuan,0,0,0,0
1668309787076,CSE 208,A00,102374,Micciancio; Daniele,0,0,0,0
1668309787501,CSE 209A,A00,112895,Impagliazzo; Russell,0,0,15,15
1668309787927,CSE 209B,A00,108005,Bellare; Mihir,0,0,0,0
1668309788352,CSE 210,A00,113163,Coblenz; Michael J,0,0,0,0
1668309788775,CSE 219,A00,106111,Dow; Steven P,0,0,20,20
1668309789199,CSE 221,A00,102376,Voelker; Geoffrey M.,0,0,0,0
1668309789625,CSE 224,A01,102378,Porter; George M,0,0,0,0
1668309790059,CSE 229A,A00,102379,Savage; Stefan,0,0,0,0
1668309790490,CSE 229C,A00,102380,Munyaka; Imani N. S.,0,0,0,0
1668309790915,CSE 232B,A00,102382,Deutsch; Alin Bernard,0,0,0,0
1668309791339,CSE 234,A01,112904,Kumar; Arun Kumar,0,0,0,0
1668309791769,CSE 237A,A00,102383,Rosing; Tajana Simunic,0,0,0,0
1668309792198,CSE 239A,A00,102384,Deutsch; Alin Bernard,0,0,0,0
1668309792621,CSE 239B,A00,102385,Polikarpova; Nadezhda,0,0,0,0
1668309793044,CSE 240A,A00,102386,Pannuto; Patrick William,0,0,0,0
1668309793474,CSE 240B,A00,102387,Zhao; Jishen,0,0,0,0
1668309793901,CSE 241A,A00,106406,Kang; Mingu,0,0,0,0
1668309794333,CSE 249B,A00,102388,Kahng; Andrew Byun,0,0,8,8
1668309794755,CSE 251B,A01,102392,Cottrell; Garrison W,0,0,0,0
1668309794755,CSE 251B,A02,102393,Cottrell; Garrison W,0,0,0,0
1668309795180,CSE 252B,A00,102394,Ochoa; Benjamin Lawrence,0,0,0,0
1668309795601,CSE 257,A01,102396,Gao; Sicun,0,0,0,0
1668309796027,CSE 272,A00,102397,Li; Tzumao,0,0,0,0
1668309796452,CSE 274,A00,111323,Chern; Albert Ren-Haur,0,0,0,0
1668309796876,CSE 282,A00,102398,Pevzner; Pavel Arkadjevich,0,0,0,0
1668309797300,CSE 284,A00,114175,Gymrek; Melissa Ann,0,0,0,0
1668309797728,CSE 290,A00,102399,Chandraker; Manmohan Krishna,0,0,0,0
1668309797728,CSE 290,B00,102400,Vaccaro; Kristen Marie,0,0,25,25
1668309797728,CSE 290,C00,102414,Pannuto; Patrick William,0,0,25,25
1668309797728,CSE 290,D00,102427,Pevzner; Pavel Arkadjevich,0,0,0,0
1668309797728,CSE 290,E00,102429,Zhao; Jishen,0,0,0,0
1668309797728,CSE 290,F00,102436,Tullsen; Dean Michael,0,0,0,0
1668309797728,CSE 290,G00,102440,Christensen; Henrik I,0,0,20,20
1668309798152,CSE 291,A00,102443,Su; Hao,0,0,0,0
1668309798152,CSE 291,B00,102448,Polikarpova; Nadezhda,0,0,0,0
1668309798152,CSE 291,C00,102453,Vaccaro; Kristen Marie,0,0,0,0
1668309798152,CSE 291,D00,111343,Savage; Stefan,0,0,0,0
1668309798152,CSE 291,E00,116474,Claffy; Kimberly Claire,0,0,0,0
1668309798152,CSE 291,F00,116479,Pasquale; Joseph,0,0,0,0
1668309798586,CSE 293,001,119111,Bafna; Vineet,9999,0,9999,0
1668309798586,CSE 293,002,119118,Bellare; Mihir,9999,0,9999,0
1668309798586,CSE 293,003,119122,Berg-Kirkpatrick; Taylor D,9999,0,9999,0
1668309798586,CSE 293,004,119135,Christensen; Henrik I,9999,0,9999,0
1668309798586,CSE 293,005,119142,Cottrell; Garrison W,9999,0,9999,0
1668309798586,CSE 293,006,119146,Deutsch; Alin Bernard,9999,0,9999,0
1668309798586,CSE 293,007,119159,Esmaeilzadeh; Hadi,9999,0,9999,0
1668309798586,CSE 293,008,119166,Freund; Yoav,9999,0,9999,0
1668309798586,CSE 293,009,119170,Griswold; William G.,9999,0,9999,0
1668309798586,CSE 293,010,119183,Gymrek; Melissa Ann,9999,0,9999,0
1668309798586,CSE 293,011,119190,Heninger; Nadia A,9999,0,9999,0
1668309798586,CSE 293,012,119230,Impagliazzo; Russell,9999,0,9999,0
1668309798586,CSE 293,013,119232,Jhala; Ranjit,9999,0,9999,0
1668309798586,CSE 293,014,119233,Kahng; Andrew Byun,9999,0,9999,0
1668309798586,CSE 293,015,119298,Kane; Daniel Mertz,9999,0,9999,0
1668309798586,CSE 293,016,119299,Kriegman; David J,9999,0,9999,0
1668309798586,CSE 293,017,119300,Kumar; Arun Kumar,9999,0,9999,0
1668309798586,CSE 293,018,119301,Lerner; Sorin,9999,0,9999,0
1668309798586,CSE 293,019,119302,Lovett; Shachar,9999,0,9999,0
1668309798586,CSE 293,020,119303,McAuley; Julian John,9999,0,9999,0
1668309798586,CSE 293,021,119304,Micciancio; Daniele,9999,0,9999,0
1668309798586,CSE 293,022,119367,Orailoglu; Alex,9999,0,9999,0
1668309798586,CSE 293,023,119382,Paturi; Ramamohan,9999,0,9999,0
1668309798586,CSE 293,024,119404,Polikarpova; Nadezhda,9999,0,9999,0
1668309798586,CSE 293,025,119406,Politz; Joseph Gibbs,9999,0,9999,0
1668309798586,CSE 293,026,119411,Porter; George M,9999,0,9999,0
1668309798586,CSE 293,027,119414,Porter; Leonard Emerson,9999,0,9999,0
1668309798586,CSE 293,028,119416,Ramamoorthi; Ravi,9999,0,9999,0
1668309798586,CSE 293,029,119417,Sahoo; Debashis,9999,0,9999,0
1668309798586,CSE 293,030,119420,Saul; Lawrence,9999,0,9999,0
1668309798586,CSE 293,031,119421,Savage; Stefan,9999,0,9999,0
1668309798586,CSE 293,032,119425,Schulze; Jurgen P.,9999,0,9999,0
1668309798586,CSE 293,033,119426,Snoeren; Alex C.,9999,0,9999,0
1668309798586,CSE 293,034,119428,Shang; Jingbo,9999,0,9999,0
1668309798586,CSE 293,035,119430,Stefan; Deian,9999,0,9999,0
1668309798586,CSE 293,036,119431,Su; Hao,9999,0,9999,0
1668309798586,CSE 293,037,119433,Swanson; Steven James,9999,0,9999,0
1668309798586,CSE 293,038,119435,Tullsen; Dean Michael,9999,0,9999,0
1668309798586,CSE 293,039,119483,Voelker; Geoffrey M.,9999,0,9999,0
1668309798586,CSE 293,040,119537,Zhao; Jishen,9999,0,9999,0
1668309798586,CSE 293,041,119538,Zhou; Yuan-Yuan,9999,0,9999,0
1668309798586,CSE 293,042,119539,Gao; Sicun,9999,0,9999,0
1668309798586,CSE 293,043,119540,Weibel; Nadir,9999,0,9999,0
1668309798586,CSE 293,044,119541,Gupta; Rajesh K.,9999,0,9999,0
1668309798586,CSE 293,045,126410,Vaccaro; Kristen Marie,9999,0,9999,0
1668309798586,CSE 293,046,126411,Klemke; Richard,9999,0,9999,0
1668309799009,CSE 294,A00,102459,Voelker; Geoffrey M.,0,0,0,0
1668309799009,CSE 294,B00,111322,Orailoglu; Alex,0,0,0,0
1668309799510,DSE 201,A00,096914,Deutsch; Alin Bernard,30,0,30,0
1668309799933,DSE 210,A00,096915,Dasgupta; Sanjoy,30,0,30,0
1668309800358,DSE 260A,A00,096916,Altintas De Callaf; Ilkay,30,0,30,0
1668309800802,ECE 200,001,103586,Antipa; Nicholas A,9999,0,9999,0
1668309800802,ECE 200,002,103587,Atanasov; Nikolay A.,9999,0,9999,0
1668309800802,ECE 200,003,103588,Bharadia; Dinesh,9999,0,9999,0
1668309800802,ECE 200,004,103589,Cheng; Chung Kuan,9999,0,9999,0
1668309800802,ECE 200,005,103590,Cosman; Pamela C.,9999,0,9999,0
1668309800802,ECE 200,006,103591,Dayeh; Shadi Ahmad,9999,0,9999,0
1668309800802,ECE 200,007,103592,Fainman; Yeshaiahu,9999,0,9999,0
1668309800802,ECE 200,008,103593,Ford; Joseph Earl,9999,0,9999,0
1668309800802,ECE 200,009,103594,Franceschetti; Massimo,9999,0,9999,0
1668309800802,ECE 200,010,103595,Fullerton; Eric E,9999,0,9999,0
1668309800802,ECE 200,011,103596,Galton; Ian A,9999,0,9999,0
1668309800802,ECE 200,012,103597,Gilja; Vikash,9999,0,9999,0
1668309800802,ECE 200,013,103598,Hall; Drew A.,9999,0,9999,0
1668309800802,ECE 200,014,103599,Hsueh; Tzu-Chien,9999,0,9999,0
1668309800802,ECE 200,015,103600,Javidi; Tara,9999,0,9999,0
1668309800802,ECE 200,016,103601,Kahng; Andrew Byun,9999,0,9999,0
1668309800802,ECE 200,017,103602,Kim; Young-Han,9999,0,9999,0
1668309800802,ECE 200,018,103603,Koushanfar; Farinaz,9999,0,9999,0
1668309800802,ECE 200,019,103604,Kuzum; Duygu,9999,0,9999,0
1668309800802,ECE 200,020,103605,Le; Hanh-Phuc,9999,0,9999,0
1668309800802,ECE 200,021,103606,Lin; Bill,9999,0,9999,0
1668309800802,ECE 200,022,103607,Liu; Zhaowei,9998,0,9999,1
1668309800802,ECE 200,023,103608,Lo; Yu-Hwa,9999,0,9999,0
1668309800802,ECE 200,024,103609,Lomakin; Vitaliy,9999,0,9999,0
1668309800802,ECE 200,025,103610,Mercier; Patrick Philip,9999,0,9999,0
1668309800802,ECE 200,026,103611,Meyer; Florian,9999,0,9999,0
1668309800802,ECE 200,027,103612,Milstein; Laurence B.,9999,0,9999,0
1668309800802,ECE 200,028,103613,Mir Arabbaygi; Siavash,9999,0,9999,0
1668309800802,ECE 200,029,103614,Mookherjea; Shayan,9999,0,9999,0
1668309800802,ECE 200,030,103615,Morris; Karcher William,9999,0,9999,0
1668309800802,ECE 200,031,103616,Ng; Tse Nga,9999,0,9999,0
1668309800802,ECE 200,032,103617,Nguyen; Truong Quang,9999,0,9999,0
1668309800802,ECE 200,033,103618,Nomura; Kenji,9999,0,9999,0
1668309800802,ECE 200,034,103619,Orlitsky; Alon,9999,0,9999,0
1668309800802,ECE 200,035,103620,Pal; Piya,9999,0,9999,0
1668309800802,ECE 200,036,103621,Papen; George C.,9999,0,9999,0
1668309800802,ECE 200,037,103622,Radic; Stojan,9999,0,9999,0
1668309800802,ECE 200,038,103623,Rao; Bhaskar D.,9999,0,9999,0
1668309800802,ECE 200,039,103624,Rao; Ramesh R,9999,0,9999,0
1668309800802,ECE 200,040,103625,Rebeiz; Gabriel,9999,0,9999,0
1668309800802,ECE 200,041,103626,Sanford; John R,9999,0,9999,0
1668309800802,ECE 200,042,103627,Siegel; Paul H.,9999,0,9999,0
1668309800802,ECE 200,043,103628,Sievenpiper; Daniel F.,9999,0,9999,0
1668309800802,ECE 200,044,103629,Sworder; David D.,9999,0,9999,0
1668309800802,ECE 200,045,103630,Taur; Yuan,9999,0,9999,0
1668309800802,ECE 200,046,103631,Touri; Behrouz,9999,0,9999,0
1668309800802,ECE 200,047,103632,Trivedi; Mohan M.,9999,0,9999,0
1668309800802,ECE 200,048,103633,Vasconcelos; Nuno,9999,0,9999,0
1668309800802,ECE 200,049,103634,Wang; Xiaolong,9999,0,9999,0
1668309800802,ECE 200,050,103635,Xie; Pengtao,9999,0,9999,0
1668309800802,ECE 200,051,103636,Yip; Michael,9999,0,9999,0
1668309800802,ECE 200,052,103637,Zeger; Kenneth A.,999,0,999,0
1668309800802,ECE 200,053,103638,Zhang; Xinyu,9999,0,9999,0
1668309800802,ECE 200,054,103639,Turakhia; Yatish Girish,9999,0,9999,0
1668309800802,ECE 200,055,103640,Kang; Mingu,9999,0,9999,0
1668309800802,ECE 200,056,103641,Shi; Yuanyuan,9999,0,9999,0
1668309800802,ECE 200,057,103642,Wang; Edward Jay,9999,0,9999,0
1668309800802,ECE 200,058,103643,Zheng; Yang,9999,0,9999,0
1668309801225,ECE 202,A00,103644,Kuzum; Duygu,0,0,0,0
1668309801660,ECE 212BN,A00,103646,Ng; Tse Nga,0,0,0,0
1668309802085,ECE 221,A00,111493,Staff,0,0,0,0
1668309802508,ECE 222B,A00,103647,Lomakin; Vitaliy,0,0,0,0
1668309802935,ECE 230B,A00,103648,Taur; Yuan,0,0,0,0
1668309803367,ECE 238B,A00,103649,Garay; Javier,0,0,0,0
1668309803793,ECE 240B,A00,112900,Fainman; Yeshaiahu,0,0,0,0
1668309804222,ECE 247A,A00,103650,Jokerst; Jesse Vincent,0,0,0,0
1668309804646,ECE 247B,A00,103651,Wang; Joseph,0,0,0,0
1668309805070,ECE 250,A00,103652,Siegel; Paul H.,0,0,0,0
1668309805495,ECE 251A,A00,103654,Rao; Bhaskar D.,0,0,0,0
1668309805918,ECE 257B,A00,103655,Bharadia; Dinesh,0,0,0,0
1668309806342,ECE 258A,A00,103656,Milstein; Laurence B.,0,0,0,0
1668309806768,ECE 260B,A00,103658,Kang; Mingu,0,0,0,0
1668309807191,ECE 264A,A00,103659,Galton; Ian A,0,0,0,0
1668309807619,ECE 265A,A00,103661,Gudem; Prasad S.S.,0,0,0,0
1668309808045,ECE 265D,A00,103662,Gudem; Prasad S.S.,0,0,0,0
1668309808488,ECE 268,A00,103663,Koushanfar; Farinaz,0,0,0,0
1668309808926,ECE 269,A01,103665,Pal; Piya,0,0,0,0
1668309809350,ECE 271B,A00,103666,Vasconcelos; Manuela,0,0,0,0
1668309809774,ECE 276A,A00,103667,Atanasov; Nikolay A.,0,0,0,0
1668309810199,ECE 277,A00,103668,An; Cheolhong,0,0,0,0
1668309810624,ECE 279,A00,117947,Hall; Drew A.,0,0,0,0
1668309811482,ECE 283,A00,103670,Hsueh; Tzu-Chien,0,0,0,0
1668309811906,ECE 284,A00,103671,Turakhia; Yatish Girish,0,0,0,0
1668309812329,ECE 285,A00,103672,Zheng; Yang,0,0,0,0
1668309812329,ECE 285,B00,103673,Sworder; David D.,0,0,0,0
1668309812758,ECE 287,A00,103676,Javidi; Tara,0,0,0,0
1668309813182,MATH 200B,A00,098023,Salehi Golsefidy; Alireza,12,0,15,3
1668309813606,MATH 202B,A00,098024,Rhoades; Brendon Patrick,9,0,15,6
1668309814032,MATH 203B,A00,098025,Oprea; Dragos N.,10,0,15,5
1668309814466,MATH 204B,A00,098026,Sorensen; Claus M,13,0,15,2
1668309814904,MATH 208,A00,098027,Izadi; Elham,7,0,10,3
1668309815329,MATH 209,A00,098028,Pollack; Aaron,10,0,10,0
1668309815755,MATH 211A,A00,112919,Rogalski; Daniel,9,0,10,1
1668309816190,MATH 211B,A00,112920,Seward; Brandon M.,9,0,10,1
1668309816619,MATH 218,A00,098029,Li; Bo,10,0,10,0
1668309817045,MATH 220B,A00,098030,Novak; Jonathan I,11,0,15,4
1668309817471,MATH 221A,A00,098031,Ebenfelt; Peter F,13,0,15,2
1668309817908,MATH 231B,A00,098032,Zlatos; Andrej,12,0,15,3
1668309818335,MATH 240B,A00,098033,Ni; Lei,9,0,15,6
1668309818760,MATH 243,A00,098034,Jekel; David Andrew,10,0,10,0
1668309819186,MATH 245A,A00,098035,Nie; Jiawang,0,0,15,16
1668309819609,MATH 248,A00,098036,Bejenaru; Ioan,10,0,10,0
1668309820050,MATH 250B,A00,098037,Spolaor; Luca,14,0,15,1
1668309820475,MATH 258,A00,098038,Ni; Lei,10,0,10,0
1668309820905,MATH 264B,A00,098041,Rhoades; Brendon Patrick,9,0,15,6
1668309821326,MATH 268,A00,098042,Buss; Samuel R,10,0,10,0
1668309821764,MATH 269,A00,098043,Rhoades; Brendon Patrick,10,0,10,0
1668309822197,MATH 270B,A00,098044,Li; Bo,10,0,15,5
1668309822622,MATH 272B,A00,098045,Holst; Michael J,13,0,15,2
1668309823051,MATH 273A,A00,098046,Tian; Xiaochuan,10,0,15,5
1668309823475,MATH 275,A01,098048,Tian; Xiaochuan,6,0,10,4
1668309823904,MATH 278A,A00,098049,Holst; Michael J,8,0,10,2
1668309824328,MATH 278B,A00,098050,Cloninger; Alexander,10,0,10,0
1668309824754,MATH 278C,A00,098051,Nie; Jiawang,7,0,10,3
1668309825177,MATH 280B,A00,098052,Zheng; Tianyi,8,0,15,7
1668309825600,MATH 281B,A00,098053,Bradic; Jelena,1,0,15,14
1668309826043,MATH 282B,A00,098054,Arias-Castro; Ery,0,0,15,15
1668309826470,MATH 285,A00,098055,Fitzsimmons; Patrick J,0,0,15,17
1668309826896,MATH 287B,A00,098056,Arias-Castro; Ery,2,0,15,13
1668309827319,MATH 288,A00,098057,Agarwal; Pooja,9,0,10,1
1668309827319,MATH 288,B00,098058,Zhang; Danna,8,0,10,2
1668309827319,MATH 288,C00,098059,Williams; Ruth J,9,0,10,1
1668309827766,MATH 290B,A00,098060,Roberts; Justin Deritter,13,0,15,2
1668309828193,MATH 292,A00,098061,Belmont; Eva Kinoshita,10,0,10,0
1668309828618,MATH 295,A00,098062,Suk; Andrew Hoon,48,0,50,2
1668309829048,MATH 296,A00,098063,Novak; Jonathan I,20,0,20,0
1668309829472,MATH 297,001,098064,Gamst; Anthony Collins,9997,0,9999,2
1668310329094,COGS 205,A00,101395,Chiba; Andrea,19,0,20,1
1668310329520,COGS 210B,001,101404,Greene; Deanna Jacquelyn,9998,0,9999,1
1668310329520,COGS 210B,002,101417,Xia; Haijun,9999,0,9999,0
1668310329520,COGS 210B,003,101422,Nitz; Douglas A.,9999,0,9999,0
1668310329520,COGS 210B,004,101423,Hollan; James D.,9998,0,9999,1
1668310329520,COGS 210B,005,101424,Deak; Gedeon O.,9998,0,9999,1
1668310329520,COGS 210B,006,101425,Rossano; Federico,9999,0,9999,0
1668310329944,COGS 211B,A00,101427,Coulson; Seana M,9996,0,9999,3
1668310330380,COGS 220,A00,101428,Hollan; James D.,0,0,25,25
1668310330802,COGS 229,A00,101429,Dow; Steven P,18,0,25,7
1668310331227,COGS 230,A00,101430,Klemmer; Scott R,12,0,17,5
1668310331651,COGS 234,A00,101431,Xia; Haijun,1,0,25,24
1668310332074,COGS 260,A00,101432,Kiyonaga; Anastasia,21,0,25,4
1668310332074,COGS 260,B00,101433,Kirsh; David Joel,15,0,25,10
1668310332495,CSE 202,A00,102371,Impagliazzo; Russell,0,0,0,0
1668310332920,CSE 203B,A01,102373,Cheng; Chung Kuan,0,0,0,0
1668310333344,CSE 208,A00,102374,Micciancio; Daniele,0,0,0,0
1668310333766,CSE 209A,A00,112895,Impagliazzo; Russell,0,0,15,15
1668310334188,CSE 209B,A00,108005,Bellare; Mihir,0,0,0,0
1668310334615,CSE 210,A00,113163,Coblenz; Michael J,0,0,0,0
1668310335040,CSE 219,A00,106111,Dow; Steven P,0,0,20,20
1668310335467,CSE 221,A00,102376,Voelker; Geoffrey M.,0,0,0,0
1668310335890,CSE 224,A01,102378,Porter; George M,0,0,0,0
1668310336316,CSE 229A,A00,102379,Savage; Stefan,0,0,0,0
1668310336744,CSE 229C,A00,102380,Munyaka; Imani N. S.,0,0,0,0
1668310337171,CSE 232B,A00,102382,Deutsch; Alin Bernard,0,0,0,0
1668310337599,CSE 234,A01,112904,Kumar; Arun Kumar,0,0,0,0
1668310338026,CSE 237A,A00,102383,Rosing; Tajana Simunic,0,0,0,0
1668310338450,CSE 239A,A00,102384,Deutsch; Alin Bernard,0,0,0,0
1668310338874,CSE 239B,A00,102385,Polikarpova; Nadezhda,0,0,0,0
1668310339298,CSE 240A,A00,102386,Pannuto; Patrick William,0,0,0,0
1668310339728,CSE 240B,A00,102387,Zhao; Jishen,0,0,0,0
1668310340156,CSE 241A,A00,106406,Kang; Mingu,0,0,0,0
1668310340583,CSE 249B,A00,102388,Kahng; Andrew Byun,0,0,8,8
1668310341008,CSE 251B,A01,102392,Cottrell; Garrison W,0,0,0,0
1668310341008,CSE 251B,A02,102393,Cottrell; Garrison W,0,0,0,0
1668310341437,CSE 252B,A00,102394,Ochoa; Benjamin Lawrence,0,0,0,0
1668310341865,CSE 257,A01,102396,Gao; Sicun,0,0,0,0
1668310342298,CSE 272,A00,102397,Li; Tzumao,0,0,0,0
1668310342720,CSE 274,A00,111323,Chern; Albert Ren-Haur,0,0,0,0
1668310343154,CSE 282,A00,102398,Pevzner; Pavel Arkadjevich,0,0,0,0
1668310343582,CSE 284,A00,114175,Gymrek; Melissa Ann,0,0,0,0
1668310344007,CSE 290,A00,102399,Chandraker; Manmohan Krishna,0,0,0,0
1668310344007,CSE 290,B00,102400,Vaccaro; Kristen Marie,0,0,25,25
1668310344007,CSE 290,C00,102414,Pannuto; Patrick William,0,0,25,25
1668310344007,CSE 290,D00,102427,Pevzner; Pavel Arkadjevich,0,0,0,0
1668310344007,CSE 290,E00,102429,Zhao; Jishen,0,0,0,0
1668310344007,CSE 290,F00,102436,Tullsen; Dean Michael,0,0,0,0
1668310344007,CSE 290,G00,102440,Christensen; Henrik I,0,0,20,20
1668310344436,CSE 291,A00,102443,Su; Hao,0,0,0,0
1668310344436,CSE 291,B00,102448,Polikarpova; Nadezhda,0,0,0,0
1668310344436,CSE 291,C00,102453,Vaccaro; Kristen Marie,0,0,0,0
1668310344436,CSE 291,D00,111343,Savage; Stefan,0,0,0,0
1668310344436,CSE 291,E00,116474,Claffy; Kimberly Claire,0,0,0,0
1668310344436,CSE 291,F00,116479,Pasquale; Joseph,0,0,0,0
1668310344870,CSE 293,001,119111,Bafna; Vineet,9999,0,9999,0
1668310344870,CSE 293,002,119118,Bellare; Mihir,9999,0,9999,0
1668310344870,CSE 293,003,119122,Berg-Kirkpatrick; Taylor D,9999,0,9999,0
1668310344870,CSE 293,004,119135,Christensen; Henrik I,9999,0,9999,0
1668310344870,CSE 293,005,119142,Cottrell; Garrison W,9999,0,9999,0
1668310344870,CSE 293,006,119146,Deutsch; Alin Bernard,9999,0,9999,0
1668310344870,CSE 293,007,119159,Esmaeilzadeh; Hadi,9999,0,9999,0
1668310344870,CSE 293,008,119166,Freund; Yoav,9999,0,9999,0
1668310344870,CSE 293,009,119170,Griswold; William G.,9999,0,9999,0
1668310344870,CSE 293,010,119183,Gymrek; Melissa Ann,9999,0,9999,0
1668310344870,CSE 293,011,119190,Heninger; Nadia A,9999,0,9999,0
1668310344870,CSE 293,012,119230,Impagliazzo; Russell,9999,0,9999,0
1668310344870,CSE 293,013,119232,Jhala; Ranjit,9999,0,9999,0
1668310344870,CSE 293,014,119233,Kahng; Andrew Byun,9999,0,9999,0
1668310344870,CSE 293,015,119298,Kane; Daniel Mertz,9999,0,9999,0
1668310344870,CSE 293,016,119299,Kriegman; David J,9999,0,9999,0
1668310344870,CSE 293,017,119300,Kumar; Arun Kumar,9999,0,9999,0
1668310344870,CSE 293,018,119301,Lerner; Sorin,9999,0,9999,0
1668310344870,CSE 293,019,119302,Lovett; Shachar,9999,0,9999,0
1668310344870,CSE 293,020,119303,McAuley; Julian John,9999,0,9999,0
1668310344870,CSE 293,021,119304,Micciancio; Daniele,9999,0,9999,0
1668310344870,CSE 293,022,119367,Orailoglu; Alex,9999,0,9999,0
1668310344870,CSE 293,023,119382,Paturi; Ramamohan,9999,0,9999,0
1668310344870,CSE 293,024,119404,Polikarpova; Nadezhda,9999,0,9999,0
1668310344870,CSE 293,025,119406,Politz; Joseph Gibbs,9999,0,9999,0
1668310344870,CSE 293,026,119411,Porter; George M,9999,0,9999,0
1668310344870,CSE 293,027,119414,Porter; Leonard Emerson,9999,0,9999,0
1668310344870,CSE 293,028,119416,Ramamoorthi; Ravi,9999,0,9999,0
1668310344870,CSE 293,029,119417,Sahoo; Debashis,9999,0,9999,0
1668310344870,CSE 293,030,119420,Saul; Lawrence,9999,0,9999,0
1668310344870,CSE 293,031,119421,Savage; Stefan,9999,0,9999,0
1668310344870,CSE 293,032,119425,Schulze; Jurgen P.,9999,0,9999,0
1668310344870,CSE 293,033,119426,Snoeren; Alex C.,9999,0,9999,0
1668310344870,CSE 293,034,119428,Shang; Jingbo,9999,0,9999,0
1668310344870,CSE 293,035,119430,Stefan; Deian,9999,0,9999,0
1668310344870,CSE 293,036,119431,Su; Hao,9999,0,9999,0
1668310344870,CSE 293,037,119433,Swanson; Steven James,9999,0,9999,0
1668310344870,CSE 293,038,119435,Tullsen; Dean Michael,9999,0,9999,0
1668310344870,CSE 293,039,119483,Voelker; Geoffrey M.,9999,0,9999,0
1668310344870,CSE 293,040,119537,Zhao; Jishen,9999,0,9999,0
1668310344870,CSE 293,041,119538,Zhou; Yuan-Yuan,9999,0,9999,0
1668310344870,CSE 293,042,119539,Gao; Sicun,9999,0,9999,0
1668310344870,CSE 293,043,119540,Weibel; Nadir,9999,0,9999,0
1668310344870,CSE 293,044,119541,Gupta; Rajesh K.,9999,0,9999,0
1668310344870,CSE 293,045,126410,Vaccaro; Kristen Marie,9999,0,9999,0
1668310344870,CSE 293,046,126411,Klemke; Richard,9999,0,9999,0
1668310345306,CSE 294,A00,102459,Voelker; Geoffrey M.,0,0,0,0
1668310345306,CSE 294,B00,111322,Orailoglu; Alex,0,0,0,0
1668310345736,DSE 201,A00,096914,Deutsch; Alin Bernard,30,0,30,0
1668310346162,DSE 210,A00,096915,Dasgupta; Sanjoy,30,0,30,0
1668310346584,DSE 260A,A00,096916,Altintas De Callaf; Ilkay,30,0,30,0
1668310347017,ECE 200,001,103586,Antipa; Nicholas A,9999,0,9999,0
1668310347017,ECE 200,002,103587,Atanasov; Nikolay A.,9999,0,9999,0
1668310347017,ECE 200,003,103588,Bharadia; Dinesh,9999,0,9999,0
1668310347017,ECE 200,004,103589,Cheng; Chung Kuan,9999,0,9999,0
1668310347017,ECE 200,005,103590,Cosman; Pamela C.,9999,0,9999,0
1668310347017,ECE 200,006,103591,Dayeh; Shadi Ahmad,9999,0,9999,0
1668310347017,ECE 200,007,103592,Fainman; Yeshaiahu,9999,0,9999,0
1668310347017,ECE 200,008,103593,Ford; Joseph Earl,9999,0,9999,0
1668310347017,ECE 200,009,103594,Franceschetti; Massimo,9999,0,9999,0
1668310347017,ECE 200,010,103595,Fullerton; Eric E,9999,0,9999,0
1668310347017,ECE 200,011,103596,Galton; Ian A,9999,0,9999,0
1668310347017,ECE 200,012,103597,Gilja; Vikash,9999,0,9999,0
1668310347017,ECE 200,013,103598,Hall; Drew A.,9999,0,9999,0
1668310347017,ECE 200,014,103599,Hsueh; Tzu-Chien,9999,0,9999,0
1668310347017,ECE 200,015,103600,Javidi; Tara,9999,0,9999,0
1668310347017,ECE 200,016,103601,Kahng; Andrew Byun,9999,0,9999,0
1668310347017,ECE 200,017,103602,Kim; Young-Han,9999,0,9999,0
1668310347017,ECE 200,018,103603,Koushanfar; Farinaz,9999,0,9999,0
1668310347017,ECE 200,019,103604,Kuzum; Duygu,9999,0,9999,0
1668310347017,ECE 200,020,103605,Le; Hanh-Phuc,9999,0,9999,0
1668310347017,ECE 200,021,103606,Lin; Bill,9999,0,9999,0
1668310347017,ECE 200,022,103607,Liu; Zhaowei,9998,0,9999,1
1668310347017,ECE 200,023,103608,Lo; Yu-Hwa,9999,0,9999,0
1668310347017,ECE 200,024,103609,Lomakin; Vitaliy,9999,0,9999,0
1668310347017,ECE 200,025,103610,Mercier; Patrick Philip,9999,0,9999,0
1668310347017,ECE 200,026,103611,Meyer; Florian,9999,0,9999,0
1668310347017,ECE 200,027,103612,Milstein; Laurence B.,9999,0,9999,0
1668310347017,ECE 200,028,103613,Mir Arabbaygi; Siavash,9999,0,9999,0
1668310347017,ECE 200,029,103614,Mookherjea; Shayan,9999,0,9999,0
1668310347017,ECE 200,030,103615,Morris; Karcher William,9999,0,9999,0
1668310347017,ECE 200,031,103616,Ng; Tse Nga,9999,0,9999,0
1668310347017,ECE 200,032,103617,Nguyen; Truong Quang,9999,0,9999,0
1668310347017,ECE 200,033,103618,Nomura; Kenji,9999,0,9999,0
1668310347017,ECE 200,034,103619,Orlitsky; Alon,9999,0,9999,0
1668310347017,ECE 200,035,103620,Pal; Piya,9999,0,9999,0
1668310347017,ECE 200,036,103621,Papen; George C.,9999,0,9999,0
1668310347017,ECE 200,037,103622,Radic; Stojan,9999,0,9999,0
1668310347017,ECE 200,038,103623,Rao; Bhaskar D.,9999,0,9999,0
1668310347017,ECE 200,039,103624,Rao; Ramesh R,9999,0,9999,0
1668310347017,ECE 200,040,103625,Rebeiz; Gabriel,9999,0,9999,0
1668310347017,ECE 200,041,103626,Sanford; John R,9999,0,9999,0
1668310347017,ECE 200,042,103627,Siegel; Paul H.,9999,0,9999,0
1668310347017,ECE 200,043,103628,Sievenpiper; Daniel F.,9999,0,9999,0
1668310347017,ECE 200,044,103629,Sworder; David D.,9999,0,9999,0
1668310347017,ECE 200,045,103630,Taur; Yuan,9999,0,9999,0
1668310347017,ECE 200,046,103631,Touri; Behrouz,9999,0,9999,0
1668310347017,ECE 200,047,103632,Trivedi; Mohan M.,9999,0,9999,0
1668310347017,ECE 200,048,103633,Vasconcelos; Nuno,9999,0,9999,0
1668310347017,ECE 200,049,103634,Wang; Xiaolong,9999,0,9999,0
1668310347017,ECE 200,050,103635,Xie; Pengtao,9999,0,9999,0
1668310347017,ECE 200,051,103636,Yip; Michael,9999,0,9999,0
1668310347017,ECE 200,052,103637,Zeger; Kenneth A.,999,0,999,0
1668310347017,ECE 200,053,103638,Zhang; Xinyu,9999,0,9999,0
1668310347017,ECE 200,054,103639,Turakhia; Yatish Girish,9999,0,9999,0
1668310347017,ECE 200,055,103640,Kang; Mingu,9999,0,9999,0
1668310347017,ECE 200,056,103641,Shi; Yuanyuan,9999,0,9999,0
1668310347017,ECE 200,057,103642,Wang; Edward Jay,9999,0,9999,0
1668310347017,ECE 200,058,103643,Zheng; Yang,9999,0,9999,0
1668310347442,ECE 202,A00,103644,Kuzum; Duygu,0,0,0,0
1668310347870,ECE 212BN,A00,103646,Ng; Tse Nga,0,0,0,0
1668310348294,ECE 221,A00,111493,Staff,0,0,0,0
1668310348718,ECE 222B,A00,103647,Lomakin; Vitaliy,0,0,0,0
1668310349142,ECE 230B,A00,103648,Taur; Yuan,0,0,0,0
1668310349569,ECE 238B,A00,103649,Garay; Javier,0,0,0,0
1668310349994,ECE 240B,A00,112900,Fainman; Yeshaiahu,0,0,0,0
1668310350437,ECE 247A,A00,103650,Jokerst; Jesse Vincent,0,0,0,0
1668310350866,ECE 247B,A00,103651,Wang; Joseph,0,0,0,0
1668310351290,ECE 250,A00,103652,Siegel; Paul H.,0,0,0,0
1668310351727,ECE 251A,A00,103654,Rao; Bhaskar D.,0,0,0,0
1668310352154,ECE 257B,A00,103655,Bharadia; Dinesh,0,0,0,0
1668310352580,ECE 258A,A00,103656,Milstein; Laurence B.,0,0,0,0
1668310353007,ECE 260B,A00,103658,Kang; Mingu,0,0,0,0
1668310353431,ECE 264A,A00,103659,Galton; Ian A,0,0,0,0
1668310353856,ECE 265A,A00,103661,Gudem; Prasad S.S.,0,0,0,0
1668310354282,ECE 265D,A00,103662,Gudem; Prasad S.S.,0,0,0,0
1668310354708,ECE 268,A00,103663,Koushanfar; Farinaz,0,0,0,0
1668310355135,ECE 269,A01,103665,Pal; Piya,0,0,0,0
1668310355558,ECE 271B,A00,103666,Vasconcelos; Manuela,0,0,0,0
1668310355983,ECE 276A,A00,103667,Atanasov; Nikolay A.,0,0,0,0
1668310356417,ECE 277,A00,103668,An; Cheolhong,0,0,0,0
1668310356841,ECE 279,A00,117947,Hall; Drew A.,0,0,0,0
1668310357694,ECE 283,A00,103670,Hsueh; Tzu-Chien,0,0,0,0
1668310358118,ECE 284,A00,103671,Turakhia; Yatish Girish,0,0,0,0
1668310358546,ECE 285,A00,103672,Zheng; Yang,0,0,0,0
1668310358546,ECE 285,B00,103673,Sworder; David D.,0,0,0,0
1668310358968,ECE 287,A00,103676,Javidi; Tara,0,0,0,0
1668310359396,MATH 200B,A00,098023,Salehi Golsefidy; Alireza,12,0,15,3
1668310359821,MATH 202B,A00,098024,Rhoades; Brendon Patrick,9,0,15,6
1668310360246,MATH 203B,A00,098025,Oprea; Dragos N.,10,0,15,5
1668310360669,MATH 204B,A00,098026,Sorensen; Claus M,13,0,15,2
1668310361096,MATH 208,A00,098027,Izadi; Elham,7,0,10,3
1668310361521,MATH 209,A00,098028,Pollack; Aaron,10,0,10,0
1668310361947,MATH 211A,A00,112919,Rogalski; Daniel,9,0,10,1
1668310362463,MATH 211B,A00,112920,Seward; Brandon M.,9,0,10,1
1668310362889,MATH 218,A00,098029,Li; Bo,10,0,10,0
1668310363312,MATH 220B,A00,098030,Novak; Jonathan I,11,0,15,4
1668310363737,MATH 221A,A00,098031,Ebenfelt; Peter F,13,0,15,2
1668310364165,MATH 231B,A00,098032,Zlatos; Andrej,12,0,15,3
1668310364589,MATH 240B,A00,098033,Ni; Lei,9,0,15,6
1668310365013,MATH 243,A00,098034,Jekel; David Andrew,10,0,10,0
1668310365446,MATH 245A,A00,098035,Nie; Jiawang,0,0,15,16
1668310365868,MATH 248,A00,098036,Bejenaru; Ioan,10,0,10,0
1668310366295,MATH 250B,A00,098037,Spolaor; Luca,14,0,15,1
1668310366718,MATH 258,A00,098038,Ni; Lei,10,0,10,0
1668310367141,MATH 264B,A00,098041,Rhoades; Brendon Patrick,9,0,15,6
1668310367564,MATH 268,A00,098042,Buss; Samuel R,10,0,10,0
1668310367991,MATH 269,A00,098043,Rhoades; Brendon Patrick,10,0,10,0
1668310368418,MATH 270B,A00,098044,Li; Bo,10,0,15,5
1668310368845,MATH 272B,A00,098045,Holst; Michael J,13,0,15,2
1668310369271,MATH 273A,A00,098046,Tian; Xiaochuan,10,0,15,5
1668310369695,MATH 275,A01,098048,Tian; Xiaochuan,6,0,10,4
1668310370120,MATH 278A,A00,098049,Holst; Michael J,8,0,10,2
1668310370547,MATH 278B,A00,098050,Cloninger; Alexander,10,0,10,0
1668310370970,MATH 278C,A00,098051,Nie; Jiawang,7,0,10,3
1668310371405,MATH 280B,A00,098052,Zheng; Tianyi,8,0,15,7
1668310371829,MATH 281B,A00,098053,Bradic; Jelena,1,0,15,14
1668310372258,MATH 282B,A00,098054,Arias-Castro; Ery,0,0,15,15
1668310372684,MATH 285,A00,098055,Fitzsimmons; Patrick J,0,0,15,17
1668310373107,MATH 287B,A00,098056,Arias-Castro; Ery,2,0,15,13
1668310373532,MATH 288,A00,098057,Agarwal; Pooja,9,0,10,1
1668310373532,MATH 288,B00,098058,Zhang; Danna,8,0,10,2
1668310373532,MATH 288,C00,098059,Williams; Ruth J,9,0,10,1
1668310373956,MATH 290B,A00,098060,Roberts; Justin Deritter,13,0,15,2
1668310374381,MATH 292,A00,098061,Belmont; Eva Kinoshita,10,0,10,0
1668310374803,MATH 295,A00,098062,Suk; Andrew Hoon,48,0,50,2
1668310375229,MATH 296,A00,098063,Novak; Jonathan I,20,0,20,0
1668310375654,MATH 297,001,098064,Gamst; Anthony Collins,9997,0,9999,2
1668310874912,COGS 205,A00,101395,Chiba; Andrea,19,0,20,1
1668310875340,COGS 210B,001,101404,Greene; Deanna Jacquelyn,9998,0,9999,1
1668310875340,COGS 210B,002,101417,Xia; Haijun,9999,0,9999,0
1668310875340,COGS 210B,003,101422,Nitz; Douglas A.,9999,0,9999,0
1668310875340,COGS 210B,004,101423,Hollan; James D.,9998,0,9999,1
1668310875340,COGS 210B,005,101424,Deak; Gedeon O.,9998,0,9999,1
1668310875340,COGS 210B,006,101425,Rossano; Federico,9999,0,9999,0
1668310875765,COGS 211B,A00,101427,Coulson; Seana M,9996,0,9999,3
1668310876191,COGS 220,A00,101428,Hollan; James D.,0,0,25,25
1668310876616,COGS 229,A00,101429,Dow; Steven P,18,0,25,7
1668310877049,COGS 230,A00,101430,Klemmer; Scott R,12,0,17,5
1668310877472,COGS 234,A00,101431,Xia; Haijun,1,0,25,24
1668310877897,COGS 260,A00,101432,Kiyonaga; Anastasia,21,0,25,4
1668310877897,COGS 260,B00,101433,Kirsh; David Joel,15,0,25,10
1668310878321,CSE 202,A00,102371,Impagliazzo; Russell,0,0,0,0
1668310878746,CSE 203B,A01,102373,Cheng; Chung Kuan,0,0,0,0
1668310879172,CSE 208,A00,102374,Micciancio; Daniele,0,0,0,0
1668310879596,CSE 209A,A00,112895,Impagliazzo; Russell,0,0,15,15
1668310880021,CSE 209B,A00,108005,Bellare; Mihir,0,0,0,0
1668310880447,CSE 210,A00,113163,Coblenz; Michael J,0,0,0,0
1668310880875,CSE 219,A00,106111,Dow; Steven P,0,0,20,20
1668310881300,CSE 221,A00,102376,Voelker; Geoffrey M.,0,0,0,0
1668310881828,CSE 224,A01,102378,Porter; George M,0,0,0,0
1668310882269,CSE 229A,A00,102379,Savage; Stefan,0,0,0,0
1668310882698,CSE 229C,A00,102380,Munyaka; Imani N. S.,0,0,0,0
1668310883122,CSE 232B,A00,102382,Deutsch; Alin Bernard,0,0,0,0
1668310883547,CSE 234,A01,112904,Kumar; Arun Kumar,0,0,0,0
1668310883971,CSE 237A,A00,102383,Rosing; Tajana Simunic,0,0,0,0
1668310884399,CSE 239A,A00,102384,Deutsch; Alin Bernard,0,0,0,0
1668310884825,CSE 239B,A00,102385,Polikarpova; Nadezhda,0,0,0,0
1668310885250,CSE 240A,A00,102386,Pannuto; Patrick William,0,0,0,0
1668310885675,CSE 240B,A00,102387,Zhao; Jishen,0,0,0,0
1668310886098,CSE 241A,A00,106406,Kang; Mingu,0,0,0,0
1668310886526,CSE 249B,A00,102388,Kahng; Andrew Byun,0,0,8,8
1668310886952,CSE 251B,A01,102392,Cottrell; Garrison W,0,0,0,0
1668310886952,CSE 251B,A02,102393,Cottrell; Garrison W,0,0,0,0
1668310887377,CSE 252B,A00,102394,Ochoa; Benjamin Lawrence,0,0,0,0
1668310887803,CSE 257,A01,102396,Gao; Sicun,0,0,0,0
1668310888231,CSE 272,A00,102397,Li; Tzumao,0,0,0,0
1668310888658,CSE 274,A00,111323,Chern; Albert Ren-Haur,0,0,0,0
1668310889082,CSE 282,A00,102398,Pevzner; Pavel Arkadjevich,0,0,0,0
1668310889507,CSE 284,A00,114175,Gymrek; Melissa Ann,0,0,0,0
1668310889932,CSE 290,A00,102399,Chandraker; Manmohan Krishna,0,0,0,0
1668310889932,CSE 290,B00,102400,Vaccaro; Kristen Marie,0,0,25,25
1668310889932,CSE 290,C00,102414,Pannuto; Patrick William,0,0,25,25
1668310889932,CSE 290,D00,102427,Pevzner; Pavel Arkadjevich,0,0,0,0
1668310889932,CSE 290,E00,102429,Zhao; Jishen,0,0,0,0
1668310889932,CSE 290,F00,102436,Tullsen; Dean Michael,0,0,0,0
1668310889932,CSE 290,G00,102440,Christensen; Henrik I,0,0,20,20
1668310890360,CSE 291,A00,102443,Su; Hao,0,0,0,0
1668310890360,CSE 291,B00,102448,Polikarpova; Nadezhda,0,0,0,0
1668310890360,CSE 291,C00,102453,Vaccaro; Kristen Marie,0,0,0,0
1668310890360,CSE 291,D00,111343,Savage; Stefan,0,0,0,0
1668310890360,CSE 291,E00,116474,Claffy; Kimberly Claire,0,0,0,0
1668310890360,CSE 291,F00,116479,Pasquale; Joseph,0,0,0,0
1668310890793,CSE 293,001,119111,Bafna; Vineet,9999,0,9999,0
1668310890793,CSE 293,002,119118,Bellare; Mihir,9999,0,9999,0
1668310890793,CSE 293,003,119122,Berg-Kirkpatrick; Taylor D,9999,0,9999,0
1668310890793,CSE 293,004,119135,Christensen; Henrik I,9999,0,9999,0
1668310890793,CSE 293,005,119142,Cottrell; Garrison W,9999,0,9999,0
1668310890793,CSE 293,006,119146,Deutsch; Alin Bernard,9999,0,9999,0
1668310890793,CSE 293,007,119159,Esmaeilzadeh; Hadi,9999,0,9999,0
1668310890793,CSE 293,008,119166,Freund; Yoav,9999,0,9999,0
1668310890793,CSE 293,009,119170,Griswold; William G.,9999,0,9999,0
1668310890793,CSE 293,010,119183,Gymrek; Melissa Ann,9999,0,9999,0
1668310890793,CSE 293,011,119190,Heninger; Nadia A,9999,0,9999,0
1668310890793,CSE 293,012,119230,Impagliazzo; Russell,9999,0,9999,0
1668310890793,CSE 293,013,119232,Jhala; Ranjit,9999,0,9999,0
1668310890793,CSE 293,014,119233,Kahng; Andrew Byun,9999,0,9999,0
1668310890793,CSE 293,015,119298,Kane; Daniel Mertz,9999,0,9999,0
1668310890793,CSE 293,016,119299,Kriegman; David J,9999,0,9999,0
1668310890793,CSE 293,017,119300,Kumar; Arun Kumar,9999,0,9999,0
1668310890793,CSE 293,018,119301,Lerner; Sorin,9999,0,9999,0
1668310890793,CSE 293,019,119302,Lovett; Shachar,9999,0,9999,0
1668310890793,CSE 293,020,119303,McAuley; Julian John,9999,0,9999,0
1668310890793,CSE 293,021,119304,Micciancio; Daniele,9999,0,9999,0
1668310890793,CSE 293,022,119367,Orailoglu; Alex,9999,0,9999,0
1668310890793,CSE 293,023,119382,Paturi; Ramamohan,9999,0,9999,0
1668310890793,CSE 293,024,119404,Polikarpova; Nadezhda,9999,0,9999,0
1668310890793,CSE 293,025,119406,Politz; Joseph Gibbs,9999,0,9999,0
1668310890793,CSE 293,026,119411,Porter; George M,9999,0,9999,0
1668310890793,CSE 293,027,119414,Porter; Leonard Emerson,9999,0,9999,0
1668310890793,CSE 293,028,119416,Ramamoorthi; Ravi,9999,0,9999,0
1668310890793,CSE 293,029,119417,Sahoo; Debashis,9999,0,9999,0
1668310890793,CSE 293,030,119420,Saul; Lawrence,9999,0,9999,0
1668310890793,CSE 293,031,119421,Savage; Stefan,9999,0,9999,0
1668310890793,CSE 293,032,119425,Schulze; Jurgen P.,9999,0,9999,0
1668310890793,CSE 293,033,119426,Snoeren; Alex C.,9999,0,9999,0
1668310890793,CSE 293,034,119428,Shang; Jingbo,9999,0,9999,0
1668310890793,CSE 293,035,119430,Stefan; Deian,9999,0,9999,0
1668310890793,CSE 293,036,119431,Su; Hao,9999,0,9999,0
1668310890793,CSE 293,037,119433,Swanson; Steven James,9999,0,9999,0
1668310890793,CSE 293,038,119435,Tullsen; Dean Michael,9999,0,9999,0
1668310890793,CSE 293,039,119483,Voelker; Geoffrey M.,9999,0,9999,0
1668310890793,CSE 293,040,119537,Zhao; Jishen,9999,0,9999,0
1668310890793,CSE 293,041,119538,Zhou; Yuan-Yuan,9999,0,9999,0
1668310890793,CSE 293,042,119539,Gao; Sicun,9999,0,9999,0
1668310890793,CSE 293,043,119540,Weibel; Nadir,9999,0,9999,0
1668310890793,CSE 293,044,119541,Gupta; Rajesh K.,9999,0,9999,0
1668310890793,CSE 293,045,126410,Vaccaro; Kristen Marie,9999,0,9999,0
1668310890793,CSE 293,046,126411,Klemke; Richard,9999,0,9999,0
1668310891219,CSE 294,A00,102459,Voelker; Geoffrey M.,0,0,0,0
1668310891219,CSE 294,B00,111322,Orailoglu; Alex,0,0,0,0
1668310891642,DSE 201,A00,096914,Deutsch; Alin Bernard,30,0,30,0
1668310892068,DSE 210,A00,096915,Dasgupta; Sanjoy,30,0,30,0
1668310892494,DSE 260A,A00,096916,Altintas De Callaf; Ilkay,30,0,30,0
1668310892963,ECE 200,001,103586,Antipa; Nicholas A,9999,0,9999,0
1668310892963,ECE 200,002,103587,Atanasov; Nikolay A.,9999,0,9999,0
1668310892963,ECE 200,003,103588,Bharadia; Dinesh,9999,0,9999,0
1668310892963,ECE 200,004,103589,Cheng; Chung Kuan,9999,0,9999,0
1668310892963,ECE 200,005,103590,Cosman; Pamela C.,9999,0,9999,0
1668310892963,ECE 200,006,103591,Dayeh; Shadi Ahmad,9999,0,9999,0
1668310892963,ECE 200,007,103592,Fainman; Yeshaiahu,9999,0,9999,0
1668310892963,ECE 200,008,103593,Ford; Joseph Earl,9999,0,9999,0
1668310892963,ECE 200,009,103594,Franceschetti; Massimo,9999,0,9999,0
1668310892963,ECE 200,010,103595,Fullerton; Eric E,9999,0,9999,0
1668310892963,ECE 200,011,103596,Galton; Ian A,9999,0,9999,0
1668310892963,ECE 200,012,103597,Gilja; Vikash,9999,0,9999,0
1668310892963,ECE 200,013,103598,Hall; Drew A.,9999,0,9999,0
1668310892963,ECE 200,014,103599,Hsueh; Tzu-Chien,9999,0,9999,0
1668310892963,ECE 200,015,103600,Javidi; Tara,9999,0,9999,0
1668310892963,ECE 200,016,103601,Kahng; Andrew Byun,9999,0,9999,0
1668310892963,ECE 200,017,103602,Kim; Young-Han,9999,0,9999,0
1668310892963,ECE 200,018,103603,Koushanfar; Farinaz,9999,0,9999,0
1668310892963,ECE 200,019,103604,Kuzum; Duygu,9999,0,9999,0
1668310892963,ECE 200,020,103605,Le; Hanh-Phuc,9999,0,9999,0
1668310892963,ECE 200,021,103606,Lin; Bill,9999,0,9999,0
1668310892963,ECE 200,022,103607,Liu; Zhaowei,9998,0,9999,1
1668310892963,ECE 200,023,103608,Lo; Yu-Hwa,9999,0,9999,0
1668310892963,ECE 200,024,103609,Lomakin; Vitaliy,9999,0,9999,0
1668310892963,ECE 200,025,103610,Mercier; Patrick Philip,9999,0,9999,0
1668310892963,ECE 200,026,103611,Meyer; Florian,9999,0,9999,0
1668310892963,ECE 200,027,103612,Milstein; Laurence B.,9999,0,9999,0
1668310892963,ECE 200,028,103613,Mir Arabbaygi; Siavash,9999,0,9999,0
1668310892963,ECE 200,029,103614,Mookherjea; Shayan,9999,0,9999,0
1668310892963,ECE 200,030,103615,Morris; Karcher William,9999,0,9999,0
1668310892963,ECE 200,031,103616,Ng; Tse Nga,9999,0,9999,0
1668310892963,ECE 200,032,103617,Nguyen; Truong Quang,9999,0,9999,0
1668310892963,ECE 200,033,103618,Nomura; Kenji,9999,0,9999,0
1668310892963,ECE 200,034,103619,Orlitsky; Alon,9999,0,9999,0
1668310892963,ECE 200,035,103620,Pal; Piya,9999,0,9999,0
1668310892963,ECE 200,036,103621,Papen; George C.,9999,0,9999,0
1668310892963,ECE 200,037,103622,Radic; Stojan,9999,0,9999,0
1668310892963,ECE 200,038,103623,Rao; Bhaskar D.,9999,0,9999,0
1668310892963,ECE 200,039,103624,Rao; Ramesh R,9999,0,9999,0
1668310892963,ECE 200,040,103625,Rebeiz; Gabriel,9999,0,9999,0
1668310892963,ECE 200,041,103626,Sanford; John R,9999,0,9999,0
1668310892963,ECE 200,042,103627,Siegel; Paul H.,9999,0,9999,0
1668310892963,ECE 200,043,103628,Sievenpiper; Daniel F.,9999,0,9999,0
1668310892963,ECE 200,044,103629,Sworder; David D.,9999,0,9999,0
1668310892963,ECE 200,045,103630,Taur; Yuan,9999,0,9999,0
1668310892963,ECE 200,046,103631,Touri; Behrouz,9999,0,9999,0
1668310892963,ECE 200,047,103632,Trivedi; Mohan M.,9999,0,9999,0
1668310892963,ECE 200,048,103633,Vasconcelos; Nuno,9999,0,9999,0
1668310892963,ECE 200,049,103634,Wang; Xiaolong,9999,0,9999,0
1668310892963,ECE 200,050,103635,Xie; Pengtao,9999,0,9999,0
1668310892963,ECE 200,051,103636,Yip; Michael,9999,0,9999,0
1668310892963,ECE 200,052,103637,Zeger; Kenneth A.,999,0,999,0
1668310892963,ECE 200,053,103638,Zhang; Xinyu,9999,0,9999,0
1668310892963,ECE 200,054,103639,Turakhia; Yatish Girish,9999,0,9999,0
1668310892963,ECE 200,055,103640,Kang; Mingu,9999,0,9999,0
1668310892963,ECE 200,056,103641,Shi; Yuanyuan,9999,0,9999,0
1668310892963,ECE 200,057,103642,Wang; Edward Jay,9999,0,9999,0
1668310892963,ECE 200,058,103643,Zheng; Yang,9999,0,9999,0
1668310893386,ECE 202,A00,103644,Kuzum; Duygu,0,0,0,0
1668310893809,ECE 212BN,A00,103646,Ng; Tse Nga,0,0,0,0
1668310894250,ECE 221,A00,111493,Staff,0,0,0,0
1668310894673,ECE 222B,A00,103647,Lomakin; Vitaliy,0,0,0,0
1668310895098,ECE 230B,A00,103648,Taur; Yuan,0,0,0,0
1668310895522,ECE 238B,A00,103649,Garay; Javier,0,0,0,0
1668310895948,ECE 240B,A00,112900,Fainman; Yeshaiahu,0,0,0,0
1668310896371,ECE 247A,A00,103650,Jokerst; Jesse Vincent,0,0,0,0
1668310896794,ECE 247B,A00,103651,Wang; Joseph,0,0,0,0
1668310897218,ECE 250,A00,103652,Siegel; Paul H.,0,0,0,0
1668310897639,ECE 251A,A00,103654,Rao; Bhaskar D.,0,0,0,0
1668310898064,ECE 257B,A00,103655,Bharadia; Dinesh,0,0,0,0
1668310898486,ECE 258A,A00,103656,Milstein; Laurence B.,0,0,0,0
1668310898914,ECE 260B,A00,103658,Kang; Mingu,0,0,0,0
1668310899335,ECE 264A,A00,103659,Galton; Ian A,0,0,0,0
1668310899763,ECE 265A,A00,103661,Gudem; Prasad S.S.,0,0,0,0
1668310900186,ECE 265D,A00,103662,Gudem; Prasad S.S.,0,0,0,0
1668310900616,ECE 268,A00,103663,Koushanfar; Farinaz,0,0,0,0
1668310901041,ECE 269,A01,103665,Pal; Piya,0,0,0,0
1668310901471,ECE 271B,A00,103666,Vasconcelos; Manuela,0,0,0,0
1668310901899,ECE 276A,A00,103667,Atanasov; Nikolay A.,0,0,0,0
1668310902323,ECE 277,A00,103668,An; Cheolhong,0,0,0,0
1668310902747,ECE 279,A00,117947,Hall; Drew A.,0,0,0,0
1668310903593,ECE 283,A00,103670,Hsueh; Tzu-Chien,0,0,0,0
1668310904017,ECE 284,A00,103671,Turakhia; Yatish Girish,0,0,0,0
1668310904442,ECE 285,A00,103672,Zheng; Yang,0,0,0,0
1668310904442,ECE 285,B00,103673,Sworder; David D.,0,0,0,0
1668310904866,ECE 287,A00,103676,Javidi; Tara,0,0,0,0
1668310905293,MATH 200B,A00,098023,Salehi Golsefidy; Alireza,12,0,15,3
1668310905719,MATH 202B,A00,098024,Rhoades; Brendon Patrick,9,0,15,6
1668310906142,MATH 203B,A00,098025,Oprea; Dragos N.,10,0,15,5
1668310906565,MATH 204B,A00,098026,Sorensen; Claus M,13,0,15,2
1668310906990,MATH 208,A00,098027,Izadi; Elham,7,0,10,3
1668310907411,MATH 209,A00,098028,Pollack; Aaron,10,0,10,0
1668310907839,MATH 211A,A00,112919,Rogalski; Daniel,9,0,10,1
1668310908264,MATH 211B,A00,112920,Seward; Brandon M.,9,0,10,1
1668310908687,MATH 218,A00,098029,Li; Bo,10,0,10,0
1668310909119,MATH 220B,A00,098030,Novak; Jonathan I,11,0,15,4
1668310909542,MATH 221A,A00,098031,Ebenfelt; Peter F,13,0,15,2
1668310909966,MATH 231B,A00,098032,Zlatos; Andrej,12,0,15,3
1668310910391,MATH 240B,A00,098033,Ni; Lei,9,0,15,6
1668310910814,MATH 243,A00,098034,Jekel; David Andrew,10,0,10,0
1668310911242,MATH 245A,A00,098035,Nie; Jiawang,0,0,15,16
1668310911665,MATH 248,A00,098036,Bejenaru; Ioan,10,0,10,0
1668310912088,MATH 250B,A00,098037,Spolaor; Luca,14,0,15,1
1668310912514,MATH 258,A00,098038,Ni; Lei,10,0,10,0
1668310912939,MATH 264B,A00,098041,Rhoades; Brendon Patrick,9,0,15,6
1668310913361,MATH 268,A00,098042,Buss; Samuel R,10,0,10,0
1668310913785,MATH 269,A00,098043,Rhoades; Brendon Patrick,10,0,10,0
1668310914210,MATH 270B,A00,098044,Li; Bo,10,0,15,5
1668310914633,MATH 272B,A00,098045,Holst; Michael J,13,0,15,2
1668310915056,MATH 273A,A00,098046,Tian; Xiaochuan,10,0,15,5
1668310915482,MATH 275,A01,098048,Tian; Xiaochuan,6,0,10,4
1668310915908,MATH 278A,A00,098049,Holst; Michael J,8,0,10,2
1668310916332,MATH 278B,A00,098050,Cloninger; Alexander,10,0,10,0
1668310916756,MATH 278C,A00,098051,Nie; Jiawang,7,0,10,3
1668310917179,MATH 280B,A00,098052,Zheng; Tianyi,8,0,15,7
1668310917604,MATH 281B,A00,098053,Bradic; Jelena,1,0,15,14
1668310918028,MATH 282B,A00,098054,Arias-Castro; Ery,0,0,15,15
1668310918454,MATH 285,A00,098055,Fitzsimmons; Patrick J,0,0,15,17
1668310918879,MATH 287B,A00,098056,Arias-Castro; Ery,2,0,15,13
1668310919303,MATH 288,A00,098057,Agarwal; Pooja,9,0,10,1
1668310919303,MATH 288,B00,098058,Zhang; Danna,8,0,10,2
1668310919303,MATH 288,C00,098059,Williams; Ruth J,9,0,10,1
1668310919727,MATH 290B,A00,098060,Roberts; Justin Deritter,13,0,15,2
1668310920159,MATH 292,A00,098061,Belmont; Eva Kinoshita,10,0,10,0
1668310920587,MATH 295,A00,098062,Suk; Andrew Hoon,48,0,50,2
1668310921012,MATH 296,A00,098063,Novak; Jonathan I,20,0,20,0
1668310921437,MATH 297,001,098064,Gamst; Anthony Collins,9997,0,9999,2
1668311430364,COGS 205,A00,101395,Chiba; Andrea,19,0,20,1
1668311430789,COGS 210B,001,101404,Greene; Deanna Jacquelyn,9998,0,9999,1
1668311430789,COGS 210B,002,101417,Xia; Haijun,9999,0,9999,0
1668311430789,COGS 210B,003,101422,Nitz; Douglas A.,9999,0,9999,0
1668311430789,COGS 210B,004,101423,Hollan; James D.,9998,0,9999,1
1668311430789,COGS 210B,005,101424,Deak; Gedeon O.,9998,0,9999,1
1668311430789,COGS 210B,006,101425,Rossano; Federico,9999,0,9999,0
1668311431223,COGS 211B,A00,101427,Coulson; Seana M,9996,0,9999,3
1668311431648,COGS 220,A00,101428,Hollan; James D.,0,0,25,25
1668311432076,COGS 229,A00,101429,Dow; Steven P,18,0,25,7
1668311432500,COGS 230,A00,101430,Klemmer; Scott R,12,0,17,5
1668311432924,COGS 234,A00,101431,Xia; Haijun,1,0,25,24
1668311433346,COGS 260,A00,101432,Kiyonaga; Anastasia,21,0,25,4
1668311433346,COGS 260,B00,101433,Kirsh; David Joel,15,0,25,10
1668311433768,CSE 202,A00,102371,Impagliazzo; Russell,0,0,0,0
1668311434195,CSE 203B,A01,102373,Cheng; Chung Kuan,0,0,0,0
1668311434617,CSE 208,A00,102374,Micciancio; Daniele,0,0,0,0
1668311435039,CSE 209A,A00,112895,Impagliazzo; Russell,0,0,15,15
1668311435463,CSE 209B,A00,108005,Bellare; Mihir,0,0,0,0
1668311435889,CSE 210,A00,113163,Coblenz; Michael J,0,0,0,0
1668311436315,CSE 219,A00,106111,Dow; Steven P,0,0,20,20
1668311436746,CSE 221,A00,102376,Voelker; Geoffrey M.,0,0,0,0
1668311437174,CSE 224,A01,102378,Porter; George M,0,0,0,0
1668311437600,CSE 229A,A00,102379,Savage; Stefan,0,0,0,0
1668311438025,CSE 229C,A00,102380,Munyaka; Imani N. S.,0,0,0,0
1668311438453,CSE 232B,A00,102382,Deutsch; Alin Bernard,0,0,0,0
1668311438876,CSE 234,A01,112904,Kumar; Arun Kumar,0,0,0,0
1668311439302,CSE 237A,A00,102383,Rosing; Tajana Simunic,0,0,0,0
1668311439730,CSE 239A,A00,102384,Deutsch; Alin Bernard,0,0,0,0
1668311440154,CSE 239B,A00,102385,Polikarpova; Nadezhda,0,0,0,0
1668311440580,CSE 240A,A00,102386,Pannuto; Patrick William,0,0,0,0
1668311441003,CSE 240B,A00,102387,Zhao; Jishen,0,0,0,0
1668311441426,CSE 241A,A00,106406,Kang; Mingu,0,0,0,0
1668311441852,CSE 249B,A00,102388,Kahng; Andrew Byun,0,0,8,8
1668311442279,CSE 251B,A01,102392,Cottrell; Garrison W,0,0,0,0
1668311442279,CSE 251B,A02,102393,Cottrell; Garrison W,0,0,0,0
1668311442702,CSE 252B,A00,102394,Ochoa; Benjamin Lawrence,0,0,0,0
1668311443146,CSE 257,A01,102396,Gao; Sicun,0,0,0,0
1668311443569,CSE 272,A00,102397,Li; Tzumao,0,0,0,0
1668311444003,CSE 274,A00,111323,Chern; Albert Ren-Haur,0,0,0,0
1668311444426,CSE 282,A00,102398,Pevzner; Pavel Arkadjevich,0,0,0,0
1668311444864,CSE 284,A00,114175,Gymrek; Melissa Ann,0,0,0,0
1668311445291,CSE 290,A00,102399,Chandraker; Manmohan Krishna,0,0,0,0
1668311445291,CSE 290,B00,102400,Vaccaro; Kristen Marie,0,0,25,25
1668311445291,CSE 290,C00,102414,Pannuto; Patrick William,0,0,25,25
1668311445291,CSE 290,D00,102427,Pevzner; Pavel Arkadjevich,0,0,0,0
1668311445291,CSE 290,E00,102429,Zhao; Jishen,0,0,0,0
1668311445291,CSE 290,F00,102436,Tullsen; Dean Michael,0,0,0,0
1668311445291,CSE 290,G00,102440,Christensen; Henrik I,0,0,20,20
1668311445717,CSE 291,A00,102443,Su; Hao,0,0,0,0
1668311445717,CSE 291,B00,102448,Polikarpova; Nadezhda,0,0,0,0
1668311445717,CSE 291,C00,102453,Vaccaro; Kristen Marie,0,0,0,0
1668311445717,CSE 291,D00,111343,Savage; Stefan,0,0,0,0
1668311445717,CSE 291,E00,116474,Claffy; Kimberly Claire,0,0,0,0
1668311445717,CSE 291,F00,116479,Pasquale; Joseph,0,0,0,0
1668311446145,CSE 293,001,119111,Bafna; Vineet,9999,0,9999,0
1668311446145,CSE 293,002,119118,Bellare; Mihir,9999,0,9999,0
1668311446145,CSE 293,003,119122,Berg-Kirkpatrick; Taylor D,9999,0,9999,0
1668311446145,CSE 293,004,119135,Christensen; Henrik I,9999,0,9999,0
1668311446145,CSE 293,005,119142,Cottrell; Garrison W,9999,0,9999,0
1668311446145,CSE 293,006,119146,Deutsch; Alin Bernard,9999,0,9999,0
1668311446145,CSE 293,007,119159,Esmaeilzadeh; Hadi,9999,0,9999,0
1668311446145,CSE 293,008,119166,Freund; Yoav,9999,0,9999,0
1668311446145,CSE 293,009,119170,Griswold; William G.,9999,0,9999,0
1668311446145,CSE 293,010,119183,Gymrek; Melissa Ann,9999,0,9999,0
1668311446145,CSE 293,011,119190,Heninger; Nadia A,9999,0,9999,0
1668311446145,CSE 293,012,119230,Impagliazzo; Russell,9999,0,9999,0
1668311446145,CSE 293,013,119232,Jhala; Ranjit,9999,0,9999,0
1668311446145,CSE 293,014,119233,Kahng; Andrew Byun,9999,0,9999,0
1668311446145,CSE 293,015,119298,Kane; Daniel Mertz,9999,0,9999,0
1668311446145,CSE 293,016,119299,Kriegman; David J,9999,0,9999,0
1668311446145,CSE 293,017,119300,Kumar; Arun Kumar,9999,0,9999,0
1668311446145,CSE 293,018,119301,Lerner; Sorin,9999,0,9999,0
1668311446145,CSE 293,019,119302,Lovett; Shachar,9999,0,9999,0
1668311446145,CSE 293,020,119303,McAuley; Julian John,9999,0,9999,0
1668311446145,CSE 293,021,119304,Micciancio; Daniele,9999,0,9999,0
1668311446145,CSE 293,022,119367,Orailoglu; Alex,9999,0,9999,0
1668311446145,CSE 293,023,119382,Paturi; Ramamohan,9999,0,9999,0
1668311446145,CSE 293,024,119404,Polikarpova; Nadezhda,9999,0,9999,0
1668311446145,CSE 293,025,119406,Politz; Joseph Gibbs,9999,0,9999,0
1668311446145,CSE 293,026,119411,Porter; George M,9999,0,9999,0
1668311446145,CSE 293,027,119414,Porter; Leonard Emerson,9999,0,9999,0
1668311446145,CSE 293,028,119416,Ramamoorthi; Ravi,9999,0,9999,0
1668311446145,CSE 293,029,119417,Sahoo; Debashis,9999,0,9999,0
1668311446145,CSE 293,030,119420,Saul; Lawrence,9999,0,9999,0
1668311446145,CSE 293,031,119421,Savage; Stefan,9999,0,9999,0
1668311446145,CSE 293,032,119425,Schulze; Jurgen P.,9999,0,9999,0
1668311446145,CSE 293,033,119426,Snoeren; Alex C.,9999,0,9999,0
1668311446145,CSE 293,034,119428,Shang; Jingbo,9999,0,9999,0
1668311446145,CSE 293,035,119430,Stefan; Deian,9999,0,9999,0
1668311446145,CSE 293,036,119431,Su; Hao,9999,0,9999,0
1668311446145,CSE 293,037,119433,Swanson; Steven James,9999,0,9999,0
1668311446145,CSE 293,038,119435,Tullsen; Dean Michael,9999,0,9999,0
1668311446145,CSE 293,039,119483,Voelker; Geoffrey M.,9999,0,9999,0
1668311446145,CSE 293,040,119537,Zhao; Jishen,9999,0,9999,0
1668311446145,CSE 293,041,119538,Zhou; Yuan-Yuan,9999,0,9999,0
1668311446145,CSE 293,042,119539,Gao; Sicun,9999,0,9999,0
1668311446145,CSE 293,043,119540,Weibel; Nadir,9999,0,9999,0
1668311446145,CSE 293,044,119541,Gupta; Rajesh K.,9999,0,9999,0
1668311446145,CSE 293,045,126410,Vaccaro; Kristen Marie,9999,0,9999,0
1668311446145,CSE 293,046,126411,Klemke; Richard,9999,0,9999,0
1668311446568,CSE 294,A00,102459,Voelker; Geoffrey M.,0,0,0,0
1668311446568,CSE 294,B00,111322,Orailoglu; Alex,0,0,0,0
1668311446992,DSE 201,A00,096914,Deutsch; Alin Bernard,30,0,30,0
1668311447416,DSE 210,A00,096915,Dasgupta; Sanjoy,30,0,30,0
1668311447843,DSE 260A,A00,096916,Altintas De Callaf; Ilkay,30,0,30,0
1668311448273,ECE 200,001,103586,Antipa; Nicholas A,9999,0,9999,0
1668311448273,ECE 200,002,103587,Atanasov; Nikolay A.,9999,0,9999,0
1668311448273,ECE 200,003,103588,Bharadia; Dinesh,9999,0,9999,0
1668311448273,ECE 200,004,103589,Cheng; Chung Kuan,9999,0,9999,0
1668311448273,ECE 200,005,103590,Cosman; Pamela C.,9999,0,9999,0
1668311448273,ECE 200,006,103591,Dayeh; Shadi Ahmad,9999,0,9999,0
1668311448273,ECE 200,007,103592,Fainman; Yeshaiahu,9999,0,9999,0
1668311448273,ECE 200,008,103593,Ford; Joseph Earl,9999,0,9999,0
1668311448273,ECE 200,009,103594,Franceschetti; Massimo,9999,0,9999,0
1668311448273,ECE 200,010,103595,Fullerton; Eric E,9999,0,9999,0
1668311448273,ECE 200,011,103596,Galton; Ian A,9999,0,9999,0
1668311448273,ECE 200,012,103597,Gilja; Vikash,9999,0,9999,0
1668311448273,ECE 200,013,103598,Hall; Drew A.,9999,0,9999,0
1668311448273,ECE 200,014,103599,Hsueh; Tzu-Chien,9999,0,9999,0
1668311448273,ECE 200,015,103600,Javidi; Tara,9999,0,9999,0
1668311448273,ECE 200,016,103601,Kahng; Andrew Byun,9999,0,9999,0
1668311448273,ECE 200,017,103602,Kim; Young-Han,9999,0,9999,0
1668311448273,ECE 200,018,103603,Koushanfar; Farinaz,9999,0,9999,0
1668311448273,ECE 200,019,103604,Kuzum; Duygu,9999,0,9999,0
1668311448273,ECE 200,020,103605,Le; Hanh-Phuc,9999,0,9999,0
1668311448273,ECE 200,021,103606,Lin; Bill,9999,0,9999,0
1668311448273,ECE 200,022,103607,Liu; Zhaowei,9998,0,9999,1
1668311448273,ECE 200,023,103608,Lo; Yu-Hwa,9999,0,9999,0
1668311448273,ECE 200,024,103609,Lomakin; Vitaliy,9999,0,9999,0
1668311448273,ECE 200,025,103610,Mercier; Patrick Philip,9999,0,9999,0
1668311448273,ECE 200,026,103611,Meyer; Florian,9999,0,9999,0
1668311448273,ECE 200,027,103612,Milstein; Laurence B.,9999,0,9999,0
1668311448273,ECE 200,028,103613,Mir Arabbaygi; Siavash,9999,0,9999,0
1668311448273,ECE 200,029,103614,Mookherjea; Shayan,9999,0,9999,0
1668311448273,ECE 200,030,103615,Morris; Karcher William,9999,0,9999,0
1668311448273,ECE 200,031,103616,Ng; Tse Nga,9999,0,9999,0
1668311448273,ECE 200,032,103617,Nguyen; Truong Quang,9999,0,9999,0
1668311448273,ECE 200,033,103618,Nomura; Kenji,9999,0,9999,0
1668311448273,ECE 200,034,103619,Orlitsky; Alon,9999,0,9999,0
1668311448273,ECE 200,035,103620,Pal; Piya,9999,0,9999,0
1668311448273,ECE 200,036,103621,Papen; George C.,9999,0,9999,0
1668311448273,ECE 200,037,103622,Radic; Stojan,9999,0,9999,0
1668311448273,ECE 200,038,103623,Rao; Bhaskar D.,9999,0,9999,0
1668311448273,ECE 200,039,103624,Rao; Ramesh R,9999,0,9999,0
1668311448273,ECE 200,040,103625,Rebeiz; Gabriel,9999,0,9999,0
1668311448273,ECE 200,041,103626,Sanford; John R,9999,0,9999,0
1668311448273,ECE 200,042,103627,Siegel; Paul H.,9999,0,9999,0
1668311448273,ECE 200,043,103628,Sievenpiper; Daniel F.,9999,0,9999,0
1668311448273,ECE 200,044,103629,Sworder; David D.,9999,0,9999,0
1668311448273,ECE 200,045,103630,Taur; Yuan,9999,0,9999,0
1668311448273,ECE 200,046,103631,Touri; Behrouz,9999,0,9999,0
1668311448273,ECE 200,047,103632,Trivedi; Mohan M.,9999,0,9999,0
1668311448273,ECE 200,048,103633,Vasconcelos; Nuno,9999,0,9999,0
1668311448273,ECE 200,049,103634,Wang; Xiaolong,9999,0,9999,0
1668311448273,ECE 200,050,103635,Xie; Pengtao,9999,0,9999,0
1668311448273,ECE 200,051,103636,Yip; Michael,9999,0,9999,0
1668311448273,ECE 200,052,103637,Zeger; Kenneth A.,999,0,999,0
1668311448273,ECE 200,053,103638,Zhang; Xinyu,9999,0,9999,0
1668311448273,ECE 200,054,103639,Turakhia; Yatish Girish,9999,0,9999,0
1668311448273,ECE 200,055,103640,Kang; Mingu,9999,0,9999,0
1668311448273,ECE 200,056,103641,Shi; Yuanyuan,9999,0,9999,0
1668311448273,ECE 200,057,103642,Wang; Edward Jay,9999,0,9999,0
1668311448273,ECE 200,058,103643,Zheng; Yang,9999,0,9999,0
1668311448699,ECE 202,A00,103644,Kuzum; Duygu,0,0,0,0
1668311449131,ECE 212BN,A00,103646,Ng; Tse Nga,0,0,0,0
1668311449556,ECE 221,A00,111493,Staff,0,0,0,0
1668311449980,ECE 222B,A00,103647,Lomakin; Vitaliy,0,0,0,0
1668311450414,ECE 230B,A00,103648,Taur; Yuan,0,0,0,0
1668311450841,ECE 238B,A00,103649,Garay; Javier,0,0,0,0
1668311451266,ECE 240B,A00,112900,Fainman; Yeshaiahu,0,0,0,0
1668311451691,ECE 247A,A00,103650,Jokerst; Jesse Vincent,0,0,0,0
1668311452118,ECE 247B,A00,103651,Wang; Joseph,0,0,0,0
1668311452543,ECE 250,A00,103652,Siegel; Paul H.,0,0,0,0
1668311452968,ECE 251A,A00,103654,Rao; Bhaskar D.,0,0,0,0
1668311453391,ECE 257B,A00,103655,Bharadia; Dinesh,0,0,0,0
1668311453890,ECE 258A,A00,103656,Milstein; Laurence B.,0,0,0,0
1668311454323,ECE 260B,A00,103658,Kang; Mingu,0,0,0,0
1668311454748,ECE 264A,A00,103659,Galton; Ian A,0,0,0,0
1668311455171,ECE 265A,A00,103661,Gudem; Prasad S.S.,0,0,0,0
1668311455602,ECE 265D,A00,103662,Gudem; Prasad S.S.,0,0,0,0
1668311456029,ECE 268,A00,103663,Koushanfar; Farinaz,0,0,0,0
1668311456455,ECE 269,A01,103665,Pal; Piya,0,0,0,0
1668311456879,ECE 271B,A00,103666,Vasconcelos; Manuela,0,0,0,0
1668311457307,ECE 276A,A00,103667,Atanasov; Nikolay A.,0,0,0,0
1668311457733,ECE 277,A00,103668,An; Cheolhong,0,0,0,0
1668311458158,ECE 279,A00,117947,Hall; Drew A.,0,0,0,0
1668311459011,ECE 283,A00,103670,Hsueh; Tzu-Chien,0,0,0,0
1668311459432,ECE 284,A00,103671,Turakhia; Yatish Girish,0,0,0,0
1668311459857,ECE 285,A00,103672,Zheng; Yang,0,0,0,0
1668311459857,ECE 285,B00,103673,Sworder; David D.,0,0,0,0
1668311460282,ECE 287,A00,103676,Javidi; Tara,0,0,0,0
1668311460708,MATH 200B,A00,098023,Salehi Golsefidy; Alireza,12,0,15,3
1668311461133,MATH 202B,A00,098024,Rhoades; Brendon Patrick,9,0,15,6
1668311461556,MATH 203B,A00,098025,Oprea; Dragos N.,10,0,15,5
1668311461979,MATH 204B,A00,098026,Sorensen; Claus M,13,0,15,2
1668311462406,MATH 208,A00,098027,Izadi; Elham,7,0,10,3
1668311462836,MATH 209,A00,098028,Pollack; Aaron,10,0,10,0
1668311463260,MATH 211A,A00,112919,Rogalski; Daniel,9,0,10,1
1668311463690,MATH 211B,A00,112920,Seward; Brandon M.,9,0,10,1
1668311464114,MATH 218,A00,098029,Li; Bo,10,0,10,0
1668311464537,MATH 220B,A00,098030,Novak; Jonathan I,11,0,15,4
1668311464961,MATH 221A,A00,098031,Ebenfelt; Peter F,13,0,15,2
1668311465384,MATH 231B,A00,098032,Zlatos; Andrej,12,0,15,3
1668311465809,MATH 240B,A00,098033,Ni; Lei,9,0,15,6
1668311466239,MATH 243,A00,098034,Jekel; David Andrew,10,0,10,0
1668311466665,MATH 245A,A00,098035,Nie; Jiawang,0,0,15,16
1668311467088,MATH 248,A00,098036,Bejenaru; Ioan,10,0,10,0
1668311467518,MATH 250B,A00,098037,Spolaor; Luca,14,0,15,1
1668311467947,MATH 258,A00,098038,Ni; Lei,10,0,10,0
1668311468370,MATH 264B,A00,098041,Rhoades; Brendon Patrick,9,0,15,6
1668311468794,MATH 268,A00,098042,Buss; Samuel R,10,0,10,0
1668311469220,MATH 269,A00,098043,Rhoades; Brendon Patrick,10,0,10,0
1668311469643,MATH 270B,A00,098044,Li; Bo,10,0,15,5
1668311470070,MATH 272B,A00,098045,Holst; Michael J,13,0,15,2
1668311470499,MATH 273A,A00,098046,Tian; Xiaochuan,10,0,15,5
1668311470925,MATH 275,A01,098048,Tian; Xiaochuan,6,0,10,4
1668311471361,MATH 278A,A00,098049,Holst; Michael J,8,0,10,2
1668311471803,MATH 278B,A00,098050,Cloninger; Alexander,10,0,10,0
1668311472227,MATH 278C,A00,098051,Nie; Jiawang,7,0,10,3
1668311472653,MATH 280B,A00,098052,Zheng; Tianyi,8,0,15,7
1668311473081,MATH 281B,A00,098053,Bradic; Jelena,1,0,15,14
1668311473504,MATH 282B,A00,098054,Arias-Castro; Ery,0,0,15,15
1668311473928,MATH 285,A00,098055,Fitzsimmons; Patrick J,0,0,15,17
1668311474352,MATH 287B,A00,098056,Arias-Castro; Ery,2,0,15,13
1668311474778,MATH 288,A00,098057,Agarwal; Pooja,9,0,10,1
1668311474778,MATH 288,B00,098058,Zhang; Danna,8,0,10,2
1668311474778,MATH 288,C00,098059,Williams; Ruth J,9,0,10,1
1668311475204,MATH 290B,A00,098060,Roberts; Justin Deritter,13,0,15,2
1668311475626,MATH 292,A00,098061,Belmont; Eva Kinoshita,10,0,10,0
1668311476050,MATH 295,A00,098062,Suk; Andrew Hoon,48,0,50,2
1668311476480,MATH 296,A00,098063,Novak; Jonathan I,20,0,20,0
1668311476906,MATH 297,001,098064,Gamst; Anthony Collins,9997,0,9999,2
1668311976278,COGS 205,A00,101395,Chiba; Andrea,19,0,20,1
1668311976703,COGS 210B,001,101404,Greene; Deanna Jacquelyn,9998,0,9999,1
1668311976703,COGS 210B,002,101417,Xia; Haijun,9999,0,9999,0
1668311976703,COGS 210B,003,101422,Nitz; Douglas A.,9999,0,9999,0
1668311976703,COGS 210B,004,101423,Hollan; James D.,9998,0,9999,1
1668311976703,COGS 210B,005,101424,Deak; Gedeon O.,9998,0,9999,1
1668311976703,COGS 210B,006,101425,Rossano; Federico,9999,0,9999,0
1668311977126,COGS 211B,A00,101427,Coulson; Seana M,9996,0,9999,3
1668311977553,COGS 220,A00,101428,Hollan; James D.,0,0,25,25
1668311977982,COGS 229,A00,101429,Dow; Steven P,18,0,25,7
1668311978408,COGS 230,A00,101430,Klemmer; Scott R,12,0,17,5
1668311978834,COGS 234,A00,101431,Xia; Haijun,1,0,25,24
1668311979257,COGS 260,A00,101432,Kiyonaga; Anastasia,21,0,25,4
1668311979257,COGS 260,B00,101433,Kirsh; David Joel,15,0,25,10
1668311979678,CSE 202,A00,102371,Impagliazzo; Russell,0,0,0,0
1668311980111,CSE 203B,A01,102373,Cheng; Chung Kuan,0,0,0,0
1668311980535,CSE 208,A00,102374,Micciancio; Daniele,0,0,0,0
1668311980959,CSE 209A,A00,112895,Impagliazzo; Russell,0,0,15,15
1668311981386,CSE 209B,A00,108005,Bellare; Mihir,0,0,0,0
1668311981811,CSE 210,A00,113163,Coblenz; Michael J,0,0,0,0
1668311982237,CSE 219,A00,106111,Dow; Steven P,0,0,20,20
1668311982662,CSE 221,A00,102376,Voelker; Geoffrey M.,0,0,0,0
1668311983089,CSE 224,A01,102378,Porter; George M,0,0,0,0
1668311983513,CSE 229A,A00,102379,Savage; Stefan,0,0,0,0
1668311983942,CSE 229C,A00,102380,Munyaka; Imani N. S.,0,0,0,0
1668311984363,CSE 232B,A00,102382,Deutsch; Alin Bernard,0,0,0,0
1668311984786,CSE 234,A01,112904,Kumar; Arun Kumar,0,0,0,0
1668311985212,CSE 237A,A00,102383,Rosing; Tajana Simunic,0,0,0,0
1668311985637,CSE 239A,A00,102384,Deutsch; Alin Bernard,0,0,0,0
1668311986064,CSE 239B,A00,102385,Polikarpova; Nadezhda,0,0,0,0
1668311986492,CSE 240A,A00,102386,Pannuto; Patrick William,0,0,0,0
1668311986916,CSE 240B,A00,102387,Zhao; Jishen,0,0,0,0
1668311987355,CSE 241A,A00,106406,Kang; Mingu,0,0,0,0
1668311987777,CSE 249B,A00,102388,Kahng; Andrew Byun,0,0,8,8
1668311988203,CSE 251B,A01,102392,Cottrell; Garrison W,0,0,0,0
1668311988203,CSE 251B,A02,102393,Cottrell; Garrison W,0,0,0,0
1668311988635,CSE 252B,A00,102394,Ochoa; Benjamin Lawrence,0,0,0,0
1668311989059,CSE 257,A01,102396,Gao; Sicun,0,0,0,0
1668311989484,CSE 272,A00,102397,Li; Tzumao,0,0,0,0
1668311989907,CSE 274,A00,111323,Chern; Albert Ren-Haur,0,0,0,0
1668311990328,CSE 282,A00,102398,Pevzner; Pavel Arkadjevich,0,0,0,0
1668311990755,CSE 284,A00,114175,Gymrek; Melissa Ann,0,0,0,0
1668311991178,CSE 290,A00,102399,Chandraker; Manmohan Krishna,0,0,0,0
1668311991178,CSE 290,B00,102400,Vaccaro; Kristen Marie,0,0,25,25
1668311991178,CSE 290,C00,102414,Pannuto; Patrick William,0,0,25,25
1668311991178,CSE 290,D00,102427,Pevzner; Pavel Arkadjevich,0,0,0,0
1668311991178,CSE 290,E00,102429,Zhao; Jishen,0,0,0,0
1668311991178,CSE 290,F00,102436,Tullsen; Dean Michael,0,0,0,0
1668311991178,CSE 290,G00,102440,Christensen; Henrik I,0,0,20,20
1668311991606,CSE 291,A00,102443,Su; Hao,0,0,0,0
1668311991606,CSE 291,B00,102448,Polikarpova; Nadezhda,0,0,0,0
1668311991606,CSE 291,C00,102453,Vaccaro; Kristen Marie,0,0,0,0
1668311991606,CSE 291,D00,111343,Savage; Stefan,0,0,0,0
1668311991606,CSE 291,E00,116474,Claffy; Kimberly Claire,0,0,0,0
1668311991606,CSE 291,F00,116479,Pasquale; Joseph,0,0,0,0
1668311992031,CSE 293,001,119111,Bafna; Vineet,9999,0,9999,0
1668311992031,CSE 293,002,119118,Bellare; Mihir,9999,0,9999,0
1668311992031,CSE 293,003,119122,Berg-Kirkpatrick; Taylor D,9999,0,9999,0
1668311992031,CSE 293,004,119135,Christensen; Henrik I,9999,0,9999,0
1668311992031,CSE 293,005,119142,Cottrell; Garrison W,9999,0,9999,0
1668311992031,CSE 293,006,119146,Deutsch; Alin Bernard,9999,0,9999,0
1668311992031,CSE 293,007,119159,Esmaeilzadeh; Hadi,9999,0,9999,0
1668311992031,CSE 293,008,119166,Freund; Yoav,9999,0,9999,0
1668311992031,CSE 293,009,119170,Griswold; William G.,9999,0,9999,0
1668311992031,CSE 293,010,119183,Gymrek; Melissa Ann,9999,0,9999,0
1668311992031,CSE 293,011,119190,Heninger; Nadia A,9999,0,9999,0
1668311992031,CSE 293,012,119230,Impagliazzo; Russell,9999,0,9999,0
1668311992031,CSE 293,013,119232,Jhala; Ranjit,9999,0,9999,0
1668311992031,CSE 293,014,119233,Kahng; Andrew Byun,9999,0,9999,0
1668311992031,CSE 293,015,119298,Kane; Daniel Mertz,9999,0,9999,0
1668311992031,CSE 293,016,119299,Kriegman; David J,9999,0,9999,0
1668311992031,CSE 293,017,119300,Kumar; Arun Kumar,9999,0,9999,0
1668311992031,CSE 293,018,119301,Lerner; Sorin,9999,0,9999,0
1668311992031,CSE 293,019,119302,Lovett; Shachar,9999,0,9999,0
1668311992031,CSE 293,020,119303,McAuley; Julian John,9999,0,9999,0
1668311992031,CSE 293,021,119304,Micciancio; Daniele,9999,0,9999,0
1668311992031,CSE 293,022,119367,Orailoglu; Alex,9999,0,9999,0
1668311992031,CSE 293,023,119382,Paturi; Ramamohan,9999,0,9999,0
1668311992031,CSE 293,024,119404,Polikarpova; Nadezhda,9999,0,9999,0
1668311992031,CSE 293,025,119406,Politz; Joseph Gibbs,9999,0,9999,0
1668311992031,CSE 293,026,119411,Porter; George M,9999,0,9999,0
1668311992031,CSE 293,027,119414,Porter; Leonard Emerson,9999,0,9999,0
1668311992031,CSE 293,028,119416,Ramamoorthi; Ravi,9999,0,9999,0
1668311992031,CSE 293,029,119417,Sahoo; Debashis,9999,0,9999,0
1668311992031,CSE 293,030,119420,Saul; Lawrence,9999,0,9999,0
1668311992031,CSE 293,031,119421,Savage; Stefan,9999,0,9999,0
1668311992031,CSE 293,032,119425,Schulze; Jurgen P.,9999,0,9999,0
1668311992031,CSE 293,033,119426,Snoeren; Alex C.,9999,0,9999,0
1668311992031,CSE 293,034,119428,Shang; Jingbo,9999,0,9999,0
1668311992031,CSE 293,035,119430,Stefan; Deian,9999,0,9999,0
1668311992031,CSE 293,036,119431,Su; Hao,9999,0,9999,0
1668311992031,CSE 293,037,119433,Swanson; Steven James,9999,0,9999,0
1668311992031,CSE 293,038,119435,Tullsen; Dean Michael,9999,0,9999,0
1668311992031,CSE 293,039,119483,Voelker; Geoffrey M.,9999,0,9999,0
1668311992031,CSE 293,040,119537,Zhao; Jishen,9999,0,9999,0
1668311992031,CSE 293,041,119538,Zhou; Yuan-Yuan,9999,0,9999,0
1668311992031,CSE 293,042,119539,Gao; Sicun,9999,0,9999,0
1668311992031,CSE 293,043,119540,Weibel; Nadir,9999,0,9999,0
1668311992031,CSE 293,044,119541,Gupta; Rajesh K.,9999,0,9999,0
1668311992031,CSE 293,045,126410,Vaccaro; Kristen Marie,9999,0,9999,0
1668311992031,CSE 293,046,126411,Klemke; Richard,9999,0,9999,0
1668311992453,CSE 294,A00,102459,Voelker; Geoffrey M.,0,0,0,0
1668311992453,CSE 294,B00,111322,Orailoglu; Alex,0,0,0,0
1668311992877,DSE 201,A00,096914,Deutsch; Alin Bernard,30,0,30,0
1668311993301,DSE 210,A00,096915,Dasgupta; Sanjoy,30,0,30,0
1668311993726,DSE 260A,A00,096916,Altintas De Callaf; Ilkay,30,0,30,0
1668311994182,ECE 200,001,103586,Antipa; Nicholas A,9999,0,9999,0
1668311994182,ECE 200,002,103587,Atanasov; Nikolay A.,9999,0,9999,0
1668311994182,ECE 200,003,103588,Bharadia; Dinesh,9999,0,9999,0
1668311994182,ECE 200,004,103589,Cheng; Chung Kuan,9999,0,9999,0
1668311994182,ECE 200,005,103590,Cosman; Pamela C.,9999,0,9999,0
1668311994182,ECE 200,006,103591,Dayeh; Shadi Ahmad,9999,0,9999,0
1668311994182,ECE 200,007,103592,Fainman; Yeshaiahu,9999,0,9999,0
1668311994182,ECE 200,008,103593,Ford; Joseph Earl,9999,0,9999,0
1668311994182,ECE 200,009,103594,Franceschetti; Massimo,9999,0,9999,0
1668311994182,ECE 200,010,103595,Fullerton; Eric E,9999,0,9999,0
1668311994182,ECE 200,011,103596,Galton; Ian A,9999,0,9999,0
1668311994182,ECE 200,012,103597,Gilja; Vikash,9999,0,9999,0
1668311994182,ECE 200,013,103598,Hall; Drew A.,9999,0,9999,0
1668311994182,ECE 200,014,103599,Hsueh; Tzu-Chien,9999,0,9999,0
1668311994182,ECE 200,015,103600,Javidi; Tara,9999,0,9999,0
1668311994182,ECE 200,016,103601,Kahng; Andrew Byun,9999,0,9999,0
1668311994182,ECE 200,017,103602,Kim; Young-Han,9999,0,9999,0
1668311994182,ECE 200,018,103603,Koushanfar; Farinaz,9999,0,9999,0
1668311994182,ECE 200,019,103604,Kuzum; Duygu,9999,0,9999,0
1668311994182,ECE 200,020,103605,Le; Hanh-Phuc,9999,0,9999,0
1668311994182,ECE 200,021,103606,Lin; Bill,9999,0,9999,0
1668311994182,ECE 200,022,103607,Liu; Zhaowei,9998,0,9999,1
1668311994182,ECE 200,023,103608,Lo; Yu-Hwa,9999,0,9999,0
1668311994182,ECE 200,024,103609,Lomakin; Vitaliy,9999,0,9999,0
1668311994182,ECE 200,025,103610,Mercier; Patrick Philip,9999,0,9999,0
1668311994182,ECE 200,026,103611,Meyer; Florian,9999,0,9999,0
1668311994182,ECE 200,027,103612,Milstein; Laurence B.,9999,0,9999,0
1668311994182,ECE 200,028,103613,Mir Arabbaygi; Siavash,9999,0,9999,0
1668311994182,ECE 200,029,103614,Mookherjea; Shayan,9999,0,9999,0
1668311994182,ECE 200,030,103615,Morris; Karcher William,9999,0,9999,0
1668311994182,ECE 200,031,103616,Ng; Tse Nga,9999,0,9999,0
1668311994182,ECE 200,032,103617,Nguyen; Truong Quang,9999,0,9999,0
1668311994182,ECE 200,033,103618,Nomura; Kenji,9999,0,9999,0
1668311994182,ECE 200,034,103619,Orlitsky; Alon,9999,0,9999,0
1668311994182,ECE 200,035,103620,Pal; Piya,9999,0,9999,0
1668311994182,ECE 200,036,103621,Papen; George C.,9999,0,9999,0
1668311994182,ECE 200,037,103622,Radic; Stojan,9999,0,9999,0
1668311994182,ECE 200,038,103623,Rao; Bhaskar D.,9999,0,9999,0
1668311994182,ECE 200,039,103624,Rao; Ramesh R,9999,0,9999,0
1668311994182,ECE 200,040,103625,Rebeiz; Gabriel,9999,0,9999,0
1668311994182,ECE 200,041,103626,Sanford; John R,9999,0,9999,0
1668311994182,ECE 200,042,103627,Siegel; Paul H.,9999,0,9999,0
1668311994182,ECE 200,043,103628,Sievenpiper; Daniel F.,9999,0,9999,0
1668311994182,ECE 200,044,103629,Sworder; David D.,9999,0,9999,0
1668311994182,ECE 200,045,103630,Taur; Yuan,9999,0,9999,0
1668311994182,ECE 200,046,103631,Touri; Behrouz,9999,0,9999,0
1668311994182,ECE 200,047,103632,Trivedi; Mohan M.,9999,0,9999,0
1668311994182,ECE 200,048,103633,Vasconcelos; Nuno,9999,0,9999,0
1668311994182,ECE 200,049,103634,Wang; Xiaolong,9999,0,9999,0
1668311994182,ECE 200,050,103635,Xie; Pengtao,9999,0,9999,0
1668311994182,ECE 200,051,103636,Yip; Michael,9999,0,9999,0
1668311994182,ECE 200,052,103637,Zeger; Kenneth A.,999,0,999,0
1668311994182,ECE 200,053,103638,Zhang; Xinyu,9999,0,9999,0
1668311994182,ECE 200,054,103639,Turakhia; Yatish Girish,9999,0,9999,0
1668311994182,ECE 200,055,103640,Kang; Mingu,9999,0,9999,0
1668311994182,ECE 200,056,103641,Shi; Yuanyuan,9999,0,9999,0
1668311994182,ECE 200,057,103642,Wang; Edward Jay,9999,0,9999,0
1668311994182,ECE 200,058,103643,Zheng; Yang,9999,0,9999,0
1668311994605,ECE 202,A00,103644,Kuzum; Duygu,0,0,0,0
1668311995033,ECE 212BN,A00,103646,Ng; Tse Nga,0,0,0,0
1668311995457,ECE 221,A00,111493,Staff,0,0,0,0
1668311995878,ECE 222B,A00,103647,Lomakin; Vitaliy,0,0,0,0
1668311996303,ECE 230B,A00,103648,Taur; Yuan,0,0,0,0
1668311996728,ECE 238B,A00,103649,Garay; Javier,0,0,0,0
1668311997157,ECE 240B,A00,112900,Fainman; Yeshaiahu,0,0,0,0
1668311997582,ECE 247A,A00,103650,Jokerst; Jesse Vincent,0,0,0,0
1668311998007,ECE 247B,A00,103651,Wang; Joseph,0,0,0,0
1668311998433,ECE 250,A00,103652,Siegel; Paul H.,0,0,0,0
1668311998859,ECE 251A,A00,103654,Rao; Bhaskar D.,0,0,0,0
1668311999284,ECE 257B,A00,103655,Bharadia; Dinesh,0,0,0,0
1668311999707,ECE 258A,A00,103656,Milstein; Laurence B.,0,0,0,0
1668312000134,ECE 260B,A00,103658,Kang; Mingu,0,0,0,0
1668312000559,ECE 264A,A00,103659,Galton; Ian A,0,0,0,0
1668312000982,ECE 265A,A00,103661,Gudem; Prasad S.S.,0,0,0,0
1668312001405,ECE 265D,A00,103662,Gudem; Prasad S.S.,0,0,0,0
1668312001830,ECE 268,A00,103663,Koushanfar; Farinaz,0,0,0,0
1668312002251,ECE 269,A01,103665,Pal; Piya,0,0,0,0
1668312002676,ECE 271B,A00,103666,Vasconcelos; Manuela,0,0,0,0
1668312003099,ECE 276A,A00,103667,Atanasov; Nikolay A.,0,0,0,0
1668312003533,ECE 277,A00,103668,An; Cheolhong,0,0,0,0
1668312003958,ECE 279,A00,117947,Hall; Drew A.,0,0,0,0
1668312004804,ECE 283,A00,103670,Hsueh; Tzu-Chien,0,0,0,0
1668312005226,ECE 284,A00,103671,Turakhia; Yatish Girish,0,0,0,0
1668312005654,ECE 285,A00,103672,Zheng; Yang,0,0,0,0
1668312005654,ECE 285,B00,103673,Sworder; David D.,0,0,0,0
1668312006079,ECE 287,A00,103676,Javidi; Tara,0,0,0,0
1668312006502,MATH 200B,A00,098023,Salehi Golsefidy; Alireza,12,0,15,3
1668312006926,MATH 202B,A00,098024,Rhoades; Brendon Patrick,9,0,15,6
1668312007353,MATH 203B,A00,098025,Oprea; Dragos N.,10,0,15,5
1668312007776,MATH 204B,A00,098026,Sorensen; Claus M,13,0,15,2
1668312008199,MATH 208,A00,098027,Izadi; Elham,7,0,10,3
1668312008625,MATH 209,A00,098028,Pollack; Aaron,10,0,10,0
1668312009046,MATH 211A,A00,112919,Rogalski; Daniel,9,0,10,1
1668312009468,MATH 211B,A00,112920,Seward; Brandon M.,9,0,10,1
1668312009892,MATH 218,A00,098029,Li; Bo,10,0,10,0
1668312010315,MATH 220B,A00,098030,Novak; Jonathan I,11,0,15,4
1668312010753,MATH 221A,A00,098031,Ebenfelt; Peter F,13,0,15,2
1668312011177,MATH 231B,A00,098032,Zlatos; Andrej,12,0,15,3
1668312011600,MATH 240B,A00,098033,Ni; Lei,9,0,15,6
1668312012041,MATH 243,A00,098034,Jekel; David Andrew,10,0,10,0
1668312012478,MATH 245A,A00,098035,Nie; Jiawang,0,0,15,16
1668312012899,MATH 248,A00,098036,Bejenaru; Ioan,10,0,10,0
1668312013324,MATH 250B,A00,098037,Spolaor; Luca,14,0,15,1
1668312013746,MATH 258,A00,098038,Ni; Lei,10,0,10,0
1668312014174,MATH 264B,A00,098041,Rhoades; Brendon Patrick,9,0,15,6
1668312014598,MATH 268,A00,098042,Buss; Samuel R,10,0,10,0
1668312015025,MATH 269,A00,098043,Rhoades; Brendon Patrick,10,0,10,0
1668312015448,MATH 270B,A00,098044,Li; Bo,10,0,15,5
1668312015877,MATH 272B,A00,098045,Holst; Michael J,13,0,15,2
1668312016383,MATH 273A,A00,098046,Tian; Xiaochuan,10,0,15,5
1668312016810,MATH 275,A01,098048,Tian; Xiaochuan,6,0,10,4
1668312017240,MATH 278A,A00,098049,Holst; Michael J,8,0,10,2
1668312017671,MATH 278B,A00,098050,Cloninger; Alexander,10,0,10,0
1668312018096,MATH 278C,A00,098051,Nie; Jiawang,7,0,10,3
1668312018517,MATH 280B,A00,098052,Zheng; Tianyi,8,0,15,7
1668312018941,MATH 281B,A00,098053,Bradic; Jelena,1,0,15,14
1668312019367,MATH 282B,A00,098054,Arias-Castro; Ery,0,0,15,15
1668312019792,MATH 285,A00,098055,Fitzsimmons; Patrick J,0,0,15,17
1668312020218,MATH 287B,A00,098056,Arias-Castro; Ery,2,0,15,13
1668312020646,MATH 288,A00,098057,Agarwal; Pooja,9,0,10,1
1668312020646,MATH 288,B00,098058,Zhang; Danna,8,0,10,2
1668312020646,MATH 288,C00,098059,Williams; Ruth J,9,0,10,1
1668312021070,MATH 290B,A00,098060,Roberts; Justin Deritter,13,0,15,2
1668312021497,MATH 292,A00,098061,Belmont; Eva Kinoshita,10,0,10,0
1668312021923,MATH 295,A00,098062,Suk; Andrew Hoon,48,0,50,2
1668312022349,MATH 296,A00,098063,Novak; Jonathan I,20,0,20,0
1668312022773,MATH 297,001,098064,Gamst; Anthony Collins,9997,0,9999,2
1668312521895,COGS 205,A00,101395,Chiba; Andrea,19,0,20,1
1668312522319,COGS 210B,001,101404,Greene; Deanna Jacquelyn,9998,0,9999,1
1668312522319,COGS 210B,002,101417,Xia; Haijun,9999,0,9999,0
1668312522319,COGS 210B,003,101422,Nitz; Douglas A.,9999,0,9999,0
1668312522319,COGS 210B,004,101423,Hollan; James D.,9998,0,9999,1
1668312522319,COGS 210B,005,101424,Deak; Gedeon O.,9998,0,9999,1
1668312522319,COGS 210B,006,101425,Rossano; Federico,9999,0,9999,0
1668312522745,COGS 211B,A00,101427,Coulson; Seana M,9996,0,9999,3
1668312523168,COGS 220,A00,101428,Hollan; James D.,0,0,25,25
1668312523591,COGS 229,A00,101429,Dow; Steven P,18,0,25,7
1668312524016,COGS 230,A00,101430,Klemmer; Scott R,12,0,17,5
1668312524442,COGS 234,A00,101431,Xia; Haijun,1,0,25,24
1668312524877,COGS 260,A00,101432,Kiyonaga; Anastasia,21,0,25,4
1668312524877,COGS 260,B00,101433,Kirsh; David Joel,15,0,25,10
1668312525302,CSE 202,A00,102371,Impagliazzo; Russell,0,0,0,0
1668312525729,CSE 203B,A01,102373,Cheng; Chung Kuan,0,0,0,0
1668312526152,CSE 208,A00,102374,Micciancio; Daniele,0,0,0,0
1668312526577,CSE 209A,A00,112895,Impagliazzo; Russell,0,0,15,15
1668312527004,CSE 209B,A00,108005,Bellare; Mihir,0,0,0,0
1668312527430,CSE 210,A00,113163,Coblenz; Michael J,0,0,0,0
1668312527856,CSE 219,A00,106111,Dow; Steven P,0,0,20,20
1668312528281,CSE 221,A00,102376,Voelker; Geoffrey M.,0,0,0,0
1668312528704,CSE 224,A01,102378,Porter; George M,0,0,0,0
1668312529128,CSE 229A,A00,102379,Savage; Stefan,0,0,0,0
1668312529551,CSE 229C,A00,102380,Munyaka; Imani N. S.,0,0,0,0
1668312529978,CSE 232B,A00,102382,Deutsch; Alin Bernard,0,0,0,0
1668312530399,CSE 234,A01,112904,Kumar; Arun Kumar,0,0,0,0
1668312530824,CSE 237A,A00,102383,Rosing; Tajana Simunic,0,0,0,0
1668312531250,CSE 239A,A00,102384,Deutsch; Alin Bernard,0,0,0,0
1668312531673,CSE 239B,A00,102385,Polikarpova; Nadezhda,0,0,0,0
1668312532097,CSE 240A,A00,102386,Pannuto; Patrick William,0,0,0,0
1668312532532,CSE 240B,A00,102387,Zhao; Jishen,0,0,0,0
1668312532967,CSE 241A,A00,106406,Kang; Mingu,0,0,0,0
1668312533391,CSE 249B,A00,102388,Kahng; Andrew Byun,0,0,8,8
1668312533814,CSE 251B,A01,102392,Cottrell; Garrison W,0,0,0,0
1668312533814,CSE 251B,A02,102393,Cottrell; Garrison W,0,0,0,0
1668312534237,CSE 252B,A00,102394,Ochoa; Benjamin Lawrence,0,0,0,0
1668312534664,CSE 257,A01,102396,Gao; Sicun,0,0,0,0
1668312535087,CSE 272,A00,102397,Li; Tzumao,0,0,0,0
1668312535589,CSE 274,A00,111323,Chern; Albert Ren-Haur,0,0,0,0
1668312536013,CSE 282,A00,102398,Pevzner; Pavel Arkadjevich,0,0,0,0
1668312536438,CSE 284,A00,114175,Gymrek; Melissa Ann,0,0,0,0
1668312536865,CSE 290,A00,102399,Chandraker; Manmohan Krishna,0,0,0,0
1668312536865,CSE 290,B00,102400,Vaccaro; Kristen Marie,0,0,25,25
1668312536865,CSE 290,C00,102414,Pannuto; Patrick William,0,0,25,25
1668312536865,CSE 290,D00,102427,Pevzner; Pavel Arkadjevich,0,0,0,0
1668312536865,CSE 290,E00,102429,Zhao; Jishen,0,0,0,0
1668312536865,CSE 290,F00,102436,Tullsen; Dean Michael,0,0,0,0
1668312536865,CSE 290,G00,102440,Christensen; Henrik I,0,0,20,20
1668312537294,CSE 291,A00,102443,Su; Hao,0,0,0,0
1668312537294,CSE 291,B00,102448,Polikarpova; Nadezhda,0,0,0,0
1668312537294,CSE 291,C00,102453,Vaccaro; Kristen Marie,0,0,0,0
1668312537294,CSE 291,D00,111343,Savage; Stefan,0,0,0,0
1668312537294,CSE 291,E00,116474,Claffy; Kimberly Claire,0,0,0,0
1668312537294,CSE 291,F00,116479,Pasquale; Joseph,0,0,0,0
1668312537722,CSE 293,001,119111,Bafna; Vineet,9999,0,9999,0
1668312537722,CSE 293,002,119118,Bellare; Mihir,9999,0,9999,0
1668312537722,CSE 293,003,119122,Berg-Kirkpatrick; Taylor D,9999,0,9999,0
1668312537722,CSE 293,004,119135,Christensen; Henrik I,9999,0,9999,0
1668312537722,CSE 293,005,119142,Cottrell; Garrison W,9999,0,9999,0
1668312537722,CSE 293,006,119146,Deutsch; Alin Bernard,9999,0,9999,0
1668312537722,CSE 293,007,119159,Esmaeilzadeh; Hadi,9999,0,9999,0
1668312537722,CSE 293,008,119166,Freund; Yoav,9999,0,9999,0
1668312537722,CSE 293,009,119170,Griswold; William G.,9999,0,9999,0
1668312537722,CSE 293,010,119183,Gymrek; Melissa Ann,9999,0,9999,0
1668312537722,CSE 293,011,119190,Heninger; Nadia A,9999,0,9999,0
1668312537722,CSE 293,012,119230,Impagliazzo; Russell,9999,0,9999,0
1668312537722,CSE 293,013,119232,Jhala; Ranjit,9999,0,9999,0
1668312537722,CSE 293,014,119233,Kahng; Andrew Byun,9999,0,9999,0
1668312537722,CSE 293,015,119298,Kane; Daniel Mertz,9999,0,9999,0
1668312537722,CSE 293,016,119299,Kriegman; David J,9999,0,9999,0
1668312537722,CSE 293,017,119300,Kumar; Arun Kumar,9999,0,9999,0
1668312537722,CSE 293,018,119301,Lerner; Sorin,9999,0,9999,0
1668312537722,CSE 293,019,119302,Lovett; Shachar,9999,0,9999,0
1668312537722,CSE 293,020,119303,McAuley; Julian John,9999,0,9999,0
1668312537722,CSE 293,021,119304,Micciancio; Daniele,9999,0,9999,0
1668312537722,CSE 293,022,119367,Orailoglu; Alex,9999,0,9999,0
1668312537722,CSE 293,023,119382,Paturi; Ramamohan,9999,0,9999,0
1668312537722,CSE 293,024,119404,Polikarpova; Nadezhda,9999,0,9999,0
1668312537722,CSE 293,025,119406,Politz; Joseph Gibbs,9999,0,9999,0
1668312537722,CSE 293,026,119411,Porter; George M,9999,0,9999,0
1668312537722,CSE 293,027,119414,Porter; Leonard Emerson,9999,0,9999,0
1668312537722,CSE 293,028,119416,Ramamoorthi; Ravi,9999,0,9999,0
1668312537722,CSE 293,029,119417,Sahoo; Debashis,9999,0,9999,0
1668312537722,CSE 293,030,119420,Saul; Lawrence,9999,0,9999,0
1668312537722,CSE 293,031,119421,Savage; Stefan,9999,0,9999,0
1668312537722,CSE 293,032,119425,Schulze; Jurgen P.,9999,0,9999,0
1668312537722,CSE 293,033,119426,Snoeren; Alex C.,9999,0,9999,0
1668312537722,CSE 293,034,119428,Shang; Jingbo,9999,0,9999,0
1668312537722,CSE 293,035,119430,Stefan; Deian,9999,0,9999,0
1668312537722,CSE 293,036,119431,Su; Hao,9999,0,9999,0
1668312537722,CSE 293,037,119433,Swanson; Steven James,9999,0,9999,0
1668312537722,CSE 293,038,119435,Tullsen; Dean Michael,9999,0,9999,0
1668312537722,CSE 293,039,119483,Voelker; Geoffrey M.,9999,0,9999,0
1668312537722,CSE 293,040,119537,Zhao; Jishen,9999,0,9999,0
1668312537722,CSE 293,041,119538,Zhou; Yuan-Yuan,9999,0,9999,0
1668312537722,CSE 293,042,119539,Gao; Sicun,9999,0,9999,0
1668312537722,CSE 293,043,119540,Weibel; Nadir,9999,0,9999,0
1668312537722,CSE 293,044,119541,Gupta; Rajesh K.,9999,0,9999,0
1668312537722,CSE 293,045,126410,Vaccaro; Kristen Marie,9999,0,9999,0
1668312537722,CSE 293,046,126411,Klemke; Richard,9999,0,9999,0
1668312538145,CSE 294,A00,102459,Voelker; Geoffrey M.,0,0,0,0
1668312538145,CSE 294,B00,111322,Orailoglu; Alex,0,0,0,0
1668312538568,DSE 201,A00,096914,Deutsch; Alin Bernard,30,0,30,0
1668312538993,DSE 210,A00,096915,Dasgupta; Sanjoy,30,0,30,0
1668312539418,DSE 260A,A00,096916,Altintas De Callaf; Ilkay,30,0,30,0
1668312539846,ECE 200,001,103586,Antipa; Nicholas A,9999,0,9999,0
1668312539846,ECE 200,002,103587,Atanasov; Nikolay A.,9999,0,9999,0
1668312539846,ECE 200,003,103588,Bharadia; Dinesh,9999,0,9999,0
1668312539846,ECE 200,004,103589,Cheng; Chung Kuan,9999,0,9999,0
1668312539846,ECE 200,005,103590,Cosman; Pamela C.,9999,0,9999,0
1668312539846,ECE 200,006,103591,Dayeh; Shadi Ahmad,9999,0,9999,0
1668312539846,ECE 200,007,103592,Fainman; Yeshaiahu,9999,0,9999,0
1668312539846,ECE 200,008,103593,Ford; Joseph Earl,9999,0,9999,0
1668312539846,ECE 200,009,103594,Franceschetti; Massimo,9999,0,9999,0
1668312539846,ECE 200,010,103595,Fullerton; Eric E,9999,0,9999,0
1668312539846,ECE 200,011,103596,Galton; Ian A,9999,0,9999,0
1668312539846,ECE 200,012,103597,Gilja; Vikash,9999,0,9999,0
1668312539846,ECE 200,013,103598,Hall; Drew A.,9999,0,9999,0
1668312539846,ECE 200,014,103599,Hsueh; Tzu-Chien,9999,0,9999,0
1668312539846,ECE 200,015,103600,Javidi; Tara,9999,0,9999,0
1668312539846,ECE 200,016,103601,Kahng; Andrew Byun,9999,0,9999,0
1668312539846,ECE 200,017,103602,Kim; Young-Han,9999,0,9999,0
1668312539846,ECE 200,018,103603,Koushanfar; Farinaz,9999,0,9999,0
1668312539846,ECE 200,019,103604,Kuzum; Duygu,9999,0,9999,0
1668312539846,ECE 200,020,103605,Le; Hanh-Phuc,9999,0,9999,0
1668312539846,ECE 200,021,103606,Lin; Bill,9999,0,9999,0
1668312539846,ECE 200,022,103607,Liu; Zhaowei,9998,0,9999,1
1668312539846,ECE 200,023,103608,Lo; Yu-Hwa,9999,0,9999,0
1668312539846,ECE 200,024,103609,Lomakin; Vitaliy,9999,0,9999,0
1668312539846,ECE 200,025,103610,Mercier; Patrick Philip,9999,0,9999,0
1668312539846,ECE 200,026,103611,Meyer; Florian,9999,0,9999,0
1668312539846,ECE 200,027,103612,Milstein; Laurence B.,9999,0,9999,0
1668312539846,ECE 200,028,103613,Mir Arabbaygi; Siavash,9999,0,9999,0
1668312539846,ECE 200,029,103614,Mookherjea; Shayan,9999,0,9999,0
1668312539846,ECE 200,030,103615,Morris; Karcher William,9999,0,9999,0
1668312539846,ECE 200,031,103616,Ng; Tse Nga,9999,0,9999,0
1668312539846,ECE 200,032,103617,Nguyen; Truong Quang,9999,0,9999,0
1668312539846,ECE 200,033,103618,Nomura; Kenji,9999,0,9999,0
1668312539846,ECE 200,034,103619,Orlitsky; Alon,9999,0,9999,0
1668312539846,ECE 200,035,103620,Pal; Piya,9999,0,9999,0
1668312539846,ECE 200,036,103621,Papen; George C.,9999,0,9999,0
1668312539846,ECE 200,037,103622,Radic; Stojan,9999,0,9999,0
1668312539846,ECE 200,038,103623,Rao; Bhaskar D.,9999,0,9999,0
1668312539846,ECE 200,039,103624,Rao; Ramesh R,9999,0,9999,0
1668312539846,ECE 200,040,103625,Rebeiz; Gabriel,9999,0,9999,0
1668312539846,ECE 200,041,103626,Sanford; John R,9999,0,9999,0
1668312539846,ECE 200,042,103627,Siegel; Paul H.,9999,0,9999,0
1668312539846,ECE 200,043,103628,Sievenpiper; Daniel F.,9999,0,9999,0
1668312539846,ECE 200,044,103629,Sworder; David D.,9999,0,9999,0
1668312539846,ECE 200,045,103630,Taur; Yuan,9999,0,9999,0
1668312539846,ECE 200,046,103631,Touri; Behrouz,9999,0,9999,0
1668312539846,ECE 200,047,103632,Trivedi; Mohan M.,9999,0,9999,0
1668312539846,ECE 200,048,103633,Vasconcelos; Nuno,9999,0,9999,0
1668312539846,ECE 200,049,103634,Wang; Xiaolong,9999,0,9999,0
1668312539846,ECE 200,050,103635,Xie; Pengtao,9999,0,9999,0
1668312539846,ECE 200,051,103636,Yip; Michael,9999,0,9999,0
1668312539846,ECE 200,052,103637,Zeger; Kenneth A.,999,0,999,0
1668312539846,ECE 200,053,103638,Zhang; Xinyu,9999,0,9999,0
1668312539846,ECE 200,054,103639,Turakhia; Yatish Girish,9999,0,9999,0
1668312539846,ECE 200,055,103640,Kang; Mingu,9999,0,9999,0
1668312539846,ECE 200,056,103641,Shi; Yuanyuan,9999,0,9999,0
1668312539846,ECE 200,057,103642,Wang; Edward Jay,9999,0,9999,0
1668312539846,ECE 200,058,103643,Zheng; Yang,9999,0,9999,0
1668312540272,ECE 202,A00,103644,Kuzum; Duygu,0,0,0,0
1668312540697,ECE 212BN,A00,103646,Ng; Tse Nga,0,0,0,0
1668312541127,ECE 221,A00,111493,Staff,0,0,0,0
1668312541554,ECE 222B,A00,103647,Lomakin; Vitaliy,0,0,0,0
1668312541979,ECE 230B,A00,103648,Taur; Yuan,0,0,0,0
1668312542402,ECE 238B,A00,103649,Garay; Javier,0,0,0,0
1668312542826,ECE 240B,A00,112900,Fainman; Yeshaiahu,0,0,0,0
1668312543249,ECE 247A,A00,103650,Jokerst; Jesse Vincent,0,0,0,0
1668312543674,ECE 247B,A00,103651,Wang; Joseph,0,0,0,0
1668312544097,ECE 250,A00,103652,Siegel; Paul H.,0,0,0,0
1668312544533,ECE 251A,A00,103654,Rao; Bhaskar D.,0,0,0,0
1668312544967,ECE 257B,A00,103655,Bharadia; Dinesh,0,0,0,0
1668312545392,ECE 258A,A00,103656,Milstein; Laurence B.,0,0,0,0
1668312545819,ECE 260B,A00,103658,Kang; Mingu,0,0,0,0
1668312546243,ECE 264A,A00,103659,Galton; Ian A,0,0,0,0
1668312546669,ECE 265A,A00,103661,Gudem; Prasad S.S.,0,0,0,0
1668312547093,ECE 265D,A00,103662,Gudem; Prasad S.S.,0,0,0,0
1668312547519,ECE 268,A00,103663,Koushanfar; Farinaz,0,0,0,0
1668312547956,ECE 269,A01,103665,Pal; Piya,0,0,0,0
1668312548381,ECE 271B,A00,103666,Vasconcelos; Manuela,0,0,0,0
1668312548825,ECE 276A,A00,103667,Atanasov; Nikolay A.,0,0,0,0
1668312549248,ECE 277,A00,103668,An; Cheolhong,0,0,0,0
1668312549674,ECE 279,A00,117947,Hall; Drew A.,0,0,0,0
1668312550527,ECE 283,A00,103670,Hsueh; Tzu-Chien,0,0,0,0
1668312550951,ECE 284,A00,103671,Turakhia; Yatish Girish,0,0,0,0
1668312551375,ECE 285,A00,103672,Zheng; Yang,0,0,0,0
1668312551375,ECE 285,B00,103673,Sworder; David D.,0,0,0,0
1668312551800,ECE 287,A00,103676,Javidi; Tara,0,0,0,0
1668312552226,MATH 200B,A00,098023,Salehi Golsefidy; Alireza,12,0,15,3
1668312552648,MATH 202B,A00,098024,Rhoades; Brendon Patrick,9,0,15,6
1668312553075,MATH 203B,A00,098025,Oprea; Dragos N.,10,0,15,5
1668312553503,MATH 204B,A00,098026,Sorensen; Claus M,13,0,15,2
1668312553926,MATH 208,A00,098027,Izadi; Elham,7,0,10,3
1668312554354,MATH 209,A00,098028,Pollack; Aaron,10,0,10,0
1668312554777,MATH 211A,A00,112919,Rogalski; Daniel,9,0,10,1
1668312555201,MATH 211B,A00,112920,Seward; Brandon M.,9,0,10,1
1668312555623,MATH 218,A00,098029,Li; Bo,10,0,10,0
1668312556051,MATH 220B,A00,098030,Novak; Jonathan I,11,0,15,4
1668312556475,MATH 221A,A00,098031,Ebenfelt; Peter F,13,0,15,2
1668312556902,MATH 231B,A00,098032,Zlatos; Andrej,12,0,15,3
1668312557336,MATH 240B,A00,098033,Ni; Lei,9,0,15,6
1668312557773,MATH 243,A00,098034,Jekel; David Andrew,10,0,10,0
1668312558199,MATH 245A,A00,098035,Nie; Jiawang,0,0,15,16
1668312558623,MATH 248,A00,098036,Bejenaru; Ioan,10,0,10,0
1668312559049,MATH 250B,A00,098037,Spolaor; Luca,14,0,15,1
1668312559472,MATH 258,A00,098038,Ni; Lei,10,0,10,0
1668312559902,MATH 264B,A00,098041,Rhoades; Brendon Patrick,9,0,15,6
1668312560328,MATH 268,A00,098042,Buss; Samuel R,10,0,10,0
1668312560753,MATH 269,A00,098043,Rhoades; Brendon Patrick,10,0,10,0
1668312561176,MATH 270B,A00,098044,Li; Bo,10,0,15,5
1668312561603,MATH 272B,A00,098045,Holst; Michael J,13,0,15,2
1668312562026,MATH 273A,A00,098046,Tian; Xiaochuan,10,0,15,5
1668312562450,MATH 275,A01,098048,Tian; Xiaochuan,6,0,10,4
1668312562872,MATH 278A,A00,098049,Holst; Michael J,8,0,10,2
1668312563296,MATH 278B,A00,098050,Cloninger; Alexander,10,0,10,0
1668312563720,MATH 278C,A00,098051,Nie; Jiawang,7,0,10,3
1668312564148,MATH 280B,A00,098052,Zheng; Tianyi,8,0,15,7
1668312564573,MATH 281B,A00,098053,Bradic; Jelena,1,0,15,14
1668312564998,MATH 282B,A00,098054,Arias-Castro; Ery,0,0,15,15
1668312565425,MATH 285,A00,098055,Fitzsimmons; Patrick J,0,0,15,17
1668312565851,MATH 287B,A00,098056,Arias-Castro; Ery,2,0,15,13
1668312566274,MATH 288,A00,098057,Agarwal; Pooja,9,0,10,1
1668312566274,MATH 288,B00,098058,Zhang; Danna,8,0,10,2
1668312566274,MATH 288,C00,098059,Williams; Ruth J,9,0,10,1
1668312566698,MATH 290B,A00,098060,Roberts; Justin Deritter,13,0,15,2
1668312567124,MATH 292,A00,098061,Belmont; Eva Kinoshita,10,0,10,0
1668312567549,MATH 295,A00,098062,Suk; Andrew Hoon,48,0,50,2
1668312567974,MATH 296,A00,098063,Novak; Jonathan I,20,0,20,0
1668312568401,MATH 297,001,098064,Gamst; Anthony Collins,9997,0,9999,2
1668313067488,COGS 205,A00,101395,Chiba; Andrea,19,0,20,1
1668313067912,COGS 210B,001,101404,Greene; Deanna Jacquelyn,9998,0,9999,1
1668313067912,COGS 210B,002,101417,Xia; Haijun,9999,0,9999,0
1668313067912,COGS 210B,003,101422,Nitz; Douglas A.,9999,0,9999,0
1668313067912,COGS 210B,004,101423,Hollan; James D.,9998,0,9999,1
1668313067912,COGS 210B,005,101424,Deak; Gedeon O.,9998,0,9999,1
1668313067912,COGS 210B,006,101425,Rossano; Federico,9999,0,9999,0
1668313068337,COGS 211B,A00,101427,Coulson; Seana M,9996,0,9999,3
1668313068760,COGS 220,A00,101428,Hollan; James D.,0,0,25,25
1668313069182,COGS 229,A00,101429,Dow; Steven P,18,0,25,7
1668313069608,COGS 230,A00,101430,Klemmer; Scott R,12,0,17,5
1668313070045,COGS 234,A00,101431,Xia; Haijun,1,0,25,24
1668313070469,COGS 260,A00,101432,Kiyonaga; Anastasia,21,0,25,4
1668313070469,COGS 260,B00,101433,Kirsh; David Joel,15,0,25,10
1668313070897,CSE 202,A00,102371,Impagliazzo; Russell,0,0,0,0
1668313071337,CSE 203B,A01,102373,Cheng; Chung Kuan,0,0,0,0
1668313071760,CSE 208,A00,102374,Micciancio; Daniele,0,0,0,0
1668313072185,CSE 209A,A00,112895,Impagliazzo; Russell,0,0,15,15
1668313072610,CSE 209B,A00,108005,Bellare; Mihir,0,0,0,0
1668313073033,CSE 210,A00,113163,Coblenz; Michael J,0,0,0,0
1668313073457,CSE 219,A00,106111,Dow; Steven P,0,0,20,20
1668313073883,CSE 221,A00,102376,Voelker; Geoffrey M.,0,0,0,0
1668313074309,CSE 224,A01,102378,Porter; George M,0,0,0,0
1668313074734,CSE 229A,A00,102379,Savage; Stefan,0,0,0,0
1668313075158,CSE 229C,A00,102380,Munyaka; Imani N. S.,0,0,0,0
1668313075581,CSE 232B,A00,102382,Deutsch; Alin Bernard,0,0,0,0
1668313076006,CSE 234,A01,112904,Kumar; Arun Kumar,0,0,0,0
1668313076436,CSE 237A,A00,102383,Rosing; Tajana Simunic,0,0,0,0
1668313076861,CSE 239A,A00,102384,Deutsch; Alin Bernard,0,0,0,0
1668313077285,CSE 239B,A00,102385,Polikarpova; Nadezhda,0,0,0,0
1668313077719,CSE 240A,A00,102386,Pannuto; Patrick William,0,0,0,0
1668313078148,CSE 240B,A00,102387,Zhao; Jishen,0,0,0,0
1668313078575,CSE 241A,A00,106406,Kang; Mingu,0,0,0,0
1668313079003,CSE 249B,A00,102388,Kahng; Andrew Byun,0,0,8,8
1668313079433,CSE 251B,A01,102392,Cottrell; Garrison W,0,0,0,0
1668313079433,CSE 251B,A02,102393,Cottrell; Garrison W,0,0,0,0
1668313079860,CSE 252B,A00,102394,Ochoa; Benjamin Lawrence,0,0,0,0
1668313080287,CSE 257,A01,102396,Gao; Sicun,0,0,0,0
1668313080709,CSE 272,A00,102397,Li; Tzumao,0,0,0,0
1668313081134,CSE 274,A00,111323,Chern; Albert Ren-Haur,0,0,0,0
1668313081560,CSE 282,A00,102398,Pevzner; Pavel Arkadjevich,0,0,0,0
1668313082003,CSE 284,A00,114175,Gymrek; Melissa Ann,0,0,0,0
1668313082427,CSE 290,A00,102399,Chandraker; Manmohan Krishna,0,0,0,0
1668313082427,CSE 290,B00,102400,Vaccaro; Kristen Marie,0,0,25,25
1668313082427,CSE 290,C00,102414,Pannuto; Patrick William,0,0,25,25
1668313082427,CSE 290,D00,102427,Pevzner; Pavel Arkadjevich,0,0,0,0
1668313082427,CSE 290,E00,102429,Zhao; Jishen,0,0,0,0
1668313082427,CSE 290,F00,102436,Tullsen; Dean Michael,0,0,0,0
1668313082427,CSE 290,G00,102440,Christensen; Henrik I,0,0,20,20
1668313082857,CSE 291,A00,102443,Su; Hao,0,0,0,0
1668313082857,CSE 291,B00,102448,Polikarpova; Nadezhda,0,0,0,0
1668313082857,CSE 291,C00,102453,Vaccaro; Kristen Marie,0,0,0,0
1668313082857,CSE 291,D00,111343,Savage; Stefan,0,0,0,0
1668313082857,CSE 291,E00,116474,Claffy; Kimberly Claire,0,0,0,0
1668313082857,CSE 291,F00,116479,Pasquale; Joseph,0,0,0,0
1668313083283,CSE 293,001,119111,Bafna; Vineet,9999,0,9999,0
1668313083283,CSE 293,002,119118,Bellare; Mihir,9999,0,9999,0
1668313083283,CSE 293,003,119122,Berg-Kirkpatrick; Taylor D,9999,0,9999,0
1668313083283,CSE 293,004,119135,Christensen; Henrik I,9999,0,9999,0
1668313083283,CSE 293,005,119142,Cottrell; Garrison W,9999,0,9999,0
1668313083283,CSE 293,006,119146,Deutsch; Alin Bernard,9999,0,9999,0
1668313083283,CSE 293,007,119159,Esmaeilzadeh; Hadi,9999,0,9999,0
1668313083283,CSE 293,008,119166,Freund; Yoav,9999,0,9999,0
1668313083283,CSE 293,009,119170,Griswold; William G.,9999,0,9999,0
1668313083283,CSE 293,010,119183,Gymrek; Melissa Ann,9999,0,9999,0
1668313083283,CSE 293,011,119190,Heninger; Nadia A,9999,0,9999,0
1668313083283,CSE 293,012,119230,Impagliazzo; Russell,9999,0,9999,0
1668313083283,CSE 293,013,119232,Jhala; Ranjit,9999,0,9999,0
1668313083283,CSE 293,014,119233,Kahng; Andrew Byun,9999,0,9999,0
1668313083283,CSE 293,015,119298,Kane; Daniel Mertz,9999,0,9999,0
1668313083283,CSE 293,016,119299,Kriegman; David J,9999,0,9999,0
1668313083283,CSE 293,017,119300,Kumar; Arun Kumar,9999,0,9999,0
1668313083283,CSE 293,018,119301,Lerner; Sorin,9999,0,9999,0
1668313083283,CSE 293,019,119302,Lovett; Shachar,9999,0,9999,0
1668313083283,CSE 293,020,119303,McAuley; Julian John,9999,0,9999,0
1668313083283,CSE 293,021,119304,Micciancio; Daniele,9999,0,9999,0
1668313083283,CSE 293,022,119367,Orailoglu; Alex,9999,0,9999,0
1668313083283,CSE 293,023,119382,Paturi; Ramamohan,9999,0,9999,0
1668313083283,CSE 293,024,119404,Polikarpova; Nadezhda,9999,0,9999,0
1668313083283,CSE 293,025,119406,Politz; Joseph Gibbs,9999,0,9999,0
1668313083283,CSE 293,026,119411,Porter; George M,9999,0,9999,0
1668313083283,CSE 293,027,119414,Porter; Leonard Emerson,9999,0,9999,0
1668313083283,CSE 293,028,119416,Ramamoorthi; Ravi,9999,0,9999,0
1668313083283,CSE 293,029,119417,Sahoo; Debashis,9999,0,9999,0
1668313083283,CSE 293,030,119420,Saul; Lawrence,9999,0,9999,0
1668313083283,CSE 293,031,119421,Savage; Stefan,9999,0,9999,0
1668313083283,CSE 293,032,119425,Schulze; Jurgen P.,9999,0,9999,0
1668313083283,CSE 293,033,119426,Snoeren; Alex C.,9999,0,9999,0
1668313083283,CSE 293,034,119428,Shang; Jingbo,9999,0,9999,0
1668313083283,CSE 293,035,119430,Stefan; Deian,9999,0,9999,0
1668313083283,CSE 293,036,119431,Su; Hao,9999,0,9999,0
1668313083283,CSE 293,037,119433,Swanson; Steven James,9999,0,9999,0
1668313083283,CSE 293,038,119435,Tullsen; Dean Michael,9999,0,9999,0
1668313083283,CSE 293,039,119483,Voelker; Geoffrey M.,9999,0,9999,0
1668313083283,CSE 293,040,119537,Zhao; Jishen,9999,0,9999,0
1668313083283,CSE 293,041,119538,Zhou; Yuan-Yuan,9999,0,9999,0
1668313083283,CSE 293,042,119539,Gao; Sicun,9999,0,9999,0
1668313083283,CSE 293,043,119540,Weibel; Nadir,9999,0,9999,0
1668313083283,CSE 293,044,119541,Gupta; Rajesh K.,9999,0,9999,0
1668313083283,CSE 293,045,126410,Vaccaro; Kristen Marie,9999,0,9999,0
1668313083283,CSE 293,046,126411,Klemke; Richard,9999,0,9999,0
1668313083710,CSE 294,A00,102459,Voelker; Geoffrey M.,0,0,0,0
1668313083710,CSE 294,B00,111322,Orailoglu; Alex,0,0,0,0
1668313084142,DSE 201,A00,096914,Deutsch; Alin Bernard,30,0,30,0
1668313084568,DSE 210,A00,096915,Dasgupta; Sanjoy,30,0,30,0
1668313084993,DSE 260A,A00,096916,Altintas De Callaf; Ilkay,30,0,30,0
1668313085441,ECE 200,001,103586,Antipa; Nicholas A,9999,0,9999,0
1668313085441,ECE 200,002,103587,Atanasov; Nikolay A.,9999,0,9999,0
1668313085441,ECE 200,003,103588,Bharadia; Dinesh,9999,0,9999,0
1668313085441,ECE 200,004,103589,Cheng; Chung Kuan,9999,0,9999,0
1668313085441,ECE 200,005,103590,Cosman; Pamela C.,9999,0,9999,0
1668313085441,ECE 200,006,103591,Dayeh; Shadi Ahmad,9999,0,9999,0
1668313085441,ECE 200,007,103592,Fainman; Yeshaiahu,9999,0,9999,0
1668313085441,ECE 200,008,103593,Ford; Joseph Earl,9999,0,9999,0
1668313085441,ECE 200,009,103594,Franceschetti; Massimo,9999,0,9999,0
1668313085441,ECE 200,010,103595,Fullerton; Eric E,9999,0,9999,0
1668313085441,ECE 200,011,103596,Galton; Ian A,9999,0,9999,0
1668313085441,ECE 200,012,103597,Gilja; Vikash,9999,0,9999,0
1668313085441,ECE 200,013,103598,Hall; Drew A.,9999,0,9999,0
1668313085441,ECE 200,014,103599,Hsueh; Tzu-Chien,9999,0,9999,0
1668313085441,ECE 200,015,103600,Javidi; Tara,9999,0,9999,0
1668313085441,ECE 200,016,103601,Kahng; Andrew Byun,9999,0,9999,0
1668313085441,ECE 200,017,103602,Kim; Young-Han,9999,0,9999,0
1668313085441,ECE 200,018,103603,Koushanfar; Farinaz,9999,0,9999,0
1668313085441,ECE 200,019,103604,Kuzum; Duygu,9999,0,9999,0
1668313085441,ECE 200,020,103605,Le; Hanh-Phuc,9999,0,9999,0
1668313085441,ECE 200,021,103606,Lin; Bill,9999,0,9999,0
1668313085441,ECE 200,022,103607,Liu; Zhaowei,9998,0,9999,1
1668313085441,ECE 200,023,103608,Lo; Yu-Hwa,9999,0,9999,0
1668313085441,ECE 200,024,103609,Lomakin; Vitaliy,9999,0,9999,0
1668313085441,ECE 200,025,103610,Mercier; Patrick Philip,9999,0,9999,0
1668313085441,ECE 200,026,103611,Meyer; Florian,9999,0,9999,0
1668313085441,ECE 200,027,103612,Milstein; Laurence B.,9999,0,9999,0
1668313085441,ECE 200,028,103613,Mir Arabbaygi; Siavash,9999,0,9999,0
1668313085441,ECE 200,029,103614,Mookherjea; Shayan,9999,0,9999,0
1668313085441,ECE 200,030,103615,Morris; Karcher William,9999,0,9999,0
1668313085441,ECE 200,031,103616,Ng; Tse Nga,9999,0,9999,0
1668313085441,ECE 200,032,103617,Nguyen; Truong Quang,9999,0,9999,0
1668313085441,ECE 200,033,103618,Nomura; Kenji,9999,0,9999,0
1668313085441,ECE 200,034,103619,Orlitsky; Alon,9999,0,9999,0
1668313085441,ECE 200,035,103620,Pal; Piya,9999,0,9999,0
1668313085441,ECE 200,036,103621,Papen; George C.,9999,0,9999,0
1668313085441,ECE 200,037,103622,Radic; Stojan,9999,0,9999,0
1668313085441,ECE 200,038,103623,Rao; Bhaskar D.,9999,0,9999,0
1668313085441,ECE 200,039,103624,Rao; Ramesh R,9999,0,9999,0
1668313085441,ECE 200,040,103625,Rebeiz; Gabriel,9999,0,9999,0
1668313085441,ECE 200,041,103626,Sanford; John R,9999,0,9999,0
1668313085441,ECE 200,042,103627,Siegel; Paul H.,9999,0,9999,0
1668313085441,ECE 200,043,103628,Sievenpiper; Daniel F.,9999,0,9999,0
1668313085441,ECE 200,044,103629,Sworder; David D.,9999,0,9999,0
1668313085441,ECE 200,045,103630,Taur; Yuan,9999,0,9999,0
1668313085441,ECE 200,046,103631,Touri; Behrouz,9999,0,9999,0
1668313085441,ECE 200,047,103632,Trivedi; Mohan M.,9999,0,9999,0
1668313085441,ECE 200,048,103633,Vasconcelos; Nuno,9999,0,9999,0
1668313085441,ECE 200,049,103634,Wang; Xiaolong,9999,0,9999,0
1668313085441,ECE 200,050,103635,Xie; Pengtao,9999,0,9999,0
1668313085441,ECE 200,051,103636,Yip; Michael,9999,0,9999,0
1668313085441,ECE 200,052,103637,Zeger; Kenneth A.,999,0,999,0
1668313085441,ECE 200,053,103638,Zhang; Xinyu,9999,0,9999,0
1668313085441,ECE 200,054,103639,Turakhia; Yatish Girish,9999,0,9999,0
1668313085441,ECE 200,055,103640,Kang; Mingu,9999,0,9999,0
1668313085441,ECE 200,056,103641,Shi; Yuanyuan,9999,0,9999,0
1668313085441,ECE 200,057,103642,Wang; Edward Jay,9999,0,9999,0
1668313085441,ECE 200,058,103643,Zheng; Yang,9999,0,9999,0
1668313085870,ECE 202,A00,103644,Kuzum; Duygu,0,0,0,0
1668313086295,ECE 212BN,A00,103646,Ng; Tse Nga,0,0,0,0
1668313086720,ECE 221,A00,111493,Staff,0,0,0,0
1668313087144,ECE 222B,A00,103647,Lomakin; Vitaliy,0,0,0,0
1668313087570,ECE 230B,A00,103648,Taur; Yuan,0,0,0,0
1668313087993,ECE 238B,A00,103649,Garay; Javier,0,0,0,0
1668313088418,ECE 240B,A00,112900,Fainman; Yeshaiahu,0,0,0,0
1668313088849,ECE 247A,A00,103650,Jokerst; Jesse Vincent,0,0,0,0
1668313089272,ECE 247B,A00,103651,Wang; Joseph,0,0,0,0
1668313089699,ECE 250,A00,103652,Siegel; Paul H.,0,0,0,0
1668313090126,ECE 251A,A00,103654,Rao; Bhaskar D.,0,0,0,0
1668313090548,ECE 257B,A00,103655,Bharadia; Dinesh,0,0,0,0
1668313090973,ECE 258A,A00,103656,Milstein; Laurence B.,0,0,0,0
1668313091399,ECE 260B,A00,103658,Kang; Mingu,0,0,0,0
1668313091824,ECE 264A,A00,103659,Galton; Ian A,0,0,0,0
1668313092247,ECE 265A,A00,103661,Gudem; Prasad S.S.,0,0,0,0
1668313092676,ECE 265D,A00,103662,Gudem; Prasad S.S.,0,0,0,0
1668313093100,ECE 268,A00,103663,Koushanfar; Farinaz,0,0,0,0
1668313093525,ECE 269,A01,103665,Pal; Piya,0,0,0,0
1668313093950,ECE 271B,A00,103666,Vasconcelos; Manuela,0,0,0,0
1668313094374,ECE 276A,A00,103667,Atanasov; Nikolay A.,0,0,0,0
1668313094807,ECE 277,A00,103668,An; Cheolhong,0,0,0,0
1668313095232,ECE 279,A00,117947,Hall; Drew A.,0,0,0,0
1668313096077,ECE 283,A00,103670,Hsueh; Tzu-Chien,0,0,0,0
1668313096505,ECE 284,A00,103671,Turakhia; Yatish Girish,0,0,0,0
1668313096931,ECE 285,A00,103672,Zheng; Yang,0,0,0,0
1668313096931,ECE 285,B00,103673,Sworder; David D.,0,0,0,0
1668313097354,ECE 287,A00,103676,Javidi; Tara,0,0,0,0
1668313097859,MATH 200B,A00,098023,Salehi Golsefidy; Alireza,12,0,15,3
1668313098290,MATH 202B,A00,098024,Rhoades; Brendon Patrick,9,0,15,6
1668313098716,MATH 203B,A00,098025,Oprea; Dragos N.,10,0,15,5
1668313099144,MATH 204B,A00,098026,Sorensen; Claus M,13,0,15,2
1668313099570,MATH 208,A00,098027,Izadi; Elham,7,0,10,3
1668313100005,MATH 209,A00,098028,Pollack; Aaron,10,0,10,0
1668313100431,MATH 211A,A00,112919,Rogalski; Daniel,9,0,10,1
1668313100853,MATH 211B,A00,112920,Seward; Brandon M.,9,0,10,1
1668313101276,MATH 218,A00,098029,Li; Bo,10,0,10,0
1668313101703,MATH 220B,A00,098030,Novak; Jonathan I,11,0,15,4
1668313102127,MATH 221A,A00,098031,Ebenfelt; Peter F,13,0,15,2
1668313102551,MATH 231B,A00,098032,Zlatos; Andrej,12,0,15,3
1668313102978,MATH 240B,A00,098033,Ni; Lei,9,0,15,6
1668313103401,MATH 243,A00,098034,Jekel; David Andrew,10,0,10,0
1668313103827,MATH 245A,A00,098035,Nie; Jiawang,0,0,15,16
1668313104251,MATH 248,A00,098036,Bejenaru; Ioan,10,0,10,0
1668313104673,MATH 250B,A00,098037,Spolaor; Luca,14,0,15,1
1668313105097,MATH 258,A00,098038,Ni; Lei,10,0,10,0
1668313105524,MATH 264B,A00,098041,Rhoades; Brendon Patrick,9,0,15,6
1668313105951,MATH 268,A00,098042,Buss; Samuel R,10,0,10,0
1668313106374,MATH 269,A00,098043,Rhoades; Brendon Patrick,10,0,10,0
1668313106802,MATH 270B,A00,098044,Li; Bo,10,0,15,5
1668313107226,MATH 272B,A00,098045,Holst; Michael J,13,0,15,2
1668313107651,MATH 273A,A00,098046,Tian; Xiaochuan,10,0,15,5
1668313108076,MATH 275,A01,098048,Tian; Xiaochuan,6,0,10,4
1668313108502,MATH 278A,A00,098049,Holst; Michael J,8,0,10,2
1668313108927,MATH 278B,A00,098050,Cloninger; Alexander,10,0,10,0
1668313109351,MATH 278C,A00,098051,Nie; Jiawang,7,0,10,3
1668313109775,MATH 280B,A00,098052,Zheng; Tianyi,8,0,15,7
1668313110215,MATH 281B,A00,098053,Bradic; Jelena,1,0,15,14
1668313110642,MATH 282B,A00,098054,Arias-Castro; Ery,0,0,15,15
1668313111066,MATH 285,A00,098055,Fitzsimmons; Patrick J,0,0,15,17
1668313111492,MATH 287B,A00,098056,Arias-Castro; Ery,2,0,15,13
1668313111917,MATH 288,A00,098057,Agarwal; Pooja,9,0,10,1
1668313111917,MATH 288,B00,098058,Zhang; Danna,8,0,10,2
1668313111917,MATH 288,C00,098059,Williams; Ruth J,9,0,10,1
1668313112342,MATH 290B,A00,098060,Roberts; Justin Deritter,13,0,15,2
1668313112767,MATH 292,A00,098061,Belmont; Eva Kinoshita,10,0,10,0
1668313113192,MATH 295,A00,098062,Suk; Andrew Hoon,48,0,50,2
1668313113613,MATH 296,A00,098063,Novak; Jonathan I,20,0,20,0
1668313114040,MATH 297,001,098064,Gamst; Anthony Collins,9997,0,9999,2
1668313612834,COGS 205,A00,101395,Chiba; Andrea,19,0,20,1
1668313613258,COGS 210B,001,101404,Greene; Deanna Jacquelyn,9998,0,9999,1
1668313613258,COGS 210B,002,101417,Xia; Haijun,9999,0,9999,0
1668313613258,COGS 210B,003,101422,Nitz; Douglas A.,9999,0,9999,0
1668313613258,COGS 210B,004,101423,Hollan; James D.,9998,0,9999,1
1668313613258,COGS 210B,005,101424,Deak; Gedeon O.,9998,0,9999,1
1668313613258,COGS 210B,006,101425,Rossano; Federico,9999,0,9999,0
1668313613681,COGS 211B,A00,101427,Coulson; Seana M,9996,0,9999,3
1668313614106,COGS 220,A00,101428,Hollan; James D.,0,0,25,25
1668313614530,COGS 229,A00,101429,Dow; Steven P,18,0,25,7
1668313614956,COGS 230,A00,101430,Klemmer; Scott R,12,0,17,5
1668313615381,COGS 234,A00,101431,Xia; Haijun,1,0,25,24
1668313615808,COGS 260,A00,101432,Kiyonaga; Anastasia,21,0,25,4
1668313615808,COGS 260,B00,101433,Kirsh; David Joel,15,0,25,10
1668313616234,CSE 202,A00,102371,Impagliazzo; Russell,0,0,0,0
1668313616731,CSE 203B,A01,102373,Cheng; Chung Kuan,0,0,0,0
1668313617154,CSE 208,A00,102374,Micciancio; Daniele,0,0,0,0
1668313617577,CSE 209A,A00,112895,Impagliazzo; Russell,0,0,15,15
1668313617998,CSE 209B,A00,108005,Bellare; Mihir,0,0,0,0
1668313618422,CSE 210,A00,113163,Coblenz; Michael J,0,0,0,0
1668313618847,CSE 219,A00,106111,Dow; Steven P,0,0,20,20
1668313619272,CSE 221,A00,102376,Voelker; Geoffrey M.,0,0,0,0
1668313619696,CSE 224,A01,102378,Porter; George M,0,0,0,0
1668313620118,CSE 229A,A00,102379,Savage; Stefan,0,0,0,0
1668313620546,CSE 229C,A00,102380,Munyaka; Imani N. S.,0,0,0,0
1668313620970,CSE 232B,A00,102382,Deutsch; Alin Bernard,0,0,0,0
1668313621395,CSE 234,A01,112904,Kumar; Arun Kumar,0,0,0,0
1668313621829,CSE 237A,A00,102383,Rosing; Tajana Simunic,0,0,0,0
1668313622253,CSE 239A,A00,102384,Deutsch; Alin Bernard,0,0,0,0
1668313622679,CSE 239B,A00,102385,Polikarpova; Nadezhda,0,0,0,0
1668313623103,CSE 240A,A00,102386,Pannuto; Patrick William,0,0,0,0
1668313623529,CSE 240B,A00,102387,Zhao; Jishen,0,0,0,0
1668313623953,CSE 241A,A00,106406,Kang; Mingu,0,0,0,0
1668313624378,CSE 249B,A00,102388,Kahng; Andrew Byun,0,0,8,8
1668313624805,CSE 251B,A01,102392,Cottrell; Garrison W,0,0,0,0
1668313624805,CSE 251B,A02,102393,Cottrell; Garrison W,0,0,0,0
1668313625229,CSE 252B,A00,102394,Ochoa; Benjamin Lawrence,0,0,0,0
1668313625658,CSE 257,A01,102396,Gao; Sicun,0,0,0,0
1668313626083,CSE 272,A00,102397,Li; Tzumao,0,0,0,0
1668313626504,CSE 274,A00,111323,Chern; Albert Ren-Haur,0,0,0,0
1668313626927,CSE 282,A00,102398,Pevzner; Pavel Arkadjevich,0,0,0,0
1668313627356,CSE 284,A00,114175,Gymrek; Melissa Ann,0,0,0,0
1668313627785,CSE 290,A00,102399,Chandraker; Manmohan Krishna,0,0,0,0
1668313627785,CSE 290,B00,102400,Vaccaro; Kristen Marie,0,0,25,25
1668313627785,CSE 290,C00,102414,Pannuto; Patrick William,0,0,25,25
1668313627785,CSE 290,D00,102427,Pevzner; Pavel Arkadjevich,0,0,0,0
1668313627785,CSE 290,E00,102429,Zhao; Jishen,0,0,0,0
1668313627785,CSE 290,F00,102436,Tullsen; Dean Michael,0,0,0,0
1668313627785,CSE 290,G00,102440,Christensen; Henrik I,0,0,20,20
1668313628210,CSE 291,A00,102443,Su; Hao,0,0,0,0
1668313628210,CSE 291,B00,102448,Polikarpova; Nadezhda,0,0,0,0
1668313628210,CSE 291,C00,102453,Vaccaro; Kristen Marie,0,0,0,0
1668313628210,CSE 291,D00,111343,Savage; Stefan,0,0,0,0
1668313628210,CSE 291,E00,116474,Claffy; Kimberly Claire,0,0,0,0
1668313628210,CSE 291,F00,116479,Pasquale; Joseph,0,0,0,0
1668313628666,CSE 293,001,119111,Bafna; Vineet,9999,0,9999,0
1668313628666,CSE 293,002,119118,Bellare; Mihir,9999,0,9999,0
1668313628666,CSE 293,003,119122,Berg-Kirkpatrick; Taylor D,9999,0,9999,0
1668313628666,CSE 293,004,119135,Christensen; Henrik I,9999,0,9999,0
1668313628666,CSE 293,005,119142,Cottrell; Garrison W,9999,0,9999,0
1668313628666,CSE 293,006,119146,Deutsch; Alin Bernard,9999,0,9999,0
1668313628666,CSE 293,007,119159,Esmaeilzadeh; Hadi,9999,0,9999,0
1668313628666,CSE 293,008,119166,Freund; Yoav,9999,0,9999,0
1668313628666,CSE 293,009,119170,Griswold; William G.,9999,0,9999,0
1668313628666,CSE 293,010,119183,Gymrek; Melissa Ann,9999,0,9999,0
1668313628666,CSE 293,011,119190,Heninger; Nadia A,9999,0,9999,0
1668313628666,CSE 293,012,119230,Impagliazzo; Russell,9999,0,9999,0
1668313628666,CSE 293,013,119232,Jhala; Ranjit,9999,0,9999,0
1668313628666,CSE 293,014,119233,Kahng; Andrew Byun,9999,0,9999,0
1668313628666,CSE 293,015,119298,Kane; Daniel Mertz,9999,0,9999,0
1668313628666,CSE 293,016,119299,Kriegman; David J,9999,0,9999,0
1668313628666,CSE 293,017,119300,Kumar; Arun Kumar,9999,0,9999,0
1668313628666,CSE 293,018,119301,Lerner; Sorin,9999,0,9999,0
1668313628666,CSE 293,019,119302,Lovett; Shachar,9999,0,9999,0
1668313628666,CSE 293,020,119303,McAuley; Julian John,9999,0,9999,0
1668313628666,CSE 293,021,119304,Micciancio; Daniele,9999,0,9999,0
1668313628666,CSE 293,022,119367,Orailoglu; Alex,9999,0,9999,0
1668313628666,CSE 293,023,119382,Paturi; Ramamohan,9999,0,9999,0
1668313628666,CSE 293,024,119404,Polikarpova; Nadezhda,9999,0,9999,0
1668313628666,CSE 293,025,119406,Politz; Joseph Gibbs,9999,0,9999,0
1668313628666,CSE 293,026,119411,Porter; George M,9999,0,9999,0
1668313628666,CSE 293,027,119414,Porter; Leonard Emerson,9999,0,9999,0
1668313628666,CSE 293,028,119416,Ramamoorthi; Ravi,9999,0,9999,0
1668313628666,CSE 293,029,119417,Sahoo; Debashis,9999,0,9999,0
1668313628666,CSE 293,030,119420,Saul; Lawrence,9999,0,9999,0
1668313628666,CSE 293,031,119421,Savage; Stefan,9999,0,9999,0
1668313628666,CSE 293,032,119425,Schulze; Jurgen P.,9999,0,9999,0
1668313628666,CSE 293,033,119426,Snoeren; Alex C.,9999,0,9999,0
1668313628666,CSE 293,034,119428,Shang; Jingbo,9999,0,9999,0
1668313628666,CSE 293,035,119430,Stefan; Deian,9999,0,9999,0
1668313628666,CSE 293,036,119431,Su; Hao,9999,0,9999,0
1668313628666,CSE 293,037,119433,Swanson; Steven James,9999,0,9999,0
1668313628666,CSE 293,038,119435,Tullsen; Dean Michael,9999,0,9999,0
1668313628666,CSE 293,039,119483,Voelker; Geoffrey M.,9999,0,9999,0
1668313628666,CSE 293,040,119537,Zhao; Jishen,9999,0,9999,0
1668313628666,CSE 293,041,119538,Zhou; Yuan-Yuan,9999,0,9999,0
1668313628666,CSE 293,042,119539,Gao; Sicun,9999,0,9999,0
1668313628666,CSE 293,043,119540,Weibel; Nadir,9999,0,9999,0
1668313628666,CSE 293,044,119541,Gupta; Rajesh K.,9999,0,9999,0
1668313628666,CSE 293,045,126410,Vaccaro; Kristen Marie,9999,0,9999,0
1668313628666,CSE 293,046,126411,Klemke; Richard,9999,0,9999,0
1668313629091,CSE 294,A00,102459,Voelker; Geoffrey M.,0,0,0,0
1668313629091,CSE 294,B00,111322,Orailoglu; Alex,0,0,0,0
1668313629512,DSE 201,A00,096914,Deutsch; Alin Bernard,30,0,30,0
1668313629938,DSE 210,A00,096915,Dasgupta; Sanjoy,30,0,30,0
1668313630364,DSE 260A,A00,096916,Altintas De Callaf; Ilkay,30,0,30,0
1668313630788,ECE 200,001,103586,Antipa; Nicholas A,9999,0,9999,0
1668313630788,ECE 200,002,103587,Atanasov; Nikolay A.,9999,0,9999,0
1668313630788,ECE 200,003,103588,Bharadia; Dinesh,9999,0,9999,0
1668313630788,ECE 200,004,103589,Cheng; Chung Kuan,9999,0,9999,0
1668313630788,ECE 200,005,103590,Cosman; Pamela C.,9999,0,9999,0
1668313630788,ECE 200,006,103591,Dayeh; Shadi Ahmad,9999,0,9999,0
1668313630788,ECE 200,007,103592,Fainman; Yeshaiahu,9999,0,9999,0
1668313630788,ECE 200,008,103593,Ford; Joseph Earl,9999,0,9999,0
1668313630788,ECE 200,009,103594,Franceschetti; Massimo,9999,0,9999,0
1668313630788,ECE 200,010,103595,Fullerton; Eric E,9999,0,9999,0
1668313630788,ECE 200,011,103596,Galton; Ian A,9999,0,9999,0
1668313630788,ECE 200,012,103597,Gilja; Vikash,9999,0,9999,0
1668313630788,ECE 200,013,103598,Hall; Drew A.,9999,0,9999,0
1668313630788,ECE 200,014,103599,Hsueh; Tzu-Chien,9999,0,9999,0
1668313630788,ECE 200,015,103600,Javidi; Tara,9999,0,9999,0
1668313630788,ECE 200,016,103601,Kahng; Andrew Byun,9999,0,9999,0
1668313630788,ECE 200,017,103602,Kim; Young-Han,9999,0,9999,0
1668313630788,ECE 200,018,103603,Koushanfar; Farinaz,9999,0,9999,0
1668313630788,ECE 200,019,103604,Kuzum; Duygu,9999,0,9999,0
1668313630788,ECE 200,020,103605,Le; Hanh-Phuc,9999,0,9999,0
1668313630788,ECE 200,021,103606,Lin; Bill,9999,0,9999,0
1668313630788,ECE 200,022,103607,Liu; Zhaowei,9998,0,9999,1
1668313630788,ECE 200,023,103608,Lo; Yu-Hwa,9999,0,9999,0
1668313630788,ECE 200,024,103609,Lomakin; Vitaliy,9999,0,9999,0
1668313630788,ECE 200,025,103610,Mercier; Patrick Philip,9999,0,9999,0
1668313630788,ECE 200,026,103611,Meyer; Florian,9999,0,9999,0
1668313630788,ECE 200,027,103612,Milstein; Laurence B.,9999,0,9999,0
1668313630788,ECE 200,028,103613,Mir Arabbaygi; Siavash,9999,0,9999,0
1668313630788,ECE 200,029,103614,Mookherjea; Shayan,9999,0,9999,0
1668313630788,ECE 200,030,103615,Morris; Karcher William,9999,0,9999,0
1668313630788,ECE 200,031,103616,Ng; Tse Nga,9999,0,9999,0
1668313630788,ECE 200,032,103617,Nguyen; Truong Quang,9999,0,9999,0
1668313630788,ECE 200,033,103618,Nomura; Kenji,9999,0,9999,0
1668313630788,ECE 200,034,103619,Orlitsky; Alon,9999,0,9999,0
1668313630788,ECE 200,035,103620,Pal; Piya,9999,0,9999,0
1668313630788,ECE 200,036,103621,Papen; George C.,9999,0,9999,0
1668313630788,ECE 200,037,103622,Radic; Stojan,9999,0,9999,0
1668313630788,ECE 200,038,103623,Rao; Bhaskar D.,9999,0,9999,0
1668313630788,ECE 200,039,103624,Rao; Ramesh R,9999,0,9999,0
1668313630788,ECE 200,040,103625,Rebeiz; Gabriel,9999,0,9999,0
1668313630788,ECE 200,041,103626,Sanford; John R,9999,0,9999,0
1668313630788,ECE 200,042,103627,Siegel; Paul H.,9999,0,9999,0
1668313630788,ECE 200,043,103628,Sievenpiper; Daniel F.,9999,0,9999,0
1668313630788,ECE 200,044,103629,Sworder; David D.,9999,0,9999,0
1668313630788,ECE 200,045,103630,Taur; Yuan,9999,0,9999,0
1668313630788,ECE 200,046,103631,Touri; Behrouz,9999,0,9999,0
1668313630788,ECE 200,047,103632,Trivedi; Mohan M.,9999,0,9999,0
1668313630788,ECE 200,048,103633,Vasconcelos; Nuno,9999,0,9999,0
1668313630788,ECE 200,049,103634,Wang; Xiaolong,9999,0,9999,0
1668313630788,ECE 200,050,103635,Xie; Pengtao,9999,0,9999,0
1668313630788,ECE 200,051,103636,Yip; Michael,9999,0,9999,0
1668313630788,ECE 200,052,103637,Zeger; Kenneth A.,999,0,999,0
1668313630788,ECE 200,053,103638,Zhang; Xinyu,9999,0,9999,0
1668313630788,ECE 200,054,103639,Turakhia; Yatish Girish,9999,0,9999,0
1668313630788,ECE 200,055,103640,Kang; Mingu,9999,0,9999,0
1668313630788,ECE 200,056,103641,Shi; Yuanyuan,9999,0,9999,0
1668313630788,ECE 200,057,103642,Wang; Edward Jay,9999,0,9999,0
1668313630788,ECE 200,058,103643,Zheng; Yang,9999,0,9999,0
1668313631212,ECE 202,A00,103644,Kuzum; Duygu,0,0,0,0
1668313631636,ECE 212BN,A00,103646,Ng; Tse Nga,0,0,0,0
1668313632060,ECE 221,A00,111493,Staff,0,0,0,0
1668313632484,ECE 222B,A00,103647,Lomakin; Vitaliy,0,0,0,0
1668313632921,ECE 230B,A00,103648,Taur; Yuan,0,0,0,0
1668313633344,ECE 238B,A00,103649,Garay; Javier,0,0,0,0
1668313633769,ECE 240B,A00,112900,Fainman; Yeshaiahu,0,0,0,0
1668313634192,ECE 247A,A00,103650,Jokerst; Jesse Vincent,0,0,0,0
1668313634614,ECE 247B,A00,103651,Wang; Joseph,0,0,0,0
1668313635037,ECE 250,A00,103652,Siegel; Paul H.,0,0,0,0
1668313635458,ECE 251A,A00,103654,Rao; Bhaskar D.,0,0,0,0
1668313635879,ECE 257B,A00,103655,Bharadia; Dinesh,0,0,0,0
1668313636303,ECE 258A,A00,103656,Milstein; Laurence B.,0,0,0,0
1668313636735,ECE 260B,A00,103658,Kang; Mingu,0,0,0,0
1668313637159,ECE 264A,A00,103659,Galton; Ian A,0,0,0,0
1668313637581,ECE 265A,A00,103661,Gudem; Prasad S.S.,0,0,0,0
1668313638009,ECE 265D,A00,103662,Gudem; Prasad S.S.,0,0,0,0
1668313638432,ECE 268,A00,103663,Koushanfar; Farinaz,0,0,0,0
1668313638860,ECE 269,A01,103665,Pal; Piya,0,0,0,0
1668313639298,ECE 271B,A00,103666,Vasconcelos; Manuela,0,0,0,0
1668313639721,ECE 276A,A00,103667,Atanasov; Nikolay A.,0,0,0,0
1668313640145,ECE 277,A00,103668,An; Cheolhong,0,0,0,0
1668313640567,ECE 279,A00,117947,Hall; Drew A.,0,0,0,0
1668313641426,ECE 283,A00,103670,Hsueh; Tzu-Chien,0,0,0,0
1668313641850,ECE 284,A00,103671,Turakhia; Yatish Girish,0,0,0,0
1668313642277,ECE 285,A00,103672,Zheng; Yang,0,0,0,0
1668313642277,ECE 285,B00,103673,Sworder; David D.,0,0,0,0
1668313642700,ECE 287,A00,103676,Javidi; Tara,0,0,0,0
1668313643124,MATH 200B,A00,098023,Salehi Golsefidy; Alireza,12,0,15,3
1668313643552,MATH 202B,A00,098024,Rhoades; Brendon Patrick,9,0,15,6
1668313643979,MATH 203B,A00,098025,Oprea; Dragos N.,10,0,15,5
1668313644406,MATH 204B,A00,098026,Sorensen; Claus M,13,0,15,2
1668313644832,MATH 208,A00,098027,Izadi; Elham,7,0,10,3
1668313645254,MATH 209,A00,098028,Pollack; Aaron,10,0,10,0
1668313645682,MATH 211A,A00,112919,Rogalski; Daniel,9,0,10,1
1668313646105,MATH 211B,A00,112920,Seward; Brandon M.,9,0,10,1
1668313646530,MATH 218,A00,098029,Li; Bo,10,0,10,0
1668313646953,MATH 220B,A00,098030,Novak; Jonathan I,11,0,15,4
1668313647381,MATH 221A,A00,098031,Ebenfelt; Peter F,13,0,15,2
1668313647812,MATH 231B,A00,098032,Zlatos; Andrej,12,0,15,3
1668313648243,MATH 240B,A00,098033,Ni; Lei,9,0,15,6
1668313648669,MATH 243,A00,098034,Jekel; David Andrew,10,0,10,0
1668313649093,MATH 245A,A00,098035,Nie; Jiawang,0,0,15,16
1668313649533,MATH 248,A00,098036,Bejenaru; Ioan,10,0,10,0
1668313649956,MATH 250B,A00,098037,Spolaor; Luca,14,0,15,1
1668313650382,MATH 258,A00,098038,Ni; Lei,10,0,10,0
1668313650807,MATH 264B,A00,098041,Rhoades; Brendon Patrick,9,0,15,6
1668313651233,MATH 268,A00,098042,Buss; Samuel R,10,0,10,0
1668313651657,MATH 269,A00,098043,Rhoades; Brendon Patrick,10,0,10,0
1668313652081,MATH 270B,A00,098044,Li; Bo,10,0,15,5
1668313652506,MATH 272B,A00,098045,Holst; Michael J,13,0,15,2
1668313652930,MATH 273A,A00,098046,Tian; Xiaochuan,10,0,15,5
1668313653353,MATH 275,A01,098048,Tian; Xiaochuan,6,0,10,4
1668313653775,MATH 278A,A00,098049,Holst; Michael J,8,0,10,2
1668313654200,MATH 278B,A00,098050,Cloninger; Alexander,10,0,10,0
1668313654627,MATH 278C,A00,098051,Nie; Jiawang,7,0,10,3
1668313655051,MATH 280B,A00,098052,Zheng; Tianyi,8,0,15,7
1668313655475,MATH 281B,A00,098053,Bradic; Jelena,1,0,15,14
1668313655901,MATH 282B,A00,098054,Arias-Castro; Ery,0,0,15,15
1668313656334,MATH 285,A00,098055,Fitzsimmons; Patrick J,0,0,15,17
1668313656759,MATH 287B,A00,098056,Arias-Castro; Ery,2,0,15,13
1668313657187,MATH 288,A00,098057,Agarwal; Pooja,9,0,10,1
1668313657187,MATH 288,B00,098058,Zhang; Danna,8,0,10,2
1668313657187,MATH 288,C00,098059,Williams; Ruth J,9,0,10,1
1668313657615,MATH 290B,A00,098060,Roberts; Justin Deritter,13,0,15,2
1668313658038,MATH 292,A00,098061,Belmont; Eva Kinoshita,10,0,10,0
1668313658461,MATH 295,A00,098062,Suk; Andrew Hoon,48,0,50,2
1668313658885,MATH 296,A00,098063,Novak; Jonathan I,20,0,20,0
1668313659308,MATH 297,001,098064,Gamst; Anthony Collins,9997,0,9999,2
1668314157955,COGS 205,A00,101395,Chiba; Andrea,19,0,20,1
1668314158383,COGS 210B,001,101404,Greene; Deanna Jacquelyn,9998,0,9999,1
1668314158383,COGS 210B,002,101417,Xia; Haijun,9999,0,9999,0
1668314158383,COGS 210B,003,101422,Nitz; Douglas A.,9999,0,9999,0
1668314158383,COGS 210B,004,101423,Hollan; James D.,9998,0,9999,1
1668314158383,COGS 210B,005,101424,Deak; Gedeon O.,9998,0,9999,1
1668314158383,COGS 210B,006,101425,Rossano; Federico,9999,0,9999,0
1668314158807,COGS 211B,A00,101427,Coulson; Seana M,9996,0,9999,3
1668314159234,COGS 220,A00,101428,Hollan; James D.,0,0,25,25
1668314159657,COGS 229,A00,101429,Dow; Steven P,18,0,25,7
1668314160079,COGS 230,A00,101430,Klemmer; Scott R,12,0,17,5
1668314160502,COGS 234,A00,101431,Xia; Haijun,1,0,25,24
1668314160926,COGS 260,A00,101432,Kiyonaga; Anastasia,21,0,25,4
1668314160926,COGS 260,B00,101433,Kirsh; David Joel,15,0,25,10
1668314161348,CSE 202,A00,102371,Impagliazzo; Russell,0,0,0,0
1668314161774,CSE 203B,A01,102373,Cheng; Chung Kuan,0,0,0,0
1668314162196,CSE 208,A00,102374,Micciancio; Daniele,0,0,0,0
1668314162626,CSE 209A,A00,112895,Impagliazzo; Russell,0,0,15,15
1668314163049,CSE 209B,A00,108005,Bellare; Mihir,0,0,0,0
1668314163478,CSE 210,A00,113163,Coblenz; Michael J,0,0,0,0
1668314163899,CSE 219,A00,106111,Dow; Steven P,0,0,20,20
1668314164323,CSE 221,A00,102376,Voelker; Geoffrey M.,0,0,0,0
1668314164750,CSE 224,A01,102378,Porter; George M,0,0,0,0
1668314165173,CSE 229A,A00,102379,Savage; Stefan,0,0,0,0
1668314165596,CSE 229C,A00,102380,Munyaka; Imani N. S.,0,0,0,0
1668314166019,CSE 232B,A00,102382,Deutsch; Alin Bernard,0,0,0,0
1668314166442,CSE 234,A01,112904,Kumar; Arun Kumar,0,0,0,0
1668314166866,CSE 237A,A00,102383,Rosing; Tajana Simunic,0,0,0,0
1668314167289,CSE 239A,A00,102384,Deutsch; Alin Bernard,0,0,0,0
1668314167720,CSE 239B,A00,102385,Polikarpova; Nadezhda,0,0,0,0
1668314168145,CSE 240A,A00,102386,Pannuto; Patrick William,0,0,0,0
1668314168570,CSE 240B,A00,102387,Zhao; Jishen,0,0,0,0
1668314169003,CSE 241A,A00,106406,Kang; Mingu,0,0,0,0
1668314169426,CSE 249B,A00,102388,Kahng; Andrew Byun,0,0,8,8
1668314169847,CSE 251B,A01,102392,Cottrell; Garrison W,0,0,0,0
1668314169847,CSE 251B,A02,102393,Cottrell; Garrison W,0,0,0,0
1668314170275,CSE 252B,A00,102394,Ochoa; Benjamin Lawrence,0,0,0,0
1668314170716,CSE 257,A01,102396,Gao; Sicun,0,0,0,0
1668314171139,CSE 272,A00,102397,Li; Tzumao,0,0,0,0
1668314171565,CSE 274,A00,111323,Chern; Albert Ren-Haur,0,0,0,0
1668314171988,CSE 282,A00,102398,Pevzner; Pavel Arkadjevich,0,0,0,0
1668314172413,CSE 284,A00,114175,Gymrek; Melissa Ann,0,0,0,0
1668314172838,CSE 290,A00,102399,Chandraker; Manmohan Krishna,0,0,0,0
1668314172838,CSE 290,B00,102400,Vaccaro; Kristen Marie,0,0,25,25
1668314172838,CSE 290,C00,102414,Pannuto; Patrick William,0,0,25,25
1668314172838,CSE 290,D00,102427,Pevzner; Pavel Arkadjevich,0,0,0,0
1668314172838,CSE 290,E00,102429,Zhao; Jishen,0,0,0,0
1668314172838,CSE 290,F00,102436,Tullsen; Dean Michael,0,0,0,0
1668314172838,CSE 290,G00,102440,Christensen; Henrik I,0,0,20,20
1668314173260,CSE 291,A00,102443,Su; Hao,0,0,0,0
1668314173260,CSE 291,B00,102448,Polikarpova; Nadezhda,0,0,0,0
1668314173260,CSE 291,C00,102453,Vaccaro; Kristen Marie,0,0,0,0
1668314173260,CSE 291,D00,111343,Savage; Stefan,0,0,0,0
1668314173260,CSE 291,E00,116474,Claffy; Kimberly Claire,0,0,0,0
1668314173260,CSE 291,F00,116479,Pasquale; Joseph,0,0,0,0
1668314173687,CSE 293,001,119111,Bafna; Vineet,9999,0,9999,0
1668314173687,CSE 293,002,119118,Bellare; Mihir,9999,0,9999,0
1668314173687,CSE 293,003,119122,Berg-Kirkpatrick; Taylor D,9999,0,9999,0
1668314173687,CSE 293,004,119135,Christensen; Henrik I,9999,0,9999,0
1668314173687,CSE 293,005,119142,Cottrell; Garrison W,9999,0,9999,0
1668314173687,CSE 293,006,119146,Deutsch; Alin Bernard,9999,0,9999,0
1668314173687,CSE 293,007,119159,Esmaeilzadeh; Hadi,9999,0,9999,0
1668314173687,CSE 293,008,119166,Freund; Yoav,9999,0,9999,0
1668314173687,CSE 293,009,119170,Griswold; William G.,9999,0,9999,0
1668314173687,CSE 293,010,119183,Gymrek; Melissa Ann,9999,0,9999,0
1668314173687,CSE 293,011,119190,Heninger; Nadia A,9999,0,9999,0
1668314173687,CSE 293,012,119230,Impagliazzo; Russell,9999,0,9999,0
1668314173687,CSE 293,013,119232,Jhala; Ranjit,9999,0,9999,0
1668314173687,CSE 293,014,119233,Kahng; Andrew Byun,9999,0,9999,0
1668314173687,CSE 293,015,119298,Kane; Daniel Mertz,9999,0,9999,0
1668314173687,CSE 293,016,119299,Kriegman; David J,9999,0,9999,0
1668314173687,CSE 293,017,119300,Kumar; Arun Kumar,9999,0,9999,0
1668314173687,CSE 293,018,119301,Lerner; Sorin,9999,0,9999,0
1668314173687,CSE 293,019,119302,Lovett; Shachar,9999,0,9999,0
1668314173687,CSE 293,020,119303,McAuley; Julian John,9999,0,9999,0
1668314173687,CSE 293,021,119304,Micciancio; Daniele,9999,0,9999,0
1668314173687,CSE 293,022,119367,Orailoglu; Alex,9999,0,9999,0
1668314173687,CSE 293,023,119382,Paturi; Ramamohan,9999,0,9999,0
1668314173687,CSE 293,024,119404,Polikarpova; Nadezhda,9999,0,9999,0
1668314173687,CSE 293,025,119406,Politz; Joseph Gibbs,9999,0,9999,0
1668314173687,CSE 293,026,119411,Porter; George M,9999,0,9999,0
1668314173687,CSE 293,027,119414,Porter; Leonard Emerson,9999,0,9999,0
1668314173687,CSE 293,028,119416,Ramamoorthi; Ravi,9999,0,9999,0
1668314173687,CSE 293,029,119417,Sahoo; Debashis,9999,0,9999,0
1668314173687,CSE 293,030,119420,Saul; Lawrence,9999,0,9999,0
1668314173687,CSE 293,031,119421,Savage; Stefan,9999,0,9999,0
1668314173687,CSE 293,032,119425,Schulze; Jurgen P.,9999,0,9999,0
1668314173687,CSE 293,033,119426,Snoeren; Alex C.,9999,0,9999,0
1668314173687,CSE 293,034,119428,Shang; Jingbo,9999,0,9999,0
1668314173687,CSE 293,035,119430,Stefan; Deian,9999,0,9999,0
1668314173687,CSE 293,036,119431,Su; Hao,9999,0,9999,0
1668314173687,CSE 293,037,119433,Swanson; Steven James,9999,0,9999,0
1668314173687,CSE 293,038,119435,Tullsen; Dean Michael,9999,0,9999,0
1668314173687,CSE 293,039,119483,Voelker; Geoffrey M.,9999,0,9999,0
1668314173687,CSE 293,040,119537,Zhao; Jishen,9999,0,9999,0
1668314173687,CSE 293,041,119538,Zhou; Yuan-Yuan,9999,0,9999,0
1668314173687,CSE 293,042,119539,Gao; Sicun,9999,0,9999,0
1668314173687,CSE 293,043,119540,Weibel; Nadir,9999,0,9999,0
1668314173687,CSE 293,044,119541,Gupta; Rajesh K.,9999,0,9999,0
1668314173687,CSE 293,045,126410,Vaccaro; Kristen Marie,9999,0,9999,0
1668314173687,CSE 293,046,126411,Klemke; Richard,9999,0,9999,0
1668314174110,CSE 294,A00,102459,Voelker; Geoffrey M.,0,0,0,0
1668314174110,CSE 294,B00,111322,Orailoglu; Alex,0,0,0,0
1668314174533,DSE 201,A00,096914,Deutsch; Alin Bernard,30,0,30,0
1668314174957,DSE 210,A00,096915,Dasgupta; Sanjoy,30,0,30,0
1668314175381,DSE 260A,A00,096916,Altintas De Callaf; Ilkay,30,0,30,0
1668314175818,ECE 200,001,103586,Antipa; Nicholas A,9999,0,9999,0
1668314175818,ECE 200,002,103587,Atanasov; Nikolay A.,9999,0,9999,0
1668314175818,ECE 200,003,103588,Bharadia; Dinesh,9999,0,9999,0
1668314175818,ECE 200,004,103589,Cheng; Chung Kuan,9999,0,9999,0
1668314175818,ECE 200,005,103590,Cosman; Pamela C.,9999,0,9999,0
1668314175818,ECE 200,006,103591,Dayeh; Shadi Ahmad,9999,0,9999,0
1668314175818,ECE 200,007,103592,Fainman; Yeshaiahu,9999,0,9999,0
1668314175818,ECE 200,008,103593,Ford; Joseph Earl,9999,0,9999,0
1668314175818,ECE 200,009,103594,Franceschetti; Massimo,9999,0,9999,0
1668314175818,ECE 200,010,103595,Fullerton; Eric E,9999,0,9999,0
1668314175818,ECE 200,011,103596,Galton; Ian A,9999,0,9999,0
1668314175818,ECE 200,012,103597,Gilja; Vikash,9999,0,9999,0
1668314175818,ECE 200,013,103598,Hall; Drew A.,9999,0,9999,0
1668314175818,ECE 200,014,103599,Hsueh; Tzu-Chien,9999,0,9999,0
1668314175818,ECE 200,015,103600,Javidi; Tara,9999,0,9999,0
1668314175818,ECE 200,016,103601,Kahng; Andrew Byun,9999,0,9999,0
1668314175818,ECE 200,017,103602,Kim; Young-Han,9999,0,9999,0
1668314175818,ECE 200,018,103603,Koushanfar; Farinaz,9999,0,9999,0
1668314175818,ECE 200,019,103604,Kuzum; Duygu,9999,0,9999,0
1668314175818,ECE 200,020,103605,Le; Hanh-Phuc,9999,0,9999,0
1668314175818,ECE 200,021,103606,Lin; Bill,9999,0,9999,0
1668314175818,ECE 200,022,103607,Liu; Zhaowei,9998,0,9999,1
1668314175818,ECE 200,023,103608,Lo; Yu-Hwa,9999,0,9999,0
1668314175818,ECE 200,024,103609,Lomakin; Vitaliy,9999,0,9999,0
1668314175818,ECE 200,025,103610,Mercier; Patrick Philip,9999,0,9999,0
1668314175818,ECE 200,026,103611,Meyer; Florian,9999,0,9999,0
1668314175818,ECE 200,027,103612,Milstein; Laurence B.,9999,0,9999,0
1668314175818,ECE 200,028,103613,Mir Arabbaygi; Siavash,9999,0,9999,0
1668314175818,ECE 200,029,103614,Mookherjea; Shayan,9999,0,9999,0
1668314175818,ECE 200,030,103615,Morris; Karcher William,9999,0,9999,0
1668314175818,ECE 200,031,103616,Ng; Tse Nga,9999,0,9999,0
1668314175818,ECE 200,032,103617,Nguyen; Truong Quang,9999,0,9999,0
1668314175818,ECE 200,033,103618,Nomura; Kenji,9999,0,9999,0
1668314175818,ECE 200,034,103619,Orlitsky; Alon,9999,0,9999,0
1668314175818,ECE 200,035,103620,Pal; Piya,9999,0,9999,0
1668314175818,ECE 200,036,103621,Papen; George C.,9999,0,9999,0
1668314175818,ECE 200,037,103622,Radic; Stojan,9999,0,9999,0
1668314175818,ECE 200,038,103623,Rao; Bhaskar D.,9999,0,9999,0
1668314175818,ECE 200,039,103624,Rao; Ramesh R,9999,0,9999,0
1668314175818,ECE 200,040,103625,Rebeiz; Gabriel,9999,0,9999,0
1668314175818,ECE 200,041,103626,Sanford; John R,9999,0,9999,0
1668314175818,ECE 200,042,103627,Siegel; Paul H.,9999,0,9999,0
1668314175818,ECE 200,043,103628,Sievenpiper; Daniel F.,9999,0,9999,0
1668314175818,ECE 200,044,103629,Sworder; David D.,9999,0,9999,0
1668314175818,ECE 200,045,103630,Taur; Yuan,9999,0,9999,0
1668314175818,ECE 200,046,103631,Touri; Behrouz,9999,0,9999,0
1668314175818,ECE 200,047,103632,Trivedi; Mohan M.,9999,0,9999,0
1668314175818,ECE 200,048,103633,Vasconcelos; Nuno,9999,0,9999,0
1668314175818,ECE 200,049,103634,Wang; Xiaolong,9999,0,9999,0
1668314175818,ECE 200,050,103635,Xie; Pengtao,9999,0,9999,0
1668314175818,ECE 200,051,103636,Yip; Michael,9999,0,9999,0
1668314175818,ECE 200,052,103637,Zeger; Kenneth A.,999,0,999,0
1668314175818,ECE 200,053,103638,Zhang; Xinyu,9999,0,9999,0
1668314175818,ECE 200,054,103639,Turakhia; Yatish Girish,9999,0,9999,0
1668314175818,ECE 200,055,103640,Kang; Mingu,9999,0,9999,0
1668314175818,ECE 200,056,103641,Shi; Yuanyuan,9999,0,9999,0
1668314175818,ECE 200,057,103642,Wang; Edward Jay,9999,0,9999,0
1668314175818,ECE 200,058,103643,Zheng; Yang,9999,0,9999,0
1668314176245,ECE 202,A00,103644,Kuzum; Duygu,0,0,0,0
1668314176670,ECE 212BN,A00,103646,Ng; Tse Nga,0,0,0,0
1668314177093,ECE 221,A00,111493,Staff,0,0,0,0
1668314177522,ECE 222B,A00,103647,Lomakin; Vitaliy,0,0,0,0
1668314177946,ECE 230B,A00,103648,Taur; Yuan,0,0,0,0
1668314178459,ECE 238B,A00,103649,Garay; Javier,0,0,0,0
1668314178882,ECE 240B,A00,112900,Fainman; Yeshaiahu,0,0,0,0
1668314179308,ECE 247A,A00,103650,Jokerst; Jesse Vincent,0,0,0,0
1668314179738,ECE 247B,A00,103651,Wang; Joseph,0,0,0,0
1668314180161,ECE 250,A00,103652,Siegel; Paul H.,0,0,0,0
1668314180589,ECE 251A,A00,103654,Rao; Bhaskar D.,0,0,0,0
1668314181015,ECE 257B,A00,103655,Bharadia; Dinesh,0,0,0,0
1668314181442,ECE 258A,A00,103656,Milstein; Laurence B.,0,0,0,0
1668314181866,ECE 260B,A00,103658,Kang; Mingu,0,0,0,0
1668314182295,ECE 264A,A00,103659,Galton; Ian A,0,0,0,0
1668314182720,ECE 265A,A00,103661,Gudem; Prasad S.S.,0,0,0,0
1668314183149,ECE 265D,A00,103662,Gudem; Prasad S.S.,0,0,0,0
1668314183571,ECE 268,A00,103663,Koushanfar; Farinaz,0,0,0,0
1668314183999,ECE 269,A01,103665,Pal; Piya,0,0,0,0
1668314184421,ECE 271B,A00,103666,Vasconcelos; Manuela,0,0,0,0
1668314184843,ECE 276A,A00,103667,Atanasov; Nikolay A.,0,0,0,0
1668314185271,ECE 277,A00,103668,An; Cheolhong,0,0,0,0
1668314185693,ECE 279,A00,117947,Hall; Drew A.,0,0,0,0
1668314186545,ECE 283,A00,103670,Hsueh; Tzu-Chien,0,0,0,0
1668314186978,ECE 284,A00,103671,Turakhia; Yatish Girish,0,0,0,0
1668314187404,ECE 285,A00,103672,Zheng; Yang,0,0,0,0
1668314187404,ECE 285,B00,103673,Sworder; David D.,0,0,0,0
1668314187826,ECE 287,A00,103676,Javidi; Tara,0,0,0,0
1668314188251,MATH 200B,A00,098023,Salehi Golsefidy; Alireza,12,0,15,3
1668314188677,MATH 202B,A00,098024,Rhoades; Brendon Patrick,9,0,15,6
1668314189102,MATH 203B,A00,098025,Oprea; Dragos N.,10,0,15,5
1668314189524,MATH 204B,A00,098026,Sorensen; Claus M,13,0,15,2
1668314189945,MATH 208,A00,098027,Izadi; Elham,7,0,10,3
1668314190372,MATH 209,A00,098028,Pollack; Aaron,10,0,10,0
1668314190796,MATH 211A,A00,112919,Rogalski; Daniel,9,0,10,1
1668314191222,MATH 211B,A00,112920,Seward; Brandon M.,9,0,10,1
1668314191652,MATH 218,A00,098029,Li; Bo,10,0,10,0
1668314192081,MATH 220B,A00,098030,Novak; Jonathan I,11,0,15,4
1668314192509,MATH 221A,A00,098031,Ebenfelt; Peter F,13,0,15,2
1668314192933,MATH 231B,A00,098032,Zlatos; Andrej,12,0,15,3
1668314193357,MATH 240B,A00,098033,Ni; Lei,9,0,15,6
1668314193779,MATH 243,A00,098034,Jekel; David Andrew,10,0,10,0
1668314194206,MATH 245A,A00,098035,Nie; Jiawang,0,0,15,16
1668314194634,MATH 248,A00,098036,Bejenaru; Ioan,10,0,10,0
1668314195058,MATH 250B,A00,098037,Spolaor; Luca,14,0,15,1
1668314195482,MATH 258,A00,098038,Ni; Lei,10,0,10,0
1668314195914,MATH 264B,A00,098041,Rhoades; Brendon Patrick,9,0,15,6
1668314196337,MATH 268,A00,098042,Buss; Samuel R,10,0,10,0
1668314196766,MATH 269,A00,098043,Rhoades; Brendon Patrick,10,0,10,0
1668314197197,MATH 270B,A00,098044,Li; Bo,10,0,15,5
1668314197621,MATH 272B,A00,098045,Holst; Michael J,13,0,15,2
1668314198048,MATH 273A,A00,098046,Tian; Xiaochuan,10,0,15,5
1668314198474,MATH 275,A01,098048,Tian; Xiaochuan,6,0,10,4
1668314198902,MATH 278A,A00,098049,Holst; Michael J,8,0,10,2
1668314199325,MATH 278B,A00,098050,Cloninger; Alexander,10,0,10,0
1668314199747,MATH 278C,A00,098051,Nie; Jiawang,7,0,10,3
1668314200170,MATH 280B,A00,098052,Zheng; Tianyi,8,0,15,7
1668314200594,MATH 281B,A00,098053,Bradic; Jelena,1,0,15,14
1668314201019,MATH 282B,A00,098054,Arias-Castro; Ery,0,0,15,15
1668314201446,MATH 285,A00,098055,Fitzsimmons; Patrick J,0,0,15,17
1668314201871,MATH 287B,A00,098056,Arias-Castro; Ery,2,0,15,13
1668314202296,MATH 288,A00,098057,Agarwal; Pooja,9,0,10,1
1668314202296,MATH 288,B00,098058,Zhang; Danna,8,0,10,2
1668314202296,MATH 288,C00,098059,Williams; Ruth J,9,0,10,1
1668314202719,MATH 290B,A00,098060,Roberts; Justin Deritter,13,0,15,2
1668314203143,MATH 292,A00,098061,Belmont; Eva Kinoshita,10,0,10,0
1668314203568,MATH 295,A00,098062,Suk; Andrew Hoon,48,0,50,2
1668314203990,MATH 296,A00,098063,Novak; Jonathan I,20,0,20,0
1668314204415,MATH 297,001,098064,Gamst; Anthony Collins,9997,0,9999,2
1668314702952,COGS 205,A00,101395,Chiba; Andrea,19,0,20,1
1668314703374,COGS 210B,001,101404,Greene; Deanna Jacquelyn,9998,0,9999,1
1668314703374,COGS 210B,002,101417,Xia; Haijun,9999,0,9999,0
1668314703374,COGS 210B,003,101422,Nitz; Douglas A.,9999,0,9999,0
1668314703374,COGS 210B,004,101423,Hollan; James D.,9998,0,9999,1
1668314703374,COGS 210B,005,101424,Deak; Gedeon O.,9998,0,9999,1
1668314703374,COGS 210B,006,101425,Rossano; Federico,9999,0,9999,0
1668314703802,COGS 211B,A00,101427,Coulson; Seana M,9996,0,9999,3
1668314704223,COGS 220,A00,101428,Hollan; James D.,0,0,25,25
1668314704654,COGS 229,A00,101429,Dow; Steven P,18,0,25,7
1668314705080,COGS 230,A00,101430,Klemmer; Scott R,12,0,17,5
1668314705514,COGS 234,A00,101431,Xia; Haijun,1,0,25,24
1668314705937,COGS 260,A00,101432,Kiyonaga; Anastasia,21,0,25,4
1668314705937,COGS 260,B00,101433,Kirsh; David Joel,15,0,25,10
1668314706359,CSE 202,A00,102371,Impagliazzo; Russell,0,0,0,0
1668314706782,CSE 203B,A01,102373,Cheng; Chung Kuan,0,0,0,0
1668314707213,CSE 208,A00,102374,Micciancio; Daniele,0,0,0,0
1668314707637,CSE 209A,A00,112895,Impagliazzo; Russell,0,0,15,15
1668314708059,CSE 209B,A00,108005,Bellare; Mihir,0,0,0,0
1668314708486,CSE 210,A00,113163,Coblenz; Michael J,0,0,0,0
1668314708908,CSE 219,A00,106111,Dow; Steven P,0,0,20,20
1668314709333,CSE 221,A00,102376,Voelker; Geoffrey M.,0,0,0,0
1668314709759,CSE 224,A01,102378,Porter; George M,0,0,0,0
1668314710183,CSE 229A,A00,102379,Savage; Stefan,0,0,0,0
1668314710607,CSE 229C,A00,102380,Munyaka; Imani N. S.,0,0,0,0
1668314711031,CSE 232B,A00,102382,Deutsch; Alin Bernard,0,0,0,0
1668314711456,CSE 234,A01,112904,Kumar; Arun Kumar,0,0,0,0
1668314711878,CSE 237A,A00,102383,Rosing; Tajana Simunic,0,0,0,0
1668314712301,CSE 239A,A00,102384,Deutsch; Alin Bernard,0,0,0,0
1668314712724,CSE 239B,A00,102385,Polikarpova; Nadezhda,0,0,0,0
1668314713149,CSE 240A,A00,102386,Pannuto; Patrick William,0,0,0,0
1668314713575,CSE 240B,A00,102387,Zhao; Jishen,0,0,0,0
1668314713998,CSE 241A,A00,106406,Kang; Mingu,0,0,0,0
1668314714421,CSE 249B,A00,102388,Kahng; Andrew Byun,0,0,8,8
1668314714849,CSE 251B,A01,102392,Cottrell; Garrison W,0,0,0,0
1668314714849,CSE 251B,A02,102393,Cottrell; Garrison W,0,0,0,0
1668314715273,CSE 252B,A00,102394,Ochoa; Benjamin Lawrence,0,0,0,0
1668314715697,CSE 257,A01,102396,Gao; Sicun,0,0,0,0
1668314716123,CSE 272,A00,102397,Li; Tzumao,0,0,0,0
1668314716549,CSE 274,A00,111323,Chern; Albert Ren-Haur,0,0,0,0
1668314716972,CSE 282,A00,102398,Pevzner; Pavel Arkadjevich,0,0,0,0
1668314717404,CSE 284,A00,114175,Gymrek; Melissa Ann,0,0,0,0
1668314717829,CSE 290,A00,102399,Chandraker; Manmohan Krishna,0,0,0,0
1668314717829,CSE 290,B00,102400,Vaccaro; Kristen Marie,0,0,25,25
1668314717829,CSE 290,C00,102414,Pannuto; Patrick William,0,0,25,25
1668314717829,CSE 290,D00,102427,Pevzner; Pavel Arkadjevich,0,0,0,0
1668314717829,CSE 290,E00,102429,Zhao; Jishen,0,0,0,0
1668314717829,CSE 290,F00,102436,Tullsen; Dean Michael,0,0,0,0
1668314717829,CSE 290,G00,102440,Christensen; Henrik I,0,0,20,20
1668314718258,CSE 291,A00,102443,Su; Hao,0,0,0,0
1668314718258,CSE 291,B00,102448,Polikarpova; Nadezhda,0,0,0,0
1668314718258,CSE 291,C00,102453,Vaccaro; Kristen Marie,0,0,0,0
1668314718258,CSE 291,D00,111343,Savage; Stefan,0,0,0,0
1668314718258,CSE 291,E00,116474,Claffy; Kimberly Claire,0,0,0,0
1668314718258,CSE 291,F00,116479,Pasquale; Joseph,0,0,0,0
1668314718693,CSE 293,001,119111,Bafna; Vineet,9999,0,9999,0
1668314718693,CSE 293,002,119118,Bellare; Mihir,9999,0,9999,0
1668314718693,CSE 293,003,119122,Berg-Kirkpatrick; Taylor D,9999,0,9999,0
1668314718693,CSE 293,004,119135,Christensen; Henrik I,9999,0,9999,0
1668314718693,CSE 293,005,119142,Cottrell; Garrison W,9999,0,9999,0
1668314718693,CSE 293,006,119146,Deutsch; Alin Bernard,9999,0,9999,0
1668314718693,CSE 293,007,119159,Esmaeilzadeh; Hadi,9999,0,9999,0
1668314718693,CSE 293,008,119166,Freund; Yoav,9999,0,9999,0
1668314718693,CSE 293,009,119170,Griswold; William G.,9999,0,9999,0
1668314718693,CSE 293,010,119183,Gymrek; Melissa Ann,9999,0,9999,0
1668314718693,CSE 293,011,119190,Heninger; Nadia A,9999,0,9999,0
1668314718693,CSE 293,012,119230,Impagliazzo; Russell,9999,0,9999,0
1668314718693,CSE 293,013,119232,Jhala; Ranjit,9999,0,9999,0
1668314718693,CSE 293,014,119233,Kahng; Andrew Byun,9999,0,9999,0
1668314718693,CSE 293,015,119298,Kane; Daniel Mertz,9999,0,9999,0
1668314718693,CSE 293,016,119299,Kriegman; David J,9999,0,9999,0
1668314718693,CSE 293,017,119300,Kumar; Arun Kumar,9999,0,9999,0
1668314718693,CSE 293,018,119301,Lerner; Sorin,9999,0,9999,0
1668314718693,CSE 293,019,119302,Lovett; Shachar,9999,0,9999,0
1668314718693,CSE 293,020,119303,McAuley; Julian John,9999,0,9999,0
1668314718693,CSE 293,021,119304,Micciancio; Daniele,9999,0,9999,0
1668314718693,CSE 293,022,119367,Orailoglu; Alex,9999,0,9999,0
1668314718693,CSE 293,023,119382,Paturi; Ramamohan,9999,0,9999,0
1668314718693,CSE 293,024,119404,Polikarpova; Nadezhda,9999,0,9999,0
1668314718693,CSE 293,025,119406,Politz; Joseph Gibbs,9999,0,9999,0
1668314718693,CSE 293,026,119411,Porter; George M,9999,0,9999,0
1668314718693,CSE 293,027,119414,Porter; Leonard Emerson,9999,0,9999,0
1668314718693,CSE 293,028,119416,Ramamoorthi; Ravi,9999,0,9999,0
1668314718693,CSE 293,029,119417,Sahoo; Debashis,9999,0,9999,0
1668314718693,CSE 293,030,119420,Saul; Lawrence,9999,0,9999,0
1668314718693,CSE 293,031,119421,Savage; Stefan,9999,0,9999,0
1668314718693,CSE 293,032,119425,Schulze; Jurgen P.,9999,0,9999,0
1668314718693,CSE 293,033,119426,Snoeren; Alex C.,9999,0,9999,0
1668314718693,CSE 293,034,119428,Shang; Jingbo,9999,0,9999,0
1668314718693,CSE 293,035,119430,Stefan; Deian,9999,0,9999,0
1668314718693,CSE 293,036,119431,Su; Hao,9999,0,9999,0
1668314718693,CSE 293,037,119433,Swanson; Steven James,9999,0,9999,0
1668314718693,CSE 293,038,119435,Tullsen; Dean Michael,9999,0,9999,0
1668314718693,CSE 293,039,119483,Voelker; Geoffrey M.,9999,0,9999,0
1668314718693,CSE 293,040,119537,Zhao; Jishen,9999,0,9999,0
1668314718693,CSE 293,041,119538,Zhou; Yuan-Yuan,9999,0,9999,0
1668314718693,CSE 293,042,119539,Gao; Sicun,9999,0,9999,0
1668314718693,CSE 293,043,119540,Weibel; Nadir,9999,0,9999,0
1668314718693,CSE 293,044,119541,Gupta; Rajesh K.,9999,0,9999,0
1668314718693,CSE 293,045,126410,Vaccaro; Kristen Marie,9999,0,9999,0
1668314718693,CSE 293,046,126411,Klemke; Richard,9999,0,9999,0
1668314719118,CSE 294,A00,102459,Voelker; Geoffrey M.,0,0,0,0
1668314719118,CSE 294,B00,111322,Orailoglu; Alex,0,0,0,0
1668314719544,DSE 201,A00,096914,Deutsch; Alin Bernard,30,0,30,0
1668314719967,DSE 210,A00,096915,Dasgupta; Sanjoy,30,0,30,0
1668314720394,DSE 260A,A00,096916,Altintas De Callaf; Ilkay,30,0,30,0
1668314720822,ECE 200,001,103586,Antipa; Nicholas A,9999,0,9999,0
1668314720822,ECE 200,002,103587,Atanasov; Nikolay A.,9999,0,9999,0
1668314720822,ECE 200,003,103588,Bharadia; Dinesh,9999,0,9999,0
1668314720822,ECE 200,004,103589,Cheng; Chung Kuan,9999,0,9999,0
1668314720822,ECE 200,005,103590,Cosman; Pamela C.,9999,0,9999,0
1668314720822,ECE 200,006,103591,Dayeh; Shadi Ahmad,9999,0,9999,0
1668314720822,ECE 200,007,103592,Fainman; Yeshaiahu,9999,0,9999,0
1668314720822,ECE 200,008,103593,Ford; Joseph Earl,9999,0,9999,0
1668314720822,ECE 200,009,103594,Franceschetti; Massimo,9999,0,9999,0
1668314720822,ECE 200,010,103595,Fullerton; Eric E,9999,0,9999,0
1668314720822,ECE 200,011,103596,Galton; Ian A,9999,0,9999,0
1668314720822,ECE 200,012,103597,Gilja; Vikash,9999,0,9999,0
1668314720822,ECE 200,013,103598,Hall; Drew A.,9999,0,9999,0
1668314720822,ECE 200,014,103599,Hsueh; Tzu-Chien,9999,0,9999,0
1668314720822,ECE 200,015,103600,Javidi; Tara,9999,0,9999,0
1668314720822,ECE 200,016,103601,Kahng; Andrew Byun,9999,0,9999,0
1668314720822,ECE 200,017,103602,Kim; Young-Han,9999,0,9999,0
1668314720822,ECE 200,018,103603,Koushanfar; Farinaz,9999,0,9999,0
1668314720822,ECE 200,019,103604,Kuzum; Duygu,9999,0,9999,0
1668314720822,ECE 200,020,103605,Le; Hanh-Phuc,9999,0,9999,0
1668314720822,ECE 200,021,103606,Lin; Bill,9999,0,9999,0
1668314720822,ECE 200,022,103607,Liu; Zhaowei,9998,0,9999,1
1668314720822,ECE 200,023,103608,Lo; Yu-Hwa,9999,0,9999,0
1668314720822,ECE 200,024,103609,Lomakin; Vitaliy,9999,0,9999,0
1668314720822,ECE 200,025,103610,Mercier; Patrick Philip,9999,0,9999,0
1668314720822,ECE 200,026,103611,Meyer; Florian,9999,0,9999,0
1668314720822,ECE 200,027,103612,Milstein; Laurence B.,9999,0,9999,0
1668314720822,ECE 200,028,103613,Mir Arabbaygi; Siavash,9999,0,9999,0
1668314720822,ECE 200,029,103614,Mookherjea; Shayan,9999,0,9999,0
1668314720822,ECE 200,030,103615,Morris; Karcher William,9999,0,9999,0
1668314720822,ECE 200,031,103616,Ng; Tse Nga,9999,0,9999,0
1668314720822,ECE 200,032,103617,Nguyen; Truong Quang,9999,0,9999,0
1668314720822,ECE 200,033,103618,Nomura; Kenji,9999,0,9999,0
1668314720822,ECE 200,034,103619,Orlitsky; Alon,9999,0,9999,0
1668314720822,ECE 200,035,103620,Pal; Piya,9999,0,9999,0
1668314720822,ECE 200,036,103621,Papen; George C.,9999,0,9999,0
1668314720822,ECE 200,037,103622,Radic; Stojan,9999,0,9999,0
1668314720822,ECE 200,038,103623,Rao; Bhaskar D.,9999,0,9999,0
1668314720822,ECE 200,039,103624,Rao; Ramesh R,9999,0,9999,0
1668314720822,ECE 200,040,103625,Rebeiz; Gabriel,9999,0,9999,0
1668314720822,ECE 200,041,103626,Sanford; John R,9999,0,9999,0
1668314720822,ECE 200,042,103627,Siegel; Paul H.,9999,0,9999,0
1668314720822,ECE 200,043,103628,Sievenpiper; Daniel F.,9999,0,9999,0
1668314720822,ECE 200,044,103629,Sworder; David D.,9999,0,9999,0
1668314720822,ECE 200,045,103630,Taur; Yuan,9999,0,9999,0
1668314720822,ECE 200,046,103631,Touri; Behrouz,9999,0,9999,0
1668314720822,ECE 200,047,103632,Trivedi; Mohan M.,9999,0,9999,0
1668314720822,ECE 200,048,103633,Vasconcelos; Nuno,9999,0,9999,0
1668314720822,ECE 200,049,103634,Wang; Xiaolong,9999,0,9999,0
1668314720822,ECE 200,050,103635,Xie; Pengtao,9999,0,9999,0
1668314720822,ECE 200,051,103636,Yip; Michael,9999,0,9999,0
1668314720822,ECE 200,052,103637,Zeger; Kenneth A.,999,0,999,0
1668314720822,ECE 200,053,103638,Zhang; Xinyu,9999,0,9999,0
1668314720822,ECE 200,054,103639,Turakhia; Yatish Girish,9999,0,9999,0
1668314720822,ECE 200,055,103640,Kang; Mingu,9999,0,9999,0
1668314720822,ECE 200,056,103641,Shi; Yuanyuan,9999,0,9999,0
1668314720822,ECE 200,057,103642,Wang; Edward Jay,9999,0,9999,0
1668314720822,ECE 200,058,103643,Zheng; Yang,9999,0,9999,0
1668314721247,ECE 202,A00,103644,Kuzum; Duygu,0,0,0,0
1668314721673,ECE 212BN,A00,103646,Ng; Tse Nga,0,0,0,0
1668314722098,ECE 221,A00,111493,Staff,0,0,0,0
1668314722528,ECE 222B,A00,103647,Lomakin; Vitaliy,0,0,0,0
1668314722952,ECE 230B,A00,103648,Taur; Yuan,0,0,0,0
1668314723376,ECE 238B,A00,103649,Garay; Javier,0,0,0,0
1668314723800,ECE 240B,A00,112900,Fainman; Yeshaiahu,0,0,0,0
1668314724228,ECE 247A,A00,103650,Jokerst; Jesse Vincent,0,0,0,0
1668314724660,ECE 247B,A00,103651,Wang; Joseph,0,0,0,0
1668314725085,ECE 250,A00,103652,Siegel; Paul H.,0,0,0,0
1668314725512,ECE 251A,A00,103654,Rao; Bhaskar D.,0,0,0,0
1668314725937,ECE 257B,A00,103655,Bharadia; Dinesh,0,0,0,0
1668314726363,ECE 258A,A00,103656,Milstein; Laurence B.,0,0,0,0
1668314726788,ECE 260B,A00,103658,Kang; Mingu,0,0,0,0
1668314727214,ECE 264A,A00,103659,Galton; Ian A,0,0,0,0
1668314727641,ECE 265A,A00,103661,Gudem; Prasad S.S.,0,0,0,0
1668314728068,ECE 265D,A00,103662,Gudem; Prasad S.S.,0,0,0,0
1668314728492,ECE 268,A00,103663,Koushanfar; Farinaz,0,0,0,0
1668314728915,ECE 269,A01,103665,Pal; Piya,0,0,0,0
1668314729343,ECE 271B,A00,103666,Vasconcelos; Manuela,0,0,0,0
1668314729765,ECE 276A,A00,103667,Atanasov; Nikolay A.,0,0,0,0
1668314730189,ECE 277,A00,103668,An; Cheolhong,0,0,0,0
1668314730623,ECE 279,A00,117947,Hall; Drew A.,0,0,0,0
1668314731474,ECE 283,A00,103670,Hsueh; Tzu-Chien,0,0,0,0
1668314731899,ECE 284,A00,103671,Turakhia; Yatish Girish,0,0,0,0
1668314732322,ECE 285,A00,103672,Zheng; Yang,0,0,0,0
1668314732322,ECE 285,B00,103673,Sworder; David D.,0,0,0,0
1668314732746,ECE 287,A00,103676,Javidi; Tara,0,0,0,0
1668314733170,MATH 200B,A00,098023,Salehi Golsefidy; Alireza,12,0,15,3
1668314733596,MATH 202B,A00,098024,Rhoades; Brendon Patrick,9,0,15,6
1668314734022,MATH 203B,A00,098025,Oprea; Dragos N.,10,0,15,5
1668314734444,MATH 204B,A00,098026,Sorensen; Claus M,13,0,15,2
1668314734869,MATH 208,A00,098027,Izadi; Elham,7,0,10,3
1668314735295,MATH 209,A00,098028,Pollack; Aaron,10,0,10,0
1668314735723,MATH 211A,A00,112919,Rogalski; Daniel,9,0,10,1
1668314736147,MATH 211B,A00,112920,Seward; Brandon M.,9,0,10,1
1668314736571,MATH 218,A00,098029,Li; Bo,10,0,10,0
1668314736997,MATH 220B,A00,098030,Novak; Jonathan I,11,0,15,4
1668314737424,MATH 221A,A00,098031,Ebenfelt; Peter F,13,0,15,2
1668314737851,MATH 231B,A00,098032,Zlatos; Andrej,12,0,15,3
1668314738274,MATH 240B,A00,098033,Ni; Lei,9,0,15,6
1668314738700,MATH 243,A00,098034,Jekel; David Andrew,10,0,10,0
1668314739125,MATH 245A,A00,098035,Nie; Jiawang,0,0,15,16
1668314739565,MATH 248,A00,098036,Bejenaru; Ioan,10,0,10,0
1668314740063,MATH 250B,A00,098037,Spolaor; Luca,14,0,15,1
1668314740486,MATH 258,A00,098038,Ni; Lei,10,0,10,0
1668314740909,MATH 264B,A00,098041,Rhoades; Brendon Patrick,9,0,15,6
1668314741333,MATH 268,A00,098042,Buss; Samuel R,10,0,10,0
1668314741757,MATH 269,A00,098043,Rhoades; Brendon Patrick,10,0,10,0
1668314742180,MATH 270B,A00,098044,Li; Bo,10,0,15,5
1668314742601,MATH 272B,A00,098045,Holst; Michael J,13,0,15,2
1668314743032,MATH 273A,A00,098046,Tian; Xiaochuan,10,0,15,5
1668314743455,MATH 275,A01,098048,Tian; Xiaochuan,6,0,10,4
1668314743879,MATH 278A,A00,098049,Holst; Michael J,8,0,10,2
1668314744302,MATH 278B,A00,098050,Cloninger; Alexander,10,0,10,0
1668314744728,MATH 278C,A00,098051,Nie; Jiawang,7,0,10,3
1668314745154,MATH 280B,A00,098052,Zheng; Tianyi,8,0,15,7
1668314745577,MATH 281B,A00,098053,Bradic; Jelena,1,0,15,14
1668314745999,MATH 282B,A00,098054,Arias-Castro; Ery,0,0,15,15
1668314746424,MATH 285,A00,098055,Fitzsimmons; Patrick J,0,0,15,17
1668314746851,MATH 287B,A00,098056,Arias-Castro; Ery,2,0,15,13
1668314747273,MATH 288,A00,098057,Agarwal; Pooja,9,0,10,1
1668314747273,MATH 288,B00,098058,Zhang; Danna,8,0,10,2
1668314747273,MATH 288,C00,098059,Williams; Ruth J,9,0,10,1
1668314747696,MATH 290B,A00,098060,Roberts; Justin Deritter,13,0,15,2
1668314748122,MATH 292,A00,098061,Belmont; Eva Kinoshita,10,0,10,0
1668314748547,MATH 295,A00,098062,Suk; Andrew Hoon,48,0,50,2
1668314748971,MATH 296,A00,098063,Novak; Jonathan I,20,0,20,0
1668314749395,MATH 297,001,098064,Gamst; Anthony Collins,9997,0,9999,2
1668315247944,COGS 205,A00,101395,Chiba; Andrea,19,0,20,1
1668315248369,COGS 210B,001,101404,Greene; Deanna Jacquelyn,9998,0,9999,1
1668315248369,COGS 210B,002,101417,Xia; Haijun,9999,0,9999,0
1668315248369,COGS 210B,003,101422,Nitz; Douglas A.,9999,0,9999,0
1668315248369,COGS 210B,004,101423,Hollan; James D.,9998,0,9999,1
1668315248369,COGS 210B,005,101424,Deak; Gedeon O.,9998,0,9999,1
1668315248369,COGS 210B,006,101425,Rossano; Federico,9999,0,9999,0
1668315248802,COGS 211B,A00,101427,Coulson; Seana M,9996,0,9999,3
1668315249237,COGS 220,A00,101428,Hollan; James D.,0,0,25,25
1668315249663,COGS 229,A00,101429,Dow; Steven P,18,0,25,7
1668315250101,COGS 230,A00,101430,Klemmer; Scott R,12,0,17,5
1668315250537,COGS 234,A00,101431,Xia; Haijun,1,0,25,24
1668315250970,COGS 260,A00,101432,Kiyonaga; Anastasia,21,0,25,4
1668315250970,COGS 260,B00,101433,Kirsh; David Joel,15,0,25,10
1668315251397,CSE 202,A00,102371,Impagliazzo; Russell,0,0,0,0
1668315251823,CSE 203B,A01,102373,Cheng; Chung Kuan,0,0,0,0
1668315252247,CSE 208,A00,102374,Micciancio; Daniele,0,0,0,0
1668315252669,CSE 209A,A00,112895,Impagliazzo; Russell,0,0,15,15
1668315253096,CSE 209B,A00,108005,Bellare; Mihir,0,0,0,0
1668315253521,CSE 210,A00,113163,Coblenz; Michael J,0,0,0,0
1668315253944,CSE 219,A00,106111,Dow; Steven P,0,0,20,20
1668315254370,CSE 221,A00,102376,Voelker; Geoffrey M.,0,0,0,0
1668315254795,CSE 224,A01,102378,Porter; George M,0,0,0,0
1668315255219,CSE 229A,A00,102379,Savage; Stefan,0,0,0,0
1668315255640,CSE 229C,A00,102380,Munyaka; Imani N. S.,0,0,0,0
1668315256064,CSE 232B,A00,102382,Deutsch; Alin Bernard,0,0,0,0
1668315256488,CSE 234,A01,112904,Kumar; Arun Kumar,0,0,0,0
1668315256914,CSE 237A,A00,102383,Rosing; Tajana Simunic,0,0,0,0
1668315257339,CSE 239A,A00,102384,Deutsch; Alin Bernard,0,0,0,0
1668315257761,CSE 239B,A00,102385,Polikarpova; Nadezhda,0,0,0,0
1668315258189,CSE 240A,A00,102386,Pannuto; Patrick William,0,0,0,0
1668315258689,CSE 240B,A00,102387,Zhao; Jishen,0,0,0,0
1668315259111,CSE 241A,A00,106406,Kang; Mingu,0,0,0,0
1668315259536,CSE 249B,A00,102388,Kahng; Andrew Byun,0,0,8,8
1668315259966,CSE 251B,A01,102392,Cottrell; Garrison W,0,0,0,0
1668315259966,CSE 251B,A02,102393,Cottrell; Garrison W,0,0,0,0
1668315260396,CSE 252B,A00,102394,Ochoa; Benjamin Lawrence,0,0,0,0
1668315260821,CSE 257,A01,102396,Gao; Sicun,0,0,0,0
1668315261250,CSE 272,A00,102397,Li; Tzumao,0,0,0,0
1668315261672,CSE 274,A00,111323,Chern; Albert Ren-Haur,0,0,0,0
1668315262095,CSE 282,A00,102398,Pevzner; Pavel Arkadjevich,0,0,0,0
1668315262519,CSE 284,A00,114175,Gymrek; Melissa Ann,0,0,0,0
1668315262953,CSE 290,A00,102399,Chandraker; Manmohan Krishna,0,0,0,0
1668315262953,CSE 290,B00,102400,Vaccaro; Kristen Marie,0,0,25,25
1668315262953,CSE 290,C00,102414,Pannuto; Patrick William,0,0,25,25
1668315262953,CSE 290,D00,102427,Pevzner; Pavel Arkadjevich,0,0,0,0
1668315262953,CSE 290,E00,102429,Zhao; Jishen,0,0,0,0
1668315262953,CSE 290,F00,102436,Tullsen; Dean Michael,0,0,0,0
1668315262953,CSE 290,G00,102440,Christensen; Henrik I,0,0,20,20
1668315263377,CSE 291,A00,102443,Su; Hao,0,0,0,0
1668315263377,CSE 291,B00,102448,Polikarpova; Nadezhda,0,0,0,0
1668315263377,CSE 291,C00,102453,Vaccaro; Kristen Marie,0,0,0,0
1668315263377,CSE 291,D00,111343,Savage; Stefan,0,0,0,0
1668315263377,CSE 291,E00,116474,Claffy; Kimberly Claire,0,0,0,0
1668315263377,CSE 291,F00,116479,Pasquale; Joseph,0,0,0,0
1668315263813,CSE 293,001,119111,Bafna; Vineet,9999,0,9999,0
1668315263813,CSE 293,002,119118,Bellare; Mihir,9999,0,9999,0
1668315263813,CSE 293,003,119122,Berg-Kirkpatrick; Taylor D,9999,0,9999,0
1668315263813,CSE 293,004,119135,Christensen; Henrik I,9999,0,9999,0
1668315263813,CSE 293,005,119142,Cottrell; Garrison W,9999,0,9999,0
1668315263813,CSE 293,006,119146,Deutsch; Alin Bernard,9999,0,9999,0
1668315263813,CSE 293,007,119159,Esmaeilzadeh; Hadi,9999,0,9999,0
1668315263813,CSE 293,008,119166,Freund; Yoav,9999,0,9999,0
1668315263813,CSE 293,009,119170,Griswold; William G.,9999,0,9999,0
1668315263813,CSE 293,010,119183,Gymrek; Melissa Ann,9999,0,9999,0
1668315263813,CSE 293,011,119190,Heninger; Nadia A,9999,0,9999,0
1668315263813,CSE 293,012,119230,Impagliazzo; Russell,9999,0,9999,0
1668315263813,CSE 293,013,119232,Jhala; Ranjit,9999,0,9999,0
1668315263813,CSE 293,014,119233,Kahng; Andrew Byun,9999,0,9999,0
1668315263813,CSE 293,015,119298,Kane; Daniel Mertz,9999,0,9999,0
1668315263813,CSE 293,016,119299,Kriegman; David J,9999,0,9999,0
1668315263813,CSE 293,017,119300,Kumar; Arun Kumar,9999,0,9999,0
1668315263813,CSE 293,018,119301,Lerner; Sorin,9999,0,9999,0
1668315263813,CSE 293,019,119302,Lovett; Shachar,9999,0,9999,0
1668315263813,CSE 293,020,119303,McAuley; Julian John,9999,0,9999,0
1668315263813,CSE 293,021,119304,Micciancio; Daniele,9999,0,9999,0
1668315263813,CSE 293,022,119367,Orailoglu; Alex,9999,0,9999,0
1668315263813,CSE 293,023,119382,Paturi; Ramamohan,9999,0,9999,0
1668315263813,CSE 293,024,119404,Polikarpova; Nadezhda,9999,0,9999,0
1668315263813,CSE 293,025,119406,Politz; Joseph Gibbs,9999,0,9999,0
1668315263813,CSE 293,026,119411,Porter; George M,9999,0,9999,0
1668315263813,CSE 293,027,119414,Porter; Leonard Emerson,9999,0,9999,0
1668315263813,CSE 293,028,119416,Ramamoorthi; Ravi,9999,0,9999,0
1668315263813,CSE 293,029,119417,Sahoo; Debashis,9999,0,9999,0
1668315263813,CSE 293,030,119420,Saul; Lawrence,9999,0,9999,0
1668315263813,CSE 293,031,119421,Savage; Stefan,9999,0,9999,0
1668315263813,CSE 293,032,119425,Schulze; Jurgen P.,9999,0,9999,0
1668315263813,CSE 293,033,119426,Snoeren; Alex C.,9999,0,9999,0
1668315263813,CSE 293,034,119428,Shang; Jingbo,9999,0,9999,0
1668315263813,CSE 293,035,119430,Stefan; Deian,9999,0,9999,0
1668315263813,CSE 293,036,119431,Su; Hao,9999,0,9999,0
1668315263813,CSE 293,037,119433,Swanson; Steven James,9999,0,9999,0
1668315263813,CSE 293,038,119435,Tullsen; Dean Michael,9999,0,9999,0
1668315263813,CSE 293,039,119483,Voelker; Geoffrey M.,9999,0,9999,0
1668315263813,CSE 293,040,119537,Zhao; Jishen,9999,0,9999,0
1668315263813,CSE 293,041,119538,Zhou; Yuan-Yuan,9999,0,9999,0
1668315263813,CSE 293,042,119539,Gao; Sicun,9999,0,9999,0
1668315263813,CSE 293,043,119540,Weibel; Nadir,9999,0,9999,0
1668315263813,CSE 293,044,119541,Gupta; Rajesh K.,9999,0,9999,0
1668315263813,CSE 293,045,126410,Vaccaro; Kristen Marie,9999,0,9999,0
1668315263813,CSE 293,046,126411,Klemke; Richard,9999,0,9999,0
1668315264236,CSE 294,A00,102459,Voelker; Geoffrey M.,0,0,0,0
1668315264236,CSE 294,B00,111322,Orailoglu; Alex,0,0,0,0
1668315264658,DSE 201,A00,096914,Deutsch; Alin Bernard,30,0,30,0
1668315265085,DSE 210,A00,096915,Dasgupta; Sanjoy,30,0,30,0
1668315265509,DSE 260A,A00,096916,Altintas De Callaf; Ilkay,30,0,30,0
1668315265946,ECE 200,001,103586,Antipa; Nicholas A,9999,0,9999,0
1668315265946,ECE 200,002,103587,Atanasov; Nikolay A.,9999,0,9999,0
1668315265946,ECE 200,003,103588,Bharadia; Dinesh,9999,0,9999,0
1668315265946,ECE 200,004,103589,Cheng; Chung Kuan,9999,0,9999,0
1668315265946,ECE 200,005,103590,Cosman; Pamela C.,9999,0,9999,0
1668315265946,ECE 200,006,103591,Dayeh; Shadi Ahmad,9999,0,9999,0
1668315265946,ECE 200,007,103592,Fainman; Yeshaiahu,9999,0,9999,0
1668315265946,ECE 200,008,103593,Ford; Joseph Earl,9999,0,9999,0
1668315265946,ECE 200,009,103594,Franceschetti; Massimo,9999,0,9999,0
1668315265946,ECE 200,010,103595,Fullerton; Eric E,9999,0,9999,0
1668315265946,ECE 200,011,103596,Galton; Ian A,9999,0,9999,0
1668315265946,ECE 200,012,103597,Gilja; Vikash,9999,0,9999,0
1668315265946,ECE 200,013,103598,Hall; Drew A.,9999,0,9999,0
1668315265946,ECE 200,014,103599,Hsueh; Tzu-Chien,9999,0,9999,0
1668315265946,ECE 200,015,103600,Javidi; Tara,9999,0,9999,0
1668315265946,ECE 200,016,103601,Kahng; Andrew Byun,9999,0,9999,0
1668315265946,ECE 200,017,103602,Kim; Young-Han,9999,0,9999,0
1668315265946,ECE 200,018,103603,Koushanfar; Farinaz,9999,0,9999,0
1668315265946,ECE 200,019,103604,Kuzum; Duygu,9999,0,9999,0
1668315265946,ECE 200,020,103605,Le; Hanh-Phuc,9999,0,9999,0
1668315265946,ECE 200,021,103606,Lin; Bill,9999,0,9999,0
1668315265946,ECE 200,022,103607,Liu; Zhaowei,9998,0,9999,1
1668315265946,ECE 200,023,103608,Lo; Yu-Hwa,9999,0,9999,0
1668315265946,ECE 200,024,103609,Lomakin; Vitaliy,9999,0,9999,0
1668315265946,ECE 200,025,103610,Mercier; Patrick Philip,9999,0,9999,0
1668315265946,ECE 200,026,103611,Meyer; Florian,9999,0,9999,0
1668315265946,ECE 200,027,103612,Milstein; Laurence B.,9999,0,9999,0
1668315265946,ECE 200,028,103613,Mir Arabbaygi; Siavash,9999,0,9999,0
1668315265946,ECE 200,029,103614,Mookherjea; Shayan,9999,0,9999,0
1668315265946,ECE 200,030,103615,Morris; Karcher William,9999,0,9999,0
1668315265946,ECE 200,031,103616,Ng; Tse Nga,9999,0,9999,0
1668315265946,ECE 200,032,103617,Nguyen; Truong Quang,9999,0,9999,0
1668315265946,ECE 200,033,103618,Nomura; Kenji,9999,0,9999,0
1668315265946,ECE 200,034,103619,Orlitsky; Alon,9999,0,9999,0
1668315265946,ECE 200,035,103620,Pal; Piya,9999,0,9999,0
1668315265946,ECE 200,036,103621,Papen; George C.,9999,0,9999,0
1668315265946,ECE 200,037,103622,Radic; Stojan,9999,0,9999,0
1668315265946,ECE 200,038,103623,Rao; Bhaskar D.,9999,0,9999,0
1668315265946,ECE 200,039,103624,Rao; Ramesh R,9999,0,9999,0
1668315265946,ECE 200,040,103625,Rebeiz; Gabriel,9999,0,9999,0
1668315265946,ECE 200,041,103626,Sanford; John R,9999,0,9999,0
1668315265946,ECE 200,042,103627,Siegel; Paul H.,9999,0,9999,0
1668315265946,ECE 200,043,103628,Sievenpiper; Daniel F.,9999,0,9999,0
1668315265946,ECE 200,044,103629,Sworder; David D.,9999,0,9999,0
1668315265946,ECE 200,045,103630,Taur; Yuan,9999,0,9999,0
1668315265946,ECE 200,046,103631,Touri; Behrouz,9999,0,9999,0
1668315265946,ECE 200,047,103632,Trivedi; Mohan M.,9999,0,9999,0
1668315265946,ECE 200,048,103633,Vasconcelos; Nuno,9999,0,9999,0
1668315265946,ECE 200,049,103634,Wang; Xiaolong,9999,0,9999,0
1668315265946,ECE 200,050,103635,Xie; Pengtao,9999,0,9999,0
1668315265946,ECE 200,051,103636,Yip; Michael,9999,0,9999,0
1668315265946,ECE 200,052,103637,Zeger; Kenneth A.,999,0,999,0
1668315265946,ECE 200,053,103638,Zhang; Xinyu,9999,0,9999,0
1668315265946,ECE 200,054,103639,Turakhia; Yatish Girish,9999,0,9999,0
1668315265946,ECE 200,055,103640,Kang; Mingu,9999,0,9999,0
1668315265946,ECE 200,056,103641,Shi; Yuanyuan,9999,0,9999,0
1668315265946,ECE 200,057,103642,Wang; Edward Jay,9999,0,9999,0
1668315265946,ECE 200,058,103643,Zheng; Yang,9999,0,9999,0
1668315266375,ECE 202,A00,103644,Kuzum; Duygu,0,0,0,0
1668315266807,ECE 212BN,A00,103646,Ng; Tse Nga,0,0,0,0
1668315267231,ECE 221,A00,111493,Staff,0,0,0,0
1668315267658,ECE 222B,A00,103647,Lomakin; Vitaliy,0,0,0,0
1668315268083,ECE 230B,A00,103648,Taur; Yuan,0,0,0,0
1668315268507,ECE 238B,A00,103649,Garay; Javier,0,0,0,0
1668315268937,ECE 240B,A00,112900,Fainman; Yeshaiahu,0,0,0,0
1668315269360,ECE 247A,A00,103650,Jokerst; Jesse Vincent,0,0,0,0
1668315269783,ECE 247B,A00,103651,Wang; Joseph,0,0,0,0
1668315270214,ECE 250,A00,103652,Siegel; Paul H.,0,0,0,0
1668315270639,ECE 251A,A00,103654,Rao; Bhaskar D.,0,0,0,0
1668315271065,ECE 257B,A00,103655,Bharadia; Dinesh,0,0,0,0
1668315271489,ECE 258A,A00,103656,Milstein; Laurence B.,0,0,0,0
1668315271922,ECE 260B,A00,103658,Kang; Mingu,0,0,0,0
1668315272344,ECE 264A,A00,103659,Galton; Ian A,0,0,0,0
1668315272768,ECE 265A,A00,103661,Gudem; Prasad S.S.,0,0,0,0
1668315273189,ECE 265D,A00,103662,Gudem; Prasad S.S.,0,0,0,0
1668315273613,ECE 268,A00,103663,Koushanfar; Farinaz,0,0,0,0
1668315274036,ECE 269,A01,103665,Pal; Piya,0,0,0,0
1668315274458,ECE 271B,A00,103666,Vasconcelos; Manuela,0,0,0,0
1668315274885,ECE 276A,A00,103667,Atanasov; Nikolay A.,0,0,0,0
1668315275308,ECE 277,A00,103668,An; Cheolhong,0,0,0,0
1668315275733,ECE 279,A00,117947,Hall; Drew A.,0,0,0,0
1668315276579,ECE 283,A00,103670,Hsueh; Tzu-Chien,0,0,0,0
1668315277005,ECE 284,A00,103671,Turakhia; Yatish Girish,0,0,0,0
1668315277433,ECE 285,A00,103672,Zheng; Yang,0,0,0,0
1668315277433,ECE 285,B00,103673,Sworder; David D.,0,0,0,0
1668315277859,ECE 287,A00,103676,Javidi; Tara,0,0,0,0
1668315278283,MATH 200B,A00,098023,Salehi Golsefidy; Alireza,12,0,15,3
1668315278708,MATH 202B,A00,098024,Rhoades; Brendon Patrick,9,0,15,6
1668315279134,MATH 203B,A00,098025,Oprea; Dragos N.,10,0,15,5
1668315279557,MATH 204B,A00,098026,Sorensen; Claus M,13,0,15,2
1668315279980,MATH 208,A00,098027,Izadi; Elham,7,0,10,3
1668315280403,MATH 209,A00,098028,Pollack; Aaron,10,0,10,0
1668315280829,MATH 211A,A00,112919,Rogalski; Daniel,9,0,10,1
1668315281254,MATH 211B,A00,112920,Seward; Brandon M.,9,0,10,1
1668315281678,MATH 218,A00,098029,Li; Bo,10,0,10,0
1668315282104,MATH 220B,A00,098030,Novak; Jonathan I,11,0,15,4
1668315282529,MATH 221A,A00,098031,Ebenfelt; Peter F,13,0,15,2
1668315282965,MATH 231B,A00,098032,Zlatos; Andrej,12,0,15,3
1668315283389,MATH 240B,A00,098033,Ni; Lei,9,0,15,6
1668315283812,MATH 243,A00,098034,Jekel; David Andrew,10,0,10,0
1668315284234,MATH 245A,A00,098035,Nie; Jiawang,0,0,15,16
1668315284658,MATH 248,A00,098036,Bejenaru; Ioan,10,0,10,0
1668315285080,MATH 250B,A00,098037,Spolaor; Luca,14,0,15,1
1668315285502,MATH 258,A00,098038,Ni; Lei,10,0,10,0
1668315285929,MATH 264B,A00,098041,Rhoades; Brendon Patrick,9,0,15,6
1668315286354,MATH 268,A00,098042,Buss; Samuel R,10,0,10,0
1668315286782,MATH 269,A00,098043,Rhoades; Brendon Patrick,10,0,10,0
1668315287209,MATH 270B,A00,098044,Li; Bo,10,0,15,5
1668315287633,MATH 272B,A00,098045,Holst; Michael J,13,0,15,2
1668315288059,MATH 273A,A00,098046,Tian; Xiaochuan,10,0,15,5
1668315288482,MATH 275,A01,098048,Tian; Xiaochuan,6,0,10,4
1668315288905,MATH 278A,A00,098049,Holst; Michael J,8,0,10,2
1668315289331,MATH 278B,A00,098050,Cloninger; Alexander,10,0,10,0
1668315289755,MATH 278C,A00,098051,Nie; Jiawang,7,0,10,3
1668315290182,MATH 280B,A00,098052,Zheng; Tianyi,8,0,15,7
1668315290610,MATH 281B,A00,098053,Bradic; Jelena,1,0,15,14
1668315291036,MATH 282B,A00,098054,Arias-Castro; Ery,0,0,15,15
1668315291457,MATH 285,A00,098055,Fitzsimmons; Patrick J,0,0,15,17
1668315291882,MATH 287B,A00,098056,Arias-Castro; Ery,2,0,15,13
1668315292308,MATH 288,A00,098057,Agarwal; Pooja,9,0,10,1
1668315292308,MATH 288,B00,098058,Zhang; Danna,8,0,10,2
1668315292308,MATH 288,C00,098059,Williams; Ruth J,9,0,10,1
1668315292733,MATH 290B,A00,098060,Roberts; Justin Deritter,13,0,15,2
1668315293161,MATH 292,A00,098061,Belmont; Eva Kinoshita,10,0,10,0
1668315293583,MATH 295,A00,098062,Suk; Andrew Hoon,48,0,50,2
1668315294006,MATH 296,A00,098063,Novak; Jonathan I,20,0,20,0
1668315294438,MATH 297,001,098064,Gamst; Anthony Collins,9997,0,9999,2
1668315793221,COGS 205,A00,101395,Chiba; Andrea,19,0,20,1
1668315793643,COGS 210B,001,101404,Greene; Deanna Jacquelyn,9998,0,9999,1
1668315793643,COGS 210B,002,101417,Xia; Haijun,9999,0,9999,0
1668315793643,COGS 210B,003,101422,Nitz; Douglas A.,9999,0,9999,0
1668315793643,COGS 210B,004,101423,Hollan; James D.,9998,0,9999,1
1668315793643,COGS 210B,005,101424,Deak; Gedeon O.,9998,0,9999,1
1668315793643,COGS 210B,006,101425,Rossano; Federico,9999,0,9999,0
1668315794068,COGS 211B,A00,101427,Coulson; Seana M,9996,0,9999,3
1668315794493,COGS 220,A00,101428,Hollan; James D.,0,0,25,25
1668315794919,COGS 229,A00,101429,Dow; Steven P,18,0,25,7
1668315795341,COGS 230,A00,101430,Klemmer; Scott R,11,0,17,6
1668315795767,COGS 234,A00,101431,Xia; Haijun,1,0,25,24
1668315796191,COGS 260,A00,101432,Kiyonaga; Anastasia,21,0,25,4
1668315796191,COGS 260,B00,101433,Kirsh; David Joel,15,0,25,10
1668315796617,CSE 202,A00,102371,Impagliazzo; Russell,0,0,0,0
1668315797040,CSE 203B,A01,102373,Cheng; Chung Kuan,0,0,0,0
1668315797466,CSE 208,A00,102374,Micciancio; Daniele,0,0,0,0
1668315797889,CSE 209A,A00,112895,Impagliazzo; Russell,0,0,15,15
1668315798315,CSE 209B,A00,108005,Bellare; Mihir,0,0,0,0
1668315798742,CSE 210,A00,113163,Coblenz; Michael J,0,0,0,0
1668315799167,CSE 219,A00,106111,Dow; Steven P,0,0,20,20
1668315799589,CSE 221,A00,102376,Voelker; Geoffrey M.,0,0,0,0
1668315800012,CSE 224,A01,102378,Porter; George M,0,0,0,0
1668315800434,CSE 229A,A00,102379,Savage; Stefan,0,0,0,0
1668315800857,CSE 229C,A00,102380,Munyaka; Imani N. S.,0,0,0,0
1668315801280,CSE 232B,A00,102382,Deutsch; Alin Bernard,0,0,0,0
1668315801703,CSE 234,A01,112904,Kumar; Arun Kumar,0,0,0,0
1668315802127,CSE 237A,A00,102383,Rosing; Tajana Simunic,0,0,0,0
1668315802551,CSE 239A,A00,102384,Deutsch; Alin Bernard,0,0,0,0
1668315802978,CSE 239B,A00,102385,Polikarpova; Nadezhda,0,0,0,0
1668315803402,CSE 240A,A00,102386,Pannuto; Patrick William,0,0,0,0
1668315803823,CSE 240B,A00,102387,Zhao; Jishen,0,0,0,0
1668315804245,CSE 241A,A00,106406,Kang; Mingu,0,0,0,0
1668315804668,CSE 249B,A00,102388,Kahng; Andrew Byun,0,0,8,8
1668315805095,CSE 251B,A01,102392,Cottrell; Garrison W,0,0,0,0
1668315805095,CSE 251B,A02,102393,Cottrell; Garrison W,0,0,0,0
1668315805518,CSE 252B,A00,102394,Ochoa; Benjamin Lawrence,0,0,0,0
1668315805942,CSE 257,A01,102396,Gao; Sicun,0,0,0,0
1668315806444,CSE 272,A00,102397,Li; Tzumao,0,0,0,0
1668315806865,CSE 274,A00,111323,Chern; Albert Ren-Haur,0,0,0,0
1668315807289,CSE 282,A00,102398,Pevzner; Pavel Arkadjevich,0,0,0,0
1668315807714,CSE 284,A00,114175,Gymrek; Melissa Ann,0,0,0,0
1668315808139,CSE 290,A00,102399,Chandraker; Manmohan Krishna,0,0,0,0
1668315808139,CSE 290,B00,102400,Vaccaro; Kristen Marie,0,0,25,25
1668315808139,CSE 290,C00,102414,Pannuto; Patrick William,0,0,25,25
1668315808139,CSE 290,D00,102427,Pevzner; Pavel Arkadjevich,0,0,0,0
1668315808139,CSE 290,E00,102429,Zhao; Jishen,0,0,0,0
1668315808139,CSE 290,F00,102436,Tullsen; Dean Michael,0,0,0,0
1668315808139,CSE 290,G00,102440,Christensen; Henrik I,0,0,20,20
1668315808563,CSE 291,A00,102443,Su; Hao,0,0,0,0
1668315808563,CSE 291,B00,102448,Polikarpova; Nadezhda,0,0,0,0
1668315808563,CSE 291,C00,102453,Vaccaro; Kristen Marie,0,0,0,0
1668315808563,CSE 291,D00,111343,Savage; Stefan,0,0,0,0
1668315808563,CSE 291,E00,116474,Claffy; Kimberly Claire,0,0,0,0
1668315808563,CSE 291,F00,116479,Pasquale; Joseph,0,0,0,0
1668315808990,CSE 293,001,119111,Bafna; Vineet,9999,0,9999,0
1668315808990,CSE 293,002,119118,Bellare; Mihir,9999,0,9999,0
1668315808990,CSE 293,003,119122,Berg-Kirkpatrick; Taylor D,9999,0,9999,0
1668315808990,CSE 293,004,119135,Christensen; Henrik I,9999,0,9999,0
1668315808990,CSE 293,005,119142,Cottrell; Garrison W,9999,0,9999,0
1668315808990,CSE 293,006,119146,Deutsch; Alin Bernard,9999,0,9999,0
1668315808990,CSE 293,007,119159,Esmaeilzadeh; Hadi,9999,0,9999,0
1668315808990,CSE 293,008,119166,Freund; Yoav,9999,0,9999,0
1668315808990,CSE 293,009,119170,Griswold; William G.,9999,0,9999,0
1668315808990,CSE 293,010,119183,Gymrek; Melissa Ann,9999,0,9999,0
1668315808990,CSE 293,011,119190,Heninger; Nadia A,9999,0,9999,0
1668315808990,CSE 293,012,119230,Impagliazzo; Russell,9999,0,9999,0
1668315808990,CSE 293,013,119232,Jhala; Ranjit,9999,0,9999,0
1668315808990,CSE 293,014,119233,Kahng; Andrew Byun,9999,0,9999,0
1668315808990,CSE 293,015,119298,Kane; Daniel Mertz,9999,0,9999,0
1668315808990,CSE 293,016,119299,Kriegman; David J,9999,0,9999,0
1668315808990,CSE 293,017,119300,Kumar; Arun Kumar,9999,0,9999,0
1668315808990,CSE 293,018,119301,Lerner; Sorin,9999,0,9999,0
1668315808990,CSE 293,019,119302,Lovett; Shachar,9999,0,9999,0
1668315808990,CSE 293,020,119303,McAuley; Julian John,9999,0,9999,0
1668315808990,CSE 293,021,119304,Micciancio; Daniele,9999,0,9999,0
1668315808990,CSE 293,022,119367,Orailoglu; Alex,9999,0,9999,0
1668315808990,CSE 293,023,119382,Paturi; Ramamohan,9999,0,9999,0
1668315808990,CSE 293,024,119404,Polikarpova; Nadezhda,9999,0,9999,0
1668315808990,CSE 293,025,119406,Politz; Joseph Gibbs,9999,0,9999,0
1668315808990,CSE 293,026,119411,Porter; George M,9999,0,9999,0
1668315808990,CSE 293,027,119414,Porter; Leonard Emerson,9999,0,9999,0
1668315808990,CSE 293,028,119416,Ramamoorthi; Ravi,9999,0,9999,0
1668315808990,CSE 293,029,119417,Sahoo; Debashis,9999,0,9999,0
1668315808990,CSE 293,030,119420,Saul; Lawrence,9999,0,9999,0
1668315808990,CSE 293,031,119421,Savage; Stefan,9999,0,9999,0
1668315808990,CSE 293,032,119425,Schulze; Jurgen P.,9999,0,9999,0
1668315808990,CSE 293,033,119426,Snoeren; Alex C.,9999,0,9999,0
1668315808990,CSE 293,034,119428,Shang; Jingbo,9999,0,9999,0
1668315808990,CSE 293,035,119430,Stefan; Deian,9999,0,9999,0
1668315808990,CSE 293,036,119431,Su; Hao,9999,0,9999,0
1668315808990,CSE 293,037,119433,Swanson; Steven James,9999,0,9999,0
1668315808990,CSE 293,038,119435,Tullsen; Dean Michael,9999,0,9999,0
1668315808990,CSE 293,039,119483,Voelker; Geoffrey M.,9999,0,9999,0
1668315808990,CSE 293,040,119537,Zhao; Jishen,9999,0,9999,0
1668315808990,CSE 293,041,119538,Zhou; Yuan-Yuan,9999,0,9999,0
1668315808990,CSE 293,042,119539,Gao; Sicun,9999,0,9999,0
1668315808990,CSE 293,043,119540,Weibel; Nadir,9999,0,9999,0
1668315808990,CSE 293,044,119541,Gupta; Rajesh K.,9999,0,9999,0
1668315808990,CSE 293,045,126410,Vaccaro; Kristen Marie,9999,0,9999,0
1668315808990,CSE 293,046,126411,Klemke; Richard,9999,0,9999,0
1668315809417,CSE 294,A00,102459,Voelker; Geoffrey M.,0,0,0,0
1668315809417,CSE 294,B00,111322,Orailoglu; Alex,0,0,0,0
1668315809853,DSE 201,A00,096914,Deutsch; Alin Bernard,30,0,30,0
1668315810279,DSE 210,A00,096915,Dasgupta; Sanjoy,30,0,30,0
1668315810701,DSE 260A,A00,096916,Altintas De Callaf; Ilkay,30,0,30,0
1668315811128,ECE 200,001,103586,Antipa; Nicholas A,9999,0,9999,0
1668315811128,ECE 200,002,103587,Atanasov; Nikolay A.,9999,0,9999,0
1668315811128,ECE 200,003,103588,Bharadia; Dinesh,9999,0,9999,0
1668315811128,ECE 200,004,103589,Cheng; Chung Kuan,9999,0,9999,0
1668315811128,ECE 200,005,103590,Cosman; Pamela C.,9999,0,9999,0
1668315811128,ECE 200,006,103591,Dayeh; Shadi Ahmad,9999,0,9999,0
1668315811128,ECE 200,007,103592,Fainman; Yeshaiahu,9999,0,9999,0
1668315811128,ECE 200,008,103593,Ford; Joseph Earl,9999,0,9999,0
1668315811128,ECE 200,009,103594,Franceschetti; Massimo,9999,0,9999,0
1668315811128,ECE 200,010,103595,Fullerton; Eric E,9999,0,9999,0
1668315811128,ECE 200,011,103596,Galton; Ian A,9999,0,9999,0
1668315811128,ECE 200,012,103597,Gilja; Vikash,9999,0,9999,0
1668315811128,ECE 200,013,103598,Hall; Drew A.,9999,0,9999,0
1668315811128,ECE 200,014,103599,Hsueh; Tzu-Chien,9999,0,9999,0
1668315811128,ECE 200,015,103600,Javidi; Tara,9999,0,9999,0
1668315811128,ECE 200,016,103601,Kahng; Andrew Byun,9999,0,9999,0
1668315811128,ECE 200,017,103602,Kim; Young-Han,9999,0,9999,0
1668315811128,ECE 200,018,103603,Koushanfar; Farinaz,9999,0,9999,0
1668315811128,ECE 200,019,103604,Kuzum; Duygu,9999,0,9999,0
1668315811128,ECE 200,020,103605,Le; Hanh-Phuc,9999,0,9999,0
1668315811128,ECE 200,021,103606,Lin; Bill,9999,0,9999,0
1668315811128,ECE 200,022,103607,Liu; Zhaowei,9998,0,9999,1
1668315811128,ECE 200,023,103608,Lo; Yu-Hwa,9999,0,9999,0
1668315811128,ECE 200,024,103609,Lomakin; Vitaliy,9999,0,9999,0
1668315811128,ECE 200,025,103610,Mercier; Patrick Philip,9999,0,9999,0
1668315811128,ECE 200,026,103611,Meyer; Florian,9999,0,9999,0
1668315811128,ECE 200,027,103612,Milstein; Laurence B.,9999,0,9999,0
1668315811128,ECE 200,028,103613,Mir Arabbaygi; Siavash,9999,0,9999,0
1668315811128,ECE 200,029,103614,Mookherjea; Shayan,9999,0,9999,0
1668315811128,ECE 200,030,103615,Morris; Karcher William,9999,0,9999,0
1668315811128,ECE 200,031,103616,Ng; Tse Nga,9999,0,9999,0
1668315811128,ECE 200,032,103617,Nguyen; Truong Quang,9999,0,9999,0
1668315811128,ECE 200,033,103618,Nomura; Kenji,9999,0,9999,0
1668315811128,ECE 200,034,103619,Orlitsky; Alon,9999,0,9999,0
1668315811128,ECE 200,035,103620,Pal; Piya,9999,0,9999,0
1668315811128,ECE 200,036,103621,Papen; George C.,9999,0,9999,0
1668315811128,ECE 200,037,103622,Radic; Stojan,9999,0,9999,0
1668315811128,ECE 200,038,103623,Rao; Bhaskar D.,9999,0,9999,0
1668315811128,ECE 200,039,103624,Rao; Ramesh R,9999,0,9999,0
1668315811128,ECE 200,040,103625,Rebeiz; Gabriel,9999,0,9999,0
1668315811128,ECE 200,041,103626,Sanford; John R,9999,0,9999,0
1668315811128,ECE 200,042,103627,Siegel; Paul H.,9999,0,9999,0
1668315811128,ECE 200,043,103628,Sievenpiper; Daniel F.,9999,0,9999,0
1668315811128,ECE 200,044,103629,Sworder; David D.,9999,0,9999,0
1668315811128,ECE 200,045,103630,Taur; Yuan,9999,0,9999,0
1668315811128,ECE 200,046,103631,Touri; Behrouz,9999,0,9999,0
1668315811128,ECE 200,047,103632,Trivedi; Mohan M.,9999,0,9999,0
1668315811128,ECE 200,048,103633,Vasconcelos; Nuno,9999,0,9999,0
1668315811128,ECE 200,049,103634,Wang; Xiaolong,9999,0,9999,0
1668315811128,ECE 200,050,103635,Xie; Pengtao,9999,0,9999,0
1668315811128,ECE 200,051,103636,Yip; Michael,9999,0,9999,0
1668315811128,ECE 200,052,103637,Zeger; Kenneth A.,999,0,999,0
1668315811128,ECE 200,053,103638,Zhang; Xinyu,9999,0,9999,0
1668315811128,ECE 200,054,103639,Turakhia; Yatish Girish,9999,0,9999,0
1668315811128,ECE 200,055,103640,Kang; Mingu,9999,0,9999,0
1668315811128,ECE 200,056,103641,Shi; Yuanyuan,9999,0,9999,0
1668315811128,ECE 200,057,103642,Wang; Edward Jay,9999,0,9999,0
1668315811128,ECE 200,058,103643,Zheng; Yang,9999,0,9999,0
1668315811553,ECE 202,A00,103644,Kuzum; Duygu,0,0,0,0
1668315811977,ECE 212BN,A00,103646,Ng; Tse Nga,0,0,0,0
1668315812402,ECE 221,A00,111493,Staff,0,0,0,0
1668315812826,ECE 222B,A00,103647,Lomakin; Vitaliy,0,0,0,0
1668315813249,ECE 230B,A00,103648,Taur; Yuan,0,0,0,0
1668315813671,ECE 238B,A00,103649,Garay; Javier,0,0,0,0
1668315814095,ECE 240B,A00,112900,Fainman; Yeshaiahu,0,0,0,0
1668315814518,ECE 247A,A00,103650,Jokerst; Jesse Vincent,0,0,0,0
1668315814941,ECE 247B,A00,103651,Wang; Joseph,0,0,0,0
1668315815374,ECE 250,A00,103652,Siegel; Paul H.,0,0,0,0
1668315815798,ECE 251A,A00,103654,Rao; Bhaskar D.,0,0,0,0
1668315816222,ECE 257B,A00,103655,Bharadia; Dinesh,0,0,0,0
1668315816645,ECE 258A,A00,103656,Milstein; Laurence B.,0,0,0,0
1668315817067,ECE 260B,A00,103658,Kang; Mingu,0,0,0,0
1668315817489,ECE 264A,A00,103659,Galton; Ian A,0,0,0,0
1668315817913,ECE 265A,A00,103661,Gudem; Prasad S.S.,0,0,0,0
1668315818343,ECE 265D,A00,103662,Gudem; Prasad S.S.,0,0,0,0
1668315818768,ECE 268,A00,103663,Koushanfar; Farinaz,0,0,0,0
1668315819193,ECE 269,A01,103665,Pal; Piya,0,0,0,0
1668315819618,ECE 271B,A00,103666,Vasconcelos; Manuela,0,0,0,0
1668315820045,ECE 276A,A00,103667,Atanasov; Nikolay A.,0,0,0,0
1668315820580,ECE 277,A00,103668,An; Cheolhong,0,0,0,0
1668315821010,ECE 279,A00,117947,Hall; Drew A.,0,0,0,0
1668315821854,ECE 283,A00,103670,Hsueh; Tzu-Chien,0,0,0,0
1668315822281,ECE 284,A00,103671,Turakhia; Yatish Girish,0,0,0,0
1668315822707,ECE 285,A00,103672,Zheng; Yang,0,0,0,0
1668315822707,ECE 285,B00,103673,Sworder; David D.,0,0,0,0
1668315823131,ECE 287,A00,103676,Javidi; Tara,0,0,0,0
1668315823557,MATH 200B,A00,098023,Salehi Golsefidy; Alireza,12,0,15,3
1668315823987,MATH 202B,A00,098024,Rhoades; Brendon Patrick,9,0,15,6
1668315824413,MATH 203B,A00,098025,Oprea; Dragos N.,10,0,15,5
1668315824841,MATH 204B,A00,098026,Sorensen; Claus M,13,0,15,2
1668315825265,MATH 208,A00,098027,Izadi; Elham,7,0,10,3
1668315825687,MATH 209,A00,098028,Pollack; Aaron,10,0,10,0
1668315826114,MATH 211A,A00,112919,Rogalski; Daniel,9,0,10,1
1668315826537,MATH 211B,A00,112920,Seward; Brandon M.,9,0,10,1
1668315826960,MATH 218,A00,098029,Li; Bo,10,0,10,0
1668315827382,MATH 220B,A00,098030,Novak; Jonathan I,11,0,15,4
1668315827809,MATH 221A,A00,098031,Ebenfelt; Peter F,13,0,15,2
1668315828234,MATH 231B,A00,098032,Zlatos; Andrej,12,0,15,3
1668315828663,MATH 240B,A00,098033,Ni; Lei,9,0,15,6
1668315829090,MATH 243,A00,098034,Jekel; David Andrew,10,0,10,0
1668315829514,MATH 245A,A00,098035,Nie; Jiawang,0,0,15,16
1668315829937,MATH 248,A00,098036,Bejenaru; Ioan,10,0,10,0
1668315830359,MATH 250B,A00,098037,Spolaor; Luca,14,0,15,1
1668315830781,MATH 258,A00,098038,Ni; Lei,10,0,10,0
1668315831203,MATH 264B,A00,098041,Rhoades; Brendon Patrick,9,0,15,6
1668315831625,MATH 268,A00,098042,Buss; Samuel R,10,0,10,0
1668315832052,MATH 269,A00,098043,Rhoades; Brendon Patrick,10,0,10,0
1668315832476,MATH 270B,A00,098044,Li; Bo,10,0,15,5
1668315832901,MATH 272B,A00,098045,Holst; Michael J,13,0,15,2
1668315833329,MATH 273A,A00,098046,Tian; Xiaochuan,10,0,15,5
1668315833757,MATH 275,A01,098048,Tian; Xiaochuan,6,0,10,4
1668315834180,MATH 278A,A00,098049,Holst; Michael J,8,0,10,2
1668315834603,MATH 278B,A00,098050,Cloninger; Alexander,10,0,10,0
1668315835028,MATH 278C,A00,098051,Nie; Jiawang,7,0,10,3
1668315835452,MATH 280B,A00,098052,Zheng; Tianyi,8,0,15,7
1668315835876,MATH 281B,A00,098053,Bradic; Jelena,1,0,15,14
1668315836299,MATH 282B,A00,098054,Arias-Castro; Ery,0,0,15,15
1668315836722,MATH 285,A00,098055,Fitzsimmons; Patrick J,0,0,15,17
1668315837144,MATH 287B,A00,098056,Arias-Castro; Ery,2,0,15,13
1668315837566,MATH 288,A00,098057,Agarwal; Pooja,9,0,10,1
1668315837566,MATH 288,B00,098058,Zhang; Danna,8,0,10,2
1668315837566,MATH 288,C00,098059,Williams; Ruth J,9,0,10,1
1668315837990,MATH 290B,A00,098060,Roberts; Justin Deritter,13,0,15,2
1668315838417,MATH 292,A00,098061,Belmont; Eva Kinoshita,10,0,10,0
1668315838839,MATH 295,A00,098062,Suk; Andrew Hoon,48,0,50,2
1668315839271,MATH 296,A00,098063,Novak; Jonathan I,20,0,20,0
1668315839694,MATH 297,001,098064,Gamst; Anthony Collins,9997,0,9999,2
1668316339061,COGS 205,A00,101395,Chiba; Andrea,19,0,20,1
1668316339486,COGS 210B,001,101404,Greene; Deanna Jacquelyn,9998,0,9999,1
1668316339486,COGS 210B,002,101417,Xia; Haijun,9999,0,9999,0
1668316339486,COGS 210B,003,101422,Nitz; Douglas A.,9999,0,9999,0
1668316339486,COGS 210B,004,101423,Hollan; James D.,9998,0,9999,1
1668316339486,COGS 210B,005,101424,Deak; Gedeon O.,9998,0,9999,1
1668316339486,COGS 210B,006,101425,Rossano; Federico,9999,0,9999,0
1668316340006,COGS 211B,A00,101427,Coulson; Seana M,9996,0,9999,3
1668316340429,COGS 220,A00,101428,Hollan; James D.,0,0,25,25
1668316340855,COGS 229,A00,101429,Dow; Steven P,18,0,25,7
1668316341277,COGS 230,A00,101430,Klemmer; Scott R,11,0,17,6
1668316341704,COGS 234,A00,101431,Xia; Haijun,1,0,25,24
1668316342127,COGS 260,A00,101432,Kiyonaga; Anastasia,21,0,25,4
1668316342127,COGS 260,B00,101433,Kirsh; David Joel,15,0,25,10
1668316342550,CSE 202,A00,102371,Impagliazzo; Russell,0,0,0,0
1668316342978,CSE 203B,A01,102373,Cheng; Chung Kuan,0,0,0,0
1668316343409,CSE 208,A00,102374,Micciancio; Daniele,0,0,0,0
1668316343831,CSE 209A,A00,112895,Impagliazzo; Russell,0,0,15,15
1668316344258,CSE 209B,A00,108005,Bellare; Mihir,0,0,0,0
1668316344682,CSE 210,A00,113163,Coblenz; Michael J,0,0,0,0
1668316345109,CSE 219,A00,106111,Dow; Steven P,0,0,20,20
1668316345532,CSE 221,A00,102376,Voelker; Geoffrey M.,0,0,0,0
1668316345956,CSE 224,A01,102378,Porter; George M,0,0,0,0
1668316346382,CSE 229A,A00,102379,Savage; Stefan,0,0,0,0
1668316346807,CSE 229C,A00,102380,Munyaka; Imani N. S.,0,0,0,0
1668316347232,CSE 232B,A00,102382,Deutsch; Alin Bernard,0,0,0,0
1668316347655,CSE 234,A01,112904,Kumar; Arun Kumar,0,0,0,0
1668316348092,CSE 237A,A00,102383,Rosing; Tajana Simunic,0,0,0,0
1668316348518,CSE 239A,A00,102384,Deutsch; Alin Bernard,0,0,0,0
1668316348945,CSE 239B,A00,102385,Polikarpova; Nadezhda,0,0,0,0
1668316349369,CSE 240A,A00,102386,Pannuto; Patrick William,0,0,0,0
1668316349793,CSE 240B,A00,102387,Zhao; Jishen,0,0,0,0
1668316350215,CSE 241A,A00,106406,Kang; Mingu,0,0,0,0
1668316350638,CSE 249B,A00,102388,Kahng; Andrew Byun,0,0,8,8
1668316351062,CSE 251B,A01,102392,Cottrell; Garrison W,0,0,0,0
1668316351062,CSE 251B,A02,102393,Cottrell; Garrison W,0,0,0,0
1668316351487,CSE 252B,A00,102394,Ochoa; Benjamin Lawrence,0,0,0,0
1668316351915,CSE 257,A01,102396,Gao; Sicun,0,0,0,0
1668316352348,CSE 272,A00,102397,Li; Tzumao,0,0,0,0
1668316352774,CSE 274,A00,111323,Chern; Albert Ren-Haur,0,0,0,0
1668316353211,CSE 282,A00,102398,Pevzner; Pavel Arkadjevich,0,0,0,0
1668316353635,CSE 284,A00,114175,Gymrek; Melissa Ann,0,0,0,0
1668316354059,CSE 290,A00,102399,Chandraker; Manmohan Krishna,0,0,0,0
1668316354059,CSE 290,B00,102400,Vaccaro; Kristen Marie,0,0,25,25
1668316354059,CSE 290,C00,102414,Pannuto; Patrick William,0,0,25,25
1668316354059,CSE 290,D00,102427,Pevzner; Pavel Arkadjevich,0,0,0,0
1668316354059,CSE 290,E00,102429,Zhao; Jishen,0,0,0,0
1668316354059,CSE 290,F00,102436,Tullsen; Dean Michael,0,0,0,0
1668316354059,CSE 290,G00,102440,Christensen; Henrik I,0,0,20,20
1668316354486,CSE 291,A00,102443,Su; Hao,0,0,0,0
1668316354486,CSE 291,B00,102448,Polikarpova; Nadezhda,0,0,0,0
1668316354486,CSE 291,C00,102453,Vaccaro; Kristen Marie,0,0,0,0
1668316354486,CSE 291,D00,111343,Savage; Stefan,0,0,0,0
1668316354486,CSE 291,E00,116474,Claffy; Kimberly Claire,0,0,0,0
1668316354486,CSE 291,F00,116479,Pasquale; Joseph,0,0,0,0
1668316354916,CSE 293,001,119111,Bafna; Vineet,9999,0,9999,0
1668316354916,CSE 293,002,119118,Bellare; Mihir,9999,0,9999,0
1668316354916,CSE 293,003,119122,Berg-Kirkpatrick; Taylor D,9999,0,9999,0
1668316354916,CSE 293,004,119135,Christensen; Henrik I,9999,0,9999,0
1668316354916,CSE 293,005,119142,Cottrell; Garrison W,9999,0,9999,0
1668316354916,CSE 293,006,119146,Deutsch; Alin Bernard,9999,0,9999,0
1668316354916,CSE 293,007,119159,Esmaeilzadeh; Hadi,9999,0,9999,0
1668316354916,CSE 293,008,119166,Freund; Yoav,9999,0,9999,0
1668316354916,CSE 293,009,119170,Griswold; William G.,9999,0,9999,0
1668316354916,CSE 293,010,119183,Gymrek; Melissa Ann,9999,0,9999,0
1668316354916,CSE 293,011,119190,Heninger; Nadia A,9999,0,9999,0
1668316354916,CSE 293,012,119230,Impagliazzo; Russell,9999,0,9999,0
1668316354916,CSE 293,013,119232,Jhala; Ranjit,9999,0,9999,0
1668316354916,CSE 293,014,119233,Kahng; Andrew Byun,9999,0,9999,0
1668316354916,CSE 293,015,119298,Kane; Daniel Mertz,9999,0,9999,0
1668316354916,CSE 293,016,119299,Kriegman; David J,9999,0,9999,0
1668316354916,CSE 293,017,119300,Kumar; Arun Kumar,9999,0,9999,0
1668316354916,CSE 293,018,119301,Lerner; Sorin,9999,0,9999,0
1668316354916,CSE 293,019,119302,Lovett; Shachar,9999,0,9999,0
1668316354916,CSE 293,020,119303,McAuley; Julian John,9999,0,9999,0
1668316354916,CSE 293,021,119304,Micciancio; Daniele,9999,0,9999,0
1668316354916,CSE 293,022,119367,Orailoglu; Alex,9999,0,9999,0
1668316354916,CSE 293,023,119382,Paturi; Ramamohan,9999,0,9999,0
1668316354916,CSE 293,024,119404,Polikarpova; Nadezhda,9999,0,9999,0
1668316354916,CSE 293,025,119406,Politz; Joseph Gibbs,9999,0,9999,0
1668316354916,CSE 293,026,119411,Porter; George M,9999,0,9999,0
1668316354916,CSE 293,027,119414,Porter; Leonard Emerson,9999,0,9999,0
1668316354916,CSE 293,028,119416,Ramamoorthi; Ravi,9999,0,9999,0
1668316354916,CSE 293,029,119417,Sahoo; Debashis,9999,0,9999,0
1668316354916,CSE 293,030,119420,Saul; Lawrence,9999,0,9999,0
1668316354916,CSE 293,031,119421,Savage; Stefan,9999,0,9999,0
1668316354916,CSE 293,032,119425,Schulze; Jurgen P.,9999,0,9999,0
1668316354916,CSE 293,033,119426,Snoeren; Alex C.,9999,0,9999,0
1668316354916,CSE 293,034,119428,Shang; Jingbo,9999,0,9999,0
1668316354916,CSE 293,035,119430,Stefan; Deian,9999,0,9999,0
1668316354916,CSE 293,036,119431,Su; Hao,9999,0,9999,0
1668316354916,CSE 293,037,119433,Swanson; Steven James,9999,0,9999,0
1668316354916,CSE 293,038,119435,Tullsen; Dean Michael,9999,0,9999,0
1668316354916,CSE 293,039,119483,Voelker; Geoffrey M.,9999,0,9999,0
1668316354916,CSE 293,040,119537,Zhao; Jishen,9999,0,9999,0
1668316354916,CSE 293,041,119538,Zhou; Yuan-Yuan,9999,0,9999,0
1668316354916,CSE 293,042,119539,Gao; Sicun,9999,0,9999,0
1668316354916,CSE 293,043,119540,Weibel; Nadir,9999,0,9999,0
1668316354916,CSE 293,044,119541,Gupta; Rajesh K.,9999,0,9999,0
1668316354916,CSE 293,045,126410,Vaccaro; Kristen Marie,9999,0,9999,0
1668316354916,CSE 293,046,126411,Klemke; Richard,9999,0,9999,0
1668316355343,CSE 294,A00,102459,Voelker; Geoffrey M.,0,0,0,0
1668316355343,CSE 294,B00,111322,Orailoglu; Alex,0,0,0,0
1668316355775,DSE 201,A00,096914,Deutsch; Alin Bernard,30,0,30,0
1668316356201,DSE 210,A00,096915,Dasgupta; Sanjoy,30,0,30,0
1668316356624,DSE 260A,A00,096916,Altintas De Callaf; Ilkay,30,0,30,0
1668316357055,ECE 200,001,103586,Antipa; Nicholas A,9999,0,9999,0
1668316357055,ECE 200,002,103587,Atanasov; Nikolay A.,9999,0,9999,0
1668316357055,ECE 200,003,103588,Bharadia; Dinesh,9999,0,9999,0
1668316357055,ECE 200,004,103589,Cheng; Chung Kuan,9999,0,9999,0
1668316357055,ECE 200,005,103590,Cosman; Pamela C.,9999,0,9999,0
1668316357055,ECE 200,006,103591,Dayeh; Shadi Ahmad,9999,0,9999,0
1668316357055,ECE 200,007,103592,Fainman; Yeshaiahu,9999,0,9999,0
1668316357055,ECE 200,008,103593,Ford; Joseph Earl,9999,0,9999,0
1668316357055,ECE 200,009,103594,Franceschetti; Massimo,9999,0,9999,0
1668316357055,ECE 200,010,103595,Fullerton; Eric E,9999,0,9999,0
1668316357055,ECE 200,011,103596,Galton; Ian A,9999,0,9999,0
1668316357055,ECE 200,012,103597,Gilja; Vikash,9999,0,9999,0
1668316357055,ECE 200,013,103598,Hall; Drew A.,9999,0,9999,0
1668316357055,ECE 200,014,103599,Hsueh; Tzu-Chien,9999,0,9999,0
1668316357055,ECE 200,015,103600,Javidi; Tara,9999,0,9999,0
1668316357055,ECE 200,016,103601,Kahng; Andrew Byun,9999,0,9999,0
1668316357055,ECE 200,017,103602,Kim; Young-Han,9999,0,9999,0
1668316357055,ECE 200,018,103603,Koushanfar; Farinaz,9999,0,9999,0
1668316357055,ECE 200,019,103604,Kuzum; Duygu,9999,0,9999,0
1668316357055,ECE 200,020,103605,Le; Hanh-Phuc,9999,0,9999,0
1668316357055,ECE 200,021,103606,Lin; Bill,9999,0,9999,0
1668316357055,ECE 200,022,103607,Liu; Zhaowei,9998,0,9999,1
1668316357055,ECE 200,023,103608,Lo; Yu-Hwa,9999,0,9999,0
1668316357055,ECE 200,024,103609,Lomakin; Vitaliy,9999,0,9999,0
1668316357055,ECE 200,025,103610,Mercier; Patrick Philip,9999,0,9999,0
1668316357055,ECE 200,026,103611,Meyer; Florian,9999,0,9999,0
1668316357055,ECE 200,027,103612,Milstein; Laurence B.,9999,0,9999,0
1668316357055,ECE 200,028,103613,Mir Arabbaygi; Siavash,9999,0,9999,0
1668316357055,ECE 200,029,103614,Mookherjea; Shayan,9999,0,9999,0
1668316357055,ECE 200,030,103615,Morris; Karcher William,9999,0,9999,0
1668316357055,ECE 200,031,103616,Ng; Tse Nga,9999,0,9999,0
1668316357055,ECE 200,032,103617,Nguyen; Truong Quang,9999,0,9999,0
1668316357055,ECE 200,033,103618,Nomura; Kenji,9999,0,9999,0
1668316357055,ECE 200,034,103619,Orlitsky; Alon,9999,0,9999,0
1668316357055,ECE 200,035,103620,Pal; Piya,9999,0,9999,0
1668316357055,ECE 200,036,103621,Papen; George C.,9999,0,9999,0
1668316357055,ECE 200,037,103622,Radic; Stojan,9999,0,9999,0
1668316357055,ECE 200,038,103623,Rao; Bhaskar D.,9999,0,9999,0
1668316357055,ECE 200,039,103624,Rao; Ramesh R,9999,0,9999,0
1668316357055,ECE 200,040,103625,Rebeiz; Gabriel,9999,0,9999,0
1668316357055,ECE 200,041,103626,Sanford; John R,9999,0,9999,0
1668316357055,ECE 200,042,103627,Siegel; Paul H.,9999,0,9999,0
1668316357055,ECE 200,043,103628,Sievenpiper; Daniel F.,9999,0,9999,0
1668316357055,ECE 200,044,103629,Sworder; David D.,9999,0,9999,0
1668316357055,ECE 200,045,103630,Taur; Yuan,9999,0,9999,0
1668316357055,ECE 200,046,103631,Touri; Behrouz,9999,0,9999,0
1668316357055,ECE 200,047,103632,Trivedi; Mohan M.,9999,0,9999,0
1668316357055,ECE 200,048,103633,Vasconcelos; Nuno,9999,0,9999,0
1668316357055,ECE 200,049,103634,Wang; Xiaolong,9999,0,9999,0
1668316357055,ECE 200,050,103635,Xie; Pengtao,9999,0,9999,0
1668316357055,ECE 200,051,103636,Yip; Michael,9999,0,9999,0
1668316357055,ECE 200,052,103637,Zeger; Kenneth A.,999,0,999,0
1668316357055,ECE 200,053,103638,Zhang; Xinyu,9999,0,9999,0
1668316357055,ECE 200,054,103639,Turakhia; Yatish Girish,9999,0,9999,0
1668316357055,ECE 200,055,103640,Kang; Mingu,9999,0,9999,0
1668316357055,ECE 200,056,103641,Shi; Yuanyuan,9999,0,9999,0
1668316357055,ECE 200,057,103642,Wang; Edward Jay,9999,0,9999,0
1668316357055,ECE 200,058,103643,Zheng; Yang,9999,0,9999,0
1668316357482,ECE 202,A00,103644,Kuzum; Duygu,0,0,0,0
1668316357905,ECE 212BN,A00,103646,Ng; Tse Nga,0,0,0,0
1668316358332,ECE 221,A00,111493,Staff,0,0,0,0
1668316358755,ECE 222B,A00,103647,Lomakin; Vitaliy,0,0,0,0
1668316359181,ECE 230B,A00,103648,Taur; Yuan,0,0,0,0
1668316359605,ECE 238B,A00,103649,Garay; Javier,0,0,0,0
1668316360029,ECE 240B,A00,112900,Fainman; Yeshaiahu,0,0,0,0
1668316360454,ECE 247A,A00,103650,Jokerst; Jesse Vincent,0,0,0,0
1668316360879,ECE 247B,A00,103651,Wang; Joseph,0,0,0,0
1668316361305,ECE 250,A00,103652,Siegel; Paul H.,0,0,0,0
1668316361740,ECE 251A,A00,103654,Rao; Bhaskar D.,0,0,0,0
1668316362165,ECE 257B,A00,103655,Bharadia; Dinesh,0,0,0,0
1668316362587,ECE 258A,A00,103656,Milstein; Laurence B.,0,0,0,0
1668316363010,ECE 260B,A00,103658,Kang; Mingu,0,0,0,0
1668316363434,ECE 264A,A00,103659,Galton; Ian A,0,0,0,0
1668316363858,ECE 265A,A00,103661,Gudem; Prasad S.S.,0,0,0,0
1668316364281,ECE 265D,A00,103662,Gudem; Prasad S.S.,0,0,0,0
1668316364718,ECE 268,A00,103663,Koushanfar; Farinaz,0,0,0,0
1668316365140,ECE 269,A01,103665,Pal; Piya,0,0,0,0
1668316365571,ECE 271B,A00,103666,Vasconcelos; Manuela,0,0,0,0
1668316365996,ECE 276A,A00,103667,Atanasov; Nikolay A.,0,0,0,0
1668316366423,ECE 277,A00,103668,An; Cheolhong,0,0,0,0
1668316366849,ECE 279,A00,117947,Hall; Drew A.,0,0,0,0
1668316367708,ECE 283,A00,103670,Hsueh; Tzu-Chien,0,0,0,0
1668316368139,ECE 284,A00,103671,Turakhia; Yatish Girish,0,0,0,0
1668316368565,ECE 285,A00,103672,Zheng; Yang,0,0,0,0
1668316368565,ECE 285,B00,103673,Sworder; David D.,0,0,0,0
1668316368990,ECE 287,A00,103676,Javidi; Tara,0,0,0,0
1668316369421,MATH 200B,A00,098023,Salehi Golsefidy; Alireza,12,0,15,3
1668316369846,MATH 202B,A00,098024,Rhoades; Brendon Patrick,9,0,15,6
1668316370276,MATH 203B,A00,098025,Oprea; Dragos N.,10,0,15,5
1668316370703,MATH 204B,A00,098026,Sorensen; Claus M,13,0,15,2
1668316371139,MATH 208,A00,098027,Izadi; Elham,7,0,10,3
1668316371565,MATH 209,A00,098028,Pollack; Aaron,10,0,10,0
1668316371999,MATH 211A,A00,112919,Rogalski; Daniel,9,0,10,1
1668316372422,MATH 211B,A00,112920,Seward; Brandon M.,9,0,10,1
1668316372843,MATH 218,A00,098029,Li; Bo,10,0,10,0
1668316373266,MATH 220B,A00,098030,Novak; Jonathan I,11,0,15,4
1668316373698,MATH 221A,A00,098031,Ebenfelt; Peter F,13,0,15,2
1668316374123,MATH 231B,A00,098032,Zlatos; Andrej,12,0,15,3
1668316374546,MATH 240B,A00,098033,Ni; Lei,9,0,15,6
1668316374983,MATH 243,A00,098034,Jekel; David Andrew,10,0,10,0
1668316375408,MATH 245A,A00,098035,Nie; Jiawang,0,0,15,16
1668316375833,MATH 248,A00,098036,Bejenaru; Ioan,10,0,10,0
1668316376261,MATH 250B,A00,098037,Spolaor; Luca,14,0,15,1
1668316376686,MATH 258,A00,098038,Ni; Lei,10,0,10,0
1668316377112,MATH 264B,A00,098041,Rhoades; Brendon Patrick,9,0,15,6
1668316377536,MATH 268,A00,098042,Buss; Samuel R,10,0,10,0
1668316377962,MATH 269,A00,098043,Rhoades; Brendon Patrick,10,0,10,0
1668316378385,MATH 270B,A00,098044,Li; Bo,10,0,15,5
1668316378809,MATH 272B,A00,098045,Holst; Michael J,13,0,15,2
1668316379232,MATH 273A,A00,098046,Tian; Xiaochuan,10,0,15,5
1668316379657,MATH 275,A01,098048,Tian; Xiaochuan,6,0,10,4
1668316380089,MATH 278A,A00,098049,Holst; Michael J,8,0,10,2
1668316380512,MATH 278B,A00,098050,Cloninger; Alexander,10,0,10,0
1668316380939,MATH 278C,A00,098051,Nie; Jiawang,7,0,10,3
1668316381361,MATH 280B,A00,098052,Zheng; Tianyi,8,0,15,7
1668316381787,MATH 281B,A00,098053,Bradic; Jelena,1,0,15,14
1668316382217,MATH 282B,A00,098054,Arias-Castro; Ery,0,0,15,15
1668316382643,MATH 285,A00,098055,Fitzsimmons; Patrick J,0,0,15,17
1668316383161,MATH 287B,A00,098056,Arias-Castro; Ery,2,0,15,13
1668316383585,MATH 288,A00,098057,Agarwal; Pooja,9,0,10,1
1668316383585,MATH 288,B00,098058,Zhang; Danna,8,0,10,2
1668316383585,MATH 288,C00,098059,Williams; Ruth J,9,0,10,1
1668316384007,MATH 290B,A00,098060,Roberts; Justin Deritter,13,0,15,2
1668316384438,MATH 292,A00,098061,Belmont; Eva Kinoshita,10,0,10,0
1668316384862,MATH 295,A00,098062,Suk; Andrew Hoon,48,0,50,2
1668316385287,MATH 296,A00,098063,Novak; Jonathan I,20,0,20,0
1668316385714,MATH 297,001,098064,Gamst; Anthony Collins,9997,0,9999,2
1668316884863,COGS 205,A00,101395,Chiba; Andrea,19,0,20,1
1668316885285,COGS 210B,001,101404,Greene; Deanna Jacquelyn,9998,0,9999,1
1668316885285,COGS 210B,002,101417,Xia; Haijun,9999,0,9999,0
1668316885285,COGS 210B,003,101422,Nitz; Douglas A.,9999,0,9999,0
1668316885285,COGS 210B,004,101423,Hollan; James D.,9998,0,9999,1
1668316885285,COGS 210B,005,101424,Deak; Gedeon O.,9998,0,9999,1
1668316885285,COGS 210B,006,101425,Rossano; Federico,9999,0,9999,0
1668316885708,COGS 211B,A00,101427,Coulson; Seana M,9996,0,9999,3
1668316886130,COGS 220,A00,101428,Hollan; James D.,0,0,25,25
1668316886554,COGS 229,A00,101429,Dow; Steven P,18,0,25,7
1668316886981,COGS 230,A00,101430,Klemmer; Scott R,11,0,17,6
1668316887407,COGS 234,A00,101431,Xia; Haijun,1,0,25,24
1668316887832,COGS 260,A00,101432,Kiyonaga; Anastasia,21,0,25,4
1668316887832,COGS 260,B00,101433,Kirsh; David Joel,15,0,25,10
1668316888257,CSE 202,A00,102371,Impagliazzo; Russell,0,0,0,0
1668316888684,CSE 203B,A01,102373,Cheng; Chung Kuan,0,0,0,0
1668316889109,CSE 208,A00,102374,Micciancio; Daniele,0,0,0,0
1668316889533,CSE 209A,A00,112895,Impagliazzo; Russell,0,0,15,15
1668316889955,CSE 209B,A00,108005,Bellare; Mihir,0,0,0,0
1668316890381,CSE 210,A00,113163,Coblenz; Michael J,0,0,0,0
1668316890803,CSE 219,A00,106111,Dow; Steven P,0,0,20,20
1668316891228,CSE 221,A00,102376,Voelker; Geoffrey M.,0,0,0,0
1668316891656,CSE 224,A01,102378,Porter; George M,0,0,0,0
1668316892082,CSE 229A,A00,102379,Savage; Stefan,0,0,0,0
1668316892511,CSE 229C,A00,102380,Munyaka; Imani N. S.,0,0,0,0
1668316892933,CSE 232B,A00,102382,Deutsch; Alin Bernard,0,0,0,0
1668316893360,CSE 234,A01,112904,Kumar; Arun Kumar,0,0,0,0
1668316893785,CSE 237A,A00,102383,Rosing; Tajana Simunic,0,0,0,0
1668316894213,CSE 239A,A00,102384,Deutsch; Alin Bernard,0,0,0,0
1668316894635,CSE 239B,A00,102385,Polikarpova; Nadezhda,0,0,0,0
1668316895060,CSE 240A,A00,102386,Pannuto; Patrick William,0,0,0,0
1668316895485,CSE 240B,A00,102387,Zhao; Jishen,0,0,0,0
1668316895910,CSE 241A,A00,106406,Kang; Mingu,0,0,0,0
1668316896332,CSE 249B,A00,102388,Kahng; Andrew Byun,0,0,8,8
1668316896756,CSE 251B,A01,102392,Cottrell; Garrison W,0,0,0,0
1668316896756,CSE 251B,A02,102393,Cottrell; Garrison W,0,0,0,0
1668316897195,CSE 252B,A00,102394,Ochoa; Benjamin Lawrence,0,0,0,0
1668316897625,CSE 257,A01,102396,Gao; Sicun,0,0,0,0
1668316898047,CSE 272,A00,102397,Li; Tzumao,0,0,0,0
1668316898472,CSE 274,A00,111323,Chern; Albert Ren-Haur,0,0,0,0
1668316898894,CSE 282,A00,102398,Pevzner; Pavel Arkadjevich,0,0,0,0
1668316899318,CSE 284,A00,114175,Gymrek; Melissa Ann,0,0,0,0
1668316899746,CSE 290,A00,102399,Chandraker; Manmohan Krishna,0,0,0,0
1668316899746,CSE 290,B00,102400,Vaccaro; Kristen Marie,0,0,25,25
1668316899746,CSE 290,C00,102414,Pannuto; Patrick William,0,0,25,25
1668316899746,CSE 290,D00,102427,Pevzner; Pavel Arkadjevich,0,0,0,0
1668316899746,CSE 290,E00,102429,Zhao; Jishen,0,0,0,0
1668316899746,CSE 290,F00,102436,Tullsen; Dean Michael,0,0,0,0
1668316899746,CSE 290,G00,102440,Christensen; Henrik I,0,0,20,20
1668316900174,CSE 291,A00,102443,Su; Hao,0,0,0,0
1668316900174,CSE 291,B00,102448,Polikarpova; Nadezhda,0,0,0,0
1668316900174,CSE 291,C00,102453,Vaccaro; Kristen Marie,0,0,0,0
1668316900174,CSE 291,D00,111343,Savage; Stefan,0,0,0,0
1668316900174,CSE 291,E00,116474,Claffy; Kimberly Claire,0,0,0,0
1668316900174,CSE 291,F00,116479,Pasquale; Joseph,0,0,0,0
1668316900601,CSE 293,001,119111,Bafna; Vineet,9999,0,9999,0
1668316900601,CSE 293,002,119118,Bellare; Mihir,9999,0,9999,0
1668316900601,CSE 293,003,119122,Berg-Kirkpatrick; Taylor D,9999,0,9999,0
1668316900601,CSE 293,004,119135,Christensen; Henrik I,9999,0,9999,0
1668316900601,CSE 293,005,119142,Cottrell; Garrison W,9999,0,9999,0
1668316900601,CSE 293,006,119146,Deutsch; Alin Bernard,9999,0,9999,0
1668316900601,CSE 293,007,119159,Esmaeilzadeh; Hadi,9999,0,9999,0
1668316900601,CSE 293,008,119166,Freund; Yoav,9999,0,9999,0
1668316900601,CSE 293,009,119170,Griswold; William G.,9999,0,9999,0
1668316900601,CSE 293,010,119183,Gymrek; Melissa Ann,9999,0,9999,0
1668316900601,CSE 293,011,119190,Heninger; Nadia A,9999,0,9999,0
1668316900601,CSE 293,012,119230,Impagliazzo; Russell,9999,0,9999,0
1668316900601,CSE 293,013,119232,Jhala; Ranjit,9999,0,9999,0
1668316900601,CSE 293,014,119233,Kahng; Andrew Byun,9999,0,9999,0
1668316900601,CSE 293,015,119298,Kane; Daniel Mertz,9999,0,9999,0
1668316900601,CSE 293,016,119299,Kriegman; David J,9999,0,9999,0
1668316900601,CSE 293,017,119300,Kumar; Arun Kumar,9999,0,9999,0
1668316900601,CSE 293,018,119301,Lerner; Sorin,9999,0,9999,0
1668316900601,CSE 293,019,119302,Lovett; Shachar,9999,0,9999,0
1668316900601,CSE 293,020,119303,McAuley; Julian John,9999,0,9999,0
1668316900601,CSE 293,021,119304,Micciancio; Daniele,9999,0,9999,0
1668316900601,CSE 293,022,119367,Orailoglu; Alex,9999,0,9999,0
1668316900601,CSE 293,023,119382,Paturi; Ramamohan,9999,0,9999,0
1668316900601,CSE 293,024,119404,Polikarpova; Nadezhda,9999,0,9999,0
1668316900601,CSE 293,025,119406,Politz; Joseph Gibbs,9999,0,9999,0
1668316900601,CSE 293,026,119411,Porter; George M,9999,0,9999,0
1668316900601,CSE 293,027,119414,Porter; Leonard Emerson,9999,0,9999,0
1668316900601,CSE 293,028,119416,Ramamoorthi; Ravi,9999,0,9999,0
1668316900601,CSE 293,029,119417,Sahoo; Debashis,9999,0,9999,0
1668316900601,CSE 293,030,119420,Saul; Lawrence,9999,0,9999,0
1668316900601,CSE 293,031,119421,Savage; Stefan,9999,0,9999,0
1668316900601,CSE 293,032,119425,Schulze; Jurgen P.,9999,0,9999,0
1668316900601,CSE 293,033,119426,Snoeren; Alex C.,9999,0,9999,0
1668316900601,CSE 293,034,119428,Shang; Jingbo,9999,0,9999,0
1668316900601,CSE 293,035,119430,Stefan; Deian,9999,0,9999,0
1668316900601,CSE 293,036,119431,Su; Hao,9999,0,9999,0
1668316900601,CSE 293,037,119433,Swanson; Steven James,9999,0,9999,0
1668316900601,CSE 293,038,119435,Tullsen; Dean Michael,9999,0,9999,0
1668316900601,CSE 293,039,119483,Voelker; Geoffrey M.,9999,0,9999,0
1668316900601,CSE 293,040,119537,Zhao; Jishen,9999,0,9999,0
1668316900601,CSE 293,041,119538,Zhou; Yuan-Yuan,9999,0,9999,0
1668316900601,CSE 293,042,119539,Gao; Sicun,9999,0,9999,0
1668316900601,CSE 293,043,119540,Weibel; Nadir,9999,0,9999,0
1668316900601,CSE 293,044,119541,Gupta; Rajesh K.,9999,0,9999,0
1668316900601,CSE 293,045,126410,Vaccaro; Kristen Marie,9999,0,9999,0
1668316900601,CSE 293,046,126411,Klemke; Richard,9999,0,9999,0
1668316901029,CSE 294,A00,102459,Voelker; Geoffrey M.,0,0,0,0
1668316901029,CSE 294,B00,111322,Orailoglu; Alex,0,0,0,0
1668316901454,DSE 201,A00,096914,Deutsch; Alin Bernard,30,0,30,0
1668316901879,DSE 210,A00,096915,Dasgupta; Sanjoy,30,0,30,0
1668316902376,DSE 260A,A00,096916,Altintas De Callaf; Ilkay,30,0,30,0
1668316902820,ECE 200,001,103586,Antipa; Nicholas A,9999,0,9999,0
1668316902820,ECE 200,002,103587,Atanasov; Nikolay A.,9999,0,9999,0
1668316902820,ECE 200,003,103588,Bharadia; Dinesh,9999,0,9999,0
1668316902820,ECE 200,004,103589,Cheng; Chung Kuan,9999,0,9999,0
1668316902820,ECE 200,005,103590,Cosman; Pamela C.,9999,0,9999,0
1668316902820,ECE 200,006,103591,Dayeh; Shadi Ahmad,9999,0,9999,0
1668316902820,ECE 200,007,103592,Fainman; Yeshaiahu,9999,0,9999,0
1668316902820,ECE 200,008,103593,Ford; Joseph Earl,9999,0,9999,0
1668316902820,ECE 200,009,103594,Franceschetti; Massimo,9999,0,9999,0
1668316902820,ECE 200,010,103595,Fullerton; Eric E,9999,0,9999,0
1668316902820,ECE 200,011,103596,Galton; Ian A,9999,0,9999,0
1668316902820,ECE 200,012,103597,Gilja; Vikash,9999,0,9999,0
1668316902820,ECE 200,013,103598,Hall; Drew A.,9999,0,9999,0
1668316902820,ECE 200,014,103599,Hsueh; Tzu-Chien,9999,0,9999,0
1668316902820,ECE 200,015,103600,Javidi; Tara,9999,0,9999,0
1668316902820,ECE 200,016,103601,Kahng; Andrew Byun,9999,0,9999,0
1668316902820,ECE 200,017,103602,Kim; Young-Han,9999,0,9999,0
1668316902820,ECE 200,018,103603,Koushanfar; Farinaz,9999,0,9999,0
1668316902820,ECE 200,019,103604,Kuzum; Duygu,9999,0,9999,0
1668316902820,ECE 200,020,103605,Le; Hanh-Phuc,9999,0,9999,0
1668316902820,ECE 200,021,103606,Lin; Bill,9999,0,9999,0
1668316902820,ECE 200,022,103607,Liu; Zhaowei,9998,0,9999,1
1668316902820,ECE 200,023,103608,Lo; Yu-Hwa,9999,0,9999,0
1668316902820,ECE 200,024,103609,Lomakin; Vitaliy,9999,0,9999,0
1668316902820,ECE 200,025,103610,Mercier; Patrick Philip,9999,0,9999,0
1668316902820,ECE 200,026,103611,Meyer; Florian,9999,0,9999,0
1668316902820,ECE 200,027,103612,Milstein; Laurence B.,9999,0,9999,0
1668316902820,ECE 200,028,103613,Mir Arabbaygi; Siavash,9999,0,9999,0
1668316902820,ECE 200,029,103614,Mookherjea; Shayan,9999,0,9999,0
1668316902820,ECE 200,030,103615,Morris; Karcher William,9999,0,9999,0
1668316902820,ECE 200,031,103616,Ng; Tse Nga,9999,0,9999,0
1668316902820,ECE 200,032,103617,Nguyen; Truong Quang,9999,0,9999,0
1668316902820,ECE 200,033,103618,Nomura; Kenji,9999,0,9999,0
1668316902820,ECE 200,034,103619,Orlitsky; Alon,9999,0,9999,0
1668316902820,ECE 200,035,103620,Pal; Piya,9999,0,9999,0
1668316902820,ECE 200,036,103621,Papen; George C.,9999,0,9999,0
1668316902820,ECE 200,037,103622,Radic; Stojan,9999,0,9999,0
1668316902820,ECE 200,038,103623,Rao; Bhaskar D.,9999,0,9999,0
1668316902820,ECE 200,039,103624,Rao; Ramesh R,9999,0,9999,0
1668316902820,ECE 200,040,103625,Rebeiz; Gabriel,9999,0,9999,0
1668316902820,ECE 200,041,103626,Sanford; John R,9999,0,9999,0
1668316902820,ECE 200,042,103627,Siegel; Paul H.,9999,0,9999,0
1668316902820,ECE 200,043,103628,Sievenpiper; Daniel F.,9999,0,9999,0
1668316902820,ECE 200,044,103629,Sworder; David D.,9999,0,9999,0
1668316902820,ECE 200,045,103630,Taur; Yuan,9999,0,9999,0
1668316902820,ECE 200,046,103631,Touri; Behrouz,9999,0,9999,0
1668316902820,ECE 200,047,103632,Trivedi; Mohan M.,9999,0,9999,0
1668316902820,ECE 200,048,103633,Vasconcelos; Nuno,9999,0,9999,0
1668316902820,ECE 200,049,103634,Wang; Xiaolong,9999,0,9999,0
1668316902820,ECE 200,050,103635,Xie; Pengtao,9999,0,9999,0
1668316902820,ECE 200,051,103636,Yip; Michael,9999,0,9999,0
1668316902820,ECE 200,052,103637,Zeger; Kenneth A.,999,0,999,0
1668316902820,ECE 200,053,103638,Zhang; Xinyu,9999,0,9999,0
1668316902820,ECE 200,054,103639,Turakhia; Yatish Girish,9999,0,9999,0
1668316902820,ECE 200,055,103640,Kang; Mingu,9999,0,9999,0
1668316902820,ECE 200,056,103641,Shi; Yuanyuan,9999,0,9999,0
1668316902820,ECE 200,057,103642,Wang; Edward Jay,9999,0,9999,0
1668316902820,ECE 200,058,103643,Zheng; Yang,9999,0,9999,0
1668316903243,ECE 202,A00,103644,Kuzum; Duygu,0,0,0,0
1668316903669,ECE 212BN,A00,103646,Ng; Tse Nga,0,0,0,0
1668316904092,ECE 221,A00,111493,Staff,0,0,0,0
1668316904514,ECE 222B,A00,103647,Lomakin; Vitaliy,0,0,0,0
1668316904937,ECE 230B,A00,103648,Taur; Yuan,0,0,0,0
1668316905360,ECE 238B,A00,103649,Garay; Javier,0,0,0,0
1668316905787,ECE 240B,A00,112900,Fainman; Yeshaiahu,0,0,0,0
1668316906209,ECE 247A,A00,103650,Jokerst; Jesse Vincent,0,0,0,0
1668316906633,ECE 247B,A00,103651,Wang; Joseph,0,0,0,0
1668316907056,ECE 250,A00,103652,Siegel; Paul H.,0,0,0,0
1668316907479,ECE 251A,A00,103654,Rao; Bhaskar D.,0,0,0,0
1668316907902,ECE 257B,A00,103655,Bharadia; Dinesh,0,0,0,0
1668316908329,ECE 258A,A00,103656,Milstein; Laurence B.,0,0,0,0
1668316908755,ECE 260B,A00,103658,Kang; Mingu,0,0,0,0
1668316909183,ECE 264A,A00,103659,Galton; Ian A,0,0,0,0
1668316909609,ECE 265A,A00,103661,Gudem; Prasad S.S.,0,0,0,0
1668316910031,ECE 265D,A00,103662,Gudem; Prasad S.S.,0,0,0,0
1668316910454,ECE 268,A00,103663,Koushanfar; Farinaz,0,0,0,0
1668316910877,ECE 269,A01,103665,Pal; Piya,0,0,0,0
1668316911301,ECE 271B,A00,103666,Vasconcelos; Manuela,0,0,0,0
1668316911728,ECE 276A,A00,103667,Atanasov; Nikolay A.,0,0,0,0
1668316912150,ECE 277,A00,103668,An; Cheolhong,0,0,0,0
1668316912575,ECE 279,A00,117947,Hall; Drew A.,0,0,0,0
1668316913423,ECE 283,A00,103670,Hsueh; Tzu-Chien,0,0,0,0
1668316913850,ECE 284,A00,103671,Turakhia; Yatish Girish,0,0,0,0
1668316914276,ECE 285,A00,103672,Zheng; Yang,0,0,0,0
1668316914276,ECE 285,B00,103673,Sworder; David D.,0,0,0,0
1668316914701,ECE 287,A00,103676,Javidi; Tara,0,0,0,0
1668316915123,MATH 200B,A00,098023,Salehi Golsefidy; Alireza,12,0,15,3
1668316915547,MATH 202B,A00,098024,Rhoades; Brendon Patrick,9,0,15,6
1668316915971,MATH 203B,A00,098025,Oprea; Dragos N.,10,0,15,5
1668316916400,MATH 204B,A00,098026,Sorensen; Claus M,13,0,15,2
1668316916825,MATH 208,A00,098027,Izadi; Elham,7,0,10,3
1668316917247,MATH 209,A00,098028,Pollack; Aaron,10,0,10,0
1668316917676,MATH 211A,A00,112919,Rogalski; Daniel,9,0,10,1
1668316918101,MATH 211B,A00,112920,Seward; Brandon M.,9,0,10,1
1668316918524,MATH 218,A00,098029,Li; Bo,10,0,10,0
1668316918950,MATH 220B,A00,098030,Novak; Jonathan I,11,0,15,4
1668316919376,MATH 221A,A00,098031,Ebenfelt; Peter F,13,0,15,2
1668316919799,MATH 231B,A00,098032,Zlatos; Andrej,12,0,15,3
1668316920222,MATH 240B,A00,098033,Ni; Lei,9,0,15,6
1668316920647,MATH 243,A00,098034,Jekel; David Andrew,10,0,10,0
1668316921071,MATH 245A,A00,098035,Nie; Jiawang,0,0,15,16
1668316921498,MATH 248,A00,098036,Bejenaru; Ioan,10,0,10,0
1668316921921,MATH 250B,A00,098037,Spolaor; Luca,14,0,15,1
1668316922346,MATH 258,A00,098038,Ni; Lei,10,0,10,0
1668316922770,MATH 264B,A00,098041,Rhoades; Brendon Patrick,9,0,15,6
1668316923192,MATH 268,A00,098042,Buss; Samuel R,10,0,10,0
1668316923616,MATH 269,A00,098043,Rhoades; Brendon Patrick,10,0,10,0
1668316924040,MATH 270B,A00,098044,Li; Bo,10,0,15,5
1668316924466,MATH 272B,A00,098045,Holst; Michael J,13,0,15,2
1668316924898,MATH 273A,A00,098046,Tian; Xiaochuan,10,0,15,5
1668316925325,MATH 275,A01,098048,Tian; Xiaochuan,6,0,10,4
1668316925749,MATH 278A,A00,098049,Holst; Michael J,8,0,10,2
1668316926180,MATH 278B,A00,098050,Cloninger; Alexander,10,0,10,0
1668316926604,MATH 278C,A00,098051,Nie; Jiawang,7,0,10,3
1668316927028,MATH 280B,A00,098052,Zheng; Tianyi,8,0,15,7
1668316927454,MATH 281B,A00,098053,Bradic; Jelena,1,0,15,14
1668316927880,MATH 282B,A00,098054,Arias-Castro; Ery,0,0,15,15
1668316928303,MATH 285,A00,098055,Fitzsimmons; Patrick J,0,0,15,17
1668316928729,MATH 287B,A00,098056,Arias-Castro; Ery,2,0,15,13
1668316929156,MATH 288,A00,098057,Agarwal; Pooja,9,0,10,1
1668316929156,MATH 288,B00,098058,Zhang; Danna,8,0,10,2
1668316929156,MATH 288,C00,098059,Williams; Ruth J,9,0,10,1
1668316929580,MATH 290B,A00,098060,Roberts; Justin Deritter,13,0,15,2
1668316930004,MATH 292,A00,098061,Belmont; Eva Kinoshita,10,0,10,0
1668316930428,MATH 295,A00,098062,Suk; Andrew Hoon,48,0,50,2
1668316930852,MATH 296,A00,098063,Novak; Jonathan I,20,0,20,0
1668316931279,MATH 297,001,098064,Gamst; Anthony Collins,9997,0,9999,2
1668317429902,COGS 205,A00,101395,Chiba; Andrea,19,0,20,1
1668317430326,COGS 210B,001,101404,Greene; Deanna Jacquelyn,9998,0,9999,1
1668317430326,COGS 210B,002,101417,Xia; Haijun,9999,0,9999,0
1668317430326,COGS 210B,003,101422,Nitz; Douglas A.,9999,0,9999,0
1668317430326,COGS 210B,004,101423,Hollan; James D.,9998,0,9999,1
1668317430326,COGS 210B,005,101424,Deak; Gedeon O.,9998,0,9999,1
1668317430326,COGS 210B,006,101425,Rossano; Federico,9999,0,9999,0
1668317430750,COGS 211B,A00,101427,Coulson; Seana M,9996,0,9999,3
1668317431179,COGS 220,A00,101428,Hollan; James D.,0,0,25,25
1668317431603,COGS 229,A00,101429,Dow; Steven P,18,0,25,7
1668317432030,COGS 230,A00,101430,Klemmer; Scott R,11,0,17,6
1668317432456,COGS 234,A00,101431,Xia; Haijun,1,0,25,24
1668317432881,COGS 260,A00,101432,Kiyonaga; Anastasia,21,0,25,4
1668317432881,COGS 260,B00,101433,Kirsh; David Joel,15,0,25,10
1668317433305,CSE 202,A00,102371,Impagliazzo; Russell,0,0,0,0
1668317433730,CSE 203B,A01,102373,Cheng; Chung Kuan,0,0,0,0
1668317434153,CSE 208,A00,102374,Micciancio; Daniele,0,0,0,0
1668317434578,CSE 209A,A00,112895,Impagliazzo; Russell,0,0,15,15
1668317435000,CSE 209B,A00,108005,Bellare; Mihir,0,0,0,0
1668317435428,CSE 210,A00,113163,Coblenz; Michael J,0,0,0,0
1668317435852,CSE 219,A00,106111,Dow; Steven P,0,0,20,20
1668317436279,CSE 221,A00,102376,Voelker; Geoffrey M.,0,0,0,0
1668317436705,CSE 224,A01,102378,Porter; George M,0,0,0,0
1668317437131,CSE 229A,A00,102379,Savage; Stefan,0,0,0,0
1668317437557,CSE 229C,A00,102380,Munyaka; Imani N. S.,0,0,0,0
1668317437981,CSE 232B,A00,102382,Deutsch; Alin Bernard,0,0,0,0
1668317438406,CSE 234,A01,112904,Kumar; Arun Kumar,0,0,0,0
1668317438841,CSE 237A,A00,102383,Rosing; Tajana Simunic,0,0,0,0
1668317439265,CSE 239A,A00,102384,Deutsch; Alin Bernard,0,0,0,0
1668317439688,CSE 239B,A00,102385,Polikarpova; Nadezhda,0,0,0,0
1668317440112,CSE 240A,A00,102386,Pannuto; Patrick William,0,0,0,0
1668317440535,CSE 240B,A00,102387,Zhao; Jishen,0,0,0,0
1668317440959,CSE 241A,A00,106406,Kang; Mingu,0,0,0,0
1668317441388,CSE 249B,A00,102388,Kahng; Andrew Byun,0,0,8,8
1668317441813,CSE 251B,A01,102392,Cottrell; Garrison W,0,0,0,0
1668317441813,CSE 251B,A02,102393,Cottrell; Garrison W,0,0,0,0
1668317442237,CSE 252B,A00,102394,Ochoa; Benjamin Lawrence,0,0,0,0
1668317442663,CSE 257,A01,102396,Gao; Sicun,0,0,0,0
1668317443090,CSE 272,A00,102397,Li; Tzumao,0,0,0,0
1668317443513,CSE 274,A00,111323,Chern; Albert Ren-Haur,0,0,0,0
1668317443938,CSE 282,A00,102398,Pevzner; Pavel Arkadjevich,0,0,0,0
1668317444361,CSE 284,A00,114175,Gymrek; Melissa Ann,0,0,0,0
1668317444784,CSE 290,A00,102399,Chandraker; Manmohan Krishna,0,0,0,0
1668317444784,CSE 290,B00,102400,Vaccaro; Kristen Marie,0,0,25,25
1668317444784,CSE 290,C00,102414,Pannuto; Patrick William,0,0,25,25
1668317444784,CSE 290,D00,102427,Pevzner; Pavel Arkadjevich,0,0,0,0
1668317444784,CSE 290,E00,102429,Zhao; Jishen,0,0,0,0
1668317444784,CSE 290,F00,102436,Tullsen; Dean Michael,0,0,0,0
1668317444784,CSE 290,G00,102440,Christensen; Henrik I,0,0,20,20
1668317445211,CSE 291,A00,102443,Su; Hao,0,0,0,0
1668317445211,CSE 291,B00,102448,Polikarpova; Nadezhda,0,0,0,0
1668317445211,CSE 291,C00,102453,Vaccaro; Kristen Marie,0,0,0,0
1668317445211,CSE 291,D00,111343,Savage; Stefan,0,0,0,0
1668317445211,CSE 291,E00,116474,Claffy; Kimberly Claire,0,0,0,0
1668317445211,CSE 291,F00,116479,Pasquale; Joseph,0,0,0,0
1668317445643,CSE 293,001,119111,Bafna; Vineet,9999,0,9999,0
1668317445643,CSE 293,002,119118,Bellare; Mihir,9999,0,9999,0
1668317445643,CSE 293,003,119122,Berg-Kirkpatrick; Taylor D,9999,0,9999,0
1668317445643,CSE 293,004,119135,Christensen; Henrik I,9999,0,9999,0
1668317445643,CSE 293,005,119142,Cottrell; Garrison W,9999,0,9999,0
1668317445643,CSE 293,006,119146,Deutsch; Alin Bernard,9999,0,9999,0
1668317445643,CSE 293,007,119159,Esmaeilzadeh; Hadi,9999,0,9999,0
1668317445643,CSE 293,008,119166,Freund; Yoav,9999,0,9999,0
1668317445643,CSE 293,009,119170,Griswold; William G.,9999,0,9999,0
1668317445643,CSE 293,010,119183,Gymrek; Melissa Ann,9999,0,9999,0
1668317445643,CSE 293,011,119190,Heninger; Nadia A,9999,0,9999,0
1668317445643,CSE 293,012,119230,Impagliazzo; Russell,9999,0,9999,0
1668317445643,CSE 293,013,119232,Jhala; Ranjit,9999,0,9999,0
1668317445643,CSE 293,014,119233,Kahng; Andrew Byun,9999,0,9999,0
1668317445643,CSE 293,015,119298,Kane; Daniel Mertz,9999,0,9999,0
1668317445643,CSE 293,016,119299,Kriegman; David J,9999,0,9999,0
1668317445643,CSE 293,017,119300,Kumar; Arun Kumar,9999,0,9999,0
1668317445643,CSE 293,018,119301,Lerner; Sorin,9999,0,9999,0
1668317445643,CSE 293,019,119302,Lovett; Shachar,9999,0,9999,0
1668317445643,CSE 293,020,119303,McAuley; Julian John,9999,0,9999,0
1668317445643,CSE 293,021,119304,Micciancio; Daniele,9999,0,9999,0
1668317445643,CSE 293,022,119367,Orailoglu; Alex,9999,0,9999,0
1668317445643,CSE 293,023,119382,Paturi; Ramamohan,9999,0,9999,0
1668317445643,CSE 293,024,119404,Polikarpova; Nadezhda,9999,0,9999,0
1668317445643,CSE 293,025,119406,Politz; Joseph Gibbs,9999,0,9999,0
1668317445643,CSE 293,026,119411,Porter; George M,9999,0,9999,0
1668317445643,CSE 293,027,119414,Porter; Leonard Emerson,9999,0,9999,0
1668317445643,CSE 293,028,119416,Ramamoorthi; Ravi,9999,0,9999,0
1668317445643,CSE 293,029,119417,Sahoo; Debashis,9999,0,9999,0
1668317445643,CSE 293,030,119420,Saul; Lawrence,9999,0,9999,0
1668317445643,CSE 293,031,119421,Savage; Stefan,9999,0,9999,0
1668317445643,CSE 293,032,119425,Schulze; Jurgen P.,9999,0,9999,0
1668317445643,CSE 293,033,119426,Snoeren; Alex C.,9999,0,9999,0
1668317445643,CSE 293,034,119428,Shang; Jingbo,9999,0,9999,0
1668317445643,CSE 293,035,119430,Stefan; Deian,9999,0,9999,0
1668317445643,CSE 293,036,119431,Su; Hao,9999,0,9999,0
1668317445643,CSE 293,037,119433,Swanson; Steven James,9999,0,9999,0
1668317445643,CSE 293,038,119435,Tullsen; Dean Michael,9999,0,9999,0
1668317445643,CSE 293,039,119483,Voelker; Geoffrey M.,9999,0,9999,0
1668317445643,CSE 293,040,119537,Zhao; Jishen,9999,0,9999,0
1668317445643,CSE 293,041,119538,Zhou; Yuan-Yuan,9999,0,9999,0
1668317445643,CSE 293,042,119539,Gao; Sicun,9999,0,9999,0
1668317445643,CSE 293,043,119540,Weibel; Nadir,9999,0,9999,0
1668317445643,CSE 293,044,119541,Gupta; Rajesh K.,9999,0,9999,0
1668317445643,CSE 293,045,126410,Vaccaro; Kristen Marie,9999,0,9999,0
1668317445643,CSE 293,046,126411,Klemke; Richard,9999,0,9999,0
1668317446068,CSE 294,A00,102459,Voelker; Geoffrey M.,0,0,0,0
1668317446068,CSE 294,B00,111322,Orailoglu; Alex,0,0,0,0
1668317446496,DSE 201,A00,096914,Deutsch; Alin Bernard,30,0,30,0
1668317446918,DSE 210,A00,096915,Dasgupta; Sanjoy,30,0,30,0
1668317447345,DSE 260A,A00,096916,Altintas De Callaf; Ilkay,30,0,30,0
1668317447779,ECE 200,001,103586,Antipa; Nicholas A,9999,0,9999,0
1668317447779,ECE 200,002,103587,Atanasov; Nikolay A.,9999,0,9999,0
1668317447779,ECE 200,003,103588,Bharadia; Dinesh,9999,0,9999,0
1668317447779,ECE 200,004,103589,Cheng; Chung Kuan,9999,0,9999,0
1668317447779,ECE 200,005,103590,Cosman; Pamela C.,9999,0,9999,0
1668317447779,ECE 200,006,103591,Dayeh; Shadi Ahmad,9999,0,9999,0
1668317447779,ECE 200,007,103592,Fainman; Yeshaiahu,9999,0,9999,0
1668317447779,ECE 200,008,103593,Ford; Joseph Earl,9999,0,9999,0
1668317447779,ECE 200,009,103594,Franceschetti; Massimo,9999,0,9999,0
1668317447779,ECE 200,010,103595,Fullerton; Eric E,9999,0,9999,0
1668317447779,ECE 200,011,103596,Galton; Ian A,9999,0,9999,0
1668317447779,ECE 200,012,103597,Gilja; Vikash,9999,0,9999,0
1668317447779,ECE 200,013,103598,Hall; Drew A.,9999,0,9999,0
1668317447779,ECE 200,014,103599,Hsueh; Tzu-Chien,9999,0,9999,0
1668317447779,ECE 200,015,103600,Javidi; Tara,9999,0,9999,0
1668317447779,ECE 200,016,103601,Kahng; Andrew Byun,9999,0,9999,0
1668317447779,ECE 200,017,103602,Kim; Young-Han,9999,0,9999,0
1668317447779,ECE 200,018,103603,Koushanfar; Farinaz,9999,0,9999,0
1668317447779,ECE 200,019,103604,Kuzum; Duygu,9999,0,9999,0
1668317447779,ECE 200,020,103605,Le; Hanh-Phuc,9999,0,9999,0
1668317447779,ECE 200,021,103606,Lin; Bill,9999,0,9999,0
1668317447779,ECE 200,022,103607,Liu; Zhaowei,9998,0,9999,1
1668317447779,ECE 200,023,103608,Lo; Yu-Hwa,9999,0,9999,0
1668317447779,ECE 200,024,103609,Lomakin; Vitaliy,9999,0,9999,0
1668317447779,ECE 200,025,103610,Mercier; Patrick Philip,9999,0,9999,0
1668317447779,ECE 200,026,103611,Meyer; Florian,9999,0,9999,0
1668317447779,ECE 200,027,103612,Milstein; Laurence B.,9999,0,9999,0
1668317447779,ECE 200,028,103613,Mir Arabbaygi; Siavash,9999,0,9999,0
1668317447779,ECE 200,029,103614,Mookherjea; Shayan,9999,0,9999,0
1668317447779,ECE 200,030,103615,Morris; Karcher William,9999,0,9999,0
1668317447779,ECE 200,031,103616,Ng; Tse Nga,9999,0,9999,0
1668317447779,ECE 200,032,103617,Nguyen; Truong Quang,9999,0,9999,0
1668317447779,ECE 200,033,103618,Nomura; Kenji,9999,0,9999,0
1668317447779,ECE 200,034,103619,Orlitsky; Alon,9999,0,9999,0
1668317447779,ECE 200,035,103620,Pal; Piya,9999,0,9999,0
1668317447779,ECE 200,036,103621,Papen; George C.,9999,0,9999,0
1668317447779,ECE 200,037,103622,Radic; Stojan,9999,0,9999,0
1668317447779,ECE 200,038,103623,Rao; Bhaskar D.,9999,0,9999,0
1668317447779,ECE 200,039,103624,Rao; Ramesh R,9999,0,9999,0
1668317447779,ECE 200,040,103625,Rebeiz; Gabriel,9999,0,9999,0
1668317447779,ECE 200,041,103626,Sanford; John R,9999,0,9999,0
1668317447779,ECE 200,042,103627,Siegel; Paul H.,9999,0,9999,0
1668317447779,ECE 200,043,103628,Sievenpiper; Daniel F.,9999,0,9999,0
1668317447779,ECE 200,044,103629,Sworder; David D.,9999,0,9999,0
1668317447779,ECE 200,045,103630,Taur; Yuan,9999,0,9999,0
1668317447779,ECE 200,046,103631,Touri; Behrouz,9999,0,9999,0
1668317447779,ECE 200,047,103632,Trivedi; Mohan M.,9999,0,9999,0
1668317447779,ECE 200,048,103633,Vasconcelos; Nuno,9999,0,9999,0
1668317447779,ECE 200,049,103634,Wang; Xiaolong,9999,0,9999,0
1668317447779,ECE 200,050,103635,Xie; Pengtao,9999,0,9999,0
1668317447779,ECE 200,051,103636,Yip; Michael,9999,0,9999,0
1668317447779,ECE 200,052,103637,Zeger; Kenneth A.,999,0,999,0
1668317447779,ECE 200,053,103638,Zhang; Xinyu,9999,0,9999,0
1668317447779,ECE 200,054,103639,Turakhia; Yatish Girish,9999,0,9999,0
1668317447779,ECE 200,055,103640,Kang; Mingu,9999,0,9999,0
1668317447779,ECE 200,056,103641,Shi; Yuanyuan,9999,0,9999,0
1668317447779,ECE 200,057,103642,Wang; Edward Jay,9999,0,9999,0
1668317447779,ECE 200,058,103643,Zheng; Yang,9999,0,9999,0
1668317448202,ECE 202,A00,103644,Kuzum; Duygu,0,0,0,0
1668317448626,ECE 212BN,A00,103646,Ng; Tse Nga,0,0,0,0
1668317449052,ECE 221,A00,111493,Staff,0,0,0,0
1668317449477,ECE 222B,A00,103647,Lomakin; Vitaliy,0,0,0,0
1668317449903,ECE 230B,A00,103648,Taur; Yuan,0,0,0,0
1668317450325,ECE 238B,A00,103649,Garay; Javier,0,0,0,0
1668317450749,ECE 240B,A00,112900,Fainman; Yeshaiahu,0,0,0,0
1668317451173,ECE 247A,A00,103650,Jokerst; Jesse Vincent,0,0,0,0
1668317451599,ECE 247B,A00,103651,Wang; Joseph,0,0,0,0
1668317452024,ECE 250,A00,103652,Siegel; Paul H.,0,0,0,0
1668317452446,ECE 251A,A00,103654,Rao; Bhaskar D.,0,0,0,0
1668317452880,ECE 257B,A00,103655,Bharadia; Dinesh,0,0,0,0
1668317453311,ECE 258A,A00,103656,Milstein; Laurence B.,0,0,0,0
1668317453736,ECE 260B,A00,103658,Kang; Mingu,0,0,0,0
1668317454165,ECE 264A,A00,103659,Galton; Ian A,0,0,0,0
1668317454587,ECE 265A,A00,103661,Gudem; Prasad S.S.,0,0,0,0
1668317455013,ECE 265D,A00,103662,Gudem; Prasad S.S.,0,0,0,0
1668317455438,ECE 268,A00,103663,Koushanfar; Farinaz,0,0,0,0
1668317455861,ECE 269,A01,103665,Pal; Piya,0,0,0,0
1668317456286,ECE 271B,A00,103666,Vasconcelos; Manuela,0,0,0,0
1668317456710,ECE 276A,A00,103667,Atanasov; Nikolay A.,0,0,0,0
1668317457133,ECE 277,A00,103668,An; Cheolhong,0,0,0,0
1668317457556,ECE 279,A00,117947,Hall; Drew A.,0,0,0,0
1668317458404,ECE 283,A00,103670,Hsueh; Tzu-Chien,0,0,0,0
1668317458828,ECE 284,A00,103671,Turakhia; Yatish Girish,0,0,0,0
1668317459251,ECE 285,A00,103672,Zheng; Yang,0,0,0,0
1668317459251,ECE 285,B00,103673,Sworder; David D.,0,0,0,0
1668317459676,ECE 287,A00,103676,Javidi; Tara,0,0,0,0
1668317460100,MATH 200B,A00,098023,Salehi Golsefidy; Alireza,12,0,15,3
1668317460523,MATH 202B,A00,098024,Rhoades; Brendon Patrick,9,0,15,6
1668317460950,MATH 203B,A00,098025,Oprea; Dragos N.,10,0,15,5
1668317461376,MATH 204B,A00,098026,Sorensen; Claus M,13,0,15,2
1668317461806,MATH 208,A00,098027,Izadi; Elham,7,0,10,3
1668317462230,MATH 209,A00,098028,Pollack; Aaron,10,0,10,0
1668317462654,MATH 211A,A00,112919,Rogalski; Daniel,9,0,10,1
1668317463103,MATH 211B,A00,112920,Seward; Brandon M.,9,0,10,1
1668317463529,MATH 218,A00,098029,Li; Bo,10,0,10,0
1668317464045,MATH 220B,A00,098030,Novak; Jonathan I,11,0,15,4
1668317464468,MATH 221A,A00,098031,Ebenfelt; Peter F,13,0,15,2
1668317464901,MATH 231B,A00,098032,Zlatos; Andrej,12,0,15,3
1668317465330,MATH 240B,A00,098033,Ni; Lei,9,0,15,6
1668317465758,MATH 243,A00,098034,Jekel; David Andrew,10,0,10,0
1668317466180,MATH 245A,A00,098035,Nie; Jiawang,0,0,15,16
1668317466603,MATH 248,A00,098036,Bejenaru; Ioan,10,0,10,0
1668317467027,MATH 250B,A00,098037,Spolaor; Luca,14,0,15,1
1668317467452,MATH 258,A00,098038,Ni; Lei,10,0,10,0
1668317467875,MATH 264B,A00,098041,Rhoades; Brendon Patrick,9,0,15,6
1668317468301,MATH 268,A00,098042,Buss; Samuel R,10,0,10,0
1668317468723,MATH 269,A00,098043,Rhoades; Brendon Patrick,10,0,10,0
1668317469147,MATH 270B,A00,098044,Li; Bo,10,0,15,5
1668317469575,MATH 272B,A00,098045,Holst; Michael J,13,0,15,2
1668317469999,MATH 273A,A00,098046,Tian; Xiaochuan,10,0,15,5
1668317470426,MATH 275,A01,098048,Tian; Xiaochuan,6,0,10,4
1668317470851,MATH 278A,A00,098049,Holst; Michael J,8,0,10,2
1668317471275,MATH 278B,A00,098050,Cloninger; Alexander,10,0,10,0
1668317471698,MATH 278C,A00,098051,Nie; Jiawang,7,0,10,3
1668317472120,MATH 280B,A00,098052,Zheng; Tianyi,8,0,15,7
1668317472548,MATH 281B,A00,098053,Bradic; Jelena,1,0,15,14
1668317472971,MATH 282B,A00,098054,Arias-Castro; Ery,0,0,15,15
1668317473394,MATH 285,A00,098055,Fitzsimmons; Patrick J,0,0,15,17
1668317473818,MATH 287B,A00,098056,Arias-Castro; Ery,2,0,15,13
1668317474242,MATH 288,A00,098057,Agarwal; Pooja,9,0,10,1
1668317474242,MATH 288,B00,098058,Zhang; Danna,8,0,10,2
1668317474242,MATH 288,C00,098059,Williams; Ruth J,9,0,10,1
1668317474666,MATH 290B,A00,098060,Roberts; Justin Deritter,13,0,15,2
1668317475101,MATH 292,A00,098061,Belmont; Eva Kinoshita,10,0,10,0
1668317475525,MATH 295,A00,098062,Suk; Andrew Hoon,48,0,50,2
1668317475949,MATH 296,A00,098063,Novak; Jonathan I,20,0,20,0
1668317476371,MATH 297,001,098064,Gamst; Anthony Collins,9997,0,9999,2
1668317974980,COGS 205,A00,101395,Chiba; Andrea,19,0,20,1
1668317975405,COGS 210B,001,101404,Greene; Deanna Jacquelyn,9998,0,9999,1
1668317975405,COGS 210B,002,101417,Xia; Haijun,9999,0,9999,0
1668317975405,COGS 210B,003,101422,Nitz; Douglas A.,9999,0,9999,0
1668317975405,COGS 210B,004,101423,Hollan; James D.,9998,0,9999,1
1668317975405,COGS 210B,005,101424,Deak; Gedeon O.,9998,0,9999,1
1668317975405,COGS 210B,006,101425,Rossano; Federico,9999,0,9999,0
1668317975829,COGS 211B,A00,101427,Coulson; Seana M,9996,0,9999,3
1668317976250,COGS 220,A00,101428,Hollan; James D.,0,0,25,25
1668317976673,COGS 229,A00,101429,Dow; Steven P,18,0,25,7
1668317977097,COGS 230,A00,101430,Klemmer; Scott R,11,0,17,6
1668317977522,COGS 234,A00,101431,Xia; Haijun,1,0,25,24
1668317977947,COGS 260,A00,101432,Kiyonaga; Anastasia,21,0,25,4
1668317977947,COGS 260,B00,101433,Kirsh; David Joel,15,0,25,10
1668317978369,CSE 202,A00,102371,Impagliazzo; Russell,0,0,0,0
1668317978801,CSE 203B,A01,102373,Cheng; Chung Kuan,0,0,0,0
1668317979235,CSE 208,A00,102374,Micciancio; Daniele,0,0,0,0
1668317979662,CSE 209A,A00,112895,Impagliazzo; Russell,0,0,15,15
1668317980087,CSE 209B,A00,108005,Bellare; Mihir,0,0,0,0
1668317980512,CSE 210,A00,113163,Coblenz; Michael J,0,0,0,0
1668317980943,CSE 219,A00,106111,Dow; Steven P,0,0,20,20
1668317981367,CSE 221,A00,102376,Voelker; Geoffrey M.,0,0,0,0
1668317981790,CSE 224,A01,102378,Porter; George M,0,0,0,0
1668317982213,CSE 229A,A00,102379,Savage; Stefan,0,0,0,0
1668317982712,CSE 229C,A00,102380,Munyaka; Imani N. S.,0,0,0,0
1668317983139,CSE 232B,A00,102382,Deutsch; Alin Bernard,0,0,0,0
1668317983561,CSE 234,A01,112904,Kumar; Arun Kumar,0,0,0,0
1668317983989,CSE 237A,A00,102383,Rosing; Tajana Simunic,0,0,0,0
1668317984415,CSE 239A,A00,102384,Deutsch; Alin Bernard,0,0,0,0
1668317984837,CSE 239B,A00,102385,Polikarpova; Nadezhda,0,0,0,0
1668317985260,CSE 240A,A00,102386,Pannuto; Patrick William,0,0,0,0
1668317985683,CSE 240B,A00,102387,Zhao; Jishen,0,0,0,0
1668317986109,CSE 241A,A00,106406,Kang; Mingu,0,0,0,0
1668317986531,CSE 249B,A00,102388,Kahng; Andrew Byun,0,0,8,8
1668317986956,CSE 251B,A01,102392,Cottrell; Garrison W,0,0,0,0
1668317986956,CSE 251B,A02,102393,Cottrell; Garrison W,0,0,0,0
1668317987380,CSE 252B,A00,102394,Ochoa; Benjamin Lawrence,0,0,0,0
1668317987805,CSE 257,A01,102396,Gao; Sicun,0,0,0,0
1668317988229,CSE 272,A00,102397,Li; Tzumao,0,0,0,0
1668317988652,CSE 274,A00,111323,Chern; Albert Ren-Haur,0,0,0,0
1668317989076,CSE 282,A00,102398,Pevzner; Pavel Arkadjevich,0,0,0,0
1668317989501,CSE 284,A00,114175,Gymrek; Melissa Ann,0,0,0,0
1668317989927,CSE 290,A00,102399,Chandraker; Manmohan Krishna,0,0,0,0
1668317989927,CSE 290,B00,102400,Vaccaro; Kristen Marie,0,0,25,25
1668317989927,CSE 290,C00,102414,Pannuto; Patrick William,0,0,25,25
1668317989927,CSE 290,D00,102427,Pevzner; Pavel Arkadjevich,0,0,0,0
1668317989927,CSE 290,E00,102429,Zhao; Jishen,0,0,0,0
1668317989927,CSE 290,F00,102436,Tullsen; Dean Michael,0,0,0,0
1668317989927,CSE 290,G00,102440,Christensen; Henrik I,0,0,20,20
1668317990353,CSE 291,A00,102443,Su; Hao,0,0,0,0
1668317990353,CSE 291,B00,102448,Polikarpova; Nadezhda,0,0,0,0
1668317990353,CSE 291,C00,102453,Vaccaro; Kristen Marie,0,0,0,0
1668317990353,CSE 291,D00,111343,Savage; Stefan,0,0,0,0
1668317990353,CSE 291,E00,116474,Claffy; Kimberly Claire,0,0,0,0
1668317990353,CSE 291,F00,116479,Pasquale; Joseph,0,0,0,0
1668317990802,CSE 293,001,119111,Bafna; Vineet,9999,0,9999,0
1668317990802,CSE 293,002,119118,Bellare; Mihir,9999,0,9999,0
1668317990802,CSE 293,003,119122,Berg-Kirkpatrick; Taylor D,9999,0,9999,0
1668317990802,CSE 293,004,119135,Christensen; Henrik I,9999,0,9999,0
1668317990802,CSE 293,005,119142,Cottrell; Garrison W,9999,0,9999,0
1668317990802,CSE 293,006,119146,Deutsch; Alin Bernard,9999,0,9999,0
1668317990802,CSE 293,007,119159,Esmaeilzadeh; Hadi,9999,0,9999,0
1668317990802,CSE 293,008,119166,Freund; Yoav,9999,0,9999,0
1668317990802,CSE 293,009,119170,Griswold; William G.,9999,0,9999,0
1668317990802,CSE 293,010,119183,Gymrek; Melissa Ann,9999,0,9999,0
1668317990802,CSE 293,011,119190,Heninger; Nadia A,9999,0,9999,0
1668317990802,CSE 293,012,119230,Impagliazzo; Russell,9999,0,9999,0
1668317990802,CSE 293,013,119232,Jhala; Ranjit,9999,0,9999,0
1668317990802,CSE 293,014,119233,Kahng; Andrew Byun,9999,0,9999,0
1668317990802,CSE 293,015,119298,Kane; Daniel Mertz,9999,0,9999,0
1668317990802,CSE 293,016,119299,Kriegman; David J,9999,0,9999,0
1668317990802,CSE 293,017,119300,Kumar; Arun Kumar,9999,0,9999,0
1668317990802,CSE 293,018,119301,Lerner; Sorin,9999,0,9999,0
1668317990802,CSE 293,019,119302,Lovett; Shachar,9999,0,9999,0
1668317990802,CSE 293,020,119303,McAuley; Julian John,9999,0,9999,0
1668317990802,CSE 293,021,119304,Micciancio; Daniele,9999,0,9999,0
1668317990802,CSE 293,022,119367,Orailoglu; Alex,9999,0,9999,0
1668317990802,CSE 293,023,119382,Paturi; Ramamohan,9999,0,9999,0
1668317990802,CSE 293,024,119404,Polikarpova; Nadezhda,9999,0,9999,0
1668317990802,CSE 293,025,119406,Politz; Joseph Gibbs,9999,0,9999,0
1668317990802,CSE 293,026,119411,Porter; George M,9999,0,9999,0
1668317990802,CSE 293,027,119414,Porter; Leonard Emerson,9999,0,9999,0
1668317990802,CSE 293,028,119416,Ramamoorthi; Ravi,9999,0,9999,0
1668317990802,CSE 293,029,119417,Sahoo; Debashis,9999,0,9999,0
1668317990802,CSE 293,030,119420,Saul; Lawrence,9999,0,9999,0
1668317990802,CSE 293,031,119421,Savage; Stefan,9999,0,9999,0
1668317990802,CSE 293,032,119425,Schulze; Jurgen P.,9999,0,9999,0
1668317990802,CSE 293,033,119426,Snoeren; Alex C.,9999,0,9999,0
1668317990802,CSE 293,034,119428,Shang; Jingbo,9999,0,9999,0
1668317990802,CSE 293,035,119430,Stefan; Deian,9999,0,9999,0
1668317990802,CSE 293,036,119431,Su; Hao,9999,0,9999,0
1668317990802,CSE 293,037,119433,Swanson; Steven James,9999,0,9999,0
1668317990802,CSE 293,038,119435,Tullsen; Dean Michael,9999,0,9999,0
1668317990802,CSE 293,039,119483,Voelker; Geoffrey M.,9999,0,9999,0
1668317990802,CSE 293,040,119537,Zhao; Jishen,9999,0,9999,0
1668317990802,CSE 293,041,119538,Zhou; Yuan-Yuan,9999,0,9999,0
1668317990802,CSE 293,042,119539,Gao; Sicun,9999,0,9999,0
1668317990802,CSE 293,043,119540,Weibel; Nadir,9999,0,9999,0
1668317990802,CSE 293,044,119541,Gupta; Rajesh K.,9999,0,9999,0
1668317990802,CSE 293,045,126410,Vaccaro; Kristen Marie,9999,0,9999,0
1668317990802,CSE 293,046,126411,Klemke; Richard,9999,0,9999,0
1668317991224,CSE 294,A00,102459,Voelker; Geoffrey M.,0,0,0,0
1668317991224,CSE 294,B00,111322,Orailoglu; Alex,0,0,0,0
1668317991645,DSE 201,A00,096914,Deutsch; Alin Bernard,30,0,30,0
1668317992072,DSE 210,A00,096915,Dasgupta; Sanjoy,30,0,30,0
1668317992497,DSE 260A,A00,096916,Altintas De Callaf; Ilkay,30,0,30,0
1668317992923,ECE 200,001,103586,Antipa; Nicholas A,9999,0,9999,0
1668317992923,ECE 200,002,103587,Atanasov; Nikolay A.,9999,0,9999,0
1668317992923,ECE 200,003,103588,Bharadia; Dinesh,9999,0,9999,0
1668317992923,ECE 200,004,103589,Cheng; Chung Kuan,9999,0,9999,0
1668317992923,ECE 200,005,103590,Cosman; Pamela C.,9999,0,9999,0
1668317992923,ECE 200,006,103591,Dayeh; Shadi Ahmad,9999,0,9999,0
1668317992923,ECE 200,007,103592,Fainman; Yeshaiahu,9999,0,9999,0
1668317992923,ECE 200,008,103593,Ford; Joseph Earl,9999,0,9999,0
1668317992923,ECE 200,009,103594,Franceschetti; Massimo,9999,0,9999,0
1668317992923,ECE 200,010,103595,Fullerton; Eric E,9999,0,9999,0
1668317992923,ECE 200,011,103596,Galton; Ian A,9999,0,9999,0
1668317992923,ECE 200,012,103597,Gilja; Vikash,9999,0,9999,0
1668317992923,ECE 200,013,103598,Hall; Drew A.,9999,0,9999,0
1668317992923,ECE 200,014,103599,Hsueh; Tzu-Chien,9999,0,9999,0
1668317992923,ECE 200,015,103600,Javidi; Tara,9999,0,9999,0
1668317992923,ECE 200,016,103601,Kahng; Andrew Byun,9999,0,9999,0
1668317992923,ECE 200,017,103602,Kim; Young-Han,9999,0,9999,0
1668317992923,ECE 200,018,103603,Koushanfar; Farinaz,9999,0,9999,0
1668317992923,ECE 200,019,103604,Kuzum; Duygu,9999,0,9999,0
1668317992923,ECE 200,020,103605,Le; Hanh-Phuc,9999,0,9999,0
1668317992923,ECE 200,021,103606,Lin; Bill,9999,0,9999,0
1668317992923,ECE 200,022,103607,Liu; Zhaowei,9998,0,9999,1
1668317992923,ECE 200,023,103608,Lo; Yu-Hwa,9999,0,9999,0
1668317992923,ECE 200,024,103609,Lomakin; Vitaliy,9999,0,9999,0
1668317992923,ECE 200,025,103610,Mercier; Patrick Philip,9999,0,9999,0
1668317992923,ECE 200,026,103611,Meyer; Florian,9999,0,9999,0
1668317992923,ECE 200,027,103612,Milstein; Laurence B.,9999,0,9999,0
1668317992923,ECE 200,028,103613,Mir Arabbaygi; Siavash,9999,0,9999,0
1668317992923,ECE 200,029,103614,Mookherjea; Shayan,9999,0,9999,0
1668317992923,ECE 200,030,103615,Morris; Karcher William,9999,0,9999,0
1668317992923,ECE 200,031,103616,Ng; Tse Nga,9999,0,9999,0
1668317992923,ECE 200,032,103617,Nguyen; Truong Quang,9999,0,9999,0
1668317992923,ECE 200,033,103618,Nomura; Kenji,9999,0,9999,0
1668317992923,ECE 200,034,103619,Orlitsky; Alon,9999,0,9999,0
1668317992923,ECE 200,035,103620,Pal; Piya,9999,0,9999,0
1668317992923,ECE 200,036,103621,Papen; George C.,9999,0,9999,0
1668317992923,ECE 200,037,103622,Radic; Stojan,9999,0,9999,0
1668317992923,ECE 200,038,103623,Rao; Bhaskar D.,9999,0,9999,0
1668317992923,ECE 200,039,103624,Rao; Ramesh R,9999,0,9999,0
1668317992923,ECE 200,040,103625,Rebeiz; Gabriel,9999,0,9999,0
1668317992923,ECE 200,041,103626,Sanford; John R,9999,0,9999,0
1668317992923,ECE 200,042,103627,Siegel; Paul H.,9999,0,9999,0
1668317992923,ECE 200,043,103628,Sievenpiper; Daniel F.,9999,0,9999,0
1668317992923,ECE 200,044,103629,Sworder; David D.,9999,0,9999,0
1668317992923,ECE 200,045,103630,Taur; Yuan,9999,0,9999,0
1668317992923,ECE 200,046,103631,Touri; Behrouz,9999,0,9999,0
1668317992923,ECE 200,047,103632,Trivedi; Mohan M.,9999,0,9999,0
1668317992923,ECE 200,048,103633,Vasconcelos; Nuno,9999,0,9999,0
1668317992923,ECE 200,049,103634,Wang; Xiaolong,9999,0,9999,0
1668317992923,ECE 200,050,103635,Xie; Pengtao,9999,0,9999,0
1668317992923,ECE 200,051,103636,Yip; Michael,9999,0,9999,0
1668317992923,ECE 200,052,103637,Zeger; Kenneth A.,999,0,999,0
1668317992923,ECE 200,053,103638,Zhang; Xinyu,9999,0,9999,0
1668317992923,ECE 200,054,103639,Turakhia; Yatish Girish,9999,0,9999,0
1668317992923,ECE 200,055,103640,Kang; Mingu,9999,0,9999,0
1668317992923,ECE 200,056,103641,Shi; Yuanyuan,9999,0,9999,0
1668317992923,ECE 200,057,103642,Wang; Edward Jay,9999,0,9999,0
1668317992923,ECE 200,058,103643,Zheng; Yang,9999,0,9999,0
1668317993348,ECE 202,A00,103644,Kuzum; Duygu,0,0,0,0
1668317993781,ECE 212BN,A00,103646,Ng; Tse Nga,0,0,0,0
1668317994205,ECE 221,A00,111493,Staff,0,0,0,0
1668317994629,ECE 222B,A00,103647,Lomakin; Vitaliy,0,0,0,0
1668317995052,ECE 230B,A00,103648,Taur; Yuan,0,0,0,0
1668317995479,ECE 238B,A00,103649,Garay; Javier,0,0,0,0
1668317995903,ECE 240B,A00,112900,Fainman; Yeshaiahu,0,0,0,0
1668317996330,ECE 247A,A00,103650,Jokerst; Jesse Vincent,0,0,0,0
1668317996756,ECE 247B,A00,103651,Wang; Joseph,0,0,0,0
1668317997180,ECE 250,A00,103652,Siegel; Paul H.,0,0,0,0
1668317997604,ECE 251A,A00,103654,Rao; Bhaskar D.,0,0,0,0
1668317998029,ECE 257B,A00,103655,Bharadia; Dinesh,0,0,0,0
1668317998452,ECE 258A,A00,103656,Milstein; Laurence B.,0,0,0,0
1668317998876,ECE 260B,A00,103658,Kang; Mingu,0,0,0,0
1668317999306,ECE 264A,A00,103659,Galton; Ian A,0,0,0,0
1668317999732,ECE 265A,A00,103661,Gudem; Prasad S.S.,0,0,0,0
1668318000157,ECE 265D,A00,103662,Gudem; Prasad S.S.,0,0,0,0
1668318000583,ECE 268,A00,103663,Koushanfar; Farinaz,0,0,0,0
1668318001009,ECE 269,A01,103665,Pal; Piya,0,0,0,0
1668318001435,ECE 271B,A00,103666,Vasconcelos; Manuela,0,0,0,0
1668318001859,ECE 276A,A00,103667,Atanasov; Nikolay A.,0,0,0,0
1668318002286,ECE 277,A00,103668,An; Cheolhong,0,0,0,0
1668318002711,ECE 279,A00,117947,Hall; Drew A.,0,0,0,0
1668318003558,ECE 283,A00,103670,Hsueh; Tzu-Chien,0,0,0,0
1668318003985,ECE 284,A00,103671,Turakhia; Yatish Girish,0,0,0,0
1668318004413,ECE 285,A00,103672,Zheng; Yang,0,0,0,0
1668318004413,ECE 285,B00,103673,Sworder; David D.,0,0,0,0
1668318004839,ECE 287,A00,103676,Javidi; Tara,0,0,0,0
1668318005262,MATH 200B,A00,098023,Salehi Golsefidy; Alireza,12,0,15,3
1668318005686,MATH 202B,A00,098024,Rhoades; Brendon Patrick,9,0,15,6
1668318006114,MATH 203B,A00,098025,Oprea; Dragos N.,10,0,15,5
1668318006541,MATH 204B,A00,098026,Sorensen; Claus M,13,0,15,2
1668318006964,MATH 208,A00,098027,Izadi; Elham,7,0,10,3
1668318007389,MATH 209,A00,098028,Pollack; Aaron,10,0,10,0
1668318007814,MATH 211A,A00,112919,Rogalski; Daniel,9,0,10,1
1668318008241,MATH 211B,A00,112920,Seward; Brandon M.,9,0,10,1
1668318008663,MATH 218,A00,098029,Li; Bo,10,0,10,0
1668318009088,MATH 220B,A00,098030,Novak; Jonathan I,11,0,15,4
1668318009515,MATH 221A,A00,098031,Ebenfelt; Peter F,13,0,15,2
1668318009947,MATH 231B,A00,098032,Zlatos; Andrej,12,0,15,3
1668318010372,MATH 240B,A00,098033,Ni; Lei,9,0,15,6
1668318010797,MATH 243,A00,098034,Jekel; David Andrew,10,0,10,0
1668318011222,MATH 245A,A00,098035,Nie; Jiawang,0,0,15,16
1668318011646,MATH 248,A00,098036,Bejenaru; Ioan,10,0,10,0
1668318012070,MATH 250B,A00,098037,Spolaor; Luca,14,0,15,1
1668318012494,MATH 258,A00,098038,Ni; Lei,10,0,10,0
1668318012917,MATH 264B,A00,098041,Rhoades; Brendon Patrick,9,0,15,6
1668318013342,MATH 268,A00,098042,Buss; Samuel R,10,0,10,0
1668318013767,MATH 269,A00,098043,Rhoades; Brendon Patrick,10,0,10,0
1668318014190,MATH 270B,A00,098044,Li; Bo,10,0,15,5
1668318014614,MATH 272B,A00,098045,Holst; Michael J,13,0,15,2
1668318015037,MATH 273A,A00,098046,Tian; Xiaochuan,10,0,15,5
1668318015496,MATH 275,A01,098048,Tian; Xiaochuan,6,0,10,4
1668318015929,MATH 278A,A00,098049,Holst; Michael J,8,0,10,2
1668318016358,MATH 278B,A00,098050,Cloninger; Alexander,10,0,10,0
1668318016793,MATH 278C,A00,098051,Nie; Jiawang,7,0,10,3
1668318017219,MATH 280B,A00,098052,Zheng; Tianyi,8,0,15,7
1668318017643,MATH 281B,A00,098053,Bradic; Jelena,1,0,15,14
1668318018068,MATH 282B,A00,098054,Arias-Castro; Ery,0,0,15,15
1668318018491,MATH 285,A00,098055,Fitzsimmons; Patrick J,0,0,15,17
1668318018916,MATH 287B,A00,098056,Arias-Castro; Ery,2,0,15,13
1668318019343,MATH 288,A00,098057,Agarwal; Pooja,9,0,10,1
1668318019343,MATH 288,B00,098058,Zhang; Danna,8,0,10,2
1668318019343,MATH 288,C00,098059,Williams; Ruth J,9,0,10,1
1668318019768,MATH 290B,A00,098060,Roberts; Justin Deritter,13,0,15,2
1668318020195,MATH 292,A00,098061,Belmont; Eva Kinoshita,10,0,10,0
1668318020621,MATH 295,A00,098062,Suk; Andrew Hoon,48,0,50,2
1668318021044,MATH 296,A00,098063,Novak; Jonathan I,20,0,20,0
1668318021468,MATH 297,001,098064,Gamst; Anthony Collins,9997,0,9999,2
1668318519669,COGS 205,A00,101395,Chiba; Andrea,19,0,20,1
1668318520100,COGS 210B,001,101404,Greene; Deanna Jacquelyn,9998,0,9999,1
1668318520100,COGS 210B,002,101417,Xia; Haijun,9999,0,9999,0
1668318520100,COGS 210B,003,101422,Nitz; Douglas A.,9999,0,9999,0
1668318520100,COGS 210B,004,101423,Hollan; James D.,9998,0,9999,1
1668318520100,COGS 210B,005,101424,Deak; Gedeon O.,9998,0,9999,1
1668318520100,COGS 210B,006,101425,Rossano; Federico,9999,0,9999,0
1668318520523,COGS 211B,A00,101427,Coulson; Seana M,9996,0,9999,3
1668318520947,COGS 220,A00,101428,Hollan; James D.,0,0,25,25
1668318521371,COGS 229,A00,101429,Dow; Steven P,18,0,25,7
1668318521796,COGS 230,A00,101430,Klemmer; Scott R,11,0,17,6
1668318522220,COGS 234,A00,101431,Xia; Haijun,1,0,25,24
1668318522643,COGS 260,A00,101432,Kiyonaga; Anastasia,21,0,25,4
1668318522643,COGS 260,B00,101433,Kirsh; David Joel,15,0,25,10
1668318523069,CSE 202,A00,102371,Impagliazzo; Russell,0,0,0,0
1668318523491,CSE 203B,A01,102373,Cheng; Chung Kuan,0,0,0,0
1668318523916,CSE 208,A00,102374,Micciancio; Daniele,0,0,0,0
1668318524342,CSE 209A,A00,112895,Impagliazzo; Russell,0,0,15,15
1668318524767,CSE 209B,A00,108005,Bellare; Mihir,0,0,0,0
1668318525190,CSE 210,A00,113163,Coblenz; Michael J,0,0,0,0
1668318525611,CSE 219,A00,106111,Dow; Steven P,0,0,20,20
1668318526042,CSE 221,A00,102376,Voelker; Geoffrey M.,0,0,0,0
1668318526467,CSE 224,A01,102378,Porter; George M,0,0,0,0
1668318526897,CSE 229A,A00,102379,Savage; Stefan,0,0,0,0
1668318527320,CSE 229C,A00,102380,Munyaka; Imani N. S.,0,0,0,0
1668318527744,CSE 232B,A00,102382,Deutsch; Alin Bernard,0,0,0,0
1668318528167,CSE 234,A01,112904,Kumar; Arun Kumar,0,0,0,0
1668318528592,CSE 237A,A00,102383,Rosing; Tajana Simunic,0,0,0,0
1668318529016,CSE 239A,A00,102384,Deutsch; Alin Bernard,0,0,0,0
1668318529440,CSE 239B,A00,102385,Polikarpova; Nadezhda,0,0,0,0
1668318529867,CSE 240A,A00,102386,Pannuto; Patrick William,0,0,0,0
1668318530291,CSE 240B,A00,102387,Zhao; Jishen,0,0,0,0
1668318530719,CSE 241A,A00,106406,Kang; Mingu,0,0,0,0
1668318531145,CSE 249B,A00,102388,Kahng; Andrew Byun,0,0,8,8
1668318531571,CSE 251B,A01,102392,Cottrell; Garrison W,0,0,0,0
1668318531571,CSE 251B,A02,102393,Cottrell; Garrison W,0,0,0,0
1668318531995,CSE 252B,A00,102394,Ochoa; Benjamin Lawrence,0,0,0,0
1668318532420,CSE 257,A01,102396,Gao; Sicun,0,0,0,0
1668318532845,CSE 272,A00,102397,Li; Tzumao,0,0,0,0
1668318533270,CSE 274,A00,111323,Chern; Albert Ren-Haur,0,0,0,0
1668318533695,CSE 282,A00,102398,Pevzner; Pavel Arkadjevich,0,0,0,0
1668318534118,CSE 284,A00,114175,Gymrek; Melissa Ann,0,0,0,0
1668318534543,CSE 290,A00,102399,Chandraker; Manmohan Krishna,0,0,0,0
1668318534543,CSE 290,B00,102400,Vaccaro; Kristen Marie,0,0,25,25
1668318534543,CSE 290,C00,102414,Pannuto; Patrick William,0,0,25,25
1668318534543,CSE 290,D00,102427,Pevzner; Pavel Arkadjevich,0,0,0,0
1668318534543,CSE 290,E00,102429,Zhao; Jishen,0,0,0,0
1668318534543,CSE 290,F00,102436,Tullsen; Dean Michael,0,0,0,0
1668318534543,CSE 290,G00,102440,Christensen; Henrik I,0,0,20,20
1668318534971,CSE 291,A00,102443,Su; Hao,0,0,0,0
1668318534971,CSE 291,B00,102448,Polikarpova; Nadezhda,0,0,0,0
1668318534971,CSE 291,C00,102453,Vaccaro; Kristen Marie,0,0,0,0
1668318534971,CSE 291,D00,111343,Savage; Stefan,0,0,0,0
1668318534971,CSE 291,E00,116474,Claffy; Kimberly Claire,0,0,0,0
1668318534971,CSE 291,F00,116479,Pasquale; Joseph,0,0,0,0
1668318535399,CSE 293,001,119111,Bafna; Vineet,9999,0,9999,0
1668318535399,CSE 293,002,119118,Bellare; Mihir,9999,0,9999,0
1668318535399,CSE 293,003,119122,Berg-Kirkpatrick; Taylor D,9999,0,9999,0
1668318535399,CSE 293,004,119135,Christensen; Henrik I,9999,0,9999,0
1668318535399,CSE 293,005,119142,Cottrell; Garrison W,9999,0,9999,0
1668318535399,CSE 293,006,119146,Deutsch; Alin Bernard,9999,0,9999,0
1668318535399,CSE 293,007,119159,Esmaeilzadeh; Hadi,9999,0,9999,0
1668318535399,CSE 293,008,119166,Freund; Yoav,9999,0,9999,0
1668318535399,CSE 293,009,119170,Griswold; William G.,9999,0,9999,0
1668318535399,CSE 293,010,119183,Gymrek; Melissa Ann,9999,0,9999,0
1668318535399,CSE 293,011,119190,Heninger; Nadia A,9999,0,9999,0
1668318535399,CSE 293,012,119230,Impagliazzo; Russell,9999,0,9999,0
1668318535399,CSE 293,013,119232,Jhala; Ranjit,9999,0,9999,0
1668318535399,CSE 293,014,119233,Kahng; Andrew Byun,9999,0,9999,0
1668318535399,CSE 293,015,119298,Kane; Daniel Mertz,9999,0,9999,0
1668318535399,CSE 293,016,119299,Kriegman; David J,9999,0,9999,0
1668318535399,CSE 293,017,119300,Kumar; Arun Kumar,9999,0,9999,0
1668318535399,CSE 293,018,119301,Lerner; Sorin,9999,0,9999,0
1668318535399,CSE 293,019,119302,Lovett; Shachar,9999,0,9999,0
1668318535399,CSE 293,020,119303,McAuley; Julian John,9999,0,9999,0
1668318535399,CSE 293,021,119304,Micciancio; Daniele,9999,0,9999,0
1668318535399,CSE 293,022,119367,Orailoglu; Alex,9999,0,9999,0
1668318535399,CSE 293,023,119382,Paturi; Ramamohan,9999,0,9999,0
1668318535399,CSE 293,024,119404,Polikarpova; Nadezhda,9999,0,9999,0
1668318535399,CSE 293,025,119406,Politz; Joseph Gibbs,9999,0,9999,0
1668318535399,CSE 293,026,119411,Porter; George M,9999,0,9999,0
1668318535399,CSE 293,027,119414,Porter; Leonard Emerson,9999,0,9999,0
1668318535399,CSE 293,028,119416,Ramamoorthi; Ravi,9999,0,9999,0
1668318535399,CSE 293,029,119417,Sahoo; Debashis,9999,0,9999,0
1668318535399,CSE 293,030,119420,Saul; Lawrence,9999,0,9999,0
1668318535399,CSE 293,031,119421,Savage; Stefan,9999,0,9999,0
1668318535399,CSE 293,032,119425,Schulze; Jurgen P.,9999,0,9999,0
1668318535399,CSE 293,033,119426,Snoeren; Alex C.,9999,0,9999,0
1668318535399,CSE 293,034,119428,Shang; Jingbo,9999,0,9999,0
1668318535399,CSE 293,035,119430,Stefan; Deian,9999,0,9999,0
1668318535399,CSE 293,036,119431,Su; Hao,9999,0,9999,0
1668318535399,CSE 293,037,119433,Swanson; Steven James,9999,0,9999,0
1668318535399,CSE 293,038,119435,Tullsen; Dean Michael,9999,0,9999,0
1668318535399,CSE 293,039,119483,Voelker; Geoffrey M.,9999,0,9999,0
1668318535399,CSE 293,040,119537,Zhao; Jishen,9999,0,9999,0
1668318535399,CSE 293,041,119538,Zhou; Yuan-Yuan,9999,0,9999,0
1668318535399,CSE 293,042,119539,Gao; Sicun,9999,0,9999,0
1668318535399,CSE 293,043,119540,Weibel; Nadir,9999,0,9999,0
1668318535399,CSE 293,044,119541,Gupta; Rajesh K.,9999,0,9999,0
1668318535399,CSE 293,045,126410,Vaccaro; Kristen Marie,9999,0,9999,0
1668318535399,CSE 293,046,126411,Klemke; Richard,9999,0,9999,0
1668318535826,CSE 294,A00,102459,Voelker; Geoffrey M.,0,0,0,0
1668318535826,CSE 294,B00,111322,Orailoglu; Alex,0,0,0,0
1668318536253,DSE 201,A00,096914,Deutsch; Alin Bernard,30,0,30,0
1668318536690,DSE 210,A00,096915,Dasgupta; Sanjoy,30,0,30,0
1668318537114,DSE 260A,A00,096916,Altintas De Callaf; Ilkay,30,0,30,0
1668318537545,ECE 200,001,103586,Antipa; Nicholas A,9999,0,9999,0
1668318537545,ECE 200,002,103587,Atanasov; Nikolay A.,9999,0,9999,0
1668318537545,ECE 200,003,103588,Bharadia; Dinesh,9999,0,9999,0
1668318537545,ECE 200,004,103589,Cheng; Chung Kuan,9999,0,9999,0
1668318537545,ECE 200,005,103590,Cosman; Pamela C.,9999,0,9999,0
1668318537545,ECE 200,006,103591,Dayeh; Shadi Ahmad,9999,0,9999,0
1668318537545,ECE 200,007,103592,Fainman; Yeshaiahu,9999,0,9999,0
1668318537545,ECE 200,008,103593,Ford; Joseph Earl,9999,0,9999,0
1668318537545,ECE 200,009,103594,Franceschetti; Massimo,9999,0,9999,0
1668318537545,ECE 200,010,103595,Fullerton; Eric E,9999,0,9999,0
1668318537545,ECE 200,011,103596,Galton; Ian A,9999,0,9999,0
1668318537545,ECE 200,012,103597,Gilja; Vikash,9999,0,9999,0
1668318537545,ECE 200,013,103598,Hall; Drew A.,9999,0,9999,0
1668318537545,ECE 200,014,103599,Hsueh; Tzu-Chien,9999,0,9999,0
1668318537545,ECE 200,015,103600,Javidi; Tara,9999,0,9999,0
1668318537545,ECE 200,016,103601,Kahng; Andrew Byun,9999,0,9999,0
1668318537545,ECE 200,017,103602,Kim; Young-Han,9999,0,9999,0
1668318537545,ECE 200,018,103603,Koushanfar; Farinaz,9999,0,9999,0
1668318537545,ECE 200,019,103604,Kuzum; Duygu,9999,0,9999,0
1668318537545,ECE 200,020,103605,Le; Hanh-Phuc,9999,0,9999,0
1668318537545,ECE 200,021,103606,Lin; Bill,9999,0,9999,0
1668318537545,ECE 200,022,103607,Liu; Zhaowei,9998,0,9999,1
1668318537545,ECE 200,023,103608,Lo; Yu-Hwa,9999,0,9999,0
1668318537545,ECE 200,024,103609,Lomakin; Vitaliy,9999,0,9999,0
1668318537545,ECE 200,025,103610,Mercier; Patrick Philip,9999,0,9999,0
1668318537545,ECE 200,026,103611,Meyer; Florian,9999,0,9999,0
1668318537545,ECE 200,027,103612,Milstein; Laurence B.,9999,0,9999,0
1668318537545,ECE 200,028,103613,Mir Arabbaygi; Siavash,9999,0,9999,0
1668318537545,ECE 200,029,103614,Mookherjea; Shayan,9999,0,9999,0
1668318537545,ECE 200,030,103615,Morris; Karcher William,9999,0,9999,0
1668318537545,ECE 200,031,103616,Ng; Tse Nga,9999,0,9999,0
1668318537545,ECE 200,032,103617,Nguyen; Truong Quang,9999,0,9999,0
1668318537545,ECE 200,033,103618,Nomura; Kenji,9999,0,9999,0
1668318537545,ECE 200,034,103619,Orlitsky; Alon,9999,0,9999,0
1668318537545,ECE 200,035,103620,Pal; Piya,9999,0,9999,0
1668318537545,ECE 200,036,103621,Papen; George C.,9999,0,9999,0
1668318537545,ECE 200,037,103622,Radic; Stojan,9999,0,9999,0
1668318537545,ECE 200,038,103623,Rao; Bhaskar D.,9999,0,9999,0
1668318537545,ECE 200,039,103624,Rao; Ramesh R,9999,0,9999,0
1668318537545,ECE 200,040,103625,Rebeiz; Gabriel,9999,0,9999,0
1668318537545,ECE 200,041,103626,Sanford; John R,9999,0,9999,0
1668318537545,ECE 200,042,103627,Siegel; Paul H.,9999,0,9999,0
1668318537545,ECE 200,043,103628,Sievenpiper; Daniel F.,9999,0,9999,0
1668318537545,ECE 200,044,103629,Sworder; David D.,9999,0,9999,0
1668318537545,ECE 200,045,103630,Taur; Yuan,9999,0,9999,0
1668318537545,ECE 200,046,103631,Touri; Behrouz,9999,0,9999,0
1668318537545,ECE 200,047,103632,Trivedi; Mohan M.,9999,0,9999,0
1668318537545,ECE 200,048,103633,Vasconcelos; Nuno,9999,0,9999,0
1668318537545,ECE 200,049,103634,Wang; Xiaolong,9999,0,9999,0
1668318537545,ECE 200,050,103635,Xie; Pengtao,9999,0,9999,0
1668318537545,ECE 200,051,103636,Yip; Michael,9999,0,9999,0
1668318537545,ECE 200,052,103637,Zeger; Kenneth A.,999,0,999,0
1668318537545,ECE 200,053,103638,Zhang; Xinyu,9999,0,9999,0
1668318537545,ECE 200,054,103639,Turakhia; Yatish Girish,9999,0,9999,0
1668318537545,ECE 200,055,103640,Kang; Mingu,9999,0,9999,0
1668318537545,ECE 200,056,103641,Shi; Yuanyuan,9999,0,9999,0
1668318537545,ECE 200,057,103642,Wang; Edward Jay,9999,0,9999,0
1668318537545,ECE 200,058,103643,Zheng; Yang,9999,0,9999,0
1668318537970,ECE 202,A00,103644,Kuzum; Duygu,0,0,0,0
1668318538394,ECE 212BN,A00,103646,Ng; Tse Nga,0,0,0,0
1668318538823,ECE 221,A00,111493,Staff,0,0,0,0
1668318539250,ECE 222B,A00,103647,Lomakin; Vitaliy,0,0,0,0
1668318539676,ECE 230B,A00,103648,Taur; Yuan,0,0,0,0
1668318540100,ECE 238B,A00,103649,Garay; Javier,0,0,0,0
1668318540527,ECE 240B,A00,112900,Fainman; Yeshaiahu,0,0,0,0
1668318540950,ECE 247A,A00,103650,Jokerst; Jesse Vincent,0,0,0,0
1668318541374,ECE 247B,A00,103651,Wang; Joseph,0,0,0,0
1668318541798,ECE 250,A00,103652,Siegel; Paul H.,0,0,0,0
1668318542220,ECE 251A,A00,103654,Rao; Bhaskar D.,0,0,0,0
1668318542650,ECE 257B,A00,103655,Bharadia; Dinesh,0,0,0,0
1668318543078,ECE 258A,A00,103656,Milstein; Laurence B.,0,0,0,0
1668318543502,ECE 260B,A00,103658,Kang; Mingu,0,0,0,0
1668318544023,ECE 264A,A00,103659,Galton; Ian A,0,0,0,0
1668318544444,ECE 265A,A00,103661,Gudem; Prasad S.S.,0,0,0,0
1668318544865,ECE 265D,A00,103662,Gudem; Prasad S.S.,0,0,0,0
1668318545292,ECE 268,A00,103663,Koushanfar; Farinaz,0,0,0,0
1668318545719,ECE 269,A01,103665,Pal; Piya,0,0,0,0
1668318546145,ECE 271B,A00,103666,Vasconcelos; Manuela,0,0,0,0
1668318546571,ECE 276A,A00,103667,Atanasov; Nikolay A.,0,0,0,0
1668318546997,ECE 277,A00,103668,An; Cheolhong,0,0,0,0
1668318547426,ECE 279,A00,117947,Hall; Drew A.,0,0,0,0
1668318548276,ECE 283,A00,103670,Hsueh; Tzu-Chien,0,0,0,0
1668318548699,ECE 284,A00,103671,Turakhia; Yatish Girish,0,0,0,0
1668318549122,ECE 285,A00,103672,Zheng; Yang,0,0,0,0
1668318549122,ECE 285,B00,103673,Sworder; David D.,0,0,0,0
1668318549544,ECE 287,A00,103676,Javidi; Tara,0,0,0,0
1668318549969,MATH 200B,A00,098023,Salehi Golsefidy; Alireza,12,0,15,3
1668318550394,MATH 202B,A00,098024,Rhoades; Brendon Patrick,9,0,15,6
1668318550819,MATH 203B,A00,098025,Oprea; Dragos N.,10,0,15,5
1668318551241,MATH 204B,A00,098026,Sorensen; Claus M,13,0,15,2
1668318551668,MATH 208,A00,098027,Izadi; Elham,7,0,10,3
1668318552095,MATH 209,A00,098028,Pollack; Aaron,10,0,10,0
1668318552520,MATH 211A,A00,112919,Rogalski; Daniel,9,0,10,1
1668318552943,MATH 211B,A00,112920,Seward; Brandon M.,9,0,10,1
1668318553367,MATH 218,A00,098029,Li; Bo,10,0,10,0
1668318553794,MATH 220B,A00,098030,Novak; Jonathan I,11,0,15,4
1668318554221,MATH 221A,A00,098031,Ebenfelt; Peter F,13,0,15,2
1668318554644,MATH 231B,A00,098032,Zlatos; Andrej,12,0,15,3
1668318555068,MATH 240B,A00,098033,Ni; Lei,9,0,15,6
1668318555492,MATH 243,A00,098034,Jekel; David Andrew,10,0,10,0
1668318555915,MATH 245A,A00,098035,Nie; Jiawang,0,0,15,16
1668318556340,MATH 248,A00,098036,Bejenaru; Ioan,10,0,10,0
1668318556767,MATH 250B,A00,098037,Spolaor; Luca,14,0,15,1
1668318557190,MATH 258,A00,098038,Ni; Lei,10,0,10,0
1668318557618,MATH 264B,A00,098041,Rhoades; Brendon Patrick,9,0,15,6
1668318558041,MATH 268,A00,098042,Buss; Samuel R,10,0,10,0
1668318558471,MATH 269,A00,098043,Rhoades; Brendon Patrick,10,0,10,0
1668318558893,MATH 270B,A00,098044,Li; Bo,10,0,15,5
1668318559317,MATH 272B,A00,098045,Holst; Michael J,13,0,15,2
1668318559745,MATH 273A,A00,098046,Tian; Xiaochuan,10,0,15,5
1668318560169,MATH 275,A01,098048,Tian; Xiaochuan,6,0,10,4
1668318560595,MATH 278A,A00,098049,Holst; Michael J,8,0,10,2
1668318561018,MATH 278B,A00,098050,Cloninger; Alexander,10,0,10,0
1668318561443,MATH 278C,A00,098051,Nie; Jiawang,7,0,10,3
1668318561867,MATH 280B,A00,098052,Zheng; Tianyi,8,0,15,7
1668318562294,MATH 281B,A00,098053,Bradic; Jelena,1,0,15,14
1668318562717,MATH 282B,A00,098054,Arias-Castro; Ery,0,0,15,15
1668318563144,MATH 285,A00,098055,Fitzsimmons; Patrick J,0,0,15,17
1668318563571,MATH 287B,A00,098056,Arias-Castro; Ery,2,0,15,13
1668318563998,MATH 288,A00,098057,Agarwal; Pooja,9,0,10,1
1668318563998,MATH 288,B00,098058,Zhang; Danna,8,0,10,2
1668318563998,MATH 288,C00,098059,Williams; Ruth J,9,0,10,1
1668318564440,MATH 290B,A00,098060,Roberts; Justin Deritter,13,0,15,2
1668318564867,MATH 292,A00,098061,Belmont; Eva Kinoshita,10,0,10,0
1668318565289,MATH 295,A00,098062,Suk; Andrew Hoon,48,0,50,2
1668318565714,MATH 296,A00,098063,Novak; Jonathan I,20,0,20,0
1668318566138,MATH 297,001,098064,Gamst; Anthony Collins,9997,0,9999,2
1668319064380,COGS 205,A00,101395,Chiba; Andrea,19,0,20,1
1668319064803,COGS 210B,001,101404,Greene; Deanna Jacquelyn,9998,0,9999,1
1668319064803,COGS 210B,002,101417,Xia; Haijun,9999,0,9999,0
1668319064803,COGS 210B,003,101422,Nitz; Douglas A.,9999,0,9999,0
1668319064803,COGS 210B,004,101423,Hollan; James D.,9998,0,9999,1
1668319064803,COGS 210B,005,101424,Deak; Gedeon O.,9998,0,9999,1
1668319064803,COGS 210B,006,101425,Rossano; Federico,9999,0,9999,0
1668319065226,COGS 211B,A00,101427,Coulson; Seana M,9996,0,9999,3
1668319065650,COGS 220,A00,101428,Hollan; James D.,0,0,25,25
1668319066075,COGS 229,A00,101429,Dow; Steven P,18,0,25,7
1668319066498,COGS 230,A00,101430,Klemmer; Scott R,11,0,17,6
1668319066923,COGS 234,A00,101431,Xia; Haijun,1,0,25,24
1668319067349,COGS 260,A00,101432,Kiyonaga; Anastasia,21,0,25,4
1668319067349,COGS 260,B00,101433,Kirsh; David Joel,15,0,25,10
1668319067771,CSE 202,A00,102371,Impagliazzo; Russell,0,0,0,0
1668319068194,CSE 203B,A01,102373,Cheng; Chung Kuan,0,0,0,0
1668319068621,CSE 208,A00,102374,Micciancio; Daniele,0,0,0,0
1668319069046,CSE 209A,A00,112895,Impagliazzo; Russell,0,0,15,15
1668319069472,CSE 209B,A00,108005,Bellare; Mihir,0,0,0,0
1668319069897,CSE 210,A00,113163,Coblenz; Michael J,0,0,0,0
1668319070322,CSE 219,A00,106111,Dow; Steven P,0,0,20,20
1668319070744,CSE 221,A00,102376,Voelker; Geoffrey M.,0,0,0,0
1668319071168,CSE 224,A01,102378,Porter; George M,0,0,0,0
1668319071592,CSE 229A,A00,102379,Savage; Stefan,0,0,0,0
1668319072018,CSE 229C,A00,102380,Munyaka; Imani N. S.,0,0,0,0
1668319072445,CSE 232B,A00,102382,Deutsch; Alin Bernard,0,0,0,0
1668319072870,CSE 234,A01,112904,Kumar; Arun Kumar,0,0,0,0
1668319073295,CSE 237A,A00,102383,Rosing; Tajana Simunic,0,0,0,0
1668319073718,CSE 239A,A00,102384,Deutsch; Alin Bernard,0,0,0,0
1668319074145,CSE 239B,A00,102385,Polikarpova; Nadezhda,0,0,0,0
1668319074569,CSE 240A,A00,102386,Pannuto; Patrick William,0,0,0,0
1668319074995,CSE 240B,A00,102387,Zhao; Jishen,0,0,0,0
1668319075418,CSE 241A,A00,106406,Kang; Mingu,0,0,0,0
1668319075842,CSE 249B,A00,102388,Kahng; Andrew Byun,0,0,8,8
1668319076267,CSE 251B,A01,102392,Cottrell; Garrison W,0,0,0,0
1668319076267,CSE 251B,A02,102393,Cottrell; Garrison W,0,0,0,0
1668319076694,CSE 252B,A00,102394,Ochoa; Benjamin Lawrence,0,0,0,0
1668319077117,CSE 257,A01,102396,Gao; Sicun,0,0,0,0
1668319077541,CSE 272,A00,102397,Li; Tzumao,0,0,0,0
1668319077964,CSE 274,A00,111323,Chern; Albert Ren-Haur,0,0,0,0
1668319078387,CSE 282,A00,102398,Pevzner; Pavel Arkadjevich,0,0,0,0
1668319078813,CSE 284,A00,114175,Gymrek; Melissa Ann,0,0,0,0
1668319079237,CSE 290,A00,102399,Chandraker; Manmohan Krishna,0,0,0,0
1668319079237,CSE 290,B00,102400,Vaccaro; Kristen Marie,0,0,25,25
1668319079237,CSE 290,C00,102414,Pannuto; Patrick William,0,0,25,25
1668319079237,CSE 290,D00,102427,Pevzner; Pavel Arkadjevich,0,0,0,0
1668319079237,CSE 290,E00,102429,Zhao; Jishen,0,0,0,0
1668319079237,CSE 290,F00,102436,Tullsen; Dean Michael,0,0,0,0
1668319079237,CSE 290,G00,102440,Christensen; Henrik I,0,0,20,20
1668319079671,CSE 291,A00,102443,Su; Hao,0,0,0,0
1668319079671,CSE 291,B00,102448,Polikarpova; Nadezhda,0,0,0,0
1668319079671,CSE 291,C00,102453,Vaccaro; Kristen Marie,0,0,0,0
1668319079671,CSE 291,D00,111343,Savage; Stefan,0,0,0,0
1668319079671,CSE 291,E00,116474,Claffy; Kimberly Claire,0,0,0,0
1668319079671,CSE 291,F00,116479,Pasquale; Joseph,0,0,0,0
1668319080127,CSE 293,001,119111,Bafna; Vineet,9999,0,9999,0
1668319080127,CSE 293,002,119118,Bellare; Mihir,9999,0,9999,0
1668319080127,CSE 293,003,119122,Berg-Kirkpatrick; Taylor D,9999,0,9999,0
1668319080127,CSE 293,004,119135,Christensen; Henrik I,9999,0,9999,0
1668319080127,CSE 293,005,119142,Cottrell; Garrison W,9999,0,9999,0
1668319080127,CSE 293,006,119146,Deutsch; Alin Bernard,9999,0,9999,0
1668319080127,CSE 293,007,119159,Esmaeilzadeh; Hadi,9999,0,9999,0
1668319080127,CSE 293,008,119166,Freund; Yoav,9999,0,9999,0
1668319080127,CSE 293,009,119170,Griswold; William G.,9999,0,9999,0
1668319080127,CSE 293,010,119183,Gymrek; Melissa Ann,9999,0,9999,0
1668319080127,CSE 293,011,119190,Heninger; Nadia A,9999,0,9999,0
1668319080127,CSE 293,012,119230,Impagliazzo; Russell,9999,0,9999,0
1668319080127,CSE 293,013,119232,Jhala; Ranjit,9999,0,9999,0
1668319080127,CSE 293,014,119233,Kahng; Andrew Byun,9999,0,9999,0
1668319080127,CSE 293,015,119298,Kane; Daniel Mertz,9999,0,9999,0
1668319080127,CSE 293,016,119299,Kriegman; David J,9999,0,9999,0
1668319080127,CSE 293,017,119300,Kumar; Arun Kumar,9999,0,9999,0
1668319080127,CSE 293,018,119301,Lerner; Sorin,9999,0,9999,0
1668319080127,CSE 293,019,119302,Lovett; Shachar,9999,0,9999,0
1668319080127,CSE 293,020,119303,McAuley; Julian John,9999,0,9999,0
1668319080127,CSE 293,021,119304,Micciancio; Daniele,9999,0,9999,0
1668319080127,CSE 293,022,119367,Orailoglu; Alex,9999,0,9999,0
1668319080127,CSE 293,023,119382,Paturi; Ramamohan,9999,0,9999,0
1668319080127,CSE 293,024,119404,Polikarpova; Nadezhda,9999,0,9999,0
1668319080127,CSE 293,025,119406,Politz; Joseph Gibbs,9999,0,9999,0
1668319080127,CSE 293,026,119411,Porter; George M,9999,0,9999,0
1668319080127,CSE 293,027,119414,Porter; Leonard Emerson,9999,0,9999,0
1668319080127,CSE 293,028,119416,Ramamoorthi; Ravi,9999,0,9999,0
1668319080127,CSE 293,029,119417,Sahoo; Debashis,9999,0,9999,0
1668319080127,CSE 293,030,119420,Saul; Lawrence,9999,0,9999,0
1668319080127,CSE 293,031,119421,Savage; Stefan,9999,0,9999,0
1668319080127,CSE 293,032,119425,Schulze; Jurgen P.,9999,0,9999,0
1668319080127,CSE 293,033,119426,Snoeren; Alex C.,9999,0,9999,0
1668319080127,CSE 293,034,119428,Shang; Jingbo,9999,0,9999,0
1668319080127,CSE 293,035,119430,Stefan; Deian,9999,0,9999,0
1668319080127,CSE 293,036,119431,Su; Hao,9999,0,9999,0
1668319080127,CSE 293,037,119433,Swanson; Steven James,9999,0,9999,0
1668319080127,CSE 293,038,119435,Tullsen; Dean Michael,9999,0,9999,0
1668319080127,CSE 293,039,119483,Voelker; Geoffrey M.,9999,0,9999,0
1668319080127,CSE 293,040,119537,Zhao; Jishen,9999,0,9999,0
1668319080127,CSE 293,041,119538,Zhou; Yuan-Yuan,9999,0,9999,0
1668319080127,CSE 293,042,119539,Gao; Sicun,9999,0,9999,0
1668319080127,CSE 293,043,119540,Weibel; Nadir,9999,0,9999,0
1668319080127,CSE 293,044,119541,Gupta; Rajesh K.,9999,0,9999,0
1668319080127,CSE 293,045,126410,Vaccaro; Kristen Marie,9999,0,9999,0
1668319080127,CSE 293,046,126411,Klemke; Richard,9999,0,9999,0
1668319080551,CSE 294,A00,102459,Voelker; Geoffrey M.,0,0,0,0
1668319080551,CSE 294,B00,111322,Orailoglu; Alex,0,0,0,0
1668319080975,DSE 201,A00,096914,Deutsch; Alin Bernard,30,0,30,0
1668319081399,DSE 210,A00,096915,Dasgupta; Sanjoy,30,0,30,0
1668319081822,DSE 260A,A00,096916,Altintas De Callaf; Ilkay,30,0,30,0
1668319082260,ECE 200,001,103586,Antipa; Nicholas A,9999,0,9999,0
1668319082260,ECE 200,002,103587,Atanasov; Nikolay A.,9999,0,9999,0
1668319082260,ECE 200,003,103588,Bharadia; Dinesh,9999,0,9999,0
1668319082260,ECE 200,004,103589,Cheng; Chung Kuan,9999,0,9999,0
1668319082260,ECE 200,005,103590,Cosman; Pamela C.,9999,0,9999,0
1668319082260,ECE 200,006,103591,Dayeh; Shadi Ahmad,9999,0,9999,0
1668319082260,ECE 200,007,103592,Fainman; Yeshaiahu,9999,0,9999,0
1668319082260,ECE 200,008,103593,Ford; Joseph Earl,9999,0,9999,0
1668319082260,ECE 200,009,103594,Franceschetti; Massimo,9999,0,9999,0
1668319082260,ECE 200,010,103595,Fullerton; Eric E,9999,0,9999,0
1668319082260,ECE 200,011,103596,Galton; Ian A,9999,0,9999,0
1668319082260,ECE 200,012,103597,Gilja; Vikash,9999,0,9999,0
1668319082260,ECE 200,013,103598,Hall; Drew A.,9999,0,9999,0
1668319082260,ECE 200,014,103599,Hsueh; Tzu-Chien,9999,0,9999,0
1668319082260,ECE 200,015,103600,Javidi; Tara,9999,0,9999,0
1668319082260,ECE 200,016,103601,Kahng; Andrew Byun,9999,0,9999,0
1668319082260,ECE 200,017,103602,Kim; Young-Han,9999,0,9999,0
1668319082260,ECE 200,018,103603,Koushanfar; Farinaz,9999,0,9999,0
1668319082260,ECE 200,019,103604,Kuzum; Duygu,9999,0,9999,0
1668319082260,ECE 200,020,103605,Le; Hanh-Phuc,9999,0,9999,0
1668319082260,ECE 200,021,103606,Lin; Bill,9999,0,9999,0
1668319082260,ECE 200,022,103607,Liu; Zhaowei,9998,0,9999,1
1668319082260,ECE 200,023,103608,Lo; Yu-Hwa,9999,0,9999,0
1668319082260,ECE 200,024,103609,Lomakin; Vitaliy,9999,0,9999,0
1668319082260,ECE 200,025,103610,Mercier; Patrick Philip,9999,0,9999,0
1668319082260,ECE 200,026,103611,Meyer; Florian,9999,0,9999,0
1668319082260,ECE 200,027,103612,Milstein; Laurence B.,9999,0,9999,0
1668319082260,ECE 200,028,103613,Mir Arabbaygi; Siavash,9999,0,9999,0
1668319082260,ECE 200,029,103614,Mookherjea; Shayan,9999,0,9999,0
1668319082260,ECE 200,030,103615,Morris; Karcher William,9999,0,9999,0
1668319082260,ECE 200,031,103616,Ng; Tse Nga,9999,0,9999,0
1668319082260,ECE 200,032,103617,Nguyen; Truong Quang,9999,0,9999,0
1668319082260,ECE 200,033,103618,Nomura; Kenji,9999,0,9999,0
1668319082260,ECE 200,034,103619,Orlitsky; Alon,9999,0,9999,0
1668319082260,ECE 200,035,103620,Pal; Piya,9999,0,9999,0
1668319082260,ECE 200,036,103621,Papen; George C.,9999,0,9999,0
1668319082260,ECE 200,037,103622,Radic; Stojan,9999,0,9999,0
1668319082260,ECE 200,038,103623,Rao; Bhaskar D.,9999,0,9999,0
1668319082260,ECE 200,039,103624,Rao; Ramesh R,9999,0,9999,0
1668319082260,ECE 200,040,103625,Rebeiz; Gabriel,9999,0,9999,0
1668319082260,ECE 200,041,103626,Sanford; John R,9999,0,9999,0
1668319082260,ECE 200,042,103627,Siegel; Paul H.,9999,0,9999,0
1668319082260,ECE 200,043,103628,Sievenpiper; Daniel F.,9999,0,9999,0
1668319082260,ECE 200,044,103629,Sworder; David D.,9999,0,9999,0
1668319082260,ECE 200,045,103630,Taur; Yuan,9999,0,9999,0
1668319082260,ECE 200,046,103631,Touri; Behrouz,9999,0,9999,0
1668319082260,ECE 200,047,103632,Trivedi; Mohan M.,9999,0,9999,0
1668319082260,ECE 200,048,103633,Vasconcelos; Nuno,9999,0,9999,0
1668319082260,ECE 200,049,103634,Wang; Xiaolong,9999,0,9999,0
1668319082260,ECE 200,050,103635,Xie; Pengtao,9999,0,9999,0
1668319082260,ECE 200,051,103636,Yip; Michael,9999,0,9999,0
1668319082260,ECE 200,052,103637,Zeger; Kenneth A.,999,0,999,0
1668319082260,ECE 200,053,103638,Zhang; Xinyu,9999,0,9999,0
1668319082260,ECE 200,054,103639,Turakhia; Yatish Girish,9999,0,9999,0
1668319082260,ECE 200,055,103640,Kang; Mingu,9999,0,9999,0
1668319082260,ECE 200,056,103641,Shi; Yuanyuan,9999,0,9999,0
1668319082260,ECE 200,057,103642,Wang; Edward Jay,9999,0,9999,0
1668319082260,ECE 200,058,103643,Zheng; Yang,9999,0,9999,0
1668319082687,ECE 202,A00,103644,Kuzum; Duygu,0,0,0,0
1668319083112,ECE 212BN,A00,103646,Ng; Tse Nga,0,0,0,0
1668319083535,ECE 221,A00,111493,Staff,0,0,0,0
1668319083959,ECE 222B,A00,103647,Lomakin; Vitaliy,0,0,0,0
1668319084382,ECE 230B,A00,103648,Taur; Yuan,0,0,0,0
1668319084804,ECE 238B,A00,103649,Garay; Javier,0,0,0,0
1668319085227,ECE 240B,A00,112900,Fainman; Yeshaiahu,0,0,0,0
1668319085648,ECE 247A,A00,103650,Jokerst; Jesse Vincent,0,0,0,0
1668319086074,ECE 247B,A00,103651,Wang; Joseph,0,0,0,0
1668319086497,ECE 250,A00,103652,Siegel; Paul H.,0,0,0,0
1668319086923,ECE 251A,A00,103654,Rao; Bhaskar D.,0,0,0,0
1668319087347,ECE 257B,A00,103655,Bharadia; Dinesh,0,0,0,0
1668319087775,ECE 258A,A00,103656,Milstein; Laurence B.,0,0,0,0
1668319088203,ECE 260B,A00,103658,Kang; Mingu,0,0,0,0
1668319088627,ECE 264A,A00,103659,Galton; Ian A,0,0,0,0
1668319089052,ECE 265A,A00,103661,Gudem; Prasad S.S.,0,0,0,0
1668319089480,ECE 265D,A00,103662,Gudem; Prasad S.S.,0,0,0,0
1668319089906,ECE 268,A00,103663,Koushanfar; Farinaz,0,0,0,0
1668319090331,ECE 269,A01,103665,Pal; Piya,0,0,0,0
1668319090756,ECE 271B,A00,103666,Vasconcelos; Manuela,0,0,0,0
1668319091182,ECE 276A,A00,103667,Atanasov; Nikolay A.,0,0,0,0
1668319091605,ECE 277,A00,103668,An; Cheolhong,0,0,0,0
1668319092027,ECE 279,A00,117947,Hall; Drew A.,0,0,0,0
1668319092872,ECE 283,A00,103670,Hsueh; Tzu-Chien,0,0,0,0
1668319093301,ECE 284,A00,103671,Turakhia; Yatish Girish,0,0,0,0
1668319093727,ECE 285,A00,103672,Zheng; Yang,0,0,0,0
1668319093727,ECE 285,B00,103673,Sworder; David D.,0,0,0,0
1668319094149,ECE 287,A00,103676,Javidi; Tara,0,0,0,0
1668319094571,MATH 200B,A00,098023,Salehi Golsefidy; Alireza,12,0,15,3
1668319094997,MATH 202B,A00,098024,Rhoades; Brendon Patrick,9,0,15,6
1668319095421,MATH 203B,A00,098025,Oprea; Dragos N.,10,0,15,5
1668319095845,MATH 204B,A00,098026,Sorensen; Claus M,13,0,15,2
1668319096271,MATH 208,A00,098027,Izadi; Elham,7,0,10,3
1668319096696,MATH 209,A00,098028,Pollack; Aaron,10,0,10,0
1668319097119,MATH 211A,A00,112919,Rogalski; Daniel,9,0,10,1
1668319097544,MATH 211B,A00,112920,Seward; Brandon M.,9,0,10,1
1668319097967,MATH 218,A00,098029,Li; Bo,10,0,10,0
1668319098390,MATH 220B,A00,098030,Novak; Jonathan I,11,0,15,4
1668319098813,MATH 221A,A00,098031,Ebenfelt; Peter F,13,0,15,2
1668319099239,MATH 231B,A00,098032,Zlatos; Andrej,12,0,15,3
1668319099663,MATH 240B,A00,098033,Ni; Lei,9,0,15,6
1668319100097,MATH 243,A00,098034,Jekel; David Andrew,10,0,10,0
1668319100519,MATH 245A,A00,098035,Nie; Jiawang,0,0,15,16
1668319100941,MATH 248,A00,098036,Bejenaru; Ioan,10,0,10,0
1668319101368,MATH 250B,A00,098037,Spolaor; Luca,14,0,15,1
1668319101791,MATH 258,A00,098038,Ni; Lei,10,0,10,0
1668319102216,MATH 264B,A00,098041,Rhoades; Brendon Patrick,9,0,15,6
1668319102638,MATH 268,A00,098042,Buss; Samuel R,10,0,10,0
1668319103062,MATH 269,A00,098043,Rhoades; Brendon Patrick,10,0,10,0
1668319103486,MATH 270B,A00,098044,Li; Bo,10,0,15,5
1668319103912,MATH 272B,A00,098045,Holst; Michael J,13,0,15,2
1668319104342,MATH 273A,A00,098046,Tian; Xiaochuan,10,0,15,5
1668319104768,MATH 275,A01,098048,Tian; Xiaochuan,6,0,10,4
1668319105269,MATH 278A,A00,098049,Holst; Michael J,8,0,10,2
1668319105696,MATH 278B,A00,098050,Cloninger; Alexander,10,0,10,0
1668319106120,MATH 278C,A00,098051,Nie; Jiawang,7,0,10,3
1668319106542,MATH 280B,A00,098052,Zheng; Tianyi,8,0,15,7
1668319106970,MATH 281B,A00,098053,Bradic; Jelena,1,0,15,14
1668319107397,MATH 282B,A00,098054,Arias-Castro; Ery,0,0,15,15
1668319107820,MATH 285,A00,098055,Fitzsimmons; Patrick J,0,0,15,17
1668319108245,MATH 287B,A00,098056,Arias-Castro; Ery,2,0,15,13
1668319108675,MATH 288,A00,098057,Agarwal; Pooja,9,0,10,1
1668319108675,MATH 288,B00,098058,Zhang; Danna,8,0,10,2
1668319108675,MATH 288,C00,098059,Williams; Ruth J,9,0,10,1
1668319109101,MATH 290B,A00,098060,Roberts; Justin Deritter,13,0,15,2
1668319109526,MATH 292,A00,098061,Belmont; Eva Kinoshita,10,0,10,0
1668319109950,MATH 295,A00,098062,Suk; Andrew Hoon,48,0,50,2
1668319110373,MATH 296,A00,098063,Novak; Jonathan I,20,0,20,0
1668319110797,MATH 297,001,098064,Gamst; Anthony Collins,9997,0,9999,2
1668319609810,COGS 205,A00,101395,Chiba; Andrea,19,0,20,1
1668319610235,COGS 210B,001,101404,Greene; Deanna Jacquelyn,9998,0,9999,1
1668319610235,COGS 210B,002,101417,Xia; Haijun,9999,0,9999,0
1668319610235,COGS 210B,003,101422,Nitz; Douglas A.,9999,0,9999,0
1668319610235,COGS 210B,004,101423,Hollan; James D.,9998,0,9999,1
1668319610235,COGS 210B,005,101424,Deak; Gedeon O.,9998,0,9999,1
1668319610235,COGS 210B,006,101425,Rossano; Federico,9999,0,9999,0
1668319610668,COGS 211B,A00,101427,Coulson; Seana M,9996,0,9999,3
1668319611094,COGS 220,A00,101428,Hollan; James D.,0,0,25,25
1668319611517,COGS 229,A00,101429,Dow; Steven P,18,0,25,7
1668319611940,COGS 230,A00,101430,Klemmer; Scott R,11,0,17,6
1668319612366,COGS 234,A00,101431,Xia; Haijun,1,0,25,24
1668319612790,COGS 260,A00,101432,Kiyonaga; Anastasia,21,0,25,4
1668319612790,COGS 260,B00,101433,Kirsh; David Joel,15,0,25,10
1668319613218,CSE 202,A00,102371,Impagliazzo; Russell,0,0,0,0
1668319613643,CSE 203B,A01,102373,Cheng; Chung Kuan,0,0,0,0
1668319614065,CSE 208,A00,102374,Micciancio; Daniele,0,0,0,0
1668319614491,CSE 209A,A00,112895,Impagliazzo; Russell,0,0,15,15
1668319614914,CSE 209B,A00,108005,Bellare; Mihir,0,0,0,0
1668319615337,CSE 210,A00,113163,Coblenz; Michael J,0,0,0,0
1668319615763,CSE 219,A00,106111,Dow; Steven P,0,0,20,20
1668319616188,CSE 221,A00,102376,Voelker; Geoffrey M.,0,0,0,0
1668319616615,CSE 224,A01,102378,Porter; George M,0,0,0,0
1668319617039,CSE 229A,A00,102379,Savage; Stefan,0,0,0,0
1668319617464,CSE 229C,A00,102380,Munyaka; Imani N. S.,0,0,0,0
1668319617890,CSE 232B,A00,102382,Deutsch; Alin Bernard,0,0,0,0
1668319618313,CSE 234,A01,112904,Kumar; Arun Kumar,0,0,0,0
1668319618736,CSE 237A,A00,102383,Rosing; Tajana Simunic,0,0,0,0
1668319619159,CSE 239A,A00,102384,Deutsch; Alin Bernard,0,0,0,0
1668319619583,CSE 239B,A00,102385,Polikarpova; Nadezhda,0,0,0,0
1668319620006,CSE 240A,A00,102386,Pannuto; Patrick William,0,0,0,0
1668319620430,CSE 240B,A00,102387,Zhao; Jishen,0,0,0,0
1668319620870,CSE 241A,A00,106406,Kang; Mingu,0,0,0,0
1668319621291,CSE 249B,A00,102388,Kahng; Andrew Byun,0,0,8,8
1668319621718,CSE 251B,A01,102392,Cottrell; Garrison W,0,0,0,0
1668319621718,CSE 251B,A02,102393,Cottrell; Garrison W,0,0,0,0
1668319622147,CSE 252B,A00,102394,Ochoa; Benjamin Lawrence,0,0,0,0
1668319622572,CSE 257,A01,102396,Gao; Sicun,0,0,0,0
1668319622996,CSE 272,A00,102397,Li; Tzumao,0,0,0,0
1668319623419,CSE 274,A00,111323,Chern; Albert Ren-Haur,0,0,0,0
1668319623844,CSE 282,A00,102398,Pevzner; Pavel Arkadjevich,0,0,0,0
1668319624343,CSE 284,A00,114175,Gymrek; Melissa Ann,0,0,0,0
1668319624770,CSE 290,A00,102399,Chandraker; Manmohan Krishna,0,0,0,0
1668319624770,CSE 290,B00,102400,Vaccaro; Kristen Marie,0,0,25,25
1668319624770,CSE 290,C00,102414,Pannuto; Patrick William,0,0,25,25
1668319624770,CSE 290,D00,102427,Pevzner; Pavel Arkadjevich,0,0,0,0
1668319624770,CSE 290,E00,102429,Zhao; Jishen,0,0,0,0
1668319624770,CSE 290,F00,102436,Tullsen; Dean Michael,0,0,0,0
1668319624770,CSE 290,G00,102440,Christensen; Henrik I,0,0,20,20
1668319625194,CSE 291,A00,102443,Su; Hao,0,0,0,0
1668319625194,CSE 291,B00,102448,Polikarpova; Nadezhda,0,0,0,0
1668319625194,CSE 291,C00,102453,Vaccaro; Kristen Marie,0,0,0,0
1668319625194,CSE 291,D00,111343,Savage; Stefan,0,0,0,0
1668319625194,CSE 291,E00,116474,Claffy; Kimberly Claire,0,0,0,0
1668319625194,CSE 291,F00,116479,Pasquale; Joseph,0,0,0,0
1668319625631,CSE 293,001,119111,Bafna; Vineet,9999,0,9999,0
1668319625631,CSE 293,002,119118,Bellare; Mihir,9999,0,9999,0
1668319625631,CSE 293,003,119122,Berg-Kirkpatrick; Taylor D,9999,0,9999,0
1668319625631,CSE 293,004,119135,Christensen; Henrik I,9999,0,9999,0
1668319625631,CSE 293,005,119142,Cottrell; Garrison W,9999,0,9999,0
1668319625631,CSE 293,006,119146,Deutsch; Alin Bernard,9999,0,9999,0
1668319625631,CSE 293,007,119159,Esmaeilzadeh; Hadi,9999,0,9999,0
1668319625631,CSE 293,008,119166,Freund; Yoav,9999,0,9999,0
1668319625631,CSE 293,009,119170,Griswold; William G.,9999,0,9999,0
1668319625631,CSE 293,010,119183,Gymrek; Melissa Ann,9999,0,9999,0
1668319625631,CSE 293,011,119190,Heninger; Nadia A,9999,0,9999,0
1668319625631,CSE 293,012,119230,Impagliazzo; Russell,9999,0,9999,0
1668319625631,CSE 293,013,119232,Jhala; Ranjit,9999,0,9999,0
1668319625631,CSE 293,014,119233,Kahng; Andrew Byun,9999,0,9999,0
1668319625631,CSE 293,015,119298,Kane; Daniel Mertz,9999,0,9999,0
1668319625631,CSE 293,016,119299,Kriegman; David J,9999,0,9999,0
1668319625631,CSE 293,017,119300,Kumar; Arun Kumar,9999,0,9999,0
1668319625631,CSE 293,018,119301,Lerner; Sorin,9999,0,9999,0
1668319625631,CSE 293,019,119302,Lovett; Shachar,9999,0,9999,0
1668319625631,CSE 293,020,119303,McAuley; Julian John,9999,0,9999,0
1668319625631,CSE 293,021,119304,Micciancio; Daniele,9999,0,9999,0
1668319625631,CSE 293,022,119367,Orailoglu; Alex,9999,0,9999,0
1668319625631,CSE 293,023,119382,Paturi; Ramamohan,9999,0,9999,0
1668319625631,CSE 293,024,119404,Polikarpova; Nadezhda,9999,0,9999,0
1668319625631,CSE 293,025,119406,Politz; Joseph Gibbs,9999,0,9999,0
1668319625631,CSE 293,026,119411,Porter; George M,9999,0,9999,0
1668319625631,CSE 293,027,119414,Porter; Leonard Emerson,9999,0,9999,0
1668319625631,CSE 293,028,119416,Ramamoorthi; Ravi,9999,0,9999,0
1668319625631,CSE 293,029,119417,Sahoo; Debashis,9999,0,9999,0
1668319625631,CSE 293,030,119420,Saul; Lawrence,9999,0,9999,0
1668319625631,CSE 293,031,119421,Savage; Stefan,9999,0,9999,0
1668319625631,CSE 293,032,119425,Schulze; Jurgen P.,9999,0,9999,0
1668319625631,CSE 293,033,119426,Snoeren; Alex C.,9999,0,9999,0
1668319625631,CSE 293,034,119428,Shang; Jingbo,9999,0,9999,0
1668319625631,CSE 293,035,119430,Stefan; Deian,9999,0,9999,0
1668319625631,CSE 293,036,119431,Su; Hao,9999,0,9999,0
1668319625631,CSE 293,037,119433,Swanson; Steven James,9999,0,9999,0
1668319625631,CSE 293,038,119435,Tullsen; Dean Michael,9999,0,9999,0
1668319625631,CSE 293,039,119483,Voelker; Geoffrey M.,9999,0,9999,0
1668319625631,CSE 293,040,119537,Zhao; Jishen,9999,0,9999,0
1668319625631,CSE 293,041,119538,Zhou; Yuan-Yuan,9999,0,9999,0
1668319625631,CSE 293,042,119539,Gao; Sicun,9999,0,9999,0
1668319625631,CSE 293,043,119540,Weibel; Nadir,9999,0,9999,0
1668319625631,CSE 293,044,119541,Gupta; Rajesh K.,9999,0,9999,0
1668319625631,CSE 293,045,126410,Vaccaro; Kristen Marie,9999,0,9999,0
1668319625631,CSE 293,046,126411,Klemke; Richard,9999,0,9999,0
1668319626056,CSE 294,A00,102459,Voelker; Geoffrey M.,0,0,0,0
1668319626056,CSE 294,B00,111322,Orailoglu; Alex,0,0,0,0
1668319626481,DSE 201,A00,096914,Deutsch; Alin Bernard,30,0,30,0
1668319626906,DSE 210,A00,096915,Dasgupta; Sanjoy,30,0,30,0
1668319627331,DSE 260A,A00,096916,Altintas De Callaf; Ilkay,30,0,30,0
1668319627763,ECE 200,001,103586,Antipa; Nicholas A,9999,0,9999,0
1668319627763,ECE 200,002,103587,Atanasov; Nikolay A.,9999,0,9999,0
1668319627763,ECE 200,003,103588,Bharadia; Dinesh,9999,0,9999,0
1668319627763,ECE 200,004,103589,Cheng; Chung Kuan,9999,0,9999,0
1668319627763,ECE 200,005,103590,Cosman; Pamela C.,9999,0,9999,0
1668319627763,ECE 200,006,103591,Dayeh; Shadi Ahmad,9999,0,9999,0
1668319627763,ECE 200,007,103592,Fainman; Yeshaiahu,9999,0,9999,0
1668319627763,ECE 200,008,103593,Ford; Joseph Earl,9999,0,9999,0
1668319627763,ECE 200,009,103594,Franceschetti; Massimo,9999,0,9999,0
1668319627763,ECE 200,010,103595,Fullerton; Eric E,9999,0,9999,0
1668319627763,ECE 200,011,103596,Galton; Ian A,9999,0,9999,0
1668319627763,ECE 200,012,103597,Gilja; Vikash,9999,0,9999,0
1668319627763,ECE 200,013,103598,Hall; Drew A.,9999,0,9999,0
1668319627763,ECE 200,014,103599,Hsueh; Tzu-Chien,9999,0,9999,0
1668319627763,ECE 200,015,103600,Javidi; Tara,9999,0,9999,0
1668319627763,ECE 200,016,103601,Kahng; Andrew Byun,9999,0,9999,0
1668319627763,ECE 200,017,103602,Kim; Young-Han,9999,0,9999,0
1668319627763,ECE 200,018,103603,Koushanfar; Farinaz,9999,0,9999,0
1668319627763,ECE 200,019,103604,Kuzum; Duygu,9999,0,9999,0
1668319627763,ECE 200,020,103605,Le; Hanh-Phuc,9999,0,9999,0
1668319627763,ECE 200,021,103606,Lin; Bill,9999,0,9999,0
1668319627763,ECE 200,022,103607,Liu; Zhaowei,9998,0,9999,1
1668319627763,ECE 200,023,103608,Lo; Yu-Hwa,9999,0,9999,0
1668319627763,ECE 200,024,103609,Lomakin; Vitaliy,9999,0,9999,0
1668319627763,ECE 200,025,103610,Mercier; Patrick Philip,9999,0,9999,0
1668319627763,ECE 200,026,103611,Meyer; Florian,9999,0,9999,0
1668319627763,ECE 200,027,103612,Milstein; Laurence B.,9999,0,9999,0
1668319627763,ECE 200,028,103613,Mir Arabbaygi; Siavash,9999,0,9999,0
1668319627763,ECE 200,029,103614,Mookherjea; Shayan,9999,0,9999,0
1668319627763,ECE 200,030,103615,Morris; Karcher William,9999,0,9999,0
1668319627763,ECE 200,031,103616,Ng; Tse Nga,9999,0,9999,0
1668319627763,ECE 200,032,103617,Nguyen; Truong Quang,9999,0,9999,0
1668319627763,ECE 200,033,103618,Nomura; Kenji,9999,0,9999,0
1668319627763,ECE 200,034,103619,Orlitsky; Alon,9999,0,9999,0
1668319627763,ECE 200,035,103620,Pal; Piya,9999,0,9999,0
1668319627763,ECE 200,036,103621,Papen; George C.,9999,0,9999,0
1668319627763,ECE 200,037,103622,Radic; Stojan,9999,0,9999,0
1668319627763,ECE 200,038,103623,Rao; Bhaskar D.,9999,0,9999,0
1668319627763,ECE 200,039,103624,Rao; Ramesh R,9999,0,9999,0
1668319627763,ECE 200,040,103625,Rebeiz; Gabriel,9999,0,9999,0
1668319627763,ECE 200,041,103626,Sanford; John R,9999,0,9999,0
1668319627763,ECE 200,042,103627,Siegel; Paul H.,9999,0,9999,0
1668319627763,ECE 200,043,103628,Sievenpiper; Daniel F.,9999,0,9999,0
1668319627763,ECE 200,044,103629,Sworder; David D.,9999,0,9999,0
1668319627763,ECE 200,045,103630,Taur; Yuan,9999,0,9999,0
1668319627763,ECE 200,046,103631,Touri; Behrouz,9999,0,9999,0
1668319627763,ECE 200,047,103632,Trivedi; Mohan M.,9999,0,9999,0
1668319627763,ECE 200,048,103633,Vasconcelos; Nuno,9999,0,9999,0
1668319627763,ECE 200,049,103634,Wang; Xiaolong,9999,0,9999,0
1668319627763,ECE 200,050,103635,Xie; Pengtao,9999,0,9999,0
1668319627763,ECE 200,051,103636,Yip; Michael,9999,0,9999,0
1668319627763,ECE 200,052,103637,Zeger; Kenneth A.,999,0,999,0
1668319627763,ECE 200,053,103638,Zhang; Xinyu,9999,0,9999,0
1668319627763,ECE 200,054,103639,Turakhia; Yatish Girish,9999,0,9999,0
1668319627763,ECE 200,055,103640,Kang; Mingu,9999,0,9999,0
1668319627763,ECE 200,056,103641,Shi; Yuanyuan,9999,0,9999,0
1668319627763,ECE 200,057,103642,Wang; Edward Jay,9999,0,9999,0
1668319627763,ECE 200,058,103643,Zheng; Yang,9999,0,9999,0
1668319628189,ECE 202,A00,103644,Kuzum; Duygu,0,0,0,0
1668319628612,ECE 212BN,A00,103646,Ng; Tse Nga,0,0,0,0
1668319629036,ECE 221,A00,111493,Staff,0,0,0,0
1668319629460,ECE 222B,A00,103647,Lomakin; Vitaliy,0,0,0,0
1668319629885,ECE 230B,A00,103648,Taur; Yuan,0,0,0,0
1668319630311,ECE 238B,A00,103649,Garay; Javier,0,0,0,0
1668319630738,ECE 240B,A00,112900,Fainman; Yeshaiahu,0,0,0,0
1668319631163,ECE 247A,A00,103650,Jokerst; Jesse Vincent,0,0,0,0
1668319631586,ECE 247B,A00,103651,Wang; Joseph,0,0,0,0
1668319632013,ECE 250,A00,103652,Siegel; Paul H.,0,0,0,0
1668319632442,ECE 251A,A00,103654,Rao; Bhaskar D.,0,0,0,0
1668319632867,ECE 257B,A00,103655,Bharadia; Dinesh,0,0,0,0
1668319633297,ECE 258A,A00,103656,Milstein; Laurence B.,0,0,0,0
1668319633720,ECE 260B,A00,103658,Kang; Mingu,0,0,0,0
1668319634143,ECE 264A,A00,103659,Galton; Ian A,0,0,0,0
1668319634565,ECE 265A,A00,103661,Gudem; Prasad S.S.,0,0,0,0
1668319634989,ECE 265D,A00,103662,Gudem; Prasad S.S.,0,0,0,0
1668319635420,ECE 268,A00,103663,Koushanfar; Farinaz,0,0,0,0
1668319635844,ECE 269,A01,103665,Pal; Piya,0,0,0,0
1668319636269,ECE 271B,A00,103666,Vasconcelos; Manuela,0,0,0,0
1668319636692,ECE 276A,A00,103667,Atanasov; Nikolay A.,0,0,0,0
1668319637117,ECE 277,A00,103668,An; Cheolhong,0,0,0,0
1668319637543,ECE 279,A00,117947,Hall; Drew A.,0,0,0,0
1668319638392,ECE 283,A00,103670,Hsueh; Tzu-Chien,0,0,0,0
1668319638824,ECE 284,A00,103671,Turakhia; Yatish Girish,0,0,0,0
1668319639249,ECE 285,A00,103672,Zheng; Yang,0,0,0,0
1668319639249,ECE 285,B00,103673,Sworder; David D.,0,0,0,0
1668319639671,ECE 287,A00,103676,Javidi; Tara,0,0,0,0
1668319640095,MATH 200B,A00,098023,Salehi Golsefidy; Alireza,12,0,15,3
1668319640518,MATH 202B,A00,098024,Rhoades; Brendon Patrick,9,0,15,6
1668319640943,MATH 203B,A00,098025,Oprea; Dragos N.,10,0,15,5
1668319641368,MATH 204B,A00,098026,Sorensen; Claus M,13,0,15,2
1668319641790,MATH 208,A00,098027,Izadi; Elham,7,0,10,3
1668319642214,MATH 209,A00,098028,Pollack; Aaron,10,0,10,0
1668319642637,MATH 211A,A00,112919,Rogalski; Daniel,9,0,10,1
1668319643060,MATH 211B,A00,112920,Seward; Brandon M.,9,0,10,1
1668319643487,MATH 218,A00,098029,Li; Bo,10,0,10,0
1668319643912,MATH 220B,A00,098030,Novak; Jonathan I,11,0,15,4
1668319644343,MATH 221A,A00,098031,Ebenfelt; Peter F,13,0,15,2
1668319644765,MATH 231B,A00,098032,Zlatos; Andrej,12,0,15,3
1668319645193,MATH 240B,A00,098033,Ni; Lei,9,0,15,6
1668319645617,MATH 243,A00,098034,Jekel; David Andrew,10,0,10,0
1668319646039,MATH 245A,A00,098035,Nie; Jiawang,0,0,15,16
1668319646462,MATH 248,A00,098036,Bejenaru; Ioan,10,0,10,0
1668319646885,MATH 250B,A00,098037,Spolaor; Luca,14,0,15,1
1668319647309,MATH 258,A00,098038,Ni; Lei,10,0,10,0
1668319647733,MATH 264B,A00,098041,Rhoades; Brendon Patrick,9,0,15,6
1668319648156,MATH 268,A00,098042,Buss; Samuel R,10,0,10,0
1668319648581,MATH 269,A00,098043,Rhoades; Brendon Patrick,10,0,10,0
1668319649006,MATH 270B,A00,098044,Li; Bo,10,0,15,5
1668319649429,MATH 272B,A00,098045,Holst; Michael J,13,0,15,2
1668319649851,MATH 273A,A00,098046,Tian; Xiaochuan,10,0,15,5
1668319650273,MATH 275,A01,098048,Tian; Xiaochuan,6,0,10,4
1668319650699,MATH 278A,A00,098049,Holst; Michael J,8,0,10,2
1668319651121,MATH 278B,A00,098050,Cloninger; Alexander,10,0,10,0
1668319651543,MATH 278C,A00,098051,Nie; Jiawang,7,0,10,3
1668319651966,MATH 280B,A00,098052,Zheng; Tianyi,8,0,15,7
1668319652390,MATH 281B,A00,098053,Bradic; Jelena,1,0,15,14
1668319652813,MATH 282B,A00,098054,Arias-Castro; Ery,0,0,15,15
1668319653239,MATH 285,A00,098055,Fitzsimmons; Patrick J,0,0,15,17
1668319653664,MATH 287B,A00,098056,Arias-Castro; Ery,2,0,15,13
1668319654089,MATH 288,A00,098057,Agarwal; Pooja,9,0,10,1
1668319654089,MATH 288,B00,098058,Zhang; Danna,8,0,10,2
1668319654089,MATH 288,C00,098059,Williams; Ruth J,9,0,10,1
1668319654516,MATH 290B,A00,098060,Roberts; Justin Deritter,13,0,15,2
1668319654939,MATH 292,A00,098061,Belmont; Eva Kinoshita,10,0,10,0
1668319655366,MATH 295,A00,098062,Suk; Andrew Hoon,48,0,50,2
1668319655791,MATH 296,A00,098063,Novak; Jonathan I,20,0,20,0
1668319656216,MATH 297,001,098064,Gamst; Anthony Collins,9997,0,9999,2
1668320155304,COGS 205,A00,101395,Chiba; Andrea,19,0,20,1
1668320155727,COGS 210B,001,101404,Greene; Deanna Jacquelyn,9998,0,9999,1
1668320155727,COGS 210B,002,101417,Xia; Haijun,9999,0,9999,0
1668320155727,COGS 210B,003,101422,Nitz; Douglas A.,9999,0,9999,0
1668320155727,COGS 210B,004,101423,Hollan; James D.,9998,0,9999,1
1668320155727,COGS 210B,005,101424,Deak; Gedeon O.,9998,0,9999,1
1668320155727,COGS 210B,006,101425,Rossano; Federico,9999,0,9999,0
1668320156150,COGS 211B,A00,101427,Coulson; Seana M,9996,0,9999,3
1668320156577,COGS 220,A00,101428,Hollan; James D.,0,0,25,25
1668320157002,COGS 229,A00,101429,Dow; Steven P,18,0,25,7
1668320157426,COGS 230,A00,101430,Klemmer; Scott R,11,0,17,6
1668320157850,COGS 234,A00,101431,Xia; Haijun,1,0,25,24
1668320158273,COGS 260,A00,101432,Kiyonaga; Anastasia,21,0,25,4
1668320158273,COGS 260,B00,101433,Kirsh; David Joel,15,0,25,10
1668320158699,CSE 202,A00,102371,Impagliazzo; Russell,0,0,0,0
1668320159121,CSE 203B,A01,102373,Cheng; Chung Kuan,0,0,0,0
1668320159552,CSE 208,A00,102374,Micciancio; Daniele,0,0,0,0
1668320159979,CSE 209A,A00,112895,Impagliazzo; Russell,0,0,15,15
1668320160404,CSE 209B,A00,108005,Bellare; Mihir,0,0,0,0
1668320160829,CSE 210,A00,113163,Coblenz; Michael J,0,0,0,0
1668320161254,CSE 219,A00,106111,Dow; Steven P,0,0,20,20
1668320161683,CSE 221,A00,102376,Voelker; Geoffrey M.,0,0,0,0
1668320162109,CSE 224,A01,102378,Porter; George M,0,0,0,0
1668320162533,CSE 229A,A00,102379,Savage; Stefan,0,0,0,0
1668320162965,CSE 229C,A00,102380,Munyaka; Imani N. S.,0,0,0,0
1668320163387,CSE 232B,A00,102382,Deutsch; Alin Bernard,0,0,0,0
1668320163813,CSE 234,A01,112904,Kumar; Arun Kumar,0,0,0,0
1668320164236,CSE 237A,A00,102383,Rosing; Tajana Simunic,0,0,0,0
1668320164659,CSE 239A,A00,102384,Deutsch; Alin Bernard,0,0,0,0
1668320165084,CSE 239B,A00,102385,Polikarpova; Nadezhda,0,0,0,0
1668320165505,CSE 240A,A00,102386,Pannuto; Patrick William,0,0,0,0
1668320165927,CSE 240B,A00,102387,Zhao; Jishen,0,0,0,0
1668320166349,CSE 241A,A00,106406,Kang; Mingu,0,0,0,0
1668320166775,CSE 249B,A00,102388,Kahng; Andrew Byun,0,0,8,8
1668320167197,CSE 251B,A01,102392,Cottrell; Garrison W,0,0,0,0
1668320167197,CSE 251B,A02,102393,Cottrell; Garrison W,0,0,0,0
1668320167619,CSE 252B,A00,102394,Ochoa; Benjamin Lawrence,0,0,0,0
1668320168044,CSE 257,A01,102396,Gao; Sicun,0,0,0,0
1668320168466,CSE 272,A00,102397,Li; Tzumao,0,0,0,0
1668320168890,CSE 274,A00,111323,Chern; Albert Ren-Haur,0,0,0,0
1668320169317,CSE 282,A00,102398,Pevzner; Pavel Arkadjevich,0,0,0,0
1668320169740,CSE 284,A00,114175,Gymrek; Melissa Ann,0,0,0,0
1668320170168,CSE 290,A00,102399,Chandraker; Manmohan Krishna,0,0,0,0
1668320170168,CSE 290,B00,102400,Vaccaro; Kristen Marie,0,0,25,25
1668320170168,CSE 290,C00,102414,Pannuto; Patrick William,0,0,25,25
1668320170168,CSE 290,D00,102427,Pevzner; Pavel Arkadjevich,0,0,0,0
1668320170168,CSE 290,E00,102429,Zhao; Jishen,0,0,0,0
1668320170168,CSE 290,F00,102436,Tullsen; Dean Michael,0,0,0,0
1668320170168,CSE 290,G00,102440,Christensen; Henrik I,0,0,20,20
1668320170593,CSE 291,A00,102443,Su; Hao,0,0,0,0
1668320170593,CSE 291,B00,102448,Polikarpova; Nadezhda,0,0,0,0
1668320170593,CSE 291,C00,102453,Vaccaro; Kristen Marie,0,0,0,0
1668320170593,CSE 291,D00,111343,Savage; Stefan,0,0,0,0
1668320170593,CSE 291,E00,116474,Claffy; Kimberly Claire,0,0,0,0
1668320170593,CSE 291,F00,116479,Pasquale; Joseph,0,0,0,0
1668320171021,CSE 293,001,119111,Bafna; Vineet,9999,0,9999,0
1668320171021,CSE 293,002,119118,Bellare; Mihir,9999,0,9999,0
1668320171021,CSE 293,003,119122,Berg-Kirkpatrick; Taylor D,9999,0,9999,0
1668320171021,CSE 293,004,119135,Christensen; Henrik I,9999,0,9999,0
1668320171021,CSE 293,005,119142,Cottrell; Garrison W,9999,0,9999,0
1668320171021,CSE 293,006,119146,Deutsch; Alin Bernard,9999,0,9999,0
1668320171021,CSE 293,007,119159,Esmaeilzadeh; Hadi,9999,0,9999,0
1668320171021,CSE 293,008,119166,Freund; Yoav,9999,0,9999,0
1668320171021,CSE 293,009,119170,Griswold; William G.,9999,0,9999,0
1668320171021,CSE 293,010,119183,Gymrek; Melissa Ann,9999,0,9999,0
1668320171021,CSE 293,011,119190,Heninger; Nadia A,9999,0,9999,0
1668320171021,CSE 293,012,119230,Impagliazzo; Russell,9999,0,9999,0
1668320171021,CSE 293,013,119232,Jhala; Ranjit,9999,0,9999,0
1668320171021,CSE 293,014,119233,Kahng; Andrew Byun,9999,0,9999,0
1668320171021,CSE 293,015,119298,Kane; Daniel Mertz,9999,0,9999,0
1668320171021,CSE 293,016,119299,Kriegman; David J,9999,0,9999,0
1668320171021,CSE 293,017,119300,Kumar; Arun Kumar,9999,0,9999,0
1668320171021,CSE 293,018,119301,Lerner; Sorin,9999,0,9999,0
1668320171021,CSE 293,019,119302,Lovett; Shachar,9999,0,9999,0
1668320171021,CSE 293,020,119303,McAuley; Julian John,9999,0,9999,0
1668320171021,CSE 293,021,119304,Micciancio; Daniele,9999,0,9999,0
1668320171021,CSE 293,022,119367,Orailoglu; Alex,9999,0,9999,0
1668320171021,CSE 293,023,119382,Paturi; Ramamohan,9999,0,9999,0
1668320171021,CSE 293,024,119404,Polikarpova; Nadezhda,9999,0,9999,0
1668320171021,CSE 293,025,119406,Politz; Joseph Gibbs,9999,0,9999,0
1668320171021,CSE 293,026,119411,Porter; George M,9999,0,9999,0
1668320171021,CSE 293,027,119414,Porter; Leonard Emerson,9999,0,9999,0
1668320171021,CSE 293,028,119416,Ramamoorthi; Ravi,9999,0,9999,0
1668320171021,CSE 293,029,119417,Sahoo; Debashis,9999,0,9999,0
1668320171021,CSE 293,030,119420,Saul; Lawrence,9999,0,9999,0
1668320171021,CSE 293,031,119421,Savage; Stefan,9999,0,9999,0
1668320171021,CSE 293,032,119425,Schulze; Jurgen P.,9999,0,9999,0
1668320171021,CSE 293,033,119426,Snoeren; Alex C.,9999,0,9999,0
1668320171021,CSE 293,034,119428,Shang; Jingbo,9999,0,9999,0
1668320171021,CSE 293,035,119430,Stefan; Deian,9999,0,9999,0
1668320171021,CSE 293,036,119431,Su; Hao,9999,0,9999,0
1668320171021,CSE 293,037,119433,Swanson; Steven James,9999,0,9999,0
1668320171021,CSE 293,038,119435,Tullsen; Dean Michael,9999,0,9999,0
1668320171021,CSE 293,039,119483,Voelker; Geoffrey M.,9999,0,9999,0
1668320171021,CSE 293,040,119537,Zhao; Jishen,9999,0,9999,0
1668320171021,CSE 293,041,119538,Zhou; Yuan-Yuan,9999,0,9999,0
1668320171021,CSE 293,042,119539,Gao; Sicun,9999,0,9999,0
1668320171021,CSE 293,043,119540,Weibel; Nadir,9999,0,9999,0
1668320171021,CSE 293,044,119541,Gupta; Rajesh K.,9999,0,9999,0
1668320171021,CSE 293,045,126410,Vaccaro; Kristen Marie,9999,0,9999,0
1668320171021,CSE 293,046,126411,Klemke; Richard,9999,0,9999,0
1668320171448,CSE 294,A00,102459,Voelker; Geoffrey M.,0,0,0,0
1668320171448,CSE 294,B00,111322,Orailoglu; Alex,0,0,0,0
1668320171874,DSE 201,A00,096914,Deutsch; Alin Bernard,30,0,30,0
1668320172301,DSE 210,A00,096915,Dasgupta; Sanjoy,30,0,30,0
1668320172724,DSE 260A,A00,096916,Altintas De Callaf; Ilkay,30,0,30,0
1668320173161,ECE 200,001,103586,Antipa; Nicholas A,9999,0,9999,0
1668320173161,ECE 200,002,103587,Atanasov; Nikolay A.,9999,0,9999,0
1668320173161,ECE 200,003,103588,Bharadia; Dinesh,9999,0,9999,0
1668320173161,ECE 200,004,103589,Cheng; Chung Kuan,9999,0,9999,0
1668320173161,ECE 200,005,103590,Cosman; Pamela C.,9999,0,9999,0
1668320173161,ECE 200,006,103591,Dayeh; Shadi Ahmad,9999,0,9999,0
1668320173161,ECE 200,007,103592,Fainman; Yeshaiahu,9999,0,9999,0
1668320173161,ECE 200,008,103593,Ford; Joseph Earl,9999,0,9999,0
1668320173161,ECE 200,009,103594,Franceschetti; Massimo,9999,0,9999,0
1668320173161,ECE 200,010,103595,Fullerton; Eric E,9999,0,9999,0
1668320173161,ECE 200,011,103596,Galton; Ian A,9999,0,9999,0
1668320173161,ECE 200,012,103597,Gilja; Vikash,9999,0,9999,0
1668320173161,ECE 200,013,103598,Hall; Drew A.,9999,0,9999,0
1668320173161,ECE 200,014,103599,Hsueh; Tzu-Chien,9999,0,9999,0
1668320173161,ECE 200,015,103600,Javidi; Tara,9999,0,9999,0
1668320173161,ECE 200,016,103601,Kahng; Andrew Byun,9999,0,9999,0
1668320173161,ECE 200,017,103602,Kim; Young-Han,9999,0,9999,0
1668320173161,ECE 200,018,103603,Koushanfar; Farinaz,9999,0,9999,0
1668320173161,ECE 200,019,103604,Kuzum; Duygu,9999,0,9999,0
1668320173161,ECE 200,020,103605,Le; Hanh-Phuc,9999,0,9999,0
1668320173161,ECE 200,021,103606,Lin; Bill,9999,0,9999,0
1668320173161,ECE 200,022,103607,Liu; Zhaowei,9998,0,9999,1
1668320173161,ECE 200,023,103608,Lo; Yu-Hwa,9999,0,9999,0
1668320173161,ECE 200,024,103609,Lomakin; Vitaliy,9999,0,9999,0
1668320173161,ECE 200,025,103610,Mercier; Patrick Philip,9999,0,9999,0
1668320173161,ECE 200,026,103611,Meyer; Florian,9999,0,9999,0
1668320173161,ECE 200,027,103612,Milstein; Laurence B.,9999,0,9999,0
1668320173161,ECE 200,028,103613,Mir Arabbaygi; Siavash,9999,0,9999,0
1668320173161,ECE 200,029,103614,Mookherjea; Shayan,9999,0,9999,0
1668320173161,ECE 200,030,103615,Morris; Karcher William,9999,0,9999,0
1668320173161,ECE 200,031,103616,Ng; Tse Nga,9999,0,9999,0
1668320173161,ECE 200,032,103617,Nguyen; Truong Quang,9999,0,9999,0
1668320173161,ECE 200,033,103618,Nomura; Kenji,9999,0,9999,0
1668320173161,ECE 200,034,103619,Orlitsky; Alon,9999,0,9999,0
1668320173161,ECE 200,035,103620,Pal; Piya,9999,0,9999,0
1668320173161,ECE 200,036,103621,Papen; George C.,9999,0,9999,0
1668320173161,ECE 200,037,103622,Radic; Stojan,9999,0,9999,0
1668320173161,ECE 200,038,103623,Rao; Bhaskar D.,9999,0,9999,0
1668320173161,ECE 200,039,103624,Rao; Ramesh R,9999,0,9999,0
1668320173161,ECE 200,040,103625,Rebeiz; Gabriel,9999,0,9999,0
1668320173161,ECE 200,041,103626,Sanford; John R,9999,0,9999,0
1668320173161,ECE 200,042,103627,Siegel; Paul H.,9999,0,9999,0
1668320173161,ECE 200,043,103628,Sievenpiper; Daniel F.,9999,0,9999,0
1668320173161,ECE 200,044,103629,Sworder; David D.,9999,0,9999,0
1668320173161,ECE 200,045,103630,Taur; Yuan,9999,0,9999,0
1668320173161,ECE 200,046,103631,Touri; Behrouz,9999,0,9999,0
1668320173161,ECE 200,047,103632,Trivedi; Mohan M.,9999,0,9999,0
1668320173161,ECE 200,048,103633,Vasconcelos; Nuno,9999,0,9999,0
1668320173161,ECE 200,049,103634,Wang; Xiaolong,9999,0,9999,0
1668320173161,ECE 200,050,103635,Xie; Pengtao,9999,0,9999,0
1668320173161,ECE 200,051,103636,Yip; Michael,9999,0,9999,0
1668320173161,ECE 200,052,103637,Zeger; Kenneth A.,999,0,999,0
1668320173161,ECE 200,053,103638,Zhang; Xinyu,9999,0,9999,0
1668320173161,ECE 200,054,103639,Turakhia; Yatish Girish,9999,0,9999,0
1668320173161,ECE 200,055,103640,Kang; Mingu,9999,0,9999,0
1668320173161,ECE 200,056,103641,Shi; Yuanyuan,9999,0,9999,0
1668320173161,ECE 200,057,103642,Wang; Edward Jay,9999,0,9999,0
1668320173161,ECE 200,058,103643,Zheng; Yang,9999,0,9999,0
1668320173595,ECE 202,A00,103644,Kuzum; Duygu,0,0,0,0
1668320174017,ECE 212BN,A00,103646,Ng; Tse Nga,0,0,0,0
1668320174444,ECE 221,A00,111493,Staff,0,0,0,0
1668320174866,ECE 222B,A00,103647,Lomakin; Vitaliy,0,0,0,0
1668320175291,ECE 230B,A00,103648,Taur; Yuan,0,0,0,0
1668320175713,ECE 238B,A00,103649,Garay; Javier,0,0,0,0
1668320176136,ECE 240B,A00,112900,Fainman; Yeshaiahu,0,0,0,0
1668320176558,ECE 247A,A00,103650,Jokerst; Jesse Vincent,0,0,0,0
1668320176982,ECE 247B,A00,103651,Wang; Joseph,0,0,0,0
1668320177404,ECE 250,A00,103652,Siegel; Paul H.,0,0,0,0
1668320177833,ECE 251A,A00,103654,Rao; Bhaskar D.,0,0,0,0
1668320178267,ECE 257B,A00,103655,Bharadia; Dinesh,0,0,0,0
1668320178692,ECE 258A,A00,103656,Milstein; Laurence B.,0,0,0,0
1668320179114,ECE 260B,A00,103658,Kang; Mingu,0,0,0,0
1668320179569,ECE 264A,A00,103659,Galton; Ian A,0,0,0,0
1668320179993,ECE 265A,A00,103661,Gudem; Prasad S.S.,0,0,0,0
1668320180418,ECE 265D,A00,103662,Gudem; Prasad S.S.,0,0,0,0
1668320180851,ECE 268,A00,103663,Koushanfar; Farinaz,0,0,0,0
1668320181277,ECE 269,A01,103665,Pal; Piya,0,0,0,0
1668320181701,ECE 271B,A00,103666,Vasconcelos; Manuela,0,0,0,0
1668320182124,ECE 276A,A00,103667,Atanasov; Nikolay A.,0,0,0,0
1668320182557,ECE 277,A00,103668,An; Cheolhong,0,0,0,0
1668320182980,ECE 279,A00,117947,Hall; Drew A.,0,0,0,0
1668320183824,ECE 283,A00,103670,Hsueh; Tzu-Chien,0,0,0,0
1668320184246,ECE 284,A00,103671,Turakhia; Yatish Girish,0,0,0,0
1668320184671,ECE 285,A00,103672,Zheng; Yang,0,0,0,0
1668320184671,ECE 285,B00,103673,Sworder; David D.,0,0,0,0
1668320185094,ECE 287,A00,103676,Javidi; Tara,0,0,0,0
1668320185520,MATH 200B,A00,098023,Salehi Golsefidy; Alireza,12,0,15,3
1668320185947,MATH 202B,A00,098024,Rhoades; Brendon Patrick,9,0,15,6
1668320186472,MATH 203B,A00,098025,Oprea; Dragos N.,10,0,15,5
1668320186895,MATH 204B,A00,098026,Sorensen; Claus M,13,0,15,2
1668320187328,MATH 208,A00,098027,Izadi; Elham,7,0,10,3
1668320187753,MATH 209,A00,098028,Pollack; Aaron,10,0,10,0
1668320188180,MATH 211A,A00,112919,Rogalski; Daniel,9,0,10,1
1668320188602,MATH 211B,A00,112920,Seward; Brandon M.,9,0,10,1
1668320189026,MATH 218,A00,098029,Li; Bo,10,0,10,0
1668320189447,MATH 220B,A00,098030,Novak; Jonathan I,11,0,15,4
1668320189873,MATH 221A,A00,098031,Ebenfelt; Peter F,13,0,15,2
1668320190305,MATH 231B,A00,098032,Zlatos; Andrej,12,0,15,3
1668320190729,MATH 240B,A00,098033,Ni; Lei,9,0,15,6
1668320191151,MATH 243,A00,098034,Jekel; David Andrew,10,0,10,0
1668320191581,MATH 245A,A00,098035,Nie; Jiawang,0,0,15,16
1668320192003,MATH 248,A00,098036,Bejenaru; Ioan,10,0,10,0
1668320192429,MATH 250B,A00,098037,Spolaor; Luca,14,0,15,1
1668320192850,MATH 258,A00,098038,Ni; Lei,10,0,10,0
1668320193276,MATH 264B,A00,098041,Rhoades; Brendon Patrick,9,0,15,6
1668320193702,MATH 268,A00,098042,Buss; Samuel R,10,0,10,0
1668320194128,MATH 269,A00,098043,Rhoades; Brendon Patrick,10,0,10,0
1668320194552,MATH 270B,A00,098044,Li; Bo,10,0,15,5
1668320194979,MATH 272B,A00,098045,Holst; Michael J,13,0,15,2
1668320195405,MATH 273A,A00,098046,Tian; Xiaochuan,10,0,15,5
1668320195828,MATH 275,A01,098048,Tian; Xiaochuan,6,0,10,4
1668320196251,MATH 278A,A00,098049,Holst; Michael J,8,0,10,2
1668320196676,MATH 278B,A00,098050,Cloninger; Alexander,10,0,10,0
1668320197107,MATH 278C,A00,098051,Nie; Jiawang,7,0,10,3
1668320197530,MATH 280B,A00,098052,Zheng; Tianyi,8,0,15,7
1668320197954,MATH 281B,A00,098053,Bradic; Jelena,1,0,15,14
1668320198379,MATH 282B,A00,098054,Arias-Castro; Ery,0,0,15,15
1668320198804,MATH 285,A00,098055,Fitzsimmons; Patrick J,0,0,15,17
1668320199226,MATH 287B,A00,098056,Arias-Castro; Ery,2,0,15,13
1668320199647,MATH 288,A00,098057,Agarwal; Pooja,9,0,10,1
1668320199647,MATH 288,B00,098058,Zhang; Danna,8,0,10,2
1668320199647,MATH 288,C00,098059,Williams; Ruth J,9,0,10,1
1668320200081,MATH 290B,A00,098060,Roberts; Justin Deritter,13,0,15,2
1668320200520,MATH 292,A00,098061,Belmont; Eva Kinoshita,10,0,10,0
1668320200943,MATH 295,A00,098062,Suk; Andrew Hoon,48,0,50,2
1668320201367,MATH 296,A00,098063,Novak; Jonathan I,20,0,20,0
1668320201796,MATH 297,001,098064,Gamst; Anthony Collins,9997,0,9999,2
1668320700278,COGS 205,A00,101395,Chiba; Andrea,19,0,20,1
1668320700712,COGS 210B,001,101404,Greene; Deanna Jacquelyn,9998,0,9999,1
1668320700712,COGS 210B,002,101417,Xia; Haijun,9999,0,9999,0
1668320700712,COGS 210B,003,101422,Nitz; Douglas A.,9999,0,9999,0
1668320700712,COGS 210B,004,101423,Hollan; James D.,9998,0,9999,1
1668320700712,COGS 210B,005,101424,Deak; Gedeon O.,9998,0,9999,1
1668320700712,COGS 210B,006,101425,Rossano; Federico,9999,0,9999,0
1668320701137,COGS 211B,A00,101427,Coulson; Seana M,9996,0,9999,3
1668320701559,COGS 220,A00,101428,Hollan; James D.,0,0,25,25
1668320701983,COGS 229,A00,101429,Dow; Steven P,18,0,25,7
1668320702410,COGS 230,A00,101430,Klemmer; Scott R,11,0,17,6
1668320702834,COGS 234,A00,101431,Xia; Haijun,1,0,25,24
1668320703260,COGS 260,A00,101432,Kiyonaga; Anastasia,21,0,25,4
1668320703260,COGS 260,B00,101433,Kirsh; David Joel,15,0,25,10
1668320703686,CSE 202,A00,102371,Impagliazzo; Russell,0,0,0,0
1668320704109,CSE 203B,A01,102373,Cheng; Chung Kuan,0,0,0,0
1668320704535,CSE 208,A00,102374,Micciancio; Daniele,0,0,0,0
1668320705057,CSE 209A,A00,112895,Impagliazzo; Russell,0,0,15,15
1668320705479,CSE 209B,A00,108005,Bellare; Mihir,0,0,0,0
1668320705904,CSE 210,A00,113163,Coblenz; Michael J,0,0,0,0
1668320706330,CSE 219,A00,106111,Dow; Steven P,0,0,20,20
1668320706763,CSE 221,A00,102376,Voelker; Geoffrey M.,0,0,0,0
1668320707190,CSE 224,A01,102378,Porter; George M,0,0,0,0
1668320707619,CSE 229A,A00,102379,Savage; Stefan,0,0,0,0
1668320708045,CSE 229C,A00,102380,Munyaka; Imani N. S.,0,0,0,0
1668320708470,CSE 232B,A00,102382,Deutsch; Alin Bernard,0,0,0,0
1668320708893,CSE 234,A01,112904,Kumar; Arun Kumar,0,0,0,0
1668320709318,CSE 237A,A00,102383,Rosing; Tajana Simunic,0,0,0,0
1668320709745,CSE 239A,A00,102384,Deutsch; Alin Bernard,0,0,0,0
1668320710171,CSE 239B,A00,102385,Polikarpova; Nadezhda,0,0,0,0
1668320710594,CSE 240A,A00,102386,Pannuto; Patrick William,0,0,0,0
1668320711020,CSE 240B,A00,102387,Zhao; Jishen,0,0,0,0
1668320711446,CSE 241A,A00,106406,Kang; Mingu,0,0,0,0
1668320711872,CSE 249B,A00,102388,Kahng; Andrew Byun,0,0,8,8
1668320712296,CSE 251B,A01,102392,Cottrell; Garrison W,0,0,0,0
1668320712296,CSE 251B,A02,102393,Cottrell; Garrison W,0,0,0,0
1668320712718,CSE 252B,A00,102394,Ochoa; Benjamin Lawrence,0,0,0,0
1668320713146,CSE 257,A01,102396,Gao; Sicun,0,0,0,0
1668320713569,CSE 272,A00,102397,Li; Tzumao,0,0,0,0
1668320713992,CSE 274,A00,111323,Chern; Albert Ren-Haur,0,0,0,0
1668320714416,CSE 282,A00,102398,Pevzner; Pavel Arkadjevich,0,0,0,0
1668320714839,CSE 284,A00,114175,Gymrek; Melissa Ann,0,0,0,0
1668320715263,CSE 290,A00,102399,Chandraker; Manmohan Krishna,0,0,0,0
1668320715263,CSE 290,B00,102400,Vaccaro; Kristen Marie,0,0,25,25
1668320715263,CSE 290,C00,102414,Pannuto; Patrick William,0,0,25,25
1668320715263,CSE 290,D00,102427,Pevzner; Pavel Arkadjevich,0,0,0,0
1668320715263,CSE 290,E00,102429,Zhao; Jishen,0,0,0,0
1668320715263,CSE 290,F00,102436,Tullsen; Dean Michael,0,0,0,0
1668320715263,CSE 290,G00,102440,Christensen; Henrik I,0,0,20,20
1668320715686,CSE 291,A00,102443,Su; Hao,0,0,0,0
1668320715686,CSE 291,B00,102448,Polikarpova; Nadezhda,0,0,0,0
1668320715686,CSE 291,C00,102453,Vaccaro; Kristen Marie,0,0,0,0
1668320715686,CSE 291,D00,111343,Savage; Stefan,0,0,0,0
1668320715686,CSE 291,E00,116474,Claffy; Kimberly Claire,0,0,0,0
1668320715686,CSE 291,F00,116479,Pasquale; Joseph,0,0,0,0
1668320716117,CSE 293,001,119111,Bafna; Vineet,9999,0,9999,0
1668320716117,CSE 293,002,119118,Bellare; Mihir,9999,0,9999,0
1668320716117,CSE 293,003,119122,Berg-Kirkpatrick; Taylor D,9999,0,9999,0
1668320716117,CSE 293,004,119135,Christensen; Henrik I,9999,0,9999,0
1668320716117,CSE 293,005,119142,Cottrell; Garrison W,9999,0,9999,0
1668320716117,CSE 293,006,119146,Deutsch; Alin Bernard,9999,0,9999,0
1668320716117,CSE 293,007,119159,Esmaeilzadeh; Hadi,9999,0,9999,0
1668320716117,CSE 293,008,119166,Freund; Yoav,9999,0,9999,0
1668320716117,CSE 293,009,119170,Griswold; William G.,9999,0,9999,0
1668320716117,CSE 293,010,119183,Gymrek; Melissa Ann,9999,0,9999,0
1668320716117,CSE 293,011,119190,Heninger; Nadia A,9999,0,9999,0
1668320716117,CSE 293,012,119230,Impagliazzo; Russell,9999,0,9999,0
1668320716117,CSE 293,013,119232,Jhala; Ranjit,9999,0,9999,0
1668320716117,CSE 293,014,119233,Kahng; Andrew Byun,9999,0,9999,0
1668320716117,CSE 293,015,119298,Kane; Daniel Mertz,9999,0,9999,0
1668320716117,CSE 293,016,119299,Kriegman; David J,9999,0,9999,0
1668320716117,CSE 293,017,119300,Kumar; Arun Kumar,9999,0,9999,0
1668320716117,CSE 293,018,119301,Lerner; Sorin,9999,0,9999,0
1668320716117,CSE 293,019,119302,Lovett; Shachar,9999,0,9999,0
1668320716117,CSE 293,020,119303,McAuley; Julian John,9999,0,9999,0
1668320716117,CSE 293,021,119304,Micciancio; Daniele,9999,0,9999,0
1668320716117,CSE 293,022,119367,Orailoglu; Alex,9999,0,9999,0
1668320716117,CSE 293,023,119382,Paturi; Ramamohan,9999,0,9999,0
1668320716117,CSE 293,024,119404,Polikarpova; Nadezhda,9999,0,9999,0
1668320716117,CSE 293,025,119406,Politz; Joseph Gibbs,9999,0,9999,0
1668320716117,CSE 293,026,119411,Porter; George M,9999,0,9999,0
1668320716117,CSE 293,027,119414,Porter; Leonard Emerson,9999,0,9999,0
1668320716117,CSE 293,028,119416,Ramamoorthi; Ravi,9999,0,9999,0
1668320716117,CSE 293,029,119417,Sahoo; Debashis,9999,0,9999,0
1668320716117,CSE 293,030,119420,Saul; Lawrence,9999,0,9999,0
1668320716117,CSE 293,031,119421,Savage; Stefan,9999,0,9999,0
1668320716117,CSE 293,032,119425,Schulze; Jurgen P.,9999,0,9999,0
1668320716117,CSE 293,033,119426,Snoeren; Alex C.,9999,0,9999,0
1668320716117,CSE 293,034,119428,Shang; Jingbo,9999,0,9999,0
1668320716117,CSE 293,035,119430,Stefan; Deian,9999,0,9999,0
1668320716117,CSE 293,036,119431,Su; Hao,9999,0,9999,0
1668320716117,CSE 293,037,119433,Swanson; Steven James,9999,0,9999,0
1668320716117,CSE 293,038,119435,Tullsen; Dean Michael,9999,0,9999,0
1668320716117,CSE 293,039,119483,Voelker; Geoffrey M.,9999,0,9999,0
1668320716117,CSE 293,040,119537,Zhao; Jishen,9999,0,9999,0
1668320716117,CSE 293,041,119538,Zhou; Yuan-Yuan,9999,0,9999,0
1668320716117,CSE 293,042,119539,Gao; Sicun,9999,0,9999,0
1668320716117,CSE 293,043,119540,Weibel; Nadir,9999,0,9999,0
1668320716117,CSE 293,044,119541,Gupta; Rajesh K.,9999,0,9999,0
1668320716117,CSE 293,045,126410,Vaccaro; Kristen Marie,9999,0,9999,0
1668320716117,CSE 293,046,126411,Klemke; Richard,9999,0,9999,0
1668320716541,CSE 294,A00,102459,Voelker; Geoffrey M.,0,0,0,0
1668320716541,CSE 294,B00,111322,Orailoglu; Alex,0,0,0,0
1668320716969,DSE 201,A00,096914,Deutsch; Alin Bernard,30,0,30,0
1668320717394,DSE 210,A00,096915,Dasgupta; Sanjoy,30,0,30,0
1668320717817,DSE 260A,A00,096916,Altintas De Callaf; Ilkay,30,0,30,0
1668320718256,ECE 200,001,103586,Antipa; Nicholas A,9999,0,9999,0
1668320718256,ECE 200,002,103587,Atanasov; Nikolay A.,9999,0,9999,0
1668320718256,ECE 200,003,103588,Bharadia; Dinesh,9999,0,9999,0
1668320718256,ECE 200,004,103589,Cheng; Chung Kuan,9999,0,9999,0
1668320718256,ECE 200,005,103590,Cosman; Pamela C.,9999,0,9999,0
1668320718256,ECE 200,006,103591,Dayeh; Shadi Ahmad,9999,0,9999,0
1668320718256,ECE 200,007,103592,Fainman; Yeshaiahu,9999,0,9999,0
1668320718256,ECE 200,008,103593,Ford; Joseph Earl,9999,0,9999,0
1668320718256,ECE 200,009,103594,Franceschetti; Massimo,9999,0,9999,0
1668320718256,ECE 200,010,103595,Fullerton; Eric E,9999,0,9999,0
1668320718256,ECE 200,011,103596,Galton; Ian A,9999,0,9999,0
1668320718256,ECE 200,012,103597,Gilja; Vikash,9999,0,9999,0
1668320718256,ECE 200,013,103598,Hall; Drew A.,9999,0,9999,0
1668320718256,ECE 200,014,103599,Hsueh; Tzu-Chien,9999,0,9999,0
1668320718256,ECE 200,015,103600,Javidi; Tara,9999,0,9999,0
1668320718256,ECE 200,016,103601,Kahng; Andrew Byun,9999,0,9999,0
1668320718256,ECE 200,017,103602,Kim; Young-Han,9999,0,9999,0
1668320718256,ECE 200,018,103603,Koushanfar; Farinaz,9999,0,9999,0
1668320718256,ECE 200,019,103604,Kuzum; Duygu,9999,0,9999,0
1668320718256,ECE 200,020,103605,Le; Hanh-Phuc,9999,0,9999,0
1668320718256,ECE 200,021,103606,Lin; Bill,9999,0,9999,0
1668320718256,ECE 200,022,103607,Liu; Zhaowei,9998,0,9999,1
1668320718256,ECE 200,023,103608,Lo; Yu-Hwa,9999,0,9999,0
1668320718256,ECE 200,024,103609,Lomakin; Vitaliy,9999,0,9999,0
1668320718256,ECE 200,025,103610,Mercier; Patrick Philip,9999,0,9999,0
1668320718256,ECE 200,026,103611,Meyer; Florian,9999,0,9999,0
1668320718256,ECE 200,027,103612,Milstein; Laurence B.,9999,0,9999,0
1668320718256,ECE 200,028,103613,Mir Arabbaygi; Siavash,9999,0,9999,0
1668320718256,ECE 200,029,103614,Mookherjea; Shayan,9999,0,9999,0
1668320718256,ECE 200,030,103615,Morris; Karcher William,9999,0,9999,0
1668320718256,ECE 200,031,103616,Ng; Tse Nga,9999,0,9999,0
1668320718256,ECE 200,032,103617,Nguyen; Truong Quang,9999,0,9999,0
1668320718256,ECE 200,033,103618,Nomura; Kenji,9999,0,9999,0
1668320718256,ECE 200,034,103619,Orlitsky; Alon,9999,0,9999,0
1668320718256,ECE 200,035,103620,Pal; Piya,9999,0,9999,0
1668320718256,ECE 200,036,103621,Papen; George C.,9999,0,9999,0
1668320718256,ECE 200,037,103622,Radic; Stojan,9999,0,9999,0
1668320718256,ECE 200,038,103623,Rao; Bhaskar D.,9999,0,9999,0
1668320718256,ECE 200,039,103624,Rao; Ramesh R,9999,0,9999,0
1668320718256,ECE 200,040,103625,Rebeiz; Gabriel,9999,0,9999,0
1668320718256,ECE 200,041,103626,Sanford; John R,9999,0,9999,0
1668320718256,ECE 200,042,103627,Siegel; Paul H.,9999,0,9999,0
1668320718256,ECE 200,043,103628,Sievenpiper; Daniel F.,9999,0,9999,0
1668320718256,ECE 200,044,103629,Sworder; David D.,9999,0,9999,0
1668320718256,ECE 200,045,103630,Taur; Yuan,9999,0,9999,0
1668320718256,ECE 200,046,103631,Touri; Behrouz,9999,0,9999,0
1668320718256,ECE 200,047,103632,Trivedi; Mohan M.,9999,0,9999,0
1668320718256,ECE 200,048,103633,Vasconcelos; Nuno,9999,0,9999,0
1668320718256,ECE 200,049,103634,Wang; Xiaolong,9999,0,9999,0
1668320718256,ECE 200,050,103635,Xie; Pengtao,9999,0,9999,0
1668320718256,ECE 200,051,103636,Yip; Michael,9999,0,9999,0
1668320718256,ECE 200,052,103637,Zeger; Kenneth A.,999,0,999,0
1668320718256,ECE 200,053,103638,Zhang; Xinyu,9999,0,9999,0
1668320718256,ECE 200,054,103639,Turakhia; Yatish Girish,9999,0,9999,0
1668320718256,ECE 200,055,103640,Kang; Mingu,9999,0,9999,0
1668320718256,ECE 200,056,103641,Shi; Yuanyuan,9999,0,9999,0
1668320718256,ECE 200,057,103642,Wang; Edward Jay,9999,0,9999,0
1668320718256,ECE 200,058,103643,Zheng; Yang,9999,0,9999,0
1668320718682,ECE 202,A00,103644,Kuzum; Duygu,0,0,0,0
1668320719106,ECE 212BN,A00,103646,Ng; Tse Nga,0,0,0,0
1668320719529,ECE 221,A00,111493,Staff,0,0,0,0
1668320719955,ECE 222B,A00,103647,Lomakin; Vitaliy,0,0,0,0
1668320720379,ECE 230B,A00,103648,Taur; Yuan,0,0,0,0
1668320720803,ECE 238B,A00,103649,Garay; Javier,0,0,0,0
1668320721233,ECE 240B,A00,112900,Fainman; Yeshaiahu,0,0,0,0
1668320721657,ECE 247A,A00,103650,Jokerst; Jesse Vincent,0,0,0,0
1668320722084,ECE 247B,A00,103651,Wang; Joseph,0,0,0,0
1668320722514,ECE 250,A00,103652,Siegel; Paul H.,0,0,0,0
1668320722939,ECE 251A,A00,103654,Rao; Bhaskar D.,0,0,0,0
1668320723363,ECE 257B,A00,103655,Bharadia; Dinesh,0,0,0,0
1668320723787,ECE 258A,A00,103656,Milstein; Laurence B.,0,0,0,0
1668320724214,ECE 260B,A00,103658,Kang; Mingu,0,0,0,0
1668320724644,ECE 264A,A00,103659,Galton; Ian A,0,0,0,0
1668320725072,ECE 265A,A00,103661,Gudem; Prasad S.S.,0,0,0,0
1668320725495,ECE 265D,A00,103662,Gudem; Prasad S.S.,0,0,0,0
1668320725919,ECE 268,A00,103663,Koushanfar; Farinaz,0,0,0,0
1668320726343,ECE 269,A01,103665,Pal; Piya,0,0,0,0
1668320726766,ECE 271B,A00,103666,Vasconcelos; Manuela,0,0,0,0
1668320727192,ECE 276A,A00,103667,Atanasov; Nikolay A.,0,0,0,0
1668320727621,ECE 277,A00,103668,An; Cheolhong,0,0,0,0
1668320728048,ECE 279,A00,117947,Hall; Drew A.,0,0,0,0
1668320728895,ECE 283,A00,103670,Hsueh; Tzu-Chien,0,0,0,0
1668320729322,ECE 284,A00,103671,Turakhia; Yatish Girish,0,0,0,0
1668320729743,ECE 285,A00,103672,Zheng; Yang,0,0,0,0
1668320729743,ECE 285,B00,103673,Sworder; David D.,0,0,0,0
1668320730166,ECE 287,A00,103676,Javidi; Tara,0,0,0,0
1668320730591,MATH 200B,A00,098023,Salehi Golsefidy; Alireza,12,0,15,3
1668320731015,MATH 202B,A00,098024,Rhoades; Brendon Patrick,9,0,15,6
1668320731441,MATH 203B,A00,098025,Oprea; Dragos N.,10,0,15,5
1668320731868,MATH 204B,A00,098026,Sorensen; Claus M,13,0,15,2
1668320732293,MATH 208,A00,098027,Izadi; Elham,7,0,10,3
1668320732733,MATH 209,A00,098028,Pollack; Aaron,10,0,10,0
1668320733159,MATH 211A,A00,112919,Rogalski; Daniel,9,0,10,1
1668320733591,MATH 211B,A00,112920,Seward; Brandon M.,9,0,10,1
1668320734032,MATH 218,A00,098029,Li; Bo,10,0,10,0
1668320734457,MATH 220B,A00,098030,Novak; Jonathan I,11,0,15,4
1668320734883,MATH 221A,A00,098031,Ebenfelt; Peter F,13,0,15,2
1668320735307,MATH 231B,A00,098032,Zlatos; Andrej,12,0,15,3
1668320735735,MATH 240B,A00,098033,Ni; Lei,9,0,15,6
1668320736165,MATH 243,A00,098034,Jekel; David Andrew,10,0,10,0
1668320736591,MATH 245A,A00,098035,Nie; Jiawang,0,0,15,16
1668320737016,MATH 248,A00,098036,Bejenaru; Ioan,10,0,10,0
1668320737443,MATH 250B,A00,098037,Spolaor; Luca,14,0,15,1
1668320737867,MATH 258,A00,098038,Ni; Lei,10,0,10,0
1668320738295,MATH 264B,A00,098041,Rhoades; Brendon Patrick,9,0,15,6
1668320738724,MATH 268,A00,098042,Buss; Samuel R,10,0,10,0
1668320739153,MATH 269,A00,098043,Rhoades; Brendon Patrick,10,0,10,0
1668320739579,MATH 270B,A00,098044,Li; Bo,10,0,15,5
1668320740008,MATH 272B,A00,098045,Holst; Michael J,13,0,15,2
1668320740433,MATH 273A,A00,098046,Tian; Xiaochuan,10,0,15,5
1668320740860,MATH 275,A01,098048,Tian; Xiaochuan,6,0,10,4
1668320741282,MATH 278A,A00,098049,Holst; Michael J,8,0,10,2
1668320741709,MATH 278B,A00,098050,Cloninger; Alexander,10,0,10,0
1668320742137,MATH 278C,A00,098051,Nie; Jiawang,7,0,10,3
1668320742565,MATH 280B,A00,098052,Zheng; Tianyi,8,0,15,7
1668320742988,MATH 281B,A00,098053,Bradic; Jelena,1,0,15,14
1668320743415,MATH 282B,A00,098054,Arias-Castro; Ery,0,0,15,15
1668320743841,MATH 285,A00,098055,Fitzsimmons; Patrick J,0,0,15,17
1668320744266,MATH 287B,A00,098056,Arias-Castro; Ery,2,0,15,13
1668320744693,MATH 288,A00,098057,Agarwal; Pooja,9,0,10,1
1668320744693,MATH 288,B00,098058,Zhang; Danna,8,0,10,2
1668320744693,MATH 288,C00,098059,Williams; Ruth J,9,0,10,1
1668320745118,MATH 290B,A00,098060,Roberts; Justin Deritter,13,0,15,2
1668320745543,MATH 292,A00,098061,Belmont; Eva Kinoshita,10,0,10,0
1668320745968,MATH 295,A00,098062,Suk; Andrew Hoon,48,0,50,2
1668320746395,MATH 296,A00,098063,Novak; Jonathan I,20,0,20,0
1668320746820,MATH 297,001,098064,Gamst; Anthony Collins,9997,0,9999,2
1668321246414,COGS 205,A00,101395,Chiba; Andrea,19,0,20,1
1668321246845,COGS 210B,001,101404,Greene; Deanna Jacquelyn,9998,0,9999,1
1668321246845,COGS 210B,002,101417,Xia; Haijun,9999,0,9999,0
1668321246845,COGS 210B,003,101422,Nitz; Douglas A.,9999,0,9999,0
1668321246845,COGS 210B,004,101423,Hollan; James D.,9998,0,9999,1
1668321246845,COGS 210B,005,101424,Deak; Gedeon O.,9998,0,9999,1
1668321246845,COGS 210B,006,101425,Rossano; Federico,9999,0,9999,0
1668321247270,COGS 211B,A00,101427,Coulson; Seana M,9996,0,9999,3
1668321247700,COGS 220,A00,101428,Hollan; James D.,0,0,25,25
1668321248125,COGS 229,A00,101429,Dow; Steven P,18,0,25,7
1668321248548,COGS 230,A00,101430,Klemmer; Scott R,11,0,17,6
1668321248972,COGS 234,A00,101431,Xia; Haijun,1,0,25,24
1668321249398,COGS 260,A00,101432,Kiyonaga; Anastasia,21,0,25,4
1668321249398,COGS 260,B00,101433,Kirsh; David Joel,15,0,25,10
1668321249824,CSE 202,A00,102371,Impagliazzo; Russell,0,0,0,0
1668321250251,CSE 203B,A01,102373,Cheng; Chung Kuan,0,0,0,0
1668321250676,CSE 208,A00,102374,Micciancio; Daniele,0,0,0,0
1668321251103,CSE 209A,A00,112895,Impagliazzo; Russell,0,0,15,15
1668321251544,CSE 209B,A00,108005,Bellare; Mihir,0,0,0,0
1668321251968,CSE 210,A00,113163,Coblenz; Michael J,0,0,0,0
1668321252396,CSE 219,A00,106111,Dow; Steven P,0,0,20,20
1668321252819,CSE 221,A00,102376,Voelker; Geoffrey M.,0,0,0,0
1668321253246,CSE 224,A01,102378,Porter; George M,0,0,0,0
1668321253669,CSE 229A,A00,102379,Savage; Stefan,0,0,0,0
1668321254096,CSE 229C,A00,102380,Munyaka; Imani N. S.,0,0,0,0
1668321254520,CSE 232B,A00,102382,Deutsch; Alin Bernard,0,0,0,0
1668321254947,CSE 234,A01,112904,Kumar; Arun Kumar,0,0,0,0
1668321255376,CSE 237A,A00,102383,Rosing; Tajana Simunic,0,0,0,0
1668321255799,CSE 239A,A00,102384,Deutsch; Alin Bernard,0,0,0,0
1668321256222,CSE 239B,A00,102385,Polikarpova; Nadezhda,0,0,0,0
1668321256644,CSE 240A,A00,102386,Pannuto; Patrick William,0,0,0,0
1668321257071,CSE 240B,A00,102387,Zhao; Jishen,0,0,0,0
1668321257509,CSE 241A,A00,106406,Kang; Mingu,0,0,0,0
1668321257932,CSE 249B,A00,102388,Kahng; Andrew Byun,0,0,8,8
1668321258355,CSE 251B,A01,102392,Cottrell; Garrison W,0,0,0,0
1668321258355,CSE 251B,A02,102393,Cottrell; Garrison W,0,0,0,0
1668321258780,CSE 252B,A00,102394,Ochoa; Benjamin Lawrence,0,0,0,0
1668321259210,CSE 257,A01,102396,Gao; Sicun,0,0,0,0
1668321259660,CSE 272,A00,102397,Li; Tzumao,0,0,0,0
1668321260084,CSE 274,A00,111323,Chern; Albert Ren-Haur,0,0,0,0
1668321260511,CSE 282,A00,102398,Pevzner; Pavel Arkadjevich,0,0,0,0
1668321260937,CSE 284,A00,114175,Gymrek; Melissa Ann,0,0,0,0
1668321261362,CSE 290,A00,102399,Chandraker; Manmohan Krishna,0,0,0,0
1668321261362,CSE 290,B00,102400,Vaccaro; Kristen Marie,0,0,25,25
1668321261362,CSE 290,C00,102414,Pannuto; Patrick William,0,0,25,25
1668321261362,CSE 290,D00,102427,Pevzner; Pavel Arkadjevich,0,0,0,0
1668321261362,CSE 290,E00,102429,Zhao; Jishen,0,0,0,0
1668321261362,CSE 290,F00,102436,Tullsen; Dean Michael,0,0,0,0
1668321261362,CSE 290,G00,102440,Christensen; Henrik I,0,0,20,20
1668321261787,CSE 291,A00,102443,Su; Hao,0,0,0,0
1668321261787,CSE 291,B00,102448,Polikarpova; Nadezhda,0,0,0,0
1668321261787,CSE 291,C00,102453,Vaccaro; Kristen Marie,0,0,0,0
1668321261787,CSE 291,D00,111343,Savage; Stefan,0,0,0,0
1668321261787,CSE 291,E00,116474,Claffy; Kimberly Claire,0,0,0,0
1668321261787,CSE 291,F00,116479,Pasquale; Joseph,0,0,0,0
1668321262215,CSE 293,001,119111,Bafna; Vineet,9999,0,9999,0
1668321262215,CSE 293,002,119118,Bellare; Mihir,9999,0,9999,0
1668321262215,CSE 293,003,119122,Berg-Kirkpatrick; Taylor D,9999,0,9999,0
1668321262215,CSE 293,004,119135,Christensen; Henrik I,9999,0,9999,0
1668321262215,CSE 293,005,119142,Cottrell; Garrison W,9999,0,9999,0
1668321262215,CSE 293,006,119146,Deutsch; Alin Bernard,9999,0,9999,0
1668321262215,CSE 293,007,119159,Esmaeilzadeh; Hadi,9999,0,9999,0
1668321262215,CSE 293,008,119166,Freund; Yoav,9999,0,9999,0
1668321262215,CSE 293,009,119170,Griswold; William G.,9999,0,9999,0
1668321262215,CSE 293,010,119183,Gymrek; Melissa Ann,9999,0,9999,0
1668321262215,CSE 293,011,119190,Heninger; Nadia A,9999,0,9999,0
1668321262215,CSE 293,012,119230,Impagliazzo; Russell,9999,0,9999,0
1668321262215,CSE 293,013,119232,Jhala; Ranjit,9999,0,9999,0
1668321262215,CSE 293,014,119233,Kahng; Andrew Byun,9999,0,9999,0
1668321262215,CSE 293,015,119298,Kane; Daniel Mertz,9999,0,9999,0
1668321262215,CSE 293,016,119299,Kriegman; David J,9999,0,9999,0
1668321262215,CSE 293,017,119300,Kumar; Arun Kumar,9999,0,9999,0
1668321262215,CSE 293,018,119301,Lerner; Sorin,9999,0,9999,0
1668321262215,CSE 293,019,119302,Lovett; Shachar,9999,0,9999,0
1668321262215,CSE 293,020,119303,McAuley; Julian John,9999,0,9999,0
1668321262215,CSE 293,021,119304,Micciancio; Daniele,9999,0,9999,0
1668321262215,CSE 293,022,119367,Orailoglu; Alex,9999,0,9999,0
1668321262215,CSE 293,023,119382,Paturi; Ramamohan,9999,0,9999,0
1668321262215,CSE 293,024,119404,Polikarpova; Nadezhda,9999,0,9999,0
1668321262215,CSE 293,025,119406,Politz; Joseph Gibbs,9999,0,9999,0
1668321262215,CSE 293,026,119411,Porter; George M,9999,0,9999,0
1668321262215,CSE 293,027,119414,Porter; Leonard Emerson,9999,0,9999,0
1668321262215,CSE 293,028,119416,Ramamoorthi; Ravi,9999,0,9999,0
1668321262215,CSE 293,029,119417,Sahoo; Debashis,9999,0,9999,0
1668321262215,CSE 293,030,119420,Saul; Lawrence,9999,0,9999,0
1668321262215,CSE 293,031,119421,Savage; Stefan,9999,0,9999,0
1668321262215,CSE 293,032,119425,Schulze; Jurgen P.,9999,0,9999,0
1668321262215,CSE 293,033,119426,Snoeren; Alex C.,9999,0,9999,0
1668321262215,CSE 293,034,119428,Shang; Jingbo,9999,0,9999,0
1668321262215,CSE 293,035,119430,Stefan; Deian,9999,0,9999,0
1668321262215,CSE 293,036,119431,Su; Hao,9999,0,9999,0
1668321262215,CSE 293,037,119433,Swanson; Steven James,9999,0,9999,0
1668321262215,CSE 293,038,119435,Tullsen; Dean Michael,9999,0,9999,0
1668321262215,CSE 293,039,119483,Voelker; Geoffrey M.,9999,0,9999,0
1668321262215,CSE 293,040,119537,Zhao; Jishen,9999,0,9999,0
1668321262215,CSE 293,041,119538,Zhou; Yuan-Yuan,9999,0,9999,0
1668321262215,CSE 293,042,119539,Gao; Sicun,9999,0,9999,0
1668321262215,CSE 293,043,119540,Weibel; Nadir,9999,0,9999,0
1668321262215,CSE 293,044,119541,Gupta; Rajesh K.,9999,0,9999,0
1668321262215,CSE 293,045,126410,Vaccaro; Kristen Marie,9999,0,9999,0
1668321262215,CSE 293,046,126411,Klemke; Richard,9999,0,9999,0
1668321262637,CSE 294,A00,102459,Voelker; Geoffrey M.,0,0,0,0
1668321262637,CSE 294,B00,111322,Orailoglu; Alex,0,0,0,0
1668321263061,DSE 201,A00,096914,Deutsch; Alin Bernard,30,0,30,0
1668321263486,DSE 210,A00,096915,Dasgupta; Sanjoy,30,0,30,0
1668321263918,DSE 260A,A00,096916,Altintas De Callaf; Ilkay,30,0,30,0
1668321264356,ECE 200,001,103586,Antipa; Nicholas A,9999,0,9999,0
1668321264356,ECE 200,002,103587,Atanasov; Nikolay A.,9999,0,9999,0
1668321264356,ECE 200,003,103588,Bharadia; Dinesh,9999,0,9999,0
1668321264356,ECE 200,004,103589,Cheng; Chung Kuan,9999,0,9999,0
1668321264356,ECE 200,005,103590,Cosman; Pamela C.,9999,0,9999,0
1668321264356,ECE 200,006,103591,Dayeh; Shadi Ahmad,9999,0,9999,0
1668321264356,ECE 200,007,103592,Fainman; Yeshaiahu,9999,0,9999,0
1668321264356,ECE 200,008,103593,Ford; Joseph Earl,9999,0,9999,0
1668321264356,ECE 200,009,103594,Franceschetti; Massimo,9999,0,9999,0
1668321264356,ECE 200,010,103595,Fullerton; Eric E,9999,0,9999,0
1668321264356,ECE 200,011,103596,Galton; Ian A,9999,0,9999,0
1668321264356,ECE 200,012,103597,Gilja; Vikash,9999,0,9999,0
1668321264356,ECE 200,013,103598,Hall; Drew A.,9999,0,9999,0
1668321264356,ECE 200,014,103599,Hsueh; Tzu-Chien,9999,0,9999,0
1668321264356,ECE 200,015,103600,Javidi; Tara,9999,0,9999,0
1668321264356,ECE 200,016,103601,Kahng; Andrew Byun,9999,0,9999,0
1668321264356,ECE 200,017,103602,Kim; Young-Han,9999,0,9999,0
1668321264356,ECE 200,018,103603,Koushanfar; Farinaz,9999,0,9999,0
1668321264356,ECE 200,019,103604,Kuzum; Duygu,9999,0,9999,0
1668321264356,ECE 200,020,103605,Le; Hanh-Phuc,9999,0,9999,0
1668321264356,ECE 200,021,103606,Lin; Bill,9999,0,9999,0
1668321264356,ECE 200,022,103607,Liu; Zhaowei,9998,0,9999,1
1668321264356,ECE 200,023,103608,Lo; Yu-Hwa,9999,0,9999,0
1668321264356,ECE 200,024,103609,Lomakin; Vitaliy,9999,0,9999,0
1668321264356,ECE 200,025,103610,Mercier; Patrick Philip,9999,0,9999,0
1668321264356,ECE 200,026,103611,Meyer; Florian,9999,0,9999,0
1668321264356,ECE 200,027,103612,Milstein; Laurence B.,9999,0,9999,0
1668321264356,ECE 200,028,103613,Mir Arabbaygi; Siavash,9999,0,9999,0
1668321264356,ECE 200,029,103614,Mookherjea; Shayan,9999,0,9999,0
1668321264356,ECE 200,030,103615,Morris; Karcher William,9999,0,9999,0
1668321264356,ECE 200,031,103616,Ng; Tse Nga,9999,0,9999,0
1668321264356,ECE 200,032,103617,Nguyen; Truong Quang,9999,0,9999,0
1668321264356,ECE 200,033,103618,Nomura; Kenji,9999,0,9999,0
1668321264356,ECE 200,034,103619,Orlitsky; Alon,9999,0,9999,0
1668321264356,ECE 200,035,103620,Pal; Piya,9999,0,9999,0
1668321264356,ECE 200,036,103621,Papen; George C.,9999,0,9999,0
1668321264356,ECE 200,037,103622,Radic; Stojan,9999,0,9999,0
1668321264356,ECE 200,038,103623,Rao; Bhaskar D.,9999,0,9999,0
1668321264356,ECE 200,039,103624,Rao; Ramesh R,9999,0,9999,0
1668321264356,ECE 200,040,103625,Rebeiz; Gabriel,9999,0,9999,0
1668321264356,ECE 200,041,103626,Sanford; John R,9999,0,9999,0
1668321264356,ECE 200,042,103627,Siegel; Paul H.,9999,0,9999,0
1668321264356,ECE 200,043,103628,Sievenpiper; Daniel F.,9999,0,9999,0
1668321264356,ECE 200,044,103629,Sworder; David D.,9999,0,9999,0
1668321264356,ECE 200,045,103630,Taur; Yuan,9999,0,9999,0
1668321264356,ECE 200,046,103631,Touri; Behrouz,9999,0,9999,0
1668321264356,ECE 200,047,103632,Trivedi; Mohan M.,9999,0,9999,0
1668321264356,ECE 200,048,103633,Vasconcelos; Nuno,9999,0,9999,0
1668321264356,ECE 200,049,103634,Wang; Xiaolong,9999,0,9999,0
1668321264356,ECE 200,050,103635,Xie; Pengtao,9999,0,9999,0
1668321264356,ECE 200,051,103636,Yip; Michael,9999,0,9999,0
1668321264356,ECE 200,052,103637,Zeger; Kenneth A.,999,0,999,0
1668321264356,ECE 200,053,103638,Zhang; Xinyu,9999,0,9999,0
1668321264356,ECE 200,054,103639,Turakhia; Yatish Girish,9999,0,9999,0
1668321264356,ECE 200,055,103640,Kang; Mingu,9999,0,9999,0
1668321264356,ECE 200,056,103641,Shi; Yuanyuan,9999,0,9999,0
1668321264356,ECE 200,057,103642,Wang; Edward Jay,9999,0,9999,0
1668321264356,ECE 200,058,103643,Zheng; Yang,9999,0,9999,0
1668321264782,ECE 202,A00,103644,Kuzum; Duygu,0,0,0,0
1668321265208,ECE 212BN,A00,103646,Ng; Tse Nga,0,0,0,0
1668321265645,ECE 221,A00,111493,Staff,0,0,0,0
1668321266069,ECE 222B,A00,103647,Lomakin; Vitaliy,0,0,0,0
1668321266493,ECE 230B,A00,103648,Taur; Yuan,0,0,0,0
1668321266926,ECE 238B,A00,103649,Garay; Javier,0,0,0,0
1668321267351,ECE 240B,A00,112900,Fainman; Yeshaiahu,0,0,0,0
1668321267847,ECE 247A,A00,103650,Jokerst; Jesse Vincent,0,0,0,0
1668321268273,ECE 247B,A00,103651,Wang; Joseph,0,0,0,0
1668321268704,ECE 250,A00,103652,Siegel; Paul H.,0,0,0,0
1668321269134,ECE 251A,A00,103654,Rao; Bhaskar D.,0,0,0,0
1668321269572,ECE 257B,A00,103655,Bharadia; Dinesh,0,0,0,0
1668321269997,ECE 258A,A00,103656,Milstein; Laurence B.,0,0,0,0
1668321270422,ECE 260B,A00,103658,Kang; Mingu,0,0,0,0
1668321270847,ECE 264A,A00,103659,Galton; Ian A,0,0,0,0
1668321271269,ECE 265A,A00,103661,Gudem; Prasad S.S.,0,0,0,0
1668321271693,ECE 265D,A00,103662,Gudem; Prasad S.S.,0,0,0,0
1668321272117,ECE 268,A00,103663,Koushanfar; Farinaz,0,0,0,0
1668321272540,ECE 269,A01,103665,Pal; Piya,0,0,0,0
1668321272967,ECE 271B,A00,103666,Vasconcelos; Manuela,0,0,0,0
1668321273392,ECE 276A,A00,103667,Atanasov; Nikolay A.,0,0,0,0
1668321273814,ECE 277,A00,103668,An; Cheolhong,0,0,0,0
1668321274245,ECE 279,A00,117947,Hall; Drew A.,0,0,0,0
1668321275095,ECE 283,A00,103670,Hsueh; Tzu-Chien,0,0,0,0
1668321275522,ECE 284,A00,103671,Turakhia; Yatish Girish,0,0,0,0
1668321275947,ECE 285,A00,103672,Zheng; Yang,0,0,0,0
1668321275947,ECE 285,B00,103673,Sworder; David D.,0,0,0,0
1668321276368,ECE 287,A00,103676,Javidi; Tara,0,0,0,0
1668321276801,MATH 200B,A00,098023,Salehi Golsefidy; Alireza,12,0,15,3
1668321277236,MATH 202B,A00,098024,Rhoades; Brendon Patrick,9,0,15,6
1668321277658,MATH 203B,A00,098025,Oprea; Dragos N.,10,0,15,5
1668321278085,MATH 204B,A00,098026,Sorensen; Claus M,13,0,15,2
1668321278509,MATH 208,A00,098027,Izadi; Elham,7,0,10,3
1668321278940,MATH 209,A00,098028,Pollack; Aaron,10,0,10,0
1668321279364,MATH 211A,A00,112919,Rogalski; Daniel,9,0,10,1
1668321279787,MATH 211B,A00,112920,Seward; Brandon M.,9,0,10,1
1668321280212,MATH 218,A00,098029,Li; Bo,10,0,10,0
1668321280648,MATH 220B,A00,098030,Novak; Jonathan I,11,0,15,4
1668321281076,MATH 221A,A00,098031,Ebenfelt; Peter F,13,0,15,2
1668321281501,MATH 231B,A00,098032,Zlatos; Andrej,12,0,15,3
1668321281927,MATH 240B,A00,098033,Ni; Lei,9,0,15,6
1668321282350,MATH 243,A00,098034,Jekel; David Andrew,10,0,10,0
1668321282787,MATH 245A,A00,098035,Nie; Jiawang,0,0,15,16
1668321283211,MATH 248,A00,098036,Bejenaru; Ioan,10,0,10,0
1668321283635,MATH 250B,A00,098037,Spolaor; Luca,14,0,15,1
1668321284060,MATH 258,A00,098038,Ni; Lei,10,0,10,0
1668321284483,MATH 264B,A00,098041,Rhoades; Brendon Patrick,9,0,15,6
1668321284919,MATH 268,A00,098042,Buss; Samuel R,10,0,10,0
1668321285349,MATH 269,A00,098043,Rhoades; Brendon Patrick,10,0,10,0
1668321285773,MATH 270B,A00,098044,Li; Bo,10,0,15,5
1668321286207,MATH 272B,A00,098045,Holst; Michael J,13,0,15,2
1668321286631,MATH 273A,A00,098046,Tian; Xiaochuan,10,0,15,5
1668321287063,MATH 275,A01,098048,Tian; Xiaochuan,6,0,10,4
1668321287494,MATH 278A,A00,098049,Holst; Michael J,8,0,10,2
1668321287927,MATH 278B,A00,098050,Cloninger; Alexander,10,0,10,0
1668321288353,MATH 278C,A00,098051,Nie; Jiawang,7,0,10,3
1668321288774,MATH 280B,A00,098052,Zheng; Tianyi,8,0,15,7
1668321289211,MATH 281B,A00,098053,Bradic; Jelena,1,0,15,14
1668321289645,MATH 282B,A00,098054,Arias-Castro; Ery,0,0,15,15
1668321290089,MATH 285,A00,098055,Fitzsimmons; Patrick J,0,0,15,17
1668321290517,MATH 287B,A00,098056,Arias-Castro; Ery,2,0,15,13
1668321290946,MATH 288,A00,098057,Agarwal; Pooja,9,0,10,1
1668321290946,MATH 288,B00,098058,Zhang; Danna,8,0,10,2
1668321290946,MATH 288,C00,098059,Williams; Ruth J,9,0,10,1
1668321291372,MATH 290B,A00,098060,Roberts; Justin Deritter,13,0,15,2
1668321291794,MATH 292,A00,098061,Belmont; Eva Kinoshita,10,0,10,0
1668321292217,MATH 295,A00,098062,Suk; Andrew Hoon,48,0,50,2
1668321292656,MATH 296,A00,098063,Novak; Jonathan I,20,0,20,0
1668321293079,MATH 297,001,098064,Gamst; Anthony Collins,9997,0,9999,2
1668321792322,COGS 205,A00,101395,Chiba; Andrea,19,0,20,1
1668321792745,COGS 210B,001,101404,Greene; Deanna Jacquelyn,9998,0,9999,1
1668321792745,COGS 210B,002,101417,Xia; Haijun,9999,0,9999,0
1668321792745,COGS 210B,003,101422,Nitz; Douglas A.,9999,0,9999,0
1668321792745,COGS 210B,004,101423,Hollan; James D.,9998,0,9999,1
1668321792745,COGS 210B,005,101424,Deak; Gedeon O.,9998,0,9999,1
1668321792745,COGS 210B,006,101425,Rossano; Federico,9999,0,9999,0
1668321793168,COGS 211B,A00,101427,Coulson; Seana M,9996,0,9999,3
1668321793591,COGS 220,A00,101428,Hollan; James D.,0,0,25,25
1668321794018,COGS 229,A00,101429,Dow; Steven P,18,0,25,7
1668321794444,COGS 230,A00,101430,Klemmer; Scott R,11,0,17,6
1668321794871,COGS 234,A00,101431,Xia; Haijun,1,0,25,24
1668321795295,COGS 260,A00,101432,Kiyonaga; Anastasia,21,0,25,4
1668321795295,COGS 260,B00,101433,Kirsh; David Joel,15,0,25,10
1668321795717,CSE 202,A00,102371,Impagliazzo; Russell,0,0,0,0
1668321796141,CSE 203B,A01,102373,Cheng; Chung Kuan,0,0,0,0
1668321796566,CSE 208,A00,102374,Micciancio; Daniele,0,0,0,0
1668321797002,CSE 209A,A00,112895,Impagliazzo; Russell,0,0,15,15
1668321797425,CSE 209B,A00,108005,Bellare; Mihir,0,0,0,0
1668321797848,CSE 210,A00,113163,Coblenz; Michael J,0,0,0,0
1668321798272,CSE 219,A00,106111,Dow; Steven P,0,0,20,20
1668321798697,CSE 221,A00,102376,Voelker; Geoffrey M.,0,0,0,0
1668321799121,CSE 224,A01,102378,Porter; George M,0,0,0,0
1668321799548,CSE 229A,A00,102379,Savage; Stefan,0,0,0,0
1668321799978,CSE 229C,A00,102380,Munyaka; Imani N. S.,0,0,0,0
1668321800402,CSE 232B,A00,102382,Deutsch; Alin Bernard,0,0,0,0
1668321800828,CSE 234,A01,112904,Kumar; Arun Kumar,0,0,0,0
1668321801251,CSE 237A,A00,102383,Rosing; Tajana Simunic,0,0,0,0
1668321801692,CSE 239A,A00,102384,Deutsch; Alin Bernard,0,0,0,0
1668321802115,CSE 239B,A00,102385,Polikarpova; Nadezhda,0,0,0,0
1668321802542,CSE 240A,A00,102386,Pannuto; Patrick William,0,0,0,0
1668321802966,CSE 240B,A00,102387,Zhao; Jishen,0,0,0,0
1668321803393,CSE 241A,A00,106406,Kang; Mingu,0,0,0,0
1668321803819,CSE 249B,A00,102388,Kahng; Andrew Byun,0,0,8,8
1668321804246,CSE 251B,A01,102392,Cottrell; Garrison W,0,0,0,0
1668321804246,CSE 251B,A02,102393,Cottrell; Garrison W,0,0,0,0
1668321804674,CSE 252B,A00,102394,Ochoa; Benjamin Lawrence,0,0,0,0
1668321805099,CSE 257,A01,102396,Gao; Sicun,0,0,0,0
1668321805524,CSE 272,A00,102397,Li; Tzumao,0,0,0,0
1668321805949,CSE 274,A00,111323,Chern; Albert Ren-Haur,0,0,0,0
1668321806373,CSE 282,A00,102398,Pevzner; Pavel Arkadjevich,0,0,0,0
1668321806797,CSE 284,A00,114175,Gymrek; Melissa Ann,0,0,0,0
1668321807223,CSE 290,A00,102399,Chandraker; Manmohan Krishna,0,0,0,0
1668321807223,CSE 290,B00,102400,Vaccaro; Kristen Marie,0,0,25,25
1668321807223,CSE 290,C00,102414,Pannuto; Patrick William,0,0,25,25
1668321807223,CSE 290,D00,102427,Pevzner; Pavel Arkadjevich,0,0,0,0
1668321807223,CSE 290,E00,102429,Zhao; Jishen,0,0,0,0
1668321807223,CSE 290,F00,102436,Tullsen; Dean Michael,0,0,0,0
1668321807223,CSE 290,G00,102440,Christensen; Henrik I,0,0,20,20
1668321817720,CSE 291,A00,102443,Su; Hao,0,0,0,0
1668321817720,CSE 291,B00,102448,Polikarpova; Nadezhda,0,0,0,0
1668321817720,CSE 291,C00,102453,Vaccaro; Kristen Marie,0,0,0,0
1668321817720,CSE 291,D00,111343,Savage; Stefan,0,0,0,0
1668321817720,CSE 291,E00,116474,Claffy; Kimberly Claire,0,0,0,0
1668321817720,CSE 291,F00,116479,Pasquale; Joseph,0,0,0,0
1668321818174,CSE 293,001,119111,Bafna; Vineet,9999,0,9999,0
1668321818174,CSE 293,002,119118,Bellare; Mihir,9999,0,9999,0
1668321818174,CSE 293,003,119122,Berg-Kirkpatrick; Taylor D,9999,0,9999,0
1668321818174,CSE 293,004,119135,Christensen; Henrik I,9999,0,9999,0
1668321818174,CSE 293,005,119142,Cottrell; Garrison W,9999,0,9999,0
1668321818174,CSE 293,006,119146,Deutsch; Alin Bernard,9999,0,9999,0
1668321818174,CSE 293,007,119159,Esmaeilzadeh; Hadi,9999,0,9999,0
1668321818174,CSE 293,008,119166,Freund; Yoav,9999,0,9999,0
1668321818174,CSE 293,009,119170,Griswold; William G.,9999,0,9999,0
1668321818174,CSE 293,010,119183,Gymrek; Melissa Ann,9999,0,9999,0
1668321818174,CSE 293,011,119190,Heninger; Nadia A,9999,0,9999,0
1668321818174,CSE 293,012,119230,Impagliazzo; Russell,9999,0,9999,0
1668321818174,CSE 293,013,119232,Jhala; Ranjit,9999,0,9999,0
1668321818174,CSE 293,014,119233,Kahng; Andrew Byun,9999,0,9999,0
1668321818174,CSE 293,015,119298,Kane; Daniel Mertz,9999,0,9999,0
1668321818174,CSE 293,016,119299,Kriegman; David J,9999,0,9999,0
1668321818174,CSE 293,017,119300,Kumar; Arun Kumar,9999,0,9999,0
1668321818174,CSE 293,018,119301,Lerner; Sorin,9999,0,9999,0
1668321818174,CSE 293,019,119302,Lovett; Shachar,9999,0,9999,0
1668321818174,CSE 293,020,119303,McAuley; Julian John,9999,0,9999,0
1668321818174,CSE 293,021,119304,Micciancio; Daniele,9999,0,9999,0
1668321818174,CSE 293,022,119367,Orailoglu; Alex,9999,0,9999,0
1668321818174,CSE 293,023,119382,Paturi; Ramamohan,9999,0,9999,0
1668321818174,CSE 293,024,119404,Polikarpova; Nadezhda,9999,0,9999,0
1668321818174,CSE 293,025,119406,Politz; Joseph Gibbs,9999,0,9999,0
1668321818174,CSE 293,026,119411,Porter; George M,9999,0,9999,0
1668321818174,CSE 293,027,119414,Porter; Leonard Emerson,9999,0,9999,0
1668321818174,CSE 293,028,119416,Ramamoorthi; Ravi,9999,0,9999,0
1668321818174,CSE 293,029,119417,Sahoo; Debashis,9999,0,9999,0
1668321818174,CSE 293,030,119420,Saul; Lawrence,9999,0,9999,0
1668321818174,CSE 293,031,119421,Savage; Stefan,9999,0,9999,0
1668321818174,CSE 293,032,119425,Schulze; Jurgen P.,9999,0,9999,0
1668321818174,CSE 293,033,119426,Snoeren; Alex C.,9999,0,9999,0
1668321818174,CSE 293,034,119428,Shang; Jingbo,9999,0,9999,0
1668321818174,CSE 293,035,119430,Stefan; Deian,9999,0,9999,0
1668321818174,CSE 293,036,119431,Su; Hao,9999,0,9999,0
1668321818174,CSE 293,037,119433,Swanson; Steven James,9999,0,9999,0
1668321818174,CSE 293,038,119435,Tullsen; Dean Michael,9999,0,9999,0
1668321818174,CSE 293,039,119483,Voelker; Geoffrey M.,9999,0,9999,0
1668321818174,CSE 293,040,119537,Zhao; Jishen,9999,0,9999,0
1668321818174,CSE 293,041,119538,Zhou; Yuan-Yuan,9999,0,9999,0
1668321818174,CSE 293,042,119539,Gao; Sicun,9999,0,9999,0
1668321818174,CSE 293,043,119540,Weibel; Nadir,9999,0,9999,0
1668321818174,CSE 293,044,119541,Gupta; Rajesh K.,9999,0,9999,0
1668321818174,CSE 293,045,126410,Vaccaro; Kristen Marie,9999,0,9999,0
1668321818174,CSE 293,046,126411,Klemke; Richard,9999,0,9999,0
1668321818598,CSE 294,A00,102459,Voelker; Geoffrey M.,0,0,0,0
1668321818598,CSE 294,B00,111322,Orailoglu; Alex,0,0,0,0
1668321819025,DSE 201,A00,096914,Deutsch; Alin Bernard,30,0,30,0
1668321819450,DSE 210,A00,096915,Dasgupta; Sanjoy,30,0,30,0
1668321819874,DSE 260A,A00,096916,Altintas De Callaf; Ilkay,30,0,30,0
1668321820332,ECE 200,001,103586,Antipa; Nicholas A,9999,0,9999,0
1668321820332,ECE 200,002,103587,Atanasov; Nikolay A.,9999,0,9999,0
1668321820332,ECE 200,003,103588,Bharadia; Dinesh,9999,0,9999,0
1668321820332,ECE 200,004,103589,Cheng; Chung Kuan,9999,0,9999,0
1668321820332,ECE 200,005,103590,Cosman; Pamela C.,9999,0,9999,0
1668321820332,ECE 200,006,103591,Dayeh; Shadi Ahmad,9999,0,9999,0
1668321820332,ECE 200,007,103592,Fainman; Yeshaiahu,9999,0,9999,0
1668321820332,ECE 200,008,103593,Ford; Joseph Earl,9999,0,9999,0
1668321820332,ECE 200,009,103594,Franceschetti; Massimo,9999,0,9999,0
1668321820332,ECE 200,010,103595,Fullerton; Eric E,9999,0,9999,0
1668321820332,ECE 200,011,103596,Galton; Ian A,9999,0,9999,0
1668321820332,ECE 200,012,103597,Gilja; Vikash,9999,0,9999,0
1668321820332,ECE 200,013,103598,Hall; Drew A.,9999,0,9999,0
1668321820332,ECE 200,014,103599,Hsueh; Tzu-Chien,9999,0,9999,0
1668321820332,ECE 200,015,103600,Javidi; Tara,9999,0,9999,0
1668321820332,ECE 200,016,103601,Kahng; Andrew Byun,9999,0,9999,0
1668321820332,ECE 200,017,103602,Kim; Young-Han,9999,0,9999,0
1668321820332,ECE 200,018,103603,Koushanfar; Farinaz,9999,0,9999,0
1668321820332,ECE 200,019,103604,Kuzum; Duygu,9999,0,9999,0
1668321820332,ECE 200,020,103605,Le; Hanh-Phuc,9999,0,9999,0
1668321820332,ECE 200,021,103606,Lin; Bill,9999,0,9999,0
1668321820332,ECE 200,022,103607,Liu; Zhaowei,9998,0,9999,1
1668321820332,ECE 200,023,103608,Lo; Yu-Hwa,9999,0,9999,0
1668321820332,ECE 200,024,103609,Lomakin; Vitaliy,9999,0,9999,0
1668321820332,ECE 200,025,103610,Mercier; Patrick Philip,9999,0,9999,0
1668321820332,ECE 200,026,103611,Meyer; Florian,9999,0,9999,0
1668321820332,ECE 200,027,103612,Milstein; Laurence B.,9999,0,9999,0
1668321820332,ECE 200,028,103613,Mir Arabbaygi; Siavash,9999,0,9999,0
1668321820332,ECE 200,029,103614,Mookherjea; Shayan,9999,0,9999,0
1668321820332,ECE 200,030,103615,Morris; Karcher William,9999,0,9999,0
1668321820332,ECE 200,031,103616,Ng; Tse Nga,9999,0,9999,0
1668321820332,ECE 200,032,103617,Nguyen; Truong Quang,9999,0,9999,0
1668321820332,ECE 200,033,103618,Nomura; Kenji,9999,0,9999,0
1668321820332,ECE 200,034,103619,Orlitsky; Alon,9999,0,9999,0
1668321820332,ECE 200,035,103620,Pal; Piya,9999,0,9999,0
1668321820332,ECE 200,036,103621,Papen; George C.,9999,0,9999,0
1668321820332,ECE 200,037,103622,Radic; Stojan,9999,0,9999,0
1668321820332,ECE 200,038,103623,Rao; Bhaskar D.,9999,0,9999,0
1668321820332,ECE 200,039,103624,Rao; Ramesh R,9999,0,9999,0
1668321820332,ECE 200,040,103625,Rebeiz; Gabriel,9999,0,9999,0
1668321820332,ECE 200,041,103626,Sanford; John R,9999,0,9999,0
1668321820332,ECE 200,042,103627,Siegel; Paul H.,9999,0,9999,0
1668321820332,ECE 200,043,103628,Sievenpiper; Daniel F.,9999,0,9999,0
1668321820332,ECE 200,044,103629,Sworder; David D.,9999,0,9999,0
1668321820332,ECE 200,045,103630,Taur; Yuan,9999,0,9999,0
1668321820332,ECE 200,046,103631,Touri; Behrouz,9999,0,9999,0
1668321820332,ECE 200,047,103632,Trivedi; Mohan M.,9999,0,9999,0
1668321820332,ECE 200,048,103633,Vasconcelos; Nuno,9999,0,9999,0
1668321820332,ECE 200,049,103634,Wang; Xiaolong,9999,0,9999,0
1668321820332,ECE 200,050,103635,Xie; Pengtao,9999,0,9999,0
1668321820332,ECE 200,051,103636,Yip; Michael,9999,0,9999,0
1668321820332,ECE 200,052,103637,Zeger; Kenneth A.,999,0,999,0
1668321820332,ECE 200,053,103638,Zhang; Xinyu,9999,0,9999,0
1668321820332,ECE 200,054,103639,Turakhia; Yatish Girish,9999,0,9999,0
1668321820332,ECE 200,055,103640,Kang; Mingu,9999,0,9999,0
1668321820332,ECE 200,056,103641,Shi; Yuanyuan,9999,0,9999,0
1668321820332,ECE 200,057,103642,Wang; Edward Jay,9999,0,9999,0
1668321820332,ECE 200,058,103643,Zheng; Yang,9999,0,9999,0
1668321820758,ECE 202,A00,103644,Kuzum; Duygu,0,0,0,0
1668321821181,ECE 212BN,A00,103646,Ng; Tse Nga,0,0,0,0
1668321821607,ECE 221,A00,111493,Staff,0,0,0,0
1668321822030,ECE 222B,A00,103647,Lomakin; Vitaliy,0,0,0,0
1668321822454,ECE 230B,A00,103648,Taur; Yuan,0,0,0,0
1668321822878,ECE 238B,A00,103649,Garay; Javier,0,0,0,0
1668321823302,ECE 240B,A00,112900,Fainman; Yeshaiahu,0,0,0,0
1668321823728,ECE 247A,A00,103650,Jokerst; Jesse Vincent,0,0,0,0
1668321824151,ECE 247B,A00,103651,Wang; Joseph,0,0,0,0
1668321824579,ECE 250,A00,103652,Siegel; Paul H.,0,0,0,0
1668321825008,ECE 251A,A00,103654,Rao; Bhaskar D.,0,0,0,0
1668321825435,ECE 257B,A00,103655,Bharadia; Dinesh,0,0,0,0
1668321825871,ECE 258A,A00,103656,Milstein; Laurence B.,0,0,0,0
1668321826295,ECE 260B,A00,103658,Kang; Mingu,0,0,0,0
1668321826720,ECE 264A,A00,103659,Galton; Ian A,0,0,0,0
1668321827147,ECE 265A,A00,103661,Gudem; Prasad S.S.,0,0,0,0
1668321827575,ECE 265D,A00,103662,Gudem; Prasad S.S.,0,0,0,0
1668321828004,ECE 268,A00,103663,Koushanfar; Farinaz,0,0,0,0
1668321828427,ECE 269,A01,103665,Pal; Piya,0,0,0,0
1668321828869,ECE 271B,A00,103666,Vasconcelos; Manuela,0,0,0,0
1668321829292,ECE 276A,A00,103667,Atanasov; Nikolay A.,0,0,0,0
1668321829723,ECE 277,A00,103668,An; Cheolhong,0,0,0,0
1668321830150,ECE 279,A00,117947,Hall; Drew A.,0,0,0,0
1668321831019,ECE 283,A00,103670,Hsueh; Tzu-Chien,0,0,0,0
1668321831448,ECE 284,A00,103671,Turakhia; Yatish Girish,0,0,0,0
1668321831872,ECE 285,A00,103672,Zheng; Yang,0,0,0,0
1668321831872,ECE 285,B00,103673,Sworder; David D.,0,0,0,0
1668321832301,ECE 287,A00,103676,Javidi; Tara,0,0,0,0
1668321832730,MATH 200B,A00,098023,Salehi Golsefidy; Alireza,12,0,15,3
1668321833153,MATH 202B,A00,098024,Rhoades; Brendon Patrick,9,0,15,6
1668321833578,MATH 203B,A00,098025,Oprea; Dragos N.,10,0,15,5
1668321834003,MATH 204B,A00,098026,Sorensen; Claus M,13,0,15,2
1668321834428,MATH 208,A00,098027,Izadi; Elham,7,0,10,3
1668321834850,MATH 209,A00,098028,Pollack; Aaron,10,0,10,0
1668321835274,MATH 211A,A00,112919,Rogalski; Daniel,9,0,10,1
1668321835697,MATH 211B,A00,112920,Seward; Brandon M.,9,0,10,1
1668321836119,MATH 218,A00,098029,Li; Bo,10,0,10,0
1668321836542,MATH 220B,A00,098030,Novak; Jonathan I,11,0,15,4
1668321836965,MATH 221A,A00,098031,Ebenfelt; Peter F,13,0,15,2
1668321837397,MATH 231B,A00,098032,Zlatos; Andrej,12,0,15,3
1668321837822,MATH 240B,A00,098033,Ni; Lei,9,0,15,6
1668321838249,MATH 243,A00,098034,Jekel; David Andrew,10,0,10,0
1668321838675,MATH 245A,A00,098035,Nie; Jiawang,0,0,15,16
1668321839106,MATH 248,A00,098036,Bejenaru; Ioan,10,0,10,0
1668321839532,MATH 250B,A00,098037,Spolaor; Luca,14,0,15,1
1668321839957,MATH 258,A00,098038,Ni; Lei,10,0,10,0
1668321840482,MATH 264B,A00,098041,Rhoades; Brendon Patrick,9,0,15,6
1668321840909,MATH 268,A00,098042,Buss; Samuel R,10,0,10,0
1668321841343,MATH 269,A00,098043,Rhoades; Brendon Patrick,10,0,10,0
1668321841778,MATH 270B,A00,098044,Li; Bo,10,0,15,5
1668321842201,MATH 272B,A00,098045,Holst; Michael J,13,0,15,2
1668321842635,MATH 273A,A00,098046,Tian; Xiaochuan,10,0,15,5
1668321843058,MATH 275,A01,098048,Tian; Xiaochuan,6,0,10,4
1668321843480,MATH 278A,A00,098049,Holst; Michael J,8,0,10,2
1668321843903,MATH 278B,A00,098050,Cloninger; Alexander,10,0,10,0
1668321844328,MATH 278C,A00,098051,Nie; Jiawang,7,0,10,3
1668321844752,MATH 280B,A00,098052,Zheng; Tianyi,8,0,15,7
1668321845178,MATH 281B,A00,098053,Bradic; Jelena,1,0,15,14
1668321845603,MATH 282B,A00,098054,Arias-Castro; Ery,0,0,15,15
1668321846027,MATH 285,A00,098055,Fitzsimmons; Patrick J,0,0,15,17
1668321846453,MATH 287B,A00,098056,Arias-Castro; Ery,2,0,15,13
1668321846876,MATH 288,A00,098057,Agarwal; Pooja,9,0,10,1
1668321846876,MATH 288,B00,098058,Zhang; Danna,8,0,10,2
1668321846876,MATH 288,C00,098059,Williams; Ruth J,9,0,10,1
1668321847302,MATH 290B,A00,098060,Roberts; Justin Deritter,13,0,15,2
1668321847726,MATH 292,A00,098061,Belmont; Eva Kinoshita,10,0,10,0
1668321848160,MATH 295,A00,098062,Suk; Andrew Hoon,48,0,50,2
1668321848584,MATH 296,A00,098063,Novak; Jonathan I,20,0,20,0
1668321849234,MATH 297,001,098064,Gamst; Anthony Collins,9997,0,9999,2
1668322347822,COGS 205,A00,101395,Chiba; Andrea,19,0,20,1
1668322348247,COGS 210B,001,101404,Greene; Deanna Jacquelyn,9998,0,9999,1
1668322348247,COGS 210B,002,101417,Xia; Haijun,9999,0,9999,0
1668322348247,COGS 210B,003,101422,Nitz; Douglas A.,9999,0,9999,0
1668322348247,COGS 210B,004,101423,Hollan; James D.,9998,0,9999,1
1668322348247,COGS 210B,005,101424,Deak; Gedeon O.,9998,0,9999,1
1668322348247,COGS 210B,006,101425,Rossano; Federico,9999,0,9999,0
1668322348671,COGS 211B,A00,101427,Coulson; Seana M,9996,0,9999,3
1668322349095,COGS 220,A00,101428,Hollan; James D.,0,0,25,25
1668322349519,COGS 229,A00,101429,Dow; Steven P,18,0,25,7
1668322349942,COGS 230,A00,101430,Klemmer; Scott R,11,0,17,6
1668322350368,COGS 234,A00,101431,Xia; Haijun,1,0,25,24
1668322350789,COGS 260,A00,101432,Kiyonaga; Anastasia,21,0,25,4
1668322350789,COGS 260,B00,101433,Kirsh; David Joel,15,0,25,10
1668322351211,CSE 202,A00,102371,Impagliazzo; Russell,0,0,0,0
1668322351636,CSE 203B,A01,102373,Cheng; Chung Kuan,0,0,0,0
1668322352063,CSE 208,A00,102374,Micciancio; Daniele,0,0,0,0
1668322352488,CSE 209A,A00,112895,Impagliazzo; Russell,0,0,15,15
1668322352912,CSE 209B,A00,108005,Bellare; Mihir,0,0,0,0
1668322353337,CSE 210,A00,113163,Coblenz; Michael J,0,0,0,0
1668322353762,CSE 219,A00,106111,Dow; Steven P,0,0,20,20
1668322354187,CSE 221,A00,102376,Voelker; Geoffrey M.,0,0,0,0
1668322354610,CSE 224,A01,102378,Porter; George M,0,0,0,0
1668322355032,CSE 229A,A00,102379,Savage; Stefan,0,0,0,0
1668322355458,CSE 229C,A00,102380,Munyaka; Imani N. S.,0,0,0,0
1668322355885,CSE 232B,A00,102382,Deutsch; Alin Bernard,0,0,0,0
1668322356312,CSE 234,A01,112904,Kumar; Arun Kumar,0,0,0,0
1668322356738,CSE 237A,A00,102383,Rosing; Tajana Simunic,0,0,0,0
1668322357163,CSE 239A,A00,102384,Deutsch; Alin Bernard,0,0,0,0
1668322357590,CSE 239B,A00,102385,Polikarpova; Nadezhda,0,0,0,0
1668322358015,CSE 240A,A00,102386,Pannuto; Patrick William,0,0,0,0
1668322358445,CSE 240B,A00,102387,Zhao; Jishen,0,0,0,0
1668322358867,CSE 241A,A00,106406,Kang; Mingu,0,0,0,0
1668322359381,CSE 249B,A00,102388,Kahng; Andrew Byun,0,0,8,8
1668322359806,CSE 251B,A01,102392,Cottrell; Garrison W,0,0,0,0
1668322359806,CSE 251B,A02,102393,Cottrell; Garrison W,0,0,0,0
1668322360230,CSE 252B,A00,102394,Ochoa; Benjamin Lawrence,0,0,0,0
1668322360655,CSE 257,A01,102396,Gao; Sicun,0,0,0,0
1668322361077,CSE 272,A00,102397,Li; Tzumao,0,0,0,0
1668322361504,CSE 274,A00,111323,Chern; Albert Ren-Haur,0,0,0,0
1668322361931,CSE 282,A00,102398,Pevzner; Pavel Arkadjevich,0,0,0,0
1668322362357,CSE 284,A00,114175,Gymrek; Melissa Ann,0,0,0,0
1668322362779,CSE 290,A00,102399,Chandraker; Manmohan Krishna,0,0,0,0
1668322362779,CSE 290,B00,102400,Vaccaro; Kristen Marie,0,0,25,25
1668322362779,CSE 290,C00,102414,Pannuto; Patrick William,0,0,25,25
1668322362779,CSE 290,D00,102427,Pevzner; Pavel Arkadjevich,0,0,0,0
1668322362779,CSE 290,E00,102429,Zhao; Jishen,0,0,0,0
1668322362779,CSE 290,F00,102436,Tullsen; Dean Michael,0,0,0,0
1668322362779,CSE 290,G00,102440,Christensen; Henrik I,0,0,20,20
1668322363203,CSE 291,A00,102443,Su; Hao,0,0,0,0
1668322363203,CSE 291,B00,102448,Polikarpova; Nadezhda,0,0,0,0
1668322363203,CSE 291,C00,102453,Vaccaro; Kristen Marie,0,0,0,0
1668322363203,CSE 291,D00,111343,Savage; Stefan,0,0,0,0
1668322363203,CSE 291,E00,116474,Claffy; Kimberly Claire,0,0,0,0
1668322363203,CSE 291,F00,116479,Pasquale; Joseph,0,0,0,0
1668322363630,CSE 293,001,119111,Bafna; Vineet,9999,0,9999,0
1668322363630,CSE 293,002,119118,Bellare; Mihir,9999,0,9999,0
1668322363630,CSE 293,003,119122,Berg-Kirkpatrick; Taylor D,9999,0,9999,0
1668322363630,CSE 293,004,119135,Christensen; Henrik I,9999,0,9999,0
1668322363630,CSE 293,005,119142,Cottrell; Garrison W,9999,0,9999,0
1668322363630,CSE 293,006,119146,Deutsch; Alin Bernard,9999,0,9999,0
1668322363630,CSE 293,007,119159,Esmaeilzadeh; Hadi,9999,0,9999,0
1668322363630,CSE 293,008,119166,Freund; Yoav,9999,0,9999,0
1668322363630,CSE 293,009,119170,Griswold; William G.,9999,0,9999,0
1668322363630,CSE 293,010,119183,Gymrek; Melissa Ann,9999,0,9999,0
1668322363630,CSE 293,011,119190,Heninger; Nadia A,9999,0,9999,0
1668322363630,CSE 293,012,119230,Impagliazzo; Russell,9999,0,9999,0
1668322363630,CSE 293,013,119232,Jhala; Ranjit,9999,0,9999,0
1668322363630,CSE 293,014,119233,Kahng; Andrew Byun,9999,0,9999,0
1668322363630,CSE 293,015,119298,Kane; Daniel Mertz,9999,0,9999,0
1668322363630,CSE 293,016,119299,Kriegman; David J,9999,0,9999,0
1668322363630,CSE 293,017,119300,Kumar; Arun Kumar,9999,0,9999,0
1668322363630,CSE 293,018,119301,Lerner; Sorin,9999,0,9999,0
1668322363630,CSE 293,019,119302,Lovett; Shachar,9999,0,9999,0
1668322363630,CSE 293,020,119303,McAuley; Julian John,9999,0,9999,0
1668322363630,CSE 293,021,119304,Micciancio; Daniele,9999,0,9999,0
1668322363630,CSE 293,022,119367,Orailoglu; Alex,9999,0,9999,0
1668322363630,CSE 293,023,119382,Paturi; Ramamohan,9999,0,9999,0
1668322363630,CSE 293,024,119404,Polikarpova; Nadezhda,9999,0,9999,0
1668322363630,CSE 293,025,119406,Politz; Joseph Gibbs,9999,0,9999,0
1668322363630,CSE 293,026,119411,Porter; George M,9999,0,9999,0
1668322363630,CSE 293,027,119414,Porter; Leonard Emerson,9999,0,9999,0
1668322363630,CSE 293,028,119416,Ramamoorthi; Ravi,9999,0,9999,0
1668322363630,CSE 293,029,119417,Sahoo; Debashis,9999,0,9999,0
1668322363630,CSE 293,030,119420,Saul; Lawrence,9999,0,9999,0
1668322363630,CSE 293,031,119421,Savage; Stefan,9999,0,9999,0
1668322363630,CSE 293,032,119425,Schulze; Jurgen P.,9999,0,9999,0
1668322363630,CSE 293,033,119426,Snoeren; Alex C.,9999,0,9999,0
1668322363630,CSE 293,034,119428,Shang; Jingbo,9999,0,9999,0
1668322363630,CSE 293,035,119430,Stefan; Deian,9999,0,9999,0
1668322363630,CSE 293,036,119431,Su; Hao,9999,0,9999,0
1668322363630,CSE 293,037,119433,Swanson; Steven James,9999,0,9999,0
1668322363630,CSE 293,038,119435,Tullsen; Dean Michael,9999,0,9999,0
1668322363630,CSE 293,039,119483,Voelker; Geoffrey M.,9999,0,9999,0
1668322363630,CSE 293,040,119537,Zhao; Jishen,9999,0,9999,0
1668322363630,CSE 293,041,119538,Zhou; Yuan-Yuan,9999,0,9999,0
1668322363630,CSE 293,042,119539,Gao; Sicun,9999,0,9999,0
1668322363630,CSE 293,043,119540,Weibel; Nadir,9999,0,9999,0
1668322363630,CSE 293,044,119541,Gupta; Rajesh K.,9999,0,9999,0
1668322363630,CSE 293,045,126410,Vaccaro; Kristen Marie,9999,0,9999,0
1668322363630,CSE 293,046,126411,Klemke; Richard,9999,0,9999,0
1668322364052,CSE 294,A00,102459,Voelker; Geoffrey M.,0,0,0,0
1668322364052,CSE 294,B00,111322,Orailoglu; Alex,0,0,0,0
1668322364478,DSE 201,A00,096914,Deutsch; Alin Bernard,30,0,30,0
1668322364904,DSE 210,A00,096915,Dasgupta; Sanjoy,30,0,30,0
1668322365328,DSE 260A,A00,096916,Altintas De Callaf; Ilkay,30,0,30,0
1668322365754,ECE 200,001,103586,Antipa; Nicholas A,9999,0,9999,0
1668322365754,ECE 200,002,103587,Atanasov; Nikolay A.,9999,0,9999,0
1668322365754,ECE 200,003,103588,Bharadia; Dinesh,9999,0,9999,0
1668322365754,ECE 200,004,103589,Cheng; Chung Kuan,9999,0,9999,0
1668322365754,ECE 200,005,103590,Cosman; Pamela C.,9999,0,9999,0
1668322365754,ECE 200,006,103591,Dayeh; Shadi Ahmad,9999,0,9999,0
1668322365754,ECE 200,007,103592,Fainman; Yeshaiahu,9999,0,9999,0
1668322365754,ECE 200,008,103593,Ford; Joseph Earl,9999,0,9999,0
1668322365754,ECE 200,009,103594,Franceschetti; Massimo,9999,0,9999,0
1668322365754,ECE 200,010,103595,Fullerton; Eric E,9999,0,9999,0
1668322365754,ECE 200,011,103596,Galton; Ian A,9999,0,9999,0
1668322365754,ECE 200,012,103597,Gilja; Vikash,9999,0,9999,0
1668322365754,ECE 200,013,103598,Hall; Drew A.,9999,0,9999,0
1668322365754,ECE 200,014,103599,Hsueh; Tzu-Chien,9999,0,9999,0
1668322365754,ECE 200,015,103600,Javidi; Tara,9999,0,9999,0
1668322365754,ECE 200,016,103601,Kahng; Andrew Byun,9999,0,9999,0
1668322365754,ECE 200,017,103602,Kim; Young-Han,9999,0,9999,0
1668322365754,ECE 200,018,103603,Koushanfar; Farinaz,9999,0,9999,0
1668322365754,ECE 200,019,103604,Kuzum; Duygu,9999,0,9999,0
1668322365754,ECE 200,020,103605,Le; Hanh-Phuc,9999,0,9999,0
1668322365754,ECE 200,021,103606,Lin; Bill,9999,0,9999,0
1668322365754,ECE 200,022,103607,Liu; Zhaowei,9998,0,9999,1
1668322365754,ECE 200,023,103608,Lo; Yu-Hwa,9999,0,9999,0
1668322365754,ECE 200,024,103609,Lomakin; Vitaliy,9999,0,9999,0
1668322365754,ECE 200,025,103610,Mercier; Patrick Philip,9999,0,9999,0
1668322365754,ECE 200,026,103611,Meyer; Florian,9999,0,9999,0
1668322365754,ECE 200,027,103612,Milstein; Laurence B.,9999,0,9999,0
1668322365754,ECE 200,028,103613,Mir Arabbaygi; Siavash,9999,0,9999,0
1668322365754,ECE 200,029,103614,Mookherjea; Shayan,9999,0,9999,0
1668322365754,ECE 200,030,103615,Morris; Karcher William,9999,0,9999,0
1668322365754,ECE 200,031,103616,Ng; Tse Nga,9999,0,9999,0
1668322365754,ECE 200,032,103617,Nguyen; Truong Quang,9999,0,9999,0
1668322365754,ECE 200,033,103618,Nomura; Kenji,9999,0,9999,0
1668322365754,ECE 200,034,103619,Orlitsky; Alon,9999,0,9999,0
1668322365754,ECE 200,035,103620,Pal; Piya,9999,0,9999,0
1668322365754,ECE 200,036,103621,Papen; George C.,9999,0,9999,0
1668322365754,ECE 200,037,103622,Radic; Stojan,9999,0,9999,0
1668322365754,ECE 200,038,103623,Rao; Bhaskar D.,9999,0,9999,0
1668322365754,ECE 200,039,103624,Rao; Ramesh R,9999,0,9999,0
1668322365754,ECE 200,040,103625,Rebeiz; Gabriel,9999,0,9999,0
1668322365754,ECE 200,041,103626,Sanford; John R,9999,0,9999,0
1668322365754,ECE 200,042,103627,Siegel; Paul H.,9999,0,9999,0
1668322365754,ECE 200,043,103628,Sievenpiper; Daniel F.,9999,0,9999,0
1668322365754,ECE 200,044,103629,Sworder; David D.,9999,0,9999,0
1668322365754,ECE 200,045,103630,Taur; Yuan,9999,0,9999,0
1668322365754,ECE 200,046,103631,Touri; Behrouz,9999,0,9999,0
1668322365754,ECE 200,047,103632,Trivedi; Mohan M.,9999,0,9999,0
1668322365754,ECE 200,048,103633,Vasconcelos; Nuno,9999,0,9999,0
1668322365754,ECE 200,049,103634,Wang; Xiaolong,9999,0,9999,0
1668322365754,ECE 200,050,103635,Xie; Pengtao,9999,0,9999,0
1668322365754,ECE 200,051,103636,Yip; Michael,9999,0,9999,0
1668322365754,ECE 200,052,103637,Zeger; Kenneth A.,999,0,999,0
1668322365754,ECE 200,053,103638,Zhang; Xinyu,9999,0,9999,0
1668322365754,ECE 200,054,103639,Turakhia; Yatish Girish,9999,0,9999,0
1668322365754,ECE 200,055,103640,Kang; Mingu,9999,0,9999,0
1668322365754,ECE 200,056,103641,Shi; Yuanyuan,9999,0,9999,0
1668322365754,ECE 200,057,103642,Wang; Edward Jay,9999,0,9999,0
1668322365754,ECE 200,058,103643,Zheng; Yang,9999,0,9999,0
1668322366177,ECE 202,A00,103644,Kuzum; Duygu,0,0,0,0
1668322366601,ECE 212BN,A00,103646,Ng; Tse Nga,0,0,0,0
1668322367029,ECE 221,A00,111493,Staff,0,0,0,0
1668322367456,ECE 222B,A00,103647,Lomakin; Vitaliy,0,0,0,0
1668322367880,ECE 230B,A00,103648,Taur; Yuan,0,0,0,0
1668322368305,ECE 238B,A00,103649,Garay; Javier,0,0,0,0
1668322368731,ECE 240B,A00,112900,Fainman; Yeshaiahu,0,0,0,0
1668322369155,ECE 247A,A00,103650,Jokerst; Jesse Vincent,0,0,0,0
1668322369580,ECE 247B,A00,103651,Wang; Joseph,0,0,0,0
1668322370006,ECE 250,A00,103652,Siegel; Paul H.,0,0,0,0
1668322370431,ECE 251A,A00,103654,Rao; Bhaskar D.,0,0,0,0
1668322370858,ECE 257B,A00,103655,Bharadia; Dinesh,0,0,0,0
1668322371293,ECE 258A,A00,103656,Milstein; Laurence B.,0,0,0,0
1668322371717,ECE 260B,A00,103658,Kang; Mingu,0,0,0,0
1668322372143,ECE 264A,A00,103659,Galton; Ian A,0,0,0,0
1668322372567,ECE 265A,A00,103661,Gudem; Prasad S.S.,0,0,0,0
1668322372993,ECE 265D,A00,103662,Gudem; Prasad S.S.,0,0,0,0
1668322373416,ECE 268,A00,103663,Koushanfar; Farinaz,0,0,0,0
1668322373845,ECE 269,A01,103665,Pal; Piya,0,0,0,0
1668322374271,ECE 271B,A00,103666,Vasconcelos; Manuela,0,0,0,0
1668322374697,ECE 276A,A00,103667,Atanasov; Nikolay A.,0,0,0,0
1668322375123,ECE 277,A00,103668,An; Cheolhong,0,0,0,0
1668322375556,ECE 279,A00,117947,Hall; Drew A.,0,0,0,0
1668322376407,ECE 283,A00,103670,Hsueh; Tzu-Chien,0,0,0,0
1668322376830,ECE 284,A00,103671,Turakhia; Yatish Girish,0,0,0,0
1668322377252,ECE 285,A00,103672,Zheng; Yang,0,0,0,0
1668322377252,ECE 285,B00,103673,Sworder; David D.,0,0,0,0
1668322377690,ECE 287,A00,103676,Javidi; Tara,0,0,0,0
1668322378117,MATH 200B,A00,098023,Salehi Golsefidy; Alireza,12,0,15,3
1668322378540,MATH 202B,A00,098024,Rhoades; Brendon Patrick,9,0,15,6
1668322378969,MATH 203B,A00,098025,Oprea; Dragos N.,10,0,15,5
1668322379394,MATH 204B,A00,098026,Sorensen; Claus M,13,0,15,2
1668322379829,MATH 208,A00,098027,Izadi; Elham,7,0,10,3
1668322380259,MATH 209,A00,098028,Pollack; Aaron,10,0,10,0
1668322380683,MATH 211A,A00,112919,Rogalski; Daniel,9,0,10,1
1668322381124,MATH 211B,A00,112920,Seward; Brandon M.,9,0,10,1
1668322381548,MATH 218,A00,098029,Li; Bo,10,0,10,0
1668322381972,MATH 220B,A00,098030,Novak; Jonathan I,11,0,15,4
1668322382403,MATH 221A,A00,098031,Ebenfelt; Peter F,13,0,15,2
1668322382830,MATH 231B,A00,098032,Zlatos; Andrej,12,0,15,3
1668322383262,MATH 240B,A00,098033,Ni; Lei,9,0,15,6
1668322383688,MATH 243,A00,098034,Jekel; David Andrew,10,0,10,0
1668322384113,MATH 245A,A00,098035,Nie; Jiawang,0,0,15,16
1668322384536,MATH 248,A00,098036,Bejenaru; Ioan,10,0,10,0
1668322384960,MATH 250B,A00,098037,Spolaor; Luca,14,0,15,1
1668322385386,MATH 258,A00,098038,Ni; Lei,10,0,10,0
1668322385811,MATH 264B,A00,098041,Rhoades; Brendon Patrick,9,0,15,6
1668322386235,MATH 268,A00,098042,Buss; Samuel R,10,0,10,0
1668322386659,MATH 269,A00,098043,Rhoades; Brendon Patrick,10,0,10,0
1668322387086,MATH 270B,A00,098044,Li; Bo,10,0,15,5
1668322387513,MATH 272B,A00,098045,Holst; Michael J,13,0,15,2
1668322387942,MATH 273A,A00,098046,Tian; Xiaochuan,10,0,15,5
1668322388378,MATH 275,A01,098048,Tian; Xiaochuan,6,0,10,4
1668322388806,MATH 278A,A00,098049,Holst; Michael J,8,0,10,2
1668322389230,MATH 278B,A00,098050,Cloninger; Alexander,10,0,10,0
1668322389657,MATH 278C,A00,098051,Nie; Jiawang,7,0,10,3
1668322390082,MATH 280B,A00,098052,Zheng; Tianyi,8,0,15,7
1668322390505,MATH 281B,A00,098053,Bradic; Jelena,1,0,15,14
1668322390929,MATH 282B,A00,098054,Arias-Castro; Ery,0,0,15,15
1668322391357,MATH 285,A00,098055,Fitzsimmons; Patrick J,0,0,15,17
1668322391779,MATH 287B,A00,098056,Arias-Castro; Ery,2,0,15,13
1668322392205,MATH 288,A00,098057,Agarwal; Pooja,9,0,10,1
1668322392205,MATH 288,B00,098058,Zhang; Danna,8,0,10,2
1668322392205,MATH 288,C00,098059,Williams; Ruth J,9,0,10,1
1668322392630,MATH 290B,A00,098060,Roberts; Justin Deritter,13,0,15,2
1668322393054,MATH 292,A00,098061,Belmont; Eva Kinoshita,10,0,10,0
1668322393479,MATH 295,A00,098062,Suk; Andrew Hoon,48,0,50,2
1668322393914,MATH 296,A00,098063,Novak; Jonathan I,20,0,20,0
1668322394339,MATH 297,001,098064,Gamst; Anthony Collins,9997,0,9999,2
1668322893065,COGS 205,A00,101395,Chiba; Andrea,19,0,20,1
1668322893488,COGS 210B,001,101404,Greene; Deanna Jacquelyn,9998,0,9999,1
1668322893488,COGS 210B,002,101417,Xia; Haijun,9999,0,9999,0
1668322893488,COGS 210B,003,101422,Nitz; Douglas A.,9999,0,9999,0
1668322893488,COGS 210B,004,101423,Hollan; James D.,9998,0,9999,1
1668322893488,COGS 210B,005,101424,Deak; Gedeon O.,9998,0,9999,1
1668322893488,COGS 210B,006,101425,Rossano; Federico,9999,0,9999,0
1668322893915,COGS 211B,A00,101427,Coulson; Seana M,9996,0,9999,3
1668322894338,COGS 220,A00,101428,Hollan; James D.,0,0,25,25
1668322894767,COGS 229,A00,101429,Dow; Steven P,18,0,25,7
1668322895192,COGS 230,A00,101430,Klemmer; Scott R,11,0,17,6
1668322895616,COGS 234,A00,101431,Xia; Haijun,1,0,25,24
1668322896041,COGS 260,A00,101432,Kiyonaga; Anastasia,21,0,25,4
1668322896041,COGS 260,B00,101433,Kirsh; David Joel,15,0,25,10
1668322896465,CSE 202,A00,102371,Impagliazzo; Russell,0,0,0,0
1668322896890,CSE 203B,A01,102373,Cheng; Chung Kuan,0,0,0,0
1668322897312,CSE 208,A00,102374,Micciancio; Daniele,0,0,0,0
1668322897734,CSE 209A,A00,112895,Impagliazzo; Russell,0,0,15,15
1668322898163,CSE 209B,A00,108005,Bellare; Mihir,0,0,0,0
1668322898592,CSE 210,A00,113163,Coblenz; Michael J,0,0,0,0
1668322899017,CSE 219,A00,106111,Dow; Steven P,0,0,20,20
1668322899443,CSE 221,A00,102376,Voelker; Geoffrey M.,0,0,0,0
1668322899867,CSE 224,A01,102378,Porter; George M,0,0,0,0
1668322900289,CSE 229A,A00,102379,Savage; Stefan,0,0,0,0
1668322900723,CSE 229C,A00,102380,Munyaka; Imani N. S.,0,0,0,0
1668322901154,CSE 232B,A00,102382,Deutsch; Alin Bernard,0,0,0,0
1668322901577,CSE 234,A01,112904,Kumar; Arun Kumar,0,0,0,0
1668322902001,CSE 237A,A00,102383,Rosing; Tajana Simunic,0,0,0,0
1668322902422,CSE 239A,A00,102384,Deutsch; Alin Bernard,0,0,0,0
1668322902846,CSE 239B,A00,102385,Polikarpova; Nadezhda,0,0,0,0
1668322903278,CSE 240A,A00,102386,Pannuto; Patrick William,0,0,0,0
1668322903704,CSE 240B,A00,102387,Zhao; Jishen,0,0,0,0
1668322904128,CSE 241A,A00,106406,Kang; Mingu,0,0,0,0
1668322904550,CSE 249B,A00,102388,Kahng; Andrew Byun,0,0,8,8
1668322904975,CSE 251B,A01,102392,Cottrell; Garrison W,0,0,0,0
1668322904975,CSE 251B,A02,102393,Cottrell; Garrison W,0,0,0,0
1668322905400,CSE 252B,A00,102394,Ochoa; Benjamin Lawrence,0,0,0,0
1668322905826,CSE 257,A01,102396,Gao; Sicun,0,0,0,0
1668322906249,CSE 272,A00,102397,Li; Tzumao,0,0,0,0
1668322906678,CSE 274,A00,111323,Chern; Albert Ren-Haur,0,0,0,0
1668322907107,CSE 282,A00,102398,Pevzner; Pavel Arkadjevich,0,0,0,0
1668322907532,CSE 284,A00,114175,Gymrek; Melissa Ann,0,0,0,0
1668322907958,CSE 290,A00,102399,Chandraker; Manmohan Krishna,0,0,0,0
1668322907958,CSE 290,B00,102400,Vaccaro; Kristen Marie,0,0,25,25
1668322907958,CSE 290,C00,102414,Pannuto; Patrick William,0,0,25,25
1668322907958,CSE 290,D00,102427,Pevzner; Pavel Arkadjevich,0,0,0,0
1668322907958,CSE 290,E00,102429,Zhao; Jishen,0,0,0,0
1668322907958,CSE 290,F00,102436,Tullsen; Dean Michael,0,0,0,0
1668322907958,CSE 290,G00,102440,Christensen; Henrik I,0,0,20,20
1668322908387,CSE 291,A00,102443,Su; Hao,0,0,0,0
1668322908387,CSE 291,B00,102448,Polikarpova; Nadezhda,0,0,0,0
1668322908387,CSE 291,C00,102453,Vaccaro; Kristen Marie,0,0,0,0
1668322908387,CSE 291,D00,111343,Savage; Stefan,0,0,0,0
1668322908387,CSE 291,E00,116474,Claffy; Kimberly Claire,0,0,0,0
1668322908387,CSE 291,F00,116479,Pasquale; Joseph,0,0,0,0
1668322908816,CSE 293,001,119111,Bafna; Vineet,9999,0,9999,0
1668322908816,CSE 293,002,119118,Bellare; Mihir,9999,0,9999,0
1668322908816,CSE 293,003,119122,Berg-Kirkpatrick; Taylor D,9999,0,9999,0
1668322908816,CSE 293,004,119135,Christensen; Henrik I,9999,0,9999,0
1668322908816,CSE 293,005,119142,Cottrell; Garrison W,9999,0,9999,0
1668322908816,CSE 293,006,119146,Deutsch; Alin Bernard,9999,0,9999,0
1668322908816,CSE 293,007,119159,Esmaeilzadeh; Hadi,9999,0,9999,0
1668322908816,CSE 293,008,119166,Freund; Yoav,9999,0,9999,0
1668322908816,CSE 293,009,119170,Griswold; William G.,9999,0,9999,0
1668322908816,CSE 293,010,119183,Gymrek; Melissa Ann,9999,0,9999,0
1668322908816,CSE 293,011,119190,Heninger; Nadia A,9999,0,9999,0
1668322908816,CSE 293,012,119230,Impagliazzo; Russell,9999,0,9999,0
1668322908816,CSE 293,013,119232,Jhala; Ranjit,9999,0,9999,0
1668322908816,CSE 293,014,119233,Kahng; Andrew Byun,9999,0,9999,0
1668322908816,CSE 293,015,119298,Kane; Daniel Mertz,9999,0,9999,0
1668322908816,CSE 293,016,119299,Kriegman; David J,9999,0,9999,0
1668322908816,CSE 293,017,119300,Kumar; Arun Kumar,9999,0,9999,0
1668322908816,CSE 293,018,119301,Lerner; Sorin,9999,0,9999,0
1668322908816,CSE 293,019,119302,Lovett; Shachar,9999,0,9999,0
1668322908816,CSE 293,020,119303,McAuley; Julian John,9999,0,9999,0
1668322908816,CSE 293,021,119304,Micciancio; Daniele,9999,0,9999,0
1668322908816,CSE 293,022,119367,Orailoglu; Alex,9999,0,9999,0
1668322908816,CSE 293,023,119382,Paturi; Ramamohan,9999,0,9999,0
1668322908816,CSE 293,024,119404,Polikarpova; Nadezhda,9999,0,9999,0
1668322908816,CSE 293,025,119406,Politz; Joseph Gibbs,9999,0,9999,0
1668322908816,CSE 293,026,119411,Porter; George M,9999,0,9999,0
1668322908816,CSE 293,027,119414,Porter; Leonard Emerson,9999,0,9999,0
1668322908816,CSE 293,028,119416,Ramamoorthi; Ravi,9999,0,9999,0
1668322908816,CSE 293,029,119417,Sahoo; Debashis,9999,0,9999,0
1668322908816,CSE 293,030,119420,Saul; Lawrence,9999,0,9999,0
1668322908816,CSE 293,031,119421,Savage; Stefan,9999,0,9999,0
1668322908816,CSE 293,032,119425,Schulze; Jurgen P.,9999,0,9999,0
1668322908816,CSE 293,033,119426,Snoeren; Alex C.,9999,0,9999,0
1668322908816,CSE 293,034,119428,Shang; Jingbo,9999,0,9999,0
1668322908816,CSE 293,035,119430,Stefan; Deian,9999,0,9999,0
1668322908816,CSE 293,036,119431,Su; Hao,9999,0,9999,0
1668322908816,CSE 293,037,119433,Swanson; Steven James,9999,0,9999,0
1668322908816,CSE 293,038,119435,Tullsen; Dean Michael,9999,0,9999,0
1668322908816,CSE 293,039,119483,Voelker; Geoffrey M.,9999,0,9999,0
1668322908816,CSE 293,040,119537,Zhao; Jishen,9999,0,9999,0
1668322908816,CSE 293,041,119538,Zhou; Yuan-Yuan,9999,0,9999,0
1668322908816,CSE 293,042,119539,Gao; Sicun,9999,0,9999,0
1668322908816,CSE 293,043,119540,Weibel; Nadir,9999,0,9999,0
1668322908816,CSE 293,044,119541,Gupta; Rajesh K.,9999,0,9999,0
1668322908816,CSE 293,045,126410,Vaccaro; Kristen Marie,9999,0,9999,0
1668322908816,CSE 293,046,126411,Klemke; Richard,9999,0,9999,0
1668322909243,CSE 294,A00,102459,Voelker; Geoffrey M.,0,0,0,0
1668322909243,CSE 294,B00,111322,Orailoglu; Alex,0,0,0,0
1668322909678,DSE 201,A00,096914,Deutsch; Alin Bernard,30,0,30,0
1668322910112,DSE 210,A00,096915,Dasgupta; Sanjoy,30,0,30,0
1668322910538,DSE 260A,A00,096916,Altintas De Callaf; Ilkay,30,0,30,0
1668322910986,ECE 200,001,103586,Antipa; Nicholas A,9999,0,9999,0
1668322910986,ECE 200,002,103587,Atanasov; Nikolay A.,9999,0,9999,0
1668322910986,ECE 200,003,103588,Bharadia; Dinesh,9999,0,9999,0
1668322910986,ECE 200,004,103589,Cheng; Chung Kuan,9999,0,9999,0
1668322910986,ECE 200,005,103590,Cosman; Pamela C.,9999,0,9999,0
1668322910986,ECE 200,006,103591,Dayeh; Shadi Ahmad,9999,0,9999,0
1668322910986,ECE 200,007,103592,Fainman; Yeshaiahu,9999,0,9999,0
1668322910986,ECE 200,008,103593,Ford; Joseph Earl,9999,0,9999,0
1668322910986,ECE 200,009,103594,Franceschetti; Massimo,9999,0,9999,0
1668322910986,ECE 200,010,103595,Fullerton; Eric E,9999,0,9999,0
1668322910986,ECE 200,011,103596,Galton; Ian A,9999,0,9999,0
1668322910986,ECE 200,012,103597,Gilja; Vikash,9999,0,9999,0
1668322910986,ECE 200,013,103598,Hall; Drew A.,9999,0,9999,0
1668322910986,ECE 200,014,103599,Hsueh; Tzu-Chien,9999,0,9999,0
1668322910986,ECE 200,015,103600,Javidi; Tara,9999,0,9999,0
1668322910986,ECE 200,016,103601,Kahng; Andrew Byun,9999,0,9999,0
1668322910986,ECE 200,017,103602,Kim; Young-Han,9999,0,9999,0
1668322910986,ECE 200,018,103603,Koushanfar; Farinaz,9999,0,9999,0
1668322910986,ECE 200,019,103604,Kuzum; Duygu,9999,0,9999,0
1668322910986,ECE 200,020,103605,Le; Hanh-Phuc,9999,0,9999,0
1668322910986,ECE 200,021,103606,Lin; Bill,9999,0,9999,0
1668322910986,ECE 200,022,103607,Liu; Zhaowei,9998,0,9999,1
1668322910986,ECE 200,023,103608,Lo; Yu-Hwa,9999,0,9999,0
1668322910986,ECE 200,024,103609,Lomakin; Vitaliy,9999,0,9999,0
1668322910986,ECE 200,025,103610,Mercier; Patrick Philip,9999,0,9999,0
1668322910986,ECE 200,026,103611,Meyer; Florian,9999,0,9999,0
1668322910986,ECE 200,027,103612,Milstein; Laurence B.,9999,0,9999,0
1668322910986,ECE 200,028,103613,Mir Arabbaygi; Siavash,9999,0,9999,0
1668322910986,ECE 200,029,103614,Mookherjea; Shayan,9999,0,9999,0
1668322910986,ECE 200,030,103615,Morris; Karcher William,9999,0,9999,0
1668322910986,ECE 200,031,103616,Ng; Tse Nga,9999,0,9999,0
1668322910986,ECE 200,032,103617,Nguyen; Truong Quang,9999,0,9999,0
1668322910986,ECE 200,033,103618,Nomura; Kenji,9999,0,9999,0
1668322910986,ECE 200,034,103619,Orlitsky; Alon,9999,0,9999,0
1668322910986,ECE 200,035,103620,Pal; Piya,9999,0,9999,0
1668322910986,ECE 200,036,103621,Papen; George C.,9999,0,9999,0
1668322910986,ECE 200,037,103622,Radic; Stojan,9999,0,9999,0
1668322910986,ECE 200,038,103623,Rao; Bhaskar D.,9999,0,9999,0
1668322910986,ECE 200,039,103624,Rao; Ramesh R,9999,0,9999,0
1668322910986,ECE 200,040,103625,Rebeiz; Gabriel,9999,0,9999,0
1668322910986,ECE 200,041,103626,Sanford; John R,9999,0,9999,0
1668322910986,ECE 200,042,103627,Siegel; Paul H.,9999,0,9999,0
1668322910986,ECE 200,043,103628,Sievenpiper; Daniel F.,9999,0,9999,0
1668322910986,ECE 200,044,103629,Sworder; David D.,9999,0,9999,0
1668322910986,ECE 200,045,103630,Taur; Yuan,9999,0,9999,0
1668322910986,ECE 200,046,103631,Touri; Behrouz,9999,0,9999,0
1668322910986,ECE 200,047,103632,Trivedi; Mohan M.,9999,0,9999,0
1668322910986,ECE 200,048,103633,Vasconcelos; Nuno,9999,0,9999,0
1668322910986,ECE 200,049,103634,Wang; Xiaolong,9999,0,9999,0
1668322910986,ECE 200,050,103635,Xie; Pengtao,9999,0,9999,0
1668322910986,ECE 200,051,103636,Yip; Michael,9999,0,9999,0
1668322910986,ECE 200,052,103637,Zeger; Kenneth A.,999,0,999,0
1668322910986,ECE 200,053,103638,Zhang; Xinyu,9999,0,9999,0
1668322910986,ECE 200,054,103639,Turakhia; Yatish Girish,9999,0,9999,0
1668322910986,ECE 200,055,103640,Kang; Mingu,9999,0,9999,0
1668322910986,ECE 200,056,103641,Shi; Yuanyuan,9999,0,9999,0
1668322910986,ECE 200,057,103642,Wang; Edward Jay,9999,0,9999,0
1668322910986,ECE 200,058,103643,Zheng; Yang,9999,0,9999,0
1668322911409,ECE 202,A00,103644,Kuzum; Duygu,0,0,0,0
1668322911844,ECE 212BN,A00,103646,Ng; Tse Nga,0,0,0,0
1668322912269,ECE 221,A00,111493,Staff,0,0,0,0
1668322912695,ECE 222B,A00,103647,Lomakin; Vitaliy,0,0,0,0
1668322913122,ECE 230B,A00,103648,Taur; Yuan,0,0,0,0
1668322913556,ECE 238B,A00,103649,Garay; Javier,0,0,0,0
1668322913985,ECE 240B,A00,112900,Fainman; Yeshaiahu,0,0,0,0
1668322914412,ECE 247A,A00,103650,Jokerst; Jesse Vincent,0,0,0,0
1668322914838,ECE 247B,A00,103651,Wang; Joseph,0,0,0,0
1668322915264,ECE 250,A00,103652,Siegel; Paul H.,0,0,0,0
1668322915692,ECE 251A,A00,103654,Rao; Bhaskar D.,0,0,0,0
1668322916115,ECE 257B,A00,103655,Bharadia; Dinesh,0,0,0,0
1668322916542,ECE 258A,A00,103656,Milstein; Laurence B.,0,0,0,0
1668322916965,ECE 260B,A00,103658,Kang; Mingu,0,0,0,0
1668322917389,ECE 264A,A00,103659,Galton; Ian A,0,0,0,0
1668322917813,ECE 265A,A00,103661,Gudem; Prasad S.S.,0,0,0,0
1668322918239,ECE 265D,A00,103662,Gudem; Prasad S.S.,0,0,0,0
1668322918664,ECE 268,A00,103663,Koushanfar; Farinaz,0,0,0,0
1668322919090,ECE 269,A01,103665,Pal; Piya,0,0,0,0
1668322919512,ECE 271B,A00,103666,Vasconcelos; Manuela,0,0,0,0
1668322919936,ECE 276A,A00,103667,Atanasov; Nikolay A.,0,0,0,0
1668322920360,ECE 277,A00,103668,An; Cheolhong,0,0,0,0
1668322920785,ECE 279,A00,117947,Hall; Drew A.,0,0,0,0
1668322921710,ECE 283,A00,103670,Hsueh; Tzu-Chien,0,0,0,0
1668322922131,ECE 284,A00,103671,Turakhia; Yatish Girish,0,0,0,0
1668322922555,ECE 285,A00,103672,Zheng; Yang,0,0,0,0
1668322922555,ECE 285,B00,103673,Sworder; David D.,0,0,0,0
1668322922980,ECE 287,A00,103676,Javidi; Tara,0,0,0,0
1668322923412,MATH 200B,A00,098023,Salehi Golsefidy; Alireza,12,0,15,3
1668322923835,MATH 202B,A00,098024,Rhoades; Brendon Patrick,9,0,15,6
1668322924260,MATH 203B,A00,098025,Oprea; Dragos N.,10,0,15,5
1668322924682,MATH 204B,A00,098026,Sorensen; Claus M,13,0,15,2
1668322925114,MATH 208,A00,098027,Izadi; Elham,7,0,10,3
1668322925543,MATH 209,A00,098028,Pollack; Aaron,10,0,10,0
1668322925966,MATH 211A,A00,112919,Rogalski; Daniel,9,0,10,1
1668322926389,MATH 211B,A00,112920,Seward; Brandon M.,9,0,10,1
1668322926820,MATH 218,A00,098029,Li; Bo,10,0,10,0
1668322927248,MATH 220B,A00,098030,Novak; Jonathan I,11,0,15,4
1668322927676,MATH 221A,A00,098031,Ebenfelt; Peter F,13,0,15,2
1668322928101,MATH 231B,A00,098032,Zlatos; Andrej,12,0,15,3
1668322928524,MATH 240B,A00,098033,Ni; Lei,9,0,15,6
1668322928947,MATH 243,A00,098034,Jekel; David Andrew,10,0,10,0
1668322929382,MATH 245A,A00,098035,Nie; Jiawang,0,0,15,16
1668322929809,MATH 248,A00,098036,Bejenaru; Ioan,10,0,10,0
1668322930231,MATH 250B,A00,098037,Spolaor; Luca,14,0,15,1
1668322930654,MATH 258,A00,098038,Ni; Lei,10,0,10,0
1668322931082,MATH 264B,A00,098041,Rhoades; Brendon Patrick,9,0,15,6
1668322931505,MATH 268,A00,098042,Buss; Samuel R,10,0,10,0
1668322931929,MATH 269,A00,098043,Rhoades; Brendon Patrick,10,0,10,0
1668322932357,MATH 270B,A00,098044,Li; Bo,10,0,15,5
1668322932781,MATH 272B,A00,098045,Holst; Michael J,13,0,15,2
1668322933205,MATH 273A,A00,098046,Tian; Xiaochuan,10,0,15,5
1668322933628,MATH 275,A01,098048,Tian; Xiaochuan,6,0,10,4
1668322934053,MATH 278A,A00,098049,Holst; Michael J,8,0,10,2
1668322934475,MATH 278B,A00,098050,Cloninger; Alexander,10,0,10,0
1668322934901,MATH 278C,A00,098051,Nie; Jiawang,7,0,10,3
1668322935333,MATH 280B,A00,098052,Zheng; Tianyi,8,0,15,7
1668322935754,MATH 281B,A00,098053,Bradic; Jelena,1,0,15,14
1668322936181,MATH 282B,A00,098054,Arias-Castro; Ery,0,0,15,15
1668322936609,MATH 285,A00,098055,Fitzsimmons; Patrick J,0,0,15,17
1668322937033,MATH 287B,A00,098056,Arias-Castro; Ery,2,0,15,13
1668322937456,MATH 288,A00,098057,Agarwal; Pooja,9,0,10,1
1668322937456,MATH 288,B00,098058,Zhang; Danna,8,0,10,2
1668322937456,MATH 288,C00,098059,Williams; Ruth J,9,0,10,1
1668322937883,MATH 290B,A00,098060,Roberts; Justin Deritter,13,0,15,2
1668322938306,MATH 292,A00,098061,Belmont; Eva Kinoshita,10,0,10,0
1668322938727,MATH 295,A00,098062,Suk; Andrew Hoon,48,0,50,2
1668322939152,MATH 296,A00,098063,Novak; Jonathan I,20,0,20,0
1668322939578,MATH 297,001,098064,Gamst; Anthony Collins,9997,0,9999,2
1668323438665,COGS 205,A00,101395,Chiba; Andrea,19,0,20,1
1668323439091,COGS 210B,001,101404,Greene; Deanna Jacquelyn,9998,0,9999,1
1668323439091,COGS 210B,002,101417,Xia; Haijun,9999,0,9999,0
1668323439091,COGS 210B,003,101422,Nitz; Douglas A.,9999,0,9999,0
1668323439091,COGS 210B,004,101423,Hollan; James D.,9998,0,9999,1
1668323439091,COGS 210B,005,101424,Deak; Gedeon O.,9998,0,9999,1
1668323439091,COGS 210B,006,101425,Rossano; Federico,9999,0,9999,0
1668323439515,COGS 211B,A00,101427,Coulson; Seana M,9996,0,9999,3
1668323439942,COGS 220,A00,101428,Hollan; James D.,0,0,25,25
1668323440441,COGS 229,A00,101429,Dow; Steven P,18,0,25,7
1668323440872,COGS 230,A00,101430,Klemmer; Scott R,11,0,17,6
1668323441295,COGS 234,A00,101431,Xia; Haijun,1,0,25,24
1668323441718,COGS 260,A00,101432,Kiyonaga; Anastasia,21,0,25,4
1668323441718,COGS 260,B00,101433,Kirsh; David Joel,15,0,25,10
1668323442143,CSE 202,A00,102371,Impagliazzo; Russell,0,0,0,0
1668323442589,CSE 203B,A01,102373,Cheng; Chung Kuan,0,0,0,0
1668323443016,CSE 208,A00,102374,Micciancio; Daniele,0,0,0,0
1668323443444,CSE 209A,A00,112895,Impagliazzo; Russell,0,0,15,15
1668323443869,CSE 209B,A00,108005,Bellare; Mihir,0,0,0,0
1668323444296,CSE 210,A00,113163,Coblenz; Michael J,0,0,0,0
1668323444723,CSE 219,A00,106111,Dow; Steven P,0,0,20,20
1668323445149,CSE 221,A00,102376,Voelker; Geoffrey M.,0,0,0,0
1668323445577,CSE 224,A01,102378,Porter; George M,0,0,0,0
1668323446003,CSE 229A,A00,102379,Savage; Stefan,0,0,0,0
1668323446430,CSE 229C,A00,102380,Munyaka; Imani N. S.,0,0,0,0
1668323446855,CSE 232B,A00,102382,Deutsch; Alin Bernard,0,0,0,0
1668323447283,CSE 234,A01,112904,Kumar; Arun Kumar,0,0,0,0
1668323447705,CSE 237A,A00,102383,Rosing; Tajana Simunic,0,0,0,0
1668323448129,CSE 239A,A00,102384,Deutsch; Alin Bernard,0,0,0,0
1668323448556,CSE 239B,A00,102385,Polikarpova; Nadezhda,0,0,0,0
1668323448982,CSE 240A,A00,102386,Pannuto; Patrick William,0,0,0,0
1668323449416,CSE 240B,A00,102387,Zhao; Jishen,0,0,0,0
1668323449848,CSE 241A,A00,106406,Kang; Mingu,0,0,0,0
1668323450274,CSE 249B,A00,102388,Kahng; Andrew Byun,0,0,8,8
1668323450701,CSE 251B,A01,102392,Cottrell; Garrison W,0,0,0,0
1668323450701,CSE 251B,A02,102393,Cottrell; Garrison W,0,0,0,0
1668323451142,CSE 252B,A00,102394,Ochoa; Benjamin Lawrence,0,0,0,0
1668323451568,CSE 257,A01,102396,Gao; Sicun,0,0,0,0
1668323451991,CSE 272,A00,102397,Li; Tzumao,0,0,0,0
1668323452414,CSE 274,A00,111323,Chern; Albert Ren-Haur,0,0,0,0
1668323452835,CSE 282,A00,102398,Pevzner; Pavel Arkadjevich,0,0,0,0
1668323453259,CSE 284,A00,114175,Gymrek; Melissa Ann,0,0,0,0
1668323453684,CSE 290,A00,102399,Chandraker; Manmohan Krishna,0,0,0,0
1668323453684,CSE 290,B00,102400,Vaccaro; Kristen Marie,0,0,25,25
1668323453684,CSE 290,C00,102414,Pannuto; Patrick William,0,0,25,25
1668323453684,CSE 290,D00,102427,Pevzner; Pavel Arkadjevich,0,0,0,0
1668323453684,CSE 290,E00,102429,Zhao; Jishen,0,0,0,0
1668323453684,CSE 290,F00,102436,Tullsen; Dean Michael,0,0,0,0
1668323453684,CSE 290,G00,102440,Christensen; Henrik I,0,0,20,20
1668323454116,CSE 291,A00,102443,Su; Hao,0,0,0,0
1668323454116,CSE 291,B00,102448,Polikarpova; Nadezhda,0,0,0,0
1668323454116,CSE 291,C00,102453,Vaccaro; Kristen Marie,0,0,0,0
1668323454116,CSE 291,D00,111343,Savage; Stefan,0,0,0,0
1668323454116,CSE 291,E00,116474,Claffy; Kimberly Claire,0,0,0,0
1668323454116,CSE 291,F00,116479,Pasquale; Joseph,0,0,0,0
1668323454558,CSE 293,001,119111,Bafna; Vineet,9999,0,9999,0
1668323454558,CSE 293,002,119118,Bellare; Mihir,9999,0,9999,0
1668323454558,CSE 293,003,119122,Berg-Kirkpatrick; Taylor D,9999,0,9999,0
1668323454558,CSE 293,004,119135,Christensen; Henrik I,9999,0,9999,0
1668323454558,CSE 293,005,119142,Cottrell; Garrison W,9999,0,9999,0
1668323454558,CSE 293,006,119146,Deutsch; Alin Bernard,9999,0,9999,0
1668323454558,CSE 293,007,119159,Esmaeilzadeh; Hadi,9999,0,9999,0
1668323454558,CSE 293,008,119166,Freund; Yoav,9999,0,9999,0
1668323454558,CSE 293,009,119170,Griswold; William G.,9999,0,9999,0
1668323454558,CSE 293,010,119183,Gymrek; Melissa Ann,9999,0,9999,0
1668323454558,CSE 293,011,119190,Heninger; Nadia A,9999,0,9999,0
1668323454558,CSE 293,012,119230,Impagliazzo; Russell,9999,0,9999,0
1668323454558,CSE 293,013,119232,Jhala; Ranjit,9999,0,9999,0
1668323454558,CSE 293,014,119233,Kahng; Andrew Byun,9999,0,9999,0
1668323454558,CSE 293,015,119298,Kane; Daniel Mertz,9999,0,9999,0
1668323454558,CSE 293,016,119299,Kriegman; David J,9999,0,9999,0
1668323454558,CSE 293,017,119300,Kumar; Arun Kumar,9999,0,9999,0
1668323454558,CSE 293,018,119301,Lerner; Sorin,9999,0,9999,0
1668323454558,CSE 293,019,119302,Lovett; Shachar,9999,0,9999,0
1668323454558,CSE 293,020,119303,McAuley; Julian John,9999,0,9999,0
1668323454558,CSE 293,021,119304,Micciancio; Daniele,9999,0,9999,0
1668323454558,CSE 293,022,119367,Orailoglu; Alex,9999,0,9999,0
1668323454558,CSE 293,023,119382,Paturi; Ramamohan,9999,0,9999,0
1668323454558,CSE 293,024,119404,Polikarpova; Nadezhda,9999,0,9999,0
1668323454558,CSE 293,025,119406,Politz; Joseph Gibbs,9999,0,9999,0
1668323454558,CSE 293,026,119411,Porter; George M,9999,0,9999,0
1668323454558,CSE 293,027,119414,Porter; Leonard Emerson,9999,0,9999,0
1668323454558,CSE 293,028,119416,Ramamoorthi; Ravi,9999,0,9999,0
1668323454558,CSE 293,029,119417,Sahoo; Debashis,9999,0,9999,0
1668323454558,CSE 293,030,119420,Saul; Lawrence,9999,0,9999,0
1668323454558,CSE 293,031,119421,Savage; Stefan,9999,0,9999,0
1668323454558,CSE 293,032,119425,Schulze; Jurgen P.,9999,0,9999,0
1668323454558,CSE 293,033,119426,Snoeren; Alex C.,9999,0,9999,0
1668323454558,CSE 293,034,119428,Shang; Jingbo,9999,0,9999,0
1668323454558,CSE 293,035,119430,Stefan; Deian,9999,0,9999,0
1668323454558,CSE 293,036,119431,Su; Hao,9999,0,9999,0
1668323454558,CSE 293,037,119433,Swanson; Steven James,9999,0,9999,0
1668323454558,CSE 293,038,119435,Tullsen; Dean Michael,9999,0,9999,0
1668323454558,CSE 293,039,119483,Voelker; Geoffrey M.,9999,0,9999,0
1668323454558,CSE 293,040,119537,Zhao; Jishen,9999,0,9999,0
1668323454558,CSE 293,041,119538,Zhou; Yuan-Yuan,9999,0,9999,0
1668323454558,CSE 293,042,119539,Gao; Sicun,9999,0,9999,0
1668323454558,CSE 293,043,119540,Weibel; Nadir,9999,0,9999,0
1668323454558,CSE 293,044,119541,Gupta; Rajesh K.,9999,0,9999,0
1668323454558,CSE 293,045,126410,Vaccaro; Kristen Marie,9999,0,9999,0
1668323454558,CSE 293,046,126411,Klemke; Richard,9999,0,9999,0
1668323454985,CSE 294,A00,102459,Voelker; Geoffrey M.,0,0,0,0
1668323454985,CSE 294,B00,111322,Orailoglu; Alex,0,0,0,0
1668323455412,DSE 201,A00,096914,Deutsch; Alin Bernard,30,0,30,0
1668323455838,DSE 210,A00,096915,Dasgupta; Sanjoy,30,0,30,0
1668323456266,DSE 260A,A00,096916,Altintas De Callaf; Ilkay,30,0,30,0
1668323456707,ECE 200,001,103586,Antipa; Nicholas A,9999,0,9999,0
1668323456707,ECE 200,002,103587,Atanasov; Nikolay A.,9999,0,9999,0
1668323456707,ECE 200,003,103588,Bharadia; Dinesh,9999,0,9999,0
1668323456707,ECE 200,004,103589,Cheng; Chung Kuan,9999,0,9999,0
1668323456707,ECE 200,005,103590,Cosman; Pamela C.,9999,0,9999,0
1668323456707,ECE 200,006,103591,Dayeh; Shadi Ahmad,9999,0,9999,0
1668323456707,ECE 200,007,103592,Fainman; Yeshaiahu,9999,0,9999,0
1668323456707,ECE 200,008,103593,Ford; Joseph Earl,9999,0,9999,0
1668323456707,ECE 200,009,103594,Franceschetti; Massimo,9999,0,9999,0
1668323456707,ECE 200,010,103595,Fullerton; Eric E,9999,0,9999,0
1668323456707,ECE 200,011,103596,Galton; Ian A,9999,0,9999,0
1668323456707,ECE 200,012,103597,Gilja; Vikash,9999,0,9999,0
1668323456707,ECE 200,013,103598,Hall; Drew A.,9999,0,9999,0
1668323456707,ECE 200,014,103599,Hsueh; Tzu-Chien,9999,0,9999,0
1668323456707,ECE 200,015,103600,Javidi; Tara,9999,0,9999,0
1668323456707,ECE 200,016,103601,Kahng; Andrew Byun,9999,0,9999,0
1668323456707,ECE 200,017,103602,Kim; Young-Han,9999,0,9999,0
1668323456707,ECE 200,018,103603,Koushanfar; Farinaz,9999,0,9999,0
1668323456707,ECE 200,019,103604,Kuzum; Duygu,9999,0,9999,0
1668323456707,ECE 200,020,103605,Le; Hanh-Phuc,9999,0,9999,0
1668323456707,ECE 200,021,103606,Lin; Bill,9999,0,9999,0
1668323456707,ECE 200,022,103607,Liu; Zhaowei,9998,0,9999,1
1668323456707,ECE 200,023,103608,Lo; Yu-Hwa,9999,0,9999,0
1668323456707,ECE 200,024,103609,Lomakin; Vitaliy,9999,0,9999,0
1668323456707,ECE 200,025,103610,Mercier; Patrick Philip,9999,0,9999,0
1668323456707,ECE 200,026,103611,Meyer; Florian,9999,0,9999,0
1668323456707,ECE 200,027,103612,Milstein; Laurence B.,9999,0,9999,0
1668323456707,ECE 200,028,103613,Mir Arabbaygi; Siavash,9999,0,9999,0
1668323456707,ECE 200,029,103614,Mookherjea; Shayan,9999,0,9999,0
1668323456707,ECE 200,030,103615,Morris; Karcher William,9999,0,9999,0
1668323456707,ECE 200,031,103616,Ng; Tse Nga,9999,0,9999,0
1668323456707,ECE 200,032,103617,Nguyen; Truong Quang,9999,0,9999,0
1668323456707,ECE 200,033,103618,Nomura; Kenji,9999,0,9999,0
1668323456707,ECE 200,034,103619,Orlitsky; Alon,9999,0,9999,0
1668323456707,ECE 200,035,103620,Pal; Piya,9999,0,9999,0
1668323456707,ECE 200,036,103621,Papen; George C.,9999,0,9999,0
1668323456707,ECE 200,037,103622,Radic; Stojan,9999,0,9999,0
1668323456707,ECE 200,038,103623,Rao; Bhaskar D.,9999,0,9999,0
1668323456707,ECE 200,039,103624,Rao; Ramesh R,9999,0,9999,0
1668323456707,ECE 200,040,103625,Rebeiz; Gabriel,9999,0,9999,0
1668323456707,ECE 200,041,103626,Sanford; John R,9999,0,9999,0
1668323456707,ECE 200,042,103627,Siegel; Paul H.,9999,0,9999,0
1668323456707,ECE 200,043,103628,Sievenpiper; Daniel F.,9999,0,9999,0
1668323456707,ECE 200,044,103629,Sworder; David D.,9999,0,9999,0
1668323456707,ECE 200,045,103630,Taur; Yuan,9999,0,9999,0
1668323456707,ECE 200,046,103631,Touri; Behrouz,9999,0,9999,0
1668323456707,ECE 200,047,103632,Trivedi; Mohan M.,9999,0,9999,0
1668323456707,ECE 200,048,103633,Vasconcelos; Nuno,9999,0,9999,0
1668323456707,ECE 200,049,103634,Wang; Xiaolong,9999,0,9999,0
1668323456707,ECE 200,050,103635,Xie; Pengtao,9999,0,9999,0
1668323456707,ECE 200,051,103636,Yip; Michael,9999,0,9999,0
1668323456707,ECE 200,052,103637,Zeger; Kenneth A.,999,0,999,0
1668323456707,ECE 200,053,103638,Zhang; Xinyu,9999,0,9999,0
1668323456707,ECE 200,054,103639,Turakhia; Yatish Girish,9999,0,9999,0
1668323456707,ECE 200,055,103640,Kang; Mingu,9999,0,9999,0
1668323456707,ECE 200,056,103641,Shi; Yuanyuan,9999,0,9999,0
1668323456707,ECE 200,057,103642,Wang; Edward Jay,9999,0,9999,0
1668323456707,ECE 200,058,103643,Zheng; Yang,9999,0,9999,0
1668323457130,ECE 202,A00,103644,Kuzum; Duygu,0,0,0,0
1668323457553,ECE 212BN,A00,103646,Ng; Tse Nga,0,0,0,0
1668323457978,ECE 221,A00,111493,Staff,0,0,0,0
1668323458404,ECE 222B,A00,103647,Lomakin; Vitaliy,0,0,0,0
1668323458829,ECE 230B,A00,103648,Taur; Yuan,0,0,0,0
1668323459252,ECE 238B,A00,103649,Garay; Javier,0,0,0,0
1668323459678,ECE 240B,A00,112900,Fainman; Yeshaiahu,0,0,0,0
1668323460105,ECE 247A,A00,103650,Jokerst; Jesse Vincent,0,0,0,0
1668323460530,ECE 247B,A00,103651,Wang; Joseph,0,0,0,0
1668323460952,ECE 250,A00,103652,Siegel; Paul H.,0,0,0,0
1668323461385,ECE 251A,A00,103654,Rao; Bhaskar D.,0,0,0,0
1668323461809,ECE 257B,A00,103655,Bharadia; Dinesh,0,0,0,0
1668323462234,ECE 258A,A00,103656,Milstein; Laurence B.,0,0,0,0
1668323462664,ECE 260B,A00,103658,Kang; Mingu,0,0,0,0
1668323463090,ECE 264A,A00,103659,Galton; Ian A,0,0,0,0
1668323463519,ECE 265A,A00,103661,Gudem; Prasad S.S.,0,0,0,0
1668323463941,ECE 265D,A00,103662,Gudem; Prasad S.S.,0,0,0,0
1668323464369,ECE 268,A00,103663,Koushanfar; Farinaz,0,0,0,0
1668323464794,ECE 269,A01,103665,Pal; Piya,0,0,0,0
1668323465217,ECE 271B,A00,103666,Vasconcelos; Manuela,0,0,0,0
1668323465640,ECE 276A,A00,103667,Atanasov; Nikolay A.,0,0,0,0
1668323466066,ECE 277,A00,103668,An; Cheolhong,0,0,0,0
1668323466492,ECE 279,A00,117947,Hall; Drew A.,0,0,0,0
1668323467352,ECE 283,A00,103670,Hsueh; Tzu-Chien,0,0,0,0
1668323467777,ECE 284,A00,103671,Turakhia; Yatish Girish,0,0,0,0
1668323468206,ECE 285,A00,103672,Zheng; Yang,0,0,0,0
1668323468206,ECE 285,B00,103673,Sworder; David D.,0,0,0,0
1668323468630,ECE 287,A00,103676,Javidi; Tara,0,0,0,0
1668323469054,MATH 200B,A00,098023,Salehi Golsefidy; Alireza,12,0,15,3
1668323469481,MATH 202B,A00,098024,Rhoades; Brendon Patrick,9,0,15,6
1668323469905,MATH 203B,A00,098025,Oprea; Dragos N.,10,0,15,5
1668323470330,MATH 204B,A00,098026,Sorensen; Claus M,13,0,15,2
1668323470756,MATH 208,A00,098027,Izadi; Elham,7,0,10,3
1668323471180,MATH 209,A00,098028,Pollack; Aaron,10,0,10,0
1668323471606,MATH 211A,A00,112919,Rogalski; Daniel,9,0,10,1
1668323472033,MATH 211B,A00,112920,Seward; Brandon M.,9,0,10,1
1668323472471,MATH 218,A00,098029,Li; Bo,10,0,10,0
1668323472896,MATH 220B,A00,098030,Novak; Jonathan I,11,0,15,4
1668323473323,MATH 221A,A00,098031,Ebenfelt; Peter F,13,0,15,2
1668323473758,MATH 231B,A00,098032,Zlatos; Andrej,12,0,15,3
1668323474181,MATH 240B,A00,098033,Ni; Lei,9,0,15,6
1668323474604,MATH 243,A00,098034,Jekel; David Andrew,10,0,10,0
1668323475036,MATH 245A,A00,098035,Nie; Jiawang,0,0,15,16
1668323475469,MATH 248,A00,098036,Bejenaru; Ioan,10,0,10,0
1668323475897,MATH 250B,A00,098037,Spolaor; Luca,14,0,15,1
1668323476319,MATH 258,A00,098038,Ni; Lei,10,0,10,0
1668323476747,MATH 264B,A00,098041,Rhoades; Brendon Patrick,9,0,15,6
1668323477172,MATH 268,A00,098042,Buss; Samuel R,10,0,10,0
1668323477598,MATH 269,A00,098043,Rhoades; Brendon Patrick,10,0,10,0
1668323478023,MATH 270B,A00,098044,Li; Bo,10,0,15,5
1668323478451,MATH 272B,A00,098045,Holst; Michael J,13,0,15,2
1668323478877,MATH 273A,A00,098046,Tian; Xiaochuan,10,0,15,5
1668323479301,MATH 275,A01,098048,Tian; Xiaochuan,6,0,10,4
1668323479722,MATH 278A,A00,098049,Holst; Michael J,8,0,10,2
1668323480147,MATH 278B,A00,098050,Cloninger; Alexander,10,0,10,0
1668323480572,MATH 278C,A00,098051,Nie; Jiawang,7,0,10,3
1668323480995,MATH 280B,A00,098052,Zheng; Tianyi,8,0,15,7
1668323481422,MATH 281B,A00,098053,Bradic; Jelena,1,0,15,14
1668323481845,MATH 282B,A00,098054,Arias-Castro; Ery,0,0,15,15
1668323482267,MATH 285,A00,098055,Fitzsimmons; Patrick J,0,0,15,17
1668323482690,MATH 287B,A00,098056,Arias-Castro; Ery,2,0,15,13
1668323483117,MATH 288,A00,098057,Agarwal; Pooja,9,0,10,1
1668323483117,MATH 288,B00,098058,Zhang; Danna,8,0,10,2
1668323483117,MATH 288,C00,098059,Williams; Ruth J,9,0,10,1
1668323483631,MATH 290B,A00,098060,Roberts; Justin Deritter,13,0,15,2
1668323484055,MATH 292,A00,098061,Belmont; Eva Kinoshita,10,0,10,0
1668323484479,MATH 295,A00,098062,Suk; Andrew Hoon,48,0,50,2
1668323484902,MATH 296,A00,098063,Novak; Jonathan I,20,0,20,0
1668323485326,MATH 297,001,098064,Gamst; Anthony Collins,9997,0,9999,2
1668323984831,COGS 205,A00,101395,Chiba; Andrea,19,0,20,1
1668323985257,COGS 210B,001,101404,Greene; Deanna Jacquelyn,9998,0,9999,1
1668323985257,COGS 210B,002,101417,Xia; Haijun,9999,0,9999,0
1668323985257,COGS 210B,003,101422,Nitz; Douglas A.,9999,0,9999,0
1668323985257,COGS 210B,004,101423,Hollan; James D.,9998,0,9999,1
1668323985257,COGS 210B,005,101424,Deak; Gedeon O.,9998,0,9999,1
1668323985257,COGS 210B,006,101425,Rossano; Federico,9999,0,9999,0
1668323985679,COGS 211B,A00,101427,Coulson; Seana M,9996,0,9999,3
1668323986103,COGS 220,A00,101428,Hollan; James D.,0,0,25,25
1668323986529,COGS 229,A00,101429,Dow; Steven P,18,0,25,7
1668323986955,COGS 230,A00,101430,Klemmer; Scott R,11,0,17,6
1668323987380,COGS 234,A00,101431,Xia; Haijun,1,0,25,24
1668323987805,COGS 260,A00,101432,Kiyonaga; Anastasia,21,0,25,4
1668323987805,COGS 260,B00,101433,Kirsh; David Joel,15,0,25,10
1668323988228,CSE 202,A00,102371,Impagliazzo; Russell,0,0,0,0
1668323988652,CSE 203B,A01,102373,Cheng; Chung Kuan,0,0,0,0
1668323989077,CSE 208,A00,102374,Micciancio; Daniele,0,0,0,0
1668323989499,CSE 209A,A00,112895,Impagliazzo; Russell,0,0,15,15
1668323989923,CSE 209B,A00,108005,Bellare; Mihir,0,0,0,0
1668323990347,CSE 210,A00,113163,Coblenz; Michael J,0,0,0,0
1668323990770,CSE 219,A00,106111,Dow; Steven P,0,0,20,20
1668323991194,CSE 221,A00,102376,Voelker; Geoffrey M.,0,0,0,0
1668323991617,CSE 224,A01,102378,Porter; George M,0,0,0,0
1668323992049,CSE 229A,A00,102379,Savage; Stefan,0,0,0,0
1668323992473,CSE 229C,A00,102380,Munyaka; Imani N. S.,0,0,0,0
1668323992897,CSE 232B,A00,102382,Deutsch; Alin Bernard,0,0,0,0
1668323993332,CSE 234,A01,112904,Kumar; Arun Kumar,0,0,0,0
1668323993756,CSE 237A,A00,102383,Rosing; Tajana Simunic,0,0,0,0
1668323994179,CSE 239A,A00,102384,Deutsch; Alin Bernard,0,0,0,0
1668323994605,CSE 239B,A00,102385,Polikarpova; Nadezhda,0,0,0,0
1668323995032,CSE 240A,A00,102386,Pannuto; Patrick William,0,0,0,0
1668323995458,CSE 240B,A00,102387,Zhao; Jishen,0,0,0,0
1668323995885,CSE 241A,A00,106406,Kang; Mingu,0,0,0,0
1668323996312,CSE 249B,A00,102388,Kahng; Andrew Byun,0,0,8,8
1668323996734,CSE 251B,A01,102392,Cottrell; Garrison W,0,0,0,0
1668323996734,CSE 251B,A02,102393,Cottrell; Garrison W,0,0,0,0
1668323997164,CSE 252B,A00,102394,Ochoa; Benjamin Lawrence,0,0,0,0
1668323997599,CSE 257,A01,102396,Gao; Sicun,0,0,0,0
1668323998025,CSE 272,A00,102397,Li; Tzumao,0,0,0,0
1668323998447,CSE 274,A00,111323,Chern; Albert Ren-Haur,0,0,0,0
1668323998875,CSE 282,A00,102398,Pevzner; Pavel Arkadjevich,0,0,0,0
1668323999303,CSE 284,A00,114175,Gymrek; Melissa Ann,0,0,0,0
1668323999730,CSE 290,A00,102399,Chandraker; Manmohan Krishna,0,0,0,0
1668323999730,CSE 290,B00,102400,Vaccaro; Kristen Marie,0,0,25,25
1668323999730,CSE 290,C00,102414,Pannuto; Patrick William,0,0,25,25
1668323999730,CSE 290,D00,102427,Pevzner; Pavel Arkadjevich,0,0,0,0
1668323999730,CSE 290,E00,102429,Zhao; Jishen,0,0,0,0
1668323999730,CSE 290,F00,102436,Tullsen; Dean Michael,0,0,0,0
1668323999730,CSE 290,G00,102440,Christensen; Henrik I,0,0,20,20
1668324000155,CSE 291,A00,102443,Su; Hao,0,0,0,0
1668324000155,CSE 291,B00,102448,Polikarpova; Nadezhda,0,0,0,0
1668324000155,CSE 291,C00,102453,Vaccaro; Kristen Marie,0,0,0,0
1668324000155,CSE 291,D00,111343,Savage; Stefan,0,0,0,0
1668324000155,CSE 291,E00,116474,Claffy; Kimberly Claire,0,0,0,0
1668324000155,CSE 291,F00,116479,Pasquale; Joseph,0,0,0,0
1668324000613,CSE 293,001,119111,Bafna; Vineet,9999,0,9999,0
1668324000613,CSE 293,002,119118,Bellare; Mihir,9999,0,9999,0
1668324000613,CSE 293,003,119122,Berg-Kirkpatrick; Taylor D,9999,0,9999,0
1668324000613,CSE 293,004,119135,Christensen; Henrik I,9999,0,9999,0
1668324000613,CSE 293,005,119142,Cottrell; Garrison W,9999,0,9999,0
1668324000613,CSE 293,006,119146,Deutsch; Alin Bernard,9999,0,9999,0
1668324000613,CSE 293,007,119159,Esmaeilzadeh; Hadi,9999,0,9999,0
1668324000613,CSE 293,008,119166,Freund; Yoav,9999,0,9999,0
1668324000613,CSE 293,009,119170,Griswold; William G.,9999,0,9999,0
1668324000613,CSE 293,010,119183,Gymrek; Melissa Ann,9999,0,9999,0
1668324000613,CSE 293,011,119190,Heninger; Nadia A,9999,0,9999,0
1668324000613,CSE 293,012,119230,Impagliazzo; Russell,9999,0,9999,0
1668324000613,CSE 293,013,119232,Jhala; Ranjit,9999,0,9999,0
1668324000613,CSE 293,014,119233,Kahng; Andrew Byun,9999,0,9999,0
1668324000613,CSE 293,015,119298,Kane; Daniel Mertz,9999,0,9999,0
1668324000613,CSE 293,016,119299,Kriegman; David J,9999,0,9999,0
1668324000613,CSE 293,017,119300,Kumar; Arun Kumar,9999,0,9999,0
1668324000613,CSE 293,018,119301,Lerner; Sorin,9999,0,9999,0
1668324000613,CSE 293,019,119302,Lovett; Shachar,9999,0,9999,0
1668324000613,CSE 293,020,119303,McAuley; Julian John,9999,0,9999,0
1668324000613,CSE 293,021,119304,Micciancio; Daniele,9999,0,9999,0
1668324000613,CSE 293,022,119367,Orailoglu; Alex,9999,0,9999,0
1668324000613,CSE 293,023,119382,Paturi; Ramamohan,9999,0,9999,0
1668324000613,CSE 293,024,119404,Polikarpova; Nadezhda,9999,0,9999,0
1668324000613,CSE 293,025,119406,Politz; Joseph Gibbs,9999,0,9999,0
1668324000613,CSE 293,026,119411,Porter; George M,9999,0,9999,0
1668324000613,CSE 293,027,119414,Porter; Leonard Emerson,9999,0,9999,0
1668324000613,CSE 293,028,119416,Ramamoorthi; Ravi,9999,0,9999,0
1668324000613,CSE 293,029,119417,Sahoo; Debashis,9999,0,9999,0
1668324000613,CSE 293,030,119420,Saul; Lawrence,9999,0,9999,0
1668324000613,CSE 293,031,119421,Savage; Stefan,9999,0,9999,0
1668324000613,CSE 293,032,119425,Schulze; Jurgen P.,9999,0,9999,0
1668324000613,CSE 293,033,119426,Snoeren; Alex C.,9999,0,9999,0
1668324000613,CSE 293,034,119428,Shang; Jingbo,9999,0,9999,0
1668324000613,CSE 293,035,119430,Stefan; Deian,9999,0,9999,0
1668324000613,CSE 293,036,119431,Su; Hao,9999,0,9999,0
1668324000613,CSE 293,037,119433,Swanson; Steven James,9999,0,9999,0
1668324000613,CSE 293,038,119435,Tullsen; Dean Michael,9999,0,9999,0
1668324000613,CSE 293,039,119483,Voelker; Geoffrey M.,9999,0,9999,0
1668324000613,CSE 293,040,119537,Zhao; Jishen,9999,0,9999,0
1668324000613,CSE 293,041,119538,Zhou; Yuan-Yuan,9999,0,9999,0
1668324000613,CSE 293,042,119539,Gao; Sicun,9999,0,9999,0
1668324000613,CSE 293,043,119540,Weibel; Nadir,9999,0,9999,0
1668324000613,CSE 293,044,119541,Gupta; Rajesh K.,9999,0,9999,0
1668324000613,CSE 293,045,126410,Vaccaro; Kristen Marie,9999,0,9999,0
1668324000613,CSE 293,046,126411,Klemke; Richard,9999,0,9999,0
1668324001038,CSE 294,A00,102459,Voelker; Geoffrey M.,0,0,0,0
1668324001038,CSE 294,B00,111322,Orailoglu; Alex,0,0,0,0
1668324001471,DSE 201,A00,096914,Deutsch; Alin Bernard,30,0,30,0
1668324001898,DSE 210,A00,096915,Dasgupta; Sanjoy,30,0,30,0
1668324002322,DSE 260A,A00,096916,Altintas De Callaf; Ilkay,30,0,30,0
1668324002748,ECE 200,001,103586,Antipa; Nicholas A,9999,0,9999,0
1668324002748,ECE 200,002,103587,Atanasov; Nikolay A.,9999,0,9999,0
1668324002748,ECE 200,003,103588,Bharadia; Dinesh,9999,0,9999,0
1668324002748,ECE 200,004,103589,Cheng; Chung Kuan,9999,0,9999,0
1668324002748,ECE 200,005,103590,Cosman; Pamela C.,9999,0,9999,0
1668324002748,ECE 200,006,103591,Dayeh; Shadi Ahmad,9999,0,9999,0
1668324002748,ECE 200,007,103592,Fainman; Yeshaiahu,9999,0,9999,0
1668324002748,ECE 200,008,103593,Ford; Joseph Earl,9999,0,9999,0
1668324002748,ECE 200,009,103594,Franceschetti; Massimo,9999,0,9999,0
1668324002748,ECE 200,010,103595,Fullerton; Eric E,9999,0,9999,0
1668324002748,ECE 200,011,103596,Galton; Ian A,9999,0,9999,0
1668324002748,ECE 200,012,103597,Gilja; Vikash,9999,0,9999,0
1668324002748,ECE 200,013,103598,Hall; Drew A.,9999,0,9999,0
1668324002748,ECE 200,014,103599,Hsueh; Tzu-Chien,9999,0,9999,0
1668324002748,ECE 200,015,103600,Javidi; Tara,9999,0,9999,0
1668324002748,ECE 200,016,103601,Kahng; Andrew Byun,9999,0,9999,0
1668324002748,ECE 200,017,103602,Kim; Young-Han,9999,0,9999,0
1668324002748,ECE 200,018,103603,Koushanfar; Farinaz,9999,0,9999,0
1668324002748,ECE 200,019,103604,Kuzum; Duygu,9999,0,9999,0
1668324002748,ECE 200,020,103605,Le; Hanh-Phuc,9999,0,9999,0
1668324002748,ECE 200,021,103606,Lin; Bill,9999,0,9999,0
1668324002748,ECE 200,022,103607,Liu; Zhaowei,9998,0,9999,1
1668324002748,ECE 200,023,103608,Lo; Yu-Hwa,9999,0,9999,0
1668324002748,ECE 200,024,103609,Lomakin; Vitaliy,9999,0,9999,0
1668324002748,ECE 200,025,103610,Mercier; Patrick Philip,9999,0,9999,0
1668324002748,ECE 200,026,103611,Meyer; Florian,9999,0,9999,0
1668324002748,ECE 200,027,103612,Milstein; Laurence B.,9999,0,9999,0
1668324002748,ECE 200,028,103613,Mir Arabbaygi; Siavash,9999,0,9999,0
1668324002748,ECE 200,029,103614,Mookherjea; Shayan,9999,0,9999,0
1668324002748,ECE 200,030,103615,Morris; Karcher William,9999,0,9999,0
1668324002748,ECE 200,031,103616,Ng; Tse Nga,9999,0,9999,0
1668324002748,ECE 200,032,103617,Nguyen; Truong Quang,9999,0,9999,0
1668324002748,ECE 200,033,103618,Nomura; Kenji,9999,0,9999,0
1668324002748,ECE 200,034,103619,Orlitsky; Alon,9999,0,9999,0
1668324002748,ECE 200,035,103620,Pal; Piya,9999,0,9999,0
1668324002748,ECE 200,036,103621,Papen; George C.,9999,0,9999,0
1668324002748,ECE 200,037,103622,Radic; Stojan,9999,0,9999,0
1668324002748,ECE 200,038,103623,Rao; Bhaskar D.,9999,0,9999,0
1668324002748,ECE 200,039,103624,Rao; Ramesh R,9999,0,9999,0
1668324002748,ECE 200,040,103625,Rebeiz; Gabriel,9999,0,9999,0
1668324002748,ECE 200,041,103626,Sanford; John R,9999,0,9999,0
1668324002748,ECE 200,042,103627,Siegel; Paul H.,9999,0,9999,0
1668324002748,ECE 200,043,103628,Sievenpiper; Daniel F.,9999,0,9999,0
1668324002748,ECE 200,044,103629,Sworder; David D.,9999,0,9999,0
1668324002748,ECE 200,045,103630,Taur; Yuan,9999,0,9999,0
1668324002748,ECE 200,046,103631,Touri; Behrouz,9999,0,9999,0
1668324002748,ECE 200,047,103632,Trivedi; Mohan M.,9999,0,9999,0
1668324002748,ECE 200,048,103633,Vasconcelos; Nuno,9999,0,9999,0
1668324002748,ECE 200,049,103634,Wang; Xiaolong,9999,0,9999,0
1668324002748,ECE 200,050,103635,Xie; Pengtao,9999,0,9999,0
1668324002748,ECE 200,051,103636,Yip; Michael,9999,0,9999,0
1668324002748,ECE 200,052,103637,Zeger; Kenneth A.,999,0,999,0
1668324002748,ECE 200,053,103638,Zhang; Xinyu,9999,0,9999,0
1668324002748,ECE 200,054,103639,Turakhia; Yatish Girish,9999,0,9999,0
1668324002748,ECE 200,055,103640,Kang; Mingu,9999,0,9999,0
1668324002748,ECE 200,056,103641,Shi; Yuanyuan,9999,0,9999,0
1668324002748,ECE 200,057,103642,Wang; Edward Jay,9999,0,9999,0
1668324002748,ECE 200,058,103643,Zheng; Yang,9999,0,9999,0
1668324003264,ECE 202,A00,103644,Kuzum; Duygu,0,0,0,0
1668324003711,ECE 212BN,A00,103646,Ng; Tse Nga,0,0,0,0
1668324004135,ECE 221,A00,111493,Staff,0,0,0,0
1668324004565,ECE 222B,A00,103647,Lomakin; Vitaliy,0,0,0,0
1668324004990,ECE 230B,A00,103648,Taur; Yuan,0,0,0,0
1668324005414,ECE 238B,A00,103649,Garay; Javier,0,0,0,0
1668324005843,ECE 240B,A00,112900,Fainman; Yeshaiahu,0,0,0,0
1668324006270,ECE 247A,A00,103650,Jokerst; Jesse Vincent,0,0,0,0
1668324006697,ECE 247B,A00,103651,Wang; Joseph,0,0,0,0
1668324007129,ECE 250,A00,103652,Siegel; Paul H.,0,0,0,0
1668324007560,ECE 251A,A00,103654,Rao; Bhaskar D.,0,0,0,0
1668324007985,ECE 257B,A00,103655,Bharadia; Dinesh,0,0,0,0
1668324008407,ECE 258A,A00,103656,Milstein; Laurence B.,0,0,0,0
1668324008829,ECE 260B,A00,103658,Kang; Mingu,0,0,0,0
1668324009261,ECE 264A,A00,103659,Galton; Ian A,0,0,0,0
1668324009687,ECE 265A,A00,103661,Gudem; Prasad S.S.,0,0,0,0
1668324010111,ECE 265D,A00,103662,Gudem; Prasad S.S.,0,0,0,0
1668324010534,ECE 268,A00,103663,Koushanfar; Farinaz,0,0,0,0
1668324010960,ECE 269,A01,103665,Pal; Piya,0,0,0,0
1668324011383,ECE 271B,A00,103666,Vasconcelos; Manuela,0,0,0,0
1668324011810,ECE 276A,A00,103667,Atanasov; Nikolay A.,0,0,0,0
1668324012234,ECE 277,A00,103668,An; Cheolhong,0,0,0,0
1668324012659,ECE 279,A00,117947,Hall; Drew A.,0,0,0,0
1668324013510,ECE 283,A00,103670,Hsueh; Tzu-Chien,0,0,0,0
1668324013935,ECE 284,A00,103671,Turakhia; Yatish Girish,0,0,0,0
1668324014362,ECE 285,A00,103672,Zheng; Yang,0,0,0,0
1668324014362,ECE 285,B00,103673,Sworder; David D.,0,0,0,0
1668324014785,ECE 287,A00,103676,Javidi; Tara,0,0,0,0
1668324015211,MATH 200B,A00,098023,Salehi Golsefidy; Alireza,12,0,15,3
1668324015640,MATH 202B,A00,098024,Rhoades; Brendon Patrick,9,0,15,6
1668324016063,MATH 203B,A00,098025,Oprea; Dragos N.,10,0,15,5
1668324016500,MATH 204B,A00,098026,Sorensen; Claus M,13,0,15,2
1668324016922,MATH 208,A00,098027,Izadi; Elham,7,0,10,3
1668324017346,MATH 209,A00,098028,Pollack; Aaron,10,0,10,0
1668324017774,MATH 211A,A00,112919,Rogalski; Daniel,9,0,10,1
1668324018202,MATH 211B,A00,112920,Seward; Brandon M.,9,0,10,1
1668324018631,MATH 218,A00,098029,Li; Bo,10,0,10,0
1668324019058,MATH 220B,A00,098030,Novak; Jonathan I,11,0,15,4
1668324019483,MATH 221A,A00,098031,Ebenfelt; Peter F,13,0,15,2
1668324019906,MATH 231B,A00,098032,Zlatos; Andrej,12,0,15,3
1668324020337,MATH 240B,A00,098033,Ni; Lei,9,0,15,6
1668324020760,MATH 243,A00,098034,Jekel; David Andrew,10,0,10,0
1668324021186,MATH 245A,A00,098035,Nie; Jiawang,0,0,15,16
1668324021609,MATH 248,A00,098036,Bejenaru; Ioan,10,0,10,0
1668324022038,MATH 250B,A00,098037,Spolaor; Luca,14,0,15,1
1668324022463,MATH 258,A00,098038,Ni; Lei,10,0,10,0
1668324022888,MATH 264B,A00,098041,Rhoades; Brendon Patrick,9,0,15,6
1668324023310,MATH 268,A00,098042,Buss; Samuel R,10,0,10,0
1668324023737,MATH 269,A00,098043,Rhoades; Brendon Patrick,10,0,10,0
1668324024162,MATH 270B,A00,098044,Li; Bo,10,0,15,5
1668324024599,MATH 272B,A00,098045,Holst; Michael J,13,0,15,2
1668324025027,MATH 273A,A00,098046,Tian; Xiaochuan,10,0,15,5
1668324025456,MATH 275,A01,098048,Tian; Xiaochuan,6,0,10,4
1668324025885,MATH 278A,A00,098049,Holst; Michael J,8,0,10,2
1668324026316,MATH 278B,A00,098050,Cloninger; Alexander,10,0,10,0
1668324026740,MATH 278C,A00,098051,Nie; Jiawang,7,0,10,3
1668324027164,MATH 280B,A00,098052,Zheng; Tianyi,8,0,15,7
1668324027589,MATH 281B,A00,098053,Bradic; Jelena,1,0,15,14
1668324028020,MATH 282B,A00,098054,Arias-Castro; Ery,0,0,15,15
1668324028446,MATH 285,A00,098055,Fitzsimmons; Patrick J,0,0,15,17
1668324028870,MATH 287B,A00,098056,Arias-Castro; Ery,2,0,15,13
1668324029295,MATH 288,A00,098057,Agarwal; Pooja,9,0,10,1
1668324029295,MATH 288,B00,098058,Zhang; Danna,8,0,10,2
1668324029295,MATH 288,C00,098059,Williams; Ruth J,9,0,10,1
1668324029723,MATH 290B,A00,098060,Roberts; Justin Deritter,13,0,15,2
1668324030153,MATH 292,A00,098061,Belmont; Eva Kinoshita,10,0,10,0
1668324030577,MATH 295,A00,098062,Suk; Andrew Hoon,48,0,50,2
1668324031002,MATH 296,A00,098063,Novak; Jonathan I,20,0,20,0
1668324031427,MATH 297,001,098064,Gamst; Anthony Collins,9997,0,9999,2
1668324530843,COGS 205,A00,101395,Chiba; Andrea,19,0,20,1
1668324531267,COGS 210B,001,101404,Greene; Deanna Jacquelyn,9998,0,9999,1
1668324531267,COGS 210B,002,101417,Xia; Haijun,9999,0,9999,0
1668324531267,COGS 210B,003,101422,Nitz; Douglas A.,9999,0,9999,0
1668324531267,COGS 210B,004,101423,Hollan; James D.,9998,0,9999,1
1668324531267,COGS 210B,005,101424,Deak; Gedeon O.,9998,0,9999,1
1668324531267,COGS 210B,006,101425,Rossano; Federico,9999,0,9999,0
1668324531690,COGS 211B,A00,101427,Coulson; Seana M,9996,0,9999,3
1668324532114,COGS 220,A00,101428,Hollan; James D.,0,0,25,25
1668324532542,COGS 229,A00,101429,Dow; Steven P,18,0,25,7
1668324532969,COGS 230,A00,101430,Klemmer; Scott R,11,0,17,6
1668324533391,COGS 234,A00,101431,Xia; Haijun,1,0,25,24
1668324533818,COGS 260,A00,101432,Kiyonaga; Anastasia,21,0,25,4
1668324533818,COGS 260,B00,101433,Kirsh; David Joel,15,0,25,10
1668324534245,CSE 202,A00,102371,Impagliazzo; Russell,0,0,0,0
1668324534670,CSE 203B,A01,102373,Cheng; Chung Kuan,0,0,0,0
1668324535095,CSE 208,A00,102374,Micciancio; Daniele,0,0,0,0
1668324535520,CSE 209A,A00,112895,Impagliazzo; Russell,0,0,15,15
1668324535945,CSE 209B,A00,108005,Bellare; Mihir,0,0,0,0
1668324536368,CSE 210,A00,113163,Coblenz; Michael J,0,0,0,0
1668324536795,CSE 219,A00,106111,Dow; Steven P,0,0,20,20
1668324537217,CSE 221,A00,102376,Voelker; Geoffrey M.,0,0,0,0
1668324537639,CSE 224,A01,102378,Porter; George M,0,0,0,0
1668324538077,CSE 229A,A00,102379,Savage; Stefan,0,0,0,0
1668324538500,CSE 229C,A00,102380,Munyaka; Imani N. S.,0,0,0,0
1668324538924,CSE 232B,A00,102382,Deutsch; Alin Bernard,0,0,0,0
1668324539349,CSE 234,A01,112904,Kumar; Arun Kumar,0,0,0,0
1668324539774,CSE 237A,A00,102383,Rosing; Tajana Simunic,0,0,0,0
1668324540197,CSE 239A,A00,102384,Deutsch; Alin Bernard,0,0,0,0
1668324540619,CSE 239B,A00,102385,Polikarpova; Nadezhda,0,0,0,0
1668324541047,CSE 240A,A00,102386,Pannuto; Patrick William,0,0,0,0
1668324541475,CSE 240B,A00,102387,Zhao; Jishen,0,0,0,0
1668324541901,CSE 241A,A00,106406,Kang; Mingu,0,0,0,0
1668324542324,CSE 249B,A00,102388,Kahng; Andrew Byun,0,0,8,8
1668324542748,CSE 251B,A01,102392,Cottrell; Garrison W,0,0,0,0
1668324542748,CSE 251B,A02,102393,Cottrell; Garrison W,0,0,0,0
1668324543174,CSE 252B,A00,102394,Ochoa; Benjamin Lawrence,0,0,0,0
1668324543596,CSE 257,A01,102396,Gao; Sicun,0,0,0,0
1668324544033,CSE 272,A00,102397,Li; Tzumao,0,0,0,0
1668324544456,CSE 274,A00,111323,Chern; Albert Ren-Haur,0,0,0,0
1668324544884,CSE 282,A00,102398,Pevzner; Pavel Arkadjevich,0,0,0,0
1668324545310,CSE 284,A00,114175,Gymrek; Melissa Ann,0,0,0,0
1668324545733,CSE 290,A00,102399,Chandraker; Manmohan Krishna,0,0,0,0
1668324545733,CSE 290,B00,102400,Vaccaro; Kristen Marie,0,0,25,25
1668324545733,CSE 290,C00,102414,Pannuto; Patrick William,0,0,25,25
1668324545733,CSE 290,D00,102427,Pevzner; Pavel Arkadjevich,0,0,0,0
1668324545733,CSE 290,E00,102429,Zhao; Jishen,0,0,0,0
1668324545733,CSE 290,F00,102436,Tullsen; Dean Michael,0,0,0,0
1668324545733,CSE 290,G00,102440,Christensen; Henrik I,0,0,20,20
1668324546157,CSE 291,A00,102443,Su; Hao,0,0,0,0
1668324546157,CSE 291,B00,102448,Polikarpova; Nadezhda,0,0,0,0
1668324546157,CSE 291,C00,102453,Vaccaro; Kristen Marie,0,0,0,0
1668324546157,CSE 291,D00,111343,Savage; Stefan,0,0,0,0
1668324546157,CSE 291,E00,116474,Claffy; Kimberly Claire,0,0,0,0
1668324546157,CSE 291,F00,116479,Pasquale; Joseph,0,0,0,0
1668324546581,CSE 293,001,119111,Bafna; Vineet,9999,0,9999,0
1668324546581,CSE 293,002,119118,Bellare; Mihir,9999,0,9999,0
1668324546581,CSE 293,003,119122,Berg-Kirkpatrick; Taylor D,9999,0,9999,0
1668324546581,CSE 293,004,119135,Christensen; Henrik I,9999,0,9999,0
1668324546581,CSE 293,005,119142,Cottrell; Garrison W,9999,0,9999,0
1668324546581,CSE 293,006,119146,Deutsch; Alin Bernard,9999,0,9999,0
1668324546581,CSE 293,007,119159,Esmaeilzadeh; Hadi,9999,0,9999,0
1668324546581,CSE 293,008,119166,Freund; Yoav,9999,0,9999,0
1668324546581,CSE 293,009,119170,Griswold; William G.,9999,0,9999,0
1668324546581,CSE 293,010,119183,Gymrek; Melissa Ann,9999,0,9999,0
1668324546581,CSE 293,011,119190,Heninger; Nadia A,9999,0,9999,0
1668324546581,CSE 293,012,119230,Impagliazzo; Russell,9999,0,9999,0
1668324546581,CSE 293,013,119232,Jhala; Ranjit,9999,0,9999,0
1668324546581,CSE 293,014,119233,Kahng; Andrew Byun,9999,0,9999,0
1668324546581,CSE 293,015,119298,Kane; Daniel Mertz,9999,0,9999,0
1668324546581,CSE 293,016,119299,Kriegman; David J,9999,0,9999,0
1668324546581,CSE 293,017,119300,Kumar; Arun Kumar,9999,0,9999,0
1668324546581,CSE 293,018,119301,Lerner; Sorin,9999,0,9999,0
1668324546581,CSE 293,019,119302,Lovett; Shachar,9999,0,9999,0
1668324546581,CSE 293,020,119303,McAuley; Julian John,9999,0,9999,0
1668324546581,CSE 293,021,119304,Micciancio; Daniele,9999,0,9999,0
1668324546581,CSE 293,022,119367,Orailoglu; Alex,9999,0,9999,0
1668324546581,CSE 293,023,119382,Paturi; Ramamohan,9999,0,9999,0
1668324546581,CSE 293,024,119404,Polikarpova; Nadezhda,9999,0,9999,0
1668324546581,CSE 293,025,119406,Politz; Joseph Gibbs,9999,0,9999,0
1668324546581,CSE 293,026,119411,Porter; George M,9999,0,9999,0
1668324546581,CSE 293,027,119414,Porter; Leonard Emerson,9999,0,9999,0
1668324546581,CSE 293,028,119416,Ramamoorthi; Ravi,9999,0,9999,0
1668324546581,CSE 293,029,119417,Sahoo; Debashis,9999,0,9999,0
1668324546581,CSE 293,030,119420,Saul; Lawrence,9999,0,9999,0
1668324546581,CSE 293,031,119421,Savage; Stefan,9999,0,9999,0
1668324546581,CSE 293,032,119425,Schulze; Jurgen P.,9999,0,9999,0
1668324546581,CSE 293,033,119426,Snoeren; Alex C.,9999,0,9999,0
1668324546581,CSE 293,034,119428,Shang; Jingbo,9999,0,9999,0
1668324546581,CSE 293,035,119430,Stefan; Deian,9999,0,9999,0
1668324546581,CSE 293,036,119431,Su; Hao,9999,0,9999,0
1668324546581,CSE 293,037,119433,Swanson; Steven James,9999,0,9999,0
1668324546581,CSE 293,038,119435,Tullsen; Dean Michael,9999,0,9999,0
1668324546581,CSE 293,039,119483,Voelker; Geoffrey M.,9999,0,9999,0
1668324546581,CSE 293,040,119537,Zhao; Jishen,9999,0,9999,0
1668324546581,CSE 293,041,119538,Zhou; Yuan-Yuan,9999,0,9999,0
1668324546581,CSE 293,042,119539,Gao; Sicun,9999,0,9999,0
1668324546581,CSE 293,043,119540,Weibel; Nadir,9999,0,9999,0
1668324546581,CSE 293,044,119541,Gupta; Rajesh K.,9999,0,9999,0
1668324546581,CSE 293,045,126410,Vaccaro; Kristen Marie,9999,0,9999,0
1668324546581,CSE 293,046,126411,Klemke; Richard,9999,0,9999,0
1668324547004,CSE 294,A00,102459,Voelker; Geoffrey M.,0,0,0,0
1668324547004,CSE 294,B00,111322,Orailoglu; Alex,0,0,0,0
1668324547427,DSE 201,A00,096914,Deutsch; Alin Bernard,30,0,30,0
1668324547851,DSE 210,A00,096915,Dasgupta; Sanjoy,30,0,30,0
1668324548276,DSE 260A,A00,096916,Altintas De Callaf; Ilkay,30,0,30,0
1668324548707,ECE 200,001,103586,Antipa; Nicholas A,9999,0,9999,0
1668324548707,ECE 200,002,103587,Atanasov; Nikolay A.,9999,0,9999,0
1668324548707,ECE 200,003,103588,Bharadia; Dinesh,9999,0,9999,0
1668324548707,ECE 200,004,103589,Cheng; Chung Kuan,9999,0,9999,0
1668324548707,ECE 200,005,103590,Cosman; Pamela C.,9999,0,9999,0
1668324548707,ECE 200,006,103591,Dayeh; Shadi Ahmad,9999,0,9999,0
1668324548707,ECE 200,007,103592,Fainman; Yeshaiahu,9999,0,9999,0
1668324548707,ECE 200,008,103593,Ford; Joseph Earl,9999,0,9999,0
1668324548707,ECE 200,009,103594,Franceschetti; Massimo,9999,0,9999,0
1668324548707,ECE 200,010,103595,Fullerton; Eric E,9999,0,9999,0
1668324548707,ECE 200,011,103596,Galton; Ian A,9999,0,9999,0
1668324548707,ECE 200,012,103597,Gilja; Vikash,9999,0,9999,0
1668324548707,ECE 200,013,103598,Hall; Drew A.,9999,0,9999,0
1668324548707,ECE 200,014,103599,Hsueh; Tzu-Chien,9999,0,9999,0
1668324548707,ECE 200,015,103600,Javidi; Tara,9999,0,9999,0
1668324548707,ECE 200,016,103601,Kahng; Andrew Byun,9999,0,9999,0
1668324548707,ECE 200,017,103602,Kim; Young-Han,9999,0,9999,0
1668324548707,ECE 200,018,103603,Koushanfar; Farinaz,9999,0,9999,0
1668324548707,ECE 200,019,103604,Kuzum; Duygu,9999,0,9999,0
1668324548707,ECE 200,020,103605,Le; Hanh-Phuc,9999,0,9999,0
1668324548707,ECE 200,021,103606,Lin; Bill,9999,0,9999,0
1668324548707,ECE 200,022,103607,Liu; Zhaowei,9998,0,9999,1
1668324548707,ECE 200,023,103608,Lo; Yu-Hwa,9999,0,9999,0
1668324548707,ECE 200,024,103609,Lomakin; Vitaliy,9999,0,9999,0
1668324548707,ECE 200,025,103610,Mercier; Patrick Philip,9999,0,9999,0
1668324548707,ECE 200,026,103611,Meyer; Florian,9999,0,9999,0
1668324548707,ECE 200,027,103612,Milstein; Laurence B.,9999,0,9999,0
1668324548707,ECE 200,028,103613,Mir Arabbaygi; Siavash,9999,0,9999,0
1668324548707,ECE 200,029,103614,Mookherjea; Shayan,9999,0,9999,0
1668324548707,ECE 200,030,103615,Morris; Karcher William,9999,0,9999,0
1668324548707,ECE 200,031,103616,Ng; Tse Nga,9999,0,9999,0
1668324548707,ECE 200,032,103617,Nguyen; Truong Quang,9999,0,9999,0
1668324548707,ECE 200,033,103618,Nomura; Kenji,9999,0,9999,0
1668324548707,ECE 200,034,103619,Orlitsky; Alon,9999,0,9999,0
1668324548707,ECE 200,035,103620,Pal; Piya,9999,0,9999,0
1668324548707,ECE 200,036,103621,Papen; George C.,9999,0,9999,0
1668324548707,ECE 200,037,103622,Radic; Stojan,9999,0,9999,0
1668324548707,ECE 200,038,103623,Rao; Bhaskar D.,9999,0,9999,0
1668324548707,ECE 200,039,103624,Rao; Ramesh R,9999,0,9999,0
1668324548707,ECE 200,040,103625,Rebeiz; Gabriel,9999,0,9999,0
1668324548707,ECE 200,041,103626,Sanford; John R,9999,0,9999,0
1668324548707,ECE 200,042,103627,Siegel; Paul H.,9999,0,9999,0
1668324548707,ECE 200,043,103628,Sievenpiper; Daniel F.,9999,0,9999,0
1668324548707,ECE 200,044,103629,Sworder; David D.,9999,0,9999,0
1668324548707,ECE 200,045,103630,Taur; Yuan,9999,0,9999,0
1668324548707,ECE 200,046,103631,Touri; Behrouz,9999,0,9999,0
1668324548707,ECE 200,047,103632,Trivedi; Mohan M.,9999,0,9999,0
1668324548707,ECE 200,048,103633,Vasconcelos; Nuno,9999,0,9999,0
1668324548707,ECE 200,049,103634,Wang; Xiaolong,9999,0,9999,0
1668324548707,ECE 200,050,103635,Xie; Pengtao,9999,0,9999,0
1668324548707,ECE 200,051,103636,Yip; Michael,9999,0,9999,0
1668324548707,ECE 200,052,103637,Zeger; Kenneth A.,999,0,999,0
1668324548707,ECE 200,053,103638,Zhang; Xinyu,9999,0,9999,0
1668324548707,ECE 200,054,103639,Turakhia; Yatish Girish,9999,0,9999,0
1668324548707,ECE 200,055,103640,Kang; Mingu,9999,0,9999,0
1668324548707,ECE 200,056,103641,Shi; Yuanyuan,9999,0,9999,0
1668324548707,ECE 200,057,103642,Wang; Edward Jay,9999,0,9999,0
1668324548707,ECE 200,058,103643,Zheng; Yang,9999,0,9999,0
1668324549130,ECE 202,A00,103644,Kuzum; Duygu,0,0,0,0
1668324549555,ECE 212BN,A00,103646,Ng; Tse Nga,0,0,0,0
1668324549979,ECE 221,A00,111493,Staff,0,0,0,0
1668324550405,ECE 222B,A00,103647,Lomakin; Vitaliy,0,0,0,0
1668324550829,ECE 230B,A00,103648,Taur; Yuan,0,0,0,0
1668324551256,ECE 238B,A00,103649,Garay; Javier,0,0,0,0
1668324551699,ECE 240B,A00,112900,Fainman; Yeshaiahu,0,0,0,0
1668324552131,ECE 247A,A00,103650,Jokerst; Jesse Vincent,0,0,0,0
1668324552557,ECE 247B,A00,103651,Wang; Joseph,0,0,0,0
1668324552985,ECE 250,A00,103652,Siegel; Paul H.,0,0,0,0
1668324553407,ECE 251A,A00,103654,Rao; Bhaskar D.,0,0,0,0
1668324553833,ECE 257B,A00,103655,Bharadia; Dinesh,0,0,0,0
1668324554256,ECE 258A,A00,103656,Milstein; Laurence B.,0,0,0,0
1668324554681,ECE 260B,A00,103658,Kang; Mingu,0,0,0,0
1668324555112,ECE 264A,A00,103659,Galton; Ian A,0,0,0,0
1668324555539,ECE 265A,A00,103661,Gudem; Prasad S.S.,0,0,0,0
1668324555965,ECE 265D,A00,103662,Gudem; Prasad S.S.,0,0,0,0
1668324556388,ECE 268,A00,103663,Koushanfar; Farinaz,0,0,0,0
1668324556813,ECE 269,A01,103665,Pal; Piya,0,0,0,0
1668324557243,ECE 271B,A00,103666,Vasconcelos; Manuela,0,0,0,0
1668324557666,ECE 276A,A00,103667,Atanasov; Nikolay A.,0,0,0,0
1668324558090,ECE 277,A00,103668,An; Cheolhong,0,0,0,0
1668324558515,ECE 279,A00,117947,Hall; Drew A.,0,0,0,0
1668324559364,ECE 283,A00,103670,Hsueh; Tzu-Chien,0,0,0,0
1668324559789,ECE 284,A00,103671,Turakhia; Yatish Girish,0,0,0,0
1668324560212,ECE 285,A00,103672,Zheng; Yang,0,0,0,0
1668324560212,ECE 285,B00,103673,Sworder; David D.,0,0,0,0
1668324560634,ECE 287,A00,103676,Javidi; Tara,0,0,0,0
1668324561061,MATH 200B,A00,098023,Salehi Golsefidy; Alireza,12,0,15,3
1668324561482,MATH 202B,A00,098024,Rhoades; Brendon Patrick,9,0,15,6
1668324561905,MATH 203B,A00,098025,Oprea; Dragos N.,10,0,15,5
1668324562332,MATH 204B,A00,098026,Sorensen; Claus M,13,0,15,2
1668324562765,MATH 208,A00,098027,Izadi; Elham,7,0,10,3
1668324563191,MATH 209,A00,098028,Pollack; Aaron,10,0,10,0
1668324563626,MATH 211A,A00,112919,Rogalski; Daniel,9,0,10,1
1668324564049,MATH 211B,A00,112920,Seward; Brandon M.,9,0,10,1
1668324564470,MATH 218,A00,098029,Li; Bo,10,0,10,0
1668324564899,MATH 220B,A00,098030,Novak; Jonathan I,11,0,15,4
1668324565326,MATH 221A,A00,098031,Ebenfelt; Peter F,13,0,15,2
1668324565828,MATH 231B,A00,098032,Zlatos; Andrej,12,0,15,3
1668324566260,MATH 240B,A00,098033,Ni; Lei,9,0,15,6
1668324566689,MATH 243,A00,098034,Jekel; David Andrew,10,0,10,0
1668324567113,MATH 245A,A00,098035,Nie; Jiawang,0,0,15,16
1668324567534,MATH 248,A00,098036,Bejenaru; Ioan,10,0,10,0
1668324567958,MATH 250B,A00,098037,Spolaor; Luca,14,0,15,1
1668324568380,MATH 258,A00,098038,Ni; Lei,10,0,10,0
1668324568803,MATH 264B,A00,098041,Rhoades; Brendon Patrick,9,0,15,6
1668324569230,MATH 268,A00,098042,Buss; Samuel R,10,0,10,0
1668324569654,MATH 269,A00,098043,Rhoades; Brendon Patrick,10,0,10,0
1668324570079,MATH 270B,A00,098044,Li; Bo,10,0,15,5
1668324570516,MATH 272B,A00,098045,Holst; Michael J,13,0,15,2
1668324570941,MATH 273A,A00,098046,Tian; Xiaochuan,10,0,15,5
1668324571368,MATH 275,A01,098048,Tian; Xiaochuan,6,0,10,4
1668324571792,MATH 278A,A00,098049,Holst; Michael J,8,0,10,2
1668324572227,MATH 278B,A00,098050,Cloninger; Alexander,10,0,10,0
1668324572654,MATH 278C,A00,098051,Nie; Jiawang,7,0,10,3
1668324573086,MATH 280B,A00,098052,Zheng; Tianyi,8,0,15,7
1668324573508,MATH 281B,A00,098053,Bradic; Jelena,1,0,15,14
1668324573934,MATH 282B,A00,098054,Arias-Castro; Ery,0,0,15,15
1668324574368,MATH 285,A00,098055,Fitzsimmons; Patrick J,0,0,15,17
1668324574792,MATH 287B,A00,098056,Arias-Castro; Ery,2,0,15,13
1668324575220,MATH 288,A00,098057,Agarwal; Pooja,9,0,10,1
1668324575220,MATH 288,B00,098058,Zhang; Danna,8,0,10,2
1668324575220,MATH 288,C00,098059,Williams; Ruth J,9,0,10,1
1668324575648,MATH 290B,A00,098060,Roberts; Justin Deritter,13,0,15,2
1668324576071,MATH 292,A00,098061,Belmont; Eva Kinoshita,10,0,10,0
1668324576495,MATH 295,A00,098062,Suk; Andrew Hoon,48,0,50,2
1668324576918,MATH 296,A00,098063,Novak; Jonathan I,20,0,20,0
1668324577347,MATH 297,001,098064,Gamst; Anthony Collins,9997,0,9999,2
1668325076283,COGS 205,A00,101395,Chiba; Andrea,19,0,20,1
1668325076710,COGS 210B,001,101404,Greene; Deanna Jacquelyn,9998,0,9999,1
1668325076710,COGS 210B,002,101417,Xia; Haijun,9999,0,9999,0
1668325076710,COGS 210B,003,101422,Nitz; Douglas A.,9999,0,9999,0
1668325076710,COGS 210B,004,101423,Hollan; James D.,9998,0,9999,1
1668325076710,COGS 210B,005,101424,Deak; Gedeon O.,9998,0,9999,1
1668325076710,COGS 210B,006,101425,Rossano; Federico,9999,0,9999,0
1668325077133,COGS 211B,A00,101427,Coulson; Seana M,9996,0,9999,3
1668325077556,COGS 220,A00,101428,Hollan; James D.,0,0,25,25
1668325077982,COGS 229,A00,101429,Dow; Steven P,18,0,25,7
1668325078409,COGS 230,A00,101430,Klemmer; Scott R,11,0,17,6
1668325078837,COGS 234,A00,101431,Xia; Haijun,1,0,25,24
1668325079266,COGS 260,A00,101432,Kiyonaga; Anastasia,21,0,25,4
1668325079266,COGS 260,B00,101433,Kirsh; David Joel,15,0,25,10
1668325079695,CSE 202,A00,102371,Impagliazzo; Russell,0,0,0,0
1668325080123,CSE 203B,A01,102373,Cheng; Chung Kuan,0,0,0,0
1668325080545,CSE 208,A00,102374,Micciancio; Daniele,0,0,0,0
1668325080968,CSE 209A,A00,112895,Impagliazzo; Russell,0,0,15,15
1668325081391,CSE 209B,A00,108005,Bellare; Mihir,0,0,0,0
1668325081819,CSE 210,A00,113163,Coblenz; Michael J,0,0,0,0
1668325082252,CSE 219,A00,106111,Dow; Steven P,0,0,20,20
1668325082681,CSE 221,A00,102376,Voelker; Geoffrey M.,0,0,0,0
1668325083105,CSE 224,A01,102378,Porter; George M,0,0,0,0
1668325083528,CSE 229A,A00,102379,Savage; Stefan,0,0,0,0
1668325083954,CSE 229C,A00,102380,Munyaka; Imani N. S.,0,0,0,0
1668325084379,CSE 232B,A00,102382,Deutsch; Alin Bernard,0,0,0,0
1668325084881,CSE 234,A01,112904,Kumar; Arun Kumar,0,0,0,0
1668325085307,CSE 237A,A00,102383,Rosing; Tajana Simunic,0,0,0,0
1668325085733,CSE 239A,A00,102384,Deutsch; Alin Bernard,0,0,0,0
1668325086156,CSE 239B,A00,102385,Polikarpova; Nadezhda,0,0,0,0
1668325086582,CSE 240A,A00,102386,Pannuto; Patrick William,0,0,0,0
1668325087008,CSE 240B,A00,102387,Zhao; Jishen,0,0,0,0
1668325087441,CSE 241A,A00,106406,Kang; Mingu,0,0,0,0
1668325087865,CSE 249B,A00,102388,Kahng; Andrew Byun,0,0,8,8
1668325088288,CSE 251B,A01,102392,Cottrell; Garrison W,0,0,0,0
1668325088288,CSE 251B,A02,102393,Cottrell; Garrison W,0,0,0,0
1668325088712,CSE 252B,A00,102394,Ochoa; Benjamin Lawrence,0,0,0,0
1668325089139,CSE 257,A01,102396,Gao; Sicun,0,0,0,0
1668325089562,CSE 272,A00,102397,Li; Tzumao,0,0,0,0
1668325089986,CSE 274,A00,111323,Chern; Albert Ren-Haur,0,0,0,0
1668325090409,CSE 282,A00,102398,Pevzner; Pavel Arkadjevich,0,0,0,0
1668325090835,CSE 284,A00,114175,Gymrek; Melissa Ann,0,0,0,0
1668325091263,CSE 290,A00,102399,Chandraker; Manmohan Krishna,0,0,0,0
1668325091263,CSE 290,B00,102400,Vaccaro; Kristen Marie,0,0,25,25
1668325091263,CSE 290,C00,102414,Pannuto; Patrick William,0,0,25,25
1668325091263,CSE 290,D00,102427,Pevzner; Pavel Arkadjevich,0,0,0,0
1668325091263,CSE 290,E00,102429,Zhao; Jishen,0,0,0,0
1668325091263,CSE 290,F00,102436,Tullsen; Dean Michael,0,0,0,0
1668325091263,CSE 290,G00,102440,Christensen; Henrik I,0,0,20,20
1668325091691,CSE 291,A00,102443,Su; Hao,0,0,0,0
1668325091691,CSE 291,B00,102448,Polikarpova; Nadezhda,0,0,0,0
1668325091691,CSE 291,C00,102453,Vaccaro; Kristen Marie,0,0,0,0
1668325091691,CSE 291,D00,111343,Savage; Stefan,0,0,0,0
1668325091691,CSE 291,E00,116474,Claffy; Kimberly Claire,0,0,0,0
1668325091691,CSE 291,F00,116479,Pasquale; Joseph,0,0,0,0
1668325092122,CSE 293,001,119111,Bafna; Vineet,9999,0,9999,0
1668325092122,CSE 293,002,119118,Bellare; Mihir,9999,0,9999,0
1668325092122,CSE 293,003,119122,Berg-Kirkpatrick; Taylor D,9999,0,9999,0
1668325092122,CSE 293,004,119135,Christensen; Henrik I,9999,0,9999,0
1668325092122,CSE 293,005,119142,Cottrell; Garrison W,9999,0,9999,0
1668325092122,CSE 293,006,119146,Deutsch; Alin Bernard,9999,0,9999,0
1668325092122,CSE 293,007,119159,Esmaeilzadeh; Hadi,9999,0,9999,0
1668325092122,CSE 293,008,119166,Freund; Yoav,9999,0,9999,0
1668325092122,CSE 293,009,119170,Griswold; William G.,9999,0,9999,0
1668325092122,CSE 293,010,119183,Gymrek; Melissa Ann,9999,0,9999,0
1668325092122,CSE 293,011,119190,Heninger; Nadia A,9999,0,9999,0
1668325092122,CSE 293,012,119230,Impagliazzo; Russell,9999,0,9999,0
1668325092122,CSE 293,013,119232,Jhala; Ranjit,9999,0,9999,0
1668325092122,CSE 293,014,119233,Kahng; Andrew Byun,9999,0,9999,0
1668325092122,CSE 293,015,119298,Kane; Daniel Mertz,9999,0,9999,0
1668325092122,CSE 293,016,119299,Kriegman; David J,9999,0,9999,0
1668325092122,CSE 293,017,119300,Kumar; Arun Kumar,9999,0,9999,0
1668325092122,CSE 293,018,119301,Lerner; Sorin,9999,0,9999,0
1668325092122,CSE 293,019,119302,Lovett; Shachar,9999,0,9999,0
1668325092122,CSE 293,020,119303,McAuley; Julian John,9999,0,9999,0
1668325092122,CSE 293,021,119304,Micciancio; Daniele,9999,0,9999,0
1668325092122,CSE 293,022,119367,Orailoglu; Alex,9999,0,9999,0
1668325092122,CSE 293,023,119382,Paturi; Ramamohan,9999,0,9999,0
1668325092122,CSE 293,024,119404,Polikarpova; Nadezhda,9999,0,9999,0
1668325092122,CSE 293,025,119406,Politz; Joseph Gibbs,9999,0,9999,0
1668325092122,CSE 293,026,119411,Porter; George M,9999,0,9999,0
1668325092122,CSE 293,027,119414,Porter; Leonard Emerson,9999,0,9999,0
1668325092122,CSE 293,028,119416,Ramamoorthi; Ravi,9999,0,9999,0
1668325092122,CSE 293,029,119417,Sahoo; Debashis,9999,0,9999,0
1668325092122,CSE 293,030,119420,Saul; Lawrence,9999,0,9999,0
1668325092122,CSE 293,031,119421,Savage; Stefan,9999,0,9999,0
1668325092122,CSE 293,032,119425,Schulze; Jurgen P.,9999,0,9999,0
1668325092122,CSE 293,033,119426,Snoeren; Alex C.,9999,0,9999,0
1668325092122,CSE 293,034,119428,Shang; Jingbo,9999,0,9999,0
1668325092122,CSE 293,035,119430,Stefan; Deian,9999,0,9999,0
1668325092122,CSE 293,036,119431,Su; Hao,9999,0,9999,0
1668325092122,CSE 293,037,119433,Swanson; Steven James,9999,0,9999,0
1668325092122,CSE 293,038,119435,Tullsen; Dean Michael,9999,0,9999,0
1668325092122,CSE 293,039,119483,Voelker; Geoffrey M.,9999,0,9999,0
1668325092122,CSE 293,040,119537,Zhao; Jishen,9999,0,9999,0
1668325092122,CSE 293,041,119538,Zhou; Yuan-Yuan,9999,0,9999,0
1668325092122,CSE 293,042,119539,Gao; Sicun,9999,0,9999,0
1668325092122,CSE 293,043,119540,Weibel; Nadir,9999,0,9999,0
1668325092122,CSE 293,044,119541,Gupta; Rajesh K.,9999,0,9999,0
1668325092122,CSE 293,045,126410,Vaccaro; Kristen Marie,9999,0,9999,0
1668325092122,CSE 293,046,126411,Klemke; Richard,9999,0,9999,0
1668325092557,CSE 294,A00,102459,Voelker; Geoffrey M.,0,0,0,0
1668325092557,CSE 294,B00,111322,Orailoglu; Alex,0,0,0,0
1668325092981,DSE 201,A00,096914,Deutsch; Alin Bernard,30,0,30,0
1668325093408,DSE 210,A00,096915,Dasgupta; Sanjoy,30,0,30,0
1668325093834,DSE 260A,A00,096916,Altintas De Callaf; Ilkay,30,0,30,0
1668325094262,ECE 200,001,103586,Antipa; Nicholas A,9999,0,9999,0
1668325094262,ECE 200,002,103587,Atanasov; Nikolay A.,9999,0,9999,0
1668325094262,ECE 200,003,103588,Bharadia; Dinesh,9999,0,9999,0
1668325094262,ECE 200,004,103589,Cheng; Chung Kuan,9999,0,9999,0
1668325094262,ECE 200,005,103590,Cosman; Pamela C.,9999,0,9999,0
1668325094262,ECE 200,006,103591,Dayeh; Shadi Ahmad,9999,0,9999,0
1668325094262,ECE 200,007,103592,Fainman; Yeshaiahu,9999,0,9999,0
1668325094262,ECE 200,008,103593,Ford; Joseph Earl,9999,0,9999,0
1668325094262,ECE 200,009,103594,Franceschetti; Massimo,9999,0,9999,0
1668325094262,ECE 200,010,103595,Fullerton; Eric E,9999,0,9999,0
1668325094262,ECE 200,011,103596,Galton; Ian A,9999,0,9999,0
1668325094262,ECE 200,012,103597,Gilja; Vikash,9999,0,9999,0
1668325094262,ECE 200,013,103598,Hall; Drew A.,9999,0,9999,0
1668325094262,ECE 200,014,103599,Hsueh; Tzu-Chien,9999,0,9999,0
1668325094262,ECE 200,015,103600,Javidi; Tara,9999,0,9999,0
1668325094262,ECE 200,016,103601,Kahng; Andrew Byun,9999,0,9999,0
1668325094262,ECE 200,017,103602,Kim; Young-Han,9999,0,9999,0
1668325094262,ECE 200,018,103603,Koushanfar; Farinaz,9999,0,9999,0
1668325094262,ECE 200,019,103604,Kuzum; Duygu,9999,0,9999,0
1668325094262,ECE 200,020,103605,Le; Hanh-Phuc,9999,0,9999,0
1668325094262,ECE 200,021,103606,Lin; Bill,9999,0,9999,0
1668325094262,ECE 200,022,103607,Liu; Zhaowei,9998,0,9999,1
1668325094262,ECE 200,023,103608,Lo; Yu-Hwa,9999,0,9999,0
1668325094262,ECE 200,024,103609,Lomakin; Vitaliy,9999,0,9999,0
1668325094262,ECE 200,025,103610,Mercier; Patrick Philip,9999,0,9999,0
1668325094262,ECE 200,026,103611,Meyer; Florian,9999,0,9999,0
1668325094262,ECE 200,027,103612,Milstein; Laurence B.,9999,0,9999,0
1668325094262,ECE 200,028,103613,Mir Arabbaygi; Siavash,9999,0,9999,0
1668325094262,ECE 200,029,103614,Mookherjea; Shayan,9999,0,9999,0
1668325094262,ECE 200,030,103615,Morris; Karcher William,9999,0,9999,0
1668325094262,ECE 200,031,103616,Ng; Tse Nga,9999,0,9999,0
1668325094262,ECE 200,032,103617,Nguyen; Truong Quang,9999,0,9999,0
1668325094262,ECE 200,033,103618,Nomura; Kenji,9999,0,9999,0
1668325094262,ECE 200,034,103619,Orlitsky; Alon,9999,0,9999,0
1668325094262,ECE 200,035,103620,Pal; Piya,9999,0,9999,0
1668325094262,ECE 200,036,103621,Papen; George C.,9999,0,9999,0
1668325094262,ECE 200,037,103622,Radic; Stojan,9999,0,9999,0
1668325094262,ECE 200,038,103623,Rao; Bhaskar D.,9999,0,9999,0
1668325094262,ECE 200,039,103624,Rao; Ramesh R,9999,0,9999,0
1668325094262,ECE 200,040,103625,Rebeiz; Gabriel,9999,0,9999,0
1668325094262,ECE 200,041,103626,Sanford; John R,9999,0,9999,0
1668325094262,ECE 200,042,103627,Siegel; Paul H.,9999,0,9999,0
1668325094262,ECE 200,043,103628,Sievenpiper; Daniel F.,9999,0,9999,0
1668325094262,ECE 200,044,103629,Sworder; David D.,9999,0,9999,0
1668325094262,ECE 200,045,103630,Taur; Yuan,9999,0,9999,0
1668325094262,ECE 200,046,103631,Touri; Behrouz,9999,0,9999,0
1668325094262,ECE 200,047,103632,Trivedi; Mohan M.,9999,0,9999,0
1668325094262,ECE 200,048,103633,Vasconcelos; Nuno,9999,0,9999,0
1668325094262,ECE 200,049,103634,Wang; Xiaolong,9999,0,9999,0
1668325094262,ECE 200,050,103635,Xie; Pengtao,9999,0,9999,0
1668325094262,ECE 200,051,103636,Yip; Michael,9999,0,9999,0
1668325094262,ECE 200,052,103637,Zeger; Kenneth A.,999,0,999,0
1668325094262,ECE 200,053,103638,Zhang; Xinyu,9999,0,9999,0
1668325094262,ECE 200,054,103639,Turakhia; Yatish Girish,9999,0,9999,0
1668325094262,ECE 200,055,103640,Kang; Mingu,9999,0,9999,0
1668325094262,ECE 200,056,103641,Shi; Yuanyuan,9999,0,9999,0
1668325094262,ECE 200,057,103642,Wang; Edward Jay,9999,0,9999,0
1668325094262,ECE 200,058,103643,Zheng; Yang,9999,0,9999,0
1668325094689,ECE 202,A00,103644,Kuzum; Duygu,0,0,0,0
1668325095116,ECE 212BN,A00,103646,Ng; Tse Nga,0,0,0,0
1668325095541,ECE 221,A00,111493,Staff,0,0,0,0
1668325095978,ECE 222B,A00,103647,Lomakin; Vitaliy,0,0,0,0
1668325096402,ECE 230B,A00,103648,Taur; Yuan,0,0,0,0
1668325096825,ECE 238B,A00,103649,Garay; Javier,0,0,0,0
1668325097255,ECE 240B,A00,112900,Fainman; Yeshaiahu,0,0,0,0
1668325097686,ECE 247A,A00,103650,Jokerst; Jesse Vincent,0,0,0,0
1668325098111,ECE 247B,A00,103651,Wang; Joseph,0,0,0,0
1668325098537,ECE 250,A00,103652,Siegel; Paul H.,0,0,0,0
1668325098960,ECE 251A,A00,103654,Rao; Bhaskar D.,0,0,0,0
1668325099385,ECE 257B,A00,103655,Bharadia; Dinesh,0,0,0,0
1668325099809,ECE 258A,A00,103656,Milstein; Laurence B.,0,0,0,0
1668325100232,ECE 260B,A00,103658,Kang; Mingu,0,0,0,0
1668325100661,ECE 264A,A00,103659,Galton; Ian A,0,0,0,0
1668325101085,ECE 265A,A00,103661,Gudem; Prasad S.S.,0,0,0,0
1668325101513,ECE 265D,A00,103662,Gudem; Prasad S.S.,0,0,0,0
1668325101938,ECE 268,A00,103663,Koushanfar; Farinaz,0,0,0,0
1668325102368,ECE 269,A01,103665,Pal; Piya,0,0,0,0
1668325102791,ECE 271B,A00,103666,Vasconcelos; Manuela,0,0,0,0
1668325103216,ECE 276A,A00,103667,Atanasov; Nikolay A.,0,0,0,0
1668325103641,ECE 277,A00,103668,An; Cheolhong,0,0,0,0
1668325104067,ECE 279,A00,117947,Hall; Drew A.,0,0,0,0
1668325104927,ECE 283,A00,103670,Hsueh; Tzu-Chien,0,0,0,0
1668325105353,ECE 284,A00,103671,Turakhia; Yatish Girish,0,0,0,0
1668325105782,ECE 285,A00,103672,Zheng; Yang,0,0,0,0
1668325105782,ECE 285,B00,103673,Sworder; David D.,0,0,0,0
1668325106212,ECE 287,A00,103676,Javidi; Tara,0,0,0,0
1668325106638,MATH 200B,A00,098023,Salehi Golsefidy; Alireza,12,0,15,3
1668325107063,MATH 202B,A00,098024,Rhoades; Brendon Patrick,9,0,15,6
1668325107486,MATH 203B,A00,098025,Oprea; Dragos N.,10,0,15,5
1668325107915,MATH 204B,A00,098026,Sorensen; Claus M,13,0,15,2
1668325108338,MATH 208,A00,098027,Izadi; Elham,7,0,10,3
1668325108765,MATH 209,A00,098028,Pollack; Aaron,10,0,10,0
1668325109191,MATH 211A,A00,112919,Rogalski; Daniel,9,0,10,1
1668325109615,MATH 211B,A00,112920,Seward; Brandon M.,9,0,10,1
1668325110041,MATH 218,A00,098029,Li; Bo,10,0,10,0
1668325110464,MATH 220B,A00,098030,Novak; Jonathan I,11,0,15,4
1668325110891,MATH 221A,A00,098031,Ebenfelt; Peter F,13,0,15,2
1668325111314,MATH 231B,A00,098032,Zlatos; Andrej,12,0,15,3
1668325111740,MATH 240B,A00,098033,Ni; Lei,9,0,15,6
1668325112166,MATH 243,A00,098034,Jekel; David Andrew,10,0,10,0
1668325112591,MATH 245A,A00,098035,Nie; Jiawang,0,0,15,16
1668325113015,MATH 248,A00,098036,Bejenaru; Ioan,10,0,10,0
1668325113437,MATH 250B,A00,098037,Spolaor; Luca,14,0,15,1
1668325113861,MATH 258,A00,098038,Ni; Lei,10,0,10,0
1668325114287,MATH 264B,A00,098041,Rhoades; Brendon Patrick,9,0,15,6
1668325114709,MATH 268,A00,098042,Buss; Samuel R,10,0,10,0
1668325115136,MATH 269,A00,098043,Rhoades; Brendon Patrick,10,0,10,0
1668325115561,MATH 270B,A00,098044,Li; Bo,10,0,15,5
1668325116001,MATH 272B,A00,098045,Holst; Michael J,13,0,15,2
1668325116428,MATH 273A,A00,098046,Tian; Xiaochuan,10,0,15,5
1668325116851,MATH 275,A01,098048,Tian; Xiaochuan,6,0,10,4
1668325117278,MATH 278A,A00,098049,Holst; Michael J,8,0,10,2
1668325117714,MATH 278B,A00,098050,Cloninger; Alexander,10,0,10,0
1668325118138,MATH 278C,A00,098051,Nie; Jiawang,7,0,10,3
1668325118565,MATH 280B,A00,098052,Zheng; Tianyi,8,0,15,7
1668325118991,MATH 281B,A00,098053,Bradic; Jelena,1,0,15,14
1668325119414,MATH 282B,A00,098054,Arias-Castro; Ery,0,0,15,15
1668325119840,MATH 285,A00,098055,Fitzsimmons; Patrick J,0,0,15,17
1668325120267,MATH 287B,A00,098056,Arias-Castro; Ery,2,0,15,13
1668325120691,MATH 288,A00,098057,Agarwal; Pooja,9,0,10,1
1668325120691,MATH 288,B00,098058,Zhang; Danna,8,0,10,2
1668325120691,MATH 288,C00,098059,Williams; Ruth J,9,0,10,1
1668325121115,MATH 290B,A00,098060,Roberts; Justin Deritter,13,0,15,2
1668325121541,MATH 292,A00,098061,Belmont; Eva Kinoshita,10,0,10,0
1668325121970,MATH 295,A00,098062,Suk; Andrew Hoon,48,0,50,2
1668325122405,MATH 296,A00,098063,Novak; Jonathan I,20,0,20,0
1668325122829,MATH 297,001,098064,Gamst; Anthony Collins,9997,0,9999,2
1668325621477,COGS 205,A00,101395,Chiba; Andrea,19,0,20,1
1668325621906,COGS 210B,001,101404,Greene; Deanna Jacquelyn,9998,0,9999,1
1668325621906,COGS 210B,002,101417,Xia; Haijun,9999,0,9999,0
1668325621906,COGS 210B,003,101422,Nitz; Douglas A.,9999,0,9999,0
1668325621906,COGS 210B,004,101423,Hollan; James D.,9998,0,9999,1
1668325621906,COGS 210B,005,101424,Deak; Gedeon O.,9998,0,9999,1
1668325621906,COGS 210B,006,101425,Rossano; Federico,9999,0,9999,0
1668325622332,COGS 211B,A00,101427,Coulson; Seana M,9996,0,9999,3
1668325622757,COGS 220,A00,101428,Hollan; James D.,0,0,25,25
1668325623182,COGS 229,A00,101429,Dow; Steven P,18,0,25,7
1668325623603,COGS 230,A00,101430,Klemmer; Scott R,11,0,17,6
1668325624028,COGS 234,A00,101431,Xia; Haijun,1,0,25,24
1668325624463,COGS 260,A00,101432,Kiyonaga; Anastasia,21,0,25,4
1668325624463,COGS 260,B00,101433,Kirsh; David Joel,15,0,25,10
1668325624888,CSE 202,A00,102371,Impagliazzo; Russell,0,0,0,0
1668325625313,CSE 203B,A01,102373,Cheng; Chung Kuan,0,0,0,0
1668325625738,CSE 208,A00,102374,Micciancio; Daniele,0,0,0,0
1668325626161,CSE 209A,A00,112895,Impagliazzo; Russell,0,0,15,15
1668325626586,CSE 209B,A00,108005,Bellare; Mihir,0,0,0,0
1668325627010,CSE 210,A00,113163,Coblenz; Michael J,0,0,0,0
1668325627440,CSE 219,A00,106111,Dow; Steven P,0,0,20,20
1668325627862,CSE 221,A00,102376,Voelker; Geoffrey M.,0,0,0,0
1668325628286,CSE 224,A01,102378,Porter; George M,0,0,0,0
1668325628709,CSE 229A,A00,102379,Savage; Stefan,0,0,0,0
1668325629134,CSE 229C,A00,102380,Munyaka; Imani N. S.,0,0,0,0
1668325629558,CSE 232B,A00,102382,Deutsch; Alin Bernard,0,0,0,0
1668325629981,CSE 234,A01,112904,Kumar; Arun Kumar,0,0,0,0
1668325630403,CSE 237A,A00,102383,Rosing; Tajana Simunic,0,0,0,0
1668325630827,CSE 239A,A00,102384,Deutsch; Alin Bernard,0,0,0,0
1668325631252,CSE 239B,A00,102385,Polikarpova; Nadezhda,0,0,0,0
1668325631676,CSE 240A,A00,102386,Pannuto; Patrick William,0,0,0,0
1668325632097,CSE 240B,A00,102387,Zhao; Jishen,0,0,0,0
1668325632520,CSE 241A,A00,106406,Kang; Mingu,0,0,0,0
1668325632944,CSE 249B,A00,102388,Kahng; Andrew Byun,0,0,8,8
1668325633365,CSE 251B,A01,102392,Cottrell; Garrison W,0,0,0,0
1668325633365,CSE 251B,A02,102393,Cottrell; Garrison W,0,0,0,0
1668325633791,CSE 252B,A00,102394,Ochoa; Benjamin Lawrence,0,0,0,0
1668325634217,CSE 257,A01,102396,Gao; Sicun,0,0,0,0
1668325634644,CSE 272,A00,102397,Li; Tzumao,0,0,0,0
1668325635068,CSE 274,A00,111323,Chern; Albert Ren-Haur,0,0,0,0
1668325635491,CSE 282,A00,102398,Pevzner; Pavel Arkadjevich,0,0,0,0
1668325635916,CSE 284,A00,114175,Gymrek; Melissa Ann,0,0,0,0
1668325636341,CSE 290,A00,102399,Chandraker; Manmohan Krishna,0,0,0,0
1668325636341,CSE 290,B00,102400,Vaccaro; Kristen Marie,0,0,25,25
1668325636341,CSE 290,C00,102414,Pannuto; Patrick William,0,0,25,25
1668325636341,CSE 290,D00,102427,Pevzner; Pavel Arkadjevich,0,0,0,0
1668325636341,CSE 290,E00,102429,Zhao; Jishen,0,0,0,0
1668325636341,CSE 290,F00,102436,Tullsen; Dean Michael,0,0,0,0
1668325636341,CSE 290,G00,102440,Christensen; Henrik I,0,0,20,20
1668325636766,CSE 291,A00,102443,Su; Hao,0,0,0,0
1668325636766,CSE 291,B00,102448,Polikarpova; Nadezhda,0,0,0,0
1668325636766,CSE 291,C00,102453,Vaccaro; Kristen Marie,0,0,0,0
1668325636766,CSE 291,D00,111343,Savage; Stefan,0,0,0,0
1668325636766,CSE 291,E00,116474,Claffy; Kimberly Claire,0,0,0,0
1668325636766,CSE 291,F00,116479,Pasquale; Joseph,0,0,0,0
1668325637199,CSE 293,001,119111,Bafna; Vineet,9999,0,9999,0
1668325637199,CSE 293,002,119118,Bellare; Mihir,9999,0,9999,0
1668325637199,CSE 293,003,119122,Berg-Kirkpatrick; Taylor D,9999,0,9999,0
1668325637199,CSE 293,004,119135,Christensen; Henrik I,9999,0,9999,0
1668325637199,CSE 293,005,119142,Cottrell; Garrison W,9999,0,9999,0
1668325637199,CSE 293,006,119146,Deutsch; Alin Bernard,9999,0,9999,0
1668325637199,CSE 293,007,119159,Esmaeilzadeh; Hadi,9999,0,9999,0
1668325637199,CSE 293,008,119166,Freund; Yoav,9999,0,9999,0
1668325637199,CSE 293,009,119170,Griswold; William G.,9999,0,9999,0
1668325637199,CSE 293,010,119183,Gymrek; Melissa Ann,9999,0,9999,0
1668325637199,CSE 293,011,119190,Heninger; Nadia A,9999,0,9999,0
1668325637199,CSE 293,012,119230,Impagliazzo; Russell,9999,0,9999,0
1668325637199,CSE 293,013,119232,Jhala; Ranjit,9999,0,9999,0
1668325637199,CSE 293,014,119233,Kahng; Andrew Byun,9999,0,9999,0
1668325637199,CSE 293,015,119298,Kane; Daniel Mertz,9999,0,9999,0
1668325637199,CSE 293,016,119299,Kriegman; David J,9999,0,9999,0
1668325637199,CSE 293,017,119300,Kumar; Arun Kumar,9999,0,9999,0
1668325637199,CSE 293,018,119301,Lerner; Sorin,9999,0,9999,0
1668325637199,CSE 293,019,119302,Lovett; Shachar,9999,0,9999,0
1668325637199,CSE 293,020,119303,McAuley; Julian John,9999,0,9999,0
1668325637199,CSE 293,021,119304,Micciancio; Daniele,9999,0,9999,0
1668325637199,CSE 293,022,119367,Orailoglu; Alex,9999,0,9999,0
1668325637199,CSE 293,023,119382,Paturi; Ramamohan,9999,0,9999,0
1668325637199,CSE 293,024,119404,Polikarpova; Nadezhda,9999,0,9999,0
1668325637199,CSE 293,025,119406,Politz; Joseph Gibbs,9999,0,9999,0
1668325637199,CSE 293,026,119411,Porter; George M,9999,0,9999,0
1668325637199,CSE 293,027,119414,Porter; Leonard Emerson,9999,0,9999,0
1668325637199,CSE 293,028,119416,Ramamoorthi; Ravi,9999,0,9999,0
1668325637199,CSE 293,029,119417,Sahoo; Debashis,9999,0,9999,0
1668325637199,CSE 293,030,119420,Saul; Lawrence,9999,0,9999,0
1668325637199,CSE 293,031,119421,Savage; Stefan,9999,0,9999,0
1668325637199,CSE 293,032,119425,Schulze; Jurgen P.,9999,0,9999,0
1668325637199,CSE 293,033,119426,Snoeren; Alex C.,9999,0,9999,0
1668325637199,CSE 293,034,119428,Shang; Jingbo,9999,0,9999,0
1668325637199,CSE 293,035,119430,Stefan; Deian,9999,0,9999,0
1668325637199,CSE 293,036,119431,Su; Hao,9999,0,9999,0
1668325637199,CSE 293,037,119433,Swanson; Steven James,9999,0,9999,0
1668325637199,CSE 293,038,119435,Tullsen; Dean Michael,9999,0,9999,0
1668325637199,CSE 293,039,119483,Voelker; Geoffrey M.,9999,0,9999,0
1668325637199,CSE 293,040,119537,Zhao; Jishen,9999,0,9999,0
1668325637199,CSE 293,041,119538,Zhou; Yuan-Yuan,9999,0,9999,0
1668325637199,CSE 293,042,119539,Gao; Sicun,9999,0,9999,0
1668325637199,CSE 293,043,119540,Weibel; Nadir,9999,0,9999,0
1668325637199,CSE 293,044,119541,Gupta; Rajesh K.,9999,0,9999,0
1668325637199,CSE 293,045,126410,Vaccaro; Kristen Marie,9999,0,9999,0
1668325637199,CSE 293,046,126411,Klemke; Richard,9999,0,9999,0
1668325637625,CSE 294,A00,102459,Voelker; Geoffrey M.,0,0,0,0
1668325637625,CSE 294,B00,111322,Orailoglu; Alex,0,0,0,0
1668325638047,DSE 201,A00,096914,Deutsch; Alin Bernard,30,0,30,0
1668325638471,DSE 210,A00,096915,Dasgupta; Sanjoy,30,0,30,0
1668325638894,DSE 260A,A00,096916,Altintas De Callaf; Ilkay,30,0,30,0
1668325639320,ECE 200,001,103586,Antipa; Nicholas A,9999,0,9999,0
1668325639320,ECE 200,002,103587,Atanasov; Nikolay A.,9999,0,9999,0
1668325639320,ECE 200,003,103588,Bharadia; Dinesh,9999,0,9999,0
1668325639320,ECE 200,004,103589,Cheng; Chung Kuan,9999,0,9999,0
1668325639320,ECE 200,005,103590,Cosman; Pamela C.,9999,0,9999,0
1668325639320,ECE 200,006,103591,Dayeh; Shadi Ahmad,9999,0,9999,0
1668325639320,ECE 200,007,103592,Fainman; Yeshaiahu,9999,0,9999,0
1668325639320,ECE 200,008,103593,Ford; Joseph Earl,9999,0,9999,0
1668325639320,ECE 200,009,103594,Franceschetti; Massimo,9999,0,9999,0
1668325639320,ECE 200,010,103595,Fullerton; Eric E,9999,0,9999,0
1668325639320,ECE 200,011,103596,Galton; Ian A,9999,0,9999,0
1668325639320,ECE 200,012,103597,Gilja; Vikash,9999,0,9999,0
1668325639320,ECE 200,013,103598,Hall; Drew A.,9999,0,9999,0
1668325639320,ECE 200,014,103599,Hsueh; Tzu-Chien,9999,0,9999,0
1668325639320,ECE 200,015,103600,Javidi; Tara,9999,0,9999,0
1668325639320,ECE 200,016,103601,Kahng; Andrew Byun,9999,0,9999,0
1668325639320,ECE 200,017,103602,Kim; Young-Han,9999,0,9999,0
1668325639320,ECE 200,018,103603,Koushanfar; Farinaz,9999,0,9999,0
1668325639320,ECE 200,019,103604,Kuzum; Duygu,9999,0,9999,0
1668325639320,ECE 200,020,103605,Le; Hanh-Phuc,9999,0,9999,0
1668325639320,ECE 200,021,103606,Lin; Bill,9999,0,9999,0
1668325639320,ECE 200,022,103607,Liu; Zhaowei,9998,0,9999,1
1668325639320,ECE 200,023,103608,Lo; Yu-Hwa,9999,0,9999,0
1668325639320,ECE 200,024,103609,Lomakin; Vitaliy,9999,0,9999,0
1668325639320,ECE 200,025,103610,Mercier; Patrick Philip,9999,0,9999,0
1668325639320,ECE 200,026,103611,Meyer; Florian,9999,0,9999,0
1668325639320,ECE 200,027,103612,Milstein; Laurence B.,9999,0,9999,0
1668325639320,ECE 200,028,103613,Mir Arabbaygi; Siavash,9999,0,9999,0
1668325639320,ECE 200,029,103614,Mookherjea; Shayan,9999,0,9999,0
1668325639320,ECE 200,030,103615,Morris; Karcher William,9999,0,9999,0
1668325639320,ECE 200,031,103616,Ng; Tse Nga,9999,0,9999,0
1668325639320,ECE 200,032,103617,Nguyen; Truong Quang,9999,0,9999,0
1668325639320,ECE 200,033,103618,Nomura; Kenji,9999,0,9999,0
1668325639320,ECE 200,034,103619,Orlitsky; Alon,9999,0,9999,0
1668325639320,ECE 200,035,103620,Pal; Piya,9999,0,9999,0
1668325639320,ECE 200,036,103621,Papen; George C.,9999,0,9999,0
1668325639320,ECE 200,037,103622,Radic; Stojan,9999,0,9999,0
1668325639320,ECE 200,038,103623,Rao; Bhaskar D.,9999,0,9999,0
1668325639320,ECE 200,039,103624,Rao; Ramesh R,9999,0,9999,0
1668325639320,ECE 200,040,103625,Rebeiz; Gabriel,9999,0,9999,0
1668325639320,ECE 200,041,103626,Sanford; John R,9999,0,9999,0
1668325639320,ECE 200,042,103627,Siegel; Paul H.,9999,0,9999,0
1668325639320,ECE 200,043,103628,Sievenpiper; Daniel F.,9999,0,9999,0
1668325639320,ECE 200,044,103629,Sworder; David D.,9999,0,9999,0
1668325639320,ECE 200,045,103630,Taur; Yuan,9999,0,9999,0
1668325639320,ECE 200,046,103631,Touri; Behrouz,9999,0,9999,0
1668325639320,ECE 200,047,103632,Trivedi; Mohan M.,9999,0,9999,0
1668325639320,ECE 200,048,103633,Vasconcelos; Nuno,9999,0,9999,0
1668325639320,ECE 200,049,103634,Wang; Xiaolong,9999,0,9999,0
1668325639320,ECE 200,050,103635,Xie; Pengtao,9999,0,9999,0
1668325639320,ECE 200,051,103636,Yip; Michael,9999,0,9999,0
1668325639320,ECE 200,052,103637,Zeger; Kenneth A.,999,0,999,0
1668325639320,ECE 200,053,103638,Zhang; Xinyu,9999,0,9999,0
1668325639320,ECE 200,054,103639,Turakhia; Yatish Girish,9999,0,9999,0
1668325639320,ECE 200,055,103640,Kang; Mingu,9999,0,9999,0
1668325639320,ECE 200,056,103641,Shi; Yuanyuan,9999,0,9999,0
1668325639320,ECE 200,057,103642,Wang; Edward Jay,9999,0,9999,0
1668325639320,ECE 200,058,103643,Zheng; Yang,9999,0,9999,0
1668325639744,ECE 202,A00,103644,Kuzum; Duygu,0,0,0,0
1668325640171,ECE 212BN,A00,103646,Ng; Tse Nga,0,0,0,0
1668325640596,ECE 221,A00,111493,Staff,0,0,0,0
1668325641019,ECE 222B,A00,103647,Lomakin; Vitaliy,0,0,0,0
1668325641443,ECE 230B,A00,103648,Taur; Yuan,0,0,0,0
1668325641867,ECE 238B,A00,103649,Garay; Javier,0,0,0,0
1668325642294,ECE 240B,A00,112900,Fainman; Yeshaiahu,0,0,0,0
1668325642722,ECE 247A,A00,103650,Jokerst; Jesse Vincent,0,0,0,0
1668325643149,ECE 247B,A00,103651,Wang; Joseph,0,0,0,0
1668325643577,ECE 250,A00,103652,Siegel; Paul H.,0,0,0,0
1668325644001,ECE 251A,A00,103654,Rao; Bhaskar D.,0,0,0,0
1668325644427,ECE 257B,A00,103655,Bharadia; Dinesh,0,0,0,0
1668325644852,ECE 258A,A00,103656,Milstein; Laurence B.,0,0,0,0
1668325645275,ECE 260B,A00,103658,Kang; Mingu,0,0,0,0
1668325645702,ECE 264A,A00,103659,Galton; Ian A,0,0,0,0
1668325646128,ECE 265A,A00,103661,Gudem; Prasad S.S.,0,0,0,0
1668325646632,ECE 265D,A00,103662,Gudem; Prasad S.S.,0,0,0,0
1668325647055,ECE 268,A00,103663,Koushanfar; Farinaz,0,0,0,0
1668325647479,ECE 269,A01,103665,Pal; Piya,0,0,0,0
1668325647905,ECE 271B,A00,103666,Vasconcelos; Manuela,0,0,0,0
1668325648334,ECE 276A,A00,103667,Atanasov; Nikolay A.,0,0,0,0
1668325648760,ECE 277,A00,103668,An; Cheolhong,0,0,0,0
1668325649189,ECE 279,A00,117947,Hall; Drew A.,0,0,0,0
1668325650049,ECE 283,A00,103670,Hsueh; Tzu-Chien,0,0,0,0
1668325650477,ECE 284,A00,103671,Turakhia; Yatish Girish,0,0,0,0
1668325650899,ECE 285,A00,103672,Zheng; Yang,0,0,0,0
1668325650899,ECE 285,B00,103673,Sworder; David D.,0,0,0,0
1668325651323,ECE 287,A00,103676,Javidi; Tara,0,0,0,0
1668325651749,MATH 200B,A00,098023,Salehi Golsefidy; Alireza,12,0,15,3
1668325652176,MATH 202B,A00,098024,Rhoades; Brendon Patrick,9,0,15,6
1668325652599,MATH 203B,A00,098025,Oprea; Dragos N.,10,0,15,5
1668325653023,MATH 204B,A00,098026,Sorensen; Claus M,13,0,15,2
1668325653450,MATH 208,A00,098027,Izadi; Elham,7,0,10,3
1668325653875,MATH 209,A00,098028,Pollack; Aaron,10,0,10,0
1668325654307,MATH 211A,A00,112919,Rogalski; Daniel,9,0,10,1
1668325654733,MATH 211B,A00,112920,Seward; Brandon M.,9,0,10,1
1668325655156,MATH 218,A00,098029,Li; Bo,10,0,10,0
1668325655580,MATH 220B,A00,098030,Novak; Jonathan I,11,0,15,4
1668325656005,MATH 221A,A00,098031,Ebenfelt; Peter F,13,0,15,2
1668325656428,MATH 231B,A00,098032,Zlatos; Andrej,12,0,15,3
1668325656854,MATH 240B,A00,098033,Ni; Lei,9,0,15,6
1668325657285,MATH 243,A00,098034,Jekel; David Andrew,10,0,10,0
1668325657711,MATH 245A,A00,098035,Nie; Jiawang,0,0,15,16
1668325658136,MATH 248,A00,098036,Bejenaru; Ioan,10,0,10,0
1668325658560,MATH 250B,A00,098037,Spolaor; Luca,14,0,15,1
1668325658983,MATH 258,A00,098038,Ni; Lei,10,0,10,0
1668325659406,MATH 264B,A00,098041,Rhoades; Brendon Patrick,9,0,15,6
1668325659830,MATH 268,A00,098042,Buss; Samuel R,10,0,10,0
1668325660257,MATH 269,A00,098043,Rhoades; Brendon Patrick,10,0,10,0
1668325660696,MATH 270B,A00,098044,Li; Bo,10,0,15,5
1668325661123,MATH 272B,A00,098045,Holst; Michael J,13,0,15,2
1668325661546,MATH 273A,A00,098046,Tian; Xiaochuan,10,0,15,5
1668325661969,MATH 275,A01,098048,Tian; Xiaochuan,6,0,10,4
1668325662393,MATH 278A,A00,098049,Holst; Michael J,8,0,10,2
1668325662820,MATH 278B,A00,098050,Cloninger; Alexander,10,0,10,0
1668325663244,MATH 278C,A00,098051,Nie; Jiawang,7,0,10,3
1668325663671,MATH 280B,A00,098052,Zheng; Tianyi,8,0,15,7
1668325664096,MATH 281B,A00,098053,Bradic; Jelena,1,0,15,14
1668325664522,MATH 282B,A00,098054,Arias-Castro; Ery,0,0,15,15
1668325664949,MATH 285,A00,098055,Fitzsimmons; Patrick J,0,0,15,17
1668325665374,MATH 287B,A00,098056,Arias-Castro; Ery,2,0,15,13
1668325665798,MATH 288,A00,098057,Agarwal; Pooja,9,0,10,1
1668325665798,MATH 288,B00,098058,Zhang; Danna,8,0,10,2
1668325665798,MATH 288,C00,098059,Williams; Ruth J,9,0,10,1
1668325666223,MATH 290B,A00,098060,Roberts; Justin Deritter,13,0,15,2
1668325666649,MATH 292,A00,098061,Belmont; Eva Kinoshita,10,0,10,0
1668325667075,MATH 295,A00,098062,Suk; Andrew Hoon,48,0,50,2
1668325667498,MATH 296,A00,098063,Novak; Jonathan I,20,0,20,0
1668325667922,MATH 297,001,098064,Gamst; Anthony Collins,9997,0,9999,2
1668326166175,COGS 205,A00,101395,Chiba; Andrea,19,0,20,1
1668326166603,COGS 210B,001,101404,Greene; Deanna Jacquelyn,9998,0,9999,1
1668326166603,COGS 210B,002,101417,Xia; Haijun,9999,0,9999,0
1668326166603,COGS 210B,003,101422,Nitz; Douglas A.,9999,0,9999,0
1668326166603,COGS 210B,004,101423,Hollan; James D.,9998,0,9999,1
1668326166603,COGS 210B,005,101424,Deak; Gedeon O.,9998,0,9999,1
1668326166603,COGS 210B,006,101425,Rossano; Federico,9999,0,9999,0
1668326167030,COGS 211B,A00,101427,Coulson; Seana M,9996,0,9999,3
1668326167456,COGS 220,A00,101428,Hollan; James D.,0,0,25,25
1668326167879,COGS 229,A00,101429,Dow; Steven P,18,0,25,7
1668326168301,COGS 230,A00,101430,Klemmer; Scott R,11,0,17,6
1668326168727,COGS 234,A00,101431,Xia; Haijun,1,0,25,24
1668326169152,COGS 260,A00,101432,Kiyonaga; Anastasia,21,0,25,4
1668326169152,COGS 260,B00,101433,Kirsh; David Joel,15,0,25,10
1668326169573,CSE 202,A00,102371,Impagliazzo; Russell,0,0,0,0
1668326169997,CSE 203B,A01,102373,Cheng; Chung Kuan,0,0,0,0
1668326170420,CSE 208,A00,102374,Micciancio; Daniele,0,0,0,0
1668326170843,CSE 209A,A00,112895,Impagliazzo; Russell,0,0,15,15
1668326171268,CSE 209B,A00,108005,Bellare; Mihir,0,0,0,0
1668326171694,CSE 210,A00,113163,Coblenz; Michael J,0,0,0,0
1668326172120,CSE 219,A00,106111,Dow; Steven P,0,0,20,20
1668326172543,CSE 221,A00,102376,Voelker; Geoffrey M.,0,0,0,0
1668326172977,CSE 224,A01,102378,Porter; George M,0,0,0,0
1668326173399,CSE 229A,A00,102379,Savage; Stefan,0,0,0,0
1668326173824,CSE 229C,A00,102380,Munyaka; Imani N. S.,0,0,0,0
1668326174250,CSE 232B,A00,102382,Deutsch; Alin Bernard,0,0,0,0
1668326174675,CSE 234,A01,112904,Kumar; Arun Kumar,0,0,0,0
1668326175099,CSE 237A,A00,102383,Rosing; Tajana Simunic,0,0,0,0
1668326175530,CSE 239A,A00,102384,Deutsch; Alin Bernard,0,0,0,0
1668326175954,CSE 239B,A00,102385,Polikarpova; Nadezhda,0,0,0,0
1668326176382,CSE 240A,A00,102386,Pannuto; Patrick William,0,0,0,0
1668326176805,CSE 240B,A00,102387,Zhao; Jishen,0,0,0,0
1668326177228,CSE 241A,A00,106406,Kang; Mingu,0,0,0,0
1668326177653,CSE 249B,A00,102388,Kahng; Andrew Byun,0,0,8,8
1668326178081,CSE 251B,A01,102392,Cottrell; Garrison W,0,0,0,0
1668326178081,CSE 251B,A02,102393,Cottrell; Garrison W,0,0,0,0
1668326178505,CSE 252B,A00,102394,Ochoa; Benjamin Lawrence,0,0,0,0
1668326178931,CSE 257,A01,102396,Gao; Sicun,0,0,0,0
1668326179356,CSE 272,A00,102397,Li; Tzumao,0,0,0,0
1668326179783,CSE 274,A00,111323,Chern; Albert Ren-Haur,0,0,0,0
1668326180210,CSE 282,A00,102398,Pevzner; Pavel Arkadjevich,0,0,0,0
1668326180635,CSE 284,A00,114175,Gymrek; Melissa Ann,0,0,0,0
1668326181063,CSE 290,A00,102399,Chandraker; Manmohan Krishna,0,0,0,0
1668326181063,CSE 290,B00,102400,Vaccaro; Kristen Marie,0,0,25,25
1668326181063,CSE 290,C00,102414,Pannuto; Patrick William,0,0,25,25
1668326181063,CSE 290,D00,102427,Pevzner; Pavel Arkadjevich,0,0,0,0
1668326181063,CSE 290,E00,102429,Zhao; Jishen,0,0,0,0
1668326181063,CSE 290,F00,102436,Tullsen; Dean Michael,0,0,0,0
1668326181063,CSE 290,G00,102440,Christensen; Henrik I,0,0,20,20
1668326181493,CSE 291,A00,102443,Su; Hao,0,0,0,0
1668326181493,CSE 291,B00,102448,Polikarpova; Nadezhda,0,0,0,0
1668326181493,CSE 291,C00,102453,Vaccaro; Kristen Marie,0,0,0,0
1668326181493,CSE 291,D00,111343,Savage; Stefan,0,0,0,0
1668326181493,CSE 291,E00,116474,Claffy; Kimberly Claire,0,0,0,0
1668326181493,CSE 291,F00,116479,Pasquale; Joseph,0,0,0,0
1668326181929,CSE 293,001,119111,Bafna; Vineet,9999,0,9999,0
1668326181929,CSE 293,002,119118,Bellare; Mihir,9999,0,9999,0
1668326181929,CSE 293,003,119122,Berg-Kirkpatrick; Taylor D,9999,0,9999,0
1668326181929,CSE 293,004,119135,Christensen; Henrik I,9999,0,9999,0
1668326181929,CSE 293,005,119142,Cottrell; Garrison W,9999,0,9999,0
1668326181929,CSE 293,006,119146,Deutsch; Alin Bernard,9999,0,9999,0
1668326181929,CSE 293,007,119159,Esmaeilzadeh; Hadi,9999,0,9999,0
1668326181929,CSE 293,008,119166,Freund; Yoav,9999,0,9999,0
1668326181929,CSE 293,009,119170,Griswold; William G.,9999,0,9999,0
1668326181929,CSE 293,010,119183,Gymrek; Melissa Ann,9999,0,9999,0
1668326181929,CSE 293,011,119190,Heninger; Nadia A,9999,0,9999,0
1668326181929,CSE 293,012,119230,Impagliazzo; Russell,9999,0,9999,0
1668326181929,CSE 293,013,119232,Jhala; Ranjit,9999,0,9999,0
1668326181929,CSE 293,014,119233,Kahng; Andrew Byun,9999,0,9999,0
1668326181929,CSE 293,015,119298,Kane; Daniel Mertz,9999,0,9999,0
1668326181929,CSE 293,016,119299,Kriegman; David J,9999,0,9999,0
1668326181929,CSE 293,017,119300,Kumar; Arun Kumar,9999,0,9999,0
1668326181929,CSE 293,018,119301,Lerner; Sorin,9999,0,9999,0
1668326181929,CSE 293,019,119302,Lovett; Shachar,9999,0,9999,0
1668326181929,CSE 293,020,119303,McAuley; Julian John,9999,0,9999,0
1668326181929,CSE 293,021,119304,Micciancio; Daniele,9999,0,9999,0
1668326181929,CSE 293,022,119367,Orailoglu; Alex,9999,0,9999,0
1668326181929,CSE 293,023,119382,Paturi; Ramamohan,9999,0,9999,0
1668326181929,CSE 293,024,119404,Polikarpova; Nadezhda,9999,0,9999,0
1668326181929,CSE 293,025,119406,Politz; Joseph Gibbs,9999,0,9999,0
1668326181929,CSE 293,026,119411,Porter; George M,9999,0,9999,0
1668326181929,CSE 293,027,119414,Porter; Leonard Emerson,9999,0,9999,0
1668326181929,CSE 293,028,119416,Ramamoorthi; Ravi,9999,0,9999,0
1668326181929,CSE 293,029,119417,Sahoo; Debashis,9999,0,9999,0
1668326181929,CSE 293,030,119420,Saul; Lawrence,9999,0,9999,0
1668326181929,CSE 293,031,119421,Savage; Stefan,9999,0,9999,0
1668326181929,CSE 293,032,119425,Schulze; Jurgen P.,9999,0,9999,0
1668326181929,CSE 293,033,119426,Snoeren; Alex C.,9999,0,9999,0
1668326181929,CSE 293,034,119428,Shang; Jingbo,9999,0,9999,0
1668326181929,CSE 293,035,119430,Stefan; Deian,9999,0,9999,0
1668326181929,CSE 293,036,119431,Su; Hao,9999,0,9999,0
1668326181929,CSE 293,037,119433,Swanson; Steven James,9999,0,9999,0
1668326181929,CSE 293,038,119435,Tullsen; Dean Michael,9999,0,9999,0
1668326181929,CSE 293,039,119483,Voelker; Geoffrey M.,9999,0,9999,0
1668326181929,CSE 293,040,119537,Zhao; Jishen,9999,0,9999,0
1668326181929,CSE 293,041,119538,Zhou; Yuan-Yuan,9999,0,9999,0
1668326181929,CSE 293,042,119539,Gao; Sicun,9999,0,9999,0
1668326181929,CSE 293,043,119540,Weibel; Nadir,9999,0,9999,0
1668326181929,CSE 293,044,119541,Gupta; Rajesh K.,9999,0,9999,0
1668326181929,CSE 293,045,126410,Vaccaro; Kristen Marie,9999,0,9999,0
1668326181929,CSE 293,046,126411,Klemke; Richard,9999,0,9999,0
1668326182357,CSE 294,A00,102459,Voelker; Geoffrey M.,0,0,0,0
1668326182357,CSE 294,B00,111322,Orailoglu; Alex,0,0,0,0
1668326182781,DSE 201,A00,096914,Deutsch; Alin Bernard,30,0,30,0
1668326183205,DSE 210,A00,096915,Dasgupta; Sanjoy,30,0,30,0
1668326183627,DSE 260A,A00,096916,Altintas De Callaf; Ilkay,30,0,30,0
1668326184055,ECE 200,001,103586,Antipa; Nicholas A,9999,0,9999,0
1668326184055,ECE 200,002,103587,Atanasov; Nikolay A.,9999,0,9999,0
1668326184055,ECE 200,003,103588,Bharadia; Dinesh,9999,0,9999,0
1668326184055,ECE 200,004,103589,Cheng; Chung Kuan,9999,0,9999,0
1668326184055,ECE 200,005,103590,Cosman; Pamela C.,9999,0,9999,0
1668326184055,ECE 200,006,103591,Dayeh; Shadi Ahmad,9999,0,9999,0
1668326184055,ECE 200,007,103592,Fainman; Yeshaiahu,9999,0,9999,0
1668326184055,ECE 200,008,103593,Ford; Joseph Earl,9999,0,9999,0
1668326184055,ECE 200,009,103594,Franceschetti; Massimo,9999,0,9999,0
1668326184055,ECE 200,010,103595,Fullerton; Eric E,9999,0,9999,0
1668326184055,ECE 200,011,103596,Galton; Ian A,9999,0,9999,0
1668326184055,ECE 200,012,103597,Gilja; Vikash,9999,0,9999,0
1668326184055,ECE 200,013,103598,Hall; Drew A.,9999,0,9999,0
1668326184055,ECE 200,014,103599,Hsueh; Tzu-Chien,9999,0,9999,0
1668326184055,ECE 200,015,103600,Javidi; Tara,9999,0,9999,0
1668326184055,ECE 200,016,103601,Kahng; Andrew Byun,9999,0,9999,0
1668326184055,ECE 200,017,103602,Kim; Young-Han,9999,0,9999,0
1668326184055,ECE 200,018,103603,Koushanfar; Farinaz,9999,0,9999,0
1668326184055,ECE 200,019,103604,Kuzum; Duygu,9999,0,9999,0
1668326184055,ECE 200,020,103605,Le; Hanh-Phuc,9999,0,9999,0
1668326184055,ECE 200,021,103606,Lin; Bill,9999,0,9999,0
1668326184055,ECE 200,022,103607,Liu; Zhaowei,9998,0,9999,1
1668326184055,ECE 200,023,103608,Lo; Yu-Hwa,9999,0,9999,0
1668326184055,ECE 200,024,103609,Lomakin; Vitaliy,9999,0,9999,0
1668326184055,ECE 200,025,103610,Mercier; Patrick Philip,9999,0,9999,0
1668326184055,ECE 200,026,103611,Meyer; Florian,9999,0,9999,0
1668326184055,ECE 200,027,103612,Milstein; Laurence B.,9999,0,9999,0
1668326184055,ECE 200,028,103613,Mir Arabbaygi; Siavash,9999,0,9999,0
1668326184055,ECE 200,029,103614,Mookherjea; Shayan,9999,0,9999,0
1668326184055,ECE 200,030,103615,Morris; Karcher William,9999,0,9999,0
1668326184055,ECE 200,031,103616,Ng; Tse Nga,9999,0,9999,0
1668326184055,ECE 200,032,103617,Nguyen; Truong Quang,9999,0,9999,0
1668326184055,ECE 200,033,103618,Nomura; Kenji,9999,0,9999,0
1668326184055,ECE 200,034,103619,Orlitsky; Alon,9999,0,9999,0
1668326184055,ECE 200,035,103620,Pal; Piya,9999,0,9999,0
1668326184055,ECE 200,036,103621,Papen; George C.,9999,0,9999,0
1668326184055,ECE 200,037,103622,Radic; Stojan,9999,0,9999,0
1668326184055,ECE 200,038,103623,Rao; Bhaskar D.,9999,0,9999,0
1668326184055,ECE 200,039,103624,Rao; Ramesh R,9999,0,9999,0
1668326184055,ECE 200,040,103625,Rebeiz; Gabriel,9999,0,9999,0
1668326184055,ECE 200,041,103626,Sanford; John R,9999,0,9999,0
1668326184055,ECE 200,042,103627,Siegel; Paul H.,9999,0,9999,0
1668326184055,ECE 200,043,103628,Sievenpiper; Daniel F.,9999,0,9999,0
1668326184055,ECE 200,044,103629,Sworder; David D.,9999,0,9999,0
1668326184055,ECE 200,045,103630,Taur; Yuan,9999,0,9999,0
1668326184055,ECE 200,046,103631,Touri; Behrouz,9999,0,9999,0
1668326184055,ECE 200,047,103632,Trivedi; Mohan M.,9999,0,9999,0
1668326184055,ECE 200,048,103633,Vasconcelos; Nuno,9999,0,9999,0
1668326184055,ECE 200,049,103634,Wang; Xiaolong,9999,0,9999,0
1668326184055,ECE 200,050,103635,Xie; Pengtao,9999,0,9999,0
1668326184055,ECE 200,051,103636,Yip; Michael,9999,0,9999,0
1668326184055,ECE 200,052,103637,Zeger; Kenneth A.,999,0,999,0
1668326184055,ECE 200,053,103638,Zhang; Xinyu,9999,0,9999,0
1668326184055,ECE 200,054,103639,Turakhia; Yatish Girish,9999,0,9999,0
1668326184055,ECE 200,055,103640,Kang; Mingu,9999,0,9999,0
1668326184055,ECE 200,056,103641,Shi; Yuanyuan,9999,0,9999,0
1668326184055,ECE 200,057,103642,Wang; Edward Jay,9999,0,9999,0
1668326184055,ECE 200,058,103643,Zheng; Yang,9999,0,9999,0
1668326184479,ECE 202,A00,103644,Kuzum; Duygu,0,0,0,0
1668326184906,ECE 212BN,A00,103646,Ng; Tse Nga,0,0,0,0
1668326185332,ECE 221,A00,111493,Staff,0,0,0,0
1668326185756,ECE 222B,A00,103647,Lomakin; Vitaliy,0,0,0,0
1668326186179,ECE 230B,A00,103648,Taur; Yuan,0,0,0,0
1668326186602,ECE 238B,A00,103649,Garay; Javier,0,0,0,0
1668326187026,ECE 240B,A00,112900,Fainman; Yeshaiahu,0,0,0,0
1668326187454,ECE 247A,A00,103650,Jokerst; Jesse Vincent,0,0,0,0
1668326187883,ECE 247B,A00,103651,Wang; Joseph,0,0,0,0
1668326188308,ECE 250,A00,103652,Siegel; Paul H.,0,0,0,0
1668326188733,ECE 251A,A00,103654,Rao; Bhaskar D.,0,0,0,0
1668326189157,ECE 257B,A00,103655,Bharadia; Dinesh,0,0,0,0
1668326189581,ECE 258A,A00,103656,Milstein; Laurence B.,0,0,0,0
1668326190002,ECE 260B,A00,103658,Kang; Mingu,0,0,0,0
1668326190427,ECE 264A,A00,103659,Galton; Ian A,0,0,0,0
1668326190850,ECE 265A,A00,103661,Gudem; Prasad S.S.,0,0,0,0
1668326191284,ECE 265D,A00,103662,Gudem; Prasad S.S.,0,0,0,0
1668326191712,ECE 268,A00,103663,Koushanfar; Farinaz,0,0,0,0
1668326192138,ECE 269,A01,103665,Pal; Piya,0,0,0,0
1668326192571,ECE 271B,A00,103666,Vasconcelos; Manuela,0,0,0,0
1668326192995,ECE 276A,A00,103667,Atanasov; Nikolay A.,0,0,0,0
1668326193421,ECE 277,A00,103668,An; Cheolhong,0,0,0,0
1668326193843,ECE 279,A00,117947,Hall; Drew A.,0,0,0,0
1668326194694,ECE 283,A00,103670,Hsueh; Tzu-Chien,0,0,0,0
1668326195123,ECE 284,A00,103671,Turakhia; Yatish Girish,0,0,0,0
1668326195551,ECE 285,A00,103672,Zheng; Yang,0,0,0,0
1668326195551,ECE 285,B00,103673,Sworder; David D.,0,0,0,0
1668326195974,ECE 287,A00,103676,Javidi; Tara,0,0,0,0
1668326196399,MATH 200B,A00,098023,Salehi Golsefidy; Alireza,12,0,15,3
1668326196825,MATH 202B,A00,098024,Rhoades; Brendon Patrick,9,0,15,6
1668326197251,MATH 203B,A00,098025,Oprea; Dragos N.,10,0,15,5
1668326197674,MATH 204B,A00,098026,Sorensen; Claus M,13,0,15,2
1668326198098,MATH 208,A00,098027,Izadi; Elham,7,0,10,3
1668326198522,MATH 209,A00,098028,Pollack; Aaron,10,0,10,0
1668326198946,MATH 211A,A00,112919,Rogalski; Daniel,9,0,10,1
1668326199370,MATH 211B,A00,112920,Seward; Brandon M.,9,0,10,1
1668326199794,MATH 218,A00,098029,Li; Bo,10,0,10,0
1668326200219,MATH 220B,A00,098030,Novak; Jonathan I,11,0,15,4
1668326200644,MATH 221A,A00,098031,Ebenfelt; Peter F,13,0,15,2
1668326201070,MATH 231B,A00,098032,Zlatos; Andrej,12,0,15,3
1668326201503,MATH 240B,A00,098033,Ni; Lei,9,0,15,6
1668326201926,MATH 243,A00,098034,Jekel; David Andrew,10,0,10,0
1668326202350,MATH 245A,A00,098035,Nie; Jiawang,0,0,15,16
1668326202789,MATH 248,A00,098036,Bejenaru; Ioan,10,0,10,0
1668326203216,MATH 250B,A00,098037,Spolaor; Luca,14,0,15,1
1668326203642,MATH 258,A00,098038,Ni; Lei,10,0,10,0
1668326204068,MATH 264B,A00,098041,Rhoades; Brendon Patrick,9,0,15,6
1668326204491,MATH 268,A00,098042,Buss; Samuel R,10,0,10,0
1668326204914,MATH 269,A00,098043,Rhoades; Brendon Patrick,10,0,10,0
1668326205337,MATH 270B,A00,098044,Li; Bo,10,0,15,5
1668326205760,MATH 272B,A00,098045,Holst; Michael J,13,0,15,2
1668326206183,MATH 273A,A00,098046,Tian; Xiaochuan,10,0,15,5
1668326206611,MATH 275,A01,098048,Tian; Xiaochuan,6,0,10,4
1668326207036,MATH 278A,A00,098049,Holst; Michael J,8,0,10,2
1668326207469,MATH 278B,A00,098050,Cloninger; Alexander,10,0,10,0
1668326207967,MATH 278C,A00,098051,Nie; Jiawang,7,0,10,3
1668326208395,MATH 280B,A00,098052,Zheng; Tianyi,8,0,15,7
1668326208818,MATH 281B,A00,098053,Bradic; Jelena,1,0,15,14
1668326209245,MATH 282B,A00,098054,Arias-Castro; Ery,0,0,15,15
1668326209671,MATH 285,A00,098055,Fitzsimmons; Patrick J,0,0,15,17
1668326210093,MATH 287B,A00,098056,Arias-Castro; Ery,2,0,15,13
1668326210519,MATH 288,A00,098057,Agarwal; Pooja,9,0,10,1
1668326210519,MATH 288,B00,098058,Zhang; Danna,8,0,10,2
1668326210519,MATH 288,C00,098059,Williams; Ruth J,9,0,10,1
1668326210945,MATH 290B,A00,098060,Roberts; Justin Deritter,13,0,15,2
1668326211370,MATH 292,A00,098061,Belmont; Eva Kinoshita,10,0,10,0
1668326211793,MATH 295,A00,098062,Suk; Andrew Hoon,48,0,50,2
1668326212217,MATH 296,A00,098063,Novak; Jonathan I,20,0,20,0
1668326212642,MATH 297,001,098064,Gamst; Anthony Collins,9997,0,9999,2
1668326712064,COGS 205,A00,101395,Chiba; Andrea,19,0,20,1
1668326712491,COGS 210B,001,101404,Greene; Deanna Jacquelyn,9998,0,9999,1
1668326712491,COGS 210B,002,101417,Xia; Haijun,9999,0,9999,0
1668326712491,COGS 210B,003,101422,Nitz; Douglas A.,9999,0,9999,0
1668326712491,COGS 210B,004,101423,Hollan; James D.,9998,0,9999,1
1668326712491,COGS 210B,005,101424,Deak; Gedeon O.,9998,0,9999,1
1668326712491,COGS 210B,006,101425,Rossano; Federico,9999,0,9999,0
1668326712917,COGS 211B,A00,101427,Coulson; Seana M,9996,0,9999,3
1668326713341,COGS 220,A00,101428,Hollan; James D.,0,0,25,25
1668326713767,COGS 229,A00,101429,Dow; Steven P,18,0,25,7
1668326714191,COGS 230,A00,101430,Klemmer; Scott R,11,0,17,6
1668326714615,COGS 234,A00,101431,Xia; Haijun,1,0,25,24
1668326715039,COGS 260,A00,101432,Kiyonaga; Anastasia,21,0,25,4
1668326715039,COGS 260,B00,101433,Kirsh; David Joel,15,0,25,10
1668326715463,CSE 202,A00,102371,Impagliazzo; Russell,0,0,0,0
1668326715885,CSE 203B,A01,102373,Cheng; Chung Kuan,0,0,0,0
1668326716311,CSE 208,A00,102374,Micciancio; Daniele,0,0,0,0
1668326716734,CSE 209A,A00,112895,Impagliazzo; Russell,0,0,15,15
1668326717161,CSE 209B,A00,108005,Bellare; Mihir,0,0,0,0
1668326717585,CSE 210,A00,113163,Coblenz; Michael J,0,0,0,0
1668326718010,CSE 219,A00,106111,Dow; Steven P,0,0,20,20
1668326718435,CSE 221,A00,102376,Voelker; Geoffrey M.,0,0,0,0
1668326718859,CSE 224,A01,102378,Porter; George M,0,0,0,0
1668326719281,CSE 229A,A00,102379,Savage; Stefan,0,0,0,0
1668326719704,CSE 229C,A00,102380,Munyaka; Imani N. S.,0,0,0,0
1668326720127,CSE 232B,A00,102382,Deutsch; Alin Bernard,0,0,0,0
1668326720552,CSE 234,A01,112904,Kumar; Arun Kumar,0,0,0,0
1668326720975,CSE 237A,A00,102383,Rosing; Tajana Simunic,0,0,0,0
1668326721399,CSE 239A,A00,102384,Deutsch; Alin Bernard,0,0,0,0
1668326721822,CSE 239B,A00,102385,Polikarpova; Nadezhda,0,0,0,0
1668326722248,CSE 240A,A00,102386,Pannuto; Patrick William,0,0,0,0
1668326722681,CSE 240B,A00,102387,Zhao; Jishen,0,0,0,0
1668326723106,CSE 241A,A00,106406,Kang; Mingu,0,0,0,0
1668326723531,CSE 249B,A00,102388,Kahng; Andrew Byun,0,0,8,8
1668326723958,CSE 251B,A01,102392,Cottrell; Garrison W,0,0,0,0
1668326723958,CSE 251B,A02,102393,Cottrell; Garrison W,0,0,0,0
1668326724382,CSE 252B,A00,102394,Ochoa; Benjamin Lawrence,0,0,0,0
1668326724810,CSE 257,A01,102396,Gao; Sicun,0,0,0,0
1668326725241,CSE 272,A00,102397,Li; Tzumao,0,0,0,0
1668326725667,CSE 274,A00,111323,Chern; Albert Ren-Haur,0,0,0,0
1668326726094,CSE 282,A00,102398,Pevzner; Pavel Arkadjevich,0,0,0,0
1668326726518,CSE 284,A00,114175,Gymrek; Melissa Ann,0,0,0,0
1668326726941,CSE 290,A00,102399,Chandraker; Manmohan Krishna,0,0,0,0
1668326726941,CSE 290,B00,102400,Vaccaro; Kristen Marie,0,0,25,25
1668326726941,CSE 290,C00,102414,Pannuto; Patrick William,0,0,25,25
1668326726941,CSE 290,D00,102427,Pevzner; Pavel Arkadjevich,0,0,0,0
1668326726941,CSE 290,E00,102429,Zhao; Jishen,0,0,0,0
1668326726941,CSE 290,F00,102436,Tullsen; Dean Michael,0,0,0,0
1668326726941,CSE 290,G00,102440,Christensen; Henrik I,0,0,20,20
1668326727460,CSE 291,A00,102443,Su; Hao,0,0,0,0
1668326727460,CSE 291,B00,102448,Polikarpova; Nadezhda,0,0,0,0
1668326727460,CSE 291,C00,102453,Vaccaro; Kristen Marie,0,0,0,0
1668326727460,CSE 291,D00,111343,Savage; Stefan,0,0,0,0
1668326727460,CSE 291,E00,116474,Claffy; Kimberly Claire,0,0,0,0
1668326727460,CSE 291,F00,116479,Pasquale; Joseph,0,0,0,0
1668326727910,CSE 293,001,119111,Bafna; Vineet,9999,0,9999,0
1668326727910,CSE 293,002,119118,Bellare; Mihir,9999,0,9999,0
1668326727910,CSE 293,003,119122,Berg-Kirkpatrick; Taylor D,9999,0,9999,0
1668326727910,CSE 293,004,119135,Christensen; Henrik I,9999,0,9999,0
1668326727910,CSE 293,005,119142,Cottrell; Garrison W,9999,0,9999,0
1668326727910,CSE 293,006,119146,Deutsch; Alin Bernard,9999,0,9999,0
1668326727910,CSE 293,007,119159,Esmaeilzadeh; Hadi,9999,0,9999,0
1668326727910,CSE 293,008,119166,Freund; Yoav,9999,0,9999,0
1668326727910,CSE 293,009,119170,Griswold; William G.,9999,0,9999,0
1668326727910,CSE 293,010,119183,Gymrek; Melissa Ann,9999,0,9999,0
1668326727910,CSE 293,011,119190,Heninger; Nadia A,9999,0,9999,0
1668326727910,CSE 293,012,119230,Impagliazzo; Russell,9999,0,9999,0
1668326727910,CSE 293,013,119232,Jhala; Ranjit,9999,0,9999,0
1668326727910,CSE 293,014,119233,Kahng; Andrew Byun,9999,0,9999,0
1668326727910,CSE 293,015,119298,Kane; Daniel Mertz,9999,0,9999,0
1668326727910,CSE 293,016,119299,Kriegman; David J,9999,0,9999,0
1668326727910,CSE 293,017,119300,Kumar; Arun Kumar,9999,0,9999,0
1668326727910,CSE 293,018,119301,Lerner; Sorin,9999,0,9999,0
1668326727910,CSE 293,019,119302,Lovett; Shachar,9999,0,9999,0
1668326727910,CSE 293,020,119303,McAuley; Julian John,9999,0,9999,0
1668326727910,CSE 293,021,119304,Micciancio; Daniele,9999,0,9999,0
1668326727910,CSE 293,022,119367,Orailoglu; Alex,9999,0,9999,0
1668326727910,CSE 293,023,119382,Paturi; Ramamohan,9999,0,9999,0
1668326727910,CSE 293,024,119404,Polikarpova; Nadezhda,9999,0,9999,0
1668326727910,CSE 293,025,119406,Politz; Joseph Gibbs,9999,0,9999,0
1668326727910,CSE 293,026,119411,Porter; George M,9999,0,9999,0
1668326727910,CSE 293,027,119414,Porter; Leonard Emerson,9999,0,9999,0
1668326727910,CSE 293,028,119416,Ramamoorthi; Ravi,9999,0,9999,0
1668326727910,CSE 293,029,119417,Sahoo; Debashis,9999,0,9999,0
1668326727910,CSE 293,030,119420,Saul; Lawrence,9999,0,9999,0
1668326727910,CSE 293,031,119421,Savage; Stefan,9999,0,9999,0
1668326727910,CSE 293,032,119425,Schulze; Jurgen P.,9999,0,9999,0
1668326727910,CSE 293,033,119426,Snoeren; Alex C.,9999,0,9999,0
1668326727910,CSE 293,034,119428,Shang; Jingbo,9999,0,9999,0
1668326727910,CSE 293,035,119430,Stefan; Deian,9999,0,9999,0
1668326727910,CSE 293,036,119431,Su; Hao,9999,0,9999,0
1668326727910,CSE 293,037,119433,Swanson; Steven James,9999,0,9999,0
1668326727910,CSE 293,038,119435,Tullsen; Dean Michael,9999,0,9999,0
1668326727910,CSE 293,039,119483,Voelker; Geoffrey M.,9999,0,9999,0
1668326727910,CSE 293,040,119537,Zhao; Jishen,9999,0,9999,0
1668326727910,CSE 293,041,119538,Zhou; Yuan-Yuan,9999,0,9999,0
1668326727910,CSE 293,042,119539,Gao; Sicun,9999,0,9999,0
1668326727910,CSE 293,043,119540,Weibel; Nadir,9999,0,9999,0
1668326727910,CSE 293,044,119541,Gupta; Rajesh K.,9999,0,9999,0
1668326727910,CSE 293,045,126410,Vaccaro; Kristen Marie,9999,0,9999,0
1668326727910,CSE 293,046,126411,Klemke; Richard,9999,0,9999,0
1668326728335,CSE 294,A00,102459,Voelker; Geoffrey M.,0,0,0,0
1668326728335,CSE 294,B00,111322,Orailoglu; Alex,0,0,0,0
1668326728759,DSE 201,A00,096914,Deutsch; Alin Bernard,30,0,30,0
1668326729185,DSE 210,A00,096915,Dasgupta; Sanjoy,30,0,30,0
1668326729613,DSE 260A,A00,096916,Altintas De Callaf; Ilkay,30,0,30,0
1668326730052,ECE 200,001,103586,Antipa; Nicholas A,9999,0,9999,0
1668326730052,ECE 200,002,103587,Atanasov; Nikolay A.,9999,0,9999,0
1668326730052,ECE 200,003,103588,Bharadia; Dinesh,9999,0,9999,0
1668326730052,ECE 200,004,103589,Cheng; Chung Kuan,9999,0,9999,0
1668326730052,ECE 200,005,103590,Cosman; Pamela C.,9999,0,9999,0
1668326730052,ECE 200,006,103591,Dayeh; Shadi Ahmad,9999,0,9999,0
1668326730052,ECE 200,007,103592,Fainman; Yeshaiahu,9999,0,9999,0
1668326730052,ECE 200,008,103593,Ford; Joseph Earl,9999,0,9999,0
1668326730052,ECE 200,009,103594,Franceschetti; Massimo,9999,0,9999,0
1668326730052,ECE 200,010,103595,Fullerton; Eric E,9999,0,9999,0
1668326730052,ECE 200,011,103596,Galton; Ian A,9999,0,9999,0
1668326730052,ECE 200,012,103597,Gilja; Vikash,9999,0,9999,0
1668326730052,ECE 200,013,103598,Hall; Drew A.,9999,0,9999,0
1668326730052,ECE 200,014,103599,Hsueh; Tzu-Chien,9999,0,9999,0
1668326730052,ECE 200,015,103600,Javidi; Tara,9999,0,9999,0
1668326730052,ECE 200,016,103601,Kahng; Andrew Byun,9999,0,9999,0
1668326730052,ECE 200,017,103602,Kim; Young-Han,9999,0,9999,0
1668326730052,ECE 200,018,103603,Koushanfar; Farinaz,9999,0,9999,0
1668326730052,ECE 200,019,103604,Kuzum; Duygu,9999,0,9999,0
1668326730052,ECE 200,020,103605,Le; Hanh-Phuc,9999,0,9999,0
1668326730052,ECE 200,021,103606,Lin; Bill,9999,0,9999,0
1668326730052,ECE 200,022,103607,Liu; Zhaowei,9998,0,9999,1
1668326730052,ECE 200,023,103608,Lo; Yu-Hwa,9999,0,9999,0
1668326730052,ECE 200,024,103609,Lomakin; Vitaliy,9999,0,9999,0
1668326730052,ECE 200,025,103610,Mercier; Patrick Philip,9999,0,9999,0
1668326730052,ECE 200,026,103611,Meyer; Florian,9999,0,9999,0
1668326730052,ECE 200,027,103612,Milstein; Laurence B.,9999,0,9999,0
1668326730052,ECE 200,028,103613,Mir Arabbaygi; Siavash,9999,0,9999,0
1668326730052,ECE 200,029,103614,Mookherjea; Shayan,9999,0,9999,0
1668326730052,ECE 200,030,103615,Morris; Karcher William,9999,0,9999,0
1668326730052,ECE 200,031,103616,Ng; Tse Nga,9999,0,9999,0
1668326730052,ECE 200,032,103617,Nguyen; Truong Quang,9999,0,9999,0
1668326730052,ECE 200,033,103618,Nomura; Kenji,9999,0,9999,0
1668326730052,ECE 200,034,103619,Orlitsky; Alon,9999,0,9999,0
1668326730052,ECE 200,035,103620,Pal; Piya,9999,0,9999,0
1668326730052,ECE 200,036,103621,Papen; George C.,9999,0,9999,0
1668326730052,ECE 200,037,103622,Radic; Stojan,9999,0,9999,0
1668326730052,ECE 200,038,103623,Rao; Bhaskar D.,9999,0,9999,0
1668326730052,ECE 200,039,103624,Rao; Ramesh R,9999,0,9999,0
1668326730052,ECE 200,040,103625,Rebeiz; Gabriel,9999,0,9999,0
1668326730052,ECE 200,041,103626,Sanford; John R,9999,0,9999,0
1668326730052,ECE 200,042,103627,Siegel; Paul H.,9999,0,9999,0
1668326730052,ECE 200,043,103628,Sievenpiper; Daniel F.,9999,0,9999,0
1668326730052,ECE 200,044,103629,Sworder; David D.,9999,0,9999,0
1668326730052,ECE 200,045,103630,Taur; Yuan,9999,0,9999,0
1668326730052,ECE 200,046,103631,Touri; Behrouz,9999,0,9999,0
1668326730052,ECE 200,047,103632,Trivedi; Mohan M.,9999,0,9999,0
1668326730052,ECE 200,048,103633,Vasconcelos; Nuno,9999,0,9999,0
1668326730052,ECE 200,049,103634,Wang; Xiaolong,9999,0,9999,0
1668326730052,ECE 200,050,103635,Xie; Pengtao,9999,0,9999,0
1668326730052,ECE 200,051,103636,Yip; Michael,9999,0,9999,0
1668326730052,ECE 200,052,103637,Zeger; Kenneth A.,999,0,999,0
1668326730052,ECE 200,053,103638,Zhang; Xinyu,9999,0,9999,0
1668326730052,ECE 200,054,103639,Turakhia; Yatish Girish,9999,0,9999,0
1668326730052,ECE 200,055,103640,Kang; Mingu,9999,0,9999,0
1668326730052,ECE 200,056,103641,Shi; Yuanyuan,9999,0,9999,0
1668326730052,ECE 200,057,103642,Wang; Edward Jay,9999,0,9999,0
1668326730052,ECE 200,058,103643,Zheng; Yang,9999,0,9999,0
1668326730476,ECE 202,A00,103644,Kuzum; Duygu,0,0,0,0
1668326730898,ECE 212BN,A00,103646,Ng; Tse Nga,0,0,0,0
1668326731324,ECE 221,A00,111493,Staff,0,0,0,0
1668326731748,ECE 222B,A00,103647,Lomakin; Vitaliy,0,0,0,0
1668326732175,ECE 230B,A00,103648,Taur; Yuan,0,0,0,0
1668326732598,ECE 238B,A00,103649,Garay; Javier,0,0,0,0
1668326733027,ECE 240B,A00,112900,Fainman; Yeshaiahu,0,0,0,0
1668326733453,ECE 247A,A00,103650,Jokerst; Jesse Vincent,0,0,0,0
1668326733877,ECE 247B,A00,103651,Wang; Joseph,0,0,0,0
1668326734303,ECE 250,A00,103652,Siegel; Paul H.,0,0,0,0
1668326734727,ECE 251A,A00,103654,Rao; Bhaskar D.,0,0,0,0
1668326735152,ECE 257B,A00,103655,Bharadia; Dinesh,0,0,0,0
1668326735578,ECE 258A,A00,103656,Milstein; Laurence B.,0,0,0,0
1668326736006,ECE 260B,A00,103658,Kang; Mingu,0,0,0,0
1668326736428,ECE 264A,A00,103659,Galton; Ian A,0,0,0,0
1668326736852,ECE 265A,A00,103661,Gudem; Prasad S.S.,0,0,0,0
1668326737284,ECE 265D,A00,103662,Gudem; Prasad S.S.,0,0,0,0
1668326737712,ECE 268,A00,103663,Koushanfar; Farinaz,0,0,0,0
1668326738137,ECE 269,A01,103665,Pal; Piya,0,0,0,0
1668326738568,ECE 271B,A00,103666,Vasconcelos; Manuela,0,0,0,0
1668326738994,ECE 276A,A00,103667,Atanasov; Nikolay A.,0,0,0,0
1668326739418,ECE 277,A00,103668,An; Cheolhong,0,0,0,0
1668326739847,ECE 279,A00,117947,Hall; Drew A.,0,0,0,0
1668326740699,ECE 283,A00,103670,Hsueh; Tzu-Chien,0,0,0,0
1668326741125,ECE 284,A00,103671,Turakhia; Yatish Girish,0,0,0,0
1668326741554,ECE 285,A00,103672,Zheng; Yang,0,0,0,0
1668326741554,ECE 285,B00,103673,Sworder; David D.,0,0,0,0
1668326741978,ECE 287,A00,103676,Javidi; Tara,0,0,0,0
1668326742403,MATH 200B,A00,098023,Salehi Golsefidy; Alireza,12,0,15,3
1668326742827,MATH 202B,A00,098024,Rhoades; Brendon Patrick,9,0,15,6
1668326743250,MATH 203B,A00,098025,Oprea; Dragos N.,10,0,15,5
1668326743679,MATH 204B,A00,098026,Sorensen; Claus M,13,0,15,2
1668326744105,MATH 208,A00,098027,Izadi; Elham,7,0,10,3
1668326744530,MATH 209,A00,098028,Pollack; Aaron,10,0,10,0
1668326744956,MATH 211A,A00,112919,Rogalski; Daniel,9,0,10,1
1668326745379,MATH 211B,A00,112920,Seward; Brandon M.,9,0,10,1
1668326745805,MATH 218,A00,098029,Li; Bo,10,0,10,0
1668326746228,MATH 220B,A00,098030,Novak; Jonathan I,11,0,15,4
1668326746652,MATH 221A,A00,098031,Ebenfelt; Peter F,13,0,15,2
1668326747077,MATH 231B,A00,098032,Zlatos; Andrej,12,0,15,3
1668326747501,MATH 240B,A00,098033,Ni; Lei,9,0,15,6
1668326747927,MATH 243,A00,098034,Jekel; David Andrew,10,0,10,0
1668326748353,MATH 245A,A00,098035,Nie; Jiawang,0,0,15,16
1668326748783,MATH 248,A00,098036,Bejenaru; Ioan,10,0,10,0
1668326749208,MATH 250B,A00,098037,Spolaor; Luca,14,0,15,1
1668326749633,MATH 258,A00,098038,Ni; Lei,10,0,10,0
1668326750058,MATH 264B,A00,098041,Rhoades; Brendon Patrick,9,0,15,6
1668326750490,MATH 268,A00,098042,Buss; Samuel R,10,0,10,0
1668326750913,MATH 269,A00,098043,Rhoades; Brendon Patrick,10,0,10,0
1668326751340,MATH 270B,A00,098044,Li; Bo,10,0,15,5
1668326751763,MATH 272B,A00,098045,Holst; Michael J,13,0,15,2
1668326752188,MATH 273A,A00,098046,Tian; Xiaochuan,10,0,15,5
1668326752619,MATH 275,A01,098048,Tian; Xiaochuan,6,0,10,4
1668326753048,MATH 278A,A00,098049,Holst; Michael J,8,0,10,2
1668326753471,MATH 278B,A00,098050,Cloninger; Alexander,10,0,10,0
1668326753902,MATH 278C,A00,098051,Nie; Jiawang,7,0,10,3
1668326754328,MATH 280B,A00,098052,Zheng; Tianyi,8,0,15,7
1668326754754,MATH 281B,A00,098053,Bradic; Jelena,1,0,15,14
1668326755180,MATH 282B,A00,098054,Arias-Castro; Ery,0,0,15,15
1668326755605,MATH 285,A00,098055,Fitzsimmons; Patrick J,0,0,15,17
1668326756028,MATH 287B,A00,098056,Arias-Castro; Ery,2,0,15,13
1668326756454,MATH 288,A00,098057,Agarwal; Pooja,9,0,10,1
1668326756454,MATH 288,B00,098058,Zhang; Danna,8,0,10,2
1668326756454,MATH 288,C00,098059,Williams; Ruth J,9,0,10,1
1668326756876,MATH 290B,A00,098060,Roberts; Justin Deritter,13,0,15,2
1668326757299,MATH 292,A00,098061,Belmont; Eva Kinoshita,10,0,10,0
1668326757724,MATH 295,A00,098062,Suk; Andrew Hoon,48,0,50,2
1668326758152,MATH 296,A00,098063,Novak; Jonathan I,20,0,20,0
1668326758577,MATH 297,001,098064,Gamst; Anthony Collins,9997,0,9999,2
1668327258894,COGS 205,A00,101395,Chiba; Andrea,19,0,20,1
1668327259319,COGS 210B,001,101404,Greene; Deanna Jacquelyn,9998,0,9999,1
1668327259319,COGS 210B,002,101417,Xia; Haijun,9999,0,9999,0
1668327259319,COGS 210B,003,101422,Nitz; Douglas A.,9999,0,9999,0
1668327259319,COGS 210B,004,101423,Hollan; James D.,9998,0,9999,1
1668327259319,COGS 210B,005,101424,Deak; Gedeon O.,9998,0,9999,1
1668327259319,COGS 210B,006,101425,Rossano; Federico,9999,0,9999,0
1668327259748,COGS 211B,A00,101427,Coulson; Seana M,9996,0,9999,3
1668327260174,COGS 220,A00,101428,Hollan; James D.,0,0,25,25
1668327260600,COGS 229,A00,101429,Dow; Steven P,18,0,25,7
1668327261028,COGS 230,A00,101430,Klemmer; Scott R,11,0,17,6
1668327261453,COGS 234,A00,101431,Xia; Haijun,1,0,25,24
1668327261883,COGS 260,A00,101432,Kiyonaga; Anastasia,21,0,25,4
1668327261883,COGS 260,B00,101433,Kirsh; David Joel,15,0,25,10
1668327262306,CSE 202,A00,102371,Impagliazzo; Russell,0,0,0,0
1668327262732,CSE 203B,A01,102373,Cheng; Chung Kuan,0,0,0,0
1668327263160,CSE 208,A00,102374,Micciancio; Daniele,0,0,0,0
1668327263588,CSE 209A,A00,112895,Impagliazzo; Russell,0,0,15,15
1668327264015,CSE 209B,A00,108005,Bellare; Mihir,0,0,0,0
1668327264446,CSE 210,A00,113163,Coblenz; Michael J,0,0,0,0
1668327264870,CSE 219,A00,106111,Dow; Steven P,0,0,20,20
1668327265301,CSE 221,A00,102376,Voelker; Geoffrey M.,0,0,0,0
1668327265730,CSE 224,A01,102378,Porter; George M,0,0,0,0
1668327266158,CSE 229A,A00,102379,Savage; Stefan,0,0,0,0
1668327266587,CSE 229C,A00,102380,Munyaka; Imani N. S.,0,0,0,0
1668327267011,CSE 232B,A00,102382,Deutsch; Alin Bernard,0,0,0,0
1668327267434,CSE 234,A01,112904,Kumar; Arun Kumar,0,0,0,0
1668327267865,CSE 237A,A00,102383,Rosing; Tajana Simunic,0,0,0,0
1668327268290,CSE 239A,A00,102384,Deutsch; Alin Bernard,0,0,0,0
1668327268716,CSE 239B,A00,102385,Polikarpova; Nadezhda,0,0,0,0
1668327269145,CSE 240A,A00,102386,Pannuto; Patrick William,0,0,0,0
1668327269570,CSE 240B,A00,102387,Zhao; Jishen,0,0,0,0
1668327269999,CSE 241A,A00,106406,Kang; Mingu,0,0,0,0
1668327270428,CSE 249B,A00,102388,Kahng; Andrew Byun,0,0,8,8
1668327270860,CSE 251B,A01,102392,Cottrell; Garrison W,0,0,0,0
1668327270860,CSE 251B,A02,102393,Cottrell; Garrison W,0,0,0,0
1668327271286,CSE 252B,A00,102394,Ochoa; Benjamin Lawrence,0,0,0,0
1668327271711,CSE 257,A01,102396,Gao; Sicun,0,0,0,0
1668327272139,CSE 272,A00,102397,Li; Tzumao,0,0,0,0
1668327272567,CSE 274,A00,111323,Chern; Albert Ren-Haur,0,0,0,0
1668327272994,CSE 282,A00,102398,Pevzner; Pavel Arkadjevich,0,0,0,0
1668327273423,CSE 284,A00,114175,Gymrek; Melissa Ann,0,0,0,0
1668327273851,CSE 290,A00,102399,Chandraker; Manmohan Krishna,0,0,0,0
1668327273851,CSE 290,B00,102400,Vaccaro; Kristen Marie,0,0,25,25
1668327273851,CSE 290,C00,102414,Pannuto; Patrick William,0,0,25,25
1668327273851,CSE 290,D00,102427,Pevzner; Pavel Arkadjevich,0,0,0,0
1668327273851,CSE 290,E00,102429,Zhao; Jishen,0,0,0,0
1668327273851,CSE 290,F00,102436,Tullsen; Dean Michael,0,0,0,0
1668327273851,CSE 290,G00,102440,Christensen; Henrik I,0,0,20,20
1668327274287,CSE 291,A00,102443,Su; Hao,0,0,0,0
1668327274287,CSE 291,B00,102448,Polikarpova; Nadezhda,0,0,0,0
1668327274287,CSE 291,C00,102453,Vaccaro; Kristen Marie,0,0,0,0
1668327274287,CSE 291,D00,111343,Savage; Stefan,0,0,0,0
1668327274287,CSE 291,E00,116474,Claffy; Kimberly Claire,0,0,0,0
1668327274287,CSE 291,F00,116479,Pasquale; Joseph,0,0,0,0
1668327274722,CSE 293,001,119111,Bafna; Vineet,9999,0,9999,0
1668327274722,CSE 293,002,119118,Bellare; Mihir,9999,0,9999,0
1668327274722,CSE 293,003,119122,Berg-Kirkpatrick; Taylor D,9999,0,9999,0
1668327274722,CSE 293,004,119135,Christensen; Henrik I,9999,0,9999,0
1668327274722,CSE 293,005,119142,Cottrell; Garrison W,9999,0,9999,0
1668327274722,CSE 293,006,119146,Deutsch; Alin Bernard,9999,0,9999,0
1668327274722,CSE 293,007,119159,Esmaeilzadeh; Hadi,9999,0,9999,0
1668327274722,CSE 293,008,119166,Freund; Yoav,9999,0,9999,0
1668327274722,CSE 293,009,119170,Griswold; William G.,9999,0,9999,0
1668327274722,CSE 293,010,119183,Gymrek; Melissa Ann,9999,0,9999,0
1668327274722,CSE 293,011,119190,Heninger; Nadia A,9999,0,9999,0
1668327274722,CSE 293,012,119230,Impagliazzo; Russell,9999,0,9999,0
1668327274722,CSE 293,013,119232,Jhala; Ranjit,9999,0,9999,0
1668327274722,CSE 293,014,119233,Kahng; Andrew Byun,9999,0,9999,0
1668327274722,CSE 293,015,119298,Kane; Daniel Mertz,9999,0,9999,0
1668327274722,CSE 293,016,119299,Kriegman; David J,9999,0,9999,0
1668327274722,CSE 293,017,119300,Kumar; Arun Kumar,9999,0,9999,0
1668327274722,CSE 293,018,119301,Lerner; Sorin,9999,0,9999,0
1668327274722,CSE 293,019,119302,Lovett; Shachar,9999,0,9999,0
1668327274722,CSE 293,020,119303,McAuley; Julian John,9999,0,9999,0
1668327274722,CSE 293,021,119304,Micciancio; Daniele,9999,0,9999,0
1668327274722,CSE 293,022,119367,Orailoglu; Alex,9999,0,9999,0
1668327274722,CSE 293,023,119382,Paturi; Ramamohan,9999,0,9999,0
1668327274722,CSE 293,024,119404,Polikarpova; Nadezhda,9999,0,9999,0
1668327274722,CSE 293,025,119406,Politz; Joseph Gibbs,9999,0,9999,0
1668327274722,CSE 293,026,119411,Porter; George M,9999,0,9999,0
1668327274722,CSE 293,027,119414,Porter; Leonard Emerson,9999,0,9999,0
1668327274722,CSE 293,028,119416,Ramamoorthi; Ravi,9999,0,9999,0
1668327274722,CSE 293,029,119417,Sahoo; Debashis,9999,0,9999,0
1668327274722,CSE 293,030,119420,Saul; Lawrence,9999,0,9999,0
1668327274722,CSE 293,031,119421,Savage; Stefan,9999,0,9999,0
1668327274722,CSE 293,032,119425,Schulze; Jurgen P.,9999,0,9999,0
1668327274722,CSE 293,033,119426,Snoeren; Alex C.,9999,0,9999,0
1668327274722,CSE 293,034,119428,Shang; Jingbo,9999,0,9999,0
1668327274722,CSE 293,035,119430,Stefan; Deian,9999,0,9999,0
1668327274722,CSE 293,036,119431,Su; Hao,9999,0,9999,0
1668327274722,CSE 293,037,119433,Swanson; Steven James,9999,0,9999,0
1668327274722,CSE 293,038,119435,Tullsen; Dean Michael,9999,0,9999,0
1668327274722,CSE 293,039,119483,Voelker; Geoffrey M.,9999,0,9999,0
1668327274722,CSE 293,040,119537,Zhao; Jishen,9999,0,9999,0
1668327274722,CSE 293,041,119538,Zhou; Yuan-Yuan,9999,0,9999,0
1668327274722,CSE 293,042,119539,Gao; Sicun,9999,0,9999,0
1668327274722,CSE 293,043,119540,Weibel; Nadir,9999,0,9999,0
1668327274722,CSE 293,044,119541,Gupta; Rajesh K.,9999,0,9999,0
1668327274722,CSE 293,045,126410,Vaccaro; Kristen Marie,9999,0,9999,0
1668327274722,CSE 293,046,126411,Klemke; Richard,9999,0,9999,0
1668327275150,CSE 294,A00,102459,Voelker; Geoffrey M.,0,0,0,0
1668327275150,CSE 294,B00,111322,Orailoglu; Alex,0,0,0,0
1668327275581,DSE 201,A00,096914,Deutsch; Alin Bernard,30,0,30,0
1668327276007,DSE 210,A00,096915,Dasgupta; Sanjoy,30,0,30,0
1668327276432,DSE 260A,A00,096916,Altintas De Callaf; Ilkay,30,0,30,0
1668327276893,ECE 200,001,103586,Antipa; Nicholas A,9999,0,9999,0
1668327276893,ECE 200,002,103587,Atanasov; Nikolay A.,9999,0,9999,0
1668327276893,ECE 200,003,103588,Bharadia; Dinesh,9999,0,9999,0
1668327276893,ECE 200,004,103589,Cheng; Chung Kuan,9999,0,9999,0
1668327276893,ECE 200,005,103590,Cosman; Pamela C.,9999,0,9999,0
1668327276893,ECE 200,006,103591,Dayeh; Shadi Ahmad,9999,0,9999,0
1668327276893,ECE 200,007,103592,Fainman; Yeshaiahu,9999,0,9999,0
1668327276893,ECE 200,008,103593,Ford; Joseph Earl,9999,0,9999,0
1668327276893,ECE 200,009,103594,Franceschetti; Massimo,9999,0,9999,0
1668327276893,ECE 200,010,103595,Fullerton; Eric E,9999,0,9999,0
1668327276893,ECE 200,011,103596,Galton; Ian A,9999,0,9999,0
1668327276893,ECE 200,012,103597,Gilja; Vikash,9999,0,9999,0
1668327276893,ECE 200,013,103598,Hall; Drew A.,9999,0,9999,0
1668327276893,ECE 200,014,103599,Hsueh; Tzu-Chien,9999,0,9999,0
1668327276893,ECE 200,015,103600,Javidi; Tara,9999,0,9999,0
1668327276893,ECE 200,016,103601,Kahng; Andrew Byun,9999,0,9999,0
1668327276893,ECE 200,017,103602,Kim; Young-Han,9999,0,9999,0
1668327276893,ECE 200,018,103603,Koushanfar; Farinaz,9999,0,9999,0
1668327276893,ECE 200,019,103604,Kuzum; Duygu,9999,0,9999,0
1668327276893,ECE 200,020,103605,Le; Hanh-Phuc,9999,0,9999,0
1668327276893,ECE 200,021,103606,Lin; Bill,9999,0,9999,0
1668327276893,ECE 200,022,103607,Liu; Zhaowei,9998,0,9999,1
1668327276893,ECE 200,023,103608,Lo; Yu-Hwa,9999,0,9999,0
1668327276893,ECE 200,024,103609,Lomakin; Vitaliy,9999,0,9999,0
1668327276893,ECE 200,025,103610,Mercier; Patrick Philip,9999,0,9999,0
1668327276893,ECE 200,026,103611,Meyer; Florian,9999,0,9999,0
1668327276893,ECE 200,027,103612,Milstein; Laurence B.,9999,0,9999,0
1668327276893,ECE 200,028,103613,Mir Arabbaygi; Siavash,9999,0,9999,0
1668327276893,ECE 200,029,103614,Mookherjea; Shayan,9999,0,9999,0
1668327276893,ECE 200,030,103615,Morris; Karcher William,9999,0,9999,0
1668327276893,ECE 200,031,103616,Ng; Tse Nga,9999,0,9999,0
1668327276893,ECE 200,032,103617,Nguyen; Truong Quang,9999,0,9999,0
1668327276893,ECE 200,033,103618,Nomura; Kenji,9999,0,9999,0
1668327276893,ECE 200,034,103619,Orlitsky; Alon,9999,0,9999,0
1668327276893,ECE 200,035,103620,Pal; Piya,9999,0,9999,0
1668327276893,ECE 200,036,103621,Papen; George C.,9999,0,9999,0
1668327276893,ECE 200,037,103622,Radic; Stojan,9999,0,9999,0
1668327276893,ECE 200,038,103623,Rao; Bhaskar D.,9999,0,9999,0
1668327276893,ECE 200,039,103624,Rao; Ramesh R,9999,0,9999,0
1668327276893,ECE 200,040,103625,Rebeiz; Gabriel,9999,0,9999,0
1668327276893,ECE 200,041,103626,Sanford; John R,9999,0,9999,0
1668327276893,ECE 200,042,103627,Siegel; Paul H.,9999,0,9999,0
1668327276893,ECE 200,043,103628,Sievenpiper; Daniel F.,9999,0,9999,0
1668327276893,ECE 200,044,103629,Sworder; David D.,9999,0,9999,0
1668327276893,ECE 200,045,103630,Taur; Yuan,9999,0,9999,0
1668327276893,ECE 200,046,103631,Touri; Behrouz,9999,0,9999,0
1668327276893,ECE 200,047,103632,Trivedi; Mohan M.,9999,0,9999,0
1668327276893,ECE 200,048,103633,Vasconcelos; Nuno,9999,0,9999,0
1668327276893,ECE 200,049,103634,Wang; Xiaolong,9999,0,9999,0
1668327276893,ECE 200,050,103635,Xie; Pengtao,9999,0,9999,0
1668327276893,ECE 200,051,103636,Yip; Michael,9999,0,9999,0
1668327276893,ECE 200,052,103637,Zeger; Kenneth A.,999,0,999,0
1668327276893,ECE 200,053,103638,Zhang; Xinyu,9999,0,9999,0
1668327276893,ECE 200,054,103639,Turakhia; Yatish Girish,9999,0,9999,0
1668327276893,ECE 200,055,103640,Kang; Mingu,9999,0,9999,0
1668327276893,ECE 200,056,103641,Shi; Yuanyuan,9999,0,9999,0
1668327276893,ECE 200,057,103642,Wang; Edward Jay,9999,0,9999,0
1668327276893,ECE 200,058,103643,Zheng; Yang,9999,0,9999,0
1668327277318,ECE 202,A00,103644,Kuzum; Duygu,0,0,0,0
1668327277752,ECE 212BN,A00,103646,Ng; Tse Nga,0,0,0,0
1668327278185,ECE 221,A00,111493,Staff,0,0,0,0
1668327278610,ECE 222B,A00,103647,Lomakin; Vitaliy,0,0,0,0
1668327279037,ECE 230B,A00,103648,Taur; Yuan,0,0,0,0
1668327279464,ECE 238B,A00,103649,Garay; Javier,0,0,0,0
1668327279890,ECE 240B,A00,112900,Fainman; Yeshaiahu,0,0,0,0
1668327280314,ECE 247A,A00,103650,Jokerst; Jesse Vincent,0,0,0,0
1668327280743,ECE 247B,A00,103651,Wang; Joseph,0,0,0,0
1668327281168,ECE 250,A00,103652,Siegel; Paul H.,0,0,0,0
1668327281597,ECE 251A,A00,103654,Rao; Bhaskar D.,0,0,0,0
1668327282031,ECE 257B,A00,103655,Bharadia; Dinesh,0,0,0,0
1668327282457,ECE 258A,A00,103656,Milstein; Laurence B.,0,0,0,0
1668327282885,ECE 260B,A00,103658,Kang; Mingu,0,0,0,0
1668327283312,ECE 264A,A00,103659,Galton; Ian A,0,0,0,0
1668327283736,ECE 265A,A00,103661,Gudem; Prasad S.S.,0,0,0,0
1668327284165,ECE 265D,A00,103662,Gudem; Prasad S.S.,0,0,0,0
1668327284590,ECE 268,A00,103663,Koushanfar; Farinaz,0,0,0,0
1668327285031,ECE 269,A01,103665,Pal; Piya,0,0,0,0
1668327285460,ECE 271B,A00,103666,Vasconcelos; Manuela,0,0,0,0
1668327285888,ECE 276A,A00,103667,Atanasov; Nikolay A.,0,0,0,0
1668327286315,ECE 277,A00,103668,An; Cheolhong,0,0,0,0
1668327286740,ECE 279,A00,117947,Hall; Drew A.,0,0,0,0
1668327287590,ECE 283,A00,103670,Hsueh; Tzu-Chien,0,0,0,0
1668327288019,ECE 284,A00,103671,Turakhia; Yatish Girish,0,0,0,0
1668327288451,ECE 285,A00,103672,Zheng; Yang,0,0,0,0
1668327288451,ECE 285,B00,103673,Sworder; David D.,0,0,0,0
1668327288878,ECE 287,A00,103676,Javidi; Tara,0,0,0,0
1668327289307,MATH 200B,A00,098023,Salehi Golsefidy; Alireza,12,0,15,3
1668327289735,MATH 202B,A00,098024,Rhoades; Brendon Patrick,9,0,15,6
1668327290168,MATH 203B,A00,098025,Oprea; Dragos N.,10,0,15,5
1668327290592,MATH 204B,A00,098026,Sorensen; Claus M,13,0,15,2
1668327291101,MATH 208,A00,098027,Izadi; Elham,7,0,10,3
1668327291529,MATH 209,A00,098028,Pollack; Aaron,10,0,10,0
1668327291954,MATH 211A,A00,112919,Rogalski; Daniel,9,0,10,1
1668327292380,MATH 211B,A00,112920,Seward; Brandon M.,9,0,10,1
1668327292811,MATH 218,A00,098029,Li; Bo,10,0,10,0
1668327293242,MATH 220B,A00,098030,Novak; Jonathan I,11,0,15,4
1668327293670,MATH 221A,A00,098031,Ebenfelt; Peter F,13,0,15,2
1668327294094,MATH 231B,A00,098032,Zlatos; Andrej,12,0,15,3
1668327294522,MATH 240B,A00,098033,Ni; Lei,9,0,15,6
1668327294948,MATH 243,A00,098034,Jekel; David Andrew,10,0,10,0
1668327295375,MATH 245A,A00,098035,Nie; Jiawang,0,0,15,16
1668327295802,MATH 248,A00,098036,Bejenaru; Ioan,10,0,10,0
1668327296228,MATH 250B,A00,098037,Spolaor; Luca,14,0,15,1
1668327296659,MATH 258,A00,098038,Ni; Lei,10,0,10,0
1668327297083,MATH 264B,A00,098041,Rhoades; Brendon Patrick,9,0,15,6
1668327297514,MATH 268,A00,098042,Buss; Samuel R,10,0,10,0
1668327297940,MATH 269,A00,098043,Rhoades; Brendon Patrick,10,0,10,0
1668327298366,MATH 270B,A00,098044,Li; Bo,10,0,15,5
1668327298793,MATH 272B,A00,098045,Holst; Michael J,13,0,15,2
1668327299223,MATH 273A,A00,098046,Tian; Xiaochuan,10,0,15,5
1668327299650,MATH 275,A01,098048,Tian; Xiaochuan,6,0,10,4
1668327300073,MATH 278A,A00,098049,Holst; Michael J,8,0,10,2
1668327300501,MATH 278B,A00,098050,Cloninger; Alexander,10,0,10,0
1668327300929,MATH 278C,A00,098051,Nie; Jiawang,7,0,10,3
1668327301355,MATH 280B,A00,098052,Zheng; Tianyi,8,0,15,7
1668327301789,MATH 281B,A00,098053,Bradic; Jelena,1,0,15,14
1668327302219,MATH 282B,A00,098054,Arias-Castro; Ery,0,0,15,15
1668327302643,MATH 285,A00,098055,Fitzsimmons; Patrick J,0,0,15,17
1668327303070,MATH 287B,A00,098056,Arias-Castro; Ery,2,0,15,13
1668327303497,MATH 288,A00,098057,Agarwal; Pooja,9,0,10,1
1668327303497,MATH 288,B00,098058,Zhang; Danna,8,0,10,2
1668327303497,MATH 288,C00,098059,Williams; Ruth J,9,0,10,1
1668327303922,MATH 290B,A00,098060,Roberts; Justin Deritter,13,0,15,2
1668327304347,MATH 292,A00,098061,Belmont; Eva Kinoshita,10,0,10,0
1668327304775,MATH 295,A00,098062,Suk; Andrew Hoon,48,0,50,2
1668327305202,MATH 296,A00,098063,Novak; Jonathan I,20,0,20,0
1668327305627,MATH 297,001,098064,Gamst; Anthony Collins,9997,0,9999,2
1668327806926,COGS 205,A00,101395,Chiba; Andrea,19,0,20,1
1668327807354,COGS 210B,001,101404,Greene; Deanna Jacquelyn,9998,0,9999,1
1668327807354,COGS 210B,002,101417,Xia; Haijun,9999,0,9999,0
1668327807354,COGS 210B,003,101422,Nitz; Douglas A.,9999,0,9999,0
1668327807354,COGS 210B,004,101423,Hollan; James D.,9998,0,9999,1
1668327807354,COGS 210B,005,101424,Deak; Gedeon O.,9998,0,9999,1
1668327807354,COGS 210B,006,101425,Rossano; Federico,9999,0,9999,0
1668327807780,COGS 211B,A00,101427,Coulson; Seana M,9996,0,9999,3
1668327808206,COGS 220,A00,101428,Hollan; James D.,0,0,25,25
1668327808631,COGS 229,A00,101429,Dow; Steven P,18,0,25,7
1668327809057,COGS 230,A00,101430,Klemmer; Scott R,11,0,17,6
1668327809482,COGS 234,A00,101431,Xia; Haijun,1,0,25,24
1668327809916,COGS 260,A00,101432,Kiyonaga; Anastasia,21,0,25,4
1668327809916,COGS 260,B00,101433,Kirsh; David Joel,15,0,25,10
1668327810346,CSE 202,A00,102371,Impagliazzo; Russell,0,0,0,0
1668327810770,CSE 203B,A01,102373,Cheng; Chung Kuan,0,0,0,0
1668327811193,CSE 208,A00,102374,Micciancio; Daniele,0,0,0,0
1668327811622,CSE 209A,A00,112895,Impagliazzo; Russell,0,0,15,15
1668327812050,CSE 209B,A00,108005,Bellare; Mihir,0,0,0,0
1668327812548,CSE 210,A00,113163,Coblenz; Michael J,0,0,0,0
1668327812976,CSE 219,A00,106111,Dow; Steven P,0,0,20,20
1668327813407,CSE 221,A00,102376,Voelker; Geoffrey M.,0,0,0,0
1668327813834,CSE 224,A01,102378,Porter; George M,0,0,0,0
1668327814259,CSE 229A,A00,102379,Savage; Stefan,0,0,0,0
1668327814684,CSE 229C,A00,102380,Munyaka; Imani N. S.,0,0,0,0
1668327815109,CSE 232B,A00,102382,Deutsch; Alin Bernard,0,0,0,0
1668327815540,CSE 234,A01,112904,Kumar; Arun Kumar,0,0,0,0
1668327815967,CSE 237A,A00,102383,Rosing; Tajana Simunic,0,0,0,0
1668327816392,CSE 239A,A00,102384,Deutsch; Alin Bernard,0,0,0,0
1668327816817,CSE 239B,A00,102385,Polikarpova; Nadezhda,0,0,0,0
1668327817242,CSE 240A,A00,102386,Pannuto; Patrick William,0,0,0,0
1668327817665,CSE 240B,A00,102387,Zhao; Jishen,0,0,0,0
1668327818091,CSE 241A,A00,106406,Kang; Mingu,0,0,0,0
1668327818516,CSE 249B,A00,102388,Kahng; Andrew Byun,0,0,8,8
1668327818941,CSE 251B,A01,102392,Cottrell; Garrison W,0,0,0,0
1668327818941,CSE 251B,A02,102393,Cottrell; Garrison W,0,0,0,0
1668327819365,CSE 252B,A00,102394,Ochoa; Benjamin Lawrence,0,0,0,0
1668327819797,CSE 257,A01,102396,Gao; Sicun,0,0,0,0
1668327820221,CSE 272,A00,102397,Li; Tzumao,0,0,0,0
1668327820653,CSE 274,A00,111323,Chern; Albert Ren-Haur,0,0,0,0
1668327821079,CSE 282,A00,102398,Pevzner; Pavel Arkadjevich,0,0,0,0
1668327821511,CSE 284,A00,114175,Gymrek; Melissa Ann,0,0,0,0
1668327821940,CSE 290,A00,102399,Chandraker; Manmohan Krishna,0,0,0,0
1668327821940,CSE 290,B00,102400,Vaccaro; Kristen Marie,0,0,25,25
1668327821940,CSE 290,C00,102414,Pannuto; Patrick William,0,0,25,25
1668327821940,CSE 290,D00,102427,Pevzner; Pavel Arkadjevich,0,0,0,0
1668327821940,CSE 290,E00,102429,Zhao; Jishen,0,0,0,0
1668327821940,CSE 290,F00,102436,Tullsen; Dean Michael,0,0,0,0
1668327821940,CSE 290,G00,102440,Christensen; Henrik I,0,0,20,20
1668327822372,CSE 291,A00,102443,Su; Hao,0,0,0,0
1668327822372,CSE 291,B00,102448,Polikarpova; Nadezhda,0,0,0,0
1668327822372,CSE 291,C00,102453,Vaccaro; Kristen Marie,0,0,0,0
1668327822372,CSE 291,D00,111343,Savage; Stefan,0,0,0,0
1668327822372,CSE 291,E00,116474,Claffy; Kimberly Claire,0,0,0,0
1668327822372,CSE 291,F00,116479,Pasquale; Joseph,0,0,0,0
1668327822802,CSE 293,001,119111,Bafna; Vineet,9999,0,9999,0
1668327822802,CSE 293,002,119118,Bellare; Mihir,9999,0,9999,0
1668327822802,CSE 293,003,119122,Berg-Kirkpatrick; Taylor D,9999,0,9999,0
1668327822802,CSE 293,004,119135,Christensen; Henrik I,9999,0,9999,0
1668327822802,CSE 293,005,119142,Cottrell; Garrison W,9999,0,9999,0
1668327822802,CSE 293,006,119146,Deutsch; Alin Bernard,9999,0,9999,0
1668327822802,CSE 293,007,119159,Esmaeilzadeh; Hadi,9999,0,9999,0
1668327822802,CSE 293,008,119166,Freund; Yoav,9999,0,9999,0
1668327822802,CSE 293,009,119170,Griswold; William G.,9999,0,9999,0
1668327822802,CSE 293,010,119183,Gymrek; Melissa Ann,9999,0,9999,0
1668327822802,CSE 293,011,119190,Heninger; Nadia A,9999,0,9999,0
1668327822802,CSE 293,012,119230,Impagliazzo; Russell,9999,0,9999,0
1668327822802,CSE 293,013,119232,Jhala; Ranjit,9999,0,9999,0
1668327822802,CSE 293,014,119233,Kahng; Andrew Byun,9999,0,9999,0
1668327822802,CSE 293,015,119298,Kane; Daniel Mertz,9999,0,9999,0
1668327822802,CSE 293,016,119299,Kriegman; David J,9999,0,9999,0
1668327822802,CSE 293,017,119300,Kumar; Arun Kumar,9999,0,9999,0
1668327822802,CSE 293,018,119301,Lerner; Sorin,9999,0,9999,0
1668327822802,CSE 293,019,119302,Lovett; Shachar,9999,0,9999,0
1668327822802,CSE 293,020,119303,McAuley; Julian John,9999,0,9999,0
1668327822802,CSE 293,021,119304,Micciancio; Daniele,9999,0,9999,0
1668327822802,CSE 293,022,119367,Orailoglu; Alex,9999,0,9999,0
1668327822802,CSE 293,023,119382,Paturi; Ramamohan,9999,0,9999,0
1668327822802,CSE 293,024,119404,Polikarpova; Nadezhda,9999,0,9999,0
1668327822802,CSE 293,025,119406,Politz; Joseph Gibbs,9999,0,9999,0
1668327822802,CSE 293,026,119411,Porter; George M,9999,0,9999,0
1668327822802,CSE 293,027,119414,Porter; Leonard Emerson,9999,0,9999,0
1668327822802,CSE 293,028,119416,Ramamoorthi; Ravi,9999,0,9999,0
1668327822802,CSE 293,029,119417,Sahoo; Debashis,9999,0,9999,0
1668327822802,CSE 293,030,119420,Saul; Lawrence,9999,0,9999,0
1668327822802,CSE 293,031,119421,Savage; Stefan,9999,0,9999,0
1668327822802,CSE 293,032,119425,Schulze; Jurgen P.,9999,0,9999,0
1668327822802,CSE 293,033,119426,Snoeren; Alex C.,9999,0,9999,0
1668327822802,CSE 293,034,119428,Shang; Jingbo,9999,0,9999,0
1668327822802,CSE 293,035,119430,Stefan; Deian,9999,0,9999,0
1668327822802,CSE 293,036,119431,Su; Hao,9999,0,9999,0
1668327822802,CSE 293,037,119433,Swanson; Steven James,9999,0,9999,0
1668327822802,CSE 293,038,119435,Tullsen; Dean Michael,9999,0,9999,0
1668327822802,CSE 293,039,119483,Voelker; Geoffrey M.,9999,0,9999,0
1668327822802,CSE 293,040,119537,Zhao; Jishen,9999,0,9999,0
1668327822802,CSE 293,041,119538,Zhou; Yuan-Yuan,9999,0,9999,0
1668327822802,CSE 293,042,119539,Gao; Sicun,9999,0,9999,0
1668327822802,CSE 293,043,119540,Weibel; Nadir,9999,0,9999,0
1668327822802,CSE 293,044,119541,Gupta; Rajesh K.,9999,0,9999,0
1668327822802,CSE 293,045,126410,Vaccaro; Kristen Marie,9999,0,9999,0
1668327822802,CSE 293,046,126411,Klemke; Richard,9999,0,9999,0
1668327823226,CSE 294,A00,102459,Voelker; Geoffrey M.,0,0,0,0
1668327823226,CSE 294,B00,111322,Orailoglu; Alex,0,0,0,0
1668327823651,DSE 201,A00,096914,Deutsch; Alin Bernard,30,0,30,0
1668327824080,DSE 210,A00,096915,Dasgupta; Sanjoy,30,0,30,0
1668327824508,DSE 260A,A00,096916,Altintas De Callaf; Ilkay,30,0,30,0
1668327824946,ECE 200,001,103586,Antipa; Nicholas A,9999,0,9999,0
1668327824946,ECE 200,002,103587,Atanasov; Nikolay A.,9999,0,9999,0
1668327824946,ECE 200,003,103588,Bharadia; Dinesh,9999,0,9999,0
1668327824946,ECE 200,004,103589,Cheng; Chung Kuan,9999,0,9999,0
1668327824946,ECE 200,005,103590,Cosman; Pamela C.,9999,0,9999,0
1668327824946,ECE 200,006,103591,Dayeh; Shadi Ahmad,9999,0,9999,0
1668327824946,ECE 200,007,103592,Fainman; Yeshaiahu,9999,0,9999,0
1668327824946,ECE 200,008,103593,Ford; Joseph Earl,9999,0,9999,0
1668327824946,ECE 200,009,103594,Franceschetti; Massimo,9999,0,9999,0
1668327824946,ECE 200,010,103595,Fullerton; Eric E,9999,0,9999,0
1668327824946,ECE 200,011,103596,Galton; Ian A,9999,0,9999,0
1668327824946,ECE 200,012,103597,Gilja; Vikash,9999,0,9999,0
1668327824946,ECE 200,013,103598,Hall; Drew A.,9999,0,9999,0
1668327824946,ECE 200,014,103599,Hsueh; Tzu-Chien,9999,0,9999,0
1668327824946,ECE 200,015,103600,Javidi; Tara,9999,0,9999,0
1668327824946,ECE 200,016,103601,Kahng; Andrew Byun,9999,0,9999,0
1668327824946,ECE 200,017,103602,Kim; Young-Han,9999,0,9999,0
1668327824946,ECE 200,018,103603,Koushanfar; Farinaz,9999,0,9999,0
1668327824946,ECE 200,019,103604,Kuzum; Duygu,9999,0,9999,0
1668327824946,ECE 200,020,103605,Le; Hanh-Phuc,9999,0,9999,0
1668327824946,ECE 200,021,103606,Lin; Bill,9999,0,9999,0
1668327824946,ECE 200,022,103607,Liu; Zhaowei,9998,0,9999,1
1668327824946,ECE 200,023,103608,Lo; Yu-Hwa,9999,0,9999,0
1668327824946,ECE 200,024,103609,Lomakin; Vitaliy,9999,0,9999,0
1668327824946,ECE 200,025,103610,Mercier; Patrick Philip,9999,0,9999,0
1668327824946,ECE 200,026,103611,Meyer; Florian,9999,0,9999,0
1668327824946,ECE 200,027,103612,Milstein; Laurence B.,9999,0,9999,0
1668327824946,ECE 200,028,103613,Mir Arabbaygi; Siavash,9999,0,9999,0
1668327824946,ECE 200,029,103614,Mookherjea; Shayan,9999,0,9999,0
1668327824946,ECE 200,030,103615,Morris; Karcher William,9999,0,9999,0
1668327824946,ECE 200,031,103616,Ng; Tse Nga,9999,0,9999,0
1668327824946,ECE 200,032,103617,Nguyen; Truong Quang,9999,0,9999,0
1668327824946,ECE 200,033,103618,Nomura; Kenji,9999,0,9999,0
1668327824946,ECE 200,034,103619,Orlitsky; Alon,9999,0,9999,0
1668327824946,ECE 200,035,103620,Pal; Piya,9999,0,9999,0
1668327824946,ECE 200,036,103621,Papen; George C.,9999,0,9999,0
1668327824946,ECE 200,037,103622,Radic; Stojan,9999,0,9999,0
1668327824946,ECE 200,038,103623,Rao; Bhaskar D.,9999,0,9999,0
1668327824946,ECE 200,039,103624,Rao; Ramesh R,9999,0,9999,0
1668327824946,ECE 200,040,103625,Rebeiz; Gabriel,9999,0,9999,0
1668327824946,ECE 200,041,103626,Sanford; John R,9999,0,9999,0
1668327824946,ECE 200,042,103627,Siegel; Paul H.,9999,0,9999,0
1668327824946,ECE 200,043,103628,Sievenpiper; Daniel F.,9999,0,9999,0
1668327824946,ECE 200,044,103629,Sworder; David D.,9999,0,9999,0
1668327824946,ECE 200,045,103630,Taur; Yuan,9999,0,9999,0
1668327824946,ECE 200,046,103631,Touri; Behrouz,9999,0,9999,0
1668327824946,ECE 200,047,103632,Trivedi; Mohan M.,9999,0,9999,0
1668327824946,ECE 200,048,103633,Vasconcelos; Nuno,9999,0,9999,0
1668327824946,ECE 200,049,103634,Wang; Xiaolong,9999,0,9999,0
1668327824946,ECE 200,050,103635,Xie; Pengtao,9999,0,9999,0
1668327824946,ECE 200,051,103636,Yip; Michael,9999,0,9999,0
1668327824946,ECE 200,052,103637,Zeger; Kenneth A.,999,0,999,0
1668327824946,ECE 200,053,103638,Zhang; Xinyu,9999,0,9999,0
1668327824946,ECE 200,054,103639,Turakhia; Yatish Girish,9999,0,9999,0
1668327824946,ECE 200,055,103640,Kang; Mingu,9999,0,9999,0
1668327824946,ECE 200,056,103641,Shi; Yuanyuan,9999,0,9999,0
1668327824946,ECE 200,057,103642,Wang; Edward Jay,9999,0,9999,0
1668327824946,ECE 200,058,103643,Zheng; Yang,9999,0,9999,0
1668327825372,ECE 202,A00,103644,Kuzum; Duygu,0,0,0,0
1668327825807,ECE 212BN,A00,103646,Ng; Tse Nga,0,0,0,0
1668327826228,ECE 221,A00,111493,Staff,0,0,0,0
1668327826660,ECE 222B,A00,103647,Lomakin; Vitaliy,0,0,0,0
1668327827084,ECE 230B,A00,103648,Taur; Yuan,0,0,0,0
1668327827507,ECE 238B,A00,103649,Garay; Javier,0,0,0,0
1668327827933,ECE 240B,A00,112900,Fainman; Yeshaiahu,0,0,0,0
1668327828357,ECE 247A,A00,103650,Jokerst; Jesse Vincent,0,0,0,0
1668327828782,ECE 247B,A00,103651,Wang; Joseph,0,0,0,0
1668327829211,ECE 250,A00,103652,Siegel; Paul H.,0,0,0,0
1668327829636,ECE 251A,A00,103654,Rao; Bhaskar D.,0,0,0,0
1668327830061,ECE 257B,A00,103655,Bharadia; Dinesh,0,0,0,0
1668327830484,ECE 258A,A00,103656,Milstein; Laurence B.,0,0,0,0
1668327830909,ECE 260B,A00,103658,Kang; Mingu,0,0,0,0
1668327831342,ECE 264A,A00,103659,Galton; Ian A,0,0,0,0
1668327831778,ECE 265A,A00,103661,Gudem; Prasad S.S.,0,0,0,0
1668327832214,ECE 265D,A00,103662,Gudem; Prasad S.S.,0,0,0,0
1668327832639,ECE 268,A00,103663,Koushanfar; Farinaz,0,0,0,0
1668327833069,ECE 269,A01,103665,Pal; Piya,0,0,0,0
1668327833494,ECE 271B,A00,103666,Vasconcelos; Manuela,0,0,0,0
1668327833920,ECE 276A,A00,103667,Atanasov; Nikolay A.,0,0,0,0
1668327834347,ECE 277,A00,103668,An; Cheolhong,0,0,0,0
1668327834770,ECE 279,A00,117947,Hall; Drew A.,0,0,0,0
1668327835620,ECE 283,A00,103670,Hsueh; Tzu-Chien,0,0,0,0
1668327836046,ECE 284,A00,103671,Turakhia; Yatish Girish,0,0,0,0
1668327836479,ECE 285,A00,103672,Zheng; Yang,0,0,0,0
1668327836479,ECE 285,B00,103673,Sworder; David D.,0,0,0,0
1668327836905,ECE 287,A00,103676,Javidi; Tara,0,0,0,0
1668327837330,MATH 200B,A00,098023,Salehi Golsefidy; Alireza,12,0,15,3
1668327837754,MATH 202B,A00,098024,Rhoades; Brendon Patrick,9,0,15,6
1668327838179,MATH 203B,A00,098025,Oprea; Dragos N.,10,0,15,5
1668327838604,MATH 204B,A00,098026,Sorensen; Claus M,13,0,15,2
1668327839032,MATH 208,A00,098027,Izadi; Elham,7,0,10,3
1668327839459,MATH 209,A00,098028,Pollack; Aaron,10,0,10,0
1668327839881,MATH 211A,A00,112919,Rogalski; Daniel,9,0,10,1
1668327840304,MATH 211B,A00,112920,Seward; Brandon M.,9,0,10,1
1668327840727,MATH 218,A00,098029,Li; Bo,10,0,10,0
1668327841153,MATH 220B,A00,098030,Novak; Jonathan I,11,0,15,4
1668327841579,MATH 221A,A00,098031,Ebenfelt; Peter F,13,0,15,2
1668327842003,MATH 231B,A00,098032,Zlatos; Andrej,12,0,15,3
1668327842427,MATH 240B,A00,098033,Ni; Lei,9,0,15,6
1668327842850,MATH 243,A00,098034,Jekel; David Andrew,10,0,10,0
1668327843274,MATH 245A,A00,098035,Nie; Jiawang,0,0,15,16
1668327843700,MATH 248,A00,098036,Bejenaru; Ioan,10,0,10,0
1668327844132,MATH 250B,A00,098037,Spolaor; Luca,14,0,15,1
1668327844560,MATH 258,A00,098038,Ni; Lei,10,0,10,0
1668327844989,MATH 264B,A00,098041,Rhoades; Brendon Patrick,9,0,15,6
1668327845413,MATH 268,A00,098042,Buss; Samuel R,10,0,10,0
1668327845837,MATH 269,A00,098043,Rhoades; Brendon Patrick,10,0,10,0
1668327846261,MATH 270B,A00,098044,Li; Bo,10,0,15,5
1668327846687,MATH 272B,A00,098045,Holst; Michael J,13,0,15,2
1668327847122,MATH 273A,A00,098046,Tian; Xiaochuan,10,0,15,5
1668327847550,MATH 275,A01,098048,Tian; Xiaochuan,6,0,10,4
1668327847973,MATH 278A,A00,098049,Holst; Michael J,8,0,10,2
1668327848396,MATH 278B,A00,098050,Cloninger; Alexander,10,0,10,0
1668327848823,MATH 278C,A00,098051,Nie; Jiawang,7,0,10,3
1668327849251,MATH 280B,A00,098052,Zheng; Tianyi,8,0,15,7
1668327849678,MATH 281B,A00,098053,Bradic; Jelena,1,0,15,14
1668327850104,MATH 282B,A00,098054,Arias-Castro; Ery,0,0,15,15
1668327850528,MATH 285,A00,098055,Fitzsimmons; Patrick J,0,0,15,17
1668327850953,MATH 287B,A00,098056,Arias-Castro; Ery,2,0,15,13
1668327851387,MATH 288,A00,098057,Agarwal; Pooja,9,0,10,1
1668327851387,MATH 288,B00,098058,Zhang; Danna,8,0,10,2
1668327851387,MATH 288,C00,098059,Williams; Ruth J,9,0,10,1
1668327851814,MATH 290B,A00,098060,Roberts; Justin Deritter,13,0,15,2
1668327852236,MATH 292,A00,098061,Belmont; Eva Kinoshita,10,0,10,0
1668327852664,MATH 295,A00,098062,Suk; Andrew Hoon,48,0,50,2
1668327853089,MATH 296,A00,098063,Novak; Jonathan I,20,0,20,0
1668327853514,MATH 297,001,098064,Gamst; Anthony Collins,9997,0,9999,2
1668328353584,COGS 205,A00,101395,Chiba; Andrea,19,0,20,1
1668328354017,COGS 210B,001,101404,Greene; Deanna Jacquelyn,9998,0,9999,1
1668328354017,COGS 210B,002,101417,Xia; Haijun,9999,0,9999,0
1668328354017,COGS 210B,003,101422,Nitz; Douglas A.,9999,0,9999,0
1668328354017,COGS 210B,004,101423,Hollan; James D.,9998,0,9999,1
1668328354017,COGS 210B,005,101424,Deak; Gedeon O.,9998,0,9999,1
1668328354017,COGS 210B,006,101425,Rossano; Federico,9999,0,9999,0
1668328354443,COGS 211B,A00,101427,Coulson; Seana M,9996,0,9999,3
1668328354867,COGS 220,A00,101428,Hollan; James D.,0,0,25,25
1668328355304,COGS 229,A00,101429,Dow; Steven P,18,0,25,7
1668328355732,COGS 230,A00,101430,Klemmer; Scott R,11,0,17,6
1668328356156,COGS 234,A00,101431,Xia; Haijun,1,0,25,24
1668328356581,COGS 260,A00,101432,Kiyonaga; Anastasia,21,0,25,4
1668328356581,COGS 260,B00,101433,Kirsh; David Joel,15,0,25,10
1668328357006,CSE 202,A00,102371,Impagliazzo; Russell,0,0,0,0
1668328357445,CSE 203B,A01,102373,Cheng; Chung Kuan,0,0,0,0
1668328357871,CSE 208,A00,102374,Micciancio; Daniele,0,0,0,0
1668328358295,CSE 209A,A00,112895,Impagliazzo; Russell,0,0,15,15
1668328358726,CSE 209B,A00,108005,Bellare; Mihir,0,0,0,0
1668328359150,CSE 210,A00,113163,Coblenz; Michael J,0,0,0,0
1668328359580,CSE 219,A00,106111,Dow; Steven P,0,0,20,20
1668328360004,CSE 221,A00,102376,Voelker; Geoffrey M.,0,0,0,0
1668328360430,CSE 224,A01,102378,Porter; George M,0,0,0,0
1668328360865,CSE 229A,A00,102379,Savage; Stefan,0,0,0,0
1668328361290,CSE 229C,A00,102380,Munyaka; Imani N. S.,0,0,0,0
1668328361714,CSE 232B,A00,102382,Deutsch; Alin Bernard,0,0,0,0
1668328362138,CSE 234,A01,112904,Kumar; Arun Kumar,0,0,0,0
1668328362563,CSE 237A,A00,102383,Rosing; Tajana Simunic,0,0,0,0
1668328362992,CSE 239A,A00,102384,Deutsch; Alin Bernard,0,0,0,0
1668328363415,CSE 239B,A00,102385,Polikarpova; Nadezhda,0,0,0,0
1668328363839,CSE 240A,A00,102386,Pannuto; Patrick William,0,0,0,0
1668328364263,CSE 240B,A00,102387,Zhao; Jishen,0,0,0,0
1668328364688,CSE 241A,A00,106406,Kang; Mingu,0,0,0,0
1668328365112,CSE 249B,A00,102388,Kahng; Andrew Byun,0,0,8,8
1668328365539,CSE 251B,A01,102392,Cottrell; Garrison W,0,0,0,0
1668328365539,CSE 251B,A02,102393,Cottrell; Garrison W,0,0,0,0
1668328365966,CSE 252B,A00,102394,Ochoa; Benjamin Lawrence,0,0,0,0
1668328366389,CSE 257,A01,102396,Gao; Sicun,0,0,0,0
1668328366812,CSE 272,A00,102397,Li; Tzumao,0,0,0,0
1668328367238,CSE 274,A00,111323,Chern; Albert Ren-Haur,0,0,0,0
1668328367668,CSE 282,A00,102398,Pevzner; Pavel Arkadjevich,0,0,0,0
1668328368092,CSE 284,A00,114175,Gymrek; Melissa Ann,0,0,0,0
1668328368520,CSE 290,A00,102399,Chandraker; Manmohan Krishna,0,0,0,0
1668328368520,CSE 290,B00,102400,Vaccaro; Kristen Marie,0,0,25,25
1668328368520,CSE 290,C00,102414,Pannuto; Patrick William,0,0,25,25
1668328368520,CSE 290,D00,102427,Pevzner; Pavel Arkadjevich,0,0,0,0
1668328368520,CSE 290,E00,102429,Zhao; Jishen,0,0,0,0
1668328368520,CSE 290,F00,102436,Tullsen; Dean Michael,0,0,0,0
1668328368520,CSE 290,G00,102440,Christensen; Henrik I,0,0,20,20
1668328368947,CSE 291,A00,102443,Su; Hao,0,0,0,0
1668328368947,CSE 291,B00,102448,Polikarpova; Nadezhda,0,0,0,0
1668328368947,CSE 291,C00,102453,Vaccaro; Kristen Marie,0,0,0,0
1668328368947,CSE 291,D00,111343,Savage; Stefan,0,0,0,0
1668328368947,CSE 291,E00,116474,Claffy; Kimberly Claire,0,0,0,0
1668328368947,CSE 291,F00,116479,Pasquale; Joseph,0,0,0,0
1668328369411,CSE 293,001,119111,Bafna; Vineet,9999,0,9999,0
1668328369411,CSE 293,002,119118,Bellare; Mihir,9999,0,9999,0
1668328369411,CSE 293,003,119122,Berg-Kirkpatrick; Taylor D,9999,0,9999,0
1668328369411,CSE 293,004,119135,Christensen; Henrik I,9999,0,9999,0
1668328369411,CSE 293,005,119142,Cottrell; Garrison W,9999,0,9999,0
1668328369411,CSE 293,006,119146,Deutsch; Alin Bernard,9999,0,9999,0
1668328369411,CSE 293,007,119159,Esmaeilzadeh; Hadi,9999,0,9999,0
1668328369411,CSE 293,008,119166,Freund; Yoav,9999,0,9999,0
1668328369411,CSE 293,009,119170,Griswold; William G.,9999,0,9999,0
1668328369411,CSE 293,010,119183,Gymrek; Melissa Ann,9999,0,9999,0
1668328369411,CSE 293,011,119190,Heninger; Nadia A,9999,0,9999,0
1668328369411,CSE 293,012,119230,Impagliazzo; Russell,9999,0,9999,0
1668328369411,CSE 293,013,119232,Jhala; Ranjit,9999,0,9999,0
1668328369411,CSE 293,014,119233,Kahng; Andrew Byun,9999,0,9999,0
1668328369411,CSE 293,015,119298,Kane; Daniel Mertz,9999,0,9999,0
1668328369411,CSE 293,016,119299,Kriegman; David J,9999,0,9999,0
1668328369411,CSE 293,017,119300,Kumar; Arun Kumar,9999,0,9999,0
1668328369411,CSE 293,018,119301,Lerner; Sorin,9999,0,9999,0
1668328369411,CSE 293,019,119302,Lovett; Shachar,9999,0,9999,0
1668328369411,CSE 293,020,119303,McAuley; Julian John,9999,0,9999,0
1668328369411,CSE 293,021,119304,Micciancio; Daniele,9999,0,9999,0
1668328369411,CSE 293,022,119367,Orailoglu; Alex,9999,0,9999,0
1668328369411,CSE 293,023,119382,Paturi; Ramamohan,9999,0,9999,0
1668328369411,CSE 293,024,119404,Polikarpova; Nadezhda,9999,0,9999,0
1668328369411,CSE 293,025,119406,Politz; Joseph Gibbs,9999,0,9999,0
1668328369411,CSE 293,026,119411,Porter; George M,9999,0,9999,0
1668328369411,CSE 293,027,119414,Porter; Leonard Emerson,9999,0,9999,0
1668328369411,CSE 293,028,119416,Ramamoorthi; Ravi,9999,0,9999,0
1668328369411,CSE 293,029,119417,Sahoo; Debashis,9999,0,9999,0
1668328369411,CSE 293,030,119420,Saul; Lawrence,9999,0,9999,0
1668328369411,CSE 293,031,119421,Savage; Stefan,9999,0,9999,0
1668328369411,CSE 293,032,119425,Schulze; Jurgen P.,9999,0,9999,0
1668328369411,CSE 293,033,119426,Snoeren; Alex C.,9999,0,9999,0
1668328369411,CSE 293,034,119428,Shang; Jingbo,9999,0,9999,0
1668328369411,CSE 293,035,119430,Stefan; Deian,9999,0,9999,0
1668328369411,CSE 293,036,119431,Su; Hao,9999,0,9999,0
1668328369411,CSE 293,037,119433,Swanson; Steven James,9999,0,9999,0
1668328369411,CSE 293,038,119435,Tullsen; Dean Michael,9999,0,9999,0
1668328369411,CSE 293,039,119483,Voelker; Geoffrey M.,9999,0,9999,0
1668328369411,CSE 293,040,119537,Zhao; Jishen,9999,0,9999,0
1668328369411,CSE 293,041,119538,Zhou; Yuan-Yuan,9999,0,9999,0
1668328369411,CSE 293,042,119539,Gao; Sicun,9999,0,9999,0
1668328369411,CSE 293,043,119540,Weibel; Nadir,9999,0,9999,0
1668328369411,CSE 293,044,119541,Gupta; Rajesh K.,9999,0,9999,0
1668328369411,CSE 293,045,126410,Vaccaro; Kristen Marie,9999,0,9999,0
1668328369411,CSE 293,046,126411,Klemke; Richard,9999,0,9999,0
1668328369835,CSE 294,A00,102459,Voelker; Geoffrey M.,0,0,0,0
1668328369835,CSE 294,B00,111322,Orailoglu; Alex,0,0,0,0
1668328370265,DSE 201,A00,096914,Deutsch; Alin Bernard,30,0,30,0
1668328370694,DSE 210,A00,096915,Dasgupta; Sanjoy,30,0,30,0
1668328371122,DSE 260A,A00,096916,Altintas De Callaf; Ilkay,30,0,30,0
1668328371606,ECE 200,001,103586,Antipa; Nicholas A,9999,0,9999,0
1668328371606,ECE 200,002,103587,Atanasov; Nikolay A.,9999,0,9999,0
1668328371606,ECE 200,003,103588,Bharadia; Dinesh,9999,0,9999,0
1668328371606,ECE 200,004,103589,Cheng; Chung Kuan,9999,0,9999,0
1668328371606,ECE 200,005,103590,Cosman; Pamela C.,9999,0,9999,0
1668328371606,ECE 200,006,103591,Dayeh; Shadi Ahmad,9999,0,9999,0
1668328371606,ECE 200,007,103592,Fainman; Yeshaiahu,9999,0,9999,0
1668328371606,ECE 200,008,103593,Ford; Joseph Earl,9999,0,9999,0
1668328371606,ECE 200,009,103594,Franceschetti; Massimo,9999,0,9999,0
1668328371606,ECE 200,010,103595,Fullerton; Eric E,9999,0,9999,0
1668328371606,ECE 200,011,103596,Galton; Ian A,9999,0,9999,0
1668328371606,ECE 200,012,103597,Gilja; Vikash,9999,0,9999,0
1668328371606,ECE 200,013,103598,Hall; Drew A.,9999,0,9999,0
1668328371606,ECE 200,014,103599,Hsueh; Tzu-Chien,9999,0,9999,0
1668328371606,ECE 200,015,103600,Javidi; Tara,9999,0,9999,0
1668328371606,ECE 200,016,103601,Kahng; Andrew Byun,9999,0,9999,0
1668328371606,ECE 200,017,103602,Kim; Young-Han,9999,0,9999,0
1668328371606,ECE 200,018,103603,Koushanfar; Farinaz,9999,0,9999,0
1668328371606,ECE 200,019,103604,Kuzum; Duygu,9999,0,9999,0
1668328371606,ECE 200,020,103605,Le; Hanh-Phuc,9999,0,9999,0
1668328371606,ECE 200,021,103606,Lin; Bill,9999,0,9999,0
1668328371606,ECE 200,022,103607,Liu; Zhaowei,9998,0,9999,1
1668328371606,ECE 200,023,103608,Lo; Yu-Hwa,9999,0,9999,0
1668328371606,ECE 200,024,103609,Lomakin; Vitaliy,9999,0,9999,0
1668328371606,ECE 200,025,103610,Mercier; Patrick Philip,9999,0,9999,0
1668328371606,ECE 200,026,103611,Meyer; Florian,9999,0,9999,0
1668328371606,ECE 200,027,103612,Milstein; Laurence B.,9999,0,9999,0
1668328371606,ECE 200,028,103613,Mir Arabbaygi; Siavash,9999,0,9999,0
1668328371606,ECE 200,029,103614,Mookherjea; Shayan,9999,0,9999,0
1668328371606,ECE 200,030,103615,Morris; Karcher William,9999,0,9999,0
1668328371606,ECE 200,031,103616,Ng; Tse Nga,9999,0,9999,0
1668328371606,ECE 200,032,103617,Nguyen; Truong Quang,9999,0,9999,0
1668328371606,ECE 200,033,103618,Nomura; Kenji,9999,0,9999,0
1668328371606,ECE 200,034,103619,Orlitsky; Alon,9999,0,9999,0
1668328371606,ECE 200,035,103620,Pal; Piya,9999,0,9999,0
1668328371606,ECE 200,036,103621,Papen; George C.,9999,0,9999,0
1668328371606,ECE 200,037,103622,Radic; Stojan,9999,0,9999,0
1668328371606,ECE 200,038,103623,Rao; Bhaskar D.,9999,0,9999,0
1668328371606,ECE 200,039,103624,Rao; Ramesh R,9999,0,9999,0
1668328371606,ECE 200,040,103625,Rebeiz; Gabriel,9999,0,9999,0
1668328371606,ECE 200,041,103626,Sanford; John R,9999,0,9999,0
1668328371606,ECE 200,042,103627,Siegel; Paul H.,9999,0,9999,0
1668328371606,ECE 200,043,103628,Sievenpiper; Daniel F.,9999,0,9999,0
1668328371606,ECE 200,044,103629,Sworder; David D.,9999,0,9999,0
1668328371606,ECE 200,045,103630,Taur; Yuan,9999,0,9999,0
1668328371606,ECE 200,046,103631,Touri; Behrouz,9999,0,9999,0
1668328371606,ECE 200,047,103632,Trivedi; Mohan M.,9999,0,9999,0
1668328371606,ECE 200,048,103633,Vasconcelos; Nuno,9999,0,9999,0
1668328371606,ECE 200,049,103634,Wang; Xiaolong,9999,0,9999,0
1668328371606,ECE 200,050,103635,Xie; Pengtao,9999,0,9999,0
1668328371606,ECE 200,051,103636,Yip; Michael,9999,0,9999,0
1668328371606,ECE 200,052,103637,Zeger; Kenneth A.,999,0,999,0
1668328371606,ECE 200,053,103638,Zhang; Xinyu,9999,0,9999,0
1668328371606,ECE 200,054,103639,Turakhia; Yatish Girish,9999,0,9999,0
1668328371606,ECE 200,055,103640,Kang; Mingu,9999,0,9999,0
1668328371606,ECE 200,056,103641,Shi; Yuanyuan,9999,0,9999,0
1668328371606,ECE 200,057,103642,Wang; Edward Jay,9999,0,9999,0
1668328371606,ECE 200,058,103643,Zheng; Yang,9999,0,9999,0
1668328372036,ECE 202,A00,103644,Kuzum; Duygu,0,0,0,0
1668328372476,ECE 212BN,A00,103646,Ng; Tse Nga,0,0,0,0
1668328372908,ECE 221,A00,111493,Staff,0,0,0,0
1668328373331,ECE 222B,A00,103647,Lomakin; Vitaliy,0,0,0,0
1668328373755,ECE 230B,A00,103648,Taur; Yuan,0,0,0,0
1668328374185,ECE 238B,A00,103649,Garay; Javier,0,0,0,0
1668328374612,ECE 240B,A00,112900,Fainman; Yeshaiahu,0,0,0,0
1668328375036,ECE 247A,A00,103650,Jokerst; Jesse Vincent,0,0,0,0
1668328375460,ECE 247B,A00,103651,Wang; Joseph,0,0,0,0
1668328375978,ECE 250,A00,103652,Siegel; Paul H.,0,0,0,0
1668328376403,ECE 251A,A00,103654,Rao; Bhaskar D.,0,0,0,0
1668328376826,ECE 257B,A00,103655,Bharadia; Dinesh,0,0,0,0
1668328377262,ECE 258A,A00,103656,Milstein; Laurence B.,0,0,0,0
1668328377688,ECE 260B,A00,103658,Kang; Mingu,0,0,0,0
1668328378114,ECE 264A,A00,103659,Galton; Ian A,0,0,0,0
1668328378542,ECE 265A,A00,103661,Gudem; Prasad S.S.,0,0,0,0
1668328378967,ECE 265D,A00,103662,Gudem; Prasad S.S.,0,0,0,0
1668328379397,ECE 268,A00,103663,Koushanfar; Farinaz,0,0,0,0
1668328379824,ECE 269,A01,103665,Pal; Piya,0,0,0,0
1668328380254,ECE 271B,A00,103666,Vasconcelos; Manuela,0,0,0,0
1668328380678,ECE 276A,A00,103667,Atanasov; Nikolay A.,0,0,0,0
1668328381102,ECE 277,A00,103668,An; Cheolhong,0,0,0,0
1668328381528,ECE 279,A00,117947,Hall; Drew A.,0,0,0,0
1668328382379,ECE 283,A00,103670,Hsueh; Tzu-Chien,0,0,0,0
1668328382806,ECE 284,A00,103671,Turakhia; Yatish Girish,0,0,0,0
1668328383232,ECE 285,A00,103672,Zheng; Yang,0,0,0,0
1668328383232,ECE 285,B00,103673,Sworder; David D.,0,0,0,0
1668328383660,ECE 287,A00,103676,Javidi; Tara,0,0,0,0
1668328384086,MATH 200B,A00,098023,Salehi Golsefidy; Alireza,12,0,15,3
1668328384512,MATH 202B,A00,098024,Rhoades; Brendon Patrick,9,0,15,6
1668328384935,MATH 203B,A00,098025,Oprea; Dragos N.,10,0,15,5
1668328385363,MATH 204B,A00,098026,Sorensen; Claus M,13,0,15,2
1668328385788,MATH 208,A00,098027,Izadi; Elham,7,0,10,3
1668328386214,MATH 209,A00,098028,Pollack; Aaron,10,0,10,0
1668328386635,MATH 211A,A00,112919,Rogalski; Daniel,9,0,10,1
1668328387062,MATH 211B,A00,112920,Seward; Brandon M.,9,0,10,1
1668328387490,MATH 218,A00,098029,Li; Bo,10,0,10,0
1668328387916,MATH 220B,A00,098030,Novak; Jonathan I,11,0,15,4
1668328388339,MATH 221A,A00,098031,Ebenfelt; Peter F,13,0,15,2
1668328388763,MATH 231B,A00,098032,Zlatos; Andrej,12,0,15,3
1668328389189,MATH 240B,A00,098033,Ni; Lei,9,0,15,6
1668328389612,MATH 243,A00,098034,Jekel; David Andrew,10,0,10,0
1668328390036,MATH 245A,A00,098035,Nie; Jiawang,0,0,15,16
1668328390463,MATH 248,A00,098036,Bejenaru; Ioan,10,0,10,0
1668328390889,MATH 250B,A00,098037,Spolaor; Luca,14,0,15,1
1668328391315,MATH 258,A00,098038,Ni; Lei,10,0,10,0
1668328391737,MATH 264B,A00,098041,Rhoades; Brendon Patrick,9,0,15,6
1668328392163,MATH 268,A00,098042,Buss; Samuel R,10,0,10,0
1668328392587,MATH 269,A00,098043,Rhoades; Brendon Patrick,10,0,10,0
1668328393011,MATH 270B,A00,098044,Li; Bo,10,0,15,5
1668328393437,MATH 272B,A00,098045,Holst; Michael J,13,0,15,2
1668328393862,MATH 273A,A00,098046,Tian; Xiaochuan,10,0,15,5
1668328394287,MATH 275,A01,098048,Tian; Xiaochuan,6,0,10,4
1668328394713,MATH 278A,A00,098049,Holst; Michael J,8,0,10,2
1668328395140,MATH 278B,A00,098050,Cloninger; Alexander,10,0,10,0
1668328395564,MATH 278C,A00,098051,Nie; Jiawang,7,0,10,3
1668328395990,MATH 280B,A00,098052,Zheng; Tianyi,8,0,15,7
1668328396414,MATH 281B,A00,098053,Bradic; Jelena,1,0,15,14
1668328396837,MATH 282B,A00,098054,Arias-Castro; Ery,0,0,15,15
1668328397262,MATH 285,A00,098055,Fitzsimmons; Patrick J,0,0,15,17
1668328397689,MATH 287B,A00,098056,Arias-Castro; Ery,2,0,15,13
1668328398114,MATH 288,A00,098057,Agarwal; Pooja,9,0,10,1
1668328398114,MATH 288,B00,098058,Zhang; Danna,8,0,10,2
1668328398114,MATH 288,C00,098059,Williams; Ruth J,9,0,10,1
1668328398539,MATH 290B,A00,098060,Roberts; Justin Deritter,13,0,15,2
1668328398966,MATH 292,A00,098061,Belmont; Eva Kinoshita,10,0,10,0
1668328399395,MATH 295,A00,098062,Suk; Andrew Hoon,48,0,50,2
1668328399822,MATH 296,A00,098063,Novak; Jonathan I,20,0,20,0
1668328400249,MATH 297,001,098064,Gamst; Anthony Collins,9997,0,9999,2
1668328901153,COGS 205,A00,101395,Chiba; Andrea,19,0,20,1
1668328901585,COGS 210B,001,101404,Greene; Deanna Jacquelyn,9998,0,9999,1
1668328901585,COGS 210B,002,101417,Xia; Haijun,9999,0,9999,0
1668328901585,COGS 210B,003,101422,Nitz; Douglas A.,9999,0,9999,0
1668328901585,COGS 210B,004,101423,Hollan; James D.,9998,0,9999,1
1668328901585,COGS 210B,005,101424,Deak; Gedeon O.,9998,0,9999,1
1668328901585,COGS 210B,006,101425,Rossano; Federico,9999,0,9999,0
1668328902011,COGS 211B,A00,101427,Coulson; Seana M,9996,0,9999,3
1668328902437,COGS 220,A00,101428,Hollan; James D.,0,0,25,25
1668328902864,COGS 229,A00,101429,Dow; Steven P,18,0,25,7
1668328903295,COGS 230,A00,101430,Klemmer; Scott R,11,0,17,6
1668328903719,COGS 234,A00,101431,Xia; Haijun,1,0,25,24
1668328904144,COGS 260,A00,101432,Kiyonaga; Anastasia,21,0,25,4
1668328904144,COGS 260,B00,101433,Kirsh; David Joel,15,0,25,10
1668328904573,CSE 202,A00,102371,Impagliazzo; Russell,0,0,0,0
1668328904998,CSE 203B,A01,102373,Cheng; Chung Kuan,0,0,0,0
1668328905422,CSE 208,A00,102374,Micciancio; Daniele,0,0,0,0
1668328905850,CSE 209A,A00,112895,Impagliazzo; Russell,0,0,15,15
1668328906279,CSE 209B,A00,108005,Bellare; Mihir,0,0,0,0
1668328906711,CSE 210,A00,113163,Coblenz; Michael J,0,0,0,0
1668328907136,CSE 219,A00,106111,Dow; Steven P,0,0,20,20
1668328907560,CSE 221,A00,102376,Voelker; Geoffrey M.,0,0,0,0
1668328907986,CSE 224,A01,102378,Porter; George M,0,0,0,0
1668328908415,CSE 229A,A00,102379,Savage; Stefan,0,0,0,0
1668328908838,CSE 229C,A00,102380,Munyaka; Imani N. S.,0,0,0,0
1668328909262,CSE 232B,A00,102382,Deutsch; Alin Bernard,0,0,0,0
1668328909692,CSE 234,A01,112904,Kumar; Arun Kumar,0,0,0,0
1668328910119,CSE 237A,A00,102383,Rosing; Tajana Simunic,0,0,0,0
1668328910544,CSE 239A,A00,102384,Deutsch; Alin Bernard,0,0,0,0
1668328910968,CSE 239B,A00,102385,Polikarpova; Nadezhda,0,0,0,0
1668328911394,CSE 240A,A00,102386,Pannuto; Patrick William,0,0,0,0
1668328911818,CSE 240B,A00,102387,Zhao; Jishen,0,0,0,0
1668328912247,CSE 241A,A00,106406,Kang; Mingu,0,0,0,0
1668328912672,CSE 249B,A00,102388,Kahng; Andrew Byun,0,0,8,8
1668328913098,CSE 251B,A01,102392,Cottrell; Garrison W,0,0,0,0
1668328913098,CSE 251B,A02,102393,Cottrell; Garrison W,0,0,0,0
1668328913523,CSE 252B,A00,102394,Ochoa; Benjamin Lawrence,0,0,0,0
1668328913948,CSE 257,A01,102396,Gao; Sicun,0,0,0,0
1668328914373,CSE 272,A00,102397,Li; Tzumao,0,0,0,0
1668328914796,CSE 274,A00,111323,Chern; Albert Ren-Haur,0,0,0,0
1668328915224,CSE 282,A00,102398,Pevzner; Pavel Arkadjevich,0,0,0,0
1668328915653,CSE 284,A00,114175,Gymrek; Melissa Ann,0,0,0,0
1668328916080,CSE 290,A00,102399,Chandraker; Manmohan Krishna,0,0,0,0
1668328916080,CSE 290,B00,102400,Vaccaro; Kristen Marie,0,0,25,25
1668328916080,CSE 290,C00,102414,Pannuto; Patrick William,0,0,25,25
1668328916080,CSE 290,D00,102427,Pevzner; Pavel Arkadjevich,0,0,0,0
1668328916080,CSE 290,E00,102429,Zhao; Jishen,0,0,0,0
1668328916080,CSE 290,F00,102436,Tullsen; Dean Michael,0,0,0,0
1668328916080,CSE 290,G00,102440,Christensen; Henrik I,0,0,20,20
1668328916506,CSE 291,A00,102443,Su; Hao,0,0,0,0
1668328916506,CSE 291,B00,102448,Polikarpova; Nadezhda,0,0,0,0
1668328916506,CSE 291,C00,102453,Vaccaro; Kristen Marie,0,0,0,0
1668328916506,CSE 291,D00,111343,Savage; Stefan,0,0,0,0
1668328916506,CSE 291,E00,116474,Claffy; Kimberly Claire,0,0,0,0
1668328916506,CSE 291,F00,116479,Pasquale; Joseph,0,0,0,0
1668328916955,CSE 293,001,119111,Bafna; Vineet,9999,0,9999,0
1668328916955,CSE 293,002,119118,Bellare; Mihir,9999,0,9999,0
1668328916955,CSE 293,003,119122,Berg-Kirkpatrick; Taylor D,9999,0,9999,0
1668328916955,CSE 293,004,119135,Christensen; Henrik I,9999,0,9999,0
1668328916955,CSE 293,005,119142,Cottrell; Garrison W,9999,0,9999,0
1668328916955,CSE 293,006,119146,Deutsch; Alin Bernard,9999,0,9999,0
1668328916955,CSE 293,007,119159,Esmaeilzadeh; Hadi,9999,0,9999,0
1668328916955,CSE 293,008,119166,Freund; Yoav,9999,0,9999,0
1668328916955,CSE 293,009,119170,Griswold; William G.,9999,0,9999,0
1668328916955,CSE 293,010,119183,Gymrek; Melissa Ann,9999,0,9999,0
1668328916955,CSE 293,011,119190,Heninger; Nadia A,9999,0,9999,0
1668328916955,CSE 293,012,119230,Impagliazzo; Russell,9999,0,9999,0
1668328916955,CSE 293,013,119232,Jhala; Ranjit,9999,0,9999,0
1668328916955,CSE 293,014,119233,Kahng; Andrew Byun,9999,0,9999,0
1668328916955,CSE 293,015,119298,Kane; Daniel Mertz,9999,0,9999,0
1668328916955,CSE 293,016,119299,Kriegman; David J,9999,0,9999,0
1668328916955,CSE 293,017,119300,Kumar; Arun Kumar,9999,0,9999,0
1668328916955,CSE 293,018,119301,Lerner; Sorin,9999,0,9999,0
1668328916955,CSE 293,019,119302,Lovett; Shachar,9999,0,9999,0
1668328916955,CSE 293,020,119303,McAuley; Julian John,9999,0,9999,0
1668328916955,CSE 293,021,119304,Micciancio; Daniele,9999,0,9999,0
1668328916955,CSE 293,022,119367,Orailoglu; Alex,9999,0,9999,0
1668328916955,CSE 293,023,119382,Paturi; Ramamohan,9999,0,9999,0
1668328916955,CSE 293,024,119404,Polikarpova; Nadezhda,9999,0,9999,0
1668328916955,CSE 293,025,119406,Politz; Joseph Gibbs,9999,0,9999,0
1668328916955,CSE 293,026,119411,Porter; George M,9999,0,9999,0
1668328916955,CSE 293,027,119414,Porter; Leonard Emerson,9999,0,9999,0
1668328916955,CSE 293,028,119416,Ramamoorthi; Ravi,9999,0,9999,0
1668328916955,CSE 293,029,119417,Sahoo; Debashis,9999,0,9999,0
1668328916955,CSE 293,030,119420,Saul; Lawrence,9999,0,9999,0
1668328916955,CSE 293,031,119421,Savage; Stefan,9999,0,9999,0
1668328916955,CSE 293,032,119425,Schulze; Jurgen P.,9999,0,9999,0
1668328916955,CSE 293,033,119426,Snoeren; Alex C.,9999,0,9999,0
1668328916955,CSE 293,034,119428,Shang; Jingbo,9999,0,9999,0
1668328916955,CSE 293,035,119430,Stefan; Deian,9999,0,9999,0
1668328916955,CSE 293,036,119431,Su; Hao,9999,0,9999,0
1668328916955,CSE 293,037,119433,Swanson; Steven James,9999,0,9999,0
1668328916955,CSE 293,038,119435,Tullsen; Dean Michael,9999,0,9999,0
1668328916955,CSE 293,039,119483,Voelker; Geoffrey M.,9999,0,9999,0
1668328916955,CSE 293,040,119537,Zhao; Jishen,9999,0,9999,0
1668328916955,CSE 293,041,119538,Zhou; Yuan-Yuan,9999,0,9999,0
1668328916955,CSE 293,042,119539,Gao; Sicun,9999,0,9999,0
1668328916955,CSE 293,043,119540,Weibel; Nadir,9999,0,9999,0
1668328916955,CSE 293,044,119541,Gupta; Rajesh K.,9999,0,9999,0
1668328916955,CSE 293,045,126410,Vaccaro; Kristen Marie,9999,0,9999,0
1668328916955,CSE 293,046,126411,Klemke; Richard,9999,0,9999,0
1668328917383,CSE 294,A00,102459,Voelker; Geoffrey M.,0,0,0,0
1668328917383,CSE 294,B00,111322,Orailoglu; Alex,0,0,0,0
1668328917806,DSE 201,A00,096914,Deutsch; Alin Bernard,30,0,30,0
1668328918235,DSE 210,A00,096915,Dasgupta; Sanjoy,30,0,30,0
1668328918661,DSE 260A,A00,096916,Altintas De Callaf; Ilkay,30,0,30,0
1668328919135,ECE 200,001,103586,Antipa; Nicholas A,9999,0,9999,0
1668328919135,ECE 200,002,103587,Atanasov; Nikolay A.,9999,0,9999,0
1668328919135,ECE 200,003,103588,Bharadia; Dinesh,9999,0,9999,0
1668328919135,ECE 200,004,103589,Cheng; Chung Kuan,9999,0,9999,0
1668328919135,ECE 200,005,103590,Cosman; Pamela C.,9999,0,9999,0
1668328919135,ECE 200,006,103591,Dayeh; Shadi Ahmad,9999,0,9999,0
1668328919135,ECE 200,007,103592,Fainman; Yeshaiahu,9999,0,9999,0
1668328919135,ECE 200,008,103593,Ford; Joseph Earl,9999,0,9999,0
1668328919135,ECE 200,009,103594,Franceschetti; Massimo,9999,0,9999,0
1668328919135,ECE 200,010,103595,Fullerton; Eric E,9999,0,9999,0
1668328919135,ECE 200,011,103596,Galton; Ian A,9999,0,9999,0
1668328919135,ECE 200,012,103597,Gilja; Vikash,9999,0,9999,0
1668328919135,ECE 200,013,103598,Hall; Drew A.,9999,0,9999,0
1668328919135,ECE 200,014,103599,Hsueh; Tzu-Chien,9999,0,9999,0
1668328919135,ECE 200,015,103600,Javidi; Tara,9999,0,9999,0
1668328919135,ECE 200,016,103601,Kahng; Andrew Byun,9999,0,9999,0
1668328919135,ECE 200,017,103602,Kim; Young-Han,9999,0,9999,0
1668328919135,ECE 200,018,103603,Koushanfar; Farinaz,9999,0,9999,0
1668328919135,ECE 200,019,103604,Kuzum; Duygu,9999,0,9999,0
1668328919135,ECE 200,020,103605,Le; Hanh-Phuc,9999,0,9999,0
1668328919135,ECE 200,021,103606,Lin; Bill,9999,0,9999,0
1668328919135,ECE 200,022,103607,Liu; Zhaowei,9998,0,9999,1
1668328919135,ECE 200,023,103608,Lo; Yu-Hwa,9999,0,9999,0
1668328919135,ECE 200,024,103609,Lomakin; Vitaliy,9999,0,9999,0
1668328919135,ECE 200,025,103610,Mercier; Patrick Philip,9999,0,9999,0
1668328919135,ECE 200,026,103611,Meyer; Florian,9999,0,9999,0
1668328919135,ECE 200,027,103612,Milstein; Laurence B.,9999,0,9999,0
1668328919135,ECE 200,028,103613,Mir Arabbaygi; Siavash,9999,0,9999,0
1668328919135,ECE 200,029,103614,Mookherjea; Shayan,9999,0,9999,0
1668328919135,ECE 200,030,103615,Morris; Karcher William,9999,0,9999,0
1668328919135,ECE 200,031,103616,Ng; Tse Nga,9999,0,9999,0
1668328919135,ECE 200,032,103617,Nguyen; Truong Quang,9999,0,9999,0
1668328919135,ECE 200,033,103618,Nomura; Kenji,9999,0,9999,0
1668328919135,ECE 200,034,103619,Orlitsky; Alon,9999,0,9999,0
1668328919135,ECE 200,035,103620,Pal; Piya,9999,0,9999,0
1668328919135,ECE 200,036,103621,Papen; George C.,9999,0,9999,0
1668328919135,ECE 200,037,103622,Radic; Stojan,9999,0,9999,0
1668328919135,ECE 200,038,103623,Rao; Bhaskar D.,9999,0,9999,0
1668328919135,ECE 200,039,103624,Rao; Ramesh R,9999,0,9999,0
1668328919135,ECE 200,040,103625,Rebeiz; Gabriel,9999,0,9999,0
1668328919135,ECE 200,041,103626,Sanford; John R,9999,0,9999,0
1668328919135,ECE 200,042,103627,Siegel; Paul H.,9999,0,9999,0
1668328919135,ECE 200,043,103628,Sievenpiper; Daniel F.,9999,0,9999,0
1668328919135,ECE 200,044,103629,Sworder; David D.,9999,0,9999,0
1668328919135,ECE 200,045,103630,Taur; Yuan,9999,0,9999,0
1668328919135,ECE 200,046,103631,Touri; Behrouz,9999,0,9999,0
1668328919135,ECE 200,047,103632,Trivedi; Mohan M.,9999,0,9999,0
1668328919135,ECE 200,048,103633,Vasconcelos; Nuno,9999,0,9999,0
1668328919135,ECE 200,049,103634,Wang; Xiaolong,9999,0,9999,0
1668328919135,ECE 200,050,103635,Xie; Pengtao,9999,0,9999,0
1668328919135,ECE 200,051,103636,Yip; Michael,9999,0,9999,0
1668328919135,ECE 200,052,103637,Zeger; Kenneth A.,999,0,999,0
1668328919135,ECE 200,053,103638,Zhang; Xinyu,9999,0,9999,0
1668328919135,ECE 200,054,103639,Turakhia; Yatish Girish,9999,0,9999,0
1668328919135,ECE 200,055,103640,Kang; Mingu,9999,0,9999,0
1668328919135,ECE 200,056,103641,Shi; Yuanyuan,9999,0,9999,0
1668328919135,ECE 200,057,103642,Wang; Edward Jay,9999,0,9999,0
1668328919135,ECE 200,058,103643,Zheng; Yang,9999,0,9999,0
1668328919560,ECE 202,A00,103644,Kuzum; Duygu,0,0,0,0
1668328919988,ECE 212BN,A00,103646,Ng; Tse Nga,0,0,0,0
1668328920414,ECE 221,A00,111493,Staff,0,0,0,0
1668328920838,ECE 222B,A00,103647,Lomakin; Vitaliy,0,0,0,0
1668328921262,ECE 230B,A00,103648,Taur; Yuan,0,0,0,0
1668328921694,ECE 238B,A00,103649,Garay; Javier,0,0,0,0
1668328922119,ECE 240B,A00,112900,Fainman; Yeshaiahu,0,0,0,0
1668328922553,ECE 247A,A00,103650,Jokerst; Jesse Vincent,0,0,0,0
1668328922981,ECE 247B,A00,103651,Wang; Joseph,0,0,0,0
1668328923410,ECE 250,A00,103652,Siegel; Paul H.,0,0,0,0
1668328923834,ECE 251A,A00,103654,Rao; Bhaskar D.,0,0,0,0
1668328924263,ECE 257B,A00,103655,Bharadia; Dinesh,0,0,0,0
1668328924687,ECE 258A,A00,103656,Milstein; Laurence B.,0,0,0,0
1668328925116,ECE 260B,A00,103658,Kang; Mingu,0,0,0,0
1668328925540,ECE 264A,A00,103659,Galton; Ian A,0,0,0,0
1668328925964,ECE 265A,A00,103661,Gudem; Prasad S.S.,0,0,0,0
1668328926398,ECE 265D,A00,103662,Gudem; Prasad S.S.,0,0,0,0
1668328926828,ECE 268,A00,103663,Koushanfar; Farinaz,0,0,0,0
1668328927254,ECE 269,A01,103665,Pal; Piya,0,0,0,0
1668328927679,ECE 271B,A00,103666,Vasconcelos; Manuela,0,0,0,0
1668328928103,ECE 276A,A00,103667,Atanasov; Nikolay A.,0,0,0,0
1668328928529,ECE 277,A00,103668,An; Cheolhong,0,0,0,0
1668328928958,ECE 279,A00,117947,Hall; Drew A.,0,0,0,0
1668328929808,ECE 283,A00,103670,Hsueh; Tzu-Chien,0,0,0,0
1668328930234,ECE 284,A00,103671,Turakhia; Yatish Girish,0,0,0,0
1668328930664,ECE 285,A00,103672,Zheng; Yang,0,0,0,0
1668328930664,ECE 285,B00,103673,Sworder; David D.,0,0,0,0
1668328931093,ECE 287,A00,103676,Javidi; Tara,0,0,0,0
1668328931525,MATH 200B,A00,098023,Salehi Golsefidy; Alireza,12,0,15,3
1668328931953,MATH 202B,A00,098024,Rhoades; Brendon Patrick,9,0,15,6
1668328932377,MATH 203B,A00,098025,Oprea; Dragos N.,10,0,15,5
1668328932801,MATH 204B,A00,098026,Sorensen; Claus M,13,0,15,2
1668328933226,MATH 208,A00,098027,Izadi; Elham,7,0,10,3
1668328933650,MATH 209,A00,098028,Pollack; Aaron,10,0,10,0
1668328934079,MATH 211A,A00,112919,Rogalski; Daniel,9,0,10,1
1668328934504,MATH 211B,A00,112920,Seward; Brandon M.,9,0,10,1
1668328934930,MATH 218,A00,098029,Li; Bo,10,0,10,0
1668328935358,MATH 220B,A00,098030,Novak; Jonathan I,11,0,15,4
1668328935785,MATH 221A,A00,098031,Ebenfelt; Peter F,13,0,15,2
1668328936214,MATH 231B,A00,098032,Zlatos; Andrej,12,0,15,3
1668328936642,MATH 240B,A00,098033,Ni; Lei,9,0,15,6
1668328937068,MATH 243,A00,098034,Jekel; David Andrew,10,0,10,0
1668328937493,MATH 245A,A00,098035,Nie; Jiawang,0,0,15,16
1668328937921,MATH 248,A00,098036,Bejenaru; Ioan,10,0,10,0
1668328938345,MATH 250B,A00,098037,Spolaor; Luca,14,0,15,1
1668328938774,MATH 258,A00,098038,Ni; Lei,10,0,10,0
1668328939199,MATH 264B,A00,098041,Rhoades; Brendon Patrick,9,0,15,6
1668328939627,MATH 268,A00,098042,Buss; Samuel R,10,0,10,0
1668328940131,MATH 269,A00,098043,Rhoades; Brendon Patrick,10,0,10,0
1668328940567,MATH 270B,A00,098044,Li; Bo,10,0,15,5
1668328940996,MATH 272B,A00,098045,Holst; Michael J,13,0,15,2
1668328941422,MATH 273A,A00,098046,Tian; Xiaochuan,10,0,15,5
1668328941846,MATH 275,A01,098048,Tian; Xiaochuan,6,0,10,4
1668328942273,MATH 278A,A00,098049,Holst; Michael J,8,0,10,2
1668328942697,MATH 278B,A00,098050,Cloninger; Alexander,10,0,10,0
1668328943123,MATH 278C,A00,098051,Nie; Jiawang,7,0,10,3
1668328943551,MATH 280B,A00,098052,Zheng; Tianyi,8,0,15,7
1668328943979,MATH 281B,A00,098053,Bradic; Jelena,1,0,15,14
1668328944406,MATH 282B,A00,098054,Arias-Castro; Ery,0,0,15,15
1668328944829,MATH 285,A00,098055,Fitzsimmons; Patrick J,0,0,15,17
1668328945257,MATH 287B,A00,098056,Arias-Castro; Ery,2,0,15,13
1668328945682,MATH 288,A00,098057,Agarwal; Pooja,9,0,10,1
1668328945682,MATH 288,B00,098058,Zhang; Danna,8,0,10,2
1668328945682,MATH 288,C00,098059,Williams; Ruth J,9,0,10,1
1668328946110,MATH 290B,A00,098060,Roberts; Justin Deritter,13,0,15,2
1668328946537,MATH 292,A00,098061,Belmont; Eva Kinoshita,10,0,10,0
1668328946965,MATH 295,A00,098062,Suk; Andrew Hoon,48,0,50,2
1668328947402,MATH 296,A00,098063,Novak; Jonathan I,20,0,20,0
1668328947825,MATH 297,001,098064,Gamst; Anthony Collins,9997,0,9999,2
1668329449072,COGS 205,A00,101395,Chiba; Andrea,19,0,20,1
1668329449497,COGS 210B,001,101404,Greene; Deanna Jacquelyn,9998,0,9999,1
1668329449497,COGS 210B,002,101417,Xia; Haijun,9999,0,9999,0
1668329449497,COGS 210B,003,101422,Nitz; Douglas A.,9999,0,9999,0
1668329449497,COGS 210B,004,101423,Hollan; James D.,9998,0,9999,1
1668329449497,COGS 210B,005,101424,Deak; Gedeon O.,9998,0,9999,1
1668329449497,COGS 210B,006,101425,Rossano; Federico,9999,0,9999,0
1668329449922,COGS 211B,A00,101427,Coulson; Seana M,9996,0,9999,3
1668329450347,COGS 220,A00,101428,Hollan; James D.,0,0,25,25
1668329450781,COGS 229,A00,101429,Dow; Steven P,18,0,25,7
1668329451208,COGS 230,A00,101430,Klemmer; Scott R,11,0,17,6
1668329451633,COGS 234,A00,101431,Xia; Haijun,1,0,25,24
1668329452059,COGS 260,A00,101432,Kiyonaga; Anastasia,21,0,25,4
1668329452059,COGS 260,B00,101433,Kirsh; David Joel,15,0,25,10
1668329452482,CSE 202,A00,102371,Impagliazzo; Russell,0,0,0,0
1668329452911,CSE 203B,A01,102373,Cheng; Chung Kuan,0,0,0,0
1668329453334,CSE 208,A00,102374,Micciancio; Daniele,0,0,0,0
1668329453758,CSE 209A,A00,112895,Impagliazzo; Russell,0,0,15,15
1668329454181,CSE 209B,A00,108005,Bellare; Mihir,0,0,0,0
1668329454607,CSE 210,A00,113163,Coblenz; Michael J,0,0,0,0
1668329455030,CSE 219,A00,106111,Dow; Steven P,0,0,20,20
1668329455459,CSE 221,A00,102376,Voelker; Geoffrey M.,0,0,0,0
1668329455885,CSE 224,A01,102378,Porter; George M,0,0,0,0
1668329456310,CSE 229A,A00,102379,Savage; Stefan,0,0,0,0
1668329456732,CSE 229C,A00,102380,Munyaka; Imani N. S.,0,0,0,0
1668329457157,CSE 232B,A00,102382,Deutsch; Alin Bernard,0,0,0,0
1668329457583,CSE 234,A01,112904,Kumar; Arun Kumar,0,0,0,0
1668329458014,CSE 237A,A00,102383,Rosing; Tajana Simunic,0,0,0,0
1668329458447,CSE 239A,A00,102384,Deutsch; Alin Bernard,0,0,0,0
1668329458871,CSE 239B,A00,102385,Polikarpova; Nadezhda,0,0,0,0
1668329459295,CSE 240A,A00,102386,Pannuto; Patrick William,0,0,0,0
1668329459718,CSE 240B,A00,102387,Zhao; Jishen,0,0,0,0
1668329460147,CSE 241A,A00,106406,Kang; Mingu,0,0,0,0
1668329460569,CSE 249B,A00,102388,Kahng; Andrew Byun,0,0,8,8
1668329460997,CSE 251B,A01,102392,Cottrell; Garrison W,0,0,0,0
1668329460997,CSE 251B,A02,102393,Cottrell; Garrison W,0,0,0,0
1668329461498,CSE 252B,A00,102394,Ochoa; Benjamin Lawrence,0,0,0,0
1668329461925,CSE 257,A01,102396,Gao; Sicun,0,0,0,0
1668329462348,CSE 272,A00,102397,Li; Tzumao,0,0,0,0
1668329462780,CSE 274,A00,111323,Chern; Albert Ren-Haur,0,0,0,0
1668329463207,CSE 282,A00,102398,Pevzner; Pavel Arkadjevich,0,0,0,0
1668329463631,CSE 284,A00,114175,Gymrek; Melissa Ann,0,0,0,0
1668329464061,CSE 290,A00,102399,Chandraker; Manmohan Krishna,0,0,0,0
1668329464061,CSE 290,B00,102400,Vaccaro; Kristen Marie,0,0,25,25
1668329464061,CSE 290,C00,102414,Pannuto; Patrick William,0,0,25,25
1668329464061,CSE 290,D00,102427,Pevzner; Pavel Arkadjevich,0,0,0,0
1668329464061,CSE 290,E00,102429,Zhao; Jishen,0,0,0,0
1668329464061,CSE 290,F00,102436,Tullsen; Dean Michael,0,0,0,0
1668329464061,CSE 290,G00,102440,Christensen; Henrik I,0,0,20,20
1668329464485,CSE 291,A00,102443,Su; Hao,0,0,0,0
1668329464485,CSE 291,B00,102448,Polikarpova; Nadezhda,0,0,0,0
1668329464485,CSE 291,C00,102453,Vaccaro; Kristen Marie,0,0,0,0
1668329464485,CSE 291,D00,111343,Savage; Stefan,0,0,0,0
1668329464485,CSE 291,E00,116474,Claffy; Kimberly Claire,0,0,0,0
1668329464485,CSE 291,F00,116479,Pasquale; Joseph,0,0,0,0
1668329464921,CSE 293,001,119111,Bafna; Vineet,9999,0,9999,0
1668329464921,CSE 293,002,119118,Bellare; Mihir,9999,0,9999,0
1668329464921,CSE 293,003,119122,Berg-Kirkpatrick; Taylor D,9999,0,9999,0
1668329464921,CSE 293,004,119135,Christensen; Henrik I,9999,0,9999,0
1668329464921,CSE 293,005,119142,Cottrell; Garrison W,9999,0,9999,0
1668329464921,CSE 293,006,119146,Deutsch; Alin Bernard,9999,0,9999,0
1668329464921,CSE 293,007,119159,Esmaeilzadeh; Hadi,9999,0,9999,0
1668329464921,CSE 293,008,119166,Freund; Yoav,9999,0,9999,0
1668329464921,CSE 293,009,119170,Griswold; William G.,9999,0,9999,0
1668329464921,CSE 293,010,119183,Gymrek; Melissa Ann,9999,0,9999,0
1668329464921,CSE 293,011,119190,Heninger; Nadia A,9999,0,9999,0
1668329464921,CSE 293,012,119230,Impagliazzo; Russell,9999,0,9999,0
1668329464921,CSE 293,013,119232,Jhala; Ranjit,9999,0,9999,0
1668329464921,CSE 293,014,119233,Kahng; Andrew Byun,9999,0,9999,0
1668329464921,CSE 293,015,119298,Kane; Daniel Mertz,9999,0,9999,0
1668329464921,CSE 293,016,119299,Kriegman; David J,9999,0,9999,0
1668329464921,CSE 293,017,119300,Kumar; Arun Kumar,9999,0,9999,0
1668329464921,CSE 293,018,119301,Lerner; Sorin,9999,0,9999,0
1668329464921,CSE 293,019,119302,Lovett; Shachar,9999,0,9999,0
1668329464921,CSE 293,020,119303,McAuley; Julian John,9999,0,9999,0
1668329464921,CSE 293,021,119304,Micciancio; Daniele,9999,0,9999,0
1668329464921,CSE 293,022,119367,Orailoglu; Alex,9999,0,9999,0
1668329464921,CSE 293,023,119382,Paturi; Ramamohan,9999,0,9999,0
1668329464921,CSE 293,024,119404,Polikarpova; Nadezhda,9999,0,9999,0
1668329464921,CSE 293,025,119406,Politz; Joseph Gibbs,9999,0,9999,0
1668329464921,CSE 293,026,119411,Porter; George M,9999,0,9999,0
1668329464921,CSE 293,027,119414,Porter; Leonard Emerson,9999,0,9999,0
1668329464921,CSE 293,028,119416,Ramamoorthi; Ravi,9999,0,9999,0
1668329464921,CSE 293,029,119417,Sahoo; Debashis,9999,0,9999,0
1668329464921,CSE 293,030,119420,Saul; Lawrence,9999,0,9999,0
1668329464921,CSE 293,031,119421,Savage; Stefan,9999,0,9999,0
1668329464921,CSE 293,032,119425,Schulze; Jurgen P.,9999,0,9999,0
1668329464921,CSE 293,033,119426,Snoeren; Alex C.,9999,0,9999,0
1668329464921,CSE 293,034,119428,Shang; Jingbo,9999,0,9999,0
1668329464921,CSE 293,035,119430,Stefan; Deian,9999,0,9999,0
1668329464921,CSE 293,036,119431,Su; Hao,9999,0,9999,0
1668329464921,CSE 293,037,119433,Swanson; Steven James,9999,0,9999,0
1668329464921,CSE 293,038,119435,Tullsen; Dean Michael,9999,0,9999,0
1668329464921,CSE 293,039,119483,Voelker; Geoffrey M.,9999,0,9999,0
1668329464921,CSE 293,040,119537,Zhao; Jishen,9999,0,9999,0
1668329464921,CSE 293,041,119538,Zhou; Yuan-Yuan,9999,0,9999,0
1668329464921,CSE 293,042,119539,Gao; Sicun,9999,0,9999,0
1668329464921,CSE 293,043,119540,Weibel; Nadir,9999,0,9999,0
1668329464921,CSE 293,044,119541,Gupta; Rajesh K.,9999,0,9999,0
1668329464921,CSE 293,045,126410,Vaccaro; Kristen Marie,9999,0,9999,0
1668329464921,CSE 293,046,126411,Klemke; Richard,9999,0,9999,0
1668329465344,CSE 294,A00,102459,Voelker; Geoffrey M.,0,0,0,0
1668329465344,CSE 294,B00,111322,Orailoglu; Alex,0,0,0,0
1668329465768,DSE 201,A00,096914,Deutsch; Alin Bernard,30,0,30,0
1668329466189,DSE 210,A00,096915,Dasgupta; Sanjoy,30,0,30,0
1668329466612,DSE 260A,A00,096916,Altintas De Callaf; Ilkay,30,0,30,0
1668329467068,ECE 200,001,103586,Antipa; Nicholas A,9999,0,9999,0
1668329467068,ECE 200,002,103587,Atanasov; Nikolay A.,9999,0,9999,0
1668329467068,ECE 200,003,103588,Bharadia; Dinesh,9999,0,9999,0
1668329467068,ECE 200,004,103589,Cheng; Chung Kuan,9999,0,9999,0
1668329467068,ECE 200,005,103590,Cosman; Pamela C.,9999,0,9999,0
1668329467068,ECE 200,006,103591,Dayeh; Shadi Ahmad,9999,0,9999,0
1668329467068,ECE 200,007,103592,Fainman; Yeshaiahu,9999,0,9999,0
1668329467068,ECE 200,008,103593,Ford; Joseph Earl,9999,0,9999,0
1668329467068,ECE 200,009,103594,Franceschetti; Massimo,9999,0,9999,0
1668329467068,ECE 200,010,103595,Fullerton; Eric E,9999,0,9999,0
1668329467068,ECE 200,011,103596,Galton; Ian A,9999,0,9999,0
1668329467068,ECE 200,012,103597,Gilja; Vikash,9999,0,9999,0
1668329467068,ECE 200,013,103598,Hall; Drew A.,9999,0,9999,0
1668329467068,ECE 200,014,103599,Hsueh; Tzu-Chien,9999,0,9999,0
1668329467068,ECE 200,015,103600,Javidi; Tara,9999,0,9999,0
1668329467068,ECE 200,016,103601,Kahng; Andrew Byun,9999,0,9999,0
1668329467068,ECE 200,017,103602,Kim; Young-Han,9999,0,9999,0
1668329467068,ECE 200,018,103603,Koushanfar; Farinaz,9999,0,9999,0
1668329467068,ECE 200,019,103604,Kuzum; Duygu,9999,0,9999,0
1668329467068,ECE 200,020,103605,Le; Hanh-Phuc,9999,0,9999,0
1668329467068,ECE 200,021,103606,Lin; Bill,9999,0,9999,0
1668329467068,ECE 200,022,103607,Liu; Zhaowei,9998,0,9999,1
1668329467068,ECE 200,023,103608,Lo; Yu-Hwa,9999,0,9999,0
1668329467068,ECE 200,024,103609,Lomakin; Vitaliy,9999,0,9999,0
1668329467068,ECE 200,025,103610,Mercier; Patrick Philip,9999,0,9999,0
1668329467068,ECE 200,026,103611,Meyer; Florian,9999,0,9999,0
1668329467068,ECE 200,027,103612,Milstein; Laurence B.,9999,0,9999,0
1668329467068,ECE 200,028,103613,Mir Arabbaygi; Siavash,9999,0,9999,0
1668329467068,ECE 200,029,103614,Mookherjea; Shayan,9999,0,9999,0
1668329467068,ECE 200,030,103615,Morris; Karcher William,9999,0,9999,0
1668329467068,ECE 200,031,103616,Ng; Tse Nga,9999,0,9999,0
1668329467068,ECE 200,032,103617,Nguyen; Truong Quang,9999,0,9999,0
1668329467068,ECE 200,033,103618,Nomura; Kenji,9999,0,9999,0
1668329467068,ECE 200,034,103619,Orlitsky; Alon,9999,0,9999,0
1668329467068,ECE 200,035,103620,Pal; Piya,9999,0,9999,0
1668329467068,ECE 200,036,103621,Papen; George C.,9999,0,9999,0
1668329467068,ECE 200,037,103622,Radic; Stojan,9999,0,9999,0
1668329467068,ECE 200,038,103623,Rao; Bhaskar D.,9999,0,9999,0
1668329467068,ECE 200,039,103624,Rao; Ramesh R,9999,0,9999,0
1668329467068,ECE 200,040,103625,Rebeiz; Gabriel,9999,0,9999,0
1668329467068,ECE 200,041,103626,Sanford; John R,9999,0,9999,0
1668329467068,ECE 200,042,103627,Siegel; Paul H.,9999,0,9999,0
1668329467068,ECE 200,043,103628,Sievenpiper; Daniel F.,9999,0,9999,0
1668329467068,ECE 200,044,103629,Sworder; David D.,9999,0,9999,0
1668329467068,ECE 200,045,103630,Taur; Yuan,9999,0,9999,0
1668329467068,ECE 200,046,103631,Touri; Behrouz,9999,0,9999,0
1668329467068,ECE 200,047,103632,Trivedi; Mohan M.,9999,0,9999,0
1668329467068,ECE 200,048,103633,Vasconcelos; Nuno,9999,0,9999,0
1668329467068,ECE 200,049,103634,Wang; Xiaolong,9999,0,9999,0
1668329467068,ECE 200,050,103635,Xie; Pengtao,9999,0,9999,0
1668329467068,ECE 200,051,103636,Yip; Michael,9999,0,9999,0
1668329467068,ECE 200,052,103637,Zeger; Kenneth A.,999,0,999,0
1668329467068,ECE 200,053,103638,Zhang; Xinyu,9999,0,9999,0
1668329467068,ECE 200,054,103639,Turakhia; Yatish Girish,9999,0,9999,0
1668329467068,ECE 200,055,103640,Kang; Mingu,9999,0,9999,0
1668329467068,ECE 200,056,103641,Shi; Yuanyuan,9999,0,9999,0
1668329467068,ECE 200,057,103642,Wang; Edward Jay,9999,0,9999,0
1668329467068,ECE 200,058,103643,Zheng; Yang,9999,0,9999,0
1668329467495,ECE 202,A00,103644,Kuzum; Duygu,0,0,0,0
1668329467917,ECE 212BN,A00,103646,Ng; Tse Nga,0,0,0,0
1668329468341,ECE 221,A00,111493,Staff,0,0,0,0
1668329468765,ECE 222B,A00,103647,Lomakin; Vitaliy,0,0,0,0
1668329469188,ECE 230B,A00,103648,Taur; Yuan,0,0,0,0
1668329469614,ECE 238B,A00,103649,Garay; Javier,0,0,0,0
1668329470039,ECE 240B,A00,112900,Fainman; Yeshaiahu,0,0,0,0
1668329470464,ECE 247A,A00,103650,Jokerst; Jesse Vincent,0,0,0,0
1668329470888,ECE 247B,A00,103651,Wang; Joseph,0,0,0,0
1668329471313,ECE 250,A00,103652,Siegel; Paul H.,0,0,0,0
1668329471751,ECE 251A,A00,103654,Rao; Bhaskar D.,0,0,0,0
1668329472173,ECE 257B,A00,103655,Bharadia; Dinesh,0,0,0,0
1668329472600,ECE 258A,A00,103656,Milstein; Laurence B.,0,0,0,0
1668329473031,ECE 260B,A00,103658,Kang; Mingu,0,0,0,0
1668329473454,ECE 264A,A00,103659,Galton; Ian A,0,0,0,0
1668329473878,ECE 265A,A00,103661,Gudem; Prasad S.S.,0,0,0,0
1668329474306,ECE 265D,A00,103662,Gudem; Prasad S.S.,0,0,0,0
1668329474731,ECE 268,A00,103663,Koushanfar; Farinaz,0,0,0,0
1668329475155,ECE 269,A01,103665,Pal; Piya,0,0,0,0
1668329475581,ECE 271B,A00,103666,Vasconcelos; Manuela,0,0,0,0
1668329476004,ECE 276A,A00,103667,Atanasov; Nikolay A.,0,0,0,0
1668329476430,ECE 277,A00,103668,An; Cheolhong,0,0,0,0
1668329476856,ECE 279,A00,117947,Hall; Drew A.,0,0,0,0
1668329477705,ECE 283,A00,103670,Hsueh; Tzu-Chien,0,0,0,0
1668329478127,ECE 284,A00,103671,Turakhia; Yatish Girish,0,0,0,0
1668329478550,ECE 285,A00,103672,Zheng; Yang,0,0,0,0
1668329478550,ECE 285,B00,103673,Sworder; David D.,0,0,0,0
1668329478977,ECE 287,A00,103676,Javidi; Tara,0,0,0,0
1668329479402,MATH 200B,A00,098023,Salehi Golsefidy; Alireza,12,0,15,3
1668329479827,MATH 202B,A00,098024,Rhoades; Brendon Patrick,9,0,15,6
1668329480252,MATH 203B,A00,098025,Oprea; Dragos N.,10,0,15,5
1668329480678,MATH 204B,A00,098026,Sorensen; Claus M,13,0,15,2
1668329481109,MATH 208,A00,098027,Izadi; Elham,7,0,10,3
1668329481536,MATH 209,A00,098028,Pollack; Aaron,10,0,10,0
1668329481962,MATH 211A,A00,112919,Rogalski; Daniel,9,0,10,1
1668329482392,MATH 211B,A00,112920,Seward; Brandon M.,9,0,10,1
1668329482824,MATH 218,A00,098029,Li; Bo,10,0,10,0
1668329483251,MATH 220B,A00,098030,Novak; Jonathan I,11,0,15,4
1668329483677,MATH 221A,A00,098031,Ebenfelt; Peter F,13,0,15,2
1668329484104,MATH 231B,A00,098032,Zlatos; Andrej,12,0,15,3
1668329484529,MATH 240B,A00,098033,Ni; Lei,9,0,15,6
1668329484955,MATH 243,A00,098034,Jekel; David Andrew,10,0,10,0
1668329485380,MATH 245A,A00,098035,Nie; Jiawang,0,0,15,16
1668329485802,MATH 248,A00,098036,Bejenaru; Ioan,10,0,10,0
1668329486229,MATH 250B,A00,098037,Spolaor; Luca,14,0,15,1
1668329486652,MATH 258,A00,098038,Ni; Lei,10,0,10,0
1668329487076,MATH 264B,A00,098041,Rhoades; Brendon Patrick,9,0,15,6
1668329487502,MATH 268,A00,098042,Buss; Samuel R,10,0,10,0
1668329487926,MATH 269,A00,098043,Rhoades; Brendon Patrick,10,0,10,0
1668329488347,MATH 270B,A00,098044,Li; Bo,10,0,15,5
1668329488776,MATH 272B,A00,098045,Holst; Michael J,13,0,15,2
1668329489201,MATH 273A,A00,098046,Tian; Xiaochuan,10,0,15,5
1668329489625,MATH 275,A01,098048,Tian; Xiaochuan,6,0,10,4
1668329490048,MATH 278A,A00,098049,Holst; Michael J,8,0,10,2
1668329490472,MATH 278B,A00,098050,Cloninger; Alexander,10,0,10,0
1668329490896,MATH 278C,A00,098051,Nie; Jiawang,7,0,10,3
1668329491319,MATH 280B,A00,098052,Zheng; Tianyi,8,0,15,7
1668329491743,MATH 281B,A00,098053,Bradic; Jelena,1,0,15,14
1668329492168,MATH 282B,A00,098054,Arias-Castro; Ery,0,0,15,15
1668329492598,MATH 285,A00,098055,Fitzsimmons; Patrick J,0,0,15,17
1668329493022,MATH 287B,A00,098056,Arias-Castro; Ery,2,0,15,13
1668329493445,MATH 288,A00,098057,Agarwal; Pooja,9,0,10,1
1668329493445,MATH 288,B00,098058,Zhang; Danna,8,0,10,2
1668329493445,MATH 288,C00,098059,Williams; Ruth J,9,0,10,1
1668329493870,MATH 290B,A00,098060,Roberts; Justin Deritter,13,0,15,2
1668329494294,MATH 292,A00,098061,Belmont; Eva Kinoshita,10,0,10,0
1668329494718,MATH 295,A00,098062,Suk; Andrew Hoon,48,0,50,2
1668329495142,MATH 296,A00,098063,Novak; Jonathan I,20,0,20,0
1668329495566,MATH 297,001,098064,Gamst; Anthony Collins,9997,0,9999,2
1668329994674,COGS 205,A00,101395,Chiba; Andrea,19,0,20,1
1668329995106,COGS 210B,001,101404,Greene; Deanna Jacquelyn,9998,0,9999,1
1668329995106,COGS 210B,002,101417,Xia; Haijun,9999,0,9999,0
1668329995106,COGS 210B,003,101422,Nitz; Douglas A.,9999,0,9999,0
1668329995106,COGS 210B,004,101423,Hollan; James D.,9998,0,9999,1
1668329995106,COGS 210B,005,101424,Deak; Gedeon O.,9998,0,9999,1
1668329995106,COGS 210B,006,101425,Rossano; Federico,9999,0,9999,0
1668329995539,COGS 211B,A00,101427,Coulson; Seana M,9996,0,9999,3
1668329995966,COGS 220,A00,101428,Hollan; James D.,0,0,25,25
1668329996392,COGS 229,A00,101429,Dow; Steven P,18,0,25,7
1668329996816,COGS 230,A00,101430,Klemmer; Scott R,11,0,17,6
1668329997242,COGS 234,A00,101431,Xia; Haijun,1,0,25,24
1668329997670,COGS 260,A00,101432,Kiyonaga; Anastasia,21,0,25,4
1668329997670,COGS 260,B00,101433,Kirsh; David Joel,15,0,25,10
1668329998099,CSE 202,A00,102371,Impagliazzo; Russell,0,0,0,0
1668329998527,CSE 203B,A01,102373,Cheng; Chung Kuan,0,0,0,0
1668329998949,CSE 208,A00,102374,Micciancio; Daniele,0,0,0,0
1668329999374,CSE 209A,A00,112895,Impagliazzo; Russell,0,0,15,15
1668329999798,CSE 209B,A00,108005,Bellare; Mihir,0,0,0,0
1668330000224,CSE 210,A00,113163,Coblenz; Michael J,0,0,0,0
1668330000649,CSE 219,A00,106111,Dow; Steven P,0,0,20,20
1668330001074,CSE 221,A00,102376,Voelker; Geoffrey M.,0,0,0,0
1668330001498,CSE 224,A01,102378,Porter; George M,0,0,0,0
1668330001923,CSE 229A,A00,102379,Savage; Stefan,0,0,0,0
1668330002348,CSE 229C,A00,102380,Munyaka; Imani N. S.,0,0,0,0
1668330002798,CSE 232B,A00,102382,Deutsch; Alin Bernard,0,0,0,0
1668330003226,CSE 234,A01,112904,Kumar; Arun Kumar,0,0,0,0
1668330003659,CSE 237A,A00,102383,Rosing; Tajana Simunic,0,0,0,0
1668330004086,CSE 239A,A00,102384,Deutsch; Alin Bernard,0,0,0,0
1668330004512,CSE 239B,A00,102385,Polikarpova; Nadezhda,0,0,0,0
1668330004940,CSE 240A,A00,102386,Pannuto; Patrick William,0,0,0,0
1668330005371,CSE 240B,A00,102387,Zhao; Jishen,0,0,0,0
1668330005795,CSE 241A,A00,106406,Kang; Mingu,0,0,0,0
1668330006230,CSE 249B,A00,102388,Kahng; Andrew Byun,0,0,8,8
1668330006654,CSE 251B,A01,102392,Cottrell; Garrison W,0,0,0,0
1668330006654,CSE 251B,A02,102393,Cottrell; Garrison W,0,0,0,0
1668330007081,CSE 252B,A00,102394,Ochoa; Benjamin Lawrence,0,0,0,0
1668330007504,CSE 257,A01,102396,Gao; Sicun,0,0,0,0
1668330007930,CSE 272,A00,102397,Li; Tzumao,0,0,0,0
1668330008359,CSE 274,A00,111323,Chern; Albert Ren-Haur,0,0,0,0
1668330008788,CSE 282,A00,102398,Pevzner; Pavel Arkadjevich,0,0,0,0
1668330009215,CSE 284,A00,114175,Gymrek; Melissa Ann,0,0,0,0
1668330009644,CSE 290,A00,102399,Chandraker; Manmohan Krishna,0,0,0,0
1668330009644,CSE 290,B00,102400,Vaccaro; Kristen Marie,0,0,25,25
1668330009644,CSE 290,C00,102414,Pannuto; Patrick William,0,0,25,25
1668330009644,CSE 290,D00,102427,Pevzner; Pavel Arkadjevich,0,0,0,0
1668330009644,CSE 290,E00,102429,Zhao; Jishen,0,0,0,0
1668330009644,CSE 290,F00,102436,Tullsen; Dean Michael,0,0,0,0
1668330009644,CSE 290,G00,102440,Christensen; Henrik I,0,0,20,20
1668330010076,CSE 291,A00,102443,Su; Hao,0,0,0,0
1668330010076,CSE 291,B00,102448,Polikarpova; Nadezhda,0,0,0,0
1668330010076,CSE 291,C00,102453,Vaccaro; Kristen Marie,0,0,0,0
1668330010076,CSE 291,D00,111343,Savage; Stefan,0,0,0,0
1668330010076,CSE 291,E00,116474,Claffy; Kimberly Claire,0,0,0,0
1668330010076,CSE 291,F00,116479,Pasquale; Joseph,0,0,0,0
1668330010512,CSE 293,001,119111,Bafna; Vineet,9999,0,9999,0
1668330010512,CSE 293,002,119118,Bellare; Mihir,9999,0,9999,0
1668330010512,CSE 293,003,119122,Berg-Kirkpatrick; Taylor D,9999,0,9999,0
1668330010512,CSE 293,004,119135,Christensen; Henrik I,9999,0,9999,0
1668330010512,CSE 293,005,119142,Cottrell; Garrison W,9999,0,9999,0
1668330010512,CSE 293,006,119146,Deutsch; Alin Bernard,9999,0,9999,0
1668330010512,CSE 293,007,119159,Esmaeilzadeh; Hadi,9999,0,9999,0
1668330010512,CSE 293,008,119166,Freund; Yoav,9999,0,9999,0
1668330010512,CSE 293,009,119170,Griswold; William G.,9999,0,9999,0
1668330010512,CSE 293,010,119183,Gymrek; Melissa Ann,9999,0,9999,0
1668330010512,CSE 293,011,119190,Heninger; Nadia A,9999,0,9999,0
1668330010512,CSE 293,012,119230,Impagliazzo; Russell,9999,0,9999,0
1668330010512,CSE 293,013,119232,Jhala; Ranjit,9999,0,9999,0
1668330010512,CSE 293,014,119233,Kahng; Andrew Byun,9999,0,9999,0
1668330010512,CSE 293,015,119298,Kane; Daniel Mertz,9999,0,9999,0
1668330010512,CSE 293,016,119299,Kriegman; David J,9999,0,9999,0
1668330010512,CSE 293,017,119300,Kumar; Arun Kumar,9999,0,9999,0
1668330010512,CSE 293,018,119301,Lerner; Sorin,9999,0,9999,0
1668330010512,CSE 293,019,119302,Lovett; Shachar,9999,0,9999,0
1668330010512,CSE 293,020,119303,McAuley; Julian John,9999,0,9999,0
1668330010512,CSE 293,021,119304,Micciancio; Daniele,9999,0,9999,0
1668330010512,CSE 293,022,119367,Orailoglu; Alex,9999,0,9999,0
1668330010512,CSE 293,023,119382,Paturi; Ramamohan,9999,0,9999,0
1668330010512,CSE 293,024,119404,Polikarpova; Nadezhda,9999,0,9999,0
1668330010512,CSE 293,025,119406,Politz; Joseph Gibbs,9999,0,9999,0
1668330010512,CSE 293,026,119411,Porter; George M,9999,0,9999,0
1668330010512,CSE 293,027,119414,Porter; Leonard Emerson,9999,0,9999,0
1668330010512,CSE 293,028,119416,Ramamoorthi; Ravi,9999,0,9999,0
1668330010512,CSE 293,029,119417,Sahoo; Debashis,9999,0,9999,0
1668330010512,CSE 293,030,119420,Saul; Lawrence,9999,0,9999,0
1668330010512,CSE 293,031,119421,Savage; Stefan,9999,0,9999,0
1668330010512,CSE 293,032,119425,Schulze; Jurgen P.,9999,0,9999,0
1668330010512,CSE 293,033,119426,Snoeren; Alex C.,9999,0,9999,0
1668330010512,CSE 293,034,119428,Shang; Jingbo,9999,0,9999,0
1668330010512,CSE 293,035,119430,Stefan; Deian,9999,0,9999,0
1668330010512,CSE 293,036,119431,Su; Hao,9999,0,9999,0
1668330010512,CSE 293,037,119433,Swanson; Steven James,9999,0,9999,0
1668330010512,CSE 293,038,119435,Tullsen; Dean Michael,9999,0,9999,0
1668330010512,CSE 293,039,119483,Voelker; Geoffrey M.,9999,0,9999,0
1668330010512,CSE 293,040,119537,Zhao; Jishen,9999,0,9999,0
1668330010512,CSE 293,041,119538,Zhou; Yuan-Yuan,9999,0,9999,0
1668330010512,CSE 293,042,119539,Gao; Sicun,9999,0,9999,0
1668330010512,CSE 293,043,119540,Weibel; Nadir,9999,0,9999,0
1668330010512,CSE 293,044,119541,Gupta; Rajesh K.,9999,0,9999,0
1668330010512,CSE 293,045,126410,Vaccaro; Kristen Marie,9999,0,9999,0
1668330010512,CSE 293,046,126411,Klemke; Richard,9999,0,9999,0
1668330010941,CSE 294,A00,102459,Voelker; Geoffrey M.,0,0,0,0
1668330010941,CSE 294,B00,111322,Orailoglu; Alex,0,0,0,0
1668330011376,DSE 201,A00,096914,Deutsch; Alin Bernard,30,0,30,0
1668330011803,DSE 210,A00,096915,Dasgupta; Sanjoy,30,0,30,0
1668330012230,DSE 260A,A00,096916,Altintas De Callaf; Ilkay,30,0,30,0
1668330012688,ECE 200,001,103586,Antipa; Nicholas A,9999,0,9999,0
1668330012688,ECE 200,002,103587,Atanasov; Nikolay A.,9999,0,9999,0
1668330012688,ECE 200,003,103588,Bharadia; Dinesh,9999,0,9999,0
1668330012688,ECE 200,004,103589,Cheng; Chung Kuan,9999,0,9999,0
1668330012688,ECE 200,005,103590,Cosman; Pamela C.,9999,0,9999,0
1668330012688,ECE 200,006,103591,Dayeh; Shadi Ahmad,9999,0,9999,0
1668330012688,ECE 200,007,103592,Fainman; Yeshaiahu,9999,0,9999,0
1668330012688,ECE 200,008,103593,Ford; Joseph Earl,9999,0,9999,0
1668330012688,ECE 200,009,103594,Franceschetti; Massimo,9999,0,9999,0
1668330012688,ECE 200,010,103595,Fullerton; Eric E,9999,0,9999,0
1668330012688,ECE 200,011,103596,Galton; Ian A,9999,0,9999,0
1668330012688,ECE 200,012,103597,Gilja; Vikash,9999,0,9999,0
1668330012688,ECE 200,013,103598,Hall; Drew A.,9999,0,9999,0
1668330012688,ECE 200,014,103599,Hsueh; Tzu-Chien,9999,0,9999,0
1668330012688,ECE 200,015,103600,Javidi; Tara,9999,0,9999,0
1668330012688,ECE 200,016,103601,Kahng; Andrew Byun,9999,0,9999,0
1668330012688,ECE 200,017,103602,Kim; Young-Han,9999,0,9999,0
1668330012688,ECE 200,018,103603,Koushanfar; Farinaz,9999,0,9999,0
1668330012688,ECE 200,019,103604,Kuzum; Duygu,9999,0,9999,0
1668330012688,ECE 200,020,103605,Le; Hanh-Phuc,9999,0,9999,0
1668330012688,ECE 200,021,103606,Lin; Bill,9999,0,9999,0
1668330012688,ECE 200,022,103607,Liu; Zhaowei,9998,0,9999,1
1668330012688,ECE 200,023,103608,Lo; Yu-Hwa,9999,0,9999,0
1668330012688,ECE 200,024,103609,Lomakin; Vitaliy,9999,0,9999,0
1668330012688,ECE 200,025,103610,Mercier; Patrick Philip,9999,0,9999,0
1668330012688,ECE 200,026,103611,Meyer; Florian,9999,0,9999,0
1668330012688,ECE 200,027,103612,Milstein; Laurence B.,9999,0,9999,0
1668330012688,ECE 200,028,103613,Mir Arabbaygi; Siavash,9999,0,9999,0
1668330012688,ECE 200,029,103614,Mookherjea; Shayan,9999,0,9999,0
1668330012688,ECE 200,030,103615,Morris; Karcher William,9999,0,9999,0
1668330012688,ECE 200,031,103616,Ng; Tse Nga,9999,0,9999,0
1668330012688,ECE 200,032,103617,Nguyen; Truong Quang,9999,0,9999,0
1668330012688,ECE 200,033,103618,Nomura; Kenji,9999,0,9999,0
1668330012688,ECE 200,034,103619,Orlitsky; Alon,9999,0,9999,0
1668330012688,ECE 200,035,103620,Pal; Piya,9999,0,9999,0
1668330012688,ECE 200,036,103621,Papen; George C.,9999,0,9999,0
1668330012688,ECE 200,037,103622,Radic; Stojan,9999,0,9999,0
1668330012688,ECE 200,038,103623,Rao; Bhaskar D.,9999,0,9999,0
1668330012688,ECE 200,039,103624,Rao; Ramesh R,9999,0,9999,0
1668330012688,ECE 200,040,103625,Rebeiz; Gabriel,9999,0,9999,0
1668330012688,ECE 200,041,103626,Sanford; John R,9999,0,9999,0
1668330012688,ECE 200,042,103627,Siegel; Paul H.,9999,0,9999,0
1668330012688,ECE 200,043,103628,Sievenpiper; Daniel F.,9999,0,9999,0
1668330012688,ECE 200,044,103629,Sworder; David D.,9999,0,9999,0
1668330012688,ECE 200,045,103630,Taur; Yuan,9999,0,9999,0
1668330012688,ECE 200,046,103631,Touri; Behrouz,9999,0,9999,0
1668330012688,ECE 200,047,103632,Trivedi; Mohan M.,9999,0,9999,0
1668330012688,ECE 200,048,103633,Vasconcelos; Nuno,9999,0,9999,0
1668330012688,ECE 200,049,103634,Wang; Xiaolong,9999,0,9999,0
1668330012688,ECE 200,050,103635,Xie; Pengtao,9999,0,9999,0
1668330012688,ECE 200,051,103636,Yip; Michael,9999,0,9999,0
1668330012688,ECE 200,052,103637,Zeger; Kenneth A.,999,0,999,0
1668330012688,ECE 200,053,103638,Zhang; Xinyu,9999,0,9999,0
1668330012688,ECE 200,054,103639,Turakhia; Yatish Girish,9999,0,9999,0
1668330012688,ECE 200,055,103640,Kang; Mingu,9999,0,9999,0
1668330012688,ECE 200,056,103641,Shi; Yuanyuan,9999,0,9999,0
1668330012688,ECE 200,057,103642,Wang; Edward Jay,9999,0,9999,0
1668330012688,ECE 200,058,103643,Zheng; Yang,9999,0,9999,0
1668330013116,ECE 202,A00,103644,Kuzum; Duygu,0,0,0,0
1668330013550,ECE 212BN,A00,103646,Ng; Tse Nga,0,0,0,0
1668330013979,ECE 221,A00,111493,Staff,0,0,0,0
1668330014406,ECE 222B,A00,103647,Lomakin; Vitaliy,0,0,0,0
1668330014835,ECE 230B,A00,103648,Taur; Yuan,0,0,0,0
1668330015260,ECE 238B,A00,103649,Garay; Javier,0,0,0,0
1668330015686,ECE 240B,A00,112900,Fainman; Yeshaiahu,0,0,0,0
1668330016114,ECE 247A,A00,103650,Jokerst; Jesse Vincent,0,0,0,0
1668330016537,ECE 247B,A00,103651,Wang; Joseph,0,0,0,0
1668330016961,ECE 250,A00,103652,Siegel; Paul H.,0,0,0,0
1668330017388,ECE 251A,A00,103654,Rao; Bhaskar D.,0,0,0,0
1668330017813,ECE 257B,A00,103655,Bharadia; Dinesh,0,0,0,0
1668330018237,ECE 258A,A00,103656,Milstein; Laurence B.,0,0,0,0
1668330018660,ECE 260B,A00,103658,Kang; Mingu,0,0,0,0
1668330019090,ECE 264A,A00,103659,Galton; Ian A,0,0,0,0
1668330019516,ECE 265A,A00,103661,Gudem; Prasad S.S.,0,0,0,0
1668330019942,ECE 265D,A00,103662,Gudem; Prasad S.S.,0,0,0,0
1668330020370,ECE 268,A00,103663,Koushanfar; Farinaz,0,0,0,0
1668330020801,ECE 269,A01,103665,Pal; Piya,0,0,0,0
1668330021225,ECE 271B,A00,103666,Vasconcelos; Manuela,0,0,0,0
1668330021649,ECE 276A,A00,103667,Atanasov; Nikolay A.,0,0,0,0
1668330022074,ECE 277,A00,103668,An; Cheolhong,0,0,0,0
1668330022497,ECE 279,A00,117947,Hall; Drew A.,0,0,0,0
1668330023348,ECE 283,A00,103670,Hsueh; Tzu-Chien,0,0,0,0
1668330023850,ECE 284,A00,103671,Turakhia; Yatish Girish,0,0,0,0
1668330024285,ECE 285,A00,103672,Zheng; Yang,0,0,0,0
1668330024285,ECE 285,B00,103673,Sworder; David D.,0,0,0,0
1668330024708,ECE 287,A00,103676,Javidi; Tara,0,0,0,0
1668330025141,MATH 200B,A00,098023,Salehi Golsefidy; Alireza,12,0,15,3
1668330025568,MATH 202B,A00,098024,Rhoades; Brendon Patrick,9,0,15,6
1668330026003,MATH 203B,A00,098025,Oprea; Dragos N.,10,0,15,5
1668330026429,MATH 204B,A00,098026,Sorensen; Claus M,13,0,15,2
1668330026853,MATH 208,A00,098027,Izadi; Elham,7,0,10,3
1668330027281,MATH 209,A00,098028,Pollack; Aaron,10,0,10,0
1668330027705,MATH 211A,A00,112919,Rogalski; Daniel,9,0,10,1
1668330028129,MATH 211B,A00,112920,Seward; Brandon M.,9,0,10,1
1668330028553,MATH 218,A00,098029,Li; Bo,10,0,10,0
1668330028980,MATH 220B,A00,098030,Novak; Jonathan I,11,0,15,4
1668330029404,MATH 221A,A00,098031,Ebenfelt; Peter F,13,0,15,2
1668330029829,MATH 231B,A00,098032,Zlatos; Andrej,12,0,15,3
1668330030252,MATH 240B,A00,098033,Ni; Lei,9,0,15,6
1668330030676,MATH 243,A00,098034,Jekel; David Andrew,10,0,10,0
1668330031104,MATH 245A,A00,098035,Nie; Jiawang,0,0,15,16
1668330031527,MATH 248,A00,098036,Bejenaru; Ioan,10,0,10,0
1668330031955,MATH 250B,A00,098037,Spolaor; Luca,14,0,15,1
1668330032377,MATH 258,A00,098038,Ni; Lei,10,0,10,0
1668330032826,MATH 264B,A00,098041,Rhoades; Brendon Patrick,9,0,15,6
1668330033251,MATH 268,A00,098042,Buss; Samuel R,10,0,10,0
1668330033675,MATH 269,A00,098043,Rhoades; Brendon Patrick,10,0,10,0
1668330034105,MATH 270B,A00,098044,Li; Bo,10,0,15,5
1668330034532,MATH 272B,A00,098045,Holst; Michael J,13,0,15,2
1668330034957,MATH 273A,A00,098046,Tian; Xiaochuan,10,0,15,5
1668330035380,MATH 275,A01,098048,Tian; Xiaochuan,6,0,10,4
1668330035808,MATH 278A,A00,098049,Holst; Michael J,8,0,10,2
1668330036230,MATH 278B,A00,098050,Cloninger; Alexander,10,0,10,0
1668330036656,MATH 278C,A00,098051,Nie; Jiawang,7,0,10,3
1668330037079,MATH 280B,A00,098052,Zheng; Tianyi,8,0,15,7
1668330037503,MATH 281B,A00,098053,Bradic; Jelena,1,0,15,14
1668330037931,MATH 282B,A00,098054,Arias-Castro; Ery,0,0,15,15
1668330038355,MATH 285,A00,098055,Fitzsimmons; Patrick J,0,0,15,17
1668330038780,MATH 287B,A00,098056,Arias-Castro; Ery,2,0,15,13
1668330039206,MATH 288,A00,098057,Agarwal; Pooja,9,0,10,1
1668330039206,MATH 288,B00,098058,Zhang; Danna,8,0,10,2
1668330039206,MATH 288,C00,098059,Williams; Ruth J,9,0,10,1
1668330039637,MATH 290B,A00,098060,Roberts; Justin Deritter,13,0,15,2
1668330040064,MATH 292,A00,098061,Belmont; Eva Kinoshita,10,0,10,0
1668330040487,MATH 295,A00,098062,Suk; Andrew Hoon,48,0,50,2
1668330040912,MATH 296,A00,098063,Novak; Jonathan I,20,0,20,0
1668330041338,MATH 297,001,098064,Gamst; Anthony Collins,9997,0,9999,2
1668330540381,COGS 205,A00,101395,Chiba; Andrea,19,0,20,1
1668330540809,COGS 210B,001,101404,Greene; Deanna Jacquelyn,9998,0,9999,1
1668330540809,COGS 210B,002,101417,Xia; Haijun,9999,0,9999,0
1668330540809,COGS 210B,003,101422,Nitz; Douglas A.,9999,0,9999,0
1668330540809,COGS 210B,004,101423,Hollan; James D.,9998,0,9999,1
1668330540809,COGS 210B,005,101424,Deak; Gedeon O.,9998,0,9999,1
1668330540809,COGS 210B,006,101425,Rossano; Federico,9999,0,9999,0
1668330541234,COGS 211B,A00,101427,Coulson; Seana M,9996,0,9999,3
1668330541659,COGS 220,A00,101428,Hollan; James D.,0,0,25,25
1668330542082,COGS 229,A00,101429,Dow; Steven P,18,0,25,7
1668330542508,COGS 230,A00,101430,Klemmer; Scott R,11,0,17,6
1668330543008,COGS 234,A00,101431,Xia; Haijun,1,0,25,24
1668330543432,COGS 260,A00,101432,Kiyonaga; Anastasia,21,0,25,4
1668330543432,COGS 260,B00,101433,Kirsh; David Joel,15,0,25,10
1668330543867,CSE 202,A00,102371,Impagliazzo; Russell,0,0,0,0
1668330544302,CSE 203B,A01,102373,Cheng; Chung Kuan,0,0,0,0
1668330544731,CSE 208,A00,102374,Micciancio; Daniele,0,0,0,0
1668330545154,CSE 209A,A00,112895,Impagliazzo; Russell,0,0,15,15
1668330545579,CSE 209B,A00,108005,Bellare; Mihir,0,0,0,0
1668330546005,CSE 210,A00,113163,Coblenz; Michael J,0,0,0,0
1668330546430,CSE 219,A00,106111,Dow; Steven P,0,0,20,20
1668330546862,CSE 221,A00,102376,Voelker; Geoffrey M.,0,0,0,0
1668330547287,CSE 224,A01,102378,Porter; George M,0,0,0,0
1668330547717,CSE 229A,A00,102379,Savage; Stefan,0,0,0,0
1668330548142,CSE 229C,A00,102380,Munyaka; Imani N. S.,0,0,0,0
1668330548568,CSE 232B,A00,102382,Deutsch; Alin Bernard,0,0,0,0
1668330548992,CSE 234,A01,112904,Kumar; Arun Kumar,0,0,0,0
1668330549426,CSE 237A,A00,102383,Rosing; Tajana Simunic,0,0,0,0
1668330549853,CSE 239A,A00,102384,Deutsch; Alin Bernard,0,0,0,0
1668330550277,CSE 239B,A00,102385,Polikarpova; Nadezhda,0,0,0,0
1668330550700,CSE 240A,A00,102386,Pannuto; Patrick William,0,0,0,0
1668330551125,CSE 240B,A00,102387,Zhao; Jishen,0,0,0,0
1668330551549,CSE 241A,A00,106406,Kang; Mingu,0,0,0,0
1668330551974,CSE 249B,A00,102388,Kahng; Andrew Byun,0,0,8,8
1668330552399,CSE 251B,A01,102392,Cottrell; Garrison W,0,0,0,0
1668330552399,CSE 251B,A02,102393,Cottrell; Garrison W,0,0,0,0
1668330552821,CSE 252B,A00,102394,Ochoa; Benjamin Lawrence,0,0,0,0
1668330553247,CSE 257,A01,102396,Gao; Sicun,0,0,0,0
1668330553670,CSE 272,A00,102397,Li; Tzumao,0,0,0,0
1668330554092,CSE 274,A00,111323,Chern; Albert Ren-Haur,0,0,0,0
1668330554518,CSE 282,A00,102398,Pevzner; Pavel Arkadjevich,0,0,0,0
1668330554944,CSE 284,A00,114175,Gymrek; Melissa Ann,0,0,0,0
1668330555369,CSE 290,A00,102399,Chandraker; Manmohan Krishna,0,0,0,0
1668330555369,CSE 290,B00,102400,Vaccaro; Kristen Marie,0,0,25,25
1668330555369,CSE 290,C00,102414,Pannuto; Patrick William,0,0,25,25
1668330555369,CSE 290,D00,102427,Pevzner; Pavel Arkadjevich,0,0,0,0
1668330555369,CSE 290,E00,102429,Zhao; Jishen,0,0,0,0
1668330555369,CSE 290,F00,102436,Tullsen; Dean Michael,0,0,0,0
1668330555369,CSE 290,G00,102440,Christensen; Henrik I,0,0,20,20
1668330555792,CSE 291,A00,102443,Su; Hao,0,0,0,0
1668330555792,CSE 291,B00,102448,Polikarpova; Nadezhda,0,0,0,0
1668330555792,CSE 291,C00,102453,Vaccaro; Kristen Marie,0,0,0,0
1668330555792,CSE 291,D00,111343,Savage; Stefan,0,0,0,0
1668330555792,CSE 291,E00,116474,Claffy; Kimberly Claire,0,0,0,0
1668330555792,CSE 291,F00,116479,Pasquale; Joseph,0,0,0,0
1668330556225,CSE 293,001,119111,Bafna; Vineet,9999,0,9999,0
1668330556225,CSE 293,002,119118,Bellare; Mihir,9999,0,9999,0
1668330556225,CSE 293,003,119122,Berg-Kirkpatrick; Taylor D,9999,0,9999,0
1668330556225,CSE 293,004,119135,Christensen; Henrik I,9999,0,9999,0
1668330556225,CSE 293,005,119142,Cottrell; Garrison W,9999,0,9999,0
1668330556225,CSE 293,006,119146,Deutsch; Alin Bernard,9999,0,9999,0
1668330556225,CSE 293,007,119159,Esmaeilzadeh; Hadi,9999,0,9999,0
1668330556225,CSE 293,008,119166,Freund; Yoav,9999,0,9999,0
1668330556225,CSE 293,009,119170,Griswold; William G.,9999,0,9999,0
1668330556225,CSE 293,010,119183,Gymrek; Melissa Ann,9999,0,9999,0
1668330556225,CSE 293,011,119190,Heninger; Nadia A,9999,0,9999,0
1668330556225,CSE 293,012,119230,Impagliazzo; Russell,9999,0,9999,0
1668330556225,CSE 293,013,119232,Jhala; Ranjit,9999,0,9999,0
1668330556225,CSE 293,014,119233,Kahng; Andrew Byun,9999,0,9999,0
1668330556225,CSE 293,015,119298,Kane; Daniel Mertz,9999,0,9999,0
1668330556225,CSE 293,016,119299,Kriegman; David J,9999,0,9999,0
1668330556225,CSE 293,017,119300,Kumar; Arun Kumar,9999,0,9999,0
1668330556225,CSE 293,018,119301,Lerner; Sorin,9999,0,9999,0
1668330556225,CSE 293,019,119302,Lovett; Shachar,9999,0,9999,0
1668330556225,CSE 293,020,119303,McAuley; Julian John,9999,0,9999,0
1668330556225,CSE 293,021,119304,Micciancio; Daniele,9999,0,9999,0
1668330556225,CSE 293,022,119367,Orailoglu; Alex,9999,0,9999,0
1668330556225,CSE 293,023,119382,Paturi; Ramamohan,9999,0,9999,0
1668330556225,CSE 293,024,119404,Polikarpova; Nadezhda,9999,0,9999,0
1668330556225,CSE 293,025,119406,Politz; Joseph Gibbs,9999,0,9999,0
1668330556225,CSE 293,026,119411,Porter; George M,9999,0,9999,0
1668330556225,CSE 293,027,119414,Porter; Leonard Emerson,9999,0,9999,0
1668330556225,CSE 293,028,119416,Ramamoorthi; Ravi,9999,0,9999,0
1668330556225,CSE 293,029,119417,Sahoo; Debashis,9999,0,9999,0
1668330556225,CSE 293,030,119420,Saul; Lawrence,9999,0,9999,0
1668330556225,CSE 293,031,119421,Savage; Stefan,9999,0,9999,0
1668330556225,CSE 293,032,119425,Schulze; Jurgen P.,9999,0,9999,0
1668330556225,CSE 293,033,119426,Snoeren; Alex C.,9999,0,9999,0
1668330556225,CSE 293,034,119428,Shang; Jingbo,9999,0,9999,0
1668330556225,CSE 293,035,119430,Stefan; Deian,9999,0,9999,0
1668330556225,CSE 293,036,119431,Su; Hao,9999,0,9999,0
1668330556225,CSE 293,037,119433,Swanson; Steven James,9999,0,9999,0
1668330556225,CSE 293,038,119435,Tullsen; Dean Michael,9999,0,9999,0
1668330556225,CSE 293,039,119483,Voelker; Geoffrey M.,9999,0,9999,0
1668330556225,CSE 293,040,119537,Zhao; Jishen,9999,0,9999,0
1668330556225,CSE 293,041,119538,Zhou; Yuan-Yuan,9999,0,9999,0
1668330556225,CSE 293,042,119539,Gao; Sicun,9999,0,9999,0
1668330556225,CSE 293,043,119540,Weibel; Nadir,9999,0,9999,0
1668330556225,CSE 293,044,119541,Gupta; Rajesh K.,9999,0,9999,0
1668330556225,CSE 293,045,126410,Vaccaro; Kristen Marie,9999,0,9999,0
1668330556225,CSE 293,046,126411,Klemke; Richard,9999,0,9999,0
1668330556650,CSE 294,A00,102459,Voelker; Geoffrey M.,0,0,0,0
1668330556650,CSE 294,B00,111322,Orailoglu; Alex,0,0,0,0
1668330557074,DSE 201,A00,096914,Deutsch; Alin Bernard,30,0,30,0
1668330557506,DSE 210,A00,096915,Dasgupta; Sanjoy,30,0,30,0
1668330557930,DSE 260A,A00,096916,Altintas De Callaf; Ilkay,30,0,30,0
1668330558393,ECE 200,001,103586,Antipa; Nicholas A,9999,0,9999,0
1668330558393,ECE 200,002,103587,Atanasov; Nikolay A.,9999,0,9999,0
1668330558393,ECE 200,003,103588,Bharadia; Dinesh,9999,0,9999,0
1668330558393,ECE 200,004,103589,Cheng; Chung Kuan,9999,0,9999,0
1668330558393,ECE 200,005,103590,Cosman; Pamela C.,9999,0,9999,0
1668330558393,ECE 200,006,103591,Dayeh; Shadi Ahmad,9999,0,9999,0
1668330558393,ECE 200,007,103592,Fainman; Yeshaiahu,9999,0,9999,0
1668330558393,ECE 200,008,103593,Ford; Joseph Earl,9999,0,9999,0
1668330558393,ECE 200,009,103594,Franceschetti; Massimo,9999,0,9999,0
1668330558393,ECE 200,010,103595,Fullerton; Eric E,9999,0,9999,0
1668330558393,ECE 200,011,103596,Galton; Ian A,9999,0,9999,0
1668330558393,ECE 200,012,103597,Gilja; Vikash,9999,0,9999,0
1668330558393,ECE 200,013,103598,Hall; Drew A.,9999,0,9999,0
1668330558393,ECE 200,014,103599,Hsueh; Tzu-Chien,9999,0,9999,0
1668330558393,ECE 200,015,103600,Javidi; Tara,9999,0,9999,0
1668330558393,ECE 200,016,103601,Kahng; Andrew Byun,9999,0,9999,0
1668330558393,ECE 200,017,103602,Kim; Young-Han,9999,0,9999,0
1668330558393,ECE 200,018,103603,Koushanfar; Farinaz,9999,0,9999,0
1668330558393,ECE 200,019,103604,Kuzum; Duygu,9999,0,9999,0
1668330558393,ECE 200,020,103605,Le; Hanh-Phuc,9999,0,9999,0
1668330558393,ECE 200,021,103606,Lin; Bill,9999,0,9999,0
1668330558393,ECE 200,022,103607,Liu; Zhaowei,9998,0,9999,1
1668330558393,ECE 200,023,103608,Lo; Yu-Hwa,9999,0,9999,0
1668330558393,ECE 200,024,103609,Lomakin; Vitaliy,9999,0,9999,0
1668330558393,ECE 200,025,103610,Mercier; Patrick Philip,9999,0,9999,0
1668330558393,ECE 200,026,103611,Meyer; Florian,9999,0,9999,0
1668330558393,ECE 200,027,103612,Milstein; Laurence B.,9999,0,9999,0
1668330558393,ECE 200,028,103613,Mir Arabbaygi; Siavash,9999,0,9999,0
1668330558393,ECE 200,029,103614,Mookherjea; Shayan,9999,0,9999,0
1668330558393,ECE 200,030,103615,Morris; Karcher William,9999,0,9999,0
1668330558393,ECE 200,031,103616,Ng; Tse Nga,9999,0,9999,0
1668330558393,ECE 200,032,103617,Nguyen; Truong Quang,9999,0,9999,0
1668330558393,ECE 200,033,103618,Nomura; Kenji,9999,0,9999,0
1668330558393,ECE 200,034,103619,Orlitsky; Alon,9999,0,9999,0
1668330558393,ECE 200,035,103620,Pal; Piya,9999,0,9999,0
1668330558393,ECE 200,036,103621,Papen; George C.,9999,0,9999,0
1668330558393,ECE 200,037,103622,Radic; Stojan,9999,0,9999,0
1668330558393,ECE 200,038,103623,Rao; Bhaskar D.,9999,0,9999,0
1668330558393,ECE 200,039,103624,Rao; Ramesh R,9999,0,9999,0
1668330558393,ECE 200,040,103625,Rebeiz; Gabriel,9999,0,9999,0
1668330558393,ECE 200,041,103626,Sanford; John R,9999,0,9999,0
1668330558393,ECE 200,042,103627,Siegel; Paul H.,9999,0,9999,0
1668330558393,ECE 200,043,103628,Sievenpiper; Daniel F.,9999,0,9999,0
1668330558393,ECE 200,044,103629,Sworder; David D.,9999,0,9999,0
1668330558393,ECE 200,045,103630,Taur; Yuan,9999,0,9999,0
1668330558393,ECE 200,046,103631,Touri; Behrouz,9999,0,9999,0
1668330558393,ECE 200,047,103632,Trivedi; Mohan M.,9999,0,9999,0
1668330558393,ECE 200,048,103633,Vasconcelos; Nuno,9999,0,9999,0
1668330558393,ECE 200,049,103634,Wang; Xiaolong,9999,0,9999,0
1668330558393,ECE 200,050,103635,Xie; Pengtao,9999,0,9999,0
1668330558393,ECE 200,051,103636,Yip; Michael,9999,0,9999,0
1668330558393,ECE 200,052,103637,Zeger; Kenneth A.,999,0,999,0
1668330558393,ECE 200,053,103638,Zhang; Xinyu,9999,0,9999,0
1668330558393,ECE 200,054,103639,Turakhia; Yatish Girish,9999,0,9999,0
1668330558393,ECE 200,055,103640,Kang; Mingu,9999,0,9999,0
1668330558393,ECE 200,056,103641,Shi; Yuanyuan,9999,0,9999,0
1668330558393,ECE 200,057,103642,Wang; Edward Jay,9999,0,9999,0
1668330558393,ECE 200,058,103643,Zheng; Yang,9999,0,9999,0
1668330558818,ECE 202,A00,103644,Kuzum; Duygu,0,0,0,0
1668330559244,ECE 212BN,A00,103646,Ng; Tse Nga,0,0,0,0
1668330559671,ECE 221,A00,111493,Staff,0,0,0,0
1668330560094,ECE 222B,A00,103647,Lomakin; Vitaliy,0,0,0,0
1668330560521,ECE 230B,A00,103648,Taur; Yuan,0,0,0,0
1668330560945,ECE 238B,A00,103649,Garay; Javier,0,0,0,0
1668330561368,ECE 240B,A00,112900,Fainman; Yeshaiahu,0,0,0,0
1668330561793,ECE 247A,A00,103650,Jokerst; Jesse Vincent,0,0,0,0
1668330562218,ECE 247B,A00,103651,Wang; Joseph,0,0,0,0
1668330562649,ECE 250,A00,103652,Siegel; Paul H.,0,0,0,0
1668330563075,ECE 251A,A00,103654,Rao; Bhaskar D.,0,0,0,0
1668330563499,ECE 257B,A00,103655,Bharadia; Dinesh,0,0,0,0
1668330563922,ECE 258A,A00,103656,Milstein; Laurence B.,0,0,0,0
1668330564351,ECE 260B,A00,103658,Kang; Mingu,0,0,0,0
1668330564775,ECE 264A,A00,103659,Galton; Ian A,0,0,0,0
1668330565204,ECE 265A,A00,103661,Gudem; Prasad S.S.,0,0,0,0
1668330565628,ECE 265D,A00,103662,Gudem; Prasad S.S.,0,0,0,0
1668330566051,ECE 268,A00,103663,Koushanfar; Farinaz,0,0,0,0
1668330566483,ECE 269,A01,103665,Pal; Piya,0,0,0,0
1668330566907,ECE 271B,A00,103666,Vasconcelos; Manuela,0,0,0,0
1668330567330,ECE 276A,A00,103667,Atanasov; Nikolay A.,0,0,0,0
1668330567755,ECE 277,A00,103668,An; Cheolhong,0,0,0,0
1668330568178,ECE 279,A00,117947,Hall; Drew A.,0,0,0,0
1668330569026,ECE 283,A00,103670,Hsueh; Tzu-Chien,0,0,0,0
1668330569454,ECE 284,A00,103671,Turakhia; Yatish Girish,0,0,0,0
1668330569878,ECE 285,A00,103672,Zheng; Yang,0,0,0,0
1668330569878,ECE 285,B00,103673,Sworder; David D.,0,0,0,0
1668330570304,ECE 287,A00,103676,Javidi; Tara,0,0,0,0
1668330570732,MATH 200B,A00,098023,Salehi Golsefidy; Alireza,12,0,15,3
1668330571154,MATH 202B,A00,098024,Rhoades; Brendon Patrick,9,0,15,6
1668330571582,MATH 203B,A00,098025,Oprea; Dragos N.,10,0,15,5
1668330572011,MATH 204B,A00,098026,Sorensen; Claus M,13,0,15,2
1668330572433,MATH 208,A00,098027,Izadi; Elham,7,0,10,3
1668330572856,MATH 209,A00,098028,Pollack; Aaron,10,0,10,0
1668330573283,MATH 211A,A00,112919,Rogalski; Daniel,9,0,10,1
1668330573710,MATH 211B,A00,112920,Seward; Brandon M.,9,0,10,1
1668330574136,MATH 218,A00,098029,Li; Bo,10,0,10,0
1668330574561,MATH 220B,A00,098030,Novak; Jonathan I,11,0,15,4
1668330574987,MATH 221A,A00,098031,Ebenfelt; Peter F,13,0,15,2
1668330575418,MATH 231B,A00,098032,Zlatos; Andrej,12,0,15,3
1668330575843,MATH 240B,A00,098033,Ni; Lei,9,0,15,6
1668330576267,MATH 243,A00,098034,Jekel; David Andrew,10,0,10,0
1668330576690,MATH 245A,A00,098035,Nie; Jiawang,0,0,15,16
1668330577112,MATH 248,A00,098036,Bejenaru; Ioan,10,0,10,0
1668330577535,MATH 250B,A00,098037,Spolaor; Luca,14,0,15,1
1668330577961,MATH 258,A00,098038,Ni; Lei,10,0,10,0
1668330578384,MATH 264B,A00,098041,Rhoades; Brendon Patrick,9,0,15,6
1668330578809,MATH 268,A00,098042,Buss; Samuel R,10,0,10,0
1668330579234,MATH 269,A00,098043,Rhoades; Brendon Patrick,10,0,10,0
1668330579663,MATH 270B,A00,098044,Li; Bo,10,0,15,5
1668330580088,MATH 272B,A00,098045,Holst; Michael J,13,0,15,2
1668330580514,MATH 273A,A00,098046,Tian; Xiaochuan,10,0,15,5
1668330580942,MATH 275,A01,098048,Tian; Xiaochuan,6,0,10,4
1668330581368,MATH 278A,A00,098049,Holst; Michael J,8,0,10,2
1668330581792,MATH 278B,A00,098050,Cloninger; Alexander,10,0,10,0
1668330582217,MATH 278C,A00,098051,Nie; Jiawang,7,0,10,3
1668330582638,MATH 280B,A00,098052,Zheng; Tianyi,8,0,15,7
1668330583062,MATH 281B,A00,098053,Bradic; Jelena,1,0,15,14
1668330583487,MATH 282B,A00,098054,Arias-Castro; Ery,0,0,15,15
1668330583912,MATH 285,A00,098055,Fitzsimmons; Patrick J,0,0,15,17
1668330584336,MATH 287B,A00,098056,Arias-Castro; Ery,2,0,15,13
1668330584762,MATH 288,A00,098057,Agarwal; Pooja,9,0,10,1
1668330584762,MATH 288,B00,098058,Zhang; Danna,8,0,10,2
1668330584762,MATH 288,C00,098059,Williams; Ruth J,9,0,10,1
1668330585186,MATH 290B,A00,098060,Roberts; Justin Deritter,13,0,15,2
1668330585608,MATH 292,A00,098061,Belmont; Eva Kinoshita,10,0,10,0
1668330586127,MATH 295,A00,098062,Suk; Andrew Hoon,48,0,50,2
1668330586551,MATH 296,A00,098063,Novak; Jonathan I,20,0,20,0
1668330586976,MATH 297,001,098064,Gamst; Anthony Collins,9997,0,9999,2
1668331086251,COGS 205,A00,101395,Chiba; Andrea,19,0,20,1
1668331086682,COGS 210B,001,101404,Greene; Deanna Jacquelyn,9998,0,9999,1
1668331086682,COGS 210B,002,101417,Xia; Haijun,9999,0,9999,0
1668331086682,COGS 210B,003,101422,Nitz; Douglas A.,9999,0,9999,0
1668331086682,COGS 210B,004,101423,Hollan; James D.,9998,0,9999,1
1668331086682,COGS 210B,005,101424,Deak; Gedeon O.,9998,0,9999,1
1668331086682,COGS 210B,006,101425,Rossano; Federico,9999,0,9999,0
1668331087106,COGS 211B,A00,101427,Coulson; Seana M,9996,0,9999,3
1668331087532,COGS 220,A00,101428,Hollan; James D.,0,0,25,25
1668331087957,COGS 229,A00,101429,Dow; Steven P,18,0,25,7
1668331088384,COGS 230,A00,101430,Klemmer; Scott R,11,0,17,6
1668331088814,COGS 234,A00,101431,Xia; Haijun,1,0,25,24
1668331089244,COGS 260,A00,101432,Kiyonaga; Anastasia,21,0,25,4
1668331089244,COGS 260,B00,101433,Kirsh; David Joel,15,0,25,10
1668331089668,CSE 202,A00,102371,Impagliazzo; Russell,0,0,0,0
1668331090095,CSE 203B,A01,102373,Cheng; Chung Kuan,0,0,0,0
1668331090521,CSE 208,A00,102374,Micciancio; Daniele,0,0,0,0
1668331090944,CSE 209A,A00,112895,Impagliazzo; Russell,0,0,15,15
1668331091370,CSE 209B,A00,108005,Bellare; Mihir,0,0,0,0
1668331091803,CSE 210,A00,113163,Coblenz; Michael J,0,0,0,0
1668331092227,CSE 219,A00,106111,Dow; Steven P,0,0,20,20
1668331092652,CSE 221,A00,102376,Voelker; Geoffrey M.,0,0,0,0
1668331093081,CSE 224,A01,102378,Porter; George M,0,0,0,0
1668331093507,CSE 229A,A00,102379,Savage; Stefan,0,0,0,0
1668331093933,CSE 229C,A00,102380,Munyaka; Imani N. S.,0,0,0,0
1668331094358,CSE 232B,A00,102382,Deutsch; Alin Bernard,0,0,0,0
1668331094786,CSE 234,A01,112904,Kumar; Arun Kumar,0,0,0,0
1668331095212,CSE 237A,A00,102383,Rosing; Tajana Simunic,0,0,0,0
1668331095633,CSE 239A,A00,102384,Deutsch; Alin Bernard,0,0,0,0
1668331096059,CSE 239B,A00,102385,Polikarpova; Nadezhda,0,0,0,0
1668331096483,CSE 240A,A00,102386,Pannuto; Patrick William,0,0,0,0
1668331096910,CSE 240B,A00,102387,Zhao; Jishen,0,0,0,0
1668331097337,CSE 241A,A00,106406,Kang; Mingu,0,0,0,0
1668331097759,CSE 249B,A00,102388,Kahng; Andrew Byun,0,0,8,8
1668331098187,CSE 251B,A01,102392,Cottrell; Garrison W,0,0,0,0
1668331098187,CSE 251B,A02,102393,Cottrell; Garrison W,0,0,0,0
1668331098610,CSE 252B,A00,102394,Ochoa; Benjamin Lawrence,0,0,0,0
1668331099036,CSE 257,A01,102396,Gao; Sicun,0,0,0,0
1668331099461,CSE 272,A00,102397,Li; Tzumao,0,0,0,0
1668331099884,CSE 274,A00,111323,Chern; Albert Ren-Haur,0,0,0,0
1668331100309,CSE 282,A00,102398,Pevzner; Pavel Arkadjevich,0,0,0,0
1668331100733,CSE 284,A00,114175,Gymrek; Melissa Ann,0,0,0,0
1668331101159,CSE 290,A00,102399,Chandraker; Manmohan Krishna,0,0,0,0
1668331101159,CSE 290,B00,102400,Vaccaro; Kristen Marie,0,0,25,25
1668331101159,CSE 290,C00,102414,Pannuto; Patrick William,0,0,25,25
1668331101159,CSE 290,D00,102427,Pevzner; Pavel Arkadjevich,0,0,0,0
1668331101159,CSE 290,E00,102429,Zhao; Jishen,0,0,0,0
1668331101159,CSE 290,F00,102436,Tullsen; Dean Michael,0,0,0,0
1668331101159,CSE 290,G00,102440,Christensen; Henrik I,0,0,20,20
1668331101588,CSE 291,A00,102443,Su; Hao,0,0,0,0
1668331101588,CSE 291,B00,102448,Polikarpova; Nadezhda,0,0,0,0
1668331101588,CSE 291,C00,102453,Vaccaro; Kristen Marie,0,0,0,0
1668331101588,CSE 291,D00,111343,Savage; Stefan,0,0,0,0
1668331101588,CSE 291,E00,116474,Claffy; Kimberly Claire,0,0,0,0
1668331101588,CSE 291,F00,116479,Pasquale; Joseph,0,0,0,0
1668331102034,CSE 293,001,119111,Bafna; Vineet,9999,0,9999,0
1668331102034,CSE 293,002,119118,Bellare; Mihir,9999,0,9999,0
1668331102034,CSE 293,003,119122,Berg-Kirkpatrick; Taylor D,9999,0,9999,0
1668331102034,CSE 293,004,119135,Christensen; Henrik I,9999,0,9999,0
1668331102034,CSE 293,005,119142,Cottrell; Garrison W,9999,0,9999,0
1668331102034,CSE 293,006,119146,Deutsch; Alin Bernard,9999,0,9999,0
1668331102034,CSE 293,007,119159,Esmaeilzadeh; Hadi,9999,0,9999,0
1668331102034,CSE 293,008,119166,Freund; Yoav,9999,0,9999,0
1668331102034,CSE 293,009,119170,Griswold; William G.,9999,0,9999,0
1668331102034,CSE 293,010,119183,Gymrek; Melissa Ann,9999,0,9999,0
1668331102034,CSE 293,011,119190,Heninger; Nadia A,9999,0,9999,0
1668331102034,CSE 293,012,119230,Impagliazzo; Russell,9999,0,9999,0
1668331102034,CSE 293,013,119232,Jhala; Ranjit,9999,0,9999,0
1668331102034,CSE 293,014,119233,Kahng; Andrew Byun,9999,0,9999,0
1668331102034,CSE 293,015,119298,Kane; Daniel Mertz,9999,0,9999,0
1668331102034,CSE 293,016,119299,Kriegman; David J,9999,0,9999,0
1668331102034,CSE 293,017,119300,Kumar; Arun Kumar,9999,0,9999,0
1668331102034,CSE 293,018,119301,Lerner; Sorin,9999,0,9999,0
1668331102034,CSE 293,019,119302,Lovett; Shachar,9999,0,9999,0
1668331102034,CSE 293,020,119303,McAuley; Julian John,9999,0,9999,0
1668331102034,CSE 293,021,119304,Micciancio; Daniele,9999,0,9999,0
1668331102034,CSE 293,022,119367,Orailoglu; Alex,9999,0,9999,0
1668331102034,CSE 293,023,119382,Paturi; Ramamohan,9999,0,9999,0
1668331102034,CSE 293,024,119404,Polikarpova; Nadezhda,9999,0,9999,0
1668331102034,CSE 293,025,119406,Politz; Joseph Gibbs,9999,0,9999,0
1668331102034,CSE 293,026,119411,Porter; George M,9999,0,9999,0
1668331102034,CSE 293,027,119414,Porter; Leonard Emerson,9999,0,9999,0
1668331102034,CSE 293,028,119416,Ramamoorthi; Ravi,9999,0,9999,0
1668331102034,CSE 293,029,119417,Sahoo; Debashis,9999,0,9999,0
1668331102034,CSE 293,030,119420,Saul; Lawrence,9999,0,9999,0
1668331102034,CSE 293,031,119421,Savage; Stefan,9999,0,9999,0
1668331102034,CSE 293,032,119425,Schulze; Jurgen P.,9999,0,9999,0
1668331102034,CSE 293,033,119426,Snoeren; Alex C.,9999,0,9999,0
1668331102034,CSE 293,034,119428,Shang; Jingbo,9999,0,9999,0
1668331102034,CSE 293,035,119430,Stefan; Deian,9999,0,9999,0
1668331102034,CSE 293,036,119431,Su; Hao,9999,0,9999,0
1668331102034,CSE 293,037,119433,Swanson; Steven James,9999,0,9999,0
1668331102034,CSE 293,038,119435,Tullsen; Dean Michael,9999,0,9999,0
1668331102034,CSE 293,039,119483,Voelker; Geoffrey M.,9999,0,9999,0
1668331102034,CSE 293,040,119537,Zhao; Jishen,9999,0,9999,0
1668331102034,CSE 293,041,119538,Zhou; Yuan-Yuan,9999,0,9999,0
1668331102034,CSE 293,042,119539,Gao; Sicun,9999,0,9999,0
1668331102034,CSE 293,043,119540,Weibel; Nadir,9999,0,9999,0
1668331102034,CSE 293,044,119541,Gupta; Rajesh K.,9999,0,9999,0
1668331102034,CSE 293,045,126410,Vaccaro; Kristen Marie,9999,0,9999,0
1668331102034,CSE 293,046,126411,Klemke; Richard,9999,0,9999,0
1668331102459,CSE 294,A00,102459,Voelker; Geoffrey M.,0,0,0,0
1668331102459,CSE 294,B00,111322,Orailoglu; Alex,0,0,0,0
1668331102885,DSE 201,A00,096914,Deutsch; Alin Bernard,30,0,30,0
1668331103308,DSE 210,A00,096915,Dasgupta; Sanjoy,30,0,30,0
1668331103734,DSE 260A,A00,096916,Altintas De Callaf; Ilkay,30,0,30,0
1668331104169,ECE 200,001,103586,Antipa; Nicholas A,9999,0,9999,0
1668331104169,ECE 200,002,103587,Atanasov; Nikolay A.,9999,0,9999,0
1668331104169,ECE 200,003,103588,Bharadia; Dinesh,9999,0,9999,0
1668331104169,ECE 200,004,103589,Cheng; Chung Kuan,9999,0,9999,0
1668331104169,ECE 200,005,103590,Cosman; Pamela C.,9999,0,9999,0
1668331104169,ECE 200,006,103591,Dayeh; Shadi Ahmad,9999,0,9999,0
1668331104169,ECE 200,007,103592,Fainman; Yeshaiahu,9999,0,9999,0
1668331104169,ECE 200,008,103593,Ford; Joseph Earl,9999,0,9999,0
1668331104169,ECE 200,009,103594,Franceschetti; Massimo,9999,0,9999,0
1668331104169,ECE 200,010,103595,Fullerton; Eric E,9999,0,9999,0
1668331104169,ECE 200,011,103596,Galton; Ian A,9999,0,9999,0
1668331104169,ECE 200,012,103597,Gilja; Vikash,9999,0,9999,0
1668331104169,ECE 200,013,103598,Hall; Drew A.,9999,0,9999,0
1668331104169,ECE 200,014,103599,Hsueh; Tzu-Chien,9999,0,9999,0
1668331104169,ECE 200,015,103600,Javidi; Tara,9999,0,9999,0
1668331104169,ECE 200,016,103601,Kahng; Andrew Byun,9999,0,9999,0
1668331104169,ECE 200,017,103602,Kim; Young-Han,9999,0,9999,0
1668331104169,ECE 200,018,103603,Koushanfar; Farinaz,9999,0,9999,0
1668331104169,ECE 200,019,103604,Kuzum; Duygu,9999,0,9999,0
1668331104169,ECE 200,020,103605,Le; Hanh-Phuc,9999,0,9999,0
1668331104169,ECE 200,021,103606,Lin; Bill,9999,0,9999,0
1668331104169,ECE 200,022,103607,Liu; Zhaowei,9998,0,9999,1
1668331104169,ECE 200,023,103608,Lo; Yu-Hwa,9999,0,9999,0
1668331104169,ECE 200,024,103609,Lomakin; Vitaliy,9999,0,9999,0
1668331104169,ECE 200,025,103610,Mercier; Patrick Philip,9999,0,9999,0
1668331104169,ECE 200,026,103611,Meyer; Florian,9999,0,9999,0
1668331104169,ECE 200,027,103612,Milstein; Laurence B.,9999,0,9999,0
1668331104169,ECE 200,028,103613,Mir Arabbaygi; Siavash,9999,0,9999,0
1668331104169,ECE 200,029,103614,Mookherjea; Shayan,9999,0,9999,0
1668331104169,ECE 200,030,103615,Morris; Karcher William,9999,0,9999,0
1668331104169,ECE 200,031,103616,Ng; Tse Nga,9999,0,9999,0
1668331104169,ECE 200,032,103617,Nguyen; Truong Quang,9999,0,9999,0
1668331104169,ECE 200,033,103618,Nomura; Kenji,9999,0,9999,0
1668331104169,ECE 200,034,103619,Orlitsky; Alon,9999,0,9999,0
1668331104169,ECE 200,035,103620,Pal; Piya,9999,0,9999,0
1668331104169,ECE 200,036,103621,Papen; George C.,9999,0,9999,0
1668331104169,ECE 200,037,103622,Radic; Stojan,9999,0,9999,0
1668331104169,ECE 200,038,103623,Rao; Bhaskar D.,9999,0,9999,0
1668331104169,ECE 200,039,103624,Rao; Ramesh R,9999,0,9999,0
1668331104169,ECE 200,040,103625,Rebeiz; Gabriel,9999,0,9999,0
1668331104169,ECE 200,041,103626,Sanford; John R,9999,0,9999,0
1668331104169,ECE 200,042,103627,Siegel; Paul H.,9999,0,9999,0
1668331104169,ECE 200,043,103628,Sievenpiper; Daniel F.,9999,0,9999,0
1668331104169,ECE 200,044,103629,Sworder; David D.,9999,0,9999,0
1668331104169,ECE 200,045,103630,Taur; Yuan,9999,0,9999,0
1668331104169,ECE 200,046,103631,Touri; Behrouz,9999,0,9999,0
1668331104169,ECE 200,047,103632,Trivedi; Mohan M.,9999,0,9999,0
1668331104169,ECE 200,048,103633,Vasconcelos; Nuno,9999,0,9999,0
1668331104169,ECE 200,049,103634,Wang; Xiaolong,9999,0,9999,0
1668331104169,ECE 200,050,103635,Xie; Pengtao,9999,0,9999,0
1668331104169,ECE 200,051,103636,Yip; Michael,9999,0,9999,0
1668331104169,ECE 200,052,103637,Zeger; Kenneth A.,999,0,999,0
1668331104169,ECE 200,053,103638,Zhang; Xinyu,9999,0,9999,0
1668331104169,ECE 200,054,103639,Turakhia; Yatish Girish,9999,0,9999,0
1668331104169,ECE 200,055,103640,Kang; Mingu,9999,0,9999,0
1668331104169,ECE 200,056,103641,Shi; Yuanyuan,9999,0,9999,0
1668331104169,ECE 200,057,103642,Wang; Edward Jay,9999,0,9999,0
1668331104169,ECE 200,058,103643,Zheng; Yang,9999,0,9999,0
1668331104596,ECE 202,A00,103644,Kuzum; Duygu,0,0,0,0
1668331105025,ECE 212BN,A00,103646,Ng; Tse Nga,0,0,0,0
1668331105539,ECE 221,A00,111493,Staff,0,0,0,0
1668331105962,ECE 222B,A00,103647,Lomakin; Vitaliy,0,0,0,0
1668331106386,ECE 230B,A00,103648,Taur; Yuan,0,0,0,0
1668331106814,ECE 238B,A00,103649,Garay; Javier,0,0,0,0
1668331107240,ECE 240B,A00,112900,Fainman; Yeshaiahu,0,0,0,0
1668331107668,ECE 247A,A00,103650,Jokerst; Jesse Vincent,0,0,0,0
1668331108094,ECE 247B,A00,103651,Wang; Joseph,0,0,0,0
1668331108520,ECE 250,A00,103652,Siegel; Paul H.,0,0,0,0
1668331108945,ECE 251A,A00,103654,Rao; Bhaskar D.,0,0,0,0
1668331109368,ECE 257B,A00,103655,Bharadia; Dinesh,0,0,0,0
1668331109792,ECE 258A,A00,103656,Milstein; Laurence B.,0,0,0,0
1668331110224,ECE 260B,A00,103658,Kang; Mingu,0,0,0,0
1668331110649,ECE 264A,A00,103659,Galton; Ian A,0,0,0,0
1668331111073,ECE 265A,A00,103661,Gudem; Prasad S.S.,0,0,0,0
1668331111498,ECE 265D,A00,103662,Gudem; Prasad S.S.,0,0,0,0
1668331111925,ECE 268,A00,103663,Koushanfar; Farinaz,0,0,0,0
1668331112351,ECE 269,A01,103665,Pal; Piya,0,0,0,0
1668331112777,ECE 271B,A00,103666,Vasconcelos; Manuela,0,0,0,0
1668331113202,ECE 276A,A00,103667,Atanasov; Nikolay A.,0,0,0,0
1668331113626,ECE 277,A00,103668,An; Cheolhong,0,0,0,0
1668331114050,ECE 279,A00,117947,Hall; Drew A.,0,0,0,0
1668331114902,ECE 283,A00,103670,Hsueh; Tzu-Chien,0,0,0,0
1668331115327,ECE 284,A00,103671,Turakhia; Yatish Girish,0,0,0,0
1668331115751,ECE 285,A00,103672,Zheng; Yang,0,0,0,0
1668331115751,ECE 285,B00,103673,Sworder; David D.,0,0,0,0
1668331116179,ECE 287,A00,103676,Javidi; Tara,0,0,0,0
1668331116602,MATH 200B,A00,098023,Salehi Golsefidy; Alireza,12,0,15,3
1668331117026,MATH 202B,A00,098024,Rhoades; Brendon Patrick,9,0,15,6
1668331117449,MATH 203B,A00,098025,Oprea; Dragos N.,10,0,15,5
1668331117876,MATH 204B,A00,098026,Sorensen; Claus M,13,0,15,2
1668331118301,MATH 208,A00,098027,Izadi; Elham,7,0,10,3
1668331118736,MATH 209,A00,098028,Pollack; Aaron,10,0,10,0
1668331119162,MATH 211A,A00,112919,Rogalski; Daniel,9,0,10,1
1668331119585,MATH 211B,A00,112920,Seward; Brandon M.,9,0,10,1
1668331120010,MATH 218,A00,098029,Li; Bo,10,0,10,0
1668331120437,MATH 220B,A00,098030,Novak; Jonathan I,11,0,15,4
1668331120860,MATH 221A,A00,098031,Ebenfelt; Peter F,13,0,15,2
1668331121286,MATH 231B,A00,098032,Zlatos; Andrej,12,0,15,3
1668331121711,MATH 240B,A00,098033,Ni; Lei,9,0,15,6
1668331122139,MATH 243,A00,098034,Jekel; David Andrew,10,0,10,0
1668331122566,MATH 245A,A00,098035,Nie; Jiawang,0,0,15,16
1668331122991,MATH 248,A00,098036,Bejenaru; Ioan,10,0,10,0
1668331123415,MATH 250B,A00,098037,Spolaor; Luca,14,0,15,1
1668331123838,MATH 258,A00,098038,Ni; Lei,10,0,10,0
1668331124262,MATH 264B,A00,098041,Rhoades; Brendon Patrick,9,0,15,6
1668331124690,MATH 268,A00,098042,Buss; Samuel R,10,0,10,0
1668331125117,MATH 269,A00,098043,Rhoades; Brendon Patrick,10,0,10,0
1668331125541,MATH 270B,A00,098044,Li; Bo,10,0,15,5
1668331125966,MATH 272B,A00,098045,Holst; Michael J,13,0,15,2
1668331126390,MATH 273A,A00,098046,Tian; Xiaochuan,10,0,15,5
1668331126819,MATH 275,A01,098048,Tian; Xiaochuan,6,0,10,4
1668331127244,MATH 278A,A00,098049,Holst; Michael J,8,0,10,2
1668331127670,MATH 278B,A00,098050,Cloninger; Alexander,10,0,10,0
1668331128093,MATH 278C,A00,098051,Nie; Jiawang,7,0,10,3
1668331128521,MATH 280B,A00,098052,Zheng; Tianyi,8,0,15,7
1668331128949,MATH 281B,A00,098053,Bradic; Jelena,1,0,15,14
1668331129373,MATH 282B,A00,098054,Arias-Castro; Ery,0,0,15,15
1668331129801,MATH 285,A00,098055,Fitzsimmons; Patrick J,0,0,15,17
1668331130227,MATH 287B,A00,098056,Arias-Castro; Ery,2,0,15,13
1668331130651,MATH 288,A00,098057,Agarwal; Pooja,9,0,10,1
1668331130651,MATH 288,B00,098058,Zhang; Danna,8,0,10,2
1668331130651,MATH 288,C00,098059,Williams; Ruth J,9,0,10,1
1668331131075,MATH 290B,A00,098060,Roberts; Justin Deritter,13,0,15,2
1668331131502,MATH 292,A00,098061,Belmont; Eva Kinoshita,10,0,10,0
1668331131926,MATH 295,A00,098062,Suk; Andrew Hoon,48,0,50,2
1668331132354,MATH 296,A00,098063,Novak; Jonathan I,20,0,20,0
1668331132785,MATH 297,001,098064,Gamst; Anthony Collins,9997,0,9999,2
1668331642814,COGS 205,A00,101395,Chiba; Andrea,19,0,20,1
1668331643248,COGS 210B,001,101404,Greene; Deanna Jacquelyn,9998,0,9999,1
1668331643248,COGS 210B,002,101417,Xia; Haijun,9999,0,9999,0
1668331643248,COGS 210B,003,101422,Nitz; Douglas A.,9999,0,9999,0
1668331643248,COGS 210B,004,101423,Hollan; James D.,9998,0,9999,1
1668331643248,COGS 210B,005,101424,Deak; Gedeon O.,9998,0,9999,1
1668331643248,COGS 210B,006,101425,Rossano; Federico,9999,0,9999,0
1668331643672,COGS 211B,A00,101427,Coulson; Seana M,9996,0,9999,3
1668331644098,COGS 220,A00,101428,Hollan; James D.,0,0,25,25
1668331644522,COGS 229,A00,101429,Dow; Steven P,18,0,25,7
1668331644944,COGS 230,A00,101430,Klemmer; Scott R,11,0,17,6
1668331645372,COGS 234,A00,101431,Xia; Haijun,1,0,25,24
1668331645796,COGS 260,A00,101432,Kiyonaga; Anastasia,21,0,25,4
1668331645796,COGS 260,B00,101433,Kirsh; David Joel,15,0,25,10
1668331646223,CSE 202,A00,102371,Impagliazzo; Russell,0,0,0,0
1668331646650,CSE 203B,A01,102373,Cheng; Chung Kuan,0,0,0,0
1668331647074,CSE 208,A00,102374,Micciancio; Daniele,0,0,0,0
1668331647502,CSE 209A,A00,112895,Impagliazzo; Russell,0,0,15,15
1668331647929,CSE 209B,A00,108005,Bellare; Mihir,0,0,0,0
1668331648357,CSE 210,A00,113163,Coblenz; Michael J,0,0,0,0
1668331648781,CSE 219,A00,106111,Dow; Steven P,0,0,20,20
1668331649205,CSE 221,A00,102376,Voelker; Geoffrey M.,0,0,0,0
1668331649631,CSE 224,A01,102378,Porter; George M,0,0,0,0
1668331650058,CSE 229A,A00,102379,Savage; Stefan,0,0,0,0
1668331650486,CSE 229C,A00,102380,Munyaka; Imani N. S.,0,0,0,0
1668331650916,CSE 232B,A00,102382,Deutsch; Alin Bernard,0,0,0,0
1668331651340,CSE 234,A01,112904,Kumar; Arun Kumar,0,0,0,0
1668331651772,CSE 237A,A00,102383,Rosing; Tajana Simunic,0,0,0,0
1668331652194,CSE 239A,A00,102384,Deutsch; Alin Bernard,0,0,0,0
1668331652618,CSE 239B,A00,102385,Polikarpova; Nadezhda,0,0,0,0
1668331653042,CSE 240A,A00,102386,Pannuto; Patrick William,0,0,0,0
1668331653470,CSE 240B,A00,102387,Zhao; Jishen,0,0,0,0
1668331653898,CSE 241A,A00,106406,Kang; Mingu,0,0,0,0
1668331654325,CSE 249B,A00,102388,Kahng; Andrew Byun,0,0,8,8
1668331654749,CSE 251B,A01,102392,Cottrell; Garrison W,0,0,0,0
1668331654749,CSE 251B,A02,102393,Cottrell; Garrison W,0,0,0,0
1668331655177,CSE 252B,A00,102394,Ochoa; Benjamin Lawrence,0,0,0,0
1668331655605,CSE 257,A01,102396,Gao; Sicun,0,0,0,0
1668331656030,CSE 272,A00,102397,Li; Tzumao,0,0,0,0
1668331656454,CSE 274,A00,111323,Chern; Albert Ren-Haur,0,0,0,0
1668331656884,CSE 282,A00,102398,Pevzner; Pavel Arkadjevich,0,0,0,0
1668331657311,CSE 284,A00,114175,Gymrek; Melissa Ann,0,0,0,0
1668331657744,CSE 290,A00,102399,Chandraker; Manmohan Krishna,0,0,0,0
1668331657744,CSE 290,B00,102400,Vaccaro; Kristen Marie,0,0,25,25
1668331657744,CSE 290,C00,102414,Pannuto; Patrick William,0,0,25,25
1668331657744,CSE 290,D00,102427,Pevzner; Pavel Arkadjevich,0,0,0,0
1668331657744,CSE 290,E00,102429,Zhao; Jishen,0,0,0,0
1668331657744,CSE 290,F00,102436,Tullsen; Dean Michael,0,0,0,0
1668331657744,CSE 290,G00,102440,Christensen; Henrik I,0,0,20,20
1668331658175,CSE 291,A00,102443,Su; Hao,0,0,0,0
1668331658175,CSE 291,B00,102448,Polikarpova; Nadezhda,0,0,0,0
1668331658175,CSE 291,C00,102453,Vaccaro; Kristen Marie,0,0,0,0
1668331658175,CSE 291,D00,111343,Savage; Stefan,0,0,0,0
1668331658175,CSE 291,E00,116474,Claffy; Kimberly Claire,0,0,0,0
1668331658175,CSE 291,F00,116479,Pasquale; Joseph,0,0,0,0
1668331658614,CSE 293,001,119111,Bafna; Vineet,9999,0,9999,0
1668331658614,CSE 293,002,119118,Bellare; Mihir,9999,0,9999,0
1668331658614,CSE 293,003,119122,Berg-Kirkpatrick; Taylor D,9999,0,9999,0
1668331658614,CSE 293,004,119135,Christensen; Henrik I,9999,0,9999,0
1668331658614,CSE 293,005,119142,Cottrell; Garrison W,9999,0,9999,0
1668331658614,CSE 293,006,119146,Deutsch; Alin Bernard,9999,0,9999,0
1668331658614,CSE 293,007,119159,Esmaeilzadeh; Hadi,9999,0,9999,0
1668331658614,CSE 293,008,119166,Freund; Yoav,9999,0,9999,0
1668331658614,CSE 293,009,119170,Griswold; William G.,9999,0,9999,0
1668331658614,CSE 293,010,119183,Gymrek; Melissa Ann,9999,0,9999,0
1668331658614,CSE 293,011,119190,Heninger; Nadia A,9999,0,9999,0
1668331658614,CSE 293,012,119230,Impagliazzo; Russell,9999,0,9999,0
1668331658614,CSE 293,013,119232,Jhala; Ranjit,9999,0,9999,0
1668331658614,CSE 293,014,119233,Kahng; Andrew Byun,9999,0,9999,0
1668331658614,CSE 293,015,119298,Kane; Daniel Mertz,9999,0,9999,0
1668331658614,CSE 293,016,119299,Kriegman; David J,9999,0,9999,0
1668331658614,CSE 293,017,119300,Kumar; Arun Kumar,9999,0,9999,0
1668331658614,CSE 293,018,119301,Lerner; Sorin,9999,0,9999,0
1668331658614,CSE 293,019,119302,Lovett; Shachar,9999,0,9999,0
1668331658614,CSE 293,020,119303,McAuley; Julian John,9999,0,9999,0
1668331658614,CSE 293,021,119304,Micciancio; Daniele,9999,0,9999,0
1668331658614,CSE 293,022,119367,Orailoglu; Alex,9999,0,9999,0
1668331658614,CSE 293,023,119382,Paturi; Ramamohan,9999,0,9999,0
1668331658614,CSE 293,024,119404,Polikarpova; Nadezhda,9999,0,9999,0
1668331658614,CSE 293,025,119406,Politz; Joseph Gibbs,9999,0,9999,0
1668331658614,CSE 293,026,119411,Porter; George M,9999,0,9999,0
1668331658614,CSE 293,027,119414,Porter; Leonard Emerson,9999,0,9999,0
1668331658614,CSE 293,028,119416,Ramamoorthi; Ravi,9999,0,9999,0
1668331658614,CSE 293,029,119417,Sahoo; Debashis,9999,0,9999,0
1668331658614,CSE 293,030,119420,Saul; Lawrence,9999,0,9999,0
1668331658614,CSE 293,031,119421,Savage; Stefan,9999,0,9999,0
1668331658614,CSE 293,032,119425,Schulze; Jurgen P.,9999,0,9999,0
1668331658614,CSE 293,033,119426,Snoeren; Alex C.,9999,0,9999,0
1668331658614,CSE 293,034,119428,Shang; Jingbo,9999,0,9999,0
1668331658614,CSE 293,035,119430,Stefan; Deian,9999,0,9999,0
1668331658614,CSE 293,036,119431,Su; Hao,9999,0,9999,0
1668331658614,CSE 293,037,119433,Swanson; Steven James,9999,0,9999,0
1668331658614,CSE 293,038,119435,Tullsen; Dean Michael,9999,0,9999,0
1668331658614,CSE 293,039,119483,Voelker; Geoffrey M.,9999,0,9999,0
1668331658614,CSE 293,040,119537,Zhao; Jishen,9999,0,9999,0
1668331658614,CSE 293,041,119538,Zhou; Yuan-Yuan,9999,0,9999,0
1668331658614,CSE 293,042,119539,Gao; Sicun,9999,0,9999,0
1668331658614,CSE 293,043,119540,Weibel; Nadir,9999,0,9999,0
1668331658614,CSE 293,044,119541,Gupta; Rajesh K.,9999,0,9999,0
1668331658614,CSE 293,045,126410,Vaccaro; Kristen Marie,9999,0,9999,0
1668331658614,CSE 293,046,126411,Klemke; Richard,9999,0,9999,0
1668331659051,CSE 294,A00,102459,Voelker; Geoffrey M.,0,0,0,0
1668331659051,CSE 294,B00,111322,Orailoglu; Alex,0,0,0,0
1668331659477,DSE 201,A00,096914,Deutsch; Alin Bernard,30,0,30,0
1668331659905,DSE 210,A00,096915,Dasgupta; Sanjoy,30,0,30,0
1668331660330,DSE 260A,A00,096916,Altintas De Callaf; Ilkay,30,0,30,0
1668331660775,ECE 200,001,103586,Antipa; Nicholas A,9999,0,9999,0
1668331660775,ECE 200,002,103587,Atanasov; Nikolay A.,9999,0,9999,0
1668331660775,ECE 200,003,103588,Bharadia; Dinesh,9999,0,9999,0
1668331660775,ECE 200,004,103589,Cheng; Chung Kuan,9999,0,9999,0
1668331660775,ECE 200,005,103590,Cosman; Pamela C.,9999,0,9999,0
1668331660775,ECE 200,006,103591,Dayeh; Shadi Ahmad,9999,0,9999,0
1668331660775,ECE 200,007,103592,Fainman; Yeshaiahu,9999,0,9999,0
1668331660775,ECE 200,008,103593,Ford; Joseph Earl,9999,0,9999,0
1668331660775,ECE 200,009,103594,Franceschetti; Massimo,9999,0,9999,0
1668331660775,ECE 200,010,103595,Fullerton; Eric E,9999,0,9999,0
1668331660775,ECE 200,011,103596,Galton; Ian A,9999,0,9999,0
1668331660775,ECE 200,012,103597,Gilja; Vikash,9999,0,9999,0
1668331660775,ECE 200,013,103598,Hall; Drew A.,9999,0,9999,0
1668331660775,ECE 200,014,103599,Hsueh; Tzu-Chien,9999,0,9999,0
1668331660775,ECE 200,015,103600,Javidi; Tara,9999,0,9999,0
1668331660775,ECE 200,016,103601,Kahng; Andrew Byun,9999,0,9999,0
1668331660775,ECE 200,017,103602,Kim; Young-Han,9999,0,9999,0
1668331660775,ECE 200,018,103603,Koushanfar; Farinaz,9999,0,9999,0
1668331660775,ECE 200,019,103604,Kuzum; Duygu,9999,0,9999,0
1668331660775,ECE 200,020,103605,Le; Hanh-Phuc,9999,0,9999,0
1668331660775,ECE 200,021,103606,Lin; Bill,9999,0,9999,0
1668331660775,ECE 200,022,103607,Liu; Zhaowei,9998,0,9999,1
1668331660775,ECE 200,023,103608,Lo; Yu-Hwa,9999,0,9999,0
1668331660775,ECE 200,024,103609,Lomakin; Vitaliy,9999,0,9999,0
1668331660775,ECE 200,025,103610,Mercier; Patrick Philip,9999,0,9999,0
1668331660775,ECE 200,026,103611,Meyer; Florian,9999,0,9999,0
1668331660775,ECE 200,027,103612,Milstein; Laurence B.,9999,0,9999,0
1668331660775,ECE 200,028,103613,Mir Arabbaygi; Siavash,9999,0,9999,0
1668331660775,ECE 200,029,103614,Mookherjea; Shayan,9999,0,9999,0
1668331660775,ECE 200,030,103615,Morris; Karcher William,9999,0,9999,0
1668331660775,ECE 200,031,103616,Ng; Tse Nga,9999,0,9999,0
1668331660775,ECE 200,032,103617,Nguyen; Truong Quang,9999,0,9999,0
1668331660775,ECE 200,033,103618,Nomura; Kenji,9999,0,9999,0
1668331660775,ECE 200,034,103619,Orlitsky; Alon,9999,0,9999,0
1668331660775,ECE 200,035,103620,Pal; Piya,9999,0,9999,0
1668331660775,ECE 200,036,103621,Papen; George C.,9999,0,9999,0
1668331660775,ECE 200,037,103622,Radic; Stojan,9999,0,9999,0
1668331660775,ECE 200,038,103623,Rao; Bhaskar D.,9999,0,9999,0
1668331660775,ECE 200,039,103624,Rao; Ramesh R,9999,0,9999,0
1668331660775,ECE 200,040,103625,Rebeiz; Gabriel,9999,0,9999,0
1668331660775,ECE 200,041,103626,Sanford; John R,9999,0,9999,0
1668331660775,ECE 200,042,103627,Siegel; Paul H.,9999,0,9999,0
1668331660775,ECE 200,043,103628,Sievenpiper; Daniel F.,9999,0,9999,0
1668331660775,ECE 200,044,103629,Sworder; David D.,9999,0,9999,0
1668331660775,ECE 200,045,103630,Taur; Yuan,9999,0,9999,0
1668331660775,ECE 200,046,103631,Touri; Behrouz,9999,0,9999,0
1668331660775,ECE 200,047,103632,Trivedi; Mohan M.,9999,0,9999,0
1668331660775,ECE 200,048,103633,Vasconcelos; Nuno,9999,0,9999,0
1668331660775,ECE 200,049,103634,Wang; Xiaolong,9999,0,9999,0
1668331660775,ECE 200,050,103635,Xie; Pengtao,9999,0,9999,0
1668331660775,ECE 200,051,103636,Yip; Michael,9999,0,9999,0
1668331660775,ECE 200,052,103637,Zeger; Kenneth A.,999,0,999,0
1668331660775,ECE 200,053,103638,Zhang; Xinyu,9999,0,9999,0
1668331660775,ECE 200,054,103639,Turakhia; Yatish Girish,9999,0,9999,0
1668331660775,ECE 200,055,103640,Kang; Mingu,9999,0,9999,0
1668331660775,ECE 200,056,103641,Shi; Yuanyuan,9999,0,9999,0
1668331660775,ECE 200,057,103642,Wang; Edward Jay,9999,0,9999,0
1668331660775,ECE 200,058,103643,Zheng; Yang,9999,0,9999,0
1668331661200,ECE 202,A00,103644,Kuzum; Duygu,0,0,0,0
1668331661629,ECE 212BN,A00,103646,Ng; Tse Nga,0,0,0,0
1668331662053,ECE 221,A00,111493,Staff,0,0,0,0
1668331662480,ECE 222B,A00,103647,Lomakin; Vitaliy,0,0,0,0
1668331662907,ECE 230B,A00,103648,Taur; Yuan,0,0,0,0
1668331663336,ECE 238B,A00,103649,Garay; Javier,0,0,0,0
1668331663763,ECE 240B,A00,112900,Fainman; Yeshaiahu,0,0,0,0
1668331664189,ECE 247A,A00,103650,Jokerst; Jesse Vincent,0,0,0,0
1668331664613,ECE 247B,A00,103651,Wang; Joseph,0,0,0,0
1668331665041,ECE 250,A00,103652,Siegel; Paul H.,0,0,0,0
1668331665466,ECE 251A,A00,103654,Rao; Bhaskar D.,0,0,0,0
1668331665890,ECE 257B,A00,103655,Bharadia; Dinesh,0,0,0,0
1668331666317,ECE 258A,A00,103656,Milstein; Laurence B.,0,0,0,0
1668331666742,ECE 260B,A00,103658,Kang; Mingu,0,0,0,0
1668331667166,ECE 264A,A00,103659,Galton; Ian A,0,0,0,0
1668331667590,ECE 265A,A00,103661,Gudem; Prasad S.S.,0,0,0,0
1668331668013,ECE 265D,A00,103662,Gudem; Prasad S.S.,0,0,0,0
1668331668440,ECE 268,A00,103663,Koushanfar; Farinaz,0,0,0,0
1668331668867,ECE 269,A01,103665,Pal; Piya,0,0,0,0
1668331669299,ECE 271B,A00,103666,Vasconcelos; Manuela,0,0,0,0
1668331669726,ECE 276A,A00,103667,Atanasov; Nikolay A.,0,0,0,0
1668331670151,ECE 277,A00,103668,An; Cheolhong,0,0,0,0
1668331670576,ECE 279,A00,117947,Hall; Drew A.,0,0,0,0
1668331671427,ECE 283,A00,103670,Hsueh; Tzu-Chien,0,0,0,0
1668331671854,ECE 284,A00,103671,Turakhia; Yatish Girish,0,0,0,0
1668331672279,ECE 285,A00,103672,Zheng; Yang,0,0,0,0
1668331672279,ECE 285,B00,103673,Sworder; David D.,0,0,0,0
1668331672704,ECE 287,A00,103676,Javidi; Tara,0,0,0,0
1668331673132,MATH 200B,A00,098023,Salehi Golsefidy; Alireza,12,0,15,3
1668331673560,MATH 202B,A00,098024,Rhoades; Brendon Patrick,9,0,15,6
1668331673985,MATH 203B,A00,098025,Oprea; Dragos N.,10,0,15,5
1668331674415,MATH 204B,A00,098026,Sorensen; Claus M,13,0,15,2
1668331674840,MATH 208,A00,098027,Izadi; Elham,7,0,10,3
1668331675263,MATH 209,A00,098028,Pollack; Aaron,10,0,10,0
1668331675706,MATH 211A,A00,112919,Rogalski; Daniel,9,0,10,1
1668331676131,MATH 211B,A00,112920,Seward; Brandon M.,9,0,10,1
1668331676557,MATH 218,A00,098029,Li; Bo,10,0,10,0
1668331676986,MATH 220B,A00,098030,Novak; Jonathan I,11,0,15,4
1668331677411,MATH 221A,A00,098031,Ebenfelt; Peter F,13,0,15,2
1668331677834,MATH 231B,A00,098032,Zlatos; Andrej,12,0,15,3
1668331678263,MATH 240B,A00,098033,Ni; Lei,9,0,15,6
1668331678764,MATH 243,A00,098034,Jekel; David Andrew,10,0,10,0
1668331679191,MATH 245A,A00,098035,Nie; Jiawang,0,0,15,16
1668331679618,MATH 248,A00,098036,Bejenaru; Ioan,10,0,10,0
1668331680043,MATH 250B,A00,098037,Spolaor; Luca,14,0,15,1
1668331680465,MATH 258,A00,098038,Ni; Lei,10,0,10,0
1668331680890,MATH 264B,A00,098041,Rhoades; Brendon Patrick,9,0,15,6
1668331681317,MATH 268,A00,098042,Buss; Samuel R,10,0,10,0
1668331681741,MATH 269,A00,098043,Rhoades; Brendon Patrick,10,0,10,0
1668331682166,MATH 270B,A00,098044,Li; Bo,10,0,15,5
1668331682592,MATH 272B,A00,098045,Holst; Michael J,13,0,15,2
1668331683020,MATH 273A,A00,098046,Tian; Xiaochuan,10,0,15,5
1668331683446,MATH 275,A01,098048,Tian; Xiaochuan,6,0,10,4
1668331683869,MATH 278A,A00,098049,Holst; Michael J,8,0,10,2
1668331684293,MATH 278B,A00,098050,Cloninger; Alexander,10,0,10,0
1668331684720,MATH 278C,A00,098051,Nie; Jiawang,7,0,10,3
1668331685144,MATH 280B,A00,098052,Zheng; Tianyi,8,0,15,7
1668331685569,MATH 281B,A00,098053,Bradic; Jelena,1,0,15,14
1668331685998,MATH 282B,A00,098054,Arias-Castro; Ery,0,0,15,15
1668331686423,MATH 285,A00,098055,Fitzsimmons; Patrick J,0,0,15,17
1668331686849,MATH 287B,A00,098056,Arias-Castro; Ery,2,0,15,13
1668331687274,MATH 288,A00,098057,Agarwal; Pooja,9,0,10,1
1668331687274,MATH 288,B00,098058,Zhang; Danna,8,0,10,2
1668331687274,MATH 288,C00,098059,Williams; Ruth J,9,0,10,1
1668331687696,MATH 290B,A00,098060,Roberts; Justin Deritter,13,0,15,2
1668331688121,MATH 292,A00,098061,Belmont; Eva Kinoshita,10,0,10,0
1668331688550,MATH 295,A00,098062,Suk; Andrew Hoon,48,0,50,2
1668331688976,MATH 296,A00,098063,Novak; Jonathan I,20,0,20,0
1668331689399,MATH 297,001,098064,Gamst; Anthony Collins,9997,0,9999,2
1668332189676,COGS 205,A00,101395,Chiba; Andrea,19,0,20,1
1668332190112,COGS 210B,001,101404,Greene; Deanna Jacquelyn,9998,0,9999,1
1668332190112,COGS 210B,002,101417,Xia; Haijun,9999,0,9999,0
1668332190112,COGS 210B,003,101422,Nitz; Douglas A.,9999,0,9999,0
1668332190112,COGS 210B,004,101423,Hollan; James D.,9998,0,9999,1
1668332190112,COGS 210B,005,101424,Deak; Gedeon O.,9998,0,9999,1
1668332190112,COGS 210B,006,101425,Rossano; Federico,9999,0,9999,0
1668332190538,COGS 211B,A00,101427,Coulson; Seana M,9996,0,9999,3
1668332190967,COGS 220,A00,101428,Hollan; James D.,0,0,25,25
1668332191395,COGS 229,A00,101429,Dow; Steven P,18,0,25,7
1668332191824,COGS 230,A00,101430,Klemmer; Scott R,11,0,17,6
1668332192247,COGS 234,A00,101431,Xia; Haijun,1,0,25,24
1668332192674,COGS 260,A00,101432,Kiyonaga; Anastasia,21,0,25,4
1668332192674,COGS 260,B00,101433,Kirsh; David Joel,15,0,25,10
1668332193107,CSE 202,A00,102371,Impagliazzo; Russell,0,0,0,0
1668332193547,CSE 203B,A01,102373,Cheng; Chung Kuan,0,0,0,0
1668332193971,CSE 208,A00,102374,Micciancio; Daniele,0,0,0,0
1668332194394,CSE 209A,A00,112895,Impagliazzo; Russell,0,0,15,15
1668332194823,CSE 209B,A00,108005,Bellare; Mihir,0,0,0,0
1668332195251,CSE 210,A00,113163,Coblenz; Michael J,0,0,0,0
1668332195676,CSE 219,A00,106111,Dow; Steven P,0,0,20,20
1668332196102,CSE 221,A00,102376,Voelker; Geoffrey M.,0,0,0,0
1668332196524,CSE 224,A01,102378,Porter; George M,0,0,0,0
1668332196953,CSE 229A,A00,102379,Savage; Stefan,0,0,0,0
1668332197377,CSE 229C,A00,102380,Munyaka; Imani N. S.,0,0,0,0
1668332197801,CSE 232B,A00,102382,Deutsch; Alin Bernard,0,0,0,0
1668332198226,CSE 234,A01,112904,Kumar; Arun Kumar,0,0,0,0
1668332198653,CSE 237A,A00,102383,Rosing; Tajana Simunic,0,0,0,0
1668332199170,CSE 239A,A00,102384,Deutsch; Alin Bernard,0,0,0,0
1668332199594,CSE 239B,A00,102385,Polikarpova; Nadezhda,0,0,0,0
1668332200023,CSE 240A,A00,102386,Pannuto; Patrick William,0,0,0,0
1668332200451,CSE 240B,A00,102387,Zhao; Jishen,0,0,0,0
1668332200876,CSE 241A,A00,106406,Kang; Mingu,0,0,0,0
1668332201302,CSE 249B,A00,102388,Kahng; Andrew Byun,0,0,8,8
1668332201731,CSE 251B,A01,102392,Cottrell; Garrison W,0,0,0,0
1668332201731,CSE 251B,A02,102393,Cottrell; Garrison W,0,0,0,0
1668332202163,CSE 252B,A00,102394,Ochoa; Benjamin Lawrence,0,0,0,0
1668332202587,CSE 257,A01,102396,Gao; Sicun,0,0,0,0
1668332203015,CSE 272,A00,102397,Li; Tzumao,0,0,0,0
1668332203439,CSE 274,A00,111323,Chern; Albert Ren-Haur,0,0,0,0
1668332203864,CSE 282,A00,102398,Pevzner; Pavel Arkadjevich,0,0,0,0
1668332204289,CSE 284,A00,114175,Gymrek; Melissa Ann,0,0,0,0
1668332204717,CSE 290,A00,102399,Chandraker; Manmohan Krishna,0,0,0,0
1668332204717,CSE 290,B00,102400,Vaccaro; Kristen Marie,0,0,25,25
1668332204717,CSE 290,C00,102414,Pannuto; Patrick William,0,0,25,25
1668332204717,CSE 290,D00,102427,Pevzner; Pavel Arkadjevich,0,0,0,0
1668332204717,CSE 290,E00,102429,Zhao; Jishen,0,0,0,0
1668332204717,CSE 290,F00,102436,Tullsen; Dean Michael,0,0,0,0
1668332204717,CSE 290,G00,102440,Christensen; Henrik I,0,0,20,20
1668332205151,CSE 291,A00,102443,Su; Hao,0,0,0,0
1668332205151,CSE 291,B00,102448,Polikarpova; Nadezhda,0,0,0,0
1668332205151,CSE 291,C00,102453,Vaccaro; Kristen Marie,0,0,0,0
1668332205151,CSE 291,D00,111343,Savage; Stefan,0,0,0,0
1668332205151,CSE 291,E00,116474,Claffy; Kimberly Claire,0,0,0,0
1668332205151,CSE 291,F00,116479,Pasquale; Joseph,0,0,0,0
1668332205593,CSE 293,001,119111,Bafna; Vineet,9999,0,9999,0
1668332205593,CSE 293,002,119118,Bellare; Mihir,9999,0,9999,0
1668332205593,CSE 293,003,119122,Berg-Kirkpatrick; Taylor D,9999,0,9999,0
1668332205593,CSE 293,004,119135,Christensen; Henrik I,9999,0,9999,0
1668332205593,CSE 293,005,119142,Cottrell; Garrison W,9999,0,9999,0
1668332205593,CSE 293,006,119146,Deutsch; Alin Bernard,9999,0,9999,0
1668332205593,CSE 293,007,119159,Esmaeilzadeh; Hadi,9999,0,9999,0
1668332205593,CSE 293,008,119166,Freund; Yoav,9999,0,9999,0
1668332205593,CSE 293,009,119170,Griswold; William G.,9999,0,9999,0
1668332205593,CSE 293,010,119183,Gymrek; Melissa Ann,9999,0,9999,0
1668332205593,CSE 293,011,119190,Heninger; Nadia A,9999,0,9999,0
1668332205593,CSE 293,012,119230,Impagliazzo; Russell,9999,0,9999,0
1668332205593,CSE 293,013,119232,Jhala; Ranjit,9999,0,9999,0
1668332205593,CSE 293,014,119233,Kahng; Andrew Byun,9999,0,9999,0
1668332205593,CSE 293,015,119298,Kane; Daniel Mertz,9999,0,9999,0
1668332205593,CSE 293,016,119299,Kriegman; David J,9999,0,9999,0
1668332205593,CSE 293,017,119300,Kumar; Arun Kumar,9999,0,9999,0
1668332205593,CSE 293,018,119301,Lerner; Sorin,9999,0,9999,0
1668332205593,CSE 293,019,119302,Lovett; Shachar,9999,0,9999,0
1668332205593,CSE 293,020,119303,McAuley; Julian John,9999,0,9999,0
1668332205593,CSE 293,021,119304,Micciancio; Daniele,9999,0,9999,0
1668332205593,CSE 293,022,119367,Orailoglu; Alex,9999,0,9999,0
1668332205593,CSE 293,023,119382,Paturi; Ramamohan,9999,0,9999,0
1668332205593,CSE 293,024,119404,Polikarpova; Nadezhda,9999,0,9999,0
1668332205593,CSE 293,025,119406,Politz; Joseph Gibbs,9999,0,9999,0
1668332205593,CSE 293,026,119411,Porter; George M,9999,0,9999,0
1668332205593,CSE 293,027,119414,Porter; Leonard Emerson,9999,0,9999,0
1668332205593,CSE 293,028,119416,Ramamoorthi; Ravi,9999,0,9999,0
1668332205593,CSE 293,029,119417,Sahoo; Debashis,9999,0,9999,0
1668332205593,CSE 293,030,119420,Saul; Lawrence,9999,0,9999,0
1668332205593,CSE 293,031,119421,Savage; Stefan,9999,0,9999,0
1668332205593,CSE 293,032,119425,Schulze; Jurgen P.,9999,0,9999,0
1668332205593,CSE 293,033,119426,Snoeren; Alex C.,9999,0,9999,0
1668332205593,CSE 293,034,119428,Shang; Jingbo,9999,0,9999,0
1668332205593,CSE 293,035,119430,Stefan; Deian,9999,0,9999,0
1668332205593,CSE 293,036,119431,Su; Hao,9999,0,9999,0
1668332205593,CSE 293,037,119433,Swanson; Steven James,9999,0,9999,0
1668332205593,CSE 293,038,119435,Tullsen; Dean Michael,9999,0,9999,0
1668332205593,CSE 293,039,119483,Voelker; Geoffrey M.,9999,0,9999,0
1668332205593,CSE 293,040,119537,Zhao; Jishen,9999,0,9999,0
1668332205593,CSE 293,041,119538,Zhou; Yuan-Yuan,9999,0,9999,0
1668332205593,CSE 293,042,119539,Gao; Sicun,9999,0,9999,0
1668332205593,CSE 293,043,119540,Weibel; Nadir,9999,0,9999,0
1668332205593,CSE 293,044,119541,Gupta; Rajesh K.,9999,0,9999,0
1668332205593,CSE 293,045,126410,Vaccaro; Kristen Marie,9999,0,9999,0
1668332205593,CSE 293,046,126411,Klemke; Richard,9999,0,9999,0
1668332206026,CSE 294,A00,102459,Voelker; Geoffrey M.,0,0,0,0
1668332206026,CSE 294,B00,111322,Orailoglu; Alex,0,0,0,0
1668332206457,DSE 201,A00,096914,Deutsch; Alin Bernard,30,0,30,0
1668332206881,DSE 210,A00,096915,Dasgupta; Sanjoy,30,0,30,0
1668332207307,DSE 260A,A00,096916,Altintas De Callaf; Ilkay,30,0,30,0
1668332207810,ECE 200,001,103586,Antipa; Nicholas A,9999,0,9999,0
1668332207810,ECE 200,002,103587,Atanasov; Nikolay A.,9999,0,9999,0
1668332207810,ECE 200,003,103588,Bharadia; Dinesh,9999,0,9999,0
1668332207810,ECE 200,004,103589,Cheng; Chung Kuan,9999,0,9999,0
1668332207810,ECE 200,005,103590,Cosman; Pamela C.,9999,0,9999,0
1668332207810,ECE 200,006,103591,Dayeh; Shadi Ahmad,9999,0,9999,0
1668332207810,ECE 200,007,103592,Fainman; Yeshaiahu,9999,0,9999,0
1668332207810,ECE 200,008,103593,Ford; Joseph Earl,9999,0,9999,0
1668332207810,ECE 200,009,103594,Franceschetti; Massimo,9999,0,9999,0
1668332207810,ECE 200,010,103595,Fullerton; Eric E,9999,0,9999,0
1668332207810,ECE 200,011,103596,Galton; Ian A,9999,0,9999,0
1668332207810,ECE 200,012,103597,Gilja; Vikash,9999,0,9999,0
1668332207810,ECE 200,013,103598,Hall; Drew A.,9999,0,9999,0
1668332207810,ECE 200,014,103599,Hsueh; Tzu-Chien,9999,0,9999,0
1668332207810,ECE 200,015,103600,Javidi; Tara,9999,0,9999,0
1668332207810,ECE 200,016,103601,Kahng; Andrew Byun,9999,0,9999,0
1668332207810,ECE 200,017,103602,Kim; Young-Han,9999,0,9999,0
1668332207810,ECE 200,018,103603,Koushanfar; Farinaz,9999,0,9999,0
1668332207810,ECE 200,019,103604,Kuzum; Duygu,9999,0,9999,0
1668332207810,ECE 200,020,103605,Le; Hanh-Phuc,9999,0,9999,0
1668332207810,ECE 200,021,103606,Lin; Bill,9999,0,9999,0
1668332207810,ECE 200,022,103607,Liu; Zhaowei,9998,0,9999,1
1668332207810,ECE 200,023,103608,Lo; Yu-Hwa,9999,0,9999,0
1668332207810,ECE 200,024,103609,Lomakin; Vitaliy,9999,0,9999,0
1668332207810,ECE 200,025,103610,Mercier; Patrick Philip,9999,0,9999,0
1668332207810,ECE 200,026,103611,Meyer; Florian,9999,0,9999,0
1668332207810,ECE 200,027,103612,Milstein; Laurence B.,9999,0,9999,0
1668332207810,ECE 200,028,103613,Mir Arabbaygi; Siavash,9999,0,9999,0
1668332207810,ECE 200,029,103614,Mookherjea; Shayan,9999,0,9999,0
1668332207810,ECE 200,030,103615,Morris; Karcher William,9999,0,9999,0
1668332207810,ECE 200,031,103616,Ng; Tse Nga,9999,0,9999,0
1668332207810,ECE 200,032,103617,Nguyen; Truong Quang,9999,0,9999,0
1668332207810,ECE 200,033,103618,Nomura; Kenji,9999,0,9999,0
1668332207810,ECE 200,034,103619,Orlitsky; Alon,9999,0,9999,0
1668332207810,ECE 200,035,103620,Pal; Piya,9999,0,9999,0
1668332207810,ECE 200,036,103621,Papen; George C.,9999,0,9999,0
1668332207810,ECE 200,037,103622,Radic; Stojan,9999,0,9999,0
1668332207810,ECE 200,038,103623,Rao; Bhaskar D.,9999,0,9999,0
1668332207810,ECE 200,039,103624,Rao; Ramesh R,9999,0,9999,0
1668332207810,ECE 200,040,103625,Rebeiz; Gabriel,9999,0,9999,0
1668332207810,ECE 200,041,103626,Sanford; John R,9999,0,9999,0
1668332207810,ECE 200,042,103627,Siegel; Paul H.,9999,0,9999,0
1668332207810,ECE 200,043,103628,Sievenpiper; Daniel F.,9999,0,9999,0
1668332207810,ECE 200,044,103629,Sworder; David D.,9999,0,9999,0
1668332207810,ECE 200,045,103630,Taur; Yuan,9999,0,9999,0
1668332207810,ECE 200,046,103631,Touri; Behrouz,9999,0,9999,0
1668332207810,ECE 200,047,103632,Trivedi; Mohan M.,9999,0,9999,0
1668332207810,ECE 200,048,103633,Vasconcelos; Nuno,9999,0,9999,0
1668332207810,ECE 200,049,103634,Wang; Xiaolong,9999,0,9999,0
1668332207810,ECE 200,050,103635,Xie; Pengtao,9999,0,9999,0
1668332207810,ECE 200,051,103636,Yip; Michael,9999,0,9999,0
1668332207810,ECE 200,052,103637,Zeger; Kenneth A.,999,0,999,0
1668332207810,ECE 200,053,103638,Zhang; Xinyu,9999,0,9999,0
1668332207810,ECE 200,054,103639,Turakhia; Yatish Girish,9999,0,9999,0
1668332207810,ECE 200,055,103640,Kang; Mingu,9999,0,9999,0
1668332207810,ECE 200,056,103641,Shi; Yuanyuan,9999,0,9999,0
1668332207810,ECE 200,057,103642,Wang; Edward Jay,9999,0,9999,0
1668332207810,ECE 200,058,103643,Zheng; Yang,9999,0,9999,0
1668332208234,ECE 202,A00,103644,Kuzum; Duygu,0,0,0,0
1668332208656,ECE 212BN,A00,103646,Ng; Tse Nga,0,0,0,0
1668332209084,ECE 221,A00,111493,Staff,0,0,0,0
1668332209511,ECE 222B,A00,103647,Lomakin; Vitaliy,0,0,0,0
1668332209935,ECE 230B,A00,103648,Taur; Yuan,0,0,0,0
1668332210361,ECE 238B,A00,103649,Garay; Javier,0,0,0,0
1668332210785,ECE 240B,A00,112900,Fainman; Yeshaiahu,0,0,0,0
1668332211213,ECE 247A,A00,103650,Jokerst; Jesse Vincent,0,0,0,0
1668332211639,ECE 247B,A00,103651,Wang; Joseph,0,0,0,0
1668332212067,ECE 250,A00,103652,Siegel; Paul H.,0,0,0,0
1668332212491,ECE 251A,A00,103654,Rao; Bhaskar D.,0,0,0,0
1668332212913,ECE 257B,A00,103655,Bharadia; Dinesh,0,0,0,0
1668332213342,ECE 258A,A00,103656,Milstein; Laurence B.,0,0,0,0
1668332213768,ECE 260B,A00,103658,Kang; Mingu,0,0,0,0
1668332214196,ECE 264A,A00,103659,Galton; Ian A,0,0,0,0
1668332214622,ECE 265A,A00,103661,Gudem; Prasad S.S.,0,0,0,0
1668332215046,ECE 265D,A00,103662,Gudem; Prasad S.S.,0,0,0,0
1668332215471,ECE 268,A00,103663,Koushanfar; Farinaz,0,0,0,0
1668332215899,ECE 269,A01,103665,Pal; Piya,0,0,0,0
1668332216346,ECE 271B,A00,103666,Vasconcelos; Manuela,0,0,0,0
1668332216774,ECE 276A,A00,103667,Atanasov; Nikolay A.,0,0,0,0
1668332217198,ECE 277,A00,103668,An; Cheolhong,0,0,0,0
1668332217622,ECE 279,A00,117947,Hall; Drew A.,0,0,0,0
1668332218472,ECE 283,A00,103670,Hsueh; Tzu-Chien,0,0,0,0
1668332218900,ECE 284,A00,103671,Turakhia; Yatish Girish,0,0,0,0
1668332219326,ECE 285,A00,103672,Zheng; Yang,0,0,0,0
1668332219326,ECE 285,B00,103673,Sworder; David D.,0,0,0,0
1668332219749,ECE 287,A00,103676,Javidi; Tara,0,0,0,0
1668332220177,MATH 200B,A00,098023,Salehi Golsefidy; Alireza,12,0,15,3
1668332220606,MATH 202B,A00,098024,Rhoades; Brendon Patrick,9,0,15,6
1668332221035,MATH 203B,A00,098025,Oprea; Dragos N.,10,0,15,5
1668332221460,MATH 204B,A00,098026,Sorensen; Claus M,13,0,15,2
1668332221888,MATH 208,A00,098027,Izadi; Elham,7,0,10,3
1668332222312,MATH 209,A00,098028,Pollack; Aaron,10,0,10,0
1668332222743,MATH 211A,A00,112919,Rogalski; Daniel,9,0,10,1
1668332223168,MATH 211B,A00,112920,Seward; Brandon M.,9,0,10,1
1668332223594,MATH 218,A00,098029,Li; Bo,10,0,10,0
1668332224019,MATH 220B,A00,098030,Novak; Jonathan I,11,0,15,4
1668332224449,MATH 221A,A00,098031,Ebenfelt; Peter F,13,0,15,2
1668332224876,MATH 231B,A00,098032,Zlatos; Andrej,12,0,15,3
1668332225299,MATH 240B,A00,098033,Ni; Lei,9,0,15,6
1668332225727,MATH 243,A00,098034,Jekel; David Andrew,10,0,10,0
1668332226158,MATH 245A,A00,098035,Nie; Jiawang,0,0,15,16
1668332226588,MATH 248,A00,098036,Bejenaru; Ioan,10,0,10,0
1668332227015,MATH 250B,A00,098037,Spolaor; Luca,14,0,15,1
1668332227440,MATH 258,A00,098038,Ni; Lei,10,0,10,0
1668332227866,MATH 264B,A00,098041,Rhoades; Brendon Patrick,9,0,15,6
1668332228290,MATH 268,A00,098042,Buss; Samuel R,10,0,10,0
1668332228714,MATH 269,A00,098043,Rhoades; Brendon Patrick,10,0,10,0
1668332229141,MATH 270B,A00,098044,Li; Bo,10,0,15,5
1668332229565,MATH 272B,A00,098045,Holst; Michael J,13,0,15,2
1668332229988,MATH 273A,A00,098046,Tian; Xiaochuan,10,0,15,5
1668332230416,MATH 275,A01,098048,Tian; Xiaochuan,6,0,10,4
1668332230841,MATH 278A,A00,098049,Holst; Michael J,8,0,10,2
1668332231266,MATH 278B,A00,098050,Cloninger; Alexander,10,0,10,0
1668332231695,MATH 278C,A00,098051,Nie; Jiawang,7,0,10,3
1668332232130,MATH 280B,A00,098052,Zheng; Tianyi,8,0,15,7
1668332232562,MATH 281B,A00,098053,Bradic; Jelena,1,0,15,14
1668332232986,MATH 282B,A00,098054,Arias-Castro; Ery,0,0,15,15
1668332233411,MATH 285,A00,098055,Fitzsimmons; Patrick J,0,0,15,17
1668332233836,MATH 287B,A00,098056,Arias-Castro; Ery,2,0,15,13
1668332234271,MATH 288,A00,098057,Agarwal; Pooja,9,0,10,1
1668332234271,MATH 288,B00,098058,Zhang; Danna,8,0,10,2
1668332234271,MATH 288,C00,098059,Williams; Ruth J,9,0,10,1
1668332234698,MATH 290B,A00,098060,Roberts; Justin Deritter,13,0,15,2
1668332235123,MATH 292,A00,098061,Belmont; Eva Kinoshita,10,0,10,0
1668332235548,MATH 295,A00,098062,Suk; Andrew Hoon,48,0,50,2
1668332235982,MATH 296,A00,098063,Novak; Jonathan I,20,0,20,0
1668332236409,MATH 297,001,098064,Gamst; Anthony Collins,9997,0,9999,2
1668332736202,COGS 205,A00,101395,Chiba; Andrea,19,0,20,1
1668332736625,COGS 210B,001,101404,Greene; Deanna Jacquelyn,9998,0,9999,1
1668332736625,COGS 210B,002,101417,Xia; Haijun,9999,0,9999,0
1668332736625,COGS 210B,003,101422,Nitz; Douglas A.,9999,0,9999,0
1668332736625,COGS 210B,004,101423,Hollan; James D.,9998,0,9999,1
1668332736625,COGS 210B,005,101424,Deak; Gedeon O.,9998,0,9999,1
1668332736625,COGS 210B,006,101425,Rossano; Federico,9999,0,9999,0
1668332737048,COGS 211B,A00,101427,Coulson; Seana M,9996,0,9999,3
1668332737475,COGS 220,A00,101428,Hollan; James D.,0,0,25,25
1668332737901,COGS 229,A00,101429,Dow; Steven P,18,0,25,7
1668332738323,COGS 230,A00,101430,Klemmer; Scott R,11,0,17,6
1668332738750,COGS 234,A00,101431,Xia; Haijun,1,0,25,24
1668332739179,COGS 260,A00,101432,Kiyonaga; Anastasia,21,0,25,4
1668332739179,COGS 260,B00,101433,Kirsh; David Joel,15,0,25,10
1668332739602,CSE 202,A00,102371,Impagliazzo; Russell,0,0,0,0
1668332740029,CSE 203B,A01,102373,Cheng; Chung Kuan,0,0,0,0
1668332740454,CSE 208,A00,102374,Micciancio; Daniele,0,0,0,0
1668332740878,CSE 209A,A00,112895,Impagliazzo; Russell,0,0,15,15
1668332741303,CSE 209B,A00,108005,Bellare; Mihir,0,0,0,0
1668332741738,CSE 210,A00,113163,Coblenz; Michael J,0,0,0,0
1668332742172,CSE 219,A00,106111,Dow; Steven P,0,0,20,20
1668332742596,CSE 221,A00,102376,Voelker; Geoffrey M.,0,0,0,0
1668332743024,CSE 224,A01,102378,Porter; George M,0,0,0,0
1668332743451,CSE 229A,A00,102379,Savage; Stefan,0,0,0,0
1668332743878,CSE 229C,A00,102380,Munyaka; Imani N. S.,0,0,0,0
1668332744307,CSE 232B,A00,102382,Deutsch; Alin Bernard,0,0,0,0
1668332744733,CSE 234,A01,112904,Kumar; Arun Kumar,0,0,0,0
1668332745157,CSE 237A,A00,102383,Rosing; Tajana Simunic,0,0,0,0
1668332745579,CSE 239A,A00,102384,Deutsch; Alin Bernard,0,0,0,0
1668332746007,CSE 239B,A00,102385,Polikarpova; Nadezhda,0,0,0,0
1668332746433,CSE 240A,A00,102386,Pannuto; Patrick William,0,0,0,0
1668332746857,CSE 240B,A00,102387,Zhao; Jishen,0,0,0,0
1668332747283,CSE 241A,A00,106406,Kang; Mingu,0,0,0,0
1668332747710,CSE 249B,A00,102388,Kahng; Andrew Byun,0,0,8,8
1668332748137,CSE 251B,A01,102392,Cottrell; Garrison W,0,0,0,0
1668332748137,CSE 251B,A02,102393,Cottrell; Garrison W,0,0,0,0
1668332748561,CSE 252B,A00,102394,Ochoa; Benjamin Lawrence,0,0,0,0
1668332748985,CSE 257,A01,102396,Gao; Sicun,0,0,0,0
1668332749413,CSE 272,A00,102397,Li; Tzumao,0,0,0,0
1668332749839,CSE 274,A00,111323,Chern; Albert Ren-Haur,0,0,0,0
1668332750265,CSE 282,A00,102398,Pevzner; Pavel Arkadjevich,0,0,0,0
1668332750688,CSE 284,A00,114175,Gymrek; Melissa Ann,0,0,0,0
1668332751114,CSE 290,A00,102399,Chandraker; Manmohan Krishna,0,0,0,0
1668332751114,CSE 290,B00,102400,Vaccaro; Kristen Marie,0,0,25,25
1668332751114,CSE 290,C00,102414,Pannuto; Patrick William,0,0,25,25
1668332751114,CSE 290,D00,102427,Pevzner; Pavel Arkadjevich,0,0,0,0
1668332751114,CSE 290,E00,102429,Zhao; Jishen,0,0,0,0
1668332751114,CSE 290,F00,102436,Tullsen; Dean Michael,0,0,0,0
1668332751114,CSE 290,G00,102440,Christensen; Henrik I,0,0,20,20
1668332751540,CSE 291,A00,102443,Su; Hao,0,0,0,0
1668332751540,CSE 291,B00,102448,Polikarpova; Nadezhda,0,0,0,0
1668332751540,CSE 291,C00,102453,Vaccaro; Kristen Marie,0,0,0,0
1668332751540,CSE 291,D00,111343,Savage; Stefan,0,0,0,0
1668332751540,CSE 291,E00,116474,Claffy; Kimberly Claire,0,0,0,0
1668332751540,CSE 291,F00,116479,Pasquale; Joseph,0,0,0,0
1668332751981,CSE 293,001,119111,Bafna; Vineet,9999,0,9999,0
1668332751981,CSE 293,002,119118,Bellare; Mihir,9999,0,9999,0
1668332751981,CSE 293,003,119122,Berg-Kirkpatrick; Taylor D,9999,0,9999,0
1668332751981,CSE 293,004,119135,Christensen; Henrik I,9999,0,9999,0
1668332751981,CSE 293,005,119142,Cottrell; Garrison W,9999,0,9999,0
1668332751981,CSE 293,006,119146,Deutsch; Alin Bernard,9999,0,9999,0
1668332751981,CSE 293,007,119159,Esmaeilzadeh; Hadi,9999,0,9999,0
1668332751981,CSE 293,008,119166,Freund; Yoav,9999,0,9999,0
1668332751981,CSE 293,009,119170,Griswold; William G.,9999,0,9999,0
1668332751981,CSE 293,010,119183,Gymrek; Melissa Ann,9999,0,9999,0
1668332751981,CSE 293,011,119190,Heninger; Nadia A,9999,0,9999,0
1668332751981,CSE 293,012,119230,Impagliazzo; Russell,9999,0,9999,0
1668332751981,CSE 293,013,119232,Jhala; Ranjit,9999,0,9999,0
1668332751981,CSE 293,014,119233,Kahng; Andrew Byun,9999,0,9999,0
1668332751981,CSE 293,015,119298,Kane; Daniel Mertz,9999,0,9999,0
1668332751981,CSE 293,016,119299,Kriegman; David J,9999,0,9999,0
1668332751981,CSE 293,017,119300,Kumar; Arun Kumar,9999,0,9999,0
1668332751981,CSE 293,018,119301,Lerner; Sorin,9999,0,9999,0
1668332751981,CSE 293,019,119302,Lovett; Shachar,9999,0,9999,0
1668332751981,CSE 293,020,119303,McAuley; Julian John,9999,0,9999,0
1668332751981,CSE 293,021,119304,Micciancio; Daniele,9999,0,9999,0
1668332751981,CSE 293,022,119367,Orailoglu; Alex,9999,0,9999,0
1668332751981,CSE 293,023,119382,Paturi; Ramamohan,9999,0,9999,0
1668332751981,CSE 293,024,119404,Polikarpova; Nadezhda,9999,0,9999,0
1668332751981,CSE 293,025,119406,Politz; Joseph Gibbs,9999,0,9999,0
1668332751981,CSE 293,026,119411,Porter; George M,9999,0,9999,0
1668332751981,CSE 293,027,119414,Porter; Leonard Emerson,9999,0,9999,0
1668332751981,CSE 293,028,119416,Ramamoorthi; Ravi,9999,0,9999,0
1668332751981,CSE 293,029,119417,Sahoo; Debashis,9999,0,9999,0
1668332751981,CSE 293,030,119420,Saul; Lawrence,9999,0,9999,0
1668332751981,CSE 293,031,119421,Savage; Stefan,9999,0,9999,0
1668332751981,CSE 293,032,119425,Schulze; Jurgen P.,9999,0,9999,0
1668332751981,CSE 293,033,119426,Snoeren; Alex C.,9999,0,9999,0
1668332751981,CSE 293,034,119428,Shang; Jingbo,9999,0,9999,0
1668332751981,CSE 293,035,119430,Stefan; Deian,9999,0,9999,0
1668332751981,CSE 293,036,119431,Su; Hao,9999,0,9999,0
1668332751981,CSE 293,037,119433,Swanson; Steven James,9999,0,9999,0
1668332751981,CSE 293,038,119435,Tullsen; Dean Michael,9999,0,9999,0
1668332751981,CSE 293,039,119483,Voelker; Geoffrey M.,9999,0,9999,0
1668332751981,CSE 293,040,119537,Zhao; Jishen,9999,0,9999,0
1668332751981,CSE 293,041,119538,Zhou; Yuan-Yuan,9999,0,9999,0
1668332751981,CSE 293,042,119539,Gao; Sicun,9999,0,9999,0
1668332751981,CSE 293,043,119540,Weibel; Nadir,9999,0,9999,0
1668332751981,CSE 293,044,119541,Gupta; Rajesh K.,9999,0,9999,0
1668332751981,CSE 293,045,126410,Vaccaro; Kristen Marie,9999,0,9999,0
1668332751981,CSE 293,046,126411,Klemke; Richard,9999,0,9999,0
1668332752408,CSE 294,A00,102459,Voelker; Geoffrey M.,0,0,0,0
1668332752408,CSE 294,B00,111322,Orailoglu; Alex,0,0,0,0
1668332752831,DSE 201,A00,096914,Deutsch; Alin Bernard,30,0,30,0
1668332753258,DSE 210,A00,096915,Dasgupta; Sanjoy,30,0,30,0
1668332753683,DSE 260A,A00,096916,Altintas De Callaf; Ilkay,30,0,30,0
1668332754115,ECE 200,001,103586,Antipa; Nicholas A,9999,0,9999,0
1668332754115,ECE 200,002,103587,Atanasov; Nikolay A.,9999,0,9999,0
1668332754115,ECE 200,003,103588,Bharadia; Dinesh,9999,0,9999,0
1668332754115,ECE 200,004,103589,Cheng; Chung Kuan,9999,0,9999,0
1668332754115,ECE 200,005,103590,Cosman; Pamela C.,9999,0,9999,0
1668332754115,ECE 200,006,103591,Dayeh; Shadi Ahmad,9999,0,9999,0
1668332754115,ECE 200,007,103592,Fainman; Yeshaiahu,9999,0,9999,0
1668332754115,ECE 200,008,103593,Ford; Joseph Earl,9999,0,9999,0
1668332754115,ECE 200,009,103594,Franceschetti; Massimo,9999,0,9999,0
1668332754115,ECE 200,010,103595,Fullerton; Eric E,9999,0,9999,0
1668332754115,ECE 200,011,103596,Galton; Ian A,9999,0,9999,0
1668332754115,ECE 200,012,103597,Gilja; Vikash,9999,0,9999,0
1668332754115,ECE 200,013,103598,Hall; Drew A.,9999,0,9999,0
1668332754115,ECE 200,014,103599,Hsueh; Tzu-Chien,9999,0,9999,0
1668332754115,ECE 200,015,103600,Javidi; Tara,9999,0,9999,0
1668332754115,ECE 200,016,103601,Kahng; Andrew Byun,9999,0,9999,0
1668332754115,ECE 200,017,103602,Kim; Young-Han,9999,0,9999,0
1668332754115,ECE 200,018,103603,Koushanfar; Farinaz,9999,0,9999,0
1668332754115,ECE 200,019,103604,Kuzum; Duygu,9999,0,9999,0
1668332754115,ECE 200,020,103605,Le; Hanh-Phuc,9999,0,9999,0
1668332754115,ECE 200,021,103606,Lin; Bill,9999,0,9999,0
1668332754115,ECE 200,022,103607,Liu; Zhaowei,9998,0,9999,1
1668332754115,ECE 200,023,103608,Lo; Yu-Hwa,9999,0,9999,0
1668332754115,ECE 200,024,103609,Lomakin; Vitaliy,9999,0,9999,0
1668332754115,ECE 200,025,103610,Mercier; Patrick Philip,9999,0,9999,0
1668332754115,ECE 200,026,103611,Meyer; Florian,9999,0,9999,0
1668332754115,ECE 200,027,103612,Milstein; Laurence B.,9999,0,9999,0
1668332754115,ECE 200,028,103613,Mir Arabbaygi; Siavash,9999,0,9999,0
1668332754115,ECE 200,029,103614,Mookherjea; Shayan,9999,0,9999,0
1668332754115,ECE 200,030,103615,Morris; Karcher William,9999,0,9999,0
1668332754115,ECE 200,031,103616,Ng; Tse Nga,9999,0,9999,0
1668332754115,ECE 200,032,103617,Nguyen; Truong Quang,9999,0,9999,0
1668332754115,ECE 200,033,103618,Nomura; Kenji,9999,0,9999,0
1668332754115,ECE 200,034,103619,Orlitsky; Alon,9999,0,9999,0
1668332754115,ECE 200,035,103620,Pal; Piya,9999,0,9999,0
1668332754115,ECE 200,036,103621,Papen; George C.,9999,0,9999,0
1668332754115,ECE 200,037,103622,Radic; Stojan,9999,0,9999,0
1668332754115,ECE 200,038,103623,Rao; Bhaskar D.,9999,0,9999,0
1668332754115,ECE 200,039,103624,Rao; Ramesh R,9999,0,9999,0
1668332754115,ECE 200,040,103625,Rebeiz; Gabriel,9999,0,9999,0
1668332754115,ECE 200,041,103626,Sanford; John R,9999,0,9999,0
1668332754115,ECE 200,042,103627,Siegel; Paul H.,9999,0,9999,0
1668332754115,ECE 200,043,103628,Sievenpiper; Daniel F.,9999,0,9999,0
1668332754115,ECE 200,044,103629,Sworder; David D.,9999,0,9999,0
1668332754115,ECE 200,045,103630,Taur; Yuan,9999,0,9999,0
1668332754115,ECE 200,046,103631,Touri; Behrouz,9999,0,9999,0
1668332754115,ECE 200,047,103632,Trivedi; Mohan M.,9999,0,9999,0
1668332754115,ECE 200,048,103633,Vasconcelos; Nuno,9999,0,9999,0
1668332754115,ECE 200,049,103634,Wang; Xiaolong,9999,0,9999,0
1668332754115,ECE 200,050,103635,Xie; Pengtao,9999,0,9999,0
1668332754115,ECE 200,051,103636,Yip; Michael,9999,0,9999,0
1668332754115,ECE 200,052,103637,Zeger; Kenneth A.,999,0,999,0
1668332754115,ECE 200,053,103638,Zhang; Xinyu,9999,0,9999,0
1668332754115,ECE 200,054,103639,Turakhia; Yatish Girish,9999,0,9999,0
1668332754115,ECE 200,055,103640,Kang; Mingu,9999,0,9999,0
1668332754115,ECE 200,056,103641,Shi; Yuanyuan,9999,0,9999,0
1668332754115,ECE 200,057,103642,Wang; Edward Jay,9999,0,9999,0
1668332754115,ECE 200,058,103643,Zheng; Yang,9999,0,9999,0
1668332754542,ECE 202,A00,103644,Kuzum; Duygu,0,0,0,0
1668332754969,ECE 212BN,A00,103646,Ng; Tse Nga,0,0,0,0
1668332755395,ECE 221,A00,111493,Staff,0,0,0,0
1668332755821,ECE 222B,A00,103647,Lomakin; Vitaliy,0,0,0,0
1668332756244,ECE 230B,A00,103648,Taur; Yuan,0,0,0,0
1668332756667,ECE 238B,A00,103649,Garay; Javier,0,0,0,0
1668332757092,ECE 240B,A00,112900,Fainman; Yeshaiahu,0,0,0,0
1668332757521,ECE 247A,A00,103650,Jokerst; Jesse Vincent,0,0,0,0
1668332757944,ECE 247B,A00,103651,Wang; Joseph,0,0,0,0
1668332758369,ECE 250,A00,103652,Siegel; Paul H.,0,0,0,0
1668332758793,ECE 251A,A00,103654,Rao; Bhaskar D.,0,0,0,0
1668332759223,ECE 257B,A00,103655,Bharadia; Dinesh,0,0,0,0
1668332759647,ECE 258A,A00,103656,Milstein; Laurence B.,0,0,0,0
1668332760070,ECE 260B,A00,103658,Kang; Mingu,0,0,0,0
1668332760503,ECE 264A,A00,103659,Galton; Ian A,0,0,0,0
1668332760929,ECE 265A,A00,103661,Gudem; Prasad S.S.,0,0,0,0
1668332761355,ECE 265D,A00,103662,Gudem; Prasad S.S.,0,0,0,0
1668332761783,ECE 268,A00,103663,Koushanfar; Farinaz,0,0,0,0
1668332762300,ECE 269,A01,103665,Pal; Piya,0,0,0,0
1668332762724,ECE 271B,A00,103666,Vasconcelos; Manuela,0,0,0,0
1668332763149,ECE 276A,A00,103667,Atanasov; Nikolay A.,0,0,0,0
1668332763573,ECE 277,A00,103668,An; Cheolhong,0,0,0,0
1668332764001,ECE 279,A00,117947,Hall; Drew A.,0,0,0,0
1668332764852,ECE 283,A00,103670,Hsueh; Tzu-Chien,0,0,0,0
1668332765279,ECE 284,A00,103671,Turakhia; Yatish Girish,0,0,0,0
1668332765706,ECE 285,A00,103672,Zheng; Yang,0,0,0,0
1668332765706,ECE 285,B00,103673,Sworder; David D.,0,0,0,0
1668332766131,ECE 287,A00,103676,Javidi; Tara,0,0,0,0
1668332766556,MATH 200B,A00,098023,Salehi Golsefidy; Alireza,12,0,15,3
1668332766982,MATH 202B,A00,098024,Rhoades; Brendon Patrick,9,0,15,6
1668332767408,MATH 203B,A00,098025,Oprea; Dragos N.,10,0,15,5
1668332767830,MATH 204B,A00,098026,Sorensen; Claus M,13,0,15,2
1668332768254,MATH 208,A00,098027,Izadi; Elham,7,0,10,3
1668332768677,MATH 209,A00,098028,Pollack; Aaron,10,0,10,0
1668332769103,MATH 211A,A00,112919,Rogalski; Daniel,9,0,10,1
1668332769525,MATH 211B,A00,112920,Seward; Brandon M.,9,0,10,1
1668332769952,MATH 218,A00,098029,Li; Bo,10,0,10,0
1668332770380,MATH 220B,A00,098030,Novak; Jonathan I,11,0,15,4
1668332770803,MATH 221A,A00,098031,Ebenfelt; Peter F,13,0,15,2
1668332771231,MATH 231B,A00,098032,Zlatos; Andrej,12,0,15,3
1668332771660,MATH 240B,A00,098033,Ni; Lei,9,0,15,6
1668332772085,MATH 243,A00,098034,Jekel; David Andrew,10,0,10,0
1668332772510,MATH 245A,A00,098035,Nie; Jiawang,0,0,15,16
1668332772932,MATH 248,A00,098036,Bejenaru; Ioan,10,0,10,0
1668332773359,MATH 250B,A00,098037,Spolaor; Luca,14,0,15,1
1668332773786,MATH 258,A00,098038,Ni; Lei,10,0,10,0
1668332774210,MATH 264B,A00,098041,Rhoades; Brendon Patrick,9,0,15,6
1668332774635,MATH 268,A00,098042,Buss; Samuel R,10,0,10,0
1668332775061,MATH 269,A00,098043,Rhoades; Brendon Patrick,10,0,10,0
1668332775488,MATH 270B,A00,098044,Li; Bo,10,0,15,5
1668332775919,MATH 272B,A00,098045,Holst; Michael J,13,0,15,2
1668332776343,MATH 273A,A00,098046,Tian; Xiaochuan,10,0,15,5
1668332776767,MATH 275,A01,098048,Tian; Xiaochuan,6,0,10,4
1668332777189,MATH 278A,A00,098049,Holst; Michael J,8,0,10,2
1668332777616,MATH 278B,A00,098050,Cloninger; Alexander,10,0,10,0
1668332778046,MATH 278C,A00,098051,Nie; Jiawang,7,0,10,3
1668332778469,MATH 280B,A00,098052,Zheng; Tianyi,8,0,15,7
1668332778897,MATH 281B,A00,098053,Bradic; Jelena,1,0,15,14
1668332779322,MATH 282B,A00,098054,Arias-Castro; Ery,0,0,15,15
1668332779750,MATH 285,A00,098055,Fitzsimmons; Patrick J,0,0,15,17
1668332780174,MATH 287B,A00,098056,Arias-Castro; Ery,2,0,15,13
1668332780602,MATH 288,A00,098057,Agarwal; Pooja,9,0,10,1
1668332780602,MATH 288,B00,098058,Zhang; Danna,8,0,10,2
1668332780602,MATH 288,C00,098059,Williams; Ruth J,9,0,10,1
1668332781030,MATH 290B,A00,098060,Roberts; Justin Deritter,13,0,15,2
1668332781459,MATH 292,A00,098061,Belmont; Eva Kinoshita,10,0,10,0
1668332781884,MATH 295,A00,098062,Suk; Andrew Hoon,48,0,50,2
1668332782308,MATH 296,A00,098063,Novak; Jonathan I,20,0,20,0
1668332782736,MATH 297,001,098064,Gamst; Anthony Collins,9997,0,9999,2
1668333282606,COGS 205,A00,101395,Chiba; Andrea,19,0,20,1
1668333283034,COGS 210B,001,101404,Greene; Deanna Jacquelyn,9998,0,9999,1
1668333283034,COGS 210B,002,101417,Xia; Haijun,9999,0,9999,0
1668333283034,COGS 210B,003,101422,Nitz; Douglas A.,9999,0,9999,0
1668333283034,COGS 210B,004,101423,Hollan; James D.,9998,0,9999,1
1668333283034,COGS 210B,005,101424,Deak; Gedeon O.,9998,0,9999,1
1668333283034,COGS 210B,006,101425,Rossano; Federico,9999,0,9999,0
1668333283461,COGS 211B,A00,101427,Coulson; Seana M,9996,0,9999,3
1668333283888,COGS 220,A00,101428,Hollan; James D.,0,0,25,25
1668333284313,COGS 229,A00,101429,Dow; Steven P,18,0,25,7
1668333284740,COGS 230,A00,101430,Klemmer; Scott R,11,0,17,6
1668333285164,COGS 234,A00,101431,Xia; Haijun,1,0,25,24
1668333285596,COGS 260,A00,101432,Kiyonaga; Anastasia,21,0,25,4
1668333285596,COGS 260,B00,101433,Kirsh; David Joel,15,0,25,10
1668333286024,CSE 202,A00,102371,Impagliazzo; Russell,0,0,0,0
1668333286450,CSE 203B,A01,102373,Cheng; Chung Kuan,0,0,0,0
1668333286875,CSE 208,A00,102374,Micciancio; Daniele,0,0,0,0
1668333287300,CSE 209A,A00,112895,Impagliazzo; Russell,0,0,15,15
1668333287727,CSE 209B,A00,108005,Bellare; Mihir,0,0,0,0
1668333288153,CSE 210,A00,113163,Coblenz; Michael J,0,0,0,0
1668333288584,CSE 219,A00,106111,Dow; Steven P,0,0,20,20
1668333289022,CSE 221,A00,102376,Voelker; Geoffrey M.,0,0,0,0
1668333289449,CSE 224,A01,102378,Porter; George M,0,0,0,0
1668333289872,CSE 229A,A00,102379,Savage; Stefan,0,0,0,0
1668333290298,CSE 229C,A00,102380,Munyaka; Imani N. S.,0,0,0,0
1668333290729,CSE 232B,A00,102382,Deutsch; Alin Bernard,0,0,0,0
1668333291162,CSE 234,A01,112904,Kumar; Arun Kumar,0,0,0,0
1668333291588,CSE 237A,A00,102383,Rosing; Tajana Simunic,0,0,0,0
1668333292012,CSE 239A,A00,102384,Deutsch; Alin Bernard,0,0,0,0
1668333292442,CSE 239B,A00,102385,Polikarpova; Nadezhda,0,0,0,0
1668333292867,CSE 240A,A00,102386,Pannuto; Patrick William,0,0,0,0
1668333293292,CSE 240B,A00,102387,Zhao; Jishen,0,0,0,0
1668333293739,CSE 241A,A00,106406,Kang; Mingu,0,0,0,0
1668333294176,CSE 249B,A00,102388,Kahng; Andrew Byun,0,0,8,8
1668333294599,CSE 251B,A01,102392,Cottrell; Garrison W,0,0,0,0
1668333294599,CSE 251B,A02,102393,Cottrell; Garrison W,0,0,0,0
1668333295037,CSE 252B,A00,102394,Ochoa; Benjamin Lawrence,0,0,0,0
1668333295465,CSE 257,A01,102396,Gao; Sicun,0,0,0,0
1668333295894,CSE 272,A00,102397,Li; Tzumao,0,0,0,0
1668333296319,CSE 274,A00,111323,Chern; Albert Ren-Haur,0,0,0,0
1668333296743,CSE 282,A00,102398,Pevzner; Pavel Arkadjevich,0,0,0,0
1668333297180,CSE 284,A00,114175,Gymrek; Melissa Ann,0,0,0,0
1668333297620,CSE 290,A00,102399,Chandraker; Manmohan Krishna,0,0,0,0
1668333297620,CSE 290,B00,102400,Vaccaro; Kristen Marie,0,0,25,25
1668333297620,CSE 290,C00,102414,Pannuto; Patrick William,0,0,25,25
1668333297620,CSE 290,D00,102427,Pevzner; Pavel Arkadjevich,0,0,0,0
1668333297620,CSE 290,E00,102429,Zhao; Jishen,0,0,0,0
1668333297620,CSE 290,F00,102436,Tullsen; Dean Michael,0,0,0,0
1668333297620,CSE 290,G00,102440,Christensen; Henrik I,0,0,20,20
1668333298053,CSE 291,A00,102443,Su; Hao,0,0,0,0
1668333298053,CSE 291,B00,102448,Polikarpova; Nadezhda,0,0,0,0
1668333298053,CSE 291,C00,102453,Vaccaro; Kristen Marie,0,0,0,0
1668333298053,CSE 291,D00,111343,Savage; Stefan,0,0,0,0
1668333298053,CSE 291,E00,116474,Claffy; Kimberly Claire,0,0,0,0
1668333298053,CSE 291,F00,116479,Pasquale; Joseph,0,0,0,0
1668333298529,CSE 293,001,119111,Bafna; Vineet,9999,0,9999,0
1668333298529,CSE 293,002,119118,Bellare; Mihir,9999,0,9999,0
1668333298529,CSE 293,003,119122,Berg-Kirkpatrick; Taylor D,9999,0,9999,0
1668333298529,CSE 293,004,119135,Christensen; Henrik I,9999,0,9999,0
1668333298529,CSE 293,005,119142,Cottrell; Garrison W,9999,0,9999,0
1668333298529,CSE 293,006,119146,Deutsch; Alin Bernard,9999,0,9999,0
1668333298529,CSE 293,007,119159,Esmaeilzadeh; Hadi,9999,0,9999,0
1668333298529,CSE 293,008,119166,Freund; Yoav,9999,0,9999,0
1668333298529,CSE 293,009,119170,Griswold; William G.,9999,0,9999,0
1668333298529,CSE 293,010,119183,Gymrek; Melissa Ann,9999,0,9999,0
1668333298529,CSE 293,011,119190,Heninger; Nadia A,9999,0,9999,0
1668333298529,CSE 293,012,119230,Impagliazzo; Russell,9999,0,9999,0
1668333298529,CSE 293,013,119232,Jhala; Ranjit,9999,0,9999,0
1668333298529,CSE 293,014,119233,Kahng; Andrew Byun,9999,0,9999,0
1668333298529,CSE 293,015,119298,Kane; Daniel Mertz,9999,0,9999,0
1668333298529,CSE 293,016,119299,Kriegman; David J,9999,0,9999,0
1668333298529,CSE 293,017,119300,Kumar; Arun Kumar,9999,0,9999,0
1668333298529,CSE 293,018,119301,Lerner; Sorin,9999,0,9999,0
1668333298529,CSE 293,019,119302,Lovett; Shachar,9999,0,9999,0
1668333298529,CSE 293,020,119303,McAuley; Julian John,9999,0,9999,0
1668333298529,CSE 293,021,119304,Micciancio; Daniele,9999,0,9999,0
1668333298529,CSE 293,022,119367,Orailoglu; Alex,9999,0,9999,0
1668333298529,CSE 293,023,119382,Paturi; Ramamohan,9999,0,9999,0
1668333298529,CSE 293,024,119404,Polikarpova; Nadezhda,9999,0,9999,0
1668333298529,CSE 293,025,119406,Politz; Joseph Gibbs,9999,0,9999,0
1668333298529,CSE 293,026,119411,Porter; George M,9999,0,9999,0
1668333298529,CSE 293,027,119414,Porter; Leonard Emerson,9999,0,9999,0
1668333298529,CSE 293,028,119416,Ramamoorthi; Ravi,9999,0,9999,0
1668333298529,CSE 293,029,119417,Sahoo; Debashis,9999,0,9999,0
1668333298529,CSE 293,030,119420,Saul; Lawrence,9999,0,9999,0
1668333298529,CSE 293,031,119421,Savage; Stefan,9999,0,9999,0
1668333298529,CSE 293,032,119425,Schulze; Jurgen P.,9999,0,9999,0
1668333298529,CSE 293,033,119426,Snoeren; Alex C.,9999,0,9999,0
1668333298529,CSE 293,034,119428,Shang; Jingbo,9999,0,9999,0
1668333298529,CSE 293,035,119430,Stefan; Deian,9999,0,9999,0
1668333298529,CSE 293,036,119431,Su; Hao,9999,0,9999,0
1668333298529,CSE 293,037,119433,Swanson; Steven James,9999,0,9999,0
1668333298529,CSE 293,038,119435,Tullsen; Dean Michael,9999,0,9999,0
1668333298529,CSE 293,039,119483,Voelker; Geoffrey M.,9999,0,9999,0
1668333298529,CSE 293,040,119537,Zhao; Jishen,9999,0,9999,0
1668333298529,CSE 293,041,119538,Zhou; Yuan-Yuan,9999,0,9999,0
1668333298529,CSE 293,042,119539,Gao; Sicun,9999,0,9999,0
1668333298529,CSE 293,043,119540,Weibel; Nadir,9999,0,9999,0
1668333298529,CSE 293,044,119541,Gupta; Rajesh K.,9999,0,9999,0
1668333298529,CSE 293,045,126410,Vaccaro; Kristen Marie,9999,0,9999,0
1668333298529,CSE 293,046,126411,Klemke; Richard,9999,0,9999,0
1668333298955,CSE 294,A00,102459,Voelker; Geoffrey M.,0,0,0,0
1668333298955,CSE 294,B00,111322,Orailoglu; Alex,0,0,0,0
1668333299387,DSE 201,A00,096914,Deutsch; Alin Bernard,30,0,30,0
1668333299817,DSE 210,A00,096915,Dasgupta; Sanjoy,30,0,30,0
1668333300245,DSE 260A,A00,096916,Altintas De Callaf; Ilkay,30,0,30,0
1668333300710,ECE 200,001,103586,Antipa; Nicholas A,9999,0,9999,0
1668333300710,ECE 200,002,103587,Atanasov; Nikolay A.,9999,0,9999,0
1668333300710,ECE 200,003,103588,Bharadia; Dinesh,9999,0,9999,0
1668333300710,ECE 200,004,103589,Cheng; Chung Kuan,9999,0,9999,0
1668333300710,ECE 200,005,103590,Cosman; Pamela C.,9999,0,9999,0
1668333300710,ECE 200,006,103591,Dayeh; Shadi Ahmad,9999,0,9999,0
1668333300710,ECE 200,007,103592,Fainman; Yeshaiahu,9999,0,9999,0
1668333300710,ECE 200,008,103593,Ford; Joseph Earl,9999,0,9999,0
1668333300710,ECE 200,009,103594,Franceschetti; Massimo,9999,0,9999,0
1668333300710,ECE 200,010,103595,Fullerton; Eric E,9999,0,9999,0
1668333300710,ECE 200,011,103596,Galton; Ian A,9999,0,9999,0
1668333300710,ECE 200,012,103597,Gilja; Vikash,9999,0,9999,0
1668333300710,ECE 200,013,103598,Hall; Drew A.,9999,0,9999,0
1668333300710,ECE 200,014,103599,Hsueh; Tzu-Chien,9999,0,9999,0
1668333300710,ECE 200,015,103600,Javidi; Tara,9999,0,9999,0
1668333300710,ECE 200,016,103601,Kahng; Andrew Byun,9999,0,9999,0
1668333300710,ECE 200,017,103602,Kim; Young-Han,9999,0,9999,0
1668333300710,ECE 200,018,103603,Koushanfar; Farinaz,9999,0,9999,0
1668333300710,ECE 200,019,103604,Kuzum; Duygu,9999,0,9999,0
1668333300710,ECE 200,020,103605,Le; Hanh-Phuc,9999,0,9999,0
1668333300710,ECE 200,021,103606,Lin; Bill,9999,0,9999,0
1668333300710,ECE 200,022,103607,Liu; Zhaowei,9998,0,9999,1
1668333300710,ECE 200,023,103608,Lo; Yu-Hwa,9999,0,9999,0
1668333300710,ECE 200,024,103609,Lomakin; Vitaliy,9999,0,9999,0
1668333300710,ECE 200,025,103610,Mercier; Patrick Philip,9999,0,9999,0
1668333300710,ECE 200,026,103611,Meyer; Florian,9999,0,9999,0
1668333300710,ECE 200,027,103612,Milstein; Laurence B.,9999,0,9999,0
1668333300710,ECE 200,028,103613,Mir Arabbaygi; Siavash,9999,0,9999,0
1668333300710,ECE 200,029,103614,Mookherjea; Shayan,9999,0,9999,0
1668333300710,ECE 200,030,103615,Morris; Karcher William,9999,0,9999,0
1668333300710,ECE 200,031,103616,Ng; Tse Nga,9999,0,9999,0
1668333300710,ECE 200,032,103617,Nguyen; Truong Quang,9999,0,9999,0
1668333300710,ECE 200,033,103618,Nomura; Kenji,9999,0,9999,0
1668333300710,ECE 200,034,103619,Orlitsky; Alon,9999,0,9999,0
1668333300710,ECE 200,035,103620,Pal; Piya,9999,0,9999,0
1668333300710,ECE 200,036,103621,Papen; George C.,9999,0,9999,0
1668333300710,ECE 200,037,103622,Radic; Stojan,9999,0,9999,0
1668333300710,ECE 200,038,103623,Rao; Bhaskar D.,9999,0,9999,0
1668333300710,ECE 200,039,103624,Rao; Ramesh R,9999,0,9999,0
1668333300710,ECE 200,040,103625,Rebeiz; Gabriel,9999,0,9999,0
1668333300710,ECE 200,041,103626,Sanford; John R,9999,0,9999,0
1668333300710,ECE 200,042,103627,Siegel; Paul H.,9999,0,9999,0
1668333300710,ECE 200,043,103628,Sievenpiper; Daniel F.,9999,0,9999,0
1668333300710,ECE 200,044,103629,Sworder; David D.,9999,0,9999,0
1668333300710,ECE 200,045,103630,Taur; Yuan,9999,0,9999,0
1668333300710,ECE 200,046,103631,Touri; Behrouz,9999,0,9999,0
1668333300710,ECE 200,047,103632,Trivedi; Mohan M.,9999,0,9999,0
1668333300710,ECE 200,048,103633,Vasconcelos; Nuno,9999,0,9999,0
1668333300710,ECE 200,049,103634,Wang; Xiaolong,9999,0,9999,0
1668333300710,ECE 200,050,103635,Xie; Pengtao,9999,0,9999,0
1668333300710,ECE 200,051,103636,Yip; Michael,9999,0,9999,0
1668333300710,ECE 200,052,103637,Zeger; Kenneth A.,999,0,999,0
1668333300710,ECE 200,053,103638,Zhang; Xinyu,9999,0,9999,0
1668333300710,ECE 200,054,103639,Turakhia; Yatish Girish,9999,0,9999,0
1668333300710,ECE 200,055,103640,Kang; Mingu,9999,0,9999,0
1668333300710,ECE 200,056,103641,Shi; Yuanyuan,9999,0,9999,0
1668333300710,ECE 200,057,103642,Wang; Edward Jay,9999,0,9999,0
1668333300710,ECE 200,058,103643,Zheng; Yang,9999,0,9999,0
1668333301135,ECE 202,A00,103644,Kuzum; Duygu,0,0,0,0
1668333301563,ECE 212BN,A00,103646,Ng; Tse Nga,0,0,0,0
1668333301991,ECE 221,A00,111493,Staff,0,0,0,0
1668333302426,ECE 222B,A00,103647,Lomakin; Vitaliy,0,0,0,0
1668333302852,ECE 230B,A00,103648,Taur; Yuan,0,0,0,0
1668333303286,ECE 238B,A00,103649,Garay; Javier,0,0,0,0
1668333303710,ECE 240B,A00,112900,Fainman; Yeshaiahu,0,0,0,0
1668333304138,ECE 247A,A00,103650,Jokerst; Jesse Vincent,0,0,0,0
1668333304567,ECE 247B,A00,103651,Wang; Joseph,0,0,0,0
1668333304999,ECE 250,A00,103652,Siegel; Paul H.,0,0,0,0
1668333305453,ECE 251A,A00,103654,Rao; Bhaskar D.,0,0,0,0
1668333305877,ECE 257B,A00,103655,Bharadia; Dinesh,0,0,0,0
1668333306306,ECE 258A,A00,103656,Milstein; Laurence B.,0,0,0,0
1668333306730,ECE 260B,A00,103658,Kang; Mingu,0,0,0,0
1668333307185,ECE 264A,A00,103659,Galton; Ian A,0,0,0,0
1668333307611,ECE 265A,A00,103661,Gudem; Prasad S.S.,0,0,0,0
1668333308042,ECE 265D,A00,103662,Gudem; Prasad S.S.,0,0,0,0
1668333308466,ECE 268,A00,103663,Koushanfar; Farinaz,0,0,0,0
1668333308890,ECE 269,A01,103665,Pal; Piya,0,0,0,0
1668333309321,ECE 271B,A00,103666,Vasconcelos; Manuela,0,0,0,0
1668333309748,ECE 276A,A00,103667,Atanasov; Nikolay A.,0,0,0,0
1668333310178,ECE 277,A00,103668,An; Cheolhong,0,0,0,0
1668333310602,ECE 279,A00,117947,Hall; Drew A.,0,0,0,0
1668333311463,ECE 283,A00,103670,Hsueh; Tzu-Chien,0,0,0,0
1668333311893,ECE 284,A00,103671,Turakhia; Yatish Girish,0,0,0,0
1668333312325,ECE 285,A00,103672,Zheng; Yang,0,0,0,0
1668333312325,ECE 285,B00,103673,Sworder; David D.,0,0,0,0
1668333312749,ECE 287,A00,103676,Javidi; Tara,0,0,0,0
1668333313195,MATH 200B,A00,098023,Salehi Golsefidy; Alireza,12,0,15,3
1668333313625,MATH 202B,A00,098024,Rhoades; Brendon Patrick,9,0,15,6
1668333314051,MATH 203B,A00,098025,Oprea; Dragos N.,10,0,15,5
1668333314475,MATH 204B,A00,098026,Sorensen; Claus M,13,0,15,2
1668333314907,MATH 208,A00,098027,Izadi; Elham,7,0,10,3
1668333315337,MATH 209,A00,098028,Pollack; Aaron,10,0,10,0
1668333315760,MATH 211A,A00,112919,Rogalski; Daniel,9,0,10,1
1668333316187,MATH 211B,A00,112920,Seward; Brandon M.,9,0,10,1
1668333316623,MATH 218,A00,098029,Li; Bo,10,0,10,0
1668333317050,MATH 220B,A00,098030,Novak; Jonathan I,11,0,15,4
1668333317483,MATH 221A,A00,098031,Ebenfelt; Peter F,13,0,15,2
1668333317913,MATH 231B,A00,098032,Zlatos; Andrej,12,0,15,3
1668333318346,MATH 240B,A00,098033,Ni; Lei,9,0,15,6
1668333318773,MATH 243,A00,098034,Jekel; David Andrew,10,0,10,0
1668333319203,MATH 245A,A00,098035,Nie; Jiawang,0,0,15,16
1668333319633,MATH 248,A00,098036,Bejenaru; Ioan,10,0,10,0
1668333320091,MATH 250B,A00,098037,Spolaor; Luca,14,0,15,1
1668333320516,MATH 258,A00,098038,Ni; Lei,10,0,10,0
1668333320946,MATH 264B,A00,098041,Rhoades; Brendon Patrick,9,0,15,6
1668333321370,MATH 268,A00,098042,Buss; Samuel R,10,0,10,0
1668333321794,MATH 269,A00,098043,Rhoades; Brendon Patrick,10,0,10,0
1668333322218,MATH 270B,A00,098044,Li; Bo,10,0,15,5
1668333322650,MATH 272B,A00,098045,Holst; Michael J,13,0,15,2
1668333323082,MATH 273A,A00,098046,Tian; Xiaochuan,10,0,15,5
1668333323506,MATH 275,A01,098048,Tian; Xiaochuan,6,0,10,4
1668333323932,MATH 278A,A00,098049,Holst; Michael J,8,0,10,2
1668333324357,MATH 278B,A00,098050,Cloninger; Alexander,10,0,10,0
1668333324783,MATH 278C,A00,098051,Nie; Jiawang,7,0,10,3
1668333325207,MATH 280B,A00,098052,Zheng; Tianyi,8,0,15,7
1668333325725,MATH 281B,A00,098053,Bradic; Jelena,1,0,15,14
1668333326152,MATH 282B,A00,098054,Arias-Castro; Ery,0,0,15,15
1668333326579,MATH 285,A00,098055,Fitzsimmons; Patrick J,0,0,15,17
1668333327003,MATH 287B,A00,098056,Arias-Castro; Ery,2,0,15,13
1668333327431,MATH 288,A00,098057,Agarwal; Pooja,9,0,10,1
1668333327431,MATH 288,B00,098058,Zhang; Danna,8,0,10,2
1668333327431,MATH 288,C00,098059,Williams; Ruth J,9,0,10,1
1668333327855,MATH 290B,A00,098060,Roberts; Justin Deritter,13,0,15,2
1668333328285,MATH 292,A00,098061,Belmont; Eva Kinoshita,10,0,10,0
1668333328716,MATH 295,A00,098062,Suk; Andrew Hoon,48,0,50,2
1668333329138,MATH 296,A00,098063,Novak; Jonathan I,20,0,20,0
1668333329564,MATH 297,001,098064,Gamst; Anthony Collins,9997,0,9999,2
1668333830908,COGS 205,A00,101395,Chiba; Andrea,19,0,20,1
1668333831334,COGS 210B,001,101404,Greene; Deanna Jacquelyn,9998,0,9999,1
1668333831334,COGS 210B,002,101417,Xia; Haijun,9999,0,9999,0
1668333831334,COGS 210B,003,101422,Nitz; Douglas A.,9999,0,9999,0
1668333831334,COGS 210B,004,101423,Hollan; James D.,9998,0,9999,1
1668333831334,COGS 210B,005,101424,Deak; Gedeon O.,9998,0,9999,1
1668333831334,COGS 210B,006,101425,Rossano; Federico,9999,0,9999,0
1668333831762,COGS 211B,A00,101427,Coulson; Seana M,9996,0,9999,3
1668333832189,COGS 220,A00,101428,Hollan; James D.,0,0,25,25
1668333832615,COGS 229,A00,101429,Dow; Steven P,18,0,25,7
1668333833040,COGS 230,A00,101430,Klemmer; Scott R,11,0,17,6
1668333833467,COGS 234,A00,101431,Xia; Haijun,1,0,25,24
1668333833897,COGS 260,A00,101432,Kiyonaga; Anastasia,21,0,25,4
1668333833897,COGS 260,B00,101433,Kirsh; David Joel,15,0,25,10
1668333834323,CSE 202,A00,102371,Impagliazzo; Russell,0,0,0,0
1668333834758,CSE 203B,A01,102373,Cheng; Chung Kuan,0,0,0,0
1668333835184,CSE 208,A00,102374,Micciancio; Daniele,0,0,0,0
1668333835609,CSE 209A,A00,112895,Impagliazzo; Russell,0,0,15,15
1668333836037,CSE 209B,A00,108005,Bellare; Mihir,0,0,0,0
1668333836462,CSE 210,A00,113163,Coblenz; Michael J,0,0,0,0
1668333836888,CSE 219,A00,106111,Dow; Steven P,0,0,20,20
1668333837313,CSE 221,A00,102376,Voelker; Geoffrey M.,0,0,0,0
1668333837742,CSE 224,A01,102378,Porter; George M,0,0,0,0
1668333838165,CSE 229A,A00,102379,Savage; Stefan,0,0,0,0
1668333838594,CSE 229C,A00,102380,Munyaka; Imani N. S.,0,0,0,0
1668333839021,CSE 232B,A00,102382,Deutsch; Alin Bernard,0,0,0,0
1668333839447,CSE 234,A01,112904,Kumar; Arun Kumar,0,0,0,0
1668333839872,CSE 237A,A00,102383,Rosing; Tajana Simunic,0,0,0,0
1668333840296,CSE 239A,A00,102384,Deutsch; Alin Bernard,0,0,0,0
1668333840721,CSE 239B,A00,102385,Polikarpova; Nadezhda,0,0,0,0
1668333841154,CSE 240A,A00,102386,Pannuto; Patrick William,0,0,0,0
1668333841580,CSE 240B,A00,102387,Zhao; Jishen,0,0,0,0
1668333842006,CSE 241A,A00,106406,Kang; Mingu,0,0,0,0
1668333842432,CSE 249B,A00,102388,Kahng; Andrew Byun,0,0,8,8
1668333842858,CSE 251B,A01,102392,Cottrell; Garrison W,0,0,0,0
1668333842858,CSE 251B,A02,102393,Cottrell; Garrison W,0,0,0,0
1668333843290,CSE 252B,A00,102394,Ochoa; Benjamin Lawrence,0,0,0,0
1668333843719,CSE 257,A01,102396,Gao; Sicun,0,0,0,0
1668333844146,CSE 272,A00,102397,Li; Tzumao,0,0,0,0
1668333844570,CSE 274,A00,111323,Chern; Albert Ren-Haur,0,0,0,0
1668333845003,CSE 282,A00,102398,Pevzner; Pavel Arkadjevich,0,0,0,0
1668333845433,CSE 284,A00,114175,Gymrek; Melissa Ann,0,0,0,0
1668333845860,CSE 290,A00,102399,Chandraker; Manmohan Krishna,0,0,0,0
1668333845860,CSE 290,B00,102400,Vaccaro; Kristen Marie,0,0,25,25
1668333845860,CSE 290,C00,102414,Pannuto; Patrick William,0,0,25,25
1668333845860,CSE 290,D00,102427,Pevzner; Pavel Arkadjevich,0,0,0,0
1668333845860,CSE 290,E00,102429,Zhao; Jishen,0,0,0,0
1668333845860,CSE 290,F00,102436,Tullsen; Dean Michael,0,0,0,0
1668333845860,CSE 290,G00,102440,Christensen; Henrik I,0,0,20,20
1668333846284,CSE 291,A00,102443,Su; Hao,0,0,0,0
1668333846284,CSE 291,B00,102448,Polikarpova; Nadezhda,0,0,0,0
1668333846284,CSE 291,C00,102453,Vaccaro; Kristen Marie,0,0,0,0
1668333846284,CSE 291,D00,111343,Savage; Stefan,0,0,0,0
1668333846284,CSE 291,E00,116474,Claffy; Kimberly Claire,0,0,0,0
1668333846284,CSE 291,F00,116479,Pasquale; Joseph,0,0,0,0
1668333846745,CSE 293,001,119111,Bafna; Vineet,9999,0,9999,0
1668333846745,CSE 293,002,119118,Bellare; Mihir,9999,0,9999,0
1668333846745,CSE 293,003,119122,Berg-Kirkpatrick; Taylor D,9999,0,9999,0
1668333846745,CSE 293,004,119135,Christensen; Henrik I,9999,0,9999,0
1668333846745,CSE 293,005,119142,Cottrell; Garrison W,9999,0,9999,0
1668333846745,CSE 293,006,119146,Deutsch; Alin Bernard,9999,0,9999,0
1668333846745,CSE 293,007,119159,Esmaeilzadeh; Hadi,9999,0,9999,0
1668333846745,CSE 293,008,119166,Freund; Yoav,9999,0,9999,0
1668333846745,CSE 293,009,119170,Griswold; William G.,9999,0,9999,0
1668333846745,CSE 293,010,119183,Gymrek; Melissa Ann,9999,0,9999,0
1668333846745,CSE 293,011,119190,Heninger; Nadia A,9999,0,9999,0
1668333846745,CSE 293,012,119230,Impagliazzo; Russell,9999,0,9999,0
1668333846745,CSE 293,013,119232,Jhala; Ranjit,9999,0,9999,0
1668333846745,CSE 293,014,119233,Kahng; Andrew Byun,9999,0,9999,0
1668333846745,CSE 293,015,119298,Kane; Daniel Mertz,9999,0,9999,0
1668333846745,CSE 293,016,119299,Kriegman; David J,9999,0,9999,0
1668333846745,CSE 293,017,119300,Kumar; Arun Kumar,9999,0,9999,0
1668333846745,CSE 293,018,119301,Lerner; Sorin,9999,0,9999,0
1668333846745,CSE 293,019,119302,Lovett; Shachar,9999,0,9999,0
1668333846745,CSE 293,020,119303,McAuley; Julian John,9999,0,9999,0
1668333846745,CSE 293,021,119304,Micciancio; Daniele,9999,0,9999,0
1668333846745,CSE 293,022,119367,Orailoglu; Alex,9999,0,9999,0
1668333846745,CSE 293,023,119382,Paturi; Ramamohan,9999,0,9999,0
1668333846745,CSE 293,024,119404,Polikarpova; Nadezhda,9999,0,9999,0
1668333846745,CSE 293,025,119406,Politz; Joseph Gibbs,9999,0,9999,0
1668333846745,CSE 293,026,119411,Porter; George M,9999,0,9999,0
1668333846745,CSE 293,027,119414,Porter; Leonard Emerson,9999,0,9999,0
1668333846745,CSE 293,028,119416,Ramamoorthi; Ravi,9999,0,9999,0
1668333846745,CSE 293,029,119417,Sahoo; Debashis,9999,0,9999,0
1668333846745,CSE 293,030,119420,Saul; Lawrence,9999,0,9999,0
1668333846745,CSE 293,031,119421,Savage; Stefan,9999,0,9999,0
1668333846745,CSE 293,032,119425,Schulze; Jurgen P.,9999,0,9999,0
1668333846745,CSE 293,033,119426,Snoeren; Alex C.,9999,0,9999,0
1668333846745,CSE 293,034,119428,Shang; Jingbo,9999,0,9999,0
1668333846745,CSE 293,035,119430,Stefan; Deian,9999,0,9999,0
1668333846745,CSE 293,036,119431,Su; Hao,9999,0,9999,0
1668333846745,CSE 293,037,119433,Swanson; Steven James,9999,0,9999,0
1668333846745,CSE 293,038,119435,Tullsen; Dean Michael,9999,0,9999,0
1668333846745,CSE 293,039,119483,Voelker; Geoffrey M.,9999,0,9999,0
1668333846745,CSE 293,040,119537,Zhao; Jishen,9999,0,9999,0
1668333846745,CSE 293,041,119538,Zhou; Yuan-Yuan,9999,0,9999,0
1668333846745,CSE 293,042,119539,Gao; Sicun,9999,0,9999,0
1668333846745,CSE 293,043,119540,Weibel; Nadir,9999,0,9999,0
1668333846745,CSE 293,044,119541,Gupta; Rajesh K.,9999,0,9999,0
1668333846745,CSE 293,045,126410,Vaccaro; Kristen Marie,9999,0,9999,0
1668333846745,CSE 293,046,126411,Klemke; Richard,9999,0,9999,0
1668333847266,CSE 294,A00,102459,Voelker; Geoffrey M.,0,0,0,0
1668333847266,CSE 294,B00,111322,Orailoglu; Alex,0,0,0,0
1668333847693,DSE 201,A00,096914,Deutsch; Alin Bernard,30,0,30,0
1668333848118,DSE 210,A00,096915,Dasgupta; Sanjoy,30,0,30,0
1668333848548,DSE 260A,A00,096916,Altintas De Callaf; Ilkay,30,0,30,0
1668333849010,ECE 200,001,103586,Antipa; Nicholas A,9999,0,9999,0
1668333849010,ECE 200,002,103587,Atanasov; Nikolay A.,9999,0,9999,0
1668333849010,ECE 200,003,103588,Bharadia; Dinesh,9999,0,9999,0
1668333849010,ECE 200,004,103589,Cheng; Chung Kuan,9999,0,9999,0
1668333849010,ECE 200,005,103590,Cosman; Pamela C.,9999,0,9999,0
1668333849010,ECE 200,006,103591,Dayeh; Shadi Ahmad,9999,0,9999,0
1668333849010,ECE 200,007,103592,Fainman; Yeshaiahu,9999,0,9999,0
1668333849010,ECE 200,008,103593,Ford; Joseph Earl,9999,0,9999,0
1668333849010,ECE 200,009,103594,Franceschetti; Massimo,9999,0,9999,0
1668333849010,ECE 200,010,103595,Fullerton; Eric E,9999,0,9999,0
1668333849010,ECE 200,011,103596,Galton; Ian A,9999,0,9999,0
1668333849010,ECE 200,012,103597,Gilja; Vikash,9999,0,9999,0
1668333849010,ECE 200,013,103598,Hall; Drew A.,9999,0,9999,0
1668333849010,ECE 200,014,103599,Hsueh; Tzu-Chien,9999,0,9999,0
1668333849010,ECE 200,015,103600,Javidi; Tara,9999,0,9999,0
1668333849010,ECE 200,016,103601,Kahng; Andrew Byun,9999,0,9999,0
1668333849010,ECE 200,017,103602,Kim; Young-Han,9999,0,9999,0
1668333849010,ECE 200,018,103603,Koushanfar; Farinaz,9999,0,9999,0
1668333849010,ECE 200,019,103604,Kuzum; Duygu,9999,0,9999,0
1668333849010,ECE 200,020,103605,Le; Hanh-Phuc,9999,0,9999,0
1668333849010,ECE 200,021,103606,Lin; Bill,9999,0,9999,0
1668333849010,ECE 200,022,103607,Liu; Zhaowei,9998,0,9999,1
1668333849010,ECE 200,023,103608,Lo; Yu-Hwa,9999,0,9999,0
1668333849010,ECE 200,024,103609,Lomakin; Vitaliy,9999,0,9999,0
1668333849010,ECE 200,025,103610,Mercier; Patrick Philip,9999,0,9999,0
1668333849010,ECE 200,026,103611,Meyer; Florian,9999,0,9999,0
1668333849010,ECE 200,027,103612,Milstein; Laurence B.,9999,0,9999,0
1668333849010,ECE 200,028,103613,Mir Arabbaygi; Siavash,9999,0,9999,0
1668333849010,ECE 200,029,103614,Mookherjea; Shayan,9999,0,9999,0
1668333849010,ECE 200,030,103615,Morris; Karcher William,9999,0,9999,0
1668333849010,ECE 200,031,103616,Ng; Tse Nga,9999,0,9999,0
1668333849010,ECE 200,032,103617,Nguyen; Truong Quang,9999,0,9999,0
1668333849010,ECE 200,033,103618,Nomura; Kenji,9999,0,9999,0
1668333849010,ECE 200,034,103619,Orlitsky; Alon,9999,0,9999,0
1668333849010,ECE 200,035,103620,Pal; Piya,9999,0,9999,0
1668333849010,ECE 200,036,103621,Papen; George C.,9999,0,9999,0
1668333849010,ECE 200,037,103622,Radic; Stojan,9999,0,9999,0
1668333849010,ECE 200,038,103623,Rao; Bhaskar D.,9999,0,9999,0
1668333849010,ECE 200,039,103624,Rao; Ramesh R,9999,0,9999,0
1668333849010,ECE 200,040,103625,Rebeiz; Gabriel,9999,0,9999,0
1668333849010,ECE 200,041,103626,Sanford; John R,9999,0,9999,0
1668333849010,ECE 200,042,103627,Siegel; Paul H.,9999,0,9999,0
1668333849010,ECE 200,043,103628,Sievenpiper; Daniel F.,9999,0,9999,0
1668333849010,ECE 200,044,103629,Sworder; David D.,9999,0,9999,0
1668333849010,ECE 200,045,103630,Taur; Yuan,9999,0,9999,0
1668333849010,ECE 200,046,103631,Touri; Behrouz,9999,0,9999,0
1668333849010,ECE 200,047,103632,Trivedi; Mohan M.,9999,0,9999,0
1668333849010,ECE 200,048,103633,Vasconcelos; Nuno,9999,0,9999,0
1668333849010,ECE 200,049,103634,Wang; Xiaolong,9999,0,9999,0
1668333849010,ECE 200,050,103635,Xie; Pengtao,9999,0,9999,0
1668333849010,ECE 200,051,103636,Yip; Michael,9999,0,9999,0
1668333849010,ECE 200,052,103637,Zeger; Kenneth A.,999,0,999,0
1668333849010,ECE 200,053,103638,Zhang; Xinyu,9999,0,9999,0
1668333849010,ECE 200,054,103639,Turakhia; Yatish Girish,9999,0,9999,0
1668333849010,ECE 200,055,103640,Kang; Mingu,9999,0,9999,0
1668333849010,ECE 200,056,103641,Shi; Yuanyuan,9999,0,9999,0
1668333849010,ECE 200,057,103642,Wang; Edward Jay,9999,0,9999,0
1668333849010,ECE 200,058,103643,Zheng; Yang,9999,0,9999,0
1668333849438,ECE 202,A00,103644,Kuzum; Duygu,0,0,0,0
1668333849869,ECE 212BN,A00,103646,Ng; Tse Nga,0,0,0,0
1668333850298,ECE 221,A00,111493,Staff,0,0,0,0
1668333850724,ECE 222B,A00,103647,Lomakin; Vitaliy,0,0,0,0
1668333851151,ECE 230B,A00,103648,Taur; Yuan,0,0,0,0
1668333851576,ECE 238B,A00,103649,Garay; Javier,0,0,0,0
1668333851999,ECE 240B,A00,112900,Fainman; Yeshaiahu,0,0,0,0
1668333852423,ECE 247A,A00,103650,Jokerst; Jesse Vincent,0,0,0,0
1668333852847,ECE 247B,A00,103651,Wang; Joseph,0,0,0,0
1668333853271,ECE 250,A00,103652,Siegel; Paul H.,0,0,0,0
1668333853697,ECE 251A,A00,103654,Rao; Bhaskar D.,0,0,0,0
1668333854123,ECE 257B,A00,103655,Bharadia; Dinesh,0,0,0,0
1668333854552,ECE 258A,A00,103656,Milstein; Laurence B.,0,0,0,0
1668333854976,ECE 260B,A00,103658,Kang; Mingu,0,0,0,0
1668333855408,ECE 264A,A00,103659,Galton; Ian A,0,0,0,0
1668333855832,ECE 265A,A00,103661,Gudem; Prasad S.S.,0,0,0,0
1668333856257,ECE 265D,A00,103662,Gudem; Prasad S.S.,0,0,0,0
1668333856685,ECE 268,A00,103663,Koushanfar; Farinaz,0,0,0,0
1668333857109,ECE 269,A01,103665,Pal; Piya,0,0,0,0
1668333857534,ECE 271B,A00,103666,Vasconcelos; Manuela,0,0,0,0
1668333857960,ECE 276A,A00,103667,Atanasov; Nikolay A.,0,0,0,0
1668333858389,ECE 277,A00,103668,An; Cheolhong,0,0,0,0
1668333858821,ECE 279,A00,117947,Hall; Drew A.,0,0,0,0
1668333859678,ECE 283,A00,103670,Hsueh; Tzu-Chien,0,0,0,0
1668333860106,ECE 284,A00,103671,Turakhia; Yatish Girish,0,0,0,0
1668333860536,ECE 285,A00,103672,Zheng; Yang,0,0,0,0
1668333860536,ECE 285,B00,103673,Sworder; David D.,0,0,0,0
1668333860962,ECE 287,A00,103676,Javidi; Tara,0,0,0,0
1668333861398,MATH 200B,A00,098023,Salehi Golsefidy; Alireza,12,0,15,3
1668333861822,MATH 202B,A00,098024,Rhoades; Brendon Patrick,9,0,15,6
1668333862253,MATH 203B,A00,098025,Oprea; Dragos N.,10,0,15,5
1668333862676,MATH 204B,A00,098026,Sorensen; Claus M,13,0,15,2
1668333863105,MATH 208,A00,098027,Izadi; Elham,7,0,10,3
1668333863529,MATH 209,A00,098028,Pollack; Aaron,10,0,10,0
1668333863955,MATH 211A,A00,112919,Rogalski; Daniel,9,0,10,1
1668333864381,MATH 211B,A00,112920,Seward; Brandon M.,9,0,10,1
1668333864804,MATH 218,A00,098029,Li; Bo,10,0,10,0
1668333865232,MATH 220B,A00,098030,Novak; Jonathan I,11,0,15,4
1668333865656,MATH 221A,A00,098031,Ebenfelt; Peter F,13,0,15,2
1668333866086,MATH 231B,A00,098032,Zlatos; Andrej,12,0,15,3
1668333866512,MATH 240B,A00,098033,Ni; Lei,9,0,15,6
1668333866936,MATH 243,A00,098034,Jekel; David Andrew,10,0,10,0
1668333867364,MATH 245A,A00,098035,Nie; Jiawang,0,0,15,16
1668333867787,MATH 248,A00,098036,Bejenaru; Ioan,10,0,10,0
1668333868220,MATH 250B,A00,098037,Spolaor; Luca,14,0,15,1
1668333868644,MATH 258,A00,098038,Ni; Lei,10,0,10,0
1668333869073,MATH 264B,A00,098041,Rhoades; Brendon Patrick,9,0,15,6
1668333869498,MATH 268,A00,098042,Buss; Samuel R,10,0,10,0
1668333869926,MATH 269,A00,098043,Rhoades; Brendon Patrick,10,0,10,0
1668333870349,MATH 270B,A00,098044,Li; Bo,10,0,15,5
1668333870774,MATH 272B,A00,098045,Holst; Michael J,13,0,15,2
1668333871202,MATH 273A,A00,098046,Tian; Xiaochuan,10,0,15,5
1668333871631,MATH 275,A01,098048,Tian; Xiaochuan,6,0,10,4
1668333872056,MATH 278A,A00,098049,Holst; Michael J,8,0,10,2
1668333872485,MATH 278B,A00,098050,Cloninger; Alexander,10,0,10,0
1668333872908,MATH 278C,A00,098051,Nie; Jiawang,7,0,10,3
1668333873347,MATH 280B,A00,098052,Zheng; Tianyi,8,0,15,7
1668333873769,MATH 281B,A00,098053,Bradic; Jelena,1,0,15,14
1668333874194,MATH 282B,A00,098054,Arias-Castro; Ery,0,0,15,15
1668333874626,MATH 285,A00,098055,Fitzsimmons; Patrick J,0,0,15,17
1668333875049,MATH 287B,A00,098056,Arias-Castro; Ery,2,0,15,13
1668333875500,MATH 288,A00,098057,Agarwal; Pooja,9,0,10,1
1668333875500,MATH 288,B00,098058,Zhang; Danna,8,0,10,2
1668333875500,MATH 288,C00,098059,Williams; Ruth J,9,0,10,1
1668333875943,MATH 290B,A00,098060,Roberts; Justin Deritter,13,0,15,2
1668333876369,MATH 292,A00,098061,Belmont; Eva Kinoshita,10,0,10,0
1668333876793,MATH 295,A00,098062,Suk; Andrew Hoon,48,0,50,2
1668333877239,MATH 296,A00,098063,Novak; Jonathan I,20,0,20,0
1668333877661,MATH 297,001,098064,Gamst; Anthony Collins,9997,0,9999,2
1668334379492,COGS 205,A00,101395,Chiba; Andrea,19,0,20,1
1668334379926,COGS 210B,001,101404,Greene; Deanna Jacquelyn,9998,0,9999,1
1668334379926,COGS 210B,002,101417,Xia; Haijun,9999,0,9999,0
1668334379926,COGS 210B,003,101422,Nitz; Douglas A.,9999,0,9999,0
1668334379926,COGS 210B,004,101423,Hollan; James D.,9998,0,9999,1
1668334379926,COGS 210B,005,101424,Deak; Gedeon O.,9998,0,9999,1
1668334379926,COGS 210B,006,101425,Rossano; Federico,9999,0,9999,0
1668334380350,COGS 211B,A00,101427,Coulson; Seana M,9996,0,9999,3
1668334380778,COGS 220,A00,101428,Hollan; James D.,0,0,25,25
1668334381203,COGS 229,A00,101429,Dow; Steven P,18,0,25,7
1668334381627,COGS 230,A00,101430,Klemmer; Scott R,11,0,17,6
1668334382049,COGS 234,A00,101431,Xia; Haijun,1,0,25,24
1668334382473,COGS 260,A00,101432,Kiyonaga; Anastasia,21,0,25,4
1668334382473,COGS 260,B00,101433,Kirsh; David Joel,15,0,25,10
1668334382900,CSE 202,A00,102371,Impagliazzo; Russell,0,0,0,0
1668334383325,CSE 203B,A01,102373,Cheng; Chung Kuan,0,0,0,0
1668334383750,CSE 208,A00,102374,Micciancio; Daniele,0,0,0,0
1668334384174,CSE 209A,A00,112895,Impagliazzo; Russell,0,0,15,15
1668334384600,CSE 209B,A00,108005,Bellare; Mihir,0,0,0,0
1668334385030,CSE 210,A00,113163,Coblenz; Michael J,0,0,0,0
1668334385454,CSE 219,A00,106111,Dow; Steven P,0,0,20,20
1668334385884,CSE 221,A00,102376,Voelker; Geoffrey M.,0,0,0,0
1668334386316,CSE 224,A01,102378,Porter; George M,0,0,0,0
1668334386754,CSE 229A,A00,102379,Savage; Stefan,0,0,0,0
1668334387188,CSE 229C,A00,102380,Munyaka; Imani N. S.,0,0,0,0
1668334387614,CSE 232B,A00,102382,Deutsch; Alin Bernard,0,0,0,0
1668334388043,CSE 234,A01,112904,Kumar; Arun Kumar,0,0,0,0
1668334388472,CSE 237A,A00,102383,Rosing; Tajana Simunic,0,0,0,0
1668334388905,CSE 239A,A00,102384,Deutsch; Alin Bernard,0,0,0,0
1668334389332,CSE 239B,A00,102385,Polikarpova; Nadezhda,0,0,0,0
1668334389761,CSE 240A,A00,102386,Pannuto; Patrick William,0,0,0,0
1668334390185,CSE 240B,A00,102387,Zhao; Jishen,0,0,0,0
1668334390610,CSE 241A,A00,106406,Kang; Mingu,0,0,0,0
1668334391039,CSE 249B,A00,102388,Kahng; Andrew Byun,0,0,8,8
1668334391468,CSE 251B,A01,102392,Cottrell; Garrison W,0,0,0,0
1668334391468,CSE 251B,A02,102393,Cottrell; Garrison W,0,0,0,0
1668334391898,CSE 252B,A00,102394,Ochoa; Benjamin Lawrence,0,0,0,0
1668334392320,CSE 257,A01,102396,Gao; Sicun,0,0,0,0
1668334392751,CSE 272,A00,102397,Li; Tzumao,0,0,0,0
1668334393177,CSE 274,A00,111323,Chern; Albert Ren-Haur,0,0,0,0
1668334393604,CSE 282,A00,102398,Pevzner; Pavel Arkadjevich,0,0,0,0
1668334394034,CSE 284,A00,114175,Gymrek; Melissa Ann,0,0,0,0
1668334394469,CSE 290,A00,102399,Chandraker; Manmohan Krishna,0,0,0,0
1668334394469,CSE 290,B00,102400,Vaccaro; Kristen Marie,0,0,25,25
1668334394469,CSE 290,C00,102414,Pannuto; Patrick William,0,0,25,25
1668334394469,CSE 290,D00,102427,Pevzner; Pavel Arkadjevich,0,0,0,0
1668334394469,CSE 290,E00,102429,Zhao; Jishen,0,0,0,0
1668334394469,CSE 290,F00,102436,Tullsen; Dean Michael,0,0,0,0
1668334394469,CSE 290,G00,102440,Christensen; Henrik I,0,0,20,20
1668334394895,CSE 291,A00,102443,Su; Hao,0,0,0,0
1668334394895,CSE 291,B00,102448,Polikarpova; Nadezhda,0,0,0,0
1668334394895,CSE 291,C00,102453,Vaccaro; Kristen Marie,0,0,0,0
1668334394895,CSE 291,D00,111343,Savage; Stefan,0,0,0,0
1668334394895,CSE 291,E00,116474,Claffy; Kimberly Claire,0,0,0,0
1668334394895,CSE 291,F00,116479,Pasquale; Joseph,0,0,0,0
1668334395359,CSE 293,001,119111,Bafna; Vineet,9999,0,9999,0
1668334395359,CSE 293,002,119118,Bellare; Mihir,9999,0,9999,0
1668334395359,CSE 293,003,119122,Berg-Kirkpatrick; Taylor D,9999,0,9999,0
1668334395359,CSE 293,004,119135,Christensen; Henrik I,9999,0,9999,0
1668334395359,CSE 293,005,119142,Cottrell; Garrison W,9999,0,9999,0
1668334395359,CSE 293,006,119146,Deutsch; Alin Bernard,9999,0,9999,0
1668334395359,CSE 293,007,119159,Esmaeilzadeh; Hadi,9999,0,9999,0
1668334395359,CSE 293,008,119166,Freund; Yoav,9999,0,9999,0
1668334395359,CSE 293,009,119170,Griswold; William G.,9999,0,9999,0
1668334395359,CSE 293,010,119183,Gymrek; Melissa Ann,9999,0,9999,0
1668334395359,CSE 293,011,119190,Heninger; Nadia A,9999,0,9999,0
1668334395359,CSE 293,012,119230,Impagliazzo; Russell,9999,0,9999,0
1668334395359,CSE 293,013,119232,Jhala; Ranjit,9999,0,9999,0
1668334395359,CSE 293,014,119233,Kahng; Andrew Byun,9999,0,9999,0
1668334395359,CSE 293,015,119298,Kane; Daniel Mertz,9999,0,9999,0
1668334395359,CSE 293,016,119299,Kriegman; David J,9999,0,9999,0
1668334395359,CSE 293,017,119300,Kumar; Arun Kumar,9999,0,9999,0
1668334395359,CSE 293,018,119301,Lerner; Sorin,9999,0,9999,0
1668334395359,CSE 293,019,119302,Lovett; Shachar,9999,0,9999,0
1668334395359,CSE 293,020,119303,McAuley; Julian John,9999,0,9999,0
1668334395359,CSE 293,021,119304,Micciancio; Daniele,9999,0,9999,0
1668334395359,CSE 293,022,119367,Orailoglu; Alex,9999,0,9999,0
1668334395359,CSE 293,023,119382,Paturi; Ramamohan,9999,0,9999,0
1668334395359,CSE 293,024,119404,Polikarpova; Nadezhda,9999,0,9999,0
1668334395359,CSE 293,025,119406,Politz; Joseph Gibbs,9999,0,9999,0
1668334395359,CSE 293,026,119411,Porter; George M,9999,0,9999,0
1668334395359,CSE 293,027,119414,Porter; Leonard Emerson,9999,0,9999,0
1668334395359,CSE 293,028,119416,Ramamoorthi; Ravi,9999,0,9999,0
1668334395359,CSE 293,029,119417,Sahoo; Debashis,9999,0,9999,0
1668334395359,CSE 293,030,119420,Saul; Lawrence,9999,0,9999,0
1668334395359,CSE 293,031,119421,Savage; Stefan,9999,0,9999,0
1668334395359,CSE 293,032,119425,Schulze; Jurgen P.,9999,0,9999,0
1668334395359,CSE 293,033,119426,Snoeren; Alex C.,9999,0,9999,0
1668334395359,CSE 293,034,119428,Shang; Jingbo,9999,0,9999,0
1668334395359,CSE 293,035,119430,Stefan; Deian,9999,0,9999,0
1668334395359,CSE 293,036,119431,Su; Hao,9999,0,9999,0
1668334395359,CSE 293,037,119433,Swanson; Steven James,9999,0,9999,0
1668334395359,CSE 293,038,119435,Tullsen; Dean Michael,9999,0,9999,0
1668334395359,CSE 293,039,119483,Voelker; Geoffrey M.,9999,0,9999,0
1668334395359,CSE 293,040,119537,Zhao; Jishen,9999,0,9999,0
1668334395359,CSE 293,041,119538,Zhou; Yuan-Yuan,9999,0,9999,0
1668334395359,CSE 293,042,119539,Gao; Sicun,9999,0,9999,0
1668334395359,CSE 293,043,119540,Weibel; Nadir,9999,0,9999,0
1668334395359,CSE 293,044,119541,Gupta; Rajesh K.,9999,0,9999,0
1668334395359,CSE 293,045,126410,Vaccaro; Kristen Marie,9999,0,9999,0
1668334395359,CSE 293,046,126411,Klemke; Richard,9999,0,9999,0
1668334395782,CSE 294,A00,102459,Voelker; Geoffrey M.,0,0,0,0
1668334395782,CSE 294,B00,111322,Orailoglu; Alex,0,0,0,0
1668334396207,DSE 201,A00,096914,Deutsch; Alin Bernard,30,0,30,0
1668334396632,DSE 210,A00,096915,Dasgupta; Sanjoy,30,0,30,0
1668334397056,DSE 260A,A00,096916,Altintas De Callaf; Ilkay,30,0,30,0
1668334397541,ECE 200,001,103586,Antipa; Nicholas A,9999,0,9999,0
1668334397541,ECE 200,002,103587,Atanasov; Nikolay A.,9999,0,9999,0
1668334397541,ECE 200,003,103588,Bharadia; Dinesh,9999,0,9999,0
1668334397541,ECE 200,004,103589,Cheng; Chung Kuan,9999,0,9999,0
1668334397541,ECE 200,005,103590,Cosman; Pamela C.,9999,0,9999,0
1668334397541,ECE 200,006,103591,Dayeh; Shadi Ahmad,9999,0,9999,0
1668334397541,ECE 200,007,103592,Fainman; Yeshaiahu,9999,0,9999,0
1668334397541,ECE 200,008,103593,Ford; Joseph Earl,9999,0,9999,0
1668334397541,ECE 200,009,103594,Franceschetti; Massimo,9999,0,9999,0
1668334397541,ECE 200,010,103595,Fullerton; Eric E,9999,0,9999,0
1668334397541,ECE 200,011,103596,Galton; Ian A,9999,0,9999,0
1668334397541,ECE 200,012,103597,Gilja; Vikash,9999,0,9999,0
1668334397541,ECE 200,013,103598,Hall; Drew A.,9999,0,9999,0
1668334397541,ECE 200,014,103599,Hsueh; Tzu-Chien,9999,0,9999,0
1668334397541,ECE 200,015,103600,Javidi; Tara,9999,0,9999,0
1668334397541,ECE 200,016,103601,Kahng; Andrew Byun,9999,0,9999,0
1668334397541,ECE 200,017,103602,Kim; Young-Han,9999,0,9999,0
1668334397541,ECE 200,018,103603,Koushanfar; Farinaz,9999,0,9999,0
1668334397541,ECE 200,019,103604,Kuzum; Duygu,9999,0,9999,0
1668334397541,ECE 200,020,103605,Le; Hanh-Phuc,9999,0,9999,0
1668334397541,ECE 200,021,103606,Lin; Bill,9999,0,9999,0
1668334397541,ECE 200,022,103607,Liu; Zhaowei,9998,0,9999,1
1668334397541,ECE 200,023,103608,Lo; Yu-Hwa,9999,0,9999,0
1668334397541,ECE 200,024,103609,Lomakin; Vitaliy,9999,0,9999,0
1668334397541,ECE 200,025,103610,Mercier; Patrick Philip,9999,0,9999,0
1668334397541,ECE 200,026,103611,Meyer; Florian,9999,0,9999,0
1668334397541,ECE 200,027,103612,Milstein; Laurence B.,9999,0,9999,0
1668334397541,ECE 200,028,103613,Mir Arabbaygi; Siavash,9999,0,9999,0
1668334397541,ECE 200,029,103614,Mookherjea; Shayan,9999,0,9999,0
1668334397541,ECE 200,030,103615,Morris; Karcher William,9999,0,9999,0
1668334397541,ECE 200,031,103616,Ng; Tse Nga,9999,0,9999,0
1668334397541,ECE 200,032,103617,Nguyen; Truong Quang,9999,0,9999,0
1668334397541,ECE 200,033,103618,Nomura; Kenji,9999,0,9999,0
1668334397541,ECE 200,034,103619,Orlitsky; Alon,9999,0,9999,0
1668334397541,ECE 200,035,103620,Pal; Piya,9999,0,9999,0
1668334397541,ECE 200,036,103621,Papen; George C.,9999,0,9999,0
1668334397541,ECE 200,037,103622,Radic; Stojan,9999,0,9999,0
1668334397541,ECE 200,038,103623,Rao; Bhaskar D.,9999,0,9999,0
1668334397541,ECE 200,039,103624,Rao; Ramesh R,9999,0,9999,0
1668334397541,ECE 200,040,103625,Rebeiz; Gabriel,9999,0,9999,0
1668334397541,ECE 200,041,103626,Sanford; John R,9999,0,9999,0
1668334397541,ECE 200,042,103627,Siegel; Paul H.,9999,0,9999,0
1668334397541,ECE 200,043,103628,Sievenpiper; Daniel F.,9999,0,9999,0
1668334397541,ECE 200,044,103629,Sworder; David D.,9999,0,9999,0
1668334397541,ECE 200,045,103630,Taur; Yuan,9999,0,9999,0
1668334397541,ECE 200,046,103631,Touri; Behrouz,9999,0,9999,0
1668334397541,ECE 200,047,103632,Trivedi; Mohan M.,9999,0,9999,0
1668334397541,ECE 200,048,103633,Vasconcelos; Nuno,9999,0,9999,0
1668334397541,ECE 200,049,103634,Wang; Xiaolong,9999,0,9999,0
1668334397541,ECE 200,050,103635,Xie; Pengtao,9999,0,9999,0
1668334397541,ECE 200,051,103636,Yip; Michael,9999,0,9999,0
1668334397541,ECE 200,052,103637,Zeger; Kenneth A.,999,0,999,0
1668334397541,ECE 200,053,103638,Zhang; Xinyu,9999,0,9999,0
1668334397541,ECE 200,054,103639,Turakhia; Yatish Girish,9999,0,9999,0
1668334397541,ECE 200,055,103640,Kang; Mingu,9999,0,9999,0
1668334397541,ECE 200,056,103641,Shi; Yuanyuan,9999,0,9999,0
1668334397541,ECE 200,057,103642,Wang; Edward Jay,9999,0,9999,0
1668334397541,ECE 200,058,103643,Zheng; Yang,9999,0,9999,0
1668334397968,ECE 202,A00,103644,Kuzum; Duygu,0,0,0,0
1668334398391,ECE 212BN,A00,103646,Ng; Tse Nga,0,0,0,0
1668334398825,ECE 221,A00,111493,Staff,0,0,0,0
1668334399248,ECE 222B,A00,103647,Lomakin; Vitaliy,0,0,0,0
1668334399677,ECE 230B,A00,103648,Taur; Yuan,0,0,0,0
1668334400102,ECE 238B,A00,103649,Garay; Javier,0,0,0,0
1668334400527,ECE 240B,A00,112900,Fainman; Yeshaiahu,0,0,0,0
1668334400950,ECE 247A,A00,103650,Jokerst; Jesse Vincent,0,0,0,0
1668334401375,ECE 247B,A00,103651,Wang; Joseph,0,0,0,0
1668334401802,ECE 250,A00,103652,Siegel; Paul H.,0,0,0,0
1668334402230,ECE 251A,A00,103654,Rao; Bhaskar D.,0,0,0,0
1668334402658,ECE 257B,A00,103655,Bharadia; Dinesh,0,0,0,0
1668334403083,ECE 258A,A00,103656,Milstein; Laurence B.,0,0,0,0
1668334403508,ECE 260B,A00,103658,Kang; Mingu,0,0,0,0
1668334403936,ECE 264A,A00,103659,Galton; Ian A,0,0,0,0
1668334404367,ECE 265A,A00,103661,Gudem; Prasad S.S.,0,0,0,0
1668334404794,ECE 265D,A00,103662,Gudem; Prasad S.S.,0,0,0,0
1668334405216,ECE 268,A00,103663,Koushanfar; Farinaz,0,0,0,0
1668334405645,ECE 269,A01,103665,Pal; Piya,0,0,0,0
1668334406072,ECE 271B,A00,103666,Vasconcelos; Manuela,0,0,0,0
1668334406497,ECE 276A,A00,103667,Atanasov; Nikolay A.,0,0,0,0
1668334406922,ECE 277,A00,103668,An; Cheolhong,0,0,0,0
1668334407349,ECE 279,A00,117947,Hall; Drew A.,0,0,0,0
1668334408200,ECE 283,A00,103670,Hsueh; Tzu-Chien,0,0,0,0
1668334408621,ECE 284,A00,103671,Turakhia; Yatish Girish,0,0,0,0
1668334409050,ECE 285,A00,103672,Zheng; Yang,0,0,0,0
1668334409050,ECE 285,B00,103673,Sworder; David D.,0,0,0,0
1668334409477,ECE 287,A00,103676,Javidi; Tara,0,0,0,0
1668334409902,MATH 200B,A00,098023,Salehi Golsefidy; Alireza,12,0,15,3
1668334410328,MATH 202B,A00,098024,Rhoades; Brendon Patrick,9,0,15,6
1668334410755,MATH 203B,A00,098025,Oprea; Dragos N.,10,0,15,5
1668334411180,MATH 204B,A00,098026,Sorensen; Claus M,13,0,15,2
1668334411606,MATH 208,A00,098027,Izadi; Elham,7,0,10,3
1668334412040,MATH 209,A00,098028,Pollack; Aaron,10,0,10,0
1668334412551,MATH 211A,A00,112919,Rogalski; Daniel,9,0,10,1
1668334412987,MATH 211B,A00,112920,Seward; Brandon M.,9,0,10,1
1668334413430,MATH 218,A00,098029,Li; Bo,10,0,10,0
1668334413870,MATH 220B,A00,098030,Novak; Jonathan I,11,0,15,4
1668334414297,MATH 221A,A00,098031,Ebenfelt; Peter F,13,0,15,2
1668334414723,MATH 231B,A00,098032,Zlatos; Andrej,12,0,15,3
1668334415148,MATH 240B,A00,098033,Ni; Lei,9,0,15,6
1668334415573,MATH 243,A00,098034,Jekel; David Andrew,10,0,10,0
1668334416002,MATH 245A,A00,098035,Nie; Jiawang,0,0,15,16
1668334416433,MATH 248,A00,098036,Bejenaru; Ioan,10,0,10,0
1668334416865,MATH 250B,A00,098037,Spolaor; Luca,14,0,15,1
1668334417290,MATH 258,A00,098038,Ni; Lei,10,0,10,0
1668334417721,MATH 264B,A00,098041,Rhoades; Brendon Patrick,9,0,15,6
1668334418161,MATH 268,A00,098042,Buss; Samuel R,10,0,10,0
1668334418590,MATH 269,A00,098043,Rhoades; Brendon Patrick,10,0,10,0
1668334419015,MATH 270B,A00,098044,Li; Bo,10,0,15,5
1668334419441,MATH 272B,A00,098045,Holst; Michael J,13,0,15,2
1668334419870,MATH 273A,A00,098046,Tian; Xiaochuan,10,0,15,5
1668334420295,MATH 275,A01,098048,Tian; Xiaochuan,6,0,10,4
1668334420725,MATH 278A,A00,098049,Holst; Michael J,8,0,10,2
1668334421163,MATH 278B,A00,098050,Cloninger; Alexander,10,0,10,0
1668334421599,MATH 278C,A00,098051,Nie; Jiawang,7,0,10,3
1668334422024,MATH 280B,A00,098052,Zheng; Tianyi,8,0,15,7
1668334422460,MATH 281B,A00,098053,Bradic; Jelena,1,0,15,14
1668334422885,MATH 282B,A00,098054,Arias-Castro; Ery,0,0,15,15
1668334423314,MATH 285,A00,098055,Fitzsimmons; Patrick J,0,0,15,17
1668334423739,MATH 287B,A00,098056,Arias-Castro; Ery,2,0,15,13
1668334424165,MATH 288,A00,098057,Agarwal; Pooja,9,0,10,1
1668334424165,MATH 288,B00,098058,Zhang; Danna,8,0,10,2
1668334424165,MATH 288,C00,098059,Williams; Ruth J,9,0,10,1
1668334424591,MATH 290B,A00,098060,Roberts; Justin Deritter,13,0,15,2
1668334425016,MATH 292,A00,098061,Belmont; Eva Kinoshita,10,0,10,0
1668334425445,MATH 295,A00,098062,Suk; Andrew Hoon,48,0,50,2
1668334425870,MATH 296,A00,098063,Novak; Jonathan I,20,0,20,0
1668334426297,MATH 297,001,098064,Gamst; Anthony Collins,9997,0,9999,2
1668334926886,COGS 205,A00,101395,Chiba; Andrea,19,0,20,1
1668334927313,COGS 210B,001,101404,Greene; Deanna Jacquelyn,9998,0,9999,1
1668334927313,COGS 210B,002,101417,Xia; Haijun,9999,0,9999,0
1668334927313,COGS 210B,003,101422,Nitz; Douglas A.,9999,0,9999,0
1668334927313,COGS 210B,004,101423,Hollan; James D.,9998,0,9999,1
1668334927313,COGS 210B,005,101424,Deak; Gedeon O.,9998,0,9999,1
1668334927313,COGS 210B,006,101425,Rossano; Federico,9999,0,9999,0
1668334927738,COGS 211B,A00,101427,Coulson; Seana M,9996,0,9999,3
1668334928177,COGS 220,A00,101428,Hollan; James D.,0,0,25,25
1668334928610,COGS 229,A00,101429,Dow; Steven P,18,0,25,7
1668334929035,COGS 230,A00,101430,Klemmer; Scott R,11,0,17,6
1668334929460,COGS 234,A00,101431,Xia; Haijun,1,0,25,24
1668334929889,COGS 260,A00,101432,Kiyonaga; Anastasia,21,0,25,4
1668334929889,COGS 260,B00,101433,Kirsh; David Joel,15,0,25,10
1668334930318,CSE 202,A00,102371,Impagliazzo; Russell,0,0,0,0
1668334930742,CSE 203B,A01,102373,Cheng; Chung Kuan,0,0,0,0
1668334931166,CSE 208,A00,102374,Micciancio; Daniele,0,0,0,0
1668334931589,CSE 209A,A00,112895,Impagliazzo; Russell,0,0,15,15
1668334932029,CSE 209B,A00,108005,Bellare; Mihir,0,0,0,0
1668334932457,CSE 210,A00,113163,Coblenz; Michael J,0,0,0,0
1668334932882,CSE 219,A00,106111,Dow; Steven P,0,0,20,20
1668334933381,CSE 221,A00,102376,Voelker; Geoffrey M.,0,0,0,0
1668334933810,CSE 224,A01,102378,Porter; George M,0,0,0,0
1668334934237,CSE 229A,A00,102379,Savage; Stefan,0,0,0,0
1668334934669,CSE 229C,A00,102380,Munyaka; Imani N. S.,0,0,0,0
1668334935091,CSE 232B,A00,102382,Deutsch; Alin Bernard,0,0,0,0
1668334935518,CSE 234,A01,112904,Kumar; Arun Kumar,0,0,0,0
1668334935948,CSE 237A,A00,102383,Rosing; Tajana Simunic,0,0,0,0
1668334936374,CSE 239A,A00,102384,Deutsch; Alin Bernard,0,0,0,0
1668334936798,CSE 239B,A00,102385,Polikarpova; Nadezhda,0,0,0,0
1668334937229,CSE 240A,A00,102386,Pannuto; Patrick William,0,0,0,0
1668334937652,CSE 240B,A00,102387,Zhao; Jishen,0,0,0,0
1668334938081,CSE 241A,A00,106406,Kang; Mingu,0,0,0,0
1668334938507,CSE 249B,A00,102388,Kahng; Andrew Byun,0,0,8,8
1668334938936,CSE 251B,A01,102392,Cottrell; Garrison W,0,0,0,0
1668334938936,CSE 251B,A02,102393,Cottrell; Garrison W,0,0,0,0
1668334939365,CSE 252B,A00,102394,Ochoa; Benjamin Lawrence,0,0,0,0
1668334939793,CSE 257,A01,102396,Gao; Sicun,0,0,0,0
1668334940216,CSE 272,A00,102397,Li; Tzumao,0,0,0,0
1668334940640,CSE 274,A00,111323,Chern; Albert Ren-Haur,0,0,0,0
1668334941068,CSE 282,A00,102398,Pevzner; Pavel Arkadjevich,0,0,0,0
1668334941494,CSE 284,A00,114175,Gymrek; Melissa Ann,0,0,0,0
1668334941918,CSE 290,A00,102399,Chandraker; Manmohan Krishna,0,0,0,0
1668334941918,CSE 290,B00,102400,Vaccaro; Kristen Marie,0,0,25,25
1668334941918,CSE 290,C00,102414,Pannuto; Patrick William,0,0,25,25
1668334941918,CSE 290,D00,102427,Pevzner; Pavel Arkadjevich,0,0,0,0
1668334941918,CSE 290,E00,102429,Zhao; Jishen,0,0,0,0
1668334941918,CSE 290,F00,102436,Tullsen; Dean Michael,0,0,0,0
1668334941918,CSE 290,G00,102440,Christensen; Henrik I,0,0,20,20
1668334942345,CSE 291,A00,102443,Su; Hao,0,0,0,0
1668334942345,CSE 291,B00,102448,Polikarpova; Nadezhda,0,0,0,0
1668334942345,CSE 291,C00,102453,Vaccaro; Kristen Marie,0,0,0,0
1668334942345,CSE 291,D00,111343,Savage; Stefan,0,0,0,0
1668334942345,CSE 291,E00,116474,Claffy; Kimberly Claire,0,0,0,0
1668334942345,CSE 291,F00,116479,Pasquale; Joseph,0,0,0,0
1668334942810,CSE 293,001,119111,Bafna; Vineet,9999,0,9999,0
1668334942810,CSE 293,002,119118,Bellare; Mihir,9999,0,9999,0
1668334942810,CSE 293,003,119122,Berg-Kirkpatrick; Taylor D,9999,0,9999,0
1668334942810,CSE 293,004,119135,Christensen; Henrik I,9999,0,9999,0
1668334942810,CSE 293,005,119142,Cottrell; Garrison W,9999,0,9999,0
1668334942810,CSE 293,006,119146,Deutsch; Alin Bernard,9999,0,9999,0
1668334942810,CSE 293,007,119159,Esmaeilzadeh; Hadi,9999,0,9999,0
1668334942810,CSE 293,008,119166,Freund; Yoav,9999,0,9999,0
1668334942810,CSE 293,009,119170,Griswold; William G.,9999,0,9999,0
1668334942810,CSE 293,010,119183,Gymrek; Melissa Ann,9999,0,9999,0
1668334942810,CSE 293,011,119190,Heninger; Nadia A,9999,0,9999,0
1668334942810,CSE 293,012,119230,Impagliazzo; Russell,9999,0,9999,0
1668334942810,CSE 293,013,119232,Jhala; Ranjit,9999,0,9999,0
1668334942810,CSE 293,014,119233,Kahng; Andrew Byun,9999,0,9999,0
1668334942810,CSE 293,015,119298,Kane; Daniel Mertz,9999,0,9999,0
1668334942810,CSE 293,016,119299,Kriegman; David J,9999,0,9999,0
1668334942810,CSE 293,017,119300,Kumar; Arun Kumar,9999,0,9999,0
1668334942810,CSE 293,018,119301,Lerner; Sorin,9999,0,9999,0
1668334942810,CSE 293,019,119302,Lovett; Shachar,9999,0,9999,0
1668334942810,CSE 293,020,119303,McAuley; Julian John,9999,0,9999,0
1668334942810,CSE 293,021,119304,Micciancio; Daniele,9999,0,9999,0
1668334942810,CSE 293,022,119367,Orailoglu; Alex,9999,0,9999,0
1668334942810,CSE 293,023,119382,Paturi; Ramamohan,9999,0,9999,0
1668334942810,CSE 293,024,119404,Polikarpova; Nadezhda,9999,0,9999,0
1668334942810,CSE 293,025,119406,Politz; Joseph Gibbs,9999,0,9999,0
1668334942810,CSE 293,026,119411,Porter; George M,9999,0,9999,0
1668334942810,CSE 293,027,119414,Porter; Leonard Emerson,9999,0,9999,0
1668334942810,CSE 293,028,119416,Ramamoorthi; Ravi,9999,0,9999,0
1668334942810,CSE 293,029,119417,Sahoo; Debashis,9999,0,9999,0
1668334942810,CSE 293,030,119420,Saul; Lawrence,9999,0,9999,0
1668334942810,CSE 293,031,119421,Savage; Stefan,9999,0,9999,0
1668334942810,CSE 293,032,119425,Schulze; Jurgen P.,9999,0,9999,0
1668334942810,CSE 293,033,119426,Snoeren; Alex C.,9999,0,9999,0
1668334942810,CSE 293,034,119428,Shang; Jingbo,9999,0,9999,0
1668334942810,CSE 293,035,119430,Stefan; Deian,9999,0,9999,0
1668334942810,CSE 293,036,119431,Su; Hao,9999,0,9999,0
1668334942810,CSE 293,037,119433,Swanson; Steven James,9999,0,9999,0
1668334942810,CSE 293,038,119435,Tullsen; Dean Michael,9999,0,9999,0
1668334942810,CSE 293,039,119483,Voelker; Geoffrey M.,9999,0,9999,0
1668334942810,CSE 293,040,119537,Zhao; Jishen,9999,0,9999,0
1668334942810,CSE 293,041,119538,Zhou; Yuan-Yuan,9999,0,9999,0
1668334942810,CSE 293,042,119539,Gao; Sicun,9999,0,9999,0
1668334942810,CSE 293,043,119540,Weibel; Nadir,9999,0,9999,0
1668334942810,CSE 293,044,119541,Gupta; Rajesh K.,9999,0,9999,0
1668334942810,CSE 293,045,126410,Vaccaro; Kristen Marie,9999,0,9999,0
1668334942810,CSE 293,046,126411,Klemke; Richard,9999,0,9999,0
1668334943236,CSE 294,A00,102459,Voelker; Geoffrey M.,0,0,0,0
1668334943236,CSE 294,B00,111322,Orailoglu; Alex,0,0,0,0
1668334943662,DSE 201,A00,096914,Deutsch; Alin Bernard,30,0,30,0
1668334944088,DSE 210,A00,096915,Dasgupta; Sanjoy,30,0,30,0
1668334944513,DSE 260A,A00,096916,Altintas De Callaf; Ilkay,30,0,30,0
1668334944961,ECE 200,001,103586,Antipa; Nicholas A,9999,0,9999,0
1668334944961,ECE 200,002,103587,Atanasov; Nikolay A.,9999,0,9999,0
1668334944961,ECE 200,003,103588,Bharadia; Dinesh,9999,0,9999,0
1668334944961,ECE 200,004,103589,Cheng; Chung Kuan,9999,0,9999,0
1668334944961,ECE 200,005,103590,Cosman; Pamela C.,9999,0,9999,0
1668334944961,ECE 200,006,103591,Dayeh; Shadi Ahmad,9999,0,9999,0
1668334944961,ECE 200,007,103592,Fainman; Yeshaiahu,9999,0,9999,0
1668334944961,ECE 200,008,103593,Ford; Joseph Earl,9999,0,9999,0
1668334944961,ECE 200,009,103594,Franceschetti; Massimo,9999,0,9999,0
1668334944961,ECE 200,010,103595,Fullerton; Eric E,9999,0,9999,0
1668334944961,ECE 200,011,103596,Galton; Ian A,9999,0,9999,0
1668334944961,ECE 200,012,103597,Gilja; Vikash,9999,0,9999,0
1668334944961,ECE 200,013,103598,Hall; Drew A.,9999,0,9999,0
1668334944961,ECE 200,014,103599,Hsueh; Tzu-Chien,9999,0,9999,0
1668334944961,ECE 200,015,103600,Javidi; Tara,9999,0,9999,0
1668334944961,ECE 200,016,103601,Kahng; Andrew Byun,9999,0,9999,0
1668334944961,ECE 200,017,103602,Kim; Young-Han,9999,0,9999,0
1668334944961,ECE 200,018,103603,Koushanfar; Farinaz,9999,0,9999,0
1668334944961,ECE 200,019,103604,Kuzum; Duygu,9999,0,9999,0
1668334944961,ECE 200,020,103605,Le; Hanh-Phuc,9999,0,9999,0
1668334944961,ECE 200,021,103606,Lin; Bill,9999,0,9999,0
1668334944961,ECE 200,022,103607,Liu; Zhaowei,9998,0,9999,1
1668334944961,ECE 200,023,103608,Lo; Yu-Hwa,9999,0,9999,0
1668334944961,ECE 200,024,103609,Lomakin; Vitaliy,9999,0,9999,0
1668334944961,ECE 200,025,103610,Mercier; Patrick Philip,9999,0,9999,0
1668334944961,ECE 200,026,103611,Meyer; Florian,9999,0,9999,0
1668334944961,ECE 200,027,103612,Milstein; Laurence B.,9999,0,9999,0
1668334944961,ECE 200,028,103613,Mir Arabbaygi; Siavash,9999,0,9999,0
1668334944961,ECE 200,029,103614,Mookherjea; Shayan,9999,0,9999,0
1668334944961,ECE 200,030,103615,Morris; Karcher William,9999,0,9999,0
1668334944961,ECE 200,031,103616,Ng; Tse Nga,9999,0,9999,0
1668334944961,ECE 200,032,103617,Nguyen; Truong Quang,9999,0,9999,0
1668334944961,ECE 200,033,103618,Nomura; Kenji,9999,0,9999,0
1668334944961,ECE 200,034,103619,Orlitsky; Alon,9999,0,9999,0
1668334944961,ECE 200,035,103620,Pal; Piya,9999,0,9999,0
1668334944961,ECE 200,036,103621,Papen; George C.,9999,0,9999,0
1668334944961,ECE 200,037,103622,Radic; Stojan,9999,0,9999,0
1668334944961,ECE 200,038,103623,Rao; Bhaskar D.,9999,0,9999,0
1668334944961,ECE 200,039,103624,Rao; Ramesh R,9999,0,9999,0
1668334944961,ECE 200,040,103625,Rebeiz; Gabriel,9999,0,9999,0
1668334944961,ECE 200,041,103626,Sanford; John R,9999,0,9999,0
1668334944961,ECE 200,042,103627,Siegel; Paul H.,9999,0,9999,0
1668334944961,ECE 200,043,103628,Sievenpiper; Daniel F.,9999,0,9999,0
1668334944961,ECE 200,044,103629,Sworder; David D.,9999,0,9999,0
1668334944961,ECE 200,045,103630,Taur; Yuan,9999,0,9999,0
1668334944961,ECE 200,046,103631,Touri; Behrouz,9999,0,9999,0
1668334944961,ECE 200,047,103632,Trivedi; Mohan M.,9999,0,9999,0
1668334944961,ECE 200,048,103633,Vasconcelos; Nuno,9999,0,9999,0
1668334944961,ECE 200,049,103634,Wang; Xiaolong,9999,0,9999,0
1668334944961,ECE 200,050,103635,Xie; Pengtao,9999,0,9999,0
1668334944961,ECE 200,051,103636,Yip; Michael,9999,0,9999,0
1668334944961,ECE 200,052,103637,Zeger; Kenneth A.,999,0,999,0
1668334944961,ECE 200,053,103638,Zhang; Xinyu,9999,0,9999,0
1668334944961,ECE 200,054,103639,Turakhia; Yatish Girish,9999,0,9999,0
1668334944961,ECE 200,055,103640,Kang; Mingu,9999,0,9999,0
1668334944961,ECE 200,056,103641,Shi; Yuanyuan,9999,0,9999,0
1668334944961,ECE 200,057,103642,Wang; Edward Jay,9999,0,9999,0
1668334944961,ECE 200,058,103643,Zheng; Yang,9999,0,9999,0
1668334945387,ECE 202,A00,103644,Kuzum; Duygu,0,0,0,0
1668334945814,ECE 212BN,A00,103646,Ng; Tse Nga,0,0,0,0
1668334946240,ECE 221,A00,111493,Staff,0,0,0,0
1668334946663,ECE 222B,A00,103647,Lomakin; Vitaliy,0,0,0,0
1668334947089,ECE 230B,A00,103648,Taur; Yuan,0,0,0,0
1668334947517,ECE 238B,A00,103649,Garay; Javier,0,0,0,0
1668334947941,ECE 240B,A00,112900,Fainman; Yeshaiahu,0,0,0,0
1668334948365,ECE 247A,A00,103650,Jokerst; Jesse Vincent,0,0,0,0
1668334948791,ECE 247B,A00,103651,Wang; Joseph,0,0,0,0
1668334949219,ECE 250,A00,103652,Siegel; Paul H.,0,0,0,0
1668334949647,ECE 251A,A00,103654,Rao; Bhaskar D.,0,0,0,0
1668334950070,ECE 257B,A00,103655,Bharadia; Dinesh,0,0,0,0
1668334950494,ECE 258A,A00,103656,Milstein; Laurence B.,0,0,0,0
1668334950919,ECE 260B,A00,103658,Kang; Mingu,0,0,0,0
1668334951347,ECE 264A,A00,103659,Galton; Ian A,0,0,0,0
1668334951773,ECE 265A,A00,103661,Gudem; Prasad S.S.,0,0,0,0
1668334952196,ECE 265D,A00,103662,Gudem; Prasad S.S.,0,0,0,0
1668334952620,ECE 268,A00,103663,Koushanfar; Farinaz,0,0,0,0
1668334953042,ECE 269,A01,103665,Pal; Piya,0,0,0,0
1668334953471,ECE 271B,A00,103666,Vasconcelos; Manuela,0,0,0,0
1668334953900,ECE 276A,A00,103667,Atanasov; Nikolay A.,0,0,0,0
1668334954329,ECE 277,A00,103668,An; Cheolhong,0,0,0,0
1668334954756,ECE 279,A00,117947,Hall; Drew A.,0,0,0,0
1668334955603,ECE 283,A00,103670,Hsueh; Tzu-Chien,0,0,0,0
1668334956026,ECE 284,A00,103671,Turakhia; Yatish Girish,0,0,0,0
1668334956457,ECE 285,A00,103672,Zheng; Yang,0,0,0,0
1668334956457,ECE 285,B00,103673,Sworder; David D.,0,0,0,0
1668334956888,ECE 287,A00,103676,Javidi; Tara,0,0,0,0
1668334957311,MATH 200B,A00,098023,Salehi Golsefidy; Alireza,12,0,15,3
1668334957738,MATH 202B,A00,098024,Rhoades; Brendon Patrick,9,0,15,6
1668334958163,MATH 203B,A00,098025,Oprea; Dragos N.,10,0,15,5
1668334958588,MATH 204B,A00,098026,Sorensen; Claus M,13,0,15,2
1668334959014,MATH 208,A00,098027,Izadi; Elham,7,0,10,3
1668334959440,MATH 209,A00,098028,Pollack; Aaron,10,0,10,0
1668334959864,MATH 211A,A00,112919,Rogalski; Daniel,9,0,10,1
1668334960286,MATH 211B,A00,112920,Seward; Brandon M.,9,0,10,1
1668334960712,MATH 218,A00,098029,Li; Bo,10,0,10,0
1668334961137,MATH 220B,A00,098030,Novak; Jonathan I,11,0,15,4
1668334961564,MATH 221A,A00,098031,Ebenfelt; Peter F,13,0,15,2
1668334961987,MATH 231B,A00,098032,Zlatos; Andrej,12,0,15,3
1668334962410,MATH 240B,A00,098033,Ni; Lei,9,0,15,6
1668334962833,MATH 243,A00,098034,Jekel; David Andrew,10,0,10,0
1668334963263,MATH 245A,A00,098035,Nie; Jiawang,0,0,15,16
1668334963687,MATH 248,A00,098036,Bejenaru; Ioan,10,0,10,0
1668334964118,MATH 250B,A00,098037,Spolaor; Luca,14,0,15,1
1668334964543,MATH 258,A00,098038,Ni; Lei,10,0,10,0
1668334964966,MATH 264B,A00,098041,Rhoades; Brendon Patrick,9,0,15,6
1668334965388,MATH 268,A00,098042,Buss; Samuel R,10,0,10,0
1668334965812,MATH 269,A00,098043,Rhoades; Brendon Patrick,10,0,10,0
1668334966254,MATH 270B,A00,098044,Li; Bo,10,0,15,5
1668334966678,MATH 272B,A00,098045,Holst; Michael J,13,0,15,2
1668334967105,MATH 273A,A00,098046,Tian; Xiaochuan,10,0,15,5
1668334967531,MATH 275,A01,098048,Tian; Xiaochuan,6,0,10,4
1668334967955,MATH 278A,A00,098049,Holst; Michael J,8,0,10,2
1668334968377,MATH 278B,A00,098050,Cloninger; Alexander,10,0,10,0
1668334968803,MATH 278C,A00,098051,Nie; Jiawang,7,0,10,3
1668334969227,MATH 280B,A00,098052,Zheng; Tianyi,8,0,15,7
1668334969649,MATH 281B,A00,098053,Bradic; Jelena,1,0,15,14
1668334970072,MATH 282B,A00,098054,Arias-Castro; Ery,0,0,15,15
1668334970495,MATH 285,A00,098055,Fitzsimmons; Patrick J,0,0,15,17
1668334970923,MATH 287B,A00,098056,Arias-Castro; Ery,2,0,15,13
1668334971352,MATH 288,A00,098057,Agarwal; Pooja,9,0,10,1
1668334971352,MATH 288,B00,098058,Zhang; Danna,8,0,10,2
1668334971352,MATH 288,C00,098059,Williams; Ruth J,9,0,10,1
1668334971775,MATH 290B,A00,098060,Roberts; Justin Deritter,13,0,15,2
1668334972197,MATH 292,A00,098061,Belmont; Eva Kinoshita,10,0,10,0
1668334972622,MATH 295,A00,098062,Suk; Andrew Hoon,48,0,50,2
1668334973049,MATH 296,A00,098063,Novak; Jonathan I,20,0,20,0
1668334973473,MATH 297,001,098064,Gamst; Anthony Collins,9997,0,9999,2
1668335478251,COGS 205,A00,101395,Chiba; Andrea,19,0,20,1
1668335478681,COGS 210B,001,101404,Greene; Deanna Jacquelyn,9998,0,9999,1
1668335478681,COGS 210B,002,101417,Xia; Haijun,9999,0,9999,0
1668335478681,COGS 210B,003,101422,Nitz; Douglas A.,9999,0,9999,0
1668335478681,COGS 210B,004,101423,Hollan; James D.,9998,0,9999,1
1668335478681,COGS 210B,005,101424,Deak; Gedeon O.,9998,0,9999,1
1668335478681,COGS 210B,006,101425,Rossano; Federico,9999,0,9999,0
1668335479108,COGS 211B,A00,101427,Coulson; Seana M,9996,0,9999,3
1668335479534,COGS 220,A00,101428,Hollan; James D.,0,0,25,25
1668335479960,COGS 229,A00,101429,Dow; Steven P,18,0,25,7
1668335480384,COGS 230,A00,101430,Klemmer; Scott R,11,0,17,6
1668335480813,COGS 234,A00,101431,Xia; Haijun,1,0,25,24
1668335481238,COGS 260,A00,101432,Kiyonaga; Anastasia,21,0,25,4
1668335481238,COGS 260,B00,101433,Kirsh; David Joel,15,0,25,10
1668335481663,CSE 202,A00,102371,Impagliazzo; Russell,0,0,0,0
1668335482104,CSE 203B,A01,102373,Cheng; Chung Kuan,0,0,0,0
1668335482534,CSE 208,A00,102374,Micciancio; Daniele,0,0,0,0
1668335482961,CSE 209A,A00,112895,Impagliazzo; Russell,0,0,15,15
1668335483402,CSE 209B,A00,108005,Bellare; Mihir,0,0,0,0
1668335483832,CSE 210,A00,113163,Coblenz; Michael J,0,0,0,0
1668335484257,CSE 219,A00,106111,Dow; Steven P,0,0,20,20
1668335484686,CSE 221,A00,102376,Voelker; Geoffrey M.,0,0,0,0
1668335485116,CSE 224,A01,102378,Porter; George M,0,0,0,0
1668335485538,CSE 229A,A00,102379,Savage; Stefan,0,0,0,0
1668335485963,CSE 229C,A00,102380,Munyaka; Imani N. S.,0,0,0,0
1668335486403,CSE 232B,A00,102382,Deutsch; Alin Bernard,0,0,0,0
1668335486832,CSE 234,A01,112904,Kumar; Arun Kumar,0,0,0,0
1668335487264,CSE 237A,A00,102383,Rosing; Tajana Simunic,0,0,0,0
1668335487703,CSE 239A,A00,102384,Deutsch; Alin Bernard,0,0,0,0
1668335488128,CSE 239B,A00,102385,Polikarpova; Nadezhda,0,0,0,0
1668335488552,CSE 240A,A00,102386,Pannuto; Patrick William,0,0,0,0
1668335488978,CSE 240B,A00,102387,Zhao; Jishen,0,0,0,0
1668335489402,CSE 241A,A00,106406,Kang; Mingu,0,0,0,0
1668335489832,CSE 249B,A00,102388,Kahng; Andrew Byun,0,0,8,8
1668335490257,CSE 251B,A01,102392,Cottrell; Garrison W,0,0,0,0
1668335490257,CSE 251B,A02,102393,Cottrell; Garrison W,0,0,0,0
1668335490683,CSE 252B,A00,102394,Ochoa; Benjamin Lawrence,0,0,0,0
1668335491114,CSE 257,A01,102396,Gao; Sicun,0,0,0,0
1668335491543,CSE 272,A00,102397,Li; Tzumao,0,0,0,0
1668335491985,CSE 274,A00,111323,Chern; Albert Ren-Haur,0,0,0,0
1668335492410,CSE 282,A00,102398,Pevzner; Pavel Arkadjevich,0,0,0,0
1668335492836,CSE 284,A00,114175,Gymrek; Melissa Ann,0,0,0,0
1668335493269,CSE 290,A00,102399,Chandraker; Manmohan Krishna,0,0,0,0
1668335493269,CSE 290,B00,102400,Vaccaro; Kristen Marie,0,0,25,25
1668335493269,CSE 290,C00,102414,Pannuto; Patrick William,0,0,25,25
1668335493269,CSE 290,D00,102427,Pevzner; Pavel Arkadjevich,0,0,0,0
1668335493269,CSE 290,E00,102429,Zhao; Jishen,0,0,0,0
1668335493269,CSE 290,F00,102436,Tullsen; Dean Michael,0,0,0,0
1668335493269,CSE 290,G00,102440,Christensen; Henrik I,0,0,20,20
1668335493702,CSE 291,A00,102443,Su; Hao,0,0,0,0
1668335493702,CSE 291,B00,102448,Polikarpova; Nadezhda,0,0,0,0
1668335493702,CSE 291,C00,102453,Vaccaro; Kristen Marie,0,0,0,0
1668335493702,CSE 291,D00,111343,Savage; Stefan,0,0,0,0
1668335493702,CSE 291,E00,116474,Claffy; Kimberly Claire,0,0,0,0
1668335493702,CSE 291,F00,116479,Pasquale; Joseph,0,0,0,0
1668335494143,CSE 293,001,119111,Bafna; Vineet,9999,0,9999,0
1668335494143,CSE 293,002,119118,Bellare; Mihir,9999,0,9999,0
1668335494143,CSE 293,003,119122,Berg-Kirkpatrick; Taylor D,9999,0,9999,0
1668335494143,CSE 293,004,119135,Christensen; Henrik I,9999,0,9999,0
1668335494143,CSE 293,005,119142,Cottrell; Garrison W,9999,0,9999,0
1668335494143,CSE 293,006,119146,Deutsch; Alin Bernard,9999,0,9999,0
1668335494143,CSE 293,007,119159,Esmaeilzadeh; Hadi,9999,0,9999,0
1668335494143,CSE 293,008,119166,Freund; Yoav,9999,0,9999,0
1668335494143,CSE 293,009,119170,Griswold; William G.,9999,0,9999,0
1668335494143,CSE 293,010,119183,Gymrek; Melissa Ann,9999,0,9999,0
1668335494143,CSE 293,011,119190,Heninger; Nadia A,9999,0,9999,0
1668335494143,CSE 293,012,119230,Impagliazzo; Russell,9999,0,9999,0
1668335494143,CSE 293,013,119232,Jhala; Ranjit,9999,0,9999,0
1668335494143,CSE 293,014,119233,Kahng; Andrew Byun,9999,0,9999,0
1668335494143,CSE 293,015,119298,Kane; Daniel Mertz,9999,0,9999,0
1668335494143,CSE 293,016,119299,Kriegman; David J,9999,0,9999,0
1668335494143,CSE 293,017,119300,Kumar; Arun Kumar,9999,0,9999,0
1668335494143,CSE 293,018,119301,Lerner; Sorin,9999,0,9999,0
1668335494143,CSE 293,019,119302,Lovett; Shachar,9999,0,9999,0
1668335494143,CSE 293,020,119303,McAuley; Julian John,9999,0,9999,0
1668335494143,CSE 293,021,119304,Micciancio; Daniele,9999,0,9999,0
1668335494143,CSE 293,022,119367,Orailoglu; Alex,9999,0,9999,0
1668335494143,CSE 293,023,119382,Paturi; Ramamohan,9999,0,9999,0
1668335494143,CSE 293,024,119404,Polikarpova; Nadezhda,9999,0,9999,0
1668335494143,CSE 293,025,119406,Politz; Joseph Gibbs,9999,0,9999,0
1668335494143,CSE 293,026,119411,Porter; George M,9999,0,9999,0
1668335494143,CSE 293,027,119414,Porter; Leonard Emerson,9999,0,9999,0
1668335494143,CSE 293,028,119416,Ramamoorthi; Ravi,9999,0,9999,0
1668335494143,CSE 293,029,119417,Sahoo; Debashis,9999,0,9999,0
1668335494143,CSE 293,030,119420,Saul; Lawrence,9999,0,9999,0
1668335494143,CSE 293,031,119421,Savage; Stefan,9999,0,9999,0
1668335494143,CSE 293,032,119425,Schulze; Jurgen P.,9999,0,9999,0
1668335494143,CSE 293,033,119426,Snoeren; Alex C.,9999,0,9999,0
1668335494143,CSE 293,034,119428,Shang; Jingbo,9999,0,9999,0
1668335494143,CSE 293,035,119430,Stefan; Deian,9999,0,9999,0
1668335494143,CSE 293,036,119431,Su; Hao,9999,0,9999,0
1668335494143,CSE 293,037,119433,Swanson; Steven James,9999,0,9999,0
1668335494143,CSE 293,038,119435,Tullsen; Dean Michael,9999,0,9999,0
1668335494143,CSE 293,039,119483,Voelker; Geoffrey M.,9999,0,9999,0
1668335494143,CSE 293,040,119537,Zhao; Jishen,9999,0,9999,0
1668335494143,CSE 293,041,119538,Zhou; Yuan-Yuan,9999,0,9999,0
1668335494143,CSE 293,042,119539,Gao; Sicun,9999,0,9999,0
1668335494143,CSE 293,043,119540,Weibel; Nadir,9999,0,9999,0
1668335494143,CSE 293,044,119541,Gupta; Rajesh K.,9999,0,9999,0
1668335494143,CSE 293,045,126410,Vaccaro; Kristen Marie,9999,0,9999,0
1668335494143,CSE 293,046,126411,Klemke; Richard,9999,0,9999,0
1668335494585,CSE 294,A00,102459,Voelker; Geoffrey M.,0,0,0,0
1668335494585,CSE 294,B00,111322,Orailoglu; Alex,0,0,0,0
1668335495010,DSE 201,A00,096914,Deutsch; Alin Bernard,30,0,30,0
1668335495433,DSE 210,A00,096915,Dasgupta; Sanjoy,30,0,30,0
1668335495857,DSE 260A,A00,096916,Altintas De Callaf; Ilkay,30,0,30,0
1668335496314,ECE 200,001,103586,Antipa; Nicholas A,9999,0,9999,0
1668335496314,ECE 200,002,103587,Atanasov; Nikolay A.,9999,0,9999,0
1668335496314,ECE 200,003,103588,Bharadia; Dinesh,9999,0,9999,0
1668335496314,ECE 200,004,103589,Cheng; Chung Kuan,9999,0,9999,0
1668335496314,ECE 200,005,103590,Cosman; Pamela C.,9999,0,9999,0
1668335496314,ECE 200,006,103591,Dayeh; Shadi Ahmad,9999,0,9999,0
1668335496314,ECE 200,007,103592,Fainman; Yeshaiahu,9999,0,9999,0
1668335496314,ECE 200,008,103593,Ford; Joseph Earl,9999,0,9999,0
1668335496314,ECE 200,009,103594,Franceschetti; Massimo,9999,0,9999,0
1668335496314,ECE 200,010,103595,Fullerton; Eric E,9999,0,9999,0
1668335496314,ECE 200,011,103596,Galton; Ian A,9999,0,9999,0
1668335496314,ECE 200,012,103597,Gilja; Vikash,9999,0,9999,0
1668335496314,ECE 200,013,103598,Hall; Drew A.,9999,0,9999,0
1668335496314,ECE 200,014,103599,Hsueh; Tzu-Chien,9999,0,9999,0
1668335496314,ECE 200,015,103600,Javidi; Tara,9999,0,9999,0
1668335496314,ECE 200,016,103601,Kahng; Andrew Byun,9999,0,9999,0
1668335496314,ECE 200,017,103602,Kim; Young-Han,9999,0,9999,0
1668335496314,ECE 200,018,103603,Koushanfar; Farinaz,9999,0,9999,0
1668335496314,ECE 200,019,103604,Kuzum; Duygu,9999,0,9999,0
1668335496314,ECE 200,020,103605,Le; Hanh-Phuc,9999,0,9999,0
1668335496314,ECE 200,021,103606,Lin; Bill,9999,0,9999,0
1668335496314,ECE 200,022,103607,Liu; Zhaowei,9998,0,9999,1
1668335496314,ECE 200,023,103608,Lo; Yu-Hwa,9999,0,9999,0
1668335496314,ECE 200,024,103609,Lomakin; Vitaliy,9999,0,9999,0
1668335496314,ECE 200,025,103610,Mercier; Patrick Philip,9999,0,9999,0
1668335496314,ECE 200,026,103611,Meyer; Florian,9999,0,9999,0
1668335496314,ECE 200,027,103612,Milstein; Laurence B.,9999,0,9999,0
1668335496314,ECE 200,028,103613,Mir Arabbaygi; Siavash,9999,0,9999,0
1668335496314,ECE 200,029,103614,Mookherjea; Shayan,9999,0,9999,0
1668335496314,ECE 200,030,103615,Morris; Karcher William,9999,0,9999,0
1668335496314,ECE 200,031,103616,Ng; Tse Nga,9999,0,9999,0
1668335496314,ECE 200,032,103617,Nguyen; Truong Quang,9999,0,9999,0
1668335496314,ECE 200,033,103618,Nomura; Kenji,9999,0,9999,0
1668335496314,ECE 200,034,103619,Orlitsky; Alon,9999,0,9999,0
1668335496314,ECE 200,035,103620,Pal; Piya,9999,0,9999,0
1668335496314,ECE 200,036,103621,Papen; George C.,9999,0,9999,0
1668335496314,ECE 200,037,103622,Radic; Stojan,9999,0,9999,0
1668335496314,ECE 200,038,103623,Rao; Bhaskar D.,9999,0,9999,0
1668335496314,ECE 200,039,103624,Rao; Ramesh R,9999,0,9999,0
1668335496314,ECE 200,040,103625,Rebeiz; Gabriel,9999,0,9999,0
1668335496314,ECE 200,041,103626,Sanford; John R,9999,0,9999,0
1668335496314,ECE 200,042,103627,Siegel; Paul H.,9999,0,9999,0
1668335496314,ECE 200,043,103628,Sievenpiper; Daniel F.,9999,0,9999,0
1668335496314,ECE 200,044,103629,Sworder; David D.,9999,0,9999,0
1668335496314,ECE 200,045,103630,Taur; Yuan,9999,0,9999,0
1668335496314,ECE 200,046,103631,Touri; Behrouz,9999,0,9999,0
1668335496314,ECE 200,047,103632,Trivedi; Mohan M.,9999,0,9999,0
1668335496314,ECE 200,048,103633,Vasconcelos; Nuno,9999,0,9999,0
1668335496314,ECE 200,049,103634,Wang; Xiaolong,9999,0,9999,0
1668335496314,ECE 200,050,103635,Xie; Pengtao,9999,0,9999,0
1668335496314,ECE 200,051,103636,Yip; Michael,9999,0,9999,0
1668335496314,ECE 200,052,103637,Zeger; Kenneth A.,999,0,999,0
1668335496314,ECE 200,053,103638,Zhang; Xinyu,9999,0,9999,0
1668335496314,ECE 200,054,103639,Turakhia; Yatish Girish,9999,0,9999,0
1668335496314,ECE 200,055,103640,Kang; Mingu,9999,0,9999,0
1668335496314,ECE 200,056,103641,Shi; Yuanyuan,9999,0,9999,0
1668335496314,ECE 200,057,103642,Wang; Edward Jay,9999,0,9999,0
1668335496314,ECE 200,058,103643,Zheng; Yang,9999,0,9999,0
1668335496738,ECE 202,A00,103644,Kuzum; Duygu,0,0,0,0
1668335497172,ECE 212BN,A00,103646,Ng; Tse Nga,0,0,0,0
1668335497598,ECE 221,A00,111493,Staff,0,0,0,0
1668335498026,ECE 222B,A00,103647,Lomakin; Vitaliy,0,0,0,0
1668335498453,ECE 230B,A00,103648,Taur; Yuan,0,0,0,0
1668335498879,ECE 238B,A00,103649,Garay; Javier,0,0,0,0
1668335499305,ECE 240B,A00,112900,Fainman; Yeshaiahu,0,0,0,0
1668335499734,ECE 247A,A00,103650,Jokerst; Jesse Vincent,0,0,0,0
1668335500159,ECE 247B,A00,103651,Wang; Joseph,0,0,0,0
1668335500584,ECE 250,A00,103652,Siegel; Paul H.,0,0,0,0
1668335501010,ECE 251A,A00,103654,Rao; Bhaskar D.,0,0,0,0
1668335501526,ECE 257B,A00,103655,Bharadia; Dinesh,0,0,0,0
1668335501953,ECE 258A,A00,103656,Milstein; Laurence B.,0,0,0,0
1668335502379,ECE 260B,A00,103658,Kang; Mingu,0,0,0,0
1668335502805,ECE 264A,A00,103659,Galton; Ian A,0,0,0,0
1668335503228,ECE 265A,A00,103661,Gudem; Prasad S.S.,0,0,0,0
1668335503655,ECE 265D,A00,103662,Gudem; Prasad S.S.,0,0,0,0
1668335504083,ECE 268,A00,103663,Koushanfar; Farinaz,0,0,0,0
1668335504510,ECE 269,A01,103665,Pal; Piya,0,0,0,0
1668335504934,ECE 271B,A00,103666,Vasconcelos; Manuela,0,0,0,0
1668335505360,ECE 276A,A00,103667,Atanasov; Nikolay A.,0,0,0,0
1668335505787,ECE 277,A00,103668,An; Cheolhong,0,0,0,0
1668335506216,ECE 279,A00,117947,Hall; Drew A.,0,0,0,0
1668335507081,ECE 283,A00,103670,Hsueh; Tzu-Chien,0,0,0,0
1668335507504,ECE 284,A00,103671,Turakhia; Yatish Girish,0,0,0,0
1668335507929,ECE 285,A00,103672,Zheng; Yang,0,0,0,0
1668335507929,ECE 285,B00,103673,Sworder; David D.,0,0,0,0
1668335508358,ECE 287,A00,103676,Javidi; Tara,0,0,0,0
1668335508788,MATH 200B,A00,098023,Salehi Golsefidy; Alireza,12,0,15,3
1668335509214,MATH 202B,A00,098024,Rhoades; Brendon Patrick,9,0,15,6
1668335509638,MATH 203B,A00,098025,Oprea; Dragos N.,10,0,15,5
1668335510062,MATH 204B,A00,098026,Sorensen; Claus M,13,0,15,2
1668335510500,MATH 208,A00,098027,Izadi; Elham,7,0,10,3
1668335510928,MATH 209,A00,098028,Pollack; Aaron,10,0,10,0
1668335511353,MATH 211A,A00,112919,Rogalski; Daniel,9,0,10,1
1668335511776,MATH 211B,A00,112920,Seward; Brandon M.,9,0,10,1
1668335512201,MATH 218,A00,098029,Li; Bo,10,0,10,0
1668335512630,MATH 220B,A00,098030,Novak; Jonathan I,11,0,15,4
1668335513057,MATH 221A,A00,098031,Ebenfelt; Peter F,13,0,15,2
1668335513482,MATH 231B,A00,098032,Zlatos; Andrej,12,0,15,3
1668335513912,MATH 240B,A00,098033,Ni; Lei,9,0,15,6
1668335514335,MATH 243,A00,098034,Jekel; David Andrew,10,0,10,0
1668335514761,MATH 245A,A00,098035,Nie; Jiawang,0,0,15,16
1668335515197,MATH 248,A00,098036,Bejenaru; Ioan,10,0,10,0
1668335515623,MATH 250B,A00,098037,Spolaor; Luca,14,0,15,1
1668335516050,MATH 258,A00,098038,Ni; Lei,10,0,10,0
1668335516481,MATH 264B,A00,098041,Rhoades; Brendon Patrick,9,0,15,6
1668335516905,MATH 268,A00,098042,Buss; Samuel R,10,0,10,0
1668335517327,MATH 269,A00,098043,Rhoades; Brendon Patrick,10,0,10,0
1668335517749,MATH 270B,A00,098044,Li; Bo,10,0,15,5
1668335518183,MATH 272B,A00,098045,Holst; Michael J,13,0,15,2
1668335518607,MATH 273A,A00,098046,Tian; Xiaochuan,10,0,15,5
1668335519032,MATH 275,A01,098048,Tian; Xiaochuan,6,0,10,4
1668335519456,MATH 278A,A00,098049,Holst; Michael J,8,0,10,2
1668335519884,MATH 278B,A00,098050,Cloninger; Alexander,10,0,10,0
1668335520330,MATH 278C,A00,098051,Nie; Jiawang,7,0,10,3
1668335520755,MATH 280B,A00,098052,Zheng; Tianyi,8,0,15,7
1668335521193,MATH 281B,A00,098053,Bradic; Jelena,1,0,15,14
1668335521624,MATH 282B,A00,098054,Arias-Castro; Ery,0,0,15,15
1668335522048,MATH 285,A00,098055,Fitzsimmons; Patrick J,0,0,15,17
1668335522475,MATH 287B,A00,098056,Arias-Castro; Ery,2,0,15,13
1668335522902,MATH 288,A00,098057,Agarwal; Pooja,9,0,10,1
1668335522902,MATH 288,B00,098058,Zhang; Danna,8,0,10,2
1668335522902,MATH 288,C00,098059,Williams; Ruth J,9,0,10,1
1668335523326,MATH 290B,A00,098060,Roberts; Justin Deritter,13,0,15,2
1668335523759,MATH 292,A00,098061,Belmont; Eva Kinoshita,10,0,10,0
1668335524191,MATH 295,A00,098062,Suk; Andrew Hoon,48,0,50,2
1668335524616,MATH 296,A00,098063,Novak; Jonathan I,20,0,20,0
1668335525047,MATH 297,001,098064,Gamst; Anthony Collins,9997,0,9999,2
1668336024950,COGS 205,A00,101395,Chiba; Andrea,19,0,20,1
1668336025380,COGS 210B,001,101404,Greene; Deanna Jacquelyn,9998,0,9999,1
1668336025380,COGS 210B,002,101417,Xia; Haijun,9999,0,9999,0
1668336025380,COGS 210B,003,101422,Nitz; Douglas A.,9999,0,9999,0
1668336025380,COGS 210B,004,101423,Hollan; James D.,9998,0,9999,1
1668336025380,COGS 210B,005,101424,Deak; Gedeon O.,9998,0,9999,1
1668336025380,COGS 210B,006,101425,Rossano; Federico,9999,0,9999,0
1668336025804,COGS 211B,A00,101427,Coulson; Seana M,9996,0,9999,3
1668336026227,COGS 220,A00,101428,Hollan; James D.,0,0,25,25
1668336026649,COGS 229,A00,101429,Dow; Steven P,18,0,25,7
1668336027072,COGS 230,A00,101430,Klemmer; Scott R,11,0,17,6
1668336027495,COGS 234,A00,101431,Xia; Haijun,1,0,25,24
1668336027922,COGS 260,A00,101432,Kiyonaga; Anastasia,21,0,25,4
1668336027922,COGS 260,B00,101433,Kirsh; David Joel,15,0,25,10
1668336028347,CSE 202,A00,102371,Impagliazzo; Russell,0,0,0,0
1668336028770,CSE 203B,A01,102373,Cheng; Chung Kuan,0,0,0,0
1668336029194,CSE 208,A00,102374,Micciancio; Daniele,0,0,0,0
1668336029618,CSE 209A,A00,112895,Impagliazzo; Russell,0,0,15,15
1668336030042,CSE 209B,A00,108005,Bellare; Mihir,0,0,0,0
1668336030469,CSE 210,A00,113163,Coblenz; Michael J,0,0,0,0
1668336030892,CSE 219,A00,106111,Dow; Steven P,0,0,20,20
1668336031318,CSE 221,A00,102376,Voelker; Geoffrey M.,0,0,0,0
1668336031746,CSE 224,A01,102378,Porter; George M,0,0,0,0
1668336032177,CSE 229A,A00,102379,Savage; Stefan,0,0,0,0
1668336032603,CSE 229C,A00,102380,Munyaka; Imani N. S.,0,0,0,0
1668336033030,CSE 232B,A00,102382,Deutsch; Alin Bernard,0,0,0,0
1668336033453,CSE 234,A01,112904,Kumar; Arun Kumar,0,0,0,0
1668336033878,CSE 237A,A00,102383,Rosing; Tajana Simunic,0,0,0,0
1668336034305,CSE 239A,A00,102384,Deutsch; Alin Bernard,0,0,0,0
1668336034733,CSE 239B,A00,102385,Polikarpova; Nadezhda,0,0,0,0
1668336035156,CSE 240A,A00,102386,Pannuto; Patrick William,0,0,0,0
1668336035581,CSE 240B,A00,102387,Zhao; Jishen,0,0,0,0
1668336036003,CSE 241A,A00,106406,Kang; Mingu,0,0,0,0
1668336036429,CSE 249B,A00,102388,Kahng; Andrew Byun,0,0,8,8
1668336036855,CSE 251B,A01,102392,Cottrell; Garrison W,0,0,0,0
1668336036855,CSE 251B,A02,102393,Cottrell; Garrison W,0,0,0,0
1668336037279,CSE 252B,A00,102394,Ochoa; Benjamin Lawrence,0,0,0,0
1668336037703,CSE 257,A01,102396,Gao; Sicun,0,0,0,0
1668336038127,CSE 272,A00,102397,Li; Tzumao,0,0,0,0
1668336038554,CSE 274,A00,111323,Chern; Albert Ren-Haur,0,0,0,0
1668336038978,CSE 282,A00,102398,Pevzner; Pavel Arkadjevich,0,0,0,0
1668336039402,CSE 284,A00,114175,Gymrek; Melissa Ann,0,0,0,0
1668336039830,CSE 290,A00,102399,Chandraker; Manmohan Krishna,0,0,0,0
1668336039830,CSE 290,B00,102400,Vaccaro; Kristen Marie,0,0,25,25
1668336039830,CSE 290,C00,102414,Pannuto; Patrick William,0,0,25,25
1668336039830,CSE 290,D00,102427,Pevzner; Pavel Arkadjevich,0,0,0,0
1668336039830,CSE 290,E00,102429,Zhao; Jishen,0,0,0,0
1668336039830,CSE 290,F00,102436,Tullsen; Dean Michael,0,0,0,0
1668336039830,CSE 290,G00,102440,Christensen; Henrik I,0,0,20,20
1668336040261,CSE 291,A00,102443,Su; Hao,0,0,0,0
1668336040261,CSE 291,B00,102448,Polikarpova; Nadezhda,0,0,0,0
1668336040261,CSE 291,C00,102453,Vaccaro; Kristen Marie,0,0,0,0
1668336040261,CSE 291,D00,111343,Savage; Stefan,0,0,0,0
1668336040261,CSE 291,E00,116474,Claffy; Kimberly Claire,0,0,0,0
1668336040261,CSE 291,F00,116479,Pasquale; Joseph,0,0,0,0
1668336040702,CSE 293,001,119111,Bafna; Vineet,9999,0,9999,0
1668336040702,CSE 293,002,119118,Bellare; Mihir,9999,0,9999,0
1668336040702,CSE 293,003,119122,Berg-Kirkpatrick; Taylor D,9999,0,9999,0
1668336040702,CSE 293,004,119135,Christensen; Henrik I,9999,0,9999,0
1668336040702,CSE 293,005,119142,Cottrell; Garrison W,9999,0,9999,0
1668336040702,CSE 293,006,119146,Deutsch; Alin Bernard,9999,0,9999,0
1668336040702,CSE 293,007,119159,Esmaeilzadeh; Hadi,9999,0,9999,0
1668336040702,CSE 293,008,119166,Freund; Yoav,9999,0,9999,0
1668336040702,CSE 293,009,119170,Griswold; William G.,9999,0,9999,0
1668336040702,CSE 293,010,119183,Gymrek; Melissa Ann,9999,0,9999,0
1668336040702,CSE 293,011,119190,Heninger; Nadia A,9999,0,9999,0
1668336040702,CSE 293,012,119230,Impagliazzo; Russell,9999,0,9999,0
1668336040702,CSE 293,013,119232,Jhala; Ranjit,9999,0,9999,0
1668336040702,CSE 293,014,119233,Kahng; Andrew Byun,9999,0,9999,0
1668336040702,CSE 293,015,119298,Kane; Daniel Mertz,9999,0,9999,0
1668336040702,CSE 293,016,119299,Kriegman; David J,9999,0,9999,0
1668336040702,CSE 293,017,119300,Kumar; Arun Kumar,9999,0,9999,0
1668336040702,CSE 293,018,119301,Lerner; Sorin,9999,0,9999,0
1668336040702,CSE 293,019,119302,Lovett; Shachar,9999,0,9999,0
1668336040702,CSE 293,020,119303,McAuley; Julian John,9999,0,9999,0
1668336040702,CSE 293,021,119304,Micciancio; Daniele,9999,0,9999,0
1668336040702,CSE 293,022,119367,Orailoglu; Alex,9999,0,9999,0
1668336040702,CSE 293,023,119382,Paturi; Ramamohan,9999,0,9999,0
1668336040702,CSE 293,024,119404,Polikarpova; Nadezhda,9999,0,9999,0
1668336040702,CSE 293,025,119406,Politz; Joseph Gibbs,9999,0,9999,0
1668336040702,CSE 293,026,119411,Porter; George M,9999,0,9999,0
1668336040702,CSE 293,027,119414,Porter; Leonard Emerson,9999,0,9999,0
1668336040702,CSE 293,028,119416,Ramamoorthi; Ravi,9999,0,9999,0
1668336040702,CSE 293,029,119417,Sahoo; Debashis,9999,0,9999,0
1668336040702,CSE 293,030,119420,Saul; Lawrence,9999,0,9999,0
1668336040702,CSE 293,031,119421,Savage; Stefan,9999,0,9999,0
1668336040702,CSE 293,032,119425,Schulze; Jurgen P.,9999,0,9999,0
1668336040702,CSE 293,033,119426,Snoeren; Alex C.,9999,0,9999,0
1668336040702,CSE 293,034,119428,Shang; Jingbo,9999,0,9999,0
1668336040702,CSE 293,035,119430,Stefan; Deian,9999,0,9999,0
1668336040702,CSE 293,036,119431,Su; Hao,9999,0,9999,0
1668336040702,CSE 293,037,119433,Swanson; Steven James,9999,0,9999,0
1668336040702,CSE 293,038,119435,Tullsen; Dean Michael,9999,0,9999,0
1668336040702,CSE 293,039,119483,Voelker; Geoffrey M.,9999,0,9999,0
1668336040702,CSE 293,040,119537,Zhao; Jishen,9999,0,9999,0
1668336040702,CSE 293,041,119538,Zhou; Yuan-Yuan,9999,0,9999,0
1668336040702,CSE 293,042,119539,Gao; Sicun,9999,0,9999,0
1668336040702,CSE 293,043,119540,Weibel; Nadir,9999,0,9999,0
1668336040702,CSE 293,044,119541,Gupta; Rajesh K.,9999,0,9999,0
1668336040702,CSE 293,045,126410,Vaccaro; Kristen Marie,9999,0,9999,0
1668336040702,CSE 293,046,126411,Klemke; Richard,9999,0,9999,0
1668336041126,CSE 294,A00,102459,Voelker; Geoffrey M.,0,0,0,0
1668336041126,CSE 294,B00,111322,Orailoglu; Alex,0,0,0,0
1668336041548,DSE 201,A00,096914,Deutsch; Alin Bernard,30,0,30,0
1668336041972,DSE 210,A00,096915,Dasgupta; Sanjoy,30,0,30,0
1668336042403,DSE 260A,A00,096916,Altintas De Callaf; Ilkay,30,0,30,0
1668336042861,ECE 200,001,103586,Antipa; Nicholas A,9999,0,9999,0
1668336042861,ECE 200,002,103587,Atanasov; Nikolay A.,9999,0,9999,0
1668336042861,ECE 200,003,103588,Bharadia; Dinesh,9999,0,9999,0
1668336042861,ECE 200,004,103589,Cheng; Chung Kuan,9999,0,9999,0
1668336042861,ECE 200,005,103590,Cosman; Pamela C.,9999,0,9999,0
1668336042861,ECE 200,006,103591,Dayeh; Shadi Ahmad,9999,0,9999,0
1668336042861,ECE 200,007,103592,Fainman; Yeshaiahu,9999,0,9999,0
1668336042861,ECE 200,008,103593,Ford; Joseph Earl,9999,0,9999,0
1668336042861,ECE 200,009,103594,Franceschetti; Massimo,9999,0,9999,0
1668336042861,ECE 200,010,103595,Fullerton; Eric E,9999,0,9999,0
1668336042861,ECE 200,011,103596,Galton; Ian A,9999,0,9999,0
1668336042861,ECE 200,012,103597,Gilja; Vikash,9999,0,9999,0
1668336042861,ECE 200,013,103598,Hall; Drew A.,9999,0,9999,0
1668336042861,ECE 200,014,103599,Hsueh; Tzu-Chien,9999,0,9999,0
1668336042861,ECE 200,015,103600,Javidi; Tara,9999,0,9999,0
1668336042861,ECE 200,016,103601,Kahng; Andrew Byun,9999,0,9999,0
1668336042861,ECE 200,017,103602,Kim; Young-Han,9999,0,9999,0
1668336042861,ECE 200,018,103603,Koushanfar; Farinaz,9999,0,9999,0
1668336042861,ECE 200,019,103604,Kuzum; Duygu,9999,0,9999,0
1668336042861,ECE 200,020,103605,Le; Hanh-Phuc,9999,0,9999,0
1668336042861,ECE 200,021,103606,Lin; Bill,9999,0,9999,0
1668336042861,ECE 200,022,103607,Liu; Zhaowei,9998,0,9999,1
1668336042861,ECE 200,023,103608,Lo; Yu-Hwa,9999,0,9999,0
1668336042861,ECE 200,024,103609,Lomakin; Vitaliy,9999,0,9999,0
1668336042861,ECE 200,025,103610,Mercier; Patrick Philip,9999,0,9999,0
1668336042861,ECE 200,026,103611,Meyer; Florian,9999,0,9999,0
1668336042861,ECE 200,027,103612,Milstein; Laurence B.,9999,0,9999,0
1668336042861,ECE 200,028,103613,Mir Arabbaygi; Siavash,9999,0,9999,0
1668336042861,ECE 200,029,103614,Mookherjea; Shayan,9999,0,9999,0
1668336042861,ECE 200,030,103615,Morris; Karcher William,9999,0,9999,0
1668336042861,ECE 200,031,103616,Ng; Tse Nga,9999,0,9999,0
1668336042861,ECE 200,032,103617,Nguyen; Truong Quang,9999,0,9999,0
1668336042861,ECE 200,033,103618,Nomura; Kenji,9999,0,9999,0
1668336042861,ECE 200,034,103619,Orlitsky; Alon,9999,0,9999,0
1668336042861,ECE 200,035,103620,Pal; Piya,9999,0,9999,0
1668336042861,ECE 200,036,103621,Papen; George C.,9999,0,9999,0
1668336042861,ECE 200,037,103622,Radic; Stojan,9999,0,9999,0
1668336042861,ECE 200,038,103623,Rao; Bhaskar D.,9999,0,9999,0
1668336042861,ECE 200,039,103624,Rao; Ramesh R,9999,0,9999,0
1668336042861,ECE 200,040,103625,Rebeiz; Gabriel,9999,0,9999,0
1668336042861,ECE 200,041,103626,Sanford; John R,9999,0,9999,0
1668336042861,ECE 200,042,103627,Siegel; Paul H.,9999,0,9999,0
1668336042861,ECE 200,043,103628,Sievenpiper; Daniel F.,9999,0,9999,0
1668336042861,ECE 200,044,103629,Sworder; David D.,9999,0,9999,0
1668336042861,ECE 200,045,103630,Taur; Yuan,9999,0,9999,0
1668336042861,ECE 200,046,103631,Touri; Behrouz,9999,0,9999,0
1668336042861,ECE 200,047,103632,Trivedi; Mohan M.,9999,0,9999,0
1668336042861,ECE 200,048,103633,Vasconcelos; Nuno,9999,0,9999,0
1668336042861,ECE 200,049,103634,Wang; Xiaolong,9999,0,9999,0
1668336042861,ECE 200,050,103635,Xie; Pengtao,9999,0,9999,0
1668336042861,ECE 200,051,103636,Yip; Michael,9999,0,9999,0
1668336042861,ECE 200,052,103637,Zeger; Kenneth A.,999,0,999,0
1668336042861,ECE 200,053,103638,Zhang; Xinyu,9999,0,9999,0
1668336042861,ECE 200,054,103639,Turakhia; Yatish Girish,9999,0,9999,0
1668336042861,ECE 200,055,103640,Kang; Mingu,9999,0,9999,0
1668336042861,ECE 200,056,103641,Shi; Yuanyuan,9999,0,9999,0
1668336042861,ECE 200,057,103642,Wang; Edward Jay,9999,0,9999,0
1668336042861,ECE 200,058,103643,Zheng; Yang,9999,0,9999,0
1668336043285,ECE 202,A00,103644,Kuzum; Duygu,0,0,0,0
1668336043709,ECE 212BN,A00,103646,Ng; Tse Nga,0,0,0,0
1668336044135,ECE 221,A00,111493,Staff,0,0,0,0
1668336044566,ECE 222B,A00,103647,Lomakin; Vitaliy,0,0,0,0
1668336044994,ECE 230B,A00,103648,Taur; Yuan,0,0,0,0
1668336045417,ECE 238B,A00,103649,Garay; Javier,0,0,0,0
1668336045847,ECE 240B,A00,112900,Fainman; Yeshaiahu,0,0,0,0
1668336046275,ECE 247A,A00,103650,Jokerst; Jesse Vincent,0,0,0,0
1668336046700,ECE 247B,A00,103651,Wang; Joseph,0,0,0,0
1668336047125,ECE 250,A00,103652,Siegel; Paul H.,0,0,0,0
1668336047550,ECE 251A,A00,103654,Rao; Bhaskar D.,0,0,0,0
1668336047978,ECE 257B,A00,103655,Bharadia; Dinesh,0,0,0,0
1668336048406,ECE 258A,A00,103656,Milstein; Laurence B.,0,0,0,0
1668336048829,ECE 260B,A00,103658,Kang; Mingu,0,0,0,0
1668336049252,ECE 264A,A00,103659,Galton; Ian A,0,0,0,0
1668336049676,ECE 265A,A00,103661,Gudem; Prasad S.S.,0,0,0,0
1668336050100,ECE 265D,A00,103662,Gudem; Prasad S.S.,0,0,0,0
1668336050528,ECE 268,A00,103663,Koushanfar; Farinaz,0,0,0,0
1668336050953,ECE 269,A01,103665,Pal; Piya,0,0,0,0
1668336051379,ECE 271B,A00,103666,Vasconcelos; Manuela,0,0,0,0
1668336051801,ECE 276A,A00,103667,Atanasov; Nikolay A.,0,0,0,0
1668336052229,ECE 277,A00,103668,An; Cheolhong,0,0,0,0
1668336052651,ECE 279,A00,117947,Hall; Drew A.,0,0,0,0
1668336053498,ECE 283,A00,103670,Hsueh; Tzu-Chien,0,0,0,0
1668336053924,ECE 284,A00,103671,Turakhia; Yatish Girish,0,0,0,0
1668336054352,ECE 285,A00,103672,Zheng; Yang,0,0,0,0
1668336054352,ECE 285,B00,103673,Sworder; David D.,0,0,0,0
1668336054780,ECE 287,A00,103676,Javidi; Tara,0,0,0,0
1668336055209,MATH 200B,A00,098023,Salehi Golsefidy; Alireza,12,0,15,3
1668336055633,MATH 202B,A00,098024,Rhoades; Brendon Patrick,9,0,15,6
1668336056062,MATH 203B,A00,098025,Oprea; Dragos N.,10,0,15,5
1668336056491,MATH 204B,A00,098026,Sorensen; Claus M,13,0,15,2
1668336056916,MATH 208,A00,098027,Izadi; Elham,7,0,10,3
1668336057339,MATH 209,A00,098028,Pollack; Aaron,10,0,10,0
1668336057764,MATH 211A,A00,112919,Rogalski; Daniel,9,0,10,1
1668336058192,MATH 211B,A00,112920,Seward; Brandon M.,9,0,10,1
1668336058619,MATH 218,A00,098029,Li; Bo,10,0,10,0
1668336059043,MATH 220B,A00,098030,Novak; Jonathan I,11,0,15,4
1668336059469,MATH 221A,A00,098031,Ebenfelt; Peter F,13,0,15,2
1668336059897,MATH 231B,A00,098032,Zlatos; Andrej,12,0,15,3
1668336060328,MATH 240B,A00,098033,Ni; Lei,9,0,15,6
1668336060753,MATH 243,A00,098034,Jekel; David Andrew,10,0,10,0
1668336061182,MATH 245A,A00,098035,Nie; Jiawang,0,0,15,16
1668336061605,MATH 248,A00,098036,Bejenaru; Ioan,10,0,10,0
1668336062030,MATH 250B,A00,098037,Spolaor; Luca,14,0,15,1
1668336062452,MATH 258,A00,098038,Ni; Lei,10,0,10,0
1668336062878,MATH 264B,A00,098041,Rhoades; Brendon Patrick,9,0,15,6
1668336063300,MATH 268,A00,098042,Buss; Samuel R,10,0,10,0
1668336063725,MATH 269,A00,098043,Rhoades; Brendon Patrick,10,0,10,0
1668336064150,MATH 270B,A00,098044,Li; Bo,10,0,15,5
1668336064662,MATH 272B,A00,098045,Holst; Michael J,13,0,15,2
1668336065088,MATH 273A,A00,098046,Tian; Xiaochuan,10,0,15,5
1668336065515,MATH 275,A01,098048,Tian; Xiaochuan,6,0,10,4
1668336065938,MATH 278A,A00,098049,Holst; Michael J,8,0,10,2
1668336066362,MATH 278B,A00,098050,Cloninger; Alexander,10,0,10,0
1668336066788,MATH 278C,A00,098051,Nie; Jiawang,7,0,10,3
1668336067215,MATH 280B,A00,098052,Zheng; Tianyi,8,0,15,7
1668336067639,MATH 281B,A00,098053,Bradic; Jelena,1,0,15,14
1668336068063,MATH 282B,A00,098054,Arias-Castro; Ery,0,0,15,15
1668336068488,MATH 285,A00,098055,Fitzsimmons; Patrick J,0,0,15,17
1668336068913,MATH 287B,A00,098056,Arias-Castro; Ery,2,0,15,13
1668336069340,MATH 288,A00,098057,Agarwal; Pooja,9,0,10,1
1668336069340,MATH 288,B00,098058,Zhang; Danna,8,0,10,2
1668336069340,MATH 288,C00,098059,Williams; Ruth J,9,0,10,1
1668336069769,MATH 290B,A00,098060,Roberts; Justin Deritter,13,0,15,2
1668336070193,MATH 292,A00,098061,Belmont; Eva Kinoshita,10,0,10,0
1668336070618,MATH 295,A00,098062,Suk; Andrew Hoon,48,0,50,2
1668336071044,MATH 296,A00,098063,Novak; Jonathan I,20,0,20,0
1668336071472,MATH 297,001,098064,Gamst; Anthony Collins,9997,0,9999,2
1668336570514,COGS 205,A00,101395,Chiba; Andrea,19,0,20,1
1668336570946,COGS 210B,001,101404,Greene; Deanna Jacquelyn,9998,0,9999,1
1668336570946,COGS 210B,002,101417,Xia; Haijun,9999,0,9999,0
1668336570946,COGS 210B,003,101422,Nitz; Douglas A.,9999,0,9999,0
1668336570946,COGS 210B,004,101423,Hollan; James D.,9998,0,9999,1
1668336570946,COGS 210B,005,101424,Deak; Gedeon O.,9998,0,9999,1
1668336570946,COGS 210B,006,101425,Rossano; Federico,9999,0,9999,0
1668336571370,COGS 211B,A00,101427,Coulson; Seana M,9996,0,9999,3
1668336571796,COGS 220,A00,101428,Hollan; James D.,0,0,25,25
1668336572220,COGS 229,A00,101429,Dow; Steven P,18,0,25,7
1668336572647,COGS 230,A00,101430,Klemmer; Scott R,11,0,17,6
1668336573073,COGS 234,A00,101431,Xia; Haijun,1,0,25,24
1668336573499,COGS 260,A00,101432,Kiyonaga; Anastasia,21,0,25,4
1668336573499,COGS 260,B00,101433,Kirsh; David Joel,15,0,25,10
1668336573927,CSE 202,A00,102371,Impagliazzo; Russell,0,0,0,0
1668336574356,CSE 203B,A01,102373,Cheng; Chung Kuan,0,0,0,0
1668336574780,CSE 208,A00,102374,Micciancio; Daniele,0,0,0,0
1668336575206,CSE 209A,A00,112895,Impagliazzo; Russell,0,0,15,15
1668336575633,CSE 209B,A00,108005,Bellare; Mihir,0,0,0,0
1668336576061,CSE 210,A00,113163,Coblenz; Michael J,0,0,0,0
1668336576485,CSE 219,A00,106111,Dow; Steven P,0,0,20,20
1668336576912,CSE 221,A00,102376,Voelker; Geoffrey M.,0,0,0,0
1668336577337,CSE 224,A01,102378,Porter; George M,0,0,0,0
1668336577764,CSE 229A,A00,102379,Savage; Stefan,0,0,0,0
1668336578188,CSE 229C,A00,102380,Munyaka; Imani N. S.,0,0,0,0
1668336578611,CSE 232B,A00,102382,Deutsch; Alin Bernard,0,0,0,0
1668336579035,CSE 234,A01,112904,Kumar; Arun Kumar,0,0,0,0
1668336579460,CSE 237A,A00,102383,Rosing; Tajana Simunic,0,0,0,0
1668336579886,CSE 239A,A00,102384,Deutsch; Alin Bernard,0,0,0,0
1668336580310,CSE 239B,A00,102385,Polikarpova; Nadezhda,0,0,0,0
1668336580733,CSE 240A,A00,102386,Pannuto; Patrick William,0,0,0,0
1668336581158,CSE 240B,A00,102387,Zhao; Jishen,0,0,0,0
1668336581582,CSE 241A,A00,106406,Kang; Mingu,0,0,0,0
1668336582009,CSE 249B,A00,102388,Kahng; Andrew Byun,0,0,8,8
1668336582438,CSE 251B,A01,102392,Cottrell; Garrison W,0,0,0,0
1668336582438,CSE 251B,A02,102393,Cottrell; Garrison W,0,0,0,0
1668336582861,CSE 252B,A00,102394,Ochoa; Benjamin Lawrence,0,0,0,0
1668336583287,CSE 257,A01,102396,Gao; Sicun,0,0,0,0
1668336583784,CSE 272,A00,102397,Li; Tzumao,0,0,0,0
1668336584211,CSE 274,A00,111323,Chern; Albert Ren-Haur,0,0,0,0
1668336584638,CSE 282,A00,102398,Pevzner; Pavel Arkadjevich,0,0,0,0
1668336585068,CSE 284,A00,114175,Gymrek; Melissa Ann,0,0,0,0
1668336585491,CSE 290,A00,102399,Chandraker; Manmohan Krishna,0,0,0,0
1668336585491,CSE 290,B00,102400,Vaccaro; Kristen Marie,0,0,25,25
1668336585491,CSE 290,C00,102414,Pannuto; Patrick William,0,0,25,25
1668336585491,CSE 290,D00,102427,Pevzner; Pavel Arkadjevich,0,0,0,0
1668336585491,CSE 290,E00,102429,Zhao; Jishen,0,0,0,0
1668336585491,CSE 290,F00,102436,Tullsen; Dean Michael,0,0,0,0
1668336585491,CSE 290,G00,102440,Christensen; Henrik I,0,0,20,20
1668336585918,CSE 291,A00,102443,Su; Hao,0,0,0,0
1668336585918,CSE 291,B00,102448,Polikarpova; Nadezhda,0,0,0,0
1668336585918,CSE 291,C00,102453,Vaccaro; Kristen Marie,0,0,0,0
1668336585918,CSE 291,D00,111343,Savage; Stefan,0,0,0,0
1668336585918,CSE 291,E00,116474,Claffy; Kimberly Claire,0,0,0,0
1668336585918,CSE 291,F00,116479,Pasquale; Joseph,0,0,0,0
1668336586364,CSE 293,001,119111,Bafna; Vineet,9999,0,9999,0
1668336586364,CSE 293,002,119118,Bellare; Mihir,9999,0,9999,0
1668336586364,CSE 293,003,119122,Berg-Kirkpatrick; Taylor D,9999,0,9999,0
1668336586364,CSE 293,004,119135,Christensen; Henrik I,9999,0,9999,0
1668336586364,CSE 293,005,119142,Cottrell; Garrison W,9999,0,9999,0
1668336586364,CSE 293,006,119146,Deutsch; Alin Bernard,9999,0,9999,0
1668336586364,CSE 293,007,119159,Esmaeilzadeh; Hadi,9999,0,9999,0
1668336586364,CSE 293,008,119166,Freund; Yoav,9999,0,9999,0
1668336586364,CSE 293,009,119170,Griswold; William G.,9999,0,9999,0
1668336586364,CSE 293,010,119183,Gymrek; Melissa Ann,9999,0,9999,0
1668336586364,CSE 293,011,119190,Heninger; Nadia A,9999,0,9999,0
1668336586364,CSE 293,012,119230,Impagliazzo; Russell,9999,0,9999,0
1668336586364,CSE 293,013,119232,Jhala; Ranjit,9999,0,9999,0
1668336586364,CSE 293,014,119233,Kahng; Andrew Byun,9999,0,9999,0
1668336586364,CSE 293,015,119298,Kane; Daniel Mertz,9999,0,9999,0
1668336586364,CSE 293,016,119299,Kriegman; David J,9999,0,9999,0
1668336586364,CSE 293,017,119300,Kumar; Arun Kumar,9999,0,9999,0
1668336586364,CSE 293,018,119301,Lerner; Sorin,9999,0,9999,0
1668336586364,CSE 293,019,119302,Lovett; Shachar,9999,0,9999,0
1668336586364,CSE 293,020,119303,McAuley; Julian John,9999,0,9999,0
1668336586364,CSE 293,021,119304,Micciancio; Daniele,9999,0,9999,0
1668336586364,CSE 293,022,119367,Orailoglu; Alex,9999,0,9999,0
1668336586364,CSE 293,023,119382,Paturi; Ramamohan,9999,0,9999,0
1668336586364,CSE 293,024,119404,Polikarpova; Nadezhda,9999,0,9999,0
1668336586364,CSE 293,025,119406,Politz; Joseph Gibbs,9999,0,9999,0
1668336586364,CSE 293,026,119411,Porter; George M,9999,0,9999,0
1668336586364,CSE 293,027,119414,Porter; Leonard Emerson,9999,0,9999,0
1668336586364,CSE 293,028,119416,Ramamoorthi; Ravi,9999,0,9999,0
1668336586364,CSE 293,029,119417,Sahoo; Debashis,9999,0,9999,0
1668336586364,CSE 293,030,119420,Saul; Lawrence,9999,0,9999,0
1668336586364,CSE 293,031,119421,Savage; Stefan,9999,0,9999,0
1668336586364,CSE 293,032,119425,Schulze; Jurgen P.,9999,0,9999,0
1668336586364,CSE 293,033,119426,Snoeren; Alex C.,9999,0,9999,0
1668336586364,CSE 293,034,119428,Shang; Jingbo,9999,0,9999,0
1668336586364,CSE 293,035,119430,Stefan; Deian,9999,0,9999,0
1668336586364,CSE 293,036,119431,Su; Hao,9999,0,9999,0
1668336586364,CSE 293,037,119433,Swanson; Steven James,9999,0,9999,0
1668336586364,CSE 293,038,119435,Tullsen; Dean Michael,9999,0,9999,0
1668336586364,CSE 293,039,119483,Voelker; Geoffrey M.,9999,0,9999,0
1668336586364,CSE 293,040,119537,Zhao; Jishen,9999,0,9999,0
1668336586364,CSE 293,041,119538,Zhou; Yuan-Yuan,9999,0,9999,0
1668336586364,CSE 293,042,119539,Gao; Sicun,9999,0,9999,0
1668336586364,CSE 293,043,119540,Weibel; Nadir,9999,0,9999,0
1668336586364,CSE 293,044,119541,Gupta; Rajesh K.,9999,0,9999,0
1668336586364,CSE 293,045,126410,Vaccaro; Kristen Marie,9999,0,9999,0
1668336586364,CSE 293,046,126411,Klemke; Richard,9999,0,9999,0
1668336586792,CSE 294,A00,102459,Voelker; Geoffrey M.,0,0,0,0
1668336586792,CSE 294,B00,111322,Orailoglu; Alex,0,0,0,0
1668336587216,DSE 201,A00,096914,Deutsch; Alin Bernard,30,0,30,0
1668336587644,DSE 210,A00,096915,Dasgupta; Sanjoy,30,0,30,0
1668336588068,DSE 260A,A00,096916,Altintas De Callaf; Ilkay,30,0,30,0
1668336588524,ECE 200,001,103586,Antipa; Nicholas A,9999,0,9999,0
1668336588524,ECE 200,002,103587,Atanasov; Nikolay A.,9999,0,9999,0
1668336588524,ECE 200,003,103588,Bharadia; Dinesh,9999,0,9999,0
1668336588524,ECE 200,004,103589,Cheng; Chung Kuan,9999,0,9999,0
1668336588524,ECE 200,005,103590,Cosman; Pamela C.,9999,0,9999,0
1668336588524,ECE 200,006,103591,Dayeh; Shadi Ahmad,9999,0,9999,0
1668336588524,ECE 200,007,103592,Fainman; Yeshaiahu,9999,0,9999,0
1668336588524,ECE 200,008,103593,Ford; Joseph Earl,9999,0,9999,0
1668336588524,ECE 200,009,103594,Franceschetti; Massimo,9999,0,9999,0
1668336588524,ECE 200,010,103595,Fullerton; Eric E,9999,0,9999,0
1668336588524,ECE 200,011,103596,Galton; Ian A,9999,0,9999,0
1668336588524,ECE 200,012,103597,Gilja; Vikash,9999,0,9999,0
1668336588524,ECE 200,013,103598,Hall; Drew A.,9999,0,9999,0
1668336588524,ECE 200,014,103599,Hsueh; Tzu-Chien,9999,0,9999,0
1668336588524,ECE 200,015,103600,Javidi; Tara,9999,0,9999,0
1668336588524,ECE 200,016,103601,Kahng; Andrew Byun,9999,0,9999,0
1668336588524,ECE 200,017,103602,Kim; Young-Han,9999,0,9999,0
1668336588524,ECE 200,018,103603,Koushanfar; Farinaz,9999,0,9999,0
1668336588524,ECE 200,019,103604,Kuzum; Duygu,9999,0,9999,0
1668336588524,ECE 200,020,103605,Le; Hanh-Phuc,9999,0,9999,0
1668336588524,ECE 200,021,103606,Lin; Bill,9999,0,9999,0
1668336588524,ECE 200,022,103607,Liu; Zhaowei,9998,0,9999,1
1668336588524,ECE 200,023,103608,Lo; Yu-Hwa,9999,0,9999,0
1668336588524,ECE 200,024,103609,Lomakin; Vitaliy,9999,0,9999,0
1668336588524,ECE 200,025,103610,Mercier; Patrick Philip,9999,0,9999,0
1668336588524,ECE 200,026,103611,Meyer; Florian,9999,0,9999,0
1668336588524,ECE 200,027,103612,Milstein; Laurence B.,9999,0,9999,0
1668336588524,ECE 200,028,103613,Mir Arabbaygi; Siavash,9999,0,9999,0
1668336588524,ECE 200,029,103614,Mookherjea; Shayan,9999,0,9999,0
1668336588524,ECE 200,030,103615,Morris; Karcher William,9999,0,9999,0
1668336588524,ECE 200,031,103616,Ng; Tse Nga,9999,0,9999,0
1668336588524,ECE 200,032,103617,Nguyen; Truong Quang,9999,0,9999,0
1668336588524,ECE 200,033,103618,Nomura; Kenji,9999,0,9999,0
1668336588524,ECE 200,034,103619,Orlitsky; Alon,9999,0,9999,0
1668336588524,ECE 200,035,103620,Pal; Piya,9999,0,9999,0
1668336588524,ECE 200,036,103621,Papen; George C.,9999,0,9999,0
1668336588524,ECE 200,037,103622,Radic; Stojan,9999,0,9999,0
1668336588524,ECE 200,038,103623,Rao; Bhaskar D.,9999,0,9999,0
1668336588524,ECE 200,039,103624,Rao; Ramesh R,9999,0,9999,0
1668336588524,ECE 200,040,103625,Rebeiz; Gabriel,9999,0,9999,0
1668336588524,ECE 200,041,103626,Sanford; John R,9999,0,9999,0
1668336588524,ECE 200,042,103627,Siegel; Paul H.,9999,0,9999,0
1668336588524,ECE 200,043,103628,Sievenpiper; Daniel F.,9999,0,9999,0
1668336588524,ECE 200,044,103629,Sworder; David D.,9999,0,9999,0
1668336588524,ECE 200,045,103630,Taur; Yuan,9999,0,9999,0
1668336588524,ECE 200,046,103631,Touri; Behrouz,9999,0,9999,0
1668336588524,ECE 200,047,103632,Trivedi; Mohan M.,9999,0,9999,0
1668336588524,ECE 200,048,103633,Vasconcelos; Nuno,9999,0,9999,0
1668336588524,ECE 200,049,103634,Wang; Xiaolong,9999,0,9999,0
1668336588524,ECE 200,050,103635,Xie; Pengtao,9999,0,9999,0
1668336588524,ECE 200,051,103636,Yip; Michael,9999,0,9999,0
1668336588524,ECE 200,052,103637,Zeger; Kenneth A.,999,0,999,0
1668336588524,ECE 200,053,103638,Zhang; Xinyu,9999,0,9999,0
1668336588524,ECE 200,054,103639,Turakhia; Yatish Girish,9999,0,9999,0
1668336588524,ECE 200,055,103640,Kang; Mingu,9999,0,9999,0
1668336588524,ECE 200,056,103641,Shi; Yuanyuan,9999,0,9999,0
1668336588524,ECE 200,057,103642,Wang; Edward Jay,9999,0,9999,0
1668336588524,ECE 200,058,103643,Zheng; Yang,9999,0,9999,0
1668336588952,ECE 202,A00,103644,Kuzum; Duygu,0,0,0,0
1668336589378,ECE 212BN,A00,103646,Ng; Tse Nga,0,0,0,0
1668336589802,ECE 221,A00,111493,Staff,0,0,0,0
1668336590225,ECE 222B,A00,103647,Lomakin; Vitaliy,0,0,0,0
1668336590651,ECE 230B,A00,103648,Taur; Yuan,0,0,0,0
1668336591079,ECE 238B,A00,103649,Garay; Javier,0,0,0,0
1668336591507,ECE 240B,A00,112900,Fainman; Yeshaiahu,0,0,0,0
1668336591931,ECE 247A,A00,103650,Jokerst; Jesse Vincent,0,0,0,0
1668336592357,ECE 247B,A00,103651,Wang; Joseph,0,0,0,0
1668336592782,ECE 250,A00,103652,Siegel; Paul H.,0,0,0,0
1668336593208,ECE 251A,A00,103654,Rao; Bhaskar D.,0,0,0,0
1668336593636,ECE 257B,A00,103655,Bharadia; Dinesh,0,0,0,0
1668336594060,ECE 258A,A00,103656,Milstein; Laurence B.,0,0,0,0
1668336594486,ECE 260B,A00,103658,Kang; Mingu,0,0,0,0
1668336594910,ECE 264A,A00,103659,Galton; Ian A,0,0,0,0
1668336595339,ECE 265A,A00,103661,Gudem; Prasad S.S.,0,0,0,0
1668336595762,ECE 265D,A00,103662,Gudem; Prasad S.S.,0,0,0,0
1668336596188,ECE 268,A00,103663,Koushanfar; Farinaz,0,0,0,0
1668336596617,ECE 269,A01,103665,Pal; Piya,0,0,0,0
1668336597061,ECE 271B,A00,103666,Vasconcelos; Manuela,0,0,0,0
1668336597485,ECE 276A,A00,103667,Atanasov; Nikolay A.,0,0,0,0
1668336597910,ECE 277,A00,103668,An; Cheolhong,0,0,0,0
1668336598335,ECE 279,A00,117947,Hall; Drew A.,0,0,0,0
1668336599188,ECE 283,A00,103670,Hsueh; Tzu-Chien,0,0,0,0
1668336599613,ECE 284,A00,103671,Turakhia; Yatish Girish,0,0,0,0
1668336600042,ECE 285,A00,103672,Zheng; Yang,0,0,0,0
1668336600042,ECE 285,B00,103673,Sworder; David D.,0,0,0,0
1668336600465,ECE 287,A00,103676,Javidi; Tara,0,0,0,0
1668336600890,MATH 200B,A00,098023,Salehi Golsefidy; Alireza,12,0,15,3
1668336601318,MATH 202B,A00,098024,Rhoades; Brendon Patrick,9,0,15,6
1668336601743,MATH 203B,A00,098025,Oprea; Dragos N.,10,0,15,5
1668336602167,MATH 204B,A00,098026,Sorensen; Claus M,13,0,15,2
1668336602595,MATH 208,A00,098027,Izadi; Elham,7,0,10,3
1668336603022,MATH 209,A00,098028,Pollack; Aaron,10,0,10,0
1668336603449,MATH 211A,A00,112919,Rogalski; Daniel,9,0,10,1
1668336603874,MATH 211B,A00,112920,Seward; Brandon M.,9,0,10,1
1668336604303,MATH 218,A00,098029,Li; Bo,10,0,10,0
1668336604731,MATH 220B,A00,098030,Novak; Jonathan I,11,0,15,4
1668336605165,MATH 221A,A00,098031,Ebenfelt; Peter F,13,0,15,2
1668336605590,MATH 231B,A00,098032,Zlatos; Andrej,12,0,15,3
1668336606025,MATH 240B,A00,098033,Ni; Lei,9,0,15,6
1668336606448,MATH 243,A00,098034,Jekel; David Andrew,10,0,10,0
1668336606873,MATH 245A,A00,098035,Nie; Jiawang,0,0,15,16
1668336607301,MATH 248,A00,098036,Bejenaru; Ioan,10,0,10,0
1668336607739,MATH 250B,A00,098037,Spolaor; Luca,14,0,15,1
1668336608171,MATH 258,A00,098038,Ni; Lei,10,0,10,0
1668336608598,MATH 264B,A00,098041,Rhoades; Brendon Patrick,9,0,15,6
1668336609023,MATH 268,A00,098042,Buss; Samuel R,10,0,10,0
1668336609449,MATH 269,A00,098043,Rhoades; Brendon Patrick,10,0,10,0
1668336609875,MATH 270B,A00,098044,Li; Bo,10,0,15,5
1668336610300,MATH 272B,A00,098045,Holst; Michael J,13,0,15,2
1668336610724,MATH 273A,A00,098046,Tian; Xiaochuan,10,0,15,5
1668336611148,MATH 275,A01,098048,Tian; Xiaochuan,6,0,10,4
1668336611574,MATH 278A,A00,098049,Holst; Michael J,8,0,10,2
1668336612001,MATH 278B,A00,098050,Cloninger; Alexander,10,0,10,0
1668336612426,MATH 278C,A00,098051,Nie; Jiawang,7,0,10,3
1668336612853,MATH 280B,A00,098052,Zheng; Tianyi,8,0,15,7
1668336613282,MATH 281B,A00,098053,Bradic; Jelena,1,0,15,14
1668336613713,MATH 282B,A00,098054,Arias-Castro; Ery,0,0,15,15
1668336614137,MATH 285,A00,098055,Fitzsimmons; Patrick J,0,0,15,17
1668336614566,MATH 287B,A00,098056,Arias-Castro; Ery,2,0,15,13
1668336614990,MATH 288,A00,098057,Agarwal; Pooja,9,0,10,1
1668336614990,MATH 288,B00,098058,Zhang; Danna,8,0,10,2
1668336614990,MATH 288,C00,098059,Williams; Ruth J,9,0,10,1
1668336615417,MATH 290B,A00,098060,Roberts; Justin Deritter,13,0,15,2
1668336615840,MATH 292,A00,098061,Belmont; Eva Kinoshita,10,0,10,0
1668336616266,MATH 295,A00,098062,Suk; Andrew Hoon,48,0,50,2
1668336616693,MATH 296,A00,098063,Novak; Jonathan I,20,0,20,0
1668336617117,MATH 297,001,098064,Gamst; Anthony Collins,9997,0,9999,2
1668337116727,COGS 205,A00,101395,Chiba; Andrea,19,0,20,1
1668337117157,COGS 210B,001,101404,Greene; Deanna Jacquelyn,9998,0,9999,1
1668337117157,COGS 210B,002,101417,Xia; Haijun,9999,0,9999,0
1668337117157,COGS 210B,003,101422,Nitz; Douglas A.,9999,0,9999,0
1668337117157,COGS 210B,004,101423,Hollan; James D.,9998,0,9999,1
1668337117157,COGS 210B,005,101424,Deak; Gedeon O.,9998,0,9999,1
1668337117157,COGS 210B,006,101425,Rossano; Federico,9999,0,9999,0
1668337117582,COGS 211B,A00,101427,Coulson; Seana M,9996,0,9999,3
1668337118009,COGS 220,A00,101428,Hollan; James D.,0,0,25,25
1668337118433,COGS 229,A00,101429,Dow; Steven P,18,0,25,7
1668337118858,COGS 230,A00,101430,Klemmer; Scott R,11,0,17,6
1668337119286,COGS 234,A00,101431,Xia; Haijun,1,0,25,24
1668337119712,COGS 260,A00,101432,Kiyonaga; Anastasia,21,0,25,4
1668337119712,COGS 260,B00,101433,Kirsh; David Joel,15,0,25,10
1668337120139,CSE 202,A00,102371,Impagliazzo; Russell,0,0,0,0
1668337120569,CSE 203B,A01,102373,Cheng; Chung Kuan,0,0,0,0
1668337120997,CSE 208,A00,102374,Micciancio; Daniele,0,0,0,0
1668337121421,CSE 209A,A00,112895,Impagliazzo; Russell,0,0,15,15
1668337121853,CSE 209B,A00,108005,Bellare; Mihir,0,0,0,0
1668337122282,CSE 210,A00,113163,Coblenz; Michael J,0,0,0,0
1668337122706,CSE 219,A00,106111,Dow; Steven P,0,0,20,20
1668337123130,CSE 221,A00,102376,Voelker; Geoffrey M.,0,0,0,0
1668337123554,CSE 224,A01,102378,Porter; George M,0,0,0,0
1668337123979,CSE 229A,A00,102379,Savage; Stefan,0,0,0,0
1668337124404,CSE 229C,A00,102380,Munyaka; Imani N. S.,0,0,0,0
1668337124829,CSE 232B,A00,102382,Deutsch; Alin Bernard,0,0,0,0
1668337125264,CSE 234,A01,112904,Kumar; Arun Kumar,0,0,0,0
1668337125687,CSE 237A,A00,102383,Rosing; Tajana Simunic,0,0,0,0
1668337126112,CSE 239A,A00,102384,Deutsch; Alin Bernard,0,0,0,0
1668337126538,CSE 239B,A00,102385,Polikarpova; Nadezhda,0,0,0,0
1668337126963,CSE 240A,A00,102386,Pannuto; Patrick William,0,0,0,0
1668337127387,CSE 240B,A00,102387,Zhao; Jishen,0,0,0,0
1668337127811,CSE 241A,A00,106406,Kang; Mingu,0,0,0,0
1668337128238,CSE 249B,A00,102388,Kahng; Andrew Byun,0,0,8,8
1668337128666,CSE 251B,A01,102392,Cottrell; Garrison W,0,0,0,0
1668337128666,CSE 251B,A02,102393,Cottrell; Garrison W,0,0,0,0
1668337129092,CSE 252B,A00,102394,Ochoa; Benjamin Lawrence,0,0,0,0
1668337129517,CSE 257,A01,102396,Gao; Sicun,0,0,0,0
1668337129942,CSE 272,A00,102397,Li; Tzumao,0,0,0,0
1668337130365,CSE 274,A00,111323,Chern; Albert Ren-Haur,0,0,0,0
1668337130792,CSE 282,A00,102398,Pevzner; Pavel Arkadjevich,0,0,0,0
1668337131219,CSE 284,A00,114175,Gymrek; Melissa Ann,0,0,0,0
1668337131646,CSE 290,A00,102399,Chandraker; Manmohan Krishna,0,0,0,0
1668337131646,CSE 290,B00,102400,Vaccaro; Kristen Marie,0,0,25,25
1668337131646,CSE 290,C00,102414,Pannuto; Patrick William,0,0,25,25
1668337131646,CSE 290,D00,102427,Pevzner; Pavel Arkadjevich,0,0,0,0
1668337131646,CSE 290,E00,102429,Zhao; Jishen,0,0,0,0
1668337131646,CSE 290,F00,102436,Tullsen; Dean Michael,0,0,0,0
1668337131646,CSE 290,G00,102440,Christensen; Henrik I,0,0,20,20
1668337132071,CSE 291,A00,102443,Su; Hao,0,0,0,0
1668337132071,CSE 291,B00,102448,Polikarpova; Nadezhda,0,0,0,0
1668337132071,CSE 291,C00,102453,Vaccaro; Kristen Marie,0,0,0,0
1668337132071,CSE 291,D00,111343,Savage; Stefan,0,0,0,0
1668337132071,CSE 291,E00,116474,Claffy; Kimberly Claire,0,0,0,0
1668337132071,CSE 291,F00,116479,Pasquale; Joseph,0,0,0,0
1668337132504,CSE 293,001,119111,Bafna; Vineet,9999,0,9999,0
1668337132504,CSE 293,002,119118,Bellare; Mihir,9999,0,9999,0
1668337132504,CSE 293,003,119122,Berg-Kirkpatrick; Taylor D,9999,0,9999,0
1668337132504,CSE 293,004,119135,Christensen; Henrik I,9999,0,9999,0
1668337132504,CSE 293,005,119142,Cottrell; Garrison W,9999,0,9999,0
1668337132504,CSE 293,006,119146,Deutsch; Alin Bernard,9999,0,9999,0
1668337132504,CSE 293,007,119159,Esmaeilzadeh; Hadi,9999,0,9999,0
1668337132504,CSE 293,008,119166,Freund; Yoav,9999,0,9999,0
1668337132504,CSE 293,009,119170,Griswold; William G.,9999,0,9999,0
1668337132504,CSE 293,010,119183,Gymrek; Melissa Ann,9999,0,9999,0
1668337132504,CSE 293,011,119190,Heninger; Nadia A,9999,0,9999,0
1668337132504,CSE 293,012,119230,Impagliazzo; Russell,9999,0,9999,0
1668337132504,CSE 293,013,119232,Jhala; Ranjit,9999,0,9999,0
1668337132504,CSE 293,014,119233,Kahng; Andrew Byun,9999,0,9999,0
1668337132504,CSE 293,015,119298,Kane; Daniel Mertz,9999,0,9999,0
1668337132504,CSE 293,016,119299,Kriegman; David J,9999,0,9999,0
1668337132504,CSE 293,017,119300,Kumar; Arun Kumar,9999,0,9999,0
1668337132504,CSE 293,018,119301,Lerner; Sorin,9999,0,9999,0
1668337132504,CSE 293,019,119302,Lovett; Shachar,9999,0,9999,0
1668337132504,CSE 293,020,119303,McAuley; Julian John,9999,0,9999,0
1668337132504,CSE 293,021,119304,Micciancio; Daniele,9999,0,9999,0
1668337132504,CSE 293,022,119367,Orailoglu; Alex,9999,0,9999,0
1668337132504,CSE 293,023,119382,Paturi; Ramamohan,9999,0,9999,0
1668337132504,CSE 293,024,119404,Polikarpova; Nadezhda,9999,0,9999,0
1668337132504,CSE 293,025,119406,Politz; Joseph Gibbs,9999,0,9999,0
1668337132504,CSE 293,026,119411,Porter; George M,9999,0,9999,0
1668337132504,CSE 293,027,119414,Porter; Leonard Emerson,9999,0,9999,0
1668337132504,CSE 293,028,119416,Ramamoorthi; Ravi,9999,0,9999,0
1668337132504,CSE 293,029,119417,Sahoo; Debashis,9999,0,9999,0
1668337132504,CSE 293,030,119420,Saul; Lawrence,9999,0,9999,0
1668337132504,CSE 293,031,119421,Savage; Stefan,9999,0,9999,0
1668337132504,CSE 293,032,119425,Schulze; Jurgen P.,9999,0,9999,0
1668337132504,CSE 293,033,119426,Snoeren; Alex C.,9999,0,9999,0
1668337132504,CSE 293,034,119428,Shang; Jingbo,9999,0,9999,0
1668337132504,CSE 293,035,119430,Stefan; Deian,9999,0,9999,0
1668337132504,CSE 293,036,119431,Su; Hao,9999,0,9999,0
1668337132504,CSE 293,037,119433,Swanson; Steven James,9999,0,9999,0
1668337132504,CSE 293,038,119435,Tullsen; Dean Michael,9999,0,9999,0
1668337132504,CSE 293,039,119483,Voelker; Geoffrey M.,9999,0,9999,0
1668337132504,CSE 293,040,119537,Zhao; Jishen,9999,0,9999,0
1668337132504,CSE 293,041,119538,Zhou; Yuan-Yuan,9999,0,9999,0
1668337132504,CSE 293,042,119539,Gao; Sicun,9999,0,9999,0
1668337132504,CSE 293,043,119540,Weibel; Nadir,9999,0,9999,0
1668337132504,CSE 293,044,119541,Gupta; Rajesh K.,9999,0,9999,0
1668337132504,CSE 293,045,126410,Vaccaro; Kristen Marie,9999,0,9999,0
1668337132504,CSE 293,046,126411,Klemke; Richard,9999,0,9999,0
1668337132930,CSE 294,A00,102459,Voelker; Geoffrey M.,0,0,0,0
1668337132930,CSE 294,B00,111322,Orailoglu; Alex,0,0,0,0
1668337133355,DSE 201,A00,096914,Deutsch; Alin Bernard,30,0,30,0
1668337133779,DSE 210,A00,096915,Dasgupta; Sanjoy,30,0,30,0
1668337134205,DSE 260A,A00,096916,Altintas De Callaf; Ilkay,30,0,30,0
1668337134644,ECE 200,001,103586,Antipa; Nicholas A,9999,0,9999,0
1668337134644,ECE 200,002,103587,Atanasov; Nikolay A.,9999,0,9999,0
1668337134644,ECE 200,003,103588,Bharadia; Dinesh,9999,0,9999,0
1668337134644,ECE 200,004,103589,Cheng; Chung Kuan,9999,0,9999,0
1668337134644,ECE 200,005,103590,Cosman; Pamela C.,9999,0,9999,0
1668337134644,ECE 200,006,103591,Dayeh; Shadi Ahmad,9999,0,9999,0
1668337134644,ECE 200,007,103592,Fainman; Yeshaiahu,9999,0,9999,0
1668337134644,ECE 200,008,103593,Ford; Joseph Earl,9999,0,9999,0
1668337134644,ECE 200,009,103594,Franceschetti; Massimo,9999,0,9999,0
1668337134644,ECE 200,010,103595,Fullerton; Eric E,9999,0,9999,0
1668337134644,ECE 200,011,103596,Galton; Ian A,9999,0,9999,0
1668337134644,ECE 200,012,103597,Gilja; Vikash,9999,0,9999,0
1668337134644,ECE 200,013,103598,Hall; Drew A.,9999,0,9999,0
1668337134644,ECE 200,014,103599,Hsueh; Tzu-Chien,9999,0,9999,0
1668337134644,ECE 200,015,103600,Javidi; Tara,9999,0,9999,0
1668337134644,ECE 200,016,103601,Kahng; Andrew Byun,9999,0,9999,0
1668337134644,ECE 200,017,103602,Kim; Young-Han,9999,0,9999,0
1668337134644,ECE 200,018,103603,Koushanfar; Farinaz,9999,0,9999,0
1668337134644,ECE 200,019,103604,Kuzum; Duygu,9999,0,9999,0
1668337134644,ECE 200,020,103605,Le; Hanh-Phuc,9999,0,9999,0
1668337134644,ECE 200,021,103606,Lin; Bill,9999,0,9999,0
1668337134644,ECE 200,022,103607,Liu; Zhaowei,9998,0,9999,1
1668337134644,ECE 200,023,103608,Lo; Yu-Hwa,9999,0,9999,0
1668337134644,ECE 200,024,103609,Lomakin; Vitaliy,9999,0,9999,0
1668337134644,ECE 200,025,103610,Mercier; Patrick Philip,9999,0,9999,0
1668337134644,ECE 200,026,103611,Meyer; Florian,9999,0,9999,0
1668337134644,ECE 200,027,103612,Milstein; Laurence B.,9999,0,9999,0
1668337134644,ECE 200,028,103613,Mir Arabbaygi; Siavash,9999,0,9999,0
1668337134644,ECE 200,029,103614,Mookherjea; Shayan,9999,0,9999,0
1668337134644,ECE 200,030,103615,Morris; Karcher William,9999,0,9999,0
1668337134644,ECE 200,031,103616,Ng; Tse Nga,9999,0,9999,0
1668337134644,ECE 200,032,103617,Nguyen; Truong Quang,9999,0,9999,0
1668337134644,ECE 200,033,103618,Nomura; Kenji,9999,0,9999,0
1668337134644,ECE 200,034,103619,Orlitsky; Alon,9999,0,9999,0
1668337134644,ECE 200,035,103620,Pal; Piya,9999,0,9999,0
1668337134644,ECE 200,036,103621,Papen; George C.,9999,0,9999,0
1668337134644,ECE 200,037,103622,Radic; Stojan,9999,0,9999,0
1668337134644,ECE 200,038,103623,Rao; Bhaskar D.,9999,0,9999,0
1668337134644,ECE 200,039,103624,Rao; Ramesh R,9999,0,9999,0
1668337134644,ECE 200,040,103625,Rebeiz; Gabriel,9999,0,9999,0
1668337134644,ECE 200,041,103626,Sanford; John R,9999,0,9999,0
1668337134644,ECE 200,042,103627,Siegel; Paul H.,9999,0,9999,0
1668337134644,ECE 200,043,103628,Sievenpiper; Daniel F.,9999,0,9999,0
1668337134644,ECE 200,044,103629,Sworder; David D.,9999,0,9999,0
1668337134644,ECE 200,045,103630,Taur; Yuan,9999,0,9999,0
1668337134644,ECE 200,046,103631,Touri; Behrouz,9999,0,9999,0
1668337134644,ECE 200,047,103632,Trivedi; Mohan M.,9999,0,9999,0
1668337134644,ECE 200,048,103633,Vasconcelos; Nuno,9999,0,9999,0
1668337134644,ECE 200,049,103634,Wang; Xiaolong,9999,0,9999,0
1668337134644,ECE 200,050,103635,Xie; Pengtao,9999,0,9999,0
1668337134644,ECE 200,051,103636,Yip; Michael,9999,0,9999,0
1668337134644,ECE 200,052,103637,Zeger; Kenneth A.,999,0,999,0
1668337134644,ECE 200,053,103638,Zhang; Xinyu,9999,0,9999,0
1668337134644,ECE 200,054,103639,Turakhia; Yatish Girish,9999,0,9999,0
1668337134644,ECE 200,055,103640,Kang; Mingu,9999,0,9999,0
1668337134644,ECE 200,056,103641,Shi; Yuanyuan,9999,0,9999,0
1668337134644,ECE 200,057,103642,Wang; Edward Jay,9999,0,9999,0
1668337134644,ECE 200,058,103643,Zheng; Yang,9999,0,9999,0
1668337135072,ECE 202,A00,103644,Kuzum; Duygu,0,0,0,0
1668337135497,ECE 212BN,A00,103646,Ng; Tse Nga,0,0,0,0
1668337135920,ECE 221,A00,111493,Staff,0,0,0,0
1668337136347,ECE 222B,A00,103647,Lomakin; Vitaliy,0,0,0,0
1668337136774,ECE 230B,A00,103648,Taur; Yuan,0,0,0,0
1668337137197,ECE 238B,A00,103649,Garay; Javier,0,0,0,0
1668337137621,ECE 240B,A00,112900,Fainman; Yeshaiahu,0,0,0,0
1668337138046,ECE 247A,A00,103650,Jokerst; Jesse Vincent,0,0,0,0
1668337138475,ECE 247B,A00,103651,Wang; Joseph,0,0,0,0
1668337138903,ECE 250,A00,103652,Siegel; Paul H.,0,0,0,0
1668337139328,ECE 251A,A00,103654,Rao; Bhaskar D.,0,0,0,0
1668337139753,ECE 257B,A00,103655,Bharadia; Dinesh,0,0,0,0
1668337140178,ECE 258A,A00,103656,Milstein; Laurence B.,0,0,0,0
1668337140603,ECE 260B,A00,103658,Kang; Mingu,0,0,0,0
1668337141032,ECE 264A,A00,103659,Galton; Ian A,0,0,0,0
1668337141455,ECE 265A,A00,103661,Gudem; Prasad S.S.,0,0,0,0
1668337141881,ECE 265D,A00,103662,Gudem; Prasad S.S.,0,0,0,0
1668337142306,ECE 268,A00,103663,Koushanfar; Farinaz,0,0,0,0
1668337142732,ECE 269,A01,103665,Pal; Piya,0,0,0,0
1668337143157,ECE 271B,A00,103666,Vasconcelos; Manuela,0,0,0,0
1668337143579,ECE 276A,A00,103667,Atanasov; Nikolay A.,0,0,0,0
1668337144004,ECE 277,A00,103668,An; Cheolhong,0,0,0,0
1668337144433,ECE 279,A00,117947,Hall; Drew A.,0,0,0,0
1668337145283,ECE 283,A00,103670,Hsueh; Tzu-Chien,0,0,0,0
1668337145705,ECE 284,A00,103671,Turakhia; Yatish Girish,0,0,0,0
1668337146135,ECE 285,A00,103672,Zheng; Yang,0,0,0,0
1668337146135,ECE 285,B00,103673,Sworder; David D.,0,0,0,0
1668337146636,ECE 287,A00,103676,Javidi; Tara,0,0,0,0
1668337147064,MATH 200B,A00,098023,Salehi Golsefidy; Alireza,12,0,15,3
1668337147488,MATH 202B,A00,098024,Rhoades; Brendon Patrick,9,0,15,6
1668337147910,MATH 203B,A00,098025,Oprea; Dragos N.,10,0,15,5
1668337148339,MATH 204B,A00,098026,Sorensen; Claus M,13,0,15,2
1668337148762,MATH 208,A00,098027,Izadi; Elham,7,0,10,3
1668337149196,MATH 209,A00,098028,Pollack; Aaron,10,0,10,0
1668337149627,MATH 211A,A00,112919,Rogalski; Daniel,9,0,10,1
1668337150050,MATH 211B,A00,112920,Seward; Brandon M.,9,0,10,1
1668337150473,MATH 218,A00,098029,Li; Bo,10,0,10,0
1668337150897,MATH 220B,A00,098030,Novak; Jonathan I,11,0,15,4
1668337151325,MATH 221A,A00,098031,Ebenfelt; Peter F,13,0,15,2
1668337151751,MATH 231B,A00,098032,Zlatos; Andrej,12,0,15,3
1668337152174,MATH 240B,A00,098033,Ni; Lei,9,0,15,6
1668337152598,MATH 243,A00,098034,Jekel; David Andrew,10,0,10,0
1668337153021,MATH 245A,A00,098035,Nie; Jiawang,0,0,15,16
1668337153446,MATH 248,A00,098036,Bejenaru; Ioan,10,0,10,0
1668337153870,MATH 250B,A00,098037,Spolaor; Luca,14,0,15,1
1668337154295,MATH 258,A00,098038,Ni; Lei,10,0,10,0
1668337154723,MATH 264B,A00,098041,Rhoades; Brendon Patrick,9,0,15,6
1668337155146,MATH 268,A00,098042,Buss; Samuel R,10,0,10,0
1668337155569,MATH 269,A00,098043,Rhoades; Brendon Patrick,10,0,10,0
1668337155993,MATH 270B,A00,098044,Li; Bo,10,0,15,5
1668337156419,MATH 272B,A00,098045,Holst; Michael J,13,0,15,2
1668337156846,MATH 273A,A00,098046,Tian; Xiaochuan,10,0,15,5
1668337157273,MATH 275,A01,098048,Tian; Xiaochuan,6,0,10,4
1668337157697,MATH 278A,A00,098049,Holst; Michael J,8,0,10,2
1668337158122,MATH 278B,A00,098050,Cloninger; Alexander,10,0,10,0
1668337158546,MATH 278C,A00,098051,Nie; Jiawang,7,0,10,3
1668337158974,MATH 280B,A00,098052,Zheng; Tianyi,8,0,15,7
1668337159398,MATH 281B,A00,098053,Bradic; Jelena,1,0,15,14
1668337159822,MATH 282B,A00,098054,Arias-Castro; Ery,0,0,15,15
1668337160244,MATH 285,A00,098055,Fitzsimmons; Patrick J,0,0,15,17
1668337160672,MATH 287B,A00,098056,Arias-Castro; Ery,2,0,15,13
1668337161096,MATH 288,A00,098057,Agarwal; Pooja,9,0,10,1
1668337161096,MATH 288,B00,098058,Zhang; Danna,8,0,10,2
1668337161096,MATH 288,C00,098059,Williams; Ruth J,9,0,10,1
1668337161519,MATH 290B,A00,098060,Roberts; Justin Deritter,13,0,15,2
1668337161944,MATH 292,A00,098061,Belmont; Eva Kinoshita,10,0,10,0
1668337162371,MATH 295,A00,098062,Suk; Andrew Hoon,48,0,50,2
1668337162796,MATH 296,A00,098063,Novak; Jonathan I,20,0,20,0
1668337163220,MATH 297,001,098064,Gamst; Anthony Collins,9997,0,9999,2
1668337662197,COGS 205,A00,101395,Chiba; Andrea,19,0,20,1
1668337662621,COGS 210B,001,101404,Greene; Deanna Jacquelyn,9998,0,9999,1
1668337662621,COGS 210B,002,101417,Xia; Haijun,9999,0,9999,0
1668337662621,COGS 210B,003,101422,Nitz; Douglas A.,9999,0,9999,0
1668337662621,COGS 210B,004,101423,Hollan; James D.,9998,0,9999,1
1668337662621,COGS 210B,005,101424,Deak; Gedeon O.,9998,0,9999,1
1668337662621,COGS 210B,006,101425,Rossano; Federico,9999,0,9999,0
1668337663047,COGS 211B,A00,101427,Coulson; Seana M,9996,0,9999,3
1668337663472,COGS 220,A00,101428,Hollan; James D.,0,0,25,25
1668337663898,COGS 229,A00,101429,Dow; Steven P,18,0,25,7
1668337664326,COGS 230,A00,101430,Klemmer; Scott R,11,0,17,6
1668337664750,COGS 234,A00,101431,Xia; Haijun,1,0,25,24
1668337665175,COGS 260,A00,101432,Kiyonaga; Anastasia,21,0,25,4
1668337665175,COGS 260,B00,101433,Kirsh; David Joel,15,0,25,10
1668337665673,CSE 202,A00,102371,Impagliazzo; Russell,0,0,0,0
1668337666101,CSE 203B,A01,102373,Cheng; Chung Kuan,0,0,0,0
1668337666529,CSE 208,A00,102374,Micciancio; Daniele,0,0,0,0
1668337666953,CSE 209A,A00,112895,Impagliazzo; Russell,0,0,15,15
1668337667377,CSE 209B,A00,108005,Bellare; Mihir,0,0,0,0
1668337667802,CSE 210,A00,113163,Coblenz; Michael J,0,0,0,0
1668337668229,CSE 219,A00,106111,Dow; Steven P,0,0,20,20
1668337668667,CSE 221,A00,102376,Voelker; Geoffrey M.,0,0,0,0
1668337669092,CSE 224,A01,102378,Porter; George M,0,0,0,0
1668337669515,CSE 229A,A00,102379,Savage; Stefan,0,0,0,0
1668337669942,CSE 229C,A00,102380,Munyaka; Imani N. S.,0,0,0,0
1668337670368,CSE 232B,A00,102382,Deutsch; Alin Bernard,0,0,0,0
1668337670793,CSE 234,A01,112904,Kumar; Arun Kumar,0,0,0,0
1668337671216,CSE 237A,A00,102383,Rosing; Tajana Simunic,0,0,0,0
1668337671641,CSE 239A,A00,102384,Deutsch; Alin Bernard,0,0,0,0
1668337672070,CSE 239B,A00,102385,Polikarpova; Nadezhda,0,0,0,0
1668337672496,CSE 240A,A00,102386,Pannuto; Patrick William,0,0,0,0
1668337672919,CSE 240B,A00,102387,Zhao; Jishen,0,0,0,0
1668337673344,CSE 241A,A00,106406,Kang; Mingu,0,0,0,0
1668337673768,CSE 249B,A00,102388,Kahng; Andrew Byun,0,0,8,8
1668337674196,CSE 251B,A01,102392,Cottrell; Garrison W,0,0,0,0
1668337674196,CSE 251B,A02,102393,Cottrell; Garrison W,0,0,0,0
1668337674626,CSE 252B,A00,102394,Ochoa; Benjamin Lawrence,0,0,0,0
1668337675049,CSE 257,A01,102396,Gao; Sicun,0,0,0,0
1668337675473,CSE 272,A00,102397,Li; Tzumao,0,0,0,0
1668337675901,CSE 274,A00,111323,Chern; Albert Ren-Haur,0,0,0,0
1668337676324,CSE 282,A00,102398,Pevzner; Pavel Arkadjevich,0,0,0,0
1668337676748,CSE 284,A00,114175,Gymrek; Melissa Ann,0,0,0,0
1668337677172,CSE 290,A00,102399,Chandraker; Manmohan Krishna,0,0,0,0
1668337677172,CSE 290,B00,102400,Vaccaro; Kristen Marie,0,0,25,25
1668337677172,CSE 290,C00,102414,Pannuto; Patrick William,0,0,25,25
1668337677172,CSE 290,D00,102427,Pevzner; Pavel Arkadjevich,0,0,0,0
1668337677172,CSE 290,E00,102429,Zhao; Jishen,0,0,0,0
1668337677172,CSE 290,F00,102436,Tullsen; Dean Michael,0,0,0,0
1668337677172,CSE 290,G00,102440,Christensen; Henrik I,0,0,20,20
1668337677601,CSE 291,A00,102443,Su; Hao,0,0,0,0
1668337677601,CSE 291,B00,102448,Polikarpova; Nadezhda,0,0,0,0
1668337677601,CSE 291,C00,102453,Vaccaro; Kristen Marie,0,0,0,0
1668337677601,CSE 291,D00,111343,Savage; Stefan,0,0,0,0
1668337677601,CSE 291,E00,116474,Claffy; Kimberly Claire,0,0,0,0
1668337677601,CSE 291,F00,116479,Pasquale; Joseph,0,0,0,0
1668337678032,CSE 293,001,119111,Bafna; Vineet,9999,0,9999,0
1668337678032,CSE 293,002,119118,Bellare; Mihir,9999,0,9999,0
1668337678032,CSE 293,003,119122,Berg-Kirkpatrick; Taylor D,9999,0,9999,0
1668337678032,CSE 293,004,119135,Christensen; Henrik I,9999,0,9999,0
1668337678032,CSE 293,005,119142,Cottrell; Garrison W,9999,0,9999,0
1668337678032,CSE 293,006,119146,Deutsch; Alin Bernard,9999,0,9999,0
1668337678032,CSE 293,007,119159,Esmaeilzadeh; Hadi,9999,0,9999,0
1668337678032,CSE 293,008,119166,Freund; Yoav,9999,0,9999,0
1668337678032,CSE 293,009,119170,Griswold; William G.,9999,0,9999,0
1668337678032,CSE 293,010,119183,Gymrek; Melissa Ann,9999,0,9999,0
1668337678032,CSE 293,011,119190,Heninger; Nadia A,9999,0,9999,0
1668337678032,CSE 293,012,119230,Impagliazzo; Russell,9999,0,9999,0
1668337678032,CSE 293,013,119232,Jhala; Ranjit,9999,0,9999,0
1668337678032,CSE 293,014,119233,Kahng; Andrew Byun,9999,0,9999,0
1668337678032,CSE 293,015,119298,Kane; Daniel Mertz,9999,0,9999,0
1668337678032,CSE 293,016,119299,Kriegman; David J,9999,0,9999,0
1668337678032,CSE 293,017,119300,Kumar; Arun Kumar,9999,0,9999,0
1668337678032,CSE 293,018,119301,Lerner; Sorin,9999,0,9999,0
1668337678032,CSE 293,019,119302,Lovett; Shachar,9999,0,9999,0
1668337678032,CSE 293,020,119303,McAuley; Julian John,9999,0,9999,0
1668337678032,CSE 293,021,119304,Micciancio; Daniele,9999,0,9999,0
1668337678032,CSE 293,022,119367,Orailoglu; Alex,9999,0,9999,0
1668337678032,CSE 293,023,119382,Paturi; Ramamohan,9999,0,9999,0
1668337678032,CSE 293,024,119404,Polikarpova; Nadezhda,9999,0,9999,0
1668337678032,CSE 293,025,119406,Politz; Joseph Gibbs,9999,0,9999,0
1668337678032,CSE 293,026,119411,Porter; George M,9999,0,9999,0
1668337678032,CSE 293,027,119414,Porter; Leonard Emerson,9999,0,9999,0
1668337678032,CSE 293,028,119416,Ramamoorthi; Ravi,9999,0,9999,0
1668337678032,CSE 293,029,119417,Sahoo; Debashis,9999,0,9999,0
1668337678032,CSE 293,030,119420,Saul; Lawrence,9999,0,9999,0
1668337678032,CSE 293,031,119421,Savage; Stefan,9999,0,9999,0
1668337678032,CSE 293,032,119425,Schulze; Jurgen P.,9999,0,9999,0
1668337678032,CSE 293,033,119426,Snoeren; Alex C.,9999,0,9999,0
1668337678032,CSE 293,034,119428,Shang; Jingbo,9999,0,9999,0
1668337678032,CSE 293,035,119430,Stefan; Deian,9999,0,9999,0
1668337678032,CSE 293,036,119431,Su; Hao,9999,0,9999,0
1668337678032,CSE 293,037,119433,Swanson; Steven James,9999,0,9999,0
1668337678032,CSE 293,038,119435,Tullsen; Dean Michael,9999,0,9999,0
1668337678032,CSE 293,039,119483,Voelker; Geoffrey M.,9999,0,9999,0
1668337678032,CSE 293,040,119537,Zhao; Jishen,9999,0,9999,0
1668337678032,CSE 293,041,119538,Zhou; Yuan-Yuan,9999,0,9999,0
1668337678032,CSE 293,042,119539,Gao; Sicun,9999,0,9999,0
1668337678032,CSE 293,043,119540,Weibel; Nadir,9999,0,9999,0
1668337678032,CSE 293,044,119541,Gupta; Rajesh K.,9999,0,9999,0
1668337678032,CSE 293,045,126410,Vaccaro; Kristen Marie,9999,0,9999,0
1668337678032,CSE 293,046,126411,Klemke; Richard,9999,0,9999,0
1668337678456,CSE 294,A00,102459,Voelker; Geoffrey M.,0,0,0,0
1668337678456,CSE 294,B00,111322,Orailoglu; Alex,0,0,0,0
1668337678880,DSE 201,A00,096914,Deutsch; Alin Bernard,30,0,30,0
1668337679309,DSE 210,A00,096915,Dasgupta; Sanjoy,30,0,30,0
1668337679738,DSE 260A,A00,096916,Altintas De Callaf; Ilkay,30,0,30,0
1668337680173,ECE 200,001,103586,Antipa; Nicholas A,9999,0,9999,0
1668337680173,ECE 200,002,103587,Atanasov; Nikolay A.,9999,0,9999,0
1668337680173,ECE 200,003,103588,Bharadia; Dinesh,9999,0,9999,0
1668337680173,ECE 200,004,103589,Cheng; Chung Kuan,9999,0,9999,0
1668337680173,ECE 200,005,103590,Cosman; Pamela C.,9999,0,9999,0
1668337680173,ECE 200,006,103591,Dayeh; Shadi Ahmad,9999,0,9999,0
1668337680173,ECE 200,007,103592,Fainman; Yeshaiahu,9999,0,9999,0
1668337680173,ECE 200,008,103593,Ford; Joseph Earl,9999,0,9999,0
1668337680173,ECE 200,009,103594,Franceschetti; Massimo,9999,0,9999,0
1668337680173,ECE 200,010,103595,Fullerton; Eric E,9999,0,9999,0
1668337680173,ECE 200,011,103596,Galton; Ian A,9999,0,9999,0
1668337680173,ECE 200,012,103597,Gilja; Vikash,9999,0,9999,0
1668337680173,ECE 200,013,103598,Hall; Drew A.,9999,0,9999,0
1668337680173,ECE 200,014,103599,Hsueh; Tzu-Chien,9999,0,9999,0
1668337680173,ECE 200,015,103600,Javidi; Tara,9999,0,9999,0
1668337680173,ECE 200,016,103601,Kahng; Andrew Byun,9999,0,9999,0
1668337680173,ECE 200,017,103602,Kim; Young-Han,9999,0,9999,0
1668337680173,ECE 200,018,103603,Koushanfar; Farinaz,9999,0,9999,0
1668337680173,ECE 200,019,103604,Kuzum; Duygu,9999,0,9999,0
1668337680173,ECE 200,020,103605,Le; Hanh-Phuc,9999,0,9999,0
1668337680173,ECE 200,021,103606,Lin; Bill,9999,0,9999,0
1668337680173,ECE 200,022,103607,Liu; Zhaowei,9998,0,9999,1
1668337680173,ECE 200,023,103608,Lo; Yu-Hwa,9999,0,9999,0
1668337680173,ECE 200,024,103609,Lomakin; Vitaliy,9999,0,9999,0
1668337680173,ECE 200,025,103610,Mercier; Patrick Philip,9999,0,9999,0
1668337680173,ECE 200,026,103611,Meyer; Florian,9999,0,9999,0
1668337680173,ECE 200,027,103612,Milstein; Laurence B.,9999,0,9999,0
1668337680173,ECE 200,028,103613,Mir Arabbaygi; Siavash,9999,0,9999,0
1668337680173,ECE 200,029,103614,Mookherjea; Shayan,9999,0,9999,0
1668337680173,ECE 200,030,103615,Morris; Karcher William,9999,0,9999,0
1668337680173,ECE 200,031,103616,Ng; Tse Nga,9999,0,9999,0
1668337680173,ECE 200,032,103617,Nguyen; Truong Quang,9999,0,9999,0
1668337680173,ECE 200,033,103618,Nomura; Kenji,9999,0,9999,0
1668337680173,ECE 200,034,103619,Orlitsky; Alon,9999,0,9999,0
1668337680173,ECE 200,035,103620,Pal; Piya,9999,0,9999,0
1668337680173,ECE 200,036,103621,Papen; George C.,9999,0,9999,0
1668337680173,ECE 200,037,103622,Radic; Stojan,9999,0,9999,0
1668337680173,ECE 200,038,103623,Rao; Bhaskar D.,9999,0,9999,0
1668337680173,ECE 200,039,103624,Rao; Ramesh R,9999,0,9999,0
1668337680173,ECE 200,040,103625,Rebeiz; Gabriel,9999,0,9999,0
1668337680173,ECE 200,041,103626,Sanford; John R,9999,0,9999,0
1668337680173,ECE 200,042,103627,Siegel; Paul H.,9999,0,9999,0
1668337680173,ECE 200,043,103628,Sievenpiper; Daniel F.,9999,0,9999,0
1668337680173,ECE 200,044,103629,Sworder; David D.,9999,0,9999,0
1668337680173,ECE 200,045,103630,Taur; Yuan,9999,0,9999,0
1668337680173,ECE 200,046,103631,Touri; Behrouz,9999,0,9999,0
1668337680173,ECE 200,047,103632,Trivedi; Mohan M.,9999,0,9999,0
1668337680173,ECE 200,048,103633,Vasconcelos; Nuno,9999,0,9999,0
1668337680173,ECE 200,049,103634,Wang; Xiaolong,9999,0,9999,0
1668337680173,ECE 200,050,103635,Xie; Pengtao,9999,0,9999,0
1668337680173,ECE 200,051,103636,Yip; Michael,9999,0,9999,0
1668337680173,ECE 200,052,103637,Zeger; Kenneth A.,999,0,999,0
1668337680173,ECE 200,053,103638,Zhang; Xinyu,9999,0,9999,0
1668337680173,ECE 200,054,103639,Turakhia; Yatish Girish,9999,0,9999,0
1668337680173,ECE 200,055,103640,Kang; Mingu,9999,0,9999,0
1668337680173,ECE 200,056,103641,Shi; Yuanyuan,9999,0,9999,0
1668337680173,ECE 200,057,103642,Wang; Edward Jay,9999,0,9999,0
1668337680173,ECE 200,058,103643,Zheng; Yang,9999,0,9999,0
1668337680596,ECE 202,A00,103644,Kuzum; Duygu,0,0,0,0
1668337681020,ECE 212BN,A00,103646,Ng; Tse Nga,0,0,0,0
1668337681447,ECE 221,A00,111493,Staff,0,0,0,0
1668337681873,ECE 222B,A00,103647,Lomakin; Vitaliy,0,0,0,0
1668337682301,ECE 230B,A00,103648,Taur; Yuan,0,0,0,0
1668337682729,ECE 238B,A00,103649,Garay; Javier,0,0,0,0
1668337683153,ECE 240B,A00,112900,Fainman; Yeshaiahu,0,0,0,0
1668337683578,ECE 247A,A00,103650,Jokerst; Jesse Vincent,0,0,0,0
1668337684005,ECE 247B,A00,103651,Wang; Joseph,0,0,0,0
1668337684433,ECE 250,A00,103652,Siegel; Paul H.,0,0,0,0
1668337684857,ECE 251A,A00,103654,Rao; Bhaskar D.,0,0,0,0
1668337685289,ECE 257B,A00,103655,Bharadia; Dinesh,0,0,0,0
1668337685716,ECE 258A,A00,103656,Milstein; Laurence B.,0,0,0,0
1668337686145,ECE 260B,A00,103658,Kang; Mingu,0,0,0,0
1668337686571,ECE 264A,A00,103659,Galton; Ian A,0,0,0,0
1668337686995,ECE 265A,A00,103661,Gudem; Prasad S.S.,0,0,0,0
1668337687420,ECE 265D,A00,103662,Gudem; Prasad S.S.,0,0,0,0
1668337687843,ECE 268,A00,103663,Koushanfar; Farinaz,0,0,0,0
1668337688270,ECE 269,A01,103665,Pal; Piya,0,0,0,0
1668337688697,ECE 271B,A00,103666,Vasconcelos; Manuela,0,0,0,0
1668337689121,ECE 276A,A00,103667,Atanasov; Nikolay A.,0,0,0,0
1668337689546,ECE 277,A00,103668,An; Cheolhong,0,0,0,0
1668337689970,ECE 279,A00,117947,Hall; Drew A.,0,0,0,0
1668337690821,ECE 283,A00,103670,Hsueh; Tzu-Chien,0,0,0,0
1668337691245,ECE 284,A00,103671,Turakhia; Yatish Girish,0,0,0,0
1668337691669,ECE 285,A00,103672,Zheng; Yang,0,0,0,0
1668337691669,ECE 285,B00,103673,Sworder; David D.,0,0,0,0
1668337692097,ECE 287,A00,103676,Javidi; Tara,0,0,0,0
1668337692531,MATH 200B,A00,098023,Salehi Golsefidy; Alireza,12,0,15,3
1668337692955,MATH 202B,A00,098024,Rhoades; Brendon Patrick,9,0,15,6
1668337693379,MATH 203B,A00,098025,Oprea; Dragos N.,10,0,15,5
1668337693802,MATH 204B,A00,098026,Sorensen; Claus M,13,0,15,2
1668337694228,MATH 208,A00,098027,Izadi; Elham,7,0,10,3
1668337694654,MATH 209,A00,098028,Pollack; Aaron,10,0,10,0
1668337695077,MATH 211A,A00,112919,Rogalski; Daniel,9,0,10,1
1668337695503,MATH 211B,A00,112920,Seward; Brandon M.,9,0,10,1
1668337695927,MATH 218,A00,098029,Li; Bo,10,0,10,0
1668337696355,MATH 220B,A00,098030,Novak; Jonathan I,11,0,15,4
1668337696781,MATH 221A,A00,098031,Ebenfelt; Peter F,13,0,15,2
1668337697204,MATH 231B,A00,098032,Zlatos; Andrej,12,0,15,3
1668337697634,MATH 240B,A00,098033,Ni; Lei,9,0,15,6
1668337698059,MATH 243,A00,098034,Jekel; David Andrew,10,0,10,0
1668337698485,MATH 245A,A00,098035,Nie; Jiawang,0,0,15,16
1668337698911,MATH 248,A00,098036,Bejenaru; Ioan,10,0,10,0
1668337699335,MATH 250B,A00,098037,Spolaor; Luca,14,0,15,1
1668337699760,MATH 258,A00,098038,Ni; Lei,10,0,10,0
1668337700185,MATH 264B,A00,098041,Rhoades; Brendon Patrick,9,0,15,6
1668337700613,MATH 268,A00,098042,Buss; Samuel R,10,0,10,0
1668337701038,MATH 269,A00,098043,Rhoades; Brendon Patrick,10,0,10,0
1668337701460,MATH 270B,A00,098044,Li; Bo,10,0,15,5
1668337701885,MATH 272B,A00,098045,Holst; Michael J,13,0,15,2
1668337702308,MATH 273A,A00,098046,Tian; Xiaochuan,10,0,15,5
1668337702732,MATH 275,A01,098048,Tian; Xiaochuan,6,0,10,4
1668337703157,MATH 278A,A00,098049,Holst; Michael J,8,0,10,2
1668337703586,MATH 278B,A00,098050,Cloninger; Alexander,10,0,10,0
1668337704011,MATH 278C,A00,098051,Nie; Jiawang,7,0,10,3
1668337704434,MATH 280B,A00,098052,Zheng; Tianyi,8,0,15,7
1668337704858,MATH 281B,A00,098053,Bradic; Jelena,1,0,15,14
1668337705283,MATH 282B,A00,098054,Arias-Castro; Ery,0,0,15,15
1668337705707,MATH 285,A00,098055,Fitzsimmons; Patrick J,0,0,15,17
1668337706134,MATH 287B,A00,098056,Arias-Castro; Ery,2,0,15,13
1668337706558,MATH 288,A00,098057,Agarwal; Pooja,9,0,10,1
1668337706558,MATH 288,B00,098058,Zhang; Danna,8,0,10,2
1668337706558,MATH 288,C00,098059,Williams; Ruth J,9,0,10,1
1668337706984,MATH 290B,A00,098060,Roberts; Justin Deritter,13,0,15,2
1668337707409,MATH 292,A00,098061,Belmont; Eva Kinoshita,10,0,10,0
1668337707835,MATH 295,A00,098062,Suk; Andrew Hoon,48,0,50,2
1668337708260,MATH 296,A00,098063,Novak; Jonathan I,20,0,20,0
1668337708773,MATH 297,001,098064,Gamst; Anthony Collins,9997,0,9999,2
1668338209130,COGS 205,A00,101395,Chiba; Andrea,19,0,20,1
1668338209556,COGS 210B,001,101404,Greene; Deanna Jacquelyn,9998,0,9999,1
1668338209556,COGS 210B,002,101417,Xia; Haijun,9999,0,9999,0
1668338209556,COGS 210B,003,101422,Nitz; Douglas A.,9999,0,9999,0
1668338209556,COGS 210B,004,101423,Hollan; James D.,9998,0,9999,1
1668338209556,COGS 210B,005,101424,Deak; Gedeon O.,9998,0,9999,1
1668338209556,COGS 210B,006,101425,Rossano; Federico,9999,0,9999,0
1668338209981,COGS 211B,A00,101427,Coulson; Seana M,9996,0,9999,3
1668338210405,COGS 220,A00,101428,Hollan; James D.,0,0,25,25
1668338210832,COGS 229,A00,101429,Dow; Steven P,18,0,25,7
1668338211259,COGS 230,A00,101430,Klemmer; Scott R,11,0,17,6
1668338211687,COGS 234,A00,101431,Xia; Haijun,1,0,25,24
1668338212112,COGS 260,A00,101432,Kiyonaga; Anastasia,21,0,25,4
1668338212112,COGS 260,B00,101433,Kirsh; David Joel,15,0,25,10
1668338212541,CSE 202,A00,102371,Impagliazzo; Russell,0,0,0,0
1668338212965,CSE 203B,A01,102373,Cheng; Chung Kuan,0,0,0,0
1668338213394,CSE 208,A00,102374,Micciancio; Daniele,0,0,0,0
1668338213820,CSE 209A,A00,112895,Impagliazzo; Russell,0,0,15,15
1668338214247,CSE 209B,A00,108005,Bellare; Mihir,0,0,0,0
1668338214677,CSE 210,A00,113163,Coblenz; Michael J,0,0,0,0
1668338215102,CSE 219,A00,106111,Dow; Steven P,0,0,20,20
1668338215541,CSE 221,A00,102376,Voelker; Geoffrey M.,0,0,0,0
1668338215971,CSE 224,A01,102378,Porter; George M,0,0,0,0
1668338216396,CSE 229A,A00,102379,Savage; Stefan,0,0,0,0
1668338216825,CSE 229C,A00,102380,Munyaka; Imani N. S.,0,0,0,0
1668338217249,CSE 232B,A00,102382,Deutsch; Alin Bernard,0,0,0,0
1668338217676,CSE 234,A01,112904,Kumar; Arun Kumar,0,0,0,0
1668338218101,CSE 237A,A00,102383,Rosing; Tajana Simunic,0,0,0,0
1668338218529,CSE 239A,A00,102384,Deutsch; Alin Bernard,0,0,0,0
1668338218957,CSE 239B,A00,102385,Polikarpova; Nadezhda,0,0,0,0
1668338219384,CSE 240A,A00,102386,Pannuto; Patrick William,0,0,0,0
1668338219810,CSE 240B,A00,102387,Zhao; Jishen,0,0,0,0
1668338220233,CSE 241A,A00,106406,Kang; Mingu,0,0,0,0
1668338220657,CSE 249B,A00,102388,Kahng; Andrew Byun,0,0,8,8
1668338221083,CSE 251B,A01,102392,Cottrell; Garrison W,0,0,0,0
1668338221083,CSE 251B,A02,102393,Cottrell; Garrison W,0,0,0,0
1668338221508,CSE 252B,A00,102394,Ochoa; Benjamin Lawrence,0,0,0,0
1668338221936,CSE 257,A01,102396,Gao; Sicun,0,0,0,0
1668338222362,CSE 272,A00,102397,Li; Tzumao,0,0,0,0
1668338222786,CSE 274,A00,111323,Chern; Albert Ren-Haur,0,0,0,0
1668338223210,CSE 282,A00,102398,Pevzner; Pavel Arkadjevich,0,0,0,0
1668338223632,CSE 284,A00,114175,Gymrek; Melissa Ann,0,0,0,0
1668338224062,CSE 290,A00,102399,Chandraker; Manmohan Krishna,0,0,0,0
1668338224062,CSE 290,B00,102400,Vaccaro; Kristen Marie,0,0,25,25
1668338224062,CSE 290,C00,102414,Pannuto; Patrick William,0,0,25,25
1668338224062,CSE 290,D00,102427,Pevzner; Pavel Arkadjevich,0,0,0,0
1668338224062,CSE 290,E00,102429,Zhao; Jishen,0,0,0,0
1668338224062,CSE 290,F00,102436,Tullsen; Dean Michael,0,0,0,0
1668338224062,CSE 290,G00,102440,Christensen; Henrik I,0,0,20,20
1668338224487,CSE 291,A00,102443,Su; Hao,0,0,0,0
1668338224487,CSE 291,B00,102448,Polikarpova; Nadezhda,0,0,0,0
1668338224487,CSE 291,C00,102453,Vaccaro; Kristen Marie,0,0,0,0
1668338224487,CSE 291,D00,111343,Savage; Stefan,0,0,0,0
1668338224487,CSE 291,E00,116474,Claffy; Kimberly Claire,0,0,0,0
1668338224487,CSE 291,F00,116479,Pasquale; Joseph,0,0,0,0
1668338224926,CSE 293,001,119111,Bafna; Vineet,9999,0,9999,0
1668338224926,CSE 293,002,119118,Bellare; Mihir,9999,0,9999,0
1668338224926,CSE 293,003,119122,Berg-Kirkpatrick; Taylor D,9999,0,9999,0
1668338224926,CSE 293,004,119135,Christensen; Henrik I,9999,0,9999,0
1668338224926,CSE 293,005,119142,Cottrell; Garrison W,9999,0,9999,0
1668338224926,CSE 293,006,119146,Deutsch; Alin Bernard,9999,0,9999,0
1668338224926,CSE 293,007,119159,Esmaeilzadeh; Hadi,9999,0,9999,0
1668338224926,CSE 293,008,119166,Freund; Yoav,9999,0,9999,0
1668338224926,CSE 293,009,119170,Griswold; William G.,9999,0,9999,0
1668338224926,CSE 293,010,119183,Gymrek; Melissa Ann,9999,0,9999,0
1668338224926,CSE 293,011,119190,Heninger; Nadia A,9999,0,9999,0
1668338224926,CSE 293,012,119230,Impagliazzo; Russell,9999,0,9999,0
1668338224926,CSE 293,013,119232,Jhala; Ranjit,9999,0,9999,0
1668338224926,CSE 293,014,119233,Kahng; Andrew Byun,9999,0,9999,0
1668338224926,CSE 293,015,119298,Kane; Daniel Mertz,9999,0,9999,0
1668338224926,CSE 293,016,119299,Kriegman; David J,9999,0,9999,0
1668338224926,CSE 293,017,119300,Kumar; Arun Kumar,9999,0,9999,0
1668338224926,CSE 293,018,119301,Lerner; Sorin,9999,0,9999,0
1668338224926,CSE 293,019,119302,Lovett; Shachar,9999,0,9999,0
1668338224926,CSE 293,020,119303,McAuley; Julian John,9999,0,9999,0
1668338224926,CSE 293,021,119304,Micciancio; Daniele,9999,0,9999,0
1668338224926,CSE 293,022,119367,Orailoglu; Alex,9999,0,9999,0
1668338224926,CSE 293,023,119382,Paturi; Ramamohan,9999,0,9999,0
1668338224926,CSE 293,024,119404,Polikarpova; Nadezhda,9999,0,9999,0
1668338224926,CSE 293,025,119406,Politz; Joseph Gibbs,9999,0,9999,0
1668338224926,CSE 293,026,119411,Porter; George M,9999,0,9999,0
1668338224926,CSE 293,027,119414,Porter; Leonard Emerson,9999,0,9999,0
1668338224926,CSE 293,028,119416,Ramamoorthi; Ravi,9999,0,9999,0
1668338224926,CSE 293,029,119417,Sahoo; Debashis,9999,0,9999,0
1668338224926,CSE 293,030,119420,Saul; Lawrence,9999,0,9999,0
1668338224926,CSE 293,031,119421,Savage; Stefan,9999,0,9999,0
1668338224926,CSE 293,032,119425,Schulze; Jurgen P.,9999,0,9999,0
1668338224926,CSE 293,033,119426,Snoeren; Alex C.,9999,0,9999,0
1668338224926,CSE 293,034,119428,Shang; Jingbo,9999,0,9999,0
1668338224926,CSE 293,035,119430,Stefan; Deian,9999,0,9999,0
1668338224926,CSE 293,036,119431,Su; Hao,9999,0,9999,0
1668338224926,CSE 293,037,119433,Swanson; Steven James,9999,0,9999,0
1668338224926,CSE 293,038,119435,Tullsen; Dean Michael,9999,0,9999,0
1668338224926,CSE 293,039,119483,Voelker; Geoffrey M.,9999,0,9999,0
1668338224926,CSE 293,040,119537,Zhao; Jishen,9999,0,9999,0
1668338224926,CSE 293,041,119538,Zhou; Yuan-Yuan,9999,0,9999,0
1668338224926,CSE 293,042,119539,Gao; Sicun,9999,0,9999,0
1668338224926,CSE 293,043,119540,Weibel; Nadir,9999,0,9999,0
1668338224926,CSE 293,044,119541,Gupta; Rajesh K.,9999,0,9999,0
1668338224926,CSE 293,045,126410,Vaccaro; Kristen Marie,9999,0,9999,0
1668338224926,CSE 293,046,126411,Klemke; Richard,9999,0,9999,0
1668338225352,CSE 294,A00,102459,Voelker; Geoffrey M.,0,0,0,0
1668338225352,CSE 294,B00,111322,Orailoglu; Alex,0,0,0,0
1668338225781,DSE 201,A00,096914,Deutsch; Alin Bernard,30,0,30,0
1668338226206,DSE 210,A00,096915,Dasgupta; Sanjoy,30,0,30,0
1668338226631,DSE 260A,A00,096916,Altintas De Callaf; Ilkay,30,0,30,0
1668338227083,ECE 200,001,103586,Antipa; Nicholas A,9999,0,9999,0
1668338227083,ECE 200,002,103587,Atanasov; Nikolay A.,9999,0,9999,0
1668338227083,ECE 200,003,103588,Bharadia; Dinesh,9999,0,9999,0
1668338227083,ECE 200,004,103589,Cheng; Chung Kuan,9999,0,9999,0
1668338227083,ECE 200,005,103590,Cosman; Pamela C.,9999,0,9999,0
1668338227083,ECE 200,006,103591,Dayeh; Shadi Ahmad,9999,0,9999,0
1668338227083,ECE 200,007,103592,Fainman; Yeshaiahu,9999,0,9999,0
1668338227083,ECE 200,008,103593,Ford; Joseph Earl,9999,0,9999,0
1668338227083,ECE 200,009,103594,Franceschetti; Massimo,9999,0,9999,0
1668338227083,ECE 200,010,103595,Fullerton; Eric E,9999,0,9999,0
1668338227083,ECE 200,011,103596,Galton; Ian A,9999,0,9999,0
1668338227083,ECE 200,012,103597,Gilja; Vikash,9999,0,9999,0
1668338227083,ECE 200,013,103598,Hall; Drew A.,9999,0,9999,0
1668338227083,ECE 200,014,103599,Hsueh; Tzu-Chien,9999,0,9999,0
1668338227083,ECE 200,015,103600,Javidi; Tara,9999,0,9999,0
1668338227083,ECE 200,016,103601,Kahng; Andrew Byun,9999,0,9999,0
1668338227083,ECE 200,017,103602,Kim; Young-Han,9999,0,9999,0
1668338227083,ECE 200,018,103603,Koushanfar; Farinaz,9999,0,9999,0
1668338227083,ECE 200,019,103604,Kuzum; Duygu,9999,0,9999,0
1668338227083,ECE 200,020,103605,Le; Hanh-Phuc,9999,0,9999,0
1668338227083,ECE 200,021,103606,Lin; Bill,9999,0,9999,0
1668338227083,ECE 200,022,103607,Liu; Zhaowei,9998,0,9999,1
1668338227083,ECE 200,023,103608,Lo; Yu-Hwa,9999,0,9999,0
1668338227083,ECE 200,024,103609,Lomakin; Vitaliy,9999,0,9999,0
1668338227083,ECE 200,025,103610,Mercier; Patrick Philip,9999,0,9999,0
1668338227083,ECE 200,026,103611,Meyer; Florian,9999,0,9999,0
1668338227083,ECE 200,027,103612,Milstein; Laurence B.,9999,0,9999,0
1668338227083,ECE 200,028,103613,Mir Arabbaygi; Siavash,9999,0,9999,0
1668338227083,ECE 200,029,103614,Mookherjea; Shayan,9999,0,9999,0
1668338227083,ECE 200,030,103615,Morris; Karcher William,9999,0,9999,0
1668338227083,ECE 200,031,103616,Ng; Tse Nga,9999,0,9999,0
1668338227083,ECE 200,032,103617,Nguyen; Truong Quang,9999,0,9999,0
1668338227083,ECE 200,033,103618,Nomura; Kenji,9999,0,9999,0
1668338227083,ECE 200,034,103619,Orlitsky; Alon,9999,0,9999,0
1668338227083,ECE 200,035,103620,Pal; Piya,9999,0,9999,0
1668338227083,ECE 200,036,103621,Papen; George C.,9999,0,9999,0
1668338227083,ECE 200,037,103622,Radic; Stojan,9999,0,9999,0
1668338227083,ECE 200,038,103623,Rao; Bhaskar D.,9999,0,9999,0
1668338227083,ECE 200,039,103624,Rao; Ramesh R,9999,0,9999,0
1668338227083,ECE 200,040,103625,Rebeiz; Gabriel,9999,0,9999,0
1668338227083,ECE 200,041,103626,Sanford; John R,9999,0,9999,0
1668338227083,ECE 200,042,103627,Siegel; Paul H.,9999,0,9999,0
1668338227083,ECE 200,043,103628,Sievenpiper; Daniel F.,9999,0,9999,0
1668338227083,ECE 200,044,103629,Sworder; David D.,9999,0,9999,0
1668338227083,ECE 200,045,103630,Taur; Yuan,9999,0,9999,0
1668338227083,ECE 200,046,103631,Touri; Behrouz,9999,0,9999,0
1668338227083,ECE 200,047,103632,Trivedi; Mohan M.,9999,0,9999,0
1668338227083,ECE 200,048,103633,Vasconcelos; Nuno,9999,0,9999,0
1668338227083,ECE 200,049,103634,Wang; Xiaolong,9999,0,9999,0
1668338227083,ECE 200,050,103635,Xie; Pengtao,9999,0,9999,0
1668338227083,ECE 200,051,103636,Yip; Michael,9999,0,9999,0
1668338227083,ECE 200,052,103637,Zeger; Kenneth A.,999,0,999,0
1668338227083,ECE 200,053,103638,Zhang; Xinyu,9999,0,9999,0
1668338227083,ECE 200,054,103639,Turakhia; Yatish Girish,9999,0,9999,0
1668338227083,ECE 200,055,103640,Kang; Mingu,9999,0,9999,0
1668338227083,ECE 200,056,103641,Shi; Yuanyuan,9999,0,9999,0
1668338227083,ECE 200,057,103642,Wang; Edward Jay,9999,0,9999,0
1668338227083,ECE 200,058,103643,Zheng; Yang,9999,0,9999,0
1668338227509,ECE 202,A00,103644,Kuzum; Duygu,0,0,0,0
1668338227937,ECE 212BN,A00,103646,Ng; Tse Nga,0,0,0,0
1668338228363,ECE 221,A00,111493,Staff,0,0,0,0
1668338228791,ECE 222B,A00,103647,Lomakin; Vitaliy,0,0,0,0
1668338229306,ECE 230B,A00,103648,Taur; Yuan,0,0,0,0
1668338229731,ECE 238B,A00,103649,Garay; Javier,0,0,0,0
1668338230161,ECE 240B,A00,112900,Fainman; Yeshaiahu,0,0,0,0
1668338230585,ECE 247A,A00,103650,Jokerst; Jesse Vincent,0,0,0,0
1668338231011,ECE 247B,A00,103651,Wang; Joseph,0,0,0,0
1668338231440,ECE 250,A00,103652,Siegel; Paul H.,0,0,0,0
1668338231867,ECE 251A,A00,103654,Rao; Bhaskar D.,0,0,0,0
1668338232294,ECE 257B,A00,103655,Bharadia; Dinesh,0,0,0,0
1668338232719,ECE 258A,A00,103656,Milstein; Laurence B.,0,0,0,0
1668338233143,ECE 260B,A00,103658,Kang; Mingu,0,0,0,0
1668338233571,ECE 264A,A00,103659,Galton; Ian A,0,0,0,0
1668338233994,ECE 265A,A00,103661,Gudem; Prasad S.S.,0,0,0,0
1668338234421,ECE 265D,A00,103662,Gudem; Prasad S.S.,0,0,0,0
1668338234846,ECE 268,A00,103663,Koushanfar; Farinaz,0,0,0,0
1668338235272,ECE 269,A01,103665,Pal; Piya,0,0,0,0
1668338235694,ECE 271B,A00,103666,Vasconcelos; Manuela,0,0,0,0
1668338236122,ECE 276A,A00,103667,Atanasov; Nikolay A.,0,0,0,0
1668338236558,ECE 277,A00,103668,An; Cheolhong,0,0,0,0
1668338236992,ECE 279,A00,117947,Hall; Drew A.,0,0,0,0
1668338237843,ECE 283,A00,103670,Hsueh; Tzu-Chien,0,0,0,0
1668338238272,ECE 284,A00,103671,Turakhia; Yatish Girish,0,0,0,0
1668338238700,ECE 285,A00,103672,Zheng; Yang,0,0,0,0
1668338238700,ECE 285,B00,103673,Sworder; David D.,0,0,0,0
1668338239126,ECE 287,A00,103676,Javidi; Tara,0,0,0,0
1668338239554,MATH 200B,A00,098023,Salehi Golsefidy; Alireza,12,0,15,3
1668338239977,MATH 202B,A00,098024,Rhoades; Brendon Patrick,9,0,15,6
1668338240402,MATH 203B,A00,098025,Oprea; Dragos N.,10,0,15,5
1668338240829,MATH 204B,A00,098026,Sorensen; Claus M,13,0,15,2
1668338241253,MATH 208,A00,098027,Izadi; Elham,7,0,10,3
1668338241674,MATH 209,A00,098028,Pollack; Aaron,10,0,10,0
1668338242111,MATH 211A,A00,112919,Rogalski; Daniel,9,0,10,1
1668338242534,MATH 211B,A00,112920,Seward; Brandon M.,9,0,10,1
1668338242958,MATH 218,A00,098029,Li; Bo,10,0,10,0
1668338243387,MATH 220B,A00,098030,Novak; Jonathan I,11,0,15,4
1668338243817,MATH 221A,A00,098031,Ebenfelt; Peter F,13,0,15,2
1668338244240,MATH 231B,A00,098032,Zlatos; Andrej,12,0,15,3
1668338244667,MATH 240B,A00,098033,Ni; Lei,9,0,15,6
1668338245090,MATH 243,A00,098034,Jekel; David Andrew,10,0,10,0
1668338245515,MATH 245A,A00,098035,Nie; Jiawang,0,0,15,16
1668338245940,MATH 248,A00,098036,Bejenaru; Ioan,10,0,10,0
1668338246371,MATH 250B,A00,098037,Spolaor; Luca,14,0,15,1
1668338246796,MATH 258,A00,098038,Ni; Lei,10,0,10,0
1668338247218,MATH 264B,A00,098041,Rhoades; Brendon Patrick,9,0,15,6
1668338247642,MATH 268,A00,098042,Buss; Samuel R,10,0,10,0
1668338248072,MATH 269,A00,098043,Rhoades; Brendon Patrick,10,0,10,0
1668338248495,MATH 270B,A00,098044,Li; Bo,10,0,15,5
1668338248922,MATH 272B,A00,098045,Holst; Michael J,13,0,15,2
1668338249346,MATH 273A,A00,098046,Tian; Xiaochuan,10,0,15,5
1668338249773,MATH 275,A01,098048,Tian; Xiaochuan,6,0,10,4
1668338250198,MATH 278A,A00,098049,Holst; Michael J,8,0,10,2
1668338250626,MATH 278B,A00,098050,Cloninger; Alexander,10,0,10,0
1668338251049,MATH 278C,A00,098051,Nie; Jiawang,7,0,10,3
1668338251473,MATH 280B,A00,098052,Zheng; Tianyi,8,0,15,7
1668338251898,MATH 281B,A00,098053,Bradic; Jelena,1,0,15,14
1668338252325,MATH 282B,A00,098054,Arias-Castro; Ery,0,0,15,15
1668338252752,MATH 285,A00,098055,Fitzsimmons; Patrick J,0,0,15,17
1668338253176,MATH 287B,A00,098056,Arias-Castro; Ery,2,0,15,13
1668338253601,MATH 288,A00,098057,Agarwal; Pooja,9,0,10,1
1668338253601,MATH 288,B00,098058,Zhang; Danna,8,0,10,2
1668338253601,MATH 288,C00,098059,Williams; Ruth J,9,0,10,1
1668338254024,MATH 290B,A00,098060,Roberts; Justin Deritter,13,0,15,2
1668338254453,MATH 292,A00,098061,Belmont; Eva Kinoshita,10,0,10,0
1668338254881,MATH 295,A00,098062,Suk; Andrew Hoon,48,0,50,2
1668338255305,MATH 296,A00,098063,Novak; Jonathan I,20,0,20,0
1668338255732,MATH 297,001,098064,Gamst; Anthony Collins,9997,0,9999,2
1668338755577,COGS 205,A00,101395,Chiba; Andrea,19,0,20,1
1668338756017,COGS 210B,001,101404,Greene; Deanna Jacquelyn,9998,0,9999,1
1668338756017,COGS 210B,002,101417,Xia; Haijun,9999,0,9999,0
1668338756017,COGS 210B,003,101422,Nitz; Douglas A.,9999,0,9999,0
1668338756017,COGS 210B,004,101423,Hollan; James D.,9998,0,9999,1
1668338756017,COGS 210B,005,101424,Deak; Gedeon O.,9998,0,9999,1
1668338756017,COGS 210B,006,101425,Rossano; Federico,9999,0,9999,0
1668338756445,COGS 211B,A00,101427,Coulson; Seana M,9996,0,9999,3
1668338756871,COGS 220,A00,101428,Hollan; James D.,0,0,25,25
1668338757298,COGS 229,A00,101429,Dow; Steven P,18,0,25,7
1668338757724,COGS 230,A00,101430,Klemmer; Scott R,11,0,17,6
1668338758149,COGS 234,A00,101431,Xia; Haijun,1,0,25,24
1668338758574,COGS 260,A00,101432,Kiyonaga; Anastasia,21,0,25,4
1668338758574,COGS 260,B00,101433,Kirsh; David Joel,15,0,25,10
1668338758998,CSE 202,A00,102371,Impagliazzo; Russell,0,0,0,0
1668338759430,CSE 203B,A01,102373,Cheng; Chung Kuan,0,0,0,0
1668338759854,CSE 208,A00,102374,Micciancio; Daniele,0,0,0,0
1668338760282,CSE 209A,A00,112895,Impagliazzo; Russell,0,0,15,15
1668338760708,CSE 209B,A00,108005,Bellare; Mihir,0,0,0,0
1668338761132,CSE 210,A00,113163,Coblenz; Michael J,0,0,0,0
1668338761557,CSE 219,A00,106111,Dow; Steven P,0,0,20,20
1668338761982,CSE 221,A00,102376,Voelker; Geoffrey M.,0,0,0,0
1668338762411,CSE 224,A01,102378,Porter; George M,0,0,0,0
1668338762835,CSE 229A,A00,102379,Savage; Stefan,0,0,0,0
1668338763259,CSE 229C,A00,102380,Munyaka; Imani N. S.,0,0,0,0
1668338763688,CSE 232B,A00,102382,Deutsch; Alin Bernard,0,0,0,0
1668338764116,CSE 234,A01,112904,Kumar; Arun Kumar,0,0,0,0
1668338764541,CSE 237A,A00,102383,Rosing; Tajana Simunic,0,0,0,0
1668338764965,CSE 239A,A00,102384,Deutsch; Alin Bernard,0,0,0,0
1668338765389,CSE 239B,A00,102385,Polikarpova; Nadezhda,0,0,0,0
1668338765815,CSE 240A,A00,102386,Pannuto; Patrick William,0,0,0,0
1668338766242,CSE 240B,A00,102387,Zhao; Jishen,0,0,0,0
1668338766667,CSE 241A,A00,106406,Kang; Mingu,0,0,0,0
1668338767096,CSE 249B,A00,102388,Kahng; Andrew Byun,0,0,8,8
1668338767519,CSE 251B,A01,102392,Cottrell; Garrison W,0,0,0,0
1668338767519,CSE 251B,A02,102393,Cottrell; Garrison W,0,0,0,0
1668338767943,CSE 252B,A00,102394,Ochoa; Benjamin Lawrence,0,0,0,0
1668338768382,CSE 257,A01,102396,Gao; Sicun,0,0,0,0
1668338768808,CSE 272,A00,102397,Li; Tzumao,0,0,0,0
1668338769231,CSE 274,A00,111323,Chern; Albert Ren-Haur,0,0,0,0
1668338769658,CSE 282,A00,102398,Pevzner; Pavel Arkadjevich,0,0,0,0
1668338770083,CSE 284,A00,114175,Gymrek; Melissa Ann,0,0,0,0
1668338770508,CSE 290,A00,102399,Chandraker; Manmohan Krishna,0,0,0,0
1668338770508,CSE 290,B00,102400,Vaccaro; Kristen Marie,0,0,25,25
1668338770508,CSE 290,C00,102414,Pannuto; Patrick William,0,0,25,25
1668338770508,CSE 290,D00,102427,Pevzner; Pavel Arkadjevich,0,0,0,0
1668338770508,CSE 290,E00,102429,Zhao; Jishen,0,0,0,0
1668338770508,CSE 290,F00,102436,Tullsen; Dean Michael,0,0,0,0
1668338770508,CSE 290,G00,102440,Christensen; Henrik I,0,0,20,20
1668338770941,CSE 291,A00,102443,Su; Hao,0,0,0,0
1668338770941,CSE 291,B00,102448,Polikarpova; Nadezhda,0,0,0,0
1668338770941,CSE 291,C00,102453,Vaccaro; Kristen Marie,0,0,0,0
1668338770941,CSE 291,D00,111343,Savage; Stefan,0,0,0,0
1668338770941,CSE 291,E00,116474,Claffy; Kimberly Claire,0,0,0,0
1668338770941,CSE 291,F00,116479,Pasquale; Joseph,0,0,0,0
1668338771380,CSE 293,001,119111,Bafna; Vineet,9999,0,9999,0
1668338771380,CSE 293,002,119118,Bellare; Mihir,9999,0,9999,0
1668338771380,CSE 293,003,119122,Berg-Kirkpatrick; Taylor D,9999,0,9999,0
1668338771380,CSE 293,004,119135,Christensen; Henrik I,9999,0,9999,0
1668338771380,CSE 293,005,119142,Cottrell; Garrison W,9999,0,9999,0
1668338771380,CSE 293,006,119146,Deutsch; Alin Bernard,9999,0,9999,0
1668338771380,CSE 293,007,119159,Esmaeilzadeh; Hadi,9999,0,9999,0
1668338771380,CSE 293,008,119166,Freund; Yoav,9999,0,9999,0
1668338771380,CSE 293,009,119170,Griswold; William G.,9999,0,9999,0
1668338771380,CSE 293,010,119183,Gymrek; Melissa Ann,9999,0,9999,0
1668338771380,CSE 293,011,119190,Heninger; Nadia A,9999,0,9999,0
1668338771380,CSE 293,012,119230,Impagliazzo; Russell,9999,0,9999,0
1668338771380,CSE 293,013,119232,Jhala; Ranjit,9999,0,9999,0
1668338771380,CSE 293,014,119233,Kahng; Andrew Byun,9999,0,9999,0
1668338771380,CSE 293,015,119298,Kane; Daniel Mertz,9999,0,9999,0
1668338771380,CSE 293,016,119299,Kriegman; David J,9999,0,9999,0
1668338771380,CSE 293,017,119300,Kumar; Arun Kumar,9999,0,9999,0
1668338771380,CSE 293,018,119301,Lerner; Sorin,9999,0,9999,0
1668338771380,CSE 293,019,119302,Lovett; Shachar,9999,0,9999,0
1668338771380,CSE 293,020,119303,McAuley; Julian John,9999,0,9999,0
1668338771380,CSE 293,021,119304,Micciancio; Daniele,9999,0,9999,0
1668338771380,CSE 293,022,119367,Orailoglu; Alex,9999,0,9999,0
1668338771380,CSE 293,023,119382,Paturi; Ramamohan,9999,0,9999,0
1668338771380,CSE 293,024,119404,Polikarpova; Nadezhda,9999,0,9999,0
1668338771380,CSE 293,025,119406,Politz; Joseph Gibbs,9999,0,9999,0
1668338771380,CSE 293,026,119411,Porter; George M,9999,0,9999,0
1668338771380,CSE 293,027,119414,Porter; Leonard Emerson,9999,0,9999,0
1668338771380,CSE 293,028,119416,Ramamoorthi; Ravi,9999,0,9999,0
1668338771380,CSE 293,029,119417,Sahoo; Debashis,9999,0,9999,0
1668338771380,CSE 293,030,119420,Saul; Lawrence,9999,0,9999,0
1668338771380,CSE 293,031,119421,Savage; Stefan,9999,0,9999,0
1668338771380,CSE 293,032,119425,Schulze; Jurgen P.,9999,0,9999,0
1668338771380,CSE 293,033,119426,Snoeren; Alex C.,9999,0,9999,0
1668338771380,CSE 293,034,119428,Shang; Jingbo,9999,0,9999,0
1668338771380,CSE 293,035,119430,Stefan; Deian,9999,0,9999,0
1668338771380,CSE 293,036,119431,Su; Hao,9999,0,9999,0
1668338771380,CSE 293,037,119433,Swanson; Steven James,9999,0,9999,0
1668338771380,CSE 293,038,119435,Tullsen; Dean Michael,9999,0,9999,0
1668338771380,CSE 293,039,119483,Voelker; Geoffrey M.,9999,0,9999,0
1668338771380,CSE 293,040,119537,Zhao; Jishen,9999,0,9999,0
1668338771380,CSE 293,041,119538,Zhou; Yuan-Yuan,9999,0,9999,0
1668338771380,CSE 293,042,119539,Gao; Sicun,9999,0,9999,0
1668338771380,CSE 293,043,119540,Weibel; Nadir,9999,0,9999,0
1668338771380,CSE 293,044,119541,Gupta; Rajesh K.,9999,0,9999,0
1668338771380,CSE 293,045,126410,Vaccaro; Kristen Marie,9999,0,9999,0
1668338771380,CSE 293,046,126411,Klemke; Richard,9999,0,9999,0
1668338771804,CSE 294,A00,102459,Voelker; Geoffrey M.,0,0,0,0
1668338771804,CSE 294,B00,111322,Orailoglu; Alex,0,0,0,0
1668338772234,DSE 201,A00,096914,Deutsch; Alin Bernard,30,0,30,0
1668338772662,DSE 210,A00,096915,Dasgupta; Sanjoy,30,0,30,0
1668338773086,DSE 260A,A00,096916,Altintas De Callaf; Ilkay,30,0,30,0
1668338773583,ECE 200,001,103586,Antipa; Nicholas A,9999,0,9999,0
1668338773583,ECE 200,002,103587,Atanasov; Nikolay A.,9999,0,9999,0
1668338773583,ECE 200,003,103588,Bharadia; Dinesh,9999,0,9999,0
1668338773583,ECE 200,004,103589,Cheng; Chung Kuan,9999,0,9999,0
1668338773583,ECE 200,005,103590,Cosman; Pamela C.,9999,0,9999,0
1668338773583,ECE 200,006,103591,Dayeh; Shadi Ahmad,9999,0,9999,0
1668338773583,ECE 200,007,103592,Fainman; Yeshaiahu,9999,0,9999,0
1668338773583,ECE 200,008,103593,Ford; Joseph Earl,9999,0,9999,0
1668338773583,ECE 200,009,103594,Franceschetti; Massimo,9999,0,9999,0
1668338773583,ECE 200,010,103595,Fullerton; Eric E,9999,0,9999,0
1668338773583,ECE 200,011,103596,Galton; Ian A,9999,0,9999,0
1668338773583,ECE 200,012,103597,Gilja; Vikash,9999,0,9999,0
1668338773583,ECE 200,013,103598,Hall; Drew A.,9999,0,9999,0
1668338773583,ECE 200,014,103599,Hsueh; Tzu-Chien,9999,0,9999,0
1668338773583,ECE 200,015,103600,Javidi; Tara,9999,0,9999,0
1668338773583,ECE 200,016,103601,Kahng; Andrew Byun,9999,0,9999,0
1668338773583,ECE 200,017,103602,Kim; Young-Han,9999,0,9999,0
1668338773583,ECE 200,018,103603,Koushanfar; Farinaz,9999,0,9999,0
1668338773583,ECE 200,019,103604,Kuzum; Duygu,9999,0,9999,0
1668338773583,ECE 200,020,103605,Le; Hanh-Phuc,9999,0,9999,0
1668338773583,ECE 200,021,103606,Lin; Bill,9999,0,9999,0
1668338773583,ECE 200,022,103607,Liu; Zhaowei,9998,0,9999,1
1668338773583,ECE 200,023,103608,Lo; Yu-Hwa,9999,0,9999,0
1668338773583,ECE 200,024,103609,Lomakin; Vitaliy,9999,0,9999,0
1668338773583,ECE 200,025,103610,Mercier; Patrick Philip,9999,0,9999,0
1668338773583,ECE 200,026,103611,Meyer; Florian,9999,0,9999,0
1668338773583,ECE 200,027,103612,Milstein; Laurence B.,9999,0,9999,0
1668338773583,ECE 200,028,103613,Mir Arabbaygi; Siavash,9999,0,9999,0
1668338773583,ECE 200,029,103614,Mookherjea; Shayan,9999,0,9999,0
1668338773583,ECE 200,030,103615,Morris; Karcher William,9999,0,9999,0
1668338773583,ECE 200,031,103616,Ng; Tse Nga,9999,0,9999,0
1668338773583,ECE 200,032,103617,Nguyen; Truong Quang,9999,0,9999,0
1668338773583,ECE 200,033,103618,Nomura; Kenji,9999,0,9999,0
1668338773583,ECE 200,034,103619,Orlitsky; Alon,9999,0,9999,0
1668338773583,ECE 200,035,103620,Pal; Piya,9999,0,9999,0
1668338773583,ECE 200,036,103621,Papen; George C.,9999,0,9999,0
1668338773583,ECE 200,037,103622,Radic; Stojan,9999,0,9999,0
1668338773583,ECE 200,038,103623,Rao; Bhaskar D.,9999,0,9999,0
1668338773583,ECE 200,039,103624,Rao; Ramesh R,9999,0,9999,0
1668338773583,ECE 200,040,103625,Rebeiz; Gabriel,9999,0,9999,0
1668338773583,ECE 200,041,103626,Sanford; John R,9999,0,9999,0
1668338773583,ECE 200,042,103627,Siegel; Paul H.,9999,0,9999,0
1668338773583,ECE 200,043,103628,Sievenpiper; Daniel F.,9999,0,9999,0
1668338773583,ECE 200,044,103629,Sworder; David D.,9999,0,9999,0
1668338773583,ECE 200,045,103630,Taur; Yuan,9999,0,9999,0
1668338773583,ECE 200,046,103631,Touri; Behrouz,9999,0,9999,0
1668338773583,ECE 200,047,103632,Trivedi; Mohan M.,9999,0,9999,0
1668338773583,ECE 200,048,103633,Vasconcelos; Nuno,9999,0,9999,0
1668338773583,ECE 200,049,103634,Wang; Xiaolong,9999,0,9999,0
1668338773583,ECE 200,050,103635,Xie; Pengtao,9999,0,9999,0
1668338773583,ECE 200,051,103636,Yip; Michael,9999,0,9999,0
1668338773583,ECE 200,052,103637,Zeger; Kenneth A.,999,0,999,0
1668338773583,ECE 200,053,103638,Zhang; Xinyu,9999,0,9999,0
1668338773583,ECE 200,054,103639,Turakhia; Yatish Girish,9999,0,9999,0
1668338773583,ECE 200,055,103640,Kang; Mingu,9999,0,9999,0
1668338773583,ECE 200,056,103641,Shi; Yuanyuan,9999,0,9999,0
1668338773583,ECE 200,057,103642,Wang; Edward Jay,9999,0,9999,0
1668338773583,ECE 200,058,103643,Zheng; Yang,9999,0,9999,0
1668338774008,ECE 202,A00,103644,Kuzum; Duygu,0,0,0,0
1668338774432,ECE 212BN,A00,103646,Ng; Tse Nga,0,0,0,0
1668338774857,ECE 221,A00,111493,Staff,0,0,0,0
1668338775285,ECE 222B,A00,103647,Lomakin; Vitaliy,0,0,0,0
1668338775707,ECE 230B,A00,103648,Taur; Yuan,0,0,0,0
1668338776141,ECE 238B,A00,103649,Garay; Javier,0,0,0,0
1668338776567,ECE 240B,A00,112900,Fainman; Yeshaiahu,0,0,0,0
1668338776995,ECE 247A,A00,103650,Jokerst; Jesse Vincent,0,0,0,0
1668338777418,ECE 247B,A00,103651,Wang; Joseph,0,0,0,0
1668338777846,ECE 250,A00,103652,Siegel; Paul H.,0,0,0,0
1668338778270,ECE 251A,A00,103654,Rao; Bhaskar D.,0,0,0,0
1668338778697,ECE 257B,A00,103655,Bharadia; Dinesh,0,0,0,0
1668338779121,ECE 258A,A00,103656,Milstein; Laurence B.,0,0,0,0
1668338779547,ECE 260B,A00,103658,Kang; Mingu,0,0,0,0
1668338779971,ECE 264A,A00,103659,Galton; Ian A,0,0,0,0
1668338780397,ECE 265A,A00,103661,Gudem; Prasad S.S.,0,0,0,0
1668338780826,ECE 265D,A00,103662,Gudem; Prasad S.S.,0,0,0,0
1668338781250,ECE 268,A00,103663,Koushanfar; Farinaz,0,0,0,0
1668338781677,ECE 269,A01,103665,Pal; Piya,0,0,0,0
1668338782113,ECE 271B,A00,103666,Vasconcelos; Manuela,0,0,0,0
1668338782538,ECE 276A,A00,103667,Atanasov; Nikolay A.,0,0,0,0
1668338782962,ECE 277,A00,103668,An; Cheolhong,0,0,0,0
1668338783387,ECE 279,A00,117947,Hall; Drew A.,0,0,0,0
1668338784243,ECE 283,A00,103670,Hsueh; Tzu-Chien,0,0,0,0
1668338784670,ECE 284,A00,103671,Turakhia; Yatish Girish,0,0,0,0
1668338785094,ECE 285,A00,103672,Zheng; Yang,0,0,0,0
1668338785094,ECE 285,B00,103673,Sworder; David D.,0,0,0,0
1668338785518,ECE 287,A00,103676,Javidi; Tara,0,0,0,0
1668338785947,MATH 200B,A00,098023,Salehi Golsefidy; Alireza,12,0,15,3
1668338786371,MATH 202B,A00,098024,Rhoades; Brendon Patrick,9,0,15,6
1668338786797,MATH 203B,A00,098025,Oprea; Dragos N.,10,0,15,5
1668338787221,MATH 204B,A00,098026,Sorensen; Claus M,13,0,15,2
1668338787645,MATH 208,A00,098027,Izadi; Elham,7,0,10,3
1668338788070,MATH 209,A00,098028,Pollack; Aaron,10,0,10,0
1668338788495,MATH 211A,A00,112919,Rogalski; Daniel,9,0,10,1
1668338788917,MATH 211B,A00,112920,Seward; Brandon M.,9,0,10,1
1668338789341,MATH 218,A00,098029,Li; Bo,10,0,10,0
1668338789765,MATH 220B,A00,098030,Novak; Jonathan I,11,0,15,4
1668338790191,MATH 221A,A00,098031,Ebenfelt; Peter F,13,0,15,2
1668338790617,MATH 231B,A00,098032,Zlatos; Andrej,12,0,15,3
1668338791041,MATH 240B,A00,098033,Ni; Lei,9,0,15,6
1668338791465,MATH 243,A00,098034,Jekel; David Andrew,10,0,10,0
1668338791893,MATH 245A,A00,098035,Nie; Jiawang,0,0,15,16
1668338792415,MATH 248,A00,098036,Bejenaru; Ioan,10,0,10,0
1668338792838,MATH 250B,A00,098037,Spolaor; Luca,14,0,15,1
1668338793264,MATH 258,A00,098038,Ni; Lei,10,0,10,0
1668338793689,MATH 264B,A00,098041,Rhoades; Brendon Patrick,9,0,15,6
1668338794112,MATH 268,A00,098042,Buss; Samuel R,10,0,10,0
1668338794539,MATH 269,A00,098043,Rhoades; Brendon Patrick,10,0,10,0
1668338794964,MATH 270B,A00,098044,Li; Bo,10,0,15,5
1668338795395,MATH 272B,A00,098045,Holst; Michael J,13,0,15,2
1668338795819,MATH 273A,A00,098046,Tian; Xiaochuan,10,0,15,5
1668338796249,MATH 275,A01,098048,Tian; Xiaochuan,6,0,10,4
1668338796676,MATH 278A,A00,098049,Holst; Michael J,8,0,10,2
1668338797101,MATH 278B,A00,098050,Cloninger; Alexander,10,0,10,0
1668338797526,MATH 278C,A00,098051,Nie; Jiawang,7,0,10,3
1668338797954,MATH 280B,A00,098052,Zheng; Tianyi,8,0,15,7
1668338798380,MATH 281B,A00,098053,Bradic; Jelena,1,0,15,14
1668338798807,MATH 282B,A00,098054,Arias-Castro; Ery,0,0,15,15
1668338799232,MATH 285,A00,098055,Fitzsimmons; Patrick J,0,0,15,17
1668338799655,MATH 287B,A00,098056,Arias-Castro; Ery,2,0,15,13
1668338800080,MATH 288,A00,098057,Agarwal; Pooja,9,0,10,1
1668338800080,MATH 288,B00,098058,Zhang; Danna,8,0,10,2
1668338800080,MATH 288,C00,098059,Williams; Ruth J,9,0,10,1
1668338800509,MATH 290B,A00,098060,Roberts; Justin Deritter,13,0,15,2
1668338800937,MATH 292,A00,098061,Belmont; Eva Kinoshita,10,0,10,0
1668338801360,MATH 295,A00,098062,Suk; Andrew Hoon,48,0,50,2
1668338801782,MATH 296,A00,098063,Novak; Jonathan I,20,0,20,0
1668338802208,MATH 297,001,098064,Gamst; Anthony Collins,9997,0,9999,2
1668339302665,COGS 205,A00,101395,Chiba; Andrea,19,0,20,1
1668339303094,COGS 210B,001,101404,Greene; Deanna Jacquelyn,9998,0,9999,1
1668339303094,COGS 210B,002,101417,Xia; Haijun,9999,0,9999,0
1668339303094,COGS 210B,003,101422,Nitz; Douglas A.,9999,0,9999,0
1668339303094,COGS 210B,004,101423,Hollan; James D.,9998,0,9999,1
1668339303094,COGS 210B,005,101424,Deak; Gedeon O.,9998,0,9999,1
1668339303094,COGS 210B,006,101425,Rossano; Federico,9999,0,9999,0
1668339303519,COGS 211B,A00,101427,Coulson; Seana M,9996,0,9999,3
1668339303944,COGS 220,A00,101428,Hollan; James D.,0,0,25,25
1668339304373,COGS 229,A00,101429,Dow; Steven P,18,0,25,7
1668339304798,COGS 230,A00,101430,Klemmer; Scott R,11,0,17,6
1668339305221,COGS 234,A00,101431,Xia; Haijun,1,0,25,24
1668339305655,COGS 260,A00,101432,Kiyonaga; Anastasia,21,0,25,4
1668339305655,COGS 260,B00,101433,Kirsh; David Joel,15,0,25,10
1668339306090,CSE 202,A00,102371,Impagliazzo; Russell,0,0,0,0
1668339306525,CSE 203B,A01,102373,Cheng; Chung Kuan,0,0,0,0
1668339306951,CSE 208,A00,102374,Micciancio; Daniele,0,0,0,0
1668339307376,CSE 209A,A00,112895,Impagliazzo; Russell,0,0,15,15
1668339307805,CSE 209B,A00,108005,Bellare; Mihir,0,0,0,0
1668339308234,CSE 210,A00,113163,Coblenz; Michael J,0,0,0,0
1668339308660,CSE 219,A00,106111,Dow; Steven P,0,0,20,20
1668339309089,CSE 221,A00,102376,Voelker; Geoffrey M.,0,0,0,0
1668339309515,CSE 224,A01,102378,Porter; George M,0,0,0,0
1668339309939,CSE 229A,A00,102379,Savage; Stefan,0,0,0,0
1668339310371,CSE 229C,A00,102380,Munyaka; Imani N. S.,0,0,0,0
1668339310797,CSE 232B,A00,102382,Deutsch; Alin Bernard,0,0,0,0
1668339311222,CSE 234,A01,112904,Kumar; Arun Kumar,0,0,0,0
1668339311648,CSE 237A,A00,102383,Rosing; Tajana Simunic,0,0,0,0
1668339312073,CSE 239A,A00,102384,Deutsch; Alin Bernard,0,0,0,0
1668339312498,CSE 239B,A00,102385,Polikarpova; Nadezhda,0,0,0,0
1668339313017,CSE 240A,A00,102386,Pannuto; Patrick William,0,0,0,0
1668339313445,CSE 240B,A00,102387,Zhao; Jishen,0,0,0,0
1668339313871,CSE 241A,A00,106406,Kang; Mingu,0,0,0,0
1668339314298,CSE 249B,A00,102388,Kahng; Andrew Byun,0,0,8,8
1668339314734,CSE 251B,A01,102392,Cottrell; Garrison W,0,0,0,0
1668339314734,CSE 251B,A02,102393,Cottrell; Garrison W,0,0,0,0
1668339315164,CSE 252B,A00,102394,Ochoa; Benjamin Lawrence,0,0,0,0
1668339315586,CSE 257,A01,102396,Gao; Sicun,0,0,0,0
1668339316018,CSE 272,A00,102397,Li; Tzumao,0,0,0,0
1668339316447,CSE 274,A00,111323,Chern; Albert Ren-Haur,0,0,0,0
1668339316877,CSE 282,A00,102398,Pevzner; Pavel Arkadjevich,0,0,0,0
1668339317306,CSE 284,A00,114175,Gymrek; Melissa Ann,0,0,0,0
1668339317739,CSE 290,A00,102399,Chandraker; Manmohan Krishna,0,0,0,0
1668339317739,CSE 290,B00,102400,Vaccaro; Kristen Marie,0,0,25,25
1668339317739,CSE 290,C00,102414,Pannuto; Patrick William,0,0,25,25
1668339317739,CSE 290,D00,102427,Pevzner; Pavel Arkadjevich,0,0,0,0
1668339317739,CSE 290,E00,102429,Zhao; Jishen,0,0,0,0
1668339317739,CSE 290,F00,102436,Tullsen; Dean Michael,0,0,0,0
1668339317739,CSE 290,G00,102440,Christensen; Henrik I,0,0,20,20
1668339318167,CSE 291,A00,102443,Su; Hao,0,0,0,0
1668339318167,CSE 291,B00,102448,Polikarpova; Nadezhda,0,0,0,0
1668339318167,CSE 291,C00,102453,Vaccaro; Kristen Marie,0,0,0,0
1668339318167,CSE 291,D00,111343,Savage; Stefan,0,0,0,0
1668339318167,CSE 291,E00,116474,Claffy; Kimberly Claire,0,0,0,0
1668339318167,CSE 291,F00,116479,Pasquale; Joseph,0,0,0,0
1668339318619,CSE 293,001,119111,Bafna; Vineet,9999,0,9999,0
1668339318619,CSE 293,002,119118,Bellare; Mihir,9999,0,9999,0
1668339318619,CSE 293,003,119122,Berg-Kirkpatrick; Taylor D,9999,0,9999,0
1668339318619,CSE 293,004,119135,Christensen; Henrik I,9999,0,9999,0
1668339318619,CSE 293,005,119142,Cottrell; Garrison W,9999,0,9999,0
1668339318619,CSE 293,006,119146,Deutsch; Alin Bernard,9999,0,9999,0
1668339318619,CSE 293,007,119159,Esmaeilzadeh; Hadi,9999,0,9999,0
1668339318619,CSE 293,008,119166,Freund; Yoav,9999,0,9999,0
1668339318619,CSE 293,009,119170,Griswold; William G.,9999,0,9999,0
1668339318619,CSE 293,010,119183,Gymrek; Melissa Ann,9999,0,9999,0
1668339318619,CSE 293,011,119190,Heninger; Nadia A,9999,0,9999,0
1668339318619,CSE 293,012,119230,Impagliazzo; Russell,9999,0,9999,0
1668339318619,CSE 293,013,119232,Jhala; Ranjit,9999,0,9999,0
1668339318619,CSE 293,014,119233,Kahng; Andrew Byun,9999,0,9999,0
1668339318619,CSE 293,015,119298,Kane; Daniel Mertz,9999,0,9999,0
1668339318619,CSE 293,016,119299,Kriegman; David J,9999,0,9999,0
1668339318619,CSE 293,017,119300,Kumar; Arun Kumar,9999,0,9999,0
1668339318619,CSE 293,018,119301,Lerner; Sorin,9999,0,9999,0
1668339318619,CSE 293,019,119302,Lovett; Shachar,9999,0,9999,0
1668339318619,CSE 293,020,119303,McAuley; Julian John,9999,0,9999,0
1668339318619,CSE 293,021,119304,Micciancio; Daniele,9999,0,9999,0
1668339318619,CSE 293,022,119367,Orailoglu; Alex,9999,0,9999,0
1668339318619,CSE 293,023,119382,Paturi; Ramamohan,9999,0,9999,0
1668339318619,CSE 293,024,119404,Polikarpova; Nadezhda,9999,0,9999,0
1668339318619,CSE 293,025,119406,Politz; Joseph Gibbs,9999,0,9999,0
1668339318619,CSE 293,026,119411,Porter; George M,9999,0,9999,0
1668339318619,CSE 293,027,119414,Porter; Leonard Emerson,9999,0,9999,0
1668339318619,CSE 293,028,119416,Ramamoorthi; Ravi,9999,0,9999,0
1668339318619,CSE 293,029,119417,Sahoo; Debashis,9999,0,9999,0
1668339318619,CSE 293,030,119420,Saul; Lawrence,9999,0,9999,0
1668339318619,CSE 293,031,119421,Savage; Stefan,9999,0,9999,0
1668339318619,CSE 293,032,119425,Schulze; Jurgen P.,9999,0,9999,0
1668339318619,CSE 293,033,119426,Snoeren; Alex C.,9999,0,9999,0
1668339318619,CSE 293,034,119428,Shang; Jingbo,9999,0,9999,0
1668339318619,CSE 293,035,119430,Stefan; Deian,9999,0,9999,0
1668339318619,CSE 293,036,119431,Su; Hao,9999,0,9999,0
1668339318619,CSE 293,037,119433,Swanson; Steven James,9999,0,9999,0
1668339318619,CSE 293,038,119435,Tullsen; Dean Michael,9999,0,9999,0
1668339318619,CSE 293,039,119483,Voelker; Geoffrey M.,9999,0,9999,0
1668339318619,CSE 293,040,119537,Zhao; Jishen,9999,0,9999,0
1668339318619,CSE 293,041,119538,Zhou; Yuan-Yuan,9999,0,9999,0
1668339318619,CSE 293,042,119539,Gao; Sicun,9999,0,9999,0
1668339318619,CSE 293,043,119540,Weibel; Nadir,9999,0,9999,0
1668339318619,CSE 293,044,119541,Gupta; Rajesh K.,9999,0,9999,0
1668339318619,CSE 293,045,126410,Vaccaro; Kristen Marie,9999,0,9999,0
1668339318619,CSE 293,046,126411,Klemke; Richard,9999,0,9999,0
1668339319054,CSE 294,A00,102459,Voelker; Geoffrey M.,0,0,0,0
1668339319054,CSE 294,B00,111322,Orailoglu; Alex,0,0,0,0
1668339319485,DSE 201,A00,096914,Deutsch; Alin Bernard,30,0,30,0
1668339319909,DSE 210,A00,096915,Dasgupta; Sanjoy,30,0,30,0
1668339320333,DSE 260A,A00,096916,Altintas De Callaf; Ilkay,30,0,30,0
1668339320812,ECE 200,001,103586,Antipa; Nicholas A,9999,0,9999,0
1668339320812,ECE 200,002,103587,Atanasov; Nikolay A.,9999,0,9999,0
1668339320812,ECE 200,003,103588,Bharadia; Dinesh,9999,0,9999,0
1668339320812,ECE 200,004,103589,Cheng; Chung Kuan,9999,0,9999,0
1668339320812,ECE 200,005,103590,Cosman; Pamela C.,9999,0,9999,0
1668339320812,ECE 200,006,103591,Dayeh; Shadi Ahmad,9999,0,9999,0
1668339320812,ECE 200,007,103592,Fainman; Yeshaiahu,9999,0,9999,0
1668339320812,ECE 200,008,103593,Ford; Joseph Earl,9999,0,9999,0
1668339320812,ECE 200,009,103594,Franceschetti; Massimo,9999,0,9999,0
1668339320812,ECE 200,010,103595,Fullerton; Eric E,9999,0,9999,0
1668339320812,ECE 200,011,103596,Galton; Ian A,9999,0,9999,0
1668339320812,ECE 200,012,103597,Gilja; Vikash,9999,0,9999,0
1668339320812,ECE 200,013,103598,Hall; Drew A.,9999,0,9999,0
1668339320812,ECE 200,014,103599,Hsueh; Tzu-Chien,9999,0,9999,0
1668339320812,ECE 200,015,103600,Javidi; Tara,9999,0,9999,0
1668339320812,ECE 200,016,103601,Kahng; Andrew Byun,9999,0,9999,0
1668339320812,ECE 200,017,103602,Kim; Young-Han,9999,0,9999,0
1668339320812,ECE 200,018,103603,Koushanfar; Farinaz,9999,0,9999,0
1668339320812,ECE 200,019,103604,Kuzum; Duygu,9999,0,9999,0
1668339320812,ECE 200,020,103605,Le; Hanh-Phuc,9999,0,9999,0
1668339320812,ECE 200,021,103606,Lin; Bill,9999,0,9999,0
1668339320812,ECE 200,022,103607,Liu; Zhaowei,9998,0,9999,1
1668339320812,ECE 200,023,103608,Lo; Yu-Hwa,9999,0,9999,0
1668339320812,ECE 200,024,103609,Lomakin; Vitaliy,9999,0,9999,0
1668339320812,ECE 200,025,103610,Mercier; Patrick Philip,9999,0,9999,0
1668339320812,ECE 200,026,103611,Meyer; Florian,9999,0,9999,0
1668339320812,ECE 200,027,103612,Milstein; Laurence B.,9999,0,9999,0
1668339320812,ECE 200,028,103613,Mir Arabbaygi; Siavash,9999,0,9999,0
1668339320812,ECE 200,029,103614,Mookherjea; Shayan,9999,0,9999,0
1668339320812,ECE 200,030,103615,Morris; Karcher William,9999,0,9999,0
1668339320812,ECE 200,031,103616,Ng; Tse Nga,9999,0,9999,0
1668339320812,ECE 200,032,103617,Nguyen; Truong Quang,9999,0,9999,0
1668339320812,ECE 200,033,103618,Nomura; Kenji,9999,0,9999,0
1668339320812,ECE 200,034,103619,Orlitsky; Alon,9999,0,9999,0
1668339320812,ECE 200,035,103620,Pal; Piya,9999,0,9999,0
1668339320812,ECE 200,036,103621,Papen; George C.,9999,0,9999,0
1668339320812,ECE 200,037,103622,Radic; Stojan,9999,0,9999,0
1668339320812,ECE 200,038,103623,Rao; Bhaskar D.,9999,0,9999,0
1668339320812,ECE 200,039,103624,Rao; Ramesh R,9999,0,9999,0
1668339320812,ECE 200,040,103625,Rebeiz; Gabriel,9999,0,9999,0
1668339320812,ECE 200,041,103626,Sanford; John R,9999,0,9999,0
1668339320812,ECE 200,042,103627,Siegel; Paul H.,9999,0,9999,0
1668339320812,ECE 200,043,103628,Sievenpiper; Daniel F.,9999,0,9999,0
1668339320812,ECE 200,044,103629,Sworder; David D.,9999,0,9999,0
1668339320812,ECE 200,045,103630,Taur; Yuan,9999,0,9999,0
1668339320812,ECE 200,046,103631,Touri; Behrouz,9999,0,9999,0
1668339320812,ECE 200,047,103632,Trivedi; Mohan M.,9999,0,9999,0
1668339320812,ECE 200,048,103633,Vasconcelos; Nuno,9999,0,9999,0
1668339320812,ECE 200,049,103634,Wang; Xiaolong,9999,0,9999,0
1668339320812,ECE 200,050,103635,Xie; Pengtao,9999,0,9999,0
1668339320812,ECE 200,051,103636,Yip; Michael,9999,0,9999,0
1668339320812,ECE 200,052,103637,Zeger; Kenneth A.,999,0,999,0
1668339320812,ECE 200,053,103638,Zhang; Xinyu,9999,0,9999,0
1668339320812,ECE 200,054,103639,Turakhia; Yatish Girish,9999,0,9999,0
1668339320812,ECE 200,055,103640,Kang; Mingu,9999,0,9999,0
1668339320812,ECE 200,056,103641,Shi; Yuanyuan,9999,0,9999,0
1668339320812,ECE 200,057,103642,Wang; Edward Jay,9999,0,9999,0
1668339320812,ECE 200,058,103643,Zheng; Yang,9999,0,9999,0
1668339321244,ECE 202,A00,103644,Kuzum; Duygu,0,0,0,0
1668339321671,ECE 212BN,A00,103646,Ng; Tse Nga,0,0,0,0
1668339322096,ECE 221,A00,111493,Staff,0,0,0,0
1668339322520,ECE 222B,A00,103647,Lomakin; Vitaliy,0,0,0,0
1668339322945,ECE 230B,A00,103648,Taur; Yuan,0,0,0,0
1668339323376,ECE 238B,A00,103649,Garay; Javier,0,0,0,0
1668339323803,ECE 240B,A00,112900,Fainman; Yeshaiahu,0,0,0,0
1668339324227,ECE 247A,A00,103650,Jokerst; Jesse Vincent,0,0,0,0
1668339324651,ECE 247B,A00,103651,Wang; Joseph,0,0,0,0
1668339325075,ECE 250,A00,103652,Siegel; Paul H.,0,0,0,0
1668339325502,ECE 251A,A00,103654,Rao; Bhaskar D.,0,0,0,0
1668339325927,ECE 257B,A00,103655,Bharadia; Dinesh,0,0,0,0
1668339326356,ECE 258A,A00,103656,Milstein; Laurence B.,0,0,0,0
1668339326784,ECE 260B,A00,103658,Kang; Mingu,0,0,0,0
1668339327208,ECE 264A,A00,103659,Galton; Ian A,0,0,0,0
1668339327633,ECE 265A,A00,103661,Gudem; Prasad S.S.,0,0,0,0
1668339328060,ECE 265D,A00,103662,Gudem; Prasad S.S.,0,0,0,0
1668339328486,ECE 268,A00,103663,Koushanfar; Farinaz,0,0,0,0
1668339328913,ECE 269,A01,103665,Pal; Piya,0,0,0,0
1668339329342,ECE 271B,A00,103666,Vasconcelos; Manuela,0,0,0,0
1668339329766,ECE 276A,A00,103667,Atanasov; Nikolay A.,0,0,0,0
1668339330196,ECE 277,A00,103668,An; Cheolhong,0,0,0,0
1668339330619,ECE 279,A00,117947,Hall; Drew A.,0,0,0,0
1668339331473,ECE 283,A00,103670,Hsueh; Tzu-Chien,0,0,0,0
1668339331900,ECE 284,A00,103671,Turakhia; Yatish Girish,0,0,0,0
1668339332323,ECE 285,A00,103672,Zheng; Yang,0,0,0,0
1668339332323,ECE 285,B00,103673,Sworder; David D.,0,0,0,0
1668339332747,ECE 287,A00,103676,Javidi; Tara,0,0,0,0
1668339333176,MATH 200B,A00,098023,Salehi Golsefidy; Alireza,12,0,15,3
1668339333600,MATH 202B,A00,098024,Rhoades; Brendon Patrick,9,0,15,6
1668339334030,MATH 203B,A00,098025,Oprea; Dragos N.,10,0,15,5
1668339334459,MATH 204B,A00,098026,Sorensen; Claus M,13,0,15,2
1668339334884,MATH 208,A00,098027,Izadi; Elham,7,0,10,3
1668339335309,MATH 209,A00,098028,Pollack; Aaron,10,0,10,0
1668339335735,MATH 211A,A00,112919,Rogalski; Daniel,9,0,10,1
1668339336170,MATH 211B,A00,112920,Seward; Brandon M.,9,0,10,1
1668339336599,MATH 218,A00,098029,Li; Bo,10,0,10,0
1668339337023,MATH 220B,A00,098030,Novak; Jonathan I,11,0,15,4
1668339337447,MATH 221A,A00,098031,Ebenfelt; Peter F,13,0,15,2
1668339337874,MATH 231B,A00,098032,Zlatos; Andrej,12,0,15,3
1668339338300,MATH 240B,A00,098033,Ni; Lei,9,0,15,6
1668339338724,MATH 243,A00,098034,Jekel; David Andrew,10,0,10,0
1668339339153,MATH 245A,A00,098035,Nie; Jiawang,0,0,15,16
1668339339577,MATH 248,A00,098036,Bejenaru; Ioan,10,0,10,0
1668339340004,MATH 250B,A00,098037,Spolaor; Luca,14,0,15,1
1668339340431,MATH 258,A00,098038,Ni; Lei,10,0,10,0
1668339340854,MATH 264B,A00,098041,Rhoades; Brendon Patrick,9,0,15,6
1668339341291,MATH 268,A00,098042,Buss; Samuel R,10,0,10,0
1668339341718,MATH 269,A00,098043,Rhoades; Brendon Patrick,10,0,10,0
1668339342147,MATH 270B,A00,098044,Li; Bo,10,0,15,5
1668339342572,MATH 272B,A00,098045,Holst; Michael J,13,0,15,2
1668339343001,MATH 273A,A00,098046,Tian; Xiaochuan,10,0,15,5
1668339343429,MATH 275,A01,098048,Tian; Xiaochuan,6,0,10,4
1668339343852,MATH 278A,A00,098049,Holst; Michael J,8,0,10,2
1668339344283,MATH 278B,A00,098050,Cloninger; Alexander,10,0,10,0
1668339344709,MATH 278C,A00,098051,Nie; Jiawang,7,0,10,3
1668339345133,MATH 280B,A00,098052,Zheng; Tianyi,8,0,15,7
1668339345557,MATH 281B,A00,098053,Bradic; Jelena,1,0,15,14
1668339345983,MATH 282B,A00,098054,Arias-Castro; Ery,0,0,15,15
1668339346413,MATH 285,A00,098055,Fitzsimmons; Patrick J,0,0,15,17
1668339346840,MATH 287B,A00,098056,Arias-Castro; Ery,2,0,15,13
1668339347267,MATH 288,A00,098057,Agarwal; Pooja,9,0,10,1
1668339347267,MATH 288,B00,098058,Zhang; Danna,8,0,10,2
1668339347267,MATH 288,C00,098059,Williams; Ruth J,9,0,10,1
1668339347693,MATH 290B,A00,098060,Roberts; Justin Deritter,13,0,15,2
1668339348118,MATH 292,A00,098061,Belmont; Eva Kinoshita,10,0,10,0
1668339348544,MATH 295,A00,098062,Suk; Andrew Hoon,48,0,50,2
1668339348967,MATH 296,A00,098063,Novak; Jonathan I,20,0,20,0
1668339349393,MATH 297,001,098064,Gamst; Anthony Collins,9997,0,9999,2
1668339850744,COGS 205,A00,101395,Chiba; Andrea,19,0,20,1
1668339851181,COGS 210B,001,101404,Greene; Deanna Jacquelyn,9998,0,9999,1
1668339851181,COGS 210B,002,101417,Xia; Haijun,9999,0,9999,0
1668339851181,COGS 210B,003,101422,Nitz; Douglas A.,9999,0,9999,0
1668339851181,COGS 210B,004,101423,Hollan; James D.,9998,0,9999,1
1668339851181,COGS 210B,005,101424,Deak; Gedeon O.,9998,0,9999,1
1668339851181,COGS 210B,006,101425,Rossano; Federico,9999,0,9999,0
1668339851609,COGS 211B,A00,101427,Coulson; Seana M,9996,0,9999,3
1668339852034,COGS 220,A00,101428,Hollan; James D.,0,0,25,25
1668339852460,COGS 229,A00,101429,Dow; Steven P,18,0,25,7
1668339852885,COGS 230,A00,101430,Klemmer; Scott R,11,0,17,6
1668339853313,COGS 234,A00,101431,Xia; Haijun,1,0,25,24
1668339853742,COGS 260,A00,101432,Kiyonaga; Anastasia,21,0,25,4
1668339853742,COGS 260,B00,101433,Kirsh; David Joel,15,0,25,10
1668339854169,CSE 202,A00,102371,Impagliazzo; Russell,0,0,0,0
1668339854596,CSE 203B,A01,102373,Cheng; Chung Kuan,0,0,0,0
1668339855019,CSE 208,A00,102374,Micciancio; Daniele,0,0,0,0
1668339855448,CSE 209A,A00,112895,Impagliazzo; Russell,0,0,15,15
1668339855871,CSE 209B,A00,108005,Bellare; Mihir,0,0,0,0
1668339856296,CSE 210,A00,113163,Coblenz; Michael J,0,0,0,0
1668339856719,CSE 219,A00,106111,Dow; Steven P,0,0,20,20
1668339857148,CSE 221,A00,102376,Voelker; Geoffrey M.,0,0,0,0
1668339857576,CSE 224,A01,102378,Porter; George M,0,0,0,0
1668339858002,CSE 229A,A00,102379,Savage; Stefan,0,0,0,0
1668339858427,CSE 229C,A00,102380,Munyaka; Imani N. S.,0,0,0,0
1668339858852,CSE 232B,A00,102382,Deutsch; Alin Bernard,0,0,0,0
1668339859283,CSE 234,A01,112904,Kumar; Arun Kumar,0,0,0,0
1668339859713,CSE 237A,A00,102383,Rosing; Tajana Simunic,0,0,0,0
1668339860137,CSE 239A,A00,102384,Deutsch; Alin Bernard,0,0,0,0
1668339860564,CSE 239B,A00,102385,Polikarpova; Nadezhda,0,0,0,0
1668339860989,CSE 240A,A00,102386,Pannuto; Patrick William,0,0,0,0
1668339861417,CSE 240B,A00,102387,Zhao; Jishen,0,0,0,0
1668339861847,CSE 241A,A00,106406,Kang; Mingu,0,0,0,0
1668339862271,CSE 249B,A00,102388,Kahng; Andrew Byun,0,0,8,8
1668339862699,CSE 251B,A01,102392,Cottrell; Garrison W,0,0,0,0
1668339862699,CSE 251B,A02,102393,Cottrell; Garrison W,0,0,0,0
1668339863124,CSE 252B,A00,102394,Ochoa; Benjamin Lawrence,0,0,0,0
1668339863553,CSE 257,A01,102396,Gao; Sicun,0,0,0,0
1668339863981,CSE 272,A00,102397,Li; Tzumao,0,0,0,0
1668339864408,CSE 274,A00,111323,Chern; Albert Ren-Haur,0,0,0,0
1668339864832,CSE 282,A00,102398,Pevzner; Pavel Arkadjevich,0,0,0,0
1668339865255,CSE 284,A00,114175,Gymrek; Melissa Ann,0,0,0,0
1668339865691,CSE 290,A00,102399,Chandraker; Manmohan Krishna,0,0,0,0
1668339865691,CSE 290,B00,102400,Vaccaro; Kristen Marie,0,0,25,25
1668339865691,CSE 290,C00,102414,Pannuto; Patrick William,0,0,25,25
1668339865691,CSE 290,D00,102427,Pevzner; Pavel Arkadjevich,0,0,0,0
1668339865691,CSE 290,E00,102429,Zhao; Jishen,0,0,0,0
1668339865691,CSE 290,F00,102436,Tullsen; Dean Michael,0,0,0,0
1668339865691,CSE 290,G00,102440,Christensen; Henrik I,0,0,20,20
1668339866119,CSE 291,A00,102443,Su; Hao,0,0,0,0
1668339866119,CSE 291,B00,102448,Polikarpova; Nadezhda,0,0,0,0
1668339866119,CSE 291,C00,102453,Vaccaro; Kristen Marie,0,0,0,0
1668339866119,CSE 291,D00,111343,Savage; Stefan,0,0,0,0
1668339866119,CSE 291,E00,116474,Claffy; Kimberly Claire,0,0,0,0
1668339866119,CSE 291,F00,116479,Pasquale; Joseph,0,0,0,0
1668339866602,CSE 293,001,119111,Bafna; Vineet,9999,0,9999,0
1668339866602,CSE 293,002,119118,Bellare; Mihir,9999,0,9999,0
1668339866602,CSE 293,003,119122,Berg-Kirkpatrick; Taylor D,9999,0,9999,0
1668339866602,CSE 293,004,119135,Christensen; Henrik I,9999,0,9999,0
1668339866602,CSE 293,005,119142,Cottrell; Garrison W,9999,0,9999,0
1668339866602,CSE 293,006,119146,Deutsch; Alin Bernard,9999,0,9999,0
1668339866602,CSE 293,007,119159,Esmaeilzadeh; Hadi,9999,0,9999,0
1668339866602,CSE 293,008,119166,Freund; Yoav,9999,0,9999,0
1668339866602,CSE 293,009,119170,Griswold; William G.,9999,0,9999,0
1668339866602,CSE 293,010,119183,Gymrek; Melissa Ann,9999,0,9999,0
1668339866602,CSE 293,011,119190,Heninger; Nadia A,9999,0,9999,0
1668339866602,CSE 293,012,119230,Impagliazzo; Russell,9999,0,9999,0
1668339866602,CSE 293,013,119232,Jhala; Ranjit,9999,0,9999,0
1668339866602,CSE 293,014,119233,Kahng; Andrew Byun,9999,0,9999,0
1668339866602,CSE 293,015,119298,Kane; Daniel Mertz,9999,0,9999,0
1668339866602,CSE 293,016,119299,Kriegman; David J,9999,0,9999,0
1668339866602,CSE 293,017,119300,Kumar; Arun Kumar,9999,0,9999,0
1668339866602,CSE 293,018,119301,Lerner; Sorin,9999,0,9999,0
1668339866602,CSE 293,019,119302,Lovett; Shachar,9999,0,9999,0
1668339866602,CSE 293,020,119303,McAuley; Julian John,9999,0,9999,0
1668339866602,CSE 293,021,119304,Micciancio; Daniele,9999,0,9999,0
1668339866602,CSE 293,022,119367,Orailoglu; Alex,9999,0,9999,0
1668339866602,CSE 293,023,119382,Paturi; Ramamohan,9999,0,9999,0
1668339866602,CSE 293,024,119404,Polikarpova; Nadezhda,9999,0,9999,0
1668339866602,CSE 293,025,119406,Politz; Joseph Gibbs,9999,0,9999,0
1668339866602,CSE 293,026,119411,Porter; George M,9999,0,9999,0
1668339866602,CSE 293,027,119414,Porter; Leonard Emerson,9999,0,9999,0
1668339866602,CSE 293,028,119416,Ramamoorthi; Ravi,9999,0,9999,0
1668339866602,CSE 293,029,119417,Sahoo; Debashis,9999,0,9999,0
1668339866602,CSE 293,030,119420,Saul; Lawrence,9999,0,9999,0
1668339866602,CSE 293,031,119421,Savage; Stefan,9999,0,9999,0
1668339866602,CSE 293,032,119425,Schulze; Jurgen P.,9999,0,9999,0
1668339866602,CSE 293,033,119426,Snoeren; Alex C.,9999,0,9999,0
1668339866602,CSE 293,034,119428,Shang; Jingbo,9999,0,9999,0
1668339866602,CSE 293,035,119430,Stefan; Deian,9999,0,9999,0
1668339866602,CSE 293,036,119431,Su; Hao,9999,0,9999,0
1668339866602,CSE 293,037,119433,Swanson; Steven James,9999,0,9999,0
1668339866602,CSE 293,038,119435,Tullsen; Dean Michael,9999,0,9999,0
1668339866602,CSE 293,039,119483,Voelker; Geoffrey M.,9999,0,9999,0
1668339866602,CSE 293,040,119537,Zhao; Jishen,9999,0,9999,0
1668339866602,CSE 293,041,119538,Zhou; Yuan-Yuan,9999,0,9999,0
1668339866602,CSE 293,042,119539,Gao; Sicun,9999,0,9999,0
1668339866602,CSE 293,043,119540,Weibel; Nadir,9999,0,9999,0
1668339866602,CSE 293,044,119541,Gupta; Rajesh K.,9999,0,9999,0
1668339866602,CSE 293,045,126410,Vaccaro; Kristen Marie,9999,0,9999,0
1668339866602,CSE 293,046,126411,Klemke; Richard,9999,0,9999,0
1668339867030,CSE 294,A00,102459,Voelker; Geoffrey M.,0,0,0,0
1668339867030,CSE 294,B00,111322,Orailoglu; Alex,0,0,0,0
1668339867457,DSE 201,A00,096914,Deutsch; Alin Bernard,30,0,30,0
1668339867881,DSE 210,A00,096915,Dasgupta; Sanjoy,30,0,30,0
1668339868309,DSE 260A,A00,096916,Altintas De Callaf; Ilkay,30,0,30,0
1668339868829,ECE 200,001,103586,Antipa; Nicholas A,9999,0,9999,0
1668339868829,ECE 200,002,103587,Atanasov; Nikolay A.,9999,0,9999,0
1668339868829,ECE 200,003,103588,Bharadia; Dinesh,9999,0,9999,0
1668339868829,ECE 200,004,103589,Cheng; Chung Kuan,9999,0,9999,0
1668339868829,ECE 200,005,103590,Cosman; Pamela C.,9999,0,9999,0
1668339868829,ECE 200,006,103591,Dayeh; Shadi Ahmad,9999,0,9999,0
1668339868829,ECE 200,007,103592,Fainman; Yeshaiahu,9999,0,9999,0
1668339868829,ECE 200,008,103593,Ford; Joseph Earl,9999,0,9999,0
1668339868829,ECE 200,009,103594,Franceschetti; Massimo,9999,0,9999,0
1668339868829,ECE 200,010,103595,Fullerton; Eric E,9999,0,9999,0
1668339868829,ECE 200,011,103596,Galton; Ian A,9999,0,9999,0
1668339868829,ECE 200,012,103597,Gilja; Vikash,9999,0,9999,0
1668339868829,ECE 200,013,103598,Hall; Drew A.,9999,0,9999,0
1668339868829,ECE 200,014,103599,Hsueh; Tzu-Chien,9999,0,9999,0
1668339868829,ECE 200,015,103600,Javidi; Tara,9999,0,9999,0
1668339868829,ECE 200,016,103601,Kahng; Andrew Byun,9999,0,9999,0
1668339868829,ECE 200,017,103602,Kim; Young-Han,9999,0,9999,0
1668339868829,ECE 200,018,103603,Koushanfar; Farinaz,9999,0,9999,0
1668339868829,ECE 200,019,103604,Kuzum; Duygu,9999,0,9999,0
1668339868829,ECE 200,020,103605,Le; Hanh-Phuc,9999,0,9999,0
1668339868829,ECE 200,021,103606,Lin; Bill,9999,0,9999,0
1668339868829,ECE 200,022,103607,Liu; Zhaowei,9998,0,9999,1
1668339868829,ECE 200,023,103608,Lo; Yu-Hwa,9999,0,9999,0
1668339868829,ECE 200,024,103609,Lomakin; Vitaliy,9999,0,9999,0
1668339868829,ECE 200,025,103610,Mercier; Patrick Philip,9999,0,9999,0
1668339868829,ECE 200,026,103611,Meyer; Florian,9999,0,9999,0
1668339868829,ECE 200,027,103612,Milstein; Laurence B.,9999,0,9999,0
1668339868829,ECE 200,028,103613,Mir Arabbaygi; Siavash,9999,0,9999,0
1668339868829,ECE 200,029,103614,Mookherjea; Shayan,9999,0,9999,0
1668339868829,ECE 200,030,103615,Morris; Karcher William,9999,0,9999,0
1668339868829,ECE 200,031,103616,Ng; Tse Nga,9999,0,9999,0
1668339868829,ECE 200,032,103617,Nguyen; Truong Quang,9999,0,9999,0
1668339868829,ECE 200,033,103618,Nomura; Kenji,9999,0,9999,0
1668339868829,ECE 200,034,103619,Orlitsky; Alon,9999,0,9999,0
1668339868829,ECE 200,035,103620,Pal; Piya,9999,0,9999,0
1668339868829,ECE 200,036,103621,Papen; George C.,9999,0,9999,0
1668339868829,ECE 200,037,103622,Radic; Stojan,9999,0,9999,0
1668339868829,ECE 200,038,103623,Rao; Bhaskar D.,9999,0,9999,0
1668339868829,ECE 200,039,103624,Rao; Ramesh R,9999,0,9999,0
1668339868829,ECE 200,040,103625,Rebeiz; Gabriel,9999,0,9999,0
1668339868829,ECE 200,041,103626,Sanford; John R,9999,0,9999,0
1668339868829,ECE 200,042,103627,Siegel; Paul H.,9999,0,9999,0
1668339868829,ECE 200,043,103628,Sievenpiper; Daniel F.,9999,0,9999,0
1668339868829,ECE 200,044,103629,Sworder; David D.,9999,0,9999,0
1668339868829,ECE 200,045,103630,Taur; Yuan,9999,0,9999,0
1668339868829,ECE 200,046,103631,Touri; Behrouz,9999,0,9999,0
1668339868829,ECE 200,047,103632,Trivedi; Mohan M.,9999,0,9999,0
1668339868829,ECE 200,048,103633,Vasconcelos; Nuno,9999,0,9999,0
1668339868829,ECE 200,049,103634,Wang; Xiaolong,9999,0,9999,0
1668339868829,ECE 200,050,103635,Xie; Pengtao,9999,0,9999,0
1668339868829,ECE 200,051,103636,Yip; Michael,9999,0,9999,0
1668339868829,ECE 200,052,103637,Zeger; Kenneth A.,999,0,999,0
1668339868829,ECE 200,053,103638,Zhang; Xinyu,9999,0,9999,0
1668339868829,ECE 200,054,103639,Turakhia; Yatish Girish,9999,0,9999,0
1668339868829,ECE 200,055,103640,Kang; Mingu,9999,0,9999,0
1668339868829,ECE 200,056,103641,Shi; Yuanyuan,9999,0,9999,0
1668339868829,ECE 200,057,103642,Wang; Edward Jay,9999,0,9999,0
1668339868829,ECE 200,058,103643,Zheng; Yang,9999,0,9999,0
1668339869258,ECE 202,A00,103644,Kuzum; Duygu,0,0,0,0
1668339869684,ECE 212BN,A00,103646,Ng; Tse Nga,0,0,0,0
1668339870109,ECE 221,A00,111493,Staff,0,0,0,0
1668339870531,ECE 222B,A00,103647,Lomakin; Vitaliy,0,0,0,0
1668339870960,ECE 230B,A00,103648,Taur; Yuan,0,0,0,0
1668339871387,ECE 238B,A00,103649,Garay; Javier,0,0,0,0
1668339871812,ECE 240B,A00,112900,Fainman; Yeshaiahu,0,0,0,0
1668339872236,ECE 247A,A00,103650,Jokerst; Jesse Vincent,0,0,0,0
1668339872659,ECE 247B,A00,103651,Wang; Joseph,0,0,0,0
1668339873092,ECE 250,A00,103652,Siegel; Paul H.,0,0,0,0
1668339873520,ECE 251A,A00,103654,Rao; Bhaskar D.,0,0,0,0
1668339873943,ECE 257B,A00,103655,Bharadia; Dinesh,0,0,0,0
1668339874367,ECE 258A,A00,103656,Milstein; Laurence B.,0,0,0,0
1668339874793,ECE 260B,A00,103658,Kang; Mingu,0,0,0,0
1668339875221,ECE 264A,A00,103659,Galton; Ian A,0,0,0,0
1668339875646,ECE 265A,A00,103661,Gudem; Prasad S.S.,0,0,0,0
1668339876069,ECE 265D,A00,103662,Gudem; Prasad S.S.,0,0,0,0
1668339876496,ECE 268,A00,103663,Koushanfar; Farinaz,0,0,0,0
1668339876919,ECE 269,A01,103665,Pal; Piya,0,0,0,0
1668339877345,ECE 271B,A00,103666,Vasconcelos; Manuela,0,0,0,0
1668339877859,ECE 276A,A00,103667,Atanasov; Nikolay A.,0,0,0,0
1668339878289,ECE 277,A00,103668,An; Cheolhong,0,0,0,0
1668339878716,ECE 279,A00,117947,Hall; Drew A.,0,0,0,0
1668339879562,ECE 283,A00,103670,Hsueh; Tzu-Chien,0,0,0,0
1668339879990,ECE 284,A00,103671,Turakhia; Yatish Girish,0,0,0,0
1668339880417,ECE 285,A00,103672,Zheng; Yang,0,0,0,0
1668339880417,ECE 285,B00,103673,Sworder; David D.,0,0,0,0
1668339880845,ECE 287,A00,103676,Javidi; Tara,0,0,0,0
1668339881272,MATH 200B,A00,098023,Salehi Golsefidy; Alireza,12,0,15,3
1668339881696,MATH 202B,A00,098024,Rhoades; Brendon Patrick,9,0,15,6
1668339882122,MATH 203B,A00,098025,Oprea; Dragos N.,10,0,15,5
1668339882552,MATH 204B,A00,098026,Sorensen; Claus M,13,0,15,2
1668339882984,MATH 208,A00,098027,Izadi; Elham,7,0,10,3
1668339883410,MATH 209,A00,098028,Pollack; Aaron,10,0,10,0
1668339883835,MATH 211A,A00,112919,Rogalski; Daniel,9,0,10,1
1668339884259,MATH 211B,A00,112920,Seward; Brandon M.,9,0,10,1
1668339884688,MATH 218,A00,098029,Li; Bo,10,0,10,0
1668339885113,MATH 220B,A00,098030,Novak; Jonathan I,11,0,15,4
1668339885535,MATH 221A,A00,098031,Ebenfelt; Peter F,13,0,15,2
1668339885961,MATH 231B,A00,098032,Zlatos; Andrej,12,0,15,3
1668339886392,MATH 240B,A00,098033,Ni; Lei,9,0,15,6
1668339886818,MATH 243,A00,098034,Jekel; David Andrew,10,0,10,0
1668339887243,MATH 245A,A00,098035,Nie; Jiawang,0,0,15,16
1668339887667,MATH 248,A00,098036,Bejenaru; Ioan,10,0,10,0
1668339888093,MATH 250B,A00,098037,Spolaor; Luca,14,0,15,1
1668339888519,MATH 258,A00,098038,Ni; Lei,10,0,10,0
1668339888947,MATH 264B,A00,098041,Rhoades; Brendon Patrick,9,0,15,6
1668339889370,MATH 268,A00,098042,Buss; Samuel R,10,0,10,0
1668339889797,MATH 269,A00,098043,Rhoades; Brendon Patrick,10,0,10,0
1668339890221,MATH 270B,A00,098044,Li; Bo,10,0,15,5
1668339890650,MATH 272B,A00,098045,Holst; Michael J,13,0,15,2
1668339891080,MATH 273A,A00,098046,Tian; Xiaochuan,10,0,15,5
1668339891514,MATH 275,A01,098048,Tian; Xiaochuan,6,0,10,4
1668339891938,MATH 278A,A00,098049,Holst; Michael J,8,0,10,2
1668339892364,MATH 278B,A00,098050,Cloninger; Alexander,10,0,10,0
1668339892791,MATH 278C,A00,098051,Nie; Jiawang,7,0,10,3
1668339893221,MATH 280B,A00,098052,Zheng; Tianyi,8,0,15,7
1668339893645,MATH 281B,A00,098053,Bradic; Jelena,1,0,15,14
1668339894068,MATH 282B,A00,098054,Arias-Castro; Ery,0,0,15,15
1668339894494,MATH 285,A00,098055,Fitzsimmons; Patrick J,0,0,15,17
1668339894918,MATH 287B,A00,098056,Arias-Castro; Ery,2,0,15,13
1668339895347,MATH 288,A00,098057,Agarwal; Pooja,9,0,10,1
1668339895347,MATH 288,B00,098058,Zhang; Danna,8,0,10,2
1668339895347,MATH 288,C00,098059,Williams; Ruth J,9,0,10,1
1668339895776,MATH 290B,A00,098060,Roberts; Justin Deritter,13,0,15,2
1668339896202,MATH 292,A00,098061,Belmont; Eva Kinoshita,10,0,10,0
1668339896628,MATH 295,A00,098062,Suk; Andrew Hoon,48,0,50,2
1668339897054,MATH 296,A00,098063,Novak; Jonathan I,20,0,20,0
1668339897483,MATH 297,001,098064,Gamst; Anthony Collins,9997,0,9999,2
1668340398310,COGS 205,A00,101395,Chiba; Andrea,19,0,20,1
1668340398833,COGS 210B,001,101404,Greene; Deanna Jacquelyn,9998,0,9999,1
1668340398833,COGS 210B,002,101417,Xia; Haijun,9999,0,9999,0
1668340398833,COGS 210B,003,101422,Nitz; Douglas A.,9999,0,9999,0
1668340398833,COGS 210B,004,101423,Hollan; James D.,9998,0,9999,1
1668340398833,COGS 210B,005,101424,Deak; Gedeon O.,9998,0,9999,1
1668340398833,COGS 210B,006,101425,Rossano; Federico,9999,0,9999,0
1668340399258,COGS 211B,A00,101427,Coulson; Seana M,9996,0,9999,3
1668340399682,COGS 220,A00,101428,Hollan; James D.,0,0,25,25
1668340400107,COGS 229,A00,101429,Dow; Steven P,18,0,25,7
1668340400535,COGS 230,A00,101430,Klemmer; Scott R,11,0,17,6
1668340400961,COGS 234,A00,101431,Xia; Haijun,1,0,25,24
1668340401387,COGS 260,A00,101432,Kiyonaga; Anastasia,21,0,25,4
1668340401387,COGS 260,B00,101433,Kirsh; David Joel,15,0,25,10
1668340401814,CSE 202,A00,102371,Impagliazzo; Russell,0,0,0,0
1668340402245,CSE 203B,A01,102373,Cheng; Chung Kuan,0,0,0,0
1668340402675,CSE 208,A00,102374,Micciancio; Daniele,0,0,0,0
1668340403099,CSE 209A,A00,112895,Impagliazzo; Russell,0,0,15,15
1668340403527,CSE 209B,A00,108005,Bellare; Mihir,0,0,0,0
1668340403953,CSE 210,A00,113163,Coblenz; Michael J,0,0,0,0
1668340404384,CSE 219,A00,106111,Dow; Steven P,0,0,20,20
1668340404811,CSE 221,A00,102376,Voelker; Geoffrey M.,0,0,0,0
1668340405237,CSE 224,A01,102378,Porter; George M,0,0,0,0
1668340405660,CSE 229A,A00,102379,Savage; Stefan,0,0,0,0
1668340406088,CSE 229C,A00,102380,Munyaka; Imani N. S.,0,0,0,0
1668340406513,CSE 232B,A00,102382,Deutsch; Alin Bernard,0,0,0,0
1668340406937,CSE 234,A01,112904,Kumar; Arun Kumar,0,0,0,0
1668340407362,CSE 237A,A00,102383,Rosing; Tajana Simunic,0,0,0,0
1668340407786,CSE 239A,A00,102384,Deutsch; Alin Bernard,0,0,0,0
1668340408215,CSE 239B,A00,102385,Polikarpova; Nadezhda,0,0,0,0
1668340408638,CSE 240A,A00,102386,Pannuto; Patrick William,0,0,0,0
1668340409063,CSE 240B,A00,102387,Zhao; Jishen,0,0,0,0
1668340409490,CSE 241A,A00,106406,Kang; Mingu,0,0,0,0
1668340409922,CSE 249B,A00,102388,Kahng; Andrew Byun,0,0,8,8
1668340410351,CSE 251B,A01,102392,Cottrell; Garrison W,0,0,0,0
1668340410351,CSE 251B,A02,102393,Cottrell; Garrison W,0,0,0,0
1668340410777,CSE 252B,A00,102394,Ochoa; Benjamin Lawrence,0,0,0,0
1668340411203,CSE 257,A01,102396,Gao; Sicun,0,0,0,0
1668340411627,CSE 272,A00,102397,Li; Tzumao,0,0,0,0
1668340412057,CSE 274,A00,111323,Chern; Albert Ren-Haur,0,0,0,0
1668340412485,CSE 282,A00,102398,Pevzner; Pavel Arkadjevich,0,0,0,0
1668340412911,CSE 284,A00,114175,Gymrek; Melissa Ann,0,0,0,0
1668340413339,CSE 290,A00,102399,Chandraker; Manmohan Krishna,0,0,0,0
1668340413339,CSE 290,B00,102400,Vaccaro; Kristen Marie,0,0,25,25
1668340413339,CSE 290,C00,102414,Pannuto; Patrick William,0,0,25,25
1668340413339,CSE 290,D00,102427,Pevzner; Pavel Arkadjevich,0,0,0,0
1668340413339,CSE 290,E00,102429,Zhao; Jishen,0,0,0,0
1668340413339,CSE 290,F00,102436,Tullsen; Dean Michael,0,0,0,0
1668340413339,CSE 290,G00,102440,Christensen; Henrik I,0,0,20,20
1668340413767,CSE 291,A00,102443,Su; Hao,0,0,0,0
1668340413767,CSE 291,B00,102448,Polikarpova; Nadezhda,0,0,0,0
1668340413767,CSE 291,C00,102453,Vaccaro; Kristen Marie,0,0,0,0
1668340413767,CSE 291,D00,111343,Savage; Stefan,0,0,0,0
1668340413767,CSE 291,E00,116474,Claffy; Kimberly Claire,0,0,0,0
1668340413767,CSE 291,F00,116479,Pasquale; Joseph,0,0,0,0
1668340414244,CSE 293,001,119111,Bafna; Vineet,9999,0,9999,0
1668340414244,CSE 293,002,119118,Bellare; Mihir,9999,0,9999,0
1668340414244,CSE 293,003,119122,Berg-Kirkpatrick; Taylor D,9999,0,9999,0
1668340414244,CSE 293,004,119135,Christensen; Henrik I,9999,0,9999,0
1668340414244,CSE 293,005,119142,Cottrell; Garrison W,9999,0,9999,0
1668340414244,CSE 293,006,119146,Deutsch; Alin Bernard,9999,0,9999,0
1668340414244,CSE 293,007,119159,Esmaeilzadeh; Hadi,9999,0,9999,0
1668340414244,CSE 293,008,119166,Freund; Yoav,9999,0,9999,0
1668340414244,CSE 293,009,119170,Griswold; William G.,9999,0,9999,0
1668340414244,CSE 293,010,119183,Gymrek; Melissa Ann,9999,0,9999,0
1668340414244,CSE 293,011,119190,Heninger; Nadia A,9999,0,9999,0
1668340414244,CSE 293,012,119230,Impagliazzo; Russell,9999,0,9999,0
1668340414244,CSE 293,013,119232,Jhala; Ranjit,9999,0,9999,0
1668340414244,CSE 293,014,119233,Kahng; Andrew Byun,9999,0,9999,0
1668340414244,CSE 293,015,119298,Kane; Daniel Mertz,9999,0,9999,0
1668340414244,CSE 293,016,119299,Kriegman; David J,9999,0,9999,0
1668340414244,CSE 293,017,119300,Kumar; Arun Kumar,9999,0,9999,0
1668340414244,CSE 293,018,119301,Lerner; Sorin,9999,0,9999,0
1668340414244,CSE 293,019,119302,Lovett; Shachar,9999,0,9999,0
1668340414244,CSE 293,020,119303,McAuley; Julian John,9999,0,9999,0
1668340414244,CSE 293,021,119304,Micciancio; Daniele,9999,0,9999,0
1668340414244,CSE 293,022,119367,Orailoglu; Alex,9999,0,9999,0
1668340414244,CSE 293,023,119382,Paturi; Ramamohan,9999,0,9999,0
1668340414244,CSE 293,024,119404,Polikarpova; Nadezhda,9999,0,9999,0
1668340414244,CSE 293,025,119406,Politz; Joseph Gibbs,9999,0,9999,0
1668340414244,CSE 293,026,119411,Porter; George M,9999,0,9999,0
1668340414244,CSE 293,027,119414,Porter; Leonard Emerson,9999,0,9999,0
1668340414244,CSE 293,028,119416,Ramamoorthi; Ravi,9999,0,9999,0
1668340414244,CSE 293,029,119417,Sahoo; Debashis,9999,0,9999,0
1668340414244,CSE 293,030,119420,Saul; Lawrence,9999,0,9999,0
1668340414244,CSE 293,031,119421,Savage; Stefan,9999,0,9999,0
1668340414244,CSE 293,032,119425,Schulze; Jurgen P.,9999,0,9999,0
1668340414244,CSE 293,033,119426,Snoeren; Alex C.,9999,0,9999,0
1668340414244,CSE 293,034,119428,Shang; Jingbo,9999,0,9999,0
1668340414244,CSE 293,035,119430,Stefan; Deian,9999,0,9999,0
1668340414244,CSE 293,036,119431,Su; Hao,9999,0,9999,0
1668340414244,CSE 293,037,119433,Swanson; Steven James,9999,0,9999,0
1668340414244,CSE 293,038,119435,Tullsen; Dean Michael,9999,0,9999,0
1668340414244,CSE 293,039,119483,Voelker; Geoffrey M.,9999,0,9999,0
1668340414244,CSE 293,040,119537,Zhao; Jishen,9999,0,9999,0
1668340414244,CSE 293,041,119538,Zhou; Yuan-Yuan,9999,0,9999,0
1668340414244,CSE 293,042,119539,Gao; Sicun,9999,0,9999,0
1668340414244,CSE 293,043,119540,Weibel; Nadir,9999,0,9999,0
1668340414244,CSE 293,044,119541,Gupta; Rajesh K.,9999,0,9999,0
1668340414244,CSE 293,045,126410,Vaccaro; Kristen Marie,9999,0,9999,0
1668340414244,CSE 293,046,126411,Klemke; Richard,9999,0,9999,0
1668340414676,CSE 294,A00,102459,Voelker; Geoffrey M.,0,0,0,0
1668340414676,CSE 294,B00,111322,Orailoglu; Alex,0,0,0,0
1668340415104,DSE 201,A00,096914,Deutsch; Alin Bernard,30,0,30,0
1668340415530,DSE 210,A00,096915,Dasgupta; Sanjoy,30,0,30,0
1668340415956,DSE 260A,A00,096916,Altintas De Callaf; Ilkay,30,0,30,0
1668340416472,ECE 200,001,103586,Antipa; Nicholas A,9999,0,9999,0
1668340416472,ECE 200,002,103587,Atanasov; Nikolay A.,9999,0,9999,0
1668340416472,ECE 200,003,103588,Bharadia; Dinesh,9999,0,9999,0
1668340416472,ECE 200,004,103589,Cheng; Chung Kuan,9999,0,9999,0
1668340416472,ECE 200,005,103590,Cosman; Pamela C.,9999,0,9999,0
1668340416472,ECE 200,006,103591,Dayeh; Shadi Ahmad,9999,0,9999,0
1668340416472,ECE 200,007,103592,Fainman; Yeshaiahu,9999,0,9999,0
1668340416472,ECE 200,008,103593,Ford; Joseph Earl,9999,0,9999,0
1668340416472,ECE 200,009,103594,Franceschetti; Massimo,9999,0,9999,0
1668340416472,ECE 200,010,103595,Fullerton; Eric E,9999,0,9999,0
1668340416472,ECE 200,011,103596,Galton; Ian A,9999,0,9999,0
1668340416472,ECE 200,012,103597,Gilja; Vikash,9999,0,9999,0
1668340416472,ECE 200,013,103598,Hall; Drew A.,9999,0,9999,0
1668340416472,ECE 200,014,103599,Hsueh; Tzu-Chien,9999,0,9999,0
1668340416472,ECE 200,015,103600,Javidi; Tara,9999,0,9999,0
1668340416472,ECE 200,016,103601,Kahng; Andrew Byun,9999,0,9999,0
1668340416472,ECE 200,017,103602,Kim; Young-Han,9999,0,9999,0
1668340416472,ECE 200,018,103603,Koushanfar; Farinaz,9999,0,9999,0
1668340416472,ECE 200,019,103604,Kuzum; Duygu,9999,0,9999,0
1668340416472,ECE 200,020,103605,Le; Hanh-Phuc,9999,0,9999,0
1668340416472,ECE 200,021,103606,Lin; Bill,9999,0,9999,0
1668340416472,ECE 200,022,103607,Liu; Zhaowei,9998,0,9999,1
1668340416472,ECE 200,023,103608,Lo; Yu-Hwa,9999,0,9999,0
1668340416472,ECE 200,024,103609,Lomakin; Vitaliy,9999,0,9999,0
1668340416472,ECE 200,025,103610,Mercier; Patrick Philip,9999,0,9999,0
1668340416472,ECE 200,026,103611,Meyer; Florian,9999,0,9999,0
1668340416472,ECE 200,027,103612,Milstein; Laurence B.,9999,0,9999,0
1668340416472,ECE 200,028,103613,Mir Arabbaygi; Siavash,9999,0,9999,0
1668340416472,ECE 200,029,103614,Mookherjea; Shayan,9999,0,9999,0
1668340416472,ECE 200,030,103615,Morris; Karcher William,9999,0,9999,0
1668340416472,ECE 200,031,103616,Ng; Tse Nga,9999,0,9999,0
1668340416472,ECE 200,032,103617,Nguyen; Truong Quang,9999,0,9999,0
1668340416472,ECE 200,033,103618,Nomura; Kenji,9999,0,9999,0
1668340416472,ECE 200,034,103619,Orlitsky; Alon,9999,0,9999,0
1668340416472,ECE 200,035,103620,Pal; Piya,9999,0,9999,0
1668340416472,ECE 200,036,103621,Papen; George C.,9999,0,9999,0
1668340416472,ECE 200,037,103622,Radic; Stojan,9999,0,9999,0
1668340416472,ECE 200,038,103623,Rao; Bhaskar D.,9999,0,9999,0
1668340416472,ECE 200,039,103624,Rao; Ramesh R,9999,0,9999,0
1668340416472,ECE 200,040,103625,Rebeiz; Gabriel,9999,0,9999,0
1668340416472,ECE 200,041,103626,Sanford; John R,9999,0,9999,0
1668340416472,ECE 200,042,103627,Siegel; Paul H.,9999,0,9999,0
1668340416472,ECE 200,043,103628,Sievenpiper; Daniel F.,9999,0,9999,0
1668340416472,ECE 200,044,103629,Sworder; David D.,9999,0,9999,0
1668340416472,ECE 200,045,103630,Taur; Yuan,9999,0,9999,0
1668340416472,ECE 200,046,103631,Touri; Behrouz,9999,0,9999,0
1668340416472,ECE 200,047,103632,Trivedi; Mohan M.,9999,0,9999,0
1668340416472,ECE 200,048,103633,Vasconcelos; Nuno,9999,0,9999,0
1668340416472,ECE 200,049,103634,Wang; Xiaolong,9999,0,9999,0
1668340416472,ECE 200,050,103635,Xie; Pengtao,9999,0,9999,0
1668340416472,ECE 200,051,103636,Yip; Michael,9999,0,9999,0
1668340416472,ECE 200,052,103637,Zeger; Kenneth A.,999,0,999,0
1668340416472,ECE 200,053,103638,Zhang; Xinyu,9999,0,9999,0
1668340416472,ECE 200,054,103639,Turakhia; Yatish Girish,9999,0,9999,0
1668340416472,ECE 200,055,103640,Kang; Mingu,9999,0,9999,0
1668340416472,ECE 200,056,103641,Shi; Yuanyuan,9999,0,9999,0
1668340416472,ECE 200,057,103642,Wang; Edward Jay,9999,0,9999,0
1668340416472,ECE 200,058,103643,Zheng; Yang,9999,0,9999,0
1668340416897,ECE 202,A00,103644,Kuzum; Duygu,0,0,0,0
1668340417321,ECE 212BN,A00,103646,Ng; Tse Nga,0,0,0,0
1668340417750,ECE 221,A00,111493,Staff,0,0,0,0
1668340418177,ECE 222B,A00,103647,Lomakin; Vitaliy,0,0,0,0
1668340418607,ECE 230B,A00,103648,Taur; Yuan,0,0,0,0
1668340419036,ECE 238B,A00,103649,Garay; Javier,0,0,0,0
1668340419460,ECE 240B,A00,112900,Fainman; Yeshaiahu,0,0,0,0
1668340419886,ECE 247A,A00,103650,Jokerst; Jesse Vincent,0,0,0,0
1668340420312,ECE 247B,A00,103651,Wang; Joseph,0,0,0,0
1668340420742,ECE 250,A00,103652,Siegel; Paul H.,0,0,0,0
1668340421173,ECE 251A,A00,103654,Rao; Bhaskar D.,0,0,0,0
1668340421598,ECE 257B,A00,103655,Bharadia; Dinesh,0,0,0,0
1668340422023,ECE 258A,A00,103656,Milstein; Laurence B.,0,0,0,0
1668340422448,ECE 260B,A00,103658,Kang; Mingu,0,0,0,0
1668340422879,ECE 264A,A00,103659,Galton; Ian A,0,0,0,0
1668340423308,ECE 265A,A00,103661,Gudem; Prasad S.S.,0,0,0,0
1668340423732,ECE 265D,A00,103662,Gudem; Prasad S.S.,0,0,0,0
1668340424158,ECE 268,A00,103663,Koushanfar; Farinaz,0,0,0,0
1668340424584,ECE 269,A01,103665,Pal; Piya,0,0,0,0
1668340425014,ECE 271B,A00,103666,Vasconcelos; Manuela,0,0,0,0
1668340425438,ECE 276A,A00,103667,Atanasov; Nikolay A.,0,0,0,0
1668340425864,ECE 277,A00,103668,An; Cheolhong,0,0,0,0
1668340426289,ECE 279,A00,117947,Hall; Drew A.,0,0,0,0
1668340427143,ECE 283,A00,103670,Hsueh; Tzu-Chien,0,0,0,0
1668340427569,ECE 284,A00,103671,Turakhia; Yatish Girish,0,0,0,0
1668340427997,ECE 285,A00,103672,Zheng; Yang,0,0,0,0
1668340427997,ECE 285,B00,103673,Sworder; David D.,0,0,0,0
1668340428422,ECE 287,A00,103676,Javidi; Tara,0,0,0,0
1668340428857,MATH 200B,A00,098023,Salehi Golsefidy; Alireza,12,0,15,3
1668340429283,MATH 202B,A00,098024,Rhoades; Brendon Patrick,9,0,15,6
1668340429709,MATH 203B,A00,098025,Oprea; Dragos N.,10,0,15,5
1668340430132,MATH 204B,A00,098026,Sorensen; Claus M,13,0,15,2
1668340430561,MATH 208,A00,098027,Izadi; Elham,7,0,10,3
1668340431006,MATH 209,A00,098028,Pollack; Aaron,10,0,10,0
1668340431437,MATH 211A,A00,112919,Rogalski; Daniel,9,0,10,1
1668340431862,MATH 211B,A00,112920,Seward; Brandon M.,9,0,10,1
1668340432288,MATH 218,A00,098029,Li; Bo,10,0,10,0
1668340432718,MATH 220B,A00,098030,Novak; Jonathan I,11,0,15,4
1668340433142,MATH 221A,A00,098031,Ebenfelt; Peter F,13,0,15,2
1668340433567,MATH 231B,A00,098032,Zlatos; Andrej,12,0,15,3
1668340433994,MATH 240B,A00,098033,Ni; Lei,9,0,15,6
1668340434418,MATH 243,A00,098034,Jekel; David Andrew,10,0,10,0
1668340434849,MATH 245A,A00,098035,Nie; Jiawang,0,0,15,16
1668340435278,MATH 248,A00,098036,Bejenaru; Ioan,10,0,10,0
1668340435704,MATH 250B,A00,098037,Spolaor; Luca,14,0,15,1
1668340436127,MATH 258,A00,098038,Ni; Lei,10,0,10,0
1668340436557,MATH 264B,A00,098041,Rhoades; Brendon Patrick,9,0,15,6
1668340436981,MATH 268,A00,098042,Buss; Samuel R,10,0,10,0
1668340437410,MATH 269,A00,098043,Rhoades; Brendon Patrick,10,0,10,0
1668340437837,MATH 270B,A00,098044,Li; Bo,10,0,15,5
1668340438268,MATH 272B,A00,098045,Holst; Michael J,13,0,15,2
1668340438698,MATH 273A,A00,098046,Tian; Xiaochuan,10,0,15,5
1668340439124,MATH 275,A01,098048,Tian; Xiaochuan,6,0,10,4
1668340439548,MATH 278A,A00,098049,Holst; Michael J,8,0,10,2
1668340439972,MATH 278B,A00,098050,Cloninger; Alexander,10,0,10,0
1668340440401,MATH 278C,A00,098051,Nie; Jiawang,7,0,10,3
1668340440829,MATH 280B,A00,098052,Zheng; Tianyi,8,0,15,7
1668340441254,MATH 281B,A00,098053,Bradic; Jelena,1,0,15,14
1668340441682,MATH 282B,A00,098054,Arias-Castro; Ery,0,0,15,15
1668340442186,MATH 285,A00,098055,Fitzsimmons; Patrick J,0,0,15,17
1668340442611,MATH 287B,A00,098056,Arias-Castro; Ery,2,0,15,13
1668340443037,MATH 288,A00,098057,Agarwal; Pooja,9,0,10,1
1668340443037,MATH 288,B00,098058,Zhang; Danna,8,0,10,2
1668340443037,MATH 288,C00,098059,Williams; Ruth J,9,0,10,1
1668340443466,MATH 290B,A00,098060,Roberts; Justin Deritter,13,0,15,2
1668340443895,MATH 292,A00,098061,Belmont; Eva Kinoshita,10,0,10,0
1668340444320,MATH 295,A00,098062,Suk; Andrew Hoon,48,0,50,2
1668340444747,MATH 296,A00,098063,Novak; Jonathan I,20,0,20,0
1668340445173,MATH 297,001,098064,Gamst; Anthony Collins,9997,0,9999,2
1668340947825,COGS 205,A00,101395,Chiba; Andrea,19,0,20,1
1668340948253,COGS 210B,001,101404,Greene; Deanna Jacquelyn,9998,0,9999,1
1668340948253,COGS 210B,002,101417,Xia; Haijun,9999,0,9999,0
1668340948253,COGS 210B,003,101422,Nitz; Douglas A.,9999,0,9999,0
1668340948253,COGS 210B,004,101423,Hollan; James D.,9998,0,9999,1
1668340948253,COGS 210B,005,101424,Deak; Gedeon O.,9998,0,9999,1
1668340948253,COGS 210B,006,101425,Rossano; Federico,9999,0,9999,0
1668340948685,COGS 211B,A00,101427,Coulson; Seana M,9996,0,9999,3
1668340949109,COGS 220,A00,101428,Hollan; James D.,0,0,25,25
1668340949536,COGS 229,A00,101429,Dow; Steven P,18,0,25,7
1668340949965,COGS 230,A00,101430,Klemmer; Scott R,11,0,17,6
1668340950389,COGS 234,A00,101431,Xia; Haijun,1,0,25,24
1668340950819,COGS 260,A00,101432,Kiyonaga; Anastasia,21,0,25,4
1668340950819,COGS 260,B00,101433,Kirsh; David Joel,15,0,25,10
1668340951246,CSE 202,A00,102371,Impagliazzo; Russell,0,0,0,0
1668340951672,CSE 203B,A01,102373,Cheng; Chung Kuan,0,0,0,0
1668340952098,CSE 208,A00,102374,Micciancio; Daniele,0,0,0,0
1668340952534,CSE 209A,A00,112895,Impagliazzo; Russell,0,0,15,15
1668340952961,CSE 209B,A00,108005,Bellare; Mihir,0,0,0,0
1668340953386,CSE 210,A00,113163,Coblenz; Michael J,0,0,0,0
1668340953811,CSE 219,A00,106111,Dow; Steven P,0,0,20,20
1668340954236,CSE 221,A00,102376,Voelker; Geoffrey M.,0,0,0,0
1668340954667,CSE 224,A01,102378,Porter; George M,0,0,0,0
1668340955096,CSE 229A,A00,102379,Savage; Stefan,0,0,0,0
1668340955522,CSE 229C,A00,102380,Munyaka; Imani N. S.,0,0,0,0
1668340955950,CSE 232B,A00,102382,Deutsch; Alin Bernard,0,0,0,0
1668340956377,CSE 234,A01,112904,Kumar; Arun Kumar,0,0,0,0
1668340956807,CSE 237A,A00,102383,Rosing; Tajana Simunic,0,0,0,0
1668340957232,CSE 239A,A00,102384,Deutsch; Alin Bernard,0,0,0,0
1668340957661,CSE 239B,A00,102385,Polikarpova; Nadezhda,0,0,0,0
1668340958090,CSE 240A,A00,102386,Pannuto; Patrick William,0,0,0,0
1668340958519,CSE 240B,A00,102387,Zhao; Jishen,0,0,0,0
1668340958946,CSE 241A,A00,106406,Kang; Mingu,0,0,0,0
1668340959374,CSE 249B,A00,102388,Kahng; Andrew Byun,0,0,8,8
1668340959803,CSE 251B,A01,102392,Cottrell; Garrison W,0,0,0,0
1668340959803,CSE 251B,A02,102393,Cottrell; Garrison W,0,0,0,0
1668340960231,CSE 252B,A00,102394,Ochoa; Benjamin Lawrence,0,0,0,0
1668340960658,CSE 257,A01,102396,Gao; Sicun,0,0,0,0
1668340961089,CSE 272,A00,102397,Li; Tzumao,0,0,0,0
1668340961514,CSE 274,A00,111323,Chern; Albert Ren-Haur,0,0,0,0
1668340961945,CSE 282,A00,102398,Pevzner; Pavel Arkadjevich,0,0,0,0
1668340962369,CSE 284,A00,114175,Gymrek; Melissa Ann,0,0,0,0
1668340962798,CSE 290,A00,102399,Chandraker; Manmohan Krishna,0,0,0,0
1668340962798,CSE 290,B00,102400,Vaccaro; Kristen Marie,0,0,25,25
1668340962798,CSE 290,C00,102414,Pannuto; Patrick William,0,0,25,25
1668340962798,CSE 290,D00,102427,Pevzner; Pavel Arkadjevich,0,0,0,0
1668340962798,CSE 290,E00,102429,Zhao; Jishen,0,0,0,0
1668340962798,CSE 290,F00,102436,Tullsen; Dean Michael,0,0,0,0
1668340962798,CSE 290,G00,102440,Christensen; Henrik I,0,0,20,20
1668340963226,CSE 291,A00,102443,Su; Hao,0,0,0,0
1668340963226,CSE 291,B00,102448,Polikarpova; Nadezhda,0,0,0,0
1668340963226,CSE 291,C00,102453,Vaccaro; Kristen Marie,0,0,0,0
1668340963226,CSE 291,D00,111343,Savage; Stefan,0,0,0,0
1668340963226,CSE 291,E00,116474,Claffy; Kimberly Claire,0,0,0,0
1668340963226,CSE 291,F00,116479,Pasquale; Joseph,0,0,0,0
1668340963753,CSE 293,001,119111,Bafna; Vineet,9999,0,9999,0
1668340963753,CSE 293,002,119118,Bellare; Mihir,9999,0,9999,0
1668340963753,CSE 293,003,119122,Berg-Kirkpatrick; Taylor D,9999,0,9999,0
1668340963753,CSE 293,004,119135,Christensen; Henrik I,9999,0,9999,0
1668340963753,CSE 293,005,119142,Cottrell; Garrison W,9999,0,9999,0
1668340963753,CSE 293,006,119146,Deutsch; Alin Bernard,9999,0,9999,0
1668340963753,CSE 293,007,119159,Esmaeilzadeh; Hadi,9999,0,9999,0
1668340963753,CSE 293,008,119166,Freund; Yoav,9999,0,9999,0
1668340963753,CSE 293,009,119170,Griswold; William G.,9999,0,9999,0
1668340963753,CSE 293,010,119183,Gymrek; Melissa Ann,9999,0,9999,0
1668340963753,CSE 293,011,119190,Heninger; Nadia A,9999,0,9999,0
1668340963753,CSE 293,012,119230,Impagliazzo; Russell,9999,0,9999,0
1668340963753,CSE 293,013,119232,Jhala; Ranjit,9999,0,9999,0
1668340963753,CSE 293,014,119233,Kahng; Andrew Byun,9999,0,9999,0
1668340963753,CSE 293,015,119298,Kane; Daniel Mertz,9999,0,9999,0
1668340963753,CSE 293,016,119299,Kriegman; David J,9999,0,9999,0
1668340963753,CSE 293,017,119300,Kumar; Arun Kumar,9999,0,9999,0
1668340963753,CSE 293,018,119301,Lerner; Sorin,9999,0,9999,0
1668340963753,CSE 293,019,119302,Lovett; Shachar,9999,0,9999,0
1668340963753,CSE 293,020,119303,McAuley; Julian John,9999,0,9999,0
1668340963753,CSE 293,021,119304,Micciancio; Daniele,9999,0,9999,0
1668340963753,CSE 293,022,119367,Orailoglu; Alex,9999,0,9999,0
1668340963753,CSE 293,023,119382,Paturi; Ramamohan,9999,0,9999,0
1668340963753,CSE 293,024,119404,Polikarpova; Nadezhda,9999,0,9999,0
1668340963753,CSE 293,025,119406,Politz; Joseph Gibbs,9999,0,9999,0
1668340963753,CSE 293,026,119411,Porter; George M,9999,0,9999,0
1668340963753,CSE 293,027,119414,Porter; Leonard Emerson,9999,0,9999,0
1668340963753,CSE 293,028,119416,Ramamoorthi; Ravi,9999,0,9999,0
1668340963753,CSE 293,029,119417,Sahoo; Debashis,9999,0,9999,0
1668340963753,CSE 293,030,119420,Saul; Lawrence,9999,0,9999,0
1668340963753,CSE 293,031,119421,Savage; Stefan,9999,0,9999,0
1668340963753,CSE 293,032,119425,Schulze; Jurgen P.,9999,0,9999,0
1668340963753,CSE 293,033,119426,Snoeren; Alex C.,9999,0,9999,0
1668340963753,CSE 293,034,119428,Shang; Jingbo,9999,0,9999,0
1668340963753,CSE 293,035,119430,Stefan; Deian,9999,0,9999,0
1668340963753,CSE 293,036,119431,Su; Hao,9999,0,9999,0
1668340963753,CSE 293,037,119433,Swanson; Steven James,9999,0,9999,0
1668340963753,CSE 293,038,119435,Tullsen; Dean Michael,9999,0,9999,0
1668340963753,CSE 293,039,119483,Voelker; Geoffrey M.,9999,0,9999,0
1668340963753,CSE 293,040,119537,Zhao; Jishen,9999,0,9999,0
1668340963753,CSE 293,041,119538,Zhou; Yuan-Yuan,9999,0,9999,0
1668340963753,CSE 293,042,119539,Gao; Sicun,9999,0,9999,0
1668340963753,CSE 293,043,119540,Weibel; Nadir,9999,0,9999,0
1668340963753,CSE 293,044,119541,Gupta; Rajesh K.,9999,0,9999,0
1668340963753,CSE 293,045,126410,Vaccaro; Kristen Marie,9999,0,9999,0
1668340963753,CSE 293,046,126411,Klemke; Richard,9999,0,9999,0
1668340964180,CSE 294,A00,102459,Voelker; Geoffrey M.,0,0,0,0
1668340964180,CSE 294,B00,111322,Orailoglu; Alex,0,0,0,0
1668340964610,DSE 201,A00,096914,Deutsch; Alin Bernard,30,0,30,0
1668340965112,DSE 210,A00,096915,Dasgupta; Sanjoy,30,0,30,0
1668340965537,DSE 260A,A00,096916,Altintas De Callaf; Ilkay,30,0,30,0
1668340966016,ECE 200,001,103586,Antipa; Nicholas A,9999,0,9999,0
1668340966016,ECE 200,002,103587,Atanasov; Nikolay A.,9999,0,9999,0
1668340966016,ECE 200,003,103588,Bharadia; Dinesh,9999,0,9999,0
1668340966016,ECE 200,004,103589,Cheng; Chung Kuan,9999,0,9999,0
1668340966016,ECE 200,005,103590,Cosman; Pamela C.,9999,0,9999,0
1668340966016,ECE 200,006,103591,Dayeh; Shadi Ahmad,9999,0,9999,0
1668340966016,ECE 200,007,103592,Fainman; Yeshaiahu,9999,0,9999,0
1668340966016,ECE 200,008,103593,Ford; Joseph Earl,9999,0,9999,0
1668340966016,ECE 200,009,103594,Franceschetti; Massimo,9999,0,9999,0
1668340966016,ECE 200,010,103595,Fullerton; Eric E,9999,0,9999,0
1668340966016,ECE 200,011,103596,Galton; Ian A,9999,0,9999,0
1668340966016,ECE 200,012,103597,Gilja; Vikash,9999,0,9999,0
1668340966016,ECE 200,013,103598,Hall; Drew A.,9999,0,9999,0
1668340966016,ECE 200,014,103599,Hsueh; Tzu-Chien,9999,0,9999,0
1668340966016,ECE 200,015,103600,Javidi; Tara,9999,0,9999,0
1668340966016,ECE 200,016,103601,Kahng; Andrew Byun,9999,0,9999,0
1668340966016,ECE 200,017,103602,Kim; Young-Han,9999,0,9999,0
1668340966016,ECE 200,018,103603,Koushanfar; Farinaz,9999,0,9999,0
1668340966016,ECE 200,019,103604,Kuzum; Duygu,9999,0,9999,0
1668340966016,ECE 200,020,103605,Le; Hanh-Phuc,9999,0,9999,0
1668340966016,ECE 200,021,103606,Lin; Bill,9999,0,9999,0
1668340966016,ECE 200,022,103607,Liu; Zhaowei,9998,0,9999,1
1668340966016,ECE 200,023,103608,Lo; Yu-Hwa,9999,0,9999,0
1668340966016,ECE 200,024,103609,Lomakin; Vitaliy,9999,0,9999,0
1668340966016,ECE 200,025,103610,Mercier; Patrick Philip,9999,0,9999,0
1668340966016,ECE 200,026,103611,Meyer; Florian,9999,0,9999,0
1668340966016,ECE 200,027,103612,Milstein; Laurence B.,9999,0,9999,0
1668340966016,ECE 200,028,103613,Mir Arabbaygi; Siavash,9999,0,9999,0
1668340966016,ECE 200,029,103614,Mookherjea; Shayan,9999,0,9999,0
1668340966016,ECE 200,030,103615,Morris; Karcher William,9999,0,9999,0
1668340966016,ECE 200,031,103616,Ng; Tse Nga,9999,0,9999,0
1668340966016,ECE 200,032,103617,Nguyen; Truong Quang,9999,0,9999,0
1668340966016,ECE 200,033,103618,Nomura; Kenji,9999,0,9999,0
1668340966016,ECE 200,034,103619,Orlitsky; Alon,9999,0,9999,0
1668340966016,ECE 200,035,103620,Pal; Piya,9999,0,9999,0
1668340966016,ECE 200,036,103621,Papen; George C.,9999,0,9999,0
1668340966016,ECE 200,037,103622,Radic; Stojan,9999,0,9999,0
1668340966016,ECE 200,038,103623,Rao; Bhaskar D.,9999,0,9999,0
1668340966016,ECE 200,039,103624,Rao; Ramesh R,9999,0,9999,0
1668340966016,ECE 200,040,103625,Rebeiz; Gabriel,9999,0,9999,0
1668340966016,ECE 200,041,103626,Sanford; John R,9999,0,9999,0
1668340966016,ECE 200,042,103627,Siegel; Paul H.,9999,0,9999,0
1668340966016,ECE 200,043,103628,Sievenpiper; Daniel F.,9999,0,9999,0
1668340966016,ECE 200,044,103629,Sworder; David D.,9999,0,9999,0
1668340966016,ECE 200,045,103630,Taur; Yuan,9999,0,9999,0
1668340966016,ECE 200,046,103631,Touri; Behrouz,9999,0,9999,0
1668340966016,ECE 200,047,103632,Trivedi; Mohan M.,9999,0,9999,0
1668340966016,ECE 200,048,103633,Vasconcelos; Nuno,9999,0,9999,0
1668340966016,ECE 200,049,103634,Wang; Xiaolong,9999,0,9999,0
1668340966016,ECE 200,050,103635,Xie; Pengtao,9999,0,9999,0
1668340966016,ECE 200,051,103636,Yip; Michael,9999,0,9999,0
1668340966016,ECE 200,052,103637,Zeger; Kenneth A.,999,0,999,0
1668340966016,ECE 200,053,103638,Zhang; Xinyu,9999,0,9999,0
1668340966016,ECE 200,054,103639,Turakhia; Yatish Girish,9999,0,9999,0
1668340966016,ECE 200,055,103640,Kang; Mingu,9999,0,9999,0
1668340966016,ECE 200,056,103641,Shi; Yuanyuan,9999,0,9999,0
1668340966016,ECE 200,057,103642,Wang; Edward Jay,9999,0,9999,0
1668340966016,ECE 200,058,103643,Zheng; Yang,9999,0,9999,0
1668340966438,ECE 202,A00,103644,Kuzum; Duygu,0,0,0,0
1668340966871,ECE 212BN,A00,103646,Ng; Tse Nga,0,0,0,0
1668340967296,ECE 221,A00,111493,Staff,0,0,0,0
1668340967722,ECE 222B,A00,103647,Lomakin; Vitaliy,0,0,0,0
1668340968146,ECE 230B,A00,103648,Taur; Yuan,0,0,0,0
1668340968571,ECE 238B,A00,103649,Garay; Javier,0,0,0,0
1668340968994,ECE 240B,A00,112900,Fainman; Yeshaiahu,0,0,0,0
1668340969417,ECE 247A,A00,103650,Jokerst; Jesse Vincent,0,0,0,0
1668340969848,ECE 247B,A00,103651,Wang; Joseph,0,0,0,0
1668340970273,ECE 250,A00,103652,Siegel; Paul H.,0,0,0,0
1668340970716,ECE 251A,A00,103654,Rao; Bhaskar D.,0,0,0,0
1668340971141,ECE 257B,A00,103655,Bharadia; Dinesh,0,0,0,0
1668340971566,ECE 258A,A00,103656,Milstein; Laurence B.,0,0,0,0
1668340971990,ECE 260B,A00,103658,Kang; Mingu,0,0,0,0
1668340972430,ECE 264A,A00,103659,Galton; Ian A,0,0,0,0
1668340972858,ECE 265A,A00,103661,Gudem; Prasad S.S.,0,0,0,0
1668340973281,ECE 265D,A00,103662,Gudem; Prasad S.S.,0,0,0,0
1668340973711,ECE 268,A00,103663,Koushanfar; Farinaz,0,0,0,0
1668340974135,ECE 269,A01,103665,Pal; Piya,0,0,0,0
1668340974567,ECE 271B,A00,103666,Vasconcelos; Manuela,0,0,0,0
1668340974992,ECE 276A,A00,103667,Atanasov; Nikolay A.,0,0,0,0
1668340975423,ECE 277,A00,103668,An; Cheolhong,0,0,0,0
1668340975848,ECE 279,A00,117947,Hall; Drew A.,0,0,0,0
1668340976696,ECE 283,A00,103670,Hsueh; Tzu-Chien,0,0,0,0
1668340977127,ECE 284,A00,103671,Turakhia; Yatish Girish,0,0,0,0
1668340977552,ECE 285,A00,103672,Zheng; Yang,0,0,0,0
1668340977552,ECE 285,B00,103673,Sworder; David D.,0,0,0,0
1668340977975,ECE 287,A00,103676,Javidi; Tara,0,0,0,0
1668340978401,MATH 200B,A00,098023,Salehi Golsefidy; Alireza,12,0,15,3
1668340978826,MATH 202B,A00,098024,Rhoades; Brendon Patrick,9,0,15,6
1668340979251,MATH 203B,A00,098025,Oprea; Dragos N.,10,0,15,5
1668340979676,MATH 204B,A00,098026,Sorensen; Claus M,13,0,15,2
1668340980114,MATH 208,A00,098027,Izadi; Elham,7,0,10,3
1668340980543,MATH 209,A00,098028,Pollack; Aaron,10,0,10,0
1668340980973,MATH 211A,A00,112919,Rogalski; Daniel,9,0,10,1
1668340981398,MATH 211B,A00,112920,Seward; Brandon M.,9,0,10,1
1668340981822,MATH 218,A00,098029,Li; Bo,10,0,10,0
1668340982250,MATH 220B,A00,098030,Novak; Jonathan I,11,0,15,4
1668340982682,MATH 221A,A00,098031,Ebenfelt; Peter F,13,0,15,2
1668340983105,MATH 231B,A00,098032,Zlatos; Andrej,12,0,15,3
1668340983530,MATH 240B,A00,098033,Ni; Lei,9,0,15,6
1668340983957,MATH 243,A00,098034,Jekel; David Andrew,10,0,10,0
1668340984389,MATH 245A,A00,098035,Nie; Jiawang,0,0,15,16
1668340984818,MATH 248,A00,098036,Bejenaru; Ioan,10,0,10,0
1668340985249,MATH 250B,A00,098037,Spolaor; Luca,14,0,15,1
1668340985673,MATH 258,A00,098038,Ni; Lei,10,0,10,0
1668340986098,MATH 264B,A00,098041,Rhoades; Brendon Patrick,9,0,15,6
1668340986528,MATH 268,A00,098042,Buss; Samuel R,10,0,10,0
1668340986956,MATH 269,A00,098043,Rhoades; Brendon Patrick,10,0,10,0
1668340987386,MATH 270B,A00,098044,Li; Bo,10,0,15,5
1668340987816,MATH 272B,A00,098045,Holst; Michael J,13,0,15,2
1668340988244,MATH 273A,A00,098046,Tian; Xiaochuan,10,0,15,5
1668340988674,MATH 275,A01,098048,Tian; Xiaochuan,6,0,10,4
1668340989100,MATH 278A,A00,098049,Holst; Michael J,8,0,10,2
1668340989525,MATH 278B,A00,098050,Cloninger; Alexander,10,0,10,0
1668340989951,MATH 278C,A00,098051,Nie; Jiawang,7,0,10,3
1668340990383,MATH 280B,A00,098052,Zheng; Tianyi,8,0,15,7
1668340990809,MATH 281B,A00,098053,Bradic; Jelena,1,0,15,14
1668340991234,MATH 282B,A00,098054,Arias-Castro; Ery,0,0,15,15
1668340991668,MATH 285,A00,098055,Fitzsimmons; Patrick J,0,0,15,17
1668340992091,MATH 287B,A00,098056,Arias-Castro; Ery,2,0,15,13
1668340992515,MATH 288,A00,098057,Agarwal; Pooja,9,0,10,1
1668340992515,MATH 288,B00,098058,Zhang; Danna,8,0,10,2
1668340992515,MATH 288,C00,098059,Williams; Ruth J,9,0,10,1
1668340992943,MATH 290B,A00,098060,Roberts; Justin Deritter,13,0,15,2
1668340993366,MATH 292,A00,098061,Belmont; Eva Kinoshita,10,0,10,0
1668340993795,MATH 295,A00,098062,Suk; Andrew Hoon,48,0,50,2
1668340994220,MATH 296,A00,098063,Novak; Jonathan I,20,0,20,0
1668340994649,MATH 297,001,098064,Gamst; Anthony Collins,9997,0,9999,2
1668341496268,COGS 205,A00,101395,Chiba; Andrea,19,0,20,1
1668341496702,COGS 210B,001,101404,Greene; Deanna Jacquelyn,9998,0,9999,1
1668341496702,COGS 210B,002,101417,Xia; Haijun,9999,0,9999,0
1668341496702,COGS 210B,003,101422,Nitz; Douglas A.,9999,0,9999,0
1668341496702,COGS 210B,004,101423,Hollan; James D.,9998,0,9999,1
1668341496702,COGS 210B,005,101424,Deak; Gedeon O.,9998,0,9999,1
1668341496702,COGS 210B,006,101425,Rossano; Federico,9999,0,9999,0
1668341497127,COGS 211B,A00,101427,Coulson; Seana M,9996,0,9999,3
1668341497551,COGS 220,A00,101428,Hollan; James D.,0,0,25,25
1668341497980,COGS 229,A00,101429,Dow; Steven P,18,0,25,7
1668341498409,COGS 230,A00,101430,Klemmer; Scott R,11,0,17,6
1668341498834,COGS 234,A00,101431,Xia; Haijun,1,0,25,24
1668341499259,COGS 260,A00,101432,Kiyonaga; Anastasia,21,0,25,4
1668341499259,COGS 260,B00,101433,Kirsh; David Joel,15,0,25,10
1668341499686,CSE 202,A00,102371,Impagliazzo; Russell,0,0,0,0
1668341500113,CSE 203B,A01,102373,Cheng; Chung Kuan,0,0,0,0
1668341500539,CSE 208,A00,102374,Micciancio; Daniele,0,0,0,0
1668341500969,CSE 209A,A00,112895,Impagliazzo; Russell,0,0,15,15
1668341501400,CSE 209B,A00,108005,Bellare; Mihir,0,0,0,0
1668341501833,CSE 210,A00,113163,Coblenz; Michael J,0,0,0,0
1668341502257,CSE 219,A00,106111,Dow; Steven P,0,0,20,20
1668341502684,CSE 221,A00,102376,Voelker; Geoffrey M.,0,0,0,0
1668341503109,CSE 224,A01,102378,Porter; George M,0,0,0,0
1668341503539,CSE 229A,A00,102379,Savage; Stefan,0,0,0,0
1668341503968,CSE 229C,A00,102380,Munyaka; Imani N. S.,0,0,0,0
1668341504391,CSE 232B,A00,102382,Deutsch; Alin Bernard,0,0,0,0
1668341504819,CSE 234,A01,112904,Kumar; Arun Kumar,0,0,0,0
1668341505245,CSE 237A,A00,102383,Rosing; Tajana Simunic,0,0,0,0
1668341505671,CSE 239A,A00,102384,Deutsch; Alin Bernard,0,0,0,0
1668341506102,CSE 239B,A00,102385,Polikarpova; Nadezhda,0,0,0,0
1668341506529,CSE 240A,A00,102386,Pannuto; Patrick William,0,0,0,0
1668341506958,CSE 240B,A00,102387,Zhao; Jishen,0,0,0,0
1668341507384,CSE 241A,A00,106406,Kang; Mingu,0,0,0,0
1668341507813,CSE 249B,A00,102388,Kahng; Andrew Byun,0,0,8,8
1668341508240,CSE 251B,A01,102392,Cottrell; Garrison W,0,0,0,0
1668341508240,CSE 251B,A02,102393,Cottrell; Garrison W,0,0,0,0
1668341508668,CSE 252B,A00,102394,Ochoa; Benjamin Lawrence,0,0,0,0
1668341509096,CSE 257,A01,102396,Gao; Sicun,0,0,0,0
1668341509526,CSE 272,A00,102397,Li; Tzumao,0,0,0,0
1668341509955,CSE 274,A00,111323,Chern; Albert Ren-Haur,0,0,0,0
1668341510381,CSE 282,A00,102398,Pevzner; Pavel Arkadjevich,0,0,0,0
1668341510807,CSE 284,A00,114175,Gymrek; Melissa Ann,0,0,0,0
1668341511241,CSE 290,A00,102399,Chandraker; Manmohan Krishna,0,0,0,0
1668341511241,CSE 290,B00,102400,Vaccaro; Kristen Marie,0,0,25,25
1668341511241,CSE 290,C00,102414,Pannuto; Patrick William,0,0,25,25
1668341511241,CSE 290,D00,102427,Pevzner; Pavel Arkadjevich,0,0,0,0
1668341511241,CSE 290,E00,102429,Zhao; Jishen,0,0,0,0
1668341511241,CSE 290,F00,102436,Tullsen; Dean Michael,0,0,0,0
1668341511241,CSE 290,G00,102440,Christensen; Henrik I,0,0,20,20
1668341511677,CSE 291,A00,102443,Su; Hao,0,0,0,0
1668341511677,CSE 291,B00,102448,Polikarpova; Nadezhda,0,0,0,0
1668341511677,CSE 291,C00,102453,Vaccaro; Kristen Marie,0,0,0,0
1668341511677,CSE 291,D00,111343,Savage; Stefan,0,0,0,0
1668341511677,CSE 291,E00,116474,Claffy; Kimberly Claire,0,0,0,0
1668341511677,CSE 291,F00,116479,Pasquale; Joseph,0,0,0,0
1668341512126,CSE 293,001,119111,Bafna; Vineet,9999,0,9999,0
1668341512126,CSE 293,002,119118,Bellare; Mihir,9999,0,9999,0
1668341512126,CSE 293,003,119122,Berg-Kirkpatrick; Taylor D,9999,0,9999,0
1668341512126,CSE 293,004,119135,Christensen; Henrik I,9999,0,9999,0
1668341512126,CSE 293,005,119142,Cottrell; Garrison W,9999,0,9999,0
1668341512126,CSE 293,006,119146,Deutsch; Alin Bernard,9999,0,9999,0
1668341512126,CSE 293,007,119159,Esmaeilzadeh; Hadi,9999,0,9999,0
1668341512126,CSE 293,008,119166,Freund; Yoav,9999,0,9999,0
1668341512126,CSE 293,009,119170,Griswold; William G.,9999,0,9999,0
1668341512126,CSE 293,010,119183,Gymrek; Melissa Ann,9999,0,9999,0
1668341512126,CSE 293,011,119190,Heninger; Nadia A,9999,0,9999,0
1668341512126,CSE 293,012,119230,Impagliazzo; Russell,9999,0,9999,0
1668341512126,CSE 293,013,119232,Jhala; Ranjit,9999,0,9999,0
1668341512126,CSE 293,014,119233,Kahng; Andrew Byun,9999,0,9999,0
1668341512126,CSE 293,015,119298,Kane; Daniel Mertz,9999,0,9999,0
1668341512126,CSE 293,016,119299,Kriegman; David J,9999,0,9999,0
1668341512126,CSE 293,017,119300,Kumar; Arun Kumar,9999,0,9999,0
1668341512126,CSE 293,018,119301,Lerner; Sorin,9999,0,9999,0
1668341512126,CSE 293,019,119302,Lovett; Shachar,9999,0,9999,0
1668341512126,CSE 293,020,119303,McAuley; Julian John,9999,0,9999,0
1668341512126,CSE 293,021,119304,Micciancio; Daniele,9999,0,9999,0
1668341512126,CSE 293,022,119367,Orailoglu; Alex,9999,0,9999,0
1668341512126,CSE 293,023,119382,Paturi; Ramamohan,9999,0,9999,0
1668341512126,CSE 293,024,119404,Polikarpova; Nadezhda,9999,0,9999,0
1668341512126,CSE 293,025,119406,Politz; Joseph Gibbs,9999,0,9999,0
1668341512126,CSE 293,026,119411,Porter; George M,9999,0,9999,0
1668341512126,CSE 293,027,119414,Porter; Leonard Emerson,9999,0,9999,0
1668341512126,CSE 293,028,119416,Ramamoorthi; Ravi,9999,0,9999,0
1668341512126,CSE 293,029,119417,Sahoo; Debashis,9999,0,9999,0
1668341512126,CSE 293,030,119420,Saul; Lawrence,9999,0,9999,0
1668341512126,CSE 293,031,119421,Savage; Stefan,9999,0,9999,0
1668341512126,CSE 293,032,119425,Schulze; Jurgen P.,9999,0,9999,0
1668341512126,CSE 293,033,119426,Snoeren; Alex C.,9999,0,9999,0
1668341512126,CSE 293,034,119428,Shang; Jingbo,9999,0,9999,0
1668341512126,CSE 293,035,119430,Stefan; Deian,9999,0,9999,0
1668341512126,CSE 293,036,119431,Su; Hao,9999,0,9999,0
1668341512126,CSE 293,037,119433,Swanson; Steven James,9999,0,9999,0
1668341512126,CSE 293,038,119435,Tullsen; Dean Michael,9999,0,9999,0
1668341512126,CSE 293,039,119483,Voelker; Geoffrey M.,9999,0,9999,0
1668341512126,CSE 293,040,119537,Zhao; Jishen,9999,0,9999,0
1668341512126,CSE 293,041,119538,Zhou; Yuan-Yuan,9999,0,9999,0
1668341512126,CSE 293,042,119539,Gao; Sicun,9999,0,9999,0
1668341512126,CSE 293,043,119540,Weibel; Nadir,9999,0,9999,0
1668341512126,CSE 293,044,119541,Gupta; Rajesh K.,9999,0,9999,0
1668341512126,CSE 293,045,126410,Vaccaro; Kristen Marie,9999,0,9999,0
1668341512126,CSE 293,046,126411,Klemke; Richard,9999,0,9999,0
1668341512551,CSE 294,A00,102459,Voelker; Geoffrey M.,0,0,0,0
1668341512551,CSE 294,B00,111322,Orailoglu; Alex,0,0,0,0
1668341512978,DSE 201,A00,096914,Deutsch; Alin Bernard,30,0,30,0
1668341513405,DSE 210,A00,096915,Dasgupta; Sanjoy,30,0,30,0
1668341513830,DSE 260A,A00,096916,Altintas De Callaf; Ilkay,30,0,30,0
1668341514290,ECE 200,001,103586,Antipa; Nicholas A,9999,0,9999,0
1668341514290,ECE 200,002,103587,Atanasov; Nikolay A.,9999,0,9999,0
1668341514290,ECE 200,003,103588,Bharadia; Dinesh,9999,0,9999,0
1668341514290,ECE 200,004,103589,Cheng; Chung Kuan,9999,0,9999,0
1668341514290,ECE 200,005,103590,Cosman; Pamela C.,9999,0,9999,0
1668341514290,ECE 200,006,103591,Dayeh; Shadi Ahmad,9999,0,9999,0
1668341514290,ECE 200,007,103592,Fainman; Yeshaiahu,9999,0,9999,0
1668341514290,ECE 200,008,103593,Ford; Joseph Earl,9999,0,9999,0
1668341514290,ECE 200,009,103594,Franceschetti; Massimo,9999,0,9999,0
1668341514290,ECE 200,010,103595,Fullerton; Eric E,9999,0,9999,0
1668341514290,ECE 200,011,103596,Galton; Ian A,9999,0,9999,0
1668341514290,ECE 200,012,103597,Gilja; Vikash,9999,0,9999,0
1668341514290,ECE 200,013,103598,Hall; Drew A.,9999,0,9999,0
1668341514290,ECE 200,014,103599,Hsueh; Tzu-Chien,9999,0,9999,0
1668341514290,ECE 200,015,103600,Javidi; Tara,9999,0,9999,0
1668341514290,ECE 200,016,103601,Kahng; Andrew Byun,9999,0,9999,0
1668341514290,ECE 200,017,103602,Kim; Young-Han,9999,0,9999,0
1668341514290,ECE 200,018,103603,Koushanfar; Farinaz,9999,0,9999,0
1668341514290,ECE 200,019,103604,Kuzum; Duygu,9999,0,9999,0
1668341514290,ECE 200,020,103605,Le; Hanh-Phuc,9999,0,9999,0
1668341514290,ECE 200,021,103606,Lin; Bill,9999,0,9999,0
1668341514290,ECE 200,022,103607,Liu; Zhaowei,9998,0,9999,1
1668341514290,ECE 200,023,103608,Lo; Yu-Hwa,9999,0,9999,0
1668341514290,ECE 200,024,103609,Lomakin; Vitaliy,9999,0,9999,0
1668341514290,ECE 200,025,103610,Mercier; Patrick Philip,9999,0,9999,0
1668341514290,ECE 200,026,103611,Meyer; Florian,9999,0,9999,0
1668341514290,ECE 200,027,103612,Milstein; Laurence B.,9999,0,9999,0
1668341514290,ECE 200,028,103613,Mir Arabbaygi; Siavash,9999,0,9999,0
1668341514290,ECE 200,029,103614,Mookherjea; Shayan,9999,0,9999,0
1668341514290,ECE 200,030,103615,Morris; Karcher William,9999,0,9999,0
1668341514290,ECE 200,031,103616,Ng; Tse Nga,9999,0,9999,0
1668341514290,ECE 200,032,103617,Nguyen; Truong Quang,9999,0,9999,0
1668341514290,ECE 200,033,103618,Nomura; Kenji,9999,0,9999,0
1668341514290,ECE 200,034,103619,Orlitsky; Alon,9999,0,9999,0
1668341514290,ECE 200,035,103620,Pal; Piya,9999,0,9999,0
1668341514290,ECE 200,036,103621,Papen; George C.,9999,0,9999,0
1668341514290,ECE 200,037,103622,Radic; Stojan,9999,0,9999,0
1668341514290,ECE 200,038,103623,Rao; Bhaskar D.,9999,0,9999,0
1668341514290,ECE 200,039,103624,Rao; Ramesh R,9999,0,9999,0
1668341514290,ECE 200,040,103625,Rebeiz; Gabriel,9999,0,9999,0
1668341514290,ECE 200,041,103626,Sanford; John R,9999,0,9999,0
1668341514290,ECE 200,042,103627,Siegel; Paul H.,9999,0,9999,0
1668341514290,ECE 200,043,103628,Sievenpiper; Daniel F.,9999,0,9999,0
1668341514290,ECE 200,044,103629,Sworder; David D.,9999,0,9999,0
1668341514290,ECE 200,045,103630,Taur; Yuan,9999,0,9999,0
1668341514290,ECE 200,046,103631,Touri; Behrouz,9999,0,9999,0
1668341514290,ECE 200,047,103632,Trivedi; Mohan M.,9999,0,9999,0
1668341514290,ECE 200,048,103633,Vasconcelos; Nuno,9999,0,9999,0
1668341514290,ECE 200,049,103634,Wang; Xiaolong,9999,0,9999,0
1668341514290,ECE 200,050,103635,Xie; Pengtao,9999,0,9999,0
1668341514290,ECE 200,051,103636,Yip; Michael,9999,0,9999,0
1668341514290,ECE 200,052,103637,Zeger; Kenneth A.,999,0,999,0
1668341514290,ECE 200,053,103638,Zhang; Xinyu,9999,0,9999,0
1668341514290,ECE 200,054,103639,Turakhia; Yatish Girish,9999,0,9999,0
1668341514290,ECE 200,055,103640,Kang; Mingu,9999,0,9999,0
1668341514290,ECE 200,056,103641,Shi; Yuanyuan,9999,0,9999,0
1668341514290,ECE 200,057,103642,Wang; Edward Jay,9999,0,9999,0
1668341514290,ECE 200,058,103643,Zheng; Yang,9999,0,9999,0
1668341514719,ECE 202,A00,103644,Kuzum; Duygu,0,0,0,0
1668341515155,ECE 212BN,A00,103646,Ng; Tse Nga,0,0,0,0
1668341515577,ECE 221,A00,111493,Staff,0,0,0,0
1668341516002,ECE 222B,A00,103647,Lomakin; Vitaliy,0,0,0,0
1668341516431,ECE 230B,A00,103648,Taur; Yuan,0,0,0,0
1668341516856,ECE 238B,A00,103649,Garay; Javier,0,0,0,0
1668341517281,ECE 240B,A00,112900,Fainman; Yeshaiahu,0,0,0,0
1668341517709,ECE 247A,A00,103650,Jokerst; Jesse Vincent,0,0,0,0
1668341518133,ECE 247B,A00,103651,Wang; Joseph,0,0,0,0
1668341518559,ECE 250,A00,103652,Siegel; Paul H.,0,0,0,0
1668341518984,ECE 251A,A00,103654,Rao; Bhaskar D.,0,0,0,0
1668341519412,ECE 257B,A00,103655,Bharadia; Dinesh,0,0,0,0
1668341519839,ECE 258A,A00,103656,Milstein; Laurence B.,0,0,0,0
1668341520264,ECE 260B,A00,103658,Kang; Mingu,0,0,0,0
1668341520690,ECE 264A,A00,103659,Galton; Ian A,0,0,0,0
1668341521119,ECE 265A,A00,103661,Gudem; Prasad S.S.,0,0,0,0
1668341521542,ECE 265D,A00,103662,Gudem; Prasad S.S.,0,0,0,0
1668341521973,ECE 268,A00,103663,Koushanfar; Farinaz,0,0,0,0
1668341522397,ECE 269,A01,103665,Pal; Piya,0,0,0,0
1668341522826,ECE 271B,A00,103666,Vasconcelos; Manuela,0,0,0,0
1668341523253,ECE 276A,A00,103667,Atanasov; Nikolay A.,0,0,0,0
1668341523679,ECE 277,A00,103668,An; Cheolhong,0,0,0,0
1668341524116,ECE 279,A00,117947,Hall; Drew A.,0,0,0,0
1668341524966,ECE 283,A00,103670,Hsueh; Tzu-Chien,0,0,0,0
1668341525391,ECE 284,A00,103671,Turakhia; Yatish Girish,0,0,0,0
1668341525821,ECE 285,A00,103672,Zheng; Yang,0,0,0,0
1668341525821,ECE 285,B00,103673,Sworder; David D.,0,0,0,0
1668341526246,ECE 287,A00,103676,Javidi; Tara,0,0,0,0
1668341526678,MATH 200B,A00,098023,Salehi Golsefidy; Alireza,12,0,15,3
1668341527103,MATH 202B,A00,098024,Rhoades; Brendon Patrick,9,0,15,6
1668341527528,MATH 203B,A00,098025,Oprea; Dragos N.,10,0,15,5
1668341527959,MATH 204B,A00,098026,Sorensen; Claus M,13,0,15,2
1668341528388,MATH 208,A00,098027,Izadi; Elham,7,0,10,3
1668341528814,MATH 209,A00,098028,Pollack; Aaron,10,0,10,0
1668341529238,MATH 211A,A00,112919,Rogalski; Daniel,9,0,10,1
1668341529664,MATH 211B,A00,112920,Seward; Brandon M.,9,0,10,1
1668341530099,MATH 218,A00,098029,Li; Bo,10,0,10,0
1668341530526,MATH 220B,A00,098030,Novak; Jonathan I,11,0,15,4
1668341530951,MATH 221A,A00,098031,Ebenfelt; Peter F,13,0,15,2
1668341531453,MATH 231B,A00,098032,Zlatos; Andrej,12,0,15,3
1668341531886,MATH 240B,A00,098033,Ni; Lei,9,0,15,6
1668341532310,MATH 243,A00,098034,Jekel; David Andrew,10,0,10,0
1668341532739,MATH 245A,A00,098035,Nie; Jiawang,0,0,15,16
1668341533162,MATH 248,A00,098036,Bejenaru; Ioan,10,0,10,0
1668341533593,MATH 250B,A00,098037,Spolaor; Luca,14,0,15,1
1668341534019,MATH 258,A00,098038,Ni; Lei,10,0,10,0
1668341534445,MATH 264B,A00,098041,Rhoades; Brendon Patrick,9,0,15,6
1668341534872,MATH 268,A00,098042,Buss; Samuel R,10,0,10,0
1668341535299,MATH 269,A00,098043,Rhoades; Brendon Patrick,10,0,10,0
1668341535723,MATH 270B,A00,098044,Li; Bo,10,0,15,5
1668341536157,MATH 272B,A00,098045,Holst; Michael J,13,0,15,2
1668341536581,MATH 273A,A00,098046,Tian; Xiaochuan,10,0,15,5
1668341537006,MATH 275,A01,098048,Tian; Xiaochuan,6,0,10,4
1668341537432,MATH 278A,A00,098049,Holst; Michael J,8,0,10,2
1668341537858,MATH 278B,A00,098050,Cloninger; Alexander,10,0,10,0
1668341538284,MATH 278C,A00,098051,Nie; Jiawang,7,0,10,3
1668341538710,MATH 280B,A00,098052,Zheng; Tianyi,8,0,15,7
1668341539134,MATH 281B,A00,098053,Bradic; Jelena,1,0,15,14
1668341539559,MATH 282B,A00,098054,Arias-Castro; Ery,0,0,15,15
1668341539985,MATH 285,A00,098055,Fitzsimmons; Patrick J,0,0,15,17
1668341540407,MATH 287B,A00,098056,Arias-Castro; Ery,2,0,15,13
1668341540837,MATH 288,A00,098057,Agarwal; Pooja,9,0,10,1
1668341540837,MATH 288,B00,098058,Zhang; Danna,8,0,10,2
1668341540837,MATH 288,C00,098059,Williams; Ruth J,9,0,10,1
1668341541265,MATH 290B,A00,098060,Roberts; Justin Deritter,13,0,15,2
1668341541691,MATH 292,A00,098061,Belmont; Eva Kinoshita,10,0,10,0
1668341542118,MATH 295,A00,098062,Suk; Andrew Hoon,48,0,50,2
1668341542541,MATH 296,A00,098063,Novak; Jonathan I,20,0,20,0
1668341542969,MATH 297,001,098064,Gamst; Anthony Collins,9997,0,9999,2
