time,subj_course_id,sec_code,sec_id,prof,available,waitlist,total,enrolled_ct
1667910332584,COGS 205,A00,101395,Chiba; Andrea,20,0,20,0
1667910333028,COGS 210B,001,101404,Greene; Deanna Jacquelyn,9998,0,9999,1
1667910333028,COGS 210B,002,101417,Xia; Haijun,9999,0,9999,0
1667910333028,COGS 210B,003,101422,Nitz; Douglas A.,9999,0,9999,0
1667910333028,COGS 210B,004,101423,Hollan; James D.,9998,0,9999,1
1667910333028,COGS 210B,005,101424,Deak; Gedeon O.,9999,0,9999,0
1667910333028,COGS 210B,006,101425,Rossano; Federico,9999,0,9999,0
1667910333467,COGS 211B,A00,101427,Coulson; Seana M,9997,0,9999,2
1667910333898,COGS 220,A00,101428,Hollan; James D.,0,0,25,25
1667910334329,COGS 229,A00,101429,Dow; Steven P,19,0,25,6
1667910334765,COGS 230,A00,101430,Klemmer; Scott R,13,0,17,4
1667910335204,COGS 234,A00,101431,Xia; Haijun,11,0,25,14
1667910335639,COGS 260,A00,101432,Kiyonaga; Anastasia,20,0,25,5
1667910335639,COGS 260,B00,101433,Kirsh; David Joel,18,0,25,7
1667910336068,CSE 202,A00,102371,Impagliazzo; Russell,0,0,0,0
1667910336496,CSE 203B,A01,102373,Cheng; Chung Kuan,0,0,0,0
1667910336921,CSE 208,A00,102374,Micciancio; Daniele,0,0,0,0
1667910337351,CSE 209A,A00,112895,Impagliazzo; Russell,0,0,15,15
1667910337779,CSE 209B,A00,108005,Bellare; Mihir,0,0,0,0
1667910338224,CSE 210,A00,113163,Coblenz; Michael J,0,0,0,0
1667910338663,CSE 219,A00,106111,Dow; Steven P,0,0,20,20
1667910339104,CSE 221,A00,102376,Voelker; Geoffrey M.,0,0,0,0
1667910339543,CSE 224,A01,102378,Porter; George M,0,0,0,0
1667910339973,CSE 229A,A00,102379,Savage; Stefan,0,0,0,0
1667910340415,CSE 229C,A00,102380,Munyaka; Imani N. S.,0,0,0,0
1667910340860,CSE 232B,A00,102382,Deutsch; Alin Bernard,0,0,0,0
1667910341306,CSE 234,A01,112904,Kumar; Arun Kumar,0,0,0,0
1667910341743,CSE 237A,A00,102383,Rosing; Tajana Simunic,0,0,0,0
1667910342181,CSE 239A,A00,102384,Deutsch; Alin Bernard,0,0,0,0
1667910342605,CSE 239B,A00,102385,Polikarpova; Nadezhda,0,0,0,0
1667910343035,CSE 240A,A00,102386,Pannuto; Patrick William,0,0,0,0
1667910343471,CSE 240B,A00,102387,Zhao; Jishen,0,0,0,0
1667910343912,CSE 241A,A00,106406,Kang; Mingu,0,0,0,0
1667910344358,CSE 249B,A00,102388,Kahng; Andrew Byun,0,0,8,8
1667910344787,CSE 251B,A01,102392,Cottrell; Garrison W,0,0,0,0
1667910344787,CSE 251B,A02,102393,Cottrell; Garrison W,0,0,0,0
1667910345220,CSE 252B,A00,102394,Ochoa; Benjamin Lawrence,0,0,0,0
1667910345652,CSE 257,A01,102396,Gao; Sicun,0,0,0,0
1667910346088,CSE 272,A00,102397,Li; Tzumao,0,0,0,0
1667910346524,CSE 274,A00,111323,Chern; Albert Ren-Haur,0,0,0,0
1667910346955,CSE 282,A00,102398,Pevzner; Pavel Arkadjevich,0,0,0,0
1667910347388,CSE 284,A00,114175,Gymrek; Melissa Ann,0,0,0,0
1667910348391,CSE 290,A00,102399,Chandraker; Manmohan Krishna,0,0,0,0
1667910348391,CSE 290,B00,102400,Vaccaro; Kristen Marie,0,0,25,25
1667910348391,CSE 290,C00,102414,Pannuto; Patrick William,0,0,25,25
1667910348391,CSE 290,D00,102427,Pevzner; Pavel Arkadjevich,0,0,0,0
1667910348391,CSE 290,E00,102429,Zhao; Jishen,0,0,0,0
1667910348391,CSE 290,F00,102436,Tullsen; Dean Michael,0,0,0,0
1667910348391,CSE 290,G00,102440,Christensen; Henrik I,0,0,20,20
1667910348826,CSE 291,A00,102443,Su; Hao,0,0,0,0
1667910348826,CSE 291,B00,102448,Polikarpova; Nadezhda,0,0,0,0
1667910348826,CSE 291,C00,102453,Vaccaro; Kristen Marie,0,0,0,0
1667910348826,CSE 291,D00,111343,Savage; Stefan,0,0,0,0
1667910348826,CSE 291,E00,116474,Claffy; Kimberly Claire,0,0,0,0
1667910348826,CSE 291,F00,116479,Pasquale; Joseph,0,0,0,0
1667910349278,CSE 293,001,119111,Bafna; Vineet,9999,0,9999,0
1667910349278,CSE 293,002,119118,Bellare; Mihir,9999,0,9999,0
1667910349278,CSE 293,003,119122,Berg-Kirkpatrick; Taylor D,9999,0,9999,0
1667910349278,CSE 293,004,119135,Christensen; Henrik I,9999,0,9999,0
1667910349278,CSE 293,005,119142,Cottrell; Garrison W,9999,0,9999,0
1667910349278,CSE 293,006,119146,Deutsch; Alin Bernard,9999,0,9999,0
1667910349278,CSE 293,007,119159,Esmaeilzadeh; Hadi,9999,0,9999,0
1667910349278,CSE 293,008,119166,Freund; Yoav,9999,0,9999,0
1667910349278,CSE 293,009,119170,Griswold; William G.,9999,0,9999,0
1667910349278,CSE 293,010,119183,Gymrek; Melissa Ann,9999,0,9999,0
1667910349278,CSE 293,011,119190,Heninger; Nadia A,9999,0,9999,0
1667910349278,CSE 293,012,119230,Impagliazzo; Russell,9999,0,9999,0
1667910349278,CSE 293,013,119232,Jhala; Ranjit,9999,0,9999,0
1667910349278,CSE 293,014,119233,Kahng; Andrew Byun,9999,0,9999,0
1667910349278,CSE 293,015,119298,Kane; Daniel Mertz,9999,0,9999,0
1667910349278,CSE 293,016,119299,Kriegman; David J,9999,0,9999,0
1667910349278,CSE 293,017,119300,Kumar; Arun Kumar,9999,0,9999,0
1667910349278,CSE 293,018,119301,Lerner; Sorin,9999,0,9999,0
1667910349278,CSE 293,019,119302,Lovett; Shachar,9999,0,9999,0
1667910349278,CSE 293,020,119303,McAuley; Julian John,9999,0,9999,0
1667910349278,CSE 293,021,119304,Micciancio; Daniele,9999,0,9999,0
1667910349278,CSE 293,022,119367,Orailoglu; Alex,9999,0,9999,0
1667910349278,CSE 293,023,119382,Paturi; Ramamohan,9999,0,9999,0
1667910349278,CSE 293,024,119404,Polikarpova; Nadezhda,9999,0,9999,0
1667910349278,CSE 293,025,119406,Politz; Joseph Gibbs,9999,0,9999,0
1667910349278,CSE 293,026,119411,Porter; George M,9999,0,9999,0
1667910349278,CSE 293,027,119414,Porter; Leonard Emerson,9999,0,9999,0
1667910349278,CSE 293,028,119416,Ramamoorthi; Ravi,9999,0,9999,0
1667910349278,CSE 293,029,119417,Sahoo; Debashis,9999,0,9999,0
1667910349278,CSE 293,030,119420,Saul; Lawrence,9999,0,9999,0
1667910349278,CSE 293,031,119421,Savage; Stefan,9999,0,9999,0
1667910349278,CSE 293,032,119425,Schulze; Jurgen P.,9999,0,9999,0
1667910349278,CSE 293,033,119426,Snoeren; Alex C.,9999,0,9999,0
1667910349278,CSE 293,034,119428,Shang; Jingbo,9999,0,9999,0
1667910349278,CSE 293,035,119430,Stefan; Deian,9999,0,9999,0
1667910349278,CSE 293,036,119431,Su; Hao,9999,0,9999,0
1667910349278,CSE 293,037,119433,Swanson; Steven James,9999,0,9999,0
1667910349278,CSE 293,038,119435,Tullsen; Dean Michael,9999,0,9999,0
1667910349278,CSE 293,039,119483,Voelker; Geoffrey M.,9999,0,9999,0
1667910349278,CSE 293,040,119537,Zhao; Jishen,9999,0,9999,0
1667910349278,CSE 293,041,119538,Zhou; Yuan-Yuan,9999,0,9999,0
1667910349278,CSE 293,042,119539,Gao; Sicun,9999,0,9999,0
1667910349278,CSE 293,043,119540,Weibel; Nadir,9999,0,9999,0
1667910349278,CSE 293,044,119541,Gupta; Rajesh K.,9999,0,9999,0
1667910349706,CSE 294,A00,102459,Voelker; Geoffrey M.,0,0,0,0
1667910349706,CSE 294,B00,111322,Orailoglu; Alex,0,0,0,0
1667910350136,DSE 201,A00,096914,Deutsch; Alin Bernard,30,0,30,0
1667910350566,DSE 210,A00,096915,Dasgupta; Sanjoy,30,0,30,0
1667910350995,DSE 260A,A00,096916,Altintas De Callaf; Ilkay,30,0,30,0
1667910351471,ECE 200,001,103586,Antipa; Nicholas A,9999,0,9999,0
1667910351471,ECE 200,002,103587,Atanasov; Nikolay A.,9999,0,9999,0
1667910351471,ECE 200,003,103588,Bharadia; Dinesh,9999,0,9999,0
1667910351471,ECE 200,004,103589,Cheng; Chung Kuan,9999,0,9999,0
1667910351471,ECE 200,005,103590,Cosman; Pamela C.,9999,0,9999,0
1667910351471,ECE 200,006,103591,Dayeh; Shadi Ahmad,9999,0,9999,0
1667910351471,ECE 200,007,103592,Fainman; Yeshaiahu,9999,0,9999,0
1667910351471,ECE 200,008,103593,Ford; Joseph Earl,9999,0,9999,0
1667910351471,ECE 200,009,103594,Franceschetti; Massimo,9999,0,9999,0
1667910351471,ECE 200,010,103595,Fullerton; Eric E,9999,0,9999,0
1667910351471,ECE 200,011,103596,Galton; Ian A,9999,0,9999,0
1667910351471,ECE 200,012,103597,Gilja; Vikash,9999,0,9999,0
1667910351471,ECE 200,013,103598,Hall; Drew A.,9999,0,9999,0
1667910351471,ECE 200,014,103599,Hsueh; Tzu-Chien,9999,0,9999,0
1667910351471,ECE 200,015,103600,Javidi; Tara,9999,0,9999,0
1667910351471,ECE 200,016,103601,Kahng; Andrew Byun,9999,0,9999,0
1667910351471,ECE 200,017,103602,Kim; Young-Han,9999,0,9999,0
1667910351471,ECE 200,018,103603,Koushanfar; Farinaz,9999,0,9999,0
1667910351471,ECE 200,019,103604,Kuzum; Duygu,9999,0,9999,0
1667910351471,ECE 200,020,103605,Le; Hanh-Phuc,9999,0,9999,0
1667910351471,ECE 200,021,103606,Lin; Bill,9999,0,9999,0
1667910351471,ECE 200,022,103607,Liu; Zhaowei,9998,0,9999,1
1667910351471,ECE 200,023,103608,Lo; Yu-Hwa,9999,0,9999,0
1667910351471,ECE 200,024,103609,Lomakin; Vitaliy,9999,0,9999,0
1667910351471,ECE 200,025,103610,Mercier; Patrick Philip,9999,0,9999,0
1667910351471,ECE 200,026,103611,Meyer; Florian,9999,0,9999,0
1667910351471,ECE 200,027,103612,Milstein; Laurence B.,9999,0,9999,0
1667910351471,ECE 200,028,103613,Mir Arabbaygi; Siavash,9999,0,9999,0
1667910351471,ECE 200,029,103614,Mookherjea; Shayan,9999,0,9999,0
1667910351471,ECE 200,030,103615,Morris; Karcher William,9999,0,9999,0
1667910351471,ECE 200,031,103616,Ng; Tse Nga,9999,0,9999,0
1667910351471,ECE 200,032,103617,Nguyen; Truong Quang,9999,0,9999,0
1667910351471,ECE 200,033,103618,Nomura; Kenji,9999,0,9999,0
1667910351471,ECE 200,034,103619,Orlitsky; Alon,9999,0,9999,0
1667910351471,ECE 200,035,103620,Pal; Piya,9999,0,9999,0
1667910351471,ECE 200,036,103621,Papen; George C.,9999,0,9999,0
1667910351471,ECE 200,037,103622,Radic; Stojan,9999,0,9999,0
1667910351471,ECE 200,038,103623,Rao; Bhaskar D.,9999,0,9999,0
1667910351471,ECE 200,039,103624,Rao; Ramesh R,9999,0,9999,0
1667910351471,ECE 200,040,103625,Rebeiz; Gabriel,9999,0,9999,0
1667910351471,ECE 200,041,103626,Sanford; John R,9999,0,9999,0
1667910351471,ECE 200,042,103627,Siegel; Paul H.,9999,0,9999,0
1667910351471,ECE 200,043,103628,Sievenpiper; Daniel F.,9999,0,9999,0
1667910351471,ECE 200,044,103629,Sworder; David D.,9999,0,9999,0
1667910351471,ECE 200,045,103630,Taur; Yuan,9999,0,9999,0
1667910351471,ECE 200,046,103631,Touri; Behrouz,9999,0,9999,0
1667910351471,ECE 200,047,103632,Trivedi; Mohan M.,9999,0,9999,0
1667910351471,ECE 200,048,103633,Vasconcelos; Nuno,9999,0,9999,0
1667910351471,ECE 200,049,103634,Wang; Xiaolong,9999,0,9999,0
1667910351471,ECE 200,050,103635,Xie; Pengtao,9999,0,9999,0
1667910351471,ECE 200,051,103636,Yip; Michael,9999,0,9999,0
1667910351471,ECE 200,052,103637,Zeger; Kenneth A.,999,0,999,0
1667910351471,ECE 200,053,103638,Zhang; Xinyu,9999,0,9999,0
1667910351471,ECE 200,054,103639,Turakhia; Yatish Girish,9999,0,9999,0
1667910351471,ECE 200,055,103640,Kang; Mingu,9999,0,9999,0
1667910351471,ECE 200,056,103641,Shi; Yuanyuan,9999,0,9999,0
1667910351471,ECE 200,057,103642,Wang; Edward Jay,9999,0,9999,0
1667910351471,ECE 200,058,103643,Zheng; Yang,9999,0,9999,0
1667910351913,ECE 202,A00,103644,Kuzum; Duygu,0,0,0,0
1667910352347,ECE 212BN,A00,103646,Ng; Tse Nga,0,0,0,0
1667910352876,ECE 221,A00,111493,Staff,0,0,0,0
1667910353310,ECE 222B,A00,103647,Lomakin; Vitaliy,0,0,0,0
1667910353742,ECE 230B,A00,103648,Taur; Yuan,0,0,0,0
1667910354173,ECE 238B,A00,103649,Garay; Javier,0,0,0,0
1667910354602,ECE 240B,A00,112900,Fainman; Yeshaiahu,0,0,0,0
1667910355042,ECE 247A,A00,103650,Jokerst; Jesse Vincent,0,0,0,0
1667910355472,ECE 247B,A00,103651,Wang; Joseph,0,0,0,0
1667910355912,ECE 250,A00,103652,Siegel; Paul H.,0,0,0,0
1667910356342,ECE 251A,A00,103654,Rao; Bhaskar D.,0,0,0,0
1667910356777,ECE 257B,A00,103655,Bharadia; Dinesh,0,0,0,0
1667910357213,ECE 258A,A00,103656,Milstein; Laurence B.,0,0,0,0
1667910357647,ECE 260B,A00,103658,Kang; Mingu,0,0,0,0
1667910358093,ECE 264A,A00,103659,Galton; Ian A,0,0,0,0
1667910358546,ECE 265A,A00,103661,Gudem; Prasad S.S.,0,0,0,0
1667910358972,ECE 265D,A00,103662,Gudem; Prasad S.S.,0,0,0,0
1667910359408,ECE 268,A00,103663,Koushanfar; Farinaz,0,0,0,0
1667910359846,ECE 269,A01,103665,Pal; Piya,0,0,0,0
1667910360294,ECE 271B,A00,103666,Vasconcelos; Manuela,0,0,0,0
1667910360727,ECE 276A,A00,103667,Atanasov; Nikolay A.,0,0,0,0
1667910361163,ECE 277,A00,103668,An; Cheolhong,0,0,0,0
1667910361590,ECE 279,A00,117947,Hall; Drew A.,0,0,0,0
1667910362481,ECE 283,A00,103670,Hsueh; Tzu-Chien,0,0,0,0
1667910362928,ECE 284,A00,103671,Turakhia; Yatish Girish,0,0,0,0
1667910363368,ECE 285,A00,103672,Zheng; Yang,0,0,0,0
1667910363368,ECE 285,B00,103673,Sworder; David D.,0,0,0,0
1667910363803,ECE 287,A00,103676,Javidi; Tara,0,0,0,0
1667910364244,MATH 200B,A00,098023,Salehi Golsefidy; Alireza,15,0,15,0
1667910364681,MATH 202B,A00,098024,Rhoades; Brendon Patrick,14,0,15,1
1667910365107,MATH 203B,A00,098025,Oprea; Dragos N.,14,0,15,1
1667910365546,MATH 204B,A00,098026,Sorensen; Claus M,15,0,15,0
1667910365973,MATH 208,A00,098027,Izadi; Elham,7,0,10,3
1667910366406,MATH 209,A00,098028,Pollack; Aaron,10,0,10,0
1667910366834,MATH 211A,A00,112919,Rogalski; Daniel,10,0,10,0
1667910367264,MATH 211B,A00,112920,Seward; Brandon M.,10,0,10,0
1667910367697,MATH 218,A00,098029,Li; Bo,10,0,10,0
1667910368129,MATH 220B,A00,098030,Novak; Jonathan I,15,0,15,0
1667910368566,MATH 221A,A00,098031,Ebenfelt; Peter F,15,0,15,0
1667910369007,MATH 231B,A00,098032,Zlatos; Andrej,15,0,15,0
1667910369439,MATH 240B,A00,098033,Ni; Lei,13,0,15,2
1667910369876,MATH 243,A00,098034,Jekel; David Andrew,10,0,10,0
1667910370308,MATH 245A,A00,098035,Nie; Jiawang,6,0,15,9
1667910370760,MATH 248,A00,098036,Bejenaru; Ioan,10,0,10,0
1667910371192,MATH 250B,A00,098037,Spolaor; Luca,14,0,15,1
1667910371629,MATH 258,A00,098038,Ni; Lei,10,0,10,0
1667910372068,MATH 264B,A00,098041,Rhoades; Brendon Patrick,13,0,15,2
1667910372496,MATH 268,A00,098042,Buss; Samuel R,10,0,10,0
1667910372921,MATH 269,A00,098043,Rhoades; Brendon Patrick,10,0,10,0
1667910373355,MATH 270B,A00,098044,Li; Bo,13,0,15,2
1667910373793,MATH 272B,A00,098045,Holst; Michael J,13,0,15,2
1667910374229,MATH 273A,A00,098046,Tian; Xiaochuan,12,0,15,3
1667910374661,MATH 275,A01,098048,Tian; Xiaochuan,7,0,10,3
1667910375102,MATH 278A,A00,098049,Holst; Michael J,8,0,10,2
1667910375540,MATH 278B,A00,098050,Cloninger; Alexander,10,0,10,0
1667910375975,MATH 278C,A00,098051,Nie; Jiawang,9,0,10,1
1667910376410,MATH 280B,A00,098052,Zheng; Tianyi,12,0,15,3
1667910376839,MATH 281B,A00,098053,Bradic; Jelena,6,0,15,9
1667910377270,MATH 282B,A00,098054,Arias-Castro; Ery,2,0,15,13
1667910377699,MATH 285,A00,098055,Fitzsimmons; Patrick J,3,0,15,12
1667910378135,MATH 287B,A00,098056,Arias-Castro; Ery,9,0,15,6
1667910378567,MATH 288,A00,098057,Agarwal; Pooja,9,0,10,1
1667910378567,MATH 288,B00,098058,Zhang; Danna,9,0,10,1
1667910378567,MATH 288,C00,098059,Williams; Ruth J,10,0,10,0
1667910379013,MATH 290B,A00,098060,Roberts; Justin Deritter,14,0,15,1
1667910379447,MATH 292,A00,098061,Belmont; Eva Kinoshita,10,0,10,0
1667910379895,MATH 295,A00,098062,Suk; Andrew Hoon,48,0,50,2
1667910380330,MATH 296,A00,098063,Novak; Jonathan I,20,0,20,0
1667910380760,MATH 297,001,098064,Gamst; Anthony Collins,9997,0,9999,2
1667910892940,COGS 205,A00,101395,Chiba; Andrea,20,0,20,0
1667910893368,COGS 210B,001,101404,Greene; Deanna Jacquelyn,9998,0,9999,1
1667910893368,COGS 210B,002,101417,Xia; Haijun,9999,0,9999,0
1667910893368,COGS 210B,003,101422,Nitz; Douglas A.,9999,0,9999,0
1667910893368,COGS 210B,004,101423,Hollan; James D.,9998,0,9999,1
1667910893368,COGS 210B,005,101424,Deak; Gedeon O.,9999,0,9999,0
1667910893368,COGS 210B,006,101425,Rossano; Federico,9999,0,9999,0
1667910893793,COGS 211B,A00,101427,Coulson; Seana M,9997,0,9999,2
1667910894219,COGS 220,A00,101428,Hollan; James D.,0,0,25,25
1667910894648,COGS 229,A00,101429,Dow; Steven P,19,0,25,6
1667910895088,COGS 230,A00,101430,Klemmer; Scott R,13,0,17,4
1667910895515,COGS 234,A00,101431,Xia; Haijun,11,0,25,14
1667910895942,COGS 260,A00,101432,Kiyonaga; Anastasia,20,0,25,5
1667910895942,COGS 260,B00,101433,Kirsh; David Joel,18,0,25,7
1667910896374,CSE 202,A00,102371,Impagliazzo; Russell,0,0,0,0
1667910896804,CSE 203B,A01,102373,Cheng; Chung Kuan,0,0,0,0
1667910897237,CSE 208,A00,102374,Micciancio; Daniele,0,0,0,0
1667910897668,CSE 209A,A00,112895,Impagliazzo; Russell,0,0,15,15
1667910898119,CSE 209B,A00,108005,Bellare; Mihir,0,0,0,0
1667910898556,CSE 210,A00,113163,Coblenz; Michael J,0,0,0,0
1667910899004,CSE 219,A00,106111,Dow; Steven P,0,0,20,20
1667910899433,CSE 221,A00,102376,Voelker; Geoffrey M.,0,0,0,0
1667910899868,CSE 224,A01,102378,Porter; George M,0,0,0,0
1667910900300,CSE 229A,A00,102379,Savage; Stefan,0,0,0,0
1667910900747,CSE 229C,A00,102380,Munyaka; Imani N. S.,0,0,0,0
1667910901179,CSE 232B,A00,102382,Deutsch; Alin Bernard,0,0,0,0
1667910901653,CSE 234,A01,112904,Kumar; Arun Kumar,0,0,0,0
1667910902089,CSE 237A,A00,102383,Rosing; Tajana Simunic,0,0,0,0
1667910902518,CSE 239A,A00,102384,Deutsch; Alin Bernard,0,0,0,0
1667910902954,CSE 239B,A00,102385,Polikarpova; Nadezhda,0,0,0,0
1667910903402,CSE 240A,A00,102386,Pannuto; Patrick William,0,0,0,0
1667910903834,CSE 240B,A00,102387,Zhao; Jishen,0,0,0,0
1667910904259,CSE 241A,A00,106406,Kang; Mingu,0,0,0,0
1667910904722,CSE 249B,A00,102388,Kahng; Andrew Byun,0,0,8,8
1667910905152,CSE 251B,A01,102392,Cottrell; Garrison W,0,0,0,0
1667910905152,CSE 251B,A02,102393,Cottrell; Garrison W,0,0,0,0
1667910905600,CSE 252B,A00,102394,Ochoa; Benjamin Lawrence,0,0,0,0
1667910906033,CSE 257,A01,102396,Gao; Sicun,0,0,0,0
1667910906462,CSE 272,A00,102397,Li; Tzumao,0,0,0,0
1667910906892,CSE 274,A00,111323,Chern; Albert Ren-Haur,0,0,0,0
1667910907323,CSE 282,A00,102398,Pevzner; Pavel Arkadjevich,0,0,0,0
1667910907768,CSE 284,A00,114175,Gymrek; Melissa Ann,0,0,0,0
1667910908228,CSE 290,A00,102399,Chandraker; Manmohan Krishna,0,0,0,0
1667910908228,CSE 290,B00,102400,Vaccaro; Kristen Marie,0,0,25,25
1667910908228,CSE 290,C00,102414,Pannuto; Patrick William,0,0,25,25
1667910908228,CSE 290,D00,102427,Pevzner; Pavel Arkadjevich,0,0,0,0
1667910908228,CSE 290,E00,102429,Zhao; Jishen,0,0,0,0
1667910908228,CSE 290,F00,102436,Tullsen; Dean Michael,0,0,0,0
1667910908228,CSE 290,G00,102440,Christensen; Henrik I,0,0,20,20
1667910908679,CSE 291,A00,102443,Su; Hao,0,0,0,0
1667910908679,CSE 291,B00,102448,Polikarpova; Nadezhda,0,0,0,0
1667910908679,CSE 291,C00,102453,Vaccaro; Kristen Marie,0,0,0,0
1667910908679,CSE 291,D00,111343,Savage; Stefan,0,0,0,0
1667910908679,CSE 291,E00,116474,Claffy; Kimberly Claire,0,0,0,0
1667910908679,CSE 291,F00,116479,Pasquale; Joseph,0,0,0,0
1667910909144,CSE 293,001,119111,Bafna; Vineet,9999,0,9999,0
1667910909144,CSE 293,002,119118,Bellare; Mihir,9999,0,9999,0
1667910909144,CSE 293,003,119122,Berg-Kirkpatrick; Taylor D,9999,0,9999,0
1667910909144,CSE 293,004,119135,Christensen; Henrik I,9999,0,9999,0
1667910909144,CSE 293,005,119142,Cottrell; Garrison W,9999,0,9999,0
1667910909144,CSE 293,006,119146,Deutsch; Alin Bernard,9999,0,9999,0
1667910909144,CSE 293,007,119159,Esmaeilzadeh; Hadi,9999,0,9999,0
1667910909144,CSE 293,008,119166,Freund; Yoav,9999,0,9999,0
1667910909144,CSE 293,009,119170,Griswold; William G.,9999,0,9999,0
1667910909144,CSE 293,010,119183,Gymrek; Melissa Ann,9999,0,9999,0
1667910909144,CSE 293,011,119190,Heninger; Nadia A,9999,0,9999,0
1667910909144,CSE 293,012,119230,Impagliazzo; Russell,9999,0,9999,0
1667910909144,CSE 293,013,119232,Jhala; Ranjit,9999,0,9999,0
1667910909144,CSE 293,014,119233,Kahng; Andrew Byun,9999,0,9999,0
1667910909144,CSE 293,015,119298,Kane; Daniel Mertz,9999,0,9999,0
1667910909144,CSE 293,016,119299,Kriegman; David J,9999,0,9999,0
1667910909144,CSE 293,017,119300,Kumar; Arun Kumar,9999,0,9999,0
1667910909144,CSE 293,018,119301,Lerner; Sorin,9999,0,9999,0
1667910909144,CSE 293,019,119302,Lovett; Shachar,9999,0,9999,0
1667910909144,CSE 293,020,119303,McAuley; Julian John,9999,0,9999,0
1667910909144,CSE 293,021,119304,Micciancio; Daniele,9999,0,9999,0
1667910909144,CSE 293,022,119367,Orailoglu; Alex,9999,0,9999,0
1667910909144,CSE 293,023,119382,Paturi; Ramamohan,9999,0,9999,0
1667910909144,CSE 293,024,119404,Polikarpova; Nadezhda,9999,0,9999,0
1667910909144,CSE 293,025,119406,Politz; Joseph Gibbs,9999,0,9999,0
1667910909144,CSE 293,026,119411,Porter; George M,9999,0,9999,0
1667910909144,CSE 293,027,119414,Porter; Leonard Emerson,9999,0,9999,0
1667910909144,CSE 293,028,119416,Ramamoorthi; Ravi,9999,0,9999,0
1667910909144,CSE 293,029,119417,Sahoo; Debashis,9999,0,9999,0
1667910909144,CSE 293,030,119420,Saul; Lawrence,9999,0,9999,0
1667910909144,CSE 293,031,119421,Savage; Stefan,9999,0,9999,0
1667910909144,CSE 293,032,119425,Schulze; Jurgen P.,9999,0,9999,0
1667910909144,CSE 293,033,119426,Snoeren; Alex C.,9999,0,9999,0
1667910909144,CSE 293,034,119428,Shang; Jingbo,9999,0,9999,0
1667910909144,CSE 293,035,119430,Stefan; Deian,9999,0,9999,0
1667910909144,CSE 293,036,119431,Su; Hao,9999,0,9999,0
1667910909144,CSE 293,037,119433,Swanson; Steven James,9999,0,9999,0
1667910909144,CSE 293,038,119435,Tullsen; Dean Michael,9999,0,9999,0
1667910909144,CSE 293,039,119483,Voelker; Geoffrey M.,9999,0,9999,0
1667910909144,CSE 293,040,119537,Zhao; Jishen,9999,0,9999,0
1667910909144,CSE 293,041,119538,Zhou; Yuan-Yuan,9999,0,9999,0
1667910909144,CSE 293,042,119539,Gao; Sicun,9999,0,9999,0
1667910909144,CSE 293,043,119540,Weibel; Nadir,9999,0,9999,0
1667910909144,CSE 293,044,119541,Gupta; Rajesh K.,9999,0,9999,0
1667910909574,CSE 294,A00,102459,Voelker; Geoffrey M.,0,0,0,0
1667910909574,CSE 294,B00,111322,Orailoglu; Alex,0,0,0,0
1667910910004,DSE 201,A00,096914,Deutsch; Alin Bernard,30,0,30,0
1667910910442,DSE 210,A00,096915,Dasgupta; Sanjoy,30,0,30,0
1667910910877,DSE 260A,A00,096916,Altintas De Callaf; Ilkay,30,0,30,0
1667910911327,ECE 200,001,103586,Antipa; Nicholas A,9999,0,9999,0
1667910911327,ECE 200,002,103587,Atanasov; Nikolay A.,9999,0,9999,0
1667910911327,ECE 200,003,103588,Bharadia; Dinesh,9999,0,9999,0
1667910911327,ECE 200,004,103589,Cheng; Chung Kuan,9999,0,9999,0
1667910911327,ECE 200,005,103590,Cosman; Pamela C.,9999,0,9999,0
1667910911327,ECE 200,006,103591,Dayeh; Shadi Ahmad,9999,0,9999,0
1667910911327,ECE 200,007,103592,Fainman; Yeshaiahu,9999,0,9999,0
1667910911327,ECE 200,008,103593,Ford; Joseph Earl,9999,0,9999,0
1667910911327,ECE 200,009,103594,Franceschetti; Massimo,9999,0,9999,0
1667910911327,ECE 200,010,103595,Fullerton; Eric E,9999,0,9999,0
1667910911327,ECE 200,011,103596,Galton; Ian A,9999,0,9999,0
1667910911327,ECE 200,012,103597,Gilja; Vikash,9999,0,9999,0
1667910911327,ECE 200,013,103598,Hall; Drew A.,9999,0,9999,0
1667910911327,ECE 200,014,103599,Hsueh; Tzu-Chien,9999,0,9999,0
1667910911327,ECE 200,015,103600,Javidi; Tara,9999,0,9999,0
1667910911327,ECE 200,016,103601,Kahng; Andrew Byun,9999,0,9999,0
1667910911327,ECE 200,017,103602,Kim; Young-Han,9999,0,9999,0
1667910911327,ECE 200,018,103603,Koushanfar; Farinaz,9999,0,9999,0
1667910911327,ECE 200,019,103604,Kuzum; Duygu,9999,0,9999,0
1667910911327,ECE 200,020,103605,Le; Hanh-Phuc,9999,0,9999,0
1667910911327,ECE 200,021,103606,Lin; Bill,9999,0,9999,0
1667910911327,ECE 200,022,103607,Liu; Zhaowei,9998,0,9999,1
1667910911327,ECE 200,023,103608,Lo; Yu-Hwa,9999,0,9999,0
1667910911327,ECE 200,024,103609,Lomakin; Vitaliy,9999,0,9999,0
1667910911327,ECE 200,025,103610,Mercier; Patrick Philip,9999,0,9999,0
1667910911327,ECE 200,026,103611,Meyer; Florian,9999,0,9999,0
1667910911327,ECE 200,027,103612,Milstein; Laurence B.,9999,0,9999,0
1667910911327,ECE 200,028,103613,Mir Arabbaygi; Siavash,9999,0,9999,0
1667910911327,ECE 200,029,103614,Mookherjea; Shayan,9999,0,9999,0
1667910911327,ECE 200,030,103615,Morris; Karcher William,9999,0,9999,0
1667910911327,ECE 200,031,103616,Ng; Tse Nga,9999,0,9999,0
1667910911327,ECE 200,032,103617,Nguyen; Truong Quang,9999,0,9999,0
1667910911327,ECE 200,033,103618,Nomura; Kenji,9999,0,9999,0
1667910911327,ECE 200,034,103619,Orlitsky; Alon,9999,0,9999,0
1667910911327,ECE 200,035,103620,Pal; Piya,9999,0,9999,0
1667910911327,ECE 200,036,103621,Papen; George C.,9999,0,9999,0
1667910911327,ECE 200,037,103622,Radic; Stojan,9999,0,9999,0
1667910911327,ECE 200,038,103623,Rao; Bhaskar D.,9999,0,9999,0
1667910911327,ECE 200,039,103624,Rao; Ramesh R,9999,0,9999,0
1667910911327,ECE 200,040,103625,Rebeiz; Gabriel,9999,0,9999,0
1667910911327,ECE 200,041,103626,Sanford; John R,9999,0,9999,0
1667910911327,ECE 200,042,103627,Siegel; Paul H.,9999,0,9999,0
1667910911327,ECE 200,043,103628,Sievenpiper; Daniel F.,9999,0,9999,0
1667910911327,ECE 200,044,103629,Sworder; David D.,9999,0,9999,0
1667910911327,ECE 200,045,103630,Taur; Yuan,9999,0,9999,0
1667910911327,ECE 200,046,103631,Touri; Behrouz,9999,0,9999,0
1667910911327,ECE 200,047,103632,Trivedi; Mohan M.,9999,0,9999,0
1667910911327,ECE 200,048,103633,Vasconcelos; Nuno,9999,0,9999,0
1667910911327,ECE 200,049,103634,Wang; Xiaolong,9999,0,9999,0
1667910911327,ECE 200,050,103635,Xie; Pengtao,9999,0,9999,0
1667910911327,ECE 200,051,103636,Yip; Michael,9999,0,9999,0
1667910911327,ECE 200,052,103637,Zeger; Kenneth A.,999,0,999,0
1667910911327,ECE 200,053,103638,Zhang; Xinyu,9999,0,9999,0
1667910911327,ECE 200,054,103639,Turakhia; Yatish Girish,9999,0,9999,0
1667910911327,ECE 200,055,103640,Kang; Mingu,9999,0,9999,0
1667910911327,ECE 200,056,103641,Shi; Yuanyuan,9999,0,9999,0
1667910911327,ECE 200,057,103642,Wang; Edward Jay,9999,0,9999,0
1667910911327,ECE 200,058,103643,Zheng; Yang,9999,0,9999,0
1667910911758,ECE 202,A00,103644,Kuzum; Duygu,0,0,0,0
1667910912186,ECE 212BN,A00,103646,Ng; Tse Nga,0,0,0,0
1667910912616,ECE 221,A00,111493,Staff,0,0,0,0
1667910913049,ECE 222B,A00,103647,Lomakin; Vitaliy,0,0,0,0
1667910913483,ECE 230B,A00,103648,Taur; Yuan,0,0,0,0
1667910913911,ECE 238B,A00,103649,Garay; Javier,0,0,0,0
1667910914349,ECE 240B,A00,112900,Fainman; Yeshaiahu,0,0,0,0
1667910914786,ECE 247A,A00,103650,Jokerst; Jesse Vincent,0,0,0,0
1667910915217,ECE 247B,A00,103651,Wang; Joseph,0,0,0,0
1667910915650,ECE 250,A00,103652,Siegel; Paul H.,0,0,0,0
1667910916120,ECE 251A,A00,103654,Rao; Bhaskar D.,0,0,0,0
1667910916552,ECE 257B,A00,103655,Bharadia; Dinesh,0,0,0,0
1667910916992,ECE 258A,A00,103656,Milstein; Laurence B.,0,0,0,0
1667910917414,ECE 260B,A00,103658,Kang; Mingu,0,0,0,0
1667910917844,ECE 264A,A00,103659,Galton; Ian A,0,0,0,0
1667910918276,ECE 265A,A00,103661,Gudem; Prasad S.S.,0,0,0,0
1667910918726,ECE 265D,A00,103662,Gudem; Prasad S.S.,0,0,0,0
1667910919157,ECE 268,A00,103663,Koushanfar; Farinaz,0,0,0,0
1667910919595,ECE 269,A01,103665,Pal; Piya,0,0,0,0
1667910920027,ECE 271B,A00,103666,Vasconcelos; Manuela,0,0,0,0
1667910920463,ECE 276A,A00,103667,Atanasov; Nikolay A.,0,0,0,0
1667910920898,ECE 277,A00,103668,An; Cheolhong,0,0,0,0
1667910921324,ECE 279,A00,117947,Hall; Drew A.,0,0,0,0
1667910922193,ECE 283,A00,103670,Hsueh; Tzu-Chien,0,0,0,0
1667910922620,ECE 284,A00,103671,Turakhia; Yatish Girish,0,0,0,0
1667910923070,ECE 285,A00,103672,Zheng; Yang,0,0,0,0
1667910923070,ECE 285,B00,103673,Sworder; David D.,0,0,0,0
1667910923494,ECE 287,A00,103676,Javidi; Tara,0,0,0,0
1667910923943,MATH 200B,A00,098023,Salehi Golsefidy; Alireza,15,0,15,0
1667910924376,MATH 202B,A00,098024,Rhoades; Brendon Patrick,14,0,15,1
1667910924813,MATH 203B,A00,098025,Oprea; Dragos N.,14,0,15,1
1667910925240,MATH 204B,A00,098026,Sorensen; Claus M,15,0,15,0
1667910925709,MATH 208,A00,098027,Izadi; Elham,7,0,10,3
1667910926150,MATH 209,A00,098028,Pollack; Aaron,10,0,10,0
1667910926582,MATH 211A,A00,112919,Rogalski; Daniel,10,0,10,0
1667910927014,MATH 211B,A00,112920,Seward; Brandon M.,10,0,10,0
1667910927442,MATH 218,A00,098029,Li; Bo,10,0,10,0
1667910927868,MATH 220B,A00,098030,Novak; Jonathan I,15,0,15,0
1667910928330,MATH 221A,A00,098031,Ebenfelt; Peter F,15,0,15,0
1667910928771,MATH 231B,A00,098032,Zlatos; Andrej,15,0,15,0
1667910929199,MATH 240B,A00,098033,Ni; Lei,13,0,15,2
1667910929712,MATH 243,A00,098034,Jekel; David Andrew,10,0,10,0
1667910930138,MATH 245A,A00,098035,Nie; Jiawang,6,0,15,9
1667910930572,MATH 248,A00,098036,Bejenaru; Ioan,10,0,10,0
1667910931002,MATH 250B,A00,098037,Spolaor; Luca,14,0,15,1
1667910931435,MATH 258,A00,098038,Ni; Lei,10,0,10,0
1667910931858,MATH 264B,A00,098041,Rhoades; Brendon Patrick,13,0,15,2
1667910932285,MATH 268,A00,098042,Buss; Samuel R,10,0,10,0
1667910932718,MATH 269,A00,098043,Rhoades; Brendon Patrick,10,0,10,0
1667910933153,MATH 270B,A00,098044,Li; Bo,13,0,15,2
1667910933590,MATH 272B,A00,098045,Holst; Michael J,13,0,15,2
1667910934020,MATH 273A,A00,098046,Tian; Xiaochuan,12,0,15,3
1667910934462,MATH 275,A01,098048,Tian; Xiaochuan,7,0,10,3
1667910934933,MATH 278A,A00,098049,Holst; Michael J,8,0,10,2
1667910935369,MATH 278B,A00,098050,Cloninger; Alexander,10,0,10,0
1667910935816,MATH 278C,A00,098051,Nie; Jiawang,9,0,10,1
1667910936255,MATH 280B,A00,098052,Zheng; Tianyi,12,0,15,3
1667910936684,MATH 281B,A00,098053,Bradic; Jelena,6,0,15,9
1667910937109,MATH 282B,A00,098054,Arias-Castro; Ery,2,0,15,13
1667910937539,MATH 285,A00,098055,Fitzsimmons; Patrick J,3,0,15,12
1667910937965,MATH 287B,A00,098056,Arias-Castro; Ery,9,0,15,6
1667910938409,MATH 288,A00,098057,Agarwal; Pooja,9,0,10,1
1667910938409,MATH 288,B00,098058,Zhang; Danna,9,0,10,1
1667910938409,MATH 288,C00,098059,Williams; Ruth J,10,0,10,0
1667910938843,MATH 290B,A00,098060,Roberts; Justin Deritter,14,0,15,1
1667910939275,MATH 292,A00,098061,Belmont; Eva Kinoshita,10,0,10,0
1667910939699,MATH 295,A00,098062,Suk; Andrew Hoon,48,0,50,2
1667910940127,MATH 296,A00,098063,Novak; Jonathan I,20,0,20,0
1667910940559,MATH 297,001,098064,Gamst; Anthony Collins,9997,0,9999,2
1667911451450,COGS 205,A00,101395,Chiba; Andrea,20,0,20,0
1667911451879,COGS 210B,001,101404,Greene; Deanna Jacquelyn,9998,0,9999,1
1667911451879,COGS 210B,002,101417,Xia; Haijun,9999,0,9999,0
1667911451879,COGS 210B,003,101422,Nitz; Douglas A.,9999,0,9999,0
1667911451879,COGS 210B,004,101423,Hollan; James D.,9998,0,9999,1
1667911451879,COGS 210B,005,101424,Deak; Gedeon O.,9999,0,9999,0
1667911451879,COGS 210B,006,101425,Rossano; Federico,9999,0,9999,0
1667911452311,COGS 211B,A00,101427,Coulson; Seana M,9997,0,9999,2
1667911452740,COGS 220,A00,101428,Hollan; James D.,0,0,25,25
1667911453173,COGS 229,A00,101429,Dow; Steven P,19,0,25,6
1667911453607,COGS 230,A00,101430,Klemmer; Scott R,13,0,17,4
1667911454037,COGS 234,A00,101431,Xia; Haijun,11,0,25,14
1667911454470,COGS 260,A00,101432,Kiyonaga; Anastasia,20,0,25,5
1667911454470,COGS 260,B00,101433,Kirsh; David Joel,18,0,25,7
1667911454901,CSE 202,A00,102371,Impagliazzo; Russell,0,0,0,0
1667911455341,CSE 203B,A01,102373,Cheng; Chung Kuan,0,0,0,0
1667911455773,CSE 208,A00,102374,Micciancio; Daniele,0,0,0,0
1667911456200,CSE 209A,A00,112895,Impagliazzo; Russell,0,0,15,15
1667911456626,CSE 209B,A00,108005,Bellare; Mihir,0,0,0,0
1667911457067,CSE 210,A00,113163,Coblenz; Michael J,0,0,0,0
1667911457505,CSE 219,A00,106111,Dow; Steven P,0,0,20,20
1667911457929,CSE 221,A00,102376,Voelker; Geoffrey M.,0,0,0,0
1667911458379,CSE 224,A01,102378,Porter; George M,0,0,0,0
1667911458815,CSE 229A,A00,102379,Savage; Stefan,0,0,0,0
1667911459249,CSE 229C,A00,102380,Munyaka; Imani N. S.,0,0,0,0
1667911459694,CSE 232B,A00,102382,Deutsch; Alin Bernard,0,0,0,0
1667911460136,CSE 234,A01,112904,Kumar; Arun Kumar,0,0,0,0
1667911460572,CSE 237A,A00,102383,Rosing; Tajana Simunic,0,0,0,0
1667911461098,CSE 239A,A00,102384,Deutsch; Alin Bernard,0,0,0,0
1667911461538,CSE 239B,A00,102385,Polikarpova; Nadezhda,0,0,0,0
1667911461965,CSE 240A,A00,102386,Pannuto; Patrick William,0,0,0,0
1667911462408,CSE 240B,A00,102387,Zhao; Jishen,0,0,0,0
1667911462837,CSE 241A,A00,106406,Kang; Mingu,0,0,0,0
1667911463279,CSE 249B,A00,102388,Kahng; Andrew Byun,0,0,8,8
1667911463724,CSE 251B,A01,102392,Cottrell; Garrison W,0,0,0,0
1667911463724,CSE 251B,A02,102393,Cottrell; Garrison W,0,0,0,0
1667911464164,CSE 252B,A00,102394,Ochoa; Benjamin Lawrence,0,0,0,0
1667911464592,CSE 257,A01,102396,Gao; Sicun,0,0,0,0
1667911465022,CSE 272,A00,102397,Li; Tzumao,0,0,0,0
1667911465456,CSE 274,A00,111323,Chern; Albert Ren-Haur,0,0,0,0
1667911465883,CSE 282,A00,102398,Pevzner; Pavel Arkadjevich,0,0,0,0
1667911466318,CSE 284,A00,114175,Gymrek; Melissa Ann,0,0,0,0
1667911466749,CSE 290,A00,102399,Chandraker; Manmohan Krishna,0,0,0,0
1667911466749,CSE 290,B00,102400,Vaccaro; Kristen Marie,0,0,25,25
1667911466749,CSE 290,C00,102414,Pannuto; Patrick William,0,0,25,25
1667911466749,CSE 290,D00,102427,Pevzner; Pavel Arkadjevich,0,0,0,0
1667911466749,CSE 290,E00,102429,Zhao; Jishen,0,0,0,0
1667911466749,CSE 290,F00,102436,Tullsen; Dean Michael,0,0,0,0
1667911466749,CSE 290,G00,102440,Christensen; Henrik I,0,0,20,20
1667911467180,CSE 291,A00,102443,Su; Hao,0,0,0,0
1667911467180,CSE 291,B00,102448,Polikarpova; Nadezhda,0,0,0,0
1667911467180,CSE 291,C00,102453,Vaccaro; Kristen Marie,0,0,0,0
1667911467180,CSE 291,D00,111343,Savage; Stefan,0,0,0,0
1667911467180,CSE 291,E00,116474,Claffy; Kimberly Claire,0,0,0,0
1667911467180,CSE 291,F00,116479,Pasquale; Joseph,0,0,0,0
1667911467648,CSE 293,001,119111,Bafna; Vineet,9999,0,9999,0
1667911467648,CSE 293,002,119118,Bellare; Mihir,9999,0,9999,0
1667911467648,CSE 293,003,119122,Berg-Kirkpatrick; Taylor D,9999,0,9999,0
1667911467648,CSE 293,004,119135,Christensen; Henrik I,9999,0,9999,0
1667911467648,CSE 293,005,119142,Cottrell; Garrison W,9999,0,9999,0
1667911467648,CSE 293,006,119146,Deutsch; Alin Bernard,9999,0,9999,0
1667911467648,CSE 293,007,119159,Esmaeilzadeh; Hadi,9999,0,9999,0
1667911467648,CSE 293,008,119166,Freund; Yoav,9999,0,9999,0
1667911467648,CSE 293,009,119170,Griswold; William G.,9999,0,9999,0
1667911467648,CSE 293,010,119183,Gymrek; Melissa Ann,9999,0,9999,0
1667911467648,CSE 293,011,119190,Heninger; Nadia A,9999,0,9999,0
1667911467648,CSE 293,012,119230,Impagliazzo; Russell,9999,0,9999,0
1667911467648,CSE 293,013,119232,Jhala; Ranjit,9999,0,9999,0
1667911467648,CSE 293,014,119233,Kahng; Andrew Byun,9999,0,9999,0
1667911467648,CSE 293,015,119298,Kane; Daniel Mertz,9999,0,9999,0
1667911467648,CSE 293,016,119299,Kriegman; David J,9999,0,9999,0
1667911467648,CSE 293,017,119300,Kumar; Arun Kumar,9999,0,9999,0
1667911467648,CSE 293,018,119301,Lerner; Sorin,9999,0,9999,0
1667911467648,CSE 293,019,119302,Lovett; Shachar,9999,0,9999,0
1667911467648,CSE 293,020,119303,McAuley; Julian John,9999,0,9999,0
1667911467648,CSE 293,021,119304,Micciancio; Daniele,9999,0,9999,0
1667911467648,CSE 293,022,119367,Orailoglu; Alex,9999,0,9999,0
1667911467648,CSE 293,023,119382,Paturi; Ramamohan,9999,0,9999,0
1667911467648,CSE 293,024,119404,Polikarpova; Nadezhda,9999,0,9999,0
1667911467648,CSE 293,025,119406,Politz; Joseph Gibbs,9999,0,9999,0
1667911467648,CSE 293,026,119411,Porter; George M,9999,0,9999,0
1667911467648,CSE 293,027,119414,Porter; Leonard Emerson,9999,0,9999,0
1667911467648,CSE 293,028,119416,Ramamoorthi; Ravi,9999,0,9999,0
1667911467648,CSE 293,029,119417,Sahoo; Debashis,9999,0,9999,0
1667911467648,CSE 293,030,119420,Saul; Lawrence,9999,0,9999,0
1667911467648,CSE 293,031,119421,Savage; Stefan,9999,0,9999,0
1667911467648,CSE 293,032,119425,Schulze; Jurgen P.,9999,0,9999,0
1667911467648,CSE 293,033,119426,Snoeren; Alex C.,9999,0,9999,0
1667911467648,CSE 293,034,119428,Shang; Jingbo,9999,0,9999,0
1667911467648,CSE 293,035,119430,Stefan; Deian,9999,0,9999,0
1667911467648,CSE 293,036,119431,Su; Hao,9999,0,9999,0
1667911467648,CSE 293,037,119433,Swanson; Steven James,9999,0,9999,0
1667911467648,CSE 293,038,119435,Tullsen; Dean Michael,9999,0,9999,0
1667911467648,CSE 293,039,119483,Voelker; Geoffrey M.,9999,0,9999,0
1667911467648,CSE 293,040,119537,Zhao; Jishen,9999,0,9999,0
1667911467648,CSE 293,041,119538,Zhou; Yuan-Yuan,9999,0,9999,0
1667911467648,CSE 293,042,119539,Gao; Sicun,9999,0,9999,0
1667911467648,CSE 293,043,119540,Weibel; Nadir,9999,0,9999,0
1667911467648,CSE 293,044,119541,Gupta; Rajesh K.,9999,0,9999,0
1667911468082,CSE 294,A00,102459,Voelker; Geoffrey M.,0,0,0,0
1667911468082,CSE 294,B00,111322,Orailoglu; Alex,0,0,0,0
1667911468509,DSE 201,A00,096914,Deutsch; Alin Bernard,30,0,30,0
1667911468948,DSE 210,A00,096915,Dasgupta; Sanjoy,30,0,30,0
1667911469377,DSE 260A,A00,096916,Altintas De Callaf; Ilkay,30,0,30,0
1667911469875,ECE 200,001,103586,Antipa; Nicholas A,9999,0,9999,0
1667911469875,ECE 200,002,103587,Atanasov; Nikolay A.,9999,0,9999,0
1667911469875,ECE 200,003,103588,Bharadia; Dinesh,9999,0,9999,0
1667911469875,ECE 200,004,103589,Cheng; Chung Kuan,9999,0,9999,0
1667911469875,ECE 200,005,103590,Cosman; Pamela C.,9999,0,9999,0
1667911469875,ECE 200,006,103591,Dayeh; Shadi Ahmad,9999,0,9999,0
1667911469875,ECE 200,007,103592,Fainman; Yeshaiahu,9999,0,9999,0
1667911469875,ECE 200,008,103593,Ford; Joseph Earl,9999,0,9999,0
1667911469875,ECE 200,009,103594,Franceschetti; Massimo,9999,0,9999,0
1667911469875,ECE 200,010,103595,Fullerton; Eric E,9999,0,9999,0
1667911469875,ECE 200,011,103596,Galton; Ian A,9999,0,9999,0
1667911469875,ECE 200,012,103597,Gilja; Vikash,9999,0,9999,0
1667911469875,ECE 200,013,103598,Hall; Drew A.,9999,0,9999,0
1667911469875,ECE 200,014,103599,Hsueh; Tzu-Chien,9999,0,9999,0
1667911469875,ECE 200,015,103600,Javidi; Tara,9999,0,9999,0
1667911469875,ECE 200,016,103601,Kahng; Andrew Byun,9999,0,9999,0
1667911469875,ECE 200,017,103602,Kim; Young-Han,9999,0,9999,0
1667911469875,ECE 200,018,103603,Koushanfar; Farinaz,9999,0,9999,0
1667911469875,ECE 200,019,103604,Kuzum; Duygu,9999,0,9999,0
1667911469875,ECE 200,020,103605,Le; Hanh-Phuc,9999,0,9999,0
1667911469875,ECE 200,021,103606,Lin; Bill,9999,0,9999,0
1667911469875,ECE 200,022,103607,Liu; Zhaowei,9998,0,9999,1
1667911469875,ECE 200,023,103608,Lo; Yu-Hwa,9999,0,9999,0
1667911469875,ECE 200,024,103609,Lomakin; Vitaliy,9999,0,9999,0
1667911469875,ECE 200,025,103610,Mercier; Patrick Philip,9999,0,9999,0
1667911469875,ECE 200,026,103611,Meyer; Florian,9999,0,9999,0
1667911469875,ECE 200,027,103612,Milstein; Laurence B.,9999,0,9999,0
1667911469875,ECE 200,028,103613,Mir Arabbaygi; Siavash,9999,0,9999,0
1667911469875,ECE 200,029,103614,Mookherjea; Shayan,9999,0,9999,0
1667911469875,ECE 200,030,103615,Morris; Karcher William,9999,0,9999,0
1667911469875,ECE 200,031,103616,Ng; Tse Nga,9999,0,9999,0
1667911469875,ECE 200,032,103617,Nguyen; Truong Quang,9999,0,9999,0
1667911469875,ECE 200,033,103618,Nomura; Kenji,9999,0,9999,0
1667911469875,ECE 200,034,103619,Orlitsky; Alon,9999,0,9999,0
1667911469875,ECE 200,035,103620,Pal; Piya,9999,0,9999,0
1667911469875,ECE 200,036,103621,Papen; George C.,9999,0,9999,0
1667911469875,ECE 200,037,103622,Radic; Stojan,9999,0,9999,0
1667911469875,ECE 200,038,103623,Rao; Bhaskar D.,9999,0,9999,0
1667911469875,ECE 200,039,103624,Rao; Ramesh R,9999,0,9999,0
1667911469875,ECE 200,040,103625,Rebeiz; Gabriel,9999,0,9999,0
1667911469875,ECE 200,041,103626,Sanford; John R,9999,0,9999,0
1667911469875,ECE 200,042,103627,Siegel; Paul H.,9999,0,9999,0
1667911469875,ECE 200,043,103628,Sievenpiper; Daniel F.,9999,0,9999,0
1667911469875,ECE 200,044,103629,Sworder; David D.,9999,0,9999,0
1667911469875,ECE 200,045,103630,Taur; Yuan,9999,0,9999,0
1667911469875,ECE 200,046,103631,Touri; Behrouz,9999,0,9999,0
1667911469875,ECE 200,047,103632,Trivedi; Mohan M.,9999,0,9999,0
1667911469875,ECE 200,048,103633,Vasconcelos; Nuno,9999,0,9999,0
1667911469875,ECE 200,049,103634,Wang; Xiaolong,9999,0,9999,0
1667911469875,ECE 200,050,103635,Xie; Pengtao,9999,0,9999,0
1667911469875,ECE 200,051,103636,Yip; Michael,9999,0,9999,0
1667911469875,ECE 200,052,103637,Zeger; Kenneth A.,999,0,999,0
1667911469875,ECE 200,053,103638,Zhang; Xinyu,9999,0,9999,0
1667911469875,ECE 200,054,103639,Turakhia; Yatish Girish,9999,0,9999,0
1667911469875,ECE 200,055,103640,Kang; Mingu,9999,0,9999,0
1667911469875,ECE 200,056,103641,Shi; Yuanyuan,9999,0,9999,0
1667911469875,ECE 200,057,103642,Wang; Edward Jay,9999,0,9999,0
1667911469875,ECE 200,058,103643,Zheng; Yang,9999,0,9999,0
1667911470315,ECE 202,A00,103644,Kuzum; Duygu,0,0,0,0
1667911470749,ECE 212BN,A00,103646,Ng; Tse Nga,0,0,0,0
1667911471201,ECE 221,A00,111493,Staff,0,0,0,0
1667911471633,ECE 222B,A00,103647,Lomakin; Vitaliy,0,0,0,0
1667911472067,ECE 230B,A00,103648,Taur; Yuan,0,0,0,0
1667911472501,ECE 238B,A00,103649,Garay; Javier,0,0,0,0
1667911472937,ECE 240B,A00,112900,Fainman; Yeshaiahu,0,0,0,0
1667911473371,ECE 247A,A00,103650,Jokerst; Jesse Vincent,0,0,0,0
1667911473819,ECE 247B,A00,103651,Wang; Joseph,0,0,0,0
1667911474247,ECE 250,A00,103652,Siegel; Paul H.,0,0,0,0
1667911474677,ECE 251A,A00,103654,Rao; Bhaskar D.,0,0,0,0
1667911475102,ECE 257B,A00,103655,Bharadia; Dinesh,0,0,0,0
1667911475542,ECE 258A,A00,103656,Milstein; Laurence B.,0,0,0,0
1667911475981,ECE 260B,A00,103658,Kang; Mingu,0,0,0,0
1667911476432,ECE 264A,A00,103659,Galton; Ian A,0,0,0,0
1667911476862,ECE 265A,A00,103661,Gudem; Prasad S.S.,0,0,0,0
1667911477307,ECE 265D,A00,103662,Gudem; Prasad S.S.,0,0,0,0
1667911477738,ECE 268,A00,103663,Koushanfar; Farinaz,0,0,0,0
1667911478168,ECE 269,A01,103665,Pal; Piya,0,0,0,0
1667911478599,ECE 271B,A00,103666,Vasconcelos; Manuela,0,0,0,0
1667911479028,ECE 276A,A00,103667,Atanasov; Nikolay A.,0,0,0,0
1667911479466,ECE 277,A00,103668,An; Cheolhong,0,0,0,0
1667911479906,ECE 279,A00,117947,Hall; Drew A.,0,0,0,0
1667911480765,ECE 283,A00,103670,Hsueh; Tzu-Chien,0,0,0,0
1667911481191,ECE 284,A00,103671,Turakhia; Yatish Girish,0,0,0,0
1667911481618,ECE 285,A00,103672,Zheng; Yang,0,0,0,0
1667911481618,ECE 285,B00,103673,Sworder; David D.,0,0,0,0
1667911482049,ECE 287,A00,103676,Javidi; Tara,0,0,0,0
1667911482479,MATH 200B,A00,098023,Salehi Golsefidy; Alireza,15,0,15,0
1667911482917,MATH 202B,A00,098024,Rhoades; Brendon Patrick,14,0,15,1
1667911483350,MATH 203B,A00,098025,Oprea; Dragos N.,14,0,15,1
1667911483780,MATH 204B,A00,098026,Sorensen; Claus M,15,0,15,0
1667911484204,MATH 208,A00,098027,Izadi; Elham,7,0,10,3
1667911484640,MATH 209,A00,098028,Pollack; Aaron,10,0,10,0
1667911485079,MATH 211A,A00,112919,Rogalski; Daniel,10,0,10,0
1667911485504,MATH 211B,A00,112920,Seward; Brandon M.,10,0,10,0
1667911485965,MATH 218,A00,098029,Li; Bo,10,0,10,0
1667911486397,MATH 220B,A00,098030,Novak; Jonathan I,15,0,15,0
1667911486821,MATH 221A,A00,098031,Ebenfelt; Peter F,15,0,15,0
1667911487256,MATH 231B,A00,098032,Zlatos; Andrej,15,0,15,0
1667911487699,MATH 240B,A00,098033,Ni; Lei,13,0,15,2
1667911488126,MATH 243,A00,098034,Jekel; David Andrew,10,0,10,0
1667911488578,MATH 245A,A00,098035,Nie; Jiawang,6,0,15,9
1667911489005,MATH 248,A00,098036,Bejenaru; Ioan,10,0,10,0
1667911489437,MATH 250B,A00,098037,Spolaor; Luca,14,0,15,1
1667911489872,MATH 258,A00,098038,Ni; Lei,10,0,10,0
1667911490301,MATH 264B,A00,098041,Rhoades; Brendon Patrick,13,0,15,2
1667911490731,MATH 268,A00,098042,Buss; Samuel R,10,0,10,0
1667911491161,MATH 269,A00,098043,Rhoades; Brendon Patrick,10,0,10,0
1667911491592,MATH 270B,A00,098044,Li; Bo,13,0,15,2
1667911492046,MATH 272B,A00,098045,Holst; Michael J,13,0,15,2
1667911492478,MATH 273A,A00,098046,Tian; Xiaochuan,12,0,15,3
1667911492919,MATH 275,A01,098048,Tian; Xiaochuan,7,0,10,3
1667911493348,MATH 278A,A00,098049,Holst; Michael J,8,0,10,2
1667911493782,MATH 278B,A00,098050,Cloninger; Alexander,10,0,10,0
1667911494216,MATH 278C,A00,098051,Nie; Jiawang,9,0,10,1
1667911494643,MATH 280B,A00,098052,Zheng; Tianyi,12,0,15,3
1667911495081,MATH 281B,A00,098053,Bradic; Jelena,6,0,15,9
1667911495519,MATH 282B,A00,098054,Arias-Castro; Ery,2,0,15,13
1667911495955,MATH 285,A00,098055,Fitzsimmons; Patrick J,3,0,15,12
1667911496380,MATH 287B,A00,098056,Arias-Castro; Ery,9,0,15,6
1667911496806,MATH 288,A00,098057,Agarwal; Pooja,9,0,10,1
1667911496806,MATH 288,B00,098058,Zhang; Danna,9,0,10,1
1667911496806,MATH 288,C00,098059,Williams; Ruth J,10,0,10,0
1667911497241,MATH 290B,A00,098060,Roberts; Justin Deritter,14,0,15,1
1667911497669,MATH 292,A00,098061,Belmont; Eva Kinoshita,10,0,10,0
1667911498111,MATH 295,A00,098062,Suk; Andrew Hoon,48,0,50,2
1667911498560,MATH 296,A00,098063,Novak; Jonathan I,20,0,20,0
1667911498989,MATH 297,001,098064,Gamst; Anthony Collins,9997,0,9999,2
1667912010365,COGS 205,A00,101395,Chiba; Andrea,20,0,20,0
1667912010802,COGS 210B,001,101404,Greene; Deanna Jacquelyn,9998,0,9999,1
1667912010802,COGS 210B,002,101417,Xia; Haijun,9999,0,9999,0
1667912010802,COGS 210B,003,101422,Nitz; Douglas A.,9999,0,9999,0
1667912010802,COGS 210B,004,101423,Hollan; James D.,9998,0,9999,1
1667912010802,COGS 210B,005,101424,Deak; Gedeon O.,9999,0,9999,0
1667912010802,COGS 210B,006,101425,Rossano; Federico,9999,0,9999,0
1667912011238,COGS 211B,A00,101427,Coulson; Seana M,9997,0,9999,2
1667912011668,COGS 220,A00,101428,Hollan; James D.,0,0,25,25
1667912012105,COGS 229,A00,101429,Dow; Steven P,19,0,25,6
1667912012538,COGS 230,A00,101430,Klemmer; Scott R,13,0,17,4
1667912012989,COGS 234,A00,101431,Xia; Haijun,11,0,25,14
1667912013422,COGS 260,A00,101432,Kiyonaga; Anastasia,20,0,25,5
1667912013422,COGS 260,B00,101433,Kirsh; David Joel,18,0,25,7
1667912013857,CSE 202,A00,102371,Impagliazzo; Russell,0,0,0,0
1667912014293,CSE 203B,A01,102373,Cheng; Chung Kuan,0,0,0,0
1667912014723,CSE 208,A00,102374,Micciancio; Daniele,0,0,0,0
1667912015148,CSE 209A,A00,112895,Impagliazzo; Russell,0,0,15,15
1667912015582,CSE 209B,A00,108005,Bellare; Mihir,0,0,0,0
1667912016012,CSE 210,A00,113163,Coblenz; Michael J,0,0,0,0
1667912016438,CSE 219,A00,106111,Dow; Steven P,0,0,20,20
1667912016878,CSE 221,A00,102376,Voelker; Geoffrey M.,0,0,0,0
1667912017304,CSE 224,A01,102378,Porter; George M,0,0,0,0
1667912017734,CSE 229A,A00,102379,Savage; Stefan,0,0,0,0
1667912018160,CSE 229C,A00,102380,Munyaka; Imani N. S.,0,0,0,0
1667912018599,CSE 232B,A00,102382,Deutsch; Alin Bernard,0,0,0,0
1667912019032,CSE 234,A01,112904,Kumar; Arun Kumar,0,0,0,0
1667912019462,CSE 237A,A00,102383,Rosing; Tajana Simunic,0,0,0,0
1667912019891,CSE 239A,A00,102384,Deutsch; Alin Bernard,0,0,0,0
1667912020333,CSE 239B,A00,102385,Polikarpova; Nadezhda,0,0,0,0
1667912020762,CSE 240A,A00,102386,Pannuto; Patrick William,0,0,0,0
1667912021192,CSE 240B,A00,102387,Zhao; Jishen,0,0,0,0
1667912021619,CSE 241A,A00,106406,Kang; Mingu,0,0,0,0
1667912022047,CSE 249B,A00,102388,Kahng; Andrew Byun,0,0,8,8
1667912022485,CSE 251B,A01,102392,Cottrell; Garrison W,0,0,0,0
1667912022485,CSE 251B,A02,102393,Cottrell; Garrison W,0,0,0,0
1667912022949,CSE 252B,A00,102394,Ochoa; Benjamin Lawrence,0,0,0,0
1667912023387,CSE 257,A01,102396,Gao; Sicun,0,0,0,0
1667912023819,CSE 272,A00,102397,Li; Tzumao,0,0,0,0
1667912024246,CSE 274,A00,111323,Chern; Albert Ren-Haur,0,0,0,0
1667912024673,CSE 282,A00,102398,Pevzner; Pavel Arkadjevich,0,0,0,0
1667912025100,CSE 284,A00,114175,Gymrek; Melissa Ann,0,0,0,0
1667912025538,CSE 290,A00,102399,Chandraker; Manmohan Krishna,0,0,0,0
1667912025538,CSE 290,B00,102400,Vaccaro; Kristen Marie,0,0,25,25
1667912025538,CSE 290,C00,102414,Pannuto; Patrick William,0,0,25,25
1667912025538,CSE 290,D00,102427,Pevzner; Pavel Arkadjevich,0,0,0,0
1667912025538,CSE 290,E00,102429,Zhao; Jishen,0,0,0,0
1667912025538,CSE 290,F00,102436,Tullsen; Dean Michael,0,0,0,0
1667912025538,CSE 290,G00,102440,Christensen; Henrik I,0,0,20,20
1667912025976,CSE 291,A00,102443,Su; Hao,0,0,0,0
1667912025976,CSE 291,B00,102448,Polikarpova; Nadezhda,0,0,0,0
1667912025976,CSE 291,C00,102453,Vaccaro; Kristen Marie,0,0,0,0
1667912025976,CSE 291,D00,111343,Savage; Stefan,0,0,0,0
1667912025976,CSE 291,E00,116474,Claffy; Kimberly Claire,0,0,0,0
1667912025976,CSE 291,F00,116479,Pasquale; Joseph,0,0,0,0
1667912026421,CSE 293,001,119111,Bafna; Vineet,9999,0,9999,0
1667912026421,CSE 293,002,119118,Bellare; Mihir,9999,0,9999,0
1667912026421,CSE 293,003,119122,Berg-Kirkpatrick; Taylor D,9999,0,9999,0
1667912026421,CSE 293,004,119135,Christensen; Henrik I,9999,0,9999,0
1667912026421,CSE 293,005,119142,Cottrell; Garrison W,9999,0,9999,0
1667912026421,CSE 293,006,119146,Deutsch; Alin Bernard,9999,0,9999,0
1667912026421,CSE 293,007,119159,Esmaeilzadeh; Hadi,9999,0,9999,0
1667912026421,CSE 293,008,119166,Freund; Yoav,9999,0,9999,0
1667912026421,CSE 293,009,119170,Griswold; William G.,9999,0,9999,0
1667912026421,CSE 293,010,119183,Gymrek; Melissa Ann,9999,0,9999,0
1667912026421,CSE 293,011,119190,Heninger; Nadia A,9999,0,9999,0
1667912026421,CSE 293,012,119230,Impagliazzo; Russell,9999,0,9999,0
1667912026421,CSE 293,013,119232,Jhala; Ranjit,9999,0,9999,0
1667912026421,CSE 293,014,119233,Kahng; Andrew Byun,9999,0,9999,0
1667912026421,CSE 293,015,119298,Kane; Daniel Mertz,9999,0,9999,0
1667912026421,CSE 293,016,119299,Kriegman; David J,9999,0,9999,0
1667912026421,CSE 293,017,119300,Kumar; Arun Kumar,9999,0,9999,0
1667912026421,CSE 293,018,119301,Lerner; Sorin,9999,0,9999,0
1667912026421,CSE 293,019,119302,Lovett; Shachar,9999,0,9999,0
1667912026421,CSE 293,020,119303,McAuley; Julian John,9999,0,9999,0
1667912026421,CSE 293,021,119304,Micciancio; Daniele,9999,0,9999,0
1667912026421,CSE 293,022,119367,Orailoglu; Alex,9999,0,9999,0
1667912026421,CSE 293,023,119382,Paturi; Ramamohan,9999,0,9999,0
1667912026421,CSE 293,024,119404,Polikarpova; Nadezhda,9999,0,9999,0
1667912026421,CSE 293,025,119406,Politz; Joseph Gibbs,9999,0,9999,0
1667912026421,CSE 293,026,119411,Porter; George M,9999,0,9999,0
1667912026421,CSE 293,027,119414,Porter; Leonard Emerson,9999,0,9999,0
1667912026421,CSE 293,028,119416,Ramamoorthi; Ravi,9999,0,9999,0
1667912026421,CSE 293,029,119417,Sahoo; Debashis,9999,0,9999,0
1667912026421,CSE 293,030,119420,Saul; Lawrence,9999,0,9999,0
1667912026421,CSE 293,031,119421,Savage; Stefan,9999,0,9999,0
1667912026421,CSE 293,032,119425,Schulze; Jurgen P.,9999,0,9999,0
1667912026421,CSE 293,033,119426,Snoeren; Alex C.,9999,0,9999,0
1667912026421,CSE 293,034,119428,Shang; Jingbo,9999,0,9999,0
1667912026421,CSE 293,035,119430,Stefan; Deian,9999,0,9999,0
1667912026421,CSE 293,036,119431,Su; Hao,9999,0,9999,0
1667912026421,CSE 293,037,119433,Swanson; Steven James,9999,0,9999,0
1667912026421,CSE 293,038,119435,Tullsen; Dean Michael,9999,0,9999,0
1667912026421,CSE 293,039,119483,Voelker; Geoffrey M.,9999,0,9999,0
1667912026421,CSE 293,040,119537,Zhao; Jishen,9999,0,9999,0
1667912026421,CSE 293,041,119538,Zhou; Yuan-Yuan,9999,0,9999,0
1667912026421,CSE 293,042,119539,Gao; Sicun,9999,0,9999,0
1667912026421,CSE 293,043,119540,Weibel; Nadir,9999,0,9999,0
1667912026421,CSE 293,044,119541,Gupta; Rajesh K.,9999,0,9999,0
1667912026867,CSE 294,A00,102459,Voelker; Geoffrey M.,0,0,0,0
1667912026867,CSE 294,B00,111322,Orailoglu; Alex,0,0,0,0
1667912027307,DSE 201,A00,096914,Deutsch; Alin Bernard,30,0,30,0
1667912027749,DSE 210,A00,096915,Dasgupta; Sanjoy,30,0,30,0
1667912028175,DSE 260A,A00,096916,Altintas De Callaf; Ilkay,30,0,30,0
1667912028641,ECE 200,001,103586,Antipa; Nicholas A,9999,0,9999,0
1667912028641,ECE 200,002,103587,Atanasov; Nikolay A.,9999,0,9999,0
1667912028641,ECE 200,003,103588,Bharadia; Dinesh,9999,0,9999,0
1667912028641,ECE 200,004,103589,Cheng; Chung Kuan,9999,0,9999,0
1667912028641,ECE 200,005,103590,Cosman; Pamela C.,9999,0,9999,0
1667912028641,ECE 200,006,103591,Dayeh; Shadi Ahmad,9999,0,9999,0
1667912028641,ECE 200,007,103592,Fainman; Yeshaiahu,9999,0,9999,0
1667912028641,ECE 200,008,103593,Ford; Joseph Earl,9999,0,9999,0
1667912028641,ECE 200,009,103594,Franceschetti; Massimo,9999,0,9999,0
1667912028641,ECE 200,010,103595,Fullerton; Eric E,9999,0,9999,0
1667912028641,ECE 200,011,103596,Galton; Ian A,9999,0,9999,0
1667912028641,ECE 200,012,103597,Gilja; Vikash,9999,0,9999,0
1667912028641,ECE 200,013,103598,Hall; Drew A.,9999,0,9999,0
1667912028641,ECE 200,014,103599,Hsueh; Tzu-Chien,9999,0,9999,0
1667912028641,ECE 200,015,103600,Javidi; Tara,9999,0,9999,0
1667912028641,ECE 200,016,103601,Kahng; Andrew Byun,9999,0,9999,0
1667912028641,ECE 200,017,103602,Kim; Young-Han,9999,0,9999,0
1667912028641,ECE 200,018,103603,Koushanfar; Farinaz,9999,0,9999,0
1667912028641,ECE 200,019,103604,Kuzum; Duygu,9999,0,9999,0
1667912028641,ECE 200,020,103605,Le; Hanh-Phuc,9999,0,9999,0
1667912028641,ECE 200,021,103606,Lin; Bill,9999,0,9999,0
1667912028641,ECE 200,022,103607,Liu; Zhaowei,9998,0,9999,1
1667912028641,ECE 200,023,103608,Lo; Yu-Hwa,9999,0,9999,0
1667912028641,ECE 200,024,103609,Lomakin; Vitaliy,9999,0,9999,0
1667912028641,ECE 200,025,103610,Mercier; Patrick Philip,9999,0,9999,0
1667912028641,ECE 200,026,103611,Meyer; Florian,9999,0,9999,0
1667912028641,ECE 200,027,103612,Milstein; Laurence B.,9999,0,9999,0
1667912028641,ECE 200,028,103613,Mir Arabbaygi; Siavash,9999,0,9999,0
1667912028641,ECE 200,029,103614,Mookherjea; Shayan,9999,0,9999,0
1667912028641,ECE 200,030,103615,Morris; Karcher William,9999,0,9999,0
1667912028641,ECE 200,031,103616,Ng; Tse Nga,9999,0,9999,0
1667912028641,ECE 200,032,103617,Nguyen; Truong Quang,9999,0,9999,0
1667912028641,ECE 200,033,103618,Nomura; Kenji,9999,0,9999,0
1667912028641,ECE 200,034,103619,Orlitsky; Alon,9999,0,9999,0
1667912028641,ECE 200,035,103620,Pal; Piya,9999,0,9999,0
1667912028641,ECE 200,036,103621,Papen; George C.,9999,0,9999,0
1667912028641,ECE 200,037,103622,Radic; Stojan,9999,0,9999,0
1667912028641,ECE 200,038,103623,Rao; Bhaskar D.,9999,0,9999,0
1667912028641,ECE 200,039,103624,Rao; Ramesh R,9999,0,9999,0
1667912028641,ECE 200,040,103625,Rebeiz; Gabriel,9999,0,9999,0
1667912028641,ECE 200,041,103626,Sanford; John R,9999,0,9999,0
1667912028641,ECE 200,042,103627,Siegel; Paul H.,9999,0,9999,0
1667912028641,ECE 200,043,103628,Sievenpiper; Daniel F.,9999,0,9999,0
1667912028641,ECE 200,044,103629,Sworder; David D.,9999,0,9999,0
1667912028641,ECE 200,045,103630,Taur; Yuan,9999,0,9999,0
1667912028641,ECE 200,046,103631,Touri; Behrouz,9999,0,9999,0
1667912028641,ECE 200,047,103632,Trivedi; Mohan M.,9999,0,9999,0
1667912028641,ECE 200,048,103633,Vasconcelos; Nuno,9999,0,9999,0
1667912028641,ECE 200,049,103634,Wang; Xiaolong,9999,0,9999,0
1667912028641,ECE 200,050,103635,Xie; Pengtao,9999,0,9999,0
1667912028641,ECE 200,051,103636,Yip; Michael,9999,0,9999,0
1667912028641,ECE 200,052,103637,Zeger; Kenneth A.,999,0,999,0
1667912028641,ECE 200,053,103638,Zhang; Xinyu,9999,0,9999,0
1667912028641,ECE 200,054,103639,Turakhia; Yatish Girish,9999,0,9999,0
1667912028641,ECE 200,055,103640,Kang; Mingu,9999,0,9999,0
1667912028641,ECE 200,056,103641,Shi; Yuanyuan,9999,0,9999,0
1667912028641,ECE 200,057,103642,Wang; Edward Jay,9999,0,9999,0
1667912028641,ECE 200,058,103643,Zheng; Yang,9999,0,9999,0
1667912029073,ECE 202,A00,103644,Kuzum; Duygu,0,0,0,0
1667912029506,ECE 212BN,A00,103646,Ng; Tse Nga,0,0,0,0
1667912029930,ECE 221,A00,111493,Staff,0,0,0,0
1667912030373,ECE 222B,A00,103647,Lomakin; Vitaliy,0,0,0,0
1667912030799,ECE 230B,A00,103648,Taur; Yuan,0,0,0,0
1667912031224,ECE 238B,A00,103649,Garay; Javier,0,0,0,0
1667912031654,ECE 240B,A00,112900,Fainman; Yeshaiahu,0,0,0,0
1667912032087,ECE 247A,A00,103650,Jokerst; Jesse Vincent,0,0,0,0
1667912032521,ECE 247B,A00,103651,Wang; Joseph,0,0,0,0
1667912032955,ECE 250,A00,103652,Siegel; Paul H.,0,0,0,0
1667912033381,ECE 251A,A00,103654,Rao; Bhaskar D.,0,0,0,0
1667912033815,ECE 257B,A00,103655,Bharadia; Dinesh,0,0,0,0
1667912034245,ECE 258A,A00,103656,Milstein; Laurence B.,0,0,0,0
1667912034701,ECE 260B,A00,103658,Kang; Mingu,0,0,0,0
1667912035129,ECE 264A,A00,103659,Galton; Ian A,0,0,0,0
1667912035616,ECE 265A,A00,103661,Gudem; Prasad S.S.,0,0,0,0
1667912036045,ECE 265D,A00,103662,Gudem; Prasad S.S.,0,0,0,0
1667912036494,ECE 268,A00,103663,Koushanfar; Farinaz,0,0,0,0
1667912037004,ECE 269,A01,103665,Pal; Piya,0,0,0,0
1667912037434,ECE 271B,A00,103666,Vasconcelos; Manuela,0,0,0,0
1667912037863,ECE 276A,A00,103667,Atanasov; Nikolay A.,0,0,0,0
1667912038298,ECE 277,A00,103668,An; Cheolhong,0,0,0,0
1667912038730,ECE 279,A00,117947,Hall; Drew A.,0,0,0,0
1667912039603,ECE 283,A00,103670,Hsueh; Tzu-Chien,0,0,0,0
1667912040038,ECE 284,A00,103671,Turakhia; Yatish Girish,0,0,0,0
1667912040480,ECE 285,A00,103672,Zheng; Yang,0,0,0,0
1667912040480,ECE 285,B00,103673,Sworder; David D.,0,0,0,0
1667912040914,ECE 287,A00,103676,Javidi; Tara,0,0,0,0
1667912041367,MATH 200B,A00,098023,Salehi Golsefidy; Alireza,15,0,15,0
1667912041795,MATH 202B,A00,098024,Rhoades; Brendon Patrick,14,0,15,1
1667912042225,MATH 203B,A00,098025,Oprea; Dragos N.,14,0,15,1
1667912042664,MATH 204B,A00,098026,Sorensen; Claus M,15,0,15,0
1667912043100,MATH 208,A00,098027,Izadi; Elham,7,0,10,3
1667912043530,MATH 209,A00,098028,Pollack; Aaron,10,0,10,0
1667912043963,MATH 211A,A00,112919,Rogalski; Daniel,10,0,10,0
1667912044387,MATH 211B,A00,112920,Seward; Brandon M.,10,0,10,0
1667912044818,MATH 218,A00,098029,Li; Bo,10,0,10,0
1667912045260,MATH 220B,A00,098030,Novak; Jonathan I,15,0,15,0
1667912045696,MATH 221A,A00,098031,Ebenfelt; Peter F,15,0,15,0
1667912046125,MATH 231B,A00,098032,Zlatos; Andrej,15,0,15,0
1667912046557,MATH 240B,A00,098033,Ni; Lei,13,0,15,2
1667912046989,MATH 243,A00,098034,Jekel; David Andrew,10,0,10,0
1667912047420,MATH 245A,A00,098035,Nie; Jiawang,6,0,15,9
1667912047848,MATH 248,A00,098036,Bejenaru; Ioan,10,0,10,0
1667912048276,MATH 250B,A00,098037,Spolaor; Luca,14,0,15,1
1667912048705,MATH 258,A00,098038,Ni; Lei,10,0,10,0
1667912049131,MATH 264B,A00,098041,Rhoades; Brendon Patrick,13,0,15,2
1667912049569,MATH 268,A00,098042,Buss; Samuel R,10,0,10,0
1667912050007,MATH 269,A00,098043,Rhoades; Brendon Patrick,10,0,10,0
1667912050437,MATH 270B,A00,098044,Li; Bo,13,0,15,2
1667912050870,MATH 272B,A00,098045,Holst; Michael J,13,0,15,2
1667912051305,MATH 273A,A00,098046,Tian; Xiaochuan,12,0,15,3
1667912051731,MATH 275,A01,098048,Tian; Xiaochuan,7,0,10,3
1667912052160,MATH 278A,A00,098049,Holst; Michael J,8,0,10,2
1667912052584,MATH 278B,A00,098050,Cloninger; Alexander,10,0,10,0
1667912053012,MATH 278C,A00,098051,Nie; Jiawang,9,0,10,1
1667912053444,MATH 280B,A00,098052,Zheng; Tianyi,12,0,15,3
1667912053869,MATH 281B,A00,098053,Bradic; Jelena,6,0,15,9
1667912054304,MATH 282B,A00,098054,Arias-Castro; Ery,2,0,15,13
1667912054750,MATH 285,A00,098055,Fitzsimmons; Patrick J,3,0,15,12
1667912055177,MATH 287B,A00,098056,Arias-Castro; Ery,9,0,15,6
1667912055610,MATH 288,A00,098057,Agarwal; Pooja,9,0,10,1
1667912055610,MATH 288,B00,098058,Zhang; Danna,9,0,10,1
1667912055610,MATH 288,C00,098059,Williams; Ruth J,10,0,10,0
1667912056036,MATH 290B,A00,098060,Roberts; Justin Deritter,14,0,15,1
1667912056475,MATH 292,A00,098061,Belmont; Eva Kinoshita,10,0,10,0
1667912056906,MATH 295,A00,098062,Suk; Andrew Hoon,48,0,50,2
1667912057335,MATH 296,A00,098063,Novak; Jonathan I,20,0,20,0
1667912057769,MATH 297,001,098064,Gamst; Anthony Collins,9997,0,9999,2
1667912568420,COGS 205,A00,101395,Chiba; Andrea,20,0,20,0
1667912568850,COGS 210B,001,101404,Greene; Deanna Jacquelyn,9998,0,9999,1
1667912568850,COGS 210B,002,101417,Xia; Haijun,9999,0,9999,0
1667912568850,COGS 210B,003,101422,Nitz; Douglas A.,9999,0,9999,0
1667912568850,COGS 210B,004,101423,Hollan; James D.,9998,0,9999,1
1667912568850,COGS 210B,005,101424,Deak; Gedeon O.,9999,0,9999,0
1667912568850,COGS 210B,006,101425,Rossano; Federico,9999,0,9999,0
1667912569278,COGS 211B,A00,101427,Coulson; Seana M,9997,0,9999,2
1667912569706,COGS 220,A00,101428,Hollan; James D.,0,0,25,25
1667912570134,COGS 229,A00,101429,Dow; Steven P,19,0,25,6
1667912570558,COGS 230,A00,101430,Klemmer; Scott R,13,0,17,4
1667912570993,COGS 234,A00,101431,Xia; Haijun,11,0,25,14
1667912571426,COGS 260,A00,101432,Kiyonaga; Anastasia,20,0,25,5
1667912571426,COGS 260,B00,101433,Kirsh; David Joel,18,0,25,7
1667912571858,CSE 202,A00,102371,Impagliazzo; Russell,0,0,0,0
1667912572312,CSE 203B,A01,102373,Cheng; Chung Kuan,0,0,0,0
1667912572764,CSE 208,A00,102374,Micciancio; Daniele,0,0,0,0
1667912573197,CSE 209A,A00,112895,Impagliazzo; Russell,0,0,15,15
1667912573642,CSE 209B,A00,108005,Bellare; Mihir,0,0,0,0
1667912574082,CSE 210,A00,113163,Coblenz; Michael J,0,0,0,0
1667912574517,CSE 219,A00,106111,Dow; Steven P,0,0,20,20
1667912574941,CSE 221,A00,102376,Voelker; Geoffrey M.,0,0,0,0
1667912575365,CSE 224,A01,102378,Porter; George M,0,0,0,0
1667912575815,CSE 229A,A00,102379,Savage; Stefan,0,0,0,0
1667912576247,CSE 229C,A00,102380,Munyaka; Imani N. S.,0,0,0,0
1667912576688,CSE 232B,A00,102382,Deutsch; Alin Bernard,0,0,0,0
1667912577121,CSE 234,A01,112904,Kumar; Arun Kumar,0,0,0,0
1667912577559,CSE 237A,A00,102383,Rosing; Tajana Simunic,0,0,0,0
1667912577990,CSE 239A,A00,102384,Deutsch; Alin Bernard,0,0,0,0
1667912578427,CSE 239B,A00,102385,Polikarpova; Nadezhda,0,0,0,0
1667912578872,CSE 240A,A00,102386,Pannuto; Patrick William,0,0,0,0
1667912579312,CSE 240B,A00,102387,Zhao; Jishen,0,0,0,0
1667912579746,CSE 241A,A00,106406,Kang; Mingu,0,0,0,0
1667912580200,CSE 249B,A00,102388,Kahng; Andrew Byun,0,0,8,8
1667912580641,CSE 251B,A01,102392,Cottrell; Garrison W,0,0,0,0
1667912580641,CSE 251B,A02,102393,Cottrell; Garrison W,0,0,0,0
1667912581072,CSE 252B,A00,102394,Ochoa; Benjamin Lawrence,0,0,0,0
1667912581513,CSE 257,A01,102396,Gao; Sicun,0,0,0,0
1667912581952,CSE 272,A00,102397,Li; Tzumao,0,0,0,0
1667912582391,CSE 274,A00,111323,Chern; Albert Ren-Haur,0,0,0,0
1667912582829,CSE 282,A00,102398,Pevzner; Pavel Arkadjevich,0,0,0,0
1667912583272,CSE 284,A00,114175,Gymrek; Melissa Ann,0,0,0,0
1667912583697,CSE 290,A00,102399,Chandraker; Manmohan Krishna,0,0,0,0
1667912583697,CSE 290,B00,102400,Vaccaro; Kristen Marie,0,0,25,25
1667912583697,CSE 290,C00,102414,Pannuto; Patrick William,0,0,25,25
1667912583697,CSE 290,D00,102427,Pevzner; Pavel Arkadjevich,0,0,0,0
1667912583697,CSE 290,E00,102429,Zhao; Jishen,0,0,0,0
1667912583697,CSE 290,F00,102436,Tullsen; Dean Michael,0,0,0,0
1667912583697,CSE 290,G00,102440,Christensen; Henrik I,0,0,20,20
1667912584142,CSE 291,A00,102443,Su; Hao,0,0,0,0
1667912584142,CSE 291,B00,102448,Polikarpova; Nadezhda,0,0,0,0
1667912584142,CSE 291,C00,102453,Vaccaro; Kristen Marie,0,0,0,0
1667912584142,CSE 291,D00,111343,Savage; Stefan,0,0,0,0
1667912584142,CSE 291,E00,116474,Claffy; Kimberly Claire,0,0,0,0
1667912584142,CSE 291,F00,116479,Pasquale; Joseph,0,0,0,0
1667912584584,CSE 293,001,119111,Bafna; Vineet,9999,0,9999,0
1667912584584,CSE 293,002,119118,Bellare; Mihir,9999,0,9999,0
1667912584584,CSE 293,003,119122,Berg-Kirkpatrick; Taylor D,9999,0,9999,0
1667912584584,CSE 293,004,119135,Christensen; Henrik I,9999,0,9999,0
1667912584584,CSE 293,005,119142,Cottrell; Garrison W,9999,0,9999,0
1667912584584,CSE 293,006,119146,Deutsch; Alin Bernard,9999,0,9999,0
1667912584584,CSE 293,007,119159,Esmaeilzadeh; Hadi,9999,0,9999,0
1667912584584,CSE 293,008,119166,Freund; Yoav,9999,0,9999,0
1667912584584,CSE 293,009,119170,Griswold; William G.,9999,0,9999,0
1667912584584,CSE 293,010,119183,Gymrek; Melissa Ann,9999,0,9999,0
1667912584584,CSE 293,011,119190,Heninger; Nadia A,9999,0,9999,0
1667912584584,CSE 293,012,119230,Impagliazzo; Russell,9999,0,9999,0
1667912584584,CSE 293,013,119232,Jhala; Ranjit,9999,0,9999,0
1667912584584,CSE 293,014,119233,Kahng; Andrew Byun,9999,0,9999,0
1667912584584,CSE 293,015,119298,Kane; Daniel Mertz,9999,0,9999,0
1667912584584,CSE 293,016,119299,Kriegman; David J,9999,0,9999,0
1667912584584,CSE 293,017,119300,Kumar; Arun Kumar,9999,0,9999,0
1667912584584,CSE 293,018,119301,Lerner; Sorin,9999,0,9999,0
1667912584584,CSE 293,019,119302,Lovett; Shachar,9999,0,9999,0
1667912584584,CSE 293,020,119303,McAuley; Julian John,9999,0,9999,0
1667912584584,CSE 293,021,119304,Micciancio; Daniele,9999,0,9999,0
1667912584584,CSE 293,022,119367,Orailoglu; Alex,9999,0,9999,0
1667912584584,CSE 293,023,119382,Paturi; Ramamohan,9999,0,9999,0
1667912584584,CSE 293,024,119404,Polikarpova; Nadezhda,9999,0,9999,0
1667912584584,CSE 293,025,119406,Politz; Joseph Gibbs,9999,0,9999,0
1667912584584,CSE 293,026,119411,Porter; George M,9999,0,9999,0
1667912584584,CSE 293,027,119414,Porter; Leonard Emerson,9999,0,9999,0
1667912584584,CSE 293,028,119416,Ramamoorthi; Ravi,9999,0,9999,0
1667912584584,CSE 293,029,119417,Sahoo; Debashis,9999,0,9999,0
1667912584584,CSE 293,030,119420,Saul; Lawrence,9999,0,9999,0
1667912584584,CSE 293,031,119421,Savage; Stefan,9999,0,9999,0
1667912584584,CSE 293,032,119425,Schulze; Jurgen P.,9999,0,9999,0
1667912584584,CSE 293,033,119426,Snoeren; Alex C.,9999,0,9999,0
1667912584584,CSE 293,034,119428,Shang; Jingbo,9999,0,9999,0
1667912584584,CSE 293,035,119430,Stefan; Deian,9999,0,9999,0
1667912584584,CSE 293,036,119431,Su; Hao,9999,0,9999,0
1667912584584,CSE 293,037,119433,Swanson; Steven James,9999,0,9999,0
1667912584584,CSE 293,038,119435,Tullsen; Dean Michael,9999,0,9999,0
1667912584584,CSE 293,039,119483,Voelker; Geoffrey M.,9999,0,9999,0
1667912584584,CSE 293,040,119537,Zhao; Jishen,9999,0,9999,0
1667912584584,CSE 293,041,119538,Zhou; Yuan-Yuan,9999,0,9999,0
1667912584584,CSE 293,042,119539,Gao; Sicun,9999,0,9999,0
1667912584584,CSE 293,043,119540,Weibel; Nadir,9999,0,9999,0
1667912584584,CSE 293,044,119541,Gupta; Rajesh K.,9999,0,9999,0
1667912585011,CSE 294,A00,102459,Voelker; Geoffrey M.,0,0,0,0
1667912585011,CSE 294,B00,111322,Orailoglu; Alex,0,0,0,0
1667912585444,DSE 201,A00,096914,Deutsch; Alin Bernard,30,0,30,0
1667912585869,DSE 210,A00,096915,Dasgupta; Sanjoy,30,0,30,0
1667912586296,DSE 260A,A00,096916,Altintas De Callaf; Ilkay,30,0,30,0
1667912586749,ECE 200,001,103586,Antipa; Nicholas A,9999,0,9999,0
1667912586749,ECE 200,002,103587,Atanasov; Nikolay A.,9999,0,9999,0
1667912586749,ECE 200,003,103588,Bharadia; Dinesh,9999,0,9999,0
1667912586749,ECE 200,004,103589,Cheng; Chung Kuan,9999,0,9999,0
1667912586749,ECE 200,005,103590,Cosman; Pamela C.,9999,0,9999,0
1667912586749,ECE 200,006,103591,Dayeh; Shadi Ahmad,9999,0,9999,0
1667912586749,ECE 200,007,103592,Fainman; Yeshaiahu,9999,0,9999,0
1667912586749,ECE 200,008,103593,Ford; Joseph Earl,9999,0,9999,0
1667912586749,ECE 200,009,103594,Franceschetti; Massimo,9999,0,9999,0
1667912586749,ECE 200,010,103595,Fullerton; Eric E,9999,0,9999,0
1667912586749,ECE 200,011,103596,Galton; Ian A,9999,0,9999,0
1667912586749,ECE 200,012,103597,Gilja; Vikash,9999,0,9999,0
1667912586749,ECE 200,013,103598,Hall; Drew A.,9999,0,9999,0
1667912586749,ECE 200,014,103599,Hsueh; Tzu-Chien,9999,0,9999,0
1667912586749,ECE 200,015,103600,Javidi; Tara,9999,0,9999,0
1667912586749,ECE 200,016,103601,Kahng; Andrew Byun,9999,0,9999,0
1667912586749,ECE 200,017,103602,Kim; Young-Han,9999,0,9999,0
1667912586749,ECE 200,018,103603,Koushanfar; Farinaz,9999,0,9999,0
1667912586749,ECE 200,019,103604,Kuzum; Duygu,9999,0,9999,0
1667912586749,ECE 200,020,103605,Le; Hanh-Phuc,9999,0,9999,0
1667912586749,ECE 200,021,103606,Lin; Bill,9999,0,9999,0
1667912586749,ECE 200,022,103607,Liu; Zhaowei,9998,0,9999,1
1667912586749,ECE 200,023,103608,Lo; Yu-Hwa,9999,0,9999,0
1667912586749,ECE 200,024,103609,Lomakin; Vitaliy,9999,0,9999,0
1667912586749,ECE 200,025,103610,Mercier; Patrick Philip,9999,0,9999,0
1667912586749,ECE 200,026,103611,Meyer; Florian,9999,0,9999,0
1667912586749,ECE 200,027,103612,Milstein; Laurence B.,9999,0,9999,0
1667912586749,ECE 200,028,103613,Mir Arabbaygi; Siavash,9999,0,9999,0
1667912586749,ECE 200,029,103614,Mookherjea; Shayan,9999,0,9999,0
1667912586749,ECE 200,030,103615,Morris; Karcher William,9999,0,9999,0
1667912586749,ECE 200,031,103616,Ng; Tse Nga,9999,0,9999,0
1667912586749,ECE 200,032,103617,Nguyen; Truong Quang,9999,0,9999,0
1667912586749,ECE 200,033,103618,Nomura; Kenji,9999,0,9999,0
1667912586749,ECE 200,034,103619,Orlitsky; Alon,9999,0,9999,0
1667912586749,ECE 200,035,103620,Pal; Piya,9999,0,9999,0
1667912586749,ECE 200,036,103621,Papen; George C.,9999,0,9999,0
1667912586749,ECE 200,037,103622,Radic; Stojan,9999,0,9999,0
1667912586749,ECE 200,038,103623,Rao; Bhaskar D.,9999,0,9999,0
1667912586749,ECE 200,039,103624,Rao; Ramesh R,9999,0,9999,0
1667912586749,ECE 200,040,103625,Rebeiz; Gabriel,9999,0,9999,0
1667912586749,ECE 200,041,103626,Sanford; John R,9999,0,9999,0
1667912586749,ECE 200,042,103627,Siegel; Paul H.,9999,0,9999,0
1667912586749,ECE 200,043,103628,Sievenpiper; Daniel F.,9999,0,9999,0
1667912586749,ECE 200,044,103629,Sworder; David D.,9999,0,9999,0
1667912586749,ECE 200,045,103630,Taur; Yuan,9999,0,9999,0
1667912586749,ECE 200,046,103631,Touri; Behrouz,9999,0,9999,0
1667912586749,ECE 200,047,103632,Trivedi; Mohan M.,9999,0,9999,0
1667912586749,ECE 200,048,103633,Vasconcelos; Nuno,9999,0,9999,0
1667912586749,ECE 200,049,103634,Wang; Xiaolong,9999,0,9999,0
1667912586749,ECE 200,050,103635,Xie; Pengtao,9999,0,9999,0
1667912586749,ECE 200,051,103636,Yip; Michael,9999,0,9999,0
1667912586749,ECE 200,052,103637,Zeger; Kenneth A.,999,0,999,0
1667912586749,ECE 200,053,103638,Zhang; Xinyu,9999,0,9999,0
1667912586749,ECE 200,054,103639,Turakhia; Yatish Girish,9999,0,9999,0
1667912586749,ECE 200,055,103640,Kang; Mingu,9999,0,9999,0
1667912586749,ECE 200,056,103641,Shi; Yuanyuan,9999,0,9999,0
1667912586749,ECE 200,057,103642,Wang; Edward Jay,9999,0,9999,0
1667912586749,ECE 200,058,103643,Zheng; Yang,9999,0,9999,0
1667912587183,ECE 202,A00,103644,Kuzum; Duygu,0,0,0,0
1667912587607,ECE 212BN,A00,103646,Ng; Tse Nga,0,0,0,0
1667912588034,ECE 221,A00,111493,Staff,0,0,0,0
1667912588574,ECE 222B,A00,103647,Lomakin; Vitaliy,0,0,0,0
1667912589003,ECE 230B,A00,103648,Taur; Yuan,0,0,0,0
1667912589426,ECE 238B,A00,103649,Garay; Javier,0,0,0,0
1667912589852,ECE 240B,A00,112900,Fainman; Yeshaiahu,0,0,0,0
1667912590287,ECE 247A,A00,103650,Jokerst; Jesse Vincent,0,0,0,0
1667912590712,ECE 247B,A00,103651,Wang; Joseph,0,0,0,0
1667912591153,ECE 250,A00,103652,Siegel; Paul H.,0,0,0,0
1667912591596,ECE 251A,A00,103654,Rao; Bhaskar D.,0,0,0,0
1667912592036,ECE 257B,A00,103655,Bharadia; Dinesh,0,0,0,0
1667912592465,ECE 258A,A00,103656,Milstein; Laurence B.,0,0,0,0
1667912592892,ECE 260B,A00,103658,Kang; Mingu,0,0,0,0
1667912593333,ECE 264A,A00,103659,Galton; Ian A,0,0,0,0
1667912593775,ECE 265A,A00,103661,Gudem; Prasad S.S.,0,0,0,0
1667912594199,ECE 265D,A00,103662,Gudem; Prasad S.S.,0,0,0,0
1667912594641,ECE 268,A00,103663,Koushanfar; Farinaz,0,0,0,0
1667912595073,ECE 269,A01,103665,Pal; Piya,0,0,0,0
1667912595503,ECE 271B,A00,103666,Vasconcelos; Manuela,0,0,0,0
1667912595930,ECE 276A,A00,103667,Atanasov; Nikolay A.,0,0,0,0
1667912596354,ECE 277,A00,103668,An; Cheolhong,0,0,0,0
1667912596777,ECE 279,A00,117947,Hall; Drew A.,0,0,0,0
1667912597635,ECE 283,A00,103670,Hsueh; Tzu-Chien,0,0,0,0
1667912598064,ECE 284,A00,103671,Turakhia; Yatish Girish,0,0,0,0
1667912598488,ECE 285,A00,103672,Zheng; Yang,0,0,0,0
1667912598488,ECE 285,B00,103673,Sworder; David D.,0,0,0,0
1667912598914,ECE 287,A00,103676,Javidi; Tara,0,0,0,0
1667912599350,MATH 200B,A00,098023,Salehi Golsefidy; Alireza,15,0,15,0
1667912599782,MATH 202B,A00,098024,Rhoades; Brendon Patrick,14,0,15,1
1667912600211,MATH 203B,A00,098025,Oprea; Dragos N.,14,0,15,1
1667912600640,MATH 204B,A00,098026,Sorensen; Claus M,15,0,15,0
1667912601066,MATH 208,A00,098027,Izadi; Elham,7,0,10,3
1667912601500,MATH 209,A00,098028,Pollack; Aaron,10,0,10,0
1667912601929,MATH 211A,A00,112919,Rogalski; Daniel,10,0,10,0
1667912602379,MATH 211B,A00,112920,Seward; Brandon M.,10,0,10,0
1667912602803,MATH 218,A00,098029,Li; Bo,10,0,10,0
1667912603227,MATH 220B,A00,098030,Novak; Jonathan I,15,0,15,0
1667912603656,MATH 221A,A00,098031,Ebenfelt; Peter F,15,0,15,0
1667912604080,MATH 231B,A00,098032,Zlatos; Andrej,15,0,15,0
1667912604512,MATH 240B,A00,098033,Ni; Lei,13,0,15,2
1667912604944,MATH 243,A00,098034,Jekel; David Andrew,10,0,10,0
1667912605373,MATH 245A,A00,098035,Nie; Jiawang,6,0,15,9
1667912605831,MATH 248,A00,098036,Bejenaru; Ioan,10,0,10,0
1667912606256,MATH 250B,A00,098037,Spolaor; Luca,14,0,15,1
1667912606688,MATH 258,A00,098038,Ni; Lei,10,0,10,0
1667912607124,MATH 264B,A00,098041,Rhoades; Brendon Patrick,13,0,15,2
1667912607558,MATH 268,A00,098042,Buss; Samuel R,10,0,10,0
1667912607985,MATH 269,A00,098043,Rhoades; Brendon Patrick,10,0,10,0
1667912608418,MATH 270B,A00,098044,Li; Bo,13,0,15,2
1667912608851,MATH 272B,A00,098045,Holst; Michael J,13,0,15,2
1667912609283,MATH 273A,A00,098046,Tian; Xiaochuan,12,0,15,3
1667912609718,MATH 275,A01,098048,Tian; Xiaochuan,7,0,10,3
1667912610153,MATH 278A,A00,098049,Holst; Michael J,8,0,10,2
1667912610589,MATH 278B,A00,098050,Cloninger; Alexander,10,0,10,0
1667912611016,MATH 278C,A00,098051,Nie; Jiawang,9,0,10,1
1667912611466,MATH 280B,A00,098052,Zheng; Tianyi,12,0,15,3
1667912612012,MATH 281B,A00,098053,Bradic; Jelena,6,0,15,9
1667912612447,MATH 282B,A00,098054,Arias-Castro; Ery,2,0,15,13
1667912612877,MATH 285,A00,098055,Fitzsimmons; Patrick J,3,0,15,12
1667912613312,MATH 287B,A00,098056,Arias-Castro; Ery,9,0,15,6
1667912613736,MATH 288,A00,098057,Agarwal; Pooja,9,0,10,1
1667912613736,MATH 288,B00,098058,Zhang; Danna,9,0,10,1
1667912613736,MATH 288,C00,098059,Williams; Ruth J,10,0,10,0
1667912614172,MATH 290B,A00,098060,Roberts; Justin Deritter,14,0,15,1
1667912614607,MATH 292,A00,098061,Belmont; Eva Kinoshita,10,0,10,0
1667912615032,MATH 295,A00,098062,Suk; Andrew Hoon,48,0,50,2
1667912615457,MATH 296,A00,098063,Novak; Jonathan I,20,0,20,0
1667912615887,MATH 297,001,098064,Gamst; Anthony Collins,9997,0,9999,2
1667913123595,COGS 205,A00,101395,Chiba; Andrea,20,0,20,0
1667913124034,COGS 210B,001,101404,Greene; Deanna Jacquelyn,9998,0,9999,1
1667913124034,COGS 210B,002,101417,Xia; Haijun,9999,0,9999,0
1667913124034,COGS 210B,003,101422,Nitz; Douglas A.,9999,0,9999,0
1667913124034,COGS 210B,004,101423,Hollan; James D.,9998,0,9999,1
1667913124034,COGS 210B,005,101424,Deak; Gedeon O.,9999,0,9999,0
1667913124034,COGS 210B,006,101425,Rossano; Federico,9999,0,9999,0
1667913124480,COGS 211B,A00,101427,Coulson; Seana M,9997,0,9999,2
1667913124912,COGS 220,A00,101428,Hollan; James D.,0,0,25,25
1667913125357,COGS 229,A00,101429,Dow; Steven P,19,0,25,6
1667913125794,COGS 230,A00,101430,Klemmer; Scott R,13,0,17,4
1667913126224,COGS 234,A00,101431,Xia; Haijun,11,0,25,14
1667913126649,COGS 260,A00,101432,Kiyonaga; Anastasia,20,0,25,5
1667913126649,COGS 260,B00,101433,Kirsh; David Joel,18,0,25,7
1667913127080,CSE 202,A00,102371,Impagliazzo; Russell,0,0,0,0
1667913127507,CSE 203B,A01,102373,Cheng; Chung Kuan,0,0,0,0
1667913127942,CSE 208,A00,102374,Micciancio; Daniele,0,0,0,0
1667913128370,CSE 209A,A00,112895,Impagliazzo; Russell,0,0,15,15
1667913128799,CSE 209B,A00,108005,Bellare; Mihir,0,0,0,0
1667913129224,CSE 210,A00,113163,Coblenz; Michael J,0,0,0,0
1667913129659,CSE 219,A00,106111,Dow; Steven P,0,0,20,20
1667913130110,CSE 221,A00,102376,Voelker; Geoffrey M.,0,0,0,0
1667913130571,CSE 224,A01,102378,Porter; George M,0,0,0,0
1667913131007,CSE 229A,A00,102379,Savage; Stefan,0,0,0,0
1667913131433,CSE 229C,A00,102380,Munyaka; Imani N. S.,0,0,0,0
1667913131868,CSE 232B,A00,102382,Deutsch; Alin Bernard,0,0,0,0
1667913132299,CSE 234,A01,112904,Kumar; Arun Kumar,0,0,0,0
1667913132721,CSE 237A,A00,102383,Rosing; Tajana Simunic,0,0,0,0
1667913133157,CSE 239A,A00,102384,Deutsch; Alin Bernard,0,0,0,0
1667913133589,CSE 239B,A00,102385,Polikarpova; Nadezhda,0,0,0,0
1667913134016,CSE 240A,A00,102386,Pannuto; Patrick William,0,0,0,0
1667913134465,CSE 240B,A00,102387,Zhao; Jishen,0,0,0,0
1667913134903,CSE 241A,A00,106406,Kang; Mingu,0,0,0,0
1667913135348,CSE 249B,A00,102388,Kahng; Andrew Byun,0,0,8,8
1667913135780,CSE 251B,A01,102392,Cottrell; Garrison W,0,0,0,0
1667913135780,CSE 251B,A02,102393,Cottrell; Garrison W,0,0,0,0
1667913136211,CSE 252B,A00,102394,Ochoa; Benjamin Lawrence,0,0,0,0
1667913136655,CSE 257,A01,102396,Gao; Sicun,0,0,0,0
1667913137088,CSE 272,A00,102397,Li; Tzumao,0,0,0,0
1667913137549,CSE 274,A00,111323,Chern; Albert Ren-Haur,0,0,0,0
1667913137983,CSE 282,A00,102398,Pevzner; Pavel Arkadjevich,0,0,0,0
1667913138410,CSE 284,A00,114175,Gymrek; Melissa Ann,0,0,0,0
1667913138842,CSE 290,A00,102399,Chandraker; Manmohan Krishna,0,0,0,0
1667913138842,CSE 290,B00,102400,Vaccaro; Kristen Marie,0,0,25,25
1667913138842,CSE 290,C00,102414,Pannuto; Patrick William,0,0,25,25
1667913138842,CSE 290,D00,102427,Pevzner; Pavel Arkadjevich,0,0,0,0
1667913138842,CSE 290,E00,102429,Zhao; Jishen,0,0,0,0
1667913138842,CSE 290,F00,102436,Tullsen; Dean Michael,0,0,0,0
1667913138842,CSE 290,G00,102440,Christensen; Henrik I,0,0,20,20
1667913139274,CSE 291,A00,102443,Su; Hao,0,0,0,0
1667913139274,CSE 291,B00,102448,Polikarpova; Nadezhda,0,0,0,0
1667913139274,CSE 291,C00,102453,Vaccaro; Kristen Marie,0,0,0,0
1667913139274,CSE 291,D00,111343,Savage; Stefan,0,0,0,0
1667913139274,CSE 291,E00,116474,Claffy; Kimberly Claire,0,0,0,0
1667913139274,CSE 291,F00,116479,Pasquale; Joseph,0,0,0,0
1667913139708,CSE 293,001,119111,Bafna; Vineet,9999,0,9999,0
1667913139708,CSE 293,002,119118,Bellare; Mihir,9999,0,9999,0
1667913139708,CSE 293,003,119122,Berg-Kirkpatrick; Taylor D,9999,0,9999,0
1667913139708,CSE 293,004,119135,Christensen; Henrik I,9999,0,9999,0
1667913139708,CSE 293,005,119142,Cottrell; Garrison W,9999,0,9999,0
1667913139708,CSE 293,006,119146,Deutsch; Alin Bernard,9999,0,9999,0
1667913139708,CSE 293,007,119159,Esmaeilzadeh; Hadi,9999,0,9999,0
1667913139708,CSE 293,008,119166,Freund; Yoav,9999,0,9999,0
1667913139708,CSE 293,009,119170,Griswold; William G.,9999,0,9999,0
1667913139708,CSE 293,010,119183,Gymrek; Melissa Ann,9999,0,9999,0
1667913139708,CSE 293,011,119190,Heninger; Nadia A,9999,0,9999,0
1667913139708,CSE 293,012,119230,Impagliazzo; Russell,9999,0,9999,0
1667913139708,CSE 293,013,119232,Jhala; Ranjit,9999,0,9999,0
1667913139708,CSE 293,014,119233,Kahng; Andrew Byun,9999,0,9999,0
1667913139708,CSE 293,015,119298,Kane; Daniel Mertz,9999,0,9999,0
1667913139708,CSE 293,016,119299,Kriegman; David J,9999,0,9999,0
1667913139708,CSE 293,017,119300,Kumar; Arun Kumar,9999,0,9999,0
1667913139708,CSE 293,018,119301,Lerner; Sorin,9999,0,9999,0
1667913139708,CSE 293,019,119302,Lovett; Shachar,9999,0,9999,0
1667913139708,CSE 293,020,119303,McAuley; Julian John,9999,0,9999,0
1667913139708,CSE 293,021,119304,Micciancio; Daniele,9999,0,9999,0
1667913139708,CSE 293,022,119367,Orailoglu; Alex,9999,0,9999,0
1667913139708,CSE 293,023,119382,Paturi; Ramamohan,9999,0,9999,0
1667913139708,CSE 293,024,119404,Polikarpova; Nadezhda,9999,0,9999,0
1667913139708,CSE 293,025,119406,Politz; Joseph Gibbs,9999,0,9999,0
1667913139708,CSE 293,026,119411,Porter; George M,9999,0,9999,0
1667913139708,CSE 293,027,119414,Porter; Leonard Emerson,9999,0,9999,0
1667913139708,CSE 293,028,119416,Ramamoorthi; Ravi,9999,0,9999,0
1667913139708,CSE 293,029,119417,Sahoo; Debashis,9999,0,9999,0
1667913139708,CSE 293,030,119420,Saul; Lawrence,9999,0,9999,0
1667913139708,CSE 293,031,119421,Savage; Stefan,9999,0,9999,0
1667913139708,CSE 293,032,119425,Schulze; Jurgen P.,9999,0,9999,0
1667913139708,CSE 293,033,119426,Snoeren; Alex C.,9999,0,9999,0
1667913139708,CSE 293,034,119428,Shang; Jingbo,9999,0,9999,0
1667913139708,CSE 293,035,119430,Stefan; Deian,9999,0,9999,0
1667913139708,CSE 293,036,119431,Su; Hao,9999,0,9999,0
1667913139708,CSE 293,037,119433,Swanson; Steven James,9999,0,9999,0
1667913139708,CSE 293,038,119435,Tullsen; Dean Michael,9999,0,9999,0
1667913139708,CSE 293,039,119483,Voelker; Geoffrey M.,9999,0,9999,0
1667913139708,CSE 293,040,119537,Zhao; Jishen,9999,0,9999,0
1667913139708,CSE 293,041,119538,Zhou; Yuan-Yuan,9999,0,9999,0
1667913139708,CSE 293,042,119539,Gao; Sicun,9999,0,9999,0
1667913139708,CSE 293,043,119540,Weibel; Nadir,9999,0,9999,0
1667913139708,CSE 293,044,119541,Gupta; Rajesh K.,9999,0,9999,0
1667913140228,CSE 294,A00,102459,Voelker; Geoffrey M.,0,0,0,0
1667913140228,CSE 294,B00,111322,Orailoglu; Alex,0,0,0,0
1667913140683,DSE 201,A00,096914,Deutsch; Alin Bernard,30,0,30,0
1667913141113,DSE 210,A00,096915,Dasgupta; Sanjoy,30,0,30,0
1667913141581,DSE 260A,A00,096916,Altintas De Callaf; Ilkay,30,0,30,0
1667913142041,ECE 200,001,103586,Antipa; Nicholas A,9999,0,9999,0
1667913142041,ECE 200,002,103587,Atanasov; Nikolay A.,9999,0,9999,0
1667913142041,ECE 200,003,103588,Bharadia; Dinesh,9999,0,9999,0
1667913142041,ECE 200,004,103589,Cheng; Chung Kuan,9999,0,9999,0
1667913142041,ECE 200,005,103590,Cosman; Pamela C.,9999,0,9999,0
1667913142041,ECE 200,006,103591,Dayeh; Shadi Ahmad,9999,0,9999,0
1667913142041,ECE 200,007,103592,Fainman; Yeshaiahu,9999,0,9999,0
1667913142041,ECE 200,008,103593,Ford; Joseph Earl,9999,0,9999,0
1667913142041,ECE 200,009,103594,Franceschetti; Massimo,9999,0,9999,0
1667913142041,ECE 200,010,103595,Fullerton; Eric E,9999,0,9999,0
1667913142041,ECE 200,011,103596,Galton; Ian A,9999,0,9999,0
1667913142041,ECE 200,012,103597,Gilja; Vikash,9999,0,9999,0
1667913142041,ECE 200,013,103598,Hall; Drew A.,9999,0,9999,0
1667913142041,ECE 200,014,103599,Hsueh; Tzu-Chien,9999,0,9999,0
1667913142041,ECE 200,015,103600,Javidi; Tara,9999,0,9999,0
1667913142041,ECE 200,016,103601,Kahng; Andrew Byun,9999,0,9999,0
1667913142041,ECE 200,017,103602,Kim; Young-Han,9999,0,9999,0
1667913142041,ECE 200,018,103603,Koushanfar; Farinaz,9999,0,9999,0
1667913142041,ECE 200,019,103604,Kuzum; Duygu,9999,0,9999,0
1667913142041,ECE 200,020,103605,Le; Hanh-Phuc,9999,0,9999,0
1667913142041,ECE 200,021,103606,Lin; Bill,9999,0,9999,0
1667913142041,ECE 200,022,103607,Liu; Zhaowei,9998,0,9999,1
1667913142041,ECE 200,023,103608,Lo; Yu-Hwa,9999,0,9999,0
1667913142041,ECE 200,024,103609,Lomakin; Vitaliy,9999,0,9999,0
1667913142041,ECE 200,025,103610,Mercier; Patrick Philip,9999,0,9999,0
1667913142041,ECE 200,026,103611,Meyer; Florian,9999,0,9999,0
1667913142041,ECE 200,027,103612,Milstein; Laurence B.,9999,0,9999,0
1667913142041,ECE 200,028,103613,Mir Arabbaygi; Siavash,9999,0,9999,0
1667913142041,ECE 200,029,103614,Mookherjea; Shayan,9999,0,9999,0
1667913142041,ECE 200,030,103615,Morris; Karcher William,9999,0,9999,0
1667913142041,ECE 200,031,103616,Ng; Tse Nga,9999,0,9999,0
1667913142041,ECE 200,032,103617,Nguyen; Truong Quang,9999,0,9999,0
1667913142041,ECE 200,033,103618,Nomura; Kenji,9999,0,9999,0
1667913142041,ECE 200,034,103619,Orlitsky; Alon,9999,0,9999,0
1667913142041,ECE 200,035,103620,Pal; Piya,9999,0,9999,0
1667913142041,ECE 200,036,103621,Papen; George C.,9999,0,9999,0
1667913142041,ECE 200,037,103622,Radic; Stojan,9999,0,9999,0
1667913142041,ECE 200,038,103623,Rao; Bhaskar D.,9999,0,9999,0
1667913142041,ECE 200,039,103624,Rao; Ramesh R,9999,0,9999,0
1667913142041,ECE 200,040,103625,Rebeiz; Gabriel,9999,0,9999,0
1667913142041,ECE 200,041,103626,Sanford; John R,9999,0,9999,0
1667913142041,ECE 200,042,103627,Siegel; Paul H.,9999,0,9999,0
1667913142041,ECE 200,043,103628,Sievenpiper; Daniel F.,9999,0,9999,0
1667913142041,ECE 200,044,103629,Sworder; David D.,9999,0,9999,0
1667913142041,ECE 200,045,103630,Taur; Yuan,9999,0,9999,0
1667913142041,ECE 200,046,103631,Touri; Behrouz,9999,0,9999,0
1667913142041,ECE 200,047,103632,Trivedi; Mohan M.,9999,0,9999,0
1667913142041,ECE 200,048,103633,Vasconcelos; Nuno,9999,0,9999,0
1667913142041,ECE 200,049,103634,Wang; Xiaolong,9999,0,9999,0
1667913142041,ECE 200,050,103635,Xie; Pengtao,9999,0,9999,0
1667913142041,ECE 200,051,103636,Yip; Michael,9999,0,9999,0
1667913142041,ECE 200,052,103637,Zeger; Kenneth A.,999,0,999,0
1667913142041,ECE 200,053,103638,Zhang; Xinyu,9999,0,9999,0
1667913142041,ECE 200,054,103639,Turakhia; Yatish Girish,9999,0,9999,0
1667913142041,ECE 200,055,103640,Kang; Mingu,9999,0,9999,0
1667913142041,ECE 200,056,103641,Shi; Yuanyuan,9999,0,9999,0
1667913142041,ECE 200,057,103642,Wang; Edward Jay,9999,0,9999,0
1667913142041,ECE 200,058,103643,Zheng; Yang,9999,0,9999,0
1667913142470,ECE 202,A00,103644,Kuzum; Duygu,0,0,0,0
1667913142895,ECE 212BN,A00,103646,Ng; Tse Nga,0,0,0,0
1667913143337,ECE 221,A00,111493,Staff,0,0,0,0
1667913143785,ECE 222B,A00,103647,Lomakin; Vitaliy,0,0,0,0
1667913144220,ECE 230B,A00,103648,Taur; Yuan,0,0,0,0
1667913144651,ECE 238B,A00,103649,Garay; Javier,0,0,0,0
1667913145078,ECE 240B,A00,112900,Fainman; Yeshaiahu,0,0,0,0
1667913145515,ECE 247A,A00,103650,Jokerst; Jesse Vincent,0,0,0,0
1667913145945,ECE 247B,A00,103651,Wang; Joseph,0,0,0,0
1667913146382,ECE 250,A00,103652,Siegel; Paul H.,0,0,0,0
1667913146818,ECE 251A,A00,103654,Rao; Bhaskar D.,0,0,0,0
1667913147249,ECE 257B,A00,103655,Bharadia; Dinesh,0,0,0,0
1667913147681,ECE 258A,A00,103656,Milstein; Laurence B.,0,0,0,0
1667913148109,ECE 260B,A00,103658,Kang; Mingu,0,0,0,0
1667913148534,ECE 264A,A00,103659,Galton; Ian A,0,0,0,0
1667913148969,ECE 265A,A00,103661,Gudem; Prasad S.S.,0,0,0,0
1667913149408,ECE 265D,A00,103662,Gudem; Prasad S.S.,0,0,0,0
1667913149835,ECE 268,A00,103663,Koushanfar; Farinaz,0,0,0,0
1667913150271,ECE 269,A01,103665,Pal; Piya,0,0,0,0
1667913150731,ECE 271B,A00,103666,Vasconcelos; Manuela,0,0,0,0
1667913151175,ECE 276A,A00,103667,Atanasov; Nikolay A.,0,0,0,0
1667913151613,ECE 277,A00,103668,An; Cheolhong,0,0,0,0
1667913152045,ECE 279,A00,117947,Hall; Drew A.,0,0,0,0
1667913152913,ECE 283,A00,103670,Hsueh; Tzu-Chien,0,0,0,0
1667913153905,ECE 284,A00,103671,Turakhia; Yatish Girish,0,0,0,0
1667913154333,ECE 285,A00,103672,Zheng; Yang,0,0,0,0
1667913154333,ECE 285,B00,103673,Sworder; David D.,0,0,0,0
1667913154767,ECE 287,A00,103676,Javidi; Tara,0,0,0,0
1667913155197,MATH 200B,A00,098023,Salehi Golsefidy; Alireza,15,0,15,0
1667913155626,MATH 202B,A00,098024,Rhoades; Brendon Patrick,14,0,15,1
1667913156067,MATH 203B,A00,098025,Oprea; Dragos N.,14,0,15,1
1667913156493,MATH 204B,A00,098026,Sorensen; Claus M,15,0,15,0
1667913156948,MATH 208,A00,098027,Izadi; Elham,7,0,10,3
1667913157385,MATH 209,A00,098028,Pollack; Aaron,10,0,10,0
1667913157833,MATH 211A,A00,112919,Rogalski; Daniel,10,0,10,0
1667913158262,MATH 211B,A00,112920,Seward; Brandon M.,10,0,10,0
1667913158696,MATH 218,A00,098029,Li; Bo,10,0,10,0
1667913159137,MATH 220B,A00,098030,Novak; Jonathan I,15,0,15,0
1667913159563,MATH 221A,A00,098031,Ebenfelt; Peter F,15,0,15,0
1667913159995,MATH 231B,A00,098032,Zlatos; Andrej,15,0,15,0
1667913160446,MATH 240B,A00,098033,Ni; Lei,13,0,15,2
1667913160896,MATH 243,A00,098034,Jekel; David Andrew,10,0,10,0
1667913161335,MATH 245A,A00,098035,Nie; Jiawang,6,0,15,9
1667913161774,MATH 248,A00,098036,Bejenaru; Ioan,10,0,10,0
1667913162212,MATH 250B,A00,098037,Spolaor; Luca,14,0,15,1
1667913162645,MATH 258,A00,098038,Ni; Lei,10,0,10,0
1667913163082,MATH 264B,A00,098041,Rhoades; Brendon Patrick,13,0,15,2
1667913163529,MATH 268,A00,098042,Buss; Samuel R,10,0,10,0
1667913163979,MATH 269,A00,098043,Rhoades; Brendon Patrick,10,0,10,0
1667913164405,MATH 270B,A00,098044,Li; Bo,13,0,15,2
1667913164839,MATH 272B,A00,098045,Holst; Michael J,13,0,15,2
1667913165274,MATH 273A,A00,098046,Tian; Xiaochuan,12,0,15,3
1667913165713,MATH 275,A01,098048,Tian; Xiaochuan,7,0,10,3
1667913166135,MATH 278A,A00,098049,Holst; Michael J,8,0,10,2
1667913166569,MATH 278B,A00,098050,Cloninger; Alexander,10,0,10,0
1667913166996,MATH 278C,A00,098051,Nie; Jiawang,9,0,10,1
1667913167423,MATH 280B,A00,098052,Zheng; Tianyi,12,0,15,3
1667913167861,MATH 281B,A00,098053,Bradic; Jelena,6,0,15,9
1667913168289,MATH 282B,A00,098054,Arias-Castro; Ery,2,0,15,13
1667913168715,MATH 285,A00,098055,Fitzsimmons; Patrick J,3,0,15,12
1667913169149,MATH 287B,A00,098056,Arias-Castro; Ery,9,0,15,6
1667913169613,MATH 288,A00,098057,Agarwal; Pooja,9,0,10,1
1667913169613,MATH 288,B00,098058,Zhang; Danna,9,0,10,1
1667913169613,MATH 288,C00,098059,Williams; Ruth J,10,0,10,0
1667913170051,MATH 290B,A00,098060,Roberts; Justin Deritter,14,0,15,1
1667913170477,MATH 292,A00,098061,Belmont; Eva Kinoshita,10,0,10,0
1667913170915,MATH 295,A00,098062,Suk; Andrew Hoon,48,0,50,2
1667913171348,MATH 296,A00,098063,Novak; Jonathan I,20,0,20,0
1667913171773,MATH 297,001,098064,Gamst; Anthony Collins,9997,0,9999,2
1667913680430,COGS 205,A00,101395,Chiba; Andrea,20,0,20,0
1667913680872,COGS 210B,001,101404,Greene; Deanna Jacquelyn,9998,0,9999,1
1667913680872,COGS 210B,002,101417,Xia; Haijun,9999,0,9999,0
1667913680872,COGS 210B,003,101422,Nitz; Douglas A.,9999,0,9999,0
1667913680872,COGS 210B,004,101423,Hollan; James D.,9998,0,9999,1
1667913680872,COGS 210B,005,101424,Deak; Gedeon O.,9999,0,9999,0
1667913680872,COGS 210B,006,101425,Rossano; Federico,9999,0,9999,0
1667913681296,COGS 211B,A00,101427,Coulson; Seana M,9997,0,9999,2
1667913681726,COGS 220,A00,101428,Hollan; James D.,0,0,25,25
1667913682156,COGS 229,A00,101429,Dow; Steven P,19,0,25,6
1667913682592,COGS 230,A00,101430,Klemmer; Scott R,13,0,17,4
1667913683016,COGS 234,A00,101431,Xia; Haijun,11,0,25,14
1667913683452,COGS 260,A00,101432,Kiyonaga; Anastasia,20,0,25,5
1667913683452,COGS 260,B00,101433,Kirsh; David Joel,18,0,25,7
1667913683905,CSE 202,A00,102371,Impagliazzo; Russell,0,0,0,0
1667913684353,CSE 203B,A01,102373,Cheng; Chung Kuan,0,0,0,0
1667913684795,CSE 208,A00,102374,Micciancio; Daniele,0,0,0,0
1667913685227,CSE 209A,A00,112895,Impagliazzo; Russell,0,0,15,15
1667913685678,CSE 209B,A00,108005,Bellare; Mihir,0,0,0,0
1667913686114,CSE 210,A00,113163,Coblenz; Michael J,0,0,0,0
1667913686558,CSE 219,A00,106111,Dow; Steven P,0,0,20,20
1667913686987,CSE 221,A00,102376,Voelker; Geoffrey M.,0,0,0,0
1667913687415,CSE 224,A01,102378,Porter; George M,0,0,0,0
1667913687847,CSE 229A,A00,102379,Savage; Stefan,0,0,0,0
1667913688285,CSE 229C,A00,102380,Munyaka; Imani N. S.,0,0,0,0
1667913688715,CSE 232B,A00,102382,Deutsch; Alin Bernard,0,0,0,0
1667913689146,CSE 234,A01,112904,Kumar; Arun Kumar,0,0,0,0
1667913689604,CSE 237A,A00,102383,Rosing; Tajana Simunic,0,0,0,0
1667913690032,CSE 239A,A00,102384,Deutsch; Alin Bernard,0,0,0,0
1667913690461,CSE 239B,A00,102385,Polikarpova; Nadezhda,0,0,0,0
1667913690895,CSE 240A,A00,102386,Pannuto; Patrick William,0,0,0,0
1667913691331,CSE 240B,A00,102387,Zhao; Jishen,0,0,0,0
1667913691763,CSE 241A,A00,106406,Kang; Mingu,0,0,0,0
1667913692187,CSE 249B,A00,102388,Kahng; Andrew Byun,0,0,8,8
1667913692619,CSE 251B,A01,102392,Cottrell; Garrison W,0,0,0,0
1667913692619,CSE 251B,A02,102393,Cottrell; Garrison W,0,0,0,0
1667913693053,CSE 252B,A00,102394,Ochoa; Benjamin Lawrence,0,0,0,0
1667913693485,CSE 257,A01,102396,Gao; Sicun,0,0,0,0
1667913693915,CSE 272,A00,102397,Li; Tzumao,0,0,0,0
1667913694361,CSE 274,A00,111323,Chern; Albert Ren-Haur,0,0,0,0
1667913694805,CSE 282,A00,102398,Pevzner; Pavel Arkadjevich,0,0,0,0
1667913695231,CSE 284,A00,114175,Gymrek; Melissa Ann,0,0,0,0
1667913695691,CSE 290,A00,102399,Chandraker; Manmohan Krishna,0,0,0,0
1667913695691,CSE 290,B00,102400,Vaccaro; Kristen Marie,0,0,25,25
1667913695691,CSE 290,C00,102414,Pannuto; Patrick William,0,0,25,25
1667913695691,CSE 290,D00,102427,Pevzner; Pavel Arkadjevich,0,0,0,0
1667913695691,CSE 290,E00,102429,Zhao; Jishen,0,0,0,0
1667913695691,CSE 290,F00,102436,Tullsen; Dean Michael,0,0,0,0
1667913695691,CSE 290,G00,102440,Christensen; Henrik I,0,0,20,20
1667913696117,CSE 291,A00,102443,Su; Hao,0,0,0,0
1667913696117,CSE 291,B00,102448,Polikarpova; Nadezhda,0,0,0,0
1667913696117,CSE 291,C00,102453,Vaccaro; Kristen Marie,0,0,0,0
1667913696117,CSE 291,D00,111343,Savage; Stefan,0,0,0,0
1667913696117,CSE 291,E00,116474,Claffy; Kimberly Claire,0,0,0,0
1667913696117,CSE 291,F00,116479,Pasquale; Joseph,0,0,0,0
1667913696558,CSE 293,001,119111,Bafna; Vineet,9999,0,9999,0
1667913696558,CSE 293,002,119118,Bellare; Mihir,9999,0,9999,0
1667913696558,CSE 293,003,119122,Berg-Kirkpatrick; Taylor D,9999,0,9999,0
1667913696558,CSE 293,004,119135,Christensen; Henrik I,9999,0,9999,0
1667913696558,CSE 293,005,119142,Cottrell; Garrison W,9999,0,9999,0
1667913696558,CSE 293,006,119146,Deutsch; Alin Bernard,9999,0,9999,0
1667913696558,CSE 293,007,119159,Esmaeilzadeh; Hadi,9999,0,9999,0
1667913696558,CSE 293,008,119166,Freund; Yoav,9999,0,9999,0
1667913696558,CSE 293,009,119170,Griswold; William G.,9999,0,9999,0
1667913696558,CSE 293,010,119183,Gymrek; Melissa Ann,9999,0,9999,0
1667913696558,CSE 293,011,119190,Heninger; Nadia A,9999,0,9999,0
1667913696558,CSE 293,012,119230,Impagliazzo; Russell,9999,0,9999,0
1667913696558,CSE 293,013,119232,Jhala; Ranjit,9999,0,9999,0
1667913696558,CSE 293,014,119233,Kahng; Andrew Byun,9999,0,9999,0
1667913696558,CSE 293,015,119298,Kane; Daniel Mertz,9999,0,9999,0
1667913696558,CSE 293,016,119299,Kriegman; David J,9999,0,9999,0
1667913696558,CSE 293,017,119300,Kumar; Arun Kumar,9999,0,9999,0
1667913696558,CSE 293,018,119301,Lerner; Sorin,9999,0,9999,0
1667913696558,CSE 293,019,119302,Lovett; Shachar,9999,0,9999,0
1667913696558,CSE 293,020,119303,McAuley; Julian John,9999,0,9999,0
1667913696558,CSE 293,021,119304,Micciancio; Daniele,9999,0,9999,0
1667913696558,CSE 293,022,119367,Orailoglu; Alex,9999,0,9999,0
1667913696558,CSE 293,023,119382,Paturi; Ramamohan,9999,0,9999,0
1667913696558,CSE 293,024,119404,Polikarpova; Nadezhda,9999,0,9999,0
1667913696558,CSE 293,025,119406,Politz; Joseph Gibbs,9999,0,9999,0
1667913696558,CSE 293,026,119411,Porter; George M,9999,0,9999,0
1667913696558,CSE 293,027,119414,Porter; Leonard Emerson,9999,0,9999,0
1667913696558,CSE 293,028,119416,Ramamoorthi; Ravi,9999,0,9999,0
1667913696558,CSE 293,029,119417,Sahoo; Debashis,9999,0,9999,0
1667913696558,CSE 293,030,119420,Saul; Lawrence,9999,0,9999,0
1667913696558,CSE 293,031,119421,Savage; Stefan,9999,0,9999,0
1667913696558,CSE 293,032,119425,Schulze; Jurgen P.,9999,0,9999,0
1667913696558,CSE 293,033,119426,Snoeren; Alex C.,9999,0,9999,0
1667913696558,CSE 293,034,119428,Shang; Jingbo,9999,0,9999,0
1667913696558,CSE 293,035,119430,Stefan; Deian,9999,0,9999,0
1667913696558,CSE 293,036,119431,Su; Hao,9999,0,9999,0
1667913696558,CSE 293,037,119433,Swanson; Steven James,9999,0,9999,0
1667913696558,CSE 293,038,119435,Tullsen; Dean Michael,9999,0,9999,0
1667913696558,CSE 293,039,119483,Voelker; Geoffrey M.,9999,0,9999,0
1667913696558,CSE 293,040,119537,Zhao; Jishen,9999,0,9999,0
1667913696558,CSE 293,041,119538,Zhou; Yuan-Yuan,9999,0,9999,0
1667913696558,CSE 293,042,119539,Gao; Sicun,9999,0,9999,0
1667913696558,CSE 293,043,119540,Weibel; Nadir,9999,0,9999,0
1667913696558,CSE 293,044,119541,Gupta; Rajesh K.,9999,0,9999,0
1667913696997,CSE 294,A00,102459,Voelker; Geoffrey M.,0,0,0,0
1667913696997,CSE 294,B00,111322,Orailoglu; Alex,0,0,0,0
1667913697431,DSE 201,A00,096914,Deutsch; Alin Bernard,30,0,30,0
1667913697888,DSE 210,A00,096915,Dasgupta; Sanjoy,30,0,30,0
1667913698328,DSE 260A,A00,096916,Altintas De Callaf; Ilkay,30,0,30,0
1667913698820,ECE 200,001,103586,Antipa; Nicholas A,9999,0,9999,0
1667913698820,ECE 200,002,103587,Atanasov; Nikolay A.,9999,0,9999,0
1667913698820,ECE 200,003,103588,Bharadia; Dinesh,9999,0,9999,0
1667913698820,ECE 200,004,103589,Cheng; Chung Kuan,9999,0,9999,0
1667913698820,ECE 200,005,103590,Cosman; Pamela C.,9999,0,9999,0
1667913698820,ECE 200,006,103591,Dayeh; Shadi Ahmad,9999,0,9999,0
1667913698820,ECE 200,007,103592,Fainman; Yeshaiahu,9999,0,9999,0
1667913698820,ECE 200,008,103593,Ford; Joseph Earl,9999,0,9999,0
1667913698820,ECE 200,009,103594,Franceschetti; Massimo,9999,0,9999,0
1667913698820,ECE 200,010,103595,Fullerton; Eric E,9999,0,9999,0
1667913698820,ECE 200,011,103596,Galton; Ian A,9999,0,9999,0
1667913698820,ECE 200,012,103597,Gilja; Vikash,9999,0,9999,0
1667913698820,ECE 200,013,103598,Hall; Drew A.,9999,0,9999,0
1667913698820,ECE 200,014,103599,Hsueh; Tzu-Chien,9999,0,9999,0
1667913698820,ECE 200,015,103600,Javidi; Tara,9999,0,9999,0
1667913698820,ECE 200,016,103601,Kahng; Andrew Byun,9999,0,9999,0
1667913698820,ECE 200,017,103602,Kim; Young-Han,9999,0,9999,0
1667913698820,ECE 200,018,103603,Koushanfar; Farinaz,9999,0,9999,0
1667913698820,ECE 200,019,103604,Kuzum; Duygu,9999,0,9999,0
1667913698820,ECE 200,020,103605,Le; Hanh-Phuc,9999,0,9999,0
1667913698820,ECE 200,021,103606,Lin; Bill,9999,0,9999,0
1667913698820,ECE 200,022,103607,Liu; Zhaowei,9998,0,9999,1
1667913698820,ECE 200,023,103608,Lo; Yu-Hwa,9999,0,9999,0
1667913698820,ECE 200,024,103609,Lomakin; Vitaliy,9999,0,9999,0
1667913698820,ECE 200,025,103610,Mercier; Patrick Philip,9999,0,9999,0
1667913698820,ECE 200,026,103611,Meyer; Florian,9999,0,9999,0
1667913698820,ECE 200,027,103612,Milstein; Laurence B.,9999,0,9999,0
1667913698820,ECE 200,028,103613,Mir Arabbaygi; Siavash,9999,0,9999,0
1667913698820,ECE 200,029,103614,Mookherjea; Shayan,9999,0,9999,0
1667913698820,ECE 200,030,103615,Morris; Karcher William,9999,0,9999,0
1667913698820,ECE 200,031,103616,Ng; Tse Nga,9999,0,9999,0
1667913698820,ECE 200,032,103617,Nguyen; Truong Quang,9999,0,9999,0
1667913698820,ECE 200,033,103618,Nomura; Kenji,9999,0,9999,0
1667913698820,ECE 200,034,103619,Orlitsky; Alon,9999,0,9999,0
1667913698820,ECE 200,035,103620,Pal; Piya,9999,0,9999,0
1667913698820,ECE 200,036,103621,Papen; George C.,9999,0,9999,0
1667913698820,ECE 200,037,103622,Radic; Stojan,9999,0,9999,0
1667913698820,ECE 200,038,103623,Rao; Bhaskar D.,9999,0,9999,0
1667913698820,ECE 200,039,103624,Rao; Ramesh R,9999,0,9999,0
1667913698820,ECE 200,040,103625,Rebeiz; Gabriel,9999,0,9999,0
1667913698820,ECE 200,041,103626,Sanford; John R,9999,0,9999,0
1667913698820,ECE 200,042,103627,Siegel; Paul H.,9999,0,9999,0
1667913698820,ECE 200,043,103628,Sievenpiper; Daniel F.,9999,0,9999,0
1667913698820,ECE 200,044,103629,Sworder; David D.,9999,0,9999,0
1667913698820,ECE 200,045,103630,Taur; Yuan,9999,0,9999,0
1667913698820,ECE 200,046,103631,Touri; Behrouz,9999,0,9999,0
1667913698820,ECE 200,047,103632,Trivedi; Mohan M.,9999,0,9999,0
1667913698820,ECE 200,048,103633,Vasconcelos; Nuno,9999,0,9999,0
1667913698820,ECE 200,049,103634,Wang; Xiaolong,9999,0,9999,0
1667913698820,ECE 200,050,103635,Xie; Pengtao,9999,0,9999,0
1667913698820,ECE 200,051,103636,Yip; Michael,9999,0,9999,0
1667913698820,ECE 200,052,103637,Zeger; Kenneth A.,999,0,999,0
1667913698820,ECE 200,053,103638,Zhang; Xinyu,9999,0,9999,0
1667913698820,ECE 200,054,103639,Turakhia; Yatish Girish,9999,0,9999,0
1667913698820,ECE 200,055,103640,Kang; Mingu,9999,0,9999,0
1667913698820,ECE 200,056,103641,Shi; Yuanyuan,9999,0,9999,0
1667913698820,ECE 200,057,103642,Wang; Edward Jay,9999,0,9999,0
1667913698820,ECE 200,058,103643,Zheng; Yang,9999,0,9999,0
1667913699256,ECE 202,A00,103644,Kuzum; Duygu,0,0,0,0
1667913699684,ECE 212BN,A00,103646,Ng; Tse Nga,0,0,0,0
1667913700113,ECE 221,A00,111493,Staff,0,0,0,0
1667913700544,ECE 222B,A00,103647,Lomakin; Vitaliy,0,0,0,0
1667913700972,ECE 230B,A00,103648,Taur; Yuan,0,0,0,0
1667913701411,ECE 238B,A00,103649,Garay; Javier,0,0,0,0
1667913701835,ECE 240B,A00,112900,Fainman; Yeshaiahu,0,0,0,0
1667913702265,ECE 247A,A00,103650,Jokerst; Jesse Vincent,0,0,0,0
1667913702714,ECE 247B,A00,103651,Wang; Joseph,0,0,0,0
1667913703154,ECE 250,A00,103652,Siegel; Paul H.,0,0,0,0
1667913703588,ECE 251A,A00,103654,Rao; Bhaskar D.,0,0,0,0
1667913704022,ECE 257B,A00,103655,Bharadia; Dinesh,0,0,0,0
1667913704455,ECE 258A,A00,103656,Milstein; Laurence B.,0,0,0,0
1667913704879,ECE 260B,A00,103658,Kang; Mingu,0,0,0,0
1667913705316,ECE 264A,A00,103659,Galton; Ian A,0,0,0,0
1667913705743,ECE 265A,A00,103661,Gudem; Prasad S.S.,0,0,0,0
1667913706171,ECE 265D,A00,103662,Gudem; Prasad S.S.,0,0,0,0
1667913706612,ECE 268,A00,103663,Koushanfar; Farinaz,0,0,0,0
1667913707037,ECE 269,A01,103665,Pal; Piya,0,0,0,0
1667913707464,ECE 271B,A00,103666,Vasconcelos; Manuela,0,0,0,0
1667913707896,ECE 276A,A00,103667,Atanasov; Nikolay A.,0,0,0,0
1667913708334,ECE 277,A00,103668,An; Cheolhong,0,0,0,0
1667913708786,ECE 279,A00,117947,Hall; Drew A.,0,0,0,0
1667913709647,ECE 283,A00,103670,Hsueh; Tzu-Chien,0,0,0,0
1667913710081,ECE 284,A00,103671,Turakhia; Yatish Girish,0,0,0,0
1667913710512,ECE 285,A00,103672,Zheng; Yang,0,0,0,0
1667913710512,ECE 285,B00,103673,Sworder; David D.,0,0,0,0
1667913710947,ECE 287,A00,103676,Javidi; Tara,0,0,0,0
1667913711378,MATH 200B,A00,098023,Salehi Golsefidy; Alireza,15,0,15,0
1667913711813,MATH 202B,A00,098024,Rhoades; Brendon Patrick,14,0,15,1
1667913712241,MATH 203B,A00,098025,Oprea; Dragos N.,14,0,15,1
1667913712679,MATH 204B,A00,098026,Sorensen; Claus M,15,0,15,0
1667913713111,MATH 208,A00,098027,Izadi; Elham,7,0,10,3
1667913713537,MATH 209,A00,098028,Pollack; Aaron,10,0,10,0
1667913714063,MATH 211A,A00,112919,Rogalski; Daniel,10,0,10,0
1667913714492,MATH 211B,A00,112920,Seward; Brandon M.,10,0,10,0
1667913714939,MATH 218,A00,098029,Li; Bo,10,0,10,0
1667913715369,MATH 220B,A00,098030,Novak; Jonathan I,15,0,15,0
1667913715806,MATH 221A,A00,098031,Ebenfelt; Peter F,15,0,15,0
1667913716245,MATH 231B,A00,098032,Zlatos; Andrej,15,0,15,0
1667913716668,MATH 240B,A00,098033,Ni; Lei,13,0,15,2
1667913717099,MATH 243,A00,098034,Jekel; David Andrew,10,0,10,0
1667913717536,MATH 245A,A00,098035,Nie; Jiawang,6,0,15,9
1667913717959,MATH 248,A00,098036,Bejenaru; Ioan,10,0,10,0
1667913718402,MATH 250B,A00,098037,Spolaor; Luca,14,0,15,1
1667913718828,MATH 258,A00,098038,Ni; Lei,10,0,10,0
1667913719257,MATH 264B,A00,098041,Rhoades; Brendon Patrick,13,0,15,2
1667913719680,MATH 268,A00,098042,Buss; Samuel R,10,0,10,0
1667913720142,MATH 269,A00,098043,Rhoades; Brendon Patrick,10,0,10,0
1667913720589,MATH 270B,A00,098044,Li; Bo,13,0,15,2
1667913721054,MATH 272B,A00,098045,Holst; Michael J,13,0,15,2
1667913721484,MATH 273A,A00,098046,Tian; Xiaochuan,12,0,15,3
1667913721921,MATH 275,A01,098048,Tian; Xiaochuan,7,0,10,3
1667913722384,MATH 278A,A00,098049,Holst; Michael J,8,0,10,2
1667913722826,MATH 278B,A00,098050,Cloninger; Alexander,10,0,10,0
1667913723254,MATH 278C,A00,098051,Nie; Jiawang,9,0,10,1
1667913723684,MATH 280B,A00,098052,Zheng; Tianyi,12,0,15,3
1667913724124,MATH 281B,A00,098053,Bradic; Jelena,6,0,15,9
1667913724578,MATH 282B,A00,098054,Arias-Castro; Ery,2,0,15,13
1667913725017,MATH 285,A00,098055,Fitzsimmons; Patrick J,3,0,15,12
1667913725441,MATH 287B,A00,098056,Arias-Castro; Ery,9,0,15,6
1667913725873,MATH 288,A00,098057,Agarwal; Pooja,9,0,10,1
1667913725873,MATH 288,B00,098058,Zhang; Danna,9,0,10,1
1667913725873,MATH 288,C00,098059,Williams; Ruth J,10,0,10,0
1667913726300,MATH 290B,A00,098060,Roberts; Justin Deritter,14,0,15,1
1667913726728,MATH 292,A00,098061,Belmont; Eva Kinoshita,10,0,10,0
1667913727154,MATH 295,A00,098062,Suk; Andrew Hoon,48,0,50,2
1667913727585,MATH 296,A00,098063,Novak; Jonathan I,20,0,20,0
1667913728015,MATH 297,001,098064,Gamst; Anthony Collins,9997,0,9999,2
1667914237793,COGS 205,A00,101395,Chiba; Andrea,20,0,20,0
1667914238235,COGS 210B,001,101404,Greene; Deanna Jacquelyn,9998,0,9999,1
1667914238235,COGS 210B,002,101417,Xia; Haijun,9999,0,9999,0
1667914238235,COGS 210B,003,101422,Nitz; Douglas A.,9999,0,9999,0
1667914238235,COGS 210B,004,101423,Hollan; James D.,9998,0,9999,1
1667914238235,COGS 210B,005,101424,Deak; Gedeon O.,9999,0,9999,0
1667914238235,COGS 210B,006,101425,Rossano; Federico,9999,0,9999,0
1667914238671,COGS 211B,A00,101427,Coulson; Seana M,9997,0,9999,2
1667914239104,COGS 220,A00,101428,Hollan; James D.,0,0,25,25
1667914239579,COGS 229,A00,101429,Dow; Steven P,19,0,25,6
1667914240017,COGS 230,A00,101430,Klemmer; Scott R,13,0,17,4
1667914240455,COGS 234,A00,101431,Xia; Haijun,11,0,25,14
1667914240903,COGS 260,A00,101432,Kiyonaga; Anastasia,20,0,25,5
1667914240903,COGS 260,B00,101433,Kirsh; David Joel,18,0,25,7
1667914241335,CSE 202,A00,102371,Impagliazzo; Russell,0,0,0,0
1667914241772,CSE 203B,A01,102373,Cheng; Chung Kuan,0,0,0,0
1667914242208,CSE 208,A00,102374,Micciancio; Daniele,0,0,0,0
1667914242637,CSE 209A,A00,112895,Impagliazzo; Russell,0,0,15,15
1667914243067,CSE 209B,A00,108005,Bellare; Mihir,0,0,0,0
1667914243517,CSE 210,A00,113163,Coblenz; Michael J,0,0,0,0
1667914243958,CSE 219,A00,106111,Dow; Steven P,0,0,20,20
1667914244471,CSE 221,A00,102376,Voelker; Geoffrey M.,0,0,0,0
1667914244912,CSE 224,A01,102378,Porter; George M,0,0,0,0
1667914245353,CSE 229A,A00,102379,Savage; Stefan,0,0,0,0
1667914245784,CSE 229C,A00,102380,Munyaka; Imani N. S.,0,0,0,0
1667914246211,CSE 232B,A00,102382,Deutsch; Alin Bernard,0,0,0,0
1667914246645,CSE 234,A01,112904,Kumar; Arun Kumar,0,0,0,0
1667914247088,CSE 237A,A00,102383,Rosing; Tajana Simunic,0,0,0,0
1667914247516,CSE 239A,A00,102384,Deutsch; Alin Bernard,0,0,0,0
1667914247951,CSE 239B,A00,102385,Polikarpova; Nadezhda,0,0,0,0
1667914248385,CSE 240A,A00,102386,Pannuto; Patrick William,0,0,0,0
1667914248818,CSE 240B,A00,102387,Zhao; Jishen,0,0,0,0
1667914249257,CSE 241A,A00,106406,Kang; Mingu,0,0,0,0
1667914249683,CSE 249B,A00,102388,Kahng; Andrew Byun,0,0,8,8
1667914250119,CSE 251B,A01,102392,Cottrell; Garrison W,0,0,0,0
1667914250119,CSE 251B,A02,102393,Cottrell; Garrison W,0,0,0,0
1667914250547,CSE 252B,A00,102394,Ochoa; Benjamin Lawrence,0,0,0,0
1667914250992,CSE 257,A01,102396,Gao; Sicun,0,0,0,0
1667914251430,CSE 272,A00,102397,Li; Tzumao,0,0,0,0
1667914251864,CSE 274,A00,111323,Chern; Albert Ren-Haur,0,0,0,0
1667914252294,CSE 282,A00,102398,Pevzner; Pavel Arkadjevich,0,0,0,0
1667914252720,CSE 284,A00,114175,Gymrek; Melissa Ann,0,0,0,0
1667914253156,CSE 290,A00,102399,Chandraker; Manmohan Krishna,0,0,0,0
1667914253156,CSE 290,B00,102400,Vaccaro; Kristen Marie,0,0,25,25
1667914253156,CSE 290,C00,102414,Pannuto; Patrick William,0,0,25,25
1667914253156,CSE 290,D00,102427,Pevzner; Pavel Arkadjevich,0,0,0,0
1667914253156,CSE 290,E00,102429,Zhao; Jishen,0,0,0,0
1667914253156,CSE 290,F00,102436,Tullsen; Dean Michael,0,0,0,0
1667914253156,CSE 290,G00,102440,Christensen; Henrik I,0,0,20,20
1667914253598,CSE 291,A00,102443,Su; Hao,0,0,0,0
1667914253598,CSE 291,B00,102448,Polikarpova; Nadezhda,0,0,0,0
1667914253598,CSE 291,C00,102453,Vaccaro; Kristen Marie,0,0,0,0
1667914253598,CSE 291,D00,111343,Savage; Stefan,0,0,0,0
1667914253598,CSE 291,E00,116474,Claffy; Kimberly Claire,0,0,0,0
1667914253598,CSE 291,F00,116479,Pasquale; Joseph,0,0,0,0
1667914254045,CSE 293,001,119111,Bafna; Vineet,9999,0,9999,0
1667914254045,CSE 293,002,119118,Bellare; Mihir,9999,0,9999,0
1667914254045,CSE 293,003,119122,Berg-Kirkpatrick; Taylor D,9999,0,9999,0
1667914254045,CSE 293,004,119135,Christensen; Henrik I,9999,0,9999,0
1667914254045,CSE 293,005,119142,Cottrell; Garrison W,9999,0,9999,0
1667914254045,CSE 293,006,119146,Deutsch; Alin Bernard,9999,0,9999,0
1667914254045,CSE 293,007,119159,Esmaeilzadeh; Hadi,9999,0,9999,0
1667914254045,CSE 293,008,119166,Freund; Yoav,9999,0,9999,0
1667914254045,CSE 293,009,119170,Griswold; William G.,9999,0,9999,0
1667914254045,CSE 293,010,119183,Gymrek; Melissa Ann,9999,0,9999,0
1667914254045,CSE 293,011,119190,Heninger; Nadia A,9999,0,9999,0
1667914254045,CSE 293,012,119230,Impagliazzo; Russell,9999,0,9999,0
1667914254045,CSE 293,013,119232,Jhala; Ranjit,9999,0,9999,0
1667914254045,CSE 293,014,119233,Kahng; Andrew Byun,9999,0,9999,0
1667914254045,CSE 293,015,119298,Kane; Daniel Mertz,9999,0,9999,0
1667914254045,CSE 293,016,119299,Kriegman; David J,9999,0,9999,0
1667914254045,CSE 293,017,119300,Kumar; Arun Kumar,9999,0,9999,0
1667914254045,CSE 293,018,119301,Lerner; Sorin,9999,0,9999,0
1667914254045,CSE 293,019,119302,Lovett; Shachar,9999,0,9999,0
1667914254045,CSE 293,020,119303,McAuley; Julian John,9999,0,9999,0
1667914254045,CSE 293,021,119304,Micciancio; Daniele,9999,0,9999,0
1667914254045,CSE 293,022,119367,Orailoglu; Alex,9999,0,9999,0
1667914254045,CSE 293,023,119382,Paturi; Ramamohan,9999,0,9999,0
1667914254045,CSE 293,024,119404,Polikarpova; Nadezhda,9999,0,9999,0
1667914254045,CSE 293,025,119406,Politz; Joseph Gibbs,9999,0,9999,0
1667914254045,CSE 293,026,119411,Porter; George M,9999,0,9999,0
1667914254045,CSE 293,027,119414,Porter; Leonard Emerson,9999,0,9999,0
1667914254045,CSE 293,028,119416,Ramamoorthi; Ravi,9999,0,9999,0
1667914254045,CSE 293,029,119417,Sahoo; Debashis,9999,0,9999,0
1667914254045,CSE 293,030,119420,Saul; Lawrence,9999,0,9999,0
1667914254045,CSE 293,031,119421,Savage; Stefan,9999,0,9999,0
1667914254045,CSE 293,032,119425,Schulze; Jurgen P.,9999,0,9999,0
1667914254045,CSE 293,033,119426,Snoeren; Alex C.,9999,0,9999,0
1667914254045,CSE 293,034,119428,Shang; Jingbo,9999,0,9999,0
1667914254045,CSE 293,035,119430,Stefan; Deian,9999,0,9999,0
1667914254045,CSE 293,036,119431,Su; Hao,9999,0,9999,0
1667914254045,CSE 293,037,119433,Swanson; Steven James,9999,0,9999,0
1667914254045,CSE 293,038,119435,Tullsen; Dean Michael,9999,0,9999,0
1667914254045,CSE 293,039,119483,Voelker; Geoffrey M.,9999,0,9999,0
1667914254045,CSE 293,040,119537,Zhao; Jishen,9999,0,9999,0
1667914254045,CSE 293,041,119538,Zhou; Yuan-Yuan,9999,0,9999,0
1667914254045,CSE 293,042,119539,Gao; Sicun,9999,0,9999,0
1667914254045,CSE 293,043,119540,Weibel; Nadir,9999,0,9999,0
1667914254045,CSE 293,044,119541,Gupta; Rajesh K.,9999,0,9999,0
1667914254487,CSE 294,A00,102459,Voelker; Geoffrey M.,0,0,0,0
1667914254487,CSE 294,B00,111322,Orailoglu; Alex,0,0,0,0
1667914254915,DSE 201,A00,096914,Deutsch; Alin Bernard,30,0,30,0
1667914255345,DSE 210,A00,096915,Dasgupta; Sanjoy,30,0,30,0
1667914255773,DSE 260A,A00,096916,Altintas De Callaf; Ilkay,30,0,30,0
1667914256226,ECE 200,001,103586,Antipa; Nicholas A,9999,0,9999,0
1667914256226,ECE 200,002,103587,Atanasov; Nikolay A.,9999,0,9999,0
1667914256226,ECE 200,003,103588,Bharadia; Dinesh,9999,0,9999,0
1667914256226,ECE 200,004,103589,Cheng; Chung Kuan,9999,0,9999,0
1667914256226,ECE 200,005,103590,Cosman; Pamela C.,9999,0,9999,0
1667914256226,ECE 200,006,103591,Dayeh; Shadi Ahmad,9999,0,9999,0
1667914256226,ECE 200,007,103592,Fainman; Yeshaiahu,9999,0,9999,0
1667914256226,ECE 200,008,103593,Ford; Joseph Earl,9999,0,9999,0
1667914256226,ECE 200,009,103594,Franceschetti; Massimo,9999,0,9999,0
1667914256226,ECE 200,010,103595,Fullerton; Eric E,9999,0,9999,0
1667914256226,ECE 200,011,103596,Galton; Ian A,9999,0,9999,0
1667914256226,ECE 200,012,103597,Gilja; Vikash,9999,0,9999,0
1667914256226,ECE 200,013,103598,Hall; Drew A.,9999,0,9999,0
1667914256226,ECE 200,014,103599,Hsueh; Tzu-Chien,9999,0,9999,0
1667914256226,ECE 200,015,103600,Javidi; Tara,9999,0,9999,0
1667914256226,ECE 200,016,103601,Kahng; Andrew Byun,9999,0,9999,0
1667914256226,ECE 200,017,103602,Kim; Young-Han,9999,0,9999,0
1667914256226,ECE 200,018,103603,Koushanfar; Farinaz,9999,0,9999,0
1667914256226,ECE 200,019,103604,Kuzum; Duygu,9999,0,9999,0
1667914256226,ECE 200,020,103605,Le; Hanh-Phuc,9999,0,9999,0
1667914256226,ECE 200,021,103606,Lin; Bill,9999,0,9999,0
1667914256226,ECE 200,022,103607,Liu; Zhaowei,9998,0,9999,1
1667914256226,ECE 200,023,103608,Lo; Yu-Hwa,9999,0,9999,0
1667914256226,ECE 200,024,103609,Lomakin; Vitaliy,9999,0,9999,0
1667914256226,ECE 200,025,103610,Mercier; Patrick Philip,9999,0,9999,0
1667914256226,ECE 200,026,103611,Meyer; Florian,9999,0,9999,0
1667914256226,ECE 200,027,103612,Milstein; Laurence B.,9999,0,9999,0
1667914256226,ECE 200,028,103613,Mir Arabbaygi; Siavash,9999,0,9999,0
1667914256226,ECE 200,029,103614,Mookherjea; Shayan,9999,0,9999,0
1667914256226,ECE 200,030,103615,Morris; Karcher William,9999,0,9999,0
1667914256226,ECE 200,031,103616,Ng; Tse Nga,9999,0,9999,0
1667914256226,ECE 200,032,103617,Nguyen; Truong Quang,9999,0,9999,0
1667914256226,ECE 200,033,103618,Nomura; Kenji,9999,0,9999,0
1667914256226,ECE 200,034,103619,Orlitsky; Alon,9999,0,9999,0
1667914256226,ECE 200,035,103620,Pal; Piya,9999,0,9999,0
1667914256226,ECE 200,036,103621,Papen; George C.,9999,0,9999,0
1667914256226,ECE 200,037,103622,Radic; Stojan,9999,0,9999,0
1667914256226,ECE 200,038,103623,Rao; Bhaskar D.,9999,0,9999,0
1667914256226,ECE 200,039,103624,Rao; Ramesh R,9999,0,9999,0
1667914256226,ECE 200,040,103625,Rebeiz; Gabriel,9999,0,9999,0
1667914256226,ECE 200,041,103626,Sanford; John R,9999,0,9999,0
1667914256226,ECE 200,042,103627,Siegel; Paul H.,9999,0,9999,0
1667914256226,ECE 200,043,103628,Sievenpiper; Daniel F.,9999,0,9999,0
1667914256226,ECE 200,044,103629,Sworder; David D.,9999,0,9999,0
1667914256226,ECE 200,045,103630,Taur; Yuan,9999,0,9999,0
1667914256226,ECE 200,046,103631,Touri; Behrouz,9999,0,9999,0
1667914256226,ECE 200,047,103632,Trivedi; Mohan M.,9999,0,9999,0
1667914256226,ECE 200,048,103633,Vasconcelos; Nuno,9999,0,9999,0
1667914256226,ECE 200,049,103634,Wang; Xiaolong,9999,0,9999,0
1667914256226,ECE 200,050,103635,Xie; Pengtao,9999,0,9999,0
1667914256226,ECE 200,051,103636,Yip; Michael,9999,0,9999,0
1667914256226,ECE 200,052,103637,Zeger; Kenneth A.,999,0,999,0
1667914256226,ECE 200,053,103638,Zhang; Xinyu,9999,0,9999,0
1667914256226,ECE 200,054,103639,Turakhia; Yatish Girish,9999,0,9999,0
1667914256226,ECE 200,055,103640,Kang; Mingu,9999,0,9999,0
1667914256226,ECE 200,056,103641,Shi; Yuanyuan,9999,0,9999,0
1667914256226,ECE 200,057,103642,Wang; Edward Jay,9999,0,9999,0
1667914256226,ECE 200,058,103643,Zheng; Yang,9999,0,9999,0
1667914256656,ECE 202,A00,103644,Kuzum; Duygu,0,0,0,0
1667914257083,ECE 212BN,A00,103646,Ng; Tse Nga,0,0,0,0
1667914257531,ECE 221,A00,111493,Staff,0,0,0,0
1667914257959,ECE 222B,A00,103647,Lomakin; Vitaliy,0,0,0,0
1667914258395,ECE 230B,A00,103648,Taur; Yuan,0,0,0,0
1667914258828,ECE 238B,A00,103649,Garay; Javier,0,0,0,0
1667914259253,ECE 240B,A00,112900,Fainman; Yeshaiahu,0,0,0,0
1667914259684,ECE 247A,A00,103650,Jokerst; Jesse Vincent,0,0,0,0
1667914260115,ECE 247B,A00,103651,Wang; Joseph,0,0,0,0
1667914260543,ECE 250,A00,103652,Siegel; Paul H.,0,0,0,0
1667914260981,ECE 251A,A00,103654,Rao; Bhaskar D.,0,0,0,0
1667914261418,ECE 257B,A00,103655,Bharadia; Dinesh,0,0,0,0
1667914261851,ECE 258A,A00,103656,Milstein; Laurence B.,0,0,0,0
1667914262285,ECE 260B,A00,103658,Kang; Mingu,0,0,0,0
1667914262711,ECE 264A,A00,103659,Galton; Ian A,0,0,0,0
1667914263143,ECE 265A,A00,103661,Gudem; Prasad S.S.,0,0,0,0
1667914263570,ECE 265D,A00,103662,Gudem; Prasad S.S.,0,0,0,0
1667914264006,ECE 268,A00,103663,Koushanfar; Farinaz,0,0,0,0
1667914264435,ECE 269,A01,103665,Pal; Piya,0,0,0,0
1667914264859,ECE 271B,A00,103666,Vasconcelos; Manuela,0,0,0,0
1667914265306,ECE 276A,A00,103667,Atanasov; Nikolay A.,0,0,0,0
1667914265737,ECE 277,A00,103668,An; Cheolhong,0,0,0,0
1667914266168,ECE 279,A00,117947,Hall; Drew A.,0,0,0,0
1667914267026,ECE 283,A00,103670,Hsueh; Tzu-Chien,0,0,0,0
1667914267460,ECE 284,A00,103671,Turakhia; Yatish Girish,0,0,0,0
1667914267886,ECE 285,A00,103672,Zheng; Yang,0,0,0,0
1667914267886,ECE 285,B00,103673,Sworder; David D.,0,0,0,0
1667914268313,ECE 287,A00,103676,Javidi; Tara,0,0,0,0
1667914268752,MATH 200B,A00,098023,Salehi Golsefidy; Alireza,15,0,15,0
1667914269180,MATH 202B,A00,098024,Rhoades; Brendon Patrick,14,0,15,1
1667914269645,MATH 203B,A00,098025,Oprea; Dragos N.,14,0,15,1
1667914270076,MATH 204B,A00,098026,Sorensen; Claus M,15,0,15,0
1667914270520,MATH 208,A00,098027,Izadi; Elham,7,0,10,3
1667914270971,MATH 209,A00,098028,Pollack; Aaron,10,0,10,0
1667914271442,MATH 211A,A00,112919,Rogalski; Daniel,10,0,10,0
1667914271875,MATH 211B,A00,112920,Seward; Brandon M.,10,0,10,0
1667914272301,MATH 218,A00,098029,Li; Bo,10,0,10,0
1667914272733,MATH 220B,A00,098030,Novak; Jonathan I,15,0,15,0
1667914273161,MATH 221A,A00,098031,Ebenfelt; Peter F,15,0,15,0
1667914273606,MATH 231B,A00,098032,Zlatos; Andrej,15,0,15,0
1667914274032,MATH 240B,A00,098033,Ni; Lei,13,0,15,2
1667914274469,MATH 243,A00,098034,Jekel; David Andrew,10,0,10,0
1667914274906,MATH 245A,A00,098035,Nie; Jiawang,6,0,15,9
1667914275340,MATH 248,A00,098036,Bejenaru; Ioan,10,0,10,0
1667914275769,MATH 250B,A00,098037,Spolaor; Luca,14,0,15,1
1667914276201,MATH 258,A00,098038,Ni; Lei,10,0,10,0
1667914276646,MATH 264B,A00,098041,Rhoades; Brendon Patrick,13,0,15,2
1667914277072,MATH 268,A00,098042,Buss; Samuel R,10,0,10,0
1667914277514,MATH 269,A00,098043,Rhoades; Brendon Patrick,10,0,10,0
1667914277948,MATH 270B,A00,098044,Li; Bo,13,0,15,2
1667914278377,MATH 272B,A00,098045,Holst; Michael J,13,0,15,2
1667914278803,MATH 273A,A00,098046,Tian; Xiaochuan,12,0,15,3
1667914279229,MATH 275,A01,098048,Tian; Xiaochuan,7,0,10,3
1667914279677,MATH 278A,A00,098049,Holst; Michael J,8,0,10,2
1667914280109,MATH 278B,A00,098050,Cloninger; Alexander,10,0,10,0
1667914280545,MATH 278C,A00,098051,Nie; Jiawang,9,0,10,1
1667914280977,MATH 280B,A00,098052,Zheng; Tianyi,12,0,15,3
1667914281401,MATH 281B,A00,098053,Bradic; Jelena,6,0,15,9
1667914281838,MATH 282B,A00,098054,Arias-Castro; Ery,2,0,15,13
1667914282270,MATH 285,A00,098055,Fitzsimmons; Patrick J,3,0,15,12
1667914282706,MATH 287B,A00,098056,Arias-Castro; Ery,9,0,15,6
1667914283136,MATH 288,A00,098057,Agarwal; Pooja,9,0,10,1
1667914283136,MATH 288,B00,098058,Zhang; Danna,9,0,10,1
1667914283136,MATH 288,C00,098059,Williams; Ruth J,10,0,10,0
1667914283588,MATH 290B,A00,098060,Roberts; Justin Deritter,14,0,15,1
1667914284029,MATH 292,A00,098061,Belmont; Eva Kinoshita,10,0,10,0
1667914284453,MATH 295,A00,098062,Suk; Andrew Hoon,48,0,50,2
1667914284885,MATH 296,A00,098063,Novak; Jonathan I,20,0,20,0
1667914285325,MATH 297,001,098064,Gamst; Anthony Collins,9997,0,9999,2
1667914795812,COGS 205,A00,101395,Chiba; Andrea,20,0,20,0
1667914796245,COGS 210B,001,101404,Greene; Deanna Jacquelyn,9998,0,9999,1
1667914796245,COGS 210B,002,101417,Xia; Haijun,9999,0,9999,0
1667914796245,COGS 210B,003,101422,Nitz; Douglas A.,9999,0,9999,0
1667914796245,COGS 210B,004,101423,Hollan; James D.,9998,0,9999,1
1667914796245,COGS 210B,005,101424,Deak; Gedeon O.,9999,0,9999,0
1667914796245,COGS 210B,006,101425,Rossano; Federico,9999,0,9999,0
1667914796679,COGS 211B,A00,101427,Coulson; Seana M,9997,0,9999,2
1667914797103,COGS 220,A00,101428,Hollan; James D.,0,0,25,25
1667914797529,COGS 229,A00,101429,Dow; Steven P,19,0,25,6
1667914797952,COGS 230,A00,101430,Klemmer; Scott R,13,0,17,4
1667914798381,COGS 234,A00,101431,Xia; Haijun,11,0,25,14
1667914798809,COGS 260,A00,101432,Kiyonaga; Anastasia,20,0,25,5
1667914798809,COGS 260,B00,101433,Kirsh; David Joel,18,0,25,7
1667914799237,CSE 202,A00,102371,Impagliazzo; Russell,0,0,0,0
1667914799679,CSE 203B,A01,102373,Cheng; Chung Kuan,0,0,0,0
1667914800139,CSE 208,A00,102374,Micciancio; Daniele,0,0,0,0
1667914800588,CSE 209A,A00,112895,Impagliazzo; Russell,0,0,15,15
1667914801029,CSE 209B,A00,108005,Bellare; Mihir,0,0,0,0
1667914801471,CSE 210,A00,113163,Coblenz; Michael J,0,0,0,0
1667914801896,CSE 219,A00,106111,Dow; Steven P,0,0,20,20
1667914802335,CSE 221,A00,102376,Voelker; Geoffrey M.,0,0,0,0
1667914802767,CSE 224,A01,102378,Porter; George M,0,0,0,0
1667914803204,CSE 229A,A00,102379,Savage; Stefan,0,0,0,0
1667914803634,CSE 229C,A00,102380,Munyaka; Imani N. S.,0,0,0,0
1667914804068,CSE 232B,A00,102382,Deutsch; Alin Bernard,0,0,0,0
1667914804502,CSE 234,A01,112904,Kumar; Arun Kumar,0,0,0,0
1667914804932,CSE 237A,A00,102383,Rosing; Tajana Simunic,0,0,0,0
1667914805359,CSE 239A,A00,102384,Deutsch; Alin Bernard,0,0,0,0
1667914805795,CSE 239B,A00,102385,Polikarpova; Nadezhda,0,0,0,0
1667914806225,CSE 240A,A00,102386,Pannuto; Patrick William,0,0,0,0
1667914806653,CSE 240B,A00,102387,Zhao; Jishen,0,0,0,0
1667914807112,CSE 241A,A00,106406,Kang; Mingu,0,0,0,0
1667914807538,CSE 249B,A00,102388,Kahng; Andrew Byun,0,0,8,8
1667914807965,CSE 251B,A01,102392,Cottrell; Garrison W,0,0,0,0
1667914807965,CSE 251B,A02,102393,Cottrell; Garrison W,0,0,0,0
1667914808408,CSE 252B,A00,102394,Ochoa; Benjamin Lawrence,0,0,0,0
1667914808844,CSE 257,A01,102396,Gao; Sicun,0,0,0,0
1667914809276,CSE 272,A00,102397,Li; Tzumao,0,0,0,0
1667914809712,CSE 274,A00,111323,Chern; Albert Ren-Haur,0,0,0,0
1667914810147,CSE 282,A00,102398,Pevzner; Pavel Arkadjevich,0,0,0,0
1667914810581,CSE 284,A00,114175,Gymrek; Melissa Ann,0,0,0,0
1667914811015,CSE 290,A00,102399,Chandraker; Manmohan Krishna,0,0,0,0
1667914811015,CSE 290,B00,102400,Vaccaro; Kristen Marie,0,0,25,25
1667914811015,CSE 290,C00,102414,Pannuto; Patrick William,0,0,25,25
1667914811015,CSE 290,D00,102427,Pevzner; Pavel Arkadjevich,0,0,0,0
1667914811015,CSE 290,E00,102429,Zhao; Jishen,0,0,0,0
1667914811015,CSE 290,F00,102436,Tullsen; Dean Michael,0,0,0,0
1667914811015,CSE 290,G00,102440,Christensen; Henrik I,0,0,20,20
1667914811443,CSE 291,A00,102443,Su; Hao,0,0,0,0
1667914811443,CSE 291,B00,102448,Polikarpova; Nadezhda,0,0,0,0
1667914811443,CSE 291,C00,102453,Vaccaro; Kristen Marie,0,0,0,0
1667914811443,CSE 291,D00,111343,Savage; Stefan,0,0,0,0
1667914811443,CSE 291,E00,116474,Claffy; Kimberly Claire,0,0,0,0
1667914811443,CSE 291,F00,116479,Pasquale; Joseph,0,0,0,0
1667914811888,CSE 293,001,119111,Bafna; Vineet,9999,0,9999,0
1667914811888,CSE 293,002,119118,Bellare; Mihir,9999,0,9999,0
1667914811888,CSE 293,003,119122,Berg-Kirkpatrick; Taylor D,9999,0,9999,0
1667914811888,CSE 293,004,119135,Christensen; Henrik I,9999,0,9999,0
1667914811888,CSE 293,005,119142,Cottrell; Garrison W,9999,0,9999,0
1667914811888,CSE 293,006,119146,Deutsch; Alin Bernard,9999,0,9999,0
1667914811888,CSE 293,007,119159,Esmaeilzadeh; Hadi,9999,0,9999,0
1667914811888,CSE 293,008,119166,Freund; Yoav,9999,0,9999,0
1667914811888,CSE 293,009,119170,Griswold; William G.,9999,0,9999,0
1667914811888,CSE 293,010,119183,Gymrek; Melissa Ann,9999,0,9999,0
1667914811888,CSE 293,011,119190,Heninger; Nadia A,9999,0,9999,0
1667914811888,CSE 293,012,119230,Impagliazzo; Russell,9999,0,9999,0
1667914811888,CSE 293,013,119232,Jhala; Ranjit,9999,0,9999,0
1667914811888,CSE 293,014,119233,Kahng; Andrew Byun,9999,0,9999,0
1667914811888,CSE 293,015,119298,Kane; Daniel Mertz,9999,0,9999,0
1667914811888,CSE 293,016,119299,Kriegman; David J,9999,0,9999,0
1667914811888,CSE 293,017,119300,Kumar; Arun Kumar,9999,0,9999,0
1667914811888,CSE 293,018,119301,Lerner; Sorin,9999,0,9999,0
1667914811888,CSE 293,019,119302,Lovett; Shachar,9999,0,9999,0
1667914811888,CSE 293,020,119303,McAuley; Julian John,9999,0,9999,0
1667914811888,CSE 293,021,119304,Micciancio; Daniele,9999,0,9999,0
1667914811888,CSE 293,022,119367,Orailoglu; Alex,9999,0,9999,0
1667914811888,CSE 293,023,119382,Paturi; Ramamohan,9999,0,9999,0
1667914811888,CSE 293,024,119404,Polikarpova; Nadezhda,9999,0,9999,0
1667914811888,CSE 293,025,119406,Politz; Joseph Gibbs,9999,0,9999,0
1667914811888,CSE 293,026,119411,Porter; George M,9999,0,9999,0
1667914811888,CSE 293,027,119414,Porter; Leonard Emerson,9999,0,9999,0
1667914811888,CSE 293,028,119416,Ramamoorthi; Ravi,9999,0,9999,0
1667914811888,CSE 293,029,119417,Sahoo; Debashis,9999,0,9999,0
1667914811888,CSE 293,030,119420,Saul; Lawrence,9999,0,9999,0
1667914811888,CSE 293,031,119421,Savage; Stefan,9999,0,9999,0
1667914811888,CSE 293,032,119425,Schulze; Jurgen P.,9999,0,9999,0
1667914811888,CSE 293,033,119426,Snoeren; Alex C.,9999,0,9999,0
1667914811888,CSE 293,034,119428,Shang; Jingbo,9999,0,9999,0
1667914811888,CSE 293,035,119430,Stefan; Deian,9999,0,9999,0
1667914811888,CSE 293,036,119431,Su; Hao,9999,0,9999,0
1667914811888,CSE 293,037,119433,Swanson; Steven James,9999,0,9999,0
1667914811888,CSE 293,038,119435,Tullsen; Dean Michael,9999,0,9999,0
1667914811888,CSE 293,039,119483,Voelker; Geoffrey M.,9999,0,9999,0
1667914811888,CSE 293,040,119537,Zhao; Jishen,9999,0,9999,0
1667914811888,CSE 293,041,119538,Zhou; Yuan-Yuan,9999,0,9999,0
1667914811888,CSE 293,042,119539,Gao; Sicun,9999,0,9999,0
1667914811888,CSE 293,043,119540,Weibel; Nadir,9999,0,9999,0
1667914811888,CSE 293,044,119541,Gupta; Rajesh K.,9999,0,9999,0
1667914812318,CSE 294,A00,102459,Voelker; Geoffrey M.,0,0,0,0
1667914812318,CSE 294,B00,111322,Orailoglu; Alex,0,0,0,0
1667914812755,DSE 201,A00,096914,Deutsch; Alin Bernard,30,0,30,0
1667914813191,DSE 210,A00,096915,Dasgupta; Sanjoy,30,0,30,0
1667914813619,DSE 260A,A00,096916,Altintas De Callaf; Ilkay,30,0,30,0
1667914814113,ECE 200,001,103586,Antipa; Nicholas A,9999,0,9999,0
1667914814113,ECE 200,002,103587,Atanasov; Nikolay A.,9999,0,9999,0
1667914814113,ECE 200,003,103588,Bharadia; Dinesh,9999,0,9999,0
1667914814113,ECE 200,004,103589,Cheng; Chung Kuan,9999,0,9999,0
1667914814113,ECE 200,005,103590,Cosman; Pamela C.,9999,0,9999,0
1667914814113,ECE 200,006,103591,Dayeh; Shadi Ahmad,9999,0,9999,0
1667914814113,ECE 200,007,103592,Fainman; Yeshaiahu,9999,0,9999,0
1667914814113,ECE 200,008,103593,Ford; Joseph Earl,9999,0,9999,0
1667914814113,ECE 200,009,103594,Franceschetti; Massimo,9999,0,9999,0
1667914814113,ECE 200,010,103595,Fullerton; Eric E,9999,0,9999,0
1667914814113,ECE 200,011,103596,Galton; Ian A,9999,0,9999,0
1667914814113,ECE 200,012,103597,Gilja; Vikash,9999,0,9999,0
1667914814113,ECE 200,013,103598,Hall; Drew A.,9999,0,9999,0
1667914814113,ECE 200,014,103599,Hsueh; Tzu-Chien,9999,0,9999,0
1667914814113,ECE 200,015,103600,Javidi; Tara,9999,0,9999,0
1667914814113,ECE 200,016,103601,Kahng; Andrew Byun,9999,0,9999,0
1667914814113,ECE 200,017,103602,Kim; Young-Han,9999,0,9999,0
1667914814113,ECE 200,018,103603,Koushanfar; Farinaz,9999,0,9999,0
1667914814113,ECE 200,019,103604,Kuzum; Duygu,9999,0,9999,0
1667914814113,ECE 200,020,103605,Le; Hanh-Phuc,9999,0,9999,0
1667914814113,ECE 200,021,103606,Lin; Bill,9999,0,9999,0
1667914814113,ECE 200,022,103607,Liu; Zhaowei,9998,0,9999,1
1667914814113,ECE 200,023,103608,Lo; Yu-Hwa,9999,0,9999,0
1667914814113,ECE 200,024,103609,Lomakin; Vitaliy,9999,0,9999,0
1667914814113,ECE 200,025,103610,Mercier; Patrick Philip,9999,0,9999,0
1667914814113,ECE 200,026,103611,Meyer; Florian,9999,0,9999,0
1667914814113,ECE 200,027,103612,Milstein; Laurence B.,9999,0,9999,0
1667914814113,ECE 200,028,103613,Mir Arabbaygi; Siavash,9999,0,9999,0
1667914814113,ECE 200,029,103614,Mookherjea; Shayan,9999,0,9999,0
1667914814113,ECE 200,030,103615,Morris; Karcher William,9999,0,9999,0
1667914814113,ECE 200,031,103616,Ng; Tse Nga,9999,0,9999,0
1667914814113,ECE 200,032,103617,Nguyen; Truong Quang,9999,0,9999,0
1667914814113,ECE 200,033,103618,Nomura; Kenji,9999,0,9999,0
1667914814113,ECE 200,034,103619,Orlitsky; Alon,9999,0,9999,0
1667914814113,ECE 200,035,103620,Pal; Piya,9999,0,9999,0
1667914814113,ECE 200,036,103621,Papen; George C.,9999,0,9999,0
1667914814113,ECE 200,037,103622,Radic; Stojan,9999,0,9999,0
1667914814113,ECE 200,038,103623,Rao; Bhaskar D.,9999,0,9999,0
1667914814113,ECE 200,039,103624,Rao; Ramesh R,9999,0,9999,0
1667914814113,ECE 200,040,103625,Rebeiz; Gabriel,9999,0,9999,0
1667914814113,ECE 200,041,103626,Sanford; John R,9999,0,9999,0
1667914814113,ECE 200,042,103627,Siegel; Paul H.,9999,0,9999,0
1667914814113,ECE 200,043,103628,Sievenpiper; Daniel F.,9999,0,9999,0
1667914814113,ECE 200,044,103629,Sworder; David D.,9999,0,9999,0
1667914814113,ECE 200,045,103630,Taur; Yuan,9999,0,9999,0
1667914814113,ECE 200,046,103631,Touri; Behrouz,9999,0,9999,0
1667914814113,ECE 200,047,103632,Trivedi; Mohan M.,9999,0,9999,0
1667914814113,ECE 200,048,103633,Vasconcelos; Nuno,9999,0,9999,0
1667914814113,ECE 200,049,103634,Wang; Xiaolong,9999,0,9999,0
1667914814113,ECE 200,050,103635,Xie; Pengtao,9999,0,9999,0
1667914814113,ECE 200,051,103636,Yip; Michael,9999,0,9999,0
1667914814113,ECE 200,052,103637,Zeger; Kenneth A.,999,0,999,0
1667914814113,ECE 200,053,103638,Zhang; Xinyu,9999,0,9999,0
1667914814113,ECE 200,054,103639,Turakhia; Yatish Girish,9999,0,9999,0
1667914814113,ECE 200,055,103640,Kang; Mingu,9999,0,9999,0
1667914814113,ECE 200,056,103641,Shi; Yuanyuan,9999,0,9999,0
1667914814113,ECE 200,057,103642,Wang; Edward Jay,9999,0,9999,0
1667914814113,ECE 200,058,103643,Zheng; Yang,9999,0,9999,0
1667914814541,ECE 202,A00,103644,Kuzum; Duygu,0,0,0,0
1667914814968,ECE 212BN,A00,103646,Ng; Tse Nga,0,0,0,0
1667914815415,ECE 221,A00,111493,Staff,0,0,0,0
1667914815847,ECE 222B,A00,103647,Lomakin; Vitaliy,0,0,0,0
1667914816278,ECE 230B,A00,103648,Taur; Yuan,0,0,0,0
1667914816709,ECE 238B,A00,103649,Garay; Javier,0,0,0,0
1667914817145,ECE 240B,A00,112900,Fainman; Yeshaiahu,0,0,0,0
1667914817585,ECE 247A,A00,103650,Jokerst; Jesse Vincent,0,0,0,0
1667914818016,ECE 247B,A00,103651,Wang; Joseph,0,0,0,0
1667914818450,ECE 250,A00,103652,Siegel; Paul H.,0,0,0,0
1667914818880,ECE 251A,A00,103654,Rao; Bhaskar D.,0,0,0,0
1667914819404,ECE 257B,A00,103655,Bharadia; Dinesh,0,0,0,0
1667914819832,ECE 258A,A00,103656,Milstein; Laurence B.,0,0,0,0
1667914820273,ECE 260B,A00,103658,Kang; Mingu,0,0,0,0
1667914820709,ECE 264A,A00,103659,Galton; Ian A,0,0,0,0
1667914821148,ECE 265A,A00,103661,Gudem; Prasad S.S.,0,0,0,0
1667914821581,ECE 265D,A00,103662,Gudem; Prasad S.S.,0,0,0,0
1667914822020,ECE 268,A00,103663,Koushanfar; Farinaz,0,0,0,0
1667914822458,ECE 269,A01,103665,Pal; Piya,0,0,0,0
1667914822896,ECE 271B,A00,103666,Vasconcelos; Manuela,0,0,0,0
1667914823341,ECE 276A,A00,103667,Atanasov; Nikolay A.,0,0,0,0
1667914823789,ECE 277,A00,103668,An; Cheolhong,0,0,0,0
1667914824230,ECE 279,A00,117947,Hall; Drew A.,0,0,0,0
1667914825097,ECE 283,A00,103670,Hsueh; Tzu-Chien,0,0,0,0
1667914825526,ECE 284,A00,103671,Turakhia; Yatish Girish,0,0,0,0
1667914825976,ECE 285,A00,103672,Zheng; Yang,0,0,0,0
1667914825976,ECE 285,B00,103673,Sworder; David D.,0,0,0,0
1667914826411,ECE 287,A00,103676,Javidi; Tara,0,0,0,0
1667914826850,MATH 200B,A00,098023,Salehi Golsefidy; Alireza,15,0,15,0
1667914827280,MATH 202B,A00,098024,Rhoades; Brendon Patrick,14,0,15,1
1667914827724,MATH 203B,A00,098025,Oprea; Dragos N.,14,0,15,1
1667914828174,MATH 204B,A00,098026,Sorensen; Claus M,15,0,15,0
1667914828612,MATH 208,A00,098027,Izadi; Elham,7,0,10,3
1667914829042,MATH 209,A00,098028,Pollack; Aaron,10,0,10,0
1667914829476,MATH 211A,A00,112919,Rogalski; Daniel,10,0,10,0
1667914829915,MATH 211B,A00,112920,Seward; Brandon M.,10,0,10,0
1667914830346,MATH 218,A00,098029,Li; Bo,10,0,10,0
1667914830777,MATH 220B,A00,098030,Novak; Jonathan I,15,0,15,0
1667914831203,MATH 221A,A00,098031,Ebenfelt; Peter F,15,0,15,0
1667914831634,MATH 231B,A00,098032,Zlatos; Andrej,15,0,15,0
1667914832066,MATH 240B,A00,098033,Ni; Lei,13,0,15,2
1667914832500,MATH 243,A00,098034,Jekel; David Andrew,10,0,10,0
1667914832938,MATH 245A,A00,098035,Nie; Jiawang,6,0,15,9
1667914833374,MATH 248,A00,098036,Bejenaru; Ioan,10,0,10,0
1667914833804,MATH 250B,A00,098037,Spolaor; Luca,14,0,15,1
1667914834256,MATH 258,A00,098038,Ni; Lei,10,0,10,0
1667914834695,MATH 264B,A00,098041,Rhoades; Brendon Patrick,13,0,15,2
1667914835120,MATH 268,A00,098042,Buss; Samuel R,10,0,10,0
1667914835549,MATH 269,A00,098043,Rhoades; Brendon Patrick,10,0,10,0
1667914835979,MATH 270B,A00,098044,Li; Bo,13,0,15,2
1667914836409,MATH 272B,A00,098045,Holst; Michael J,13,0,15,2
1667914836860,MATH 273A,A00,098046,Tian; Xiaochuan,12,0,15,3
1667914837289,MATH 275,A01,098048,Tian; Xiaochuan,7,0,10,3
1667914837724,MATH 278A,A00,098049,Holst; Michael J,8,0,10,2
1667914838158,MATH 278B,A00,098050,Cloninger; Alexander,10,0,10,0
1667914838581,MATH 278C,A00,098051,Nie; Jiawang,9,0,10,1
1667914839008,MATH 280B,A00,098052,Zheng; Tianyi,12,0,15,3
1667914839436,MATH 281B,A00,098053,Bradic; Jelena,6,0,15,9
1667914839878,MATH 282B,A00,098054,Arias-Castro; Ery,2,0,15,13
1667914840320,MATH 285,A00,098055,Fitzsimmons; Patrick J,3,0,15,12
1667914840745,MATH 287B,A00,098056,Arias-Castro; Ery,9,0,15,6
1667914841177,MATH 288,A00,098057,Agarwal; Pooja,9,0,10,1
1667914841177,MATH 288,B00,098058,Zhang; Danna,9,0,10,1
1667914841177,MATH 288,C00,098059,Williams; Ruth J,10,0,10,0
1667914841612,MATH 290B,A00,098060,Roberts; Justin Deritter,14,0,15,1
1667914842046,MATH 292,A00,098061,Belmont; Eva Kinoshita,10,0,10,0
1667914842474,MATH 295,A00,098062,Suk; Andrew Hoon,48,0,50,2
1667914842901,MATH 296,A00,098063,Novak; Jonathan I,20,0,20,0
1667914843327,MATH 297,001,098064,Gamst; Anthony Collins,9997,0,9999,2
1667915353078,COGS 205,A00,101395,Chiba; Andrea,20,0,20,0
1667915353516,COGS 210B,001,101404,Greene; Deanna Jacquelyn,9998,0,9999,1
1667915353516,COGS 210B,002,101417,Xia; Haijun,9999,0,9999,0
1667915353516,COGS 210B,003,101422,Nitz; Douglas A.,9999,0,9999,0
1667915353516,COGS 210B,004,101423,Hollan; James D.,9998,0,9999,1
1667915353516,COGS 210B,005,101424,Deak; Gedeon O.,9999,0,9999,0
1667915353516,COGS 210B,006,101425,Rossano; Federico,9999,0,9999,0
1667915353948,COGS 211B,A00,101427,Coulson; Seana M,9997,0,9999,2
1667915354389,COGS 220,A00,101428,Hollan; James D.,0,0,25,25
1667915354830,COGS 229,A00,101429,Dow; Steven P,19,0,25,6
1667915355254,COGS 230,A00,101430,Klemmer; Scott R,13,0,17,4
1667915355695,COGS 234,A00,101431,Xia; Haijun,11,0,25,14
1667915356127,COGS 260,A00,101432,Kiyonaga; Anastasia,20,0,25,5
1667915356127,COGS 260,B00,101433,Kirsh; David Joel,18,0,25,7
1667915356551,CSE 202,A00,102371,Impagliazzo; Russell,0,0,0,0
1667915357007,CSE 203B,A01,102373,Cheng; Chung Kuan,0,0,0,0
1667915357434,CSE 208,A00,102374,Micciancio; Daniele,0,0,0,0
1667915357869,CSE 209A,A00,112895,Impagliazzo; Russell,0,0,15,15
1667915358295,CSE 209B,A00,108005,Bellare; Mihir,0,0,0,0
1667915358737,CSE 210,A00,113163,Coblenz; Michael J,0,0,0,0
1667915359169,CSE 219,A00,106111,Dow; Steven P,0,0,20,20
1667915359594,CSE 221,A00,102376,Voelker; Geoffrey M.,0,0,0,0
1667915360031,CSE 224,A01,102378,Porter; George M,0,0,0,0
1667915360464,CSE 229A,A00,102379,Savage; Stefan,0,0,0,0
1667915360896,CSE 229C,A00,102380,Munyaka; Imani N. S.,0,0,0,0
1667915361322,CSE 232B,A00,102382,Deutsch; Alin Bernard,0,0,0,0
1667915361758,CSE 234,A01,112904,Kumar; Arun Kumar,0,0,0,0
1667915362189,CSE 237A,A00,102383,Rosing; Tajana Simunic,0,0,0,0
1667915362624,CSE 239A,A00,102384,Deutsch; Alin Bernard,0,0,0,0
1667915363068,CSE 239B,A00,102385,Polikarpova; Nadezhda,0,0,0,0
1667915363504,CSE 240A,A00,102386,Pannuto; Patrick William,0,0,0,0
1667915363942,CSE 240B,A00,102387,Zhao; Jishen,0,0,0,0
1667915364385,CSE 241A,A00,106406,Kang; Mingu,0,0,0,0
1667915364831,CSE 249B,A00,102388,Kahng; Andrew Byun,0,0,8,8
1667915365263,CSE 251B,A01,102392,Cottrell; Garrison W,0,0,0,0
1667915365263,CSE 251B,A02,102393,Cottrell; Garrison W,0,0,0,0
1667915365688,CSE 252B,A00,102394,Ochoa; Benjamin Lawrence,0,0,0,0
1667915366137,CSE 257,A01,102396,Gao; Sicun,0,0,0,0
1667915366587,CSE 272,A00,102397,Li; Tzumao,0,0,0,0
1667915367017,CSE 274,A00,111323,Chern; Albert Ren-Haur,0,0,0,0
1667915367451,CSE 282,A00,102398,Pevzner; Pavel Arkadjevich,0,0,0,0
1667915367884,CSE 284,A00,114175,Gymrek; Melissa Ann,0,0,0,0
1667915368330,CSE 290,A00,102399,Chandraker; Manmohan Krishna,0,0,0,0
1667915368330,CSE 290,B00,102400,Vaccaro; Kristen Marie,0,0,25,25
1667915368330,CSE 290,C00,102414,Pannuto; Patrick William,0,0,25,25
1667915368330,CSE 290,D00,102427,Pevzner; Pavel Arkadjevich,0,0,0,0
1667915368330,CSE 290,E00,102429,Zhao; Jishen,0,0,0,0
1667915368330,CSE 290,F00,102436,Tullsen; Dean Michael,0,0,0,0
1667915368330,CSE 290,G00,102440,Christensen; Henrik I,0,0,20,20
1667915368757,CSE 291,A00,102443,Su; Hao,0,0,0,0
1667915368757,CSE 291,B00,102448,Polikarpova; Nadezhda,0,0,0,0
1667915368757,CSE 291,C00,102453,Vaccaro; Kristen Marie,0,0,0,0
1667915368757,CSE 291,D00,111343,Savage; Stefan,0,0,0,0
1667915368757,CSE 291,E00,116474,Claffy; Kimberly Claire,0,0,0,0
1667915368757,CSE 291,F00,116479,Pasquale; Joseph,0,0,0,0
1667915369199,CSE 293,001,119111,Bafna; Vineet,9999,0,9999,0
1667915369199,CSE 293,002,119118,Bellare; Mihir,9999,0,9999,0
1667915369199,CSE 293,003,119122,Berg-Kirkpatrick; Taylor D,9999,0,9999,0
1667915369199,CSE 293,004,119135,Christensen; Henrik I,9999,0,9999,0
1667915369199,CSE 293,005,119142,Cottrell; Garrison W,9999,0,9999,0
1667915369199,CSE 293,006,119146,Deutsch; Alin Bernard,9999,0,9999,0
1667915369199,CSE 293,007,119159,Esmaeilzadeh; Hadi,9999,0,9999,0
1667915369199,CSE 293,008,119166,Freund; Yoav,9999,0,9999,0
1667915369199,CSE 293,009,119170,Griswold; William G.,9999,0,9999,0
1667915369199,CSE 293,010,119183,Gymrek; Melissa Ann,9999,0,9999,0
1667915369199,CSE 293,011,119190,Heninger; Nadia A,9999,0,9999,0
1667915369199,CSE 293,012,119230,Impagliazzo; Russell,9999,0,9999,0
1667915369199,CSE 293,013,119232,Jhala; Ranjit,9999,0,9999,0
1667915369199,CSE 293,014,119233,Kahng; Andrew Byun,9999,0,9999,0
1667915369199,CSE 293,015,119298,Kane; Daniel Mertz,9999,0,9999,0
1667915369199,CSE 293,016,119299,Kriegman; David J,9999,0,9999,0
1667915369199,CSE 293,017,119300,Kumar; Arun Kumar,9999,0,9999,0
1667915369199,CSE 293,018,119301,Lerner; Sorin,9999,0,9999,0
1667915369199,CSE 293,019,119302,Lovett; Shachar,9999,0,9999,0
1667915369199,CSE 293,020,119303,McAuley; Julian John,9999,0,9999,0
1667915369199,CSE 293,021,119304,Micciancio; Daniele,9999,0,9999,0
1667915369199,CSE 293,022,119367,Orailoglu; Alex,9999,0,9999,0
1667915369199,CSE 293,023,119382,Paturi; Ramamohan,9999,0,9999,0
1667915369199,CSE 293,024,119404,Polikarpova; Nadezhda,9999,0,9999,0
1667915369199,CSE 293,025,119406,Politz; Joseph Gibbs,9999,0,9999,0
1667915369199,CSE 293,026,119411,Porter; George M,9999,0,9999,0
1667915369199,CSE 293,027,119414,Porter; Leonard Emerson,9999,0,9999,0
1667915369199,CSE 293,028,119416,Ramamoorthi; Ravi,9999,0,9999,0
1667915369199,CSE 293,029,119417,Sahoo; Debashis,9999,0,9999,0
1667915369199,CSE 293,030,119420,Saul; Lawrence,9999,0,9999,0
1667915369199,CSE 293,031,119421,Savage; Stefan,9999,0,9999,0
1667915369199,CSE 293,032,119425,Schulze; Jurgen P.,9999,0,9999,0
1667915369199,CSE 293,033,119426,Snoeren; Alex C.,9999,0,9999,0
1667915369199,CSE 293,034,119428,Shang; Jingbo,9999,0,9999,0
1667915369199,CSE 293,035,119430,Stefan; Deian,9999,0,9999,0
1667915369199,CSE 293,036,119431,Su; Hao,9999,0,9999,0
1667915369199,CSE 293,037,119433,Swanson; Steven James,9999,0,9999,0
1667915369199,CSE 293,038,119435,Tullsen; Dean Michael,9999,0,9999,0
1667915369199,CSE 293,039,119483,Voelker; Geoffrey M.,9999,0,9999,0
1667915369199,CSE 293,040,119537,Zhao; Jishen,9999,0,9999,0
1667915369199,CSE 293,041,119538,Zhou; Yuan-Yuan,9999,0,9999,0
1667915369199,CSE 293,042,119539,Gao; Sicun,9999,0,9999,0
1667915369199,CSE 293,043,119540,Weibel; Nadir,9999,0,9999,0
1667915369199,CSE 293,044,119541,Gupta; Rajesh K.,9999,0,9999,0
1667915369632,CSE 294,A00,102459,Voelker; Geoffrey M.,0,0,0,0
1667915369632,CSE 294,B00,111322,Orailoglu; Alex,0,0,0,0
1667915370058,DSE 201,A00,096914,Deutsch; Alin Bernard,30,0,30,0
1667915370502,DSE 210,A00,096915,Dasgupta; Sanjoy,30,0,30,0
1667915370943,DSE 260A,A00,096916,Altintas De Callaf; Ilkay,30,0,30,0
1667915371387,ECE 200,001,103586,Antipa; Nicholas A,9999,0,9999,0
1667915371387,ECE 200,002,103587,Atanasov; Nikolay A.,9999,0,9999,0
1667915371387,ECE 200,003,103588,Bharadia; Dinesh,9999,0,9999,0
1667915371387,ECE 200,004,103589,Cheng; Chung Kuan,9999,0,9999,0
1667915371387,ECE 200,005,103590,Cosman; Pamela C.,9999,0,9999,0
1667915371387,ECE 200,006,103591,Dayeh; Shadi Ahmad,9999,0,9999,0
1667915371387,ECE 200,007,103592,Fainman; Yeshaiahu,9999,0,9999,0
1667915371387,ECE 200,008,103593,Ford; Joseph Earl,9999,0,9999,0
1667915371387,ECE 200,009,103594,Franceschetti; Massimo,9999,0,9999,0
1667915371387,ECE 200,010,103595,Fullerton; Eric E,9999,0,9999,0
1667915371387,ECE 200,011,103596,Galton; Ian A,9999,0,9999,0
1667915371387,ECE 200,012,103597,Gilja; Vikash,9999,0,9999,0
1667915371387,ECE 200,013,103598,Hall; Drew A.,9999,0,9999,0
1667915371387,ECE 200,014,103599,Hsueh; Tzu-Chien,9999,0,9999,0
1667915371387,ECE 200,015,103600,Javidi; Tara,9999,0,9999,0
1667915371387,ECE 200,016,103601,Kahng; Andrew Byun,9999,0,9999,0
1667915371387,ECE 200,017,103602,Kim; Young-Han,9999,0,9999,0
1667915371387,ECE 200,018,103603,Koushanfar; Farinaz,9999,0,9999,0
1667915371387,ECE 200,019,103604,Kuzum; Duygu,9999,0,9999,0
1667915371387,ECE 200,020,103605,Le; Hanh-Phuc,9999,0,9999,0
1667915371387,ECE 200,021,103606,Lin; Bill,9999,0,9999,0
1667915371387,ECE 200,022,103607,Liu; Zhaowei,9998,0,9999,1
1667915371387,ECE 200,023,103608,Lo; Yu-Hwa,9999,0,9999,0
1667915371387,ECE 200,024,103609,Lomakin; Vitaliy,9999,0,9999,0
1667915371387,ECE 200,025,103610,Mercier; Patrick Philip,9999,0,9999,0
1667915371387,ECE 200,026,103611,Meyer; Florian,9999,0,9999,0
1667915371387,ECE 200,027,103612,Milstein; Laurence B.,9999,0,9999,0
1667915371387,ECE 200,028,103613,Mir Arabbaygi; Siavash,9999,0,9999,0
1667915371387,ECE 200,029,103614,Mookherjea; Shayan,9999,0,9999,0
1667915371387,ECE 200,030,103615,Morris; Karcher William,9999,0,9999,0
1667915371387,ECE 200,031,103616,Ng; Tse Nga,9999,0,9999,0
1667915371387,ECE 200,032,103617,Nguyen; Truong Quang,9999,0,9999,0
1667915371387,ECE 200,033,103618,Nomura; Kenji,9999,0,9999,0
1667915371387,ECE 200,034,103619,Orlitsky; Alon,9999,0,9999,0
1667915371387,ECE 200,035,103620,Pal; Piya,9999,0,9999,0
1667915371387,ECE 200,036,103621,Papen; George C.,9999,0,9999,0
1667915371387,ECE 200,037,103622,Radic; Stojan,9999,0,9999,0
1667915371387,ECE 200,038,103623,Rao; Bhaskar D.,9999,0,9999,0
1667915371387,ECE 200,039,103624,Rao; Ramesh R,9999,0,9999,0
1667915371387,ECE 200,040,103625,Rebeiz; Gabriel,9999,0,9999,0
1667915371387,ECE 200,041,103626,Sanford; John R,9999,0,9999,0
1667915371387,ECE 200,042,103627,Siegel; Paul H.,9999,0,9999,0
1667915371387,ECE 200,043,103628,Sievenpiper; Daniel F.,9999,0,9999,0
1667915371387,ECE 200,044,103629,Sworder; David D.,9999,0,9999,0
1667915371387,ECE 200,045,103630,Taur; Yuan,9999,0,9999,0
1667915371387,ECE 200,046,103631,Touri; Behrouz,9999,0,9999,0
1667915371387,ECE 200,047,103632,Trivedi; Mohan M.,9999,0,9999,0
1667915371387,ECE 200,048,103633,Vasconcelos; Nuno,9999,0,9999,0
1667915371387,ECE 200,049,103634,Wang; Xiaolong,9999,0,9999,0
1667915371387,ECE 200,050,103635,Xie; Pengtao,9999,0,9999,0
1667915371387,ECE 200,051,103636,Yip; Michael,9999,0,9999,0
1667915371387,ECE 200,052,103637,Zeger; Kenneth A.,999,0,999,0
1667915371387,ECE 200,053,103638,Zhang; Xinyu,9999,0,9999,0
1667915371387,ECE 200,054,103639,Turakhia; Yatish Girish,9999,0,9999,0
1667915371387,ECE 200,055,103640,Kang; Mingu,9999,0,9999,0
1667915371387,ECE 200,056,103641,Shi; Yuanyuan,9999,0,9999,0
1667915371387,ECE 200,057,103642,Wang; Edward Jay,9999,0,9999,0
1667915371387,ECE 200,058,103643,Zheng; Yang,9999,0,9999,0
1667915371826,ECE 202,A00,103644,Kuzum; Duygu,0,0,0,0
1667915372258,ECE 212BN,A00,103646,Ng; Tse Nga,0,0,0,0
1667915372699,ECE 221,A00,111493,Staff,0,0,0,0
1667915373131,ECE 222B,A00,103647,Lomakin; Vitaliy,0,0,0,0
1667915373564,ECE 230B,A00,103648,Taur; Yuan,0,0,0,0
1667915374036,ECE 238B,A00,103649,Garay; Javier,0,0,0,0
1667915374467,ECE 240B,A00,112900,Fainman; Yeshaiahu,0,0,0,0
1667915374896,ECE 247A,A00,103650,Jokerst; Jesse Vincent,0,0,0,0
1667915375321,ECE 247B,A00,103651,Wang; Joseph,0,0,0,0
1667915375749,ECE 250,A00,103652,Siegel; Paul H.,0,0,0,0
1667915376176,ECE 251A,A00,103654,Rao; Bhaskar D.,0,0,0,0
1667915376605,ECE 257B,A00,103655,Bharadia; Dinesh,0,0,0,0
1667915377029,ECE 258A,A00,103656,Milstein; Laurence B.,0,0,0,0
1667915377483,ECE 260B,A00,103658,Kang; Mingu,0,0,0,0
1667915377937,ECE 264A,A00,103659,Galton; Ian A,0,0,0,0
1667915378363,ECE 265A,A00,103661,Gudem; Prasad S.S.,0,0,0,0
1667915378787,ECE 265D,A00,103662,Gudem; Prasad S.S.,0,0,0,0
1667915379212,ECE 268,A00,103663,Koushanfar; Farinaz,0,0,0,0
1667915379636,ECE 269,A01,103665,Pal; Piya,0,0,0,0
1667915380061,ECE 271B,A00,103666,Vasconcelos; Manuela,0,0,0,0
1667915380491,ECE 276A,A00,103667,Atanasov; Nikolay A.,0,0,0,0
1667915380924,ECE 277,A00,103668,An; Cheolhong,0,0,0,0
1667915381355,ECE 279,A00,117947,Hall; Drew A.,0,0,0,0
1667915382210,ECE 283,A00,103670,Hsueh; Tzu-Chien,0,0,0,0
1667915382637,ECE 284,A00,103671,Turakhia; Yatish Girish,0,0,0,0
1667915383070,ECE 285,A00,103672,Zheng; Yang,0,0,0,0
1667915383070,ECE 285,B00,103673,Sworder; David D.,0,0,0,0
1667915383510,ECE 287,A00,103676,Javidi; Tara,0,0,0,0
1667915383941,MATH 200B,A00,098023,Salehi Golsefidy; Alireza,15,0,15,0
1667915384368,MATH 202B,A00,098024,Rhoades; Brendon Patrick,14,0,15,1
1667915384801,MATH 203B,A00,098025,Oprea; Dragos N.,14,0,15,1
1667915385237,MATH 204B,A00,098026,Sorensen; Claus M,15,0,15,0
1667915385661,MATH 208,A00,098027,Izadi; Elham,7,0,10,3
1667915386100,MATH 209,A00,098028,Pollack; Aaron,10,0,10,0
1667915386529,MATH 211A,A00,112919,Rogalski; Daniel,10,0,10,0
1667915386957,MATH 211B,A00,112920,Seward; Brandon M.,10,0,10,0
1667915387381,MATH 218,A00,098029,Li; Bo,10,0,10,0
1667915387818,MATH 220B,A00,098030,Novak; Jonathan I,15,0,15,0
1667915388251,MATH 221A,A00,098031,Ebenfelt; Peter F,15,0,15,0
1667915388692,MATH 231B,A00,098032,Zlatos; Andrej,15,0,15,0
1667915389119,MATH 240B,A00,098033,Ni; Lei,13,0,15,2
1667915389553,MATH 243,A00,098034,Jekel; David Andrew,10,0,10,0
1667915389987,MATH 245A,A00,098035,Nie; Jiawang,6,0,15,9
1667915390411,MATH 248,A00,098036,Bejenaru; Ioan,10,0,10,0
1667915390842,MATH 250B,A00,098037,Spolaor; Luca,14,0,15,1
1667915391313,MATH 258,A00,098038,Ni; Lei,10,0,10,0
1667915391742,MATH 264B,A00,098041,Rhoades; Brendon Patrick,13,0,15,2
1667915392181,MATH 268,A00,098042,Buss; Samuel R,10,0,10,0
1667915392614,MATH 269,A00,098043,Rhoades; Brendon Patrick,10,0,10,0
1667915393042,MATH 270B,A00,098044,Li; Bo,13,0,15,2
1667915393550,MATH 272B,A00,098045,Holst; Michael J,13,0,15,2
1667915393986,MATH 273A,A00,098046,Tian; Xiaochuan,12,0,15,3
1667915394412,MATH 275,A01,098048,Tian; Xiaochuan,7,0,10,3
1667915394847,MATH 278A,A00,098049,Holst; Michael J,8,0,10,2
1667915395280,MATH 278B,A00,098050,Cloninger; Alexander,10,0,10,0
1667915395707,MATH 278C,A00,098051,Nie; Jiawang,9,0,10,1
1667915396142,MATH 280B,A00,098052,Zheng; Tianyi,12,0,15,3
1667915396576,MATH 281B,A00,098053,Bradic; Jelena,6,0,15,9
1667915397007,MATH 282B,A00,098054,Arias-Castro; Ery,2,0,15,13
1667915397443,MATH 285,A00,098055,Fitzsimmons; Patrick J,3,0,15,12
1667915397898,MATH 287B,A00,098056,Arias-Castro; Ery,9,0,15,6
1667915398336,MATH 288,A00,098057,Agarwal; Pooja,9,0,10,1
1667915398336,MATH 288,B00,098058,Zhang; Danna,9,0,10,1
1667915398336,MATH 288,C00,098059,Williams; Ruth J,10,0,10,0
1667915398760,MATH 290B,A00,098060,Roberts; Justin Deritter,14,0,15,1
1667915399196,MATH 292,A00,098061,Belmont; Eva Kinoshita,10,0,10,0
1667915399621,MATH 295,A00,098062,Suk; Andrew Hoon,48,0,50,2
1667915400049,MATH 296,A00,098063,Novak; Jonathan I,20,0,20,0
1667915400491,MATH 297,001,098064,Gamst; Anthony Collins,9997,0,9999,2
1667915913933,COGS 205,A00,101395,Chiba; Andrea,20,0,20,0
1667915914373,COGS 210B,001,101404,Greene; Deanna Jacquelyn,9998,0,9999,1
1667915914373,COGS 210B,002,101417,Xia; Haijun,9999,0,9999,0
1667915914373,COGS 210B,003,101422,Nitz; Douglas A.,9999,0,9999,0
1667915914373,COGS 210B,004,101423,Hollan; James D.,9998,0,9999,1
1667915914373,COGS 210B,005,101424,Deak; Gedeon O.,9999,0,9999,0
1667915914373,COGS 210B,006,101425,Rossano; Federico,9999,0,9999,0
1667915914822,COGS 211B,A00,101427,Coulson; Seana M,9997,0,9999,2
1667915915266,COGS 220,A00,101428,Hollan; James D.,0,0,25,25
1667915915714,COGS 229,A00,101429,Dow; Steven P,19,0,25,6
1667915916147,COGS 230,A00,101430,Klemmer; Scott R,13,0,17,4
1667915916576,COGS 234,A00,101431,Xia; Haijun,11,0,25,14
1667915917011,COGS 260,A00,101432,Kiyonaga; Anastasia,20,0,25,5
1667915917011,COGS 260,B00,101433,Kirsh; David Joel,18,0,25,7
1667915917438,CSE 202,A00,102371,Impagliazzo; Russell,0,0,0,0
1667915917867,CSE 203B,A01,102373,Cheng; Chung Kuan,0,0,0,0
1667915918292,CSE 208,A00,102374,Micciancio; Daniele,0,0,0,0
1667915918724,CSE 209A,A00,112895,Impagliazzo; Russell,0,0,15,15
1667915919149,CSE 209B,A00,108005,Bellare; Mihir,0,0,0,0
1667915919591,CSE 210,A00,113163,Coblenz; Michael J,0,0,0,0
1667915920029,CSE 219,A00,106111,Dow; Steven P,0,0,20,20
1667915920468,CSE 221,A00,102376,Voelker; Geoffrey M.,0,0,0,0
1667915920904,CSE 224,A01,102378,Porter; George M,0,0,0,0
1667915921333,CSE 229A,A00,102379,Savage; Stefan,0,0,0,0
1667915921762,CSE 229C,A00,102380,Munyaka; Imani N. S.,0,0,0,0
1667915922190,CSE 232B,A00,102382,Deutsch; Alin Bernard,0,0,0,0
1667915922638,CSE 234,A01,112904,Kumar; Arun Kumar,0,0,0,0
1667915923066,CSE 237A,A00,102383,Rosing; Tajana Simunic,0,0,0,0
1667915923503,CSE 239A,A00,102384,Deutsch; Alin Bernard,0,0,0,0
1667915923946,CSE 239B,A00,102385,Polikarpova; Nadezhda,0,0,0,0
1667915924387,CSE 240A,A00,102386,Pannuto; Patrick William,0,0,0,0
1667915924840,CSE 240B,A00,102387,Zhao; Jishen,0,0,0,0
1667915925273,CSE 241A,A00,106406,Kang; Mingu,0,0,0,0
1667915925714,CSE 249B,A00,102388,Kahng; Andrew Byun,0,0,8,8
1667915926171,CSE 251B,A01,102392,Cottrell; Garrison W,0,0,0,0
1667915926171,CSE 251B,A02,102393,Cottrell; Garrison W,0,0,0,0
1667915926603,CSE 252B,A00,102394,Ochoa; Benjamin Lawrence,0,0,0,0
1667915927027,CSE 257,A01,102396,Gao; Sicun,0,0,0,0
1667915927536,CSE 272,A00,102397,Li; Tzumao,0,0,0,0
1667915927979,CSE 274,A00,111323,Chern; Albert Ren-Haur,0,0,0,0
1667915928409,CSE 282,A00,102398,Pevzner; Pavel Arkadjevich,0,0,0,0
1667915928845,CSE 284,A00,114175,Gymrek; Melissa Ann,0,0,0,0
1667915929271,CSE 290,A00,102399,Chandraker; Manmohan Krishna,0,0,0,0
1667915929271,CSE 290,B00,102400,Vaccaro; Kristen Marie,0,0,25,25
1667915929271,CSE 290,C00,102414,Pannuto; Patrick William,0,0,25,25
1667915929271,CSE 290,D00,102427,Pevzner; Pavel Arkadjevich,0,0,0,0
1667915929271,CSE 290,E00,102429,Zhao; Jishen,0,0,0,0
1667915929271,CSE 290,F00,102436,Tullsen; Dean Michael,0,0,0,0
1667915929271,CSE 290,G00,102440,Christensen; Henrik I,0,0,20,20
1667915929701,CSE 291,A00,102443,Su; Hao,0,0,0,0
1667915929701,CSE 291,B00,102448,Polikarpova; Nadezhda,0,0,0,0
1667915929701,CSE 291,C00,102453,Vaccaro; Kristen Marie,0,0,0,0
1667915929701,CSE 291,D00,111343,Savage; Stefan,0,0,0,0
1667915929701,CSE 291,E00,116474,Claffy; Kimberly Claire,0,0,0,0
1667915929701,CSE 291,F00,116479,Pasquale; Joseph,0,0,0,0
1667915930183,CSE 293,001,119111,Bafna; Vineet,9999,0,9999,0
1667915930183,CSE 293,002,119118,Bellare; Mihir,9999,0,9999,0
1667915930183,CSE 293,003,119122,Berg-Kirkpatrick; Taylor D,9999,0,9999,0
1667915930183,CSE 293,004,119135,Christensen; Henrik I,9999,0,9999,0
1667915930183,CSE 293,005,119142,Cottrell; Garrison W,9999,0,9999,0
1667915930183,CSE 293,006,119146,Deutsch; Alin Bernard,9999,0,9999,0
1667915930183,CSE 293,007,119159,Esmaeilzadeh; Hadi,9999,0,9999,0
1667915930183,CSE 293,008,119166,Freund; Yoav,9999,0,9999,0
1667915930183,CSE 293,009,119170,Griswold; William G.,9999,0,9999,0
1667915930183,CSE 293,010,119183,Gymrek; Melissa Ann,9999,0,9999,0
1667915930183,CSE 293,011,119190,Heninger; Nadia A,9999,0,9999,0
1667915930183,CSE 293,012,119230,Impagliazzo; Russell,9999,0,9999,0
1667915930183,CSE 293,013,119232,Jhala; Ranjit,9999,0,9999,0
1667915930183,CSE 293,014,119233,Kahng; Andrew Byun,9999,0,9999,0
1667915930183,CSE 293,015,119298,Kane; Daniel Mertz,9999,0,9999,0
1667915930183,CSE 293,016,119299,Kriegman; David J,9999,0,9999,0
1667915930183,CSE 293,017,119300,Kumar; Arun Kumar,9999,0,9999,0
1667915930183,CSE 293,018,119301,Lerner; Sorin,9999,0,9999,0
1667915930183,CSE 293,019,119302,Lovett; Shachar,9999,0,9999,0
1667915930183,CSE 293,020,119303,McAuley; Julian John,9999,0,9999,0
1667915930183,CSE 293,021,119304,Micciancio; Daniele,9999,0,9999,0
1667915930183,CSE 293,022,119367,Orailoglu; Alex,9999,0,9999,0
1667915930183,CSE 293,023,119382,Paturi; Ramamohan,9999,0,9999,0
1667915930183,CSE 293,024,119404,Polikarpova; Nadezhda,9999,0,9999,0
1667915930183,CSE 293,025,119406,Politz; Joseph Gibbs,9999,0,9999,0
1667915930183,CSE 293,026,119411,Porter; George M,9999,0,9999,0
1667915930183,CSE 293,027,119414,Porter; Leonard Emerson,9999,0,9999,0
1667915930183,CSE 293,028,119416,Ramamoorthi; Ravi,9999,0,9999,0
1667915930183,CSE 293,029,119417,Sahoo; Debashis,9999,0,9999,0
1667915930183,CSE 293,030,119420,Saul; Lawrence,9999,0,9999,0
1667915930183,CSE 293,031,119421,Savage; Stefan,9999,0,9999,0
1667915930183,CSE 293,032,119425,Schulze; Jurgen P.,9999,0,9999,0
1667915930183,CSE 293,033,119426,Snoeren; Alex C.,9999,0,9999,0
1667915930183,CSE 293,034,119428,Shang; Jingbo,9999,0,9999,0
1667915930183,CSE 293,035,119430,Stefan; Deian,9999,0,9999,0
1667915930183,CSE 293,036,119431,Su; Hao,9999,0,9999,0
1667915930183,CSE 293,037,119433,Swanson; Steven James,9999,0,9999,0
1667915930183,CSE 293,038,119435,Tullsen; Dean Michael,9999,0,9999,0
1667915930183,CSE 293,039,119483,Voelker; Geoffrey M.,9999,0,9999,0
1667915930183,CSE 293,040,119537,Zhao; Jishen,9999,0,9999,0
1667915930183,CSE 293,041,119538,Zhou; Yuan-Yuan,9999,0,9999,0
1667915930183,CSE 293,042,119539,Gao; Sicun,9999,0,9999,0
1667915930183,CSE 293,043,119540,Weibel; Nadir,9999,0,9999,0
1667915930183,CSE 293,044,119541,Gupta; Rajesh K.,9999,0,9999,0
1667915930618,CSE 294,A00,102459,Voelker; Geoffrey M.,0,0,0,0
1667915930618,CSE 294,B00,111322,Orailoglu; Alex,0,0,0,0
1667915931090,DSE 201,A00,096914,Deutsch; Alin Bernard,30,0,30,0
1667915931515,DSE 210,A00,096915,Dasgupta; Sanjoy,30,0,30,0
1667915931954,DSE 260A,A00,096916,Altintas De Callaf; Ilkay,30,0,30,0
1667915932396,ECE 200,001,103586,Antipa; Nicholas A,9999,0,9999,0
1667915932396,ECE 200,002,103587,Atanasov; Nikolay A.,9999,0,9999,0
1667915932396,ECE 200,003,103588,Bharadia; Dinesh,9999,0,9999,0
1667915932396,ECE 200,004,103589,Cheng; Chung Kuan,9999,0,9999,0
1667915932396,ECE 200,005,103590,Cosman; Pamela C.,9999,0,9999,0
1667915932396,ECE 200,006,103591,Dayeh; Shadi Ahmad,9999,0,9999,0
1667915932396,ECE 200,007,103592,Fainman; Yeshaiahu,9999,0,9999,0
1667915932396,ECE 200,008,103593,Ford; Joseph Earl,9999,0,9999,0
1667915932396,ECE 200,009,103594,Franceschetti; Massimo,9999,0,9999,0
1667915932396,ECE 200,010,103595,Fullerton; Eric E,9999,0,9999,0
1667915932396,ECE 200,011,103596,Galton; Ian A,9999,0,9999,0
1667915932396,ECE 200,012,103597,Gilja; Vikash,9999,0,9999,0
1667915932396,ECE 200,013,103598,Hall; Drew A.,9999,0,9999,0
1667915932396,ECE 200,014,103599,Hsueh; Tzu-Chien,9999,0,9999,0
1667915932396,ECE 200,015,103600,Javidi; Tara,9999,0,9999,0
1667915932396,ECE 200,016,103601,Kahng; Andrew Byun,9999,0,9999,0
1667915932396,ECE 200,017,103602,Kim; Young-Han,9999,0,9999,0
1667915932396,ECE 200,018,103603,Koushanfar; Farinaz,9999,0,9999,0
1667915932396,ECE 200,019,103604,Kuzum; Duygu,9999,0,9999,0
1667915932396,ECE 200,020,103605,Le; Hanh-Phuc,9999,0,9999,0
1667915932396,ECE 200,021,103606,Lin; Bill,9999,0,9999,0
1667915932396,ECE 200,022,103607,Liu; Zhaowei,9998,0,9999,1
1667915932396,ECE 200,023,103608,Lo; Yu-Hwa,9999,0,9999,0
1667915932396,ECE 200,024,103609,Lomakin; Vitaliy,9999,0,9999,0
1667915932396,ECE 200,025,103610,Mercier; Patrick Philip,9999,0,9999,0
1667915932396,ECE 200,026,103611,Meyer; Florian,9999,0,9999,0
1667915932396,ECE 200,027,103612,Milstein; Laurence B.,9999,0,9999,0
1667915932396,ECE 200,028,103613,Mir Arabbaygi; Siavash,9999,0,9999,0
1667915932396,ECE 200,029,103614,Mookherjea; Shayan,9999,0,9999,0
1667915932396,ECE 200,030,103615,Morris; Karcher William,9999,0,9999,0
1667915932396,ECE 200,031,103616,Ng; Tse Nga,9999,0,9999,0
1667915932396,ECE 200,032,103617,Nguyen; Truong Quang,9999,0,9999,0
1667915932396,ECE 200,033,103618,Nomura; Kenji,9999,0,9999,0
1667915932396,ECE 200,034,103619,Orlitsky; Alon,9999,0,9999,0
1667915932396,ECE 200,035,103620,Pal; Piya,9999,0,9999,0
1667915932396,ECE 200,036,103621,Papen; George C.,9999,0,9999,0
1667915932396,ECE 200,037,103622,Radic; Stojan,9999,0,9999,0
1667915932396,ECE 200,038,103623,Rao; Bhaskar D.,9999,0,9999,0
1667915932396,ECE 200,039,103624,Rao; Ramesh R,9999,0,9999,0
1667915932396,ECE 200,040,103625,Rebeiz; Gabriel,9999,0,9999,0
1667915932396,ECE 200,041,103626,Sanford; John R,9999,0,9999,0
1667915932396,ECE 200,042,103627,Siegel; Paul H.,9999,0,9999,0
1667915932396,ECE 200,043,103628,Sievenpiper; Daniel F.,9999,0,9999,0
1667915932396,ECE 200,044,103629,Sworder; David D.,9999,0,9999,0
1667915932396,ECE 200,045,103630,Taur; Yuan,9999,0,9999,0
1667915932396,ECE 200,046,103631,Touri; Behrouz,9999,0,9999,0
1667915932396,ECE 200,047,103632,Trivedi; Mohan M.,9999,0,9999,0
1667915932396,ECE 200,048,103633,Vasconcelos; Nuno,9999,0,9999,0
1667915932396,ECE 200,049,103634,Wang; Xiaolong,9999,0,9999,0
1667915932396,ECE 200,050,103635,Xie; Pengtao,9999,0,9999,0
1667915932396,ECE 200,051,103636,Yip; Michael,9999,0,9999,0
1667915932396,ECE 200,052,103637,Zeger; Kenneth A.,999,0,999,0
1667915932396,ECE 200,053,103638,Zhang; Xinyu,9999,0,9999,0
1667915932396,ECE 200,054,103639,Turakhia; Yatish Girish,9999,0,9999,0
1667915932396,ECE 200,055,103640,Kang; Mingu,9999,0,9999,0
1667915932396,ECE 200,056,103641,Shi; Yuanyuan,9999,0,9999,0
1667915932396,ECE 200,057,103642,Wang; Edward Jay,9999,0,9999,0
1667915932396,ECE 200,058,103643,Zheng; Yang,9999,0,9999,0
1667915932840,ECE 202,A00,103644,Kuzum; Duygu,0,0,0,0
1667915933273,ECE 212BN,A00,103646,Ng; Tse Nga,0,0,0,0
1667915933704,ECE 221,A00,111493,Staff,0,0,0,0
1667915934146,ECE 222B,A00,103647,Lomakin; Vitaliy,0,0,0,0
1667915934572,ECE 230B,A00,103648,Taur; Yuan,0,0,0,0
1667915935007,ECE 238B,A00,103649,Garay; Javier,0,0,0,0
1667915935435,ECE 240B,A00,112900,Fainman; Yeshaiahu,0,0,0,0
1667915935873,ECE 247A,A00,103650,Jokerst; Jesse Vincent,0,0,0,0
1667915936304,ECE 247B,A00,103651,Wang; Joseph,0,0,0,0
1667915936744,ECE 250,A00,103652,Siegel; Paul H.,0,0,0,0
1667915937170,ECE 251A,A00,103654,Rao; Bhaskar D.,0,0,0,0
1667915937605,ECE 257B,A00,103655,Bharadia; Dinesh,0,0,0,0
1667915938028,ECE 258A,A00,103656,Milstein; Laurence B.,0,0,0,0
1667915938463,ECE 260B,A00,103658,Kang; Mingu,0,0,0,0
1667915938898,ECE 264A,A00,103659,Galton; Ian A,0,0,0,0
1667915939337,ECE 265A,A00,103661,Gudem; Prasad S.S.,0,0,0,0
1667915939766,ECE 265D,A00,103662,Gudem; Prasad S.S.,0,0,0,0
1667915940212,ECE 268,A00,103663,Koushanfar; Farinaz,0,0,0,0
1667915940644,ECE 269,A01,103665,Pal; Piya,0,0,0,0
1667915941072,ECE 271B,A00,103666,Vasconcelos; Manuela,0,0,0,0
1667915941513,ECE 276A,A00,103667,Atanasov; Nikolay A.,0,0,0,0
1667915941952,ECE 277,A00,103668,An; Cheolhong,0,0,0,0
1667915942377,ECE 279,A00,117947,Hall; Drew A.,0,0,0,0
1667915943237,ECE 283,A00,103670,Hsueh; Tzu-Chien,0,0,0,0
1667915943674,ECE 284,A00,103671,Turakhia; Yatish Girish,0,0,0,0
1667915944138,ECE 285,A00,103672,Zheng; Yang,0,0,0,0
1667915944138,ECE 285,B00,103673,Sworder; David D.,0,0,0,0
1667915944589,ECE 287,A00,103676,Javidi; Tara,0,0,0,0
1667915945064,MATH 200B,A00,098023,Salehi Golsefidy; Alireza,15,0,15,0
1667915945493,MATH 202B,A00,098024,Rhoades; Brendon Patrick,14,0,15,1
1667915945930,MATH 203B,A00,098025,Oprea; Dragos N.,14,0,15,1
1667915946355,MATH 204B,A00,098026,Sorensen; Claus M,15,0,15,0
1667915946793,MATH 208,A00,098027,Izadi; Elham,7,0,10,3
1667915947240,MATH 209,A00,098028,Pollack; Aaron,10,0,10,0
1667915947687,MATH 211A,A00,112919,Rogalski; Daniel,10,0,10,0
1667915948112,MATH 211B,A00,112920,Seward; Brandon M.,10,0,10,0
1667915948545,MATH 218,A00,098029,Li; Bo,10,0,10,0
1667915948988,MATH 220B,A00,098030,Novak; Jonathan I,15,0,15,0
1667915949428,MATH 221A,A00,098031,Ebenfelt; Peter F,15,0,15,0
1667915949877,MATH 231B,A00,098032,Zlatos; Andrej,15,0,15,0
1667915950313,MATH 240B,A00,098033,Ni; Lei,13,0,15,2
1667915950749,MATH 243,A00,098034,Jekel; David Andrew,10,0,10,0
1667915951178,MATH 245A,A00,098035,Nie; Jiawang,6,0,15,9
1667915951603,MATH 248,A00,098036,Bejenaru; Ioan,10,0,10,0
1667915952039,MATH 250B,A00,098037,Spolaor; Luca,14,0,15,1
1667915952472,MATH 258,A00,098038,Ni; Lei,10,0,10,0
1667915952899,MATH 264B,A00,098041,Rhoades; Brendon Patrick,13,0,15,2
1667915953324,MATH 268,A00,098042,Buss; Samuel R,10,0,10,0
1667915953754,MATH 269,A00,098043,Rhoades; Brendon Patrick,10,0,10,0
1667915954186,MATH 270B,A00,098044,Li; Bo,13,0,15,2
1667915954615,MATH 272B,A00,098045,Holst; Michael J,13,0,15,2
1667915955044,MATH 273A,A00,098046,Tian; Xiaochuan,12,0,15,3
1667915955469,MATH 275,A01,098048,Tian; Xiaochuan,7,0,10,3
1667915955901,MATH 278A,A00,098049,Holst; Michael J,8,0,10,2
1667915956325,MATH 278B,A00,098050,Cloninger; Alexander,10,0,10,0
1667915956765,MATH 278C,A00,098051,Nie; Jiawang,9,0,10,1
1667915957192,MATH 280B,A00,098052,Zheng; Tianyi,12,0,15,3
1667915957616,MATH 281B,A00,098053,Bradic; Jelena,6,0,15,9
1667915958060,MATH 282B,A00,098054,Arias-Castro; Ery,2,0,15,13
1667915958499,MATH 285,A00,098055,Fitzsimmons; Patrick J,3,0,15,12
1667915958923,MATH 287B,A00,098056,Arias-Castro; Ery,9,0,15,6
1667915959349,MATH 288,A00,098057,Agarwal; Pooja,9,0,10,1
1667915959349,MATH 288,B00,098058,Zhang; Danna,9,0,10,1
1667915959349,MATH 288,C00,098059,Williams; Ruth J,10,0,10,0
1667915959782,MATH 290B,A00,098060,Roberts; Justin Deritter,14,0,15,1
1667915960233,MATH 292,A00,098061,Belmont; Eva Kinoshita,10,0,10,0
1667915960662,MATH 295,A00,098062,Suk; Andrew Hoon,48,0,50,2
1667915961087,MATH 296,A00,098063,Novak; Jonathan I,20,0,20,0
1667915961515,MATH 297,001,098064,Gamst; Anthony Collins,9997,0,9999,2
1667916471466,COGS 205,A00,101395,Chiba; Andrea,20,0,20,0
1667916471911,COGS 210B,001,101404,Greene; Deanna Jacquelyn,9998,0,9999,1
1667916471911,COGS 210B,002,101417,Xia; Haijun,9999,0,9999,0
1667916471911,COGS 210B,003,101422,Nitz; Douglas A.,9999,0,9999,0
1667916471911,COGS 210B,004,101423,Hollan; James D.,9998,0,9999,1
1667916471911,COGS 210B,005,101424,Deak; Gedeon O.,9999,0,9999,0
1667916471911,COGS 210B,006,101425,Rossano; Federico,9999,0,9999,0
1667916472342,COGS 211B,A00,101427,Coulson; Seana M,9997,0,9999,2
1667916472765,COGS 220,A00,101428,Hollan; James D.,0,0,25,25
1667916473211,COGS 229,A00,101429,Dow; Steven P,19,0,25,6
1667916473688,COGS 230,A00,101430,Klemmer; Scott R,13,0,17,4
1667916474120,COGS 234,A00,101431,Xia; Haijun,11,0,25,14
1667916474587,COGS 260,A00,101432,Kiyonaga; Anastasia,20,0,25,5
1667916474587,COGS 260,B00,101433,Kirsh; David Joel,18,0,25,7
1667916475014,CSE 202,A00,102371,Impagliazzo; Russell,0,0,0,0
1667916475445,CSE 203B,A01,102373,Cheng; Chung Kuan,0,0,0,0
1667916475873,CSE 208,A00,102374,Micciancio; Daniele,0,0,0,0
1667916476299,CSE 209A,A00,112895,Impagliazzo; Russell,0,0,15,15
1667916476728,CSE 209B,A00,108005,Bellare; Mihir,0,0,0,0
1667916477165,CSE 210,A00,113163,Coblenz; Michael J,0,0,0,0
1667916477596,CSE 219,A00,106111,Dow; Steven P,0,0,20,20
1667916478030,CSE 221,A00,102376,Voelker; Geoffrey M.,0,0,0,0
1667916478463,CSE 224,A01,102378,Porter; George M,0,0,0,0
1667916478888,CSE 229A,A00,102379,Savage; Stefan,0,0,0,0
1667916479313,CSE 229C,A00,102380,Munyaka; Imani N. S.,0,0,0,0
1667916479742,CSE 232B,A00,102382,Deutsch; Alin Bernard,0,0,0,0
1667916480202,CSE 234,A01,112904,Kumar; Arun Kumar,0,0,0,0
1667916480632,CSE 237A,A00,102383,Rosing; Tajana Simunic,0,0,0,0
1667916481072,CSE 239A,A00,102384,Deutsch; Alin Bernard,0,0,0,0
1667916481508,CSE 239B,A00,102385,Polikarpova; Nadezhda,0,0,0,0
1667916481943,CSE 240A,A00,102386,Pannuto; Patrick William,0,0,0,0
1667916482376,CSE 240B,A00,102387,Zhao; Jishen,0,0,0,0
1667916482802,CSE 241A,A00,106406,Kang; Mingu,0,0,0,0
1667916483238,CSE 249B,A00,102388,Kahng; Andrew Byun,0,0,8,8
1667916483663,CSE 251B,A01,102392,Cottrell; Garrison W,0,0,0,0
1667916483663,CSE 251B,A02,102393,Cottrell; Garrison W,0,0,0,0
1667916484097,CSE 252B,A00,102394,Ochoa; Benjamin Lawrence,0,0,0,0
1667916484531,CSE 257,A01,102396,Gao; Sicun,0,0,0,0
1667916484970,CSE 272,A00,102397,Li; Tzumao,0,0,0,0
1667916485405,CSE 274,A00,111323,Chern; Albert Ren-Haur,0,0,0,0
1667916485834,CSE 282,A00,102398,Pevzner; Pavel Arkadjevich,0,0,0,0
1667916486279,CSE 284,A00,114175,Gymrek; Melissa Ann,0,0,0,0
1667916486705,CSE 290,A00,102399,Chandraker; Manmohan Krishna,0,0,0,0
1667916486705,CSE 290,B00,102400,Vaccaro; Kristen Marie,0,0,25,25
1667916486705,CSE 290,C00,102414,Pannuto; Patrick William,0,0,25,25
1667916486705,CSE 290,D00,102427,Pevzner; Pavel Arkadjevich,0,0,0,0
1667916486705,CSE 290,E00,102429,Zhao; Jishen,0,0,0,0
1667916486705,CSE 290,F00,102436,Tullsen; Dean Michael,0,0,0,0
1667916486705,CSE 290,G00,102440,Christensen; Henrik I,0,0,20,20
1667916487146,CSE 291,A00,102443,Su; Hao,0,0,0,0
1667916487146,CSE 291,B00,102448,Polikarpova; Nadezhda,0,0,0,0
1667916487146,CSE 291,C00,102453,Vaccaro; Kristen Marie,0,0,0,0
1667916487146,CSE 291,D00,111343,Savage; Stefan,0,0,0,0
1667916487146,CSE 291,E00,116474,Claffy; Kimberly Claire,0,0,0,0
1667916487146,CSE 291,F00,116479,Pasquale; Joseph,0,0,0,0
1667916487581,CSE 293,001,119111,Bafna; Vineet,9999,0,9999,0
1667916487581,CSE 293,002,119118,Bellare; Mihir,9999,0,9999,0
1667916487581,CSE 293,003,119122,Berg-Kirkpatrick; Taylor D,9999,0,9999,0
1667916487581,CSE 293,004,119135,Christensen; Henrik I,9999,0,9999,0
1667916487581,CSE 293,005,119142,Cottrell; Garrison W,9999,0,9999,0
1667916487581,CSE 293,006,119146,Deutsch; Alin Bernard,9999,0,9999,0
1667916487581,CSE 293,007,119159,Esmaeilzadeh; Hadi,9999,0,9999,0
1667916487581,CSE 293,008,119166,Freund; Yoav,9999,0,9999,0
1667916487581,CSE 293,009,119170,Griswold; William G.,9999,0,9999,0
1667916487581,CSE 293,010,119183,Gymrek; Melissa Ann,9999,0,9999,0
1667916487581,CSE 293,011,119190,Heninger; Nadia A,9999,0,9999,0
1667916487581,CSE 293,012,119230,Impagliazzo; Russell,9999,0,9999,0
1667916487581,CSE 293,013,119232,Jhala; Ranjit,9999,0,9999,0
1667916487581,CSE 293,014,119233,Kahng; Andrew Byun,9999,0,9999,0
1667916487581,CSE 293,015,119298,Kane; Daniel Mertz,9999,0,9999,0
1667916487581,CSE 293,016,119299,Kriegman; David J,9999,0,9999,0
1667916487581,CSE 293,017,119300,Kumar; Arun Kumar,9999,0,9999,0
1667916487581,CSE 293,018,119301,Lerner; Sorin,9999,0,9999,0
1667916487581,CSE 293,019,119302,Lovett; Shachar,9999,0,9999,0
1667916487581,CSE 293,020,119303,McAuley; Julian John,9999,0,9999,0
1667916487581,CSE 293,021,119304,Micciancio; Daniele,9999,0,9999,0
1667916487581,CSE 293,022,119367,Orailoglu; Alex,9999,0,9999,0
1667916487581,CSE 293,023,119382,Paturi; Ramamohan,9999,0,9999,0
1667916487581,CSE 293,024,119404,Polikarpova; Nadezhda,9999,0,9999,0
1667916487581,CSE 293,025,119406,Politz; Joseph Gibbs,9999,0,9999,0
1667916487581,CSE 293,026,119411,Porter; George M,9999,0,9999,0
1667916487581,CSE 293,027,119414,Porter; Leonard Emerson,9999,0,9999,0
1667916487581,CSE 293,028,119416,Ramamoorthi; Ravi,9999,0,9999,0
1667916487581,CSE 293,029,119417,Sahoo; Debashis,9999,0,9999,0
1667916487581,CSE 293,030,119420,Saul; Lawrence,9999,0,9999,0
1667916487581,CSE 293,031,119421,Savage; Stefan,9999,0,9999,0
1667916487581,CSE 293,032,119425,Schulze; Jurgen P.,9999,0,9999,0
1667916487581,CSE 293,033,119426,Snoeren; Alex C.,9999,0,9999,0
1667916487581,CSE 293,034,119428,Shang; Jingbo,9999,0,9999,0
1667916487581,CSE 293,035,119430,Stefan; Deian,9999,0,9999,0
1667916487581,CSE 293,036,119431,Su; Hao,9999,0,9999,0
1667916487581,CSE 293,037,119433,Swanson; Steven James,9999,0,9999,0
1667916487581,CSE 293,038,119435,Tullsen; Dean Michael,9999,0,9999,0
1667916487581,CSE 293,039,119483,Voelker; Geoffrey M.,9999,0,9999,0
1667916487581,CSE 293,040,119537,Zhao; Jishen,9999,0,9999,0
1667916487581,CSE 293,041,119538,Zhou; Yuan-Yuan,9999,0,9999,0
1667916487581,CSE 293,042,119539,Gao; Sicun,9999,0,9999,0
1667916487581,CSE 293,043,119540,Weibel; Nadir,9999,0,9999,0
1667916487581,CSE 293,044,119541,Gupta; Rajesh K.,9999,0,9999,0
1667916488016,CSE 294,A00,102459,Voelker; Geoffrey M.,0,0,0,0
1667916488016,CSE 294,B00,111322,Orailoglu; Alex,0,0,0,0
1667916488446,DSE 201,A00,096914,Deutsch; Alin Bernard,30,0,30,0
1667916488873,DSE 210,A00,096915,Dasgupta; Sanjoy,30,0,30,0
1667916489318,DSE 260A,A00,096916,Altintas De Callaf; Ilkay,30,0,30,0
1667916489758,ECE 200,001,103586,Antipa; Nicholas A,9999,0,9999,0
1667916489758,ECE 200,002,103587,Atanasov; Nikolay A.,9999,0,9999,0
1667916489758,ECE 200,003,103588,Bharadia; Dinesh,9999,0,9999,0
1667916489758,ECE 200,004,103589,Cheng; Chung Kuan,9999,0,9999,0
1667916489758,ECE 200,005,103590,Cosman; Pamela C.,9999,0,9999,0
1667916489758,ECE 200,006,103591,Dayeh; Shadi Ahmad,9999,0,9999,0
1667916489758,ECE 200,007,103592,Fainman; Yeshaiahu,9999,0,9999,0
1667916489758,ECE 200,008,103593,Ford; Joseph Earl,9999,0,9999,0
1667916489758,ECE 200,009,103594,Franceschetti; Massimo,9999,0,9999,0
1667916489758,ECE 200,010,103595,Fullerton; Eric E,9999,0,9999,0
1667916489758,ECE 200,011,103596,Galton; Ian A,9999,0,9999,0
1667916489758,ECE 200,012,103597,Gilja; Vikash,9999,0,9999,0
1667916489758,ECE 200,013,103598,Hall; Drew A.,9999,0,9999,0
1667916489758,ECE 200,014,103599,Hsueh; Tzu-Chien,9999,0,9999,0
1667916489758,ECE 200,015,103600,Javidi; Tara,9999,0,9999,0
1667916489758,ECE 200,016,103601,Kahng; Andrew Byun,9999,0,9999,0
1667916489758,ECE 200,017,103602,Kim; Young-Han,9999,0,9999,0
1667916489758,ECE 200,018,103603,Koushanfar; Farinaz,9999,0,9999,0
1667916489758,ECE 200,019,103604,Kuzum; Duygu,9999,0,9999,0
1667916489758,ECE 200,020,103605,Le; Hanh-Phuc,9999,0,9999,0
1667916489758,ECE 200,021,103606,Lin; Bill,9999,0,9999,0
1667916489758,ECE 200,022,103607,Liu; Zhaowei,9998,0,9999,1
1667916489758,ECE 200,023,103608,Lo; Yu-Hwa,9999,0,9999,0
1667916489758,ECE 200,024,103609,Lomakin; Vitaliy,9999,0,9999,0
1667916489758,ECE 200,025,103610,Mercier; Patrick Philip,9999,0,9999,0
1667916489758,ECE 200,026,103611,Meyer; Florian,9999,0,9999,0
1667916489758,ECE 200,027,103612,Milstein; Laurence B.,9999,0,9999,0
1667916489758,ECE 200,028,103613,Mir Arabbaygi; Siavash,9999,0,9999,0
1667916489758,ECE 200,029,103614,Mookherjea; Shayan,9999,0,9999,0
1667916489758,ECE 200,030,103615,Morris; Karcher William,9999,0,9999,0
1667916489758,ECE 200,031,103616,Ng; Tse Nga,9999,0,9999,0
1667916489758,ECE 200,032,103617,Nguyen; Truong Quang,9999,0,9999,0
1667916489758,ECE 200,033,103618,Nomura; Kenji,9999,0,9999,0
1667916489758,ECE 200,034,103619,Orlitsky; Alon,9999,0,9999,0
1667916489758,ECE 200,035,103620,Pal; Piya,9999,0,9999,0
1667916489758,ECE 200,036,103621,Papen; George C.,9999,0,9999,0
1667916489758,ECE 200,037,103622,Radic; Stojan,9999,0,9999,0
1667916489758,ECE 200,038,103623,Rao; Bhaskar D.,9999,0,9999,0
1667916489758,ECE 200,039,103624,Rao; Ramesh R,9999,0,9999,0
1667916489758,ECE 200,040,103625,Rebeiz; Gabriel,9999,0,9999,0
1667916489758,ECE 200,041,103626,Sanford; John R,9999,0,9999,0
1667916489758,ECE 200,042,103627,Siegel; Paul H.,9999,0,9999,0
1667916489758,ECE 200,043,103628,Sievenpiper; Daniel F.,9999,0,9999,0
1667916489758,ECE 200,044,103629,Sworder; David D.,9999,0,9999,0
1667916489758,ECE 200,045,103630,Taur; Yuan,9999,0,9999,0
1667916489758,ECE 200,046,103631,Touri; Behrouz,9999,0,9999,0
1667916489758,ECE 200,047,103632,Trivedi; Mohan M.,9999,0,9999,0
1667916489758,ECE 200,048,103633,Vasconcelos; Nuno,9999,0,9999,0
1667916489758,ECE 200,049,103634,Wang; Xiaolong,9999,0,9999,0
1667916489758,ECE 200,050,103635,Xie; Pengtao,9999,0,9999,0
1667916489758,ECE 200,051,103636,Yip; Michael,9999,0,9999,0
1667916489758,ECE 200,052,103637,Zeger; Kenneth A.,999,0,999,0
1667916489758,ECE 200,053,103638,Zhang; Xinyu,9999,0,9999,0
1667916489758,ECE 200,054,103639,Turakhia; Yatish Girish,9999,0,9999,0
1667916489758,ECE 200,055,103640,Kang; Mingu,9999,0,9999,0
1667916489758,ECE 200,056,103641,Shi; Yuanyuan,9999,0,9999,0
1667916489758,ECE 200,057,103642,Wang; Edward Jay,9999,0,9999,0
1667916489758,ECE 200,058,103643,Zheng; Yang,9999,0,9999,0
1667916490189,ECE 202,A00,103644,Kuzum; Duygu,0,0,0,0
1667916490614,ECE 212BN,A00,103646,Ng; Tse Nga,0,0,0,0
1667916491041,ECE 221,A00,111493,Staff,0,0,0,0
1667916491475,ECE 222B,A00,103647,Lomakin; Vitaliy,0,0,0,0
1667916491898,ECE 230B,A00,103648,Taur; Yuan,0,0,0,0
1667916492325,ECE 238B,A00,103649,Garay; Javier,0,0,0,0
1667916492750,ECE 240B,A00,112900,Fainman; Yeshaiahu,0,0,0,0
1667916493177,ECE 247A,A00,103650,Jokerst; Jesse Vincent,0,0,0,0
1667916493628,ECE 247B,A00,103651,Wang; Joseph,0,0,0,0
1667916494098,ECE 250,A00,103652,Siegel; Paul H.,0,0,0,0
1667916494526,ECE 251A,A00,103654,Rao; Bhaskar D.,0,0,0,0
1667916494960,ECE 257B,A00,103655,Bharadia; Dinesh,0,0,0,0
1667916495385,ECE 258A,A00,103656,Milstein; Laurence B.,0,0,0,0
1667916495816,ECE 260B,A00,103658,Kang; Mingu,0,0,0,0
1667916496241,ECE 264A,A00,103659,Galton; Ian A,0,0,0,0
1667916496681,ECE 265A,A00,103661,Gudem; Prasad S.S.,0,0,0,0
1667916497118,ECE 265D,A00,103662,Gudem; Prasad S.S.,0,0,0,0
1667916497559,ECE 268,A00,103663,Koushanfar; Farinaz,0,0,0,0
1667916498017,ECE 269,A01,103665,Pal; Piya,0,0,0,0
1667916498452,ECE 271B,A00,103666,Vasconcelos; Manuela,0,0,0,0
1667916498879,ECE 276A,A00,103667,Atanasov; Nikolay A.,0,0,0,0
1667916499332,ECE 277,A00,103668,An; Cheolhong,0,0,0,0
1667916499775,ECE 279,A00,117947,Hall; Drew A.,0,0,0,0
1667916500675,ECE 283,A00,103670,Hsueh; Tzu-Chien,0,0,0,0
1667916501106,ECE 284,A00,103671,Turakhia; Yatish Girish,0,0,0,0
1667916501559,ECE 285,A00,103672,Zheng; Yang,0,0,0,0
1667916501559,ECE 285,B00,103673,Sworder; David D.,0,0,0,0
1667916502112,ECE 287,A00,103676,Javidi; Tara,0,0,0,0
1667916502545,MATH 200B,A00,098023,Salehi Golsefidy; Alireza,15,0,15,0
1667916502978,MATH 202B,A00,098024,Rhoades; Brendon Patrick,14,0,15,1
1667916503409,MATH 203B,A00,098025,Oprea; Dragos N.,14,0,15,1
1667916503838,MATH 204B,A00,098026,Sorensen; Claus M,15,0,15,0
1667916504267,MATH 208,A00,098027,Izadi; Elham,7,0,10,3
1667916504705,MATH 209,A00,098028,Pollack; Aaron,10,0,10,0
1667916505132,MATH 211A,A00,112919,Rogalski; Daniel,10,0,10,0
1667916505556,MATH 211B,A00,112920,Seward; Brandon M.,10,0,10,0
1667916505989,MATH 218,A00,098029,Li; Bo,10,0,10,0
1667916506412,MATH 220B,A00,098030,Novak; Jonathan I,15,0,15,0
1667916506847,MATH 221A,A00,098031,Ebenfelt; Peter F,15,0,15,0
1667916507283,MATH 231B,A00,098032,Zlatos; Andrej,15,0,15,0
1667916507714,MATH 240B,A00,098033,Ni; Lei,13,0,15,2
1667916508165,MATH 243,A00,098034,Jekel; David Andrew,10,0,10,0
1667916508615,MATH 245A,A00,098035,Nie; Jiawang,6,0,15,9
1667916509042,MATH 248,A00,098036,Bejenaru; Ioan,10,0,10,0
1667916509483,MATH 250B,A00,098037,Spolaor; Luca,14,0,15,1
1667916509912,MATH 258,A00,098038,Ni; Lei,10,0,10,0
1667916510336,MATH 264B,A00,098041,Rhoades; Brendon Patrick,13,0,15,2
1667916510793,MATH 268,A00,098042,Buss; Samuel R,10,0,10,0
1667916511217,MATH 269,A00,098043,Rhoades; Brendon Patrick,10,0,10,0
1667916511652,MATH 270B,A00,098044,Li; Bo,13,0,15,2
1667916512079,MATH 272B,A00,098045,Holst; Michael J,13,0,15,2
1667916512515,MATH 273A,A00,098046,Tian; Xiaochuan,12,0,15,3
1667916512941,MATH 275,A01,098048,Tian; Xiaochuan,7,0,10,3
1667916513372,MATH 278A,A00,098049,Holst; Michael J,8,0,10,2
1667916513806,MATH 278B,A00,098050,Cloninger; Alexander,10,0,10,0
1667916514233,MATH 278C,A00,098051,Nie; Jiawang,9,0,10,1
1667916514673,MATH 280B,A00,098052,Zheng; Tianyi,12,0,15,3
1667916515097,MATH 281B,A00,098053,Bradic; Jelena,6,0,15,9
1667916515529,MATH 282B,A00,098054,Arias-Castro; Ery,2,0,15,13
1667916515955,MATH 285,A00,098055,Fitzsimmons; Patrick J,3,0,15,12
1667916516393,MATH 287B,A00,098056,Arias-Castro; Ery,9,0,15,6
1667916516837,MATH 288,A00,098057,Agarwal; Pooja,9,0,10,1
1667916516837,MATH 288,B00,098058,Zhang; Danna,9,0,10,1
1667916516837,MATH 288,C00,098059,Williams; Ruth J,10,0,10,0
1667916517266,MATH 290B,A00,098060,Roberts; Justin Deritter,14,0,15,1
1667916517702,MATH 292,A00,098061,Belmont; Eva Kinoshita,10,0,10,0
1667916518127,MATH 295,A00,098062,Suk; Andrew Hoon,48,0,50,2
1667916518558,MATH 296,A00,098063,Novak; Jonathan I,20,0,20,0
1667916518988,MATH 297,001,098064,Gamst; Anthony Collins,9997,0,9999,2
1667917027570,COGS 205,A00,101395,Chiba; Andrea,20,0,20,0
1667917027994,COGS 210B,001,101404,Greene; Deanna Jacquelyn,9998,0,9999,1
1667917027994,COGS 210B,002,101417,Xia; Haijun,9999,0,9999,0
1667917027994,COGS 210B,003,101422,Nitz; Douglas A.,9999,0,9999,0
1667917027994,COGS 210B,004,101423,Hollan; James D.,9998,0,9999,1
1667917027994,COGS 210B,005,101424,Deak; Gedeon O.,9999,0,9999,0
1667917027994,COGS 210B,006,101425,Rossano; Federico,9999,0,9999,0
1667917028423,COGS 211B,A00,101427,Coulson; Seana M,9997,0,9999,2
1667917028865,COGS 220,A00,101428,Hollan; James D.,0,0,25,25
1667917029294,COGS 229,A00,101429,Dow; Steven P,19,0,25,6
1667917029726,COGS 230,A00,101430,Klemmer; Scott R,13,0,17,4
1667917030165,COGS 234,A00,101431,Xia; Haijun,11,0,25,14
1667917030588,COGS 260,A00,101432,Kiyonaga; Anastasia,20,0,25,5
1667917030588,COGS 260,B00,101433,Kirsh; David Joel,18,0,25,7
1667917031101,CSE 202,A00,102371,Impagliazzo; Russell,0,0,0,0
1667917031569,CSE 203B,A01,102373,Cheng; Chung Kuan,0,0,0,0
1667917031996,CSE 208,A00,102374,Micciancio; Daniele,0,0,0,0
1667917032433,CSE 209A,A00,112895,Impagliazzo; Russell,0,0,15,15
1667917032872,CSE 209B,A00,108005,Bellare; Mihir,0,0,0,0
1667917033307,CSE 210,A00,113163,Coblenz; Michael J,0,0,0,0
1667917033734,CSE 219,A00,106111,Dow; Steven P,0,0,20,20
1667917034161,CSE 221,A00,102376,Voelker; Geoffrey M.,0,0,0,0
1667917034588,CSE 224,A01,102378,Porter; George M,0,0,0,0
1667917035016,CSE 229A,A00,102379,Savage; Stefan,0,0,0,0
1667917035442,CSE 229C,A00,102380,Munyaka; Imani N. S.,0,0,0,0
1667917035901,CSE 232B,A00,102382,Deutsch; Alin Bernard,0,0,0,0
1667917036359,CSE 234,A01,112904,Kumar; Arun Kumar,0,0,0,0
1667917036800,CSE 237A,A00,102383,Rosing; Tajana Simunic,0,0,0,0
1667917037223,CSE 239A,A00,102384,Deutsch; Alin Bernard,0,0,0,0
1667917037658,CSE 239B,A00,102385,Polikarpova; Nadezhda,0,0,0,0
1667917038094,CSE 240A,A00,102386,Pannuto; Patrick William,0,0,0,0
1667917038531,CSE 240B,A00,102387,Zhao; Jishen,0,0,0,0
1667917038972,CSE 241A,A00,106406,Kang; Mingu,0,0,0,0
1667917039396,CSE 249B,A00,102388,Kahng; Andrew Byun,0,0,8,8
1667917039828,CSE 251B,A01,102392,Cottrell; Garrison W,0,0,0,0
1667917039828,CSE 251B,A02,102393,Cottrell; Garrison W,0,0,0,0
1667917040268,CSE 252B,A00,102394,Ochoa; Benjamin Lawrence,0,0,0,0
1667917040704,CSE 257,A01,102396,Gao; Sicun,0,0,0,0
1667917041135,CSE 272,A00,102397,Li; Tzumao,0,0,0,0
1667917041565,CSE 274,A00,111323,Chern; Albert Ren-Haur,0,0,0,0
1667917041994,CSE 282,A00,102398,Pevzner; Pavel Arkadjevich,0,0,0,0
1667917042421,CSE 284,A00,114175,Gymrek; Melissa Ann,0,0,0,0
1667917042859,CSE 290,A00,102399,Chandraker; Manmohan Krishna,0,0,0,0
1667917042859,CSE 290,B00,102400,Vaccaro; Kristen Marie,0,0,25,25
1667917042859,CSE 290,C00,102414,Pannuto; Patrick William,0,0,25,25
1667917042859,CSE 290,D00,102427,Pevzner; Pavel Arkadjevich,0,0,0,0
1667917042859,CSE 290,E00,102429,Zhao; Jishen,0,0,0,0
1667917042859,CSE 290,F00,102436,Tullsen; Dean Michael,0,0,0,0
1667917042859,CSE 290,G00,102440,Christensen; Henrik I,0,0,20,20
1667917043292,CSE 291,A00,102443,Su; Hao,0,0,0,0
1667917043292,CSE 291,B00,102448,Polikarpova; Nadezhda,0,0,0,0
1667917043292,CSE 291,C00,102453,Vaccaro; Kristen Marie,0,0,0,0
1667917043292,CSE 291,D00,111343,Savage; Stefan,0,0,0,0
1667917043292,CSE 291,E00,116474,Claffy; Kimberly Claire,0,0,0,0
1667917043292,CSE 291,F00,116479,Pasquale; Joseph,0,0,0,0
1667917043733,CSE 293,001,119111,Bafna; Vineet,9999,0,9999,0
1667917043733,CSE 293,002,119118,Bellare; Mihir,9999,0,9999,0
1667917043733,CSE 293,003,119122,Berg-Kirkpatrick; Taylor D,9999,0,9999,0
1667917043733,CSE 293,004,119135,Christensen; Henrik I,9999,0,9999,0
1667917043733,CSE 293,005,119142,Cottrell; Garrison W,9999,0,9999,0
1667917043733,CSE 293,006,119146,Deutsch; Alin Bernard,9999,0,9999,0
1667917043733,CSE 293,007,119159,Esmaeilzadeh; Hadi,9999,0,9999,0
1667917043733,CSE 293,008,119166,Freund; Yoav,9999,0,9999,0
1667917043733,CSE 293,009,119170,Griswold; William G.,9999,0,9999,0
1667917043733,CSE 293,010,119183,Gymrek; Melissa Ann,9999,0,9999,0
1667917043733,CSE 293,011,119190,Heninger; Nadia A,9999,0,9999,0
1667917043733,CSE 293,012,119230,Impagliazzo; Russell,9999,0,9999,0
1667917043733,CSE 293,013,119232,Jhala; Ranjit,9999,0,9999,0
1667917043733,CSE 293,014,119233,Kahng; Andrew Byun,9999,0,9999,0
1667917043733,CSE 293,015,119298,Kane; Daniel Mertz,9999,0,9999,0
1667917043733,CSE 293,016,119299,Kriegman; David J,9999,0,9999,0
1667917043733,CSE 293,017,119300,Kumar; Arun Kumar,9999,0,9999,0
1667917043733,CSE 293,018,119301,Lerner; Sorin,9999,0,9999,0
1667917043733,CSE 293,019,119302,Lovett; Shachar,9999,0,9999,0
1667917043733,CSE 293,020,119303,McAuley; Julian John,9999,0,9999,0
1667917043733,CSE 293,021,119304,Micciancio; Daniele,9999,0,9999,0
1667917043733,CSE 293,022,119367,Orailoglu; Alex,9999,0,9999,0
1667917043733,CSE 293,023,119382,Paturi; Ramamohan,9999,0,9999,0
1667917043733,CSE 293,024,119404,Polikarpova; Nadezhda,9999,0,9999,0
1667917043733,CSE 293,025,119406,Politz; Joseph Gibbs,9999,0,9999,0
1667917043733,CSE 293,026,119411,Porter; George M,9999,0,9999,0
1667917043733,CSE 293,027,119414,Porter; Leonard Emerson,9999,0,9999,0
1667917043733,CSE 293,028,119416,Ramamoorthi; Ravi,9999,0,9999,0
1667917043733,CSE 293,029,119417,Sahoo; Debashis,9999,0,9999,0
1667917043733,CSE 293,030,119420,Saul; Lawrence,9999,0,9999,0
1667917043733,CSE 293,031,119421,Savage; Stefan,9999,0,9999,0
1667917043733,CSE 293,032,119425,Schulze; Jurgen P.,9999,0,9999,0
1667917043733,CSE 293,033,119426,Snoeren; Alex C.,9999,0,9999,0
1667917043733,CSE 293,034,119428,Shang; Jingbo,9999,0,9999,0
1667917043733,CSE 293,035,119430,Stefan; Deian,9999,0,9999,0
1667917043733,CSE 293,036,119431,Su; Hao,9999,0,9999,0
1667917043733,CSE 293,037,119433,Swanson; Steven James,9999,0,9999,0
1667917043733,CSE 293,038,119435,Tullsen; Dean Michael,9999,0,9999,0
1667917043733,CSE 293,039,119483,Voelker; Geoffrey M.,9999,0,9999,0
1667917043733,CSE 293,040,119537,Zhao; Jishen,9999,0,9999,0
1667917043733,CSE 293,041,119538,Zhou; Yuan-Yuan,9999,0,9999,0
1667917043733,CSE 293,042,119539,Gao; Sicun,9999,0,9999,0
1667917043733,CSE 293,043,119540,Weibel; Nadir,9999,0,9999,0
1667917043733,CSE 293,044,119541,Gupta; Rajesh K.,9999,0,9999,0
1667917044164,CSE 294,A00,102459,Voelker; Geoffrey M.,0,0,0,0
1667917044164,CSE 294,B00,111322,Orailoglu; Alex,0,0,0,0
1667917044600,DSE 201,A00,096914,Deutsch; Alin Bernard,30,0,30,0
1667917045023,DSE 210,A00,096915,Dasgupta; Sanjoy,30,0,30,0
1667917045458,DSE 260A,A00,096916,Altintas De Callaf; Ilkay,30,0,30,0
1667917045893,ECE 200,001,103586,Antipa; Nicholas A,9999,0,9999,0
1667917045893,ECE 200,002,103587,Atanasov; Nikolay A.,9999,0,9999,0
1667917045893,ECE 200,003,103588,Bharadia; Dinesh,9999,0,9999,0
1667917045893,ECE 200,004,103589,Cheng; Chung Kuan,9999,0,9999,0
1667917045893,ECE 200,005,103590,Cosman; Pamela C.,9999,0,9999,0
1667917045893,ECE 200,006,103591,Dayeh; Shadi Ahmad,9999,0,9999,0
1667917045893,ECE 200,007,103592,Fainman; Yeshaiahu,9999,0,9999,0
1667917045893,ECE 200,008,103593,Ford; Joseph Earl,9999,0,9999,0
1667917045893,ECE 200,009,103594,Franceschetti; Massimo,9999,0,9999,0
1667917045893,ECE 200,010,103595,Fullerton; Eric E,9999,0,9999,0
1667917045893,ECE 200,011,103596,Galton; Ian A,9999,0,9999,0
1667917045893,ECE 200,012,103597,Gilja; Vikash,9999,0,9999,0
1667917045893,ECE 200,013,103598,Hall; Drew A.,9999,0,9999,0
1667917045893,ECE 200,014,103599,Hsueh; Tzu-Chien,9999,0,9999,0
1667917045893,ECE 200,015,103600,Javidi; Tara,9999,0,9999,0
1667917045893,ECE 200,016,103601,Kahng; Andrew Byun,9999,0,9999,0
1667917045893,ECE 200,017,103602,Kim; Young-Han,9999,0,9999,0
1667917045893,ECE 200,018,103603,Koushanfar; Farinaz,9999,0,9999,0
1667917045893,ECE 200,019,103604,Kuzum; Duygu,9999,0,9999,0
1667917045893,ECE 200,020,103605,Le; Hanh-Phuc,9999,0,9999,0
1667917045893,ECE 200,021,103606,Lin; Bill,9999,0,9999,0
1667917045893,ECE 200,022,103607,Liu; Zhaowei,9998,0,9999,1
1667917045893,ECE 200,023,103608,Lo; Yu-Hwa,9999,0,9999,0
1667917045893,ECE 200,024,103609,Lomakin; Vitaliy,9999,0,9999,0
1667917045893,ECE 200,025,103610,Mercier; Patrick Philip,9999,0,9999,0
1667917045893,ECE 200,026,103611,Meyer; Florian,9999,0,9999,0
1667917045893,ECE 200,027,103612,Milstein; Laurence B.,9999,0,9999,0
1667917045893,ECE 200,028,103613,Mir Arabbaygi; Siavash,9999,0,9999,0
1667917045893,ECE 200,029,103614,Mookherjea; Shayan,9999,0,9999,0
1667917045893,ECE 200,030,103615,Morris; Karcher William,9999,0,9999,0
1667917045893,ECE 200,031,103616,Ng; Tse Nga,9999,0,9999,0
1667917045893,ECE 200,032,103617,Nguyen; Truong Quang,9999,0,9999,0
1667917045893,ECE 200,033,103618,Nomura; Kenji,9999,0,9999,0
1667917045893,ECE 200,034,103619,Orlitsky; Alon,9999,0,9999,0
1667917045893,ECE 200,035,103620,Pal; Piya,9999,0,9999,0
1667917045893,ECE 200,036,103621,Papen; George C.,9999,0,9999,0
1667917045893,ECE 200,037,103622,Radic; Stojan,9999,0,9999,0
1667917045893,ECE 200,038,103623,Rao; Bhaskar D.,9999,0,9999,0
1667917045893,ECE 200,039,103624,Rao; Ramesh R,9999,0,9999,0
1667917045893,ECE 200,040,103625,Rebeiz; Gabriel,9999,0,9999,0
1667917045893,ECE 200,041,103626,Sanford; John R,9999,0,9999,0
1667917045893,ECE 200,042,103627,Siegel; Paul H.,9999,0,9999,0
1667917045893,ECE 200,043,103628,Sievenpiper; Daniel F.,9999,0,9999,0
1667917045893,ECE 200,044,103629,Sworder; David D.,9999,0,9999,0
1667917045893,ECE 200,045,103630,Taur; Yuan,9999,0,9999,0
1667917045893,ECE 200,046,103631,Touri; Behrouz,9999,0,9999,0
1667917045893,ECE 200,047,103632,Trivedi; Mohan M.,9999,0,9999,0
1667917045893,ECE 200,048,103633,Vasconcelos; Nuno,9999,0,9999,0
1667917045893,ECE 200,049,103634,Wang; Xiaolong,9999,0,9999,0
1667917045893,ECE 200,050,103635,Xie; Pengtao,9999,0,9999,0
1667917045893,ECE 200,051,103636,Yip; Michael,9999,0,9999,0
1667917045893,ECE 200,052,103637,Zeger; Kenneth A.,999,0,999,0
1667917045893,ECE 200,053,103638,Zhang; Xinyu,9999,0,9999,0
1667917045893,ECE 200,054,103639,Turakhia; Yatish Girish,9999,0,9999,0
1667917045893,ECE 200,055,103640,Kang; Mingu,9999,0,9999,0
1667917045893,ECE 200,056,103641,Shi; Yuanyuan,9999,0,9999,0
1667917045893,ECE 200,057,103642,Wang; Edward Jay,9999,0,9999,0
1667917045893,ECE 200,058,103643,Zheng; Yang,9999,0,9999,0
1667917046343,ECE 202,A00,103644,Kuzum; Duygu,0,0,0,0
1667917046790,ECE 212BN,A00,103646,Ng; Tse Nga,0,0,0,0
1667917047216,ECE 221,A00,111493,Staff,0,0,0,0
1667917047649,ECE 222B,A00,103647,Lomakin; Vitaliy,0,0,0,0
1667917048073,ECE 230B,A00,103648,Taur; Yuan,0,0,0,0
1667917048499,ECE 238B,A00,103649,Garay; Javier,0,0,0,0
1667917048933,ECE 240B,A00,112900,Fainman; Yeshaiahu,0,0,0,0
1667917049359,ECE 247A,A00,103650,Jokerst; Jesse Vincent,0,0,0,0
1667917049789,ECE 247B,A00,103651,Wang; Joseph,0,0,0,0
1667917050213,ECE 250,A00,103652,Siegel; Paul H.,0,0,0,0
1667917050642,ECE 251A,A00,103654,Rao; Bhaskar D.,0,0,0,0
1667917051083,ECE 257B,A00,103655,Bharadia; Dinesh,0,0,0,0
1667917051510,ECE 258A,A00,103656,Milstein; Laurence B.,0,0,0,0
1667917051951,ECE 260B,A00,103658,Kang; Mingu,0,0,0,0
1667917052385,ECE 264A,A00,103659,Galton; Ian A,0,0,0,0
1667917052836,ECE 265A,A00,103661,Gudem; Prasad S.S.,0,0,0,0
1667917053262,ECE 265D,A00,103662,Gudem; Prasad S.S.,0,0,0,0
1667917053702,ECE 268,A00,103663,Koushanfar; Farinaz,0,0,0,0
1667917054158,ECE 269,A01,103665,Pal; Piya,0,0,0,0
1667917054592,ECE 271B,A00,103666,Vasconcelos; Manuela,0,0,0,0
1667917055043,ECE 276A,A00,103667,Atanasov; Nikolay A.,0,0,0,0
1667917055478,ECE 277,A00,103668,An; Cheolhong,0,0,0,0
1667917055914,ECE 279,A00,117947,Hall; Drew A.,0,0,0,0
1667917056766,ECE 283,A00,103670,Hsueh; Tzu-Chien,0,0,0,0
1667917057194,ECE 284,A00,103671,Turakhia; Yatish Girish,0,0,0,0
1667917057642,ECE 285,A00,103672,Zheng; Yang,0,0,0,0
1667917057642,ECE 285,B00,103673,Sworder; David D.,0,0,0,0
1667917058081,ECE 287,A00,103676,Javidi; Tara,0,0,0,0
1667917058505,MATH 200B,A00,098023,Salehi Golsefidy; Alireza,15,0,15,0
1667917058929,MATH 202B,A00,098024,Rhoades; Brendon Patrick,14,0,15,1
1667917059356,MATH 203B,A00,098025,Oprea; Dragos N.,14,0,15,1
1667917059785,MATH 204B,A00,098026,Sorensen; Claus M,15,0,15,0
1667917060210,MATH 208,A00,098027,Izadi; Elham,7,0,10,3
1667917060647,MATH 209,A00,098028,Pollack; Aaron,10,0,10,0
1667917061073,MATH 211A,A00,112919,Rogalski; Daniel,10,0,10,0
1667917061497,MATH 211B,A00,112920,Seward; Brandon M.,10,0,10,0
1667917061932,MATH 218,A00,098029,Li; Bo,10,0,10,0
1667917062363,MATH 220B,A00,098030,Novak; Jonathan I,15,0,15,0
1667917062799,MATH 221A,A00,098031,Ebenfelt; Peter F,15,0,15,0
1667917063226,MATH 231B,A00,098032,Zlatos; Andrej,15,0,15,0
1667917063651,MATH 240B,A00,098033,Ni; Lei,13,0,15,2
1667917064086,MATH 243,A00,098034,Jekel; David Andrew,10,0,10,0
1667917064517,MATH 245A,A00,098035,Nie; Jiawang,6,0,15,9
1667917064940,MATH 248,A00,098036,Bejenaru; Ioan,10,0,10,0
1667917065376,MATH 250B,A00,098037,Spolaor; Luca,14,0,15,1
1667917065815,MATH 258,A00,098038,Ni; Lei,10,0,10,0
1667917066243,MATH 264B,A00,098041,Rhoades; Brendon Patrick,13,0,15,2
1667917066681,MATH 268,A00,098042,Buss; Samuel R,10,0,10,0
1667917067122,MATH 269,A00,098043,Rhoades; Brendon Patrick,10,0,10,0
1667917067576,MATH 270B,A00,098044,Li; Bo,13,0,15,2
1667917068032,MATH 272B,A00,098045,Holst; Michael J,13,0,15,2
1667917068467,MATH 273A,A00,098046,Tian; Xiaochuan,12,0,15,3
1667917068892,MATH 275,A01,098048,Tian; Xiaochuan,7,0,10,3
1667917069330,MATH 278A,A00,098049,Holst; Michael J,8,0,10,2
1667917069759,MATH 278B,A00,098050,Cloninger; Alexander,10,0,10,0
1667917070182,MATH 278C,A00,098051,Nie; Jiawang,9,0,10,1
1667917070618,MATH 280B,A00,098052,Zheng; Tianyi,12,0,15,3
1667917071050,MATH 281B,A00,098053,Bradic; Jelena,6,0,15,9
1667917071479,MATH 282B,A00,098054,Arias-Castro; Ery,2,0,15,13
1667917071909,MATH 285,A00,098055,Fitzsimmons; Patrick J,3,0,15,12
1667917072333,MATH 287B,A00,098056,Arias-Castro; Ery,9,0,15,6
1667917072767,MATH 288,A00,098057,Agarwal; Pooja,9,0,10,1
1667917072767,MATH 288,B00,098058,Zhang; Danna,9,0,10,1
1667917072767,MATH 288,C00,098059,Williams; Ruth J,10,0,10,0
1667917073204,MATH 290B,A00,098060,Roberts; Justin Deritter,14,0,15,1
1667917073645,MATH 292,A00,098061,Belmont; Eva Kinoshita,10,0,10,0
1667917074071,MATH 295,A00,098062,Suk; Andrew Hoon,48,0,50,2
1667917074500,MATH 296,A00,098063,Novak; Jonathan I,20,0,20,0
1667917075001,MATH 297,001,098064,Gamst; Anthony Collins,9997,0,9999,2
1667917584111,COGS 205,A00,101395,Chiba; Andrea,20,0,20,0
1667917584558,COGS 210B,001,101404,Greene; Deanna Jacquelyn,9998,0,9999,1
1667917584558,COGS 210B,002,101417,Xia; Haijun,9999,0,9999,0
1667917584558,COGS 210B,003,101422,Nitz; Douglas A.,9999,0,9999,0
1667917584558,COGS 210B,004,101423,Hollan; James D.,9998,0,9999,1
1667917584558,COGS 210B,005,101424,Deak; Gedeon O.,9999,0,9999,0
1667917584558,COGS 210B,006,101425,Rossano; Federico,9999,0,9999,0
1667917584988,COGS 211B,A00,101427,Coulson; Seana M,9997,0,9999,2
1667917585416,COGS 220,A00,101428,Hollan; James D.,0,0,25,25
1667917585853,COGS 229,A00,101429,Dow; Steven P,19,0,25,6
1667917586366,COGS 230,A00,101430,Klemmer; Scott R,13,0,17,4
1667917586789,COGS 234,A00,101431,Xia; Haijun,11,0,25,14
1667917587222,COGS 260,A00,101432,Kiyonaga; Anastasia,20,0,25,5
1667917587222,COGS 260,B00,101433,Kirsh; David Joel,18,0,25,7
1667917587662,CSE 202,A00,102371,Impagliazzo; Russell,0,0,0,0
1667917588091,CSE 203B,A01,102373,Cheng; Chung Kuan,0,0,0,0
1667917588520,CSE 208,A00,102374,Micciancio; Daniele,0,0,0,0
1667917588954,CSE 209A,A00,112895,Impagliazzo; Russell,0,0,15,15
1667917589385,CSE 209B,A00,108005,Bellare; Mihir,0,0,0,0
1667917589823,CSE 210,A00,113163,Coblenz; Michael J,0,0,0,0
1667917590269,CSE 219,A00,106111,Dow; Steven P,0,0,20,20
1667917590719,CSE 221,A00,102376,Voelker; Geoffrey M.,0,0,0,0
1667917591155,CSE 224,A01,102378,Porter; George M,0,0,0,0
1667917591591,CSE 229A,A00,102379,Savage; Stefan,0,0,0,0
1667917592026,CSE 229C,A00,102380,Munyaka; Imani N. S.,0,0,0,0
1667917592464,CSE 232B,A00,102382,Deutsch; Alin Bernard,0,0,0,0
1667917592889,CSE 234,A01,112904,Kumar; Arun Kumar,0,0,0,0
1667917593313,CSE 237A,A00,102383,Rosing; Tajana Simunic,0,0,0,0
1667917593740,CSE 239A,A00,102384,Deutsch; Alin Bernard,0,0,0,0
1667917594167,CSE 239B,A00,102385,Polikarpova; Nadezhda,0,0,0,0
1667917594604,CSE 240A,A00,102386,Pannuto; Patrick William,0,0,0,0
1667917595032,CSE 240B,A00,102387,Zhao; Jishen,0,0,0,0
1667917595462,CSE 241A,A00,106406,Kang; Mingu,0,0,0,0
1667917595891,CSE 249B,A00,102388,Kahng; Andrew Byun,0,0,8,8
1667917596338,CSE 251B,A01,102392,Cottrell; Garrison W,0,0,0,0
1667917596338,CSE 251B,A02,102393,Cottrell; Garrison W,0,0,0,0
1667917596772,CSE 252B,A00,102394,Ochoa; Benjamin Lawrence,0,0,0,0
1667917597203,CSE 257,A01,102396,Gao; Sicun,0,0,0,0
1667917597628,CSE 272,A00,102397,Li; Tzumao,0,0,0,0
1667917598079,CSE 274,A00,111323,Chern; Albert Ren-Haur,0,0,0,0
1667917598502,CSE 282,A00,102398,Pevzner; Pavel Arkadjevich,0,0,0,0
1667917598937,CSE 284,A00,114175,Gymrek; Melissa Ann,0,0,0,0
1667917599365,CSE 290,A00,102399,Chandraker; Manmohan Krishna,0,0,0,0
1667917599365,CSE 290,B00,102400,Vaccaro; Kristen Marie,0,0,25,25
1667917599365,CSE 290,C00,102414,Pannuto; Patrick William,0,0,25,25
1667917599365,CSE 290,D00,102427,Pevzner; Pavel Arkadjevich,0,0,0,0
1667917599365,CSE 290,E00,102429,Zhao; Jishen,0,0,0,0
1667917599365,CSE 290,F00,102436,Tullsen; Dean Michael,0,0,0,0
1667917599365,CSE 290,G00,102440,Christensen; Henrik I,0,0,20,20
1667917599812,CSE 291,A00,102443,Su; Hao,0,0,0,0
1667917599812,CSE 291,B00,102448,Polikarpova; Nadezhda,0,0,0,0
1667917599812,CSE 291,C00,102453,Vaccaro; Kristen Marie,0,0,0,0
1667917599812,CSE 291,D00,111343,Savage; Stefan,0,0,0,0
1667917599812,CSE 291,E00,116474,Claffy; Kimberly Claire,0,0,0,0
1667917599812,CSE 291,F00,116479,Pasquale; Joseph,0,0,0,0
1667917600236,CSE 293,001,119111,Bafna; Vineet,9999,0,9999,0
1667917600236,CSE 293,002,119118,Bellare; Mihir,9999,0,9999,0
1667917600236,CSE 293,003,119122,Berg-Kirkpatrick; Taylor D,9999,0,9999,0
1667917600236,CSE 293,004,119135,Christensen; Henrik I,9999,0,9999,0
1667917600236,CSE 293,005,119142,Cottrell; Garrison W,9999,0,9999,0
1667917600236,CSE 293,006,119146,Deutsch; Alin Bernard,9999,0,9999,0
1667917600236,CSE 293,007,119159,Esmaeilzadeh; Hadi,9999,0,9999,0
1667917600236,CSE 293,008,119166,Freund; Yoav,9999,0,9999,0
1667917600236,CSE 293,009,119170,Griswold; William G.,9999,0,9999,0
1667917600236,CSE 293,010,119183,Gymrek; Melissa Ann,9999,0,9999,0
1667917600236,CSE 293,011,119190,Heninger; Nadia A,9999,0,9999,0
1667917600236,CSE 293,012,119230,Impagliazzo; Russell,9999,0,9999,0
1667917600236,CSE 293,013,119232,Jhala; Ranjit,9999,0,9999,0
1667917600236,CSE 293,014,119233,Kahng; Andrew Byun,9999,0,9999,0
1667917600236,CSE 293,015,119298,Kane; Daniel Mertz,9999,0,9999,0
1667917600236,CSE 293,016,119299,Kriegman; David J,9999,0,9999,0
1667917600236,CSE 293,017,119300,Kumar; Arun Kumar,9999,0,9999,0
1667917600236,CSE 293,018,119301,Lerner; Sorin,9999,0,9999,0
1667917600236,CSE 293,019,119302,Lovett; Shachar,9999,0,9999,0
1667917600236,CSE 293,020,119303,McAuley; Julian John,9999,0,9999,0
1667917600236,CSE 293,021,119304,Micciancio; Daniele,9999,0,9999,0
1667917600236,CSE 293,022,119367,Orailoglu; Alex,9999,0,9999,0
1667917600236,CSE 293,023,119382,Paturi; Ramamohan,9999,0,9999,0
1667917600236,CSE 293,024,119404,Polikarpova; Nadezhda,9999,0,9999,0
1667917600236,CSE 293,025,119406,Politz; Joseph Gibbs,9999,0,9999,0
1667917600236,CSE 293,026,119411,Porter; George M,9999,0,9999,0
1667917600236,CSE 293,027,119414,Porter; Leonard Emerson,9999,0,9999,0
1667917600236,CSE 293,028,119416,Ramamoorthi; Ravi,9999,0,9999,0
1667917600236,CSE 293,029,119417,Sahoo; Debashis,9999,0,9999,0
1667917600236,CSE 293,030,119420,Saul; Lawrence,9999,0,9999,0
1667917600236,CSE 293,031,119421,Savage; Stefan,9999,0,9999,0
1667917600236,CSE 293,032,119425,Schulze; Jurgen P.,9999,0,9999,0
1667917600236,CSE 293,033,119426,Snoeren; Alex C.,9999,0,9999,0
1667917600236,CSE 293,034,119428,Shang; Jingbo,9999,0,9999,0
1667917600236,CSE 293,035,119430,Stefan; Deian,9999,0,9999,0
1667917600236,CSE 293,036,119431,Su; Hao,9999,0,9999,0
1667917600236,CSE 293,037,119433,Swanson; Steven James,9999,0,9999,0
1667917600236,CSE 293,038,119435,Tullsen; Dean Michael,9999,0,9999,0
1667917600236,CSE 293,039,119483,Voelker; Geoffrey M.,9999,0,9999,0
1667917600236,CSE 293,040,119537,Zhao; Jishen,9999,0,9999,0
1667917600236,CSE 293,041,119538,Zhou; Yuan-Yuan,9999,0,9999,0
1667917600236,CSE 293,042,119539,Gao; Sicun,9999,0,9999,0
1667917600236,CSE 293,043,119540,Weibel; Nadir,9999,0,9999,0
1667917600236,CSE 293,044,119541,Gupta; Rajesh K.,9999,0,9999,0
1667917600674,CSE 294,A00,102459,Voelker; Geoffrey M.,0,0,0,0
1667917600674,CSE 294,B00,111322,Orailoglu; Alex,0,0,0,0
1667917601101,DSE 201,A00,096914,Deutsch; Alin Bernard,30,0,30,0
1667917601529,DSE 210,A00,096915,Dasgupta; Sanjoy,30,0,30,0
1667917601952,DSE 260A,A00,096916,Altintas De Callaf; Ilkay,30,0,30,0
1667917602382,ECE 200,001,103586,Antipa; Nicholas A,9999,0,9999,0
1667917602382,ECE 200,002,103587,Atanasov; Nikolay A.,9999,0,9999,0
1667917602382,ECE 200,003,103588,Bharadia; Dinesh,9999,0,9999,0
1667917602382,ECE 200,004,103589,Cheng; Chung Kuan,9999,0,9999,0
1667917602382,ECE 200,005,103590,Cosman; Pamela C.,9999,0,9999,0
1667917602382,ECE 200,006,103591,Dayeh; Shadi Ahmad,9999,0,9999,0
1667917602382,ECE 200,007,103592,Fainman; Yeshaiahu,9999,0,9999,0
1667917602382,ECE 200,008,103593,Ford; Joseph Earl,9999,0,9999,0
1667917602382,ECE 200,009,103594,Franceschetti; Massimo,9999,0,9999,0
1667917602382,ECE 200,010,103595,Fullerton; Eric E,9999,0,9999,0
1667917602382,ECE 200,011,103596,Galton; Ian A,9999,0,9999,0
1667917602382,ECE 200,012,103597,Gilja; Vikash,9999,0,9999,0
1667917602382,ECE 200,013,103598,Hall; Drew A.,9999,0,9999,0
1667917602382,ECE 200,014,103599,Hsueh; Tzu-Chien,9999,0,9999,0
1667917602382,ECE 200,015,103600,Javidi; Tara,9999,0,9999,0
1667917602382,ECE 200,016,103601,Kahng; Andrew Byun,9999,0,9999,0
1667917602382,ECE 200,017,103602,Kim; Young-Han,9999,0,9999,0
1667917602382,ECE 200,018,103603,Koushanfar; Farinaz,9999,0,9999,0
1667917602382,ECE 200,019,103604,Kuzum; Duygu,9999,0,9999,0
1667917602382,ECE 200,020,103605,Le; Hanh-Phuc,9999,0,9999,0
1667917602382,ECE 200,021,103606,Lin; Bill,9999,0,9999,0
1667917602382,ECE 200,022,103607,Liu; Zhaowei,9998,0,9999,1
1667917602382,ECE 200,023,103608,Lo; Yu-Hwa,9999,0,9999,0
1667917602382,ECE 200,024,103609,Lomakin; Vitaliy,9999,0,9999,0
1667917602382,ECE 200,025,103610,Mercier; Patrick Philip,9999,0,9999,0
1667917602382,ECE 200,026,103611,Meyer; Florian,9999,0,9999,0
1667917602382,ECE 200,027,103612,Milstein; Laurence B.,9999,0,9999,0
1667917602382,ECE 200,028,103613,Mir Arabbaygi; Siavash,9999,0,9999,0
1667917602382,ECE 200,029,103614,Mookherjea; Shayan,9999,0,9999,0
1667917602382,ECE 200,030,103615,Morris; Karcher William,9999,0,9999,0
1667917602382,ECE 200,031,103616,Ng; Tse Nga,9999,0,9999,0
1667917602382,ECE 200,032,103617,Nguyen; Truong Quang,9999,0,9999,0
1667917602382,ECE 200,033,103618,Nomura; Kenji,9999,0,9999,0
1667917602382,ECE 200,034,103619,Orlitsky; Alon,9999,0,9999,0
1667917602382,ECE 200,035,103620,Pal; Piya,9999,0,9999,0
1667917602382,ECE 200,036,103621,Papen; George C.,9999,0,9999,0
1667917602382,ECE 200,037,103622,Radic; Stojan,9999,0,9999,0
1667917602382,ECE 200,038,103623,Rao; Bhaskar D.,9999,0,9999,0
1667917602382,ECE 200,039,103624,Rao; Ramesh R,9999,0,9999,0
1667917602382,ECE 200,040,103625,Rebeiz; Gabriel,9999,0,9999,0
1667917602382,ECE 200,041,103626,Sanford; John R,9999,0,9999,0
1667917602382,ECE 200,042,103627,Siegel; Paul H.,9999,0,9999,0
1667917602382,ECE 200,043,103628,Sievenpiper; Daniel F.,9999,0,9999,0
1667917602382,ECE 200,044,103629,Sworder; David D.,9999,0,9999,0
1667917602382,ECE 200,045,103630,Taur; Yuan,9999,0,9999,0
1667917602382,ECE 200,046,103631,Touri; Behrouz,9999,0,9999,0
1667917602382,ECE 200,047,103632,Trivedi; Mohan M.,9999,0,9999,0
1667917602382,ECE 200,048,103633,Vasconcelos; Nuno,9999,0,9999,0
1667917602382,ECE 200,049,103634,Wang; Xiaolong,9999,0,9999,0
1667917602382,ECE 200,050,103635,Xie; Pengtao,9999,0,9999,0
1667917602382,ECE 200,051,103636,Yip; Michael,9999,0,9999,0
1667917602382,ECE 200,052,103637,Zeger; Kenneth A.,999,0,999,0
1667917602382,ECE 200,053,103638,Zhang; Xinyu,9999,0,9999,0
1667917602382,ECE 200,054,103639,Turakhia; Yatish Girish,9999,0,9999,0
1667917602382,ECE 200,055,103640,Kang; Mingu,9999,0,9999,0
1667917602382,ECE 200,056,103641,Shi; Yuanyuan,9999,0,9999,0
1667917602382,ECE 200,057,103642,Wang; Edward Jay,9999,0,9999,0
1667917602382,ECE 200,058,103643,Zheng; Yang,9999,0,9999,0
1667917602828,ECE 202,A00,103644,Kuzum; Duygu,0,0,0,0
1667917603261,ECE 212BN,A00,103646,Ng; Tse Nga,0,0,0,0
1667917603697,ECE 221,A00,111493,Staff,0,0,0,0
1667917604131,ECE 222B,A00,103647,Lomakin; Vitaliy,0,0,0,0
1667917604630,ECE 230B,A00,103648,Taur; Yuan,0,0,0,0
1667917605054,ECE 238B,A00,103649,Garay; Javier,0,0,0,0
1667917605499,ECE 240B,A00,112900,Fainman; Yeshaiahu,0,0,0,0
1667917605928,ECE 247A,A00,103650,Jokerst; Jesse Vincent,0,0,0,0
1667917606362,ECE 247B,A00,103651,Wang; Joseph,0,0,0,0
1667917606787,ECE 250,A00,103652,Siegel; Paul H.,0,0,0,0
1667917607218,ECE 251A,A00,103654,Rao; Bhaskar D.,0,0,0,0
1667917607648,ECE 257B,A00,103655,Bharadia; Dinesh,0,0,0,0
1667917608078,ECE 258A,A00,103656,Milstein; Laurence B.,0,0,0,0
1667917608514,ECE 260B,A00,103658,Kang; Mingu,0,0,0,0
1667917608944,ECE 264A,A00,103659,Galton; Ian A,0,0,0,0
1667917609374,ECE 265A,A00,103661,Gudem; Prasad S.S.,0,0,0,0
1667917609804,ECE 265D,A00,103662,Gudem; Prasad S.S.,0,0,0,0
1667917610231,ECE 268,A00,103663,Koushanfar; Farinaz,0,0,0,0
1667917610662,ECE 269,A01,103665,Pal; Piya,0,0,0,0
1667917611097,ECE 271B,A00,103666,Vasconcelos; Manuela,0,0,0,0
1667917611521,ECE 276A,A00,103667,Atanasov; Nikolay A.,0,0,0,0
1667917611965,ECE 277,A00,103668,An; Cheolhong,0,0,0,0
1667917612392,ECE 279,A00,117947,Hall; Drew A.,0,0,0,0
1667917613251,ECE 283,A00,103670,Hsueh; Tzu-Chien,0,0,0,0
1667917613686,ECE 284,A00,103671,Turakhia; Yatish Girish,0,0,0,0
1667917614123,ECE 285,A00,103672,Zheng; Yang,0,0,0,0
1667917614123,ECE 285,B00,103673,Sworder; David D.,0,0,0,0
1667917614550,ECE 287,A00,103676,Javidi; Tara,0,0,0,0
1667917614997,MATH 200B,A00,098023,Salehi Golsefidy; Alireza,15,0,15,0
1667917615426,MATH 202B,A00,098024,Rhoades; Brendon Patrick,14,0,15,1
1667917615852,MATH 203B,A00,098025,Oprea; Dragos N.,14,0,15,1
1667917616277,MATH 204B,A00,098026,Sorensen; Claus M,15,0,15,0
1667917616708,MATH 208,A00,098027,Izadi; Elham,7,0,10,3
1667917617133,MATH 209,A00,098028,Pollack; Aaron,10,0,10,0
1667917617564,MATH 211A,A00,112919,Rogalski; Daniel,10,0,10,0
1667917617994,MATH 211B,A00,112920,Seward; Brandon M.,10,0,10,0
1667917618430,MATH 218,A00,098029,Li; Bo,10,0,10,0
1667917618854,MATH 220B,A00,098030,Novak; Jonathan I,15,0,15,0
1667917619290,MATH 221A,A00,098031,Ebenfelt; Peter F,15,0,15,0
1667917619715,MATH 231B,A00,098032,Zlatos; Andrej,15,0,15,0
1667917620162,MATH 240B,A00,098033,Ni; Lei,13,0,15,2
1667917620591,MATH 243,A00,098034,Jekel; David Andrew,10,0,10,0
1667917621024,MATH 245A,A00,098035,Nie; Jiawang,6,0,15,9
1667917621455,MATH 248,A00,098036,Bejenaru; Ioan,10,0,10,0
1667917621883,MATH 250B,A00,098037,Spolaor; Luca,14,0,15,1
1667917622307,MATH 258,A00,098038,Ni; Lei,10,0,10,0
1667917622735,MATH 264B,A00,098041,Rhoades; Brendon Patrick,13,0,15,2
1667917623166,MATH 268,A00,098042,Buss; Samuel R,10,0,10,0
1667917623628,MATH 269,A00,098043,Rhoades; Brendon Patrick,10,0,10,0
1667917624053,MATH 270B,A00,098044,Li; Bo,13,0,15,2
1667917624489,MATH 272B,A00,098045,Holst; Michael J,13,0,15,2
1667917624914,MATH 273A,A00,098046,Tian; Xiaochuan,12,0,15,3
1667917625344,MATH 275,A01,098048,Tian; Xiaochuan,7,0,10,3
1667917625787,MATH 278A,A00,098049,Holst; Michael J,8,0,10,2
1667917626230,MATH 278B,A00,098050,Cloninger; Alexander,10,0,10,0
1667917626666,MATH 278C,A00,098051,Nie; Jiawang,9,0,10,1
1667917627100,MATH 280B,A00,098052,Zheng; Tianyi,12,0,15,3
1667917627538,MATH 281B,A00,098053,Bradic; Jelena,6,0,15,9
1667917627965,MATH 282B,A00,098054,Arias-Castro; Ery,2,0,15,13
1667917628391,MATH 285,A00,098055,Fitzsimmons; Patrick J,3,0,15,12
1667917628824,MATH 287B,A00,098056,Arias-Castro; Ery,9,0,15,6
1667917629261,MATH 288,A00,098057,Agarwal; Pooja,9,0,10,1
1667917629261,MATH 288,B00,098058,Zhang; Danna,9,0,10,1
1667917629261,MATH 288,C00,098059,Williams; Ruth J,10,0,10,0
1667917629700,MATH 290B,A00,098060,Roberts; Justin Deritter,14,0,15,1
1667917630139,MATH 292,A00,098061,Belmont; Eva Kinoshita,10,0,10,0
1667917630564,MATH 295,A00,098062,Suk; Andrew Hoon,48,0,50,2
1667917631002,MATH 296,A00,098063,Novak; Jonathan I,20,0,20,0
1667917631436,MATH 297,001,098064,Gamst; Anthony Collins,9997,0,9999,2
1667918140197,COGS 205,A00,101395,Chiba; Andrea,20,0,20,0
1667918140639,COGS 210B,001,101404,Greene; Deanna Jacquelyn,9998,0,9999,1
1667918140639,COGS 210B,002,101417,Xia; Haijun,9999,0,9999,0
1667918140639,COGS 210B,003,101422,Nitz; Douglas A.,9999,0,9999,0
1667918140639,COGS 210B,004,101423,Hollan; James D.,9998,0,9999,1
1667918140639,COGS 210B,005,101424,Deak; Gedeon O.,9999,0,9999,0
1667918140639,COGS 210B,006,101425,Rossano; Federico,9999,0,9999,0
1667918141071,COGS 211B,A00,101427,Coulson; Seana M,9997,0,9999,2
1667918141501,COGS 220,A00,101428,Hollan; James D.,0,0,25,25
1667918141942,COGS 229,A00,101429,Dow; Steven P,19,0,25,6
1667918142369,COGS 230,A00,101430,Klemmer; Scott R,13,0,17,4
1667918142793,COGS 234,A00,101431,Xia; Haijun,11,0,25,14
1667918143252,COGS 260,A00,101432,Kiyonaga; Anastasia,20,0,25,5
1667918143252,COGS 260,B00,101433,Kirsh; David Joel,18,0,25,7
1667918143703,CSE 202,A00,102371,Impagliazzo; Russell,0,0,0,0
1667918144144,CSE 203B,A01,102373,Cheng; Chung Kuan,0,0,0,0
1667918144587,CSE 208,A00,102374,Micciancio; Daniele,0,0,0,0
1667918145036,CSE 209A,A00,112895,Impagliazzo; Russell,0,0,15,15
1667918145464,CSE 209B,A00,108005,Bellare; Mihir,0,0,0,0
1667918145906,CSE 210,A00,113163,Coblenz; Michael J,0,0,0,0
1667918146338,CSE 219,A00,106111,Dow; Steven P,0,0,20,20
1667918146783,CSE 221,A00,102376,Voelker; Geoffrey M.,0,0,0,0
1667918147221,CSE 224,A01,102378,Porter; George M,0,0,0,0
1667918147654,CSE 229A,A00,102379,Savage; Stefan,0,0,0,0
1667918148080,CSE 229C,A00,102380,Munyaka; Imani N. S.,0,0,0,0
1667918148524,CSE 232B,A00,102382,Deutsch; Alin Bernard,0,0,0,0
1667918148955,CSE 234,A01,112904,Kumar; Arun Kumar,0,0,0,0
1667918149397,CSE 237A,A00,102383,Rosing; Tajana Simunic,0,0,0,0
1667918149827,CSE 239A,A00,102384,Deutsch; Alin Bernard,0,0,0,0
1667918150252,CSE 239B,A00,102385,Polikarpova; Nadezhda,0,0,0,0
1667918150679,CSE 240A,A00,102386,Pannuto; Patrick William,0,0,0,0
1667918151109,CSE 240B,A00,102387,Zhao; Jishen,0,0,0,0
1667918151533,CSE 241A,A00,106406,Kang; Mingu,0,0,0,0
1667918152033,CSE 249B,A00,102388,Kahng; Andrew Byun,0,0,8,8
1667918152469,CSE 251B,A01,102392,Cottrell; Garrison W,0,0,0,0
1667918152469,CSE 251B,A02,102393,Cottrell; Garrison W,0,0,0,0
1667918152899,CSE 252B,A00,102394,Ochoa; Benjamin Lawrence,0,0,0,0
1667918153343,CSE 257,A01,102396,Gao; Sicun,0,0,0,0
1667918153773,CSE 272,A00,102397,Li; Tzumao,0,0,0,0
1667918154207,CSE 274,A00,111323,Chern; Albert Ren-Haur,0,0,0,0
1667918154642,CSE 282,A00,102398,Pevzner; Pavel Arkadjevich,0,0,0,0
1667918155068,CSE 284,A00,114175,Gymrek; Melissa Ann,0,0,0,0
1667918155516,CSE 290,A00,102399,Chandraker; Manmohan Krishna,0,0,0,0
1667918155516,CSE 290,B00,102400,Vaccaro; Kristen Marie,0,0,25,25
1667918155516,CSE 290,C00,102414,Pannuto; Patrick William,0,0,25,25
1667918155516,CSE 290,D00,102427,Pevzner; Pavel Arkadjevich,0,0,0,0
1667918155516,CSE 290,E00,102429,Zhao; Jishen,0,0,0,0
1667918155516,CSE 290,F00,102436,Tullsen; Dean Michael,0,0,0,0
1667918155516,CSE 290,G00,102440,Christensen; Henrik I,0,0,20,20
1667918155955,CSE 291,A00,102443,Su; Hao,0,0,0,0
1667918155955,CSE 291,B00,102448,Polikarpova; Nadezhda,0,0,0,0
1667918155955,CSE 291,C00,102453,Vaccaro; Kristen Marie,0,0,0,0
1667918155955,CSE 291,D00,111343,Savage; Stefan,0,0,0,0
1667918155955,CSE 291,E00,116474,Claffy; Kimberly Claire,0,0,0,0
1667918155955,CSE 291,F00,116479,Pasquale; Joseph,0,0,0,0
1667918156382,CSE 293,001,119111,Bafna; Vineet,9999,0,9999,0
1667918156382,CSE 293,002,119118,Bellare; Mihir,9999,0,9999,0
1667918156382,CSE 293,003,119122,Berg-Kirkpatrick; Taylor D,9999,0,9999,0
1667918156382,CSE 293,004,119135,Christensen; Henrik I,9999,0,9999,0
1667918156382,CSE 293,005,119142,Cottrell; Garrison W,9999,0,9999,0
1667918156382,CSE 293,006,119146,Deutsch; Alin Bernard,9999,0,9999,0
1667918156382,CSE 293,007,119159,Esmaeilzadeh; Hadi,9999,0,9999,0
1667918156382,CSE 293,008,119166,Freund; Yoav,9999,0,9999,0
1667918156382,CSE 293,009,119170,Griswold; William G.,9999,0,9999,0
1667918156382,CSE 293,010,119183,Gymrek; Melissa Ann,9999,0,9999,0
1667918156382,CSE 293,011,119190,Heninger; Nadia A,9999,0,9999,0
1667918156382,CSE 293,012,119230,Impagliazzo; Russell,9999,0,9999,0
1667918156382,CSE 293,013,119232,Jhala; Ranjit,9999,0,9999,0
1667918156382,CSE 293,014,119233,Kahng; Andrew Byun,9999,0,9999,0
1667918156382,CSE 293,015,119298,Kane; Daniel Mertz,9999,0,9999,0
1667918156382,CSE 293,016,119299,Kriegman; David J,9999,0,9999,0
1667918156382,CSE 293,017,119300,Kumar; Arun Kumar,9999,0,9999,0
1667918156382,CSE 293,018,119301,Lerner; Sorin,9999,0,9999,0
1667918156382,CSE 293,019,119302,Lovett; Shachar,9999,0,9999,0
1667918156382,CSE 293,020,119303,McAuley; Julian John,9999,0,9999,0
1667918156382,CSE 293,021,119304,Micciancio; Daniele,9999,0,9999,0
1667918156382,CSE 293,022,119367,Orailoglu; Alex,9999,0,9999,0
1667918156382,CSE 293,023,119382,Paturi; Ramamohan,9999,0,9999,0
1667918156382,CSE 293,024,119404,Polikarpova; Nadezhda,9999,0,9999,0
1667918156382,CSE 293,025,119406,Politz; Joseph Gibbs,9999,0,9999,0
1667918156382,CSE 293,026,119411,Porter; George M,9999,0,9999,0
1667918156382,CSE 293,027,119414,Porter; Leonard Emerson,9999,0,9999,0
1667918156382,CSE 293,028,119416,Ramamoorthi; Ravi,9999,0,9999,0
1667918156382,CSE 293,029,119417,Sahoo; Debashis,9999,0,9999,0
1667918156382,CSE 293,030,119420,Saul; Lawrence,9999,0,9999,0
1667918156382,CSE 293,031,119421,Savage; Stefan,9999,0,9999,0
1667918156382,CSE 293,032,119425,Schulze; Jurgen P.,9999,0,9999,0
1667918156382,CSE 293,033,119426,Snoeren; Alex C.,9999,0,9999,0
1667918156382,CSE 293,034,119428,Shang; Jingbo,9999,0,9999,0
1667918156382,CSE 293,035,119430,Stefan; Deian,9999,0,9999,0
1667918156382,CSE 293,036,119431,Su; Hao,9999,0,9999,0
1667918156382,CSE 293,037,119433,Swanson; Steven James,9999,0,9999,0
1667918156382,CSE 293,038,119435,Tullsen; Dean Michael,9999,0,9999,0
1667918156382,CSE 293,039,119483,Voelker; Geoffrey M.,9999,0,9999,0
1667918156382,CSE 293,040,119537,Zhao; Jishen,9999,0,9999,0
1667918156382,CSE 293,041,119538,Zhou; Yuan-Yuan,9999,0,9999,0
1667918156382,CSE 293,042,119539,Gao; Sicun,9999,0,9999,0
1667918156382,CSE 293,043,119540,Weibel; Nadir,9999,0,9999,0
1667918156382,CSE 293,044,119541,Gupta; Rajesh K.,9999,0,9999,0
1667918156815,CSE 294,A00,102459,Voelker; Geoffrey M.,0,0,0,0
1667918156815,CSE 294,B00,111322,Orailoglu; Alex,0,0,0,0
1667918157260,DSE 201,A00,096914,Deutsch; Alin Bernard,30,0,30,0
1667918157689,DSE 210,A00,096915,Dasgupta; Sanjoy,30,0,30,0
1667918158149,DSE 260A,A00,096916,Altintas De Callaf; Ilkay,30,0,30,0
1667918158578,ECE 200,001,103586,Antipa; Nicholas A,9999,0,9999,0
1667918158578,ECE 200,002,103587,Atanasov; Nikolay A.,9999,0,9999,0
1667918158578,ECE 200,003,103588,Bharadia; Dinesh,9999,0,9999,0
1667918158578,ECE 200,004,103589,Cheng; Chung Kuan,9999,0,9999,0
1667918158578,ECE 200,005,103590,Cosman; Pamela C.,9999,0,9999,0
1667918158578,ECE 200,006,103591,Dayeh; Shadi Ahmad,9999,0,9999,0
1667918158578,ECE 200,007,103592,Fainman; Yeshaiahu,9999,0,9999,0
1667918158578,ECE 200,008,103593,Ford; Joseph Earl,9999,0,9999,0
1667918158578,ECE 200,009,103594,Franceschetti; Massimo,9999,0,9999,0
1667918158578,ECE 200,010,103595,Fullerton; Eric E,9999,0,9999,0
1667918158578,ECE 200,011,103596,Galton; Ian A,9999,0,9999,0
1667918158578,ECE 200,012,103597,Gilja; Vikash,9999,0,9999,0
1667918158578,ECE 200,013,103598,Hall; Drew A.,9999,0,9999,0
1667918158578,ECE 200,014,103599,Hsueh; Tzu-Chien,9999,0,9999,0
1667918158578,ECE 200,015,103600,Javidi; Tara,9999,0,9999,0
1667918158578,ECE 200,016,103601,Kahng; Andrew Byun,9999,0,9999,0
1667918158578,ECE 200,017,103602,Kim; Young-Han,9999,0,9999,0
1667918158578,ECE 200,018,103603,Koushanfar; Farinaz,9999,0,9999,0
1667918158578,ECE 200,019,103604,Kuzum; Duygu,9999,0,9999,0
1667918158578,ECE 200,020,103605,Le; Hanh-Phuc,9999,0,9999,0
1667918158578,ECE 200,021,103606,Lin; Bill,9999,0,9999,0
1667918158578,ECE 200,022,103607,Liu; Zhaowei,9998,0,9999,1
1667918158578,ECE 200,023,103608,Lo; Yu-Hwa,9999,0,9999,0
1667918158578,ECE 200,024,103609,Lomakin; Vitaliy,9999,0,9999,0
1667918158578,ECE 200,025,103610,Mercier; Patrick Philip,9999,0,9999,0
1667918158578,ECE 200,026,103611,Meyer; Florian,9999,0,9999,0
1667918158578,ECE 200,027,103612,Milstein; Laurence B.,9999,0,9999,0
1667918158578,ECE 200,028,103613,Mir Arabbaygi; Siavash,9999,0,9999,0
1667918158578,ECE 200,029,103614,Mookherjea; Shayan,9999,0,9999,0
1667918158578,ECE 200,030,103615,Morris; Karcher William,9999,0,9999,0
1667918158578,ECE 200,031,103616,Ng; Tse Nga,9999,0,9999,0
1667918158578,ECE 200,032,103617,Nguyen; Truong Quang,9999,0,9999,0
1667918158578,ECE 200,033,103618,Nomura; Kenji,9999,0,9999,0
1667918158578,ECE 200,034,103619,Orlitsky; Alon,9999,0,9999,0
1667918158578,ECE 200,035,103620,Pal; Piya,9999,0,9999,0
1667918158578,ECE 200,036,103621,Papen; George C.,9999,0,9999,0
1667918158578,ECE 200,037,103622,Radic; Stojan,9999,0,9999,0
1667918158578,ECE 200,038,103623,Rao; Bhaskar D.,9999,0,9999,0
1667918158578,ECE 200,039,103624,Rao; Ramesh R,9999,0,9999,0
1667918158578,ECE 200,040,103625,Rebeiz; Gabriel,9999,0,9999,0
1667918158578,ECE 200,041,103626,Sanford; John R,9999,0,9999,0
1667918158578,ECE 200,042,103627,Siegel; Paul H.,9999,0,9999,0
1667918158578,ECE 200,043,103628,Sievenpiper; Daniel F.,9999,0,9999,0
1667918158578,ECE 200,044,103629,Sworder; David D.,9999,0,9999,0
1667918158578,ECE 200,045,103630,Taur; Yuan,9999,0,9999,0
1667918158578,ECE 200,046,103631,Touri; Behrouz,9999,0,9999,0
1667918158578,ECE 200,047,103632,Trivedi; Mohan M.,9999,0,9999,0
1667918158578,ECE 200,048,103633,Vasconcelos; Nuno,9999,0,9999,0
1667918158578,ECE 200,049,103634,Wang; Xiaolong,9999,0,9999,0
1667918158578,ECE 200,050,103635,Xie; Pengtao,9999,0,9999,0
1667918158578,ECE 200,051,103636,Yip; Michael,9999,0,9999,0
1667918158578,ECE 200,052,103637,Zeger; Kenneth A.,999,0,999,0
1667918158578,ECE 200,053,103638,Zhang; Xinyu,9999,0,9999,0
1667918158578,ECE 200,054,103639,Turakhia; Yatish Girish,9999,0,9999,0
1667918158578,ECE 200,055,103640,Kang; Mingu,9999,0,9999,0
1667918158578,ECE 200,056,103641,Shi; Yuanyuan,9999,0,9999,0
1667918158578,ECE 200,057,103642,Wang; Edward Jay,9999,0,9999,0
1667918158578,ECE 200,058,103643,Zheng; Yang,9999,0,9999,0
1667918159017,ECE 202,A00,103644,Kuzum; Duygu,0,0,0,0
1667918159450,ECE 212BN,A00,103646,Ng; Tse Nga,0,0,0,0
1667918159878,ECE 221,A00,111493,Staff,0,0,0,0
1667918160309,ECE 222B,A00,103647,Lomakin; Vitaliy,0,0,0,0
1667918160759,ECE 230B,A00,103648,Taur; Yuan,0,0,0,0
1667918161209,ECE 238B,A00,103649,Garay; Javier,0,0,0,0
1667918161668,ECE 240B,A00,112900,Fainman; Yeshaiahu,0,0,0,0
1667918162100,ECE 247A,A00,103650,Jokerst; Jesse Vincent,0,0,0,0
1667918162534,ECE 247B,A00,103651,Wang; Joseph,0,0,0,0
1667918162965,ECE 250,A00,103652,Siegel; Paul H.,0,0,0,0
1667918163400,ECE 251A,A00,103654,Rao; Bhaskar D.,0,0,0,0
1667918163852,ECE 257B,A00,103655,Bharadia; Dinesh,0,0,0,0
1667918164285,ECE 258A,A00,103656,Milstein; Laurence B.,0,0,0,0
1667918164750,ECE 260B,A00,103658,Kang; Mingu,0,0,0,0
1667918165178,ECE 264A,A00,103659,Galton; Ian A,0,0,0,0
1667918165646,ECE 265A,A00,103661,Gudem; Prasad S.S.,0,0,0,0
1667918166074,ECE 265D,A00,103662,Gudem; Prasad S.S.,0,0,0,0
1667918166511,ECE 268,A00,103663,Koushanfar; Farinaz,0,0,0,0
1667918166939,ECE 269,A01,103665,Pal; Piya,0,0,0,0
1667918167369,ECE 271B,A00,103666,Vasconcelos; Manuela,0,0,0,0
1667918167801,ECE 276A,A00,103667,Atanasov; Nikolay A.,0,0,0,0
1667918168225,ECE 277,A00,103668,An; Cheolhong,0,0,0,0
1667918168656,ECE 279,A00,117947,Hall; Drew A.,0,0,0,0
1667918169523,ECE 283,A00,103670,Hsueh; Tzu-Chien,0,0,0,0
1667918169958,ECE 284,A00,103671,Turakhia; Yatish Girish,0,0,0,0
1667918170382,ECE 285,A00,103672,Zheng; Yang,0,0,0,0
1667918170382,ECE 285,B00,103673,Sworder; David D.,0,0,0,0
1667918170825,ECE 287,A00,103676,Javidi; Tara,0,0,0,0
1667918171266,MATH 200B,A00,098023,Salehi Golsefidy; Alireza,15,0,15,0
1667918171696,MATH 202B,A00,098024,Rhoades; Brendon Patrick,14,0,15,1
1667918172127,MATH 203B,A00,098025,Oprea; Dragos N.,14,0,15,1
1667918172558,MATH 204B,A00,098026,Sorensen; Claus M,15,0,15,0
1667918173001,MATH 208,A00,098027,Izadi; Elham,7,0,10,3
1667918173427,MATH 209,A00,098028,Pollack; Aaron,10,0,10,0
1667918173865,MATH 211A,A00,112919,Rogalski; Daniel,10,0,10,0
1667918174303,MATH 211B,A00,112920,Seward; Brandon M.,10,0,10,0
1667918174732,MATH 218,A00,098029,Li; Bo,10,0,10,0
1667918175161,MATH 220B,A00,098030,Novak; Jonathan I,15,0,15,0
1667918175588,MATH 221A,A00,098031,Ebenfelt; Peter F,15,0,15,0
1667918176015,MATH 231B,A00,098032,Zlatos; Andrej,15,0,15,0
1667918176445,MATH 240B,A00,098033,Ni; Lei,13,0,15,2
1667918176894,MATH 243,A00,098034,Jekel; David Andrew,10,0,10,0
1667918177333,MATH 245A,A00,098035,Nie; Jiawang,6,0,15,9
1667918177859,MATH 248,A00,098036,Bejenaru; Ioan,10,0,10,0
1667918178288,MATH 250B,A00,098037,Spolaor; Luca,14,0,15,1
1667918178718,MATH 258,A00,098038,Ni; Lei,10,0,10,0
1667918179149,MATH 264B,A00,098041,Rhoades; Brendon Patrick,13,0,15,2
1667918179576,MATH 268,A00,098042,Buss; Samuel R,10,0,10,0
1667918180004,MATH 269,A00,098043,Rhoades; Brendon Patrick,10,0,10,0
1667918180433,MATH 270B,A00,098044,Li; Bo,13,0,15,2
1667918180862,MATH 272B,A00,098045,Holst; Michael J,13,0,15,2
1667918181294,MATH 273A,A00,098046,Tian; Xiaochuan,12,0,15,3
1667918181726,MATH 275,A01,098048,Tian; Xiaochuan,7,0,10,3
1667918182152,MATH 278A,A00,098049,Holst; Michael J,8,0,10,2
1667918182603,MATH 278B,A00,098050,Cloninger; Alexander,10,0,10,0
1667918183053,MATH 278C,A00,098051,Nie; Jiawang,9,0,10,1
1667918183487,MATH 280B,A00,098052,Zheng; Tianyi,12,0,15,3
1667918183920,MATH 281B,A00,098053,Bradic; Jelena,6,0,15,9
1667918184360,MATH 282B,A00,098054,Arias-Castro; Ery,2,0,15,13
1667918184793,MATH 285,A00,098055,Fitzsimmons; Patrick J,3,0,15,12
1667918185224,MATH 287B,A00,098056,Arias-Castro; Ery,9,0,15,6
1667918185654,MATH 288,A00,098057,Agarwal; Pooja,9,0,10,1
1667918185654,MATH 288,B00,098058,Zhang; Danna,9,0,10,1
1667918185654,MATH 288,C00,098059,Williams; Ruth J,10,0,10,0
1667918186084,MATH 290B,A00,098060,Roberts; Justin Deritter,14,0,15,1
1667918186513,MATH 292,A00,098061,Belmont; Eva Kinoshita,10,0,10,0
1667918186955,MATH 295,A00,098062,Suk; Andrew Hoon,48,0,50,2
1667918187381,MATH 296,A00,098063,Novak; Jonathan I,20,0,20,0
1667918187804,MATH 297,001,098064,Gamst; Anthony Collins,9997,0,9999,2
1667918697909,COGS 205,A00,101395,Chiba; Andrea,20,0,20,0
1667918698338,COGS 210B,001,101404,Greene; Deanna Jacquelyn,9998,0,9999,1
1667918698338,COGS 210B,002,101417,Xia; Haijun,9999,0,9999,0
1667918698338,COGS 210B,003,101422,Nitz; Douglas A.,9999,0,9999,0
1667918698338,COGS 210B,004,101423,Hollan; James D.,9998,0,9999,1
1667918698338,COGS 210B,005,101424,Deak; Gedeon O.,9999,0,9999,0
1667918698338,COGS 210B,006,101425,Rossano; Federico,9999,0,9999,0
1667918698784,COGS 211B,A00,101427,Coulson; Seana M,9997,0,9999,2
1667918699223,COGS 220,A00,101428,Hollan; James D.,0,0,25,25
1667918699652,COGS 229,A00,101429,Dow; Steven P,19,0,25,6
1667918700077,COGS 230,A00,101430,Klemmer; Scott R,13,0,17,4
1667918700524,COGS 234,A00,101431,Xia; Haijun,11,0,25,14
1667918700962,COGS 260,A00,101432,Kiyonaga; Anastasia,20,0,25,5
1667918700962,COGS 260,B00,101433,Kirsh; David Joel,18,0,25,7
1667918701394,CSE 202,A00,102371,Impagliazzo; Russell,0,0,0,0
1667918701827,CSE 203B,A01,102373,Cheng; Chung Kuan,0,0,0,0
1667918702270,CSE 208,A00,102374,Micciancio; Daniele,0,0,0,0
1667918702702,CSE 209A,A00,112895,Impagliazzo; Russell,0,0,15,15
1667918703132,CSE 209B,A00,108005,Bellare; Mihir,0,0,0,0
1667918703560,CSE 210,A00,113163,Coblenz; Michael J,0,0,0,0
1667918703982,CSE 219,A00,106111,Dow; Steven P,0,0,20,20
1667918704410,CSE 221,A00,102376,Voelker; Geoffrey M.,0,0,0,0
1667918704848,CSE 224,A01,102378,Porter; George M,0,0,0,0
1667918705279,CSE 229A,A00,102379,Savage; Stefan,0,0,0,0
1667918705704,CSE 229C,A00,102380,Munyaka; Imani N. S.,0,0,0,0
1667918706132,CSE 232B,A00,102382,Deutsch; Alin Bernard,0,0,0,0
1667918706556,CSE 234,A01,112904,Kumar; Arun Kumar,0,0,0,0
1667918706981,CSE 237A,A00,102383,Rosing; Tajana Simunic,0,0,0,0
1667918707405,CSE 239A,A00,102384,Deutsch; Alin Bernard,0,0,0,0
1667918707831,CSE 239B,A00,102385,Polikarpova; Nadezhda,0,0,0,0
1667918708353,CSE 240A,A00,102386,Pannuto; Patrick William,0,0,0,0
1667918708780,CSE 240B,A00,102387,Zhao; Jishen,0,0,0,0
1667918709214,CSE 241A,A00,106406,Kang; Mingu,0,0,0,0
1667918709643,CSE 249B,A00,102388,Kahng; Andrew Byun,0,0,8,8
1667918710076,CSE 251B,A01,102392,Cottrell; Garrison W,0,0,0,0
1667918710076,CSE 251B,A02,102393,Cottrell; Garrison W,0,0,0,0
1667918710520,CSE 252B,A00,102394,Ochoa; Benjamin Lawrence,0,0,0,0
1667918710955,CSE 257,A01,102396,Gao; Sicun,0,0,0,0
1667918711382,CSE 272,A00,102397,Li; Tzumao,0,0,0,0
1667918711809,CSE 274,A00,111323,Chern; Albert Ren-Haur,0,0,0,0
1667918712235,CSE 282,A00,102398,Pevzner; Pavel Arkadjevich,0,0,0,0
1667918712665,CSE 284,A00,114175,Gymrek; Melissa Ann,0,0,0,0
1667918713095,CSE 290,A00,102399,Chandraker; Manmohan Krishna,0,0,0,0
1667918713095,CSE 290,B00,102400,Vaccaro; Kristen Marie,0,0,25,25
1667918713095,CSE 290,C00,102414,Pannuto; Patrick William,0,0,25,25
1667918713095,CSE 290,D00,102427,Pevzner; Pavel Arkadjevich,0,0,0,0
1667918713095,CSE 290,E00,102429,Zhao; Jishen,0,0,0,0
1667918713095,CSE 290,F00,102436,Tullsen; Dean Michael,0,0,0,0
1667918713095,CSE 290,G00,102440,Christensen; Henrik I,0,0,20,20
1667918713529,CSE 291,A00,102443,Su; Hao,0,0,0,0
1667918713529,CSE 291,B00,102448,Polikarpova; Nadezhda,0,0,0,0
1667918713529,CSE 291,C00,102453,Vaccaro; Kristen Marie,0,0,0,0
1667918713529,CSE 291,D00,111343,Savage; Stefan,0,0,0,0
1667918713529,CSE 291,E00,116474,Claffy; Kimberly Claire,0,0,0,0
1667918713529,CSE 291,F00,116479,Pasquale; Joseph,0,0,0,0
1667918713970,CSE 293,001,119111,Bafna; Vineet,9999,0,9999,0
1667918713970,CSE 293,002,119118,Bellare; Mihir,9999,0,9999,0
1667918713970,CSE 293,003,119122,Berg-Kirkpatrick; Taylor D,9999,0,9999,0
1667918713970,CSE 293,004,119135,Christensen; Henrik I,9999,0,9999,0
1667918713970,CSE 293,005,119142,Cottrell; Garrison W,9999,0,9999,0
1667918713970,CSE 293,006,119146,Deutsch; Alin Bernard,9999,0,9999,0
1667918713970,CSE 293,007,119159,Esmaeilzadeh; Hadi,9999,0,9999,0
1667918713970,CSE 293,008,119166,Freund; Yoav,9999,0,9999,0
1667918713970,CSE 293,009,119170,Griswold; William G.,9999,0,9999,0
1667918713970,CSE 293,010,119183,Gymrek; Melissa Ann,9999,0,9999,0
1667918713970,CSE 293,011,119190,Heninger; Nadia A,9999,0,9999,0
1667918713970,CSE 293,012,119230,Impagliazzo; Russell,9999,0,9999,0
1667918713970,CSE 293,013,119232,Jhala; Ranjit,9999,0,9999,0
1667918713970,CSE 293,014,119233,Kahng; Andrew Byun,9999,0,9999,0
1667918713970,CSE 293,015,119298,Kane; Daniel Mertz,9999,0,9999,0
1667918713970,CSE 293,016,119299,Kriegman; David J,9999,0,9999,0
1667918713970,CSE 293,017,119300,Kumar; Arun Kumar,9999,0,9999,0
1667918713970,CSE 293,018,119301,Lerner; Sorin,9999,0,9999,0
1667918713970,CSE 293,019,119302,Lovett; Shachar,9999,0,9999,0
1667918713970,CSE 293,020,119303,McAuley; Julian John,9999,0,9999,0
1667918713970,CSE 293,021,119304,Micciancio; Daniele,9999,0,9999,0
1667918713970,CSE 293,022,119367,Orailoglu; Alex,9999,0,9999,0
1667918713970,CSE 293,023,119382,Paturi; Ramamohan,9999,0,9999,0
1667918713970,CSE 293,024,119404,Polikarpova; Nadezhda,9999,0,9999,0
1667918713970,CSE 293,025,119406,Politz; Joseph Gibbs,9999,0,9999,0
1667918713970,CSE 293,026,119411,Porter; George M,9999,0,9999,0
1667918713970,CSE 293,027,119414,Porter; Leonard Emerson,9999,0,9999,0
1667918713970,CSE 293,028,119416,Ramamoorthi; Ravi,9999,0,9999,0
1667918713970,CSE 293,029,119417,Sahoo; Debashis,9999,0,9999,0
1667918713970,CSE 293,030,119420,Saul; Lawrence,9999,0,9999,0
1667918713970,CSE 293,031,119421,Savage; Stefan,9999,0,9999,0
1667918713970,CSE 293,032,119425,Schulze; Jurgen P.,9999,0,9999,0
1667918713970,CSE 293,033,119426,Snoeren; Alex C.,9999,0,9999,0
1667918713970,CSE 293,034,119428,Shang; Jingbo,9999,0,9999,0
1667918713970,CSE 293,035,119430,Stefan; Deian,9999,0,9999,0
1667918713970,CSE 293,036,119431,Su; Hao,9999,0,9999,0
1667918713970,CSE 293,037,119433,Swanson; Steven James,9999,0,9999,0
1667918713970,CSE 293,038,119435,Tullsen; Dean Michael,9999,0,9999,0
1667918713970,CSE 293,039,119483,Voelker; Geoffrey M.,9999,0,9999,0
1667918713970,CSE 293,040,119537,Zhao; Jishen,9999,0,9999,0
1667918713970,CSE 293,041,119538,Zhou; Yuan-Yuan,9999,0,9999,0
1667918713970,CSE 293,042,119539,Gao; Sicun,9999,0,9999,0
1667918713970,CSE 293,043,119540,Weibel; Nadir,9999,0,9999,0
1667918713970,CSE 293,044,119541,Gupta; Rajesh K.,9999,0,9999,0
1667918714394,CSE 294,A00,102459,Voelker; Geoffrey M.,0,0,0,0
1667918714394,CSE 294,B00,111322,Orailoglu; Alex,0,0,0,0
1667918714827,DSE 201,A00,096914,Deutsch; Alin Bernard,30,0,30,0
1667918715255,DSE 210,A00,096915,Dasgupta; Sanjoy,30,0,30,0
1667918715686,DSE 260A,A00,096916,Altintas De Callaf; Ilkay,30,0,30,0
1667918716131,ECE 200,001,103586,Antipa; Nicholas A,9999,0,9999,0
1667918716131,ECE 200,002,103587,Atanasov; Nikolay A.,9999,0,9999,0
1667918716131,ECE 200,003,103588,Bharadia; Dinesh,9999,0,9999,0
1667918716131,ECE 200,004,103589,Cheng; Chung Kuan,9999,0,9999,0
1667918716131,ECE 200,005,103590,Cosman; Pamela C.,9999,0,9999,0
1667918716131,ECE 200,006,103591,Dayeh; Shadi Ahmad,9999,0,9999,0
1667918716131,ECE 200,007,103592,Fainman; Yeshaiahu,9999,0,9999,0
1667918716131,ECE 200,008,103593,Ford; Joseph Earl,9999,0,9999,0
1667918716131,ECE 200,009,103594,Franceschetti; Massimo,9999,0,9999,0
1667918716131,ECE 200,010,103595,Fullerton; Eric E,9999,0,9999,0
1667918716131,ECE 200,011,103596,Galton; Ian A,9999,0,9999,0
1667918716131,ECE 200,012,103597,Gilja; Vikash,9999,0,9999,0
1667918716131,ECE 200,013,103598,Hall; Drew A.,9999,0,9999,0
1667918716131,ECE 200,014,103599,Hsueh; Tzu-Chien,9999,0,9999,0
1667918716131,ECE 200,015,103600,Javidi; Tara,9999,0,9999,0
1667918716131,ECE 200,016,103601,Kahng; Andrew Byun,9999,0,9999,0
1667918716131,ECE 200,017,103602,Kim; Young-Han,9999,0,9999,0
1667918716131,ECE 200,018,103603,Koushanfar; Farinaz,9999,0,9999,0
1667918716131,ECE 200,019,103604,Kuzum; Duygu,9999,0,9999,0
1667918716131,ECE 200,020,103605,Le; Hanh-Phuc,9999,0,9999,0
1667918716131,ECE 200,021,103606,Lin; Bill,9999,0,9999,0
1667918716131,ECE 200,022,103607,Liu; Zhaowei,9998,0,9999,1
1667918716131,ECE 200,023,103608,Lo; Yu-Hwa,9999,0,9999,0
1667918716131,ECE 200,024,103609,Lomakin; Vitaliy,9999,0,9999,0
1667918716131,ECE 200,025,103610,Mercier; Patrick Philip,9999,0,9999,0
1667918716131,ECE 200,026,103611,Meyer; Florian,9999,0,9999,0
1667918716131,ECE 200,027,103612,Milstein; Laurence B.,9999,0,9999,0
1667918716131,ECE 200,028,103613,Mir Arabbaygi; Siavash,9999,0,9999,0
1667918716131,ECE 200,029,103614,Mookherjea; Shayan,9999,0,9999,0
1667918716131,ECE 200,030,103615,Morris; Karcher William,9999,0,9999,0
1667918716131,ECE 200,031,103616,Ng; Tse Nga,9999,0,9999,0
1667918716131,ECE 200,032,103617,Nguyen; Truong Quang,9999,0,9999,0
1667918716131,ECE 200,033,103618,Nomura; Kenji,9999,0,9999,0
1667918716131,ECE 200,034,103619,Orlitsky; Alon,9999,0,9999,0
1667918716131,ECE 200,035,103620,Pal; Piya,9999,0,9999,0
1667918716131,ECE 200,036,103621,Papen; George C.,9999,0,9999,0
1667918716131,ECE 200,037,103622,Radic; Stojan,9999,0,9999,0
1667918716131,ECE 200,038,103623,Rao; Bhaskar D.,9999,0,9999,0
1667918716131,ECE 200,039,103624,Rao; Ramesh R,9999,0,9999,0
1667918716131,ECE 200,040,103625,Rebeiz; Gabriel,9999,0,9999,0
1667918716131,ECE 200,041,103626,Sanford; John R,9999,0,9999,0
1667918716131,ECE 200,042,103627,Siegel; Paul H.,9999,0,9999,0
1667918716131,ECE 200,043,103628,Sievenpiper; Daniel F.,9999,0,9999,0
1667918716131,ECE 200,044,103629,Sworder; David D.,9999,0,9999,0
1667918716131,ECE 200,045,103630,Taur; Yuan,9999,0,9999,0
1667918716131,ECE 200,046,103631,Touri; Behrouz,9999,0,9999,0
1667918716131,ECE 200,047,103632,Trivedi; Mohan M.,9999,0,9999,0
1667918716131,ECE 200,048,103633,Vasconcelos; Nuno,9999,0,9999,0
1667918716131,ECE 200,049,103634,Wang; Xiaolong,9999,0,9999,0
1667918716131,ECE 200,050,103635,Xie; Pengtao,9999,0,9999,0
1667918716131,ECE 200,051,103636,Yip; Michael,9999,0,9999,0
1667918716131,ECE 200,052,103637,Zeger; Kenneth A.,999,0,999,0
1667918716131,ECE 200,053,103638,Zhang; Xinyu,9999,0,9999,0
1667918716131,ECE 200,054,103639,Turakhia; Yatish Girish,9999,0,9999,0
1667918716131,ECE 200,055,103640,Kang; Mingu,9999,0,9999,0
1667918716131,ECE 200,056,103641,Shi; Yuanyuan,9999,0,9999,0
1667918716131,ECE 200,057,103642,Wang; Edward Jay,9999,0,9999,0
1667918716131,ECE 200,058,103643,Zheng; Yang,9999,0,9999,0
1667918716559,ECE 202,A00,103644,Kuzum; Duygu,0,0,0,0
1667918716986,ECE 212BN,A00,103646,Ng; Tse Nga,0,0,0,0
1667918717420,ECE 221,A00,111493,Staff,0,0,0,0
1667918717855,ECE 222B,A00,103647,Lomakin; Vitaliy,0,0,0,0
1667918718286,ECE 230B,A00,103648,Taur; Yuan,0,0,0,0
1667918718723,ECE 238B,A00,103649,Garay; Javier,0,0,0,0
1667918719160,ECE 240B,A00,112900,Fainman; Yeshaiahu,0,0,0,0
1667918719607,ECE 247A,A00,103650,Jokerst; Jesse Vincent,0,0,0,0
1667918720042,ECE 247B,A00,103651,Wang; Joseph,0,0,0,0
1667918720479,ECE 250,A00,103652,Siegel; Paul H.,0,0,0,0
1667918720901,ECE 251A,A00,103654,Rao; Bhaskar D.,0,0,0,0
1667918721335,ECE 257B,A00,103655,Bharadia; Dinesh,0,0,0,0
1667918721760,ECE 258A,A00,103656,Milstein; Laurence B.,0,0,0,0
1667918722187,ECE 260B,A00,103658,Kang; Mingu,0,0,0,0
1667918722636,ECE 264A,A00,103659,Galton; Ian A,0,0,0,0
1667918723058,ECE 265A,A00,103661,Gudem; Prasad S.S.,0,0,0,0
1667918723480,ECE 265D,A00,103662,Gudem; Prasad S.S.,0,0,0,0
1667918723918,ECE 268,A00,103663,Koushanfar; Farinaz,0,0,0,0
1667918724353,ECE 269,A01,103665,Pal; Piya,0,0,0,0
1667918724792,ECE 271B,A00,103666,Vasconcelos; Manuela,0,0,0,0
1667918725228,ECE 276A,A00,103667,Atanasov; Nikolay A.,0,0,0,0
1667918725665,ECE 277,A00,103668,An; Cheolhong,0,0,0,0
1667918726095,ECE 279,A00,117947,Hall; Drew A.,0,0,0,0
1667918726993,ECE 283,A00,103670,Hsueh; Tzu-Chien,0,0,0,0
1667918727435,ECE 284,A00,103671,Turakhia; Yatish Girish,0,0,0,0
1667918727883,ECE 285,A00,103672,Zheng; Yang,0,0,0,0
1667918727883,ECE 285,B00,103673,Sworder; David D.,0,0,0,0
1667918728326,ECE 287,A00,103676,Javidi; Tara,0,0,0,0
1667918728774,MATH 200B,A00,098023,Salehi Golsefidy; Alireza,15,0,15,0
1667918729205,MATH 202B,A00,098024,Rhoades; Brendon Patrick,14,0,15,1
1667918729645,MATH 203B,A00,098025,Oprea; Dragos N.,14,0,15,1
1667918730077,MATH 204B,A00,098026,Sorensen; Claus M,15,0,15,0
1667918730519,MATH 208,A00,098027,Izadi; Elham,7,0,10,3
1667918730956,MATH 209,A00,098028,Pollack; Aaron,10,0,10,0
1667918731395,MATH 211A,A00,112919,Rogalski; Daniel,10,0,10,0
1667918731850,MATH 211B,A00,112920,Seward; Brandon M.,10,0,10,0
1667918732281,MATH 218,A00,098029,Li; Bo,10,0,10,0
1667918732714,MATH 220B,A00,098030,Novak; Jonathan I,15,0,15,0
1667918733147,MATH 221A,A00,098031,Ebenfelt; Peter F,15,0,15,0
1667918733590,MATH 231B,A00,098032,Zlatos; Andrej,15,0,15,0
1667918734020,MATH 240B,A00,098033,Ni; Lei,13,0,15,2
1667918734451,MATH 243,A00,098034,Jekel; David Andrew,10,0,10,0
1667918734888,MATH 245A,A00,098035,Nie; Jiawang,6,0,15,9
1667918735322,MATH 248,A00,098036,Bejenaru; Ioan,10,0,10,0
1667918735745,MATH 250B,A00,098037,Spolaor; Luca,14,0,15,1
1667918736200,MATH 258,A00,098038,Ni; Lei,10,0,10,0
1667918736659,MATH 264B,A00,098041,Rhoades; Brendon Patrick,13,0,15,2
1667918737099,MATH 268,A00,098042,Buss; Samuel R,10,0,10,0
1667918737546,MATH 269,A00,098043,Rhoades; Brendon Patrick,10,0,10,0
1667918737968,MATH 270B,A00,098044,Li; Bo,13,0,15,2
1667918738399,MATH 272B,A00,098045,Holst; Michael J,13,0,15,2
1667918738834,MATH 273A,A00,098046,Tian; Xiaochuan,12,0,15,3
1667918739262,MATH 275,A01,098048,Tian; Xiaochuan,7,0,10,3
1667918739694,MATH 278A,A00,098049,Holst; Michael J,8,0,10,2
1667918740146,MATH 278B,A00,098050,Cloninger; Alexander,10,0,10,0
1667918740582,MATH 278C,A00,098051,Nie; Jiawang,9,0,10,1
1667918741018,MATH 280B,A00,098052,Zheng; Tianyi,12,0,15,3
1667918741453,MATH 281B,A00,098053,Bradic; Jelena,6,0,15,9
1667918741878,MATH 282B,A00,098054,Arias-Castro; Ery,2,0,15,13
1667918742306,MATH 285,A00,098055,Fitzsimmons; Patrick J,3,0,15,12
1667918742733,MATH 287B,A00,098056,Arias-Castro; Ery,9,0,15,6
1667918743160,MATH 288,A00,098057,Agarwal; Pooja,9,0,10,1
1667918743160,MATH 288,B00,098058,Zhang; Danna,9,0,10,1
1667918743160,MATH 288,C00,098059,Williams; Ruth J,10,0,10,0
1667918743590,MATH 290B,A00,098060,Roberts; Justin Deritter,14,0,15,1
1667918744025,MATH 292,A00,098061,Belmont; Eva Kinoshita,10,0,10,0
1667918744458,MATH 295,A00,098062,Suk; Andrew Hoon,48,0,50,2
1667918744888,MATH 296,A00,098063,Novak; Jonathan I,20,0,20,0
1667918745319,MATH 297,001,098064,Gamst; Anthony Collins,9997,0,9999,2
1667919254913,COGS 205,A00,101395,Chiba; Andrea,20,0,20,0
1667919255336,COGS 210B,001,101404,Greene; Deanna Jacquelyn,9998,0,9999,1
1667919255336,COGS 210B,002,101417,Xia; Haijun,9999,0,9999,0
1667919255336,COGS 210B,003,101422,Nitz; Douglas A.,9999,0,9999,0
1667919255336,COGS 210B,004,101423,Hollan; James D.,9998,0,9999,1
1667919255336,COGS 210B,005,101424,Deak; Gedeon O.,9999,0,9999,0
1667919255336,COGS 210B,006,101425,Rossano; Federico,9999,0,9999,0
1667919255763,COGS 211B,A00,101427,Coulson; Seana M,9997,0,9999,2
1667919256197,COGS 220,A00,101428,Hollan; James D.,0,0,25,25
1667919256629,COGS 229,A00,101429,Dow; Steven P,19,0,25,6
1667919257075,COGS 230,A00,101430,Klemmer; Scott R,13,0,17,4
1667919257516,COGS 234,A00,101431,Xia; Haijun,11,0,25,14
1667919257950,COGS 260,A00,101432,Kiyonaga; Anastasia,20,0,25,5
1667919257950,COGS 260,B00,101433,Kirsh; David Joel,18,0,25,7
1667919258374,CSE 202,A00,102371,Impagliazzo; Russell,0,0,0,0
1667919258831,CSE 203B,A01,102373,Cheng; Chung Kuan,0,0,0,0
1667919259257,CSE 208,A00,102374,Micciancio; Daniele,0,0,0,0
1667919259683,CSE 209A,A00,112895,Impagliazzo; Russell,0,0,15,15
1667919260109,CSE 209B,A00,108005,Bellare; Mihir,0,0,0,0
1667919260533,CSE 210,A00,113163,Coblenz; Michael J,0,0,0,0
1667919260961,CSE 219,A00,106111,Dow; Steven P,0,0,20,20
1667919261390,CSE 221,A00,102376,Voelker; Geoffrey M.,0,0,0,0
1667919261816,CSE 224,A01,102378,Porter; George M,0,0,0,0
1667919262257,CSE 229A,A00,102379,Savage; Stefan,0,0,0,0
1667919262699,CSE 229C,A00,102380,Munyaka; Imani N. S.,0,0,0,0
1667919263135,CSE 232B,A00,102382,Deutsch; Alin Bernard,0,0,0,0
1667919263574,CSE 234,A01,112904,Kumar; Arun Kumar,0,0,0,0
1667919264002,CSE 237A,A00,102383,Rosing; Tajana Simunic,0,0,0,0
1667919264442,CSE 239A,A00,102384,Deutsch; Alin Bernard,0,0,0,0
1667919264890,CSE 239B,A00,102385,Polikarpova; Nadezhda,0,0,0,0
1667919265316,CSE 240A,A00,102386,Pannuto; Patrick William,0,0,0,0
1667919265750,CSE 240B,A00,102387,Zhao; Jishen,0,0,0,0
1667919266181,CSE 241A,A00,106406,Kang; Mingu,0,0,0,0
1667919266608,CSE 249B,A00,102388,Kahng; Andrew Byun,0,0,8,8
1667919267034,CSE 251B,A01,102392,Cottrell; Garrison W,0,0,0,0
1667919267034,CSE 251B,A02,102393,Cottrell; Garrison W,0,0,0,0
1667919267471,CSE 252B,A00,102394,Ochoa; Benjamin Lawrence,0,0,0,0
1667919267900,CSE 257,A01,102396,Gao; Sicun,0,0,0,0
1667919268354,CSE 272,A00,102397,Li; Tzumao,0,0,0,0
1667919268779,CSE 274,A00,111323,Chern; Albert Ren-Haur,0,0,0,0
1667919269218,CSE 282,A00,102398,Pevzner; Pavel Arkadjevich,0,0,0,0
1667919269648,CSE 284,A00,114175,Gymrek; Melissa Ann,0,0,0,0
1667919270072,CSE 290,A00,102399,Chandraker; Manmohan Krishna,0,0,0,0
1667919270072,CSE 290,B00,102400,Vaccaro; Kristen Marie,0,0,25,25
1667919270072,CSE 290,C00,102414,Pannuto; Patrick William,0,0,25,25
1667919270072,CSE 290,D00,102427,Pevzner; Pavel Arkadjevich,0,0,0,0
1667919270072,CSE 290,E00,102429,Zhao; Jishen,0,0,0,0
1667919270072,CSE 290,F00,102436,Tullsen; Dean Michael,0,0,0,0
1667919270072,CSE 290,G00,102440,Christensen; Henrik I,0,0,20,20
1667919270516,CSE 291,A00,102443,Su; Hao,0,0,0,0
1667919270516,CSE 291,B00,102448,Polikarpova; Nadezhda,0,0,0,0
1667919270516,CSE 291,C00,102453,Vaccaro; Kristen Marie,0,0,0,0
1667919270516,CSE 291,D00,111343,Savage; Stefan,0,0,0,0
1667919270516,CSE 291,E00,116474,Claffy; Kimberly Claire,0,0,0,0
1667919270516,CSE 291,F00,116479,Pasquale; Joseph,0,0,0,0
1667919270949,CSE 293,001,119111,Bafna; Vineet,9999,0,9999,0
1667919270949,CSE 293,002,119118,Bellare; Mihir,9999,0,9999,0
1667919270949,CSE 293,003,119122,Berg-Kirkpatrick; Taylor D,9999,0,9999,0
1667919270949,CSE 293,004,119135,Christensen; Henrik I,9999,0,9999,0
1667919270949,CSE 293,005,119142,Cottrell; Garrison W,9999,0,9999,0
1667919270949,CSE 293,006,119146,Deutsch; Alin Bernard,9999,0,9999,0
1667919270949,CSE 293,007,119159,Esmaeilzadeh; Hadi,9999,0,9999,0
1667919270949,CSE 293,008,119166,Freund; Yoav,9999,0,9999,0
1667919270949,CSE 293,009,119170,Griswold; William G.,9999,0,9999,0
1667919270949,CSE 293,010,119183,Gymrek; Melissa Ann,9999,0,9999,0
1667919270949,CSE 293,011,119190,Heninger; Nadia A,9999,0,9999,0
1667919270949,CSE 293,012,119230,Impagliazzo; Russell,9999,0,9999,0
1667919270949,CSE 293,013,119232,Jhala; Ranjit,9999,0,9999,0
1667919270949,CSE 293,014,119233,Kahng; Andrew Byun,9999,0,9999,0
1667919270949,CSE 293,015,119298,Kane; Daniel Mertz,9999,0,9999,0
1667919270949,CSE 293,016,119299,Kriegman; David J,9999,0,9999,0
1667919270949,CSE 293,017,119300,Kumar; Arun Kumar,9999,0,9999,0
1667919270949,CSE 293,018,119301,Lerner; Sorin,9999,0,9999,0
1667919270949,CSE 293,019,119302,Lovett; Shachar,9999,0,9999,0
1667919270949,CSE 293,020,119303,McAuley; Julian John,9999,0,9999,0
1667919270949,CSE 293,021,119304,Micciancio; Daniele,9999,0,9999,0
1667919270949,CSE 293,022,119367,Orailoglu; Alex,9999,0,9999,0
1667919270949,CSE 293,023,119382,Paturi; Ramamohan,9999,0,9999,0
1667919270949,CSE 293,024,119404,Polikarpova; Nadezhda,9999,0,9999,0
1667919270949,CSE 293,025,119406,Politz; Joseph Gibbs,9999,0,9999,0
1667919270949,CSE 293,026,119411,Porter; George M,9999,0,9999,0
1667919270949,CSE 293,027,119414,Porter; Leonard Emerson,9999,0,9999,0
1667919270949,CSE 293,028,119416,Ramamoorthi; Ravi,9999,0,9999,0
1667919270949,CSE 293,029,119417,Sahoo; Debashis,9999,0,9999,0
1667919270949,CSE 293,030,119420,Saul; Lawrence,9999,0,9999,0
1667919270949,CSE 293,031,119421,Savage; Stefan,9999,0,9999,0
1667919270949,CSE 293,032,119425,Schulze; Jurgen P.,9999,0,9999,0
1667919270949,CSE 293,033,119426,Snoeren; Alex C.,9999,0,9999,0
1667919270949,CSE 293,034,119428,Shang; Jingbo,9999,0,9999,0
1667919270949,CSE 293,035,119430,Stefan; Deian,9999,0,9999,0
1667919270949,CSE 293,036,119431,Su; Hao,9999,0,9999,0
1667919270949,CSE 293,037,119433,Swanson; Steven James,9999,0,9999,0
1667919270949,CSE 293,038,119435,Tullsen; Dean Michael,9999,0,9999,0
1667919270949,CSE 293,039,119483,Voelker; Geoffrey M.,9999,0,9999,0
1667919270949,CSE 293,040,119537,Zhao; Jishen,9999,0,9999,0
1667919270949,CSE 293,041,119538,Zhou; Yuan-Yuan,9999,0,9999,0
1667919270949,CSE 293,042,119539,Gao; Sicun,9999,0,9999,0
1667919270949,CSE 293,043,119540,Weibel; Nadir,9999,0,9999,0
1667919270949,CSE 293,044,119541,Gupta; Rajesh K.,9999,0,9999,0
1667919271380,CSE 294,A00,102459,Voelker; Geoffrey M.,0,0,0,0
1667919271380,CSE 294,B00,111322,Orailoglu; Alex,0,0,0,0
1667919271806,DSE 201,A00,096914,Deutsch; Alin Bernard,30,0,30,0
1667919272241,DSE 210,A00,096915,Dasgupta; Sanjoy,30,0,30,0
1667919272675,DSE 260A,A00,096916,Altintas De Callaf; Ilkay,30,0,30,0
1667919273103,ECE 200,001,103586,Antipa; Nicholas A,9999,0,9999,0
1667919273103,ECE 200,002,103587,Atanasov; Nikolay A.,9999,0,9999,0
1667919273103,ECE 200,003,103588,Bharadia; Dinesh,9999,0,9999,0
1667919273103,ECE 200,004,103589,Cheng; Chung Kuan,9999,0,9999,0
1667919273103,ECE 200,005,103590,Cosman; Pamela C.,9999,0,9999,0
1667919273103,ECE 200,006,103591,Dayeh; Shadi Ahmad,9999,0,9999,0
1667919273103,ECE 200,007,103592,Fainman; Yeshaiahu,9999,0,9999,0
1667919273103,ECE 200,008,103593,Ford; Joseph Earl,9999,0,9999,0
1667919273103,ECE 200,009,103594,Franceschetti; Massimo,9999,0,9999,0
1667919273103,ECE 200,010,103595,Fullerton; Eric E,9999,0,9999,0
1667919273103,ECE 200,011,103596,Galton; Ian A,9999,0,9999,0
1667919273103,ECE 200,012,103597,Gilja; Vikash,9999,0,9999,0
1667919273103,ECE 200,013,103598,Hall; Drew A.,9999,0,9999,0
1667919273103,ECE 200,014,103599,Hsueh; Tzu-Chien,9999,0,9999,0
1667919273103,ECE 200,015,103600,Javidi; Tara,9999,0,9999,0
1667919273103,ECE 200,016,103601,Kahng; Andrew Byun,9999,0,9999,0
1667919273103,ECE 200,017,103602,Kim; Young-Han,9999,0,9999,0
1667919273103,ECE 200,018,103603,Koushanfar; Farinaz,9999,0,9999,0
1667919273103,ECE 200,019,103604,Kuzum; Duygu,9999,0,9999,0
1667919273103,ECE 200,020,103605,Le; Hanh-Phuc,9999,0,9999,0
1667919273103,ECE 200,021,103606,Lin; Bill,9999,0,9999,0
1667919273103,ECE 200,022,103607,Liu; Zhaowei,9998,0,9999,1
1667919273103,ECE 200,023,103608,Lo; Yu-Hwa,9999,0,9999,0
1667919273103,ECE 200,024,103609,Lomakin; Vitaliy,9999,0,9999,0
1667919273103,ECE 200,025,103610,Mercier; Patrick Philip,9999,0,9999,0
1667919273103,ECE 200,026,103611,Meyer; Florian,9999,0,9999,0
1667919273103,ECE 200,027,103612,Milstein; Laurence B.,9999,0,9999,0
1667919273103,ECE 200,028,103613,Mir Arabbaygi; Siavash,9999,0,9999,0
1667919273103,ECE 200,029,103614,Mookherjea; Shayan,9999,0,9999,0
1667919273103,ECE 200,030,103615,Morris; Karcher William,9999,0,9999,0
1667919273103,ECE 200,031,103616,Ng; Tse Nga,9999,0,9999,0
1667919273103,ECE 200,032,103617,Nguyen; Truong Quang,9999,0,9999,0
1667919273103,ECE 200,033,103618,Nomura; Kenji,9999,0,9999,0
1667919273103,ECE 200,034,103619,Orlitsky; Alon,9999,0,9999,0
1667919273103,ECE 200,035,103620,Pal; Piya,9999,0,9999,0
1667919273103,ECE 200,036,103621,Papen; George C.,9999,0,9999,0
1667919273103,ECE 200,037,103622,Radic; Stojan,9999,0,9999,0
1667919273103,ECE 200,038,103623,Rao; Bhaskar D.,9999,0,9999,0
1667919273103,ECE 200,039,103624,Rao; Ramesh R,9999,0,9999,0
1667919273103,ECE 200,040,103625,Rebeiz; Gabriel,9999,0,9999,0
1667919273103,ECE 200,041,103626,Sanford; John R,9999,0,9999,0
1667919273103,ECE 200,042,103627,Siegel; Paul H.,9999,0,9999,0
1667919273103,ECE 200,043,103628,Sievenpiper; Daniel F.,9999,0,9999,0
1667919273103,ECE 200,044,103629,Sworder; David D.,9999,0,9999,0
1667919273103,ECE 200,045,103630,Taur; Yuan,9999,0,9999,0
1667919273103,ECE 200,046,103631,Touri; Behrouz,9999,0,9999,0
1667919273103,ECE 200,047,103632,Trivedi; Mohan M.,9999,0,9999,0
1667919273103,ECE 200,048,103633,Vasconcelos; Nuno,9999,0,9999,0
1667919273103,ECE 200,049,103634,Wang; Xiaolong,9999,0,9999,0
1667919273103,ECE 200,050,103635,Xie; Pengtao,9999,0,9999,0
1667919273103,ECE 200,051,103636,Yip; Michael,9999,0,9999,0
1667919273103,ECE 200,052,103637,Zeger; Kenneth A.,999,0,999,0
1667919273103,ECE 200,053,103638,Zhang; Xinyu,9999,0,9999,0
1667919273103,ECE 200,054,103639,Turakhia; Yatish Girish,9999,0,9999,0
1667919273103,ECE 200,055,103640,Kang; Mingu,9999,0,9999,0
1667919273103,ECE 200,056,103641,Shi; Yuanyuan,9999,0,9999,0
1667919273103,ECE 200,057,103642,Wang; Edward Jay,9999,0,9999,0
1667919273103,ECE 200,058,103643,Zheng; Yang,9999,0,9999,0
1667919273530,ECE 202,A00,103644,Kuzum; Duygu,0,0,0,0
1667919273957,ECE 212BN,A00,103646,Ng; Tse Nga,0,0,0,0
1667919274397,ECE 221,A00,111493,Staff,0,0,0,0
1667919274824,ECE 222B,A00,103647,Lomakin; Vitaliy,0,0,0,0
1667919275249,ECE 230B,A00,103648,Taur; Yuan,0,0,0,0
1667919275675,ECE 238B,A00,103649,Garay; Javier,0,0,0,0
1667919276103,ECE 240B,A00,112900,Fainman; Yeshaiahu,0,0,0,0
1667919276536,ECE 247A,A00,103650,Jokerst; Jesse Vincent,0,0,0,0
1667919276973,ECE 247B,A00,103651,Wang; Joseph,0,0,0,0
1667919277400,ECE 250,A00,103652,Siegel; Paul H.,0,0,0,0
1667919277831,ECE 251A,A00,103654,Rao; Bhaskar D.,0,0,0,0
1667919278258,ECE 257B,A00,103655,Bharadia; Dinesh,0,0,0,0
1667919278695,ECE 258A,A00,103656,Milstein; Laurence B.,0,0,0,0
1667919279130,ECE 260B,A00,103658,Kang; Mingu,0,0,0,0
1667919279555,ECE 264A,A00,103659,Galton; Ian A,0,0,0,0
1667919280000,ECE 265A,A00,103661,Gudem; Prasad S.S.,0,0,0,0
1667919280428,ECE 265D,A00,103662,Gudem; Prasad S.S.,0,0,0,0
1667919280866,ECE 268,A00,103663,Koushanfar; Farinaz,0,0,0,0
1667919281302,ECE 269,A01,103665,Pal; Piya,0,0,0,0
1667919281746,ECE 271B,A00,103666,Vasconcelos; Manuela,0,0,0,0
1667919282274,ECE 276A,A00,103667,Atanasov; Nikolay A.,0,0,0,0
1667919282702,ECE 277,A00,103668,An; Cheolhong,0,0,0,0
1667919283145,ECE 279,A00,117947,Hall; Drew A.,0,0,0,0
1667919284016,ECE 283,A00,103670,Hsueh; Tzu-Chien,0,0,0,0
1667919284446,ECE 284,A00,103671,Turakhia; Yatish Girish,0,0,0,0
1667919284875,ECE 285,A00,103672,Zheng; Yang,0,0,0,0
1667919284875,ECE 285,B00,103673,Sworder; David D.,0,0,0,0
1667919285301,ECE 287,A00,103676,Javidi; Tara,0,0,0,0
1667919285732,MATH 200B,A00,098023,Salehi Golsefidy; Alireza,15,0,15,0
1667919286166,MATH 202B,A00,098024,Rhoades; Brendon Patrick,14,0,15,1
1667919286596,MATH 203B,A00,098025,Oprea; Dragos N.,14,0,15,1
1667919287039,MATH 204B,A00,098026,Sorensen; Claus M,15,0,15,0
1667919287467,MATH 208,A00,098027,Izadi; Elham,7,0,10,3
1667919287897,MATH 209,A00,098028,Pollack; Aaron,10,0,10,0
1667919288330,MATH 211A,A00,112919,Rogalski; Daniel,10,0,10,0
1667919288758,MATH 211B,A00,112920,Seward; Brandon M.,10,0,10,0
1667919289196,MATH 218,A00,098029,Li; Bo,10,0,10,0
1667919289631,MATH 220B,A00,098030,Novak; Jonathan I,15,0,15,0
1667919290054,MATH 221A,A00,098031,Ebenfelt; Peter F,15,0,15,0
1667919290482,MATH 231B,A00,098032,Zlatos; Andrej,15,0,15,0
1667919290908,MATH 240B,A00,098033,Ni; Lei,13,0,15,2
1667919291338,MATH 243,A00,098034,Jekel; David Andrew,10,0,10,0
1667919291773,MATH 245A,A00,098035,Nie; Jiawang,6,0,15,9
1667919292246,MATH 248,A00,098036,Bejenaru; Ioan,10,0,10,0
1667919292671,MATH 250B,A00,098037,Spolaor; Luca,14,0,15,1
1667919293126,MATH 258,A00,098038,Ni; Lei,10,0,10,0
1667919293561,MATH 264B,A00,098041,Rhoades; Brendon Patrick,13,0,15,2
1667919294009,MATH 268,A00,098042,Buss; Samuel R,10,0,10,0
1667919294437,MATH 269,A00,098043,Rhoades; Brendon Patrick,10,0,10,0
1667919294870,MATH 270B,A00,098044,Li; Bo,13,0,15,2
1667919295304,MATH 272B,A00,098045,Holst; Michael J,13,0,15,2
1667919295732,MATH 273A,A00,098046,Tian; Xiaochuan,12,0,15,3
1667919296166,MATH 275,A01,098048,Tian; Xiaochuan,7,0,10,3
1667919296606,MATH 278A,A00,098049,Holst; Michael J,8,0,10,2
1667919297041,MATH 278B,A00,098050,Cloninger; Alexander,10,0,10,0
1667919297469,MATH 278C,A00,098051,Nie; Jiawang,9,0,10,1
1667919297912,MATH 280B,A00,098052,Zheng; Tianyi,12,0,15,3
1667919298349,MATH 281B,A00,098053,Bradic; Jelena,6,0,15,9
1667919298797,MATH 282B,A00,098054,Arias-Castro; Ery,2,0,15,13
1667919299224,MATH 285,A00,098055,Fitzsimmons; Patrick J,3,0,15,12
1667919299653,MATH 287B,A00,098056,Arias-Castro; Ery,9,0,15,6
1667919300076,MATH 288,A00,098057,Agarwal; Pooja,9,0,10,1
1667919300076,MATH 288,B00,098058,Zhang; Danna,9,0,10,1
1667919300076,MATH 288,C00,098059,Williams; Ruth J,10,0,10,0
1667919300507,MATH 290B,A00,098060,Roberts; Justin Deritter,14,0,15,1
1667919300952,MATH 292,A00,098061,Belmont; Eva Kinoshita,10,0,10,0
1667919301375,MATH 295,A00,098062,Suk; Andrew Hoon,48,0,50,2
1667919301826,MATH 296,A00,098063,Novak; Jonathan I,20,0,20,0
1667919302260,MATH 297,001,098064,Gamst; Anthony Collins,9997,0,9999,2
1667919822681,COGS 205,A00,101395,Chiba; Andrea,20,0,20,0
1667919823190,COGS 210B,001,101404,Greene; Deanna Jacquelyn,9998,0,9999,1
1667919823190,COGS 210B,002,101417,Xia; Haijun,9999,0,9999,0
1667919823190,COGS 210B,003,101422,Nitz; Douglas A.,9999,0,9999,0
1667919823190,COGS 210B,004,101423,Hollan; James D.,9998,0,9999,1
1667919823190,COGS 210B,005,101424,Deak; Gedeon O.,9999,0,9999,0
1667919823190,COGS 210B,006,101425,Rossano; Federico,9999,0,9999,0
1667919823621,COGS 211B,A00,101427,Coulson; Seana M,9997,0,9999,2
1667919824059,COGS 220,A00,101428,Hollan; James D.,0,0,25,25
1667919824497,COGS 229,A00,101429,Dow; Steven P,19,0,25,6
1667919824929,COGS 230,A00,101430,Klemmer; Scott R,13,0,17,4
1667919825367,COGS 234,A00,101431,Xia; Haijun,11,0,25,14
1667919825794,COGS 260,A00,101432,Kiyonaga; Anastasia,20,0,25,5
1667919825794,COGS 260,B00,101433,Kirsh; David Joel,18,0,25,7
1667919826223,CSE 202,A00,102371,Impagliazzo; Russell,0,0,0,0
1667919826656,CSE 203B,A01,102373,Cheng; Chung Kuan,0,0,0,0
1667919827084,CSE 208,A00,102374,Micciancio; Daniele,0,0,0,0
1667919827523,CSE 209A,A00,112895,Impagliazzo; Russell,0,0,15,15
1667919827948,CSE 209B,A00,108005,Bellare; Mihir,0,0,0,0
1667919828389,CSE 210,A00,113163,Coblenz; Michael J,0,0,0,0
1667919828822,CSE 219,A00,106111,Dow; Steven P,0,0,20,20
1667919829250,CSE 221,A00,102376,Voelker; Geoffrey M.,0,0,0,0
1667919829699,CSE 224,A01,102378,Porter; George M,0,0,0,0
1667919830144,CSE 229A,A00,102379,Savage; Stefan,0,0,0,0
1667919830570,CSE 229C,A00,102380,Munyaka; Imani N. S.,0,0,0,0
1667919830998,CSE 232B,A00,102382,Deutsch; Alin Bernard,0,0,0,0
1667919831430,CSE 234,A01,112904,Kumar; Arun Kumar,0,0,0,0
1667919831871,CSE 237A,A00,102383,Rosing; Tajana Simunic,0,0,0,0
1667919832303,CSE 239A,A00,102384,Deutsch; Alin Bernard,0,0,0,0
1667919832737,CSE 239B,A00,102385,Polikarpova; Nadezhda,0,0,0,0
1667919833165,CSE 240A,A00,102386,Pannuto; Patrick William,0,0,0,0
1667919833602,CSE 240B,A00,102387,Zhao; Jishen,0,0,0,0
1667919834025,CSE 241A,A00,106406,Kang; Mingu,0,0,0,0
1667919834458,CSE 249B,A00,102388,Kahng; Andrew Byun,0,0,8,8
1667919834888,CSE 251B,A01,102392,Cottrell; Garrison W,0,0,0,0
1667919834888,CSE 251B,A02,102393,Cottrell; Garrison W,0,0,0,0
1667919835317,CSE 252B,A00,102394,Ochoa; Benjamin Lawrence,0,0,0,0
1667919835768,CSE 257,A01,102396,Gao; Sicun,0,0,0,0
1667919836221,CSE 272,A00,102397,Li; Tzumao,0,0,0,0
1667919836664,CSE 274,A00,111323,Chern; Albert Ren-Haur,0,0,0,0
1667919837099,CSE 282,A00,102398,Pevzner; Pavel Arkadjevich,0,0,0,0
1667919837546,CSE 284,A00,114175,Gymrek; Melissa Ann,0,0,0,0
1667919837984,CSE 290,A00,102399,Chandraker; Manmohan Krishna,0,0,0,0
1667919837984,CSE 290,B00,102400,Vaccaro; Kristen Marie,0,0,25,25
1667919837984,CSE 290,C00,102414,Pannuto; Patrick William,0,0,25,25
1667919837984,CSE 290,D00,102427,Pevzner; Pavel Arkadjevich,0,0,0,0
1667919837984,CSE 290,E00,102429,Zhao; Jishen,0,0,0,0
1667919837984,CSE 290,F00,102436,Tullsen; Dean Michael,0,0,0,0
1667919837984,CSE 290,G00,102440,Christensen; Henrik I,0,0,20,20
1667919838410,CSE 291,A00,102443,Su; Hao,0,0,0,0
1667919838410,CSE 291,B00,102448,Polikarpova; Nadezhda,0,0,0,0
1667919838410,CSE 291,C00,102453,Vaccaro; Kristen Marie,0,0,0,0
1667919838410,CSE 291,D00,111343,Savage; Stefan,0,0,0,0
1667919838410,CSE 291,E00,116474,Claffy; Kimberly Claire,0,0,0,0
1667919838410,CSE 291,F00,116479,Pasquale; Joseph,0,0,0,0
1667919838890,CSE 293,001,119111,Bafna; Vineet,9999,0,9999,0
1667919838890,CSE 293,002,119118,Bellare; Mihir,9999,0,9999,0
1667919838890,CSE 293,003,119122,Berg-Kirkpatrick; Taylor D,9999,0,9999,0
1667919838890,CSE 293,004,119135,Christensen; Henrik I,9999,0,9999,0
1667919838890,CSE 293,005,119142,Cottrell; Garrison W,9999,0,9999,0
1667919838890,CSE 293,006,119146,Deutsch; Alin Bernard,9999,0,9999,0
1667919838890,CSE 293,007,119159,Esmaeilzadeh; Hadi,9999,0,9999,0
1667919838890,CSE 293,008,119166,Freund; Yoav,9999,0,9999,0
1667919838890,CSE 293,009,119170,Griswold; William G.,9999,0,9999,0
1667919838890,CSE 293,010,119183,Gymrek; Melissa Ann,9999,0,9999,0
1667919838890,CSE 293,011,119190,Heninger; Nadia A,9999,0,9999,0
1667919838890,CSE 293,012,119230,Impagliazzo; Russell,9999,0,9999,0
1667919838890,CSE 293,013,119232,Jhala; Ranjit,9999,0,9999,0
1667919838890,CSE 293,014,119233,Kahng; Andrew Byun,9999,0,9999,0
1667919838890,CSE 293,015,119298,Kane; Daniel Mertz,9999,0,9999,0
1667919838890,CSE 293,016,119299,Kriegman; David J,9999,0,9999,0
1667919838890,CSE 293,017,119300,Kumar; Arun Kumar,9999,0,9999,0
1667919838890,CSE 293,018,119301,Lerner; Sorin,9999,0,9999,0
1667919838890,CSE 293,019,119302,Lovett; Shachar,9999,0,9999,0
1667919838890,CSE 293,020,119303,McAuley; Julian John,9999,0,9999,0
1667919838890,CSE 293,021,119304,Micciancio; Daniele,9999,0,9999,0
1667919838890,CSE 293,022,119367,Orailoglu; Alex,9999,0,9999,0
1667919838890,CSE 293,023,119382,Paturi; Ramamohan,9999,0,9999,0
1667919838890,CSE 293,024,119404,Polikarpova; Nadezhda,9999,0,9999,0
1667919838890,CSE 293,025,119406,Politz; Joseph Gibbs,9999,0,9999,0
1667919838890,CSE 293,026,119411,Porter; George M,9999,0,9999,0
1667919838890,CSE 293,027,119414,Porter; Leonard Emerson,9999,0,9999,0
1667919838890,CSE 293,028,119416,Ramamoorthi; Ravi,9999,0,9999,0
1667919838890,CSE 293,029,119417,Sahoo; Debashis,9999,0,9999,0
1667919838890,CSE 293,030,119420,Saul; Lawrence,9999,0,9999,0
1667919838890,CSE 293,031,119421,Savage; Stefan,9999,0,9999,0
1667919838890,CSE 293,032,119425,Schulze; Jurgen P.,9999,0,9999,0
1667919838890,CSE 293,033,119426,Snoeren; Alex C.,9999,0,9999,0
1667919838890,CSE 293,034,119428,Shang; Jingbo,9999,0,9999,0
1667919838890,CSE 293,035,119430,Stefan; Deian,9999,0,9999,0
1667919838890,CSE 293,036,119431,Su; Hao,9999,0,9999,0
1667919838890,CSE 293,037,119433,Swanson; Steven James,9999,0,9999,0
1667919838890,CSE 293,038,119435,Tullsen; Dean Michael,9999,0,9999,0
1667919838890,CSE 293,039,119483,Voelker; Geoffrey M.,9999,0,9999,0
1667919838890,CSE 293,040,119537,Zhao; Jishen,9999,0,9999,0
1667919838890,CSE 293,041,119538,Zhou; Yuan-Yuan,9999,0,9999,0
1667919838890,CSE 293,042,119539,Gao; Sicun,9999,0,9999,0
1667919838890,CSE 293,043,119540,Weibel; Nadir,9999,0,9999,0
1667919838890,CSE 293,044,119541,Gupta; Rajesh K.,9999,0,9999,0
1667919839319,CSE 294,A00,102459,Voelker; Geoffrey M.,0,0,0,0
1667919839319,CSE 294,B00,111322,Orailoglu; Alex,0,0,0,0
1667919839745,DSE 201,A00,096914,Deutsch; Alin Bernard,30,0,30,0
1667919840170,DSE 210,A00,096915,Dasgupta; Sanjoy,30,0,30,0
1667919840595,DSE 260A,A00,096916,Altintas De Callaf; Ilkay,30,0,30,0
1667919841049,ECE 200,001,103586,Antipa; Nicholas A,9999,0,9999,0
1667919841049,ECE 200,002,103587,Atanasov; Nikolay A.,9999,0,9999,0
1667919841049,ECE 200,003,103588,Bharadia; Dinesh,9999,0,9999,0
1667919841049,ECE 200,004,103589,Cheng; Chung Kuan,9999,0,9999,0
1667919841049,ECE 200,005,103590,Cosman; Pamela C.,9999,0,9999,0
1667919841049,ECE 200,006,103591,Dayeh; Shadi Ahmad,9999,0,9999,0
1667919841049,ECE 200,007,103592,Fainman; Yeshaiahu,9999,0,9999,0
1667919841049,ECE 200,008,103593,Ford; Joseph Earl,9999,0,9999,0
1667919841049,ECE 200,009,103594,Franceschetti; Massimo,9999,0,9999,0
1667919841049,ECE 200,010,103595,Fullerton; Eric E,9999,0,9999,0
1667919841049,ECE 200,011,103596,Galton; Ian A,9999,0,9999,0
1667919841049,ECE 200,012,103597,Gilja; Vikash,9999,0,9999,0
1667919841049,ECE 200,013,103598,Hall; Drew A.,9999,0,9999,0
1667919841049,ECE 200,014,103599,Hsueh; Tzu-Chien,9999,0,9999,0
1667919841049,ECE 200,015,103600,Javidi; Tara,9999,0,9999,0
1667919841049,ECE 200,016,103601,Kahng; Andrew Byun,9999,0,9999,0
1667919841049,ECE 200,017,103602,Kim; Young-Han,9999,0,9999,0
1667919841049,ECE 200,018,103603,Koushanfar; Farinaz,9999,0,9999,0
1667919841049,ECE 200,019,103604,Kuzum; Duygu,9999,0,9999,0
1667919841049,ECE 200,020,103605,Le; Hanh-Phuc,9999,0,9999,0
1667919841049,ECE 200,021,103606,Lin; Bill,9999,0,9999,0
1667919841049,ECE 200,022,103607,Liu; Zhaowei,9998,0,9999,1
1667919841049,ECE 200,023,103608,Lo; Yu-Hwa,9999,0,9999,0
1667919841049,ECE 200,024,103609,Lomakin; Vitaliy,9999,0,9999,0
1667919841049,ECE 200,025,103610,Mercier; Patrick Philip,9999,0,9999,0
1667919841049,ECE 200,026,103611,Meyer; Florian,9999,0,9999,0
1667919841049,ECE 200,027,103612,Milstein; Laurence B.,9999,0,9999,0
1667919841049,ECE 200,028,103613,Mir Arabbaygi; Siavash,9999,0,9999,0
1667919841049,ECE 200,029,103614,Mookherjea; Shayan,9999,0,9999,0
1667919841049,ECE 200,030,103615,Morris; Karcher William,9999,0,9999,0
1667919841049,ECE 200,031,103616,Ng; Tse Nga,9999,0,9999,0
1667919841049,ECE 200,032,103617,Nguyen; Truong Quang,9999,0,9999,0
1667919841049,ECE 200,033,103618,Nomura; Kenji,9999,0,9999,0
1667919841049,ECE 200,034,103619,Orlitsky; Alon,9999,0,9999,0
1667919841049,ECE 200,035,103620,Pal; Piya,9999,0,9999,0
1667919841049,ECE 200,036,103621,Papen; George C.,9999,0,9999,0
1667919841049,ECE 200,037,103622,Radic; Stojan,9999,0,9999,0
1667919841049,ECE 200,038,103623,Rao; Bhaskar D.,9999,0,9999,0
1667919841049,ECE 200,039,103624,Rao; Ramesh R,9999,0,9999,0
1667919841049,ECE 200,040,103625,Rebeiz; Gabriel,9999,0,9999,0
1667919841049,ECE 200,041,103626,Sanford; John R,9999,0,9999,0
1667919841049,ECE 200,042,103627,Siegel; Paul H.,9999,0,9999,0
1667919841049,ECE 200,043,103628,Sievenpiper; Daniel F.,9999,0,9999,0
1667919841049,ECE 200,044,103629,Sworder; David D.,9999,0,9999,0
1667919841049,ECE 200,045,103630,Taur; Yuan,9999,0,9999,0
1667919841049,ECE 200,046,103631,Touri; Behrouz,9999,0,9999,0
1667919841049,ECE 200,047,103632,Trivedi; Mohan M.,9999,0,9999,0
1667919841049,ECE 200,048,103633,Vasconcelos; Nuno,9999,0,9999,0
1667919841049,ECE 200,049,103634,Wang; Xiaolong,9999,0,9999,0
1667919841049,ECE 200,050,103635,Xie; Pengtao,9999,0,9999,0
1667919841049,ECE 200,051,103636,Yip; Michael,9999,0,9999,0
1667919841049,ECE 200,052,103637,Zeger; Kenneth A.,999,0,999,0
1667919841049,ECE 200,053,103638,Zhang; Xinyu,9999,0,9999,0
1667919841049,ECE 200,054,103639,Turakhia; Yatish Girish,9999,0,9999,0
1667919841049,ECE 200,055,103640,Kang; Mingu,9999,0,9999,0
1667919841049,ECE 200,056,103641,Shi; Yuanyuan,9999,0,9999,0
1667919841049,ECE 200,057,103642,Wang; Edward Jay,9999,0,9999,0
1667919841049,ECE 200,058,103643,Zheng; Yang,9999,0,9999,0
1667919841485,ECE 202,A00,103644,Kuzum; Duygu,0,0,0,0
1667919841914,ECE 212BN,A00,103646,Ng; Tse Nga,0,0,0,0
1667919842375,ECE 221,A00,111493,Staff,0,0,0,0
1667919842803,ECE 222B,A00,103647,Lomakin; Vitaliy,0,0,0,0
1667919843234,ECE 230B,A00,103648,Taur; Yuan,0,0,0,0
1667919843660,ECE 238B,A00,103649,Garay; Javier,0,0,0,0
1667919844099,ECE 240B,A00,112900,Fainman; Yeshaiahu,0,0,0,0
1667919844529,ECE 247A,A00,103650,Jokerst; Jesse Vincent,0,0,0,0
1667919844975,ECE 247B,A00,103651,Wang; Joseph,0,0,0,0
1667919845414,ECE 250,A00,103652,Siegel; Paul H.,0,0,0,0
1667919845849,ECE 251A,A00,103654,Rao; Bhaskar D.,0,0,0,0
1667919846282,ECE 257B,A00,103655,Bharadia; Dinesh,0,0,0,0
1667919846722,ECE 258A,A00,103656,Milstein; Laurence B.,0,0,0,0
1667919847146,ECE 260B,A00,103658,Kang; Mingu,0,0,0,0
1667919847574,ECE 264A,A00,103659,Galton; Ian A,0,0,0,0
1667919848007,ECE 265A,A00,103661,Gudem; Prasad S.S.,0,0,0,0
1667919848441,ECE 265D,A00,103662,Gudem; Prasad S.S.,0,0,0,0
1667919848879,ECE 268,A00,103663,Koushanfar; Farinaz,0,0,0,0
1667919849314,ECE 269,A01,103665,Pal; Piya,0,0,0,0
1667919849750,ECE 271B,A00,103666,Vasconcelos; Manuela,0,0,0,0
1667919850176,ECE 276A,A00,103667,Atanasov; Nikolay A.,0,0,0,0
1667919850622,ECE 277,A00,103668,An; Cheolhong,0,0,0,0
1667919851056,ECE 279,A00,117947,Hall; Drew A.,0,0,0,0
1667919851909,ECE 283,A00,103670,Hsueh; Tzu-Chien,0,0,0,0
1667919852348,ECE 284,A00,103671,Turakhia; Yatish Girish,0,0,0,0
1667919852777,ECE 285,A00,103672,Zheng; Yang,0,0,0,0
1667919852777,ECE 285,B00,103673,Sworder; David D.,0,0,0,0
1667919853210,ECE 287,A00,103676,Javidi; Tara,0,0,0,0
1667919853649,MATH 200B,A00,098023,Salehi Golsefidy; Alireza,15,0,15,0
1667919854084,MATH 202B,A00,098024,Rhoades; Brendon Patrick,14,0,15,1
1667919854510,MATH 203B,A00,098025,Oprea; Dragos N.,14,0,15,1
1667919854934,MATH 204B,A00,098026,Sorensen; Claus M,15,0,15,0
1667919855358,MATH 208,A00,098027,Izadi; Elham,7,0,10,3
1667919855790,MATH 209,A00,098028,Pollack; Aaron,10,0,10,0
1667919856221,MATH 211A,A00,112919,Rogalski; Daniel,10,0,10,0
1667919856650,MATH 211B,A00,112920,Seward; Brandon M.,10,0,10,0
1667919857079,MATH 218,A00,098029,Li; Bo,10,0,10,0
1667919857503,MATH 220B,A00,098030,Novak; Jonathan I,15,0,15,0
1667919857929,MATH 221A,A00,098031,Ebenfelt; Peter F,15,0,15,0
1667919858356,MATH 231B,A00,098032,Zlatos; Andrej,15,0,15,0
1667919858793,MATH 240B,A00,098033,Ni; Lei,13,0,15,2
1667919859238,MATH 243,A00,098034,Jekel; David Andrew,10,0,10,0
1667919859668,MATH 245A,A00,098035,Nie; Jiawang,6,0,15,9
1667919860107,MATH 248,A00,098036,Bejenaru; Ioan,10,0,10,0
1667919860540,MATH 250B,A00,098037,Spolaor; Luca,14,0,15,1
1667919861009,MATH 258,A00,098038,Ni; Lei,10,0,10,0
1667919861440,MATH 264B,A00,098041,Rhoades; Brendon Patrick,13,0,15,2
1667919861887,MATH 268,A00,098042,Buss; Samuel R,10,0,10,0
1667919862350,MATH 269,A00,098043,Rhoades; Brendon Patrick,10,0,10,0
1667919862801,MATH 270B,A00,098044,Li; Bo,13,0,15,2
1667919863253,MATH 272B,A00,098045,Holst; Michael J,13,0,15,2
1667919863684,MATH 273A,A00,098046,Tian; Xiaochuan,12,0,15,3
1667919864135,MATH 275,A01,098048,Tian; Xiaochuan,7,0,10,3
1667919864561,MATH 278A,A00,098049,Holst; Michael J,8,0,10,2
1667919864990,MATH 278B,A00,098050,Cloninger; Alexander,10,0,10,0
1667919865420,MATH 278C,A00,098051,Nie; Jiawang,9,0,10,1
1667919865847,MATH 280B,A00,098052,Zheng; Tianyi,12,0,15,3
1667919866276,MATH 281B,A00,098053,Bradic; Jelena,6,0,15,9
1667919866709,MATH 282B,A00,098054,Arias-Castro; Ery,2,0,15,13
1667919867229,MATH 285,A00,098055,Fitzsimmons; Patrick J,3,0,15,12
1667919867657,MATH 287B,A00,098056,Arias-Castro; Ery,9,0,15,6
1667919868083,MATH 288,A00,098057,Agarwal; Pooja,9,0,10,1
1667919868083,MATH 288,B00,098058,Zhang; Danna,9,0,10,1
1667919868083,MATH 288,C00,098059,Williams; Ruth J,10,0,10,0
1667919868508,MATH 290B,A00,098060,Roberts; Justin Deritter,14,0,15,1
1667919868941,MATH 292,A00,098061,Belmont; Eva Kinoshita,10,0,10,0
1667919869369,MATH 295,A00,098062,Suk; Andrew Hoon,48,0,50,2
1667919869796,MATH 296,A00,098063,Novak; Jonathan I,20,0,20,0
1667919870230,MATH 297,001,098064,Gamst; Anthony Collins,9997,0,9999,2
1667920381621,COGS 205,A00,101395,Chiba; Andrea,20,0,20,0
1667920382066,COGS 210B,001,101404,Greene; Deanna Jacquelyn,9998,0,9999,1
1667920382066,COGS 210B,002,101417,Xia; Haijun,9999,0,9999,0
1667920382066,COGS 210B,003,101422,Nitz; Douglas A.,9999,0,9999,0
1667920382066,COGS 210B,004,101423,Hollan; James D.,9998,0,9999,1
1667920382066,COGS 210B,005,101424,Deak; Gedeon O.,9999,0,9999,0
1667920382066,COGS 210B,006,101425,Rossano; Federico,9999,0,9999,0
1667920382501,COGS 211B,A00,101427,Coulson; Seana M,9997,0,9999,2
1667920382927,COGS 220,A00,101428,Hollan; James D.,0,0,25,25
1667920383360,COGS 229,A00,101429,Dow; Steven P,19,0,25,6
1667920383828,COGS 230,A00,101430,Klemmer; Scott R,13,0,17,4
1667920384256,COGS 234,A00,101431,Xia; Haijun,11,0,25,14
1667920384691,COGS 260,A00,101432,Kiyonaga; Anastasia,20,0,25,5
1667920384691,COGS 260,B00,101433,Kirsh; David Joel,18,0,25,7
1667920385127,CSE 202,A00,102371,Impagliazzo; Russell,0,0,0,0
1667920385557,CSE 203B,A01,102373,Cheng; Chung Kuan,0,0,0,0
1667920385981,CSE 208,A00,102374,Micciancio; Daniele,0,0,0,0
1667920386438,CSE 209A,A00,112895,Impagliazzo; Russell,0,0,15,15
1667920386874,CSE 209B,A00,108005,Bellare; Mihir,0,0,0,0
1667920387334,CSE 210,A00,113163,Coblenz; Michael J,0,0,0,0
1667920387767,CSE 219,A00,106111,Dow; Steven P,0,0,20,20
1667920388204,CSE 221,A00,102376,Voelker; Geoffrey M.,0,0,0,0
1667920388641,CSE 224,A01,102378,Porter; George M,0,0,0,0
1667920389070,CSE 229A,A00,102379,Savage; Stefan,0,0,0,0
1667920389502,CSE 229C,A00,102380,Munyaka; Imani N. S.,0,0,0,0
1667920389953,CSE 232B,A00,102382,Deutsch; Alin Bernard,0,0,0,0
1667920390398,CSE 234,A01,112904,Kumar; Arun Kumar,0,0,0,0
1667920390833,CSE 237A,A00,102383,Rosing; Tajana Simunic,0,0,0,0
1667920391268,CSE 239A,A00,102384,Deutsch; Alin Bernard,0,0,0,0
1667920391702,CSE 239B,A00,102385,Polikarpova; Nadezhda,0,0,0,0
1667920392141,CSE 240A,A00,102386,Pannuto; Patrick William,0,0,0,0
1667920392573,CSE 240B,A00,102387,Zhao; Jishen,0,0,0,0
1667920393038,CSE 241A,A00,106406,Kang; Mingu,0,0,0,0
1667920393466,CSE 249B,A00,102388,Kahng; Andrew Byun,0,0,8,8
1667920393900,CSE 251B,A01,102392,Cottrell; Garrison W,0,0,0,0
1667920393900,CSE 251B,A02,102393,Cottrell; Garrison W,0,0,0,0
1667920394330,CSE 252B,A00,102394,Ochoa; Benjamin Lawrence,0,0,0,0
1667920394763,CSE 257,A01,102396,Gao; Sicun,0,0,0,0
1667920395193,CSE 272,A00,102397,Li; Tzumao,0,0,0,0
1667920395626,CSE 274,A00,111323,Chern; Albert Ren-Haur,0,0,0,0
1667920396058,CSE 282,A00,102398,Pevzner; Pavel Arkadjevich,0,0,0,0
1667920396504,CSE 284,A00,114175,Gymrek; Melissa Ann,0,0,0,0
1667920396935,CSE 290,A00,102399,Chandraker; Manmohan Krishna,0,0,0,0
1667920396935,CSE 290,B00,102400,Vaccaro; Kristen Marie,0,0,25,25
1667920396935,CSE 290,C00,102414,Pannuto; Patrick William,0,0,25,25
1667920396935,CSE 290,D00,102427,Pevzner; Pavel Arkadjevich,0,0,0,0
1667920396935,CSE 290,E00,102429,Zhao; Jishen,0,0,0,0
1667920396935,CSE 290,F00,102436,Tullsen; Dean Michael,0,0,0,0
1667920396935,CSE 290,G00,102440,Christensen; Henrik I,0,0,20,20
1667920397390,CSE 291,A00,102443,Su; Hao,0,0,0,0
1667920397390,CSE 291,B00,102448,Polikarpova; Nadezhda,0,0,0,0
1667920397390,CSE 291,C00,102453,Vaccaro; Kristen Marie,0,0,0,0
1667920397390,CSE 291,D00,111343,Savage; Stefan,0,0,0,0
1667920397390,CSE 291,E00,116474,Claffy; Kimberly Claire,0,0,0,0
1667920397390,CSE 291,F00,116479,Pasquale; Joseph,0,0,0,0
1667920397840,CSE 293,001,119111,Bafna; Vineet,9999,0,9999,0
1667920397840,CSE 293,002,119118,Bellare; Mihir,9999,0,9999,0
1667920397840,CSE 293,003,119122,Berg-Kirkpatrick; Taylor D,9999,0,9999,0
1667920397840,CSE 293,004,119135,Christensen; Henrik I,9999,0,9999,0
1667920397840,CSE 293,005,119142,Cottrell; Garrison W,9999,0,9999,0
1667920397840,CSE 293,006,119146,Deutsch; Alin Bernard,9999,0,9999,0
1667920397840,CSE 293,007,119159,Esmaeilzadeh; Hadi,9999,0,9999,0
1667920397840,CSE 293,008,119166,Freund; Yoav,9999,0,9999,0
1667920397840,CSE 293,009,119170,Griswold; William G.,9999,0,9999,0
1667920397840,CSE 293,010,119183,Gymrek; Melissa Ann,9999,0,9999,0
1667920397840,CSE 293,011,119190,Heninger; Nadia A,9999,0,9999,0
1667920397840,CSE 293,012,119230,Impagliazzo; Russell,9999,0,9999,0
1667920397840,CSE 293,013,119232,Jhala; Ranjit,9999,0,9999,0
1667920397840,CSE 293,014,119233,Kahng; Andrew Byun,9999,0,9999,0
1667920397840,CSE 293,015,119298,Kane; Daniel Mertz,9999,0,9999,0
1667920397840,CSE 293,016,119299,Kriegman; David J,9999,0,9999,0
1667920397840,CSE 293,017,119300,Kumar; Arun Kumar,9999,0,9999,0
1667920397840,CSE 293,018,119301,Lerner; Sorin,9999,0,9999,0
1667920397840,CSE 293,019,119302,Lovett; Shachar,9999,0,9999,0
1667920397840,CSE 293,020,119303,McAuley; Julian John,9999,0,9999,0
1667920397840,CSE 293,021,119304,Micciancio; Daniele,9999,0,9999,0
1667920397840,CSE 293,022,119367,Orailoglu; Alex,9999,0,9999,0
1667920397840,CSE 293,023,119382,Paturi; Ramamohan,9999,0,9999,0
1667920397840,CSE 293,024,119404,Polikarpova; Nadezhda,9999,0,9999,0
1667920397840,CSE 293,025,119406,Politz; Joseph Gibbs,9999,0,9999,0
1667920397840,CSE 293,026,119411,Porter; George M,9999,0,9999,0
1667920397840,CSE 293,027,119414,Porter; Leonard Emerson,9999,0,9999,0
1667920397840,CSE 293,028,119416,Ramamoorthi; Ravi,9999,0,9999,0
1667920397840,CSE 293,029,119417,Sahoo; Debashis,9999,0,9999,0
1667920397840,CSE 293,030,119420,Saul; Lawrence,9999,0,9999,0
1667920397840,CSE 293,031,119421,Savage; Stefan,9999,0,9999,0
1667920397840,CSE 293,032,119425,Schulze; Jurgen P.,9999,0,9999,0
1667920397840,CSE 293,033,119426,Snoeren; Alex C.,9999,0,9999,0
1667920397840,CSE 293,034,119428,Shang; Jingbo,9999,0,9999,0
1667920397840,CSE 293,035,119430,Stefan; Deian,9999,0,9999,0
1667920397840,CSE 293,036,119431,Su; Hao,9999,0,9999,0
1667920397840,CSE 293,037,119433,Swanson; Steven James,9999,0,9999,0
1667920397840,CSE 293,038,119435,Tullsen; Dean Michael,9999,0,9999,0
1667920397840,CSE 293,039,119483,Voelker; Geoffrey M.,9999,0,9999,0
1667920397840,CSE 293,040,119537,Zhao; Jishen,9999,0,9999,0
1667920397840,CSE 293,041,119538,Zhou; Yuan-Yuan,9999,0,9999,0
1667920397840,CSE 293,042,119539,Gao; Sicun,9999,0,9999,0
1667920397840,CSE 293,043,119540,Weibel; Nadir,9999,0,9999,0
1667920397840,CSE 293,044,119541,Gupta; Rajesh K.,9999,0,9999,0
1667920398271,CSE 294,A00,102459,Voelker; Geoffrey M.,0,0,0,0
1667920398271,CSE 294,B00,111322,Orailoglu; Alex,0,0,0,0
1667920398695,DSE 201,A00,096914,Deutsch; Alin Bernard,30,0,30,0
1667920399227,DSE 210,A00,096915,Dasgupta; Sanjoy,30,0,30,0
1667920399665,DSE 260A,A00,096916,Altintas De Callaf; Ilkay,30,0,30,0
1667920400115,ECE 200,001,103586,Antipa; Nicholas A,9999,0,9999,0
1667920400115,ECE 200,002,103587,Atanasov; Nikolay A.,9999,0,9999,0
1667920400115,ECE 200,003,103588,Bharadia; Dinesh,9999,0,9999,0
1667920400115,ECE 200,004,103589,Cheng; Chung Kuan,9999,0,9999,0
1667920400115,ECE 200,005,103590,Cosman; Pamela C.,9999,0,9999,0
1667920400115,ECE 200,006,103591,Dayeh; Shadi Ahmad,9999,0,9999,0
1667920400115,ECE 200,007,103592,Fainman; Yeshaiahu,9999,0,9999,0
1667920400115,ECE 200,008,103593,Ford; Joseph Earl,9999,0,9999,0
1667920400115,ECE 200,009,103594,Franceschetti; Massimo,9999,0,9999,0
1667920400115,ECE 200,010,103595,Fullerton; Eric E,9999,0,9999,0
1667920400115,ECE 200,011,103596,Galton; Ian A,9999,0,9999,0
1667920400115,ECE 200,012,103597,Gilja; Vikash,9999,0,9999,0
1667920400115,ECE 200,013,103598,Hall; Drew A.,9999,0,9999,0
1667920400115,ECE 200,014,103599,Hsueh; Tzu-Chien,9999,0,9999,0
1667920400115,ECE 200,015,103600,Javidi; Tara,9999,0,9999,0
1667920400115,ECE 200,016,103601,Kahng; Andrew Byun,9999,0,9999,0
1667920400115,ECE 200,017,103602,Kim; Young-Han,9999,0,9999,0
1667920400115,ECE 200,018,103603,Koushanfar; Farinaz,9999,0,9999,0
1667920400115,ECE 200,019,103604,Kuzum; Duygu,9999,0,9999,0
1667920400115,ECE 200,020,103605,Le; Hanh-Phuc,9999,0,9999,0
1667920400115,ECE 200,021,103606,Lin; Bill,9999,0,9999,0
1667920400115,ECE 200,022,103607,Liu; Zhaowei,9998,0,9999,1
1667920400115,ECE 200,023,103608,Lo; Yu-Hwa,9999,0,9999,0
1667920400115,ECE 200,024,103609,Lomakin; Vitaliy,9999,0,9999,0
1667920400115,ECE 200,025,103610,Mercier; Patrick Philip,9999,0,9999,0
1667920400115,ECE 200,026,103611,Meyer; Florian,9999,0,9999,0
1667920400115,ECE 200,027,103612,Milstein; Laurence B.,9999,0,9999,0
1667920400115,ECE 200,028,103613,Mir Arabbaygi; Siavash,9999,0,9999,0
1667920400115,ECE 200,029,103614,Mookherjea; Shayan,9999,0,9999,0
1667920400115,ECE 200,030,103615,Morris; Karcher William,9999,0,9999,0
1667920400115,ECE 200,031,103616,Ng; Tse Nga,9999,0,9999,0
1667920400115,ECE 200,032,103617,Nguyen; Truong Quang,9999,0,9999,0
1667920400115,ECE 200,033,103618,Nomura; Kenji,9999,0,9999,0
1667920400115,ECE 200,034,103619,Orlitsky; Alon,9999,0,9999,0
1667920400115,ECE 200,035,103620,Pal; Piya,9999,0,9999,0
1667920400115,ECE 200,036,103621,Papen; George C.,9999,0,9999,0
1667920400115,ECE 200,037,103622,Radic; Stojan,9999,0,9999,0
1667920400115,ECE 200,038,103623,Rao; Bhaskar D.,9999,0,9999,0
1667920400115,ECE 200,039,103624,Rao; Ramesh R,9999,0,9999,0
1667920400115,ECE 200,040,103625,Rebeiz; Gabriel,9999,0,9999,0
1667920400115,ECE 200,041,103626,Sanford; John R,9999,0,9999,0
1667920400115,ECE 200,042,103627,Siegel; Paul H.,9999,0,9999,0
1667920400115,ECE 200,043,103628,Sievenpiper; Daniel F.,9999,0,9999,0
1667920400115,ECE 200,044,103629,Sworder; David D.,9999,0,9999,0
1667920400115,ECE 200,045,103630,Taur; Yuan,9999,0,9999,0
1667920400115,ECE 200,046,103631,Touri; Behrouz,9999,0,9999,0
1667920400115,ECE 200,047,103632,Trivedi; Mohan M.,9999,0,9999,0
1667920400115,ECE 200,048,103633,Vasconcelos; Nuno,9999,0,9999,0
1667920400115,ECE 200,049,103634,Wang; Xiaolong,9999,0,9999,0
1667920400115,ECE 200,050,103635,Xie; Pengtao,9999,0,9999,0
1667920400115,ECE 200,051,103636,Yip; Michael,9999,0,9999,0
1667920400115,ECE 200,052,103637,Zeger; Kenneth A.,999,0,999,0
1667920400115,ECE 200,053,103638,Zhang; Xinyu,9999,0,9999,0
1667920400115,ECE 200,054,103639,Turakhia; Yatish Girish,9999,0,9999,0
1667920400115,ECE 200,055,103640,Kang; Mingu,9999,0,9999,0
1667920400115,ECE 200,056,103641,Shi; Yuanyuan,9999,0,9999,0
1667920400115,ECE 200,057,103642,Wang; Edward Jay,9999,0,9999,0
1667920400115,ECE 200,058,103643,Zheng; Yang,9999,0,9999,0
1667920400550,ECE 202,A00,103644,Kuzum; Duygu,0,0,0,0
1667920400982,ECE 212BN,A00,103646,Ng; Tse Nga,0,0,0,0
1667920401408,ECE 221,A00,111493,Staff,0,0,0,0
1667920401840,ECE 222B,A00,103647,Lomakin; Vitaliy,0,0,0,0
1667920402274,ECE 230B,A00,103648,Taur; Yuan,0,0,0,0
1667920402709,ECE 238B,A00,103649,Garay; Javier,0,0,0,0
1667920403154,ECE 240B,A00,112900,Fainman; Yeshaiahu,0,0,0,0
1667920403582,ECE 247A,A00,103650,Jokerst; Jesse Vincent,0,0,0,0
1667920404008,ECE 247B,A00,103651,Wang; Joseph,0,0,0,0
1667920404457,ECE 250,A00,103652,Siegel; Paul H.,0,0,0,0
1667920404881,ECE 251A,A00,103654,Rao; Bhaskar D.,0,0,0,0
1667920405322,ECE 257B,A00,103655,Bharadia; Dinesh,0,0,0,0
1667920405754,ECE 258A,A00,103656,Milstein; Laurence B.,0,0,0,0
1667920406201,ECE 260B,A00,103658,Kang; Mingu,0,0,0,0
1667920406628,ECE 264A,A00,103659,Galton; Ian A,0,0,0,0
1667920407066,ECE 265A,A00,103661,Gudem; Prasad S.S.,0,0,0,0
1667920407491,ECE 265D,A00,103662,Gudem; Prasad S.S.,0,0,0,0
1667920407948,ECE 268,A00,103663,Koushanfar; Farinaz,0,0,0,0
1667920408396,ECE 269,A01,103665,Pal; Piya,0,0,0,0
1667920408835,ECE 271B,A00,103666,Vasconcelos; Manuela,0,0,0,0
1667920409258,ECE 276A,A00,103667,Atanasov; Nikolay A.,0,0,0,0
1667920409698,ECE 277,A00,103668,An; Cheolhong,0,0,0,0
1667920410131,ECE 279,A00,117947,Hall; Drew A.,0,0,0,0
1667920411008,ECE 283,A00,103670,Hsueh; Tzu-Chien,0,0,0,0
1667920411447,ECE 284,A00,103671,Turakhia; Yatish Girish,0,0,0,0
1667920411881,ECE 285,A00,103672,Zheng; Yang,0,0,0,0
1667920411881,ECE 285,B00,103673,Sworder; David D.,0,0,0,0
1667920412312,ECE 287,A00,103676,Javidi; Tara,0,0,0,0
1667920412735,MATH 200B,A00,098023,Salehi Golsefidy; Alireza,15,0,15,0
1667920413185,MATH 202B,A00,098024,Rhoades; Brendon Patrick,14,0,15,1
1667920413609,MATH 203B,A00,098025,Oprea; Dragos N.,14,0,15,1
1667920414048,MATH 204B,A00,098026,Sorensen; Claus M,15,0,15,0
1667920414479,MATH 208,A00,098027,Izadi; Elham,7,0,10,3
1667920414906,MATH 209,A00,098028,Pollack; Aaron,10,0,10,0
1667920415384,MATH 211A,A00,112919,Rogalski; Daniel,10,0,10,0
1667920415821,MATH 211B,A00,112920,Seward; Brandon M.,10,0,10,0
1667920416257,MATH 218,A00,098029,Li; Bo,10,0,10,0
1667920416681,MATH 220B,A00,098030,Novak; Jonathan I,15,0,15,0
1667920417109,MATH 221A,A00,098031,Ebenfelt; Peter F,15,0,15,0
1667920417552,MATH 231B,A00,098032,Zlatos; Andrej,15,0,15,0
1667920417986,MATH 240B,A00,098033,Ni; Lei,13,0,15,2
1667920418442,MATH 243,A00,098034,Jekel; David Andrew,10,0,10,0
1667920418875,MATH 245A,A00,098035,Nie; Jiawang,6,0,15,9
1667920419317,MATH 248,A00,098036,Bejenaru; Ioan,10,0,10,0
1667920419752,MATH 250B,A00,098037,Spolaor; Luca,14,0,15,1
1667920420182,MATH 258,A00,098038,Ni; Lei,10,0,10,0
1667920420622,MATH 264B,A00,098041,Rhoades; Brendon Patrick,13,0,15,2
1667920421057,MATH 268,A00,098042,Buss; Samuel R,10,0,10,0
1667920421485,MATH 269,A00,098043,Rhoades; Brendon Patrick,10,0,10,0
1667920421920,MATH 270B,A00,098044,Li; Bo,13,0,15,2
1667920422359,MATH 272B,A00,098045,Holst; Michael J,13,0,15,2
1667920422801,MATH 273A,A00,098046,Tian; Xiaochuan,12,0,15,3
1667920423255,MATH 275,A01,098048,Tian; Xiaochuan,7,0,10,3
1667920423683,MATH 278A,A00,098049,Holst; Michael J,8,0,10,2
1667920424137,MATH 278B,A00,098050,Cloninger; Alexander,10,0,10,0
1667920424566,MATH 278C,A00,098051,Nie; Jiawang,9,0,10,1
1667920425008,MATH 280B,A00,098052,Zheng; Tianyi,12,0,15,3
1667920425449,MATH 281B,A00,098053,Bradic; Jelena,6,0,15,9
1667920425890,MATH 282B,A00,098054,Arias-Castro; Ery,2,0,15,13
1667920426337,MATH 285,A00,098055,Fitzsimmons; Patrick J,3,0,15,12
1667920426780,MATH 287B,A00,098056,Arias-Castro; Ery,9,0,15,6
1667920427208,MATH 288,A00,098057,Agarwal; Pooja,9,0,10,1
1667920427208,MATH 288,B00,098058,Zhang; Danna,9,0,10,1
1667920427208,MATH 288,C00,098059,Williams; Ruth J,10,0,10,0
1667920427635,MATH 290B,A00,098060,Roberts; Justin Deritter,14,0,15,1
1667920428073,MATH 292,A00,098061,Belmont; Eva Kinoshita,10,0,10,0
1667920428511,MATH 295,A00,098062,Suk; Andrew Hoon,48,0,50,2
1667920428940,MATH 296,A00,098063,Novak; Jonathan I,20,0,20,0
1667920429381,MATH 297,001,098064,Gamst; Anthony Collins,9997,0,9999,2
1667920940277,COGS 205,A00,101395,Chiba; Andrea,19,0,20,1
1667920940729,COGS 210B,001,101404,Greene; Deanna Jacquelyn,9998,0,9999,1
1667920940729,COGS 210B,002,101417,Xia; Haijun,9999,0,9999,0
1667920940729,COGS 210B,003,101422,Nitz; Douglas A.,9999,0,9999,0
1667920940729,COGS 210B,004,101423,Hollan; James D.,9998,0,9999,1
1667920940729,COGS 210B,005,101424,Deak; Gedeon O.,9999,0,9999,0
1667920940729,COGS 210B,006,101425,Rossano; Federico,9999,0,9999,0
1667920941203,COGS 211B,A00,101427,Coulson; Seana M,9997,0,9999,2
1667920941630,COGS 220,A00,101428,Hollan; James D.,0,0,25,25
1667920942079,COGS 229,A00,101429,Dow; Steven P,19,0,25,6
1667920942505,COGS 230,A00,101430,Klemmer; Scott R,13,0,17,4
1667920942934,COGS 234,A00,101431,Xia; Haijun,11,0,25,14
1667920943367,COGS 260,A00,101432,Kiyonaga; Anastasia,19,0,25,6
1667920943367,COGS 260,B00,101433,Kirsh; David Joel,18,0,25,7
1667920943806,CSE 202,A00,102371,Impagliazzo; Russell,0,0,0,0
1667920944235,CSE 203B,A01,102373,Cheng; Chung Kuan,0,0,0,0
1667920944662,CSE 208,A00,102374,Micciancio; Daniele,0,0,0,0
1667920945105,CSE 209A,A00,112895,Impagliazzo; Russell,0,0,15,15
1667920945534,CSE 209B,A00,108005,Bellare; Mihir,0,0,0,0
1667920945959,CSE 210,A00,113163,Coblenz; Michael J,0,0,0,0
1667920946386,CSE 219,A00,106111,Dow; Steven P,0,0,20,20
1667920946809,CSE 221,A00,102376,Voelker; Geoffrey M.,0,0,0,0
1667920947245,CSE 224,A01,102378,Porter; George M,0,0,0,0
1667920947673,CSE 229A,A00,102379,Savage; Stefan,0,0,0,0
1667920948103,CSE 229C,A00,102380,Munyaka; Imani N. S.,0,0,0,0
1667920948527,CSE 232B,A00,102382,Deutsch; Alin Bernard,0,0,0,0
1667920948960,CSE 234,A01,112904,Kumar; Arun Kumar,0,0,0,0
1667920949384,CSE 237A,A00,102383,Rosing; Tajana Simunic,0,0,0,0
1667920949823,CSE 239A,A00,102384,Deutsch; Alin Bernard,0,0,0,0
1667920950254,CSE 239B,A00,102385,Polikarpova; Nadezhda,0,0,0,0
1667920950688,CSE 240A,A00,102386,Pannuto; Patrick William,0,0,0,0
1667920951113,CSE 240B,A00,102387,Zhao; Jishen,0,0,0,0
1667920951551,CSE 241A,A00,106406,Kang; Mingu,0,0,0,0
1667920951979,CSE 249B,A00,102388,Kahng; Andrew Byun,0,0,8,8
1667920952419,CSE 251B,A01,102392,Cottrell; Garrison W,0,0,0,0
1667920952419,CSE 251B,A02,102393,Cottrell; Garrison W,0,0,0,0
1667920952848,CSE 252B,A00,102394,Ochoa; Benjamin Lawrence,0,0,0,0
1667920953277,CSE 257,A01,102396,Gao; Sicun,0,0,0,0
1667920953701,CSE 272,A00,102397,Li; Tzumao,0,0,0,0
1667920954132,CSE 274,A00,111323,Chern; Albert Ren-Haur,0,0,0,0
1667920954565,CSE 282,A00,102398,Pevzner; Pavel Arkadjevich,0,0,0,0
1667920954989,CSE 284,A00,114175,Gymrek; Melissa Ann,0,0,0,0
1667920955418,CSE 290,A00,102399,Chandraker; Manmohan Krishna,0,0,0,0
1667920955418,CSE 290,B00,102400,Vaccaro; Kristen Marie,0,0,25,25
1667920955418,CSE 290,C00,102414,Pannuto; Patrick William,0,0,25,25
1667920955418,CSE 290,D00,102427,Pevzner; Pavel Arkadjevich,0,0,0,0
1667920955418,CSE 290,E00,102429,Zhao; Jishen,0,0,0,0
1667920955418,CSE 290,F00,102436,Tullsen; Dean Michael,0,0,0,0
1667920955418,CSE 290,G00,102440,Christensen; Henrik I,0,0,20,20
1667920955856,CSE 291,A00,102443,Su; Hao,0,0,0,0
1667920955856,CSE 291,B00,102448,Polikarpova; Nadezhda,0,0,0,0
1667920955856,CSE 291,C00,102453,Vaccaro; Kristen Marie,0,0,0,0
1667920955856,CSE 291,D00,111343,Savage; Stefan,0,0,0,0
1667920955856,CSE 291,E00,116474,Claffy; Kimberly Claire,0,0,0,0
1667920955856,CSE 291,F00,116479,Pasquale; Joseph,0,0,0,0
1667920956313,CSE 293,001,119111,Bafna; Vineet,9999,0,9999,0
1667920956313,CSE 293,002,119118,Bellare; Mihir,9999,0,9999,0
1667920956313,CSE 293,003,119122,Berg-Kirkpatrick; Taylor D,9999,0,9999,0
1667920956313,CSE 293,004,119135,Christensen; Henrik I,9999,0,9999,0
1667920956313,CSE 293,005,119142,Cottrell; Garrison W,9999,0,9999,0
1667920956313,CSE 293,006,119146,Deutsch; Alin Bernard,9999,0,9999,0
1667920956313,CSE 293,007,119159,Esmaeilzadeh; Hadi,9999,0,9999,0
1667920956313,CSE 293,008,119166,Freund; Yoav,9999,0,9999,0
1667920956313,CSE 293,009,119170,Griswold; William G.,9999,0,9999,0
1667920956313,CSE 293,010,119183,Gymrek; Melissa Ann,9999,0,9999,0
1667920956313,CSE 293,011,119190,Heninger; Nadia A,9999,0,9999,0
1667920956313,CSE 293,012,119230,Impagliazzo; Russell,9999,0,9999,0
1667920956313,CSE 293,013,119232,Jhala; Ranjit,9999,0,9999,0
1667920956313,CSE 293,014,119233,Kahng; Andrew Byun,9999,0,9999,0
1667920956313,CSE 293,015,119298,Kane; Daniel Mertz,9999,0,9999,0
1667920956313,CSE 293,016,119299,Kriegman; David J,9999,0,9999,0
1667920956313,CSE 293,017,119300,Kumar; Arun Kumar,9999,0,9999,0
1667920956313,CSE 293,018,119301,Lerner; Sorin,9999,0,9999,0
1667920956313,CSE 293,019,119302,Lovett; Shachar,9999,0,9999,0
1667920956313,CSE 293,020,119303,McAuley; Julian John,9999,0,9999,0
1667920956313,CSE 293,021,119304,Micciancio; Daniele,9999,0,9999,0
1667920956313,CSE 293,022,119367,Orailoglu; Alex,9999,0,9999,0
1667920956313,CSE 293,023,119382,Paturi; Ramamohan,9999,0,9999,0
1667920956313,CSE 293,024,119404,Polikarpova; Nadezhda,9999,0,9999,0
1667920956313,CSE 293,025,119406,Politz; Joseph Gibbs,9999,0,9999,0
1667920956313,CSE 293,026,119411,Porter; George M,9999,0,9999,0
1667920956313,CSE 293,027,119414,Porter; Leonard Emerson,9999,0,9999,0
1667920956313,CSE 293,028,119416,Ramamoorthi; Ravi,9999,0,9999,0
1667920956313,CSE 293,029,119417,Sahoo; Debashis,9999,0,9999,0
1667920956313,CSE 293,030,119420,Saul; Lawrence,9999,0,9999,0
1667920956313,CSE 293,031,119421,Savage; Stefan,9999,0,9999,0
1667920956313,CSE 293,032,119425,Schulze; Jurgen P.,9999,0,9999,0
1667920956313,CSE 293,033,119426,Snoeren; Alex C.,9999,0,9999,0
1667920956313,CSE 293,034,119428,Shang; Jingbo,9999,0,9999,0
1667920956313,CSE 293,035,119430,Stefan; Deian,9999,0,9999,0
1667920956313,CSE 293,036,119431,Su; Hao,9999,0,9999,0
1667920956313,CSE 293,037,119433,Swanson; Steven James,9999,0,9999,0
1667920956313,CSE 293,038,119435,Tullsen; Dean Michael,9999,0,9999,0
1667920956313,CSE 293,039,119483,Voelker; Geoffrey M.,9999,0,9999,0
1667920956313,CSE 293,040,119537,Zhao; Jishen,9999,0,9999,0
1667920956313,CSE 293,041,119538,Zhou; Yuan-Yuan,9999,0,9999,0
1667920956313,CSE 293,042,119539,Gao; Sicun,9999,0,9999,0
1667920956313,CSE 293,043,119540,Weibel; Nadir,9999,0,9999,0
1667920956313,CSE 293,044,119541,Gupta; Rajesh K.,9999,0,9999,0
1667920956737,CSE 294,A00,102459,Voelker; Geoffrey M.,0,0,0,0
1667920956737,CSE 294,B00,111322,Orailoglu; Alex,0,0,0,0
1667920957167,DSE 201,A00,096914,Deutsch; Alin Bernard,30,0,30,0
1667920957593,DSE 210,A00,096915,Dasgupta; Sanjoy,30,0,30,0
1667920958031,DSE 260A,A00,096916,Altintas De Callaf; Ilkay,30,0,30,0
1667920958526,ECE 200,001,103586,Antipa; Nicholas A,9999,0,9999,0
1667920958526,ECE 200,002,103587,Atanasov; Nikolay A.,9999,0,9999,0
1667920958526,ECE 200,003,103588,Bharadia; Dinesh,9999,0,9999,0
1667920958526,ECE 200,004,103589,Cheng; Chung Kuan,9999,0,9999,0
1667920958526,ECE 200,005,103590,Cosman; Pamela C.,9999,0,9999,0
1667920958526,ECE 200,006,103591,Dayeh; Shadi Ahmad,9999,0,9999,0
1667920958526,ECE 200,007,103592,Fainman; Yeshaiahu,9999,0,9999,0
1667920958526,ECE 200,008,103593,Ford; Joseph Earl,9999,0,9999,0
1667920958526,ECE 200,009,103594,Franceschetti; Massimo,9999,0,9999,0
1667920958526,ECE 200,010,103595,Fullerton; Eric E,9999,0,9999,0
1667920958526,ECE 200,011,103596,Galton; Ian A,9999,0,9999,0
1667920958526,ECE 200,012,103597,Gilja; Vikash,9999,0,9999,0
1667920958526,ECE 200,013,103598,Hall; Drew A.,9999,0,9999,0
1667920958526,ECE 200,014,103599,Hsueh; Tzu-Chien,9999,0,9999,0
1667920958526,ECE 200,015,103600,Javidi; Tara,9999,0,9999,0
1667920958526,ECE 200,016,103601,Kahng; Andrew Byun,9999,0,9999,0
1667920958526,ECE 200,017,103602,Kim; Young-Han,9999,0,9999,0
1667920958526,ECE 200,018,103603,Koushanfar; Farinaz,9999,0,9999,0
1667920958526,ECE 200,019,103604,Kuzum; Duygu,9999,0,9999,0
1667920958526,ECE 200,020,103605,Le; Hanh-Phuc,9999,0,9999,0
1667920958526,ECE 200,021,103606,Lin; Bill,9999,0,9999,0
1667920958526,ECE 200,022,103607,Liu; Zhaowei,9998,0,9999,1
1667920958526,ECE 200,023,103608,Lo; Yu-Hwa,9999,0,9999,0
1667920958526,ECE 200,024,103609,Lomakin; Vitaliy,9999,0,9999,0
1667920958526,ECE 200,025,103610,Mercier; Patrick Philip,9999,0,9999,0
1667920958526,ECE 200,026,103611,Meyer; Florian,9999,0,9999,0
1667920958526,ECE 200,027,103612,Milstein; Laurence B.,9999,0,9999,0
1667920958526,ECE 200,028,103613,Mir Arabbaygi; Siavash,9999,0,9999,0
1667920958526,ECE 200,029,103614,Mookherjea; Shayan,9999,0,9999,0
1667920958526,ECE 200,030,103615,Morris; Karcher William,9999,0,9999,0
1667920958526,ECE 200,031,103616,Ng; Tse Nga,9999,0,9999,0
1667920958526,ECE 200,032,103617,Nguyen; Truong Quang,9999,0,9999,0
1667920958526,ECE 200,033,103618,Nomura; Kenji,9999,0,9999,0
1667920958526,ECE 200,034,103619,Orlitsky; Alon,9999,0,9999,0
1667920958526,ECE 200,035,103620,Pal; Piya,9999,0,9999,0
1667920958526,ECE 200,036,103621,Papen; George C.,9999,0,9999,0
1667920958526,ECE 200,037,103622,Radic; Stojan,9999,0,9999,0
1667920958526,ECE 200,038,103623,Rao; Bhaskar D.,9999,0,9999,0
1667920958526,ECE 200,039,103624,Rao; Ramesh R,9999,0,9999,0
1667920958526,ECE 200,040,103625,Rebeiz; Gabriel,9999,0,9999,0
1667920958526,ECE 200,041,103626,Sanford; John R,9999,0,9999,0
1667920958526,ECE 200,042,103627,Siegel; Paul H.,9999,0,9999,0
1667920958526,ECE 200,043,103628,Sievenpiper; Daniel F.,9999,0,9999,0
1667920958526,ECE 200,044,103629,Sworder; David D.,9999,0,9999,0
1667920958526,ECE 200,045,103630,Taur; Yuan,9999,0,9999,0
1667920958526,ECE 200,046,103631,Touri; Behrouz,9999,0,9999,0
1667920958526,ECE 200,047,103632,Trivedi; Mohan M.,9999,0,9999,0
1667920958526,ECE 200,048,103633,Vasconcelos; Nuno,9999,0,9999,0
1667920958526,ECE 200,049,103634,Wang; Xiaolong,9999,0,9999,0
1667920958526,ECE 200,050,103635,Xie; Pengtao,9999,0,9999,0
1667920958526,ECE 200,051,103636,Yip; Michael,9999,0,9999,0
1667920958526,ECE 200,052,103637,Zeger; Kenneth A.,999,0,999,0
1667920958526,ECE 200,053,103638,Zhang; Xinyu,9999,0,9999,0
1667920958526,ECE 200,054,103639,Turakhia; Yatish Girish,9999,0,9999,0
1667920958526,ECE 200,055,103640,Kang; Mingu,9999,0,9999,0
1667920958526,ECE 200,056,103641,Shi; Yuanyuan,9999,0,9999,0
1667920958526,ECE 200,057,103642,Wang; Edward Jay,9999,0,9999,0
1667920958526,ECE 200,058,103643,Zheng; Yang,9999,0,9999,0
1667920958967,ECE 202,A00,103644,Kuzum; Duygu,0,0,0,0
1667920959405,ECE 212BN,A00,103646,Ng; Tse Nga,0,0,0,0
1667920959847,ECE 221,A00,111493,Staff,0,0,0,0
1667920960283,ECE 222B,A00,103647,Lomakin; Vitaliy,0,0,0,0
1667920960712,ECE 230B,A00,103648,Taur; Yuan,0,0,0,0
1667920961166,ECE 238B,A00,103649,Garay; Javier,0,0,0,0
1667920961588,ECE 240B,A00,112900,Fainman; Yeshaiahu,0,0,0,0
1667920962025,ECE 247A,A00,103650,Jokerst; Jesse Vincent,0,0,0,0
1667920962465,ECE 247B,A00,103651,Wang; Joseph,0,0,0,0
1667920962895,ECE 250,A00,103652,Siegel; Paul H.,0,0,0,0
1667920963321,ECE 251A,A00,103654,Rao; Bhaskar D.,0,0,0,0
1667920963747,ECE 257B,A00,103655,Bharadia; Dinesh,0,0,0,0
1667920964189,ECE 258A,A00,103656,Milstein; Laurence B.,0,0,0,0
1667920964620,ECE 260B,A00,103658,Kang; Mingu,0,0,0,0
1667920965065,ECE 264A,A00,103659,Galton; Ian A,0,0,0,0
1667920965523,ECE 265A,A00,103661,Gudem; Prasad S.S.,0,0,0,0
1667920965950,ECE 265D,A00,103662,Gudem; Prasad S.S.,0,0,0,0
1667920966406,ECE 268,A00,103663,Koushanfar; Farinaz,0,0,0,0
1667920966831,ECE 269,A01,103665,Pal; Piya,0,0,0,0
1667920967254,ECE 271B,A00,103666,Vasconcelos; Manuela,0,0,0,0
1667920967686,ECE 276A,A00,103667,Atanasov; Nikolay A.,0,0,0,0
1667920968118,ECE 277,A00,103668,An; Cheolhong,0,0,0,0
1667920968546,ECE 279,A00,117947,Hall; Drew A.,0,0,0,0
1667920969423,ECE 283,A00,103670,Hsueh; Tzu-Chien,0,0,0,0
1667920969860,ECE 284,A00,103671,Turakhia; Yatish Girish,0,0,0,0
1667920970305,ECE 285,A00,103672,Zheng; Yang,0,0,0,0
1667920970305,ECE 285,B00,103673,Sworder; David D.,0,0,0,0
1667920970733,ECE 287,A00,103676,Javidi; Tara,0,0,0,0
1667920971160,MATH 200B,A00,098023,Salehi Golsefidy; Alireza,15,0,15,0
1667920971593,MATH 202B,A00,098024,Rhoades; Brendon Patrick,14,0,15,1
1667920972032,MATH 203B,A00,098025,Oprea; Dragos N.,14,0,15,1
1667920972469,MATH 204B,A00,098026,Sorensen; Claus M,15,0,15,0
1667920972896,MATH 208,A00,098027,Izadi; Elham,7,0,10,3
1667920973332,MATH 209,A00,098028,Pollack; Aaron,10,0,10,0
1667920973759,MATH 211A,A00,112919,Rogalski; Daniel,10,0,10,0
1667920974228,MATH 211B,A00,112920,Seward; Brandon M.,10,0,10,0
1667920974772,MATH 218,A00,098029,Li; Bo,10,0,10,0
1667920975220,MATH 220B,A00,098030,Novak; Jonathan I,15,0,15,0
1667920975644,MATH 221A,A00,098031,Ebenfelt; Peter F,15,0,15,0
1667920976078,MATH 231B,A00,098032,Zlatos; Andrej,15,0,15,0
1667920976518,MATH 240B,A00,098033,Ni; Lei,13,0,15,2
1667920976945,MATH 243,A00,098034,Jekel; David Andrew,10,0,10,0
1667920977369,MATH 245A,A00,098035,Nie; Jiawang,6,0,15,9
1667920977795,MATH 248,A00,098036,Bejenaru; Ioan,10,0,10,0
1667920978242,MATH 250B,A00,098037,Spolaor; Luca,14,0,15,1
1667920978674,MATH 258,A00,098038,Ni; Lei,10,0,10,0
1667920979105,MATH 264B,A00,098041,Rhoades; Brendon Patrick,13,0,15,2
1667920979546,MATH 268,A00,098042,Buss; Samuel R,10,0,10,0
1667920979975,MATH 269,A00,098043,Rhoades; Brendon Patrick,10,0,10,0
1667920980426,MATH 270B,A00,098044,Li; Bo,13,0,15,2
1667920980861,MATH 272B,A00,098045,Holst; Michael J,13,0,15,2
1667920981287,MATH 273A,A00,098046,Tian; Xiaochuan,12,0,15,3
1667920981712,MATH 275,A01,098048,Tian; Xiaochuan,7,0,10,3
1667920982136,MATH 278A,A00,098049,Holst; Michael J,8,0,10,2
1667920982575,MATH 278B,A00,098050,Cloninger; Alexander,10,0,10,0
1667920983010,MATH 278C,A00,098051,Nie; Jiawang,9,0,10,1
1667920983451,MATH 280B,A00,098052,Zheng; Tianyi,12,0,15,3
1667920983879,MATH 281B,A00,098053,Bradic; Jelena,6,0,15,9
1667920984312,MATH 282B,A00,098054,Arias-Castro; Ery,2,0,15,13
1667920984746,MATH 285,A00,098055,Fitzsimmons; Patrick J,3,0,15,12
1667920985179,MATH 287B,A00,098056,Arias-Castro; Ery,9,0,15,6
1667920985617,MATH 288,A00,098057,Agarwal; Pooja,9,0,10,1
1667920985617,MATH 288,B00,098058,Zhang; Danna,9,0,10,1
1667920985617,MATH 288,C00,098059,Williams; Ruth J,10,0,10,0
1667920986041,MATH 290B,A00,098060,Roberts; Justin Deritter,14,0,15,1
1667920986494,MATH 292,A00,098061,Belmont; Eva Kinoshita,10,0,10,0
1667920986935,MATH 295,A00,098062,Suk; Andrew Hoon,48,0,50,2
1667920987368,MATH 296,A00,098063,Novak; Jonathan I,20,0,20,0
1667920987797,MATH 297,001,098064,Gamst; Anthony Collins,9997,0,9999,2
1667921498943,COGS 205,A00,101395,Chiba; Andrea,19,0,20,1
1667921499378,COGS 210B,001,101404,Greene; Deanna Jacquelyn,9998,0,9999,1
1667921499378,COGS 210B,002,101417,Xia; Haijun,9999,0,9999,0
1667921499378,COGS 210B,003,101422,Nitz; Douglas A.,9999,0,9999,0
1667921499378,COGS 210B,004,101423,Hollan; James D.,9998,0,9999,1
1667921499378,COGS 210B,005,101424,Deak; Gedeon O.,9999,0,9999,0
1667921499378,COGS 210B,006,101425,Rossano; Federico,9999,0,9999,0
1667921499807,COGS 211B,A00,101427,Coulson; Seana M,9997,0,9999,2
1667921500249,COGS 220,A00,101428,Hollan; James D.,0,0,25,25
1667921500680,COGS 229,A00,101429,Dow; Steven P,19,0,25,6
1667921501106,COGS 230,A00,101430,Klemmer; Scott R,13,0,17,4
1667921501537,COGS 234,A00,101431,Xia; Haijun,11,0,25,14
1667921501985,COGS 260,A00,101432,Kiyonaga; Anastasia,19,0,25,6
1667921501985,COGS 260,B00,101433,Kirsh; David Joel,18,0,25,7
1667921502419,CSE 202,A00,102371,Impagliazzo; Russell,0,0,0,0
1667921502860,CSE 203B,A01,102373,Cheng; Chung Kuan,0,0,0,0
1667921503288,CSE 208,A00,102374,Micciancio; Daniele,0,0,0,0
1667921503729,CSE 209A,A00,112895,Impagliazzo; Russell,0,0,15,15
1667921504170,CSE 209B,A00,108005,Bellare; Mihir,0,0,0,0
1667921504606,CSE 210,A00,113163,Coblenz; Michael J,0,0,0,0
1667921505039,CSE 219,A00,106111,Dow; Steven P,0,0,20,20
1667921505476,CSE 221,A00,102376,Voelker; Geoffrey M.,0,0,0,0
1667921505907,CSE 224,A01,102378,Porter; George M,0,0,0,0
1667921506424,CSE 229A,A00,102379,Savage; Stefan,0,0,0,0
1667921506893,CSE 229C,A00,102380,Munyaka; Imani N. S.,0,0,0,0
1667921507342,CSE 232B,A00,102382,Deutsch; Alin Bernard,0,0,0,0
1667921507782,CSE 234,A01,112904,Kumar; Arun Kumar,0,0,0,0
1667921508213,CSE 237A,A00,102383,Rosing; Tajana Simunic,0,0,0,0
1667921508652,CSE 239A,A00,102384,Deutsch; Alin Bernard,0,0,0,0
1667921509082,CSE 239B,A00,102385,Polikarpova; Nadezhda,0,0,0,0
1667921509522,CSE 240A,A00,102386,Pannuto; Patrick William,0,0,0,0
1667921509948,CSE 240B,A00,102387,Zhao; Jishen,0,0,0,0
1667921510381,CSE 241A,A00,106406,Kang; Mingu,0,0,0,0
1667921510816,CSE 249B,A00,102388,Kahng; Andrew Byun,0,0,8,8
1667921511255,CSE 251B,A01,102392,Cottrell; Garrison W,0,0,0,0
1667921511255,CSE 251B,A02,102393,Cottrell; Garrison W,0,0,0,0
1667921511683,CSE 252B,A00,102394,Ochoa; Benjamin Lawrence,0,0,0,0
1667921512112,CSE 257,A01,102396,Gao; Sicun,0,0,0,0
1667921512539,CSE 272,A00,102397,Li; Tzumao,0,0,0,0
1667921512984,CSE 274,A00,111323,Chern; Albert Ren-Haur,0,0,0,0
1667921513415,CSE 282,A00,102398,Pevzner; Pavel Arkadjevich,0,0,0,0
1667921513848,CSE 284,A00,114175,Gymrek; Melissa Ann,0,0,0,0
1667921514309,CSE 290,A00,102399,Chandraker; Manmohan Krishna,0,0,0,0
1667921514309,CSE 290,B00,102400,Vaccaro; Kristen Marie,0,0,25,25
1667921514309,CSE 290,C00,102414,Pannuto; Patrick William,0,0,25,25
1667921514309,CSE 290,D00,102427,Pevzner; Pavel Arkadjevich,0,0,0,0
1667921514309,CSE 290,E00,102429,Zhao; Jishen,0,0,0,0
1667921514309,CSE 290,F00,102436,Tullsen; Dean Michael,0,0,0,0
1667921514309,CSE 290,G00,102440,Christensen; Henrik I,0,0,20,20
1667921514745,CSE 291,A00,102443,Su; Hao,0,0,0,0
1667921514745,CSE 291,B00,102448,Polikarpova; Nadezhda,0,0,0,0
1667921514745,CSE 291,C00,102453,Vaccaro; Kristen Marie,0,0,0,0
1667921514745,CSE 291,D00,111343,Savage; Stefan,0,0,0,0
1667921514745,CSE 291,E00,116474,Claffy; Kimberly Claire,0,0,0,0
1667921514745,CSE 291,F00,116479,Pasquale; Joseph,0,0,0,0
1667921515213,CSE 293,001,119111,Bafna; Vineet,9999,0,9999,0
1667921515213,CSE 293,002,119118,Bellare; Mihir,9999,0,9999,0
1667921515213,CSE 293,003,119122,Berg-Kirkpatrick; Taylor D,9999,0,9999,0
1667921515213,CSE 293,004,119135,Christensen; Henrik I,9999,0,9999,0
1667921515213,CSE 293,005,119142,Cottrell; Garrison W,9999,0,9999,0
1667921515213,CSE 293,006,119146,Deutsch; Alin Bernard,9999,0,9999,0
1667921515213,CSE 293,007,119159,Esmaeilzadeh; Hadi,9999,0,9999,0
1667921515213,CSE 293,008,119166,Freund; Yoav,9999,0,9999,0
1667921515213,CSE 293,009,119170,Griswold; William G.,9999,0,9999,0
1667921515213,CSE 293,010,119183,Gymrek; Melissa Ann,9999,0,9999,0
1667921515213,CSE 293,011,119190,Heninger; Nadia A,9999,0,9999,0
1667921515213,CSE 293,012,119230,Impagliazzo; Russell,9999,0,9999,0
1667921515213,CSE 293,013,119232,Jhala; Ranjit,9999,0,9999,0
1667921515213,CSE 293,014,119233,Kahng; Andrew Byun,9999,0,9999,0
1667921515213,CSE 293,015,119298,Kane; Daniel Mertz,9999,0,9999,0
1667921515213,CSE 293,016,119299,Kriegman; David J,9999,0,9999,0
1667921515213,CSE 293,017,119300,Kumar; Arun Kumar,9999,0,9999,0
1667921515213,CSE 293,018,119301,Lerner; Sorin,9999,0,9999,0
1667921515213,CSE 293,019,119302,Lovett; Shachar,9999,0,9999,0
1667921515213,CSE 293,020,119303,McAuley; Julian John,9999,0,9999,0
1667921515213,CSE 293,021,119304,Micciancio; Daniele,9999,0,9999,0
1667921515213,CSE 293,022,119367,Orailoglu; Alex,9999,0,9999,0
1667921515213,CSE 293,023,119382,Paturi; Ramamohan,9999,0,9999,0
1667921515213,CSE 293,024,119404,Polikarpova; Nadezhda,9999,0,9999,0
1667921515213,CSE 293,025,119406,Politz; Joseph Gibbs,9999,0,9999,0
1667921515213,CSE 293,026,119411,Porter; George M,9999,0,9999,0
1667921515213,CSE 293,027,119414,Porter; Leonard Emerson,9999,0,9999,0
1667921515213,CSE 293,028,119416,Ramamoorthi; Ravi,9999,0,9999,0
1667921515213,CSE 293,029,119417,Sahoo; Debashis,9999,0,9999,0
1667921515213,CSE 293,030,119420,Saul; Lawrence,9999,0,9999,0
1667921515213,CSE 293,031,119421,Savage; Stefan,9999,0,9999,0
1667921515213,CSE 293,032,119425,Schulze; Jurgen P.,9999,0,9999,0
1667921515213,CSE 293,033,119426,Snoeren; Alex C.,9999,0,9999,0
1667921515213,CSE 293,034,119428,Shang; Jingbo,9999,0,9999,0
1667921515213,CSE 293,035,119430,Stefan; Deian,9999,0,9999,0
1667921515213,CSE 293,036,119431,Su; Hao,9999,0,9999,0
1667921515213,CSE 293,037,119433,Swanson; Steven James,9999,0,9999,0
1667921515213,CSE 293,038,119435,Tullsen; Dean Michael,9999,0,9999,0
1667921515213,CSE 293,039,119483,Voelker; Geoffrey M.,9999,0,9999,0
1667921515213,CSE 293,040,119537,Zhao; Jishen,9999,0,9999,0
1667921515213,CSE 293,041,119538,Zhou; Yuan-Yuan,9999,0,9999,0
1667921515213,CSE 293,042,119539,Gao; Sicun,9999,0,9999,0
1667921515213,CSE 293,043,119540,Weibel; Nadir,9999,0,9999,0
1667921515213,CSE 293,044,119541,Gupta; Rajesh K.,9999,0,9999,0
1667921515653,CSE 294,A00,102459,Voelker; Geoffrey M.,0,0,0,0
1667921515653,CSE 294,B00,111322,Orailoglu; Alex,0,0,0,0
1667921516079,DSE 201,A00,096914,Deutsch; Alin Bernard,30,0,30,0
1667921516529,DSE 210,A00,096915,Dasgupta; Sanjoy,30,0,30,0
1667921516974,DSE 260A,A00,096916,Altintas De Callaf; Ilkay,30,0,30,0
1667921517434,ECE 200,001,103586,Antipa; Nicholas A,9999,0,9999,0
1667921517434,ECE 200,002,103587,Atanasov; Nikolay A.,9999,0,9999,0
1667921517434,ECE 200,003,103588,Bharadia; Dinesh,9999,0,9999,0
1667921517434,ECE 200,004,103589,Cheng; Chung Kuan,9999,0,9999,0
1667921517434,ECE 200,005,103590,Cosman; Pamela C.,9999,0,9999,0
1667921517434,ECE 200,006,103591,Dayeh; Shadi Ahmad,9999,0,9999,0
1667921517434,ECE 200,007,103592,Fainman; Yeshaiahu,9999,0,9999,0
1667921517434,ECE 200,008,103593,Ford; Joseph Earl,9999,0,9999,0
1667921517434,ECE 200,009,103594,Franceschetti; Massimo,9999,0,9999,0
1667921517434,ECE 200,010,103595,Fullerton; Eric E,9999,0,9999,0
1667921517434,ECE 200,011,103596,Galton; Ian A,9999,0,9999,0
1667921517434,ECE 200,012,103597,Gilja; Vikash,9999,0,9999,0
1667921517434,ECE 200,013,103598,Hall; Drew A.,9999,0,9999,0
1667921517434,ECE 200,014,103599,Hsueh; Tzu-Chien,9999,0,9999,0
1667921517434,ECE 200,015,103600,Javidi; Tara,9999,0,9999,0
1667921517434,ECE 200,016,103601,Kahng; Andrew Byun,9999,0,9999,0
1667921517434,ECE 200,017,103602,Kim; Young-Han,9999,0,9999,0
1667921517434,ECE 200,018,103603,Koushanfar; Farinaz,9999,0,9999,0
1667921517434,ECE 200,019,103604,Kuzum; Duygu,9999,0,9999,0
1667921517434,ECE 200,020,103605,Le; Hanh-Phuc,9999,0,9999,0
1667921517434,ECE 200,021,103606,Lin; Bill,9999,0,9999,0
1667921517434,ECE 200,022,103607,Liu; Zhaowei,9998,0,9999,1
1667921517434,ECE 200,023,103608,Lo; Yu-Hwa,9999,0,9999,0
1667921517434,ECE 200,024,103609,Lomakin; Vitaliy,9999,0,9999,0
1667921517434,ECE 200,025,103610,Mercier; Patrick Philip,9999,0,9999,0
1667921517434,ECE 200,026,103611,Meyer; Florian,9999,0,9999,0
1667921517434,ECE 200,027,103612,Milstein; Laurence B.,9999,0,9999,0
1667921517434,ECE 200,028,103613,Mir Arabbaygi; Siavash,9999,0,9999,0
1667921517434,ECE 200,029,103614,Mookherjea; Shayan,9999,0,9999,0
1667921517434,ECE 200,030,103615,Morris; Karcher William,9999,0,9999,0
1667921517434,ECE 200,031,103616,Ng; Tse Nga,9999,0,9999,0
1667921517434,ECE 200,032,103617,Nguyen; Truong Quang,9999,0,9999,0
1667921517434,ECE 200,033,103618,Nomura; Kenji,9999,0,9999,0
1667921517434,ECE 200,034,103619,Orlitsky; Alon,9999,0,9999,0
1667921517434,ECE 200,035,103620,Pal; Piya,9999,0,9999,0
1667921517434,ECE 200,036,103621,Papen; George C.,9999,0,9999,0
1667921517434,ECE 200,037,103622,Radic; Stojan,9999,0,9999,0
1667921517434,ECE 200,038,103623,Rao; Bhaskar D.,9999,0,9999,0
1667921517434,ECE 200,039,103624,Rao; Ramesh R,9999,0,9999,0
1667921517434,ECE 200,040,103625,Rebeiz; Gabriel,9999,0,9999,0
1667921517434,ECE 200,041,103626,Sanford; John R,9999,0,9999,0
1667921517434,ECE 200,042,103627,Siegel; Paul H.,9999,0,9999,0
1667921517434,ECE 200,043,103628,Sievenpiper; Daniel F.,9999,0,9999,0
1667921517434,ECE 200,044,103629,Sworder; David D.,9999,0,9999,0
1667921517434,ECE 200,045,103630,Taur; Yuan,9999,0,9999,0
1667921517434,ECE 200,046,103631,Touri; Behrouz,9999,0,9999,0
1667921517434,ECE 200,047,103632,Trivedi; Mohan M.,9999,0,9999,0
1667921517434,ECE 200,048,103633,Vasconcelos; Nuno,9999,0,9999,0
1667921517434,ECE 200,049,103634,Wang; Xiaolong,9999,0,9999,0
1667921517434,ECE 200,050,103635,Xie; Pengtao,9999,0,9999,0
1667921517434,ECE 200,051,103636,Yip; Michael,9999,0,9999,0
1667921517434,ECE 200,052,103637,Zeger; Kenneth A.,999,0,999,0
1667921517434,ECE 200,053,103638,Zhang; Xinyu,9999,0,9999,0
1667921517434,ECE 200,054,103639,Turakhia; Yatish Girish,9999,0,9999,0
1667921517434,ECE 200,055,103640,Kang; Mingu,9999,0,9999,0
1667921517434,ECE 200,056,103641,Shi; Yuanyuan,9999,0,9999,0
1667921517434,ECE 200,057,103642,Wang; Edward Jay,9999,0,9999,0
1667921517434,ECE 200,058,103643,Zheng; Yang,9999,0,9999,0
1667921517882,ECE 202,A00,103644,Kuzum; Duygu,0,0,0,0
1667921518312,ECE 212BN,A00,103646,Ng; Tse Nga,0,0,0,0
1667921518746,ECE 221,A00,111493,Staff,0,0,0,0
1667921519182,ECE 222B,A00,103647,Lomakin; Vitaliy,0,0,0,0
1667921519609,ECE 230B,A00,103648,Taur; Yuan,0,0,0,0
1667921520044,ECE 238B,A00,103649,Garay; Javier,0,0,0,0
1667921520480,ECE 240B,A00,112900,Fainman; Yeshaiahu,0,0,0,0
1667921520917,ECE 247A,A00,103650,Jokerst; Jesse Vincent,0,0,0,0
1667921521347,ECE 247B,A00,103651,Wang; Joseph,0,0,0,0
1667921521781,ECE 250,A00,103652,Siegel; Paul H.,0,0,0,0
1667921522211,ECE 251A,A00,103654,Rao; Bhaskar D.,0,0,0,0
1667921522652,ECE 257B,A00,103655,Bharadia; Dinesh,0,0,0,0
1667921523086,ECE 258A,A00,103656,Milstein; Laurence B.,0,0,0,0
1667921523525,ECE 260B,A00,103658,Kang; Mingu,0,0,0,0
1667921523965,ECE 264A,A00,103659,Galton; Ian A,0,0,0,0
1667921524388,ECE 265A,A00,103661,Gudem; Prasad S.S.,0,0,0,0
1667921524830,ECE 265D,A00,103662,Gudem; Prasad S.S.,0,0,0,0
1667921525261,ECE 268,A00,103663,Koushanfar; Farinaz,0,0,0,0
1667921525686,ECE 269,A01,103665,Pal; Piya,0,0,0,0
1667921526124,ECE 271B,A00,103666,Vasconcelos; Manuela,0,0,0,0
1667921526553,ECE 276A,A00,103667,Atanasov; Nikolay A.,0,0,0,0
1667921526982,ECE 277,A00,103668,An; Cheolhong,0,0,0,0
1667921527425,ECE 279,A00,117947,Hall; Drew A.,0,0,0,0
1667921528338,ECE 283,A00,103670,Hsueh; Tzu-Chien,0,0,0,0
1667921528774,ECE 284,A00,103671,Turakhia; Yatish Girish,0,0,0,0
1667921529211,ECE 285,A00,103672,Zheng; Yang,0,0,0,0
1667921529211,ECE 285,B00,103673,Sworder; David D.,0,0,0,0
1667921529664,ECE 287,A00,103676,Javidi; Tara,0,0,0,0
1667921530108,MATH 200B,A00,098023,Salehi Golsefidy; Alireza,15,0,15,0
1667921530540,MATH 202B,A00,098024,Rhoades; Brendon Patrick,14,0,15,1
1667921530973,MATH 203B,A00,098025,Oprea; Dragos N.,14,0,15,1
1667921531394,MATH 204B,A00,098026,Sorensen; Claus M,15,0,15,0
1667921531821,MATH 208,A00,098027,Izadi; Elham,7,0,10,3
1667921532248,MATH 209,A00,098028,Pollack; Aaron,10,0,10,0
1667921532678,MATH 211A,A00,112919,Rogalski; Daniel,10,0,10,0
1667921533110,MATH 211B,A00,112920,Seward; Brandon M.,10,0,10,0
1667921533542,MATH 218,A00,098029,Li; Bo,10,0,10,0
1667921533980,MATH 220B,A00,098030,Novak; Jonathan I,15,0,15,0
1667921534416,MATH 221A,A00,098031,Ebenfelt; Peter F,15,0,15,0
1667921534846,MATH 231B,A00,098032,Zlatos; Andrej,15,0,15,0
1667921535285,MATH 240B,A00,098033,Ni; Lei,13,0,15,2
1667921535716,MATH 243,A00,098034,Jekel; David Andrew,10,0,10,0
1667921536150,MATH 245A,A00,098035,Nie; Jiawang,6,0,15,9
1667921536581,MATH 248,A00,098036,Bejenaru; Ioan,10,0,10,0
1667921537009,MATH 250B,A00,098037,Spolaor; Luca,14,0,15,1
1667921537442,MATH 258,A00,098038,Ni; Lei,10,0,10,0
1667921537875,MATH 264B,A00,098041,Rhoades; Brendon Patrick,13,0,15,2
1667921538304,MATH 268,A00,098042,Buss; Samuel R,10,0,10,0
1667921538738,MATH 269,A00,098043,Rhoades; Brendon Patrick,10,0,10,0
1667921539167,MATH 270B,A00,098044,Li; Bo,13,0,15,2
1667921539600,MATH 272B,A00,098045,Holst; Michael J,13,0,15,2
1667921540023,MATH 273A,A00,098046,Tian; Xiaochuan,12,0,15,3
1667921540471,MATH 275,A01,098048,Tian; Xiaochuan,7,0,10,3
1667921540909,MATH 278A,A00,098049,Holst; Michael J,8,0,10,2
1667921541345,MATH 278B,A00,098050,Cloninger; Alexander,10,0,10,0
1667921541769,MATH 278C,A00,098051,Nie; Jiawang,9,0,10,1
1667921542210,MATH 280B,A00,098052,Zheng; Tianyi,12,0,15,3
1667921542637,MATH 281B,A00,098053,Bradic; Jelena,6,0,15,9
1667921543075,MATH 282B,A00,098054,Arias-Castro; Ery,2,0,15,13
1667921543502,MATH 285,A00,098055,Fitzsimmons; Patrick J,3,0,15,12
1667921543928,MATH 287B,A00,098056,Arias-Castro; Ery,9,0,15,6
1667921544367,MATH 288,A00,098057,Agarwal; Pooja,9,0,10,1
1667921544367,MATH 288,B00,098058,Zhang; Danna,9,0,10,1
1667921544367,MATH 288,C00,098059,Williams; Ruth J,10,0,10,0
1667921544813,MATH 290B,A00,098060,Roberts; Justin Deritter,14,0,15,1
1667921545261,MATH 292,A00,098061,Belmont; Eva Kinoshita,10,0,10,0
1667921545703,MATH 295,A00,098062,Suk; Andrew Hoon,48,0,50,2
1667921546128,MATH 296,A00,098063,Novak; Jonathan I,20,0,20,0
1667921546561,MATH 297,001,098064,Gamst; Anthony Collins,9997,0,9999,2
1667922058006,COGS 205,A00,101395,Chiba; Andrea,19,0,20,1
1667922058436,COGS 210B,001,101404,Greene; Deanna Jacquelyn,9998,0,9999,1
1667922058436,COGS 210B,002,101417,Xia; Haijun,9999,0,9999,0
1667922058436,COGS 210B,003,101422,Nitz; Douglas A.,9999,0,9999,0
1667922058436,COGS 210B,004,101423,Hollan; James D.,9998,0,9999,1
1667922058436,COGS 210B,005,101424,Deak; Gedeon O.,9999,0,9999,0
1667922058436,COGS 210B,006,101425,Rossano; Federico,9999,0,9999,0
1667922058868,COGS 211B,A00,101427,Coulson; Seana M,9997,0,9999,2
1667922059309,COGS 220,A00,101428,Hollan; James D.,0,0,25,25
1667922059739,COGS 229,A00,101429,Dow; Steven P,19,0,25,6
1667922060175,COGS 230,A00,101430,Klemmer; Scott R,13,0,17,4
1667922060604,COGS 234,A00,101431,Xia; Haijun,11,0,25,14
1667922061044,COGS 260,A00,101432,Kiyonaga; Anastasia,19,0,25,6
1667922061044,COGS 260,B00,101433,Kirsh; David Joel,18,0,25,7
1667922061491,CSE 202,A00,102371,Impagliazzo; Russell,0,0,0,0
1667922061934,CSE 203B,A01,102373,Cheng; Chung Kuan,0,0,0,0
1667922062389,CSE 208,A00,102374,Micciancio; Daniele,0,0,0,0
1667922062828,CSE 209A,A00,112895,Impagliazzo; Russell,0,0,15,15
1667922063261,CSE 209B,A00,108005,Bellare; Mihir,0,0,0,0
1667922063701,CSE 210,A00,113163,Coblenz; Michael J,0,0,0,0
1667922064134,CSE 219,A00,106111,Dow; Steven P,0,0,20,20
1667922064561,CSE 221,A00,102376,Voelker; Geoffrey M.,0,0,0,0
1667922064986,CSE 224,A01,102378,Porter; George M,0,0,0,0
1667922065411,CSE 229A,A00,102379,Savage; Stefan,0,0,0,0
1667922065836,CSE 229C,A00,102380,Munyaka; Imani N. S.,0,0,0,0
1667922066274,CSE 232B,A00,102382,Deutsch; Alin Bernard,0,0,0,0
1667922066708,CSE 234,A01,112904,Kumar; Arun Kumar,0,0,0,0
1667922067143,CSE 237A,A00,102383,Rosing; Tajana Simunic,0,0,0,0
1667922067568,CSE 239A,A00,102384,Deutsch; Alin Bernard,0,0,0,0
1667922067996,CSE 239B,A00,102385,Polikarpova; Nadezhda,0,0,0,0
1667922068424,CSE 240A,A00,102386,Pannuto; Patrick William,0,0,0,0
1667922068866,CSE 240B,A00,102387,Zhao; Jishen,0,0,0,0
1667922069303,CSE 241A,A00,106406,Kang; Mingu,0,0,0,0
1667922069733,CSE 249B,A00,102388,Kahng; Andrew Byun,0,0,8,8
1667922070191,CSE 251B,A01,102392,Cottrell; Garrison W,0,0,0,0
1667922070191,CSE 251B,A02,102393,Cottrell; Garrison W,0,0,0,0
1667922070628,CSE 252B,A00,102394,Ochoa; Benjamin Lawrence,0,0,0,0
1667922071057,CSE 257,A01,102396,Gao; Sicun,0,0,0,0
1667922071484,CSE 272,A00,102397,Li; Tzumao,0,0,0,0
1667922071935,CSE 274,A00,111323,Chern; Albert Ren-Haur,0,0,0,0
1667922072372,CSE 282,A00,102398,Pevzner; Pavel Arkadjevich,0,0,0,0
1667922072803,CSE 284,A00,114175,Gymrek; Melissa Ann,0,0,0,0
1667922073232,CSE 290,A00,102399,Chandraker; Manmohan Krishna,0,0,0,0
1667922073232,CSE 290,B00,102400,Vaccaro; Kristen Marie,0,0,25,25
1667922073232,CSE 290,C00,102414,Pannuto; Patrick William,0,0,25,25
1667922073232,CSE 290,D00,102427,Pevzner; Pavel Arkadjevich,0,0,0,0
1667922073232,CSE 290,E00,102429,Zhao; Jishen,0,0,0,0
1667922073232,CSE 290,F00,102436,Tullsen; Dean Michael,0,0,0,0
1667922073232,CSE 290,G00,102440,Christensen; Henrik I,0,0,20,20
1667922073666,CSE 291,A00,102443,Su; Hao,0,0,0,0
1667922073666,CSE 291,B00,102448,Polikarpova; Nadezhda,0,0,0,0
1667922073666,CSE 291,C00,102453,Vaccaro; Kristen Marie,0,0,0,0
1667922073666,CSE 291,D00,111343,Savage; Stefan,0,0,0,0
1667922073666,CSE 291,E00,116474,Claffy; Kimberly Claire,0,0,0,0
1667922073666,CSE 291,F00,116479,Pasquale; Joseph,0,0,0,0
1667922074127,CSE 293,001,119111,Bafna; Vineet,9999,0,9999,0
1667922074127,CSE 293,002,119118,Bellare; Mihir,9999,0,9999,0
1667922074127,CSE 293,003,119122,Berg-Kirkpatrick; Taylor D,9999,0,9999,0
1667922074127,CSE 293,004,119135,Christensen; Henrik I,9999,0,9999,0
1667922074127,CSE 293,005,119142,Cottrell; Garrison W,9999,0,9999,0
1667922074127,CSE 293,006,119146,Deutsch; Alin Bernard,9999,0,9999,0
1667922074127,CSE 293,007,119159,Esmaeilzadeh; Hadi,9999,0,9999,0
1667922074127,CSE 293,008,119166,Freund; Yoav,9999,0,9999,0
1667922074127,CSE 293,009,119170,Griswold; William G.,9999,0,9999,0
1667922074127,CSE 293,010,119183,Gymrek; Melissa Ann,9999,0,9999,0
1667922074127,CSE 293,011,119190,Heninger; Nadia A,9999,0,9999,0
1667922074127,CSE 293,012,119230,Impagliazzo; Russell,9999,0,9999,0
1667922074127,CSE 293,013,119232,Jhala; Ranjit,9999,0,9999,0
1667922074127,CSE 293,014,119233,Kahng; Andrew Byun,9999,0,9999,0
1667922074127,CSE 293,015,119298,Kane; Daniel Mertz,9999,0,9999,0
1667922074127,CSE 293,016,119299,Kriegman; David J,9999,0,9999,0
1667922074127,CSE 293,017,119300,Kumar; Arun Kumar,9999,0,9999,0
1667922074127,CSE 293,018,119301,Lerner; Sorin,9999,0,9999,0
1667922074127,CSE 293,019,119302,Lovett; Shachar,9999,0,9999,0
1667922074127,CSE 293,020,119303,McAuley; Julian John,9999,0,9999,0
1667922074127,CSE 293,021,119304,Micciancio; Daniele,9999,0,9999,0
1667922074127,CSE 293,022,119367,Orailoglu; Alex,9999,0,9999,0
1667922074127,CSE 293,023,119382,Paturi; Ramamohan,9999,0,9999,0
1667922074127,CSE 293,024,119404,Polikarpova; Nadezhda,9999,0,9999,0
1667922074127,CSE 293,025,119406,Politz; Joseph Gibbs,9999,0,9999,0
1667922074127,CSE 293,026,119411,Porter; George M,9999,0,9999,0
1667922074127,CSE 293,027,119414,Porter; Leonard Emerson,9999,0,9999,0
1667922074127,CSE 293,028,119416,Ramamoorthi; Ravi,9999,0,9999,0
1667922074127,CSE 293,029,119417,Sahoo; Debashis,9999,0,9999,0
1667922074127,CSE 293,030,119420,Saul; Lawrence,9999,0,9999,0
1667922074127,CSE 293,031,119421,Savage; Stefan,9999,0,9999,0
1667922074127,CSE 293,032,119425,Schulze; Jurgen P.,9999,0,9999,0
1667922074127,CSE 293,033,119426,Snoeren; Alex C.,9999,0,9999,0
1667922074127,CSE 293,034,119428,Shang; Jingbo,9999,0,9999,0
1667922074127,CSE 293,035,119430,Stefan; Deian,9999,0,9999,0
1667922074127,CSE 293,036,119431,Su; Hao,9999,0,9999,0
1667922074127,CSE 293,037,119433,Swanson; Steven James,9999,0,9999,0
1667922074127,CSE 293,038,119435,Tullsen; Dean Michael,9999,0,9999,0
1667922074127,CSE 293,039,119483,Voelker; Geoffrey M.,9999,0,9999,0
1667922074127,CSE 293,040,119537,Zhao; Jishen,9999,0,9999,0
1667922074127,CSE 293,041,119538,Zhou; Yuan-Yuan,9999,0,9999,0
1667922074127,CSE 293,042,119539,Gao; Sicun,9999,0,9999,0
1667922074127,CSE 293,043,119540,Weibel; Nadir,9999,0,9999,0
1667922074127,CSE 293,044,119541,Gupta; Rajesh K.,9999,0,9999,0
1667922074553,CSE 294,A00,102459,Voelker; Geoffrey M.,0,0,0,0
1667922074553,CSE 294,B00,111322,Orailoglu; Alex,0,0,0,0
1667922074996,DSE 201,A00,096914,Deutsch; Alin Bernard,30,0,30,0
1667922075429,DSE 210,A00,096915,Dasgupta; Sanjoy,30,0,30,0
1667922075855,DSE 260A,A00,096916,Altintas De Callaf; Ilkay,30,0,30,0
1667922076295,ECE 200,001,103586,Antipa; Nicholas A,9999,0,9999,0
1667922076295,ECE 200,002,103587,Atanasov; Nikolay A.,9999,0,9999,0
1667922076295,ECE 200,003,103588,Bharadia; Dinesh,9999,0,9999,0
1667922076295,ECE 200,004,103589,Cheng; Chung Kuan,9999,0,9999,0
1667922076295,ECE 200,005,103590,Cosman; Pamela C.,9999,0,9999,0
1667922076295,ECE 200,006,103591,Dayeh; Shadi Ahmad,9999,0,9999,0
1667922076295,ECE 200,007,103592,Fainman; Yeshaiahu,9999,0,9999,0
1667922076295,ECE 200,008,103593,Ford; Joseph Earl,9999,0,9999,0
1667922076295,ECE 200,009,103594,Franceschetti; Massimo,9999,0,9999,0
1667922076295,ECE 200,010,103595,Fullerton; Eric E,9999,0,9999,0
1667922076295,ECE 200,011,103596,Galton; Ian A,9999,0,9999,0
1667922076295,ECE 200,012,103597,Gilja; Vikash,9999,0,9999,0
1667922076295,ECE 200,013,103598,Hall; Drew A.,9999,0,9999,0
1667922076295,ECE 200,014,103599,Hsueh; Tzu-Chien,9999,0,9999,0
1667922076295,ECE 200,015,103600,Javidi; Tara,9999,0,9999,0
1667922076295,ECE 200,016,103601,Kahng; Andrew Byun,9999,0,9999,0
1667922076295,ECE 200,017,103602,Kim; Young-Han,9999,0,9999,0
1667922076295,ECE 200,018,103603,Koushanfar; Farinaz,9999,0,9999,0
1667922076295,ECE 200,019,103604,Kuzum; Duygu,9999,0,9999,0
1667922076295,ECE 200,020,103605,Le; Hanh-Phuc,9999,0,9999,0
1667922076295,ECE 200,021,103606,Lin; Bill,9999,0,9999,0
1667922076295,ECE 200,022,103607,Liu; Zhaowei,9998,0,9999,1
1667922076295,ECE 200,023,103608,Lo; Yu-Hwa,9999,0,9999,0
1667922076295,ECE 200,024,103609,Lomakin; Vitaliy,9999,0,9999,0
1667922076295,ECE 200,025,103610,Mercier; Patrick Philip,9999,0,9999,0
1667922076295,ECE 200,026,103611,Meyer; Florian,9999,0,9999,0
1667922076295,ECE 200,027,103612,Milstein; Laurence B.,9999,0,9999,0
1667922076295,ECE 200,028,103613,Mir Arabbaygi; Siavash,9999,0,9999,0
1667922076295,ECE 200,029,103614,Mookherjea; Shayan,9999,0,9999,0
1667922076295,ECE 200,030,103615,Morris; Karcher William,9999,0,9999,0
1667922076295,ECE 200,031,103616,Ng; Tse Nga,9999,0,9999,0
1667922076295,ECE 200,032,103617,Nguyen; Truong Quang,9999,0,9999,0
1667922076295,ECE 200,033,103618,Nomura; Kenji,9999,0,9999,0
1667922076295,ECE 200,034,103619,Orlitsky; Alon,9999,0,9999,0
1667922076295,ECE 200,035,103620,Pal; Piya,9999,0,9999,0
1667922076295,ECE 200,036,103621,Papen; George C.,9999,0,9999,0
1667922076295,ECE 200,037,103622,Radic; Stojan,9999,0,9999,0
1667922076295,ECE 200,038,103623,Rao; Bhaskar D.,9999,0,9999,0
1667922076295,ECE 200,039,103624,Rao; Ramesh R,9999,0,9999,0
1667922076295,ECE 200,040,103625,Rebeiz; Gabriel,9999,0,9999,0
1667922076295,ECE 200,041,103626,Sanford; John R,9999,0,9999,0
1667922076295,ECE 200,042,103627,Siegel; Paul H.,9999,0,9999,0
1667922076295,ECE 200,043,103628,Sievenpiper; Daniel F.,9999,0,9999,0
1667922076295,ECE 200,044,103629,Sworder; David D.,9999,0,9999,0
1667922076295,ECE 200,045,103630,Taur; Yuan,9999,0,9999,0
1667922076295,ECE 200,046,103631,Touri; Behrouz,9999,0,9999,0
1667922076295,ECE 200,047,103632,Trivedi; Mohan M.,9999,0,9999,0
1667922076295,ECE 200,048,103633,Vasconcelos; Nuno,9999,0,9999,0
1667922076295,ECE 200,049,103634,Wang; Xiaolong,9999,0,9999,0
1667922076295,ECE 200,050,103635,Xie; Pengtao,9999,0,9999,0
1667922076295,ECE 200,051,103636,Yip; Michael,9999,0,9999,0
1667922076295,ECE 200,052,103637,Zeger; Kenneth A.,999,0,999,0
1667922076295,ECE 200,053,103638,Zhang; Xinyu,9999,0,9999,0
1667922076295,ECE 200,054,103639,Turakhia; Yatish Girish,9999,0,9999,0
1667922076295,ECE 200,055,103640,Kang; Mingu,9999,0,9999,0
1667922076295,ECE 200,056,103641,Shi; Yuanyuan,9999,0,9999,0
1667922076295,ECE 200,057,103642,Wang; Edward Jay,9999,0,9999,0
1667922076295,ECE 200,058,103643,Zheng; Yang,9999,0,9999,0
1667922076733,ECE 202,A00,103644,Kuzum; Duygu,0,0,0,0
1667922077198,ECE 212BN,A00,103646,Ng; Tse Nga,0,0,0,0
1667922077627,ECE 221,A00,111493,Staff,0,0,0,0
1667922078050,ECE 222B,A00,103647,Lomakin; Vitaliy,0,0,0,0
1667922078480,ECE 230B,A00,103648,Taur; Yuan,0,0,0,0
1667922078913,ECE 238B,A00,103649,Garay; Javier,0,0,0,0
1667922079373,ECE 240B,A00,112900,Fainman; Yeshaiahu,0,0,0,0
1667922079809,ECE 247A,A00,103650,Jokerst; Jesse Vincent,0,0,0,0
1667922080248,ECE 247B,A00,103651,Wang; Joseph,0,0,0,0
1667922080683,ECE 250,A00,103652,Siegel; Paul H.,0,0,0,0
1667922081124,ECE 251A,A00,103654,Rao; Bhaskar D.,0,0,0,0
1667922081554,ECE 257B,A00,103655,Bharadia; Dinesh,0,0,0,0
1667922081982,ECE 258A,A00,103656,Milstein; Laurence B.,0,0,0,0
1667922082523,ECE 260B,A00,103658,Kang; Mingu,0,0,0,0
1667922082950,ECE 264A,A00,103659,Galton; Ian A,0,0,0,0
1667922083383,ECE 265A,A00,103661,Gudem; Prasad S.S.,0,0,0,0
1667922083821,ECE 265D,A00,103662,Gudem; Prasad S.S.,0,0,0,0
1667922084253,ECE 268,A00,103663,Koushanfar; Farinaz,0,0,0,0
1667922084680,ECE 269,A01,103665,Pal; Piya,0,0,0,0
1667922085117,ECE 271B,A00,103666,Vasconcelos; Manuela,0,0,0,0
1667922085544,ECE 276A,A00,103667,Atanasov; Nikolay A.,0,0,0,0
1667922085980,ECE 277,A00,103668,An; Cheolhong,0,0,0,0
1667922086406,ECE 279,A00,117947,Hall; Drew A.,0,0,0,0
1667922087310,ECE 283,A00,103670,Hsueh; Tzu-Chien,0,0,0,0
1667922087744,ECE 284,A00,103671,Turakhia; Yatish Girish,0,0,0,0
1667922088173,ECE 285,A00,103672,Zheng; Yang,0,0,0,0
1667922088173,ECE 285,B00,103673,Sworder; David D.,0,0,0,0
1667922088605,ECE 287,A00,103676,Javidi; Tara,0,0,0,0
1667922089041,MATH 200B,A00,098023,Salehi Golsefidy; Alireza,15,0,15,0
1667922089481,MATH 202B,A00,098024,Rhoades; Brendon Patrick,14,0,15,1
1667922089922,MATH 203B,A00,098025,Oprea; Dragos N.,14,0,15,1
1667922090356,MATH 204B,A00,098026,Sorensen; Claus M,15,0,15,0
1667922090790,MATH 208,A00,098027,Izadi; Elham,7,0,10,3
1667922091228,MATH 209,A00,098028,Pollack; Aaron,10,0,10,0
1667922091653,MATH 211A,A00,112919,Rogalski; Daniel,10,0,10,0
1667922092086,MATH 211B,A00,112920,Seward; Brandon M.,10,0,10,0
1667922092520,MATH 218,A00,098029,Li; Bo,10,0,10,0
1667922092959,MATH 220B,A00,098030,Novak; Jonathan I,15,0,15,0
1667922093383,MATH 221A,A00,098031,Ebenfelt; Peter F,15,0,15,0
1667922093825,MATH 231B,A00,098032,Zlatos; Andrej,15,0,15,0
1667922094254,MATH 240B,A00,098033,Ni; Lei,13,0,15,2
1667922094694,MATH 243,A00,098034,Jekel; David Andrew,10,0,10,0
1667922095135,MATH 245A,A00,098035,Nie; Jiawang,6,0,15,9
1667922095561,MATH 248,A00,098036,Bejenaru; Ioan,10,0,10,0
1667922095987,MATH 250B,A00,098037,Spolaor; Luca,14,0,15,1
1667922096423,MATH 258,A00,098038,Ni; Lei,10,0,10,0
1667922096858,MATH 264B,A00,098041,Rhoades; Brendon Patrick,13,0,15,2
1667922097293,MATH 268,A00,098042,Buss; Samuel R,10,0,10,0
1667922097730,MATH 269,A00,098043,Rhoades; Brendon Patrick,10,0,10,0
1667922098166,MATH 270B,A00,098044,Li; Bo,13,0,15,2
1667922098598,MATH 272B,A00,098045,Holst; Michael J,13,0,15,2
1667922099036,MATH 273A,A00,098046,Tian; Xiaochuan,12,0,15,3
1667922099460,MATH 275,A01,098048,Tian; Xiaochuan,7,0,10,3
1667922099890,MATH 278A,A00,098049,Holst; Michael J,8,0,10,2
1667922100314,MATH 278B,A00,098050,Cloninger; Alexander,10,0,10,0
1667922100745,MATH 278C,A00,098051,Nie; Jiawang,9,0,10,1
1667922101178,MATH 280B,A00,098052,Zheng; Tianyi,12,0,15,3
1667922101607,MATH 281B,A00,098053,Bradic; Jelena,6,0,15,9
1667922102050,MATH 282B,A00,098054,Arias-Castro; Ery,2,0,15,13
1667922102493,MATH 285,A00,098055,Fitzsimmons; Patrick J,3,0,15,12
1667922102939,MATH 287B,A00,098056,Arias-Castro; Ery,9,0,15,6
1667922103386,MATH 288,A00,098057,Agarwal; Pooja,9,0,10,1
1667922103386,MATH 288,B00,098058,Zhang; Danna,9,0,10,1
1667922103386,MATH 288,C00,098059,Williams; Ruth J,10,0,10,0
1667922103826,MATH 290B,A00,098060,Roberts; Justin Deritter,14,0,15,1
1667922104267,MATH 292,A00,098061,Belmont; Eva Kinoshita,10,0,10,0
1667922104697,MATH 295,A00,098062,Suk; Andrew Hoon,48,0,50,2
1667922105121,MATH 296,A00,098063,Novak; Jonathan I,20,0,20,0
1667922105553,MATH 297,001,098064,Gamst; Anthony Collins,9997,0,9999,2
1667922616853,COGS 205,A00,101395,Chiba; Andrea,19,0,20,1
1667922617280,COGS 210B,001,101404,Greene; Deanna Jacquelyn,9998,0,9999,1
1667922617280,COGS 210B,002,101417,Xia; Haijun,9999,0,9999,0
1667922617280,COGS 210B,003,101422,Nitz; Douglas A.,9999,0,9999,0
1667922617280,COGS 210B,004,101423,Hollan; James D.,9998,0,9999,1
1667922617280,COGS 210B,005,101424,Deak; Gedeon O.,9999,0,9999,0
1667922617280,COGS 210B,006,101425,Rossano; Federico,9999,0,9999,0
1667922617706,COGS 211B,A00,101427,Coulson; Seana M,9997,0,9999,2
1667922618129,COGS 220,A00,101428,Hollan; James D.,0,0,25,25
1667922618561,COGS 229,A00,101429,Dow; Steven P,19,0,25,6
1667922618993,COGS 230,A00,101430,Klemmer; Scott R,13,0,17,4
1667922619434,COGS 234,A00,101431,Xia; Haijun,11,0,25,14
1667922619883,COGS 260,A00,101432,Kiyonaga; Anastasia,19,0,25,6
1667922619883,COGS 260,B00,101433,Kirsh; David Joel,18,0,25,7
1667922620313,CSE 202,A00,102371,Impagliazzo; Russell,0,0,0,0
1667922620746,CSE 203B,A01,102373,Cheng; Chung Kuan,0,0,0,0
1667922621185,CSE 208,A00,102374,Micciancio; Daniele,0,0,0,0
1667922621616,CSE 209A,A00,112895,Impagliazzo; Russell,0,0,15,15
1667922622060,CSE 209B,A00,108005,Bellare; Mihir,0,0,0,0
1667922622499,CSE 210,A00,113163,Coblenz; Michael J,0,0,0,0
1667922622926,CSE 219,A00,106111,Dow; Steven P,0,0,20,20
1667922623366,CSE 221,A00,102376,Voelker; Geoffrey M.,0,0,0,0
1667922623798,CSE 224,A01,102378,Porter; George M,0,0,0,0
1667922624235,CSE 229A,A00,102379,Savage; Stefan,0,0,0,0
1667922624666,CSE 229C,A00,102380,Munyaka; Imani N. S.,0,0,0,0
1667922625091,CSE 232B,A00,102382,Deutsch; Alin Bernard,0,0,0,0
1667922625515,CSE 234,A01,112904,Kumar; Arun Kumar,0,0,0,0
1667922625954,CSE 237A,A00,102383,Rosing; Tajana Simunic,0,0,0,0
1667922626397,CSE 239A,A00,102384,Deutsch; Alin Bernard,0,0,0,0
1667922626829,CSE 239B,A00,102385,Polikarpova; Nadezhda,0,0,0,0
1667922627276,CSE 240A,A00,102386,Pannuto; Patrick William,0,0,0,0
1667922627703,CSE 240B,A00,102387,Zhao; Jishen,0,0,0,0
1667922628136,CSE 241A,A00,106406,Kang; Mingu,0,0,0,0
1667922628571,CSE 249B,A00,102388,Kahng; Andrew Byun,0,0,8,8
1667922629005,CSE 251B,A01,102392,Cottrell; Garrison W,0,0,0,0
1667922629005,CSE 251B,A02,102393,Cottrell; Garrison W,0,0,0,0
1667922629432,CSE 252B,A00,102394,Ochoa; Benjamin Lawrence,0,0,0,0
1667922629877,CSE 257,A01,102396,Gao; Sicun,0,0,0,0
1667922630306,CSE 272,A00,102397,Li; Tzumao,0,0,0,0
1667922630741,CSE 274,A00,111323,Chern; Albert Ren-Haur,0,0,0,0
1667922631169,CSE 282,A00,102398,Pevzner; Pavel Arkadjevich,0,0,0,0
1667922631596,CSE 284,A00,114175,Gymrek; Melissa Ann,0,0,0,0
1667922632020,CSE 290,A00,102399,Chandraker; Manmohan Krishna,0,0,0,0
1667922632020,CSE 290,B00,102400,Vaccaro; Kristen Marie,0,0,25,25
1667922632020,CSE 290,C00,102414,Pannuto; Patrick William,0,0,25,25
1667922632020,CSE 290,D00,102427,Pevzner; Pavel Arkadjevich,0,0,0,0
1667922632020,CSE 290,E00,102429,Zhao; Jishen,0,0,0,0
1667922632020,CSE 290,F00,102436,Tullsen; Dean Michael,0,0,0,0
1667922632020,CSE 290,G00,102440,Christensen; Henrik I,0,0,20,20
1667922632463,CSE 291,A00,102443,Su; Hao,0,0,0,0
1667922632463,CSE 291,B00,102448,Polikarpova; Nadezhda,0,0,0,0
1667922632463,CSE 291,C00,102453,Vaccaro; Kristen Marie,0,0,0,0
1667922632463,CSE 291,D00,111343,Savage; Stefan,0,0,0,0
1667922632463,CSE 291,E00,116474,Claffy; Kimberly Claire,0,0,0,0
1667922632463,CSE 291,F00,116479,Pasquale; Joseph,0,0,0,0
1667922632921,CSE 293,001,119111,Bafna; Vineet,9999,0,9999,0
1667922632921,CSE 293,002,119118,Bellare; Mihir,9999,0,9999,0
1667922632921,CSE 293,003,119122,Berg-Kirkpatrick; Taylor D,9999,0,9999,0
1667922632921,CSE 293,004,119135,Christensen; Henrik I,9999,0,9999,0
1667922632921,CSE 293,005,119142,Cottrell; Garrison W,9999,0,9999,0
1667922632921,CSE 293,006,119146,Deutsch; Alin Bernard,9999,0,9999,0
1667922632921,CSE 293,007,119159,Esmaeilzadeh; Hadi,9999,0,9999,0
1667922632921,CSE 293,008,119166,Freund; Yoav,9999,0,9999,0
1667922632921,CSE 293,009,119170,Griswold; William G.,9999,0,9999,0
1667922632921,CSE 293,010,119183,Gymrek; Melissa Ann,9999,0,9999,0
1667922632921,CSE 293,011,119190,Heninger; Nadia A,9999,0,9999,0
1667922632921,CSE 293,012,119230,Impagliazzo; Russell,9999,0,9999,0
1667922632921,CSE 293,013,119232,Jhala; Ranjit,9999,0,9999,0
1667922632921,CSE 293,014,119233,Kahng; Andrew Byun,9999,0,9999,0
1667922632921,CSE 293,015,119298,Kane; Daniel Mertz,9999,0,9999,0
1667922632921,CSE 293,016,119299,Kriegman; David J,9999,0,9999,0
1667922632921,CSE 293,017,119300,Kumar; Arun Kumar,9999,0,9999,0
1667922632921,CSE 293,018,119301,Lerner; Sorin,9999,0,9999,0
1667922632921,CSE 293,019,119302,Lovett; Shachar,9999,0,9999,0
1667922632921,CSE 293,020,119303,McAuley; Julian John,9999,0,9999,0
1667922632921,CSE 293,021,119304,Micciancio; Daniele,9999,0,9999,0
1667922632921,CSE 293,022,119367,Orailoglu; Alex,9999,0,9999,0
1667922632921,CSE 293,023,119382,Paturi; Ramamohan,9999,0,9999,0
1667922632921,CSE 293,024,119404,Polikarpova; Nadezhda,9999,0,9999,0
1667922632921,CSE 293,025,119406,Politz; Joseph Gibbs,9999,0,9999,0
1667922632921,CSE 293,026,119411,Porter; George M,9999,0,9999,0
1667922632921,CSE 293,027,119414,Porter; Leonard Emerson,9999,0,9999,0
1667922632921,CSE 293,028,119416,Ramamoorthi; Ravi,9999,0,9999,0
1667922632921,CSE 293,029,119417,Sahoo; Debashis,9999,0,9999,0
1667922632921,CSE 293,030,119420,Saul; Lawrence,9999,0,9999,0
1667922632921,CSE 293,031,119421,Savage; Stefan,9999,0,9999,0
1667922632921,CSE 293,032,119425,Schulze; Jurgen P.,9999,0,9999,0
1667922632921,CSE 293,033,119426,Snoeren; Alex C.,9999,0,9999,0
1667922632921,CSE 293,034,119428,Shang; Jingbo,9999,0,9999,0
1667922632921,CSE 293,035,119430,Stefan; Deian,9999,0,9999,0
1667922632921,CSE 293,036,119431,Su; Hao,9999,0,9999,0
1667922632921,CSE 293,037,119433,Swanson; Steven James,9999,0,9999,0
1667922632921,CSE 293,038,119435,Tullsen; Dean Michael,9999,0,9999,0
1667922632921,CSE 293,039,119483,Voelker; Geoffrey M.,9999,0,9999,0
1667922632921,CSE 293,040,119537,Zhao; Jishen,9999,0,9999,0
1667922632921,CSE 293,041,119538,Zhou; Yuan-Yuan,9999,0,9999,0
1667922632921,CSE 293,042,119539,Gao; Sicun,9999,0,9999,0
1667922632921,CSE 293,043,119540,Weibel; Nadir,9999,0,9999,0
1667922632921,CSE 293,044,119541,Gupta; Rajesh K.,9999,0,9999,0
1667922633359,CSE 294,A00,102459,Voelker; Geoffrey M.,0,0,0,0
1667922633359,CSE 294,B00,111322,Orailoglu; Alex,0,0,0,0
1667922633788,DSE 201,A00,096914,Deutsch; Alin Bernard,30,0,30,0
1667922634240,DSE 210,A00,096915,Dasgupta; Sanjoy,30,0,30,0
1667922634663,DSE 260A,A00,096916,Altintas De Callaf; Ilkay,30,0,30,0
1667922635100,ECE 200,001,103586,Antipa; Nicholas A,9999,0,9999,0
1667922635100,ECE 200,002,103587,Atanasov; Nikolay A.,9999,0,9999,0
1667922635100,ECE 200,003,103588,Bharadia; Dinesh,9999,0,9999,0
1667922635100,ECE 200,004,103589,Cheng; Chung Kuan,9999,0,9999,0
1667922635100,ECE 200,005,103590,Cosman; Pamela C.,9999,0,9999,0
1667922635100,ECE 200,006,103591,Dayeh; Shadi Ahmad,9999,0,9999,0
1667922635100,ECE 200,007,103592,Fainman; Yeshaiahu,9999,0,9999,0
1667922635100,ECE 200,008,103593,Ford; Joseph Earl,9999,0,9999,0
1667922635100,ECE 200,009,103594,Franceschetti; Massimo,9999,0,9999,0
1667922635100,ECE 200,010,103595,Fullerton; Eric E,9999,0,9999,0
1667922635100,ECE 200,011,103596,Galton; Ian A,9999,0,9999,0
1667922635100,ECE 200,012,103597,Gilja; Vikash,9999,0,9999,0
1667922635100,ECE 200,013,103598,Hall; Drew A.,9999,0,9999,0
1667922635100,ECE 200,014,103599,Hsueh; Tzu-Chien,9999,0,9999,0
1667922635100,ECE 200,015,103600,Javidi; Tara,9999,0,9999,0
1667922635100,ECE 200,016,103601,Kahng; Andrew Byun,9999,0,9999,0
1667922635100,ECE 200,017,103602,Kim; Young-Han,9999,0,9999,0
1667922635100,ECE 200,018,103603,Koushanfar; Farinaz,9999,0,9999,0
1667922635100,ECE 200,019,103604,Kuzum; Duygu,9999,0,9999,0
1667922635100,ECE 200,020,103605,Le; Hanh-Phuc,9999,0,9999,0
1667922635100,ECE 200,021,103606,Lin; Bill,9999,0,9999,0
1667922635100,ECE 200,022,103607,Liu; Zhaowei,9998,0,9999,1
1667922635100,ECE 200,023,103608,Lo; Yu-Hwa,9999,0,9999,0
1667922635100,ECE 200,024,103609,Lomakin; Vitaliy,9999,0,9999,0
1667922635100,ECE 200,025,103610,Mercier; Patrick Philip,9999,0,9999,0
1667922635100,ECE 200,026,103611,Meyer; Florian,9999,0,9999,0
1667922635100,ECE 200,027,103612,Milstein; Laurence B.,9999,0,9999,0
1667922635100,ECE 200,028,103613,Mir Arabbaygi; Siavash,9999,0,9999,0
1667922635100,ECE 200,029,103614,Mookherjea; Shayan,9999,0,9999,0
1667922635100,ECE 200,030,103615,Morris; Karcher William,9999,0,9999,0
1667922635100,ECE 200,031,103616,Ng; Tse Nga,9999,0,9999,0
1667922635100,ECE 200,032,103617,Nguyen; Truong Quang,9999,0,9999,0
1667922635100,ECE 200,033,103618,Nomura; Kenji,9999,0,9999,0
1667922635100,ECE 200,034,103619,Orlitsky; Alon,9999,0,9999,0
1667922635100,ECE 200,035,103620,Pal; Piya,9999,0,9999,0
1667922635100,ECE 200,036,103621,Papen; George C.,9999,0,9999,0
1667922635100,ECE 200,037,103622,Radic; Stojan,9999,0,9999,0
1667922635100,ECE 200,038,103623,Rao; Bhaskar D.,9999,0,9999,0
1667922635100,ECE 200,039,103624,Rao; Ramesh R,9999,0,9999,0
1667922635100,ECE 200,040,103625,Rebeiz; Gabriel,9999,0,9999,0
1667922635100,ECE 200,041,103626,Sanford; John R,9999,0,9999,0
1667922635100,ECE 200,042,103627,Siegel; Paul H.,9999,0,9999,0
1667922635100,ECE 200,043,103628,Sievenpiper; Daniel F.,9999,0,9999,0
1667922635100,ECE 200,044,103629,Sworder; David D.,9999,0,9999,0
1667922635100,ECE 200,045,103630,Taur; Yuan,9999,0,9999,0
1667922635100,ECE 200,046,103631,Touri; Behrouz,9999,0,9999,0
1667922635100,ECE 200,047,103632,Trivedi; Mohan M.,9999,0,9999,0
1667922635100,ECE 200,048,103633,Vasconcelos; Nuno,9999,0,9999,0
1667922635100,ECE 200,049,103634,Wang; Xiaolong,9999,0,9999,0
1667922635100,ECE 200,050,103635,Xie; Pengtao,9999,0,9999,0
1667922635100,ECE 200,051,103636,Yip; Michael,9999,0,9999,0
1667922635100,ECE 200,052,103637,Zeger; Kenneth A.,999,0,999,0
1667922635100,ECE 200,053,103638,Zhang; Xinyu,9999,0,9999,0
1667922635100,ECE 200,054,103639,Turakhia; Yatish Girish,9999,0,9999,0
1667922635100,ECE 200,055,103640,Kang; Mingu,9999,0,9999,0
1667922635100,ECE 200,056,103641,Shi; Yuanyuan,9999,0,9999,0
1667922635100,ECE 200,057,103642,Wang; Edward Jay,9999,0,9999,0
1667922635100,ECE 200,058,103643,Zheng; Yang,9999,0,9999,0
1667922635531,ECE 202,A00,103644,Kuzum; Duygu,0,0,0,0
1667922635954,ECE 212BN,A00,103646,Ng; Tse Nga,0,0,0,0
1667922636380,ECE 221,A00,111493,Staff,0,0,0,0
1667922636820,ECE 222B,A00,103647,Lomakin; Vitaliy,0,0,0,0
1667922637247,ECE 230B,A00,103648,Taur; Yuan,0,0,0,0
1667922637671,ECE 238B,A00,103649,Garay; Javier,0,0,0,0
1667922638107,ECE 240B,A00,112900,Fainman; Yeshaiahu,0,0,0,0
1667922638549,ECE 247A,A00,103650,Jokerst; Jesse Vincent,0,0,0,0
1667922638983,ECE 247B,A00,103651,Wang; Joseph,0,0,0,0
1667922639432,ECE 250,A00,103652,Siegel; Paul H.,0,0,0,0
1667922639862,ECE 251A,A00,103654,Rao; Bhaskar D.,0,0,0,0
1667922640302,ECE 257B,A00,103655,Bharadia; Dinesh,0,0,0,0
1667922640729,ECE 258A,A00,103656,Milstein; Laurence B.,0,0,0,0
1667922641165,ECE 260B,A00,103658,Kang; Mingu,0,0,0,0
1667922641609,ECE 264A,A00,103659,Galton; Ian A,0,0,0,0
1667922642038,ECE 265A,A00,103661,Gudem; Prasad S.S.,0,0,0,0
1667922642482,ECE 265D,A00,103662,Gudem; Prasad S.S.,0,0,0,0
1667922642910,ECE 268,A00,103663,Koushanfar; Farinaz,0,0,0,0
1667922643357,ECE 269,A01,103665,Pal; Piya,0,0,0,0
1667922643786,ECE 271B,A00,103666,Vasconcelos; Manuela,0,0,0,0
1667922644215,ECE 276A,A00,103667,Atanasov; Nikolay A.,0,0,0,0
1667922644651,ECE 277,A00,103668,An; Cheolhong,0,0,0,0
1667922645078,ECE 279,A00,117947,Hall; Drew A.,0,0,0,0
1667922645959,ECE 283,A00,103670,Hsueh; Tzu-Chien,0,0,0,0
1667922646425,ECE 284,A00,103671,Turakhia; Yatish Girish,0,0,0,0
1667922646849,ECE 285,A00,103672,Zheng; Yang,0,0,0,0
1667922646849,ECE 285,B00,103673,Sworder; David D.,0,0,0,0
1667922647277,ECE 287,A00,103676,Javidi; Tara,0,0,0,0
1667922647723,MATH 200B,A00,098023,Salehi Golsefidy; Alireza,15,0,15,0
1667922648158,MATH 202B,A00,098024,Rhoades; Brendon Patrick,14,0,15,1
1667922648587,MATH 203B,A00,098025,Oprea; Dragos N.,14,0,15,1
1667922649024,MATH 204B,A00,098026,Sorensen; Claus M,15,0,15,0
1667922649468,MATH 208,A00,098027,Izadi; Elham,7,0,10,3
1667922649896,MATH 209,A00,098028,Pollack; Aaron,10,0,10,0
1667922650332,MATH 211A,A00,112919,Rogalski; Daniel,10,0,10,0
1667922650769,MATH 211B,A00,112920,Seward; Brandon M.,10,0,10,0
1667922651203,MATH 218,A00,098029,Li; Bo,10,0,10,0
1667922651642,MATH 220B,A00,098030,Novak; Jonathan I,15,0,15,0
1667922652068,MATH 221A,A00,098031,Ebenfelt; Peter F,15,0,15,0
1667922652501,MATH 231B,A00,098032,Zlatos; Andrej,15,0,15,0
1667922652932,MATH 240B,A00,098033,Ni; Lei,13,0,15,2
1667922653373,MATH 243,A00,098034,Jekel; David Andrew,10,0,10,0
1667922653818,MATH 245A,A00,098035,Nie; Jiawang,6,0,15,9
1667922654247,MATH 248,A00,098036,Bejenaru; Ioan,10,0,10,0
1667922654693,MATH 250B,A00,098037,Spolaor; Luca,14,0,15,1
1667922655120,MATH 258,A00,098038,Ni; Lei,10,0,10,0
1667922655556,MATH 264B,A00,098041,Rhoades; Brendon Patrick,13,0,15,2
1667922655995,MATH 268,A00,098042,Buss; Samuel R,10,0,10,0
1667922656420,MATH 269,A00,098043,Rhoades; Brendon Patrick,10,0,10,0
1667922656855,MATH 270B,A00,098044,Li; Bo,13,0,15,2
1667922657292,MATH 272B,A00,098045,Holst; Michael J,13,0,15,2
1667922658333,MATH 273A,A00,098046,Tian; Xiaochuan,12,0,15,3
1667922658872,MATH 275,A01,098048,Tian; Xiaochuan,7,0,10,3
1667922659308,MATH 278A,A00,098049,Holst; Michael J,8,0,10,2
1667922659764,MATH 278B,A00,098050,Cloninger; Alexander,10,0,10,0
1667922660209,MATH 278C,A00,098051,Nie; Jiawang,9,0,10,1
1667922660643,MATH 280B,A00,098052,Zheng; Tianyi,12,0,15,3
1667922661079,MATH 281B,A00,098053,Bradic; Jelena,6,0,15,9
1667922661510,MATH 282B,A00,098054,Arias-Castro; Ery,2,0,15,13
1667922661934,MATH 285,A00,098055,Fitzsimmons; Patrick J,3,0,15,12
1667922662375,MATH 287B,A00,098056,Arias-Castro; Ery,9,0,15,6
1667922662809,MATH 288,A00,098057,Agarwal; Pooja,9,0,10,1
1667922662809,MATH 288,B00,098058,Zhang; Danna,9,0,10,1
1667922662809,MATH 288,C00,098059,Williams; Ruth J,10,0,10,0
1667922663241,MATH 290B,A00,098060,Roberts; Justin Deritter,14,0,15,1
1667922663679,MATH 292,A00,098061,Belmont; Eva Kinoshita,10,0,10,0
1667922664108,MATH 295,A00,098062,Suk; Andrew Hoon,48,0,50,2
1667922664542,MATH 296,A00,098063,Novak; Jonathan I,20,0,20,0
1667922664977,MATH 297,001,098064,Gamst; Anthony Collins,9997,0,9999,2
1667923175933,COGS 205,A00,101395,Chiba; Andrea,19,0,20,1
1667923176378,COGS 210B,001,101404,Greene; Deanna Jacquelyn,9998,0,9999,1
1667923176378,COGS 210B,002,101417,Xia; Haijun,9999,0,9999,0
1667923176378,COGS 210B,003,101422,Nitz; Douglas A.,9999,0,9999,0
1667923176378,COGS 210B,004,101423,Hollan; James D.,9998,0,9999,1
1667923176378,COGS 210B,005,101424,Deak; Gedeon O.,9999,0,9999,0
1667923176378,COGS 210B,006,101425,Rossano; Federico,9999,0,9999,0
1667923176814,COGS 211B,A00,101427,Coulson; Seana M,9997,0,9999,2
1667923177251,COGS 220,A00,101428,Hollan; James D.,0,0,25,25
1667923177680,COGS 229,A00,101429,Dow; Steven P,19,0,25,6
1667923178119,COGS 230,A00,101430,Klemmer; Scott R,13,0,17,4
1667923178562,COGS 234,A00,101431,Xia; Haijun,11,0,25,14
1667923179032,COGS 260,A00,101432,Kiyonaga; Anastasia,19,0,25,6
1667923179032,COGS 260,B00,101433,Kirsh; David Joel,18,0,25,7
1667923179477,CSE 202,A00,102371,Impagliazzo; Russell,0,0,0,0
1667923179905,CSE 203B,A01,102373,Cheng; Chung Kuan,0,0,0,0
1667923180337,CSE 208,A00,102374,Micciancio; Daniele,0,0,0,0
1667923180765,CSE 209A,A00,112895,Impagliazzo; Russell,0,0,15,15
1667923181191,CSE 209B,A00,108005,Bellare; Mihir,0,0,0,0
1667923181619,CSE 210,A00,113163,Coblenz; Michael J,0,0,0,0
1667923182045,CSE 219,A00,106111,Dow; Steven P,0,0,20,20
1667923182479,CSE 221,A00,102376,Voelker; Geoffrey M.,0,0,0,0
1667923182911,CSE 224,A01,102378,Porter; George M,0,0,0,0
1667923183341,CSE 229A,A00,102379,Savage; Stefan,0,0,0,0
1667923183771,CSE 229C,A00,102380,Munyaka; Imani N. S.,0,0,0,0
1667923184216,CSE 232B,A00,102382,Deutsch; Alin Bernard,0,0,0,0
1667923184651,CSE 234,A01,112904,Kumar; Arun Kumar,0,0,0,0
1667923185076,CSE 237A,A00,102383,Rosing; Tajana Simunic,0,0,0,0
1667923185517,CSE 239A,A00,102384,Deutsch; Alin Bernard,0,0,0,0
1667923185953,CSE 239B,A00,102385,Polikarpova; Nadezhda,0,0,0,0
1667923186394,CSE 240A,A00,102386,Pannuto; Patrick William,0,0,0,0
1667923186834,CSE 240B,A00,102387,Zhao; Jishen,0,0,0,0
1667923187266,CSE 241A,A00,106406,Kang; Mingu,0,0,0,0
1667923187704,CSE 249B,A00,102388,Kahng; Andrew Byun,0,0,8,8
1667923188140,CSE 251B,A01,102392,Cottrell; Garrison W,0,0,0,0
1667923188140,CSE 251B,A02,102393,Cottrell; Garrison W,0,0,0,0
1667923188588,CSE 252B,A00,102394,Ochoa; Benjamin Lawrence,0,0,0,0
1667923189023,CSE 257,A01,102396,Gao; Sicun,0,0,0,0
1667923189467,CSE 272,A00,102397,Li; Tzumao,0,0,0,0
1667923189905,CSE 274,A00,111323,Chern; Albert Ren-Haur,0,0,0,0
1667923190466,CSE 282,A00,102398,Pevzner; Pavel Arkadjevich,0,0,0,0
1667923190897,CSE 284,A00,114175,Gymrek; Melissa Ann,0,0,0,0
1667923191341,CSE 290,A00,102399,Chandraker; Manmohan Krishna,0,0,0,0
1667923191341,CSE 290,B00,102400,Vaccaro; Kristen Marie,0,0,25,25
1667923191341,CSE 290,C00,102414,Pannuto; Patrick William,0,0,25,25
1667923191341,CSE 290,D00,102427,Pevzner; Pavel Arkadjevich,0,0,0,0
1667923191341,CSE 290,E00,102429,Zhao; Jishen,0,0,0,0
1667923191341,CSE 290,F00,102436,Tullsen; Dean Michael,0,0,0,0
1667923191341,CSE 290,G00,102440,Christensen; Henrik I,0,0,20,20
1667923191767,CSE 291,A00,102443,Su; Hao,0,0,0,0
1667923191767,CSE 291,B00,102448,Polikarpova; Nadezhda,0,0,0,0
1667923191767,CSE 291,C00,102453,Vaccaro; Kristen Marie,0,0,0,0
1667923191767,CSE 291,D00,111343,Savage; Stefan,0,0,0,0
1667923191767,CSE 291,E00,116474,Claffy; Kimberly Claire,0,0,0,0
1667923191767,CSE 291,F00,116479,Pasquale; Joseph,0,0,0,0
1667923192229,CSE 293,001,119111,Bafna; Vineet,9999,0,9999,0
1667923192229,CSE 293,002,119118,Bellare; Mihir,9999,0,9999,0
1667923192229,CSE 293,003,119122,Berg-Kirkpatrick; Taylor D,9999,0,9999,0
1667923192229,CSE 293,004,119135,Christensen; Henrik I,9999,0,9999,0
1667923192229,CSE 293,005,119142,Cottrell; Garrison W,9999,0,9999,0
1667923192229,CSE 293,006,119146,Deutsch; Alin Bernard,9999,0,9999,0
1667923192229,CSE 293,007,119159,Esmaeilzadeh; Hadi,9999,0,9999,0
1667923192229,CSE 293,008,119166,Freund; Yoav,9999,0,9999,0
1667923192229,CSE 293,009,119170,Griswold; William G.,9999,0,9999,0
1667923192229,CSE 293,010,119183,Gymrek; Melissa Ann,9999,0,9999,0
1667923192229,CSE 293,011,119190,Heninger; Nadia A,9999,0,9999,0
1667923192229,CSE 293,012,119230,Impagliazzo; Russell,9999,0,9999,0
1667923192229,CSE 293,013,119232,Jhala; Ranjit,9999,0,9999,0
1667923192229,CSE 293,014,119233,Kahng; Andrew Byun,9999,0,9999,0
1667923192229,CSE 293,015,119298,Kane; Daniel Mertz,9999,0,9999,0
1667923192229,CSE 293,016,119299,Kriegman; David J,9999,0,9999,0
1667923192229,CSE 293,017,119300,Kumar; Arun Kumar,9999,0,9999,0
1667923192229,CSE 293,018,119301,Lerner; Sorin,9999,0,9999,0
1667923192229,CSE 293,019,119302,Lovett; Shachar,9999,0,9999,0
1667923192229,CSE 293,020,119303,McAuley; Julian John,9999,0,9999,0
1667923192229,CSE 293,021,119304,Micciancio; Daniele,9999,0,9999,0
1667923192229,CSE 293,022,119367,Orailoglu; Alex,9999,0,9999,0
1667923192229,CSE 293,023,119382,Paturi; Ramamohan,9999,0,9999,0
1667923192229,CSE 293,024,119404,Polikarpova; Nadezhda,9999,0,9999,0
1667923192229,CSE 293,025,119406,Politz; Joseph Gibbs,9999,0,9999,0
1667923192229,CSE 293,026,119411,Porter; George M,9999,0,9999,0
1667923192229,CSE 293,027,119414,Porter; Leonard Emerson,9999,0,9999,0
1667923192229,CSE 293,028,119416,Ramamoorthi; Ravi,9999,0,9999,0
1667923192229,CSE 293,029,119417,Sahoo; Debashis,9999,0,9999,0
1667923192229,CSE 293,030,119420,Saul; Lawrence,9999,0,9999,0
1667923192229,CSE 293,031,119421,Savage; Stefan,9999,0,9999,0
1667923192229,CSE 293,032,119425,Schulze; Jurgen P.,9999,0,9999,0
1667923192229,CSE 293,033,119426,Snoeren; Alex C.,9999,0,9999,0
1667923192229,CSE 293,034,119428,Shang; Jingbo,9999,0,9999,0
1667923192229,CSE 293,035,119430,Stefan; Deian,9999,0,9999,0
1667923192229,CSE 293,036,119431,Su; Hao,9999,0,9999,0
1667923192229,CSE 293,037,119433,Swanson; Steven James,9999,0,9999,0
1667923192229,CSE 293,038,119435,Tullsen; Dean Michael,9999,0,9999,0
1667923192229,CSE 293,039,119483,Voelker; Geoffrey M.,9999,0,9999,0
1667923192229,CSE 293,040,119537,Zhao; Jishen,9999,0,9999,0
1667923192229,CSE 293,041,119538,Zhou; Yuan-Yuan,9999,0,9999,0
1667923192229,CSE 293,042,119539,Gao; Sicun,9999,0,9999,0
1667923192229,CSE 293,043,119540,Weibel; Nadir,9999,0,9999,0
1667923192229,CSE 293,044,119541,Gupta; Rajesh K.,9999,0,9999,0
1667923192654,CSE 294,A00,102459,Voelker; Geoffrey M.,0,0,0,0
1667923192654,CSE 294,B00,111322,Orailoglu; Alex,0,0,0,0
1667923193121,DSE 201,A00,096914,Deutsch; Alin Bernard,30,0,30,0
1667923193562,DSE 210,A00,096915,Dasgupta; Sanjoy,30,0,30,0
1667923194009,DSE 260A,A00,096916,Altintas De Callaf; Ilkay,30,0,30,0
1667923194461,ECE 200,001,103586,Antipa; Nicholas A,9999,0,9999,0
1667923194461,ECE 200,002,103587,Atanasov; Nikolay A.,9999,0,9999,0
1667923194461,ECE 200,003,103588,Bharadia; Dinesh,9999,0,9999,0
1667923194461,ECE 200,004,103589,Cheng; Chung Kuan,9999,0,9999,0
1667923194461,ECE 200,005,103590,Cosman; Pamela C.,9999,0,9999,0
1667923194461,ECE 200,006,103591,Dayeh; Shadi Ahmad,9999,0,9999,0
1667923194461,ECE 200,007,103592,Fainman; Yeshaiahu,9999,0,9999,0
1667923194461,ECE 200,008,103593,Ford; Joseph Earl,9999,0,9999,0
1667923194461,ECE 200,009,103594,Franceschetti; Massimo,9999,0,9999,0
1667923194461,ECE 200,010,103595,Fullerton; Eric E,9999,0,9999,0
1667923194461,ECE 200,011,103596,Galton; Ian A,9999,0,9999,0
1667923194461,ECE 200,012,103597,Gilja; Vikash,9999,0,9999,0
1667923194461,ECE 200,013,103598,Hall; Drew A.,9999,0,9999,0
1667923194461,ECE 200,014,103599,Hsueh; Tzu-Chien,9999,0,9999,0
1667923194461,ECE 200,015,103600,Javidi; Tara,9999,0,9999,0
1667923194461,ECE 200,016,103601,Kahng; Andrew Byun,9999,0,9999,0
1667923194461,ECE 200,017,103602,Kim; Young-Han,9999,0,9999,0
1667923194461,ECE 200,018,103603,Koushanfar; Farinaz,9999,0,9999,0
1667923194461,ECE 200,019,103604,Kuzum; Duygu,9999,0,9999,0
1667923194461,ECE 200,020,103605,Le; Hanh-Phuc,9999,0,9999,0
1667923194461,ECE 200,021,103606,Lin; Bill,9999,0,9999,0
1667923194461,ECE 200,022,103607,Liu; Zhaowei,9998,0,9999,1
1667923194461,ECE 200,023,103608,Lo; Yu-Hwa,9999,0,9999,0
1667923194461,ECE 200,024,103609,Lomakin; Vitaliy,9999,0,9999,0
1667923194461,ECE 200,025,103610,Mercier; Patrick Philip,9999,0,9999,0
1667923194461,ECE 200,026,103611,Meyer; Florian,9999,0,9999,0
1667923194461,ECE 200,027,103612,Milstein; Laurence B.,9999,0,9999,0
1667923194461,ECE 200,028,103613,Mir Arabbaygi; Siavash,9999,0,9999,0
1667923194461,ECE 200,029,103614,Mookherjea; Shayan,9999,0,9999,0
1667923194461,ECE 200,030,103615,Morris; Karcher William,9999,0,9999,0
1667923194461,ECE 200,031,103616,Ng; Tse Nga,9999,0,9999,0
1667923194461,ECE 200,032,103617,Nguyen; Truong Quang,9999,0,9999,0
1667923194461,ECE 200,033,103618,Nomura; Kenji,9999,0,9999,0
1667923194461,ECE 200,034,103619,Orlitsky; Alon,9999,0,9999,0
1667923194461,ECE 200,035,103620,Pal; Piya,9999,0,9999,0
1667923194461,ECE 200,036,103621,Papen; George C.,9999,0,9999,0
1667923194461,ECE 200,037,103622,Radic; Stojan,9999,0,9999,0
1667923194461,ECE 200,038,103623,Rao; Bhaskar D.,9999,0,9999,0
1667923194461,ECE 200,039,103624,Rao; Ramesh R,9999,0,9999,0
1667923194461,ECE 200,040,103625,Rebeiz; Gabriel,9999,0,9999,0
1667923194461,ECE 200,041,103626,Sanford; John R,9999,0,9999,0
1667923194461,ECE 200,042,103627,Siegel; Paul H.,9999,0,9999,0
1667923194461,ECE 200,043,103628,Sievenpiper; Daniel F.,9999,0,9999,0
1667923194461,ECE 200,044,103629,Sworder; David D.,9999,0,9999,0
1667923194461,ECE 200,045,103630,Taur; Yuan,9999,0,9999,0
1667923194461,ECE 200,046,103631,Touri; Behrouz,9999,0,9999,0
1667923194461,ECE 200,047,103632,Trivedi; Mohan M.,9999,0,9999,0
1667923194461,ECE 200,048,103633,Vasconcelos; Nuno,9999,0,9999,0
1667923194461,ECE 200,049,103634,Wang; Xiaolong,9999,0,9999,0
1667923194461,ECE 200,050,103635,Xie; Pengtao,9999,0,9999,0
1667923194461,ECE 200,051,103636,Yip; Michael,9999,0,9999,0
1667923194461,ECE 200,052,103637,Zeger; Kenneth A.,999,0,999,0
1667923194461,ECE 200,053,103638,Zhang; Xinyu,9999,0,9999,0
1667923194461,ECE 200,054,103639,Turakhia; Yatish Girish,9999,0,9999,0
1667923194461,ECE 200,055,103640,Kang; Mingu,9999,0,9999,0
1667923194461,ECE 200,056,103641,Shi; Yuanyuan,9999,0,9999,0
1667923194461,ECE 200,057,103642,Wang; Edward Jay,9999,0,9999,0
1667923194461,ECE 200,058,103643,Zheng; Yang,9999,0,9999,0
1667923194895,ECE 202,A00,103644,Kuzum; Duygu,0,0,0,0
1667923195333,ECE 212BN,A00,103646,Ng; Tse Nga,0,0,0,0
1667923195759,ECE 221,A00,111493,Staff,0,0,0,0
1667923196198,ECE 222B,A00,103647,Lomakin; Vitaliy,0,0,0,0
1667923196626,ECE 230B,A00,103648,Taur; Yuan,0,0,0,0
1667923197061,ECE 238B,A00,103649,Garay; Javier,0,0,0,0
1667923197495,ECE 240B,A00,112900,Fainman; Yeshaiahu,0,0,0,0
1667923197937,ECE 247A,A00,103650,Jokerst; Jesse Vincent,0,0,0,0
1667923198374,ECE 247B,A00,103651,Wang; Joseph,0,0,0,0
1667923198823,ECE 250,A00,103652,Siegel; Paul H.,0,0,0,0
1667923199274,ECE 251A,A00,103654,Rao; Bhaskar D.,0,0,0,0
1667923199707,ECE 257B,A00,103655,Bharadia; Dinesh,0,0,0,0
1667923200132,ECE 258A,A00,103656,Milstein; Laurence B.,0,0,0,0
1667923200560,ECE 260B,A00,103658,Kang; Mingu,0,0,0,0
1667923200993,ECE 264A,A00,103659,Galton; Ian A,0,0,0,0
1667923201434,ECE 265A,A00,103661,Gudem; Prasad S.S.,0,0,0,0
1667923201878,ECE 265D,A00,103662,Gudem; Prasad S.S.,0,0,0,0
1667923202306,ECE 268,A00,103663,Koushanfar; Farinaz,0,0,0,0
1667923202755,ECE 269,A01,103665,Pal; Piya,0,0,0,0
1667923203185,ECE 271B,A00,103666,Vasconcelos; Manuela,0,0,0,0
1667923203617,ECE 276A,A00,103667,Atanasov; Nikolay A.,0,0,0,0
1667923204056,ECE 277,A00,103668,An; Cheolhong,0,0,0,0
1667923204484,ECE 279,A00,117947,Hall; Drew A.,0,0,0,0
1667923205558,ECE 283,A00,103670,Hsueh; Tzu-Chien,0,0,0,0
1667923205999,ECE 284,A00,103671,Turakhia; Yatish Girish,0,0,0,0
1667923206452,ECE 285,A00,103672,Zheng; Yang,0,0,0,0
1667923206452,ECE 285,B00,103673,Sworder; David D.,0,0,0,0
1667923206924,ECE 287,A00,103676,Javidi; Tara,0,0,0,0
1667923207359,MATH 200B,A00,098023,Salehi Golsefidy; Alireza,15,0,15,0
1667923207782,MATH 202B,A00,098024,Rhoades; Brendon Patrick,14,0,15,1
1667923208213,MATH 203B,A00,098025,Oprea; Dragos N.,14,0,15,1
1667923208645,MATH 204B,A00,098026,Sorensen; Claus M,15,0,15,0
1667923209069,MATH 208,A00,098027,Izadi; Elham,7,0,10,3
1667923209507,MATH 209,A00,098028,Pollack; Aaron,10,0,10,0
1667923209941,MATH 211A,A00,112919,Rogalski; Daniel,10,0,10,0
1667923210384,MATH 211B,A00,112920,Seward; Brandon M.,10,0,10,0
1667923210830,MATH 218,A00,098029,Li; Bo,10,0,10,0
1667923211266,MATH 220B,A00,098030,Novak; Jonathan I,15,0,15,0
1667923211703,MATH 221A,A00,098031,Ebenfelt; Peter F,15,0,15,0
1667923212141,MATH 231B,A00,098032,Zlatos; Andrej,15,0,15,0
1667923212585,MATH 240B,A00,098033,Ni; Lei,13,0,15,2
1667923213010,MATH 243,A00,098034,Jekel; David Andrew,10,0,10,0
1667923213455,MATH 245A,A00,098035,Nie; Jiawang,6,0,15,9
1667923213890,MATH 248,A00,098036,Bejenaru; Ioan,10,0,10,0
1667923214315,MATH 250B,A00,098037,Spolaor; Luca,14,0,15,1
1667923214744,MATH 258,A00,098038,Ni; Lei,10,0,10,0
1667923215183,MATH 264B,A00,098041,Rhoades; Brendon Patrick,13,0,15,2
1667923215616,MATH 268,A00,098042,Buss; Samuel R,10,0,10,0
1667923216041,MATH 269,A00,098043,Rhoades; Brendon Patrick,10,0,10,0
1667923216470,MATH 270B,A00,098044,Li; Bo,13,0,15,2
1667923216902,MATH 272B,A00,098045,Holst; Michael J,13,0,15,2
1667923217330,MATH 273A,A00,098046,Tian; Xiaochuan,12,0,15,3
1667923217760,MATH 275,A01,098048,Tian; Xiaochuan,7,0,10,3
1667923218197,MATH 278A,A00,098049,Holst; Michael J,8,0,10,2
1667923218630,MATH 278B,A00,098050,Cloninger; Alexander,10,0,10,0
1667923219086,MATH 278C,A00,098051,Nie; Jiawang,9,0,10,1
1667923219520,MATH 280B,A00,098052,Zheng; Tianyi,12,0,15,3
1667923219955,MATH 281B,A00,098053,Bradic; Jelena,6,0,15,9
1667923220392,MATH 282B,A00,098054,Arias-Castro; Ery,2,0,15,13
1667923220835,MATH 285,A00,098055,Fitzsimmons; Patrick J,3,0,15,12
1667923221268,MATH 287B,A00,098056,Arias-Castro; Ery,9,0,15,6
1667923221703,MATH 288,A00,098057,Agarwal; Pooja,9,0,10,1
1667923221703,MATH 288,B00,098058,Zhang; Danna,9,0,10,1
1667923221703,MATH 288,C00,098059,Williams; Ruth J,10,0,10,0
1667923222132,MATH 290B,A00,098060,Roberts; Justin Deritter,14,0,15,1
1667923222565,MATH 292,A00,098061,Belmont; Eva Kinoshita,10,0,10,0
1667923222996,MATH 295,A00,098062,Suk; Andrew Hoon,48,0,50,2
1667923223422,MATH 296,A00,098063,Novak; Jonathan I,20,0,20,0
1667923223858,MATH 297,001,098064,Gamst; Anthony Collins,9997,0,9999,2
1667923735075,COGS 205,A00,101395,Chiba; Andrea,19,0,20,1
1667923735503,COGS 210B,001,101404,Greene; Deanna Jacquelyn,9998,0,9999,1
1667923735503,COGS 210B,002,101417,Xia; Haijun,9999,0,9999,0
1667923735503,COGS 210B,003,101422,Nitz; Douglas A.,9999,0,9999,0
1667923735503,COGS 210B,004,101423,Hollan; James D.,9998,0,9999,1
1667923735503,COGS 210B,005,101424,Deak; Gedeon O.,9999,0,9999,0
1667923735503,COGS 210B,006,101425,Rossano; Federico,9999,0,9999,0
1667923735933,COGS 211B,A00,101427,Coulson; Seana M,9997,0,9999,2
1667923736362,COGS 220,A00,101428,Hollan; James D.,0,0,25,25
1667923736795,COGS 229,A00,101429,Dow; Steven P,19,0,25,6
1667923737223,COGS 230,A00,101430,Klemmer; Scott R,13,0,17,4
1667923737652,COGS 234,A00,101431,Xia; Haijun,11,0,25,14
1667923738093,COGS 260,A00,101432,Kiyonaga; Anastasia,19,0,25,6
1667923738093,COGS 260,B00,101433,Kirsh; David Joel,18,0,25,7
1667923738531,CSE 202,A00,102371,Impagliazzo; Russell,0,0,0,0
1667923738961,CSE 203B,A01,102373,Cheng; Chung Kuan,0,0,0,0
1667923739403,CSE 208,A00,102374,Micciancio; Daniele,0,0,0,0
1667923739833,CSE 209A,A00,112895,Impagliazzo; Russell,0,0,15,15
1667923740268,CSE 209B,A00,108005,Bellare; Mihir,0,0,0,0
1667923740704,CSE 210,A00,113163,Coblenz; Michael J,0,0,0,0
1667923741132,CSE 219,A00,106111,Dow; Steven P,0,0,20,20
1667923741560,CSE 221,A00,102376,Voelker; Geoffrey M.,0,0,0,0
1667923741987,CSE 224,A01,102378,Porter; George M,0,0,0,0
1667923742431,CSE 229A,A00,102379,Savage; Stefan,0,0,0,0
1667923742877,CSE 229C,A00,102380,Munyaka; Imani N. S.,0,0,0,0
1667923743315,CSE 232B,A00,102382,Deutsch; Alin Bernard,0,0,0,0
1667923743748,CSE 234,A01,112904,Kumar; Arun Kumar,0,0,0,0
1667923744183,CSE 237A,A00,102383,Rosing; Tajana Simunic,0,0,0,0
1667923744624,CSE 239A,A00,102384,Deutsch; Alin Bernard,0,0,0,0
1667923745061,CSE 239B,A00,102385,Polikarpova; Nadezhda,0,0,0,0
1667923745493,CSE 240A,A00,102386,Pannuto; Patrick William,0,0,0,0
1667923745944,CSE 240B,A00,102387,Zhao; Jishen,0,0,0,0
1667923746376,CSE 241A,A00,106406,Kang; Mingu,0,0,0,0
1667923746817,CSE 249B,A00,102388,Kahng; Andrew Byun,0,0,8,8
1667923747252,CSE 251B,A01,102392,Cottrell; Garrison W,0,0,0,0
1667923747252,CSE 251B,A02,102393,Cottrell; Garrison W,0,0,0,0
1667923747695,CSE 252B,A00,102394,Ochoa; Benjamin Lawrence,0,0,0,0
1667923748140,CSE 257,A01,102396,Gao; Sicun,0,0,0,0
1667923748568,CSE 272,A00,102397,Li; Tzumao,0,0,0,0
1667923749009,CSE 274,A00,111323,Chern; Albert Ren-Haur,0,0,0,0
1667923749448,CSE 282,A00,102398,Pevzner; Pavel Arkadjevich,0,0,0,0
1667923749875,CSE 284,A00,114175,Gymrek; Melissa Ann,0,0,0,0
1667923750306,CSE 290,A00,102399,Chandraker; Manmohan Krishna,0,0,0,0
1667923750306,CSE 290,B00,102400,Vaccaro; Kristen Marie,0,0,25,25
1667923750306,CSE 290,C00,102414,Pannuto; Patrick William,0,0,25,25
1667923750306,CSE 290,D00,102427,Pevzner; Pavel Arkadjevich,0,0,0,0
1667923750306,CSE 290,E00,102429,Zhao; Jishen,0,0,0,0
1667923750306,CSE 290,F00,102436,Tullsen; Dean Michael,0,0,0,0
1667923750306,CSE 290,G00,102440,Christensen; Henrik I,0,0,20,20
1667923750749,CSE 291,A00,102443,Su; Hao,0,0,0,0
1667923750749,CSE 291,B00,102448,Polikarpova; Nadezhda,0,0,0,0
1667923750749,CSE 291,C00,102453,Vaccaro; Kristen Marie,0,0,0,0
1667923750749,CSE 291,D00,111343,Savage; Stefan,0,0,0,0
1667923750749,CSE 291,E00,116474,Claffy; Kimberly Claire,0,0,0,0
1667923750749,CSE 291,F00,116479,Pasquale; Joseph,0,0,0,0
1667923751192,CSE 293,001,119111,Bafna; Vineet,9999,0,9999,0
1667923751192,CSE 293,002,119118,Bellare; Mihir,9999,0,9999,0
1667923751192,CSE 293,003,119122,Berg-Kirkpatrick; Taylor D,9999,0,9999,0
1667923751192,CSE 293,004,119135,Christensen; Henrik I,9999,0,9999,0
1667923751192,CSE 293,005,119142,Cottrell; Garrison W,9999,0,9999,0
1667923751192,CSE 293,006,119146,Deutsch; Alin Bernard,9999,0,9999,0
1667923751192,CSE 293,007,119159,Esmaeilzadeh; Hadi,9999,0,9999,0
1667923751192,CSE 293,008,119166,Freund; Yoav,9999,0,9999,0
1667923751192,CSE 293,009,119170,Griswold; William G.,9999,0,9999,0
1667923751192,CSE 293,010,119183,Gymrek; Melissa Ann,9999,0,9999,0
1667923751192,CSE 293,011,119190,Heninger; Nadia A,9999,0,9999,0
1667923751192,CSE 293,012,119230,Impagliazzo; Russell,9999,0,9999,0
1667923751192,CSE 293,013,119232,Jhala; Ranjit,9999,0,9999,0
1667923751192,CSE 293,014,119233,Kahng; Andrew Byun,9999,0,9999,0
1667923751192,CSE 293,015,119298,Kane; Daniel Mertz,9999,0,9999,0
1667923751192,CSE 293,016,119299,Kriegman; David J,9999,0,9999,0
1667923751192,CSE 293,017,119300,Kumar; Arun Kumar,9999,0,9999,0
1667923751192,CSE 293,018,119301,Lerner; Sorin,9999,0,9999,0
1667923751192,CSE 293,019,119302,Lovett; Shachar,9999,0,9999,0
1667923751192,CSE 293,020,119303,McAuley; Julian John,9999,0,9999,0
1667923751192,CSE 293,021,119304,Micciancio; Daniele,9999,0,9999,0
1667923751192,CSE 293,022,119367,Orailoglu; Alex,9999,0,9999,0
1667923751192,CSE 293,023,119382,Paturi; Ramamohan,9999,0,9999,0
1667923751192,CSE 293,024,119404,Polikarpova; Nadezhda,9999,0,9999,0
1667923751192,CSE 293,025,119406,Politz; Joseph Gibbs,9999,0,9999,0
1667923751192,CSE 293,026,119411,Porter; George M,9999,0,9999,0
1667923751192,CSE 293,027,119414,Porter; Leonard Emerson,9999,0,9999,0
1667923751192,CSE 293,028,119416,Ramamoorthi; Ravi,9999,0,9999,0
1667923751192,CSE 293,029,119417,Sahoo; Debashis,9999,0,9999,0
1667923751192,CSE 293,030,119420,Saul; Lawrence,9999,0,9999,0
1667923751192,CSE 293,031,119421,Savage; Stefan,9999,0,9999,0
1667923751192,CSE 293,032,119425,Schulze; Jurgen P.,9999,0,9999,0
1667923751192,CSE 293,033,119426,Snoeren; Alex C.,9999,0,9999,0
1667923751192,CSE 293,034,119428,Shang; Jingbo,9999,0,9999,0
1667923751192,CSE 293,035,119430,Stefan; Deian,9999,0,9999,0
1667923751192,CSE 293,036,119431,Su; Hao,9999,0,9999,0
1667923751192,CSE 293,037,119433,Swanson; Steven James,9999,0,9999,0
1667923751192,CSE 293,038,119435,Tullsen; Dean Michael,9999,0,9999,0
1667923751192,CSE 293,039,119483,Voelker; Geoffrey M.,9999,0,9999,0
1667923751192,CSE 293,040,119537,Zhao; Jishen,9999,0,9999,0
1667923751192,CSE 293,041,119538,Zhou; Yuan-Yuan,9999,0,9999,0
1667923751192,CSE 293,042,119539,Gao; Sicun,9999,0,9999,0
1667923751192,CSE 293,043,119540,Weibel; Nadir,9999,0,9999,0
1667923751192,CSE 293,044,119541,Gupta; Rajesh K.,9999,0,9999,0
1667923751617,CSE 294,A00,102459,Voelker; Geoffrey M.,0,0,0,0
1667923751617,CSE 294,B00,111322,Orailoglu; Alex,0,0,0,0
1667923752081,DSE 201,A00,096914,Deutsch; Alin Bernard,30,0,30,0
1667923752522,DSE 210,A00,096915,Dasgupta; Sanjoy,30,0,30,0
1667923752949,DSE 260A,A00,096916,Altintas De Callaf; Ilkay,30,0,30,0
1667923753382,ECE 200,001,103586,Antipa; Nicholas A,9999,0,9999,0
1667923753382,ECE 200,002,103587,Atanasov; Nikolay A.,9999,0,9999,0
1667923753382,ECE 200,003,103588,Bharadia; Dinesh,9999,0,9999,0
1667923753382,ECE 200,004,103589,Cheng; Chung Kuan,9999,0,9999,0
1667923753382,ECE 200,005,103590,Cosman; Pamela C.,9999,0,9999,0
1667923753382,ECE 200,006,103591,Dayeh; Shadi Ahmad,9999,0,9999,0
1667923753382,ECE 200,007,103592,Fainman; Yeshaiahu,9999,0,9999,0
1667923753382,ECE 200,008,103593,Ford; Joseph Earl,9999,0,9999,0
1667923753382,ECE 200,009,103594,Franceschetti; Massimo,9999,0,9999,0
1667923753382,ECE 200,010,103595,Fullerton; Eric E,9999,0,9999,0
1667923753382,ECE 200,011,103596,Galton; Ian A,9999,0,9999,0
1667923753382,ECE 200,012,103597,Gilja; Vikash,9999,0,9999,0
1667923753382,ECE 200,013,103598,Hall; Drew A.,9999,0,9999,0
1667923753382,ECE 200,014,103599,Hsueh; Tzu-Chien,9999,0,9999,0
1667923753382,ECE 200,015,103600,Javidi; Tara,9999,0,9999,0
1667923753382,ECE 200,016,103601,Kahng; Andrew Byun,9999,0,9999,0
1667923753382,ECE 200,017,103602,Kim; Young-Han,9999,0,9999,0
1667923753382,ECE 200,018,103603,Koushanfar; Farinaz,9999,0,9999,0
1667923753382,ECE 200,019,103604,Kuzum; Duygu,9999,0,9999,0
1667923753382,ECE 200,020,103605,Le; Hanh-Phuc,9999,0,9999,0
1667923753382,ECE 200,021,103606,Lin; Bill,9999,0,9999,0
1667923753382,ECE 200,022,103607,Liu; Zhaowei,9998,0,9999,1
1667923753382,ECE 200,023,103608,Lo; Yu-Hwa,9999,0,9999,0
1667923753382,ECE 200,024,103609,Lomakin; Vitaliy,9999,0,9999,0
1667923753382,ECE 200,025,103610,Mercier; Patrick Philip,9999,0,9999,0
1667923753382,ECE 200,026,103611,Meyer; Florian,9999,0,9999,0
1667923753382,ECE 200,027,103612,Milstein; Laurence B.,9999,0,9999,0
1667923753382,ECE 200,028,103613,Mir Arabbaygi; Siavash,9999,0,9999,0
1667923753382,ECE 200,029,103614,Mookherjea; Shayan,9999,0,9999,0
1667923753382,ECE 200,030,103615,Morris; Karcher William,9999,0,9999,0
1667923753382,ECE 200,031,103616,Ng; Tse Nga,9999,0,9999,0
1667923753382,ECE 200,032,103617,Nguyen; Truong Quang,9999,0,9999,0
1667923753382,ECE 200,033,103618,Nomura; Kenji,9999,0,9999,0
1667923753382,ECE 200,034,103619,Orlitsky; Alon,9999,0,9999,0
1667923753382,ECE 200,035,103620,Pal; Piya,9999,0,9999,0
1667923753382,ECE 200,036,103621,Papen; George C.,9999,0,9999,0
1667923753382,ECE 200,037,103622,Radic; Stojan,9999,0,9999,0
1667923753382,ECE 200,038,103623,Rao; Bhaskar D.,9999,0,9999,0
1667923753382,ECE 200,039,103624,Rao; Ramesh R,9999,0,9999,0
1667923753382,ECE 200,040,103625,Rebeiz; Gabriel,9999,0,9999,0
1667923753382,ECE 200,041,103626,Sanford; John R,9999,0,9999,0
1667923753382,ECE 200,042,103627,Siegel; Paul H.,9999,0,9999,0
1667923753382,ECE 200,043,103628,Sievenpiper; Daniel F.,9999,0,9999,0
1667923753382,ECE 200,044,103629,Sworder; David D.,9999,0,9999,0
1667923753382,ECE 200,045,103630,Taur; Yuan,9999,0,9999,0
1667923753382,ECE 200,046,103631,Touri; Behrouz,9999,0,9999,0
1667923753382,ECE 200,047,103632,Trivedi; Mohan M.,9999,0,9999,0
1667923753382,ECE 200,048,103633,Vasconcelos; Nuno,9999,0,9999,0
1667923753382,ECE 200,049,103634,Wang; Xiaolong,9999,0,9999,0
1667923753382,ECE 200,050,103635,Xie; Pengtao,9999,0,9999,0
1667923753382,ECE 200,051,103636,Yip; Michael,9999,0,9999,0
1667923753382,ECE 200,052,103637,Zeger; Kenneth A.,999,0,999,0
1667923753382,ECE 200,053,103638,Zhang; Xinyu,9999,0,9999,0
1667923753382,ECE 200,054,103639,Turakhia; Yatish Girish,9999,0,9999,0
1667923753382,ECE 200,055,103640,Kang; Mingu,9999,0,9999,0
1667923753382,ECE 200,056,103641,Shi; Yuanyuan,9999,0,9999,0
1667923753382,ECE 200,057,103642,Wang; Edward Jay,9999,0,9999,0
1667923753382,ECE 200,058,103643,Zheng; Yang,9999,0,9999,0
1667923753825,ECE 202,A00,103644,Kuzum; Duygu,0,0,0,0
1667923754258,ECE 212BN,A00,103646,Ng; Tse Nga,0,0,0,0
1667923754687,ECE 221,A00,111493,Staff,0,0,0,0
1667923755127,ECE 222B,A00,103647,Lomakin; Vitaliy,0,0,0,0
1667923755560,ECE 230B,A00,103648,Taur; Yuan,0,0,0,0
1667923755998,ECE 238B,A00,103649,Garay; Javier,0,0,0,0
1667923756429,ECE 240B,A00,112900,Fainman; Yeshaiahu,0,0,0,0
1667923756857,ECE 247A,A00,103650,Jokerst; Jesse Vincent,0,0,0,0
1667923757300,ECE 247B,A00,103651,Wang; Joseph,0,0,0,0
1667923757731,ECE 250,A00,103652,Siegel; Paul H.,0,0,0,0
1667923758158,ECE 251A,A00,103654,Rao; Bhaskar D.,0,0,0,0
1667923758598,ECE 257B,A00,103655,Bharadia; Dinesh,0,0,0,0
1667923759026,ECE 258A,A00,103656,Milstein; Laurence B.,0,0,0,0
1667923759450,ECE 260B,A00,103658,Kang; Mingu,0,0,0,0
1667923759876,ECE 264A,A00,103659,Galton; Ian A,0,0,0,0
1667923760300,ECE 265A,A00,103661,Gudem; Prasad S.S.,0,0,0,0
1667923760729,ECE 265D,A00,103662,Gudem; Prasad S.S.,0,0,0,0
1667923761160,ECE 268,A00,103663,Koushanfar; Farinaz,0,0,0,0
1667923761596,ECE 269,A01,103665,Pal; Piya,0,0,0,0
1667923762026,ECE 271B,A00,103666,Vasconcelos; Manuela,0,0,0,0
1667923762456,ECE 276A,A00,103667,Atanasov; Nikolay A.,0,0,0,0
1667923762887,ECE 277,A00,103668,An; Cheolhong,0,0,0,0
1667923763336,ECE 279,A00,117947,Hall; Drew A.,0,0,0,0
1667923764252,ECE 283,A00,103670,Hsueh; Tzu-Chien,0,0,0,0
1667923764697,ECE 284,A00,103671,Turakhia; Yatish Girish,0,0,0,0
1667923765124,ECE 285,A00,103672,Zheng; Yang,0,0,0,0
1667923765124,ECE 285,B00,103673,Sworder; David D.,0,0,0,0
1667923765561,ECE 287,A00,103676,Javidi; Tara,0,0,0,0
1667923766022,MATH 200B,A00,098023,Salehi Golsefidy; Alireza,15,0,15,0
1667923766538,MATH 202B,A00,098024,Rhoades; Brendon Patrick,14,0,15,1
1667923766963,MATH 203B,A00,098025,Oprea; Dragos N.,14,0,15,1
1667923767401,MATH 204B,A00,098026,Sorensen; Claus M,15,0,15,0
1667923767837,MATH 208,A00,098027,Izadi; Elham,7,0,10,3
1667923768260,MATH 209,A00,098028,Pollack; Aaron,10,0,10,0
1667923768697,MATH 211A,A00,112919,Rogalski; Daniel,10,0,10,0
1667923769152,MATH 211B,A00,112920,Seward; Brandon M.,10,0,10,0
1667923769585,MATH 218,A00,098029,Li; Bo,10,0,10,0
1667923770028,MATH 220B,A00,098030,Novak; Jonathan I,15,0,15,0
1667923770457,MATH 221A,A00,098031,Ebenfelt; Peter F,15,0,15,0
1667923770886,MATH 231B,A00,098032,Zlatos; Andrej,15,0,15,0
1667923771314,MATH 240B,A00,098033,Ni; Lei,13,0,15,2
1667923771754,MATH 243,A00,098034,Jekel; David Andrew,10,0,10,0
1667923772194,MATH 245A,A00,098035,Nie; Jiawang,6,0,15,9
1667923772627,MATH 248,A00,098036,Bejenaru; Ioan,10,0,10,0
1667923773063,MATH 250B,A00,098037,Spolaor; Luca,14,0,15,1
1667923773498,MATH 258,A00,098038,Ni; Lei,10,0,10,0
1667923773945,MATH 264B,A00,098041,Rhoades; Brendon Patrick,13,0,15,2
1667923774381,MATH 268,A00,098042,Buss; Samuel R,10,0,10,0
1667923774836,MATH 269,A00,098043,Rhoades; Brendon Patrick,10,0,10,0
1667923775269,MATH 270B,A00,098044,Li; Bo,13,0,15,2
1667923775711,MATH 272B,A00,098045,Holst; Michael J,13,0,15,2
1667923776155,MATH 273A,A00,098046,Tian; Xiaochuan,12,0,15,3
1667923776601,MATH 275,A01,098048,Tian; Xiaochuan,7,0,10,3
1667923777039,MATH 278A,A00,098049,Holst; Michael J,8,0,10,2
1667923777468,MATH 278B,A00,098050,Cloninger; Alexander,10,0,10,0
1667923777900,MATH 278C,A00,098051,Nie; Jiawang,9,0,10,1
1667923778335,MATH 280B,A00,098052,Zheng; Tianyi,12,0,15,3
1667923778769,MATH 281B,A00,098053,Bradic; Jelena,6,0,15,9
1667923779197,MATH 282B,A00,098054,Arias-Castro; Ery,2,0,15,13
1667923779629,MATH 285,A00,098055,Fitzsimmons; Patrick J,3,0,15,12
1667923780061,MATH 287B,A00,098056,Arias-Castro; Ery,9,0,15,6
1667923780495,MATH 288,A00,098057,Agarwal; Pooja,9,0,10,1
1667923780495,MATH 288,B00,098058,Zhang; Danna,9,0,10,1
1667923780495,MATH 288,C00,098059,Williams; Ruth J,10,0,10,0
1667923780929,MATH 290B,A00,098060,Roberts; Justin Deritter,14,0,15,1
1667923781359,MATH 292,A00,098061,Belmont; Eva Kinoshita,10,0,10,0
1667923781789,MATH 295,A00,098062,Suk; Andrew Hoon,48,0,50,2
1667923782218,MATH 296,A00,098063,Novak; Jonathan I,20,0,20,0
1667923782644,MATH 297,001,098064,Gamst; Anthony Collins,9997,0,9999,2
1667924293766,COGS 205,A00,101395,Chiba; Andrea,19,0,20,1
1667924294189,COGS 210B,001,101404,Greene; Deanna Jacquelyn,9998,0,9999,1
1667924294189,COGS 210B,002,101417,Xia; Haijun,9999,0,9999,0
1667924294189,COGS 210B,003,101422,Nitz; Douglas A.,9999,0,9999,0
1667924294189,COGS 210B,004,101423,Hollan; James D.,9998,0,9999,1
1667924294189,COGS 210B,005,101424,Deak; Gedeon O.,9999,0,9999,0
1667924294189,COGS 210B,006,101425,Rossano; Federico,9999,0,9999,0
1667924294613,COGS 211B,A00,101427,Coulson; Seana M,9997,0,9999,2
1667924295048,COGS 220,A00,101428,Hollan; James D.,0,0,25,25
1667924295476,COGS 229,A00,101429,Dow; Steven P,19,0,25,6
1667924295919,COGS 230,A00,101430,Klemmer; Scott R,13,0,17,4
1667924296372,COGS 234,A00,101431,Xia; Haijun,11,0,25,14
1667924296796,COGS 260,A00,101432,Kiyonaga; Anastasia,19,0,25,6
1667924296796,COGS 260,B00,101433,Kirsh; David Joel,18,0,25,7
1667924297226,CSE 202,A00,102371,Impagliazzo; Russell,0,0,0,0
1667924297661,CSE 203B,A01,102373,Cheng; Chung Kuan,0,0,0,0
1667924298184,CSE 208,A00,102374,Micciancio; Daniele,0,0,0,0
1667924298625,CSE 209A,A00,112895,Impagliazzo; Russell,0,0,15,15
1667924299090,CSE 209B,A00,108005,Bellare; Mihir,0,0,0,0
1667924299525,CSE 210,A00,113163,Coblenz; Michael J,0,0,0,0
1667924299957,CSE 219,A00,106111,Dow; Steven P,0,0,20,20
1667924300387,CSE 221,A00,102376,Voelker; Geoffrey M.,0,0,0,0
1667924300829,CSE 224,A01,102378,Porter; George M,0,0,0,0
1667924301274,CSE 229A,A00,102379,Savage; Stefan,0,0,0,0
1667924301701,CSE 229C,A00,102380,Munyaka; Imani N. S.,0,0,0,0
1667924302131,CSE 232B,A00,102382,Deutsch; Alin Bernard,0,0,0,0
1667924302559,CSE 234,A01,112904,Kumar; Arun Kumar,0,0,0,0
1667924303009,CSE 237A,A00,102383,Rosing; Tajana Simunic,0,0,0,0
1667924303445,CSE 239A,A00,102384,Deutsch; Alin Bernard,0,0,0,0
1667924303887,CSE 239B,A00,102385,Polikarpova; Nadezhda,0,0,0,0
1667924304312,CSE 240A,A00,102386,Pannuto; Patrick William,0,0,0,0
1667924304747,CSE 240B,A00,102387,Zhao; Jishen,0,0,0,0
1667924305174,CSE 241A,A00,106406,Kang; Mingu,0,0,0,0
1667924305613,CSE 249B,A00,102388,Kahng; Andrew Byun,0,0,8,8
1667924306045,CSE 251B,A01,102392,Cottrell; Garrison W,0,0,0,0
1667924306045,CSE 251B,A02,102393,Cottrell; Garrison W,0,0,0,0
1667924306509,CSE 252B,A00,102394,Ochoa; Benjamin Lawrence,0,0,0,0
1667924306949,CSE 257,A01,102396,Gao; Sicun,0,0,0,0
1667924307376,CSE 272,A00,102397,Li; Tzumao,0,0,0,0
1667924307809,CSE 274,A00,111323,Chern; Albert Ren-Haur,0,0,0,0
1667924308260,CSE 282,A00,102398,Pevzner; Pavel Arkadjevich,0,0,0,0
1667924308695,CSE 284,A00,114175,Gymrek; Melissa Ann,0,0,0,0
1667924309127,CSE 290,A00,102399,Chandraker; Manmohan Krishna,0,0,0,0
1667924309127,CSE 290,B00,102400,Vaccaro; Kristen Marie,0,0,25,25
1667924309127,CSE 290,C00,102414,Pannuto; Patrick William,0,0,25,25
1667924309127,CSE 290,D00,102427,Pevzner; Pavel Arkadjevich,0,0,0,0
1667924309127,CSE 290,E00,102429,Zhao; Jishen,0,0,0,0
1667924309127,CSE 290,F00,102436,Tullsen; Dean Michael,0,0,0,0
1667924309127,CSE 290,G00,102440,Christensen; Henrik I,0,0,20,20
1667924309564,CSE 291,A00,102443,Su; Hao,0,0,0,0
1667924309564,CSE 291,B00,102448,Polikarpova; Nadezhda,0,0,0,0
1667924309564,CSE 291,C00,102453,Vaccaro; Kristen Marie,0,0,0,0
1667924309564,CSE 291,D00,111343,Savage; Stefan,0,0,0,0
1667924309564,CSE 291,E00,116474,Claffy; Kimberly Claire,0,0,0,0
1667924309564,CSE 291,F00,116479,Pasquale; Joseph,0,0,0,0
1667924309993,CSE 293,001,119111,Bafna; Vineet,9999,0,9999,0
1667924309993,CSE 293,002,119118,Bellare; Mihir,9999,0,9999,0
1667924309993,CSE 293,003,119122,Berg-Kirkpatrick; Taylor D,9999,0,9999,0
1667924309993,CSE 293,004,119135,Christensen; Henrik I,9999,0,9999,0
1667924309993,CSE 293,005,119142,Cottrell; Garrison W,9999,0,9999,0
1667924309993,CSE 293,006,119146,Deutsch; Alin Bernard,9999,0,9999,0
1667924309993,CSE 293,007,119159,Esmaeilzadeh; Hadi,9999,0,9999,0
1667924309993,CSE 293,008,119166,Freund; Yoav,9999,0,9999,0
1667924309993,CSE 293,009,119170,Griswold; William G.,9999,0,9999,0
1667924309993,CSE 293,010,119183,Gymrek; Melissa Ann,9999,0,9999,0
1667924309993,CSE 293,011,119190,Heninger; Nadia A,9999,0,9999,0
1667924309993,CSE 293,012,119230,Impagliazzo; Russell,9999,0,9999,0
1667924309993,CSE 293,013,119232,Jhala; Ranjit,9999,0,9999,0
1667924309993,CSE 293,014,119233,Kahng; Andrew Byun,9999,0,9999,0
1667924309993,CSE 293,015,119298,Kane; Daniel Mertz,9999,0,9999,0
1667924309993,CSE 293,016,119299,Kriegman; David J,9999,0,9999,0
1667924309993,CSE 293,017,119300,Kumar; Arun Kumar,9999,0,9999,0
1667924309993,CSE 293,018,119301,Lerner; Sorin,9999,0,9999,0
1667924309993,CSE 293,019,119302,Lovett; Shachar,9999,0,9999,0
1667924309993,CSE 293,020,119303,McAuley; Julian John,9999,0,9999,0
1667924309993,CSE 293,021,119304,Micciancio; Daniele,9999,0,9999,0
1667924309993,CSE 293,022,119367,Orailoglu; Alex,9999,0,9999,0
1667924309993,CSE 293,023,119382,Paturi; Ramamohan,9999,0,9999,0
1667924309993,CSE 293,024,119404,Polikarpova; Nadezhda,9999,0,9999,0
1667924309993,CSE 293,025,119406,Politz; Joseph Gibbs,9999,0,9999,0
1667924309993,CSE 293,026,119411,Porter; George M,9999,0,9999,0
1667924309993,CSE 293,027,119414,Porter; Leonard Emerson,9999,0,9999,0
1667924309993,CSE 293,028,119416,Ramamoorthi; Ravi,9999,0,9999,0
1667924309993,CSE 293,029,119417,Sahoo; Debashis,9999,0,9999,0
1667924309993,CSE 293,030,119420,Saul; Lawrence,9999,0,9999,0
1667924309993,CSE 293,031,119421,Savage; Stefan,9999,0,9999,0
1667924309993,CSE 293,032,119425,Schulze; Jurgen P.,9999,0,9999,0
1667924309993,CSE 293,033,119426,Snoeren; Alex C.,9999,0,9999,0
1667924309993,CSE 293,034,119428,Shang; Jingbo,9999,0,9999,0
1667924309993,CSE 293,035,119430,Stefan; Deian,9999,0,9999,0
1667924309993,CSE 293,036,119431,Su; Hao,9999,0,9999,0
1667924309993,CSE 293,037,119433,Swanson; Steven James,9999,0,9999,0
1667924309993,CSE 293,038,119435,Tullsen; Dean Michael,9999,0,9999,0
1667924309993,CSE 293,039,119483,Voelker; Geoffrey M.,9999,0,9999,0
1667924309993,CSE 293,040,119537,Zhao; Jishen,9999,0,9999,0
1667924309993,CSE 293,041,119538,Zhou; Yuan-Yuan,9999,0,9999,0
1667924309993,CSE 293,042,119539,Gao; Sicun,9999,0,9999,0
1667924309993,CSE 293,043,119540,Weibel; Nadir,9999,0,9999,0
1667924309993,CSE 293,044,119541,Gupta; Rajesh K.,9999,0,9999,0
1667924310421,CSE 294,A00,102459,Voelker; Geoffrey M.,0,0,0,0
1667924310421,CSE 294,B00,111322,Orailoglu; Alex,0,0,0,0
1667924310847,DSE 201,A00,096914,Deutsch; Alin Bernard,30,0,30,0
1667924311278,DSE 210,A00,096915,Dasgupta; Sanjoy,30,0,30,0
1667924311705,DSE 260A,A00,096916,Altintas De Callaf; Ilkay,30,0,30,0
1667924312163,ECE 200,001,103586,Antipa; Nicholas A,9999,0,9999,0
1667924312163,ECE 200,002,103587,Atanasov; Nikolay A.,9999,0,9999,0
1667924312163,ECE 200,003,103588,Bharadia; Dinesh,9999,0,9999,0
1667924312163,ECE 200,004,103589,Cheng; Chung Kuan,9999,0,9999,0
1667924312163,ECE 200,005,103590,Cosman; Pamela C.,9999,0,9999,0
1667924312163,ECE 200,006,103591,Dayeh; Shadi Ahmad,9999,0,9999,0
1667924312163,ECE 200,007,103592,Fainman; Yeshaiahu,9999,0,9999,0
1667924312163,ECE 200,008,103593,Ford; Joseph Earl,9999,0,9999,0
1667924312163,ECE 200,009,103594,Franceschetti; Massimo,9999,0,9999,0
1667924312163,ECE 200,010,103595,Fullerton; Eric E,9999,0,9999,0
1667924312163,ECE 200,011,103596,Galton; Ian A,9999,0,9999,0
1667924312163,ECE 200,012,103597,Gilja; Vikash,9999,0,9999,0
1667924312163,ECE 200,013,103598,Hall; Drew A.,9999,0,9999,0
1667924312163,ECE 200,014,103599,Hsueh; Tzu-Chien,9999,0,9999,0
1667924312163,ECE 200,015,103600,Javidi; Tara,9999,0,9999,0
1667924312163,ECE 200,016,103601,Kahng; Andrew Byun,9999,0,9999,0
1667924312163,ECE 200,017,103602,Kim; Young-Han,9999,0,9999,0
1667924312163,ECE 200,018,103603,Koushanfar; Farinaz,9999,0,9999,0
1667924312163,ECE 200,019,103604,Kuzum; Duygu,9999,0,9999,0
1667924312163,ECE 200,020,103605,Le; Hanh-Phuc,9999,0,9999,0
1667924312163,ECE 200,021,103606,Lin; Bill,9999,0,9999,0
1667924312163,ECE 200,022,103607,Liu; Zhaowei,9998,0,9999,1
1667924312163,ECE 200,023,103608,Lo; Yu-Hwa,9999,0,9999,0
1667924312163,ECE 200,024,103609,Lomakin; Vitaliy,9999,0,9999,0
1667924312163,ECE 200,025,103610,Mercier; Patrick Philip,9999,0,9999,0
1667924312163,ECE 200,026,103611,Meyer; Florian,9999,0,9999,0
1667924312163,ECE 200,027,103612,Milstein; Laurence B.,9999,0,9999,0
1667924312163,ECE 200,028,103613,Mir Arabbaygi; Siavash,9999,0,9999,0
1667924312163,ECE 200,029,103614,Mookherjea; Shayan,9999,0,9999,0
1667924312163,ECE 200,030,103615,Morris; Karcher William,9999,0,9999,0
1667924312163,ECE 200,031,103616,Ng; Tse Nga,9999,0,9999,0
1667924312163,ECE 200,032,103617,Nguyen; Truong Quang,9999,0,9999,0
1667924312163,ECE 200,033,103618,Nomura; Kenji,9999,0,9999,0
1667924312163,ECE 200,034,103619,Orlitsky; Alon,9999,0,9999,0
1667924312163,ECE 200,035,103620,Pal; Piya,9999,0,9999,0
1667924312163,ECE 200,036,103621,Papen; George C.,9999,0,9999,0
1667924312163,ECE 200,037,103622,Radic; Stojan,9999,0,9999,0
1667924312163,ECE 200,038,103623,Rao; Bhaskar D.,9999,0,9999,0
1667924312163,ECE 200,039,103624,Rao; Ramesh R,9999,0,9999,0
1667924312163,ECE 200,040,103625,Rebeiz; Gabriel,9999,0,9999,0
1667924312163,ECE 200,041,103626,Sanford; John R,9999,0,9999,0
1667924312163,ECE 200,042,103627,Siegel; Paul H.,9999,0,9999,0
1667924312163,ECE 200,043,103628,Sievenpiper; Daniel F.,9999,0,9999,0
1667924312163,ECE 200,044,103629,Sworder; David D.,9999,0,9999,0
1667924312163,ECE 200,045,103630,Taur; Yuan,9999,0,9999,0
1667924312163,ECE 200,046,103631,Touri; Behrouz,9999,0,9999,0
1667924312163,ECE 200,047,103632,Trivedi; Mohan M.,9999,0,9999,0
1667924312163,ECE 200,048,103633,Vasconcelos; Nuno,9999,0,9999,0
1667924312163,ECE 200,049,103634,Wang; Xiaolong,9999,0,9999,0
1667924312163,ECE 200,050,103635,Xie; Pengtao,9999,0,9999,0
1667924312163,ECE 200,051,103636,Yip; Michael,9999,0,9999,0
1667924312163,ECE 200,052,103637,Zeger; Kenneth A.,999,0,999,0
1667924312163,ECE 200,053,103638,Zhang; Xinyu,9999,0,9999,0
1667924312163,ECE 200,054,103639,Turakhia; Yatish Girish,9999,0,9999,0
1667924312163,ECE 200,055,103640,Kang; Mingu,9999,0,9999,0
1667924312163,ECE 200,056,103641,Shi; Yuanyuan,9999,0,9999,0
1667924312163,ECE 200,057,103642,Wang; Edward Jay,9999,0,9999,0
1667924312163,ECE 200,058,103643,Zheng; Yang,9999,0,9999,0
1667924312596,ECE 202,A00,103644,Kuzum; Duygu,0,0,0,0
1667924313021,ECE 212BN,A00,103646,Ng; Tse Nga,0,0,0,0
1667924313449,ECE 221,A00,111493,Staff,0,0,0,0
1667924313882,ECE 222B,A00,103647,Lomakin; Vitaliy,0,0,0,0
1667924314318,ECE 230B,A00,103648,Taur; Yuan,0,0,0,0
1667924314751,ECE 238B,A00,103649,Garay; Javier,0,0,0,0
1667924315176,ECE 240B,A00,112900,Fainman; Yeshaiahu,0,0,0,0
1667924315613,ECE 247A,A00,103650,Jokerst; Jesse Vincent,0,0,0,0
1667924316055,ECE 247B,A00,103651,Wang; Joseph,0,0,0,0
1667924316485,ECE 250,A00,103652,Siegel; Paul H.,0,0,0,0
1667924316936,ECE 251A,A00,103654,Rao; Bhaskar D.,0,0,0,0
1667924317367,ECE 257B,A00,103655,Bharadia; Dinesh,0,0,0,0
1667924317815,ECE 258A,A00,103656,Milstein; Laurence B.,0,0,0,0
1667924318246,ECE 260B,A00,103658,Kang; Mingu,0,0,0,0
1667924318689,ECE 264A,A00,103659,Galton; Ian A,0,0,0,0
1667924319121,ECE 265A,A00,103661,Gudem; Prasad S.S.,0,0,0,0
1667924319550,ECE 265D,A00,103662,Gudem; Prasad S.S.,0,0,0,0
1667924319993,ECE 268,A00,103663,Koushanfar; Farinaz,0,0,0,0
1667924320451,ECE 269,A01,103665,Pal; Piya,0,0,0,0
1667924320875,ECE 271B,A00,103666,Vasconcelos; Manuela,0,0,0,0
1667924321311,ECE 276A,A00,103667,Atanasov; Nikolay A.,0,0,0,0
1667924321761,ECE 277,A00,103668,An; Cheolhong,0,0,0,0
1667924322197,ECE 279,A00,117947,Hall; Drew A.,0,0,0,0
1667924323092,ECE 283,A00,103670,Hsueh; Tzu-Chien,0,0,0,0
1667924323526,ECE 284,A00,103671,Turakhia; Yatish Girish,0,0,0,0
1667924323961,ECE 285,A00,103672,Zheng; Yang,0,0,0,0
1667924323961,ECE 285,B00,103673,Sworder; David D.,0,0,0,0
1667924324397,ECE 287,A00,103676,Javidi; Tara,0,0,0,0
1667924324835,MATH 200B,A00,098023,Salehi Golsefidy; Alireza,15,0,15,0
1667924325266,MATH 202B,A00,098024,Rhoades; Brendon Patrick,14,0,15,1
1667924325691,MATH 203B,A00,098025,Oprea; Dragos N.,14,0,15,1
1667924326137,MATH 204B,A00,098026,Sorensen; Claus M,15,0,15,0
1667924326568,MATH 208,A00,098027,Izadi; Elham,7,0,10,3
1667924326999,MATH 209,A00,098028,Pollack; Aaron,10,0,10,0
1667924327431,MATH 211A,A00,112919,Rogalski; Daniel,10,0,10,0
1667924327866,MATH 211B,A00,112920,Seward; Brandon M.,10,0,10,0
1667924328317,MATH 218,A00,098029,Li; Bo,10,0,10,0
1667924328758,MATH 220B,A00,098030,Novak; Jonathan I,15,0,15,0
1667924329187,MATH 221A,A00,098031,Ebenfelt; Peter F,15,0,15,0
1667924329626,MATH 231B,A00,098032,Zlatos; Andrej,15,0,15,0
1667924330065,MATH 240B,A00,098033,Ni; Lei,13,0,15,2
1667924330505,MATH 243,A00,098034,Jekel; David Andrew,10,0,10,0
1667924330947,MATH 245A,A00,098035,Nie; Jiawang,6,0,15,9
1667924331376,MATH 248,A00,098036,Bejenaru; Ioan,10,0,10,0
1667924331817,MATH 250B,A00,098037,Spolaor; Luca,14,0,15,1
1667924332250,MATH 258,A00,098038,Ni; Lei,10,0,10,0
1667924332689,MATH 264B,A00,098041,Rhoades; Brendon Patrick,13,0,15,2
1667924333119,MATH 268,A00,098042,Buss; Samuel R,10,0,10,0
1667924333544,MATH 269,A00,098043,Rhoades; Brendon Patrick,10,0,10,0
1667924333976,MATH 270B,A00,098044,Li; Bo,13,0,15,2
1667924334414,MATH 272B,A00,098045,Holst; Michael J,13,0,15,2
1667924334847,MATH 273A,A00,098046,Tian; Xiaochuan,12,0,15,3
1667924335286,MATH 275,A01,098048,Tian; Xiaochuan,7,0,10,3
1667924335713,MATH 278A,A00,098049,Holst; Michael J,8,0,10,2
1667924336145,MATH 278B,A00,098050,Cloninger; Alexander,10,0,10,0
1667924336568,MATH 278C,A00,098051,Nie; Jiawang,9,0,10,1
1667924337003,MATH 280B,A00,098052,Zheng; Tianyi,12,0,15,3
1667924337435,MATH 281B,A00,098053,Bradic; Jelena,6,0,15,9
1667924337871,MATH 282B,A00,098054,Arias-Castro; Ery,2,0,15,13
1667924338307,MATH 285,A00,098055,Fitzsimmons; Patrick J,3,0,15,12
1667924338741,MATH 287B,A00,098056,Arias-Castro; Ery,9,0,15,6
1667924339189,MATH 288,A00,098057,Agarwal; Pooja,9,0,10,1
1667924339189,MATH 288,B00,098058,Zhang; Danna,9,0,10,1
1667924339189,MATH 288,C00,098059,Williams; Ruth J,10,0,10,0
1667924339615,MATH 290B,A00,098060,Roberts; Justin Deritter,14,0,15,1
1667924340042,MATH 292,A00,098061,Belmont; Eva Kinoshita,10,0,10,0
1667924340484,MATH 295,A00,098062,Suk; Andrew Hoon,48,0,50,2
1667924340917,MATH 296,A00,098063,Novak; Jonathan I,20,0,20,0
1667924341357,MATH 297,001,098064,Gamst; Anthony Collins,9997,0,9999,2
1667924852640,COGS 205,A00,101395,Chiba; Andrea,19,0,20,1
1667924853069,COGS 210B,001,101404,Greene; Deanna Jacquelyn,9998,0,9999,1
1667924853069,COGS 210B,002,101417,Xia; Haijun,9999,0,9999,0
1667924853069,COGS 210B,003,101422,Nitz; Douglas A.,9999,0,9999,0
1667924853069,COGS 210B,004,101423,Hollan; James D.,9998,0,9999,1
1667924853069,COGS 210B,005,101424,Deak; Gedeon O.,9999,0,9999,0
1667924853069,COGS 210B,006,101425,Rossano; Federico,9999,0,9999,0
1667924853497,COGS 211B,A00,101427,Coulson; Seana M,9997,0,9999,2
1667924853921,COGS 220,A00,101428,Hollan; James D.,0,0,25,25
1667924854355,COGS 229,A00,101429,Dow; Steven P,19,0,25,6
1667924854786,COGS 230,A00,101430,Klemmer; Scott R,13,0,17,4
1667924855210,COGS 234,A00,101431,Xia; Haijun,11,0,25,14
1667924855652,COGS 260,A00,101432,Kiyonaga; Anastasia,19,0,25,6
1667924855652,COGS 260,B00,101433,Kirsh; David Joel,18,0,25,7
1667924856094,CSE 202,A00,102371,Impagliazzo; Russell,0,0,0,0
1667924856525,CSE 203B,A01,102373,Cheng; Chung Kuan,0,0,0,0
1667924856959,CSE 208,A00,102374,Micciancio; Daniele,0,0,0,0
1667924857383,CSE 209A,A00,112895,Impagliazzo; Russell,0,0,15,15
1667924857821,CSE 209B,A00,108005,Bellare; Mihir,0,0,0,0
1667924858268,CSE 210,A00,113163,Coblenz; Michael J,0,0,0,0
1667924858713,CSE 219,A00,106111,Dow; Steven P,0,0,20,20
1667924859159,CSE 221,A00,102376,Voelker; Geoffrey M.,0,0,0,0
1667924859597,CSE 224,A01,102378,Porter; George M,0,0,0,0
1667924860024,CSE 229A,A00,102379,Savage; Stefan,0,0,0,0
1667924860452,CSE 229C,A00,102380,Munyaka; Imani N. S.,0,0,0,0
1667924860880,CSE 232B,A00,102382,Deutsch; Alin Bernard,0,0,0,0
1667924861307,CSE 234,A01,112904,Kumar; Arun Kumar,0,0,0,0
1667924861736,CSE 237A,A00,102383,Rosing; Tajana Simunic,0,0,0,0
1667924862173,CSE 239A,A00,102384,Deutsch; Alin Bernard,0,0,0,0
1667924862606,CSE 239B,A00,102385,Polikarpova; Nadezhda,0,0,0,0
1667924863031,CSE 240A,A00,102386,Pannuto; Patrick William,0,0,0,0
1667924863466,CSE 240B,A00,102387,Zhao; Jishen,0,0,0,0
1667924863901,CSE 241A,A00,106406,Kang; Mingu,0,0,0,0
1667924864342,CSE 249B,A00,102388,Kahng; Andrew Byun,0,0,8,8
1667924864772,CSE 251B,A01,102392,Cottrell; Garrison W,0,0,0,0
1667924864772,CSE 251B,A02,102393,Cottrell; Garrison W,0,0,0,0
1667924865205,CSE 252B,A00,102394,Ochoa; Benjamin Lawrence,0,0,0,0
1667924865634,CSE 257,A01,102396,Gao; Sicun,0,0,0,0
1667924866061,CSE 272,A00,102397,Li; Tzumao,0,0,0,0
1667924866485,CSE 274,A00,111323,Chern; Albert Ren-Haur,0,0,0,0
1667924866936,CSE 282,A00,102398,Pevzner; Pavel Arkadjevich,0,0,0,0
1667924867364,CSE 284,A00,114175,Gymrek; Melissa Ann,0,0,0,0
1667924867800,CSE 290,A00,102399,Chandraker; Manmohan Krishna,0,0,0,0
1667924867800,CSE 290,B00,102400,Vaccaro; Kristen Marie,0,0,25,25
1667924867800,CSE 290,C00,102414,Pannuto; Patrick William,0,0,25,25
1667924867800,CSE 290,D00,102427,Pevzner; Pavel Arkadjevich,0,0,0,0
1667924867800,CSE 290,E00,102429,Zhao; Jishen,0,0,0,0
1667924867800,CSE 290,F00,102436,Tullsen; Dean Michael,0,0,0,0
1667924867800,CSE 290,G00,102440,Christensen; Henrik I,0,0,20,20
1667924868248,CSE 291,A00,102443,Su; Hao,0,0,0,0
1667924868248,CSE 291,B00,102448,Polikarpova; Nadezhda,0,0,0,0
1667924868248,CSE 291,C00,102453,Vaccaro; Kristen Marie,0,0,0,0
1667924868248,CSE 291,D00,111343,Savage; Stefan,0,0,0,0
1667924868248,CSE 291,E00,116474,Claffy; Kimberly Claire,0,0,0,0
1667924868248,CSE 291,F00,116479,Pasquale; Joseph,0,0,0,0
1667924868679,CSE 293,001,119111,Bafna; Vineet,9999,0,9999,0
1667924868679,CSE 293,002,119118,Bellare; Mihir,9999,0,9999,0
1667924868679,CSE 293,003,119122,Berg-Kirkpatrick; Taylor D,9999,0,9999,0
1667924868679,CSE 293,004,119135,Christensen; Henrik I,9999,0,9999,0
1667924868679,CSE 293,005,119142,Cottrell; Garrison W,9999,0,9999,0
1667924868679,CSE 293,006,119146,Deutsch; Alin Bernard,9999,0,9999,0
1667924868679,CSE 293,007,119159,Esmaeilzadeh; Hadi,9999,0,9999,0
1667924868679,CSE 293,008,119166,Freund; Yoav,9999,0,9999,0
1667924868679,CSE 293,009,119170,Griswold; William G.,9999,0,9999,0
1667924868679,CSE 293,010,119183,Gymrek; Melissa Ann,9999,0,9999,0
1667924868679,CSE 293,011,119190,Heninger; Nadia A,9999,0,9999,0
1667924868679,CSE 293,012,119230,Impagliazzo; Russell,9999,0,9999,0
1667924868679,CSE 293,013,119232,Jhala; Ranjit,9999,0,9999,0
1667924868679,CSE 293,014,119233,Kahng; Andrew Byun,9999,0,9999,0
1667924868679,CSE 293,015,119298,Kane; Daniel Mertz,9999,0,9999,0
1667924868679,CSE 293,016,119299,Kriegman; David J,9999,0,9999,0
1667924868679,CSE 293,017,119300,Kumar; Arun Kumar,9999,0,9999,0
1667924868679,CSE 293,018,119301,Lerner; Sorin,9999,0,9999,0
1667924868679,CSE 293,019,119302,Lovett; Shachar,9999,0,9999,0
1667924868679,CSE 293,020,119303,McAuley; Julian John,9999,0,9999,0
1667924868679,CSE 293,021,119304,Micciancio; Daniele,9999,0,9999,0
1667924868679,CSE 293,022,119367,Orailoglu; Alex,9999,0,9999,0
1667924868679,CSE 293,023,119382,Paturi; Ramamohan,9999,0,9999,0
1667924868679,CSE 293,024,119404,Polikarpova; Nadezhda,9999,0,9999,0
1667924868679,CSE 293,025,119406,Politz; Joseph Gibbs,9999,0,9999,0
1667924868679,CSE 293,026,119411,Porter; George M,9999,0,9999,0
1667924868679,CSE 293,027,119414,Porter; Leonard Emerson,9999,0,9999,0
1667924868679,CSE 293,028,119416,Ramamoorthi; Ravi,9999,0,9999,0
1667924868679,CSE 293,029,119417,Sahoo; Debashis,9999,0,9999,0
1667924868679,CSE 293,030,119420,Saul; Lawrence,9999,0,9999,0
1667924868679,CSE 293,031,119421,Savage; Stefan,9999,0,9999,0
1667924868679,CSE 293,032,119425,Schulze; Jurgen P.,9999,0,9999,0
1667924868679,CSE 293,033,119426,Snoeren; Alex C.,9999,0,9999,0
1667924868679,CSE 293,034,119428,Shang; Jingbo,9999,0,9999,0
1667924868679,CSE 293,035,119430,Stefan; Deian,9999,0,9999,0
1667924868679,CSE 293,036,119431,Su; Hao,9999,0,9999,0
1667924868679,CSE 293,037,119433,Swanson; Steven James,9999,0,9999,0
1667924868679,CSE 293,038,119435,Tullsen; Dean Michael,9999,0,9999,0
1667924868679,CSE 293,039,119483,Voelker; Geoffrey M.,9999,0,9999,0
1667924868679,CSE 293,040,119537,Zhao; Jishen,9999,0,9999,0
1667924868679,CSE 293,041,119538,Zhou; Yuan-Yuan,9999,0,9999,0
1667924868679,CSE 293,042,119539,Gao; Sicun,9999,0,9999,0
1667924868679,CSE 293,043,119540,Weibel; Nadir,9999,0,9999,0
1667924868679,CSE 293,044,119541,Gupta; Rajesh K.,9999,0,9999,0
1667924869120,CSE 294,A00,102459,Voelker; Geoffrey M.,0,0,0,0
1667924869120,CSE 294,B00,111322,Orailoglu; Alex,0,0,0,0
1667924869543,DSE 201,A00,096914,Deutsch; Alin Bernard,30,0,30,0
1667924869977,DSE 210,A00,096915,Dasgupta; Sanjoy,30,0,30,0
1667924870400,DSE 260A,A00,096916,Altintas De Callaf; Ilkay,30,0,30,0
1667924870872,ECE 200,001,103586,Antipa; Nicholas A,9999,0,9999,0
1667924870872,ECE 200,002,103587,Atanasov; Nikolay A.,9999,0,9999,0
1667924870872,ECE 200,003,103588,Bharadia; Dinesh,9999,0,9999,0
1667924870872,ECE 200,004,103589,Cheng; Chung Kuan,9999,0,9999,0
1667924870872,ECE 200,005,103590,Cosman; Pamela C.,9999,0,9999,0
1667924870872,ECE 200,006,103591,Dayeh; Shadi Ahmad,9999,0,9999,0
1667924870872,ECE 200,007,103592,Fainman; Yeshaiahu,9999,0,9999,0
1667924870872,ECE 200,008,103593,Ford; Joseph Earl,9999,0,9999,0
1667924870872,ECE 200,009,103594,Franceschetti; Massimo,9999,0,9999,0
1667924870872,ECE 200,010,103595,Fullerton; Eric E,9999,0,9999,0
1667924870872,ECE 200,011,103596,Galton; Ian A,9999,0,9999,0
1667924870872,ECE 200,012,103597,Gilja; Vikash,9999,0,9999,0
1667924870872,ECE 200,013,103598,Hall; Drew A.,9999,0,9999,0
1667924870872,ECE 200,014,103599,Hsueh; Tzu-Chien,9999,0,9999,0
1667924870872,ECE 200,015,103600,Javidi; Tara,9999,0,9999,0
1667924870872,ECE 200,016,103601,Kahng; Andrew Byun,9999,0,9999,0
1667924870872,ECE 200,017,103602,Kim; Young-Han,9999,0,9999,0
1667924870872,ECE 200,018,103603,Koushanfar; Farinaz,9999,0,9999,0
1667924870872,ECE 200,019,103604,Kuzum; Duygu,9999,0,9999,0
1667924870872,ECE 200,020,103605,Le; Hanh-Phuc,9999,0,9999,0
1667924870872,ECE 200,021,103606,Lin; Bill,9999,0,9999,0
1667924870872,ECE 200,022,103607,Liu; Zhaowei,9998,0,9999,1
1667924870872,ECE 200,023,103608,Lo; Yu-Hwa,9999,0,9999,0
1667924870872,ECE 200,024,103609,Lomakin; Vitaliy,9999,0,9999,0
1667924870872,ECE 200,025,103610,Mercier; Patrick Philip,9999,0,9999,0
1667924870872,ECE 200,026,103611,Meyer; Florian,9999,0,9999,0
1667924870872,ECE 200,027,103612,Milstein; Laurence B.,9999,0,9999,0
1667924870872,ECE 200,028,103613,Mir Arabbaygi; Siavash,9999,0,9999,0
1667924870872,ECE 200,029,103614,Mookherjea; Shayan,9999,0,9999,0
1667924870872,ECE 200,030,103615,Morris; Karcher William,9999,0,9999,0
1667924870872,ECE 200,031,103616,Ng; Tse Nga,9999,0,9999,0
1667924870872,ECE 200,032,103617,Nguyen; Truong Quang,9999,0,9999,0
1667924870872,ECE 200,033,103618,Nomura; Kenji,9999,0,9999,0
1667924870872,ECE 200,034,103619,Orlitsky; Alon,9999,0,9999,0
1667924870872,ECE 200,035,103620,Pal; Piya,9999,0,9999,0
1667924870872,ECE 200,036,103621,Papen; George C.,9999,0,9999,0
1667924870872,ECE 200,037,103622,Radic; Stojan,9999,0,9999,0
1667924870872,ECE 200,038,103623,Rao; Bhaskar D.,9999,0,9999,0
1667924870872,ECE 200,039,103624,Rao; Ramesh R,9999,0,9999,0
1667924870872,ECE 200,040,103625,Rebeiz; Gabriel,9999,0,9999,0
1667924870872,ECE 200,041,103626,Sanford; John R,9999,0,9999,0
1667924870872,ECE 200,042,103627,Siegel; Paul H.,9999,0,9999,0
1667924870872,ECE 200,043,103628,Sievenpiper; Daniel F.,9999,0,9999,0
1667924870872,ECE 200,044,103629,Sworder; David D.,9999,0,9999,0
1667924870872,ECE 200,045,103630,Taur; Yuan,9999,0,9999,0
1667924870872,ECE 200,046,103631,Touri; Behrouz,9999,0,9999,0
1667924870872,ECE 200,047,103632,Trivedi; Mohan M.,9999,0,9999,0
1667924870872,ECE 200,048,103633,Vasconcelos; Nuno,9999,0,9999,0
1667924870872,ECE 200,049,103634,Wang; Xiaolong,9999,0,9999,0
1667924870872,ECE 200,050,103635,Xie; Pengtao,9999,0,9999,0
1667924870872,ECE 200,051,103636,Yip; Michael,9999,0,9999,0
1667924870872,ECE 200,052,103637,Zeger; Kenneth A.,999,0,999,0
1667924870872,ECE 200,053,103638,Zhang; Xinyu,9999,0,9999,0
1667924870872,ECE 200,054,103639,Turakhia; Yatish Girish,9999,0,9999,0
1667924870872,ECE 200,055,103640,Kang; Mingu,9999,0,9999,0
1667924870872,ECE 200,056,103641,Shi; Yuanyuan,9999,0,9999,0
1667924870872,ECE 200,057,103642,Wang; Edward Jay,9999,0,9999,0
1667924870872,ECE 200,058,103643,Zheng; Yang,9999,0,9999,0
1667924871306,ECE 202,A00,103644,Kuzum; Duygu,0,0,0,0
1667924871739,ECE 212BN,A00,103646,Ng; Tse Nga,0,0,0,0
1667924872174,ECE 221,A00,111493,Staff,0,0,0,0
1667924872605,ECE 222B,A00,103647,Lomakin; Vitaliy,0,0,0,0
1667924873033,ECE 230B,A00,103648,Taur; Yuan,0,0,0,0
1667924873463,ECE 238B,A00,103649,Garay; Javier,0,0,0,0
1667924873996,ECE 240B,A00,112900,Fainman; Yeshaiahu,0,0,0,0
1667924874430,ECE 247A,A00,103650,Jokerst; Jesse Vincent,0,0,0,0
1667924874887,ECE 247B,A00,103651,Wang; Joseph,0,0,0,0
1667924875314,ECE 250,A00,103652,Siegel; Paul H.,0,0,0,0
1667924875753,ECE 251A,A00,103654,Rao; Bhaskar D.,0,0,0,0
1667924876184,ECE 257B,A00,103655,Bharadia; Dinesh,0,0,0,0
1667924876631,ECE 258A,A00,103656,Milstein; Laurence B.,0,0,0,0
1667924877063,ECE 260B,A00,103658,Kang; Mingu,0,0,0,0
1667924877502,ECE 264A,A00,103659,Galton; Ian A,0,0,0,0
1667924877945,ECE 265A,A00,103661,Gudem; Prasad S.S.,0,0,0,0
1667924878386,ECE 265D,A00,103662,Gudem; Prasad S.S.,0,0,0,0
1667924878820,ECE 268,A00,103663,Koushanfar; Farinaz,0,0,0,0
1667924879266,ECE 269,A01,103665,Pal; Piya,0,0,0,0
1667924879702,ECE 271B,A00,103666,Vasconcelos; Manuela,0,0,0,0
1667924880129,ECE 276A,A00,103667,Atanasov; Nikolay A.,0,0,0,0
1667924880554,ECE 277,A00,103668,An; Cheolhong,0,0,0,0
1667924880988,ECE 279,A00,117947,Hall; Drew A.,0,0,0,0
1667924881875,ECE 283,A00,103670,Hsueh; Tzu-Chien,0,0,0,0
1667924882309,ECE 284,A00,103671,Turakhia; Yatish Girish,0,0,0,0
1667924882733,ECE 285,A00,103672,Zheng; Yang,0,0,0,0
1667924882733,ECE 285,B00,103673,Sworder; David D.,0,0,0,0
1667924883178,ECE 287,A00,103676,Javidi; Tara,0,0,0,0
1667924883614,MATH 200B,A00,098023,Salehi Golsefidy; Alireza,15,0,15,0
1667924884043,MATH 202B,A00,098024,Rhoades; Brendon Patrick,14,0,15,1
1667924884481,MATH 203B,A00,098025,Oprea; Dragos N.,14,0,15,1
1667924884916,MATH 204B,A00,098026,Sorensen; Claus M,15,0,15,0
1667924885351,MATH 208,A00,098027,Izadi; Elham,7,0,10,3
1667924885774,MATH 209,A00,098028,Pollack; Aaron,10,0,10,0
1667924886201,MATH 211A,A00,112919,Rogalski; Daniel,10,0,10,0
1667924886633,MATH 211B,A00,112920,Seward; Brandon M.,10,0,10,0
1667924887071,MATH 218,A00,098029,Li; Bo,10,0,10,0
1667924887525,MATH 220B,A00,098030,Novak; Jonathan I,15,0,15,0
1667924887967,MATH 221A,A00,098031,Ebenfelt; Peter F,15,0,15,0
1667924888404,MATH 231B,A00,098032,Zlatos; Andrej,15,0,15,0
1667924888835,MATH 240B,A00,098033,Ni; Lei,13,0,15,2
1667924889263,MATH 243,A00,098034,Jekel; David Andrew,10,0,10,0
1667924889695,MATH 245A,A00,098035,Nie; Jiawang,6,0,15,9
1667924890128,MATH 248,A00,098036,Bejenaru; Ioan,10,0,10,0
1667924890564,MATH 250B,A00,098037,Spolaor; Luca,14,0,15,1
1667924891039,MATH 258,A00,098038,Ni; Lei,10,0,10,0
1667924891481,MATH 264B,A00,098041,Rhoades; Brendon Patrick,13,0,15,2
1667924891926,MATH 268,A00,098042,Buss; Samuel R,10,0,10,0
1667924892371,MATH 269,A00,098043,Rhoades; Brendon Patrick,10,0,10,0
1667924892803,MATH 270B,A00,098044,Li; Bo,13,0,15,2
1667924893231,MATH 272B,A00,098045,Holst; Michael J,13,0,15,2
1667924893671,MATH 273A,A00,098046,Tian; Xiaochuan,12,0,15,3
1667924894101,MATH 275,A01,098048,Tian; Xiaochuan,7,0,10,3
1667924894534,MATH 278A,A00,098049,Holst; Michael J,8,0,10,2
1667924894959,MATH 278B,A00,098050,Cloninger; Alexander,10,0,10,0
1667924895411,MATH 278C,A00,098051,Nie; Jiawang,9,0,10,1
1667924895852,MATH 280B,A00,098052,Zheng; Tianyi,12,0,15,3
1667924896286,MATH 281B,A00,098053,Bradic; Jelena,6,0,15,9
1667924896715,MATH 282B,A00,098054,Arias-Castro; Ery,2,0,15,13
1667924897153,MATH 285,A00,098055,Fitzsimmons; Patrick J,3,0,15,12
1667924897579,MATH 287B,A00,098056,Arias-Castro; Ery,9,0,15,6
1667924898029,MATH 288,A00,098057,Agarwal; Pooja,9,0,10,1
1667924898029,MATH 288,B00,098058,Zhang; Danna,9,0,10,1
1667924898029,MATH 288,C00,098059,Williams; Ruth J,10,0,10,0
1667924898457,MATH 290B,A00,098060,Roberts; Justin Deritter,14,0,15,1
1667924898880,MATH 292,A00,098061,Belmont; Eva Kinoshita,10,0,10,0
1667924899307,MATH 295,A00,098062,Suk; Andrew Hoon,48,0,50,2
1667924899745,MATH 296,A00,098063,Novak; Jonathan I,20,0,20,0
1667924900173,MATH 297,001,098064,Gamst; Anthony Collins,9997,0,9999,2
1667925411265,COGS 205,A00,101395,Chiba; Andrea,19,0,20,1
1667925411689,COGS 210B,001,101404,Greene; Deanna Jacquelyn,9998,0,9999,1
1667925411689,COGS 210B,002,101417,Xia; Haijun,9999,0,9999,0
1667925411689,COGS 210B,003,101422,Nitz; Douglas A.,9999,0,9999,0
1667925411689,COGS 210B,004,101423,Hollan; James D.,9998,0,9999,1
1667925411689,COGS 210B,005,101424,Deak; Gedeon O.,9999,0,9999,0
1667925411689,COGS 210B,006,101425,Rossano; Federico,9999,0,9999,0
1667925412113,COGS 211B,A00,101427,Coulson; Seana M,9997,0,9999,2
1667925412545,COGS 220,A00,101428,Hollan; James D.,0,0,25,25
1667925412982,COGS 229,A00,101429,Dow; Steven P,19,0,25,6
1667925413409,COGS 230,A00,101430,Klemmer; Scott R,13,0,17,4
1667925413845,COGS 234,A00,101431,Xia; Haijun,11,0,25,14
1667925414273,COGS 260,A00,101432,Kiyonaga; Anastasia,19,0,25,6
1667925414273,COGS 260,B00,101433,Kirsh; David Joel,18,0,25,7
1667925414705,CSE 202,A00,102371,Impagliazzo; Russell,0,0,0,0
1667925415146,CSE 203B,A01,102373,Cheng; Chung Kuan,0,0,0,0
1667925415568,CSE 208,A00,102374,Micciancio; Daniele,0,0,0,0
1667925416025,CSE 209A,A00,112895,Impagliazzo; Russell,0,0,15,15
1667925416466,CSE 209B,A00,108005,Bellare; Mihir,0,0,0,0
1667925416893,CSE 210,A00,113163,Coblenz; Michael J,0,0,0,0
1667925417326,CSE 219,A00,106111,Dow; Steven P,0,0,20,20
1667925417772,CSE 221,A00,102376,Voelker; Geoffrey M.,0,0,0,0
1667925418204,CSE 224,A01,102378,Porter; George M,0,0,0,0
1667925418633,CSE 229A,A00,102379,Savage; Stefan,0,0,0,0
1667925419059,CSE 229C,A00,102380,Munyaka; Imani N. S.,0,0,0,0
1667925419499,CSE 232B,A00,102382,Deutsch; Alin Bernard,0,0,0,0
1667925419936,CSE 234,A01,112904,Kumar; Arun Kumar,0,0,0,0
1667925420365,CSE 237A,A00,102383,Rosing; Tajana Simunic,0,0,0,0
1667925420792,CSE 239A,A00,102384,Deutsch; Alin Bernard,0,0,0,0
1667925421264,CSE 239B,A00,102385,Polikarpova; Nadezhda,0,0,0,0
1667925421697,CSE 240A,A00,102386,Pannuto; Patrick William,0,0,0,0
1667925422124,CSE 240B,A00,102387,Zhao; Jishen,0,0,0,0
1667925422554,CSE 241A,A00,106406,Kang; Mingu,0,0,0,0
1667925422985,CSE 249B,A00,102388,Kahng; Andrew Byun,0,0,8,8
1667925423419,CSE 251B,A01,102392,Cottrell; Garrison W,0,0,0,0
1667925423419,CSE 251B,A02,102393,Cottrell; Garrison W,0,0,0,0
1667925423843,CSE 252B,A00,102394,Ochoa; Benjamin Lawrence,0,0,0,0
1667925424279,CSE 257,A01,102396,Gao; Sicun,0,0,0,0
1667925424707,CSE 272,A00,102397,Li; Tzumao,0,0,0,0
1667925425169,CSE 274,A00,111323,Chern; Albert Ren-Haur,0,0,0,0
1667925425599,CSE 282,A00,102398,Pevzner; Pavel Arkadjevich,0,0,0,0
1667925426029,CSE 284,A00,114175,Gymrek; Melissa Ann,0,0,0,0
1667925426461,CSE 290,A00,102399,Chandraker; Manmohan Krishna,0,0,0,0
1667925426461,CSE 290,B00,102400,Vaccaro; Kristen Marie,0,0,25,25
1667925426461,CSE 290,C00,102414,Pannuto; Patrick William,0,0,25,25
1667925426461,CSE 290,D00,102427,Pevzner; Pavel Arkadjevich,0,0,0,0
1667925426461,CSE 290,E00,102429,Zhao; Jishen,0,0,0,0
1667925426461,CSE 290,F00,102436,Tullsen; Dean Michael,0,0,0,0
1667925426461,CSE 290,G00,102440,Christensen; Henrik I,0,0,20,20
1667925426893,CSE 291,A00,102443,Su; Hao,0,0,0,0
1667925426893,CSE 291,B00,102448,Polikarpova; Nadezhda,0,0,0,0
1667925426893,CSE 291,C00,102453,Vaccaro; Kristen Marie,0,0,0,0
1667925426893,CSE 291,D00,111343,Savage; Stefan,0,0,0,0
1667925426893,CSE 291,E00,116474,Claffy; Kimberly Claire,0,0,0,0
1667925426893,CSE 291,F00,116479,Pasquale; Joseph,0,0,0,0
1667925427329,CSE 293,001,119111,Bafna; Vineet,9999,0,9999,0
1667925427329,CSE 293,002,119118,Bellare; Mihir,9999,0,9999,0
1667925427329,CSE 293,003,119122,Berg-Kirkpatrick; Taylor D,9999,0,9999,0
1667925427329,CSE 293,004,119135,Christensen; Henrik I,9999,0,9999,0
1667925427329,CSE 293,005,119142,Cottrell; Garrison W,9999,0,9999,0
1667925427329,CSE 293,006,119146,Deutsch; Alin Bernard,9999,0,9999,0
1667925427329,CSE 293,007,119159,Esmaeilzadeh; Hadi,9999,0,9999,0
1667925427329,CSE 293,008,119166,Freund; Yoav,9999,0,9999,0
1667925427329,CSE 293,009,119170,Griswold; William G.,9999,0,9999,0
1667925427329,CSE 293,010,119183,Gymrek; Melissa Ann,9999,0,9999,0
1667925427329,CSE 293,011,119190,Heninger; Nadia A,9999,0,9999,0
1667925427329,CSE 293,012,119230,Impagliazzo; Russell,9999,0,9999,0
1667925427329,CSE 293,013,119232,Jhala; Ranjit,9999,0,9999,0
1667925427329,CSE 293,014,119233,Kahng; Andrew Byun,9999,0,9999,0
1667925427329,CSE 293,015,119298,Kane; Daniel Mertz,9999,0,9999,0
1667925427329,CSE 293,016,119299,Kriegman; David J,9999,0,9999,0
1667925427329,CSE 293,017,119300,Kumar; Arun Kumar,9999,0,9999,0
1667925427329,CSE 293,018,119301,Lerner; Sorin,9999,0,9999,0
1667925427329,CSE 293,019,119302,Lovett; Shachar,9999,0,9999,0
1667925427329,CSE 293,020,119303,McAuley; Julian John,9999,0,9999,0
1667925427329,CSE 293,021,119304,Micciancio; Daniele,9999,0,9999,0
1667925427329,CSE 293,022,119367,Orailoglu; Alex,9999,0,9999,0
1667925427329,CSE 293,023,119382,Paturi; Ramamohan,9999,0,9999,0
1667925427329,CSE 293,024,119404,Polikarpova; Nadezhda,9999,0,9999,0
1667925427329,CSE 293,025,119406,Politz; Joseph Gibbs,9999,0,9999,0
1667925427329,CSE 293,026,119411,Porter; George M,9999,0,9999,0
1667925427329,CSE 293,027,119414,Porter; Leonard Emerson,9999,0,9999,0
1667925427329,CSE 293,028,119416,Ramamoorthi; Ravi,9999,0,9999,0
1667925427329,CSE 293,029,119417,Sahoo; Debashis,9999,0,9999,0
1667925427329,CSE 293,030,119420,Saul; Lawrence,9999,0,9999,0
1667925427329,CSE 293,031,119421,Savage; Stefan,9999,0,9999,0
1667925427329,CSE 293,032,119425,Schulze; Jurgen P.,9999,0,9999,0
1667925427329,CSE 293,033,119426,Snoeren; Alex C.,9999,0,9999,0
1667925427329,CSE 293,034,119428,Shang; Jingbo,9999,0,9999,0
1667925427329,CSE 293,035,119430,Stefan; Deian,9999,0,9999,0
1667925427329,CSE 293,036,119431,Su; Hao,9999,0,9999,0
1667925427329,CSE 293,037,119433,Swanson; Steven James,9999,0,9999,0
1667925427329,CSE 293,038,119435,Tullsen; Dean Michael,9999,0,9999,0
1667925427329,CSE 293,039,119483,Voelker; Geoffrey M.,9999,0,9999,0
1667925427329,CSE 293,040,119537,Zhao; Jishen,9999,0,9999,0
1667925427329,CSE 293,041,119538,Zhou; Yuan-Yuan,9999,0,9999,0
1667925427329,CSE 293,042,119539,Gao; Sicun,9999,0,9999,0
1667925427329,CSE 293,043,119540,Weibel; Nadir,9999,0,9999,0
1667925427329,CSE 293,044,119541,Gupta; Rajesh K.,9999,0,9999,0
1667925427756,CSE 294,A00,102459,Voelker; Geoffrey M.,0,0,0,0
1667925427756,CSE 294,B00,111322,Orailoglu; Alex,0,0,0,0
1667925428185,DSE 201,A00,096914,Deutsch; Alin Bernard,30,0,30,0
1667925428615,DSE 210,A00,096915,Dasgupta; Sanjoy,30,0,30,0
1667925429043,DSE 260A,A00,096916,Altintas De Callaf; Ilkay,30,0,30,0
1667925429505,ECE 200,001,103586,Antipa; Nicholas A,9999,0,9999,0
1667925429505,ECE 200,002,103587,Atanasov; Nikolay A.,9999,0,9999,0
1667925429505,ECE 200,003,103588,Bharadia; Dinesh,9999,0,9999,0
1667925429505,ECE 200,004,103589,Cheng; Chung Kuan,9999,0,9999,0
1667925429505,ECE 200,005,103590,Cosman; Pamela C.,9999,0,9999,0
1667925429505,ECE 200,006,103591,Dayeh; Shadi Ahmad,9999,0,9999,0
1667925429505,ECE 200,007,103592,Fainman; Yeshaiahu,9999,0,9999,0
1667925429505,ECE 200,008,103593,Ford; Joseph Earl,9999,0,9999,0
1667925429505,ECE 200,009,103594,Franceschetti; Massimo,9999,0,9999,0
1667925429505,ECE 200,010,103595,Fullerton; Eric E,9999,0,9999,0
1667925429505,ECE 200,011,103596,Galton; Ian A,9999,0,9999,0
1667925429505,ECE 200,012,103597,Gilja; Vikash,9999,0,9999,0
1667925429505,ECE 200,013,103598,Hall; Drew A.,9999,0,9999,0
1667925429505,ECE 200,014,103599,Hsueh; Tzu-Chien,9999,0,9999,0
1667925429505,ECE 200,015,103600,Javidi; Tara,9999,0,9999,0
1667925429505,ECE 200,016,103601,Kahng; Andrew Byun,9999,0,9999,0
1667925429505,ECE 200,017,103602,Kim; Young-Han,9999,0,9999,0
1667925429505,ECE 200,018,103603,Koushanfar; Farinaz,9999,0,9999,0
1667925429505,ECE 200,019,103604,Kuzum; Duygu,9999,0,9999,0
1667925429505,ECE 200,020,103605,Le; Hanh-Phuc,9999,0,9999,0
1667925429505,ECE 200,021,103606,Lin; Bill,9999,0,9999,0
1667925429505,ECE 200,022,103607,Liu; Zhaowei,9998,0,9999,1
1667925429505,ECE 200,023,103608,Lo; Yu-Hwa,9999,0,9999,0
1667925429505,ECE 200,024,103609,Lomakin; Vitaliy,9999,0,9999,0
1667925429505,ECE 200,025,103610,Mercier; Patrick Philip,9999,0,9999,0
1667925429505,ECE 200,026,103611,Meyer; Florian,9999,0,9999,0
1667925429505,ECE 200,027,103612,Milstein; Laurence B.,9999,0,9999,0
1667925429505,ECE 200,028,103613,Mir Arabbaygi; Siavash,9999,0,9999,0
1667925429505,ECE 200,029,103614,Mookherjea; Shayan,9999,0,9999,0
1667925429505,ECE 200,030,103615,Morris; Karcher William,9999,0,9999,0
1667925429505,ECE 200,031,103616,Ng; Tse Nga,9999,0,9999,0
1667925429505,ECE 200,032,103617,Nguyen; Truong Quang,9999,0,9999,0
1667925429505,ECE 200,033,103618,Nomura; Kenji,9999,0,9999,0
1667925429505,ECE 200,034,103619,Orlitsky; Alon,9999,0,9999,0
1667925429505,ECE 200,035,103620,Pal; Piya,9999,0,9999,0
1667925429505,ECE 200,036,103621,Papen; George C.,9999,0,9999,0
1667925429505,ECE 200,037,103622,Radic; Stojan,9999,0,9999,0
1667925429505,ECE 200,038,103623,Rao; Bhaskar D.,9999,0,9999,0
1667925429505,ECE 200,039,103624,Rao; Ramesh R,9999,0,9999,0
1667925429505,ECE 200,040,103625,Rebeiz; Gabriel,9999,0,9999,0
1667925429505,ECE 200,041,103626,Sanford; John R,9999,0,9999,0
1667925429505,ECE 200,042,103627,Siegel; Paul H.,9999,0,9999,0
1667925429505,ECE 200,043,103628,Sievenpiper; Daniel F.,9999,0,9999,0
1667925429505,ECE 200,044,103629,Sworder; David D.,9999,0,9999,0
1667925429505,ECE 200,045,103630,Taur; Yuan,9999,0,9999,0
1667925429505,ECE 200,046,103631,Touri; Behrouz,9999,0,9999,0
1667925429505,ECE 200,047,103632,Trivedi; Mohan M.,9999,0,9999,0
1667925429505,ECE 200,048,103633,Vasconcelos; Nuno,9999,0,9999,0
1667925429505,ECE 200,049,103634,Wang; Xiaolong,9999,0,9999,0
1667925429505,ECE 200,050,103635,Xie; Pengtao,9999,0,9999,0
1667925429505,ECE 200,051,103636,Yip; Michael,9999,0,9999,0
1667925429505,ECE 200,052,103637,Zeger; Kenneth A.,999,0,999,0
1667925429505,ECE 200,053,103638,Zhang; Xinyu,9999,0,9999,0
1667925429505,ECE 200,054,103639,Turakhia; Yatish Girish,9999,0,9999,0
1667925429505,ECE 200,055,103640,Kang; Mingu,9999,0,9999,0
1667925429505,ECE 200,056,103641,Shi; Yuanyuan,9999,0,9999,0
1667925429505,ECE 200,057,103642,Wang; Edward Jay,9999,0,9999,0
1667925429505,ECE 200,058,103643,Zheng; Yang,9999,0,9999,0
1667925429964,ECE 202,A00,103644,Kuzum; Duygu,0,0,0,0
1667925430388,ECE 212BN,A00,103646,Ng; Tse Nga,0,0,0,0
1667925430820,ECE 221,A00,111493,Staff,0,0,0,0
1667925431266,ECE 222B,A00,103647,Lomakin; Vitaliy,0,0,0,0
1667925431688,ECE 230B,A00,103648,Taur; Yuan,0,0,0,0
1667925432110,ECE 238B,A00,103649,Garay; Javier,0,0,0,0
1667925432562,ECE 240B,A00,112900,Fainman; Yeshaiahu,0,0,0,0
1667925433003,ECE 247A,A00,103650,Jokerst; Jesse Vincent,0,0,0,0
1667925433430,ECE 247B,A00,103651,Wang; Joseph,0,0,0,0
1667925433856,ECE 250,A00,103652,Siegel; Paul H.,0,0,0,0
1667925434283,ECE 251A,A00,103654,Rao; Bhaskar D.,0,0,0,0
1667925434714,ECE 257B,A00,103655,Bharadia; Dinesh,0,0,0,0
1667925435145,ECE 258A,A00,103656,Milstein; Laurence B.,0,0,0,0
1667925435578,ECE 260B,A00,103658,Kang; Mingu,0,0,0,0
1667925436027,ECE 264A,A00,103659,Galton; Ian A,0,0,0,0
1667925436460,ECE 265A,A00,103661,Gudem; Prasad S.S.,0,0,0,0
1667925436890,ECE 265D,A00,103662,Gudem; Prasad S.S.,0,0,0,0
1667925437314,ECE 268,A00,103663,Koushanfar; Farinaz,0,0,0,0
1667925437747,ECE 269,A01,103665,Pal; Piya,0,0,0,0
1667925438173,ECE 271B,A00,103666,Vasconcelos; Manuela,0,0,0,0
1667925438614,ECE 276A,A00,103667,Atanasov; Nikolay A.,0,0,0,0
1667925439052,ECE 277,A00,103668,An; Cheolhong,0,0,0,0
1667925439480,ECE 279,A00,117947,Hall; Drew A.,0,0,0,0
1667925440351,ECE 283,A00,103670,Hsueh; Tzu-Chien,0,0,0,0
1667925440783,ECE 284,A00,103671,Turakhia; Yatish Girish,0,0,0,0
1667925441228,ECE 285,A00,103672,Zheng; Yang,0,0,0,0
1667925441228,ECE 285,B00,103673,Sworder; David D.,0,0,0,0
1667925441655,ECE 287,A00,103676,Javidi; Tara,0,0,0,0
1667925442078,MATH 200B,A00,098023,Salehi Golsefidy; Alireza,15,0,15,0
1667925442534,MATH 202B,A00,098024,Rhoades; Brendon Patrick,14,0,15,1
1667925442962,MATH 203B,A00,098025,Oprea; Dragos N.,14,0,15,1
1667925443408,MATH 204B,A00,098026,Sorensen; Claus M,15,0,15,0
1667925443835,MATH 208,A00,098027,Izadi; Elham,7,0,10,3
1667925444270,MATH 209,A00,098028,Pollack; Aaron,10,0,10,0
1667925444696,MATH 211A,A00,112919,Rogalski; Daniel,10,0,10,0
1667925445127,MATH 211B,A00,112920,Seward; Brandon M.,10,0,10,0
1667925445552,MATH 218,A00,098029,Li; Bo,10,0,10,0
1667925445983,MATH 220B,A00,098030,Novak; Jonathan I,15,0,15,0
1667925446420,MATH 221A,A00,098031,Ebenfelt; Peter F,15,0,15,0
1667925446875,MATH 231B,A00,098032,Zlatos; Andrej,15,0,15,0
1667925447300,MATH 240B,A00,098033,Ni; Lei,13,0,15,2
1667925447728,MATH 243,A00,098034,Jekel; David Andrew,10,0,10,0
1667925448161,MATH 245A,A00,098035,Nie; Jiawang,6,0,15,9
1667925448601,MATH 248,A00,098036,Bejenaru; Ioan,10,0,10,0
1667925449033,MATH 250B,A00,098037,Spolaor; Luca,14,0,15,1
1667925449538,MATH 258,A00,098038,Ni; Lei,10,0,10,0
1667925449964,MATH 264B,A00,098041,Rhoades; Brendon Patrick,13,0,15,2
1667925450388,MATH 268,A00,098042,Buss; Samuel R,10,0,10,0
1667925450817,MATH 269,A00,098043,Rhoades; Brendon Patrick,10,0,10,0
1667925451242,MATH 270B,A00,098044,Li; Bo,13,0,15,2
1667925451674,MATH 272B,A00,098045,Holst; Michael J,13,0,15,2
1667925452105,MATH 273A,A00,098046,Tian; Xiaochuan,12,0,15,3
1667925452529,MATH 275,A01,098048,Tian; Xiaochuan,7,0,10,3
1667925452974,MATH 278A,A00,098049,Holst; Michael J,8,0,10,2
1667925453400,MATH 278B,A00,098050,Cloninger; Alexander,10,0,10,0
1667925453853,MATH 278C,A00,098051,Nie; Jiawang,9,0,10,1
1667925454285,MATH 280B,A00,098052,Zheng; Tianyi,12,0,15,3
1667925454721,MATH 281B,A00,098053,Bradic; Jelena,6,0,15,9
1667925455170,MATH 282B,A00,098054,Arias-Castro; Ery,2,0,15,13
1667925455598,MATH 285,A00,098055,Fitzsimmons; Patrick J,3,0,15,12
1667925456027,MATH 287B,A00,098056,Arias-Castro; Ery,9,0,15,6
1667925456460,MATH 288,A00,098057,Agarwal; Pooja,9,0,10,1
1667925456460,MATH 288,B00,098058,Zhang; Danna,9,0,10,1
1667925456460,MATH 288,C00,098059,Williams; Ruth J,10,0,10,0
1667925456888,MATH 290B,A00,098060,Roberts; Justin Deritter,14,0,15,1
1667925457347,MATH 292,A00,098061,Belmont; Eva Kinoshita,10,0,10,0
1667925457777,MATH 295,A00,098062,Suk; Andrew Hoon,48,0,50,2
1667925458210,MATH 296,A00,098063,Novak; Jonathan I,20,0,20,0
1667925458636,MATH 297,001,098064,Gamst; Anthony Collins,9997,0,9999,2
1667925970279,COGS 205,A00,101395,Chiba; Andrea,19,0,20,1
1667925970723,COGS 210B,001,101404,Greene; Deanna Jacquelyn,9998,0,9999,1
1667925970723,COGS 210B,002,101417,Xia; Haijun,9999,0,9999,0
1667925970723,COGS 210B,003,101422,Nitz; Douglas A.,9999,0,9999,0
1667925970723,COGS 210B,004,101423,Hollan; James D.,9998,0,9999,1
1667925970723,COGS 210B,005,101424,Deak; Gedeon O.,9999,0,9999,0
1667925970723,COGS 210B,006,101425,Rossano; Federico,9999,0,9999,0
1667925971160,COGS 211B,A00,101427,Coulson; Seana M,9997,0,9999,2
1667925971604,COGS 220,A00,101428,Hollan; James D.,0,0,25,25
1667925972057,COGS 229,A00,101429,Dow; Steven P,19,0,25,6
1667925972484,COGS 230,A00,101430,Klemmer; Scott R,13,0,17,4
1667925972913,COGS 234,A00,101431,Xia; Haijun,11,0,25,14
1667925973349,COGS 260,A00,101432,Kiyonaga; Anastasia,19,0,25,6
1667925973349,COGS 260,B00,101433,Kirsh; David Joel,18,0,25,7
1667925973779,CSE 202,A00,102371,Impagliazzo; Russell,0,0,0,0
1667925974202,CSE 203B,A01,102373,Cheng; Chung Kuan,0,0,0,0
1667925974629,CSE 208,A00,102374,Micciancio; Daniele,0,0,0,0
1667925975067,CSE 209A,A00,112895,Impagliazzo; Russell,0,0,15,15
1667925975517,CSE 209B,A00,108005,Bellare; Mihir,0,0,0,0
1667925975943,CSE 210,A00,113163,Coblenz; Michael J,0,0,0,0
1667925976386,CSE 219,A00,106111,Dow; Steven P,0,0,20,20
1667925976814,CSE 221,A00,102376,Voelker; Geoffrey M.,0,0,0,0
1667925977255,CSE 224,A01,102378,Porter; George M,0,0,0,0
1667925977693,CSE 229A,A00,102379,Savage; Stefan,0,0,0,0
1667925978128,CSE 229C,A00,102380,Munyaka; Imani N. S.,0,0,0,0
1667925978595,CSE 232B,A00,102382,Deutsch; Alin Bernard,0,0,0,0
1667925979034,CSE 234,A01,112904,Kumar; Arun Kumar,0,0,0,0
1667925979461,CSE 237A,A00,102383,Rosing; Tajana Simunic,0,0,0,0
1667925979901,CSE 239A,A00,102384,Deutsch; Alin Bernard,0,0,0,0
1667925980324,CSE 239B,A00,102385,Polikarpova; Nadezhda,0,0,0,0
1667925980757,CSE 240A,A00,102386,Pannuto; Patrick William,0,0,0,0
1667925981189,CSE 240B,A00,102387,Zhao; Jishen,0,0,0,0
1667925981692,CSE 241A,A00,106406,Kang; Mingu,0,0,0,0
1667925982139,CSE 249B,A00,102388,Kahng; Andrew Byun,0,0,8,8
1667925982575,CSE 251B,A01,102392,Cottrell; Garrison W,0,0,0,0
1667925982575,CSE 251B,A02,102393,Cottrell; Garrison W,0,0,0,0
1667925983000,CSE 252B,A00,102394,Ochoa; Benjamin Lawrence,0,0,0,0
1667925983426,CSE 257,A01,102396,Gao; Sicun,0,0,0,0
1667925983881,CSE 272,A00,102397,Li; Tzumao,0,0,0,0
1667925984317,CSE 274,A00,111323,Chern; Albert Ren-Haur,0,0,0,0
1667925984747,CSE 282,A00,102398,Pevzner; Pavel Arkadjevich,0,0,0,0
1667925985180,CSE 284,A00,114175,Gymrek; Melissa Ann,0,0,0,0
1667925985613,CSE 290,A00,102399,Chandraker; Manmohan Krishna,0,0,0,0
1667925985613,CSE 290,B00,102400,Vaccaro; Kristen Marie,0,0,25,25
1667925985613,CSE 290,C00,102414,Pannuto; Patrick William,0,0,25,25
1667925985613,CSE 290,D00,102427,Pevzner; Pavel Arkadjevich,0,0,0,0
1667925985613,CSE 290,E00,102429,Zhao; Jishen,0,0,0,0
1667925985613,CSE 290,F00,102436,Tullsen; Dean Michael,0,0,0,0
1667925985613,CSE 290,G00,102440,Christensen; Henrik I,0,0,20,20
1667925986042,CSE 291,A00,102443,Su; Hao,0,0,0,0
1667925986042,CSE 291,B00,102448,Polikarpova; Nadezhda,0,0,0,0
1667925986042,CSE 291,C00,102453,Vaccaro; Kristen Marie,0,0,0,0
1667925986042,CSE 291,D00,111343,Savage; Stefan,0,0,0,0
1667925986042,CSE 291,E00,116474,Claffy; Kimberly Claire,0,0,0,0
1667925986042,CSE 291,F00,116479,Pasquale; Joseph,0,0,0,0
1667925986518,CSE 293,001,119111,Bafna; Vineet,9999,0,9999,0
1667925986518,CSE 293,002,119118,Bellare; Mihir,9999,0,9999,0
1667925986518,CSE 293,003,119122,Berg-Kirkpatrick; Taylor D,9999,0,9999,0
1667925986518,CSE 293,004,119135,Christensen; Henrik I,9999,0,9999,0
1667925986518,CSE 293,005,119142,Cottrell; Garrison W,9999,0,9999,0
1667925986518,CSE 293,006,119146,Deutsch; Alin Bernard,9999,0,9999,0
1667925986518,CSE 293,007,119159,Esmaeilzadeh; Hadi,9999,0,9999,0
1667925986518,CSE 293,008,119166,Freund; Yoav,9999,0,9999,0
1667925986518,CSE 293,009,119170,Griswold; William G.,9999,0,9999,0
1667925986518,CSE 293,010,119183,Gymrek; Melissa Ann,9999,0,9999,0
1667925986518,CSE 293,011,119190,Heninger; Nadia A,9999,0,9999,0
1667925986518,CSE 293,012,119230,Impagliazzo; Russell,9999,0,9999,0
1667925986518,CSE 293,013,119232,Jhala; Ranjit,9999,0,9999,0
1667925986518,CSE 293,014,119233,Kahng; Andrew Byun,9999,0,9999,0
1667925986518,CSE 293,015,119298,Kane; Daniel Mertz,9999,0,9999,0
1667925986518,CSE 293,016,119299,Kriegman; David J,9999,0,9999,0
1667925986518,CSE 293,017,119300,Kumar; Arun Kumar,9999,0,9999,0
1667925986518,CSE 293,018,119301,Lerner; Sorin,9999,0,9999,0
1667925986518,CSE 293,019,119302,Lovett; Shachar,9999,0,9999,0
1667925986518,CSE 293,020,119303,McAuley; Julian John,9999,0,9999,0
1667925986518,CSE 293,021,119304,Micciancio; Daniele,9999,0,9999,0
1667925986518,CSE 293,022,119367,Orailoglu; Alex,9999,0,9999,0
1667925986518,CSE 293,023,119382,Paturi; Ramamohan,9999,0,9999,0
1667925986518,CSE 293,024,119404,Polikarpova; Nadezhda,9999,0,9999,0
1667925986518,CSE 293,025,119406,Politz; Joseph Gibbs,9999,0,9999,0
1667925986518,CSE 293,026,119411,Porter; George M,9999,0,9999,0
1667925986518,CSE 293,027,119414,Porter; Leonard Emerson,9999,0,9999,0
1667925986518,CSE 293,028,119416,Ramamoorthi; Ravi,9999,0,9999,0
1667925986518,CSE 293,029,119417,Sahoo; Debashis,9999,0,9999,0
1667925986518,CSE 293,030,119420,Saul; Lawrence,9999,0,9999,0
1667925986518,CSE 293,031,119421,Savage; Stefan,9999,0,9999,0
1667925986518,CSE 293,032,119425,Schulze; Jurgen P.,9999,0,9999,0
1667925986518,CSE 293,033,119426,Snoeren; Alex C.,9999,0,9999,0
1667925986518,CSE 293,034,119428,Shang; Jingbo,9999,0,9999,0
1667925986518,CSE 293,035,119430,Stefan; Deian,9999,0,9999,0
1667925986518,CSE 293,036,119431,Su; Hao,9999,0,9999,0
1667925986518,CSE 293,037,119433,Swanson; Steven James,9999,0,9999,0
1667925986518,CSE 293,038,119435,Tullsen; Dean Michael,9999,0,9999,0
1667925986518,CSE 293,039,119483,Voelker; Geoffrey M.,9999,0,9999,0
1667925986518,CSE 293,040,119537,Zhao; Jishen,9999,0,9999,0
1667925986518,CSE 293,041,119538,Zhou; Yuan-Yuan,9999,0,9999,0
1667925986518,CSE 293,042,119539,Gao; Sicun,9999,0,9999,0
1667925986518,CSE 293,043,119540,Weibel; Nadir,9999,0,9999,0
1667925986518,CSE 293,044,119541,Gupta; Rajesh K.,9999,0,9999,0
1667925986944,CSE 294,A00,102459,Voelker; Geoffrey M.,0,0,0,0
1667925986944,CSE 294,B00,111322,Orailoglu; Alex,0,0,0,0
1667925987374,DSE 201,A00,096914,Deutsch; Alin Bernard,30,0,30,0
1667925987810,DSE 210,A00,096915,Dasgupta; Sanjoy,30,0,30,0
1667925988250,DSE 260A,A00,096916,Altintas De Callaf; Ilkay,30,0,30,0
1667925988726,ECE 200,001,103586,Antipa; Nicholas A,9999,0,9999,0
1667925988726,ECE 200,002,103587,Atanasov; Nikolay A.,9999,0,9999,0
1667925988726,ECE 200,003,103588,Bharadia; Dinesh,9999,0,9999,0
1667925988726,ECE 200,004,103589,Cheng; Chung Kuan,9999,0,9999,0
1667925988726,ECE 200,005,103590,Cosman; Pamela C.,9999,0,9999,0
1667925988726,ECE 200,006,103591,Dayeh; Shadi Ahmad,9999,0,9999,0
1667925988726,ECE 200,007,103592,Fainman; Yeshaiahu,9999,0,9999,0
1667925988726,ECE 200,008,103593,Ford; Joseph Earl,9999,0,9999,0
1667925988726,ECE 200,009,103594,Franceschetti; Massimo,9999,0,9999,0
1667925988726,ECE 200,010,103595,Fullerton; Eric E,9999,0,9999,0
1667925988726,ECE 200,011,103596,Galton; Ian A,9999,0,9999,0
1667925988726,ECE 200,012,103597,Gilja; Vikash,9999,0,9999,0
1667925988726,ECE 200,013,103598,Hall; Drew A.,9999,0,9999,0
1667925988726,ECE 200,014,103599,Hsueh; Tzu-Chien,9999,0,9999,0
1667925988726,ECE 200,015,103600,Javidi; Tara,9999,0,9999,0
1667925988726,ECE 200,016,103601,Kahng; Andrew Byun,9999,0,9999,0
1667925988726,ECE 200,017,103602,Kim; Young-Han,9999,0,9999,0
1667925988726,ECE 200,018,103603,Koushanfar; Farinaz,9999,0,9999,0
1667925988726,ECE 200,019,103604,Kuzum; Duygu,9999,0,9999,0
1667925988726,ECE 200,020,103605,Le; Hanh-Phuc,9999,0,9999,0
1667925988726,ECE 200,021,103606,Lin; Bill,9999,0,9999,0
1667925988726,ECE 200,022,103607,Liu; Zhaowei,9998,0,9999,1
1667925988726,ECE 200,023,103608,Lo; Yu-Hwa,9999,0,9999,0
1667925988726,ECE 200,024,103609,Lomakin; Vitaliy,9999,0,9999,0
1667925988726,ECE 200,025,103610,Mercier; Patrick Philip,9999,0,9999,0
1667925988726,ECE 200,026,103611,Meyer; Florian,9999,0,9999,0
1667925988726,ECE 200,027,103612,Milstein; Laurence B.,9999,0,9999,0
1667925988726,ECE 200,028,103613,Mir Arabbaygi; Siavash,9999,0,9999,0
1667925988726,ECE 200,029,103614,Mookherjea; Shayan,9999,0,9999,0
1667925988726,ECE 200,030,103615,Morris; Karcher William,9999,0,9999,0
1667925988726,ECE 200,031,103616,Ng; Tse Nga,9999,0,9999,0
1667925988726,ECE 200,032,103617,Nguyen; Truong Quang,9999,0,9999,0
1667925988726,ECE 200,033,103618,Nomura; Kenji,9999,0,9999,0
1667925988726,ECE 200,034,103619,Orlitsky; Alon,9999,0,9999,0
1667925988726,ECE 200,035,103620,Pal; Piya,9999,0,9999,0
1667925988726,ECE 200,036,103621,Papen; George C.,9999,0,9999,0
1667925988726,ECE 200,037,103622,Radic; Stojan,9999,0,9999,0
1667925988726,ECE 200,038,103623,Rao; Bhaskar D.,9999,0,9999,0
1667925988726,ECE 200,039,103624,Rao; Ramesh R,9999,0,9999,0
1667925988726,ECE 200,040,103625,Rebeiz; Gabriel,9999,0,9999,0
1667925988726,ECE 200,041,103626,Sanford; John R,9999,0,9999,0
1667925988726,ECE 200,042,103627,Siegel; Paul H.,9999,0,9999,0
1667925988726,ECE 200,043,103628,Sievenpiper; Daniel F.,9999,0,9999,0
1667925988726,ECE 200,044,103629,Sworder; David D.,9999,0,9999,0
1667925988726,ECE 200,045,103630,Taur; Yuan,9999,0,9999,0
1667925988726,ECE 200,046,103631,Touri; Behrouz,9999,0,9999,0
1667925988726,ECE 200,047,103632,Trivedi; Mohan M.,9999,0,9999,0
1667925988726,ECE 200,048,103633,Vasconcelos; Nuno,9999,0,9999,0
1667925988726,ECE 200,049,103634,Wang; Xiaolong,9999,0,9999,0
1667925988726,ECE 200,050,103635,Xie; Pengtao,9999,0,9999,0
1667925988726,ECE 200,051,103636,Yip; Michael,9999,0,9999,0
1667925988726,ECE 200,052,103637,Zeger; Kenneth A.,999,0,999,0
1667925988726,ECE 200,053,103638,Zhang; Xinyu,9999,0,9999,0
1667925988726,ECE 200,054,103639,Turakhia; Yatish Girish,9999,0,9999,0
1667925988726,ECE 200,055,103640,Kang; Mingu,9999,0,9999,0
1667925988726,ECE 200,056,103641,Shi; Yuanyuan,9999,0,9999,0
1667925988726,ECE 200,057,103642,Wang; Edward Jay,9999,0,9999,0
1667925988726,ECE 200,058,103643,Zheng; Yang,9999,0,9999,0
1667925989167,ECE 202,A00,103644,Kuzum; Duygu,0,0,0,0
1667925989593,ECE 212BN,A00,103646,Ng; Tse Nga,0,0,0,0
1667925990025,ECE 221,A00,111493,Staff,0,0,0,0
1667925990485,ECE 222B,A00,103647,Lomakin; Vitaliy,0,0,0,0
1667925990909,ECE 230B,A00,103648,Taur; Yuan,0,0,0,0
1667925991355,ECE 238B,A00,103649,Garay; Javier,0,0,0,0
1667925991780,ECE 240B,A00,112900,Fainman; Yeshaiahu,0,0,0,0
1667925992221,ECE 247A,A00,103650,Jokerst; Jesse Vincent,0,0,0,0
1667925992643,ECE 247B,A00,103651,Wang; Joseph,0,0,0,0
1667925993076,ECE 250,A00,103652,Siegel; Paul H.,0,0,0,0
1667925993512,ECE 251A,A00,103654,Rao; Bhaskar D.,0,0,0,0
1667925993941,ECE 257B,A00,103655,Bharadia; Dinesh,0,0,0,0
1667925994372,ECE 258A,A00,103656,Milstein; Laurence B.,0,0,0,0
1667925994796,ECE 260B,A00,103658,Kang; Mingu,0,0,0,0
1667925995231,ECE 264A,A00,103659,Galton; Ian A,0,0,0,0
1667925995660,ECE 265A,A00,103661,Gudem; Prasad S.S.,0,0,0,0
1667925996085,ECE 265D,A00,103662,Gudem; Prasad S.S.,0,0,0,0
1667925996519,ECE 268,A00,103663,Koushanfar; Farinaz,0,0,0,0
1667925996948,ECE 269,A01,103665,Pal; Piya,0,0,0,0
1667925997377,ECE 271B,A00,103666,Vasconcelos; Manuela,0,0,0,0
1667925997819,ECE 276A,A00,103667,Atanasov; Nikolay A.,0,0,0,0
1667925998241,ECE 277,A00,103668,An; Cheolhong,0,0,0,0
1667925998678,ECE 279,A00,117947,Hall; Drew A.,0,0,0,0
1667925999527,ECE 283,A00,103670,Hsueh; Tzu-Chien,0,0,0,0
1667925999960,ECE 284,A00,103671,Turakhia; Yatish Girish,0,0,0,0
1667926000388,ECE 285,A00,103672,Zheng; Yang,0,0,0,0
1667926000388,ECE 285,B00,103673,Sworder; David D.,0,0,0,0
1667926000825,ECE 287,A00,103676,Javidi; Tara,0,0,0,0
1667926001251,MATH 200B,A00,098023,Salehi Golsefidy; Alireza,15,0,15,0
1667926001686,MATH 202B,A00,098024,Rhoades; Brendon Patrick,14,0,15,1
1667926002117,MATH 203B,A00,098025,Oprea; Dragos N.,14,0,15,1
1667926002546,MATH 204B,A00,098026,Sorensen; Claus M,15,0,15,0
1667926002980,MATH 208,A00,098027,Izadi; Elham,7,0,10,3
1667926003417,MATH 209,A00,098028,Pollack; Aaron,10,0,10,0
1667926003839,MATH 211A,A00,112919,Rogalski; Daniel,10,0,10,0
1667926004296,MATH 211B,A00,112920,Seward; Brandon M.,10,0,10,0
1667926004720,MATH 218,A00,098029,Li; Bo,10,0,10,0
1667926005159,MATH 220B,A00,098030,Novak; Jonathan I,15,0,15,0
1667926005595,MATH 221A,A00,098031,Ebenfelt; Peter F,15,0,15,0
1667926006018,MATH 231B,A00,098032,Zlatos; Andrej,15,0,15,0
1667926006452,MATH 240B,A00,098033,Ni; Lei,13,0,15,2
1667926006884,MATH 243,A00,098034,Jekel; David Andrew,10,0,10,0
1667926007310,MATH 245A,A00,098035,Nie; Jiawang,6,0,15,9
1667926007741,MATH 248,A00,098036,Bejenaru; Ioan,10,0,10,0
1667926008198,MATH 250B,A00,098037,Spolaor; Luca,14,0,15,1
1667926008621,MATH 258,A00,098038,Ni; Lei,10,0,10,0
1667926009070,MATH 264B,A00,098041,Rhoades; Brendon Patrick,13,0,15,2
1667926009503,MATH 268,A00,098042,Buss; Samuel R,10,0,10,0
1667926009926,MATH 269,A00,098043,Rhoades; Brendon Patrick,10,0,10,0
1667926010380,MATH 270B,A00,098044,Li; Bo,13,0,15,2
1667926010805,MATH 272B,A00,098045,Holst; Michael J,13,0,15,2
1667926011245,MATH 273A,A00,098046,Tian; Xiaochuan,12,0,15,3
1667926011669,MATH 275,A01,098048,Tian; Xiaochuan,7,0,10,3
1667926012097,MATH 278A,A00,098049,Holst; Michael J,8,0,10,2
1667926012527,MATH 278B,A00,098050,Cloninger; Alexander,10,0,10,0
1667926012975,MATH 278C,A00,098051,Nie; Jiawang,9,0,10,1
1667926013404,MATH 280B,A00,098052,Zheng; Tianyi,12,0,15,3
1667926013838,MATH 281B,A00,098053,Bradic; Jelena,6,0,15,9
1667926014273,MATH 282B,A00,098054,Arias-Castro; Ery,2,0,15,13
1667926014711,MATH 285,A00,098055,Fitzsimmons; Patrick J,3,0,15,12
1667926015152,MATH 287B,A00,098056,Arias-Castro; Ery,9,0,15,6
1667926015576,MATH 288,A00,098057,Agarwal; Pooja,9,0,10,1
1667926015576,MATH 288,B00,098058,Zhang; Danna,9,0,10,1
1667926015576,MATH 288,C00,098059,Williams; Ruth J,10,0,10,0
1667926016009,MATH 290B,A00,098060,Roberts; Justin Deritter,14,0,15,1
1667926016455,MATH 292,A00,098061,Belmont; Eva Kinoshita,10,0,10,0
1667926016882,MATH 295,A00,098062,Suk; Andrew Hoon,48,0,50,2
1667926017317,MATH 296,A00,098063,Novak; Jonathan I,20,0,20,0
1667926017751,MATH 297,001,098064,Gamst; Anthony Collins,9997,0,9999,2
1667926528415,COGS 205,A00,101395,Chiba; Andrea,19,0,20,1
1667926528846,COGS 210B,001,101404,Greene; Deanna Jacquelyn,9998,0,9999,1
1667926528846,COGS 210B,002,101417,Xia; Haijun,9999,0,9999,0
1667926528846,COGS 210B,003,101422,Nitz; Douglas A.,9999,0,9999,0
1667926528846,COGS 210B,004,101423,Hollan; James D.,9998,0,9999,1
1667926528846,COGS 210B,005,101424,Deak; Gedeon O.,9999,0,9999,0
1667926528846,COGS 210B,006,101425,Rossano; Federico,9999,0,9999,0
1667926529282,COGS 211B,A00,101427,Coulson; Seana M,9997,0,9999,2
1667926529711,COGS 220,A00,101428,Hollan; James D.,0,0,25,25
1667926530142,COGS 229,A00,101429,Dow; Steven P,19,0,25,6
1667926530586,COGS 230,A00,101430,Klemmer; Scott R,13,0,17,4
1667926531017,COGS 234,A00,101431,Xia; Haijun,11,0,25,14
1667926531466,COGS 260,A00,101432,Kiyonaga; Anastasia,19,0,25,6
1667926531466,COGS 260,B00,101433,Kirsh; David Joel,18,0,25,7
1667926531900,CSE 202,A00,102371,Impagliazzo; Russell,0,0,0,0
1667926532360,CSE 203B,A01,102373,Cheng; Chung Kuan,0,0,0,0
1667926532789,CSE 208,A00,102374,Micciancio; Daniele,0,0,0,0
1667926533230,CSE 209A,A00,112895,Impagliazzo; Russell,0,0,15,15
1667926533672,CSE 209B,A00,108005,Bellare; Mihir,0,0,0,0
1667926534105,CSE 210,A00,113163,Coblenz; Michael J,0,0,0,0
1667926534537,CSE 219,A00,106111,Dow; Steven P,0,0,20,20
1667926534965,CSE 221,A00,102376,Voelker; Geoffrey M.,0,0,0,0
1667926535407,CSE 224,A01,102378,Porter; George M,0,0,0,0
1667926535847,CSE 229A,A00,102379,Savage; Stefan,0,0,0,0
1667926536291,CSE 229C,A00,102380,Munyaka; Imani N. S.,0,0,0,0
1667926536720,CSE 232B,A00,102382,Deutsch; Alin Bernard,0,0,0,0
1667926537154,CSE 234,A01,112904,Kumar; Arun Kumar,0,0,0,0
1667926537585,CSE 237A,A00,102383,Rosing; Tajana Simunic,0,0,0,0
1667926538024,CSE 239A,A00,102384,Deutsch; Alin Bernard,0,0,0,0
1667926538455,CSE 239B,A00,102385,Polikarpova; Nadezhda,0,0,0,0
1667926538893,CSE 240A,A00,102386,Pannuto; Patrick William,0,0,0,0
1667926539325,CSE 240B,A00,102387,Zhao; Jishen,0,0,0,0
1667926539757,CSE 241A,A00,106406,Kang; Mingu,0,0,0,0
1667926540187,CSE 249B,A00,102388,Kahng; Andrew Byun,0,0,8,8
1667926540827,CSE 251B,A01,102392,Cottrell; Garrison W,0,0,0,0
1667926540827,CSE 251B,A02,102393,Cottrell; Garrison W,0,0,0,0
1667926541268,CSE 252B,A00,102394,Ochoa; Benjamin Lawrence,0,0,0,0
1667926541698,CSE 257,A01,102396,Gao; Sicun,0,0,0,0
1667926542130,CSE 272,A00,102397,Li; Tzumao,0,0,0,0
1667926542562,CSE 274,A00,111323,Chern; Albert Ren-Haur,0,0,0,0
1667926542996,CSE 282,A00,102398,Pevzner; Pavel Arkadjevich,0,0,0,0
1667926543437,CSE 284,A00,114175,Gymrek; Melissa Ann,0,0,0,0
1667926543886,CSE 290,A00,102399,Chandraker; Manmohan Krishna,0,0,0,0
1667926543886,CSE 290,B00,102400,Vaccaro; Kristen Marie,0,0,25,25
1667926543886,CSE 290,C00,102414,Pannuto; Patrick William,0,0,25,25
1667926543886,CSE 290,D00,102427,Pevzner; Pavel Arkadjevich,0,0,0,0
1667926543886,CSE 290,E00,102429,Zhao; Jishen,0,0,0,0
1667926543886,CSE 290,F00,102436,Tullsen; Dean Michael,0,0,0,0
1667926543886,CSE 290,G00,102440,Christensen; Henrik I,0,0,20,20
1667926544322,CSE 291,A00,102443,Su; Hao,0,0,0,0
1667926544322,CSE 291,B00,102448,Polikarpova; Nadezhda,0,0,0,0
1667926544322,CSE 291,C00,102453,Vaccaro; Kristen Marie,0,0,0,0
1667926544322,CSE 291,D00,111343,Savage; Stefan,0,0,0,0
1667926544322,CSE 291,E00,116474,Claffy; Kimberly Claire,0,0,0,0
1667926544322,CSE 291,F00,116479,Pasquale; Joseph,0,0,0,0
1667926544793,CSE 293,001,119111,Bafna; Vineet,9999,0,9999,0
1667926544793,CSE 293,002,119118,Bellare; Mihir,9999,0,9999,0
1667926544793,CSE 293,003,119122,Berg-Kirkpatrick; Taylor D,9999,0,9999,0
1667926544793,CSE 293,004,119135,Christensen; Henrik I,9999,0,9999,0
1667926544793,CSE 293,005,119142,Cottrell; Garrison W,9999,0,9999,0
1667926544793,CSE 293,006,119146,Deutsch; Alin Bernard,9999,0,9999,0
1667926544793,CSE 293,007,119159,Esmaeilzadeh; Hadi,9999,0,9999,0
1667926544793,CSE 293,008,119166,Freund; Yoav,9999,0,9999,0
1667926544793,CSE 293,009,119170,Griswold; William G.,9999,0,9999,0
1667926544793,CSE 293,010,119183,Gymrek; Melissa Ann,9999,0,9999,0
1667926544793,CSE 293,011,119190,Heninger; Nadia A,9999,0,9999,0
1667926544793,CSE 293,012,119230,Impagliazzo; Russell,9999,0,9999,0
1667926544793,CSE 293,013,119232,Jhala; Ranjit,9999,0,9999,0
1667926544793,CSE 293,014,119233,Kahng; Andrew Byun,9999,0,9999,0
1667926544793,CSE 293,015,119298,Kane; Daniel Mertz,9999,0,9999,0
1667926544793,CSE 293,016,119299,Kriegman; David J,9999,0,9999,0
1667926544793,CSE 293,017,119300,Kumar; Arun Kumar,9999,0,9999,0
1667926544793,CSE 293,018,119301,Lerner; Sorin,9999,0,9999,0
1667926544793,CSE 293,019,119302,Lovett; Shachar,9999,0,9999,0
1667926544793,CSE 293,020,119303,McAuley; Julian John,9999,0,9999,0
1667926544793,CSE 293,021,119304,Micciancio; Daniele,9999,0,9999,0
1667926544793,CSE 293,022,119367,Orailoglu; Alex,9999,0,9999,0
1667926544793,CSE 293,023,119382,Paturi; Ramamohan,9999,0,9999,0
1667926544793,CSE 293,024,119404,Polikarpova; Nadezhda,9999,0,9999,0
1667926544793,CSE 293,025,119406,Politz; Joseph Gibbs,9999,0,9999,0
1667926544793,CSE 293,026,119411,Porter; George M,9999,0,9999,0
1667926544793,CSE 293,027,119414,Porter; Leonard Emerson,9999,0,9999,0
1667926544793,CSE 293,028,119416,Ramamoorthi; Ravi,9999,0,9999,0
1667926544793,CSE 293,029,119417,Sahoo; Debashis,9999,0,9999,0
1667926544793,CSE 293,030,119420,Saul; Lawrence,9999,0,9999,0
1667926544793,CSE 293,031,119421,Savage; Stefan,9999,0,9999,0
1667926544793,CSE 293,032,119425,Schulze; Jurgen P.,9999,0,9999,0
1667926544793,CSE 293,033,119426,Snoeren; Alex C.,9999,0,9999,0
1667926544793,CSE 293,034,119428,Shang; Jingbo,9999,0,9999,0
1667926544793,CSE 293,035,119430,Stefan; Deian,9999,0,9999,0
1667926544793,CSE 293,036,119431,Su; Hao,9999,0,9999,0
1667926544793,CSE 293,037,119433,Swanson; Steven James,9999,0,9999,0
1667926544793,CSE 293,038,119435,Tullsen; Dean Michael,9999,0,9999,0
1667926544793,CSE 293,039,119483,Voelker; Geoffrey M.,9999,0,9999,0
1667926544793,CSE 293,040,119537,Zhao; Jishen,9999,0,9999,0
1667926544793,CSE 293,041,119538,Zhou; Yuan-Yuan,9999,0,9999,0
1667926544793,CSE 293,042,119539,Gao; Sicun,9999,0,9999,0
1667926544793,CSE 293,043,119540,Weibel; Nadir,9999,0,9999,0
1667926544793,CSE 293,044,119541,Gupta; Rajesh K.,9999,0,9999,0
1667926545228,CSE 294,A00,102459,Voelker; Geoffrey M.,0,0,0,0
1667926545228,CSE 294,B00,111322,Orailoglu; Alex,0,0,0,0
1667926545658,DSE 201,A00,096914,Deutsch; Alin Bernard,30,0,30,0
1667926546109,DSE 210,A00,096915,Dasgupta; Sanjoy,30,0,30,0
1667926546540,DSE 260A,A00,096916,Altintas De Callaf; Ilkay,30,0,30,0
1667926546977,ECE 200,001,103586,Antipa; Nicholas A,9999,0,9999,0
1667926546977,ECE 200,002,103587,Atanasov; Nikolay A.,9999,0,9999,0
1667926546977,ECE 200,003,103588,Bharadia; Dinesh,9999,0,9999,0
1667926546977,ECE 200,004,103589,Cheng; Chung Kuan,9999,0,9999,0
1667926546977,ECE 200,005,103590,Cosman; Pamela C.,9999,0,9999,0
1667926546977,ECE 200,006,103591,Dayeh; Shadi Ahmad,9999,0,9999,0
1667926546977,ECE 200,007,103592,Fainman; Yeshaiahu,9999,0,9999,0
1667926546977,ECE 200,008,103593,Ford; Joseph Earl,9999,0,9999,0
1667926546977,ECE 200,009,103594,Franceschetti; Massimo,9999,0,9999,0
1667926546977,ECE 200,010,103595,Fullerton; Eric E,9999,0,9999,0
1667926546977,ECE 200,011,103596,Galton; Ian A,9999,0,9999,0
1667926546977,ECE 200,012,103597,Gilja; Vikash,9999,0,9999,0
1667926546977,ECE 200,013,103598,Hall; Drew A.,9999,0,9999,0
1667926546977,ECE 200,014,103599,Hsueh; Tzu-Chien,9999,0,9999,0
1667926546977,ECE 200,015,103600,Javidi; Tara,9999,0,9999,0
1667926546977,ECE 200,016,103601,Kahng; Andrew Byun,9999,0,9999,0
1667926546977,ECE 200,017,103602,Kim; Young-Han,9999,0,9999,0
1667926546977,ECE 200,018,103603,Koushanfar; Farinaz,9999,0,9999,0
1667926546977,ECE 200,019,103604,Kuzum; Duygu,9999,0,9999,0
1667926546977,ECE 200,020,103605,Le; Hanh-Phuc,9999,0,9999,0
1667926546977,ECE 200,021,103606,Lin; Bill,9999,0,9999,0
1667926546977,ECE 200,022,103607,Liu; Zhaowei,9998,0,9999,1
1667926546977,ECE 200,023,103608,Lo; Yu-Hwa,9999,0,9999,0
1667926546977,ECE 200,024,103609,Lomakin; Vitaliy,9999,0,9999,0
1667926546977,ECE 200,025,103610,Mercier; Patrick Philip,9999,0,9999,0
1667926546977,ECE 200,026,103611,Meyer; Florian,9999,0,9999,0
1667926546977,ECE 200,027,103612,Milstein; Laurence B.,9999,0,9999,0
1667926546977,ECE 200,028,103613,Mir Arabbaygi; Siavash,9999,0,9999,0
1667926546977,ECE 200,029,103614,Mookherjea; Shayan,9999,0,9999,0
1667926546977,ECE 200,030,103615,Morris; Karcher William,9999,0,9999,0
1667926546977,ECE 200,031,103616,Ng; Tse Nga,9999,0,9999,0
1667926546977,ECE 200,032,103617,Nguyen; Truong Quang,9999,0,9999,0
1667926546977,ECE 200,033,103618,Nomura; Kenji,9999,0,9999,0
1667926546977,ECE 200,034,103619,Orlitsky; Alon,9999,0,9999,0
1667926546977,ECE 200,035,103620,Pal; Piya,9999,0,9999,0
1667926546977,ECE 200,036,103621,Papen; George C.,9999,0,9999,0
1667926546977,ECE 200,037,103622,Radic; Stojan,9999,0,9999,0
1667926546977,ECE 200,038,103623,Rao; Bhaskar D.,9999,0,9999,0
1667926546977,ECE 200,039,103624,Rao; Ramesh R,9999,0,9999,0
1667926546977,ECE 200,040,103625,Rebeiz; Gabriel,9999,0,9999,0
1667926546977,ECE 200,041,103626,Sanford; John R,9999,0,9999,0
1667926546977,ECE 200,042,103627,Siegel; Paul H.,9999,0,9999,0
1667926546977,ECE 200,043,103628,Sievenpiper; Daniel F.,9999,0,9999,0
1667926546977,ECE 200,044,103629,Sworder; David D.,9999,0,9999,0
1667926546977,ECE 200,045,103630,Taur; Yuan,9999,0,9999,0
1667926546977,ECE 200,046,103631,Touri; Behrouz,9999,0,9999,0
1667926546977,ECE 200,047,103632,Trivedi; Mohan M.,9999,0,9999,0
1667926546977,ECE 200,048,103633,Vasconcelos; Nuno,9999,0,9999,0
1667926546977,ECE 200,049,103634,Wang; Xiaolong,9999,0,9999,0
1667926546977,ECE 200,050,103635,Xie; Pengtao,9999,0,9999,0
1667926546977,ECE 200,051,103636,Yip; Michael,9999,0,9999,0
1667926546977,ECE 200,052,103637,Zeger; Kenneth A.,999,0,999,0
1667926546977,ECE 200,053,103638,Zhang; Xinyu,9999,0,9999,0
1667926546977,ECE 200,054,103639,Turakhia; Yatish Girish,9999,0,9999,0
1667926546977,ECE 200,055,103640,Kang; Mingu,9999,0,9999,0
1667926546977,ECE 200,056,103641,Shi; Yuanyuan,9999,0,9999,0
1667926546977,ECE 200,057,103642,Wang; Edward Jay,9999,0,9999,0
1667926546977,ECE 200,058,103643,Zheng; Yang,9999,0,9999,0
1667926547407,ECE 202,A00,103644,Kuzum; Duygu,0,0,0,0
1667926547831,ECE 212BN,A00,103646,Ng; Tse Nga,0,0,0,0
1667926548270,ECE 221,A00,111493,Staff,0,0,0,0
1667926548699,ECE 222B,A00,103647,Lomakin; Vitaliy,0,0,0,0
1667926549129,ECE 230B,A00,103648,Taur; Yuan,0,0,0,0
1667926549556,ECE 238B,A00,103649,Garay; Javier,0,0,0,0
1667926550005,ECE 240B,A00,112900,Fainman; Yeshaiahu,0,0,0,0
1667926550440,ECE 247A,A00,103650,Jokerst; Jesse Vincent,0,0,0,0
1667926550874,ECE 247B,A00,103651,Wang; Joseph,0,0,0,0
1667926551302,ECE 250,A00,103652,Siegel; Paul H.,0,0,0,0
1667926551744,ECE 251A,A00,103654,Rao; Bhaskar D.,0,0,0,0
1667926552169,ECE 257B,A00,103655,Bharadia; Dinesh,0,0,0,0
1667926552599,ECE 258A,A00,103656,Milstein; Laurence B.,0,0,0,0
1667926553026,ECE 260B,A00,103658,Kang; Mingu,0,0,0,0
1667926553467,ECE 264A,A00,103659,Galton; Ian A,0,0,0,0
1667926553909,ECE 265A,A00,103661,Gudem; Prasad S.S.,0,0,0,0
1667926554349,ECE 265D,A00,103662,Gudem; Prasad S.S.,0,0,0,0
1667926554791,ECE 268,A00,103663,Koushanfar; Farinaz,0,0,0,0
1667926555221,ECE 269,A01,103665,Pal; Piya,0,0,0,0
1667926555655,ECE 271B,A00,103666,Vasconcelos; Manuela,0,0,0,0
1667926556109,ECE 276A,A00,103667,Atanasov; Nikolay A.,0,0,0,0
1667926556550,ECE 277,A00,103668,An; Cheolhong,0,0,0,0
1667926557112,ECE 279,A00,117947,Hall; Drew A.,0,0,0,0
1667926557986,ECE 283,A00,103670,Hsueh; Tzu-Chien,0,0,0,0
1667926558426,ECE 284,A00,103671,Turakhia; Yatish Girish,0,0,0,0
1667926558861,ECE 285,A00,103672,Zheng; Yang,0,0,0,0
1667926558861,ECE 285,B00,103673,Sworder; David D.,0,0,0,0
1667926559287,ECE 287,A00,103676,Javidi; Tara,0,0,0,0
1667926559717,MATH 200B,A00,098023,Salehi Golsefidy; Alireza,15,0,15,0
1667926560148,MATH 202B,A00,098024,Rhoades; Brendon Patrick,14,0,15,1
1667926560586,MATH 203B,A00,098025,Oprea; Dragos N.,14,0,15,1
1667926561018,MATH 204B,A00,098026,Sorensen; Claus M,15,0,15,0
1667926561476,MATH 208,A00,098027,Izadi; Elham,7,0,10,3
1667926561911,MATH 209,A00,098028,Pollack; Aaron,10,0,10,0
1667926562367,MATH 211A,A00,112919,Rogalski; Daniel,10,0,10,0
1667926562801,MATH 211B,A00,112920,Seward; Brandon M.,10,0,10,0
1667926563226,MATH 218,A00,098029,Li; Bo,10,0,10,0
1667926563654,MATH 220B,A00,098030,Novak; Jonathan I,15,0,15,0
1667926564093,MATH 221A,A00,098031,Ebenfelt; Peter F,15,0,15,0
1667926564517,MATH 231B,A00,098032,Zlatos; Andrej,15,0,15,0
1667926564943,MATH 240B,A00,098033,Ni; Lei,13,0,15,2
1667926565371,MATH 243,A00,098034,Jekel; David Andrew,10,0,10,0
1667926565836,MATH 245A,A00,098035,Nie; Jiawang,6,0,15,9
1667926566290,MATH 248,A00,098036,Bejenaru; Ioan,10,0,10,0
1667926566713,MATH 250B,A00,098037,Spolaor; Luca,14,0,15,1
1667926567137,MATH 258,A00,098038,Ni; Lei,10,0,10,0
1667926567568,MATH 264B,A00,098041,Rhoades; Brendon Patrick,13,0,15,2
1667926567997,MATH 268,A00,098042,Buss; Samuel R,10,0,10,0
1667926568437,MATH 269,A00,098043,Rhoades; Brendon Patrick,10,0,10,0
1667926568869,MATH 270B,A00,098044,Li; Bo,13,0,15,2
1667926569304,MATH 272B,A00,098045,Holst; Michael J,13,0,15,2
1667926569735,MATH 273A,A00,098046,Tian; Xiaochuan,12,0,15,3
1667926570186,MATH 275,A01,098048,Tian; Xiaochuan,7,0,10,3
1667926570616,MATH 278A,A00,098049,Holst; Michael J,8,0,10,2
1667926571044,MATH 278B,A00,098050,Cloninger; Alexander,10,0,10,0
1667926571487,MATH 278C,A00,098051,Nie; Jiawang,9,0,10,1
1667926571917,MATH 280B,A00,098052,Zheng; Tianyi,12,0,15,3
1667926572376,MATH 281B,A00,098053,Bradic; Jelena,6,0,15,9
1667926572817,MATH 282B,A00,098054,Arias-Castro; Ery,2,0,15,13
1667926573243,MATH 285,A00,098055,Fitzsimmons; Patrick J,3,0,15,12
1667926573680,MATH 287B,A00,098056,Arias-Castro; Ery,9,0,15,6
1667926574123,MATH 288,A00,098057,Agarwal; Pooja,9,0,10,1
1667926574123,MATH 288,B00,098058,Zhang; Danna,9,0,10,1
1667926574123,MATH 288,C00,098059,Williams; Ruth J,10,0,10,0
1667926574569,MATH 290B,A00,098060,Roberts; Justin Deritter,14,0,15,1
1667926574999,MATH 292,A00,098061,Belmont; Eva Kinoshita,10,0,10,0
1667926575438,MATH 295,A00,098062,Suk; Andrew Hoon,48,0,50,2
1667926575860,MATH 296,A00,098063,Novak; Jonathan I,20,0,20,0
1667926576299,MATH 297,001,098064,Gamst; Anthony Collins,9997,0,9999,2
1667927087863,COGS 205,A00,101395,Chiba; Andrea,19,0,20,1
1667927088306,COGS 210B,001,101404,Greene; Deanna Jacquelyn,9998,0,9999,1
1667927088306,COGS 210B,002,101417,Xia; Haijun,9999,0,9999,0
1667927088306,COGS 210B,003,101422,Nitz; Douglas A.,9999,0,9999,0
1667927088306,COGS 210B,004,101423,Hollan; James D.,9998,0,9999,1
1667927088306,COGS 210B,005,101424,Deak; Gedeon O.,9999,0,9999,0
1667927088306,COGS 210B,006,101425,Rossano; Federico,9999,0,9999,0
1667927088736,COGS 211B,A00,101427,Coulson; Seana M,9997,0,9999,2
1667927089251,COGS 220,A00,101428,Hollan; James D.,0,0,25,25
1667927089682,COGS 229,A00,101429,Dow; Steven P,19,0,25,6
1667927090114,COGS 230,A00,101430,Klemmer; Scott R,13,0,17,4
1667927090579,COGS 234,A00,101431,Xia; Haijun,11,0,25,14
1667927091025,COGS 260,A00,101432,Kiyonaga; Anastasia,19,0,25,6
1667927091025,COGS 260,B00,101433,Kirsh; David Joel,18,0,25,7
1667927091460,CSE 202,A00,102371,Impagliazzo; Russell,0,0,0,0
1667927091882,CSE 203B,A01,102373,Cheng; Chung Kuan,0,0,0,0
1667927092323,CSE 208,A00,102374,Micciancio; Daniele,0,0,0,0
1667927092752,CSE 209A,A00,112895,Impagliazzo; Russell,0,0,15,15
1667927093177,CSE 209B,A00,108005,Bellare; Mihir,0,0,0,0
1667927093622,CSE 210,A00,113163,Coblenz; Michael J,0,0,0,0
1667927094055,CSE 219,A00,106111,Dow; Steven P,0,0,20,20
1667927094488,CSE 221,A00,102376,Voelker; Geoffrey M.,0,0,0,0
1667927094915,CSE 224,A01,102378,Porter; George M,0,0,0,0
1667927095358,CSE 229A,A00,102379,Savage; Stefan,0,0,0,0
1667927095788,CSE 229C,A00,102380,Munyaka; Imani N. S.,0,0,0,0
1667927096216,CSE 232B,A00,102382,Deutsch; Alin Bernard,0,0,0,0
1667927096651,CSE 234,A01,112904,Kumar; Arun Kumar,0,0,0,0
1667927097075,CSE 237A,A00,102383,Rosing; Tajana Simunic,0,0,0,0
1667927097513,CSE 239A,A00,102384,Deutsch; Alin Bernard,0,0,0,0
1667927097951,CSE 239B,A00,102385,Polikarpova; Nadezhda,0,0,0,0
1667927098391,CSE 240A,A00,102386,Pannuto; Patrick William,0,0,0,0
1667927098819,CSE 240B,A00,102387,Zhao; Jishen,0,0,0,0
1667927099257,CSE 241A,A00,106406,Kang; Mingu,0,0,0,0
1667927099684,CSE 249B,A00,102388,Kahng; Andrew Byun,0,0,8,8
1667927100128,CSE 251B,A01,102392,Cottrell; Garrison W,0,0,0,0
1667927100128,CSE 251B,A02,102393,Cottrell; Garrison W,0,0,0,0
1667927100572,CSE 252B,A00,102394,Ochoa; Benjamin Lawrence,0,0,0,0
1667927100996,CSE 257,A01,102396,Gao; Sicun,0,0,0,0
1667927101419,CSE 272,A00,102397,Li; Tzumao,0,0,0,0
1667927101849,CSE 274,A00,111323,Chern; Albert Ren-Haur,0,0,0,0
1667927102290,CSE 282,A00,102398,Pevzner; Pavel Arkadjevich,0,0,0,0
1667927102722,CSE 284,A00,114175,Gymrek; Melissa Ann,0,0,0,0
1667927103165,CSE 290,A00,102399,Chandraker; Manmohan Krishna,0,0,0,0
1667927103165,CSE 290,B00,102400,Vaccaro; Kristen Marie,0,0,25,25
1667927103165,CSE 290,C00,102414,Pannuto; Patrick William,0,0,25,25
1667927103165,CSE 290,D00,102427,Pevzner; Pavel Arkadjevich,0,0,0,0
1667927103165,CSE 290,E00,102429,Zhao; Jishen,0,0,0,0
1667927103165,CSE 290,F00,102436,Tullsen; Dean Michael,0,0,0,0
1667927103165,CSE 290,G00,102440,Christensen; Henrik I,0,0,20,20
1667927103606,CSE 291,A00,102443,Su; Hao,0,0,0,0
1667927103606,CSE 291,B00,102448,Polikarpova; Nadezhda,0,0,0,0
1667927103606,CSE 291,C00,102453,Vaccaro; Kristen Marie,0,0,0,0
1667927103606,CSE 291,D00,111343,Savage; Stefan,0,0,0,0
1667927103606,CSE 291,E00,116474,Claffy; Kimberly Claire,0,0,0,0
1667927103606,CSE 291,F00,116479,Pasquale; Joseph,0,0,0,0
1667927104048,CSE 293,001,119111,Bafna; Vineet,9999,0,9999,0
1667927104048,CSE 293,002,119118,Bellare; Mihir,9999,0,9999,0
1667927104048,CSE 293,003,119122,Berg-Kirkpatrick; Taylor D,9999,0,9999,0
1667927104048,CSE 293,004,119135,Christensen; Henrik I,9999,0,9999,0
1667927104048,CSE 293,005,119142,Cottrell; Garrison W,9999,0,9999,0
1667927104048,CSE 293,006,119146,Deutsch; Alin Bernard,9999,0,9999,0
1667927104048,CSE 293,007,119159,Esmaeilzadeh; Hadi,9999,0,9999,0
1667927104048,CSE 293,008,119166,Freund; Yoav,9999,0,9999,0
1667927104048,CSE 293,009,119170,Griswold; William G.,9999,0,9999,0
1667927104048,CSE 293,010,119183,Gymrek; Melissa Ann,9999,0,9999,0
1667927104048,CSE 293,011,119190,Heninger; Nadia A,9999,0,9999,0
1667927104048,CSE 293,012,119230,Impagliazzo; Russell,9999,0,9999,0
1667927104048,CSE 293,013,119232,Jhala; Ranjit,9999,0,9999,0
1667927104048,CSE 293,014,119233,Kahng; Andrew Byun,9999,0,9999,0
1667927104048,CSE 293,015,119298,Kane; Daniel Mertz,9999,0,9999,0
1667927104048,CSE 293,016,119299,Kriegman; David J,9999,0,9999,0
1667927104048,CSE 293,017,119300,Kumar; Arun Kumar,9999,0,9999,0
1667927104048,CSE 293,018,119301,Lerner; Sorin,9999,0,9999,0
1667927104048,CSE 293,019,119302,Lovett; Shachar,9999,0,9999,0
1667927104048,CSE 293,020,119303,McAuley; Julian John,9999,0,9999,0
1667927104048,CSE 293,021,119304,Micciancio; Daniele,9999,0,9999,0
1667927104048,CSE 293,022,119367,Orailoglu; Alex,9999,0,9999,0
1667927104048,CSE 293,023,119382,Paturi; Ramamohan,9999,0,9999,0
1667927104048,CSE 293,024,119404,Polikarpova; Nadezhda,9999,0,9999,0
1667927104048,CSE 293,025,119406,Politz; Joseph Gibbs,9999,0,9999,0
1667927104048,CSE 293,026,119411,Porter; George M,9999,0,9999,0
1667927104048,CSE 293,027,119414,Porter; Leonard Emerson,9999,0,9999,0
1667927104048,CSE 293,028,119416,Ramamoorthi; Ravi,9999,0,9999,0
1667927104048,CSE 293,029,119417,Sahoo; Debashis,9999,0,9999,0
1667927104048,CSE 293,030,119420,Saul; Lawrence,9999,0,9999,0
1667927104048,CSE 293,031,119421,Savage; Stefan,9999,0,9999,0
1667927104048,CSE 293,032,119425,Schulze; Jurgen P.,9999,0,9999,0
1667927104048,CSE 293,033,119426,Snoeren; Alex C.,9999,0,9999,0
1667927104048,CSE 293,034,119428,Shang; Jingbo,9999,0,9999,0
1667927104048,CSE 293,035,119430,Stefan; Deian,9999,0,9999,0
1667927104048,CSE 293,036,119431,Su; Hao,9999,0,9999,0
1667927104048,CSE 293,037,119433,Swanson; Steven James,9999,0,9999,0
1667927104048,CSE 293,038,119435,Tullsen; Dean Michael,9999,0,9999,0
1667927104048,CSE 293,039,119483,Voelker; Geoffrey M.,9999,0,9999,0
1667927104048,CSE 293,040,119537,Zhao; Jishen,9999,0,9999,0
1667927104048,CSE 293,041,119538,Zhou; Yuan-Yuan,9999,0,9999,0
1667927104048,CSE 293,042,119539,Gao; Sicun,9999,0,9999,0
1667927104048,CSE 293,043,119540,Weibel; Nadir,9999,0,9999,0
1667927104048,CSE 293,044,119541,Gupta; Rajesh K.,9999,0,9999,0
1667927104485,CSE 294,A00,102459,Voelker; Geoffrey M.,0,0,0,0
1667927104485,CSE 294,B00,111322,Orailoglu; Alex,0,0,0,0
1667927104921,DSE 201,A00,096914,Deutsch; Alin Bernard,30,0,30,0
1667927105347,DSE 210,A00,096915,Dasgupta; Sanjoy,30,0,30,0
1667927105770,DSE 260A,A00,096916,Altintas De Callaf; Ilkay,30,0,30,0
1667927106209,ECE 200,001,103586,Antipa; Nicholas A,9999,0,9999,0
1667927106209,ECE 200,002,103587,Atanasov; Nikolay A.,9999,0,9999,0
1667927106209,ECE 200,003,103588,Bharadia; Dinesh,9999,0,9999,0
1667927106209,ECE 200,004,103589,Cheng; Chung Kuan,9999,0,9999,0
1667927106209,ECE 200,005,103590,Cosman; Pamela C.,9999,0,9999,0
1667927106209,ECE 200,006,103591,Dayeh; Shadi Ahmad,9999,0,9999,0
1667927106209,ECE 200,007,103592,Fainman; Yeshaiahu,9999,0,9999,0
1667927106209,ECE 200,008,103593,Ford; Joseph Earl,9999,0,9999,0
1667927106209,ECE 200,009,103594,Franceschetti; Massimo,9999,0,9999,0
1667927106209,ECE 200,010,103595,Fullerton; Eric E,9999,0,9999,0
1667927106209,ECE 200,011,103596,Galton; Ian A,9999,0,9999,0
1667927106209,ECE 200,012,103597,Gilja; Vikash,9999,0,9999,0
1667927106209,ECE 200,013,103598,Hall; Drew A.,9999,0,9999,0
1667927106209,ECE 200,014,103599,Hsueh; Tzu-Chien,9999,0,9999,0
1667927106209,ECE 200,015,103600,Javidi; Tara,9999,0,9999,0
1667927106209,ECE 200,016,103601,Kahng; Andrew Byun,9999,0,9999,0
1667927106209,ECE 200,017,103602,Kim; Young-Han,9999,0,9999,0
1667927106209,ECE 200,018,103603,Koushanfar; Farinaz,9999,0,9999,0
1667927106209,ECE 200,019,103604,Kuzum; Duygu,9999,0,9999,0
1667927106209,ECE 200,020,103605,Le; Hanh-Phuc,9999,0,9999,0
1667927106209,ECE 200,021,103606,Lin; Bill,9999,0,9999,0
1667927106209,ECE 200,022,103607,Liu; Zhaowei,9998,0,9999,1
1667927106209,ECE 200,023,103608,Lo; Yu-Hwa,9999,0,9999,0
1667927106209,ECE 200,024,103609,Lomakin; Vitaliy,9999,0,9999,0
1667927106209,ECE 200,025,103610,Mercier; Patrick Philip,9999,0,9999,0
1667927106209,ECE 200,026,103611,Meyer; Florian,9999,0,9999,0
1667927106209,ECE 200,027,103612,Milstein; Laurence B.,9999,0,9999,0
1667927106209,ECE 200,028,103613,Mir Arabbaygi; Siavash,9999,0,9999,0
1667927106209,ECE 200,029,103614,Mookherjea; Shayan,9999,0,9999,0
1667927106209,ECE 200,030,103615,Morris; Karcher William,9999,0,9999,0
1667927106209,ECE 200,031,103616,Ng; Tse Nga,9999,0,9999,0
1667927106209,ECE 200,032,103617,Nguyen; Truong Quang,9999,0,9999,0
1667927106209,ECE 200,033,103618,Nomura; Kenji,9999,0,9999,0
1667927106209,ECE 200,034,103619,Orlitsky; Alon,9999,0,9999,0
1667927106209,ECE 200,035,103620,Pal; Piya,9999,0,9999,0
1667927106209,ECE 200,036,103621,Papen; George C.,9999,0,9999,0
1667927106209,ECE 200,037,103622,Radic; Stojan,9999,0,9999,0
1667927106209,ECE 200,038,103623,Rao; Bhaskar D.,9999,0,9999,0
1667927106209,ECE 200,039,103624,Rao; Ramesh R,9999,0,9999,0
1667927106209,ECE 200,040,103625,Rebeiz; Gabriel,9999,0,9999,0
1667927106209,ECE 200,041,103626,Sanford; John R,9999,0,9999,0
1667927106209,ECE 200,042,103627,Siegel; Paul H.,9999,0,9999,0
1667927106209,ECE 200,043,103628,Sievenpiper; Daniel F.,9999,0,9999,0
1667927106209,ECE 200,044,103629,Sworder; David D.,9999,0,9999,0
1667927106209,ECE 200,045,103630,Taur; Yuan,9999,0,9999,0
1667927106209,ECE 200,046,103631,Touri; Behrouz,9999,0,9999,0
1667927106209,ECE 200,047,103632,Trivedi; Mohan M.,9999,0,9999,0
1667927106209,ECE 200,048,103633,Vasconcelos; Nuno,9999,0,9999,0
1667927106209,ECE 200,049,103634,Wang; Xiaolong,9999,0,9999,0
1667927106209,ECE 200,050,103635,Xie; Pengtao,9999,0,9999,0
1667927106209,ECE 200,051,103636,Yip; Michael,9999,0,9999,0
1667927106209,ECE 200,052,103637,Zeger; Kenneth A.,999,0,999,0
1667927106209,ECE 200,053,103638,Zhang; Xinyu,9999,0,9999,0
1667927106209,ECE 200,054,103639,Turakhia; Yatish Girish,9999,0,9999,0
1667927106209,ECE 200,055,103640,Kang; Mingu,9999,0,9999,0
1667927106209,ECE 200,056,103641,Shi; Yuanyuan,9999,0,9999,0
1667927106209,ECE 200,057,103642,Wang; Edward Jay,9999,0,9999,0
1667927106209,ECE 200,058,103643,Zheng; Yang,9999,0,9999,0
1667927106641,ECE 202,A00,103644,Kuzum; Duygu,0,0,0,0
1667927107067,ECE 212BN,A00,103646,Ng; Tse Nga,0,0,0,0
1667927107523,ECE 221,A00,111493,Staff,0,0,0,0
1667927107947,ECE 222B,A00,103647,Lomakin; Vitaliy,0,0,0,0
1667927108370,ECE 230B,A00,103648,Taur; Yuan,0,0,0,0
1667927108798,ECE 238B,A00,103649,Garay; Javier,0,0,0,0
1667927109240,ECE 240B,A00,112900,Fainman; Yeshaiahu,0,0,0,0
1667927109679,ECE 247A,A00,103650,Jokerst; Jesse Vincent,0,0,0,0
1667927110112,ECE 247B,A00,103651,Wang; Joseph,0,0,0,0
1667927110543,ECE 250,A00,103652,Siegel; Paul H.,0,0,0,0
1667927110969,ECE 251A,A00,103654,Rao; Bhaskar D.,0,0,0,0
1667927111441,ECE 257B,A00,103655,Bharadia; Dinesh,0,0,0,0
1667927111864,ECE 258A,A00,103656,Milstein; Laurence B.,0,0,0,0
1667927112306,ECE 260B,A00,103658,Kang; Mingu,0,0,0,0
1667927112739,ECE 264A,A00,103659,Galton; Ian A,0,0,0,0
1667927113174,ECE 265A,A00,103661,Gudem; Prasad S.S.,0,0,0,0
1667927113611,ECE 265D,A00,103662,Gudem; Prasad S.S.,0,0,0,0
1667927114042,ECE 268,A00,103663,Koushanfar; Farinaz,0,0,0,0
1667927114504,ECE 269,A01,103665,Pal; Piya,0,0,0,0
1667927114945,ECE 271B,A00,103666,Vasconcelos; Manuela,0,0,0,0
1667927115400,ECE 276A,A00,103667,Atanasov; Nikolay A.,0,0,0,0
1667927115832,ECE 277,A00,103668,An; Cheolhong,0,0,0,0
1667927116262,ECE 279,A00,117947,Hall; Drew A.,0,0,0,0
1667927117145,ECE 283,A00,103670,Hsueh; Tzu-Chien,0,0,0,0
1667927117578,ECE 284,A00,103671,Turakhia; Yatish Girish,0,0,0,0
1667927118005,ECE 285,A00,103672,Zheng; Yang,0,0,0,0
1667927118005,ECE 285,B00,103673,Sworder; David D.,0,0,0,0
1667927118440,ECE 287,A00,103676,Javidi; Tara,0,0,0,0
1667927118872,MATH 200B,A00,098023,Salehi Golsefidy; Alireza,15,0,15,0
1667927119306,MATH 202B,A00,098024,Rhoades; Brendon Patrick,14,0,15,1
1667927119741,MATH 203B,A00,098025,Oprea; Dragos N.,14,0,15,1
1667927120186,MATH 204B,A00,098026,Sorensen; Claus M,15,0,15,0
1667927120631,MATH 208,A00,098027,Izadi; Elham,7,0,10,3
1667927121062,MATH 209,A00,098028,Pollack; Aaron,10,0,10,0
1667927121493,MATH 211A,A00,112919,Rogalski; Daniel,10,0,10,0
1667927121923,MATH 211B,A00,112920,Seward; Brandon M.,10,0,10,0
1667927122350,MATH 218,A00,098029,Li; Bo,10,0,10,0
1667927122789,MATH 220B,A00,098030,Novak; Jonathan I,15,0,15,0
1667927123220,MATH 221A,A00,098031,Ebenfelt; Peter F,15,0,15,0
1667927123652,MATH 231B,A00,098032,Zlatos; Andrej,15,0,15,0
1667927124092,MATH 240B,A00,098033,Ni; Lei,13,0,15,2
1667927124538,MATH 243,A00,098034,Jekel; David Andrew,10,0,10,0
1667927124989,MATH 245A,A00,098035,Nie; Jiawang,6,0,15,9
1667927125429,MATH 248,A00,098036,Bejenaru; Ioan,10,0,10,0
1667927125867,MATH 250B,A00,098037,Spolaor; Luca,14,0,15,1
1667927126305,MATH 258,A00,098038,Ni; Lei,10,0,10,0
1667927126736,MATH 264B,A00,098041,Rhoades; Brendon Patrick,13,0,15,2
1667927127165,MATH 268,A00,098042,Buss; Samuel R,10,0,10,0
1667927127603,MATH 269,A00,098043,Rhoades; Brendon Patrick,10,0,10,0
1667927128036,MATH 270B,A00,098044,Li; Bo,13,0,15,2
1667927128472,MATH 272B,A00,098045,Holst; Michael J,13,0,15,2
1667927128898,MATH 273A,A00,098046,Tian; Xiaochuan,12,0,15,3
1667927129371,MATH 275,A01,098048,Tian; Xiaochuan,7,0,10,3
1667927129806,MATH 278A,A00,098049,Holst; Michael J,8,0,10,2
1667927130240,MATH 278B,A00,098050,Cloninger; Alexander,10,0,10,0
1667927130677,MATH 278C,A00,098051,Nie; Jiawang,9,0,10,1
1667927131112,MATH 280B,A00,098052,Zheng; Tianyi,12,0,15,3
1667927131548,MATH 281B,A00,098053,Bradic; Jelena,6,0,15,9
1667927131976,MATH 282B,A00,098054,Arias-Castro; Ery,2,0,15,13
1667927132402,MATH 285,A00,098055,Fitzsimmons; Patrick J,3,0,15,12
1667927132840,MATH 287B,A00,098056,Arias-Castro; Ery,9,0,15,6
1667927133384,MATH 288,A00,098057,Agarwal; Pooja,9,0,10,1
1667927133384,MATH 288,B00,098058,Zhang; Danna,9,0,10,1
1667927133384,MATH 288,C00,098059,Williams; Ruth J,10,0,10,0
1667927133808,MATH 290B,A00,098060,Roberts; Justin Deritter,14,0,15,1
1667927134239,MATH 292,A00,098061,Belmont; Eva Kinoshita,10,0,10,0
1667927134682,MATH 295,A00,098062,Suk; Andrew Hoon,48,0,50,2
1667927135113,MATH 296,A00,098063,Novak; Jonathan I,20,0,20,0
1667927135555,MATH 297,001,098064,Gamst; Anthony Collins,9997,0,9999,2
