time,subj_course_id,sec_code,sec_id,prof,available,waitlist,total,enrolled_ct
1668342638723,COGS 205,A00,101395,Chiba; Andrea,19,0,20,1
1668342639158,COGS 210B,001,101404,Greene; Deanna Jacquelyn,9998,0,9999,1
1668342639158,COGS 210B,002,101417,Xia; Haijun,9999,0,9999,0
1668342639158,COGS 210B,003,101422,Nitz; Douglas A.,9999,0,9999,0
1668342639158,COGS 210B,004,101423,Hollan; James D.,9998,0,9999,1
1668342639158,COGS 210B,005,101424,Deak; Gedeon O.,9998,0,9999,1
1668342639158,COGS 210B,006,101425,Rossano; Federico,9999,0,9999,0
1668342639584,COGS 211B,A00,101427,Coulson; Seana M,9996,0,9999,3
1668342640010,COGS 220,A00,101428,Hollan; James D.,0,0,25,25
1668342640436,COGS 229,A00,101429,Dow; Steven P,18,0,25,7
1668342640862,COGS 230,A00,101430,Klemmer; Scott R,11,0,17,6
1668342641290,COGS 234,A00,101431,Xia; Haijun,1,0,25,24
1668342641717,COGS 260,A00,101432,Kiyonaga; Anastasia,21,0,25,4
1668342641717,COGS 260,B00,101433,Kirsh; David Joel,15,0,25,10
1668342642150,CSE 202,A00,102371,Impagliazzo; Russell,0,0,0,0
1668342642589,CSE 203B,A01,102373,Cheng; Chung Kuan,0,0,0,0
1668342643019,CSE 208,A00,102374,Micciancio; Daniele,0,0,0,0
1668342643449,CSE 209A,A00,112895,Impagliazzo; Russell,0,0,15,15
1668342643882,CSE 209B,A00,108005,Bellare; Mihir,0,0,0,0
1668342644311,CSE 210,A00,113163,Coblenz; Michael J,0,0,0,0
1668342644737,CSE 219,A00,106111,Dow; Steven P,0,0,20,20
1668342645180,CSE 221,A00,102376,Voelker; Geoffrey M.,0,0,0,0
1668342645604,CSE 224,A01,102378,Porter; George M,0,0,0,0
1668342646031,CSE 229A,A00,102379,Savage; Stefan,0,0,0,0
1668342646459,CSE 229C,A00,102380,Munyaka; Imani N. S.,0,0,0,0
1668342646885,CSE 232B,A00,102382,Deutsch; Alin Bernard,0,0,0,0
1668342647316,CSE 234,A01,112904,Kumar; Arun Kumar,0,0,0,0
1668342647746,CSE 237A,A00,102383,Rosing; Tajana Simunic,0,0,0,0
1668342648171,CSE 239A,A00,102384,Deutsch; Alin Bernard,0,0,0,0
1668342648597,CSE 239B,A00,102385,Polikarpova; Nadezhda,0,0,0,0
1668342649024,CSE 240A,A00,102386,Pannuto; Patrick William,0,0,0,0
1668342649453,CSE 240B,A00,102387,Zhao; Jishen,0,0,0,0
1668342649885,CSE 241A,A00,106406,Kang; Mingu,0,0,0,0
1668342650314,CSE 249B,A00,102388,Kahng; Andrew Byun,0,0,8,8
1668342650746,CSE 251B,A01,102392,Cottrell; Garrison W,0,0,0,0
1668342650746,CSE 251B,A02,102393,Cottrell; Garrison W,0,0,0,0
1668342651172,CSE 252B,A00,102394,Ochoa; Benjamin Lawrence,0,0,0,0
1668342651597,CSE 257,A01,102396,Gao; Sicun,0,0,0,0
1668342652025,CSE 272,A00,102397,Li; Tzumao,0,0,0,0
1668342652454,CSE 274,A00,111323,Chern; Albert Ren-Haur,0,0,0,0
1668342652880,CSE 282,A00,102398,Pevzner; Pavel Arkadjevich,0,0,0,0
1668342653311,CSE 284,A00,114175,Gymrek; Melissa Ann,0,0,0,0
1668342653744,CSE 290,A00,102399,Chandraker; Manmohan Krishna,0,0,0,0
1668342653744,CSE 290,B00,102400,Vaccaro; Kristen Marie,0,0,25,25
1668342653744,CSE 290,C00,102414,Pannuto; Patrick William,0,0,25,25
1668342653744,CSE 290,D00,102427,Pevzner; Pavel Arkadjevich,0,0,0,0
1668342653744,CSE 290,E00,102429,Zhao; Jishen,0,0,0,0
1668342653744,CSE 290,F00,102436,Tullsen; Dean Michael,0,0,0,0
1668342653744,CSE 290,G00,102440,Christensen; Henrik I,0,0,20,20
1668342654174,CSE 291,A00,102443,Su; Hao,0,0,0,0
1668342654174,CSE 291,B00,102448,Polikarpova; Nadezhda,0,0,0,0
1668342654174,CSE 291,C00,102453,Vaccaro; Kristen Marie,0,0,0,0
1668342654174,CSE 291,D00,111343,Savage; Stefan,0,0,0,0
1668342654174,CSE 291,E00,116474,Claffy; Kimberly Claire,0,0,0,0
1668342654174,CSE 291,F00,116479,Pasquale; Joseph,0,0,0,0
1668342654617,CSE 293,001,119111,Bafna; Vineet,9999,0,9999,0
1668342654617,CSE 293,002,119118,Bellare; Mihir,9999,0,9999,0
1668342654617,CSE 293,003,119122,Berg-Kirkpatrick; Taylor D,9999,0,9999,0
1668342654617,CSE 293,004,119135,Christensen; Henrik I,9999,0,9999,0
1668342654617,CSE 293,005,119142,Cottrell; Garrison W,9999,0,9999,0
1668342654617,CSE 293,006,119146,Deutsch; Alin Bernard,9999,0,9999,0
1668342654617,CSE 293,007,119159,Esmaeilzadeh; Hadi,9999,0,9999,0
1668342654617,CSE 293,008,119166,Freund; Yoav,9999,0,9999,0
1668342654617,CSE 293,009,119170,Griswold; William G.,9999,0,9999,0
1668342654617,CSE 293,010,119183,Gymrek; Melissa Ann,9999,0,9999,0
1668342654617,CSE 293,011,119190,Heninger; Nadia A,9999,0,9999,0
1668342654617,CSE 293,012,119230,Impagliazzo; Russell,9999,0,9999,0
1668342654617,CSE 293,013,119232,Jhala; Ranjit,9999,0,9999,0
1668342654617,CSE 293,014,119233,Kahng; Andrew Byun,9999,0,9999,0
1668342654617,CSE 293,015,119298,Kane; Daniel Mertz,9999,0,9999,0
1668342654617,CSE 293,016,119299,Kriegman; David J,9999,0,9999,0
1668342654617,CSE 293,017,119300,Kumar; Arun Kumar,9999,0,9999,0
1668342654617,CSE 293,018,119301,Lerner; Sorin,9999,0,9999,0
1668342654617,CSE 293,019,119302,Lovett; Shachar,9999,0,9999,0
1668342654617,CSE 293,020,119303,McAuley; Julian John,9999,0,9999,0
1668342654617,CSE 293,021,119304,Micciancio; Daniele,9999,0,9999,0
1668342654617,CSE 293,022,119367,Orailoglu; Alex,9999,0,9999,0
1668342654617,CSE 293,023,119382,Paturi; Ramamohan,9999,0,9999,0
1668342654617,CSE 293,024,119404,Polikarpova; Nadezhda,9999,0,9999,0
1668342654617,CSE 293,025,119406,Politz; Joseph Gibbs,9999,0,9999,0
1668342654617,CSE 293,026,119411,Porter; George M,9999,0,9999,0
1668342654617,CSE 293,027,119414,Porter; Leonard Emerson,9999,0,9999,0
1668342654617,CSE 293,028,119416,Ramamoorthi; Ravi,9999,0,9999,0
1668342654617,CSE 293,029,119417,Sahoo; Debashis,9999,0,9999,0
1668342654617,CSE 293,030,119420,Saul; Lawrence,9999,0,9999,0
1668342654617,CSE 293,031,119421,Savage; Stefan,9999,0,9999,0
1668342654617,CSE 293,032,119425,Schulze; Jurgen P.,9999,0,9999,0
1668342654617,CSE 293,033,119426,Snoeren; Alex C.,9999,0,9999,0
1668342654617,CSE 293,034,119428,Shang; Jingbo,9999,0,9999,0
1668342654617,CSE 293,035,119430,Stefan; Deian,9999,0,9999,0
1668342654617,CSE 293,036,119431,Su; Hao,9999,0,9999,0
1668342654617,CSE 293,037,119433,Swanson; Steven James,9999,0,9999,0
1668342654617,CSE 293,038,119435,Tullsen; Dean Michael,9999,0,9999,0
1668342654617,CSE 293,039,119483,Voelker; Geoffrey M.,9999,0,9999,0
1668342654617,CSE 293,040,119537,Zhao; Jishen,9999,0,9999,0
1668342654617,CSE 293,041,119538,Zhou; Yuan-Yuan,9999,0,9999,0
1668342654617,CSE 293,042,119539,Gao; Sicun,9999,0,9999,0
1668342654617,CSE 293,043,119540,Weibel; Nadir,9999,0,9999,0
1668342654617,CSE 293,044,119541,Gupta; Rajesh K.,9999,0,9999,0
1668342654617,CSE 293,045,126410,Vaccaro; Kristen Marie,9999,0,9999,0
1668342654617,CSE 293,046,126411,Klemke; Richard,9999,0,9999,0
1668342655045,CSE 294,A00,102459,Voelker; Geoffrey M.,0,0,0,0
1668342655045,CSE 294,B00,111322,Orailoglu; Alex,0,0,0,0
1668342655473,DSE 201,A00,096914,Deutsch; Alin Bernard,30,0,30,0
1668342655898,DSE 210,A00,096915,Dasgupta; Sanjoy,30,0,30,0
1668342656327,DSE 260A,A00,096916,Altintas De Callaf; Ilkay,30,0,30,0
1668342656806,ECE 200,001,103586,Antipa; Nicholas A,9999,0,9999,0
1668342656806,ECE 200,002,103587,Atanasov; Nikolay A.,9999,0,9999,0
1668342656806,ECE 200,003,103588,Bharadia; Dinesh,9999,0,9999,0
1668342656806,ECE 200,004,103589,Cheng; Chung Kuan,9999,0,9999,0
1668342656806,ECE 200,005,103590,Cosman; Pamela C.,9999,0,9999,0
1668342656806,ECE 200,006,103591,Dayeh; Shadi Ahmad,9999,0,9999,0
1668342656806,ECE 200,007,103592,Fainman; Yeshaiahu,9999,0,9999,0
1668342656806,ECE 200,008,103593,Ford; Joseph Earl,9999,0,9999,0
1668342656806,ECE 200,009,103594,Franceschetti; Massimo,9999,0,9999,0
1668342656806,ECE 200,010,103595,Fullerton; Eric E,9999,0,9999,0
1668342656806,ECE 200,011,103596,Galton; Ian A,9999,0,9999,0
1668342656806,ECE 200,012,103597,Gilja; Vikash,9999,0,9999,0
1668342656806,ECE 200,013,103598,Hall; Drew A.,9999,0,9999,0
1668342656806,ECE 200,014,103599,Hsueh; Tzu-Chien,9999,0,9999,0
1668342656806,ECE 200,015,103600,Javidi; Tara,9999,0,9999,0
1668342656806,ECE 200,016,103601,Kahng; Andrew Byun,9999,0,9999,0
1668342656806,ECE 200,017,103602,Kim; Young-Han,9999,0,9999,0
1668342656806,ECE 200,018,103603,Koushanfar; Farinaz,9999,0,9999,0
1668342656806,ECE 200,019,103604,Kuzum; Duygu,9999,0,9999,0
1668342656806,ECE 200,020,103605,Le; Hanh-Phuc,9999,0,9999,0
1668342656806,ECE 200,021,103606,Lin; Bill,9999,0,9999,0
1668342656806,ECE 200,022,103607,Liu; Zhaowei,9998,0,9999,1
1668342656806,ECE 200,023,103608,Lo; Yu-Hwa,9999,0,9999,0
1668342656806,ECE 200,024,103609,Lomakin; Vitaliy,9999,0,9999,0
1668342656806,ECE 200,025,103610,Mercier; Patrick Philip,9999,0,9999,0
1668342656806,ECE 200,026,103611,Meyer; Florian,9999,0,9999,0
1668342656806,ECE 200,027,103612,Milstein; Laurence B.,9999,0,9999,0
1668342656806,ECE 200,028,103613,Mir Arabbaygi; Siavash,9999,0,9999,0
1668342656806,ECE 200,029,103614,Mookherjea; Shayan,9999,0,9999,0
1668342656806,ECE 200,030,103615,Morris; Karcher William,9999,0,9999,0
1668342656806,ECE 200,031,103616,Ng; Tse Nga,9999,0,9999,0
1668342656806,ECE 200,032,103617,Nguyen; Truong Quang,9999,0,9999,0
1668342656806,ECE 200,033,103618,Nomura; Kenji,9999,0,9999,0
1668342656806,ECE 200,034,103619,Orlitsky; Alon,9999,0,9999,0
1668342656806,ECE 200,035,103620,Pal; Piya,9999,0,9999,0
1668342656806,ECE 200,036,103621,Papen; George C.,9999,0,9999,0
1668342656806,ECE 200,037,103622,Radic; Stojan,9999,0,9999,0
1668342656806,ECE 200,038,103623,Rao; Bhaskar D.,9999,0,9999,0
1668342656806,ECE 200,039,103624,Rao; Ramesh R,9999,0,9999,0
1668342656806,ECE 200,040,103625,Rebeiz; Gabriel,9999,0,9999,0
1668342656806,ECE 200,041,103626,Sanford; John R,9999,0,9999,0
1668342656806,ECE 200,042,103627,Siegel; Paul H.,9999,0,9999,0
1668342656806,ECE 200,043,103628,Sievenpiper; Daniel F.,9999,0,9999,0
1668342656806,ECE 200,044,103629,Sworder; David D.,9999,0,9999,0
1668342656806,ECE 200,045,103630,Taur; Yuan,9999,0,9999,0
1668342656806,ECE 200,046,103631,Touri; Behrouz,9999,0,9999,0
1668342656806,ECE 200,047,103632,Trivedi; Mohan M.,9999,0,9999,0
1668342656806,ECE 200,048,103633,Vasconcelos; Nuno,9999,0,9999,0
1668342656806,ECE 200,049,103634,Wang; Xiaolong,9999,0,9999,0
1668342656806,ECE 200,050,103635,Xie; Pengtao,9999,0,9999,0
1668342656806,ECE 200,051,103636,Yip; Michael,9999,0,9999,0
1668342656806,ECE 200,052,103637,Zeger; Kenneth A.,999,0,999,0
1668342656806,ECE 200,053,103638,Zhang; Xinyu,9999,0,9999,0
1668342656806,ECE 200,054,103639,Turakhia; Yatish Girish,9999,0,9999,0
1668342656806,ECE 200,055,103640,Kang; Mingu,9999,0,9999,0
1668342656806,ECE 200,056,103641,Shi; Yuanyuan,9999,0,9999,0
1668342656806,ECE 200,057,103642,Wang; Edward Jay,9999,0,9999,0
1668342656806,ECE 200,058,103643,Zheng; Yang,9999,0,9999,0
1668342657234,ECE 202,A00,103644,Kuzum; Duygu,0,0,0,0
1668342657661,ECE 212BN,A00,103646,Ng; Tse Nga,0,0,0,0
1668342658161,ECE 221,A00,111493,Staff,0,0,0,0
1668342658587,ECE 222B,A00,103647,Lomakin; Vitaliy,0,0,0,0
1668342659015,ECE 230B,A00,103648,Taur; Yuan,0,0,0,0
1668342659445,ECE 238B,A00,103649,Garay; Javier,0,0,0,0
1668342659869,ECE 240B,A00,112900,Fainman; Yeshaiahu,0,0,0,0
1668342660297,ECE 247A,A00,103650,Jokerst; Jesse Vincent,0,0,0,0
1668342660724,ECE 247B,A00,103651,Wang; Joseph,0,0,0,0
1668342661149,ECE 250,A00,103652,Siegel; Paul H.,0,0,0,0
1668342661578,ECE 251A,A00,103654,Rao; Bhaskar D.,0,0,0,0
1668342662008,ECE 257B,A00,103655,Bharadia; Dinesh,0,0,0,0
1668342662437,ECE 258A,A00,103656,Milstein; Laurence B.,0,0,0,0
1668342662865,ECE 260B,A00,103658,Kang; Mingu,0,0,0,0
1668342663296,ECE 264A,A00,103659,Galton; Ian A,0,0,0,0
1668342663727,ECE 265A,A00,103661,Gudem; Prasad S.S.,0,0,0,0
1668342664153,ECE 265D,A00,103662,Gudem; Prasad S.S.,0,0,0,0
1668342664578,ECE 268,A00,103663,Koushanfar; Farinaz,0,0,0,0
1668342665005,ECE 269,A01,103665,Pal; Piya,0,0,0,0
1668342665437,ECE 271B,A00,103666,Vasconcelos; Manuela,0,0,0,0
1668342665862,ECE 276A,A00,103667,Atanasov; Nikolay A.,0,0,0,0
1668342666295,ECE 277,A00,103668,An; Cheolhong,0,0,0,0
1668342666725,ECE 279,A00,117947,Hall; Drew A.,0,0,0,0
1668342667578,ECE 283,A00,103670,Hsueh; Tzu-Chien,0,0,0,0
1668342668005,ECE 284,A00,103671,Turakhia; Yatish Girish,0,0,0,0
1668342668446,ECE 285,A00,103672,Zheng; Yang,0,0,0,0
1668342668446,ECE 285,B00,103673,Sworder; David D.,0,0,0,0
1668342668874,ECE 287,A00,103676,Javidi; Tara,0,0,0,0
1668342669306,MATH 200B,A00,098023,Salehi Golsefidy; Alireza,12,0,15,3
1668342669733,MATH 202B,A00,098024,Rhoades; Brendon Patrick,9,0,15,6
1668342670161,MATH 203B,A00,098025,Oprea; Dragos N.,10,0,15,5
1668342670591,MATH 204B,A00,098026,Sorensen; Claus M,13,0,15,2
1668342671019,MATH 208,A00,098027,Izadi; Elham,7,0,10,3
1668342671448,MATH 209,A00,098028,Pollack; Aaron,10,0,10,0
1668342671874,MATH 211A,A00,112919,Rogalski; Daniel,9,0,10,1
1668342672303,MATH 211B,A00,112920,Seward; Brandon M.,9,0,10,1
1668342672733,MATH 218,A00,098029,Li; Bo,10,0,10,0
1668342673159,MATH 220B,A00,098030,Novak; Jonathan I,11,0,15,4
1668342673586,MATH 221A,A00,098031,Ebenfelt; Peter F,13,0,15,2
1668342674010,MATH 231B,A00,098032,Zlatos; Andrej,12,0,15,3
1668342674447,MATH 240B,A00,098033,Ni; Lei,9,0,15,6
1668342674872,MATH 243,A00,098034,Jekel; David Andrew,10,0,10,0
1668342675301,MATH 245A,A00,098035,Nie; Jiawang,0,0,15,16
1668342675728,MATH 248,A00,098036,Bejenaru; Ioan,10,0,10,0
1668342676156,MATH 250B,A00,098037,Spolaor; Luca,14,0,15,1
1668342676587,MATH 258,A00,098038,Ni; Lei,10,0,10,0
1668342677030,MATH 264B,A00,098041,Rhoades; Brendon Patrick,9,0,15,6
1668342677458,MATH 268,A00,098042,Buss; Samuel R,10,0,10,0
1668342677886,MATH 269,A00,098043,Rhoades; Brendon Patrick,10,0,10,0
1668342678312,MATH 270B,A00,098044,Li; Bo,10,0,15,5
1668342678740,MATH 272B,A00,098045,Holst; Michael J,13,0,15,2
1668342679172,MATH 273A,A00,098046,Tian; Xiaochuan,10,0,15,5
1668342679596,MATH 275,A01,098048,Tian; Xiaochuan,6,0,10,4
1668342680026,MATH 278A,A00,098049,Holst; Michael J,8,0,10,2
1668342680454,MATH 278B,A00,098050,Cloninger; Alexander,10,0,10,0
1668342680880,MATH 278C,A00,098051,Nie; Jiawang,7,0,10,3
1668342681307,MATH 280B,A00,098052,Zheng; Tianyi,8,0,15,7
1668342681733,MATH 281B,A00,098053,Bradic; Jelena,1,0,15,14
1668342682161,MATH 282B,A00,098054,Arias-Castro; Ery,0,0,15,15
1668342682585,MATH 285,A00,098055,Fitzsimmons; Patrick J,0,0,15,17
1668342683012,MATH 287B,A00,098056,Arias-Castro; Ery,2,0,15,13
1668342683439,MATH 288,A00,098057,Agarwal; Pooja,9,0,10,1
1668342683439,MATH 288,B00,098058,Zhang; Danna,8,0,10,2
1668342683439,MATH 288,C00,098059,Williams; Ruth J,9,0,10,1
1668342683878,MATH 290B,A00,098060,Roberts; Justin Deritter,13,0,15,2
1668342684302,MATH 292,A00,098061,Belmont; Eva Kinoshita,10,0,10,0
1668342684727,MATH 295,A00,098062,Suk; Andrew Hoon,48,0,50,2
1668342685152,MATH 296,A00,098063,Novak; Jonathan I,20,0,20,0
1668342685579,MATH 297,001,098064,Gamst; Anthony Collins,9997,0,9999,2
1668343187734,COGS 205,A00,101395,Chiba; Andrea,19,0,20,1
1668343188169,COGS 210B,001,101404,Greene; Deanna Jacquelyn,9998,0,9999,1
1668343188169,COGS 210B,002,101417,Xia; Haijun,9999,0,9999,0
1668343188169,COGS 210B,003,101422,Nitz; Douglas A.,9999,0,9999,0
1668343188169,COGS 210B,004,101423,Hollan; James D.,9998,0,9999,1
1668343188169,COGS 210B,005,101424,Deak; Gedeon O.,9998,0,9999,1
1668343188169,COGS 210B,006,101425,Rossano; Federico,9999,0,9999,0
1668343188597,COGS 211B,A00,101427,Coulson; Seana M,9996,0,9999,3
1668343189024,COGS 220,A00,101428,Hollan; James D.,0,0,25,25
1668343189449,COGS 229,A00,101429,Dow; Steven P,18,0,25,7
1668343189876,COGS 230,A00,101430,Klemmer; Scott R,11,0,17,6
1668343190304,COGS 234,A00,101431,Xia; Haijun,1,0,25,24
1668343190731,COGS 260,A00,101432,Kiyonaga; Anastasia,21,0,25,4
1668343190731,COGS 260,B00,101433,Kirsh; David Joel,15,0,25,10
1668343191162,CSE 202,A00,102371,Impagliazzo; Russell,0,0,0,0
1668343191587,CSE 203B,A01,102373,Cheng; Chung Kuan,0,0,0,0
1668343192013,CSE 208,A00,102374,Micciancio; Daniele,0,0,0,0
1668343192441,CSE 209A,A00,112895,Impagliazzo; Russell,0,0,15,15
1668343192867,CSE 209B,A00,108005,Bellare; Mihir,0,0,0,0
1668343193297,CSE 210,A00,113163,Coblenz; Michael J,0,0,0,0
1668343193725,CSE 219,A00,106111,Dow; Steven P,0,0,20,20
1668343194157,CSE 221,A00,102376,Voelker; Geoffrey M.,0,0,0,0
1668343194585,CSE 224,A01,102378,Porter; George M,0,0,0,0
1668343195012,CSE 229A,A00,102379,Savage; Stefan,0,0,0,0
1668343195443,CSE 229C,A00,102380,Munyaka; Imani N. S.,0,0,0,0
1668343195872,CSE 232B,A00,102382,Deutsch; Alin Bernard,0,0,0,0
1668343196303,CSE 234,A01,112904,Kumar; Arun Kumar,0,0,0,0
1668343196729,CSE 237A,A00,102383,Rosing; Tajana Simunic,0,0,0,0
1668343197157,CSE 239A,A00,102384,Deutsch; Alin Bernard,0,0,0,0
1668343197580,CSE 239B,A00,102385,Polikarpova; Nadezhda,0,0,0,0
1668343198006,CSE 240A,A00,102386,Pannuto; Patrick William,0,0,0,0
1668343198434,CSE 240B,A00,102387,Zhao; Jishen,0,0,0,0
1668343198864,CSE 241A,A00,106406,Kang; Mingu,0,0,0,0
1668343199292,CSE 249B,A00,102388,Kahng; Andrew Byun,0,0,8,8
1668343199718,CSE 251B,A01,102392,Cottrell; Garrison W,0,0,0,0
1668343199718,CSE 251B,A02,102393,Cottrell; Garrison W,0,0,0,0
1668343200145,CSE 252B,A00,102394,Ochoa; Benjamin Lawrence,0,0,0,0
1668343200569,CSE 257,A01,102396,Gao; Sicun,0,0,0,0
1668343201004,CSE 272,A00,102397,Li; Tzumao,0,0,0,0
1668343201429,CSE 274,A00,111323,Chern; Albert Ren-Haur,0,0,0,0
1668343201859,CSE 282,A00,102398,Pevzner; Pavel Arkadjevich,0,0,0,0
1668343202291,CSE 284,A00,114175,Gymrek; Melissa Ann,0,0,0,0
1668343202719,CSE 290,A00,102399,Chandraker; Manmohan Krishna,0,0,0,0
1668343202719,CSE 290,B00,102400,Vaccaro; Kristen Marie,0,0,25,25
1668343202719,CSE 290,C00,102414,Pannuto; Patrick William,0,0,25,25
1668343202719,CSE 290,D00,102427,Pevzner; Pavel Arkadjevich,0,0,0,0
1668343202719,CSE 290,E00,102429,Zhao; Jishen,0,0,0,0
1668343202719,CSE 290,F00,102436,Tullsen; Dean Michael,0,0,0,0
1668343202719,CSE 290,G00,102440,Christensen; Henrik I,0,0,20,20
1668343203158,CSE 291,A00,102443,Su; Hao,0,0,0,0
1668343203158,CSE 291,B00,102448,Polikarpova; Nadezhda,0,0,0,0
1668343203158,CSE 291,C00,102453,Vaccaro; Kristen Marie,0,0,0,0
1668343203158,CSE 291,D00,111343,Savage; Stefan,0,0,0,0
1668343203158,CSE 291,E00,116474,Claffy; Kimberly Claire,0,0,0,0
1668343203158,CSE 291,F00,116479,Pasquale; Joseph,0,0,0,0
1668343203623,CSE 293,001,119111,Bafna; Vineet,9999,0,9999,0
1668343203623,CSE 293,002,119118,Bellare; Mihir,9999,0,9999,0
1668343203623,CSE 293,003,119122,Berg-Kirkpatrick; Taylor D,9999,0,9999,0
1668343203623,CSE 293,004,119135,Christensen; Henrik I,9999,0,9999,0
1668343203623,CSE 293,005,119142,Cottrell; Garrison W,9999,0,9999,0
1668343203623,CSE 293,006,119146,Deutsch; Alin Bernard,9999,0,9999,0
1668343203623,CSE 293,007,119159,Esmaeilzadeh; Hadi,9999,0,9999,0
1668343203623,CSE 293,008,119166,Freund; Yoav,9999,0,9999,0
1668343203623,CSE 293,009,119170,Griswold; William G.,9999,0,9999,0
1668343203623,CSE 293,010,119183,Gymrek; Melissa Ann,9999,0,9999,0
1668343203623,CSE 293,011,119190,Heninger; Nadia A,9999,0,9999,0
1668343203623,CSE 293,012,119230,Impagliazzo; Russell,9999,0,9999,0
1668343203623,CSE 293,013,119232,Jhala; Ranjit,9999,0,9999,0
1668343203623,CSE 293,014,119233,Kahng; Andrew Byun,9999,0,9999,0
1668343203623,CSE 293,015,119298,Kane; Daniel Mertz,9999,0,9999,0
1668343203623,CSE 293,016,119299,Kriegman; David J,9999,0,9999,0
1668343203623,CSE 293,017,119300,Kumar; Arun Kumar,9999,0,9999,0
1668343203623,CSE 293,018,119301,Lerner; Sorin,9999,0,9999,0
1668343203623,CSE 293,019,119302,Lovett; Shachar,9999,0,9999,0
1668343203623,CSE 293,020,119303,McAuley; Julian John,9999,0,9999,0
1668343203623,CSE 293,021,119304,Micciancio; Daniele,9999,0,9999,0
1668343203623,CSE 293,022,119367,Orailoglu; Alex,9999,0,9999,0
1668343203623,CSE 293,023,119382,Paturi; Ramamohan,9999,0,9999,0
1668343203623,CSE 293,024,119404,Polikarpova; Nadezhda,9999,0,9999,0
1668343203623,CSE 293,025,119406,Politz; Joseph Gibbs,9999,0,9999,0
1668343203623,CSE 293,026,119411,Porter; George M,9999,0,9999,0
1668343203623,CSE 293,027,119414,Porter; Leonard Emerson,9999,0,9999,0
1668343203623,CSE 293,028,119416,Ramamoorthi; Ravi,9999,0,9999,0
1668343203623,CSE 293,029,119417,Sahoo; Debashis,9999,0,9999,0
1668343203623,CSE 293,030,119420,Saul; Lawrence,9999,0,9999,0
1668343203623,CSE 293,031,119421,Savage; Stefan,9999,0,9999,0
1668343203623,CSE 293,032,119425,Schulze; Jurgen P.,9999,0,9999,0
1668343203623,CSE 293,033,119426,Snoeren; Alex C.,9999,0,9999,0
1668343203623,CSE 293,034,119428,Shang; Jingbo,9999,0,9999,0
1668343203623,CSE 293,035,119430,Stefan; Deian,9999,0,9999,0
1668343203623,CSE 293,036,119431,Su; Hao,9999,0,9999,0
1668343203623,CSE 293,037,119433,Swanson; Steven James,9999,0,9999,0
1668343203623,CSE 293,038,119435,Tullsen; Dean Michael,9999,0,9999,0
1668343203623,CSE 293,039,119483,Voelker; Geoffrey M.,9999,0,9999,0
1668343203623,CSE 293,040,119537,Zhao; Jishen,9999,0,9999,0
1668343203623,CSE 293,041,119538,Zhou; Yuan-Yuan,9999,0,9999,0
1668343203623,CSE 293,042,119539,Gao; Sicun,9999,0,9999,0
1668343203623,CSE 293,043,119540,Weibel; Nadir,9999,0,9999,0
1668343203623,CSE 293,044,119541,Gupta; Rajesh K.,9999,0,9999,0
1668343203623,CSE 293,045,126410,Vaccaro; Kristen Marie,9999,0,9999,0
1668343203623,CSE 293,046,126411,Klemke; Richard,9999,0,9999,0
1668343204054,CSE 294,A00,102459,Voelker; Geoffrey M.,0,0,0,0
1668343204054,CSE 294,B00,111322,Orailoglu; Alex,0,0,0,0
1668343204480,DSE 201,A00,096914,Deutsch; Alin Bernard,30,0,30,0
1668343204908,DSE 210,A00,096915,Dasgupta; Sanjoy,30,0,30,0
1668343205334,DSE 260A,A00,096916,Altintas De Callaf; Ilkay,30,0,30,0
1668343205789,ECE 200,001,103586,Antipa; Nicholas A,9999,0,9999,0
1668343205789,ECE 200,002,103587,Atanasov; Nikolay A.,9999,0,9999,0
1668343205789,ECE 200,003,103588,Bharadia; Dinesh,9999,0,9999,0
1668343205789,ECE 200,004,103589,Cheng; Chung Kuan,9999,0,9999,0
1668343205789,ECE 200,005,103590,Cosman; Pamela C.,9999,0,9999,0
1668343205789,ECE 200,006,103591,Dayeh; Shadi Ahmad,9999,0,9999,0
1668343205789,ECE 200,007,103592,Fainman; Yeshaiahu,9999,0,9999,0
1668343205789,ECE 200,008,103593,Ford; Joseph Earl,9999,0,9999,0
1668343205789,ECE 200,009,103594,Franceschetti; Massimo,9999,0,9999,0
1668343205789,ECE 200,010,103595,Fullerton; Eric E,9999,0,9999,0
1668343205789,ECE 200,011,103596,Galton; Ian A,9999,0,9999,0
1668343205789,ECE 200,012,103597,Gilja; Vikash,9999,0,9999,0
1668343205789,ECE 200,013,103598,Hall; Drew A.,9999,0,9999,0
1668343205789,ECE 200,014,103599,Hsueh; Tzu-Chien,9999,0,9999,0
1668343205789,ECE 200,015,103600,Javidi; Tara,9999,0,9999,0
1668343205789,ECE 200,016,103601,Kahng; Andrew Byun,9999,0,9999,0
1668343205789,ECE 200,017,103602,Kim; Young-Han,9999,0,9999,0
1668343205789,ECE 200,018,103603,Koushanfar; Farinaz,9999,0,9999,0
1668343205789,ECE 200,019,103604,Kuzum; Duygu,9999,0,9999,0
1668343205789,ECE 200,020,103605,Le; Hanh-Phuc,9999,0,9999,0
1668343205789,ECE 200,021,103606,Lin; Bill,9999,0,9999,0
1668343205789,ECE 200,022,103607,Liu; Zhaowei,9998,0,9999,1
1668343205789,ECE 200,023,103608,Lo; Yu-Hwa,9999,0,9999,0
1668343205789,ECE 200,024,103609,Lomakin; Vitaliy,9999,0,9999,0
1668343205789,ECE 200,025,103610,Mercier; Patrick Philip,9999,0,9999,0
1668343205789,ECE 200,026,103611,Meyer; Florian,9999,0,9999,0
1668343205789,ECE 200,027,103612,Milstein; Laurence B.,9999,0,9999,0
1668343205789,ECE 200,028,103613,Mir Arabbaygi; Siavash,9999,0,9999,0
1668343205789,ECE 200,029,103614,Mookherjea; Shayan,9999,0,9999,0
1668343205789,ECE 200,030,103615,Morris; Karcher William,9999,0,9999,0
1668343205789,ECE 200,031,103616,Ng; Tse Nga,9999,0,9999,0
1668343205789,ECE 200,032,103617,Nguyen; Truong Quang,9999,0,9999,0
1668343205789,ECE 200,033,103618,Nomura; Kenji,9999,0,9999,0
1668343205789,ECE 200,034,103619,Orlitsky; Alon,9999,0,9999,0
1668343205789,ECE 200,035,103620,Pal; Piya,9999,0,9999,0
1668343205789,ECE 200,036,103621,Papen; George C.,9999,0,9999,0
1668343205789,ECE 200,037,103622,Radic; Stojan,9999,0,9999,0
1668343205789,ECE 200,038,103623,Rao; Bhaskar D.,9999,0,9999,0
1668343205789,ECE 200,039,103624,Rao; Ramesh R,9999,0,9999,0
1668343205789,ECE 200,040,103625,Rebeiz; Gabriel,9999,0,9999,0
1668343205789,ECE 200,041,103626,Sanford; John R,9999,0,9999,0
1668343205789,ECE 200,042,103627,Siegel; Paul H.,9999,0,9999,0
1668343205789,ECE 200,043,103628,Sievenpiper; Daniel F.,9999,0,9999,0
1668343205789,ECE 200,044,103629,Sworder; David D.,9999,0,9999,0
1668343205789,ECE 200,045,103630,Taur; Yuan,9999,0,9999,0
1668343205789,ECE 200,046,103631,Touri; Behrouz,9999,0,9999,0
1668343205789,ECE 200,047,103632,Trivedi; Mohan M.,9999,0,9999,0
1668343205789,ECE 200,048,103633,Vasconcelos; Nuno,9999,0,9999,0
1668343205789,ECE 200,049,103634,Wang; Xiaolong,9999,0,9999,0
1668343205789,ECE 200,050,103635,Xie; Pengtao,9999,0,9999,0
1668343205789,ECE 200,051,103636,Yip; Michael,9999,0,9999,0
1668343205789,ECE 200,052,103637,Zeger; Kenneth A.,999,0,999,0
1668343205789,ECE 200,053,103638,Zhang; Xinyu,9999,0,9999,0
1668343205789,ECE 200,054,103639,Turakhia; Yatish Girish,9999,0,9999,0
1668343205789,ECE 200,055,103640,Kang; Mingu,9999,0,9999,0
1668343205789,ECE 200,056,103641,Shi; Yuanyuan,9999,0,9999,0
1668343205789,ECE 200,057,103642,Wang; Edward Jay,9999,0,9999,0
1668343205789,ECE 200,058,103643,Zheng; Yang,9999,0,9999,0
1668343206213,ECE 202,A00,103644,Kuzum; Duygu,0,0,0,0
1668343206637,ECE 212BN,A00,103646,Ng; Tse Nga,0,0,0,0
1668343207064,ECE 221,A00,111493,Staff,0,0,0,0
1668343207493,ECE 222B,A00,103647,Lomakin; Vitaliy,0,0,0,0
1668343207930,ECE 230B,A00,103648,Taur; Yuan,0,0,0,0
1668343208361,ECE 238B,A00,103649,Garay; Javier,0,0,0,0
1668343208793,ECE 240B,A00,112900,Fainman; Yeshaiahu,0,0,0,0
1668343209220,ECE 247A,A00,103650,Jokerst; Jesse Vincent,0,0,0,0
1668343209644,ECE 247B,A00,103651,Wang; Joseph,0,0,0,0
1668343210077,ECE 250,A00,103652,Siegel; Paul H.,0,0,0,0
1668343210508,ECE 251A,A00,103654,Rao; Bhaskar D.,0,0,0,0
1668343210938,ECE 257B,A00,103655,Bharadia; Dinesh,0,0,0,0
1668343211364,ECE 258A,A00,103656,Milstein; Laurence B.,0,0,0,0
1668343211790,ECE 260B,A00,103658,Kang; Mingu,0,0,0,0
1668343212218,ECE 264A,A00,103659,Galton; Ian A,0,0,0,0
1668343212646,ECE 265A,A00,103661,Gudem; Prasad S.S.,0,0,0,0
1668343213069,ECE 265D,A00,103662,Gudem; Prasad S.S.,0,0,0,0
1668343213496,ECE 268,A00,103663,Koushanfar; Farinaz,0,0,0,0
1668343213924,ECE 269,A01,103665,Pal; Piya,0,0,0,0
1668343214350,ECE 271B,A00,103666,Vasconcelos; Manuela,0,0,0,0
1668343214775,ECE 276A,A00,103667,Atanasov; Nikolay A.,0,0,0,0
1668343215206,ECE 277,A00,103668,An; Cheolhong,0,0,0,0
1668343215634,ECE 279,A00,117947,Hall; Drew A.,0,0,0,0
1668343216487,ECE 283,A00,103670,Hsueh; Tzu-Chien,0,0,0,0
1668343216912,ECE 284,A00,103671,Turakhia; Yatish Girish,0,0,0,0
1668343217341,ECE 285,A00,103672,Zheng; Yang,0,0,0,0
1668343217341,ECE 285,B00,103673,Sworder; David D.,0,0,0,0
1668343217768,ECE 287,A00,103676,Javidi; Tara,0,0,0,0
1668343218203,MATH 200B,A00,098023,Salehi Golsefidy; Alireza,12,0,15,3
1668343218631,MATH 202B,A00,098024,Rhoades; Brendon Patrick,9,0,15,6
1668343219065,MATH 203B,A00,098025,Oprea; Dragos N.,10,0,15,5
1668343219494,MATH 204B,A00,098026,Sorensen; Claus M,13,0,15,2
1668343219919,MATH 208,A00,098027,Izadi; Elham,7,0,10,3
1668343220345,MATH 209,A00,098028,Pollack; Aaron,10,0,10,0
1668343220771,MATH 211A,A00,112919,Rogalski; Daniel,9,0,10,1
1668343221199,MATH 211B,A00,112920,Seward; Brandon M.,9,0,10,1
1668343221629,MATH 218,A00,098029,Li; Bo,10,0,10,0
1668343222058,MATH 220B,A00,098030,Novak; Jonathan I,11,0,15,4
1668343222489,MATH 221A,A00,098031,Ebenfelt; Peter F,13,0,15,2
1668343222920,MATH 231B,A00,098032,Zlatos; Andrej,12,0,15,3
1668343223350,MATH 240B,A00,098033,Ni; Lei,9,0,15,6
1668343223853,MATH 243,A00,098034,Jekel; David Andrew,10,0,10,0
1668343224279,MATH 245A,A00,098035,Nie; Jiawang,0,0,15,16
1668343224705,MATH 248,A00,098036,Bejenaru; Ioan,10,0,10,0
1668343225130,MATH 250B,A00,098037,Spolaor; Luca,14,0,15,1
1668343225559,MATH 258,A00,098038,Ni; Lei,10,0,10,0
1668343225984,MATH 264B,A00,098041,Rhoades; Brendon Patrick,9,0,15,6
1668343226413,MATH 268,A00,098042,Buss; Samuel R,10,0,10,0
1668343226839,MATH 269,A00,098043,Rhoades; Brendon Patrick,10,0,10,0
1668343227270,MATH 270B,A00,098044,Li; Bo,10,0,15,5
1668343227696,MATH 272B,A00,098045,Holst; Michael J,13,0,15,2
1668343228125,MATH 273A,A00,098046,Tian; Xiaochuan,10,0,15,5
1668343228556,MATH 275,A01,098048,Tian; Xiaochuan,6,0,10,4
1668343228983,MATH 278A,A00,098049,Holst; Michael J,8,0,10,2
1668343229408,MATH 278B,A00,098050,Cloninger; Alexander,10,0,10,0
1668343229833,MATH 278C,A00,098051,Nie; Jiawang,7,0,10,3
1668343230263,MATH 280B,A00,098052,Zheng; Tianyi,8,0,15,7
1668343230687,MATH 281B,A00,098053,Bradic; Jelena,1,0,15,14
1668343231116,MATH 282B,A00,098054,Arias-Castro; Ery,0,0,15,15
1668343231541,MATH 285,A00,098055,Fitzsimmons; Patrick J,0,0,15,17
1668343231970,MATH 287B,A00,098056,Arias-Castro; Ery,2,0,15,13
1668343232400,MATH 288,A00,098057,Agarwal; Pooja,9,0,10,1
1668343232400,MATH 288,B00,098058,Zhang; Danna,8,0,10,2
1668343232400,MATH 288,C00,098059,Williams; Ruth J,9,0,10,1
1668343232826,MATH 290B,A00,098060,Roberts; Justin Deritter,13,0,15,2
1668343233250,MATH 292,A00,098061,Belmont; Eva Kinoshita,10,0,10,0
1668343233675,MATH 295,A00,098062,Suk; Andrew Hoon,48,0,50,2
1668343234104,MATH 296,A00,098063,Novak; Jonathan I,20,0,20,0
1668343234531,MATH 297,001,098064,Gamst; Anthony Collins,9997,0,9999,2
1668343736289,COGS 205,A00,101395,Chiba; Andrea,19,0,20,1
1668343736717,COGS 210B,001,101404,Greene; Deanna Jacquelyn,9998,0,9999,1
1668343736717,COGS 210B,002,101417,Xia; Haijun,9999,0,9999,0
1668343736717,COGS 210B,003,101422,Nitz; Douglas A.,9999,0,9999,0
1668343736717,COGS 210B,004,101423,Hollan; James D.,9998,0,9999,1
1668343736717,COGS 210B,005,101424,Deak; Gedeon O.,9998,0,9999,1
1668343736717,COGS 210B,006,101425,Rossano; Federico,9999,0,9999,0
1668343737147,COGS 211B,A00,101427,Coulson; Seana M,9996,0,9999,3
1668343737576,COGS 220,A00,101428,Hollan; James D.,0,0,25,25
1668343738003,COGS 229,A00,101429,Dow; Steven P,18,0,25,7
1668343738431,COGS 230,A00,101430,Klemmer; Scott R,11,0,17,6
1668343738857,COGS 234,A00,101431,Xia; Haijun,1,0,25,24
1668343739284,COGS 260,A00,101432,Kiyonaga; Anastasia,21,0,25,4
1668343739284,COGS 260,B00,101433,Kirsh; David Joel,15,0,25,10
1668343739711,CSE 202,A00,102371,Impagliazzo; Russell,0,0,0,0
1668343740136,CSE 203B,A01,102373,Cheng; Chung Kuan,0,0,0,0
1668343740568,CSE 208,A00,102374,Micciancio; Daniele,0,0,0,0
1668343741008,CSE 209A,A00,112895,Impagliazzo; Russell,0,0,15,15
1668343741435,CSE 209B,A00,108005,Bellare; Mihir,0,0,0,0
1668343741861,CSE 210,A00,113163,Coblenz; Michael J,0,0,0,0
1668343742293,CSE 219,A00,106111,Dow; Steven P,0,0,20,20
1668343742721,CSE 221,A00,102376,Voelker; Geoffrey M.,0,0,0,0
1668343743150,CSE 224,A01,102378,Porter; George M,0,0,0,0
1668343743578,CSE 229A,A00,102379,Savage; Stefan,0,0,0,0
1668343744001,CSE 229C,A00,102380,Munyaka; Imani N. S.,0,0,0,0
1668343744430,CSE 232B,A00,102382,Deutsch; Alin Bernard,0,0,0,0
1668343744856,CSE 234,A01,112904,Kumar; Arun Kumar,0,0,0,0
1668343745284,CSE 237A,A00,102383,Rosing; Tajana Simunic,0,0,0,0
1668343745802,CSE 239A,A00,102384,Deutsch; Alin Bernard,0,0,0,0
1668343746231,CSE 239B,A00,102385,Polikarpova; Nadezhda,0,0,0,0
1668343746658,CSE 240A,A00,102386,Pannuto; Patrick William,0,0,0,0
1668343747086,CSE 240B,A00,102387,Zhao; Jishen,0,0,0,0
1668343747513,CSE 241A,A00,106406,Kang; Mingu,0,0,0,0
1668343747938,CSE 249B,A00,102388,Kahng; Andrew Byun,0,0,8,8
1668343748363,CSE 251B,A01,102392,Cottrell; Garrison W,0,0,0,0
1668343748363,CSE 251B,A02,102393,Cottrell; Garrison W,0,0,0,0
1668343748789,CSE 252B,A00,102394,Ochoa; Benjamin Lawrence,0,0,0,0
1668343749218,CSE 257,A01,102396,Gao; Sicun,0,0,0,0
1668343749641,CSE 272,A00,102397,Li; Tzumao,0,0,0,0
1668343750070,CSE 274,A00,111323,Chern; Albert Ren-Haur,0,0,0,0
1668343750495,CSE 282,A00,102398,Pevzner; Pavel Arkadjevich,0,0,0,0
1668343750920,CSE 284,A00,114175,Gymrek; Melissa Ann,0,0,0,0
1668343751351,CSE 290,A00,102399,Chandraker; Manmohan Krishna,0,0,0,0
1668343751351,CSE 290,B00,102400,Vaccaro; Kristen Marie,0,0,25,25
1668343751351,CSE 290,C00,102414,Pannuto; Patrick William,0,0,25,25
1668343751351,CSE 290,D00,102427,Pevzner; Pavel Arkadjevich,0,0,0,0
1668343751351,CSE 290,E00,102429,Zhao; Jishen,0,0,0,0
1668343751351,CSE 290,F00,102436,Tullsen; Dean Michael,0,0,0,0
1668343751351,CSE 290,G00,102440,Christensen; Henrik I,0,0,20,20
1668343751782,CSE 291,A00,102443,Su; Hao,0,0,0,0
1668343751782,CSE 291,B00,102448,Polikarpova; Nadezhda,0,0,0,0
1668343751782,CSE 291,C00,102453,Vaccaro; Kristen Marie,0,0,0,0
1668343751782,CSE 291,D00,111343,Savage; Stefan,0,0,0,0
1668343751782,CSE 291,E00,116474,Claffy; Kimberly Claire,0,0,0,0
1668343751782,CSE 291,F00,116479,Pasquale; Joseph,0,0,0,0
1668343752254,CSE 293,001,119111,Bafna; Vineet,9999,0,9999,0
1668343752254,CSE 293,002,119118,Bellare; Mihir,9999,0,9999,0
1668343752254,CSE 293,003,119122,Berg-Kirkpatrick; Taylor D,9999,0,9999,0
1668343752254,CSE 293,004,119135,Christensen; Henrik I,9999,0,9999,0
1668343752254,CSE 293,005,119142,Cottrell; Garrison W,9999,0,9999,0
1668343752254,CSE 293,006,119146,Deutsch; Alin Bernard,9999,0,9999,0
1668343752254,CSE 293,007,119159,Esmaeilzadeh; Hadi,9999,0,9999,0
1668343752254,CSE 293,008,119166,Freund; Yoav,9999,0,9999,0
1668343752254,CSE 293,009,119170,Griswold; William G.,9999,0,9999,0
1668343752254,CSE 293,010,119183,Gymrek; Melissa Ann,9999,0,9999,0
1668343752254,CSE 293,011,119190,Heninger; Nadia A,9999,0,9999,0
1668343752254,CSE 293,012,119230,Impagliazzo; Russell,9999,0,9999,0
1668343752254,CSE 293,013,119232,Jhala; Ranjit,9999,0,9999,0
1668343752254,CSE 293,014,119233,Kahng; Andrew Byun,9999,0,9999,0
1668343752254,CSE 293,015,119298,Kane; Daniel Mertz,9999,0,9999,0
1668343752254,CSE 293,016,119299,Kriegman; David J,9999,0,9999,0
1668343752254,CSE 293,017,119300,Kumar; Arun Kumar,9999,0,9999,0
1668343752254,CSE 293,018,119301,Lerner; Sorin,9999,0,9999,0
1668343752254,CSE 293,019,119302,Lovett; Shachar,9999,0,9999,0
1668343752254,CSE 293,020,119303,McAuley; Julian John,9999,0,9999,0
1668343752254,CSE 293,021,119304,Micciancio; Daniele,9999,0,9999,0
1668343752254,CSE 293,022,119367,Orailoglu; Alex,9999,0,9999,0
1668343752254,CSE 293,023,119382,Paturi; Ramamohan,9999,0,9999,0
1668343752254,CSE 293,024,119404,Polikarpova; Nadezhda,9999,0,9999,0
1668343752254,CSE 293,025,119406,Politz; Joseph Gibbs,9999,0,9999,0
1668343752254,CSE 293,026,119411,Porter; George M,9999,0,9999,0
1668343752254,CSE 293,027,119414,Porter; Leonard Emerson,9999,0,9999,0
1668343752254,CSE 293,028,119416,Ramamoorthi; Ravi,9999,0,9999,0
1668343752254,CSE 293,029,119417,Sahoo; Debashis,9999,0,9999,0
1668343752254,CSE 293,030,119420,Saul; Lawrence,9999,0,9999,0
1668343752254,CSE 293,031,119421,Savage; Stefan,9999,0,9999,0
1668343752254,CSE 293,032,119425,Schulze; Jurgen P.,9999,0,9999,0
1668343752254,CSE 293,033,119426,Snoeren; Alex C.,9999,0,9999,0
1668343752254,CSE 293,034,119428,Shang; Jingbo,9999,0,9999,0
1668343752254,CSE 293,035,119430,Stefan; Deian,9999,0,9999,0
1668343752254,CSE 293,036,119431,Su; Hao,9999,0,9999,0
1668343752254,CSE 293,037,119433,Swanson; Steven James,9999,0,9999,0
1668343752254,CSE 293,038,119435,Tullsen; Dean Michael,9999,0,9999,0
1668343752254,CSE 293,039,119483,Voelker; Geoffrey M.,9999,0,9999,0
1668343752254,CSE 293,040,119537,Zhao; Jishen,9999,0,9999,0
1668343752254,CSE 293,041,119538,Zhou; Yuan-Yuan,9999,0,9999,0
1668343752254,CSE 293,042,119539,Gao; Sicun,9999,0,9999,0
1668343752254,CSE 293,043,119540,Weibel; Nadir,9999,0,9999,0
1668343752254,CSE 293,044,119541,Gupta; Rajesh K.,9999,0,9999,0
1668343752254,CSE 293,045,126410,Vaccaro; Kristen Marie,9999,0,9999,0
1668343752254,CSE 293,046,126411,Klemke; Richard,9999,0,9999,0
1668343752682,CSE 294,A00,102459,Voelker; Geoffrey M.,0,0,0,0
1668343752682,CSE 294,B00,111322,Orailoglu; Alex,0,0,0,0
1668343753109,DSE 201,A00,096914,Deutsch; Alin Bernard,30,0,30,0
1668343753534,DSE 210,A00,096915,Dasgupta; Sanjoy,30,0,30,0
1668343753958,DSE 260A,A00,096916,Altintas De Callaf; Ilkay,30,0,30,0
1668343754422,ECE 200,001,103586,Antipa; Nicholas A,9999,0,9999,0
1668343754422,ECE 200,002,103587,Atanasov; Nikolay A.,9999,0,9999,0
1668343754422,ECE 200,003,103588,Bharadia; Dinesh,9999,0,9999,0
1668343754422,ECE 200,004,103589,Cheng; Chung Kuan,9999,0,9999,0
1668343754422,ECE 200,005,103590,Cosman; Pamela C.,9999,0,9999,0
1668343754422,ECE 200,006,103591,Dayeh; Shadi Ahmad,9999,0,9999,0
1668343754422,ECE 200,007,103592,Fainman; Yeshaiahu,9999,0,9999,0
1668343754422,ECE 200,008,103593,Ford; Joseph Earl,9999,0,9999,0
1668343754422,ECE 200,009,103594,Franceschetti; Massimo,9999,0,9999,0
1668343754422,ECE 200,010,103595,Fullerton; Eric E,9999,0,9999,0
1668343754422,ECE 200,011,103596,Galton; Ian A,9999,0,9999,0
1668343754422,ECE 200,012,103597,Gilja; Vikash,9999,0,9999,0
1668343754422,ECE 200,013,103598,Hall; Drew A.,9999,0,9999,0
1668343754422,ECE 200,014,103599,Hsueh; Tzu-Chien,9999,0,9999,0
1668343754422,ECE 200,015,103600,Javidi; Tara,9999,0,9999,0
1668343754422,ECE 200,016,103601,Kahng; Andrew Byun,9999,0,9999,0
1668343754422,ECE 200,017,103602,Kim; Young-Han,9999,0,9999,0
1668343754422,ECE 200,018,103603,Koushanfar; Farinaz,9999,0,9999,0
1668343754422,ECE 200,019,103604,Kuzum; Duygu,9999,0,9999,0
1668343754422,ECE 200,020,103605,Le; Hanh-Phuc,9999,0,9999,0
1668343754422,ECE 200,021,103606,Lin; Bill,9999,0,9999,0
1668343754422,ECE 200,022,103607,Liu; Zhaowei,9998,0,9999,1
1668343754422,ECE 200,023,103608,Lo; Yu-Hwa,9999,0,9999,0
1668343754422,ECE 200,024,103609,Lomakin; Vitaliy,9999,0,9999,0
1668343754422,ECE 200,025,103610,Mercier; Patrick Philip,9999,0,9999,0
1668343754422,ECE 200,026,103611,Meyer; Florian,9999,0,9999,0
1668343754422,ECE 200,027,103612,Milstein; Laurence B.,9999,0,9999,0
1668343754422,ECE 200,028,103613,Mir Arabbaygi; Siavash,9999,0,9999,0
1668343754422,ECE 200,029,103614,Mookherjea; Shayan,9999,0,9999,0
1668343754422,ECE 200,030,103615,Morris; Karcher William,9999,0,9999,0
1668343754422,ECE 200,031,103616,Ng; Tse Nga,9999,0,9999,0
1668343754422,ECE 200,032,103617,Nguyen; Truong Quang,9999,0,9999,0
1668343754422,ECE 200,033,103618,Nomura; Kenji,9999,0,9999,0
1668343754422,ECE 200,034,103619,Orlitsky; Alon,9999,0,9999,0
1668343754422,ECE 200,035,103620,Pal; Piya,9999,0,9999,0
1668343754422,ECE 200,036,103621,Papen; George C.,9999,0,9999,0
1668343754422,ECE 200,037,103622,Radic; Stojan,9999,0,9999,0
1668343754422,ECE 200,038,103623,Rao; Bhaskar D.,9999,0,9999,0
1668343754422,ECE 200,039,103624,Rao; Ramesh R,9999,0,9999,0
1668343754422,ECE 200,040,103625,Rebeiz; Gabriel,9999,0,9999,0
1668343754422,ECE 200,041,103626,Sanford; John R,9999,0,9999,0
1668343754422,ECE 200,042,103627,Siegel; Paul H.,9999,0,9999,0
1668343754422,ECE 200,043,103628,Sievenpiper; Daniel F.,9999,0,9999,0
1668343754422,ECE 200,044,103629,Sworder; David D.,9999,0,9999,0
1668343754422,ECE 200,045,103630,Taur; Yuan,9999,0,9999,0
1668343754422,ECE 200,046,103631,Touri; Behrouz,9999,0,9999,0
1668343754422,ECE 200,047,103632,Trivedi; Mohan M.,9999,0,9999,0
1668343754422,ECE 200,048,103633,Vasconcelos; Nuno,9999,0,9999,0
1668343754422,ECE 200,049,103634,Wang; Xiaolong,9999,0,9999,0
1668343754422,ECE 200,050,103635,Xie; Pengtao,9999,0,9999,0
1668343754422,ECE 200,051,103636,Yip; Michael,9999,0,9999,0
1668343754422,ECE 200,052,103637,Zeger; Kenneth A.,999,0,999,0
1668343754422,ECE 200,053,103638,Zhang; Xinyu,9999,0,9999,0
1668343754422,ECE 200,054,103639,Turakhia; Yatish Girish,9999,0,9999,0
1668343754422,ECE 200,055,103640,Kang; Mingu,9999,0,9999,0
1668343754422,ECE 200,056,103641,Shi; Yuanyuan,9999,0,9999,0
1668343754422,ECE 200,057,103642,Wang; Edward Jay,9999,0,9999,0
1668343754422,ECE 200,058,103643,Zheng; Yang,9999,0,9999,0
1668343754850,ECE 202,A00,103644,Kuzum; Duygu,0,0,0,0
1668343755275,ECE 212BN,A00,103646,Ng; Tse Nga,0,0,0,0
1668343755699,ECE 221,A00,111493,Staff,0,0,0,0
1668343756129,ECE 222B,A00,103647,Lomakin; Vitaliy,0,0,0,0
1668343756554,ECE 230B,A00,103648,Taur; Yuan,0,0,0,0
1668343756979,ECE 238B,A00,103649,Garay; Javier,0,0,0,0
1668343757408,ECE 240B,A00,112900,Fainman; Yeshaiahu,0,0,0,0
1668343757834,ECE 247A,A00,103650,Jokerst; Jesse Vincent,0,0,0,0
1668343758264,ECE 247B,A00,103651,Wang; Joseph,0,0,0,0
1668343758691,ECE 250,A00,103652,Siegel; Paul H.,0,0,0,0
1668343759115,ECE 251A,A00,103654,Rao; Bhaskar D.,0,0,0,0
1668343759539,ECE 257B,A00,103655,Bharadia; Dinesh,0,0,0,0
1668343759964,ECE 258A,A00,103656,Milstein; Laurence B.,0,0,0,0
1668343760392,ECE 260B,A00,103658,Kang; Mingu,0,0,0,0
1668343760818,ECE 264A,A00,103659,Galton; Ian A,0,0,0,0
1668343761243,ECE 265A,A00,103661,Gudem; Prasad S.S.,0,0,0,0
1668343761667,ECE 265D,A00,103662,Gudem; Prasad S.S.,0,0,0,0
1668343762095,ECE 268,A00,103663,Koushanfar; Farinaz,0,0,0,0
1668343762523,ECE 269,A01,103665,Pal; Piya,0,0,0,0
1668343762947,ECE 271B,A00,103666,Vasconcelos; Manuela,0,0,0,0
1668343763375,ECE 276A,A00,103667,Atanasov; Nikolay A.,0,0,0,0
1668343763801,ECE 277,A00,103668,An; Cheolhong,0,0,0,0
1668343764224,ECE 279,A00,117947,Hall; Drew A.,0,0,0,0
1668343765076,ECE 283,A00,103670,Hsueh; Tzu-Chien,0,0,0,0
1668343765500,ECE 284,A00,103671,Turakhia; Yatish Girish,0,0,0,0
1668343765929,ECE 285,A00,103672,Zheng; Yang,0,0,0,0
1668343765929,ECE 285,B00,103673,Sworder; David D.,0,0,0,0
1668343766361,ECE 287,A00,103676,Javidi; Tara,0,0,0,0
1668343766795,MATH 200B,A00,098023,Salehi Golsefidy; Alireza,12,0,15,3
1668343767221,MATH 202B,A00,098024,Rhoades; Brendon Patrick,9,0,15,6
1668343767652,MATH 203B,A00,098025,Oprea; Dragos N.,10,0,15,5
1668343768080,MATH 204B,A00,098026,Sorensen; Claus M,13,0,15,2
1668343768506,MATH 208,A00,098027,Izadi; Elham,7,0,10,3
1668343768932,MATH 209,A00,098028,Pollack; Aaron,10,0,10,0
1668343769358,MATH 211A,A00,112919,Rogalski; Daniel,9,0,10,1
1668343769782,MATH 211B,A00,112920,Seward; Brandon M.,9,0,10,1
1668343770207,MATH 218,A00,098029,Li; Bo,10,0,10,0
1668343770632,MATH 220B,A00,098030,Novak; Jonathan I,11,0,15,4
1668343771056,MATH 221A,A00,098031,Ebenfelt; Peter F,13,0,15,2
1668343771485,MATH 231B,A00,098032,Zlatos; Andrej,12,0,15,3
1668343771911,MATH 240B,A00,098033,Ni; Lei,9,0,15,6
1668343772339,MATH 243,A00,098034,Jekel; David Andrew,10,0,10,0
1668343772766,MATH 245A,A00,098035,Nie; Jiawang,0,0,15,16
1668343773190,MATH 248,A00,098036,Bejenaru; Ioan,10,0,10,0
1668343773616,MATH 250B,A00,098037,Spolaor; Luca,14,0,15,1
1668343774042,MATH 258,A00,098038,Ni; Lei,10,0,10,0
1668343774474,MATH 264B,A00,098041,Rhoades; Brendon Patrick,9,0,15,6
1668343774899,MATH 268,A00,098042,Buss; Samuel R,10,0,10,0
1668343775326,MATH 269,A00,098043,Rhoades; Brendon Patrick,10,0,10,0
1668343775754,MATH 270B,A00,098044,Li; Bo,10,0,15,5
1668343776180,MATH 272B,A00,098045,Holst; Michael J,13,0,15,2
1668343776608,MATH 273A,A00,098046,Tian; Xiaochuan,10,0,15,5
1668343777031,MATH 275,A01,098048,Tian; Xiaochuan,6,0,10,4
1668343777457,MATH 278A,A00,098049,Holst; Michael J,8,0,10,2
1668343777883,MATH 278B,A00,098050,Cloninger; Alexander,10,0,10,0
1668343778307,MATH 278C,A00,098051,Nie; Jiawang,7,0,10,3
1668343778734,MATH 280B,A00,098052,Zheng; Tianyi,8,0,15,7
1668343779157,MATH 281B,A00,098053,Bradic; Jelena,1,0,15,14
1668343779586,MATH 282B,A00,098054,Arias-Castro; Ery,0,0,15,15
1668343780014,MATH 285,A00,098055,Fitzsimmons; Patrick J,0,0,15,17
1668343780438,MATH 287B,A00,098056,Arias-Castro; Ery,2,0,15,13
1668343780867,MATH 288,A00,098057,Agarwal; Pooja,9,0,10,1
1668343780867,MATH 288,B00,098058,Zhang; Danna,8,0,10,2
1668343780867,MATH 288,C00,098059,Williams; Ruth J,9,0,10,1
1668343781293,MATH 290B,A00,098060,Roberts; Justin Deritter,13,0,15,2
1668343781732,MATH 292,A00,098061,Belmont; Eva Kinoshita,10,0,10,0
1668343782157,MATH 295,A00,098062,Suk; Andrew Hoon,48,0,50,2
1668343782582,MATH 296,A00,098063,Novak; Jonathan I,20,0,20,0
1668343783008,MATH 297,001,098064,Gamst; Anthony Collins,9997,0,9999,2
1668344283528,COGS 205,A00,101395,Chiba; Andrea,19,0,20,1
1668344283953,COGS 210B,001,101404,Greene; Deanna Jacquelyn,9998,0,9999,1
1668344283953,COGS 210B,002,101417,Xia; Haijun,9999,0,9999,0
1668344283953,COGS 210B,003,101422,Nitz; Douglas A.,9999,0,9999,0
1668344283953,COGS 210B,004,101423,Hollan; James D.,9998,0,9999,1
1668344283953,COGS 210B,005,101424,Deak; Gedeon O.,9998,0,9999,1
1668344283953,COGS 210B,006,101425,Rossano; Federico,9999,0,9999,0
1668344284379,COGS 211B,A00,101427,Coulson; Seana M,9996,0,9999,3
1668344284803,COGS 220,A00,101428,Hollan; James D.,0,0,25,25
1668344285230,COGS 229,A00,101429,Dow; Steven P,18,0,25,7
1668344285657,COGS 230,A00,101430,Klemmer; Scott R,11,0,17,6
1668344286081,COGS 234,A00,101431,Xia; Haijun,1,0,25,24
1668344286504,COGS 260,A00,101432,Kiyonaga; Anastasia,21,0,25,4
1668344286504,COGS 260,B00,101433,Kirsh; David Joel,15,0,25,10
1668344286939,CSE 202,A00,102371,Impagliazzo; Russell,0,0,0,0
1668344287366,CSE 203B,A01,102373,Cheng; Chung Kuan,0,0,0,0
1668344287791,CSE 208,A00,102374,Micciancio; Daniele,0,0,0,0
1668344288219,CSE 209A,A00,112895,Impagliazzo; Russell,0,0,15,15
1668344288667,CSE 209B,A00,108005,Bellare; Mihir,0,0,0,0
1668344289092,CSE 210,A00,113163,Coblenz; Michael J,0,0,0,0
1668344289517,CSE 219,A00,106111,Dow; Steven P,0,0,20,20
1668344289941,CSE 221,A00,102376,Voelker; Geoffrey M.,0,0,0,0
1668344290377,CSE 224,A01,102378,Porter; George M,0,0,0,0
1668344290802,CSE 229A,A00,102379,Savage; Stefan,0,0,0,0
1668344291226,CSE 229C,A00,102380,Munyaka; Imani N. S.,0,0,0,0
1668344291651,CSE 232B,A00,102382,Deutsch; Alin Bernard,0,0,0,0
1668344292081,CSE 234,A01,112904,Kumar; Arun Kumar,0,0,0,0
1668344292510,CSE 237A,A00,102383,Rosing; Tajana Simunic,0,0,0,0
1668344292941,CSE 239A,A00,102384,Deutsch; Alin Bernard,0,0,0,0
1668344293369,CSE 239B,A00,102385,Polikarpova; Nadezhda,0,0,0,0
1668344293804,CSE 240A,A00,102386,Pannuto; Patrick William,0,0,0,0
1668344294230,CSE 240B,A00,102387,Zhao; Jishen,0,0,0,0
1668344294654,CSE 241A,A00,106406,Kang; Mingu,0,0,0,0
1668344295090,CSE 249B,A00,102388,Kahng; Andrew Byun,0,0,8,8
1668344295516,CSE 251B,A01,102392,Cottrell; Garrison W,0,0,0,0
1668344295516,CSE 251B,A02,102393,Cottrell; Garrison W,0,0,0,0
1668344295945,CSE 252B,A00,102394,Ochoa; Benjamin Lawrence,0,0,0,0
1668344296374,CSE 257,A01,102396,Gao; Sicun,0,0,0,0
1668344296798,CSE 272,A00,102397,Li; Tzumao,0,0,0,0
1668344297231,CSE 274,A00,111323,Chern; Albert Ren-Haur,0,0,0,0
1668344297656,CSE 282,A00,102398,Pevzner; Pavel Arkadjevich,0,0,0,0
1668344298086,CSE 284,A00,114175,Gymrek; Melissa Ann,0,0,0,0
1668344298514,CSE 290,A00,102399,Chandraker; Manmohan Krishna,0,0,0,0
1668344298514,CSE 290,B00,102400,Vaccaro; Kristen Marie,0,0,25,25
1668344298514,CSE 290,C00,102414,Pannuto; Patrick William,0,0,25,25
1668344298514,CSE 290,D00,102427,Pevzner; Pavel Arkadjevich,0,0,0,0
1668344298514,CSE 290,E00,102429,Zhao; Jishen,0,0,0,0
1668344298514,CSE 290,F00,102436,Tullsen; Dean Michael,0,0,0,0
1668344298514,CSE 290,G00,102440,Christensen; Henrik I,0,0,20,20
1668344298946,CSE 291,A00,102443,Su; Hao,0,0,0,0
1668344298946,CSE 291,B00,102448,Polikarpova; Nadezhda,0,0,0,0
1668344298946,CSE 291,C00,102453,Vaccaro; Kristen Marie,0,0,0,0
1668344298946,CSE 291,D00,111343,Savage; Stefan,0,0,0,0
1668344298946,CSE 291,E00,116474,Claffy; Kimberly Claire,0,0,0,0
1668344298946,CSE 291,F00,116479,Pasquale; Joseph,0,0,0,0
1668344299389,CSE 293,001,119111,Bafna; Vineet,9999,0,9999,0
1668344299389,CSE 293,002,119118,Bellare; Mihir,9999,0,9999,0
1668344299389,CSE 293,003,119122,Berg-Kirkpatrick; Taylor D,9999,0,9999,0
1668344299389,CSE 293,004,119135,Christensen; Henrik I,9999,0,9999,0
1668344299389,CSE 293,005,119142,Cottrell; Garrison W,9999,0,9999,0
1668344299389,CSE 293,006,119146,Deutsch; Alin Bernard,9999,0,9999,0
1668344299389,CSE 293,007,119159,Esmaeilzadeh; Hadi,9999,0,9999,0
1668344299389,CSE 293,008,119166,Freund; Yoav,9999,0,9999,0
1668344299389,CSE 293,009,119170,Griswold; William G.,9999,0,9999,0
1668344299389,CSE 293,010,119183,Gymrek; Melissa Ann,9999,0,9999,0
1668344299389,CSE 293,011,119190,Heninger; Nadia A,9999,0,9999,0
1668344299389,CSE 293,012,119230,Impagliazzo; Russell,9999,0,9999,0
1668344299389,CSE 293,013,119232,Jhala; Ranjit,9999,0,9999,0
1668344299389,CSE 293,014,119233,Kahng; Andrew Byun,9999,0,9999,0
1668344299389,CSE 293,015,119298,Kane; Daniel Mertz,9999,0,9999,0
1668344299389,CSE 293,016,119299,Kriegman; David J,9999,0,9999,0
1668344299389,CSE 293,017,119300,Kumar; Arun Kumar,9999,0,9999,0
1668344299389,CSE 293,018,119301,Lerner; Sorin,9999,0,9999,0
1668344299389,CSE 293,019,119302,Lovett; Shachar,9999,0,9999,0
1668344299389,CSE 293,020,119303,McAuley; Julian John,9999,0,9999,0
1668344299389,CSE 293,021,119304,Micciancio; Daniele,9999,0,9999,0
1668344299389,CSE 293,022,119367,Orailoglu; Alex,9999,0,9999,0
1668344299389,CSE 293,023,119382,Paturi; Ramamohan,9999,0,9999,0
1668344299389,CSE 293,024,119404,Polikarpova; Nadezhda,9999,0,9999,0
1668344299389,CSE 293,025,119406,Politz; Joseph Gibbs,9999,0,9999,0
1668344299389,CSE 293,026,119411,Porter; George M,9999,0,9999,0
1668344299389,CSE 293,027,119414,Porter; Leonard Emerson,9999,0,9999,0
1668344299389,CSE 293,028,119416,Ramamoorthi; Ravi,9999,0,9999,0
1668344299389,CSE 293,029,119417,Sahoo; Debashis,9999,0,9999,0
1668344299389,CSE 293,030,119420,Saul; Lawrence,9999,0,9999,0
1668344299389,CSE 293,031,119421,Savage; Stefan,9999,0,9999,0
1668344299389,CSE 293,032,119425,Schulze; Jurgen P.,9999,0,9999,0
1668344299389,CSE 293,033,119426,Snoeren; Alex C.,9999,0,9999,0
1668344299389,CSE 293,034,119428,Shang; Jingbo,9999,0,9999,0
1668344299389,CSE 293,035,119430,Stefan; Deian,9999,0,9999,0
1668344299389,CSE 293,036,119431,Su; Hao,9999,0,9999,0
1668344299389,CSE 293,037,119433,Swanson; Steven James,9999,0,9999,0
1668344299389,CSE 293,038,119435,Tullsen; Dean Michael,9999,0,9999,0
1668344299389,CSE 293,039,119483,Voelker; Geoffrey M.,9999,0,9999,0
1668344299389,CSE 293,040,119537,Zhao; Jishen,9999,0,9999,0
1668344299389,CSE 293,041,119538,Zhou; Yuan-Yuan,9999,0,9999,0
1668344299389,CSE 293,042,119539,Gao; Sicun,9999,0,9999,0
1668344299389,CSE 293,043,119540,Weibel; Nadir,9999,0,9999,0
1668344299389,CSE 293,044,119541,Gupta; Rajesh K.,9999,0,9999,0
1668344299389,CSE 293,045,126410,Vaccaro; Kristen Marie,9999,0,9999,0
1668344299389,CSE 293,046,126411,Klemke; Richard,9999,0,9999,0
1668344299815,CSE 294,A00,102459,Voelker; Geoffrey M.,0,0,0,0
1668344299815,CSE 294,B00,111322,Orailoglu; Alex,0,0,0,0
1668344300240,DSE 201,A00,096914,Deutsch; Alin Bernard,30,0,30,0
1668344300666,DSE 210,A00,096915,Dasgupta; Sanjoy,30,0,30,0
1668344301092,DSE 260A,A00,096916,Altintas De Callaf; Ilkay,30,0,30,0
1668344301535,ECE 200,001,103586,Antipa; Nicholas A,9999,0,9999,0
1668344301535,ECE 200,002,103587,Atanasov; Nikolay A.,9999,0,9999,0
1668344301535,ECE 200,003,103588,Bharadia; Dinesh,9999,0,9999,0
1668344301535,ECE 200,004,103589,Cheng; Chung Kuan,9999,0,9999,0
1668344301535,ECE 200,005,103590,Cosman; Pamela C.,9999,0,9999,0
1668344301535,ECE 200,006,103591,Dayeh; Shadi Ahmad,9999,0,9999,0
1668344301535,ECE 200,007,103592,Fainman; Yeshaiahu,9999,0,9999,0
1668344301535,ECE 200,008,103593,Ford; Joseph Earl,9999,0,9999,0
1668344301535,ECE 200,009,103594,Franceschetti; Massimo,9999,0,9999,0
1668344301535,ECE 200,010,103595,Fullerton; Eric E,9999,0,9999,0
1668344301535,ECE 200,011,103596,Galton; Ian A,9999,0,9999,0
1668344301535,ECE 200,012,103597,Gilja; Vikash,9999,0,9999,0
1668344301535,ECE 200,013,103598,Hall; Drew A.,9999,0,9999,0
1668344301535,ECE 200,014,103599,Hsueh; Tzu-Chien,9999,0,9999,0
1668344301535,ECE 200,015,103600,Javidi; Tara,9999,0,9999,0
1668344301535,ECE 200,016,103601,Kahng; Andrew Byun,9999,0,9999,0
1668344301535,ECE 200,017,103602,Kim; Young-Han,9999,0,9999,0
1668344301535,ECE 200,018,103603,Koushanfar; Farinaz,9999,0,9999,0
1668344301535,ECE 200,019,103604,Kuzum; Duygu,9999,0,9999,0
1668344301535,ECE 200,020,103605,Le; Hanh-Phuc,9999,0,9999,0
1668344301535,ECE 200,021,103606,Lin; Bill,9999,0,9999,0
1668344301535,ECE 200,022,103607,Liu; Zhaowei,9998,0,9999,1
1668344301535,ECE 200,023,103608,Lo; Yu-Hwa,9999,0,9999,0
1668344301535,ECE 200,024,103609,Lomakin; Vitaliy,9999,0,9999,0
1668344301535,ECE 200,025,103610,Mercier; Patrick Philip,9999,0,9999,0
1668344301535,ECE 200,026,103611,Meyer; Florian,9999,0,9999,0
1668344301535,ECE 200,027,103612,Milstein; Laurence B.,9999,0,9999,0
1668344301535,ECE 200,028,103613,Mir Arabbaygi; Siavash,9999,0,9999,0
1668344301535,ECE 200,029,103614,Mookherjea; Shayan,9999,0,9999,0
1668344301535,ECE 200,030,103615,Morris; Karcher William,9999,0,9999,0
1668344301535,ECE 200,031,103616,Ng; Tse Nga,9999,0,9999,0
1668344301535,ECE 200,032,103617,Nguyen; Truong Quang,9999,0,9999,0
1668344301535,ECE 200,033,103618,Nomura; Kenji,9999,0,9999,0
1668344301535,ECE 200,034,103619,Orlitsky; Alon,9999,0,9999,0
1668344301535,ECE 200,035,103620,Pal; Piya,9999,0,9999,0
1668344301535,ECE 200,036,103621,Papen; George C.,9999,0,9999,0
1668344301535,ECE 200,037,103622,Radic; Stojan,9999,0,9999,0
1668344301535,ECE 200,038,103623,Rao; Bhaskar D.,9999,0,9999,0
1668344301535,ECE 200,039,103624,Rao; Ramesh R,9999,0,9999,0
1668344301535,ECE 200,040,103625,Rebeiz; Gabriel,9999,0,9999,0
1668344301535,ECE 200,041,103626,Sanford; John R,9999,0,9999,0
1668344301535,ECE 200,042,103627,Siegel; Paul H.,9999,0,9999,0
1668344301535,ECE 200,043,103628,Sievenpiper; Daniel F.,9999,0,9999,0
1668344301535,ECE 200,044,103629,Sworder; David D.,9999,0,9999,0
1668344301535,ECE 200,045,103630,Taur; Yuan,9999,0,9999,0
1668344301535,ECE 200,046,103631,Touri; Behrouz,9999,0,9999,0
1668344301535,ECE 200,047,103632,Trivedi; Mohan M.,9999,0,9999,0
1668344301535,ECE 200,048,103633,Vasconcelos; Nuno,9999,0,9999,0
1668344301535,ECE 200,049,103634,Wang; Xiaolong,9999,0,9999,0
1668344301535,ECE 200,050,103635,Xie; Pengtao,9999,0,9999,0
1668344301535,ECE 200,051,103636,Yip; Michael,9999,0,9999,0
1668344301535,ECE 200,052,103637,Zeger; Kenneth A.,999,0,999,0
1668344301535,ECE 200,053,103638,Zhang; Xinyu,9999,0,9999,0
1668344301535,ECE 200,054,103639,Turakhia; Yatish Girish,9999,0,9999,0
1668344301535,ECE 200,055,103640,Kang; Mingu,9999,0,9999,0
1668344301535,ECE 200,056,103641,Shi; Yuanyuan,9999,0,9999,0
1668344301535,ECE 200,057,103642,Wang; Edward Jay,9999,0,9999,0
1668344301535,ECE 200,058,103643,Zheng; Yang,9999,0,9999,0
1668344301959,ECE 202,A00,103644,Kuzum; Duygu,0,0,0,0
1668344302387,ECE 212BN,A00,103646,Ng; Tse Nga,0,0,0,0
1668344302813,ECE 221,A00,111493,Staff,0,0,0,0
1668344303238,ECE 222B,A00,103647,Lomakin; Vitaliy,0,0,0,0
1668344303662,ECE 230B,A00,103648,Taur; Yuan,0,0,0,0
1668344304086,ECE 238B,A00,103649,Garay; Javier,0,0,0,0
1668344304511,ECE 240B,A00,112900,Fainman; Yeshaiahu,0,0,0,0
1668344304939,ECE 247A,A00,103650,Jokerst; Jesse Vincent,0,0,0,0
1668344305366,ECE 247B,A00,103651,Wang; Joseph,0,0,0,0
1668344305802,ECE 250,A00,103652,Siegel; Paul H.,0,0,0,0
1668344306226,ECE 251A,A00,103654,Rao; Bhaskar D.,0,0,0,0
1668344306651,ECE 257B,A00,103655,Bharadia; Dinesh,0,0,0,0
1668344307078,ECE 258A,A00,103656,Milstein; Laurence B.,0,0,0,0
1668344307504,ECE 260B,A00,103658,Kang; Mingu,0,0,0,0
1668344307928,ECE 264A,A00,103659,Galton; Ian A,0,0,0,0
1668344308353,ECE 265A,A00,103661,Gudem; Prasad S.S.,0,0,0,0
1668344308777,ECE 265D,A00,103662,Gudem; Prasad S.S.,0,0,0,0
1668344309216,ECE 268,A00,103663,Koushanfar; Farinaz,0,0,0,0
1668344309716,ECE 269,A01,103665,Pal; Piya,0,0,0,0
1668344310147,ECE 271B,A00,103666,Vasconcelos; Manuela,0,0,0,0
1668344310576,ECE 276A,A00,103667,Atanasov; Nikolay A.,0,0,0,0
1668344311000,ECE 277,A00,103668,An; Cheolhong,0,0,0,0
1668344311426,ECE 279,A00,117947,Hall; Drew A.,0,0,0,0
1668344312272,ECE 283,A00,103670,Hsueh; Tzu-Chien,0,0,0,0
1668344312696,ECE 284,A00,103671,Turakhia; Yatish Girish,0,0,0,0
1668344313126,ECE 285,A00,103672,Zheng; Yang,0,0,0,0
1668344313126,ECE 285,B00,103673,Sworder; David D.,0,0,0,0
1668344313553,ECE 287,A00,103676,Javidi; Tara,0,0,0,0
1668344313980,MATH 200B,A00,098023,Salehi Golsefidy; Alireza,12,0,15,3
1668344314411,MATH 202B,A00,098024,Rhoades; Brendon Patrick,9,0,15,6
1668344314835,MATH 203B,A00,098025,Oprea; Dragos N.,10,0,15,5
1668344315262,MATH 204B,A00,098026,Sorensen; Claus M,13,0,15,2
1668344315686,MATH 208,A00,098027,Izadi; Elham,7,0,10,3
1668344316119,MATH 209,A00,098028,Pollack; Aaron,10,0,10,0
1668344316547,MATH 211A,A00,112919,Rogalski; Daniel,9,0,10,1
1668344316973,MATH 211B,A00,112920,Seward; Brandon M.,9,0,10,1
1668344317398,MATH 218,A00,098029,Li; Bo,10,0,10,0
1668344317830,MATH 220B,A00,098030,Novak; Jonathan I,11,0,15,4
1668344318254,MATH 221A,A00,098031,Ebenfelt; Peter F,13,0,15,2
1668344318679,MATH 231B,A00,098032,Zlatos; Andrej,12,0,15,3
1668344319104,MATH 240B,A00,098033,Ni; Lei,9,0,15,6
1668344319543,MATH 243,A00,098034,Jekel; David Andrew,10,0,10,0
1668344319970,MATH 245A,A00,098035,Nie; Jiawang,0,0,15,16
1668344320398,MATH 248,A00,098036,Bejenaru; Ioan,10,0,10,0
1668344320831,MATH 250B,A00,098037,Spolaor; Luca,14,0,15,1
1668344321265,MATH 258,A00,098038,Ni; Lei,10,0,10,0
1668344321689,MATH 264B,A00,098041,Rhoades; Brendon Patrick,9,0,15,6
1668344322115,MATH 268,A00,098042,Buss; Samuel R,10,0,10,0
1668344322541,MATH 269,A00,098043,Rhoades; Brendon Patrick,10,0,10,0
1668344322967,MATH 270B,A00,098044,Li; Bo,10,0,15,5
1668344323392,MATH 272B,A00,098045,Holst; Michael J,13,0,15,2
1668344323820,MATH 273A,A00,098046,Tian; Xiaochuan,10,0,15,5
1668344324249,MATH 275,A01,098048,Tian; Xiaochuan,6,0,10,4
1668344324676,MATH 278A,A00,098049,Holst; Michael J,8,0,10,2
1668344325100,MATH 278B,A00,098050,Cloninger; Alexander,10,0,10,0
1668344325523,MATH 278C,A00,098051,Nie; Jiawang,7,0,10,3
1668344325947,MATH 280B,A00,098052,Zheng; Tianyi,8,0,15,7
1668344326371,MATH 281B,A00,098053,Bradic; Jelena,1,0,15,14
1668344326794,MATH 282B,A00,098054,Arias-Castro; Ery,0,0,15,15
1668344327223,MATH 285,A00,098055,Fitzsimmons; Patrick J,0,0,15,17
1668344327647,MATH 287B,A00,098056,Arias-Castro; Ery,2,0,15,13
1668344328072,MATH 288,A00,098057,Agarwal; Pooja,9,0,10,1
1668344328072,MATH 288,B00,098058,Zhang; Danna,8,0,10,2
1668344328072,MATH 288,C00,098059,Williams; Ruth J,9,0,10,1
1668344328494,MATH 290B,A00,098060,Roberts; Justin Deritter,13,0,15,2
1668344328921,MATH 292,A00,098061,Belmont; Eva Kinoshita,10,0,10,0
1668344329349,MATH 295,A00,098062,Suk; Andrew Hoon,48,0,50,2
1668344329773,MATH 296,A00,098063,Novak; Jonathan I,20,0,20,0
1668344330197,MATH 297,001,098064,Gamst; Anthony Collins,9997,0,9999,2
1668344829689,COGS 205,A00,101395,Chiba; Andrea,19,0,20,1
1668344830113,COGS 210B,001,101404,Greene; Deanna Jacquelyn,9998,0,9999,1
1668344830113,COGS 210B,002,101417,Xia; Haijun,9999,0,9999,0
1668344830113,COGS 210B,003,101422,Nitz; Douglas A.,9999,0,9999,0
1668344830113,COGS 210B,004,101423,Hollan; James D.,9998,0,9999,1
1668344830113,COGS 210B,005,101424,Deak; Gedeon O.,9998,0,9999,1
1668344830113,COGS 210B,006,101425,Rossano; Federico,9999,0,9999,0
1668344830540,COGS 211B,A00,101427,Coulson; Seana M,9996,0,9999,3
1668344830963,COGS 220,A00,101428,Hollan; James D.,0,0,25,25
1668344831392,COGS 229,A00,101429,Dow; Steven P,18,0,25,7
1668344831817,COGS 230,A00,101430,Klemmer; Scott R,11,0,17,6
1668344832240,COGS 234,A00,101431,Xia; Haijun,1,0,25,24
1668344832666,COGS 260,A00,101432,Kiyonaga; Anastasia,21,0,25,4
1668344832666,COGS 260,B00,101433,Kirsh; David Joel,15,0,25,10
1668344833091,CSE 202,A00,102371,Impagliazzo; Russell,0,0,0,0
1668344833513,CSE 203B,A01,102373,Cheng; Chung Kuan,0,0,0,0
1668344833937,CSE 208,A00,102374,Micciancio; Daniele,0,0,0,0
1668344834363,CSE 209A,A00,112895,Impagliazzo; Russell,0,0,15,15
1668344834788,CSE 209B,A00,108005,Bellare; Mihir,0,0,0,0
1668344835217,CSE 210,A00,113163,Coblenz; Michael J,0,0,0,0
1668344835641,CSE 219,A00,106111,Dow; Steven P,0,0,20,20
1668344836066,CSE 221,A00,102376,Voelker; Geoffrey M.,0,0,0,0
1668344836490,CSE 224,A01,102378,Porter; George M,0,0,0,0
1668344836914,CSE 229A,A00,102379,Savage; Stefan,0,0,0,0
1668344837337,CSE 229C,A00,102380,Munyaka; Imani N. S.,0,0,0,0
1668344837761,CSE 232B,A00,102382,Deutsch; Alin Bernard,0,0,0,0
1668344838184,CSE 234,A01,112904,Kumar; Arun Kumar,0,0,0,0
1668344838611,CSE 237A,A00,102383,Rosing; Tajana Simunic,0,0,0,0
1668344839036,CSE 239A,A00,102384,Deutsch; Alin Bernard,0,0,0,0
1668344839459,CSE 239B,A00,102385,Polikarpova; Nadezhda,0,0,0,0
1668344839883,CSE 240A,A00,102386,Pannuto; Patrick William,0,0,0,0
1668344840307,CSE 240B,A00,102387,Zhao; Jishen,0,0,0,0
1668344840732,CSE 241A,A00,106406,Kang; Mingu,0,0,0,0
1668344841157,CSE 249B,A00,102388,Kahng; Andrew Byun,0,0,8,8
1668344841585,CSE 251B,A01,102392,Cottrell; Garrison W,0,0,0,0
1668344841585,CSE 251B,A02,102393,Cottrell; Garrison W,0,0,0,0
1668344842008,CSE 252B,A00,102394,Ochoa; Benjamin Lawrence,0,0,0,0
1668344842431,CSE 257,A01,102396,Gao; Sicun,0,0,0,0
1668344842858,CSE 272,A00,102397,Li; Tzumao,0,0,0,0
1668344843286,CSE 274,A00,111323,Chern; Albert Ren-Haur,0,0,0,0
1668344843708,CSE 282,A00,102398,Pevzner; Pavel Arkadjevich,0,0,0,0
1668344844135,CSE 284,A00,114175,Gymrek; Melissa Ann,0,0,0,0
1668344844559,CSE 290,A00,102399,Chandraker; Manmohan Krishna,0,0,0,0
1668344844559,CSE 290,B00,102400,Vaccaro; Kristen Marie,0,0,25,25
1668344844559,CSE 290,C00,102414,Pannuto; Patrick William,0,0,25,25
1668344844559,CSE 290,D00,102427,Pevzner; Pavel Arkadjevich,0,0,0,0
1668344844559,CSE 290,E00,102429,Zhao; Jishen,0,0,0,0
1668344844559,CSE 290,F00,102436,Tullsen; Dean Michael,0,0,0,0
1668344844559,CSE 290,G00,102440,Christensen; Henrik I,0,0,20,20
1668344844988,CSE 291,A00,102443,Su; Hao,0,0,0,0
1668344844988,CSE 291,B00,102448,Polikarpova; Nadezhda,0,0,0,0
1668344844988,CSE 291,C00,102453,Vaccaro; Kristen Marie,0,0,0,0
1668344844988,CSE 291,D00,111343,Savage; Stefan,0,0,0,0
1668344844988,CSE 291,E00,116474,Claffy; Kimberly Claire,0,0,0,0
1668344844988,CSE 291,F00,116479,Pasquale; Joseph,0,0,0,0
1668344845417,CSE 293,001,119111,Bafna; Vineet,9999,0,9999,0
1668344845417,CSE 293,002,119118,Bellare; Mihir,9999,0,9999,0
1668344845417,CSE 293,003,119122,Berg-Kirkpatrick; Taylor D,9999,0,9999,0
1668344845417,CSE 293,004,119135,Christensen; Henrik I,9999,0,9999,0
1668344845417,CSE 293,005,119142,Cottrell; Garrison W,9999,0,9999,0
1668344845417,CSE 293,006,119146,Deutsch; Alin Bernard,9999,0,9999,0
1668344845417,CSE 293,007,119159,Esmaeilzadeh; Hadi,9999,0,9999,0
1668344845417,CSE 293,008,119166,Freund; Yoav,9999,0,9999,0
1668344845417,CSE 293,009,119170,Griswold; William G.,9999,0,9999,0
1668344845417,CSE 293,010,119183,Gymrek; Melissa Ann,9999,0,9999,0
1668344845417,CSE 293,011,119190,Heninger; Nadia A,9999,0,9999,0
1668344845417,CSE 293,012,119230,Impagliazzo; Russell,9999,0,9999,0
1668344845417,CSE 293,013,119232,Jhala; Ranjit,9999,0,9999,0
1668344845417,CSE 293,014,119233,Kahng; Andrew Byun,9999,0,9999,0
1668344845417,CSE 293,015,119298,Kane; Daniel Mertz,9999,0,9999,0
1668344845417,CSE 293,016,119299,Kriegman; David J,9999,0,9999,0
1668344845417,CSE 293,017,119300,Kumar; Arun Kumar,9999,0,9999,0
1668344845417,CSE 293,018,119301,Lerner; Sorin,9999,0,9999,0
1668344845417,CSE 293,019,119302,Lovett; Shachar,9999,0,9999,0
1668344845417,CSE 293,020,119303,McAuley; Julian John,9999,0,9999,0
1668344845417,CSE 293,021,119304,Micciancio; Daniele,9999,0,9999,0
1668344845417,CSE 293,022,119367,Orailoglu; Alex,9999,0,9999,0
1668344845417,CSE 293,023,119382,Paturi; Ramamohan,9999,0,9999,0
1668344845417,CSE 293,024,119404,Polikarpova; Nadezhda,9999,0,9999,0
1668344845417,CSE 293,025,119406,Politz; Joseph Gibbs,9999,0,9999,0
1668344845417,CSE 293,026,119411,Porter; George M,9999,0,9999,0
1668344845417,CSE 293,027,119414,Porter; Leonard Emerson,9999,0,9999,0
1668344845417,CSE 293,028,119416,Ramamoorthi; Ravi,9999,0,9999,0
1668344845417,CSE 293,029,119417,Sahoo; Debashis,9999,0,9999,0
1668344845417,CSE 293,030,119420,Saul; Lawrence,9999,0,9999,0
1668344845417,CSE 293,031,119421,Savage; Stefan,9999,0,9999,0
1668344845417,CSE 293,032,119425,Schulze; Jurgen P.,9999,0,9999,0
1668344845417,CSE 293,033,119426,Snoeren; Alex C.,9999,0,9999,0
1668344845417,CSE 293,034,119428,Shang; Jingbo,9999,0,9999,0
1668344845417,CSE 293,035,119430,Stefan; Deian,9999,0,9999,0
1668344845417,CSE 293,036,119431,Su; Hao,9999,0,9999,0
1668344845417,CSE 293,037,119433,Swanson; Steven James,9999,0,9999,0
1668344845417,CSE 293,038,119435,Tullsen; Dean Michael,9999,0,9999,0
1668344845417,CSE 293,039,119483,Voelker; Geoffrey M.,9999,0,9999,0
1668344845417,CSE 293,040,119537,Zhao; Jishen,9999,0,9999,0
1668344845417,CSE 293,041,119538,Zhou; Yuan-Yuan,9999,0,9999,0
1668344845417,CSE 293,042,119539,Gao; Sicun,9999,0,9999,0
1668344845417,CSE 293,043,119540,Weibel; Nadir,9999,0,9999,0
1668344845417,CSE 293,044,119541,Gupta; Rajesh K.,9999,0,9999,0
1668344845417,CSE 293,045,126410,Vaccaro; Kristen Marie,9999,0,9999,0
1668344845417,CSE 293,046,126411,Klemke; Richard,9999,0,9999,0
1668344845841,CSE 294,A00,102459,Voelker; Geoffrey M.,0,0,0,0
1668344845841,CSE 294,B00,111322,Orailoglu; Alex,0,0,0,0
1668344846267,DSE 201,A00,096914,Deutsch; Alin Bernard,30,0,30,0
1668344846691,DSE 210,A00,096915,Dasgupta; Sanjoy,30,0,30,0
1668344847116,DSE 260A,A00,096916,Altintas De Callaf; Ilkay,30,0,30,0
1668344847557,ECE 200,001,103586,Antipa; Nicholas A,9999,0,9999,0
1668344847557,ECE 200,002,103587,Atanasov; Nikolay A.,9999,0,9999,0
1668344847557,ECE 200,003,103588,Bharadia; Dinesh,9999,0,9999,0
1668344847557,ECE 200,004,103589,Cheng; Chung Kuan,9999,0,9999,0
1668344847557,ECE 200,005,103590,Cosman; Pamela C.,9999,0,9999,0
1668344847557,ECE 200,006,103591,Dayeh; Shadi Ahmad,9999,0,9999,0
1668344847557,ECE 200,007,103592,Fainman; Yeshaiahu,9999,0,9999,0
1668344847557,ECE 200,008,103593,Ford; Joseph Earl,9999,0,9999,0
1668344847557,ECE 200,009,103594,Franceschetti; Massimo,9999,0,9999,0
1668344847557,ECE 200,010,103595,Fullerton; Eric E,9999,0,9999,0
1668344847557,ECE 200,011,103596,Galton; Ian A,9999,0,9999,0
1668344847557,ECE 200,012,103597,Gilja; Vikash,9999,0,9999,0
1668344847557,ECE 200,013,103598,Hall; Drew A.,9999,0,9999,0
1668344847557,ECE 200,014,103599,Hsueh; Tzu-Chien,9999,0,9999,0
1668344847557,ECE 200,015,103600,Javidi; Tara,9999,0,9999,0
1668344847557,ECE 200,016,103601,Kahng; Andrew Byun,9999,0,9999,0
1668344847557,ECE 200,017,103602,Kim; Young-Han,9999,0,9999,0
1668344847557,ECE 200,018,103603,Koushanfar; Farinaz,9999,0,9999,0
1668344847557,ECE 200,019,103604,Kuzum; Duygu,9999,0,9999,0
1668344847557,ECE 200,020,103605,Le; Hanh-Phuc,9999,0,9999,0
1668344847557,ECE 200,021,103606,Lin; Bill,9999,0,9999,0
1668344847557,ECE 200,022,103607,Liu; Zhaowei,9998,0,9999,1
1668344847557,ECE 200,023,103608,Lo; Yu-Hwa,9999,0,9999,0
1668344847557,ECE 200,024,103609,Lomakin; Vitaliy,9999,0,9999,0
1668344847557,ECE 200,025,103610,Mercier; Patrick Philip,9999,0,9999,0
1668344847557,ECE 200,026,103611,Meyer; Florian,9999,0,9999,0
1668344847557,ECE 200,027,103612,Milstein; Laurence B.,9999,0,9999,0
1668344847557,ECE 200,028,103613,Mir Arabbaygi; Siavash,9999,0,9999,0
1668344847557,ECE 200,029,103614,Mookherjea; Shayan,9999,0,9999,0
1668344847557,ECE 200,030,103615,Morris; Karcher William,9999,0,9999,0
1668344847557,ECE 200,031,103616,Ng; Tse Nga,9999,0,9999,0
1668344847557,ECE 200,032,103617,Nguyen; Truong Quang,9999,0,9999,0
1668344847557,ECE 200,033,103618,Nomura; Kenji,9999,0,9999,0
1668344847557,ECE 200,034,103619,Orlitsky; Alon,9999,0,9999,0
1668344847557,ECE 200,035,103620,Pal; Piya,9999,0,9999,0
1668344847557,ECE 200,036,103621,Papen; George C.,9999,0,9999,0
1668344847557,ECE 200,037,103622,Radic; Stojan,9999,0,9999,0
1668344847557,ECE 200,038,103623,Rao; Bhaskar D.,9999,0,9999,0
1668344847557,ECE 200,039,103624,Rao; Ramesh R,9999,0,9999,0
1668344847557,ECE 200,040,103625,Rebeiz; Gabriel,9999,0,9999,0
1668344847557,ECE 200,041,103626,Sanford; John R,9999,0,9999,0
1668344847557,ECE 200,042,103627,Siegel; Paul H.,9999,0,9999,0
1668344847557,ECE 200,043,103628,Sievenpiper; Daniel F.,9999,0,9999,0
1668344847557,ECE 200,044,103629,Sworder; David D.,9999,0,9999,0
1668344847557,ECE 200,045,103630,Taur; Yuan,9999,0,9999,0
1668344847557,ECE 200,046,103631,Touri; Behrouz,9999,0,9999,0
1668344847557,ECE 200,047,103632,Trivedi; Mohan M.,9999,0,9999,0
1668344847557,ECE 200,048,103633,Vasconcelos; Nuno,9999,0,9999,0
1668344847557,ECE 200,049,103634,Wang; Xiaolong,9999,0,9999,0
1668344847557,ECE 200,050,103635,Xie; Pengtao,9999,0,9999,0
1668344847557,ECE 200,051,103636,Yip; Michael,9999,0,9999,0
1668344847557,ECE 200,052,103637,Zeger; Kenneth A.,999,0,999,0
1668344847557,ECE 200,053,103638,Zhang; Xinyu,9999,0,9999,0
1668344847557,ECE 200,054,103639,Turakhia; Yatish Girish,9999,0,9999,0
1668344847557,ECE 200,055,103640,Kang; Mingu,9999,0,9999,0
1668344847557,ECE 200,056,103641,Shi; Yuanyuan,9999,0,9999,0
1668344847557,ECE 200,057,103642,Wang; Edward Jay,9999,0,9999,0
1668344847557,ECE 200,058,103643,Zheng; Yang,9999,0,9999,0
1668344847983,ECE 202,A00,103644,Kuzum; Duygu,0,0,0,0
1668344848408,ECE 212BN,A00,103646,Ng; Tse Nga,0,0,0,0
1668344848833,ECE 221,A00,111493,Staff,0,0,0,0
1668344849256,ECE 222B,A00,103647,Lomakin; Vitaliy,0,0,0,0
1668344849681,ECE 230B,A00,103648,Taur; Yuan,0,0,0,0
1668344850107,ECE 238B,A00,103649,Garay; Javier,0,0,0,0
1668344850530,ECE 240B,A00,112900,Fainman; Yeshaiahu,0,0,0,0
1668344850954,ECE 247A,A00,103650,Jokerst; Jesse Vincent,0,0,0,0
1668344851380,ECE 247B,A00,103651,Wang; Joseph,0,0,0,0
1668344851804,ECE 250,A00,103652,Siegel; Paul H.,0,0,0,0
1668344852227,ECE 251A,A00,103654,Rao; Bhaskar D.,0,0,0,0
1668344852650,ECE 257B,A00,103655,Bharadia; Dinesh,0,0,0,0
1668344853073,ECE 258A,A00,103656,Milstein; Laurence B.,0,0,0,0
1668344853497,ECE 260B,A00,103658,Kang; Mingu,0,0,0,0
1668344853924,ECE 264A,A00,103659,Galton; Ian A,0,0,0,0
1668344854351,ECE 265A,A00,103661,Gudem; Prasad S.S.,0,0,0,0
1668344854778,ECE 265D,A00,103662,Gudem; Prasad S.S.,0,0,0,0
1668344855209,ECE 268,A00,103663,Koushanfar; Farinaz,0,0,0,0
1668344855633,ECE 269,A01,103665,Pal; Piya,0,0,0,0
1668344856058,ECE 271B,A00,103666,Vasconcelos; Manuela,0,0,0,0
1668344856481,ECE 276A,A00,103667,Atanasov; Nikolay A.,0,0,0,0
1668344856905,ECE 277,A00,103668,An; Cheolhong,0,0,0,0
1668344857327,ECE 279,A00,117947,Hall; Drew A.,0,0,0,0
1668344858180,ECE 283,A00,103670,Hsueh; Tzu-Chien,0,0,0,0
1668344858605,ECE 284,A00,103671,Turakhia; Yatish Girish,0,0,0,0
1668344859034,ECE 285,A00,103672,Zheng; Yang,0,0,0,0
1668344859034,ECE 285,B00,103673,Sworder; David D.,0,0,0,0
1668344859457,ECE 287,A00,103676,Javidi; Tara,0,0,0,0
1668344859880,MATH 200B,A00,098023,Salehi Golsefidy; Alireza,12,0,15,3
1668344860304,MATH 202B,A00,098024,Rhoades; Brendon Patrick,9,0,15,6
1668344860730,MATH 203B,A00,098025,Oprea; Dragos N.,10,0,15,5
1668344861153,MATH 204B,A00,098026,Sorensen; Claus M,13,0,15,2
1668344861580,MATH 208,A00,098027,Izadi; Elham,7,0,10,3
1668344862006,MATH 209,A00,098028,Pollack; Aaron,10,0,10,0
1668344862429,MATH 211A,A00,112919,Rogalski; Daniel,9,0,10,1
1668344862852,MATH 211B,A00,112920,Seward; Brandon M.,9,0,10,1
1668344863276,MATH 218,A00,098029,Li; Bo,10,0,10,0
1668344863701,MATH 220B,A00,098030,Novak; Jonathan I,11,0,15,4
1668344864128,MATH 221A,A00,098031,Ebenfelt; Peter F,13,0,15,2
1668344864557,MATH 231B,A00,098032,Zlatos; Andrej,12,0,15,3
1668344864980,MATH 240B,A00,098033,Ni; Lei,9,0,15,6
1668344865403,MATH 243,A00,098034,Jekel; David Andrew,10,0,10,0
1668344865829,MATH 245A,A00,098035,Nie; Jiawang,0,0,15,16
1668344866254,MATH 248,A00,098036,Bejenaru; Ioan,10,0,10,0
1668344866678,MATH 250B,A00,098037,Spolaor; Luca,14,0,15,1
1668344867100,MATH 258,A00,098038,Ni; Lei,10,0,10,0
1668344867525,MATH 264B,A00,098041,Rhoades; Brendon Patrick,9,0,15,6
1668344867950,MATH 268,A00,098042,Buss; Samuel R,10,0,10,0
1668344868374,MATH 269,A00,098043,Rhoades; Brendon Patrick,10,0,10,0
1668344868798,MATH 270B,A00,098044,Li; Bo,10,0,15,5
1668344869225,MATH 272B,A00,098045,Holst; Michael J,13,0,15,2
1668344869648,MATH 273A,A00,098046,Tian; Xiaochuan,10,0,15,5
1668344870073,MATH 275,A01,098048,Tian; Xiaochuan,6,0,10,4
1668344870497,MATH 278A,A00,098049,Holst; Michael J,8,0,10,2
1668344870923,MATH 278B,A00,098050,Cloninger; Alexander,10,0,10,0
1668344871352,MATH 278C,A00,098051,Nie; Jiawang,7,0,10,3
1668344871778,MATH 280B,A00,098052,Zheng; Tianyi,8,0,15,7
1668344872292,MATH 281B,A00,098053,Bradic; Jelena,1,0,15,14
1668344872715,MATH 282B,A00,098054,Arias-Castro; Ery,0,0,15,15
1668344873138,MATH 285,A00,098055,Fitzsimmons; Patrick J,0,0,15,17
1668344873564,MATH 287B,A00,098056,Arias-Castro; Ery,2,0,15,13
1668344873996,MATH 288,A00,098057,Agarwal; Pooja,9,0,10,1
1668344873996,MATH 288,B00,098058,Zhang; Danna,8,0,10,2
1668344873996,MATH 288,C00,098059,Williams; Ruth J,9,0,10,1
1668344874430,MATH 290B,A00,098060,Roberts; Justin Deritter,13,0,15,2
1668344874856,MATH 292,A00,098061,Belmont; Eva Kinoshita,10,0,10,0
1668344875279,MATH 295,A00,098062,Suk; Andrew Hoon,48,0,50,2
1668344875718,MATH 296,A00,098063,Novak; Jonathan I,20,0,20,0
1668344876143,MATH 297,001,098064,Gamst; Anthony Collins,9997,0,9999,2
1668345374222,COGS 205,A00,101395,Chiba; Andrea,19,0,20,1
1668345374648,COGS 210B,001,101404,Greene; Deanna Jacquelyn,9998,0,9999,1
1668345374648,COGS 210B,002,101417,Xia; Haijun,9999,0,9999,0
1668345374648,COGS 210B,003,101422,Nitz; Douglas A.,9999,0,9999,0
1668345374648,COGS 210B,004,101423,Hollan; James D.,9998,0,9999,1
1668345374648,COGS 210B,005,101424,Deak; Gedeon O.,9998,0,9999,1
1668345374648,COGS 210B,006,101425,Rossano; Federico,9999,0,9999,0
1668345375073,COGS 211B,A00,101427,Coulson; Seana M,9996,0,9999,3
1668345375497,COGS 220,A00,101428,Hollan; James D.,0,0,25,25
1668345375921,COGS 229,A00,101429,Dow; Steven P,18,0,25,7
1668345376346,COGS 230,A00,101430,Klemmer; Scott R,11,0,17,6
1668345376772,COGS 234,A00,101431,Xia; Haijun,1,0,25,24
1668345377199,COGS 260,A00,101432,Kiyonaga; Anastasia,21,0,25,4
1668345377199,COGS 260,B00,101433,Kirsh; David Joel,15,0,25,10
1668345377622,CSE 202,A00,102371,Impagliazzo; Russell,0,0,0,0
1668345378050,CSE 203B,A01,102373,Cheng; Chung Kuan,0,0,0,0
1668345378473,CSE 208,A00,102374,Micciancio; Daniele,0,0,0,0
1668345378898,CSE 209A,A00,112895,Impagliazzo; Russell,0,0,15,15
1668345379323,CSE 209B,A00,108005,Bellare; Mihir,0,0,0,0
1668345379744,CSE 210,A00,113163,Coblenz; Michael J,0,0,0,0
1668345380171,CSE 219,A00,106111,Dow; Steven P,0,0,20,20
1668345380597,CSE 221,A00,102376,Voelker; Geoffrey M.,0,0,0,0
1668345381022,CSE 224,A01,102378,Porter; George M,0,0,0,0
1668345381444,CSE 229A,A00,102379,Savage; Stefan,0,0,0,0
1668345381870,CSE 229C,A00,102380,Munyaka; Imani N. S.,0,0,0,0
1668345382296,CSE 232B,A00,102382,Deutsch; Alin Bernard,0,0,0,0
1668345382721,CSE 234,A01,112904,Kumar; Arun Kumar,0,0,0,0
1668345383146,CSE 237A,A00,102383,Rosing; Tajana Simunic,0,0,0,0
1668345383571,CSE 239A,A00,102384,Deutsch; Alin Bernard,0,0,0,0
1668345383995,CSE 239B,A00,102385,Polikarpova; Nadezhda,0,0,0,0
1668345384421,CSE 240A,A00,102386,Pannuto; Patrick William,0,0,0,0
1668345384846,CSE 240B,A00,102387,Zhao; Jishen,0,0,0,0
1668345385273,CSE 241A,A00,106406,Kang; Mingu,0,0,0,0
1668345385696,CSE 249B,A00,102388,Kahng; Andrew Byun,0,0,8,8
1668345386122,CSE 251B,A01,102392,Cottrell; Garrison W,0,0,0,0
1668345386122,CSE 251B,A02,102393,Cottrell; Garrison W,0,0,0,0
1668345386548,CSE 252B,A00,102394,Ochoa; Benjamin Lawrence,0,0,0,0
1668345386974,CSE 257,A01,102396,Gao; Sicun,0,0,0,0
1668345387399,CSE 272,A00,102397,Li; Tzumao,0,0,0,0
1668345387824,CSE 274,A00,111323,Chern; Albert Ren-Haur,0,0,0,0
1668345388248,CSE 282,A00,102398,Pevzner; Pavel Arkadjevich,0,0,0,0
1668345388673,CSE 284,A00,114175,Gymrek; Melissa Ann,0,0,0,0
1668345389099,CSE 290,A00,102399,Chandraker; Manmohan Krishna,0,0,0,0
1668345389099,CSE 290,B00,102400,Vaccaro; Kristen Marie,0,0,25,25
1668345389099,CSE 290,C00,102414,Pannuto; Patrick William,0,0,25,25
1668345389099,CSE 290,D00,102427,Pevzner; Pavel Arkadjevich,0,0,0,0
1668345389099,CSE 290,E00,102429,Zhao; Jishen,0,0,0,0
1668345389099,CSE 290,F00,102436,Tullsen; Dean Michael,0,0,0,0
1668345389099,CSE 290,G00,102440,Christensen; Henrik I,0,0,20,20
1668345389529,CSE 291,A00,102443,Su; Hao,0,0,0,0
1668345389529,CSE 291,B00,102448,Polikarpova; Nadezhda,0,0,0,0
1668345389529,CSE 291,C00,102453,Vaccaro; Kristen Marie,0,0,0,0
1668345389529,CSE 291,D00,111343,Savage; Stefan,0,0,0,0
1668345389529,CSE 291,E00,116474,Claffy; Kimberly Claire,0,0,0,0
1668345389529,CSE 291,F00,116479,Pasquale; Joseph,0,0,0,0
1668345389956,CSE 293,001,119111,Bafna; Vineet,9999,0,9999,0
1668345389956,CSE 293,002,119118,Bellare; Mihir,9999,0,9999,0
1668345389956,CSE 293,003,119122,Berg-Kirkpatrick; Taylor D,9999,0,9999,0
1668345389956,CSE 293,004,119135,Christensen; Henrik I,9999,0,9999,0
1668345389956,CSE 293,005,119142,Cottrell; Garrison W,9999,0,9999,0
1668345389956,CSE 293,006,119146,Deutsch; Alin Bernard,9999,0,9999,0
1668345389956,CSE 293,007,119159,Esmaeilzadeh; Hadi,9999,0,9999,0
1668345389956,CSE 293,008,119166,Freund; Yoav,9999,0,9999,0
1668345389956,CSE 293,009,119170,Griswold; William G.,9999,0,9999,0
1668345389956,CSE 293,010,119183,Gymrek; Melissa Ann,9999,0,9999,0
1668345389956,CSE 293,011,119190,Heninger; Nadia A,9999,0,9999,0
1668345389956,CSE 293,012,119230,Impagliazzo; Russell,9999,0,9999,0
1668345389956,CSE 293,013,119232,Jhala; Ranjit,9999,0,9999,0
1668345389956,CSE 293,014,119233,Kahng; Andrew Byun,9999,0,9999,0
1668345389956,CSE 293,015,119298,Kane; Daniel Mertz,9999,0,9999,0
1668345389956,CSE 293,016,119299,Kriegman; David J,9999,0,9999,0
1668345389956,CSE 293,017,119300,Kumar; Arun Kumar,9999,0,9999,0
1668345389956,CSE 293,018,119301,Lerner; Sorin,9999,0,9999,0
1668345389956,CSE 293,019,119302,Lovett; Shachar,9999,0,9999,0
1668345389956,CSE 293,020,119303,McAuley; Julian John,9999,0,9999,0
1668345389956,CSE 293,021,119304,Micciancio; Daniele,9999,0,9999,0
1668345389956,CSE 293,022,119367,Orailoglu; Alex,9999,0,9999,0
1668345389956,CSE 293,023,119382,Paturi; Ramamohan,9999,0,9999,0
1668345389956,CSE 293,024,119404,Polikarpova; Nadezhda,9999,0,9999,0
1668345389956,CSE 293,025,119406,Politz; Joseph Gibbs,9999,0,9999,0
1668345389956,CSE 293,026,119411,Porter; George M,9999,0,9999,0
1668345389956,CSE 293,027,119414,Porter; Leonard Emerson,9999,0,9999,0
1668345389956,CSE 293,028,119416,Ramamoorthi; Ravi,9999,0,9999,0
1668345389956,CSE 293,029,119417,Sahoo; Debashis,9999,0,9999,0
1668345389956,CSE 293,030,119420,Saul; Lawrence,9999,0,9999,0
1668345389956,CSE 293,031,119421,Savage; Stefan,9999,0,9999,0
1668345389956,CSE 293,032,119425,Schulze; Jurgen P.,9999,0,9999,0
1668345389956,CSE 293,033,119426,Snoeren; Alex C.,9999,0,9999,0
1668345389956,CSE 293,034,119428,Shang; Jingbo,9999,0,9999,0
1668345389956,CSE 293,035,119430,Stefan; Deian,9999,0,9999,0
1668345389956,CSE 293,036,119431,Su; Hao,9999,0,9999,0
1668345389956,CSE 293,037,119433,Swanson; Steven James,9999,0,9999,0
1668345389956,CSE 293,038,119435,Tullsen; Dean Michael,9999,0,9999,0
1668345389956,CSE 293,039,119483,Voelker; Geoffrey M.,9999,0,9999,0
1668345389956,CSE 293,040,119537,Zhao; Jishen,9999,0,9999,0
1668345389956,CSE 293,041,119538,Zhou; Yuan-Yuan,9999,0,9999,0
1668345389956,CSE 293,042,119539,Gao; Sicun,9999,0,9999,0
1668345389956,CSE 293,043,119540,Weibel; Nadir,9999,0,9999,0
1668345389956,CSE 293,044,119541,Gupta; Rajesh K.,9999,0,9999,0
1668345389956,CSE 293,045,126410,Vaccaro; Kristen Marie,9999,0,9999,0
1668345389956,CSE 293,046,126411,Klemke; Richard,9999,0,9999,0
1668345390471,CSE 294,A00,102459,Voelker; Geoffrey M.,0,0,0,0
1668345390471,CSE 294,B00,111322,Orailoglu; Alex,0,0,0,0
1668345390898,DSE 201,A00,096914,Deutsch; Alin Bernard,30,0,30,0
1668345391323,DSE 210,A00,096915,Dasgupta; Sanjoy,30,0,30,0
1668345391749,DSE 260A,A00,096916,Altintas De Callaf; Ilkay,30,0,30,0
1668345392199,ECE 200,001,103586,Antipa; Nicholas A,9999,0,9999,0
1668345392199,ECE 200,002,103587,Atanasov; Nikolay A.,9999,0,9999,0
1668345392199,ECE 200,003,103588,Bharadia; Dinesh,9999,0,9999,0
1668345392199,ECE 200,004,103589,Cheng; Chung Kuan,9999,0,9999,0
1668345392199,ECE 200,005,103590,Cosman; Pamela C.,9999,0,9999,0
1668345392199,ECE 200,006,103591,Dayeh; Shadi Ahmad,9999,0,9999,0
1668345392199,ECE 200,007,103592,Fainman; Yeshaiahu,9999,0,9999,0
1668345392199,ECE 200,008,103593,Ford; Joseph Earl,9999,0,9999,0
1668345392199,ECE 200,009,103594,Franceschetti; Massimo,9999,0,9999,0
1668345392199,ECE 200,010,103595,Fullerton; Eric E,9999,0,9999,0
1668345392199,ECE 200,011,103596,Galton; Ian A,9999,0,9999,0
1668345392199,ECE 200,012,103597,Gilja; Vikash,9999,0,9999,0
1668345392199,ECE 200,013,103598,Hall; Drew A.,9999,0,9999,0
1668345392199,ECE 200,014,103599,Hsueh; Tzu-Chien,9999,0,9999,0
1668345392199,ECE 200,015,103600,Javidi; Tara,9999,0,9999,0
1668345392199,ECE 200,016,103601,Kahng; Andrew Byun,9999,0,9999,0
1668345392199,ECE 200,017,103602,Kim; Young-Han,9999,0,9999,0
1668345392199,ECE 200,018,103603,Koushanfar; Farinaz,9999,0,9999,0
1668345392199,ECE 200,019,103604,Kuzum; Duygu,9999,0,9999,0
1668345392199,ECE 200,020,103605,Le; Hanh-Phuc,9999,0,9999,0
1668345392199,ECE 200,021,103606,Lin; Bill,9999,0,9999,0
1668345392199,ECE 200,022,103607,Liu; Zhaowei,9998,0,9999,1
1668345392199,ECE 200,023,103608,Lo; Yu-Hwa,9999,0,9999,0
1668345392199,ECE 200,024,103609,Lomakin; Vitaliy,9999,0,9999,0
1668345392199,ECE 200,025,103610,Mercier; Patrick Philip,9999,0,9999,0
1668345392199,ECE 200,026,103611,Meyer; Florian,9999,0,9999,0
1668345392199,ECE 200,027,103612,Milstein; Laurence B.,9999,0,9999,0
1668345392199,ECE 200,028,103613,Mir Arabbaygi; Siavash,9999,0,9999,0
1668345392199,ECE 200,029,103614,Mookherjea; Shayan,9999,0,9999,0
1668345392199,ECE 200,030,103615,Morris; Karcher William,9999,0,9999,0
1668345392199,ECE 200,031,103616,Ng; Tse Nga,9999,0,9999,0
1668345392199,ECE 200,032,103617,Nguyen; Truong Quang,9999,0,9999,0
1668345392199,ECE 200,033,103618,Nomura; Kenji,9999,0,9999,0
1668345392199,ECE 200,034,103619,Orlitsky; Alon,9999,0,9999,0
1668345392199,ECE 200,035,103620,Pal; Piya,9999,0,9999,0
1668345392199,ECE 200,036,103621,Papen; George C.,9999,0,9999,0
1668345392199,ECE 200,037,103622,Radic; Stojan,9999,0,9999,0
1668345392199,ECE 200,038,103623,Rao; Bhaskar D.,9999,0,9999,0
1668345392199,ECE 200,039,103624,Rao; Ramesh R,9999,0,9999,0
1668345392199,ECE 200,040,103625,Rebeiz; Gabriel,9999,0,9999,0
1668345392199,ECE 200,041,103626,Sanford; John R,9999,0,9999,0
1668345392199,ECE 200,042,103627,Siegel; Paul H.,9999,0,9999,0
1668345392199,ECE 200,043,103628,Sievenpiper; Daniel F.,9999,0,9999,0
1668345392199,ECE 200,044,103629,Sworder; David D.,9999,0,9999,0
1668345392199,ECE 200,045,103630,Taur; Yuan,9999,0,9999,0
1668345392199,ECE 200,046,103631,Touri; Behrouz,9999,0,9999,0
1668345392199,ECE 200,047,103632,Trivedi; Mohan M.,9999,0,9999,0
1668345392199,ECE 200,048,103633,Vasconcelos; Nuno,9999,0,9999,0
1668345392199,ECE 200,049,103634,Wang; Xiaolong,9999,0,9999,0
1668345392199,ECE 200,050,103635,Xie; Pengtao,9999,0,9999,0
1668345392199,ECE 200,051,103636,Yip; Michael,9999,0,9999,0
1668345392199,ECE 200,052,103637,Zeger; Kenneth A.,999,0,999,0
1668345392199,ECE 200,053,103638,Zhang; Xinyu,9999,0,9999,0
1668345392199,ECE 200,054,103639,Turakhia; Yatish Girish,9999,0,9999,0
1668345392199,ECE 200,055,103640,Kang; Mingu,9999,0,9999,0
1668345392199,ECE 200,056,103641,Shi; Yuanyuan,9999,0,9999,0
1668345392199,ECE 200,057,103642,Wang; Edward Jay,9999,0,9999,0
1668345392199,ECE 200,058,103643,Zheng; Yang,9999,0,9999,0
1668345392622,ECE 202,A00,103644,Kuzum; Duygu,0,0,0,0
1668345393048,ECE 212BN,A00,103646,Ng; Tse Nga,0,0,0,0
1668345393470,ECE 221,A00,111493,Staff,0,0,0,0
1668345393897,ECE 222B,A00,103647,Lomakin; Vitaliy,0,0,0,0
1668345394322,ECE 230B,A00,103648,Taur; Yuan,0,0,0,0
1668345394751,ECE 238B,A00,103649,Garay; Javier,0,0,0,0
1668345395179,ECE 240B,A00,112900,Fainman; Yeshaiahu,0,0,0,0
1668345395605,ECE 247A,A00,103650,Jokerst; Jesse Vincent,0,0,0,0
1668345396029,ECE 247B,A00,103651,Wang; Joseph,0,0,0,0
1668345396454,ECE 250,A00,103652,Siegel; Paul H.,0,0,0,0
1668345396880,ECE 251A,A00,103654,Rao; Bhaskar D.,0,0,0,0
1668345397306,ECE 257B,A00,103655,Bharadia; Dinesh,0,0,0,0
1668345397732,ECE 258A,A00,103656,Milstein; Laurence B.,0,0,0,0
1668345398156,ECE 260B,A00,103658,Kang; Mingu,0,0,0,0
1668345398583,ECE 264A,A00,103659,Galton; Ian A,0,0,0,0
1668345399008,ECE 265A,A00,103661,Gudem; Prasad S.S.,0,0,0,0
1668345399433,ECE 265D,A00,103662,Gudem; Prasad S.S.,0,0,0,0
1668345399855,ECE 268,A00,103663,Koushanfar; Farinaz,0,0,0,0
1668345400278,ECE 269,A01,103665,Pal; Piya,0,0,0,0
1668345400701,ECE 271B,A00,103666,Vasconcelos; Manuela,0,0,0,0
1668345401128,ECE 276A,A00,103667,Atanasov; Nikolay A.,0,0,0,0
1668345401552,ECE 277,A00,103668,An; Cheolhong,0,0,0,0
1668345401975,ECE 279,A00,117947,Hall; Drew A.,0,0,0,0
1668345402822,ECE 283,A00,103670,Hsueh; Tzu-Chien,0,0,0,0
1668345403263,ECE 284,A00,103671,Turakhia; Yatish Girish,0,0,0,0
1668345403691,ECE 285,A00,103672,Zheng; Yang,0,0,0,0
1668345403691,ECE 285,B00,103673,Sworder; David D.,0,0,0,0
1668345404116,ECE 287,A00,103676,Javidi; Tara,0,0,0,0
1668345404538,MATH 200B,A00,098023,Salehi Golsefidy; Alireza,12,0,15,3
1668345404964,MATH 202B,A00,098024,Rhoades; Brendon Patrick,9,0,15,6
1668345405391,MATH 203B,A00,098025,Oprea; Dragos N.,10,0,15,5
1668345405814,MATH 204B,A00,098026,Sorensen; Claus M,13,0,15,2
1668345406247,MATH 208,A00,098027,Izadi; Elham,7,0,10,3
1668345406670,MATH 209,A00,098028,Pollack; Aaron,10,0,10,0
1668345407096,MATH 211A,A00,112919,Rogalski; Daniel,9,0,10,1
1668345407520,MATH 211B,A00,112920,Seward; Brandon M.,9,0,10,1
1668345407943,MATH 218,A00,098029,Li; Bo,10,0,10,0
1668345408367,MATH 220B,A00,098030,Novak; Jonathan I,11,0,15,4
1668345408793,MATH 221A,A00,098031,Ebenfelt; Peter F,13,0,15,2
1668345409216,MATH 231B,A00,098032,Zlatos; Andrej,12,0,15,3
1668345409642,MATH 240B,A00,098033,Ni; Lei,9,0,15,6
1668345410068,MATH 243,A00,098034,Jekel; David Andrew,10,0,10,0
1668345410491,MATH 245A,A00,098035,Nie; Jiawang,0,0,15,16
1668345410915,MATH 248,A00,098036,Bejenaru; Ioan,10,0,10,0
1668345411341,MATH 250B,A00,098037,Spolaor; Luca,14,0,15,1
1668345411763,MATH 258,A00,098038,Ni; Lei,10,0,10,0
1668345412187,MATH 264B,A00,098041,Rhoades; Brendon Patrick,9,0,15,6
1668345412613,MATH 268,A00,098042,Buss; Samuel R,10,0,10,0
1668345413039,MATH 269,A00,098043,Rhoades; Brendon Patrick,10,0,10,0
1668345413471,MATH 270B,A00,098044,Li; Bo,10,0,15,5
1668345413897,MATH 272B,A00,098045,Holst; Michael J,13,0,15,2
1668345414322,MATH 273A,A00,098046,Tian; Xiaochuan,10,0,15,5
1668345414745,MATH 275,A01,098048,Tian; Xiaochuan,6,0,10,4
1668345415169,MATH 278A,A00,098049,Holst; Michael J,8,0,10,2
1668345415594,MATH 278B,A00,098050,Cloninger; Alexander,10,0,10,0
1668345416016,MATH 278C,A00,098051,Nie; Jiawang,7,0,10,3
1668345416443,MATH 280B,A00,098052,Zheng; Tianyi,8,0,15,7
1668345416870,MATH 281B,A00,098053,Bradic; Jelena,1,0,15,14
1668345417300,MATH 282B,A00,098054,Arias-Castro; Ery,0,0,15,15
1668345417726,MATH 285,A00,098055,Fitzsimmons; Patrick J,0,0,15,17
1668345418152,MATH 287B,A00,098056,Arias-Castro; Ery,2,0,15,13
1668345418575,MATH 288,A00,098057,Agarwal; Pooja,9,0,10,1
1668345418575,MATH 288,B00,098058,Zhang; Danna,8,0,10,2
1668345418575,MATH 288,C00,098059,Williams; Ruth J,9,0,10,1
1668345418999,MATH 290B,A00,098060,Roberts; Justin Deritter,13,0,15,2
1668345419421,MATH 292,A00,098061,Belmont; Eva Kinoshita,10,0,10,0
1668345419844,MATH 295,A00,098062,Suk; Andrew Hoon,48,0,50,2
1668345420277,MATH 296,A00,098063,Novak; Jonathan I,20,0,20,0
1668345420703,MATH 297,001,098064,Gamst; Anthony Collins,9997,0,9999,2
1668345918309,COGS 205,A00,101395,Chiba; Andrea,19,0,20,1
1668345918739,COGS 210B,001,101404,Greene; Deanna Jacquelyn,9998,0,9999,1
1668345918739,COGS 210B,002,101417,Xia; Haijun,9999,0,9999,0
1668345918739,COGS 210B,003,101422,Nitz; Douglas A.,9999,0,9999,0
1668345918739,COGS 210B,004,101423,Hollan; James D.,9998,0,9999,1
1668345918739,COGS 210B,005,101424,Deak; Gedeon O.,9998,0,9999,1
1668345918739,COGS 210B,006,101425,Rossano; Federico,9999,0,9999,0
1668345919163,COGS 211B,A00,101427,Coulson; Seana M,9996,0,9999,3
1668345919588,COGS 220,A00,101428,Hollan; James D.,0,0,25,25
1668345920010,COGS 229,A00,101429,Dow; Steven P,18,0,25,7
1668345920435,COGS 230,A00,101430,Klemmer; Scott R,11,0,17,6
1668345920860,COGS 234,A00,101431,Xia; Haijun,1,0,25,24
1668345921283,COGS 260,A00,101432,Kiyonaga; Anastasia,21,0,25,4
1668345921283,COGS 260,B00,101433,Kirsh; David Joel,15,0,25,10
1668345921707,CSE 202,A00,102371,Impagliazzo; Russell,0,0,0,0
1668345922129,CSE 203B,A01,102373,Cheng; Chung Kuan,0,0,0,0
1668345922552,CSE 208,A00,102374,Micciancio; Daniele,0,0,0,0
1668345922975,CSE 209A,A00,112895,Impagliazzo; Russell,0,0,15,15
1668345923400,CSE 209B,A00,108005,Bellare; Mihir,0,0,0,0
1668345923826,CSE 210,A00,113163,Coblenz; Michael J,0,0,0,0
1668345924252,CSE 219,A00,106111,Dow; Steven P,0,0,20,20
1668345924686,CSE 221,A00,102376,Voelker; Geoffrey M.,0,0,0,0
1668345925114,CSE 224,A01,102378,Porter; George M,0,0,0,0
1668345925550,CSE 229A,A00,102379,Savage; Stefan,0,0,0,0
1668345925972,CSE 229C,A00,102380,Munyaka; Imani N. S.,0,0,0,0
1668345926399,CSE 232B,A00,102382,Deutsch; Alin Bernard,0,0,0,0
1668345926824,CSE 234,A01,112904,Kumar; Arun Kumar,0,0,0,0
1668345927249,CSE 237A,A00,102383,Rosing; Tajana Simunic,0,0,0,0
1668345927671,CSE 239A,A00,102384,Deutsch; Alin Bernard,0,0,0,0
1668345928094,CSE 239B,A00,102385,Polikarpova; Nadezhda,0,0,0,0
1668345928518,CSE 240A,A00,102386,Pannuto; Patrick William,0,0,0,0
1668345928941,CSE 240B,A00,102387,Zhao; Jishen,0,0,0,0
1668345929365,CSE 241A,A00,106406,Kang; Mingu,0,0,0,0
1668345929788,CSE 249B,A00,102388,Kahng; Andrew Byun,0,0,8,8
1668345930212,CSE 251B,A01,102392,Cottrell; Garrison W,0,0,0,0
1668345930212,CSE 251B,A02,102393,Cottrell; Garrison W,0,0,0,0
1668345930637,CSE 252B,A00,102394,Ochoa; Benjamin Lawrence,0,0,0,0
1668345931063,CSE 257,A01,102396,Gao; Sicun,0,0,0,0
1668345931486,CSE 272,A00,102397,Li; Tzumao,0,0,0,0
1668345931911,CSE 274,A00,111323,Chern; Albert Ren-Haur,0,0,0,0
1668345932334,CSE 282,A00,102398,Pevzner; Pavel Arkadjevich,0,0,0,0
1668345932756,CSE 284,A00,114175,Gymrek; Melissa Ann,0,0,0,0
1668345933180,CSE 290,A00,102399,Chandraker; Manmohan Krishna,0,0,0,0
1668345933180,CSE 290,B00,102400,Vaccaro; Kristen Marie,0,0,25,25
1668345933180,CSE 290,C00,102414,Pannuto; Patrick William,0,0,25,25
1668345933180,CSE 290,D00,102427,Pevzner; Pavel Arkadjevich,0,0,0,0
1668345933180,CSE 290,E00,102429,Zhao; Jishen,0,0,0,0
1668345933180,CSE 290,F00,102436,Tullsen; Dean Michael,0,0,0,0
1668345933180,CSE 290,G00,102440,Christensen; Henrik I,0,0,20,20
1668345933613,CSE 291,A00,102443,Su; Hao,0,0,0,0
1668345933613,CSE 291,B00,102448,Polikarpova; Nadezhda,0,0,0,0
1668345933613,CSE 291,C00,102453,Vaccaro; Kristen Marie,0,0,0,0
1668345933613,CSE 291,D00,111343,Savage; Stefan,0,0,0,0
1668345933613,CSE 291,E00,116474,Claffy; Kimberly Claire,0,0,0,0
1668345933613,CSE 291,F00,116479,Pasquale; Joseph,0,0,0,0
1668345934047,CSE 293,001,119111,Bafna; Vineet,9999,0,9999,0
1668345934047,CSE 293,002,119118,Bellare; Mihir,9999,0,9999,0
1668345934047,CSE 293,003,119122,Berg-Kirkpatrick; Taylor D,9999,0,9999,0
1668345934047,CSE 293,004,119135,Christensen; Henrik I,9999,0,9999,0
1668345934047,CSE 293,005,119142,Cottrell; Garrison W,9999,0,9999,0
1668345934047,CSE 293,006,119146,Deutsch; Alin Bernard,9999,0,9999,0
1668345934047,CSE 293,007,119159,Esmaeilzadeh; Hadi,9999,0,9999,0
1668345934047,CSE 293,008,119166,Freund; Yoav,9999,0,9999,0
1668345934047,CSE 293,009,119170,Griswold; William G.,9999,0,9999,0
1668345934047,CSE 293,010,119183,Gymrek; Melissa Ann,9999,0,9999,0
1668345934047,CSE 293,011,119190,Heninger; Nadia A,9999,0,9999,0
1668345934047,CSE 293,012,119230,Impagliazzo; Russell,9999,0,9999,0
1668345934047,CSE 293,013,119232,Jhala; Ranjit,9999,0,9999,0
1668345934047,CSE 293,014,119233,Kahng; Andrew Byun,9999,0,9999,0
1668345934047,CSE 293,015,119298,Kane; Daniel Mertz,9999,0,9999,0
1668345934047,CSE 293,016,119299,Kriegman; David J,9999,0,9999,0
1668345934047,CSE 293,017,119300,Kumar; Arun Kumar,9999,0,9999,0
1668345934047,CSE 293,018,119301,Lerner; Sorin,9999,0,9999,0
1668345934047,CSE 293,019,119302,Lovett; Shachar,9999,0,9999,0
1668345934047,CSE 293,020,119303,McAuley; Julian John,9999,0,9999,0
1668345934047,CSE 293,021,119304,Micciancio; Daniele,9999,0,9999,0
1668345934047,CSE 293,022,119367,Orailoglu; Alex,9999,0,9999,0
1668345934047,CSE 293,023,119382,Paturi; Ramamohan,9999,0,9999,0
1668345934047,CSE 293,024,119404,Polikarpova; Nadezhda,9999,0,9999,0
1668345934047,CSE 293,025,119406,Politz; Joseph Gibbs,9999,0,9999,0
1668345934047,CSE 293,026,119411,Porter; George M,9999,0,9999,0
1668345934047,CSE 293,027,119414,Porter; Leonard Emerson,9999,0,9999,0
1668345934047,CSE 293,028,119416,Ramamoorthi; Ravi,9999,0,9999,0
1668345934047,CSE 293,029,119417,Sahoo; Debashis,9999,0,9999,0
1668345934047,CSE 293,030,119420,Saul; Lawrence,9999,0,9999,0
1668345934047,CSE 293,031,119421,Savage; Stefan,9999,0,9999,0
1668345934047,CSE 293,032,119425,Schulze; Jurgen P.,9999,0,9999,0
1668345934047,CSE 293,033,119426,Snoeren; Alex C.,9999,0,9999,0
1668345934047,CSE 293,034,119428,Shang; Jingbo,9999,0,9999,0
1668345934047,CSE 293,035,119430,Stefan; Deian,9999,0,9999,0
1668345934047,CSE 293,036,119431,Su; Hao,9999,0,9999,0
1668345934047,CSE 293,037,119433,Swanson; Steven James,9999,0,9999,0
1668345934047,CSE 293,038,119435,Tullsen; Dean Michael,9999,0,9999,0
1668345934047,CSE 293,039,119483,Voelker; Geoffrey M.,9999,0,9999,0
1668345934047,CSE 293,040,119537,Zhao; Jishen,9999,0,9999,0
1668345934047,CSE 293,041,119538,Zhou; Yuan-Yuan,9999,0,9999,0
1668345934047,CSE 293,042,119539,Gao; Sicun,9999,0,9999,0
1668345934047,CSE 293,043,119540,Weibel; Nadir,9999,0,9999,0
1668345934047,CSE 293,044,119541,Gupta; Rajesh K.,9999,0,9999,0
1668345934047,CSE 293,045,126410,Vaccaro; Kristen Marie,9999,0,9999,0
1668345934047,CSE 293,046,126411,Klemke; Richard,9999,0,9999,0
1668345934468,CSE 294,A00,102459,Voelker; Geoffrey M.,0,0,0,0
1668345934468,CSE 294,B00,111322,Orailoglu; Alex,0,0,0,0
1668345934895,DSE 201,A00,096914,Deutsch; Alin Bernard,30,0,30,0
1668345935317,DSE 210,A00,096915,Dasgupta; Sanjoy,30,0,30,0
1668345935743,DSE 260A,A00,096916,Altintas De Callaf; Ilkay,30,0,30,0
1668345936177,ECE 200,001,103586,Antipa; Nicholas A,9999,0,9999,0
1668345936177,ECE 200,002,103587,Atanasov; Nikolay A.,9999,0,9999,0
1668345936177,ECE 200,003,103588,Bharadia; Dinesh,9999,0,9999,0
1668345936177,ECE 200,004,103589,Cheng; Chung Kuan,9999,0,9999,0
1668345936177,ECE 200,005,103590,Cosman; Pamela C.,9999,0,9999,0
1668345936177,ECE 200,006,103591,Dayeh; Shadi Ahmad,9999,0,9999,0
1668345936177,ECE 200,007,103592,Fainman; Yeshaiahu,9999,0,9999,0
1668345936177,ECE 200,008,103593,Ford; Joseph Earl,9999,0,9999,0
1668345936177,ECE 200,009,103594,Franceschetti; Massimo,9999,0,9999,0
1668345936177,ECE 200,010,103595,Fullerton; Eric E,9999,0,9999,0
1668345936177,ECE 200,011,103596,Galton; Ian A,9999,0,9999,0
1668345936177,ECE 200,012,103597,Gilja; Vikash,9999,0,9999,0
1668345936177,ECE 200,013,103598,Hall; Drew A.,9999,0,9999,0
1668345936177,ECE 200,014,103599,Hsueh; Tzu-Chien,9999,0,9999,0
1668345936177,ECE 200,015,103600,Javidi; Tara,9999,0,9999,0
1668345936177,ECE 200,016,103601,Kahng; Andrew Byun,9999,0,9999,0
1668345936177,ECE 200,017,103602,Kim; Young-Han,9999,0,9999,0
1668345936177,ECE 200,018,103603,Koushanfar; Farinaz,9999,0,9999,0
1668345936177,ECE 200,019,103604,Kuzum; Duygu,9999,0,9999,0
1668345936177,ECE 200,020,103605,Le; Hanh-Phuc,9999,0,9999,0
1668345936177,ECE 200,021,103606,Lin; Bill,9999,0,9999,0
1668345936177,ECE 200,022,103607,Liu; Zhaowei,9998,0,9999,1
1668345936177,ECE 200,023,103608,Lo; Yu-Hwa,9999,0,9999,0
1668345936177,ECE 200,024,103609,Lomakin; Vitaliy,9999,0,9999,0
1668345936177,ECE 200,025,103610,Mercier; Patrick Philip,9999,0,9999,0
1668345936177,ECE 200,026,103611,Meyer; Florian,9999,0,9999,0
1668345936177,ECE 200,027,103612,Milstein; Laurence B.,9999,0,9999,0
1668345936177,ECE 200,028,103613,Mir Arabbaygi; Siavash,9999,0,9999,0
1668345936177,ECE 200,029,103614,Mookherjea; Shayan,9999,0,9999,0
1668345936177,ECE 200,030,103615,Morris; Karcher William,9999,0,9999,0
1668345936177,ECE 200,031,103616,Ng; Tse Nga,9999,0,9999,0
1668345936177,ECE 200,032,103617,Nguyen; Truong Quang,9999,0,9999,0
1668345936177,ECE 200,033,103618,Nomura; Kenji,9999,0,9999,0
1668345936177,ECE 200,034,103619,Orlitsky; Alon,9999,0,9999,0
1668345936177,ECE 200,035,103620,Pal; Piya,9999,0,9999,0
1668345936177,ECE 200,036,103621,Papen; George C.,9999,0,9999,0
1668345936177,ECE 200,037,103622,Radic; Stojan,9999,0,9999,0
1668345936177,ECE 200,038,103623,Rao; Bhaskar D.,9999,0,9999,0
1668345936177,ECE 200,039,103624,Rao; Ramesh R,9999,0,9999,0
1668345936177,ECE 200,040,103625,Rebeiz; Gabriel,9999,0,9999,0
1668345936177,ECE 200,041,103626,Sanford; John R,9999,0,9999,0
1668345936177,ECE 200,042,103627,Siegel; Paul H.,9999,0,9999,0
1668345936177,ECE 200,043,103628,Sievenpiper; Daniel F.,9999,0,9999,0
1668345936177,ECE 200,044,103629,Sworder; David D.,9999,0,9999,0
1668345936177,ECE 200,045,103630,Taur; Yuan,9999,0,9999,0
1668345936177,ECE 200,046,103631,Touri; Behrouz,9999,0,9999,0
1668345936177,ECE 200,047,103632,Trivedi; Mohan M.,9999,0,9999,0
1668345936177,ECE 200,048,103633,Vasconcelos; Nuno,9999,0,9999,0
1668345936177,ECE 200,049,103634,Wang; Xiaolong,9999,0,9999,0
1668345936177,ECE 200,050,103635,Xie; Pengtao,9999,0,9999,0
1668345936177,ECE 200,051,103636,Yip; Michael,9999,0,9999,0
1668345936177,ECE 200,052,103637,Zeger; Kenneth A.,999,0,999,0
1668345936177,ECE 200,053,103638,Zhang; Xinyu,9999,0,9999,0
1668345936177,ECE 200,054,103639,Turakhia; Yatish Girish,9999,0,9999,0
1668345936177,ECE 200,055,103640,Kang; Mingu,9999,0,9999,0
1668345936177,ECE 200,056,103641,Shi; Yuanyuan,9999,0,9999,0
1668345936177,ECE 200,057,103642,Wang; Edward Jay,9999,0,9999,0
1668345936177,ECE 200,058,103643,Zheng; Yang,9999,0,9999,0
1668345936602,ECE 202,A00,103644,Kuzum; Duygu,0,0,0,0
1668345937024,ECE 212BN,A00,103646,Ng; Tse Nga,0,0,0,0
1668345937450,ECE 221,A00,111493,Staff,0,0,0,0
1668345937872,ECE 222B,A00,103647,Lomakin; Vitaliy,0,0,0,0
1668345938296,ECE 230B,A00,103648,Taur; Yuan,0,0,0,0
1668345938726,ECE 238B,A00,103649,Garay; Javier,0,0,0,0
1668345939153,ECE 240B,A00,112900,Fainman; Yeshaiahu,0,0,0,0
1668345939574,ECE 247A,A00,103650,Jokerst; Jesse Vincent,0,0,0,0
1668345939996,ECE 247B,A00,103651,Wang; Joseph,0,0,0,0
1668345940423,ECE 250,A00,103652,Siegel; Paul H.,0,0,0,0
1668345940849,ECE 251A,A00,103654,Rao; Bhaskar D.,0,0,0,0
1668345941273,ECE 257B,A00,103655,Bharadia; Dinesh,0,0,0,0
1668345941696,ECE 258A,A00,103656,Milstein; Laurence B.,0,0,0,0
1668345942120,ECE 260B,A00,103658,Kang; Mingu,0,0,0,0
1668345942541,ECE 264A,A00,103659,Galton; Ian A,0,0,0,0
1668345942969,ECE 265A,A00,103661,Gudem; Prasad S.S.,0,0,0,0
1668345943390,ECE 265D,A00,103662,Gudem; Prasad S.S.,0,0,0,0
1668345943813,ECE 268,A00,103663,Koushanfar; Farinaz,0,0,0,0
1668345944236,ECE 269,A01,103665,Pal; Piya,0,0,0,0
1668345944663,ECE 271B,A00,103666,Vasconcelos; Manuela,0,0,0,0
1668345945087,ECE 276A,A00,103667,Atanasov; Nikolay A.,0,0,0,0
1668345945511,ECE 277,A00,103668,An; Cheolhong,0,0,0,0
1668345945935,ECE 279,A00,117947,Hall; Drew A.,0,0,0,0
1668345946780,ECE 283,A00,103670,Hsueh; Tzu-Chien,0,0,0,0
1668345947204,ECE 284,A00,103671,Turakhia; Yatish Girish,0,0,0,0
1668345947627,ECE 285,A00,103672,Zheng; Yang,0,0,0,0
1668345947627,ECE 285,B00,103673,Sworder; David D.,0,0,0,0
1668345948050,ECE 287,A00,103676,Javidi; Tara,0,0,0,0
1668345948474,MATH 200B,A00,098023,Salehi Golsefidy; Alireza,12,0,15,3
1668345948903,MATH 202B,A00,098024,Rhoades; Brendon Patrick,9,0,15,6
1668345949350,MATH 203B,A00,098025,Oprea; Dragos N.,10,0,15,5
1668345949771,MATH 204B,A00,098026,Sorensen; Claus M,13,0,15,2
1668345950199,MATH 208,A00,098027,Izadi; Elham,7,0,10,3
1668345950621,MATH 209,A00,098028,Pollack; Aaron,10,0,10,0
1668345951119,MATH 211A,A00,112919,Rogalski; Daniel,9,0,10,1
1668345951545,MATH 211B,A00,112920,Seward; Brandon M.,9,0,10,1
1668345951970,MATH 218,A00,098029,Li; Bo,10,0,10,0
1668345952395,MATH 220B,A00,098030,Novak; Jonathan I,11,0,15,4
1668345952819,MATH 221A,A00,098031,Ebenfelt; Peter F,13,0,15,2
1668345953242,MATH 231B,A00,098032,Zlatos; Andrej,12,0,15,3
1668345953664,MATH 240B,A00,098033,Ni; Lei,9,0,15,6
1668345954089,MATH 243,A00,098034,Jekel; David Andrew,10,0,10,0
1668345954516,MATH 245A,A00,098035,Nie; Jiawang,0,0,15,16
1668345954937,MATH 248,A00,098036,Bejenaru; Ioan,10,0,10,0
1668345955360,MATH 250B,A00,098037,Spolaor; Luca,14,0,15,1
1668345955782,MATH 258,A00,098038,Ni; Lei,10,0,10,0
1668345956203,MATH 264B,A00,098041,Rhoades; Brendon Patrick,9,0,15,6
1668345956629,MATH 268,A00,098042,Buss; Samuel R,10,0,10,0
1668345957052,MATH 269,A00,098043,Rhoades; Brendon Patrick,10,0,10,0
1668345957474,MATH 270B,A00,098044,Li; Bo,10,0,15,5
1668345957898,MATH 272B,A00,098045,Holst; Michael J,13,0,15,2
1668345958324,MATH 273A,A00,098046,Tian; Xiaochuan,10,0,15,5
1668345958747,MATH 275,A01,098048,Tian; Xiaochuan,6,0,10,4
1668345959173,MATH 278A,A00,098049,Holst; Michael J,8,0,10,2
1668345959598,MATH 278B,A00,098050,Cloninger; Alexander,10,0,10,0
1668345960022,MATH 278C,A00,098051,Nie; Jiawang,7,0,10,3
1668345960445,MATH 280B,A00,098052,Zheng; Tianyi,8,0,15,7
1668345960871,MATH 281B,A00,098053,Bradic; Jelena,1,0,15,14
1668345961298,MATH 282B,A00,098054,Arias-Castro; Ery,0,0,15,15
1668345961722,MATH 285,A00,098055,Fitzsimmons; Patrick J,0,0,15,17
1668345962145,MATH 287B,A00,098056,Arias-Castro; Ery,2,0,15,13
1668345962566,MATH 288,A00,098057,Agarwal; Pooja,9,0,10,1
1668345962566,MATH 288,B00,098058,Zhang; Danna,8,0,10,2
1668345962566,MATH 288,C00,098059,Williams; Ruth J,9,0,10,1
1668345962990,MATH 290B,A00,098060,Roberts; Justin Deritter,13,0,15,2
1668345963415,MATH 292,A00,098061,Belmont; Eva Kinoshita,10,0,10,0
1668345963837,MATH 295,A00,098062,Suk; Andrew Hoon,48,0,50,2
1668345964261,MATH 296,A00,098063,Novak; Jonathan I,20,0,20,0
1668345964686,MATH 297,001,098064,Gamst; Anthony Collins,9997,0,9999,2
1668346462860,COGS 205,A00,101395,Chiba; Andrea,19,0,20,1
1668346463284,COGS 210B,001,101404,Greene; Deanna Jacquelyn,9998,0,9999,1
1668346463284,COGS 210B,002,101417,Xia; Haijun,9999,0,9999,0
1668346463284,COGS 210B,003,101422,Nitz; Douglas A.,9999,0,9999,0
1668346463284,COGS 210B,004,101423,Hollan; James D.,9998,0,9999,1
1668346463284,COGS 210B,005,101424,Deak; Gedeon O.,9998,0,9999,1
1668346463284,COGS 210B,006,101425,Rossano; Federico,9999,0,9999,0
1668346463716,COGS 211B,A00,101427,Coulson; Seana M,9996,0,9999,3
1668346464141,COGS 220,A00,101428,Hollan; James D.,0,0,25,25
1668346464565,COGS 229,A00,101429,Dow; Steven P,18,0,25,7
1668346464999,COGS 230,A00,101430,Klemmer; Scott R,11,0,17,6
1668346465422,COGS 234,A00,101431,Xia; Haijun,1,0,25,24
1668346465849,COGS 260,A00,101432,Kiyonaga; Anastasia,21,0,25,4
1668346465849,COGS 260,B00,101433,Kirsh; David Joel,15,0,25,10
1668346466275,CSE 202,A00,102371,Impagliazzo; Russell,0,0,0,0
1668346466701,CSE 203B,A01,102373,Cheng; Chung Kuan,0,0,0,0
1668346467133,CSE 208,A00,102374,Micciancio; Daniele,0,0,0,0
1668346467556,CSE 209A,A00,112895,Impagliazzo; Russell,0,0,15,15
1668346467980,CSE 209B,A00,108005,Bellare; Mihir,0,0,0,0
1668346468406,CSE 210,A00,113163,Coblenz; Michael J,0,0,0,0
1668346468831,CSE 219,A00,106111,Dow; Steven P,0,0,20,20
1668346469341,CSE 221,A00,102376,Voelker; Geoffrey M.,0,0,0,0
1668346469767,CSE 224,A01,102378,Porter; George M,0,0,0,0
1668346470195,CSE 229A,A00,102379,Savage; Stefan,0,0,0,0
1668346470624,CSE 229C,A00,102380,Munyaka; Imani N. S.,0,0,0,0
1668346471046,CSE 232B,A00,102382,Deutsch; Alin Bernard,0,0,0,0
1668346471472,CSE 234,A01,112904,Kumar; Arun Kumar,0,0,0,0
1668346471895,CSE 237A,A00,102383,Rosing; Tajana Simunic,0,0,0,0
1668346472318,CSE 239A,A00,102384,Deutsch; Alin Bernard,0,0,0,0
1668346472744,CSE 239B,A00,102385,Polikarpova; Nadezhda,0,0,0,0
1668346473168,CSE 240A,A00,102386,Pannuto; Patrick William,0,0,0,0
1668346473593,CSE 240B,A00,102387,Zhao; Jishen,0,0,0,0
1668346474018,CSE 241A,A00,106406,Kang; Mingu,0,0,0,0
1668346474447,CSE 249B,A00,102388,Kahng; Andrew Byun,0,0,8,8
1668346474874,CSE 251B,A01,102392,Cottrell; Garrison W,0,0,0,0
1668346474874,CSE 251B,A02,102393,Cottrell; Garrison W,0,0,0,0
1668346475299,CSE 252B,A00,102394,Ochoa; Benjamin Lawrence,0,0,0,0
1668346475725,CSE 257,A01,102396,Gao; Sicun,0,0,0,0
1668346476156,CSE 272,A00,102397,Li; Tzumao,0,0,0,0
1668346476577,CSE 274,A00,111323,Chern; Albert Ren-Haur,0,0,0,0
1668346477000,CSE 282,A00,102398,Pevzner; Pavel Arkadjevich,0,0,0,0
1668346477423,CSE 284,A00,114175,Gymrek; Melissa Ann,0,0,0,0
1668346477849,CSE 290,A00,102399,Chandraker; Manmohan Krishna,0,0,0,0
1668346477849,CSE 290,B00,102400,Vaccaro; Kristen Marie,0,0,25,25
1668346477849,CSE 290,C00,102414,Pannuto; Patrick William,0,0,25,25
1668346477849,CSE 290,D00,102427,Pevzner; Pavel Arkadjevich,0,0,0,0
1668346477849,CSE 290,E00,102429,Zhao; Jishen,0,0,0,0
1668346477849,CSE 290,F00,102436,Tullsen; Dean Michael,0,0,0,0
1668346477849,CSE 290,G00,102440,Christensen; Henrik I,0,0,20,20
1668346478276,CSE 291,A00,102443,Su; Hao,0,0,0,0
1668346478276,CSE 291,B00,102448,Polikarpova; Nadezhda,0,0,0,0
1668346478276,CSE 291,C00,102453,Vaccaro; Kristen Marie,0,0,0,0
1668346478276,CSE 291,D00,111343,Savage; Stefan,0,0,0,0
1668346478276,CSE 291,E00,116474,Claffy; Kimberly Claire,0,0,0,0
1668346478276,CSE 291,F00,116479,Pasquale; Joseph,0,0,0,0
1668346478710,CSE 293,001,119111,Bafna; Vineet,9999,0,9999,0
1668346478710,CSE 293,002,119118,Bellare; Mihir,9999,0,9999,0
1668346478710,CSE 293,003,119122,Berg-Kirkpatrick; Taylor D,9999,0,9999,0
1668346478710,CSE 293,004,119135,Christensen; Henrik I,9999,0,9999,0
1668346478710,CSE 293,005,119142,Cottrell; Garrison W,9999,0,9999,0
1668346478710,CSE 293,006,119146,Deutsch; Alin Bernard,9999,0,9999,0
1668346478710,CSE 293,007,119159,Esmaeilzadeh; Hadi,9999,0,9999,0
1668346478710,CSE 293,008,119166,Freund; Yoav,9999,0,9999,0
1668346478710,CSE 293,009,119170,Griswold; William G.,9999,0,9999,0
1668346478710,CSE 293,010,119183,Gymrek; Melissa Ann,9999,0,9999,0
1668346478710,CSE 293,011,119190,Heninger; Nadia A,9999,0,9999,0
1668346478710,CSE 293,012,119230,Impagliazzo; Russell,9999,0,9999,0
1668346478710,CSE 293,013,119232,Jhala; Ranjit,9999,0,9999,0
1668346478710,CSE 293,014,119233,Kahng; Andrew Byun,9999,0,9999,0
1668346478710,CSE 293,015,119298,Kane; Daniel Mertz,9999,0,9999,0
1668346478710,CSE 293,016,119299,Kriegman; David J,9999,0,9999,0
1668346478710,CSE 293,017,119300,Kumar; Arun Kumar,9999,0,9999,0
1668346478710,CSE 293,018,119301,Lerner; Sorin,9999,0,9999,0
1668346478710,CSE 293,019,119302,Lovett; Shachar,9999,0,9999,0
1668346478710,CSE 293,020,119303,McAuley; Julian John,9999,0,9999,0
1668346478710,CSE 293,021,119304,Micciancio; Daniele,9999,0,9999,0
1668346478710,CSE 293,022,119367,Orailoglu; Alex,9999,0,9999,0
1668346478710,CSE 293,023,119382,Paturi; Ramamohan,9999,0,9999,0
1668346478710,CSE 293,024,119404,Polikarpova; Nadezhda,9999,0,9999,0
1668346478710,CSE 293,025,119406,Politz; Joseph Gibbs,9999,0,9999,0
1668346478710,CSE 293,026,119411,Porter; George M,9999,0,9999,0
1668346478710,CSE 293,027,119414,Porter; Leonard Emerson,9999,0,9999,0
1668346478710,CSE 293,028,119416,Ramamoorthi; Ravi,9999,0,9999,0
1668346478710,CSE 293,029,119417,Sahoo; Debashis,9999,0,9999,0
1668346478710,CSE 293,030,119420,Saul; Lawrence,9999,0,9999,0
1668346478710,CSE 293,031,119421,Savage; Stefan,9999,0,9999,0
1668346478710,CSE 293,032,119425,Schulze; Jurgen P.,9999,0,9999,0
1668346478710,CSE 293,033,119426,Snoeren; Alex C.,9999,0,9999,0
1668346478710,CSE 293,034,119428,Shang; Jingbo,9999,0,9999,0
1668346478710,CSE 293,035,119430,Stefan; Deian,9999,0,9999,0
1668346478710,CSE 293,036,119431,Su; Hao,9999,0,9999,0
1668346478710,CSE 293,037,119433,Swanson; Steven James,9999,0,9999,0
1668346478710,CSE 293,038,119435,Tullsen; Dean Michael,9999,0,9999,0
1668346478710,CSE 293,039,119483,Voelker; Geoffrey M.,9999,0,9999,0
1668346478710,CSE 293,040,119537,Zhao; Jishen,9999,0,9999,0
1668346478710,CSE 293,041,119538,Zhou; Yuan-Yuan,9999,0,9999,0
1668346478710,CSE 293,042,119539,Gao; Sicun,9999,0,9999,0
1668346478710,CSE 293,043,119540,Weibel; Nadir,9999,0,9999,0
1668346478710,CSE 293,044,119541,Gupta; Rajesh K.,9999,0,9999,0
1668346478710,CSE 293,045,126410,Vaccaro; Kristen Marie,9999,0,9999,0
1668346478710,CSE 293,046,126411,Klemke; Richard,9999,0,9999,0
1668346479132,CSE 294,A00,102459,Voelker; Geoffrey M.,0,0,0,0
1668346479132,CSE 294,B00,111322,Orailoglu; Alex,0,0,0,0
1668346479557,DSE 201,A00,096914,Deutsch; Alin Bernard,30,0,30,0
1668346479981,DSE 210,A00,096915,Dasgupta; Sanjoy,30,0,30,0
1668346480420,DSE 260A,A00,096916,Altintas De Callaf; Ilkay,30,0,30,0
1668346480848,ECE 200,001,103586,Antipa; Nicholas A,9999,0,9999,0
1668346480848,ECE 200,002,103587,Atanasov; Nikolay A.,9999,0,9999,0
1668346480848,ECE 200,003,103588,Bharadia; Dinesh,9999,0,9999,0
1668346480848,ECE 200,004,103589,Cheng; Chung Kuan,9999,0,9999,0
1668346480848,ECE 200,005,103590,Cosman; Pamela C.,9999,0,9999,0
1668346480848,ECE 200,006,103591,Dayeh; Shadi Ahmad,9999,0,9999,0
1668346480848,ECE 200,007,103592,Fainman; Yeshaiahu,9999,0,9999,0
1668346480848,ECE 200,008,103593,Ford; Joseph Earl,9999,0,9999,0
1668346480848,ECE 200,009,103594,Franceschetti; Massimo,9999,0,9999,0
1668346480848,ECE 200,010,103595,Fullerton; Eric E,9999,0,9999,0
1668346480848,ECE 200,011,103596,Galton; Ian A,9999,0,9999,0
1668346480848,ECE 200,012,103597,Gilja; Vikash,9999,0,9999,0
1668346480848,ECE 200,013,103598,Hall; Drew A.,9999,0,9999,0
1668346480848,ECE 200,014,103599,Hsueh; Tzu-Chien,9999,0,9999,0
1668346480848,ECE 200,015,103600,Javidi; Tara,9999,0,9999,0
1668346480848,ECE 200,016,103601,Kahng; Andrew Byun,9999,0,9999,0
1668346480848,ECE 200,017,103602,Kim; Young-Han,9999,0,9999,0
1668346480848,ECE 200,018,103603,Koushanfar; Farinaz,9999,0,9999,0
1668346480848,ECE 200,019,103604,Kuzum; Duygu,9999,0,9999,0
1668346480848,ECE 200,020,103605,Le; Hanh-Phuc,9999,0,9999,0
1668346480848,ECE 200,021,103606,Lin; Bill,9999,0,9999,0
1668346480848,ECE 200,022,103607,Liu; Zhaowei,9998,0,9999,1
1668346480848,ECE 200,023,103608,Lo; Yu-Hwa,9999,0,9999,0
1668346480848,ECE 200,024,103609,Lomakin; Vitaliy,9999,0,9999,0
1668346480848,ECE 200,025,103610,Mercier; Patrick Philip,9999,0,9999,0
1668346480848,ECE 200,026,103611,Meyer; Florian,9999,0,9999,0
1668346480848,ECE 200,027,103612,Milstein; Laurence B.,9999,0,9999,0
1668346480848,ECE 200,028,103613,Mir Arabbaygi; Siavash,9999,0,9999,0
1668346480848,ECE 200,029,103614,Mookherjea; Shayan,9999,0,9999,0
1668346480848,ECE 200,030,103615,Morris; Karcher William,9999,0,9999,0
1668346480848,ECE 200,031,103616,Ng; Tse Nga,9999,0,9999,0
1668346480848,ECE 200,032,103617,Nguyen; Truong Quang,9999,0,9999,0
1668346480848,ECE 200,033,103618,Nomura; Kenji,9999,0,9999,0
1668346480848,ECE 200,034,103619,Orlitsky; Alon,9999,0,9999,0
1668346480848,ECE 200,035,103620,Pal; Piya,9999,0,9999,0
1668346480848,ECE 200,036,103621,Papen; George C.,9999,0,9999,0
1668346480848,ECE 200,037,103622,Radic; Stojan,9999,0,9999,0
1668346480848,ECE 200,038,103623,Rao; Bhaskar D.,9999,0,9999,0
1668346480848,ECE 200,039,103624,Rao; Ramesh R,9999,0,9999,0
1668346480848,ECE 200,040,103625,Rebeiz; Gabriel,9999,0,9999,0
1668346480848,ECE 200,041,103626,Sanford; John R,9999,0,9999,0
1668346480848,ECE 200,042,103627,Siegel; Paul H.,9999,0,9999,0
1668346480848,ECE 200,043,103628,Sievenpiper; Daniel F.,9999,0,9999,0
1668346480848,ECE 200,044,103629,Sworder; David D.,9999,0,9999,0
1668346480848,ECE 200,045,103630,Taur; Yuan,9999,0,9999,0
1668346480848,ECE 200,046,103631,Touri; Behrouz,9999,0,9999,0
1668346480848,ECE 200,047,103632,Trivedi; Mohan M.,9999,0,9999,0
1668346480848,ECE 200,048,103633,Vasconcelos; Nuno,9999,0,9999,0
1668346480848,ECE 200,049,103634,Wang; Xiaolong,9999,0,9999,0
1668346480848,ECE 200,050,103635,Xie; Pengtao,9999,0,9999,0
1668346480848,ECE 200,051,103636,Yip; Michael,9999,0,9999,0
1668346480848,ECE 200,052,103637,Zeger; Kenneth A.,999,0,999,0
1668346480848,ECE 200,053,103638,Zhang; Xinyu,9999,0,9999,0
1668346480848,ECE 200,054,103639,Turakhia; Yatish Girish,9999,0,9999,0
1668346480848,ECE 200,055,103640,Kang; Mingu,9999,0,9999,0
1668346480848,ECE 200,056,103641,Shi; Yuanyuan,9999,0,9999,0
1668346480848,ECE 200,057,103642,Wang; Edward Jay,9999,0,9999,0
1668346480848,ECE 200,058,103643,Zheng; Yang,9999,0,9999,0
1668346481271,ECE 202,A00,103644,Kuzum; Duygu,0,0,0,0
1668346481695,ECE 212BN,A00,103646,Ng; Tse Nga,0,0,0,0
1668346482123,ECE 221,A00,111493,Staff,0,0,0,0
1668346482549,ECE 222B,A00,103647,Lomakin; Vitaliy,0,0,0,0
1668346482982,ECE 230B,A00,103648,Taur; Yuan,0,0,0,0
1668346483407,ECE 238B,A00,103649,Garay; Javier,0,0,0,0
1668346483830,ECE 240B,A00,112900,Fainman; Yeshaiahu,0,0,0,0
1668346484253,ECE 247A,A00,103650,Jokerst; Jesse Vincent,0,0,0,0
1668346484679,ECE 247B,A00,103651,Wang; Joseph,0,0,0,0
1668346485102,ECE 250,A00,103652,Siegel; Paul H.,0,0,0,0
1668346485524,ECE 251A,A00,103654,Rao; Bhaskar D.,0,0,0,0
1668346485949,ECE 257B,A00,103655,Bharadia; Dinesh,0,0,0,0
1668346486374,ECE 258A,A00,103656,Milstein; Laurence B.,0,0,0,0
1668346486801,ECE 260B,A00,103658,Kang; Mingu,0,0,0,0
1668346487225,ECE 264A,A00,103659,Galton; Ian A,0,0,0,0
1668346487653,ECE 265A,A00,103661,Gudem; Prasad S.S.,0,0,0,0
1668346488076,ECE 265D,A00,103662,Gudem; Prasad S.S.,0,0,0,0
1668346488498,ECE 268,A00,103663,Koushanfar; Farinaz,0,0,0,0
1668346488925,ECE 269,A01,103665,Pal; Piya,0,0,0,0
1668346489351,ECE 271B,A00,103666,Vasconcelos; Manuela,0,0,0,0
1668346489777,ECE 276A,A00,103667,Atanasov; Nikolay A.,0,0,0,0
1668346490201,ECE 277,A00,103668,An; Cheolhong,0,0,0,0
1668346490630,ECE 279,A00,117947,Hall; Drew A.,0,0,0,0
1668346491480,ECE 283,A00,103670,Hsueh; Tzu-Chien,0,0,0,0
1668346491907,ECE 284,A00,103671,Turakhia; Yatish Girish,0,0,0,0
1668346492338,ECE 285,A00,103672,Zheng; Yang,0,0,0,0
1668346492338,ECE 285,B00,103673,Sworder; David D.,0,0,0,0
1668346492763,ECE 287,A00,103676,Javidi; Tara,0,0,0,0
1668346493185,MATH 200B,A00,098023,Salehi Golsefidy; Alireza,12,0,15,3
1668346493607,MATH 202B,A00,098024,Rhoades; Brendon Patrick,9,0,15,6
1668346494030,MATH 203B,A00,098025,Oprea; Dragos N.,10,0,15,5
1668346494452,MATH 204B,A00,098026,Sorensen; Claus M,13,0,15,2
1668346494874,MATH 208,A00,098027,Izadi; Elham,7,0,10,3
1668346495296,MATH 209,A00,098028,Pollack; Aaron,10,0,10,0
1668346495719,MATH 211A,A00,112919,Rogalski; Daniel,9,0,10,1
1668346496143,MATH 211B,A00,112920,Seward; Brandon M.,9,0,10,1
1668346496567,MATH 218,A00,098029,Li; Bo,10,0,10,0
1668346496989,MATH 220B,A00,098030,Novak; Jonathan I,11,0,15,4
1668346497416,MATH 221A,A00,098031,Ebenfelt; Peter F,13,0,15,2
1668346497854,MATH 231B,A00,098032,Zlatos; Andrej,12,0,15,3
1668346498277,MATH 240B,A00,098033,Ni; Lei,9,0,15,6
1668346498699,MATH 243,A00,098034,Jekel; David Andrew,10,0,10,0
1668346499123,MATH 245A,A00,098035,Nie; Jiawang,0,0,15,16
1668346499547,MATH 248,A00,098036,Bejenaru; Ioan,10,0,10,0
1668346499972,MATH 250B,A00,098037,Spolaor; Luca,14,0,15,1
1668346500396,MATH 258,A00,098038,Ni; Lei,10,0,10,0
1668346500820,MATH 264B,A00,098041,Rhoades; Brendon Patrick,9,0,15,6
1668346501241,MATH 268,A00,098042,Buss; Samuel R,10,0,10,0
1668346501665,MATH 269,A00,098043,Rhoades; Brendon Patrick,10,0,10,0
1668346502093,MATH 270B,A00,098044,Li; Bo,10,0,15,5
1668346502515,MATH 272B,A00,098045,Holst; Michael J,13,0,15,2
1668346502940,MATH 273A,A00,098046,Tian; Xiaochuan,10,0,15,5
1668346503363,MATH 275,A01,098048,Tian; Xiaochuan,6,0,10,4
1668346503790,MATH 278A,A00,098049,Holst; Michael J,8,0,10,2
1668346504213,MATH 278B,A00,098050,Cloninger; Alexander,10,0,10,0
1668346504635,MATH 278C,A00,098051,Nie; Jiawang,7,0,10,3
1668346505057,MATH 280B,A00,098052,Zheng; Tianyi,8,0,15,7
1668346505482,MATH 281B,A00,098053,Bradic; Jelena,1,0,15,14
1668346505906,MATH 282B,A00,098054,Arias-Castro; Ery,0,0,15,15
1668346506334,MATH 285,A00,098055,Fitzsimmons; Patrick J,0,0,15,17
1668346506755,MATH 287B,A00,098056,Arias-Castro; Ery,2,0,15,13
1668346507180,MATH 288,A00,098057,Agarwal; Pooja,9,0,10,1
1668346507180,MATH 288,B00,098058,Zhang; Danna,8,0,10,2
1668346507180,MATH 288,C00,098059,Williams; Ruth J,9,0,10,1
1668346507607,MATH 290B,A00,098060,Roberts; Justin Deritter,13,0,15,2
1668346508029,MATH 292,A00,098061,Belmont; Eva Kinoshita,10,0,10,0
1668346508454,MATH 295,A00,098062,Suk; Andrew Hoon,48,0,50,2
1668346508876,MATH 296,A00,098063,Novak; Jonathan I,20,0,20,0
1668346509297,MATH 297,001,098064,Gamst; Anthony Collins,9997,0,9999,2
1668347084653,COGS 205,A00,101395,Chiba; Andrea,19,0,20,1
1668347085079,COGS 210B,001,101404,Greene; Deanna Jacquelyn,9998,0,9999,1
1668347085079,COGS 210B,002,101417,Xia; Haijun,9999,0,9999,0
1668347085079,COGS 210B,003,101422,Nitz; Douglas A.,9999,0,9999,0
1668347085079,COGS 210B,004,101423,Hollan; James D.,9998,0,9999,1
1668347085079,COGS 210B,005,101424,Deak; Gedeon O.,9998,0,9999,1
1668347085079,COGS 210B,006,101425,Rossano; Federico,9999,0,9999,0
1668347085500,COGS 211B,A00,101427,Coulson; Seana M,9996,0,9999,3
1668347085927,COGS 220,A00,101428,Hollan; James D.,0,0,25,25
1668347086351,COGS 229,A00,101429,Dow; Steven P,18,0,25,7
1668347086773,COGS 230,A00,101430,Klemmer; Scott R,11,0,17,6
1668347087199,COGS 234,A00,101431,Xia; Haijun,1,0,25,24
1668347087625,COGS 260,A00,101432,Kiyonaga; Anastasia,21,0,25,4
1668347087625,COGS 260,B00,101433,Kirsh; David Joel,15,0,25,10
1668347088050,CSE 202,A00,102371,Impagliazzo; Russell,0,0,0,0
1668347088474,CSE 203B,A01,102373,Cheng; Chung Kuan,0,0,0,0
1668347088899,CSE 208,A00,102374,Micciancio; Daniele,0,0,0,0
1668347089326,CSE 209A,A00,112895,Impagliazzo; Russell,0,0,15,15
1668347089752,CSE 209B,A00,108005,Bellare; Mihir,0,0,0,0
1668347090174,CSE 210,A00,113163,Coblenz; Michael J,0,0,0,0
1668347090597,CSE 219,A00,106111,Dow; Steven P,0,0,20,20
1668347091020,CSE 221,A00,102376,Voelker; Geoffrey M.,0,0,0,0
1668347091443,CSE 224,A01,102378,Porter; George M,0,0,0,0
1668347091868,CSE 229A,A00,102379,Savage; Stefan,0,0,0,0
1668347092292,CSE 229C,A00,102380,Munyaka; Imani N. S.,0,0,0,0
1668347092721,CSE 232B,A00,102382,Deutsch; Alin Bernard,0,0,0,0
1668347093146,CSE 234,A01,112904,Kumar; Arun Kumar,0,0,0,0
1668347093569,CSE 237A,A00,102383,Rosing; Tajana Simunic,0,0,0,0
1668347093996,CSE 239A,A00,102384,Deutsch; Alin Bernard,0,0,0,0
1668347094419,CSE 239B,A00,102385,Polikarpova; Nadezhda,0,0,0,0
1668347094843,CSE 240A,A00,102386,Pannuto; Patrick William,0,0,0,0
1668347095269,CSE 240B,A00,102387,Zhao; Jishen,0,0,0,0
1668347095691,CSE 241A,A00,106406,Kang; Mingu,0,0,0,0
1668347096115,CSE 249B,A00,102388,Kahng; Andrew Byun,0,0,8,8
1668347096539,CSE 251B,A01,102392,Cottrell; Garrison W,0,0,0,0
1668347096539,CSE 251B,A02,102393,Cottrell; Garrison W,0,0,0,0
1668347096962,CSE 252B,A00,102394,Ochoa; Benjamin Lawrence,0,0,0,0
1668347097384,CSE 257,A01,102396,Gao; Sicun,0,0,0,0
1668347097808,CSE 272,A00,102397,Li; Tzumao,0,0,0,0
1668347098233,CSE 274,A00,111323,Chern; Albert Ren-Haur,0,0,0,0
1668347098657,CSE 282,A00,102398,Pevzner; Pavel Arkadjevich,0,0,0,0
1668347099083,CSE 284,A00,114175,Gymrek; Melissa Ann,0,0,0,0
1668347099514,CSE 290,A00,102399,Chandraker; Manmohan Krishna,0,0,0,0
1668347099514,CSE 290,B00,102400,Vaccaro; Kristen Marie,0,0,25,25
1668347099514,CSE 290,C00,102414,Pannuto; Patrick William,0,0,25,25
1668347099514,CSE 290,D00,102427,Pevzner; Pavel Arkadjevich,0,0,0,0
1668347099514,CSE 290,E00,102429,Zhao; Jishen,0,0,0,0
1668347099514,CSE 290,F00,102436,Tullsen; Dean Michael,0,0,0,0
1668347099514,CSE 290,G00,102440,Christensen; Henrik I,0,0,20,20
1668347099938,CSE 291,A00,102443,Su; Hao,0,0,0,0
1668347099938,CSE 291,B00,102448,Polikarpova; Nadezhda,0,0,0,0
1668347099938,CSE 291,C00,102453,Vaccaro; Kristen Marie,0,0,0,0
1668347099938,CSE 291,D00,111343,Savage; Stefan,0,0,0,0
1668347099938,CSE 291,E00,116474,Claffy; Kimberly Claire,0,0,0,0
1668347099938,CSE 291,F00,116479,Pasquale; Joseph,0,0,0,0
1668347100375,CSE 293,001,119111,Bafna; Vineet,9999,0,9999,0
1668347100375,CSE 293,002,119118,Bellare; Mihir,9999,0,9999,0
1668347100375,CSE 293,003,119122,Berg-Kirkpatrick; Taylor D,9999,0,9999,0
1668347100375,CSE 293,004,119135,Christensen; Henrik I,9999,0,9999,0
1668347100375,CSE 293,005,119142,Cottrell; Garrison W,9999,0,9999,0
1668347100375,CSE 293,006,119146,Deutsch; Alin Bernard,9999,0,9999,0
1668347100375,CSE 293,007,119159,Esmaeilzadeh; Hadi,9999,0,9999,0
1668347100375,CSE 293,008,119166,Freund; Yoav,9999,0,9999,0
1668347100375,CSE 293,009,119170,Griswold; William G.,9999,0,9999,0
1668347100375,CSE 293,010,119183,Gymrek; Melissa Ann,9999,0,9999,0
1668347100375,CSE 293,011,119190,Heninger; Nadia A,9999,0,9999,0
1668347100375,CSE 293,012,119230,Impagliazzo; Russell,9999,0,9999,0
1668347100375,CSE 293,013,119232,Jhala; Ranjit,9999,0,9999,0
1668347100375,CSE 293,014,119233,Kahng; Andrew Byun,9999,0,9999,0
1668347100375,CSE 293,015,119298,Kane; Daniel Mertz,9999,0,9999,0
1668347100375,CSE 293,016,119299,Kriegman; David J,9999,0,9999,0
1668347100375,CSE 293,017,119300,Kumar; Arun Kumar,9999,0,9999,0
1668347100375,CSE 293,018,119301,Lerner; Sorin,9999,0,9999,0
1668347100375,CSE 293,019,119302,Lovett; Shachar,9999,0,9999,0
1668347100375,CSE 293,020,119303,McAuley; Julian John,9999,0,9999,0
1668347100375,CSE 293,021,119304,Micciancio; Daniele,9999,0,9999,0
1668347100375,CSE 293,022,119367,Orailoglu; Alex,9999,0,9999,0
1668347100375,CSE 293,023,119382,Paturi; Ramamohan,9999,0,9999,0
1668347100375,CSE 293,024,119404,Polikarpova; Nadezhda,9999,0,9999,0
1668347100375,CSE 293,025,119406,Politz; Joseph Gibbs,9999,0,9999,0
1668347100375,CSE 293,026,119411,Porter; George M,9999,0,9999,0
1668347100375,CSE 293,027,119414,Porter; Leonard Emerson,9999,0,9999,0
1668347100375,CSE 293,028,119416,Ramamoorthi; Ravi,9999,0,9999,0
1668347100375,CSE 293,029,119417,Sahoo; Debashis,9999,0,9999,0
1668347100375,CSE 293,030,119420,Saul; Lawrence,9999,0,9999,0
1668347100375,CSE 293,031,119421,Savage; Stefan,9999,0,9999,0
1668347100375,CSE 293,032,119425,Schulze; Jurgen P.,9999,0,9999,0
1668347100375,CSE 293,033,119426,Snoeren; Alex C.,9999,0,9999,0
1668347100375,CSE 293,034,119428,Shang; Jingbo,9999,0,9999,0
1668347100375,CSE 293,035,119430,Stefan; Deian,9999,0,9999,0
1668347100375,CSE 293,036,119431,Su; Hao,9999,0,9999,0
1668347100375,CSE 293,037,119433,Swanson; Steven James,9999,0,9999,0
1668347100375,CSE 293,038,119435,Tullsen; Dean Michael,9999,0,9999,0
1668347100375,CSE 293,039,119483,Voelker; Geoffrey M.,9999,0,9999,0
1668347100375,CSE 293,040,119537,Zhao; Jishen,9999,0,9999,0
1668347100375,CSE 293,041,119538,Zhou; Yuan-Yuan,9999,0,9999,0
1668347100375,CSE 293,042,119539,Gao; Sicun,9999,0,9999,0
1668347100375,CSE 293,043,119540,Weibel; Nadir,9999,0,9999,0
1668347100375,CSE 293,044,119541,Gupta; Rajesh K.,9999,0,9999,0
1668347100375,CSE 293,045,126410,Vaccaro; Kristen Marie,9999,0,9999,0
1668347100375,CSE 293,046,126411,Klemke; Richard,9999,0,9999,0
1668347100797,CSE 294,A00,102459,Voelker; Geoffrey M.,0,0,0,0
1668347100797,CSE 294,B00,111322,Orailoglu; Alex,0,0,0,0
1668347101222,DSE 201,A00,096914,Deutsch; Alin Bernard,30,0,30,0
1668347101643,DSE 210,A00,096915,Dasgupta; Sanjoy,30,0,30,0
1668347102073,DSE 260A,A00,096916,Altintas De Callaf; Ilkay,30,0,30,0
1668347102530,ECE 200,001,103586,Antipa; Nicholas A,9999,0,9999,0
1668347102530,ECE 200,002,103587,Atanasov; Nikolay A.,9999,0,9999,0
1668347102530,ECE 200,003,103588,Bharadia; Dinesh,9999,0,9999,0
1668347102530,ECE 200,004,103589,Cheng; Chung Kuan,9999,0,9999,0
1668347102530,ECE 200,005,103590,Cosman; Pamela C.,9999,0,9999,0
1668347102530,ECE 200,006,103591,Dayeh; Shadi Ahmad,9999,0,9999,0
1668347102530,ECE 200,007,103592,Fainman; Yeshaiahu,9999,0,9999,0
1668347102530,ECE 200,008,103593,Ford; Joseph Earl,9999,0,9999,0
1668347102530,ECE 200,009,103594,Franceschetti; Massimo,9999,0,9999,0
1668347102530,ECE 200,010,103595,Fullerton; Eric E,9999,0,9999,0
1668347102530,ECE 200,011,103596,Galton; Ian A,9999,0,9999,0
1668347102530,ECE 200,012,103597,Gilja; Vikash,9999,0,9999,0
1668347102530,ECE 200,013,103598,Hall; Drew A.,9999,0,9999,0
1668347102530,ECE 200,014,103599,Hsueh; Tzu-Chien,9999,0,9999,0
1668347102530,ECE 200,015,103600,Javidi; Tara,9999,0,9999,0
1668347102530,ECE 200,016,103601,Kahng; Andrew Byun,9999,0,9999,0
1668347102530,ECE 200,017,103602,Kim; Young-Han,9999,0,9999,0
1668347102530,ECE 200,018,103603,Koushanfar; Farinaz,9999,0,9999,0
1668347102530,ECE 200,019,103604,Kuzum; Duygu,9999,0,9999,0
1668347102530,ECE 200,020,103605,Le; Hanh-Phuc,9999,0,9999,0
1668347102530,ECE 200,021,103606,Lin; Bill,9999,0,9999,0
1668347102530,ECE 200,022,103607,Liu; Zhaowei,9998,0,9999,1
1668347102530,ECE 200,023,103608,Lo; Yu-Hwa,9999,0,9999,0
1668347102530,ECE 200,024,103609,Lomakin; Vitaliy,9999,0,9999,0
1668347102530,ECE 200,025,103610,Mercier; Patrick Philip,9999,0,9999,0
1668347102530,ECE 200,026,103611,Meyer; Florian,9999,0,9999,0
1668347102530,ECE 200,027,103612,Milstein; Laurence B.,9999,0,9999,0
1668347102530,ECE 200,028,103613,Mir Arabbaygi; Siavash,9999,0,9999,0
1668347102530,ECE 200,029,103614,Mookherjea; Shayan,9999,0,9999,0
1668347102530,ECE 200,030,103615,Morris; Karcher William,9999,0,9999,0
1668347102530,ECE 200,031,103616,Ng; Tse Nga,9999,0,9999,0
1668347102530,ECE 200,032,103617,Nguyen; Truong Quang,9999,0,9999,0
1668347102530,ECE 200,033,103618,Nomura; Kenji,9999,0,9999,0
1668347102530,ECE 200,034,103619,Orlitsky; Alon,9999,0,9999,0
1668347102530,ECE 200,035,103620,Pal; Piya,9999,0,9999,0
1668347102530,ECE 200,036,103621,Papen; George C.,9999,0,9999,0
1668347102530,ECE 200,037,103622,Radic; Stojan,9999,0,9999,0
1668347102530,ECE 200,038,103623,Rao; Bhaskar D.,9999,0,9999,0
1668347102530,ECE 200,039,103624,Rao; Ramesh R,9999,0,9999,0
1668347102530,ECE 200,040,103625,Rebeiz; Gabriel,9999,0,9999,0
1668347102530,ECE 200,041,103626,Sanford; John R,9999,0,9999,0
1668347102530,ECE 200,042,103627,Siegel; Paul H.,9999,0,9999,0
1668347102530,ECE 200,043,103628,Sievenpiper; Daniel F.,9999,0,9999,0
1668347102530,ECE 200,044,103629,Sworder; David D.,9999,0,9999,0
1668347102530,ECE 200,045,103630,Taur; Yuan,9999,0,9999,0
1668347102530,ECE 200,046,103631,Touri; Behrouz,9999,0,9999,0
1668347102530,ECE 200,047,103632,Trivedi; Mohan M.,9999,0,9999,0
1668347102530,ECE 200,048,103633,Vasconcelos; Nuno,9999,0,9999,0
1668347102530,ECE 200,049,103634,Wang; Xiaolong,9999,0,9999,0
1668347102530,ECE 200,050,103635,Xie; Pengtao,9999,0,9999,0
1668347102530,ECE 200,051,103636,Yip; Michael,9999,0,9999,0
1668347102530,ECE 200,052,103637,Zeger; Kenneth A.,999,0,999,0
1668347102530,ECE 200,053,103638,Zhang; Xinyu,9999,0,9999,0
1668347102530,ECE 200,054,103639,Turakhia; Yatish Girish,9999,0,9999,0
1668347102530,ECE 200,055,103640,Kang; Mingu,9999,0,9999,0
1668347102530,ECE 200,056,103641,Shi; Yuanyuan,9999,0,9999,0
1668347102530,ECE 200,057,103642,Wang; Edward Jay,9999,0,9999,0
1668347102530,ECE 200,058,103643,Zheng; Yang,9999,0,9999,0
1668347102961,ECE 202,A00,103644,Kuzum; Duygu,0,0,0,0
1668347103383,ECE 212BN,A00,103646,Ng; Tse Nga,0,0,0,0
1668347103811,ECE 221,A00,111493,Staff,0,0,0,0
1668347104239,ECE 222B,A00,103647,Lomakin; Vitaliy,0,0,0,0
1668347104662,ECE 230B,A00,103648,Taur; Yuan,0,0,0,0
1668347105089,ECE 238B,A00,103649,Garay; Javier,0,0,0,0
1668347105511,ECE 240B,A00,112900,Fainman; Yeshaiahu,0,0,0,0
1668347105939,ECE 247A,A00,103650,Jokerst; Jesse Vincent,0,0,0,0
1668347106368,ECE 247B,A00,103651,Wang; Joseph,0,0,0,0
1668347106793,ECE 250,A00,103652,Siegel; Paul H.,0,0,0,0
1668347107219,ECE 251A,A00,103654,Rao; Bhaskar D.,0,0,0,0
1668347107715,ECE 257B,A00,103655,Bharadia; Dinesh,0,0,0,0
1668347108137,ECE 258A,A00,103656,Milstein; Laurence B.,0,0,0,0
1668347108563,ECE 260B,A00,103658,Kang; Mingu,0,0,0,0
1668347108988,ECE 264A,A00,103659,Galton; Ian A,0,0,0,0
1668347109413,ECE 265A,A00,103661,Gudem; Prasad S.S.,0,0,0,0
1668347109841,ECE 265D,A00,103662,Gudem; Prasad S.S.,0,0,0,0
1668347110269,ECE 268,A00,103663,Koushanfar; Farinaz,0,0,0,0
1668347110693,ECE 269,A01,103665,Pal; Piya,0,0,0,0
1668347111118,ECE 271B,A00,103666,Vasconcelos; Manuela,0,0,0,0
1668347111546,ECE 276A,A00,103667,Atanasov; Nikolay A.,0,0,0,0
1668347111970,ECE 277,A00,103668,An; Cheolhong,0,0,0,0
1668347112393,ECE 279,A00,117947,Hall; Drew A.,0,0,0,0
1668347113246,ECE 283,A00,103670,Hsueh; Tzu-Chien,0,0,0,0
1668347113671,ECE 284,A00,103671,Turakhia; Yatish Girish,0,0,0,0
1668347114099,ECE 285,A00,103672,Zheng; Yang,0,0,0,0
1668347114099,ECE 285,B00,103673,Sworder; David D.,0,0,0,0
1668347114525,ECE 287,A00,103676,Javidi; Tara,0,0,0,0
1668347114950,MATH 200B,A00,098023,Salehi Golsefidy; Alireza,12,0,15,3
1668347115377,MATH 202B,A00,098024,Rhoades; Brendon Patrick,9,0,15,6
1668347115802,MATH 203B,A00,098025,Oprea; Dragos N.,10,0,15,5
1668347116227,MATH 204B,A00,098026,Sorensen; Claus M,13,0,15,2
1668347116653,MATH 208,A00,098027,Izadi; Elham,7,0,10,3
1668347117080,MATH 209,A00,098028,Pollack; Aaron,10,0,10,0
1668347117507,MATH 211A,A00,112919,Rogalski; Daniel,9,0,10,1
1668347117930,MATH 211B,A00,112920,Seward; Brandon M.,9,0,10,1
1668347118354,MATH 218,A00,098029,Li; Bo,10,0,10,0
1668347118781,MATH 220B,A00,098030,Novak; Jonathan I,11,0,15,4
1668347119212,MATH 221A,A00,098031,Ebenfelt; Peter F,13,0,15,2
1668347119640,MATH 231B,A00,098032,Zlatos; Andrej,12,0,15,3
1668347120065,MATH 240B,A00,098033,Ni; Lei,9,0,15,6
1668347120490,MATH 243,A00,098034,Jekel; David Andrew,10,0,10,0
1668347120917,MATH 245A,A00,098035,Nie; Jiawang,0,0,15,16
1668347121341,MATH 248,A00,098036,Bejenaru; Ioan,10,0,10,0
1668347121765,MATH 250B,A00,098037,Spolaor; Luca,14,0,15,1
1668347122191,MATH 258,A00,098038,Ni; Lei,10,0,10,0
1668347122614,MATH 264B,A00,098041,Rhoades; Brendon Patrick,9,0,15,6
1668347123038,MATH 268,A00,098042,Buss; Samuel R,10,0,10,0
1668347123465,MATH 269,A00,098043,Rhoades; Brendon Patrick,10,0,10,0
1668347123893,MATH 270B,A00,098044,Li; Bo,10,0,15,5
1668347124315,MATH 272B,A00,098045,Holst; Michael J,13,0,15,2
1668347124740,MATH 273A,A00,098046,Tian; Xiaochuan,10,0,15,5
1668347125164,MATH 275,A01,098048,Tian; Xiaochuan,6,0,10,4
1668347125597,MATH 278A,A00,098049,Holst; Michael J,8,0,10,2
1668347126025,MATH 278B,A00,098050,Cloninger; Alexander,10,0,10,0
1668347126448,MATH 278C,A00,098051,Nie; Jiawang,7,0,10,3
1668347126887,MATH 280B,A00,098052,Zheng; Tianyi,8,0,15,7
1668347127317,MATH 281B,A00,098053,Bradic; Jelena,1,0,15,14
1668347127741,MATH 282B,A00,098054,Arias-Castro; Ery,0,0,15,15
1668347128169,MATH 285,A00,098055,Fitzsimmons; Patrick J,0,0,15,17
1668347128609,MATH 287B,A00,098056,Arias-Castro; Ery,2,0,15,13
1668347129033,MATH 288,A00,098057,Agarwal; Pooja,9,0,10,1
1668347129033,MATH 288,B00,098058,Zhang; Danna,8,0,10,2
1668347129033,MATH 288,C00,098059,Williams; Ruth J,9,0,10,1
1668347129457,MATH 290B,A00,098060,Roberts; Justin Deritter,13,0,15,2
1668347129880,MATH 292,A00,098061,Belmont; Eva Kinoshita,10,0,10,0
1668347130305,MATH 295,A00,098062,Suk; Andrew Hoon,48,0,50,2
1668347130735,MATH 296,A00,098063,Novak; Jonathan I,20,0,20,0
1668347131160,MATH 297,001,098064,Gamst; Anthony Collins,9997,0,9999,2
1668347650328,COGS 205,A00,101395,Chiba; Andrea,19,0,20,1
1668347650761,COGS 210B,001,101404,Greene; Deanna Jacquelyn,9998,0,9999,1
1668347650761,COGS 210B,002,101417,Xia; Haijun,9999,0,9999,0
1668347650761,COGS 210B,003,101422,Nitz; Douglas A.,9999,0,9999,0
1668347650761,COGS 210B,004,101423,Hollan; James D.,9998,0,9999,1
1668347650761,COGS 210B,005,101424,Deak; Gedeon O.,9998,0,9999,1
1668347650761,COGS 210B,006,101425,Rossano; Federico,9999,0,9999,0
1668347651186,COGS 211B,A00,101427,Coulson; Seana M,9996,0,9999,3
1668347651610,COGS 220,A00,101428,Hollan; James D.,0,0,25,25
1668347652046,COGS 229,A00,101429,Dow; Steven P,18,0,25,7
1668347652470,COGS 230,A00,101430,Klemmer; Scott R,11,0,17,6
1668347652898,COGS 234,A00,101431,Xia; Haijun,1,0,25,24
1668347653334,COGS 260,A00,101432,Kiyonaga; Anastasia,21,0,25,4
1668347653334,COGS 260,B00,101433,Kirsh; David Joel,15,0,25,10
1668347653765,CSE 202,A00,102371,Impagliazzo; Russell,0,0,0,0
1668347654192,CSE 203B,A01,102373,Cheng; Chung Kuan,0,0,0,0
1668347654621,CSE 208,A00,102374,Micciancio; Daniele,0,0,0,0
1668347655050,CSE 209A,A00,112895,Impagliazzo; Russell,0,0,15,15
1668347655474,CSE 209B,A00,108005,Bellare; Mihir,0,0,0,0
1668347655897,CSE 210,A00,113163,Coblenz; Michael J,0,0,0,0
1668347656324,CSE 219,A00,106111,Dow; Steven P,0,0,20,20
1668347656755,CSE 221,A00,102376,Voelker; Geoffrey M.,0,0,0,0
1668347657179,CSE 224,A01,102378,Porter; George M,0,0,0,0
1668347657611,CSE 229A,A00,102379,Savage; Stefan,0,0,0,0
1668347658050,CSE 229C,A00,102380,Munyaka; Imani N. S.,0,0,0,0
1668347658476,CSE 232B,A00,102382,Deutsch; Alin Bernard,0,0,0,0
1668347658905,CSE 234,A01,112904,Kumar; Arun Kumar,0,0,0,0
1668347659332,CSE 237A,A00,102383,Rosing; Tajana Simunic,0,0,0,0
1668347659756,CSE 239A,A00,102384,Deutsch; Alin Bernard,0,0,0,0
1668347660180,CSE 239B,A00,102385,Polikarpova; Nadezhda,0,0,0,0
1668347660607,CSE 240A,A00,102386,Pannuto; Patrick William,0,0,0,0
1668347661034,CSE 240B,A00,102387,Zhao; Jishen,0,0,0,0
1668347661458,CSE 241A,A00,106406,Kang; Mingu,0,0,0,0
1668347661883,CSE 249B,A00,102388,Kahng; Andrew Byun,0,0,8,8
1668347662322,CSE 251B,A01,102392,Cottrell; Garrison W,0,0,0,0
1668347662322,CSE 251B,A02,102393,Cottrell; Garrison W,0,0,0,0
1668347662746,CSE 252B,A00,102394,Ochoa; Benjamin Lawrence,0,0,0,0
1668347663170,CSE 257,A01,102396,Gao; Sicun,0,0,0,0
1668347663594,CSE 272,A00,102397,Li; Tzumao,0,0,0,0
1668347664020,CSE 274,A00,111323,Chern; Albert Ren-Haur,0,0,0,0
1668347664445,CSE 282,A00,102398,Pevzner; Pavel Arkadjevich,0,0,0,0
1668347664869,CSE 284,A00,114175,Gymrek; Melissa Ann,0,0,0,0
1668347665303,CSE 290,A00,102399,Chandraker; Manmohan Krishna,0,0,0,0
1668347665303,CSE 290,B00,102400,Vaccaro; Kristen Marie,0,0,25,25
1668347665303,CSE 290,C00,102414,Pannuto; Patrick William,0,0,25,25
1668347665303,CSE 290,D00,102427,Pevzner; Pavel Arkadjevich,0,0,0,0
1668347665303,CSE 290,E00,102429,Zhao; Jishen,0,0,0,0
1668347665303,CSE 290,F00,102436,Tullsen; Dean Michael,0,0,0,0
1668347665303,CSE 290,G00,102440,Christensen; Henrik I,0,0,20,20
1668347665728,CSE 291,A00,102443,Su; Hao,0,0,0,0
1668347665728,CSE 291,B00,102448,Polikarpova; Nadezhda,0,0,0,0
1668347665728,CSE 291,C00,102453,Vaccaro; Kristen Marie,0,0,0,0
1668347665728,CSE 291,D00,111343,Savage; Stefan,0,0,0,0
1668347665728,CSE 291,E00,116474,Claffy; Kimberly Claire,0,0,0,0
1668347665728,CSE 291,F00,116479,Pasquale; Joseph,0,0,0,0
1668347666167,CSE 293,001,119111,Bafna; Vineet,9999,0,9999,0
1668347666167,CSE 293,002,119118,Bellare; Mihir,9999,0,9999,0
1668347666167,CSE 293,003,119122,Berg-Kirkpatrick; Taylor D,9999,0,9999,0
1668347666167,CSE 293,004,119135,Christensen; Henrik I,9999,0,9999,0
1668347666167,CSE 293,005,119142,Cottrell; Garrison W,9999,0,9999,0
1668347666167,CSE 293,006,119146,Deutsch; Alin Bernard,9999,0,9999,0
1668347666167,CSE 293,007,119159,Esmaeilzadeh; Hadi,9999,0,9999,0
1668347666167,CSE 293,008,119166,Freund; Yoav,9999,0,9999,0
1668347666167,CSE 293,009,119170,Griswold; William G.,9999,0,9999,0
1668347666167,CSE 293,010,119183,Gymrek; Melissa Ann,9999,0,9999,0
1668347666167,CSE 293,011,119190,Heninger; Nadia A,9999,0,9999,0
1668347666167,CSE 293,012,119230,Impagliazzo; Russell,9999,0,9999,0
1668347666167,CSE 293,013,119232,Jhala; Ranjit,9999,0,9999,0
1668347666167,CSE 293,014,119233,Kahng; Andrew Byun,9999,0,9999,0
1668347666167,CSE 293,015,119298,Kane; Daniel Mertz,9999,0,9999,0
1668347666167,CSE 293,016,119299,Kriegman; David J,9999,0,9999,0
1668347666167,CSE 293,017,119300,Kumar; Arun Kumar,9999,0,9999,0
1668347666167,CSE 293,018,119301,Lerner; Sorin,9999,0,9999,0
1668347666167,CSE 293,019,119302,Lovett; Shachar,9999,0,9999,0
1668347666167,CSE 293,020,119303,McAuley; Julian John,9999,0,9999,0
1668347666167,CSE 293,021,119304,Micciancio; Daniele,9999,0,9999,0
1668347666167,CSE 293,022,119367,Orailoglu; Alex,9999,0,9999,0
1668347666167,CSE 293,023,119382,Paturi; Ramamohan,9999,0,9999,0
1668347666167,CSE 293,024,119404,Polikarpova; Nadezhda,9999,0,9999,0
1668347666167,CSE 293,025,119406,Politz; Joseph Gibbs,9999,0,9999,0
1668347666167,CSE 293,026,119411,Porter; George M,9999,0,9999,0
1668347666167,CSE 293,027,119414,Porter; Leonard Emerson,9999,0,9999,0
1668347666167,CSE 293,028,119416,Ramamoorthi; Ravi,9999,0,9999,0
1668347666167,CSE 293,029,119417,Sahoo; Debashis,9999,0,9999,0
1668347666167,CSE 293,030,119420,Saul; Lawrence,9999,0,9999,0
1668347666167,CSE 293,031,119421,Savage; Stefan,9999,0,9999,0
1668347666167,CSE 293,032,119425,Schulze; Jurgen P.,9999,0,9999,0
1668347666167,CSE 293,033,119426,Snoeren; Alex C.,9999,0,9999,0
1668347666167,CSE 293,034,119428,Shang; Jingbo,9999,0,9999,0
1668347666167,CSE 293,035,119430,Stefan; Deian,9999,0,9999,0
1668347666167,CSE 293,036,119431,Su; Hao,9999,0,9999,0
1668347666167,CSE 293,037,119433,Swanson; Steven James,9999,0,9999,0
1668347666167,CSE 293,038,119435,Tullsen; Dean Michael,9999,0,9999,0
1668347666167,CSE 293,039,119483,Voelker; Geoffrey M.,9999,0,9999,0
1668347666167,CSE 293,040,119537,Zhao; Jishen,9999,0,9999,0
1668347666167,CSE 293,041,119538,Zhou; Yuan-Yuan,9999,0,9999,0
1668347666167,CSE 293,042,119539,Gao; Sicun,9999,0,9999,0
1668347666167,CSE 293,043,119540,Weibel; Nadir,9999,0,9999,0
1668347666167,CSE 293,044,119541,Gupta; Rajesh K.,9999,0,9999,0
1668347666167,CSE 293,045,126410,Vaccaro; Kristen Marie,9999,0,9999,0
1668347666167,CSE 293,046,126411,Klemke; Richard,9999,0,9999,0
1668347666591,CSE 294,A00,102459,Voelker; Geoffrey M.,0,0,0,0
1668347666591,CSE 294,B00,111322,Orailoglu; Alex,0,0,0,0
1668347667019,DSE 201,A00,096914,Deutsch; Alin Bernard,30,0,30,0
1668347667445,DSE 210,A00,096915,Dasgupta; Sanjoy,30,0,30,0
1668347667870,DSE 260A,A00,096916,Altintas De Callaf; Ilkay,30,0,30,0
1668347668336,ECE 200,001,103586,Antipa; Nicholas A,9999,0,9999,0
1668347668336,ECE 200,002,103587,Atanasov; Nikolay A.,9999,0,9999,0
1668347668336,ECE 200,003,103588,Bharadia; Dinesh,9999,0,9999,0
1668347668336,ECE 200,004,103589,Cheng; Chung Kuan,9999,0,9999,0
1668347668336,ECE 200,005,103590,Cosman; Pamela C.,9999,0,9999,0
1668347668336,ECE 200,006,103591,Dayeh; Shadi Ahmad,9999,0,9999,0
1668347668336,ECE 200,007,103592,Fainman; Yeshaiahu,9999,0,9999,0
1668347668336,ECE 200,008,103593,Ford; Joseph Earl,9999,0,9999,0
1668347668336,ECE 200,009,103594,Franceschetti; Massimo,9999,0,9999,0
1668347668336,ECE 200,010,103595,Fullerton; Eric E,9999,0,9999,0
1668347668336,ECE 200,011,103596,Galton; Ian A,9999,0,9999,0
1668347668336,ECE 200,012,103597,Gilja; Vikash,9999,0,9999,0
1668347668336,ECE 200,013,103598,Hall; Drew A.,9999,0,9999,0
1668347668336,ECE 200,014,103599,Hsueh; Tzu-Chien,9999,0,9999,0
1668347668336,ECE 200,015,103600,Javidi; Tara,9999,0,9999,0
1668347668336,ECE 200,016,103601,Kahng; Andrew Byun,9999,0,9999,0
1668347668336,ECE 200,017,103602,Kim; Young-Han,9999,0,9999,0
1668347668336,ECE 200,018,103603,Koushanfar; Farinaz,9999,0,9999,0
1668347668336,ECE 200,019,103604,Kuzum; Duygu,9999,0,9999,0
1668347668336,ECE 200,020,103605,Le; Hanh-Phuc,9999,0,9999,0
1668347668336,ECE 200,021,103606,Lin; Bill,9999,0,9999,0
1668347668336,ECE 200,022,103607,Liu; Zhaowei,9998,0,9999,1
1668347668336,ECE 200,023,103608,Lo; Yu-Hwa,9999,0,9999,0
1668347668336,ECE 200,024,103609,Lomakin; Vitaliy,9999,0,9999,0
1668347668336,ECE 200,025,103610,Mercier; Patrick Philip,9999,0,9999,0
1668347668336,ECE 200,026,103611,Meyer; Florian,9999,0,9999,0
1668347668336,ECE 200,027,103612,Milstein; Laurence B.,9999,0,9999,0
1668347668336,ECE 200,028,103613,Mir Arabbaygi; Siavash,9999,0,9999,0
1668347668336,ECE 200,029,103614,Mookherjea; Shayan,9999,0,9999,0
1668347668336,ECE 200,030,103615,Morris; Karcher William,9999,0,9999,0
1668347668336,ECE 200,031,103616,Ng; Tse Nga,9999,0,9999,0
1668347668336,ECE 200,032,103617,Nguyen; Truong Quang,9999,0,9999,0
1668347668336,ECE 200,033,103618,Nomura; Kenji,9999,0,9999,0
1668347668336,ECE 200,034,103619,Orlitsky; Alon,9999,0,9999,0
1668347668336,ECE 200,035,103620,Pal; Piya,9999,0,9999,0
1668347668336,ECE 200,036,103621,Papen; George C.,9999,0,9999,0
1668347668336,ECE 200,037,103622,Radic; Stojan,9999,0,9999,0
1668347668336,ECE 200,038,103623,Rao; Bhaskar D.,9999,0,9999,0
1668347668336,ECE 200,039,103624,Rao; Ramesh R,9999,0,9999,0
1668347668336,ECE 200,040,103625,Rebeiz; Gabriel,9999,0,9999,0
1668347668336,ECE 200,041,103626,Sanford; John R,9999,0,9999,0
1668347668336,ECE 200,042,103627,Siegel; Paul H.,9999,0,9999,0
1668347668336,ECE 200,043,103628,Sievenpiper; Daniel F.,9999,0,9999,0
1668347668336,ECE 200,044,103629,Sworder; David D.,9999,0,9999,0
1668347668336,ECE 200,045,103630,Taur; Yuan,9999,0,9999,0
1668347668336,ECE 200,046,103631,Touri; Behrouz,9999,0,9999,0
1668347668336,ECE 200,047,103632,Trivedi; Mohan M.,9999,0,9999,0
1668347668336,ECE 200,048,103633,Vasconcelos; Nuno,9999,0,9999,0
1668347668336,ECE 200,049,103634,Wang; Xiaolong,9999,0,9999,0
1668347668336,ECE 200,050,103635,Xie; Pengtao,9999,0,9999,0
1668347668336,ECE 200,051,103636,Yip; Michael,9999,0,9999,0
1668347668336,ECE 200,052,103637,Zeger; Kenneth A.,999,0,999,0
1668347668336,ECE 200,053,103638,Zhang; Xinyu,9999,0,9999,0
1668347668336,ECE 200,054,103639,Turakhia; Yatish Girish,9999,0,9999,0
1668347668336,ECE 200,055,103640,Kang; Mingu,9999,0,9999,0
1668347668336,ECE 200,056,103641,Shi; Yuanyuan,9999,0,9999,0
1668347668336,ECE 200,057,103642,Wang; Edward Jay,9999,0,9999,0
1668347668336,ECE 200,058,103643,Zheng; Yang,9999,0,9999,0
1668347668761,ECE 202,A00,103644,Kuzum; Duygu,0,0,0,0
1668347669184,ECE 212BN,A00,103646,Ng; Tse Nga,0,0,0,0
1668347669606,ECE 221,A00,111493,Staff,0,0,0,0
1668347670033,ECE 222B,A00,103647,Lomakin; Vitaliy,0,0,0,0
1668347670459,ECE 230B,A00,103648,Taur; Yuan,0,0,0,0
1668347670885,ECE 238B,A00,103649,Garay; Javier,0,0,0,0
1668347671312,ECE 240B,A00,112900,Fainman; Yeshaiahu,0,0,0,0
1668347671739,ECE 247A,A00,103650,Jokerst; Jesse Vincent,0,0,0,0
1668347672164,ECE 247B,A00,103651,Wang; Joseph,0,0,0,0
1668347672597,ECE 250,A00,103652,Siegel; Paul H.,0,0,0,0
1668347673021,ECE 251A,A00,103654,Rao; Bhaskar D.,0,0,0,0
1668347673448,ECE 257B,A00,103655,Bharadia; Dinesh,0,0,0,0
1668347673873,ECE 258A,A00,103656,Milstein; Laurence B.,0,0,0,0
1668347674300,ECE 260B,A00,103658,Kang; Mingu,0,0,0,0
1668347674728,ECE 264A,A00,103659,Galton; Ian A,0,0,0,0
1668347675153,ECE 265A,A00,103661,Gudem; Prasad S.S.,0,0,0,0
1668347675592,ECE 265D,A00,103662,Gudem; Prasad S.S.,0,0,0,0
1668347676015,ECE 268,A00,103663,Koushanfar; Farinaz,0,0,0,0
1668347676439,ECE 269,A01,103665,Pal; Piya,0,0,0,0
1668347676864,ECE 271B,A00,103666,Vasconcelos; Manuela,0,0,0,0
1668347677292,ECE 276A,A00,103667,Atanasov; Nikolay A.,0,0,0,0
1668347677722,ECE 277,A00,103668,An; Cheolhong,0,0,0,0
1668347678145,ECE 279,A00,117947,Hall; Drew A.,0,0,0,0
1668347678995,ECE 283,A00,103670,Hsueh; Tzu-Chien,0,0,0,0
1668347679419,ECE 284,A00,103671,Turakhia; Yatish Girish,0,0,0,0
1668347679851,ECE 285,A00,103672,Zheng; Yang,0,0,0,0
1668347679851,ECE 285,B00,103673,Sworder; David D.,0,0,0,0
1668347680277,ECE 287,A00,103676,Javidi; Tara,0,0,0,0
1668347680705,MATH 200B,A00,098023,Salehi Golsefidy; Alireza,12,0,15,3
1668347681130,MATH 202B,A00,098024,Rhoades; Brendon Patrick,9,0,15,6
1668347681554,MATH 203B,A00,098025,Oprea; Dragos N.,10,0,15,5
1668347681981,MATH 204B,A00,098026,Sorensen; Claus M,13,0,15,2
1668347682404,MATH 208,A00,098027,Izadi; Elham,7,0,10,3
1668347682831,MATH 209,A00,098028,Pollack; Aaron,10,0,10,0
1668347683257,MATH 211A,A00,112919,Rogalski; Daniel,9,0,10,1
1668347683682,MATH 211B,A00,112920,Seward; Brandon M.,9,0,10,1
1668347684115,MATH 218,A00,098029,Li; Bo,10,0,10,0
1668347684542,MATH 220B,A00,098030,Novak; Jonathan I,11,0,15,4
1668347684966,MATH 221A,A00,098031,Ebenfelt; Peter F,13,0,15,2
1668347685392,MATH 231B,A00,098032,Zlatos; Andrej,12,0,15,3
1668347685819,MATH 240B,A00,098033,Ni; Lei,9,0,15,6
1668347686246,MATH 243,A00,098034,Jekel; David Andrew,10,0,10,0
1668347686674,MATH 245A,A00,098035,Nie; Jiawang,0,0,15,16
1668347687098,MATH 248,A00,098036,Bejenaru; Ioan,10,0,10,0
1668347687526,MATH 250B,A00,098037,Spolaor; Luca,14,0,15,1
1668347687953,MATH 258,A00,098038,Ni; Lei,10,0,10,0
1668347688378,MATH 264B,A00,098041,Rhoades; Brendon Patrick,9,0,15,6
1668347688803,MATH 268,A00,098042,Buss; Samuel R,10,0,10,0
1668347689229,MATH 269,A00,098043,Rhoades; Brendon Patrick,10,0,10,0
1668347689655,MATH 270B,A00,098044,Li; Bo,10,0,15,5
1668347690178,MATH 272B,A00,098045,Holst; Michael J,13,0,15,2
1668347690604,MATH 273A,A00,098046,Tian; Xiaochuan,10,0,15,5
1668347691031,MATH 275,A01,098048,Tian; Xiaochuan,6,0,10,4
1668347691466,MATH 278A,A00,098049,Holst; Michael J,8,0,10,2
1668347691895,MATH 278B,A00,098050,Cloninger; Alexander,10,0,10,0
1668347692323,MATH 278C,A00,098051,Nie; Jiawang,7,0,10,3
1668347692762,MATH 280B,A00,098052,Zheng; Tianyi,8,0,15,7
1668347693191,MATH 281B,A00,098053,Bradic; Jelena,1,0,15,14
1668347693624,MATH 282B,A00,098054,Arias-Castro; Ery,0,0,15,15
1668347694063,MATH 285,A00,098055,Fitzsimmons; Patrick J,0,0,15,17
1668347694493,MATH 287B,A00,098056,Arias-Castro; Ery,2,0,15,13
1668347694925,MATH 288,A00,098057,Agarwal; Pooja,9,0,10,1
1668347694925,MATH 288,B00,098058,Zhang; Danna,8,0,10,2
1668347694925,MATH 288,C00,098059,Williams; Ruth J,9,0,10,1
1668347695355,MATH 290B,A00,098060,Roberts; Justin Deritter,13,0,15,2
1668347695780,MATH 292,A00,098061,Belmont; Eva Kinoshita,10,0,10,0
1668347696206,MATH 295,A00,098062,Suk; Andrew Hoon,48,0,50,2
1668347696633,MATH 296,A00,098063,Novak; Jonathan I,20,0,20,0
1668347697059,MATH 297,001,098064,Gamst; Anthony Collins,9997,0,9999,2
1668348199766,COGS 205,A00,101395,Chiba; Andrea,19,0,20,1
1668348200195,COGS 210B,001,101404,Greene; Deanna Jacquelyn,9998,0,9999,1
1668348200195,COGS 210B,002,101417,Xia; Haijun,9999,0,9999,0
1668348200195,COGS 210B,003,101422,Nitz; Douglas A.,9999,0,9999,0
1668348200195,COGS 210B,004,101423,Hollan; James D.,9998,0,9999,1
1668348200195,COGS 210B,005,101424,Deak; Gedeon O.,9998,0,9999,1
1668348200195,COGS 210B,006,101425,Rossano; Federico,9999,0,9999,0
1668348200621,COGS 211B,A00,101427,Coulson; Seana M,9996,0,9999,3
1668348201045,COGS 220,A00,101428,Hollan; James D.,0,0,25,25
1668348201470,COGS 229,A00,101429,Dow; Steven P,18,0,25,7
1668348201898,COGS 230,A00,101430,Klemmer; Scott R,11,0,17,6
1668348202328,COGS 234,A00,101431,Xia; Haijun,1,0,25,24
1668348202758,COGS 260,A00,101432,Kiyonaga; Anastasia,21,0,25,4
1668348202758,COGS 260,B00,101433,Kirsh; David Joel,15,0,25,10
1668348203186,CSE 202,A00,102371,Impagliazzo; Russell,0,0,0,0
1668348203612,CSE 203B,A01,102373,Cheng; Chung Kuan,0,0,0,0
1668348204043,CSE 208,A00,102374,Micciancio; Daniele,0,0,0,0
1668348204465,CSE 209A,A00,112895,Impagliazzo; Russell,0,0,15,15
1668348204897,CSE 209B,A00,108005,Bellare; Mihir,0,0,0,0
1668348205322,CSE 210,A00,113163,Coblenz; Michael J,0,0,0,0
1668348205757,CSE 219,A00,106111,Dow; Steven P,0,0,20,20
1668348206181,CSE 221,A00,102376,Voelker; Geoffrey M.,0,0,0,0
1668348206609,CSE 224,A01,102378,Porter; George M,0,0,0,0
1668348207034,CSE 229A,A00,102379,Savage; Stefan,0,0,0,0
1668348207476,CSE 229C,A00,102380,Munyaka; Imani N. S.,0,0,0,0
1668348207902,CSE 232B,A00,102382,Deutsch; Alin Bernard,0,0,0,0
1668348208331,CSE 234,A01,112904,Kumar; Arun Kumar,0,0,0,0
1668348208766,CSE 237A,A00,102383,Rosing; Tajana Simunic,0,0,0,0
1668348209191,CSE 239A,A00,102384,Deutsch; Alin Bernard,0,0,0,0
1668348209640,CSE 239B,A00,102385,Polikarpova; Nadezhda,0,0,0,0
1668348210075,CSE 240A,A00,102386,Pannuto; Patrick William,0,0,0,0
1668348210519,CSE 240B,A00,102387,Zhao; Jishen,0,0,0,0
1668348210944,CSE 241A,A00,106406,Kang; Mingu,0,0,0,0
1668348211374,CSE 249B,A00,102388,Kahng; Andrew Byun,0,0,8,8
1668348211809,CSE 251B,A01,102392,Cottrell; Garrison W,0,0,0,0
1668348211809,CSE 251B,A02,102393,Cottrell; Garrison W,0,0,0,0
1668348212232,CSE 252B,A00,102394,Ochoa; Benjamin Lawrence,0,0,0,0
1668348212657,CSE 257,A01,102396,Gao; Sicun,0,0,0,0
1668348213173,CSE 272,A00,102397,Li; Tzumao,0,0,0,0
1668348213601,CSE 274,A00,111323,Chern; Albert Ren-Haur,0,0,0,0
1668348214026,CSE 282,A00,102398,Pevzner; Pavel Arkadjevich,0,0,0,0
1668348214452,CSE 284,A00,114175,Gymrek; Melissa Ann,0,0,0,0
1668348214883,CSE 290,A00,102399,Chandraker; Manmohan Krishna,0,0,0,0
1668348214883,CSE 290,B00,102400,Vaccaro; Kristen Marie,0,0,25,25
1668348214883,CSE 290,C00,102414,Pannuto; Patrick William,0,0,25,25
1668348214883,CSE 290,D00,102427,Pevzner; Pavel Arkadjevich,0,0,0,0
1668348214883,CSE 290,E00,102429,Zhao; Jishen,0,0,0,0
1668348214883,CSE 290,F00,102436,Tullsen; Dean Michael,0,0,0,0
1668348214883,CSE 290,G00,102440,Christensen; Henrik I,0,0,20,20
1668348215320,CSE 291,A00,102443,Su; Hao,0,0,0,0
1668348215320,CSE 291,B00,102448,Polikarpova; Nadezhda,0,0,0,0
1668348215320,CSE 291,C00,102453,Vaccaro; Kristen Marie,0,0,0,0
1668348215320,CSE 291,D00,111343,Savage; Stefan,0,0,0,0
1668348215320,CSE 291,E00,116474,Claffy; Kimberly Claire,0,0,0,0
1668348215320,CSE 291,F00,116479,Pasquale; Joseph,0,0,0,0
1668348215780,CSE 293,001,119111,Bafna; Vineet,9999,0,9999,0
1668348215780,CSE 293,002,119118,Bellare; Mihir,9999,0,9999,0
1668348215780,CSE 293,003,119122,Berg-Kirkpatrick; Taylor D,9999,0,9999,0
1668348215780,CSE 293,004,119135,Christensen; Henrik I,9999,0,9999,0
1668348215780,CSE 293,005,119142,Cottrell; Garrison W,9999,0,9999,0
1668348215780,CSE 293,006,119146,Deutsch; Alin Bernard,9999,0,9999,0
1668348215780,CSE 293,007,119159,Esmaeilzadeh; Hadi,9999,0,9999,0
1668348215780,CSE 293,008,119166,Freund; Yoav,9999,0,9999,0
1668348215780,CSE 293,009,119170,Griswold; William G.,9999,0,9999,0
1668348215780,CSE 293,010,119183,Gymrek; Melissa Ann,9999,0,9999,0
1668348215780,CSE 293,011,119190,Heninger; Nadia A,9999,0,9999,0
1668348215780,CSE 293,012,119230,Impagliazzo; Russell,9999,0,9999,0
1668348215780,CSE 293,013,119232,Jhala; Ranjit,9999,0,9999,0
1668348215780,CSE 293,014,119233,Kahng; Andrew Byun,9999,0,9999,0
1668348215780,CSE 293,015,119298,Kane; Daniel Mertz,9999,0,9999,0
1668348215780,CSE 293,016,119299,Kriegman; David J,9999,0,9999,0
1668348215780,CSE 293,017,119300,Kumar; Arun Kumar,9999,0,9999,0
1668348215780,CSE 293,018,119301,Lerner; Sorin,9999,0,9999,0
1668348215780,CSE 293,019,119302,Lovett; Shachar,9999,0,9999,0
1668348215780,CSE 293,020,119303,McAuley; Julian John,9999,0,9999,0
1668348215780,CSE 293,021,119304,Micciancio; Daniele,9999,0,9999,0
1668348215780,CSE 293,022,119367,Orailoglu; Alex,9999,0,9999,0
1668348215780,CSE 293,023,119382,Paturi; Ramamohan,9999,0,9999,0
1668348215780,CSE 293,024,119404,Polikarpova; Nadezhda,9999,0,9999,0
1668348215780,CSE 293,025,119406,Politz; Joseph Gibbs,9999,0,9999,0
1668348215780,CSE 293,026,119411,Porter; George M,9999,0,9999,0
1668348215780,CSE 293,027,119414,Porter; Leonard Emerson,9999,0,9999,0
1668348215780,CSE 293,028,119416,Ramamoorthi; Ravi,9999,0,9999,0
1668348215780,CSE 293,029,119417,Sahoo; Debashis,9999,0,9999,0
1668348215780,CSE 293,030,119420,Saul; Lawrence,9999,0,9999,0
1668348215780,CSE 293,031,119421,Savage; Stefan,9999,0,9999,0
1668348215780,CSE 293,032,119425,Schulze; Jurgen P.,9999,0,9999,0
1668348215780,CSE 293,033,119426,Snoeren; Alex C.,9999,0,9999,0
1668348215780,CSE 293,034,119428,Shang; Jingbo,9999,0,9999,0
1668348215780,CSE 293,035,119430,Stefan; Deian,9999,0,9999,0
1668348215780,CSE 293,036,119431,Su; Hao,9999,0,9999,0
1668348215780,CSE 293,037,119433,Swanson; Steven James,9999,0,9999,0
1668348215780,CSE 293,038,119435,Tullsen; Dean Michael,9999,0,9999,0
1668348215780,CSE 293,039,119483,Voelker; Geoffrey M.,9999,0,9999,0
1668348215780,CSE 293,040,119537,Zhao; Jishen,9999,0,9999,0
1668348215780,CSE 293,041,119538,Zhou; Yuan-Yuan,9999,0,9999,0
1668348215780,CSE 293,042,119539,Gao; Sicun,9999,0,9999,0
1668348215780,CSE 293,043,119540,Weibel; Nadir,9999,0,9999,0
1668348215780,CSE 293,044,119541,Gupta; Rajesh K.,9999,0,9999,0
1668348215780,CSE 293,045,126410,Vaccaro; Kristen Marie,9999,0,9999,0
1668348215780,CSE 293,046,126411,Klemke; Richard,9999,0,9999,0
1668348216209,CSE 294,A00,102459,Voelker; Geoffrey M.,0,0,0,0
1668348216209,CSE 294,B00,111322,Orailoglu; Alex,0,0,0,0
1668348216634,DSE 201,A00,096914,Deutsch; Alin Bernard,30,0,30,0
1668348217058,DSE 210,A00,096915,Dasgupta; Sanjoy,30,0,30,0
1668348217486,DSE 260A,A00,096916,Altintas De Callaf; Ilkay,30,0,30,0
1668348217945,ECE 200,001,103586,Antipa; Nicholas A,9999,0,9999,0
1668348217945,ECE 200,002,103587,Atanasov; Nikolay A.,9999,0,9999,0
1668348217945,ECE 200,003,103588,Bharadia; Dinesh,9999,0,9999,0
1668348217945,ECE 200,004,103589,Cheng; Chung Kuan,9999,0,9999,0
1668348217945,ECE 200,005,103590,Cosman; Pamela C.,9999,0,9999,0
1668348217945,ECE 200,006,103591,Dayeh; Shadi Ahmad,9999,0,9999,0
1668348217945,ECE 200,007,103592,Fainman; Yeshaiahu,9999,0,9999,0
1668348217945,ECE 200,008,103593,Ford; Joseph Earl,9999,0,9999,0
1668348217945,ECE 200,009,103594,Franceschetti; Massimo,9999,0,9999,0
1668348217945,ECE 200,010,103595,Fullerton; Eric E,9999,0,9999,0
1668348217945,ECE 200,011,103596,Galton; Ian A,9999,0,9999,0
1668348217945,ECE 200,012,103597,Gilja; Vikash,9999,0,9999,0
1668348217945,ECE 200,013,103598,Hall; Drew A.,9999,0,9999,0
1668348217945,ECE 200,014,103599,Hsueh; Tzu-Chien,9999,0,9999,0
1668348217945,ECE 200,015,103600,Javidi; Tara,9999,0,9999,0
1668348217945,ECE 200,016,103601,Kahng; Andrew Byun,9999,0,9999,0
1668348217945,ECE 200,017,103602,Kim; Young-Han,9999,0,9999,0
1668348217945,ECE 200,018,103603,Koushanfar; Farinaz,9999,0,9999,0
1668348217945,ECE 200,019,103604,Kuzum; Duygu,9999,0,9999,0
1668348217945,ECE 200,020,103605,Le; Hanh-Phuc,9999,0,9999,0
1668348217945,ECE 200,021,103606,Lin; Bill,9999,0,9999,0
1668348217945,ECE 200,022,103607,Liu; Zhaowei,9998,0,9999,1
1668348217945,ECE 200,023,103608,Lo; Yu-Hwa,9999,0,9999,0
1668348217945,ECE 200,024,103609,Lomakin; Vitaliy,9999,0,9999,0
1668348217945,ECE 200,025,103610,Mercier; Patrick Philip,9999,0,9999,0
1668348217945,ECE 200,026,103611,Meyer; Florian,9999,0,9999,0
1668348217945,ECE 200,027,103612,Milstein; Laurence B.,9999,0,9999,0
1668348217945,ECE 200,028,103613,Mir Arabbaygi; Siavash,9999,0,9999,0
1668348217945,ECE 200,029,103614,Mookherjea; Shayan,9999,0,9999,0
1668348217945,ECE 200,030,103615,Morris; Karcher William,9999,0,9999,0
1668348217945,ECE 200,031,103616,Ng; Tse Nga,9999,0,9999,0
1668348217945,ECE 200,032,103617,Nguyen; Truong Quang,9999,0,9999,0
1668348217945,ECE 200,033,103618,Nomura; Kenji,9999,0,9999,0
1668348217945,ECE 200,034,103619,Orlitsky; Alon,9999,0,9999,0
1668348217945,ECE 200,035,103620,Pal; Piya,9999,0,9999,0
1668348217945,ECE 200,036,103621,Papen; George C.,9999,0,9999,0
1668348217945,ECE 200,037,103622,Radic; Stojan,9999,0,9999,0
1668348217945,ECE 200,038,103623,Rao; Bhaskar D.,9999,0,9999,0
1668348217945,ECE 200,039,103624,Rao; Ramesh R,9999,0,9999,0
1668348217945,ECE 200,040,103625,Rebeiz; Gabriel,9999,0,9999,0
1668348217945,ECE 200,041,103626,Sanford; John R,9999,0,9999,0
1668348217945,ECE 200,042,103627,Siegel; Paul H.,9999,0,9999,0
1668348217945,ECE 200,043,103628,Sievenpiper; Daniel F.,9999,0,9999,0
1668348217945,ECE 200,044,103629,Sworder; David D.,9999,0,9999,0
1668348217945,ECE 200,045,103630,Taur; Yuan,9999,0,9999,0
1668348217945,ECE 200,046,103631,Touri; Behrouz,9999,0,9999,0
1668348217945,ECE 200,047,103632,Trivedi; Mohan M.,9999,0,9999,0
1668348217945,ECE 200,048,103633,Vasconcelos; Nuno,9999,0,9999,0
1668348217945,ECE 200,049,103634,Wang; Xiaolong,9999,0,9999,0
1668348217945,ECE 200,050,103635,Xie; Pengtao,9999,0,9999,0
1668348217945,ECE 200,051,103636,Yip; Michael,9999,0,9999,0
1668348217945,ECE 200,052,103637,Zeger; Kenneth A.,999,0,999,0
1668348217945,ECE 200,053,103638,Zhang; Xinyu,9999,0,9999,0
1668348217945,ECE 200,054,103639,Turakhia; Yatish Girish,9999,0,9999,0
1668348217945,ECE 200,055,103640,Kang; Mingu,9999,0,9999,0
1668348217945,ECE 200,056,103641,Shi; Yuanyuan,9999,0,9999,0
1668348217945,ECE 200,057,103642,Wang; Edward Jay,9999,0,9999,0
1668348217945,ECE 200,058,103643,Zheng; Yang,9999,0,9999,0
1668348218385,ECE 202,A00,103644,Kuzum; Duygu,0,0,0,0
1668348218808,ECE 212BN,A00,103646,Ng; Tse Nga,0,0,0,0
1668348219233,ECE 221,A00,111493,Staff,0,0,0,0
1668348219659,ECE 222B,A00,103647,Lomakin; Vitaliy,0,0,0,0
1668348220085,ECE 230B,A00,103648,Taur; Yuan,0,0,0,0
1668348220512,ECE 238B,A00,103649,Garay; Javier,0,0,0,0
1668348220936,ECE 240B,A00,112900,Fainman; Yeshaiahu,0,0,0,0
1668348221363,ECE 247A,A00,103650,Jokerst; Jesse Vincent,0,0,0,0
1668348221803,ECE 247B,A00,103651,Wang; Joseph,0,0,0,0
1668348222239,ECE 250,A00,103652,Siegel; Paul H.,0,0,0,0
1668348222663,ECE 251A,A00,103654,Rao; Bhaskar D.,0,0,0,0
1668348223090,ECE 257B,A00,103655,Bharadia; Dinesh,0,0,0,0
1668348223523,ECE 258A,A00,103656,Milstein; Laurence B.,0,0,0,0
1668348223953,ECE 260B,A00,103658,Kang; Mingu,0,0,0,0
1668348224379,ECE 264A,A00,103659,Galton; Ian A,0,0,0,0
1668348224809,ECE 265A,A00,103661,Gudem; Prasad S.S.,0,0,0,0
1668348225237,ECE 265D,A00,103662,Gudem; Prasad S.S.,0,0,0,0
1668348225661,ECE 268,A00,103663,Koushanfar; Farinaz,0,0,0,0
1668348226102,ECE 269,A01,103665,Pal; Piya,0,0,0,0
1668348226540,ECE 271B,A00,103666,Vasconcelos; Manuela,0,0,0,0
1668348226968,ECE 276A,A00,103667,Atanasov; Nikolay A.,0,0,0,0
1668348227400,ECE 277,A00,103668,An; Cheolhong,0,0,0,0
1668348227826,ECE 279,A00,117947,Hall; Drew A.,0,0,0,0
1668348228673,ECE 283,A00,103670,Hsueh; Tzu-Chien,0,0,0,0
1668348229103,ECE 284,A00,103671,Turakhia; Yatish Girish,0,0,0,0
1668348229533,ECE 285,A00,103672,Zheng; Yang,0,0,0,0
1668348229533,ECE 285,B00,103673,Sworder; David D.,0,0,0,0
1668348229961,ECE 287,A00,103676,Javidi; Tara,0,0,0,0
1668348230387,MATH 200B,A00,098023,Salehi Golsefidy; Alireza,12,0,15,3
1668348230811,MATH 202B,A00,098024,Rhoades; Brendon Patrick,9,0,15,6
1668348231237,MATH 203B,A00,098025,Oprea; Dragos N.,10,0,15,5
1668348231668,MATH 204B,A00,098026,Sorensen; Claus M,13,0,15,2
1668348232093,MATH 208,A00,098027,Izadi; Elham,7,0,10,3
1668348232520,MATH 209,A00,098028,Pollack; Aaron,10,0,10,0
1668348232947,MATH 211A,A00,112919,Rogalski; Daniel,9,0,10,1
1668348233375,MATH 211B,A00,112920,Seward; Brandon M.,9,0,10,1
1668348233801,MATH 218,A00,098029,Li; Bo,10,0,10,0
1668348234237,MATH 220B,A00,098030,Novak; Jonathan I,11,0,15,4
1668348234666,MATH 221A,A00,098031,Ebenfelt; Peter F,13,0,15,2
1668348235091,MATH 231B,A00,098032,Zlatos; Andrej,12,0,15,3
1668348235516,MATH 240B,A00,098033,Ni; Lei,9,0,15,6
1668348235943,MATH 243,A00,098034,Jekel; David Andrew,10,0,10,0
1668348236372,MATH 245A,A00,098035,Nie; Jiawang,0,0,15,16
1668348236799,MATH 248,A00,098036,Bejenaru; Ioan,10,0,10,0
1668348237224,MATH 250B,A00,098037,Spolaor; Luca,14,0,15,1
1668348237651,MATH 258,A00,098038,Ni; Lei,10,0,10,0
1668348238079,MATH 264B,A00,098041,Rhoades; Brendon Patrick,9,0,15,6
1668348238504,MATH 268,A00,098042,Buss; Samuel R,10,0,10,0
1668348238936,MATH 269,A00,098043,Rhoades; Brendon Patrick,10,0,10,0
1668348239365,MATH 270B,A00,098044,Li; Bo,10,0,15,5
1668348239801,MATH 272B,A00,098045,Holst; Michael J,13,0,15,2
1668348240231,MATH 273A,A00,098046,Tian; Xiaochuan,10,0,15,5
1668348240657,MATH 275,A01,098048,Tian; Xiaochuan,6,0,10,4
1668348241081,MATH 278A,A00,098049,Holst; Michael J,8,0,10,2
1668348241510,MATH 278B,A00,098050,Cloninger; Alexander,10,0,10,0
1668348241948,MATH 278C,A00,098051,Nie; Jiawang,7,0,10,3
1668348242388,MATH 280B,A00,098052,Zheng; Tianyi,8,0,15,7
1668348242815,MATH 281B,A00,098053,Bradic; Jelena,1,0,15,14
1668348243242,MATH 282B,A00,098054,Arias-Castro; Ery,0,0,15,15
1668348243667,MATH 285,A00,098055,Fitzsimmons; Patrick J,0,0,15,17
1668348244090,MATH 287B,A00,098056,Arias-Castro; Ery,2,0,15,13
1668348244529,MATH 288,A00,098057,Agarwal; Pooja,9,0,10,1
1668348244529,MATH 288,B00,098058,Zhang; Danna,8,0,10,2
1668348244529,MATH 288,C00,098059,Williams; Ruth J,9,0,10,1
1668348244972,MATH 290B,A00,098060,Roberts; Justin Deritter,13,0,15,2
1668348245404,MATH 292,A00,098061,Belmont; Eva Kinoshita,10,0,10,0
1668348245832,MATH 295,A00,098062,Suk; Andrew Hoon,48,0,50,2
1668348246259,MATH 296,A00,098063,Novak; Jonathan I,20,0,20,0
1668348246692,MATH 297,001,098064,Gamst; Anthony Collins,9997,0,9999,2
1668348748891,COGS 205,A00,101395,Chiba; Andrea,19,0,20,1
1668348749327,COGS 210B,001,101404,Greene; Deanna Jacquelyn,9998,0,9999,1
1668348749327,COGS 210B,002,101417,Xia; Haijun,9999,0,9999,0
1668348749327,COGS 210B,003,101422,Nitz; Douglas A.,9999,0,9999,0
1668348749327,COGS 210B,004,101423,Hollan; James D.,9998,0,9999,1
1668348749327,COGS 210B,005,101424,Deak; Gedeon O.,9998,0,9999,1
1668348749327,COGS 210B,006,101425,Rossano; Federico,9999,0,9999,0
1668348749755,COGS 211B,A00,101427,Coulson; Seana M,9996,0,9999,3
1668348750185,COGS 220,A00,101428,Hollan; James D.,0,0,25,25
1668348750609,COGS 229,A00,101429,Dow; Steven P,18,0,25,7
1668348751038,COGS 230,A00,101430,Klemmer; Scott R,11,0,17,6
1668348751462,COGS 234,A00,101431,Xia; Haijun,1,0,25,24
1668348751899,COGS 260,A00,101432,Kiyonaga; Anastasia,21,0,25,4
1668348751899,COGS 260,B00,101433,Kirsh; David Joel,15,0,25,10
1668348752338,CSE 202,A00,102371,Impagliazzo; Russell,0,0,0,0
1668348752773,CSE 203B,A01,102373,Cheng; Chung Kuan,0,0,0,0
1668348753211,CSE 208,A00,102374,Micciancio; Daniele,0,0,0,0
1668348753646,CSE 209A,A00,112895,Impagliazzo; Russell,0,0,15,15
1668348754081,CSE 209B,A00,108005,Bellare; Mihir,0,0,0,0
1668348754506,CSE 210,A00,113163,Coblenz; Michael J,0,0,0,0
1668348754930,CSE 219,A00,106111,Dow; Steven P,0,0,20,20
1668348755359,CSE 221,A00,102376,Voelker; Geoffrey M.,0,0,0,0
1668348755788,CSE 224,A01,102378,Porter; George M,0,0,0,0
1668348756215,CSE 229A,A00,102379,Savage; Stefan,0,0,0,0
1668348756641,CSE 229C,A00,102380,Munyaka; Imani N. S.,0,0,0,0
1668348757065,CSE 232B,A00,102382,Deutsch; Alin Bernard,0,0,0,0
1668348757491,CSE 234,A01,112904,Kumar; Arun Kumar,0,0,0,0
1668348757921,CSE 237A,A00,102383,Rosing; Tajana Simunic,0,0,0,0
1668348758349,CSE 239A,A00,102384,Deutsch; Alin Bernard,0,0,0,0
1668348758778,CSE 239B,A00,102385,Polikarpova; Nadezhda,0,0,0,0
1668348759203,CSE 240A,A00,102386,Pannuto; Patrick William,0,0,0,0
1668348759632,CSE 240B,A00,102387,Zhao; Jishen,0,0,0,0
1668348760069,CSE 241A,A00,106406,Kang; Mingu,0,0,0,0
1668348760494,CSE 249B,A00,102388,Kahng; Andrew Byun,0,0,8,8
1668348760920,CSE 251B,A01,102392,Cottrell; Garrison W,0,0,0,0
1668348760920,CSE 251B,A02,102393,Cottrell; Garrison W,0,0,0,0
1668348761346,CSE 252B,A00,102394,Ochoa; Benjamin Lawrence,0,0,0,0
1668348761774,CSE 257,A01,102396,Gao; Sicun,0,0,0,0
1668348762197,CSE 272,A00,102397,Li; Tzumao,0,0,0,0
1668348762624,CSE 274,A00,111323,Chern; Albert Ren-Haur,0,0,0,0
1668348763048,CSE 282,A00,102398,Pevzner; Pavel Arkadjevich,0,0,0,0
1668348763477,CSE 284,A00,114175,Gymrek; Melissa Ann,0,0,0,0
1668348763911,CSE 290,A00,102399,Chandraker; Manmohan Krishna,0,0,0,0
1668348763911,CSE 290,B00,102400,Vaccaro; Kristen Marie,0,0,25,25
1668348763911,CSE 290,C00,102414,Pannuto; Patrick William,0,0,25,25
1668348763911,CSE 290,D00,102427,Pevzner; Pavel Arkadjevich,0,0,0,0
1668348763911,CSE 290,E00,102429,Zhao; Jishen,0,0,0,0
1668348763911,CSE 290,F00,102436,Tullsen; Dean Michael,0,0,0,0
1668348763911,CSE 290,G00,102440,Christensen; Henrik I,0,0,20,20
1668348764339,CSE 291,A00,102443,Su; Hao,0,0,0,0
1668348764339,CSE 291,B00,102448,Polikarpova; Nadezhda,0,0,0,0
1668348764339,CSE 291,C00,102453,Vaccaro; Kristen Marie,0,0,0,0
1668348764339,CSE 291,D00,111343,Savage; Stefan,0,0,0,0
1668348764339,CSE 291,E00,116474,Claffy; Kimberly Claire,0,0,0,0
1668348764339,CSE 291,F00,116479,Pasquale; Joseph,0,0,0,0
1668348764784,CSE 293,001,119111,Bafna; Vineet,9999,0,9999,0
1668348764784,CSE 293,002,119118,Bellare; Mihir,9999,0,9999,0
1668348764784,CSE 293,003,119122,Berg-Kirkpatrick; Taylor D,9999,0,9999,0
1668348764784,CSE 293,004,119135,Christensen; Henrik I,9999,0,9999,0
1668348764784,CSE 293,005,119142,Cottrell; Garrison W,9999,0,9999,0
1668348764784,CSE 293,006,119146,Deutsch; Alin Bernard,9999,0,9999,0
1668348764784,CSE 293,007,119159,Esmaeilzadeh; Hadi,9999,0,9999,0
1668348764784,CSE 293,008,119166,Freund; Yoav,9999,0,9999,0
1668348764784,CSE 293,009,119170,Griswold; William G.,9999,0,9999,0
1668348764784,CSE 293,010,119183,Gymrek; Melissa Ann,9999,0,9999,0
1668348764784,CSE 293,011,119190,Heninger; Nadia A,9999,0,9999,0
1668348764784,CSE 293,012,119230,Impagliazzo; Russell,9999,0,9999,0
1668348764784,CSE 293,013,119232,Jhala; Ranjit,9999,0,9999,0
1668348764784,CSE 293,014,119233,Kahng; Andrew Byun,9999,0,9999,0
1668348764784,CSE 293,015,119298,Kane; Daniel Mertz,9999,0,9999,0
1668348764784,CSE 293,016,119299,Kriegman; David J,9999,0,9999,0
1668348764784,CSE 293,017,119300,Kumar; Arun Kumar,9999,0,9999,0
1668348764784,CSE 293,018,119301,Lerner; Sorin,9999,0,9999,0
1668348764784,CSE 293,019,119302,Lovett; Shachar,9999,0,9999,0
1668348764784,CSE 293,020,119303,McAuley; Julian John,9999,0,9999,0
1668348764784,CSE 293,021,119304,Micciancio; Daniele,9999,0,9999,0
1668348764784,CSE 293,022,119367,Orailoglu; Alex,9999,0,9999,0
1668348764784,CSE 293,023,119382,Paturi; Ramamohan,9999,0,9999,0
1668348764784,CSE 293,024,119404,Polikarpova; Nadezhda,9999,0,9999,0
1668348764784,CSE 293,025,119406,Politz; Joseph Gibbs,9999,0,9999,0
1668348764784,CSE 293,026,119411,Porter; George M,9999,0,9999,0
1668348764784,CSE 293,027,119414,Porter; Leonard Emerson,9999,0,9999,0
1668348764784,CSE 293,028,119416,Ramamoorthi; Ravi,9999,0,9999,0
1668348764784,CSE 293,029,119417,Sahoo; Debashis,9999,0,9999,0
1668348764784,CSE 293,030,119420,Saul; Lawrence,9999,0,9999,0
1668348764784,CSE 293,031,119421,Savage; Stefan,9999,0,9999,0
1668348764784,CSE 293,032,119425,Schulze; Jurgen P.,9999,0,9999,0
1668348764784,CSE 293,033,119426,Snoeren; Alex C.,9999,0,9999,0
1668348764784,CSE 293,034,119428,Shang; Jingbo,9999,0,9999,0
1668348764784,CSE 293,035,119430,Stefan; Deian,9999,0,9999,0
1668348764784,CSE 293,036,119431,Su; Hao,9999,0,9999,0
1668348764784,CSE 293,037,119433,Swanson; Steven James,9999,0,9999,0
1668348764784,CSE 293,038,119435,Tullsen; Dean Michael,9999,0,9999,0
1668348764784,CSE 293,039,119483,Voelker; Geoffrey M.,9999,0,9999,0
1668348764784,CSE 293,040,119537,Zhao; Jishen,9999,0,9999,0
1668348764784,CSE 293,041,119538,Zhou; Yuan-Yuan,9999,0,9999,0
1668348764784,CSE 293,042,119539,Gao; Sicun,9999,0,9999,0
1668348764784,CSE 293,043,119540,Weibel; Nadir,9999,0,9999,0
1668348764784,CSE 293,044,119541,Gupta; Rajesh K.,9999,0,9999,0
1668348764784,CSE 293,045,126410,Vaccaro; Kristen Marie,9999,0,9999,0
1668348764784,CSE 293,046,126411,Klemke; Richard,9999,0,9999,0
1668348765217,CSE 294,A00,102459,Voelker; Geoffrey M.,0,0,0,0
1668348765217,CSE 294,B00,111322,Orailoglu; Alex,0,0,0,0
1668348765643,DSE 201,A00,096914,Deutsch; Alin Bernard,30,0,30,0
1668348766068,DSE 210,A00,096915,Dasgupta; Sanjoy,30,0,30,0
1668348766496,DSE 260A,A00,096916,Altintas De Callaf; Ilkay,30,0,30,0
1668348766946,ECE 200,001,103586,Antipa; Nicholas A,9999,0,9999,0
1668348766946,ECE 200,002,103587,Atanasov; Nikolay A.,9999,0,9999,0
1668348766946,ECE 200,003,103588,Bharadia; Dinesh,9999,0,9999,0
1668348766946,ECE 200,004,103589,Cheng; Chung Kuan,9999,0,9999,0
1668348766946,ECE 200,005,103590,Cosman; Pamela C.,9999,0,9999,0
1668348766946,ECE 200,006,103591,Dayeh; Shadi Ahmad,9999,0,9999,0
1668348766946,ECE 200,007,103592,Fainman; Yeshaiahu,9999,0,9999,0
1668348766946,ECE 200,008,103593,Ford; Joseph Earl,9999,0,9999,0
1668348766946,ECE 200,009,103594,Franceschetti; Massimo,9999,0,9999,0
1668348766946,ECE 200,010,103595,Fullerton; Eric E,9999,0,9999,0
1668348766946,ECE 200,011,103596,Galton; Ian A,9999,0,9999,0
1668348766946,ECE 200,012,103597,Gilja; Vikash,9999,0,9999,0
1668348766946,ECE 200,013,103598,Hall; Drew A.,9999,0,9999,0
1668348766946,ECE 200,014,103599,Hsueh; Tzu-Chien,9999,0,9999,0
1668348766946,ECE 200,015,103600,Javidi; Tara,9999,0,9999,0
1668348766946,ECE 200,016,103601,Kahng; Andrew Byun,9999,0,9999,0
1668348766946,ECE 200,017,103602,Kim; Young-Han,9999,0,9999,0
1668348766946,ECE 200,018,103603,Koushanfar; Farinaz,9999,0,9999,0
1668348766946,ECE 200,019,103604,Kuzum; Duygu,9999,0,9999,0
1668348766946,ECE 200,020,103605,Le; Hanh-Phuc,9999,0,9999,0
1668348766946,ECE 200,021,103606,Lin; Bill,9999,0,9999,0
1668348766946,ECE 200,022,103607,Liu; Zhaowei,9998,0,9999,1
1668348766946,ECE 200,023,103608,Lo; Yu-Hwa,9999,0,9999,0
1668348766946,ECE 200,024,103609,Lomakin; Vitaliy,9999,0,9999,0
1668348766946,ECE 200,025,103610,Mercier; Patrick Philip,9999,0,9999,0
1668348766946,ECE 200,026,103611,Meyer; Florian,9999,0,9999,0
1668348766946,ECE 200,027,103612,Milstein; Laurence B.,9999,0,9999,0
1668348766946,ECE 200,028,103613,Mir Arabbaygi; Siavash,9999,0,9999,0
1668348766946,ECE 200,029,103614,Mookherjea; Shayan,9999,0,9999,0
1668348766946,ECE 200,030,103615,Morris; Karcher William,9999,0,9999,0
1668348766946,ECE 200,031,103616,Ng; Tse Nga,9999,0,9999,0
1668348766946,ECE 200,032,103617,Nguyen; Truong Quang,9999,0,9999,0
1668348766946,ECE 200,033,103618,Nomura; Kenji,9999,0,9999,0
1668348766946,ECE 200,034,103619,Orlitsky; Alon,9999,0,9999,0
1668348766946,ECE 200,035,103620,Pal; Piya,9999,0,9999,0
1668348766946,ECE 200,036,103621,Papen; George C.,9999,0,9999,0
1668348766946,ECE 200,037,103622,Radic; Stojan,9999,0,9999,0
1668348766946,ECE 200,038,103623,Rao; Bhaskar D.,9999,0,9999,0
1668348766946,ECE 200,039,103624,Rao; Ramesh R,9999,0,9999,0
1668348766946,ECE 200,040,103625,Rebeiz; Gabriel,9999,0,9999,0
1668348766946,ECE 200,041,103626,Sanford; John R,9999,0,9999,0
1668348766946,ECE 200,042,103627,Siegel; Paul H.,9999,0,9999,0
1668348766946,ECE 200,043,103628,Sievenpiper; Daniel F.,9999,0,9999,0
1668348766946,ECE 200,044,103629,Sworder; David D.,9999,0,9999,0
1668348766946,ECE 200,045,103630,Taur; Yuan,9999,0,9999,0
1668348766946,ECE 200,046,103631,Touri; Behrouz,9999,0,9999,0
1668348766946,ECE 200,047,103632,Trivedi; Mohan M.,9999,0,9999,0
1668348766946,ECE 200,048,103633,Vasconcelos; Nuno,9999,0,9999,0
1668348766946,ECE 200,049,103634,Wang; Xiaolong,9999,0,9999,0
1668348766946,ECE 200,050,103635,Xie; Pengtao,9999,0,9999,0
1668348766946,ECE 200,051,103636,Yip; Michael,9999,0,9999,0
1668348766946,ECE 200,052,103637,Zeger; Kenneth A.,999,0,999,0
1668348766946,ECE 200,053,103638,Zhang; Xinyu,9999,0,9999,0
1668348766946,ECE 200,054,103639,Turakhia; Yatish Girish,9999,0,9999,0
1668348766946,ECE 200,055,103640,Kang; Mingu,9999,0,9999,0
1668348766946,ECE 200,056,103641,Shi; Yuanyuan,9999,0,9999,0
1668348766946,ECE 200,057,103642,Wang; Edward Jay,9999,0,9999,0
1668348766946,ECE 200,058,103643,Zheng; Yang,9999,0,9999,0
1668348767383,ECE 202,A00,103644,Kuzum; Duygu,0,0,0,0
1668348767807,ECE 212BN,A00,103646,Ng; Tse Nga,0,0,0,0
1668348768231,ECE 221,A00,111493,Staff,0,0,0,0
1668348768658,ECE 222B,A00,103647,Lomakin; Vitaliy,0,0,0,0
1668348769086,ECE 230B,A00,103648,Taur; Yuan,0,0,0,0
1668348769515,ECE 238B,A00,103649,Garay; Javier,0,0,0,0
1668348769941,ECE 240B,A00,112900,Fainman; Yeshaiahu,0,0,0,0
1668348770366,ECE 247A,A00,103650,Jokerst; Jesse Vincent,0,0,0,0
1668348770795,ECE 247B,A00,103651,Wang; Joseph,0,0,0,0
1668348771219,ECE 250,A00,103652,Siegel; Paul H.,0,0,0,0
1668348771659,ECE 251A,A00,103654,Rao; Bhaskar D.,0,0,0,0
1668348772095,ECE 257B,A00,103655,Bharadia; Dinesh,0,0,0,0
1668348772534,ECE 258A,A00,103656,Milstein; Laurence B.,0,0,0,0
1668348772959,ECE 260B,A00,103658,Kang; Mingu,0,0,0,0
1668348773387,ECE 264A,A00,103659,Galton; Ian A,0,0,0,0
1668348773812,ECE 265A,A00,103661,Gudem; Prasad S.S.,0,0,0,0
1668348774239,ECE 265D,A00,103662,Gudem; Prasad S.S.,0,0,0,0
1668348774664,ECE 268,A00,103663,Koushanfar; Farinaz,0,0,0,0
1668348775089,ECE 269,A01,103665,Pal; Piya,0,0,0,0
1668348775514,ECE 271B,A00,103666,Vasconcelos; Manuela,0,0,0,0
1668348775941,ECE 276A,A00,103667,Atanasov; Nikolay A.,0,0,0,0
1668348776367,ECE 277,A00,103668,An; Cheolhong,0,0,0,0
1668348776789,ECE 279,A00,117947,Hall; Drew A.,0,0,0,0
1668348777637,ECE 283,A00,103670,Hsueh; Tzu-Chien,0,0,0,0
1668348778065,ECE 284,A00,103671,Turakhia; Yatish Girish,0,0,0,0
1668348778492,ECE 285,A00,103672,Zheng; Yang,0,0,0,0
1668348778492,ECE 285,B00,103673,Sworder; David D.,0,0,0,0
1668348778996,ECE 287,A00,103676,Javidi; Tara,0,0,0,0
1668348779423,MATH 200B,A00,098023,Salehi Golsefidy; Alireza,12,0,15,3
1668348779848,MATH 202B,A00,098024,Rhoades; Brendon Patrick,9,0,15,6
1668348780271,MATH 203B,A00,098025,Oprea; Dragos N.,10,0,15,5
1668348780698,MATH 204B,A00,098026,Sorensen; Claus M,13,0,15,2
1668348781123,MATH 208,A00,098027,Izadi; Elham,7,0,10,3
1668348781546,MATH 209,A00,098028,Pollack; Aaron,10,0,10,0
1668348781971,MATH 211A,A00,112919,Rogalski; Daniel,9,0,10,1
1668348782394,MATH 211B,A00,112920,Seward; Brandon M.,9,0,10,1
1668348782822,MATH 218,A00,098029,Li; Bo,10,0,10,0
1668348783245,MATH 220B,A00,098030,Novak; Jonathan I,11,0,15,4
1668348783670,MATH 221A,A00,098031,Ebenfelt; Peter F,13,0,15,2
1668348784095,MATH 231B,A00,098032,Zlatos; Andrej,12,0,15,3
1668348784521,MATH 240B,A00,098033,Ni; Lei,9,0,15,6
1668348784945,MATH 243,A00,098034,Jekel; David Andrew,10,0,10,0
1668348785373,MATH 245A,A00,098035,Nie; Jiawang,0,0,15,16
1668348785798,MATH 248,A00,098036,Bejenaru; Ioan,10,0,10,0
1668348786224,MATH 250B,A00,098037,Spolaor; Luca,14,0,15,1
1668348786657,MATH 258,A00,098038,Ni; Lei,10,0,10,0
1668348787080,MATH 264B,A00,098041,Rhoades; Brendon Patrick,9,0,15,6
1668348787505,MATH 268,A00,098042,Buss; Samuel R,10,0,10,0
1668348787932,MATH 269,A00,098043,Rhoades; Brendon Patrick,10,0,10,0
1668348788360,MATH 270B,A00,098044,Li; Bo,10,0,15,5
1668348788786,MATH 272B,A00,098045,Holst; Michael J,13,0,15,2
1668348789212,MATH 273A,A00,098046,Tian; Xiaochuan,10,0,15,5
1668348789638,MATH 275,A01,098048,Tian; Xiaochuan,6,0,10,4
1668348790063,MATH 278A,A00,098049,Holst; Michael J,8,0,10,2
1668348790487,MATH 278B,A00,098050,Cloninger; Alexander,10,0,10,0
1668348790910,MATH 278C,A00,098051,Nie; Jiawang,7,0,10,3
1668348791335,MATH 280B,A00,098052,Zheng; Tianyi,8,0,15,7
1668348791763,MATH 281B,A00,098053,Bradic; Jelena,1,0,15,14
1668348792187,MATH 282B,A00,098054,Arias-Castro; Ery,0,0,15,15
1668348792612,MATH 285,A00,098055,Fitzsimmons; Patrick J,0,0,15,17
1668348793040,MATH 287B,A00,098056,Arias-Castro; Ery,2,0,15,13
1668348793485,MATH 288,A00,098057,Agarwal; Pooja,9,0,10,1
1668348793485,MATH 288,B00,098058,Zhang; Danna,8,0,10,2
1668348793485,MATH 288,C00,098059,Williams; Ruth J,9,0,10,1
1668348793909,MATH 290B,A00,098060,Roberts; Justin Deritter,13,0,15,2
1668348794334,MATH 292,A00,098061,Belmont; Eva Kinoshita,10,0,10,0
1668348794759,MATH 295,A00,098062,Suk; Andrew Hoon,48,0,50,2
1668348795187,MATH 296,A00,098063,Novak; Jonathan I,20,0,20,0
1668348795614,MATH 297,001,098064,Gamst; Anthony Collins,9997,0,9999,2
1668349297110,COGS 205,A00,101395,Chiba; Andrea,19,0,20,1
1668349297540,COGS 210B,001,101404,Greene; Deanna Jacquelyn,9998,0,9999,1
1668349297540,COGS 210B,002,101417,Xia; Haijun,9999,0,9999,0
1668349297540,COGS 210B,003,101422,Nitz; Douglas A.,9999,0,9999,0
1668349297540,COGS 210B,004,101423,Hollan; James D.,9998,0,9999,1
1668349297540,COGS 210B,005,101424,Deak; Gedeon O.,9998,0,9999,1
1668349297540,COGS 210B,006,101425,Rossano; Federico,9999,0,9999,0
1668349297968,COGS 211B,A00,101427,Coulson; Seana M,9996,0,9999,3
1668349298393,COGS 220,A00,101428,Hollan; James D.,0,0,25,25
1668349298817,COGS 229,A00,101429,Dow; Steven P,18,0,25,7
1668349299240,COGS 230,A00,101430,Klemmer; Scott R,11,0,17,6
1668349299675,COGS 234,A00,101431,Xia; Haijun,1,0,25,24
1668349300105,COGS 260,A00,101432,Kiyonaga; Anastasia,21,0,25,4
1668349300105,COGS 260,B00,101433,Kirsh; David Joel,15,0,25,10
1668349300619,CSE 202,A00,102371,Impagliazzo; Russell,0,0,0,0
1668349301052,CSE 203B,A01,102373,Cheng; Chung Kuan,0,0,0,0
1668349301475,CSE 208,A00,102374,Micciancio; Daniele,0,0,0,0
1668349301900,CSE 209A,A00,112895,Impagliazzo; Russell,0,0,15,15
1668349302327,CSE 209B,A00,108005,Bellare; Mihir,0,0,0,0
1668349302759,CSE 210,A00,113163,Coblenz; Michael J,0,0,0,0
1668349303198,CSE 219,A00,106111,Dow; Steven P,0,0,20,20
1668349303626,CSE 221,A00,102376,Voelker; Geoffrey M.,0,0,0,0
1668349304053,CSE 224,A01,102378,Porter; George M,0,0,0,0
1668349304495,CSE 229A,A00,102379,Savage; Stefan,0,0,0,0
1668349304919,CSE 229C,A00,102380,Munyaka; Imani N. S.,0,0,0,0
1668349305357,CSE 232B,A00,102382,Deutsch; Alin Bernard,0,0,0,0
1668349305783,CSE 234,A01,112904,Kumar; Arun Kumar,0,0,0,0
1668349306207,CSE 237A,A00,102383,Rosing; Tajana Simunic,0,0,0,0
1668349306633,CSE 239A,A00,102384,Deutsch; Alin Bernard,0,0,0,0
1668349307060,CSE 239B,A00,102385,Polikarpova; Nadezhda,0,0,0,0
1668349307493,CSE 240A,A00,102386,Pannuto; Patrick William,0,0,0,0
1668349307931,CSE 240B,A00,102387,Zhao; Jishen,0,0,0,0
1668349308361,CSE 241A,A00,106406,Kang; Mingu,0,0,0,0
1668349308800,CSE 249B,A00,102388,Kahng; Andrew Byun,0,0,8,8
1668349309230,CSE 251B,A01,102392,Cottrell; Garrison W,0,0,0,0
1668349309230,CSE 251B,A02,102393,Cottrell; Garrison W,0,0,0,0
1668349309658,CSE 252B,A00,102394,Ochoa; Benjamin Lawrence,0,0,0,0
1668349310084,CSE 257,A01,102396,Gao; Sicun,0,0,0,0
1668349310515,CSE 272,A00,102397,Li; Tzumao,0,0,0,0
1668349310940,CSE 274,A00,111323,Chern; Albert Ren-Haur,0,0,0,0
1668349311366,CSE 282,A00,102398,Pevzner; Pavel Arkadjevich,0,0,0,0
1668349311790,CSE 284,A00,114175,Gymrek; Melissa Ann,0,0,0,0
1668349312216,CSE 290,A00,102399,Chandraker; Manmohan Krishna,0,0,0,0
1668349312216,CSE 290,B00,102400,Vaccaro; Kristen Marie,0,0,25,25
1668349312216,CSE 290,C00,102414,Pannuto; Patrick William,0,0,25,25
1668349312216,CSE 290,D00,102427,Pevzner; Pavel Arkadjevich,0,0,0,0
1668349312216,CSE 290,E00,102429,Zhao; Jishen,0,0,0,0
1668349312216,CSE 290,F00,102436,Tullsen; Dean Michael,0,0,0,0
1668349312216,CSE 290,G00,102440,Christensen; Henrik I,0,0,20,20
1668349312651,CSE 291,A00,102443,Su; Hao,0,0,0,0
1668349312651,CSE 291,B00,102448,Polikarpova; Nadezhda,0,0,0,0
1668349312651,CSE 291,C00,102453,Vaccaro; Kristen Marie,0,0,0,0
1668349312651,CSE 291,D00,111343,Savage; Stefan,0,0,0,0
1668349312651,CSE 291,E00,116474,Claffy; Kimberly Claire,0,0,0,0
1668349312651,CSE 291,F00,116479,Pasquale; Joseph,0,0,0,0
1668349313130,CSE 293,001,119111,Bafna; Vineet,9999,0,9999,0
1668349313130,CSE 293,002,119118,Bellare; Mihir,9999,0,9999,0
1668349313130,CSE 293,003,119122,Berg-Kirkpatrick; Taylor D,9999,0,9999,0
1668349313130,CSE 293,004,119135,Christensen; Henrik I,9999,0,9999,0
1668349313130,CSE 293,005,119142,Cottrell; Garrison W,9999,0,9999,0
1668349313130,CSE 293,006,119146,Deutsch; Alin Bernard,9999,0,9999,0
1668349313130,CSE 293,007,119159,Esmaeilzadeh; Hadi,9999,0,9999,0
1668349313130,CSE 293,008,119166,Freund; Yoav,9999,0,9999,0
1668349313130,CSE 293,009,119170,Griswold; William G.,9999,0,9999,0
1668349313130,CSE 293,010,119183,Gymrek; Melissa Ann,9999,0,9999,0
1668349313130,CSE 293,011,119190,Heninger; Nadia A,9999,0,9999,0
1668349313130,CSE 293,012,119230,Impagliazzo; Russell,9999,0,9999,0
1668349313130,CSE 293,013,119232,Jhala; Ranjit,9999,0,9999,0
1668349313130,CSE 293,014,119233,Kahng; Andrew Byun,9999,0,9999,0
1668349313130,CSE 293,015,119298,Kane; Daniel Mertz,9999,0,9999,0
1668349313130,CSE 293,016,119299,Kriegman; David J,9999,0,9999,0
1668349313130,CSE 293,017,119300,Kumar; Arun Kumar,9999,0,9999,0
1668349313130,CSE 293,018,119301,Lerner; Sorin,9999,0,9999,0
1668349313130,CSE 293,019,119302,Lovett; Shachar,9999,0,9999,0
1668349313130,CSE 293,020,119303,McAuley; Julian John,9999,0,9999,0
1668349313130,CSE 293,021,119304,Micciancio; Daniele,9999,0,9999,0
1668349313130,CSE 293,022,119367,Orailoglu; Alex,9999,0,9999,0
1668349313130,CSE 293,023,119382,Paturi; Ramamohan,9999,0,9999,0
1668349313130,CSE 293,024,119404,Polikarpova; Nadezhda,9999,0,9999,0
1668349313130,CSE 293,025,119406,Politz; Joseph Gibbs,9999,0,9999,0
1668349313130,CSE 293,026,119411,Porter; George M,9999,0,9999,0
1668349313130,CSE 293,027,119414,Porter; Leonard Emerson,9999,0,9999,0
1668349313130,CSE 293,028,119416,Ramamoorthi; Ravi,9999,0,9999,0
1668349313130,CSE 293,029,119417,Sahoo; Debashis,9999,0,9999,0
1668349313130,CSE 293,030,119420,Saul; Lawrence,9999,0,9999,0
1668349313130,CSE 293,031,119421,Savage; Stefan,9999,0,9999,0
1668349313130,CSE 293,032,119425,Schulze; Jurgen P.,9999,0,9999,0
1668349313130,CSE 293,033,119426,Snoeren; Alex C.,9999,0,9999,0
1668349313130,CSE 293,034,119428,Shang; Jingbo,9999,0,9999,0
1668349313130,CSE 293,035,119430,Stefan; Deian,9999,0,9999,0
1668349313130,CSE 293,036,119431,Su; Hao,9999,0,9999,0
1668349313130,CSE 293,037,119433,Swanson; Steven James,9999,0,9999,0
1668349313130,CSE 293,038,119435,Tullsen; Dean Michael,9999,0,9999,0
1668349313130,CSE 293,039,119483,Voelker; Geoffrey M.,9999,0,9999,0
1668349313130,CSE 293,040,119537,Zhao; Jishen,9999,0,9999,0
1668349313130,CSE 293,041,119538,Zhou; Yuan-Yuan,9999,0,9999,0
1668349313130,CSE 293,042,119539,Gao; Sicun,9999,0,9999,0
1668349313130,CSE 293,043,119540,Weibel; Nadir,9999,0,9999,0
1668349313130,CSE 293,044,119541,Gupta; Rajesh K.,9999,0,9999,0
1668349313130,CSE 293,045,126410,Vaccaro; Kristen Marie,9999,0,9999,0
1668349313130,CSE 293,046,126411,Klemke; Richard,9999,0,9999,0
1668349313553,CSE 294,A00,102459,Voelker; Geoffrey M.,0,0,0,0
1668349313553,CSE 294,B00,111322,Orailoglu; Alex,0,0,0,0
1668349313978,DSE 201,A00,096914,Deutsch; Alin Bernard,30,0,30,0
1668349314402,DSE 210,A00,096915,Dasgupta; Sanjoy,30,0,30,0
1668349314829,DSE 260A,A00,096916,Altintas De Callaf; Ilkay,30,0,30,0
1668349315292,ECE 200,001,103586,Antipa; Nicholas A,9999,0,9999,0
1668349315292,ECE 200,002,103587,Atanasov; Nikolay A.,9999,0,9999,0
1668349315292,ECE 200,003,103588,Bharadia; Dinesh,9999,0,9999,0
1668349315292,ECE 200,004,103589,Cheng; Chung Kuan,9999,0,9999,0
1668349315292,ECE 200,005,103590,Cosman; Pamela C.,9999,0,9999,0
1668349315292,ECE 200,006,103591,Dayeh; Shadi Ahmad,9999,0,9999,0
1668349315292,ECE 200,007,103592,Fainman; Yeshaiahu,9999,0,9999,0
1668349315292,ECE 200,008,103593,Ford; Joseph Earl,9999,0,9999,0
1668349315292,ECE 200,009,103594,Franceschetti; Massimo,9999,0,9999,0
1668349315292,ECE 200,010,103595,Fullerton; Eric E,9999,0,9999,0
1668349315292,ECE 200,011,103596,Galton; Ian A,9999,0,9999,0
1668349315292,ECE 200,012,103597,Gilja; Vikash,9999,0,9999,0
1668349315292,ECE 200,013,103598,Hall; Drew A.,9999,0,9999,0
1668349315292,ECE 200,014,103599,Hsueh; Tzu-Chien,9999,0,9999,0
1668349315292,ECE 200,015,103600,Javidi; Tara,9999,0,9999,0
1668349315292,ECE 200,016,103601,Kahng; Andrew Byun,9999,0,9999,0
1668349315292,ECE 200,017,103602,Kim; Young-Han,9999,0,9999,0
1668349315292,ECE 200,018,103603,Koushanfar; Farinaz,9999,0,9999,0
1668349315292,ECE 200,019,103604,Kuzum; Duygu,9999,0,9999,0
1668349315292,ECE 200,020,103605,Le; Hanh-Phuc,9999,0,9999,0
1668349315292,ECE 200,021,103606,Lin; Bill,9999,0,9999,0
1668349315292,ECE 200,022,103607,Liu; Zhaowei,9998,0,9999,1
1668349315292,ECE 200,023,103608,Lo; Yu-Hwa,9999,0,9999,0
1668349315292,ECE 200,024,103609,Lomakin; Vitaliy,9999,0,9999,0
1668349315292,ECE 200,025,103610,Mercier; Patrick Philip,9999,0,9999,0
1668349315292,ECE 200,026,103611,Meyer; Florian,9999,0,9999,0
1668349315292,ECE 200,027,103612,Milstein; Laurence B.,9999,0,9999,0
1668349315292,ECE 200,028,103613,Mir Arabbaygi; Siavash,9999,0,9999,0
1668349315292,ECE 200,029,103614,Mookherjea; Shayan,9999,0,9999,0
1668349315292,ECE 200,030,103615,Morris; Karcher William,9999,0,9999,0
1668349315292,ECE 200,031,103616,Ng; Tse Nga,9999,0,9999,0
1668349315292,ECE 200,032,103617,Nguyen; Truong Quang,9999,0,9999,0
1668349315292,ECE 200,033,103618,Nomura; Kenji,9999,0,9999,0
1668349315292,ECE 200,034,103619,Orlitsky; Alon,9999,0,9999,0
1668349315292,ECE 200,035,103620,Pal; Piya,9999,0,9999,0
1668349315292,ECE 200,036,103621,Papen; George C.,9999,0,9999,0
1668349315292,ECE 200,037,103622,Radic; Stojan,9999,0,9999,0
1668349315292,ECE 200,038,103623,Rao; Bhaskar D.,9999,0,9999,0
1668349315292,ECE 200,039,103624,Rao; Ramesh R,9999,0,9999,0
1668349315292,ECE 200,040,103625,Rebeiz; Gabriel,9999,0,9999,0
1668349315292,ECE 200,041,103626,Sanford; John R,9999,0,9999,0
1668349315292,ECE 200,042,103627,Siegel; Paul H.,9999,0,9999,0
1668349315292,ECE 200,043,103628,Sievenpiper; Daniel F.,9999,0,9999,0
1668349315292,ECE 200,044,103629,Sworder; David D.,9999,0,9999,0
1668349315292,ECE 200,045,103630,Taur; Yuan,9999,0,9999,0
1668349315292,ECE 200,046,103631,Touri; Behrouz,9999,0,9999,0
1668349315292,ECE 200,047,103632,Trivedi; Mohan M.,9999,0,9999,0
1668349315292,ECE 200,048,103633,Vasconcelos; Nuno,9999,0,9999,0
1668349315292,ECE 200,049,103634,Wang; Xiaolong,9999,0,9999,0
1668349315292,ECE 200,050,103635,Xie; Pengtao,9999,0,9999,0
1668349315292,ECE 200,051,103636,Yip; Michael,9999,0,9999,0
1668349315292,ECE 200,052,103637,Zeger; Kenneth A.,999,0,999,0
1668349315292,ECE 200,053,103638,Zhang; Xinyu,9999,0,9999,0
1668349315292,ECE 200,054,103639,Turakhia; Yatish Girish,9999,0,9999,0
1668349315292,ECE 200,055,103640,Kang; Mingu,9999,0,9999,0
1668349315292,ECE 200,056,103641,Shi; Yuanyuan,9999,0,9999,0
1668349315292,ECE 200,057,103642,Wang; Edward Jay,9999,0,9999,0
1668349315292,ECE 200,058,103643,Zheng; Yang,9999,0,9999,0
1668349315729,ECE 202,A00,103644,Kuzum; Duygu,0,0,0,0
1668349316159,ECE 212BN,A00,103646,Ng; Tse Nga,0,0,0,0
1668349316589,ECE 221,A00,111493,Staff,0,0,0,0
1668349317030,ECE 222B,A00,103647,Lomakin; Vitaliy,0,0,0,0
1668349317468,ECE 230B,A00,103648,Taur; Yuan,0,0,0,0
1668349317920,ECE 238B,A00,103649,Garay; Javier,0,0,0,0
1668349318354,ECE 240B,A00,112900,Fainman; Yeshaiahu,0,0,0,0
1668349318785,ECE 247A,A00,103650,Jokerst; Jesse Vincent,0,0,0,0
1668349319209,ECE 247B,A00,103651,Wang; Joseph,0,0,0,0
1668349319636,ECE 250,A00,103652,Siegel; Paul H.,0,0,0,0
1668349320061,ECE 251A,A00,103654,Rao; Bhaskar D.,0,0,0,0
1668349320508,ECE 257B,A00,103655,Bharadia; Dinesh,0,0,0,0
1668349320936,ECE 258A,A00,103656,Milstein; Laurence B.,0,0,0,0
1668349321360,ECE 260B,A00,103658,Kang; Mingu,0,0,0,0
1668349321798,ECE 264A,A00,103659,Galton; Ian A,0,0,0,0
1668349322229,ECE 265A,A00,103661,Gudem; Prasad S.S.,0,0,0,0
1668349322656,ECE 265D,A00,103662,Gudem; Prasad S.S.,0,0,0,0
1668349323090,ECE 268,A00,103663,Koushanfar; Farinaz,0,0,0,0
1668349323524,ECE 269,A01,103665,Pal; Piya,0,0,0,0
1668349323956,ECE 271B,A00,103666,Vasconcelos; Manuela,0,0,0,0
1668349324390,ECE 276A,A00,103667,Atanasov; Nikolay A.,0,0,0,0
1668349324814,ECE 277,A00,103668,An; Cheolhong,0,0,0,0
1668349325250,ECE 279,A00,117947,Hall; Drew A.,0,0,0,0
1668349326103,ECE 283,A00,103670,Hsueh; Tzu-Chien,0,0,0,0
1668349326533,ECE 284,A00,103671,Turakhia; Yatish Girish,0,0,0,0
1668349326962,ECE 285,A00,103672,Zheng; Yang,0,0,0,0
1668349326962,ECE 285,B00,103673,Sworder; David D.,0,0,0,0
1668349327397,ECE 287,A00,103676,Javidi; Tara,0,0,0,0
1668349327823,MATH 200B,A00,098023,Salehi Golsefidy; Alireza,12,0,15,3
1668349328250,MATH 202B,A00,098024,Rhoades; Brendon Patrick,9,0,15,6
1668349328674,MATH 203B,A00,098025,Oprea; Dragos N.,10,0,15,5
1668349329100,MATH 204B,A00,098026,Sorensen; Claus M,13,0,15,2
1668349329521,MATH 208,A00,098027,Izadi; Elham,7,0,10,3
1668349329948,MATH 209,A00,098028,Pollack; Aaron,10,0,10,0
1668349330377,MATH 211A,A00,112919,Rogalski; Daniel,9,0,10,1
1668349330800,MATH 211B,A00,112920,Seward; Brandon M.,9,0,10,1
1668349331226,MATH 218,A00,098029,Li; Bo,10,0,10,0
1668349331650,MATH 220B,A00,098030,Novak; Jonathan I,11,0,15,4
1668349332079,MATH 221A,A00,098031,Ebenfelt; Peter F,13,0,15,2
1668349332505,MATH 231B,A00,098032,Zlatos; Andrej,12,0,15,3
1668349332932,MATH 240B,A00,098033,Ni; Lei,9,0,15,6
1668349333358,MATH 243,A00,098034,Jekel; David Andrew,10,0,10,0
1668349333810,MATH 245A,A00,098035,Nie; Jiawang,0,0,15,16
1668349334235,MATH 248,A00,098036,Bejenaru; Ioan,10,0,10,0
1668349334665,MATH 250B,A00,098037,Spolaor; Luca,14,0,15,1
1668349335097,MATH 258,A00,098038,Ni; Lei,10,0,10,0
1668349335519,MATH 264B,A00,098041,Rhoades; Brendon Patrick,9,0,15,6
1668349335942,MATH 268,A00,098042,Buss; Samuel R,10,0,10,0
1668349336374,MATH 269,A00,098043,Rhoades; Brendon Patrick,10,0,10,0
1668349336800,MATH 270B,A00,098044,Li; Bo,10,0,15,5
1668349337229,MATH 272B,A00,098045,Holst; Michael J,13,0,15,2
1668349337654,MATH 273A,A00,098046,Tian; Xiaochuan,10,0,15,5
1668349338080,MATH 275,A01,098048,Tian; Xiaochuan,6,0,10,4
1668349338503,MATH 278A,A00,098049,Holst; Michael J,8,0,10,2
1668349338931,MATH 278B,A00,098050,Cloninger; Alexander,10,0,10,0
1668349339358,MATH 278C,A00,098051,Nie; Jiawang,7,0,10,3
1668349339788,MATH 280B,A00,098052,Zheng; Tianyi,8,0,15,7
1668349340212,MATH 281B,A00,098053,Bradic; Jelena,1,0,15,14
1668349340636,MATH 282B,A00,098054,Arias-Castro; Ery,0,0,15,15
1668349341061,MATH 285,A00,098055,Fitzsimmons; Patrick J,0,0,15,17
1668349341489,MATH 287B,A00,098056,Arias-Castro; Ery,2,0,15,13
1668349341924,MATH 288,A00,098057,Agarwal; Pooja,9,0,10,1
1668349341924,MATH 288,B00,098058,Zhang; Danna,8,0,10,2
1668349341924,MATH 288,C00,098059,Williams; Ruth J,9,0,10,1
1668349342352,MATH 290B,A00,098060,Roberts; Justin Deritter,13,0,15,2
1668349342774,MATH 292,A00,098061,Belmont; Eva Kinoshita,10,0,10,0
1668349343198,MATH 295,A00,098062,Suk; Andrew Hoon,48,0,50,2
1668349343620,MATH 296,A00,098063,Novak; Jonathan I,20,0,20,0
1668349344139,MATH 297,001,098064,Gamst; Anthony Collins,9997,0,9999,2
1668349844826,COGS 205,A00,101395,Chiba; Andrea,19,0,20,1
1668349845254,COGS 210B,001,101404,Greene; Deanna Jacquelyn,9998,0,9999,1
1668349845254,COGS 210B,002,101417,Xia; Haijun,9999,0,9999,0
1668349845254,COGS 210B,003,101422,Nitz; Douglas A.,9999,0,9999,0
1668349845254,COGS 210B,004,101423,Hollan; James D.,9998,0,9999,1
1668349845254,COGS 210B,005,101424,Deak; Gedeon O.,9998,0,9999,1
1668349845254,COGS 210B,006,101425,Rossano; Federico,9999,0,9999,0
1668349845678,COGS 211B,A00,101427,Coulson; Seana M,9996,0,9999,3
1668349846103,COGS 220,A00,101428,Hollan; James D.,0,0,25,25
1668349846528,COGS 229,A00,101429,Dow; Steven P,18,0,25,7
1668349846950,COGS 230,A00,101430,Klemmer; Scott R,11,0,17,6
1668349847378,COGS 234,A00,101431,Xia; Haijun,1,0,25,24
1668349847801,COGS 260,A00,101432,Kiyonaga; Anastasia,21,0,25,4
1668349847801,COGS 260,B00,101433,Kirsh; David Joel,15,0,25,10
1668349848225,CSE 202,A00,102371,Impagliazzo; Russell,0,0,0,0
1668349848649,CSE 203B,A01,102373,Cheng; Chung Kuan,0,0,0,0
1668349849077,CSE 208,A00,102374,Micciancio; Daniele,0,0,0,0
1668349849504,CSE 209A,A00,112895,Impagliazzo; Russell,0,0,15,15
1668349849930,CSE 209B,A00,108005,Bellare; Mihir,0,0,0,0
1668349850368,CSE 210,A00,113163,Coblenz; Michael J,0,0,0,0
1668349850794,CSE 219,A00,106111,Dow; Steven P,0,0,20,20
1668349851221,CSE 221,A00,102376,Voelker; Geoffrey M.,0,0,0,0
1668349851646,CSE 224,A01,102378,Porter; George M,0,0,0,0
1668349852070,CSE 229A,A00,102379,Savage; Stefan,0,0,0,0
1668349852496,CSE 229C,A00,102380,Munyaka; Imani N. S.,0,0,0,0
1668349852921,CSE 232B,A00,102382,Deutsch; Alin Bernard,0,0,0,0
1668349853348,CSE 234,A01,112904,Kumar; Arun Kumar,0,0,0,0
1668349853774,CSE 237A,A00,102383,Rosing; Tajana Simunic,0,0,0,0
1668349854196,CSE 239A,A00,102384,Deutsch; Alin Bernard,0,0,0,0
1668349854617,CSE 239B,A00,102385,Polikarpova; Nadezhda,0,0,0,0
1668349855042,CSE 240A,A00,102386,Pannuto; Patrick William,0,0,0,0
1668349855468,CSE 240B,A00,102387,Zhao; Jishen,0,0,0,0
1668349855892,CSE 241A,A00,106406,Kang; Mingu,0,0,0,0
1668349856318,CSE 249B,A00,102388,Kahng; Andrew Byun,0,0,8,8
1668349856747,CSE 251B,A01,102392,Cottrell; Garrison W,0,0,0,0
1668349856747,CSE 251B,A02,102393,Cottrell; Garrison W,0,0,0,0
1668349857176,CSE 252B,A00,102394,Ochoa; Benjamin Lawrence,0,0,0,0
1668349857611,CSE 257,A01,102396,Gao; Sicun,0,0,0,0
1668349858038,CSE 272,A00,102397,Li; Tzumao,0,0,0,0
1668349858462,CSE 274,A00,111323,Chern; Albert Ren-Haur,0,0,0,0
1668349858898,CSE 282,A00,102398,Pevzner; Pavel Arkadjevich,0,0,0,0
1668349859321,CSE 284,A00,114175,Gymrek; Melissa Ann,0,0,0,0
1668349859747,CSE 290,A00,102399,Chandraker; Manmohan Krishna,0,0,0,0
1668349859747,CSE 290,B00,102400,Vaccaro; Kristen Marie,0,0,25,25
1668349859747,CSE 290,C00,102414,Pannuto; Patrick William,0,0,25,25
1668349859747,CSE 290,D00,102427,Pevzner; Pavel Arkadjevich,0,0,0,0
1668349859747,CSE 290,E00,102429,Zhao; Jishen,0,0,0,0
1668349859747,CSE 290,F00,102436,Tullsen; Dean Michael,0,0,0,0
1668349859747,CSE 290,G00,102440,Christensen; Henrik I,0,0,20,20
1668349860170,CSE 291,A00,102443,Su; Hao,0,0,0,0
1668349860170,CSE 291,B00,102448,Polikarpova; Nadezhda,0,0,0,0
1668349860170,CSE 291,C00,102453,Vaccaro; Kristen Marie,0,0,0,0
1668349860170,CSE 291,D00,111343,Savage; Stefan,0,0,0,0
1668349860170,CSE 291,E00,116474,Claffy; Kimberly Claire,0,0,0,0
1668349860170,CSE 291,F00,116479,Pasquale; Joseph,0,0,0,0
1668349860625,CSE 293,001,119111,Bafna; Vineet,9999,0,9999,0
1668349860625,CSE 293,002,119118,Bellare; Mihir,9999,0,9999,0
1668349860625,CSE 293,003,119122,Berg-Kirkpatrick; Taylor D,9999,0,9999,0
1668349860625,CSE 293,004,119135,Christensen; Henrik I,9999,0,9999,0
1668349860625,CSE 293,005,119142,Cottrell; Garrison W,9999,0,9999,0
1668349860625,CSE 293,006,119146,Deutsch; Alin Bernard,9999,0,9999,0
1668349860625,CSE 293,007,119159,Esmaeilzadeh; Hadi,9999,0,9999,0
1668349860625,CSE 293,008,119166,Freund; Yoav,9999,0,9999,0
1668349860625,CSE 293,009,119170,Griswold; William G.,9999,0,9999,0
1668349860625,CSE 293,010,119183,Gymrek; Melissa Ann,9999,0,9999,0
1668349860625,CSE 293,011,119190,Heninger; Nadia A,9999,0,9999,0
1668349860625,CSE 293,012,119230,Impagliazzo; Russell,9999,0,9999,0
1668349860625,CSE 293,013,119232,Jhala; Ranjit,9999,0,9999,0
1668349860625,CSE 293,014,119233,Kahng; Andrew Byun,9999,0,9999,0
1668349860625,CSE 293,015,119298,Kane; Daniel Mertz,9999,0,9999,0
1668349860625,CSE 293,016,119299,Kriegman; David J,9999,0,9999,0
1668349860625,CSE 293,017,119300,Kumar; Arun Kumar,9999,0,9999,0
1668349860625,CSE 293,018,119301,Lerner; Sorin,9999,0,9999,0
1668349860625,CSE 293,019,119302,Lovett; Shachar,9999,0,9999,0
1668349860625,CSE 293,020,119303,McAuley; Julian John,9999,0,9999,0
1668349860625,CSE 293,021,119304,Micciancio; Daniele,9999,0,9999,0
1668349860625,CSE 293,022,119367,Orailoglu; Alex,9999,0,9999,0
1668349860625,CSE 293,023,119382,Paturi; Ramamohan,9999,0,9999,0
1668349860625,CSE 293,024,119404,Polikarpova; Nadezhda,9999,0,9999,0
1668349860625,CSE 293,025,119406,Politz; Joseph Gibbs,9999,0,9999,0
1668349860625,CSE 293,026,119411,Porter; George M,9999,0,9999,0
1668349860625,CSE 293,027,119414,Porter; Leonard Emerson,9999,0,9999,0
1668349860625,CSE 293,028,119416,Ramamoorthi; Ravi,9999,0,9999,0
1668349860625,CSE 293,029,119417,Sahoo; Debashis,9999,0,9999,0
1668349860625,CSE 293,030,119420,Saul; Lawrence,9999,0,9999,0
1668349860625,CSE 293,031,119421,Savage; Stefan,9999,0,9999,0
1668349860625,CSE 293,032,119425,Schulze; Jurgen P.,9999,0,9999,0
1668349860625,CSE 293,033,119426,Snoeren; Alex C.,9999,0,9999,0
1668349860625,CSE 293,034,119428,Shang; Jingbo,9999,0,9999,0
1668349860625,CSE 293,035,119430,Stefan; Deian,9999,0,9999,0
1668349860625,CSE 293,036,119431,Su; Hao,9999,0,9999,0
1668349860625,CSE 293,037,119433,Swanson; Steven James,9999,0,9999,0
1668349860625,CSE 293,038,119435,Tullsen; Dean Michael,9999,0,9999,0
1668349860625,CSE 293,039,119483,Voelker; Geoffrey M.,9999,0,9999,0
1668349860625,CSE 293,040,119537,Zhao; Jishen,9999,0,9999,0
1668349860625,CSE 293,041,119538,Zhou; Yuan-Yuan,9999,0,9999,0
1668349860625,CSE 293,042,119539,Gao; Sicun,9999,0,9999,0
1668349860625,CSE 293,043,119540,Weibel; Nadir,9999,0,9999,0
1668349860625,CSE 293,044,119541,Gupta; Rajesh K.,9999,0,9999,0
1668349860625,CSE 293,045,126410,Vaccaro; Kristen Marie,9999,0,9999,0
1668349860625,CSE 293,046,126411,Klemke; Richard,9999,0,9999,0
1668349861051,CSE 294,A00,102459,Voelker; Geoffrey M.,0,0,0,0
1668349861051,CSE 294,B00,111322,Orailoglu; Alex,0,0,0,0
1668349861476,DSE 201,A00,096914,Deutsch; Alin Bernard,30,0,30,0
1668349861902,DSE 210,A00,096915,Dasgupta; Sanjoy,30,0,30,0
1668349862332,DSE 260A,A00,096916,Altintas De Callaf; Ilkay,30,0,30,0
1668349862795,ECE 200,001,103586,Antipa; Nicholas A,9999,0,9999,0
1668349862795,ECE 200,002,103587,Atanasov; Nikolay A.,9999,0,9999,0
1668349862795,ECE 200,003,103588,Bharadia; Dinesh,9999,0,9999,0
1668349862795,ECE 200,004,103589,Cheng; Chung Kuan,9999,0,9999,0
1668349862795,ECE 200,005,103590,Cosman; Pamela C.,9999,0,9999,0
1668349862795,ECE 200,006,103591,Dayeh; Shadi Ahmad,9999,0,9999,0
1668349862795,ECE 200,007,103592,Fainman; Yeshaiahu,9999,0,9999,0
1668349862795,ECE 200,008,103593,Ford; Joseph Earl,9999,0,9999,0
1668349862795,ECE 200,009,103594,Franceschetti; Massimo,9999,0,9999,0
1668349862795,ECE 200,010,103595,Fullerton; Eric E,9999,0,9999,0
1668349862795,ECE 200,011,103596,Galton; Ian A,9999,0,9999,0
1668349862795,ECE 200,012,103597,Gilja; Vikash,9999,0,9999,0
1668349862795,ECE 200,013,103598,Hall; Drew A.,9999,0,9999,0
1668349862795,ECE 200,014,103599,Hsueh; Tzu-Chien,9999,0,9999,0
1668349862795,ECE 200,015,103600,Javidi; Tara,9999,0,9999,0
1668349862795,ECE 200,016,103601,Kahng; Andrew Byun,9999,0,9999,0
1668349862795,ECE 200,017,103602,Kim; Young-Han,9999,0,9999,0
1668349862795,ECE 200,018,103603,Koushanfar; Farinaz,9999,0,9999,0
1668349862795,ECE 200,019,103604,Kuzum; Duygu,9999,0,9999,0
1668349862795,ECE 200,020,103605,Le; Hanh-Phuc,9999,0,9999,0
1668349862795,ECE 200,021,103606,Lin; Bill,9999,0,9999,0
1668349862795,ECE 200,022,103607,Liu; Zhaowei,9998,0,9999,1
1668349862795,ECE 200,023,103608,Lo; Yu-Hwa,9999,0,9999,0
1668349862795,ECE 200,024,103609,Lomakin; Vitaliy,9999,0,9999,0
1668349862795,ECE 200,025,103610,Mercier; Patrick Philip,9999,0,9999,0
1668349862795,ECE 200,026,103611,Meyer; Florian,9999,0,9999,0
1668349862795,ECE 200,027,103612,Milstein; Laurence B.,9999,0,9999,0
1668349862795,ECE 200,028,103613,Mir Arabbaygi; Siavash,9999,0,9999,0
1668349862795,ECE 200,029,103614,Mookherjea; Shayan,9999,0,9999,0
1668349862795,ECE 200,030,103615,Morris; Karcher William,9999,0,9999,0
1668349862795,ECE 200,031,103616,Ng; Tse Nga,9999,0,9999,0
1668349862795,ECE 200,032,103617,Nguyen; Truong Quang,9999,0,9999,0
1668349862795,ECE 200,033,103618,Nomura; Kenji,9999,0,9999,0
1668349862795,ECE 200,034,103619,Orlitsky; Alon,9999,0,9999,0
1668349862795,ECE 200,035,103620,Pal; Piya,9999,0,9999,0
1668349862795,ECE 200,036,103621,Papen; George C.,9999,0,9999,0
1668349862795,ECE 200,037,103622,Radic; Stojan,9999,0,9999,0
1668349862795,ECE 200,038,103623,Rao; Bhaskar D.,9999,0,9999,0
1668349862795,ECE 200,039,103624,Rao; Ramesh R,9999,0,9999,0
1668349862795,ECE 200,040,103625,Rebeiz; Gabriel,9999,0,9999,0
1668349862795,ECE 200,041,103626,Sanford; John R,9999,0,9999,0
1668349862795,ECE 200,042,103627,Siegel; Paul H.,9999,0,9999,0
1668349862795,ECE 200,043,103628,Sievenpiper; Daniel F.,9999,0,9999,0
1668349862795,ECE 200,044,103629,Sworder; David D.,9999,0,9999,0
1668349862795,ECE 200,045,103630,Taur; Yuan,9999,0,9999,0
1668349862795,ECE 200,046,103631,Touri; Behrouz,9999,0,9999,0
1668349862795,ECE 200,047,103632,Trivedi; Mohan M.,9999,0,9999,0
1668349862795,ECE 200,048,103633,Vasconcelos; Nuno,9999,0,9999,0
1668349862795,ECE 200,049,103634,Wang; Xiaolong,9999,0,9999,0
1668349862795,ECE 200,050,103635,Xie; Pengtao,9999,0,9999,0
1668349862795,ECE 200,051,103636,Yip; Michael,9999,0,9999,0
1668349862795,ECE 200,052,103637,Zeger; Kenneth A.,999,0,999,0
1668349862795,ECE 200,053,103638,Zhang; Xinyu,9999,0,9999,0
1668349862795,ECE 200,054,103639,Turakhia; Yatish Girish,9999,0,9999,0
1668349862795,ECE 200,055,103640,Kang; Mingu,9999,0,9999,0
1668349862795,ECE 200,056,103641,Shi; Yuanyuan,9999,0,9999,0
1668349862795,ECE 200,057,103642,Wang; Edward Jay,9999,0,9999,0
1668349862795,ECE 200,058,103643,Zheng; Yang,9999,0,9999,0
1668349863220,ECE 202,A00,103644,Kuzum; Duygu,0,0,0,0
1668349863646,ECE 212BN,A00,103646,Ng; Tse Nga,0,0,0,0
1668349864073,ECE 221,A00,111493,Staff,0,0,0,0
1668349864499,ECE 222B,A00,103647,Lomakin; Vitaliy,0,0,0,0
1668349865056,ECE 230B,A00,103648,Taur; Yuan,0,0,0,0
1668349865481,ECE 238B,A00,103649,Garay; Javier,0,0,0,0
1668349865904,ECE 240B,A00,112900,Fainman; Yeshaiahu,0,0,0,0
1668349866331,ECE 247A,A00,103650,Jokerst; Jesse Vincent,0,0,0,0
1668349866760,ECE 247B,A00,103651,Wang; Joseph,0,0,0,0
1668349867189,ECE 250,A00,103652,Siegel; Paul H.,0,0,0,0
1668349867624,ECE 251A,A00,103654,Rao; Bhaskar D.,0,0,0,0
1668349868048,ECE 257B,A00,103655,Bharadia; Dinesh,0,0,0,0
1668349868473,ECE 258A,A00,103656,Milstein; Laurence B.,0,0,0,0
1668349868898,ECE 260B,A00,103658,Kang; Mingu,0,0,0,0
1668349869325,ECE 264A,A00,103659,Galton; Ian A,0,0,0,0
1668349869749,ECE 265A,A00,103661,Gudem; Prasad S.S.,0,0,0,0
1668349870176,ECE 265D,A00,103662,Gudem; Prasad S.S.,0,0,0,0
1668349870604,ECE 268,A00,103663,Koushanfar; Farinaz,0,0,0,0
1668349871026,ECE 269,A01,103665,Pal; Piya,0,0,0,0
1668349871453,ECE 271B,A00,103666,Vasconcelos; Manuela,0,0,0,0
1668349871877,ECE 276A,A00,103667,Atanasov; Nikolay A.,0,0,0,0
1668349872301,ECE 277,A00,103668,An; Cheolhong,0,0,0,0
1668349872724,ECE 279,A00,117947,Hall; Drew A.,0,0,0,0
1668349873572,ECE 283,A00,103670,Hsueh; Tzu-Chien,0,0,0,0
1668349874001,ECE 284,A00,103671,Turakhia; Yatish Girish,0,0,0,0
1668349874428,ECE 285,A00,103672,Zheng; Yang,0,0,0,0
1668349874428,ECE 285,B00,103673,Sworder; David D.,0,0,0,0
1668349874853,ECE 287,A00,103676,Javidi; Tara,0,0,0,0
1668349875276,MATH 200B,A00,098023,Salehi Golsefidy; Alireza,12,0,15,3
1668349875705,MATH 202B,A00,098024,Rhoades; Brendon Patrick,9,0,15,6
1668349876135,MATH 203B,A00,098025,Oprea; Dragos N.,10,0,15,5
1668349876559,MATH 204B,A00,098026,Sorensen; Claus M,13,0,15,2
1668349876984,MATH 208,A00,098027,Izadi; Elham,7,0,10,3
1668349877410,MATH 209,A00,098028,Pollack; Aaron,10,0,10,0
1668349877840,MATH 211A,A00,112919,Rogalski; Daniel,9,0,10,1
1668349878263,MATH 211B,A00,112920,Seward; Brandon M.,9,0,10,1
1668349878690,MATH 218,A00,098029,Li; Bo,10,0,10,0
1668349879115,MATH 220B,A00,098030,Novak; Jonathan I,11,0,15,4
1668349879538,MATH 221A,A00,098031,Ebenfelt; Peter F,13,0,15,2
1668349879974,MATH 231B,A00,098032,Zlatos; Andrej,12,0,15,3
1668349880397,MATH 240B,A00,098033,Ni; Lei,9,0,15,6
1668349880824,MATH 243,A00,098034,Jekel; David Andrew,10,0,10,0
1668349881248,MATH 245A,A00,098035,Nie; Jiawang,0,0,15,16
1668349881673,MATH 248,A00,098036,Bejenaru; Ioan,10,0,10,0
1668349882095,MATH 250B,A00,098037,Spolaor; Luca,14,0,15,1
1668349882522,MATH 258,A00,098038,Ni; Lei,10,0,10,0
1668349882945,MATH 264B,A00,098041,Rhoades; Brendon Patrick,9,0,15,6
1668349883370,MATH 268,A00,098042,Buss; Samuel R,10,0,10,0
1668349883794,MATH 269,A00,098043,Rhoades; Brendon Patrick,10,0,10,0
1668349884217,MATH 270B,A00,098044,Li; Bo,10,0,15,5
1668349884640,MATH 272B,A00,098045,Holst; Michael J,13,0,15,2
1668349885066,MATH 273A,A00,098046,Tian; Xiaochuan,10,0,15,5
1668349885489,MATH 275,A01,098048,Tian; Xiaochuan,6,0,10,4
1668349885921,MATH 278A,A00,098049,Holst; Michael J,8,0,10,2
1668349886352,MATH 278B,A00,098050,Cloninger; Alexander,10,0,10,0
1668349886777,MATH 278C,A00,098051,Nie; Jiawang,7,0,10,3
1668349887223,MATH 280B,A00,098052,Zheng; Tianyi,8,0,15,7
1668349887649,MATH 281B,A00,098053,Bradic; Jelena,1,0,15,14
1668349888073,MATH 282B,A00,098054,Arias-Castro; Ery,0,0,15,15
1668349888498,MATH 285,A00,098055,Fitzsimmons; Patrick J,0,0,15,17
1668349888926,MATH 287B,A00,098056,Arias-Castro; Ery,2,0,15,13
1668349889362,MATH 288,A00,098057,Agarwal; Pooja,9,0,10,1
1668349889362,MATH 288,B00,098058,Zhang; Danna,8,0,10,2
1668349889362,MATH 288,C00,098059,Williams; Ruth J,9,0,10,1
1668349889817,MATH 290B,A00,098060,Roberts; Justin Deritter,13,0,15,2
1668349890248,MATH 292,A00,098061,Belmont; Eva Kinoshita,10,0,10,0
1668349890674,MATH 295,A00,098062,Suk; Andrew Hoon,48,0,50,2
1668349891098,MATH 296,A00,098063,Novak; Jonathan I,20,0,20,0
1668349891522,MATH 297,001,098064,Gamst; Anthony Collins,9997,0,9999,2
1668350392188,COGS 205,A00,101395,Chiba; Andrea,19,0,20,1
1668350392618,COGS 210B,001,101404,Greene; Deanna Jacquelyn,9998,0,9999,1
1668350392618,COGS 210B,002,101417,Xia; Haijun,9999,0,9999,0
1668350392618,COGS 210B,003,101422,Nitz; Douglas A.,9999,0,9999,0
1668350392618,COGS 210B,004,101423,Hollan; James D.,9998,0,9999,1
1668350392618,COGS 210B,005,101424,Deak; Gedeon O.,9998,0,9999,1
1668350392618,COGS 210B,006,101425,Rossano; Federico,9999,0,9999,0
1668350393041,COGS 211B,A00,101427,Coulson; Seana M,9996,0,9999,3
1668350393465,COGS 220,A00,101428,Hollan; James D.,0,0,25,25
1668350393889,COGS 229,A00,101429,Dow; Steven P,18,0,25,7
1668350394315,COGS 230,A00,101430,Klemmer; Scott R,11,0,17,6
1668350394740,COGS 234,A00,101431,Xia; Haijun,1,0,25,24
1668350395163,COGS 260,A00,101432,Kiyonaga; Anastasia,21,0,25,4
1668350395163,COGS 260,B00,101433,Kirsh; David Joel,15,0,25,10
1668350395590,CSE 202,A00,102371,Impagliazzo; Russell,0,0,0,0
1668350396014,CSE 203B,A01,102373,Cheng; Chung Kuan,0,0,0,0
1668350396441,CSE 208,A00,102374,Micciancio; Daniele,0,0,0,0
1668350396872,CSE 209A,A00,112895,Impagliazzo; Russell,0,0,15,15
1668350397297,CSE 209B,A00,108005,Bellare; Mihir,0,0,0,0
1668350397720,CSE 210,A00,113163,Coblenz; Michael J,0,0,0,0
1668350398144,CSE 219,A00,106111,Dow; Steven P,0,0,20,20
1668350398567,CSE 221,A00,102376,Voelker; Geoffrey M.,0,0,0,0
1668350399002,CSE 224,A01,102378,Porter; George M,0,0,0,0
1668350399433,CSE 229A,A00,102379,Savage; Stefan,0,0,0,0
1668350399868,CSE 229C,A00,102380,Munyaka; Imani N. S.,0,0,0,0
1668350400300,CSE 232B,A00,102382,Deutsch; Alin Bernard,0,0,0,0
1668350400743,CSE 234,A01,112904,Kumar; Arun Kumar,0,0,0,0
1668350401179,CSE 237A,A00,102383,Rosing; Tajana Simunic,0,0,0,0
1668350401603,CSE 239A,A00,102384,Deutsch; Alin Bernard,0,0,0,0
1668350402029,CSE 239B,A00,102385,Polikarpova; Nadezhda,0,0,0,0
1668350402452,CSE 240A,A00,102386,Pannuto; Patrick William,0,0,0,0
1668350402884,CSE 240B,A00,102387,Zhao; Jishen,0,0,0,0
1668350403308,CSE 241A,A00,106406,Kang; Mingu,0,0,0,0
1668350403732,CSE 249B,A00,102388,Kahng; Andrew Byun,0,0,8,8
1668350404157,CSE 251B,A01,102392,Cottrell; Garrison W,0,0,0,0
1668350404157,CSE 251B,A02,102393,Cottrell; Garrison W,0,0,0,0
1668350404585,CSE 252B,A00,102394,Ochoa; Benjamin Lawrence,0,0,0,0
1668350405011,CSE 257,A01,102396,Gao; Sicun,0,0,0,0
1668350405434,CSE 272,A00,102397,Li; Tzumao,0,0,0,0
1668350405863,CSE 274,A00,111323,Chern; Albert Ren-Haur,0,0,0,0
1668350406296,CSE 282,A00,102398,Pevzner; Pavel Arkadjevich,0,0,0,0
1668350406721,CSE 284,A00,114175,Gymrek; Melissa Ann,0,0,0,0
1668350407154,CSE 290,A00,102399,Chandraker; Manmohan Krishna,0,0,0,0
1668350407154,CSE 290,B00,102400,Vaccaro; Kristen Marie,0,0,25,25
1668350407154,CSE 290,C00,102414,Pannuto; Patrick William,0,0,25,25
1668350407154,CSE 290,D00,102427,Pevzner; Pavel Arkadjevich,0,0,0,0
1668350407154,CSE 290,E00,102429,Zhao; Jishen,0,0,0,0
1668350407154,CSE 290,F00,102436,Tullsen; Dean Michael,0,0,0,0
1668350407154,CSE 290,G00,102440,Christensen; Henrik I,0,0,20,20
1668350407591,CSE 291,A00,102443,Su; Hao,0,0,0,0
1668350407591,CSE 291,B00,102448,Polikarpova; Nadezhda,0,0,0,0
1668350407591,CSE 291,C00,102453,Vaccaro; Kristen Marie,0,0,0,0
1668350407591,CSE 291,D00,111343,Savage; Stefan,0,0,0,0
1668350407591,CSE 291,E00,116474,Claffy; Kimberly Claire,0,0,0,0
1668350407591,CSE 291,F00,116479,Pasquale; Joseph,0,0,0,0
1668350408017,CSE 293,001,119111,Bafna; Vineet,9999,0,9999,0
1668350408017,CSE 293,002,119118,Bellare; Mihir,9999,0,9999,0
1668350408017,CSE 293,003,119122,Berg-Kirkpatrick; Taylor D,9999,0,9999,0
1668350408017,CSE 293,004,119135,Christensen; Henrik I,9999,0,9999,0
1668350408017,CSE 293,005,119142,Cottrell; Garrison W,9999,0,9999,0
1668350408017,CSE 293,006,119146,Deutsch; Alin Bernard,9999,0,9999,0
1668350408017,CSE 293,007,119159,Esmaeilzadeh; Hadi,9999,0,9999,0
1668350408017,CSE 293,008,119166,Freund; Yoav,9999,0,9999,0
1668350408017,CSE 293,009,119170,Griswold; William G.,9999,0,9999,0
1668350408017,CSE 293,010,119183,Gymrek; Melissa Ann,9999,0,9999,0
1668350408017,CSE 293,011,119190,Heninger; Nadia A,9999,0,9999,0
1668350408017,CSE 293,012,119230,Impagliazzo; Russell,9999,0,9999,0
1668350408017,CSE 293,013,119232,Jhala; Ranjit,9999,0,9999,0
1668350408017,CSE 293,014,119233,Kahng; Andrew Byun,9999,0,9999,0
1668350408017,CSE 293,015,119298,Kane; Daniel Mertz,9999,0,9999,0
1668350408017,CSE 293,016,119299,Kriegman; David J,9999,0,9999,0
1668350408017,CSE 293,017,119300,Kumar; Arun Kumar,9999,0,9999,0
1668350408017,CSE 293,018,119301,Lerner; Sorin,9999,0,9999,0
1668350408017,CSE 293,019,119302,Lovett; Shachar,9999,0,9999,0
1668350408017,CSE 293,020,119303,McAuley; Julian John,9999,0,9999,0
1668350408017,CSE 293,021,119304,Micciancio; Daniele,9999,0,9999,0
1668350408017,CSE 293,022,119367,Orailoglu; Alex,9999,0,9999,0
1668350408017,CSE 293,023,119382,Paturi; Ramamohan,9999,0,9999,0
1668350408017,CSE 293,024,119404,Polikarpova; Nadezhda,9999,0,9999,0
1668350408017,CSE 293,025,119406,Politz; Joseph Gibbs,9999,0,9999,0
1668350408017,CSE 293,026,119411,Porter; George M,9999,0,9999,0
1668350408017,CSE 293,027,119414,Porter; Leonard Emerson,9999,0,9999,0
1668350408017,CSE 293,028,119416,Ramamoorthi; Ravi,9999,0,9999,0
1668350408017,CSE 293,029,119417,Sahoo; Debashis,9999,0,9999,0
1668350408017,CSE 293,030,119420,Saul; Lawrence,9999,0,9999,0
1668350408017,CSE 293,031,119421,Savage; Stefan,9999,0,9999,0
1668350408017,CSE 293,032,119425,Schulze; Jurgen P.,9999,0,9999,0
1668350408017,CSE 293,033,119426,Snoeren; Alex C.,9999,0,9999,0
1668350408017,CSE 293,034,119428,Shang; Jingbo,9999,0,9999,0
1668350408017,CSE 293,035,119430,Stefan; Deian,9999,0,9999,0
1668350408017,CSE 293,036,119431,Su; Hao,9999,0,9999,0
1668350408017,CSE 293,037,119433,Swanson; Steven James,9999,0,9999,0
1668350408017,CSE 293,038,119435,Tullsen; Dean Michael,9999,0,9999,0
1668350408017,CSE 293,039,119483,Voelker; Geoffrey M.,9999,0,9999,0
1668350408017,CSE 293,040,119537,Zhao; Jishen,9999,0,9999,0
1668350408017,CSE 293,041,119538,Zhou; Yuan-Yuan,9999,0,9999,0
1668350408017,CSE 293,042,119539,Gao; Sicun,9999,0,9999,0
1668350408017,CSE 293,043,119540,Weibel; Nadir,9999,0,9999,0
1668350408017,CSE 293,044,119541,Gupta; Rajesh K.,9999,0,9999,0
1668350408017,CSE 293,045,126410,Vaccaro; Kristen Marie,9999,0,9999,0
1668350408017,CSE 293,046,126411,Klemke; Richard,9999,0,9999,0
1668350408442,CSE 294,A00,102459,Voelker; Geoffrey M.,0,0,0,0
1668350408442,CSE 294,B00,111322,Orailoglu; Alex,0,0,0,0
1668350408868,DSE 201,A00,096914,Deutsch; Alin Bernard,30,0,30,0
1668350409291,DSE 210,A00,096915,Dasgupta; Sanjoy,30,0,30,0
1668350409717,DSE 260A,A00,096916,Altintas De Callaf; Ilkay,30,0,30,0
1668350410145,ECE 200,001,103586,Antipa; Nicholas A,9999,0,9999,0
1668350410145,ECE 200,002,103587,Atanasov; Nikolay A.,9999,0,9999,0
1668350410145,ECE 200,003,103588,Bharadia; Dinesh,9999,0,9999,0
1668350410145,ECE 200,004,103589,Cheng; Chung Kuan,9999,0,9999,0
1668350410145,ECE 200,005,103590,Cosman; Pamela C.,9999,0,9999,0
1668350410145,ECE 200,006,103591,Dayeh; Shadi Ahmad,9999,0,9999,0
1668350410145,ECE 200,007,103592,Fainman; Yeshaiahu,9999,0,9999,0
1668350410145,ECE 200,008,103593,Ford; Joseph Earl,9999,0,9999,0
1668350410145,ECE 200,009,103594,Franceschetti; Massimo,9999,0,9999,0
1668350410145,ECE 200,010,103595,Fullerton; Eric E,9999,0,9999,0
1668350410145,ECE 200,011,103596,Galton; Ian A,9999,0,9999,0
1668350410145,ECE 200,012,103597,Gilja; Vikash,9999,0,9999,0
1668350410145,ECE 200,013,103598,Hall; Drew A.,9999,0,9999,0
1668350410145,ECE 200,014,103599,Hsueh; Tzu-Chien,9999,0,9999,0
1668350410145,ECE 200,015,103600,Javidi; Tara,9999,0,9999,0
1668350410145,ECE 200,016,103601,Kahng; Andrew Byun,9999,0,9999,0
1668350410145,ECE 200,017,103602,Kim; Young-Han,9999,0,9999,0
1668350410145,ECE 200,018,103603,Koushanfar; Farinaz,9999,0,9999,0
1668350410145,ECE 200,019,103604,Kuzum; Duygu,9999,0,9999,0
1668350410145,ECE 200,020,103605,Le; Hanh-Phuc,9999,0,9999,0
1668350410145,ECE 200,021,103606,Lin; Bill,9999,0,9999,0
1668350410145,ECE 200,022,103607,Liu; Zhaowei,9998,0,9999,1
1668350410145,ECE 200,023,103608,Lo; Yu-Hwa,9999,0,9999,0
1668350410145,ECE 200,024,103609,Lomakin; Vitaliy,9999,0,9999,0
1668350410145,ECE 200,025,103610,Mercier; Patrick Philip,9999,0,9999,0
1668350410145,ECE 200,026,103611,Meyer; Florian,9999,0,9999,0
1668350410145,ECE 200,027,103612,Milstein; Laurence B.,9999,0,9999,0
1668350410145,ECE 200,028,103613,Mir Arabbaygi; Siavash,9999,0,9999,0
1668350410145,ECE 200,029,103614,Mookherjea; Shayan,9999,0,9999,0
1668350410145,ECE 200,030,103615,Morris; Karcher William,9999,0,9999,0
1668350410145,ECE 200,031,103616,Ng; Tse Nga,9999,0,9999,0
1668350410145,ECE 200,032,103617,Nguyen; Truong Quang,9999,0,9999,0
1668350410145,ECE 200,033,103618,Nomura; Kenji,9999,0,9999,0
1668350410145,ECE 200,034,103619,Orlitsky; Alon,9999,0,9999,0
1668350410145,ECE 200,035,103620,Pal; Piya,9999,0,9999,0
1668350410145,ECE 200,036,103621,Papen; George C.,9999,0,9999,0
1668350410145,ECE 200,037,103622,Radic; Stojan,9999,0,9999,0
1668350410145,ECE 200,038,103623,Rao; Bhaskar D.,9999,0,9999,0
1668350410145,ECE 200,039,103624,Rao; Ramesh R,9999,0,9999,0
1668350410145,ECE 200,040,103625,Rebeiz; Gabriel,9999,0,9999,0
1668350410145,ECE 200,041,103626,Sanford; John R,9999,0,9999,0
1668350410145,ECE 200,042,103627,Siegel; Paul H.,9999,0,9999,0
1668350410145,ECE 200,043,103628,Sievenpiper; Daniel F.,9999,0,9999,0
1668350410145,ECE 200,044,103629,Sworder; David D.,9999,0,9999,0
1668350410145,ECE 200,045,103630,Taur; Yuan,9999,0,9999,0
1668350410145,ECE 200,046,103631,Touri; Behrouz,9999,0,9999,0
1668350410145,ECE 200,047,103632,Trivedi; Mohan M.,9999,0,9999,0
1668350410145,ECE 200,048,103633,Vasconcelos; Nuno,9999,0,9999,0
1668350410145,ECE 200,049,103634,Wang; Xiaolong,9999,0,9999,0
1668350410145,ECE 200,050,103635,Xie; Pengtao,9999,0,9999,0
1668350410145,ECE 200,051,103636,Yip; Michael,9999,0,9999,0
1668350410145,ECE 200,052,103637,Zeger; Kenneth A.,999,0,999,0
1668350410145,ECE 200,053,103638,Zhang; Xinyu,9999,0,9999,0
1668350410145,ECE 200,054,103639,Turakhia; Yatish Girish,9999,0,9999,0
1668350410145,ECE 200,055,103640,Kang; Mingu,9999,0,9999,0
1668350410145,ECE 200,056,103641,Shi; Yuanyuan,9999,0,9999,0
1668350410145,ECE 200,057,103642,Wang; Edward Jay,9999,0,9999,0
1668350410145,ECE 200,058,103643,Zheng; Yang,9999,0,9999,0
1668350410592,ECE 202,A00,103644,Kuzum; Duygu,0,0,0,0
1668350411034,ECE 212BN,A00,103646,Ng; Tse Nga,0,0,0,0
1668350411458,ECE 221,A00,111493,Staff,0,0,0,0
1668350411882,ECE 222B,A00,103647,Lomakin; Vitaliy,0,0,0,0
1668350412308,ECE 230B,A00,103648,Taur; Yuan,0,0,0,0
1668350412738,ECE 238B,A00,103649,Garay; Javier,0,0,0,0
1668350413176,ECE 240B,A00,112900,Fainman; Yeshaiahu,0,0,0,0
1668350413604,ECE 247A,A00,103650,Jokerst; Jesse Vincent,0,0,0,0
1668350414044,ECE 247B,A00,103651,Wang; Joseph,0,0,0,0
1668350414480,ECE 250,A00,103652,Siegel; Paul H.,0,0,0,0
1668350414906,ECE 251A,A00,103654,Rao; Bhaskar D.,0,0,0,0
1668350415329,ECE 257B,A00,103655,Bharadia; Dinesh,0,0,0,0
1668350415766,ECE 258A,A00,103656,Milstein; Laurence B.,0,0,0,0
1668350416190,ECE 260B,A00,103658,Kang; Mingu,0,0,0,0
1668350416614,ECE 264A,A00,103659,Galton; Ian A,0,0,0,0
1668350417045,ECE 265A,A00,103661,Gudem; Prasad S.S.,0,0,0,0
1668350417468,ECE 265D,A00,103662,Gudem; Prasad S.S.,0,0,0,0
1668350417892,ECE 268,A00,103663,Koushanfar; Farinaz,0,0,0,0
1668350418316,ECE 269,A01,103665,Pal; Piya,0,0,0,0
1668350418743,ECE 271B,A00,103666,Vasconcelos; Manuela,0,0,0,0
1668350419172,ECE 276A,A00,103667,Atanasov; Nikolay A.,0,0,0,0
1668350419602,ECE 277,A00,103668,An; Cheolhong,0,0,0,0
1668350420055,ECE 279,A00,117947,Hall; Drew A.,0,0,0,0
1668350420934,ECE 283,A00,103670,Hsueh; Tzu-Chien,0,0,0,0
1668350421369,ECE 284,A00,103671,Turakhia; Yatish Girish,0,0,0,0
1668350421797,ECE 285,A00,103672,Zheng; Yang,0,0,0,0
1668350421797,ECE 285,B00,103673,Sworder; David D.,0,0,0,0
1668350422218,ECE 287,A00,103676,Javidi; Tara,0,0,0,0
1668350422642,MATH 200B,A00,098023,Salehi Golsefidy; Alireza,12,0,15,3
1668350423069,MATH 202B,A00,098024,Rhoades; Brendon Patrick,9,0,15,6
1668350423493,MATH 203B,A00,098025,Oprea; Dragos N.,10,0,15,5
1668350423918,MATH 204B,A00,098026,Sorensen; Claus M,13,0,15,2
1668350424342,MATH 208,A00,098027,Izadi; Elham,7,0,10,3
1668350424769,MATH 209,A00,098028,Pollack; Aaron,10,0,10,0
1668350425194,MATH 211A,A00,112919,Rogalski; Daniel,9,0,10,1
1668350425620,MATH 211B,A00,112920,Seward; Brandon M.,9,0,10,1
1668350426044,MATH 218,A00,098029,Li; Bo,10,0,10,0
1668350426471,MATH 220B,A00,098030,Novak; Jonathan I,11,0,15,4
1668350426898,MATH 221A,A00,098031,Ebenfelt; Peter F,13,0,15,2
1668350427321,MATH 231B,A00,098032,Zlatos; Andrej,12,0,15,3
1668350427743,MATH 240B,A00,098033,Ni; Lei,9,0,15,6
1668350428168,MATH 243,A00,098034,Jekel; David Andrew,10,0,10,0
1668350428596,MATH 245A,A00,098035,Nie; Jiawang,0,0,15,16
1668350429128,MATH 248,A00,098036,Bejenaru; Ioan,10,0,10,0
1668350429552,MATH 250B,A00,098037,Spolaor; Luca,14,0,15,1
1668350429979,MATH 258,A00,098038,Ni; Lei,10,0,10,0
1668350430409,MATH 264B,A00,098041,Rhoades; Brendon Patrick,9,0,15,6
1668350430833,MATH 268,A00,098042,Buss; Samuel R,10,0,10,0
1668350431269,MATH 269,A00,098043,Rhoades; Brendon Patrick,10,0,10,0
1668350431693,MATH 270B,A00,098044,Li; Bo,10,0,15,5
1668350432117,MATH 272B,A00,098045,Holst; Michael J,13,0,15,2
1668350432553,MATH 273A,A00,098046,Tian; Xiaochuan,10,0,15,5
1668350432992,MATH 275,A01,098048,Tian; Xiaochuan,6,0,10,4
1668350433426,MATH 278A,A00,098049,Holst; Michael J,8,0,10,2
1668350433849,MATH 278B,A00,098050,Cloninger; Alexander,10,0,10,0
1668350434286,MATH 278C,A00,098051,Nie; Jiawang,7,0,10,3
1668350434710,MATH 280B,A00,098052,Zheng; Tianyi,8,0,15,7
1668350435135,MATH 281B,A00,098053,Bradic; Jelena,1,0,15,14
1668350435562,MATH 282B,A00,098054,Arias-Castro; Ery,0,0,15,15
1668350435989,MATH 285,A00,098055,Fitzsimmons; Patrick J,0,0,15,17
1668350436417,MATH 287B,A00,098056,Arias-Castro; Ery,2,0,15,13
1668350436848,MATH 288,A00,098057,Agarwal; Pooja,9,0,10,1
1668350436848,MATH 288,B00,098058,Zhang; Danna,8,0,10,2
1668350436848,MATH 288,C00,098059,Williams; Ruth J,9,0,10,1
1668350437286,MATH 290B,A00,098060,Roberts; Justin Deritter,13,0,15,2
1668350437717,MATH 292,A00,098061,Belmont; Eva Kinoshita,10,0,10,0
1668350438145,MATH 295,A00,098062,Suk; Andrew Hoon,48,0,50,2
1668350438569,MATH 296,A00,098063,Novak; Jonathan I,20,0,20,0
1668350439007,MATH 297,001,098064,Gamst; Anthony Collins,9997,0,9999,2
1668350939297,COGS 205,A00,101395,Chiba; Andrea,19,0,20,1
1668350939723,COGS 210B,001,101404,Greene; Deanna Jacquelyn,9998,0,9999,1
1668350939723,COGS 210B,002,101417,Xia; Haijun,9999,0,9999,0
1668350939723,COGS 210B,003,101422,Nitz; Douglas A.,9999,0,9999,0
1668350939723,COGS 210B,004,101423,Hollan; James D.,9998,0,9999,1
1668350939723,COGS 210B,005,101424,Deak; Gedeon O.,9998,0,9999,1
1668350939723,COGS 210B,006,101425,Rossano; Federico,9999,0,9999,0
1668350940154,COGS 211B,A00,101427,Coulson; Seana M,9996,0,9999,3
1668350940579,COGS 220,A00,101428,Hollan; James D.,0,0,25,25
1668350941004,COGS 229,A00,101429,Dow; Steven P,18,0,25,7
1668350941426,COGS 230,A00,101430,Klemmer; Scott R,11,0,17,6
1668350941866,COGS 234,A00,101431,Xia; Haijun,1,0,25,24
1668350942304,COGS 260,A00,101432,Kiyonaga; Anastasia,21,0,25,4
1668350942304,COGS 260,B00,101433,Kirsh; David Joel,15,0,25,10
1668350942734,CSE 202,A00,102371,Impagliazzo; Russell,0,0,0,0
1668350943158,CSE 203B,A01,102373,Cheng; Chung Kuan,0,0,0,0
1668350943582,CSE 208,A00,102374,Micciancio; Daniele,0,0,0,0
1668350944006,CSE 209A,A00,112895,Impagliazzo; Russell,0,0,15,15
1668350944432,CSE 209B,A00,108005,Bellare; Mihir,0,0,0,0
1668350944860,CSE 210,A00,113163,Coblenz; Michael J,0,0,0,0
1668350945284,CSE 219,A00,106111,Dow; Steven P,0,0,20,20
1668350945710,CSE 221,A00,102376,Voelker; Geoffrey M.,0,0,0,0
1668350946131,CSE 224,A01,102378,Porter; George M,0,0,0,0
1668350946554,CSE 229A,A00,102379,Savage; Stefan,0,0,0,0
1668350946977,CSE 229C,A00,102380,Munyaka; Imani N. S.,0,0,0,0
1668350947404,CSE 232B,A00,102382,Deutsch; Alin Bernard,0,0,0,0
1668350947831,CSE 234,A01,112904,Kumar; Arun Kumar,0,0,0,0
1668350948257,CSE 237A,A00,102383,Rosing; Tajana Simunic,0,0,0,0
1668350948683,CSE 239A,A00,102384,Deutsch; Alin Bernard,0,0,0,0
1668350949106,CSE 239B,A00,102385,Polikarpova; Nadezhda,0,0,0,0
1668350949604,CSE 240A,A00,102386,Pannuto; Patrick William,0,0,0,0
1668350950027,CSE 240B,A00,102387,Zhao; Jishen,0,0,0,0
1668350950455,CSE 241A,A00,106406,Kang; Mingu,0,0,0,0
1668350950877,CSE 249B,A00,102388,Kahng; Andrew Byun,0,0,8,8
1668350951305,CSE 251B,A01,102392,Cottrell; Garrison W,0,0,0,0
1668350951305,CSE 251B,A02,102393,Cottrell; Garrison W,0,0,0,0
1668350951728,CSE 252B,A00,102394,Ochoa; Benjamin Lawrence,0,0,0,0
1668350952151,CSE 257,A01,102396,Gao; Sicun,0,0,0,0
1668350952576,CSE 272,A00,102397,Li; Tzumao,0,0,0,0
1668350953002,CSE 274,A00,111323,Chern; Albert Ren-Haur,0,0,0,0
1668350953424,CSE 282,A00,102398,Pevzner; Pavel Arkadjevich,0,0,0,0
1668350953851,CSE 284,A00,114175,Gymrek; Melissa Ann,0,0,0,0
1668350954273,CSE 290,A00,102399,Chandraker; Manmohan Krishna,0,0,0,0
1668350954273,CSE 290,B00,102400,Vaccaro; Kristen Marie,0,0,25,25
1668350954273,CSE 290,C00,102414,Pannuto; Patrick William,0,0,25,25
1668350954273,CSE 290,D00,102427,Pevzner; Pavel Arkadjevich,0,0,0,0
1668350954273,CSE 290,E00,102429,Zhao; Jishen,0,0,0,0
1668350954273,CSE 290,F00,102436,Tullsen; Dean Michael,0,0,0,0
1668350954273,CSE 290,G00,102440,Christensen; Henrik I,0,0,20,20
1668350954697,CSE 291,A00,102443,Su; Hao,0,0,0,0
1668350954697,CSE 291,B00,102448,Polikarpova; Nadezhda,0,0,0,0
1668350954697,CSE 291,C00,102453,Vaccaro; Kristen Marie,0,0,0,0
1668350954697,CSE 291,D00,111343,Savage; Stefan,0,0,0,0
1668350954697,CSE 291,E00,116474,Claffy; Kimberly Claire,0,0,0,0
1668350954697,CSE 291,F00,116479,Pasquale; Joseph,0,0,0,0
1668350955125,CSE 293,001,119111,Bafna; Vineet,9999,0,9999,0
1668350955125,CSE 293,002,119118,Bellare; Mihir,9999,0,9999,0
1668350955125,CSE 293,003,119122,Berg-Kirkpatrick; Taylor D,9999,0,9999,0
1668350955125,CSE 293,004,119135,Christensen; Henrik I,9999,0,9999,0
1668350955125,CSE 293,005,119142,Cottrell; Garrison W,9999,0,9999,0
1668350955125,CSE 293,006,119146,Deutsch; Alin Bernard,9999,0,9999,0
1668350955125,CSE 293,007,119159,Esmaeilzadeh; Hadi,9999,0,9999,0
1668350955125,CSE 293,008,119166,Freund; Yoav,9999,0,9999,0
1668350955125,CSE 293,009,119170,Griswold; William G.,9999,0,9999,0
1668350955125,CSE 293,010,119183,Gymrek; Melissa Ann,9999,0,9999,0
1668350955125,CSE 293,011,119190,Heninger; Nadia A,9999,0,9999,0
1668350955125,CSE 293,012,119230,Impagliazzo; Russell,9999,0,9999,0
1668350955125,CSE 293,013,119232,Jhala; Ranjit,9999,0,9999,0
1668350955125,CSE 293,014,119233,Kahng; Andrew Byun,9999,0,9999,0
1668350955125,CSE 293,015,119298,Kane; Daniel Mertz,9999,0,9999,0
1668350955125,CSE 293,016,119299,Kriegman; David J,9999,0,9999,0
1668350955125,CSE 293,017,119300,Kumar; Arun Kumar,9999,0,9999,0
1668350955125,CSE 293,018,119301,Lerner; Sorin,9999,0,9999,0
1668350955125,CSE 293,019,119302,Lovett; Shachar,9999,0,9999,0
1668350955125,CSE 293,020,119303,McAuley; Julian John,9999,0,9999,0
1668350955125,CSE 293,021,119304,Micciancio; Daniele,9999,0,9999,0
1668350955125,CSE 293,022,119367,Orailoglu; Alex,9999,0,9999,0
1668350955125,CSE 293,023,119382,Paturi; Ramamohan,9999,0,9999,0
1668350955125,CSE 293,024,119404,Polikarpova; Nadezhda,9999,0,9999,0
1668350955125,CSE 293,025,119406,Politz; Joseph Gibbs,9999,0,9999,0
1668350955125,CSE 293,026,119411,Porter; George M,9999,0,9999,0
1668350955125,CSE 293,027,119414,Porter; Leonard Emerson,9999,0,9999,0
1668350955125,CSE 293,028,119416,Ramamoorthi; Ravi,9999,0,9999,0
1668350955125,CSE 293,029,119417,Sahoo; Debashis,9999,0,9999,0
1668350955125,CSE 293,030,119420,Saul; Lawrence,9999,0,9999,0
1668350955125,CSE 293,031,119421,Savage; Stefan,9999,0,9999,0
1668350955125,CSE 293,032,119425,Schulze; Jurgen P.,9999,0,9999,0
1668350955125,CSE 293,033,119426,Snoeren; Alex C.,9999,0,9999,0
1668350955125,CSE 293,034,119428,Shang; Jingbo,9999,0,9999,0
1668350955125,CSE 293,035,119430,Stefan; Deian,9999,0,9999,0
1668350955125,CSE 293,036,119431,Su; Hao,9999,0,9999,0
1668350955125,CSE 293,037,119433,Swanson; Steven James,9999,0,9999,0
1668350955125,CSE 293,038,119435,Tullsen; Dean Michael,9999,0,9999,0
1668350955125,CSE 293,039,119483,Voelker; Geoffrey M.,9999,0,9999,0
1668350955125,CSE 293,040,119537,Zhao; Jishen,9999,0,9999,0
1668350955125,CSE 293,041,119538,Zhou; Yuan-Yuan,9999,0,9999,0
1668350955125,CSE 293,042,119539,Gao; Sicun,9999,0,9999,0
1668350955125,CSE 293,043,119540,Weibel; Nadir,9999,0,9999,0
1668350955125,CSE 293,044,119541,Gupta; Rajesh K.,9999,0,9999,0
1668350955125,CSE 293,045,126410,Vaccaro; Kristen Marie,9999,0,9999,0
1668350955125,CSE 293,046,126411,Klemke; Richard,9999,0,9999,0
1668350955551,CSE 294,A00,102459,Voelker; Geoffrey M.,0,0,0,0
1668350955551,CSE 294,B00,111322,Orailoglu; Alex,0,0,0,0
1668350955977,DSE 201,A00,096914,Deutsch; Alin Bernard,30,0,30,0
1668350956402,DSE 210,A00,096915,Dasgupta; Sanjoy,30,0,30,0
1668350956830,DSE 260A,A00,096916,Altintas De Callaf; Ilkay,30,0,30,0
1668350957263,ECE 200,001,103586,Antipa; Nicholas A,9999,0,9999,0
1668350957263,ECE 200,002,103587,Atanasov; Nikolay A.,9999,0,9999,0
1668350957263,ECE 200,003,103588,Bharadia; Dinesh,9999,0,9999,0
1668350957263,ECE 200,004,103589,Cheng; Chung Kuan,9999,0,9999,0
1668350957263,ECE 200,005,103590,Cosman; Pamela C.,9999,0,9999,0
1668350957263,ECE 200,006,103591,Dayeh; Shadi Ahmad,9999,0,9999,0
1668350957263,ECE 200,007,103592,Fainman; Yeshaiahu,9999,0,9999,0
1668350957263,ECE 200,008,103593,Ford; Joseph Earl,9999,0,9999,0
1668350957263,ECE 200,009,103594,Franceschetti; Massimo,9999,0,9999,0
1668350957263,ECE 200,010,103595,Fullerton; Eric E,9999,0,9999,0
1668350957263,ECE 200,011,103596,Galton; Ian A,9999,0,9999,0
1668350957263,ECE 200,012,103597,Gilja; Vikash,9999,0,9999,0
1668350957263,ECE 200,013,103598,Hall; Drew A.,9999,0,9999,0
1668350957263,ECE 200,014,103599,Hsueh; Tzu-Chien,9999,0,9999,0
1668350957263,ECE 200,015,103600,Javidi; Tara,9999,0,9999,0
1668350957263,ECE 200,016,103601,Kahng; Andrew Byun,9999,0,9999,0
1668350957263,ECE 200,017,103602,Kim; Young-Han,9999,0,9999,0
1668350957263,ECE 200,018,103603,Koushanfar; Farinaz,9999,0,9999,0
1668350957263,ECE 200,019,103604,Kuzum; Duygu,9999,0,9999,0
1668350957263,ECE 200,020,103605,Le; Hanh-Phuc,9999,0,9999,0
1668350957263,ECE 200,021,103606,Lin; Bill,9999,0,9999,0
1668350957263,ECE 200,022,103607,Liu; Zhaowei,9998,0,9999,1
1668350957263,ECE 200,023,103608,Lo; Yu-Hwa,9999,0,9999,0
1668350957263,ECE 200,024,103609,Lomakin; Vitaliy,9999,0,9999,0
1668350957263,ECE 200,025,103610,Mercier; Patrick Philip,9999,0,9999,0
1668350957263,ECE 200,026,103611,Meyer; Florian,9999,0,9999,0
1668350957263,ECE 200,027,103612,Milstein; Laurence B.,9999,0,9999,0
1668350957263,ECE 200,028,103613,Mir Arabbaygi; Siavash,9999,0,9999,0
1668350957263,ECE 200,029,103614,Mookherjea; Shayan,9999,0,9999,0
1668350957263,ECE 200,030,103615,Morris; Karcher William,9999,0,9999,0
1668350957263,ECE 200,031,103616,Ng; Tse Nga,9999,0,9999,0
1668350957263,ECE 200,032,103617,Nguyen; Truong Quang,9999,0,9999,0
1668350957263,ECE 200,033,103618,Nomura; Kenji,9999,0,9999,0
1668350957263,ECE 200,034,103619,Orlitsky; Alon,9999,0,9999,0
1668350957263,ECE 200,035,103620,Pal; Piya,9999,0,9999,0
1668350957263,ECE 200,036,103621,Papen; George C.,9999,0,9999,0
1668350957263,ECE 200,037,103622,Radic; Stojan,9999,0,9999,0
1668350957263,ECE 200,038,103623,Rao; Bhaskar D.,9999,0,9999,0
1668350957263,ECE 200,039,103624,Rao; Ramesh R,9999,0,9999,0
1668350957263,ECE 200,040,103625,Rebeiz; Gabriel,9999,0,9999,0
1668350957263,ECE 200,041,103626,Sanford; John R,9999,0,9999,0
1668350957263,ECE 200,042,103627,Siegel; Paul H.,9999,0,9999,0
1668350957263,ECE 200,043,103628,Sievenpiper; Daniel F.,9999,0,9999,0
1668350957263,ECE 200,044,103629,Sworder; David D.,9999,0,9999,0
1668350957263,ECE 200,045,103630,Taur; Yuan,9999,0,9999,0
1668350957263,ECE 200,046,103631,Touri; Behrouz,9999,0,9999,0
1668350957263,ECE 200,047,103632,Trivedi; Mohan M.,9999,0,9999,0
1668350957263,ECE 200,048,103633,Vasconcelos; Nuno,9999,0,9999,0
1668350957263,ECE 200,049,103634,Wang; Xiaolong,9999,0,9999,0
1668350957263,ECE 200,050,103635,Xie; Pengtao,9999,0,9999,0
1668350957263,ECE 200,051,103636,Yip; Michael,9999,0,9999,0
1668350957263,ECE 200,052,103637,Zeger; Kenneth A.,999,0,999,0
1668350957263,ECE 200,053,103638,Zhang; Xinyu,9999,0,9999,0
1668350957263,ECE 200,054,103639,Turakhia; Yatish Girish,9999,0,9999,0
1668350957263,ECE 200,055,103640,Kang; Mingu,9999,0,9999,0
1668350957263,ECE 200,056,103641,Shi; Yuanyuan,9999,0,9999,0
1668350957263,ECE 200,057,103642,Wang; Edward Jay,9999,0,9999,0
1668350957263,ECE 200,058,103643,Zheng; Yang,9999,0,9999,0
1668350957696,ECE 202,A00,103644,Kuzum; Duygu,0,0,0,0
1668350958122,ECE 212BN,A00,103646,Ng; Tse Nga,0,0,0,0
1668350958545,ECE 221,A00,111493,Staff,0,0,0,0
1668350958972,ECE 222B,A00,103647,Lomakin; Vitaliy,0,0,0,0
1668350959396,ECE 230B,A00,103648,Taur; Yuan,0,0,0,0
1668350959820,ECE 238B,A00,103649,Garay; Javier,0,0,0,0
1668350960243,ECE 240B,A00,112900,Fainman; Yeshaiahu,0,0,0,0
1668350960668,ECE 247A,A00,103650,Jokerst; Jesse Vincent,0,0,0,0
1668350961093,ECE 247B,A00,103651,Wang; Joseph,0,0,0,0
1668350961520,ECE 250,A00,103652,Siegel; Paul H.,0,0,0,0
1668350961943,ECE 251A,A00,103654,Rao; Bhaskar D.,0,0,0,0
1668350962366,ECE 257B,A00,103655,Bharadia; Dinesh,0,0,0,0
1668350962796,ECE 258A,A00,103656,Milstein; Laurence B.,0,0,0,0
1668350963222,ECE 260B,A00,103658,Kang; Mingu,0,0,0,0
1668350963649,ECE 264A,A00,103659,Galton; Ian A,0,0,0,0
1668350964075,ECE 265A,A00,103661,Gudem; Prasad S.S.,0,0,0,0
1668350964501,ECE 265D,A00,103662,Gudem; Prasad S.S.,0,0,0,0
1668350964924,ECE 268,A00,103663,Koushanfar; Farinaz,0,0,0,0
1668350965361,ECE 269,A01,103665,Pal; Piya,0,0,0,0
1668350965783,ECE 271B,A00,103666,Vasconcelos; Manuela,0,0,0,0
1668350966210,ECE 276A,A00,103667,Atanasov; Nikolay A.,0,0,0,0
1668350966634,ECE 277,A00,103668,An; Cheolhong,0,0,0,0
1668350967061,ECE 279,A00,117947,Hall; Drew A.,0,0,0,0
1668350967913,ECE 283,A00,103670,Hsueh; Tzu-Chien,0,0,0,0
1668350968336,ECE 284,A00,103671,Turakhia; Yatish Girish,0,0,0,0
1668350968759,ECE 285,A00,103672,Zheng; Yang,0,0,0,0
1668350968759,ECE 285,B00,103673,Sworder; David D.,0,0,0,0
1668350969185,ECE 287,A00,103676,Javidi; Tara,0,0,0,0
1668350969609,MATH 200B,A00,098023,Salehi Golsefidy; Alireza,12,0,15,3
1668350970034,MATH 202B,A00,098024,Rhoades; Brendon Patrick,9,0,15,6
1668350970468,MATH 203B,A00,098025,Oprea; Dragos N.,10,0,15,5
1668350970892,MATH 204B,A00,098026,Sorensen; Claus M,13,0,15,2
1668350971320,MATH 208,A00,098027,Izadi; Elham,7,0,10,3
1668350971743,MATH 209,A00,098028,Pollack; Aaron,10,0,10,0
1668350972165,MATH 211A,A00,112919,Rogalski; Daniel,9,0,10,1
1668350972588,MATH 211B,A00,112920,Seward; Brandon M.,9,0,10,1
1668350973015,MATH 218,A00,098029,Li; Bo,10,0,10,0
1668350973453,MATH 220B,A00,098030,Novak; Jonathan I,11,0,15,4
1668350973878,MATH 221A,A00,098031,Ebenfelt; Peter F,13,0,15,2
1668350974305,MATH 231B,A00,098032,Zlatos; Andrej,12,0,15,3
1668350974731,MATH 240B,A00,098033,Ni; Lei,9,0,15,6
1668350975158,MATH 243,A00,098034,Jekel; David Andrew,10,0,10,0
1668350975583,MATH 245A,A00,098035,Nie; Jiawang,0,0,15,16
1668350976007,MATH 248,A00,098036,Bejenaru; Ioan,10,0,10,0
1668350976433,MATH 250B,A00,098037,Spolaor; Luca,14,0,15,1
1668350976858,MATH 258,A00,098038,Ni; Lei,10,0,10,0
1668350977282,MATH 264B,A00,098041,Rhoades; Brendon Patrick,9,0,15,6
1668350977709,MATH 268,A00,098042,Buss; Samuel R,10,0,10,0
1668350978141,MATH 269,A00,098043,Rhoades; Brendon Patrick,10,0,10,0
1668350978565,MATH 270B,A00,098044,Li; Bo,10,0,15,5
1668350978990,MATH 272B,A00,098045,Holst; Michael J,13,0,15,2
1668350979413,MATH 273A,A00,098046,Tian; Xiaochuan,10,0,15,5
1668350979841,MATH 275,A01,098048,Tian; Xiaochuan,6,0,10,4
1668350980264,MATH 278A,A00,098049,Holst; Michael J,8,0,10,2
1668350980689,MATH 278B,A00,098050,Cloninger; Alexander,10,0,10,0
1668350981114,MATH 278C,A00,098051,Nie; Jiawang,7,0,10,3
1668350981537,MATH 280B,A00,098052,Zheng; Tianyi,8,0,15,7
1668350981960,MATH 281B,A00,098053,Bradic; Jelena,1,0,15,14
1668350982384,MATH 282B,A00,098054,Arias-Castro; Ery,0,0,15,15
1668350982808,MATH 285,A00,098055,Fitzsimmons; Patrick J,0,0,15,17
1668350983231,MATH 287B,A00,098056,Arias-Castro; Ery,2,0,15,13
1668350983657,MATH 288,A00,098057,Agarwal; Pooja,9,0,10,1
1668350983657,MATH 288,B00,098058,Zhang; Danna,8,0,10,2
1668350983657,MATH 288,C00,098059,Williams; Ruth J,9,0,10,1
1668350984084,MATH 290B,A00,098060,Roberts; Justin Deritter,13,0,15,2
1668350984507,MATH 292,A00,098061,Belmont; Eva Kinoshita,10,0,10,0
1668350984932,MATH 295,A00,098062,Suk; Andrew Hoon,48,0,50,2
1668350985354,MATH 296,A00,098063,Novak; Jonathan I,20,0,20,0
1668350985776,MATH 297,001,098064,Gamst; Anthony Collins,9997,0,9999,2
1668351485812,COGS 205,A00,101395,Chiba; Andrea,19,0,20,1
1668351486238,COGS 210B,001,101404,Greene; Deanna Jacquelyn,9998,0,9999,1
1668351486238,COGS 210B,002,101417,Xia; Haijun,9999,0,9999,0
1668351486238,COGS 210B,003,101422,Nitz; Douglas A.,9999,0,9999,0
1668351486238,COGS 210B,004,101423,Hollan; James D.,9998,0,9999,1
1668351486238,COGS 210B,005,101424,Deak; Gedeon O.,9998,0,9999,1
1668351486238,COGS 210B,006,101425,Rossano; Federico,9999,0,9999,0
1668351486661,COGS 211B,A00,101427,Coulson; Seana M,9996,0,9999,3
1668351487087,COGS 220,A00,101428,Hollan; James D.,0,0,25,25
1668351487511,COGS 229,A00,101429,Dow; Steven P,18,0,25,7
1668351487937,COGS 230,A00,101430,Klemmer; Scott R,11,0,17,6
1668351488359,COGS 234,A00,101431,Xia; Haijun,1,0,25,24
1668351488791,COGS 260,A00,101432,Kiyonaga; Anastasia,21,0,25,4
1668351488791,COGS 260,B00,101433,Kirsh; David Joel,15,0,25,10
1668351489225,CSE 202,A00,102371,Impagliazzo; Russell,0,0,0,0
1668351489650,CSE 203B,A01,102373,Cheng; Chung Kuan,0,0,0,0
1668351490075,CSE 208,A00,102374,Micciancio; Daniele,0,0,0,0
1668351490499,CSE 209A,A00,112895,Impagliazzo; Russell,0,0,15,15
1668351490924,CSE 209B,A00,108005,Bellare; Mihir,0,0,0,0
1668351491347,CSE 210,A00,113163,Coblenz; Michael J,0,0,0,0
1668351491770,CSE 219,A00,106111,Dow; Steven P,0,0,20,20
1668351492194,CSE 221,A00,102376,Voelker; Geoffrey M.,0,0,0,0
1668351492620,CSE 224,A01,102378,Porter; George M,0,0,0,0
1668351493042,CSE 229A,A00,102379,Savage; Stefan,0,0,0,0
1668351493465,CSE 229C,A00,102380,Munyaka; Imani N. S.,0,0,0,0
1668351493894,CSE 232B,A00,102382,Deutsch; Alin Bernard,0,0,0,0
1668351494318,CSE 234,A01,112904,Kumar; Arun Kumar,0,0,0,0
1668351494750,CSE 237A,A00,102383,Rosing; Tajana Simunic,0,0,0,0
1668351495177,CSE 239A,A00,102384,Deutsch; Alin Bernard,0,0,0,0
1668351495602,CSE 239B,A00,102385,Polikarpova; Nadezhda,0,0,0,0
1668351496026,CSE 240A,A00,102386,Pannuto; Patrick William,0,0,0,0
1668351496449,CSE 240B,A00,102387,Zhao; Jishen,0,0,0,0
1668351496872,CSE 241A,A00,106406,Kang; Mingu,0,0,0,0
1668351497294,CSE 249B,A00,102388,Kahng; Andrew Byun,0,0,8,8
1668351497722,CSE 251B,A01,102392,Cottrell; Garrison W,0,0,0,0
1668351497722,CSE 251B,A02,102393,Cottrell; Garrison W,0,0,0,0
1668351498144,CSE 252B,A00,102394,Ochoa; Benjamin Lawrence,0,0,0,0
1668351498570,CSE 257,A01,102396,Gao; Sicun,0,0,0,0
1668351499006,CSE 272,A00,102397,Li; Tzumao,0,0,0,0
1668351499429,CSE 274,A00,111323,Chern; Albert Ren-Haur,0,0,0,0
1668351499854,CSE 282,A00,102398,Pevzner; Pavel Arkadjevich,0,0,0,0
1668351500277,CSE 284,A00,114175,Gymrek; Melissa Ann,0,0,0,0
1668351500700,CSE 290,A00,102399,Chandraker; Manmohan Krishna,0,0,0,0
1668351500700,CSE 290,B00,102400,Vaccaro; Kristen Marie,0,0,25,25
1668351500700,CSE 290,C00,102414,Pannuto; Patrick William,0,0,25,25
1668351500700,CSE 290,D00,102427,Pevzner; Pavel Arkadjevich,0,0,0,0
1668351500700,CSE 290,E00,102429,Zhao; Jishen,0,0,0,0
1668351500700,CSE 290,F00,102436,Tullsen; Dean Michael,0,0,0,0
1668351500700,CSE 290,G00,102440,Christensen; Henrik I,0,0,20,20
1668351501131,CSE 291,A00,102443,Su; Hao,0,0,0,0
1668351501131,CSE 291,B00,102448,Polikarpova; Nadezhda,0,0,0,0
1668351501131,CSE 291,C00,102453,Vaccaro; Kristen Marie,0,0,0,0
1668351501131,CSE 291,D00,111343,Savage; Stefan,0,0,0,0
1668351501131,CSE 291,E00,116474,Claffy; Kimberly Claire,0,0,0,0
1668351501131,CSE 291,F00,116479,Pasquale; Joseph,0,0,0,0
1668351501557,CSE 293,001,119111,Bafna; Vineet,9999,0,9999,0
1668351501557,CSE 293,002,119118,Bellare; Mihir,9999,0,9999,0
1668351501557,CSE 293,003,119122,Berg-Kirkpatrick; Taylor D,9999,0,9999,0
1668351501557,CSE 293,004,119135,Christensen; Henrik I,9999,0,9999,0
1668351501557,CSE 293,005,119142,Cottrell; Garrison W,9999,0,9999,0
1668351501557,CSE 293,006,119146,Deutsch; Alin Bernard,9999,0,9999,0
1668351501557,CSE 293,007,119159,Esmaeilzadeh; Hadi,9999,0,9999,0
1668351501557,CSE 293,008,119166,Freund; Yoav,9999,0,9999,0
1668351501557,CSE 293,009,119170,Griswold; William G.,9999,0,9999,0
1668351501557,CSE 293,010,119183,Gymrek; Melissa Ann,9999,0,9999,0
1668351501557,CSE 293,011,119190,Heninger; Nadia A,9999,0,9999,0
1668351501557,CSE 293,012,119230,Impagliazzo; Russell,9999,0,9999,0
1668351501557,CSE 293,013,119232,Jhala; Ranjit,9999,0,9999,0
1668351501557,CSE 293,014,119233,Kahng; Andrew Byun,9999,0,9999,0
1668351501557,CSE 293,015,119298,Kane; Daniel Mertz,9999,0,9999,0
1668351501557,CSE 293,016,119299,Kriegman; David J,9999,0,9999,0
1668351501557,CSE 293,017,119300,Kumar; Arun Kumar,9999,0,9999,0
1668351501557,CSE 293,018,119301,Lerner; Sorin,9999,0,9999,0
1668351501557,CSE 293,019,119302,Lovett; Shachar,9999,0,9999,0
1668351501557,CSE 293,020,119303,McAuley; Julian John,9999,0,9999,0
1668351501557,CSE 293,021,119304,Micciancio; Daniele,9999,0,9999,0
1668351501557,CSE 293,022,119367,Orailoglu; Alex,9999,0,9999,0
1668351501557,CSE 293,023,119382,Paturi; Ramamohan,9999,0,9999,0
1668351501557,CSE 293,024,119404,Polikarpova; Nadezhda,9999,0,9999,0
1668351501557,CSE 293,025,119406,Politz; Joseph Gibbs,9999,0,9999,0
1668351501557,CSE 293,026,119411,Porter; George M,9999,0,9999,0
1668351501557,CSE 293,027,119414,Porter; Leonard Emerson,9999,0,9999,0
1668351501557,CSE 293,028,119416,Ramamoorthi; Ravi,9999,0,9999,0
1668351501557,CSE 293,029,119417,Sahoo; Debashis,9999,0,9999,0
1668351501557,CSE 293,030,119420,Saul; Lawrence,9999,0,9999,0
1668351501557,CSE 293,031,119421,Savage; Stefan,9999,0,9999,0
1668351501557,CSE 293,032,119425,Schulze; Jurgen P.,9999,0,9999,0
1668351501557,CSE 293,033,119426,Snoeren; Alex C.,9999,0,9999,0
1668351501557,CSE 293,034,119428,Shang; Jingbo,9999,0,9999,0
1668351501557,CSE 293,035,119430,Stefan; Deian,9999,0,9999,0
1668351501557,CSE 293,036,119431,Su; Hao,9999,0,9999,0
1668351501557,CSE 293,037,119433,Swanson; Steven James,9999,0,9999,0
1668351501557,CSE 293,038,119435,Tullsen; Dean Michael,9999,0,9999,0
1668351501557,CSE 293,039,119483,Voelker; Geoffrey M.,9999,0,9999,0
1668351501557,CSE 293,040,119537,Zhao; Jishen,9999,0,9999,0
1668351501557,CSE 293,041,119538,Zhou; Yuan-Yuan,9999,0,9999,0
1668351501557,CSE 293,042,119539,Gao; Sicun,9999,0,9999,0
1668351501557,CSE 293,043,119540,Weibel; Nadir,9999,0,9999,0
1668351501557,CSE 293,044,119541,Gupta; Rajesh K.,9999,0,9999,0
1668351501557,CSE 293,045,126410,Vaccaro; Kristen Marie,9999,0,9999,0
1668351501557,CSE 293,046,126411,Klemke; Richard,9999,0,9999,0
1668351501980,CSE 294,A00,102459,Voelker; Geoffrey M.,0,0,0,0
1668351501980,CSE 294,B00,111322,Orailoglu; Alex,0,0,0,0
1668351502405,DSE 201,A00,096914,Deutsch; Alin Bernard,30,0,30,0
1668351502827,DSE 210,A00,096915,Dasgupta; Sanjoy,30,0,30,0
1668351503261,DSE 260A,A00,096916,Altintas De Callaf; Ilkay,30,0,30,0
1668351503705,ECE 200,001,103586,Antipa; Nicholas A,9999,0,9999,0
1668351503705,ECE 200,002,103587,Atanasov; Nikolay A.,9999,0,9999,0
1668351503705,ECE 200,003,103588,Bharadia; Dinesh,9999,0,9999,0
1668351503705,ECE 200,004,103589,Cheng; Chung Kuan,9999,0,9999,0
1668351503705,ECE 200,005,103590,Cosman; Pamela C.,9999,0,9999,0
1668351503705,ECE 200,006,103591,Dayeh; Shadi Ahmad,9999,0,9999,0
1668351503705,ECE 200,007,103592,Fainman; Yeshaiahu,9999,0,9999,0
1668351503705,ECE 200,008,103593,Ford; Joseph Earl,9999,0,9999,0
1668351503705,ECE 200,009,103594,Franceschetti; Massimo,9999,0,9999,0
1668351503705,ECE 200,010,103595,Fullerton; Eric E,9999,0,9999,0
1668351503705,ECE 200,011,103596,Galton; Ian A,9999,0,9999,0
1668351503705,ECE 200,012,103597,Gilja; Vikash,9999,0,9999,0
1668351503705,ECE 200,013,103598,Hall; Drew A.,9999,0,9999,0
1668351503705,ECE 200,014,103599,Hsueh; Tzu-Chien,9999,0,9999,0
1668351503705,ECE 200,015,103600,Javidi; Tara,9999,0,9999,0
1668351503705,ECE 200,016,103601,Kahng; Andrew Byun,9999,0,9999,0
1668351503705,ECE 200,017,103602,Kim; Young-Han,9999,0,9999,0
1668351503705,ECE 200,018,103603,Koushanfar; Farinaz,9999,0,9999,0
1668351503705,ECE 200,019,103604,Kuzum; Duygu,9999,0,9999,0
1668351503705,ECE 200,020,103605,Le; Hanh-Phuc,9999,0,9999,0
1668351503705,ECE 200,021,103606,Lin; Bill,9999,0,9999,0
1668351503705,ECE 200,022,103607,Liu; Zhaowei,9998,0,9999,1
1668351503705,ECE 200,023,103608,Lo; Yu-Hwa,9999,0,9999,0
1668351503705,ECE 200,024,103609,Lomakin; Vitaliy,9999,0,9999,0
1668351503705,ECE 200,025,103610,Mercier; Patrick Philip,9999,0,9999,0
1668351503705,ECE 200,026,103611,Meyer; Florian,9999,0,9999,0
1668351503705,ECE 200,027,103612,Milstein; Laurence B.,9999,0,9999,0
1668351503705,ECE 200,028,103613,Mir Arabbaygi; Siavash,9999,0,9999,0
1668351503705,ECE 200,029,103614,Mookherjea; Shayan,9999,0,9999,0
1668351503705,ECE 200,030,103615,Morris; Karcher William,9999,0,9999,0
1668351503705,ECE 200,031,103616,Ng; Tse Nga,9999,0,9999,0
1668351503705,ECE 200,032,103617,Nguyen; Truong Quang,9999,0,9999,0
1668351503705,ECE 200,033,103618,Nomura; Kenji,9999,0,9999,0
1668351503705,ECE 200,034,103619,Orlitsky; Alon,9999,0,9999,0
1668351503705,ECE 200,035,103620,Pal; Piya,9999,0,9999,0
1668351503705,ECE 200,036,103621,Papen; George C.,9999,0,9999,0
1668351503705,ECE 200,037,103622,Radic; Stojan,9999,0,9999,0
1668351503705,ECE 200,038,103623,Rao; Bhaskar D.,9999,0,9999,0
1668351503705,ECE 200,039,103624,Rao; Ramesh R,9999,0,9999,0
1668351503705,ECE 200,040,103625,Rebeiz; Gabriel,9999,0,9999,0
1668351503705,ECE 200,041,103626,Sanford; John R,9999,0,9999,0
1668351503705,ECE 200,042,103627,Siegel; Paul H.,9999,0,9999,0
1668351503705,ECE 200,043,103628,Sievenpiper; Daniel F.,9999,0,9999,0
1668351503705,ECE 200,044,103629,Sworder; David D.,9999,0,9999,0
1668351503705,ECE 200,045,103630,Taur; Yuan,9999,0,9999,0
1668351503705,ECE 200,046,103631,Touri; Behrouz,9999,0,9999,0
1668351503705,ECE 200,047,103632,Trivedi; Mohan M.,9999,0,9999,0
1668351503705,ECE 200,048,103633,Vasconcelos; Nuno,9999,0,9999,0
1668351503705,ECE 200,049,103634,Wang; Xiaolong,9999,0,9999,0
1668351503705,ECE 200,050,103635,Xie; Pengtao,9999,0,9999,0
1668351503705,ECE 200,051,103636,Yip; Michael,9999,0,9999,0
1668351503705,ECE 200,052,103637,Zeger; Kenneth A.,999,0,999,0
1668351503705,ECE 200,053,103638,Zhang; Xinyu,9999,0,9999,0
1668351503705,ECE 200,054,103639,Turakhia; Yatish Girish,9999,0,9999,0
1668351503705,ECE 200,055,103640,Kang; Mingu,9999,0,9999,0
1668351503705,ECE 200,056,103641,Shi; Yuanyuan,9999,0,9999,0
1668351503705,ECE 200,057,103642,Wang; Edward Jay,9999,0,9999,0
1668351503705,ECE 200,058,103643,Zheng; Yang,9999,0,9999,0
1668351504130,ECE 202,A00,103644,Kuzum; Duygu,0,0,0,0
1668351504552,ECE 212BN,A00,103646,Ng; Tse Nga,0,0,0,0
1668351504977,ECE 221,A00,111493,Staff,0,0,0,0
1668351505402,ECE 222B,A00,103647,Lomakin; Vitaliy,0,0,0,0
1668351505825,ECE 230B,A00,103648,Taur; Yuan,0,0,0,0
1668351506248,ECE 238B,A00,103649,Garay; Javier,0,0,0,0
1668351506674,ECE 240B,A00,112900,Fainman; Yeshaiahu,0,0,0,0
1668351507101,ECE 247A,A00,103650,Jokerst; Jesse Vincent,0,0,0,0
1668351507532,ECE 247B,A00,103651,Wang; Joseph,0,0,0,0
1668351507958,ECE 250,A00,103652,Siegel; Paul H.,0,0,0,0
1668351508381,ECE 251A,A00,103654,Rao; Bhaskar D.,0,0,0,0
1668351508803,ECE 257B,A00,103655,Bharadia; Dinesh,0,0,0,0
1668351509227,ECE 258A,A00,103656,Milstein; Laurence B.,0,0,0,0
1668351509650,ECE 260B,A00,103658,Kang; Mingu,0,0,0,0
1668351510083,ECE 264A,A00,103659,Galton; Ian A,0,0,0,0
1668351510513,ECE 265A,A00,103661,Gudem; Prasad S.S.,0,0,0,0
1668351510944,ECE 265D,A00,103662,Gudem; Prasad S.S.,0,0,0,0
1668351511365,ECE 268,A00,103663,Koushanfar; Farinaz,0,0,0,0
1668351511797,ECE 269,A01,103665,Pal; Piya,0,0,0,0
1668351512219,ECE 271B,A00,103666,Vasconcelos; Manuela,0,0,0,0
1668351512736,ECE 276A,A00,103667,Atanasov; Nikolay A.,0,0,0,0
1668351513159,ECE 277,A00,103668,An; Cheolhong,0,0,0,0
1668351513584,ECE 279,A00,117947,Hall; Drew A.,0,0,0,0
1668351514440,ECE 283,A00,103670,Hsueh; Tzu-Chien,0,0,0,0
1668351514863,ECE 284,A00,103671,Turakhia; Yatish Girish,0,0,0,0
1668351515286,ECE 285,A00,103672,Zheng; Yang,0,0,0,0
1668351515286,ECE 285,B00,103673,Sworder; David D.,0,0,0,0
1668351515710,ECE 287,A00,103676,Javidi; Tara,0,0,0,0
1668351516132,MATH 200B,A00,098023,Salehi Golsefidy; Alireza,12,0,15,3
1668351516558,MATH 202B,A00,098024,Rhoades; Brendon Patrick,9,0,15,6
1668351516990,MATH 203B,A00,098025,Oprea; Dragos N.,10,0,15,5
1668351517413,MATH 204B,A00,098026,Sorensen; Claus M,13,0,15,2
1668351517836,MATH 208,A00,098027,Izadi; Elham,7,0,10,3
1668351518262,MATH 209,A00,098028,Pollack; Aaron,10,0,10,0
1668351518687,MATH 211A,A00,112919,Rogalski; Daniel,9,0,10,1
1668351519111,MATH 211B,A00,112920,Seward; Brandon M.,9,0,10,1
1668351519534,MATH 218,A00,098029,Li; Bo,10,0,10,0
1668351519959,MATH 220B,A00,098030,Novak; Jonathan I,11,0,15,4
1668351520393,MATH 221A,A00,098031,Ebenfelt; Peter F,13,0,15,2
1668351520817,MATH 231B,A00,098032,Zlatos; Andrej,12,0,15,3
1668351521245,MATH 240B,A00,098033,Ni; Lei,9,0,15,6
1668351521671,MATH 243,A00,098034,Jekel; David Andrew,10,0,10,0
1668351522109,MATH 245A,A00,098035,Nie; Jiawang,0,0,15,16
1668351522533,MATH 248,A00,098036,Bejenaru; Ioan,10,0,10,0
1668351522957,MATH 250B,A00,098037,Spolaor; Luca,14,0,15,1
1668351523382,MATH 258,A00,098038,Ni; Lei,10,0,10,0
1668351523807,MATH 264B,A00,098041,Rhoades; Brendon Patrick,9,0,15,6
1668351524235,MATH 268,A00,098042,Buss; Samuel R,10,0,10,0
1668351524662,MATH 269,A00,098043,Rhoades; Brendon Patrick,10,0,10,0
1668351525085,MATH 270B,A00,098044,Li; Bo,10,0,15,5
1668351525511,MATH 272B,A00,098045,Holst; Michael J,13,0,15,2
1668351525935,MATH 273A,A00,098046,Tian; Xiaochuan,10,0,15,5
1668351526361,MATH 275,A01,098048,Tian; Xiaochuan,6,0,10,4
1668351526784,MATH 278A,A00,098049,Holst; Michael J,8,0,10,2
1668351527210,MATH 278B,A00,098050,Cloninger; Alexander,10,0,10,0
1668351527635,MATH 278C,A00,098051,Nie; Jiawang,7,0,10,3
1668351528057,MATH 280B,A00,098052,Zheng; Tianyi,8,0,15,7
1668351528483,MATH 281B,A00,098053,Bradic; Jelena,1,0,15,14
1668351531538,MATH 282B,A00,098054,Arias-Castro; Ery,0,0,15,15
1668351531963,MATH 285,A00,098055,Fitzsimmons; Patrick J,0,0,15,17
1668351532404,MATH 287B,A00,098056,Arias-Castro; Ery,2,0,15,13
1668351532829,MATH 288,A00,098057,Agarwal; Pooja,9,0,10,1
1668351532829,MATH 288,B00,098058,Zhang; Danna,8,0,10,2
1668351532829,MATH 288,C00,098059,Williams; Ruth J,9,0,10,1
1668351533251,MATH 290B,A00,098060,Roberts; Justin Deritter,13,0,15,2
1668351533674,MATH 292,A00,098061,Belmont; Eva Kinoshita,10,0,10,0
1668351534116,MATH 295,A00,098062,Suk; Andrew Hoon,48,0,50,2
1668351534538,MATH 296,A00,098063,Novak; Jonathan I,20,0,20,0
1668351534965,MATH 297,001,098064,Gamst; Anthony Collins,9997,0,9999,2
1668352035177,COGS 205,A00,101395,Chiba; Andrea,19,0,20,1
1668352035678,COGS 210B,001,101404,Greene; Deanna Jacquelyn,9998,0,9999,1
1668352035678,COGS 210B,002,101417,Xia; Haijun,9999,0,9999,0
1668352035678,COGS 210B,003,101422,Nitz; Douglas A.,9999,0,9999,0
1668352035678,COGS 210B,004,101423,Hollan; James D.,9998,0,9999,1
1668352035678,COGS 210B,005,101424,Deak; Gedeon O.,9998,0,9999,1
1668352035678,COGS 210B,006,101425,Rossano; Federico,9999,0,9999,0
1668352036100,COGS 211B,A00,101427,Coulson; Seana M,9996,0,9999,3
1668352036521,COGS 220,A00,101428,Hollan; James D.,0,0,25,25
1668352036956,COGS 229,A00,101429,Dow; Steven P,18,0,25,7
1668352037377,COGS 230,A00,101430,Klemmer; Scott R,11,0,17,6
1668352037811,COGS 234,A00,101431,Xia; Haijun,1,0,25,24
1668352038237,COGS 260,A00,101432,Kiyonaga; Anastasia,21,0,25,4
1668352038237,COGS 260,B00,101433,Kirsh; David Joel,15,0,25,10
1668352038668,CSE 202,A00,102371,Impagliazzo; Russell,0,0,0,0
1668352039094,CSE 203B,A01,102373,Cheng; Chung Kuan,0,0,0,0
1668352039521,CSE 208,A00,102374,Micciancio; Daniele,0,0,0,0
1668352039943,CSE 209A,A00,112895,Impagliazzo; Russell,0,0,15,15
1668352040374,CSE 209B,A00,108005,Bellare; Mihir,0,0,0,0
1668352040798,CSE 210,A00,113163,Coblenz; Michael J,0,0,0,0
1668352041223,CSE 219,A00,106111,Dow; Steven P,0,0,20,20
1668352041654,CSE 221,A00,102376,Voelker; Geoffrey M.,0,0,0,0
1668352042077,CSE 224,A01,102378,Porter; George M,0,0,0,0
1668352042502,CSE 229A,A00,102379,Savage; Stefan,0,0,0,0
1668352042942,CSE 229C,A00,102380,Munyaka; Imani N. S.,0,0,0,0
1668352043365,CSE 232B,A00,102382,Deutsch; Alin Bernard,0,0,0,0
1668352043793,CSE 234,A01,112904,Kumar; Arun Kumar,0,0,0,0
1668352044216,CSE 237A,A00,102383,Rosing; Tajana Simunic,0,0,0,0
1668352044639,CSE 239A,A00,102384,Deutsch; Alin Bernard,0,0,0,0
1668352045065,CSE 239B,A00,102385,Polikarpova; Nadezhda,0,0,0,0
1668352045493,CSE 240A,A00,102386,Pannuto; Patrick William,0,0,0,0
1668352045916,CSE 240B,A00,102387,Zhao; Jishen,0,0,0,0
1668352046339,CSE 241A,A00,106406,Kang; Mingu,0,0,0,0
1668352046762,CSE 249B,A00,102388,Kahng; Andrew Byun,0,0,8,8
1668352047189,CSE 251B,A01,102392,Cottrell; Garrison W,0,0,0,0
1668352047189,CSE 251B,A02,102393,Cottrell; Garrison W,0,0,0,0
1668352047611,CSE 252B,A00,102394,Ochoa; Benjamin Lawrence,0,0,0,0
1668352048038,CSE 257,A01,102396,Gao; Sicun,0,0,0,0
1668352048469,CSE 272,A00,102397,Li; Tzumao,0,0,0,0
1668352048891,CSE 274,A00,111323,Chern; Albert Ren-Haur,0,0,0,0
1668352049314,CSE 282,A00,102398,Pevzner; Pavel Arkadjevich,0,0,0,0
1668352049740,CSE 284,A00,114175,Gymrek; Melissa Ann,0,0,0,0
1668352050172,CSE 290,A00,102399,Chandraker; Manmohan Krishna,0,0,0,0
1668352050172,CSE 290,B00,102400,Vaccaro; Kristen Marie,0,0,25,25
1668352050172,CSE 290,C00,102414,Pannuto; Patrick William,0,0,25,25
1668352050172,CSE 290,D00,102427,Pevzner; Pavel Arkadjevich,0,0,0,0
1668352050172,CSE 290,E00,102429,Zhao; Jishen,0,0,0,0
1668352050172,CSE 290,F00,102436,Tullsen; Dean Michael,0,0,0,0
1668352050172,CSE 290,G00,102440,Christensen; Henrik I,0,0,20,20
1668352050594,CSE 291,A00,102443,Su; Hao,0,0,0,0
1668352050594,CSE 291,B00,102448,Polikarpova; Nadezhda,0,0,0,0
1668352050594,CSE 291,C00,102453,Vaccaro; Kristen Marie,0,0,0,0
1668352050594,CSE 291,D00,111343,Savage; Stefan,0,0,0,0
1668352050594,CSE 291,E00,116474,Claffy; Kimberly Claire,0,0,0,0
1668352050594,CSE 291,F00,116479,Pasquale; Joseph,0,0,0,0
1668352051036,CSE 293,001,119111,Bafna; Vineet,9999,0,9999,0
1668352051036,CSE 293,002,119118,Bellare; Mihir,9999,0,9999,0
1668352051036,CSE 293,003,119122,Berg-Kirkpatrick; Taylor D,9999,0,9999,0
1668352051036,CSE 293,004,119135,Christensen; Henrik I,9999,0,9999,0
1668352051036,CSE 293,005,119142,Cottrell; Garrison W,9999,0,9999,0
1668352051036,CSE 293,006,119146,Deutsch; Alin Bernard,9999,0,9999,0
1668352051036,CSE 293,007,119159,Esmaeilzadeh; Hadi,9999,0,9999,0
1668352051036,CSE 293,008,119166,Freund; Yoav,9999,0,9999,0
1668352051036,CSE 293,009,119170,Griswold; William G.,9999,0,9999,0
1668352051036,CSE 293,010,119183,Gymrek; Melissa Ann,9999,0,9999,0
1668352051036,CSE 293,011,119190,Heninger; Nadia A,9999,0,9999,0
1668352051036,CSE 293,012,119230,Impagliazzo; Russell,9999,0,9999,0
1668352051036,CSE 293,013,119232,Jhala; Ranjit,9999,0,9999,0
1668352051036,CSE 293,014,119233,Kahng; Andrew Byun,9999,0,9999,0
1668352051036,CSE 293,015,119298,Kane; Daniel Mertz,9999,0,9999,0
1668352051036,CSE 293,016,119299,Kriegman; David J,9999,0,9999,0
1668352051036,CSE 293,017,119300,Kumar; Arun Kumar,9999,0,9999,0
1668352051036,CSE 293,018,119301,Lerner; Sorin,9999,0,9999,0
1668352051036,CSE 293,019,119302,Lovett; Shachar,9999,0,9999,0
1668352051036,CSE 293,020,119303,McAuley; Julian John,9999,0,9999,0
1668352051036,CSE 293,021,119304,Micciancio; Daniele,9999,0,9999,0
1668352051036,CSE 293,022,119367,Orailoglu; Alex,9999,0,9999,0
1668352051036,CSE 293,023,119382,Paturi; Ramamohan,9999,0,9999,0
1668352051036,CSE 293,024,119404,Polikarpova; Nadezhda,9999,0,9999,0
1668352051036,CSE 293,025,119406,Politz; Joseph Gibbs,9999,0,9999,0
1668352051036,CSE 293,026,119411,Porter; George M,9999,0,9999,0
1668352051036,CSE 293,027,119414,Porter; Leonard Emerson,9999,0,9999,0
1668352051036,CSE 293,028,119416,Ramamoorthi; Ravi,9999,0,9999,0
1668352051036,CSE 293,029,119417,Sahoo; Debashis,9999,0,9999,0
1668352051036,CSE 293,030,119420,Saul; Lawrence,9999,0,9999,0
1668352051036,CSE 293,031,119421,Savage; Stefan,9999,0,9999,0
1668352051036,CSE 293,032,119425,Schulze; Jurgen P.,9999,0,9999,0
1668352051036,CSE 293,033,119426,Snoeren; Alex C.,9999,0,9999,0
1668352051036,CSE 293,034,119428,Shang; Jingbo,9999,0,9999,0
1668352051036,CSE 293,035,119430,Stefan; Deian,9999,0,9999,0
1668352051036,CSE 293,036,119431,Su; Hao,9999,0,9999,0
1668352051036,CSE 293,037,119433,Swanson; Steven James,9999,0,9999,0
1668352051036,CSE 293,038,119435,Tullsen; Dean Michael,9999,0,9999,0
1668352051036,CSE 293,039,119483,Voelker; Geoffrey M.,9999,0,9999,0
1668352051036,CSE 293,040,119537,Zhao; Jishen,9999,0,9999,0
1668352051036,CSE 293,041,119538,Zhou; Yuan-Yuan,9999,0,9999,0
1668352051036,CSE 293,042,119539,Gao; Sicun,9999,0,9999,0
1668352051036,CSE 293,043,119540,Weibel; Nadir,9999,0,9999,0
1668352051036,CSE 293,044,119541,Gupta; Rajesh K.,9999,0,9999,0
1668352051036,CSE 293,045,126410,Vaccaro; Kristen Marie,9999,0,9999,0
1668352051036,CSE 293,046,126411,Klemke; Richard,9999,0,9999,0
1668352051459,CSE 294,A00,102459,Voelker; Geoffrey M.,0,0,0,0
1668352051459,CSE 294,B00,111322,Orailoglu; Alex,0,0,0,0
1668352051885,DSE 201,A00,096914,Deutsch; Alin Bernard,30,0,30,0
1668352052308,DSE 210,A00,096915,Dasgupta; Sanjoy,30,0,30,0
1668352052731,DSE 260A,A00,096916,Altintas De Callaf; Ilkay,30,0,30,0
1668352053159,ECE 200,001,103586,Antipa; Nicholas A,9999,0,9999,0
1668352053159,ECE 200,002,103587,Atanasov; Nikolay A.,9999,0,9999,0
1668352053159,ECE 200,003,103588,Bharadia; Dinesh,9999,0,9999,0
1668352053159,ECE 200,004,103589,Cheng; Chung Kuan,9999,0,9999,0
1668352053159,ECE 200,005,103590,Cosman; Pamela C.,9999,0,9999,0
1668352053159,ECE 200,006,103591,Dayeh; Shadi Ahmad,9999,0,9999,0
1668352053159,ECE 200,007,103592,Fainman; Yeshaiahu,9999,0,9999,0
1668352053159,ECE 200,008,103593,Ford; Joseph Earl,9999,0,9999,0
1668352053159,ECE 200,009,103594,Franceschetti; Massimo,9999,0,9999,0
1668352053159,ECE 200,010,103595,Fullerton; Eric E,9999,0,9999,0
1668352053159,ECE 200,011,103596,Galton; Ian A,9999,0,9999,0
1668352053159,ECE 200,012,103597,Gilja; Vikash,9999,0,9999,0
1668352053159,ECE 200,013,103598,Hall; Drew A.,9999,0,9999,0
1668352053159,ECE 200,014,103599,Hsueh; Tzu-Chien,9999,0,9999,0
1668352053159,ECE 200,015,103600,Javidi; Tara,9999,0,9999,0
1668352053159,ECE 200,016,103601,Kahng; Andrew Byun,9999,0,9999,0
1668352053159,ECE 200,017,103602,Kim; Young-Han,9999,0,9999,0
1668352053159,ECE 200,018,103603,Koushanfar; Farinaz,9999,0,9999,0
1668352053159,ECE 200,019,103604,Kuzum; Duygu,9999,0,9999,0
1668352053159,ECE 200,020,103605,Le; Hanh-Phuc,9999,0,9999,0
1668352053159,ECE 200,021,103606,Lin; Bill,9999,0,9999,0
1668352053159,ECE 200,022,103607,Liu; Zhaowei,9998,0,9999,1
1668352053159,ECE 200,023,103608,Lo; Yu-Hwa,9999,0,9999,0
1668352053159,ECE 200,024,103609,Lomakin; Vitaliy,9999,0,9999,0
1668352053159,ECE 200,025,103610,Mercier; Patrick Philip,9999,0,9999,0
1668352053159,ECE 200,026,103611,Meyer; Florian,9999,0,9999,0
1668352053159,ECE 200,027,103612,Milstein; Laurence B.,9999,0,9999,0
1668352053159,ECE 200,028,103613,Mir Arabbaygi; Siavash,9999,0,9999,0
1668352053159,ECE 200,029,103614,Mookherjea; Shayan,9999,0,9999,0
1668352053159,ECE 200,030,103615,Morris; Karcher William,9999,0,9999,0
1668352053159,ECE 200,031,103616,Ng; Tse Nga,9999,0,9999,0
1668352053159,ECE 200,032,103617,Nguyen; Truong Quang,9999,0,9999,0
1668352053159,ECE 200,033,103618,Nomura; Kenji,9999,0,9999,0
1668352053159,ECE 200,034,103619,Orlitsky; Alon,9999,0,9999,0
1668352053159,ECE 200,035,103620,Pal; Piya,9999,0,9999,0
1668352053159,ECE 200,036,103621,Papen; George C.,9999,0,9999,0
1668352053159,ECE 200,037,103622,Radic; Stojan,9999,0,9999,0
1668352053159,ECE 200,038,103623,Rao; Bhaskar D.,9999,0,9999,0
1668352053159,ECE 200,039,103624,Rao; Ramesh R,9999,0,9999,0
1668352053159,ECE 200,040,103625,Rebeiz; Gabriel,9999,0,9999,0
1668352053159,ECE 200,041,103626,Sanford; John R,9999,0,9999,0
1668352053159,ECE 200,042,103627,Siegel; Paul H.,9999,0,9999,0
1668352053159,ECE 200,043,103628,Sievenpiper; Daniel F.,9999,0,9999,0
1668352053159,ECE 200,044,103629,Sworder; David D.,9999,0,9999,0
1668352053159,ECE 200,045,103630,Taur; Yuan,9999,0,9999,0
1668352053159,ECE 200,046,103631,Touri; Behrouz,9999,0,9999,0
1668352053159,ECE 200,047,103632,Trivedi; Mohan M.,9999,0,9999,0
1668352053159,ECE 200,048,103633,Vasconcelos; Nuno,9999,0,9999,0
1668352053159,ECE 200,049,103634,Wang; Xiaolong,9999,0,9999,0
1668352053159,ECE 200,050,103635,Xie; Pengtao,9999,0,9999,0
1668352053159,ECE 200,051,103636,Yip; Michael,9999,0,9999,0
1668352053159,ECE 200,052,103637,Zeger; Kenneth A.,999,0,999,0
1668352053159,ECE 200,053,103638,Zhang; Xinyu,9999,0,9999,0
1668352053159,ECE 200,054,103639,Turakhia; Yatish Girish,9999,0,9999,0
1668352053159,ECE 200,055,103640,Kang; Mingu,9999,0,9999,0
1668352053159,ECE 200,056,103641,Shi; Yuanyuan,9999,0,9999,0
1668352053159,ECE 200,057,103642,Wang; Edward Jay,9999,0,9999,0
1668352053159,ECE 200,058,103643,Zheng; Yang,9999,0,9999,0
1668352053581,ECE 202,A00,103644,Kuzum; Duygu,0,0,0,0
1668352054016,ECE 212BN,A00,103646,Ng; Tse Nga,0,0,0,0
1668352054440,ECE 221,A00,111493,Staff,0,0,0,0
1668352054881,ECE 222B,A00,103647,Lomakin; Vitaliy,0,0,0,0
1668352055312,ECE 230B,A00,103648,Taur; Yuan,0,0,0,0
1668352055736,ECE 238B,A00,103649,Garay; Javier,0,0,0,0
1668352056167,ECE 240B,A00,112900,Fainman; Yeshaiahu,0,0,0,0
1668352056590,ECE 247A,A00,103650,Jokerst; Jesse Vincent,0,0,0,0
1668352057016,ECE 247B,A00,103651,Wang; Joseph,0,0,0,0
1668352057451,ECE 250,A00,103652,Siegel; Paul H.,0,0,0,0
1668352057873,ECE 251A,A00,103654,Rao; Bhaskar D.,0,0,0,0
1668352058308,ECE 257B,A00,103655,Bharadia; Dinesh,0,0,0,0
1668352058731,ECE 258A,A00,103656,Milstein; Laurence B.,0,0,0,0
1668352059153,ECE 260B,A00,103658,Kang; Mingu,0,0,0,0
1668352059580,ECE 264A,A00,103659,Galton; Ian A,0,0,0,0
1668352060004,ECE 265A,A00,103661,Gudem; Prasad S.S.,0,0,0,0
1668352060428,ECE 265D,A00,103662,Gudem; Prasad S.S.,0,0,0,0
1668352060855,ECE 268,A00,103663,Koushanfar; Farinaz,0,0,0,0
1668352061277,ECE 269,A01,103665,Pal; Piya,0,0,0,0
1668352061703,ECE 271B,A00,103666,Vasconcelos; Manuela,0,0,0,0
1668352062127,ECE 276A,A00,103667,Atanasov; Nikolay A.,0,0,0,0
1668352062562,ECE 277,A00,103668,An; Cheolhong,0,0,0,0
1668352062986,ECE 279,A00,117947,Hall; Drew A.,0,0,0,0
1668352063840,ECE 283,A00,103670,Hsueh; Tzu-Chien,0,0,0,0
1668352064263,ECE 284,A00,103671,Turakhia; Yatish Girish,0,0,0,0
1668352064686,ECE 285,A00,103672,Zheng; Yang,0,0,0,0
1668352064686,ECE 285,B00,103673,Sworder; David D.,0,0,0,0
1668352065113,ECE 287,A00,103676,Javidi; Tara,0,0,0,0
1668352065534,MATH 200B,A00,098023,Salehi Golsefidy; Alireza,12,0,15,3
1668352065957,MATH 202B,A00,098024,Rhoades; Brendon Patrick,9,0,15,6
1668352066383,MATH 203B,A00,098025,Oprea; Dragos N.,10,0,15,5
1668352066806,MATH 204B,A00,098026,Sorensen; Claus M,13,0,15,2
1668352067231,MATH 208,A00,098027,Izadi; Elham,7,0,10,3
1668352067655,MATH 209,A00,098028,Pollack; Aaron,10,0,10,0
1668352068082,MATH 211A,A00,112919,Rogalski; Daniel,9,0,10,1
1668352068504,MATH 211B,A00,112920,Seward; Brandon M.,9,0,10,1
1668352068927,MATH 218,A00,098029,Li; Bo,10,0,10,0
1668352069358,MATH 220B,A00,098030,Novak; Jonathan I,11,0,15,4
1668352069784,MATH 221A,A00,098031,Ebenfelt; Peter F,13,0,15,2
1668352070206,MATH 231B,A00,098032,Zlatos; Andrej,12,0,15,3
1668352070631,MATH 240B,A00,098033,Ni; Lei,9,0,15,6
1668352071056,MATH 243,A00,098034,Jekel; David Andrew,10,0,10,0
1668352071477,MATH 245A,A00,098035,Nie; Jiawang,0,0,15,16
1668352071902,MATH 248,A00,098036,Bejenaru; Ioan,10,0,10,0
1668352072328,MATH 250B,A00,098037,Spolaor; Luca,14,0,15,1
1668352072751,MATH 258,A00,098038,Ni; Lei,10,0,10,0
1668352073177,MATH 264B,A00,098041,Rhoades; Brendon Patrick,9,0,15,6
1668352073600,MATH 268,A00,098042,Buss; Samuel R,10,0,10,0
1668352074025,MATH 269,A00,098043,Rhoades; Brendon Patrick,10,0,10,0
1668352074448,MATH 270B,A00,098044,Li; Bo,10,0,15,5
1668352074872,MATH 272B,A00,098045,Holst; Michael J,13,0,15,2
1668352075298,MATH 273A,A00,098046,Tian; Xiaochuan,10,0,15,5
1668352075721,MATH 275,A01,098048,Tian; Xiaochuan,6,0,10,4
1668352076159,MATH 278A,A00,098049,Holst; Michael J,8,0,10,2
1668352076584,MATH 278B,A00,098050,Cloninger; Alexander,10,0,10,0
1668352077007,MATH 278C,A00,098051,Nie; Jiawang,7,0,10,3
1668352077429,MATH 280B,A00,098052,Zheng; Tianyi,8,0,15,7
1668352077856,MATH 281B,A00,098053,Bradic; Jelena,1,0,15,14
1668352078293,MATH 282B,A00,098054,Arias-Castro; Ery,0,0,15,15
1668352078791,MATH 285,A00,098055,Fitzsimmons; Patrick J,0,0,15,17
1668352079222,MATH 287B,A00,098056,Arias-Castro; Ery,2,0,15,13
1668352079651,MATH 288,A00,098057,Agarwal; Pooja,9,0,10,1
1668352079651,MATH 288,B00,098058,Zhang; Danna,8,0,10,2
1668352079651,MATH 288,C00,098059,Williams; Ruth J,9,0,10,1
1668352080078,MATH 290B,A00,098060,Roberts; Justin Deritter,13,0,15,2
1668352080501,MATH 292,A00,098061,Belmont; Eva Kinoshita,10,0,10,0
1668352080924,MATH 295,A00,098062,Suk; Andrew Hoon,48,0,50,2
1668352081346,MATH 296,A00,098063,Novak; Jonathan I,20,0,20,0
1668352081769,MATH 297,001,098064,Gamst; Anthony Collins,9997,0,9999,2
1668352582417,COGS 205,A00,101395,Chiba; Andrea,19,0,20,1
1668352582851,COGS 210B,001,101404,Greene; Deanna Jacquelyn,9998,0,9999,1
1668352582851,COGS 210B,002,101417,Xia; Haijun,9999,0,9999,0
1668352582851,COGS 210B,003,101422,Nitz; Douglas A.,9999,0,9999,0
1668352582851,COGS 210B,004,101423,Hollan; James D.,9998,0,9999,1
1668352582851,COGS 210B,005,101424,Deak; Gedeon O.,9998,0,9999,1
1668352582851,COGS 210B,006,101425,Rossano; Federico,9999,0,9999,0
1668352583274,COGS 211B,A00,101427,Coulson; Seana M,9996,0,9999,3
1668352583697,COGS 220,A00,101428,Hollan; James D.,0,0,25,25
1668352584123,COGS 229,A00,101429,Dow; Steven P,18,0,25,7
1668352584549,COGS 230,A00,101430,Klemmer; Scott R,11,0,17,6
1668352584982,COGS 234,A00,101431,Xia; Haijun,1,0,25,24
1668352585406,COGS 260,A00,101432,Kiyonaga; Anastasia,21,0,25,4
1668352585406,COGS 260,B00,101433,Kirsh; David Joel,15,0,25,10
1668352585831,CSE 202,A00,102371,Impagliazzo; Russell,0,0,0,0
1668352586257,CSE 203B,A01,102373,Cheng; Chung Kuan,0,0,0,0
1668352586682,CSE 208,A00,102374,Micciancio; Daniele,0,0,0,0
1668352587109,CSE 209A,A00,112895,Impagliazzo; Russell,0,0,15,15
1668352587533,CSE 209B,A00,108005,Bellare; Mihir,0,0,0,0
1668352587956,CSE 210,A00,113163,Coblenz; Michael J,0,0,0,0
1668352588378,CSE 219,A00,106111,Dow; Steven P,0,0,20,20
1668352588806,CSE 221,A00,102376,Voelker; Geoffrey M.,0,0,0,0
1668352589229,CSE 224,A01,102378,Porter; George M,0,0,0,0
1668352589654,CSE 229A,A00,102379,Savage; Stefan,0,0,0,0
1668352590078,CSE 229C,A00,102380,Munyaka; Imani N. S.,0,0,0,0
1668352590500,CSE 232B,A00,102382,Deutsch; Alin Bernard,0,0,0,0
1668352590929,CSE 234,A01,112904,Kumar; Arun Kumar,0,0,0,0
1668352591366,CSE 237A,A00,102383,Rosing; Tajana Simunic,0,0,0,0
1668352591789,CSE 239A,A00,102384,Deutsch; Alin Bernard,0,0,0,0
1668352592218,CSE 239B,A00,102385,Polikarpova; Nadezhda,0,0,0,0
1668352592641,CSE 240A,A00,102386,Pannuto; Patrick William,0,0,0,0
1668352593067,CSE 240B,A00,102387,Zhao; Jishen,0,0,0,0
1668352593492,CSE 241A,A00,106406,Kang; Mingu,0,0,0,0
1668352593916,CSE 249B,A00,102388,Kahng; Andrew Byun,0,0,8,8
1668352594342,CSE 251B,A01,102392,Cottrell; Garrison W,0,0,0,0
1668352594342,CSE 251B,A02,102393,Cottrell; Garrison W,0,0,0,0
1668352594765,CSE 252B,A00,102394,Ochoa; Benjamin Lawrence,0,0,0,0
1668352595190,CSE 257,A01,102396,Gao; Sicun,0,0,0,0
1668352595618,CSE 272,A00,102397,Li; Tzumao,0,0,0,0
1668352596042,CSE 274,A00,111323,Chern; Albert Ren-Haur,0,0,0,0
1668352596473,CSE 282,A00,102398,Pevzner; Pavel Arkadjevich,0,0,0,0
1668352596898,CSE 284,A00,114175,Gymrek; Melissa Ann,0,0,0,0
1668352597323,CSE 290,A00,102399,Chandraker; Manmohan Krishna,0,0,0,0
1668352597323,CSE 290,B00,102400,Vaccaro; Kristen Marie,0,0,25,25
1668352597323,CSE 290,C00,102414,Pannuto; Patrick William,0,0,25,25
1668352597323,CSE 290,D00,102427,Pevzner; Pavel Arkadjevich,0,0,0,0
1668352597323,CSE 290,E00,102429,Zhao; Jishen,0,0,0,0
1668352597323,CSE 290,F00,102436,Tullsen; Dean Michael,0,0,0,0
1668352597323,CSE 290,G00,102440,Christensen; Henrik I,0,0,20,20
1668352597751,CSE 291,A00,102443,Su; Hao,0,0,0,0
1668352597751,CSE 291,B00,102448,Polikarpova; Nadezhda,0,0,0,0
1668352597751,CSE 291,C00,102453,Vaccaro; Kristen Marie,0,0,0,0
1668352597751,CSE 291,D00,111343,Savage; Stefan,0,0,0,0
1668352597751,CSE 291,E00,116474,Claffy; Kimberly Claire,0,0,0,0
1668352597751,CSE 291,F00,116479,Pasquale; Joseph,0,0,0,0
1668352598177,CSE 293,001,119111,Bafna; Vineet,9999,0,9999,0
1668352598177,CSE 293,002,119118,Bellare; Mihir,9999,0,9999,0
1668352598177,CSE 293,003,119122,Berg-Kirkpatrick; Taylor D,9999,0,9999,0
1668352598177,CSE 293,004,119135,Christensen; Henrik I,9999,0,9999,0
1668352598177,CSE 293,005,119142,Cottrell; Garrison W,9999,0,9999,0
1668352598177,CSE 293,006,119146,Deutsch; Alin Bernard,9999,0,9999,0
1668352598177,CSE 293,007,119159,Esmaeilzadeh; Hadi,9999,0,9999,0
1668352598177,CSE 293,008,119166,Freund; Yoav,9999,0,9999,0
1668352598177,CSE 293,009,119170,Griswold; William G.,9999,0,9999,0
1668352598177,CSE 293,010,119183,Gymrek; Melissa Ann,9999,0,9999,0
1668352598177,CSE 293,011,119190,Heninger; Nadia A,9999,0,9999,0
1668352598177,CSE 293,012,119230,Impagliazzo; Russell,9999,0,9999,0
1668352598177,CSE 293,013,119232,Jhala; Ranjit,9999,0,9999,0
1668352598177,CSE 293,014,119233,Kahng; Andrew Byun,9999,0,9999,0
1668352598177,CSE 293,015,119298,Kane; Daniel Mertz,9999,0,9999,0
1668352598177,CSE 293,016,119299,Kriegman; David J,9999,0,9999,0
1668352598177,CSE 293,017,119300,Kumar; Arun Kumar,9999,0,9999,0
1668352598177,CSE 293,018,119301,Lerner; Sorin,9999,0,9999,0
1668352598177,CSE 293,019,119302,Lovett; Shachar,9999,0,9999,0
1668352598177,CSE 293,020,119303,McAuley; Julian John,9999,0,9999,0
1668352598177,CSE 293,021,119304,Micciancio; Daniele,9999,0,9999,0
1668352598177,CSE 293,022,119367,Orailoglu; Alex,9999,0,9999,0
1668352598177,CSE 293,023,119382,Paturi; Ramamohan,9999,0,9999,0
1668352598177,CSE 293,024,119404,Polikarpova; Nadezhda,9999,0,9999,0
1668352598177,CSE 293,025,119406,Politz; Joseph Gibbs,9999,0,9999,0
1668352598177,CSE 293,026,119411,Porter; George M,9999,0,9999,0
1668352598177,CSE 293,027,119414,Porter; Leonard Emerson,9999,0,9999,0
1668352598177,CSE 293,028,119416,Ramamoorthi; Ravi,9999,0,9999,0
1668352598177,CSE 293,029,119417,Sahoo; Debashis,9999,0,9999,0
1668352598177,CSE 293,030,119420,Saul; Lawrence,9999,0,9999,0
1668352598177,CSE 293,031,119421,Savage; Stefan,9999,0,9999,0
1668352598177,CSE 293,032,119425,Schulze; Jurgen P.,9999,0,9999,0
1668352598177,CSE 293,033,119426,Snoeren; Alex C.,9999,0,9999,0
1668352598177,CSE 293,034,119428,Shang; Jingbo,9999,0,9999,0
1668352598177,CSE 293,035,119430,Stefan; Deian,9999,0,9999,0
1668352598177,CSE 293,036,119431,Su; Hao,9999,0,9999,0
1668352598177,CSE 293,037,119433,Swanson; Steven James,9999,0,9999,0
1668352598177,CSE 293,038,119435,Tullsen; Dean Michael,9999,0,9999,0
1668352598177,CSE 293,039,119483,Voelker; Geoffrey M.,9999,0,9999,0
1668352598177,CSE 293,040,119537,Zhao; Jishen,9999,0,9999,0
1668352598177,CSE 293,041,119538,Zhou; Yuan-Yuan,9999,0,9999,0
1668352598177,CSE 293,042,119539,Gao; Sicun,9999,0,9999,0
1668352598177,CSE 293,043,119540,Weibel; Nadir,9999,0,9999,0
1668352598177,CSE 293,044,119541,Gupta; Rajesh K.,9999,0,9999,0
1668352598177,CSE 293,045,126410,Vaccaro; Kristen Marie,9999,0,9999,0
1668352598177,CSE 293,046,126411,Klemke; Richard,9999,0,9999,0
1668352598601,CSE 294,A00,102459,Voelker; Geoffrey M.,0,0,0,0
1668352598601,CSE 294,B00,111322,Orailoglu; Alex,0,0,0,0
1668352599029,DSE 201,A00,096914,Deutsch; Alin Bernard,30,0,30,0
1668352599569,DSE 210,A00,096915,Dasgupta; Sanjoy,30,0,30,0
1668352600003,DSE 260A,A00,096916,Altintas De Callaf; Ilkay,30,0,30,0
1668352600455,ECE 200,001,103586,Antipa; Nicholas A,9999,0,9999,0
1668352600455,ECE 200,002,103587,Atanasov; Nikolay A.,9999,0,9999,0
1668352600455,ECE 200,003,103588,Bharadia; Dinesh,9999,0,9999,0
1668352600455,ECE 200,004,103589,Cheng; Chung Kuan,9999,0,9999,0
1668352600455,ECE 200,005,103590,Cosman; Pamela C.,9999,0,9999,0
1668352600455,ECE 200,006,103591,Dayeh; Shadi Ahmad,9999,0,9999,0
1668352600455,ECE 200,007,103592,Fainman; Yeshaiahu,9999,0,9999,0
1668352600455,ECE 200,008,103593,Ford; Joseph Earl,9999,0,9999,0
1668352600455,ECE 200,009,103594,Franceschetti; Massimo,9999,0,9999,0
1668352600455,ECE 200,010,103595,Fullerton; Eric E,9999,0,9999,0
1668352600455,ECE 200,011,103596,Galton; Ian A,9999,0,9999,0
1668352600455,ECE 200,012,103597,Gilja; Vikash,9999,0,9999,0
1668352600455,ECE 200,013,103598,Hall; Drew A.,9999,0,9999,0
1668352600455,ECE 200,014,103599,Hsueh; Tzu-Chien,9999,0,9999,0
1668352600455,ECE 200,015,103600,Javidi; Tara,9999,0,9999,0
1668352600455,ECE 200,016,103601,Kahng; Andrew Byun,9999,0,9999,0
1668352600455,ECE 200,017,103602,Kim; Young-Han,9999,0,9999,0
1668352600455,ECE 200,018,103603,Koushanfar; Farinaz,9999,0,9999,0
1668352600455,ECE 200,019,103604,Kuzum; Duygu,9999,0,9999,0
1668352600455,ECE 200,020,103605,Le; Hanh-Phuc,9999,0,9999,0
1668352600455,ECE 200,021,103606,Lin; Bill,9999,0,9999,0
1668352600455,ECE 200,022,103607,Liu; Zhaowei,9998,0,9999,1
1668352600455,ECE 200,023,103608,Lo; Yu-Hwa,9999,0,9999,0
1668352600455,ECE 200,024,103609,Lomakin; Vitaliy,9999,0,9999,0
1668352600455,ECE 200,025,103610,Mercier; Patrick Philip,9999,0,9999,0
1668352600455,ECE 200,026,103611,Meyer; Florian,9999,0,9999,0
1668352600455,ECE 200,027,103612,Milstein; Laurence B.,9999,0,9999,0
1668352600455,ECE 200,028,103613,Mir Arabbaygi; Siavash,9999,0,9999,0
1668352600455,ECE 200,029,103614,Mookherjea; Shayan,9999,0,9999,0
1668352600455,ECE 200,030,103615,Morris; Karcher William,9999,0,9999,0
1668352600455,ECE 200,031,103616,Ng; Tse Nga,9999,0,9999,0
1668352600455,ECE 200,032,103617,Nguyen; Truong Quang,9999,0,9999,0
1668352600455,ECE 200,033,103618,Nomura; Kenji,9999,0,9999,0
1668352600455,ECE 200,034,103619,Orlitsky; Alon,9999,0,9999,0
1668352600455,ECE 200,035,103620,Pal; Piya,9999,0,9999,0
1668352600455,ECE 200,036,103621,Papen; George C.,9999,0,9999,0
1668352600455,ECE 200,037,103622,Radic; Stojan,9999,0,9999,0
1668352600455,ECE 200,038,103623,Rao; Bhaskar D.,9999,0,9999,0
1668352600455,ECE 200,039,103624,Rao; Ramesh R,9999,0,9999,0
1668352600455,ECE 200,040,103625,Rebeiz; Gabriel,9999,0,9999,0
1668352600455,ECE 200,041,103626,Sanford; John R,9999,0,9999,0
1668352600455,ECE 200,042,103627,Siegel; Paul H.,9999,0,9999,0
1668352600455,ECE 200,043,103628,Sievenpiper; Daniel F.,9999,0,9999,0
1668352600455,ECE 200,044,103629,Sworder; David D.,9999,0,9999,0
1668352600455,ECE 200,045,103630,Taur; Yuan,9999,0,9999,0
1668352600455,ECE 200,046,103631,Touri; Behrouz,9999,0,9999,0
1668352600455,ECE 200,047,103632,Trivedi; Mohan M.,9999,0,9999,0
1668352600455,ECE 200,048,103633,Vasconcelos; Nuno,9999,0,9999,0
1668352600455,ECE 200,049,103634,Wang; Xiaolong,9999,0,9999,0
1668352600455,ECE 200,050,103635,Xie; Pengtao,9999,0,9999,0
1668352600455,ECE 200,051,103636,Yip; Michael,9999,0,9999,0
1668352600455,ECE 200,052,103637,Zeger; Kenneth A.,999,0,999,0
1668352600455,ECE 200,053,103638,Zhang; Xinyu,9999,0,9999,0
1668352600455,ECE 200,054,103639,Turakhia; Yatish Girish,9999,0,9999,0
1668352600455,ECE 200,055,103640,Kang; Mingu,9999,0,9999,0
1668352600455,ECE 200,056,103641,Shi; Yuanyuan,9999,0,9999,0
1668352600455,ECE 200,057,103642,Wang; Edward Jay,9999,0,9999,0
1668352600455,ECE 200,058,103643,Zheng; Yang,9999,0,9999,0
1668352600884,ECE 202,A00,103644,Kuzum; Duygu,0,0,0,0
1668352601309,ECE 212BN,A00,103646,Ng; Tse Nga,0,0,0,0
1668352601732,ECE 221,A00,111493,Staff,0,0,0,0
1668352602172,ECE 222B,A00,103647,Lomakin; Vitaliy,0,0,0,0
1668352602594,ECE 230B,A00,103648,Taur; Yuan,0,0,0,0
1668352603028,ECE 238B,A00,103649,Garay; Javier,0,0,0,0
1668352603454,ECE 240B,A00,112900,Fainman; Yeshaiahu,0,0,0,0
1668352603884,ECE 247A,A00,103650,Jokerst; Jesse Vincent,0,0,0,0
1668352604324,ECE 247B,A00,103651,Wang; Joseph,0,0,0,0
1668352604751,ECE 250,A00,103652,Siegel; Paul H.,0,0,0,0
1668352605175,ECE 251A,A00,103654,Rao; Bhaskar D.,0,0,0,0
1668352605598,ECE 257B,A00,103655,Bharadia; Dinesh,0,0,0,0
1668352606022,ECE 258A,A00,103656,Milstein; Laurence B.,0,0,0,0
1668352606458,ECE 260B,A00,103658,Kang; Mingu,0,0,0,0
1668352606885,ECE 264A,A00,103659,Galton; Ian A,0,0,0,0
1668352607317,ECE 265A,A00,103661,Gudem; Prasad S.S.,0,0,0,0
1668352607744,ECE 265D,A00,103662,Gudem; Prasad S.S.,0,0,0,0
1668352608168,ECE 268,A00,103663,Koushanfar; Farinaz,0,0,0,0
1668352608604,ECE 269,A01,103665,Pal; Piya,0,0,0,0
1668352609037,ECE 271B,A00,103666,Vasconcelos; Manuela,0,0,0,0
1668352609465,ECE 276A,A00,103667,Atanasov; Nikolay A.,0,0,0,0
1668352609900,ECE 277,A00,103668,An; Cheolhong,0,0,0,0
1668352610325,ECE 279,A00,117947,Hall; Drew A.,0,0,0,0
1668352611184,ECE 283,A00,103670,Hsueh; Tzu-Chien,0,0,0,0
1668352611611,ECE 284,A00,103671,Turakhia; Yatish Girish,0,0,0,0
1668352612037,ECE 285,A00,103672,Zheng; Yang,0,0,0,0
1668352612037,ECE 285,B00,103673,Sworder; David D.,0,0,0,0
1668352612468,ECE 287,A00,103676,Javidi; Tara,0,0,0,0
1668352612892,MATH 200B,A00,098023,Salehi Golsefidy; Alireza,12,0,15,3
1668352613317,MATH 202B,A00,098024,Rhoades; Brendon Patrick,9,0,15,6
1668352613742,MATH 203B,A00,098025,Oprea; Dragos N.,10,0,15,5
1668352614164,MATH 204B,A00,098026,Sorensen; Claus M,13,0,15,2
1668352614596,MATH 208,A00,098027,Izadi; Elham,7,0,10,3
1668352615025,MATH 209,A00,098028,Pollack; Aaron,10,0,10,0
1668352615456,MATH 211A,A00,112919,Rogalski; Daniel,9,0,10,1
1668352615880,MATH 211B,A00,112920,Seward; Brandon M.,9,0,10,1
1668352616320,MATH 218,A00,098029,Li; Bo,10,0,10,0
1668352616743,MATH 220B,A00,098030,Novak; Jonathan I,11,0,15,4
1668352617185,MATH 221A,A00,098031,Ebenfelt; Peter F,13,0,15,2
1668352617607,MATH 231B,A00,098032,Zlatos; Andrej,12,0,15,3
1668352618046,MATH 240B,A00,098033,Ni; Lei,9,0,15,6
1668352618473,MATH 243,A00,098034,Jekel; David Andrew,10,0,10,0
1668352618896,MATH 245A,A00,098035,Nie; Jiawang,0,0,15,16
1668352619320,MATH 248,A00,098036,Bejenaru; Ioan,10,0,10,0
1668352619754,MATH 250B,A00,098037,Spolaor; Luca,14,0,15,1
1668352620185,MATH 258,A00,098038,Ni; Lei,10,0,10,0
1668352620608,MATH 264B,A00,098041,Rhoades; Brendon Patrick,9,0,15,6
1668352621034,MATH 268,A00,098042,Buss; Samuel R,10,0,10,0
1668352621460,MATH 269,A00,098043,Rhoades; Brendon Patrick,10,0,10,0
1668352621888,MATH 270B,A00,098044,Li; Bo,10,0,15,5
1668352622317,MATH 272B,A00,098045,Holst; Michael J,13,0,15,2
1668352622745,MATH 273A,A00,098046,Tian; Xiaochuan,10,0,15,5
1668352623174,MATH 275,A01,098048,Tian; Xiaochuan,6,0,10,4
1668352623610,MATH 278A,A00,098049,Holst; Michael J,8,0,10,2
1668352624043,MATH 278B,A00,098050,Cloninger; Alexander,10,0,10,0
1668352624467,MATH 278C,A00,098051,Nie; Jiawang,7,0,10,3
1668352624890,MATH 280B,A00,098052,Zheng; Tianyi,8,0,15,7
1668352625318,MATH 281B,A00,098053,Bradic; Jelena,1,0,15,14
1668352625752,MATH 282B,A00,098054,Arias-Castro; Ery,0,0,15,15
1668352626177,MATH 285,A00,098055,Fitzsimmons; Patrick J,0,0,15,17
1668352626603,MATH 287B,A00,098056,Arias-Castro; Ery,2,0,15,13
1668352627036,MATH 288,A00,098057,Agarwal; Pooja,9,0,10,1
1668352627036,MATH 288,B00,098058,Zhang; Danna,8,0,10,2
1668352627036,MATH 288,C00,098059,Williams; Ruth J,9,0,10,1
1668352627471,MATH 290B,A00,098060,Roberts; Justin Deritter,13,0,15,2
1668352627897,MATH 292,A00,098061,Belmont; Eva Kinoshita,10,0,10,0
1668352628324,MATH 295,A00,098062,Suk; Andrew Hoon,48,0,50,2
1668352628748,MATH 296,A00,098063,Novak; Jonathan I,20,0,20,0
1668352629175,MATH 297,001,098064,Gamst; Anthony Collins,9997,0,9999,2
1668353129660,COGS 205,A00,101395,Chiba; Andrea,19,0,20,1
1668353130088,COGS 210B,001,101404,Greene; Deanna Jacquelyn,9998,0,9999,1
1668353130088,COGS 210B,002,101417,Xia; Haijun,9999,0,9999,0
1668353130088,COGS 210B,003,101422,Nitz; Douglas A.,9999,0,9999,0
1668353130088,COGS 210B,004,101423,Hollan; James D.,9998,0,9999,1
1668353130088,COGS 210B,005,101424,Deak; Gedeon O.,9998,0,9999,1
1668353130088,COGS 210B,006,101425,Rossano; Federico,9999,0,9999,0
1668353130510,COGS 211B,A00,101427,Coulson; Seana M,9996,0,9999,3
1668353130945,COGS 220,A00,101428,Hollan; James D.,0,0,25,25
1668353131368,COGS 229,A00,101429,Dow; Steven P,18,0,25,7
1668353131804,COGS 230,A00,101430,Klemmer; Scott R,11,0,17,6
1668353132233,COGS 234,A00,101431,Xia; Haijun,1,0,25,24
1668353132656,COGS 260,A00,101432,Kiyonaga; Anastasia,21,0,25,4
1668353132656,COGS 260,B00,101433,Kirsh; David Joel,15,0,25,10
1668353133094,CSE 202,A00,102371,Impagliazzo; Russell,0,0,0,0
1668353133515,CSE 203B,A01,102373,Cheng; Chung Kuan,0,0,0,0
1668353133946,CSE 208,A00,102374,Micciancio; Daniele,0,0,0,0
1668353134373,CSE 209A,A00,112895,Impagliazzo; Russell,0,0,15,15
1668353134808,CSE 209B,A00,108005,Bellare; Mihir,0,0,0,0
1668353135232,CSE 210,A00,113163,Coblenz; Michael J,0,0,0,0
1668353135658,CSE 219,A00,106111,Dow; Steven P,0,0,20,20
1668353136081,CSE 221,A00,102376,Voelker; Geoffrey M.,0,0,0,0
1668353136506,CSE 224,A01,102378,Porter; George M,0,0,0,0
1668353136928,CSE 229A,A00,102379,Savage; Stefan,0,0,0,0
1668353137352,CSE 229C,A00,102380,Munyaka; Imani N. S.,0,0,0,0
1668353137780,CSE 232B,A00,102382,Deutsch; Alin Bernard,0,0,0,0
1668353138204,CSE 234,A01,112904,Kumar; Arun Kumar,0,0,0,0
1668353138630,CSE 237A,A00,102383,Rosing; Tajana Simunic,0,0,0,0
1668353139056,CSE 239A,A00,102384,Deutsch; Alin Bernard,0,0,0,0
1668353139479,CSE 239B,A00,102385,Polikarpova; Nadezhda,0,0,0,0
1668353139902,CSE 240A,A00,102386,Pannuto; Patrick William,0,0,0,0
1668353140325,CSE 240B,A00,102387,Zhao; Jishen,0,0,0,0
1668353140748,CSE 241A,A00,106406,Kang; Mingu,0,0,0,0
1668353141175,CSE 249B,A00,102388,Kahng; Andrew Byun,0,0,8,8
1668353141610,CSE 251B,A01,102392,Cottrell; Garrison W,0,0,0,0
1668353141610,CSE 251B,A02,102393,Cottrell; Garrison W,0,0,0,0
1668353142033,CSE 252B,A00,102394,Ochoa; Benjamin Lawrence,0,0,0,0
1668353142460,CSE 257,A01,102396,Gao; Sicun,0,0,0,0
1668353142882,CSE 272,A00,102397,Li; Tzumao,0,0,0,0
1668353143304,CSE 274,A00,111323,Chern; Albert Ren-Haur,0,0,0,0
1668353143728,CSE 282,A00,102398,Pevzner; Pavel Arkadjevich,0,0,0,0
1668353144151,CSE 284,A00,114175,Gymrek; Melissa Ann,0,0,0,0
1668353144575,CSE 290,A00,102399,Chandraker; Manmohan Krishna,0,0,0,0
1668353144575,CSE 290,B00,102400,Vaccaro; Kristen Marie,0,0,25,25
1668353144575,CSE 290,C00,102414,Pannuto; Patrick William,0,0,25,25
1668353144575,CSE 290,D00,102427,Pevzner; Pavel Arkadjevich,0,0,0,0
1668353144575,CSE 290,E00,102429,Zhao; Jishen,0,0,0,0
1668353144575,CSE 290,F00,102436,Tullsen; Dean Michael,0,0,0,0
1668353144575,CSE 290,G00,102440,Christensen; Henrik I,0,0,20,20
1668353144999,CSE 291,A00,102443,Su; Hao,0,0,0,0
1668353144999,CSE 291,B00,102448,Polikarpova; Nadezhda,0,0,0,0
1668353144999,CSE 291,C00,102453,Vaccaro; Kristen Marie,0,0,0,0
1668353144999,CSE 291,D00,111343,Savage; Stefan,0,0,0,0
1668353144999,CSE 291,E00,116474,Claffy; Kimberly Claire,0,0,0,0
1668353144999,CSE 291,F00,116479,Pasquale; Joseph,0,0,0,0
1668353145433,CSE 293,001,119111,Bafna; Vineet,9999,0,9999,0
1668353145433,CSE 293,002,119118,Bellare; Mihir,9999,0,9999,0
1668353145433,CSE 293,003,119122,Berg-Kirkpatrick; Taylor D,9999,0,9999,0
1668353145433,CSE 293,004,119135,Christensen; Henrik I,9999,0,9999,0
1668353145433,CSE 293,005,119142,Cottrell; Garrison W,9999,0,9999,0
1668353145433,CSE 293,006,119146,Deutsch; Alin Bernard,9999,0,9999,0
1668353145433,CSE 293,007,119159,Esmaeilzadeh; Hadi,9999,0,9999,0
1668353145433,CSE 293,008,119166,Freund; Yoav,9999,0,9999,0
1668353145433,CSE 293,009,119170,Griswold; William G.,9999,0,9999,0
1668353145433,CSE 293,010,119183,Gymrek; Melissa Ann,9999,0,9999,0
1668353145433,CSE 293,011,119190,Heninger; Nadia A,9999,0,9999,0
1668353145433,CSE 293,012,119230,Impagliazzo; Russell,9999,0,9999,0
1668353145433,CSE 293,013,119232,Jhala; Ranjit,9999,0,9999,0
1668353145433,CSE 293,014,119233,Kahng; Andrew Byun,9999,0,9999,0
1668353145433,CSE 293,015,119298,Kane; Daniel Mertz,9999,0,9999,0
1668353145433,CSE 293,016,119299,Kriegman; David J,9999,0,9999,0
1668353145433,CSE 293,017,119300,Kumar; Arun Kumar,9999,0,9999,0
1668353145433,CSE 293,018,119301,Lerner; Sorin,9999,0,9999,0
1668353145433,CSE 293,019,119302,Lovett; Shachar,9999,0,9999,0
1668353145433,CSE 293,020,119303,McAuley; Julian John,9999,0,9999,0
1668353145433,CSE 293,021,119304,Micciancio; Daniele,9999,0,9999,0
1668353145433,CSE 293,022,119367,Orailoglu; Alex,9999,0,9999,0
1668353145433,CSE 293,023,119382,Paturi; Ramamohan,9999,0,9999,0
1668353145433,CSE 293,024,119404,Polikarpova; Nadezhda,9999,0,9999,0
1668353145433,CSE 293,025,119406,Politz; Joseph Gibbs,9999,0,9999,0
1668353145433,CSE 293,026,119411,Porter; George M,9999,0,9999,0
1668353145433,CSE 293,027,119414,Porter; Leonard Emerson,9999,0,9999,0
1668353145433,CSE 293,028,119416,Ramamoorthi; Ravi,9999,0,9999,0
1668353145433,CSE 293,029,119417,Sahoo; Debashis,9999,0,9999,0
1668353145433,CSE 293,030,119420,Saul; Lawrence,9999,0,9999,0
1668353145433,CSE 293,031,119421,Savage; Stefan,9999,0,9999,0
1668353145433,CSE 293,032,119425,Schulze; Jurgen P.,9999,0,9999,0
1668353145433,CSE 293,033,119426,Snoeren; Alex C.,9999,0,9999,0
1668353145433,CSE 293,034,119428,Shang; Jingbo,9999,0,9999,0
1668353145433,CSE 293,035,119430,Stefan; Deian,9999,0,9999,0
1668353145433,CSE 293,036,119431,Su; Hao,9999,0,9999,0
1668353145433,CSE 293,037,119433,Swanson; Steven James,9999,0,9999,0
1668353145433,CSE 293,038,119435,Tullsen; Dean Michael,9999,0,9999,0
1668353145433,CSE 293,039,119483,Voelker; Geoffrey M.,9999,0,9999,0
1668353145433,CSE 293,040,119537,Zhao; Jishen,9999,0,9999,0
1668353145433,CSE 293,041,119538,Zhou; Yuan-Yuan,9999,0,9999,0
1668353145433,CSE 293,042,119539,Gao; Sicun,9999,0,9999,0
1668353145433,CSE 293,043,119540,Weibel; Nadir,9999,0,9999,0
1668353145433,CSE 293,044,119541,Gupta; Rajesh K.,9999,0,9999,0
1668353145433,CSE 293,045,126410,Vaccaro; Kristen Marie,9999,0,9999,0
1668353145433,CSE 293,046,126411,Klemke; Richard,9999,0,9999,0
1668353145873,CSE 294,A00,102459,Voelker; Geoffrey M.,0,0,0,0
1668353145873,CSE 294,B00,111322,Orailoglu; Alex,0,0,0,0
1668353146297,DSE 201,A00,096914,Deutsch; Alin Bernard,30,0,30,0
1668353146722,DSE 210,A00,096915,Dasgupta; Sanjoy,30,0,30,0
1668353147145,DSE 260A,A00,096916,Altintas De Callaf; Ilkay,30,0,30,0
1668353147574,ECE 200,001,103586,Antipa; Nicholas A,9999,0,9999,0
1668353147574,ECE 200,002,103587,Atanasov; Nikolay A.,9999,0,9999,0
1668353147574,ECE 200,003,103588,Bharadia; Dinesh,9999,0,9999,0
1668353147574,ECE 200,004,103589,Cheng; Chung Kuan,9999,0,9999,0
1668353147574,ECE 200,005,103590,Cosman; Pamela C.,9999,0,9999,0
1668353147574,ECE 200,006,103591,Dayeh; Shadi Ahmad,9999,0,9999,0
1668353147574,ECE 200,007,103592,Fainman; Yeshaiahu,9999,0,9999,0
1668353147574,ECE 200,008,103593,Ford; Joseph Earl,9999,0,9999,0
1668353147574,ECE 200,009,103594,Franceschetti; Massimo,9999,0,9999,0
1668353147574,ECE 200,010,103595,Fullerton; Eric E,9999,0,9999,0
1668353147574,ECE 200,011,103596,Galton; Ian A,9999,0,9999,0
1668353147574,ECE 200,012,103597,Gilja; Vikash,9999,0,9999,0
1668353147574,ECE 200,013,103598,Hall; Drew A.,9999,0,9999,0
1668353147574,ECE 200,014,103599,Hsueh; Tzu-Chien,9999,0,9999,0
1668353147574,ECE 200,015,103600,Javidi; Tara,9999,0,9999,0
1668353147574,ECE 200,016,103601,Kahng; Andrew Byun,9999,0,9999,0
1668353147574,ECE 200,017,103602,Kim; Young-Han,9999,0,9999,0
1668353147574,ECE 200,018,103603,Koushanfar; Farinaz,9999,0,9999,0
1668353147574,ECE 200,019,103604,Kuzum; Duygu,9999,0,9999,0
1668353147574,ECE 200,020,103605,Le; Hanh-Phuc,9999,0,9999,0
1668353147574,ECE 200,021,103606,Lin; Bill,9999,0,9999,0
1668353147574,ECE 200,022,103607,Liu; Zhaowei,9998,0,9999,1
1668353147574,ECE 200,023,103608,Lo; Yu-Hwa,9999,0,9999,0
1668353147574,ECE 200,024,103609,Lomakin; Vitaliy,9999,0,9999,0
1668353147574,ECE 200,025,103610,Mercier; Patrick Philip,9999,0,9999,0
1668353147574,ECE 200,026,103611,Meyer; Florian,9999,0,9999,0
1668353147574,ECE 200,027,103612,Milstein; Laurence B.,9999,0,9999,0
1668353147574,ECE 200,028,103613,Mir Arabbaygi; Siavash,9999,0,9999,0
1668353147574,ECE 200,029,103614,Mookherjea; Shayan,9999,0,9999,0
1668353147574,ECE 200,030,103615,Morris; Karcher William,9999,0,9999,0
1668353147574,ECE 200,031,103616,Ng; Tse Nga,9999,0,9999,0
1668353147574,ECE 200,032,103617,Nguyen; Truong Quang,9999,0,9999,0
1668353147574,ECE 200,033,103618,Nomura; Kenji,9999,0,9999,0
1668353147574,ECE 200,034,103619,Orlitsky; Alon,9999,0,9999,0
1668353147574,ECE 200,035,103620,Pal; Piya,9999,0,9999,0
1668353147574,ECE 200,036,103621,Papen; George C.,9999,0,9999,0
1668353147574,ECE 200,037,103622,Radic; Stojan,9999,0,9999,0
1668353147574,ECE 200,038,103623,Rao; Bhaskar D.,9999,0,9999,0
1668353147574,ECE 200,039,103624,Rao; Ramesh R,9999,0,9999,0
1668353147574,ECE 200,040,103625,Rebeiz; Gabriel,9999,0,9999,0
1668353147574,ECE 200,041,103626,Sanford; John R,9999,0,9999,0
1668353147574,ECE 200,042,103627,Siegel; Paul H.,9999,0,9999,0
1668353147574,ECE 200,043,103628,Sievenpiper; Daniel F.,9999,0,9999,0
1668353147574,ECE 200,044,103629,Sworder; David D.,9999,0,9999,0
1668353147574,ECE 200,045,103630,Taur; Yuan,9999,0,9999,0
1668353147574,ECE 200,046,103631,Touri; Behrouz,9999,0,9999,0
1668353147574,ECE 200,047,103632,Trivedi; Mohan M.,9999,0,9999,0
1668353147574,ECE 200,048,103633,Vasconcelos; Nuno,9999,0,9999,0
1668353147574,ECE 200,049,103634,Wang; Xiaolong,9999,0,9999,0
1668353147574,ECE 200,050,103635,Xie; Pengtao,9999,0,9999,0
1668353147574,ECE 200,051,103636,Yip; Michael,9999,0,9999,0
1668353147574,ECE 200,052,103637,Zeger; Kenneth A.,999,0,999,0
1668353147574,ECE 200,053,103638,Zhang; Xinyu,9999,0,9999,0
1668353147574,ECE 200,054,103639,Turakhia; Yatish Girish,9999,0,9999,0
1668353147574,ECE 200,055,103640,Kang; Mingu,9999,0,9999,0
1668353147574,ECE 200,056,103641,Shi; Yuanyuan,9999,0,9999,0
1668353147574,ECE 200,057,103642,Wang; Edward Jay,9999,0,9999,0
1668353147574,ECE 200,058,103643,Zheng; Yang,9999,0,9999,0
1668353147999,ECE 202,A00,103644,Kuzum; Duygu,0,0,0,0
1668353148426,ECE 212BN,A00,103646,Ng; Tse Nga,0,0,0,0
1668353148858,ECE 221,A00,111493,Staff,0,0,0,0
1668353149285,ECE 222B,A00,103647,Lomakin; Vitaliy,0,0,0,0
1668353149710,ECE 230B,A00,103648,Taur; Yuan,0,0,0,0
1668353150136,ECE 238B,A00,103649,Garay; Javier,0,0,0,0
1668353150558,ECE 240B,A00,112900,Fainman; Yeshaiahu,0,0,0,0
1668353150979,ECE 247A,A00,103650,Jokerst; Jesse Vincent,0,0,0,0
1668353151416,ECE 247B,A00,103651,Wang; Joseph,0,0,0,0
1668353151850,ECE 250,A00,103652,Siegel; Paul H.,0,0,0,0
1668353152274,ECE 251A,A00,103654,Rao; Bhaskar D.,0,0,0,0
1668353152699,ECE 257B,A00,103655,Bharadia; Dinesh,0,0,0,0
1668353153122,ECE 258A,A00,103656,Milstein; Laurence B.,0,0,0,0
1668353153555,ECE 260B,A00,103658,Kang; Mingu,0,0,0,0
1668353153990,ECE 264A,A00,103659,Galton; Ian A,0,0,0,0
1668353154414,ECE 265A,A00,103661,Gudem; Prasad S.S.,0,0,0,0
1668353154844,ECE 265D,A00,103662,Gudem; Prasad S.S.,0,0,0,0
1668353155268,ECE 268,A00,103663,Koushanfar; Farinaz,0,0,0,0
1668353155691,ECE 269,A01,103665,Pal; Piya,0,0,0,0
1668353156129,ECE 271B,A00,103666,Vasconcelos; Manuela,0,0,0,0
1668353156551,ECE 276A,A00,103667,Atanasov; Nikolay A.,0,0,0,0
1668353156983,ECE 277,A00,103668,An; Cheolhong,0,0,0,0
1668353157409,ECE 279,A00,117947,Hall; Drew A.,0,0,0,0
1668353158262,ECE 283,A00,103670,Hsueh; Tzu-Chien,0,0,0,0
1668353158685,ECE 284,A00,103671,Turakhia; Yatish Girish,0,0,0,0
1668353159113,ECE 285,A00,103672,Zheng; Yang,0,0,0,0
1668353159113,ECE 285,B00,103673,Sworder; David D.,0,0,0,0
1668353159536,ECE 287,A00,103676,Javidi; Tara,0,0,0,0
1668353159966,MATH 200B,A00,098023,Salehi Golsefidy; Alireza,12,0,15,3
1668353160391,MATH 202B,A00,098024,Rhoades; Brendon Patrick,9,0,15,6
1668353160817,MATH 203B,A00,098025,Oprea; Dragos N.,10,0,15,5
1668353161251,MATH 204B,A00,098026,Sorensen; Claus M,13,0,15,2
1668353161676,MATH 208,A00,098027,Izadi; Elham,7,0,10,3
1668353162104,MATH 209,A00,098028,Pollack; Aaron,10,0,10,0
1668353162529,MATH 211A,A00,112919,Rogalski; Daniel,9,0,10,1
1668353162954,MATH 211B,A00,112920,Seward; Brandon M.,9,0,10,1
1668353163474,MATH 218,A00,098029,Li; Bo,10,0,10,0
1668353163902,MATH 220B,A00,098030,Novak; Jonathan I,11,0,15,4
1668353164325,MATH 221A,A00,098031,Ebenfelt; Peter F,13,0,15,2
1668353164748,MATH 231B,A00,098032,Zlatos; Andrej,12,0,15,3
1668353165184,MATH 240B,A00,098033,Ni; Lei,9,0,15,6
1668353165608,MATH 243,A00,098034,Jekel; David Andrew,10,0,10,0
1668353166038,MATH 245A,A00,098035,Nie; Jiawang,0,0,15,16
1668353166459,MATH 248,A00,098036,Bejenaru; Ioan,10,0,10,0
1668353166886,MATH 250B,A00,098037,Spolaor; Luca,14,0,15,1
1668353167309,MATH 258,A00,098038,Ni; Lei,10,0,10,0
1668353167745,MATH 264B,A00,098041,Rhoades; Brendon Patrick,9,0,15,6
1668353168167,MATH 268,A00,098042,Buss; Samuel R,10,0,10,0
1668353168595,MATH 269,A00,098043,Rhoades; Brendon Patrick,10,0,10,0
1668353169030,MATH 270B,A00,098044,Li; Bo,10,0,15,5
1668353169453,MATH 272B,A00,098045,Holst; Michael J,13,0,15,2
1668353169880,MATH 273A,A00,098046,Tian; Xiaochuan,10,0,15,5
1668353170304,MATH 275,A01,098048,Tian; Xiaochuan,6,0,10,4
1668353170731,MATH 278A,A00,098049,Holst; Michael J,8,0,10,2
1668353171173,MATH 278B,A00,098050,Cloninger; Alexander,10,0,10,0
1668353171608,MATH 278C,A00,098051,Nie; Jiawang,7,0,10,3
1668353172030,MATH 280B,A00,098052,Zheng; Tianyi,8,0,15,7
1668353172456,MATH 281B,A00,098053,Bradic; Jelena,1,0,15,14
1668353172881,MATH 282B,A00,098054,Arias-Castro; Ery,0,0,15,15
1668353173305,MATH 285,A00,098055,Fitzsimmons; Patrick J,0,0,15,17
1668353173728,MATH 287B,A00,098056,Arias-Castro; Ery,2,0,15,13
1668353174155,MATH 288,A00,098057,Agarwal; Pooja,9,0,10,1
1668353174155,MATH 288,B00,098058,Zhang; Danna,8,0,10,2
1668353174155,MATH 288,C00,098059,Williams; Ruth J,9,0,10,1
1668353174577,MATH 290B,A00,098060,Roberts; Justin Deritter,13,0,15,2
1668353175003,MATH 292,A00,098061,Belmont; Eva Kinoshita,10,0,10,0
1668353175430,MATH 295,A00,098062,Suk; Andrew Hoon,48,0,50,2
1668353175855,MATH 296,A00,098063,Novak; Jonathan I,20,0,20,0
1668353176291,MATH 297,001,098064,Gamst; Anthony Collins,9997,0,9999,2
1668353679628,COGS 205,A00,101395,Chiba; Andrea,19,0,20,1
1668353680056,COGS 210B,001,101404,Greene; Deanna Jacquelyn,9998,0,9999,1
1668353680056,COGS 210B,002,101417,Xia; Haijun,9999,0,9999,0
1668353680056,COGS 210B,003,101422,Nitz; Douglas A.,9999,0,9999,0
1668353680056,COGS 210B,004,101423,Hollan; James D.,9998,0,9999,1
1668353680056,COGS 210B,005,101424,Deak; Gedeon O.,9998,0,9999,1
1668353680056,COGS 210B,006,101425,Rossano; Federico,9999,0,9999,0
1668353680479,COGS 211B,A00,101427,Coulson; Seana M,9996,0,9999,3
1668353680906,COGS 220,A00,101428,Hollan; James D.,0,0,25,25
1668353681338,COGS 229,A00,101429,Dow; Steven P,18,0,25,7
1668353681762,COGS 230,A00,101430,Klemmer; Scott R,11,0,17,6
1668353682186,COGS 234,A00,101431,Xia; Haijun,1,0,25,24
1668353682613,COGS 260,A00,101432,Kiyonaga; Anastasia,21,0,25,4
1668353682613,COGS 260,B00,101433,Kirsh; David Joel,15,0,25,10
1668353683038,CSE 202,A00,102371,Impagliazzo; Russell,0,0,0,0
1668353683463,CSE 203B,A01,102373,Cheng; Chung Kuan,0,0,0,0
1668353683899,CSE 208,A00,102374,Micciancio; Daniele,0,0,0,0
1668353684322,CSE 209A,A00,112895,Impagliazzo; Russell,0,0,15,15
1668353684752,CSE 209B,A00,108005,Bellare; Mihir,0,0,0,0
1668353685178,CSE 210,A00,113163,Coblenz; Michael J,0,0,0,0
1668353685605,CSE 219,A00,106111,Dow; Steven P,0,0,20,20
1668353686029,CSE 221,A00,102376,Voelker; Geoffrey M.,0,0,0,0
1668353686454,CSE 224,A01,102378,Porter; George M,0,0,0,0
1668353686993,CSE 229A,A00,102379,Savage; Stefan,0,0,0,0
1668353687423,CSE 229C,A00,102380,Munyaka; Imani N. S.,0,0,0,0
1668353687848,CSE 232B,A00,102382,Deutsch; Alin Bernard,0,0,0,0
1668353688271,CSE 234,A01,112904,Kumar; Arun Kumar,0,0,0,0
1668353688696,CSE 237A,A00,102383,Rosing; Tajana Simunic,0,0,0,0
1668353689133,CSE 239A,A00,102384,Deutsch; Alin Bernard,0,0,0,0
1668353689562,CSE 239B,A00,102385,Polikarpova; Nadezhda,0,0,0,0
1668353689984,CSE 240A,A00,102386,Pannuto; Patrick William,0,0,0,0
1668353690430,CSE 240B,A00,102387,Zhao; Jishen,0,0,0,0
1668353690856,CSE 241A,A00,106406,Kang; Mingu,0,0,0,0
1668353691282,CSE 249B,A00,102388,Kahng; Andrew Byun,0,0,8,8
1668353691706,CSE 251B,A01,102392,Cottrell; Garrison W,0,0,0,0
1668353691706,CSE 251B,A02,102393,Cottrell; Garrison W,0,0,0,0
1668353692129,CSE 252B,A00,102394,Ochoa; Benjamin Lawrence,0,0,0,0
1668353692562,CSE 257,A01,102396,Gao; Sicun,0,0,0,0
1668353692987,CSE 272,A00,102397,Li; Tzumao,0,0,0,0
1668353693424,CSE 274,A00,111323,Chern; Albert Ren-Haur,0,0,0,0
1668353693847,CSE 282,A00,102398,Pevzner; Pavel Arkadjevich,0,0,0,0
1668353694272,CSE 284,A00,114175,Gymrek; Melissa Ann,0,0,0,0
1668353694696,CSE 290,A00,102399,Chandraker; Manmohan Krishna,0,0,0,0
1668353694696,CSE 290,B00,102400,Vaccaro; Kristen Marie,0,0,25,25
1668353694696,CSE 290,C00,102414,Pannuto; Patrick William,0,0,25,25
1668353694696,CSE 290,D00,102427,Pevzner; Pavel Arkadjevich,0,0,0,0
1668353694696,CSE 290,E00,102429,Zhao; Jishen,0,0,0,0
1668353694696,CSE 290,F00,102436,Tullsen; Dean Michael,0,0,0,0
1668353694696,CSE 290,G00,102440,Christensen; Henrik I,0,0,20,20
1668353695133,CSE 291,A00,102443,Su; Hao,0,0,0,0
1668353695133,CSE 291,B00,102448,Polikarpova; Nadezhda,0,0,0,0
1668353695133,CSE 291,C00,102453,Vaccaro; Kristen Marie,0,0,0,0
1668353695133,CSE 291,D00,111343,Savage; Stefan,0,0,0,0
1668353695133,CSE 291,E00,116474,Claffy; Kimberly Claire,0,0,0,0
1668353695133,CSE 291,F00,116479,Pasquale; Joseph,0,0,0,0
1668353695566,CSE 293,001,119111,Bafna; Vineet,9999,0,9999,0
1668353695566,CSE 293,002,119118,Bellare; Mihir,9999,0,9999,0
1668353695566,CSE 293,003,119122,Berg-Kirkpatrick; Taylor D,9999,0,9999,0
1668353695566,CSE 293,004,119135,Christensen; Henrik I,9999,0,9999,0
1668353695566,CSE 293,005,119142,Cottrell; Garrison W,9999,0,9999,0
1668353695566,CSE 293,006,119146,Deutsch; Alin Bernard,9999,0,9999,0
1668353695566,CSE 293,007,119159,Esmaeilzadeh; Hadi,9999,0,9999,0
1668353695566,CSE 293,008,119166,Freund; Yoav,9999,0,9999,0
1668353695566,CSE 293,009,119170,Griswold; William G.,9999,0,9999,0
1668353695566,CSE 293,010,119183,Gymrek; Melissa Ann,9999,0,9999,0
1668353695566,CSE 293,011,119190,Heninger; Nadia A,9999,0,9999,0
1668353695566,CSE 293,012,119230,Impagliazzo; Russell,9999,0,9999,0
1668353695566,CSE 293,013,119232,Jhala; Ranjit,9999,0,9999,0
1668353695566,CSE 293,014,119233,Kahng; Andrew Byun,9999,0,9999,0
1668353695566,CSE 293,015,119298,Kane; Daniel Mertz,9999,0,9999,0
1668353695566,CSE 293,016,119299,Kriegman; David J,9999,0,9999,0
1668353695566,CSE 293,017,119300,Kumar; Arun Kumar,9999,0,9999,0
1668353695566,CSE 293,018,119301,Lerner; Sorin,9999,0,9999,0
1668353695566,CSE 293,019,119302,Lovett; Shachar,9999,0,9999,0
1668353695566,CSE 293,020,119303,McAuley; Julian John,9999,0,9999,0
1668353695566,CSE 293,021,119304,Micciancio; Daniele,9999,0,9999,0
1668353695566,CSE 293,022,119367,Orailoglu; Alex,9999,0,9999,0
1668353695566,CSE 293,023,119382,Paturi; Ramamohan,9999,0,9999,0
1668353695566,CSE 293,024,119404,Polikarpova; Nadezhda,9999,0,9999,0
1668353695566,CSE 293,025,119406,Politz; Joseph Gibbs,9999,0,9999,0
1668353695566,CSE 293,026,119411,Porter; George M,9999,0,9999,0
1668353695566,CSE 293,027,119414,Porter; Leonard Emerson,9999,0,9999,0
1668353695566,CSE 293,028,119416,Ramamoorthi; Ravi,9999,0,9999,0
1668353695566,CSE 293,029,119417,Sahoo; Debashis,9999,0,9999,0
1668353695566,CSE 293,030,119420,Saul; Lawrence,9999,0,9999,0
1668353695566,CSE 293,031,119421,Savage; Stefan,9999,0,9999,0
1668353695566,CSE 293,032,119425,Schulze; Jurgen P.,9999,0,9999,0
1668353695566,CSE 293,033,119426,Snoeren; Alex C.,9999,0,9999,0
1668353695566,CSE 293,034,119428,Shang; Jingbo,9999,0,9999,0
1668353695566,CSE 293,035,119430,Stefan; Deian,9999,0,9999,0
1668353695566,CSE 293,036,119431,Su; Hao,9999,0,9999,0
1668353695566,CSE 293,037,119433,Swanson; Steven James,9999,0,9999,0
1668353695566,CSE 293,038,119435,Tullsen; Dean Michael,9999,0,9999,0
1668353695566,CSE 293,039,119483,Voelker; Geoffrey M.,9999,0,9999,0
1668353695566,CSE 293,040,119537,Zhao; Jishen,9999,0,9999,0
1668353695566,CSE 293,041,119538,Zhou; Yuan-Yuan,9999,0,9999,0
1668353695566,CSE 293,042,119539,Gao; Sicun,9999,0,9999,0
1668353695566,CSE 293,043,119540,Weibel; Nadir,9999,0,9999,0
1668353695566,CSE 293,044,119541,Gupta; Rajesh K.,9999,0,9999,0
1668353695566,CSE 293,045,126410,Vaccaro; Kristen Marie,9999,0,9999,0
1668353695566,CSE 293,046,126411,Klemke; Richard,9999,0,9999,0
1668353696003,CSE 294,A00,102459,Voelker; Geoffrey M.,0,0,0,0
1668353696003,CSE 294,B00,111322,Orailoglu; Alex,0,0,0,0
1668353696442,DSE 201,A00,096914,Deutsch; Alin Bernard,30,0,30,0
1668353696864,DSE 210,A00,096915,Dasgupta; Sanjoy,30,0,30,0
1668353697286,DSE 260A,A00,096916,Altintas De Callaf; Ilkay,30,0,30,0
1668353697741,ECE 200,001,103586,Antipa; Nicholas A,9999,0,9999,0
1668353697741,ECE 200,002,103587,Atanasov; Nikolay A.,9999,0,9999,0
1668353697741,ECE 200,003,103588,Bharadia; Dinesh,9999,0,9999,0
1668353697741,ECE 200,004,103589,Cheng; Chung Kuan,9999,0,9999,0
1668353697741,ECE 200,005,103590,Cosman; Pamela C.,9999,0,9999,0
1668353697741,ECE 200,006,103591,Dayeh; Shadi Ahmad,9999,0,9999,0
1668353697741,ECE 200,007,103592,Fainman; Yeshaiahu,9999,0,9999,0
1668353697741,ECE 200,008,103593,Ford; Joseph Earl,9999,0,9999,0
1668353697741,ECE 200,009,103594,Franceschetti; Massimo,9999,0,9999,0
1668353697741,ECE 200,010,103595,Fullerton; Eric E,9999,0,9999,0
1668353697741,ECE 200,011,103596,Galton; Ian A,9999,0,9999,0
1668353697741,ECE 200,012,103597,Gilja; Vikash,9999,0,9999,0
1668353697741,ECE 200,013,103598,Hall; Drew A.,9999,0,9999,0
1668353697741,ECE 200,014,103599,Hsueh; Tzu-Chien,9999,0,9999,0
1668353697741,ECE 200,015,103600,Javidi; Tara,9999,0,9999,0
1668353697741,ECE 200,016,103601,Kahng; Andrew Byun,9999,0,9999,0
1668353697741,ECE 200,017,103602,Kim; Young-Han,9999,0,9999,0
1668353697741,ECE 200,018,103603,Koushanfar; Farinaz,9999,0,9999,0
1668353697741,ECE 200,019,103604,Kuzum; Duygu,9999,0,9999,0
1668353697741,ECE 200,020,103605,Le; Hanh-Phuc,9999,0,9999,0
1668353697741,ECE 200,021,103606,Lin; Bill,9999,0,9999,0
1668353697741,ECE 200,022,103607,Liu; Zhaowei,9998,0,9999,1
1668353697741,ECE 200,023,103608,Lo; Yu-Hwa,9999,0,9999,0
1668353697741,ECE 200,024,103609,Lomakin; Vitaliy,9999,0,9999,0
1668353697741,ECE 200,025,103610,Mercier; Patrick Philip,9999,0,9999,0
1668353697741,ECE 200,026,103611,Meyer; Florian,9999,0,9999,0
1668353697741,ECE 200,027,103612,Milstein; Laurence B.,9999,0,9999,0
1668353697741,ECE 200,028,103613,Mir Arabbaygi; Siavash,9999,0,9999,0
1668353697741,ECE 200,029,103614,Mookherjea; Shayan,9999,0,9999,0
1668353697741,ECE 200,030,103615,Morris; Karcher William,9999,0,9999,0
1668353697741,ECE 200,031,103616,Ng; Tse Nga,9999,0,9999,0
1668353697741,ECE 200,032,103617,Nguyen; Truong Quang,9999,0,9999,0
1668353697741,ECE 200,033,103618,Nomura; Kenji,9999,0,9999,0
1668353697741,ECE 200,034,103619,Orlitsky; Alon,9999,0,9999,0
1668353697741,ECE 200,035,103620,Pal; Piya,9999,0,9999,0
1668353697741,ECE 200,036,103621,Papen; George C.,9999,0,9999,0
1668353697741,ECE 200,037,103622,Radic; Stojan,9999,0,9999,0
1668353697741,ECE 200,038,103623,Rao; Bhaskar D.,9999,0,9999,0
1668353697741,ECE 200,039,103624,Rao; Ramesh R,9999,0,9999,0
1668353697741,ECE 200,040,103625,Rebeiz; Gabriel,9999,0,9999,0
1668353697741,ECE 200,041,103626,Sanford; John R,9999,0,9999,0
1668353697741,ECE 200,042,103627,Siegel; Paul H.,9999,0,9999,0
1668353697741,ECE 200,043,103628,Sievenpiper; Daniel F.,9999,0,9999,0
1668353697741,ECE 200,044,103629,Sworder; David D.,9999,0,9999,0
1668353697741,ECE 200,045,103630,Taur; Yuan,9999,0,9999,0
1668353697741,ECE 200,046,103631,Touri; Behrouz,9999,0,9999,0
1668353697741,ECE 200,047,103632,Trivedi; Mohan M.,9999,0,9999,0
1668353697741,ECE 200,048,103633,Vasconcelos; Nuno,9999,0,9999,0
1668353697741,ECE 200,049,103634,Wang; Xiaolong,9999,0,9999,0
1668353697741,ECE 200,050,103635,Xie; Pengtao,9999,0,9999,0
1668353697741,ECE 200,051,103636,Yip; Michael,9999,0,9999,0
1668353697741,ECE 200,052,103637,Zeger; Kenneth A.,999,0,999,0
1668353697741,ECE 200,053,103638,Zhang; Xinyu,9999,0,9999,0
1668353697741,ECE 200,054,103639,Turakhia; Yatish Girish,9999,0,9999,0
1668353697741,ECE 200,055,103640,Kang; Mingu,9999,0,9999,0
1668353697741,ECE 200,056,103641,Shi; Yuanyuan,9999,0,9999,0
1668353697741,ECE 200,057,103642,Wang; Edward Jay,9999,0,9999,0
1668353697741,ECE 200,058,103643,Zheng; Yang,9999,0,9999,0
1668353698166,ECE 202,A00,103644,Kuzum; Duygu,0,0,0,0
1668353698588,ECE 212BN,A00,103646,Ng; Tse Nga,0,0,0,0
1668353699011,ECE 221,A00,111493,Staff,0,0,0,0
1668353699438,ECE 222B,A00,103647,Lomakin; Vitaliy,0,0,0,0
1668353699862,ECE 230B,A00,103648,Taur; Yuan,0,0,0,0
1668353700285,ECE 238B,A00,103649,Garay; Javier,0,0,0,0
1668353700716,ECE 240B,A00,112900,Fainman; Yeshaiahu,0,0,0,0
1668353701141,ECE 247A,A00,103650,Jokerst; Jesse Vincent,0,0,0,0
1668353701572,ECE 247B,A00,103651,Wang; Joseph,0,0,0,0
1668353702001,ECE 250,A00,103652,Siegel; Paul H.,0,0,0,0
1668353702434,ECE 251A,A00,103654,Rao; Bhaskar D.,0,0,0,0
1668353702860,ECE 257B,A00,103655,Bharadia; Dinesh,0,0,0,0
1668353703286,ECE 258A,A00,103656,Milstein; Laurence B.,0,0,0,0
1668353703710,ECE 260B,A00,103658,Kang; Mingu,0,0,0,0
1668353704143,ECE 264A,A00,103659,Galton; Ian A,0,0,0,0
1668353704565,ECE 265A,A00,103661,Gudem; Prasad S.S.,0,0,0,0
1668353704992,ECE 265D,A00,103662,Gudem; Prasad S.S.,0,0,0,0
1668353705430,ECE 268,A00,103663,Koushanfar; Farinaz,0,0,0,0
1668353705860,ECE 269,A01,103665,Pal; Piya,0,0,0,0
1668353706286,ECE 271B,A00,103666,Vasconcelos; Manuela,0,0,0,0
1668353706730,ECE 276A,A00,103667,Atanasov; Nikolay A.,0,0,0,0
1668353707161,ECE 277,A00,103668,An; Cheolhong,0,0,0,0
1668353707586,ECE 279,A00,117947,Hall; Drew A.,0,0,0,0
1668353708448,ECE 283,A00,103670,Hsueh; Tzu-Chien,0,0,0,0
1668353708873,ECE 284,A00,103671,Turakhia; Yatish Girish,0,0,0,0
1668353709314,ECE 285,A00,103672,Zheng; Yang,0,0,0,0
1668353709314,ECE 285,B00,103673,Sworder; David D.,0,0,0,0
1668353709749,ECE 287,A00,103676,Javidi; Tara,0,0,0,0
1668353710186,MATH 200B,A00,098023,Salehi Golsefidy; Alireza,12,0,15,3
1668353710609,MATH 202B,A00,098024,Rhoades; Brendon Patrick,9,0,15,6
1668353711042,MATH 203B,A00,098025,Oprea; Dragos N.,10,0,15,5
1668353711465,MATH 204B,A00,098026,Sorensen; Claus M,13,0,15,2
1668353711899,MATH 208,A00,098027,Izadi; Elham,7,0,10,3
1668353712325,MATH 209,A00,098028,Pollack; Aaron,10,0,10,0
1668353712756,MATH 211A,A00,112919,Rogalski; Daniel,9,0,10,1
1668353713198,MATH 211B,A00,112920,Seward; Brandon M.,9,0,10,1
1668353713620,MATH 218,A00,098029,Li; Bo,10,0,10,0
1668353714045,MATH 220B,A00,098030,Novak; Jonathan I,11,0,15,4
1668353714471,MATH 221A,A00,098031,Ebenfelt; Peter F,13,0,15,2
1668353714908,MATH 231B,A00,098032,Zlatos; Andrej,12,0,15,3
1668353715337,MATH 240B,A00,098033,Ni; Lei,9,0,15,6
1668353715769,MATH 243,A00,098034,Jekel; David Andrew,10,0,10,0
1668353716200,MATH 245A,A00,098035,Nie; Jiawang,0,0,15,16
1668353716649,MATH 248,A00,098036,Bejenaru; Ioan,10,0,10,0
1668353717075,MATH 250B,A00,098037,Spolaor; Luca,14,0,15,1
1668353717501,MATH 258,A00,098038,Ni; Lei,10,0,10,0
1668353717944,MATH 264B,A00,098041,Rhoades; Brendon Patrick,9,0,15,6
1668353718376,MATH 268,A00,098042,Buss; Samuel R,10,0,10,0
1668353718799,MATH 269,A00,098043,Rhoades; Brendon Patrick,10,0,10,0
1668353719235,MATH 270B,A00,098044,Li; Bo,10,0,15,5
1668353719684,MATH 272B,A00,098045,Holst; Michael J,13,0,15,2
1668353720120,MATH 273A,A00,098046,Tian; Xiaochuan,10,0,15,5
1668353720547,MATH 275,A01,098048,Tian; Xiaochuan,6,0,10,4
1668353720971,MATH 278A,A00,098049,Holst; Michael J,8,0,10,2
1668353721405,MATH 278B,A00,098050,Cloninger; Alexander,10,0,10,0
1668353721829,MATH 278C,A00,098051,Nie; Jiawang,7,0,10,3
1668353722262,MATH 280B,A00,098052,Zheng; Tianyi,8,0,15,7
1668353722685,MATH 281B,A00,098053,Bradic; Jelena,1,0,15,14
1668353723111,MATH 282B,A00,098054,Arias-Castro; Ery,0,0,15,15
1668353723560,MATH 285,A00,098055,Fitzsimmons; Patrick J,0,0,15,17
1668353723983,MATH 287B,A00,098056,Arias-Castro; Ery,2,0,15,13
1668353724415,MATH 288,A00,098057,Agarwal; Pooja,9,0,10,1
1668353724415,MATH 288,B00,098058,Zhang; Danna,8,0,10,2
1668353724415,MATH 288,C00,098059,Williams; Ruth J,9,0,10,1
1668353724838,MATH 290B,A00,098060,Roberts; Justin Deritter,13,0,15,2
1668353725266,MATH 292,A00,098061,Belmont; Eva Kinoshita,10,0,10,0
1668353725695,MATH 295,A00,098062,Suk; Andrew Hoon,48,0,50,2
1668353726119,MATH 296,A00,098063,Novak; Jonathan I,20,0,20,0
1668353726545,MATH 297,001,098064,Gamst; Anthony Collins,9997,0,9999,2
1668354229083,COGS 205,A00,101395,Chiba; Andrea,19,0,20,1
1668354229529,COGS 210B,001,101404,Greene; Deanna Jacquelyn,9998,0,9999,1
1668354229529,COGS 210B,002,101417,Xia; Haijun,9999,0,9999,0
1668354229529,COGS 210B,003,101422,Nitz; Douglas A.,9999,0,9999,0
1668354229529,COGS 210B,004,101423,Hollan; James D.,9998,0,9999,1
1668354229529,COGS 210B,005,101424,Deak; Gedeon O.,9998,0,9999,1
1668354229529,COGS 210B,006,101425,Rossano; Federico,9999,0,9999,0
1668354229957,COGS 211B,A00,101427,Coulson; Seana M,9996,0,9999,3
1668354230382,COGS 220,A00,101428,Hollan; James D.,0,0,25,25
1668354230819,COGS 229,A00,101429,Dow; Steven P,18,0,25,7
1668354231245,COGS 230,A00,101430,Klemmer; Scott R,11,0,17,6
1668354231670,COGS 234,A00,101431,Xia; Haijun,1,0,25,24
1668354232101,COGS 260,A00,101432,Kiyonaga; Anastasia,21,0,25,4
1668354232101,COGS 260,B00,101433,Kirsh; David Joel,15,0,25,10
1668354232534,CSE 202,A00,102371,Impagliazzo; Russell,0,0,0,0
1668354232969,CSE 203B,A01,102373,Cheng; Chung Kuan,0,0,0,0
1668354233402,CSE 208,A00,102374,Micciancio; Daniele,0,0,0,0
1668354233828,CSE 209A,A00,112895,Impagliazzo; Russell,0,0,15,15
1668354234261,CSE 209B,A00,108005,Bellare; Mihir,0,0,0,0
1668354234695,CSE 210,A00,113163,Coblenz; Michael J,0,0,0,0
1668354235122,CSE 219,A00,106111,Dow; Steven P,0,0,20,20
1668354235548,CSE 221,A00,102376,Voelker; Geoffrey M.,0,0,0,0
1668354235975,CSE 224,A01,102378,Porter; George M,0,0,0,0
1668354236411,CSE 229A,A00,102379,Savage; Stefan,0,0,0,0
1668354236846,CSE 229C,A00,102380,Munyaka; Imani N. S.,0,0,0,0
1668354237273,CSE 232B,A00,102382,Deutsch; Alin Bernard,0,0,0,0
1668354237709,CSE 234,A01,112904,Kumar; Arun Kumar,0,0,0,0
1668354238133,CSE 237A,A00,102383,Rosing; Tajana Simunic,0,0,0,0
1668354238572,CSE 239A,A00,102384,Deutsch; Alin Bernard,0,0,0,0
1668354238994,CSE 239B,A00,102385,Polikarpova; Nadezhda,0,0,0,0
1668354239421,CSE 240A,A00,102386,Pannuto; Patrick William,0,0,0,0
1668354239844,CSE 240B,A00,102387,Zhao; Jishen,0,0,0,0
1668354240267,CSE 241A,A00,106406,Kang; Mingu,0,0,0,0
1668354240700,CSE 249B,A00,102388,Kahng; Andrew Byun,0,0,8,8
1668354241125,CSE 251B,A01,102392,Cottrell; Garrison W,0,0,0,0
1668354241125,CSE 251B,A02,102393,Cottrell; Garrison W,0,0,0,0
1668354241548,CSE 252B,A00,102394,Ochoa; Benjamin Lawrence,0,0,0,0
1668354241974,CSE 257,A01,102396,Gao; Sicun,0,0,0,0
1668354242403,CSE 272,A00,102397,Li; Tzumao,0,0,0,0
1668354242829,CSE 274,A00,111323,Chern; Albert Ren-Haur,0,0,0,0
1668354243253,CSE 282,A00,102398,Pevzner; Pavel Arkadjevich,0,0,0,0
1668354243678,CSE 284,A00,114175,Gymrek; Melissa Ann,0,0,0,0
1668354244117,CSE 290,A00,102399,Chandraker; Manmohan Krishna,0,0,0,0
1668354244117,CSE 290,B00,102400,Vaccaro; Kristen Marie,0,0,25,25
1668354244117,CSE 290,C00,102414,Pannuto; Patrick William,0,0,25,25
1668354244117,CSE 290,D00,102427,Pevzner; Pavel Arkadjevich,0,0,0,0
1668354244117,CSE 290,E00,102429,Zhao; Jishen,0,0,0,0
1668354244117,CSE 290,F00,102436,Tullsen; Dean Michael,0,0,0,0
1668354244117,CSE 290,G00,102440,Christensen; Henrik I,0,0,20,20
1668354244541,CSE 291,A00,102443,Su; Hao,0,0,0,0
1668354244541,CSE 291,B00,102448,Polikarpova; Nadezhda,0,0,0,0
1668354244541,CSE 291,C00,102453,Vaccaro; Kristen Marie,0,0,0,0
1668354244541,CSE 291,D00,111343,Savage; Stefan,0,0,0,0
1668354244541,CSE 291,E00,116474,Claffy; Kimberly Claire,0,0,0,0
1668354244541,CSE 291,F00,116479,Pasquale; Joseph,0,0,0,0
1668354244978,CSE 293,001,119111,Bafna; Vineet,9999,0,9999,0
1668354244978,CSE 293,002,119118,Bellare; Mihir,9999,0,9999,0
1668354244978,CSE 293,003,119122,Berg-Kirkpatrick; Taylor D,9999,0,9999,0
1668354244978,CSE 293,004,119135,Christensen; Henrik I,9999,0,9999,0
1668354244978,CSE 293,005,119142,Cottrell; Garrison W,9999,0,9999,0
1668354244978,CSE 293,006,119146,Deutsch; Alin Bernard,9999,0,9999,0
1668354244978,CSE 293,007,119159,Esmaeilzadeh; Hadi,9999,0,9999,0
1668354244978,CSE 293,008,119166,Freund; Yoav,9999,0,9999,0
1668354244978,CSE 293,009,119170,Griswold; William G.,9999,0,9999,0
1668354244978,CSE 293,010,119183,Gymrek; Melissa Ann,9999,0,9999,0
1668354244978,CSE 293,011,119190,Heninger; Nadia A,9999,0,9999,0
1668354244978,CSE 293,012,119230,Impagliazzo; Russell,9999,0,9999,0
1668354244978,CSE 293,013,119232,Jhala; Ranjit,9999,0,9999,0
1668354244978,CSE 293,014,119233,Kahng; Andrew Byun,9999,0,9999,0
1668354244978,CSE 293,015,119298,Kane; Daniel Mertz,9999,0,9999,0
1668354244978,CSE 293,016,119299,Kriegman; David J,9999,0,9999,0
1668354244978,CSE 293,017,119300,Kumar; Arun Kumar,9999,0,9999,0
1668354244978,CSE 293,018,119301,Lerner; Sorin,9999,0,9999,0
1668354244978,CSE 293,019,119302,Lovett; Shachar,9999,0,9999,0
1668354244978,CSE 293,020,119303,McAuley; Julian John,9999,0,9999,0
1668354244978,CSE 293,021,119304,Micciancio; Daniele,9999,0,9999,0
1668354244978,CSE 293,022,119367,Orailoglu; Alex,9999,0,9999,0
1668354244978,CSE 293,023,119382,Paturi; Ramamohan,9999,0,9999,0
1668354244978,CSE 293,024,119404,Polikarpova; Nadezhda,9999,0,9999,0
1668354244978,CSE 293,025,119406,Politz; Joseph Gibbs,9999,0,9999,0
1668354244978,CSE 293,026,119411,Porter; George M,9999,0,9999,0
1668354244978,CSE 293,027,119414,Porter; Leonard Emerson,9999,0,9999,0
1668354244978,CSE 293,028,119416,Ramamoorthi; Ravi,9999,0,9999,0
1668354244978,CSE 293,029,119417,Sahoo; Debashis,9999,0,9999,0
1668354244978,CSE 293,030,119420,Saul; Lawrence,9999,0,9999,0
1668354244978,CSE 293,031,119421,Savage; Stefan,9999,0,9999,0
1668354244978,CSE 293,032,119425,Schulze; Jurgen P.,9999,0,9999,0
1668354244978,CSE 293,033,119426,Snoeren; Alex C.,9999,0,9999,0
1668354244978,CSE 293,034,119428,Shang; Jingbo,9999,0,9999,0
1668354244978,CSE 293,035,119430,Stefan; Deian,9999,0,9999,0
1668354244978,CSE 293,036,119431,Su; Hao,9999,0,9999,0
1668354244978,CSE 293,037,119433,Swanson; Steven James,9999,0,9999,0
1668354244978,CSE 293,038,119435,Tullsen; Dean Michael,9999,0,9999,0
1668354244978,CSE 293,039,119483,Voelker; Geoffrey M.,9999,0,9999,0
1668354244978,CSE 293,040,119537,Zhao; Jishen,9999,0,9999,0
1668354244978,CSE 293,041,119538,Zhou; Yuan-Yuan,9999,0,9999,0
1668354244978,CSE 293,042,119539,Gao; Sicun,9999,0,9999,0
1668354244978,CSE 293,043,119540,Weibel; Nadir,9999,0,9999,0
1668354244978,CSE 293,044,119541,Gupta; Rajesh K.,9999,0,9999,0
1668354244978,CSE 293,045,126410,Vaccaro; Kristen Marie,9999,0,9999,0
1668354244978,CSE 293,046,126411,Klemke; Richard,9999,0,9999,0
1668354245402,CSE 294,A00,102459,Voelker; Geoffrey M.,0,0,0,0
1668354245402,CSE 294,B00,111322,Orailoglu; Alex,0,0,0,0
1668354245826,DSE 201,A00,096914,Deutsch; Alin Bernard,30,0,30,0
1668354246282,DSE 210,A00,096915,Dasgupta; Sanjoy,30,0,30,0
1668354246707,DSE 260A,A00,096916,Altintas De Callaf; Ilkay,30,0,30,0
1668354247166,ECE 200,001,103586,Antipa; Nicholas A,9999,0,9999,0
1668354247166,ECE 200,002,103587,Atanasov; Nikolay A.,9999,0,9999,0
1668354247166,ECE 200,003,103588,Bharadia; Dinesh,9999,0,9999,0
1668354247166,ECE 200,004,103589,Cheng; Chung Kuan,9999,0,9999,0
1668354247166,ECE 200,005,103590,Cosman; Pamela C.,9999,0,9999,0
1668354247166,ECE 200,006,103591,Dayeh; Shadi Ahmad,9999,0,9999,0
1668354247166,ECE 200,007,103592,Fainman; Yeshaiahu,9999,0,9999,0
1668354247166,ECE 200,008,103593,Ford; Joseph Earl,9999,0,9999,0
1668354247166,ECE 200,009,103594,Franceschetti; Massimo,9999,0,9999,0
1668354247166,ECE 200,010,103595,Fullerton; Eric E,9999,0,9999,0
1668354247166,ECE 200,011,103596,Galton; Ian A,9999,0,9999,0
1668354247166,ECE 200,012,103597,Gilja; Vikash,9999,0,9999,0
1668354247166,ECE 200,013,103598,Hall; Drew A.,9999,0,9999,0
1668354247166,ECE 200,014,103599,Hsueh; Tzu-Chien,9999,0,9999,0
1668354247166,ECE 200,015,103600,Javidi; Tara,9999,0,9999,0
1668354247166,ECE 200,016,103601,Kahng; Andrew Byun,9999,0,9999,0
1668354247166,ECE 200,017,103602,Kim; Young-Han,9999,0,9999,0
1668354247166,ECE 200,018,103603,Koushanfar; Farinaz,9999,0,9999,0
1668354247166,ECE 200,019,103604,Kuzum; Duygu,9999,0,9999,0
1668354247166,ECE 200,020,103605,Le; Hanh-Phuc,9999,0,9999,0
1668354247166,ECE 200,021,103606,Lin; Bill,9999,0,9999,0
1668354247166,ECE 200,022,103607,Liu; Zhaowei,9998,0,9999,1
1668354247166,ECE 200,023,103608,Lo; Yu-Hwa,9999,0,9999,0
1668354247166,ECE 200,024,103609,Lomakin; Vitaliy,9999,0,9999,0
1668354247166,ECE 200,025,103610,Mercier; Patrick Philip,9999,0,9999,0
1668354247166,ECE 200,026,103611,Meyer; Florian,9999,0,9999,0
1668354247166,ECE 200,027,103612,Milstein; Laurence B.,9999,0,9999,0
1668354247166,ECE 200,028,103613,Mir Arabbaygi; Siavash,9999,0,9999,0
1668354247166,ECE 200,029,103614,Mookherjea; Shayan,9999,0,9999,0
1668354247166,ECE 200,030,103615,Morris; Karcher William,9999,0,9999,0
1668354247166,ECE 200,031,103616,Ng; Tse Nga,9999,0,9999,0
1668354247166,ECE 200,032,103617,Nguyen; Truong Quang,9999,0,9999,0
1668354247166,ECE 200,033,103618,Nomura; Kenji,9999,0,9999,0
1668354247166,ECE 200,034,103619,Orlitsky; Alon,9999,0,9999,0
1668354247166,ECE 200,035,103620,Pal; Piya,9999,0,9999,0
1668354247166,ECE 200,036,103621,Papen; George C.,9999,0,9999,0
1668354247166,ECE 200,037,103622,Radic; Stojan,9999,0,9999,0
1668354247166,ECE 200,038,103623,Rao; Bhaskar D.,9999,0,9999,0
1668354247166,ECE 200,039,103624,Rao; Ramesh R,9999,0,9999,0
1668354247166,ECE 200,040,103625,Rebeiz; Gabriel,9999,0,9999,0
1668354247166,ECE 200,041,103626,Sanford; John R,9999,0,9999,0
1668354247166,ECE 200,042,103627,Siegel; Paul H.,9999,0,9999,0
1668354247166,ECE 200,043,103628,Sievenpiper; Daniel F.,9999,0,9999,0
1668354247166,ECE 200,044,103629,Sworder; David D.,9999,0,9999,0
1668354247166,ECE 200,045,103630,Taur; Yuan,9999,0,9999,0
1668354247166,ECE 200,046,103631,Touri; Behrouz,9999,0,9999,0
1668354247166,ECE 200,047,103632,Trivedi; Mohan M.,9999,0,9999,0
1668354247166,ECE 200,048,103633,Vasconcelos; Nuno,9999,0,9999,0
1668354247166,ECE 200,049,103634,Wang; Xiaolong,9999,0,9999,0
1668354247166,ECE 200,050,103635,Xie; Pengtao,9999,0,9999,0
1668354247166,ECE 200,051,103636,Yip; Michael,9999,0,9999,0
1668354247166,ECE 200,052,103637,Zeger; Kenneth A.,999,0,999,0
1668354247166,ECE 200,053,103638,Zhang; Xinyu,9999,0,9999,0
1668354247166,ECE 200,054,103639,Turakhia; Yatish Girish,9999,0,9999,0
1668354247166,ECE 200,055,103640,Kang; Mingu,9999,0,9999,0
1668354247166,ECE 200,056,103641,Shi; Yuanyuan,9999,0,9999,0
1668354247166,ECE 200,057,103642,Wang; Edward Jay,9999,0,9999,0
1668354247166,ECE 200,058,103643,Zheng; Yang,9999,0,9999,0
1668354247604,ECE 202,A00,103644,Kuzum; Duygu,0,0,0,0
1668354248029,ECE 212BN,A00,103646,Ng; Tse Nga,0,0,0,0
1668354248475,ECE 221,A00,111493,Staff,0,0,0,0
1668354248899,ECE 222B,A00,103647,Lomakin; Vitaliy,0,0,0,0
1668354249324,ECE 230B,A00,103648,Taur; Yuan,0,0,0,0
1668354249761,ECE 238B,A00,103649,Garay; Javier,0,0,0,0
1668354250183,ECE 240B,A00,112900,Fainman; Yeshaiahu,0,0,0,0
1668354250606,ECE 247A,A00,103650,Jokerst; Jesse Vincent,0,0,0,0
1668354251038,ECE 247B,A00,103651,Wang; Joseph,0,0,0,0
1668354251473,ECE 250,A00,103652,Siegel; Paul H.,0,0,0,0
1668354251910,ECE 251A,A00,103654,Rao; Bhaskar D.,0,0,0,0
1668354252333,ECE 257B,A00,103655,Bharadia; Dinesh,0,0,0,0
1668354252759,ECE 258A,A00,103656,Milstein; Laurence B.,0,0,0,0
1668354253259,ECE 260B,A00,103658,Kang; Mingu,0,0,0,0
1668354253695,ECE 264A,A00,103659,Galton; Ian A,0,0,0,0
1668354254119,ECE 265A,A00,103661,Gudem; Prasad S.S.,0,0,0,0
1668354254542,ECE 265D,A00,103662,Gudem; Prasad S.S.,0,0,0,0
1668354254966,ECE 268,A00,103663,Koushanfar; Farinaz,0,0,0,0
1668354255390,ECE 269,A01,103665,Pal; Piya,0,0,0,0
1668354255819,ECE 271B,A00,103666,Vasconcelos; Manuela,0,0,0,0
1668354256242,ECE 276A,A00,103667,Atanasov; Nikolay A.,0,0,0,0
1668354256668,ECE 277,A00,103668,An; Cheolhong,0,0,0,0
1668354257107,ECE 279,A00,117947,Hall; Drew A.,0,0,0,0
1668354257958,ECE 283,A00,103670,Hsueh; Tzu-Chien,0,0,0,0
1668354258381,ECE 284,A00,103671,Turakhia; Yatish Girish,0,0,0,0
1668354258817,ECE 285,A00,103672,Zheng; Yang,0,0,0,0
1668354258817,ECE 285,B00,103673,Sworder; David D.,0,0,0,0
1668354259243,ECE 287,A00,103676,Javidi; Tara,0,0,0,0
1668354259666,MATH 200B,A00,098023,Salehi Golsefidy; Alireza,12,0,15,3
1668354260089,MATH 202B,A00,098024,Rhoades; Brendon Patrick,9,0,15,6
1668354260512,MATH 203B,A00,098025,Oprea; Dragos N.,10,0,15,5
1668354260935,MATH 204B,A00,098026,Sorensen; Claus M,13,0,15,2
1668354261365,MATH 208,A00,098027,Izadi; Elham,7,0,10,3
1668354261789,MATH 209,A00,098028,Pollack; Aaron,10,0,10,0
1668354262214,MATH 211A,A00,112919,Rogalski; Daniel,9,0,10,1
1668354262638,MATH 211B,A00,112920,Seward; Brandon M.,9,0,10,1
1668354263067,MATH 218,A00,098029,Li; Bo,10,0,10,0
1668354263492,MATH 220B,A00,098030,Novak; Jonathan I,11,0,15,4
1668354263924,MATH 221A,A00,098031,Ebenfelt; Peter F,13,0,15,2
1668354264346,MATH 231B,A00,098032,Zlatos; Andrej,12,0,15,3
1668354264770,MATH 240B,A00,098033,Ni; Lei,9,0,15,6
1668354265206,MATH 243,A00,098034,Jekel; David Andrew,10,0,10,0
1668354265639,MATH 245A,A00,098035,Nie; Jiawang,0,0,15,16
1668354266069,MATH 248,A00,098036,Bejenaru; Ioan,10,0,10,0
1668354266493,MATH 250B,A00,098037,Spolaor; Luca,14,0,15,1
1668354266919,MATH 258,A00,098038,Ni; Lei,10,0,10,0
1668354267346,MATH 264B,A00,098041,Rhoades; Brendon Patrick,9,0,15,6
1668354267786,MATH 268,A00,098042,Buss; Samuel R,10,0,10,0
1668354268212,MATH 269,A00,098043,Rhoades; Brendon Patrick,10,0,10,0
1668354268638,MATH 270B,A00,098044,Li; Bo,10,0,15,5
1668354269060,MATH 272B,A00,098045,Holst; Michael J,13,0,15,2
1668354269493,MATH 273A,A00,098046,Tian; Xiaochuan,10,0,15,5
1668354269927,MATH 275,A01,098048,Tian; Xiaochuan,6,0,10,4
1668354270366,MATH 278A,A00,098049,Holst; Michael J,8,0,10,2
1668354270790,MATH 278B,A00,098050,Cloninger; Alexander,10,0,10,0
1668354271214,MATH 278C,A00,098051,Nie; Jiawang,7,0,10,3
1668354271637,MATH 280B,A00,098052,Zheng; Tianyi,8,0,15,7
1668354272067,MATH 281B,A00,098053,Bradic; Jelena,1,0,15,14
1668354272490,MATH 282B,A00,098054,Arias-Castro; Ery,0,0,15,15
1668354272917,MATH 285,A00,098055,Fitzsimmons; Patrick J,0,0,15,17
1668354273362,MATH 287B,A00,098056,Arias-Castro; Ery,2,0,15,13
1668354273790,MATH 288,A00,098057,Agarwal; Pooja,9,0,10,1
1668354273790,MATH 288,B00,098058,Zhang; Danna,8,0,10,2
1668354273790,MATH 288,C00,098059,Williams; Ruth J,9,0,10,1
1668354274227,MATH 290B,A00,098060,Roberts; Justin Deritter,13,0,15,2
1668354274651,MATH 292,A00,098061,Belmont; Eva Kinoshita,10,0,10,0
1668354275077,MATH 295,A00,098062,Suk; Andrew Hoon,48,0,50,2
1668354275502,MATH 296,A00,098063,Novak; Jonathan I,20,0,20,0
1668354275930,MATH 297,001,098064,Gamst; Anthony Collins,9997,0,9999,2
1668354778530,COGS 205,A00,101395,Chiba; Andrea,19,0,20,1
1668354778956,COGS 210B,001,101404,Greene; Deanna Jacquelyn,9998,0,9999,1
1668354778956,COGS 210B,002,101417,Xia; Haijun,9999,0,9999,0
1668354778956,COGS 210B,003,101422,Nitz; Douglas A.,9999,0,9999,0
1668354778956,COGS 210B,004,101423,Hollan; James D.,9998,0,9999,1
1668354778956,COGS 210B,005,101424,Deak; Gedeon O.,9998,0,9999,1
1668354778956,COGS 210B,006,101425,Rossano; Federico,9999,0,9999,0
1668354779379,COGS 211B,A00,101427,Coulson; Seana M,9996,0,9999,3
1668354779814,COGS 220,A00,101428,Hollan; James D.,0,0,25,25
1668354780241,COGS 229,A00,101429,Dow; Steven P,18,0,25,7
1668354780667,COGS 230,A00,101430,Klemmer; Scott R,11,0,17,6
1668354781092,COGS 234,A00,101431,Xia; Haijun,1,0,25,24
1668354781526,COGS 260,A00,101432,Kiyonaga; Anastasia,21,0,25,4
1668354781526,COGS 260,B00,101433,Kirsh; David Joel,15,0,25,10
1668354781950,CSE 202,A00,102371,Impagliazzo; Russell,0,0,0,0
1668354782392,CSE 203B,A01,102373,Cheng; Chung Kuan,0,0,0,0
1668354782814,CSE 208,A00,102374,Micciancio; Daniele,0,0,0,0
1668354783246,CSE 209A,A00,112895,Impagliazzo; Russell,0,0,15,15
1668354783673,CSE 209B,A00,108005,Bellare; Mihir,0,0,0,0
1668354784100,CSE 210,A00,113163,Coblenz; Michael J,0,0,0,0
1668354784542,CSE 219,A00,106111,Dow; Steven P,0,0,20,20
1668354784966,CSE 221,A00,102376,Voelker; Geoffrey M.,0,0,0,0
1668354785393,CSE 224,A01,102378,Porter; George M,0,0,0,0
1668354785819,CSE 229A,A00,102379,Savage; Stefan,0,0,0,0
1668354786256,CSE 229C,A00,102380,Munyaka; Imani N. S.,0,0,0,0
1668354786680,CSE 232B,A00,102382,Deutsch; Alin Bernard,0,0,0,0
1668354787111,CSE 234,A01,112904,Kumar; Arun Kumar,0,0,0,0
1668354787535,CSE 237A,A00,102383,Rosing; Tajana Simunic,0,0,0,0
1668354787962,CSE 239A,A00,102384,Deutsch; Alin Bernard,0,0,0,0
1668354788386,CSE 239B,A00,102385,Polikarpova; Nadezhda,0,0,0,0
1668354788820,CSE 240A,A00,102386,Pannuto; Patrick William,0,0,0,0
1668354789243,CSE 240B,A00,102387,Zhao; Jishen,0,0,0,0
1668354789668,CSE 241A,A00,106406,Kang; Mingu,0,0,0,0
1668354790111,CSE 249B,A00,102388,Kahng; Andrew Byun,0,0,8,8
1668354790536,CSE 251B,A01,102392,Cottrell; Garrison W,0,0,0,0
1668354790536,CSE 251B,A02,102393,Cottrell; Garrison W,0,0,0,0
1668354790963,CSE 252B,A00,102394,Ochoa; Benjamin Lawrence,0,0,0,0
1668354791389,CSE 257,A01,102396,Gao; Sicun,0,0,0,0
1668354791838,CSE 272,A00,102397,Li; Tzumao,0,0,0,0
1668354792284,CSE 274,A00,111323,Chern; Albert Ren-Haur,0,0,0,0
1668354792708,CSE 282,A00,102398,Pevzner; Pavel Arkadjevich,0,0,0,0
1668354793131,CSE 284,A00,114175,Gymrek; Melissa Ann,0,0,0,0
1668354793562,CSE 290,A00,102399,Chandraker; Manmohan Krishna,0,0,0,0
1668354793562,CSE 290,B00,102400,Vaccaro; Kristen Marie,0,0,25,25
1668354793562,CSE 290,C00,102414,Pannuto; Patrick William,0,0,25,25
1668354793562,CSE 290,D00,102427,Pevzner; Pavel Arkadjevich,0,0,0,0
1668354793562,CSE 290,E00,102429,Zhao; Jishen,0,0,0,0
1668354793562,CSE 290,F00,102436,Tullsen; Dean Michael,0,0,0,0
1668354793562,CSE 290,G00,102440,Christensen; Henrik I,0,0,20,20
1668354794000,CSE 291,A00,102443,Su; Hao,0,0,0,0
1668354794000,CSE 291,B00,102448,Polikarpova; Nadezhda,0,0,0,0
1668354794000,CSE 291,C00,102453,Vaccaro; Kristen Marie,0,0,0,0
1668354794000,CSE 291,D00,111343,Savage; Stefan,0,0,0,0
1668354794000,CSE 291,E00,116474,Claffy; Kimberly Claire,0,0,0,0
1668354794000,CSE 291,F00,116479,Pasquale; Joseph,0,0,0,0
1668354794428,CSE 293,001,119111,Bafna; Vineet,9999,0,9999,0
1668354794428,CSE 293,002,119118,Bellare; Mihir,9999,0,9999,0
1668354794428,CSE 293,003,119122,Berg-Kirkpatrick; Taylor D,9999,0,9999,0
1668354794428,CSE 293,004,119135,Christensen; Henrik I,9999,0,9999,0
1668354794428,CSE 293,005,119142,Cottrell; Garrison W,9999,0,9999,0
1668354794428,CSE 293,006,119146,Deutsch; Alin Bernard,9999,0,9999,0
1668354794428,CSE 293,007,119159,Esmaeilzadeh; Hadi,9999,0,9999,0
1668354794428,CSE 293,008,119166,Freund; Yoav,9999,0,9999,0
1668354794428,CSE 293,009,119170,Griswold; William G.,9999,0,9999,0
1668354794428,CSE 293,010,119183,Gymrek; Melissa Ann,9999,0,9999,0
1668354794428,CSE 293,011,119190,Heninger; Nadia A,9999,0,9999,0
1668354794428,CSE 293,012,119230,Impagliazzo; Russell,9999,0,9999,0
1668354794428,CSE 293,013,119232,Jhala; Ranjit,9999,0,9999,0
1668354794428,CSE 293,014,119233,Kahng; Andrew Byun,9999,0,9999,0
1668354794428,CSE 293,015,119298,Kane; Daniel Mertz,9999,0,9999,0
1668354794428,CSE 293,016,119299,Kriegman; David J,9999,0,9999,0
1668354794428,CSE 293,017,119300,Kumar; Arun Kumar,9999,0,9999,0
1668354794428,CSE 293,018,119301,Lerner; Sorin,9999,0,9999,0
1668354794428,CSE 293,019,119302,Lovett; Shachar,9999,0,9999,0
1668354794428,CSE 293,020,119303,McAuley; Julian John,9999,0,9999,0
1668354794428,CSE 293,021,119304,Micciancio; Daniele,9999,0,9999,0
1668354794428,CSE 293,022,119367,Orailoglu; Alex,9999,0,9999,0
1668354794428,CSE 293,023,119382,Paturi; Ramamohan,9999,0,9999,0
1668354794428,CSE 293,024,119404,Polikarpova; Nadezhda,9999,0,9999,0
1668354794428,CSE 293,025,119406,Politz; Joseph Gibbs,9999,0,9999,0
1668354794428,CSE 293,026,119411,Porter; George M,9999,0,9999,0
1668354794428,CSE 293,027,119414,Porter; Leonard Emerson,9999,0,9999,0
1668354794428,CSE 293,028,119416,Ramamoorthi; Ravi,9999,0,9999,0
1668354794428,CSE 293,029,119417,Sahoo; Debashis,9999,0,9999,0
1668354794428,CSE 293,030,119420,Saul; Lawrence,9999,0,9999,0
1668354794428,CSE 293,031,119421,Savage; Stefan,9999,0,9999,0
1668354794428,CSE 293,032,119425,Schulze; Jurgen P.,9999,0,9999,0
1668354794428,CSE 293,033,119426,Snoeren; Alex C.,9999,0,9999,0
1668354794428,CSE 293,034,119428,Shang; Jingbo,9999,0,9999,0
1668354794428,CSE 293,035,119430,Stefan; Deian,9999,0,9999,0
1668354794428,CSE 293,036,119431,Su; Hao,9999,0,9999,0
1668354794428,CSE 293,037,119433,Swanson; Steven James,9999,0,9999,0
1668354794428,CSE 293,038,119435,Tullsen; Dean Michael,9999,0,9999,0
1668354794428,CSE 293,039,119483,Voelker; Geoffrey M.,9999,0,9999,0
1668354794428,CSE 293,040,119537,Zhao; Jishen,9999,0,9999,0
1668354794428,CSE 293,041,119538,Zhou; Yuan-Yuan,9999,0,9999,0
1668354794428,CSE 293,042,119539,Gao; Sicun,9999,0,9999,0
1668354794428,CSE 293,043,119540,Weibel; Nadir,9999,0,9999,0
1668354794428,CSE 293,044,119541,Gupta; Rajesh K.,9999,0,9999,0
1668354794428,CSE 293,045,126410,Vaccaro; Kristen Marie,9999,0,9999,0
1668354794428,CSE 293,046,126411,Klemke; Richard,9999,0,9999,0
1668354794864,CSE 294,A00,102459,Voelker; Geoffrey M.,0,0,0,0
1668354794864,CSE 294,B00,111322,Orailoglu; Alex,0,0,0,0
1668354795287,DSE 201,A00,096914,Deutsch; Alin Bernard,30,0,30,0
1668354795738,DSE 210,A00,096915,Dasgupta; Sanjoy,30,0,30,0
1668354796184,DSE 260A,A00,096916,Altintas De Callaf; Ilkay,30,0,30,0
1668354796617,ECE 200,001,103586,Antipa; Nicholas A,9999,0,9999,0
1668354796617,ECE 200,002,103587,Atanasov; Nikolay A.,9999,0,9999,0
1668354796617,ECE 200,003,103588,Bharadia; Dinesh,9999,0,9999,0
1668354796617,ECE 200,004,103589,Cheng; Chung Kuan,9999,0,9999,0
1668354796617,ECE 200,005,103590,Cosman; Pamela C.,9999,0,9999,0
1668354796617,ECE 200,006,103591,Dayeh; Shadi Ahmad,9999,0,9999,0
1668354796617,ECE 200,007,103592,Fainman; Yeshaiahu,9999,0,9999,0
1668354796617,ECE 200,008,103593,Ford; Joseph Earl,9999,0,9999,0
1668354796617,ECE 200,009,103594,Franceschetti; Massimo,9999,0,9999,0
1668354796617,ECE 200,010,103595,Fullerton; Eric E,9999,0,9999,0
1668354796617,ECE 200,011,103596,Galton; Ian A,9999,0,9999,0
1668354796617,ECE 200,012,103597,Gilja; Vikash,9999,0,9999,0
1668354796617,ECE 200,013,103598,Hall; Drew A.,9999,0,9999,0
1668354796617,ECE 200,014,103599,Hsueh; Tzu-Chien,9999,0,9999,0
1668354796617,ECE 200,015,103600,Javidi; Tara,9999,0,9999,0
1668354796617,ECE 200,016,103601,Kahng; Andrew Byun,9999,0,9999,0
1668354796617,ECE 200,017,103602,Kim; Young-Han,9999,0,9999,0
1668354796617,ECE 200,018,103603,Koushanfar; Farinaz,9999,0,9999,0
1668354796617,ECE 200,019,103604,Kuzum; Duygu,9999,0,9999,0
1668354796617,ECE 200,020,103605,Le; Hanh-Phuc,9999,0,9999,0
1668354796617,ECE 200,021,103606,Lin; Bill,9999,0,9999,0
1668354796617,ECE 200,022,103607,Liu; Zhaowei,9998,0,9999,1
1668354796617,ECE 200,023,103608,Lo; Yu-Hwa,9999,0,9999,0
1668354796617,ECE 200,024,103609,Lomakin; Vitaliy,9999,0,9999,0
1668354796617,ECE 200,025,103610,Mercier; Patrick Philip,9999,0,9999,0
1668354796617,ECE 200,026,103611,Meyer; Florian,9999,0,9999,0
1668354796617,ECE 200,027,103612,Milstein; Laurence B.,9999,0,9999,0
1668354796617,ECE 200,028,103613,Mir Arabbaygi; Siavash,9999,0,9999,0
1668354796617,ECE 200,029,103614,Mookherjea; Shayan,9999,0,9999,0
1668354796617,ECE 200,030,103615,Morris; Karcher William,9999,0,9999,0
1668354796617,ECE 200,031,103616,Ng; Tse Nga,9999,0,9999,0
1668354796617,ECE 200,032,103617,Nguyen; Truong Quang,9999,0,9999,0
1668354796617,ECE 200,033,103618,Nomura; Kenji,9999,0,9999,0
1668354796617,ECE 200,034,103619,Orlitsky; Alon,9999,0,9999,0
1668354796617,ECE 200,035,103620,Pal; Piya,9999,0,9999,0
1668354796617,ECE 200,036,103621,Papen; George C.,9999,0,9999,0
1668354796617,ECE 200,037,103622,Radic; Stojan,9999,0,9999,0
1668354796617,ECE 200,038,103623,Rao; Bhaskar D.,9999,0,9999,0
1668354796617,ECE 200,039,103624,Rao; Ramesh R,9999,0,9999,0
1668354796617,ECE 200,040,103625,Rebeiz; Gabriel,9999,0,9999,0
1668354796617,ECE 200,041,103626,Sanford; John R,9999,0,9999,0
1668354796617,ECE 200,042,103627,Siegel; Paul H.,9999,0,9999,0
1668354796617,ECE 200,043,103628,Sievenpiper; Daniel F.,9999,0,9999,0
1668354796617,ECE 200,044,103629,Sworder; David D.,9999,0,9999,0
1668354796617,ECE 200,045,103630,Taur; Yuan,9999,0,9999,0
1668354796617,ECE 200,046,103631,Touri; Behrouz,9999,0,9999,0
1668354796617,ECE 200,047,103632,Trivedi; Mohan M.,9999,0,9999,0
1668354796617,ECE 200,048,103633,Vasconcelos; Nuno,9999,0,9999,0
1668354796617,ECE 200,049,103634,Wang; Xiaolong,9999,0,9999,0
1668354796617,ECE 200,050,103635,Xie; Pengtao,9999,0,9999,0
1668354796617,ECE 200,051,103636,Yip; Michael,9999,0,9999,0
1668354796617,ECE 200,052,103637,Zeger; Kenneth A.,999,0,999,0
1668354796617,ECE 200,053,103638,Zhang; Xinyu,9999,0,9999,0
1668354796617,ECE 200,054,103639,Turakhia; Yatish Girish,9999,0,9999,0
1668354796617,ECE 200,055,103640,Kang; Mingu,9999,0,9999,0
1668354796617,ECE 200,056,103641,Shi; Yuanyuan,9999,0,9999,0
1668354796617,ECE 200,057,103642,Wang; Edward Jay,9999,0,9999,0
1668354796617,ECE 200,058,103643,Zheng; Yang,9999,0,9999,0
1668354797043,ECE 202,A00,103644,Kuzum; Duygu,0,0,0,0
1668354797467,ECE 212BN,A00,103646,Ng; Tse Nga,0,0,0,0
1668354797902,ECE 221,A00,111493,Staff,0,0,0,0
1668354798326,ECE 222B,A00,103647,Lomakin; Vitaliy,0,0,0,0
1668354798758,ECE 230B,A00,103648,Taur; Yuan,0,0,0,0
1668354799185,ECE 238B,A00,103649,Garay; Javier,0,0,0,0
1668354799609,ECE 240B,A00,112900,Fainman; Yeshaiahu,0,0,0,0
1668354800036,ECE 247A,A00,103650,Jokerst; Jesse Vincent,0,0,0,0
1668354800473,ECE 247B,A00,103651,Wang; Joseph,0,0,0,0
1668354800894,ECE 250,A00,103652,Siegel; Paul H.,0,0,0,0
1668354801321,ECE 251A,A00,103654,Rao; Bhaskar D.,0,0,0,0
1668354801769,ECE 257B,A00,103655,Bharadia; Dinesh,0,0,0,0
1668354802194,ECE 258A,A00,103656,Milstein; Laurence B.,0,0,0,0
1668354802617,ECE 260B,A00,103658,Kang; Mingu,0,0,0,0
1668354803056,ECE 264A,A00,103659,Galton; Ian A,0,0,0,0
1668354803481,ECE 265A,A00,103661,Gudem; Prasad S.S.,0,0,0,0
1668354803909,ECE 265D,A00,103662,Gudem; Prasad S.S.,0,0,0,0
1668354804339,ECE 268,A00,103663,Koushanfar; Farinaz,0,0,0,0
1668354804764,ECE 269,A01,103665,Pal; Piya,0,0,0,0
1668354805198,ECE 271B,A00,103666,Vasconcelos; Manuela,0,0,0,0
1668354805625,ECE 276A,A00,103667,Atanasov; Nikolay A.,0,0,0,0
1668354806067,ECE 277,A00,103668,An; Cheolhong,0,0,0,0
1668354806492,ECE 279,A00,117947,Hall; Drew A.,0,0,0,0
1668354807341,ECE 283,A00,103670,Hsueh; Tzu-Chien,0,0,0,0
1668354807775,ECE 284,A00,103671,Turakhia; Yatish Girish,0,0,0,0
1668354808207,ECE 285,A00,103672,Zheng; Yang,0,0,0,0
1668354808207,ECE 285,B00,103673,Sworder; David D.,0,0,0,0
1668354808629,ECE 287,A00,103676,Javidi; Tara,0,0,0,0
1668354809058,MATH 200B,A00,098023,Salehi Golsefidy; Alireza,12,0,15,3
1668354809502,MATH 202B,A00,098024,Rhoades; Brendon Patrick,9,0,15,6
1668354809943,MATH 203B,A00,098025,Oprea; Dragos N.,10,0,15,5
1668354810369,MATH 204B,A00,098026,Sorensen; Claus M,13,0,15,2
1668354810798,MATH 208,A00,098027,Izadi; Elham,7,0,10,3
1668354811234,MATH 209,A00,098028,Pollack; Aaron,10,0,10,0
1668354811656,MATH 211A,A00,112919,Rogalski; Daniel,9,0,10,1
1668354812087,MATH 211B,A00,112920,Seward; Brandon M.,9,0,10,1
1668354812529,MATH 218,A00,098029,Li; Bo,10,0,10,0
1668354812952,MATH 220B,A00,098030,Novak; Jonathan I,11,0,15,4
1668354813375,MATH 221A,A00,098031,Ebenfelt; Peter F,13,0,15,2
1668354813805,MATH 231B,A00,098032,Zlatos; Andrej,12,0,15,3
1668354814231,MATH 240B,A00,098033,Ni; Lei,9,0,15,6
1668354814657,MATH 243,A00,098034,Jekel; David Andrew,10,0,10,0
1668354815086,MATH 245A,A00,098035,Nie; Jiawang,0,0,15,16
1668354815520,MATH 248,A00,098036,Bejenaru; Ioan,10,0,10,0
1668354815947,MATH 250B,A00,098037,Spolaor; Luca,14,0,15,1
1668354816373,MATH 258,A00,098038,Ni; Lei,10,0,10,0
1668354816807,MATH 264B,A00,098041,Rhoades; Brendon Patrick,9,0,15,6
1668354817233,MATH 268,A00,098042,Buss; Samuel R,10,0,10,0
1668354817656,MATH 269,A00,098043,Rhoades; Brendon Patrick,10,0,10,0
1668354818096,MATH 270B,A00,098044,Li; Bo,10,0,15,5
1668354818523,MATH 272B,A00,098045,Holst; Michael J,13,0,15,2
1668354818965,MATH 273A,A00,098046,Tian; Xiaochuan,10,0,15,5
1668354819463,MATH 275,A01,098048,Tian; Xiaochuan,6,0,10,4
1668354819893,MATH 278A,A00,098049,Holst; Michael J,8,0,10,2
1668354820318,MATH 278B,A00,098050,Cloninger; Alexander,10,0,10,0
1668354820757,MATH 278C,A00,098051,Nie; Jiawang,7,0,10,3
1668354821180,MATH 280B,A00,098052,Zheng; Tianyi,8,0,15,7
1668354821616,MATH 281B,A00,098053,Bradic; Jelena,1,0,15,14
1668354822074,MATH 282B,A00,098054,Arias-Castro; Ery,0,0,15,15
1668354822506,MATH 285,A00,098055,Fitzsimmons; Patrick J,0,0,15,17
1668354822947,MATH 287B,A00,098056,Arias-Castro; Ery,2,0,15,13
1668354823371,MATH 288,A00,098057,Agarwal; Pooja,9,0,10,1
1668354823371,MATH 288,B00,098058,Zhang; Danna,8,0,10,2
1668354823371,MATH 288,C00,098059,Williams; Ruth J,9,0,10,1
1668354823802,MATH 290B,A00,098060,Roberts; Justin Deritter,13,0,15,2
1668354824226,MATH 292,A00,098061,Belmont; Eva Kinoshita,10,0,10,0
1668354824651,MATH 295,A00,098062,Suk; Andrew Hoon,48,0,50,2
1668354825099,MATH 296,A00,098063,Novak; Jonathan I,20,0,20,0
1668354825520,MATH 297,001,098064,Gamst; Anthony Collins,9997,0,9999,2
1668355331594,COGS 205,A00,101395,Chiba; Andrea,19,0,20,1
1668355332024,COGS 210B,001,101404,Greene; Deanna Jacquelyn,9998,0,9999,1
1668355332024,COGS 210B,002,101417,Xia; Haijun,9999,0,9999,0
1668355332024,COGS 210B,003,101422,Nitz; Douglas A.,9999,0,9999,0
1668355332024,COGS 210B,004,101423,Hollan; James D.,9998,0,9999,1
1668355332024,COGS 210B,005,101424,Deak; Gedeon O.,9998,0,9999,1
1668355332024,COGS 210B,006,101425,Rossano; Federico,9999,0,9999,0
1668355332448,COGS 211B,A00,101427,Coulson; Seana M,9996,0,9999,3
1668355332884,COGS 220,A00,101428,Hollan; James D.,0,0,25,25
1668355333320,COGS 229,A00,101429,Dow; Steven P,18,0,25,7
1668355333761,COGS 230,A00,101430,Klemmer; Scott R,11,0,17,6
1668355334198,COGS 234,A00,101431,Xia; Haijun,1,0,25,24
1668355334634,COGS 260,A00,101432,Kiyonaga; Anastasia,21,0,25,4
1668355334634,COGS 260,B00,101433,Kirsh; David Joel,15,0,25,10
1668355335079,CSE 202,A00,102371,Impagliazzo; Russell,0,0,0,0
1668355335501,CSE 203B,A01,102373,Cheng; Chung Kuan,0,0,0,0
1668355335934,CSE 208,A00,102374,Micciancio; Daniele,0,0,0,0
1668355336361,CSE 209A,A00,112895,Impagliazzo; Russell,0,0,15,15
1668355336785,CSE 209B,A00,108005,Bellare; Mihir,0,0,0,0
1668355337208,CSE 210,A00,113163,Coblenz; Michael J,0,0,0,0
1668355337656,CSE 219,A00,106111,Dow; Steven P,0,0,20,20
1668355338085,CSE 221,A00,102376,Voelker; Geoffrey M.,0,0,0,0
1668355338537,CSE 224,A01,102378,Porter; George M,0,0,0,0
1668355338968,CSE 229A,A00,102379,Savage; Stefan,0,0,0,0
1668355339409,CSE 229C,A00,102380,Munyaka; Imani N. S.,0,0,0,0
1668355339851,CSE 232B,A00,102382,Deutsch; Alin Bernard,0,0,0,0
1668355340306,CSE 234,A01,112904,Kumar; Arun Kumar,0,0,0,0
1668355340733,CSE 237A,A00,102383,Rosing; Tajana Simunic,0,0,0,0
1668355341167,CSE 239A,A00,102384,Deutsch; Alin Bernard,0,0,0,0
1668355341594,CSE 239B,A00,102385,Polikarpova; Nadezhda,0,0,0,0
1668355342040,CSE 240A,A00,102386,Pannuto; Patrick William,0,0,0,0
1668355342471,CSE 240B,A00,102387,Zhao; Jishen,0,0,0,0
1668355342932,CSE 241A,A00,106406,Kang; Mingu,0,0,0,0
1668355343357,CSE 249B,A00,102388,Kahng; Andrew Byun,0,0,8,8
1668355343784,CSE 251B,A01,102392,Cottrell; Garrison W,0,0,0,0
1668355343784,CSE 251B,A02,102393,Cottrell; Garrison W,0,0,0,0
1668355344227,CSE 252B,A00,102394,Ochoa; Benjamin Lawrence,0,0,0,0
1668355344658,CSE 257,A01,102396,Gao; Sicun,0,0,0,0
1668355345082,CSE 272,A00,102397,Li; Tzumao,0,0,0,0
1668355345509,CSE 274,A00,111323,Chern; Albert Ren-Haur,0,0,0,0
1668355346049,CSE 282,A00,102398,Pevzner; Pavel Arkadjevich,0,0,0,0
1668355346479,CSE 284,A00,114175,Gymrek; Melissa Ann,0,0,0,0
1668355346919,CSE 290,A00,102399,Chandraker; Manmohan Krishna,0,0,0,0
1668355346919,CSE 290,B00,102400,Vaccaro; Kristen Marie,0,0,25,25
1668355346919,CSE 290,C00,102414,Pannuto; Patrick William,0,0,25,25
1668355346919,CSE 290,D00,102427,Pevzner; Pavel Arkadjevich,0,0,0,0
1668355346919,CSE 290,E00,102429,Zhao; Jishen,0,0,0,0
1668355346919,CSE 290,F00,102436,Tullsen; Dean Michael,0,0,0,0
1668355346919,CSE 290,G00,102440,Christensen; Henrik I,0,0,20,20
1668355347343,CSE 291,A00,102443,Su; Hao,0,0,0,0
1668355347343,CSE 291,B00,102448,Polikarpova; Nadezhda,0,0,0,0
1668355347343,CSE 291,C00,102453,Vaccaro; Kristen Marie,0,0,0,0
1668355347343,CSE 291,D00,111343,Savage; Stefan,0,0,0,0
1668355347343,CSE 291,E00,116474,Claffy; Kimberly Claire,0,0,0,0
1668355347343,CSE 291,F00,116479,Pasquale; Joseph,0,0,0,0
1668355347815,CSE 293,001,119111,Bafna; Vineet,9999,0,9999,0
1668355347815,CSE 293,002,119118,Bellare; Mihir,9999,0,9999,0
1668355347815,CSE 293,003,119122,Berg-Kirkpatrick; Taylor D,9999,0,9999,0
1668355347815,CSE 293,004,119135,Christensen; Henrik I,9999,0,9999,0
1668355347815,CSE 293,005,119142,Cottrell; Garrison W,9999,0,9999,0
1668355347815,CSE 293,006,119146,Deutsch; Alin Bernard,9999,0,9999,0
1668355347815,CSE 293,007,119159,Esmaeilzadeh; Hadi,9999,0,9999,0
1668355347815,CSE 293,008,119166,Freund; Yoav,9999,0,9999,0
1668355347815,CSE 293,009,119170,Griswold; William G.,9999,0,9999,0
1668355347815,CSE 293,010,119183,Gymrek; Melissa Ann,9999,0,9999,0
1668355347815,CSE 293,011,119190,Heninger; Nadia A,9999,0,9999,0
1668355347815,CSE 293,012,119230,Impagliazzo; Russell,9999,0,9999,0
1668355347815,CSE 293,013,119232,Jhala; Ranjit,9999,0,9999,0
1668355347815,CSE 293,014,119233,Kahng; Andrew Byun,9999,0,9999,0
1668355347815,CSE 293,015,119298,Kane; Daniel Mertz,9999,0,9999,0
1668355347815,CSE 293,016,119299,Kriegman; David J,9999,0,9999,0
1668355347815,CSE 293,017,119300,Kumar; Arun Kumar,9999,0,9999,0
1668355347815,CSE 293,018,119301,Lerner; Sorin,9999,0,9999,0
1668355347815,CSE 293,019,119302,Lovett; Shachar,9999,0,9999,0
1668355347815,CSE 293,020,119303,McAuley; Julian John,9999,0,9999,0
1668355347815,CSE 293,021,119304,Micciancio; Daniele,9999,0,9999,0
1668355347815,CSE 293,022,119367,Orailoglu; Alex,9999,0,9999,0
1668355347815,CSE 293,023,119382,Paturi; Ramamohan,9999,0,9999,0
1668355347815,CSE 293,024,119404,Polikarpova; Nadezhda,9999,0,9999,0
1668355347815,CSE 293,025,119406,Politz; Joseph Gibbs,9999,0,9999,0
1668355347815,CSE 293,026,119411,Porter; George M,9999,0,9999,0
1668355347815,CSE 293,027,119414,Porter; Leonard Emerson,9999,0,9999,0
1668355347815,CSE 293,028,119416,Ramamoorthi; Ravi,9999,0,9999,0
1668355347815,CSE 293,029,119417,Sahoo; Debashis,9999,0,9999,0
1668355347815,CSE 293,030,119420,Saul; Lawrence,9999,0,9999,0
1668355347815,CSE 293,031,119421,Savage; Stefan,9999,0,9999,0
1668355347815,CSE 293,032,119425,Schulze; Jurgen P.,9999,0,9999,0
1668355347815,CSE 293,033,119426,Snoeren; Alex C.,9999,0,9999,0
1668355347815,CSE 293,034,119428,Shang; Jingbo,9999,0,9999,0
1668355347815,CSE 293,035,119430,Stefan; Deian,9999,0,9999,0
1668355347815,CSE 293,036,119431,Su; Hao,9999,0,9999,0
1668355347815,CSE 293,037,119433,Swanson; Steven James,9999,0,9999,0
1668355347815,CSE 293,038,119435,Tullsen; Dean Michael,9999,0,9999,0
1668355347815,CSE 293,039,119483,Voelker; Geoffrey M.,9999,0,9999,0
1668355347815,CSE 293,040,119537,Zhao; Jishen,9999,0,9999,0
1668355347815,CSE 293,041,119538,Zhou; Yuan-Yuan,9999,0,9999,0
1668355347815,CSE 293,042,119539,Gao; Sicun,9999,0,9999,0
1668355347815,CSE 293,043,119540,Weibel; Nadir,9999,0,9999,0
1668355347815,CSE 293,044,119541,Gupta; Rajesh K.,9999,0,9999,0
1668355347815,CSE 293,045,126410,Vaccaro; Kristen Marie,9999,0,9999,0
1668355347815,CSE 293,046,126411,Klemke; Richard,9999,0,9999,0
1668355348249,CSE 294,A00,102459,Voelker; Geoffrey M.,0,0,0,0
1668355348249,CSE 294,B00,111322,Orailoglu; Alex,0,0,0,0
1668355348673,DSE 201,A00,096914,Deutsch; Alin Bernard,30,0,30,0
1668355349106,DSE 210,A00,096915,Dasgupta; Sanjoy,30,0,30,0
1668355349533,DSE 260A,A00,096916,Altintas De Callaf; Ilkay,30,0,30,0
1668355349989,ECE 200,001,103586,Antipa; Nicholas A,9999,0,9999,0
1668355349989,ECE 200,002,103587,Atanasov; Nikolay A.,9999,0,9999,0
1668355349989,ECE 200,003,103588,Bharadia; Dinesh,9999,0,9999,0
1668355349989,ECE 200,004,103589,Cheng; Chung Kuan,9999,0,9999,0
1668355349989,ECE 200,005,103590,Cosman; Pamela C.,9999,0,9999,0
1668355349989,ECE 200,006,103591,Dayeh; Shadi Ahmad,9999,0,9999,0
1668355349989,ECE 200,007,103592,Fainman; Yeshaiahu,9999,0,9999,0
1668355349989,ECE 200,008,103593,Ford; Joseph Earl,9999,0,9999,0
1668355349989,ECE 200,009,103594,Franceschetti; Massimo,9999,0,9999,0
1668355349989,ECE 200,010,103595,Fullerton; Eric E,9999,0,9999,0
1668355349989,ECE 200,011,103596,Galton; Ian A,9999,0,9999,0
1668355349989,ECE 200,012,103597,Gilja; Vikash,9999,0,9999,0
1668355349989,ECE 200,013,103598,Hall; Drew A.,9999,0,9999,0
1668355349989,ECE 200,014,103599,Hsueh; Tzu-Chien,9999,0,9999,0
1668355349989,ECE 200,015,103600,Javidi; Tara,9999,0,9999,0
1668355349989,ECE 200,016,103601,Kahng; Andrew Byun,9999,0,9999,0
1668355349989,ECE 200,017,103602,Kim; Young-Han,9999,0,9999,0
1668355349989,ECE 200,018,103603,Koushanfar; Farinaz,9999,0,9999,0
1668355349989,ECE 200,019,103604,Kuzum; Duygu,9999,0,9999,0
1668355349989,ECE 200,020,103605,Le; Hanh-Phuc,9999,0,9999,0
1668355349989,ECE 200,021,103606,Lin; Bill,9999,0,9999,0
1668355349989,ECE 200,022,103607,Liu; Zhaowei,9998,0,9999,1
1668355349989,ECE 200,023,103608,Lo; Yu-Hwa,9999,0,9999,0
1668355349989,ECE 200,024,103609,Lomakin; Vitaliy,9999,0,9999,0
1668355349989,ECE 200,025,103610,Mercier; Patrick Philip,9999,0,9999,0
1668355349989,ECE 200,026,103611,Meyer; Florian,9999,0,9999,0
1668355349989,ECE 200,027,103612,Milstein; Laurence B.,9999,0,9999,0
1668355349989,ECE 200,028,103613,Mir Arabbaygi; Siavash,9999,0,9999,0
1668355349989,ECE 200,029,103614,Mookherjea; Shayan,9999,0,9999,0
1668355349989,ECE 200,030,103615,Morris; Karcher William,9999,0,9999,0
1668355349989,ECE 200,031,103616,Ng; Tse Nga,9999,0,9999,0
1668355349989,ECE 200,032,103617,Nguyen; Truong Quang,9999,0,9999,0
1668355349989,ECE 200,033,103618,Nomura; Kenji,9999,0,9999,0
1668355349989,ECE 200,034,103619,Orlitsky; Alon,9999,0,9999,0
1668355349989,ECE 200,035,103620,Pal; Piya,9999,0,9999,0
1668355349989,ECE 200,036,103621,Papen; George C.,9999,0,9999,0
1668355349989,ECE 200,037,103622,Radic; Stojan,9999,0,9999,0
1668355349989,ECE 200,038,103623,Rao; Bhaskar D.,9999,0,9999,0
1668355349989,ECE 200,039,103624,Rao; Ramesh R,9999,0,9999,0
1668355349989,ECE 200,040,103625,Rebeiz; Gabriel,9999,0,9999,0
1668355349989,ECE 200,041,103626,Sanford; John R,9999,0,9999,0
1668355349989,ECE 200,042,103627,Siegel; Paul H.,9999,0,9999,0
1668355349989,ECE 200,043,103628,Sievenpiper; Daniel F.,9999,0,9999,0
1668355349989,ECE 200,044,103629,Sworder; David D.,9999,0,9999,0
1668355349989,ECE 200,045,103630,Taur; Yuan,9999,0,9999,0
1668355349989,ECE 200,046,103631,Touri; Behrouz,9999,0,9999,0
1668355349989,ECE 200,047,103632,Trivedi; Mohan M.,9999,0,9999,0
1668355349989,ECE 200,048,103633,Vasconcelos; Nuno,9999,0,9999,0
1668355349989,ECE 200,049,103634,Wang; Xiaolong,9999,0,9999,0
1668355349989,ECE 200,050,103635,Xie; Pengtao,9999,0,9999,0
1668355349989,ECE 200,051,103636,Yip; Michael,9999,0,9999,0
1668355349989,ECE 200,052,103637,Zeger; Kenneth A.,999,0,999,0
1668355349989,ECE 200,053,103638,Zhang; Xinyu,9999,0,9999,0
1668355349989,ECE 200,054,103639,Turakhia; Yatish Girish,9999,0,9999,0
1668355349989,ECE 200,055,103640,Kang; Mingu,9999,0,9999,0
1668355349989,ECE 200,056,103641,Shi; Yuanyuan,9999,0,9999,0
1668355349989,ECE 200,057,103642,Wang; Edward Jay,9999,0,9999,0
1668355349989,ECE 200,058,103643,Zheng; Yang,9999,0,9999,0
1668355350432,ECE 202,A00,103644,Kuzum; Duygu,0,0,0,0
1668355350866,ECE 212BN,A00,103646,Ng; Tse Nga,0,0,0,0
1668355351292,ECE 221,A00,111493,Staff,0,0,0,0
1668355351743,ECE 222B,A00,103647,Lomakin; Vitaliy,0,0,0,0
1668355352169,ECE 230B,A00,103648,Taur; Yuan,0,0,0,0
1668355352596,ECE 238B,A00,103649,Garay; Javier,0,0,0,0
1668355353019,ECE 240B,A00,112900,Fainman; Yeshaiahu,0,0,0,0
1668355353442,ECE 247A,A00,103650,Jokerst; Jesse Vincent,0,0,0,0
1668355353880,ECE 247B,A00,103651,Wang; Joseph,0,0,0,0
1668355354319,ECE 250,A00,103652,Siegel; Paul H.,0,0,0,0
1668355354741,ECE 251A,A00,103654,Rao; Bhaskar D.,0,0,0,0
1668355355169,ECE 257B,A00,103655,Bharadia; Dinesh,0,0,0,0
1668355355610,ECE 258A,A00,103656,Milstein; Laurence B.,0,0,0,0
1668355356043,ECE 260B,A00,103658,Kang; Mingu,0,0,0,0
1668355356488,ECE 264A,A00,103659,Galton; Ian A,0,0,0,0
1668355356914,ECE 265A,A00,103661,Gudem; Prasad S.S.,0,0,0,0
1668355357341,ECE 265D,A00,103662,Gudem; Prasad S.S.,0,0,0,0
1668355357766,ECE 268,A00,103663,Koushanfar; Farinaz,0,0,0,0
1668355358203,ECE 269,A01,103665,Pal; Piya,0,0,0,0
1668355358631,ECE 271B,A00,103666,Vasconcelos; Manuela,0,0,0,0
1668355359055,ECE 276A,A00,103667,Atanasov; Nikolay A.,0,0,0,0
1668355359501,ECE 277,A00,103668,An; Cheolhong,0,0,0,0
1668355359927,ECE 279,A00,117947,Hall; Drew A.,0,0,0,0
1668355360799,ECE 283,A00,103670,Hsueh; Tzu-Chien,0,0,0,0
1668355361227,ECE 284,A00,103671,Turakhia; Yatish Girish,0,0,0,0
1668355361659,ECE 285,A00,103672,Zheng; Yang,0,0,0,0
1668355361659,ECE 285,B00,103673,Sworder; David D.,0,0,0,0
1668355362094,ECE 287,A00,103676,Javidi; Tara,0,0,0,0
1668355362520,MATH 200B,A00,098023,Salehi Golsefidy; Alireza,12,0,15,3
1668355362951,MATH 202B,A00,098024,Rhoades; Brendon Patrick,9,0,15,6
1668355363378,MATH 203B,A00,098025,Oprea; Dragos N.,10,0,15,5
1668355363807,MATH 204B,A00,098026,Sorensen; Claus M,13,0,15,2
1668355364242,MATH 208,A00,098027,Izadi; Elham,7,0,10,3
1668355364668,MATH 209,A00,098028,Pollack; Aaron,10,0,10,0
1668355365099,MATH 211A,A00,112919,Rogalski; Daniel,9,0,10,1
1668355365524,MATH 211B,A00,112920,Seward; Brandon M.,9,0,10,1
1668355365970,MATH 218,A00,098029,Li; Bo,10,0,10,0
1668355366397,MATH 220B,A00,098030,Novak; Jonathan I,11,0,15,4
1668355366848,MATH 221A,A00,098031,Ebenfelt; Peter F,13,0,15,2
1668355367280,MATH 231B,A00,098032,Zlatos; Andrej,12,0,15,3
1668355367713,MATH 240B,A00,098033,Ni; Lei,9,0,15,6
1668355368141,MATH 243,A00,098034,Jekel; David Andrew,10,0,10,0
1668355368575,MATH 245A,A00,098035,Nie; Jiawang,0,0,15,16
1668355369009,MATH 248,A00,098036,Bejenaru; Ioan,10,0,10,0
1668355369435,MATH 250B,A00,098037,Spolaor; Luca,14,0,15,1
1668355369871,MATH 258,A00,098038,Ni; Lei,10,0,10,0
1668355370307,MATH 264B,A00,098041,Rhoades; Brendon Patrick,9,0,15,6
1668355370735,MATH 268,A00,098042,Buss; Samuel R,10,0,10,0
1668355371162,MATH 269,A00,098043,Rhoades; Brendon Patrick,10,0,10,0
1668355371585,MATH 270B,A00,098044,Li; Bo,10,0,15,5
1668355372015,MATH 272B,A00,098045,Holst; Michael J,13,0,15,2
1668355372449,MATH 273A,A00,098046,Tian; Xiaochuan,10,0,15,5
1668355372899,MATH 275,A01,098048,Tian; Xiaochuan,6,0,10,4
1668355373332,MATH 278A,A00,098049,Holst; Michael J,8,0,10,2
1668355373755,MATH 278B,A00,098050,Cloninger; Alexander,10,0,10,0
1668355374178,MATH 278C,A00,098051,Nie; Jiawang,7,0,10,3
1668355374620,MATH 280B,A00,098052,Zheng; Tianyi,8,0,15,7
1668355375043,MATH 281B,A00,098053,Bradic; Jelena,1,0,15,14
1668355375465,MATH 282B,A00,098054,Arias-Castro; Ery,0,0,15,15
1668355375893,MATH 285,A00,098055,Fitzsimmons; Patrick J,0,0,15,17
1668355376330,MATH 287B,A00,098056,Arias-Castro; Ery,2,0,15,13
1668355376769,MATH 288,A00,098057,Agarwal; Pooja,9,0,10,1
1668355376769,MATH 288,B00,098058,Zhang; Danna,8,0,10,2
1668355376769,MATH 288,C00,098059,Williams; Ruth J,9,0,10,1
1668355377196,MATH 290B,A00,098060,Roberts; Justin Deritter,13,0,15,2
1668355377622,MATH 292,A00,098061,Belmont; Eva Kinoshita,10,0,10,0
1668355378062,MATH 295,A00,098062,Suk; Andrew Hoon,48,0,50,2
1668355378507,MATH 296,A00,098063,Novak; Jonathan I,20,0,20,0
1668355378933,MATH 297,001,098064,Gamst; Anthony Collins,9997,0,9999,2
1668355884321,COGS 205,A00,101395,Chiba; Andrea,19,0,20,1
1668355884747,COGS 210B,001,101404,Greene; Deanna Jacquelyn,9998,0,9999,1
1668355884747,COGS 210B,002,101417,Xia; Haijun,9999,0,9999,0
1668355884747,COGS 210B,003,101422,Nitz; Douglas A.,9999,0,9999,0
1668355884747,COGS 210B,004,101423,Hollan; James D.,9998,0,9999,1
1668355884747,COGS 210B,005,101424,Deak; Gedeon O.,9998,0,9999,1
1668355884747,COGS 210B,006,101425,Rossano; Federico,9999,0,9999,0
1668355885168,COGS 211B,A00,101427,Coulson; Seana M,9996,0,9999,3
1668355885603,COGS 220,A00,101428,Hollan; James D.,0,0,25,25
1668355886029,COGS 229,A00,101429,Dow; Steven P,18,0,25,7
1668355886453,COGS 230,A00,101430,Klemmer; Scott R,11,0,17,6
1668355886876,COGS 234,A00,101431,Xia; Haijun,1,0,25,24
1668355887300,COGS 260,A00,101432,Kiyonaga; Anastasia,21,0,25,4
1668355887300,COGS 260,B00,101433,Kirsh; David Joel,15,0,25,10
1668355887724,CSE 202,A00,102371,Impagliazzo; Russell,0,0,0,0
1668355888157,CSE 203B,A01,102373,Cheng; Chung Kuan,0,0,0,0
1668355888580,CSE 208,A00,102374,Micciancio; Daniele,0,0,0,0
1668355889003,CSE 209A,A00,112895,Impagliazzo; Russell,0,0,15,15
1668355889439,CSE 209B,A00,108005,Bellare; Mihir,0,0,0,0
1668355889875,CSE 210,A00,113163,Coblenz; Michael J,0,0,0,0
1668355890300,CSE 219,A00,106111,Dow; Steven P,0,0,20,20
1668355890724,CSE 221,A00,102376,Voelker; Geoffrey M.,0,0,0,0
1668355891148,CSE 224,A01,102378,Porter; George M,0,0,0,0
1668355891571,CSE 229A,A00,102379,Savage; Stefan,0,0,0,0
1668355891992,CSE 229C,A00,102380,Munyaka; Imani N. S.,0,0,0,0
1668355892422,CSE 232B,A00,102382,Deutsch; Alin Bernard,0,0,0,0
1668355892848,CSE 234,A01,112904,Kumar; Arun Kumar,0,0,0,0
1668355893272,CSE 237A,A00,102383,Rosing; Tajana Simunic,0,0,0,0
1668355893709,CSE 239A,A00,102384,Deutsch; Alin Bernard,0,0,0,0
1668355894132,CSE 239B,A00,102385,Polikarpova; Nadezhda,0,0,0,0
1668355894578,CSE 240A,A00,102386,Pannuto; Patrick William,0,0,0,0
1668355895002,CSE 240B,A00,102387,Zhao; Jishen,0,0,0,0
1668355895448,CSE 241A,A00,106406,Kang; Mingu,0,0,0,0
1668355895874,CSE 249B,A00,102388,Kahng; Andrew Byun,0,0,8,8
1668355896316,CSE 251B,A01,102392,Cottrell; Garrison W,0,0,0,0
1668355896316,CSE 251B,A02,102393,Cottrell; Garrison W,0,0,0,0
1668355896740,CSE 252B,A00,102394,Ochoa; Benjamin Lawrence,0,0,0,0
1668355897165,CSE 257,A01,102396,Gao; Sicun,0,0,0,0
1668355897588,CSE 272,A00,102397,Li; Tzumao,0,0,0,0
1668355898011,CSE 274,A00,111323,Chern; Albert Ren-Haur,0,0,0,0
1668355898448,CSE 282,A00,102398,Pevzner; Pavel Arkadjevich,0,0,0,0
1668355898875,CSE 284,A00,114175,Gymrek; Melissa Ann,0,0,0,0
1668355899316,CSE 290,A00,102399,Chandraker; Manmohan Krishna,0,0,0,0
1668355899316,CSE 290,B00,102400,Vaccaro; Kristen Marie,0,0,25,25
1668355899316,CSE 290,C00,102414,Pannuto; Patrick William,0,0,25,25
1668355899316,CSE 290,D00,102427,Pevzner; Pavel Arkadjevich,0,0,0,0
1668355899316,CSE 290,E00,102429,Zhao; Jishen,0,0,0,0
1668355899316,CSE 290,F00,102436,Tullsen; Dean Michael,0,0,0,0
1668355899316,CSE 290,G00,102440,Christensen; Henrik I,0,0,20,20
1668355899745,CSE 291,A00,102443,Su; Hao,0,0,0,0
1668355899745,CSE 291,B00,102448,Polikarpova; Nadezhda,0,0,0,0
1668355899745,CSE 291,C00,102453,Vaccaro; Kristen Marie,0,0,0,0
1668355899745,CSE 291,D00,111343,Savage; Stefan,0,0,0,0
1668355899745,CSE 291,E00,116474,Claffy; Kimberly Claire,0,0,0,0
1668355899745,CSE 291,F00,116479,Pasquale; Joseph,0,0,0,0
1668355900171,CSE 293,001,119111,Bafna; Vineet,9999,0,9999,0
1668355900171,CSE 293,002,119118,Bellare; Mihir,9999,0,9999,0
1668355900171,CSE 293,003,119122,Berg-Kirkpatrick; Taylor D,9999,0,9999,0
1668355900171,CSE 293,004,119135,Christensen; Henrik I,9999,0,9999,0
1668355900171,CSE 293,005,119142,Cottrell; Garrison W,9999,0,9999,0
1668355900171,CSE 293,006,119146,Deutsch; Alin Bernard,9999,0,9999,0
1668355900171,CSE 293,007,119159,Esmaeilzadeh; Hadi,9999,0,9999,0
1668355900171,CSE 293,008,119166,Freund; Yoav,9999,0,9999,0
1668355900171,CSE 293,009,119170,Griswold; William G.,9999,0,9999,0
1668355900171,CSE 293,010,119183,Gymrek; Melissa Ann,9999,0,9999,0
1668355900171,CSE 293,011,119190,Heninger; Nadia A,9999,0,9999,0
1668355900171,CSE 293,012,119230,Impagliazzo; Russell,9999,0,9999,0
1668355900171,CSE 293,013,119232,Jhala; Ranjit,9999,0,9999,0
1668355900171,CSE 293,014,119233,Kahng; Andrew Byun,9999,0,9999,0
1668355900171,CSE 293,015,119298,Kane; Daniel Mertz,9999,0,9999,0
1668355900171,CSE 293,016,119299,Kriegman; David J,9999,0,9999,0
1668355900171,CSE 293,017,119300,Kumar; Arun Kumar,9999,0,9999,0
1668355900171,CSE 293,018,119301,Lerner; Sorin,9999,0,9999,0
1668355900171,CSE 293,019,119302,Lovett; Shachar,9999,0,9999,0
1668355900171,CSE 293,020,119303,McAuley; Julian John,9999,0,9999,0
1668355900171,CSE 293,021,119304,Micciancio; Daniele,9999,0,9999,0
1668355900171,CSE 293,022,119367,Orailoglu; Alex,9999,0,9999,0
1668355900171,CSE 293,023,119382,Paturi; Ramamohan,9999,0,9999,0
1668355900171,CSE 293,024,119404,Polikarpova; Nadezhda,9999,0,9999,0
1668355900171,CSE 293,025,119406,Politz; Joseph Gibbs,9999,0,9999,0
1668355900171,CSE 293,026,119411,Porter; George M,9999,0,9999,0
1668355900171,CSE 293,027,119414,Porter; Leonard Emerson,9999,0,9999,0
1668355900171,CSE 293,028,119416,Ramamoorthi; Ravi,9999,0,9999,0
1668355900171,CSE 293,029,119417,Sahoo; Debashis,9999,0,9999,0
1668355900171,CSE 293,030,119420,Saul; Lawrence,9999,0,9999,0
1668355900171,CSE 293,031,119421,Savage; Stefan,9999,0,9999,0
1668355900171,CSE 293,032,119425,Schulze; Jurgen P.,9999,0,9999,0
1668355900171,CSE 293,033,119426,Snoeren; Alex C.,9999,0,9999,0
1668355900171,CSE 293,034,119428,Shang; Jingbo,9999,0,9999,0
1668355900171,CSE 293,035,119430,Stefan; Deian,9999,0,9999,0
1668355900171,CSE 293,036,119431,Su; Hao,9999,0,9999,0
1668355900171,CSE 293,037,119433,Swanson; Steven James,9999,0,9999,0
1668355900171,CSE 293,038,119435,Tullsen; Dean Michael,9999,0,9999,0
1668355900171,CSE 293,039,119483,Voelker; Geoffrey M.,9999,0,9999,0
1668355900171,CSE 293,040,119537,Zhao; Jishen,9999,0,9999,0
1668355900171,CSE 293,041,119538,Zhou; Yuan-Yuan,9999,0,9999,0
1668355900171,CSE 293,042,119539,Gao; Sicun,9999,0,9999,0
1668355900171,CSE 293,043,119540,Weibel; Nadir,9999,0,9999,0
1668355900171,CSE 293,044,119541,Gupta; Rajesh K.,9999,0,9999,0
1668355900171,CSE 293,045,126410,Vaccaro; Kristen Marie,9999,0,9999,0
1668355900171,CSE 293,046,126411,Klemke; Richard,9999,0,9999,0
1668355900598,CSE 294,A00,102459,Voelker; Geoffrey M.,0,0,0,0
1668355900598,CSE 294,B00,111322,Orailoglu; Alex,0,0,0,0
1668355901023,DSE 201,A00,096914,Deutsch; Alin Bernard,30,0,30,0
1668355901447,DSE 210,A00,096915,Dasgupta; Sanjoy,30,0,30,0
1668355901872,DSE 260A,A00,096916,Altintas De Callaf; Ilkay,30,0,30,0
1668355902299,ECE 200,001,103586,Antipa; Nicholas A,9999,0,9999,0
1668355902299,ECE 200,002,103587,Atanasov; Nikolay A.,9999,0,9999,0
1668355902299,ECE 200,003,103588,Bharadia; Dinesh,9999,0,9999,0
1668355902299,ECE 200,004,103589,Cheng; Chung Kuan,9999,0,9999,0
1668355902299,ECE 200,005,103590,Cosman; Pamela C.,9999,0,9999,0
1668355902299,ECE 200,006,103591,Dayeh; Shadi Ahmad,9999,0,9999,0
1668355902299,ECE 200,007,103592,Fainman; Yeshaiahu,9999,0,9999,0
1668355902299,ECE 200,008,103593,Ford; Joseph Earl,9999,0,9999,0
1668355902299,ECE 200,009,103594,Franceschetti; Massimo,9999,0,9999,0
1668355902299,ECE 200,010,103595,Fullerton; Eric E,9999,0,9999,0
1668355902299,ECE 200,011,103596,Galton; Ian A,9999,0,9999,0
1668355902299,ECE 200,012,103597,Gilja; Vikash,9999,0,9999,0
1668355902299,ECE 200,013,103598,Hall; Drew A.,9999,0,9999,0
1668355902299,ECE 200,014,103599,Hsueh; Tzu-Chien,9999,0,9999,0
1668355902299,ECE 200,015,103600,Javidi; Tara,9999,0,9999,0
1668355902299,ECE 200,016,103601,Kahng; Andrew Byun,9999,0,9999,0
1668355902299,ECE 200,017,103602,Kim; Young-Han,9999,0,9999,0
1668355902299,ECE 200,018,103603,Koushanfar; Farinaz,9999,0,9999,0
1668355902299,ECE 200,019,103604,Kuzum; Duygu,9999,0,9999,0
1668355902299,ECE 200,020,103605,Le; Hanh-Phuc,9999,0,9999,0
1668355902299,ECE 200,021,103606,Lin; Bill,9999,0,9999,0
1668355902299,ECE 200,022,103607,Liu; Zhaowei,9998,0,9999,1
1668355902299,ECE 200,023,103608,Lo; Yu-Hwa,9999,0,9999,0
1668355902299,ECE 200,024,103609,Lomakin; Vitaliy,9999,0,9999,0
1668355902299,ECE 200,025,103610,Mercier; Patrick Philip,9999,0,9999,0
1668355902299,ECE 200,026,103611,Meyer; Florian,9999,0,9999,0
1668355902299,ECE 200,027,103612,Milstein; Laurence B.,9999,0,9999,0
1668355902299,ECE 200,028,103613,Mir Arabbaygi; Siavash,9999,0,9999,0
1668355902299,ECE 200,029,103614,Mookherjea; Shayan,9999,0,9999,0
1668355902299,ECE 200,030,103615,Morris; Karcher William,9999,0,9999,0
1668355902299,ECE 200,031,103616,Ng; Tse Nga,9999,0,9999,0
1668355902299,ECE 200,032,103617,Nguyen; Truong Quang,9999,0,9999,0
1668355902299,ECE 200,033,103618,Nomura; Kenji,9999,0,9999,0
1668355902299,ECE 200,034,103619,Orlitsky; Alon,9999,0,9999,0
1668355902299,ECE 200,035,103620,Pal; Piya,9999,0,9999,0
1668355902299,ECE 200,036,103621,Papen; George C.,9999,0,9999,0
1668355902299,ECE 200,037,103622,Radic; Stojan,9999,0,9999,0
1668355902299,ECE 200,038,103623,Rao; Bhaskar D.,9999,0,9999,0
1668355902299,ECE 200,039,103624,Rao; Ramesh R,9999,0,9999,0
1668355902299,ECE 200,040,103625,Rebeiz; Gabriel,9999,0,9999,0
1668355902299,ECE 200,041,103626,Sanford; John R,9999,0,9999,0
1668355902299,ECE 200,042,103627,Siegel; Paul H.,9999,0,9999,0
1668355902299,ECE 200,043,103628,Sievenpiper; Daniel F.,9999,0,9999,0
1668355902299,ECE 200,044,103629,Sworder; David D.,9999,0,9999,0
1668355902299,ECE 200,045,103630,Taur; Yuan,9999,0,9999,0
1668355902299,ECE 200,046,103631,Touri; Behrouz,9999,0,9999,0
1668355902299,ECE 200,047,103632,Trivedi; Mohan M.,9999,0,9999,0
1668355902299,ECE 200,048,103633,Vasconcelos; Nuno,9999,0,9999,0
1668355902299,ECE 200,049,103634,Wang; Xiaolong,9999,0,9999,0
1668355902299,ECE 200,050,103635,Xie; Pengtao,9999,0,9999,0
1668355902299,ECE 200,051,103636,Yip; Michael,9999,0,9999,0
1668355902299,ECE 200,052,103637,Zeger; Kenneth A.,999,0,999,0
1668355902299,ECE 200,053,103638,Zhang; Xinyu,9999,0,9999,0
1668355902299,ECE 200,054,103639,Turakhia; Yatish Girish,9999,0,9999,0
1668355902299,ECE 200,055,103640,Kang; Mingu,9999,0,9999,0
1668355902299,ECE 200,056,103641,Shi; Yuanyuan,9999,0,9999,0
1668355902299,ECE 200,057,103642,Wang; Edward Jay,9999,0,9999,0
1668355902299,ECE 200,058,103643,Zheng; Yang,9999,0,9999,0
1668355902727,ECE 202,A00,103644,Kuzum; Duygu,0,0,0,0
1668355903149,ECE 212BN,A00,103646,Ng; Tse Nga,0,0,0,0
1668355903573,ECE 221,A00,111493,Staff,0,0,0,0
1668355903997,ECE 222B,A00,103647,Lomakin; Vitaliy,0,0,0,0
1668355904423,ECE 230B,A00,103648,Taur; Yuan,0,0,0,0
1668355904847,ECE 238B,A00,103649,Garay; Javier,0,0,0,0
1668355905272,ECE 240B,A00,112900,Fainman; Yeshaiahu,0,0,0,0
1668355905697,ECE 247A,A00,103650,Jokerst; Jesse Vincent,0,0,0,0
1668355906120,ECE 247B,A00,103651,Wang; Joseph,0,0,0,0
1668355906546,ECE 250,A00,103652,Siegel; Paul H.,0,0,0,0
1668355906978,ECE 251A,A00,103654,Rao; Bhaskar D.,0,0,0,0
1668355907400,ECE 257B,A00,103655,Bharadia; Dinesh,0,0,0,0
1668355907824,ECE 258A,A00,103656,Milstein; Laurence B.,0,0,0,0
1668355908249,ECE 260B,A00,103658,Kang; Mingu,0,0,0,0
1668355908671,ECE 264A,A00,103659,Galton; Ian A,0,0,0,0
1668355909104,ECE 265A,A00,103661,Gudem; Prasad S.S.,0,0,0,0
1668355909526,ECE 265D,A00,103662,Gudem; Prasad S.S.,0,0,0,0
1668355909953,ECE 268,A00,103663,Koushanfar; Farinaz,0,0,0,0
1668355910380,ECE 269,A01,103665,Pal; Piya,0,0,0,0
1668355910807,ECE 271B,A00,103666,Vasconcelos; Manuela,0,0,0,0
1668355911233,ECE 276A,A00,103667,Atanasov; Nikolay A.,0,0,0,0
1668355911659,ECE 277,A00,103668,An; Cheolhong,0,0,0,0
1668355912085,ECE 279,A00,117947,Hall; Drew A.,0,0,0,0
1668355912931,ECE 283,A00,103670,Hsueh; Tzu-Chien,0,0,0,0
1668355913356,ECE 284,A00,103671,Turakhia; Yatish Girish,0,0,0,0
1668355913781,ECE 285,A00,103672,Zheng; Yang,0,0,0,0
1668355913781,ECE 285,B00,103673,Sworder; David D.,0,0,0,0
1668355914216,ECE 287,A00,103676,Javidi; Tara,0,0,0,0
1668355914637,MATH 200B,A00,098023,Salehi Golsefidy; Alireza,12,0,15,3
1668355915151,MATH 202B,A00,098024,Rhoades; Brendon Patrick,9,0,15,6
1668355915576,MATH 203B,A00,098025,Oprea; Dragos N.,10,0,15,5
1668355915999,MATH 204B,A00,098026,Sorensen; Claus M,13,0,15,2
1668355916426,MATH 208,A00,098027,Izadi; Elham,7,0,10,3
1668355916851,MATH 209,A00,098028,Pollack; Aaron,10,0,10,0
1668355917279,MATH 211A,A00,112919,Rogalski; Daniel,9,0,10,1
1668355917705,MATH 211B,A00,112920,Seward; Brandon M.,9,0,10,1
1668355918129,MATH 218,A00,098029,Li; Bo,10,0,10,0
1668355918552,MATH 220B,A00,098030,Novak; Jonathan I,11,0,15,4
1668355918978,MATH 221A,A00,098031,Ebenfelt; Peter F,13,0,15,2
1668355919399,MATH 231B,A00,098032,Zlatos; Andrej,12,0,15,3
1668355919825,MATH 240B,A00,098033,Ni; Lei,9,0,15,6
1668355920262,MATH 243,A00,098034,Jekel; David Andrew,10,0,10,0
1668355920693,MATH 245A,A00,098035,Nie; Jiawang,0,0,15,16
1668355921114,MATH 248,A00,098036,Bejenaru; Ioan,10,0,10,0
1668355921537,MATH 250B,A00,098037,Spolaor; Luca,14,0,15,1
1668355921969,MATH 258,A00,098038,Ni; Lei,10,0,10,0
1668355922396,MATH 264B,A00,098041,Rhoades; Brendon Patrick,9,0,15,6
1668355922818,MATH 268,A00,098042,Buss; Samuel R,10,0,10,0
1668355923243,MATH 269,A00,098043,Rhoades; Brendon Patrick,10,0,10,0
1668355923666,MATH 270B,A00,098044,Li; Bo,10,0,15,5
1668355924090,MATH 272B,A00,098045,Holst; Michael J,13,0,15,2
1668355924519,MATH 273A,A00,098046,Tian; Xiaochuan,10,0,15,5
1668355924955,MATH 275,A01,098048,Tian; Xiaochuan,6,0,10,4
1668355925378,MATH 278A,A00,098049,Holst; Michael J,8,0,10,2
1668355925803,MATH 278B,A00,098050,Cloninger; Alexander,10,0,10,0
1668355926259,MATH 278C,A00,098051,Nie; Jiawang,7,0,10,3
1668355926687,MATH 280B,A00,098052,Zheng; Tianyi,8,0,15,7
1668355927110,MATH 281B,A00,098053,Bradic; Jelena,1,0,15,14
1668355927532,MATH 282B,A00,098054,Arias-Castro; Ery,0,0,15,15
1668355927957,MATH 285,A00,098055,Fitzsimmons; Patrick J,0,0,15,17
1668355928382,MATH 287B,A00,098056,Arias-Castro; Ery,2,0,15,13
1668355928812,MATH 288,A00,098057,Agarwal; Pooja,9,0,10,1
1668355928812,MATH 288,B00,098058,Zhang; Danna,8,0,10,2
1668355928812,MATH 288,C00,098059,Williams; Ruth J,9,0,10,1
1668355929235,MATH 290B,A00,098060,Roberts; Justin Deritter,13,0,15,2
1668355929662,MATH 292,A00,098061,Belmont; Eva Kinoshita,10,0,10,0
1668355930085,MATH 295,A00,098062,Suk; Andrew Hoon,48,0,50,2
1668355930508,MATH 296,A00,098063,Novak; Jonathan I,20,0,20,0
1668355930933,MATH 297,001,098064,Gamst; Anthony Collins,9997,0,9999,2
1668356431139,COGS 205,A00,101395,Chiba; Andrea,19,0,20,1
1668356431564,COGS 210B,001,101404,Greene; Deanna Jacquelyn,9998,0,9999,1
1668356431564,COGS 210B,002,101417,Xia; Haijun,9999,0,9999,0
1668356431564,COGS 210B,003,101422,Nitz; Douglas A.,9999,0,9999,0
1668356431564,COGS 210B,004,101423,Hollan; James D.,9998,0,9999,1
1668356431564,COGS 210B,005,101424,Deak; Gedeon O.,9998,0,9999,1
1668356431564,COGS 210B,006,101425,Rossano; Federico,9999,0,9999,0
1668356431990,COGS 211B,A00,101427,Coulson; Seana M,9996,0,9999,3
1668356432416,COGS 220,A00,101428,Hollan; James D.,0,0,25,25
1668356432839,COGS 229,A00,101429,Dow; Steven P,18,0,25,7
1668356433264,COGS 230,A00,101430,Klemmer; Scott R,11,0,17,6
1668356433686,COGS 234,A00,101431,Xia; Haijun,1,0,25,24
1668356434111,COGS 260,A00,101432,Kiyonaga; Anastasia,21,0,25,4
1668356434111,COGS 260,B00,101433,Kirsh; David Joel,15,0,25,10
1668356434534,CSE 202,A00,102371,Impagliazzo; Russell,0,0,0,0
1668356434960,CSE 203B,A01,102373,Cheng; Chung Kuan,0,0,0,0
1668356435500,CSE 208,A00,102374,Micciancio; Daniele,0,0,0,0
1668356435927,CSE 209A,A00,112895,Impagliazzo; Russell,0,0,15,15
1668356436352,CSE 209B,A00,108005,Bellare; Mihir,0,0,0,0
1668356436781,CSE 210,A00,113163,Coblenz; Michael J,0,0,0,0
1668356437213,CSE 219,A00,106111,Dow; Steven P,0,0,20,20
1668356437636,CSE 221,A00,102376,Voelker; Geoffrey M.,0,0,0,0
1668356438062,CSE 224,A01,102378,Porter; George M,0,0,0,0
1668356438485,CSE 229A,A00,102379,Savage; Stefan,0,0,0,0
1668356438911,CSE 229C,A00,102380,Munyaka; Imani N. S.,0,0,0,0
1668356439334,CSE 232B,A00,102382,Deutsch; Alin Bernard,0,0,0,0
1668356439757,CSE 234,A01,112904,Kumar; Arun Kumar,0,0,0,0
1668356440181,CSE 237A,A00,102383,Rosing; Tajana Simunic,0,0,0,0
1668356440603,CSE 239A,A00,102384,Deutsch; Alin Bernard,0,0,0,0
1668356441027,CSE 239B,A00,102385,Polikarpova; Nadezhda,0,0,0,0
1668356441453,CSE 240A,A00,102386,Pannuto; Patrick William,0,0,0,0
1668356441880,CSE 240B,A00,102387,Zhao; Jishen,0,0,0,0
1668356442303,CSE 241A,A00,106406,Kang; Mingu,0,0,0,0
1668356442728,CSE 249B,A00,102388,Kahng; Andrew Byun,0,0,8,8
1668356443151,CSE 251B,A01,102392,Cottrell; Garrison W,0,0,0,0
1668356443151,CSE 251B,A02,102393,Cottrell; Garrison W,0,0,0,0
1668356443580,CSE 252B,A00,102394,Ochoa; Benjamin Lawrence,0,0,0,0
1668356444005,CSE 257,A01,102396,Gao; Sicun,0,0,0,0
1668356444435,CSE 272,A00,102397,Li; Tzumao,0,0,0,0
1668356444861,CSE 274,A00,111323,Chern; Albert Ren-Haur,0,0,0,0
1668356445285,CSE 282,A00,102398,Pevzner; Pavel Arkadjevich,0,0,0,0
1668356445721,CSE 284,A00,114175,Gymrek; Melissa Ann,0,0,0,0
1668356446145,CSE 290,A00,102399,Chandraker; Manmohan Krishna,0,0,0,0
1668356446145,CSE 290,B00,102400,Vaccaro; Kristen Marie,0,0,25,25
1668356446145,CSE 290,C00,102414,Pannuto; Patrick William,0,0,25,25
1668356446145,CSE 290,D00,102427,Pevzner; Pavel Arkadjevich,0,0,0,0
1668356446145,CSE 290,E00,102429,Zhao; Jishen,0,0,0,0
1668356446145,CSE 290,F00,102436,Tullsen; Dean Michael,0,0,0,0
1668356446145,CSE 290,G00,102440,Christensen; Henrik I,0,0,20,20
1668356446592,CSE 291,A00,102443,Su; Hao,0,0,0,0
1668356446592,CSE 291,B00,102448,Polikarpova; Nadezhda,0,0,0,0
1668356446592,CSE 291,C00,102453,Vaccaro; Kristen Marie,0,0,0,0
1668356446592,CSE 291,D00,111343,Savage; Stefan,0,0,0,0
1668356446592,CSE 291,E00,116474,Claffy; Kimberly Claire,0,0,0,0
1668356446592,CSE 291,F00,116479,Pasquale; Joseph,0,0,0,0
1668356447026,CSE 293,001,119111,Bafna; Vineet,9999,0,9999,0
1668356447026,CSE 293,002,119118,Bellare; Mihir,9999,0,9999,0
1668356447026,CSE 293,003,119122,Berg-Kirkpatrick; Taylor D,9999,0,9999,0
1668356447026,CSE 293,004,119135,Christensen; Henrik I,9999,0,9999,0
1668356447026,CSE 293,005,119142,Cottrell; Garrison W,9999,0,9999,0
1668356447026,CSE 293,006,119146,Deutsch; Alin Bernard,9999,0,9999,0
1668356447026,CSE 293,007,119159,Esmaeilzadeh; Hadi,9999,0,9999,0
1668356447026,CSE 293,008,119166,Freund; Yoav,9999,0,9999,0
1668356447026,CSE 293,009,119170,Griswold; William G.,9999,0,9999,0
1668356447026,CSE 293,010,119183,Gymrek; Melissa Ann,9999,0,9999,0
1668356447026,CSE 293,011,119190,Heninger; Nadia A,9999,0,9999,0
1668356447026,CSE 293,012,119230,Impagliazzo; Russell,9999,0,9999,0
1668356447026,CSE 293,013,119232,Jhala; Ranjit,9999,0,9999,0
1668356447026,CSE 293,014,119233,Kahng; Andrew Byun,9999,0,9999,0
1668356447026,CSE 293,015,119298,Kane; Daniel Mertz,9999,0,9999,0
1668356447026,CSE 293,016,119299,Kriegman; David J,9999,0,9999,0
1668356447026,CSE 293,017,119300,Kumar; Arun Kumar,9999,0,9999,0
1668356447026,CSE 293,018,119301,Lerner; Sorin,9999,0,9999,0
1668356447026,CSE 293,019,119302,Lovett; Shachar,9999,0,9999,0
1668356447026,CSE 293,020,119303,McAuley; Julian John,9999,0,9999,0
1668356447026,CSE 293,021,119304,Micciancio; Daniele,9999,0,9999,0
1668356447026,CSE 293,022,119367,Orailoglu; Alex,9999,0,9999,0
1668356447026,CSE 293,023,119382,Paturi; Ramamohan,9999,0,9999,0
1668356447026,CSE 293,024,119404,Polikarpova; Nadezhda,9999,0,9999,0
1668356447026,CSE 293,025,119406,Politz; Joseph Gibbs,9999,0,9999,0
1668356447026,CSE 293,026,119411,Porter; George M,9999,0,9999,0
1668356447026,CSE 293,027,119414,Porter; Leonard Emerson,9999,0,9999,0
1668356447026,CSE 293,028,119416,Ramamoorthi; Ravi,9999,0,9999,0
1668356447026,CSE 293,029,119417,Sahoo; Debashis,9999,0,9999,0
1668356447026,CSE 293,030,119420,Saul; Lawrence,9999,0,9999,0
1668356447026,CSE 293,031,119421,Savage; Stefan,9999,0,9999,0
1668356447026,CSE 293,032,119425,Schulze; Jurgen P.,9999,0,9999,0
1668356447026,CSE 293,033,119426,Snoeren; Alex C.,9999,0,9999,0
1668356447026,CSE 293,034,119428,Shang; Jingbo,9999,0,9999,0
1668356447026,CSE 293,035,119430,Stefan; Deian,9999,0,9999,0
1668356447026,CSE 293,036,119431,Su; Hao,9999,0,9999,0
1668356447026,CSE 293,037,119433,Swanson; Steven James,9999,0,9999,0
1668356447026,CSE 293,038,119435,Tullsen; Dean Michael,9999,0,9999,0
1668356447026,CSE 293,039,119483,Voelker; Geoffrey M.,9999,0,9999,0
1668356447026,CSE 293,040,119537,Zhao; Jishen,9999,0,9999,0
1668356447026,CSE 293,041,119538,Zhou; Yuan-Yuan,9999,0,9999,0
1668356447026,CSE 293,042,119539,Gao; Sicun,9999,0,9999,0
1668356447026,CSE 293,043,119540,Weibel; Nadir,9999,0,9999,0
1668356447026,CSE 293,044,119541,Gupta; Rajesh K.,9999,0,9999,0
1668356447026,CSE 293,045,126410,Vaccaro; Kristen Marie,9999,0,9999,0
1668356447026,CSE 293,046,126411,Klemke; Richard,9999,0,9999,0
1668356447450,CSE 294,A00,102459,Voelker; Geoffrey M.,0,0,0,0
1668356447450,CSE 294,B00,111322,Orailoglu; Alex,0,0,0,0
1668356447874,DSE 201,A00,096914,Deutsch; Alin Bernard,30,0,30,0
1668356448300,DSE 210,A00,096915,Dasgupta; Sanjoy,30,0,30,0
1668356448723,DSE 260A,A00,096916,Altintas De Callaf; Ilkay,30,0,30,0
1668356449160,ECE 200,001,103586,Antipa; Nicholas A,9999,0,9999,0
1668356449160,ECE 200,002,103587,Atanasov; Nikolay A.,9999,0,9999,0
1668356449160,ECE 200,003,103588,Bharadia; Dinesh,9999,0,9999,0
1668356449160,ECE 200,004,103589,Cheng; Chung Kuan,9999,0,9999,0
1668356449160,ECE 200,005,103590,Cosman; Pamela C.,9999,0,9999,0
1668356449160,ECE 200,006,103591,Dayeh; Shadi Ahmad,9999,0,9999,0
1668356449160,ECE 200,007,103592,Fainman; Yeshaiahu,9999,0,9999,0
1668356449160,ECE 200,008,103593,Ford; Joseph Earl,9999,0,9999,0
1668356449160,ECE 200,009,103594,Franceschetti; Massimo,9999,0,9999,0
1668356449160,ECE 200,010,103595,Fullerton; Eric E,9999,0,9999,0
1668356449160,ECE 200,011,103596,Galton; Ian A,9999,0,9999,0
1668356449160,ECE 200,012,103597,Gilja; Vikash,9999,0,9999,0
1668356449160,ECE 200,013,103598,Hall; Drew A.,9999,0,9999,0
1668356449160,ECE 200,014,103599,Hsueh; Tzu-Chien,9999,0,9999,0
1668356449160,ECE 200,015,103600,Javidi; Tara,9999,0,9999,0
1668356449160,ECE 200,016,103601,Kahng; Andrew Byun,9999,0,9999,0
1668356449160,ECE 200,017,103602,Kim; Young-Han,9999,0,9999,0
1668356449160,ECE 200,018,103603,Koushanfar; Farinaz,9999,0,9999,0
1668356449160,ECE 200,019,103604,Kuzum; Duygu,9999,0,9999,0
1668356449160,ECE 200,020,103605,Le; Hanh-Phuc,9999,0,9999,0
1668356449160,ECE 200,021,103606,Lin; Bill,9999,0,9999,0
1668356449160,ECE 200,022,103607,Liu; Zhaowei,9998,0,9999,1
1668356449160,ECE 200,023,103608,Lo; Yu-Hwa,9999,0,9999,0
1668356449160,ECE 200,024,103609,Lomakin; Vitaliy,9999,0,9999,0
1668356449160,ECE 200,025,103610,Mercier; Patrick Philip,9999,0,9999,0
1668356449160,ECE 200,026,103611,Meyer; Florian,9999,0,9999,0
1668356449160,ECE 200,027,103612,Milstein; Laurence B.,9999,0,9999,0
1668356449160,ECE 200,028,103613,Mir Arabbaygi; Siavash,9999,0,9999,0
1668356449160,ECE 200,029,103614,Mookherjea; Shayan,9999,0,9999,0
1668356449160,ECE 200,030,103615,Morris; Karcher William,9999,0,9999,0
1668356449160,ECE 200,031,103616,Ng; Tse Nga,9999,0,9999,0
1668356449160,ECE 200,032,103617,Nguyen; Truong Quang,9999,0,9999,0
1668356449160,ECE 200,033,103618,Nomura; Kenji,9999,0,9999,0
1668356449160,ECE 200,034,103619,Orlitsky; Alon,9999,0,9999,0
1668356449160,ECE 200,035,103620,Pal; Piya,9999,0,9999,0
1668356449160,ECE 200,036,103621,Papen; George C.,9999,0,9999,0
1668356449160,ECE 200,037,103622,Radic; Stojan,9999,0,9999,0
1668356449160,ECE 200,038,103623,Rao; Bhaskar D.,9999,0,9999,0
1668356449160,ECE 200,039,103624,Rao; Ramesh R,9999,0,9999,0
1668356449160,ECE 200,040,103625,Rebeiz; Gabriel,9999,0,9999,0
1668356449160,ECE 200,041,103626,Sanford; John R,9999,0,9999,0
1668356449160,ECE 200,042,103627,Siegel; Paul H.,9999,0,9999,0
1668356449160,ECE 200,043,103628,Sievenpiper; Daniel F.,9999,0,9999,0
1668356449160,ECE 200,044,103629,Sworder; David D.,9999,0,9999,0
1668356449160,ECE 200,045,103630,Taur; Yuan,9999,0,9999,0
1668356449160,ECE 200,046,103631,Touri; Behrouz,9999,0,9999,0
1668356449160,ECE 200,047,103632,Trivedi; Mohan M.,9999,0,9999,0
1668356449160,ECE 200,048,103633,Vasconcelos; Nuno,9999,0,9999,0
1668356449160,ECE 200,049,103634,Wang; Xiaolong,9999,0,9999,0
1668356449160,ECE 200,050,103635,Xie; Pengtao,9999,0,9999,0
1668356449160,ECE 200,051,103636,Yip; Michael,9999,0,9999,0
1668356449160,ECE 200,052,103637,Zeger; Kenneth A.,999,0,999,0
1668356449160,ECE 200,053,103638,Zhang; Xinyu,9999,0,9999,0
1668356449160,ECE 200,054,103639,Turakhia; Yatish Girish,9999,0,9999,0
1668356449160,ECE 200,055,103640,Kang; Mingu,9999,0,9999,0
1668356449160,ECE 200,056,103641,Shi; Yuanyuan,9999,0,9999,0
1668356449160,ECE 200,057,103642,Wang; Edward Jay,9999,0,9999,0
1668356449160,ECE 200,058,103643,Zheng; Yang,9999,0,9999,0
1668356449587,ECE 202,A00,103644,Kuzum; Duygu,0,0,0,0
1668356450022,ECE 212BN,A00,103646,Ng; Tse Nga,0,0,0,0
1668356450445,ECE 221,A00,111493,Staff,0,0,0,0
1668356450874,ECE 222B,A00,103647,Lomakin; Vitaliy,0,0,0,0
1668356451297,ECE 230B,A00,103648,Taur; Yuan,0,0,0,0
1668356451719,ECE 238B,A00,103649,Garay; Javier,0,0,0,0
1668356452142,ECE 240B,A00,112900,Fainman; Yeshaiahu,0,0,0,0
1668356452571,ECE 247A,A00,103650,Jokerst; Jesse Vincent,0,0,0,0
1668356453002,ECE 247B,A00,103651,Wang; Joseph,0,0,0,0
1668356453426,ECE 250,A00,103652,Siegel; Paul H.,0,0,0,0
1668356453849,ECE 251A,A00,103654,Rao; Bhaskar D.,0,0,0,0
1668356454271,ECE 257B,A00,103655,Bharadia; Dinesh,0,0,0,0
1668356454695,ECE 258A,A00,103656,Milstein; Laurence B.,0,0,0,0
1668356455129,ECE 260B,A00,103658,Kang; Mingu,0,0,0,0
1668356455552,ECE 264A,A00,103659,Galton; Ian A,0,0,0,0
1668356455978,ECE 265A,A00,103661,Gudem; Prasad S.S.,0,0,0,0
1668356456400,ECE 265D,A00,103662,Gudem; Prasad S.S.,0,0,0,0
1668356456836,ECE 268,A00,103663,Koushanfar; Farinaz,0,0,0,0
1668356457264,ECE 269,A01,103665,Pal; Piya,0,0,0,0
1668356457688,ECE 271B,A00,103666,Vasconcelos; Manuela,0,0,0,0
1668356458115,ECE 276A,A00,103667,Atanasov; Nikolay A.,0,0,0,0
1668356458544,ECE 277,A00,103668,An; Cheolhong,0,0,0,0
1668356458983,ECE 279,A00,117947,Hall; Drew A.,0,0,0,0
1668356459834,ECE 283,A00,103670,Hsueh; Tzu-Chien,0,0,0,0
1668356460266,ECE 284,A00,103671,Turakhia; Yatish Girish,0,0,0,0
1668356460690,ECE 285,A00,103672,Zheng; Yang,0,0,0,0
1668356460690,ECE 285,B00,103673,Sworder; David D.,0,0,0,0
1668356461113,ECE 287,A00,103676,Javidi; Tara,0,0,0,0
1668356461549,MATH 200B,A00,098023,Salehi Golsefidy; Alireza,12,0,15,3
1668356461974,MATH 202B,A00,098024,Rhoades; Brendon Patrick,9,0,15,6
1668356462401,MATH 203B,A00,098025,Oprea; Dragos N.,10,0,15,5
1668356462823,MATH 204B,A00,098026,Sorensen; Claus M,13,0,15,2
1668356463254,MATH 208,A00,098027,Izadi; Elham,7,0,10,3
1668356463677,MATH 209,A00,098028,Pollack; Aaron,10,0,10,0
1668356464107,MATH 211A,A00,112919,Rogalski; Daniel,9,0,10,1
1668356464533,MATH 211B,A00,112920,Seward; Brandon M.,9,0,10,1
1668356464959,MATH 218,A00,098029,Li; Bo,10,0,10,0
1668356465383,MATH 220B,A00,098030,Novak; Jonathan I,11,0,15,4
1668356465807,MATH 221A,A00,098031,Ebenfelt; Peter F,13,0,15,2
1668356466236,MATH 231B,A00,098032,Zlatos; Andrej,12,0,15,3
1668356466664,MATH 240B,A00,098033,Ni; Lei,9,0,15,6
1668356467089,MATH 243,A00,098034,Jekel; David Andrew,10,0,10,0
1668356467533,MATH 245A,A00,098035,Nie; Jiawang,0,0,15,16
1668356467955,MATH 248,A00,098036,Bejenaru; Ioan,10,0,10,0
1668356468382,MATH 250B,A00,098037,Spolaor; Luca,14,0,15,1
1668356468807,MATH 258,A00,098038,Ni; Lei,10,0,10,0
1668356469231,MATH 264B,A00,098041,Rhoades; Brendon Patrick,9,0,15,6
1668356469657,MATH 268,A00,098042,Buss; Samuel R,10,0,10,0
1668356470090,MATH 269,A00,098043,Rhoades; Brendon Patrick,10,0,10,0
1668356470521,MATH 270B,A00,098044,Li; Bo,10,0,15,5
1668356470944,MATH 272B,A00,098045,Holst; Michael J,13,0,15,2
1668356471370,MATH 273A,A00,098046,Tian; Xiaochuan,10,0,15,5
1668356471793,MATH 275,A01,098048,Tian; Xiaochuan,6,0,10,4
1668356472227,MATH 278A,A00,098049,Holst; Michael J,8,0,10,2
1668356472652,MATH 278B,A00,098050,Cloninger; Alexander,10,0,10,0
1668356473078,MATH 278C,A00,098051,Nie; Jiawang,7,0,10,3
1668356473505,MATH 280B,A00,098052,Zheng; Tianyi,8,0,15,7
1668356473939,MATH 281B,A00,098053,Bradic; Jelena,1,0,15,14
1668356474366,MATH 282B,A00,098054,Arias-Castro; Ery,0,0,15,15
1668356474789,MATH 285,A00,098055,Fitzsimmons; Patrick J,0,0,15,17
1668356475216,MATH 287B,A00,098056,Arias-Castro; Ery,2,0,15,13
1668356475639,MATH 288,A00,098057,Agarwal; Pooja,9,0,10,1
1668356475639,MATH 288,B00,098058,Zhang; Danna,8,0,10,2
1668356475639,MATH 288,C00,098059,Williams; Ruth J,9,0,10,1
1668356476069,MATH 290B,A00,098060,Roberts; Justin Deritter,13,0,15,2
1668356476494,MATH 292,A00,098061,Belmont; Eva Kinoshita,10,0,10,0
1668356476927,MATH 295,A00,098062,Suk; Andrew Hoon,48,0,50,2
1668356477354,MATH 296,A00,098063,Novak; Jonathan I,20,0,20,0
1668356477777,MATH 297,001,098064,Gamst; Anthony Collins,9997,0,9999,2
1668356979546,COGS 205,A00,101395,Chiba; Andrea,19,0,20,1
1668356979975,COGS 210B,001,101404,Greene; Deanna Jacquelyn,9998,0,9999,1
1668356979975,COGS 210B,002,101417,Xia; Haijun,9999,0,9999,0
1668356979975,COGS 210B,003,101422,Nitz; Douglas A.,9999,0,9999,0
1668356979975,COGS 210B,004,101423,Hollan; James D.,9998,0,9999,1
1668356979975,COGS 210B,005,101424,Deak; Gedeon O.,9998,0,9999,1
1668356979975,COGS 210B,006,101425,Rossano; Federico,9999,0,9999,0
1668356980412,COGS 211B,A00,101427,Coulson; Seana M,9996,0,9999,3
1668356980842,COGS 220,A00,101428,Hollan; James D.,0,0,25,25
1668356981277,COGS 229,A00,101429,Dow; Steven P,18,0,25,7
1668356981701,COGS 230,A00,101430,Klemmer; Scott R,11,0,17,6
1668356982124,COGS 234,A00,101431,Xia; Haijun,1,0,25,24
1668356982558,COGS 260,A00,101432,Kiyonaga; Anastasia,21,0,25,4
1668356982558,COGS 260,B00,101433,Kirsh; David Joel,15,0,25,10
1668356982984,CSE 202,A00,102371,Impagliazzo; Russell,0,0,0,0
1668356983419,CSE 203B,A01,102373,Cheng; Chung Kuan,0,0,0,0
1668356983849,CSE 208,A00,102374,Micciancio; Daniele,0,0,0,0
1668356984272,CSE 209A,A00,112895,Impagliazzo; Russell,0,0,15,15
1668356984694,CSE 209B,A00,108005,Bellare; Mihir,0,0,0,0
1668356985117,CSE 210,A00,113163,Coblenz; Michael J,0,0,0,0
1668356985544,CSE 219,A00,106111,Dow; Steven P,0,0,20,20
1668356985986,CSE 221,A00,102376,Voelker; Geoffrey M.,0,0,0,0
1668356986410,CSE 224,A01,102378,Porter; George M,0,0,0,0
1668356986848,CSE 229A,A00,102379,Savage; Stefan,0,0,0,0
1668356987277,CSE 229C,A00,102380,Munyaka; Imani N. S.,0,0,0,0
1668356987704,CSE 232B,A00,102382,Deutsch; Alin Bernard,0,0,0,0
1668356988144,CSE 234,A01,112904,Kumar; Arun Kumar,0,0,0,0
1668356988584,CSE 237A,A00,102383,Rosing; Tajana Simunic,0,0,0,0
1668356989006,CSE 239A,A00,102384,Deutsch; Alin Bernard,0,0,0,0
1668356989428,CSE 239B,A00,102385,Polikarpova; Nadezhda,0,0,0,0
1668356989853,CSE 240A,A00,102386,Pannuto; Patrick William,0,0,0,0
1668356990285,CSE 240B,A00,102387,Zhao; Jishen,0,0,0,0
1668356990719,CSE 241A,A00,106406,Kang; Mingu,0,0,0,0
1668356991145,CSE 249B,A00,102388,Kahng; Andrew Byun,0,0,8,8
1668356991573,CSE 251B,A01,102392,Cottrell; Garrison W,0,0,0,0
1668356991573,CSE 251B,A02,102393,Cottrell; Garrison W,0,0,0,0
1668356991997,CSE 252B,A00,102394,Ochoa; Benjamin Lawrence,0,0,0,0
1668356992421,CSE 257,A01,102396,Gao; Sicun,0,0,0,0
1668356992872,CSE 272,A00,102397,Li; Tzumao,0,0,0,0
1668356993296,CSE 274,A00,111323,Chern; Albert Ren-Haur,0,0,0,0
1668356993722,CSE 282,A00,102398,Pevzner; Pavel Arkadjevich,0,0,0,0
1668356994146,CSE 284,A00,114175,Gymrek; Melissa Ann,0,0,0,0
1668356994589,CSE 290,A00,102399,Chandraker; Manmohan Krishna,0,0,0,0
1668356994589,CSE 290,B00,102400,Vaccaro; Kristen Marie,0,0,25,25
1668356994589,CSE 290,C00,102414,Pannuto; Patrick William,0,0,25,25
1668356994589,CSE 290,D00,102427,Pevzner; Pavel Arkadjevich,0,0,0,0
1668356994589,CSE 290,E00,102429,Zhao; Jishen,0,0,0,0
1668356994589,CSE 290,F00,102436,Tullsen; Dean Michael,0,0,0,0
1668356994589,CSE 290,G00,102440,Christensen; Henrik I,0,0,20,20
1668356995020,CSE 291,A00,102443,Su; Hao,0,0,0,0
1668356995020,CSE 291,B00,102448,Polikarpova; Nadezhda,0,0,0,0
1668356995020,CSE 291,C00,102453,Vaccaro; Kristen Marie,0,0,0,0
1668356995020,CSE 291,D00,111343,Savage; Stefan,0,0,0,0
1668356995020,CSE 291,E00,116474,Claffy; Kimberly Claire,0,0,0,0
1668356995020,CSE 291,F00,116479,Pasquale; Joseph,0,0,0,0
1668356995490,CSE 293,001,119111,Bafna; Vineet,9999,0,9999,0
1668356995490,CSE 293,002,119118,Bellare; Mihir,9999,0,9999,0
1668356995490,CSE 293,003,119122,Berg-Kirkpatrick; Taylor D,9999,0,9999,0
1668356995490,CSE 293,004,119135,Christensen; Henrik I,9999,0,9999,0
1668356995490,CSE 293,005,119142,Cottrell; Garrison W,9999,0,9999,0
1668356995490,CSE 293,006,119146,Deutsch; Alin Bernard,9999,0,9999,0
1668356995490,CSE 293,007,119159,Esmaeilzadeh; Hadi,9999,0,9999,0
1668356995490,CSE 293,008,119166,Freund; Yoav,9999,0,9999,0
1668356995490,CSE 293,009,119170,Griswold; William G.,9999,0,9999,0
1668356995490,CSE 293,010,119183,Gymrek; Melissa Ann,9999,0,9999,0
1668356995490,CSE 293,011,119190,Heninger; Nadia A,9999,0,9999,0
1668356995490,CSE 293,012,119230,Impagliazzo; Russell,9999,0,9999,0
1668356995490,CSE 293,013,119232,Jhala; Ranjit,9999,0,9999,0
1668356995490,CSE 293,014,119233,Kahng; Andrew Byun,9999,0,9999,0
1668356995490,CSE 293,015,119298,Kane; Daniel Mertz,9999,0,9999,0
1668356995490,CSE 293,016,119299,Kriegman; David J,9999,0,9999,0
1668356995490,CSE 293,017,119300,Kumar; Arun Kumar,9999,0,9999,0
1668356995490,CSE 293,018,119301,Lerner; Sorin,9999,0,9999,0
1668356995490,CSE 293,019,119302,Lovett; Shachar,9999,0,9999,0
1668356995490,CSE 293,020,119303,McAuley; Julian John,9999,0,9999,0
1668356995490,CSE 293,021,119304,Micciancio; Daniele,9999,0,9999,0
1668356995490,CSE 293,022,119367,Orailoglu; Alex,9999,0,9999,0
1668356995490,CSE 293,023,119382,Paturi; Ramamohan,9999,0,9999,0
1668356995490,CSE 293,024,119404,Polikarpova; Nadezhda,9999,0,9999,0
1668356995490,CSE 293,025,119406,Politz; Joseph Gibbs,9999,0,9999,0
1668356995490,CSE 293,026,119411,Porter; George M,9999,0,9999,0
1668356995490,CSE 293,027,119414,Porter; Leonard Emerson,9999,0,9999,0
1668356995490,CSE 293,028,119416,Ramamoorthi; Ravi,9999,0,9999,0
1668356995490,CSE 293,029,119417,Sahoo; Debashis,9999,0,9999,0
1668356995490,CSE 293,030,119420,Saul; Lawrence,9999,0,9999,0
1668356995490,CSE 293,031,119421,Savage; Stefan,9999,0,9999,0
1668356995490,CSE 293,032,119425,Schulze; Jurgen P.,9999,0,9999,0
1668356995490,CSE 293,033,119426,Snoeren; Alex C.,9999,0,9999,0
1668356995490,CSE 293,034,119428,Shang; Jingbo,9999,0,9999,0
1668356995490,CSE 293,035,119430,Stefan; Deian,9999,0,9999,0
1668356995490,CSE 293,036,119431,Su; Hao,9999,0,9999,0
1668356995490,CSE 293,037,119433,Swanson; Steven James,9999,0,9999,0
1668356995490,CSE 293,038,119435,Tullsen; Dean Michael,9999,0,9999,0
1668356995490,CSE 293,039,119483,Voelker; Geoffrey M.,9999,0,9999,0
1668356995490,CSE 293,040,119537,Zhao; Jishen,9999,0,9999,0
1668356995490,CSE 293,041,119538,Zhou; Yuan-Yuan,9999,0,9999,0
1668356995490,CSE 293,042,119539,Gao; Sicun,9999,0,9999,0
1668356995490,CSE 293,043,119540,Weibel; Nadir,9999,0,9999,0
1668356995490,CSE 293,044,119541,Gupta; Rajesh K.,9999,0,9999,0
1668356995490,CSE 293,045,126410,Vaccaro; Kristen Marie,9999,0,9999,0
1668356995490,CSE 293,046,126411,Klemke; Richard,9999,0,9999,0
1668356995931,CSE 294,A00,102459,Voelker; Geoffrey M.,0,0,0,0
1668356995931,CSE 294,B00,111322,Orailoglu; Alex,0,0,0,0
1668356996355,DSE 201,A00,096914,Deutsch; Alin Bernard,30,0,30,0
1668356996779,DSE 210,A00,096915,Dasgupta; Sanjoy,30,0,30,0
1668356997204,DSE 260A,A00,096916,Altintas De Callaf; Ilkay,30,0,30,0
1668356997683,ECE 200,001,103586,Antipa; Nicholas A,9999,0,9999,0
1668356997683,ECE 200,002,103587,Atanasov; Nikolay A.,9999,0,9999,0
1668356997683,ECE 200,003,103588,Bharadia; Dinesh,9999,0,9999,0
1668356997683,ECE 200,004,103589,Cheng; Chung Kuan,9999,0,9999,0
1668356997683,ECE 200,005,103590,Cosman; Pamela C.,9999,0,9999,0
1668356997683,ECE 200,006,103591,Dayeh; Shadi Ahmad,9999,0,9999,0
1668356997683,ECE 200,007,103592,Fainman; Yeshaiahu,9999,0,9999,0
1668356997683,ECE 200,008,103593,Ford; Joseph Earl,9999,0,9999,0
1668356997683,ECE 200,009,103594,Franceschetti; Massimo,9999,0,9999,0
1668356997683,ECE 200,010,103595,Fullerton; Eric E,9999,0,9999,0
1668356997683,ECE 200,011,103596,Galton; Ian A,9999,0,9999,0
1668356997683,ECE 200,012,103597,Gilja; Vikash,9999,0,9999,0
1668356997683,ECE 200,013,103598,Hall; Drew A.,9999,0,9999,0
1668356997683,ECE 200,014,103599,Hsueh; Tzu-Chien,9999,0,9999,0
1668356997683,ECE 200,015,103600,Javidi; Tara,9999,0,9999,0
1668356997683,ECE 200,016,103601,Kahng; Andrew Byun,9999,0,9999,0
1668356997683,ECE 200,017,103602,Kim; Young-Han,9999,0,9999,0
1668356997683,ECE 200,018,103603,Koushanfar; Farinaz,9999,0,9999,0
1668356997683,ECE 200,019,103604,Kuzum; Duygu,9999,0,9999,0
1668356997683,ECE 200,020,103605,Le; Hanh-Phuc,9999,0,9999,0
1668356997683,ECE 200,021,103606,Lin; Bill,9999,0,9999,0
1668356997683,ECE 200,022,103607,Liu; Zhaowei,9998,0,9999,1
1668356997683,ECE 200,023,103608,Lo; Yu-Hwa,9999,0,9999,0
1668356997683,ECE 200,024,103609,Lomakin; Vitaliy,9999,0,9999,0
1668356997683,ECE 200,025,103610,Mercier; Patrick Philip,9999,0,9999,0
1668356997683,ECE 200,026,103611,Meyer; Florian,9999,0,9999,0
1668356997683,ECE 200,027,103612,Milstein; Laurence B.,9999,0,9999,0
1668356997683,ECE 200,028,103613,Mir Arabbaygi; Siavash,9999,0,9999,0
1668356997683,ECE 200,029,103614,Mookherjea; Shayan,9999,0,9999,0
1668356997683,ECE 200,030,103615,Morris; Karcher William,9999,0,9999,0
1668356997683,ECE 200,031,103616,Ng; Tse Nga,9999,0,9999,0
1668356997683,ECE 200,032,103617,Nguyen; Truong Quang,9999,0,9999,0
1668356997683,ECE 200,033,103618,Nomura; Kenji,9999,0,9999,0
1668356997683,ECE 200,034,103619,Orlitsky; Alon,9999,0,9999,0
1668356997683,ECE 200,035,103620,Pal; Piya,9999,0,9999,0
1668356997683,ECE 200,036,103621,Papen; George C.,9999,0,9999,0
1668356997683,ECE 200,037,103622,Radic; Stojan,9999,0,9999,0
1668356997683,ECE 200,038,103623,Rao; Bhaskar D.,9999,0,9999,0
1668356997683,ECE 200,039,103624,Rao; Ramesh R,9999,0,9999,0
1668356997683,ECE 200,040,103625,Rebeiz; Gabriel,9999,0,9999,0
1668356997683,ECE 200,041,103626,Sanford; John R,9999,0,9999,0
1668356997683,ECE 200,042,103627,Siegel; Paul H.,9999,0,9999,0
1668356997683,ECE 200,043,103628,Sievenpiper; Daniel F.,9999,0,9999,0
1668356997683,ECE 200,044,103629,Sworder; David D.,9999,0,9999,0
1668356997683,ECE 200,045,103630,Taur; Yuan,9999,0,9999,0
1668356997683,ECE 200,046,103631,Touri; Behrouz,9999,0,9999,0
1668356997683,ECE 200,047,103632,Trivedi; Mohan M.,9999,0,9999,0
1668356997683,ECE 200,048,103633,Vasconcelos; Nuno,9999,0,9999,0
1668356997683,ECE 200,049,103634,Wang; Xiaolong,9999,0,9999,0
1668356997683,ECE 200,050,103635,Xie; Pengtao,9999,0,9999,0
1668356997683,ECE 200,051,103636,Yip; Michael,9999,0,9999,0
1668356997683,ECE 200,052,103637,Zeger; Kenneth A.,999,0,999,0
1668356997683,ECE 200,053,103638,Zhang; Xinyu,9999,0,9999,0
1668356997683,ECE 200,054,103639,Turakhia; Yatish Girish,9999,0,9999,0
1668356997683,ECE 200,055,103640,Kang; Mingu,9999,0,9999,0
1668356997683,ECE 200,056,103641,Shi; Yuanyuan,9999,0,9999,0
1668356997683,ECE 200,057,103642,Wang; Edward Jay,9999,0,9999,0
1668356997683,ECE 200,058,103643,Zheng; Yang,9999,0,9999,0
1668356998109,ECE 202,A00,103644,Kuzum; Duygu,0,0,0,0
1668356998532,ECE 212BN,A00,103646,Ng; Tse Nga,0,0,0,0
1668356998954,ECE 221,A00,111493,Staff,0,0,0,0
1668356999385,ECE 222B,A00,103647,Lomakin; Vitaliy,0,0,0,0
1668356999814,ECE 230B,A00,103648,Taur; Yuan,0,0,0,0
1668357000239,ECE 238B,A00,103649,Garay; Javier,0,0,0,0
1668357000747,ECE 240B,A00,112900,Fainman; Yeshaiahu,0,0,0,0
1668357001176,ECE 247A,A00,103650,Jokerst; Jesse Vincent,0,0,0,0
1668357001600,ECE 247B,A00,103651,Wang; Joseph,0,0,0,0
1668357002031,ECE 250,A00,103652,Siegel; Paul H.,0,0,0,0
1668357002457,ECE 251A,A00,103654,Rao; Bhaskar D.,0,0,0,0
1668357002882,ECE 257B,A00,103655,Bharadia; Dinesh,0,0,0,0
1668357003304,ECE 258A,A00,103656,Milstein; Laurence B.,0,0,0,0
1668357003729,ECE 260B,A00,103658,Kang; Mingu,0,0,0,0
1668357004151,ECE 264A,A00,103659,Galton; Ian A,0,0,0,0
1668357004592,ECE 265A,A00,103661,Gudem; Prasad S.S.,0,0,0,0
1668357005015,ECE 265D,A00,103662,Gudem; Prasad S.S.,0,0,0,0
1668357005441,ECE 268,A00,103663,Koushanfar; Farinaz,0,0,0,0
1668357005865,ECE 269,A01,103665,Pal; Piya,0,0,0,0
1668357006292,ECE 271B,A00,103666,Vasconcelos; Manuela,0,0,0,0
1668357006714,ECE 276A,A00,103667,Atanasov; Nikolay A.,0,0,0,0
1668357007139,ECE 277,A00,103668,An; Cheolhong,0,0,0,0
1668357007573,ECE 279,A00,117947,Hall; Drew A.,0,0,0,0
1668357008428,ECE 283,A00,103670,Hsueh; Tzu-Chien,0,0,0,0
1668357008851,ECE 284,A00,103671,Turakhia; Yatish Girish,0,0,0,0
1668357009281,ECE 285,A00,103672,Zheng; Yang,0,0,0,0
1668357009281,ECE 285,B00,103673,Sworder; David D.,0,0,0,0
1668357009713,ECE 287,A00,103676,Javidi; Tara,0,0,0,0
1668357010136,MATH 200B,A00,098023,Salehi Golsefidy; Alireza,12,0,15,3
1668357010562,MATH 202B,A00,098024,Rhoades; Brendon Patrick,9,0,15,6
1668357010987,MATH 203B,A00,098025,Oprea; Dragos N.,10,0,15,5
1668357011410,MATH 204B,A00,098026,Sorensen; Claus M,13,0,15,2
1668357011835,MATH 208,A00,098027,Izadi; Elham,7,0,10,3
1668357012265,MATH 209,A00,098028,Pollack; Aaron,10,0,10,0
1668357012688,MATH 211A,A00,112919,Rogalski; Daniel,9,0,10,1
1668357013123,MATH 211B,A00,112920,Seward; Brandon M.,9,0,10,1
1668357013549,MATH 218,A00,098029,Li; Bo,10,0,10,0
1668357013974,MATH 220B,A00,098030,Novak; Jonathan I,11,0,15,4
1668357014408,MATH 221A,A00,098031,Ebenfelt; Peter F,13,0,15,2
1668357014842,MATH 231B,A00,098032,Zlatos; Andrej,12,0,15,3
1668357015277,MATH 240B,A00,098033,Ni; Lei,9,0,15,6
1668357015702,MATH 243,A00,098034,Jekel; David Andrew,10,0,10,0
1668357016134,MATH 245A,A00,098035,Nie; Jiawang,0,0,15,16
1668357016559,MATH 248,A00,098036,Bejenaru; Ioan,10,0,10,0
1668357016983,MATH 250B,A00,098037,Spolaor; Luca,14,0,15,1
1668357017406,MATH 258,A00,098038,Ni; Lei,10,0,10,0
1668357017832,MATH 264B,A00,098041,Rhoades; Brendon Patrick,9,0,15,6
1668357018256,MATH 268,A00,098042,Buss; Samuel R,10,0,10,0
1668357018683,MATH 269,A00,098043,Rhoades; Brendon Patrick,10,0,10,0
1668357019109,MATH 270B,A00,098044,Li; Bo,10,0,15,5
1668357019552,MATH 272B,A00,098045,Holst; Michael J,13,0,15,2
1668357019975,MATH 273A,A00,098046,Tian; Xiaochuan,10,0,15,5
1668357020410,MATH 275,A01,098048,Tian; Xiaochuan,6,0,10,4
1668357020845,MATH 278A,A00,098049,Holst; Michael J,8,0,10,2
1668357021278,MATH 278B,A00,098050,Cloninger; Alexander,10,0,10,0
1668357021703,MATH 278C,A00,098051,Nie; Jiawang,7,0,10,3
1668357022137,MATH 280B,A00,098052,Zheng; Tianyi,8,0,15,7
1668357022568,MATH 281B,A00,098053,Bradic; Jelena,1,0,15,14
1668357022991,MATH 282B,A00,098054,Arias-Castro; Ery,0,0,15,15
1668357023428,MATH 285,A00,098055,Fitzsimmons; Patrick J,0,0,15,17
1668357023853,MATH 287B,A00,098056,Arias-Castro; Ery,2,0,15,13
1668357024280,MATH 288,A00,098057,Agarwal; Pooja,9,0,10,1
1668357024280,MATH 288,B00,098058,Zhang; Danna,8,0,10,2
1668357024280,MATH 288,C00,098059,Williams; Ruth J,9,0,10,1
1668357024712,MATH 290B,A00,098060,Roberts; Justin Deritter,13,0,15,2
1668357025141,MATH 292,A00,098061,Belmont; Eva Kinoshita,10,0,10,0
1668357025565,MATH 295,A00,098062,Suk; Andrew Hoon,48,0,50,2
1668357025992,MATH 296,A00,098063,Novak; Jonathan I,20,0,20,0
1668357026429,MATH 297,001,098064,Gamst; Anthony Collins,9997,0,9999,2
1668357526394,COGS 205,A00,101395,Chiba; Andrea,19,0,20,1
1668357526829,COGS 210B,001,101404,Greene; Deanna Jacquelyn,9998,0,9999,1
1668357526829,COGS 210B,002,101417,Xia; Haijun,9999,0,9999,0
1668357526829,COGS 210B,003,101422,Nitz; Douglas A.,9999,0,9999,0
1668357526829,COGS 210B,004,101423,Hollan; James D.,9998,0,9999,1
1668357526829,COGS 210B,005,101424,Deak; Gedeon O.,9998,0,9999,1
1668357526829,COGS 210B,006,101425,Rossano; Federico,9999,0,9999,0
1668357527252,COGS 211B,A00,101427,Coulson; Seana M,9996,0,9999,3
1668357527683,COGS 220,A00,101428,Hollan; James D.,0,0,25,25
1668357528107,COGS 229,A00,101429,Dow; Steven P,18,0,25,7
1668357528531,COGS 230,A00,101430,Klemmer; Scott R,11,0,17,6
1668357528954,COGS 234,A00,101431,Xia; Haijun,1,0,25,24
1668357529376,COGS 260,A00,101432,Kiyonaga; Anastasia,21,0,25,4
1668357529376,COGS 260,B00,101433,Kirsh; David Joel,15,0,25,10
1668357529810,CSE 202,A00,102371,Impagliazzo; Russell,0,0,0,0
1668357530236,CSE 203B,A01,102373,Cheng; Chung Kuan,0,0,0,0
1668357530661,CSE 208,A00,102374,Micciancio; Daniele,0,0,0,0
1668357531083,CSE 209A,A00,112895,Impagliazzo; Russell,0,0,15,15
1668357531509,CSE 209B,A00,108005,Bellare; Mihir,0,0,0,0
1668357531935,CSE 210,A00,113163,Coblenz; Michael J,0,0,0,0
1668357532358,CSE 219,A00,106111,Dow; Steven P,0,0,20,20
1668357532781,CSE 221,A00,102376,Voelker; Geoffrey M.,0,0,0,0
1668357533204,CSE 224,A01,102378,Porter; George M,0,0,0,0
1668357533629,CSE 229A,A00,102379,Savage; Stefan,0,0,0,0
1668357534061,CSE 229C,A00,102380,Munyaka; Imani N. S.,0,0,0,0
1668357534499,CSE 232B,A00,102382,Deutsch; Alin Bernard,0,0,0,0
1668357534928,CSE 234,A01,112904,Kumar; Arun Kumar,0,0,0,0
1668357535352,CSE 237A,A00,102383,Rosing; Tajana Simunic,0,0,0,0
1668357535776,CSE 239A,A00,102384,Deutsch; Alin Bernard,0,0,0,0
1668357536203,CSE 239B,A00,102385,Polikarpova; Nadezhda,0,0,0,0
1668357536636,CSE 240A,A00,102386,Pannuto; Patrick William,0,0,0,0
1668357537060,CSE 240B,A00,102387,Zhao; Jishen,0,0,0,0
1668357537494,CSE 241A,A00,106406,Kang; Mingu,0,0,0,0
1668357537918,CSE 249B,A00,102388,Kahng; Andrew Byun,0,0,8,8
1668357538344,CSE 251B,A01,102392,Cottrell; Garrison W,0,0,0,0
1668357538344,CSE 251B,A02,102393,Cottrell; Garrison W,0,0,0,0
1668357538766,CSE 252B,A00,102394,Ochoa; Benjamin Lawrence,0,0,0,0
1668357539194,CSE 257,A01,102396,Gao; Sicun,0,0,0,0
1668357539621,CSE 272,A00,102397,Li; Tzumao,0,0,0,0
1668357540062,CSE 274,A00,111323,Chern; Albert Ren-Haur,0,0,0,0
1668357540485,CSE 282,A00,102398,Pevzner; Pavel Arkadjevich,0,0,0,0
1668357540913,CSE 284,A00,114175,Gymrek; Melissa Ann,0,0,0,0
1668357541350,CSE 290,A00,102399,Chandraker; Manmohan Krishna,0,0,0,0
1668357541350,CSE 290,B00,102400,Vaccaro; Kristen Marie,0,0,25,25
1668357541350,CSE 290,C00,102414,Pannuto; Patrick William,0,0,25,25
1668357541350,CSE 290,D00,102427,Pevzner; Pavel Arkadjevich,0,0,0,0
1668357541350,CSE 290,E00,102429,Zhao; Jishen,0,0,0,0
1668357541350,CSE 290,F00,102436,Tullsen; Dean Michael,0,0,0,0
1668357541350,CSE 290,G00,102440,Christensen; Henrik I,0,0,20,20
1668357541790,CSE 291,A00,102443,Su; Hao,0,0,0,0
1668357541790,CSE 291,B00,102448,Polikarpova; Nadezhda,0,0,0,0
1668357541790,CSE 291,C00,102453,Vaccaro; Kristen Marie,0,0,0,0
1668357541790,CSE 291,D00,111343,Savage; Stefan,0,0,0,0
1668357541790,CSE 291,E00,116474,Claffy; Kimberly Claire,0,0,0,0
1668357541790,CSE 291,F00,116479,Pasquale; Joseph,0,0,0,0
1668357542245,CSE 293,001,119111,Bafna; Vineet,9999,0,9999,0
1668357542245,CSE 293,002,119118,Bellare; Mihir,9999,0,9999,0
1668357542245,CSE 293,003,119122,Berg-Kirkpatrick; Taylor D,9999,0,9999,0
1668357542245,CSE 293,004,119135,Christensen; Henrik I,9999,0,9999,0
1668357542245,CSE 293,005,119142,Cottrell; Garrison W,9999,0,9999,0
1668357542245,CSE 293,006,119146,Deutsch; Alin Bernard,9999,0,9999,0
1668357542245,CSE 293,007,119159,Esmaeilzadeh; Hadi,9999,0,9999,0
1668357542245,CSE 293,008,119166,Freund; Yoav,9999,0,9999,0
1668357542245,CSE 293,009,119170,Griswold; William G.,9999,0,9999,0
1668357542245,CSE 293,010,119183,Gymrek; Melissa Ann,9999,0,9999,0
1668357542245,CSE 293,011,119190,Heninger; Nadia A,9999,0,9999,0
1668357542245,CSE 293,012,119230,Impagliazzo; Russell,9999,0,9999,0
1668357542245,CSE 293,013,119232,Jhala; Ranjit,9999,0,9999,0
1668357542245,CSE 293,014,119233,Kahng; Andrew Byun,9999,0,9999,0
1668357542245,CSE 293,015,119298,Kane; Daniel Mertz,9999,0,9999,0
1668357542245,CSE 293,016,119299,Kriegman; David J,9999,0,9999,0
1668357542245,CSE 293,017,119300,Kumar; Arun Kumar,9999,0,9999,0
1668357542245,CSE 293,018,119301,Lerner; Sorin,9999,0,9999,0
1668357542245,CSE 293,019,119302,Lovett; Shachar,9999,0,9999,0
1668357542245,CSE 293,020,119303,McAuley; Julian John,9999,0,9999,0
1668357542245,CSE 293,021,119304,Micciancio; Daniele,9999,0,9999,0
1668357542245,CSE 293,022,119367,Orailoglu; Alex,9999,0,9999,0
1668357542245,CSE 293,023,119382,Paturi; Ramamohan,9999,0,9999,0
1668357542245,CSE 293,024,119404,Polikarpova; Nadezhda,9999,0,9999,0
1668357542245,CSE 293,025,119406,Politz; Joseph Gibbs,9999,0,9999,0
1668357542245,CSE 293,026,119411,Porter; George M,9999,0,9999,0
1668357542245,CSE 293,027,119414,Porter; Leonard Emerson,9999,0,9999,0
1668357542245,CSE 293,028,119416,Ramamoorthi; Ravi,9999,0,9999,0
1668357542245,CSE 293,029,119417,Sahoo; Debashis,9999,0,9999,0
1668357542245,CSE 293,030,119420,Saul; Lawrence,9999,0,9999,0
1668357542245,CSE 293,031,119421,Savage; Stefan,9999,0,9999,0
1668357542245,CSE 293,032,119425,Schulze; Jurgen P.,9999,0,9999,0
1668357542245,CSE 293,033,119426,Snoeren; Alex C.,9999,0,9999,0
1668357542245,CSE 293,034,119428,Shang; Jingbo,9999,0,9999,0
1668357542245,CSE 293,035,119430,Stefan; Deian,9999,0,9999,0
1668357542245,CSE 293,036,119431,Su; Hao,9999,0,9999,0
1668357542245,CSE 293,037,119433,Swanson; Steven James,9999,0,9999,0
1668357542245,CSE 293,038,119435,Tullsen; Dean Michael,9999,0,9999,0
1668357542245,CSE 293,039,119483,Voelker; Geoffrey M.,9999,0,9999,0
1668357542245,CSE 293,040,119537,Zhao; Jishen,9999,0,9999,0
1668357542245,CSE 293,041,119538,Zhou; Yuan-Yuan,9999,0,9999,0
1668357542245,CSE 293,042,119539,Gao; Sicun,9999,0,9999,0
1668357542245,CSE 293,043,119540,Weibel; Nadir,9999,0,9999,0
1668357542245,CSE 293,044,119541,Gupta; Rajesh K.,9999,0,9999,0
1668357542245,CSE 293,045,126410,Vaccaro; Kristen Marie,9999,0,9999,0
1668357542245,CSE 293,046,126411,Klemke; Richard,9999,0,9999,0
1668357542680,CSE 294,A00,102459,Voelker; Geoffrey M.,0,0,0,0
1668357542680,CSE 294,B00,111322,Orailoglu; Alex,0,0,0,0
1668357543106,DSE 201,A00,096914,Deutsch; Alin Bernard,30,0,30,0
1668357543544,DSE 210,A00,096915,Dasgupta; Sanjoy,30,0,30,0
1668357543975,DSE 260A,A00,096916,Altintas De Callaf; Ilkay,30,0,30,0
1668357544421,ECE 200,001,103586,Antipa; Nicholas A,9999,0,9999,0
1668357544421,ECE 200,002,103587,Atanasov; Nikolay A.,9999,0,9999,0
1668357544421,ECE 200,003,103588,Bharadia; Dinesh,9999,0,9999,0
1668357544421,ECE 200,004,103589,Cheng; Chung Kuan,9999,0,9999,0
1668357544421,ECE 200,005,103590,Cosman; Pamela C.,9999,0,9999,0
1668357544421,ECE 200,006,103591,Dayeh; Shadi Ahmad,9999,0,9999,0
1668357544421,ECE 200,007,103592,Fainman; Yeshaiahu,9999,0,9999,0
1668357544421,ECE 200,008,103593,Ford; Joseph Earl,9999,0,9999,0
1668357544421,ECE 200,009,103594,Franceschetti; Massimo,9999,0,9999,0
1668357544421,ECE 200,010,103595,Fullerton; Eric E,9999,0,9999,0
1668357544421,ECE 200,011,103596,Galton; Ian A,9999,0,9999,0
1668357544421,ECE 200,012,103597,Gilja; Vikash,9999,0,9999,0
1668357544421,ECE 200,013,103598,Hall; Drew A.,9999,0,9999,0
1668357544421,ECE 200,014,103599,Hsueh; Tzu-Chien,9999,0,9999,0
1668357544421,ECE 200,015,103600,Javidi; Tara,9999,0,9999,0
1668357544421,ECE 200,016,103601,Kahng; Andrew Byun,9999,0,9999,0
1668357544421,ECE 200,017,103602,Kim; Young-Han,9999,0,9999,0
1668357544421,ECE 200,018,103603,Koushanfar; Farinaz,9999,0,9999,0
1668357544421,ECE 200,019,103604,Kuzum; Duygu,9999,0,9999,0
1668357544421,ECE 200,020,103605,Le; Hanh-Phuc,9999,0,9999,0
1668357544421,ECE 200,021,103606,Lin; Bill,9999,0,9999,0
1668357544421,ECE 200,022,103607,Liu; Zhaowei,9998,0,9999,1
1668357544421,ECE 200,023,103608,Lo; Yu-Hwa,9999,0,9999,0
1668357544421,ECE 200,024,103609,Lomakin; Vitaliy,9999,0,9999,0
1668357544421,ECE 200,025,103610,Mercier; Patrick Philip,9999,0,9999,0
1668357544421,ECE 200,026,103611,Meyer; Florian,9999,0,9999,0
1668357544421,ECE 200,027,103612,Milstein; Laurence B.,9999,0,9999,0
1668357544421,ECE 200,028,103613,Mir Arabbaygi; Siavash,9999,0,9999,0
1668357544421,ECE 200,029,103614,Mookherjea; Shayan,9999,0,9999,0
1668357544421,ECE 200,030,103615,Morris; Karcher William,9999,0,9999,0
1668357544421,ECE 200,031,103616,Ng; Tse Nga,9999,0,9999,0
1668357544421,ECE 200,032,103617,Nguyen; Truong Quang,9999,0,9999,0
1668357544421,ECE 200,033,103618,Nomura; Kenji,9999,0,9999,0
1668357544421,ECE 200,034,103619,Orlitsky; Alon,9999,0,9999,0
1668357544421,ECE 200,035,103620,Pal; Piya,9999,0,9999,0
1668357544421,ECE 200,036,103621,Papen; George C.,9999,0,9999,0
1668357544421,ECE 200,037,103622,Radic; Stojan,9999,0,9999,0
1668357544421,ECE 200,038,103623,Rao; Bhaskar D.,9999,0,9999,0
1668357544421,ECE 200,039,103624,Rao; Ramesh R,9999,0,9999,0
1668357544421,ECE 200,040,103625,Rebeiz; Gabriel,9999,0,9999,0
1668357544421,ECE 200,041,103626,Sanford; John R,9999,0,9999,0
1668357544421,ECE 200,042,103627,Siegel; Paul H.,9999,0,9999,0
1668357544421,ECE 200,043,103628,Sievenpiper; Daniel F.,9999,0,9999,0
1668357544421,ECE 200,044,103629,Sworder; David D.,9999,0,9999,0
1668357544421,ECE 200,045,103630,Taur; Yuan,9999,0,9999,0
1668357544421,ECE 200,046,103631,Touri; Behrouz,9999,0,9999,0
1668357544421,ECE 200,047,103632,Trivedi; Mohan M.,9999,0,9999,0
1668357544421,ECE 200,048,103633,Vasconcelos; Nuno,9999,0,9999,0
1668357544421,ECE 200,049,103634,Wang; Xiaolong,9999,0,9999,0
1668357544421,ECE 200,050,103635,Xie; Pengtao,9999,0,9999,0
1668357544421,ECE 200,051,103636,Yip; Michael,9999,0,9999,0
1668357544421,ECE 200,052,103637,Zeger; Kenneth A.,999,0,999,0
1668357544421,ECE 200,053,103638,Zhang; Xinyu,9999,0,9999,0
1668357544421,ECE 200,054,103639,Turakhia; Yatish Girish,9999,0,9999,0
1668357544421,ECE 200,055,103640,Kang; Mingu,9999,0,9999,0
1668357544421,ECE 200,056,103641,Shi; Yuanyuan,9999,0,9999,0
1668357544421,ECE 200,057,103642,Wang; Edward Jay,9999,0,9999,0
1668357544421,ECE 200,058,103643,Zheng; Yang,9999,0,9999,0
1668357544845,ECE 202,A00,103644,Kuzum; Duygu,0,0,0,0
1668357545280,ECE 212BN,A00,103646,Ng; Tse Nga,0,0,0,0
1668357545703,ECE 221,A00,111493,Staff,0,0,0,0
1668357546140,ECE 222B,A00,103647,Lomakin; Vitaliy,0,0,0,0
1668357546572,ECE 230B,A00,103648,Taur; Yuan,0,0,0,0
1668357547001,ECE 238B,A00,103649,Garay; Javier,0,0,0,0
1668357547425,ECE 240B,A00,112900,Fainman; Yeshaiahu,0,0,0,0
1668357547852,ECE 247A,A00,103650,Jokerst; Jesse Vincent,0,0,0,0
1668357548290,ECE 247B,A00,103651,Wang; Joseph,0,0,0,0
1668357548715,ECE 250,A00,103652,Siegel; Paul H.,0,0,0,0
1668357549138,ECE 251A,A00,103654,Rao; Bhaskar D.,0,0,0,0
1668357549572,ECE 257B,A00,103655,Bharadia; Dinesh,0,0,0,0
1668357550005,ECE 258A,A00,103656,Milstein; Laurence B.,0,0,0,0
1668357550432,ECE 260B,A00,103658,Kang; Mingu,0,0,0,0
1668357550860,ECE 264A,A00,103659,Galton; Ian A,0,0,0,0
1668357551285,ECE 265A,A00,103661,Gudem; Prasad S.S.,0,0,0,0
1668357551708,ECE 265D,A00,103662,Gudem; Prasad S.S.,0,0,0,0
1668357552139,ECE 268,A00,103663,Koushanfar; Farinaz,0,0,0,0
1668357552561,ECE 269,A01,103665,Pal; Piya,0,0,0,0
1668357552995,ECE 271B,A00,103666,Vasconcelos; Manuela,0,0,0,0
1668357553429,ECE 276A,A00,103667,Atanasov; Nikolay A.,0,0,0,0
1668357553866,ECE 277,A00,103668,An; Cheolhong,0,0,0,0
1668357554299,ECE 279,A00,117947,Hall; Drew A.,0,0,0,0
1668357555164,ECE 283,A00,103670,Hsueh; Tzu-Chien,0,0,0,0
1668357555590,ECE 284,A00,103671,Turakhia; Yatish Girish,0,0,0,0
1668357556013,ECE 285,A00,103672,Zheng; Yang,0,0,0,0
1668357556013,ECE 285,B00,103673,Sworder; David D.,0,0,0,0
1668357556437,ECE 287,A00,103676,Javidi; Tara,0,0,0,0
1668357556874,MATH 200B,A00,098023,Salehi Golsefidy; Alireza,12,0,15,3
1668357557296,MATH 202B,A00,098024,Rhoades; Brendon Patrick,9,0,15,6
1668357557726,MATH 203B,A00,098025,Oprea; Dragos N.,10,0,15,5
1668357558150,MATH 204B,A00,098026,Sorensen; Claus M,13,0,15,2
1668357558571,MATH 208,A00,098027,Izadi; Elham,7,0,10,3
1668357559013,MATH 209,A00,098028,Pollack; Aaron,10,0,10,0
1668357559443,MATH 211A,A00,112919,Rogalski; Daniel,9,0,10,1
1668357559875,MATH 211B,A00,112920,Seward; Brandon M.,9,0,10,1
1668357560300,MATH 218,A00,098029,Li; Bo,10,0,10,0
1668357560723,MATH 220B,A00,098030,Novak; Jonathan I,11,0,15,4
1668357561161,MATH 221A,A00,098031,Ebenfelt; Peter F,13,0,15,2
1668357561588,MATH 231B,A00,098032,Zlatos; Andrej,12,0,15,3
1668357562013,MATH 240B,A00,098033,Ni; Lei,9,0,15,6
1668357562438,MATH 243,A00,098034,Jekel; David Andrew,10,0,10,0
1668357562863,MATH 245A,A00,098035,Nie; Jiawang,0,0,15,16
1668357563287,MATH 248,A00,098036,Bejenaru; Ioan,10,0,10,0
1668357563712,MATH 250B,A00,098037,Spolaor; Luca,14,0,15,1
1668357564214,MATH 258,A00,098038,Ni; Lei,10,0,10,0
1668357564643,MATH 264B,A00,098041,Rhoades; Brendon Patrick,9,0,15,6
1668357565066,MATH 268,A00,098042,Buss; Samuel R,10,0,10,0
1668357565500,MATH 269,A00,098043,Rhoades; Brendon Patrick,10,0,10,0
1668357565927,MATH 270B,A00,098044,Li; Bo,10,0,15,5
1668357566359,MATH 272B,A00,098045,Holst; Michael J,13,0,15,2
1668357566783,MATH 273A,A00,098046,Tian; Xiaochuan,10,0,15,5
1668357567207,MATH 275,A01,098048,Tian; Xiaochuan,6,0,10,4
1668357567629,MATH 278A,A00,098049,Holst; Michael J,8,0,10,2
1668357568055,MATH 278B,A00,098050,Cloninger; Alexander,10,0,10,0
1668357568486,MATH 278C,A00,098051,Nie; Jiawang,7,0,10,3
1668357568910,MATH 280B,A00,098052,Zheng; Tianyi,8,0,15,7
1668357569336,MATH 281B,A00,098053,Bradic; Jelena,1,0,15,14
1668357569759,MATH 282B,A00,098054,Arias-Castro; Ery,0,0,15,15
1668357570192,MATH 285,A00,098055,Fitzsimmons; Patrick J,0,0,15,17
1668357570617,MATH 287B,A00,098056,Arias-Castro; Ery,2,0,15,13
1668357571044,MATH 288,A00,098057,Agarwal; Pooja,9,0,10,1
1668357571044,MATH 288,B00,098058,Zhang; Danna,8,0,10,2
1668357571044,MATH 288,C00,098059,Williams; Ruth J,9,0,10,1
1668357571479,MATH 290B,A00,098060,Roberts; Justin Deritter,13,0,15,2
1668357571914,MATH 292,A00,098061,Belmont; Eva Kinoshita,10,0,10,0
1668357572340,MATH 295,A00,098062,Suk; Andrew Hoon,48,0,50,2
1668357572762,MATH 296,A00,098063,Novak; Jonathan I,20,0,20,0
1668357573183,MATH 297,001,098064,Gamst; Anthony Collins,9997,0,9999,2
1668358073219,COGS 205,A00,101395,Chiba; Andrea,19,0,20,1
1668358073645,COGS 210B,001,101404,Greene; Deanna Jacquelyn,9998,0,9999,1
1668358073645,COGS 210B,002,101417,Xia; Haijun,9999,0,9999,0
1668358073645,COGS 210B,003,101422,Nitz; Douglas A.,9999,0,9999,0
1668358073645,COGS 210B,004,101423,Hollan; James D.,9998,0,9999,1
1668358073645,COGS 210B,005,101424,Deak; Gedeon O.,9998,0,9999,1
1668358073645,COGS 210B,006,101425,Rossano; Federico,9999,0,9999,0
1668358074069,COGS 211B,A00,101427,Coulson; Seana M,9996,0,9999,3
1668358074497,COGS 220,A00,101428,Hollan; James D.,0,0,25,25
1668358074931,COGS 229,A00,101429,Dow; Steven P,18,0,25,7
1668358075353,COGS 230,A00,101430,Klemmer; Scott R,11,0,17,6
1668358075776,COGS 234,A00,101431,Xia; Haijun,1,0,25,24
1668358076202,COGS 260,A00,101432,Kiyonaga; Anastasia,21,0,25,4
1668358076202,COGS 260,B00,101433,Kirsh; David Joel,15,0,25,10
1668358076627,CSE 202,A00,102371,Impagliazzo; Russell,0,0,0,0
1668358077051,CSE 203B,A01,102373,Cheng; Chung Kuan,0,0,0,0
1668358077475,CSE 208,A00,102374,Micciancio; Daniele,0,0,0,0
1668358077900,CSE 209A,A00,112895,Impagliazzo; Russell,0,0,15,15
1668358078322,CSE 209B,A00,108005,Bellare; Mihir,0,0,0,0
1668358078750,CSE 210,A00,113163,Coblenz; Michael J,0,0,0,0
1668358079175,CSE 219,A00,106111,Dow; Steven P,0,0,20,20
1668358079597,CSE 221,A00,102376,Voelker; Geoffrey M.,0,0,0,0
1668358080020,CSE 224,A01,102378,Porter; George M,0,0,0,0
1668358080443,CSE 229A,A00,102379,Savage; Stefan,0,0,0,0
1668358080866,CSE 229C,A00,102380,Munyaka; Imani N. S.,0,0,0,0
1668358081290,CSE 232B,A00,102382,Deutsch; Alin Bernard,0,0,0,0
1668358081715,CSE 234,A01,112904,Kumar; Arun Kumar,0,0,0,0
1668358082138,CSE 237A,A00,102383,Rosing; Tajana Simunic,0,0,0,0
1668358082560,CSE 239A,A00,102384,Deutsch; Alin Bernard,0,0,0,0
1668358082986,CSE 239B,A00,102385,Polikarpova; Nadezhda,0,0,0,0
1668358083422,CSE 240A,A00,102386,Pannuto; Patrick William,0,0,0,0
1668358083862,CSE 240B,A00,102387,Zhao; Jishen,0,0,0,0
1668358084411,CSE 241A,A00,106406,Kang; Mingu,0,0,0,0
1668358084834,CSE 249B,A00,102388,Kahng; Andrew Byun,0,0,8,8
1668358085258,CSE 251B,A01,102392,Cottrell; Garrison W,0,0,0,0
1668358085258,CSE 251B,A02,102393,Cottrell; Garrison W,0,0,0,0
1668358085681,CSE 252B,A00,102394,Ochoa; Benjamin Lawrence,0,0,0,0
1668358086105,CSE 257,A01,102396,Gao; Sicun,0,0,0,0
1668358086529,CSE 272,A00,102397,Li; Tzumao,0,0,0,0
1668358086952,CSE 274,A00,111323,Chern; Albert Ren-Haur,0,0,0,0
1668358087376,CSE 282,A00,102398,Pevzner; Pavel Arkadjevich,0,0,0,0
1668358087804,CSE 284,A00,114175,Gymrek; Melissa Ann,0,0,0,0
1668358088229,CSE 290,A00,102399,Chandraker; Manmohan Krishna,0,0,0,0
1668358088229,CSE 290,B00,102400,Vaccaro; Kristen Marie,0,0,25,25
1668358088229,CSE 290,C00,102414,Pannuto; Patrick William,0,0,25,25
1668358088229,CSE 290,D00,102427,Pevzner; Pavel Arkadjevich,0,0,0,0
1668358088229,CSE 290,E00,102429,Zhao; Jishen,0,0,0,0
1668358088229,CSE 290,F00,102436,Tullsen; Dean Michael,0,0,0,0
1668358088229,CSE 290,G00,102440,Christensen; Henrik I,0,0,20,20
1668358088654,CSE 291,A00,102443,Su; Hao,0,0,0,0
1668358088654,CSE 291,B00,102448,Polikarpova; Nadezhda,0,0,0,0
1668358088654,CSE 291,C00,102453,Vaccaro; Kristen Marie,0,0,0,0
1668358088654,CSE 291,D00,111343,Savage; Stefan,0,0,0,0
1668358088654,CSE 291,E00,116474,Claffy; Kimberly Claire,0,0,0,0
1668358088654,CSE 291,F00,116479,Pasquale; Joseph,0,0,0,0
1668358089082,CSE 293,001,119111,Bafna; Vineet,9999,0,9999,0
1668358089082,CSE 293,002,119118,Bellare; Mihir,9999,0,9999,0
1668358089082,CSE 293,003,119122,Berg-Kirkpatrick; Taylor D,9999,0,9999,0
1668358089082,CSE 293,004,119135,Christensen; Henrik I,9999,0,9999,0
1668358089082,CSE 293,005,119142,Cottrell; Garrison W,9999,0,9999,0
1668358089082,CSE 293,006,119146,Deutsch; Alin Bernard,9999,0,9999,0
1668358089082,CSE 293,007,119159,Esmaeilzadeh; Hadi,9999,0,9999,0
1668358089082,CSE 293,008,119166,Freund; Yoav,9999,0,9999,0
1668358089082,CSE 293,009,119170,Griswold; William G.,9999,0,9999,0
1668358089082,CSE 293,010,119183,Gymrek; Melissa Ann,9999,0,9999,0
1668358089082,CSE 293,011,119190,Heninger; Nadia A,9999,0,9999,0
1668358089082,CSE 293,012,119230,Impagliazzo; Russell,9999,0,9999,0
1668358089082,CSE 293,013,119232,Jhala; Ranjit,9999,0,9999,0
1668358089082,CSE 293,014,119233,Kahng; Andrew Byun,9999,0,9999,0
1668358089082,CSE 293,015,119298,Kane; Daniel Mertz,9999,0,9999,0
1668358089082,CSE 293,016,119299,Kriegman; David J,9999,0,9999,0
1668358089082,CSE 293,017,119300,Kumar; Arun Kumar,9999,0,9999,0
1668358089082,CSE 293,018,119301,Lerner; Sorin,9999,0,9999,0
1668358089082,CSE 293,019,119302,Lovett; Shachar,9999,0,9999,0
1668358089082,CSE 293,020,119303,McAuley; Julian John,9999,0,9999,0
1668358089082,CSE 293,021,119304,Micciancio; Daniele,9999,0,9999,0
1668358089082,CSE 293,022,119367,Orailoglu; Alex,9999,0,9999,0
1668358089082,CSE 293,023,119382,Paturi; Ramamohan,9999,0,9999,0
1668358089082,CSE 293,024,119404,Polikarpova; Nadezhda,9999,0,9999,0
1668358089082,CSE 293,025,119406,Politz; Joseph Gibbs,9999,0,9999,0
1668358089082,CSE 293,026,119411,Porter; George M,9999,0,9999,0
1668358089082,CSE 293,027,119414,Porter; Leonard Emerson,9999,0,9999,0
1668358089082,CSE 293,028,119416,Ramamoorthi; Ravi,9999,0,9999,0
1668358089082,CSE 293,029,119417,Sahoo; Debashis,9999,0,9999,0
1668358089082,CSE 293,030,119420,Saul; Lawrence,9999,0,9999,0
1668358089082,CSE 293,031,119421,Savage; Stefan,9999,0,9999,0
1668358089082,CSE 293,032,119425,Schulze; Jurgen P.,9999,0,9999,0
1668358089082,CSE 293,033,119426,Snoeren; Alex C.,9999,0,9999,0
1668358089082,CSE 293,034,119428,Shang; Jingbo,9999,0,9999,0
1668358089082,CSE 293,035,119430,Stefan; Deian,9999,0,9999,0
1668358089082,CSE 293,036,119431,Su; Hao,9999,0,9999,0
1668358089082,CSE 293,037,119433,Swanson; Steven James,9999,0,9999,0
1668358089082,CSE 293,038,119435,Tullsen; Dean Michael,9999,0,9999,0
1668358089082,CSE 293,039,119483,Voelker; Geoffrey M.,9999,0,9999,0
1668358089082,CSE 293,040,119537,Zhao; Jishen,9999,0,9999,0
1668358089082,CSE 293,041,119538,Zhou; Yuan-Yuan,9999,0,9999,0
1668358089082,CSE 293,042,119539,Gao; Sicun,9999,0,9999,0
1668358089082,CSE 293,043,119540,Weibel; Nadir,9999,0,9999,0
1668358089082,CSE 293,044,119541,Gupta; Rajesh K.,9999,0,9999,0
1668358089082,CSE 293,045,126410,Vaccaro; Kristen Marie,9999,0,9999,0
1668358089082,CSE 293,046,126411,Klemke; Richard,9999,0,9999,0
1668358089504,CSE 294,A00,102459,Voelker; Geoffrey M.,0,0,0,0
1668358089504,CSE 294,B00,111322,Orailoglu; Alex,0,0,0,0
1668358089926,DSE 201,A00,096914,Deutsch; Alin Bernard,30,0,30,0
1668358090353,DSE 210,A00,096915,Dasgupta; Sanjoy,30,0,30,0
1668358090777,DSE 260A,A00,096916,Altintas De Callaf; Ilkay,30,0,30,0
1668358091204,ECE 200,001,103586,Antipa; Nicholas A,9999,0,9999,0
1668358091204,ECE 200,002,103587,Atanasov; Nikolay A.,9999,0,9999,0
1668358091204,ECE 200,003,103588,Bharadia; Dinesh,9999,0,9999,0
1668358091204,ECE 200,004,103589,Cheng; Chung Kuan,9999,0,9999,0
1668358091204,ECE 200,005,103590,Cosman; Pamela C.,9999,0,9999,0
1668358091204,ECE 200,006,103591,Dayeh; Shadi Ahmad,9999,0,9999,0
1668358091204,ECE 200,007,103592,Fainman; Yeshaiahu,9999,0,9999,0
1668358091204,ECE 200,008,103593,Ford; Joseph Earl,9999,0,9999,0
1668358091204,ECE 200,009,103594,Franceschetti; Massimo,9999,0,9999,0
1668358091204,ECE 200,010,103595,Fullerton; Eric E,9999,0,9999,0
1668358091204,ECE 200,011,103596,Galton; Ian A,9999,0,9999,0
1668358091204,ECE 200,012,103597,Gilja; Vikash,9999,0,9999,0
1668358091204,ECE 200,013,103598,Hall; Drew A.,9999,0,9999,0
1668358091204,ECE 200,014,103599,Hsueh; Tzu-Chien,9999,0,9999,0
1668358091204,ECE 200,015,103600,Javidi; Tara,9999,0,9999,0
1668358091204,ECE 200,016,103601,Kahng; Andrew Byun,9999,0,9999,0
1668358091204,ECE 200,017,103602,Kim; Young-Han,9999,0,9999,0
1668358091204,ECE 200,018,103603,Koushanfar; Farinaz,9999,0,9999,0
1668358091204,ECE 200,019,103604,Kuzum; Duygu,9999,0,9999,0
1668358091204,ECE 200,020,103605,Le; Hanh-Phuc,9999,0,9999,0
1668358091204,ECE 200,021,103606,Lin; Bill,9999,0,9999,0
1668358091204,ECE 200,022,103607,Liu; Zhaowei,9998,0,9999,1
1668358091204,ECE 200,023,103608,Lo; Yu-Hwa,9999,0,9999,0
1668358091204,ECE 200,024,103609,Lomakin; Vitaliy,9999,0,9999,0
1668358091204,ECE 200,025,103610,Mercier; Patrick Philip,9999,0,9999,0
1668358091204,ECE 200,026,103611,Meyer; Florian,9999,0,9999,0
1668358091204,ECE 200,027,103612,Milstein; Laurence B.,9999,0,9999,0
1668358091204,ECE 200,028,103613,Mir Arabbaygi; Siavash,9999,0,9999,0
1668358091204,ECE 200,029,103614,Mookherjea; Shayan,9999,0,9999,0
1668358091204,ECE 200,030,103615,Morris; Karcher William,9999,0,9999,0
1668358091204,ECE 200,031,103616,Ng; Tse Nga,9999,0,9999,0
1668358091204,ECE 200,032,103617,Nguyen; Truong Quang,9999,0,9999,0
1668358091204,ECE 200,033,103618,Nomura; Kenji,9999,0,9999,0
1668358091204,ECE 200,034,103619,Orlitsky; Alon,9999,0,9999,0
1668358091204,ECE 200,035,103620,Pal; Piya,9999,0,9999,0
1668358091204,ECE 200,036,103621,Papen; George C.,9999,0,9999,0
1668358091204,ECE 200,037,103622,Radic; Stojan,9999,0,9999,0
1668358091204,ECE 200,038,103623,Rao; Bhaskar D.,9999,0,9999,0
1668358091204,ECE 200,039,103624,Rao; Ramesh R,9999,0,9999,0
1668358091204,ECE 200,040,103625,Rebeiz; Gabriel,9999,0,9999,0
1668358091204,ECE 200,041,103626,Sanford; John R,9999,0,9999,0
1668358091204,ECE 200,042,103627,Siegel; Paul H.,9999,0,9999,0
1668358091204,ECE 200,043,103628,Sievenpiper; Daniel F.,9999,0,9999,0
1668358091204,ECE 200,044,103629,Sworder; David D.,9999,0,9999,0
1668358091204,ECE 200,045,103630,Taur; Yuan,9999,0,9999,0
1668358091204,ECE 200,046,103631,Touri; Behrouz,9999,0,9999,0
1668358091204,ECE 200,047,103632,Trivedi; Mohan M.,9999,0,9999,0
1668358091204,ECE 200,048,103633,Vasconcelos; Nuno,9999,0,9999,0
1668358091204,ECE 200,049,103634,Wang; Xiaolong,9999,0,9999,0
1668358091204,ECE 200,050,103635,Xie; Pengtao,9999,0,9999,0
1668358091204,ECE 200,051,103636,Yip; Michael,9999,0,9999,0
1668358091204,ECE 200,052,103637,Zeger; Kenneth A.,999,0,999,0
1668358091204,ECE 200,053,103638,Zhang; Xinyu,9999,0,9999,0
1668358091204,ECE 200,054,103639,Turakhia; Yatish Girish,9999,0,9999,0
1668358091204,ECE 200,055,103640,Kang; Mingu,9999,0,9999,0
1668358091204,ECE 200,056,103641,Shi; Yuanyuan,9999,0,9999,0
1668358091204,ECE 200,057,103642,Wang; Edward Jay,9999,0,9999,0
1668358091204,ECE 200,058,103643,Zheng; Yang,9999,0,9999,0
1668358091627,ECE 202,A00,103644,Kuzum; Duygu,0,0,0,0
1668358092070,ECE 212BN,A00,103646,Ng; Tse Nga,0,0,0,0
1668358092496,ECE 221,A00,111493,Staff,0,0,0,0
1668358092919,ECE 222B,A00,103647,Lomakin; Vitaliy,0,0,0,0
1668358093341,ECE 230B,A00,103648,Taur; Yuan,0,0,0,0
1668358093765,ECE 238B,A00,103649,Garay; Javier,0,0,0,0
1668358094201,ECE 240B,A00,112900,Fainman; Yeshaiahu,0,0,0,0
1668358094630,ECE 247A,A00,103650,Jokerst; Jesse Vincent,0,0,0,0
1668358095068,ECE 247B,A00,103651,Wang; Joseph,0,0,0,0
1668358095497,ECE 250,A00,103652,Siegel; Paul H.,0,0,0,0
1668358095920,ECE 251A,A00,103654,Rao; Bhaskar D.,0,0,0,0
1668358096349,ECE 257B,A00,103655,Bharadia; Dinesh,0,0,0,0
1668358096775,ECE 258A,A00,103656,Milstein; Laurence B.,0,0,0,0
1668358097198,ECE 260B,A00,103658,Kang; Mingu,0,0,0,0
1668358097623,ECE 264A,A00,103659,Galton; Ian A,0,0,0,0
1668358098047,ECE 265A,A00,103661,Gudem; Prasad S.S.,0,0,0,0
1668358098472,ECE 265D,A00,103662,Gudem; Prasad S.S.,0,0,0,0
1668358098897,ECE 268,A00,103663,Koushanfar; Farinaz,0,0,0,0
1668358099318,ECE 269,A01,103665,Pal; Piya,0,0,0,0
1668358099742,ECE 271B,A00,103666,Vasconcelos; Manuela,0,0,0,0
1668358100170,ECE 276A,A00,103667,Atanasov; Nikolay A.,0,0,0,0
1668358100593,ECE 277,A00,103668,An; Cheolhong,0,0,0,0
1668358101017,ECE 279,A00,117947,Hall; Drew A.,0,0,0,0
1668358101869,ECE 283,A00,103670,Hsueh; Tzu-Chien,0,0,0,0
1668358102293,ECE 284,A00,103671,Turakhia; Yatish Girish,0,0,0,0
1668358102718,ECE 285,A00,103672,Zheng; Yang,0,0,0,0
1668358102718,ECE 285,B00,103673,Sworder; David D.,0,0,0,0
1668358103143,ECE 287,A00,103676,Javidi; Tara,0,0,0,0
1668358103567,MATH 200B,A00,098023,Salehi Golsefidy; Alireza,12,0,15,3
1668358103991,MATH 202B,A00,098024,Rhoades; Brendon Patrick,9,0,15,6
1668358104416,MATH 203B,A00,098025,Oprea; Dragos N.,10,0,15,5
1668358104842,MATH 204B,A00,098026,Sorensen; Claus M,13,0,15,2
1668358105269,MATH 208,A00,098027,Izadi; Elham,7,0,10,3
1668358105696,MATH 209,A00,098028,Pollack; Aaron,10,0,10,0
1668358106128,MATH 211A,A00,112919,Rogalski; Daniel,9,0,10,1
1668358106552,MATH 211B,A00,112920,Seward; Brandon M.,9,0,10,1
1668358106977,MATH 218,A00,098029,Li; Bo,10,0,10,0
1668358107401,MATH 220B,A00,098030,Novak; Jonathan I,11,0,15,4
1668358107826,MATH 221A,A00,098031,Ebenfelt; Peter F,13,0,15,2
1668358108256,MATH 231B,A00,098032,Zlatos; Andrej,12,0,15,3
1668358108682,MATH 240B,A00,098033,Ni; Lei,9,0,15,6
1668358109108,MATH 243,A00,098034,Jekel; David Andrew,10,0,10,0
1668358109537,MATH 245A,A00,098035,Nie; Jiawang,0,0,15,16
1668358109974,MATH 248,A00,098036,Bejenaru; Ioan,10,0,10,0
1668358110406,MATH 250B,A00,098037,Spolaor; Luca,14,0,15,1
1668358110840,MATH 258,A00,098038,Ni; Lei,10,0,10,0
1668358111273,MATH 264B,A00,098041,Rhoades; Brendon Patrick,9,0,15,6
1668358111698,MATH 268,A00,098042,Buss; Samuel R,10,0,10,0
1668358112125,MATH 269,A00,098043,Rhoades; Brendon Patrick,10,0,10,0
1668358112547,MATH 270B,A00,098044,Li; Bo,10,0,15,5
1668358112970,MATH 272B,A00,098045,Holst; Michael J,13,0,15,2
1668358113393,MATH 273A,A00,098046,Tian; Xiaochuan,10,0,15,5
1668358113816,MATH 275,A01,098048,Tian; Xiaochuan,6,0,10,4
1668358114238,MATH 278A,A00,098049,Holst; Michael J,8,0,10,2
1668358114664,MATH 278B,A00,098050,Cloninger; Alexander,10,0,10,0
1668358115091,MATH 278C,A00,098051,Nie; Jiawang,7,0,10,3
1668358115517,MATH 280B,A00,098052,Zheng; Tianyi,8,0,15,7
1668358115943,MATH 281B,A00,098053,Bradic; Jelena,1,0,15,14
1668358116368,MATH 282B,A00,098054,Arias-Castro; Ery,0,0,15,15
1668358116791,MATH 285,A00,098055,Fitzsimmons; Patrick J,0,0,15,17
1668358117215,MATH 287B,A00,098056,Arias-Castro; Ery,2,0,15,13
1668358117639,MATH 288,A00,098057,Agarwal; Pooja,9,0,10,1
1668358117639,MATH 288,B00,098058,Zhang; Danna,8,0,10,2
1668358117639,MATH 288,C00,098059,Williams; Ruth J,9,0,10,1
1668358118061,MATH 290B,A00,098060,Roberts; Justin Deritter,13,0,15,2
1668358118484,MATH 292,A00,098061,Belmont; Eva Kinoshita,10,0,10,0
1668358118908,MATH 295,A00,098062,Suk; Andrew Hoon,48,0,50,2
1668358119329,MATH 296,A00,098063,Novak; Jonathan I,20,0,20,0
1668358119756,MATH 297,001,098064,Gamst; Anthony Collins,9997,0,9999,2
1668358619738,COGS 205,A00,101395,Chiba; Andrea,19,0,20,1
1668358620174,COGS 210B,001,101404,Greene; Deanna Jacquelyn,9998,0,9999,1
1668358620174,COGS 210B,002,101417,Xia; Haijun,9999,0,9999,0
1668358620174,COGS 210B,003,101422,Nitz; Douglas A.,9999,0,9999,0
1668358620174,COGS 210B,004,101423,Hollan; James D.,9998,0,9999,1
1668358620174,COGS 210B,005,101424,Deak; Gedeon O.,9998,0,9999,1
1668358620174,COGS 210B,006,101425,Rossano; Federico,9999,0,9999,0
1668358620595,COGS 211B,A00,101427,Coulson; Seana M,9996,0,9999,3
1668358621019,COGS 220,A00,101428,Hollan; James D.,0,0,25,25
1668358621443,COGS 229,A00,101429,Dow; Steven P,18,0,25,7
1668358621871,COGS 230,A00,101430,Klemmer; Scott R,11,0,17,6
1668358622297,COGS 234,A00,101431,Xia; Haijun,1,0,25,24
1668358622725,COGS 260,A00,101432,Kiyonaga; Anastasia,21,0,25,4
1668358622725,COGS 260,B00,101433,Kirsh; David Joel,15,0,25,10
1668358623152,CSE 202,A00,102371,Impagliazzo; Russell,0,0,0,0
1668358623580,CSE 203B,A01,102373,Cheng; Chung Kuan,0,0,0,0
1668358624002,CSE 208,A00,102374,Micciancio; Daniele,0,0,0,0
1668358624427,CSE 209A,A00,112895,Impagliazzo; Russell,0,0,15,15
1668358624865,CSE 209B,A00,108005,Bellare; Mihir,0,0,0,0
1668358625298,CSE 210,A00,113163,Coblenz; Michael J,0,0,0,0
1668358625731,CSE 219,A00,106111,Dow; Steven P,0,0,20,20
1668358626164,CSE 221,A00,102376,Voelker; Geoffrey M.,0,0,0,0
1668358626591,CSE 224,A01,102378,Porter; George M,0,0,0,0
1668358627014,CSE 229A,A00,102379,Savage; Stefan,0,0,0,0
1668358627437,CSE 229C,A00,102380,Munyaka; Imani N. S.,0,0,0,0
1668358627862,CSE 232B,A00,102382,Deutsch; Alin Bernard,0,0,0,0
1668358628287,CSE 234,A01,112904,Kumar; Arun Kumar,0,0,0,0
1668358628710,CSE 237A,A00,102383,Rosing; Tajana Simunic,0,0,0,0
1668358629134,CSE 239A,A00,102384,Deutsch; Alin Bernard,0,0,0,0
1668358629557,CSE 239B,A00,102385,Polikarpova; Nadezhda,0,0,0,0
1668358629981,CSE 240A,A00,102386,Pannuto; Patrick William,0,0,0,0
1668358630403,CSE 240B,A00,102387,Zhao; Jishen,0,0,0,0
1668358630827,CSE 241A,A00,106406,Kang; Mingu,0,0,0,0
1668358631250,CSE 249B,A00,102388,Kahng; Andrew Byun,0,0,8,8
1668358631678,CSE 251B,A01,102392,Cottrell; Garrison W,0,0,0,0
1668358631678,CSE 251B,A02,102393,Cottrell; Garrison W,0,0,0,0
1668358632106,CSE 252B,A00,102394,Ochoa; Benjamin Lawrence,0,0,0,0
1668358632529,CSE 257,A01,102396,Gao; Sicun,0,0,0,0
1668358632952,CSE 272,A00,102397,Li; Tzumao,0,0,0,0
1668358633377,CSE 274,A00,111323,Chern; Albert Ren-Haur,0,0,0,0
1668358633803,CSE 282,A00,102398,Pevzner; Pavel Arkadjevich,0,0,0,0
1668358634228,CSE 284,A00,114175,Gymrek; Melissa Ann,0,0,0,0
1668358634653,CSE 290,A00,102399,Chandraker; Manmohan Krishna,0,0,0,0
1668358634653,CSE 290,B00,102400,Vaccaro; Kristen Marie,0,0,25,25
1668358634653,CSE 290,C00,102414,Pannuto; Patrick William,0,0,25,25
1668358634653,CSE 290,D00,102427,Pevzner; Pavel Arkadjevich,0,0,0,0
1668358634653,CSE 290,E00,102429,Zhao; Jishen,0,0,0,0
1668358634653,CSE 290,F00,102436,Tullsen; Dean Michael,0,0,0,0
1668358634653,CSE 290,G00,102440,Christensen; Henrik I,0,0,20,20
1668358635085,CSE 291,A00,102443,Su; Hao,0,0,0,0
1668358635085,CSE 291,B00,102448,Polikarpova; Nadezhda,0,0,0,0
1668358635085,CSE 291,C00,102453,Vaccaro; Kristen Marie,0,0,0,0
1668358635085,CSE 291,D00,111343,Savage; Stefan,0,0,0,0
1668358635085,CSE 291,E00,116474,Claffy; Kimberly Claire,0,0,0,0
1668358635085,CSE 291,F00,116479,Pasquale; Joseph,0,0,0,0
1668358635515,CSE 293,001,119111,Bafna; Vineet,9999,0,9999,0
1668358635515,CSE 293,002,119118,Bellare; Mihir,9999,0,9999,0
1668358635515,CSE 293,003,119122,Berg-Kirkpatrick; Taylor D,9999,0,9999,0
1668358635515,CSE 293,004,119135,Christensen; Henrik I,9999,0,9999,0
1668358635515,CSE 293,005,119142,Cottrell; Garrison W,9999,0,9999,0
1668358635515,CSE 293,006,119146,Deutsch; Alin Bernard,9999,0,9999,0
1668358635515,CSE 293,007,119159,Esmaeilzadeh; Hadi,9999,0,9999,0
1668358635515,CSE 293,008,119166,Freund; Yoav,9999,0,9999,0
1668358635515,CSE 293,009,119170,Griswold; William G.,9999,0,9999,0
1668358635515,CSE 293,010,119183,Gymrek; Melissa Ann,9999,0,9999,0
1668358635515,CSE 293,011,119190,Heninger; Nadia A,9999,0,9999,0
1668358635515,CSE 293,012,119230,Impagliazzo; Russell,9999,0,9999,0
1668358635515,CSE 293,013,119232,Jhala; Ranjit,9999,0,9999,0
1668358635515,CSE 293,014,119233,Kahng; Andrew Byun,9999,0,9999,0
1668358635515,CSE 293,015,119298,Kane; Daniel Mertz,9999,0,9999,0
1668358635515,CSE 293,016,119299,Kriegman; David J,9999,0,9999,0
1668358635515,CSE 293,017,119300,Kumar; Arun Kumar,9999,0,9999,0
1668358635515,CSE 293,018,119301,Lerner; Sorin,9999,0,9999,0
1668358635515,CSE 293,019,119302,Lovett; Shachar,9999,0,9999,0
1668358635515,CSE 293,020,119303,McAuley; Julian John,9999,0,9999,0
1668358635515,CSE 293,021,119304,Micciancio; Daniele,9999,0,9999,0
1668358635515,CSE 293,022,119367,Orailoglu; Alex,9999,0,9999,0
1668358635515,CSE 293,023,119382,Paturi; Ramamohan,9999,0,9999,0
1668358635515,CSE 293,024,119404,Polikarpova; Nadezhda,9999,0,9999,0
1668358635515,CSE 293,025,119406,Politz; Joseph Gibbs,9999,0,9999,0
1668358635515,CSE 293,026,119411,Porter; George M,9999,0,9999,0
1668358635515,CSE 293,027,119414,Porter; Leonard Emerson,9999,0,9999,0
1668358635515,CSE 293,028,119416,Ramamoorthi; Ravi,9999,0,9999,0
1668358635515,CSE 293,029,119417,Sahoo; Debashis,9999,0,9999,0
1668358635515,CSE 293,030,119420,Saul; Lawrence,9999,0,9999,0
1668358635515,CSE 293,031,119421,Savage; Stefan,9999,0,9999,0
1668358635515,CSE 293,032,119425,Schulze; Jurgen P.,9999,0,9999,0
1668358635515,CSE 293,033,119426,Snoeren; Alex C.,9999,0,9999,0
1668358635515,CSE 293,034,119428,Shang; Jingbo,9999,0,9999,0
1668358635515,CSE 293,035,119430,Stefan; Deian,9999,0,9999,0
1668358635515,CSE 293,036,119431,Su; Hao,9999,0,9999,0
1668358635515,CSE 293,037,119433,Swanson; Steven James,9999,0,9999,0
1668358635515,CSE 293,038,119435,Tullsen; Dean Michael,9999,0,9999,0
1668358635515,CSE 293,039,119483,Voelker; Geoffrey M.,9999,0,9999,0
1668358635515,CSE 293,040,119537,Zhao; Jishen,9999,0,9999,0
1668358635515,CSE 293,041,119538,Zhou; Yuan-Yuan,9999,0,9999,0
1668358635515,CSE 293,042,119539,Gao; Sicun,9999,0,9999,0
1668358635515,CSE 293,043,119540,Weibel; Nadir,9999,0,9999,0
1668358635515,CSE 293,044,119541,Gupta; Rajesh K.,9999,0,9999,0
1668358635515,CSE 293,045,126410,Vaccaro; Kristen Marie,9999,0,9999,0
1668358635515,CSE 293,046,126411,Klemke; Richard,9999,0,9999,0
1668358635951,CSE 294,A00,102459,Voelker; Geoffrey M.,0,0,0,0
1668358635951,CSE 294,B00,111322,Orailoglu; Alex,0,0,0,0
1668358636376,DSE 201,A00,096914,Deutsch; Alin Bernard,30,0,30,0
1668358636805,DSE 210,A00,096915,Dasgupta; Sanjoy,30,0,30,0
1668358637230,DSE 260A,A00,096916,Altintas De Callaf; Ilkay,30,0,30,0
1668358637702,ECE 200,001,103586,Antipa; Nicholas A,9999,0,9999,0
1668358637702,ECE 200,002,103587,Atanasov; Nikolay A.,9999,0,9999,0
1668358637702,ECE 200,003,103588,Bharadia; Dinesh,9999,0,9999,0
1668358637702,ECE 200,004,103589,Cheng; Chung Kuan,9999,0,9999,0
1668358637702,ECE 200,005,103590,Cosman; Pamela C.,9999,0,9999,0
1668358637702,ECE 200,006,103591,Dayeh; Shadi Ahmad,9999,0,9999,0
1668358637702,ECE 200,007,103592,Fainman; Yeshaiahu,9999,0,9999,0
1668358637702,ECE 200,008,103593,Ford; Joseph Earl,9999,0,9999,0
1668358637702,ECE 200,009,103594,Franceschetti; Massimo,9999,0,9999,0
1668358637702,ECE 200,010,103595,Fullerton; Eric E,9999,0,9999,0
1668358637702,ECE 200,011,103596,Galton; Ian A,9999,0,9999,0
1668358637702,ECE 200,012,103597,Gilja; Vikash,9999,0,9999,0
1668358637702,ECE 200,013,103598,Hall; Drew A.,9999,0,9999,0
1668358637702,ECE 200,014,103599,Hsueh; Tzu-Chien,9999,0,9999,0
1668358637702,ECE 200,015,103600,Javidi; Tara,9999,0,9999,0
1668358637702,ECE 200,016,103601,Kahng; Andrew Byun,9999,0,9999,0
1668358637702,ECE 200,017,103602,Kim; Young-Han,9999,0,9999,0
1668358637702,ECE 200,018,103603,Koushanfar; Farinaz,9999,0,9999,0
1668358637702,ECE 200,019,103604,Kuzum; Duygu,9999,0,9999,0
1668358637702,ECE 200,020,103605,Le; Hanh-Phuc,9999,0,9999,0
1668358637702,ECE 200,021,103606,Lin; Bill,9999,0,9999,0
1668358637702,ECE 200,022,103607,Liu; Zhaowei,9998,0,9999,1
1668358637702,ECE 200,023,103608,Lo; Yu-Hwa,9999,0,9999,0
1668358637702,ECE 200,024,103609,Lomakin; Vitaliy,9999,0,9999,0
1668358637702,ECE 200,025,103610,Mercier; Patrick Philip,9999,0,9999,0
1668358637702,ECE 200,026,103611,Meyer; Florian,9999,0,9999,0
1668358637702,ECE 200,027,103612,Milstein; Laurence B.,9999,0,9999,0
1668358637702,ECE 200,028,103613,Mir Arabbaygi; Siavash,9999,0,9999,0
1668358637702,ECE 200,029,103614,Mookherjea; Shayan,9999,0,9999,0
1668358637702,ECE 200,030,103615,Morris; Karcher William,9999,0,9999,0
1668358637702,ECE 200,031,103616,Ng; Tse Nga,9999,0,9999,0
1668358637702,ECE 200,032,103617,Nguyen; Truong Quang,9999,0,9999,0
1668358637702,ECE 200,033,103618,Nomura; Kenji,9999,0,9999,0
1668358637702,ECE 200,034,103619,Orlitsky; Alon,9999,0,9999,0
1668358637702,ECE 200,035,103620,Pal; Piya,9999,0,9999,0
1668358637702,ECE 200,036,103621,Papen; George C.,9999,0,9999,0
1668358637702,ECE 200,037,103622,Radic; Stojan,9999,0,9999,0
1668358637702,ECE 200,038,103623,Rao; Bhaskar D.,9999,0,9999,0
1668358637702,ECE 200,039,103624,Rao; Ramesh R,9999,0,9999,0
1668358637702,ECE 200,040,103625,Rebeiz; Gabriel,9999,0,9999,0
1668358637702,ECE 200,041,103626,Sanford; John R,9999,0,9999,0
1668358637702,ECE 200,042,103627,Siegel; Paul H.,9999,0,9999,0
1668358637702,ECE 200,043,103628,Sievenpiper; Daniel F.,9999,0,9999,0
1668358637702,ECE 200,044,103629,Sworder; David D.,9999,0,9999,0
1668358637702,ECE 200,045,103630,Taur; Yuan,9999,0,9999,0
1668358637702,ECE 200,046,103631,Touri; Behrouz,9999,0,9999,0
1668358637702,ECE 200,047,103632,Trivedi; Mohan M.,9999,0,9999,0
1668358637702,ECE 200,048,103633,Vasconcelos; Nuno,9999,0,9999,0
1668358637702,ECE 200,049,103634,Wang; Xiaolong,9999,0,9999,0
1668358637702,ECE 200,050,103635,Xie; Pengtao,9999,0,9999,0
1668358637702,ECE 200,051,103636,Yip; Michael,9999,0,9999,0
1668358637702,ECE 200,052,103637,Zeger; Kenneth A.,999,0,999,0
1668358637702,ECE 200,053,103638,Zhang; Xinyu,9999,0,9999,0
1668358637702,ECE 200,054,103639,Turakhia; Yatish Girish,9999,0,9999,0
1668358637702,ECE 200,055,103640,Kang; Mingu,9999,0,9999,0
1668358637702,ECE 200,056,103641,Shi; Yuanyuan,9999,0,9999,0
1668358637702,ECE 200,057,103642,Wang; Edward Jay,9999,0,9999,0
1668358637702,ECE 200,058,103643,Zheng; Yang,9999,0,9999,0
1668358638125,ECE 202,A00,103644,Kuzum; Duygu,0,0,0,0
1668358638547,ECE 212BN,A00,103646,Ng; Tse Nga,0,0,0,0
1668358638974,ECE 221,A00,111493,Staff,0,0,0,0
1668358639398,ECE 222B,A00,103647,Lomakin; Vitaliy,0,0,0,0
1668358639822,ECE 230B,A00,103648,Taur; Yuan,0,0,0,0
1668358640246,ECE 238B,A00,103649,Garay; Javier,0,0,0,0
1668358640668,ECE 240B,A00,112900,Fainman; Yeshaiahu,0,0,0,0
1668358641092,ECE 247A,A00,103650,Jokerst; Jesse Vincent,0,0,0,0
1668358641519,ECE 247B,A00,103651,Wang; Joseph,0,0,0,0
1668358641943,ECE 250,A00,103652,Siegel; Paul H.,0,0,0,0
1668358642368,ECE 251A,A00,103654,Rao; Bhaskar D.,0,0,0,0
1668358642793,ECE 257B,A00,103655,Bharadia; Dinesh,0,0,0,0
1668358643220,ECE 258A,A00,103656,Milstein; Laurence B.,0,0,0,0
1668358643645,ECE 260B,A00,103658,Kang; Mingu,0,0,0,0
1668358644072,ECE 264A,A00,103659,Galton; Ian A,0,0,0,0
1668358644503,ECE 265A,A00,103661,Gudem; Prasad S.S.,0,0,0,0
1668358644927,ECE 265D,A00,103662,Gudem; Prasad S.S.,0,0,0,0
1668358645351,ECE 268,A00,103663,Koushanfar; Farinaz,0,0,0,0
1668358645779,ECE 269,A01,103665,Pal; Piya,0,0,0,0
1668358646201,ECE 271B,A00,103666,Vasconcelos; Manuela,0,0,0,0
1668358646622,ECE 276A,A00,103667,Atanasov; Nikolay A.,0,0,0,0
1668358647045,ECE 277,A00,103668,An; Cheolhong,0,0,0,0
1668358647640,ECE 279,A00,117947,Hall; Drew A.,0,0,0,0
1668358648491,ECE 283,A00,103670,Hsueh; Tzu-Chien,0,0,0,0
1668358648914,ECE 284,A00,103671,Turakhia; Yatish Girish,0,0,0,0
1668358649344,ECE 285,A00,103672,Zheng; Yang,0,0,0,0
1668358649344,ECE 285,B00,103673,Sworder; David D.,0,0,0,0
1668358649779,ECE 287,A00,103676,Javidi; Tara,0,0,0,0
1668358650205,MATH 200B,A00,098023,Salehi Golsefidy; Alireza,12,0,15,3
1668358650629,MATH 202B,A00,098024,Rhoades; Brendon Patrick,9,0,15,6
1668358651053,MATH 203B,A00,098025,Oprea; Dragos N.,10,0,15,5
1668358651478,MATH 204B,A00,098026,Sorensen; Claus M,13,0,15,2
1668358651901,MATH 208,A00,098027,Izadi; Elham,7,0,10,3
1668358652324,MATH 209,A00,098028,Pollack; Aaron,10,0,10,0
1668358652749,MATH 211A,A00,112919,Rogalski; Daniel,9,0,10,1
1668358653174,MATH 211B,A00,112920,Seward; Brandon M.,9,0,10,1
1668358653599,MATH 218,A00,098029,Li; Bo,10,0,10,0
1668358654026,MATH 220B,A00,098030,Novak; Jonathan I,11,0,15,4
1668358654450,MATH 221A,A00,098031,Ebenfelt; Peter F,13,0,15,2
1668358654883,MATH 231B,A00,098032,Zlatos; Andrej,12,0,15,3
1668358655311,MATH 240B,A00,098033,Ni; Lei,9,0,15,6
1668358655735,MATH 243,A00,098034,Jekel; David Andrew,10,0,10,0
1668358656159,MATH 245A,A00,098035,Nie; Jiawang,0,0,15,16
1668358656586,MATH 248,A00,098036,Bejenaru; Ioan,10,0,10,0
1668358657023,MATH 250B,A00,098037,Spolaor; Luca,14,0,15,1
1668358657458,MATH 258,A00,098038,Ni; Lei,10,0,10,0
1668358657894,MATH 264B,A00,098041,Rhoades; Brendon Patrick,9,0,15,6
1668358658319,MATH 268,A00,098042,Buss; Samuel R,10,0,10,0
1668358658744,MATH 269,A00,098043,Rhoades; Brendon Patrick,10,0,10,0
1668358659167,MATH 270B,A00,098044,Li; Bo,10,0,15,5
1668358659596,MATH 272B,A00,098045,Holst; Michael J,13,0,15,2
1668358660030,MATH 273A,A00,098046,Tian; Xiaochuan,10,0,15,5
1668358660454,MATH 275,A01,098048,Tian; Xiaochuan,6,0,10,4
1668358660879,MATH 278A,A00,098049,Holst; Michael J,8,0,10,2
1668358661304,MATH 278B,A00,098050,Cloninger; Alexander,10,0,10,0
1668358661726,MATH 278C,A00,098051,Nie; Jiawang,7,0,10,3
1668358662150,MATH 280B,A00,098052,Zheng; Tianyi,8,0,15,7
1668358662574,MATH 281B,A00,098053,Bradic; Jelena,1,0,15,14
1668358663000,MATH 282B,A00,098054,Arias-Castro; Ery,0,0,15,15
1668358663426,MATH 285,A00,098055,Fitzsimmons; Patrick J,0,0,15,17
1668358663852,MATH 287B,A00,098056,Arias-Castro; Ery,2,0,15,13
1668358664279,MATH 288,A00,098057,Agarwal; Pooja,9,0,10,1
1668358664279,MATH 288,B00,098058,Zhang; Danna,8,0,10,2
1668358664279,MATH 288,C00,098059,Williams; Ruth J,9,0,10,1
1668358664703,MATH 290B,A00,098060,Roberts; Justin Deritter,13,0,15,2
1668358665127,MATH 292,A00,098061,Belmont; Eva Kinoshita,10,0,10,0
1668358665549,MATH 295,A00,098062,Suk; Andrew Hoon,48,0,50,2
1668358665973,MATH 296,A00,098063,Novak; Jonathan I,20,0,20,0
1668358666401,MATH 297,001,098064,Gamst; Anthony Collins,9997,0,9999,2
1668359165991,COGS 205,A00,101395,Chiba; Andrea,19,0,20,1
1668359166415,COGS 210B,001,101404,Greene; Deanna Jacquelyn,9998,0,9999,1
1668359166415,COGS 210B,002,101417,Xia; Haijun,9999,0,9999,0
1668359166415,COGS 210B,003,101422,Nitz; Douglas A.,9999,0,9999,0
1668359166415,COGS 210B,004,101423,Hollan; James D.,9998,0,9999,1
1668359166415,COGS 210B,005,101424,Deak; Gedeon O.,9998,0,9999,1
1668359166415,COGS 210B,006,101425,Rossano; Federico,9999,0,9999,0
1668359166842,COGS 211B,A00,101427,Coulson; Seana M,9996,0,9999,3
1668359167339,COGS 220,A00,101428,Hollan; James D.,0,0,25,25
1668359167774,COGS 229,A00,101429,Dow; Steven P,18,0,25,7
1668359168208,COGS 230,A00,101430,Klemmer; Scott R,11,0,17,6
1668359168631,COGS 234,A00,101431,Xia; Haijun,1,0,25,24
1668359169054,COGS 260,A00,101432,Kiyonaga; Anastasia,21,0,25,4
1668359169054,COGS 260,B00,101433,Kirsh; David Joel,15,0,25,10
1668359169476,CSE 202,A00,102371,Impagliazzo; Russell,0,0,0,0
1668359169901,CSE 203B,A01,102373,Cheng; Chung Kuan,0,0,0,0
1668359170330,CSE 208,A00,102374,Micciancio; Daniele,0,0,0,0
1668359170755,CSE 209A,A00,112895,Impagliazzo; Russell,0,0,15,15
1668359171183,CSE 209B,A00,108005,Bellare; Mihir,0,0,0,0
1668359171610,CSE 210,A00,113163,Coblenz; Michael J,0,0,0,0
1668359172032,CSE 219,A00,106111,Dow; Steven P,0,0,20,20
1668359172455,CSE 221,A00,102376,Voelker; Geoffrey M.,0,0,0,0
1668359172879,CSE 224,A01,102378,Porter; George M,0,0,0,0
1668359173302,CSE 229A,A00,102379,Savage; Stefan,0,0,0,0
1668359173724,CSE 229C,A00,102380,Munyaka; Imani N. S.,0,0,0,0
1668359174158,CSE 232B,A00,102382,Deutsch; Alin Bernard,0,0,0,0
1668359174584,CSE 234,A01,112904,Kumar; Arun Kumar,0,0,0,0
1668359175011,CSE 237A,A00,102383,Rosing; Tajana Simunic,0,0,0,0
1668359175444,CSE 239A,A00,102384,Deutsch; Alin Bernard,0,0,0,0
1668359175872,CSE 239B,A00,102385,Polikarpova; Nadezhda,0,0,0,0
1668359176296,CSE 240A,A00,102386,Pannuto; Patrick William,0,0,0,0
1668359176718,CSE 240B,A00,102387,Zhao; Jishen,0,0,0,0
1668359177141,CSE 241A,A00,106406,Kang; Mingu,0,0,0,0
1668359177566,CSE 249B,A00,102388,Kahng; Andrew Byun,0,0,8,8
1668359177989,CSE 251B,A01,102392,Cottrell; Garrison W,0,0,0,0
1668359177989,CSE 251B,A02,102393,Cottrell; Garrison W,0,0,0,0
1668359178416,CSE 252B,A00,102394,Ochoa; Benjamin Lawrence,0,0,0,0
1668359178841,CSE 257,A01,102396,Gao; Sicun,0,0,0,0
1668359179266,CSE 272,A00,102397,Li; Tzumao,0,0,0,0
1668359179691,CSE 274,A00,111323,Chern; Albert Ren-Haur,0,0,0,0
1668359180114,CSE 282,A00,102398,Pevzner; Pavel Arkadjevich,0,0,0,0
1668359180539,CSE 284,A00,114175,Gymrek; Melissa Ann,0,0,0,0
1668359180963,CSE 290,A00,102399,Chandraker; Manmohan Krishna,0,0,0,0
1668359180963,CSE 290,B00,102400,Vaccaro; Kristen Marie,0,0,25,25
1668359180963,CSE 290,C00,102414,Pannuto; Patrick William,0,0,25,25
1668359180963,CSE 290,D00,102427,Pevzner; Pavel Arkadjevich,0,0,0,0
1668359180963,CSE 290,E00,102429,Zhao; Jishen,0,0,0,0
1668359180963,CSE 290,F00,102436,Tullsen; Dean Michael,0,0,0,0
1668359180963,CSE 290,G00,102440,Christensen; Henrik I,0,0,20,20
1668359181393,CSE 291,A00,102443,Su; Hao,0,0,0,0
1668359181393,CSE 291,B00,102448,Polikarpova; Nadezhda,0,0,0,0
1668359181393,CSE 291,C00,102453,Vaccaro; Kristen Marie,0,0,0,0
1668359181393,CSE 291,D00,111343,Savage; Stefan,0,0,0,0
1668359181393,CSE 291,E00,116474,Claffy; Kimberly Claire,0,0,0,0
1668359181393,CSE 291,F00,116479,Pasquale; Joseph,0,0,0,0
1668359181848,CSE 293,001,119111,Bafna; Vineet,9999,0,9999,0
1668359181848,CSE 293,002,119118,Bellare; Mihir,9999,0,9999,0
1668359181848,CSE 293,003,119122,Berg-Kirkpatrick; Taylor D,9999,0,9999,0
1668359181848,CSE 293,004,119135,Christensen; Henrik I,9999,0,9999,0
1668359181848,CSE 293,005,119142,Cottrell; Garrison W,9999,0,9999,0
1668359181848,CSE 293,006,119146,Deutsch; Alin Bernard,9999,0,9999,0
1668359181848,CSE 293,007,119159,Esmaeilzadeh; Hadi,9999,0,9999,0
1668359181848,CSE 293,008,119166,Freund; Yoav,9999,0,9999,0
1668359181848,CSE 293,009,119170,Griswold; William G.,9999,0,9999,0
1668359181848,CSE 293,010,119183,Gymrek; Melissa Ann,9999,0,9999,0
1668359181848,CSE 293,011,119190,Heninger; Nadia A,9999,0,9999,0
1668359181848,CSE 293,012,119230,Impagliazzo; Russell,9999,0,9999,0
1668359181848,CSE 293,013,119232,Jhala; Ranjit,9999,0,9999,0
1668359181848,CSE 293,014,119233,Kahng; Andrew Byun,9999,0,9999,0
1668359181848,CSE 293,015,119298,Kane; Daniel Mertz,9999,0,9999,0
1668359181848,CSE 293,016,119299,Kriegman; David J,9999,0,9999,0
1668359181848,CSE 293,017,119300,Kumar; Arun Kumar,9999,0,9999,0
1668359181848,CSE 293,018,119301,Lerner; Sorin,9999,0,9999,0
1668359181848,CSE 293,019,119302,Lovett; Shachar,9999,0,9999,0
1668359181848,CSE 293,020,119303,McAuley; Julian John,9999,0,9999,0
1668359181848,CSE 293,021,119304,Micciancio; Daniele,9999,0,9999,0
1668359181848,CSE 293,022,119367,Orailoglu; Alex,9999,0,9999,0
1668359181848,CSE 293,023,119382,Paturi; Ramamohan,9999,0,9999,0
1668359181848,CSE 293,024,119404,Polikarpova; Nadezhda,9999,0,9999,0
1668359181848,CSE 293,025,119406,Politz; Joseph Gibbs,9999,0,9999,0
1668359181848,CSE 293,026,119411,Porter; George M,9999,0,9999,0
1668359181848,CSE 293,027,119414,Porter; Leonard Emerson,9999,0,9999,0
1668359181848,CSE 293,028,119416,Ramamoorthi; Ravi,9999,0,9999,0
1668359181848,CSE 293,029,119417,Sahoo; Debashis,9999,0,9999,0
1668359181848,CSE 293,030,119420,Saul; Lawrence,9999,0,9999,0
1668359181848,CSE 293,031,119421,Savage; Stefan,9999,0,9999,0
1668359181848,CSE 293,032,119425,Schulze; Jurgen P.,9999,0,9999,0
1668359181848,CSE 293,033,119426,Snoeren; Alex C.,9999,0,9999,0
1668359181848,CSE 293,034,119428,Shang; Jingbo,9999,0,9999,0
1668359181848,CSE 293,035,119430,Stefan; Deian,9999,0,9999,0
1668359181848,CSE 293,036,119431,Su; Hao,9999,0,9999,0
1668359181848,CSE 293,037,119433,Swanson; Steven James,9999,0,9999,0
1668359181848,CSE 293,038,119435,Tullsen; Dean Michael,9999,0,9999,0
1668359181848,CSE 293,039,119483,Voelker; Geoffrey M.,9999,0,9999,0
1668359181848,CSE 293,040,119537,Zhao; Jishen,9999,0,9999,0
1668359181848,CSE 293,041,119538,Zhou; Yuan-Yuan,9999,0,9999,0
1668359181848,CSE 293,042,119539,Gao; Sicun,9999,0,9999,0
1668359181848,CSE 293,043,119540,Weibel; Nadir,9999,0,9999,0
1668359181848,CSE 293,044,119541,Gupta; Rajesh K.,9999,0,9999,0
1668359181848,CSE 293,045,126410,Vaccaro; Kristen Marie,9999,0,9999,0
1668359181848,CSE 293,046,126411,Klemke; Richard,9999,0,9999,0
1668359182270,CSE 294,A00,102459,Voelker; Geoffrey M.,0,0,0,0
1668359182270,CSE 294,B00,111322,Orailoglu; Alex,0,0,0,0
1668359182693,DSE 201,A00,096914,Deutsch; Alin Bernard,30,0,30,0
1668359183117,DSE 210,A00,096915,Dasgupta; Sanjoy,30,0,30,0
1668359183542,DSE 260A,A00,096916,Altintas De Callaf; Ilkay,30,0,30,0
1668359183971,ECE 200,001,103586,Antipa; Nicholas A,9999,0,9999,0
1668359183971,ECE 200,002,103587,Atanasov; Nikolay A.,9999,0,9999,0
1668359183971,ECE 200,003,103588,Bharadia; Dinesh,9999,0,9999,0
1668359183971,ECE 200,004,103589,Cheng; Chung Kuan,9999,0,9999,0
1668359183971,ECE 200,005,103590,Cosman; Pamela C.,9999,0,9999,0
1668359183971,ECE 200,006,103591,Dayeh; Shadi Ahmad,9999,0,9999,0
1668359183971,ECE 200,007,103592,Fainman; Yeshaiahu,9999,0,9999,0
1668359183971,ECE 200,008,103593,Ford; Joseph Earl,9999,0,9999,0
1668359183971,ECE 200,009,103594,Franceschetti; Massimo,9999,0,9999,0
1668359183971,ECE 200,010,103595,Fullerton; Eric E,9999,0,9999,0
1668359183971,ECE 200,011,103596,Galton; Ian A,9999,0,9999,0
1668359183971,ECE 200,012,103597,Gilja; Vikash,9999,0,9999,0
1668359183971,ECE 200,013,103598,Hall; Drew A.,9999,0,9999,0
1668359183971,ECE 200,014,103599,Hsueh; Tzu-Chien,9999,0,9999,0
1668359183971,ECE 200,015,103600,Javidi; Tara,9999,0,9999,0
1668359183971,ECE 200,016,103601,Kahng; Andrew Byun,9999,0,9999,0
1668359183971,ECE 200,017,103602,Kim; Young-Han,9999,0,9999,0
1668359183971,ECE 200,018,103603,Koushanfar; Farinaz,9999,0,9999,0
1668359183971,ECE 200,019,103604,Kuzum; Duygu,9999,0,9999,0
1668359183971,ECE 200,020,103605,Le; Hanh-Phuc,9999,0,9999,0
1668359183971,ECE 200,021,103606,Lin; Bill,9999,0,9999,0
1668359183971,ECE 200,022,103607,Liu; Zhaowei,9998,0,9999,1
1668359183971,ECE 200,023,103608,Lo; Yu-Hwa,9999,0,9999,0
1668359183971,ECE 200,024,103609,Lomakin; Vitaliy,9999,0,9999,0
1668359183971,ECE 200,025,103610,Mercier; Patrick Philip,9999,0,9999,0
1668359183971,ECE 200,026,103611,Meyer; Florian,9999,0,9999,0
1668359183971,ECE 200,027,103612,Milstein; Laurence B.,9999,0,9999,0
1668359183971,ECE 200,028,103613,Mir Arabbaygi; Siavash,9999,0,9999,0
1668359183971,ECE 200,029,103614,Mookherjea; Shayan,9999,0,9999,0
1668359183971,ECE 200,030,103615,Morris; Karcher William,9999,0,9999,0
1668359183971,ECE 200,031,103616,Ng; Tse Nga,9999,0,9999,0
1668359183971,ECE 200,032,103617,Nguyen; Truong Quang,9999,0,9999,0
1668359183971,ECE 200,033,103618,Nomura; Kenji,9999,0,9999,0
1668359183971,ECE 200,034,103619,Orlitsky; Alon,9999,0,9999,0
1668359183971,ECE 200,035,103620,Pal; Piya,9999,0,9999,0
1668359183971,ECE 200,036,103621,Papen; George C.,9999,0,9999,0
1668359183971,ECE 200,037,103622,Radic; Stojan,9999,0,9999,0
1668359183971,ECE 200,038,103623,Rao; Bhaskar D.,9999,0,9999,0
1668359183971,ECE 200,039,103624,Rao; Ramesh R,9999,0,9999,0
1668359183971,ECE 200,040,103625,Rebeiz; Gabriel,9999,0,9999,0
1668359183971,ECE 200,041,103626,Sanford; John R,9999,0,9999,0
1668359183971,ECE 200,042,103627,Siegel; Paul H.,9999,0,9999,0
1668359183971,ECE 200,043,103628,Sievenpiper; Daniel F.,9999,0,9999,0
1668359183971,ECE 200,044,103629,Sworder; David D.,9999,0,9999,0
1668359183971,ECE 200,045,103630,Taur; Yuan,9999,0,9999,0
1668359183971,ECE 200,046,103631,Touri; Behrouz,9999,0,9999,0
1668359183971,ECE 200,047,103632,Trivedi; Mohan M.,9999,0,9999,0
1668359183971,ECE 200,048,103633,Vasconcelos; Nuno,9999,0,9999,0
1668359183971,ECE 200,049,103634,Wang; Xiaolong,9999,0,9999,0
1668359183971,ECE 200,050,103635,Xie; Pengtao,9999,0,9999,0
1668359183971,ECE 200,051,103636,Yip; Michael,9999,0,9999,0
1668359183971,ECE 200,052,103637,Zeger; Kenneth A.,999,0,999,0
1668359183971,ECE 200,053,103638,Zhang; Xinyu,9999,0,9999,0
1668359183971,ECE 200,054,103639,Turakhia; Yatish Girish,9999,0,9999,0
1668359183971,ECE 200,055,103640,Kang; Mingu,9999,0,9999,0
1668359183971,ECE 200,056,103641,Shi; Yuanyuan,9999,0,9999,0
1668359183971,ECE 200,057,103642,Wang; Edward Jay,9999,0,9999,0
1668359183971,ECE 200,058,103643,Zheng; Yang,9999,0,9999,0
1668359184397,ECE 202,A00,103644,Kuzum; Duygu,0,0,0,0
1668359184821,ECE 212BN,A00,103646,Ng; Tse Nga,0,0,0,0
1668359185260,ECE 221,A00,111493,Staff,0,0,0,0
1668359185692,ECE 222B,A00,103647,Lomakin; Vitaliy,0,0,0,0
1668359186116,ECE 230B,A00,103648,Taur; Yuan,0,0,0,0
1668359186540,ECE 238B,A00,103649,Garay; Javier,0,0,0,0
1668359186981,ECE 240B,A00,112900,Fainman; Yeshaiahu,0,0,0,0
1668359187407,ECE 247A,A00,103650,Jokerst; Jesse Vincent,0,0,0,0
1668359187829,ECE 247B,A00,103651,Wang; Joseph,0,0,0,0
1668359188255,ECE 250,A00,103652,Siegel; Paul H.,0,0,0,0
1668359188678,ECE 251A,A00,103654,Rao; Bhaskar D.,0,0,0,0
1668359189105,ECE 257B,A00,103655,Bharadia; Dinesh,0,0,0,0
1668359189528,ECE 258A,A00,103656,Milstein; Laurence B.,0,0,0,0
1668359189957,ECE 260B,A00,103658,Kang; Mingu,0,0,0,0
1668359190381,ECE 264A,A00,103659,Galton; Ian A,0,0,0,0
1668359190809,ECE 265A,A00,103661,Gudem; Prasad S.S.,0,0,0,0
1668359191240,ECE 265D,A00,103662,Gudem; Prasad S.S.,0,0,0,0
1668359191665,ECE 268,A00,103663,Koushanfar; Farinaz,0,0,0,0
1668359192090,ECE 269,A01,103665,Pal; Piya,0,0,0,0
1668359192516,ECE 271B,A00,103666,Vasconcelos; Manuela,0,0,0,0
1668359192939,ECE 276A,A00,103667,Atanasov; Nikolay A.,0,0,0,0
1668359193363,ECE 277,A00,103668,An; Cheolhong,0,0,0,0
1668359193788,ECE 279,A00,117947,Hall; Drew A.,0,0,0,0
1668359194637,ECE 283,A00,103670,Hsueh; Tzu-Chien,0,0,0,0
1668359195062,ECE 284,A00,103671,Turakhia; Yatish Girish,0,0,0,0
1668359195485,ECE 285,A00,103672,Zheng; Yang,0,0,0,0
1668359195485,ECE 285,B00,103673,Sworder; David D.,0,0,0,0
1668359195913,ECE 287,A00,103676,Javidi; Tara,0,0,0,0
1668359196336,MATH 200B,A00,098023,Salehi Golsefidy; Alireza,12,0,15,3
1668359196770,MATH 202B,A00,098024,Rhoades; Brendon Patrick,9,0,15,6
1668359197195,MATH 203B,A00,098025,Oprea; Dragos N.,10,0,15,5
1668359197633,MATH 204B,A00,098026,Sorensen; Claus M,13,0,15,2
1668359198055,MATH 208,A00,098027,Izadi; Elham,7,0,10,3
1668359198479,MATH 209,A00,098028,Pollack; Aaron,10,0,10,0
1668359198911,MATH 211A,A00,112919,Rogalski; Daniel,9,0,10,1
1668359199338,MATH 211B,A00,112920,Seward; Brandon M.,9,0,10,1
1668359199761,MATH 218,A00,098029,Li; Bo,10,0,10,0
1668359200186,MATH 220B,A00,098030,Novak; Jonathan I,11,0,15,4
1668359200620,MATH 221A,A00,098031,Ebenfelt; Peter F,13,0,15,2
1668359201058,MATH 231B,A00,098032,Zlatos; Andrej,12,0,15,3
1668359201484,MATH 240B,A00,098033,Ni; Lei,9,0,15,6
1668359201909,MATH 243,A00,098034,Jekel; David Andrew,10,0,10,0
1668359202334,MATH 245A,A00,098035,Nie; Jiawang,0,0,15,16
1668359202764,MATH 248,A00,098036,Bejenaru; Ioan,10,0,10,0
1668359203196,MATH 250B,A00,098037,Spolaor; Luca,14,0,15,1
1668359203635,MATH 258,A00,098038,Ni; Lei,10,0,10,0
1668359204074,MATH 264B,A00,098041,Rhoades; Brendon Patrick,9,0,15,6
1668359204498,MATH 268,A00,098042,Buss; Samuel R,10,0,10,0
1668359204923,MATH 269,A00,098043,Rhoades; Brendon Patrick,10,0,10,0
1668359205346,MATH 270B,A00,098044,Li; Bo,10,0,15,5
1668359205769,MATH 272B,A00,098045,Holst; Michael J,13,0,15,2
1668359206195,MATH 273A,A00,098046,Tian; Xiaochuan,10,0,15,5
1668359206619,MATH 275,A01,098048,Tian; Xiaochuan,6,0,10,4
1668359207044,MATH 278A,A00,098049,Holst; Michael J,8,0,10,2
1668359207471,MATH 278B,A00,098050,Cloninger; Alexander,10,0,10,0
1668359207894,MATH 278C,A00,098051,Nie; Jiawang,7,0,10,3
1668359208321,MATH 280B,A00,098052,Zheng; Tianyi,8,0,15,7
1668359208747,MATH 281B,A00,098053,Bradic; Jelena,1,0,15,14
1668359209170,MATH 282B,A00,098054,Arias-Castro; Ery,0,0,15,15
1668359209597,MATH 285,A00,098055,Fitzsimmons; Patrick J,0,0,15,17
1668359210020,MATH 287B,A00,098056,Arias-Castro; Ery,2,0,15,13
1668359210533,MATH 288,A00,098057,Agarwal; Pooja,9,0,10,1
1668359210533,MATH 288,B00,098058,Zhang; Danna,8,0,10,2
1668359210533,MATH 288,C00,098059,Williams; Ruth J,9,0,10,1
1668359210956,MATH 290B,A00,098060,Roberts; Justin Deritter,13,0,15,2
1668359211378,MATH 292,A00,098061,Belmont; Eva Kinoshita,10,0,10,0
1668359211800,MATH 295,A00,098062,Suk; Andrew Hoon,48,0,50,2
1668359212231,MATH 296,A00,098063,Novak; Jonathan I,20,0,20,0
1668359212654,MATH 297,001,098064,Gamst; Anthony Collins,9997,0,9999,2
1668359712309,COGS 205,A00,101395,Chiba; Andrea,19,0,20,1
1668359712733,COGS 210B,001,101404,Greene; Deanna Jacquelyn,9998,0,9999,1
1668359712733,COGS 210B,002,101417,Xia; Haijun,9999,0,9999,0
1668359712733,COGS 210B,003,101422,Nitz; Douglas A.,9999,0,9999,0
1668359712733,COGS 210B,004,101423,Hollan; James D.,9998,0,9999,1
1668359712733,COGS 210B,005,101424,Deak; Gedeon O.,9998,0,9999,1
1668359712733,COGS 210B,006,101425,Rossano; Federico,9999,0,9999,0
1668359713158,COGS 211B,A00,101427,Coulson; Seana M,9996,0,9999,3
1668359713579,COGS 220,A00,101428,Hollan; James D.,0,0,25,25
1668359714003,COGS 229,A00,101429,Dow; Steven P,18,0,25,7
1668359714428,COGS 230,A00,101430,Klemmer; Scott R,11,0,17,6
1668359714851,COGS 234,A00,101431,Xia; Haijun,1,0,25,24
1668359715276,COGS 260,A00,101432,Kiyonaga; Anastasia,21,0,25,4
1668359715276,COGS 260,B00,101433,Kirsh; David Joel,15,0,25,10
1668359715698,CSE 202,A00,102371,Impagliazzo; Russell,0,0,0,0
1668359716124,CSE 203B,A01,102373,Cheng; Chung Kuan,0,0,0,0
1668359716556,CSE 208,A00,102374,Micciancio; Daniele,0,0,0,0
1668359716989,CSE 209A,A00,112895,Impagliazzo; Russell,0,0,15,15
1668359717422,CSE 209B,A00,108005,Bellare; Mihir,0,0,0,0
1668359717856,CSE 210,A00,113163,Coblenz; Michael J,0,0,0,0
1668359718285,CSE 219,A00,106111,Dow; Steven P,0,0,20,20
1668359718720,CSE 221,A00,102376,Voelker; Geoffrey M.,0,0,0,0
1668359719152,CSE 224,A01,102378,Porter; George M,0,0,0,0
1668359719574,CSE 229A,A00,102379,Savage; Stefan,0,0,0,0
1668359719999,CSE 229C,A00,102380,Munyaka; Imani N. S.,0,0,0,0
1668359720431,CSE 232B,A00,102382,Deutsch; Alin Bernard,0,0,0,0
1668359720857,CSE 234,A01,112904,Kumar; Arun Kumar,0,0,0,0
1668359721294,CSE 237A,A00,102383,Rosing; Tajana Simunic,0,0,0,0
1668359721718,CSE 239A,A00,102384,Deutsch; Alin Bernard,0,0,0,0
1668359722140,CSE 239B,A00,102385,Polikarpova; Nadezhda,0,0,0,0
1668359722565,CSE 240A,A00,102386,Pannuto; Patrick William,0,0,0,0
1668359722987,CSE 240B,A00,102387,Zhao; Jishen,0,0,0,0
1668359723414,CSE 241A,A00,106406,Kang; Mingu,0,0,0,0
1668359723837,CSE 249B,A00,102388,Kahng; Andrew Byun,0,0,8,8
1668359724263,CSE 251B,A01,102392,Cottrell; Garrison W,0,0,0,0
1668359724263,CSE 251B,A02,102393,Cottrell; Garrison W,0,0,0,0
1668359724687,CSE 252B,A00,102394,Ochoa; Benjamin Lawrence,0,0,0,0
1668359725109,CSE 257,A01,102396,Gao; Sicun,0,0,0,0
1668359725536,CSE 272,A00,102397,Li; Tzumao,0,0,0,0
1668359725959,CSE 274,A00,111323,Chern; Albert Ren-Haur,0,0,0,0
1668359726383,CSE 282,A00,102398,Pevzner; Pavel Arkadjevich,0,0,0,0
1668359726812,CSE 284,A00,114175,Gymrek; Melissa Ann,0,0,0,0
1668359727245,CSE 290,A00,102399,Chandraker; Manmohan Krishna,0,0,0,0
1668359727245,CSE 290,B00,102400,Vaccaro; Kristen Marie,0,0,25,25
1668359727245,CSE 290,C00,102414,Pannuto; Patrick William,0,0,25,25
1668359727245,CSE 290,D00,102427,Pevzner; Pavel Arkadjevich,0,0,0,0
1668359727245,CSE 290,E00,102429,Zhao; Jishen,0,0,0,0
1668359727245,CSE 290,F00,102436,Tullsen; Dean Michael,0,0,0,0
1668359727245,CSE 290,G00,102440,Christensen; Henrik I,0,0,20,20
1668359727677,CSE 291,A00,102443,Su; Hao,0,0,0,0
1668359727677,CSE 291,B00,102448,Polikarpova; Nadezhda,0,0,0,0
1668359727677,CSE 291,C00,102453,Vaccaro; Kristen Marie,0,0,0,0
1668359727677,CSE 291,D00,111343,Savage; Stefan,0,0,0,0
1668359727677,CSE 291,E00,116474,Claffy; Kimberly Claire,0,0,0,0
1668359727677,CSE 291,F00,116479,Pasquale; Joseph,0,0,0,0
1668359728104,CSE 293,001,119111,Bafna; Vineet,9999,0,9999,0
1668359728104,CSE 293,002,119118,Bellare; Mihir,9999,0,9999,0
1668359728104,CSE 293,003,119122,Berg-Kirkpatrick; Taylor D,9999,0,9999,0
1668359728104,CSE 293,004,119135,Christensen; Henrik I,9999,0,9999,0
1668359728104,CSE 293,005,119142,Cottrell; Garrison W,9999,0,9999,0
1668359728104,CSE 293,006,119146,Deutsch; Alin Bernard,9999,0,9999,0
1668359728104,CSE 293,007,119159,Esmaeilzadeh; Hadi,9999,0,9999,0
1668359728104,CSE 293,008,119166,Freund; Yoav,9999,0,9999,0
1668359728104,CSE 293,009,119170,Griswold; William G.,9999,0,9999,0
1668359728104,CSE 293,010,119183,Gymrek; Melissa Ann,9999,0,9999,0
1668359728104,CSE 293,011,119190,Heninger; Nadia A,9999,0,9999,0
1668359728104,CSE 293,012,119230,Impagliazzo; Russell,9999,0,9999,0
1668359728104,CSE 293,013,119232,Jhala; Ranjit,9999,0,9999,0
1668359728104,CSE 293,014,119233,Kahng; Andrew Byun,9999,0,9999,0
1668359728104,CSE 293,015,119298,Kane; Daniel Mertz,9999,0,9999,0
1668359728104,CSE 293,016,119299,Kriegman; David J,9999,0,9999,0
1668359728104,CSE 293,017,119300,Kumar; Arun Kumar,9999,0,9999,0
1668359728104,CSE 293,018,119301,Lerner; Sorin,9999,0,9999,0
1668359728104,CSE 293,019,119302,Lovett; Shachar,9999,0,9999,0
1668359728104,CSE 293,020,119303,McAuley; Julian John,9999,0,9999,0
1668359728104,CSE 293,021,119304,Micciancio; Daniele,9999,0,9999,0
1668359728104,CSE 293,022,119367,Orailoglu; Alex,9999,0,9999,0
1668359728104,CSE 293,023,119382,Paturi; Ramamohan,9999,0,9999,0
1668359728104,CSE 293,024,119404,Polikarpova; Nadezhda,9999,0,9999,0
1668359728104,CSE 293,025,119406,Politz; Joseph Gibbs,9999,0,9999,0
1668359728104,CSE 293,026,119411,Porter; George M,9999,0,9999,0
1668359728104,CSE 293,027,119414,Porter; Leonard Emerson,9999,0,9999,0
1668359728104,CSE 293,028,119416,Ramamoorthi; Ravi,9999,0,9999,0
1668359728104,CSE 293,029,119417,Sahoo; Debashis,9999,0,9999,0
1668359728104,CSE 293,030,119420,Saul; Lawrence,9999,0,9999,0
1668359728104,CSE 293,031,119421,Savage; Stefan,9999,0,9999,0
1668359728104,CSE 293,032,119425,Schulze; Jurgen P.,9999,0,9999,0
1668359728104,CSE 293,033,119426,Snoeren; Alex C.,9999,0,9999,0
1668359728104,CSE 293,034,119428,Shang; Jingbo,9999,0,9999,0
1668359728104,CSE 293,035,119430,Stefan; Deian,9999,0,9999,0
1668359728104,CSE 293,036,119431,Su; Hao,9999,0,9999,0
1668359728104,CSE 293,037,119433,Swanson; Steven James,9999,0,9999,0
1668359728104,CSE 293,038,119435,Tullsen; Dean Michael,9999,0,9999,0
1668359728104,CSE 293,039,119483,Voelker; Geoffrey M.,9999,0,9999,0
1668359728104,CSE 293,040,119537,Zhao; Jishen,9999,0,9999,0
1668359728104,CSE 293,041,119538,Zhou; Yuan-Yuan,9999,0,9999,0
1668359728104,CSE 293,042,119539,Gao; Sicun,9999,0,9999,0
1668359728104,CSE 293,043,119540,Weibel; Nadir,9999,0,9999,0
1668359728104,CSE 293,044,119541,Gupta; Rajesh K.,9999,0,9999,0
1668359728104,CSE 293,045,126410,Vaccaro; Kristen Marie,9999,0,9999,0
1668359728104,CSE 293,046,126411,Klemke; Richard,9999,0,9999,0
1668359728535,CSE 294,A00,102459,Voelker; Geoffrey M.,0,0,0,0
1668359728535,CSE 294,B00,111322,Orailoglu; Alex,0,0,0,0
1668359728966,DSE 201,A00,096914,Deutsch; Alin Bernard,30,0,30,0
1668359729407,DSE 210,A00,096915,Dasgupta; Sanjoy,30,0,30,0
1668359729830,DSE 260A,A00,096916,Altintas De Callaf; Ilkay,30,0,30,0
1668359730373,ECE 200,001,103586,Antipa; Nicholas A,9999,0,9999,0
1668359730373,ECE 200,002,103587,Atanasov; Nikolay A.,9999,0,9999,0
1668359730373,ECE 200,003,103588,Bharadia; Dinesh,9999,0,9999,0
1668359730373,ECE 200,004,103589,Cheng; Chung Kuan,9999,0,9999,0
1668359730373,ECE 200,005,103590,Cosman; Pamela C.,9999,0,9999,0
1668359730373,ECE 200,006,103591,Dayeh; Shadi Ahmad,9999,0,9999,0
1668359730373,ECE 200,007,103592,Fainman; Yeshaiahu,9999,0,9999,0
1668359730373,ECE 200,008,103593,Ford; Joseph Earl,9999,0,9999,0
1668359730373,ECE 200,009,103594,Franceschetti; Massimo,9999,0,9999,0
1668359730373,ECE 200,010,103595,Fullerton; Eric E,9999,0,9999,0
1668359730373,ECE 200,011,103596,Galton; Ian A,9999,0,9999,0
1668359730373,ECE 200,012,103597,Gilja; Vikash,9999,0,9999,0
1668359730373,ECE 200,013,103598,Hall; Drew A.,9999,0,9999,0
1668359730373,ECE 200,014,103599,Hsueh; Tzu-Chien,9999,0,9999,0
1668359730373,ECE 200,015,103600,Javidi; Tara,9999,0,9999,0
1668359730373,ECE 200,016,103601,Kahng; Andrew Byun,9999,0,9999,0
1668359730373,ECE 200,017,103602,Kim; Young-Han,9999,0,9999,0
1668359730373,ECE 200,018,103603,Koushanfar; Farinaz,9999,0,9999,0
1668359730373,ECE 200,019,103604,Kuzum; Duygu,9999,0,9999,0
1668359730373,ECE 200,020,103605,Le; Hanh-Phuc,9999,0,9999,0
1668359730373,ECE 200,021,103606,Lin; Bill,9999,0,9999,0
1668359730373,ECE 200,022,103607,Liu; Zhaowei,9998,0,9999,1
1668359730373,ECE 200,023,103608,Lo; Yu-Hwa,9999,0,9999,0
1668359730373,ECE 200,024,103609,Lomakin; Vitaliy,9999,0,9999,0
1668359730373,ECE 200,025,103610,Mercier; Patrick Philip,9999,0,9999,0
1668359730373,ECE 200,026,103611,Meyer; Florian,9999,0,9999,0
1668359730373,ECE 200,027,103612,Milstein; Laurence B.,9999,0,9999,0
1668359730373,ECE 200,028,103613,Mir Arabbaygi; Siavash,9999,0,9999,0
1668359730373,ECE 200,029,103614,Mookherjea; Shayan,9999,0,9999,0
1668359730373,ECE 200,030,103615,Morris; Karcher William,9999,0,9999,0
1668359730373,ECE 200,031,103616,Ng; Tse Nga,9999,0,9999,0
1668359730373,ECE 200,032,103617,Nguyen; Truong Quang,9999,0,9999,0
1668359730373,ECE 200,033,103618,Nomura; Kenji,9999,0,9999,0
1668359730373,ECE 200,034,103619,Orlitsky; Alon,9999,0,9999,0
1668359730373,ECE 200,035,103620,Pal; Piya,9999,0,9999,0
1668359730373,ECE 200,036,103621,Papen; George C.,9999,0,9999,0
1668359730373,ECE 200,037,103622,Radic; Stojan,9999,0,9999,0
1668359730373,ECE 200,038,103623,Rao; Bhaskar D.,9999,0,9999,0
1668359730373,ECE 200,039,103624,Rao; Ramesh R,9999,0,9999,0
1668359730373,ECE 200,040,103625,Rebeiz; Gabriel,9999,0,9999,0
1668359730373,ECE 200,041,103626,Sanford; John R,9999,0,9999,0
1668359730373,ECE 200,042,103627,Siegel; Paul H.,9999,0,9999,0
1668359730373,ECE 200,043,103628,Sievenpiper; Daniel F.,9999,0,9999,0
1668359730373,ECE 200,044,103629,Sworder; David D.,9999,0,9999,0
1668359730373,ECE 200,045,103630,Taur; Yuan,9999,0,9999,0
1668359730373,ECE 200,046,103631,Touri; Behrouz,9999,0,9999,0
1668359730373,ECE 200,047,103632,Trivedi; Mohan M.,9999,0,9999,0
1668359730373,ECE 200,048,103633,Vasconcelos; Nuno,9999,0,9999,0
1668359730373,ECE 200,049,103634,Wang; Xiaolong,9999,0,9999,0
1668359730373,ECE 200,050,103635,Xie; Pengtao,9999,0,9999,0
1668359730373,ECE 200,051,103636,Yip; Michael,9999,0,9999,0
1668359730373,ECE 200,052,103637,Zeger; Kenneth A.,999,0,999,0
1668359730373,ECE 200,053,103638,Zhang; Xinyu,9999,0,9999,0
1668359730373,ECE 200,054,103639,Turakhia; Yatish Girish,9999,0,9999,0
1668359730373,ECE 200,055,103640,Kang; Mingu,9999,0,9999,0
1668359730373,ECE 200,056,103641,Shi; Yuanyuan,9999,0,9999,0
1668359730373,ECE 200,057,103642,Wang; Edward Jay,9999,0,9999,0
1668359730373,ECE 200,058,103643,Zheng; Yang,9999,0,9999,0
1668359730800,ECE 202,A00,103644,Kuzum; Duygu,0,0,0,0
1668359731225,ECE 212BN,A00,103646,Ng; Tse Nga,0,0,0,0
1668359731649,ECE 221,A00,111493,Staff,0,0,0,0
1668359732072,ECE 222B,A00,103647,Lomakin; Vitaliy,0,0,0,0
1668359732497,ECE 230B,A00,103648,Taur; Yuan,0,0,0,0
1668359732921,ECE 238B,A00,103649,Garay; Javier,0,0,0,0
1668359733343,ECE 240B,A00,112900,Fainman; Yeshaiahu,0,0,0,0
1668359733773,ECE 247A,A00,103650,Jokerst; Jesse Vincent,0,0,0,0
1668359734197,ECE 247B,A00,103651,Wang; Joseph,0,0,0,0
1668359734624,ECE 250,A00,103652,Siegel; Paul H.,0,0,0,0
1668359735048,ECE 251A,A00,103654,Rao; Bhaskar D.,0,0,0,0
1668359735471,ECE 257B,A00,103655,Bharadia; Dinesh,0,0,0,0
1668359735899,ECE 258A,A00,103656,Milstein; Laurence B.,0,0,0,0
1668359736322,ECE 260B,A00,103658,Kang; Mingu,0,0,0,0
1668359736751,ECE 264A,A00,103659,Galton; Ian A,0,0,0,0
1668359737175,ECE 265A,A00,103661,Gudem; Prasad S.S.,0,0,0,0
1668359737603,ECE 265D,A00,103662,Gudem; Prasad S.S.,0,0,0,0
1668359738026,ECE 268,A00,103663,Koushanfar; Farinaz,0,0,0,0
1668359738449,ECE 269,A01,103665,Pal; Piya,0,0,0,0
1668359738883,ECE 271B,A00,103666,Vasconcelos; Manuela,0,0,0,0
1668359739305,ECE 276A,A00,103667,Atanasov; Nikolay A.,0,0,0,0
1668359739728,ECE 277,A00,103668,An; Cheolhong,0,0,0,0
1668359740160,ECE 279,A00,117947,Hall; Drew A.,0,0,0,0
1668359741012,ECE 283,A00,103670,Hsueh; Tzu-Chien,0,0,0,0
1668359741435,ECE 284,A00,103671,Turakhia; Yatish Girish,0,0,0,0
1668359741858,ECE 285,A00,103672,Zheng; Yang,0,0,0,0
1668359741858,ECE 285,B00,103673,Sworder; David D.,0,0,0,0
1668359742281,ECE 287,A00,103676,Javidi; Tara,0,0,0,0
1668359742706,MATH 200B,A00,098023,Salehi Golsefidy; Alireza,12,0,15,3
1668359743129,MATH 202B,A00,098024,Rhoades; Brendon Patrick,9,0,15,6
1668359743554,MATH 203B,A00,098025,Oprea; Dragos N.,10,0,15,5
1668359743979,MATH 204B,A00,098026,Sorensen; Claus M,13,0,15,2
1668359744401,MATH 208,A00,098027,Izadi; Elham,7,0,10,3
1668359744826,MATH 209,A00,098028,Pollack; Aaron,10,0,10,0
1668359745251,MATH 211A,A00,112919,Rogalski; Daniel,9,0,10,1
1668359745673,MATH 211B,A00,112920,Seward; Brandon M.,9,0,10,1
1668359746099,MATH 218,A00,098029,Li; Bo,10,0,10,0
1668359746523,MATH 220B,A00,098030,Novak; Jonathan I,11,0,15,4
1668359746949,MATH 221A,A00,098031,Ebenfelt; Peter F,13,0,15,2
1668359747384,MATH 231B,A00,098032,Zlatos; Andrej,12,0,15,3
1668359747808,MATH 240B,A00,098033,Ni; Lei,9,0,15,6
1668359748231,MATH 243,A00,098034,Jekel; David Andrew,10,0,10,0
1668359748656,MATH 245A,A00,098035,Nie; Jiawang,0,0,15,16
1668359749081,MATH 248,A00,098036,Bejenaru; Ioan,10,0,10,0
1668359749506,MATH 250B,A00,098037,Spolaor; Luca,14,0,15,1
1668359749928,MATH 258,A00,098038,Ni; Lei,10,0,10,0
1668359750363,MATH 264B,A00,098041,Rhoades; Brendon Patrick,9,0,15,6
1668359750785,MATH 268,A00,098042,Buss; Samuel R,10,0,10,0
1668359751209,MATH 269,A00,098043,Rhoades; Brendon Patrick,10,0,10,0
1668359751629,MATH 270B,A00,098044,Li; Bo,10,0,15,5
1668359752053,MATH 272B,A00,098045,Holst; Michael J,13,0,15,2
1668359752480,MATH 273A,A00,098046,Tian; Xiaochuan,10,0,15,5
1668359752921,MATH 275,A01,098048,Tian; Xiaochuan,6,0,10,4
1668359753352,MATH 278A,A00,098049,Holst; Michael J,8,0,10,2
1668359753779,MATH 278B,A00,098050,Cloninger; Alexander,10,0,10,0
1668359754201,MATH 278C,A00,098051,Nie; Jiawang,7,0,10,3
1668359754627,MATH 280B,A00,098052,Zheng; Tianyi,8,0,15,7
1668359755051,MATH 281B,A00,098053,Bradic; Jelena,1,0,15,14
1668359755475,MATH 282B,A00,098054,Arias-Castro; Ery,0,0,15,15
1668359755900,MATH 285,A00,098055,Fitzsimmons; Patrick J,0,0,15,17
1668359756325,MATH 287B,A00,098056,Arias-Castro; Ery,2,0,15,13
1668359756748,MATH 288,A00,098057,Agarwal; Pooja,9,0,10,1
1668359756748,MATH 288,B00,098058,Zhang; Danna,8,0,10,2
1668359756748,MATH 288,C00,098059,Williams; Ruth J,9,0,10,1
1668359757171,MATH 290B,A00,098060,Roberts; Justin Deritter,13,0,15,2
1668359757594,MATH 292,A00,098061,Belmont; Eva Kinoshita,10,0,10,0
1668359758025,MATH 295,A00,098062,Suk; Andrew Hoon,48,0,50,2
1668359758449,MATH 296,A00,098063,Novak; Jonathan I,20,0,20,0
1668359758873,MATH 297,001,098064,Gamst; Anthony Collins,9997,0,9999,2
